ROWNUM,合约,日期,前收盘价,前结算价,开盘价,最高价,最低价,收盘价,结算价,涨跌1,涨跌2,成交量,成交金额,持仓量
1,v1701,20170103,6180,6180,5815,6180,5815,5970,6090,-210,-90,428,13034950,9838
2,v1701,20170104,5970,6090,6100,6100,6100,6100,6100,10,10,112,3416000,9838
3,v1701,20170105,6100,6100,6100,6100,6055,6055,6095,-45,-5,26,792550,9814
4,v1701,20170106,6055,6095,0,0,0,6095,6095,0,0,0,0,9814
5,v1701,20170109,6095,6095,6150,6200,6150,6200,6195,105,100,76,2355000,9800
6,v1701,20170110,6200,6195,6250,6280,5835,6180,6180,-15,-15,90,2781050,9790
7,v1701,20170111,6180,6180,6180,6180,6180,6180,6180,0,0,314,9702600,9790
8,v1701,20170112,6180,6180,6200,6200,6200,6200,6200,20,20,2,62000,9790
9,v1701,20170113,6200,6200,6500,6500,6185,6185,6465,-15,265,24,775800,9770
10,v1701,20170116,6185,6465,6250,6380,6205,6250,6150,-215,-315,178,5521450,0
11,v1702,20170103,6150,6150,0,0,0,6065,6065,-85,-85,0,0,50
12,v1702,20170104,6065,6065,0,0,0,6065,6065,0,0,0,0,50
13,v1702,20170105,6065,6065,0,0,0,6065,6065,0,0,0,0,50
14,v1702,20170106,6065,6065,0,0,0,6065,6065,0,0,0,0,50
15,v1702,20170109,6065,6065,0,0,0,6160,6160,95,95,0,0,50
16,v1702,20170110,6160,6160,0,0,0,6150,6150,-10,-10,0,0,50
17,v1702,20170111,6150,6150,0,0,0,6150,6150,0,0,0,0,50
18,v1702,20170112,6150,6150,6450,6450,6450,6450,6450,300,300,2,64500,48
19,v1702,20170113,6450,6450,6450,6450,6400,6400,6420,-50,-30,20,642000,28
20,v1702,20170116,6400,6420,6600,6600,6205,6205,6400,-215,-20,4,128050,26
21,v1702,20170117,6205,6400,0,0,0,6400,6400,0,0,0,0,26
22,v1702,20170118,6400,6400,0,0,0,6395,6395,-5,-5,0,0,26
23,v1702,20170119,6395,6395,6080,6085,6080,6085,6080,-310,-315,4,121650,26
24,v1702,20170120,6085,6080,5780,5780,5780,5780,5780,-300,-300,30,867000,12
25,v1702,20170123,5780,5780,0,0,0,5780,5780,0,0,0,0,12
26,v1702,20170124,5780,5780,0,0,0,5780,5780,0,0,0,0,12
27,v1702,20170125,5780,5780,0,0,0,5780,5780,0,0,0,0,12
28,v1702,20170126,5780,5780,0,0,0,5780,5780,0,0,0,0,12
29,v1702,20170203,5780,5780,0,0,0,5780,5780,0,0,0,0,12
30,v1702,20170206,5780,5780,0,0,0,5780,5780,0,0,0,0,12
31,v1702,20170207,5780,5780,0,0,0,5780,5780,0,0,0,0,12
32,v1702,20170208,5780,5780,0,0,0,5780,5780,0,0,0,0,12
33,v1702,20170209,5780,5780,0,0,0,5780,5780,0,0,0,0,12
34,v1702,20170210,5780,5780,0,0,0,5780,5780,0,0,0,0,12
35,v1702,20170213,5780,5780,6100,6100,6100,6100,6100,320,320,2,61000,12
36,v1702,20170214,6100,6100,0,0,0,6100,6100,0,0,0,0,12
37,v1702,20170215,6100,6100,0,0,0,6100,6100,0,0,0,0,12
38,v1702,20170216,6100,6100,0,0,0,6100,6100,0,0,0,0,0
39,v1703,20170103,5725,5725,6010,6010,6010,6010,6010,285,285,2,60100,8
40,v1703,20170104,6010,6010,6035,6035,6035,6035,6035,25,25,2,60350,8
41,v1703,20170105,6035,6035,0,0,0,6035,6035,0,0,0,0,8
42,v1703,20170106,6035,6035,0,0,0,6035,6035,0,0,0,0,8
43,v1703,20170109,6035,6035,0,0,0,6130,6130,95,95,0,0,8
44,v1703,20170110,6130,6130,0,0,0,6120,6120,-10,-10,0,0,8
45,v1703,20170111,6120,6120,0,0,0,6165,6165,45,45,0,0,8
46,v1703,20170112,6165,6165,0,0,0,6465,6465,300,300,0,0,8
47,v1703,20170113,6465,6465,6575,6575,6445,6445,6540,-20,75,8,261700,2
48,v1703,20170116,6445,6540,6720,6720,6545,6545,6630,5,90,4,132650,2
49,v1703,20170117,6545,6630,0,0,0,6630,6630,0,0,0,0,2
50,v1703,20170118,6630,6630,0,0,0,6450,6450,-180,-180,0,0,2
51,v1703,20170119,6450,6450,0,0,0,6450,6450,0,0,0,0,2
52,v1703,20170120,6450,6450,6300,6300,6135,6195,6225,-255,-225,26,809700,26
53,v1703,20170123,6195,6225,6195,6195,6190,6190,6190,-35,-35,16,495550,26
54,v1703,20170124,6190,6190,0,0,0,6190,6190,0,0,0,0,26
55,v1703,20170125,6190,6190,0,0,0,6190,6190,0,0,0,0,26
56,v1703,20170126,6190,6190,0,0,0,6190,6190,0,0,0,0,26
57,v1703,20170203,6190,6190,6455,6480,6455,6480,6470,290,280,6,194150,26
58,v1703,20170206,6480,6470,0,0,0,6470,6470,0,0,0,0,26
59,v1703,20170207,6470,6470,0,0,0,6470,6470,0,0,0,0,26
60,v1703,20170208,6470,6470,0,0,0,6470,6470,0,0,0,0,26
61,v1703,20170209,6470,6470,0,0,0,6470,6470,0,0,0,0,26
62,v1703,20170210,6470,6470,0,0,0,6470,6470,0,0,0,0,26
63,v1703,20170213,6470,6470,6160,6505,6160,6505,6330,35,-140,4,126650,28
64,v1703,20170214,6505,6330,6645,6645,6645,6645,6645,315,315,2,66450,28
65,v1703,20170215,6645,6645,0,0,0,6645,6645,0,0,0,0,28
66,v1703,20170216,6645,6645,6315,6315,6315,6315,6315,-330,-330,2,63150,26
67,v1703,20170217,6315,6315,0,0,0,6315,6315,0,0,0,0,26
68,v1703,20170220,6315,6315,0,0,0,6315,6315,0,0,0,0,26
69,v1703,20170221,6315,6315,0,0,0,6315,6315,0,0,0,0,26
70,v1703,20170222,6315,6315,0,0,0,6315,6315,0,0,0,0,26
71,v1703,20170223,6315,6315,0,0,0,6315,6315,0,0,0,0,26
72,v1703,20170224,6315,6315,0,0,0,6315,6315,0,0,0,0,26
73,v1703,20170227,6315,6315,0,0,0,6315,6315,0,0,0,0,26
74,v1703,20170228,6315,6315,6630,6630,6630,6630,6630,315,315,2,66300,26
75,v1703,20170301,6630,6630,0,0,0,6235,6235,-395,-395,0,0,26
76,v1703,20170302,6235,6235,0,0,0,5675,5675,-560,-560,0,0,26
77,v1703,20170303,5675,5675,5055,5055,5055,5055,5055,-620,-620,20,505500,12
78,v1703,20170306,5055,5055,0,0,0,5355,5355,300,300,0,0,12
79,v1703,20170307,5355,5355,0,0,0,5835,5835,480,480,0,0,12
80,v1703,20170308,5835,5835,0,0,0,5835,5835,0,0,0,0,12
81,v1703,20170309,5835,5835,0,0,0,5835,5835,0,0,0,0,12
82,v1703,20170310,5835,5835,0,0,0,5835,5835,0,0,0,0,12
83,v1703,20170313,5835,5835,0,0,0,5835,5835,0,0,0,0,12
84,v1703,20170314,5835,5835,6100,6100,6100,6100,5150,265,-685,2,61000,0
85,v1704,20170103,5980,5980,0,0,0,6275,6275,295,295,0,0,10
86,v1704,20170104,6275,6275,0,0,0,6300,6300,25,25,0,0,10
87,v1704,20170105,6300,6300,6360,6360,6165,6165,6260,-135,-40,16,501000,10
88,v1704,20170106,6165,6260,0,0,0,6260,6260,0,0,0,0,10
89,v1704,20170109,6260,6260,0,0,0,6360,6360,100,100,0,0,10
90,v1704,20170110,6360,6360,0,0,0,6345,6345,-15,-15,0,0,10
91,v1704,20170111,6345,6345,0,0,0,6345,6345,0,0,0,0,10
92,v1704,20170112,6345,6345,0,0,0,6650,6650,305,305,0,0,10
93,v1704,20170113,6650,6650,0,0,0,6725,6725,75,75,0,0,10
94,v1704,20170116,6725,6725,6585,7055,6585,7055,6775,330,50,12,406550,10
95,v1704,20170117,7055,6775,0,0,0,6775,6775,0,0,0,0,10
96,v1704,20170118,6775,6775,0,0,0,6775,6775,0,0,0,0,10
97,v1704,20170119,6775,6775,0,0,0,6445,6445,-330,-330,0,0,10
98,v1704,20170120,6445,6445,6685,6695,6685,6695,6685,250,240,6,200650,10
99,v1704,20170123,6695,6685,0,0,0,6650,6650,-35,-35,0,0,10
100,v1704,20170124,6650,6650,0,0,0,6650,6650,0,0,0,0,10
101,v1704,20170125,6650,6650,0,0,0,6650,6650,0,0,0,0,10
102,v1704,20170126,6650,6650,0,0,0,6650,6650,0,0,0,0,10
103,v1704,20170203,6650,6650,0,0,0,6950,6950,300,300,0,0,10
104,v1704,20170206,6950,6950,0,0,0,6950,6950,0,0,0,0,10
105,v1704,20170207,6950,6950,0,0,0,6950,6950,0,0,0,0,10
106,v1704,20170208,6950,6950,0,0,0,6950,6950,0,0,0,0,10
107,v1704,20170209,6950,6950,0,0,0,6950,6950,0,0,0,0,10
108,v1704,20170210,6950,6950,0,0,0,6950,6950,0,0,0,0,10
109,v1704,20170213,6950,6950,0,0,0,6800,6800,-150,-150,0,0,10
110,v1704,20170214,6800,6800,0,0,0,7135,7135,335,335,0,0,10
111,v1704,20170215,7135,7135,0,0,0,7135,7135,0,0,0,0,10
112,v1704,20170216,7135,7135,0,0,0,6785,6785,-350,-350,0,0,10
113,v1704,20170217,6785,6785,6750,7095,6750,7095,6920,310,135,4,138450,8
114,v1704,20170220,7095,6920,0,0,0,6920,6920,0,0,0,0,8
115,v1704,20170221,6920,6920,0,0,0,6920,6920,0,0,0,0,8
116,v1704,20170222,6920,6920,0,0,0,6920,6920,0,0,0,0,8
117,v1704,20170223,6920,6920,0,0,0,6920,6920,0,0,0,0,8
118,v1704,20170224,6920,6920,0,0,0,6920,6920,0,0,0,0,8
119,v1704,20170227,6920,6920,0,0,0,6920,6920,0,0,0,0,8
120,v1704,20170228,6920,6920,0,0,0,7265,7265,345,345,0,0,8
121,v1704,20170301,7265,7265,0,0,0,7265,7265,0,0,0,0,8
122,v1704,20170302,7265,7265,0,0,0,7265,7265,0,0,0,0,8
123,v1704,20170303,7265,7265,0,0,0,6905,6905,-360,-360,0,0,8
124,v1704,20170306,6905,6905,0,0,0,6905,6905,0,0,0,0,8
125,v1704,20170307,6905,6905,0,0,0,6905,6905,0,0,0,0,8
126,v1704,20170308,6905,6905,6800,6800,6600,6600,6700,-305,-205,4,134000,8
127,v1704,20170309,6600,6700,0,0,0,6700,6700,0,0,0,0,8
128,v1704,20170310,6700,6700,0,0,0,6700,6700,0,0,0,0,8
129,v1704,20170313,6700,6700,0,0,0,6700,6700,0,0,0,0,8
130,v1704,20170314,6700,6700,0,0,0,6365,6365,-335,-335,0,0,8
131,v1704,20170315,6365,6365,0,0,0,6365,6365,0,0,0,0,8
132,v1704,20170316,6365,6365,6675,6675,6665,6665,6670,300,305,6,200100,2
133,v1704,20170317,6665,6670,0,0,0,6670,6670,0,0,0,0,2
134,v1704,20170320,6670,6670,0,0,0,6670,6670,0,0,0,0,2
135,v1704,20170321,6670,6670,0,0,0,6670,6670,0,0,0,0,2
136,v1704,20170322,6670,6670,0,0,0,6670,6670,0,0,0,0,2
137,v1704,20170323,6670,6670,0,0,0,6670,6670,0,0,0,0,2
138,v1704,20170324,6670,6670,0,0,0,6670,6670,0,0,0,0,2
139,v1704,20170327,6670,6670,0,0,0,6670,6670,0,0,0,0,2
140,v1704,20170328,6670,6670,0,0,0,6670,6670,0,0,0,0,2
141,v1704,20170329,6670,6670,7000,7000,7000,7000,7000,330,330,2,70000,4
142,v1704,20170330,7000,7000,7050,7050,6650,6650,6850,-350,-150,4,137000,4
143,v1704,20170331,6650,6850,0,0,0,6850,6850,0,0,0,0,4
144,v1704,20170405,6850,6850,0,0,0,6850,6850,0,0,0,0,4
145,v1704,20170406,6850,6850,0,0,0,6850,6850,0,0,0,0,4
146,v1704,20170407,6850,6850,0,0,0,6850,6850,0,0,0,0,4
147,v1704,20170410,6850,6850,0,0,0,6850,6850,0,0,0,0,4
148,v1704,20170411,6850,6850,0,0,0,6850,6850,0,0,0,0,4
149,v1704,20170412,6850,6850,0,0,0,6850,6850,0,0,0,0,4
150,v1704,20170413,6850,6850,0,0,0,6850,6850,0,0,0,0,4
151,v1704,20170414,6850,6850,0,0,0,6850,6850,0,0,0,0,4
152,v1704,20170417,6850,6850,0,0,0,6850,6850,0,0,0,0,4
153,v1704,20170418,6850,6850,0,0,0,6850,6850,0,0,0,0,0
154,v1705,20170103,6210,6220,6215,6240,6010,6025,6065,-195,-155,297090,9010836250,170220
155,v1705,20170104,6025,6065,5990,6150,5950,6135,6085,70,20,280916,8552643950,147252
156,v1705,20170105,6135,6085,6155,6215,6105,6125,6145,40,60,171118,5261574250,152024
157,v1705,20170106,6125,6145,6150,6185,6080,6135,6130,-10,-15,224062,6872158200,156660
158,v1705,20170109,6135,6130,6135,6380,6105,6380,6255,250,125,285438,8929380650,144858
159,v1705,20170110,6380,6255,6380,6435,6310,6390,6375,135,120,211502,6742646100,144142
160,v1705,20170111,6390,6375,6435,6515,6335,6410,6410,35,35,235202,7538593900,135818
161,v1705,20170112,6410,6410,6420,6480,6375,6430,6420,20,10,192506,6183990300,136552
162,v1705,20170113,6430,6420,6450,6500,6415,6470,6455,50,35,153230,4946857900,137872
163,v1705,20170116,6470,6455,6550,6645,6525,6550,6590,95,135,263320,8677011700,144102
164,v1705,20170117,6550,6590,6550,6565,6370,6430,6470,-160,-120,219580,7106709850,133410
165,v1705,20170118,6430,6470,6430,6480,6405,6480,6440,10,-30,123098,3966424200,132318
166,v1705,20170119,6480,6440,6465,6595,6405,6585,6500,145,60,195288,6349877150,141032
167,v1705,20170120,6585,6500,6565,6585,6510,6540,6540,40,40,143384,4690731050,128190
168,v1705,20170123,6540,6540,6560,6605,6495,6520,6550,-20,10,148092,4851001950,125796
169,v1705,20170124,6520,6550,6550,6570,6455,6490,6510,-60,-40,126280,4111308800,130320
170,v1705,20170125,6490,6510,6485,6590,6450,6560,6535,50,25,105330,3442897900,117618
171,v1705,20170126,6560,6535,6595,6605,6500,6575,6535,40,0,62026,2027614500,112958
172,v1705,20170203,6575,6535,6620,6850,6610,6800,6760,265,225,203504,6879322900,143690
173,v1705,20170206,6800,6760,6820,6865,6750,6810,6800,50,40,140656,4785553300,146814
174,v1705,20170207,6810,6800,6800,6880,6785,6845,6840,45,40,99878,3416739950,149102
175,v1705,20170208,6845,6840,6810,6855,6720,6790,6785,-50,-55,146270,4964381000,142326
176,v1705,20170209,6790,6785,6805,6850,6785,6810,6815,25,30,104872,3574715050,145070
177,v1705,20170210,6810,6815,6820,6925,6770,6875,6845,60,30,160906,5508451600,158608
178,v1705,20170213,6875,6845,6950,6985,6900,6920,6945,75,100,135964,4722131850,158090
179,v1705,20170214,6920,6945,6900,6980,6880,6940,6935,-5,-10,128578,4460259450,156838
180,v1705,20170215,6940,6935,6880,6925,6740,6750,6825,-185,-110,170504,5820114150,139636
181,v1705,20170216,6750,6825,6770,6795,6690,6755,6740,-70,-85,160470,5409880150,128834
182,v1705,20170217,6755,6740,6760,6775,6635,6680,6695,-60,-45,139200,4661228100,125592
183,v1705,20170220,6680,6695,6670,6750,6640,6710,6705,15,10,103208,3460880700,128818
184,v1705,20170221,6710,6705,6730,6760,6510,6515,6620,-190,-85,213062,7057024200,127074
185,v1705,20170222,6515,6620,6505,6555,6470,6495,6510,-125,-110,145922,4751608950,122546
186,v1705,20170223,6495,6510,6490,6515,6335,6360,6410,-150,-100,197476,6330500100,120680
187,v1705,20170224,6360,6410,6335,6460,6280,6450,6380,40,-30,152156,4856542450,112428
188,v1705,20170227,6450,6380,6450,6545,6450,6510,6500,130,120,128142,4165881050,106650
189,v1705,20170228,6510,6500,6490,6525,6400,6405,6460,-95,-40,155306,5018446200,110778
190,v1705,20170301,6405,6460,6445,6470,6370,6440,6420,-20,-40,122160,3921757900,113682
191,v1705,20170302,6440,6420,6445,6480,6395,6465,6440,45,20,113466,3653801100,115082
192,v1705,20170303,6465,6440,6400,6610,6380,6595,6545,155,105,215636,7058748950,121710
193,v1705,20170306,6595,6545,6615,6710,6610,6670,6660,125,115,132720,4421266550,120460
194,v1705,20170307,6670,6660,6700,6740,6615,6675,6670,15,10,124248,4143948100,116724
195,v1705,20170308,6675,6670,6590,6615,6400,6410,6495,-260,-175,193656,6290948500,112770
196,v1705,20170309,6410,6495,6325,6550,6300,6490,6465,-5,-30,240938,7793097650,118192
197,v1705,20170310,6490,6465,6495,6540,6360,6405,6420,-60,-45,204726,6575721150,119356
198,v1705,20170313,6405,6420,6305,6460,6280,6440,6390,20,-30,158570,5069000200,119196
199,v1705,20170314,6440,6390,6445,6585,6400,6560,6480,170,90,166356,5390764350,127076
200,v1705,20170315,6560,6480,6610,6655,6560,6565,6605,85,125,154764,5111730250,121258
201,v1705,20170316,6565,6605,6590,6675,6565,6670,6610,65,5,139668,4616618150,126460
202,v1705,20170317,6670,6610,6650,6705,6610,6655,6650,45,40,127050,4227411250,127334
203,v1705,20170320,6655,6650,6650,6680,6550,6570,6590,-80,-60,127738,4211141250,115210
204,v1705,20170321,6570,6590,6560,6565,6370,6415,6445,-175,-145,184710,5952520400,101058
205,v1705,20170322,6415,6445,6370,6400,6305,6345,6355,-100,-90,130112,4137346900,91616
206,v1705,20170323,6345,6355,6390,6450,6235,6335,6345,-20,-10,158440,5027296150,96602
207,v1705,20170324,6335,6345,6340,6375,6260,6265,6330,-80,-15,90160,2854275300,94240
208,v1705,20170327,6265,6330,6230,6275,6110,6170,6170,-160,-160,178008,5493127250,96318
209,v1705,20170328,6170,6170,6215,6240,6185,6200,6215,30,45,75106,2334158500,89744
210,v1705,20170329,6200,6215,6270,6300,6215,6250,6260,35,45,78560,2459954950,80866
211,v1705,20170330,6250,6260,6285,6320,6095,6155,6180,-105,-80,94530,2921646900,83846
212,v1705,20170331,6155,6180,6190,6195,6080,6115,6120,-65,-60,107686,3295481900,87320
213,v1705,20170405,6115,6120,6135,6295,6085,6265,6210,145,90,113370,3522252850,63208
214,v1705,20170406,6265,6210,6235,6250,6185,6205,6215,-5,5,52718,1638850000,59342
215,v1705,20170407,6205,6215,6160,6240,5985,6030,6095,-185,-120,102176,3115317250,65040
216,v1705,20170410,6030,6095,6050,6110,5965,6035,6030,-60,-65,54690,1649323800,55046
217,v1705,20170411,6035,6030,6095,6165,6035,6110,6115,80,85,56534,1729315150,29666
218,v1705,20170412,6110,6115,6100,6105,6030,6045,6070,-70,-45,16338,495866600,25138
219,v1705,20170413,6045,6070,6035,6060,5850,5855,5930,-215,-140,19706,584373350,19148
220,v1705,20170414,5855,5930,5875,5890,5710,5730,5770,-200,-160,13312,384177400,16088
221,v1705,20170417,5730,5770,5770,5795,5665,5705,5745,-65,-25,9684,278340200,12614
222,v1705,20170418,5705,5745,5690,5780,5575,5575,5645,-170,-100,7450,210403800,10012
223,v1705,20170419,5575,5645,5560,5570,5480,5560,5525,-85,-120,4986,137859650,9106
224,v1705,20170420,5560,5525,5520,5595,5460,5535,5520,10,-5,4432,122337450,7766
225,v1705,20170421,5535,5520,5555,5645,5545,5605,5605,85,85,5068,142095100,6672
226,v1705,20170424,5605,5605,5590,5600,5460,5540,5530,-65,-75,2424,67079050,5470
227,v1705,20170425,5540,5530,5540,5560,5435,5435,5505,-95,-25,1376,37889450,5054
228,v1705,20170426,5435,5505,5440,5580,5440,5545,5475,40,-30,2138,58571800,4410
229,v1705,20170427,5545,5475,5515,5635,5490,5635,5525,160,50,1318,36417800,3930
230,v1705,20170428,5635,5525,5645,5760,5635,5745,5705,220,180,1224,34916700,3572
231,v1705,20170502,5745,5705,5710,5760,5685,5685,5700,-20,-5,122,3479100,3584
232,v1705,20170503,5685,5700,5720,5765,5675,5675,5720,-25,20,48,1373950,3584
233,v1705,20170504,5675,5720,5535,5535,5435,5510,5500,-210,-220,128,3522250,3604
234,v1705,20170505,5510,5500,5410,5485,5410,5480,5470,-20,-30,70,1916200,3624
235,v1705,20170508,5480,5470,5555,5555,5505,5505,5515,35,45,216,5961350,3642
236,v1705,20170509,5505,5515,5545,5635,5540,5620,5575,105,60,196,5465500,3668
237,v1705,20170510,5620,5575,5700,5700,5505,5505,5650,-70,75,320,9042600,3384
238,v1705,20170511,5505,5650,5570,5650,5570,5650,5600,0,-50,34,952700,3404
239,v1705,20170512,5650,5600,5565,5565,5560,5560,5560,-40,-40,12,333650,3416
240,v1705,20170515,5560,5560,5700,5820,5670,5670,5640,110,80,448,12934800,0
241,v1706,20170103,6265,6265,0,0,0,6110,6110,-155,-155,0,0,0
242,v1706,20170104,6110,6110,6185,6185,6100,6100,6130,-10,20,62,1900850,4
243,v1706,20170105,6100,6130,6200,6200,6200,6200,6200,70,70,2,62000,2
244,v1706,20170106,6200,6200,0,0,0,6185,6185,-15,-15,0,0,2
245,v1706,20170109,6185,6185,0,0,0,6310,6310,125,125,0,0,2
246,v1706,20170110,6310,6310,6495,6495,6495,6495,6495,185,185,4,129900,6
247,v1706,20170111,6495,6495,0,0,0,6530,6530,35,35,0,0,6
248,v1706,20170112,6530,6530,6270,6400,6270,6305,6290,-225,-240,18,566300,8
249,v1706,20170113,6305,6290,6430,6515,6430,6515,6460,225,170,8,258450,0
250,v1706,20170116,6515,6460,0,0,0,6595,6595,135,135,0,0,0
251,v1706,20170117,6595,6595,0,0,0,6475,6475,-120,-120,0,0,0
252,v1706,20170118,6475,6475,0,0,0,6445,6445,-30,-30,0,0,0
253,v1706,20170119,6445,6445,0,0,0,6505,6505,60,60,0,0,0
254,v1706,20170120,6505,6505,0,0,0,6545,6545,40,40,0,0,0
255,v1706,20170123,6545,6545,0,0,0,6555,6555,10,10,0,0,0
256,v1706,20170124,6555,6555,0,0,0,6515,6515,-40,-40,0,0,0
257,v1706,20170125,6515,6515,0,0,0,6540,6540,25,25,0,0,0
258,v1706,20170126,6540,6540,0,0,0,6540,6540,0,0,0,0,0
259,v1706,20170203,6540,6540,0,0,0,6765,6765,225,225,0,0,0
260,v1706,20170206,6765,6765,0,0,0,6805,6805,40,40,0,0,0
261,v1706,20170207,6805,6805,0,0,0,6845,6845,40,40,0,0,0
262,v1706,20170208,6845,6845,0,0,0,6790,6790,-55,-55,0,0,0
263,v1706,20170209,6790,6790,0,0,0,6820,6820,30,30,0,0,0
264,v1706,20170210,6820,6820,0,0,0,6850,6850,30,30,0,0,0
265,v1706,20170213,6850,6850,0,0,0,6950,6950,100,100,0,0,0
266,v1706,20170214,6950,6950,0,0,0,6940,6940,-10,-10,0,0,0
267,v1706,20170215,6940,6940,0,0,0,6830,6830,-110,-110,0,0,0
268,v1706,20170216,6830,6830,0,0,0,6745,6745,-85,-85,0,0,0
269,v1706,20170217,6745,6745,0,0,0,6700,6700,-45,-45,0,0,0
270,v1706,20170220,6700,6700,0,0,0,6710,6710,10,10,0,0,0
271,v1706,20170221,6710,6710,6740,6815,6740,6815,6775,105,65,4,135550,0
272,v1706,20170222,6815,6775,0,0,0,6665,6665,-110,-110,0,0,0
273,v1706,20170223,6665,6665,0,0,0,6565,6565,-100,-100,0,0,0
274,v1706,20170224,6565,6565,6330,6500,6330,6500,6415,-65,-150,4,128300,0
275,v1706,20170227,6500,6415,0,0,0,6535,6535,120,120,0,0,0
276,v1706,20170228,6535,6535,0,0,0,6495,6495,-40,-40,0,0,0
277,v1706,20170301,6495,6495,0,0,0,6455,6455,-40,-40,0,0,0
278,v1706,20170302,6455,6455,0,0,0,6475,6475,20,20,0,0,0
279,v1706,20170303,6475,6475,0,0,0,6580,6580,105,105,0,0,0
280,v1706,20170306,6580,6580,0,0,0,6695,6695,115,115,0,0,0
281,v1706,20170307,6695,6695,0,0,0,6705,6705,10,10,0,0,0
282,v1706,20170308,6705,6705,0,0,0,6530,6530,-175,-175,0,0,0
283,v1706,20170309,6530,6530,0,0,0,6500,6500,-30,-30,0,0,0
284,v1706,20170310,6500,6500,0,0,0,6455,6455,-45,-45,0,0,0
285,v1706,20170313,6455,6455,0,0,0,6425,6425,-30,-30,0,0,0
286,v1706,20170314,6425,6425,0,0,0,6515,6515,90,90,0,0,0
287,v1706,20170315,6515,6515,0,0,0,6640,6640,125,125,0,0,0
288,v1706,20170316,6640,6640,0,0,0,6645,6645,5,5,0,0,0
289,v1706,20170317,6645,6645,0,0,0,6685,6685,40,40,0,0,0
290,v1706,20170320,6685,6685,0,0,0,6625,6625,-60,-60,0,0,0
291,v1706,20170321,6625,6625,0,0,0,6480,6480,-145,-145,0,0,0
292,v1706,20170322,6480,6480,0,0,0,6390,6390,-90,-90,0,0,0
293,v1706,20170323,6390,6390,0,0,0,6380,6380,-10,-10,0,0,0
294,v1706,20170324,6380,6380,0,0,0,6365,6365,-15,-15,0,0,0
295,v1706,20170327,6365,6365,0,0,0,6205,6205,-160,-160,0,0,0
296,v1706,20170328,6205,6205,0,0,0,6250,6250,45,45,0,0,0
297,v1706,20170329,6250,6250,0,0,0,6295,6295,45,45,0,0,0
298,v1706,20170330,6295,6295,0,0,0,6215,6215,-80,-80,0,0,0
299,v1706,20170331,6215,6215,0,0,0,6155,6155,-60,-60,0,0,0
300,v1706,20170405,6155,6155,0,0,0,6245,6245,90,90,0,0,0
301,v1706,20170406,6245,6245,0,0,0,6250,6250,5,5,0,0,0
302,v1706,20170407,6250,6250,0,0,0,6130,6130,-120,-120,0,0,0
303,v1706,20170410,6130,6130,0,0,0,6065,6065,-65,-65,0,0,0
304,v1706,20170411,6065,6065,0,0,0,6150,6150,85,85,0,0,0
305,v1706,20170412,6150,6150,0,0,0,6105,6105,-45,-45,0,0,0
306,v1706,20170413,6105,6105,0,0,0,5965,5965,-140,-140,0,0,0
307,v1706,20170414,5965,5965,0,0,0,5805,5805,-160,-160,0,0,0
308,v1706,20170417,5805,5805,0,0,0,5780,5780,-25,-25,0,0,0
309,v1706,20170418,5780,5780,0,0,0,5680,5680,-100,-100,0,0,0
310,v1706,20170419,5680,5680,0,0,0,5560,5560,-120,-120,0,0,0
311,v1706,20170420,5560,5560,0,0,0,5555,5555,-5,-5,0,0,0
312,v1706,20170421,5555,5555,0,0,0,5640,5640,85,85,0,0,0
313,v1706,20170424,5640,5640,0,0,0,5565,5565,-75,-75,0,0,0
314,v1706,20170425,5565,5565,0,0,0,5540,5540,-25,-25,0,0,0
315,v1706,20170426,5540,5540,0,0,0,5510,5510,-30,-30,0,0,0
316,v1706,20170427,5510,5510,0,0,0,5560,5560,50,50,0,0,0
317,v1706,20170428,5560,5560,0,0,0,5740,5740,180,180,0,0,0
318,v1706,20170502,5740,5740,0,0,0,5735,5735,-5,-5,0,0,0
319,v1706,20170503,5735,5735,0,0,0,5755,5755,20,20,0,0,0
320,v1706,20170504,5755,5755,0,0,0,5535,5535,-220,-220,0,0,0
321,v1706,20170505,5535,5535,0,0,0,5505,5505,-30,-30,0,0,0
322,v1706,20170508,5505,5505,0,0,0,5550,5550,45,45,0,0,0
323,v1706,20170509,5550,5550,0,0,0,5610,5610,60,60,0,0,0
324,v1706,20170510,5610,5610,0,0,0,5685,5685,75,75,0,0,0
325,v1706,20170511,5685,5685,0,0,0,5635,5635,-50,-50,0,0,0
326,v1706,20170512,5635,5635,0,0,0,5595,5595,-40,-40,0,0,0
327,v1706,20170515,5595,5595,0,0,0,5675,5675,80,80,0,0,0
328,v1706,20170516,5675,5675,0,0,0,5675,5675,0,0,0,0,0
329,v1706,20170517,5675,5675,0,0,0,5675,5675,0,0,0,0,0
330,v1706,20170518,5675,5675,0,0,0,5675,5675,0,0,0,0,0
331,v1706,20170519,5675,5675,0,0,0,5675,5675,0,0,0,0,0
332,v1706,20170522,5675,5675,0,0,0,5675,5675,0,0,0,0,0
333,v1706,20170523,5675,5675,0,0,0,5675,5675,0,0,0,0,0
334,v1706,20170524,5675,5675,0,0,0,5675,5675,0,0,0,0,0
335,v1706,20170525,5675,5675,0,0,0,5675,5675,0,0,0,0,0
336,v1706,20170526,5675,5675,0,0,0,5675,5675,0,0,0,0,0
337,v1706,20170531,5675,5675,0,0,0,5675,5675,0,0,0,0,0
338,v1706,20170601,5675,5675,0,0,0,5675,5675,0,0,0,0,0
339,v1706,20170602,5675,5675,0,0,0,5675,5675,0,0,0,0,0
340,v1706,20170605,5675,5675,0,0,0,5675,5675,0,0,0,0,0
341,v1706,20170606,5675,5675,0,0,0,5675,5675,0,0,0,0,0
342,v1706,20170607,5675,5675,0,0,0,5675,5675,0,0,0,0,0
343,v1706,20170608,5675,5675,0,0,0,5675,5675,0,0,0,0,0
344,v1706,20170609,5675,5675,0,0,0,5675,5675,0,0,0,0,0
345,v1706,20170612,5675,5675,0,0,0,5675,5675,0,0,0,0,0
346,v1706,20170613,5675,5675,0,0,0,5675,5675,0,0,0,0,0
347,v1706,20170614,5675,5675,0,0,0,5675,5675,0,0,0,0,0
348,v1707,20170103,6265,6265,0,0,0,6110,6110,-155,-155,0,0,0
349,v1707,20170104,6110,6110,0,0,0,6125,6125,15,15,0,0,0
350,v1707,20170105,6125,6125,0,0,0,6190,6190,65,65,0,0,0
351,v1707,20170106,6190,6190,0,0,0,6175,6175,-15,-15,0,0,0
352,v1707,20170109,6175,6175,0,0,0,6300,6300,125,125,0,0,0
353,v1707,20170110,6300,6300,0,0,0,6480,6480,180,180,0,0,0
354,v1707,20170111,6480,6480,0,0,0,6515,6515,35,35,0,0,0
355,v1707,20170112,6515,6515,0,0,0,6280,6280,-235,-235,0,0,0
356,v1707,20170113,6280,6280,0,0,0,6445,6445,165,165,0,0,0
357,v1707,20170116,6445,6445,0,0,0,6575,6575,130,130,0,0,0
358,v1707,20170117,6575,6575,0,0,0,6460,6460,-115,-115,0,0,0
359,v1707,20170118,6460,6460,0,0,0,6435,6435,-25,-25,0,0,0
360,v1707,20170119,6435,6435,0,0,0,6490,6490,55,55,0,0,0
361,v1707,20170120,6490,6490,0,0,0,6525,6525,35,35,0,0,0
362,v1707,20170123,6525,6525,0,0,0,6530,6530,5,5,0,0,0
363,v1707,20170124,6530,6530,0,0,0,6495,6495,-35,-35,0,0,0
364,v1707,20170125,6495,6495,0,0,0,6515,6515,20,20,0,0,0
365,v1707,20170126,6515,6515,0,0,0,6515,6515,0,0,0,0,0
366,v1707,20170203,6515,6515,0,0,0,6735,6735,220,220,0,0,0
367,v1707,20170206,6735,6735,0,0,0,6770,6770,35,35,0,0,0
368,v1707,20170207,6770,6770,0,0,0,6805,6805,35,35,0,0,0
369,v1707,20170208,6805,6805,0,0,0,6755,6755,-50,-50,0,0,0
370,v1707,20170209,6755,6755,0,0,0,6780,6780,25,25,0,0,0
371,v1707,20170210,6780,6780,0,0,0,6805,6805,25,25,0,0,0
372,v1707,20170213,6805,6805,0,0,0,6900,6900,95,95,0,0,0
373,v1707,20170214,6900,6900,0,0,0,6895,6895,-5,-5,0,0,0
374,v1707,20170215,6895,6895,0,0,0,6790,6790,-105,-105,0,0,0
375,v1707,20170216,6790,6790,0,0,0,6710,6710,-80,-80,0,0,0
376,v1707,20170217,6710,6710,0,0,0,6670,6670,-40,-40,0,0,0
377,v1707,20170220,6670,6670,0,0,0,6675,6675,5,5,0,0,0
378,v1707,20170221,6675,6675,0,0,0,6735,6735,60,60,0,0,0
379,v1707,20170222,6735,6735,0,0,0,6625,6625,-110,-110,0,0,0
380,v1707,20170223,6625,6625,0,0,0,6525,6525,-100,-100,0,0,0
381,v1707,20170224,6525,6525,0,0,0,6380,6380,-145,-145,0,0,0
382,v1707,20170227,6380,6380,0,0,0,6500,6500,120,120,0,0,0
383,v1707,20170228,6500,6500,0,0,0,6460,6460,-40,-40,0,0,0
384,v1707,20170301,6460,6460,0,0,0,6420,6420,-40,-40,0,0,0
385,v1707,20170302,6420,6420,0,0,0,6435,6435,15,15,0,0,0
386,v1707,20170303,6435,6435,0,0,0,6535,6535,100,100,0,0,0
387,v1707,20170306,6535,6535,0,0,0,6645,6645,110,110,0,0,0
388,v1707,20170307,6645,6645,0,0,0,6650,6650,5,5,0,0,0
389,v1707,20170308,6650,6650,0,0,0,6480,6480,-170,-170,0,0,0
390,v1707,20170309,6480,6480,0,0,0,6455,6455,-25,-25,0,0,0
391,v1707,20170310,6455,6455,0,0,0,6415,6415,-40,-40,0,0,0
392,v1707,20170313,6415,6415,0,0,0,6390,6390,-25,-25,0,0,0
393,v1707,20170314,6390,6390,0,0,0,6480,6480,90,90,0,0,0
394,v1707,20170315,6480,6480,0,0,0,6600,6600,120,120,0,0,0
395,v1707,20170316,6600,6600,0,0,0,6600,6600,0,0,0,0,0
396,v1707,20170317,6600,6600,0,0,0,6635,6635,35,35,0,0,0
397,v1707,20170320,6635,6635,0,0,0,6580,6580,-55,-55,0,0,0
398,v1707,20170321,6580,6580,0,0,0,6440,6440,-140,-140,0,0,0
399,v1707,20170322,6440,6440,0,0,0,6355,6355,-85,-85,0,0,0
400,v1707,20170323,6355,6355,0,0,0,6345,6345,-10,-10,0,0,0
401,v1707,20170324,6345,6345,0,0,0,6335,6335,-10,-10,0,0,0
402,v1707,20170327,6335,6335,0,0,0,6175,6175,-160,-160,0,0,0
403,v1707,20170328,6175,6175,0,0,0,6220,6220,45,45,0,0,0
404,v1707,20170329,6220,6220,0,0,0,6265,6265,45,45,0,0,0
405,v1707,20170330,6265,6265,0,0,0,6185,6185,-80,-80,0,0,0
406,v1707,20170331,6185,6185,0,0,0,6125,6125,-60,-60,0,0,0
407,v1707,20170405,6125,6125,0,0,0,6215,6215,90,90,0,0,0
408,v1707,20170406,6215,6215,0,0,0,6220,6220,5,5,0,0,0
409,v1707,20170407,6220,6220,0,0,0,6100,6100,-120,-120,0,0,0
410,v1707,20170410,6100,6100,0,0,0,6035,6035,-65,-65,0,0,0
411,v1707,20170411,6035,6035,0,0,0,6120,6120,85,85,0,0,0
412,v1707,20170412,6120,6120,0,0,0,6075,6075,-45,-45,0,0,0
413,v1707,20170413,6075,6075,0,0,0,5935,5935,-140,-140,0,0,0
414,v1707,20170414,5935,5935,0,0,0,5775,5775,-160,-160,0,0,0
415,v1707,20170417,5775,5775,0,0,0,5750,5750,-25,-25,0,0,0
416,v1707,20170418,5750,5750,0,0,0,5650,5650,-100,-100,0,0,0
417,v1707,20170419,5650,5650,0,0,0,5530,5530,-120,-120,0,0,0
418,v1707,20170420,5530,5530,0,0,0,5525,5525,-5,-5,0,0,0
419,v1707,20170421,5525,5525,0,0,0,5610,5610,85,85,0,0,0
420,v1707,20170424,5610,5610,5655,5655,5655,5655,5655,45,45,2,56550,2
421,v1707,20170425,5655,5655,0,0,0,5630,5630,-25,-25,0,0,2
422,v1707,20170426,5630,5630,0,0,0,5600,5600,-30,-30,0,0,2
423,v1707,20170427,5600,5600,0,0,0,5650,5650,50,50,0,0,2
424,v1707,20170428,5650,5650,0,0,0,5830,5830,180,180,0,0,2
425,v1707,20170502,5830,5830,0,0,0,5825,5825,-5,-5,0,0,2
426,v1707,20170503,5825,5825,0,0,0,5845,5845,20,20,0,0,2
427,v1707,20170504,5845,5845,0,0,0,5625,5625,-220,-220,0,0,2
428,v1707,20170505,5625,5625,0,0,0,5595,5595,-30,-30,0,0,2
429,v1707,20170508,5595,5595,0,0,0,5640,5640,45,45,0,0,2
430,v1707,20170509,5640,5640,0,0,0,5700,5700,60,60,0,0,2
431,v1707,20170510,5700,5700,0,0,0,5775,5775,75,75,0,0,2
432,v1707,20170511,5775,5775,0,0,0,5725,5725,-50,-50,0,0,2
433,v1707,20170512,5725,5725,0,0,0,5685,5685,-40,-40,0,0,2
434,v1707,20170515,5685,5685,0,0,0,5765,5765,80,80,0,0,2
435,v1707,20170516,5765,5765,0,0,0,5765,5765,0,0,0,0,2
436,v1707,20170517,5765,5765,0,0,0,5765,5765,0,0,0,0,2
437,v1707,20170518,5765,5765,0,0,0,5765,5765,0,0,0,0,2
438,v1707,20170519,5765,5765,0,0,0,5765,5765,0,0,0,0,2
439,v1707,20170522,5765,5765,0,0,0,5765,5765,0,0,0,0,2
440,v1707,20170523,5765,5765,0,0,0,5765,5765,0,0,0,0,2
441,v1707,20170524,5765,5765,0,0,0,5765,5765,0,0,0,0,2
442,v1707,20170525,5765,5765,0,0,0,5765,5765,0,0,0,0,2
443,v1707,20170526,5765,5765,0,0,0,5765,5765,0,0,0,0,2
444,v1707,20170531,5765,5765,5820,5820,5820,5820,5820,55,55,2,58200,0
445,v1707,20170601,5820,5820,0,0,0,5820,5820,0,0,0,0,0
446,v1707,20170602,5820,5820,0,0,0,5820,5820,0,0,0,0,0
447,v1707,20170605,5820,5820,0,0,0,5820,5820,0,0,0,0,0
448,v1707,20170606,5820,5820,0,0,0,5820,5820,0,0,0,0,0
449,v1707,20170607,5820,5820,0,0,0,5820,5820,0,0,0,0,0
450,v1707,20170608,5820,5820,0,0,0,5820,5820,0,0,0,0,0
451,v1707,20170609,5820,5820,0,0,0,5820,5820,0,0,0,0,0
452,v1707,20170612,5820,5820,0,0,0,5820,5820,0,0,0,0,0
453,v1707,20170613,5820,5820,0,0,0,5820,5820,0,0,0,0,0
454,v1707,20170614,5820,5820,0,0,0,5820,5820,0,0,0,0,0
455,v1707,20170615,5820,5820,0,0,0,5820,5820,0,0,0,0,0
456,v1707,20170616,5820,5820,0,0,0,5820,5820,0,0,0,0,0
457,v1707,20170619,5820,5820,0,0,0,5820,5820,0,0,0,0,0
458,v1707,20170620,5820,5820,0,0,0,5820,5820,0,0,0,0,0
459,v1707,20170621,5820,5820,0,0,0,5820,5820,0,0,0,0,0
460,v1707,20170622,5820,5820,0,0,0,5820,5820,0,0,0,0,0
461,v1707,20170623,5820,5820,0,0,0,5820,5820,0,0,0,0,0
462,v1707,20170626,5820,5820,0,0,0,5820,5820,0,0,0,0,0
463,v1707,20170627,5820,5820,0,0,0,5820,5820,0,0,0,0,0
464,v1707,20170628,5820,5820,0,0,0,5820,5820,0,0,0,0,0
465,v1707,20170629,5820,5820,0,0,0,5820,5820,0,0,0,0,0
466,v1707,20170630,5820,5820,0,0,0,5820,5820,0,0,0,0,0
467,v1707,20170703,5820,5820,0,0,0,5820,5820,0,0,0,0,0
468,v1707,20170704,5820,5820,0,0,0,5820,5820,0,0,0,0,0
469,v1707,20170705,5820,5820,0,0,0,5820,5820,0,0,0,0,0
470,v1707,20170706,5820,5820,0,0,0,5820,5820,0,0,0,0,0
471,v1707,20170707,5820,5820,0,0,0,5820,5820,0,0,0,0,0
472,v1707,20170710,5820,5820,0,0,0,5820,5820,0,0,0,0,0
473,v1707,20170711,5820,5820,0,0,0,5820,5820,0,0,0,0,0
474,v1707,20170712,5820,5820,0,0,0,5820,5820,0,0,0,0,0
475,v1707,20170713,5820,5820,0,0,0,5820,5820,0,0,0,0,0
476,v1707,20170714,5820,5820,0,0,0,5820,5820,0,0,0,0,0
477,v1708,20170103,6345,6345,0,0,0,6190,6190,-155,-155,0,0,2
478,v1708,20170104,6190,6190,0,0,0,6210,6210,20,20,0,0,2
479,v1708,20170105,6210,6210,0,0,0,6280,6280,70,70,0,0,2
480,v1708,20170106,6280,6280,0,0,0,6265,6265,-15,-15,0,0,2
481,v1708,20170109,6265,6265,0,0,0,6390,6390,125,125,0,0,2
482,v1708,20170110,6390,6390,0,0,0,6575,6575,185,185,0,0,2
483,v1708,20170111,6575,6575,0,0,0,6610,6610,35,35,0,0,2
484,v1708,20170112,6610,6610,0,0,0,6370,6370,-240,-240,0,0,2
485,v1708,20170113,6370,6370,0,0,0,6540,6540,170,170,0,0,2
486,v1708,20170116,6540,6540,0,0,0,6675,6675,135,135,0,0,2
487,v1708,20170117,6675,6675,0,0,0,6555,6555,-120,-120,0,0,2
488,v1708,20170118,6555,6555,0,0,0,6525,6525,-30,-30,0,0,2
489,v1708,20170119,6525,6525,0,0,0,6585,6585,60,60,0,0,2
490,v1708,20170120,6585,6585,0,0,0,6625,6625,40,40,0,0,2
491,v1708,20170123,6625,6625,0,0,0,6635,6635,10,10,0,0,2
492,v1708,20170124,6635,6635,0,0,0,6595,6595,-40,-40,0,0,2
493,v1708,20170125,6595,6595,0,0,0,6620,6620,25,25,0,0,2
494,v1708,20170126,6620,6620,0,0,0,6620,6620,0,0,0,0,2
495,v1708,20170203,6620,6620,0,0,0,6845,6845,225,225,0,0,2
496,v1708,20170206,6845,6845,0,0,0,6885,6885,40,40,0,0,2
497,v1708,20170207,6885,6885,0,0,0,6925,6925,40,40,0,0,2
498,v1708,20170208,6925,6925,0,0,0,6870,6870,-55,-55,0,0,2
499,v1708,20170209,6870,6870,0,0,0,6900,6900,30,30,0,0,2
500,v1708,20170210,6900,6900,0,0,0,6930,6930,30,30,0,0,2
501,v1708,20170213,6930,6930,0,0,0,7030,7030,100,100,0,0,2
502,v1708,20170214,7030,7030,0,0,0,7020,7020,-10,-10,0,0,2
503,v1708,20170215,7020,7020,0,0,0,6910,6910,-110,-110,0,0,2
504,v1708,20170216,6910,6910,0,0,0,6825,6825,-85,-85,0,0,2
505,v1708,20170217,6825,6825,0,0,0,6780,6780,-45,-45,0,0,2
506,v1708,20170220,6780,6780,0,0,0,6790,6790,10,10,0,0,2
507,v1708,20170221,6790,6790,0,0,0,6855,6855,65,65,0,0,2
508,v1708,20170222,6855,6855,0,0,0,6745,6745,-110,-110,0,0,2
509,v1708,20170223,6745,6745,0,0,0,6645,6645,-100,-100,0,0,2
510,v1708,20170224,6645,6645,0,0,0,6495,6495,-150,-150,0,0,2
511,v1708,20170227,6495,6495,0,0,0,6615,6615,120,120,0,0,2
512,v1708,20170228,6615,6615,0,0,0,6575,6575,-40,-40,0,0,2
513,v1708,20170301,6575,6575,0,0,0,6535,6535,-40,-40,0,0,2
514,v1708,20170302,6535,6535,6360,6360,6360,6360,6360,-175,-175,2,63600,4
515,v1708,20170303,6360,6360,0,0,0,6460,6460,100,100,0,0,4
516,v1708,20170306,6460,6460,6780,6780,6780,6780,6780,320,320,2,67800,2
517,v1708,20170307,6780,6780,0,0,0,6790,6790,10,10,0,0,2
518,v1708,20170308,6790,6790,0,0,0,6615,6615,-175,-175,0,0,2
519,v1708,20170309,6615,6615,0,0,0,6585,6585,-30,-30,0,0,2
520,v1708,20170310,6585,6585,0,0,0,6540,6540,-45,-45,0,0,2
521,v1708,20170313,6540,6540,0,0,0,6510,6510,-30,-30,0,0,2
522,v1708,20170314,6510,6510,0,0,0,6600,6600,90,90,0,0,2
523,v1708,20170315,6600,6600,0,0,0,6725,6725,125,125,0,0,2
524,v1708,20170316,6725,6725,0,0,0,6725,6725,0,0,0,0,2
525,v1708,20170317,6725,6725,0,0,0,6765,6765,40,40,0,0,2
526,v1708,20170320,6765,6765,0,0,0,6705,6705,-60,-60,0,0,2
527,v1708,20170321,6705,6705,0,0,0,6560,6560,-145,-145,0,0,2
528,v1708,20170322,6560,6560,0,0,0,6470,6470,-90,-90,0,0,2
529,v1708,20170323,6470,6470,6360,6360,6360,6360,6360,-110,-110,2,63600,2
530,v1708,20170324,6360,6360,0,0,0,6345,6345,-15,-15,0,0,2
531,v1708,20170327,6345,6345,0,0,0,6185,6185,-160,-160,0,0,2
532,v1708,20170328,6185,6185,0,0,0,6230,6230,45,45,0,0,2
533,v1708,20170329,6230,6230,0,0,0,6275,6275,45,45,0,0,2
534,v1708,20170330,6275,6275,0,0,0,6195,6195,-80,-80,0,0,2
535,v1708,20170331,6195,6195,0,0,0,6135,6135,-60,-60,0,0,2
536,v1708,20170405,6135,6135,0,0,0,6225,6225,90,90,0,0,2
537,v1708,20170406,6225,6225,0,0,0,6230,6230,5,5,0,0,2
538,v1708,20170407,6230,6230,0,0,0,6110,6110,-120,-120,0,0,2
539,v1708,20170410,6110,6110,0,0,0,6045,6045,-65,-65,0,0,2
540,v1708,20170411,6045,6045,0,0,0,6130,6130,85,85,0,0,2
541,v1708,20170412,6130,6130,0,0,0,6085,6085,-45,-45,0,0,2
542,v1708,20170413,6085,6085,0,0,0,5945,5945,-140,-140,0,0,2
543,v1708,20170414,5945,5945,0,0,0,5785,5785,-160,-160,0,0,2
544,v1708,20170417,5785,5785,0,0,0,5760,5760,-25,-25,0,0,2
545,v1708,20170418,5760,5760,0,0,0,5660,5660,-100,-100,0,0,2
546,v1708,20170419,5660,5660,0,0,0,5540,5540,-120,-120,0,0,2
547,v1708,20170420,5540,5540,0,0,0,5535,5535,-5,-5,0,0,2
548,v1708,20170421,5535,5535,0,0,0,5620,5620,85,85,0,0,2
549,v1708,20170424,5620,5620,0,0,0,5665,5665,45,45,0,0,2
550,v1708,20170425,5665,5665,0,0,0,5640,5640,-25,-25,0,0,2
551,v1708,20170426,5640,5640,0,0,0,5610,5610,-30,-30,0,0,2
552,v1708,20170427,5610,5610,0,0,0,5660,5660,50,50,0,0,2
553,v1708,20170428,5660,5660,0,0,0,5840,5840,180,180,0,0,2
554,v1708,20170502,5840,5840,0,0,0,5835,5835,-5,-5,0,0,2
555,v1708,20170503,5835,5835,0,0,0,5855,5855,20,20,0,0,2
556,v1708,20170504,5855,5855,0,0,0,5630,5630,-225,-225,0,0,2
557,v1708,20170505,5630,5630,0,0,0,5600,5600,-30,-30,0,0,2
558,v1708,20170508,5600,5600,0,0,0,5645,5645,45,45,0,0,2
559,v1708,20170509,5645,5645,0,0,0,5705,5705,60,60,0,0,2
560,v1708,20170510,5705,5705,0,0,0,5780,5780,75,75,0,0,2
561,v1708,20170511,5780,5780,0,0,0,5730,5730,-50,-50,0,0,2
562,v1708,20170512,5730,5730,0,0,0,5690,5690,-40,-40,0,0,2
563,v1708,20170515,5690,5690,0,0,0,5770,5770,80,80,0,0,2
564,v1708,20170516,5770,5770,0,0,0,5770,5770,0,0,0,0,2
565,v1708,20170517,5770,5770,0,0,0,5770,5770,0,0,0,0,2
566,v1708,20170518,5770,5770,0,0,0,5770,5770,0,0,0,0,2
567,v1708,20170519,5770,5770,0,0,0,5770,5770,0,0,0,0,2
568,v1708,20170522,5770,5770,0,0,0,5770,5770,0,0,0,0,2
569,v1708,20170523,5770,5770,0,0,0,5770,5770,0,0,0,0,2
570,v1708,20170524,5770,5770,0,0,0,5770,5770,0,0,0,0,2
571,v1708,20170525,5770,5770,0,0,0,5770,5770,0,0,0,0,2
572,v1708,20170526,5770,5770,0,0,0,5770,5770,0,0,0,0,2
573,v1708,20170531,5770,5770,0,0,0,5825,5825,55,55,0,0,2
574,v1708,20170601,5825,5825,0,0,0,5825,5825,0,0,0,0,2
575,v1708,20170602,5825,5825,0,0,0,5825,5825,0,0,0,0,2
576,v1708,20170605,5825,5825,0,0,0,5825,5825,0,0,0,0,2
577,v1708,20170606,5825,5825,0,0,0,5825,5825,0,0,0,0,2
578,v1708,20170607,5825,5825,0,0,0,5825,5825,0,0,0,0,2
579,v1708,20170608,5825,5825,0,0,0,5825,5825,0,0,0,0,2
580,v1708,20170609,5825,5825,0,0,0,5825,5825,0,0,0,0,2
581,v1708,20170612,5825,5825,0,0,0,5825,5825,0,0,0,0,2
582,v1708,20170613,5825,5825,0,0,0,5825,5825,0,0,0,0,2
583,v1708,20170614,5825,5825,0,0,0,5825,5825,0,0,0,0,2
584,v1708,20170615,5825,5825,0,0,0,5825,5825,0,0,0,0,2
585,v1708,20170616,5825,5825,0,0,0,5825,5825,0,0,0,0,2
586,v1708,20170619,5825,5825,0,0,0,5825,5825,0,0,0,0,2
587,v1708,20170620,5825,5825,0,0,0,5825,5825,0,0,0,0,2
588,v1708,20170621,5825,5825,0,0,0,5825,5825,0,0,0,0,2
589,v1708,20170622,5825,5825,0,0,0,5825,5825,0,0,0,0,2
590,v1708,20170623,5825,5825,0,0,0,5825,5825,0,0,0,0,2
591,v1708,20170626,5825,5825,0,0,0,5825,5825,0,0,0,0,2
592,v1708,20170627,5825,5825,0,0,0,5825,5825,0,0,0,0,2
593,v1708,20170628,5825,5825,0,0,0,5825,5825,0,0,0,0,2
594,v1708,20170629,5825,5825,0,0,0,5825,5825,0,0,0,0,2
595,v1708,20170630,5825,5825,0,0,0,5825,5825,0,0,0,0,2
596,v1708,20170703,5825,5825,0,0,0,6115,6115,290,290,0,0,2
597,v1708,20170704,6115,6115,0,0,0,6115,6115,0,0,0,0,2
598,v1708,20170705,6115,6115,0,0,0,6115,6115,0,0,0,0,2
599,v1708,20170706,6115,6115,0,0,0,6115,6115,0,0,0,0,2
600,v1708,20170707,6115,6115,0,0,0,6115,6115,0,0,0,0,2
601,v1708,20170710,6115,6115,6420,6420,6420,6420,6420,305,305,44,1412400,22
602,v1708,20170711,6420,6420,6885,6885,6600,6600,6860,180,440,24,823350,2
603,v1708,20170712,6600,6860,0,0,0,6860,6860,0,0,0,0,2
604,v1708,20170713,6860,6860,0,0,0,6860,6860,0,0,0,0,2
605,v1708,20170714,6860,6860,0,0,0,6860,6860,0,0,0,0,2
606,v1708,20170717,6860,6860,0,0,0,6860,6860,0,0,0,0,2
607,v1708,20170718,6860,6860,0,0,0,6860,6860,0,0,0,0,2
608,v1708,20170719,6860,6860,0,0,0,6860,6860,0,0,0,0,2
609,v1708,20170720,6860,6860,0,0,0,6860,6860,0,0,0,0,2
610,v1708,20170721,6860,6860,0,0,0,6860,6860,0,0,0,0,2
611,v1708,20170724,6860,6860,0,0,0,6860,6860,0,0,0,0,2
612,v1708,20170725,6860,6860,0,0,0,6860,6860,0,0,0,0,2
613,v1708,20170726,6860,6860,0,0,0,6860,6860,0,0,0,0,2
614,v1708,20170727,6860,6860,7200,7200,7200,7200,7200,340,340,2,72000,0
615,v1708,20170728,7200,7200,0,0,0,7200,7200,0,0,0,0,0
616,v1708,20170731,7200,7200,0,0,0,7200,7200,0,0,0,0,0
617,v1708,20170801,7200,7200,0,0,0,7200,7200,0,0,0,0,0
618,v1708,20170802,7200,7200,0,0,0,7200,7200,0,0,0,0,0
619,v1708,20170803,7200,7200,0,0,0,7200,7200,0,0,0,0,0
620,v1708,20170804,7200,7200,0,0,0,7200,7200,0,0,0,0,0
621,v1708,20170807,7200,7200,0,0,0,7200,7200,0,0,0,0,0
622,v1708,20170808,7200,7200,0,0,0,7200,7200,0,0,0,0,0
623,v1708,20170809,7200,7200,0,0,0,7200,7200,0,0,0,0,0
624,v1708,20170810,7200,7200,0,0,0,7200,7200,0,0,0,0,0
625,v1708,20170811,7200,7200,0,0,0,7200,7200,0,0,0,0,0
626,v1708,20170814,7200,7200,0,0,0,7200,7200,0,0,0,0,0
627,v1709,20170103,6185,6195,6100,6215,5965,5965,6030,-230,-165,10950,330200950,22456
628,v1709,20170104,5965,6030,5935,6090,5910,6080,6020,50,-10,10974,330417700,23762
629,v1709,20170105,6080,6020,6100,6150,6055,6075,6095,55,75,3134,95568050,23972
630,v1709,20170106,6075,6095,6085,6130,6030,6100,6085,5,-10,4094,124562200,24380
631,v1709,20170109,6100,6085,6100,6310,6060,6310,6205,225,120,8468,262917300,22754
632,v1709,20170110,6310,6205,6340,6385,6265,6345,6330,140,125,4726,149578200,22396
633,v1709,20170111,6345,6330,6365,6460,6290,6360,6370,30,40,5656,180143600,22628
634,v1709,20170112,6360,6370,6420,6440,6355,6405,6390,35,20,4810,153784150,22496
635,v1709,20170113,6405,6390,6440,6480,6400,6450,6440,60,50,5246,168965450,22194
636,v1709,20170116,6450,6440,6520,6635,6520,6575,6585,135,145,9780,322234450,19482
637,v1709,20170117,6575,6585,6595,6595,6410,6450,6500,-135,-85,5616,182640800,19230
638,v1709,20170118,6450,6500,6465,6505,6425,6505,6455,5,-45,1886,60903300,19308
639,v1709,20170119,6505,6455,6505,6595,6410,6580,6515,125,60,3896,127009550,18240
640,v1709,20170120,6580,6515,6555,6600,6525,6565,6555,50,40,2344,76852650,18280
641,v1709,20170123,6565,6555,6575,6620,6540,6560,6585,5,30,3472,114368900,18234
642,v1709,20170124,6560,6585,6570,6595,6490,6520,6545,-65,-40,2310,75629000,18088
643,v1709,20170125,6520,6545,6525,6595,6470,6570,6545,25,0,2390,78269300,17298
644,v1709,20170126,6570,6545,6580,6605,6525,6600,6565,55,20,1970,64694300,17562
645,v1709,20170203,6600,6565,6620,6850,6620,6790,6760,225,195,7818,264416600,17628
646,v1709,20170206,6790,6760,6875,6875,6745,6765,6770,5,10,10126,342921650,19644
647,v1709,20170207,6765,6770,6740,6830,6740,6780,6785,10,15,5662,192132300,20362
648,v1709,20170208,6780,6785,6780,6815,6740,6775,6790,-10,5,10576,359180450,21414
649,v1709,20170209,6775,6790,6790,6815,6775,6800,6800,10,10,4060,138042050,22338
650,v1709,20170210,6800,6800,6805,6865,6745,6835,6790,35,-10,7746,263122950,23922
651,v1709,20170213,6835,6790,6885,6935,6865,6910,6905,120,115,5912,204227150,25382
652,v1709,20170214,6910,6905,6895,6955,6870,6925,6925,20,20,4732,163858400,24668
653,v1709,20170215,6925,6925,6870,6920,6720,6755,6825,-170,-100,9312,317925300,23710
654,v1709,20170216,6755,6825,6700,6805,6675,6735,6735,-90,-90,8688,292741350,22964
655,v1709,20170217,6735,6735,6745,6770,6655,6685,6705,-50,-30,7098,238043600,21712
656,v1709,20170220,6685,6705,6705,6760,6660,6720,6720,15,15,3696,124212800,21422
657,v1709,20170221,6720,6720,6725,6765,6555,6560,6645,-160,-75,8860,294389950,21526
658,v1709,20170222,6560,6645,6550,6605,6510,6520,6550,-125,-95,6574,215380350,21322
659,v1709,20170223,6520,6550,6550,6555,6380,6420,6440,-130,-110,14350,462089700,19526
660,v1709,20170224,6420,6440,6390,6485,6330,6485,6415,45,-25,4954,158936650,19404
661,v1709,20170227,6485,6415,6475,6590,6475,6580,6555,165,140,5700,186869700,20372
662,v1709,20170228,6580,6555,6555,6605,6475,6485,6550,-70,-5,7620,249730850,21352
663,v1709,20170301,6485,6550,6530,6535,6440,6485,6485,-65,-65,5318,172506200,21428
664,v1709,20170302,6485,6485,6465,6545,6445,6525,6490,40,5,4880,158406600,21600
665,v1709,20170303,6525,6490,6480,6665,6455,6660,6605,170,115,11306,373443300,20984
666,v1709,20170306,6660,6605,6660,6780,6660,6730,6730,125,125,11720,394472000,23166
667,v1709,20170307,6730,6730,6750,6795,6695,6740,6745,10,15,7406,249773000,23428
668,v1709,20170308,6740,6745,6695,6695,6445,6450,6555,-295,-190,16512,541449550,23284
669,v1709,20170309,6450,6555,6385,6575,6310,6505,6465,-50,-90,18880,610468900,20994
670,v1709,20170310,6505,6465,6480,6550,6430,6455,6465,-10,0,15134,489326850,20702
671,v1709,20170313,6455,6465,6405,6495,6340,6490,6420,25,-45,15352,493039850,22084
672,v1709,20170314,6490,6420,6500,6625,6455,6615,6530,195,110,14844,484688100,22912
673,v1709,20170315,6615,6530,6665,6710,6610,6630,6660,100,130,21162,705001800,23900
674,v1709,20170316,6630,6660,6665,6740,6620,6730,6670,70,10,19450,648771950,26418
675,v1709,20170317,6730,6670,6725,6760,6665,6710,6705,40,35,14846,497810600,26574
676,v1709,20170320,6710,6705,6680,6720,6610,6650,6655,-55,-50,16988,565686300,25856
677,v1709,20170321,6650,6655,6635,6640,6480,6490,6540,-165,-115,29288,958247500,26534
678,v1709,20170322,6490,6540,6460,6470,6380,6380,6420,-160,-120,23414,751702550,30312
679,v1709,20170323,6380,6420,6425,6505,6290,6370,6395,-50,-25,28388,908342850,34814
680,v1709,20170324,6370,6395,6390,6405,6320,6325,6360,-70,-35,18268,581127800,36356
681,v1709,20170327,6325,6360,6320,6320,6120,6165,6190,-195,-170,35736,1106576800,44298
682,v1709,20170328,6165,6190,6190,6230,6180,6185,6195,-5,5,17108,530314950,44074
683,v1709,20170329,6185,6195,6250,6300,6225,6265,6260,70,65,23350,730881500,47806
684,v1709,20170330,6265,6260,6300,6325,6140,6170,6220,-90,-40,28954,901092250,46296
685,v1709,20170331,6170,6220,6220,6220,6090,6115,6125,-105,-95,43324,1327790600,59662
686,v1709,20170405,6115,6125,6150,6275,6070,6240,6190,115,65,39756,1231117600,58834
687,v1709,20170406,6240,6190,6205,6245,6180,6210,6215,20,25,21718,675041600,60676
688,v1709,20170407,6210,6215,6130,6225,6005,6035,6105,-180,-110,88478,2701278800,74378
689,v1709,20170410,6035,6105,6075,6075,5940,5975,5995,-130,-110,93738,2810119800,88658
690,v1709,20170411,5975,5995,5970,6110,5935,5970,6020,-25,25,133668,4024852500,100920
691,v1709,20170412,5970,6020,5965,5990,5895,5900,5935,-120,-85,125396,3721509150,114632
692,v1709,20170413,5900,5935,5920,5920,5760,5785,5815,-150,-120,229042,6662967650,140362
693,v1709,20170414,5785,5815,5795,5820,5650,5665,5700,-150,-115,173058,4936337400,153966
694,v1709,20170417,5665,5700,5700,5765,5605,5640,5685,-60,-15,154844,4405257100,160076
695,v1709,20170418,5640,5685,5620,5670,5530,5540,5585,-145,-100,147766,4129143900,163968
696,v1709,20170419,5540,5585,5520,5555,5455,5530,5495,-55,-90,190394,5235199100,170016
697,v1709,20170420,5530,5495,5505,5615,5480,5610,5530,115,35,190892,5279034250,170344
698,v1709,20170421,5610,5530,5615,5745,5615,5660,5685,130,155,206876,5884974000,145532
699,v1709,20170424,5660,5685,5640,5670,5505,5600,5575,-85,-110,179946,5018731550,144630
700,v1709,20170425,5600,5575,5590,5660,5530,5535,5595,-40,20,117900,3300144200,143180
701,v1709,20170426,5535,5595,5545,5645,5505,5560,5575,-35,-20,194886,5435260150,145486
702,v1709,20170427,5560,5575,5590,5780,5570,5770,5650,195,75,187372,5297058750,143360
703,v1709,20170428,5770,5650,5795,5920,5755,5880,5845,230,195,288076,8423183150,141014
704,v1709,20170502,5880,5845,5880,5895,5815,5835,5850,-10,5,138460,4053234000,130788
705,v1709,20170503,5835,5850,5830,5905,5775,5775,5840,-75,-10,184516,5387895250,131418
706,v1709,20170504,5775,5840,5660,5735,5560,5605,5655,-235,-185,233878,6618654400,129672
707,v1709,20170505,5605,5655,5570,5645,5535,5615,5600,-40,-55,154060,4316931950,129836
708,v1709,20170508,5615,5600,5690,5755,5620,5650,5675,50,75,167326,4750589400,129498
709,v1709,20170509,5650,5675,5675,5825,5660,5810,5760,135,85,229802,6620075850,137188
710,v1709,20170510,5810,5760,5820,5875,5640,5695,5750,-65,-10,309988,8914273600,129384
711,v1709,20170511,5695,5750,5715,5860,5665,5830,5765,80,15,269462,7773584300,125192
712,v1709,20170512,5830,5765,5795,5810,5705,5725,5755,-40,-10,180886,5206901750,116106
713,v1709,20170515,5725,5755,5750,5985,5750,5950,5885,195,130,293220,8634452350,127962
714,v1709,20170516,5950,5885,5955,5985,5900,5980,5940,95,55,169816,5047581950,125670
715,v1709,20170517,5980,5940,5970,5995,5890,5960,5940,20,0,181114,5382443200,121744
716,v1709,20170518,5960,5940,5935,6145,5885,6115,6025,175,85,342466,10321484850,145208
717,v1709,20170519,6115,6025,6160,6245,6110,6210,6165,185,140,256756,7918644100,143326
718,v1709,20170522,6210,6165,6245,6295,6135,6220,6220,55,55,253272,7877643050,135324
719,v1709,20170523,6220,6220,6220,6255,6140,6155,6190,-65,-30,206986,6411264200,136110
720,v1709,20170524,6155,6190,6160,6185,5945,6035,6050,-155,-140,310188,9389468350,118958
721,v1709,20170525,6035,6050,6040,6120,5975,6040,6050,-10,0,244294,7394937650,118586
722,v1709,20170526,6040,6050,5980,6000,5865,5955,5935,-95,-115,203294,6032983500,111786
723,v1709,20170531,5955,5935,5955,6060,5915,5935,5985,0,50,269396,8068392450,119522
724,v1709,20170601,5935,5985,5950,6180,5925,6150,6085,165,100,370310,11268194050,147620
725,v1709,20170602,6150,6085,6130,6145,5870,5875,6030,-210,-55,320560,9666311950,121356
726,v1709,20170605,5875,6030,5925,5935,5795,5845,5855,-185,-175,269562,7895471950,116292
727,v1709,20170606,5845,5855,5860,5905,5760,5845,5840,-10,-15,209696,6127801200,120732
728,v1709,20170607,5845,5840,5870,5920,5815,5860,5865,20,25,188224,5522761450,118852
729,v1709,20170608,5860,5865,5815,5935,5795,5875,5850,10,-15,205668,6019298550,114600
730,v1709,20170609,5875,5850,5875,5920,5855,5880,5880,30,30,144168,4239821400,112556
731,v1709,20170612,5880,5880,5920,6095,5910,6070,6030,190,150,235272,7096262750,127468
732,v1709,20170613,6070,6030,6070,6080,5965,5995,6025,-35,-5,192160,5793163450,123928
733,v1709,20170614,5995,6025,6010,6030,5900,5975,5955,-50,-70,262810,7826290050,119690
734,v1709,20170615,5975,5955,5925,5995,5850,5890,5935,-65,-20,283718,8425043800,125650
735,v1709,20170616,5890,5935,5910,5975,5855,5880,5910,-55,-25,207106,6122341950,129406
736,v1709,20170619,5880,5910,5885,5920,5805,5825,5855,-85,-55,256514,7512620750,139466
737,v1709,20170620,5825,5855,5810,5835,5730,5825,5785,-30,-70,207714,6010446050,138914
738,v1709,20170621,5825,5785,5785,5930,5785,5900,5875,115,90,275468,8098435650,132164
739,v1709,20170622,5900,5875,5920,5940,5865,5900,5895,25,20,201328,5937052200,128848
740,v1709,20170623,5900,5895,5915,6090,5915,6060,6020,165,125,269012,8098535250,150104
741,v1709,20170626,6060,6020,6075,6145,6040,6145,6100,125,80,179588,5479308250,153720
742,v1709,20170627,6145,6100,6130,6200,6105,6195,6155,95,55,168426,5185481700,172288
743,v1709,20170628,6195,6155,6200,6220,6110,6175,6160,20,5,161200,4966891000,169020
744,v1709,20170629,6175,6160,6195,6375,6155,6330,6280,170,120,280272,8803861750,190156
745,v1709,20170630,6330,6280,6320,6395,6310,6370,6355,90,75,203372,6464164350,198034
746,v1709,20170703,6370,6355,6410,6455,6355,6390,6400,35,45,171148,5479113500,193882
747,v1709,20170704,6390,6400,6390,6460,6275,6305,6350,-95,-50,300546,9548983000,186382
748,v1709,20170705,6305,6350,6350,6520,6340,6470,6455,120,105,328156,10596994400,209328
749,v1709,20170706,6470,6455,6430,6565,6415,6560,6480,105,25,220034,7133994700,218672
750,v1709,20170707,6560,6480,6520,6635,6520,6610,6570,130,90,204786,6727629400,217072
751,v1709,20170710,6610,6570,6600,6660,6560,6605,6605,35,35,182100,6014073150,215876
752,v1709,20170711,6605,6605,6635,6715,6575,6675,6645,70,40,299890,9969559600,213646
753,v1709,20170712,6675,6645,6705,6720,6555,6590,6615,-55,-30,236270,7820179500,206870
754,v1709,20170713,6590,6615,6590,6645,6510,6620,6590,5,-25,228950,7545313800,203782
755,v1709,20170714,6620,6590,6605,6645,6495,6555,6560,-35,-30,212850,6985182400,198992
756,v1709,20170717,6555,6560,6595,6630,6505,6545,6560,-15,0,251828,8263547850,189788
757,v1709,20170718,6545,6560,6560,6685,6480,6640,6595,80,35,346450,11430187000,199286
758,v1709,20170719,6640,6595,6665,6795,6660,6785,6740,190,145,236214,7964934350,212888
759,v1709,20170720,6785,6740,6760,7025,6725,6790,6900,50,160,498204,17188900000,193522
760,v1709,20170721,6790,6900,6720,6900,6700,6860,6775,-40,-125,335670,11378172450,186664
761,v1709,20170724,6860,6775,6790,6885,6755,6830,6820,55,45,235614,8039366100,181124
762,v1709,20170725,6830,6820,6855,6945,6845,6865,6880,45,60,212022,7297526400,181750
763,v1709,20170726,6865,6880,6900,6930,6750,6800,6805,-80,-75,272040,9262485100,169306
764,v1709,20170727,6800,6805,6825,6975,6790,6910,6875,105,70,298482,10265558450,189928
765,v1709,20170728,6910,6875,6910,6940,6805,6830,6865,-45,-10,273748,9403022200,176570
766,v1709,20170731,6830,6865,6850,6920,6700,6835,6795,-30,-70,270912,9205768650,164224
767,v1709,20170801,6835,6795,6850,6950,6810,6890,6875,95,80,213430,7340802250,166728
768,v1709,20170802,6890,6875,6880,7170,6870,7135,7060,260,185,457846,16169597400,196974
769,v1709,20170803,7135,7060,7140,7170,7065,7090,7105,30,45,193760,6887477300,179338
770,v1709,20170804,7090,7105,7100,7380,7100,7370,7295,265,190,274548,10018586700,183052
771,v1709,20170807,7370,7295,7395,7435,7100,7355,7285,60,-10,277496,10112733700,146292
772,v1709,20170808,7355,7285,7355,7515,7315,7465,7415,180,130,207832,7707325850,136596
773,v1709,20170809,7465,7415,7485,7545,7440,7540,7495,125,80,125966,4722695100,117626
774,v1709,20170810,7540,7495,7500,7645,7470,7635,7545,140,50,83796,3162013600,104544
775,v1709,20170811,7635,7545,7600,7665,7295,7360,7500,-185,-45,104542,3921162550,70920
776,v1709,20170814,7360,7500,7365,7460,7365,7380,7395,-120,-105,26874,994138550,63706
777,v1709,20170815,7380,7395,7360,7370,7175,7240,7250,-155,-145,34840,1262989000,52764
778,v1709,20170816,7240,7250,7215,7275,7130,7160,7190,-90,-60,21890,787233050,43748
779,v1709,20170817,7160,7190,7215,7380,7215,7265,7295,75,105,16824,613662300,39174
780,v1709,20170818,7265,7295,7250,7480,7235,7460,7405,165,110,13216,489351000,37346
781,v1709,20170821,7460,7405,7500,7520,7410,7495,7475,90,70,8720,325986450,34936
782,v1709,20170822,7495,7475,7500,7570,7425,7550,7490,75,15,9516,356598850,32070
783,v1709,20170823,7550,7490,7495,7495,7370,7420,7425,-70,-65,6672,247804150,29600
784,v1709,20170824,7420,7425,7475,7545,7460,7480,7495,55,70,4440,166498900,27976
785,v1709,20170825,7480,7495,7495,7600,7495,7570,7545,75,50,5482,206913550,25150
786,v1709,20170828,7570,7545,7505,7640,7435,7600,7575,55,30,4162,157707800,23536
787,v1709,20170829,7600,7575,7590,7680,7565,7620,7620,45,45,5992,228338000,21482
788,v1709,20170830,7620,7620,7595,7595,7500,7550,7540,-70,-80,6908,260449400,17484
789,v1709,20170831,7550,7540,7405,7600,7405,7585,7545,45,5,6192,233737650,12386
790,v1709,20170901,7585,7545,7700,7700,7095,7700,7580,155,35,970,36779450,11918
791,v1709,20170904,7700,7580,7800,7800,7510,7740,7625,160,45,974,37144850,11088
792,v1709,20170905,7740,7625,7505,7740,7505,7710,7695,85,70,290,11160900,10812
793,v1709,20170906,7710,7695,7750,7750,7730,7730,7740,35,45,34,1315800,10784
794,v1709,20170907,7730,7740,7705,7705,7600,7600,7655,-140,-85,40,1531950,10744
795,v1709,20170908,7600,7655,7625,7690,7580,7585,7625,-70,-30,160,6101900,10598
796,v1709,20170911,7585,7625,7435,7455,7435,7455,7435,-170,-190,52,1933800,10602
797,v1709,20170912,7455,7435,7460,7555,7460,7555,7505,120,70,8,300300,10602
798,v1709,20170913,7555,7505,7200,7215,7200,7215,7205,-290,-300,8,288300,10602
799,v1709,20170914,7215,7205,7210,7550,7210,7550,7610,345,405,68,2574800,0
800,v1710,20170103,6235,6235,0,0,0,6070,6070,-165,-165,0,0,0
801,v1710,20170104,6070,6070,0,0,0,6060,6060,-10,-10,0,0,0
802,v1710,20170105,6060,6060,0,0,0,6135,6135,75,75,0,0,0
803,v1710,20170106,6135,6135,0,0,0,6125,6125,-10,-10,0,0,0
804,v1710,20170109,6125,6125,0,0,0,6245,6245,120,120,0,0,0
805,v1710,20170110,6245,6245,0,0,0,6370,6370,125,125,0,0,0
806,v1710,20170111,6370,6370,0,0,0,6410,6410,40,40,0,0,0
807,v1710,20170112,6410,6410,0,0,0,6430,6430,20,20,0,0,0
808,v1710,20170113,6430,6430,0,0,0,6480,6480,50,50,0,0,0
809,v1710,20170116,6480,6480,0,0,0,6625,6625,145,145,0,0,0
810,v1710,20170117,6625,6625,0,0,0,6540,6540,-85,-85,0,0,0
811,v1710,20170118,6540,6540,0,0,0,6495,6495,-45,-45,0,0,0
812,v1710,20170119,6495,6495,0,0,0,6555,6555,60,60,0,0,0
813,v1710,20170120,6555,6555,0,0,0,6595,6595,40,40,0,0,0
814,v1710,20170123,6595,6595,0,0,0,6625,6625,30,30,0,0,0
815,v1710,20170124,6625,6625,0,0,0,6585,6585,-40,-40,0,0,0
816,v1710,20170125,6585,6585,0,0,0,6585,6585,0,0,0,0,0
817,v1710,20170126,6585,6585,0,0,0,6605,6605,20,20,0,0,0
818,v1710,20170203,6605,6605,0,0,0,6800,6800,195,195,0,0,0
819,v1710,20170206,6800,6800,0,0,0,6810,6810,10,10,0,0,0
820,v1710,20170207,6810,6810,0,0,0,6825,6825,15,15,0,0,0
821,v1710,20170208,6825,6825,6925,6925,6925,6925,6925,100,100,2,69250,2
822,v1710,20170209,6925,6925,0,0,0,6935,6935,10,10,0,0,2
823,v1710,20170210,6935,6935,0,0,0,6925,6925,-10,-10,0,0,2
824,v1710,20170213,6925,6925,0,0,0,7040,7040,115,115,0,0,2
825,v1710,20170214,7040,7040,0,0,0,7060,7060,20,20,0,0,2
826,v1710,20170215,7060,7060,0,0,0,6960,6960,-100,-100,0,0,2
827,v1710,20170216,6960,6960,0,0,0,6870,6870,-90,-90,0,0,2
828,v1710,20170217,6870,6870,0,0,0,6840,6840,-30,-30,0,0,2
829,v1710,20170220,6840,6840,0,0,0,6855,6855,15,15,0,0,2
830,v1710,20170221,6855,6855,0,0,0,6780,6780,-75,-75,0,0,2
831,v1710,20170222,6780,6780,0,0,0,6685,6685,-95,-95,0,0,2
832,v1710,20170223,6685,6685,0,0,0,6575,6575,-110,-110,0,0,2
833,v1710,20170224,6575,6575,0,0,0,6550,6550,-25,-25,0,0,2
834,v1710,20170227,6550,6550,0,0,0,6690,6690,140,140,0,0,2
835,v1710,20170228,6690,6690,0,0,0,6685,6685,-5,-5,0,0,2
836,v1710,20170301,6685,6685,0,0,0,6620,6620,-65,-65,0,0,2
837,v1710,20170302,6620,6620,0,0,0,6625,6625,5,5,0,0,2
838,v1710,20170303,6625,6625,0,0,0,6740,6740,115,115,0,0,2
839,v1710,20170306,6740,6740,0,0,0,6865,6865,125,125,0,0,2
840,v1710,20170307,6865,6865,0,0,0,6880,6880,15,15,0,0,2
841,v1710,20170308,6880,6880,0,0,0,6690,6690,-190,-190,0,0,2
842,v1710,20170309,6690,6690,0,0,0,6600,6600,-90,-90,0,0,2
843,v1710,20170310,6600,6600,0,0,0,6600,6600,0,0,0,0,2
844,v1710,20170313,6600,6600,0,0,0,6555,6555,-45,-45,0,0,2
845,v1710,20170314,6555,6555,0,0,0,6665,6665,110,110,0,0,2
846,v1710,20170315,6665,6665,0,0,0,6795,6795,130,130,0,0,2
847,v1710,20170316,6795,6795,0,0,0,6805,6805,10,10,0,0,2
848,v1710,20170317,6805,6805,0,0,0,6840,6840,35,35,0,0,2
849,v1710,20170320,6840,6840,0,0,0,6790,6790,-50,-50,0,0,2
850,v1710,20170321,6790,6790,0,0,0,6675,6675,-115,-115,0,0,2
851,v1710,20170322,6675,6675,0,0,0,6555,6555,-120,-120,0,0,2
852,v1710,20170323,6555,6555,0,0,0,6530,6530,-25,-25,0,0,2
853,v1710,20170324,6530,6530,0,0,0,6495,6495,-35,-35,0,0,2
854,v1710,20170327,6495,6495,0,0,0,6325,6325,-170,-170,0,0,2
855,v1710,20170328,6325,6325,0,0,0,6330,6330,5,5,0,0,2
856,v1710,20170329,6330,6330,0,0,0,6395,6395,65,65,0,0,2
857,v1710,20170330,6395,6395,0,0,0,6355,6355,-40,-40,0,0,2
858,v1710,20170331,6355,6355,0,0,0,6260,6260,-95,-95,0,0,2
859,v1710,20170405,6260,6260,0,0,0,6325,6325,65,65,0,0,2
860,v1710,20170406,6325,6325,0,0,0,6350,6350,25,25,0,0,2
861,v1710,20170407,6350,6350,0,0,0,6240,6240,-110,-110,0,0,2
862,v1710,20170410,6240,6240,0,0,0,6130,6130,-110,-110,0,0,2
863,v1710,20170411,6130,6130,0,0,0,6155,6155,25,25,0,0,2
864,v1710,20170412,6155,6155,0,0,0,6070,6070,-85,-85,0,0,2
865,v1710,20170413,6070,6070,0,0,0,5950,5950,-120,-120,0,0,2
866,v1710,20170414,5950,5950,0,0,0,5835,5835,-115,-115,0,0,2
867,v1710,20170417,5835,5835,0,0,0,5820,5820,-15,-15,0,0,2
868,v1710,20170418,5820,5820,0,0,0,5720,5720,-100,-100,0,0,2
869,v1710,20170419,5720,5720,0,0,0,5630,5630,-90,-90,0,0,2
870,v1710,20170420,5630,5630,0,0,0,5665,5665,35,35,0,0,2
871,v1710,20170421,5665,5665,0,0,0,5820,5820,155,155,0,0,2
872,v1710,20170424,5820,5820,0,0,0,5710,5710,-110,-110,0,0,2
873,v1710,20170425,5710,5710,0,0,0,5730,5730,20,20,0,0,2
874,v1710,20170426,5730,5730,0,0,0,5710,5710,-20,-20,0,0,2
875,v1710,20170427,5710,5710,0,0,0,5785,5785,75,75,0,0,2
876,v1710,20170428,5785,5785,0,0,0,5980,5980,195,195,0,0,2
877,v1710,20170502,5980,5980,0,0,0,5985,5985,5,5,0,0,2
878,v1710,20170503,5985,5985,0,0,0,5975,5975,-10,-10,0,0,2
879,v1710,20170504,5975,5975,0,0,0,5790,5790,-185,-185,0,0,2
880,v1710,20170505,5790,5790,0,0,0,5735,5735,-55,-55,0,0,2
881,v1710,20170508,5735,5735,0,0,0,5810,5810,75,75,0,0,2
882,v1710,20170509,5810,5810,5845,5845,5675,5800,5780,-10,-30,16,462700,2
883,v1710,20170510,5800,5780,0,0,0,5770,5770,-10,-10,0,0,2
884,v1710,20170511,5770,5770,0,0,0,5785,5785,15,15,0,0,2
885,v1710,20170512,5785,5785,0,0,0,5775,5775,-10,-10,0,0,2
886,v1710,20170515,5775,5775,0,0,0,5905,5905,130,130,0,0,2
887,v1710,20170516,5905,5905,0,0,0,5960,5960,55,55,0,0,2
888,v1710,20170517,5960,5960,0,0,0,5960,5960,0,0,0,0,2
889,v1710,20170518,5960,5960,0,0,0,6045,6045,85,85,0,0,2
890,v1710,20170519,6045,6045,0,0,0,6185,6185,140,140,0,0,2
891,v1710,20170522,6185,6185,0,0,0,6240,6240,55,55,0,0,2
892,v1710,20170523,6240,6240,0,0,0,6210,6210,-30,-30,0,0,2
893,v1710,20170524,6210,6210,0,0,0,6070,6070,-140,-140,0,0,2
894,v1710,20170525,6070,6070,0,0,0,6070,6070,0,0,0,0,2
895,v1710,20170526,6070,6070,0,0,0,5955,5955,-115,-115,0,0,2
896,v1710,20170531,5955,5955,0,0,0,6005,6005,50,50,0,0,2
897,v1710,20170601,6005,6005,0,0,0,6105,6105,100,100,0,0,2
898,v1710,20170602,6105,6105,0,0,0,6050,6050,-55,-55,0,0,2
899,v1710,20170605,6050,6050,0,0,0,5875,5875,-175,-175,0,0,2
900,v1710,20170606,5875,5875,0,0,0,5860,5860,-15,-15,0,0,2
901,v1710,20170607,5860,5860,0,0,0,5885,5885,25,25,0,0,2
902,v1710,20170608,5885,5885,0,0,0,5870,5870,-15,-15,0,0,2
903,v1710,20170609,5870,5870,0,0,0,5900,5900,30,30,0,0,2
904,v1710,20170612,5900,5900,0,0,0,6050,6050,150,150,0,0,2
905,v1710,20170613,6050,6050,0,0,0,6045,6045,-5,-5,0,0,2
906,v1710,20170614,6045,6045,0,0,0,5975,5975,-70,-70,0,0,2
907,v1710,20170615,5975,5975,0,0,0,5955,5955,-20,-20,0,0,2
908,v1710,20170616,5955,5955,0,0,0,5930,5930,-25,-25,0,0,2
909,v1710,20170619,5930,5930,0,0,0,5875,5875,-55,-55,0,0,2
910,v1710,20170620,5875,5875,0,0,0,5805,5805,-70,-70,0,0,2
911,v1710,20170621,5805,5805,0,0,0,5895,5895,90,90,0,0,2
912,v1710,20170622,5895,5895,0,0,0,5915,5915,20,20,0,0,2
913,v1710,20170623,5915,5915,5885,6075,5885,6075,5980,160,65,4,119600,2
914,v1710,20170626,6075,5980,0,0,0,6055,6055,75,75,0,0,2
915,v1710,20170627,6055,6055,0,0,0,6105,6105,50,50,0,0,2
916,v1710,20170628,6105,6105,0,0,0,6105,6105,0,0,0,0,2
917,v1710,20170629,6105,6105,6335,6335,6225,6225,6280,120,175,4,125600,2
918,v1710,20170630,6225,6280,6485,6485,6335,6335,6410,55,130,4,128200,2
919,v1710,20170703,6335,6410,0,0,0,6410,6410,0,0,0,0,2
920,v1710,20170704,6410,6410,0,0,0,6360,6360,-50,-50,0,0,2
921,v1710,20170705,6360,6360,0,0,0,6465,6465,105,105,0,0,2
922,v1710,20170706,6465,6465,6440,6570,6440,6570,6505,105,40,4,130100,2
923,v1710,20170707,6570,6505,0,0,0,6595,6595,90,90,0,0,2
924,v1710,20170710,6595,6595,0,0,0,6630,6630,35,35,0,0,2
925,v1710,20170711,6630,6630,6740,6740,6605,6605,6670,-25,40,4,133450,2
926,v1710,20170712,6605,6670,0,0,0,6640,6640,-30,-30,0,0,2
927,v1710,20170713,6640,6640,0,0,0,6615,6615,-25,-25,0,0,2
928,v1710,20170714,6615,6615,0,0,0,6585,6585,-30,-30,0,0,2
929,v1710,20170717,6585,6585,0,0,0,6585,6585,0,0,0,0,2
930,v1710,20170718,6585,6585,0,0,0,6620,6620,35,35,0,0,2
931,v1710,20170719,6620,6620,0,0,0,6765,6765,145,145,0,0,2
932,v1710,20170720,6765,6765,0,0,0,6925,6925,160,160,0,0,2
933,v1710,20170721,6925,6925,0,0,0,6800,6800,-125,-125,0,0,2
934,v1710,20170724,6800,6800,0,0,0,6845,6845,45,45,0,0,2
935,v1710,20170725,6845,6845,6765,6765,6765,6765,6765,-80,-80,2,67650,0
936,v1710,20170726,6765,6765,6755,6875,6755,6875,6815,110,50,8,272600,2
937,v1710,20170727,6875,6815,6845,6940,6845,6940,6865,125,50,8,274750,6
938,v1710,20170728,6940,6865,6900,6900,6900,6900,6900,35,35,2,69000,4
939,v1710,20170731,6900,6900,0,0,0,6830,6830,-70,-70,0,0,4
940,v1710,20170801,6830,6830,0,0,0,6910,6910,80,80,0,0,4
941,v1710,20170802,6910,6910,0,0,0,6910,6910,0,0,0,0,4
942,v1710,20170803,6910,6910,7225,7225,7225,7225,7225,315,315,2,72250,2
943,v1710,20170804,7225,7225,7225,7300,7200,7300,7255,75,30,12,435500,8
944,v1710,20170807,7300,7255,0,0,0,7255,7255,0,0,0,0,8
945,v1710,20170808,7255,7255,7500,7500,7255,7255,7375,0,120,4,147550,10
946,v1710,20170809,7255,7375,0,0,0,7375,7375,0,0,0,0,10
947,v1710,20170810,7375,7375,0,0,0,7420,7420,45,45,0,0,10
948,v1710,20170811,7420,7420,7685,7685,7330,7330,7505,-90,85,4,150150,10
949,v1710,20170814,7330,7505,0,0,0,7400,7400,-105,-105,0,0,10
950,v1710,20170815,7400,7400,0,0,0,7255,7255,-145,-145,0,0,10
951,v1710,20170816,7255,7255,0,0,0,7195,7195,-60,-60,0,0,10
952,v1710,20170817,7195,7195,0,0,0,7195,7195,0,0,0,0,10
953,v1710,20170818,7195,7195,0,0,0,7300,7300,105,105,0,0,10
954,v1710,20170821,7300,7300,0,0,0,7365,7365,65,65,0,0,10
955,v1710,20170822,7365,7365,0,0,0,7375,7375,10,10,0,0,10
956,v1710,20170823,7375,7375,0,0,0,7315,7315,-60,-60,0,0,10
957,v1710,20170824,7315,7315,7215,7230,7215,7230,7220,-85,-95,6,216600,16
958,v1710,20170825,7230,7220,0,0,0,7265,7265,45,45,0,0,16
959,v1710,20170828,7265,7265,7620,7620,7620,7620,7620,355,355,6,228600,12
960,v1710,20170829,7620,7620,7395,7755,7395,7550,7570,-70,-50,18,681500,12
961,v1710,20170830,7550,7570,0,0,0,7570,7570,0,0,0,0,12
962,v1710,20170831,7570,7570,0,0,0,7575,7575,5,5,0,0,12
963,v1710,20170901,7575,7575,0,0,0,7610,7610,35,35,0,0,12
964,v1710,20170904,7610,7610,0,0,0,7655,7655,45,45,0,0,12
965,v1710,20170905,7655,7655,0,0,0,7655,7655,0,0,0,0,12
966,v1710,20170906,7655,7655,0,0,0,7695,7695,40,40,0,0,12
967,v1710,20170907,7695,7695,0,0,0,7615,7615,-80,-80,0,0,12
968,v1710,20170908,7615,7615,0,0,0,7590,7590,-25,-25,0,0,12
969,v1710,20170911,7590,7590,0,0,0,7405,7405,-185,-185,0,0,12
970,v1710,20170912,7405,7405,0,0,0,7470,7470,65,65,0,0,12
971,v1710,20170913,7470,7470,0,0,0,7175,7175,-295,-295,0,0,12
972,v1710,20170914,7175,7175,0,0,0,7530,7530,355,355,0,0,12
973,v1710,20170915,7530,7530,7430,7430,7155,7155,7245,-375,-285,6,217400,10
974,v1710,20170918,7155,7245,7100,7100,7100,7100,7100,-145,-145,2,71000,8
975,v1710,20170919,7100,7100,0,0,0,7100,7100,0,0,0,0,8
976,v1710,20170920,7100,7100,7050,7140,7050,7140,7095,40,-5,8,283800,2
977,v1710,20170921,7140,7095,0,0,0,7095,7095,0,0,0,0,2
978,v1710,20170922,7095,7095,0,0,0,7095,7095,0,0,0,0,2
979,v1710,20170925,7095,7095,0,0,0,7095,7095,0,0,0,0,2
980,v1710,20170926,7095,7095,0,0,0,7095,7095,0,0,0,0,2
981,v1710,20170927,7095,7095,7095,7095,7095,7095,7095,0,0,4,141900,0
982,v1710,20170928,7095,7095,0,0,0,7095,7095,0,0,0,0,0
983,v1710,20170929,7095,7095,0,0,0,7095,7095,0,0,0,0,0
984,v1710,20171009,7095,7095,0,0,0,7095,7095,0,0,0,0,0
985,v1710,20171010,7095,7095,0,0,0,7095,7095,0,0,0,0,0
986,v1710,20171011,7095,7095,0,0,0,7095,7095,0,0,0,0,0
987,v1710,20171012,7095,7095,0,0,0,7095,7095,0,0,0,0,0
988,v1710,20171013,7095,7095,0,0,0,7095,7095,0,0,0,0,0
989,v1710,20171016,7095,7095,0,0,0,7095,7095,0,0,0,0,0
990,v1710,20171017,7095,7095,0,0,0,7095,7095,0,0,0,0,0
991,v1710,20171018,7095,7095,0,0,0,7095,7095,0,0,0,0,0
992,v1710,20171019,7095,7095,0,0,0,7095,7095,0,0,0,0,0
993,v1710,20171020,7095,7095,0,0,0,7095,7095,0,0,0,0,0
994,v1711,20170103,6435,6435,0,0,0,6265,6265,-170,-170,0,0,0
995,v1711,20170104,6265,6265,0,0,0,6255,6255,-10,-10,0,0,0
996,v1711,20170105,6255,6255,0,0,0,6330,6330,75,75,0,0,0
997,v1711,20170106,6330,6330,0,0,0,6320,6320,-10,-10,0,0,0
998,v1711,20170109,6320,6320,0,0,0,6440,6440,120,120,0,0,0
999,v1711,20170110,6440,6440,0,0,0,6565,6565,125,125,0,0,0
1000,v1711,20170111,6565,6565,0,0,0,6605,6605,40,40,0,0,0
1001,v1711,20170112,6605,6605,0,0,0,6625,6625,20,20,0,0,0
1002,v1711,20170113,6625,6625,0,0,0,6675,6675,50,50,0,0,0
1003,v1711,20170116,6675,6675,0,0,0,6825,6825,150,150,0,0,0
1004,v1711,20170117,6825,6825,0,0,0,6740,6740,-85,-85,0,0,0
1005,v1711,20170118,6740,6740,0,0,0,6695,6695,-45,-45,0,0,0
1006,v1711,20170119,6695,6695,0,0,0,6755,6755,60,60,0,0,0
1007,v1711,20170120,6755,6755,0,0,0,6795,6795,40,40,0,0,0
1008,v1711,20170123,6795,6795,0,0,0,6825,6825,30,30,0,0,0
1009,v1711,20170124,6825,6825,0,0,0,6785,6785,-40,-40,0,0,0
1010,v1711,20170125,6785,6785,0,0,0,6785,6785,0,0,0,0,0
1011,v1711,20170126,6785,6785,0,0,0,6805,6805,20,20,0,0,0
1012,v1711,20170203,6805,6805,0,0,0,7005,7005,200,200,0,0,0
1013,v1711,20170206,7005,7005,0,0,0,7015,7015,10,10,0,0,0
1014,v1711,20170207,7015,7015,0,0,0,7030,7030,15,15,0,0,0
1015,v1711,20170208,7030,7030,0,0,0,7130,7130,100,100,0,0,0
1016,v1711,20170209,7130,7130,0,0,0,7140,7140,10,10,0,0,0
1017,v1711,20170210,7140,7140,0,0,0,7130,7130,-10,-10,0,0,0
1018,v1711,20170213,7130,7130,0,0,0,7250,7250,120,120,0,0,0
1019,v1711,20170214,7250,7250,0,0,0,7270,7270,20,20,0,0,0
1020,v1711,20170215,7270,7270,0,0,0,7170,7170,-100,-100,0,0,0
1021,v1711,20170216,7170,7170,0,0,0,7080,7080,-90,-90,0,0,0
1022,v1711,20170217,7080,7080,0,0,0,7050,7050,-30,-30,0,0,0
1023,v1711,20170220,7050,7050,0,0,0,7065,7065,15,15,0,0,0
1024,v1711,20170221,7065,7065,0,0,0,6990,6990,-75,-75,0,0,0
1025,v1711,20170222,6990,6990,0,0,0,6895,6895,-95,-95,0,0,0
1026,v1711,20170223,6895,6895,0,0,0,6780,6780,-115,-115,0,0,0
1027,v1711,20170224,6780,6780,0,0,0,6755,6755,-25,-25,0,0,0
1028,v1711,20170227,6755,6755,0,0,0,6900,6900,145,145,0,0,0
1029,v1711,20170228,6900,6900,0,0,0,6895,6895,-5,-5,0,0,0
1030,v1711,20170301,6895,6895,0,0,0,6830,6830,-65,-65,0,0,0
1031,v1711,20170302,6830,6830,0,0,0,6835,6835,5,5,0,0,0
1032,v1711,20170303,6835,6835,0,0,0,6955,6955,120,120,0,0,0
1033,v1711,20170306,6955,6955,0,0,0,7085,7085,130,130,0,0,0
1034,v1711,20170307,7085,7085,0,0,0,7100,7100,15,15,0,0,0
1035,v1711,20170308,7100,7100,0,0,0,6905,6905,-195,-195,0,0,0
1036,v1711,20170309,6905,6905,0,0,0,6815,6815,-90,-90,0,0,0
1037,v1711,20170310,6815,6815,0,0,0,6815,6815,0,0,0,0,0
1038,v1711,20170313,6815,6815,0,0,0,6770,6770,-45,-45,0,0,0
1039,v1711,20170314,6770,6770,0,0,0,6885,6885,115,115,0,0,0
1040,v1711,20170315,6885,6885,0,0,0,7020,7020,135,135,0,0,0
1041,v1711,20170316,7020,7020,0,0,0,7030,7030,10,10,0,0,0
1042,v1711,20170317,7030,7030,0,0,0,7065,7065,35,35,0,0,0
1043,v1711,20170320,7065,7065,0,0,0,7015,7015,-50,-50,0,0,0
1044,v1711,20170321,7015,7015,0,0,0,6895,6895,-120,-120,0,0,0
1045,v1711,20170322,6895,6895,0,0,0,6770,6770,-125,-125,0,0,0
1046,v1711,20170323,6770,6770,0,0,0,6745,6745,-25,-25,0,0,0
1047,v1711,20170324,6745,6745,0,0,0,6710,6710,-35,-35,0,0,0
1048,v1711,20170327,6710,6710,0,0,0,6535,6535,-175,-175,0,0,0
1049,v1711,20170328,6535,6535,0,0,0,6540,6540,5,5,0,0,0
1050,v1711,20170329,6540,6540,0,0,0,6605,6605,65,65,0,0,0
1051,v1711,20170330,6605,6605,0,0,0,6565,6565,-40,-40,0,0,0
1052,v1711,20170331,6565,6565,0,0,0,6465,6465,-100,-100,0,0,0
1053,v1711,20170405,6465,6465,0,0,0,6530,6530,65,65,0,0,0
1054,v1711,20170406,6530,6530,0,0,0,6555,6555,25,25,0,0,0
1055,v1711,20170407,6555,6555,0,0,0,6440,6440,-115,-115,0,0,0
1056,v1711,20170410,6440,6440,0,0,0,6325,6325,-115,-115,0,0,0
1057,v1711,20170411,6325,6325,0,0,0,6350,6350,25,25,0,0,0
1058,v1711,20170412,6350,6350,0,0,0,6265,6265,-85,-85,0,0,0
1059,v1711,20170413,6265,6265,0,0,0,6140,6140,-125,-125,0,0,0
1060,v1711,20170414,6140,6140,0,0,0,6020,6020,-120,-120,0,0,0
1061,v1711,20170417,6020,6020,0,0,0,6005,6005,-15,-15,0,0,0
1062,v1711,20170418,6005,6005,0,0,0,5900,5900,-105,-105,0,0,0
1063,v1711,20170419,5900,5900,0,0,0,5805,5805,-95,-95,0,0,0
1064,v1711,20170420,5805,5805,0,0,0,5840,5840,35,35,0,0,0
1065,v1711,20170421,5840,5840,0,0,0,6000,6000,160,160,0,0,0
1066,v1711,20170424,6000,6000,0,0,0,5885,5885,-115,-115,0,0,0
1067,v1711,20170425,5885,5885,0,0,0,5905,5905,20,20,0,0,0
1068,v1711,20170426,5905,5905,0,0,0,5885,5885,-20,-20,0,0,0
1069,v1711,20170427,5885,5885,0,0,0,5960,5960,75,75,0,0,0
1070,v1711,20170428,5960,5960,0,0,0,6165,6165,205,205,0,0,0
1071,v1711,20170502,6165,6165,0,0,0,6170,6170,5,5,0,0,0
1072,v1711,20170503,6170,6170,0,0,0,6160,6160,-10,-10,0,0,0
1073,v1711,20170504,6160,6160,0,0,0,5965,5965,-195,-195,0,0,0
1074,v1711,20170505,5965,5965,0,0,0,5910,5910,-55,-55,0,0,0
1075,v1711,20170508,5910,5910,0,0,0,5985,5985,75,75,0,0,0
1076,v1711,20170509,5985,5985,0,0,0,5955,5955,-30,-30,0,0,0
1077,v1711,20170510,5955,5955,0,0,0,5945,5945,-10,-10,0,0,0
1078,v1711,20170511,5945,5945,0,0,0,5960,5960,15,15,0,0,0
1079,v1711,20170512,5960,5960,0,0,0,5950,5950,-10,-10,0,0,0
1080,v1711,20170515,5950,5950,0,0,0,5950,5950,0,0,0,0,0
1081,v1711,20170516,5950,5950,0,0,0,6005,6005,55,55,0,0,0
1082,v1711,20170517,6005,6005,0,0,0,6005,6005,0,0,0,0,0
1083,v1711,20170518,6005,6005,0,0,0,6090,6090,85,85,0,0,0
1084,v1711,20170519,6090,6090,0,0,0,6230,6230,140,140,0,0,0
1085,v1711,20170522,6230,6230,0,0,0,6285,6285,55,55,0,0,0
1086,v1711,20170523,6285,6285,0,0,0,6255,6255,-30,-30,0,0,0
1087,v1711,20170524,6255,6255,0,0,0,6115,6115,-140,-140,0,0,0
1088,v1711,20170525,6115,6115,0,0,0,6115,6115,0,0,0,0,0
1089,v1711,20170526,6115,6115,0,0,0,6000,6000,-115,-115,0,0,0
1090,v1711,20170531,6000,6000,0,0,0,6050,6050,50,50,0,0,0
1091,v1711,20170601,6050,6050,0,0,0,6150,6150,100,100,0,0,0
1092,v1711,20170602,6150,6150,0,0,0,6095,6095,-55,-55,0,0,0
1093,v1711,20170605,6095,6095,0,0,0,5920,5920,-175,-175,0,0,0
1094,v1711,20170606,5920,5920,0,0,0,5905,5905,-15,-15,0,0,0
1095,v1711,20170607,5905,5905,0,0,0,5930,5930,25,25,0,0,0
1096,v1711,20170608,5930,5930,0,0,0,5915,5915,-15,-15,0,0,0
1097,v1711,20170609,5915,5915,0,0,0,5945,5945,30,30,0,0,0
1098,v1711,20170612,5945,5945,0,0,0,6095,6095,150,150,0,0,0
1099,v1711,20170613,6095,6095,0,0,0,6090,6090,-5,-5,0,0,0
1100,v1711,20170614,6090,6090,0,0,0,6020,6020,-70,-70,0,0,0
1101,v1711,20170615,6020,6020,0,0,0,6000,6000,-20,-20,0,0,0
1102,v1711,20170616,6000,6000,0,0,0,5975,5975,-25,-25,0,0,0
1103,v1711,20170619,5975,5975,0,0,0,5920,5920,-55,-55,0,0,0
1104,v1711,20170620,5920,5920,0,0,0,5915,5915,-5,-5,0,0,0
1105,v1711,20170621,5915,5915,0,0,0,6005,6005,90,90,0,0,0
1106,v1711,20170622,6005,6005,0,0,0,6025,6025,20,20,0,0,0
1107,v1711,20170623,6025,6025,0,0,0,6090,6090,65,65,0,0,0
1108,v1711,20170626,6090,6090,0,0,0,6170,6170,80,80,0,0,0
1109,v1711,20170627,6170,6170,0,0,0,6225,6225,55,55,0,0,0
1110,v1711,20170628,6225,6225,6215,6215,6215,6215,6215,-10,-10,2,62150,2
1111,v1711,20170629,6215,6215,0,0,0,6390,6390,175,175,0,0,2
1112,v1711,20170630,6390,6390,0,0,0,6520,6520,130,130,0,0,2
1113,v1711,20170703,6520,6520,0,0,0,6490,6490,-30,-30,0,0,2
1114,v1711,20170704,6490,6490,0,0,0,6440,6440,-50,-50,0,0,2
1115,v1711,20170705,6440,6440,0,0,0,6545,6545,105,105,0,0,2
1116,v1711,20170706,6545,6545,0,0,0,6585,6585,40,40,0,0,2
1117,v1711,20170707,6585,6585,0,0,0,6675,6675,90,90,0,0,2
1118,v1711,20170710,6675,6675,0,0,0,6710,6710,35,35,0,0,2
1119,v1711,20170711,6710,6710,6380,6380,6380,6380,6380,-330,-330,2,63800,2
1120,v1711,20170712,6380,6380,0,0,0,6355,6355,-25,-25,0,0,2
1121,v1711,20170713,6355,6355,0,0,0,6335,6335,-20,-20,0,0,2
1122,v1711,20170714,6335,6335,0,0,0,6310,6310,-25,-25,0,0,2
1123,v1711,20170717,6310,6310,0,0,0,6310,6310,0,0,0,0,2
1124,v1711,20170718,6310,6310,6545,6625,6545,6620,6585,310,275,8,263400,2
1125,v1711,20170719,6620,6585,6685,6685,6685,6685,6685,100,100,2,66850,2
1126,v1711,20170720,6685,6685,0,0,0,6840,6840,155,155,0,0,2
1127,v1711,20170721,6840,6840,0,0,0,6720,6720,-120,-120,0,0,2
1128,v1711,20170724,6720,6720,0,0,0,6760,6760,40,40,0,0,2
1129,v1711,20170725,6760,6760,0,0,0,6685,6685,-75,-75,0,0,2
1130,v1711,20170726,6685,6685,0,0,0,6730,6730,45,45,0,0,2
1131,v1711,20170727,6730,6730,0,0,0,6775,6775,45,45,0,0,2
1132,v1711,20170728,6775,6775,0,0,0,6805,6805,30,30,0,0,2
1133,v1711,20170731,6805,6805,0,0,0,6740,6740,-65,-65,0,0,2
1134,v1711,20170801,6740,6740,0,0,0,6815,6815,75,75,0,0,2
1135,v1711,20170802,6815,6815,0,0,0,6995,6995,180,180,0,0,2
1136,v1711,20170803,6995,6995,0,0,0,7310,7310,315,315,0,0,2
1137,v1711,20170804,7310,7310,7250,7250,7250,7250,7250,-60,-60,6,217500,8
1138,v1711,20170807,7250,7250,0,0,0,7245,7245,-5,-5,0,0,8
1139,v1711,20170808,7245,7245,0,0,0,7360,7360,115,115,0,0,8
1140,v1711,20170809,7360,7360,0,0,0,7435,7435,75,75,0,0,8
1141,v1711,20170810,7435,7435,0,0,0,7480,7480,45,45,0,0,8
1142,v1711,20170811,7480,7480,0,0,0,7565,7565,85,85,0,0,8
1143,v1711,20170814,7565,7565,0,0,0,7460,7460,-105,-105,0,0,8
1144,v1711,20170815,7460,7460,0,0,0,7315,7315,-145,-145,0,0,8
1145,v1711,20170816,7315,7315,0,0,0,7255,7255,-60,-60,0,0,8
1146,v1711,20170817,7255,7255,0,0,0,7360,7360,105,105,0,0,8
1147,v1711,20170818,7360,7360,0,0,0,7470,7470,110,110,0,0,8
1148,v1711,20170821,7470,7470,0,0,0,7540,7540,70,70,0,0,8
1149,v1711,20170822,7540,7540,0,0,0,7555,7555,15,15,0,0,8
1150,v1711,20170823,7555,7555,0,0,0,7490,7490,-65,-65,0,0,8
1151,v1711,20170824,7490,7490,0,0,0,7395,7395,-95,-95,0,0,8
1152,v1711,20170825,7395,7395,0,0,0,7440,7440,45,45,0,0,8
1153,v1711,20170828,7440,7440,0,0,0,7800,7800,360,360,0,0,8
1154,v1711,20170829,7800,7800,0,0,0,7750,7750,-50,-50,0,0,8
1155,v1711,20170830,7750,7750,0,0,0,7670,7670,-80,-80,0,0,8
1156,v1711,20170831,7670,7670,0,0,0,7675,7675,5,5,0,0,8
1157,v1711,20170901,7675,7675,0,0,0,7710,7710,35,35,0,0,8
1158,v1711,20170904,7710,7710,0,0,0,7755,7755,45,45,0,0,8
1159,v1711,20170905,7755,7755,0,0,0,7825,7825,70,70,0,0,8
1160,v1711,20170906,7825,7825,0,0,0,7870,7870,45,45,0,0,8
1161,v1711,20170907,7870,7870,0,0,0,7785,7785,-85,-85,0,0,8
1162,v1711,20170908,7785,7785,0,0,0,7755,7755,-30,-30,0,0,8
1163,v1711,20170911,7755,7755,0,0,0,7565,7565,-190,-190,0,0,8
1164,v1711,20170912,7565,7565,0,0,0,7635,7635,70,70,0,0,8
1165,v1711,20170913,7635,7635,0,0,0,7330,7330,-305,-305,0,0,8
1166,v1711,20170914,7330,7330,0,0,0,7695,7695,365,365,0,0,8
1167,v1711,20170915,7695,7695,0,0,0,7405,7405,-290,-290,0,0,8
1168,v1711,20170918,7405,7405,0,0,0,7260,7260,-145,-145,0,0,8
1169,v1711,20170919,7260,7260,0,0,0,7260,7260,0,0,0,0,8
1170,v1711,20170920,7260,7260,7145,7145,7145,7145,7145,-115,-115,6,214350,6
1171,v1711,20170921,7145,7145,0,0,0,7145,7145,0,0,0,0,6
1172,v1711,20170922,7145,7145,0,0,0,7145,7145,0,0,0,0,6
1173,v1711,20170925,7145,7145,0,0,0,7145,7145,0,0,0,0,6
1174,v1711,20170926,7145,7145,0,0,0,7145,7145,0,0,0,0,6
1175,v1711,20170927,7145,7145,0,0,0,7145,7145,0,0,0,0,6
1176,v1711,20170928,7145,7145,0,0,0,7145,7145,0,0,0,0,6
1177,v1711,20170929,7145,7145,0,0,0,7145,7145,0,0,0,0,6
1178,v1711,20171009,7145,7145,0,0,0,7145,7145,0,0,0,0,6
1179,v1711,20171010,7145,7145,0,0,0,7145,7145,0,0,0,0,6
1180,v1711,20171011,7145,7145,0,0,0,6790,6790,-355,-355,0,0,6
1181,v1711,20171012,6790,6790,0,0,0,6790,6790,0,0,0,0,6
1182,v1711,20171013,6790,6790,0,0,0,6790,6790,0,0,0,0,6
1183,v1711,20171016,6790,6790,0,0,0,6790,6790,0,0,0,0,6
1184,v1711,20171017,6790,6790,0,0,0,6790,6790,0,0,0,0,6
1185,v1711,20171018,6790,6790,6565,6565,6565,6565,6565,-225,-225,2,65650,4
1186,v1711,20171019,6565,6565,0,0,0,6565,6565,0,0,0,0,4
1187,v1711,20171020,6565,6565,6685,6685,6685,6685,6685,120,120,4,133700,4
1188,v1711,20171023,6685,6685,6985,6985,6800,6800,6890,115,205,4,137850,4
1189,v1711,20171024,6800,6890,6560,6560,6560,6560,6560,-330,-330,4,131200,0
1190,v1711,20171025,6560,6560,0,0,0,6560,6560,0,0,0,0,0
1191,v1711,20171026,6560,6560,0,0,0,6560,6560,0,0,0,0,0
1192,v1711,20171027,6560,6560,0,0,0,6560,6560,0,0,0,0,0
1193,v1711,20171030,6560,6560,0,0,0,6560,6560,0,0,0,0,0
1194,v1711,20171031,6560,6560,0,0,0,6560,6560,0,0,0,0,0
1195,v1711,20171101,6560,6560,0,0,0,6560,6560,0,0,0,0,0
1196,v1711,20171102,6560,6560,0,0,0,6560,6560,0,0,0,0,0
1197,v1711,20171103,6560,6560,0,0,0,6560,6560,0,0,0,0,0
1198,v1711,20171106,6560,6560,0,0,0,6560,6560,0,0,0,0,0
1199,v1711,20171107,6560,6560,0,0,0,6560,6560,0,0,0,0,0
1200,v1711,20171108,6560,6560,0,0,0,6560,6560,0,0,0,0,0
1201,v1711,20171109,6560,6560,0,0,0,6560,6560,0,0,0,0,0
1202,v1711,20171110,6560,6560,0,0,0,6560,6560,0,0,0,0,0
1203,v1711,20171113,6560,6560,0,0,0,6560,6560,0,0,0,0,0
1204,v1711,20171114,6560,6560,0,0,0,6560,6560,0,0,0,0,0
1205,v1712,20170103,6435,6435,0,0,0,6265,6265,-170,-170,0,0,0
1206,v1712,20170104,6265,6265,0,0,0,6255,6255,-10,-10,0,0,0
1207,v1712,20170105,6255,6255,0,0,0,6330,6330,75,75,0,0,0
1208,v1712,20170106,6330,6330,0,0,0,6320,6320,-10,-10,0,0,0
1209,v1712,20170109,6320,6320,0,0,0,6440,6440,120,120,0,0,0
1210,v1712,20170110,6440,6440,0,0,0,6565,6565,125,125,0,0,0
1211,v1712,20170111,6565,6565,0,0,0,6605,6605,40,40,0,0,0
1212,v1712,20170112,6605,6605,0,0,0,6625,6625,20,20,0,0,0
1213,v1712,20170113,6625,6625,0,0,0,6675,6675,50,50,0,0,0
1214,v1712,20170116,6675,6675,0,0,0,6825,6825,150,150,0,0,0
1215,v1712,20170117,6825,6825,0,0,0,6740,6740,-85,-85,0,0,0
1216,v1712,20170118,6740,6740,0,0,0,6695,6695,-45,-45,0,0,0
1217,v1712,20170119,6695,6695,0,0,0,6755,6755,60,60,0,0,0
1218,v1712,20170120,6755,6755,0,0,0,6795,6795,40,40,0,0,0
1219,v1712,20170123,6795,6795,0,0,0,6825,6825,30,30,0,0,0
1220,v1712,20170124,6825,6825,0,0,0,6785,6785,-40,-40,0,0,0
1221,v1712,20170125,6785,6785,0,0,0,6785,6785,0,0,0,0,0
1222,v1712,20170126,6785,6785,0,0,0,6805,6805,20,20,0,0,0
1223,v1712,20170203,6805,6805,0,0,0,7005,7005,200,200,0,0,0
1224,v1712,20170206,7005,7005,0,0,0,7015,7015,10,10,0,0,0
1225,v1712,20170207,7015,7015,0,0,0,7030,7030,15,15,0,0,0
1226,v1712,20170208,7030,7030,0,0,0,7130,7130,100,100,0,0,0
1227,v1712,20170209,7130,7130,0,0,0,7140,7140,10,10,0,0,0
1228,v1712,20170210,7140,7140,0,0,0,7130,7130,-10,-10,0,0,0
1229,v1712,20170213,7130,7130,0,0,0,7250,7250,120,120,0,0,0
1230,v1712,20170214,7250,7250,0,0,0,7270,7270,20,20,0,0,0
1231,v1712,20170215,7270,7270,0,0,0,7170,7170,-100,-100,0,0,0
1232,v1712,20170216,7170,7170,0,0,0,7080,7080,-90,-90,0,0,0
1233,v1712,20170217,7080,7080,0,0,0,7050,7050,-30,-30,0,0,0
1234,v1712,20170220,7050,7050,0,0,0,7065,7065,15,15,0,0,0
1235,v1712,20170221,7065,7065,0,0,0,6990,6990,-75,-75,0,0,0
1236,v1712,20170222,6990,6990,0,0,0,6895,6895,-95,-95,0,0,0
1237,v1712,20170223,6895,6895,0,0,0,6780,6780,-115,-115,0,0,0
1238,v1712,20170224,6780,6780,0,0,0,6755,6755,-25,-25,0,0,0
1239,v1712,20170227,6755,6755,0,0,0,6900,6900,145,145,0,0,0
1240,v1712,20170228,6900,6900,0,0,0,6895,6895,-5,-5,0,0,0
1241,v1712,20170301,6895,6895,0,0,0,6830,6830,-65,-65,0,0,0
1242,v1712,20170302,6830,6830,0,0,0,6835,6835,5,5,0,0,0
1243,v1712,20170303,6835,6835,0,0,0,6955,6955,120,120,0,0,0
1244,v1712,20170306,6955,6955,0,0,0,7085,7085,130,130,0,0,0
1245,v1712,20170307,7085,7085,0,0,0,7100,7100,15,15,0,0,0
1246,v1712,20170308,7100,7100,0,0,0,6905,6905,-195,-195,0,0,0
1247,v1712,20170309,6905,6905,0,0,0,6815,6815,-90,-90,0,0,0
1248,v1712,20170310,6815,6815,0,0,0,6815,6815,0,0,0,0,0
1249,v1712,20170313,6815,6815,0,0,0,6770,6770,-45,-45,0,0,0
1250,v1712,20170314,6770,6770,0,0,0,6885,6885,115,115,0,0,0
1251,v1712,20170315,6885,6885,0,0,0,7020,7020,135,135,0,0,0
1252,v1712,20170316,7020,7020,0,0,0,7030,7030,10,10,0,0,0
1253,v1712,20170317,7030,7030,0,0,0,7065,7065,35,35,0,0,0
1254,v1712,20170320,7065,7065,0,0,0,7015,7015,-50,-50,0,0,0
1255,v1712,20170321,7015,7015,0,0,0,6895,6895,-120,-120,0,0,0
1256,v1712,20170322,6895,6895,0,0,0,6770,6770,-125,-125,0,0,0
1257,v1712,20170323,6770,6770,0,0,0,6745,6745,-25,-25,0,0,0
1258,v1712,20170324,6745,6745,0,0,0,6710,6710,-35,-35,0,0,0
1259,v1712,20170327,6710,6710,0,0,0,6535,6535,-175,-175,0,0,0
1260,v1712,20170328,6535,6535,0,0,0,6540,6540,5,5,0,0,0
1261,v1712,20170329,6540,6540,0,0,0,6605,6605,65,65,0,0,0
1262,v1712,20170330,6605,6605,0,0,0,6565,6565,-40,-40,0,0,0
1263,v1712,20170331,6565,6565,0,0,0,6465,6465,-100,-100,0,0,0
1264,v1712,20170405,6465,6465,0,0,0,6530,6530,65,65,0,0,0
1265,v1712,20170406,6530,6530,0,0,0,6555,6555,25,25,0,0,0
1266,v1712,20170407,6555,6555,0,0,0,6440,6440,-115,-115,0,0,0
1267,v1712,20170410,6440,6440,0,0,0,6325,6325,-115,-115,0,0,0
1268,v1712,20170411,6325,6325,0,0,0,6350,6350,25,25,0,0,0
1269,v1712,20170412,6350,6350,0,0,0,6265,6265,-85,-85,0,0,0
1270,v1712,20170413,6265,6265,0,0,0,6140,6140,-125,-125,0,0,0
1271,v1712,20170414,6140,6140,0,0,0,6020,6020,-120,-120,0,0,0
1272,v1712,20170417,6020,6020,0,0,0,6005,6005,-15,-15,0,0,0
1273,v1712,20170418,6005,6005,0,0,0,5900,5900,-105,-105,0,0,0
1274,v1712,20170419,5900,5900,0,0,0,5805,5805,-95,-95,0,0,0
1275,v1712,20170420,5805,5805,0,0,0,5840,5840,35,35,0,0,0
1276,v1712,20170421,5840,5840,0,0,0,6000,6000,160,160,0,0,0
1277,v1712,20170424,6000,6000,0,0,0,5885,5885,-115,-115,0,0,0
1278,v1712,20170425,5885,5885,0,0,0,5905,5905,20,20,0,0,0
1279,v1712,20170426,5905,5905,0,0,0,5885,5885,-20,-20,0,0,0
1280,v1712,20170427,5885,5885,0,0,0,5960,5960,75,75,0,0,0
1281,v1712,20170428,5960,5960,0,0,0,6165,6165,205,205,0,0,0
1282,v1712,20170502,6165,6165,0,0,0,6170,6170,5,5,0,0,0
1283,v1712,20170503,6170,6170,0,0,0,6160,6160,-10,-10,0,0,0
1284,v1712,20170504,6160,6160,0,0,0,5965,5965,-195,-195,0,0,0
1285,v1712,20170505,5965,5965,0,0,0,5910,5910,-55,-55,0,0,0
1286,v1712,20170508,5910,5910,0,0,0,5985,5985,75,75,0,0,0
1287,v1712,20170509,5985,5985,0,0,0,5955,5955,-30,-30,0,0,0
1288,v1712,20170510,5955,5955,0,0,0,5945,5945,-10,-10,0,0,0
1289,v1712,20170511,5945,5945,0,0,0,5960,5960,15,15,0,0,0
1290,v1712,20170512,5960,5960,0,0,0,5950,5950,-10,-10,0,0,0
1291,v1712,20170515,5950,5950,0,0,0,5950,5950,0,0,0,0,0
1292,v1712,20170516,5950,5950,0,0,0,6005,6005,55,55,0,0,0
1293,v1712,20170517,6005,6005,0,0,0,6005,6005,0,0,0,0,0
1294,v1712,20170518,6005,6005,0,0,0,6090,6090,85,85,0,0,0
1295,v1712,20170519,6090,6090,0,0,0,6230,6230,140,140,0,0,0
1296,v1712,20170522,6230,6230,6250,6250,6150,6150,6200,-80,-30,8,248000,0
1297,v1712,20170523,6150,6200,0,0,0,6175,6175,-25,-25,0,0,0
1298,v1712,20170524,6175,6175,0,0,0,6040,6040,-135,-135,0,0,0
1299,v1712,20170525,6040,6040,0,0,0,6040,6040,0,0,0,0,0
1300,v1712,20170526,6040,6040,0,0,0,5930,5930,-110,-110,0,0,0
1301,v1712,20170531,5930,5930,0,0,0,5975,5975,45,45,0,0,0
1302,v1712,20170601,5975,5975,0,0,0,6070,6070,95,95,0,0,0
1303,v1712,20170602,6070,6070,0,0,0,6020,6020,-50,-50,0,0,0
1304,v1712,20170605,6020,6020,0,0,0,5850,5850,-170,-170,0,0,0
1305,v1712,20170606,5850,5850,0,0,0,5840,5840,-10,-10,0,0,0
1306,v1712,20170607,5840,5840,0,0,0,5865,5865,25,25,0,0,0
1307,v1712,20170608,5865,5865,0,0,0,5850,5850,-15,-15,0,0,0
1308,v1712,20170609,5850,5850,0,0,0,5875,5875,25,25,0,0,0
1309,v1712,20170612,5875,5875,0,0,0,6020,6020,145,145,0,0,0
1310,v1712,20170613,6020,6020,0,0,0,6020,6020,0,0,0,0,0
1311,v1712,20170614,6020,6020,0,0,0,5955,5955,-65,-65,0,0,0
1312,v1712,20170615,5955,5955,0,0,0,5935,5935,-20,-20,0,0,0
1313,v1712,20170616,5935,5935,0,0,0,5915,5915,-20,-20,0,0,0
1314,v1712,20170619,5915,5915,0,0,0,5860,5860,-55,-55,0,0,0
1315,v1712,20170620,5860,5860,0,0,0,5790,5790,-70,-70,0,0,0
1316,v1712,20170621,5790,5790,0,0,0,5880,5880,90,90,0,0,0
1317,v1712,20170622,5880,5880,0,0,0,5900,5900,20,20,0,0,0
1318,v1712,20170623,5900,5900,0,0,0,5960,5960,60,60,0,0,0
1319,v1712,20170626,5960,5960,0,0,0,6035,6035,75,75,0,0,0
1320,v1712,20170627,6035,6035,0,0,0,6085,6085,50,50,0,0,0
1321,v1712,20170628,6085,6085,0,0,0,6080,6080,-5,-5,0,0,0
1322,v1712,20170629,6080,6080,0,0,0,6250,6250,170,170,0,0,0
1323,v1712,20170630,6250,6250,0,0,0,6375,6375,125,125,0,0,0
1324,v1712,20170703,6375,6375,0,0,0,6420,6420,45,45,0,0,0
1325,v1712,20170704,6420,6420,0,0,0,6370,6370,-50,-50,0,0,0
1326,v1712,20170705,6370,6370,0,0,0,6475,6475,105,105,0,0,0
1327,v1712,20170706,6475,6475,0,0,0,6515,6515,40,40,0,0,0
1328,v1712,20170707,6515,6515,0,0,0,6605,6605,90,90,0,0,0
1329,v1712,20170710,6605,6605,6625,6625,6400,6415,6505,-190,-100,74,2408650,10
1330,v1712,20170711,6415,6505,0,0,0,6505,6505,0,0,0,0,10
1331,v1712,20170712,6505,6505,0,0,0,6480,6480,-25,-25,0,0,10
1332,v1712,20170713,6480,6480,0,0,0,6460,6460,-20,-20,0,0,10
1333,v1712,20170714,6460,6460,6365,6405,6365,6405,6385,-55,-75,4,127700,6
1334,v1712,20170717,6405,6385,0,0,0,6385,6385,0,0,0,0,6
1335,v1712,20170718,6385,6385,0,0,0,6660,6660,275,275,0,0,6
1336,v1712,20170719,6660,6660,0,0,0,6760,6760,100,100,0,0,6
1337,v1712,20170720,6760,6760,6945,6945,6945,6945,6945,185,185,20,694500,20
1338,v1712,20170721,6945,6945,6760,6760,6760,6760,6760,-185,-185,2,67600,22
1339,v1712,20170724,6760,6760,0,0,0,6800,6800,40,40,0,0,22
1340,v1712,20170725,6800,6800,0,0,0,6725,6725,-75,-75,0,0,22
1341,v1712,20170726,6725,6725,0,0,0,6770,6770,45,45,0,0,22
1342,v1712,20170727,6770,6770,0,0,0,6815,6815,45,45,0,0,22
1343,v1712,20170728,6815,6815,0,0,0,6845,6845,30,30,0,0,22
1344,v1712,20170731,6845,6845,0,0,0,6780,6780,-65,-65,0,0,22
1345,v1712,20170801,6780,6780,0,0,0,6855,6855,75,75,0,0,22
1346,v1712,20170802,6855,6855,0,0,0,7035,7035,180,180,0,0,22
1347,v1712,20170803,7035,7035,0,0,0,7355,7355,320,320,0,0,22
1348,v1712,20170804,7355,7355,7250,7250,7200,7250,7245,-105,-110,24,869500,24
1349,v1712,20170807,7250,7245,0,0,0,7240,7240,-5,-5,0,0,24
1350,v1712,20170808,7240,7240,7130,7245,7130,7230,7175,-10,-65,54,1938250,24
1351,v1712,20170809,7230,7175,7320,7320,7280,7280,7300,105,125,4,146000,22
1352,v1712,20170810,7280,7300,7315,7480,7315,7480,7395,180,95,8,295900,22
1353,v1712,20170811,7480,7395,0,0,0,7475,7475,80,80,0,0,22
1354,v1712,20170814,7475,7475,0,0,0,7475,7475,0,0,0,0,22
1355,v1712,20170815,7475,7475,0,0,0,7330,7330,-145,-145,0,0,22
1356,v1712,20170816,7330,7330,0,0,0,7270,7270,-60,-60,0,0,22
1357,v1712,20170817,7270,7270,0,0,0,7375,7375,105,105,0,0,22
1358,v1712,20170818,7375,7375,0,0,0,7485,7485,110,110,0,0,22
1359,v1712,20170821,7485,7485,7300,7300,7300,7300,7300,-185,-185,2,73000,22
1360,v1712,20170822,7300,7300,0,0,0,7310,7310,10,10,0,0,22
1361,v1712,20170823,7310,7310,0,0,0,7250,7250,-60,-60,0,0,22
1362,v1712,20170824,7250,7250,0,0,0,7160,7160,-90,-90,0,0,22
1363,v1712,20170825,7160,7160,0,0,0,7205,7205,45,45,0,0,22
1364,v1712,20170828,7205,7205,7555,7555,7555,7555,7555,350,350,10,377750,22
1365,v1712,20170829,7555,7555,7280,7280,7280,7280,7280,-275,-275,10,364000,22
1366,v1712,20170830,7280,7280,0,0,0,7205,7205,-75,-75,0,0,22
1367,v1712,20170831,7205,7205,7550,7550,7375,7375,7460,170,255,4,149250,22
1368,v1712,20170901,7375,7460,0,0,0,7490,7490,30,30,0,0,22
1369,v1712,20170904,7490,7490,0,0,0,7530,7530,40,40,0,0,22
1370,v1712,20170905,7530,7530,0,0,0,7595,7595,65,65,0,0,22
1371,v1712,20170906,7595,7595,0,0,0,7635,7635,40,40,0,0,22
1372,v1712,20170907,7635,7635,0,0,0,7555,7555,-80,-80,0,0,22
1373,v1712,20170908,7555,7555,0,0,0,7530,7530,-25,-25,0,0,22
1374,v1712,20170911,7530,7530,0,0,0,7345,7345,-185,-185,0,0,22
1375,v1712,20170912,7345,7345,0,0,0,7410,7410,65,65,0,0,22
1376,v1712,20170913,7410,7410,7115,7505,7115,7505,7310,95,-100,4,146200,22
1377,v1712,20170914,7505,7310,0,0,0,7675,7675,365,365,0,0,22
1378,v1712,20170915,7675,7675,0,0,0,7385,7385,-290,-290,0,0,22
1379,v1712,20170918,7385,7385,7020,7185,7020,7050,7085,-335,-300,6,212550,22
1380,v1712,20170919,7050,7085,0,0,0,7085,7085,0,0,0,0,22
1381,v1712,20170920,7085,7085,7170,7170,7170,7170,7170,85,85,22,788700,6
1382,v1712,20170921,7170,7170,6915,6915,6915,6915,6915,-255,-255,4,138300,4
1383,v1712,20170922,6915,6915,0,0,0,6915,6915,0,0,0,0,4
1384,v1712,20170925,6915,6915,0,0,0,6915,6915,0,0,0,0,4
1385,v1712,20170926,6915,6915,0,0,0,6915,6915,0,0,0,0,4
1386,v1712,20170927,6915,6915,6730,7050,6730,7050,6935,135,20,8,277400,4
1387,v1712,20170928,7050,6935,0,0,0,6935,6935,0,0,0,0,4
1388,v1712,20170929,6935,6935,0,0,0,6935,6935,0,0,0,0,4
1389,v1712,20171009,6935,6935,6520,6520,6520,6520,6520,-415,-415,2,65200,2
1390,v1712,20171010,6520,6520,6640,6645,6630,6635,6635,115,115,12,398300,10
1391,v1712,20171011,6635,6635,0,0,0,6635,6635,0,0,0,0,10
1392,v1712,20171012,6635,6635,6640,6640,6575,6575,6605,-60,-30,4,132150,12
1393,v1712,20171013,6575,6605,0,0,0,6605,6605,0,0,0,0,12
1394,v1712,20171016,6605,6605,0,0,0,6605,6605,0,0,0,0,12
1395,v1712,20171017,6605,6605,6645,6650,6640,6650,6645,45,40,12,398700,4
1396,v1712,20171018,6650,6645,6630,6830,6575,6575,6655,-70,10,8,266250,2
1397,v1712,20171019,6575,6655,0,0,0,6655,6655,0,0,0,0,2
1398,v1712,20171020,6655,6655,0,0,0,6775,6775,120,120,0,0,2
1399,v1712,20171023,6775,6775,0,0,0,6980,6980,205,205,0,0,2
1400,v1712,20171024,6980,6980,0,0,0,6650,6650,-330,-330,0,0,2
1401,v1712,20171025,6650,6650,0,0,0,6650,6650,0,0,0,0,2
1402,v1712,20171026,6650,6650,0,0,0,6650,6650,0,0,0,0,2
1403,v1712,20171027,6650,6650,0,0,0,6650,6650,0,0,0,0,2
1404,v1712,20171030,6650,6650,0,0,0,6650,6650,0,0,0,0,2
1405,v1712,20171031,6650,6650,0,0,0,6650,6650,0,0,0,0,2
1406,v1712,20171101,6650,6650,0,0,0,6650,6650,0,0,0,0,2
1407,v1712,20171102,6650,6650,0,0,0,6650,6650,0,0,0,0,2
1408,v1712,20171103,6650,6650,0,0,0,6650,6650,0,0,0,0,2
1409,v1712,20171106,6650,6650,0,0,0,6650,6650,0,0,0,0,2
1410,v1712,20171107,6650,6650,0,0,0,6650,6650,0,0,0,0,2
1411,v1712,20171108,6650,6650,0,0,0,6650,6650,0,0,0,0,2
1412,v1712,20171109,6650,6650,0,0,0,6650,6650,0,0,0,0,2
1413,v1712,20171110,6650,6650,0,0,0,6650,6650,0,0,0,0,2
1414,v1712,20171113,6650,6650,6765,6765,6325,6550,6545,-100,-105,6,196400,2
1415,v1712,20171114,6550,6545,0,0,0,6545,6545,0,0,0,0,2
1416,v1712,20171115,6545,6545,0,0,0,6545,6545,0,0,0,0,2
1417,v1712,20171116,6545,6545,0,0,0,6545,6545,0,0,0,0,2
1418,v1712,20171117,6545,6545,0,0,0,6545,6545,0,0,0,0,2
1419,v1712,20171120,6545,6545,0,0,0,6545,6545,0,0,0,0,2
1420,v1712,20171121,6545,6545,0,0,0,6545,6545,0,0,0,0,2
1421,v1712,20171122,6545,6545,0,0,0,6545,6545,0,0,0,0,2
1422,v1712,20171123,6545,6545,0,0,0,6545,6545,0,0,0,0,2
1423,v1712,20171124,6545,6545,0,0,0,6545,6545,0,0,0,0,2
1424,v1712,20171127,6545,6545,0,0,0,6545,6545,0,0,0,0,2
1425,v1712,20171128,6545,6545,6545,6545,6545,6545,6545,0,0,2,65450,2
1426,v1712,20171129,6545,6545,0,0,0,6545,6545,0,0,0,0,2
1427,v1712,20171130,6545,6545,6220,6220,6220,6220,6220,-325,-325,2,62200,0
1428,v1712,20171201,6220,6220,0,0,0,6220,6220,0,0,0,0,0
1429,v1712,20171204,6220,6220,0,0,0,6220,6220,0,0,0,0,0
1430,v1712,20171205,6220,6220,0,0,0,6220,6220,0,0,0,0,0
1431,v1712,20171206,6220,6220,0,0,0,6220,6220,0,0,0,0,0
1432,v1712,20171207,6220,6220,0,0,0,6220,6220,0,0,0,0,0
1433,v1712,20171208,6220,6220,0,0,0,6220,6220,0,0,0,0,0
1434,v1712,20171211,6220,6220,0,0,0,6220,6220,0,0,0,0,0
1435,v1712,20171212,6220,6220,0,0,0,6220,6220,0,0,0,0,0
1436,v1712,20171213,6220,6220,0,0,0,6220,6220,0,0,0,0,0
1437,v1712,20171214,6220,6220,0,0,0,6220,6220,0,0,0,0,0
1438,v1801,20170117,6825,6825,6450,6505,6380,6390,6440,-435,-385,390,12559250,192
1439,v1801,20170118,6390,6440,6375,6435,6365,6435,6395,-5,-45,30,959250,194
1440,v1801,20170119,6435,6395,6375,6525,6360,6520,6445,125,50,72,2320750,182
1441,v1801,20170120,6520,6445,6520,6525,6465,6500,6495,55,50,58,1884950,154
1442,v1801,20170123,6500,6495,6565,6565,6485,6485,6535,-10,40,14,457450,156
1443,v1801,20170124,6485,6535,6500,6500,6460,6465,6480,-70,-55,14,453750,158
1444,v1801,20170125,6465,6480,6495,6510,6495,6510,6495,30,15,10,324750,160
1445,v1801,20170126,6510,6495,6535,6535,6465,6480,6485,-15,-10,16,518900,150
1446,v1801,20170203,6480,6485,6700,6780,6615,6715,6695,230,210,62,2076550,128
1447,v1801,20170206,6715,6695,6755,6755,6685,6685,6725,-10,30,40,1345400,130
1448,v1801,20170207,6685,6725,6740,6745,6705,6725,6715,0,-10,62,2083150,122
1449,v1801,20170208,6725,6715,6685,6750,6685,6710,6715,-5,0,74,2485250,124
1450,v1801,20170209,6710,6715,6755,6770,6740,6745,6750,30,35,78,2632500,126
1451,v1801,20170210,6745,6750,6720,6800,6715,6800,6750,50,0,38,1282800,136
1452,v1801,20170213,6800,6750,6890,6900,6850,6895,6875,145,125,130,4471000,174
1453,v1801,20170214,6895,6875,6860,6900,6855,6875,6875,0,0,96,3302350,184
1454,v1801,20170215,6875,6875,6830,6880,6735,6735,6785,-140,-90,84,2851300,210
1455,v1801,20170216,6735,6785,6755,6755,6665,6690,6705,-95,-80,118,3956550,172
1456,v1801,20170217,6690,6705,6720,6720,6650,6685,6680,-20,-25,34,1136350,190
1457,v1801,20170220,6685,6680,6700,6700,6700,6700,6700,20,20,14,469000,194
1458,v1801,20170221,6700,6700,6685,6685,6575,6575,6605,-125,-95,80,2642350,242
1459,v1801,20170222,6575,6605,6570,6615,6550,6560,6575,-45,-30,152,4998250,278
1460,v1801,20170223,6560,6575,6560,6560,6400,6415,6455,-160,-120,92,2971100,300
1461,v1801,20170224,6415,6455,6400,6500,6385,6500,6440,45,-15,24,772900,296
1462,v1801,20170227,6500,6440,6510,6605,6510,6580,6585,140,145,74,2436850,318
1463,v1801,20170228,6580,6585,6580,6610,6490,6490,6570,-95,-15,44,1445700,332
1464,v1801,20170301,6490,6570,6530,6530,6485,6495,6500,-75,-70,24,780250,334
1465,v1801,20170302,6495,6500,6515,6515,6460,6480,6485,-20,-15,46,1492400,352
1466,v1801,20170303,6480,6485,6490,6660,6490,6640,6615,155,130,60,1984550,346
1467,v1801,20170306,6640,6615,6675,6760,6670,6715,6710,100,95,176,5906950,330
1468,v1801,20170307,6715,6710,6750,6760,6700,6750,6725,40,15,114,3836000,306
1469,v1801,20170308,6750,6725,6665,6680,6440,6440,6575,-285,-150,202,6643450,312
1470,v1801,20170309,6440,6575,6400,6550,6340,6500,6440,-75,-135,288,9279750,348
1471,v1801,20170310,6500,6440,6525,6525,6435,6435,6485,-5,45,134,4346250,418
1472,v1801,20170313,6435,6485,6400,6460,6360,6460,6415,-25,-70,100,3209600,442
1473,v1801,20170314,6460,6415,6485,6585,6450,6585,6505,170,90,96,3124050,452
1474,v1801,20170315,6585,6505,6625,6665,6600,6615,6635,110,130,88,2920150,440
1475,v1801,20170316,6615,6635,6680,6690,6600,6670,6655,35,20,134,4460200,476
1476,v1801,20170317,6670,6655,6685,6735,6660,6695,6695,40,40,158,5289450,526
1477,v1801,20170320,6695,6695,6695,6695,6605,6655,6645,-40,-50,90,2990900,560
1478,v1801,20170321,6655,6645,6610,6610,6490,6490,6550,-155,-95,272,8912650,642
1479,v1801,20170322,6490,6550,6405,6465,6365,6370,6400,-180,-150,450,14407750,690
1480,v1801,20170323,6370,6400,6440,6470,6300,6360,6370,-40,-30,732,23318250,1132
1481,v1801,20170324,6360,6370,6390,6390,6320,6320,6350,-50,-20,584,18551300,1484
1482,v1801,20170327,6320,6350,6280,6330,6110,6165,6190,-185,-160,618,19137050,1680
1483,v1801,20170328,6165,6190,6200,6225,6165,6165,6180,-25,-10,588,18181950,1802
1484,v1801,20170329,6165,6180,6255,6275,6215,6250,6240,70,60,378,11795600,1752
1485,v1801,20170330,6250,6240,6265,6290,6140,6160,6180,-80,-60,534,16509000,1792
1486,v1801,20170331,6160,6180,6195,6195,6090,6115,6120,-65,-60,468,14331400,1958
1487,v1801,20170405,6115,6120,6145,6240,6075,6230,6170,110,50,1070,33029850,1972
1488,v1801,20170406,6230,6170,6200,6205,6155,6180,6185,10,15,444,13737700,2044
1489,v1801,20170407,6180,6185,6105,6190,6000,6015,6065,-170,-120,872,26454450,2216
1490,v1801,20170410,6015,6065,6055,6055,5950,5980,5990,-85,-75,1296,38833750,2730
1491,v1801,20170411,5980,5990,6005,6090,5940,5955,6005,-35,15,1226,36838500,2780
1492,v1801,20170412,5955,6005,5965,5965,5855,5865,5900,-140,-105,2524,74467550,3718
1493,v1801,20170413,5865,5900,5870,5880,5710,5735,5775,-165,-125,4804,138815500,6182
1494,v1801,20170414,5735,5775,5765,5765,5565,5600,5630,-175,-145,6662,187688050,9724
1495,v1801,20170417,5600,5630,5635,5685,5550,5580,5610,-50,-20,4256,119432850,11402
1496,v1801,20170418,5580,5610,5590,5600,5485,5490,5530,-120,-80,5270,145837900,12500
1497,v1801,20170419,5490,5530,5450,5510,5425,5495,5455,-35,-75,6476,176689600,12676
1498,v1801,20170420,5495,5455,5470,5575,5440,5575,5490,120,35,5692,156247400,13176
1499,v1801,20170421,5575,5490,5580,5690,5580,5615,5625,125,135,7234,203459100,11520
1500,v1801,20170424,5615,5625,5625,5625,5470,5555,5530,-70,-95,4946,136811450,12364
1501,v1801,20170425,5555,5530,5555,5620,5490,5505,5555,-25,25,4892,135979300,12494
1502,v1801,20170426,5505,5555,5500,5600,5480,5530,5540,-25,-15,7586,210185000,12918
1503,v1801,20170427,5530,5540,5540,5730,5535,5730,5615,190,75,4622,129846650,12324
1504,v1801,20170428,5730,5615,5740,5885,5725,5855,5810,240,195,6968,202575850,11446
1505,v1801,20170502,5855,5810,5855,5870,5800,5840,5840,30,30,5516,161165900,12858
1506,v1801,20170503,5840,5840,5850,5895,5775,5775,5830,-65,-10,5086,148376400,12828
1507,v1801,20170504,5775,5830,5700,5720,5560,5610,5650,-220,-180,7950,224588200,13430
1508,v1801,20170505,5610,5650,5570,5640,5535,5610,5590,-40,-60,4596,128535650,13826
1509,v1801,20170508,5610,5590,5735,5735,5605,5635,5670,45,80,5234,148389450,14242
1510,v1801,20170509,5635,5670,5655,5785,5645,5765,5725,95,55,6828,195543550,13758
1511,v1801,20170510,5765,5725,5765,5820,5550,5590,5650,-135,-75,14816,418702400,14966
1512,v1801,20170511,5590,5650,5580,5760,5570,5735,5655,85,5,7674,217079150,14026
1513,v1801,20170512,5735,5655,5690,5720,5630,5675,5680,20,25,6420,182328750,13880
1514,v1801,20170515,5675,5680,5700,5905,5690,5880,5805,200,125,6758,196211850,13460
1515,v1801,20170516,5880,5805,5905,5965,5855,5965,5915,160,110,11414,337809700,12652
1516,v1801,20170517,5965,5915,5950,5965,5865,5950,5910,35,-5,7898,233515650,12292
1517,v1801,20170518,5950,5910,5950,6100,5865,6080,5990,170,80,11532,345491400,12844
1518,v1801,20170519,6080,5990,6150,6210,6090,6185,6135,195,145,6078,186443900,12390
1519,v1801,20170522,6185,6135,6225,6245,6110,6160,6190,25,55,9304,288084950,12108
1520,v1801,20170523,6160,6190,6190,6195,6070,6075,6135,-115,-55,8478,260263600,11388
1521,v1801,20170524,6075,6135,6085,6110,5830,5925,5930,-210,-205,17814,528209400,15796
1522,v1801,20170525,5925,5930,5905,6015,5860,5930,5930,0,0,13776,408645400,20146
1523,v1801,20170526,5930,5930,5885,5885,5780,5850,5835,-80,-95,11738,342625850,22426
1524,v1801,20170531,5850,5835,5835,5945,5810,5820,5885,-15,50,10026,295019800,22312
1525,v1801,20170601,5820,5885,5835,6025,5820,5975,5950,90,65,14542,432889650,25498
1526,v1801,20170602,5975,5950,5960,5985,5735,5755,5865,-195,-85,11190,328392950,27246
1527,v1801,20170605,5755,5865,5775,5810,5670,5700,5715,-165,-150,11006,314683400,30156
1528,v1801,20170606,5700,5715,5710,5765,5625,5715,5690,0,-25,6600,187933400,31018
1529,v1801,20170607,5715,5690,5735,5765,5680,5695,5715,5,25,6306,180233950,31606
1530,v1801,20170608,5695,5715,5630,5775,5630,5725,5710,10,-5,8714,248987100,31604
1531,v1801,20170609,5725,5710,5735,5760,5705,5730,5730,20,20,3756,107698450,31824
1532,v1801,20170612,5730,5730,5750,5895,5750,5885,5840,155,110,11332,331142200,31528
1533,v1801,20170613,5885,5840,5870,5905,5830,5855,5870,15,30,7710,226422300,31756
1534,v1801,20170614,5855,5870,5870,5880,5750,5800,5800,-70,-70,11080,321570850,33034
1535,v1801,20170615,5800,5800,5775,5815,5680,5720,5755,-80,-45,17944,516717950,37322
1536,v1801,20170616,5720,5755,5730,5785,5680,5710,5730,-45,-25,11334,324723050,40384
1537,v1801,20170619,5710,5730,5700,5740,5640,5665,5680,-65,-50,20424,580319750,43158
1538,v1801,20170620,5665,5680,5670,5675,5565,5630,5610,-50,-70,17302,485511300,48018
1539,v1801,20170621,5630,5610,5630,5720,5595,5690,5680,80,70,16016,454865100,49400
1540,v1801,20170622,5690,5680,5695,5720,5650,5675,5675,-5,-5,14242,404284550,49146
1541,v1801,20170623,5675,5675,5700,5820,5695,5805,5755,130,80,18736,539476050,48492
1542,v1801,20170626,5805,5755,5800,5870,5785,5860,5830,105,75,15674,456956050,47974
1543,v1801,20170627,5860,5830,5860,5925,5835,5925,5890,95,60,15186,447299300,45682
1544,v1801,20170628,5925,5890,5940,5950,5860,5915,5910,25,20,9542,282111950,45486
1545,v1801,20170629,5915,5910,5955,6205,5915,6065,6015,155,105,24000,721845750,50632
1546,v1801,20170630,6065,6015,6055,6110,6040,6065,6070,50,55,13094,397725000,52618
1547,v1801,20170703,6065,6070,6110,6155,6060,6095,6105,25,35,9414,287425350,53210
1548,v1801,20170704,6095,6105,6100,6145,5980,5985,6035,-120,-70,20814,628539600,57096
1549,v1801,20170705,5985,6035,6030,6160,6025,6075,6100,40,65,19232,586893800,60834
1550,v1801,20170706,6075,6100,6045,6160,6030,6155,6105,55,5,13594,414997650,63238
1551,v1801,20170707,6155,6105,6125,6275,6120,6260,6200,155,95,16374,507704500,60918
1552,v1801,20170710,6260,6200,6250,6315,6210,6250,6265,50,65,16274,509823900,62080
1553,v1801,20170711,6250,6265,6280,6385,6230,6290,6295,25,30,22278,701391950,64710
1554,v1801,20170712,6290,6295,6320,6345,6200,6235,6265,-60,-30,15426,483329700,62472
1555,v1801,20170713,6235,6265,6215,6345,6150,6280,6250,15,-15,20852,652031650,60496
1556,v1801,20170714,6280,6250,6280,6300,6195,6245,6240,-5,-10,12916,403178500,58940
1557,v1801,20170717,6245,6240,6295,6320,6210,6230,6255,-10,15,17120,535799400,58652
1558,v1801,20170718,6230,6255,6250,6340,6210,6335,6280,80,25,18766,589680250,58924
1559,v1801,20170719,6335,6280,6350,6445,6345,6430,6410,150,130,15474,495960350,58812
1560,v1801,20170720,6430,6410,6445,6720,6400,6550,6590,140,180,42298,1394158850,53940
1561,v1801,20170721,6550,6590,6510,6565,6420,6545,6470,-45,-120,36440,1179655950,52308
1562,v1801,20170724,6545,6470,6510,6595,6455,6525,6535,55,65,27120,886184000,54354
1563,v1801,20170725,6525,6535,6550,6680,6550,6655,6625,120,90,30432,1008506350,57562
1564,v1801,20170726,6655,6625,6710,6760,6510,6540,6630,-85,5,50762,1683154000,61282
1565,v1801,20170727,6540,6630,6580,6685,6535,6670,6625,40,-5,34736,1150963550,64112
1566,v1801,20170728,6670,6625,6680,6685,6540,6550,6615,-75,-10,39144,1295093000,64490
1567,v1801,20170731,6550,6615,6600,6650,6475,6625,6590,10,-25,49908,1645158600,68744
1568,v1801,20170801,6625,6590,6650,6730,6620,6670,6680,80,90,45726,1527744000,70012
1569,v1801,20170802,6670,6680,6640,6920,6640,6870,6815,190,135,87356,2977882900,74384
1570,v1801,20170803,6870,6815,6870,6950,6850,6885,6895,70,80,70736,2439504150,81932
1571,v1801,20170804,6885,6895,6900,7140,6900,7135,7060,240,165,96544,3408219100,94786
1572,v1801,20170807,7135,7060,7195,7255,6975,7225,7145,165,85,163648,5847650700,128348
1573,v1801,20170808,7225,7145,7270,7405,7215,7355,7310,210,165,185812,6796030550,158262
1574,v1801,20170809,7355,7310,7420,7495,7325,7400,7420,90,110,208618,7744161850,174554
1575,v1801,20170810,7400,7420,7385,7565,7340,7530,7440,110,20,253688,9441719650,198004
1576,v1801,20170811,7530,7440,7500,7580,7160,7265,7385,-175,-55,521004,19238442750,191004
1577,v1801,20170814,7265,7385,7295,7345,7210,7220,7270,-165,-115,244482,8891486900,196768
1578,v1801,20170815,7220,7270,7180,7205,6970,7035,7055,-235,-215,414068,14608970200,185404
1579,v1801,20170816,7035,7055,7010,7095,6955,7005,7025,-50,-30,317540,11156276550,183148
1580,v1801,20170817,7005,7025,7150,7240,7065,7120,7150,95,125,339058,12125826450,178016
1581,v1801,20170818,7120,7150,7095,7400,7090,7310,7300,160,150,456150,16658709350,193420
1582,v1801,20170821,7310,7300,7360,7450,7265,7360,7350,60,50,352964,12978924100,187204
1583,v1801,20170822,7360,7350,7350,7490,7255,7440,7380,90,30,402808,14867121550,178182
1584,v1801,20170823,7440,7380,7375,7380,7190,7265,7275,-115,-105,388382,14127932900,173444
1585,v1801,20170824,7265,7275,7320,7450,7315,7355,7370,80,95,293064,10804641300,168950
1586,v1801,20170825,7355,7370,7435,7555,7390,7480,7470,110,100,346118,12932306350,180350
1587,v1801,20170828,7480,7470,7355,7565,7310,7505,7470,35,0,346886,12959073100,206598
1588,v1801,20170829,7505,7470,7505,7610,7425,7510,7515,40,45,389646,14645930800,195880
1589,v1801,20170830,7510,7515,7470,7520,7390,7515,7455,0,-60,272602,10166853800,203592
1590,v1801,20170831,7515,7455,7460,7640,7450,7620,7560,165,105,357356,13515973150,226944
1591,v1801,20170901,7620,7560,7640,7845,7640,7835,7750,275,190,403984,15663259000,248666
1592,v1801,20170904,7835,7750,7950,7975,7730,7755,7820,5,70,329016,12872555500,224200
1593,v1801,20170905,7755,7820,7755,7890,7735,7880,7830,60,10,311304,12188445350,232082
1594,v1801,20170906,7880,7830,7815,7880,7740,7815,7810,-15,-20,328212,12820606450,235040
1595,v1801,20170907,7815,7810,7860,7920,7540,7625,7725,-185,-85,504480,19488473500,244150
1596,v1801,20170908,7625,7725,7640,7695,7525,7545,7605,-180,-120,405572,15424115150,255712
1597,v1801,20170911,7545,7605,7460,7565,7315,7550,7430,-55,-175,451948,16798833550,244518
1598,v1801,20170912,7550,7430,7650,7675,7510,7665,7600,235,170,367166,13958390850,234286
1599,v1801,20170913,7665,7600,7655,7685,7275,7345,7440,-255,-160,563038,20955407750,259764
1600,v1801,20170914,7345,7440,7365,7395,7250,7275,7320,-165,-120,402750,14748411550,253292
1601,v1801,20170915,7275,7320,7285,7305,7060,7140,7160,-180,-160,458612,16420465400,240010
1602,v1801,20170918,7140,7160,7120,7220,7060,7165,7140,5,-20,400300,14292197650,231264
1603,v1801,20170919,7165,7140,7180,7215,6990,7005,7105,-135,-35,369878,13148069800,232842
1604,v1801,20170920,7005,7105,7065,7075,6900,6940,6975,-165,-130,420004,14651446650,235132
1605,v1801,20170921,6940,6975,6915,6945,6730,6765,6800,-210,-175,432614,14713050050,238556
1606,v1801,20170922,6765,6800,6740,6800,6665,6755,6735,-45,-65,325788,10974764750,223586
1607,v1801,20170925,6755,6735,6770,6850,6650,6765,6740,30,5,385076,12977874500,217404
1608,v1801,20170926,6765,6740,6800,6875,6780,6855,6825,115,85,297104,10139019550,213322
1609,v1801,20170927,6855,6825,6890,6890,6820,6830,6845,5,20,204156,6990014800,206166
1610,v1801,20170928,6830,6845,6710,6715,6510,6620,6600,-225,-245,380936,12578881500,192868
1611,v1801,20170929,6620,6600,6680,6705,6595,6690,6640,90,40,187202,6217453450,184646
1612,v1801,20171009,6690,6640,6705,6795,6405,6450,6550,-190,-90,388798,12737736750,189608
1613,v1801,20171010,6450,6550,6465,6505,6360,6375,6435,-175,-115,278660,8968709650,206886
1614,v1801,20171011,6375,6435,6405,6505,6375,6390,6435,-45,0,323254,10405761700,195628
1615,v1801,20171012,6390,6435,6430,6435,6270,6420,6335,-15,-100,424482,13450951650,206624
1616,v1801,20171013,6420,6335,6435,6525,6410,6490,6465,155,130,386646,12500926200,201206
1617,v1801,20171016,6490,6465,6530,6565,6290,6410,6410,-55,-55,525660,16848772000,220956
1618,v1801,20171017,6410,6410,6365,6510,6275,6415,6430,5,20,515982,16598058600,233890
1619,v1801,20171018,6415,6430,6435,6490,6395,6420,6440,-10,10,291902,9402841150,229252
1620,v1801,20171019,6420,6440,6335,6390,6200,6315,6280,-125,-160,544066,17091697800,208156
1621,v1801,20171020,6315,6280,6360,6530,6300,6530,6430,250,150,481170,15477721300,222852
1622,v1801,20171023,6530,6430,6455,6540,6435,6490,6485,60,55,362916,11771567950,219538
1623,v1801,20171024,6490,6485,6525,6660,6500,6520,6585,35,100,479336,15792294550,231062
1624,v1801,20171025,6520,6585,6550,6625,6410,6460,6510,-125,-75,429528,13990905750,229442
1625,v1801,20171026,6460,6510,6450,6495,6405,6410,6435,-100,-75,369792,11905767400,227636
1626,v1801,20171027,6410,6435,6410,6500,6360,6435,6435,0,0,403426,12988632500,214952
1627,v1801,20171030,6435,6435,6475,6620,6455,6580,6555,145,120,451188,14794426950,232016
1628,v1801,20171031,6580,6555,6570,6575,6305,6340,6405,-215,-150,485284,15543920600,207838
1629,v1801,20171101,6340,6405,6355,6420,6220,6235,6335,-170,-70,415744,13173387250,201478
1630,v1801,20171102,6235,6335,6310,6370,6245,6325,6305,-10,-30,443900,13998740050,203860
1631,v1801,20171103,6325,6305,6330,6380,6280,6315,6330,10,25,326456,10335114500,209068
1632,v1801,20171106,6315,6330,6360,6490,6325,6455,6420,125,90,467160,15003181350,214096
1633,v1801,20171107,6455,6420,6490,6525,6420,6460,6465,40,45,382910,12378107950,238614
1634,v1801,20171108,6460,6465,6420,6475,6380,6435,6430,-30,-35,329692,10601995550,237158
1635,v1801,20171109,6435,6430,6485,6580,6355,6380,6470,-50,40,602970,19509859350,241386
1636,v1801,20171110,6380,6470,6375,6470,6375,6410,6425,-60,-45,422588,13581163300,234002
1637,v1801,20171113,6410,6425,6430,6430,6300,6375,6355,-50,-70,393456,12502207350,241290
1638,v1801,20171114,6375,6355,6390,6405,6315,6320,6350,-35,-5,315584,10026888350,242808
1639,v1801,20171115,6320,6350,6190,6235,6035,6035,6120,-315,-230,506230,15498650750,251366
1640,v1801,20171116,6035,6120,6010,6040,5905,5930,5965,-190,-155,423256,12632835250,264542
1641,v1801,20171117,5930,5965,5920,6050,5920,6005,5980,40,15,372880,11156751700,241548
1642,v1801,20171120,6005,5980,6045,6070,5975,6015,6025,35,45,362932,10938443650,238296
1643,v1801,20171121,6015,6025,6015,6085,5960,5990,6015,-35,-10,394130,11861551000,246976
1644,v1801,20171122,5990,6015,6020,6245,6010,6220,6145,205,130,608038,18686018300,223916
1645,v1801,20171123,6220,6145,6260,6350,6235,6270,6290,125,145,423520,13325093750,202892
1646,v1801,20171124,6270,6290,6310,6340,6215,6290,6280,0,-10,288396,9057837600,192064
1647,v1801,20171127,6290,6280,6300,6370,6070,6140,6250,-140,-30,541072,16917696700,167526
1648,v1801,20171128,6140,6250,6105,6185,6105,6155,6145,-95,-105,290028,8913695400,161354
1649,v1801,20171129,6155,6145,6135,6195,6115,6155,6155,10,10,236084,7270995450,156934
1650,v1801,20171130,6155,6155,6180,6240,6020,6105,6120,-50,-35,345444,10578166900,124258
1651,v1801,20171201,6105,6120,6120,6220,6085,6205,6155,85,35,140150,4315260350,105202
1652,v1801,20171204,6205,6155,6320,6395,6250,6350,6315,195,160,130848,4132305750,84926
1653,v1801,20171205,6350,6315,6395,6455,6305,6325,6395,10,80,79076,2529411800,68402
1654,v1801,20171206,6325,6395,6310,6495,6300,6495,6400,100,5,55436,1774713200,61260
1655,v1801,20171207,6495,6400,6430,6520,6270,6350,6420,-50,20,77232,2480695550,50186
1656,v1801,20171208,6350,6420,6395,6710,6370,6635,6575,215,155,76762,2523643700,50846
1657,v1801,20171211,6635,6575,6620,6710,6580,6650,6640,75,65,35184,1168852000,47064
1658,v1801,20171212,6650,6640,6695,6720,6605,6645,6655,5,15,26558,883798800,44530
1659,v1801,20171213,6645,6655,6645,6670,6515,6575,6560,-80,-95,23806,781094550,41080
1660,v1801,20171214,6575,6560,6575,6660,6525,6535,6595,-25,35,24284,801068450,37872
1661,v1801,20171215,6535,6595,6505,6580,6470,6545,6535,-50,-60,16580,542002050,35826
1662,v1801,20171218,6545,6535,6640,6665,6555,6575,6595,40,60,19810,653606800,33942
1663,v1801,20171219,6575,6595,6595,6680,6560,6615,6630,20,35,20288,672673800,30610
1664,v1801,20171220,6615,6630,6630,6680,6600,6615,6640,-15,10,16614,551977750,28612
1665,v1801,20171221,6615,6640,6620,6620,6460,6465,6535,-175,-105,20316,663849800,20822
1666,v1801,20171222,6465,6535,6480,6530,6435,6530,6480,-5,-55,8660,280702800,18768
1667,v1801,20171225,6530,6480,6480,6570,6400,6445,6480,-35,0,7962,257979600,17220
1668,v1801,20171226,6445,6480,6480,6600,6415,6550,6505,70,25,4750,154587050,15982
1669,v1801,20171227,6550,6505,6560,6600,6455,6465,6535,-40,30,4138,135303300,13878
1670,v1801,20171228,6465,6535,6485,6510,6450,6455,6470,-80,-65,974,31511950,13294
1671,v1801,20171229,6455,6470,6460,6730,6455,6470,6485,0,15,1396,45289250,12324
1672,v1802,20170217,6705,6705,0,0,0,6680,6680,-25,-25,0,0,0
1673,v1802,20170220,6680,6680,0,0,0,6695,6695,15,15,0,0,0
1674,v1802,20170221,6695,6695,0,0,0,6605,6605,-90,-90,0,0,0
1675,v1802,20170222,6605,6605,0,0,0,6580,6580,-25,-25,0,0,0
1676,v1802,20170223,6580,6580,0,0,0,6460,6460,-120,-120,0,0,0
1677,v1802,20170224,6460,6460,0,0,0,6445,6445,-15,-15,0,0,0
1678,v1802,20170227,6445,6445,0,0,0,6590,6590,145,145,0,0,0
1679,v1802,20170228,6590,6590,0,0,0,6575,6575,-15,-15,0,0,0
1680,v1802,20170301,6575,6575,0,0,0,6505,6505,-70,-70,0,0,0
1681,v1802,20170302,6505,6505,0,0,0,6490,6490,-15,-15,0,0,0
1682,v1802,20170303,6490,6490,0,0,0,6620,6620,130,130,0,0,0
1683,v1802,20170306,6620,6620,0,0,0,6715,6715,95,95,0,0,0
1684,v1802,20170307,6715,6715,0,0,0,6730,6730,15,15,0,0,0
1685,v1802,20170308,6730,6730,0,0,0,6580,6580,-150,-150,0,0,0
1686,v1802,20170309,6580,6580,0,0,0,6445,6445,-135,-135,0,0,0
1687,v1802,20170310,6445,6445,0,0,0,6490,6490,45,45,0,0,0
1688,v1802,20170313,6490,6490,0,0,0,6420,6420,-70,-70,0,0,0
1689,v1802,20170314,6420,6420,0,0,0,6510,6510,90,90,0,0,0
1690,v1802,20170315,6510,6510,0,0,0,6640,6640,130,130,0,0,0
1691,v1802,20170316,6640,6640,0,0,0,6660,6660,20,20,0,0,0
1692,v1802,20170317,6660,6660,0,0,0,6700,6700,40,40,0,0,0
1693,v1802,20170320,6700,6700,0,0,0,6650,6650,-50,-50,0,0,0
1694,v1802,20170321,6650,6650,0,0,0,6555,6555,-95,-95,0,0,0
1695,v1802,20170322,6555,6555,0,0,0,6405,6405,-150,-150,0,0,0
1696,v1802,20170323,6405,6405,0,0,0,6375,6375,-30,-30,0,0,0
1697,v1802,20170324,6375,6375,0,0,0,6355,6355,-20,-20,0,0,0
1698,v1802,20170327,6355,6355,0,0,0,6195,6195,-160,-160,0,0,0
1699,v1802,20170328,6195,6195,0,0,0,6185,6185,-10,-10,0,0,0
1700,v1802,20170329,6185,6185,5695,6450,5695,6450,6070,265,-115,4,121450,0
1701,v1802,20170330,6450,6070,0,0,0,6015,6015,-55,-55,0,0,0
1702,v1802,20170331,6015,6015,0,0,0,5960,5960,-55,-55,0,0,0
1703,v1802,20170405,5960,5960,0,0,0,6005,6005,45,45,0,0,0
1704,v1802,20170406,6005,6005,0,0,0,6015,6015,10,10,0,0,0
1705,v1802,20170407,6015,6015,0,0,0,5900,5900,-115,-115,0,0,0
1706,v1802,20170410,5900,5900,0,0,0,5830,5830,-70,-70,0,0,0
1707,v1802,20170411,5830,5830,0,0,0,5840,5840,10,10,0,0,0
1708,v1802,20170412,5840,5840,0,0,0,5740,5740,-100,-100,0,0,0
1709,v1802,20170413,5740,5740,0,0,0,5620,5620,-120,-120,0,0,0
1710,v1802,20170414,5620,5620,0,0,0,5480,5480,-140,-140,0,0,0
1711,v1802,20170417,5480,5480,0,0,0,5465,5465,-15,-15,0,0,0
1712,v1802,20170418,5465,5465,0,0,0,5390,5390,-75,-75,0,0,0
1713,v1802,20170419,5390,5390,0,0,0,5320,5320,-70,-70,0,0,0
1714,v1802,20170420,5320,5320,0,0,0,5350,5350,30,30,0,0,0
1715,v1802,20170421,5350,5350,0,0,0,5480,5480,130,130,0,0,0
1716,v1802,20170424,5480,5480,0,0,0,5390,5390,-90,-90,0,0,0
1717,v1802,20170425,5390,5390,0,0,0,5410,5410,20,20,0,0,0
1718,v1802,20170426,5410,5410,0,0,0,5400,5400,-10,-10,0,0,0
1719,v1802,20170427,5400,5400,0,0,0,5470,5470,70,70,0,0,0
1720,v1802,20170428,5470,5470,0,0,0,5655,5655,185,185,0,0,0
1721,v1802,20170502,5655,5655,0,0,0,5680,5680,25,25,0,0,0
1722,v1802,20170503,5680,5680,0,0,0,5675,5675,-5,-5,0,0,0
1723,v1802,20170504,5675,5675,0,0,0,5500,5500,-175,-175,0,0,0
1724,v1802,20170505,5500,5500,0,0,0,5445,5445,-55,-55,0,0,0
1725,v1802,20170508,5445,5445,0,0,0,5520,5520,75,75,0,0,0
1726,v1802,20170509,5520,5520,0,0,0,5570,5570,50,50,0,0,0
1727,v1802,20170510,5570,5570,0,0,0,5500,5500,-70,-70,0,0,0
1728,v1802,20170511,5500,5500,0,0,0,5500,5500,0,0,0,0,0
1729,v1802,20170512,5500,5500,0,0,0,5520,5520,20,20,0,0,0
1730,v1802,20170515,5520,5520,0,0,0,5640,5640,120,120,0,0,0
1731,v1802,20170516,5640,5640,0,0,0,5745,5745,105,105,0,0,0
1732,v1802,20170517,5745,5745,0,0,0,5745,5745,0,0,0,0,0
1733,v1802,20170518,5745,5745,0,0,0,5820,5820,75,75,0,0,0
1734,v1802,20170519,5820,5820,0,0,0,5960,5960,140,140,0,0,0
1735,v1802,20170522,5960,5960,0,0,0,6010,6010,50,50,0,0,0
1736,v1802,20170523,6010,6010,0,0,0,5960,5960,-50,-50,0,0,0
1737,v1802,20170524,5960,5960,0,0,0,5765,5765,-195,-195,0,0,0
1738,v1802,20170525,5765,5765,0,0,0,5765,5765,0,0,0,0,0
1739,v1802,20170526,5765,5765,0,0,0,5675,5675,-90,-90,0,0,0
1740,v1802,20170531,5675,5675,0,0,0,5720,5720,45,45,0,0,0
1741,v1802,20170601,5720,5720,0,0,0,5780,5780,60,60,0,0,0
1742,v1802,20170602,5780,5780,0,0,0,5700,5700,-80,-80,0,0,0
1743,v1802,20170605,5700,5700,0,0,0,5555,5555,-145,-145,0,0,0
1744,v1802,20170606,5555,5555,0,0,0,5535,5535,-20,-20,0,0,0
1745,v1802,20170607,5535,5535,0,0,0,5555,5555,20,20,0,0,0
1746,v1802,20170608,5555,5555,0,0,0,5555,5555,0,0,0,0,0
1747,v1802,20170609,5555,5555,0,0,0,5570,5570,15,15,0,0,0
1748,v1802,20170612,5570,5570,0,0,0,5675,5675,105,105,0,0,0
1749,v1802,20170613,5675,5675,0,0,0,5700,5700,25,25,0,0,0
1750,v1802,20170614,5700,5700,0,0,0,5635,5635,-65,-65,0,0,0
1751,v1802,20170615,5635,5635,0,0,0,5595,5595,-40,-40,0,0,0
1752,v1802,20170616,5595,5595,0,0,0,5575,5575,-20,-20,0,0,0
1753,v1802,20170619,5575,5575,0,0,0,5530,5530,-45,-45,0,0,0
1754,v1802,20170620,5530,5530,0,0,0,5465,5465,-65,-65,0,0,0
1755,v1802,20170621,5465,5465,0,0,0,5530,5530,65,65,0,0,0
1756,v1802,20170622,5530,5530,0,0,0,5530,5530,0,0,0,0,0
1757,v1802,20170623,5530,5530,0,0,0,5605,5605,75,75,0,0,0
1758,v1802,20170626,5605,5605,0,0,0,5675,5675,70,70,0,0,0
1759,v1802,20170627,5675,5675,0,0,0,5730,5730,55,55,0,0,0
1760,v1802,20170628,5730,5730,0,0,0,5745,5745,15,15,0,0,0
1761,v1802,20170629,5745,5745,0,0,0,5845,5845,100,100,0,0,0
1762,v1802,20170630,5845,5845,0,0,0,5895,5895,50,50,0,0,0
1763,v1802,20170703,5895,5895,0,0,0,5925,5925,30,30,0,0,0
1764,v1802,20170704,5925,5925,0,0,0,5860,5860,-65,-65,0,0,0
1765,v1802,20170705,5860,5860,0,0,0,5920,5920,60,60,0,0,0
1766,v1802,20170706,5920,5920,0,0,0,5920,5920,0,0,0,0,0
1767,v1802,20170707,5920,5920,6215,6215,6215,6215,6215,295,295,2,62150,2
1768,v1802,20170710,6215,6215,0,0,0,6280,6280,65,65,0,0,2
1769,v1802,20170711,6280,6280,0,0,0,6310,6310,30,30,0,0,2
1770,v1802,20170712,6310,6310,0,0,0,6280,6280,-30,-30,0,0,2
1771,v1802,20170713,6280,6280,0,0,0,6265,6265,-15,-15,0,0,2
1772,v1802,20170714,6265,6265,0,0,0,6255,6255,-10,-10,0,0,2
1773,v1802,20170717,6255,6255,0,0,0,6270,6270,15,15,0,0,2
1774,v1802,20170718,6270,6270,0,0,0,6295,6295,25,25,0,0,2
1775,v1802,20170719,6295,6295,0,0,0,6425,6425,130,130,0,0,2
1776,v1802,20170720,6425,6425,0,0,0,6605,6605,180,180,0,0,2
1777,v1802,20170721,6605,6605,0,0,0,6485,6485,-120,-120,0,0,2
1778,v1802,20170724,6485,6485,0,0,0,6550,6550,65,65,0,0,2
1779,v1802,20170725,6550,6550,0,0,0,6640,6640,90,90,0,0,2
1780,v1802,20170726,6640,6640,0,0,0,6645,6645,5,5,0,0,2
1781,v1802,20170727,6645,6645,0,0,0,6640,6640,-5,-5,0,0,2
1782,v1802,20170728,6640,6640,0,0,0,6630,6630,-10,-10,0,0,2
1783,v1802,20170731,6630,6630,0,0,0,6605,6605,-25,-25,0,0,2
1784,v1802,20170801,6605,6605,0,0,0,6695,6695,90,90,0,0,2
1785,v1802,20170802,6695,6695,0,0,0,6830,6830,135,135,0,0,2
1786,v1802,20170803,6830,6830,0,0,0,6910,6910,80,80,0,0,2
1787,v1802,20170804,6910,6910,0,0,0,7075,7075,165,165,0,0,2
1788,v1802,20170807,7075,7075,0,0,0,7160,7160,85,85,0,0,2
1789,v1802,20170808,7160,7160,0,0,0,7325,7325,165,165,0,0,2
1790,v1802,20170809,7325,7325,0,0,0,7435,7435,110,110,0,0,2
1791,v1802,20170810,7435,7435,0,0,0,7455,7455,20,20,0,0,2
1792,v1802,20170811,7455,7455,0,0,0,7400,7400,-55,-55,0,0,2
1793,v1802,20170814,7400,7400,0,0,0,7285,7285,-115,-115,0,0,2
1794,v1802,20170815,7285,7285,0,0,0,7070,7070,-215,-215,0,0,2
1795,v1802,20170816,7070,7070,0,0,0,7040,7040,-30,-30,0,0,2
1796,v1802,20170817,7040,7040,0,0,0,7165,7165,125,125,0,0,2
1797,v1802,20170818,7165,7165,0,0,0,7315,7315,150,150,0,0,2
1798,v1802,20170821,7315,7315,0,0,0,7365,7365,50,50,0,0,2
1799,v1802,20170822,7365,7365,0,0,0,7395,7395,30,30,0,0,2
1800,v1802,20170823,7395,7395,0,0,0,7290,7290,-105,-105,0,0,2
1801,v1802,20170824,7290,7290,0,0,0,7385,7385,95,95,0,0,2
1802,v1802,20170825,7385,7385,0,0,0,7485,7485,100,100,0,0,2
1803,v1802,20170828,7485,7485,0,0,0,7485,7485,0,0,0,0,2
1804,v1802,20170829,7485,7485,0,0,0,7530,7530,45,45,0,0,2
1805,v1802,20170830,7530,7530,0,0,0,7470,7470,-60,-60,0,0,2
1806,v1802,20170831,7470,7470,0,0,0,7575,7575,105,105,0,0,2
1807,v1802,20170901,7575,7575,7520,7815,7520,7815,7665,240,90,8,306700,2
1808,v1802,20170904,7815,7665,0,0,0,7730,7730,65,65,0,0,2
1809,v1802,20170905,7730,7730,0,0,0,7735,7735,5,5,0,0,2
1810,v1802,20170906,7735,7735,0,0,0,7720,7720,-15,-15,0,0,2
1811,v1802,20170907,7720,7720,7340,7625,7340,7625,7480,-95,-240,4,149650,2
1812,v1802,20170908,7625,7480,0,0,0,7365,7365,-115,-115,0,0,2
1813,v1802,20170911,7365,7365,0,0,0,7200,7200,-165,-165,0,0,2
1814,v1802,20170912,7200,7200,0,0,0,7360,7360,160,160,0,0,2
1815,v1802,20170913,7360,7360,0,0,0,7210,7210,-150,-150,0,0,2
1816,v1802,20170914,7210,7210,7110,7430,7110,7430,7270,220,60,8,290800,2
1817,v1802,20170915,7430,7270,0,0,0,7115,7115,-155,-155,0,0,2
1818,v1802,20170918,7115,7115,0,0,0,7100,7100,-15,-15,0,0,2
1819,v1802,20170919,7100,7100,0,0,0,7070,7070,-30,-30,0,0,2
1820,v1802,20170920,7070,7070,0,0,0,6945,6945,-125,-125,0,0,2
1821,v1802,20170921,6945,6945,0,0,0,6775,6775,-170,-170,0,0,2
1822,v1802,20170922,6775,6775,0,0,0,6715,6715,-60,-60,0,0,2
1823,v1802,20170925,6715,6715,0,0,0,6715,6715,0,0,0,0,2
1824,v1802,20170926,6715,6715,0,0,0,6795,6795,80,80,0,0,2
1825,v1802,20170927,6795,6795,0,0,0,6810,6810,15,15,0,0,2
1826,v1802,20170928,6810,6810,0,0,0,6570,6570,-240,-240,0,0,2
1827,v1802,20170929,6570,6570,0,0,0,6605,6605,35,35,0,0,2
1828,v1802,20171009,6605,6605,0,0,0,6520,6520,-85,-85,0,0,2
1829,v1802,20171010,6520,6520,0,0,0,6410,6410,-110,-110,0,0,2
1830,v1802,20171011,6410,6410,0,0,0,6410,6410,0,0,0,0,2
1831,v1802,20171012,6410,6410,0,0,0,6315,6315,-95,-95,0,0,2
1832,v1802,20171013,6315,6315,0,0,0,6440,6440,125,125,0,0,2
1833,v1802,20171016,6440,6440,6375,6375,6375,6375,6375,-65,-65,2,63750,4
1834,v1802,20171017,6375,6375,6430,6430,6430,6430,6430,55,55,2,64300,4
1835,v1802,20171018,6430,6430,0,0,0,6435,6435,5,5,0,0,4
1836,v1802,20171019,6435,6435,0,0,0,6280,6280,-155,-155,0,0,4
1837,v1802,20171020,6280,6280,6315,6315,6315,6315,6315,35,35,2,63150,2
1838,v1802,20171023,6315,6315,0,0,0,6365,6365,50,50,0,0,2
1839,v1802,20171024,6365,6365,0,0,0,6460,6460,95,95,0,0,2
1840,v1802,20171025,6460,6460,0,0,0,6390,6390,-70,-70,0,0,2
1841,v1802,20171026,6390,6390,0,0,0,6320,6320,-70,-70,0,0,2
1842,v1802,20171027,6320,6320,0,0,0,6320,6320,0,0,0,0,2
1843,v1802,20171030,6320,6320,0,0,0,6435,6435,115,115,0,0,2
1844,v1802,20171031,6435,6435,0,0,0,6290,6290,-145,-145,0,0,2
1845,v1802,20171101,6290,6290,0,0,0,6225,6225,-65,-65,0,0,2
1846,v1802,20171102,6225,6225,0,0,0,6200,6200,-25,-25,0,0,2
1847,v1802,20171103,6200,6200,0,0,0,6220,6220,20,20,0,0,2
1848,v1802,20171106,6220,6220,6470,6470,6390,6395,6430,175,210,8,257250,2
1849,v1802,20171107,6395,6430,0,0,0,6475,6475,45,45,0,0,2
1850,v1802,20171108,6475,6475,0,0,0,6440,6440,-35,-35,0,0,2
1851,v1802,20171109,6440,6440,0,0,0,6480,6480,40,40,0,0,2
1852,v1802,20171110,6480,6480,0,0,0,6435,6435,-45,-45,0,0,2
1853,v1802,20171113,6435,6435,0,0,0,6365,6365,-70,-70,0,0,2
1854,v1802,20171114,6365,6365,6415,6415,6245,6245,6330,-120,-35,4,126600,4
1855,v1802,20171115,6245,6330,6030,6030,6030,6030,6030,-300,-300,2,60300,4
1856,v1802,20171116,6030,6030,0,0,0,5880,5880,-150,-150,0,0,4
1857,v1802,20171117,5880,5880,0,0,0,5890,5890,10,10,0,0,4
1858,v1802,20171120,5890,5890,0,0,0,5930,5930,40,40,0,0,4
1859,v1802,20171121,5930,5930,0,0,0,5925,5925,-5,-5,0,0,4
1860,v1802,20171122,5925,5925,0,0,0,6050,6050,125,125,0,0,4
1861,v1802,20171123,6050,6050,6140,6140,6140,6140,6140,90,90,2,61400,4
1862,v1802,20171124,6140,6140,0,0,0,6135,6135,-5,-5,0,0,4
1863,v1802,20171127,6135,6135,0,0,0,6110,6110,-25,-25,0,0,4
1864,v1802,20171128,6110,6110,0,0,0,6010,6010,-100,-100,0,0,4
1865,v1802,20171129,6010,6010,6160,6195,6110,6175,6170,165,160,22,678750,10
1866,v1802,20171130,6175,6170,6180,6180,5995,5995,6085,-175,-85,4,121750,10
1867,v1802,20171201,5995,6085,0,0,0,6085,6085,0,0,0,0,10
1868,v1802,20171204,6085,6085,6150,6285,6150,6285,6170,200,85,12,370350,8
1869,v1802,20171205,6285,6170,6320,6320,6320,6320,6320,150,150,2,63200,8
1870,v1802,20171206,6320,6320,0,0,0,6320,6320,0,0,0,0,8
1871,v1802,20171207,6320,6320,0,0,0,6335,6335,15,15,0,0,8
1872,v1802,20171208,6335,6335,0,0,0,6485,6485,150,150,0,0,8
1873,v1802,20171211,6485,6485,0,0,0,6545,6545,60,60,0,0,8
1874,v1802,20171212,6545,6545,0,0,0,6555,6555,10,10,0,0,8
1875,v1802,20171213,6555,6555,6410,6410,6410,6410,6410,-145,-145,4,128200,4
1876,v1802,20171214,6410,6410,0,0,0,6440,6440,30,30,0,0,4
1877,v1802,20171215,6440,6440,0,0,0,6385,6385,-55,-55,0,0,4
1878,v1802,20171218,6385,6385,0,0,0,6440,6440,55,55,0,0,4
1879,v1802,20171219,6440,6440,0,0,0,6470,6470,30,30,0,0,4
1880,v1802,20171220,6470,6470,0,0,0,6475,6475,5,5,0,0,4
1881,v1802,20171221,6475,6475,0,0,0,6375,6375,-100,-100,0,0,4
1882,v1802,20171222,6375,6375,0,0,0,6325,6325,-50,-50,0,0,4
1883,v1802,20171225,6325,6325,0,0,0,6325,6325,0,0,0,0,4
1884,v1802,20171226,6325,6325,0,0,0,6345,6345,20,20,0,0,4
1885,v1802,20171227,6345,6345,0,0,0,6370,6370,25,25,0,0,4
1886,v1802,20171228,6370,6370,0,0,0,6310,6310,-60,-60,0,0,4
1887,v1802,20171229,6310,6310,0,0,0,6320,6320,10,10,0,0,4
1888,v1803,20170315,6510,6510,0,0,0,6640,6640,130,130,0,0,0
1889,v1803,20170316,6640,6640,0,0,0,6660,6660,20,20,0,0,0
1890,v1803,20170317,6660,6660,0,0,0,6700,6700,40,40,0,0,0
1891,v1803,20170320,6700,6700,0,0,0,6650,6650,-50,-50,0,0,0
1892,v1803,20170321,6650,6650,0,0,0,6555,6555,-95,-95,0,0,0
1893,v1803,20170322,6555,6555,0,0,0,6405,6405,-150,-150,0,0,0
1894,v1803,20170323,6405,6405,0,0,0,6375,6375,-30,-30,0,0,0
1895,v1803,20170324,6375,6375,0,0,0,6355,6355,-20,-20,0,0,0
1896,v1803,20170327,6355,6355,0,0,0,6195,6195,-160,-160,0,0,0
1897,v1803,20170328,6195,6195,0,0,0,6185,6185,-10,-10,0,0,0
1898,v1803,20170329,6185,6185,0,0,0,6075,6075,-110,-110,0,0,0
1899,v1803,20170330,6075,6075,0,0,0,6020,6020,-55,-55,0,0,0
1900,v1803,20170331,6020,6020,0,0,0,5965,5965,-55,-55,0,0,0
1901,v1803,20170405,5965,5965,0,0,0,6010,6010,45,45,0,0,0
1902,v1803,20170406,6010,6010,0,0,0,6020,6020,10,10,0,0,0
1903,v1803,20170407,6020,6020,0,0,0,5905,5905,-115,-115,0,0,0
1904,v1803,20170410,5905,5905,0,0,0,5835,5835,-70,-70,0,0,0
1905,v1803,20170411,5835,5835,0,0,0,5845,5845,10,10,0,0,0
1906,v1803,20170412,5845,5845,0,0,0,5745,5745,-100,-100,0,0,0
1907,v1803,20170413,5745,5745,0,0,0,5625,5625,-120,-120,0,0,0
1908,v1803,20170414,5625,5625,0,0,0,5485,5485,-140,-140,0,0,0
1909,v1803,20170417,5485,5485,0,0,0,5470,5470,-15,-15,0,0,0
1910,v1803,20170418,5470,5470,0,0,0,5395,5395,-75,-75,0,0,0
1911,v1803,20170419,5395,5395,0,0,0,5325,5325,-70,-70,0,0,0
1912,v1803,20170420,5325,5325,0,0,0,5355,5355,30,30,0,0,0
1913,v1803,20170421,5355,5355,0,0,0,5485,5485,130,130,0,0,0
1914,v1803,20170424,5485,5485,0,0,0,5395,5395,-90,-90,0,0,0
1915,v1803,20170425,5395,5395,0,0,0,5415,5415,20,20,0,0,0
1916,v1803,20170426,5415,5415,0,0,0,5405,5405,-10,-10,0,0,0
1917,v1803,20170427,5405,5405,0,0,0,5475,5475,70,70,0,0,0
1918,v1803,20170428,5475,5475,0,0,0,5665,5665,190,190,0,0,0
1919,v1803,20170502,5665,5665,0,0,0,5690,5690,25,25,0,0,0
1920,v1803,20170503,5690,5690,0,0,0,5685,5685,-5,-5,0,0,0
1921,v1803,20170504,5685,5685,0,0,0,5510,5510,-175,-175,0,0,0
1922,v1803,20170505,5510,5510,0,0,0,5455,5455,-55,-55,0,0,0
1923,v1803,20170508,5455,5455,0,0,0,5530,5530,75,75,0,0,0
1924,v1803,20170509,5530,5530,0,0,0,5580,5580,50,50,0,0,0
1925,v1803,20170510,5580,5580,0,0,0,5510,5510,-70,-70,0,0,0
1926,v1803,20170511,5510,5510,0,0,0,5510,5510,0,0,0,0,0
1927,v1803,20170512,5510,5510,0,0,0,5530,5530,20,20,0,0,0
1928,v1803,20170515,5530,5530,0,0,0,5650,5650,120,120,0,0,0
1929,v1803,20170516,5650,5650,0,0,0,5755,5755,105,105,0,0,0
1930,v1803,20170517,5755,5755,0,0,0,5755,5755,0,0,0,0,0
1931,v1803,20170518,5755,5755,0,0,0,5830,5830,75,75,0,0,0
1932,v1803,20170519,5830,5830,0,0,0,5970,5970,140,140,0,0,0
1933,v1803,20170522,5970,5970,0,0,0,6020,6020,50,50,0,0,0
1934,v1803,20170523,6020,6020,0,0,0,5970,5970,-50,-50,0,0,0
1935,v1803,20170524,5970,5970,0,0,0,5775,5775,-195,-195,0,0,0
1936,v1803,20170525,5775,5775,0,0,0,5775,5775,0,0,0,0,0
1937,v1803,20170526,5775,5775,0,0,0,5685,5685,-90,-90,0,0,0
1938,v1803,20170531,5685,5685,0,0,0,5730,5730,45,45,0,0,0
1939,v1803,20170601,5730,5730,0,0,0,5790,5790,60,60,0,0,0
1940,v1803,20170602,5790,5790,0,0,0,5710,5710,-80,-80,0,0,0
1941,v1803,20170605,5710,5710,0,0,0,5565,5565,-145,-145,0,0,0
1942,v1803,20170606,5565,5565,0,0,0,5545,5545,-20,-20,0,0,0
1943,v1803,20170607,5545,5545,0,0,0,5565,5565,20,20,0,0,0
1944,v1803,20170608,5565,5565,0,0,0,5565,5565,0,0,0,0,0
1945,v1803,20170609,5565,5565,0,0,0,5580,5580,15,15,0,0,0
1946,v1803,20170612,5580,5580,0,0,0,5685,5685,105,105,0,0,0
1947,v1803,20170613,5685,5685,0,0,0,5710,5710,25,25,0,0,0
1948,v1803,20170614,5710,5710,0,0,0,5645,5645,-65,-65,0,0,0
1949,v1803,20170615,5645,5645,0,0,0,5605,5605,-40,-40,0,0,0
1950,v1803,20170616,5605,5605,0,0,0,5585,5585,-20,-20,0,0,0
1951,v1803,20170619,5585,5585,0,0,0,5540,5540,-45,-45,0,0,0
1952,v1803,20170620,5540,5540,0,0,0,5540,5540,0,0,0,0,0
1953,v1803,20170621,5540,5540,0,0,0,5605,5605,65,65,0,0,0
1954,v1803,20170622,5605,5605,0,0,0,5605,5605,0,0,0,0,0
1955,v1803,20170623,5605,5605,0,0,0,5680,5680,75,75,0,0,0
1956,v1803,20170626,5680,5680,0,0,0,5750,5750,70,70,0,0,0
1957,v1803,20170627,5750,5750,0,0,0,5805,5805,55,55,0,0,0
1958,v1803,20170628,5805,5805,0,0,0,5820,5820,15,15,0,0,0
1959,v1803,20170629,5820,5820,0,0,0,5920,5920,100,100,0,0,0
1960,v1803,20170630,5920,5920,0,0,0,5970,5970,50,50,0,0,0
1961,v1803,20170703,5970,5970,0,0,0,5970,5970,0,0,0,0,0
1962,v1803,20170704,5970,5970,0,0,0,5905,5905,-65,-65,0,0,0
1963,v1803,20170705,5905,5905,0,0,0,5965,5965,60,60,0,0,0
1964,v1803,20170706,5965,5965,0,0,0,5965,5965,0,0,0,0,0
1965,v1803,20170707,5965,5965,0,0,0,6260,6260,295,295,0,0,0
1966,v1803,20170710,6260,6260,0,0,0,6325,6325,65,65,0,0,0
1967,v1803,20170711,6325,6325,0,0,0,6355,6355,30,30,0,0,0
1968,v1803,20170712,6355,6355,0,0,0,6325,6325,-30,-30,0,0,0
1969,v1803,20170713,6325,6325,6340,6370,6250,6280,6300,-45,-25,16,504300,0
1970,v1803,20170714,6280,6300,0,0,0,6290,6290,-10,-10,0,0,0
1971,v1803,20170717,6290,6290,0,0,0,6305,6305,15,15,0,0,0
1972,v1803,20170718,6305,6305,0,0,0,6330,6330,25,25,0,0,0
1973,v1803,20170719,6330,6330,0,0,0,6460,6460,130,130,0,0,0
1974,v1803,20170720,6460,6460,0,0,0,6640,6640,180,180,0,0,0
1975,v1803,20170721,6640,6640,0,0,0,6520,6520,-120,-120,0,0,0
1976,v1803,20170724,6520,6520,0,0,0,6585,6585,65,65,0,0,0
1977,v1803,20170725,6585,6585,0,0,0,6675,6675,90,90,0,0,0
1978,v1803,20170726,6675,6675,0,0,0,6680,6680,5,5,0,0,0
1979,v1803,20170727,6680,6680,0,0,0,6675,6675,-5,-5,0,0,0
1980,v1803,20170728,6675,6675,0,0,0,6665,6665,-10,-10,0,0,0
1981,v1803,20170731,6665,6665,0,0,0,6640,6640,-25,-25,0,0,0
1982,v1803,20170801,6640,6640,0,0,0,6730,6730,90,90,0,0,0
1983,v1803,20170802,6730,6730,0,0,0,6865,6865,135,135,0,0,0
1984,v1803,20170803,6865,6865,0,0,0,6945,6945,80,80,0,0,0
1985,v1803,20170804,6945,6945,0,0,0,7110,7110,165,165,0,0,0
1986,v1803,20170807,7110,7110,0,0,0,7195,7195,85,85,0,0,0
1987,v1803,20170808,7195,7195,0,0,0,7360,7360,165,165,0,0,0
1988,v1803,20170809,7360,7360,0,0,0,7470,7470,110,110,0,0,0
1989,v1803,20170810,7470,7470,0,0,0,7490,7490,20,20,0,0,0
1990,v1803,20170811,7490,7490,0,0,0,7435,7435,-55,-55,0,0,0
1991,v1803,20170814,7435,7435,0,0,0,7320,7320,-115,-115,0,0,0
1992,v1803,20170815,7320,7320,0,0,0,7105,7105,-215,-215,0,0,0
1993,v1803,20170816,7105,7105,0,0,0,7075,7075,-30,-30,0,0,0
1994,v1803,20170817,7075,7075,0,0,0,7200,7200,125,125,0,0,0
1995,v1803,20170818,7200,7200,0,0,0,7350,7350,150,150,0,0,0
1996,v1803,20170821,7350,7350,0,0,0,7400,7400,50,50,0,0,0
1997,v1803,20170822,7400,7400,0,0,0,7430,7430,30,30,0,0,0
1998,v1803,20170823,7430,7430,0,0,0,7325,7325,-105,-105,0,0,0
1999,v1803,20170824,7325,7325,0,0,0,7420,7420,95,95,0,0,0
2000,v1803,20170825,7420,7420,0,0,0,7520,7520,100,100,0,0,0
2001,v1803,20170828,7520,7520,0,0,0,7520,7520,0,0,0,0,0
2002,v1803,20170829,7520,7520,0,0,0,7565,7565,45,45,0,0,0
2003,v1803,20170830,7565,7565,0,0,0,7505,7505,-60,-60,0,0,0
2004,v1803,20170831,7505,7505,0,0,0,7610,7610,105,105,0,0,0
2005,v1803,20170901,7610,7610,0,0,0,7700,7700,90,90,0,0,0
2006,v1803,20170904,7700,7700,0,0,0,7765,7765,65,65,0,0,0
2007,v1803,20170905,7765,7765,0,0,0,7770,7770,5,5,0,0,0
2008,v1803,20170906,7770,7770,0,0,0,7755,7755,-15,-15,0,0,0
2009,v1803,20170907,7755,7755,0,0,0,7515,7515,-240,-240,0,0,0
2010,v1803,20170908,7515,7515,0,0,0,7400,7400,-115,-115,0,0,0
2011,v1803,20170911,7400,7400,0,0,0,7230,7230,-170,-170,0,0,0
2012,v1803,20170912,7230,7230,0,0,0,7395,7395,165,165,0,0,0
2013,v1803,20170913,7395,7395,0,0,0,7240,7240,-155,-155,0,0,0
2014,v1803,20170914,7240,7240,0,0,0,7300,7300,60,60,0,0,0
2015,v1803,20170915,7300,7300,0,0,0,7145,7145,-155,-155,0,0,0
2016,v1803,20170918,7145,7145,0,0,0,7130,7130,-15,-15,0,0,0
2017,v1803,20170919,7130,7130,0,0,0,7100,7100,-30,-30,0,0,0
2018,v1803,20170920,7100,7100,0,0,0,6975,6975,-125,-125,0,0,0
2019,v1803,20170921,6975,6975,0,0,0,6800,6800,-175,-175,0,0,0
2020,v1803,20170922,6800,6800,6695,6695,6695,6695,6695,-105,-105,2,66950,2
2021,v1803,20170925,6695,6695,0,0,0,6695,6695,0,0,0,0,2
2022,v1803,20170926,6695,6695,0,0,0,6775,6775,80,80,0,0,2
2023,v1803,20170927,6775,6775,0,0,0,6790,6790,15,15,0,0,2
2024,v1803,20170928,6790,6790,6755,6755,6755,6755,6755,-35,-35,2,67550,2
2025,v1803,20170929,6755,6755,0,0,0,6795,6795,40,40,0,0,2
2026,v1803,20171009,6795,6795,0,0,0,6705,6705,-90,-90,0,0,2
2027,v1803,20171010,6705,6705,0,0,0,6590,6590,-115,-115,0,0,2
2028,v1803,20171011,6590,6590,0,0,0,6590,6590,0,0,0,0,2
2029,v1803,20171012,6590,6590,0,0,0,6490,6490,-100,-100,0,0,2
2030,v1803,20171013,6490,6490,0,0,0,6620,6620,130,130,0,0,2
2031,v1803,20171016,6620,6620,0,0,0,6555,6555,-65,-65,0,0,2
2032,v1803,20171017,6555,6555,0,0,0,6610,6610,55,55,0,0,2
2033,v1803,20171018,6610,6610,0,0,0,6620,6620,10,10,0,0,2
2034,v1803,20171019,6620,6620,6350,6350,6350,6350,6350,-270,-270,2,63500,0
2035,v1803,20171020,6350,6350,0,0,0,6385,6385,35,35,0,0,0
2036,v1803,20171023,6385,6385,0,0,0,6435,6435,50,50,0,0,0
2037,v1803,20171024,6435,6435,0,0,0,6530,6530,95,95,0,0,0
2038,v1803,20171025,6530,6530,0,0,0,6460,6460,-70,-70,0,0,0
2039,v1803,20171026,6460,6460,0,0,0,6390,6390,-70,-70,0,0,0
2040,v1803,20171027,6390,6390,6705,6705,6135,6135,6420,-255,30,4,128400,0
2041,v1803,20171030,6135,6420,0,0,0,6535,6535,115,115,0,0,0
2042,v1803,20171031,6535,6535,0,0,0,6390,6390,-145,-145,0,0,0
2043,v1803,20171101,6390,6390,0,0,0,6325,6325,-65,-65,0,0,0
2044,v1803,20171102,6325,6325,0,0,0,6300,6300,-25,-25,0,0,0
2045,v1803,20171103,6300,6300,0,0,0,6320,6320,20,20,0,0,0
2046,v1803,20171106,6320,6320,0,0,0,6530,6530,210,210,0,0,0
2047,v1803,20171107,6530,6530,0,0,0,6575,6575,45,45,0,0,0
2048,v1803,20171108,6575,6575,0,0,0,6540,6540,-35,-35,0,0,0
2049,v1803,20171109,6540,6540,0,0,0,6580,6580,40,40,0,0,0
2050,v1803,20171110,6580,6580,0,0,0,6535,6535,-45,-45,0,0,0
2051,v1803,20171113,6535,6535,0,0,0,6465,6465,-70,-70,0,0,0
2052,v1803,20171114,6465,6465,0,0,0,6430,6430,-35,-35,0,0,0
2053,v1803,20171115,6430,6430,0,0,0,6130,6130,-300,-300,0,0,0
2054,v1803,20171116,6130,6130,0,0,0,5975,5975,-155,-155,0,0,0
2055,v1803,20171117,5975,5975,0,0,0,5990,5990,15,15,0,0,0
2056,v1803,20171120,5990,5990,5990,6130,5990,6130,6060,140,70,8,242400,0
2057,v1803,20171121,6130,6060,0,0,0,6050,6050,-10,-10,0,0,0
2058,v1803,20171122,6050,6050,0,0,0,6180,6180,130,130,0,0,0
2059,v1803,20171123,6180,6180,0,0,0,6270,6270,90,90,0,0,0
2060,v1803,20171124,6270,6270,0,0,0,6265,6265,-5,-5,0,0,0
2061,v1803,20171127,6265,6265,0,0,0,6240,6240,-25,-25,0,0,0
2062,v1803,20171128,6240,6240,0,0,0,6140,6140,-100,-100,0,0,0
2063,v1803,20171129,6140,6140,0,0,0,6300,6300,160,160,0,0,0
2064,v1803,20171130,6300,6300,0,0,0,6215,6215,-85,-85,0,0,0
2065,v1803,20171201,6215,6215,0,0,0,6250,6250,35,35,0,0,0
2066,v1803,20171204,6250,6250,0,0,0,6335,6335,85,85,0,0,0
2067,v1803,20171205,6335,6335,0,0,0,6485,6485,150,150,0,0,0
2068,v1803,20171206,6485,6485,0,0,0,6490,6490,5,5,0,0,0
2069,v1803,20171207,6490,6490,0,0,0,6510,6510,20,20,0,0,0
2070,v1803,20171208,6510,6510,0,0,0,6665,6665,155,155,0,0,0
2071,v1803,20171211,6665,6665,0,0,0,6730,6730,65,65,0,0,0
2072,v1803,20171212,6730,6730,0,0,0,6745,6745,15,15,0,0,0
2073,v1803,20171213,6745,6745,0,0,0,6600,6600,-145,-145,0,0,0
2074,v1803,20171214,6600,6600,0,0,0,6635,6635,35,35,0,0,0
2075,v1803,20171215,6635,6635,0,0,0,6575,6575,-60,-60,0,0,0
2076,v1803,20171218,6575,6575,0,0,0,6635,6635,60,60,0,0,0
2077,v1803,20171219,6635,6635,0,0,0,6670,6670,35,35,0,0,0
2078,v1803,20171220,6670,6670,0,0,0,6680,6680,10,10,0,0,0
2079,v1803,20171221,6680,6680,0,0,0,6575,6575,-105,-105,0,0,0
2080,v1803,20171222,6575,6575,0,0,0,6520,6520,-55,-55,0,0,0
2081,v1803,20171225,6520,6520,0,0,0,6520,6520,0,0,0,0,0
2082,v1803,20171226,6520,6520,0,0,0,6545,6545,25,25,0,0,0
2083,v1803,20171227,6545,6545,0,0,0,6575,6575,30,30,0,0,0
2084,v1803,20171228,6575,6575,0,0,0,6510,6510,-65,-65,0,0,0
2085,v1803,20171229,6510,6510,0,0,0,6525,6525,15,15,0,0,0
2086,v1804,20170419,5395,5395,0,0,0,5325,5325,-70,-70,0,0,0
2087,v1804,20170420,5325,5325,0,0,0,5355,5355,30,30,0,0,0
2088,v1804,20170421,5355,5355,0,0,0,5485,5485,130,130,0,0,0
2089,v1804,20170424,5485,5485,0,0,0,5395,5395,-90,-90,0,0,0
2090,v1804,20170425,5395,5395,0,0,0,5415,5415,20,20,0,0,0
2091,v1804,20170426,5415,5415,0,0,0,5405,5405,-10,-10,0,0,0
2092,v1804,20170427,5405,5405,0,0,0,5475,5475,70,70,0,0,0
2093,v1804,20170428,5475,5475,0,0,0,5665,5665,190,190,0,0,0
2094,v1804,20170502,5665,5665,0,0,0,5690,5690,25,25,0,0,0
2095,v1804,20170503,5690,5690,0,0,0,5685,5685,-5,-5,0,0,0
2096,v1804,20170504,5685,5685,0,0,0,5510,5510,-175,-175,0,0,0
2097,v1804,20170505,5510,5510,0,0,0,5455,5455,-55,-55,0,0,0
2098,v1804,20170508,5455,5455,0,0,0,5530,5530,75,75,0,0,0
2099,v1804,20170509,5530,5530,0,0,0,5580,5580,50,50,0,0,0
2100,v1804,20170510,5580,5580,0,0,0,5510,5510,-70,-70,0,0,0
2101,v1804,20170511,5510,5510,0,0,0,5510,5510,0,0,0,0,0
2102,v1804,20170512,5510,5510,0,0,0,5530,5530,20,20,0,0,0
2103,v1804,20170515,5530,5530,0,0,0,5650,5650,120,120,0,0,0
2104,v1804,20170516,5650,5650,0,0,0,5755,5755,105,105,0,0,0
2105,v1804,20170517,5755,5755,0,0,0,5755,5755,0,0,0,0,0
2106,v1804,20170518,5755,5755,0,0,0,5830,5830,75,75,0,0,0
2107,v1804,20170519,5830,5830,0,0,0,5970,5970,140,140,0,0,0
2108,v1804,20170522,5970,5970,6295,6295,6080,6170,6210,200,240,16,496950,0
2109,v1804,20170523,6170,6210,0,0,0,6155,6155,-55,-55,0,0,0
2110,v1804,20170524,6155,6155,0,0,0,5950,5950,-205,-205,0,0,0
2111,v1804,20170525,5950,5950,0,0,0,5950,5950,0,0,0,0,0
2112,v1804,20170526,5950,5950,0,0,0,5855,5855,-95,-95,0,0,0
2113,v1804,20170531,5855,5855,0,0,0,5905,5905,50,50,0,0,0
2114,v1804,20170601,5905,5905,0,0,0,5970,5970,65,65,0,0,0
2115,v1804,20170602,5970,5970,0,0,0,5885,5885,-85,-85,0,0,0
2116,v1804,20170605,5885,5885,0,0,0,5735,5735,-150,-150,0,0,0
2117,v1804,20170606,5735,5735,0,0,0,5710,5710,-25,-25,0,0,0
2118,v1804,20170607,5710,5710,0,0,0,5735,5735,25,25,0,0,0
2119,v1804,20170608,5735,5735,0,0,0,5730,5730,-5,-5,0,0,0
2120,v1804,20170609,5730,5730,0,0,0,5750,5750,20,20,0,0,0
2121,v1804,20170612,5750,5750,0,0,0,5860,5860,110,110,0,0,0
2122,v1804,20170613,5860,5860,0,0,0,5890,5890,30,30,0,0,0
2123,v1804,20170614,5890,5890,0,0,0,5820,5820,-70,-70,0,0,0
2124,v1804,20170615,5820,5820,0,0,0,5775,5775,-45,-45,0,0,0
2125,v1804,20170616,5775,5775,0,0,0,5750,5750,-25,-25,0,0,0
2126,v1804,20170619,5750,5750,0,0,0,5700,5700,-50,-50,0,0,0
2127,v1804,20170620,5700,5700,0,0,0,5700,5700,0,0,0,0,0
2128,v1804,20170621,5700,5700,0,0,0,5770,5770,70,70,0,0,0
2129,v1804,20170622,5770,5770,0,0,0,5765,5765,-5,-5,0,0,0
2130,v1804,20170623,5765,5765,0,0,0,5845,5845,80,80,0,0,0
2131,v1804,20170626,5845,5845,0,0,0,5920,5920,75,75,0,0,0
2132,v1804,20170627,5920,5920,0,0,0,5980,5980,60,60,0,0,0
2133,v1804,20170628,5980,5980,0,0,0,6000,6000,20,20,0,0,0
2134,v1804,20170629,6000,6000,0,0,0,6105,6105,105,105,0,0,0
2135,v1804,20170630,6105,6105,0,0,0,6160,6160,55,55,0,0,0
2136,v1804,20170703,6160,6160,0,0,0,6195,6195,35,35,0,0,0
2137,v1804,20170704,6195,6195,0,0,0,6125,6125,-70,-70,0,0,0
2138,v1804,20170705,6125,6125,0,0,0,6190,6190,65,65,0,0,0
2139,v1804,20170706,6190,6190,0,0,0,6195,6195,5,5,0,0,0
2140,v1804,20170707,6195,6195,0,0,0,6500,6500,305,305,0,0,0
2141,v1804,20170710,6500,6500,0,0,0,6565,6565,65,65,0,0,0
2142,v1804,20170711,6565,6565,0,0,0,6595,6595,30,30,0,0,0
2143,v1804,20170712,6595,6595,0,0,0,6565,6565,-30,-30,0,0,0
2144,v1804,20170713,6565,6565,0,0,0,6540,6540,-25,-25,0,0,0
2145,v1804,20170714,6540,6540,0,0,0,6530,6530,-10,-10,0,0,0
2146,v1804,20170717,6530,6530,0,0,0,6545,6545,15,15,0,0,0
2147,v1804,20170718,6545,6545,0,0,0,6570,6570,25,25,0,0,0
2148,v1804,20170719,6570,6570,0,0,0,6705,6705,135,135,0,0,0
2149,v1804,20170720,6705,6705,0,0,0,6890,6890,185,185,0,0,0
2150,v1804,20170721,6890,6890,0,0,0,6765,6765,-125,-125,0,0,0
2151,v1804,20170724,6765,6765,0,0,0,6830,6830,65,65,0,0,0
2152,v1804,20170725,6830,6830,0,0,0,6920,6920,90,90,0,0,0
2153,v1804,20170726,6920,6920,0,0,0,6925,6925,5,5,0,0,0
2154,v1804,20170727,6925,6925,0,0,0,6920,6920,-5,-5,0,0,0
2155,v1804,20170728,6920,6920,0,0,0,6910,6910,-10,-10,0,0,0
2156,v1804,20170731,6910,6910,0,0,0,6885,6885,-25,-25,0,0,0
2157,v1804,20170801,6885,6885,0,0,0,6975,6975,90,90,0,0,0
2158,v1804,20170802,6975,6975,0,0,0,7115,7115,140,140,0,0,0
2159,v1804,20170803,7115,7115,0,0,0,7195,7195,80,80,0,0,0
2160,v1804,20170804,7195,7195,0,0,0,7365,7365,170,170,0,0,0
2161,v1804,20170807,7365,7365,0,0,0,7450,7450,85,85,0,0,0
2162,v1804,20170808,7450,7450,0,0,0,7620,7620,170,170,0,0,0
2163,v1804,20170809,7620,7620,0,0,0,7730,7730,110,110,0,0,0
2164,v1804,20170810,7730,7730,7345,7345,7345,7345,7345,-385,-385,2,73450,2
2165,v1804,20170811,7345,7345,0,0,0,7295,7295,-50,-50,0,0,2
2166,v1804,20170814,7295,7295,0,0,0,7185,7185,-110,-110,0,0,2
2167,v1804,20170815,7185,7185,0,0,0,6975,6975,-210,-210,0,0,2
2168,v1804,20170816,6975,6975,0,0,0,6950,6950,-25,-25,0,0,2
2169,v1804,20170817,6950,6950,0,0,0,7070,7070,120,120,0,0,2
2170,v1804,20170818,7070,7070,0,0,0,7215,7215,145,145,0,0,2
2171,v1804,20170821,7215,7215,0,0,0,7260,7260,45,45,0,0,2
2172,v1804,20170822,7260,7260,0,0,0,7285,7285,25,25,0,0,2
2173,v1804,20170823,7285,7285,0,0,0,7185,7185,-100,-100,0,0,2
2174,v1804,20170824,7185,7185,0,0,0,7275,7275,90,90,0,0,2
2175,v1804,20170825,7275,7275,0,0,0,7370,7370,95,95,0,0,2
2176,v1804,20170828,7370,7370,0,0,0,7370,7370,0,0,0,0,2
2177,v1804,20170829,7370,7370,7415,7415,7415,7415,7415,45,45,4,148300,6
2178,v1804,20170830,7415,7415,0,0,0,7360,7360,-55,-55,0,0,6
2179,v1804,20170831,7360,7360,0,0,0,7460,7460,100,100,0,0,6
2180,v1804,20170901,7460,7460,7430,7430,7430,7430,7430,-30,-30,4,148600,2
2181,v1804,20170904,7430,7430,0,0,0,7495,7495,65,65,0,0,2
2182,v1804,20170905,7495,7495,0,0,0,7500,7500,5,5,0,0,2
2183,v1804,20170906,7500,7500,0,0,0,7485,7485,-15,-15,0,0,2
2184,v1804,20170907,7485,7485,0,0,0,7255,7255,-230,-230,0,0,2
2185,v1804,20170908,7255,7255,0,0,0,7145,7145,-110,-110,0,0,2
2186,v1804,20170911,7145,7145,0,0,0,6985,6985,-160,-160,0,0,2
2187,v1804,20170912,6985,6985,0,0,0,7140,7140,155,155,0,0,2
2188,v1804,20170913,7140,7140,0,0,0,6990,6990,-150,-150,0,0,2
2189,v1804,20170914,6990,6990,0,0,0,7045,7045,55,55,0,0,2
2190,v1804,20170915,7045,7045,0,0,0,6895,6895,-150,-150,0,0,2
2191,v1804,20170918,6895,6895,0,0,0,6880,6880,-15,-15,0,0,2
2192,v1804,20170919,6880,6880,0,0,0,6850,6850,-30,-30,0,0,2
2193,v1804,20170920,6850,6850,0,0,0,6725,6725,-125,-125,0,0,2
2194,v1804,20170921,6725,6725,0,0,0,6560,6560,-165,-165,0,0,2
2195,v1804,20170922,6560,6560,0,0,0,6460,6460,-100,-100,0,0,2
2196,v1804,20170925,6460,6460,0,0,0,6460,6460,0,0,0,0,2
2197,v1804,20170926,6460,6460,0,0,0,6540,6540,80,80,0,0,2
2198,v1804,20170927,6540,6540,0,0,0,6555,6555,15,15,0,0,2
2199,v1804,20170928,6555,6555,0,0,0,6525,6525,-30,-30,0,0,2
2200,v1804,20170929,6525,6525,0,0,0,6560,6560,35,35,0,0,2
2201,v1804,20171009,6560,6560,0,0,0,6475,6475,-85,-85,0,0,2
2202,v1804,20171010,6475,6475,0,0,0,6365,6365,-110,-110,0,0,2
2203,v1804,20171011,6365,6365,0,0,0,6365,6365,0,0,0,0,2
2204,v1804,20171012,6365,6365,0,0,0,6270,6270,-95,-95,0,0,2
2205,v1804,20171013,6270,6270,0,0,0,6395,6395,125,125,0,0,2
2206,v1804,20171016,6395,6395,0,0,0,6335,6335,-60,-60,0,0,2
2207,v1804,20171017,6335,6335,0,0,0,6385,6385,50,50,0,0,2
2208,v1804,20171018,6385,6385,0,0,0,6390,6390,5,5,0,0,2
2209,v1804,20171019,6390,6390,0,0,0,6130,6130,-260,-260,0,0,2
2210,v1804,20171020,6130,6130,0,0,0,6160,6160,30,30,0,0,2
2211,v1804,20171023,6160,6160,0,0,0,6210,6210,50,50,0,0,2
2212,v1804,20171024,6210,6210,0,0,0,6305,6305,95,95,0,0,2
2213,v1804,20171025,6305,6305,0,0,0,6235,6235,-70,-70,0,0,2
2214,v1804,20171026,6235,6235,0,0,0,6165,6165,-70,-70,0,0,2
2215,v1804,20171027,6165,6165,0,0,0,6190,6190,25,25,0,0,2
2216,v1804,20171030,6190,6190,0,0,0,6305,6305,115,115,0,0,2
2217,v1804,20171031,6305,6305,0,0,0,6165,6165,-140,-140,0,0,2
2218,v1804,20171101,6165,6165,0,0,0,6100,6100,-65,-65,0,0,2
2219,v1804,20171102,6100,6100,0,0,0,6075,6075,-25,-25,0,0,2
2220,v1804,20171103,6075,6075,0,0,0,6095,6095,20,20,0,0,2
2221,v1804,20171106,6095,6095,0,0,0,6300,6300,205,205,0,0,2
2222,v1804,20171107,6300,6300,0,0,0,6340,6340,40,40,0,0,2
2223,v1804,20171108,6340,6340,0,0,0,6310,6310,-30,-30,0,0,2
2224,v1804,20171109,6310,6310,0,0,0,6345,6345,35,35,0,0,2
2225,v1804,20171110,6345,6345,0,0,0,6305,6305,-40,-40,0,0,2
2226,v1804,20171113,6305,6305,0,0,0,6240,6240,-65,-65,0,0,2
2227,v1804,20171114,6240,6240,0,0,0,6210,6210,-30,-30,0,0,2
2228,v1804,20171115,6210,6210,0,0,0,5920,5920,-290,-290,0,0,2
2229,v1804,20171116,5920,5920,0,0,0,5775,5775,-145,-145,0,0,2
2230,v1804,20171117,5775,5775,0,0,0,5785,5785,10,10,0,0,2
2231,v1804,20171120,5785,5785,0,0,0,5850,5850,65,65,0,0,2
2232,v1804,20171121,5850,5850,0,0,0,5845,5845,-5,-5,0,0,2
2233,v1804,20171122,5845,5845,0,0,0,5970,5970,125,125,0,0,2
2234,v1804,20171123,5970,5970,0,0,0,6055,6055,85,85,0,0,2
2235,v1804,20171124,6055,6055,0,0,0,6050,6050,-5,-5,0,0,2
2236,v1804,20171127,6050,6050,0,0,0,6025,6025,-25,-25,0,0,2
2237,v1804,20171128,6025,6025,0,0,0,5925,5925,-100,-100,0,0,2
2238,v1804,20171129,5925,5925,0,0,0,6080,6080,155,155,0,0,2
2239,v1804,20171130,6080,6080,0,0,0,6000,6000,-80,-80,0,0,2
2240,v1804,20171201,6000,6000,0,0,0,6030,6030,30,30,0,0,2
2241,v1804,20171204,6030,6030,0,0,0,6110,6110,80,80,0,0,2
2242,v1804,20171205,6110,6110,0,0,0,6255,6255,145,145,0,0,2
2243,v1804,20171206,6255,6255,0,0,0,6255,6255,0,0,0,0,2
2244,v1804,20171207,6255,6255,0,0,0,6270,6270,15,15,0,0,2
2245,v1804,20171208,6270,6270,0,0,0,6420,6420,150,150,0,0,2
2246,v1804,20171211,6420,6420,0,0,0,6480,6480,60,60,0,0,2
2247,v1804,20171212,6480,6480,0,0,0,6490,6490,10,10,0,0,2
2248,v1804,20171213,6490,6490,0,0,0,6350,6350,-140,-140,0,0,2
2249,v1804,20171214,6350,6350,0,0,0,6380,6380,30,30,0,0,2
2250,v1804,20171215,6380,6380,0,0,0,6325,6325,-55,-55,0,0,2
2251,v1804,20171218,6325,6325,0,0,0,6380,6380,55,55,0,0,2
2252,v1804,20171219,6380,6380,0,0,0,6410,6410,30,30,0,0,2
2253,v1804,20171220,6410,6410,0,0,0,6415,6415,5,5,0,0,2
2254,v1804,20171221,6415,6415,0,0,0,6315,6315,-100,-100,0,0,2
2255,v1804,20171222,6315,6315,0,0,0,6265,6265,-50,-50,0,0,2
2256,v1804,20171225,6265,6265,0,0,0,6265,6265,0,0,0,0,2
2257,v1804,20171226,6265,6265,0,0,0,6285,6285,20,20,0,0,2
2258,v1804,20171227,6285,6285,0,0,0,6310,6310,25,25,0,0,2
2259,v1804,20171228,6310,6310,5995,5995,5995,5995,5995,-315,-315,4,119900,2
2260,v1804,20171229,5995,5995,0,0,0,6290,6290,295,295,0,0,2
2261,v1805,20170516,5650,5650,5890,5930,5850,5900,5890,250,240,8,235700,8
2262,v1805,20170517,5900,5890,0,0,0,5890,5890,0,0,0,0,8
2263,v1805,20170518,5890,5890,5870,6045,5870,6015,5975,125,85,16,478150,14
2264,v1805,20170519,6015,5975,5955,6155,5955,6155,6060,180,85,16,484800,24
2265,v1805,20170522,6155,6060,6155,6155,6120,6120,6135,60,75,12,368250,22
2266,v1805,20170523,6120,6135,6085,6085,6035,6035,6060,-100,-75,4,121200,22
2267,v1805,20170524,6035,6060,6055,6055,5830,5900,5895,-160,-165,52,1532750,48
2268,v1805,20170525,5900,5895,5895,5955,5835,5895,5890,0,-5,54,1591050,42
2269,v1805,20170526,5895,5890,5780,5800,5750,5800,5770,-90,-120,22,635100,54
2270,v1805,20170531,5800,5770,5860,5860,5780,5780,5800,10,30,16,464200,66
2271,v1805,20170601,5780,5800,5820,5965,5820,5915,5910,115,110,32,946350,70
2272,v1805,20170602,5915,5910,5860,5860,5765,5765,5800,-145,-110,142,4118050,192
2273,v1805,20170605,5765,5800,5795,5795,5675,5735,5720,-65,-80,200,5722000,342
2274,v1805,20170606,5735,5720,5760,5770,5680,5740,5720,20,0,98,2803150,386
2275,v1805,20170607,5740,5720,5765,5770,5720,5745,5740,25,20,152,4364700,518
2276,v1805,20170608,5745,5740,5705,5795,5690,5750,5760,10,20,68,1959600,510
2277,v1805,20170609,5750,5760,5785,5785,5720,5735,5745,-25,-15,26,746950,516
2278,v1805,20170612,5735,5745,5810,5910,5785,5870,5865,125,120,96,2815300,510
2279,v1805,20170613,5870,5865,5875,5910,5800,5800,5875,-65,10,214,6287250,498
2280,v1805,20170614,5800,5875,5825,5865,5750,5805,5795,-70,-80,210,6085100,528
2281,v1805,20170615,5805,5795,5745,5800,5690,5725,5740,-70,-55,172,4940400,612
2282,v1805,20170616,5725,5740,5755,5775,5710,5715,5725,-25,-15,134,3836950,696
2283,v1805,20170619,5715,5725,5730,5730,5665,5700,5690,-25,-35,272,7742550,782
2284,v1805,20170620,5700,5690,5690,5700,5605,5665,5645,-25,-45,514,14511700,1142
2285,v1805,20170621,5665,5645,5665,5755,5600,5720,5720,75,75,244,6980400,1136
2286,v1805,20170622,5720,5720,5755,5755,5680,5695,5710,-25,-10,338,9650550,1290
2287,v1805,20170623,5695,5710,5700,5825,5700,5815,5780,105,70,532,15387600,1218
2288,v1805,20170626,5815,5780,5775,5870,5775,5870,5840,90,60,176,5139800,1260
2289,v1805,20170627,5870,5840,5885,5915,5855,5910,5890,70,50,132,3888550,1248
2290,v1805,20170628,5910,5890,5910,5935,5880,5915,5910,25,20,338,9989950,1216
2291,v1805,20170629,5915,5910,5920,6060,5910,6025,6005,115,95,370,11117900,1156
2292,v1805,20170630,6025,6005,6005,6070,6005,6045,6040,40,35,184,5557800,1246
2293,v1805,20170703,6045,6040,6075,6085,6030,6060,6050,20,10,226,6840450,1304
2294,v1805,20170704,6060,6050,6035,6080,5950,5955,6000,-95,-50,500,15000900,1526
2295,v1805,20170705,5955,6000,5990,6080,5975,6015,6025,15,25,360,10847800,1424
2296,v1805,20170706,6015,6025,6015,6095,6010,6080,6060,55,35,348,10545000,1554
2297,v1805,20170707,6080,6060,6060,6195,6060,6180,6130,120,70,300,9196500,1630
2298,v1805,20170710,6180,6130,6185,6230,6095,6155,6170,25,40,374,11545050,1684
2299,v1805,20170711,6155,6170,6215,6280,6150,6195,6200,25,30,526,16313800,1890
2300,v1805,20170712,6195,6200,6245,6250,6125,6150,6175,-50,-25,462,14274050,2014
2301,v1805,20170713,6150,6175,6160,6225,6075,6190,6185,15,10,760,23518600,2140
2302,v1805,20170714,6190,6185,6175,6220,6120,6170,6190,-15,5,1620,50149800,2282
2303,v1805,20170717,6170,6190,6170,6220,6145,6160,6180,-30,-10,404,12484600,2310
2304,v1805,20170718,6160,6180,6210,6245,6140,6240,6205,60,25,1082,33588650,2720
2305,v1805,20170719,6240,6205,6275,6340,6275,6325,6320,120,115,408,12897500,2880
2306,v1805,20170720,6325,6320,6325,6635,6320,6495,6490,175,170,1590,51626250,2806
2307,v1805,20170721,6495,6490,6405,6480,6345,6455,6395,-35,-95,1064,34041900,3012
2308,v1805,20170724,6455,6395,6405,6480,6375,6405,6430,10,35,632,20327550,3228
2309,v1805,20170725,6405,6430,6435,6570,6435,6545,6510,115,80,622,20253850,3380
2310,v1805,20170726,6545,6510,6565,6640,6420,6455,6525,-55,15,394,12863300,3402
2311,v1805,20170727,6455,6525,6465,6575,6460,6565,6520,40,-5,350,11410800,3508
2312,v1805,20170728,6565,6520,6560,6570,6440,6445,6480,-75,-40,824,26717650,3722
2313,v1805,20170731,6445,6480,6485,6550,6390,6535,6480,55,0,560,18153450,3680
2314,v1805,20170801,6535,6480,6545,6630,6535,6590,6605,110,125,1166,38514700,4326
2315,v1805,20170802,6590,6605,6565,6805,6565,6755,6735,150,130,1602,53950600,4374
2316,v1805,20170803,6755,6735,6790,6825,6745,6765,6780,30,45,806,27329250,4580
2317,v1805,20170804,6765,6780,6795,6980,6795,6980,6930,200,150,880,30500650,4906
2318,v1805,20170807,6980,6930,6950,7095,6835,7065,6985,135,55,1664,58115450,5142
2319,v1805,20170808,7065,6985,7065,7250,7065,7235,7190,250,205,2578,92724800,6014
2320,v1805,20170809,7235,7190,7285,7405,7260,7315,7340,125,150,2764,101456850,7236
2321,v1805,20170810,7315,7340,7340,7435,7235,7405,7330,65,-10,7402,271307800,9852
2322,v1805,20170811,7405,7330,7345,7420,7060,7155,7265,-175,-65,3708,134769250,9446
2323,v1805,20170814,7155,7265,7230,7230,7105,7115,7150,-150,-115,824,29476950,9480
2324,v1805,20170815,7115,7150,7115,7115,6845,6870,6905,-280,-245,4756,164232750,9506
2325,v1805,20170816,6870,6905,6855,6930,6765,6795,6835,-110,-70,4646,158807850,10792
2326,v1805,20170817,6795,6835,6860,6995,6850,6910,6930,75,95,4002,138741750,10860
2327,v1805,20170818,6910,6930,6880,7155,6880,7100,7065,170,135,6742,238311650,11516
2328,v1805,20170821,7100,7065,7130,7245,7070,7210,7170,145,105,6158,220872550,11626
2329,v1805,20170822,7210,7170,7210,7330,7105,7265,7230,95,60,9686,350202950,10854
2330,v1805,20170823,7265,7230,7210,7210,7045,7120,7120,-110,-110,10846,386289150,11232
2331,v1805,20170824,7120,7120,7165,7290,7165,7215,7220,95,100,7996,288751950,11500
2332,v1805,20170825,7215,7220,7280,7405,7250,7355,7340,135,120,11828,434173250,9662
2333,v1805,20170828,7355,7340,7295,7465,7205,7390,7375,50,35,13840,510544700,12760
2334,v1805,20170829,7390,7375,7380,7490,7285,7345,7370,-30,-5,16134,594593700,13038
2335,v1805,20170830,7345,7370,7330,7330,7230,7310,7275,-60,-95,8796,320049600,13420
2336,v1805,20170831,7310,7275,7270,7390,7255,7375,7330,100,55,10406,381596400,12892
2337,v1805,20170901,7375,7330,7410,7525,7405,7520,7465,190,135,15738,587607000,16520
2338,v1805,20170904,7520,7465,7600,7655,7475,7500,7540,35,75,16446,620207350,16484
2339,v1805,20170905,7500,7540,7550,7640,7485,7630,7560,90,20,14240,538611250,18798
2340,v1805,20170906,7630,7560,7580,7655,7515,7570,7590,10,30,16334,619878400,19712
2341,v1805,20170907,7570,7590,7605,7670,7325,7405,7480,-185,-110,22714,850009400,22138
2342,v1805,20170908,7405,7480,7400,7480,7350,7365,7410,-115,-70,15714,582413300,20354
2343,v1805,20170911,7365,7410,7300,7375,7115,7350,7235,-60,-175,22362,809111800,19338
2344,v1805,20170912,7350,7235,7400,7470,7320,7440,7385,205,150,12596,465303150,19972
2345,v1805,20170913,7440,7385,7430,7465,7115,7165,7240,-220,-145,21216,768271400,20430
2346,v1805,20170914,7165,7240,7190,7215,7075,7090,7140,-150,-100,11250,401765850,20198
2347,v1805,20170915,7090,7140,7100,7110,6880,6930,6970,-210,-170,19864,692374950,21818
2348,v1805,20170918,6930,6970,6880,7000,6860,6930,6920,-40,-50,14494,501732500,22132
2349,v1805,20170919,6930,6920,6950,6980,6755,6760,6875,-160,-45,12870,442552650,22466
2350,v1805,20170920,6760,6875,6785,6830,6685,6715,6740,-160,-135,17206,580059450,24568
2351,v1805,20170921,6715,6740,6730,6730,6535,6555,6605,-185,-135,24998,826064300,27872
2352,v1805,20170922,6555,6605,6540,6585,6475,6555,6535,-50,-70,15816,517126800,27780
2353,v1805,20170925,6555,6535,6555,6640,6450,6540,6535,5,0,16740,547026750,26842
2354,v1805,20170926,6540,6535,6575,6630,6545,6610,6590,75,55,15010,494694550,25058
2355,v1805,20170927,6610,6590,6625,6665,6605,6635,6640,45,50,10812,359062600,23374
2356,v1805,20170928,6635,6640,6580,6580,6310,6375,6390,-265,-250,22302,712941750,23520
2357,v1805,20170929,6375,6390,6425,6450,6350,6430,6395,40,5,8742,279678300,23646
2358,v1805,20171009,6430,6395,6480,6515,6200,6235,6310,-160,-85,18330,578337000,27096
2359,v1805,20171010,6235,6310,6230,6310,6165,6175,6235,-135,-75,20190,629871900,32044
2360,v1805,20171011,6175,6235,6220,6260,6170,6180,6210,-55,-25,17250,535700550,34170
2361,v1805,20171012,6180,6210,6195,6230,6105,6230,6140,20,-70,29818,916031950,38676
2362,v1805,20171013,6230,6140,6245,6315,6225,6290,6260,150,120,25718,805579300,37240
2363,v1805,20171016,6290,6260,6320,6350,6120,6235,6210,-25,-50,37916,1177464850,45512
2364,v1805,20171017,6235,6210,6200,6335,6130,6285,6260,75,50,31980,1001756450,46064
2365,v1805,20171018,6285,6260,6290,6345,6275,6285,6310,25,50,21038,663924450,46862
2366,v1805,20171019,6285,6310,6250,6250,6140,6200,6180,-110,-130,42980,1328702500,49384
2367,v1805,20171020,6200,6180,6235,6380,6190,6380,6290,200,110,45314,1425933550,52282
2368,v1805,20171023,6380,6290,6360,6460,6315,6425,6400,135,110,38914,1245820300,54766
2369,v1805,20171024,6425,6400,6600,6660,6435,6585,6595,185,195,63158,2083053400,52070
2370,v1805,20171025,6585,6595,6605,6630,6445,6515,6550,-80,-45,42276,1385487050,47668
2371,v1805,20171026,6515,6550,6510,6550,6450,6470,6490,-80,-60,37838,1227962150,54698
2372,v1805,20171027,6470,6490,6480,6535,6420,6445,6475,-45,-15,37962,1229035650,54484
2373,v1805,20171030,6445,6475,6460,6610,6450,6565,6550,90,75,42682,1398233300,54456
2374,v1805,20171031,6565,6550,6555,6560,6320,6345,6395,-205,-155,45616,1458935550,56936
2375,v1805,20171101,6345,6395,6350,6425,6280,6285,6370,-110,-25,45538,1451007750,60840
2376,v1805,20171102,6285,6370,6350,6435,6325,6420,6380,50,10,57972,1849328500,63928
2377,v1805,20171103,6420,6380,6430,6475,6370,6410,6425,30,45,39840,1280271550,66144
2378,v1805,20171106,6410,6425,6440,6565,6415,6555,6500,130,75,50194,1631792450,65726
2379,v1805,20171107,6555,6500,6590,6620,6500,6555,6555,55,55,43774,1435045800,69514
2380,v1805,20171108,6555,6555,6550,6565,6480,6525,6525,-30,-30,37870,1235580800,72284
2381,v1805,20171109,6525,6525,6560,6690,6455,6515,6590,-10,65,103958,3426764350,87130
2382,v1805,20171110,6515,6590,6520,6570,6500,6515,6535,-75,-55,54078,1767940800,88628
2383,v1805,20171113,6515,6535,6505,6520,6400,6490,6450,-45,-85,58656,1892998300,90694
2384,v1805,20171114,6490,6450,6510,6510,6425,6450,6465,0,15,48130,1556993800,97052
2385,v1805,20171115,6450,6465,6330,6350,6145,6145,6245,-320,-220,104548,3264922300,107222
2386,v1805,20171116,6145,6245,6170,6185,6030,6050,6105,-195,-140,88106,2690795200,118364
2387,v1805,20171117,6050,6105,6055,6175,6035,6145,6115,40,10,89334,2731663850,120198
2388,v1805,20171120,6145,6115,6165,6200,6110,6155,6160,40,45,79150,2439746050,122942
2389,v1805,20171121,6155,6160,6165,6225,6125,6150,6165,-10,5,92908,2865922100,139240
2390,v1805,20171122,6150,6165,6190,6380,6165,6370,6285,205,120,165350,5199207750,143566
2391,v1805,20171123,6370,6285,6425,6490,6385,6400,6430,115,145,144262,4639125200,147490
2392,v1805,20171124,6400,6430,6435,6475,6335,6425,6415,-5,-15,139380,4471192250,157278
2393,v1805,20171127,6425,6415,6440,6500,6190,6230,6370,-185,-45,242520,7725011700,165626
2394,v1805,20171128,6230,6370,6215,6280,6175,6215,6220,-155,-150,144016,4482003750,170812
2395,v1805,20171129,6215,6220,6225,6305,6200,6260,6255,40,35,168562,5275899600,178950
2396,v1805,20171130,6260,6255,6290,6340,6065,6140,6180,-115,-75,368000,11378157500,196066
2397,v1805,20171201,6140,6180,6120,6335,6100,6300,6225,120,45,479538,14928005400,217122
2398,v1805,20171204,6300,6225,6385,6520,6365,6470,6440,245,215,615428,19822895300,240672
2399,v1805,20171205,6470,6440,6470,6600,6400,6435,6510,-5,70,543610,17705521900,226874
2400,v1805,20171206,6435,6510,6425,6645,6410,6645,6530,135,20,517894,16913731800,252536
2401,v1805,20171207,6645,6530,6605,6670,6325,6430,6530,-100,0,776574,25371258850,232114
2402,v1805,20171208,6430,6530,6460,6845,6450,6775,6695,245,165,949804,31796459950,325000
2403,v1805,20171211,6775,6695,6790,6835,6690,6755,6760,60,65,660096,22322772400,328546
2404,v1805,20171212,6755,6760,6790,6840,6710,6755,6765,-5,5,519006,17558340900,334646
2405,v1805,20171213,6755,6765,6735,6795,6585,6670,6650,-95,-115,575422,19146226850,300870
2406,v1805,20171214,6670,6650,6670,6785,6610,6620,6700,-30,50,679314,22758068800,313226
2407,v1805,20171215,6620,6700,6635,6685,6550,6625,6630,-75,-70,437546,14509386950,307020
2408,v1805,20171218,6625,6630,6730,6770,6640,6685,6705,55,75,542470,18191738600,318540
2409,v1805,20171219,6685,6705,6670,6840,6660,6715,6760,10,55,633986,21432240900,333842
2410,v1805,20171220,6715,6760,6740,6790,6705,6720,6745,-40,-15,404526,13649682300,336566
2411,v1805,20171221,6720,6745,6685,6705,6565,6570,6635,-175,-110,505460,16780718650,307642
2412,v1805,20171222,6570,6635,6580,6645,6540,6635,6600,0,-35,365860,12077415900,302324
2413,v1805,20171225,6635,6600,6620,6685,6510,6550,6595,-50,-5,415534,13705882350,290238
2414,v1805,20171226,6550,6595,6575,6720,6515,6695,6635,100,40,495646,16449032550,311572
2415,v1805,20171227,6695,6635,6705,6725,6580,6595,6655,-40,20,439592,14632254150,296464
2416,v1805,20171228,6595,6655,6600,6620,6560,6590,6590,-65,-65,286800,9451719150,292052
2417,v1805,20171229,6590,6590,6635,6690,6605,6655,6645,65,55,352994,11732937150,293482
2418,v1806,20170615,5795,5795,0,0,0,5740,5740,-55,-55,0,0,0
2419,v1806,20170616,5740,5740,0,0,0,5730,5730,-10,-10,0,0,0
2420,v1806,20170619,5730,5730,0,0,0,5695,5695,-35,-35,0,0,0
2421,v1806,20170620,5695,5695,0,0,0,5650,5650,-45,-45,0,0,0
2422,v1806,20170621,5650,5650,0,0,0,5725,5725,75,75,0,0,0
2423,v1806,20170622,5725,5725,0,0,0,5715,5715,-10,-10,0,0,0
2424,v1806,20170623,5715,5715,0,0,0,5785,5785,70,70,0,0,0
2425,v1806,20170626,5785,5785,0,0,0,5845,5845,60,60,0,0,0
2426,v1806,20170627,5845,5845,0,0,0,5895,5895,50,50,0,0,0
2427,v1806,20170628,5895,5895,0,0,0,5915,5915,20,20,0,0,0
2428,v1806,20170629,5915,5915,0,0,0,6010,6010,95,95,0,0,0
2429,v1806,20170630,6010,6010,0,0,0,6045,6045,35,35,0,0,0
2430,v1806,20170703,6045,6045,0,0,0,6055,6055,10,10,0,0,0
2431,v1806,20170704,6055,6055,0,0,0,6005,6005,-50,-50,0,0,0
2432,v1806,20170705,6005,6005,0,0,0,6030,6030,25,25,0,0,0
2433,v1806,20170706,6030,6030,0,0,0,6065,6065,35,35,0,0,0
2434,v1806,20170707,6065,6065,0,0,0,6135,6135,70,70,0,0,0
2435,v1806,20170710,6135,6135,0,0,0,6175,6175,40,40,0,0,0
2436,v1806,20170711,6175,6175,0,0,0,6205,6205,30,30,0,0,0
2437,v1806,20170712,6205,6205,0,0,0,6180,6180,-25,-25,0,0,0
2438,v1806,20170713,6180,6180,0,0,0,6190,6190,10,10,0,0,0
2439,v1806,20170714,6190,6190,0,0,0,6195,6195,5,5,0,0,0
2440,v1806,20170717,6195,6195,0,0,0,6185,6185,-10,-10,0,0,0
2441,v1806,20170718,6185,6185,0,0,0,6210,6210,25,25,0,0,0
2442,v1806,20170719,6210,6210,0,0,0,6325,6325,115,115,0,0,0
2443,v1806,20170720,6325,6325,0,0,0,6495,6495,170,170,0,0,0
2444,v1806,20170721,6495,6495,0,0,0,6400,6400,-95,-95,0,0,0
2445,v1806,20170724,6400,6400,0,0,0,6435,6435,35,35,0,0,0
2446,v1806,20170725,6435,6435,0,0,0,6515,6515,80,80,0,0,0
2447,v1806,20170726,6515,6515,0,0,0,6530,6530,15,15,0,0,0
2448,v1806,20170727,6530,6530,0,0,0,6525,6525,-5,-5,0,0,0
2449,v1806,20170728,6525,6525,0,0,0,6485,6485,-40,-40,0,0,0
2450,v1806,20170731,6485,6485,0,0,0,6485,6485,0,0,0,0,0
2451,v1806,20170801,6485,6485,0,0,0,6610,6610,125,125,0,0,0
2452,v1806,20170802,6610,6610,0,0,0,6740,6740,130,130,0,0,0
2453,v1806,20170803,6740,6740,0,0,0,6785,6785,45,45,0,0,0
2454,v1806,20170804,6785,6785,0,0,0,6935,6935,150,150,0,0,0
2455,v1806,20170807,6935,6935,0,0,0,6990,6990,55,55,0,0,0
2456,v1806,20170808,6990,6990,0,0,0,7195,7195,205,205,0,0,0
2457,v1806,20170809,7195,7195,0,0,0,7345,7345,150,150,0,0,0
2458,v1806,20170810,7345,7345,0,0,0,7335,7335,-10,-10,0,0,0
2459,v1806,20170811,7335,7335,0,0,0,7270,7270,-65,-65,0,0,0
2460,v1806,20170814,7270,7270,0,0,0,7155,7155,-115,-115,0,0,0
2461,v1806,20170815,7155,7155,0,0,0,6910,6910,-245,-245,0,0,0
2462,v1806,20170816,6910,6910,0,0,0,6840,6840,-70,-70,0,0,0
2463,v1806,20170817,6840,6840,0,0,0,6935,6935,95,95,0,0,0
2464,v1806,20170818,6935,6935,0,0,0,7070,7070,135,135,0,0,0
2465,v1806,20170821,7070,7070,0,0,0,7175,7175,105,105,0,0,0
2466,v1806,20170822,7175,7175,0,0,0,7235,7235,60,60,0,0,0
2467,v1806,20170823,7235,7235,0,0,0,7125,7125,-110,-110,0,0,0
2468,v1806,20170824,7125,7125,0,0,0,7225,7225,100,100,0,0,0
2469,v1806,20170825,7225,7225,0,0,0,7345,7345,120,120,0,0,0
2470,v1806,20170828,7345,7345,0,0,0,7380,7380,35,35,0,0,0
2471,v1806,20170829,7380,7380,0,0,0,7375,7375,-5,-5,0,0,0
2472,v1806,20170830,7375,7375,0,0,0,7280,7280,-95,-95,0,0,0
2473,v1806,20170831,7280,7280,0,0,0,7335,7335,55,55,0,0,0
2474,v1806,20170901,7335,7335,0,0,0,7470,7470,135,135,0,0,0
2475,v1806,20170904,7470,7470,0,0,0,7545,7545,75,75,0,0,0
2476,v1806,20170905,7545,7545,0,0,0,7565,7565,20,20,0,0,0
2477,v1806,20170906,7565,7565,0,0,0,7595,7595,30,30,0,0,0
2478,v1806,20170907,7595,7595,0,0,0,7485,7485,-110,-110,0,0,0
2479,v1806,20170908,7485,7485,0,0,0,7415,7415,-70,-70,0,0,0
2480,v1806,20170911,7415,7415,0,0,0,7240,7240,-175,-175,0,0,0
2481,v1806,20170912,7240,7240,0,0,0,7390,7390,150,150,0,0,0
2482,v1806,20170913,7390,7390,0,0,0,7245,7245,-145,-145,0,0,0
2483,v1806,20170914,7245,7245,0,0,0,7145,7145,-100,-100,0,0,0
2484,v1806,20170915,7145,7145,0,0,0,6975,6975,-170,-170,0,0,0
2485,v1806,20170918,6975,6975,0,0,0,6925,6925,-50,-50,0,0,0
2486,v1806,20170919,6925,6925,0,0,0,6880,6880,-45,-45,0,0,0
2487,v1806,20170920,6880,6880,0,0,0,6745,6745,-135,-135,0,0,0
2488,v1806,20170921,6745,6745,0,0,0,6610,6610,-135,-135,0,0,0
2489,v1806,20170922,6610,6610,0,0,0,6540,6540,-70,-70,0,0,0
2490,v1806,20170925,6540,6540,0,0,0,6540,6540,0,0,0,0,0
2491,v1806,20170926,6540,6540,0,0,0,6595,6595,55,55,0,0,0
2492,v1806,20170927,6595,6595,0,0,0,6645,6645,50,50,0,0,0
2493,v1806,20170928,6645,6645,0,0,0,6395,6395,-250,-250,0,0,0
2494,v1806,20170929,6395,6395,0,0,0,6400,6400,5,5,0,0,0
2495,v1806,20171009,6400,6400,0,0,0,6315,6315,-85,-85,0,0,0
2496,v1806,20171010,6315,6315,0,0,0,6240,6240,-75,-75,0,0,0
2497,v1806,20171011,6240,6240,0,0,0,6215,6215,-25,-25,0,0,0
2498,v1806,20171012,6215,6215,0,0,0,6145,6145,-70,-70,0,0,0
2499,v1806,20171013,6145,6145,0,0,0,6265,6265,120,120,0,0,0
2500,v1806,20171016,6265,6265,0,0,0,6215,6215,-50,-50,0,0,0
2501,v1806,20171017,6215,6215,6080,6310,6080,6310,6195,95,-20,12,371700,0
2502,v1806,20171018,6310,6195,0,0,0,6240,6240,45,45,0,0,0
2503,v1806,20171019,6240,6240,0,0,0,6115,6115,-125,-125,0,0,0
2504,v1806,20171020,6115,6115,0,0,0,6220,6220,105,105,0,0,0
2505,v1806,20171023,6220,6220,0,0,0,6325,6325,105,105,0,0,0
2506,v1806,20171024,6325,6325,0,0,0,6515,6515,190,190,0,0,0
2507,v1806,20171025,6515,6515,0,0,0,6475,6475,-40,-40,0,0,0
2508,v1806,20171026,6475,6475,0,0,0,6420,6420,-55,-55,0,0,0
2509,v1806,20171027,6420,6420,0,0,0,6410,6410,-10,-10,0,0,0
2510,v1806,20171030,6410,6410,0,0,0,6480,6480,70,70,0,0,0
2511,v1806,20171031,6480,6480,0,0,0,6330,6330,-150,-150,0,0,0
2512,v1806,20171101,6330,6330,0,0,0,6310,6310,-20,-20,0,0,0
2513,v1806,20171102,6310,6310,0,0,0,6315,6315,5,5,0,0,0
2514,v1806,20171103,6315,6315,0,0,0,6355,6355,40,40,0,0,0
2515,v1806,20171106,6355,6355,0,0,0,6425,6425,70,70,0,0,0
2516,v1806,20171107,6425,6425,0,0,0,6475,6475,50,50,0,0,0
2517,v1806,20171108,6475,6475,0,0,0,6450,6450,-25,-25,0,0,0
2518,v1806,20171109,6450,6450,6750,6770,6580,6640,6665,190,215,808,26938600,2
2519,v1806,20171110,6640,6665,0,0,0,6610,6610,-55,-55,0,0,2
2520,v1806,20171113,6610,6610,0,0,0,6610,6610,0,0,0,0,2
2521,v1806,20171114,6610,6610,0,0,0,6625,6625,15,15,0,0,2
2522,v1806,20171115,6625,6625,0,0,0,6400,6400,-225,-225,0,0,2
2523,v1806,20171116,6400,6400,0,0,0,6260,6260,-140,-140,0,0,2
2524,v1806,20171117,6260,6260,0,0,0,6270,6270,10,10,0,0,2
2525,v1806,20171120,6270,6270,0,0,0,6315,6315,45,45,0,0,2
2526,v1806,20171121,6315,6315,0,0,0,6320,6320,5,5,0,0,2
2527,v1806,20171122,6320,6320,0,0,0,6440,6440,120,120,0,0,2
2528,v1806,20171123,6440,6440,0,0,0,6585,6585,145,145,0,0,2
2529,v1806,20171124,6585,6585,0,0,0,6570,6570,-15,-15,0,0,2
2530,v1806,20171127,6570,6570,0,0,0,6525,6525,-45,-45,0,0,2
2531,v1806,20171128,6525,6525,0,0,0,6375,6375,-150,-150,0,0,2
2532,v1806,20171129,6375,6375,0,0,0,6375,6375,0,0,0,0,2
2533,v1806,20171130,6375,6375,0,0,0,6375,6375,0,0,0,0,2
2534,v1806,20171201,6375,6375,0,0,0,6375,6375,0,0,0,0,2
2535,v1806,20171204,6375,6375,0,0,0,6595,6595,220,220,0,0,2
2536,v1806,20171205,6595,6595,0,0,0,6595,6595,0,0,0,0,2
2537,v1806,20171206,6595,6595,0,0,0,6595,6595,0,0,0,0,2
2538,v1806,20171207,6595,6595,0,0,0,6595,6595,0,0,0,0,2
2539,v1806,20171208,6595,6595,0,0,0,6760,6760,165,165,0,0,2
2540,v1806,20171211,6760,6760,0,0,0,6825,6825,65,65,0,0,2
2541,v1806,20171212,6825,6825,6665,6770,6665,6770,6715,-55,-110,4,134350,2
2542,v1806,20171213,6770,6715,0,0,0,6605,6605,-110,-110,0,0,2
2543,v1806,20171214,6605,6605,0,0,0,6605,6605,0,0,0,0,2
2544,v1806,20171215,6605,6605,0,0,0,6540,6540,-65,-65,0,0,2
2545,v1806,20171218,6540,6540,0,0,0,6610,6610,70,70,0,0,2
2546,v1806,20171219,6610,6610,0,0,0,6660,6660,50,50,0,0,2
2547,v1806,20171220,6660,6660,0,0,0,6650,6650,-10,-10,0,0,2
2548,v1806,20171221,6650,6650,6585,6685,6585,6685,6635,35,-15,8,265400,0
2549,v1806,20171222,6685,6635,6515,6515,6515,6515,6515,-120,-120,2,65150,2
2550,v1806,20171225,6515,6515,6705,6705,6705,6705,6705,190,190,2,67050,0
2551,v1806,20171226,6705,6705,0,0,0,6745,6745,40,40,0,0,0
2552,v1806,20171227,6745,6745,0,0,0,6765,6765,20,20,0,0,0
2553,v1806,20171228,6765,6765,0,0,0,6700,6700,-65,-65,0,0,0
2554,v1806,20171229,6700,6700,0,0,0,6755,6755,55,55,0,0,0
2555,v1807,20170717,6195,6195,0,0,0,6185,6185,-10,-10,0,0,0
2556,v1807,20170718,6185,6185,0,0,0,6210,6210,25,25,0,0,0
2557,v1807,20170719,6210,6210,0,0,0,6325,6325,115,115,0,0,0
2558,v1807,20170720,6325,6325,0,0,0,6495,6495,170,170,0,0,0
2559,v1807,20170721,6495,6495,0,0,0,6400,6400,-95,-95,0,0,0
2560,v1807,20170724,6400,6400,0,0,0,6435,6435,35,35,0,0,0
2561,v1807,20170725,6435,6435,0,0,0,6515,6515,80,80,0,0,0
2562,v1807,20170726,6515,6515,0,0,0,6530,6530,15,15,0,0,0
2563,v1807,20170727,6530,6530,0,0,0,6525,6525,-5,-5,0,0,0
2564,v1807,20170728,6525,6525,0,0,0,6485,6485,-40,-40,0,0,0
2565,v1807,20170731,6485,6485,0,0,0,6485,6485,0,0,0,0,0
2566,v1807,20170801,6485,6485,0,0,0,6610,6610,125,125,0,0,0
2567,v1807,20170802,6610,6610,0,0,0,6740,6740,130,130,0,0,0
2568,v1807,20170803,6740,6740,0,0,0,6785,6785,45,45,0,0,0
2569,v1807,20170804,6785,6785,0,0,0,6935,6935,150,150,0,0,0
2570,v1807,20170807,6935,6935,0,0,0,6990,6990,55,55,0,0,0
2571,v1807,20170808,6990,6990,0,0,0,7195,7195,205,205,0,0,0
2572,v1807,20170809,7195,7195,0,0,0,7345,7345,150,150,0,0,0
2573,v1807,20170810,7345,7345,0,0,0,7335,7335,-10,-10,0,0,0
2574,v1807,20170811,7335,7335,0,0,0,7270,7270,-65,-65,0,0,0
2575,v1807,20170814,7270,7270,0,0,0,7155,7155,-115,-115,0,0,0
2576,v1807,20170815,7155,7155,0,0,0,6910,6910,-245,-245,0,0,0
2577,v1807,20170816,6910,6910,0,0,0,6840,6840,-70,-70,0,0,0
2578,v1807,20170817,6840,6840,0,0,0,6935,6935,95,95,0,0,0
2579,v1807,20170818,6935,6935,0,0,0,7070,7070,135,135,0,0,0
2580,v1807,20170821,7070,7070,0,0,0,7175,7175,105,105,0,0,0
2581,v1807,20170822,7175,7175,0,0,0,7235,7235,60,60,0,0,0
2582,v1807,20170823,7235,7235,0,0,0,7125,7125,-110,-110,0,0,0
2583,v1807,20170824,7125,7125,0,0,0,7225,7225,100,100,0,0,0
2584,v1807,20170825,7225,7225,0,0,0,7345,7345,120,120,0,0,0
2585,v1807,20170828,7345,7345,0,0,0,7380,7380,35,35,0,0,0
2586,v1807,20170829,7380,7380,0,0,0,7375,7375,-5,-5,0,0,0
2587,v1807,20170830,7375,7375,0,0,0,7280,7280,-95,-95,0,0,0
2588,v1807,20170831,7280,7280,0,0,0,7335,7335,55,55,0,0,0
2589,v1807,20170901,7335,7335,0,0,0,7470,7470,135,135,0,0,0
2590,v1807,20170904,7470,7470,0,0,0,7545,7545,75,75,0,0,0
2591,v1807,20170905,7545,7545,0,0,0,7565,7565,20,20,0,0,0
2592,v1807,20170906,7565,7565,0,0,0,7595,7595,30,30,0,0,0
2593,v1807,20170907,7595,7595,0,0,0,7485,7485,-110,-110,0,0,0
2594,v1807,20170908,7485,7485,0,0,0,7415,7415,-70,-70,0,0,0
2595,v1807,20170911,7415,7415,0,0,0,7240,7240,-175,-175,0,0,0
2596,v1807,20170912,7240,7240,0,0,0,7390,7390,150,150,0,0,0
2597,v1807,20170913,7390,7390,0,0,0,7245,7245,-145,-145,0,0,0
2598,v1807,20170914,7245,7245,0,0,0,7145,7145,-100,-100,0,0,0
2599,v1807,20170915,7145,7145,0,0,0,6975,6975,-170,-170,0,0,0
2600,v1807,20170918,6975,6975,0,0,0,6925,6925,-50,-50,0,0,0
2601,v1807,20170919,6925,6925,0,0,0,6880,6880,-45,-45,0,0,0
2602,v1807,20170920,6880,6880,0,0,0,6745,6745,-135,-135,0,0,0
2603,v1807,20170921,6745,6745,0,0,0,6610,6610,-135,-135,0,0,0
2604,v1807,20170922,6610,6610,0,0,0,6540,6540,-70,-70,0,0,0
2605,v1807,20170925,6540,6540,0,0,0,6540,6540,0,0,0,0,0
2606,v1807,20170926,6540,6540,0,0,0,6595,6595,55,55,0,0,0
2607,v1807,20170927,6595,6595,0,0,0,6645,6645,50,50,0,0,0
2608,v1807,20170928,6645,6645,0,0,0,6395,6395,-250,-250,0,0,0
2609,v1807,20170929,6395,6395,0,0,0,6400,6400,5,5,0,0,0
2610,v1807,20171009,6400,6400,0,0,0,6315,6315,-85,-85,0,0,0
2611,v1807,20171010,6315,6315,0,0,0,6240,6240,-75,-75,0,0,0
2612,v1807,20171011,6240,6240,0,0,0,6215,6215,-25,-25,0,0,0
2613,v1807,20171012,6215,6215,0,0,0,6145,6145,-70,-70,0,0,0
2614,v1807,20171013,6145,6145,0,0,0,6265,6265,120,120,0,0,0
2615,v1807,20171016,6265,6265,0,0,0,6215,6215,-50,-50,0,0,0
2616,v1807,20171017,6215,6215,0,0,0,6200,6200,-15,-15,0,0,0
2617,v1807,20171018,6200,6200,0,0,0,6245,6245,45,45,0,0,0
2618,v1807,20171019,6245,6245,0,0,0,6120,6120,-125,-125,0,0,0
2619,v1807,20171020,6120,6120,0,0,0,6225,6225,105,105,0,0,0
2620,v1807,20171023,6225,6225,0,0,0,6330,6330,105,105,0,0,0
2621,v1807,20171024,6330,6330,0,0,0,6520,6520,190,190,0,0,0
2622,v1807,20171025,6520,6520,0,0,0,6480,6480,-40,-40,0,0,0
2623,v1807,20171026,6480,6480,0,0,0,6425,6425,-55,-55,0,0,0
2624,v1807,20171027,6425,6425,0,0,0,6415,6415,-10,-10,0,0,0
2625,v1807,20171030,6415,6415,0,0,0,6485,6485,70,70,0,0,0
2626,v1807,20171031,6485,6485,0,0,0,6335,6335,-150,-150,0,0,0
2627,v1807,20171101,6335,6335,0,0,0,6315,6315,-20,-20,0,0,0
2628,v1807,20171102,6315,6315,0,0,0,6320,6320,5,5,0,0,0
2629,v1807,20171103,6320,6320,0,0,0,6360,6360,40,40,0,0,0
2630,v1807,20171106,6360,6360,0,0,0,6430,6430,70,70,0,0,0
2631,v1807,20171107,6430,6430,0,0,0,6480,6480,50,50,0,0,0
2632,v1807,20171108,6480,6480,0,0,0,6455,6455,-25,-25,0,0,0
2633,v1807,20171109,6455,6455,0,0,0,6670,6670,215,215,0,0,0
2634,v1807,20171110,6670,6670,0,0,0,6615,6615,-55,-55,0,0,0
2635,v1807,20171113,6615,6615,0,0,0,6530,6530,-85,-85,0,0,0
2636,v1807,20171114,6530,6530,0,0,0,6545,6545,15,15,0,0,0
2637,v1807,20171115,6545,6545,0,0,0,6325,6325,-220,-220,0,0,0
2638,v1807,20171116,6325,6325,0,0,0,6185,6185,-140,-140,0,0,0
2639,v1807,20171117,6185,6185,0,0,0,6195,6195,10,10,0,0,0
2640,v1807,20171120,6195,6195,0,0,0,6240,6240,45,45,0,0,0
2641,v1807,20171121,6240,6240,0,0,0,6245,6245,5,5,0,0,0
2642,v1807,20171122,6245,6245,0,0,0,6365,6365,120,120,0,0,0
2643,v1807,20171123,6365,6365,6255,6500,6255,6430,6385,65,20,14,446950,2
2644,v1807,20171124,6430,6385,0,0,0,6375,6375,-10,-10,0,0,2
2645,v1807,20171127,6375,6375,0,0,0,6335,6335,-40,-40,0,0,2
2646,v1807,20171128,6335,6335,0,0,0,6190,6190,-145,-145,0,0,2
2647,v1807,20171129,6190,6190,0,0,0,6220,6220,30,30,0,0,2
2648,v1807,20171130,6220,6220,0,0,0,6150,6150,-70,-70,0,0,2
2649,v1807,20171201,6150,6150,0,0,0,6190,6190,40,40,0,0,2
2650,v1807,20171204,6190,6190,0,0,0,6400,6400,210,210,0,0,2
2651,v1807,20171205,6400,6400,0,0,0,6465,6465,65,65,0,0,2
2652,v1807,20171206,6465,6465,6660,6660,6660,6660,6660,195,195,2,66600,2
2653,v1807,20171207,6660,6660,0,0,0,6660,6660,0,0,0,0,2
2654,v1807,20171208,6660,6660,6710,6710,6710,6710,6710,50,50,2,67100,2
2655,v1807,20171211,6710,6710,6700,6700,6700,6700,6700,-10,-10,2,67000,0
2656,v1807,20171212,6700,6700,0,0,0,6595,6595,-105,-105,0,0,0
2657,v1807,20171213,6595,6595,0,0,0,6485,6485,-110,-110,0,0,0
2658,v1807,20171214,6485,6485,0,0,0,6530,6530,45,45,0,0,0
2659,v1807,20171215,6530,6530,0,0,0,6465,6465,-65,-65,0,0,0
2660,v1807,20171218,6465,6465,0,0,0,6535,6535,70,70,0,0,0
2661,v1807,20171219,6535,6535,0,0,0,6585,6585,50,50,0,0,0
2662,v1807,20171220,6585,6585,0,0,0,6575,6575,-10,-10,0,0,0
2663,v1807,20171221,6575,6575,0,0,0,6565,6565,-10,-10,0,0,0
2664,v1807,20171222,6565,6565,0,0,0,6450,6450,-115,-115,0,0,0
2665,v1807,20171225,6450,6450,0,0,0,6635,6635,185,185,0,0,0
2666,v1807,20171226,6635,6635,0,0,0,6675,6675,40,40,0,0,0
2667,v1807,20171227,6675,6675,0,0,0,6695,6695,20,20,0,0,0
2668,v1807,20171228,6695,6695,0,0,0,6630,6630,-65,-65,0,0,0
2669,v1807,20171229,6630,6630,0,0,0,6685,6685,55,55,0,0,0
2670,v1808,20170815,7155,7155,0,0,0,6910,6910,-245,-245,0,0,0
2671,v1808,20170816,6910,6910,0,0,0,6840,6840,-70,-70,0,0,0
2672,v1808,20170817,6840,6840,0,0,0,6935,6935,95,95,0,0,0
2673,v1808,20170818,6935,6935,0,0,0,7070,7070,135,135,0,0,0
2674,v1808,20170821,7070,7070,0,0,0,7175,7175,105,105,0,0,0
2675,v1808,20170822,7175,7175,0,0,0,7235,7235,60,60,0,0,0
2676,v1808,20170823,7235,7235,0,0,0,7125,7125,-110,-110,0,0,0
2677,v1808,20170824,7125,7125,0,0,0,7225,7225,100,100,0,0,0
2678,v1808,20170825,7225,7225,0,0,0,7345,7345,120,120,0,0,0
2679,v1808,20170828,7345,7345,0,0,0,7380,7380,35,35,0,0,0
2680,v1808,20170829,7380,7380,0,0,0,7375,7375,-5,-5,0,0,0
2681,v1808,20170830,7375,7375,0,0,0,7280,7280,-95,-95,0,0,0
2682,v1808,20170831,7280,7280,0,0,0,7335,7335,55,55,0,0,0
2683,v1808,20170901,7335,7335,0,0,0,7470,7470,135,135,0,0,0
2684,v1808,20170904,7470,7470,0,0,0,7545,7545,75,75,0,0,0
2685,v1808,20170905,7545,7545,0,0,0,7565,7565,20,20,0,0,0
2686,v1808,20170906,7565,7565,0,0,0,7595,7595,30,30,0,0,0
2687,v1808,20170907,7595,7595,0,0,0,7485,7485,-110,-110,0,0,0
2688,v1808,20170908,7485,7485,0,0,0,7415,7415,-70,-70,0,0,0
2689,v1808,20170911,7415,7415,0,0,0,7240,7240,-175,-175,0,0,0
2690,v1808,20170912,7240,7240,0,0,0,7390,7390,150,150,0,0,0
2691,v1808,20170913,7390,7390,0,0,0,7245,7245,-145,-145,0,0,0
2692,v1808,20170914,7245,7245,0,0,0,7145,7145,-100,-100,0,0,0
2693,v1808,20170915,7145,7145,0,0,0,6975,6975,-170,-170,0,0,0
2694,v1808,20170918,6975,6975,0,0,0,6925,6925,-50,-50,0,0,0
2695,v1808,20170919,6925,6925,0,0,0,6880,6880,-45,-45,0,0,0
2696,v1808,20170920,6880,6880,0,0,0,6745,6745,-135,-135,0,0,0
2697,v1808,20170921,6745,6745,0,0,0,6610,6610,-135,-135,0,0,0
2698,v1808,20170922,6610,6610,0,0,0,6540,6540,-70,-70,0,0,0
2699,v1808,20170925,6540,6540,0,0,0,6540,6540,0,0,0,0,0
2700,v1808,20170926,6540,6540,0,0,0,6595,6595,55,55,0,0,0
2701,v1808,20170927,6595,6595,0,0,0,6645,6645,50,50,0,0,0
2702,v1808,20170928,6645,6645,0,0,0,6395,6395,-250,-250,0,0,0
2703,v1808,20170929,6395,6395,0,0,0,6400,6400,5,5,0,0,0
2704,v1808,20171009,6400,6400,0,0,0,6315,6315,-85,-85,0,0,0
2705,v1808,20171010,6315,6315,0,0,0,6240,6240,-75,-75,0,0,0
2706,v1808,20171011,6240,6240,0,0,0,6215,6215,-25,-25,0,0,0
2707,v1808,20171012,6215,6215,0,0,0,6145,6145,-70,-70,0,0,0
2708,v1808,20171013,6145,6145,0,0,0,6265,6265,120,120,0,0,0
2709,v1808,20171016,6265,6265,0,0,0,6215,6215,-50,-50,0,0,0
2710,v1808,20171017,6215,6215,0,0,0,6200,6200,-15,-15,0,0,0
2711,v1808,20171018,6200,6200,0,0,0,6245,6245,45,45,0,0,0
2712,v1808,20171019,6245,6245,0,0,0,6120,6120,-125,-125,0,0,0
2713,v1808,20171020,6120,6120,0,0,0,6225,6225,105,105,0,0,0
2714,v1808,20171023,6225,6225,0,0,0,6330,6330,105,105,0,0,0
2715,v1808,20171024,6330,6330,0,0,0,6520,6520,190,190,0,0,0
2716,v1808,20171025,6520,6520,0,0,0,6480,6480,-40,-40,0,0,0
2717,v1808,20171026,6480,6480,0,0,0,6425,6425,-55,-55,0,0,0
2718,v1808,20171027,6425,6425,0,0,0,6415,6415,-10,-10,0,0,0
2719,v1808,20171030,6415,6415,0,0,0,6485,6485,70,70,0,0,0
2720,v1808,20171031,6485,6485,0,0,0,6335,6335,-150,-150,0,0,0
2721,v1808,20171101,6335,6335,0,0,0,6315,6315,-20,-20,0,0,0
2722,v1808,20171102,6315,6315,0,0,0,6320,6320,5,5,0,0,0
2723,v1808,20171103,6320,6320,0,0,0,6360,6360,40,40,0,0,0
2724,v1808,20171106,6360,6360,0,0,0,6430,6430,70,70,0,0,0
2725,v1808,20171107,6430,6430,0,0,0,6480,6480,50,50,0,0,0
2726,v1808,20171108,6480,6480,0,0,0,6455,6455,-25,-25,0,0,0
2727,v1808,20171109,6455,6455,0,0,0,6670,6670,215,215,0,0,0
2728,v1808,20171110,6670,6670,0,0,0,6615,6615,-55,-55,0,0,0
2729,v1808,20171113,6615,6615,0,0,0,6530,6530,-85,-85,0,0,0
2730,v1808,20171114,6530,6530,0,0,0,6545,6545,15,15,0,0,0
2731,v1808,20171115,6545,6545,0,0,0,6325,6325,-220,-220,0,0,0
2732,v1808,20171116,6325,6325,5995,5995,5995,5995,5995,-330,-330,2,59950,2
2733,v1808,20171117,5995,5995,0,0,0,6000,6000,5,5,0,0,2
2734,v1808,20171120,6000,6000,0,0,0,6040,6040,40,40,0,0,2
2735,v1808,20171121,6040,6040,0,0,0,6040,6040,0,0,0,0,2
2736,v1808,20171122,6040,6040,0,0,0,6155,6155,115,115,0,0,2
2737,v1808,20171123,6155,6155,0,0,0,6170,6170,15,15,0,0,2
2738,v1808,20171124,6170,6170,0,0,0,6160,6160,-10,-10,0,0,2
2739,v1808,20171127,6160,6160,0,0,0,6120,6120,-40,-40,0,0,2
2740,v1808,20171128,6120,6120,0,0,0,5980,5980,-140,-140,0,0,2
2741,v1808,20171129,5980,5980,0,0,0,6010,6010,30,30,0,0,2
2742,v1808,20171130,6010,6010,0,0,0,5940,5940,-70,-70,0,0,2
2743,v1808,20171201,5940,5940,0,0,0,5980,5980,40,40,0,0,2
2744,v1808,20171204,5980,5980,0,0,0,6185,6185,205,205,0,0,2
2745,v1808,20171205,6185,6185,0,0,0,6250,6250,65,65,0,0,2
2746,v1808,20171206,6250,6250,0,0,0,6435,6435,185,185,0,0,2
2747,v1808,20171207,6435,6435,0,0,0,6435,6435,0,0,0,0,2
2748,v1808,20171208,6435,6435,0,0,0,6480,6480,45,45,0,0,2
2749,v1808,20171211,6480,6480,0,0,0,6475,6475,-5,-5,0,0,2
2750,v1808,20171212,6475,6475,0,0,0,6375,6375,-100,-100,0,0,2
2751,v1808,20171213,6375,6375,0,0,0,6270,6270,-105,-105,0,0,2
2752,v1808,20171214,6270,6270,0,0,0,6315,6315,45,45,0,0,2
2753,v1808,20171215,6315,6315,0,0,0,6250,6250,-65,-65,0,0,2
2754,v1808,20171218,6250,6250,0,0,0,6320,6320,70,70,0,0,2
2755,v1808,20171219,6320,6320,0,0,0,6370,6370,50,50,0,0,2
2756,v1808,20171220,6370,6370,0,0,0,6360,6360,-10,-10,0,0,2
2757,v1808,20171221,6360,6360,0,0,0,6350,6350,-10,-10,0,0,2
2758,v1808,20171222,6350,6350,0,0,0,6240,6240,-110,-110,0,0,2
2759,v1808,20171225,6240,6240,0,0,0,6420,6420,180,180,0,0,2
2760,v1808,20171226,6420,6420,0,0,0,6455,6455,35,35,0,0,2
2761,v1808,20171227,6455,6455,0,0,0,6470,6470,15,15,0,0,2
2762,v1808,20171228,6470,6470,0,0,0,6410,6410,-60,-60,0,0,2
2763,v1808,20171229,6410,6410,0,0,0,6460,6460,50,50,0,0,2
2764,v1809,20170915,7145,7145,6955,6965,6815,6850,6865,-295,-280,70,2404050,60
2765,v1809,20170918,6850,6865,6780,6840,6730,6800,6780,-65,-85,238,8069150,64
2766,v1809,20170919,6800,6780,6825,6845,6665,6665,6760,-115,-20,428,14471850,272
2767,v1809,20170920,6665,6760,6690,6710,6595,6620,6640,-140,-120,812,26964200,556
2768,v1809,20170921,6620,6640,6605,6605,6460,6480,6500,-160,-140,1106,35967050,828
2769,v1809,20170922,6480,6500,6460,6500,6410,6465,6460,-35,-40,392,12667900,950
2770,v1809,20170925,6465,6460,6500,6545,6370,6455,6435,-5,-25,444,14291950,1142
2771,v1809,20170926,6455,6435,6500,6525,6460,6515,6500,80,65,398,12939000,1044
2772,v1809,20170927,6515,6500,6515,6555,6515,6530,6540,30,40,350,11445250,1034
2773,v1809,20170928,6530,6540,6480,6480,6255,6295,6320,-245,-220,918,29015050,1310
2774,v1809,20170929,6295,6320,6375,6405,6310,6365,6340,45,20,810,25693750,1428
2775,v1809,20171009,6365,6340,6280,6425,6150,6180,6250,-160,-90,2120,66260700,2216
2776,v1809,20171010,6180,6250,6170,6245,6115,6115,6170,-135,-80,1228,37911900,2858
2777,v1809,20171011,6115,6170,6180,6195,6105,6110,6140,-60,-30,864,26545950,2986
2778,v1809,20171012,6110,6140,6140,6160,6050,6160,6085,20,-55,1354,41200350,3178
2779,v1809,20171013,6160,6085,6180,6240,6160,6220,6195,135,110,1242,38500150,3238
2780,v1809,20171016,6220,6195,6255,6275,6075,6180,6160,-15,-35,2992,92164700,4188
2781,v1809,20171017,6180,6160,6160,6270,6090,6215,6200,55,40,2196,68090600,4220
2782,v1809,20171018,6215,6200,6235,6275,6220,6230,6245,30,45,1664,51995300,4386
2783,v1809,20171019,6230,6245,6200,6200,6100,6150,6140,-95,-105,2492,76538150,5102
2784,v1809,20171020,6150,6140,6180,6315,6150,6305,6250,165,110,2170,67848000,4954
2785,v1809,20171023,6305,6250,6270,6390,6260,6365,6335,115,85,2124,67328500,4746
2786,v1809,20171024,6365,6335,6395,6600,6330,6530,6525,195,190,3154,102929450,3208
2787,v1809,20171025,6530,6525,6545,6600,6425,6480,6510,-45,-15,1238,40298050,3118
2788,v1809,20171026,6480,6510,6460,6510,6425,6445,6460,-65,-50,1106,35741050,2964
2789,v1809,20171027,6445,6460,6435,6490,6400,6420,6440,-40,-20,858,27634200,2958
2790,v1809,20171030,6420,6440,6430,6575,6425,6535,6515,95,75,874,28488700,2862
2791,v1809,20171031,6535,6515,6520,6520,6310,6335,6365,-180,-150,1004,31964550,3246
2792,v1809,20171101,6335,6365,6370,6420,6315,6320,6380,-45,15,1104,35232050,3404
2793,v1809,20171102,6320,6380,6400,6445,6355,6440,6410,60,30,832,26666150,3096
2794,v1809,20171103,6440,6410,6455,6495,6400,6435,6450,25,40,326,10515900,3066
2795,v1809,20171106,6435,6450,6465,6595,6450,6595,6535,145,85,1004,32816300,3010
2796,v1809,20171107,6595,6535,6620,6650,6540,6585,6590,50,55,552,18192550,2966
2797,v1809,20171108,6585,6590,6560,6600,6520,6560,6560,-30,-30,1188,38967500,2912
2798,v1809,20171109,6560,6560,6595,6700,6485,6560,6630,0,70,1792,59424350,3004
2799,v1809,20171110,6560,6630,6560,6600,6550,6555,6570,-75,-60,350,11501850,3030
2800,v1809,20171113,6555,6570,6525,6545,6450,6525,6490,-45,-80,842,27342700,3266
2801,v1809,20171114,6525,6490,6545,6545,6465,6480,6500,-10,10,492,15990150,3344
2802,v1809,20171115,6480,6500,6405,6405,6200,6200,6280,-300,-220,3800,119359950,5718
2803,v1809,20171116,6200,6280,6250,6250,6090,6110,6150,-170,-130,1434,44122550,6456
2804,v1809,20171117,6110,6150,6110,6210,6095,6180,6150,30,0,1918,59006200,6514
2805,v1809,20171120,6180,6150,6190,6235,6165,6205,6200,55,50,714,22143000,6662
2806,v1809,20171121,6205,6200,6210,6265,6190,6200,6220,0,20,1112,34610150,6986
2807,v1809,20171122,6200,6220,6235,6425,6225,6425,6335,205,115,2016,63864750,7156
2808,v1809,20171123,6425,6335,6460,6525,6430,6445,6470,110,135,1476,47751500,7070
2809,v1809,20171124,6445,6470,6445,6510,6385,6475,6465,5,-5,852,27559800,7232
2810,v1809,20171127,6475,6465,6500,6550,6265,6295,6440,-170,-25,2278,73378550,7754
2811,v1809,20171128,6295,6440,6290,6330,6240,6275,6280,-165,-160,1922,60391550,8112
2812,v1809,20171129,6275,6280,6270,6355,6265,6305,6310,25,30,1016,32070250,8224
2813,v1809,20171130,6305,6310,6340,6395,6120,6195,6225,-115,-85,2844,88548550,9448
2814,v1809,20171201,6195,6225,6170,6385,6155,6350,6265,125,40,3548,111186350,9032
2815,v1809,20171204,6350,6265,6380,6565,6380,6525,6485,260,220,4032,130742250,9176
2816,v1809,20171205,6525,6485,6520,6640,6465,6490,6545,5,60,4168,136444250,9024
2817,v1809,20171206,6490,6545,6490,6655,6460,6650,6580,105,35,4908,161503600,8986
2818,v1809,20171207,6650,6580,6610,6670,6350,6455,6515,-125,-65,8862,288872650,10686
2819,v1809,20171208,6455,6515,6500,6790,6475,6760,6680,245,165,11450,382574800,15056
2820,v1809,20171211,6760,6680,6735,6815,6655,6755,6740,75,60,7462,251603700,15606
2821,v1809,20171212,6755,6740,6810,6825,6710,6755,6755,15,15,3862,130502700,15668
2822,v1809,20171213,6755,6755,6720,6765,6590,6650,6635,-105,-120,5062,167987150,15532
2823,v1809,20171214,6650,6635,6665,6765,6605,6625,6685,-10,50,4702,157184900,16590
2824,v1809,20171215,6625,6685,6640,6670,6560,6630,6625,-55,-60,4108,136154750,16388
2825,v1809,20171218,6630,6625,6680,6745,6635,6680,6700,55,75,5162,172945250,16936
2826,v1809,20171219,6680,6700,6670,6820,6660,6715,6745,15,45,5156,173905200,17188
2827,v1809,20171220,6715,6745,6750,6780,6705,6715,6735,-30,-10,4740,159686050,16282
2828,v1809,20171221,6715,6735,6700,6710,6600,6600,6655,-135,-80,6608,219945950,14736
2829,v1809,20171222,6600,6655,6610,6655,6565,6650,6605,-5,-50,3542,117037350,14046
2830,v1809,20171225,6650,6605,6640,6695,6535,6570,6590,-35,-15,5164,170240450,12714
2831,v1809,20171226,6570,6590,6590,6725,6540,6710,6655,120,65,4978,165751900,13126
2832,v1809,20171227,6710,6655,6725,6735,6615,6630,6670,-25,15,6722,224297700,11736
2833,v1809,20171228,6630,6670,6650,6665,6605,6645,6635,-25,-35,5860,194426400,11236
2834,v1809,20171229,6645,6635,6665,6735,6660,6705,6695,70,60,3452,115579200,10864
2835,v1810,20171023,6250,6250,0,0,0,6335,6335,85,85,0,0,0
2836,v1810,20171024,6335,6335,0,0,0,6520,6520,185,185,0,0,0
2837,v1810,20171025,6520,6520,0,0,0,6510,6510,-10,-10,0,0,0
2838,v1810,20171026,6510,6510,0,0,0,6465,6465,-45,-45,0,0,0
2839,v1810,20171027,6465,6465,0,0,0,6445,6445,-20,-20,0,0,0
2840,v1810,20171030,6445,6445,0,0,0,6520,6520,75,75,0,0,0
2841,v1810,20171031,6520,6520,0,0,0,6370,6370,-150,-150,0,0,0
2842,v1810,20171101,6370,6370,0,0,0,6385,6385,15,15,0,0,0
2843,v1810,20171102,6385,6385,0,0,0,6415,6415,30,30,0,0,0
2844,v1810,20171103,6415,6415,0,0,0,6455,6455,40,40,0,0,0
2845,v1810,20171106,6455,6455,0,0,0,6540,6540,85,85,0,0,0
2846,v1810,20171107,6540,6540,0,0,0,6595,6595,55,55,0,0,0
2847,v1810,20171108,6595,6595,0,0,0,6565,6565,-30,-30,0,0,0
2848,v1810,20171109,6565,6565,0,0,0,6635,6635,70,70,0,0,0
2849,v1810,20171110,6635,6635,0,0,0,6575,6575,-60,-60,0,0,0
2850,v1810,20171113,6575,6575,0,0,0,6495,6495,-80,-80,0,0,0
2851,v1810,20171114,6495,6495,0,0,0,6505,6505,10,10,0,0,0
2852,v1810,20171115,6505,6505,0,0,0,6285,6285,-220,-220,0,0,0
2853,v1810,20171116,6285,6285,0,0,0,6155,6155,-130,-130,0,0,0
2854,v1810,20171117,6155,6155,0,0,0,6155,6155,0,0,0,0,0
2855,v1810,20171120,6155,6155,0,0,0,6205,6205,50,50,0,0,0
2856,v1810,20171121,6205,6205,0,0,0,6225,6225,20,20,0,0,0
2857,v1810,20171122,6225,6225,0,0,0,6340,6340,115,115,0,0,0
2858,v1810,20171123,6340,6340,0,0,0,6475,6475,135,135,0,0,0
2859,v1810,20171124,6475,6475,0,0,0,6470,6470,-5,-5,0,0,0
2860,v1810,20171127,6470,6470,0,0,0,6445,6445,-25,-25,0,0,0
2861,v1810,20171128,6445,6445,0,0,0,6285,6285,-160,-160,0,0,0
2862,v1810,20171129,6285,6285,0,0,0,6315,6315,30,30,0,0,0
2863,v1810,20171130,6315,6315,0,0,0,6230,6230,-85,-85,0,0,0
2864,v1810,20171201,6230,6230,0,0,0,6270,6270,40,40,0,0,0
2865,v1810,20171204,6270,6270,0,0,0,6490,6490,220,220,0,0,0
2866,v1810,20171205,6490,6490,0,0,0,6550,6550,60,60,0,0,0
2867,v1810,20171206,6550,6550,0,0,0,6585,6585,35,35,0,0,0
2868,v1810,20171207,6585,6585,0,0,0,6520,6520,-65,-65,0,0,0
2869,v1810,20171208,6520,6520,0,0,0,6685,6685,165,165,0,0,0
2870,v1810,20171211,6685,6685,0,0,0,6745,6745,60,60,0,0,0
2871,v1810,20171212,6745,6745,0,0,0,6760,6760,15,15,0,0,0
2872,v1810,20171213,6760,6760,0,0,0,6640,6640,-120,-120,0,0,0
2873,v1810,20171214,6640,6640,0,0,0,6690,6690,50,50,0,0,0
2874,v1810,20171215,6690,6690,0,0,0,6630,6630,-60,-60,0,0,0
2875,v1810,20171218,6630,6630,0,0,0,6705,6705,75,75,0,0,0
2876,v1810,20171219,6705,6705,0,0,0,6750,6750,45,45,0,0,0
2877,v1810,20171220,6750,6750,0,0,0,6740,6740,-10,-10,0,0,0
2878,v1810,20171221,6740,6740,0,0,0,6660,6660,-80,-80,0,0,0
2879,v1810,20171222,6660,6660,0,0,0,6610,6610,-50,-50,0,0,0
2880,v1810,20171225,6610,6610,0,0,0,6595,6595,-15,-15,0,0,0
2881,v1810,20171226,6595,6595,0,0,0,6660,6660,65,65,0,0,0
2882,v1810,20171227,6660,6660,0,0,0,6675,6675,15,15,0,0,0
2883,v1810,20171228,6675,6675,0,0,0,6640,6640,-35,-35,0,0,0
2884,v1810,20171229,6640,6640,0,0,0,6700,6700,60,60,0,0,0
2885,v1811,20171115,6505,6505,0,0,0,6285,6285,-220,-220,0,0,0
2886,v1811,20171116,6285,6285,5930,5930,5925,5925,5925,-360,-360,4,118550,4
2887,v1811,20171117,5925,5925,5945,6015,5945,6015,5985,90,60,10,299450,10
2888,v1811,20171120,6015,5985,6215,6215,6215,6215,6215,230,230,4,124300,6
2889,v1811,20171121,6215,6215,6315,6315,6315,6315,6315,100,100,6,189450,0
2890,v1811,20171122,6315,6315,0,0,0,6430,6430,115,115,0,0,0
2891,v1811,20171123,6430,6430,0,0,0,6565,6565,135,135,0,0,0
2892,v1811,20171124,6565,6565,0,0,0,6560,6560,-5,-5,0,0,0
2893,v1811,20171127,6560,6560,0,0,0,6535,6535,-25,-25,0,0,0
2894,v1811,20171128,6535,6535,0,0,0,6535,6535,0,0,0,0,0
2895,v1811,20171129,6535,6535,0,0,0,6535,6535,0,0,0,0,0
2896,v1811,20171130,6535,6535,0,0,0,6450,6450,-85,-85,0,0,0
2897,v1811,20171201,6450,6450,0,0,0,6490,6490,40,40,0,0,0
2898,v1811,20171204,6490,6490,0,0,0,6715,6715,225,225,0,0,0
2899,v1811,20171205,6715,6715,0,0,0,6775,6775,60,60,0,0,0
2900,v1811,20171206,6775,6775,0,0,0,6810,6810,35,35,0,0,0
2901,v1811,20171207,6810,6810,0,0,0,6745,6745,-65,-65,0,0,0
2902,v1811,20171208,6745,6745,0,0,0,6915,6915,170,170,0,0,0
2903,v1811,20171211,6915,6915,0,0,0,6975,6975,60,60,0,0,0
2904,v1811,20171212,6975,6975,6900,6900,6640,6640,6770,-335,-205,4,135400,0
2905,v1811,20171213,6640,6770,0,0,0,6650,6650,-120,-120,0,0,0
2906,v1811,20171214,6650,6650,0,0,0,6700,6700,50,50,0,0,0
2907,v1811,20171215,6700,6700,0,0,0,6640,6640,-60,-60,0,0,0
2908,v1811,20171218,6640,6640,0,0,0,6715,6715,75,75,0,0,0
2909,v1811,20171219,6715,6715,0,0,0,6760,6760,45,45,0,0,0
2910,v1811,20171220,6760,6760,0,0,0,6750,6750,-10,-10,0,0,0
2911,v1811,20171221,6750,6750,0,0,0,6670,6670,-80,-80,0,0,0
2912,v1811,20171222,6670,6670,0,0,0,6620,6620,-50,-50,0,0,0
2913,v1811,20171225,6620,6620,0,0,0,6605,6605,-15,-15,0,0,0
2914,v1811,20171226,6605,6605,0,0,0,6670,6670,65,65,0,0,0
2915,v1811,20171227,6670,6670,0,0,0,6685,6685,15,15,0,0,0
2916,v1811,20171228,6685,6685,0,0,0,6650,6650,-35,-35,0,0,0
2917,v1811,20171229,6650,6650,0,0,0,6710,6710,60,60,0,0,0
2918,v1812,20171215,6700,6700,0,0,0,6640,6640,-60,-60,0,0,0
2919,v1812,20171218,6640,6640,0,0,0,6715,6715,75,75,0,0,0
2920,v1812,20171219,6715,6715,0,0,0,6760,6760,45,45,0,0,0
2921,v1812,20171220,6760,6760,0,0,0,6750,6750,-10,-10,0,0,0
2922,v1812,20171221,6750,6750,0,0,0,6670,6670,-80,-80,0,0,0
2923,v1812,20171222,6670,6670,0,0,0,6620,6620,-50,-50,0,0,0
2924,v1812,20171225,6620,6620,0,0,0,6605,6605,-15,-15,0,0,0
2925,v1812,20171226,6605,6605,0,0,0,6670,6670,65,65,0,0,0
2926,v1812,20171227,6670,6670,0,0,0,6685,6685,15,15,0,0,0
2927,v1812,20171228,6685,6685,6875,6875,6390,6850,6625,165,-60,8,265150,0
2928,v1812,20171229,6850,6625,0,0,0,6680,6680,55,55,0,0,0
