ROWNUM,合约,日期,前收盘价,前结算价,开盘价,最高价,最低价,收盘价,结算价,涨跌1,涨跌2,成交量,成交金额,持仓量
1,c1701,20170103,1489,1501,1501,1508,1484,1508,1490,7,-11,1338,19947900,18622
2,c1701,20170104,1508,1490,1516,1516,1480,1485,1493,-5,3,1282,19143000,16320
3,c1701,20170105,1485,1493,1514,1516,1514,1516,1514,23,21,1006,15238960,15320
4,c1701,20170106,1516,1514,1516,1516,1490,1490,1501,-24,-13,2200,33024000,13786
5,c1701,20170109,1490,1501,1482,1500,1480,1500,1497,-1,-4,1242,18601400,11636
6,c1701,20170110,1500,1497,1485,1485,1475,1475,1479,-22,-18,1614,23881760,9196
7,c1701,20170111,1475,1479,1500,1567,1500,1567,1501,88,22,326,4894020,7800
8,c1701,20170112,1567,1501,1510,1510,1510,1510,1510,9,9,100,1510000,7800
9,c1701,20170113,1510,1510,0,0,0,1510,1510,0,0,0,0,7122
10,c1701,20170116,1510,1510,0,0,0,1495,1495,-15,-15,0,0,0
11,c1703,20170103,1479,1477,1479,1480,1473,1475,1476,-2,-1,1010,14916720,8874
12,c1703,20170104,1475,1476,1478,1481,1475,1477,1478,1,2,434,6416200,8870
13,c1703,20170105,1477,1478,1479,1480,1475,1476,1477,-2,-1,702,10375140,8920
14,c1703,20170106,1476,1477,1477,1478,1467,1473,1472,-4,-5,326,4799920,8904
15,c1703,20170109,1473,1472,1472,1472,1466,1468,1468,-4,-4,262,3847080,8884
16,c1703,20170110,1468,1468,1460,1472,1460,1467,1467,-1,-1,250,3668760,8880
17,c1703,20170111,1467,1467,1466,1472,1466,1469,1469,2,2,336,4937460,8864
18,c1703,20170112,1469,1469,1469,1470,1465,1467,1466,-2,-3,304,4458180,8862
19,c1703,20170113,1467,1466,1461,1474,1461,1472,1471,6,5,336,4943080,8878
20,c1703,20170116,1472,1471,1470,1478,1470,1478,1475,7,4,584,8617160,8974
21,c1703,20170117,1478,1475,1477,1482,1472,1472,1477,-3,2,1212,17912480,9208
22,c1703,20170118,1472,1477,1476,1500,1474,1500,1486,23,9,1904,28298040,9130
23,c1703,20170119,1500,1486,1500,1506,1498,1499,1501,13,15,1228,18437400,8934
24,c1703,20170120,1499,1501,1502,1506,1492,1502,1499,1,-2,364,5458020,8926
25,c1703,20170123,1502,1499,1502,1510,1495,1506,1504,7,5,550,8275040,8926
26,c1703,20170124,1506,1504,1505,1514,1503,1505,1509,1,5,646,9749140,8564
27,c1703,20170125,1505,1509,1486,1499,1485,1492,1493,-17,-16,1134,16939060,8506
28,c1703,20170126,1492,1493,1505,1510,1493,1495,1496,2,3,1884,28200480,8502
29,c1703,20170203,1495,1496,1495,1505,1493,1505,1499,9,3,562,8429740,8576
30,c1703,20170206,1505,1499,1509,1570,1505,1527,1532,28,33,2558,39197800,8886
31,c1703,20170207,1527,1532,1529,1531,1511,1513,1520,-19,-12,424,6445340,8994
32,c1703,20170208,1513,1520,1508,1519,1508,1516,1512,-4,-8,8174,123611200,9650
33,c1703,20170209,1516,1512,1518,1530,1515,1519,1524,7,12,1186,18077580,9732
34,c1703,20170210,1519,1524,1524,1527,1515,1520,1519,-4,-5,450,6839540,9732
35,c1703,20170213,1520,1519,1530,1530,1519,1524,1522,5,3,700,10656060,9826
36,c1703,20170214,1524,1522,1520,1520,1509,1509,1513,-13,-9,676,10228100,9680
37,c1703,20170215,1509,1513,1506,1515,1506,1506,1510,-7,-3,1992,30089580,9324
38,c1703,20170216,1506,1510,1510,1517,1505,1505,1508,-5,-2,238,3590100,9280
39,c1703,20170217,1505,1508,1510,1510,1501,1503,1502,-5,-6,796,11963660,8748
40,c1703,20170220,1503,1502,1506,1511,1503,1506,1507,4,5,130,1959500,8732
41,c1703,20170221,1506,1507,1512,1517,1505,1508,1511,1,4,362,5471620,8676
42,c1703,20170222,1508,1511,1508,1511,1500,1510,1504,-1,-7,308,4633480,8604
43,c1703,20170223,1510,1504,1506,1516,1499,1500,1502,-4,-2,660,9916020,8512
44,c1703,20170224,1500,1502,1492,1503,1492,1499,1498,-3,-4,340,5094260,8388
45,c1703,20170227,1499,1498,1505,1529,1502,1508,1512,10,14,522,7894660,8202
46,c1703,20170228,1508,1512,1510,1535,1498,1501,1515,-11,3,1498,22697940,7398
47,c1703,20170301,1501,1515,1530,1550,1500,1514,1514,-1,-1,108,1635840,7400
48,c1703,20170302,1514,1514,1505,1505,1505,1505,1505,-9,-9,1700,25585000,4848
49,c1703,20170303,1505,1505,1525,1525,1511,1525,1522,20,17,648,9867600,4208
50,c1703,20170306,1525,1522,0,0,0,1522,1522,0,0,0,0,4208
51,c1703,20170307,1522,1522,1592,1593,1431,1500,1526,-22,4,388,5921040,3840
52,c1703,20170308,1500,1526,1580,1580,1580,1580,1580,54,54,4,63200,3840
53,c1703,20170309,1580,1580,0,0,0,1580,1580,0,0,0,0,880
54,c1703,20170310,1580,1580,1600,1600,1600,1600,1600,20,20,200,3200000,880
55,c1703,20170313,1600,1600,0,0,0,1600,1600,0,0,0,0,880
56,c1703,20170314,1600,1600,0,0,0,1518,1518,-82,-82,0,0,0
57,c1705,20170103,1519,1519,1518,1530,1514,1519,1521,0,2,926968,14103943680,2084556
58,c1705,20170104,1519,1521,1522,1545,1518,1534,1533,13,12,1608180,24665361100,2223460
59,c1705,20170105,1534,1533,1539,1543,1526,1527,1532,-6,-1,843106,12921176040,2229226
60,c1705,20170106,1527,1532,1529,1537,1506,1515,1522,-17,-10,1406662,21410244020,2266618
61,c1705,20170109,1515,1522,1513,1517,1501,1508,1508,-14,-14,902174,13612358440,2333308
62,c1705,20170110,1508,1508,1510,1516,1498,1503,1507,-5,-1,948046,14288147120,2414014
63,c1705,20170111,1503,1507,1506,1514,1503,1507,1509,0,2,981004,14804191700,2501116
64,c1705,20170112,1507,1509,1508,1515,1499,1508,1506,-1,-3,1133218,17072375500,2485608
65,c1705,20170113,1508,1506,1512,1526,1511,1513,1517,7,11,1166318,17699958500,2471028
66,c1705,20170116,1513,1517,1518,1532,1517,1529,1526,12,9,1139582,17398072560,2523402
67,c1705,20170117,1529,1526,1530,1539,1521,1524,1530,-2,4,974562,14911709280,2477628
68,c1705,20170118,1524,1530,1528,1565,1526,1562,1545,32,15,2104924,32522257080,2738830
69,c1705,20170119,1562,1545,1562,1574,1554,1558,1562,13,17,2059418,32187903840,2786890
70,c1705,20170120,1558,1562,1558,1569,1549,1564,1558,2,-4,1326494,20677421420,2711350
71,c1705,20170123,1564,1558,1567,1578,1560,1573,1568,15,10,1089490,17093226740,2705688
72,c1705,20170124,1573,1568,1573,1582,1557,1560,1570,-8,2,1422634,22346387000,2558454
73,c1705,20170125,1560,1570,1558,1558,1547,1556,1552,-14,-18,788424,12243348400,2458008
74,c1705,20170126,1556,1552,1560,1565,1554,1560,1559,8,7,325324,5071913040,2411414
75,c1705,20170203,1560,1559,1558,1575,1558,1573,1567,14,8,756736,11863715300,2462782
76,c1705,20170206,1573,1567,1578,1632,1577,1600,1603,33,36,3723882,59706804560,3229440
77,c1705,20170207,1600,1603,1600,1606,1588,1589,1594,-14,-9,2002418,31920928260,3391294
78,c1705,20170208,1589,1594,1594,1609,1591,1602,1600,8,6,1977856,31663061260,3520522
79,c1705,20170209,1602,1600,1607,1620,1595,1602,1608,2,8,2479128,39878169000,3459868
80,c1705,20170210,1602,1608,1600,1612,1589,1605,1602,-3,-6,1635212,26203404580,3420196
81,c1705,20170213,1605,1602,1613,1621,1600,1604,1611,2,9,1847450,29765511680,3432252
82,c1705,20170214,1604,1611,1605,1608,1572,1574,1587,-37,-24,2302814,36546975540,3300192
83,c1705,20170215,1574,1587,1570,1581,1562,1562,1572,-25,-15,1352322,21270548480,3230292
84,c1705,20170216,1562,1572,1573,1584,1565,1572,1576,0,4,1819206,28686091200,3136530
85,c1705,20170217,1572,1576,1569,1575,1553,1566,1562,-10,-14,1429908,22349184460,2996954
86,c1705,20170220,1566,1562,1566,1586,1563,1583,1578,21,16,1225614,19344228240,3043192
87,c1705,20170221,1583,1578,1585,1604,1583,1586,1594,8,16,1990974,31744328960,2763674
88,c1705,20170222,1586,1594,1584,1599,1581,1598,1590,4,-4,1167748,18572390680,2705756
89,c1705,20170223,1598,1590,1598,1604,1575,1584,1589,-6,-1,1429178,22716086280,2636254
90,c1705,20170224,1584,1589,1575,1592,1569,1591,1580,2,-9,1378056,21775390740,2571902
91,c1705,20170227,1591,1580,1596,1607,1595,1604,1602,24,22,1515486,24280036000,2567966
92,c1705,20170228,1604,1602,1605,1614,1597,1603,1605,1,3,1323872,21249361840,2487278
93,c1705,20170301,1603,1605,1608,1613,1593,1603,1601,-2,-4,1304060,20887525960,2507070
94,c1705,20170302,1603,1601,1610,1619,1607,1608,1612,7,11,1118680,18042587140,2489524
95,c1705,20170303,1608,1612,1605,1626,1599,1626,1612,14,0,1104322,17810255740,2451190
96,c1705,20170306,1626,1612,1630,1654,1630,1648,1645,36,33,2156384,35473161880,2348336
97,c1705,20170307,1648,1645,1648,1654,1637,1644,1644,-1,-1,1272466,20924024920,2181080
98,c1705,20170308,1644,1644,1638,1642,1621,1626,1632,-18,-12,1523890,24876892060,2016574
99,c1705,20170309,1626,1632,1624,1629,1601,1609,1611,-23,-21,1865654,30070674560,1872286
100,c1705,20170310,1609,1611,1605,1609,1586,1587,1596,-24,-15,1226896,19587866720,1711708
101,c1705,20170313,1587,1596,1580,1595,1577,1592,1587,-4,-9,698202,11086180460,1615668
102,c1705,20170314,1592,1587,1590,1597,1565,1565,1585,-22,-2,915780,14520639900,1545090
103,c1705,20170315,1565,1585,1575,1580,1568,1576,1574,-9,-11,539626,8495917560,1504480
104,c1705,20170316,1576,1574,1577,1585,1565,1575,1574,1,0,553354,8714270640,1428364
105,c1705,20170317,1575,1574,1575,1579,1570,1578,1575,4,1,331812,5226074300,1370408
106,c1705,20170320,1578,1575,1589,1599,1582,1597,1589,22,14,581764,9250012420,1271054
107,c1705,20170321,1597,1589,1592,1602,1591,1600,1596,11,7,376932,6018655420,1235474
108,c1705,20170322,1600,1596,1599,1627,1598,1625,1614,29,18,641828,10362433260,1122672
109,c1705,20170323,1625,1614,1625,1633,1606,1612,1617,-2,3,428338,6928500080,1056050
110,c1705,20170324,1612,1617,1613,1635,1609,1629,1621,12,4,415536,6738921520,1001198
111,c1705,20170327,1629,1621,1637,1649,1619,1636,1634,15,13,505850,8270151940,879702
112,c1705,20170328,1636,1634,1639,1646,1627,1643,1636,9,2,380170,6219590560,825124
113,c1705,20170329,1643,1636,1640,1643,1602,1612,1619,-24,-17,434420,7036452220,740548
114,c1705,20170330,1612,1619,1613,1617,1603,1607,1608,-12,-11,194352,3126064080,698672
115,c1705,20170331,1607,1608,1607,1620,1600,1616,1613,8,5,228810,3690760160,634234
116,c1705,20170405,1616,1613,1622,1631,1610,1630,1621,17,8,173068,2806206280,592892
117,c1705,20170406,1630,1621,1630,1636,1610,1634,1625,13,4,299270,4863247720,502714
118,c1705,20170407,1634,1625,1629,1640,1617,1620,1627,-5,2,202412,3293362560,448834
119,c1705,20170410,1620,1627,1625,1635,1615,1629,1625,2,-2,110424,1795398820,426096
120,c1705,20170411,1629,1625,1633,1639,1602,1606,1616,-19,-9,203272,3286251580,341438
121,c1705,20170412,1606,1616,1606,1610,1600,1603,1604,-13,-12,81990,1315703440,313864
122,c1705,20170413,1603,1604,1603,1608,1595,1602,1601,-2,-3,88278,1414047060,294864
123,c1705,20170414,1602,1601,1603,1605,1597,1605,1601,4,0,42360,678378740,279262
124,c1705,20170417,1605,1601,1606,1614,1604,1612,1609,11,8,55054,886350020,269958
125,c1705,20170418,1612,1609,1612,1615,1605,1607,1609,-2,0,52528,845264100,251820
126,c1705,20170419,1607,1609,1608,1608,1586,1594,1594,-15,-15,52192,832318440,239826
127,c1705,20170420,1594,1594,1591,1605,1591,1604,1599,10,5,28840,461413800,228840
128,c1705,20170421,1604,1599,1601,1632,1601,1631,1618,32,19,55750,902548140,210358
129,c1705,20170424,1631,1618,1626,1631,1621,1622,1625,4,7,31882,518314100,193432
130,c1705,20170425,1622,1625,1625,1627,1614,1618,1619,-7,-6,34626,560825940,179602
131,c1705,20170426,1618,1619,1623,1626,1617,1622,1622,3,3,28976,470262440,159472
132,c1705,20170427,1622,1622,1621,1621,1611,1617,1615,-5,-7,46598,752697620,133826
133,c1705,20170428,1617,1615,1615,1622,1614,1621,1618,6,3,27326,442199940,110764
134,c1705,20170502,1621,1618,1640,1640,1612,1631,1637,13,19,10704,175296140,21684
135,c1705,20170503,1631,1637,1639,1642,1621,1638,1638,1,1,8940,146488840,13058
136,c1705,20170504,1638,1638,1642,1650,1635,1648,1643,10,5,8704,143023520,8916
137,c1705,20170505,1648,1643,1630,1644,1630,1640,1640,-3,-3,2526,41437080,8666
138,c1705,20170508,1640,1640,1650,1650,1631,1631,1643,-9,3,442,7265640,7712
139,c1705,20170509,1631,1643,1670,1670,1670,1670,1670,27,27,26,434200,7712
140,c1705,20170510,1670,1670,1631,1670,1631,1670,1667,0,-3,508,8469560,7442
141,c1705,20170511,1670,1667,1660,1670,1660,1670,1661,3,-6,1564,25982400,4450
142,c1705,20170512,1670,1661,0,0,0,1661,1661,0,0,0,0,4416
143,c1705,20170515,1661,1661,1597,1710,1597,1710,1641,49,-20,80,1301400,0
144,c1707,20170103,1544,1542,1546,1555,1543,1549,1547,7,5,58,897540,1580
145,c1707,20170104,1549,1547,1555,1564,1555,1558,1559,11,12,14,218300,1576
146,c1707,20170105,1558,1559,1553,1558,1551,1558,1555,-1,-4,20,311000,1572
147,c1707,20170106,1558,1555,1552,1558,1538,1543,1550,-12,-5,34,527120,1560
148,c1707,20170109,1543,1550,1536,1539,1534,1538,1536,-12,-14,28,430320,1572
149,c1707,20170110,1538,1536,1535,1545,1529,1534,1536,-2,0,82,1260000,1578
150,c1707,20170111,1534,1536,1540,1542,1535,1537,1538,1,2,48,738420,1580
151,c1707,20170112,1537,1538,1539,1539,1532,1534,1533,-4,-5,28,429400,1578
152,c1707,20170113,1534,1533,1541,1551,1541,1551,1544,18,11,16,247120,1582
153,c1707,20170116,1551,1544,1541,1555,1541,1555,1549,11,5,86,1332520,1584
154,c1707,20170117,1555,1549,1560,1562,1550,1551,1555,2,6,84,1306740,1578
155,c1707,20170118,1551,1555,1556,1588,1556,1588,1568,33,13,68,1066780,1586
156,c1707,20170119,1588,1568,1594,1604,1586,1594,1595,26,27,188,2999440,1608
157,c1707,20170120,1594,1595,1590,1602,1590,1602,1595,7,0,32,510500,1614
158,c1707,20170123,1602,1595,1600,1608,1593,1608,1601,13,6,46,736600,1614
159,c1707,20170124,1608,1601,1608,1614,1592,1596,1603,-5,2,50,801880,1618
160,c1707,20170125,1596,1603,1587,1592,1583,1589,1585,-14,-18,96,1522480,1618
161,c1707,20170126,1589,1585,1592,1592,1588,1590,1590,5,5,44,699820,1608
162,c1707,20170203,1590,1590,1602,1605,1592,1604,1600,14,10,58,928280,1600
163,c1707,20170206,1604,1600,1610,1660,1608,1628,1632,28,32,450,7347860,1584
164,c1707,20170207,1628,1632,1626,1629,1617,1620,1623,-12,-9,258,4189660,1596
165,c1707,20170208,1620,1623,1637,1638,1620,1634,1629,11,6,112,1825300,1610
166,c1707,20170209,1634,1629,1641,1648,1632,1633,1640,4,11,102,1673760,1616
167,c1707,20170210,1633,1640,1638,1642,1627,1638,1634,-2,-6,44,719180,1614
168,c1707,20170213,1638,1634,1648,1650,1635,1635,1642,1,8,152,2496160,1680
169,c1707,20170214,1635,1642,1634,1634,1614,1614,1620,-28,-22,172,2786720,1750
170,c1707,20170215,1614,1620,1616,1638,1608,1608,1613,-12,-7,128,2065120,1796
171,c1707,20170216,1608,1613,1618,1625,1609,1609,1618,-4,5,200,3237620,1906
172,c1707,20170217,1609,1618,1615,1618,1600,1613,1609,-5,-9,132,2123960,1894
173,c1707,20170220,1613,1609,1626,1632,1618,1623,1625,14,16,60,975040,1866
174,c1707,20170221,1623,1625,1625,1647,1625,1631,1638,6,13,378,6194780,1826
175,c1707,20170222,1631,1638,1631,1644,1627,1638,1639,0,1,126,2066180,1832
176,c1707,20170223,1638,1639,1648,1649,1612,1627,1633,-12,-6,60,980240,1848
177,c1707,20170224,1627,1633,1622,1638,1615,1638,1627,5,-6,80,1302320,1842
178,c1707,20170227,1638,1627,1637,1654,1637,1645,1645,18,18,248,4081940,1740
179,c1707,20170228,1645,1645,1643,1650,1639,1641,1644,-4,-1,184,3025180,1620
180,c1707,20170301,1641,1644,1647,1649,1635,1645,1644,1,0,174,2861080,1604
181,c1707,20170302,1645,1644,1647,1659,1645,1645,1650,1,6,182,3003400,1534
182,c1707,20170303,1645,1650,1643,1659,1643,1655,1648,5,-2,154,2539100,1456
183,c1707,20170306,1655,1648,1660,1681,1660,1674,1672,26,24,388,6488500,1412
184,c1707,20170307,1674,1672,1672,1691,1664,1666,1669,-6,-3,134,2237620,1450
185,c1707,20170308,1666,1669,1662,1666,1651,1651,1658,-18,-11,442,7329100,1512
186,c1707,20170309,1651,1658,1653,1660,1635,1640,1642,-18,-16,292,4794660,1466
187,c1707,20170310,1640,1642,1635,1636,1620,1620,1623,-22,-19,182,2955260,1406
188,c1707,20170313,1620,1623,1611,1630,1609,1630,1618,7,-5,108,1748280,1410
189,c1707,20170314,1630,1618,1656,1656,1605,1605,1624,-13,6,198,3215960,1414
190,c1707,20170315,1605,1624,1607,1619,1607,1612,1613,-12,-11,82,1323460,1420
191,c1707,20170316,1612,1613,1620,1628,1610,1618,1618,5,5,50,809240,1426
192,c1707,20170317,1618,1618,1620,1622,1616,1622,1618,4,0,40,647400,1432
193,c1707,20170320,1622,1618,1624,1642,1624,1642,1637,24,19,200,3275160,1464
194,c1707,20170321,1642,1637,1634,1643,1632,1643,1634,6,-3,166,2714040,1406
195,c1707,20170322,1643,1634,1645,1660,1634,1653,1643,19,9,172,2826680,1456
196,c1707,20170323,1653,1643,1653,1660,1640,1641,1646,-2,3,124,2041980,1440
197,c1707,20170324,1641,1646,1648,1662,1640,1656,1650,10,4,74,1221340,1460
198,c1707,20170327,1656,1650,1665,1668,1646,1652,1656,2,6,282,4670040,1506
199,c1707,20170328,1652,1656,1650,1665,1647,1665,1658,9,2,168,2785920,1526
200,c1707,20170329,1665,1658,1665,1666,1622,1633,1641,-25,-17,342,5614580,1366
201,c1707,20170330,1633,1641,1630,1638,1622,1625,1626,-16,-15,66,1073560,1342
202,c1707,20170331,1625,1626,1625,1632,1620,1630,1625,4,-1,46,747920,1342
203,c1707,20170405,1630,1625,1636,1640,1627,1637,1635,12,10,70,1144580,1342
204,c1707,20170406,1637,1635,1635,1644,1621,1640,1635,5,0,70,1144620,1338
205,c1707,20170407,1640,1635,1640,1642,1622,1623,1634,-12,-1,154,2516420,1352
206,c1707,20170410,1623,1634,1627,1639,1621,1635,1632,1,-2,100,1632960,1352
207,c1707,20170411,1635,1632,1638,1644,1620,1620,1634,-12,2,260,4250360,1434
208,c1707,20170412,1620,1634,1628,1628,1607,1612,1615,-22,-19,172,2779180,1400
209,c1707,20170413,1612,1615,1619,1623,1609,1613,1615,-2,0,94,1518160,1442
210,c1707,20170414,1613,1615,1618,1623,1616,1622,1620,7,5,88,1425620,1446
211,c1707,20170417,1622,1620,1621,1624,1616,1620,1619,0,-1,72,1165940,1432
212,c1707,20170418,1620,1619,1618,1623,1610,1610,1617,-9,-2,214,3462440,1282
213,c1707,20170419,1610,1617,1588,1615,1588,1607,1608,-10,-9,210,3376940,1388
214,c1707,20170420,1607,1608,1602,1615,1602,1615,1610,7,2,56,901620,1372
215,c1707,20170421,1615,1610,1612,1637,1611,1632,1625,22,15,224,3640920,1208
216,c1707,20170424,1632,1625,1624,1630,1623,1630,1625,5,0,38,617540,1192
217,c1707,20170425,1630,1625,1609,1632,1609,1621,1621,-4,-4,196,3178600,1286
218,c1707,20170426,1621,1621,1628,1628,1623,1623,1624,2,3,72,1169780,1280
219,c1707,20170427,1623,1624,1615,1617,1609,1616,1615,-8,-9,28,452200,1288
220,c1707,20170428,1616,1615,1618,1623,1611,1620,1619,5,4,60,971980,1306
221,c1707,20170502,1620,1619,1622,1643,1622,1637,1638,18,19,156,2556440,1248
222,c1707,20170503,1637,1638,1635,1638,1630,1632,1632,-6,-6,68,1110180,1268
223,c1707,20170504,1632,1632,1633,1646,1629,1634,1638,2,6,100,1638940,1272
224,c1707,20170505,1634,1638,1639,1651,1633,1633,1640,-5,2,52,852800,1276
225,c1707,20170508,1633,1640,1631,1647,1631,1635,1638,-5,-2,50,819260,1246
226,c1707,20170509,1635,1638,1616,1633,1611,1625,1623,-13,-15,70,1136300,1268
227,c1707,20170510,1625,1623,1633,1640,1625,1625,1630,2,7,62,1010620,1280
228,c1707,20170511,1625,1630,1625,1634,1625,1634,1628,4,-2,134,2181580,1220
229,c1707,20170512,1634,1628,1637,1637,1626,1636,1634,8,6,36,588520,1194
230,c1707,20170515,1636,1634,1648,1648,1627,1627,1639,-7,5,54,885340,1188
231,c1707,20170516,1627,1639,1626,1628,1620,1628,1624,-11,-15,50,812060,1176
232,c1707,20170517,1628,1624,1623,1636,1623,1629,1632,5,8,34,555000,1168
233,c1707,20170518,1629,1632,1626,1637,1625,1632,1631,0,-1,46,750580,1166
234,c1707,20170519,1632,1631,1637,1639,1632,1639,1635,8,4,34,556160,1164
235,c1707,20170522,1639,1635,1635,1635,1618,1619,1621,-16,-14,78,1265040,1178
236,c1707,20170523,1619,1621,1618,1637,1618,1622,1623,1,2,98,1590700,1172
237,c1707,20170524,1622,1623,1626,1635,1621,1633,1625,10,2,48,780420,1168
238,c1707,20170525,1633,1625,1627,1633,1626,1633,1630,8,5,30,489220,1164
239,c1707,20170526,1633,1630,1628,1632,1624,1632,1627,2,-3,36,586020,1156
240,c1707,20170531,1632,1627,1637,1637,1620,1629,1631,2,4,286,4665600,976
241,c1707,20170601,1629,1631,1632,1648,1632,1647,1635,16,4,168,2748200,886
242,c1707,20170602,1647,1635,1645,1652,1642,1647,1646,12,11,114,1877540,832
243,c1707,20170605,1647,1646,1654,1654,1645,1650,1649,4,3,32,527720,814
244,c1707,20170606,1650,1649,1653,1658,1647,1656,1651,7,2,86,1420700,814
245,c1707,20170607,1656,1651,1651,1663,1651,1659,1656,8,5,206,3412300,708
246,c1707,20170608,1659,1656,1656,1680,1654,1654,1659,-2,3,116,1925480,640
247,c1707,20170609,1654,1659,1651,1686,1651,1685,1668,26,9,52,867760,618
248,c1707,20170612,1685,1668,1673,1689,1663,1678,1686,10,18,482,8127900,606
249,c1707,20170613,1678,1686,1660,1666,1650,1650,1656,-36,-30,186,3081440,702
250,c1707,20170614,1650,1656,1646,1651,1640,1645,1643,-11,-13,50,821820,722
251,c1707,20170615,1645,1643,1640,1648,1640,1640,1643,-3,0,14,230060,722
252,c1707,20170616,1640,1643,1627,1627,1620,1627,1625,-16,-18,24,390060,724
253,c1707,20170619,1627,1625,1620,1629,1618,1618,1622,-7,-3,20,324520,722
254,c1707,20170620,1618,1622,1571,1616,1571,1596,1585,-26,-37,94,1490340,712
255,c1707,20170621,1596,1585,1597,1615,1597,1608,1604,23,19,58,930540,714
256,c1707,20170622,1608,1604,1612,1612,1602,1605,1607,1,3,34,546460,708
257,c1707,20170623,1605,1607,1606,1620,1601,1615,1614,8,7,246,3971780,710
258,c1707,20170626,1615,1614,1621,1646,1621,1633,1635,19,21,548,8961700,1100
259,c1707,20170627,1633,1635,1632,1640,1631,1632,1637,-3,2,108,1768240,1106
260,c1707,20170628,1632,1637,1638,1652,1625,1625,1638,-12,1,74,1212840,1104
261,c1707,20170629,1625,1638,1623,1641,1622,1641,1626,3,-12,34,552860,1100
262,c1707,20170630,1641,1626,1678,1678,1624,1626,1634,0,8,106,1732600,1096
263,c1707,20170703,1626,1634,1650,1650,1640,1650,1646,16,12,100,1646800,178
264,c1707,20170704,1650,1646,1548,1650,1548,1625,1619,-21,-27,48,777520,0
265,c1707,20170705,1625,1619,0,0,0,1619,1619,0,0,0,0,0
266,c1707,20170706,1619,1619,0,0,0,1619,1619,0,0,0,0,0
267,c1707,20170707,1619,1619,0,0,0,1619,1619,0,0,0,0,0
268,c1707,20170710,1619,1619,0,0,0,1619,1619,0,0,0,0,0
269,c1707,20170711,1619,1619,0,0,0,1619,1619,0,0,0,0,0
270,c1707,20170712,1619,1619,1630,1630,1630,1630,1630,11,11,400,6520000,0
271,c1707,20170713,1630,1630,0,0,0,1630,1630,0,0,0,0,0
272,c1707,20170714,1630,1630,0,0,0,1632,1632,2,2,0,0,0
273,c1709,20170103,1571,1568,1571,1585,1571,1580,1578,12,10,97816,1544510420,324596
274,c1709,20170104,1580,1578,1577,1599,1577,1587,1589,9,11,142208,2260894740,344064
275,c1709,20170105,1587,1589,1591,1594,1578,1579,1584,-10,-5,94172,1491736400,366732
276,c1709,20170106,1579,1584,1579,1588,1565,1572,1574,-12,-10,135688,2135855460,364556
277,c1709,20170109,1572,1574,1570,1574,1561,1569,1567,-5,-7,95718,1500667980,376404
278,c1709,20170110,1569,1567,1570,1579,1565,1569,1571,2,4,114446,1798880200,395046
279,c1709,20170111,1569,1571,1579,1582,1569,1573,1575,2,4,136528,2151397480,426520
280,c1709,20170112,1573,1575,1561,1581,1561,1569,1570,-6,-5,143310,2250624360,445372
281,c1709,20170113,1569,1570,1574,1586,1573,1577,1580,7,10,148690,2349596680,450308
282,c1709,20170116,1577,1580,1579,1593,1578,1589,1586,9,6,143498,2276301500,444380
283,c1709,20170117,1589,1586,1589,1602,1587,1589,1593,3,7,152742,2434487100,460736
284,c1709,20170118,1589,1593,1594,1635,1588,1632,1610,39,17,268284,4321467500,522436
285,c1709,20170119,1632,1610,1631,1655,1629,1639,1641,29,31,439602,7217607740,574322
286,c1709,20170120,1639,1641,1638,1659,1633,1650,1647,9,6,284840,4692187060,646496
287,c1709,20170123,1650,1647,1655,1659,1645,1649,1649,2,2,241714,3988046160,678524
288,c1709,20170124,1649,1649,1651,1655,1640,1641,1648,-8,-1,207816,3425386180,703432
289,c1709,20170125,1641,1648,1634,1637,1622,1631,1629,-17,-19,147174,2398831480,672456
290,c1709,20170126,1631,1629,1637,1640,1633,1637,1636,8,7,70022,1145829280,662080
291,c1709,20170203,1637,1636,1642,1656,1638,1656,1649,20,13,189500,3125342260,704908
292,c1709,20170206,1656,1649,1663,1718,1660,1679,1689,30,40,901520,15234109720,932676
293,c1709,20170207,1679,1689,1673,1682,1663,1665,1669,-24,-20,582354,9723318620,1071524
294,c1709,20170208,1665,1669,1670,1685,1670,1678,1677,9,8,440952,7397655520,1159216
295,c1709,20170209,1678,1677,1683,1693,1668,1673,1681,-4,4,569102,9570294200,1222534
296,c1709,20170210,1673,1681,1673,1679,1660,1673,1669,-8,-12,455768,7610262420,1313610
297,c1709,20170213,1673,1669,1681,1690,1672,1672,1680,3,11,507804,8531960720,1384344
298,c1709,20170214,1672,1680,1670,1679,1645,1646,1659,-34,-21,624430,10362687340,1447250
299,c1709,20170215,1646,1659,1640,1657,1632,1633,1646,-26,-13,413870,6814019520,1458634
300,c1709,20170216,1633,1646,1642,1656,1637,1643,1648,-3,2,530340,8740664240,1495368
301,c1709,20170217,1643,1648,1639,1647,1623,1641,1635,-7,-13,494288,8083932240,1496270
302,c1709,20170220,1641,1635,1636,1659,1636,1658,1651,23,16,380688,6285218160,1528596
303,c1709,20170221,1658,1651,1660,1672,1656,1658,1663,7,12,609958,10146914260,1594664
304,c1709,20170222,1658,1663,1656,1671,1652,1668,1661,5,-2,342652,5694394920,1607330
305,c1709,20170223,1668,1661,1670,1676,1647,1654,1661,-7,0,475646,7901091640,1635438
306,c1709,20170224,1654,1661,1646,1668,1632,1667,1653,6,-8,532992,8811656840,1671024
307,c1709,20170227,1667,1653,1669,1685,1669,1685,1677,32,24,789846,13251517520,1723924
308,c1709,20170228,1685,1677,1680,1696,1678,1687,1686,10,9,661640,11156622680,1823108
309,c1709,20170301,1687,1686,1693,1696,1670,1684,1682,-2,-4,748328,12592271360,1856908
310,c1709,20170302,1684,1682,1695,1698,1686,1690,1692,8,10,554462,9383039980,1954880
311,c1709,20170303,1690,1692,1683,1708,1680,1707,1692,15,0,693978,11746851720,1991558
312,c1709,20170306,1707,1692,1710,1731,1710,1719,1721,27,29,1023778,17623986880,2074476
313,c1709,20170307,1719,1721,1718,1723,1708,1713,1715,-8,-6,687028,11785486040,2088690
314,c1709,20170308,1713,1715,1702,1710,1690,1698,1701,-17,-14,823486,14014994600,2080596
315,c1709,20170309,1698,1701,1692,1698,1679,1688,1686,-13,-15,1162912,19612492520,2092678
316,c1709,20170310,1688,1686,1684,1687,1663,1665,1674,-21,-12,986658,16519344640,2089206
317,c1709,20170313,1665,1674,1658,1675,1653,1673,1666,-1,-8,749548,12493070500,2146956
318,c1709,20170314,1673,1666,1669,1683,1646,1648,1668,-18,2,1696376,28310569540,2273838
319,c1709,20170315,1648,1668,1655,1665,1650,1661,1658,-7,-10,1072526,17787347020,2345822
320,c1709,20170316,1661,1658,1664,1671,1645,1657,1657,-1,-1,1335958,22145891840,2434672
321,c1709,20170317,1657,1657,1656,1662,1650,1659,1657,2,0,948036,15711247160,2448036
322,c1709,20170320,1659,1657,1664,1686,1664,1683,1676,26,19,1441254,24168520840,2570850
323,c1709,20170321,1683,1676,1679,1690,1676,1686,1682,10,6,1260966,21220623140,2635262
324,c1709,20170322,1686,1682,1686,1711,1681,1710,1699,28,17,2091152,35529312160,2505676
325,c1709,20170323,1710,1699,1710,1715,1687,1693,1698,-6,-1,1566338,26610296360,2471824
326,c1709,20170324,1693,1698,1693,1712,1686,1705,1698,7,0,1707110,28999452560,2528610
327,c1709,20170327,1705,1698,1710,1722,1690,1704,1705,6,7,1771398,30206689200,2414212
328,c1709,20170328,1704,1705,1706,1721,1697,1716,1708,11,3,1490256,25465834960,2498614
329,c1709,20170329,1716,1708,1712,1714,1662,1673,1684,-35,-24,2663530,44875436520,2439700
330,c1709,20170330,1673,1684,1673,1677,1665,1670,1671,-14,-13,997778,16673916400,2317176
331,c1709,20170331,1670,1671,1671,1679,1662,1672,1672,1,1,1012176,16925766420,2272606
332,c1709,20170405,1672,1672,1675,1685,1666,1682,1676,10,4,1128202,18912182080,2268970
333,c1709,20170406,1682,1676,1682,1693,1653,1691,1677,15,1,2196456,36843156380,2202516
334,c1709,20170407,1691,1677,1685,1693,1665,1669,1676,-8,-1,1815498,30443991080,2010088
335,c1709,20170410,1669,1676,1672,1684,1660,1675,1673,-1,-3,1174012,19644386440,1972180
336,c1709,20170411,1675,1673,1681,1686,1631,1633,1652,-40,-21,2663586,44025442120,2070226
337,c1709,20170412,1633,1652,1631,1640,1623,1626,1633,-26,-19,1132200,18495113920,1980722
338,c1709,20170413,1626,1633,1630,1639,1621,1636,1632,3,-1,1078650,17606582020,2017788
339,c1709,20170414,1636,1632,1638,1645,1634,1639,1639,7,7,935078,15334963320,1967864
340,c1709,20170417,1639,1639,1641,1647,1632,1639,1638,0,-1,904770,14826387160,1940446
341,c1709,20170418,1639,1638,1637,1639,1623,1628,1631,-10,-7,1004102,16378372080,1919332
342,c1709,20170419,1628,1631,1623,1624,1606,1616,1614,-15,-17,1309118,21132466020,1839010
343,c1709,20170420,1616,1614,1616,1629,1614,1626,1622,12,8,725662,11776905460,1799344
344,c1709,20170421,1626,1622,1622,1650,1620,1649,1635,27,13,1105960,18093484380,1704166
345,c1709,20170424,1649,1635,1649,1652,1636,1642,1643,7,8,814786,13389106100,1704772
346,c1709,20170425,1642,1643,1640,1645,1626,1630,1634,-13,-9,836714,13673808300,1697344
347,c1709,20170426,1630,1634,1636,1644,1634,1635,1637,1,3,614346,10061567760,1687442
348,c1709,20170427,1635,1637,1634,1635,1616,1623,1622,-14,-15,1027034,16662883340,1723104
349,c1709,20170428,1623,1622,1626,1628,1620,1622,1623,0,1,441180,7163542560,1690124
350,c1709,20170502,1622,1623,1631,1652,1623,1649,1643,26,20,1266968,20817437040,1697368
351,c1709,20170503,1649,1643,1645,1646,1635,1637,1639,-6,-4,574338,9418679740,1644098
352,c1709,20170504,1637,1639,1632,1651,1623,1640,1641,1,2,1173958,19275414100,1652490
353,c1709,20170505,1640,1641,1636,1648,1632,1640,1640,-1,-1,1008028,16536822740,1659744
354,c1709,20170508,1640,1640,1646,1655,1635,1642,1644,2,4,1359524,22358817160,1736212
355,c1709,20170509,1642,1644,1640,1642,1621,1628,1628,-16,-16,1119082,18227719040,1746014
356,c1709,20170510,1628,1628,1631,1635,1618,1626,1626,-2,-2,791252,12869942060,1660156
357,c1709,20170511,1626,1626,1630,1645,1622,1645,1633,19,7,853672,13947482180,1599208
358,c1709,20170512,1645,1633,1643,1645,1636,1644,1640,11,7,629266,10324480860,1618422
359,c1709,20170515,1644,1640,1645,1660,1628,1629,1645,-11,5,1365566,22465753440,1659328
360,c1709,20170516,1629,1645,1626,1635,1624,1629,1629,-16,-16,678022,11050622120,1675270
361,c1709,20170517,1629,1629,1632,1643,1629,1643,1637,14,8,754538,12353363020,1629886
362,c1709,20170518,1643,1637,1639,1643,1632,1639,1637,2,0,587848,9625186060,1582938
363,c1709,20170519,1639,1637,1639,1648,1638,1643,1643,6,6,573042,9415682680,1575700
364,c1709,20170522,1643,1643,1643,1645,1610,1618,1622,-25,-21,1343276,21795050040,1670184
365,c1709,20170523,1618,1622,1620,1626,1613,1615,1619,-7,-3,601388,9738118880,1661090
366,c1709,20170524,1615,1619,1612,1629,1605,1622,1621,3,2,898080,14558426580,1640730
367,c1709,20170525,1622,1621,1624,1625,1614,1619,1618,-2,-3,496064,8028675740,1638034
368,c1709,20170526,1619,1618,1617,1623,1612,1619,1618,1,0,479736,7763561780,1595994
369,c1709,20170531,1619,1618,1620,1624,1604,1608,1614,-10,-4,921344,14870987800,1598746
370,c1709,20170601,1608,1614,1612,1632,1607,1627,1619,13,5,1208998,19582579020,1590890
371,c1709,20170602,1627,1619,1625,1639,1621,1636,1632,17,13,779286,12721907060,1569628
372,c1709,20170605,1636,1632,1634,1641,1632,1639,1636,7,4,515582,8437346080,1560916
373,c1709,20170606,1639,1636,1639,1642,1629,1638,1634,2,-2,456774,7467664400,1518970
374,c1709,20170607,1638,1634,1642,1644,1634,1637,1638,3,4,462082,7573425340,1510686
375,c1709,20170608,1637,1638,1641,1645,1632,1637,1637,-1,-1,698422,11436044380,1494558
376,c1709,20170609,1637,1637,1637,1674,1635,1672,1654,35,17,1575888,26067982340,1656652
377,c1709,20170612,1672,1654,1673,1688,1662,1687,1674,33,20,1021032,17100107560,1701650
378,c1709,20170613,1687,1674,1680,1684,1666,1668,1674,-6,0,841228,14085506280,1627666
379,c1709,20170614,1668,1674,1670,1684,1669,1683,1676,9,2,576780,9667532600,1653026
380,c1709,20170615,1683,1676,1675,1686,1671,1678,1678,2,2,577952,9698347860,1648312
381,c1709,20170616,1678,1678,1680,1691,1671,1674,1678,-4,0,684676,11492009180,1629904
382,c1709,20170619,1674,1678,1672,1682,1659,1660,1669,-18,-9,872750,14569601660,1607842
383,c1709,20170620,1660,1669,1659,1666,1656,1665,1661,-4,-8,511876,8502600800,1596700
384,c1709,20170621,1665,1661,1659,1672,1659,1668,1667,7,6,394220,6575005900,1599592
385,c1709,20170622,1668,1667,1666,1670,1661,1663,1665,-4,-2,321164,5348451460,1559166
386,c1709,20170623,1663,1665,1661,1679,1654,1676,1670,11,5,716334,11967935060,1542490
387,c1709,20170626,1676,1670,1675,1704,1675,1692,1694,22,24,1060536,17968221340,1549864
388,c1709,20170627,1692,1694,1690,1700,1688,1699,1693,5,-1,538200,9113859940,1502946
389,c1709,20170628,1699,1693,1695,1713,1686,1688,1700,-5,7,914050,15538983320,1432370
390,c1709,20170629,1688,1700,1691,1695,1684,1686,1689,-14,-11,502556,8489374400,1397190
391,c1709,20170630,1686,1689,1688,1696,1683,1687,1689,-2,0,571918,9660856520,1332110
392,c1709,20170703,1687,1689,1704,1708,1680,1686,1688,-3,-1,693826,11718298060,1366832
393,c1709,20170704,1686,1688,1685,1690,1675,1679,1681,-9,-7,561522,9443040480,1362760
394,c1709,20170705,1679,1681,1681,1688,1679,1683,1684,2,3,397456,6693904440,1375022
395,c1709,20170706,1683,1684,1684,1688,1669,1673,1676,-11,-8,580602,9732211520,1363156
396,c1709,20170707,1673,1676,1676,1678,1663,1676,1671,0,-5,715004,11952529240,1419054
397,c1709,20170710,1676,1671,1684,1693,1671,1672,1683,1,12,708088,11922098100,1410700
398,c1709,20170711,1672,1683,1677,1680,1670,1674,1674,-9,-9,478350,8011516540,1438330
399,c1709,20170712,1674,1674,1676,1689,1676,1681,1682,7,8,513740,8643380020,1445122
400,c1709,20170713,1681,1682,1678,1678,1660,1664,1668,-18,-14,655580,10936098000,1434702
401,c1709,20170714,1664,1668,1656,1669,1656,1666,1664,-2,-4,449400,7480549140,1363856
402,c1709,20170717,1666,1664,1667,1691,1655,1689,1674,25,10,909056,15224519400,1294576
403,c1709,20170718,1689,1674,1693,1695,1680,1687,1688,13,14,647626,10936485920,1280832
404,c1709,20170719,1687,1688,1686,1690,1676,1677,1682,-11,-6,481642,8103885600,1275326
405,c1709,20170720,1677,1682,1680,1692,1677,1685,1684,3,2,518308,8731281480,1319218
406,c1709,20170721,1685,1684,1686,1692,1671,1675,1679,-9,-5,704108,11827425500,1254800
407,c1709,20170724,1675,1679,1666,1672,1663,1667,1668,-12,-11,367518,6132052180,1177532
408,c1709,20170725,1667,1668,1672,1673,1660,1668,1665,0,-3,414842,6907718320,1133262
409,c1709,20170726,1668,1665,1664,1669,1653,1655,1659,-10,-6,450298,7474671300,1057836
410,c1709,20170727,1655,1659,1658,1662,1650,1653,1656,-6,-3,377110,6245575420,1040624
411,c1709,20170728,1653,1656,1655,1669,1650,1661,1659,5,3,462742,7680249520,990910
412,c1709,20170731,1661,1659,1659,1661,1644,1645,1650,-14,-9,430092,7098950700,951196
413,c1709,20170801,1645,1650,1648,1656,1645,1648,1650,-2,0,296254,4890201360,922116
414,c1709,20170802,1648,1650,1649,1653,1641,1650,1646,0,-4,307252,5059827100,850282
415,c1709,20170803,1650,1646,1651,1659,1649,1652,1654,6,8,156406,2588227500,793762
416,c1709,20170804,1652,1654,1653,1665,1650,1663,1660,9,6,155788,2586688300,733768
417,c1709,20170807,1663,1660,1668,1670,1652,1660,1661,0,1,145520,2417145500,698964
418,c1709,20170808,1660,1661,1663,1669,1662,1667,1666,6,5,130704,2178213820,621026
419,c1709,20170809,1667,1666,1665,1686,1665,1683,1680,17,14,321732,5405239120,459604
420,c1709,20170810,1683,1680,1681,1686,1677,1683,1680,3,0,161484,2714535180,374002
421,c1709,20170811,1683,1680,1681,1685,1670,1682,1680,2,0,145472,2444496420,301212
422,c1709,20170814,1682,1680,1679,1690,1679,1683,1684,3,4,89516,1507583360,266554
423,c1709,20170815,1683,1684,1683,1692,1683,1683,1687,-1,3,101666,1715870460,211980
424,c1709,20170816,1683,1687,1680,1688,1680,1683,1684,-4,-3,39542,666006800,191878
425,c1709,20170817,1683,1684,1685,1700,1683,1697,1691,13,7,96100,1625387420,160122
426,c1709,20170818,1697,1691,1700,1700,1691,1694,1694,3,3,32654,553214960,141758
427,c1709,20170821,1694,1694,1689,1766,1689,1695,1698,1,4,46946,797243920,120966
428,c1709,20170822,1695,1698,1695,1709,1691,1705,1698,7,0,27340,464415800,108624
429,c1709,20170823,1705,1698,1700,1714,1700,1703,1709,5,11,35184,601346800,89818
430,c1709,20170824,1703,1709,1702,1707,1699,1704,1702,-5,-7,12948,220424980,82146
431,c1709,20170825,1704,1702,1702,1707,1692,1697,1702,-5,0,20176,343449220,70288
432,c1709,20170828,1697,1702,1702,1702,1685,1686,1690,-16,-12,17016,287616340,59452
433,c1709,20170829,1686,1690,1681,1685,1652,1653,1666,-37,-24,17254,287478200,47626
434,c1709,20170830,1653,1666,1649,1656,1641,1642,1644,-24,-22,22650,372539580,31498
435,c1709,20170831,1642,1644,1645,1645,1617,1636,1629,-8,-15,14592,237811760,21624
436,c1709,20170901,1636,1629,1610,1651,1610,1627,1640,-2,11,798,13092140,17942
437,c1709,20170904,1627,1640,1645,1645,1627,1640,1634,0,-6,656,10725320,13784
438,c1709,20170905,1640,1634,1631,1638,1630,1635,1634,1,0,1062,17360600,12856
439,c1709,20170906,1635,1634,1652,1655,1650,1650,1654,16,20,660,10916920,11400
440,c1709,20170907,1650,1654,1650,1657,1640,1640,1654,-14,0,1288,21313300,11020
441,c1709,20170908,1640,1654,1635,1689,1635,1689,1648,35,-6,260,4285820,7108
442,c1709,20170911,1689,1648,1686,1686,1630,1630,1662,-18,14,120,1994400,1638
443,c1709,20170912,1630,1662,0,0,0,1662,1662,0,0,0,0,1638
444,c1709,20170913,1662,1662,1666,1675,1601,1610,1640,-52,-22,4004,65675600,2640
445,c1709,20170914,1610,1640,1661,1661,1661,1661,1643,21,3,600,9886080,0
446,c1711,20170103,1608,1610,1606,1624,1606,1616,1619,6,9,152,2461140,752
447,c1711,20170104,1616,1619,1625,1632,1622,1627,1627,8,8,286,4654520,692
448,c1711,20170105,1627,1627,1629,1630,1618,1621,1620,-6,-7,114,1847340,702
449,c1711,20170106,1621,1620,1625,1625,1601,1608,1610,-12,-10,236,3801640,650
450,c1711,20170109,1608,1610,1608,1612,1600,1606,1605,-4,-5,88,1412660,668
451,c1711,20170110,1606,1605,1611,1613,1602,1602,1608,-3,3,118,1897880,660
452,c1711,20170111,1602,1608,1619,1619,1602,1606,1608,-2,0,284,4567300,788
453,c1711,20170112,1606,1608,1609,1612,1598,1606,1606,-2,-2,352,5654800,1030
454,c1711,20170113,1606,1606,1609,1618,1606,1610,1612,4,6,208,3354380,1002
455,c1711,20170116,1610,1612,1608,1614,1604,1610,1608,-2,-4,248,3990240,980
456,c1711,20170117,1610,1608,1617,1617,1607,1611,1612,3,4,146,2353840,1054
457,c1711,20170118,1611,1612,1614,1634,1609,1634,1618,22,6,262,4241580,1052
458,c1711,20170119,1634,1618,1640,1659,1632,1649,1646,31,28,518,8531300,1170
459,c1711,20170120,1649,1646,1649,1665,1644,1663,1654,17,8,98,1621000,1180
460,c1711,20170123,1663,1654,1684,1684,1655,1660,1662,6,8,172,2859460,1140
461,c1711,20170124,1660,1662,1657,1666,1648,1649,1655,-13,-7,172,2846940,1088
462,c1711,20170125,1649,1655,1638,1678,1634,1646,1646,-9,-9,554,9124340,1132
463,c1711,20170126,1646,1646,1665,1665,1647,1655,1650,9,4,180,2970980,1142
464,c1711,20170203,1655,1650,1670,1670,1651,1667,1663,17,13,122,2029760,1130
465,c1711,20170206,1667,1663,1684,1746,1672,1718,1716,55,53,716,12290540,1384
466,c1711,20170207,1718,1716,1708,1734,1705,1716,1721,0,5,1314,22616600,1944
467,c1711,20170208,1716,1721,1719,1730,1717,1726,1725,5,4,292,5037280,1912
468,c1711,20170209,1726,1725,1725,1739,1719,1719,1729,-6,4,240,4151540,1900
469,c1711,20170210,1719,1729,1721,1727,1709,1718,1717,-11,-12,132,2266740,1894
470,c1711,20170213,1718,1717,1731,1732,1718,1719,1723,2,6,132,2275400,1830
471,c1711,20170214,1719,1723,1717,1719,1698,1701,1705,-22,-18,136,2319520,1890
472,c1711,20170215,1701,1705,1695,1706,1687,1690,1698,-15,-7,170,2887740,2006
473,c1711,20170216,1690,1698,1704,1705,1691,1693,1700,-5,2,110,1870260,2054
474,c1711,20170217,1693,1700,1694,1699,1679,1690,1696,-10,-4,402,6820720,2052
475,c1711,20170220,1690,1696,1704,1706,1694,1705,1699,9,3,122,2073580,1984
476,c1711,20170221,1705,1699,1707,1722,1707,1713,1712,14,13,184,3151600,2008
477,c1711,20170222,1713,1712,1713,1714,1704,1714,1709,2,-3,64,1094280,1976
478,c1711,20170223,1714,1709,1715,1720,1693,1701,1704,-8,-5,208,3546140,1964
479,c1711,20170224,1701,1704,1692,1709,1688,1709,1701,5,-3,126,2143540,1920
480,c1711,20170227,1709,1701,1717,1729,1715,1727,1720,26,19,146,2511540,1860
481,c1711,20170228,1727,1720,1720,1738,1717,1727,1728,7,8,118,2040200,1850
482,c1711,20170301,1727,1728,1732,1733,1714,1727,1724,-1,-4,208,3586260,1764
483,c1711,20170302,1727,1724,1733,1740,1728,1728,1733,4,9,84,1455960,1772
484,c1711,20170303,1728,1733,1731,1743,1730,1743,1734,10,1,328,5688860,1850
485,c1711,20170306,1743,1734,1748,1790,1746,1756,1758,22,24,316,5556800,1856
486,c1711,20170307,1756,1758,1761,1761,1745,1749,1751,-9,-7,182,3186940,1864
487,c1711,20170308,1749,1751,1736,1747,1730,1733,1736,-18,-15,302,5243940,1862
488,c1711,20170309,1733,1736,1732,1732,1716,1726,1722,-10,-14,196,3376480,1890
489,c1711,20170310,1726,1722,1720,1725,1712,1712,1717,-10,-5,192,3296840,1876
490,c1711,20170313,1712,1717,1681,1721,1681,1718,1715,1,-2,140,2401720,1962
491,c1711,20170314,1718,1715,1720,1729,1685,1685,1714,-30,-1,258,4423120,2006
492,c1711,20170315,1685,1714,1695,1715,1695,1709,1708,-5,-6,162,2767220,2012
493,c1711,20170316,1709,1708,1717,1717,1699,1708,1706,0,-2,246,4198880,2118
494,c1711,20170317,1708,1706,1708,1711,1703,1710,1707,4,1,60,1024640,2122
495,c1711,20170320,1710,1707,1722,1732,1715,1720,1723,13,16,684,11788440,2248
496,c1711,20170321,1720,1723,1713,1728,1711,1722,1718,-1,-5,488,8383880,2504
497,c1711,20170322,1722,1718,1743,1745,1708,1737,1729,19,11,216,3736160,2542
498,c1711,20170323,1737,1729,1730,1739,1716,1719,1719,-10,-10,720,12377180,2294
499,c1711,20170324,1719,1719,1714,1730,1714,1730,1719,11,0,198,3404940,2202
500,c1711,20170327,1730,1719,1728,1733,1715,1719,1724,0,5,186,3207640,2114
501,c1711,20170328,1719,1724,1718,1733,1716,1725,1729,1,5,286,4944960,1948
502,c1711,20170329,1725,1729,1720,1723,1703,1703,1711,-26,-18,618,10576280,1836
503,c1711,20170330,1703,1711,1707,1707,1701,1702,1703,-9,-8,40,681540,1828
504,c1711,20170331,1702,1703,1707,1712,1702,1705,1707,2,4,24,409700,1834
505,c1711,20170405,1705,1707,1710,1715,1704,1704,1709,-3,2,22,376140,1830
506,c1711,20170406,1704,1709,1700,1714,1693,1709,1705,0,-4,96,1637240,1820
507,c1711,20170407,1709,1705,1718,1718,1693,1695,1698,-10,-7,60,1019380,1820
508,c1711,20170410,1695,1698,1692,1705,1691,1697,1693,-1,-5,266,4504380,2032
509,c1711,20170411,1697,1693,1699,1705,1671,1671,1682,-22,-11,418,7034360,2072
510,c1711,20170412,1671,1682,1671,1678,1662,1662,1668,-20,-14,178,2969840,2112
511,c1711,20170413,1662,1668,1669,1675,1659,1667,1664,-1,-4,146,2430360,2120
512,c1711,20170414,1667,1664,1664,1680,1654,1656,1666,-8,2,108,1799340,2068
513,c1711,20170417,1656,1666,1672,1674,1660,1668,1666,2,0,104,1733280,2092
514,c1711,20170418,1668,1666,1669,1674,1660,1660,1668,-6,2,246,4104660,2092
515,c1711,20170419,1660,1668,1651,1654,1644,1646,1649,-22,-19,852,14052440,2268
516,c1711,20170420,1646,1649,1654,1658,1653,1655,1655,6,6,178,2945920,2154
517,c1711,20170421,1655,1655,1661,1682,1661,1679,1669,24,14,78,1302280,2138
518,c1711,20170424,1679,1669,1678,1687,1670,1674,1681,5,12,258,4338680,2122
519,c1711,20170425,1674,1681,1676,1677,1663,1665,1670,-16,-11,180,3006080,2124
520,c1711,20170426,1665,1670,1680,1682,1670,1677,1677,7,7,46,771580,2154
521,c1711,20170427,1677,1677,1660,1666,1655,1655,1660,-22,-17,70,1162520,2160
522,c1711,20170428,1655,1660,1660,1666,1657,1657,1661,-3,1,6,99660,2160
523,c1711,20170502,1657,1661,1663,1686,1663,1685,1681,24,20,220,3698760,2050
524,c1711,20170503,1685,1681,1673,1675,1669,1671,1671,-10,-10,78,1303500,2044
525,c1711,20170504,1671,1671,1675,1685,1665,1676,1674,5,3,98,1640900,2022
526,c1711,20170505,1676,1674,1677,1679,1666,1670,1676,-4,2,42,704020,2020
527,c1711,20170508,1670,1676,1678,1685,1673,1678,1679,2,3,24,403080,2022
528,c1711,20170509,1678,1679,1672,1672,1658,1660,1661,-19,-18,130,2159840,2036
529,c1711,20170510,1660,1661,1667,1669,1656,1662,1661,1,0,24,398820,2022
530,c1711,20170511,1662,1661,1665,1678,1662,1677,1672,16,11,28,468420,2010
531,c1711,20170512,1677,1672,1671,1678,1671,1673,1674,1,2,80,1339360,2010
532,c1711,20170515,1673,1674,1684,1686,1666,1666,1682,-8,8,78,1312380,1950
533,c1711,20170516,1666,1682,1667,1668,1664,1666,1665,-16,-17,94,1565140,1970
534,c1711,20170517,1666,1665,1667,1676,1667,1674,1673,9,8,46,769620,1946
535,c1711,20170518,1674,1673,1666,1666,1666,1666,1666,-7,-7,2,33320,1946
536,c1711,20170519,1666,1666,1667,1676,1666,1672,1672,6,6,30,501620,1924
537,c1711,20170522,1672,1672,1672,1672,1652,1657,1657,-15,-15,290,4807120,1940
538,c1711,20170523,1657,1657,1661,1664,1653,1657,1656,0,-1,216,3578880,1948
539,c1711,20170524,1657,1656,1657,1667,1657,1661,1661,5,5,100,1661020,1916
540,c1711,20170525,1661,1661,1658,1664,1656,1657,1658,-4,-3,36,597120,1922
541,c1711,20170526,1657,1658,1656,1657,1655,1657,1656,-1,-2,6,99360,1916
542,c1711,20170531,1657,1656,1653,1660,1651,1651,1655,-5,-1,180,2979240,1848
543,c1711,20170601,1651,1655,1654,1669,1654,1667,1659,12,4,122,2024540,1826
544,c1711,20170602,1667,1659,1668,1679,1668,1670,1671,11,12,508,8489000,1344
545,c1711,20170605,1670,1671,1673,1677,1673,1677,1675,6,4,22,368580,1340
546,c1711,20170606,1677,1675,1674,1678,1670,1676,1673,1,-2,34,569100,1336
547,c1711,20170607,1676,1673,1679,1679,1673,1675,1676,2,3,26,435920,1350
548,c1711,20170608,1675,1676,1678,1679,1673,1673,1676,-3,0,94,1575980,1392
549,c1711,20170609,1673,1676,1678,1706,1678,1703,1692,27,16,138,2335600,1372
550,c1711,20170612,1703,1692,1703,1723,1701,1720,1711,28,19,208,3560060,1308
551,c1711,20170613,1720,1711,1711,1714,1707,1707,1709,-4,-2,62,1059940,1316
552,c1711,20170614,1707,1709,1712,1713,1701,1709,1704,0,-5,260,4432060,1462
553,c1711,20170615,1709,1704,1703,1710,1703,1710,1706,6,2,100,1706160,1460
554,c1711,20170616,1710,1706,1708,1710,1696,1698,1705,-8,-1,58,989080,1472
555,c1711,20170619,1698,1705,1696,1703,1683,1687,1693,-18,-12,108,1829000,1438
556,c1711,20170620,1687,1693,1686,1688,1680,1688,1684,-5,-9,70,1179140,1378
557,c1711,20170621,1688,1684,1694,1694,1687,1688,1690,4,6,20,338160,1372
558,c1711,20170622,1688,1690,1688,1692,1687,1687,1688,-3,-2,42,709120,1350
559,c1711,20170623,1687,1688,1687,1739,1687,1690,1709,2,21,1140,19488420,1454
560,c1711,20170626,1690,1709,1702,1717,1702,1706,1709,-3,0,350,5984080,1480
561,c1711,20170627,1706,1709,1702,1713,1695,1709,1704,0,-5,184,3137000,1546
562,c1711,20170628,1709,1704,1709,1717,1694,1694,1709,-10,5,210,3589440,1522
563,c1711,20170629,1694,1709,1701,1702,1691,1696,1699,-13,-10,118,2004980,1508
564,c1711,20170630,1696,1699,1706,1706,1694,1694,1700,-5,1,110,1870120,1448
565,c1711,20170703,1694,1700,1705,1705,1697,1698,1700,-2,0,56,952280,1452
566,c1711,20170704,1698,1700,1703,1704,1688,1690,1695,-10,-5,42,712300,1474
567,c1711,20170705,1690,1695,1695,1699,1693,1695,1695,0,0,18,305160,1476
568,c1711,20170706,1695,1695,1691,1694,1683,1686,1688,-9,-7,32,540280,1474
569,c1711,20170707,1686,1688,1690,1694,1682,1692,1686,4,-2,196,3306080,1560
570,c1711,20170710,1692,1686,1696,1709,1690,1690,1700,4,14,202,3434420,1460
571,c1711,20170711,1690,1700,1696,1701,1691,1699,1696,-1,-4,62,1051980,1476
572,c1711,20170712,1699,1696,1704,1705,1696,1704,1702,8,6,56,953180,1482
573,c1711,20170713,1704,1702,1698,1698,1683,1690,1690,-12,-12,126,2130100,1482
574,c1711,20170714,1690,1690,1688,1694,1687,1689,1689,-1,-1,120,2027740,1434
575,c1711,20170717,1689,1689,1687,1700,1684,1700,1695,11,6,264,4475560,1360
576,c1711,20170718,1700,1695,1700,1706,1694,1701,1701,6,6,64,1088900,1374
577,c1711,20170719,1701,1701,1696,1702,1692,1692,1694,-9,-7,90,1525260,1310
578,c1711,20170720,1692,1694,1698,1702,1695,1699,1698,5,4,48,815120,1312
579,c1711,20170721,1699,1698,1697,1697,1690,1693,1692,-5,-6,68,1150980,1324
580,c1711,20170724,1693,1692,1685,1688,1685,1687,1686,-5,-6,118,1989640,1334
581,c1711,20170725,1687,1686,1687,1690,1682,1686,1684,0,-2,72,1212760,1332
582,c1711,20170726,1686,1684,1686,1686,1673,1680,1680,-4,-4,374,6286820,1198
583,c1711,20170727,1680,1680,1684,1684,1677,1682,1678,2,-2,86,1443680,1132
584,c1711,20170728,1682,1678,1678,1687,1671,1687,1674,9,-4,588,9846060,678
585,c1711,20170731,1687,1674,1685,1686,1674,1675,1683,1,9,190,3198520,710
586,c1711,20170801,1675,1683,1678,1686,1676,1676,1679,-7,-4,106,1780600,714
587,c1711,20170802,1676,1679,1680,1680,1667,1673,1670,-6,-9,62,1035860,702
588,c1711,20170803,1673,1670,1678,1683,1674,1674,1678,4,8,24,402800,694
589,c1711,20170804,1674,1678,1680,1685,1677,1683,1680,5,2,122,2050460,630
590,c1711,20170807,1683,1680,1682,1686,1668,1679,1680,-1,0,54,907500,618
591,c1711,20170808,1679,1680,1682,1682,1682,1682,1682,2,2,2,33640,616
592,c1711,20170809,1682,1682,1695,1718,1690,1716,1703,34,21,118,2009800,566
593,c1711,20170810,1716,1703,1724,1724,1702,1707,1711,4,8,190,3250960,548
594,c1711,20170811,1707,1711,1700,1710,1691,1704,1704,-7,-7,88,1499560,536
595,c1711,20170814,1704,1704,1704,1711,1704,1711,1707,7,3,24,409680,544
596,c1711,20170815,1711,1707,1708,1711,1702,1707,1707,0,0,92,1570580,556
597,c1711,20170816,1707,1707,1702,1708,1702,1708,1705,1,-2,26,443340,552
598,c1711,20170817,1708,1705,1706,1716,1702,1714,1709,9,4,82,1401820,534
599,c1711,20170818,1714,1709,1708,1710,1705,1705,1706,-4,-3,44,750860,528
600,c1711,20170821,1705,1706,1708,1713,1706,1708,1708,2,2,28,478420,536
601,c1711,20170822,1708,1708,1700,1715,1700,1711,1711,3,3,60,1027020,534
602,c1711,20170823,1711,1711,1715,1716,1710,1710,1712,-1,1,56,958900,534
603,c1711,20170824,1710,1712,1709,1709,1699,1704,1702,-8,-10,30,510860,532
604,c1711,20170825,1704,1702,1704,1704,1695,1695,1700,-7,-2,10,170080,532
605,c1711,20170828,1695,1700,1702,1702,1691,1691,1696,-9,-4,22,373260,530
606,c1711,20170829,1691,1696,1690,1697,1667,1671,1685,-25,-11,58,977680,532
607,c1711,20170830,1671,1685,1668,1681,1668,1673,1674,-12,-11,52,870940,534
608,c1711,20170831,1673,1674,1671,1673,1650,1660,1662,-14,-12,156,2593700,572
609,c1711,20170901,1660,1662,1660,1669,1655,1661,1660,-1,-2,222,3687220,592
610,c1711,20170904,1661,1660,1670,1673,1662,1671,1670,11,10,360,6013700,842
611,c1711,20170905,1671,1670,1668,1671,1664,1670,1669,0,-1,200,3338240,886
612,c1711,20170906,1670,1669,1667,1678,1667,1673,1674,4,5,280,4688160,1044
613,c1711,20170907,1673,1674,1676,1678,1670,1670,1675,-4,1,152,2546300,1056
614,c1711,20170908,1670,1675,1669,1676,1643,1645,1656,-30,-19,134,2219280,1020
615,c1711,20170911,1645,1656,1642,1650,1642,1646,1647,-10,-9,36,593220,1024
616,c1711,20170912,1646,1647,1642,1647,1642,1646,1645,-1,-2,20,329060,1026
617,c1711,20170913,1646,1645,1642,1650,1634,1649,1642,4,-3,34,558600,1022
618,c1711,20170914,1649,1642,1659,1682,1659,1661,1670,19,28,284,4743200,1170
619,c1711,20170915,1661,1670,1656,1659,1646,1651,1654,-19,-16,98,1621880,1186
620,c1711,20170918,1651,1654,1647,1659,1645,1650,1654,-4,0,72,1191440,1170
621,c1711,20170919,1650,1654,1646,1659,1646,1656,1655,2,1,106,1754700,1164
622,c1711,20170920,1656,1655,1664,1673,1660,1664,1667,9,12,320,5337100,982
623,c1711,20170921,1664,1667,1658,1670,1658,1670,1664,3,-3,40,665900,970
624,c1711,20170922,1670,1664,1666,1685,1666,1668,1673,4,9,104,1740700,944
625,c1711,20170925,1668,1673,1674,1674,1665,1667,1666,-6,-7,76,1266220,998
626,c1711,20170926,1667,1666,1672,1687,1669,1677,1678,11,12,96,1611180,1006
627,c1711,20170927,1677,1678,1672,1672,1668,1670,1669,-8,-9,14,233680,1006
628,c1711,20170928,1670,1669,1662,1664,1650,1652,1655,-17,-14,40,662320,990
629,c1711,20170929,1652,1655,1642,1653,1642,1650,1651,-5,-4,70,1156380,938
630,c1711,20171009,1650,1651,1659,1659,1629,1631,1637,-20,-14,36,589560,930
631,c1711,20171010,1631,1637,1633,1634,1623,1634,1629,-3,-8,192,3129400,940
632,c1711,20171011,1634,1629,1637,1637,1631,1633,1632,4,3,30,489820,934
633,c1711,20171012,1633,1632,1633,1633,1630,1630,1632,-2,0,6,97920,934
634,c1711,20171013,1630,1632,1639,1639,1633,1634,1634,2,2,28,457720,932
635,c1711,20171016,1634,1634,1632,1635,1625,1635,1631,1,-3,104,1696840,936
636,c1711,20171017,1635,1631,1635,1643,1632,1640,1637,9,6,160,2620360,940
637,c1711,20171018,1640,1637,1648,1655,1632,1638,1638,1,1,40,655540,938
638,c1711,20171019,1638,1638,1635,1639,1635,1639,1636,1,-2,8,130880,938
639,c1711,20171020,1639,1636,1633,1640,1633,1635,1636,-1,0,10,163620,934
640,c1711,20171023,1635,1636,1628,1631,1625,1626,1627,-10,-9,38,618500,928
641,c1711,20171024,1626,1627,1627,1640,1623,1635,1631,8,4,74,1207560,918
642,c1711,20171025,1635,1631,1638,1638,1632,1635,1634,4,3,20,326900,910
643,c1711,20171026,1635,1634,1638,1641,1621,1630,1630,-4,-4,72,1174300,896
644,c1711,20171027,1630,1630,1620,1635,1620,1633,1631,3,1,88,1435580,898
645,c1711,20171030,1633,1631,1604,1664,1604,1629,1629,-2,-2,5490,89463820,6286
646,c1711,20171031,1629,1629,1629,1637,1608,1637,1629,8,0,1920,31279180,8074
647,c1711,20171101,1637,1629,1650,1650,1650,1650,1650,21,21,1196,19734000,0
648,c1711,20171102,1650,1650,0,0,0,1650,1650,0,0,0,0,0
649,c1711,20171103,1650,1650,0,0,0,1650,1650,0,0,0,0,0
650,c1711,20171106,1650,1650,0,0,0,1650,1650,0,0,0,0,0
651,c1711,20171107,1650,1650,0,0,0,1650,1650,0,0,0,0,0
652,c1711,20171108,1650,1650,0,0,0,1650,1650,0,0,0,0,0
653,c1711,20171109,1650,1650,0,0,0,1650,1650,0,0,0,0,0
654,c1711,20171110,1650,1650,0,0,0,1650,1650,0,0,0,0,0
655,c1711,20171113,1650,1650,0,0,0,1650,1650,0,0,0,0,0
656,c1711,20171114,1650,1650,0,0,0,1650,1650,0,0,0,0,0
657,c1801,20170117,1608,1608,1618,1627,1590,1624,1619,16,11,15452,250321120,13400
658,c1801,20170118,1624,1619,1624,1672,1620,1671,1639,52,20,12248,200862580,20518
659,c1801,20170119,1671,1639,1672,1697,1662,1689,1682,50,43,28874,485926440,33788
660,c1801,20170120,1689,1682,1688,1708,1683,1703,1696,21,14,19646,333336020,41230
661,c1801,20170123,1703,1696,1711,1717,1693,1696,1701,0,5,20062,341274020,48948
662,c1801,20170124,1696,1701,1695,1702,1682,1684,1694,-17,-7,14858,251716560,52136
663,c1801,20170125,1684,1694,1680,1683,1666,1680,1674,-14,-20,20562,344236140,55710
664,c1801,20170126,1680,1674,1685,1697,1674,1683,1684,9,10,7254,122174060,58346
665,c1801,20170203,1683,1684,1683,1703,1683,1702,1695,18,11,9220,156364580,62170
666,c1801,20170206,1702,1695,1708,1779,1708,1743,1750,48,55,73668,1289267480,99100
667,c1801,20170207,1743,1750,1740,1749,1728,1730,1736,-20,-14,126962,2204365600,182910
668,c1801,20170208,1730,1736,1739,1750,1735,1744,1742,8,6,66448,1157773740,216702
669,c1801,20170209,1744,1742,1746,1759,1734,1737,1748,-5,6,61396,1073621940,239442
670,c1801,20170210,1737,1748,1738,1746,1730,1738,1737,-10,-11,34200,594319700,245610
671,c1801,20170213,1738,1737,1742,1753,1738,1739,1744,2,7,41208,718694800,253310
672,c1801,20170214,1739,1744,1739,1743,1713,1715,1725,-29,-19,39184,676172560,263860
673,c1801,20170215,1715,1725,1710,1723,1703,1703,1714,-22,-11,25156,431314260,270936
674,c1801,20170216,1703,1714,1713,1723,1706,1711,1716,-3,2,49076,842383900,287420
675,c1801,20170217,1711,1716,1706,1713,1693,1706,1702,-10,-14,41538,707094660,287942
676,c1801,20170220,1706,1702,1702,1720,1702,1720,1714,18,12,34598,593318000,296170
677,c1801,20170221,1720,1714,1721,1730,1717,1719,1724,5,10,39076,673745240,299410
678,c1801,20170222,1719,1724,1714,1728,1714,1728,1723,4,-1,24054,414474000,303138
679,c1801,20170223,1728,1723,1727,1732,1707,1712,1719,-11,-4,39542,679823840,301128
680,c1801,20170224,1712,1719,1707,1728,1695,1728,1714,9,-5,47338,811818220,299996
681,c1801,20170227,1728,1714,1729,1742,1728,1739,1735,25,21,45020,781248340,299458
682,c1801,20170228,1739,1735,1742,1749,1734,1745,1740,10,5,32846,571567020,305348
683,c1801,20170301,1745,1740,1749,1752,1731,1744,1743,4,3,29060,506676900,313206
684,c1801,20170302,1744,1743,1749,1756,1745,1749,1750,6,7,36262,634903140,325306
685,c1801,20170303,1749,1750,1743,1765,1741,1764,1752,14,2,24530,429840100,330150
686,c1801,20170306,1764,1752,1765,1787,1765,1775,1777,23,25,56718,1008277840,350760
687,c1801,20170307,1775,1777,1773,1779,1765,1768,1770,-9,-7,52638,931924860,364272
688,c1801,20170308,1768,1770,1765,1765,1747,1750,1756,-20,-14,43870,770733220,367678
689,c1801,20170309,1750,1756,1749,1752,1737,1744,1743,-12,-13,65334,1139233740,377452
690,c1801,20170310,1744,1743,1740,1743,1726,1727,1733,-16,-10,55524,962622240,379608
691,c1801,20170313,1727,1733,1720,1737,1715,1736,1728,3,-5,46840,809738620,380356
692,c1801,20170314,1736,1728,1738,1743,1720,1722,1731,-6,3,76152,1318241100,389640
693,c1801,20170315,1722,1731,1730,1736,1725,1733,1730,2,-1,80662,1395761700,398920
694,c1801,20170316,1733,1730,1735,1742,1725,1734,1732,4,2,76814,1330563240,408342
695,c1801,20170317,1734,1732,1733,1740,1730,1738,1735,6,3,41520,720489160,415308
696,c1801,20170320,1738,1735,1743,1768,1743,1767,1757,32,22,80998,1423919640,426682
697,c1801,20170321,1767,1757,1759,1774,1759,1771,1768,14,11,88842,1570934400,461310
698,c1801,20170322,1771,1768,1771,1791,1765,1789,1778,21,10,123236,2191665460,459182
699,c1801,20170323,1789,1778,1792,1795,1762,1765,1774,-13,-4,121934,2163573940,474560
700,c1801,20170324,1765,1774,1760,1777,1756,1767,1764,-7,-10,112068,1977037440,479350
701,c1801,20170327,1767,1764,1769,1780,1747,1757,1760,-7,-4,114594,2017669700,481308
702,c1801,20170328,1757,1760,1757,1769,1748,1760,1760,0,0,90998,1602161680,480334
703,c1801,20170329,1760,1760,1762,1762,1725,1733,1741,-27,-19,196274,3417353780,525976
704,c1801,20170330,1733,1741,1733,1739,1728,1732,1732,-9,-9,70710,1225164440,520164
705,c1801,20170331,1732,1732,1732,1738,1723,1731,1731,-1,-1,62220,1077151020,519892
706,c1801,20170405,1731,1731,1742,1742,1728,1735,1731,4,0,112974,1956210360,505752
707,c1801,20170406,1735,1731,1735,1739,1713,1732,1726,1,-5,188808,3259614020,510424
708,c1801,20170407,1732,1726,1728,1735,1714,1715,1721,-11,-5,145510,2505078520,518784
709,c1801,20170410,1715,1721,1713,1725,1707,1720,1716,-1,-5,116826,2005244040,530742
710,c1801,20170411,1720,1716,1725,1730,1685,1685,1703,-31,-13,272720,4646718480,554580
711,c1801,20170412,1685,1703,1685,1689,1659,1670,1677,-33,-26,181390,3042788920,535296
712,c1801,20170413,1670,1677,1672,1679,1665,1675,1672,-2,-5,131554,2200562620,550406
713,c1801,20170414,1675,1672,1674,1687,1673,1680,1680,8,8,103196,1734222680,549064
714,c1801,20170417,1680,1680,1687,1687,1664,1673,1673,-7,-7,148556,2485533620,537998
715,c1801,20170418,1673,1673,1674,1679,1660,1665,1669,-8,-4,154592,2580729220,529842
716,c1801,20170419,1665,1669,1661,1663,1645,1655,1653,-14,-16,169290,2798538640,534878
717,c1801,20170420,1655,1653,1653,1666,1652,1663,1660,10,7,97174,1613478140,534060
718,c1801,20170421,1663,1660,1661,1686,1656,1685,1672,25,12,175622,2936724780,542130
719,c1801,20170424,1685,1672,1685,1686,1668,1676,1675,4,3,153934,2579463340,562636
720,c1801,20170425,1676,1675,1679,1679,1666,1670,1671,-5,-4,136992,2289570120,569396
721,c1801,20170426,1670,1671,1675,1683,1673,1675,1677,4,6,112130,1880824380,566538
722,c1801,20170427,1675,1677,1672,1673,1656,1662,1662,-15,-15,155624,2587885320,572808
723,c1801,20170428,1662,1662,1660,1666,1658,1662,1662,0,0,74608,1240134080,566210
724,c1801,20170502,1662,1662,1669,1695,1661,1694,1683,32,21,238288,4010897260,549308
725,c1801,20170503,1694,1683,1690,1690,1680,1682,1684,-1,1,108096,1820542220,555702
726,c1801,20170504,1682,1684,1683,1692,1672,1681,1684,-3,0,168416,2837271500,562942
727,c1801,20170505,1681,1684,1676,1690,1676,1681,1683,-3,-1,145680,2451876480,563666
728,c1801,20170508,1681,1683,1690,1694,1679,1685,1686,2,3,134148,2262232260,562074
729,c1801,20170509,1685,1686,1683,1684,1667,1673,1674,-13,-12,129006,2159595760,571896
730,c1801,20170510,1673,1674,1673,1679,1666,1669,1672,-5,-2,79530,1329803640,565050
731,c1801,20170511,1669,1672,1673,1689,1669,1689,1677,17,5,101436,1702016100,552808
732,c1801,20170512,1689,1677,1683,1691,1681,1689,1685,12,8,82164,1385129960,554082
733,c1801,20170515,1689,1685,1690,1705,1679,1679,1690,-6,5,169062,2858591260,563626
734,c1801,20170516,1679,1690,1676,1687,1672,1685,1682,-5,-8,90652,1524861680,564872
735,c1801,20170517,1685,1682,1688,1698,1686,1695,1692,13,10,146834,2485751280,582526
736,c1801,20170518,1695,1692,1692,1694,1684,1689,1687,-3,-5,97958,1653072320,568360
737,c1801,20170519,1689,1687,1682,1697,1682,1695,1692,8,5,88932,1505243080,569408
738,c1801,20170522,1695,1692,1696,1700,1666,1669,1677,-23,-15,249772,4189359820,596590
739,c1801,20170523,1669,1677,1672,1677,1665,1666,1670,-11,-7,95296,1592218640,603488
740,c1801,20170524,1666,1670,1665,1678,1660,1671,1671,1,1,109546,1830602860,596718
741,c1801,20170525,1671,1671,1672,1676,1668,1671,1670,0,-1,46376,774723360,597600
742,c1801,20170526,1671,1670,1671,1673,1665,1670,1669,0,-1,63408,1058715800,598374
743,c1801,20170531,1670,1669,1671,1673,1656,1658,1664,-11,-5,144964,2413054000,577992
744,c1801,20170601,1658,1664,1665,1679,1657,1673,1667,9,3,161438,2691323960,557840
745,c1801,20170602,1673,1667,1672,1686,1669,1683,1679,16,12,120232,2019267640,543600
746,c1801,20170605,1683,1679,1683,1693,1679,1692,1685,13,6,89012,1500724220,538376
747,c1801,20170606,1692,1685,1690,1691,1682,1688,1685,3,0,64310,1084154900,536566
748,c1801,20170607,1688,1685,1690,1694,1687,1691,1690,6,5,64556,1091485440,549224
749,c1801,20170608,1691,1690,1695,1696,1686,1692,1691,2,1,98780,1670387300,556592
750,c1801,20170609,1692,1691,1691,1735,1690,1734,1713,43,22,313600,5374860260,642144
751,c1801,20170612,1734,1713,1737,1756,1726,1754,1740,41,27,248920,4333108440,699568
752,c1801,20170613,1754,1740,1743,1753,1735,1738,1742,-2,2,226742,3951663840,725374
753,c1801,20170614,1738,1742,1736,1749,1734,1748,1741,6,-1,157840,2748180940,741376
754,c1801,20170615,1748,1741,1741,1752,1737,1748,1743,7,2,137070,2390431500,743580
755,c1801,20170616,1748,1743,1751,1753,1731,1734,1741,-9,-2,174356,3035905780,746212
756,c1801,20170619,1734,1741,1730,1740,1719,1722,1730,-19,-11,199094,3444490360,721200
757,c1801,20170620,1722,1730,1718,1722,1711,1720,1717,-10,-13,172312,2958609380,682438
758,c1801,20170621,1720,1717,1716,1726,1715,1723,1721,6,4,86484,1488698800,681480
759,c1801,20170622,1723,1721,1723,1723,1712,1715,1717,-6,-4,80870,1389047340,664642
760,c1801,20170623,1715,1717,1714,1728,1702,1724,1717,7,0,182640,3136314380,650476
761,c1801,20170626,1724,1717,1719,1749,1719,1736,1740,19,23,263324,4582789480,639178
762,c1801,20170627,1736,1740,1736,1744,1734,1741,1739,1,-1,132926,2312121080,650082
763,c1801,20170628,1741,1739,1745,1754,1726,1728,1739,-11,0,308268,5363716460,686698
764,c1801,20170629,1728,1739,1728,1734,1725,1729,1729,-10,-10,125600,2172499700,697928
765,c1801,20170630,1729,1729,1730,1734,1721,1721,1726,-8,-3,197256,3404924260,707090
766,c1801,20170703,1721,1726,1735,1743,1724,1730,1730,4,4,193806,3353284720,743950
767,c1801,20170704,1730,1730,1730,1733,1714,1719,1722,-11,-8,158702,2734038460,750614
768,c1801,20170705,1719,1722,1721,1727,1718,1721,1723,-1,1,89068,1534925320,751442
769,c1801,20170706,1721,1723,1724,1726,1711,1714,1717,-9,-6,111638,1916841980,761028
770,c1801,20170707,1714,1717,1712,1725,1711,1725,1717,8,0,161704,2776973920,765364
771,c1801,20170710,1725,1717,1729,1742,1717,1717,1729,0,12,226676,3921391300,764818
772,c1801,20170711,1717,1729,1720,1728,1719,1726,1724,-3,-5,166112,2863900440,795562
773,c1801,20170712,1726,1724,1728,1734,1722,1727,1728,3,4,153082,2646379800,798426
774,c1801,20170713,1727,1728,1720,1722,1710,1712,1715,-16,-13,210028,3603777900,813296
775,c1801,20170714,1712,1715,1705,1712,1700,1707,1707,-8,-8,279356,4768951560,804212
776,c1801,20170717,1707,1707,1706,1721,1700,1717,1710,10,3,281810,4819581920,808966
777,c1801,20170718,1717,1710,1721,1725,1711,1715,1719,5,9,227874,3917326000,811236
778,c1801,20170719,1715,1719,1714,1718,1703,1706,1710,-13,-9,175326,2999443060,816456
779,c1801,20170720,1706,1710,1708,1718,1706,1714,1714,4,4,154952,2656315200,818838
780,c1801,20170721,1714,1714,1717,1719,1704,1707,1709,-7,-5,232930,3981832360,858958
781,c1801,20170724,1707,1709,1700,1701,1688,1689,1693,-20,-16,293952,4976621440,850912
782,c1801,20170725,1689,1693,1695,1696,1687,1691,1690,-2,-3,223458,3778504780,860736
783,c1801,20170726,1691,1690,1687,1690,1677,1679,1683,-11,-7,238988,4022486180,849470
784,c1801,20170727,1679,1683,1682,1690,1681,1686,1686,3,3,238878,4027693520,830886
785,c1801,20170728,1686,1686,1688,1697,1681,1691,1689,5,3,363266,6137356800,836566
786,c1801,20170731,1691,1689,1687,1689,1673,1679,1681,-10,-8,337508,5674559780,922660
787,c1801,20170801,1679,1681,1678,1684,1675,1678,1679,-3,-2,253786,4262599680,928520
788,c1801,20170802,1678,1679,1673,1677,1663,1674,1671,-5,-8,405962,6784184520,960942
789,c1801,20170803,1674,1671,1673,1679,1671,1673,1675,2,4,273680,4585356380,976220
790,c1801,20170804,1673,1675,1674,1679,1671,1676,1675,1,0,247098,4139869220,1008176
791,c1801,20170807,1676,1675,1680,1683,1651,1674,1672,-1,-3,414220,6926326620,999976
792,c1801,20170808,1674,1672,1677,1683,1676,1680,1679,8,7,290886,4885032960,1027036
793,c1801,20170809,1680,1679,1682,1720,1681,1714,1702,35,23,982358,16720935700,1115368
794,c1801,20170810,1714,1702,1714,1724,1711,1718,1716,16,14,632410,10856360040,1194580
795,c1801,20170811,1718,1716,1702,1729,1700,1727,1715,11,-1,762502,13081346540,1219194
796,c1801,20170814,1727,1715,1727,1737,1719,1721,1724,6,9,579330,9990128160,1236070
797,c1801,20170815,1721,1724,1723,1740,1719,1720,1727,-4,3,850470,14692077020,1263282
798,c1801,20170816,1720,1727,1719,1727,1716,1724,1722,-3,-5,385214,6636369360,1275882
799,c1801,20170817,1724,1722,1726,1742,1725,1737,1735,15,13,852628,14796565360,1380686
800,c1801,20170818,1737,1735,1732,1740,1727,1728,1732,-7,-3,395372,6848942520,1380626
801,c1801,20170821,1728,1732,1729,1738,1720,1725,1729,-7,-3,579112,10015459600,1352640
802,c1801,20170822,1725,1729,1725,1741,1717,1737,1729,8,0,571640,9888260280,1407068
803,c1801,20170823,1737,1729,1736,1744,1726,1727,1735,-2,6,639080,11088136760,1382984
804,c1801,20170824,1727,1735,1723,1728,1720,1725,1724,-10,-11,374710,6461402700,1362460
805,c1801,20170825,1725,1724,1726,1730,1714,1719,1720,-5,-4,469018,8071072640,1340010
806,c1801,20170828,1719,1720,1719,1723,1714,1718,1718,-2,-2,336220,5778631580,1357624
807,c1801,20170829,1718,1718,1717,1723,1697,1702,1709,-16,-9,780036,13332495260,1312862
808,c1801,20170830,1702,1709,1700,1702,1691,1693,1696,-16,-13,430926,7311116540,1319336
809,c1801,20170831,1693,1696,1693,1697,1685,1687,1691,-9,-5,447622,7570499780,1262188
810,c1801,20170901,1687,1691,1695,1697,1688,1690,1692,-1,1,482466,8165404600,1270436
811,c1801,20170904,1690,1692,1692,1717,1690,1713,1706,21,14,787952,13447790500,1193792
812,c1801,20170905,1713,1706,1714,1715,1707,1714,1711,8,5,316908,5423179960,1223656
813,c1801,20170906,1714,1711,1713,1725,1711,1715,1720,4,9,455942,7843283860,1248900
814,c1801,20170907,1715,1720,1716,1727,1716,1719,1720,-1,0,334710,5757395960,1226582
815,c1801,20170908,1719,1720,1719,1723,1685,1687,1699,-33,-21,899744,15291027520,1188528
816,c1801,20170911,1687,1699,1686,1693,1681,1688,1688,-11,-11,437106,7380723460,1168230
817,c1801,20170912,1688,1688,1690,1692,1683,1691,1687,3,-1,359724,6070834900,1172518
818,c1801,20170913,1691,1687,1693,1695,1677,1692,1686,5,-1,559214,9430654240,1125192
819,c1801,20170914,1692,1686,1695,1720,1693,1702,1710,16,24,1062516,18171505140,1145646
820,c1801,20170915,1702,1710,1703,1706,1691,1691,1697,-19,-13,472030,8014096080,1084918
821,c1801,20170918,1691,1697,1691,1697,1687,1692,1693,-5,-4,314486,5324292920,1070042
822,c1801,20170919,1692,1693,1690,1702,1689,1696,1697,3,4,345334,5860813040,1062070
823,c1801,20170920,1696,1697,1697,1708,1693,1696,1702,-1,5,493578,8400807840,1037912
824,c1801,20170921,1696,1702,1696,1711,1695,1709,1702,7,0,543116,9247552360,1056178
825,c1801,20170922,1709,1702,1710,1727,1704,1716,1715,14,13,1002200,17193280840,1065492
826,c1801,20170925,1716,1715,1716,1718,1707,1713,1712,-2,-3,411604,7049760460,1064942
827,c1801,20170926,1713,1712,1714,1733,1713,1723,1724,11,12,768198,13249051120,1138062
828,c1801,20170927,1723,1724,1724,1725,1711,1714,1716,-10,-8,543920,9334914260,1095336
829,c1801,20170928,1714,1716,1715,1715,1692,1694,1702,-22,-14,764198,13011612760,939168
830,c1801,20170929,1694,1702,1696,1698,1687,1693,1692,-9,-10,353320,5981012480,873756
831,c1801,20171009,1693,1692,1680,1683,1665,1666,1672,-26,-20,796326,13317685740,924436
832,c1801,20171010,1666,1672,1667,1676,1666,1671,1671,-1,-1,406202,6790125500,980388
833,c1801,20171011,1671,1671,1675,1680,1669,1671,1674,0,3,364256,6097693020,962366
834,c1801,20171012,1671,1674,1674,1677,1671,1674,1674,0,0,333840,5589070720,946420
835,c1801,20171013,1674,1674,1678,1686,1676,1677,1679,3,5,338730,5689547700,913630
836,c1801,20171016,1677,1679,1681,1685,1671,1678,1676,-1,-3,416598,6985201880,931698
837,c1801,20171017,1678,1676,1677,1681,1674,1678,1677,2,1,280546,4705596240,927988
838,c1801,20171018,1678,1677,1677,1685,1673,1675,1676,-2,-1,247208,4145040440,966622
839,c1801,20171019,1675,1676,1674,1675,1660,1672,1669,-4,-7,471274,7868357420,959152
840,c1801,20171020,1672,1669,1669,1673,1666,1668,1670,-1,1,256168,4278108440,1004052
841,c1801,20171023,1668,1670,1665,1668,1660,1663,1663,-7,-7,383070,6372951440,1032742
842,c1801,20171024,1663,1663,1668,1673,1661,1666,1666,3,3,535898,8931838760,1036118
843,c1801,20171025,1666,1666,1668,1680,1667,1675,1673,9,7,442314,7403109720,954184
844,c1801,20171026,1675,1673,1675,1678,1670,1674,1673,1,0,255492,4276304320,960400
845,c1801,20171027,1674,1673,1671,1675,1664,1665,1668,-8,-5,375480,6264019940,941058
846,c1801,20171030,1665,1668,1662,1662,1647,1656,1656,-12,-12,465842,7714643860,987036
847,c1801,20171031,1656,1656,1657,1660,1652,1657,1656,1,0,233206,3862995980,1005370
848,c1801,20171101,1657,1656,1656,1670,1648,1661,1661,5,5,565162,9390724260,961570
849,c1801,20171102,1661,1661,1663,1668,1663,1667,1665,6,4,240580,4007144720,955070
850,c1801,20171103,1667,1665,1670,1675,1666,1673,1671,8,6,301202,5033841580,952210
851,c1801,20171106,1673,1671,1670,1684,1670,1675,1675,4,4,400312,6708828740,928154
852,c1801,20171107,1675,1675,1672,1684,1672,1682,1678,7,3,471644,7916050100,864806
853,c1801,20171108,1682,1678,1685,1689,1675,1686,1682,8,4,612106,10299405060,850426
854,c1801,20171109,1686,1682,1685,1687,1676,1685,1681,3,-1,392088,6593086140,850956
855,c1801,20171110,1685,1681,1680,1689,1675,1685,1682,4,1,634178,10669593460,840916
856,c1801,20171113,1685,1682,1685,1693,1682,1687,1685,5,3,301960,5089934760,851282
857,c1801,20171114,1687,1685,1685,1704,1683,1693,1692,8,7,794978,13453288100,843330
858,c1801,20171115,1693,1692,1689,1699,1686,1694,1691,2,-1,423266,7159829120,826368
859,c1801,20171116,1694,1691,1697,1697,1687,1690,1690,-1,-1,268986,4546789920,853496
860,c1801,20171117,1690,1690,1690,1692,1675,1677,1681,-13,-9,421068,7078440560,784632
861,c1801,20171120,1677,1681,1682,1694,1679,1690,1687,9,6,380700,6422452900,750174
862,c1801,20171121,1690,1687,1690,1696,1687,1693,1691,6,4,289740,4902330560,762394
863,c1801,20171122,1693,1691,1693,1700,1692,1698,1696,7,5,243858,4136647900,759818
864,c1801,20171123,1698,1696,1700,1710,1700,1705,1704,9,8,299866,5111977500,737584
865,c1801,20171124,1705,1704,1706,1711,1695,1699,1702,-5,-2,363848,6195118120,681942
866,c1801,20171127,1699,1702,1702,1709,1696,1702,1703,0,1,274692,4678304640,677364
867,c1801,20171128,1702,1703,1703,1710,1700,1707,1704,4,1,195996,3340433020,656748
868,c1801,20171129,1707,1704,1710,1723,1709,1718,1715,14,11,342082,5867075920,653920
869,c1801,20171130,1718,1715,1720,1724,1711,1715,1716,0,1,258188,4432649240,603778
870,c1801,20171201,1715,1716,1716,1717,1702,1708,1706,-8,-10,428168,7308281820,549998
871,c1801,20171204,1708,1706,1711,1725,1711,1719,1718,13,12,352402,6054461940,545824
872,c1801,20171205,1719,1718,1718,1728,1715,1722,1721,4,3,357728,6158513840,492400
873,c1801,20171206,1722,1721,1722,1727,1718,1722,1721,1,0,219030,3771664880,458864
874,c1801,20171207,1722,1721,1721,1722,1706,1707,1712,-14,-9,271074,4642482500,346970
875,c1801,20171208,1707,1712,1706,1710,1704,1707,1706,-5,-6,76648,1308270940,317790
876,c1801,20171211,1707,1706,1711,1712,1704,1707,1707,1,1,94088,1606879320,293860
877,c1801,20171212,1707,1707,1712,1712,1703,1704,1705,-3,-2,61928,1056042220,276280
878,c1801,20171213,1704,1705,1704,1713,1699,1711,1705,6,0,79960,1363595440,252280
879,c1801,20171214,1711,1705,1709,1720,1709,1717,1715,12,10,58442,1002680160,232090
880,c1801,20171215,1717,1715,1717,1721,1713,1717,1716,2,1,66634,1143453960,206278
881,c1801,20171218,1717,1716,1720,1731,1720,1730,1727,14,11,110550,1909924260,174258
882,c1801,20171219,1730,1727,1731,1736,1725,1729,1729,2,2,53602,927003060,156284
883,c1801,20171220,1729,1729,1730,1736,1728,1733,1731,4,2,42140,729630920,145640
884,c1801,20171221,1733,1731,1736,1775,1731,1766,1752,35,21,90052,1578266560,120302
885,c1801,20171222,1766,1752,1770,1770,1750,1760,1756,8,4,30410,534072260,106026
886,c1801,20171225,1760,1756,1756,1758,1738,1739,1745,-17,-11,21630,377455480,90420
887,c1801,20171226,1739,1745,1738,1745,1735,1744,1741,-1,-4,12120,211099160,81650
888,c1801,20171227,1744,1741,1739,1765,1739,1752,1755,11,14,32442,569412360,66126
889,c1801,20171228,1752,1755,1784,1784,1746,1751,1755,-4,0,21596,379021600,49786
890,c1801,20171229,1751,1755,1750,1765,1729,1740,1738,-15,-17,24488,425823380,36950
891,c1803,20170315,1731,1731,1763,1763,1754,1754,1761,23,30,30,528520,24
892,c1803,20170316,1754,1761,1754,1766,1743,1759,1757,-2,-4,28,492220,30
893,c1803,20170317,1759,1757,1760,1760,1753,1754,1756,-3,-1,62,1088740,66
894,c1803,20170320,1754,1756,1725,1799,1725,1798,1786,42,30,358,6396320,184
895,c1803,20170321,1798,1786,1795,1795,1763,1789,1778,3,-8,224,3983480,248
896,c1803,20170322,1789,1778,1782,1804,1782,1800,1798,22,20,146,2625160,302
897,c1803,20170323,1800,1798,1798,1802,1780,1781,1788,-17,-10,154,2754800,306
898,c1803,20170324,1781,1788,1785,1790,1774,1786,1780,-2,-8,86,1531560,302
899,c1803,20170327,1786,1780,1785,1785,1769,1773,1775,-7,-5,70,1242800,288
900,c1803,20170328,1773,1775,1774,1782,1768,1776,1777,1,2,68,1208660,308
901,c1803,20170329,1776,1777,1771,1771,1748,1749,1756,-28,-21,192,3371520,328
902,c1803,20170330,1749,1756,1752,1754,1741,1744,1746,-12,-10,246,4295500,494
903,c1803,20170331,1744,1746,1742,1756,1739,1742,1744,-4,-2,258,4499940,458
904,c1803,20170405,1742,1744,1750,1754,1744,1747,1748,3,4,178,3112980,456
905,c1803,20170406,1747,1748,1749,1757,1733,1750,1740,2,-8,142,2471700,442
906,c1803,20170407,1750,1740,1741,1741,1722,1730,1733,-10,-7,190,3292820,544
907,c1803,20170410,1730,1733,1723,1723,1720,1723,1721,-10,-12,738,12705600,960
908,c1803,20170411,1723,1721,1727,1731,1692,1693,1707,-28,-14,202,3448740,956
909,c1803,20170412,1693,1707,1685,1695,1671,1678,1682,-29,-25,150,2523260,952
910,c1803,20170413,1678,1682,1685,1688,1675,1683,1683,1,1,90,1515080,948
911,c1803,20170414,1683,1683,1690,1700,1688,1696,1698,13,15,240,4075260,984
912,c1803,20170417,1696,1698,1691,1699,1686,1689,1689,-9,-9,44,743400,1008
913,c1803,20170418,1689,1689,1681,1689,1680,1680,1684,-9,-5,136,2291360,1046
914,c1803,20170419,1680,1684,1675,1678,1664,1665,1670,-19,-14,28,467720,1048
915,c1803,20170420,1665,1670,1677,1681,1672,1679,1677,9,7,38,637580,1048
916,c1803,20170421,1679,1677,1675,1691,1671,1689,1678,12,1,290,4868860,1176
917,c1803,20170424,1689,1678,1685,1693,1680,1690,1685,12,7,34,573180,1172
918,c1803,20170425,1690,1685,1688,1688,1673,1681,1679,-4,-6,84,1410360,1206
919,c1803,20170426,1681,1679,1694,1695,1683,1687,1689,8,10,72,1216680,1204
920,c1803,20170427,1687,1689,1680,1683,1673,1675,1678,-14,-11,346,5808820,1368
921,c1803,20170428,1675,1678,1679,1684,1675,1678,1678,0,0,456,7654980,1484
922,c1803,20170502,1678,1678,1673,1697,1673,1697,1691,19,13,444,7510400,1430
923,c1803,20170503,1697,1691,1685,1687,1679,1680,1682,-11,-9,250,4205400,1598
924,c1803,20170504,1680,1682,1695,1695,1676,1681,1683,-1,1,234,3940100,1740
925,c1803,20170505,1681,1683,1682,1688,1674,1678,1682,-5,-1,70,1177460,1742
926,c1803,20170508,1678,1682,1683,1690,1677,1685,1684,3,2,168,2830660,1760
927,c1803,20170509,1685,1684,1682,1682,1671,1676,1674,-8,-10,46,770240,1754
928,c1803,20170510,1676,1674,1675,1679,1671,1671,1675,-3,1,46,770660,1758
929,c1803,20170511,1671,1675,1671,1695,1671,1695,1683,20,8,84,1413860,1782
930,c1803,20170512,1695,1683,1681,1687,1681,1686,1683,3,0,46,774340,1784
931,c1803,20170515,1686,1683,1699,1699,1679,1679,1690,-4,7,116,1960700,1780
932,c1803,20170516,1679,1690,1681,1683,1675,1681,1678,-9,-12,192,3223320,1744
933,c1803,20170517,1681,1678,1688,1697,1687,1691,1690,13,12,142,2401040,1742
934,c1803,20170518,1691,1690,1687,1699,1684,1687,1689,-3,-1,50,844700,1744
935,c1803,20170519,1687,1689,1688,1693,1686,1687,1688,-2,-1,172,2904240,1718
936,c1803,20170522,1687,1688,1690,1690,1673,1677,1678,-11,-10,280,4698880,1618
937,c1803,20170523,1677,1678,1677,1681,1674,1678,1678,0,0,212,3558800,1532
938,c1803,20170524,1678,1678,1682,1686,1680,1686,1682,8,4,82,1380000,1478
939,c1803,20170525,1686,1682,1682,1682,1679,1679,1680,-3,-2,6,100800,1476
940,c1803,20170526,1679,1680,1678,1682,1676,1682,1678,2,-2,34,570680,1466
941,c1803,20170531,1682,1678,1678,1684,1676,1681,1679,3,1,264,4433160,1424
942,c1803,20170601,1681,1679,1683,1690,1681,1689,1686,10,7,84,1416700,1412
943,c1803,20170602,1689,1686,1682,1696,1682,1695,1691,9,5,56,947060,1424
944,c1803,20170605,1695,1691,1691,1703,1683,1702,1695,11,4,128,2170500,1416
945,c1803,20170606,1702,1695,1698,1708,1691,1701,1695,6,0,62,1051100,1380
946,c1803,20170607,1701,1695,1706,1706,1697,1697,1699,2,4,80,1359920,1350
947,c1803,20170608,1697,1699,1700,1708,1698,1698,1701,-1,2,34,578580,1364
948,c1803,20170609,1698,1701,1701,1738,1701,1738,1720,37,19,232,3990820,1398
949,c1803,20170612,1738,1720,1736,1759,1734,1759,1743,39,23,206,3590720,1376
950,c1803,20170613,1759,1743,1744,1750,1742,1744,1744,1,1,210,3663540,1460
951,c1803,20170614,1744,1744,1745,1750,1741,1750,1746,6,2,64,1117680,1476
952,c1803,20170615,1750,1746,1742,1752,1742,1750,1749,4,3,26,454900,1474
953,c1803,20170616,1750,1749,1753,1753,1738,1740,1745,-9,-4,54,942780,1480
954,c1803,20170619,1740,1745,1741,1745,1729,1729,1732,-16,-13,86,1489860,1416
955,c1803,20170620,1729,1732,1729,1732,1722,1728,1727,-4,-5,48,828960,1394
956,c1803,20170621,1728,1727,1729,1731,1723,1723,1728,-4,1,12,207440,1388
957,c1803,20170622,1723,1728,1734,1734,1722,1722,1723,-6,-5,20,344720,1392
958,c1803,20170623,1722,1723,1719,1730,1716,1730,1724,7,1,40,689660,1410
959,c1803,20170626,1730,1724,1747,1755,1742,1751,1746,27,22,50,873460,1410
960,c1803,20170627,1751,1746,1805,1805,1685,1748,1772,2,26,128,2269000,1370
961,c1803,20170628,1748,1772,1757,1765,1745,1746,1754,-26,-18,92,1613820,1330
962,c1803,20170629,1746,1754,1744,1745,1737,1740,1740,-14,-14,40,696280,1340
963,c1803,20170630,1740,1740,1739,1743,1735,1735,1738,-5,-2,28,486760,1330
964,c1803,20170703,1735,1738,1740,1744,1735,1741,1738,3,0,24,417240,1320
965,c1803,20170704,1741,1738,1713,1743,1713,1728,1731,-10,-7,60,1038760,1300
966,c1803,20170705,1728,1731,0,0,0,1731,1731,0,0,0,0,1300
967,c1803,20170706,1731,1731,1730,1730,1729,1729,1729,-2,-2,26,449660,1294
968,c1803,20170707,1729,1729,1729,1731,1729,1731,1730,2,1,8,138420,1292
969,c1803,20170710,1731,1730,1741,1743,1717,1732,1733,2,3,58,1005260,1284
970,c1803,20170711,1732,1733,1736,1738,1733,1737,1736,4,3,18,312520,1276
971,c1803,20170712,1737,1736,1732,1732,1732,1732,1732,-4,-4,2,34640,1276
972,c1803,20170713,1732,1732,1730,1730,1722,1722,1725,-10,-7,20,345080,1278
973,c1803,20170714,1722,1725,1720,1721,1720,1721,1720,-4,-5,10,172040,1278
974,c1803,20170717,1721,1720,1717,1731,1717,1731,1726,11,6,10,172620,1270
975,c1803,20170718,1731,1726,1741,1741,1720,1720,1730,-6,4,32,553880,1262
976,c1803,20170719,1720,1730,1722,1728,1715,1717,1721,-13,-9,62,1067120,1280
977,c1803,20170720,1717,1721,1727,1728,1722,1723,1722,2,1,118,2032640,1254
978,c1803,20170721,1723,1722,1721,1722,1717,1720,1720,-2,-2,16,275220,1256
979,c1803,20170724,1720,1720,1703,1709,1703,1703,1704,-17,-16,18,306860,1256
980,c1803,20170725,1703,1704,1699,1704,1699,1703,1702,-1,-2,34,578740,1260
981,c1803,20170726,1703,1702,1695,1695,1694,1694,1694,-8,-8,50,847060,1282
982,c1803,20170727,1694,1694,1703,1703,1702,1702,1702,8,8,4,68100,1284
983,c1803,20170728,1702,1702,1697,1704,1697,1704,1703,2,1,42,715460,1258
984,c1803,20170731,1704,1703,1717,1717,1691,1691,1694,-12,-9,52,881320,1268
985,c1803,20170801,1691,1694,1695,1699,1692,1692,1695,-2,1,16,271340,1266
986,c1803,20170802,1692,1695,1685,1685,1681,1683,1681,-12,-14,126,2119180,1262
987,c1803,20170803,1683,1681,1693,1693,1685,1685,1689,4,8,10,168960,1260
988,c1803,20170804,1685,1689,1688,1690,1688,1690,1688,1,-1,30,506680,1232
989,c1803,20170807,1690,1688,1691,1691,1670,1687,1681,-1,-7,164,2757260,1208
990,c1803,20170808,1687,1681,1694,1694,1693,1693,1693,12,12,4,67740,1208
991,c1803,20170809,1693,1693,1689,1727,1689,1723,1707,30,14,70,1195320,1188
992,c1803,20170810,1723,1707,1726,1728,1710,1725,1712,18,5,250,4281900,1160
993,c1803,20170811,1725,1712,1716,1727,1710,1727,1721,15,9,96,1652500,1178
994,c1803,20170814,1727,1721,1728,1730,1723,1723,1728,2,7,48,829820,1184
995,c1803,20170815,1723,1728,1726,1735,1721,1724,1729,-4,1,132,2282920,1208
996,c1803,20170816,1724,1729,1725,1727,1724,1724,1724,-5,-5,52,896980,1194
997,c1803,20170817,1724,1724,1728,1739,1728,1737,1732,13,8,64,1108740,1216
998,c1803,20170818,1737,1732,1735,1735,1728,1728,1730,-4,-2,44,761580,1206
999,c1803,20170821,1728,1730,1728,1737,1723,1723,1725,-7,-5,88,1518800,1206
1000,c1803,20170822,1723,1725,1720,1738,1720,1738,1733,13,8,84,1456200,1218
1001,c1803,20170823,1738,1733,1741,1741,1729,1729,1737,-4,4,84,1459120,1210
1002,c1803,20170824,1729,1737,1725,1729,1725,1725,1725,-12,-12,60,1035540,1202
1003,c1803,20170825,1725,1725,1728,1728,1722,1722,1725,-3,0,12,207020,1200
1004,c1803,20170828,1722,1725,1720,1724,1720,1720,1720,-5,-5,18,309680,1188
1005,c1803,20170829,1720,1720,1708,1708,1700,1703,1701,-17,-19,24,408360,1184
1006,c1803,20170830,1703,1701,1706,1706,1697,1697,1701,-4,0,24,408300,1186
1007,c1803,20170831,1697,1701,1699,1703,1693,1696,1698,-5,-3,44,747140,1186
1008,c1803,20170901,1696,1698,1696,1697,1690,1690,1695,-8,-3,18,305200,1186
1009,c1803,20170904,1690,1695,1695,1718,1695,1713,1708,18,13,84,1434800,1198
1010,c1803,20170905,1713,1708,1713,1715,1710,1713,1712,5,4,18,308280,1200
1011,c1803,20170906,1713,1712,1716,1725,1716,1717,1721,5,9,50,860540,1210
1012,c1803,20170907,1717,1721,1724,1725,1717,1721,1721,0,0,46,792020,1212
1013,c1803,20170908,1721,1721,1720,1720,1688,1688,1696,-33,-25,210,3561600,1200
1014,c1803,20170911,1688,1696,1693,1696,1692,1693,1694,-3,-2,118,1999740,1234
1015,c1803,20170912,1693,1694,1689,1693,1689,1693,1690,-1,-4,28,473240,1240
1016,c1803,20170913,1693,1690,1692,1698,1685,1697,1694,7,4,52,881140,1216
1017,c1803,20170914,1697,1694,1699,1721,1699,1713,1712,19,18,56,959120,1204
1018,c1803,20170915,1713,1712,1706,1706,1698,1699,1701,-13,-11,24,408420,1208
1019,c1803,20170918,1699,1701,1700,1702,1694,1702,1697,1,-4,50,848660,1210
1020,c1803,20170919,1702,1697,1703,1703,1703,1703,1703,6,6,4,68120,1206
1021,c1803,20170920,1703,1703,1701,1709,1696,1696,1704,-7,1,30,511460,1196
1022,c1803,20170921,1696,1704,1704,1704,1703,1703,1703,-1,-1,12,204460,1196
1023,c1803,20170922,1703,1703,1706,1718,1706,1710,1713,7,10,60,1027960,1190
1024,c1803,20170925,1710,1713,1709,1712,1709,1712,1710,-1,-3,8,136860,1190
1025,c1803,20170926,1712,1710,1719,1726,1714,1721,1720,11,10,86,1479400,1200
1026,c1803,20170927,1721,1720,1715,1715,1711,1714,1713,-6,-7,20,342620,1196
1027,c1803,20170928,1714,1713,1698,1703,1690,1702,1695,-11,-18,142,2408040,1192
1028,c1803,20170929,1702,1695,1690,1699,1689,1699,1694,4,-1,90,1524700,1196
1029,c1803,20171009,1699,1694,1700,1700,1671,1682,1681,-12,-13,382,6424400,1138
1030,c1803,20171010,1682,1681,1687,1687,1682,1682,1684,1,3,12,202100,1140
1031,c1803,20171011,1682,1684,1683,1690,1683,1690,1686,6,2,72,1214340,1082
1032,c1803,20171012,1690,1686,1685,1691,1684,1686,1686,0,0,16,269900,1094
1033,c1803,20171013,1686,1686,1691,1699,1690,1692,1693,6,7,138,2336540,1156
1034,c1803,20171016,1692,1693,1692,1694,1689,1690,1690,-3,-3,26,439580,1166
1035,c1803,20171017,1690,1690,1691,1694,1690,1691,1690,1,0,44,743980,1148
1036,c1803,20171018,1691,1690,1691,1695,1690,1694,1693,4,3,20,338660,1150
1037,c1803,20171019,1694,1693,1688,1694,1688,1693,1691,0,-2,42,710420,1164
1038,c1803,20171020,1693,1691,1694,1694,1690,1690,1693,-1,2,64,1083600,1220
1039,c1803,20171023,1690,1693,1686,1690,1685,1689,1686,-4,-7,24,404820,1222
1040,c1803,20171024,1689,1686,1692,1696,1685,1685,1687,-1,1,28,472360,1226
1041,c1803,20171025,1685,1687,1692,1696,1691,1695,1694,8,7,74,1253660,1222
1042,c1803,20171026,1695,1694,1691,1695,1691,1692,1692,-2,-2,10,169280,1226
1043,c1803,20171027,1692,1692,1690,1690,1686,1687,1687,-5,-5,22,371340,1218
1044,c1803,20171030,1687,1687,1684,1684,1680,1682,1682,-5,-5,64,1076640,1226
1045,c1803,20171031,1682,1682,1682,1684,1681,1684,1682,2,0,16,269180,1238
1046,c1803,20171101,1684,1682,1680,1693,1679,1689,1684,7,2,60,1010720,1250
1047,c1803,20171102,1689,1684,1689,1694,1685,1687,1688,3,4,18,303900,1242
1048,c1803,20171103,1687,1688,1689,1694,1689,1692,1691,4,3,28,473720,1248
1049,c1803,20171106,1692,1691,1698,1700,1695,1700,1698,9,7,62,1053020,1264
1050,c1803,20171107,1700,1698,1699,1708,1699,1708,1699,10,1,78,1325520,1312
1051,c1803,20171108,1708,1699,1699,1707,1699,1707,1699,8,0,316,5370840,1566
1052,c1803,20171109,1707,1699,1703,1703,1700,1702,1701,3,2,18,306240,1570
1053,c1803,20171110,1702,1701,1702,1707,1700,1703,1702,2,1,36,613000,1566
1054,c1803,20171113,1703,1702,1698,1707,1698,1707,1702,5,0,20,340540,1556
1055,c1803,20171114,1707,1702,1709,1717,1706,1710,1710,8,8,60,1026300,1532
1056,c1803,20171115,1710,1710,1705,1710,1704,1708,1707,-2,-3,20,341440,1532
1057,c1803,20171116,1708,1707,1706,1706,1704,1705,1705,-2,-2,36,613880,1512
1058,c1803,20171117,1705,1705,1700,1713,1693,1702,1702,-3,-3,384,6537300,1540
1059,c1803,20171120,1702,1702,1706,1706,1700,1702,1700,0,-2,706,12005900,1812
1060,c1803,20171121,1702,1700,1702,1704,1697,1701,1699,1,-1,4530,76993580,6246
1061,c1803,20171122,1701,1699,1704,1708,1704,1704,1705,5,6,40,682120,6246
1062,c1803,20171123,1704,1705,1710,1718,1709,1716,1713,11,8,234,4010100,6220
1063,c1803,20171124,1716,1713,1720,1722,1704,1712,1715,-1,2,66,1132320,6214
1064,c1803,20171127,1712,1715,1715,1718,1710,1716,1713,1,-2,88,1507700,6170
1065,c1803,20171128,1716,1713,1716,1717,1710,1715,1713,2,0,58,993800,6172
1066,c1803,20171129,1715,1713,1718,1727,1715,1723,1722,10,9,76,1308920,6160
1067,c1803,20171130,1723,1722,1728,1729,1717,1717,1724,-5,2,1288,22213680,6268
1068,c1803,20171201,1717,1724,1714,1725,1712,1724,1718,0,-6,5862,100754520,10722
1069,c1803,20171204,1724,1718,1734,1734,1719,1728,1722,10,4,4190,72161060,10732
1070,c1803,20171205,1728,1722,1721,1725,1713,1714,1719,-8,-3,4282,73614940,10618
1071,c1803,20171206,1714,1719,1718,1720,1701,1715,1713,-4,-6,11370,194874300,7866
1072,c1803,20171207,1715,1713,1712,1722,1708,1717,1715,4,2,13966,239622900,11820
1073,c1803,20171208,1717,1715,1717,1719,1711,1719,1716,4,1,2330,39991580,11706
1074,c1803,20171211,1719,1716,1720,1721,1716,1719,1718,3,2,3720,63943780,13128
1075,c1803,20171212,1719,1718,1720,1721,1710,1715,1716,-3,-2,3628,62261880,13010
1076,c1803,20171213,1715,1716,1715,1725,1715,1722,1719,6,3,2874,49412480,13086
1077,c1803,20171214,1722,1719,1726,1730,1712,1729,1728,10,9,2652,45840480,12710
1078,c1803,20171215,1729,1728,1729,1734,1728,1731,1729,3,1,4194,72544780,12738
1079,c1803,20171218,1731,1729,1734,1761,1734,1755,1747,26,18,6470,113070620,13172
1080,c1803,20171219,1755,1747,1746,1774,1745,1766,1766,19,19,5272,93108780,14492
1081,c1803,20171220,1766,1766,1766,1773,1766,1771,1770,5,4,2746,48607800,14722
1082,c1803,20171221,1771,1770,1770,1811,1770,1800,1786,30,16,6846,122301280,15020
1083,c1803,20171222,1800,1786,1800,1800,1783,1784,1785,-2,-1,6956,124200740,14520
1084,c1803,20171225,1784,1785,1780,1783,1773,1775,1777,-10,-8,6360,113034880,15006
1085,c1803,20171226,1775,1777,1774,1780,1762,1768,1770,-9,-7,3926,69519160,14130
1086,c1803,20171227,1768,1770,1774,1780,1773,1779,1777,9,7,1366,24274720,14050
1087,c1803,20171228,1779,1777,1783,1783,1765,1779,1774,2,-3,3722,66028740,14080
1088,c1803,20171229,1779,1774,1775,1778,1769,1774,1773,0,-1,4976,88239040,14376
1089,c1805,20170516,1690,1690,1702,1726,1702,1724,1721,34,31,10976,188957340,7602
1090,c1805,20170517,1724,1721,1726,1738,1725,1731,1730,10,9,4850,83947520,10490
1091,c1805,20170518,1731,1730,1731,1731,1722,1725,1725,-5,-5,2414,41647380,11160
1092,c1805,20170519,1725,1725,1725,1737,1724,1735,1731,10,6,3592,62199400,12448
1093,c1805,20170522,1735,1731,1739,1740,1717,1719,1721,-12,-10,7140,122927880,10612
1094,c1805,20170523,1719,1721,1719,1725,1717,1720,1720,-1,-1,3046,52409320,10844
1095,c1805,20170524,1720,1720,1716,1731,1715,1726,1724,6,4,3484,60097620,11828
1096,c1805,20170525,1726,1724,1726,1728,1722,1725,1725,1,1,2592,44717680,12830
1097,c1805,20170526,1725,1725,1724,1730,1721,1725,1725,0,0,2074,35788520,13218
1098,c1805,20170531,1725,1725,1724,1731,1720,1725,1724,0,-1,3728,64302800,14496
1099,c1805,20170601,1725,1724,1724,1734,1721,1729,1727,5,3,3012,52027720,15356
1100,c1805,20170602,1729,1727,1732,1737,1726,1734,1732,7,5,3176,55031420,16288
1101,c1805,20170605,1734,1732,1734,1747,1730,1747,1739,15,7,4594,79909720,18200
1102,c1805,20170606,1747,1739,1747,1747,1735,1740,1738,1,-1,1836,31917860,18740
1103,c1805,20170607,1740,1738,1743,1746,1740,1743,1741,5,3,2358,41065240,20046
1104,c1805,20170608,1743,1741,1745,1748,1737,1744,1742,3,1,3234,56346500,20676
1105,c1805,20170609,1744,1742,1741,1779,1741,1777,1764,35,22,8108,143036760,22424
1106,c1805,20170612,1777,1764,1780,1798,1775,1797,1787,33,23,9144,163461180,26500
1107,c1805,20170613,1797,1787,1790,1795,1783,1785,1787,-2,0,7084,126657100,27370
1108,c1805,20170614,1785,1787,1787,1793,1782,1791,1787,4,0,4266,76256000,28456
1109,c1805,20170615,1791,1787,1790,1795,1779,1792,1787,5,0,5194,92826360,30070
1110,c1805,20170616,1792,1787,1792,1795,1778,1778,1785,-9,-2,5026,89756120,29928
1111,c1805,20170619,1778,1785,1783,1787,1769,1769,1778,-16,-7,9402,167214960,29578
1112,c1805,20170620,1769,1778,1767,1773,1765,1773,1768,-5,-10,5752,101709140,28576
1113,c1805,20170621,1773,1768,1768,1776,1768,1772,1771,4,3,3170,56146980,29678
1114,c1805,20170622,1772,1771,1770,1773,1768,1772,1770,1,-1,3732,66063420,31158
1115,c1805,20170623,1772,1770,1769,1776,1760,1774,1769,4,-1,6166,109124120,32726
1116,c1805,20170626,1774,1769,1770,1796,1770,1787,1786,18,17,5240,93624300,33190
1117,c1805,20170627,1787,1786,1790,1793,1783,1790,1786,4,0,4076,72811100,34774
1118,c1805,20170628,1790,1786,1799,1800,1780,1780,1790,-6,4,8566,153344920,36286
1119,c1805,20170629,1780,1790,1778,1783,1777,1779,1779,-11,-11,5614,99905200,37286
1120,c1805,20170630,1779,1779,1782,1784,1775,1775,1778,-4,-1,5300,94251380,37680
1121,c1805,20170703,1775,1778,1795,1795,1775,1778,1780,0,2,6056,107804740,39316
1122,c1805,20170704,1778,1780,1778,1780,1762,1762,1767,-18,-13,8588,151830220,41342
1123,c1805,20170705,1762,1767,1770,1771,1765,1767,1768,0,1,2222,39301060,41710
1124,c1805,20170706,1767,1768,1768,1772,1760,1763,1763,-5,-5,3222,56827880,41486
1125,c1805,20170707,1763,1763,1763,1774,1762,1774,1768,11,5,5256,92949200,42860
1126,c1805,20170710,1774,1768,1780,1791,1764,1767,1777,-1,9,10384,184619720,44574
1127,c1805,20170711,1767,1777,1770,1776,1770,1774,1773,-3,-4,3302,58552820,45072
1128,c1805,20170712,1774,1773,1773,1782,1772,1776,1777,3,4,4304,76489640,46170
1129,c1805,20170713,1776,1777,1770,1773,1763,1764,1767,-13,-10,8476,149789960,49032
1130,c1805,20170714,1764,1767,1762,1762,1753,1759,1758,-8,-9,4692,82520360,48422
1131,c1805,20170717,1759,1758,1758,1770,1755,1768,1761,10,3,8734,153839480,52772
1132,c1805,20170718,1768,1761,1775,1775,1762,1765,1769,4,8,10374,183567760,56888
1133,c1805,20170719,1765,1769,1767,1767,1755,1756,1760,-13,-9,7724,135981200,58724
1134,c1805,20170720,1756,1760,1760,1767,1757,1765,1763,5,3,3510,61903780,60258
1135,c1805,20170721,1765,1763,1767,1770,1758,1762,1762,-1,-1,4784,84297060,60816
1136,c1805,20170724,1762,1762,1756,1756,1742,1743,1747,-19,-15,14360,250915420,59702
1137,c1805,20170725,1743,1747,1748,1750,1740,1743,1744,-4,-3,5766,100559260,61030
1138,c1805,20170726,1743,1744,1735,1743,1732,1732,1735,-12,-9,13132,227899000,61752
1139,c1805,20170727,1732,1735,1735,1741,1733,1741,1738,6,3,8368,145472040,65324
1140,c1805,20170728,1741,1738,1741,1748,1736,1745,1741,7,3,27986,487349660,68982
1141,c1805,20170731,1745,1741,1746,1746,1733,1735,1737,-6,-4,21394,371628140,75860
1142,c1805,20170801,1735,1737,1738,1741,1734,1736,1737,-1,0,8940,155319780,76004
1143,c1805,20170802,1736,1737,1731,1732,1715,1721,1721,-16,-16,46084,793557900,94344
1144,c1805,20170803,1721,1721,1721,1728,1720,1722,1724,1,3,22028,379937400,102818
1145,c1805,20170804,1722,1724,1722,1728,1721,1723,1724,-1,0,13064,225281420,103774
1146,c1805,20170807,1723,1724,1728,1732,1702,1723,1722,-1,-2,19326,332809780,107780
1147,c1805,20170808,1723,1722,1723,1728,1719,1725,1724,3,2,31036,535155540,122862
1148,c1805,20170809,1725,1724,1725,1769,1725,1764,1745,40,21,64854,1132288460,149272
1149,c1805,20170810,1764,1745,1763,1771,1758,1768,1763,23,18,20888,368272840,153116
1150,c1805,20170811,1768,1763,1758,1771,1750,1770,1760,7,-3,26066,458862980,157162
1151,c1805,20170814,1770,1760,1772,1783,1763,1765,1768,5,8,16836,297693240,159136
1152,c1805,20170815,1765,1768,1765,1777,1760,1761,1767,-7,-1,24814,438670280,169742
1153,c1805,20170816,1761,1767,1758,1767,1756,1762,1761,-5,-6,12158,214196280,170690
1154,c1805,20170817,1762,1761,1762,1779,1762,1777,1773,16,12,34446,611012680,167344
1155,c1805,20170818,1777,1773,1778,1780,1770,1774,1773,1,0,24354,432032860,168100
1156,c1805,20170821,1774,1773,1776,1785,1769,1772,1775,-1,2,36302,644688440,172022
1157,c1805,20170822,1772,1775,1773,1785,1766,1779,1775,4,0,26030,462240200,178040
1158,c1805,20170823,1779,1775,1777,1785,1771,1771,1778,-4,3,27286,485213460,179052
1159,c1805,20170824,1771,1778,1769,1774,1767,1772,1770,-6,-8,21208,375540580,182664
1160,c1805,20170825,1772,1770,1769,1777,1763,1765,1769,-5,-1,26738,473115820,182724
1161,c1805,20170828,1765,1769,1764,1768,1762,1766,1765,-3,-4,28810,508651480,192002
1162,c1805,20170829,1766,1765,1765,1768,1744,1747,1755,-18,-10,43226,758917560,194984
1163,c1805,20170830,1747,1755,1742,1748,1737,1738,1742,-17,-13,31766,553541940,197558
1164,c1805,20170831,1738,1742,1738,1744,1732,1734,1738,-8,-4,38420,668043300,207824
1165,c1805,20170901,1734,1738,1743,1744,1735,1738,1739,0,1,38634,672000020,213010
1166,c1805,20170904,1738,1739,1740,1760,1737,1757,1750,18,11,57470,1005908260,213462
1167,c1805,20170905,1757,1750,1757,1760,1752,1757,1756,7,6,25752,452210320,216458
1168,c1805,20170906,1757,1756,1758,1768,1756,1756,1763,0,7,40044,706335380,219012
1169,c1805,20170907,1756,1763,1756,1769,1753,1762,1762,-1,-1,22856,402914640,219518
1170,c1805,20170908,1762,1762,1762,1766,1732,1733,1742,-29,-20,73370,1278650320,215084
1171,c1805,20170911,1733,1742,1733,1739,1729,1733,1734,-9,-8,37420,648884980,218254
1172,c1805,20170912,1733,1734,1734,1737,1729,1735,1732,1,-2,39728,688232560,223362
1173,c1805,20170913,1735,1732,1736,1741,1725,1737,1733,5,1,71730,1243595040,230840
1174,c1805,20170914,1737,1733,1742,1763,1740,1749,1753,16,20,119474,2095508520,258906
1175,c1805,20170915,1749,1753,1749,1753,1737,1738,1743,-15,-10,60378,1052704800,251430
1176,c1805,20170918,1738,1743,1741,1742,1732,1736,1737,-7,-6,39236,681555700,248890
1177,c1805,20170919,1736,1737,1736,1745,1722,1738,1739,1,2,53606,932385220,263448
1178,c1805,20170920,1738,1739,1738,1750,1735,1736,1742,-3,3,62866,1095606080,254694
1179,c1805,20170921,1736,1742,1739,1745,1735,1743,1739,1,-3,65516,1139611200,262972
1180,c1805,20170922,1743,1739,1744,1758,1741,1746,1748,7,9,117636,2056555740,279126
1181,c1805,20170925,1746,1748,1746,1749,1740,1745,1743,-3,-5,56154,979292180,293780
1182,c1805,20170926,1745,1743,1743,1761,1743,1757,1754,14,11,85762,1504779180,311976
1183,c1805,20170927,1757,1754,1752,1758,1747,1750,1751,-4,-3,77662,1360347000,308602
1184,c1805,20170928,1750,1751,1750,1750,1734,1735,1741,-16,-10,103448,1801305460,283660
1185,c1805,20170929,1735,1741,1733,1742,1732,1735,1736,-6,-5,50328,873722480,280338
1186,c1805,20171009,1735,1736,1733,1733,1712,1715,1719,-21,-17,133608,2296906360,290620
1187,c1805,20171010,1715,1719,1718,1722,1714,1717,1718,-2,-1,74072,1273269260,312294
1188,c1805,20171011,1717,1718,1717,1725,1716,1719,1719,1,1,53610,921980980,313764
1189,c1805,20171012,1719,1719,1721,1724,1718,1722,1721,3,2,40308,693730360,318488
1190,c1805,20171013,1722,1721,1725,1733,1723,1726,1726,5,5,64622,1115702940,330510
1191,c1805,20171016,1726,1726,1731,1732,1721,1726,1726,0,0,67896,1171925700,328912
1192,c1805,20171017,1726,1726,1725,1730,1723,1726,1726,0,0,51124,882425540,332558
1193,c1805,20171018,1726,1726,1724,1733,1721,1723,1724,-3,-2,46770,806691720,335608
1194,c1805,20171019,1723,1724,1722,1723,1710,1720,1717,-4,-7,67184,1154122480,330956
1195,c1805,20171020,1720,1717,1721,1721,1716,1718,1718,1,1,29076,499689940,337560
1196,c1805,20171023,1718,1718,1717,1717,1709,1711,1712,-7,-6,54408,931510060,346464
1197,c1805,20171024,1711,1712,1714,1719,1711,1713,1714,1,2,72628,1245477980,364778
1198,c1805,20171025,1713,1714,1715,1726,1715,1723,1720,9,6,72152,1241453040,360526
1199,c1805,20171026,1723,1720,1721,1724,1715,1718,1718,-2,-2,48812,838809820,368294
1200,c1805,20171027,1718,1718,1717,1719,1712,1712,1714,-6,-4,73402,1258646500,366406
1201,c1805,20171030,1712,1714,1701,1708,1698,1704,1704,-10,-10,90276,1538478000,395446
1202,c1805,20171031,1704,1704,1704,1707,1701,1705,1704,1,0,47560,810775720,391896
1203,c1805,20171101,1705,1704,1704,1720,1700,1712,1712,8,8,143162,2451387140,376838
1204,c1805,20171102,1712,1712,1713,1717,1712,1715,1714,3,2,46982,805424140,377294
1205,c1805,20171103,1715,1714,1718,1723,1714,1722,1719,8,5,74982,1289305380,377670
1206,c1805,20171106,1722,1719,1719,1728,1719,1725,1723,6,4,103536,1784894200,356828
1207,c1805,20171107,1725,1723,1724,1733,1722,1730,1727,7,4,108892,1881161680,364118
1208,c1805,20171108,1730,1727,1730,1736,1721,1730,1728,3,1,140254,2423802340,350872
1209,c1805,20171109,1730,1728,1729,1732,1723,1729,1727,1,-1,97228,1679437920,345958
1210,c1805,20171110,1729,1727,1725,1737,1724,1737,1730,10,3,171048,2960335500,328636
1211,c1805,20171113,1737,1730,1738,1741,1734,1740,1737,10,7,85212,1480911860,344560
1212,c1805,20171114,1740,1737,1739,1753,1736,1746,1744,9,7,187372,3268306300,368136
1213,c1805,20171115,1746,1744,1742,1748,1736,1745,1741,1,-3,117748,2050976220,362558
1214,c1805,20171116,1745,1741,1745,1748,1739,1739,1742,-2,1,78744,1371827640,379362
1215,c1805,20171117,1739,1742,1738,1742,1728,1728,1731,-14,-11,125662,2176281660,378068
1216,c1805,20171120,1728,1731,1735,1744,1731,1742,1737,11,6,100830,1752024600,376244
1217,c1805,20171121,1742,1737,1743,1749,1739,1745,1743,8,6,102408,1785282780,388318
1218,c1805,20171122,1745,1743,1746,1754,1744,1753,1749,10,6,109882,1922401540,431600
1219,c1805,20171123,1753,1749,1755,1760,1753,1753,1756,4,7,132462,2326327660,441400
1220,c1805,20171124,1753,1756,1753,1760,1745,1748,1751,-8,-5,127294,2229250600,471138
1221,c1805,20171127,1748,1751,1752,1755,1747,1752,1750,1,-1,108132,1893056980,472508
1222,c1805,20171128,1752,1750,1752,1757,1751,1755,1753,5,3,72242,1266879800,481876
1223,c1805,20171129,1755,1753,1758,1770,1756,1767,1763,14,10,160022,2822320280,498818
1224,c1805,20171130,1767,1763,1770,1773,1761,1762,1765,-1,2,191102,3374794440,496212
1225,c1805,20171201,1762,1765,1764,1764,1754,1759,1757,-6,-8,241916,4251054940,520784
1226,c1805,20171204,1759,1757,1765,1775,1763,1774,1770,17,13,243880,4316738440,575160
1227,c1805,20171205,1774,1770,1771,1782,1769,1777,1776,7,6,294000,5223958420,630260
1228,c1805,20171206,1777,1776,1780,1792,1777,1787,1784,11,8,399282,7124530460,710156
1229,c1805,20171207,1787,1784,1786,1790,1767,1769,1776,-15,-8,588272,10450627800,704332
1230,c1805,20171208,1769,1776,1771,1775,1768,1774,1772,-2,-4,204498,3624048260,741042
1231,c1805,20171211,1774,1772,1779,1781,1765,1769,1772,-3,0,366304,6492907440,755780
1232,c1805,20171212,1769,1772,1770,1774,1765,1769,1769,-3,-3,230170,4071733220,758932
1233,c1805,20171213,1769,1769,1769,1779,1768,1778,1774,9,5,246226,4369380480,815740
1234,c1805,20171214,1778,1774,1780,1788,1778,1785,1783,11,9,319306,5694255760,857258
1235,c1805,20171215,1785,1783,1785,1794,1783,1792,1787,9,4,322410,5764674240,909108
1236,c1805,20171218,1792,1787,1798,1826,1797,1823,1813,36,26,735602,13341357540,1023858
1237,c1805,20171219,1823,1813,1825,1832,1813,1816,1821,3,8,487066,8869671620,961578
1238,c1805,20171220,1816,1821,1817,1827,1817,1819,1821,-2,0,372144,6778425280,968396
1239,c1805,20171221,1819,1821,1820,1836,1820,1836,1830,15,9,503382,9214904460,1033638
1240,c1805,20171222,1836,1830,1835,1837,1818,1823,1824,-7,-6,494096,9016725120,1045440
1241,c1805,20171225,1823,1824,1823,1823,1801,1807,1808,-17,-16,720438,13032008200,1039378
1242,c1805,20171226,1807,1808,1805,1815,1802,1810,1808,2,0,398228,7203847440,1004050
1243,c1805,20171227,1810,1808,1816,1823,1813,1816,1817,8,9,387366,7041076660,1048018
1244,c1805,20171228,1816,1817,1837,1837,1808,1814,1814,-3,-3,303240,5502915020,1008370
1245,c1805,20171229,1814,1814,1813,1817,1810,1816,1813,2,-1,172514,3128329620,982626
1246,c1807,20170717,1758,1758,1775,1775,1775,1775,1775,17,17,2,35500,2
1247,c1807,20170718,1775,1775,1788,1788,1771,1771,1774,-4,-1,48,851560,44
1248,c1807,20170719,1771,1774,1767,1769,1766,1768,1767,-6,-7,8,141400,40
1249,c1807,20170720,1768,1767,1770,1773,1742,1768,1769,1,2,52,920180,52
1250,c1807,20170721,1768,1769,1770,1770,1762,1762,1767,-7,-2,48,848480,80
1251,c1807,20170724,1762,1767,1748,1748,1743,1743,1745,-24,-22,4,69820,82
1252,c1807,20170725,1743,1745,0,0,0,1745,1745,0,0,0,0,82
1253,c1807,20170726,1745,1745,0,0,0,1745,1745,0,0,0,0,82
1254,c1807,20170727,1745,1745,1750,1750,1743,1743,1746,-2,1,4,69860,80
1255,c1807,20170728,1743,1746,1750,1752,1739,1744,1746,-2,0,14,244460,84
1256,c1807,20170731,1744,1746,1754,1754,1742,1747,1744,1,-2,30,523380,92
1257,c1807,20170801,1747,1744,0,0,0,1744,1744,0,0,0,0,92
1258,c1807,20170802,1744,1744,1738,1740,1727,1740,1733,-4,-11,42,728160,82
1259,c1807,20170803,1740,1733,1740,1740,1740,1740,1740,7,7,2,34800,80
1260,c1807,20170804,1740,1740,0,0,0,1740,1740,0,0,0,0,80
1261,c1807,20170807,1740,1740,1730,1748,1729,1744,1736,4,-4,30,520900,78
1262,c1807,20170808,1744,1736,1740,1740,1740,1740,1740,4,4,10,174000,80
1263,c1807,20170809,1740,1740,1742,1773,1742,1773,1759,33,19,28,492640,90
1264,c1807,20170810,1773,1759,1782,1782,1765,1776,1776,17,17,36,639660,100
1265,c1807,20170811,1776,1776,1776,1781,1776,1781,1777,5,1,16,284460,108
1266,c1807,20170814,1781,1777,1784,1784,1777,1777,1782,0,5,8,142580,110
1267,c1807,20170815,1777,1782,1783,1784,1776,1776,1782,-6,0,52,926920,114
1268,c1807,20170816,1776,1782,1772,1772,1772,1772,1772,-10,-10,2,35440,114
1269,c1807,20170817,1772,1772,1782,1782,1778,1782,1781,10,9,16,284960,120
1270,c1807,20170818,1782,1781,1785,1785,1779,1784,1783,3,2,10,178300,122
1271,c1807,20170821,1784,1783,1785,1794,1785,1785,1786,2,3,18,321600,128
1272,c1807,20170822,1785,1786,1790,1790,1790,1790,1790,4,4,2,35800,128
1273,c1807,20170823,1790,1790,1790,1790,1785,1790,1786,0,-4,18,321560,136
1274,c1807,20170824,1790,1786,1780,1783,1774,1783,1779,-3,-7,26,462780,142
1275,c1807,20170825,1783,1779,1787,1787,1777,1781,1780,2,1,28,498640,148
1276,c1807,20170828,1781,1780,1781,1781,1773,1775,1777,-5,-3,14,248800,146
1277,c1807,20170829,1775,1777,1773,1773,1761,1761,1764,-16,-13,48,846940,140
1278,c1807,20170830,1761,1764,1759,1759,1757,1757,1757,-7,-7,22,386660,132
1279,c1807,20170831,1757,1757,1760,1760,1751,1751,1755,-6,-2,6,105300,136
1280,c1807,20170901,1751,1755,1762,1762,1750,1756,1751,1,-4,70,1226320,146
1281,c1807,20170904,1756,1751,1756,1769,1755,1769,1759,18,8,18,316780,146
1282,c1807,20170905,1769,1759,1770,1792,1764,1767,1771,8,12,40,708740,152
1283,c1807,20170906,1767,1771,1769,1777,1769,1772,1772,1,1,8,141820,154
1284,c1807,20170907,1772,1772,1778,1778,1770,1770,1773,-2,1,10,177320,164
1285,c1807,20170908,1770,1773,1781,1781,1752,1752,1759,-21,-14,96,1689420,204
1286,c1807,20170911,1752,1759,1757,1757,1751,1755,1753,-4,-6,46,806680,246
1287,c1807,20170912,1755,1753,1757,1757,1750,1755,1753,2,0,20,350680,246
1288,c1807,20170913,1755,1753,1750,1750,1750,1750,1750,-3,-3,2,35000,246
1289,c1807,20170914,1750,1750,1759,1778,1759,1764,1769,14,19,56,991000,240
1290,c1807,20170915,1764,1769,1763,1763,1759,1759,1761,-10,-8,12,211360,244
1291,c1807,20170918,1759,1761,1759,1763,1751,1758,1755,-3,-6,72,1264200,268
1292,c1807,20170919,1758,1755,1758,1758,1755,1755,1755,0,0,20,351120,268
1293,c1807,20170920,1755,1755,1759,1759,1755,1755,1757,0,2,6,105440,266
1294,c1807,20170921,1755,1757,1750,1750,1750,1750,1750,-7,-7,2,35000,264
1295,c1807,20170922,1750,1750,1751,1762,1748,1759,1758,9,8,22,386900,260
1296,c1807,20170925,1759,1758,0,0,0,1758,1758,0,0,0,0,260
1297,c1807,20170926,1758,1758,1764,1766,1761,1766,1765,8,7,54,953280,304
1298,c1807,20170927,1766,1765,1765,1765,1765,1765,1765,0,0,4,70600,306
1299,c1807,20170928,1765,1765,1748,1759,1748,1751,1756,-14,-9,78,1369680,320
1300,c1807,20170929,1751,1756,0,0,0,1754,1754,-2,-2,0,0,320
1301,c1807,20171009,1754,1754,1750,1751,1742,1742,1744,-12,-10,382,6664460,522
1302,c1807,20171010,1742,1744,1748,1748,1747,1748,1747,4,3,8,139820,526
1303,c1807,20171011,1748,1747,1748,1748,1745,1748,1747,1,0,8,139780,528
1304,c1807,20171012,1748,1747,1742,1747,1742,1745,1742,-2,-5,46,801560,492
1305,c1807,20171013,1745,1742,1747,1752,1747,1749,1748,7,6,44,769340,496
1306,c1807,20171016,1749,1748,1747,1749,1747,1749,1748,1,0,6,104880,498
1307,c1807,20171017,1749,1748,0,0,0,1748,1748,0,0,0,0,498
1308,c1807,20171018,1748,1748,0,0,0,1748,1748,0,0,0,0,498
1309,c1807,20171019,1748,1748,1745,1748,1741,1748,1745,0,-3,10,174540,498
1310,c1807,20171020,1748,1745,0,0,0,1745,1745,0,0,0,0,498
1311,c1807,20171023,1745,1745,1737,1737,1737,1737,1737,-8,-8,2,34740,498
1312,c1807,20171024,1737,1737,0,0,0,1737,1737,0,0,0,0,498
1313,c1807,20171025,1737,1737,1746,1746,1746,1746,1746,9,9,2,34920,496
1314,c1807,20171026,1746,1746,1742,1742,1742,1742,1742,-4,-4,4,69680,498
1315,c1807,20171027,1742,1742,1740,1740,1736,1736,1737,-6,-5,58,1007960,500
1316,c1807,20171030,1736,1737,1733,1733,1733,1733,1733,-4,-4,66,1143780,494
1317,c1807,20171031,1733,1733,0,0,0,1733,1733,0,0,0,0,494
1318,c1807,20171101,1733,1733,1733,1742,1733,1738,1736,5,3,14,243140,492
1319,c1807,20171102,1738,1736,0,0,0,1736,1736,0,0,0,0,492
1320,c1807,20171103,1736,1736,1741,1742,1738,1742,1740,6,4,18,313340,492
1321,c1807,20171106,1742,1740,0,0,0,1740,1740,0,0,0,0,492
1322,c1807,20171107,1740,1740,1742,1750,1742,1746,1746,6,6,8,139700,492
1323,c1807,20171108,1746,1746,1744,1749,1743,1749,1744,3,-2,14,244200,496
1324,c1807,20171109,1749,1744,1744,1747,1744,1747,1745,3,1,8,139620,496
1325,c1807,20171110,1747,1745,1748,1750,1745,1750,1748,5,3,16,279680,488
1326,c1807,20171113,1750,1748,1756,1759,1753,1759,1756,11,8,12,210740,488
1327,c1807,20171114,1759,1756,1758,1765,1755,1761,1759,5,3,20,351820,482
1328,c1807,20171115,1761,1759,1756,1763,1756,1761,1758,2,-1,24,422140,484
1329,c1807,20171116,1761,1758,0,0,0,1758,1758,0,0,0,0,484
1330,c1807,20171117,1758,1758,1755,1755,1755,1755,1755,-3,-3,2,35100,484
1331,c1807,20171120,1755,1755,1758,1758,1756,1758,1757,3,2,28,492160,500
1332,c1807,20171121,1758,1757,1757,1768,1757,1760,1760,3,3,22,387380,498
1333,c1807,20171122,1760,1760,1762,1767,1762,1765,1764,5,4,16,282360,496
1334,c1807,20171123,1765,1764,1769,1774,1767,1771,1771,7,7,34,602180,492
1335,c1807,20171124,1771,1771,1774,1774,1764,1765,1768,-6,-3,10,176800,490
1336,c1807,20171127,1765,1768,0,0,0,1768,1768,0,0,0,0,490
1337,c1807,20171128,1768,1768,0,0,0,1768,1768,0,0,0,0,490
1338,c1807,20171129,1768,1768,1775,1776,1770,1775,1774,7,6,158,2803600,398
1339,c1807,20171130,1775,1774,1779,1779,1775,1778,1775,4,1,58,1029680,352
1340,c1807,20171201,1778,1775,1776,1776,1765,1769,1770,-6,-5,16,283200,358
1341,c1807,20171204,1769,1770,1771,1780,1771,1779,1776,9,6,322,5719580,402
1342,c1807,20171205,1779,1776,1779,1786,1779,1782,1782,6,6,72,1283180,396
1343,c1807,20171206,1782,1782,1787,1798,1787,1794,1793,12,11,168,3012280,394
1344,c1807,20171207,1794,1793,1794,1794,1783,1783,1784,-10,-9,328,5852340,600
1345,c1807,20171208,1783,1784,1786,1787,1776,1786,1784,2,0,424,7565440,734
1346,c1807,20171211,1786,1784,1789,1789,1780,1783,1781,-1,-3,360,6414080,778
1347,c1807,20171212,1783,1781,1785,1785,1783,1783,1783,2,2,44,784760,790
1348,c1807,20171213,1783,1783,1788,1790,1786,1790,1788,7,5,82,1466560,774
1349,c1807,20171214,1790,1788,1796,1796,1793,1793,1793,5,5,46,825020,752
1350,c1807,20171215,1793,1793,1793,1795,1793,1795,1793,2,0,10,179380,746
1351,c1807,20171218,1795,1793,1808,1826,1807,1826,1820,33,27,476,8663960,870
1352,c1807,20171219,1826,1820,1818,1834,1818,1824,1825,4,5,88,1606820,896
1353,c1807,20171220,1824,1825,1831,1832,1827,1827,1829,2,4,68,1244040,912
1354,c1807,20171221,1827,1829,1836,1839,1832,1836,1835,7,6,554,10167800,1106
1355,c1807,20171222,1836,1835,1833,1833,1826,1828,1829,-7,-6,20,365820,1106
1356,c1807,20171225,1828,1829,1821,1828,1813,1816,1822,-13,-7,1074,19574080,1032
1357,c1807,20171226,1816,1822,1817,1820,1811,1813,1817,-9,-5,1602,29109620,1070
1358,c1807,20171227,1813,1817,1818,1822,1813,1813,1817,-4,0,142,2580200,1040
1359,c1807,20171228,1813,1817,1816,1816,1810,1815,1812,-2,-5,42,761420,1038
1360,c1807,20171229,1815,1812,1818,1818,1812,1814,1812,2,0,116,2102960,976
1361,c1809,20170915,1769,1769,1766,1798,1766,1778,1780,9,11,1922,34224620,1530
1362,c1809,20170918,1778,1780,1780,1780,1765,1766,1772,-14,-8,6174,109437820,5754
1363,c1809,20170919,1766,1772,1767,1773,1764,1765,1766,-7,-6,2376,41968640,7136
1364,c1809,20170920,1765,1766,1765,1772,1761,1762,1766,-4,0,3450,60927380,9274
1365,c1809,20170921,1762,1766,1764,1768,1761,1766,1763,0,-3,948,16720780,9430
1366,c1809,20170922,1766,1763,1765,1779,1763,1766,1768,3,5,10308,182251840,14812
1367,c1809,20170925,1766,1768,1766,1768,1761,1765,1763,-3,-5,1308,23073000,15060
1368,c1809,20170926,1765,1763,1765,1777,1764,1770,1769,7,6,3288,58181960,16130
1369,c1809,20170927,1770,1769,1769,1769,1764,1765,1766,-4,-3,2140,37803680,16918
1370,c1809,20170928,1765,1766,1765,1765,1755,1758,1759,-8,-7,2666,46897600,16306
1371,c1809,20170929,1758,1759,1755,1761,1754,1756,1756,-3,-3,2008,35279900,16096
1372,c1809,20171009,1756,1756,1761,1761,1738,1740,1748,-16,-8,5488,95962320,18292
1373,c1809,20171010,1740,1748,1743,1750,1743,1747,1748,-1,0,2764,48322800,19862
1374,c1809,20171011,1747,1748,1748,1753,1743,1743,1748,-5,0,3132,54761380,21444
1375,c1809,20171012,1743,1748,1745,1751,1745,1749,1748,1,0,2516,43992300,21862
1376,c1809,20171013,1749,1748,1754,1757,1751,1752,1753,4,5,2972,52109660,22474
1377,c1809,20171016,1752,1753,1755,1758,1749,1753,1753,0,0,2746,48142160,23740
1378,c1809,20171017,1753,1753,1751,1756,1748,1752,1753,-1,0,1286,22551300,24034
1379,c1809,20171018,1752,1753,1753,1758,1749,1749,1752,-4,-1,2570,45027460,25082
1380,c1809,20171019,1749,1752,1749,1749,1738,1746,1742,-6,-10,4718,82230860,26424
1381,c1809,20171020,1746,1742,1749,1749,1743,1745,1745,3,3,630,10999660,26560
1382,c1809,20171023,1745,1745,1741,1745,1739,1741,1741,-4,-4,1390,24206940,26560
1383,c1809,20171024,1741,1741,1744,1748,1739,1741,1743,0,2,2382,41541720,26894
1384,c1809,20171025,1741,1743,1743,1751,1742,1749,1747,6,4,2178,38053180,27136
1385,c1809,20171026,1749,1747,1749,1749,1744,1746,1746,-1,-1,1466,25609220,27532
1386,c1809,20171027,1746,1746,1748,1748,1738,1738,1740,-8,-6,3612,62852380,27114
1387,c1809,20171030,1738,1740,1738,1738,1726,1731,1731,-9,-9,4056,70224720,29156
1388,c1809,20171031,1731,1731,1730,1734,1728,1732,1731,1,0,7948,137601100,34128
1389,c1809,20171101,1732,1731,1731,1743,1729,1736,1735,5,4,6084,105575220,36212
1390,c1809,20171102,1736,1735,1736,1740,1735,1740,1737,5,2,4808,83543720,38854
1391,c1809,20171103,1740,1737,1740,1760,1738,1743,1742,6,5,6806,118605080,40422
1392,c1809,20171106,1743,1742,1743,1747,1741,1747,1743,5,1,3334,58143120,41444
1393,c1809,20171107,1747,1743,1747,1749,1742,1744,1745,1,2,14084,245816520,48700
1394,c1809,20171108,1744,1745,1746,1752,1742,1747,1746,2,1,5138,89713080,49450
1395,c1809,20171109,1747,1746,1748,1749,1742,1745,1743,-1,-3,5462,95235660,48624
1396,c1809,20171110,1745,1743,1742,1750,1739,1750,1745,7,2,6046,105537420,50680
1397,c1809,20171113,1750,1745,1751,1756,1746,1755,1751,10,6,6166,107974000,53210
1398,c1809,20171114,1755,1751,1755,1767,1750,1760,1757,9,6,9616,169022460,56692
1399,c1809,20171115,1760,1757,1755,1767,1750,1760,1757,3,0,11872,208698660,58728
1400,c1809,20171116,1760,1757,1764,1764,1741,1756,1756,-1,-1,6504,114256840,58984
1401,c1809,20171117,1756,1756,1756,1757,1745,1746,1749,-10,-7,9016,157720240,58832
1402,c1809,20171120,1746,1749,1751,1758,1750,1758,1754,9,5,5852,102674140,60234
1403,c1809,20171121,1758,1754,1762,1764,1756,1761,1759,7,5,4884,85928080,61218
1404,c1809,20171122,1761,1759,1763,1765,1756,1764,1761,5,2,8312,146417300,65562
1405,c1809,20171123,1764,1761,1765,1770,1765,1766,1767,5,6,7132,126056560,68856
1406,c1809,20171124,1766,1767,1767,1770,1759,1760,1763,-7,-4,7752,136743860,70740
1407,c1809,20171127,1760,1763,1760,1765,1760,1762,1761,-1,-2,5332,93940320,70718
1408,c1809,20171128,1762,1761,1762,1767,1762,1765,1763,4,2,8384,147884800,74516
1409,c1809,20171129,1765,1763,1765,1778,1765,1775,1772,12,9,15166,268751040,81040
1410,c1809,20171130,1775,1772,1777,1780,1769,1773,1774,1,2,19372,343788480,90094
1411,c1809,20171201,1773,1774,1773,1773,1764,1768,1767,-6,-7,14776,261092380,92576
1412,c1809,20171204,1768,1767,1770,1787,1770,1786,1780,19,13,18184,323823220,101086
1413,c1809,20171205,1786,1780,1781,1796,1780,1787,1788,7,8,17974,321509540,108950
1414,c1809,20171206,1787,1788,1790,1799,1789,1799,1795,11,7,39412,707475200,128658
1415,c1809,20171207,1799,1795,1796,1800,1778,1779,1788,-16,-7,44778,800984520,140280
1416,c1809,20171208,1779,1788,1783,1787,1777,1785,1784,-3,-4,21838,389594560,149162
1417,c1809,20171211,1785,1784,1788,1791,1776,1784,1783,0,-1,28430,507155640,155330
1418,c1809,20171212,1784,1783,1781,1787,1777,1781,1781,-2,-2,19434,346130060,161968
1419,c1809,20171213,1781,1781,1781,1789,1780,1788,1784,7,3,26168,467097460,179508
1420,c1809,20171214,1788,1784,1788,1792,1787,1790,1789,6,5,40086,717407960,194862
1421,c1809,20171215,1790,1789,1795,1795,1788,1791,1791,2,2,44008,788308080,205664
1422,c1809,20171218,1791,1791,1793,1810,1793,1809,1801,18,10,80010,1441608160,226654
1423,c1809,20171219,1809,1801,1812,1820,1803,1806,1810,5,9,43244,782874720,234054
1424,c1809,20171220,1806,1810,1810,1812,1802,1804,1807,-6,-3,40792,737268660,251764
1425,c1809,20171221,1804,1807,1805,1816,1805,1815,1811,8,4,48078,870931220,249852
1426,c1809,20171222,1815,1811,1818,1818,1804,1809,1808,-2,-3,40248,727695040,246334
1427,c1809,20171225,1809,1808,1808,1808,1791,1793,1797,-15,-11,72926,1310503180,258308
1428,c1809,20171226,1793,1797,1797,1797,1781,1785,1789,-12,-8,53692,960582560,258986
1429,c1809,20171227,1785,1789,1790,1797,1789,1792,1792,3,3,50082,897752900,253148
1430,c1809,20171228,1792,1792,1792,1799,1786,1794,1790,2,-2,47616,852356120,258866
1431,c1809,20171229,1794,1790,1795,1797,1788,1793,1791,3,1,37986,680691680,258458
1432,c1811,20171115,1757,1757,1769,1786,1763,1781,1780,24,23,134,2386120,82
1433,c1811,20171116,1781,1780,1780,1780,1761,1769,1767,-11,-13,100,1767480,48
1434,c1811,20171117,1769,1767,1764,1764,1754,1762,1760,-5,-7,6,105600,48
1435,c1811,20171120,1762,1760,1760,1766,1760,1766,1762,6,2,6,105720,52
1436,c1811,20171121,1766,1762,1772,1775,1772,1775,1774,13,12,10,177400,44
1437,c1811,20171122,1775,1774,1775,1776,1766,1776,1773,2,-1,8,141840,44
1438,c1811,20171123,1776,1773,1772,1778,1771,1777,1773,4,0,12,212840,46
1439,c1811,20171124,1777,1773,1774,1774,1773,1773,1773,0,0,4,70940,46
1440,c1811,20171127,1773,1773,1778,1778,1778,1778,1778,5,5,2,35560,44
1441,c1811,20171128,1778,1778,1776,1778,1772,1778,1777,0,-1,44,781880,46
1442,c1811,20171129,1778,1777,1780,1780,1780,1780,1780,3,3,18,320400,56
1443,c1811,20171130,1780,1780,1782,1790,1781,1785,1786,5,6,34,607320,46
1444,c1811,20171201,1785,1786,1781,1781,1779,1780,1780,-6,-6,54,961540,76
1445,c1811,20171204,1780,1780,1780,1788,1780,1787,1783,7,3,188,3353820,162
1446,c1811,20171205,1787,1783,1786,1793,1786,1790,1789,7,6,54,966420,166
1447,c1811,20171206,1790,1789,1795,1803,1795,1799,1798,10,9,146,2625360,232
1448,c1811,20171207,1799,1798,1799,1799,1783,1783,1790,-15,-8,60,1074040,232
1449,c1811,20171208,1783,1790,1780,1789,1780,1789,1786,-1,-4,70,1250300,276
1450,c1811,20171211,1789,1786,1789,1789,1784,1789,1787,3,1,28,500520,272
1451,c1811,20171212,1789,1787,1787,1788,1783,1784,1784,-3,-3,56,999140,262
1452,c1811,20171213,1784,1784,1756,1796,1756,1792,1790,8,6,90,1611020,286
1453,c1811,20171214,1792,1790,1798,1798,1792,1796,1795,6,5,16,287280,284
1454,c1811,20171215,1796,1795,1795,1801,1795,1800,1798,5,3,194,3488820,318
1455,c1811,20171218,1800,1798,1806,1818,1805,1815,1812,17,14,70,1268760,312
1456,c1811,20171219,1815,1812,1820,1820,1815,1816,1817,4,5,92,1672220,332
1457,c1811,20171220,1816,1817,1820,1820,1816,1818,1818,1,1,116,2109820,330
1458,c1811,20171221,1818,1818,1821,1826,1815,1815,1820,-3,2,364,6625160,594
1459,c1811,20171222,1815,1820,1811,1819,1811,1813,1814,-7,-6,308,5589340,670
1460,c1811,20171225,1813,1814,1808,1808,1799,1801,1804,-13,-10,60,1082660,646
1461,c1811,20171226,1801,1804,1801,1803,1793,1796,1801,-8,-3,1110,19996880,650
1462,c1811,20171227,1796,1801,1801,1802,1798,1801,1801,0,0,70,1260700,678
1463,c1811,20171228,1801,1801,1801,1802,1792,1802,1800,1,-1,98,1764220,682
1464,c1811,20171229,1802,1800,1798,1800,1792,1792,1794,-8,-6,88,1579380,698
