ROWNUM,合约,日期,前收盘价,前结算价,开盘价,最高价,最低价,收盘价,结算价,涨跌1,涨跌2,成交量,成交金额,持仓量
1,a1701,20170103,4361,4372,4390,4390,4200,4337,4289,-35,-83,194,8322380,20860
2,a1701,20170104,4337,4289,4335,4335,4335,4335,4335,46,46,20,867000,16314
3,a1701,20170105,4335,4335,4414,4414,4349,4400,4396,65,61,3150,138474640,16000
4,a1701,20170106,4400,4396,4380,4391,4341,4385,4386,-11,-10,1778,77983940,14182
5,a1701,20170109,4385,4386,4380,4390,4352,4352,4375,-34,-11,1340,58636880,9554
6,a1701,20170110,4352,4375,4370,4375,4326,4326,4338,-49,-37,1110,48158600,7570
7,a1701,20170111,4326,4338,0,0,0,4338,4338,0,0,0,0,6000
8,a1701,20170112,4338,4338,4300,4303,4300,4300,4300,-38,-38,560,24080900,5328
9,a1701,20170113,4300,4300,0,0,0,4300,4300,0,0,0,0,3934
10,a1701,20170116,4300,4300,4210,4210,4200,4200,4372,-100,72,36,1514200,0
11,a1703,20170103,4201,4205,4257,4257,4173,4174,4191,-31,-14,10,419120,1102
12,a1703,20170104,4174,4191,4179,4179,4179,4179,4179,-12,-12,4,167160,1102
13,a1703,20170105,4179,4179,0,0,0,4179,4179,0,0,0,0,1102
14,a1703,20170106,4179,4179,4151,4293,4150,4151,4197,-28,18,18,755520,1104
15,a1703,20170109,4151,4197,4151,4151,4143,4143,4149,-54,-48,8,331920,1104
16,a1703,20170110,4143,4149,4067,4067,4067,4067,4067,-82,-82,2,81340,1104
17,a1703,20170111,4067,4067,4096,4172,4085,4085,4122,18,55,10,412200,1102
18,a1703,20170112,4085,4122,4085,4129,4015,4015,4095,-107,-27,170,6961980,1262
19,a1703,20170113,4015,4095,4149,4150,4034,4034,4096,-61,1,198,8110520,1302
20,a1703,20170116,4034,4096,4065,4200,4065,4143,4100,47,4,32,1312100,1302
21,a1703,20170117,4143,4100,0,0,0,4100,4100,0,0,0,0,1302
22,a1703,20170118,4100,4100,4219,4220,4181,4204,4201,104,101,56,2352860,1328
23,a1703,20170119,4204,4201,0,0,0,4201,4201,0,0,0,0,1328
24,a1703,20170120,4201,4201,0,0,0,4201,4201,0,0,0,0,1328
25,a1703,20170123,4201,4201,0,0,0,4201,4201,0,0,0,0,1328
26,a1703,20170124,4201,4201,4376,4376,4151,4153,4226,-48,25,6,253600,1328
27,a1703,20170125,4153,4226,4018,4167,4018,4167,4060,-59,-166,14,568480,1328
28,a1703,20170126,4167,4060,0,0,0,4060,4060,0,0,0,0,1328
29,a1703,20170203,4060,4060,4243,4243,4242,4242,4242,182,182,6,254540,1322
30,a1703,20170206,4242,4242,0,0,0,4242,4242,0,0,0,0,1322
31,a1703,20170207,4242,4242,0,0,0,4242,4242,0,0,0,0,1322
32,a1703,20170208,4242,4242,4319,4319,4150,4150,4186,-92,-56,38,1590860,1302
33,a1703,20170209,4150,4186,4150,4311,4150,4311,4234,125,48,52,2202060,1282
34,a1703,20170210,4311,4234,4191,4283,4191,4222,4218,-12,-16,22,928060,1276
35,a1703,20170213,4222,4218,4301,4311,4193,4209,4240,-9,22,24,1017600,1272
36,a1703,20170214,4209,4240,4223,4358,4223,4300,4287,60,47,32,1372100,1266
37,a1703,20170215,4300,4287,4385,4468,4226,4348,4347,61,60,86,3738560,1262
38,a1703,20170216,4348,4347,0,0,0,4347,4347,0,0,0,0,1262
39,a1703,20170217,4347,4347,4310,4310,4305,4305,4307,-42,-40,4,172300,1258
40,a1703,20170220,4305,4307,4232,4232,4200,4200,4217,-107,-90,18,759100,1246
41,a1703,20170221,4200,4217,4271,4271,4271,4271,4271,54,54,4,170840,1242
42,a1703,20170222,4271,4271,4251,4251,4104,4104,4188,-167,-83,46,1926600,1222
43,a1703,20170223,4104,4188,4129,4130,4129,4130,4129,-58,-59,24,991180,1222
44,a1703,20170224,4130,4129,3925,3925,3925,3925,3925,-204,-204,4,157000,1222
45,a1703,20170227,3925,3925,4001,4085,3987,4030,4022,105,97,110,4425020,1164
46,a1703,20170228,4030,4022,4000,4025,4000,4025,4017,3,-5,14,562500,1150
47,a1703,20170301,4025,4017,4010,4010,4010,4010,4010,-7,-7,2,80200,1148
48,a1703,20170302,4010,4010,4000,4000,4000,4000,4000,-10,-10,4,160000,956
49,a1703,20170303,4000,4000,4000,4000,4000,4000,4000,0,0,40,1600000,916
50,a1703,20170306,4000,4000,0,0,0,4000,4000,0,0,0,0,516
51,a1703,20170307,4000,4000,0,0,0,4000,4000,0,0,0,0,316
52,a1703,20170308,4000,4000,0,0,0,4000,4000,0,0,0,0,316
53,a1703,20170309,4000,4000,0,0,0,4000,4000,0,0,0,0,316
54,a1703,20170310,4000,4000,0,0,0,4000,4000,0,0,0,0,316
55,a1703,20170313,4000,4000,0,0,0,4000,4000,0,0,0,0,0
56,a1703,20170314,4000,4000,0,0,0,4000,4000,0,0,0,0,0
57,a1705,20170103,4279,4296,4270,4311,4208,4217,4246,-79,-50,204190,8670845860,220916
58,a1705,20170104,4217,4246,4220,4287,4193,4285,4236,39,-10,285182,12080976860,234992
59,a1705,20170105,4285,4236,4285,4296,4241,4260,4271,24,35,224458,9588351060,231530
60,a1705,20170106,4260,4271,4248,4323,4233,4267,4279,-4,8,270432,11573863000,237594
61,a1705,20170109,4267,4279,4262,4291,4185,4211,4226,-68,-53,352130,14883347760,225122
62,a1705,20170110,4211,4226,4211,4233,4143,4169,4185,-57,-41,291642,12205671400,217724
63,a1705,20170111,4169,4185,4163,4214,4161,4174,4186,-11,1,288396,12072946920,215232
64,a1705,20170112,4174,4186,4170,4198,4088,4112,4142,-74,-44,339852,14078640300,221344
65,a1705,20170113,4112,4142,4115,4194,4100,4147,4149,5,7,322058,13362736560,203754
66,a1705,20170116,4147,4149,4143,4252,4128,4232,4197,83,48,330776,13883130700,189194
67,a1705,20170117,4232,4197,4232,4278,4200,4230,4242,33,45,266598,11309325920,180746
68,a1705,20170118,4230,4242,4242,4282,4206,4264,4243,22,1,258896,10985418960,188432
69,a1705,20170119,4264,4243,4259,4306,4237,4287,4273,44,30,328396,14034396620,192598
70,a1705,20170120,4287,4273,4292,4292,4217,4219,4254,-54,-19,177472,7550760680,177778
71,a1705,20170123,4219,4254,4221,4254,4164,4182,4199,-72,-55,213350,8958849260,179154
72,a1705,20170124,4182,4199,4192,4240,4175,4214,4209,15,10,150058,6316904280,170170
73,a1705,20170125,4214,4209,4214,4224,4164,4191,4196,-18,-13,165648,6950648760,154174
74,a1705,20170126,4191,4196,4208,4246,4184,4238,4220,42,24,149104,6292859440,152776
75,a1705,20170203,4238,4220,4220,4332,4206,4315,4297,95,77,212938,9151615380,197316
76,a1705,20170206,4315,4297,4319,4371,4288,4359,4330,62,33,254668,11029538280,221378
77,a1705,20170207,4359,4330,4353,4367,4326,4349,4345,19,15,172980,7516147020,207344
78,a1705,20170208,4349,4345,4347,4391,4326,4343,4359,-2,14,268570,11709307320,211090
79,a1705,20170209,4343,4359,4343,4375,4322,4322,4350,-37,-9,201800,8779092340,201018
80,a1705,20170210,4322,4350,4322,4353,4303,4338,4331,-12,-19,164532,7126779800,196564
81,a1705,20170213,4338,4331,4334,4403,4312,4333,4349,2,18,273856,11911758420,198158
82,a1705,20170214,4333,4349,4330,4436,4323,4352,4386,3,37,481990,21141653440,211388
83,a1705,20170215,4352,4386,4366,4376,4274,4283,4306,-103,-80,277688,11958138700,183384
84,a1705,20170216,4283,4306,4281,4328,4265,4279,4296,-27,-10,208902,8975817260,173934
85,a1705,20170217,4279,4296,4285,4304,4212,4230,4253,-66,-43,255552,10868631260,164804
86,a1705,20170220,4230,4253,4230,4251,4214,4236,4235,-17,-18,130384,5522880980,164596
87,a1705,20170221,4236,4235,4234,4287,4226,4261,4257,26,22,177294,7548954440,165250
88,a1705,20170222,4261,4257,4250,4270,4187,4198,4219,-59,-38,196078,8274054220,156706
89,a1705,20170223,4198,4219,4200,4234,4169,4180,4205,-39,-14,177450,7462211840,156622
90,a1705,20170224,4180,4205,4194,4194,4094,4135,4131,-70,-74,218530,9029285420,155260
91,a1705,20170227,4135,4131,4128,4155,4084,4125,4119,-6,-12,229232,9443066400,166654
92,a1705,20170228,4125,4119,4130,4175,4111,4119,4143,0,24,242666,10055386400,156518
93,a1705,20170301,4119,4143,4122,4173,4116,4129,4141,-14,-2,228870,9477960660,161326
94,a1705,20170302,4129,4141,4131,4136,4095,4107,4114,-34,-27,246010,10122459000,183758
95,a1705,20170303,4107,4114,4100,4103,3991,4038,4040,-76,-74,270680,10938131980,197160
96,a1705,20170306,4038,4040,4038,4046,4010,4023,4026,-17,-14,210618,8481338880,212282
97,a1705,20170307,4023,4026,4023,4037,3977,3988,4007,-38,-19,243624,9762028740,237552
98,a1705,20170308,3988,4007,3988,4032,3967,4023,4001,16,-6,295622,11829234180,215422
99,a1705,20170309,4023,4001,4028,4045,3977,4011,4019,10,18,315116,12664754900,207792
100,a1705,20170310,4011,4019,4005,4013,3852,3881,3927,-138,-92,398872,15664950780,186306
101,a1705,20170313,3881,3927,3900,3937,3888,3912,3913,-15,-14,178924,7003023420,171168
102,a1705,20170314,3912,3913,3907,3923,3844,3872,3881,-41,-32,207434,8052579940,179710
103,a1705,20170315,3872,3881,3870,3888,3840,3854,3862,-27,-19,197392,7623328180,188434
104,a1705,20170316,3854,3862,3862,3867,3802,3813,3829,-49,-33,254112,9730678620,212106
105,a1705,20170317,3813,3829,3811,3840,3811,3822,3824,-7,-5,175716,6720344980,202950
106,a1705,20170320,3822,3824,3820,3853,3818,3830,3835,6,11,172084,6600903380,200514
107,a1705,20170321,3830,3835,3837,3837,3764,3790,3792,-45,-43,216072,8193664460,206082
108,a1705,20170322,3790,3792,3795,3866,3783,3848,3829,56,37,279206,10692110040,177060
109,a1705,20170323,3848,3829,3853,3875,3822,3842,3842,13,13,241444,9278110020,164942
110,a1705,20170324,3842,3842,3840,3865,3811,3844,3841,2,-1,163240,6271498260,155552
111,a1705,20170327,3844,3841,3839,3855,3687,3725,3758,-116,-83,225970,8492512160,143570
112,a1705,20170328,3725,3758,3729,3777,3708,3750,3745,-8,-13,104796,3925422940,123068
113,a1705,20170329,3750,3745,3760,3763,3732,3744,3746,-1,1,66980,2509354600,119356
114,a1705,20170330,3744,3746,3758,3758,3713,3725,3728,-21,-18,43896,1636606700,113140
115,a1705,20170331,3725,3728,3719,3761,3662,3718,3728,-10,0,35998,1342196840,106868
116,a1705,20170405,3718,3728,3700,3750,3679,3743,3716,15,-12,30170,1121266800,101202
117,a1705,20170406,3743,3716,3750,3764,3709,3719,3735,3,19,24914,930784460,98610
118,a1705,20170407,3719,3735,3729,3736,3695,3709,3716,-26,-19,37812,1405380160,89626
119,a1705,20170410,3709,3716,3710,3788,3710,3770,3749,54,33,45158,1693423860,76748
120,a1705,20170411,3770,3749,3780,3792,3751,3772,3776,23,27,22172,837386360,71178
121,a1705,20170412,3772,3776,3772,3787,3731,3753,3766,-23,-10,26368,993135880,63760
122,a1705,20170413,3753,3766,3766,3810,3747,3801,3783,35,17,16826,636628520,56810
123,a1705,20170414,3801,3783,3801,3821,3793,3809,3805,26,22,14730,560577440,50388
124,a1705,20170417,3809,3805,3805,3837,3752,3753,3790,-52,-15,21750,824463460,46182
125,a1705,20170418,3753,3790,3753,3754,3652,3657,3695,-133,-95,15242,563282620,42982
126,a1705,20170419,3657,3695,3641,3687,3635,3681,3668,-14,-27,8510,312147880,38886
127,a1705,20170420,3681,3668,3693,3693,3650,3670,3675,2,7,6754,248252600,37106
128,a1705,20170421,3670,3675,3670,3681,3650,3653,3662,-22,-13,5858,214545860,35682
129,a1705,20170424,3653,3662,3656,3667,3628,3635,3644,-27,-18,12632,460374400,30898
130,a1705,20170425,3635,3644,3638,3638,3606,3627,3619,-17,-25,12556,454527060,26522
131,a1705,20170426,3627,3619,3627,3658,3623,3635,3637,16,18,9412,342350900,23018
132,a1705,20170427,3635,3637,3638,3646,3609,3616,3626,-21,-11,10474,379811020,20498
133,a1705,20170428,3616,3626,3640,3654,3614,3653,3636,27,10,16408,596746140,15060
134,a1705,20170502,3653,3636,3636,3738,3636,3736,3692,100,56,1358,50142380,8476
135,a1705,20170503,3736,3692,3701,3729,3701,3728,3719,36,27,566,21054720,8868
136,a1705,20170504,3728,3719,3737,3743,3720,3720,3735,1,16,64,2390400,6270
137,a1705,20170505,3720,3735,3734,3735,3725,3725,3730,-10,-5,96,3581200,4366
138,a1705,20170508,3725,3730,3725,3760,3720,3732,3740,2,10,164,6133840,4524
139,a1705,20170509,3732,3740,3733,3733,3733,3733,3733,-7,-7,46,1717180,4570
140,a1705,20170510,3733,3733,3744,3744,3744,3744,3744,11,11,16,599040,3266
141,a1705,20170511,3744,3744,3740,3750,3720,3720,3738,-24,-6,518,19364120,582
142,a1705,20170512,3720,3738,3740,3740,3700,3700,3722,-38,-16,240,8934000,308
143,a1705,20170515,3700,3722,3710,3713,3693,3713,3712,-9,-10,180,6673400,0
144,a1707,20170103,4265,4265,0,0,0,4216,4216,-49,-49,0,0,30
145,a1707,20170104,4216,4216,0,0,0,4216,4216,0,0,0,0,30
146,a1707,20170105,4216,4216,0,0,0,4216,4216,0,0,0,0,30
147,a1707,20170106,4216,4216,0,0,0,4216,4216,0,0,0,0,30
148,a1707,20170109,4216,4216,0,0,0,4216,4216,0,0,0,0,30
149,a1707,20170110,4216,4216,0,0,0,4216,4216,0,0,0,0,30
150,a1707,20170111,4216,4216,0,0,0,4217,4217,1,1,0,0,30
151,a1707,20170112,4217,4217,0,0,0,4217,4217,0,0,0,0,30
152,a1707,20170113,4217,4217,0,0,0,4217,4217,0,0,0,0,30
153,a1707,20170116,4217,4217,0,0,0,4217,4217,0,0,0,0,30
154,a1707,20170117,4217,4217,0,0,0,4217,4217,0,0,0,0,30
155,a1707,20170118,4217,4217,0,0,0,4217,4217,0,0,0,0,30
156,a1707,20170119,4217,4217,0,0,0,4217,4217,0,0,0,0,30
157,a1707,20170120,4217,4217,0,0,0,4217,4217,0,0,0,0,30
158,a1707,20170123,4217,4217,0,0,0,4217,4217,0,0,0,0,30
159,a1707,20170124,4217,4217,0,0,0,4217,4217,0,0,0,0,30
160,a1707,20170125,4217,4217,0,0,0,4217,4217,0,0,0,0,30
161,a1707,20170126,4217,4217,4227,4227,4164,4164,4195,-53,-22,4,167820,30
162,a1707,20170203,4164,4195,0,0,0,4195,4195,0,0,0,0,30
163,a1707,20170206,4195,4195,0,0,0,4195,4195,0,0,0,0,30
164,a1707,20170207,4195,4195,0,0,0,4209,4209,14,14,0,0,30
165,a1707,20170208,4209,4209,0,0,0,4209,4209,0,0,0,0,30
166,a1707,20170209,4209,4209,0,0,0,4201,4201,-8,-8,0,0,30
167,a1707,20170210,4201,4201,4289,4289,4289,4289,4289,88,88,2,85780,32
168,a1707,20170213,4289,4289,4357,4357,4263,4263,4329,-26,40,8,346380,28
169,a1707,20170214,4263,4329,4297,4434,4297,4355,4337,26,8,42,1821840,38
170,a1707,20170215,4355,4337,4373,4373,4277,4277,4311,-60,-26,8,344940,34
171,a1707,20170216,4277,4311,0,0,0,4311,4311,0,0,0,0,34
172,a1707,20170217,4311,4311,4258,4258,4248,4250,4253,-61,-58,8,340280,28
173,a1707,20170220,4250,4253,0,0,0,4253,4253,0,0,0,0,28
174,a1707,20170221,4253,4253,4194,4264,4194,4264,4229,11,-24,8,338320,24
175,a1707,20170222,4264,4229,0,0,0,4229,4229,0,0,0,0,24
176,a1707,20170223,4229,4229,0,0,0,4229,4229,0,0,0,0,24
177,a1707,20170224,4229,4229,0,0,0,4155,4155,-74,-74,0,0,24
178,a1707,20170227,4155,4155,4109,4109,4101,4101,4105,-54,-50,4,164200,22
179,a1707,20170228,4101,4105,4071,4134,4071,4134,4092,29,-13,8,327420,28
180,a1707,20170301,4134,4092,4121,4121,4085,4085,4103,-7,11,4,164120,28
181,a1707,20170302,4085,4103,4091,4091,4091,4091,4091,-12,-12,2,81820,26
182,a1707,20170303,4091,4091,0,0,0,4091,4091,0,0,0,0,26
183,a1707,20170306,4091,4091,0,0,0,4077,4077,-14,-14,0,0,26
184,a1707,20170307,4077,4077,0,0,0,4077,4077,0,0,0,0,26
185,a1707,20170308,4077,4077,0,0,0,4077,4077,0,0,0,0,26
186,a1707,20170309,4077,4077,0,0,0,4095,4095,18,18,0,0,26
187,a1707,20170310,4095,4095,3891,3899,3891,3899,3895,-196,-200,4,155800,24
188,a1707,20170313,3899,3895,3894,3894,3894,3894,3894,-1,-1,2,77880,22
189,a1707,20170314,3894,3894,0,0,0,3894,3894,0,0,0,0,22
190,a1707,20170315,3894,3894,0,0,0,3894,3894,0,0,0,0,22
191,a1707,20170316,3894,3894,0,0,0,3894,3894,0,0,0,0,22
192,a1707,20170317,3894,3894,3854,3879,3837,3875,3861,-19,-33,8,308900,26
193,a1707,20170320,3875,3861,3867,3924,3867,3908,3910,47,49,170,6647180,98
194,a1707,20170321,3908,3910,3894,3908,3860,3868,3870,-42,-40,68,2631880,98
195,a1707,20170322,3868,3870,3898,3932,3845,3932,3905,62,35,16,624880,96
196,a1707,20170323,3932,3905,3899,3899,3899,3899,3899,-6,-6,2,77980,96
197,a1707,20170324,3899,3899,3926,3932,3868,3901,3888,2,-11,104,4043940,60
198,a1707,20170327,3901,3888,3886,3886,3799,3799,3855,-89,-33,6,231300,60
199,a1707,20170328,3799,3855,3791,3791,3791,3791,3791,-64,-64,2,75820,60
200,a1707,20170329,3791,3791,0,0,0,3792,3792,1,1,0,0,60
201,a1707,20170330,3792,3792,0,0,0,3792,3792,0,0,0,0,60
202,a1707,20170331,3792,3792,3819,3820,3819,3820,3819,28,27,4,152780,58
203,a1707,20170405,3820,3819,3779,3781,3778,3781,3779,-38,-40,6,226760,58
204,a1707,20170406,3781,3779,0,0,0,3779,3779,0,0,0,0,58
205,a1707,20170407,3779,3779,3789,3789,3789,3789,3789,10,10,2,75780,56
206,a1707,20170410,3789,3789,3838,3858,3838,3858,3851,69,62,6,231080,58
207,a1707,20170411,3858,3851,3799,3799,3799,3799,3799,-52,-52,2,75980,58
208,a1707,20170412,3799,3799,3881,3881,3881,3881,3881,82,82,2,77620,58
209,a1707,20170413,3881,3881,0,0,0,3881,3881,0,0,0,0,58
210,a1707,20170414,3881,3881,3878,3896,3844,3844,3871,-37,-10,12,464620,58
211,a1707,20170417,3844,3871,3900,3900,3821,3821,3858,-50,-13,6,231520,58
212,a1707,20170418,3821,3858,3736,3736,3736,3736,3736,-122,-122,2,74720,58
213,a1707,20170419,3736,3736,0,0,0,3736,3736,0,0,0,0,58
214,a1707,20170420,3736,3736,0,0,0,3736,3736,0,0,0,0,58
215,a1707,20170421,3736,3736,3742,3765,3714,3714,3740,-22,4,14,523680,62
216,a1707,20170424,3714,3740,3753,3756,3753,3755,3755,15,15,26,976320,70
217,a1707,20170425,3755,3755,3719,3719,3683,3683,3701,-72,-54,4,148040,66
218,a1707,20170426,3683,3701,3722,3722,3722,3722,3722,21,21,2,74440,66
219,a1707,20170427,3722,3722,3700,3700,3699,3699,3699,-23,-23,8,295940,66
220,a1707,20170428,3699,3699,3719,3719,3719,3719,3719,20,20,2,74380,64
221,a1707,20170502,3719,3719,0,0,0,3783,3783,64,64,0,0,64
222,a1707,20170503,3783,3783,3841,3841,3833,3833,3837,50,54,4,153480,64
223,a1707,20170504,3833,3837,3748,3748,3748,3748,3748,-89,-89,2,74960,62
224,a1707,20170505,3748,3748,0,0,0,3748,3748,0,0,0,0,62
225,a1707,20170508,3748,3748,3833,3833,3745,3767,3778,19,30,8,302240,58
226,a1707,20170509,3767,3778,3838,3838,3772,3772,3799,-6,21,12,455920,56
227,a1707,20170510,3772,3799,0,0,0,3799,3799,0,0,0,0,56
228,a1707,20170511,3799,3799,0,0,0,3793,3793,-6,-6,0,0,56
229,a1707,20170512,3793,3793,3815,3815,3750,3750,3782,-43,-11,4,151300,56
230,a1707,20170515,3750,3782,3805,3805,3783,3784,3791,2,9,14,530760,62
231,a1707,20170516,3784,3791,3722,3784,3722,3784,3753,-7,-38,8,300240,62
232,a1707,20170517,3784,3753,3711,3798,3711,3736,3755,-17,2,14,525820,60
233,a1707,20170518,3736,3755,3803,3809,3803,3809,3806,54,51,4,152240,60
234,a1707,20170519,3809,3806,3714,3749,3688,3705,3717,-101,-89,14,520380,60
235,a1707,20170522,3705,3717,3748,3802,3748,3751,3772,34,55,8,301760,58
236,a1707,20170523,3751,3772,0,0,0,3772,3772,0,0,0,0,58
237,a1707,20170524,3772,3772,3760,3796,3760,3796,3778,24,6,4,151120,60
238,a1707,20170525,3796,3778,3715,3715,3715,3715,3715,-63,-63,2,74300,60
239,a1707,20170526,3715,3715,3747,3747,3747,3747,3747,32,32,2,74940,58
240,a1707,20170531,3747,3747,0,0,0,3747,3747,0,0,0,0,58
241,a1707,20170601,3747,3747,0,0,0,3690,3690,-57,-57,0,0,58
242,a1707,20170602,3690,3690,0,0,0,3690,3690,0,0,0,0,58
243,a1707,20170605,3690,3690,3671,3767,3610,3767,3740,77,50,68,2543600,78
244,a1707,20170606,3767,3740,3795,3795,3752,3762,3769,22,29,18,678540,70
245,a1707,20170607,3762,3769,3753,3786,3753,3786,3769,17,0,4,150780,70
246,a1707,20170608,3786,3769,3818,3818,3750,3778,3777,9,8,18,679920,70
247,a1707,20170609,3778,3777,3780,3897,3780,3818,3822,41,45,12,458720,66
248,a1707,20170612,3818,3822,3890,3891,3851,3851,3879,29,57,34,1319000,70
249,a1707,20170613,3851,3879,3866,3895,3828,3828,3862,-51,-17,10,386240,70
250,a1707,20170614,3828,3862,3788,3788,3788,3788,3788,-74,-74,2,75760,68
251,a1707,20170615,3788,3788,0,0,0,3788,3788,0,0,0,0,68
252,a1707,20170616,3788,3788,3869,3869,3726,3726,3797,-62,9,4,151900,68
253,a1707,20170619,3726,3797,0,0,0,3797,3797,0,0,0,0,68
254,a1707,20170620,3797,3797,0,0,0,3797,3797,0,0,0,0,68
255,a1707,20170621,3797,3797,0,0,0,3789,3789,-8,-8,0,0,68
256,a1707,20170622,3789,3789,0,0,0,3789,3789,0,0,0,0,68
257,a1707,20170623,3789,3789,3742,3742,3720,3720,3731,-69,-58,12,447740,58
258,a1707,20170626,3720,3731,3667,3769,3667,3668,3707,-63,-24,10,370760,58
259,a1707,20170627,3668,3707,3697,3770,3608,3770,3722,63,15,46,1712380,72
260,a1707,20170628,3770,3722,3778,3778,3778,3778,3778,56,56,2,75560,72
261,a1707,20170629,3778,3778,0,0,0,3778,3778,0,0,0,0,72
262,a1707,20170630,3778,3778,0,0,0,3778,3778,0,0,0,0,72
263,a1707,20170703,3778,3778,0,0,0,3778,3778,0,0,0,0,4
264,a1707,20170704,3778,3778,0,0,0,3778,3778,0,0,0,0,4
265,a1707,20170705,3778,3778,0,0,0,3778,3778,0,0,0,0,4
266,a1707,20170706,3778,3778,0,0,0,3778,3778,0,0,0,0,4
267,a1707,20170707,3778,3778,0,0,0,3778,3778,0,0,0,0,4
268,a1707,20170710,3778,3778,0,0,0,3778,3778,0,0,0,0,4
269,a1707,20170711,3778,3778,0,0,0,3778,3778,0,0,0,0,4
270,a1707,20170712,3778,3778,0,0,0,3778,3778,0,0,0,0,4
271,a1707,20170713,3778,3778,0,0,0,3778,3778,0,0,0,0,4
272,a1707,20170714,3778,3778,4004,4004,4004,4004,4004,226,226,4,160160,0
273,a1709,20170103,4190,4206,4180,4220,4137,4143,4161,-63,-45,6636,276183560,22710
274,a1709,20170104,4143,4161,4141,4210,4126,4207,4164,46,3,8606,358437080,23418
275,a1709,20170105,4207,4164,4209,4224,4178,4194,4203,30,39,4688,197050180,23926
276,a1709,20170106,4194,4203,4192,4246,4175,4192,4208,-11,5,7942,334245140,24014
277,a1709,20170109,4192,4208,4200,4219,4121,4147,4159,-61,-49,6612,275052620,23716
278,a1709,20170110,4147,4159,4150,4169,4080,4107,4118,-52,-41,8108,333933840,25030
279,a1709,20170111,4107,4118,4099,4149,4099,4110,4116,-8,-2,10984,452167820,24236
280,a1709,20170112,4110,4116,4115,4140,4050,4064,4094,-52,-22,16194,663025320,28620
281,a1709,20170113,4064,4094,4074,4148,4056,4101,4105,7,11,13516,554962160,28996
282,a1709,20170116,4101,4105,4108,4190,4088,4170,4145,65,40,12874,533696940,27536
283,a1709,20170117,4170,4145,4170,4210,4146,4173,4181,28,36,13404,560464720,28214
284,a1709,20170118,4173,4181,4186,4215,4158,4198,4184,17,3,13464,563403980,27122
285,a1709,20170119,4198,4184,4206,4247,4174,4218,4211,34,27,13514,569188540,27124
286,a1709,20170120,4218,4211,4218,4223,4163,4165,4192,-46,-19,7442,311975780,26970
287,a1709,20170123,4165,4192,4169,4189,4122,4128,4148,-64,-44,7008,290743040,26780
288,a1709,20170124,4128,4148,4135,4180,4126,4150,4152,2,4,6496,269762360,27032
289,a1709,20170125,4150,4152,4155,4155,4115,4132,4133,-20,-19,8450,349256960,26040
290,a1709,20170126,4132,4133,4134,4190,4130,4166,4158,33,25,6112,254175840,26042
291,a1709,20170203,4166,4158,4146,4251,4142,4234,4217,76,59,9456,398805400,26104
292,a1709,20170206,4234,4217,4233,4295,4212,4283,4256,66,39,12648,538374660,27338
293,a1709,20170207,4283,4256,4283,4319,4271,4295,4295,39,39,27156,1166428380,37998
294,a1709,20170208,4295,4295,4295,4330,4280,4297,4306,2,11,15914,685395320,40138
295,a1709,20170209,4297,4306,4303,4317,4274,4280,4300,-26,-6,13578,583907960,41526
296,a1709,20170210,4280,4300,4281,4311,4268,4303,4292,3,-8,12890,553308400,44254
297,a1709,20170213,4303,4292,4307,4354,4287,4297,4315,5,23,17906,772656680,44466
298,a1709,20170214,4297,4315,4300,4378,4291,4313,4335,-2,20,24362,1056296000,47520
299,a1709,20170215,4313,4335,4325,4332,4236,4259,4269,-76,-66,23104,986396060,48686
300,a1709,20170216,4259,4269,4259,4302,4249,4265,4278,-4,9,16582,709540740,49120
301,a1709,20170217,4265,4278,4268,4289,4193,4207,4237,-71,-41,22214,941306100,49688
302,a1709,20170220,4207,4237,4221,4221,4180,4200,4198,-37,-39,19624,823891900,49522
303,a1709,20170221,4200,4198,4200,4241,4183,4219,4209,21,11,19522,821763260,50426
304,a1709,20170222,4219,4209,4215,4226,4161,4170,4185,-39,-24,19540,817796520,55444
305,a1709,20170223,4170,4185,4170,4197,4146,4158,4175,-27,-10,14898,622098920,58202
306,a1709,20170224,4158,4175,4159,4165,4088,4116,4115,-59,-60,27060,1113585080,63424
307,a1709,20170227,4116,4115,4115,4138,4074,4098,4102,-17,-13,33730,1383627900,70808
308,a1709,20170228,4098,4102,4091,4130,4082,4095,4107,-7,5,24928,1024025440,74342
309,a1709,20170301,4095,4107,4103,4152,4094,4116,4123,9,16,34234,1411500860,85898
310,a1709,20170302,4116,4123,4129,4129,4082,4089,4101,-34,-22,46452,1905209560,93146
311,a1709,20170303,4089,4101,4088,4088,3986,4020,4025,-81,-76,52356,2107750540,98800
312,a1709,20170306,4020,4025,4020,4033,4006,4019,4020,-6,-5,37880,1522973820,106236
313,a1709,20170307,4019,4020,4019,4029,3974,3980,4001,-40,-19,52572,2103794940,118180
314,a1709,20170308,3980,4001,3982,4003,3960,3998,3983,-3,-18,56612,2255267660,117144
315,a1709,20170309,3998,3983,3992,4011,3951,3977,3990,-6,7,57892,2309917500,119652
316,a1709,20170310,3977,3990,3977,3986,3865,3885,3911,-105,-79,101662,3976039680,113834
317,a1709,20170313,3885,3911,3897,3920,3882,3895,3898,-16,-13,56022,2184195140,117024
318,a1709,20170314,3895,3898,3872,3903,3846,3856,3871,-42,-27,61064,2363969220,130198
319,a1709,20170315,3856,3871,3850,3880,3838,3856,3858,-15,-13,62000,2392474540,142162
320,a1709,20170316,3856,3858,3867,3873,3838,3846,3854,-12,-4,73100,2817893820,149836
321,a1709,20170317,3846,3854,3853,3868,3842,3853,3854,-1,0,73520,2834087980,160652
322,a1709,20170320,3853,3854,3852,3885,3848,3878,3869,24,15,79966,3094156160,167132
323,a1709,20170321,3878,3869,3877,3890,3841,3852,3859,-17,-10,90416,3489998500,176178
324,a1709,20170322,3852,3859,3855,3908,3845,3882,3876,23,17,132668,5143435360,181048
325,a1709,20170323,3882,3876,3877,3905,3853,3871,3880,-5,4,162134,6290893260,191462
326,a1709,20170324,3871,3880,3860,3896,3857,3876,3876,-4,-4,120488,4670294960,192586
327,a1709,20170327,3876,3876,3875,3887,3751,3782,3808,-94,-68,215224,8197255980,187602
328,a1709,20170328,3782,3808,3782,3810,3762,3789,3790,-19,-18,95602,3623445340,188024
329,a1709,20170329,3789,3790,3795,3816,3779,3798,3796,8,6,94780,3597878360,196704
330,a1709,20170330,3798,3796,3793,3805,3765,3784,3781,-12,-15,120554,4558169700,208232
331,a1709,20170331,3784,3781,3770,3825,3715,3788,3793,7,12,164772,6250973640,212770
332,a1709,20170405,3788,3793,3750,3814,3741,3802,3780,9,-13,147868,5589488520,218080
333,a1709,20170406,3802,3780,3805,3817,3764,3781,3791,1,11,177766,6740254440,230598
334,a1709,20170407,3781,3791,3783,3797,3749,3763,3769,-28,-22,178010,6709544440,229332
335,a1709,20170410,3763,3769,3775,3866,3766,3847,3821,78,52,383392,14649601640,240108
336,a1709,20170411,3847,3821,3847,3869,3821,3849,3848,28,27,240006,9235964520,240820
337,a1709,20170412,3849,3848,3849,3884,3802,3824,3846,-24,-2,331126,12737349200,237456
338,a1709,20170413,3824,3846,3828,3873,3812,3856,3849,10,3,204042,7853785460,239840
339,a1709,20170414,3856,3849,3859,3882,3836,3861,3856,12,7,212310,8187041420,235418
340,a1709,20170417,3861,3856,3866,3906,3766,3770,3827,-86,-29,462692,17711564260,246260
341,a1709,20170418,3770,3827,3770,3775,3701,3714,3738,-113,-89,342290,12795248720,269130
342,a1709,20170419,3714,3738,3718,3748,3695,3746,3729,8,-9,250428,9338534160,265590
343,a1709,20170420,3746,3729,3749,3774,3702,3752,3743,23,14,289822,10849431500,247684
344,a1709,20170421,3752,3743,3748,3769,3730,3743,3747,0,4,171178,6414143240,249612
345,a1709,20170424,3743,3747,3750,3782,3722,3735,3748,-12,1,236160,8853431780,259696
346,a1709,20170425,3735,3748,3740,3741,3708,3726,3725,-22,-23,175878,6551881640,259566
347,a1709,20170426,3726,3725,3730,3755,3705,3725,3728,0,3,190462,7101828720,259462
348,a1709,20170427,3725,3728,3729,3745,3715,3730,3727,2,-1,176358,6574011720,249700
349,a1709,20170428,3730,3727,3735,3768,3727,3754,3750,27,23,222022,8325932400,244886
350,a1709,20170502,3754,3750,3760,3855,3760,3841,3824,91,74,213302,8158152240,242402
351,a1709,20170503,3841,3824,3835,3839,3808,3828,3825,4,1,145726,5574832520,230746
352,a1709,20170504,3828,3825,3833,3844,3796,3809,3819,-16,-6,210882,8053674700,225278
353,a1709,20170505,3809,3819,3814,3841,3801,3813,3819,-6,0,187392,7156571720,225662
354,a1709,20170508,3813,3819,3823,3875,3801,3831,3833,12,14,264808,10152386460,231214
355,a1709,20170509,3831,3833,3828,3846,3806,3836,3827,3,-6,171918,6579751580,223240
356,a1709,20170510,3836,3827,3838,3855,3819,3839,3837,12,10,161018,6178354860,216130
357,a1709,20170511,3839,3837,3844,3860,3767,3805,3808,-32,-29,305604,11637577420,221558
358,a1709,20170512,3805,3808,3800,3808,3772,3781,3788,-27,-20,159162,6030171600,205876
359,a1709,20170515,3781,3788,3766,3800,3761,3772,3780,-16,-8,139314,5267126940,209750
360,a1709,20170516,3772,3780,3781,3789,3753,3767,3769,-13,-11,146526,5523257520,220238
361,a1709,20170517,3767,3769,3772,3816,3763,3809,3792,40,23,204770,7765530800,209824
362,a1709,20170518,3809,3792,3804,3828,3755,3771,3783,-21,-9,211096,7987162800,219988
363,a1709,20170519,3771,3783,3755,3773,3737,3762,3754,-21,-29,172484,6476595480,224960
364,a1709,20170522,3762,3754,3770,3844,3759,3817,3811,63,57,255794,9750628320,212428
365,a1709,20170523,3817,3811,3818,3844,3804,3833,3826,22,15,161914,6194958580,216550
366,a1709,20170524,3833,3826,3835,3888,3814,3864,3852,38,26,281698,10851465840,241548
367,a1709,20170525,3864,3852,3866,3882,3831,3843,3856,-9,4,243516,9391854420,231928
368,a1709,20170526,3843,3856,3856,3870,3811,3829,3843,-27,-13,191072,7343232360,214552
369,a1709,20170531,3829,3843,3820,3820,3721,3736,3759,-107,-84,252010,9474409200,194716
370,a1709,20170601,3736,3759,3743,3756,3726,3748,3740,-11,-19,152548,5706470080,199148
371,a1709,20170602,3748,3740,3750,3785,3741,3766,3765,26,25,162320,6112472280,180634
372,a1709,20170605,3766,3765,3766,3836,3764,3828,3812,63,47,218852,8343226840,190924
373,a1709,20170606,3828,3812,3826,3856,3816,3835,3834,23,22,163366,6264157580,193388
374,a1709,20170607,3835,3834,3835,3860,3817,3847,3840,13,6,174568,6704662360,198324
375,a1709,20170608,3847,3840,3854,3865,3835,3849,3847,9,7,119798,4608898380,199262
376,a1709,20170609,3849,3847,3855,3967,3850,3940,3918,93,71,420468,16474513980,245244
377,a1709,20170612,3940,3918,3947,3996,3926,3976,3957,58,39,262142,10374098600,240904
378,a1709,20170613,3976,3957,3970,3979,3917,3961,3949,4,-8,253786,10023827280,232856
379,a1709,20170614,3961,3949,3961,3974,3925,3942,3949,-7,0,202706,8005809000,236644
380,a1709,20170615,3942,3949,3930,3978,3916,3959,3949,10,0,225364,8899951800,236062
381,a1709,20170616,3959,3949,3950,4008,3892,3918,3948,-31,-1,342834,13537155060,211344
382,a1709,20170619,3918,3948,3933,3948,3878,3888,3911,-60,-37,252282,9868874440,198054
383,a1709,20170620,3888,3911,3888,3913,3863,3892,3890,-19,-21,209276,8141381640,197050
384,a1709,20170621,3892,3890,3884,3922,3841,3855,3876,-35,-14,248000,9612724140,184826
385,a1709,20170622,3855,3876,3855,3866,3831,3843,3852,-33,-24,162644,6265938380,180734
386,a1709,20170623,3843,3852,3838,3854,3816,3841,3837,-11,-15,152572,5854850320,179916
387,a1709,20170626,3841,3837,3850,3886,3832,3845,3858,8,21,170544,6579631900,182340
388,a1709,20170627,3845,3858,3842,3857,3823,3842,3843,-16,-15,113022,4344557440,187286
389,a1709,20170628,3842,3843,3850,3872,3831,3856,3851,13,8,194670,7497115180,197970
390,a1709,20170629,3856,3851,3877,3880,3842,3857,3860,6,9,181442,7004181360,202406
391,a1709,20170630,3857,3860,3859,3888,3824,3858,3859,-2,-1,203510,7855389080,203116
392,a1709,20170703,3858,3859,3867,3934,3848,3900,3896,41,37,287202,11190504200,212616
393,a1709,20170704,3900,3896,3905,3940,3865,3902,3908,6,12,230034,8990407800,209914
394,a1709,20170705,3902,3908,3912,3917,3877,3888,3898,-20,-10,182868,7129574500,200426
395,a1709,20170706,3888,3898,3895,3916,3832,3849,3866,-49,-32,311198,12033080200,193848
396,a1709,20170707,3849,3866,3852,3861,3803,3819,3832,-47,-34,184030,7053127860,190986
397,a1709,20170710,3819,3832,3831,3907,3821,3878,3868,46,36,268234,10375622380,166330
398,a1709,20170711,3878,3868,3878,3920,3876,3888,3896,20,28,204406,7964391400,166854
399,a1709,20170712,3888,3896,3878,3946,3865,3906,3909,10,13,243904,9536052940,173020
400,a1709,20170713,3906,3909,3912,3924,3882,3892,3900,-17,-9,155072,6049003180,174112
401,a1709,20170714,3892,3900,3892,3892,3808,3820,3834,-80,-66,231940,8894502120,166232
402,a1709,20170717,3820,3834,3830,3844,3789,3811,3820,-23,-14,184864,7063432060,163202
403,a1709,20170718,3811,3820,3820,3836,3805,3823,3821,3,1,121324,4636363580,160604
404,a1709,20170719,3823,3821,3834,3853,3795,3813,3819,-8,-2,152106,5809275500,167412
405,a1709,20170720,3813,3819,3821,3843,3778,3803,3815,-16,-4,201288,7680690700,176590
406,a1709,20170721,3803,3815,3814,3818,3780,3808,3802,-7,-13,189748,7215538320,179932
407,a1709,20170724,3808,3802,3808,3823,3746,3783,3779,-19,-23,210952,7971963420,172928
408,a1709,20170725,3783,3779,3783,3816,3774,3789,3789,10,10,121838,4616671360,171852
409,a1709,20170726,3789,3789,3780,3812,3765,3796,3790,7,1,140620,5330324840,169736
410,a1709,20170727,3796,3790,3790,3817,3785,3809,3805,19,15,117218,4460712600,162084
411,a1709,20170728,3809,3805,3817,3822,3787,3794,3805,-11,0,120938,4602349800,157016
412,a1709,20170731,3794,3805,3802,3822,3781,3811,3802,6,-3,174944,6652680620,140784
413,a1709,20170801,3811,3802,3805,3832,3773,3791,3804,-11,2,193362,7355549400,136750
414,a1709,20170802,3791,3804,3791,3801,3764,3793,3781,-11,-23,130602,4938391880,134482
415,a1709,20170803,3793,3781,3797,3800,3771,3779,3782,-2,1,83664,3164737700,130868
416,a1709,20170804,3779,3782,3779,3794,3761,3780,3780,-2,-2,120910,4571184120,103534
417,a1709,20170807,3780,3780,3790,3863,3767,3860,3818,80,38,140644,5370212860,79512
418,a1709,20170808,3860,3818,3846,3885,3846,3863,3867,45,49,69252,2678608360,58360
419,a1709,20170809,3863,3867,3860,3884,3847,3873,3867,6,0,26940,1041850260,47940
420,a1709,20170810,3873,3867,3867,3891,3856,3878,3876,11,9,22932,888932140,38226
421,a1709,20170811,3878,3876,3887,3895,3830,3850,3858,-26,-18,23934,923463080,30190
422,a1709,20170814,3850,3858,3858,3858,3775,3785,3802,-73,-56,19386,737192460,28662
423,a1709,20170815,3785,3802,3779,3811,3776,3789,3789,-13,-13,30372,1151036640,26908
424,a1709,20170816,3789,3789,3787,3797,3768,3786,3783,-3,-6,5460,206595560,25264
425,a1709,20170817,3786,3783,3784,3803,3782,3797,3791,14,8,6160,233572780,23840
426,a1709,20170818,3797,3791,3791,3809,3780,3791,3793,0,2,5170,196119060,21526
427,a1709,20170821,3791,3793,3791,3829,3790,3801,3808,8,15,6396,243561920,19956
428,a1709,20170822,3801,3808,3806,3822,3782,3815,3805,7,-3,6102,232231560,19864
429,a1709,20170823,3815,3805,3808,3844,3802,3820,3823,15,18,7692,294137160,19936
430,a1709,20170824,3820,3823,3840,3840,3796,3809,3809,-14,-14,4444,169292060,18388
431,a1709,20170825,3809,3809,3812,3817,3802,3809,3807,0,-2,3310,126028320,17418
432,a1709,20170828,3809,3807,3812,3838,3798,3807,3818,0,11,5592,213538440,16850
433,a1709,20170829,3807,3818,3811,3815,3773,3788,3801,-30,-17,6106,232116100,16314
434,a1709,20170830,3788,3801,3788,3795,3765,3769,3782,-32,-19,8078,305553220,16000
435,a1709,20170831,3769,3782,3773,3792,3740,3746,3770,-36,-12,3922,147867380,15366
436,a1709,20170901,3746,3770,3745,3760,3745,3748,3748,-22,-22,190,7122060,44
437,a1709,20170904,3748,3748,0,0,0,3748,3748,0,0,0,0,44
438,a1709,20170905,3748,3748,0,0,0,3748,3748,0,0,0,0,12
439,a1709,20170906,3748,3748,3738,3738,3738,3738,3738,-10,-10,8,299040,12
440,a1709,20170907,3738,3738,0,0,0,3738,3738,0,0,0,0,4
441,a1709,20170908,3738,3738,0,0,0,3738,3738,0,0,0,0,4
442,a1709,20170911,3738,3738,0,0,0,3738,3738,0,0,0,0,0
443,a1709,20170912,3738,3738,0,0,0,3738,3738,0,0,0,0,0
444,a1709,20170913,3738,3738,0,0,0,3738,3738,0,0,0,0,0
445,a1709,20170914,3738,3738,0,0,0,3748,3748,10,10,0,0,0
446,a1711,20170103,4149,4149,0,0,0,4149,4149,0,0,0,0,4
447,a1711,20170104,4149,4149,0,0,0,4149,4149,0,0,0,0,4
448,a1711,20170105,4149,4149,0,0,0,4149,4149,0,0,0,0,4
449,a1711,20170106,4149,4149,0,0,0,4149,4149,0,0,0,0,4
450,a1711,20170109,4149,4149,0,0,0,4149,4149,0,0,0,0,4
451,a1711,20170110,4149,4149,0,0,0,4149,4149,0,0,0,0,4
452,a1711,20170111,4149,4149,0,0,0,4149,4149,0,0,0,0,4
453,a1711,20170112,4149,4149,0,0,0,4149,4149,0,0,0,0,4
454,a1711,20170113,4149,4149,0,0,0,4149,4149,0,0,0,0,4
455,a1711,20170116,4149,4149,0,0,0,4149,4149,0,0,0,0,4
456,a1711,20170117,4149,4149,0,0,0,4149,4149,0,0,0,0,4
457,a1711,20170118,4149,4149,0,0,0,4149,4149,0,0,0,0,4
458,a1711,20170119,4149,4149,0,0,0,4149,4149,0,0,0,0,4
459,a1711,20170120,4149,4149,0,0,0,4149,4149,0,0,0,0,4
460,a1711,20170123,4149,4149,0,0,0,4149,4149,0,0,0,0,4
461,a1711,20170124,4149,4149,0,0,0,4149,4149,0,0,0,0,4
462,a1711,20170125,4149,4149,4200,4200,4200,4200,4200,51,51,2,84000,4
463,a1711,20170126,4200,4200,0,0,0,4225,4225,25,25,0,0,4
464,a1711,20170203,4225,4225,0,0,0,4225,4225,0,0,0,0,4
465,a1711,20170206,4225,4225,4263,4263,4263,4263,4263,38,38,2,85260,4
466,a1711,20170207,4263,4263,0,0,0,4263,4263,0,0,0,0,4
467,a1711,20170208,4263,4263,0,0,0,4263,4263,0,0,0,0,4
468,a1711,20170209,4263,4263,0,0,0,4258,4258,-5,-5,0,0,4
469,a1711,20170210,4258,4258,0,0,0,4258,4258,0,0,0,0,4
470,a1711,20170213,4258,4258,0,0,0,4258,4258,0,0,0,0,4
471,a1711,20170214,4258,4258,4291,4388,4291,4331,4336,73,78,6,260200,6
472,a1711,20170215,4331,4336,4256,4256,4238,4238,4247,-98,-89,4,169880,4
473,a1711,20170216,4238,4247,0,0,0,4247,4247,0,0,0,0,4
474,a1711,20170217,4247,4247,4146,4215,4146,4215,4180,-32,-67,4,167220,6
475,a1711,20170220,4215,4180,4198,4198,4198,4198,4198,18,18,2,83960,4
476,a1711,20170221,4198,4198,0,0,0,4198,4198,0,0,0,0,4
477,a1711,20170222,4198,4198,4183,4183,4183,4183,4183,-15,-15,2,83660,4
478,a1711,20170223,4183,4183,0,0,0,4183,4183,0,0,0,0,4
479,a1711,20170224,4183,4183,0,0,0,4183,4183,0,0,0,0,4
480,a1711,20170227,4183,4183,0,0,0,4183,4183,0,0,0,0,4
481,a1711,20170228,4183,4183,0,0,0,4152,4152,-31,-31,0,0,4
482,a1711,20170301,4152,4152,0,0,0,4152,4152,0,0,0,0,4
483,a1711,20170302,4152,4152,4091,4134,4091,4134,4112,-18,-40,4,164500,4
484,a1711,20170303,4134,4112,0,0,0,4112,4112,0,0,0,0,4
485,a1711,20170306,4112,4112,0,0,0,4107,4107,-5,-5,0,0,4
486,a1711,20170307,4107,4107,4040,4040,4016,4038,4033,-69,-74,16,645360,16
487,a1711,20170308,4038,4033,4001,4040,4001,4009,4025,-24,-8,10,402520,16
488,a1711,20170309,4009,4025,4020,4020,4001,4007,4013,-18,-12,12,481640,14
489,a1711,20170310,4007,4013,0,0,0,3934,3934,-79,-79,0,0,14
490,a1711,20170313,3934,3934,3888,3888,3888,3888,3888,-46,-46,2,77760,12
491,a1711,20170314,3888,3888,3971,3976,3879,3897,3914,9,26,18,704540,16
492,a1711,20170315,3897,3914,0,0,0,3914,3914,0,0,0,0,16
493,a1711,20170316,3914,3914,3904,3904,3904,3904,3904,-10,-10,2,78080,18
494,a1711,20170317,3904,3904,3901,3901,3901,3901,3901,-3,-3,2,78020,20
495,a1711,20170320,3901,3901,3948,3949,3948,3949,3948,48,47,6,236900,18
496,a1711,20170321,3949,3948,0,0,0,3948,3948,0,0,0,0,18
497,a1711,20170322,3948,3948,3900,3900,3900,3900,3900,-48,-48,2,78000,18
498,a1711,20170323,3900,3900,3896,3896,3896,3896,3896,-4,-4,8,311680,10
499,a1711,20170324,3896,3896,3909,3909,3909,3909,3909,13,13,2,78180,12
500,a1711,20170327,3909,3909,0,0,0,3841,3841,-68,-68,0,0,12
501,a1711,20170328,3841,3841,0,0,0,3841,3841,0,0,0,0,12
502,a1711,20170329,3841,3841,3799,3799,3799,3799,3799,-42,-42,36,1367640,44
503,a1711,20170330,3799,3799,3845,3845,3843,3843,3844,44,45,38,1461060,44
504,a1711,20170331,3843,3844,3841,3841,3841,3841,3841,-3,-3,10,384100,34
505,a1711,20170405,3841,3841,0,0,0,3841,3841,0,0,0,0,34
506,a1711,20170406,3841,3841,3860,3869,3842,3869,3856,28,15,10,385660,38
507,a1711,20170407,3869,3856,3834,3834,3821,3821,3827,-35,-29,10,382780,32
508,a1711,20170410,3821,3827,3860,3860,3860,3860,3860,33,33,6,231600,26
509,a1711,20170411,3860,3860,3902,3904,3894,3894,3900,34,40,10,390040,26
510,a1711,20170412,3894,3900,3901,3920,3880,3880,3900,-20,0,6,234020,22
511,a1711,20170413,3880,3900,3890,3890,3890,3890,3890,-10,-10,2,77800,22
512,a1711,20170414,3890,3890,3902,3902,3902,3902,3902,12,12,2,78040,20
513,a1711,20170417,3902,3902,3891,3975,3876,3876,3908,-26,6,10,390840,18
514,a1711,20170418,3876,3908,0,0,0,3818,3818,-90,-90,0,0,18
515,a1711,20170419,3818,3818,0,0,0,3818,3818,0,0,0,0,18
516,a1711,20170420,3818,3818,0,0,0,3818,3818,0,0,0,0,18
517,a1711,20170421,3818,3818,3804,3804,3800,3800,3800,-18,-18,10,380080,26
518,a1711,20170424,3800,3800,3813,3813,3795,3796,3804,-4,4,8,304320,22
519,a1711,20170425,3796,3804,3770,3770,3770,3770,3770,-34,-34,4,150800,26
520,a1711,20170426,3770,3770,0,0,0,3770,3770,0,0,0,0,26
521,a1711,20170427,3770,3770,3779,3779,3779,3779,3779,9,9,2,75580,24
522,a1711,20170428,3779,3779,0,0,0,3779,3779,0,0,0,0,24
523,a1711,20170502,3779,3779,3868,3868,3860,3860,3861,81,82,14,540560,12
524,a1711,20170503,3860,3861,0,0,0,3861,3861,0,0,0,0,12
525,a1711,20170504,3861,3861,0,0,0,3855,3855,-6,-6,0,0,12
526,a1711,20170505,3855,3855,3841,3841,3841,3841,3841,-14,-14,2,76820,10
527,a1711,20170508,3841,3841,0,0,0,3841,3841,0,0,0,0,10
528,a1711,20170509,3841,3841,0,0,0,3841,3841,0,0,0,0,10
529,a1711,20170510,3841,3841,0,0,0,3841,3841,0,0,0,0,10
530,a1711,20170511,3841,3841,0,0,0,3840,3840,-1,-1,0,0,10
531,a1711,20170512,3840,3840,3807,3807,3807,3807,3807,-33,-33,2,76140,10
532,a1711,20170515,3807,3807,0,0,0,3807,3807,0,0,0,0,10
533,a1711,20170516,3807,3807,3833,3833,3752,3774,3773,-33,-34,12,452820,12
534,a1711,20170517,3774,3773,0,0,0,3773,3773,0,0,0,0,12
535,a1711,20170518,3773,3773,0,0,0,3773,3773,0,0,0,0,12
536,a1711,20170519,3773,3773,0,0,0,3773,3773,0,0,0,0,12
537,a1711,20170522,3773,3773,3791,3887,3791,3887,3850,114,77,8,308060,10
538,a1711,20170523,3887,3850,3860,3860,3860,3860,3860,10,10,2,77200,12
539,a1711,20170524,3860,3860,3930,3930,3888,3888,3909,28,49,4,156360,12
540,a1711,20170525,3888,3909,0,0,0,3909,3909,0,0,0,0,12
541,a1711,20170526,3909,3909,0,0,0,3909,3909,0,0,0,0,12
542,a1711,20170531,3909,3909,0,0,0,3824,3824,-85,-85,0,0,12
543,a1711,20170601,3824,3824,0,0,0,3824,3824,0,0,0,0,12
544,a1711,20170602,3824,3824,3822,3822,3797,3797,3809,-27,-15,4,152380,12
545,a1711,20170605,3797,3809,3874,3874,3864,3864,3869,55,60,4,154760,12
546,a1711,20170606,3864,3869,3842,3842,3842,3842,3842,-27,-27,2,76840,10
547,a1711,20170607,3842,3842,3874,3874,3874,3874,3874,32,32,2,77480,10
548,a1711,20170608,3874,3874,0,0,0,3874,3874,0,0,0,0,10
549,a1711,20170609,3874,3874,3929,4035,3929,3929,3966,55,92,8,317300,8
550,a1711,20170612,3929,3966,3997,3997,3997,3997,3997,31,31,2,79940,8
551,a1711,20170613,3997,3997,0,0,0,3997,3997,0,0,0,0,8
552,a1711,20170614,3997,3997,0,0,0,3997,3997,0,0,0,0,8
553,a1711,20170615,3997,3997,0,0,0,3997,3997,0,0,0,0,8
554,a1711,20170616,3997,3997,3970,4016,3947,3947,3985,-50,-12,38,1514440,14
555,a1711,20170619,3947,3985,3964,3964,3964,3964,3964,-21,-21,2,79280,14
556,a1711,20170620,3964,3964,0,0,0,3964,3964,0,0,0,0,14
557,a1711,20170621,3964,3964,0,0,0,3950,3950,-14,-14,0,0,14
558,a1711,20170622,3950,3950,3891,3891,3891,3891,3891,-59,-59,2,77820,12
559,a1711,20170623,3891,3891,0,0,0,3891,3891,0,0,0,0,12
560,a1711,20170626,3891,3891,0,0,0,3891,3891,0,0,0,0,12
561,a1711,20170627,3891,3891,0,0,0,3891,3891,0,0,0,0,12
562,a1711,20170628,3891,3891,0,0,0,3891,3891,0,0,0,0,12
563,a1711,20170629,3891,3891,3909,3909,3856,3890,3885,-1,-6,6,233100,10
564,a1711,20170630,3890,3885,3911,3911,3911,3911,3911,26,26,2,78220,8
565,a1711,20170703,3911,3911,0,0,0,3918,3918,7,7,0,0,8
566,a1711,20170704,3918,3918,3946,3946,3917,3917,3931,-1,13,4,157260,8
567,a1711,20170705,3917,3931,0,0,0,3931,3931,0,0,0,0,8
568,a1711,20170706,3931,3931,0,0,0,3931,3931,0,0,0,0,8
569,a1711,20170707,3931,3931,0,0,0,3931,3931,0,0,0,0,8
570,a1711,20170710,3931,3931,0,0,0,3931,3931,0,0,0,0,8
571,a1711,20170711,3931,3931,3922,3922,3922,3922,3922,-9,-9,2,78440,6
572,a1711,20170712,3922,3922,3920,3953,3919,3953,3929,31,7,8,314340,4
573,a1711,20170713,3953,3929,0,0,0,3929,3929,0,0,0,0,4
574,a1711,20170714,3929,3929,3865,3865,3865,3865,3865,-64,-64,2,77300,4
575,a1711,20170717,3865,3865,0,0,0,3865,3865,0,0,0,0,4
576,a1711,20170718,3865,3865,0,0,0,3865,3865,0,0,0,0,4
577,a1711,20170719,3865,3865,3845,3845,3845,3845,3845,-20,-20,2,76900,6
578,a1711,20170720,3845,3845,0,0,0,3845,3845,0,0,0,0,6
579,a1711,20170721,3845,3845,0,0,0,3845,3845,0,0,0,0,6
580,a1711,20170724,3845,3845,0,0,0,3845,3845,0,0,0,0,6
581,a1711,20170725,3845,3845,0,0,0,3845,3845,0,0,0,0,6
582,a1711,20170726,3845,3845,0,0,0,3845,3845,0,0,0,0,6
583,a1711,20170727,3845,3845,0,0,0,3845,3845,0,0,0,0,6
584,a1711,20170728,3845,3845,3862,3862,3815,3815,3838,-30,-7,4,153540,6
585,a1711,20170731,3815,3838,0,0,0,3838,3838,0,0,0,0,6
586,a1711,20170801,3838,3838,3854,3854,3850,3850,3853,12,15,12,462400,14
587,a1711,20170802,3850,3853,3843,3843,3778,3778,3810,-75,-43,16,609680,14
588,a1711,20170803,3778,3810,3827,3827,3799,3799,3822,-11,12,12,458680,16
589,a1711,20170804,3799,3822,3831,3832,3790,3790,3817,-32,-5,6,229060,16
590,a1711,20170807,3790,3817,3921,3921,3921,3921,3921,104,104,2,78420,14
591,a1711,20170808,3921,3921,3884,3922,3883,3914,3905,-7,-16,30,1171620,6
592,a1711,20170809,3914,3905,3915,3915,3915,3915,3915,10,10,2,78300,6
593,a1711,20170810,3915,3915,3935,3948,3928,3928,3935,13,20,20,787020,12
594,a1711,20170811,3928,3935,3923,3923,3923,3923,3923,-12,-12,2,78460,10
595,a1711,20170814,3923,3923,3843,3852,3838,3840,3843,-83,-80,14,538100,6
596,a1711,20170815,3840,3843,3859,3859,3859,3859,3859,16,16,2,77180,4
597,a1711,20170816,3859,3859,0,0,0,3859,3859,0,0,0,0,4
598,a1711,20170817,3859,3859,3877,3877,3877,3877,3877,18,18,2,77540,4
599,a1711,20170818,3877,3877,0,0,0,3877,3877,0,0,0,0,4
600,a1711,20170821,3877,3877,0,0,0,3877,3877,0,0,0,0,4
601,a1711,20170822,3877,3877,0,0,0,3877,3877,0,0,0,0,4
602,a1711,20170823,3877,3877,0,0,0,3877,3877,0,0,0,0,4
603,a1711,20170824,3877,3877,0,0,0,3877,3877,0,0,0,0,4
604,a1711,20170825,3877,3877,0,0,0,3877,3877,0,0,0,0,4
605,a1711,20170828,3877,3877,0,0,0,3877,3877,0,0,0,0,4
606,a1711,20170829,3877,3877,0,0,0,3877,3877,0,0,0,0,4
607,a1711,20170830,3877,3877,0,0,0,3858,3858,-19,-19,0,0,4
608,a1711,20170831,3858,3858,0,0,0,3858,3858,0,0,0,0,4
609,a1711,20170901,3858,3858,3833,3852,3822,3822,3846,-36,-12,200,7693300,164
610,a1711,20170904,3822,3846,3819,3842,3816,3842,3822,-4,-24,12,458680,164
611,a1711,20170905,3842,3822,3816,3826,3816,3826,3824,4,2,14,535380,164
612,a1711,20170906,3826,3824,3825,3826,3825,3826,3825,2,1,14,535540,164
613,a1711,20170907,3826,3825,3810,3810,3799,3800,3805,-25,-20,18,684960,166
614,a1711,20170908,3800,3805,3815,3815,3805,3805,3805,0,0,86,3272500,84
615,a1711,20170911,3805,3805,3780,3780,3780,3780,3780,-25,-25,2,75600,86
616,a1711,20170912,3780,3780,0,0,0,3780,3780,0,0,0,0,86
617,a1711,20170913,3780,3780,3765,3800,3765,3800,3782,20,2,4,151300,86
618,a1711,20170914,3800,3782,3761,3762,3743,3748,3754,-34,-28,14,525600,86
619,a1711,20170915,3748,3754,0,0,0,3754,3754,0,0,0,0,86
620,a1711,20170918,3754,3754,3709,3711,3709,3711,3710,-43,-44,4,148400,86
621,a1711,20170919,3711,3710,3756,3779,3749,3750,3758,40,48,14,526240,84
622,a1711,20170920,3750,3758,0,0,0,3747,3747,-11,-11,0,0,84
623,a1711,20170921,3747,3747,3788,3788,3688,3704,3733,-43,-14,74,2762500,96
624,a1711,20170922,3704,3733,0,0,0,3733,3733,0,0,0,0,96
625,a1711,20170925,3733,3733,3689,3774,3689,3718,3726,-15,-7,12,447120,94
626,a1711,20170926,3718,3726,3755,3755,3721,3721,3749,-5,23,12,449900,96
627,a1711,20170927,3721,3749,0,0,0,3749,3749,0,0,0,0,96
628,a1711,20170928,3749,3749,3764,3764,3764,3764,3764,15,15,2,75280,96
629,a1711,20170929,3764,3764,3625,3780,3625,3745,3718,-19,-46,28,1041300,90
630,a1711,20171009,3745,3718,0,0,0,3718,3718,0,0,0,0,90
631,a1711,20171010,3718,3718,0,0,0,3718,3718,0,0,0,0,90
632,a1711,20171011,3718,3718,3731,3731,3731,3731,3731,13,13,2,74620,88
633,a1711,20171012,3731,3731,0,0,0,3731,3731,0,0,0,0,88
634,a1711,20171013,3731,3731,3677,3763,3677,3763,3720,32,-11,16,595320,88
635,a1711,20171016,3763,3720,0,0,0,3720,3720,0,0,0,0,88
636,a1711,20171017,3720,3720,3646,3650,3646,3650,3646,-70,-74,14,510520,86
637,a1711,20171018,3650,3646,0,0,0,3646,3646,0,0,0,0,86
638,a1711,20171019,3646,3646,0,0,0,3646,3646,0,0,0,0,86
639,a1711,20171020,3646,3646,0,0,0,3646,3646,0,0,0,0,86
640,a1711,20171023,3646,3646,3560,3630,3560,3565,3596,-81,-50,12,431540,90
641,a1711,20171024,3565,3596,0,0,0,3596,3596,0,0,0,0,90
642,a1711,20171025,3596,3596,0,0,0,3596,3596,0,0,0,0,90
643,a1711,20171026,3596,3596,3620,3650,3545,3580,3585,-16,-11,38,1362400,98
644,a1711,20171027,3580,3585,3520,3520,3520,3520,3520,-65,-65,2,70400,98
645,a1711,20171030,3520,3520,3510,3528,3506,3528,3514,8,-6,12,421760,98
646,a1711,20171031,3528,3514,3508,3540,3508,3540,3511,26,-3,20,702320,82
647,a1711,20171101,3540,3511,0,0,0,3511,3511,0,0,0,0,0
648,a1711,20171102,3511,3511,0,0,0,3511,3511,0,0,0,0,0
649,a1711,20171103,3511,3511,0,0,0,3511,3511,0,0,0,0,0
650,a1711,20171106,3511,3511,0,0,0,3511,3511,0,0,0,0,0
651,a1711,20171107,3511,3511,0,0,0,3511,3511,0,0,0,0,0
652,a1711,20171108,3511,3511,0,0,0,3511,3511,0,0,0,0,0
653,a1711,20171109,3511,3511,0,0,0,3511,3511,0,0,0,0,0
654,a1711,20171110,3511,3511,0,0,0,3511,3511,0,0,0,0,0
655,a1711,20171113,3511,3511,0,0,0,3511,3511,0,0,0,0,0
656,a1711,20171114,3511,3511,0,0,0,3511,3511,0,0,0,0,0
657,a1801,20170103,4140,4149,4114,4160,4075,4085,4119,-64,-30,3170,130603360,11342
658,a1801,20170104,4085,4119,4093,4142,4071,4136,4106,17,-13,3340,137168840,12382
659,a1801,20170105,4136,4106,4132,4148,4109,4111,4124,5,18,2988,123242380,12566
660,a1801,20170106,4111,4124,4111,4167,4109,4126,4133,2,9,1988,82176500,12500
661,a1801,20170109,4126,4133,4129,4146,4071,4079,4106,-54,-27,2100,86242580,12482
662,a1801,20170110,4079,4106,4091,4099,4040,4049,4070,-57,-36,2868,116730340,13028
663,a1801,20170111,4049,4070,4058,4090,4043,4061,4063,-9,-7,2174,88342440,13110
664,a1801,20170112,4061,4063,4067,4085,4032,4032,4055,-31,-8,1744,70719720,13490
665,a1801,20170113,4032,4055,4032,4103,4030,4080,4069,25,14,1196,48674860,13644
666,a1801,20170116,4080,4069,4061,4143,4061,4134,4113,65,44,948,38997940,13582
667,a1801,20170117,4134,4113,4137,4170,4116,4133,4143,20,30,1704,70605760,14038
668,a1801,20170118,4133,4143,4138,4171,4124,4159,4150,16,7,2964,123009600,14474
669,a1801,20170119,4159,4150,4169,4196,4140,4177,4170,27,20,6648,277225640,15308
670,a1801,20170120,4177,4170,4177,4186,4131,4133,4156,-37,-14,5332,221607740,15300
671,a1801,20170123,4133,4156,4132,4152,4090,4111,4110,-45,-46,1750,71934940,15022
672,a1801,20170124,4111,4110,4111,4150,4103,4129,4123,19,13,1076,44368680,14952
673,a1801,20170125,4129,4123,4121,4128,4093,4100,4106,-23,-17,818,33590220,14900
674,a1801,20170126,4100,4106,4100,4148,4100,4126,4122,20,16,2804,115596280,14840
675,a1801,20170203,4126,4122,4102,4187,4102,4182,4169,60,47,2474,103146460,15304
676,a1801,20170206,4182,4169,4188,4224,4165,4220,4197,51,28,3534,148344160,16392
677,a1801,20170207,4220,4197,4220,4237,4202,4220,4215,23,18,6170,260111260,17014
678,a1801,20170208,4220,4215,4218,4255,4202,4229,4230,14,15,5312,224716500,16996
679,a1801,20170209,4229,4230,4229,4248,4208,4215,4233,-15,3,3572,151208840,17298
680,a1801,20170210,4215,4233,4222,4238,4203,4230,4220,-3,-13,2936,123914860,17286
681,a1801,20170213,4230,4220,4236,4278,4222,4228,4241,8,21,2314,98141180,17442
682,a1801,20170214,4228,4241,4240,4300,4239,4245,4263,4,22,5736,244536680,18796
683,a1801,20170215,4245,4263,4256,4264,4186,4208,4218,-55,-45,12574,530432180,19262
684,a1801,20170216,4208,4218,4206,4248,4205,4212,4231,-6,13,3232,136771540,19096
685,a1801,20170217,4212,4231,4212,4247,4178,4189,4204,-42,-27,6696,281517140,18924
686,a1801,20170220,4189,4204,4189,4197,4161,4179,4173,-25,-31,3180,132728420,19166
687,a1801,20170221,4179,4173,4178,4210,4171,4193,4186,20,13,4450,186295560,19470
688,a1801,20170222,4193,4186,4192,4203,4150,4155,4172,-31,-14,1890,78863080,19716
689,a1801,20170223,4155,4172,4151,4180,4136,4141,4164,-31,-8,4488,186884160,20062
690,a1801,20170224,4141,4164,4148,4153,4083,4119,4106,-45,-58,6810,279623560,20928
691,a1801,20170227,4119,4106,4124,4135,4086,4104,4109,-2,3,2210,90828280,21204
692,a1801,20170228,4104,4109,4110,4142,4095,4110,4125,1,16,1556,64188720,21134
693,a1801,20170301,4110,4125,4117,4156,4117,4129,4133,4,8,2440,100865300,21306
694,a1801,20170302,4129,4133,4133,4135,4110,4118,4119,-15,-14,1962,80834380,22046
695,a1801,20170303,4118,4119,4112,4112,4030,4040,4055,-79,-64,4032,163518160,23582
696,a1801,20170306,4040,4055,4043,4053,4031,4034,4039,-21,-16,5126,207054300,24432
697,a1801,20170307,4034,4039,4030,4050,3995,4005,4018,-34,-21,4818,193596460,25980
698,a1801,20170308,4005,4018,3999,4023,3990,4018,4008,0,-10,3202,128368140,26122
699,a1801,20170309,4018,4008,4019,4030,3981,4000,4008,-8,0,3574,143259820,26040
700,a1801,20170310,4000,4008,3998,4009,3906,3907,3943,-101,-65,6528,257462460,25610
701,a1801,20170313,3907,3943,3910,3941,3910,3924,3923,-19,-20,3576,140292120,25588
702,a1801,20170314,3924,3923,3922,3932,3888,3896,3908,-27,-15,3836,149934540,25608
703,a1801,20170315,3896,3908,3898,3917,3876,3901,3897,-7,-11,2808,109448080,26026
704,a1801,20170316,3901,3897,3905,3914,3883,3889,3897,-8,0,3528,137500900,26712
705,a1801,20170317,3889,3897,3861,3907,3861,3895,3897,-2,0,2720,106010640,27038
706,a1801,20170320,3895,3897,3897,3923,3891,3917,3909,20,12,2826,110484360,27460
707,a1801,20170321,3917,3909,3915,3931,3890,3903,3903,-6,-6,2516,98215600,27240
708,a1801,20170322,3903,3903,3903,3950,3894,3918,3923,15,20,5158,202386240,27286
709,a1801,20170323,3918,3923,3916,3939,3898,3911,3921,-12,-2,4760,186662800,28758
710,a1801,20170324,3911,3921,3900,3931,3900,3914,3916,-7,-5,2648,103705060,29314
711,a1801,20170327,3914,3916,3910,3921,3830,3856,3866,-60,-50,12720,491781600,27184
712,a1801,20170328,3856,3866,3859,3884,3840,3857,3858,-9,-8,6796,262232820,24564
713,a1801,20170329,3857,3858,3865,3880,3851,3868,3864,10,6,2876,111156060,24060
714,a1801,20170330,3868,3864,3864,3868,3830,3842,3844,-22,-20,9504,365421240,22612
715,a1801,20170331,3842,3844,3839,3877,3782,3839,3843,-5,-1,4580,176041580,22760
716,a1801,20170405,3839,3843,3821,3857,3796,3848,3830,5,-13,3260,124874720,22498
717,a1801,20170406,3848,3830,3859,3860,3807,3822,3835,-8,5,6004,230293540,20782
718,a1801,20170407,3822,3835,3821,3836,3792,3804,3809,-31,-26,5316,202490420,18560
719,a1801,20170410,3804,3809,3809,3913,3809,3891,3869,82,60,5402,209019660,19128
720,a1801,20170411,3891,3869,3888,3909,3864,3893,3891,24,22,3744,145688320,19026
721,a1801,20170412,3893,3891,3901,3930,3850,3874,3893,-17,2,4798,186821800,18718
722,a1801,20170413,3874,3893,3865,3915,3860,3897,3898,4,5,3104,121008020,19256
723,a1801,20170414,3897,3898,3905,3921,3882,3903,3900,5,2,4166,162487020,20636
724,a1801,20170417,3903,3900,3905,3945,3822,3823,3866,-77,-34,18300,707523360,13882
725,a1801,20170418,3823,3866,3828,3832,3757,3764,3791,-102,-75,9010,341606100,15406
726,a1801,20170419,3764,3791,3765,3796,3742,3791,3777,0,-14,6018,227320100,14740
727,a1801,20170420,3791,3777,3787,3814,3751,3795,3788,18,11,6644,251718740,15596
728,a1801,20170421,3795,3788,3795,3807,3773,3784,3791,-4,3,3992,151345740,15836
729,a1801,20170424,3784,3791,3791,3823,3761,3772,3783,-19,-8,9330,352995580,20138
730,a1801,20170425,3772,3783,3772,3779,3753,3765,3767,-18,-16,6248,235363760,21230
731,a1801,20170426,3765,3767,3767,3793,3749,3765,3767,-2,0,6260,235876200,22388
732,a1801,20170427,3765,3767,3767,3781,3760,3770,3768,3,1,4990,188070500,21662
733,a1801,20170428,3770,3768,3773,3802,3768,3789,3786,21,18,8130,307872700,23620
734,a1801,20170502,3789,3786,3811,3881,3804,3868,3849,82,63,9256,356346420,27168
735,a1801,20170503,3868,3849,3856,3869,3844,3857,3857,8,8,7274,280624020,27106
736,a1801,20170504,3857,3857,3847,3872,3831,3844,3852,-13,-5,6470,249239980,26482
737,a1801,20170505,3844,3852,3860,3871,3836,3845,3851,-7,-1,5112,196907840,26078
738,a1801,20170508,3845,3851,3863,3901,3835,3863,3865,12,14,9834,380125580,26402
739,a1801,20170509,3863,3865,3870,3877,3838,3862,3856,-3,-9,7132,275052080,27322
740,a1801,20170510,3862,3856,3850,3883,3850,3870,3867,14,11,5436,210232460,28342
741,a1801,20170511,3870,3867,3875,3885,3800,3832,3830,-35,-37,15084,577719800,28742
742,a1801,20170512,3832,3830,3811,3837,3804,3810,3817,-20,-13,8562,326850020,29412
743,a1801,20170515,3810,3817,3810,3826,3795,3805,3809,-12,-8,6192,235909060,29098
744,a1801,20170516,3805,3809,3810,3820,3786,3798,3800,-11,-9,5112,194283820,29336
745,a1801,20170517,3798,3800,3800,3842,3794,3837,3820,37,20,9150,349546260,28232
746,a1801,20170518,3837,3820,3837,3851,3789,3803,3817,-17,-3,11888,453867040,27818
747,a1801,20170519,3803,3817,3785,3801,3766,3789,3780,-28,-37,14284,540020900,30468
748,a1801,20170522,3789,3780,3790,3859,3788,3834,3828,54,48,21298,815384280,33158
749,a1801,20170523,3834,3828,3834,3850,3819,3840,3837,12,9,9964,382373420,33186
750,a1801,20170524,3840,3837,3840,3894,3825,3878,3862,41,25,17668,682408520,33190
751,a1801,20170525,3878,3862,3878,3886,3840,3851,3863,-11,1,12604,487001480,33014
752,a1801,20170526,3851,3863,3852,3872,3820,3837,3843,-26,-20,12582,483628300,31908
753,a1801,20170531,3837,3843,3826,3826,3737,3750,3774,-93,-69,18154,685163820,29060
754,a1801,20170601,3750,3774,3744,3769,3742,3759,3753,-15,-21,7152,268480100,29036
755,a1801,20170602,3759,3753,3762,3790,3754,3772,3775,19,22,8706,328707800,29096
756,a1801,20170605,3772,3775,3774,3836,3769,3823,3816,48,41,14758,563198800,28684
757,a1801,20170606,3823,3816,3820,3846,3810,3830,3827,14,11,8730,334148220,29536
758,a1801,20170607,3830,3827,3829,3847,3815,3838,3831,11,4,9930,380435340,28654
759,a1801,20170608,3838,3831,3845,3849,3826,3839,3836,8,5,6814,261386700,29584
760,a1801,20170609,3839,3836,3841,3930,3839,3902,3895,66,59,33430,1302258100,40160
761,a1801,20170612,3902,3895,3905,3949,3886,3929,3915,34,20,26772,1048183100,48356
762,a1801,20170613,3929,3915,3919,3933,3900,3924,3916,9,1,20628,807985940,50036
763,a1801,20170614,3924,3916,3925,3936,3894,3907,3910,-9,-6,20466,800414980,54792
764,a1801,20170615,3907,3910,3901,3937,3891,3921,3916,11,6,20630,807990380,57618
765,a1801,20170616,3921,3916,3906,3965,3900,3905,3924,-11,8,41582,1631682560,54578
766,a1801,20170619,3905,3924,3909,3932,3893,3896,3907,-28,-17,26482,1034714100,52586
767,a1801,20170620,3896,3907,3899,3913,3876,3897,3894,-10,-13,24312,946784260,54358
768,a1801,20170621,3897,3894,3894,3919,3847,3861,3876,-33,-18,26028,1009091660,50710
769,a1801,20170622,3861,3876,3860,3878,3842,3846,3860,-30,-16,15228,587932840,51154
770,a1801,20170623,3846,3860,3835,3858,3825,3838,3840,-22,-20,13166,505658760,53508
771,a1801,20170626,3838,3840,3850,3874,3831,3836,3853,-4,13,17330,667766960,56368
772,a1801,20170627,3836,3853,3836,3847,3818,3834,3835,-19,-18,14184,544063280,56090
773,a1801,20170628,3834,3835,3838,3860,3826,3841,3841,6,6,14136,543100360,58664
774,a1801,20170629,3841,3841,3841,3855,3831,3842,3842,1,1,19282,740839640,61744
775,a1801,20170630,3842,3842,3843,3864,3822,3838,3841,-4,-1,20304,779904680,62038
776,a1801,20170703,3838,3841,3840,3900,3836,3880,3875,39,34,26450,1024971480,63538
777,a1801,20170704,3880,3875,3883,3903,3846,3878,3879,3,4,24444,948262760,64272
778,a1801,20170705,3878,3879,3879,3887,3858,3866,3874,-13,-5,15186,588327080,65016
779,a1801,20170706,3866,3874,3866,3900,3835,3855,3865,-19,-9,46978,1815812400,66990
780,a1801,20170707,3855,3865,3859,3859,3816,3824,3837,-41,-28,25090,962711720,69402
781,a1801,20170710,3824,3837,3836,3900,3833,3886,3874,49,37,67598,2619174560,70850
782,a1801,20170711,3886,3874,3880,3924,3879,3893,3900,19,26,42156,1644217240,75920
783,a1801,20170712,3893,3900,3880,3939,3870,3912,3911,12,11,41760,1633500880,81920
784,a1801,20170713,3912,3911,3900,3922,3888,3897,3902,-14,-9,37616,1467880260,82368
785,a1801,20170714,3897,3902,3890,3891,3826,3837,3852,-65,-50,51654,1989793900,74322
786,a1801,20170717,3837,3852,3850,3869,3837,3844,3850,-8,-2,34900,1343974680,72634
787,a1801,20170718,3844,3850,3856,3869,3842,3857,3854,7,4,27806,1071836640,74398
788,a1801,20170719,3857,3854,3869,3877,3843,3850,3856,-4,2,28772,1109627060,76880
789,a1801,20170720,3850,3856,3859,3876,3845,3858,3860,2,4,39900,1540515140,82580
790,a1801,20170721,3858,3860,3865,3882,3852,3872,3868,12,8,59728,2310299840,86264
791,a1801,20170724,3872,3868,3868,3882,3811,3833,3840,-35,-28,66116,2539460640,89194
792,a1801,20170725,3833,3840,3835,3863,3820,3856,3844,16,4,38868,1494469500,93772
793,a1801,20170726,3856,3844,3850,3860,3821,3843,3840,-1,-4,57840,2221468200,101948
794,a1801,20170727,3843,3840,3840,3867,3832,3859,3854,19,14,44650,1721040980,109134
795,a1801,20170728,3859,3854,3870,3878,3842,3853,3861,-1,7,67662,2612494560,109782
796,a1801,20170731,3853,3861,3855,3874,3842,3866,3859,5,-2,64784,2500178080,111628
797,a1801,20170801,3866,3859,3865,3887,3833,3840,3858,-19,-1,109564,4227369180,124726
798,a1801,20170802,3840,3858,3830,3847,3805,3836,3823,-22,-35,90192,3448438000,126524
799,a1801,20170803,3836,3823,3840,3843,3813,3813,3826,-10,3,55870,2137996420,133910
800,a1801,20170804,3813,3826,3812,3829,3786,3825,3814,-1,-12,99990,3813782180,153662
801,a1801,20170807,3825,3814,3830,3936,3826,3925,3881,111,67,224516,8713800080,167038
802,a1801,20170808,3925,3881,3926,3990,3921,3951,3958,70,77,256984,10173750060,188460
803,a1801,20170809,3951,3958,3951,3997,3951,3982,3976,24,18,157330,6256385340,194150
804,a1801,20170810,3982,3976,3978,4015,3970,3995,3993,19,17,174878,6983428500,206944
805,a1801,20170811,3995,3993,3997,4017,3927,3954,3971,-39,-22,258036,10247598080,202010
806,a1801,20170814,3954,3971,3960,3965,3888,3898,3912,-73,-59,229696,8986660780,186226
807,a1801,20170815,3898,3912,3893,3915,3880,3890,3896,-22,-16,138022,5377582740,190458
808,a1801,20170816,3890,3896,3894,3897,3868,3881,3884,-15,-12,121690,4727197580,198722
809,a1801,20170817,3881,3884,3885,3913,3883,3906,3898,22,14,171204,6674005660,209488
810,a1801,20170818,3906,3898,3906,3920,3876,3898,3901,0,3,122000,4759747400,207444
811,a1801,20170821,3898,3901,3902,3945,3896,3913,3922,12,21,182162,7144461300,213880
812,a1801,20170822,3913,3922,3910,3935,3883,3925,3915,3,-7,167060,6540748040,216674
813,a1801,20170823,3925,3915,3919,3970,3911,3929,3937,14,22,213398,8403127300,224268
814,a1801,20170824,3929,3937,3930,3938,3901,3919,3916,-18,-21,166422,6518588060,215344
815,a1801,20170825,3919,3916,3922,3930,3910,3921,3919,5,3,126656,4964050020,204144
816,a1801,20170828,3921,3919,3925,3960,3912,3927,3936,8,17,181486,7144257420,206614
817,a1801,20170829,3927,3936,3931,3942,3895,3913,3916,-23,-20,154328,6044747220,201598
818,a1801,20170830,3913,3916,3908,3915,3888,3893,3902,-23,-14,93298,3641082540,208580
819,a1801,20170831,3893,3902,3898,3913,3872,3873,3890,-29,-12,146826,5711790820,213908
820,a1801,20170901,3873,3890,3868,3888,3846,3849,3867,-41,-23,170676,6600437400,219214
821,a1801,20170904,3849,3867,3855,3863,3836,3858,3850,-9,-17,155898,6002548720,226244
822,a1801,20170905,3858,3850,3856,3867,3845,3852,3853,2,3,111748,4306347420,232728
823,a1801,20170906,3852,3853,3857,3868,3826,3833,3851,-20,-2,172806,6655715300,253802
824,a1801,20170907,3833,3851,3833,3837,3815,3818,3825,-33,-26,183230,7008994740,294818
825,a1801,20170908,3818,3825,3829,3851,3819,3840,3833,15,8,185560,7113730420,273626
826,a1801,20170911,3840,3833,3845,3845,3780,3820,3808,-13,-25,209958,7995272980,279254
827,a1801,20170912,3820,3808,3820,3824,3796,3809,3813,1,5,117140,4466820860,278124
828,a1801,20170913,3809,3813,3809,3826,3797,3824,3812,11,-1,152498,5813494720,274412
829,a1801,20170914,3824,3812,3823,3846,3813,3821,3827,9,15,172352,6597158560,273674
830,a1801,20170915,3821,3827,3825,3834,3805,3814,3818,-13,-9,124146,4740871800,279566
831,a1801,20170918,3814,3818,3818,3827,3801,3813,3814,-5,-4,110776,4225624300,281250
832,a1801,20170919,3813,3814,3807,3825,3801,3810,3813,-4,-1,94122,3589655160,275602
833,a1801,20170920,3810,3813,3811,3813,3766,3805,3790,-8,-23,144346,5471465620,284774
834,a1801,20170921,3805,3790,3808,3811,3778,3790,3795,0,5,96056,3645631380,281734
835,a1801,20170922,3790,3795,3790,3830,3782,3828,3810,33,15,174910,6665207000,279628
836,a1801,20170925,3828,3810,3836,3836,3814,3825,3822,15,12,103168,3943542160,275064
837,a1801,20170926,3825,3822,3826,3841,3816,3826,3827,4,5,111156,4255022020,272124
838,a1801,20170927,3826,3827,3821,3846,3818,3839,3831,12,4,94966,3638615100,265508
839,a1801,20170928,3839,3831,3837,3858,3812,3829,3832,-2,1,136420,5228942040,238700
840,a1801,20170929,3829,3832,3827,3841,3819,3821,3828,-11,-4,95326,3649913380,226674
841,a1801,20171009,3821,3828,3835,3844,3790,3827,3806,-1,-22,137090,5218558880,239312
842,a1801,20171010,3827,3806,3828,3882,3818,3880,3852,74,46,269172,10371045520,271720
843,a1801,20171011,3880,3852,3878,3893,3846,3849,3870,-3,18,215640,8346327900,239278
844,a1801,20171012,3849,3870,3850,3853,3803,3808,3825,-62,-45,146904,5619722440,219920
845,a1801,20171013,3808,3825,3810,3843,3802,3820,3823,-5,-2,181998,6958334340,205330
846,a1801,20171016,3820,3823,3828,3832,3794,3806,3811,-17,-12,178030,6786124400,215864
847,a1801,20171017,3806,3811,3804,3808,3736,3748,3766,-63,-45,265242,9989077820,266292
848,a1801,20171018,3748,3766,3738,3750,3716,3729,3730,-37,-36,232254,8663455960,289494
849,a1801,20171019,3729,3730,3733,3734,3710,3713,3721,-17,-9,134406,5001676080,307562
850,a1801,20171020,3713,3721,3713,3735,3713,3724,3725,3,4,108040,4025123260,305118
851,a1801,20171023,3724,3725,3723,3733,3667,3682,3690,-43,-35,211022,7788703260,333504
852,a1801,20171024,3682,3690,3681,3687,3653,3656,3670,-34,-20,148630,5455183100,356610
853,a1801,20171025,3656,3670,3656,3670,3651,3663,3661,-7,-9,134368,4919683280,354550
854,a1801,20171026,3663,3661,3666,3669,3638,3642,3652,-19,-9,124556,4549908140,370674
855,a1801,20171027,3642,3652,3648,3649,3608,3626,3627,-26,-25,158774,5760166200,375812
856,a1801,20171030,3626,3627,3632,3647,3614,3625,3630,-2,3,126228,4582867680,376370
857,a1801,20171031,3625,3630,3627,3639,3616,3631,3627,1,-3,90154,3270392440,371904
858,a1801,20171101,3631,3627,3627,3645,3626,3630,3635,3,8,100174,3641942640,373514
859,a1801,20171102,3630,3635,3628,3643,3622,3638,3634,3,-1,108380,3938693100,372762
860,a1801,20171103,3638,3634,3633,3661,3633,3644,3643,10,9,105932,3859908760,371192
861,a1801,20171106,3644,3643,3646,3650,3614,3650,3630,7,-13,164640,5977391580,365268
862,a1801,20171107,3650,3630,3649,3680,3645,3668,3666,38,36,164620,6035313800,332680
863,a1801,20171108,3668,3666,3672,3672,3656,3665,3665,-1,-1,75816,2778707380,326986
864,a1801,20171109,3665,3665,3665,3695,3657,3683,3668,18,3,112254,4118338500,312016
865,a1801,20171110,3683,3668,3683,3689,3640,3664,3669,-4,1,130584,4792301180,304978
866,a1801,20171113,3664,3669,3666,3676,3657,3668,3669,-1,0,67626,2481515300,304106
867,a1801,20171114,3668,3669,3668,3676,3630,3634,3647,-35,-22,142026,5180080060,312700
868,a1801,20171115,3634,3647,3634,3642,3570,3616,3616,-31,-31,164162,5936122160,310516
869,a1801,20171116,3616,3616,3621,3633,3606,3624,3621,8,5,86038,3115753940,309964
870,a1801,20171117,3624,3621,3619,3625,3609,3625,3617,4,-4,62060,2245073760,308862
871,a1801,20171120,3625,3617,3620,3652,3617,3636,3635,19,18,121810,4427898760,302366
872,a1801,20171121,3636,3635,3630,3690,3629,3683,3662,48,27,173354,6348485120,277400
873,a1801,20171122,3683,3662,3680,3700,3677,3684,3686,22,24,120548,4443626560,261052
874,a1801,20171123,3684,3686,3692,3702,3660,3679,3682,-7,-4,107690,3966071880,254236
875,a1801,20171124,3679,3682,3683,3695,3671,3680,3683,-2,1,56612,2085578820,249562
876,a1801,20171127,3680,3683,3680,3685,3651,3667,3667,-16,-16,80700,2959899340,240220
877,a1801,20171128,3667,3667,3674,3677,3656,3666,3666,-1,-1,64328,2358613060,234064
878,a1801,20171129,3666,3666,3670,3670,3641,3641,3652,-25,-14,70032,2557843180,227592
879,a1801,20171130,3641,3652,3645,3648,3555,3560,3597,-92,-55,170114,6119850000,232708
880,a1801,20171201,3560,3597,3563,3589,3559,3572,3574,-25,-23,82022,2932190760,218936
881,a1801,20171204,3572,3574,3589,3602,3570,3600,3587,26,13,71306,2557920420,211364
882,a1801,20171205,3600,3587,3596,3604,3559,3575,3577,-12,-10,71660,2563960340,204700
883,a1801,20171206,3575,3577,3579,3598,3562,3573,3582,-4,5,80730,2892395080,199076
884,a1801,20171207,3573,3582,3575,3580,3446,3453,3497,-129,-85,175432,6135677500,182826
885,a1801,20171208,3453,3497,3450,3455,3410,3429,3436,-68,-61,83666,2875363040,170218
886,a1801,20171211,3429,3436,3434,3475,3429,3457,3455,21,19,81890,2829682780,152782
887,a1801,20171212,3457,3455,3453,3497,3448,3479,3470,24,15,68330,2371606300,129514
888,a1801,20171213,3479,3470,3480,3497,3466,3494,3480,24,10,41228,1435137100,119314
889,a1801,20171214,3494,3480,3496,3496,3467,3471,3477,-9,-3,14710,511524700,113498
890,a1801,20171215,3471,3477,3470,3479,3456,3463,3467,-14,-10,13966,484209900,109022
891,a1801,20171218,3463,3467,3466,3493,3453,3486,3471,19,4,24050,834974720,95642
892,a1801,20171219,3486,3471,3484,3486,3457,3468,3470,-3,-1,10224,354793680,90558
893,a1801,20171220,3468,3470,3467,3473,3454,3459,3464,-11,-6,13846,479760260,82780
894,a1801,20171221,3459,3464,3457,3460,3423,3425,3445,-39,-19,23610,813406440,69598
895,a1801,20171222,3425,3445,3427,3430,3273,3281,3331,-164,-114,47394,1579086140,55344
896,a1801,20171225,3281,3331,3284,3342,3270,3341,3310,10,-21,23976,793682340,47414
897,a1801,20171226,3341,3310,3337,3345,3279,3306,3301,-4,-9,19078,629937180,41492
898,a1801,20171227,3306,3301,3310,3310,3276,3280,3286,-21,-15,8874,291604060,38752
899,a1801,20171228,3280,3286,3278,3282,3126,3134,3180,-152,-106,33072,1051891180,30964
900,a1801,20171229,3134,3180,3129,3130,3021,3035,3051,-145,-129,42698,1303109920,26188
901,a1803,20170103,4217,4217,0,0,0,4217,4217,0,0,0,0,10
902,a1803,20170104,4217,4217,0,0,0,4217,4217,0,0,0,0,10
903,a1803,20170105,4217,4217,0,0,0,4217,4217,0,0,0,0,10
904,a1803,20170106,4217,4217,0,0,0,4217,4217,0,0,0,0,10
905,a1803,20170109,4217,4217,0,0,0,4217,4217,0,0,0,0,10
906,a1803,20170110,4217,4217,0,0,0,4217,4217,0,0,0,0,10
907,a1803,20170111,4217,4217,0,0,0,4210,4210,-7,-7,0,0,10
908,a1803,20170112,4210,4210,0,0,0,4202,4202,-8,-8,0,0,10
909,a1803,20170113,4202,4202,0,0,0,4216,4216,14,14,0,0,10
910,a1803,20170116,4216,4216,0,0,0,4216,4216,0,0,0,0,10
911,a1803,20170117,4216,4216,0,0,0,4216,4216,0,0,0,0,10
912,a1803,20170118,4216,4216,0,0,0,4216,4216,0,0,0,0,10
913,a1803,20170119,4216,4216,0,0,0,4216,4216,0,0,0,0,10
914,a1803,20170120,4216,4216,0,0,0,4216,4216,0,0,0,0,10
915,a1803,20170123,4216,4216,0,0,0,4216,4216,0,0,0,0,10
916,a1803,20170124,4216,4216,0,0,0,4216,4216,0,0,0,0,10
917,a1803,20170125,4216,4216,0,0,0,4216,4216,0,0,0,0,10
918,a1803,20170126,4216,4216,0,0,0,4232,4232,16,16,0,0,10
919,a1803,20170203,4232,4232,0,0,0,4232,4232,0,0,0,0,10
920,a1803,20170206,4232,4232,0,0,0,4232,4232,0,0,0,0,10
921,a1803,20170207,4232,4232,0,0,0,4232,4232,0,0,0,0,10
922,a1803,20170208,4232,4232,0,0,0,4232,4232,0,0,0,0,10
923,a1803,20170209,4232,4232,0,0,0,4235,4235,3,3,0,0,10
924,a1803,20170210,4235,4235,0,0,0,4235,4235,0,0,0,0,10
925,a1803,20170213,4235,4235,4272,4272,4272,4272,4272,37,37,2,85440,10
926,a1803,20170214,4272,4272,0,0,0,4272,4272,0,0,0,0,10
927,a1803,20170215,4272,4272,0,0,0,4272,4272,0,0,0,0,10
928,a1803,20170216,4272,4272,0,0,0,4272,4272,0,0,0,0,10
929,a1803,20170217,4272,4272,0,0,0,4272,4272,0,0,0,0,10
930,a1803,20170220,4272,4272,0,0,0,4272,4272,0,0,0,0,10
931,a1803,20170221,4272,4272,0,0,0,4272,4272,0,0,0,0,10
932,a1803,20170222,4272,4272,4164,4195,4164,4195,4179,-77,-93,4,167180,10
933,a1803,20170223,4195,4179,0,0,0,4179,4179,0,0,0,0,10
934,a1803,20170224,4179,4179,0,0,0,4121,4121,-58,-58,0,0,10
935,a1803,20170227,4121,4121,0,0,0,4121,4121,0,0,0,0,10
936,a1803,20170228,4121,4121,0,0,0,4121,4121,0,0,0,0,10
937,a1803,20170301,4121,4121,0,0,0,4121,4121,0,0,0,0,10
938,a1803,20170302,4121,4121,0,0,0,4121,4121,0,0,0,0,10
939,a1803,20170303,4121,4121,0,0,0,4121,4121,0,0,0,0,10
940,a1803,20170306,4121,4121,0,0,0,4121,4121,0,0,0,0,10
941,a1803,20170307,4121,4121,0,0,0,4050,4050,-71,-71,0,0,10
942,a1803,20170308,4050,4050,4039,4039,4039,4039,4039,-11,-11,2,80780,10
943,a1803,20170309,4039,4039,0,0,0,4039,4039,0,0,0,0,10
944,a1803,20170310,4039,4039,0,0,0,4039,4039,0,0,0,0,10
945,a1803,20170313,4039,4039,0,0,0,4019,4019,-20,-20,0,0,10
946,a1803,20170314,4019,4019,0,0,0,4004,4004,-15,-15,0,0,10
947,a1803,20170315,4004,4004,0,0,0,3993,3993,-11,-11,0,0,10
948,a1803,20170316,3993,3993,0,0,0,3993,3993,0,0,0,0,10
949,a1803,20170317,3993,3993,0,0,0,3993,3993,0,0,0,0,10
950,a1803,20170320,3993,3993,0,0,0,3993,3993,0,0,0,0,10
951,a1803,20170321,3993,3993,0,0,0,3993,3993,0,0,0,0,10
952,a1803,20170322,3993,3993,0,0,0,3993,3993,0,0,0,0,10
953,a1803,20170323,3993,3993,0,0,0,3991,3991,-2,-2,0,0,10
954,a1803,20170324,3991,3991,0,0,0,3991,3991,0,0,0,0,10
955,a1803,20170327,3991,3991,0,0,0,3941,3941,-50,-50,0,0,10
956,a1803,20170328,3941,3941,0,0,0,3933,3933,-8,-8,0,0,10
957,a1803,20170329,3933,3933,0,0,0,3933,3933,0,0,0,0,10
958,a1803,20170330,3933,3933,0,0,0,3913,3913,-20,-20,0,0,10
959,a1803,20170331,3913,3913,0,0,0,3912,3912,-1,-1,0,0,10
960,a1803,20170405,3912,3912,0,0,0,3899,3899,-13,-13,0,0,10
961,a1803,20170406,3899,3899,0,0,0,3904,3904,5,5,0,0,10
962,a1803,20170407,3904,3904,0,0,0,3878,3878,-26,-26,0,0,10
963,a1803,20170410,3878,3878,0,0,0,3939,3939,61,61,0,0,10
964,a1803,20170411,3939,3939,0,0,0,3961,3961,22,22,0,0,10
965,a1803,20170412,3961,3961,0,0,0,3963,3963,2,2,0,0,10
966,a1803,20170413,3963,3963,0,0,0,3963,3963,0,0,0,0,10
967,a1803,20170414,3963,3963,0,0,0,3963,3963,0,0,0,0,10
968,a1803,20170417,3963,3963,0,0,0,3963,3963,0,0,0,0,10
969,a1803,20170418,3963,3963,0,0,0,3887,3887,-76,-76,0,0,10
970,a1803,20170419,3887,3887,0,0,0,3873,3873,-14,-14,0,0,10
971,a1803,20170420,3873,3873,0,0,0,3873,3873,0,0,0,0,10
972,a1803,20170421,3873,3873,0,0,0,3873,3873,0,0,0,0,10
973,a1803,20170424,3873,3873,0,0,0,3865,3865,-8,-8,0,0,10
974,a1803,20170425,3865,3865,0,0,0,3865,3865,0,0,0,0,10
975,a1803,20170426,3865,3865,0,0,0,3865,3865,0,0,0,0,10
976,a1803,20170427,3865,3865,3779,3779,3779,3779,3779,-86,-86,2,75580,10
977,a1803,20170428,3779,3779,0,0,0,3797,3797,18,18,0,0,10
978,a1803,20170502,3797,3797,0,0,0,3860,3860,63,63,0,0,10
979,a1803,20170503,3860,3860,0,0,0,3868,3868,8,8,0,0,10
980,a1803,20170504,3868,3868,0,0,0,3868,3868,0,0,0,0,10
981,a1803,20170505,3868,3868,0,0,0,3868,3868,0,0,0,0,10
982,a1803,20170508,3868,3868,0,0,0,3868,3868,0,0,0,0,10
983,a1803,20170509,3868,3868,0,0,0,3859,3859,-9,-9,0,0,10
984,a1803,20170510,3859,3859,0,0,0,3870,3870,11,11,0,0,10
985,a1803,20170511,3870,3870,0,0,0,3870,3870,0,0,0,0,10
986,a1803,20170512,3870,3870,0,0,0,3857,3857,-13,-13,0,0,10
987,a1803,20170515,3857,3857,0,0,0,3857,3857,0,0,0,0,10
988,a1803,20170516,3857,3857,0,0,0,3857,3857,0,0,0,0,10
989,a1803,20170517,3857,3857,3879,3879,3879,3879,3879,22,22,20,775800,26
990,a1803,20170518,3879,3879,0,0,0,3876,3876,-3,-3,0,0,26
991,a1803,20170519,3876,3876,3788,3823,3785,3823,3791,-53,-85,32,1213380,10
992,a1803,20170522,3823,3791,3819,3849,3819,3849,3834,58,43,4,153360,10
993,a1803,20170523,3849,3834,0,0,0,3850,3850,16,16,0,0,10
994,a1803,20170524,3850,3850,0,0,0,3875,3875,25,25,0,0,10
995,a1803,20170525,3875,3875,3885,3925,3885,3925,3905,50,30,4,156200,12
996,a1803,20170526,3925,3905,0,0,0,3885,3885,-20,-20,0,0,12
997,a1803,20170531,3885,3885,0,0,0,3816,3816,-69,-69,0,0,12
998,a1803,20170601,3816,3816,3830,3830,3757,3757,3793,-59,-23,4,151740,12
999,a1803,20170602,3757,3793,0,0,0,3793,3793,0,0,0,0,12
1000,a1803,20170605,3793,3793,0,0,0,3834,3834,41,41,0,0,12
1001,a1803,20170606,3834,3834,0,0,0,3845,3845,11,11,0,0,12
1002,a1803,20170607,3845,3845,0,0,0,3849,3849,4,4,0,0,12
1003,a1803,20170608,3849,3849,3832,3832,3832,3832,3832,-17,-17,2,76640,10
1004,a1803,20170609,3832,3832,3906,3906,3906,3906,3906,74,74,2,78120,10
1005,a1803,20170612,3906,3906,0,0,0,3926,3926,20,20,0,0,10
1006,a1803,20170613,3926,3926,0,0,0,3927,3927,1,1,0,0,10
1007,a1803,20170614,3927,3927,0,0,0,3927,3927,0,0,0,0,10
1008,a1803,20170615,3927,3927,0,0,0,3933,3933,6,6,0,0,10
1009,a1803,20170616,3933,3933,0,0,0,3941,3941,8,8,0,0,10
1010,a1803,20170619,3941,3941,3937,3937,3937,3937,3937,-4,-4,4,157480,10
1011,a1803,20170620,3937,3937,0,0,0,3937,3937,0,0,0,0,10
1012,a1803,20170621,3937,3937,3917,3945,3916,3935,3928,-2,-9,8,314260,12
1013,a1803,20170622,3935,3928,0,0,0,3912,3912,-16,-16,0,0,12
1014,a1803,20170623,3912,3912,3879,3879,3879,3879,3879,-33,-33,2,77580,12
1015,a1803,20170626,3879,3879,0,0,0,3879,3879,0,0,0,0,12
1016,a1803,20170627,3879,3879,0,0,0,3879,3879,0,0,0,0,12
1017,a1803,20170628,3879,3879,0,0,0,3879,3879,0,0,0,0,12
1018,a1803,20170629,3879,3879,0,0,0,3879,3879,0,0,0,0,12
1019,a1803,20170630,3879,3879,0,0,0,3879,3879,0,0,0,0,12
1020,a1803,20170703,3879,3879,0,0,0,3910,3910,31,31,0,0,12
1021,a1803,20170704,3910,3910,3905,3905,3905,3905,3905,-5,-5,2,78100,12
1022,a1803,20170705,3905,3905,0,0,0,3905,3905,0,0,0,0,12
1023,a1803,20170706,3905,3905,0,0,0,3896,3896,-9,-9,0,0,12
1024,a1803,20170707,3896,3896,0,0,0,3868,3868,-28,-28,0,0,12
1025,a1803,20170710,3868,3868,0,0,0,3905,3905,37,37,0,0,12
1026,a1803,20170711,3905,3905,0,0,0,3905,3905,0,0,0,0,12
1027,a1803,20170712,3905,3905,0,0,0,3916,3916,11,11,0,0,12
1028,a1803,20170713,3916,3916,3954,3954,3908,3908,3933,-8,17,10,393360,12
1029,a1803,20170714,3908,3933,0,0,0,3883,3883,-50,-50,0,0,12
1030,a1803,20170717,3883,3883,0,0,0,3881,3881,-2,-2,0,0,12
1031,a1803,20170718,3881,3881,0,0,0,3881,3881,0,0,0,0,12
1032,a1803,20170719,3881,3881,0,0,0,3881,3881,0,0,0,0,12
1033,a1803,20170720,3881,3881,0,0,0,3881,3881,0,0,0,0,12
1034,a1803,20170721,3881,3881,0,0,0,3889,3889,8,8,0,0,12
1035,a1803,20170724,3889,3889,3927,3927,3850,3850,3904,-39,15,42,1640000,14
1036,a1803,20170725,3850,3904,0,0,0,3888,3888,-16,-16,0,0,14
1037,a1803,20170726,3888,3888,3869,3907,3849,3865,3870,-23,-18,46,1780260,28
1038,a1803,20170727,3865,3870,0,0,0,3870,3870,0,0,0,0,28
1039,a1803,20170728,3870,3870,3848,3848,3844,3844,3846,-26,-24,4,153840,28
1040,a1803,20170731,3844,3846,0,0,0,3846,3846,0,0,0,0,28
1041,a1803,20170801,3846,3846,0,0,0,3846,3846,0,0,0,0,28
1042,a1803,20170802,3846,3846,0,0,0,3846,3846,0,0,0,0,28
1043,a1803,20170803,3846,3846,0,0,0,3846,3846,0,0,0,0,28
1044,a1803,20170804,3846,3846,0,0,0,3846,3846,0,0,0,0,28
1045,a1803,20170807,3846,3846,0,0,0,3899,3899,53,53,0,0,28
1046,a1803,20170808,3899,3899,0,0,0,3976,3976,77,77,0,0,28
1047,a1803,20170809,3976,3976,3992,3992,3981,3981,3986,5,10,4,159460,28
1048,a1803,20170810,3981,3986,3952,3987,3952,3979,3979,-7,-7,40,1591720,46
1049,a1803,20170811,3979,3979,3982,3982,3973,3973,3979,-6,0,8,318380,40
1050,a1803,20170814,3973,3979,0,0,0,3970,3970,-9,-9,0,0,40
1051,a1803,20170815,3970,3970,3890,3890,3882,3889,3887,-81,-83,6,233220,38
1052,a1803,20170816,3889,3887,0,0,0,3887,3887,0,0,0,0,38
1053,a1803,20170817,3887,3887,0,0,0,3887,3887,0,0,0,0,38
1054,a1803,20170818,3887,3887,0,0,0,3887,3887,0,0,0,0,38
1055,a1803,20170821,3887,3887,3888,3913,3888,3913,3908,26,21,12,469060,28
1056,a1803,20170822,3913,3908,0,0,0,3908,3908,0,0,0,0,28
1057,a1803,20170823,3908,3908,0,0,0,3908,3908,0,0,0,0,28
1058,a1803,20170824,3908,3908,0,0,0,3908,3908,0,0,0,0,28
1059,a1803,20170825,3908,3908,0,0,0,3908,3908,0,0,0,0,28
1060,a1803,20170828,3908,3908,0,0,0,3912,3912,4,4,0,0,28
1061,a1803,20170829,3912,3912,0,0,0,3912,3912,0,0,0,0,28
1062,a1803,20170830,3912,3912,0,0,0,3912,3912,0,0,0,0,28
1063,a1803,20170831,3912,3912,0,0,0,3912,3912,0,0,0,0,28
1064,a1803,20170901,3912,3912,0,0,0,3912,3912,0,0,0,0,28
1065,a1803,20170904,3912,3912,0,0,0,3912,3912,0,0,0,0,28
1066,a1803,20170905,3912,3912,0,0,0,3912,3912,0,0,0,0,28
1067,a1803,20170906,3912,3912,0,0,0,3912,3912,0,0,0,0,28
1068,a1803,20170907,3912,3912,0,0,0,3912,3912,0,0,0,0,28
1069,a1803,20170908,3912,3912,0,0,0,3853,3853,-59,-59,0,0,28
1070,a1803,20170911,3853,3853,3805,3805,3805,3805,3805,-48,-48,4,152200,26
1071,a1803,20170912,3805,3805,3818,3841,3815,3815,3824,10,19,6,229480,24
1072,a1803,20170913,3815,3824,0,0,0,3819,3819,-5,-5,0,0,24
1073,a1803,20170914,3819,3819,0,0,0,3819,3819,0,0,0,0,24
1074,a1803,20170915,3819,3819,0,0,0,3819,3819,0,0,0,0,24
1075,a1803,20170918,3819,3819,0,0,0,3819,3819,0,0,0,0,24
1076,a1803,20170919,3819,3819,3798,3827,3798,3827,3817,8,-2,6,229040,26
1077,a1803,20170920,3827,3817,3792,3792,3792,3792,3792,-25,-25,2,75840,28
1078,a1803,20170921,3792,3792,3793,3793,3793,3793,3793,1,1,2,75860,26
1079,a1803,20170922,3793,3793,3798,3798,3774,3774,3786,-19,-7,4,151440,28
1080,a1803,20170925,3774,3786,3825,3825,3812,3815,3819,29,33,8,305520,26
1081,a1803,20170926,3815,3819,0,0,0,3819,3819,0,0,0,0,26
1082,a1803,20170927,3819,3819,3827,3827,3827,3827,3827,8,8,2,76540,26
1083,a1803,20170928,3827,3827,3837,3837,3813,3813,3833,-14,6,26,996660,24
1084,a1803,20170929,3813,3833,0,0,0,3825,3825,-8,-8,0,0,24
1085,a1803,20171009,3825,3825,0,0,0,3825,3825,0,0,0,0,24
1086,a1803,20171010,3825,3825,0,0,0,3871,3871,46,46,0,0,24
1087,a1803,20171011,3871,3871,3859,3859,3859,3859,3859,-12,-12,2,77180,22
1088,a1803,20171012,3859,3859,0,0,0,3840,3840,-19,-19,0,0,22
1089,a1803,20171013,3840,3840,3850,3850,3840,3840,3842,0,2,8,307400,24
1090,a1803,20171016,3840,3842,0,0,0,3842,3842,0,0,0,0,24
1091,a1803,20171017,3842,3842,0,0,0,3778,3778,-64,-64,0,0,24
1092,a1803,20171018,3778,3778,3742,3742,3705,3705,3728,-73,-50,8,298260,22
1093,a1803,20171019,3705,3728,0,0,0,3728,3728,0,0,0,0,22
1094,a1803,20171020,3728,3728,0,0,0,3728,3728,0,0,0,0,22
1095,a1803,20171023,3728,3728,3741,3741,3699,3699,3713,-29,-15,6,222780,26
1096,a1803,20171024,3699,3713,0,0,0,3713,3713,0,0,0,0,26
1097,a1803,20171025,3713,3713,3658,3684,3658,3684,3671,-29,-42,4,146840,26
1098,a1803,20171026,3684,3671,0,0,0,3662,3662,-9,-9,0,0,26
1099,a1803,20171027,3662,3662,0,0,0,3662,3662,0,0,0,0,26
1100,a1803,20171030,3662,3662,0,0,0,3641,3641,-21,-21,0,0,26
1101,a1803,20171031,3641,3641,0,0,0,3641,3641,0,0,0,0,26
1102,a1803,20171101,3641,3641,0,0,0,3641,3641,0,0,0,0,26
1103,a1803,20171102,3641,3641,0,0,0,3641,3641,0,0,0,0,26
1104,a1803,20171103,3641,3641,0,0,0,3641,3641,0,0,0,0,26
1105,a1803,20171106,3641,3641,0,0,0,3641,3641,0,0,0,0,26
1106,a1803,20171107,3641,3641,0,0,0,3641,3641,0,0,0,0,26
1107,a1803,20171108,3641,3641,3733,3733,3674,3674,3687,33,46,10,368780,30
1108,a1803,20171109,3674,3687,0,0,0,3687,3687,0,0,0,0,30
1109,a1803,20171110,3687,3687,3663,3684,3655,3683,3673,-4,-14,10,367360,30
1110,a1803,20171113,3683,3673,0,0,0,3673,3673,0,0,0,0,30
1111,a1803,20171114,3673,3673,0,0,0,3673,3673,0,0,0,0,30
1112,a1803,20171115,3673,3673,3651,3653,3647,3653,3650,-20,-23,6,219020,34
1113,a1803,20171116,3653,3650,0,0,0,3650,3650,0,0,0,0,34
1114,a1803,20171117,3650,3650,0,0,0,3650,3650,0,0,0,0,34
1115,a1803,20171120,3650,3650,3671,3671,3671,3671,3671,21,21,2,73420,32
1116,a1803,20171121,3671,3671,3715,3715,3662,3690,3694,19,23,24,886780,30
1117,a1803,20171122,3690,3694,3737,3737,3703,3721,3725,27,31,20,745040,36
1118,a1803,20171123,3721,3725,3750,3750,3726,3729,3738,4,13,16,598220,40
1119,a1803,20171124,3729,3738,3738,3738,3737,3737,3737,-1,-1,14,523200,32
1120,a1803,20171127,3737,3737,3732,3732,3732,3732,3732,-5,-5,2,74640,34
1121,a1803,20171128,3732,3732,3707,3727,3707,3727,3717,-5,-15,4,148680,34
1122,a1803,20171129,3727,3717,0,0,0,3717,3717,0,0,0,0,34
1123,a1803,20171130,3717,3717,3688,3688,3640,3640,3664,-77,-53,4,146560,36
1124,a1803,20171201,3640,3664,3636,3636,3636,3636,3636,-28,-28,6,218160,36
1125,a1803,20171204,3636,3636,3671,3687,3671,3671,3672,35,36,32,1175060,58
1126,a1803,20171205,3671,3672,3667,3667,3667,3667,3667,-5,-5,20,733400,40
1127,a1803,20171206,3667,3667,0,0,0,3667,3667,0,0,0,0,40
1128,a1803,20171207,3667,3667,3644,3651,3498,3499,3536,-168,-131,384,13579220,256
1129,a1803,20171208,3499,3536,3461,3494,3461,3463,3472,-73,-64,42,1458420,274
1130,a1803,20171211,3463,3472,3483,3493,3479,3490,3485,18,13,36,1254640,284
1131,a1803,20171212,3490,3485,3475,3487,3470,3487,3481,2,-4,22,766000,286
1132,a1803,20171213,3487,3481,3488,3495,3488,3495,3490,14,9,6,209420,282
1133,a1803,20171214,3495,3490,3477,3495,3463,3480,3478,-10,-12,68,2365100,322
1134,a1803,20171215,3480,3478,3495,3496,3471,3471,3483,-7,5,24,836060,322
1135,a1803,20171218,3471,3483,3488,3498,3486,3488,3490,5,7,32,1116800,322
1136,a1803,20171219,3488,3490,3481,3492,3472,3472,3480,-18,-10,14,487200,322
1137,a1803,20171220,3472,3480,3470,3470,3470,3470,3470,-10,-10,4,138800,322
1138,a1803,20171221,3470,3470,3486,3490,3480,3480,3485,10,15,24,836520,330
1139,a1803,20171222,3480,3485,3441,3441,3333,3345,3380,-140,-105,492,16632680,404
1140,a1803,20171225,3345,3380,3371,3396,3346,3396,3368,16,-12,354,11924220,562
1141,a1803,20171226,3396,3368,3389,3409,3346,3372,3368,4,0,446,15024440,768
1142,a1803,20171227,3372,3368,3369,3379,3350,3359,3357,-9,-11,424,14237660,970
1143,a1803,20171228,3359,3357,3360,3362,3223,3226,3273,-131,-84,2664,87206800,2834
1144,a1803,20171229,3226,3273,3226,3226,3120,3122,3143,-151,-130,9068,285027140,9628
1145,a1805,20170103,4192,4214,4167,4167,4128,4128,4150,-86,-64,8,332040,82
1146,a1805,20170104,4128,4150,4175,4175,4163,4163,4171,13,21,6,250260,86
1147,a1805,20170105,4163,4171,4173,4198,4173,4198,4185,27,14,4,167420,86
1148,a1805,20170106,4198,4185,4176,4199,4160,4160,4177,-25,-8,20,835440,94
1149,a1805,20170109,4160,4177,4164,4165,4133,4136,4151,-41,-26,38,1577540,94
1150,a1805,20170110,4136,4151,4136,4154,4101,4101,4126,-50,-25,32,1320480,96
1151,a1805,20170111,4101,4126,4109,4136,4109,4112,4115,-14,-11,18,740860,100
1152,a1805,20170112,4112,4115,4146,4147,4100,4104,4115,-11,0,52,2140080,114
1153,a1805,20170113,4104,4115,4108,4147,4101,4144,4122,29,7,16,659540,112
1154,a1805,20170116,4144,4122,4132,4199,4132,4188,4177,66,55,16,668400,110
1155,a1805,20170117,4188,4177,4210,4212,4160,4160,4186,-17,9,18,753580,106
1156,a1805,20170118,4160,4186,4206,4228,4172,4219,4205,33,19,20,841140,100
1157,a1805,20170119,4219,4205,4227,4230,4202,4221,4219,16,14,30,1265740,96
1158,a1805,20170120,4221,4219,4226,4226,4185,4185,4205,-34,-14,26,1093360,94
1159,a1805,20170123,4185,4205,4185,4185,4149,4164,4168,-41,-37,14,583580,98
1160,a1805,20170124,4164,4168,4187,4198,4187,4191,4193,23,25,8,335440,98
1161,a1805,20170125,4191,4193,4190,4190,4175,4175,4182,-18,-11,4,167300,100
1162,a1805,20170126,4175,4182,4192,4192,4182,4182,4187,0,5,4,167480,100
1163,a1805,20170203,4182,4187,4212,4239,4212,4227,4222,40,35,20,844580,104
1164,a1805,20170206,4227,4222,4239,4274,4227,4274,4244,52,22,8,339540,106
1165,a1805,20170207,4274,4244,4269,4274,4257,4273,4266,29,22,36,1535760,108
1166,a1805,20170208,4273,4266,4274,4287,4261,4261,4276,-5,10,24,1026260,112
1167,a1805,20170209,4261,4276,4285,4289,4266,4266,4281,-10,5,320,13700000,114
1168,a1805,20170210,4266,4281,4278,4288,4252,4280,4270,-1,-11,442,18875360,120
1169,a1805,20170213,4280,4270,4277,4330,4277,4280,4309,10,39,130,5601900,190
1170,a1805,20170214,4280,4309,4301,4354,4300,4310,4336,1,27,252,10928340,274
1171,a1805,20170215,4310,4336,4299,4300,4269,4271,4282,-65,-54,172,7365040,286
1172,a1805,20170216,4271,4282,4200,4296,4200,4274,4250,-8,-32,388,16490620,220
1173,a1805,20170217,4274,4250,4283,4289,4237,4253,4254,3,4,110,4680140,236
1174,a1805,20170220,4253,4254,4240,4246,4226,4227,4233,-27,-21,192,8128820,262
1175,a1805,20170221,4227,4233,4234,4261,4223,4259,4232,26,-1,68,2877820,268
1176,a1805,20170222,4259,4232,4228,4233,4212,4212,4218,-20,-14,78,3290460,308
1177,a1805,20170223,4212,4218,4230,4237,4201,4216,4220,-2,2,44,1856840,322
1178,a1805,20170224,4216,4220,4209,4209,4138,4156,4160,-64,-60,270,11234420,378
1179,a1805,20170227,4156,4160,4154,4164,4125,4145,4149,-15,-11,76,3153380,368
1180,a1805,20170228,4145,4149,4156,4172,4144,4149,4154,0,5,22,913960,378
1181,a1805,20170301,4149,4154,4156,4182,4151,4157,4169,3,15,32,1334200,374
1182,a1805,20170302,4157,4169,4170,4170,4151,4155,4157,-14,-12,10,415700,376
1183,a1805,20170303,4155,4157,4136,4136,4076,4076,4098,-81,-59,162,6639620,496
1184,a1805,20170306,4076,4098,4085,4109,4078,4100,4091,2,-7,52,2127720,516
1185,a1805,20170307,4100,4091,4094,4105,4059,4059,4090,-32,-1,1222,49990400,590
1186,a1805,20170308,4059,4090,4072,4079,4038,4065,4060,-25,-30,1420,57652080,646
1187,a1805,20170309,4065,4060,4056,4088,4031,4036,4056,-24,-4,1736,70423220,728
1188,a1805,20170310,4036,4056,4025,4049,3967,3979,4025,-77,-31,2496,100472840,682
1189,a1805,20170313,3979,4025,3963,4055,3963,4044,4034,19,9,1268,51160440,688
1190,a1805,20170314,4044,4034,4031,4050,3972,3979,4026,-55,-8,2060,82938360,704
1191,a1805,20170315,3979,4026,3979,4017,3976,4002,3998,-24,-28,1030,41185600,720
1192,a1805,20170316,4002,3998,4006,4014,3977,3988,3992,-10,-6,242,9662280,756
1193,a1805,20170317,3988,3992,3996,4009,3972,3990,3990,-2,-2,2078,82916720,808
1194,a1805,20170320,3990,3990,3986,4028,3986,4003,4007,13,17,2430,97381500,730
1195,a1805,20170321,4003,4007,4003,4012,3982,3991,4002,-16,-5,308,12327360,822
1196,a1805,20170322,3991,4002,3991,4027,3981,4008,3997,6,-5,1600,63966960,1132
1197,a1805,20170323,4008,3997,3997,4015,3985,3993,3995,-4,-2,1618,64640920,894
1198,a1805,20170324,3993,3995,3991,4014,3987,3990,3997,-5,2,620,24782860,868
1199,a1805,20170327,3990,3997,3998,3999,3916,3945,3950,-52,-47,1654,65344380,772
1200,a1805,20170328,3945,3950,3943,3970,3923,3937,3947,-13,-3,848,33471860,774
1201,a1805,20170329,3937,3947,3944,3963,3936,3947,3949,0,2,246,9716180,776
1202,a1805,20170330,3947,3949,3941,3944,3908,3921,3926,-28,-23,1196,46961260,806
1203,a1805,20170331,3921,3926,3905,3966,3901,3936,3940,10,14,812,31997200,776
1204,a1805,20170405,3936,3940,3920,3968,3914,3962,3948,22,8,370,14608380,812
1205,a1805,20170406,3962,3948,3958,3970,3930,3931,3951,-17,3,288,11379440,790
1206,a1805,20170407,3931,3951,3925,3943,3905,3905,3920,-46,-31,290,11370420,812
1207,a1805,20170410,3905,3920,3926,3999,3922,3984,3956,64,36,258,10206520,738
1208,a1805,20170411,3984,3956,3984,3990,3962,3986,3979,30,23,344,13690400,744
1209,a1805,20170412,3986,3979,3982,4009,3955,3967,3986,-12,7,142,5660900,742
1210,a1805,20170413,3967,3986,3973,4000,3972,3992,3987,6,1,70,2791100,748
1211,a1805,20170414,3992,3987,3998,4000,3981,3993,3989,6,2,90,3590440,720
1212,a1805,20170417,3993,3989,3997,4015,3930,3934,3991,-55,2,1538,61383940,708
1213,a1805,20170418,3934,3991,3922,3940,3869,3869,3922,-122,-69,1904,74688680,748
1214,a1805,20170419,3869,3922,3870,3900,3862,3890,3885,-32,-37,592,23004760,784
1215,a1805,20170420,3890,3885,3888,3918,3853,3912,3888,27,3,1372,53352200,924
1216,a1805,20170421,3912,3888,3917,3919,3875,3895,3899,7,11,2292,89385540,1026
1217,a1805,20170424,3895,3899,3900,3917,3867,3887,3906,-12,7,1180,46092680,1062
1218,a1805,20170425,3887,3906,3882,3895,3866,3886,3879,-20,-27,1224,47480200,1238
1219,a1805,20170426,3886,3879,3881,3909,3865,3870,3884,-9,5,1602,62223180,1122
1220,a1805,20170427,3870,3884,3870,3885,3845,3855,3865,-29,-19,1312,50712720,1448
1221,a1805,20170428,3855,3865,3851,3870,3846,3855,3858,-10,-7,2424,93522340,1516
1222,a1805,20170502,3855,3858,3873,3932,3866,3927,3895,69,37,1434,55860800,1634
1223,a1805,20170503,3927,3895,3911,3911,3884,3901,3901,6,6,776,30278480,1606
1224,a1805,20170504,3901,3901,3890,3908,3870,3882,3892,-19,-9,2290,89133040,1584
1225,a1805,20170505,3882,3892,3885,3908,3865,3874,3888,-18,-4,2678,104139520,1668
1226,a1805,20170508,3874,3888,3891,3905,3855,3885,3881,-3,-7,5226,202832260,1748
1227,a1805,20170509,3885,3881,3880,3901,3873,3893,3887,12,6,2482,96478460,1812
1228,a1805,20170510,3893,3887,3903,3925,3890,3907,3909,20,22,2442,95474080,1826
1229,a1805,20170511,3907,3909,3906,3919,3869,3888,3897,-21,-12,2156,84032200,1150
1230,a1805,20170512,3888,3897,3885,3886,3872,3883,3880,-14,-17,52,2017940,1150
1231,a1805,20170515,3883,3880,3872,3899,3862,3870,3884,-10,4,1810,70317700,1178
1232,a1805,20170516,3870,3884,3876,3890,3841,3851,3854,-33,-30,1494,57585980,1246
1233,a1805,20170517,3851,3854,3857,3897,3850,3886,3883,32,29,610,23687480,1236
1234,a1805,20170518,3886,3883,3876,3885,3850,3853,3868,-30,-15,286,11065120,1210
1235,a1805,20170519,3853,3868,3840,3857,3830,3841,3840,-27,-28,1316,50543520,1202
1236,a1805,20170522,3841,3840,3845,3906,3845,3892,3889,52,49,1740,67677000,1122
1237,a1805,20170523,3892,3889,3890,3897,3864,3891,3887,2,-2,2912,113213020,1142
1238,a1805,20170524,3891,3887,3879,3919,3858,3905,3880,18,-7,3002,116485540,1552
1239,a1805,20170525,3905,3880,3910,3910,3875,3881,3895,1,15,982,38254760,1566
1240,a1805,20170526,3881,3895,3888,3898,3864,3874,3874,-21,-21,338,13096980,1494
1241,a1805,20170531,3874,3874,3846,3848,3771,3785,3833,-89,-41,492,18860700,1434
1242,a1805,20170601,3785,3833,3785,3791,3774,3781,3782,-52,-51,190,7187460,1434
1243,a1805,20170602,3781,3782,3799,3824,3779,3810,3805,28,23,394,14994120,1564
1244,a1805,20170605,3810,3805,3816,3866,3802,3863,3844,58,39,296,11379400,1594
1245,a1805,20170606,3863,3844,3855,3876,3849,3862,3859,18,15,148,5712280,1602
1246,a1805,20170607,3862,3859,3870,3876,3853,3869,3868,10,9,62,2398200,1606
1247,a1805,20170608,3869,3868,3875,3876,3868,3874,3874,6,6,34,1317160,1602
1248,a1805,20170609,3874,3874,3852,3968,3852,3943,3937,69,63,722,28428660,1608
1249,a1805,20170612,3943,3937,3932,3983,3907,3961,3950,24,13,374,14773420,1578
1250,a1805,20170613,3961,3950,3954,3963,3934,3956,3951,6,1,350,13830540,1642
1251,a1805,20170614,3956,3951,3947,3967,3931,3941,3942,-10,-9,180,7096000,1708
1252,a1805,20170615,3941,3942,3936,3960,3930,3950,3945,8,3,710,28016240,1892
1253,a1805,20170616,3950,3945,3946,3993,3926,3930,3952,-15,7,616,24345980,1974
1254,a1805,20170619,3930,3952,3936,3960,3929,3929,3941,-23,-11,290,11430980,2042
1255,a1805,20170620,3929,3941,3929,3946,3915,3934,3932,-7,-9,394,15495760,1976
1256,a1805,20170621,3934,3932,3926,3954,3886,3901,3919,-31,-13,274,10738400,1950
1257,a1805,20170622,3901,3919,3897,3913,3882,3888,3899,-31,-20,154,6004500,1936
1258,a1805,20170623,3888,3899,3881,3892,3864,3882,3879,-17,-20,184,7139000,1954
1259,a1805,20170626,3882,3879,3879,3908,3879,3879,3895,0,16,106,4128760,1936
1260,a1805,20170627,3879,3895,3879,3882,3868,3872,3873,-23,-22,110,4260860,1874
1261,a1805,20170628,3872,3873,3886,3894,3869,3876,3879,3,6,160,6207620,1860
1262,a1805,20170629,3876,3879,3879,3887,3873,3876,3877,-3,-2,148,5738120,1892
1263,a1805,20170630,3876,3877,3883,3897,3863,3880,3887,3,10,108,4198420,1890
1264,a1805,20170703,3880,3887,3880,3930,3875,3913,3914,26,27,910,35619720,1884
1265,a1805,20170704,3913,3914,3920,3933,3883,3910,3911,-4,-3,266,10405620,1922
1266,a1805,20170705,3910,3911,3918,3921,3894,3902,3910,-9,-1,290,11340060,1954
1267,a1805,20170706,3902,3910,3904,3926,3869,3890,3895,-20,-15,752,29292940,1980
1268,a1805,20170707,3890,3895,3890,3902,3870,3873,3882,-22,-13,244,9473680,2034
1269,a1805,20170710,3873,3882,3884,3941,3880,3930,3919,48,37,874,34253040,1920
1270,a1805,20170711,3930,3919,3940,3959,3928,3937,3942,18,23,490,19320220,1876
1271,a1805,20170712,3937,3942,3928,3974,3915,3942,3945,0,3,448,17676640,1806
1272,a1805,20170713,3942,3945,3936,3955,3929,3931,3935,-14,-10,708,27865980,1600
1273,a1805,20170714,3931,3935,3916,3916,3865,3868,3887,-67,-48,336,13060500,1578
1274,a1805,20170717,3868,3887,3868,3899,3852,3878,3884,-9,-3,332,12895380,1644
1275,a1805,20170718,3878,3884,3894,3901,3881,3894,3890,10,6,158,6147420,1660
1276,a1805,20170719,3894,3890,3897,3910,3882,3894,3892,4,2,360,14012980,1720
1277,a1805,20170720,3894,3892,3898,3921,3892,3914,3914,22,22,932,36480720,1646
1278,a1805,20170721,3914,3914,3926,3930,3905,3921,3922,7,8,342,13414540,1628
1279,a1805,20170724,3921,3922,3913,3935,3871,3888,3908,-34,-14,278,10865660,1638
1280,a1805,20170725,3888,3908,3888,3913,3880,3910,3904,2,-4,600,23428660,1936
1281,a1805,20170726,3910,3904,3909,3922,3888,3908,3903,4,-1,546,21314640,1962
1282,a1805,20170727,3908,3903,3912,3925,3907,3918,3915,15,12,730,28585080,2110
1283,a1805,20170728,3918,3915,3926,3931,3901,3910,3919,-5,4,360,14109220,2056
1284,a1805,20170731,3910,3919,3914,3925,3896,3918,3910,-1,-9,618,24165080,2280
1285,a1805,20170801,3918,3910,3918,3933,3881,3889,3905,-21,-5,1012,39523260,2434
1286,a1805,20170802,3889,3905,3881,3893,3857,3878,3871,-27,-34,626,24235080,2418
1287,a1805,20170803,3878,3871,3889,3889,3863,3863,3873,-8,2,160,6198300,2400
1288,a1805,20170804,3863,3873,3856,3879,3850,3875,3864,2,-9,604,23343520,2294
1289,a1805,20170807,3875,3864,3875,3960,3875,3960,3925,96,61,1882,73886360,3066
1290,a1805,20170808,3960,3925,3954,4015,3954,3981,3991,56,66,3588,143198660,3974
1291,a1805,20170809,3981,3991,3987,4023,3985,4015,4005,24,14,872,34929320,4132
1292,a1805,20170810,4015,4005,4010,4043,4004,4029,4018,24,13,1468,58998520,4322
1293,a1805,20170811,4029,4018,4038,4050,3973,3992,4002,-26,-16,1976,79089640,4290
1294,a1805,20170814,3992,4002,3995,3995,3936,3944,3951,-58,-51,1538,60770160,4184
1295,a1805,20170815,3944,3951,3938,3953,3927,3936,3937,-15,-14,1002,39454360,4110
1296,a1805,20170816,3936,3937,3937,3941,3915,3927,3924,-10,-13,1028,40340100,4264
1297,a1805,20170817,3927,3924,3929,3952,3926,3950,3942,26,18,2124,83737520,4494
1298,a1805,20170818,3950,3942,3958,3958,3922,3945,3947,3,5,814,32132840,4740
1299,a1805,20170821,3945,3947,3935,3985,3932,3956,3961,9,14,1570,62192320,5188
1300,a1805,20170822,3956,3961,3965,3974,3931,3970,3962,9,1,1420,56263040,5472
1301,a1805,20170823,3970,3962,3965,4006,3957,3975,3979,13,17,2932,116669780,5932
1302,a1805,20170824,3975,3979,3975,3980,3946,3960,3959,-19,-20,1726,68334400,6108
1303,a1805,20170825,3960,3959,3966,3970,3955,3965,3961,6,2,2030,80413220,5758
1304,a1805,20170828,3965,3961,3965,3995,3957,3958,3979,-3,18,4760,189401420,7406
1305,a1805,20170829,3958,3979,3961,3974,3922,3932,3942,-47,-37,4500,177406880,8522
1306,a1805,20170830,3932,3942,3928,3938,3912,3916,3927,-26,-15,1738,68257820,8554
1307,a1805,20170831,3916,3927,3916,3933,3892,3892,3910,-35,-17,2226,87052940,8960
1308,a1805,20170901,3892,3910,3890,3912,3873,3877,3894,-33,-16,3372,131320460,9124
1309,a1805,20170904,3877,3894,3882,3898,3871,3892,3885,-2,-9,5728,222536280,8266
1310,a1805,20170905,3892,3885,3894,3904,3883,3889,3891,4,6,3166,123215960,8712
1311,a1805,20170906,3889,3891,3896,3907,3873,3880,3893,-11,2,3582,139454800,8950
1312,a1805,20170907,3880,3893,3879,3883,3861,3863,3872,-30,-21,5282,204529400,9458
1313,a1805,20170908,3863,3872,3872,3894,3866,3882,3879,10,7,5680,220337320,10084
1314,a1805,20170911,3882,3879,3880,3885,3824,3862,3850,-17,-29,8392,323136120,12132
1315,a1805,20170912,3862,3850,3856,3863,3836,3850,3853,0,3,2930,112893280,12248
1316,a1805,20170913,3850,3853,3852,3859,3834,3855,3848,2,-5,4726,181874040,13244
1317,a1805,20170914,3855,3848,3859,3872,3846,3851,3857,3,9,6536,252103000,14028
1318,a1805,20170915,3851,3857,3857,3864,3841,3843,3852,-14,-5,7154,275610340,14536
1319,a1805,20170918,3843,3852,3830,3854,3830,3848,3841,-4,-11,4888,187786060,14446
1320,a1805,20170919,3848,3841,3843,3857,3835,3843,3848,2,7,3220,123922120,14840
1321,a1805,20170920,3843,3848,3843,3843,3802,3829,3820,-19,-28,8498,324684240,16790
1322,a1805,20170921,3829,3820,3830,3835,3806,3814,3821,-6,1,4814,183970980,17114
1323,a1805,20170922,3814,3821,3812,3852,3806,3849,3830,28,9,8692,332980340,17214
1324,a1805,20170925,3849,3830,3853,3856,3836,3843,3843,13,13,5674,218054880,16430
1325,a1805,20170926,3843,3843,3845,3855,3836,3846,3847,3,4,5224,200993800,16458
1326,a1805,20170927,3846,3847,3841,3861,3840,3857,3851,10,4,3158,121629780,16430
1327,a1805,20170928,3857,3851,3856,3870,3829,3842,3848,-9,-3,5436,209194180,15944
1328,a1805,20170929,3842,3848,3840,3856,3836,3842,3845,-6,-3,4524,173976060,16346
1329,a1805,20171009,3842,3845,3858,3862,3822,3859,3833,14,-12,7484,286932260,17090
1330,a1805,20171010,3859,3833,3863,3880,3846,3861,3862,28,29,23550,909607000,23174
1331,a1805,20171011,3861,3862,3875,3882,3852,3854,3867,-8,5,21484,830869500,29784
1332,a1805,20171012,3854,3867,3853,3860,3835,3842,3847,-25,-20,10986,422702340,30464
1333,a1805,20171013,3842,3847,3845,3880,3835,3861,3862,14,15,11144,430403840,31926
1334,a1805,20171016,3861,3862,3873,3880,3848,3865,3863,3,1,13506,521832120,34088
1335,a1805,20171017,3865,3863,3845,3860,3825,3829,3839,-34,-24,24196,929027000,36894
1336,a1805,20171018,3829,3839,3825,3829,3792,3796,3807,-43,-32,22814,868652180,37526
1337,a1805,20171019,3796,3807,3808,3808,3782,3783,3792,-24,-15,8034,304702500,38554
1338,a1805,20171020,3783,3792,3788,3804,3785,3797,3795,5,3,7262,275631100,39256
1339,a1805,20171023,3797,3795,3798,3805,3756,3763,3771,-32,-24,19508,735657580,37462
1340,a1805,20171024,3763,3771,3762,3771,3737,3740,3753,-31,-18,17288,648965960,43800
1341,a1805,20171025,3740,3753,3728,3764,3728,3754,3750,1,-3,20744,777957640,51936
1342,a1805,20171026,3754,3750,3757,3759,3736,3740,3746,-10,-4,10586,396650180,55898
1343,a1805,20171027,3740,3746,3746,3746,3701,3714,3721,-32,-25,15500,576790960,61152
1344,a1805,20171030,3714,3721,3717,3741,3709,3724,3727,3,6,13050,486459320,64956
1345,a1805,20171031,3724,3727,3726,3740,3724,3730,3730,3,3,10692,398845040,67126
1346,a1805,20171101,3730,3730,3731,3747,3726,3738,3737,8,7,11440,427576100,69438
1347,a1805,20171102,3738,3737,3733,3748,3730,3744,3738,7,1,14536,543397360,71812
1348,a1805,20171103,3744,3738,3738,3758,3738,3750,3749,12,11,9792,367169940,71922
1349,a1805,20171106,3750,3749,3752,3764,3732,3763,3746,14,-3,17320,648973020,69226
1350,a1805,20171107,3763,3746,3759,3792,3759,3783,3776,37,30,20718,782506440,68322
1351,a1805,20171108,3783,3776,3779,3789,3766,3776,3776,0,0,13442,507570700,69962
1352,a1805,20171109,3776,3776,3780,3805,3773,3796,3781,20,5,10992,415692740,69836
1353,a1805,20171110,3796,3781,3802,3802,3760,3778,3782,-3,1,13962,528091860,69116
1354,a1805,20171113,3778,3782,3779,3792,3774,3787,3786,5,4,10864,411319820,70724
1355,a1805,20171114,3787,3786,3784,3792,3757,3762,3770,-24,-16,14788,557593160,70890
1356,a1805,20171115,3762,3770,3760,3774,3722,3749,3751,-21,-19,29996,1125226240,69942
1357,a1805,20171116,3749,3751,3752,3761,3743,3756,3753,5,2,11808,443239460,72050
1358,a1805,20171117,3756,3753,3753,3758,3745,3751,3750,-2,-3,8690,325922760,72602
1359,a1805,20171120,3751,3750,3741,3783,3738,3772,3766,22,16,23632,890050240,72838
1360,a1805,20171121,3772,3766,3769,3800,3765,3791,3785,25,19,37160,1406524200,78212
1361,a1805,20171122,3791,3785,3790,3815,3786,3803,3799,18,14,39000,1481930680,87216
1362,a1805,20171123,3803,3799,3808,3820,3788,3805,3807,6,8,44042,1677111280,100182
1363,a1805,20171124,3805,3807,3805,3830,3800,3816,3818,9,11,30810,1176391120,104464
1364,a1805,20171127,3816,3818,3818,3825,3786,3807,3806,-11,-12,36010,1370703140,112778
1365,a1805,20171128,3807,3806,3808,3809,3782,3788,3794,-18,-12,32966,1251034240,120176
1366,a1805,20171129,3788,3794,3790,3801,3769,3769,3779,-25,-15,36424,1376771200,128278
1367,a1805,20171130,3769,3779,3769,3776,3705,3709,3734,-70,-45,87612,3271956940,144512
1368,a1805,20171201,3709,3734,3707,3719,3695,3709,3708,-25,-26,64034,2374745180,143876
1369,a1805,20171204,3709,3708,3710,3743,3709,3735,3726,27,18,59376,2212700960,149962
1370,a1805,20171205,3735,3726,3735,3745,3711,3719,3726,-7,0,48018,1789582860,155956
1371,a1805,20171206,3719,3726,3725,3746,3720,3726,3733,0,7,69908,2609804940,163122
1372,a1805,20171207,3726,3733,3730,3738,3640,3646,3678,-87,-55,113104,4160221040,174272
1373,a1805,20171208,3646,3678,3642,3648,3618,3626,3628,-52,-50,73332,2661199700,184462
1374,a1805,20171211,3626,3628,3634,3638,3607,3621,3623,-7,-5,106498,3858807380,200938
1375,a1805,20171212,3621,3623,3617,3628,3601,3615,3613,-8,-10,133604,4827659920,234294
1376,a1805,20171213,3615,3613,3610,3635,3581,3622,3615,9,2,142002,5133823240,241096
1377,a1805,20171214,3622,3615,3618,3643,3618,3636,3629,21,14,92654,3362707080,236234
1378,a1805,20171215,3636,3629,3636,3648,3626,3632,3637,3,8,77228,2809188000,238450
1379,a1805,20171218,3632,3637,3646,3681,3618,3674,3651,37,14,132010,4819886700,233160
1380,a1805,20171219,3674,3651,3673,3677,3650,3669,3665,18,14,90864,3330416120,232754
1381,a1805,20171220,3669,3665,3664,3674,3634,3647,3656,-18,-9,88146,3222774460,237086
1382,a1805,20171221,3647,3656,3652,3671,3636,3642,3653,-14,-3,99680,3642032520,222966
1383,a1805,20171222,3642,3653,3646,3650,3574,3601,3606,-52,-47,197914,7138197040,236462
1384,a1805,20171225,3601,3606,3605,3667,3593,3666,3636,60,30,167506,6091735480,216854
1385,a1805,20171226,3666,3636,3663,3693,3655,3670,3674,34,38,123054,4521254280,210502
1386,a1805,20171227,3670,3674,3666,3683,3655,3670,3667,-4,-7,83144,3048979820,218516
1387,a1805,20171228,3670,3667,3665,3673,3616,3632,3642,-35,-25,143972,5244508660,228746
1388,a1805,20171229,3632,3642,3632,3640,3608,3626,3623,-16,-19,132704,4808784940,227374
1389,a1807,20170117,4177,4177,0,0,0,4177,4177,0,0,0,0,0
1390,a1807,20170118,4177,4177,0,0,0,4177,4177,0,0,0,0,0
1391,a1807,20170119,4177,4177,0,0,0,4177,4177,0,0,0,0,0
1392,a1807,20170120,4177,4177,0,0,0,4164,4164,-13,-13,0,0,0
1393,a1807,20170123,4164,4164,0,0,0,4164,4164,0,0,0,0,0
1394,a1807,20170124,4164,4164,0,0,0,4164,4164,0,0,0,0,0
1395,a1807,20170125,4164,4164,0,0,0,4154,4154,-10,-10,0,0,0
1396,a1807,20170126,4154,4154,0,0,0,4158,4158,4,4,0,0,0
1397,a1807,20170203,4158,4158,0,0,0,4158,4158,0,0,0,0,0
1398,a1807,20170206,4158,4158,0,0,0,4179,4179,21,21,0,0,0
1399,a1807,20170207,4179,4179,0,0,0,4226,4226,47,47,0,0,0
1400,a1807,20170208,4226,4226,4343,4343,4343,4343,4343,117,117,2,86860,2
1401,a1807,20170209,4343,4343,0,0,0,4327,4327,-16,-16,0,0,2
1402,a1807,20170210,4327,4327,0,0,0,4327,4327,0,0,0,0,2
1403,a1807,20170213,4327,4327,0,0,0,4327,4327,0,0,0,0,2
1404,a1807,20170214,4327,4327,0,0,0,4327,4327,0,0,0,0,2
1405,a1807,20170215,4327,4327,0,0,0,4327,4327,0,0,0,0,2
1406,a1807,20170216,4327,4327,4314,4314,4314,4314,4314,-13,-13,2,86280,4
1407,a1807,20170217,4314,4314,0,0,0,4314,4314,0,0,0,0,4
1408,a1807,20170220,4314,4314,0,0,0,4293,4293,-21,-21,0,0,4
1409,a1807,20170221,4293,4293,0,0,0,4293,4293,0,0,0,0,4
1410,a1807,20170222,4293,4293,4201,4247,4201,4246,4243,-47,-50,60,2545820,6
1411,a1807,20170223,4246,4243,0,0,0,4243,4243,0,0,0,0,6
1412,a1807,20170224,4243,4243,4144,4145,4144,4144,4144,-99,-99,8,331560,10
1413,a1807,20170227,4144,4144,0,0,0,4144,4144,0,0,0,0,10
1414,a1807,20170228,4144,4144,0,0,0,4144,4144,0,0,0,0,10
1415,a1807,20170301,4144,4144,0,0,0,4144,4144,0,0,0,0,10
1416,a1807,20170302,4144,4144,0,0,0,4144,4144,0,0,0,0,10
1417,a1807,20170303,4144,4144,0,0,0,4144,4144,0,0,0,0,10
1418,a1807,20170306,4144,4144,0,0,0,4144,4144,0,0,0,0,10
1419,a1807,20170307,4144,4144,0,0,0,4144,4144,0,0,0,0,10
1420,a1807,20170308,4144,4144,0,0,0,4115,4115,-29,-29,0,0,10
1421,a1807,20170309,4115,4115,0,0,0,4095,4095,-20,-20,0,0,10
1422,a1807,20170310,4095,4095,0,0,0,4095,4095,0,0,0,0,10
1423,a1807,20170313,4095,4095,3980,3980,3980,3980,3980,-115,-115,10,398000,10
1424,a1807,20170314,3980,3980,4024,4024,4024,4024,4024,44,44,2,80480,10
1425,a1807,20170315,4024,4024,0,0,0,4011,4011,-13,-13,0,0,10
1426,a1807,20170316,4011,4011,0,0,0,4011,4011,0,0,0,0,10
1427,a1807,20170317,4011,4011,0,0,0,4009,4009,-2,-2,0,0,10
1428,a1807,20170320,4009,4009,4036,4039,4036,4039,4036,30,27,8,322940,8
1429,a1807,20170321,4039,4036,0,0,0,4036,4036,0,0,0,0,8
1430,a1807,20170322,4036,4036,4050,4050,4050,4050,4050,14,14,4,162000,8
1431,a1807,20170323,4050,4050,0,0,0,4048,4048,-2,-2,0,0,8
1432,a1807,20170324,4048,4048,0,0,0,4050,4050,2,2,0,0,8
1433,a1807,20170327,4050,4050,0,0,0,4003,4003,-47,-47,0,0,8
1434,a1807,20170328,4003,4003,0,0,0,4000,4000,-3,-3,0,0,8
1435,a1807,20170329,4000,4000,0,0,0,4002,4002,2,2,0,0,8
1436,a1807,20170330,4002,4002,0,0,0,3979,3979,-23,-23,0,0,8
1437,a1807,20170331,3979,3979,0,0,0,3993,3993,14,14,0,0,8
1438,a1807,20170405,3993,3993,0,0,0,3993,3993,0,0,0,0,8
1439,a1807,20170406,3993,3993,0,0,0,3996,3996,3,3,0,0,8
1440,a1807,20170407,3996,3996,0,0,0,3965,3965,-31,-31,0,0,8
1441,a1807,20170410,3965,3965,0,0,0,4001,4001,36,36,0,0,8
1442,a1807,20170411,4001,4001,0,0,0,4001,4001,0,0,0,0,8
1443,a1807,20170412,4001,4001,3997,3997,3997,3997,3997,-4,-4,4,159880,4
1444,a1807,20170413,3997,3997,0,0,0,3998,3998,1,1,0,0,4
1445,a1807,20170414,3998,3998,0,0,0,3998,3998,0,0,0,0,4
1446,a1807,20170417,3998,3998,0,0,0,3998,3998,0,0,0,0,4
1447,a1807,20170418,3998,3998,0,0,0,3929,3929,-69,-69,0,0,4
1448,a1807,20170419,3929,3929,3940,3940,3915,3915,3927,-14,-2,4,157100,4
1449,a1807,20170420,3915,3927,3811,3811,3811,3811,3811,-116,-116,2,76220,2
1450,a1807,20170421,3811,3811,0,0,0,3821,3821,10,10,0,0,2
1451,a1807,20170424,3821,3821,0,0,0,3827,3827,6,6,0,0,2
1452,a1807,20170425,3827,3827,0,0,0,3801,3801,-26,-26,0,0,2
1453,a1807,20170426,3801,3801,0,0,0,3805,3805,4,4,0,0,2
1454,a1807,20170427,3805,3805,0,0,0,3787,3787,-18,-18,0,0,2
1455,a1807,20170428,3787,3787,0,0,0,3781,3781,-6,-6,0,0,2
1456,a1807,20170502,3781,3781,3895,3909,3895,3909,3902,128,121,4,156080,4
1457,a1807,20170503,3909,3902,0,0,0,3902,3902,0,0,0,0,4
1458,a1807,20170504,3902,3902,3890,3890,3890,3890,3890,-12,-12,2,77800,2
1459,a1807,20170505,3890,3890,0,0,0,3887,3887,-3,-3,0,0,2
1460,a1807,20170508,3887,3887,0,0,0,3881,3881,-6,-6,0,0,2
1461,a1807,20170509,3881,3881,0,0,0,3887,3887,6,6,0,0,2
1462,a1807,20170510,3887,3887,0,0,0,3909,3909,22,22,0,0,2
1463,a1807,20170511,3909,3909,0,0,0,3909,3909,0,0,0,0,2
1464,a1807,20170512,3909,3909,0,0,0,3892,3892,-17,-17,0,0,2
1465,a1807,20170515,3892,3892,0,0,0,3896,3896,4,4,0,0,2
1466,a1807,20170516,3896,3896,0,0,0,3896,3896,0,0,0,0,2
1467,a1807,20170517,3896,3896,0,0,0,3896,3896,0,0,0,0,2
1468,a1807,20170518,3896,3896,0,0,0,3881,3881,-15,-15,0,0,2
1469,a1807,20170519,3881,3881,0,0,0,3881,3881,0,0,0,0,2
1470,a1807,20170522,3881,3881,0,0,0,3881,3881,0,0,0,0,2
1471,a1807,20170523,3881,3881,0,0,0,3880,3880,-1,-1,0,0,2
1472,a1807,20170524,3880,3880,0,0,0,3874,3874,-6,-6,0,0,2
1473,a1807,20170525,3874,3874,0,0,0,3888,3888,14,14,0,0,2
1474,a1807,20170526,3888,3888,0,0,0,3868,3868,-20,-20,0,0,2
1475,a1807,20170531,3868,3868,0,0,0,3828,3828,-40,-40,0,0,2
1476,a1807,20170601,3828,3828,0,0,0,3828,3828,0,0,0,0,2
1477,a1807,20170602,3828,3828,0,0,0,3851,3851,23,23,0,0,2
1478,a1807,20170605,3851,3851,0,0,0,3851,3851,0,0,0,0,2
1479,a1807,20170606,3851,3851,0,0,0,3851,3851,0,0,0,0,2
1480,a1807,20170607,3851,3851,0,0,0,3859,3859,8,8,0,0,2
1481,a1807,20170608,3859,3859,0,0,0,3864,3864,5,5,0,0,2
1482,a1807,20170609,3864,3864,0,0,0,3926,3926,62,62,0,0,2
1483,a1807,20170612,3926,3926,0,0,0,3938,3938,12,12,0,0,2
1484,a1807,20170613,3938,3938,3943,3943,3943,3943,3943,5,5,2,78860,0
1485,a1807,20170614,3943,3943,0,0,0,3943,3943,0,0,0,0,0
1486,a1807,20170615,3943,3943,0,0,0,3946,3946,3,3,0,0,0
1487,a1807,20170616,3946,3946,0,0,0,3946,3946,0,0,0,0,0
1488,a1807,20170619,3946,3946,0,0,0,3946,3946,0,0,0,0,0
1489,a1807,20170620,3946,3946,0,0,0,3946,3946,0,0,0,0,0
1490,a1807,20170621,3946,3946,0,0,0,3946,3946,0,0,0,0,0
1491,a1807,20170622,3946,3946,0,0,0,3926,3926,-20,-20,0,0,0
1492,a1807,20170623,3926,3926,0,0,0,3926,3926,0,0,0,0,0
1493,a1807,20170626,3926,3926,0,0,0,3942,3942,16,16,0,0,0
1494,a1807,20170627,3942,3942,0,0,0,3942,3942,0,0,0,0,0
1495,a1807,20170628,3942,3942,0,0,0,3942,3942,0,0,0,0,0
1496,a1807,20170629,3942,3942,0,0,0,3940,3940,-2,-2,0,0,0
1497,a1807,20170630,3940,3940,0,0,0,3950,3950,10,10,0,0,0
1498,a1807,20170703,3950,3950,0,0,0,3950,3950,0,0,0,0,0
1499,a1807,20170704,3950,3950,0,0,0,3950,3950,0,0,0,0,0
1500,a1807,20170705,3950,3950,0,0,0,3949,3949,-1,-1,0,0,0
1501,a1807,20170706,3949,3949,0,0,0,3934,3934,-15,-15,0,0,0
1502,a1807,20170707,3934,3934,0,0,0,3921,3921,-13,-13,0,0,0
1503,a1807,20170710,3921,3921,0,0,0,3921,3921,0,0,0,0,0
1504,a1807,20170711,3921,3921,0,0,0,3921,3921,0,0,0,0,0
1505,a1807,20170712,3921,3921,0,0,0,3923,3923,2,2,0,0,0
1506,a1807,20170713,3923,3923,0,0,0,3914,3914,-9,-9,0,0,0
1507,a1807,20170714,3914,3914,0,0,0,3867,3867,-47,-47,0,0,0
1508,a1807,20170717,3867,3867,3951,3951,3853,3853,3902,-14,35,56,2185120,4
1509,a1807,20170718,3853,3902,0,0,0,3902,3902,0,0,0,0,4
1510,a1807,20170719,3902,3902,0,0,0,3902,3902,0,0,0,0,4
1511,a1807,20170720,3902,3902,0,0,0,3902,3902,0,0,0,0,4
1512,a1807,20170721,3902,3902,3903,3903,3903,3903,3903,1,1,2,78060,2
1513,a1807,20170724,3903,3903,0,0,0,3903,3903,0,0,0,0,2
1514,a1807,20170725,3903,3903,0,0,0,3903,3903,0,0,0,0,2
1515,a1807,20170726,3903,3903,0,0,0,3903,3903,0,0,0,0,2
1516,a1807,20170727,3903,3903,0,0,0,3903,3903,0,0,0,0,2
1517,a1807,20170728,3903,3903,0,0,0,3903,3903,0,0,0,0,2
1518,a1807,20170731,3903,3903,0,0,0,3903,3903,0,0,0,0,2
1519,a1807,20170801,3903,3903,3882,3882,3882,3882,3882,-21,-21,2,77640,2
1520,a1807,20170802,3882,3882,0,0,0,3882,3882,0,0,0,0,2
1521,a1807,20170803,3882,3882,0,0,0,3882,3882,0,0,0,0,2
1522,a1807,20170804,3882,3882,0,0,0,3882,3882,0,0,0,0,2
1523,a1807,20170807,3882,3882,3852,3938,3852,3938,3895,56,13,4,155800,2
1524,a1807,20170808,3938,3895,0,0,0,3895,3895,0,0,0,0,2
1525,a1807,20170809,3895,3895,0,0,0,3930,3930,35,35,0,0,2
1526,a1807,20170810,3930,3930,0,0,0,4002,4002,72,72,0,0,2
1527,a1807,20170811,4002,4002,0,0,0,4002,4002,0,0,0,0,2
1528,a1807,20170814,4002,4002,0,0,0,4002,4002,0,0,0,0,2
1529,a1807,20170815,4002,4002,0,0,0,4002,4002,0,0,0,0,2
1530,a1807,20170816,4002,4002,0,0,0,4002,4002,0,0,0,0,2
1531,a1807,20170817,4002,4002,0,0,0,4002,4002,0,0,0,0,2
1532,a1807,20170818,4002,4002,0,0,0,4002,4002,0,0,0,0,2
1533,a1807,20170821,4002,4002,4038,4047,3961,3988,4016,-14,14,704,28274060,6
1534,a1807,20170822,3988,4016,0,0,0,4016,4016,0,0,0,0,6
1535,a1807,20170823,4016,4016,0,0,0,4016,4016,0,0,0,0,6
1536,a1807,20170824,4016,4016,0,0,0,4016,4016,0,0,0,0,6
1537,a1807,20170825,4016,4016,0,0,0,4018,4018,2,2,0,0,6
1538,a1807,20170828,4018,4018,0,0,0,4036,4036,18,18,0,0,6
1539,a1807,20170829,4036,4036,0,0,0,4036,4036,0,0,0,0,6
1540,a1807,20170830,4036,4036,0,0,0,4036,4036,0,0,0,0,6
1541,a1807,20170831,4036,4036,0,0,0,3994,3994,-42,-42,0,0,6
1542,a1807,20170901,3994,3994,0,0,0,3994,3994,0,0,0,0,6
1543,a1807,20170904,3994,3994,0,0,0,3994,3994,0,0,0,0,6
1544,a1807,20170905,3994,3994,0,0,0,3994,3994,0,0,0,0,6
1545,a1807,20170906,3994,3994,0,0,0,3994,3994,0,0,0,0,6
1546,a1807,20170907,3994,3994,0,0,0,3961,3961,-33,-33,0,0,6
1547,a1807,20170908,3961,3961,0,0,0,3942,3942,-19,-19,0,0,6
1548,a1807,20170911,3942,3942,0,0,0,3942,3942,0,0,0,0,6
1549,a1807,20170912,3942,3942,0,0,0,3942,3942,0,0,0,0,6
1550,a1807,20170913,3942,3942,0,0,0,3922,3922,-20,-20,0,0,6
1551,a1807,20170914,3922,3922,0,0,0,3922,3922,0,0,0,0,6
1552,a1807,20170915,3922,3922,0,0,0,3911,3911,-11,-11,0,0,6
1553,a1807,20170918,3911,3911,0,0,0,3911,3911,0,0,0,0,6
1554,a1807,20170919,3911,3911,0,0,0,3911,3911,0,0,0,0,6
1555,a1807,20170920,3911,3911,0,0,0,3894,3894,-17,-17,0,0,6
1556,a1807,20170921,3894,3894,0,0,0,3893,3893,-1,-1,0,0,6
1557,a1807,20170922,3893,3893,0,0,0,3893,3893,0,0,0,0,6
1558,a1807,20170925,3893,3893,0,0,0,3893,3893,0,0,0,0,6
1559,a1807,20170926,3893,3893,3931,3931,3851,3851,3891,-42,-2,4,155640,8
1560,a1807,20170927,3851,3891,3891,3891,3891,3891,3891,0,0,2,77820,6
1561,a1807,20170928,3891,3891,3920,3920,3920,3920,3920,29,29,2,78400,6
1562,a1807,20170929,3920,3920,0,0,0,3920,3920,0,0,0,0,6
1563,a1807,20171009,3920,3920,4129,4129,3847,3847,3988,-73,68,4,159520,6
1564,a1807,20171010,3847,3988,3938,3938,3937,3937,3937,-51,-51,6,236240,4
1565,a1807,20171011,3937,3937,0,0,0,3933,3933,-4,-4,0,0,4
1566,a1807,20171012,3933,3933,0,0,0,3913,3913,-20,-20,0,0,4
1567,a1807,20171013,3913,3913,0,0,0,3913,3913,0,0,0,0,4
1568,a1807,20171016,3913,3913,3904,3904,3904,3904,3904,-9,-9,2,78080,2
1569,a1807,20171017,3904,3904,0,0,0,3904,3904,0,0,0,0,2
1570,a1807,20171018,3904,3904,3881,3881,3849,3849,3865,-55,-39,4,154600,4
1571,a1807,20171019,3849,3865,3806,3869,3806,3869,3827,4,-38,6,229620,4
1572,a1807,20171020,3869,3827,0,0,0,3827,3827,0,0,0,0,4
1573,a1807,20171023,3827,3827,0,0,0,3827,3827,0,0,0,0,4
1574,a1807,20171024,3827,3827,0,0,0,3809,3809,-18,-18,0,0,4
1575,a1807,20171025,3809,3809,0,0,0,3809,3809,0,0,0,0,4
1576,a1807,20171026,3809,3809,0,0,0,3805,3805,-4,-4,0,0,4
1577,a1807,20171027,3805,3805,0,0,0,3780,3780,-25,-25,0,0,4
1578,a1807,20171030,3780,3780,0,0,0,3786,3786,6,6,0,0,4
1579,a1807,20171031,3786,3786,0,0,0,3789,3789,3,3,0,0,4
1580,a1807,20171101,3789,3789,0,0,0,3796,3796,7,7,0,0,4
1581,a1807,20171102,3796,3796,0,0,0,3796,3796,0,0,0,0,4
1582,a1807,20171103,3796,3796,0,0,0,3796,3796,0,0,0,0,4
1583,a1807,20171106,3796,3796,0,0,0,3796,3796,0,0,0,0,4
1584,a1807,20171107,3796,3796,0,0,0,3796,3796,0,0,0,0,4
1585,a1807,20171108,3796,3796,0,0,0,3796,3796,0,0,0,0,4
1586,a1807,20171109,3796,3796,0,0,0,3796,3796,0,0,0,0,4
1587,a1807,20171110,3796,3796,0,0,0,3796,3796,0,0,0,0,4
1588,a1807,20171113,3796,3796,0,0,0,3796,3796,0,0,0,0,4
1589,a1807,20171114,3796,3796,3815,3815,3815,3815,3815,19,19,2,76300,4
1590,a1807,20171115,3815,3815,0,0,0,3815,3815,0,0,0,0,4
1591,a1807,20171116,3815,3815,0,0,0,3815,3815,0,0,0,0,4
1592,a1807,20171117,3815,3815,0,0,0,3815,3815,0,0,0,0,4
1593,a1807,20171120,3815,3815,0,0,0,3815,3815,0,0,0,0,4
1594,a1807,20171121,3815,3815,0,0,0,3815,3815,0,0,0,0,4
1595,a1807,20171122,3815,3815,0,0,0,3815,3815,0,0,0,0,4
1596,a1807,20171123,3815,3815,0,0,0,3815,3815,0,0,0,0,4
1597,a1807,20171124,3815,3815,0,0,0,3815,3815,0,0,0,0,4
1598,a1807,20171127,3815,3815,0,0,0,3815,3815,0,0,0,0,4
1599,a1807,20171128,3815,3815,0,0,0,3815,3815,0,0,0,0,4
1600,a1807,20171129,3815,3815,0,0,0,3815,3815,0,0,0,0,4
1601,a1807,20171130,3815,3815,0,0,0,3786,3786,-29,-29,0,0,4
1602,a1807,20171201,3786,3786,3694,3763,3694,3763,3728,-23,-58,4,149140,2
1603,a1807,20171204,3763,3728,0,0,0,3728,3728,0,0,0,0,2
1604,a1807,20171205,3728,3728,0,0,0,3728,3728,0,0,0,0,2
1605,a1807,20171206,3728,3728,0,0,0,3728,3728,0,0,0,0,2
1606,a1807,20171207,3728,3728,0,0,0,3674,3674,-54,-54,0,0,2
1607,a1807,20171208,3674,3674,0,0,0,3674,3674,0,0,0,0,2
1608,a1807,20171211,3674,3674,0,0,0,3674,3674,0,0,0,0,2
1609,a1807,20171212,3674,3674,0,0,0,3674,3674,0,0,0,0,2
1610,a1807,20171213,3674,3674,0,0,0,3674,3674,0,0,0,0,2
1611,a1807,20171214,3674,3674,0,0,0,3674,3674,0,0,0,0,2
1612,a1807,20171215,3674,3674,3709,3709,3709,3709,3709,35,35,4,148360,6
1613,a1807,20171218,3709,3709,0,0,0,3709,3709,0,0,0,0,6
1614,a1807,20171219,3709,3709,0,0,0,3709,3709,0,0,0,0,6
1615,a1807,20171220,3709,3709,0,0,0,3709,3709,0,0,0,0,6
1616,a1807,20171221,3709,3709,0,0,0,3709,3709,0,0,0,0,6
1617,a1807,20171222,3709,3709,3709,3709,3583,3583,3646,-126,-63,4,145840,6
1618,a1807,20171225,3583,3646,3681,3681,3681,3681,3681,35,35,2,73620,6
1619,a1807,20171226,3681,3681,0,0,0,3681,3681,0,0,0,0,6
1620,a1807,20171227,3681,3681,0,0,0,3681,3681,0,0,0,0,6
1621,a1807,20171228,3681,3681,0,0,0,3681,3681,0,0,0,0,6
1622,a1807,20171229,3681,3681,0,0,0,3681,3681,0,0,0,0,6
1623,a1809,20170315,4024,4024,0,0,0,4024,4024,0,0,0,0,0
1624,a1809,20170316,4024,4024,0,0,0,4024,4024,0,0,0,0,0
1625,a1809,20170317,4024,4024,3987,4036,3980,4026,4003,2,-21,36,1441160,4
1626,a1809,20170320,4026,4003,4068,4068,4068,4068,4068,65,65,2,81360,4
1627,a1809,20170321,4068,4068,0,0,0,4059,4059,-9,-9,0,0,4
1628,a1809,20170322,4059,4059,3980,4065,3980,4065,4032,6,-27,26,1048520,12
1629,a1809,20170323,4065,4032,4069,4069,4039,4039,4059,7,27,8,324760,12
1630,a1809,20170324,4039,4059,3958,4023,3958,4023,4000,-36,-59,6,240040,10
1631,a1809,20170327,4023,4000,4066,4066,3953,4006,4006,6,6,10,400620,14
1632,a1809,20170328,4006,4006,0,0,0,4006,4006,0,0,0,0,14
1633,a1809,20170329,4006,4006,0,0,0,4006,4006,0,0,0,0,14
1634,a1809,20170330,4006,4006,3980,3980,3980,3980,3980,-26,-26,2,79600,14
1635,a1809,20170331,3980,3980,3982,3983,3982,3983,3982,3,2,4,159300,14
1636,a1809,20170405,3983,3982,3939,3939,3939,3939,3939,-43,-43,2,78780,14
1637,a1809,20170406,3939,3939,0,0,0,3965,3965,26,26,0,0,14
1638,a1809,20170407,3965,3965,3952,4010,3930,3930,3965,-35,0,12,475900,16
1639,a1809,20170410,3930,3965,3978,4032,3978,4030,4014,65,49,8,321120,10
1640,a1809,20170411,4030,4014,4022,4060,4020,4020,4036,6,22,10,403620,10
1641,a1809,20170412,4020,4036,4008,4030,3985,4021,4013,-15,-23,10,401300,6
1642,a1809,20170413,4021,4013,0,0,0,4013,4013,0,0,0,0,6
1643,a1809,20170414,4013,4013,4040,4040,4013,4013,4026,0,13,4,161060,4
1644,a1809,20170417,4013,4026,4026,4026,4000,4000,4010,-26,-16,6,240620,6
1645,a1809,20170418,4000,4010,3997,3997,3935,3935,3959,-75,-51,14,554280,16
1646,a1809,20170419,3935,3959,3905,3950,3905,3928,3925,-31,-34,10,392580,14
1647,a1809,20170420,3928,3925,3922,3922,3922,3922,3922,-3,-3,4,156880,14
1648,a1809,20170421,3922,3922,0,0,0,3924,3924,2,2,0,0,14
1649,a1809,20170424,3924,3924,0,0,0,3924,3924,0,0,0,0,14
1650,a1809,20170425,3924,3924,0,0,0,3924,3924,0,0,0,0,14
1651,a1809,20170426,3924,3924,0,0,0,3924,3924,0,0,0,0,14
1652,a1809,20170427,3924,3924,0,0,0,3917,3917,-7,-7,0,0,14
1653,a1809,20170428,3917,3917,3920,3920,3920,3920,3920,3,3,2,78400,16
1654,a1809,20170502,3920,3920,3968,3968,3968,3968,3968,48,48,2,79360,14
1655,a1809,20170503,3968,3968,3955,3955,3955,3955,3955,-13,-13,2,79100,14
1656,a1809,20170504,3955,3955,3930,3930,3930,3930,3930,-25,-25,2,78600,14
1657,a1809,20170505,3930,3930,0,0,0,3930,3930,0,0,0,0,14
1658,a1809,20170508,3930,3930,3964,3964,3888,3932,3928,2,-2,8,314300,14
1659,a1809,20170509,3932,3928,0,0,0,3930,3930,2,2,0,0,14
1660,a1809,20170510,3930,3930,3965,3966,3965,3966,3965,36,35,8,317260,14
1661,a1809,20170511,3966,3965,0,0,0,3938,3938,-27,-27,0,0,14
1662,a1809,20170512,3938,3938,0,0,0,3938,3938,0,0,0,0,14
1663,a1809,20170515,3938,3938,3945,3945,3945,3945,3945,7,7,2,78900,14
1664,a1809,20170516,3945,3945,3913,3913,3913,3913,3913,-32,-32,2,78260,16
1665,a1809,20170517,3913,3913,3935,3935,3935,3935,3935,22,22,2,78700,14
1666,a1809,20170518,3935,3935,3915,3915,3899,3910,3908,-25,-27,6,234480,16
1667,a1809,20170519,3910,3908,3897,3907,3897,3907,3903,-1,-5,6,234220,20
1668,a1809,20170522,3907,3903,3949,3963,3936,3947,3953,44,50,132,5218160,18
1669,a1809,20170523,3947,3953,0,0,0,3953,3953,0,0,0,0,18
1670,a1809,20170524,3953,3953,3943,3970,3914,3970,3937,17,-16,10,393700,20
1671,a1809,20170525,3970,3937,3971,3971,3948,3952,3957,15,20,6,237420,22
1672,a1809,20170526,3952,3957,3922,3922,3922,3922,3922,-35,-35,2,78440,22
1673,a1809,20170531,3922,3922,3891,3891,3853,3853,3871,-69,-51,12,464540,24
1674,a1809,20170601,3853,3871,0,0,0,3852,3852,-19,-19,0,0,24
1675,a1809,20170602,3852,3852,3830,3844,3828,3840,3833,-12,-19,24,920080,34
1676,a1809,20170605,3840,3833,3832,3862,3825,3862,3842,29,9,12,461040,42
1677,a1809,20170606,3862,3842,3882,3887,3882,3887,3884,45,42,4,155380,38
1678,a1809,20170607,3887,3884,3831,3893,3831,3893,3870,9,-14,14,541920,40
1679,a1809,20170608,3893,3870,3910,3910,3900,3900,3905,30,35,4,156200,40
1680,a1809,20170609,3900,3905,3955,3978,3945,3971,3965,66,60,32,1269100,34
1681,a1809,20170612,3971,3965,3946,3970,3943,3970,3950,5,-15,26,1027120,54
1682,a1809,20170613,3970,3950,3972,3979,3972,3979,3975,29,25,4,159020,50
1683,a1809,20170614,3979,3975,0,0,0,3962,3962,-13,-13,0,0,50
1684,a1809,20170615,3962,3962,3952,3969,3934,3965,3951,3,-11,82,3240200,52
1685,a1809,20170616,3965,3951,3966,4064,3946,3946,3976,-5,25,18,715780,52
1686,a1809,20170619,3946,3976,3948,3948,3948,3948,3948,-28,-28,2,78960,50
1687,a1809,20170620,3948,3948,0,0,0,3948,3948,0,0,0,0,50
1688,a1809,20170621,3948,3948,3950,3950,3910,3910,3932,-38,-16,6,235960,50
1689,a1809,20170622,3910,3932,0,0,0,3913,3913,-19,-19,0,0,50
1690,a1809,20170623,3913,3913,3878,3878,3878,3878,3878,-35,-35,2,77560,50
1691,a1809,20170626,3878,3878,0,0,0,3880,3880,2,2,0,0,50
1692,a1809,20170627,3880,3880,0,0,0,3880,3880,0,0,0,0,50
1693,a1809,20170628,3880,3880,0,0,0,3880,3880,0,0,0,0,50
1694,a1809,20170629,3880,3880,3882,3899,3882,3888,3889,8,9,8,311160,52
1695,a1809,20170630,3888,3889,0,0,0,3889,3889,0,0,0,0,52
1696,a1809,20170703,3889,3889,3937,3945,3937,3945,3942,56,53,42,1655780,64
1697,a1809,20170704,3945,3942,3952,3959,3918,3918,3941,-24,-1,34,1340120,86
1698,a1809,20170705,3918,3941,3938,3938,3933,3933,3935,-8,-6,8,314840,88
1699,a1809,20170706,3933,3935,3930,3930,3895,3898,3911,-37,-24,96,3754960,94
1700,a1809,20170707,3898,3911,3890,3904,3890,3891,3898,-20,-13,16,623800,98
1701,a1809,20170710,3891,3898,3908,3963,3893,3956,3950,58,52,78,3081120,86
1702,a1809,20170711,3956,3950,3979,3984,3979,3984,3980,34,30,12,477680,82
1703,a1809,20170712,3984,3980,3982,3994,3960,3968,3975,-12,-5,18,715560,86
1704,a1809,20170713,3968,3975,3988,3988,3956,3959,3964,-16,-11,8,317180,86
1705,a1809,20170714,3959,3964,3930,3944,3895,3895,3919,-69,-45,26,1019100,88
1706,a1809,20170717,3895,3919,3911,3919,3908,3908,3913,-11,-6,20,782680,96
1707,a1809,20170718,3908,3913,3905,3905,3905,3905,3905,-8,-8,2,78100,94
1708,a1809,20170719,3905,3905,3932,3932,3915,3915,3921,10,16,12,470600,98
1709,a1809,20170720,3915,3921,3926,3942,3926,3942,3936,21,15,6,236160,100
1710,a1809,20170721,3942,3936,3940,3951,3927,3927,3937,-9,1,28,1102480,106
1711,a1809,20170724,3927,3937,3962,3962,3901,3916,3932,-21,-5,26,1022520,104
1712,a1809,20170725,3916,3932,3934,3942,3929,3929,3938,-3,6,14,551360,102
1713,a1809,20170726,3929,3938,3930,3934,3924,3930,3929,-8,-9,12,471580,96
1714,a1809,20170727,3930,3929,3950,3950,3927,3945,3936,16,7,10,393660,92
1715,a1809,20170728,3945,3936,0,0,0,3936,3936,0,0,0,0,92
1716,a1809,20170731,3936,3936,3940,3940,3940,3940,3940,4,4,2,78800,90
1717,a1809,20170801,3940,3940,3940,3953,3940,3945,3945,5,5,30,1183720,114
1718,a1809,20170802,3945,3945,3891,3891,3891,3891,3891,-54,-54,2,77820,116
1719,a1809,20170803,3891,3891,3868,3899,3868,3899,3886,8,-5,10,388640,118
1720,a1809,20170804,3899,3886,0,0,0,3892,3892,6,6,0,0,118
1721,a1809,20170807,3892,3892,3930,3981,3930,3981,3954,89,62,38,1502780,112
1722,a1809,20170808,3981,3954,3989,4030,3980,4010,4005,56,51,88,3525180,86
1723,a1809,20170809,4010,4005,4006,4033,4006,4022,4026,17,21,26,1046840,92
1724,a1809,20170810,4022,4026,4041,4048,4026,4033,4037,7,11,20,807440,92
1725,a1809,20170811,4033,4037,4023,4103,4000,4026,4052,-11,15,78,3160960,104
1726,a1809,20170814,4026,4052,4001,4004,3969,3974,3988,-78,-64,48,1914500,130
1727,a1809,20170815,3974,3988,3984,3984,3968,3968,3979,-20,-9,14,557160,124
1728,a1809,20170816,3968,3979,3915,3961,3915,3946,3935,-33,-44,114,4486420,114
1729,a1809,20170817,3946,3935,3958,3978,3958,3970,3970,35,35,34,1350080,110
1730,a1809,20170818,3970,3970,3981,3981,3953,3953,3967,-17,-3,14,555500,112
1731,a1809,20170821,3953,3967,3981,4002,3980,3982,3994,15,27,30,1198420,104
1732,a1809,20170822,3982,3994,3985,3994,3960,3994,3975,0,-19,28,1113080,110
1733,a1809,20170823,3994,3975,3989,4010,3989,3994,3998,19,23,20,799700,112
1734,a1809,20170824,3994,3998,3995,3995,3983,3983,3989,-15,-9,4,159560,114
1735,a1809,20170825,3983,3989,3982,3982,3982,3982,3982,-7,-7,10,398200,124
1736,a1809,20170828,3982,3982,3987,4018,3987,3999,4005,17,23,52,2082760,146
1737,a1809,20170829,3999,4005,3985,3996,3966,3966,3991,-39,-14,156,6227080,248
1738,a1809,20170830,3966,3991,3977,3981,3968,3968,3973,-23,-18,28,1112680,260
1739,a1809,20170831,3968,3973,3974,3974,3952,3952,3963,-21,-10,28,1109800,262
1740,a1809,20170901,3952,3963,3993,3993,3939,3939,3955,-24,-8,14,553780,270
1741,a1809,20170904,3939,3955,3950,3954,3940,3954,3945,-1,-10,38,1499220,274
1742,a1809,20170905,3954,3945,3956,3957,3932,3932,3944,-13,-1,112,4417980,306
1743,a1809,20170906,3932,3944,3936,3955,3931,3940,3941,-4,-3,42,1655420,322
1744,a1809,20170907,3940,3941,3927,3930,3921,3926,3925,-15,-16,70,2748100,374
1745,a1809,20170908,3926,3925,3928,3941,3925,3937,3929,12,4,60,2357640,374
1746,a1809,20170911,3937,3929,3937,3937,3892,3911,3907,-18,-22,106,4141840,416
1747,a1809,20170912,3911,3907,3912,3912,3900,3905,3904,-2,-3,28,1093360,428
1748,a1809,20170913,3905,3904,3911,3917,3895,3900,3901,-4,-3,86,3355260,450
1749,a1809,20170914,3900,3901,3913,3925,3903,3915,3915,14,14,56,2192420,444
1750,a1809,20170915,3915,3915,3901,3912,3892,3892,3904,-23,-11,118,4607780,486
1751,a1809,20170918,3892,3904,3891,3901,3887,3898,3892,-6,-12,44,1712760,504
1752,a1809,20170919,3898,3892,3885,3905,3885,3893,3895,1,3,44,1714180,522
1753,a1809,20170920,3893,3895,3889,3889,3863,3880,3870,-15,-25,184,7121040,638
1754,a1809,20170921,3880,3870,3878,3881,3854,3860,3874,-10,4,188,7283900,654
1755,a1809,20170922,3860,3874,3863,3894,3854,3893,3877,19,3,192,7444720,664
1756,a1809,20170925,3893,3877,3877,3892,3877,3880,3889,3,12,90,3500500,662
1757,a1809,20170926,3880,3889,3884,3895,3880,3892,3889,3,0,18,700080,656
1758,a1809,20170927,3892,3889,3882,3901,3879,3896,3888,7,-1,88,3421780,640
1759,a1809,20170928,3896,3888,3891,3905,3876,3876,3886,-12,-2,170,6607000,588
1760,a1809,20170929,3876,3886,3880,3890,3874,3878,3882,-8,-4,22,854220,590
1761,a1809,20171009,3878,3882,3895,3899,3867,3899,3877,17,-5,94,3644680,612
1762,a1809,20171010,3899,3877,3894,3910,3886,3888,3897,11,20,340,13252860,614
1763,a1809,20171011,3888,3897,3888,3903,3880,3881,3889,-16,-8,460,17889820,646
1764,a1809,20171012,3881,3889,3875,3885,3864,3870,3874,-19,-15,148,5734160,674
1765,a1809,20171013,3870,3874,3878,3906,3878,3887,3889,13,15,162,6301200,736
1766,a1809,20171016,3887,3889,3875,3910,3875,3892,3891,3,2,102,3969160,744
1767,a1809,20171017,3892,3891,3882,3885,3862,3868,3870,-23,-21,250,9676980,886
1768,a1809,20171018,3868,3870,3865,3865,3840,3844,3848,-26,-22,436,16780600,1054
1769,a1809,20171019,3844,3848,3848,3848,3832,3836,3841,-12,-7,146,5608360,1116
1770,a1809,20171020,3836,3841,3840,3851,3839,3843,3845,2,4,166,6383080,1108
1771,a1809,20171023,3843,3845,3847,3847,3804,3810,3816,-35,-29,248,9464120,1242
1772,a1809,20171024,3810,3816,3804,3816,3789,3789,3805,-27,-11,316,12026040,1286
1773,a1809,20171025,3789,3805,3771,3814,3771,3814,3802,9,-3,112,4259280,1280
1774,a1809,20171026,3814,3802,3806,3806,3788,3791,3798,-11,-4,86,3266620,1304
1775,a1809,20171027,3791,3798,3796,3796,3753,3770,3769,-28,-29,132,4975540,1388
1776,a1809,20171030,3770,3769,3764,3794,3762,3781,3780,12,11,154,5822000,1406
1777,a1809,20171031,3781,3780,3781,3793,3778,3781,3785,1,5,204,7722600,1384
1778,a1809,20171101,3781,3785,3780,3798,3780,3791,3788,6,3,104,3940280,1432
1779,a1809,20171102,3791,3788,3791,3804,3785,3796,3796,8,8,242,9188700,1420
1780,a1809,20171103,3796,3796,3810,3811,3801,3810,3807,14,11,64,2436980,1408
1781,a1809,20171106,3810,3807,3805,3816,3794,3816,3801,9,-6,230,8742320,1416
1782,a1809,20171107,3816,3801,3819,3847,3818,3842,3832,41,31,230,8815000,1354
1783,a1809,20171108,3842,3832,3840,3840,3825,3839,3834,7,2,142,5444580,1332
1784,a1809,20171109,3839,3834,3836,3863,3833,3849,3840,15,6,92,3533420,1302
1785,a1809,20171110,3849,3840,3854,3854,3822,3830,3837,-10,-3,226,8672560,1380
1786,a1809,20171113,3830,3837,3831,3846,3830,3841,3839,4,2,120,4607440,1384
1787,a1809,20171114,3841,3839,3840,3844,3818,3820,3828,-19,-11,276,10566600,1370
1788,a1809,20171115,3820,3828,3828,3829,3792,3816,3814,-12,-14,402,15332440,1584
1789,a1809,20171116,3816,3814,3815,3828,3813,3824,3818,10,4,50,1909080,1586
1790,a1809,20171117,3824,3818,3821,3827,3816,3824,3822,6,4,174,6651240,1638
1791,a1809,20171120,3824,3822,3811,3848,3810,3840,3831,18,9,256,9809520,1588
1792,a1809,20171121,3840,3831,3840,3854,3829,3845,3836,14,5,706,27087480,1708
1793,a1809,20171122,3845,3836,3845,3869,3845,3858,3853,22,17,216,8324500,1620
1794,a1809,20171123,3858,3853,3870,3873,3847,3866,3861,13,8,308,11892960,1576
1795,a1809,20171124,3866,3861,3866,3880,3859,3859,3871,-2,10,344,13319380,1520
1796,a1809,20171127,3859,3871,3867,3871,3841,3857,3858,-14,-13,308,11882720,1628
1797,a1809,20171128,3857,3858,3859,3862,3842,3845,3851,-13,-7,286,11015620,1704
1798,a1809,20171129,3845,3851,3855,3855,3833,3834,3838,-17,-13,220,8444040,1780
1799,a1809,20171130,3834,3838,3832,3839,3776,3776,3808,-62,-30,712,27117140,2180
1800,a1809,20171201,3776,3808,3772,3790,3770,3782,3782,-26,-26,496,18758880,2420
1801,a1809,20171204,3782,3782,3776,3815,3776,3814,3802,32,20,728,27683160,2394
1802,a1809,20171205,3814,3802,3810,3819,3785,3795,3804,-7,2,296,11260380,2398
1803,a1809,20171206,3795,3804,3809,3820,3796,3803,3810,-1,6,366,13948140,2500
1804,a1809,20171207,3803,3810,3808,3813,3725,3730,3753,-80,-57,1616,60654100,3228
1805,a1809,20171208,3730,3753,3730,3731,3707,3714,3716,-39,-37,1690,62805900,3804
1806,a1809,20171211,3714,3716,3716,3716,3672,3677,3692,-39,-24,6268,231473420,5608
1807,a1809,20171212,3677,3692,3677,3683,3661,3668,3670,-24,-22,2626,96397880,6400
1808,a1809,20171213,3668,3670,3666,3683,3637,3668,3666,-2,-4,2710,99358740,7302
1809,a1809,20171214,3668,3666,3671,3682,3664,3675,3672,9,6,2396,87997460,8294
1810,a1809,20171215,3675,3672,3672,3685,3670,3674,3678,2,6,1698,62461640,8590
1811,a1809,20171218,3674,3678,3682,3711,3668,3703,3690,25,12,1790,66058940,8874
1812,a1809,20171219,3703,3690,3707,3708,3685,3702,3700,12,10,2706,100135820,9918
1813,a1809,20171220,3702,3700,3695,3705,3678,3691,3693,-9,-7,1050,38777760,10178
1814,a1809,20171221,3691,3693,3695,3711,3683,3688,3694,-5,1,2318,85639840,10730
1815,a1809,20171222,3688,3694,3690,3692,3630,3643,3653,-51,-41,8076,295086560,12898
1816,a1809,20171225,3643,3653,3643,3699,3638,3695,3672,42,19,3674,134941500,13240
1817,a1809,20171226,3695,3672,3698,3723,3689,3707,3710,35,38,2330,86450740,13312
1818,a1809,20171227,3707,3710,3714,3715,3693,3706,3703,-4,-7,1992,73766040,13662
1819,a1809,20171228,3706,3703,3700,3708,3666,3687,3683,-16,-20,4322,159220480,14512
1820,a1809,20171229,3687,3683,3683,3691,3669,3684,3680,1,-3,3176,116891920,14830
1821,a1811,20170516,3945,3945,0,0,0,3945,3945,0,0,0,0,0
1822,a1811,20170517,3945,3945,0,0,0,3945,3945,0,0,0,0,0
1823,a1811,20170518,3945,3945,0,0,0,3945,3945,0,0,0,0,0
1824,a1811,20170519,3945,3945,0,0,0,3945,3945,0,0,0,0,0
1825,a1811,20170522,3945,3945,0,0,0,3945,3945,0,0,0,0,0
1826,a1811,20170523,3945,3945,0,0,0,3945,3945,0,0,0,0,0
1827,a1811,20170524,3945,3945,0,0,0,3945,3945,0,0,0,0,0
1828,a1811,20170525,3945,3945,0,0,0,3945,3945,0,0,0,0,0
1829,a1811,20170526,3945,3945,0,0,0,3945,3945,0,0,0,0,0
1830,a1811,20170531,3945,3945,0,0,0,3894,3894,-51,-51,0,0,0
1831,a1811,20170601,3894,3894,0,0,0,3894,3894,0,0,0,0,0
1832,a1811,20170602,3894,3894,0,0,0,3894,3894,0,0,0,0,0
1833,a1811,20170605,3894,3894,0,0,0,3894,3894,0,0,0,0,0
1834,a1811,20170606,3894,3894,0,0,0,3894,3894,0,0,0,0,0
1835,a1811,20170607,3894,3894,0,0,0,3894,3894,0,0,0,0,0
1836,a1811,20170608,3894,3894,0,0,0,3894,3894,0,0,0,0,0
1837,a1811,20170609,3894,3894,0,0,0,3894,3894,0,0,0,0,0
1838,a1811,20170612,3894,3894,0,0,0,3880,3880,-14,-14,0,0,0
1839,a1811,20170613,3880,3880,0,0,0,3880,3880,0,0,0,0,0
1840,a1811,20170614,3880,3880,0,0,0,3880,3880,0,0,0,0,0
1841,a1811,20170615,3880,3880,0,0,0,3880,3880,0,0,0,0,0
1842,a1811,20170616,3880,3880,0,0,0,3880,3880,0,0,0,0,0
1843,a1811,20170619,3880,3880,0,0,0,3853,3853,-27,-27,0,0,0
1844,a1811,20170620,3853,3853,0,0,0,3853,3853,0,0,0,0,0
1845,a1811,20170621,3853,3853,0,0,0,3838,3838,-15,-15,0,0,0
1846,a1811,20170622,3838,3838,0,0,0,3819,3819,-19,-19,0,0,0
1847,a1811,20170623,3819,3819,0,0,0,3841,3841,22,22,0,0,0
1848,a1811,20170626,3841,3841,4045,4045,3953,3953,3999,112,158,4,159960,2
1849,a1811,20170627,3953,3999,0,0,0,3948,3948,-51,-51,0,0,2
1850,a1811,20170628,3948,3948,3887,3887,3887,3887,3887,-61,-61,2,77740,0
1851,a1811,20170629,3887,3887,3852,3852,3852,3852,3852,-35,-35,2,77040,2
1852,a1811,20170630,3852,3852,0,0,0,3852,3852,0,0,0,0,2
1853,a1811,20170703,3852,3852,0,0,0,3904,3904,52,52,0,0,2
1854,a1811,20170704,3904,3904,3882,3915,3882,3893,3897,-11,-7,10,389700,4
1855,a1811,20170705,3893,3897,3900,3915,3900,3915,3907,18,10,4,156300,4
1856,a1811,20170706,3915,3907,3880,3880,3860,3860,3870,-47,-37,4,154800,4
1857,a1811,20170707,3860,3870,0,0,0,3870,3870,0,0,0,0,4
1858,a1811,20170710,3870,3870,0,0,0,3921,3921,51,51,0,0,4
1859,a1811,20170711,3921,3921,0,0,0,3921,3921,0,0,0,0,4
1860,a1811,20170712,3921,3921,0,0,0,3917,3917,-4,-4,0,0,4
1861,a1811,20170713,3917,3917,0,0,0,3917,3917,0,0,0,0,4
1862,a1811,20170714,3917,3917,0,0,0,3873,3873,-44,-44,0,0,4
1863,a1811,20170717,3873,3873,0,0,0,3873,3873,0,0,0,0,4
1864,a1811,20170718,3873,3873,0,0,0,3873,3873,0,0,0,0,4
1865,a1811,20170719,3873,3873,0,0,0,3873,3873,0,0,0,0,4
1866,a1811,20170720,3873,3873,0,0,0,3873,3873,0,0,0,0,4
1867,a1811,20170721,3873,3873,0,0,0,3873,3873,0,0,0,0,4
1868,a1811,20170724,3873,3873,3971,3973,3946,3950,3968,77,95,24,952360,22
1869,a1811,20170725,3950,3968,3961,3961,3935,3935,3939,-33,-29,14,551580,8
1870,a1811,20170726,3935,3939,0,0,0,3939,3939,0,0,0,0,8
1871,a1811,20170727,3939,3939,3941,3981,3941,3981,3961,42,22,4,158440,10
1872,a1811,20170728,3981,3961,3962,3962,3962,3962,3962,1,1,2,79240,8
1873,a1811,20170731,3962,3962,0,0,0,3962,3962,0,0,0,0,8
1874,a1811,20170801,3962,3962,3980,3980,3928,3935,3942,-27,-20,8,315420,10
1875,a1811,20170802,3935,3942,3942,3942,3942,3942,3942,0,0,2,78840,8
1876,a1811,20170803,3942,3942,0,0,0,3942,3942,0,0,0,0,8
1877,a1811,20170804,3942,3942,0,0,0,3942,3942,0,0,0,0,8
1878,a1811,20170807,3942,3942,0,0,0,4004,4004,62,62,0,0,8
1879,a1811,20170808,4004,4004,3987,3987,3987,3987,3987,-17,-17,8,318960,8
1880,a1811,20170809,3987,3987,3992,4048,3992,4048,4027,61,40,10,402720,8
1881,a1811,20170810,4048,4027,4031,4031,4025,4025,4028,-2,1,4,161120,8
1882,a1811,20170811,4025,4028,4057,4057,4031,4031,4044,3,16,4,161760,8
1883,a1811,20170814,4031,4044,4000,4020,4000,4020,4014,-24,-30,8,321140,10
1884,a1811,20170815,4020,4014,3980,3980,3980,3980,3980,-34,-34,2,79600,10
1885,a1811,20170816,3980,3980,3960,4007,3960,4007,3993,27,13,8,319500,4
1886,a1811,20170817,4007,3993,0,0,0,3993,3993,0,0,0,0,4
1887,a1811,20170818,3993,3993,0,0,0,3993,3993,0,0,0,0,4
1888,a1811,20170821,3993,3993,0,0,0,3993,3993,0,0,0,0,4
1889,a1811,20170822,3993,3993,0,0,0,3975,3975,-18,-18,0,0,4
1890,a1811,20170823,3975,3975,4030,4030,3997,3997,4013,22,38,4,160540,2
1891,a1811,20170824,3997,4013,0,0,0,4004,4004,-9,-9,0,0,2
1892,a1811,20170825,4004,4004,0,0,0,4004,4004,0,0,0,0,2
1893,a1811,20170828,4004,4004,0,0,0,4004,4004,0,0,0,0,2
1894,a1811,20170829,4004,4004,0,0,0,4004,4004,0,0,0,0,2
1895,a1811,20170830,4004,4004,0,0,0,3986,3986,-18,-18,0,0,2
1896,a1811,20170831,3986,3986,0,0,0,3976,3976,-10,-10,0,0,2
1897,a1811,20170901,3976,3976,0,0,0,3968,3968,-8,-8,0,0,2
1898,a1811,20170904,3968,3968,3984,3984,3931,3975,3959,7,-9,8,316720,2
1899,a1811,20170905,3975,3959,0,0,0,3959,3959,0,0,0,0,2
1900,a1811,20170906,3959,3959,0,0,0,3956,3956,-3,-3,0,0,2
1901,a1811,20170907,3956,3956,0,0,0,3940,3940,-16,-16,0,0,2
1902,a1811,20170908,3940,3940,0,0,0,3940,3940,0,0,0,0,2
1903,a1811,20170911,3940,3940,0,0,0,3940,3940,0,0,0,0,2
1904,a1811,20170912,3940,3940,0,0,0,3940,3940,0,0,0,0,2
1905,a1811,20170913,3940,3940,0,0,0,3940,3940,0,0,0,0,2
1906,a1811,20170914,3940,3940,0,0,0,3940,3940,0,0,0,0,2
1907,a1811,20170915,3940,3940,0,0,0,3934,3934,-6,-6,0,0,2
1908,a1811,20170918,3934,3934,0,0,0,3934,3934,0,0,0,0,2
1909,a1811,20170919,3934,3934,0,0,0,3934,3934,0,0,0,0,2
1910,a1811,20170920,3934,3934,3964,3964,3858,3864,3879,-70,-55,12,465560,2
1911,a1811,20170921,3864,3879,0,0,0,3879,3879,0,0,0,0,2
1912,a1811,20170922,3879,3879,0,0,0,3882,3882,3,3,0,0,2
1913,a1811,20170925,3882,3882,0,0,0,3894,3894,12,12,0,0,2
1914,a1811,20170926,3894,3894,0,0,0,3894,3894,0,0,0,0,2
1915,a1811,20170927,3894,3894,0,0,0,3893,3893,-1,-1,0,0,2
1916,a1811,20170928,3893,3893,0,0,0,3893,3893,0,0,0,0,2
1917,a1811,20170929,3893,3893,0,0,0,3893,3893,0,0,0,0,2
1918,a1811,20171009,3893,3893,0,0,0,3888,3888,-5,-5,0,0,2
1919,a1811,20171010,3888,3888,0,0,0,3888,3888,0,0,0,0,2
1920,a1811,20171011,3888,3888,0,0,0,3888,3888,0,0,0,0,2
1921,a1811,20171012,3888,3888,0,0,0,3874,3874,-14,-14,0,0,2
1922,a1811,20171013,3874,3874,0,0,0,3874,3874,0,0,0,0,2
1923,a1811,20171016,3874,3874,0,0,0,3874,3874,0,0,0,0,2
1924,a1811,20171017,3874,3874,0,0,0,3854,3854,-20,-20,0,0,2
1925,a1811,20171018,3854,3854,0,0,0,3854,3854,0,0,0,0,2
1926,a1811,20171019,3854,3854,0,0,0,3854,3854,0,0,0,0,2
1927,a1811,20171020,3854,3854,0,0,0,3854,3854,0,0,0,0,2
1928,a1811,20171023,3854,3854,0,0,0,3825,3825,-29,-29,0,0,2
1929,a1811,20171024,3825,3825,0,0,0,3825,3825,0,0,0,0,2
1930,a1811,20171025,3825,3825,0,0,0,3825,3825,0,0,0,0,2
1931,a1811,20171026,3825,3825,0,0,0,3821,3821,-4,-4,0,0,2
1932,a1811,20171027,3821,3821,0,0,0,3792,3792,-29,-29,0,0,2
1933,a1811,20171030,3792,3792,0,0,0,3792,3792,0,0,0,0,2
1934,a1811,20171031,3792,3792,0,0,0,3792,3792,0,0,0,0,2
1935,a1811,20171101,3792,3792,0,0,0,3792,3792,0,0,0,0,2
1936,a1811,20171102,3792,3792,0,0,0,3792,3792,0,0,0,0,2
1937,a1811,20171103,3792,3792,0,0,0,3795,3795,3,3,0,0,2
1938,a1811,20171106,3795,3795,0,0,0,3790,3790,-5,-5,0,0,2
1939,a1811,20171107,3790,3790,0,0,0,3820,3820,30,30,0,0,2
1940,a1811,20171108,3820,3820,0,0,0,3831,3831,11,11,0,0,2
1941,a1811,20171109,3831,3831,3871,3871,3837,3837,3854,6,23,4,154160,4
1942,a1811,20171110,3837,3854,0,0,0,3854,3854,0,0,0,0,4
1943,a1811,20171113,3854,3854,0,0,0,3854,3854,0,0,0,0,4
1944,a1811,20171114,3854,3854,0,0,0,3854,3854,0,0,0,0,4
1945,a1811,20171115,3854,3854,0,0,0,3854,3854,0,0,0,0,4
1946,a1811,20171116,3854,3854,0,0,0,3854,3854,0,0,0,0,4
1947,a1811,20171117,3854,3854,0,0,0,3854,3854,0,0,0,0,4
1948,a1811,20171120,3854,3854,0,0,0,3854,3854,0,0,0,0,4
1949,a1811,20171121,3854,3854,0,0,0,3854,3854,0,0,0,0,4
1950,a1811,20171122,3854,3854,0,0,0,3854,3854,0,0,0,0,4
1951,a1811,20171123,3854,3854,0,0,0,3854,3854,0,0,0,0,4
1952,a1811,20171124,3854,3854,0,0,0,3854,3854,0,0,0,0,4
1953,a1811,20171127,3854,3854,0,0,0,3854,3854,0,0,0,0,4
1954,a1811,20171128,3854,3854,0,0,0,3854,3854,0,0,0,0,4
1955,a1811,20171129,3854,3854,0,0,0,3854,3854,0,0,0,0,4
1956,a1811,20171130,3854,3854,0,0,0,3824,3824,-30,-30,0,0,4
1957,a1811,20171201,3824,3824,0,0,0,3818,3818,-6,-6,0,0,4
1958,a1811,20171204,3818,3818,0,0,0,3818,3818,0,0,0,0,4
1959,a1811,20171205,3818,3818,0,0,0,3818,3818,0,0,0,0,4
1960,a1811,20171206,3818,3818,0,0,0,3818,3818,0,0,0,0,4
1961,a1811,20171207,3818,3818,0,0,0,3818,3818,0,0,0,0,4
1962,a1811,20171208,3818,3818,0,0,0,3818,3818,0,0,0,0,4
1963,a1811,20171211,3818,3818,0,0,0,3818,3818,0,0,0,0,4
1964,a1811,20171212,3818,3818,0,0,0,3796,3796,-22,-22,0,0,4
1965,a1811,20171213,3796,3796,0,0,0,3796,3796,0,0,0,0,4
1966,a1811,20171214,3796,3796,0,0,0,3796,3796,0,0,0,0,4
1967,a1811,20171215,3796,3796,0,0,0,3796,3796,0,0,0,0,4
1968,a1811,20171218,3796,3796,0,0,0,3796,3796,0,0,0,0,4
1969,a1811,20171219,3796,3796,0,0,0,3806,3806,10,10,0,0,4
1970,a1811,20171220,3806,3806,0,0,0,3806,3806,0,0,0,0,4
1971,a1811,20171221,3806,3806,0,0,0,3806,3806,0,0,0,0,4
1972,a1811,20171222,3806,3806,0,0,0,3764,3764,-42,-42,0,0,4
1973,a1811,20171225,3764,3764,0,0,0,3764,3764,0,0,0,0,4
1974,a1811,20171226,3764,3764,0,0,0,3764,3764,0,0,0,0,4
1975,a1811,20171227,3764,3764,0,0,0,3764,3764,0,0,0,0,4
1976,a1811,20171228,3764,3764,0,0,0,3764,3764,0,0,0,0,4
1977,a1811,20171229,3764,3764,0,0,0,3764,3764,0,0,0,0,4
1978,a1901,20170717,3873,3873,0,0,0,3880,3880,7,7,0,0,0
1979,a1901,20170718,3880,3880,0,0,0,3880,3880,0,0,0,0,0
1980,a1901,20170719,3880,3880,0,0,0,3906,3906,26,26,0,0,0
1981,a1901,20170720,3906,3906,0,0,0,3906,3906,0,0,0,0,0
1982,a1901,20170721,3906,3906,3930,3991,3923,3923,3953,17,47,12,474460,0
1983,a1901,20170724,3923,3953,3926,3926,3924,3924,3925,-29,-28,4,157000,2
1984,a1901,20170725,3924,3925,0,0,0,3925,3925,0,0,0,0,2
1985,a1901,20170726,3925,3925,3959,3959,3959,3959,3959,34,34,2,79180,4
1986,a1901,20170727,3959,3959,3926,3966,3923,3966,3946,7,-13,10,394640,6
1987,a1901,20170728,3966,3946,0,0,0,3946,3946,0,0,0,0,6
1988,a1901,20170731,3946,3946,3979,3979,3979,3979,3979,33,33,2,79580,6
1989,a1901,20170801,3979,3979,3966,3966,3966,3966,3966,-13,-13,2,79320,8
1990,a1901,20170802,3966,3966,3912,3912,3909,3909,3909,-57,-57,28,1094620,34
1991,a1901,20170803,3909,3909,3908,3962,3906,3962,3917,53,8,32,1253500,8
1992,a1901,20170804,3962,3917,3954,3954,3913,3920,3933,3,16,50,1966900,6
1993,a1901,20170807,3920,3933,0,0,0,3970,3970,37,37,0,0,6
1994,a1901,20170808,3970,3970,3991,4006,3991,4006,4005,36,35,82,3284620,58
1995,a1901,20170809,4006,4005,4022,4040,4022,4040,4037,35,32,36,1453460,30
1996,a1901,20170810,4040,4037,4048,4125,4033,4125,4078,88,41,72,2936440,42
1997,a1901,20170811,4125,4078,4120,4120,4028,4042,4078,-36,0,84,3425620,18
1998,a1901,20170814,4042,4078,4010,4010,4010,4010,4010,-68,-68,6,240600,12
1999,a1901,20170815,4010,4010,3992,3992,3992,3992,3992,-18,-18,2,79840,10
2000,a1901,20170816,3992,3992,0,0,0,3992,3992,0,0,0,0,10
2001,a1901,20170817,3992,3992,3989,4035,3989,4035,4019,43,27,6,241180,16
2002,a1901,20170818,4035,4019,4015,4015,4015,4015,4015,-4,-4,6,240900,20
2003,a1901,20170821,4015,4015,4014,4048,3976,4048,4017,33,2,36,1446260,22
2004,a1901,20170822,4048,4017,4069,4070,4022,4070,4042,53,25,28,1131860,22
2005,a1901,20170823,4070,4042,4053,4053,4032,4042,4036,0,-6,30,1210940,16
2006,a1901,20170824,4042,4036,4018,4018,4006,4006,4010,-30,-26,6,240620,20
2007,a1901,20170825,4006,4010,4006,4017,4000,4001,4001,-9,-9,34,1360620,50
2008,a1901,20170828,4001,4001,4014,4020,3984,3984,4008,-17,7,44,1763720,60
2009,a1901,20170829,3984,4008,3958,4023,3958,4023,3999,15,-9,54,2159680,42
2010,a1901,20170830,4023,3999,4001,4002,3967,3967,3986,-32,-13,20,797200,44
2011,a1901,20170831,3967,3986,3991,3997,3983,3983,3989,-3,3,36,1436040,48
2012,a1901,20170901,3983,3989,3990,3990,3978,3987,3984,-2,-5,28,1115640,50
2013,a1901,20170904,3987,3984,3989,3989,3981,3981,3982,-3,-2,42,1672800,76
2014,a1901,20170905,3981,3982,3984,3987,3974,3987,3981,5,-1,28,1114780,60
2015,a1901,20170906,3987,3981,3996,3996,3980,3980,3983,-1,2,18,716940,72
2016,a1901,20170907,3980,3983,3977,3980,3975,3975,3978,-8,-5,22,875240,80
2017,a1901,20170908,3975,3978,3966,3992,3961,3990,3978,12,0,38,1511820,100
2018,a1901,20170911,3990,3978,3990,3990,3943,3963,3952,-15,-26,32,1264840,94
2019,a1901,20170912,3963,3952,3962,3975,3962,3975,3968,23,16,8,317440,96
2020,a1901,20170913,3975,3968,3961,3961,3936,3952,3949,-16,-19,20,789920,86
2021,a1901,20170914,3952,3949,4099,4099,3956,3977,4029,28,80,70,2820640,86
2022,a1901,20170915,3977,4029,3957,3978,3957,3961,3969,-68,-60,20,793860,92
2023,a1901,20170918,3961,3969,3951,3959,3940,3959,3945,-10,-24,12,473460,86
2024,a1901,20170919,3959,3945,3949,3964,3949,3964,3960,19,15,16,633600,96
2025,a1901,20170920,3964,3960,3809,3939,3809,3922,3901,-38,-59,128,4994080,124
2026,a1901,20170921,3922,3901,3927,3927,3908,3908,3917,7,16,6,235040,122
2027,a1901,20170922,3908,3917,3906,3946,3906,3943,3916,26,-1,88,3446820,104
2028,a1901,20170925,3943,3916,3943,3943,3932,3932,3934,16,18,22,865580,104
2029,a1901,20170926,3932,3934,3922,3936,3922,3936,3931,2,-3,6,235860,106
2030,a1901,20170927,3936,3931,3928,3948,3928,3948,3935,17,4,14,550980,108
2031,a1901,20170928,3948,3935,3786,3932,3786,3926,3891,-9,-44,108,4202620,102
2032,a1901,20170929,3926,3891,3912,3926,3912,3926,3920,35,29,6,235200,104
2033,a1901,20171009,3926,3920,3938,3957,3920,3935,3939,15,19,20,787920,110
2034,a1901,20171010,3935,3939,3949,3955,3933,3941,3945,2,6,60,2367200,118
2035,a1901,20171011,3941,3945,3919,3946,3919,3920,3926,-25,-19,96,3769480,152
2036,a1901,20171012,3920,3926,3926,3939,3918,3920,3933,-6,7,36,1415900,150
2037,a1901,20171013,3920,3933,3945,3950,3939,3939,3944,6,11,6,236680,148
2038,a1901,20171016,3939,3944,3940,3940,3940,3940,3940,-4,-4,10,394000,148
2039,a1901,20171017,3940,3940,3921,3925,3911,3915,3918,-25,-22,10,391860,150
2040,a1901,20171018,3915,3918,3912,3918,3899,3908,3913,-10,-5,82,3209340,160
2041,a1901,20171019,3908,3913,3900,3902,3900,3902,3901,-11,-12,8,312080,162
2042,a1901,20171020,3902,3901,3906,3906,3906,3906,3906,5,5,2,78120,162
2043,a1901,20171023,3906,3906,3910,3910,3875,3875,3889,-31,-17,24,933540,176
2044,a1901,20171024,3875,3889,3875,3880,3855,3855,3869,-34,-20,26,1006120,188
2045,a1901,20171025,3855,3869,3865,3878,3856,3870,3865,1,-4,24,927640,190
2046,a1901,20171026,3870,3865,3872,3872,3860,3860,3865,-5,0,8,309260,190
2047,a1901,20171027,3860,3865,3856,3856,3828,3828,3838,-37,-27,14,537420,194
2048,a1901,20171030,3828,3838,3837,3850,3837,3850,3846,12,8,14,538520,202
2049,a1901,20171031,3850,3846,3839,3845,3827,3841,3837,-5,-9,88,3376820,206
2050,a1901,20171101,3841,3837,3849,3851,3847,3847,3847,10,10,60,2308360,248
2051,a1901,20171102,3847,3847,3846,3847,3846,3847,3846,0,-1,4,153860,250
2052,a1901,20171103,3847,3846,3851,3862,3851,3854,3856,8,10,32,1233920,252
2053,a1901,20171106,3854,3856,3851,3862,3851,3862,3855,6,-1,16,616860,246
2054,a1901,20171107,3862,3855,3877,3897,3877,3889,3886,34,31,14,544080,242
2055,a1901,20171108,3889,3886,3894,3894,3894,3894,3894,8,8,2,77880,244
2056,a1901,20171109,3894,3894,3889,3899,3889,3899,3894,5,0,6,233660,244
2057,a1901,20171110,3899,3894,3904,3904,3881,3884,3892,-10,-2,10,389260,240
2058,a1901,20171113,3884,3892,3890,3905,3890,3895,3898,3,6,20,779780,254
2059,a1901,20171114,3895,3898,3891,3892,3883,3886,3887,-12,-11,20,777560,254
2060,a1901,20171115,3886,3887,3852,3891,3852,3880,3877,-7,-10,80,3102340,240
2061,a1901,20171116,3880,3877,3888,3888,3880,3880,3884,3,7,4,155360,240
2062,a1901,20171117,3880,3884,0,0,0,3884,3884,0,0,0,0,240
2063,a1901,20171120,3884,3884,3880,3910,3880,3910,3903,26,19,68,2654580,276
2064,a1901,20171121,3910,3903,3903,3937,3900,3933,3917,30,14,120,4700580,258
2065,a1901,20171122,3933,3917,3923,3933,3920,3928,3927,11,10,46,1806760,252
2066,a1901,20171123,3928,3927,3931,3931,3922,3922,3926,-5,-1,6,235560,246
2067,a1901,20171124,3922,3926,3917,3940,3917,3939,3938,13,12,56,2205640,260
2068,a1901,20171127,3939,3938,3928,3937,3910,3927,3928,-11,-10,38,1492860,284
2069,a1901,20171128,3927,3928,3934,3935,3908,3908,3919,-20,-9,44,1724600,284
2070,a1901,20171129,3908,3919,3910,3918,3902,3902,3911,-17,-8,70,2738040,316
2071,a1901,20171130,3902,3911,3902,3907,3875,3875,3884,-36,-27,46,1787060,350
2072,a1901,20171201,3875,3884,3870,3913,3830,3862,3872,-22,-12,42,1626620,364
2073,a1901,20171204,3862,3872,3879,3899,3849,3881,3882,9,10,90,3494320,352
2074,a1901,20171205,3881,3882,3895,3898,3876,3876,3891,-6,9,20,778320,364
2075,a1901,20171206,3876,3891,3877,3890,3876,3880,3878,-11,-13,50,1939220,332
2076,a1901,20171207,3880,3878,3866,3890,3777,3835,3847,-43,-31,200,7694420,428
2077,a1901,20171208,3835,3847,3806,3816,3803,3811,3810,-36,-37,60,2286240,458
2078,a1901,20171211,3811,3810,3802,3809,3768,3768,3787,-42,-23,146,5529060,534
2079,a1901,20171212,3768,3787,3776,3777,3740,3750,3754,-37,-33,260,9762420,648
2080,a1901,20171213,3750,3754,3750,3760,3728,3749,3745,-5,-9,184,6892480,768
2081,a1901,20171214,3749,3745,3757,3760,3745,3755,3752,10,7,124,4653000,802
2082,a1901,20171215,3755,3752,3764,3765,3749,3754,3756,2,4,134,5033420,840
2083,a1901,20171218,3754,3756,3759,3795,3748,3787,3766,31,10,76,2862480,860
2084,a1901,20171219,3787,3766,3773,3781,3760,3769,3771,3,5,66,2489020,880
2085,a1901,20171220,3769,3771,3776,3779,3756,3762,3767,-9,-4,32,1205720,874
2086,a1901,20171221,3762,3767,3761,3780,3752,3780,3767,13,0,50,1883740,852
2087,a1901,20171222,3780,3767,3756,3756,3706,3719,3726,-48,-41,192,7155800,848
2088,a1901,20171225,3719,3726,3717,3775,3716,3775,3741,49,15,164,6136360,830
2089,a1901,20171226,3775,3741,3783,3809,3775,3789,3796,48,55,490,18600500,1150
2090,a1901,20171227,3789,3796,3799,3799,3780,3785,3792,-11,-4,50,1896460,1190
2091,a1901,20171228,3785,3792,3785,3794,3755,3778,3771,-14,-21,100,3771260,1260
2092,a1901,20171229,3778,3771,3774,3774,3755,3760,3761,-11,-10,132,4965560,1178
2093,a1903,20170915,4029,4029,0,0,0,4029,4029,0,0,0,0,0
2094,a1903,20170918,4029,4029,0,0,0,4029,4029,0,0,0,0,0
2095,a1903,20170919,4029,4029,0,0,0,4029,4029,0,0,0,0,0
2096,a1903,20170920,4029,4029,0,0,0,3957,3957,-72,-72,0,0,0
2097,a1903,20170921,3957,3957,0,0,0,3941,3941,-16,-16,0,0,0
2098,a1903,20170922,3941,3941,0,0,0,3941,3941,0,0,0,0,0
2099,a1903,20170925,3941,3941,0,0,0,3941,3941,0,0,0,0,0
2100,a1903,20170926,3941,3941,0,0,0,3941,3941,0,0,0,0,0
2101,a1903,20170927,3941,3941,0,0,0,3941,3941,0,0,0,0,0
2102,a1903,20170928,3941,3941,0,0,0,3941,3941,0,0,0,0,0
2103,a1903,20170929,3941,3941,0,0,0,3941,3941,0,0,0,0,0
2104,a1903,20171009,3941,3941,0,0,0,3941,3941,0,0,0,0,0
2105,a1903,20171010,3941,3941,0,0,0,3941,3941,0,0,0,0,0
2106,a1903,20171011,3941,3941,0,0,0,3941,3941,0,0,0,0,0
2107,a1903,20171012,3941,3941,0,0,0,3941,3941,0,0,0,0,0
2108,a1903,20171013,3941,3941,0,0,0,3941,3941,0,0,0,0,0
2109,a1903,20171016,3941,3941,0,0,0,3941,3941,0,0,0,0,0
2110,a1903,20171017,3941,3941,0,0,0,3941,3941,0,0,0,0,0
2111,a1903,20171018,3941,3941,0,0,0,3933,3933,-8,-8,0,0,0
2112,a1903,20171019,3933,3933,3879,3906,3874,3899,3885,-34,-48,12,466240,4
2113,a1903,20171020,3899,3885,0,0,0,3885,3885,0,0,0,0,4
2114,a1903,20171023,3885,3885,0,0,0,3885,3885,0,0,0,0,4
2115,a1903,20171024,3885,3885,0,0,0,3870,3870,-15,-15,0,0,4
2116,a1903,20171025,3870,3870,0,0,0,3870,3870,0,0,0,0,4
2117,a1903,20171026,3870,3870,0,0,0,3868,3868,-2,-2,0,0,4
2118,a1903,20171027,3868,3868,0,0,0,3846,3846,-22,-22,0,0,4
2119,a1903,20171030,3846,3846,0,0,0,3846,3846,0,0,0,0,4
2120,a1903,20171031,3846,3846,0,0,0,3846,3846,0,0,0,0,4
2121,a1903,20171101,3846,3846,3860,3860,3860,3860,3860,14,14,4,154400,2
2122,a1903,20171102,3860,3860,3863,3863,3863,3863,3863,3,3,2,77260,2
2123,a1903,20171103,3863,3863,0,0,0,3863,3863,0,0,0,0,2
2124,a1903,20171106,3863,3863,0,0,0,3863,3863,0,0,0,0,2
2125,a1903,20171107,3863,3863,0,0,0,3863,3863,0,0,0,0,2
2126,a1903,20171108,3863,3863,0,0,0,3863,3863,0,0,0,0,2
2127,a1903,20171109,3863,3863,0,0,0,3880,3880,17,17,0,0,2
2128,a1903,20171110,3880,3880,0,0,0,3880,3880,0,0,0,0,2
2129,a1903,20171113,3880,3880,0,0,0,3880,3880,0,0,0,0,2
2130,a1903,20171114,3880,3880,0,0,0,3880,3880,0,0,0,0,2
2131,a1903,20171115,3880,3880,0,0,0,3880,3880,0,0,0,0,2
2132,a1903,20171116,3880,3880,0,0,0,3880,3880,0,0,0,0,2
2133,a1903,20171117,3880,3880,0,0,0,3880,3880,0,0,0,0,2
2134,a1903,20171120,3880,3880,0,0,0,3880,3880,0,0,0,0,2
2135,a1903,20171121,3880,3880,3850,3930,3850,3919,3892,39,12,252,9808440,2
2136,a1903,20171122,3919,3892,0,0,0,3901,3901,9,9,0,0,2
2137,a1903,20171123,3901,3901,0,0,0,3901,3901,0,0,0,0,2
2138,a1903,20171124,3901,3901,0,0,0,3901,3901,0,0,0,0,2
2139,a1903,20171127,3901,3901,0,0,0,3901,3901,0,0,0,0,2
2140,a1903,20171128,3901,3901,0,0,0,3901,3901,0,0,0,0,2
2141,a1903,20171129,3901,3901,0,0,0,3901,3901,0,0,0,0,2
2142,a1903,20171130,3901,3901,0,0,0,3901,3901,0,0,0,0,2
2143,a1903,20171201,3901,3901,0,0,0,3884,3884,-17,-17,0,0,2
2144,a1903,20171204,3884,3884,0,0,0,3884,3884,0,0,0,0,2
2145,a1903,20171205,3884,3884,0,0,0,3884,3884,0,0,0,0,2
2146,a1903,20171206,3884,3884,0,0,0,3884,3884,0,0,0,0,2
2147,a1903,20171207,3884,3884,0,0,0,3853,3853,-31,-31,0,0,2
2148,a1903,20171208,3853,3853,0,0,0,3853,3853,0,0,0,0,2
2149,a1903,20171211,3853,3853,0,0,0,3853,3853,0,0,0,0,2
2150,a1903,20171212,3853,3853,0,0,0,3820,3820,-33,-33,0,0,2
2151,a1903,20171213,3820,3820,3815,3816,3810,3810,3814,-10,-6,14,534080,14
2152,a1903,20171214,3810,3814,3801,3806,3801,3806,3803,-8,-11,4,152140,14
2153,a1903,20171215,3806,3803,0,0,0,3803,3803,0,0,0,0,14
2154,a1903,20171218,3803,3803,0,0,0,3813,3813,10,10,0,0,14
2155,a1903,20171219,3813,3813,0,0,0,3813,3813,0,0,0,0,14
2156,a1903,20171220,3813,3813,0,0,0,3813,3813,0,0,0,0,14
2157,a1903,20171221,3813,3813,0,0,0,3813,3813,0,0,0,0,14
2158,a1903,20171222,3813,3813,0,0,0,3772,3772,-41,-41,0,0,14
2159,a1903,20171225,3772,3772,3780,3780,3780,3780,3780,8,8,4,151200,10
2160,a1903,20171226,3780,3780,0,0,0,3835,3835,55,55,0,0,10
2161,a1903,20171227,3835,3835,0,0,0,3835,3835,0,0,0,0,10
2162,a1903,20171228,3835,3835,0,0,0,3834,3834,-1,-1,0,0,10
2163,a1903,20171229,3834,3834,3791,3791,3776,3776,3783,-58,-51,4,151340,6
2164,a1905,20171115,3880,3880,0,0,0,3881,3881,1,1,0,0,0
2165,a1905,20171116,3881,3881,0,0,0,3892,3892,11,11,0,0,0
2166,a1905,20171117,3892,3892,0,0,0,3892,3892,0,0,0,0,0
2167,a1905,20171120,3892,3892,3902,3902,3902,3902,3902,10,10,2,78040,2
2168,a1905,20171121,3902,3902,3905,3960,3905,3944,3927,42,25,298,11703200,2
2169,a1905,20171122,3944,3927,0,0,0,3941,3941,14,14,0,0,2
2170,a1905,20171123,3941,3941,0,0,0,3941,3941,0,0,0,0,2
2171,a1905,20171124,3941,3941,3987,3987,3952,3952,3969,11,28,8,317520,2
2172,a1905,20171127,3952,3969,3933,3969,3933,3969,3956,0,-13,8,316540,6
2173,a1905,20171128,3969,3956,3981,3981,3953,3953,3961,-3,5,8,316940,8
2174,a1905,20171129,3953,3961,3963,3963,3949,3955,3955,-6,-6,6,237340,12
2175,a1905,20171130,3955,3955,3936,3936,3920,3920,3928,-35,-27,10,392860,22
2176,a1905,20171201,3920,3928,0,0,0,3928,3928,0,0,0,0,22
2177,a1905,20171204,3928,3928,3958,3958,3955,3957,3957,29,29,8,316560,30
2178,a1905,20171205,3957,3957,0,0,0,3957,3957,0,0,0,0,30
2179,a1905,20171206,3957,3957,0,0,0,3957,3957,0,0,0,0,30
2180,a1905,20171207,3957,3957,3885,3885,3885,3885,3885,-72,-72,2,77700,32
2181,a1905,20171208,3885,3885,3901,3903,3879,3898,3890,13,5,14,544620,38
2182,a1905,20171211,3898,3890,3860,3875,3855,3855,3867,-35,-23,18,696100,34
2183,a1905,20171212,3855,3867,3867,3867,3823,3828,3838,-39,-29,28,1074760,38
2184,a1905,20171213,3828,3838,3816,3850,3815,3850,3835,12,-3,16,613640,42
2185,a1905,20171214,3850,3835,3829,3829,3829,3829,3829,-6,-6,2,76580,40
2186,a1905,20171215,3829,3829,3852,3852,3832,3842,3838,13,9,22,844440,48
2187,a1905,20171218,3842,3838,3853,3863,3853,3863,3855,25,17,8,308460,54
2188,a1905,20171219,3863,3855,0,0,0,3855,3855,0,0,0,0,54
2189,a1905,20171220,3855,3855,3868,3868,3862,3862,3864,7,9,6,231860,52
2190,a1905,20171221,3862,3864,3840,3863,3840,3863,3849,-1,-15,10,384900,46
2191,a1905,20171222,3863,3849,3820,3821,3790,3793,3805,-56,-44,24,913380,30
2192,a1905,20171225,3793,3805,3794,3827,3794,3827,3813,22,8,12,457620,34
2193,a1905,20171226,3827,3813,3875,3875,3862,3862,3868,49,55,4,154740,32
2194,a1905,20171227,3862,3868,3875,3875,3862,3862,3870,-6,2,14,541840,32
2195,a1905,20171228,3862,3870,3858,3859,3834,3854,3850,-16,-20,18,693160,40
2196,a1905,20171229,3854,3850,3849,3851,3840,3851,3846,1,-4,18,692320,44
