ROWNUM,合约,日期,前收盘价,前结算价,开盘价,最高价,最低价,收盘价,结算价,涨跌1,涨跌2,成交量,成交金额,持仓量
1,y1701,20170103,6900,6890,6920,6956,6744,6744,6852,-146,-38,3494,239414040,16466
2,y1701,20170104,6744,6852,6846,6850,6770,6850,6830,-2,-22,1600,109297480,16066
3,y1701,20170105,6850,6830,6850,6850,6850,6850,6850,20,20,2042,139877000,16142
4,y1701,20170106,6850,6850,6850,6850,6850,6850,6850,0,0,174,11919000,14356
5,y1701,20170109,6850,6850,0,0,0,6840,6840,-10,-10,0,0,9356
6,y1701,20170110,6840,6840,6820,6820,6664,6820,6772,-20,-68,66,4470000,966
7,y1701,20170111,6820,6772,6860,6860,6860,6860,6862,88,90,18,1235360,450
8,y1701,20170112,6860,6862,6870,6870,6860,6860,6864,-2,2,40,2745720,60
9,y1701,20170113,6860,6864,0,0,0,6864,6864,0,0,0,0,0
10,y1701,20170116,6864,6864,0,0,0,6846,6846,-18,-18,0,0,0
11,y1703,20170103,6832,6832,0,0,0,6832,6832,0,0,0,0,4
12,y1703,20170104,6832,6832,6866,6866,6866,6866,6866,34,34,2,137320,2
13,y1703,20170105,6866,6866,0,0,0,6866,6866,0,0,0,0,2
14,y1703,20170106,6866,6866,0,0,0,6866,6866,0,0,0,0,2
15,y1703,20170109,6866,6866,0,0,0,6866,6866,0,0,0,0,2
16,y1703,20170110,6866,6866,0,0,0,6866,6866,0,0,0,0,2
17,y1703,20170111,6866,6866,6928,6928,6928,6928,6928,62,62,4,277120,4
18,y1703,20170112,6928,6928,0,0,0,6928,6928,0,0,0,0,4
19,y1703,20170113,6928,6928,0,0,0,6928,6928,0,0,0,0,4
20,y1703,20170116,6928,6928,6942,6942,6942,6942,6942,14,14,2,138840,2
21,y1703,20170117,6942,6942,0,0,0,6942,6942,0,0,0,0,2
22,y1703,20170118,6942,6942,0,0,0,6942,6942,0,0,0,0,2
23,y1703,20170119,6942,6942,0,0,0,6942,6942,0,0,0,0,2
24,y1703,20170120,6942,6942,0,0,0,6942,6942,0,0,0,0,2
25,y1703,20170123,6942,6942,0,0,0,6942,6942,0,0,0,0,2
26,y1703,20170124,6942,6942,7068,7068,6894,6894,6980,-48,38,4,279240,2
27,y1703,20170125,6894,6980,0,0,0,6980,6980,0,0,0,0,2
28,y1703,20170126,6980,6980,0,0,0,6980,6980,0,0,0,0,2
29,y1703,20170203,6980,6980,0,0,0,6980,6980,0,0,0,0,2
30,y1703,20170206,6980,6980,0,0,0,6950,6950,-30,-30,0,0,2
31,y1703,20170207,6950,6950,0,0,0,6950,6950,0,0,0,0,2
32,y1703,20170208,6950,6950,0,0,0,6950,6950,0,0,0,0,2
33,y1703,20170209,6950,6950,0,0,0,6950,6950,0,0,0,0,2
34,y1703,20170210,6950,6950,6796,6812,6796,6812,6804,-138,-146,4,272160,2
35,y1703,20170213,6812,6804,0,0,0,6804,6804,0,0,0,0,2
36,y1703,20170214,6804,6804,0,0,0,6804,6804,0,0,0,0,2
37,y1703,20170215,6804,6804,0,0,0,6804,6804,0,0,0,0,2
38,y1703,20170216,6804,6804,0,0,0,6804,6804,0,0,0,0,2
39,y1703,20170217,6804,6804,6848,6848,6474,6540,6556,-264,-248,14,918080,2
40,y1703,20170220,6540,6556,0,0,0,6556,6556,0,0,0,0,2
41,y1703,20170221,6556,6556,6736,6736,6486,6486,6610,-70,54,4,264440,4
42,y1703,20170222,6486,6610,0,0,0,6610,6610,0,0,0,0,4
43,y1703,20170223,6610,6610,0,0,0,6610,6610,0,0,0,0,4
44,y1703,20170224,6610,6610,0,0,0,6610,6610,0,0,0,0,4
45,y1703,20170227,6610,6610,6602,6602,6602,6602,6602,-8,-8,2,132040,2
46,y1703,20170228,6602,6602,6680,6680,6398,6398,6482,-204,-120,20,1296760,2
47,y1703,20170301,6398,6482,0,0,0,6094,6094,-388,-388,0,0,2
48,y1703,20170302,6094,6094,0,0,0,5546,5546,-548,-548,0,0,2
49,y1703,20170303,5546,5546,5130,5130,5130,5130,5130,-416,-416,2,102600,0
50,y1703,20170306,5130,5130,0,0,0,5130,5130,0,0,0,0,0
51,y1703,20170307,5130,5130,0,0,0,5130,5130,0,0,0,0,0
52,y1703,20170308,5130,5130,0,0,0,5130,5130,0,0,0,0,0
53,y1703,20170309,5130,5130,0,0,0,5130,5130,0,0,0,0,0
54,y1703,20170310,5130,5130,0,0,0,5130,5130,0,0,0,0,0
55,y1703,20170313,5130,5130,0,0,0,5130,5130,0,0,0,0,0
56,y1703,20170314,5130,5130,0,0,0,5130,5130,0,0,0,0,0
57,y1705,20170103,6980,6992,6988,7058,6940,6950,7008,-42,16,365268,25602730040,690910
58,y1705,20170104,6950,7008,6972,6998,6822,6880,6898,-128,-110,582356,40181624680,731594
59,y1705,20170105,6880,6898,6900,6930,6852,6874,6892,-24,-6,393544,27130012200,730618
60,y1705,20170106,6874,6892,6874,6900,6794,6800,6852,-92,-40,359944,24669287840,749254
61,y1705,20170109,6800,6852,6822,6848,6782,6824,6818,-28,-34,408540,27862404080,729550
62,y1705,20170110,6824,6818,6816,6898,6812,6878,6852,60,34,409104,28035636480,713350
63,y1705,20170111,6878,6852,6860,6952,6850,6950,6908,98,56,467120,32269054400,702340
64,y1705,20170112,6950,6908,6958,6964,6902,6932,6936,24,28,330464,22923461560,711234
65,y1705,20170113,6932,6936,6926,6994,6896,6936,6950,0,14,370210,25732244320,715642
66,y1705,20170116,6936,6950,6926,7020,6908,7000,6968,50,18,370910,25848906360,694024
67,y1705,20170117,7000,6968,7014,7064,6970,7024,7014,56,46,405022,28411764080,695316
68,y1705,20170118,7024,7014,7038,7052,6974,7020,7006,6,-8,374022,26210713520,681198
69,y1705,20170119,7020,7006,7008,7070,6992,7010,7028,4,22,355212,24965045000,668934
70,y1705,20170120,7010,7028,7016,7036,6976,7000,7004,-28,-24,264832,18552316400,648028
71,y1705,20170123,7000,7004,6998,6998,6944,6972,6970,-32,-34,256178,17855783720,637806
72,y1705,20170124,6972,6970,6970,7084,6956,7066,7022,96,52,338142,23747984280,642812
73,y1705,20170125,7066,7022,7070,7072,6962,6982,7012,-40,-10,261372,18331631600,637712
74,y1705,20170126,6982,7012,6990,7022,6926,6936,6970,-76,-42,236768,16506991440,639586
75,y1705,20170203,6936,6970,6926,6960,6836,6854,6884,-116,-86,228264,15714271640,654040
76,y1705,20170206,6854,6884,6858,6910,6842,6864,6870,-20,-14,343954,23633863160,683186
77,y1705,20170207,6864,6870,6868,6906,6830,6844,6868,-26,-2,271606,18657361360,715812
78,y1705,20170208,6844,6868,6832,6934,6832,6906,6890,38,22,366640,25264994320,710038
79,y1705,20170209,6906,6890,6904,6932,6882,6884,6910,-6,20,243498,16826772000,700542
80,y1705,20170210,6884,6910,6888,6958,6874,6956,6926,46,16,332846,23056455240,697962
81,y1705,20170213,6956,6926,6926,6978,6860,6868,6928,-58,2,500438,34678958920,701168
82,y1705,20170214,6868,6928,6878,6910,6822,6828,6872,-100,-56,360880,24801242160,703786
83,y1705,20170215,6828,6872,6852,6882,6812,6830,6842,-42,-30,363660,24885118720,696142
84,y1705,20170216,6830,6842,6832,6872,6800,6800,6836,-42,-6,404834,27682055920,711570
85,y1705,20170217,6800,6836,6792,6826,6684,6690,6752,-146,-84,559224,37766295360,674438
86,y1705,20170220,6690,6752,6688,6718,6672,6698,6692,-54,-60,246048,16469502880,661152
87,y1705,20170221,6698,6692,6690,6722,6632,6670,6688,-22,-4,453510,30331088880,684604
88,y1705,20170222,6670,6688,6652,6668,6606,6654,6636,-34,-52,340086,22574640160,686626
89,y1705,20170223,6654,6636,6666,6676,6560,6584,6616,-52,-20,396318,26223965240,698940
90,y1705,20170224,6584,6616,6600,6604,6518,6588,6576,-28,-40,309544,20355858680,674262
91,y1705,20170227,6588,6576,6598,6624,6562,6578,6596,2,20,331488,21870149600,680246
92,y1705,20170228,6578,6596,6570,6598,6534,6572,6568,-24,-28,298660,19619320120,676220
93,y1705,20170301,6572,6568,6616,6712,6594,6652,6656,84,88,567856,37802194520,654728
94,y1705,20170302,6652,6656,6688,6716,6648,6688,6680,32,24,335560,22417597240,611066
95,y1705,20170303,6688,6680,6680,6694,6634,6672,6668,-8,-12,271558,18109835520,600346
96,y1705,20170306,6672,6668,6672,6728,6636,6686,6676,18,8,326362,21792255480,587368
97,y1705,20170307,6686,6676,6686,6688,6568,6586,6616,-90,-60,409912,27120156160,608580
98,y1705,20170308,6586,6616,6572,6596,6486,6538,6536,-78,-80,364530,23832170040,592516
99,y1705,20170309,6538,6536,6548,6564,6470,6536,6530,0,-6,334204,21824098560,592816
100,y1705,20170310,6536,6530,6510,6514,6388,6414,6448,-116,-82,414058,26703006360,592592
101,y1705,20170313,6414,6448,6420,6462,6408,6436,6434,-12,-14,305690,19674040880,574732
102,y1705,20170314,6436,6434,6400,6408,6334,6354,6370,-80,-64,418912,26685615080,589072
103,y1705,20170315,6354,6370,6366,6390,6294,6348,6350,-22,-20,369382,23461014960,552050
104,y1705,20170316,6348,6350,6378,6392,6300,6340,6340,-10,-10,374026,23718394480,580150
105,y1705,20170317,6340,6340,6356,6398,6324,6374,6362,34,22,295404,18795189320,550432
106,y1705,20170320,6374,6362,6386,6398,6350,6396,6372,34,10,296168,18875275080,500860
107,y1705,20170321,6396,6372,6396,6412,6342,6380,6380,8,8,210912,13458698320,466082
108,y1705,20170322,6380,6380,6396,6408,6352,6354,6378,-26,-2,169454,10808900760,440270
109,y1705,20170323,6354,6378,6354,6360,6264,6270,6310,-108,-68,181880,11478044640,425004
110,y1705,20170324,6270,6310,6280,6306,6218,6228,6254,-82,-56,130098,8138312000,410998
111,y1705,20170327,6228,6254,6222,6234,6056,6066,6126,-188,-128,180154,11038158200,390202
112,y1705,20170328,6066,6126,6048,6100,6020,6056,6060,-70,-66,143032,8668702920,356560
113,y1705,20170329,6056,6060,6066,6092,6048,6070,6070,10,10,95924,5823085600,337522
114,y1705,20170330,6070,6070,6080,6088,5978,5996,6030,-74,-40,120720,7279626160,332596
115,y1705,20170331,5996,6030,5938,6024,5900,5904,5968,-126,-62,100200,5981156800,316256
116,y1705,20170405,5904,5968,5900,5958,5836,5934,5904,-34,-64,88352,5217151920,294390
117,y1705,20170406,5934,5904,5948,5974,5920,5950,5944,46,40,80832,4805871640,271212
118,y1705,20170407,5950,5944,5956,5964,5820,5872,5894,-72,-50,94240,5556187480,246578
119,y1705,20170410,5872,5894,5868,5944,5858,5864,5894,-30,0,137520,8105697920,192394
120,y1705,20170411,5864,5894,5860,5912,5844,5892,5884,-2,-10,53436,3144372600,173594
121,y1705,20170412,5892,5884,5896,5910,5778,5780,5838,-104,-46,62830,3668466040,156816
122,y1705,20170413,5780,5838,5786,5836,5780,5820,5816,-18,-22,46938,2730187400,136440
123,y1705,20170414,5820,5816,5814,5840,5774,5802,5806,-14,-10,39614,2300239960,127402
124,y1705,20170417,5802,5806,5802,5874,5800,5800,5838,-6,32,38902,2271125040,120228
125,y1705,20170418,5800,5838,5814,5854,5760,5760,5808,-78,-30,56068,3256971880,97234
126,y1705,20170419,5760,5808,5750,5750,5612,5622,5656,-186,-152,53312,3015804600,79860
127,y1705,20170420,5622,5656,5630,5690,5584,5670,5664,14,8,40288,2282063000,69992
128,y1705,20170421,5670,5664,5700,5700,5656,5688,5682,24,18,19220,1092194760,63708
129,y1705,20170424,5688,5682,5602,5760,5602,5750,5734,68,52,25446,1459186440,51778
130,y1705,20170425,5750,5734,5760,5764,5658,5666,5706,-68,-28,20628,1177334320,42978
131,y1705,20170426,5666,5706,5676,5708,5658,5664,5690,-42,-16,12410,706300800,34578
132,y1705,20170427,5664,5690,5690,5708,5656,5656,5686,-34,-4,14384,818114280,29014
133,y1705,20170428,5656,5686,5666,5666,5598,5612,5632,-74,-54,16682,939757160,24022
134,y1705,20170502,5612,5632,5404,5750,5404,5708,5658,76,26,4862,275157880,22140
135,y1705,20170503,5708,5658,5708,5732,5706,5724,5714,66,56,1226,70062440,22188
136,y1705,20170504,5724,5714,5710,5710,5686,5686,5700,-28,-14,236,13452400,22142
137,y1705,20170505,5686,5700,5658,5658,5644,5644,5648,-56,-52,448,25309440,22048
138,y1705,20170508,5644,5648,5758,5760,5758,5760,5758,112,110,40,2303960,22060
139,y1705,20170509,5760,5758,5684,5722,5684,5686,5690,-72,-68,92,5234960,15570
140,y1705,20170510,5686,5690,0,0,0,5690,5690,0,0,16,916160,13678
141,y1705,20170511,5690,5690,5752,5800,5752,5800,5790,110,100,1200,69496080,11166
142,y1705,20170512,5800,5790,5790,5790,5754,5754,5784,-36,-6,1384,80075440,9246
143,y1705,20170515,5754,5784,5838,5838,5838,5838,5718,54,-66,2276,131756200,0
144,y1707,20170103,6950,6990,0,0,0,6990,6990,0,0,0,0,0
145,y1707,20170104,6990,6990,6886,6886,6886,6886,6886,-104,-104,2,137720,2
146,y1707,20170105,6886,6886,6852,6852,6850,6850,6850,-36,-36,10,685080,10
147,y1707,20170106,6850,6850,0,0,0,6850,6850,0,0,0,0,10
148,y1707,20170109,6850,6850,6802,6802,6802,6802,6802,-48,-48,2,136040,10
149,y1707,20170110,6802,6802,0,0,0,6802,6802,0,0,0,0,10
150,y1707,20170111,6802,6802,6820,6922,6820,6912,6868,110,66,8,549480,12
151,y1707,20170112,6912,6868,0,0,0,6876,6876,8,8,0,0,12
152,y1707,20170113,6876,6876,6892,6914,6884,6884,6896,8,20,6,413800,10
153,y1707,20170116,6884,6896,6944,6990,6944,6990,6966,94,70,6,418040,10
154,y1707,20170117,6990,6966,0,0,0,6966,6966,0,0,0,0,10
155,y1707,20170118,6966,6966,6958,6958,6958,6958,6958,-8,-8,2,139160,10
156,y1707,20170119,6958,6958,0,0,0,6958,6958,0,0,0,0,10
157,y1707,20170120,6958,6958,0,0,0,6958,6958,0,0,0,0,10
158,y1707,20170123,6958,6958,6948,6966,6948,6966,6958,8,0,6,417560,8
159,y1707,20170124,6966,6958,0,0,0,6958,6958,0,0,0,0,8
160,y1707,20170125,6958,6958,0,0,0,6958,6958,0,0,0,0,8
161,y1707,20170126,6958,6958,0,0,0,6918,6918,-40,-40,0,0,8
162,y1707,20170203,6918,6918,6848,6848,6848,6848,6848,-70,-70,2,136960,8
163,y1707,20170206,6848,6848,6850,6850,6850,6850,6850,2,2,2,137000,8
164,y1707,20170207,6850,6850,0,0,0,6850,6850,0,0,0,0,8
165,y1707,20170208,6850,6850,6840,6900,6840,6866,6880,16,30,10,688040,6
166,y1707,20170209,6866,6880,0,0,0,6880,6880,0,0,0,0,6
167,y1707,20170210,6880,6880,7018,7018,6860,6860,6938,-20,58,4,277560,6
168,y1707,20170213,6860,6938,7046,7046,6928,6928,6996,-10,58,8,559680,6
169,y1707,20170214,6928,6996,6900,6900,6880,6880,6890,-116,-106,6,413400,6
170,y1707,20170215,6880,6890,6856,6856,6856,6856,6856,-34,-34,2,137120,4
171,y1707,20170216,6856,6856,0,0,0,6856,6856,0,0,0,0,4
172,y1707,20170217,6856,6856,6818,6818,6818,6818,6818,-38,-38,2,136360,4
173,y1707,20170220,6818,6818,0,0,0,6818,6818,0,0,0,0,4
174,y1707,20170221,6818,6818,6712,6734,6712,6730,6724,-88,-94,6,403520,4
175,y1707,20170222,6730,6724,6636,6636,6636,6636,6636,-88,-88,2,132720,4
176,y1707,20170223,6636,6636,0,0,0,6636,6636,0,0,0,0,4
177,y1707,20170224,6636,6636,0,0,0,6636,6636,0,0,0,0,4
178,y1707,20170227,6636,6636,0,0,0,6636,6636,0,0,0,0,4
179,y1707,20170228,6636,6636,6576,6612,6576,6612,6594,-24,-42,42,2769480,4
180,y1707,20170301,6612,6594,0,0,0,6594,6594,0,0,0,0,4
181,y1707,20170302,6594,6594,6834,6834,6648,6648,6740,54,146,4,269640,4
182,y1707,20170303,6648,6740,0,0,0,6740,6740,0,0,0,0,4
183,y1707,20170306,6740,6740,0,0,0,6740,6740,0,0,0,0,4
184,y1707,20170307,6740,6740,0,0,0,6730,6730,-10,-10,0,0,4
185,y1707,20170308,6730,6730,0,0,0,6700,6700,-30,-30,0,0,4
186,y1707,20170309,6700,6700,0,0,0,6688,6688,-12,-12,0,0,4
187,y1707,20170310,6688,6688,0,0,0,6606,6606,-82,-82,0,0,4
188,y1707,20170313,6606,6606,0,0,0,6566,6566,-40,-40,0,0,4
189,y1707,20170314,6566,6566,0,0,0,6532,6532,-34,-34,0,0,4
190,y1707,20170315,6532,6532,6306,6394,6306,6394,6348,-138,-184,8,507960,4
191,y1707,20170316,6394,6348,0,0,0,6348,6348,0,0,0,0,4
192,y1707,20170317,6348,6348,0,0,0,6348,6348,0,0,0,0,4
193,y1707,20170320,6348,6348,0,0,0,6348,6348,0,0,0,0,4
194,y1707,20170321,6348,6348,0,0,0,6348,6348,0,0,0,0,4
195,y1707,20170322,6348,6348,6444,6444,6394,6394,6418,46,70,4,256760,4
196,y1707,20170323,6394,6418,0,0,0,6390,6390,-28,-28,0,0,4
197,y1707,20170324,6390,6390,0,0,0,6348,6348,-42,-42,0,0,4
198,y1707,20170327,6348,6348,0,0,0,6220,6220,-128,-128,0,0,4
199,y1707,20170328,6220,6220,0,0,0,6212,6212,-8,-8,0,0,4
200,y1707,20170329,6212,6212,0,0,0,6222,6222,10,10,0,0,4
201,y1707,20170330,6222,6222,0,0,0,6086,6086,-136,-136,0,0,4
202,y1707,20170331,6086,6086,0,0,0,6080,6080,-6,-6,0,0,4
203,y1707,20170405,6080,6080,0,0,0,6016,6016,-64,-64,0,0,4
204,y1707,20170406,6016,6016,0,0,0,6016,6016,0,0,0,0,4
205,y1707,20170407,6016,6016,0,0,0,5966,5966,-50,-50,0,0,4
206,y1707,20170410,5966,5966,5824,5928,5824,5928,5876,-38,-90,8,470080,4
207,y1707,20170411,5928,5876,0,0,0,5876,5876,0,0,0,0,4
208,y1707,20170412,5876,5876,0,0,0,5876,5876,0,0,0,0,4
209,y1707,20170413,5876,5876,0,0,0,5876,5876,0,0,0,0,4
210,y1707,20170414,5876,5876,0,0,0,5876,5876,0,0,0,0,4
211,y1707,20170417,5876,5876,0,0,0,5876,5876,0,0,0,0,4
212,y1707,20170418,5876,5876,0,0,0,5876,5876,0,0,0,0,4
213,y1707,20170419,5876,5876,5796,5796,5796,5796,5796,-80,-80,2,115920,4
214,y1707,20170420,5796,5796,5610,5610,5610,5610,5610,-186,-186,2,112200,4
215,y1707,20170421,5610,5610,0,0,0,5610,5610,0,0,0,0,4
216,y1707,20170424,5610,5610,5756,5780,5734,5734,5758,124,148,10,575800,4
217,y1707,20170425,5734,5758,0,0,0,5758,5758,0,0,0,0,4
218,y1707,20170426,5758,5758,0,0,0,5742,5742,-16,-16,0,0,4
219,y1707,20170427,5742,5742,0,0,0,5742,5742,0,0,0,0,4
220,y1707,20170428,5742,5742,5626,5626,5626,5626,5626,-116,-116,2,112520,2
221,y1707,20170502,5626,5626,0,0,0,5650,5650,24,24,0,0,2
222,y1707,20170503,5650,5650,0,0,0,5650,5650,0,0,0,0,2
223,y1707,20170504,5650,5650,0,0,0,5650,5650,0,0,0,0,2
224,y1707,20170505,5650,5650,5824,5824,5798,5798,5810,148,160,12,697320,14
225,y1707,20170508,5798,5810,0,0,0,5810,5810,0,0,0,0,14
226,y1707,20170509,5810,5810,5824,5870,5824,5870,5846,60,36,4,233880,14
227,y1707,20170510,5870,5846,0,0,0,5846,5846,0,0,0,0,14
228,y1707,20170511,5846,5846,0,0,0,5948,5948,102,102,0,0,14
229,y1707,20170512,5948,5948,0,0,0,5948,5948,0,0,0,0,14
230,y1707,20170515,5948,5948,5964,5964,5964,5964,5964,16,16,2,119280,14
231,y1707,20170516,5964,5964,6094,6094,6012,6078,6050,114,86,18,1089080,14
232,y1707,20170517,6078,6050,6082,6082,6082,6082,6082,32,32,2,121640,14
233,y1707,20170518,6082,6082,6006,6006,5980,5982,5994,-100,-88,26,1558760,14
234,y1707,20170519,5982,5994,5968,5972,5968,5972,5970,-22,-24,4,238800,14
235,y1707,20170522,5972,5970,6008,6008,6008,6008,6008,38,38,2,120160,14
236,y1707,20170523,6008,6008,0,0,0,6008,6008,0,0,0,0,14
237,y1707,20170524,6008,6008,5950,5950,5940,5940,5946,-68,-62,6,356800,14
238,y1707,20170525,5940,5946,5944,5944,5938,5938,5940,-8,-6,8,475240,16
239,y1707,20170526,5938,5940,0,0,0,5866,5866,-74,-74,0,0,16
240,y1707,20170531,5866,5866,0,0,0,5758,5758,-108,-108,0,0,16
241,y1707,20170601,5758,5758,0,0,0,5736,5736,-22,-22,0,0,16
242,y1707,20170602,5736,5736,0,0,0,5736,5736,0,0,0,0,16
243,y1707,20170605,5736,5736,0,0,0,5736,5736,0,0,0,0,16
244,y1707,20170606,5736,5736,0,0,0,5736,5736,0,0,0,0,16
245,y1707,20170607,5736,5736,0,0,0,5736,5736,0,0,0,0,16
246,y1707,20170608,5736,5736,0,0,0,5736,5736,0,0,0,0,16
247,y1707,20170609,5736,5736,0,0,0,5750,5750,14,14,0,0,16
248,y1707,20170612,5750,5750,0,0,0,5792,5792,42,42,0,0,16
249,y1707,20170613,5792,5792,0,0,0,5792,5792,0,0,0,0,16
250,y1707,20170614,5792,5792,0,0,0,5792,5792,0,0,0,0,16
251,y1707,20170615,5792,5792,5574,5574,5574,5574,5574,-218,-218,2,111480,16
252,y1707,20170616,5574,5574,5710,5712,5710,5712,5710,138,136,4,228440,12
253,y1707,20170619,5712,5710,0,0,0,5710,5710,0,0,0,0,12
254,y1707,20170620,5710,5710,0,0,0,5710,5710,0,0,0,0,12
255,y1707,20170621,5710,5710,5788,5788,5584,5584,5652,-126,-58,12,678240,4
256,y1707,20170622,5584,5652,0,0,0,5652,5652,0,0,0,0,4
257,y1707,20170623,5652,5652,0,0,0,5652,5652,0,0,0,0,4
258,y1707,20170626,5652,5652,0,0,0,5652,5652,0,0,0,0,4
259,y1707,20170627,5652,5652,0,0,0,5652,5652,0,0,0,0,4
260,y1707,20170628,5652,5652,0,0,0,5652,5652,0,0,0,0,4
261,y1707,20170629,5652,5652,0,0,0,5652,5652,0,0,0,0,4
262,y1707,20170630,5652,5652,5652,5652,5652,5652,5652,0,0,4,226080,4
263,y1707,20170703,5652,5652,0,0,0,5652,5652,0,0,0,0,4
264,y1707,20170704,5652,5652,0,0,0,5652,5652,0,0,0,0,0
265,y1707,20170705,5652,5652,5750,5750,5750,5750,5750,98,98,4,230000,4
266,y1707,20170706,5750,5750,0,0,0,5750,5750,0,0,0,0,4
267,y1707,20170707,5750,5750,0,0,0,5750,5750,0,0,0,0,4
268,y1707,20170710,5750,5750,0,0,0,5750,5750,0,0,0,0,4
269,y1707,20170711,5750,5750,0,0,0,5750,5750,0,0,0,0,4
270,y1707,20170712,5750,5750,6080,6080,6080,6080,6080,330,330,2,121600,4
271,y1707,20170713,6080,6080,6062,6062,6062,6062,6062,-18,-18,2,121240,4
272,y1707,20170714,6062,6062,0,0,0,5910,5910,-152,-152,0,0,0
273,y1708,20170103,7008,7008,0,0,0,7008,7008,0,0,0,0,2
274,y1708,20170104,7008,7008,0,0,0,7008,7008,0,0,0,0,2
275,y1708,20170105,7008,7008,0,0,0,7008,7008,0,0,0,0,2
276,y1708,20170106,7008,7008,0,0,0,7008,7008,0,0,0,0,2
277,y1708,20170109,7008,7008,0,0,0,7008,7008,0,0,0,0,2
278,y1708,20170110,7008,7008,0,0,0,7008,7008,0,0,0,0,2
279,y1708,20170111,7008,7008,0,0,0,7008,7008,0,0,0,0,2
280,y1708,20170112,7008,7008,0,0,0,7008,7008,0,0,0,0,2
281,y1708,20170113,7008,7008,0,0,0,7008,7008,0,0,0,0,2
282,y1708,20170116,7008,7008,0,0,0,7008,7008,0,0,0,0,2
283,y1708,20170117,7008,7008,0,0,0,7008,7008,0,0,0,0,2
284,y1708,20170118,7008,7008,0,0,0,7008,7008,0,0,0,0,2
285,y1708,20170119,7008,7008,7068,7090,7068,7090,7078,82,70,4,283160,2
286,y1708,20170120,7090,7078,0,0,0,7078,7078,0,0,0,0,2
287,y1708,20170123,7078,7078,0,0,0,7078,7078,0,0,0,0,2
288,y1708,20170124,7078,7078,7078,7078,7078,7078,7078,0,0,4,283120,2
289,y1708,20170125,7078,7078,0,0,0,7078,7078,0,0,0,0,2
290,y1708,20170126,7078,7078,0,0,0,7078,7078,0,0,0,0,2
291,y1708,20170203,7078,7078,0,0,0,7078,7078,0,0,0,0,2
292,y1708,20170206,7078,7078,0,0,0,7080,7080,2,2,0,0,2
293,y1708,20170207,7080,7080,0,0,0,7078,7078,-2,-2,0,0,2
294,y1708,20170208,7078,7078,0,0,0,7078,7078,0,0,0,0,2
295,y1708,20170209,7078,7078,0,0,0,7078,7078,0,0,0,0,2
296,y1708,20170210,7078,7078,0,0,0,7078,7078,0,0,0,0,2
297,y1708,20170213,7078,7078,0,0,0,7078,7078,0,0,0,0,2
298,y1708,20170214,7078,7078,0,0,0,6972,6972,-106,-106,0,0,2
299,y1708,20170215,6972,6972,0,0,0,6972,6972,0,0,0,0,2
300,y1708,20170216,6972,6972,0,0,0,6972,6972,0,0,0,0,2
301,y1708,20170217,6972,6972,0,0,0,6934,6934,-38,-38,0,0,2
302,y1708,20170220,6934,6934,0,0,0,6874,6874,-60,-60,0,0,2
303,y1708,20170221,6874,6874,0,0,0,6780,6780,-94,-94,0,0,2
304,y1708,20170222,6780,6780,0,0,0,6780,6780,0,0,0,0,2
305,y1708,20170223,6780,6780,0,0,0,6780,6780,0,0,0,0,2
306,y1708,20170224,6780,6780,6572,6620,6572,6620,6596,-160,-184,4,263840,2
307,y1708,20170227,6620,6596,0,0,0,6596,6596,0,0,0,0,2
308,y1708,20170228,6596,6596,0,0,0,6596,6596,0,0,0,0,2
309,y1708,20170301,6596,6596,0,0,0,6596,6596,0,0,0,0,2
310,y1708,20170302,6596,6596,0,0,0,6596,6596,0,0,0,0,2
311,y1708,20170303,6596,6596,0,0,0,6596,6596,0,0,0,0,2
312,y1708,20170306,6596,6596,0,0,0,6596,6596,0,0,0,0,2
313,y1708,20170307,6596,6596,0,0,0,6596,6596,0,0,0,0,2
314,y1708,20170308,6596,6596,0,0,0,6596,6596,0,0,0,0,2
315,y1708,20170309,6596,6596,6600,6600,6600,6600,6600,4,4,50,3300000,52
316,y1708,20170310,6600,6600,6602,6604,6416,6504,6540,-96,-60,44,2878240,36
317,y1708,20170313,6504,6540,6550,6550,6550,6550,6550,10,10,2,131000,36
318,y1708,20170314,6550,6550,6436,6546,6436,6546,6472,-4,-78,6,388360,36
319,y1708,20170315,6546,6472,6418,6418,6418,6418,6418,-54,-54,2,128360,36
320,y1708,20170316,6418,6418,6500,6522,6466,6486,6488,68,70,10,648800,36
321,y1708,20170317,6486,6488,0,0,0,6488,6488,0,0,0,0,36
322,y1708,20170320,6488,6488,0,0,0,6488,6488,0,0,0,0,36
323,y1708,20170321,6488,6488,6502,6502,6436,6436,6468,-52,-20,4,258760,36
324,y1708,20170322,6436,6468,6534,6534,6452,6452,6492,-16,24,40,2597200,36
325,y1708,20170323,6452,6492,6456,6456,6456,6456,6456,-36,-36,4,258240,36
326,y1708,20170324,6456,6456,0,0,0,6456,6456,0,0,0,0,36
327,y1708,20170327,6456,6456,0,0,0,6324,6324,-132,-132,0,0,36
328,y1708,20170328,6324,6324,0,0,0,6324,6324,0,0,0,0,36
329,y1708,20170329,6324,6324,0,0,0,6334,6334,10,10,0,0,36
330,y1708,20170330,6334,6334,0,0,0,6294,6294,-40,-40,0,0,36
331,y1708,20170331,6294,6294,6010,6010,6010,6010,6010,-284,-284,4,240400,38
332,y1708,20170405,6010,6010,5996,6060,5996,6060,6044,50,34,12,725280,30
333,y1708,20170406,6060,6044,0,0,0,6044,6044,0,0,0,0,30
334,y1708,20170407,6044,6044,6050,6050,6010,6010,6032,-34,-12,16,965400,22
335,y1708,20170410,6010,6032,5986,6102,5986,6002,6036,-30,4,10,603760,24
336,y1708,20170411,6002,6036,6030,6030,6030,6030,6030,-6,-6,2,120600,24
337,y1708,20170412,6030,6030,5988,5988,5846,5846,5920,-184,-110,26,1539640,34
338,y1708,20170413,5846,5920,5862,5914,5862,5914,5888,-6,-32,4,235520,34
339,y1708,20170414,5914,5888,5876,5876,5876,5876,5876,-12,-12,2,117520,36
340,y1708,20170417,5876,5876,5926,5926,5926,5926,5926,50,50,2,118520,36
341,y1708,20170418,5926,5926,5918,5918,5844,5844,5868,-82,-58,6,352160,38
342,y1708,20170419,5844,5868,5678,5678,5678,5678,5678,-190,-190,2,113560,36
343,y1708,20170420,5678,5678,0,0,0,5710,5710,32,32,0,0,36
344,y1708,20170421,5710,5710,5730,5738,5682,5682,5704,-28,-6,34,1939800,52
345,y1708,20170424,5682,5704,5740,5860,5740,5740,5774,36,70,28,1616760,52
346,y1708,20170425,5740,5774,0,0,0,5774,5774,0,0,0,0,52
347,y1708,20170426,5774,5774,5776,5776,5722,5722,5742,-52,-32,10,574200,60
348,y1708,20170427,5722,5742,5832,5832,5754,5782,5790,40,48,40,2316400,64
349,y1708,20170428,5782,5790,5748,5752,5720,5740,5738,-50,-52,14,803520,64
350,y1708,20170502,5740,5738,5830,5838,5830,5838,5834,100,96,4,233360,66
351,y1708,20170503,5838,5834,0,0,0,5834,5834,0,0,0,0,66
352,y1708,20170504,5834,5834,5734,5802,5734,5772,5768,-62,-66,6,346160,64
353,y1708,20170505,5772,5768,0,0,0,5744,5744,-24,-24,0,0,64
354,y1708,20170508,5744,5744,5776,5832,5776,5832,5798,88,54,16,927840,64
355,y1708,20170509,5832,5798,0,0,0,5798,5798,0,0,0,0,64
356,y1708,20170510,5798,5798,0,0,0,5798,5798,0,0,0,0,64
357,y1708,20170511,5798,5798,5798,5956,5748,5956,5816,158,18,54,3141360,58
358,y1708,20170512,5956,5816,5830,5830,5830,5830,5830,14,14,2,116600,60
359,y1708,20170515,5830,5830,5888,5928,5888,5928,5908,98,78,4,236320,60
360,y1708,20170516,5928,5908,5962,5962,5962,5962,5962,54,54,2,119240,58
361,y1708,20170517,5962,5962,5994,5994,5994,5994,5994,32,32,2,119880,58
362,y1708,20170518,5994,5994,5928,5928,5918,5918,5922,-76,-72,4,236920,54
363,y1708,20170519,5918,5922,5836,5836,5836,5836,5836,-86,-86,4,233440,58
364,y1708,20170522,5836,5836,5930,5962,5930,5962,5946,126,110,8,475680,58
365,y1708,20170523,5962,5946,5946,5946,5896,5896,5920,-50,-26,4,236840,58
366,y1708,20170524,5896,5920,0,0,0,5892,5892,-28,-28,0,0,58
367,y1708,20170525,5892,5892,5920,5920,5776,5776,5840,-116,-52,6,350480,60
368,y1708,20170526,5776,5840,5834,5834,5834,5834,5834,-6,-6,2,116680,60
369,y1708,20170531,5834,5834,5622,5622,5622,5622,5622,-212,-212,8,449760,52
370,y1708,20170601,5622,5622,0,0,0,5608,5608,-14,-14,0,0,52
371,y1708,20170602,5608,5608,0,0,0,5608,5608,0,0,0,0,52
372,y1708,20170605,5608,5608,5596,5598,5560,5598,5584,-10,-24,6,335080,50
373,y1708,20170606,5598,5584,0,0,0,5584,5584,0,0,0,0,50
374,y1708,20170607,5584,5584,5660,5660,5660,5660,5660,76,76,2,113200,50
375,y1708,20170608,5660,5660,0,0,0,5660,5660,0,0,0,0,50
376,y1708,20170609,5660,5660,5732,5732,5660,5660,5696,0,36,4,227840,50
377,y1708,20170612,5660,5696,0,0,0,5696,5696,0,0,0,0,50
378,y1708,20170613,5696,5696,0,0,0,5696,5696,0,0,0,0,50
379,y1708,20170614,5696,5696,0,0,0,5696,5696,0,0,0,0,50
380,y1708,20170615,5696,5696,0,0,0,5700,5700,4,4,0,0,50
381,y1708,20170616,5700,5700,5834,5834,5716,5746,5788,46,88,394,22808000,48
382,y1708,20170619,5746,5788,5860,5860,5854,5854,5856,66,68,6,351360,50
383,y1708,20170620,5854,5856,5900,5900,5810,5810,5854,-46,-2,4,234200,48
384,y1708,20170621,5810,5854,0,0,0,5796,5796,-58,-58,0,0,48
385,y1708,20170622,5796,5796,5760,5760,5702,5702,5740,-94,-56,30,1722480,50
386,y1708,20170623,5702,5740,5736,5736,5720,5720,5724,-20,-16,6,343520,52
387,y1708,20170626,5720,5724,5734,5750,5720,5750,5732,26,8,34,1949160,50
388,y1708,20170627,5750,5732,5680,5776,5680,5776,5710,44,-22,22,1256520,54
389,y1708,20170628,5776,5710,5774,5826,5774,5822,5808,112,98,20,1161640,48
390,y1708,20170629,5822,5808,5842,5842,5842,5842,5842,34,34,2,116840,50
391,y1708,20170630,5842,5842,5908,5908,5844,5844,5876,2,34,4,235040,48
392,y1708,20170703,5844,5876,5934,5934,5934,5934,5934,58,58,2,118680,50
393,y1708,20170704,5934,5934,5952,5952,5870,5870,5910,-64,-24,4,236440,48
394,y1708,20170705,5870,5910,5874,5874,5872,5872,5872,-38,-38,4,234920,52
395,y1708,20170706,5872,5872,5922,5922,5922,5922,5922,50,50,2,118440,52
396,y1708,20170707,5922,5922,0,0,0,5922,5922,0,0,0,0,52
397,y1708,20170710,5922,5922,0,0,0,6004,6004,82,82,0,0,52
398,y1708,20170711,6004,6004,0,0,0,6068,6068,64,64,0,0,52
399,y1708,20170712,6068,6068,6068,6070,6068,6070,6068,2,0,4,242760,54
400,y1708,20170713,6070,6068,6050,6050,6050,6050,6050,-18,-18,2,121000,54
401,y1708,20170714,6050,6050,0,0,0,6050,6050,0,0,0,0,54
402,y1708,20170717,6050,6050,0,0,0,6050,6050,0,0,0,0,54
403,y1708,20170718,6050,6050,6024,6028,5870,6028,5964,-22,-86,16,954400,54
404,y1708,20170719,6028,5964,6038,6038,5874,5874,5956,-90,-8,4,238240,54
405,y1708,20170720,5874,5956,6008,6048,6008,6040,6040,84,84,20,1208040,58
406,y1708,20170721,6040,6040,0,0,0,6040,6040,0,0,0,0,58
407,y1708,20170724,6040,6040,0,0,0,6040,6040,0,0,0,0,58
408,y1708,20170725,6040,6040,6198,6198,6180,6180,6190,140,150,70,4333200,98
409,y1708,20170726,6180,6190,6152,6204,5924,6204,6072,14,-118,46,2793800,58
410,y1708,20170727,6204,6072,6302,6302,6302,6302,6302,230,230,4,252080,62
411,y1708,20170728,6302,6302,6346,6346,6126,6252,6244,-50,-58,8,499520,58
412,y1708,20170731,6252,6244,6324,6550,6004,6550,6292,306,48,6,377560,54
413,y1708,20170801,6550,6292,0,0,0,6292,6292,0,0,0,0,54
414,y1708,20170802,6292,6292,0,0,0,6250,6250,-42,-42,0,0,54
415,y1708,20170803,6250,6250,0,0,0,6250,6250,0,0,0,0,54
416,y1708,20170804,6250,6250,0,0,0,6200,6200,-50,-50,0,0,54
417,y1708,20170807,6200,6200,0,0,0,6200,6200,0,0,0,0,54
418,y1708,20170808,6200,6200,0,0,0,6200,6200,0,0,0,0,54
419,y1708,20170809,6200,6200,0,0,0,6200,6200,0,0,0,0,54
420,y1708,20170810,6200,6200,0,0,0,6200,6200,0,0,0,0,54
421,y1708,20170811,6200,6200,0,0,0,6200,6200,0,0,0,0,54
422,y1708,20170814,6200,6200,5888,5888,5888,5888,5888,-312,-312,24,1413120,0
423,y1709,20170103,7032,7034,7020,7102,7006,7018,7058,-16,24,31608,2231494320,165838
424,y1709,20170104,7018,7058,7028,7056,6890,6948,6966,-110,-92,52920,3687247400,173134
425,y1709,20170105,6948,6966,6950,6992,6918,6940,6956,-26,-10,38922,2707696080,177146
426,y1709,20170106,6940,6956,6930,6966,6868,6872,6918,-84,-38,35086,2427479320,183244
427,y1709,20170109,6872,6918,6890,6924,6854,6898,6890,-20,-28,43288,2983331600,188532
428,y1709,20170110,6898,6890,6872,6970,6872,6956,6926,66,36,42588,2950384600,191380
429,y1709,20170111,6956,6926,6930,7030,6924,7022,6978,96,52,42758,2984014920,193120
430,y1709,20170112,7022,6978,7018,7038,6982,7012,7014,34,36,44312,3108524080,192590
431,y1709,20170113,7012,7014,7014,7076,6978,7016,7028,2,14,46448,3265080040,194628
432,y1709,20170116,7016,7028,7010,7112,6992,7094,7058,66,30,62596,4418636920,197884
433,y1709,20170117,7094,7058,7098,7146,7054,7094,7100,36,42,58120,4126660880,202098
434,y1709,20170118,7094,7100,7100,7126,7052,7086,7084,-14,-16,45036,3190673920,205836
435,y1709,20170119,7086,7084,7080,7126,7056,7074,7088,-10,4,41442,2937858720,206594
436,y1709,20170120,7074,7088,7078,7102,7050,7066,7074,-22,-14,37170,2629415160,201346
437,y1709,20170123,7066,7074,7058,7068,7026,7050,7048,-24,-26,30662,2161564560,202624
438,y1709,20170124,7050,7048,7046,7158,7042,7144,7104,96,56,53704,3815302840,199620
439,y1709,20170125,7144,7104,7138,7146,7048,7066,7092,-38,-12,40522,2874248160,199656
440,y1709,20170126,7066,7092,7072,7104,7000,7012,7058,-80,-34,41508,2930450440,201806
441,y1709,20170203,7012,7058,7010,7030,6920,6928,6966,-130,-92,35672,2485141160,206914
442,y1709,20170206,6928,6966,6926,6978,6910,6926,6934,-40,-32,81068,5622352320,222728
443,y1709,20170207,6926,6934,6934,6966,6896,6904,6930,-30,-4,55284,3831407400,228758
444,y1709,20170208,6904,6930,6900,6984,6896,6954,6948,24,18,75534,5249388240,241822
445,y1709,20170209,6954,6948,6956,6970,6938,6944,6954,-4,6,46378,3225648280,241002
446,y1709,20170210,6944,6954,6948,7008,6936,7008,6982,54,28,64464,4501061160,247004
447,y1709,20170213,7008,6982,6984,7018,6902,6916,6966,-66,-16,153106,10666352760,268868
448,y1709,20170214,6916,6966,6918,6958,6868,6874,6918,-92,-48,92468,6398145920,285956
449,y1709,20170215,6874,6918,6888,6924,6856,6874,6890,-44,-28,81114,5589281160,291820
450,y1709,20170216,6874,6890,6878,6946,6860,6862,6904,-28,14,129672,8954080760,303612
451,y1709,20170217,6862,6904,6856,6890,6760,6768,6816,-136,-88,145644,9929129040,317708
452,y1709,20170220,6768,6816,6760,6790,6752,6772,6770,-44,-46,66174,4480821120,324602
453,y1709,20170221,6772,6770,6768,6790,6716,6754,6762,-16,-8,105640,7143998920,336072
454,y1709,20170222,6754,6762,6746,6748,6694,6730,6718,-32,-44,86140,5788310360,338582
455,y1709,20170223,6730,6718,6728,6752,6640,6664,6688,-54,-30,101132,6764367760,343464
456,y1709,20170224,6664,6688,6672,6694,6616,6676,6666,-12,-22,127742,8516293280,350126
457,y1709,20170227,6676,6666,6682,6712,6658,6674,6686,8,20,107498,7189450760,354364
458,y1709,20170228,6674,6686,6668,6692,6632,6664,6664,-22,-22,102162,6809310480,361630
459,y1709,20170301,6664,6664,6708,6814,6692,6768,6762,104,98,262670,17765153960,396856
460,y1709,20170302,6768,6762,6800,6850,6780,6814,6810,52,48,191256,13028240320,416230
461,y1709,20170303,6814,6810,6812,6824,6774,6812,6800,2,-10,139060,9458825720,412830
462,y1709,20170306,6812,6800,6802,6856,6780,6814,6810,14,10,145186,9889341360,421522
463,y1709,20170307,6814,6810,6812,6818,6706,6728,6754,-82,-56,202972,13711316040,444578
464,y1709,20170308,6728,6754,6720,6728,6620,6668,6670,-86,-84,202598,13516975280,453266
465,y1709,20170309,6668,6670,6688,6700,6610,6664,6662,-6,-8,182774,12178443440,458946
466,y1709,20170310,6664,6662,6640,6650,6532,6550,6588,-112,-74,227692,15001321520,461522
467,y1709,20170313,6550,6588,6570,6596,6546,6570,6568,-18,-20,192788,12666149520,481742
468,y1709,20170314,6570,6568,6530,6542,6474,6494,6508,-74,-60,219628,14297546400,504802
469,y1709,20170315,6494,6508,6512,6540,6436,6504,6498,-4,-10,214064,13911107200,519018
470,y1709,20170316,6504,6498,6534,6546,6434,6472,6486,-26,-12,305380,19809442880,546440
471,y1709,20170317,6472,6486,6490,6512,6446,6486,6480,0,-6,250300,16220085200,538082
472,y1709,20170320,6486,6480,6492,6540,6480,6536,6512,56,32,351656,22903138800,589688
473,y1709,20170321,6536,6512,6532,6550,6460,6498,6504,-14,-8,368332,23959873160,626086
474,y1709,20170322,6498,6504,6510,6540,6476,6486,6510,-18,6,387230,25210833920,641030
475,y1709,20170323,6486,6510,6484,6498,6398,6402,6442,-108,-68,527282,33977557400,672938
476,y1709,20170324,6402,6442,6400,6446,6352,6362,6394,-80,-48,398264,25469060560,682588
477,y1709,20170327,6362,6394,6352,6366,6196,6210,6266,-184,-128,505232,31660622200,705668
478,y1709,20170328,6210,6266,6200,6240,6158,6200,6202,-66,-64,482584,29935103320,709384
479,y1709,20170329,6200,6202,6220,6236,6186,6206,6206,4,4,375492,23310502920,714094
480,y1709,20170330,6206,6206,6210,6214,6102,6122,6154,-84,-52,566156,34851420480,780276
481,y1709,20170331,6122,6154,6100,6144,6024,6034,6084,-120,-70,408756,24876148920,775188
482,y1709,20170405,6034,6084,5980,6068,5956,6040,6018,-44,-66,443066,26667138120,813142
483,y1709,20170406,6040,6018,6056,6080,6018,6034,6044,16,26,383256,23171168560,835108
484,y1709,20170407,6034,6044,6044,6050,5894,5946,5972,-98,-72,589768,35223314520,844360
485,y1709,20170410,5946,5972,5946,6044,5940,5968,5990,-4,18,765434,45850516600,868732
486,y1709,20170411,5968,5990,5950,6034,5950,6004,5996,14,6,547510,32836403640,870594
487,y1709,20170412,6004,5996,6008,6028,5888,5898,5950,-98,-46,726862,43261998360,899804
488,y1709,20170413,5898,5950,5902,5962,5890,5956,5936,6,-14,431608,25625111560,876898
489,y1709,20170414,5956,5936,5942,5980,5914,5944,5946,8,10,413540,24592047560,872344
490,y1709,20170417,5944,5946,5946,6028,5942,5952,5986,6,40,577462,34567844600,893606
491,y1709,20170418,5952,5986,5952,6010,5896,5902,5952,-84,-34,623694,37133198320,921552
492,y1709,20170419,5902,5952,5892,5894,5770,5794,5814,-158,-138,824890,47975248400,963156
493,y1709,20170420,5794,5814,5762,5832,5742,5816,5800,2,-14,689060,39969218960,973242
494,y1709,20170421,5816,5800,5838,5846,5782,5820,5814,20,14,533580,31030963400,964490
495,y1709,20170424,5820,5814,5822,5888,5816,5874,5854,60,40,565566,33119253360,929628
496,y1709,20170425,5874,5854,5878,5878,5794,5814,5840,-40,-14,502008,29323992840,948828
497,y1709,20170426,5814,5840,5824,5862,5806,5830,5834,-10,-6,419808,24495421400,926608
498,y1709,20170427,5830,5834,5848,5898,5838,5846,5868,12,34,541650,31785938840,909018
499,y1709,20170428,5846,5868,5838,5844,5804,5820,5824,-48,-44,463372,26995704520,917322
500,y1709,20170502,5820,5824,5864,5910,5838,5894,5882,70,58,367600,21628164880,914208
501,y1709,20170503,5894,5882,5894,5918,5874,5886,5890,4,8,375182,22104675480,913730
502,y1709,20170504,5886,5890,5870,5894,5810,5848,5846,-42,-44,615870,36011499720,918878
503,y1709,20170505,5848,5846,5840,5860,5782,5810,5824,-36,-22,577336,33631630760,909082
504,y1709,20170508,5810,5824,5856,5954,5848,5898,5902,74,78,791376,46710712880,926890
505,y1709,20170509,5898,5902,5912,5928,5868,5924,5890,22,-12,405108,23868079440,898460
506,y1709,20170510,5924,5890,5910,5948,5888,5908,5922,18,32,418914,24811801600,884056
507,y1709,20170511,5908,5922,5900,6008,5850,6004,5924,82,2,823286,48782895360,867602
508,y1709,20170512,6004,5924,5998,6002,5940,5976,5964,52,40,412878,24626150360,857152
509,y1709,20170515,5976,5964,5954,6022,5930,5984,5982,20,18,458734,27446988240,857884
510,y1709,20170516,5984,5982,6014,6052,6010,6024,6030,42,48,495214,29869213760,828300
511,y1709,20170517,6024,6030,6026,6060,5976,6048,6018,18,-12,505778,30442179200,815280
512,y1709,20170518,6048,6018,6058,6066,5984,5994,6018,-24,0,401006,24134720240,803190
513,y1709,20170519,5994,6018,5950,5990,5912,5938,5956,-80,-62,554150,33007374440,814964
514,y1709,20170522,5938,5956,5952,6044,5950,6000,6006,44,50,450176,27044242720,788544
515,y1709,20170523,6000,6006,6006,6022,5950,5952,5986,-54,-20,390548,23383806120,797068
516,y1709,20170524,5952,5986,5942,5974,5878,5910,5922,-76,-64,500930,29672789680,794188
517,y1709,20170525,5910,5922,5928,5948,5906,5916,5926,-6,4,309736,18357686960,794468
518,y1709,20170526,5916,5926,5922,5934,5812,5822,5866,-104,-60,496570,29131178920,787764
519,y1709,20170531,5822,5866,5760,5778,5662,5670,5728,-196,-138,437292,25052418560,817252
520,y1709,20170601,5670,5728,5686,5698,5638,5658,5672,-70,-56,428642,24317614520,827798
521,y1709,20170602,5658,5672,5676,5724,5660,5660,5686,-12,14,440508,25052549800,862586
522,y1709,20170605,5660,5686,5650,5740,5624,5712,5696,26,10,442794,25223739600,843496
523,y1709,20170606,5712,5696,5712,5750,5686,5742,5714,46,18,442610,25296329400,837236
524,y1709,20170607,5742,5714,5750,5788,5704,5728,5740,14,26,436114,25033275440,839068
525,y1709,20170608,5728,5740,5732,5752,5696,5728,5722,-12,-18,340462,19487701800,829654
526,y1709,20170609,5728,5722,5732,5792,5724,5778,5770,56,48,404264,23330199080,798222
527,y1709,20170612,5778,5770,5780,5860,5774,5856,5820,86,50,452916,26360742200,783674
528,y1709,20170613,5856,5820,5850,5850,5802,5816,5826,-4,6,258926,15087653600,764010
529,y1709,20170614,5816,5826,5804,5848,5800,5832,5828,6,2,278286,16220441120,780758
530,y1709,20170615,5832,5828,5832,5884,5812,5840,5842,12,14,341054,19929086320,793578
531,y1709,20170616,5840,5842,5848,5930,5818,5884,5886,42,44,453988,26730563200,795688
532,y1709,20170619,5884,5886,5896,5944,5874,5914,5914,28,28,365674,21627106600,794648
533,y1709,20170620,5914,5914,5910,5922,5820,5838,5866,-76,-48,368694,21632969440,792090
534,y1709,20170621,5838,5866,5812,5828,5770,5814,5802,-52,-64,392304,22763354240,788544
535,y1709,20170622,5814,5802,5826,5838,5764,5778,5796,-24,-6,300572,17422815080,769472
536,y1709,20170623,5778,5796,5778,5808,5748,5780,5778,-16,-18,307244,17753898440,763900
537,y1709,20170626,5780,5778,5792,5824,5768,5786,5794,8,16,245210,14209330560,752238
538,y1709,20170627,5786,5794,5786,5848,5770,5836,5804,42,10,274848,15952366720,748988
539,y1709,20170628,5836,5804,5854,5914,5848,5886,5878,82,74,440960,25928218040,773184
540,y1709,20170629,5886,5878,5852,5978,5852,5940,5942,62,64,638358,37932173040,778030
541,y1709,20170630,5940,5942,5948,5974,5896,5940,5934,-2,-8,436240,25892954640,759780
542,y1709,20170703,5940,5934,5930,6094,5926,6012,6002,78,68,480590,28846578520,741098
543,y1709,20170704,6012,6002,6024,6034,5912,5922,5964,-80,-38,398096,23749577440,718576
544,y1709,20170705,5922,5964,5932,5974,5924,5944,5946,-20,-18,249944,14865099280,701178
545,y1709,20170706,5944,5946,5960,6026,5952,5994,5992,48,46,434484,26042688080,671890
546,y1709,20170707,5994,5992,5988,6014,5946,6000,5986,8,-6,296130,17728708280,651114
547,y1709,20170710,6000,5986,5994,6126,5990,6110,6074,124,88,467312,28389905600,651128
548,y1709,20170711,6110,6074,6118,6188,6092,6152,6142,78,68,468486,28779465760,625216
549,y1709,20170712,6152,6142,6142,6186,6118,6140,6150,-2,8,298518,18360373120,605586
550,y1709,20170713,6140,6150,6134,6160,6070,6100,6110,-50,-40,319246,19510314640,607766
551,y1709,20170714,6100,6110,6086,6094,6018,6048,6054,-62,-56,314084,19015337240,591116
552,y1709,20170717,6048,6054,6070,6116,6060,6078,6086,24,32,284336,17305542840,585662
553,y1709,20170718,6078,6086,6088,6136,6032,6048,6084,-38,-2,336066,20451607600,573178
554,y1709,20170719,6048,6084,6072,6096,6030,6078,6064,-6,-20,264976,16071983040,572888
555,y1709,20170720,6078,6064,6088,6164,6072,6132,6120,68,56,307384,18816332120,575598
556,y1709,20170721,6132,6120,6156,6190,6098,6136,6148,16,28,345396,21239257040,561978
557,y1709,20170724,6136,6148,6132,6146,6046,6074,6082,-74,-66,308090,18739382720,560612
558,y1709,20170725,6074,6082,6092,6176,6074,6174,6130,92,48,285684,17514400320,553946
559,y1709,20170726,6174,6130,6180,6198,6070,6084,6126,-46,-4,323094,19793937760,530428
560,y1709,20170727,6084,6126,6080,6158,6080,6148,6128,22,2,226214,13863038880,509232
561,y1709,20170728,6148,6128,6162,6214,6066,6082,6132,-46,4,367086,22515751520,461412
562,y1709,20170731,6082,6132,6066,6170,6066,6158,6128,26,-4,198878,12189674120,426762
563,y1709,20170801,6158,6128,6152,6206,6134,6160,6168,32,40,186044,11478132640,404146
564,y1709,20170802,6160,6168,6134,6150,6092,6120,6114,-48,-54,134164,8203027560,379042
565,y1709,20170803,6120,6114,6124,6158,6008,6034,6094,-80,-20,179096,10914199240,334560
566,y1709,20170804,6034,6094,6028,6056,6006,6038,6028,-56,-66,128576,7753107680,301954
567,y1709,20170807,6038,6028,6054,6080,6020,6030,6046,2,18,76794,4643008160,283950
568,y1709,20170808,6030,6046,6020,6138,6008,6136,6084,90,38,111458,6781231240,242484
569,y1709,20170809,6136,6084,6132,6172,6120,6164,6144,80,60,71630,4401435920,226922
570,y1709,20170810,6164,6144,6158,6186,6092,6178,6138,34,-6,87488,5371320280,209496
571,y1709,20170811,6178,6138,6186,6278,6084,6132,6160,-6,22,143964,8868584800,183078
572,y1709,20170814,6132,6160,6156,6192,6096,6166,6144,6,-16,74342,4567628200,170292
573,y1709,20170815,6166,6144,6152,6170,6120,6142,6146,-2,2,56470,3471439800,155586
574,y1709,20170816,6142,6146,6128,6136,6062,6066,6090,-80,-56,64382,3921862840,144040
575,y1709,20170817,6066,6090,6084,6114,6062,6096,6090,6,0,46996,2862638640,134770
576,y1709,20170818,6096,6090,6090,6150,6078,6148,6110,58,20,35070,2143219400,124152
577,y1709,20170821,6148,6110,6154,6174,6132,6154,6156,44,46,43748,2693245560,106384
578,y1709,20170822,6154,6156,6166,6250,6144,6246,6196,90,40,31388,1944959640,96078
579,y1709,20170823,6246,6196,6228,6280,6186,6264,6244,68,48,22706,1418102560,89220
580,y1709,20170824,6264,6244,6264,6278,6210,6266,6250,22,6,18892,1180831440,79060
581,y1709,20170825,6266,6250,6288,6306,6206,6210,6238,-40,-12,24052,1500502880,70044
582,y1709,20170828,6210,6238,6208,6266,6200,6216,6226,-22,-12,31238,1945348400,57242
583,y1709,20170829,6216,6226,6188,6222,6154,6160,6192,-66,-34,14958,926310840,51840
584,y1709,20170830,6160,6192,6154,6190,6130,6130,6154,-62,-38,10440,642631240,46604
585,y1709,20170831,6130,6154,6130,6148,6114,6140,6128,-14,-26,13522,828697600,40118
586,y1709,20170901,6140,6128,6128,6200,6128,6190,6180,62,52,492,30411880,33138
587,y1709,20170904,6190,6180,6200,6250,6168,6224,6216,44,36,190,11813560,24088
588,y1709,20170905,6224,6216,6220,6296,6186,6296,6216,80,0,958,59561040,16976
589,y1709,20170906,6296,6216,6216,6290,6216,6280,6254,64,38,426,26646880,13844
590,y1709,20170907,6280,6254,6198,6252,6198,6224,6234,-30,-20,426,26558640,13844
591,y1709,20170908,6224,6234,6220,6220,6156,6166,6192,-68,-42,500,30961160,13558
592,y1709,20170911,6166,6192,6146,6212,6146,6212,6178,20,-14,8,494320,13558
593,y1709,20170912,6212,6178,6260,6260,6140,6190,6140,12,-38,1622,99599000,9096
594,y1709,20170913,6190,6140,0,0,0,6140,6140,0,0,0,0,8500
595,y1709,20170914,6140,6140,0,0,0,6188,6188,48,48,0,0,0
596,y1711,20170103,6982,6982,0,0,0,6982,6982,0,0,0,0,6
597,y1711,20170104,6982,6982,0,0,0,6982,6982,0,0,0,0,6
598,y1711,20170105,6982,6982,0,0,0,6982,6982,0,0,0,0,6
599,y1711,20170106,6982,6982,0,0,0,6982,6982,0,0,0,0,6
600,y1711,20170109,6982,6982,0,0,0,6982,6982,0,0,0,0,6
601,y1711,20170110,6982,6982,0,0,0,6982,6982,0,0,0,0,6
602,y1711,20170111,6982,6982,0,0,0,6982,6982,0,0,0,0,6
603,y1711,20170112,6982,6982,0,0,0,6982,6982,0,0,0,0,6
604,y1711,20170113,6982,6982,0,0,0,6982,6982,0,0,0,0,6
605,y1711,20170116,6982,6982,0,0,0,6982,6982,0,0,0,0,6
606,y1711,20170117,6982,6982,0,0,0,6982,6982,0,0,0,0,6
607,y1711,20170118,6982,6982,0,0,0,6982,6982,0,0,0,0,6
608,y1711,20170119,6982,6982,0,0,0,6982,6982,0,0,0,0,6
609,y1711,20170120,6982,6982,0,0,0,6982,6982,0,0,0,0,6
610,y1711,20170123,6982,6982,0,0,0,6982,6982,0,0,0,0,6
611,y1711,20170124,6982,6982,0,0,0,7036,7036,54,54,0,0,6
612,y1711,20170125,7036,7036,0,0,0,7036,7036,0,0,0,0,6
613,y1711,20170126,7036,7036,0,0,0,7004,7004,-32,-32,0,0,6
614,y1711,20170203,7004,7004,0,0,0,7004,7004,0,0,0,0,6
615,y1711,20170206,7004,7004,0,0,0,7004,7004,0,0,0,0,6
616,y1711,20170207,7004,7004,0,0,0,7004,7004,0,0,0,0,6
617,y1711,20170208,7004,7004,0,0,0,7004,7004,0,0,0,0,6
618,y1711,20170209,7004,7004,6912,7012,6912,6916,6946,-88,-58,6,416800,6
619,y1711,20170210,6916,6946,6972,6972,6972,6972,6972,26,26,2,139440,6
620,y1711,20170213,6972,6972,0,0,0,6972,6972,0,0,0,0,6
621,y1711,20170214,6972,6972,0,0,0,6972,6972,0,0,0,0,6
622,y1711,20170215,6972,6972,0,0,0,6972,6972,0,0,0,0,6
623,y1711,20170216,6972,6972,0,0,0,6972,6972,0,0,0,0,6
624,y1711,20170217,6972,6972,0,0,0,6884,6884,-88,-88,0,0,6
625,y1711,20170220,6884,6884,0,0,0,6884,6884,0,0,0,0,6
626,y1711,20170221,6884,6884,0,0,0,6884,6884,0,0,0,0,6
627,y1711,20170222,6884,6884,0,0,0,6884,6884,0,0,0,0,6
628,y1711,20170223,6884,6884,6680,6680,6680,6680,6680,-204,-204,2,133600,6
629,y1711,20170224,6680,6680,0,0,0,6680,6680,0,0,0,0,6
630,y1711,20170227,6680,6680,0,0,0,6680,6680,0,0,0,0,6
631,y1711,20170228,6680,6680,6678,6678,6678,6678,6678,-2,-2,2,133560,6
632,y1711,20170301,6678,6678,0,0,0,6678,6678,0,0,0,0,6
633,y1711,20170302,6678,6678,0,0,0,6678,6678,0,0,0,0,6
634,y1711,20170303,6678,6678,0,0,0,6678,6678,0,0,0,0,6
635,y1711,20170306,6678,6678,0,0,0,6678,6678,0,0,0,0,6
636,y1711,20170307,6678,6678,0,0,0,6678,6678,0,0,0,0,6
637,y1711,20170308,6678,6678,0,0,0,6678,6678,0,0,0,0,6
638,y1711,20170309,6678,6678,0,0,0,6678,6678,0,0,0,0,6
639,y1711,20170310,6678,6678,0,0,0,6604,6604,-74,-74,0,0,6
640,y1711,20170313,6604,6604,0,0,0,6604,6604,0,0,0,0,6
641,y1711,20170314,6604,6604,0,0,0,6604,6604,0,0,0,0,6
642,y1711,20170315,6604,6604,6450,6486,6450,6486,6468,-118,-136,4,258720,8
643,y1711,20170316,6486,6468,0,0,0,6468,6468,0,0,0,0,8
644,y1711,20170317,6468,6468,0,0,0,6468,6468,0,0,0,0,8
645,y1711,20170320,6468,6468,0,0,0,6468,6468,0,0,0,0,8
646,y1711,20170321,6468,6468,0,0,0,6468,6468,0,0,0,0,8
647,y1711,20170322,6468,6468,6544,6544,6544,6544,6544,76,76,2,130880,8
648,y1711,20170323,6544,6544,0,0,0,6544,6544,0,0,0,0,8
649,y1711,20170324,6544,6544,0,0,0,6544,6544,0,0,0,0,8
650,y1711,20170327,6544,6544,0,0,0,6414,6414,-130,-130,0,0,8
651,y1711,20170328,6414,6414,6128,6336,6128,6196,6220,-218,-194,6,373200,8
652,y1711,20170329,6196,6220,0,0,0,6220,6220,0,0,0,0,8
653,y1711,20170330,6220,6220,6154,6284,6140,6200,6194,-20,-26,12,743480,8
654,y1711,20170331,6200,6194,0,0,0,6124,6124,-70,-70,0,0,8
655,y1711,20170405,6124,6124,0,0,0,6124,6124,0,0,0,0,8
656,y1711,20170406,6124,6124,0,0,0,6124,6124,0,0,0,0,8
657,y1711,20170407,6124,6124,5996,5996,5996,5996,5996,-128,-128,2,119920,8
658,y1711,20170410,5996,5996,0,0,0,6018,6018,22,22,0,0,8
659,y1711,20170411,6018,6018,0,0,0,6018,6018,0,0,0,0,8
660,y1711,20170412,6018,6018,0,0,0,5972,5972,-46,-46,0,0,8
661,y1711,20170413,5972,5972,0,0,0,5972,5972,0,0,0,0,8
662,y1711,20170414,5972,5972,0,0,0,5972,5972,0,0,0,0,8
663,y1711,20170417,5972,5972,0,0,0,5972,5972,0,0,0,0,8
664,y1711,20170418,5972,5972,6052,6052,5974,6016,6014,44,42,6,360840,10
665,y1711,20170419,6016,6014,0,0,0,6014,6014,0,0,0,0,10
666,y1711,20170420,6014,6014,5996,5996,5858,5858,5928,-156,-86,6,355680,16
667,y1711,20170421,5858,5928,5868,5880,5868,5880,5874,-48,-54,12,705000,12
668,y1711,20170424,5880,5874,5894,5976,5894,5976,5934,102,60,4,237400,12
669,y1711,20170425,5976,5934,0,0,0,5934,5934,0,0,0,0,12
670,y1711,20170426,5934,5934,0,0,0,5934,5934,0,0,0,0,12
671,y1711,20170427,5934,5934,0,0,0,5934,5934,0,0,0,0,12
672,y1711,20170428,5934,5934,0,0,0,5890,5890,-44,-44,0,0,12
673,y1711,20170502,5890,5890,6000,6000,5948,5948,5954,58,64,20,1190880,22
674,y1711,20170503,5948,5954,0,0,0,5954,5954,0,0,0,0,22
675,y1711,20170504,5954,5954,5944,5968,5942,5960,5946,6,-8,22,1308160,18
676,y1711,20170505,5960,5946,0,0,0,5946,5946,0,0,0,0,18
677,y1711,20170508,5946,5946,6058,6058,6054,6054,6056,108,110,4,242240,22
678,y1711,20170509,6054,6056,0,0,0,6056,6056,0,0,0,0,22
679,y1711,20170510,6056,6056,6006,6110,6006,6014,6056,-42,0,22,1332520,20
680,y1711,20170511,6014,6056,6066,6066,6066,6066,6066,10,10,2,121320,18
681,y1711,20170512,6066,6066,6086,6086,6042,6042,6060,-24,-6,10,606040,18
682,y1711,20170515,6042,6060,0,0,0,6060,6060,0,0,0,0,18
683,y1711,20170516,6060,6060,0,0,0,6060,6060,0,0,0,0,18
684,y1711,20170517,6060,6060,6078,6078,6078,6078,6078,18,18,2,121560,20
685,y1711,20170518,6078,6078,0,0,0,6078,6078,0,0,0,0,20
686,y1711,20170519,6078,6078,0,0,0,6078,6078,0,0,0,0,20
687,y1711,20170522,6078,6078,0,0,0,6078,6078,0,0,0,0,20
688,y1711,20170523,6078,6078,0,0,0,6078,6078,0,0,0,0,20
689,y1711,20170524,6078,6078,0,0,0,6078,6078,0,0,0,0,20
690,y1711,20170525,6078,6078,0,0,0,6078,6078,0,0,0,0,20
691,y1711,20170526,6078,6078,0,0,0,6078,6078,0,0,0,0,20
692,y1711,20170531,6078,6078,0,0,0,5936,5936,-142,-142,0,0,20
693,y1711,20170601,5936,5936,0,0,0,5878,5878,-58,-58,0,0,20
694,y1711,20170602,5878,5878,0,0,0,5878,5878,0,0,0,0,20
695,y1711,20170605,5878,5878,0,0,0,5878,5878,0,0,0,0,20
696,y1711,20170606,5878,5878,0,0,0,5878,5878,0,0,0,0,20
697,y1711,20170607,5878,5878,0,0,0,5878,5878,0,0,0,0,20
698,y1711,20170608,5878,5878,0,0,0,5840,5840,-38,-38,0,0,20
699,y1711,20170609,5840,5840,0,0,0,5840,5840,0,0,0,0,20
700,y1711,20170612,5840,5840,0,0,0,5840,5840,0,0,0,0,20
701,y1711,20170613,5840,5840,0,0,0,5840,5840,0,0,0,0,20
702,y1711,20170614,5840,5840,0,0,0,5840,5840,0,0,0,0,20
703,y1711,20170615,5840,5840,0,0,0,5840,5840,0,0,0,0,20
704,y1711,20170616,5840,5840,5858,5968,5858,5968,5912,128,72,4,236520,18
705,y1711,20170619,5968,5912,0,0,0,5954,5954,42,42,0,0,18
706,y1711,20170620,5954,5954,0,0,0,5954,5954,0,0,0,0,18
707,y1711,20170621,5954,5954,0,0,0,5954,5954,0,0,0,0,18
708,y1711,20170622,5954,5954,0,0,0,5954,5954,0,0,0,0,18
709,y1711,20170623,5954,5954,5844,5844,5844,5844,5844,-110,-110,2,116880,18
710,y1711,20170626,5844,5844,0,0,0,5844,5844,0,0,0,0,18
711,y1711,20170627,5844,5844,0,0,0,5844,5844,0,0,0,0,18
712,y1711,20170628,5844,5844,0,0,0,5844,5844,0,0,0,0,18
713,y1711,20170629,5844,5844,0,0,0,5844,5844,0,0,0,0,18
714,y1711,20170630,5844,5844,0,0,0,5844,5844,0,0,0,0,18
715,y1711,20170703,5844,5844,0,0,0,6058,6058,214,214,0,0,18
716,y1711,20170704,6058,6058,0,0,0,6058,6058,0,0,0,0,18
717,y1711,20170705,6058,6058,0,0,0,6058,6058,0,0,0,0,18
718,y1711,20170706,6058,6058,0,0,0,6058,6058,0,0,0,0,18
719,y1711,20170707,6058,6058,0,0,0,6058,6058,0,0,0,0,18
720,y1711,20170710,6058,6058,6158,6214,6100,6100,6156,42,98,8,492480,14
721,y1711,20170711,6100,6156,0,0,0,6200,6200,44,44,0,0,14
722,y1711,20170712,6200,6200,0,0,0,6200,6200,0,0,0,0,14
723,y1711,20170713,6200,6200,0,0,0,6200,6200,0,0,0,0,14
724,y1711,20170714,6200,6200,0,0,0,6200,6200,0,0,0,0,14
725,y1711,20170717,6200,6200,0,0,0,6200,6200,0,0,0,0,14
726,y1711,20170718,6200,6200,0,0,0,6198,6198,-2,-2,0,0,14
727,y1711,20170719,6198,6198,0,0,0,6198,6198,0,0,0,0,14
728,y1711,20170720,6198,6198,0,0,0,6198,6198,0,0,0,0,14
729,y1711,20170721,6198,6198,0,0,0,6198,6198,0,0,0,0,14
730,y1711,20170724,6198,6198,0,0,0,6198,6198,0,0,0,0,14
731,y1711,20170725,6198,6198,0,0,0,6198,6198,0,0,0,0,14
732,y1711,20170726,6198,6198,0,0,0,6198,6198,0,0,0,0,14
733,y1711,20170727,6198,6198,6236,6288,6164,6234,6250,36,52,52,3250280,14
734,y1711,20170728,6234,6250,6158,6158,6158,6158,6158,-92,-92,2,123160,14
735,y1711,20170731,6158,6158,0,0,0,6154,6154,-4,-4,0,0,14
736,y1711,20170801,6154,6154,6252,6252,6252,6252,6252,98,98,20,1250400,34
737,y1711,20170802,6252,6252,0,0,0,6252,6252,0,0,0,0,34
738,y1711,20170803,6252,6252,6204,6208,6204,6206,6206,-46,-46,14,868920,32
739,y1711,20170804,6206,6206,6146,6146,6146,6146,6146,-60,-60,4,245840,32
740,y1711,20170807,6146,6146,0,0,0,6146,6146,0,0,0,0,32
741,y1711,20170808,6146,6146,0,0,0,6184,6184,38,38,0,0,32
742,y1711,20170809,6184,6184,0,0,0,6244,6244,60,60,0,0,32
743,y1711,20170810,6244,6244,6296,6330,6280,6280,6304,36,60,8,504400,30
744,y1711,20170811,6280,6304,6352,6366,6352,6366,6358,62,54,4,254360,30
745,y1711,20170814,6366,6358,0,0,0,6342,6342,-16,-16,0,0,30
746,y1711,20170815,6342,6342,0,0,0,6340,6340,-2,-2,0,0,30
747,y1711,20170816,6340,6340,0,0,0,6284,6284,-56,-56,0,0,30
748,y1711,20170817,6284,6284,0,0,0,6284,6284,0,0,0,0,30
749,y1711,20170818,6284,6284,0,0,0,6284,6284,0,0,0,0,30
750,y1711,20170821,6284,6284,0,0,0,6284,6284,0,0,0,0,30
751,y1711,20170822,6284,6284,6380,6380,6380,6380,6380,96,96,2,127600,28
752,y1711,20170823,6380,6380,6408,6408,6408,6408,6408,28,28,6,384480,28
753,y1711,20170824,6408,6408,0,0,0,6408,6408,0,0,0,0,28
754,y1711,20170825,6408,6408,0,0,0,6408,6408,0,0,0,0,28
755,y1711,20170828,6408,6408,0,0,0,6396,6396,-12,-12,0,0,28
756,y1711,20170829,6396,6396,0,0,0,6396,6396,0,0,0,0,28
757,y1711,20170830,6396,6396,0,0,0,6358,6358,-38,-38,0,0,28
758,y1711,20170831,6358,6358,0,0,0,6358,6358,0,0,0,0,28
759,y1711,20170901,6358,6358,0,0,0,6358,6358,0,0,0,0,28
760,y1711,20170904,6358,6358,0,0,0,6358,6358,0,0,0,0,28
761,y1711,20170905,6358,6358,0,0,0,6358,6358,0,0,0,0,28
762,y1711,20170906,6358,6358,0,0,0,6358,6358,0,0,0,0,28
763,y1711,20170907,6358,6358,0,0,0,6358,6358,0,0,0,0,28
764,y1711,20170908,6358,6358,0,0,0,6358,6358,0,0,0,0,28
765,y1711,20170911,6358,6358,0,0,0,6358,6358,0,0,0,0,28
766,y1711,20170912,6358,6358,0,0,0,6358,6358,0,0,0,0,28
767,y1711,20170913,6358,6358,0,0,0,6358,6358,0,0,0,0,28
768,y1711,20170914,6358,6358,0,0,0,6358,6358,0,0,0,0,28
769,y1711,20170915,6358,6358,6514,6514,6382,6382,6448,24,90,4,257920,28
770,y1711,20170918,6382,6448,0,0,0,6448,6448,0,0,0,0,28
771,y1711,20170919,6448,6448,0,0,0,6448,6448,0,0,0,0,28
772,y1711,20170920,6448,6448,0,0,0,6448,6448,0,0,0,0,28
773,y1711,20170921,6448,6448,0,0,0,6448,6448,0,0,0,0,28
774,y1711,20170922,6448,6448,0,0,0,6448,6448,0,0,0,0,28
775,y1711,20170925,6448,6448,0,0,0,6448,6448,0,0,0,0,28
776,y1711,20170926,6448,6448,0,0,0,6448,6448,0,0,0,0,28
777,y1711,20170927,6448,6448,0,0,0,6448,6448,0,0,0,0,28
778,y1711,20170928,6448,6448,0,0,0,6448,6448,0,0,0,0,28
779,y1711,20170929,6448,6448,0,0,0,6448,6448,0,0,0,0,28
780,y1711,20171009,6448,6448,6104,6104,6104,6104,6104,-344,-344,2,122080,28
781,y1711,20171010,6104,6104,6080,6080,6076,6076,6078,-28,-26,8,486320,26
782,y1711,20171011,6076,6078,0,0,0,6078,6078,0,0,0,0,26
783,y1711,20171012,6078,6078,0,0,0,6078,6078,0,0,0,0,26
784,y1711,20171013,6078,6078,0,0,0,6078,6078,0,0,0,0,26
785,y1711,20171016,6078,6078,0,0,0,6078,6078,0,0,0,0,26
786,y1711,20171017,6078,6078,0,0,0,6078,6078,0,0,0,0,26
787,y1711,20171018,6078,6078,6002,6100,6000,6100,6022,22,-56,10,602200,16
788,y1711,20171019,6100,6022,0,0,0,6022,6022,0,0,0,0,16
789,y1711,20171020,6022,6022,0,0,0,6022,6022,0,0,0,0,16
790,y1711,20171023,6022,6022,5992,5992,5992,5992,5992,-30,-30,2,119840,14
791,y1711,20171024,5992,5992,5990,5990,5990,5990,5990,-2,-2,6,359400,12
792,y1711,20171025,5990,5990,0,0,0,5990,5990,0,0,0,0,12
793,y1711,20171026,5990,5990,0,0,0,5990,5990,0,0,0,0,12
794,y1711,20171027,5990,5990,5990,5990,5990,5990,5990,0,0,4,239600,8
795,y1711,20171030,5990,5990,0,0,0,5990,5990,0,0,0,0,8
796,y1711,20171031,5990,5990,6146,6146,5888,5888,5952,-102,-38,8,476200,6
797,y1711,20171101,5888,5952,0,0,0,5952,5952,0,0,0,0,0
798,y1711,20171102,5952,5952,0,0,0,5952,5952,0,0,0,0,0
799,y1711,20171103,5952,5952,0,0,0,5952,5952,0,0,0,0,0
800,y1711,20171106,5952,5952,0,0,0,5952,5952,0,0,0,0,0
801,y1711,20171107,5952,5952,0,0,0,5952,5952,0,0,0,0,0
802,y1711,20171108,5952,5952,0,0,0,5952,5952,0,0,0,0,0
803,y1711,20171109,5952,5952,0,0,0,5952,5952,0,0,0,0,0
804,y1711,20171110,5952,5952,0,0,0,5952,5952,0,0,0,0,0
805,y1711,20171113,5952,5952,0,0,0,5952,5952,0,0,0,0,0
806,y1711,20171114,5952,5952,0,0,0,5952,5952,0,0,0,0,0
807,y1712,20170103,7104,7104,0,0,0,7104,7104,0,0,0,0,2
808,y1712,20170104,7104,7104,0,0,0,7012,7012,-92,-92,0,0,2
809,y1712,20170105,7012,7012,0,0,0,7012,7012,0,0,0,0,2
810,y1712,20170106,7012,7012,0,0,0,7012,7012,0,0,0,0,2
811,y1712,20170109,7012,7012,0,0,0,7012,7012,0,0,0,0,2
812,y1712,20170110,7012,7012,0,0,0,7012,7012,0,0,0,0,2
813,y1712,20170111,7012,7012,0,0,0,7012,7012,0,0,0,0,2
814,y1712,20170112,7012,7012,0,0,0,7012,7012,0,0,0,0,2
815,y1712,20170113,7012,7012,0,0,0,7012,7012,0,0,0,0,2
816,y1712,20170116,7012,7012,0,0,0,7012,7012,0,0,0,0,2
817,y1712,20170117,7012,7012,7164,7164,7164,7164,7164,152,152,2,143280,4
818,y1712,20170118,7164,7164,0,0,0,7164,7164,0,0,0,0,4
819,y1712,20170119,7164,7164,0,0,0,7164,7164,0,0,0,0,4
820,y1712,20170120,7164,7164,0,0,0,7164,7164,0,0,0,0,4
821,y1712,20170123,7164,7164,0,0,0,7164,7164,0,0,0,0,4
822,y1712,20170124,7164,7164,0,0,0,7164,7164,0,0,0,0,4
823,y1712,20170125,7164,7164,0,0,0,7164,7164,0,0,0,0,4
824,y1712,20170126,7164,7164,0,0,0,7130,7130,-34,-34,0,0,4
825,y1712,20170203,7130,7130,0,0,0,7130,7130,0,0,0,0,4
826,y1712,20170206,7130,7130,0,0,0,7098,7098,-32,-32,0,0,4
827,y1712,20170207,7098,7098,0,0,0,7094,7094,-4,-4,0,0,4
828,y1712,20170208,7094,7094,0,0,0,7094,7094,0,0,0,0,4
829,y1712,20170209,7094,7094,6910,7078,6910,7078,6978,-16,-116,8,558280,6
830,y1712,20170210,7078,6978,0,0,0,6978,6978,0,0,0,0,6
831,y1712,20170213,6978,6978,0,0,0,6978,6978,0,0,0,0,6
832,y1712,20170214,6978,6978,0,0,0,6978,6978,0,0,0,0,6
833,y1712,20170215,6978,6978,0,0,0,6978,6978,0,0,0,0,6
834,y1712,20170216,6978,6978,0,0,0,6978,6978,0,0,0,0,6
835,y1712,20170217,6978,6978,6948,6948,6948,6948,6948,-30,-30,2,138960,6
836,y1712,20170220,6948,6948,6948,6948,6890,6890,6918,-58,-30,4,276760,6
837,y1712,20170221,6890,6918,6854,6854,6854,6854,6854,-64,-64,2,137080,4
838,y1712,20170222,6854,6854,0,0,0,6854,6854,0,0,0,0,4
839,y1712,20170223,6854,6854,6900,6900,6900,6900,6900,46,46,2,138000,6
840,y1712,20170224,6900,6900,0,0,0,6900,6900,0,0,0,0,6
841,y1712,20170227,6900,6900,0,0,0,6900,6900,0,0,0,0,6
842,y1712,20170228,6900,6900,0,0,0,6900,6900,0,0,0,0,6
843,y1712,20170301,6900,6900,0,0,0,6900,6900,0,0,0,0,6
844,y1712,20170302,6900,6900,0,0,0,6900,6900,0,0,0,0,6
845,y1712,20170303,6900,6900,0,0,0,6900,6900,0,0,0,0,6
846,y1712,20170306,6900,6900,0,0,0,6900,6900,0,0,0,0,6
847,y1712,20170307,6900,6900,0,0,0,6900,6900,0,0,0,0,6
848,y1712,20170308,6900,6900,0,0,0,6900,6900,0,0,0,0,6
849,y1712,20170309,6900,6900,0,0,0,6892,6892,-8,-8,0,0,6
850,y1712,20170310,6892,6892,0,0,0,6816,6816,-76,-76,0,0,6
851,y1712,20170313,6816,6816,0,0,0,6796,6796,-20,-20,0,0,6
852,y1712,20170314,6796,6796,0,0,0,6734,6734,-62,-62,0,0,6
853,y1712,20170315,6734,6734,0,0,0,6734,6734,0,0,0,0,6
854,y1712,20170316,6734,6734,6724,6724,6724,6724,6724,-10,-10,2,134480,8
855,y1712,20170317,6724,6724,0,0,0,6724,6724,0,0,0,0,8
856,y1712,20170320,6724,6724,0,0,0,6724,6724,0,0,0,0,8
857,y1712,20170321,6724,6724,0,0,0,6724,6724,0,0,0,0,8
858,y1712,20170322,6724,6724,0,0,0,6802,6802,78,78,0,0,8
859,y1712,20170323,6802,6802,0,0,0,6732,6732,-70,-70,0,0,8
860,y1712,20170324,6732,6732,0,0,0,6682,6682,-50,-50,0,0,8
861,y1712,20170327,6682,6682,0,0,0,6550,6550,-132,-132,0,0,8
862,y1712,20170328,6550,6550,6398,6398,6398,6398,6398,-152,-152,2,127960,10
863,y1712,20170329,6398,6398,0,0,0,6398,6398,0,0,0,0,10
864,y1712,20170330,6398,6398,0,0,0,6398,6398,0,0,0,0,10
865,y1712,20170331,6398,6398,0,0,0,6326,6326,-72,-72,0,0,10
866,y1712,20170405,6326,6326,0,0,0,6326,6326,0,0,0,0,10
867,y1712,20170406,6326,6326,0,0,0,6352,6352,26,26,0,0,10
868,y1712,20170407,6352,6352,0,0,0,6220,6220,-132,-132,0,0,10
869,y1712,20170410,6220,6220,0,0,0,6238,6238,18,18,0,0,10
870,y1712,20170411,6238,6238,0,0,0,6244,6244,6,6,0,0,10
871,y1712,20170412,6244,6244,0,0,0,6198,6198,-46,-46,0,0,10
872,y1712,20170413,6198,6198,0,0,0,6184,6184,-14,-14,0,0,10
873,y1712,20170414,6184,6184,0,0,0,6194,6194,10,10,0,0,10
874,y1712,20170417,6194,6194,0,0,0,6194,6194,0,0,0,0,10
875,y1712,20170418,6194,6194,0,0,0,6236,6236,42,42,0,0,10
876,y1712,20170419,6236,6236,0,0,0,6092,6092,-144,-144,0,0,10
877,y1712,20170420,6092,6092,0,0,0,6006,6006,-86,-86,0,0,10
878,y1712,20170421,6006,6006,0,0,0,6006,6006,0,0,0,0,10
879,y1712,20170424,6006,6006,0,0,0,6066,6066,60,60,0,0,10
880,y1712,20170425,6066,6066,6086,6086,6086,6086,6086,20,20,2,121720,12
881,y1712,20170426,6086,6086,0,0,0,6080,6080,-6,-6,0,0,12
882,y1712,20170427,6080,6080,0,0,0,6114,6114,34,34,0,0,12
883,y1712,20170428,6114,6114,0,0,0,6114,6114,0,0,0,0,12
884,y1712,20170502,6114,6114,0,0,0,6180,6180,66,66,0,0,12
885,y1712,20170503,6180,6180,0,0,0,6188,6188,8,8,0,0,12
886,y1712,20170504,6188,6188,5960,5960,5960,5960,5960,-228,-228,4,238400,8
887,y1712,20170505,5960,5960,0,0,0,5960,5960,0,0,0,0,8
888,y1712,20170508,5960,5960,0,0,0,6070,6070,110,110,0,0,8
889,y1712,20170509,6070,6070,0,0,0,6070,6070,0,0,0,0,8
890,y1712,20170510,6070,6070,0,0,0,6070,6070,0,0,0,0,8
891,y1712,20170511,6070,6070,0,0,0,6080,6080,10,10,0,0,8
892,y1712,20170512,6080,6080,0,0,0,6074,6074,-6,-6,0,0,8
893,y1712,20170515,6074,6074,0,0,0,6124,6124,50,50,0,0,8
894,y1712,20170516,6124,6124,0,0,0,6172,6172,48,48,0,0,8
895,y1712,20170517,6172,6172,0,0,0,6190,6190,18,18,0,0,8
896,y1712,20170518,6190,6190,0,0,0,6190,6190,0,0,0,0,8
897,y1712,20170519,6190,6190,0,0,0,6190,6190,0,0,0,0,8
898,y1712,20170522,6190,6190,0,0,0,6190,6190,0,0,0,0,8
899,y1712,20170523,6190,6190,0,0,0,6170,6170,-20,-20,0,0,8
900,y1712,20170524,6170,6170,6066,6066,6066,6066,6066,-104,-104,2,121320,8
901,y1712,20170525,6066,6066,0,0,0,6066,6066,0,0,0,0,8
902,y1712,20170526,6066,6066,6044,6044,6044,6044,6044,-22,-22,2,120880,8
903,y1712,20170531,6044,6044,0,0,0,6044,6044,0,0,0,0,8
904,y1712,20170601,6044,6044,0,0,0,6044,6044,0,0,0,0,8
905,y1712,20170602,6044,6044,0,0,0,6044,6044,0,0,0,0,8
906,y1712,20170605,6044,6044,0,0,0,6044,6044,0,0,0,0,8
907,y1712,20170606,6044,6044,0,0,0,6044,6044,0,0,0,0,8
908,y1712,20170607,6044,6044,0,0,0,6044,6044,0,0,0,0,8
909,y1712,20170608,6044,6044,0,0,0,5900,5900,-144,-144,0,0,8
910,y1712,20170609,5900,5900,5972,5986,5972,5986,5978,86,78,4,239160,8
911,y1712,20170612,5986,5978,0,0,0,6028,6028,50,50,0,0,8
912,y1712,20170613,6028,6028,0,0,0,6034,6034,6,6,0,0,8
913,y1712,20170614,6034,6034,0,0,0,6034,6034,0,0,0,0,8
914,y1712,20170615,6034,6034,0,0,0,6034,6034,0,0,0,0,8
915,y1712,20170616,6034,6034,0,0,0,6034,6034,0,0,0,0,8
916,y1712,20170619,6034,6034,0,0,0,6034,6034,0,0,0,0,8
917,y1712,20170620,6034,6034,0,0,0,6034,6034,0,0,0,0,8
918,y1712,20170621,6034,6034,0,0,0,5970,5970,-64,-64,0,0,8
919,y1712,20170622,5970,5970,0,0,0,5970,5970,0,0,0,0,8
920,y1712,20170623,5970,5970,0,0,0,5970,5970,0,0,0,0,8
921,y1712,20170626,5970,5970,5896,5896,5896,5896,5896,-74,-74,4,235840,4
922,y1712,20170627,5896,5896,0,0,0,5906,5906,10,10,0,0,4
923,y1712,20170628,5906,5906,0,0,0,5980,5980,74,74,0,0,4
924,y1712,20170629,5980,5980,0,0,0,6044,6044,64,64,0,0,4
925,y1712,20170630,6044,6044,0,0,0,6036,6036,-8,-8,0,0,4
926,y1712,20170703,6036,6036,0,0,0,6036,6036,0,0,0,0,4
927,y1712,20170704,6036,6036,0,0,0,5998,5998,-38,-38,0,0,4
928,y1712,20170705,5998,5998,0,0,0,5980,5980,-18,-18,0,0,4
929,y1712,20170706,5980,5980,0,0,0,6026,6026,46,46,0,0,4
930,y1712,20170707,6026,6026,0,0,0,6020,6020,-6,-6,0,0,4
931,y1712,20170710,6020,6020,0,0,0,6116,6116,96,96,0,0,4
932,y1712,20170711,6116,6116,0,0,0,6184,6184,68,68,0,0,4
933,y1712,20170712,6184,6184,0,0,0,6192,6192,8,8,0,0,4
934,y1712,20170713,6192,6192,0,0,0,6152,6152,-40,-40,0,0,4
935,y1712,20170714,6152,6152,0,0,0,6096,6096,-56,-56,0,0,4
936,y1712,20170717,6096,6096,0,0,0,6128,6128,32,32,0,0,4
937,y1712,20170718,6128,6128,0,0,0,6126,6126,-2,-2,0,0,4
938,y1712,20170719,6126,6126,0,0,0,6106,6106,-20,-20,0,0,4
939,y1712,20170720,6106,6106,0,0,0,6162,6162,56,56,0,0,4
940,y1712,20170721,6162,6162,0,0,0,6190,6190,28,28,0,0,4
941,y1712,20170724,6190,6190,0,0,0,6124,6124,-66,-66,0,0,4
942,y1712,20170725,6124,6124,0,0,0,6172,6172,48,48,0,0,4
943,y1712,20170726,6172,6172,6402,6402,6300,6300,6350,128,178,8,508120,6
944,y1712,20170727,6300,6350,0,0,0,6350,6350,0,0,0,0,6
945,y1712,20170728,6350,6350,0,0,0,6258,6258,-92,-92,0,0,6
946,y1712,20170731,6258,6258,0,0,0,6254,6254,-4,-4,0,0,6
947,y1712,20170801,6254,6254,0,0,0,6352,6352,98,98,0,0,6
948,y1712,20170802,6352,6352,0,0,0,6298,6298,-54,-54,0,0,6
949,y1712,20170803,6298,6298,0,0,0,6298,6298,0,0,0,0,6
950,y1712,20170804,6298,6298,0,0,0,6238,6238,-60,-60,0,0,6
951,y1712,20170807,6238,6238,6158,6196,6134,6134,6162,-104,-76,6,369760,4
952,y1712,20170808,6134,6162,0,0,0,6200,6200,38,38,0,0,4
953,y1712,20170809,6200,6200,0,0,0,6260,6260,60,60,0,0,4
954,y1712,20170810,6260,6260,0,0,0,6320,6320,60,60,0,0,4
955,y1712,20170811,6320,6320,6360,6360,6310,6310,6326,-10,6,6,379600,4
956,y1712,20170814,6310,6326,0,0,0,6326,6326,0,0,0,0,4
957,y1712,20170815,6326,6326,0,0,0,6326,6326,0,0,0,0,4
958,y1712,20170816,6326,6326,6230,6254,6230,6254,6242,-72,-84,4,249680,4
959,y1712,20170817,6254,6242,6302,6302,6204,6204,6250,-38,8,126,7876960,18
960,y1712,20170818,6204,6250,6218,6218,6218,6218,6218,-32,-32,2,124360,18
961,y1712,20170821,6218,6218,6270,6274,6270,6274,6272,56,54,4,250880,14
962,y1712,20170822,6274,6272,0,0,0,6366,6366,94,94,0,0,14
963,y1712,20170823,6366,6366,0,0,0,6366,6366,0,0,0,0,14
964,y1712,20170824,6366,6366,0,0,0,6366,6366,0,0,0,0,14
965,y1712,20170825,6366,6366,0,0,0,6366,6366,0,0,0,0,14
966,y1712,20170828,6366,6366,0,0,0,6366,6366,0,0,0,0,14
967,y1712,20170829,6366,6366,0,0,0,6320,6320,-46,-46,0,0,14
968,y1712,20170830,6320,6320,0,0,0,6282,6282,-38,-38,0,0,14
969,y1712,20170831,6282,6282,0,0,0,6282,6282,0,0,0,0,14
970,y1712,20170901,6282,6282,0,0,0,6334,6334,52,52,0,0,14
971,y1712,20170904,6334,6334,0,0,0,6342,6342,8,8,0,0,14
972,y1712,20170905,6342,6342,6388,6388,6346,6346,6366,4,24,4,254680,12
973,y1712,20170906,6346,6366,0,0,0,6366,6366,0,0,0,0,12
974,y1712,20170907,6366,6366,0,0,0,6366,6366,0,0,0,0,12
975,y1712,20170908,6366,6366,0,0,0,6366,6366,0,0,0,0,12
976,y1712,20170911,6366,6366,0,0,0,6366,6366,0,0,0,0,12
977,y1712,20170912,6366,6366,0,0,0,6350,6350,-16,-16,0,0,12
978,y1712,20170913,6350,6350,0,0,0,6350,6350,0,0,0,0,12
979,y1712,20170914,6350,6350,0,0,0,6350,6350,0,0,0,0,12
980,y1712,20170915,6350,6350,0,0,0,6360,6360,10,10,0,0,12
981,y1712,20170918,6360,6360,0,0,0,6350,6350,-10,-10,0,0,12
982,y1712,20170919,6350,6350,0,0,0,6350,6350,0,0,0,0,12
983,y1712,20170920,6350,6350,0,0,0,6350,6350,0,0,0,0,12
984,y1712,20170921,6350,6350,0,0,0,6350,6350,0,0,0,0,12
985,y1712,20170922,6350,6350,0,0,0,6350,6350,0,0,0,0,12
986,y1712,20170925,6350,6350,0,0,0,6350,6350,0,0,0,0,12
987,y1712,20170926,6350,6350,0,0,0,6350,6350,0,0,0,0,12
988,y1712,20170927,6350,6350,0,0,0,6170,6170,-180,-180,0,0,12
989,y1712,20170928,6170,6170,5968,6048,5968,6048,6008,-122,-162,12,720960,12
990,y1712,20170929,6048,6008,0,0,0,6008,6008,0,0,0,0,12
991,y1712,20171009,6008,6008,0,0,0,5688,5688,-320,-320,0,0,12
992,y1712,20171010,5688,5688,0,0,0,5972,5972,284,284,0,0,12
993,y1712,20171011,5972,5972,0,0,0,5972,5972,0,0,0,0,12
994,y1712,20171012,5972,5972,5998,5998,5998,5998,5998,26,26,2,119960,14
995,y1712,20171013,5998,5998,0,0,0,5998,5998,0,0,0,0,14
996,y1712,20171016,5998,5998,0,0,0,5998,5998,0,0,0,0,14
997,y1712,20171017,5998,5998,6082,6082,6070,6070,6076,72,78,4,243040,12
998,y1712,20171018,6070,6076,0,0,0,6058,6058,-18,-18,0,0,12
999,y1712,20171019,6058,6058,0,0,0,6058,6058,0,0,0,0,12
1000,y1712,20171020,6058,6058,0,0,0,6058,6058,0,0,0,0,12
1001,y1712,20171023,6058,6058,0,0,0,6058,6058,0,0,0,0,12
1002,y1712,20171024,6058,6058,0,0,0,6058,6058,0,0,0,0,12
1003,y1712,20171025,6058,6058,6046,6118,6046,6118,6084,60,26,14,851800,14
1004,y1712,20171026,6118,6084,0,0,0,6084,6084,0,0,0,0,14
1005,y1712,20171027,6084,6084,6130,6130,6130,6130,6130,46,46,2,122600,12
1006,y1712,20171030,6130,6130,0,0,0,6130,6130,0,0,0,0,12
1007,y1712,20171031,6130,6130,0,0,0,6092,6092,-38,-38,0,0,12
1008,y1712,20171101,6092,6092,6020,6020,6020,6020,6020,-72,-72,2,120400,12
1009,y1712,20171102,6020,6020,0,0,0,6020,6020,0,0,0,0,12
1010,y1712,20171103,6020,6020,0,0,0,6020,6020,0,0,0,0,12
1011,y1712,20171106,6020,6020,6038,6052,6038,6052,6044,32,24,4,241800,8
1012,y1712,20171107,6052,6044,0,0,0,6044,6044,0,0,0,0,8
1013,y1712,20171108,6044,6044,0,0,0,6044,6044,0,0,0,0,8
1014,y1712,20171109,6044,6044,0,0,0,6044,6044,0,0,0,0,8
1015,y1712,20171110,6044,6044,0,0,0,6044,6044,0,0,0,0,8
1016,y1712,20171113,6044,6044,6060,6060,5936,5936,5998,-108,-46,4,239920,8
1017,y1712,20171114,5936,5998,0,0,0,5998,5998,0,0,0,0,8
1018,y1712,20171115,5998,5998,0,0,0,5998,5998,0,0,0,0,8
1019,y1712,20171116,5998,5998,5982,5982,5804,5900,5894,-98,-104,6,353720,6
1020,y1712,20171117,5900,5894,0,0,0,5894,5894,0,0,0,0,6
1021,y1712,20171120,5894,5894,0,0,0,5894,5894,0,0,0,0,6
1022,y1712,20171121,5894,5894,5702,5702,5702,5702,5702,-192,-192,2,114040,6
1023,y1712,20171122,5702,5702,5808,5808,5808,5808,5808,106,106,2,116160,4
1024,y1712,20171123,5808,5808,0,0,0,5808,5808,0,0,0,0,4
1025,y1712,20171124,5808,5808,0,0,0,5808,5808,0,0,0,0,4
1026,y1712,20171127,5808,5808,0,0,0,5808,5808,0,0,0,0,4
1027,y1712,20171128,5808,5808,5808,5808,5808,5808,5808,0,0,4,232320,2
1028,y1712,20171129,5808,5808,0,0,0,5808,5808,0,0,0,0,2
1029,y1712,20171130,5808,5808,5808,5808,5808,5808,5808,0,0,2,116160,0
1030,y1712,20171201,5808,5808,0,0,0,5808,5808,0,0,0,0,0
1031,y1712,20171204,5808,5808,0,0,0,5808,5808,0,0,0,0,0
1032,y1712,20171205,5808,5808,0,0,0,5808,5808,0,0,0,0,0
1033,y1712,20171206,5808,5808,0,0,0,5808,5808,0,0,0,0,0
1034,y1712,20171207,5808,5808,0,0,0,5808,5808,0,0,0,0,0
1035,y1712,20171208,5808,5808,0,0,0,5808,5808,0,0,0,0,0
1036,y1712,20171211,5808,5808,0,0,0,5808,5808,0,0,0,0,0
1037,y1712,20171212,5808,5808,0,0,0,5808,5808,0,0,0,0,0
1038,y1712,20171213,5808,5808,0,0,0,5808,5808,0,0,0,0,0
1039,y1712,20171214,5808,5808,0,0,0,5808,5808,0,0,0,0,0
1040,y1801,20170117,7012,7012,7114,7220,7114,7166,7186,154,174,1718,123460960,1230
1041,y1801,20170118,7166,7186,7168,7180,7132,7160,7162,-26,-24,878,62898120,1668
1042,y1801,20170119,7160,7162,7160,7184,7136,7146,7158,-16,-4,674,48255640,1830
1043,y1801,20170120,7146,7158,7152,7164,7122,7146,7140,-12,-18,2622,187213200,3428
1044,y1801,20170123,7146,7140,7138,7148,7108,7134,7130,-6,-10,1618,115373480,4088
1045,y1801,20170124,7134,7130,7140,7224,7128,7190,7180,60,50,3096,222304440,5590
1046,y1801,20170125,7190,7180,7170,7198,7108,7128,7156,-52,-24,2890,206842560,7070
1047,y1801,20170126,7128,7156,7136,7158,7064,7080,7112,-76,-44,1170,83224200,7328
1048,y1801,20170203,7080,7112,7068,7100,7014,7026,7060,-86,-52,3862,272707920,9966
1049,y1801,20170206,7026,7060,7056,7072,7012,7036,7044,-24,-16,4762,335519080,11154
1050,y1801,20170207,7036,7044,7036,7078,7014,7018,7048,-26,4,3826,269676040,13434
1051,y1801,20170208,7018,7048,7014,7090,7014,7074,7052,26,4,3738,263678200,13980
1052,y1801,20170209,7074,7052,7056,7078,7046,7048,7066,-4,14,1250,88328240,14040
1053,y1801,20170210,7048,7066,7066,7120,7046,7118,7096,52,30,3574,253682440,14764
1054,y1801,20170213,7118,7096,7090,7134,7032,7044,7082,-52,-14,4068,288147360,16860
1055,y1801,20170214,7044,7082,7058,7076,7002,7008,7042,-74,-40,6220,438038160,18540
1056,y1801,20170215,7008,7042,7028,7040,6982,7008,7012,-34,-30,4300,301527000,18520
1057,y1801,20170216,7008,7012,7012,7066,6990,6992,7030,-20,18,5584,392603200,19034
1058,y1801,20170217,6992,7030,6962,7012,6898,6902,6932,-128,-98,5660,392393120,20994
1059,y1801,20170220,6902,6932,6894,6922,6892,6910,6904,-22,-28,2056,141984800,21152
1060,y1801,20170221,6910,6904,6896,6926,6856,6892,6900,-12,-4,4596,317210880,22064
1061,y1801,20170222,6892,6900,6858,6882,6836,6872,6854,-28,-46,4022,275739400,23312
1062,y1801,20170223,6872,6854,6858,6890,6786,6812,6826,-42,-28,5118,349390560,25482
1063,y1801,20170224,6812,6826,6826,6840,6768,6804,6798,-22,-28,9270,630175080,25542
1064,y1801,20170227,6804,6798,6832,6842,6790,6804,6824,6,26,3784,258247000,26110
1065,y1801,20170228,6804,6824,6800,6828,6772,6800,6802,-24,-22,3986,271192200,26300
1066,y1801,20170301,6800,6802,6852,6940,6830,6900,6882,98,80,9098,626235000,27976
1067,y1801,20170302,6900,6882,6942,6980,6914,6954,6950,72,68,6886,478644680,30770
1068,y1801,20170303,6954,6950,6970,6970,6914,6954,6942,4,-8,4088,283819320,31208
1069,y1801,20170306,6954,6942,6940,6994,6914,6954,6944,12,2,10642,739078400,34852
1070,y1801,20170307,6954,6944,6952,6956,6850,6860,6886,-84,-58,8912,613681600,35590
1071,y1801,20170308,6860,6886,6864,6866,6766,6802,6806,-84,-80,9662,657750200,36808
1072,y1801,20170309,6802,6806,6818,6840,6750,6792,6796,-14,-10,17716,1204316040,46222
1073,y1801,20170310,6792,6796,6782,6782,6662,6674,6714,-122,-82,17398,1168178840,51488
1074,y1801,20170313,6674,6714,6668,6726,6668,6704,6698,-10,-16,9782,655369920,54448
1075,y1801,20170314,6704,6698,6688,6688,6620,6634,6652,-64,-46,18686,1243239880,57650
1076,y1801,20170315,6634,6652,6636,6680,6580,6642,6642,-10,-10,8366,555818720,58380
1077,y1801,20170316,6642,6642,6680,6686,6574,6606,6620,-36,-22,19182,1270087000,60748
1078,y1801,20170317,6606,6620,6620,6650,6580,6624,6614,4,-6,11218,742060280,59478
1079,y1801,20170320,6624,6614,6624,6672,6620,6668,6646,54,32,15758,1047541880,58814
1080,y1801,20170321,6668,6646,6666,6686,6600,6636,6642,-10,-4,11536,766409720,61764
1081,y1801,20170322,6636,6642,6640,6678,6616,6630,6646,-12,4,12924,859097760,62972
1082,y1801,20170323,6630,6646,6648,6648,6544,6550,6594,-96,-52,21128,1393359840,71046
1083,y1801,20170324,6550,6594,6556,6592,6504,6506,6538,-88,-56,12642,826783520,71954
1084,y1801,20170327,6506,6538,6490,6512,6352,6368,6416,-170,-122,22474,1442138960,75640
1085,y1801,20170328,6368,6416,6366,6396,6320,6358,6364,-58,-52,11190,712229320,77410
1086,y1801,20170329,6358,6364,6368,6390,6350,6368,6368,4,4,14684,935325280,78164
1087,y1801,20170330,6368,6368,6378,6378,6266,6280,6310,-88,-58,14500,915163920,81558
1088,y1801,20170331,6280,6310,6266,6304,6192,6200,6252,-110,-58,11498,719063240,83372
1089,y1801,20170405,6200,6252,6170,6234,6126,6202,6186,-50,-66,17270,1068492400,85888
1090,y1801,20170406,6202,6186,6208,6242,6182,6192,6206,6,20,15382,954660840,90830
1091,y1801,20170407,6192,6206,6210,6210,6060,6106,6130,-100,-76,21556,1321798440,93694
1092,y1801,20170410,6106,6130,6110,6202,5982,6130,6150,0,20,26924,1656282640,96250
1093,y1801,20170411,6130,6150,6130,6194,6118,6164,6160,14,10,21850,1346316600,94524
1094,y1801,20170412,6164,6160,6168,6182,6044,6050,6104,-110,-56,33948,2072539680,101874
1095,y1801,20170413,6050,6104,6060,6120,6046,6114,6094,10,-10,29610,1804995960,101390
1096,y1801,20170414,6114,6094,6104,6132,6070,6098,6104,4,10,19724,1204000200,100220
1097,y1801,20170417,6098,6104,6102,6182,6098,6112,6140,8,36,27396,1682639320,99486
1098,y1801,20170418,6112,6140,6116,6170,6062,6066,6118,-74,-22,35146,2150892080,102978
1099,y1801,20170419,6066,6118,6058,6058,5940,5962,5982,-156,-136,41882,2506188160,109800
1100,y1801,20170420,5962,5982,5928,5992,5918,5980,5962,-2,-20,50686,3022577160,107318
1101,y1801,20170421,5980,5962,5986,6010,5946,5984,5980,22,18,29116,1741642280,106316
1102,y1801,20170424,5984,5980,5992,6054,5986,6038,6020,58,40,47670,2870487520,106400
1103,y1801,20170425,6038,6020,6038,6044,5968,5984,6010,-36,-10,39110,2350695400,115246
1104,y1801,20170426,5984,6010,5990,6030,5978,6000,6004,-10,-6,33346,2002347480,112120
1105,y1801,20170427,6000,6004,6016,6064,6010,6022,6036,18,32,35074,2117368560,116876
1106,y1801,20170428,6022,6036,6016,6018,5982,5990,5998,-46,-38,31868,1911797440,117876
1107,y1801,20170502,5990,5998,6020,6080,6010,6066,6056,68,58,29238,1770858960,115192
1108,y1801,20170503,6066,6056,6068,6086,6046,6060,6062,4,6,27084,1641953800,120396
1109,y1801,20170504,6060,6062,6048,6066,5986,6022,6022,-40,-40,46412,2794958960,121996
1110,y1801,20170505,6022,6022,6030,6034,5958,5986,6000,-36,-22,39752,2385536840,121878
1111,y1801,20170508,5986,6000,6018,6130,6018,6070,6076,70,76,65598,3985970200,120152
1112,y1801,20170509,6070,6076,6076,6096,6038,6088,6060,12,-16,37590,2278622240,123898
1113,y1801,20170510,6088,6060,6080,6116,6058,6076,6092,16,32,38660,2355639920,126314
1114,y1801,20170511,6076,6092,6076,6170,6022,6168,6090,76,-2,60504,3685672000,129014
1115,y1801,20170512,6168,6090,6160,6166,6108,6142,6130,52,40,29540,1810967120,129638
1116,y1801,20170515,6142,6130,6126,6188,6098,6154,6148,24,18,42678,2624218560,132626
1117,y1801,20170516,6154,6148,6170,6220,6170,6192,6198,44,50,55780,3457689200,143932
1118,y1801,20170517,6192,6198,6192,6228,6146,6218,6186,20,-12,45752,2830965160,151906
1119,y1801,20170518,6218,6186,6228,6234,6152,6164,6184,-22,-2,45500,2814542200,157740
1120,y1801,20170519,6164,6184,6130,6156,6084,6110,6124,-74,-60,65132,3989861640,164464
1121,y1801,20170522,6110,6124,6126,6212,6124,6170,6178,46,54,40120,2478972640,161978
1122,y1801,20170523,6170,6178,6178,6194,6122,6124,6158,-54,-20,39086,2407322360,168528
1123,y1801,20170524,6124,6158,6120,6142,6050,6082,6090,-76,-68,54182,3300701560,172578
1124,y1801,20170525,6082,6090,6092,6116,6078,6090,6096,0,6,33030,2013755240,175716
1125,y1801,20170526,6090,6096,6100,6102,5988,5998,6038,-98,-58,69362,4189253120,187478
1126,y1801,20170531,5998,6038,5978,5978,5838,5844,5904,-194,-134,77232,4559800880,212824
1127,y1801,20170601,5844,5904,5856,5874,5814,5834,5850,-70,-54,48628,2844773240,215258
1128,y1801,20170602,5834,5850,5858,5898,5836,5838,5866,-12,16,65764,3858346720,232182
1129,y1801,20170605,5838,5866,5832,5914,5800,5886,5870,20,4,56498,3316740440,231114
1130,y1801,20170606,5886,5870,5892,5920,5860,5910,5886,40,16,67910,3998209880,231704
1131,y1801,20170607,5910,5886,5926,5956,5878,5900,5908,14,22,58570,3460635720,232940
1132,y1801,20170608,5900,5908,5906,5920,5866,5896,5894,-12,-14,43684,2574922440,237944
1133,y1801,20170609,5896,5894,5908,5960,5836,5942,5936,48,42,77690,4612335200,237600
1134,y1801,20170612,5942,5936,5940,6014,5940,6010,5974,74,38,81226,4852851360,238688
1135,y1801,20170613,6010,5974,6002,6004,5958,5968,5982,-6,8,43018,2574026120,238674
1136,y1801,20170614,5968,5982,5968,6012,5952,5996,5988,14,6,50736,3038752920,240800
1137,y1801,20170615,5996,5988,6000,6048,5978,6006,6008,18,20,57550,3457674120,248716
1138,y1801,20170616,6006,6008,6010,6092,5982,6050,6052,42,44,80812,4891753680,262782
1139,y1801,20170619,6050,6052,6058,6106,6040,6080,6080,28,28,72960,4436415280,270828
1140,y1801,20170620,6080,6080,6074,6086,5984,6002,6030,-78,-50,75354,4544147440,283378
1141,y1801,20170621,6002,6030,5982,5992,5932,5960,5960,-70,-70,88032,5247782960,286030
1142,y1801,20170622,5960,5960,5968,5986,5906,5918,5940,-42,-20,55094,3273355640,284526
1143,y1801,20170623,5918,5940,5920,5950,5892,5922,5916,-18,-24,56836,3363474320,281472
1144,y1801,20170626,5922,5916,5922,5954,5904,5928,5926,12,10,50220,2976811640,284030
1145,y1801,20170627,5928,5926,5946,5984,5912,5972,5944,46,18,59764,3553202160,287324
1146,y1801,20170628,5972,5944,5988,6048,5984,6022,6016,78,72,104070,6262067560,298782
1147,y1801,20170629,6022,6016,5998,6104,5996,6064,6072,48,56,137032,8322841240,310466
1148,y1801,20170630,6064,6072,6066,6116,6040,6078,6074,6,2,109760,6668187840,332526
1149,y1801,20170703,6078,6074,6074,6230,6066,6156,6146,82,72,130432,8017035960,358890
1150,y1801,20170704,6156,6146,6160,6174,6064,6068,6108,-78,-38,110838,6770174840,375406
1151,y1801,20170705,6068,6108,6082,6124,6072,6094,6094,-14,-14,69432,4231620280,378048
1152,y1801,20170706,6094,6094,6124,6176,6100,6144,6144,50,50,150604,9255202200,391960
1153,y1801,20170707,6144,6144,6140,6160,6102,6146,6136,2,-8,79080,4853642160,393302
1154,y1801,20170710,6146,6136,6148,6276,6142,6260,6226,124,90,165308,10293577520,414932
1155,y1801,20170711,6260,6226,6272,6336,6242,6302,6294,76,68,170262,10717926680,414012
1156,y1801,20170712,6302,6294,6290,6338,6268,6290,6300,-4,6,108796,6854920840,422524
1157,y1801,20170713,6290,6300,6288,6312,6222,6246,6264,-54,-36,159480,9991630800,429784
1158,y1801,20170714,6246,6264,6206,6246,6166,6194,6200,-70,-64,152242,9439990840,433516
1159,y1801,20170717,6194,6200,6220,6252,6200,6216,6222,16,22,132794,8264367840,452290
1160,y1801,20170718,6216,6222,6224,6278,6174,6190,6228,-32,6,141206,8794593240,453360
1161,y1801,20170719,6190,6228,6216,6238,6172,6218,6206,-10,-22,135024,8381421800,463412
1162,y1801,20170720,6218,6206,6228,6304,6212,6274,6262,68,56,204490,12805413320,486836
1163,y1801,20170721,6274,6262,6304,6330,6252,6288,6294,26,32,215252,13549400280,496780
1164,y1801,20170724,6288,6294,6278,6298,6198,6216,6232,-78,-62,216992,13523061800,514242
1165,y1801,20170725,6216,6232,6224,6324,6214,6324,6276,92,44,178738,11220706240,525912
1166,y1801,20170726,6324,6276,6328,6346,6226,6234,6280,-42,4,284380,17862571040,543086
1167,y1801,20170727,6234,6280,6242,6314,6238,6306,6286,26,6,210586,13239805000,559090
1168,y1801,20170728,6306,6286,6326,6384,6216,6236,6292,-50,6,488842,30763533960,593688
1169,y1801,20170731,6236,6292,6248,6332,6234,6318,6290,26,-2,355790,22379980920,598646
1170,y1801,20170801,6318,6290,6308,6368,6292,6322,6334,32,44,447064,28317367120,648094
1171,y1801,20170802,6322,6334,6292,6314,6242,6264,6266,-70,-68,435526,27293908160,666774
1172,y1801,20170803,6264,6266,6276,6306,6142,6162,6232,-104,-34,537868,33526861160,705764
1173,y1801,20170804,6162,6232,6152,6190,6132,6178,6160,-54,-72,406390,25038852080,720234
1174,y1801,20170807,6178,6160,6188,6226,6162,6164,6188,4,28,378386,23422074080,723440
1175,y1801,20170808,6164,6188,6152,6272,6140,6272,6218,84,30,454292,28252315520,712712
1176,y1801,20170809,6272,6218,6280,6316,6262,6308,6284,90,66,372812,23432146440,699652
1177,y1801,20170810,6308,6284,6306,6326,6230,6324,6280,40,-4,528000,33163145280,720454
1178,y1801,20170811,6324,6280,6328,6426,6218,6266,6306,-14,26,865902,54617866720,731094
1179,y1801,20170814,6266,6306,6302,6328,6232,6292,6286,-14,-20,477444,30012276880,740400
1180,y1801,20170815,6292,6286,6270,6304,6250,6266,6274,-20,-12,453146,28435884360,736666
1181,y1801,20170816,6266,6274,6236,6248,6170,6184,6206,-90,-68,404702,25123330520,743536
1182,y1801,20170817,6184,6206,6210,6232,6182,6224,6208,18,2,349788,21719835920,750672
1183,y1801,20170818,6224,6208,6224,6284,6204,6280,6238,72,30,372908,23268131120,743474
1184,y1801,20170821,6280,6238,6272,6320,6266,6296,6296,58,58,455954,28711440000,750946
1185,y1801,20170822,6296,6296,6316,6398,6284,6394,6338,98,42,545276,34563688600,748800
1186,y1801,20170823,6394,6338,6386,6434,6332,6412,6394,74,56,561140,35882812480,766438
1187,y1801,20170824,6412,6394,6416,6424,6360,6408,6388,14,-6,408538,26103019400,754900
1188,y1801,20170825,6408,6388,6432,6444,6352,6358,6394,-30,6,378130,24180174760,747922
1189,y1801,20170828,6358,6394,6350,6418,6342,6364,6380,-30,-14,367084,23420438400,743714
1190,y1801,20170829,6364,6380,6370,6374,6306,6316,6336,-64,-44,357900,22681680840,733808
1191,y1801,20170830,6316,6336,6302,6348,6282,6284,6314,-52,-22,349288,22054671360,742350
1192,y1801,20170831,6284,6314,6280,6322,6274,6296,6298,-18,-16,287658,18117754480,739746
1193,y1801,20170901,6296,6298,6282,6360,6282,6350,6338,52,40,353116,22383004080,746112
1194,y1801,20170904,6350,6338,6352,6404,6320,6388,6370,50,32,381784,24320155760,748970
1195,y1801,20170905,6388,6370,6382,6402,6332,6398,6370,28,0,369522,23538900040,753344
1196,y1801,20170906,6398,6370,6404,6420,6360,6384,6388,14,18,410226,26211552520,768022
1197,y1801,20170907,6384,6388,6380,6398,6340,6388,6368,0,-20,410396,26141161600,749616
1198,y1801,20170908,6388,6368,6412,6416,6312,6320,6356,-48,-12,512100,32555785560,745964
1199,y1801,20170911,6320,6356,6320,6400,6250,6388,6334,32,-22,573664,36338611400,705288
1200,y1801,20170912,6388,6334,6384,6392,6326,6350,6356,16,22,410228,26080639800,709194
1201,y1801,20170913,6350,6356,6358,6456,6328,6332,6378,-24,22,713260,45493162920,686174
1202,y1801,20170914,6332,6378,6354,6424,6342,6410,6388,32,10,514298,32855386720,683666
1203,y1801,20170915,6410,6388,6390,6426,6380,6410,6402,22,14,445806,28541199160,689308
1204,y1801,20170918,6410,6402,6404,6410,6322,6354,6358,-48,-44,405732,25800407960,679324
1205,y1801,20170919,6354,6358,6324,6378,6316,6332,6342,-26,-16,341018,21633252360,692432
1206,y1801,20170920,6332,6342,6324,6356,6294,6324,6324,-18,-18,344534,21789896680,676516
1207,y1801,20170921,6324,6324,6332,6350,6276,6276,6316,-48,-8,388122,24515243320,694452
1208,y1801,20170922,6276,6316,6262,6272,6216,6232,6240,-84,-76,444062,27717665200,715532
1209,y1801,20170925,6232,6240,6236,6268,6158,6174,6206,-66,-34,423306,26275913440,739976
1210,y1801,20170926,6174,6206,6178,6202,6172,6180,6188,-26,-18,216712,13410270520,716146
1211,y1801,20170927,6180,6188,6198,6212,6140,6166,6174,-22,-14,327324,20211768680,727222
1212,y1801,20170928,6166,6174,6162,6164,6026,6074,6084,-100,-90,444316,27035925720,705546
1213,y1801,20170929,6074,6084,6072,6112,6058,6088,6074,4,-10,289670,17598016920,674548
1214,y1801,20171009,6088,6074,6130,6148,6102,6110,6120,36,46,181278,11095340520,653764
1215,y1801,20171010,6110,6120,6112,6120,6060,6066,6088,-54,-32,258154,15719818160,691892
1216,y1801,20171011,6066,6088,6062,6070,6022,6038,6048,-50,-40,279978,16935468280,712964
1217,y1801,20171012,6038,6048,6038,6082,6036,6072,6058,24,10,206076,12486101320,706010
1218,y1801,20171013,6072,6058,6074,6092,6008,6084,6058,26,0,378488,22931827600,718238
1219,y1801,20171016,6084,6058,6098,6124,6070,6104,6100,46,42,326258,19907477360,721444
1220,y1801,20171017,6104,6100,6128,6128,6074,6098,6100,-2,0,242794,14811554600,732808
1221,y1801,20171018,6098,6100,6080,6092,6042,6064,6066,-36,-34,265214,16092136760,735732
1222,y1801,20171019,6064,6066,6066,6080,5966,5974,6036,-92,-30,363018,21917853560,776480
1223,y1801,20171020,5974,6036,5978,6058,5972,6050,6014,14,-22,335988,20209808720,759666
1224,y1801,20171023,6050,6014,6080,6090,6036,6066,6060,52,46,314102,19039053920,735680
1225,y1801,20171024,6066,6060,6080,6096,6054,6074,6074,14,14,241960,14697804320,723300
1226,y1801,20171025,6074,6074,6058,6158,6056,6134,6100,60,26,392262,23929282840,719108
1227,y1801,20171026,6134,6100,6126,6138,6098,6130,6116,30,16,245984,15048284840,717868
1228,y1801,20171027,6130,6116,6142,6146,6110,6128,6128,12,12,220800,13531997600,685310
1229,y1801,20171030,6128,6128,6110,6182,6096,6152,6146,24,18,283530,17430397640,673374
1230,y1801,20171031,6152,6146,6150,6156,6108,6128,6126,-18,-20,221632,13577839120,671840
1231,y1801,20171101,6128,6126,6128,6142,6094,6102,6116,-24,-10,246554,15083817320,677984
1232,y1801,20171102,6102,6116,6110,6150,6088,6134,6124,18,8,244714,14986542760,665202
1233,y1801,20171103,6134,6124,6112,6124,6090,6118,6110,-6,-14,221854,13556844200,659944
1234,y1801,20171106,6118,6110,6112,6134,6060,6108,6090,-2,-20,312640,19043598520,648830
1235,y1801,20171107,6108,6090,6098,6156,6090,6144,6126,54,36,211616,12964683960,633794
1236,y1801,20171108,6144,6126,6134,6158,6112,6118,6132,-8,6,189914,11646636480,626830
1237,y1801,20171109,6118,6132,6142,6168,6114,6150,6144,18,12,277504,17054843120,602958
1238,y1801,20171110,6150,6144,6142,6152,6074,6078,6108,-66,-36,251956,15389981040,617234
1239,y1801,20171113,6078,6108,6086,6098,6066,6074,6080,-34,-28,173800,10567477760,611292
1240,y1801,20171114,6074,6080,6060,6064,6020,6026,6038,-54,-42,216028,13047359200,626330
1241,y1801,20171115,6026,6038,6014,6036,5968,5970,5998,-68,-40,260296,15616431960,640550
1242,y1801,20171116,5970,5998,5974,6026,5950,5988,5984,-10,-14,240148,14373316360,651274
1243,y1801,20171117,5988,5984,5988,6008,5958,5958,5982,-26,-2,198022,11849206160,645352
1244,y1801,20171120,5958,5982,5974,5974,5884,5914,5912,-68,-70,345548,20432885680,664108
1245,y1801,20171121,5914,5912,5888,5922,5864,5906,5896,-6,-16,230774,13609350320,638842
1246,y1801,20171122,5906,5896,5914,5936,5908,5918,5920,22,24,179868,10649907640,633870
1247,y1801,20171123,5918,5920,5928,5944,5896,5910,5920,-10,0,186670,11052525560,612316
1248,y1801,20171124,5910,5920,5904,5948,5896,5928,5930,8,10,191076,11331781680,568162
1249,y1801,20171127,5928,5930,5940,5944,5868,5882,5900,-48,-30,215216,12701668240,551820
1250,y1801,20171128,5882,5900,5880,5896,5860,5870,5882,-30,-18,123602,7272602880,534328
1251,y1801,20171129,5870,5882,5870,5884,5816,5824,5842,-58,-40,196598,11486595720,528736
1252,y1801,20171130,5824,5842,5824,5874,5806,5854,5846,12,4,157602,9214905840,472438
1253,y1801,20171201,5854,5846,5876,5886,5830,5868,5858,22,12,107352,6290378520,441464
1254,y1801,20171204,5868,5858,5892,5892,5824,5864,5850,6,-8,123742,7240228160,407562
1255,y1801,20171205,5864,5850,5856,5876,5780,5804,5828,-46,-22,105822,6169013240,378814
1256,y1801,20171206,5804,5828,5812,5832,5786,5822,5814,-6,-14,69514,4042564200,357060
1257,y1801,20171207,5822,5814,5820,5820,5674,5698,5742,-116,-72,124716,7163135400,312622
1258,y1801,20171208,5698,5742,5800,5800,5678,5686,5700,-56,-42,72548,4135639960,294224
1259,y1801,20171211,5686,5700,5690,5712,5644,5694,5678,-6,-22,89168,5064248760,264894
1260,y1801,20171212,5694,5678,5680,5728,5680,5708,5712,30,34,68514,3914122040,233952
1261,y1801,20171213,5708,5712,5708,5716,5680,5700,5700,-12,-12,55148,3143939080,215128
1262,y1801,20171214,5700,5700,5700,5704,5416,5604,5640,-96,-60,70084,3953653400,187020
1263,y1801,20171215,5604,5640,5618,5620,5580,5590,5602,-50,-38,48964,2743369440,166408
1264,y1801,20171218,5590,5602,5632,5632,5594,5622,5612,20,10,36714,2061085240,147684
1265,y1801,20171219,5622,5612,5600,5614,5542,5554,5566,-58,-46,32274,1796765800,134932
1266,y1801,20171220,5554,5566,5562,5572,5528,5532,5554,-34,-12,41236,2290748760,115798
1267,y1801,20171221,5532,5554,5532,5546,5384,5400,5452,-154,-102,67022,3654568200,85612
1268,y1801,20171222,5400,5452,5400,5402,5284,5298,5328,-154,-124,42880,2285322120,79164
1269,y1801,20171225,5298,5328,5318,5336,5268,5324,5312,-4,-16,29364,1560186560,65788
1270,y1801,20171226,5324,5312,5344,5344,5312,5312,5324,0,12,14452,769478840,57896
1271,y1801,20171227,5312,5324,5322,5360,5322,5360,5346,36,22,19824,1059965520,42890
1272,y1801,20171228,5360,5346,5350,5374,5306,5326,5334,-20,-12,19036,1015493040,33608
1273,y1801,20171229,5326,5334,5300,5338,5192,5282,5268,-52,-66,23684,1248064120,22360
1274,y1803,20170315,6652,6652,0,0,0,6652,6652,0,0,0,0,0
1275,y1803,20170316,6652,6652,0,0,0,6652,6652,0,0,0,0,0
1276,y1803,20170317,6652,6652,0,0,0,6652,6652,0,0,0,0,0
1277,y1803,20170320,6652,6652,0,0,0,6684,6684,32,32,0,0,0
1278,y1803,20170321,6684,6684,0,0,0,6684,6684,0,0,0,0,0
1279,y1803,20170322,6684,6684,0,0,0,6688,6688,4,4,0,0,0
1280,y1803,20170323,6688,6688,0,0,0,6636,6636,-52,-52,0,0,0
1281,y1803,20170324,6636,6636,0,0,0,6580,6580,-56,-56,0,0,0
1282,y1803,20170327,6580,6580,0,0,0,6458,6458,-122,-122,0,0,0
1283,y1803,20170328,6458,6458,6412,6412,6300,6300,6346,-158,-112,6,380840,2
1284,y1803,20170329,6300,6346,0,0,0,6346,6346,0,0,0,0,2
1285,y1803,20170330,6346,6346,0,0,0,6346,6346,0,0,0,0,2
1286,y1803,20170331,6346,6346,6302,6302,6302,6302,6302,-44,-44,2,126040,2
1287,y1803,20170405,6302,6302,0,0,0,6236,6236,-66,-66,0,0,2
1288,y1803,20170406,6236,6236,0,0,0,6236,6236,0,0,0,0,2
1289,y1803,20170407,6236,6236,0,0,0,6160,6160,-76,-76,0,0,2
1290,y1803,20170410,6160,6160,0,0,0,6160,6160,0,0,0,0,2
1291,y1803,20170411,6160,6160,0,0,0,6160,6160,0,0,0,0,2
1292,y1803,20170412,6160,6160,6128,6128,6128,6128,6128,-32,-32,4,245120,6
1293,y1803,20170413,6128,6128,6150,6150,6150,6150,6150,22,22,4,246000,8
1294,y1803,20170414,6150,6150,0,0,0,6150,6150,0,0,0,0,8
1295,y1803,20170417,6150,6150,0,0,0,6150,6150,0,0,0,0,8
1296,y1803,20170418,6150,6150,0,0,0,6128,6128,-22,-22,0,0,8
1297,y1803,20170419,6128,6128,0,0,0,6128,6128,0,0,0,0,8
1298,y1803,20170420,6128,6128,0,0,0,6108,6108,-20,-20,0,0,8
1299,y1803,20170421,6108,6108,0,0,0,6126,6126,18,18,0,0,8
1300,y1803,20170424,6126,6126,5964,6028,5964,6028,5996,-98,-130,4,239840,4
1301,y1803,20170425,6028,5996,0,0,0,5996,5996,0,0,0,0,4
1302,y1803,20170426,5996,5996,0,0,0,5996,5996,0,0,0,0,4
1303,y1803,20170427,5996,5996,0,0,0,5996,5996,0,0,0,0,4
1304,y1803,20170428,5996,5996,0,0,0,5996,5996,0,0,0,0,4
1305,y1803,20170502,5996,5996,0,0,0,6052,6052,56,56,0,0,4
1306,y1803,20170503,6052,6052,0,0,0,6052,6052,0,0,0,0,4
1307,y1803,20170504,6052,6052,0,0,0,6052,6052,0,0,0,0,4
1308,y1803,20170505,6052,6052,0,0,0,6030,6030,-22,-22,0,0,4
1309,y1803,20170508,6030,6030,6202,6202,6114,6114,6146,84,116,8,491800,4
1310,y1803,20170509,6114,6146,0,0,0,6146,6146,0,0,0,0,4
1311,y1803,20170510,6146,6146,0,0,0,6146,6146,0,0,0,0,4
1312,y1803,20170511,6146,6146,0,0,0,6144,6144,-2,-2,0,0,4
1313,y1803,20170512,6144,6144,0,0,0,6144,6144,0,0,0,0,4
1314,y1803,20170515,6144,6144,0,0,0,6162,6162,18,18,0,0,4
1315,y1803,20170516,6162,6162,0,0,0,6212,6212,50,50,0,0,4
1316,y1803,20170517,6212,6212,6248,6248,6248,6248,6248,36,36,2,124960,6
1317,y1803,20170518,6248,6248,0,0,0,6248,6248,0,0,0,0,6
1318,y1803,20170519,6248,6248,0,0,0,6248,6248,0,0,0,0,6
1319,y1803,20170522,6248,6248,0,0,0,6248,6248,0,0,0,0,6
1320,y1803,20170523,6248,6248,0,0,0,6248,6248,0,0,0,0,6
1321,y1803,20170524,6248,6248,0,0,0,6248,6248,0,0,0,0,6
1322,y1803,20170525,6248,6248,0,0,0,6248,6248,0,0,0,0,6
1323,y1803,20170526,6248,6248,0,0,0,6248,6248,0,0,0,0,6
1324,y1803,20170531,6248,6248,0,0,0,6110,6110,-138,-138,0,0,6
1325,y1803,20170601,6110,6110,0,0,0,6056,6056,-54,-54,0,0,6
1326,y1803,20170602,6056,6056,5830,5920,5830,5920,5874,-136,-182,12,705000,6
1327,y1803,20170605,5920,5874,0,0,0,5874,5874,0,0,0,0,6
1328,y1803,20170606,5874,5874,0,0,0,5874,5874,0,0,0,0,6
1329,y1803,20170607,5874,5874,0,0,0,5894,5894,20,20,0,0,6
1330,y1803,20170608,5894,5894,0,0,0,5882,5882,-12,-12,0,0,6
1331,y1803,20170609,5882,5882,0,0,0,5922,5922,40,40,0,0,6
1332,y1803,20170612,5922,5922,0,0,0,5958,5958,36,36,0,0,6
1333,y1803,20170613,5958,5958,0,0,0,5964,5964,6,6,0,0,6
1334,y1803,20170614,5964,5964,0,0,0,5968,5968,4,4,0,0,6
1335,y1803,20170615,5968,5968,0,0,0,5986,5986,18,18,0,0,6
1336,y1803,20170616,5986,5986,0,0,0,6028,6028,42,42,0,0,6
1337,y1803,20170619,6028,6028,0,0,0,6054,6054,26,26,0,0,6
1338,y1803,20170620,6054,6054,0,0,0,6054,6054,0,0,0,0,6
1339,y1803,20170621,6054,6054,0,0,0,6054,6054,0,0,0,0,6
1340,y1803,20170622,6054,6054,0,0,0,6034,6034,-20,-20,0,0,6
1341,y1803,20170623,6034,6034,0,0,0,6010,6010,-24,-24,0,0,6
1342,y1803,20170626,6010,6010,5996,5996,5996,5996,5996,-14,-14,2,119920,8
1343,y1803,20170627,5996,5996,0,0,0,5996,5996,0,0,0,0,8
1344,y1803,20170628,5996,5996,0,0,0,6068,6068,72,72,0,0,8
1345,y1803,20170629,6068,6068,6006,6138,6006,6080,6074,12,6,6,364480,6
1346,y1803,20170630,6080,6074,0,0,0,6074,6074,0,0,0,0,6
1347,y1803,20170703,6074,6074,0,0,0,6074,6074,0,0,0,0,6
1348,y1803,20170704,6074,6074,0,0,0,6038,6038,-36,-36,0,0,6
1349,y1803,20170705,6038,6038,0,0,0,6026,6026,-12,-12,0,0,6
1350,y1803,20170706,6026,6026,0,0,0,6074,6074,48,48,0,0,6
1351,y1803,20170707,6074,6074,0,0,0,6068,6068,-6,-6,0,0,6
1352,y1803,20170710,6068,6068,0,0,0,6156,6156,88,88,0,0,6
1353,y1803,20170711,6156,6156,6312,6312,6312,6312,6312,156,156,2,126240,8
1354,y1803,20170712,6312,6312,6312,6312,6312,6312,6312,0,0,2,126240,8
1355,y1803,20170713,6312,6312,6250,6264,6178,6264,6230,-48,-82,6,373840,4
1356,y1803,20170714,6264,6230,0,0,0,6230,6230,0,0,0,0,4
1357,y1803,20170717,6230,6230,6226,6226,6226,6226,6226,-4,-4,2,124520,2
1358,y1803,20170718,6226,6226,0,0,0,6226,6226,0,0,0,0,2
1359,y1803,20170719,6226,6226,0,0,0,6226,6226,0,0,0,0,2
1360,y1803,20170720,6226,6226,0,0,0,6282,6282,56,56,0,0,2
1361,y1803,20170721,6282,6282,0,0,0,6282,6282,0,0,0,0,2
1362,y1803,20170724,6282,6282,0,0,0,6222,6222,-60,-60,0,0,2
1363,y1803,20170725,6222,6222,0,0,0,6222,6222,0,0,0,0,2
1364,y1803,20170726,6222,6222,6304,6304,6304,6304,6304,82,82,2,126080,0
1365,y1803,20170727,6304,6304,0,0,0,6304,6304,0,0,0,0,0
1366,y1803,20170728,6304,6304,0,0,0,6304,6304,0,0,0,0,0
1367,y1803,20170731,6304,6304,0,0,0,6304,6304,0,0,0,0,0
1368,y1803,20170801,6304,6304,0,0,0,6304,6304,0,0,0,0,0
1369,y1803,20170802,6304,6304,0,0,0,6304,6304,0,0,0,0,0
1370,y1803,20170803,6304,6304,6250,6268,6150,6150,6214,-154,-90,24,1491800,4
1371,y1803,20170804,6150,6214,0,0,0,6214,6214,0,0,0,0,4
1372,y1803,20170807,6214,6214,6248,6248,6208,6216,6232,2,18,18,1122040,2
1373,y1803,20170808,6216,6232,6184,6222,6184,6222,6202,-10,-30,4,248120,0
1374,y1803,20170809,6222,6202,0,0,0,6266,6266,64,64,0,0,0
1375,y1803,20170810,6266,6266,0,0,0,6266,6266,0,0,0,0,0
1376,y1803,20170811,6266,6266,0,0,0,6266,6266,0,0,0,0,0
1377,y1803,20170814,6266,6266,0,0,0,6266,6266,0,0,0,0,0
1378,y1803,20170815,6266,6266,6354,6354,6264,6300,6306,34,40,452,28512000,56
1379,y1803,20170816,6300,6306,0,0,0,6306,6306,0,0,0,0,56
1380,y1803,20170817,6306,6306,6230,6308,6230,6304,6264,-2,-42,10,626480,60
1381,y1803,20170818,6304,6264,0,0,0,6294,6294,30,30,0,0,60
1382,y1803,20170821,6294,6294,6344,6344,6316,6316,6342,22,48,54,3425120,6
1383,y1803,20170822,6316,6342,6320,6320,6320,6320,6320,-22,-22,2,126400,6
1384,y1803,20170823,6320,6320,0,0,0,6320,6320,0,0,0,0,6
1385,y1803,20170824,6320,6320,6442,6442,6442,6442,6442,122,122,4,257680,8
1386,y1803,20170825,6442,6442,0,0,0,6442,6442,0,0,0,0,8
1387,y1803,20170828,6442,6442,0,0,0,6442,6442,0,0,0,0,8
1388,y1803,20170829,6442,6442,0,0,0,6442,6442,0,0,0,0,8
1389,y1803,20170830,6442,6442,0,0,0,6442,6442,0,0,0,0,8
1390,y1803,20170831,6442,6442,0,0,0,6426,6426,-16,-16,0,0,8
1391,y1803,20170901,6426,6426,0,0,0,6426,6426,0,0,0,0,8
1392,y1803,20170904,6426,6426,0,0,0,6426,6426,0,0,0,0,8
1393,y1803,20170905,6426,6426,0,0,0,6426,6426,0,0,0,0,8
1394,y1803,20170906,6426,6426,0,0,0,6426,6426,0,0,0,0,8
1395,y1803,20170907,6426,6426,0,0,0,6426,6426,0,0,0,0,8
1396,y1803,20170908,6426,6426,0,0,0,6426,6426,0,0,0,0,8
1397,y1803,20170911,6426,6426,0,0,0,6426,6426,0,0,0,0,8
1398,y1803,20170912,6426,6426,0,0,0,6426,6426,0,0,0,0,8
1399,y1803,20170913,6426,6426,6486,6542,6360,6360,6440,-66,14,42,2705240,6
1400,y1803,20170914,6360,6440,6426,6454,6426,6454,6434,14,-6,6,386120,4
1401,y1803,20170915,6454,6434,6490,6490,6490,6490,6490,56,56,2,129800,6
1402,y1803,20170918,6490,6490,0,0,0,6450,6450,-40,-40,0,0,6
1403,y1803,20170919,6450,6450,0,0,0,6434,6434,-16,-16,0,0,6
1404,y1803,20170920,6434,6434,6124,6378,6124,6342,6304,-92,-130,10,630520,6
1405,y1803,20170921,6342,6304,0,0,0,6304,6304,0,0,0,0,6
1406,y1803,20170922,6304,6304,6322,6322,6322,6322,6322,18,18,2,126440,4
1407,y1803,20170925,6322,6322,0,0,0,6288,6288,-34,-34,0,0,4
1408,y1803,20170926,6288,6288,0,0,0,6270,6270,-18,-18,0,0,4
1409,y1803,20170927,6270,6270,0,0,0,6234,6234,-36,-36,0,0,4
1410,y1803,20170928,6234,6234,0,0,0,6148,6148,-86,-86,0,0,4
1411,y1803,20170929,6148,6148,6072,6138,6016,6138,6072,-10,-76,364,22109280,4
1412,y1803,20171009,6138,6072,0,0,0,6116,6116,44,44,0,0,4
1413,y1803,20171010,6116,6116,6180,6180,6180,6180,6180,64,64,2,123600,6
1414,y1803,20171011,6180,6180,0,0,0,6180,6180,0,0,0,0,6
1415,y1803,20171012,6180,6180,0,0,0,6190,6190,10,10,0,0,6
1416,y1803,20171013,6190,6190,0,0,0,6190,6190,0,0,0,0,6
1417,y1803,20171016,6190,6190,0,0,0,6190,6190,0,0,0,0,6
1418,y1803,20171017,6190,6190,0,0,0,6190,6190,0,0,0,0,6
1419,y1803,20171018,6190,6190,6120,6120,6120,6120,6120,-70,-70,2,122400,4
1420,y1803,20171019,6120,6120,6100,6100,6094,6094,6096,-26,-24,4,243880,6
1421,y1803,20171020,6094,6096,6042,6072,6042,6072,6044,-24,-52,26,1571880,26
1422,y1803,20171023,6072,6044,6118,6130,6118,6130,6122,86,78,22,1346920,6
1423,y1803,20171024,6130,6122,0,0,0,6122,6122,0,0,0,0,6
1424,y1803,20171025,6122,6122,6160,6160,6160,6160,6160,38,38,2,123200,6
1425,y1803,20171026,6160,6160,0,0,0,6160,6160,0,0,0,0,6
1426,y1803,20171027,6160,6160,0,0,0,6160,6160,0,0,0,0,6
1427,y1803,20171030,6160,6160,0,0,0,6160,6160,0,0,0,0,6
1428,y1803,20171031,6160,6160,0,0,0,6160,6160,0,0,0,0,6
1429,y1803,20171101,6160,6160,0,0,0,6160,6160,0,0,0,0,6
1430,y1803,20171102,6160,6160,0,0,0,6160,6160,0,0,0,0,6
1431,y1803,20171103,6160,6160,0,0,0,6160,6160,0,0,0,0,6
1432,y1803,20171106,6160,6160,6120,6168,6102,6130,6136,-30,-24,26,1595840,12
1433,y1803,20171107,6130,6136,6166,6180,6166,6180,6172,44,36,4,246920,10
1434,y1803,20171108,6180,6172,0,0,0,6172,6172,0,0,0,0,10
1435,y1803,20171109,6172,6172,6160,6160,6160,6160,6160,-12,-12,2,123200,12
1436,y1803,20171110,6160,6160,6152,6152,6130,6130,6140,-30,-20,4,245640,10
1437,y1803,20171113,6130,6140,6160,6176,6160,6176,6168,36,28,4,246720,12
1438,y1803,20171114,6176,6168,6080,6080,6080,6080,6080,-88,-88,2,121600,12
1439,y1803,20171115,6080,6080,6106,6106,6032,6032,6068,-48,-12,4,242760,12
1440,y1803,20171116,6032,6068,6030,6030,6006,6006,6018,-62,-50,4,240720,10
1441,y1803,20171117,6006,6018,0,0,0,6018,6018,0,0,0,0,10
1442,y1803,20171120,6018,6018,0,0,0,6018,6018,0,0,0,0,10
1443,y1803,20171121,6018,6018,6008,6008,5940,5940,5974,-78,-44,4,238960,10
1444,y1803,20171122,5940,5974,0,0,0,5980,5980,6,6,0,0,10
1445,y1803,20171123,5980,5980,6002,6002,6002,6002,6002,22,22,2,120040,12
1446,y1803,20171124,6002,6002,6022,6022,5970,5970,5996,-32,-6,4,239840,14
1447,y1803,20171127,5970,5996,0,0,0,5996,5996,0,0,0,0,14
1448,y1803,20171128,5996,5996,0,0,0,5996,5996,0,0,0,0,14
1449,y1803,20171129,5996,5996,5962,5962,5910,5910,5938,-86,-58,10,593960,16
1450,y1803,20171130,5910,5938,0,0,0,5938,5938,0,0,0,0,16
1451,y1803,20171201,5938,5938,0,0,0,5938,5938,0,0,0,0,16
1452,y1803,20171204,5938,5938,0,0,0,5938,5938,0,0,0,0,16
1453,y1803,20171205,5938,5938,0,0,0,5938,5938,0,0,0,0,16
1454,y1803,20171206,5938,5938,0,0,0,5938,5938,0,0,0,0,16
1455,y1803,20171207,5938,5938,0,0,0,5866,5866,-72,-72,0,0,16
1456,y1803,20171208,5866,5866,0,0,0,5866,5866,0,0,0,0,16
1457,y1803,20171211,5866,5866,0,0,0,5866,5866,0,0,0,0,16
1458,y1803,20171212,5866,5866,5912,5912,5782,5782,5846,-84,-20,4,233880,16
1459,y1803,20171213,5782,5846,0,0,0,5846,5846,0,0,0,0,16
1460,y1803,20171214,5846,5846,0,0,0,5786,5786,-60,-60,0,0,16
1461,y1803,20171215,5786,5786,0,0,0,5786,5786,0,0,0,0,16
1462,y1803,20171218,5786,5786,0,0,0,5786,5786,0,0,0,0,16
1463,y1803,20171219,5786,5786,0,0,0,5786,5786,0,0,0,0,16
1464,y1803,20171220,5786,5786,0,0,0,5786,5786,0,0,0,0,16
1465,y1803,20171221,5786,5786,5562,5562,5562,5562,5562,-224,-224,2,111240,14
1466,y1803,20171222,5562,5562,5484,5552,5436,5436,5476,-126,-86,44,2409880,36
1467,y1803,20171225,5436,5476,5464,5470,5428,5428,5456,-48,-20,8,436600,36
1468,y1803,20171226,5428,5456,5470,5524,5460,5470,5472,14,16,92,5036040,90
1469,y1803,20171227,5470,5472,5494,5494,5414,5470,5454,-2,-18,52,2837080,78
1470,y1803,20171228,5470,5454,5480,5480,5450,5450,5462,-4,8,34,1857640,82
1471,y1803,20171229,5450,5462,5456,5462,5370,5408,5394,-54,-68,24,1294560,82
1472,y1805,20170516,6162,6162,6300,6308,6258,6288,6288,126,126,1460,91804960,1084
1473,y1805,20170517,6288,6288,6292,6326,6250,6318,6278,30,-10,472,29639160,1320
1474,y1805,20170518,6318,6278,6316,6324,6260,6280,6288,2,10,276,17358800,1504
1475,y1805,20170519,6280,6288,6210,6250,6198,6230,6230,-58,-58,140,8723760,1508
1476,y1805,20170522,6230,6230,6252,6312,6252,6288,6294,58,64,356,22411760,1594
1477,y1805,20170523,6288,6294,6288,6300,6246,6250,6270,-44,-24,160,10033440,1678
1478,y1805,20170524,6250,6270,6268,6268,6180,6216,6220,-54,-50,486,30237280,1970
1479,y1805,20170525,6216,6220,6222,6232,6192,6216,6212,-4,-8,348,21619560,2110
1480,y1805,20170526,6216,6212,6222,6222,6122,6122,6182,-90,-30,400,24728720,2192
1481,y1805,20170531,6122,6182,6108,6108,5998,6000,6054,-182,-128,1064,64416960,2558
1482,y1805,20170601,6000,6054,6018,6024,5962,5972,5994,-82,-60,668,40047640,2444
1483,y1805,20170602,5972,5994,5998,6038,5990,5990,6010,-4,16,374,22479400,2552
1484,y1805,20170605,5990,6010,5966,6066,5966,6030,6026,20,16,386,23263800,2664
1485,y1805,20170606,6030,6026,6032,6064,6000,6052,6034,26,8,1062,64100560,3080
1486,y1805,20170607,6052,6034,6052,6092,6028,6044,6044,10,10,1066,64441480,3520
1487,y1805,20170608,6044,6044,6026,6052,6010,6032,6030,-12,-14,660,39802440,3700
1488,y1805,20170609,6032,6030,6040,6080,6040,6058,6068,28,38,634,38471520,3700
1489,y1805,20170612,6058,6068,6078,6100,6062,6092,6078,24,10,1524,92643120,3684
1490,y1805,20170613,6092,6078,6082,6096,6058,6060,6072,-18,-6,1032,62670120,3958
1491,y1805,20170614,6060,6072,6054,6096,6054,6084,6078,12,6,546,33193800,4032
1492,y1805,20170615,6084,6078,6092,6128,6072,6096,6100,18,22,652,39777960,4090
1493,y1805,20170616,6096,6100,6100,6176,6076,6140,6128,40,28,772,47313760,4424
1494,y1805,20170619,6140,6128,6154,6212,6138,6176,6182,48,54,1046,64670040,4626
1495,y1805,20170620,6176,6182,6168,6178,6086,6102,6132,-80,-50,1640,100566880,5406
1496,y1805,20170621,6102,6132,6098,6098,6040,6054,6058,-78,-74,1046,63368280,5656
1497,y1805,20170622,6054,6058,6066,6074,6000,6004,6028,-54,-30,730,44016200,5846
1498,y1805,20170623,6004,6028,6020,6040,5982,6006,6000,-22,-28,1304,78265320,5928
1499,y1805,20170626,6006,6000,6010,6038,5992,6004,6016,4,16,1744,104941680,6586
1500,y1805,20170627,6004,6016,6022,6060,5990,6048,6014,32,-2,1734,104307400,7358
1501,y1805,20170628,6048,6014,6064,6112,6060,6092,6094,78,80,4820,293742960,9178
1502,y1805,20170629,6092,6094,6072,6176,6072,6140,6146,46,52,3992,245421600,11230
1503,y1805,20170630,6140,6146,6146,6190,6124,6160,6154,14,8,1852,114004040,12310
1504,y1805,20170703,6160,6154,6170,6278,6150,6242,6204,88,50,3326,206397560,13338
1505,y1805,20170704,6242,6204,6248,6250,6144,6144,6180,-60,-24,2380,147096840,13934
1506,y1805,20170705,6144,6180,6152,6200,6152,6176,6176,-4,-4,1216,75122720,13794
1507,y1805,20170706,6176,6176,6182,6262,6182,6244,6226,68,50,2072,129024920,14330
1508,y1805,20170707,6244,6226,6230,6250,6192,6230,6226,4,0,2614,162799160,14774
1509,y1805,20170710,6230,6226,6226,6346,6226,6330,6306,104,80,3284,207142440,16018
1510,y1805,20170711,6330,6306,6340,6394,6308,6366,6354,60,48,3932,249901320,17590
1511,y1805,20170712,6366,6354,6354,6390,6334,6352,6362,-2,8,2344,149163040,18332
1512,y1805,20170713,6352,6362,6362,6370,6300,6316,6330,-46,-32,5392,341390720,19116
1513,y1805,20170714,6316,6330,6318,6332,6244,6270,6270,-60,-60,3726,233656560,19592
1514,y1805,20170717,6270,6270,6290,6328,6276,6290,6294,20,24,4614,290473320,21202
1515,y1805,20170718,6290,6294,6292,6352,6266,6278,6318,-16,24,5634,356000880,22090
1516,y1805,20170719,6278,6318,6300,6322,6252,6304,6292,-14,-26,2052,129114560,22198
1517,y1805,20170720,6304,6292,6312,6382,6300,6358,6350,66,58,4834,306999160,23076
1518,y1805,20170721,6358,6350,6372,6408,6342,6390,6384,40,34,5768,368265560,25736
1519,y1805,20170724,6390,6384,6400,6400,6300,6318,6332,-66,-52,3978,251963920,26828
1520,y1805,20170725,6318,6332,6332,6424,6318,6420,6384,88,52,4932,314940760,27892
1521,y1805,20170726,6420,6384,6412,6442,6344,6344,6382,-40,-2,14360,916548160,28300
1522,y1805,20170727,6344,6382,6374,6420,6350,6412,6392,30,10,5348,341945720,29016
1523,y1805,20170728,6412,6392,6416,6490,6330,6346,6390,-46,-2,8094,517367320,28160
1524,y1805,20170731,6346,6390,6362,6456,6348,6440,6410,50,20,7814,500978640,28718
1525,y1805,20170801,6440,6410,6420,6490,6420,6444,6456,34,46,7038,454511360,30166
1526,y1805,20170802,6444,6456,6438,6438,6370,6392,6386,-64,-70,8000,510983840,33522
1527,y1805,20170803,6392,6386,6386,6428,6280,6288,6360,-98,-26,8622,548457480,34110
1528,y1805,20170804,6288,6360,6288,6322,6252,6306,6296,-54,-64,7818,492340160,34794
1529,y1805,20170807,6306,6296,6308,6354,6290,6292,6320,-4,24,5574,352319120,34760
1530,y1805,20170808,6292,6320,6290,6394,6262,6388,6340,68,20,5580,353861560,35332
1531,y1805,20170809,6388,6340,6390,6436,6380,6424,6400,84,60,7904,505973480,37294
1532,y1805,20170810,6424,6400,6426,6436,6336,6422,6384,22,-16,12162,776643280,40242
1533,y1805,20170811,6422,6384,6436,6528,6322,6360,6404,-24,20,23812,1525163640,47930
1534,y1805,20170814,6360,6404,6378,6422,6328,6382,6376,-22,-28,17600,1122286680,50852
1535,y1805,20170815,6382,6376,6352,6390,6332,6348,6362,-28,-14,15800,1005318560,56402
1536,y1805,20170816,6348,6362,6326,6338,6248,6262,6282,-100,-80,15928,1000599840,57630
1537,y1805,20170817,6262,6282,6280,6310,6268,6308,6292,26,10,11934,750945480,59794
1538,y1805,20170818,6308,6292,6308,6362,6288,6362,6324,70,32,8898,562720880,60556
1539,y1805,20170821,6362,6324,6346,6402,6346,6386,6380,62,56,14468,923113160,61754
1540,y1805,20170822,6386,6380,6402,6472,6372,6468,6416,88,36,19900,1276805840,64570
1541,y1805,20170823,6468,6416,6452,6506,6412,6492,6478,76,62,32150,2082987400,66108
1542,y1805,20170824,6492,6478,6498,6500,6432,6490,6460,12,-18,26706,1725209480,71262
1543,y1805,20170825,6490,6460,6516,6526,6438,6446,6486,-14,26,22628,1467918240,73974
1544,y1805,20170828,6446,6486,6442,6500,6432,6448,6462,-38,-24,12502,808082240,73668
1545,y1805,20170829,6448,6462,6454,6458,6384,6388,6418,-74,-44,14224,912926040,74866
1546,y1805,20170830,6388,6418,6374,6412,6350,6352,6382,-66,-36,24238,1547040120,80722
1547,y1805,20170831,6352,6382,6348,6394,6344,6362,6362,-20,-20,17642,1122574400,84394
1548,y1805,20170901,6362,6362,6360,6424,6350,6418,6404,56,42,20832,1334340880,87970
1549,y1805,20170904,6418,6404,6422,6462,6388,6448,6428,44,24,19356,1244529160,90762
1550,y1805,20170905,6448,6428,6442,6460,6398,6454,6430,26,2,28004,1801064080,95866
1551,y1805,20170906,6454,6430,6466,6486,6428,6452,6454,22,24,22552,1455701040,96400
1552,y1805,20170907,6452,6454,6448,6462,6408,6450,6432,-4,-22,16672,1072660720,96122
1553,y1805,20170908,6450,6432,6472,6488,6370,6374,6418,-58,-14,24196,1553018200,99714
1554,y1805,20170911,6374,6418,6378,6460,6314,6450,6394,32,-24,42832,2739380960,102064
1555,y1805,20170912,6450,6394,6436,6456,6394,6430,6424,36,30,36194,2325695360,100052
1556,y1805,20170913,6430,6424,6436,6522,6400,6402,6450,-22,26,45966,2965572120,105452
1557,y1805,20170914,6402,6450,6424,6484,6414,6470,6452,20,2,34160,2204275840,109104
1558,y1805,20170915,6470,6452,6460,6494,6446,6478,6470,26,18,33720,2182074960,115124
1559,y1805,20170918,6478,6470,6468,6476,6396,6432,6426,-38,-44,24460,1572204640,117414
1560,y1805,20170919,6432,6426,6394,6452,6394,6420,6426,-6,0,25738,1654005080,114064
1561,y1805,20170920,6420,6426,6410,6446,6388,6412,6414,-14,-12,19938,1279096960,116208
1562,y1805,20170921,6412,6414,6416,6440,6374,6376,6408,-38,-6,25000,1602387720,115970
1563,y1805,20170922,6376,6408,6350,6368,6316,6334,6340,-74,-68,30894,1959106920,113748
1564,y1805,20170925,6334,6340,6338,6362,6258,6282,6300,-58,-40,28838,1816985720,115776
1565,y1805,20170926,6282,6300,6274,6316,6274,6290,6296,-10,-4,18394,1158429280,116660
1566,y1805,20170927,6290,6296,6304,6330,6250,6280,6284,-16,-12,39318,2471113360,112118
1567,y1805,20170928,6280,6284,6278,6280,6150,6200,6202,-84,-82,44162,2739657800,108624
1568,y1805,20170929,6200,6202,6198,6234,6174,6204,6192,2,-10,30428,1884422040,113686
1569,y1805,20171009,6204,6192,6234,6258,6206,6222,6228,30,36,26658,1660423920,117136
1570,y1805,20171010,6222,6228,6226,6230,6178,6192,6204,-36,-24,31662,1964514200,126674
1571,y1805,20171011,6192,6204,6180,6196,6152,6168,6178,-36,-26,36290,2242292680,132578
1572,y1805,20171012,6168,6178,6170,6216,6168,6202,6192,24,14,22040,1364763120,135678
1573,y1805,20171013,6202,6192,6212,6222,6142,6210,6190,18,-2,45846,2838776920,138374
1574,y1805,20171016,6210,6190,6234,6254,6212,6248,6238,58,48,34300,2139797400,139988
1575,y1805,20171017,6248,6238,6248,6270,6222,6248,6244,10,6,29486,1841358960,142354
1576,y1805,20171018,6248,6244,6230,6240,6188,6212,6216,-32,-28,33090,2056962320,141694
1577,y1805,20171019,6212,6216,6216,6230,6122,6126,6188,-90,-28,33392,2066766160,141230
1578,y1805,20171020,6126,6188,6128,6210,6128,6210,6170,22,-18,41236,2544782320,143294
1579,y1805,20171023,6210,6170,6228,6256,6188,6220,6216,50,46,51622,3209720040,142656
1580,y1805,20171024,6220,6216,6232,6254,6210,6230,6230,14,14,62024,3864448400,152024
1581,y1805,20171025,6230,6230,6214,6310,6202,6292,6252,62,22,50592,3163589280,149764
1582,y1805,20171026,6292,6252,6292,6298,6252,6282,6270,30,18,37576,2356174240,153562
1583,y1805,20171027,6282,6270,6284,6292,6258,6280,6274,10,4,37260,2338269080,154028
1584,y1805,20171030,6280,6274,6272,6338,6248,6308,6308,34,34,39630,2500425280,160448
1585,y1805,20171031,6308,6308,6308,6314,6258,6274,6282,-34,-26,46974,2951596040,169922
1586,y1805,20171101,6274,6282,6262,6296,6242,6260,6272,-22,-10,55620,3489461240,184800
1587,y1805,20171102,6260,6272,6280,6308,6246,6294,6282,22,10,72106,4530953680,201116
1588,y1805,20171103,6294,6282,6270,6288,6250,6282,6270,0,-12,66120,4146621800,213120
1589,y1805,20171106,6282,6270,6274,6300,6218,6274,6252,4,-18,77794,4865082840,222252
1590,y1805,20171107,6274,6252,6266,6324,6256,6312,6294,60,42,58196,3663509880,229086
1591,y1805,20171108,6312,6294,6300,6324,6278,6290,6298,-4,4,64304,4050500200,243428
1592,y1805,20171109,6290,6298,6310,6358,6290,6328,6326,30,28,119336,7549730840,254050
1593,y1805,20171110,6328,6326,6316,6330,6246,6254,6282,-72,-44,93966,5904242720,275048
1594,y1805,20171113,6254,6282,6264,6274,6238,6250,6254,-32,-28,75394,4715850520,284730
1595,y1805,20171114,6250,6254,6238,6242,6192,6196,6214,-58,-40,84462,5249075800,294578
1596,y1805,20171115,6196,6214,6184,6210,6136,6136,6166,-78,-48,117520,7246764920,308694
1597,y1805,20171116,6136,6166,6136,6194,6108,6148,6150,-18,-16,95008,5842999160,321924
1598,y1805,20171117,6148,6150,6140,6170,6122,6124,6146,-26,-4,75700,4653769040,340014
1599,y1805,20171120,6124,6146,6126,6136,6058,6090,6086,-56,-60,156834,9546154200,361140
1600,y1805,20171121,6090,6086,6070,6104,6040,6080,6076,-6,-10,117414,7134421040,368088
1601,y1805,20171122,6080,6076,6098,6112,6084,6098,6098,22,22,101482,6189284240,379078
1602,y1805,20171123,6098,6098,6118,6118,6076,6088,6098,-10,0,119636,7297064840,400928
1603,y1805,20171124,6088,6098,6086,6140,6074,6120,6122,22,24,160882,9849925120,438684
1604,y1805,20171127,6120,6122,6122,6140,6058,6068,6092,-54,-30,185788,11318665120,461540
1605,y1805,20171128,6068,6092,6066,6084,6046,6056,6068,-36,-24,122688,7446093160,469108
1606,y1805,20171129,6056,6068,6058,6064,6002,6008,6026,-60,-42,237384,14306803960,526974
1607,y1805,20171130,6008,6026,5996,6068,5986,6034,6032,8,6,267232,16121317200,527404
1608,y1805,20171201,6034,6032,6052,6074,6006,6046,6036,14,4,256608,15492884360,553710
1609,y1805,20171204,6046,6036,6046,6066,6010,6056,6038,20,2,299140,18065830200,581190
1610,y1805,20171205,6056,6038,6042,6064,5954,5978,6010,-60,-28,326096,19599975680,619406
1611,y1805,20171206,5978,6010,5976,6012,5964,5996,5990,-14,-20,242468,14526112920,635926
1612,y1805,20171207,5996,5990,5990,5990,5860,5880,5924,-110,-66,379818,22504293840,672790
1613,y1805,20171208,5880,5924,5860,5902,5860,5872,5882,-52,-42,242682,14276965640,678450
1614,y1805,20171211,5872,5882,5870,5908,5834,5890,5874,8,-8,336974,19797155480,702548
1615,y1805,20171212,5890,5874,5884,5936,5874,5914,5912,40,38,295804,17489417440,725044
1616,y1805,20171213,5914,5912,5906,5918,5874,5896,5894,-16,-18,225554,13297725720,748678
1617,y1805,20171214,5896,5894,5890,5896,5794,5806,5842,-88,-52,337080,19697723080,791526
1618,y1805,20171215,5806,5842,5818,5828,5790,5802,5810,-40,-32,242042,14063787840,807398
1619,y1805,20171218,5802,5810,5836,5848,5814,5834,5828,24,18,248990,14515813840,821312
1620,y1805,20171219,5834,5828,5822,5828,5760,5782,5792,-46,-36,277182,16056693360,847482
1621,y1805,20171220,5782,5792,5780,5800,5772,5778,5786,-14,-6,210902,12206637400,857912
1622,y1805,20171221,5778,5786,5794,5806,5674,5690,5734,-96,-52,439454,25205659520,899944
1623,y1805,20171222,5690,5734,5680,5686,5602,5622,5634,-112,-100,372202,20970983520,924442
1624,y1805,20171225,5622,5634,5634,5670,5616,5660,5648,26,14,255536,14435829360,907568
1625,y1805,20171226,5660,5648,5652,5680,5652,5662,5666,14,18,143882,8153547000,909902
1626,y1805,20171227,5662,5666,5690,5718,5656,5706,5690,40,24,284632,16200516560,911116
1627,y1805,20171228,5706,5690,5702,5734,5680,5694,5704,4,14,246336,14052763160,900738
1628,y1805,20171229,5694,5704,5690,5702,5644,5668,5668,-36,-36,284374,16120891680,905954
1629,y1807,20170717,6270,6270,0,0,0,6270,6270,0,0,0,0,0
1630,y1807,20170718,6270,6270,0,0,0,6270,6270,0,0,0,0,0
1631,y1807,20170719,6270,6270,6440,6440,6300,6300,6370,30,100,4,254800,2
1632,y1807,20170720,6300,6370,0,0,0,6428,6428,58,58,0,0,2
1633,y1807,20170721,6428,6428,0,0,0,6462,6462,34,34,0,0,2
1634,y1807,20170724,6462,6462,0,0,0,6410,6410,-52,-52,0,0,2
1635,y1807,20170725,6410,6410,6430,6430,6404,6404,6416,-6,6,4,256680,0
1636,y1807,20170726,6404,6416,6512,6512,6336,6336,6420,-80,4,46,2953960,0
1637,y1807,20170727,6336,6420,0,0,0,6420,6420,0,0,0,0,0
1638,y1807,20170728,6420,6420,0,0,0,6420,6420,0,0,0,0,0
1639,y1807,20170731,6420,6420,0,0,0,6420,6420,0,0,0,0,0
1640,y1807,20170801,6420,6420,0,0,0,6420,6420,0,0,0,0,0
1641,y1807,20170802,6420,6420,0,0,0,6420,6420,0,0,0,0,0
1642,y1807,20170803,6420,6420,0,0,0,6420,6420,0,0,0,0,0
1643,y1807,20170804,6420,6420,0,0,0,6420,6420,0,0,0,0,0
1644,y1807,20170807,6420,6420,0,0,0,6420,6420,0,0,0,0,0
1645,y1807,20170808,6420,6420,0,0,0,6420,6420,0,0,0,0,0
1646,y1807,20170809,6420,6420,0,0,0,6420,6420,0,0,0,0,0
1647,y1807,20170810,6420,6420,0,0,0,6420,6420,0,0,0,0,0
1648,y1807,20170811,6420,6420,0,0,0,6420,6420,0,0,0,0,0
1649,y1807,20170814,6420,6420,6510,6510,6510,6510,6510,90,90,2,130200,2
1650,y1807,20170815,6510,6510,0,0,0,6496,6496,-14,-14,0,0,2
1651,y1807,20170816,6496,6496,6268,6392,6230,6324,6310,-172,-186,196,12370560,4
1652,y1807,20170817,6324,6310,0,0,0,6310,6310,0,0,0,0,4
1653,y1807,20170818,6310,6310,0,0,0,6310,6310,0,0,0,0,4
1654,y1807,20170821,6310,6310,0,0,0,6310,6310,0,0,0,0,4
1655,y1807,20170822,6310,6310,0,0,0,6344,6344,34,34,0,0,4
1656,y1807,20170823,6344,6344,0,0,0,6404,6404,60,60,0,0,4
1657,y1807,20170824,6404,6404,0,0,0,6404,6404,0,0,0,0,4
1658,y1807,20170825,6404,6404,0,0,0,6428,6428,24,24,0,0,4
1659,y1807,20170828,6428,6428,0,0,0,6428,6428,0,0,0,0,4
1660,y1807,20170829,6428,6428,0,0,0,6428,6428,0,0,0,0,4
1661,y1807,20170830,6428,6428,0,0,0,6428,6428,0,0,0,0,4
1662,y1807,20170831,6428,6428,0,0,0,6428,6428,0,0,0,0,4
1663,y1807,20170901,6428,6428,0,0,0,6470,6470,42,42,0,0,4
1664,y1807,20170904,6470,6470,0,0,0,6470,6470,0,0,0,0,4
1665,y1807,20170905,6470,6470,6460,6510,6460,6470,6486,0,16,8,518920,4
1666,y1807,20170906,6470,6486,0,0,0,6486,6486,0,0,0,0,4
1667,y1807,20170907,6486,6486,0,0,0,6486,6486,0,0,0,0,4
1668,y1807,20170908,6486,6486,0,0,0,6486,6486,0,0,0,0,4
1669,y1807,20170911,6486,6486,0,0,0,6486,6486,0,0,0,0,4
1670,y1807,20170912,6486,6486,0,0,0,6486,6486,0,0,0,0,4
1671,y1807,20170913,6486,6486,0,0,0,6512,6512,26,26,0,0,4
1672,y1807,20170914,6512,6512,0,0,0,6512,6512,0,0,0,0,4
1673,y1807,20170915,6512,6512,0,0,0,6512,6512,0,0,0,0,4
1674,y1807,20170918,6512,6512,0,0,0,6512,6512,0,0,0,0,4
1675,y1807,20170919,6512,6512,0,0,0,6512,6512,0,0,0,0,4
1676,y1807,20170920,6512,6512,0,0,0,6512,6512,0,0,0,0,4
1677,y1807,20170921,6512,6512,0,0,0,6512,6512,0,0,0,0,4
1678,y1807,20170922,6512,6512,0,0,0,6444,6444,-68,-68,0,0,4
1679,y1807,20170925,6444,6444,0,0,0,6404,6404,-40,-40,0,0,4
1680,y1807,20170926,6404,6404,0,0,0,6404,6404,0,0,0,0,4
1681,y1807,20170927,6404,6404,0,0,0,6392,6392,-12,-12,0,0,4
1682,y1807,20170928,6392,6392,0,0,0,6392,6392,0,0,0,0,4
1683,y1807,20170929,6392,6392,0,0,0,6382,6382,-10,-10,0,0,4
1684,y1807,20171009,6382,6382,0,0,0,6418,6418,36,36,0,0,4
1685,y1807,20171010,6418,6418,0,0,0,6418,6418,0,0,0,0,4
1686,y1807,20171011,6418,6418,0,0,0,6392,6392,-26,-26,0,0,4
1687,y1807,20171012,6392,6392,0,0,0,6406,6406,14,14,0,0,4
1688,y1807,20171013,6406,6406,0,0,0,6404,6404,-2,-2,0,0,4
1689,y1807,20171016,6404,6404,0,0,0,6452,6452,48,48,0,0,4
1690,y1807,20171017,6452,6452,0,0,0,6458,6458,6,6,0,0,4
1691,y1807,20171018,6458,6458,0,0,0,6430,6430,-28,-28,0,0,4
1692,y1807,20171019,6430,6430,0,0,0,6402,6402,-28,-28,0,0,4
1693,y1807,20171020,6402,6402,0,0,0,6384,6384,-18,-18,0,0,4
1694,y1807,20171023,6384,6384,0,0,0,6322,6322,-62,-62,0,0,4
1695,y1807,20171024,6322,6322,0,0,0,6322,6322,0,0,0,0,4
1696,y1807,20171025,6322,6322,0,0,0,6322,6322,0,0,0,0,4
1697,y1807,20171026,6322,6322,0,0,0,6322,6322,0,0,0,0,4
1698,y1807,20171027,6322,6322,0,0,0,6322,6322,0,0,0,0,4
1699,y1807,20171030,6322,6322,0,0,0,6322,6322,0,0,0,0,4
1700,y1807,20171031,6322,6322,0,0,0,6322,6322,0,0,0,0,4
1701,y1807,20171101,6322,6322,0,0,0,6312,6312,-10,-10,0,0,4
1702,y1807,20171102,6312,6312,0,0,0,6312,6312,0,0,0,0,4
1703,y1807,20171103,6312,6312,0,0,0,6312,6312,0,0,0,0,4
1704,y1807,20171106,6312,6312,0,0,0,6312,6312,0,0,0,0,4
1705,y1807,20171107,6312,6312,0,0,0,6312,6312,0,0,0,0,4
1706,y1807,20171108,6312,6312,0,0,0,6312,6312,0,0,0,0,4
1707,y1807,20171109,6312,6312,6436,6438,6346,6382,6388,70,76,10,638960,2
1708,y1807,20171110,6382,6388,6388,6388,6244,6290,6306,-98,-82,6,378440,2
1709,y1807,20171113,6290,6306,0,0,0,6306,6306,0,0,0,0,2
1710,y1807,20171114,6306,6306,0,0,0,6306,6306,0,0,0,0,2
1711,y1807,20171115,6306,6306,0,0,0,6306,6306,0,0,0,0,2
1712,y1807,20171116,6306,6306,0,0,0,6306,6306,0,0,0,0,2
1713,y1807,20171117,6306,6306,0,0,0,6306,6306,0,0,0,0,2
1714,y1807,20171120,6306,6306,0,0,0,6246,6246,-60,-60,0,0,2
1715,y1807,20171121,6246,6246,6078,6148,6078,6148,6112,-98,-134,8,489040,6
1716,y1807,20171122,6148,6112,0,0,0,6112,6112,0,0,0,0,6
1717,y1807,20171123,6112,6112,0,0,0,6112,6112,0,0,0,0,6
1718,y1807,20171124,6112,6112,0,0,0,6136,6136,24,24,0,0,6
1719,y1807,20171127,6136,6136,0,0,0,6136,6136,0,0,0,0,6
1720,y1807,20171128,6136,6136,0,0,0,6136,6136,0,0,0,0,6
1721,y1807,20171129,6136,6136,6070,6070,6070,6070,6070,-66,-66,4,242800,2
1722,y1807,20171130,6070,6070,0,0,0,6070,6070,0,0,0,0,2
1723,y1807,20171201,6070,6070,0,0,0,6070,6070,0,0,0,0,2
1724,y1807,20171204,6070,6070,0,0,0,6070,6070,0,0,0,0,2
1725,y1807,20171205,6070,6070,0,0,0,6070,6070,0,0,0,0,2
1726,y1807,20171206,6070,6070,0,0,0,6070,6070,0,0,0,0,2
1727,y1807,20171207,6070,6070,0,0,0,6004,6004,-66,-66,0,0,2
1728,y1807,20171208,6004,6004,0,0,0,6004,6004,0,0,0,0,2
1729,y1807,20171211,6004,6004,0,0,0,6004,6004,0,0,0,0,2
1730,y1807,20171212,6004,6004,0,0,0,6004,6004,0,0,0,0,2
1731,y1807,20171213,6004,6004,0,0,0,6004,6004,0,0,0,0,2
1732,y1807,20171214,6004,6004,5928,5928,5928,5928,5928,-76,-76,2,118560,4
1733,y1807,20171215,5928,5928,0,0,0,5928,5928,0,0,0,0,4
1734,y1807,20171218,5928,5928,0,0,0,5928,5928,0,0,0,0,4
1735,y1807,20171219,5928,5928,0,0,0,5892,5892,-36,-36,0,0,4
1736,y1807,20171220,5892,5892,5846,5896,5846,5896,5870,4,-22,4,234840,6
1737,y1807,20171221,5896,5870,0,0,0,5870,5870,0,0,0,0,6
1738,y1807,20171222,5870,5870,0,0,0,5768,5768,-102,-102,0,0,6
1739,y1807,20171225,5768,5768,0,0,0,5768,5768,0,0,0,0,6
1740,y1807,20171226,5768,5768,0,0,0,5768,5768,0,0,0,0,6
1741,y1807,20171227,5768,5768,0,0,0,5768,5768,0,0,0,0,6
1742,y1807,20171228,5768,5768,0,0,0,5768,5768,0,0,0,0,6
1743,y1807,20171229,5768,5768,0,0,0,5768,5768,0,0,0,0,6
1744,y1808,20170815,6510,6510,0,0,0,6496,6496,-14,-14,0,0,0
1745,y1808,20170816,6496,6496,0,0,0,6312,6312,-184,-184,0,0,0
1746,y1808,20170817,6312,6312,0,0,0,6312,6312,0,0,0,0,0
1747,y1808,20170818,6312,6312,0,0,0,6344,6344,32,32,0,0,0
1748,y1808,20170821,6344,6344,0,0,0,6344,6344,0,0,0,0,0
1749,y1808,20170822,6344,6344,0,0,0,6344,6344,0,0,0,0,0
1750,y1808,20170823,6344,6344,0,0,0,6344,6344,0,0,0,0,0
1751,y1808,20170824,6344,6344,0,0,0,6344,6344,0,0,0,0,0
1752,y1808,20170825,6344,6344,0,0,0,6344,6344,0,0,0,0,0
1753,y1808,20170828,6344,6344,0,0,0,6376,6376,32,32,0,0,0
1754,y1808,20170829,6376,6376,0,0,0,6376,6376,0,0,0,0,0
1755,y1808,20170830,6376,6376,0,0,0,6376,6376,0,0,0,0,0
1756,y1808,20170831,6376,6376,0,0,0,6376,6376,0,0,0,0,0
1757,y1808,20170901,6376,6376,6366,6734,6092,6566,6396,190,20,106,6780680,16
1758,y1808,20170904,6566,6396,6550,6550,6550,6550,6550,154,154,12,786000,4
1759,y1808,20170905,6550,6550,0,0,0,6550,6550,0,0,0,0,4
1760,y1808,20170906,6550,6550,0,0,0,6550,6550,0,0,0,0,4
1761,y1808,20170907,6550,6550,0,0,0,6550,6550,0,0,0,0,4
1762,y1808,20170908,6550,6550,0,0,0,6518,6518,-32,-32,0,0,4
1763,y1808,20170911,6518,6518,0,0,0,6518,6518,0,0,0,0,4
1764,y1808,20170912,6518,6518,0,0,0,6518,6518,0,0,0,0,4
1765,y1808,20170913,6518,6518,0,0,0,6544,6544,26,26,0,0,4
1766,y1808,20170914,6544,6544,6592,6592,6532,6532,6562,-12,18,12,787440,8
1767,y1808,20170915,6532,6562,0,0,0,6562,6562,0,0,0,0,8
1768,y1808,20170918,6562,6562,6480,6480,6420,6480,6450,-82,-112,8,516000,6
1769,y1808,20170919,6480,6450,0,0,0,6450,6450,0,0,0,0,6
1770,y1808,20170920,6450,6450,0,0,0,6450,6450,0,0,0,0,6
1771,y1808,20170921,6450,6450,0,0,0,6450,6450,0,0,0,0,6
1772,y1808,20170922,6450,6450,0,0,0,6450,6450,0,0,0,0,6
1773,y1808,20170925,6450,6450,0,0,0,6410,6410,-40,-40,0,0,6
1774,y1808,20170926,6410,6410,0,0,0,6406,6406,-4,-4,0,0,6
1775,y1808,20170927,6406,6406,0,0,0,6406,6406,0,0,0,0,6
1776,y1808,20170928,6406,6406,0,0,0,6406,6406,0,0,0,0,6
1777,y1808,20170929,6406,6406,0,0,0,6396,6396,-10,-10,0,0,6
1778,y1808,20171009,6396,6396,0,0,0,6432,6432,36,36,0,0,6
1779,y1808,20171010,6432,6432,0,0,0,6432,6432,0,0,0,0,6
1780,y1808,20171011,6432,6432,0,0,0,6406,6406,-26,-26,0,0,6
1781,y1808,20171012,6406,6406,0,0,0,6420,6420,14,14,0,0,6
1782,y1808,20171013,6420,6420,0,0,0,6418,6418,-2,-2,0,0,6
1783,y1808,20171016,6418,6418,0,0,0,6418,6418,0,0,0,0,6
1784,y1808,20171017,6418,6418,6306,6306,6306,6306,6306,-112,-112,4,252240,4
1785,y1808,20171018,6306,6306,0,0,0,6282,6282,-24,-24,0,0,4
1786,y1808,20171019,6282,6282,0,0,0,6282,6282,0,0,0,0,4
1787,y1808,20171020,6282,6282,0,0,0,6282,6282,0,0,0,0,4
1788,y1808,20171023,6282,6282,0,0,0,6282,6282,0,0,0,0,4
1789,y1808,20171024,6282,6282,0,0,0,6282,6282,0,0,0,0,4
1790,y1808,20171025,6282,6282,0,0,0,6282,6282,0,0,0,0,4
1791,y1808,20171026,6282,6282,0,0,0,6282,6282,0,0,0,0,4
1792,y1808,20171027,6282,6282,0,0,0,6330,6330,48,48,0,0,4
1793,y1808,20171030,6330,6330,0,0,0,6330,6330,0,0,0,0,4
1794,y1808,20171031,6330,6330,0,0,0,6330,6330,0,0,0,0,4
1795,y1808,20171101,6330,6330,0,0,0,6330,6330,0,0,0,0,4
1796,y1808,20171102,6330,6330,0,0,0,6330,6330,0,0,0,0,4
1797,y1808,20171103,6330,6330,0,0,0,6330,6330,0,0,0,0,4
1798,y1808,20171106,6330,6330,0,0,0,6330,6330,0,0,0,0,4
1799,y1808,20171107,6330,6330,0,0,0,6330,6330,0,0,0,0,4
1800,y1808,20171108,6330,6330,0,0,0,6330,6330,0,0,0,0,4
1801,y1808,20171109,6330,6330,0,0,0,6360,6360,30,30,0,0,4
1802,y1808,20171110,6360,6360,0,0,0,6360,6360,0,0,0,0,4
1803,y1808,20171113,6360,6360,0,0,0,6360,6360,0,0,0,0,4
1804,y1808,20171114,6360,6360,0,0,0,6320,6320,-40,-40,0,0,4
1805,y1808,20171115,6320,6320,0,0,0,6320,6320,0,0,0,0,4
1806,y1808,20171116,6320,6320,6194,6194,6194,6194,6194,-126,-126,2,123880,4
1807,y1808,20171117,6194,6194,0,0,0,6194,6194,0,0,0,0,4
1808,y1808,20171120,6194,6194,0,0,0,6194,6194,0,0,0,0,4
1809,y1808,20171121,6194,6194,0,0,0,6062,6062,-132,-132,0,0,4
1810,y1808,20171122,6062,6062,0,0,0,6098,6098,36,36,0,0,4
1811,y1808,20171123,6098,6098,0,0,0,6120,6120,22,22,0,0,4
1812,y1808,20171124,6120,6120,0,0,0,6144,6144,24,24,0,0,4
1813,y1808,20171127,6144,6144,0,0,0,6144,6144,0,0,0,0,4
1814,y1808,20171128,6144,6144,0,0,0,6144,6144,0,0,0,0,4
1815,y1808,20171129,6144,6144,0,0,0,6144,6144,0,0,0,0,4
1816,y1808,20171130,6144,6144,0,0,0,6150,6150,6,6,0,0,4
1817,y1808,20171201,6150,6150,0,0,0,6150,6150,0,0,0,0,4
1818,y1808,20171204,6150,6150,0,0,0,6150,6150,0,0,0,0,4
1819,y1808,20171205,6150,6150,0,0,0,6150,6150,0,0,0,0,4
1820,y1808,20171206,6150,6150,0,0,0,6150,6150,0,0,0,0,4
1821,y1808,20171207,6150,6150,0,0,0,6150,6150,0,0,0,0,4
1822,y1808,20171208,6150,6150,0,0,0,6150,6150,0,0,0,0,4
1823,y1808,20171211,6150,6150,0,0,0,6142,6142,-8,-8,0,0,4
1824,y1808,20171212,6142,6142,5976,5976,5958,5958,5966,-184,-176,6,358040,10
1825,y1808,20171213,5958,5966,0,0,0,5966,5966,0,0,0,0,10
1826,y1808,20171214,5966,5966,5886,5982,5886,5970,5938,4,-28,14,831480,10
1827,y1808,20171215,5970,5938,0,0,0,5932,5932,-6,-6,0,0,10
1828,y1808,20171218,5932,5932,0,0,0,5932,5932,0,0,0,0,10
1829,y1808,20171219,5932,5932,0,0,0,5910,5910,-22,-22,0,0,10
1830,y1808,20171220,5910,5910,0,0,0,5910,5910,0,0,0,0,10
1831,y1808,20171221,5910,5910,0,0,0,5838,5838,-72,-72,0,0,10
1832,y1808,20171222,5838,5838,0,0,0,5770,5770,-68,-68,0,0,10
1833,y1808,20171225,5770,5770,0,0,0,5770,5770,0,0,0,0,10
1834,y1808,20171226,5770,5770,0,0,0,5770,5770,0,0,0,0,10
1835,y1808,20171227,5770,5770,0,0,0,5780,5780,10,10,0,0,10
1836,y1808,20171228,5780,5780,0,0,0,5780,5780,0,0,0,0,10
1837,y1808,20171229,5780,5780,0,0,0,5780,5780,0,0,0,0,10
1838,y1809,20170915,6562,6562,6562,6568,6520,6550,6550,-12,-12,174,11397600,118
1839,y1809,20170918,6550,6550,6536,6538,6480,6492,6506,-58,-44,400,26028400,398
1840,y1809,20170919,6492,6506,6468,6512,6468,6500,6494,-6,-12,320,20786000,564
1841,y1809,20170920,6500,6494,6482,6512,6470,6482,6498,-12,4,308,20018880,598
1842,y1809,20170921,6482,6498,6508,6508,6454,6454,6482,-44,-16,214,13873800,658
1843,y1809,20170922,6454,6482,6416,6436,6402,6420,6416,-62,-66,402,25797000,794
1844,y1809,20170925,6420,6416,6426,6440,6346,6360,6382,-56,-34,284,18127480,904
1845,y1809,20170926,6360,6382,6368,6394,6368,6374,6384,-8,2,70,4469440,920
1846,y1809,20170927,6374,6384,6374,6410,6342,6360,6366,-24,-18,168,10697400,910
1847,y1809,20170928,6360,6366,6366,6366,6250,6288,6288,-78,-78,258,16224920,986
1848,y1809,20170929,6288,6288,6308,6320,6252,6276,6274,-12,-14,504,31629640,1166
1849,y1809,20171009,6276,6274,6312,6324,6282,6298,6300,24,26,132,8316800,1148
1850,y1809,20171010,6298,6300,6300,6306,6258,6264,6274,-36,-26,962,60367360,1868
1851,y1809,20171011,6264,6274,6248,6268,6232,6250,6252,-24,-22,292,18257760,1990
1852,y1809,20171012,6250,6252,6256,6284,6248,6266,6266,14,14,692,43372640,2558
1853,y1809,20171013,6266,6266,6256,6288,6218,6288,6260,22,-6,618,38691280,2826
1854,y1809,20171016,6288,6260,6296,6326,6288,6326,6312,66,52,520,32828040,2880
1855,y1809,20171017,6326,6312,6352,6352,6298,6320,6318,8,6,660,41709640,3264
1856,y1809,20171018,6320,6318,6306,6320,6258,6290,6290,-28,-28,2228,140148920,4352
1857,y1809,20171019,6290,6290,6292,6306,6204,6204,6258,-86,-32,942,58968600,4790
1858,y1809,20171020,6204,6258,6208,6292,6208,6288,6254,30,-4,1162,72689240,4970
1859,y1809,20171023,6288,6254,6330,6342,6276,6306,6302,52,48,526,33152520,4990
1860,y1809,20171024,6306,6302,6334,6338,6298,6318,6322,16,20,1094,69172120,5368
1861,y1809,20171025,6318,6322,6306,6396,6302,6372,6340,50,18,1560,98928160,5646
1862,y1809,20171026,6372,6340,6364,6380,6336,6360,6356,20,16,880,55936160,5838
1863,y1809,20171027,6360,6356,6362,6370,6240,6362,6354,6,-2,1072,68115520,6172
1864,y1809,20171030,6362,6354,6346,6420,6332,6394,6400,40,46,1038,66449320,6658
1865,y1809,20171031,6394,6400,6382,6398,6348,6360,6368,-40,-32,580,36937840,6708
1866,y1809,20171101,6360,6368,6332,6380,6332,6346,6364,-22,-4,922,58676440,6958
1867,y1809,20171102,6346,6364,6364,6396,6338,6382,6372,18,8,426,27150040,7040
1868,y1809,20171103,6382,6372,6360,6394,6352,6394,6372,22,0,2436,155231240,6930
1869,y1809,20171106,6394,6372,6386,6406,6330,6374,6366,2,-6,2080,132452560,7244
1870,y1809,20171107,6374,6366,6368,6430,6368,6422,6404,56,38,1436,91973600,7930
1871,y1809,20171108,6422,6404,6408,6426,6392,6398,6410,-6,6,982,62959160,8244
1872,y1809,20171109,6398,6410,6422,6462,6402,6436,6430,26,20,1288,82834680,8366
1873,y1809,20171110,6436,6430,6418,6426,6344,6350,6392,-80,-38,5218,333554160,11086
1874,y1809,20171113,6350,6392,6378,6378,6336,6348,6348,-44,-44,1246,79113040,11650
1875,y1809,20171114,6348,6348,6324,6336,6284,6284,6308,-64,-40,4130,260590240,12690
1876,y1809,20171115,6284,6308,6280,6300,6208,6220,6244,-88,-64,2556,159624480,13396
1877,y1809,20171116,6220,6244,6222,6274,6194,6242,6238,-2,-6,2402,149848480,13928
1878,y1809,20171117,6242,6238,6242,6264,6216,6220,6230,-18,-8,4042,251886200,15804
1879,y1809,20171120,6220,6230,6226,6226,6162,6194,6178,-36,-52,2930,181031800,16230
1880,y1809,20171121,6194,6178,6170,6210,6148,6198,6188,20,10,3164,195840840,16744
1881,y1809,20171122,6198,6188,6208,6230,6202,6212,6218,24,30,5240,325853200,18442
1882,y1809,20171123,6212,6218,6228,6234,6204,6212,6218,-6,0,1530,95146920,18632
1883,y1809,20171124,6212,6218,6204,6260,6204,6242,6246,24,28,5994,374394400,21376
1884,y1809,20171127,6242,6246,6260,6260,6178,6186,6204,-60,-42,4338,269200240,23526
1885,y1809,20171128,6186,6204,6192,6206,6176,6182,6190,-22,-14,4694,290596720,24684
1886,y1809,20171129,6182,6190,6186,6196,6136,6140,6160,-50,-30,9360,576624120,21748
1887,y1809,20171130,6140,6160,6130,6194,6122,6162,6166,2,6,5084,313487240,20246
1888,y1809,20171201,6162,6166,6186,6204,6144,6196,6172,30,6,7886,486835560,21394
1889,y1809,20171204,6196,6172,6194,6214,6162,6200,6190,28,18,4868,301394240,22402
1890,y1809,20171205,6200,6190,6188,6204,6110,6126,6160,-64,-30,8390,516869480,23190
1891,y1809,20171206,6126,6160,6134,6160,6116,6130,6134,-30,-26,8078,495589920,22272
1892,y1809,20171207,6130,6134,6122,6128,6006,6028,6058,-106,-76,16980,1028661560,24698
1893,y1809,20171208,6028,6058,6040,6052,6010,6022,6034,-36,-24,6898,416359640,24950
1894,y1809,20171211,6022,6034,6022,6056,5984,6038,6024,4,-10,6988,421014720,26486
1895,y1809,20171212,6038,6024,6030,6080,6026,6060,6058,36,34,8144,493471640,28752
1896,y1809,20171213,6060,6058,6056,6064,6024,6044,6044,-14,-14,5028,303956520,28994
1897,y1809,20171214,6044,6044,6040,6044,5950,5960,5994,-84,-50,6312,378379240,31522
1898,y1809,20171215,5960,5994,5958,5980,5948,5958,5966,-36,-28,3914,233545440,32788
1899,y1809,20171218,5958,5966,5998,6028,5974,5992,5990,26,24,5778,346148680,33698
1900,y1809,20171219,5992,5990,5980,5986,5918,5942,5944,-48,-46,10086,599659600,36640
1901,y1809,20171220,5942,5944,5944,5958,5930,5936,5946,-8,2,5924,352265760,37344
1902,y1809,20171221,5936,5946,5938,5960,5840,5854,5900,-92,-46,14202,838060520,41584
1903,y1809,20171222,5854,5900,5860,5860,5768,5788,5794,-112,-106,17032,986860480,46324
1904,y1809,20171225,5788,5794,5798,5834,5778,5826,5814,32,20,11164,649164720,50368
1905,y1809,20171226,5826,5814,5836,5844,5810,5824,5822,10,8,10668,621302160,50522
1906,y1809,20171227,5824,5822,5838,5870,5812,5864,5846,42,24,14452,845079000,52174
1907,y1809,20171228,5864,5846,5862,5884,5830,5844,5850,-2,4,16690,976491120,56082
1908,y1809,20171229,5844,5850,5830,5852,5792,5812,5810,-38,-40,18124,1053178440,60556
1909,y1811,20171115,6308,6308,0,0,0,6308,6308,0,0,0,0,0
1910,y1811,20171116,6308,6308,0,0,0,6308,6308,0,0,0,0,0
1911,y1811,20171117,6308,6308,0,0,0,6308,6308,0,0,0,0,0
1912,y1811,20171120,6308,6308,0,0,0,6308,6308,0,0,0,0,0
1913,y1811,20171121,6308,6308,0,0,0,6308,6308,0,0,0,0,0
1914,y1811,20171122,6308,6308,6292,6292,6292,6292,6292,-16,-16,2,125840,2
1915,y1811,20171123,6292,6292,0,0,0,6292,6292,0,0,0,0,2
1916,y1811,20171124,6292,6292,6220,6220,6220,6220,6220,-72,-72,2,124400,2
1917,y1811,20171127,6220,6220,0,0,0,6220,6220,0,0,0,0,2
1918,y1811,20171128,6220,6220,0,0,0,6206,6206,-14,-14,0,0,2
1919,y1811,20171129,6206,6206,0,0,0,6176,6176,-30,-30,0,0,2
1920,y1811,20171130,6176,6176,0,0,0,6176,6176,0,0,0,0,2
1921,y1811,20171201,6176,6176,0,0,0,6176,6176,0,0,0,0,2
1922,y1811,20171204,6176,6176,0,0,0,6176,6176,0,0,0,0,2
1923,y1811,20171205,6176,6176,0,0,0,6148,6148,-28,-28,0,0,2
1924,y1811,20171206,6148,6148,0,0,0,6124,6124,-24,-24,0,0,2
1925,y1811,20171207,6124,6124,0,0,0,6050,6050,-74,-74,0,0,2
1926,y1811,20171208,6050,6050,0,0,0,6050,6050,0,0,0,0,2
1927,y1811,20171211,6050,6050,6002,6002,6002,6002,6002,-48,-48,2,120040,4
1928,y1811,20171212,6002,6002,0,0,0,6002,6002,0,0,0,0,4
1929,y1811,20171213,6002,6002,6098,6098,6038,6080,6068,78,66,10,606800,6
1930,y1811,20171214,6080,6068,6090,6090,6040,6040,6056,-28,-12,6,363400,6
1931,y1811,20171215,6040,6056,0,0,0,6028,6028,-28,-28,0,0,6
1932,y1811,20171218,6028,6028,6010,6010,6010,6010,6010,-18,-18,2,120200,6
1933,y1811,20171219,6010,6010,6000,6000,6000,6000,6000,-10,-10,2,120000,6
1934,y1811,20171220,6000,6000,0,0,0,6000,6000,0,0,0,0,6
1935,y1811,20171221,6000,6000,5970,5970,5970,5970,5970,-30,-30,2,119400,6
1936,y1811,20171222,5970,5970,5820,5820,5820,5820,5820,-150,-150,2,116400,6
1937,y1811,20171225,5820,5820,0,0,0,5820,5820,0,0,0,0,6
1938,y1811,20171226,5820,5820,0,0,0,5820,5820,0,0,0,0,6
1939,y1811,20171227,5820,5820,0,0,0,5842,5842,22,22,0,0,6
1940,y1811,20171228,5842,5842,5956,5972,5896,5930,5932,88,90,16,949400,16
1941,y1811,20171229,5930,5932,5946,5946,5946,5946,5946,14,14,2,118920,16
1942,y1812,20171215,6056,6056,0,0,0,6056,6056,0,0,0,0,0
1943,y1812,20171218,6056,6056,0,0,0,6056,6056,0,0,0,0,0
1944,y1812,20171219,6056,6056,0,0,0,6056,6056,0,0,0,0,0
1945,y1812,20171220,6056,6056,0,0,0,6056,6056,0,0,0,0,0
1946,y1812,20171221,6056,6056,0,0,0,6056,6056,0,0,0,0,0
1947,y1812,20171222,6056,6056,0,0,0,6056,6056,0,0,0,0,0
1948,y1812,20171225,6056,6056,0,0,0,6056,6056,0,0,0,0,0
1949,y1812,20171226,6056,6056,0,0,0,6056,6056,0,0,0,0,0
1950,y1812,20171227,6056,6056,0,0,0,6056,6056,0,0,0,0,0
1951,y1812,20171228,6056,6056,0,0,0,6056,6056,0,0,0,0,0
1952,y1812,20171229,6056,6056,0,0,0,6056,6056,0,0,0,0,0
