ROWNUM,合约,日期,前收盘价,前结算价,开盘价,最高价,最低价,收盘价,结算价,涨跌1,涨跌2,成交量,成交金额,持仓量
1,l1701,20170103,9780,9780,9820,9820,9600,9600,9650,-180,-130,742,35807800,8614
2,l1701,20170104,9600,9650,9550,9650,9550,9565,9575,-85,-75,972,46552250,8272
3,l1701,20170105,9565,9575,9600,9600,9550,9600,9555,25,-20,676,32311550,7874
4,l1701,20170106,9600,9555,9735,9770,9460,9460,9555,-95,0,1314,62807650,7224
5,l1701,20170109,9460,9555,9505,9650,9460,9650,9520,95,-35,568,27044650,7058
6,l1701,20170110,9650,9520,9660,9750,9580,9750,9660,230,140,128,6183000,7020
7,l1701,20170111,9750,9660,9745,9750,9650,9650,9710,-10,50,22,1068300,7012
8,l1701,20170112,9650,9710,9750,9880,9695,9740,9770,30,60,492,24034950,6980
9,l1701,20170113,9740,9770,9750,9940,9745,9940,9835,170,65,1142,56180050,6960
10,l1701,20170116,9940,9835,9800,10100,9800,10100,9645,265,-190,678,32846600,0
11,l1702,20170103,9840,9840,0,0,0,9710,9710,-130,-130,0,0,2
12,l1702,20170104,9710,9710,9460,9470,9460,9470,9460,-240,-250,6,283900,8
13,l1702,20170105,9470,9460,9495,9595,9495,9595,9530,135,70,6,285900,2
14,l1702,20170106,9595,9530,9515,9515,9515,9515,9515,-15,-15,2,95150,0
15,l1702,20170109,9515,9515,0,0,0,9515,9515,0,0,0,0,0
16,l1702,20170110,9515,9515,0,0,0,9650,9650,135,135,0,0,0
17,l1702,20170111,9650,9650,0,0,0,9650,9650,0,0,0,0,0
18,l1702,20170112,9650,9650,0,0,0,9650,9650,0,0,0,0,0
19,l1702,20170113,9650,9650,0,0,0,9710,9710,60,60,0,0,0
20,l1702,20170116,9710,9710,0,0,0,9525,9525,-185,-185,0,0,0
21,l1702,20170117,9525,9525,0,0,0,9525,9525,0,0,0,0,0
22,l1702,20170118,9525,9525,9600,9600,9600,9600,9600,75,75,2,96000,2
23,l1702,20170119,9600,9600,0,0,0,9600,9600,0,0,0,0,2
24,l1702,20170120,9600,9600,9615,9615,9615,9615,9615,15,15,2,96150,2
25,l1702,20170123,9615,9615,10085,10085,10085,10085,10085,470,470,2,100850,2
26,l1702,20170124,10085,10085,0,0,0,10085,10085,0,0,0,0,2
27,l1702,20170125,10085,10085,0,0,0,10085,10085,0,0,0,0,2
28,l1702,20170126,10085,10085,10790,10790,10790,10790,10790,705,705,2,107900,0
29,l1702,20170203,10790,10790,0,0,0,10790,10790,0,0,0,0,0
30,l1702,20170206,10790,10790,0,0,0,10790,10790,0,0,0,0,0
31,l1702,20170207,10790,10790,0,0,0,10790,10790,0,0,0,0,0
32,l1702,20170208,10790,10790,0,0,0,10790,10790,0,0,0,0,0
33,l1702,20170209,10790,10790,0,0,0,10790,10790,0,0,0,0,0
34,l1702,20170210,10790,10790,0,0,0,10790,10790,0,0,0,0,0
35,l1702,20170213,10790,10790,0,0,0,10790,10790,0,0,0,0,0
36,l1702,20170214,10790,10790,0,0,0,10790,10790,0,0,0,0,0
37,l1702,20170215,10790,10790,0,0,0,10790,10790,0,0,0,0,0
38,l1702,20170216,10790,10790,0,0,0,10790,10790,0,0,0,0,0
39,l1703,20170103,9985,9985,0,0,0,9855,9855,-130,-130,0,0,16
40,l1703,20170104,9855,9855,9700,9700,9700,9700,9700,-155,-155,4,194000,16
41,l1703,20170105,9700,9700,0,0,0,9700,9700,0,0,0,0,16
42,l1703,20170106,9700,9700,9820,9820,9820,9820,9820,120,120,4,196400,16
43,l1703,20170109,9820,9820,0,0,0,9820,9820,0,0,0,0,16
44,l1703,20170110,9820,9820,0,0,0,9820,9820,0,0,0,0,16
45,l1703,20170111,9820,9820,0,0,0,9820,9820,0,0,0,0,16
46,l1703,20170112,9820,9820,0,0,0,9820,9820,0,0,0,0,16
47,l1703,20170113,9820,9820,0,0,0,9885,9885,65,65,0,0,16
48,l1703,20170116,9885,9885,0,0,0,9695,9695,-190,-190,0,0,16
49,l1703,20170117,9695,9695,0,0,0,9695,9695,0,0,0,0,16
50,l1703,20170118,9695,9695,0,0,0,9770,9770,75,75,0,0,16
51,l1703,20170119,9770,9770,0,0,0,9770,9770,0,0,0,0,16
52,l1703,20170120,9770,9770,0,0,0,9785,9785,15,15,0,0,16
53,l1703,20170123,9785,9785,10270,10270,10245,10245,10260,460,475,16,820850,20
54,l1703,20170124,10245,10260,10255,10255,10255,10255,10255,-5,-5,4,205100,16
55,l1703,20170125,10255,10255,0,0,0,10255,10255,0,0,0,0,16
56,l1703,20170126,10255,10255,10255,10255,10255,10255,10255,0,0,2,102550,14
57,l1703,20170203,10255,10255,0,0,0,10255,10255,0,0,0,0,14
58,l1703,20170206,10255,10255,10195,10195,10195,10195,10195,-60,-60,2,101950,16
59,l1703,20170207,10195,10195,10655,10655,10195,10550,10510,355,315,8,420550,16
60,l1703,20170208,10550,10510,10665,10665,10665,10665,10665,155,155,2,106650,14
61,l1703,20170209,10665,10665,0,0,0,10665,10665,0,0,0,0,14
62,l1703,20170210,10665,10665,0,0,0,10665,10665,0,0,0,0,14
63,l1703,20170213,10665,10665,0,0,0,10665,10665,0,0,0,0,14
64,l1703,20170214,10665,10665,10680,10680,10135,10140,10315,-525,-350,6,309550,14
65,l1703,20170215,10140,10315,0,0,0,10250,10250,-65,-65,0,0,14
66,l1703,20170216,10250,10250,0,0,0,10250,10250,0,0,0,0,14
67,l1703,20170217,10250,10250,0,0,0,10250,10250,0,0,0,0,14
68,l1703,20170220,10250,10250,0,0,0,10250,10250,0,0,0,0,14
69,l1703,20170221,10250,10250,0,0,0,10250,10250,0,0,0,0,14
70,l1703,20170222,10250,10250,0,0,0,10250,10250,0,0,0,0,14
71,l1703,20170223,10250,10250,0,0,0,10250,10250,0,0,0,0,14
72,l1703,20170224,10250,10250,0,0,0,10250,10250,0,0,0,0,14
73,l1703,20170227,10250,10250,0,0,0,10250,10250,0,0,0,0,14
74,l1703,20170228,10250,10250,0,0,0,9740,9740,-510,-510,0,0,14
75,l1703,20170301,9740,9740,8965,8965,8965,8965,8965,-775,-775,10,448250,14
76,l1703,20170302,8965,8965,0,0,0,8965,8965,0,0,0,0,14
77,l1703,20170303,8965,8965,0,0,0,8965,8965,0,0,0,0,14
78,l1703,20170306,8965,8965,8965,8965,8965,8965,8965,0,0,2,89650,14
79,l1703,20170307,8965,8965,0,0,0,8965,8965,0,0,0,0,14
80,l1703,20170308,8965,8965,0,0,0,8965,8965,0,0,0,0,14
81,l1703,20170309,8965,8965,0,0,0,8965,8965,0,0,0,0,14
82,l1703,20170310,8965,8965,8950,8950,8950,8950,8950,-15,-15,14,626500,14
83,l1703,20170313,8950,8950,0,0,0,8950,8950,0,0,0,0,14
84,l1703,20170314,8950,8950,0,0,0,8955,8955,5,5,0,0,0
85,l1704,20170103,10050,10050,9660,9860,9660,9860,9760,-190,-290,4,195200,2
86,l1704,20170104,9860,9760,0,0,0,9760,9760,0,0,0,0,2
87,l1704,20170105,9760,9760,0,0,0,9760,9760,0,0,0,0,2
88,l1704,20170106,9760,9760,9675,9675,9585,9585,9635,-175,-125,84,4047850,12
89,l1704,20170109,9585,9635,9650,9650,9650,9650,9650,15,15,10,482500,2
90,l1704,20170110,9650,9650,0,0,0,9790,9790,140,140,0,0,2
91,l1704,20170111,9790,9790,0,0,0,9790,9790,0,0,0,0,2
92,l1704,20170112,9790,9790,0,0,0,9790,9790,0,0,0,0,2
93,l1704,20170113,9790,9790,0,0,0,9855,9855,65,65,0,0,2
94,l1704,20170116,9855,9855,0,0,0,9665,9665,-190,-190,0,0,2
95,l1704,20170117,9665,9665,0,0,0,9665,9665,0,0,0,0,2
96,l1704,20170118,9665,9665,0,0,0,10145,10145,480,480,0,0,2
97,l1704,20170119,10145,10145,0,0,0,10145,10145,0,0,0,0,2
98,l1704,20170120,10145,10145,0,0,0,10145,10145,0,0,0,0,2
99,l1704,20170123,10145,10145,10340,10340,10340,10340,10340,195,195,2,103400,4
100,l1704,20170124,10340,10340,10360,10360,10360,10360,10360,20,20,2,103600,4
101,l1704,20170125,10360,10360,0,0,0,10360,10360,0,0,0,0,4
102,l1704,20170126,10360,10360,0,0,0,10360,10360,0,0,0,0,4
103,l1704,20170203,10360,10360,0,0,0,10360,10360,0,0,0,0,4
104,l1704,20170206,10360,10360,0,0,0,10360,10360,0,0,0,0,4
105,l1704,20170207,10360,10360,10590,10605,10360,10360,10535,0,175,72,3793650,6
106,l1704,20170208,10360,10535,10265,10265,10265,10265,10265,-270,-270,2,102650,4
107,l1704,20170209,10265,10265,0,0,0,10265,10265,0,0,0,0,4
108,l1704,20170210,10265,10265,0,0,0,10265,10265,0,0,0,0,4
109,l1704,20170213,10265,10265,0,0,0,10265,10265,0,0,0,0,4
110,l1704,20170214,10265,10265,0,0,0,9930,9930,-335,-335,0,0,4
111,l1704,20170215,9930,9930,0,0,0,9930,9930,0,0,0,0,4
112,l1704,20170216,9930,9930,0,0,0,9930,9930,0,0,0,0,4
113,l1704,20170217,9930,9930,0,0,0,9930,9930,0,0,0,0,4
114,l1704,20170220,9930,9930,0,0,0,9930,9930,0,0,0,0,4
115,l1704,20170221,9930,9930,0,0,0,9930,9930,0,0,0,0,4
116,l1704,20170222,9930,9930,0,0,0,9930,9930,0,0,0,0,4
117,l1704,20170223,9930,9930,0,0,0,9930,9930,0,0,0,0,4
118,l1704,20170224,9930,9930,0,0,0,9930,9930,0,0,0,0,4
119,l1704,20170227,9930,9930,0,0,0,9930,9930,0,0,0,0,4
120,l1704,20170228,9930,9930,0,0,0,9930,9930,0,0,0,0,4
121,l1704,20170301,9930,9930,9930,9930,9930,9930,9930,0,0,6,297900,0
122,l1704,20170302,9930,9930,0,0,0,9930,9930,0,0,0,0,0
123,l1704,20170303,9930,9930,0,0,0,9930,9930,0,0,0,0,0
124,l1704,20170306,9930,9930,0,0,0,9930,9930,0,0,0,0,0
125,l1704,20170307,9930,9930,0,0,0,9930,9930,0,0,0,0,0
126,l1704,20170308,9930,9930,0,0,0,9930,9930,0,0,0,0,0
127,l1704,20170309,9930,9930,0,0,0,9930,9930,0,0,0,0,0
128,l1704,20170310,9930,9930,0,0,0,9915,9915,-15,-15,0,0,0
129,l1704,20170313,9915,9915,0,0,0,9915,9915,0,0,0,0,0
130,l1704,20170314,9915,9915,0,0,0,9915,9915,0,0,0,0,0
131,l1704,20170315,9915,9915,0,0,0,9915,9915,0,0,0,0,0
132,l1704,20170316,9915,9915,0,0,0,9915,9915,0,0,0,0,0
133,l1704,20170317,9915,9915,0,0,0,9915,9915,0,0,0,0,0
134,l1704,20170320,9915,9915,0,0,0,9915,9915,0,0,0,0,0
135,l1704,20170321,9915,9915,0,0,0,9915,9915,0,0,0,0,0
136,l1704,20170322,9915,9915,0,0,0,9915,9915,0,0,0,0,0
137,l1704,20170323,9915,9915,0,0,0,9915,9915,0,0,0,0,0
138,l1704,20170324,9915,9915,0,0,0,9915,9915,0,0,0,0,0
139,l1704,20170327,9915,9915,0,0,0,9915,9915,0,0,0,0,0
140,l1704,20170328,9915,9915,0,0,0,9915,9915,0,0,0,0,0
141,l1704,20170329,9915,9915,0,0,0,9915,9915,0,0,0,0,0
142,l1704,20170330,9915,9915,0,0,0,9915,9915,0,0,0,0,0
143,l1704,20170331,9915,9915,0,0,0,9915,9915,0,0,0,0,0
144,l1704,20170405,9915,9915,0,0,0,9915,9915,0,0,0,0,0
145,l1704,20170406,9915,9915,0,0,0,9915,9915,0,0,0,0,0
146,l1704,20170407,9915,9915,0,0,0,9915,9915,0,0,0,0,0
147,l1704,20170410,9915,9915,0,0,0,9915,9915,0,0,0,0,0
148,l1704,20170411,9915,9915,0,0,0,9915,9915,0,0,0,0,0
149,l1704,20170412,9915,9915,0,0,0,9915,9915,0,0,0,0,0
150,l1704,20170413,9915,9915,0,0,0,9915,9915,0,0,0,0,0
151,l1704,20170414,9915,9915,0,0,0,9915,9915,0,0,0,0,0
152,l1704,20170417,9915,9915,0,0,0,9915,9915,0,0,0,0,0
153,l1704,20170418,9915,9915,0,0,0,9915,9915,0,0,0,0,0
154,l1705,20170103,9880,9950,9875,9955,9705,9710,9800,-240,-150,415780,20380315600,259528
155,l1705,20170104,9710,9800,9670,9820,9635,9695,9715,-105,-85,435098,21135449150,264658
156,l1705,20170105,9695,9715,9740,9770,9620,9700,9690,-15,-25,422060,20448977050,269682
157,l1705,20170106,9700,9690,9740,9900,9525,9525,9730,-165,40,676846,32940555700,280058
158,l1705,20170109,9525,9730,9550,9795,9520,9795,9675,65,-55,455126,22024360300,255758
159,l1705,20170110,9795,9675,9770,9870,9650,9860,9745,185,70,468766,22842527950,252054
160,l1705,20170111,9860,9745,9870,9940,9730,9815,9815,70,70,486490,23876429950,253340
161,l1705,20170112,9815,9815,9850,9990,9755,9825,9865,10,50,541204,26701410150,264852
162,l1705,20170113,9825,9865,9860,10125,9830,10105,9975,240,110,597018,29779489550,305540
163,l1705,20170116,10105,9975,10215,10315,10120,10270,10225,295,250,512566,26213025400,302868
164,l1705,20170117,10270,10225,10235,10330,10080,10130,10200,-95,-25,443762,22642505600,298556
165,l1705,20170118,10130,10200,10145,10275,10085,10220,10190,20,-10,464360,23664234500,318414
166,l1705,20170119,10220,10190,10195,10215,10050,10140,10120,-50,-70,331550,16780289100,290632
167,l1705,20170120,10140,10120,10120,10390,10105,10265,10240,145,120,581066,29756093350,327438
168,l1705,20170123,10265,10240,10330,10445,10260,10325,10355,85,115,426468,22088593200,340644
169,l1705,20170124,10325,10355,10300,10380,10150,10230,10255,-125,-100,380182,19495140850,296570
170,l1705,20170125,10230,10255,10200,10425,10190,10405,10320,150,65,295564,15257138700,309676
171,l1705,20170126,10405,10320,10435,10460,10210,10260,10300,-60,-20,290286,14954405750,292882
172,l1705,20170203,10260,10300,10300,10410,10160,10240,10280,-60,-20,301228,15488860450,292186
173,l1705,20170206,10240,10280,10220,10420,10175,10390,10335,110,55,449064,23205673650,351494
174,l1705,20170207,10390,10335,10390,10520,10310,10310,10415,-25,80,540664,28156740500,359940
175,l1705,20170208,10310,10415,10280,10350,10150,10225,10245,-190,-170,494180,25325558050,358150
176,l1705,20170209,10225,10245,10255,10345,10205,10220,10270,-25,25,418832,21514297800,344460
177,l1705,20170210,10220,10270,10255,10305,10115,10250,10220,-20,-50,436310,22302446050,327314
178,l1705,20170213,10250,10220,10350,10625,10350,10605,10510,385,290,600652,31567963400,386424
179,l1705,20170214,10605,10510,10580,10615,10480,10590,10540,80,30,334462,17634327400,374202
180,l1705,20170215,10590,10540,10460,10520,10015,10015,10365,-525,-175,628750,32588049300,329870
181,l1705,20170216,10015,10365,10100,10200,9905,9910,10080,-455,-285,659612,33251668900,288706
182,l1705,20170217,9910,10080,10000,10040,9830,9885,9940,-195,-140,485284,24123131800,280162
183,l1705,20170220,9885,9940,9905,10015,9870,9925,9945,-15,5,372246,18517608000,285172
184,l1705,20170221,9925,9945,9950,10025,9770,9830,9890,-115,-55,535186,26471078000,304060
185,l1705,20170222,9830,9890,9830,9930,9795,9850,9860,-40,-30,403142,19877088050,289336
186,l1705,20170223,9850,9860,9850,9900,9580,9645,9725,-215,-135,611368,29728835400,338616
187,l1705,20170224,9645,9725,9580,9745,9565,9675,9680,-50,-45,448394,21710155050,322912
188,l1705,20170227,9675,9680,9725,9805,9665,9675,9735,-5,55,444308,21628039650,328532
189,l1705,20170228,9675,9735,9650,9765,9510,9620,9630,-115,-105,510746,24599094450,345974
190,l1705,20170301,9620,9630,9650,9690,9535,9585,9620,-45,-10,463070,22276826650,380176
191,l1705,20170302,9585,9620,9605,9650,9545,9625,9600,5,-20,508490,24407747250,411554
192,l1705,20170303,9625,9600,9570,9700,9520,9660,9640,60,40,551636,26596482750,398926
193,l1705,20170306,9660,9640,9670,9790,9660,9720,9730,80,90,451708,21984492550,378426
194,l1705,20170307,9720,9730,9745,9760,9600,9655,9655,-75,-75,444340,21451941100,400504
195,l1705,20170308,9655,9655,9510,9530,9275,9305,9405,-350,-250,715286,33637394300,426496
196,l1705,20170309,9305,9405,9250,9310,9175,9260,9255,-145,-150,513392,23758906950,394126
197,l1705,20170310,9260,9255,9295,9325,9110,9115,9210,-140,-45,432912,19942400400,403938
198,l1705,20170313,9115,9210,9050,9225,9025,9210,9110,0,-100,466488,21254487800,385160
199,l1705,20170314,9210,9110,9215,9290,9160,9195,9230,85,120,458866,21179972150,375552
200,l1705,20170315,9195,9230,9265,9340,9200,9250,9280,20,50,378776,17579102350,361786
201,l1705,20170316,9250,9280,9300,9390,9265,9390,9330,110,50,450104,20997398650,349640
202,l1705,20170317,9390,9330,9380,9440,9350,9405,9395,75,65,347798,16341997950,355620
203,l1705,20170320,9405,9395,9395,9455,9275,9445,9335,50,-60,443606,20711738300,344674
204,l1705,20170321,9445,9335,9440,9490,9380,9400,9435,65,100,471444,22247530000,334690
205,l1705,20170322,9400,9435,9355,9355,9200,9245,9250,-190,-185,456576,21125188750,325900
206,l1705,20170323,9245,9250,9335,9405,9305,9345,9355,95,105,370792,17345656750,310868
207,l1705,20170324,9345,9355,9350,9470,9260,9260,9400,-95,45,415988,19554107050,290498
208,l1705,20170327,9260,9400,9205,9280,9015,9195,9150,-205,-250,497698,22774814250,281574
209,l1705,20170328,9195,9150,9235,9250,9135,9145,9180,-5,30,298168,13690680750,268340
210,l1705,20170329,9145,9180,9205,9350,9205,9305,9295,125,115,334256,15535910650,243040
211,l1705,20170330,9305,9295,9380,9390,9150,9180,9245,-115,-50,308258,14255660250,252234
212,l1705,20170331,9180,9245,9225,9295,9070,9140,9195,-105,-50,334164,15364277950,238466
213,l1705,20170405,9140,9195,9175,9485,9160,9475,9340,280,145,385288,17999907000,208768
214,l1705,20170406,9475,9340,9450,9535,9405,9530,9470,190,130,295334,13984822700,197144
215,l1705,20170407,9530,9470,9440,9610,9405,9485,9510,15,40,310894,14788825400,154488
216,l1705,20170410,9485,9510,9505,9565,9270,9270,9410,-240,-100,134158,6315222650,124394
217,l1705,20170411,9270,9410,9300,9405,9285,9355,9345,-55,-65,82838,3871113100,106046
218,l1705,20170412,9355,9345,9360,9400,9275,9305,9330,-40,-15,63832,2979021350,93998
219,l1705,20170413,9305,9330,9270,9345,9210,9220,9285,-110,-45,47992,2228855350,83280
220,l1705,20170414,9220,9285,9245,9270,9000,9115,9095,-170,-190,57266,2604451350,65432
221,l1705,20170417,9115,9095,9150,9185,9010,9045,9090,-50,-5,26972,1225986400,58390
222,l1705,20170418,9045,9090,9005,9080,8910,9010,9000,-80,-90,31128,1400974100,51572
223,l1705,20170419,9010,9000,8970,9025,8900,8990,8955,-10,-45,22730,1017914750,45190
224,l1705,20170420,8990,8955,8975,9015,8885,8955,8950,0,-5,24366,1090964850,39030
225,l1705,20170421,8955,8950,8960,9035,8870,8870,8955,-80,5,12546,561945750,35036
226,l1705,20170424,8870,8955,8810,8845,8710,8730,8760,-225,-195,11778,516140250,30208
227,l1705,20170425,8730,8760,8740,8780,8695,8700,8730,-60,-30,8038,351050600,25132
228,l1705,20170426,8700,8730,8715,8805,8695,8725,8750,-5,20,8498,371995300,18976
229,l1705,20170427,8725,8750,8750,8775,8720,8760,8745,10,-5,5984,261709000,14546
230,l1705,20170428,8760,8745,8785,8900,8785,8825,8850,80,105,7152,316506650,8750
231,l1705,20170502,8825,8850,8760,8925,8760,8900,8900,50,50,1750,77878300,7084
232,l1705,20170503,8900,8900,8900,8940,8800,8810,8885,-90,-15,1736,77145900,5766
233,l1705,20170504,8810,8885,8760,8765,8650,8700,8685,-185,-200,796,34585000,5116
234,l1705,20170505,8700,8685,8750,8750,8630,8685,8650,0,-35,188,8134750,4948
235,l1705,20170508,8685,8650,8800,8800,8715,8750,8750,100,100,262,11463450,4786
236,l1705,20170509,8750,8750,8700,8780,8655,8680,8675,-70,-75,104,4512950,4752
237,l1705,20170510,8680,8675,8680,8680,8600,8600,8600,-75,-75,402,17286800,4750
238,l1705,20170511,8600,8600,8645,8680,8645,8680,8650,80,50,58,2509800,4702
239,l1705,20170512,8680,8650,8700,8710,8660,8710,8675,60,25,146,6332900,4702
240,l1705,20170515,8710,8675,8800,8900,8785,8900,8815,225,140,1642,72471700,0
241,l1706,20170103,9890,9890,9890,9955,9745,9745,9865,-145,-25,236,11642600,44
242,l1706,20170104,9745,9865,9665,9770,9665,9770,9760,-95,-105,26,1269050,20
243,l1706,20170105,9770,9760,9715,9715,9560,9645,9640,-115,-120,6,289200,18
244,l1706,20170106,9645,9640,9780,9780,9550,9550,9665,-90,25,38,1836500,8
245,l1706,20170109,9550,9665,9665,9665,9665,9665,9665,0,0,2,96650,10
246,l1706,20170110,9665,9665,9570,9750,9570,9750,9690,85,25,6,290700,8
247,l1706,20170111,9750,9690,9755,9755,9755,9755,9755,65,65,2,97550,10
248,l1706,20170112,9755,9755,9800,9800,9800,9800,9800,45,45,2,98000,8
249,l1706,20170113,9800,9800,9925,9925,9870,9870,9895,70,95,4,197950,8
250,l1706,20170116,9870,9895,0,0,0,10140,10140,245,245,0,0,8
251,l1706,20170117,10140,10140,0,0,0,10140,10140,0,0,0,0,8
252,l1706,20170118,10140,10140,0,0,0,10140,10140,0,0,0,0,8
253,l1706,20170119,10140,10140,0,0,0,10140,10140,0,0,0,0,8
254,l1706,20170120,10140,10140,0,0,0,10140,10140,0,0,0,0,8
255,l1706,20170123,10140,10140,10400,10400,10325,10330,10360,190,220,94,4870050,8
256,l1706,20170124,10330,10360,10335,10335,10010,10010,10170,-350,-190,4,203450,10
257,l1706,20170125,10010,10170,0,0,0,10190,10190,20,20,0,0,10
258,l1706,20170126,10190,10190,0,0,0,10190,10190,0,0,0,0,10
259,l1706,20170203,10190,10190,0,0,0,10190,10190,0,0,0,0,10
260,l1706,20170206,10190,10190,0,0,0,10190,10190,0,0,0,0,10
261,l1706,20170207,10190,10190,0,0,0,10190,10190,0,0,0,0,10
262,l1706,20170208,10190,10190,10155,10155,10155,10155,10155,-35,-35,2,101550,8
263,l1706,20170209,10155,10155,0,0,0,10155,10155,0,0,0,0,8
264,l1706,20170210,10155,10155,0,0,0,10155,10155,0,0,0,0,8
265,l1706,20170213,10155,10155,0,0,0,10440,10440,285,285,0,0,8
266,l1706,20170214,10440,10440,0,0,0,10440,10440,0,0,0,0,8
267,l1706,20170215,10440,10440,10350,10350,10270,10270,10310,-170,-130,4,206200,8
268,l1706,20170216,10270,10310,9920,9925,9830,9925,9880,-385,-430,22,1086950,8
269,l1706,20170217,9925,9880,0,0,0,9880,9880,0,0,0,0,8
270,l1706,20170220,9880,9880,0,0,0,9880,9880,0,0,0,0,8
271,l1706,20170221,9880,9880,0,0,0,9880,9880,0,0,0,0,8
272,l1706,20170222,9880,9880,0,0,0,9880,9880,0,0,0,0,8
273,l1706,20170223,9880,9880,0,0,0,9745,9745,-135,-135,0,0,8
274,l1706,20170224,9745,9745,0,0,0,9745,9745,0,0,0,0,8
275,l1706,20170227,9745,9745,9740,9740,9740,9740,9740,-5,-5,2,97400,6
276,l1706,20170228,9740,9740,0,0,0,9740,9740,0,0,0,0,6
277,l1706,20170301,9740,9740,9700,9700,9530,9530,9600,-210,-140,10,480000,8
278,l1706,20170302,9530,9600,0,0,0,9600,9600,0,0,0,0,8
279,l1706,20170303,9600,9600,0,0,0,9600,9600,0,0,0,0,8
280,l1706,20170306,9600,9600,0,0,0,9600,9600,0,0,0,0,8
281,l1706,20170307,9600,9600,0,0,0,9600,9600,0,0,0,0,8
282,l1706,20170308,9600,9600,9425,9425,9310,9390,9365,-210,-235,56,2623300,6
283,l1706,20170309,9390,9365,9295,9305,9220,9285,9270,-80,-95,28,1298200,10
284,l1706,20170310,9285,9270,0,0,0,9270,9270,0,0,0,0,10
285,l1706,20170313,9270,9270,9120,9120,9120,9120,9120,-150,-150,4,182400,10
286,l1706,20170314,9120,9120,9200,9200,9200,9200,9200,80,80,4,184000,6
287,l1706,20170315,9200,9200,0,0,0,9200,9200,0,0,0,0,6
288,l1706,20170316,9200,9200,9360,9360,9360,9360,9360,160,160,2,93600,6
289,l1706,20170317,9360,9360,0,0,0,9360,9360,0,0,0,0,6
290,l1706,20170320,9360,9360,0,0,0,9360,9360,0,0,0,0,6
291,l1706,20170321,9360,9360,9370,9455,9370,9455,9410,95,50,8,376500,6
292,l1706,20170322,9455,9410,0,0,0,9230,9230,-180,-180,0,0,6
293,l1706,20170323,9230,9230,0,0,0,9230,9230,0,0,0,0,6
294,l1706,20170324,9230,9230,9490,9490,9390,9480,9435,250,205,8,377550,8
295,l1706,20170327,9480,9435,0,0,0,9185,9185,-250,-250,0,0,8
296,l1706,20170328,9185,9185,9185,9185,9185,9185,9185,0,0,6,275550,2
297,l1706,20170329,9185,9185,0,0,0,9300,9300,115,115,0,0,2
298,l1706,20170330,9300,9300,0,0,0,9250,9250,-50,-50,0,0,2
299,l1706,20170331,9250,9250,0,0,0,9200,9200,-50,-50,0,0,2
300,l1706,20170405,9200,9200,0,0,0,9345,9345,145,145,0,0,2
301,l1706,20170406,9345,9345,0,0,0,9475,9475,130,130,0,0,2
302,l1706,20170407,9475,9475,9505,9590,9505,9590,9540,115,65,24,1144950,2
303,l1706,20170410,9590,9540,9590,9590,9495,9495,9565,-45,25,16,765350,14
304,l1706,20170411,9495,9565,9405,9405,9400,9400,9400,-165,-165,4,188050,12
305,l1706,20170412,9400,9400,0,0,0,9385,9385,-15,-15,0,0,12
306,l1706,20170413,9385,9385,0,0,0,9340,9340,-45,-45,0,0,12
307,l1706,20170414,9340,9340,9100,9100,9090,9090,9095,-250,-245,6,272850,6
308,l1706,20170417,9090,9095,8925,8925,8925,8925,8925,-170,-170,2,89250,6
309,l1706,20170418,8925,8925,8845,9025,8720,8980,8855,55,-70,60,2657050,6
310,l1706,20170419,8980,8855,0,0,0,8855,8855,0,0,0,0,6
311,l1706,20170420,8855,8855,0,0,0,8855,8855,0,0,0,0,6
312,l1706,20170421,8855,8855,0,0,0,8855,8855,0,0,0,0,6
313,l1706,20170424,8855,8855,0,0,0,8665,8665,-190,-190,0,0,6
314,l1706,20170425,8665,8665,8495,8495,8495,8495,8495,-170,-170,2,84950,6
315,l1706,20170426,8495,8495,8635,8635,8635,8635,8635,140,140,2,86350,6
316,l1706,20170427,8635,8635,0,0,0,8635,8635,0,0,0,0,6
317,l1706,20170428,8635,8635,8750,8750,8750,8750,8750,115,115,2,87500,4
318,l1706,20170502,8750,8750,0,0,0,8795,8795,45,45,0,0,4
319,l1706,20170503,8795,8795,0,0,0,8795,8795,0,0,0,0,4
320,l1706,20170504,8795,8795,0,0,0,8600,8600,-195,-195,0,0,4
321,l1706,20170505,8600,8600,0,0,0,8570,8570,-30,-30,0,0,4
322,l1706,20170508,8570,8570,0,0,0,8665,8665,95,95,0,0,4
323,l1706,20170509,8665,8665,0,0,0,8595,8595,-70,-70,0,0,4
324,l1706,20170510,8595,8595,0,0,0,8525,8525,-70,-70,0,0,4
325,l1706,20170511,8525,8525,0,0,0,8570,8570,45,45,0,0,4
326,l1706,20170512,8570,8570,0,0,0,8590,8590,20,20,0,0,4
327,l1706,20170515,8590,8590,0,0,0,8725,8725,135,135,0,0,4
328,l1706,20170516,8725,8725,0,0,0,8725,8725,0,0,0,0,4
329,l1706,20170517,8725,8725,0,0,0,8725,8725,0,0,0,0,4
330,l1706,20170518,8725,8725,0,0,0,8725,8725,0,0,0,0,4
331,l1706,20170519,8725,8725,0,0,0,8725,8725,0,0,0,0,4
332,l1706,20170522,8725,8725,0,0,0,8725,8725,0,0,0,0,4
333,l1706,20170523,8725,8725,0,0,0,8725,8725,0,0,0,0,4
334,l1706,20170524,8725,8725,0,0,0,8725,8725,0,0,0,0,4
335,l1706,20170525,8725,8725,0,0,0,9150,9150,425,425,0,0,4
336,l1706,20170526,9150,9150,9150,9150,8780,8780,8930,-370,-220,14,625300,10
337,l1706,20170531,8780,8930,9365,9365,9365,9365,9365,435,435,10,468250,0
338,l1706,20170601,9365,9365,0,0,0,9365,9365,0,0,0,0,0
339,l1706,20170602,9365,9365,0,0,0,9365,9365,0,0,0,0,0
340,l1706,20170605,9365,9365,0,0,0,9365,9365,0,0,0,0,0
341,l1706,20170606,9365,9365,0,0,0,9365,9365,0,0,0,0,0
342,l1706,20170607,9365,9365,0,0,0,9365,9365,0,0,0,0,0
343,l1706,20170608,9365,9365,0,0,0,9365,9365,0,0,0,0,0
344,l1706,20170609,9365,9365,0,0,0,9365,9365,0,0,0,0,0
345,l1706,20170612,9365,9365,0,0,0,9365,9365,0,0,0,0,0
346,l1706,20170613,9365,9365,0,0,0,9365,9365,0,0,0,0,0
347,l1706,20170614,9365,9365,0,0,0,9365,9365,0,0,0,0,0
348,l1707,20170103,9930,9930,0,0,0,9905,9905,-25,-25,0,0,6
349,l1707,20170104,9905,9905,0,0,0,9800,9800,-105,-105,0,0,6
350,l1707,20170105,9800,9800,0,0,0,9800,9800,0,0,0,0,6
351,l1707,20170106,9800,9800,0,0,0,9825,9825,25,25,0,0,6
352,l1707,20170109,9825,9825,0,0,0,9825,9825,0,0,0,0,6
353,l1707,20170110,9825,9825,0,0,0,9825,9825,0,0,0,0,6
354,l1707,20170111,9825,9825,0,0,0,9825,9825,0,0,0,0,6
355,l1707,20170112,9825,9825,0,0,0,9825,9825,0,0,0,0,6
356,l1707,20170113,9825,9825,9980,9980,9920,9920,9950,95,125,4,199000,6
357,l1707,20170116,9920,9950,0,0,0,10195,10195,245,245,0,0,6
358,l1707,20170117,10195,10195,0,0,0,10195,10195,0,0,0,0,6
359,l1707,20170118,10195,10195,0,0,0,10195,10195,0,0,0,0,6
360,l1707,20170119,10195,10195,0,0,0,10195,10195,0,0,0,0,6
361,l1707,20170120,10195,10195,0,0,0,10195,10195,0,0,0,0,6
362,l1707,20170123,10195,10195,0,0,0,10195,10195,0,0,0,0,6
363,l1707,20170124,10195,10195,0,0,0,10195,10195,0,0,0,0,6
364,l1707,20170125,10195,10195,0,0,0,10195,10195,0,0,0,0,6
365,l1707,20170126,10195,10195,0,0,0,10180,10180,-15,-15,0,0,6
366,l1707,20170203,10180,10180,0,0,0,10180,10180,0,0,0,0,6
367,l1707,20170206,10180,10180,0,0,0,10180,10180,0,0,0,0,6
368,l1707,20170207,10180,10180,0,0,0,10180,10180,0,0,0,0,6
369,l1707,20170208,10180,10180,0,0,0,10180,10180,0,0,0,0,6
370,l1707,20170209,10180,10180,0,0,0,10180,10180,0,0,0,0,6
371,l1707,20170210,10180,10180,0,0,0,10180,10180,0,0,0,0,6
372,l1707,20170213,10180,10180,0,0,0,10465,10465,285,285,0,0,6
373,l1707,20170214,10465,10465,0,0,0,10465,10465,0,0,0,0,6
374,l1707,20170215,10465,10465,0,0,0,10335,10335,-130,-130,0,0,6
375,l1707,20170216,10335,10335,10050,10050,10050,10050,10050,-285,-285,4,201000,10
376,l1707,20170217,10050,10050,0,0,0,10050,10050,0,0,0,0,10
377,l1707,20170220,10050,10050,0,0,0,10050,10050,0,0,0,0,10
378,l1707,20170221,10050,10050,0,0,0,10050,10050,0,0,0,0,10
379,l1707,20170222,10050,10050,0,0,0,10050,10050,0,0,0,0,10
380,l1707,20170223,10050,10050,0,0,0,9915,9915,-135,-135,0,0,10
381,l1707,20170224,9915,9915,0,0,0,9870,9870,-45,-45,0,0,10
382,l1707,20170227,9870,9870,0,0,0,9870,9870,0,0,0,0,10
383,l1707,20170228,9870,9870,0,0,0,9765,9765,-105,-105,0,0,10
384,l1707,20170301,9765,9765,0,0,0,9765,9765,0,0,0,0,10
385,l1707,20170302,9765,9765,0,0,0,9765,9765,0,0,0,0,10
386,l1707,20170303,9765,9765,0,0,0,9765,9765,0,0,0,0,10
387,l1707,20170306,9765,9765,0,0,0,9765,9765,0,0,0,0,10
388,l1707,20170307,9765,9765,0,0,0,9765,9765,0,0,0,0,10
389,l1707,20170308,9765,9765,0,0,0,9530,9530,-235,-235,0,0,10
390,l1707,20170309,9530,9530,0,0,0,9435,9435,-95,-95,0,0,10
391,l1707,20170310,9435,9435,0,0,0,9390,9390,-45,-45,0,0,10
392,l1707,20170313,9390,9390,0,0,0,9240,9240,-150,-150,0,0,10
393,l1707,20170314,9240,9240,0,0,0,9240,9240,0,0,0,0,10
394,l1707,20170315,9240,9240,0,0,0,9240,9240,0,0,0,0,10
395,l1707,20170316,9240,9240,0,0,0,9400,9400,160,160,0,0,10
396,l1707,20170317,9400,9400,0,0,0,9400,9400,0,0,0,0,10
397,l1707,20170320,9400,9400,9425,9425,9425,9425,9425,25,25,2,94250,8
398,l1707,20170321,9425,9425,0,0,0,9425,9425,0,0,0,0,8
399,l1707,20170322,9425,9425,0,0,0,9245,9245,-180,-180,0,0,8
400,l1707,20170323,9245,9245,0,0,0,9345,9345,100,100,0,0,8
401,l1707,20170324,9345,9345,9350,9360,9350,9360,9355,15,10,4,187100,6
402,l1707,20170327,9360,9355,0,0,0,9110,9110,-245,-245,0,0,6
403,l1707,20170328,9110,9110,0,0,0,9110,9110,0,0,0,0,6
404,l1707,20170329,9110,9110,0,0,0,9110,9110,0,0,0,0,6
405,l1707,20170330,9110,9110,0,0,0,9110,9110,0,0,0,0,6
406,l1707,20170331,9110,9110,9225,9225,9225,9225,9225,115,115,2,92250,6
407,l1707,20170405,9225,9225,0,0,0,9370,9370,145,145,0,0,6
408,l1707,20170406,9370,9370,0,0,0,9370,9370,0,0,0,0,6
409,l1707,20170407,9370,9370,0,0,0,9370,9370,0,0,0,0,6
410,l1707,20170410,9370,9370,0,0,0,9390,9390,20,20,0,0,6
411,l1707,20170411,9390,9390,9255,9255,9255,9255,9255,-135,-135,2,92550,4
412,l1707,20170412,9255,9255,9210,9210,9210,9210,9210,-45,-45,2,92100,2
413,l1707,20170413,9210,9210,9460,9460,9460,9460,9460,250,250,4,189200,6
414,l1707,20170414,9460,9460,0,0,0,9215,9215,-245,-245,0,0,6
415,l1707,20170417,9215,9215,0,0,0,9045,9045,-170,-170,0,0,6
416,l1707,20170418,9045,9045,0,0,0,9045,9045,0,0,0,0,6
417,l1707,20170419,9045,9045,0,0,0,9045,9045,0,0,0,0,6
418,l1707,20170420,9045,9045,9085,9085,8975,8975,9030,-70,-15,4,180600,6
419,l1707,20170421,8975,9030,0,0,0,9035,9035,5,5,0,0,6
420,l1707,20170424,9035,9035,8885,8885,8585,8585,8760,-450,-275,30,1314650,6
421,l1707,20170425,8585,8760,0,0,0,8760,8760,0,0,0,0,6
422,l1707,20170426,8760,8760,0,0,0,8760,8760,0,0,0,0,6
423,l1707,20170427,8760,8760,0,0,0,8760,8760,0,0,0,0,6
424,l1707,20170428,8760,8760,8900,8900,8900,8900,8900,140,140,4,178000,2
425,l1707,20170502,8900,8900,0,0,0,8900,8900,0,0,0,0,2
426,l1707,20170503,8900,8900,0,0,0,8900,8900,0,0,0,0,2
427,l1707,20170504,8900,8900,8915,8960,8915,8960,8955,60,55,192,8601150,194
428,l1707,20170505,8960,8955,8900,8900,8900,8900,8900,-55,-55,30,1335000,194
429,l1707,20170508,8900,8900,0,0,0,8900,8900,0,0,0,0,194
430,l1707,20170509,8900,8900,9015,9015,8965,8965,8970,65,70,12,538400,194
431,l1707,20170510,8965,8970,8615,8615,8615,8615,8615,-355,-355,192,8270400,2
432,l1707,20170511,8615,8615,0,0,0,8665,8665,50,50,0,0,2
433,l1707,20170512,8665,8665,0,0,0,8665,8665,0,0,0,0,2
434,l1707,20170515,8665,8665,0,0,0,8665,8665,0,0,0,0,2
435,l1707,20170516,8665,8665,9060,9060,9060,9060,9060,395,395,2,90600,0
436,l1707,20170517,9060,9060,0,0,0,9060,9060,0,0,0,0,0
437,l1707,20170518,9060,9060,0,0,0,9060,9060,0,0,0,0,0
438,l1707,20170519,9060,9060,0,0,0,9060,9060,0,0,0,0,0
439,l1707,20170522,9060,9060,0,0,0,9060,9060,0,0,0,0,0
440,l1707,20170523,9060,9060,0,0,0,9060,9060,0,0,0,0,0
441,l1707,20170524,9060,9060,0,0,0,9060,9060,0,0,0,0,0
442,l1707,20170525,9060,9060,0,0,0,9060,9060,0,0,0,0,0
443,l1707,20170526,9060,9060,0,0,0,9060,9060,0,0,0,0,0
444,l1707,20170531,9060,9060,0,0,0,9500,9500,440,440,0,0,0
445,l1707,20170601,9500,9500,0,0,0,9500,9500,0,0,0,0,0
446,l1707,20170602,9500,9500,0,0,0,9500,9500,0,0,0,0,0
447,l1707,20170605,9500,9500,0,0,0,9500,9500,0,0,0,0,0
448,l1707,20170606,9500,9500,0,0,0,9500,9500,0,0,0,0,0
449,l1707,20170607,9500,9500,0,0,0,9500,9500,0,0,0,0,0
450,l1707,20170608,9500,9500,0,0,0,9500,9500,0,0,0,0,0
451,l1707,20170609,9500,9500,0,0,0,9500,9500,0,0,0,0,0
452,l1707,20170612,9500,9500,0,0,0,9500,9500,0,0,0,0,0
453,l1707,20170613,9500,9500,0,0,0,9500,9500,0,0,0,0,0
454,l1707,20170614,9500,9500,0,0,0,9500,9500,0,0,0,0,0
455,l1707,20170615,9500,9500,0,0,0,9500,9500,0,0,0,0,0
456,l1707,20170616,9500,9500,0,0,0,9500,9500,0,0,0,0,0
457,l1707,20170619,9500,9500,9965,9965,9160,9620,9685,120,185,24,1162200,12
458,l1707,20170620,9620,9685,9255,9255,9245,9245,9245,-440,-440,12,554900,0
459,l1707,20170621,9245,9245,8795,9260,8795,9260,9025,15,-220,4,180550,0
460,l1707,20170622,9260,9025,8585,9320,8585,9320,8950,295,-75,4,179050,0
461,l1707,20170623,9320,8950,0,0,0,8950,8950,0,0,0,0,0
462,l1707,20170626,8950,8950,0,0,0,8950,8950,0,0,0,0,0
463,l1707,20170627,8950,8950,0,0,0,8950,8950,0,0,0,0,0
464,l1707,20170628,8950,8950,0,0,0,8950,8950,0,0,0,0,0
465,l1707,20170629,8950,8950,0,0,0,8950,8950,0,0,0,0,0
466,l1707,20170630,8950,8950,0,0,0,8950,8950,0,0,0,0,0
467,l1707,20170703,8950,8950,0,0,0,8950,8950,0,0,0,0,0
468,l1707,20170704,8950,8950,0,0,0,8950,8950,0,0,0,0,0
469,l1707,20170705,8950,8950,0,0,0,8950,8950,0,0,0,0,0
470,l1707,20170706,8950,8950,0,0,0,8950,8950,0,0,0,0,0
471,l1707,20170707,8950,8950,0,0,0,8950,8950,0,0,0,0,0
472,l1707,20170710,8950,8950,0,0,0,8950,8950,0,0,0,0,0
473,l1707,20170711,8950,8950,0,0,0,8950,8950,0,0,0,0,0
474,l1707,20170712,8950,8950,0,0,0,8950,8950,0,0,0,0,0
475,l1707,20170713,8950,8950,0,0,0,8950,8950,0,0,0,0,0
476,l1707,20170714,8950,8950,0,0,0,8950,8950,0,0,0,0,0
477,l1708,20170103,9845,9845,0,0,0,9825,9825,-20,-20,0,0,8
478,l1708,20170104,9825,9825,0,0,0,9725,9725,-100,-100,0,0,8
479,l1708,20170105,9725,9725,0,0,0,9725,9725,0,0,0,0,8
480,l1708,20170106,9725,9725,0,0,0,9750,9750,25,25,0,0,8
481,l1708,20170109,9750,9750,0,0,0,9750,9750,0,0,0,0,8
482,l1708,20170110,9750,9750,0,0,0,9750,9750,0,0,0,0,8
483,l1708,20170111,9750,9750,0,0,0,9750,9750,0,0,0,0,8
484,l1708,20170112,9750,9750,0,0,0,9750,9750,0,0,0,0,8
485,l1708,20170113,9750,9750,0,0,0,9870,9870,120,120,0,0,8
486,l1708,20170116,9870,9870,0,0,0,10115,10115,245,245,0,0,8
487,l1708,20170117,10115,10115,0,0,0,10115,10115,0,0,0,0,8
488,l1708,20170118,10115,10115,0,0,0,10115,10115,0,0,0,0,8
489,l1708,20170119,10115,10115,0,0,0,10115,10115,0,0,0,0,8
490,l1708,20170120,10115,10115,0,0,0,10115,10115,0,0,0,0,8
491,l1708,20170123,10115,10115,0,0,0,10115,10115,0,0,0,0,8
492,l1708,20170124,10115,10115,0,0,0,10115,10115,0,0,0,0,8
493,l1708,20170125,10115,10115,0,0,0,10115,10115,0,0,0,0,8
494,l1708,20170126,10115,10115,0,0,0,10100,10100,-15,-15,0,0,8
495,l1708,20170203,10100,10100,0,0,0,10100,10100,0,0,0,0,8
496,l1708,20170206,10100,10100,10250,10250,10250,10250,10250,150,150,2,102500,10
497,l1708,20170207,10250,10250,10290,10290,10290,10290,10290,40,40,2,102900,12
498,l1708,20170208,10290,10290,10235,10335,10235,10335,10280,45,-10,6,308500,16
499,l1708,20170209,10335,10280,0,0,0,10280,10280,0,0,0,0,16
500,l1708,20170210,10280,10280,10265,10265,10240,10245,10255,-35,-25,10,512800,14
501,l1708,20170213,10245,10255,10495,10495,10495,10495,10495,240,240,2,104950,12
502,l1708,20170214,10495,10495,0,0,0,10495,10495,0,0,0,0,12
503,l1708,20170215,10495,10495,0,0,0,10365,10365,-130,-130,0,0,12
504,l1708,20170216,10365,10365,10170,10170,10170,10170,10170,-195,-195,2,101700,14
505,l1708,20170217,10170,10170,0,0,0,10030,10030,-140,-140,0,0,14
506,l1708,20170220,10030,10030,0,0,0,10030,10030,0,0,0,0,14
507,l1708,20170221,10030,10030,0,0,0,10030,10030,0,0,0,0,14
508,l1708,20170222,10030,10030,0,0,0,10030,10030,0,0,0,0,14
509,l1708,20170223,10030,10030,0,0,0,9895,9895,-135,-135,0,0,14
510,l1708,20170224,9895,9895,0,0,0,9895,9895,0,0,0,0,14
511,l1708,20170227,9895,9895,0,0,0,9895,9895,0,0,0,0,14
512,l1708,20170228,9895,9895,0,0,0,9790,9790,-105,-105,0,0,14
513,l1708,20170301,9790,9790,0,0,0,9790,9790,0,0,0,0,14
514,l1708,20170302,9790,9790,0,0,0,9790,9790,0,0,0,0,14
515,l1708,20170303,9790,9790,0,0,0,9790,9790,0,0,0,0,14
516,l1708,20170306,9790,9790,0,0,0,9790,9790,0,0,0,0,14
517,l1708,20170307,9790,9790,0,0,0,9790,9790,0,0,0,0,14
518,l1708,20170308,9790,9790,0,0,0,9555,9555,-235,-235,0,0,14
519,l1708,20170309,9555,9555,9270,9270,9270,9270,9270,-285,-285,4,185400,10
520,l1708,20170310,9270,9270,0,0,0,9225,9225,-45,-45,0,0,10
521,l1708,20170313,9225,9225,9200,9200,9000,9155,9125,-70,-100,58,2646350,8
522,l1708,20170314,9155,9125,0,0,0,9125,9125,0,0,0,0,8
523,l1708,20170315,9125,9125,0,0,0,9125,9125,0,0,0,0,8
524,l1708,20170316,9125,9125,0,0,0,9165,9165,40,40,0,0,8
525,l1708,20170317,9165,9165,0,0,0,9205,9205,40,40,0,0,8
526,l1708,20170320,9205,9205,0,0,0,9205,9205,0,0,0,0,8
527,l1708,20170321,9205,9205,9295,9535,9295,9535,9415,330,210,8,376600,4
528,l1708,20170322,9535,9415,0,0,0,9415,9415,0,0,0,0,4
529,l1708,20170323,9415,9415,0,0,0,9415,9415,0,0,0,0,4
530,l1708,20170324,9415,9415,9310,9310,9310,9310,9310,-105,-105,2,93100,4
531,l1708,20170327,9310,9310,0,0,0,9065,9065,-245,-245,0,0,4
532,l1708,20170328,9065,9065,0,0,0,9065,9065,0,0,0,0,4
533,l1708,20170329,9065,9065,0,0,0,9065,9065,0,0,0,0,4
534,l1708,20170330,9065,9065,0,0,0,9065,9065,0,0,0,0,4
535,l1708,20170331,9065,9065,9180,9180,9180,9180,9180,115,115,2,91800,4
536,l1708,20170405,9180,9180,9195,9255,8970,9255,9145,75,-35,14,640250,4
537,l1708,20170406,9255,9145,0,0,0,9145,9145,0,0,0,0,4
538,l1708,20170407,9145,9145,0,0,0,9145,9145,0,0,0,0,4
539,l1708,20170410,9145,9145,0,0,0,9145,9145,0,0,0,0,4
540,l1708,20170411,9145,9145,0,0,0,9145,9145,0,0,0,0,4
541,l1708,20170412,9145,9145,0,0,0,9145,9145,0,0,0,0,4
542,l1708,20170413,9145,9145,0,0,0,9145,9145,0,0,0,0,4
543,l1708,20170414,9145,9145,0,0,0,8910,8910,-235,-235,0,0,4
544,l1708,20170417,8910,8910,0,0,0,8910,8910,0,0,0,0,4
545,l1708,20170418,8910,8910,0,0,0,8910,8910,0,0,0,0,4
546,l1708,20170419,8910,8910,8910,8910,8910,8910,8910,0,0,2,89100,6
547,l1708,20170420,8910,8910,8770,8770,8770,8770,8770,-140,-140,2,87700,6
548,l1708,20170421,8770,8770,0,0,0,8770,8770,0,0,0,0,6
549,l1708,20170424,8770,8770,8770,8770,8555,8555,8660,-215,-110,4,173250,6
550,l1708,20170425,8555,8660,0,0,0,8495,8495,-165,-165,0,0,6
551,l1708,20170426,8495,8495,0,0,0,8630,8630,135,135,0,0,6
552,l1708,20170427,8630,8630,0,0,0,8630,8630,0,0,0,0,6
553,l1708,20170428,8630,8630,0,0,0,8765,8765,135,135,0,0,6
554,l1708,20170502,8765,8765,0,0,0,8765,8765,0,0,0,0,6
555,l1708,20170503,8765,8765,0,0,0,8765,8765,0,0,0,0,6
556,l1708,20170504,8765,8765,0,0,0,8765,8765,0,0,0,0,6
557,l1708,20170505,8765,8765,0,0,0,8765,8765,0,0,0,0,6
558,l1708,20170508,8765,8765,0,0,0,8765,8765,0,0,0,0,6
559,l1708,20170509,8765,8765,0,0,0,8765,8765,0,0,0,0,6
560,l1708,20170510,8765,8765,0,0,0,8765,8765,0,0,0,0,6
561,l1708,20170511,8765,8765,0,0,0,8765,8765,0,0,0,0,6
562,l1708,20170512,8765,8765,0,0,0,8765,8765,0,0,0,0,6
563,l1708,20170515,8765,8765,0,0,0,8905,8905,140,140,0,0,6
564,l1708,20170516,8905,8905,0,0,0,8910,8910,5,5,0,0,6
565,l1708,20170517,8910,8910,0,0,0,8910,8910,0,0,0,0,6
566,l1708,20170518,8910,8910,0,0,0,8910,8910,0,0,0,0,6
567,l1708,20170519,8910,8910,0,0,0,8910,8910,0,0,0,0,6
568,l1708,20170522,8910,8910,9205,9300,9205,9300,9255,390,345,8,370250,6
569,l1708,20170523,9300,9255,0,0,0,9255,9255,0,0,0,0,6
570,l1708,20170524,9255,9255,0,0,0,9255,9255,0,0,0,0,6
571,l1708,20170525,9255,9255,9390,9390,9060,9060,9225,-195,-30,8,369000,10
572,l1708,20170526,9060,9225,0,0,0,9225,9225,0,0,0,0,10
573,l1708,20170531,9225,9225,0,0,0,9670,9670,445,445,0,0,10
574,l1708,20170601,9670,9670,0,0,0,9670,9670,0,0,0,0,10
575,l1708,20170602,9670,9670,0,0,0,9190,9190,-480,-480,0,0,10
576,l1708,20170605,9190,9190,0,0,0,9145,9145,-45,-45,0,0,10
577,l1708,20170606,9145,9145,0,0,0,9135,9135,-10,-10,0,0,10
578,l1708,20170607,9135,9135,0,0,0,9135,9135,0,0,0,0,10
579,l1708,20170608,9135,9135,0,0,0,9135,9135,0,0,0,0,10
580,l1708,20170609,9135,9135,9045,9045,8950,8955,8990,-180,-145,74,3327800,0
581,l1708,20170612,8955,8990,0,0,0,8990,8990,0,0,0,0,0
582,l1708,20170613,8990,8990,0,0,0,8990,8990,0,0,0,0,0
583,l1708,20170614,8990,8990,0,0,0,8990,8990,0,0,0,0,0
584,l1708,20170615,8990,8990,0,0,0,8990,8990,0,0,0,0,0
585,l1708,20170616,8990,8990,0,0,0,8990,8990,0,0,0,0,0
586,l1708,20170619,8990,8990,0,0,0,8990,8990,0,0,0,0,0
587,l1708,20170620,8990,8990,0,0,0,8990,8990,0,0,0,0,0
588,l1708,20170621,8990,8990,0,0,0,8780,8780,-210,-210,0,0,0
589,l1708,20170622,8780,8780,0,0,0,8710,8710,-70,-70,0,0,0
590,l1708,20170623,8710,8710,0,0,0,8710,8710,0,0,0,0,0
591,l1708,20170626,8710,8710,0,0,0,8710,8710,0,0,0,0,0
592,l1708,20170627,8710,8710,0,0,0,8710,8710,0,0,0,0,0
593,l1708,20170628,8710,8710,8930,8930,8670,8870,8820,160,110,6,264700,0
594,l1708,20170629,8870,8820,0,0,0,8820,8820,0,0,0,0,0
595,l1708,20170630,8820,8820,0,0,0,8820,8820,0,0,0,0,0
596,l1708,20170703,8820,8820,0,0,0,8820,8820,0,0,0,0,0
597,l1708,20170704,8820,8820,0,0,0,8820,8820,0,0,0,0,0
598,l1708,20170705,8820,8820,0,0,0,8820,8820,0,0,0,0,0
599,l1708,20170706,8820,8820,0,0,0,8820,8820,0,0,0,0,0
600,l1708,20170707,8820,8820,0,0,0,8820,8820,0,0,0,0,0
601,l1708,20170710,8820,8820,0,0,0,8820,8820,0,0,0,0,0
602,l1708,20170711,8820,8820,0,0,0,8820,8820,0,0,0,0,0
603,l1708,20170712,8820,8820,0,0,0,8820,8820,0,0,0,0,0
604,l1708,20170713,8820,8820,8890,9070,8890,9070,8980,250,160,4,179600,0
605,l1708,20170714,9070,8980,0,0,0,8980,8980,0,0,0,0,0
606,l1708,20170717,8980,8980,0,0,0,8980,8980,0,0,0,0,0
607,l1708,20170718,8980,8980,0,0,0,8980,8980,0,0,0,0,0
608,l1708,20170719,8980,8980,8980,9285,8980,9285,9130,305,150,4,182650,0
609,l1708,20170720,9285,9130,0,0,0,9130,9130,0,0,0,0,0
610,l1708,20170721,9130,9130,0,0,0,9130,9130,0,0,0,0,0
611,l1708,20170724,9130,9130,0,0,0,9130,9130,0,0,0,0,0
612,l1708,20170725,9130,9130,0,0,0,9130,9130,0,0,0,0,0
613,l1708,20170726,9130,9130,0,0,0,9130,9130,0,0,0,0,0
614,l1708,20170727,9130,9130,0,0,0,9130,9130,0,0,0,0,0
615,l1708,20170728,9130,9130,0,0,0,9130,9130,0,0,0,0,0
616,l1708,20170731,9130,9130,0,0,0,9130,9130,0,0,0,0,0
617,l1708,20170801,9130,9130,0,0,0,9130,9130,0,0,0,0,0
618,l1708,20170802,9130,9130,0,0,0,9130,9130,0,0,0,0,0
619,l1708,20170803,9130,9130,0,0,0,9130,9130,0,0,0,0,0
620,l1708,20170804,9130,9130,0,0,0,9130,9130,0,0,0,0,0
621,l1708,20170807,9130,9130,0,0,0,9130,9130,0,0,0,0,0
622,l1708,20170808,9130,9130,0,0,0,9130,9130,0,0,0,0,0
623,l1708,20170809,9130,9130,0,0,0,9130,9130,0,0,0,0,0
624,l1708,20170810,9130,9130,0,0,0,9130,9130,0,0,0,0,0
625,l1708,20170811,9130,9130,0,0,0,9130,9130,0,0,0,0,0
626,l1708,20170814,9130,9130,0,0,0,9130,9130,0,0,0,0,0
627,l1709,20170103,9720,9765,9740,9770,9550,9555,9650,-210,-115,19906,960667350,32378
628,l1709,20170104,9555,9650,9530,9610,9470,9495,9525,-155,-125,25246,1202352950,34256
629,l1709,20170105,9495,9525,9525,9565,9450,9505,9505,-20,-20,15356,729797350,34946
630,l1709,20170106,9505,9505,9525,9685,9360,9365,9550,-140,45,24596,1174834100,35728
631,l1709,20170109,9365,9550,9375,9570,9340,9570,9465,20,-85,16136,763814050,34812
632,l1709,20170110,9570,9465,9545,9650,9460,9650,9530,185,65,20478,975968200,33760
633,l1709,20170111,9650,9530,9635,9705,9555,9610,9615,80,85,24404,1173700600,38116
634,l1709,20170112,9610,9615,9645,9785,9575,9645,9675,30,60,18470,893710850,37604
635,l1709,20170113,9645,9675,9675,9900,9645,9895,9760,220,85,18204,888603600,35354
636,l1709,20170116,9895,9760,9965,10090,9915,10060,10010,300,250,21046,1053409600,33364
637,l1709,20170117,10060,10010,10055,10125,9920,9960,10015,-50,5,24266,1215616600,36562
638,l1709,20170118,9960,10015,9975,10085,9920,10045,10015,30,0,16956,849104950,35548
639,l1709,20170119,10045,10015,10015,10035,9900,9985,9955,-30,-60,14336,713859750,36056
640,l1709,20170120,9985,9955,9980,10190,9950,10095,10065,140,110,20826,1048431900,34448
641,l1709,20170123,10095,10065,10130,10265,10095,10165,10185,100,120,16464,838737700,36514
642,l1709,20170124,10165,10185,10170,10220,10025,10105,10120,-80,-65,12968,656328000,36854
643,l1709,20170125,10105,10120,10115,10270,10080,10250,10180,130,60,10712,545455200,35690
644,l1709,20170126,10250,10180,10255,10310,10120,10155,10180,-25,0,12782,650876450,36230
645,l1709,20170203,10155,10180,10205,10270,10060,10110,10170,-70,-10,12636,642759050,35884
646,l1709,20170206,10110,10170,10185,10320,10070,10300,10225,130,55,22002,1125162300,42804
647,l1709,20170207,10300,10225,10225,10425,10225,10280,10340,55,115,28496,1473738950,47280
648,l1709,20170208,10280,10340,10260,10380,10210,10285,10310,-55,-30,29812,1536903950,48862
649,l1709,20170209,10285,10310,10310,10405,10290,10320,10345,10,35,24332,1259179850,53208
650,l1709,20170210,10320,10345,10330,10370,10205,10335,10300,-10,-45,26082,1343417650,54944
651,l1709,20170213,10335,10300,10380,10670,10380,10660,10560,360,260,46578,2459790400,65064
652,l1709,20170214,10660,10560,10615,10660,10550,10640,10605,80,45,22816,1210327350,66946
653,l1709,20170215,10640,10605,10570,10590,10185,10225,10460,-380,-145,41254,2157944800,64612
654,l1709,20170216,10225,10460,10250,10345,10050,10055,10230,-405,-230,51412,2629911350,64428
655,l1709,20170217,10055,10230,10130,10175,9980,10000,10070,-230,-160,32780,1650783000,61350
656,l1709,20170220,10000,10070,10000,10130,9990,10045,10065,-25,-5,28408,1429928250,62302
657,l1709,20170221,10045,10065,10065,10125,9895,9935,10000,-130,-65,34142,1707678950,62118
658,l1709,20170222,9935,10000,9920,10035,9900,9960,9970,-40,-30,23612,1177234600,61940
659,l1709,20170223,9960,9970,9970,10015,9720,9770,9860,-200,-110,41654,2054376150,64694
660,l1709,20170224,9770,9860,9700,9855,9700,9795,9795,-65,-65,34434,1687073450,65684
661,l1709,20170227,9795,9795,9845,9935,9815,9820,9865,25,70,37842,1867148400,66698
662,l1709,20170228,9820,9865,9800,9900,9670,9750,9775,-115,-90,35818,1750976900,65416
663,l1709,20170301,9750,9775,9780,9820,9670,9705,9750,-70,-25,33494,1633085200,67188
664,l1709,20170302,9705,9750,9735,9765,9675,9750,9720,0,-30,29884,1452746500,65972
665,l1709,20170303,9750,9720,9705,9830,9635,9785,9760,65,40,44822,2187738050,73456
666,l1709,20170306,9785,9760,9780,9905,9780,9850,9855,90,95,37606,1853176550,70446
667,l1709,20170307,9850,9855,9860,9890,9745,9790,9795,-65,-60,33152,1624324050,75458
668,l1709,20170308,9790,9795,9730,9730,9405,9415,9525,-380,-270,65720,3131459200,83958
669,l1709,20170309,9415,9525,9345,9375,9225,9320,9320,-205,-205,52574,2450151650,82954
670,l1709,20170310,9320,9320,9330,9360,9135,9140,9245,-180,-75,43020,1989303450,87410
671,l1709,20170313,9140,9245,9040,9235,9040,9225,9120,-20,-125,56572,2579989050,84140
672,l1709,20170314,9225,9120,9230,9325,9200,9235,9265,115,145,57302,2654600400,85370
673,l1709,20170315,9235,9265,9305,9385,9270,9305,9335,40,70,46220,2158043250,86906
674,l1709,20170316,9305,9335,9360,9430,9320,9415,9380,80,45,63866,2996329800,93114
675,l1709,20170317,9415,9380,9400,9465,9390,9445,9425,65,45,49120,2315731850,95308
676,l1709,20170320,9445,9425,9450,9490,9315,9480,9375,55,-50,60006,2813808250,98064
677,l1709,20170321,9480,9375,9455,9500,9405,9415,9450,40,75,73728,3484937350,100458
678,l1709,20170322,9415,9450,9365,9375,9230,9260,9270,-190,-180,81774,3791581100,112916
679,l1709,20170323,9260,9270,9350,9390,9265,9265,9330,-5,60,80470,3755147750,121634
680,l1709,20170324,9265,9330,9285,9340,9175,9180,9265,-150,-65,111674,5174114200,137046
681,l1709,20170327,9180,9265,9120,9145,8885,9030,9015,-235,-250,146330,6596101700,162514
682,l1709,20170328,9030,9015,9090,9135,9010,9045,9065,30,50,112576,5103805400,167296
683,l1709,20170329,9045,9065,9120,9250,9120,9210,9185,145,120,138080,6342954550,154966
684,l1709,20170330,9210,9185,9280,9295,9105,9130,9175,-55,-10,112262,5152304600,166450
685,l1709,20170331,9130,9175,9200,9240,9025,9060,9150,-115,-25,139532,6385137750,173812
686,l1709,20170405,9060,9150,9085,9395,9075,9360,9250,210,100,219176,10137830700,172258
687,l1709,20170406,9360,9250,9345,9485,9310,9480,9395,230,145,239668,11262231400,223428
688,l1709,20170407,9480,9395,9380,9570,9310,9370,9430,-25,35,540022,25470835700,269732
689,l1709,20170410,9370,9430,9430,9465,9135,9140,9295,-290,-135,576324,26793460750,317040
690,l1709,20170411,9140,9295,9170,9210,9125,9160,9160,-135,-135,395228,18108518650,321480
691,l1709,20170412,9160,9160,9170,9245,9055,9075,9125,-85,-35,579694,26457142800,347882
692,l1709,20170413,9075,9125,9065,9170,9005,9040,9090,-85,-35,462646,21033134000,337672
693,l1709,20170414,9040,9090,9060,9105,8740,8840,8895,-250,-195,778964,34650087050,406584
694,l1709,20170417,8840,8895,8880,8935,8770,8805,8850,-90,-45,385900,17076425950,404496
695,l1709,20170418,8805,8850,8810,8880,8700,8820,8800,-30,-50,515812,22696324050,407630
696,l1709,20170419,8820,8800,8780,8835,8675,8785,8760,-15,-40,517110,22649663200,416112
697,l1709,20170420,8785,8760,8740,8875,8655,8830,8750,70,-10,663926,29060296450,404456
698,l1709,20170421,8830,8750,8845,8900,8715,8745,8820,-5,70,494366,21806055850,399360
699,l1709,20170424,8745,8820,8750,8750,8525,8640,8610,-180,-210,577426,24861227400,416868
700,l1709,20170425,8640,8610,8640,8695,8570,8580,8625,-30,15,402374,17352533900,431100
701,l1709,20170426,8580,8625,8595,8735,8550,8635,8645,10,20,469784,20315543450,408618
702,l1709,20170427,8635,8645,8655,8700,8620,8680,8655,35,10,341594,14790420250,416608
703,l1709,20170428,8680,8655,8720,8900,8715,8880,8825,225,170,523468,23109745400,385734
704,l1709,20170502,8880,8825,8865,8920,8780,8880,8865,55,40,333184,14770391050,378104
705,l1709,20170503,8880,8865,8855,8930,8795,8840,8865,-25,0,415754,18428809950,387392
706,l1709,20170504,8840,8865,8685,8775,8605,8755,8700,-110,-165,614526,26732463550,398342
707,l1709,20170505,8755,8700,8695,8765,8650,8705,8705,5,5,501596,21832574900,389422
708,l1709,20170508,8705,8705,8835,8895,8720,8735,8815,30,110,507678,22376201800,399014
709,l1709,20170509,8735,8815,8755,8780,8700,8740,8735,-75,-80,283060,12366542600,401044
710,l1709,20170510,8740,8735,8775,8775,8535,8645,8630,-90,-105,619286,26727295100,408452
711,l1709,20170511,8645,8630,8665,8795,8610,8795,8700,165,70,451914,19663173500,389336
712,l1709,20170512,8795,8700,8760,8840,8720,8810,8790,110,90,465566,20462757500,404414
713,l1709,20170515,8810,8790,8850,9060,8815,9060,8930,270,140,699816,31254642300,478048
714,l1709,20170516,9060,8930,9060,9155,8995,9150,9065,220,135,521186,23626720150,484092
715,l1709,20170517,9150,9065,9110,9175,9075,9115,9115,50,50,523658,23873172800,461694
716,l1709,20170518,9115,9115,9070,9230,9045,9205,9135,90,20,511532,23372236550,488494
717,l1709,20170519,9205,9135,9300,9425,9240,9350,9325,215,190,572054,26675347800,458424
718,l1709,20170522,9350,9325,9390,9420,9235,9295,9310,-30,-15,467626,21770397100,432954
719,l1709,20170523,9295,9310,9325,9365,9250,9275,9300,-35,-10,364062,16933597900,432006
720,l1709,20170524,9275,9300,9330,9330,9100,9205,9200,-95,-100,537906,24752569250,406688
721,l1709,20170525,9205,9200,9205,9340,9170,9190,9230,-10,30,454686,20995091100,400208
722,l1709,20170526,9190,9230,9100,9155,9045,9130,9105,-100,-125,430900,19626402750,387540
723,l1709,20170531,9130,9105,9150,9235,8980,9000,9140,-105,35,634398,28994272400,379688
724,l1709,20170601,9000,9140,9040,9275,9005,9220,9140,80,0,627782,28692266350,411280
725,l1709,20170602,9220,9140,9195,9210,8905,8930,9045,-210,-95,730692,33058363950,398122
726,l1709,20170605,8930,9045,8955,8990,8870,8900,8930,-145,-115,492108,21974226850,422958
727,l1709,20170606,8900,8930,8930,8955,8850,8895,8900,-35,-30,477104,21240761950,425258
728,l1709,20170607,8895,8900,8900,8960,8820,8860,8870,-40,-30,435562,19320632750,446972
729,l1709,20170608,8860,8870,8805,9000,8780,8915,8885,45,15,504234,22409305950,430522
730,l1709,20170609,8915,8885,8920,8985,8875,8930,8930,45,45,303974,13580025700,431668
731,l1709,20170612,8930,8930,8960,9170,8960,9135,9095,205,165,466676,21224365700,437058
732,l1709,20170613,9135,9095,9130,9165,8905,8930,9090,-165,-5,460360,20927950600,425312
733,l1709,20170614,8930,9090,8955,9065,8870,8925,8955,-165,-135,550678,24666117650,412192
734,l1709,20170615,8925,8955,8880,8935,8820,8835,8870,-120,-85,463508,20565347750,426900
735,l1709,20170616,8835,8870,8855,8930,8795,8840,8860,-30,-10,441252,19552477150,438224
736,l1709,20170619,8840,8860,8855,8990,8825,8910,8910,50,50,481022,21433002200,440090
737,l1709,20170620,8910,8910,8910,8955,8830,8890,8895,-20,-15,391512,17417823800,430718
738,l1709,20170621,8890,8895,8835,8940,8785,8840,8845,-55,-50,430386,19034500000,436588
739,l1709,20170622,8840,8845,8860,8885,8660,8690,8770,-155,-75,551948,24207006900,459842
740,l1709,20170623,8690,8770,8710,8755,8675,8730,8710,-40,-60,289682,12621785900,440766
741,l1709,20170626,8730,8710,8755,8840,8735,8820,8790,110,80,326780,14366232800,410940
742,l1709,20170627,8820,8790,8800,8920,8800,8880,8860,90,70,336906,14932665850,395378
743,l1709,20170628,8880,8860,8910,8960,8780,8830,8845,-30,-15,364390,16119502600,404050
744,l1709,20170629,8830,8845,8885,9070,8855,8975,8960,130,115,563122,25230105350,400136
745,l1709,20170630,8975,8960,8970,9045,8915,9025,8985,65,25,313526,14088279000,402232
746,l1709,20170703,9025,8985,9065,9125,8995,9030,9055,45,70,338346,15327057400,413588
747,l1709,20170704,9030,9055,9025,9025,8790,8820,8865,-235,-190,520642,23087402600,413188
748,l1709,20170705,8820,8865,8845,8915,8805,8825,8860,-40,-5,333882,14793526850,413158
749,l1709,20170706,8825,8860,8805,8960,8790,8955,8870,95,10,359488,15949737950,392190
750,l1709,20170707,8955,8870,8930,9045,8915,9015,8990,145,120,472638,21248552000,391896
751,l1709,20170710,9015,8990,9005,9105,8845,8860,8965,-130,-25,545904,24481151100,408312
752,l1709,20170711,8860,8965,8915,9025,8855,9005,8945,40,-20,535442,23959204100,403472
753,l1709,20170712,9005,8945,9035,9165,9015,9075,9085,130,140,658162,29905646100,408342
754,l1709,20170713,9075,9085,9055,9265,9025,9135,9150,50,65,648510,29675073250,427080
755,l1709,20170714,9135,9150,9155,9200,9105,9160,9150,10,0,421188,19273573500,412114
756,l1709,20170717,9160,9150,9195,9290,9155,9165,9215,15,65,514016,23692544300,409972
757,l1709,20170718,9165,9215,9180,9270,9165,9220,9215,5,0,364950,16817685350,413922
758,l1709,20170719,9220,9215,9190,9305,9190,9250,9265,35,50,404210,18733482000,396368
759,l1709,20170720,9250,9265,9295,9725,9295,9650,9545,385,280,1088292,51949446950,381646
760,l1709,20170721,9650,9545,9580,9685,9475,9660,9555,115,10,665868,31826993150,359462
761,l1709,20170724,9660,9555,9570,9755,9545,9640,9655,85,100,556912,26886665700,359574
762,l1709,20170725,9640,9655,9665,9725,9565,9630,9645,-25,-10,383720,18512514700,339518
763,l1709,20170726,9630,9645,9700,9745,9470,9540,9610,-105,-35,472246,22701523800,320284
764,l1709,20170727,9540,9610,9575,9580,9450,9550,9515,-60,-95,283278,13483970300,307752
765,l1709,20170728,9550,9515,9555,9565,9365,9400,9440,-115,-75,345918,16331091700,280918
766,l1709,20170731,9400,9440,9440,9480,9340,9420,9420,-20,-20,369898,17426519950,271862
767,l1709,20170801,9420,9420,9450,9670,9405,9500,9560,80,140,398528,19051183350,262332
768,l1709,20170802,9500,9560,9470,9560,9425,9485,9490,-75,-70,212716,10097165200,254906
769,l1709,20170803,9485,9490,9500,9545,9365,9395,9445,-95,-45,143646,6785550100,226692
770,l1709,20170804,9395,9445,9400,9590,9400,9520,9505,75,60,108030,5135411950,210248
771,l1709,20170807,9520,9505,9560,9640,9400,9425,9455,-80,-50,104244,4928878600,190130
772,l1709,20170808,9425,9455,9450,9600,9440,9575,9520,120,65,92172,4388756350,170396
773,l1709,20170809,9575,9520,9600,9710,9535,9605,9625,85,105,83626,4024518100,152408
774,l1709,20170810,9605,9625,9580,9685,9565,9625,9610,0,-15,58154,2794805000,147562
775,l1709,20170811,9625,9610,9610,9610,9360,9400,9475,-210,-135,81494,3862081050,120226
776,l1709,20170814,9400,9475,9425,9455,9350,9395,9405,-80,-70,29740,1398977700,117140
777,l1709,20170815,9395,9405,9370,9370,9210,9320,9290,-85,-115,55970,2600525900,98464
778,l1709,20170816,9320,9290,9300,9355,9260,9315,9325,25,35,25116,1171538150,90896
779,l1709,20170817,9315,9325,9430,9545,9425,9490,9480,165,155,39340,1865695550,79670
780,l1709,20170818,9490,9480,9480,9535,9460,9530,9510,50,30,24030,1142792100,74306
781,l1709,20170821,9530,9510,9585,9645,9560,9600,9605,90,95,24482,1176038150,65008
782,l1709,20170822,9600,9605,9570,9840,9500,9820,9700,215,95,35442,1719219550,52760
783,l1709,20170823,9820,9700,9760,9795,9680,9690,9735,-10,35,16386,797774200,48256
784,l1709,20170824,9690,9735,9750,9790,9675,9680,9725,-55,-10,13274,645652450,42522
785,l1709,20170825,9680,9725,9690,9845,9680,9680,9800,-45,75,8046,394331300,39764
786,l1709,20170828,9680,9800,9630,9705,9580,9700,9665,-100,-135,11108,536812100,33224
787,l1709,20170829,9700,9665,9665,9825,9665,9785,9760,120,95,5226,255109600,30976
788,l1709,20170830,9785,9760,9760,9805,9730,9770,9765,10,5,4376,213675950,28048
789,l1709,20170831,9770,9765,9760,9965,9695,9900,9825,135,60,9758,479546650,24546
790,l1709,20170901,9900,9825,9825,10070,9825,10065,9950,240,125,2636,131179750,22176
791,l1709,20170904,10065,9950,10230,10230,10095,10100,10115,150,165,1586,80245350,21000
792,l1709,20170905,10100,10115,10120,10175,10055,10150,10140,35,25,1914,97047350,20386
793,l1709,20170906,10150,10140,10140,10140,9970,9970,10075,-170,-65,1592,80202500,19562
794,l1709,20170907,9970,10075,10000,10015,9835,9835,9945,-240,-130,782,38896450,19384
795,l1709,20170908,9835,9945,9865,9900,9730,9730,9840,-215,-105,528,25989450,19216
796,l1709,20170911,9730,9840,9730,9760,9650,9715,9705,-125,-135,1172,56878900,19056
797,l1709,20170912,9715,9705,9705,9900,9705,9860,9755,155,50,2344,114371300,18908
798,l1709,20170913,9860,9755,9885,9900,9630,9630,9855,-125,100,1252,61715350,17938
799,l1709,20170914,9630,9855,9650,9665,9550,9615,9930,-240,75,880,42642100,0
800,l1710,20170103,9780,9780,0,0,0,9665,9665,-115,-115,0,0,2
801,l1710,20170104,9665,9665,0,0,0,9665,9665,0,0,0,0,2
802,l1710,20170105,9665,9665,0,0,0,9665,9665,0,0,0,0,2
803,l1710,20170106,9665,9665,0,0,0,9710,9710,45,45,0,0,2
804,l1710,20170109,9710,9710,0,0,0,9710,9710,0,0,0,0,2
805,l1710,20170110,9710,9710,0,0,0,9710,9710,0,0,0,0,2
806,l1710,20170111,9710,9710,0,0,0,9710,9710,0,0,0,0,2
807,l1710,20170112,9710,9710,0,0,0,9710,9710,0,0,0,0,2
808,l1710,20170113,9710,9710,0,0,0,9795,9795,85,85,0,0,2
809,l1710,20170116,9795,9795,0,0,0,10045,10045,250,250,0,0,2
810,l1710,20170117,10045,10045,0,0,0,10045,10045,0,0,0,0,2
811,l1710,20170118,10045,10045,0,0,0,10045,10045,0,0,0,0,2
812,l1710,20170119,10045,10045,0,0,0,10045,10045,0,0,0,0,2
813,l1710,20170120,10045,10045,0,0,0,10045,10045,0,0,0,0,2
814,l1710,20170123,10045,10045,0,0,0,10045,10045,0,0,0,0,2
815,l1710,20170124,10045,10045,0,0,0,10045,10045,0,0,0,0,2
816,l1710,20170125,10045,10045,0,0,0,10045,10045,0,0,0,0,2
817,l1710,20170126,10045,10045,0,0,0,10045,10045,0,0,0,0,2
818,l1710,20170203,10045,10045,0,0,0,10045,10045,0,0,0,0,2
819,l1710,20170206,10045,10045,0,0,0,10095,10095,50,50,0,0,2
820,l1710,20170207,10095,10095,0,0,0,10095,10095,0,0,0,0,2
821,l1710,20170208,10095,10095,0,0,0,10095,10095,0,0,0,0,2
822,l1710,20170209,10095,10095,0,0,0,10095,10095,0,0,0,0,2
823,l1710,20170210,10095,10095,0,0,0,10055,10055,-40,-40,0,0,2
824,l1710,20170213,10055,10055,0,0,0,10305,10305,250,250,0,0,2
825,l1710,20170214,10305,10305,0,0,0,10345,10345,40,40,0,0,2
826,l1710,20170215,10345,10345,0,0,0,10205,10205,-140,-140,0,0,2
827,l1710,20170216,10205,10205,0,0,0,10205,10205,0,0,0,0,2
828,l1710,20170217,10205,10205,0,0,0,10050,10050,-155,-155,0,0,2
829,l1710,20170220,10050,10050,0,0,0,10050,10050,0,0,0,0,2
830,l1710,20170221,10050,10050,0,0,0,10050,10050,0,0,0,0,2
831,l1710,20170222,10050,10050,0,0,0,10050,10050,0,0,0,0,2
832,l1710,20170223,10050,10050,0,0,0,9940,9940,-110,-110,0,0,2
833,l1710,20170224,9940,9940,0,0,0,9940,9940,0,0,0,0,2
834,l1710,20170227,9940,9940,0,0,0,9940,9940,0,0,0,0,2
835,l1710,20170228,9940,9940,0,0,0,9850,9850,-90,-90,0,0,2
836,l1710,20170301,9850,9850,9740,9740,9740,9740,9740,-110,-110,2,97400,4
837,l1710,20170302,9740,9740,9775,9775,9665,9665,9730,-75,-10,16,778500,6
838,l1710,20170303,9665,9730,0,0,0,9730,9730,0,0,0,0,6
839,l1710,20170306,9730,9730,0,0,0,9790,9790,60,60,0,0,6
840,l1710,20170307,9790,9790,0,0,0,9790,9790,0,0,0,0,6
841,l1710,20170308,9790,9790,0,0,0,9525,9525,-265,-265,0,0,6
842,l1710,20170309,9525,9525,9205,9205,9205,9205,9205,-320,-320,2,92050,4
843,l1710,20170310,9205,9205,0,0,0,9205,9205,0,0,0,0,4
844,l1710,20170313,9205,9205,0,0,0,9205,9205,0,0,0,0,4
845,l1710,20170314,9205,9205,0,0,0,9205,9205,0,0,0,0,4
846,l1710,20170315,9205,9205,0,0,0,9205,9205,0,0,0,0,4
847,l1710,20170316,9205,9205,0,0,0,9360,9360,155,155,0,0,4
848,l1710,20170317,9360,9360,9385,9450,9385,9410,9415,50,55,10,470800,4
849,l1710,20170320,9410,9415,0,0,0,9415,9415,0,0,0,0,4
850,l1710,20170321,9415,9415,0,0,0,9415,9415,0,0,0,0,4
851,l1710,20170322,9415,9415,9300,9300,9255,9255,9285,-160,-130,6,278550,4
852,l1710,20170323,9255,9285,0,0,0,9285,9285,0,0,0,0,4
853,l1710,20170324,9285,9285,9120,9280,9120,9280,9200,-5,-85,4,184000,4
854,l1710,20170327,9280,9200,0,0,0,8955,8955,-245,-245,0,0,4
855,l1710,20170328,8955,8955,9015,9015,9015,9015,9015,60,60,2,90150,4
856,l1710,20170329,9015,9015,9215,9215,9215,9215,9215,200,200,6,276450,6
857,l1710,20170330,9215,9215,8995,9100,8995,9100,9045,-115,-170,4,180950,4
858,l1710,20170331,9100,9045,0,0,0,9045,9045,0,0,0,0,4
859,l1710,20170405,9045,9045,0,0,0,9300,9300,255,255,0,0,4
860,l1710,20170406,9300,9300,0,0,0,9400,9400,100,100,0,0,4
861,l1710,20170407,9400,9400,9655,9655,9305,9305,9480,-95,80,8,379200,4
862,l1710,20170410,9305,9480,0,0,0,9345,9345,-135,-135,0,0,4
863,l1710,20170411,9345,9345,0,0,0,9345,9345,0,0,0,0,4
864,l1710,20170412,9345,9345,0,0,0,9345,9345,0,0,0,0,4
865,l1710,20170413,9345,9345,9060,9065,9010,9065,9045,-280,-300,6,271350,8
866,l1710,20170414,9065,9045,9010,9010,9010,9010,9010,-35,-35,6,270300,6
867,l1710,20170417,9010,9010,0,0,0,9010,9010,0,0,0,0,6
868,l1710,20170418,9010,9010,0,0,0,9010,9010,0,0,0,0,6
869,l1710,20170419,9010,9010,8560,8855,8560,8715,8710,-295,-300,6,261300,6
870,l1710,20170420,8715,8710,0,0,0,8710,8710,0,0,0,0,6
871,l1710,20170421,8710,8710,0,0,0,8710,8710,0,0,0,0,6
872,l1710,20170424,8710,8710,0,0,0,8710,8710,0,0,0,0,6
873,l1710,20170425,8710,8710,0,0,0,8725,8725,15,15,0,0,6
874,l1710,20170426,8725,8725,0,0,0,8725,8725,0,0,0,0,6
875,l1710,20170427,8725,8725,8680,8680,8680,8680,8680,-45,-45,2,86800,8
876,l1710,20170428,8680,8680,8845,8845,8845,8845,8845,165,165,2,88450,6
877,l1710,20170502,8845,8845,8905,8905,8905,8905,8905,60,60,2,89050,4
878,l1710,20170503,8905,8905,0,0,0,8905,8905,0,0,0,0,4
879,l1710,20170504,8905,8905,8805,8805,8805,8805,8805,-100,-100,2,88050,6
880,l1710,20170505,8805,8805,8585,8585,8585,8585,8585,-220,-220,2,85850,4
881,l1710,20170508,8585,8585,8710,8820,8710,8820,8730,235,145,10,436600,6
882,l1710,20170509,8820,8730,0,0,0,8730,8730,0,0,0,0,6
883,l1710,20170510,8730,8730,8850,8850,8590,8590,8720,-140,-10,6,261700,6
884,l1710,20170511,8590,8720,0,0,0,8720,8720,0,0,0,0,6
885,l1710,20170512,8720,8720,0,0,0,8750,8750,30,30,0,0,6
886,l1710,20170515,8750,8750,0,0,0,8885,8885,135,135,0,0,6
887,l1710,20170516,8885,8885,0,0,0,9070,9070,185,185,0,0,6
888,l1710,20170517,9070,9070,0,0,0,9070,9070,0,0,0,0,6
889,l1710,20170518,9070,9070,9240,9240,9240,9240,9240,170,170,2,92400,8
890,l1710,20170519,9240,9240,9205,9205,9205,9205,9205,-35,-35,2,92050,6
891,l1710,20170522,9205,9205,9435,9435,9185,9185,9310,-20,105,4,186200,6
892,l1710,20170523,9185,9310,0,0,0,9310,9310,0,0,0,0,6
893,l1710,20170524,9310,9310,9150,9150,9150,9150,9150,-160,-160,20,915000,24
894,l1710,20170525,9150,9150,9215,9325,9090,9090,9210,-60,60,6,276300,22
895,l1710,20170526,9090,9210,9080,9150,8960,9150,9060,-60,-150,22,996650,8
896,l1710,20170531,9150,9060,9040,9040,9040,9040,9040,-20,-20,4,180800,8
897,l1710,20170601,9040,9040,0,0,0,9160,9160,120,120,0,0,8
898,l1710,20170602,9160,9160,0,0,0,9160,9160,0,0,0,0,8
899,l1710,20170605,9160,9160,0,0,0,9160,9160,0,0,0,0,8
900,l1710,20170606,9160,9160,0,0,0,9140,9140,-20,-20,0,0,8
901,l1710,20170607,9140,9140,0,0,0,9110,9110,-30,-30,0,0,8
902,l1710,20170608,9110,9110,8925,8925,8925,8925,8925,-185,-185,2,89250,6
903,l1710,20170609,8925,8925,0,0,0,8925,8925,0,0,0,0,6
904,l1710,20170612,8925,8925,9130,9130,9130,9130,9130,205,205,2,91300,6
905,l1710,20170613,9130,9130,8995,8995,8995,8995,8995,-135,-135,2,89950,8
906,l1710,20170614,8995,8995,8995,8995,8995,8995,8995,0,0,2,89950,6
907,l1710,20170615,8995,8995,0,0,0,8995,8995,0,0,0,0,6
908,l1710,20170616,8995,8995,0,0,0,8995,8995,0,0,0,0,6
909,l1710,20170619,8995,8995,0,0,0,8995,8995,0,0,0,0,6
910,l1710,20170620,8995,8995,0,0,0,8995,8995,0,0,0,0,6
911,l1710,20170621,8995,8995,0,0,0,8995,8995,0,0,0,0,6
912,l1710,20170622,8995,8995,0,0,0,8995,8995,0,0,0,0,6
913,l1710,20170623,8995,8995,0,0,0,8995,8995,0,0,0,0,6
914,l1710,20170626,8995,8995,0,0,0,9075,9075,80,80,0,0,6
915,l1710,20170627,9075,9075,0,0,0,9075,9075,0,0,0,0,6
916,l1710,20170628,9075,9075,0,0,0,9075,9075,0,0,0,0,6
917,l1710,20170629,9075,9075,0,0,0,9075,9075,0,0,0,0,6
918,l1710,20170630,9075,9075,0,0,0,9075,9075,0,0,0,0,6
919,l1710,20170703,9075,9075,9150,9155,9060,9060,9105,-15,30,320,14571900,6
920,l1710,20170704,9060,9105,0,0,0,9105,9105,0,0,0,0,6
921,l1710,20170705,9105,9105,8900,8900,8900,8900,8900,-205,-205,2,89000,8
922,l1710,20170706,8900,8900,0,0,0,8900,8900,0,0,0,0,8
923,l1710,20170707,8900,8900,0,0,0,8900,8900,0,0,0,0,8
924,l1710,20170710,8900,8900,0,0,0,8900,8900,0,0,0,0,8
925,l1710,20170711,8900,8900,0,0,0,8900,8900,0,0,0,0,8
926,l1710,20170712,8900,8900,0,0,0,8980,8980,80,80,0,0,8
927,l1710,20170713,8980,8980,0,0,0,9100,9100,120,120,0,0,8
928,l1710,20170714,9100,9100,0,0,0,9100,9100,0,0,0,0,8
929,l1710,20170717,9100,9100,9290,9290,9145,9260,9225,160,125,8,369000,8
930,l1710,20170718,9260,9225,0,0,0,9225,9225,0,0,0,0,8
931,l1710,20170719,9225,9225,9225,9225,9225,9225,9225,0,0,4,184500,4
932,l1710,20170720,9225,9225,9585,9585,9415,9500,9525,275,300,60,2857550,4
933,l1710,20170721,9500,9525,0,0,0,9580,9580,55,55,0,0,4
934,l1710,20170724,9580,9580,9615,9770,9615,9655,9685,75,105,30,1452800,2
935,l1710,20170725,9655,9685,0,0,0,9685,9685,0,0,0,0,2
936,l1710,20170726,9685,9685,9470,9725,9470,9725,9595,40,-90,4,191950,2
937,l1710,20170727,9725,9595,0,0,0,9595,9595,0,0,0,0,2
938,l1710,20170728,9595,9595,0,0,0,9595,9595,0,0,0,0,2
939,l1710,20170731,9595,9595,0,0,0,9595,9595,0,0,0,0,2
940,l1710,20170801,9595,9595,0,0,0,9595,9595,0,0,0,0,2
941,l1710,20170802,9595,9595,9680,9680,9435,9435,9555,-160,-40,8,382250,2
942,l1710,20170803,9435,9555,0,0,0,9555,9555,0,0,0,0,2
943,l1710,20170804,9555,9555,0,0,0,9555,9555,0,0,0,0,2
944,l1710,20170807,9555,9555,9685,9685,9315,9500,9500,-55,-55,12,570000,2
945,l1710,20170808,9500,9500,0,0,0,9530,9530,30,30,0,0,2
946,l1710,20170809,9530,9530,0,0,0,9570,9570,40,40,0,0,2
947,l1710,20170810,9570,9570,0,0,0,9570,9570,0,0,0,0,2
948,l1710,20170811,9570,9570,0,0,0,9440,9440,-130,-130,0,0,2
949,l1710,20170814,9440,9440,0,0,0,9440,9440,0,0,0,0,2
950,l1710,20170815,9440,9440,9405,9405,9050,9380,9280,-60,-160,92,4268800,0
951,l1710,20170816,9380,9280,0,0,0,9280,9280,0,0,0,0,0
952,l1710,20170817,9280,9280,0,0,0,9350,9350,70,70,0,0,0
953,l1710,20170818,9350,9350,0,0,0,9350,9350,0,0,0,0,0
954,l1710,20170821,9350,9350,0,0,0,9440,9440,90,90,0,0,0
955,l1710,20170822,9440,9440,9810,9810,9600,9605,9705,165,265,80,3882900,0
956,l1710,20170823,9605,9705,0,0,0,9705,9705,0,0,0,0,0
957,l1710,20170824,9705,9705,0,0,0,9705,9705,0,0,0,0,0
958,l1710,20170825,9705,9705,0,0,0,9705,9705,0,0,0,0,0
959,l1710,20170828,9705,9705,0,0,0,9705,9705,0,0,0,0,0
960,l1710,20170829,9705,9705,0,0,0,9705,9705,0,0,0,0,0
961,l1710,20170830,9705,9705,0,0,0,9705,9705,0,0,0,0,0
962,l1710,20170831,9705,9705,0,0,0,9705,9705,0,0,0,0,0
963,l1710,20170901,9705,9705,0,0,0,9825,9825,120,120,0,0,0
964,l1710,20170904,9825,9825,0,0,0,9985,9985,160,160,0,0,0
965,l1710,20170905,9985,9985,10480,10480,10480,10480,10480,495,495,20,1048000,20
966,l1710,20170906,10480,10480,10010,10080,10010,10080,10030,-400,-450,30,1505000,8
967,l1710,20170907,10080,10030,10010,10010,10010,10010,10010,-20,-20,6,300300,2
968,l1710,20170908,10010,10010,0,0,0,9905,9905,-105,-105,0,0,2
969,l1710,20170911,9905,9905,0,0,0,9770,9770,-135,-135,0,0,2
970,l1710,20170912,9770,9770,0,0,0,9770,9770,0,0,0,0,2
971,l1710,20170913,9770,9770,0,0,0,9870,9870,100,100,0,0,2
972,l1710,20170914,9870,9870,0,0,0,9945,9945,75,75,0,0,2
973,l1710,20170915,9945,9945,0,0,0,9945,9945,0,0,0,0,2
974,l1710,20170918,9945,9945,0,0,0,9945,9945,0,0,0,0,2
975,l1710,20170919,9945,9945,9765,9765,9450,9450,9585,-495,-360,12,575250,2
976,l1710,20170920,9450,9585,0,0,0,9585,9585,0,0,0,0,2
977,l1710,20170921,9585,9585,0,0,0,9585,9585,0,0,0,0,2
978,l1710,20170922,9585,9585,0,0,0,9585,9585,0,0,0,0,2
979,l1710,20170925,9585,9585,9135,9585,9135,9585,9360,0,-225,4,187200,2
980,l1710,20170926,9585,9360,0,0,0,9360,9360,0,0,0,0,2
981,l1710,20170927,9360,9360,0,0,0,9360,9360,0,0,0,0,2
982,l1710,20170928,9360,9360,0,0,0,9360,9360,0,0,0,0,2
983,l1710,20170929,9360,9360,9700,9700,8705,8705,9200,-655,-160,4,184050,4
984,l1710,20171009,8705,9200,0,0,0,9200,9200,0,0,0,0,4
985,l1710,20171010,9200,9200,0,0,0,9200,9200,0,0,0,0,4
986,l1710,20171011,9200,9200,0,0,0,9200,9200,0,0,0,0,4
987,l1710,20171012,9200,9200,0,0,0,9200,9200,0,0,0,0,4
988,l1710,20171013,9200,9200,9200,9200,9200,9200,9200,0,0,2,92000,2
989,l1710,20171016,9200,9200,0,0,0,9200,9200,0,0,0,0,2
990,l1710,20171017,9200,9200,0,0,0,9200,9200,0,0,0,0,2
991,l1710,20171018,9200,9200,0,0,0,9250,9250,50,50,0,0,2
992,l1710,20171019,9250,9250,0,0,0,9250,9250,0,0,0,0,2
993,l1710,20171020,9250,9250,0,0,0,9200,9200,-50,-50,0,0,0
994,l1711,20170103,9650,9650,0,0,0,9650,9650,0,0,0,0,0
995,l1711,20170104,9650,9650,0,0,0,9650,9650,0,0,0,0,0
996,l1711,20170105,9650,9650,0,0,0,9650,9650,0,0,0,0,0
997,l1711,20170106,9650,9650,0,0,0,9695,9695,45,45,0,0,0
998,l1711,20170109,9695,9695,0,0,0,9695,9695,0,0,0,0,0
999,l1711,20170110,9695,9695,0,0,0,9695,9695,0,0,0,0,0
1000,l1711,20170111,9695,9695,0,0,0,9695,9695,0,0,0,0,0
1001,l1711,20170112,9695,9695,0,0,0,9695,9695,0,0,0,0,0
1002,l1711,20170113,9695,9695,0,0,0,9780,9780,85,85,0,0,0
1003,l1711,20170116,9780,9780,10040,10040,10040,10040,10040,260,260,4,200800,2
1004,l1711,20170117,10040,10040,10060,10060,10060,10060,10060,20,20,2,100600,0
1005,l1711,20170118,10060,10060,0,0,0,10060,10060,0,0,0,0,0
1006,l1711,20170119,10060,10060,0,0,0,10060,10060,0,0,0,0,0
1007,l1711,20170120,10060,10060,0,0,0,10060,10060,0,0,0,0,0
1008,l1711,20170123,10060,10060,0,0,0,10060,10060,0,0,0,0,0
1009,l1711,20170124,10060,10060,0,0,0,10060,10060,0,0,0,0,0
1010,l1711,20170125,10060,10060,0,0,0,10060,10060,0,0,0,0,0
1011,l1711,20170126,10060,10060,0,0,0,10060,10060,0,0,0,0,0
1012,l1711,20170203,10060,10060,0,0,0,10060,10060,0,0,0,0,0
1013,l1711,20170206,10060,10060,0,0,0,10060,10060,0,0,0,0,0
1014,l1711,20170207,10060,10060,0,0,0,10060,10060,0,0,0,0,0
1015,l1711,20170208,10060,10060,0,0,0,10060,10060,0,0,0,0,0
1016,l1711,20170209,10060,10060,0,0,0,10060,10060,0,0,0,0,0
1017,l1711,20170210,10060,10060,0,0,0,10020,10020,-40,-40,0,0,0
1018,l1711,20170213,10020,10020,0,0,0,10270,10270,250,250,0,0,0
1019,l1711,20170214,10270,10270,10585,10585,10585,10585,10585,315,315,2,105850,2
1020,l1711,20170215,10585,10585,0,0,0,10445,10445,-140,-140,0,0,2
1021,l1711,20170216,10445,10445,0,0,0,10220,10220,-225,-225,0,0,2
1022,l1711,20170217,10220,10220,0,0,0,10065,10065,-155,-155,0,0,2
1023,l1711,20170220,10065,10065,0,0,0,10065,10065,0,0,0,0,2
1024,l1711,20170221,10065,10065,0,0,0,10065,10065,0,0,0,0,2
1025,l1711,20170222,10065,10065,0,0,0,10065,10065,0,0,0,0,2
1026,l1711,20170223,10065,10065,0,0,0,9955,9955,-110,-110,0,0,2
1027,l1711,20170224,9955,9955,0,0,0,9955,9955,0,0,0,0,2
1028,l1711,20170227,9955,9955,0,0,0,9955,9955,0,0,0,0,2
1029,l1711,20170228,9955,9955,0,0,0,9865,9865,-90,-90,0,0,2
1030,l1711,20170301,9865,9865,0,0,0,9865,9865,0,0,0,0,2
1031,l1711,20170302,9865,9865,0,0,0,9855,9855,-10,-10,0,0,2
1032,l1711,20170303,9855,9855,0,0,0,9855,9855,0,0,0,0,2
1033,l1711,20170306,9855,9855,0,0,0,9855,9855,0,0,0,0,2
1034,l1711,20170307,9855,9855,0,0,0,9855,9855,0,0,0,0,2
1035,l1711,20170308,9855,9855,0,0,0,9585,9585,-270,-270,0,0,2
1036,l1711,20170309,9585,9585,0,0,0,9265,9265,-320,-320,0,0,2
1037,l1711,20170310,9265,9265,0,0,0,9265,9265,0,0,0,0,2
1038,l1711,20170313,9265,9265,0,0,0,9265,9265,0,0,0,0,2
1039,l1711,20170314,9265,9265,0,0,0,9265,9265,0,0,0,0,2
1040,l1711,20170315,9265,9265,0,0,0,9265,9265,0,0,0,0,2
1041,l1711,20170316,9265,9265,0,0,0,9305,9305,40,40,0,0,2
1042,l1711,20170317,9305,9305,0,0,0,9355,9355,50,50,0,0,2
1043,l1711,20170320,9355,9355,0,0,0,9310,9310,-45,-45,0,0,2
1044,l1711,20170321,9310,9310,0,0,0,9380,9380,70,70,0,0,2
1045,l1711,20170322,9380,9380,0,0,0,9255,9255,-125,-125,0,0,2
1046,l1711,20170323,9255,9255,9380,9380,9280,9280,9330,25,75,20,933000,2
1047,l1711,20170324,9280,9330,9185,9185,9120,9120,9150,-210,-180,4,183050,2
1048,l1711,20170327,9120,9150,0,0,0,8905,8905,-245,-245,0,0,2
1049,l1711,20170328,8905,8905,8920,9275,8920,9000,9065,95,160,6,271950,2
1050,l1711,20170329,9000,9065,0,0,0,9265,9265,200,200,0,0,2
1051,l1711,20170330,9265,9265,0,0,0,9095,9095,-170,-170,0,0,2
1052,l1711,20170331,9095,9095,0,0,0,9095,9095,0,0,0,0,2
1053,l1711,20170405,9095,9095,0,0,0,9190,9190,95,95,0,0,2
1054,l1711,20170406,9190,9190,0,0,0,9330,9330,140,140,0,0,2
1055,l1711,20170407,9330,9330,0,0,0,9330,9330,0,0,0,0,2
1056,l1711,20170410,9330,9330,0,0,0,9200,9200,-130,-130,0,0,2
1057,l1711,20170411,9200,9200,0,0,0,9070,9070,-130,-130,0,0,2
1058,l1711,20170412,9070,9070,0,0,0,9070,9070,0,0,0,0,2
1059,l1711,20170413,9070,9070,9150,9150,9150,9150,9150,80,80,2,91500,4
1060,l1711,20170414,9150,9150,0,0,0,9115,9115,-35,-35,0,0,4
1061,l1711,20170417,9115,9115,0,0,0,9070,9070,-45,-45,0,0,4
1062,l1711,20170418,9070,9070,9070,9070,8685,8685,8875,-385,-195,8,355100,4
1063,l1711,20170419,8685,8875,0,0,0,8580,8580,-295,-295,0,0,4
1064,l1711,20170420,8580,8580,0,0,0,8575,8575,-5,-5,0,0,4
1065,l1711,20170421,8575,8575,0,0,0,8640,8640,65,65,0,0,4
1066,l1711,20170424,8640,8640,0,0,0,8640,8640,0,0,0,0,4
1067,l1711,20170425,8640,8640,0,0,0,8655,8655,15,15,0,0,4
1068,l1711,20170426,8655,8655,0,0,0,8655,8655,0,0,0,0,4
1069,l1711,20170427,8655,8655,8645,8645,8645,8645,8645,-10,-10,2,86450,6
1070,l1711,20170428,8645,8645,0,0,0,8805,8805,160,160,0,0,6
1071,l1711,20170502,8805,8805,8795,8795,8795,8795,8795,-10,-10,2,87950,4
1072,l1711,20170503,8795,8795,0,0,0,8795,8795,0,0,0,0,4
1073,l1711,20170504,8795,8795,0,0,0,8795,8795,0,0,0,0,4
1074,l1711,20170505,8795,8795,0,0,0,8580,8580,-215,-215,0,0,4
1075,l1711,20170508,8580,8580,0,0,0,8720,8720,140,140,0,0,4
1076,l1711,20170509,8720,8720,0,0,0,8720,8720,0,0,0,0,4
1077,l1711,20170510,8720,8720,0,0,0,8720,8720,0,0,0,0,4
1078,l1711,20170511,8720,8720,0,0,0,8720,8720,0,0,0,0,4
1079,l1711,20170512,8720,8720,0,0,0,8720,8720,0,0,0,0,4
1080,l1711,20170515,8720,8720,0,0,0,8855,8855,135,135,0,0,4
1081,l1711,20170516,8855,8855,0,0,0,8855,8855,0,0,0,0,4
1082,l1711,20170517,8855,8855,0,0,0,8900,8900,45,45,0,0,4
1083,l1711,20170518,8900,8900,0,0,0,9065,9065,165,165,0,0,4
1084,l1711,20170519,9065,9065,9405,9405,9405,9405,9405,340,340,2,94050,6
1085,l1711,20170522,9405,9405,0,0,0,9510,9510,105,105,0,0,6
1086,l1711,20170523,9510,9510,0,0,0,9500,9500,-10,-10,0,0,6
1087,l1711,20170524,9500,9500,0,0,0,9340,9340,-160,-160,0,0,6
1088,l1711,20170525,9340,9340,0,0,0,9340,9340,0,0,0,0,6
1089,l1711,20170526,9340,9340,0,0,0,9190,9190,-150,-150,0,0,6
1090,l1711,20170531,9190,9190,0,0,0,9170,9170,-20,-20,0,0,6
1091,l1711,20170601,9170,9170,9005,9305,9005,9305,9155,135,-15,4,183100,8
1092,l1711,20170602,9305,9155,8840,8840,8840,8840,8840,-315,-315,2,88400,6
1093,l1711,20170605,8840,8840,0,0,0,8840,8840,0,0,0,0,6
1094,l1711,20170606,8840,8840,0,0,0,8840,8840,0,0,0,0,6
1095,l1711,20170607,8840,8840,0,0,0,8840,8840,0,0,0,0,6
1096,l1711,20170608,8840,8840,0,0,0,8840,8840,0,0,0,0,6
1097,l1711,20170609,8840,8840,0,0,0,8840,8840,0,0,0,0,6
1098,l1711,20170612,8840,8840,0,0,0,9040,9040,200,200,0,0,6
1099,l1711,20170613,9040,9040,0,0,0,9040,9040,0,0,0,0,6
1100,l1711,20170614,9040,9040,0,0,0,9040,9040,0,0,0,0,6
1101,l1711,20170615,9040,9040,0,0,0,8955,8955,-85,-85,0,0,6
1102,l1711,20170616,8955,8955,0,0,0,8955,8955,0,0,0,0,6
1103,l1711,20170619,8955,8955,8860,8860,8805,8805,8830,-150,-125,4,176650,8
1104,l1711,20170620,8805,8830,0,0,0,8830,8830,0,0,0,0,8
1105,l1711,20170621,8830,8830,0,0,0,8830,8830,0,0,0,0,8
1106,l1711,20170622,8830,8830,0,0,0,8830,8830,0,0,0,0,8
1107,l1711,20170623,8830,8830,0,0,0,8770,8770,-60,-60,0,0,8
1108,l1711,20170626,8770,8770,0,0,0,8770,8770,0,0,0,0,8
1109,l1711,20170627,8770,8770,0,0,0,8835,8835,65,65,0,0,8
1110,l1711,20170628,8835,8835,0,0,0,8825,8825,-10,-10,0,0,8
1111,l1711,20170629,8825,8825,0,0,0,8935,8935,110,110,0,0,8
1112,l1711,20170630,8935,8935,0,0,0,8955,8955,20,20,0,0,8
1113,l1711,20170703,8955,8955,9020,9055,8995,8995,9020,40,65,6,270700,10
1114,l1711,20170704,8995,9020,0,0,0,8835,8835,-185,-185,0,0,10
1115,l1711,20170705,8835,8835,8885,8885,8885,8885,8885,50,50,2,88850,8
1116,l1711,20170706,8885,8885,0,0,0,8885,8885,0,0,0,0,8
1117,l1711,20170707,8885,8885,0,0,0,9005,9005,120,120,0,0,8
1118,l1711,20170710,9005,9005,0,0,0,8980,8980,-25,-25,0,0,8
1119,l1711,20170711,8980,8980,8890,8890,8890,8890,8890,-90,-90,2,88900,8
1120,l1711,20170712,8890,8890,0,0,0,8890,8890,0,0,0,0,8
1121,l1711,20170713,8890,8890,9180,9185,9180,9185,9180,295,290,4,183650,6
1122,l1711,20170714,9185,9180,0,0,0,9180,9180,0,0,0,0,6
1123,l1711,20170717,9180,9180,9175,9175,9120,9120,9155,-60,-25,6,274700,6
1124,l1711,20170718,9120,9155,0,0,0,9155,9155,0,0,0,0,6
1125,l1711,20170719,9155,9155,0,0,0,9155,9155,0,0,0,0,6
1126,l1711,20170720,9155,9155,9385,9610,9385,9610,9495,455,340,4,189950,8
1127,l1711,20170721,9610,9495,0,0,0,9500,9500,5,5,0,0,8
1128,l1711,20170724,9500,9500,0,0,0,9600,9600,100,100,0,0,8
1129,l1711,20170725,9600,9600,9660,9660,9660,9660,9660,60,60,2,96600,8
1130,l1711,20170726,9660,9660,0,0,0,9575,9575,-85,-85,0,0,8
1131,l1711,20170727,9575,9575,0,0,0,9575,9575,0,0,0,0,8
1132,l1711,20170728,9575,9575,0,0,0,9575,9575,0,0,0,0,8
1133,l1711,20170731,9575,9575,0,0,0,9555,9555,-20,-20,0,0,8
1134,l1711,20170801,9555,9555,0,0,0,9555,9555,0,0,0,0,8
1135,l1711,20170802,9555,9555,0,0,0,9555,9555,0,0,0,0,8
1136,l1711,20170803,9555,9555,0,0,0,9510,9510,-45,-45,0,0,8
1137,l1711,20170804,9510,9510,0,0,0,9510,9510,0,0,0,0,8
1138,l1711,20170807,9510,9510,0,0,0,9460,9460,-50,-50,0,0,8
1139,l1711,20170808,9460,9460,0,0,0,9525,9525,65,65,0,0,8
1140,l1711,20170809,9525,9525,0,0,0,9525,9525,0,0,0,0,8
1141,l1711,20170810,9525,9525,0,0,0,9525,9525,0,0,0,0,8
1142,l1711,20170811,9525,9525,0,0,0,9395,9395,-130,-130,0,0,8
1143,l1711,20170814,9395,9395,0,0,0,9395,9395,0,0,0,0,8
1144,l1711,20170815,9395,9395,0,0,0,9240,9240,-155,-155,0,0,8
1145,l1711,20170816,9240,9240,0,0,0,9240,9240,0,0,0,0,8
1146,l1711,20170817,9240,9240,0,0,0,9390,9390,150,150,0,0,8
1147,l1711,20170818,9390,9390,0,0,0,9390,9390,0,0,0,0,8
1148,l1711,20170821,9390,9390,0,0,0,9480,9480,90,90,0,0,8
1149,l1711,20170822,9480,9480,0,0,0,9745,9745,265,265,0,0,8
1150,l1711,20170823,9745,9745,0,0,0,9745,9745,0,0,0,0,8
1151,l1711,20170824,9745,9745,0,0,0,9745,9745,0,0,0,0,8
1152,l1711,20170825,9745,9745,0,0,0,9745,9745,0,0,0,0,8
1153,l1711,20170828,9745,9745,0,0,0,9615,9615,-130,-130,0,0,8
1154,l1711,20170829,9615,9615,0,0,0,9705,9705,90,90,0,0,8
1155,l1711,20170830,9705,9705,0,0,0,9705,9705,0,0,0,0,8
1156,l1711,20170831,9705,9705,0,0,0,9760,9760,55,55,0,0,8
1157,l1711,20170901,9760,9760,0,0,0,9880,9880,120,120,0,0,8
1158,l1711,20170904,9880,9880,0,0,0,10040,10040,160,160,0,0,8
1159,l1711,20170905,10040,10040,0,0,0,10535,10535,495,495,0,0,8
1160,l1711,20170906,10535,10535,0,0,0,10085,10085,-450,-450,0,0,8
1161,l1711,20170907,10085,10085,0,0,0,10065,10065,-20,-20,0,0,8
1162,l1711,20170908,10065,10065,0,0,0,9960,9960,-105,-105,0,0,8
1163,l1711,20170911,9960,9960,0,0,0,9825,9825,-135,-135,0,0,8
1164,l1711,20170912,9825,9825,0,0,0,9875,9875,50,50,0,0,8
1165,l1711,20170913,9875,9875,0,0,0,9975,9975,100,100,0,0,8
1166,l1711,20170914,9975,9975,0,0,0,10050,10050,75,75,0,0,8
1167,l1711,20170915,10050,10050,0,0,0,10050,10050,0,0,0,0,8
1168,l1711,20170918,10050,10050,0,0,0,10050,10050,0,0,0,0,8
1169,l1711,20170919,10050,10050,0,0,0,9690,9690,-360,-360,0,0,8
1170,l1711,20170920,9690,9690,0,0,0,9690,9690,0,0,0,0,8
1171,l1711,20170921,9690,9690,0,0,0,9690,9690,0,0,0,0,8
1172,l1711,20170922,9690,9690,0,0,0,9690,9690,0,0,0,0,8
1173,l1711,20170925,9690,9690,0,0,0,9465,9465,-225,-225,0,0,8
1174,l1711,20170926,9465,9465,0,0,0,9465,9465,0,0,0,0,8
1175,l1711,20170927,9465,9465,0,0,0,9465,9465,0,0,0,0,8
1176,l1711,20170928,9465,9465,0,0,0,9465,9465,0,0,0,0,8
1177,l1711,20170929,9465,9465,0,0,0,9465,9465,0,0,0,0,8
1178,l1711,20171009,9465,9465,0,0,0,9465,9465,0,0,0,0,8
1179,l1711,20171010,9465,9465,0,0,0,9465,9465,0,0,0,0,8
1180,l1711,20171011,9465,9465,0,0,0,9465,9465,0,0,0,0,8
1181,l1711,20171012,9465,9465,0,0,0,9465,9465,0,0,0,0,8
1182,l1711,20171013,9465,9465,0,0,0,9465,9465,0,0,0,0,8
1183,l1711,20171016,9465,9465,0,0,0,9465,9465,0,0,0,0,8
1184,l1711,20171017,9465,9465,0,0,0,9465,9465,0,0,0,0,8
1185,l1711,20171018,9465,9465,0,0,0,9465,9465,0,0,0,0,8
1186,l1711,20171019,9465,9465,9465,9465,9465,9465,9465,0,0,2,94650,6
1187,l1711,20171020,9465,9465,0,0,0,9465,9465,0,0,0,0,6
1188,l1711,20171023,9465,9465,0,0,0,9465,9465,0,0,0,0,6
1189,l1711,20171024,9465,9465,0,0,0,9465,9465,0,0,0,0,6
1190,l1711,20171025,9465,9465,0,0,0,9465,9465,0,0,0,0,6
1191,l1711,20171026,9465,9465,0,0,0,9465,9465,0,0,0,0,6
1192,l1711,20171027,9465,9465,0,0,0,9465,9465,0,0,0,0,6
1193,l1711,20171030,9465,9465,9420,9525,9420,9520,9500,55,35,10,475050,4
1194,l1711,20171031,9520,9500,9500,9590,9440,9590,9510,90,10,6,285300,0
1195,l1711,20171101,9590,9510,0,0,0,9510,9510,0,0,0,0,0
1196,l1711,20171102,9510,9510,0,0,0,9510,9510,0,0,0,0,0
1197,l1711,20171103,9510,9510,0,0,0,9510,9510,0,0,0,0,0
1198,l1711,20171106,9510,9510,0,0,0,9510,9510,0,0,0,0,0
1199,l1711,20171107,9510,9510,0,0,0,9510,9510,0,0,0,0,0
1200,l1711,20171108,9510,9510,0,0,0,9510,9510,0,0,0,0,0
1201,l1711,20171109,9510,9510,0,0,0,9510,9510,0,0,0,0,0
1202,l1711,20171110,9510,9510,0,0,0,9510,9510,0,0,0,0,0
1203,l1711,20171113,9510,9510,0,0,0,9510,9510,0,0,0,0,0
1204,l1711,20171114,9510,9510,0,0,0,9510,9510,0,0,0,0,0
1205,l1712,20170103,9670,9670,0,0,0,9560,9560,-110,-110,0,0,2
1206,l1712,20170104,9560,9560,0,0,0,9560,9560,0,0,0,0,2
1207,l1712,20170105,9560,9560,0,0,0,9560,9560,0,0,0,0,2
1208,l1712,20170106,9560,9560,0,0,0,9605,9605,45,45,0,0,2
1209,l1712,20170109,9605,9605,0,0,0,9605,9605,0,0,0,0,2
1210,l1712,20170110,9605,9605,9595,9595,9595,9595,9595,-10,-10,2,95950,4
1211,l1712,20170111,9595,9595,0,0,0,9595,9595,0,0,0,0,4
1212,l1712,20170112,9595,9595,0,0,0,9595,9595,0,0,0,0,4
1213,l1712,20170113,9595,9595,9800,9800,9800,9800,9800,205,205,2,98000,4
1214,l1712,20170116,9800,9800,0,0,0,10060,10060,260,260,0,0,4
1215,l1712,20170117,10060,10060,0,0,0,10060,10060,0,0,0,0,4
1216,l1712,20170118,10060,10060,0,0,0,10060,10060,0,0,0,0,4
1217,l1712,20170119,10060,10060,0,0,0,10060,10060,0,0,0,0,4
1218,l1712,20170120,10060,10060,0,0,0,10060,10060,0,0,0,0,4
1219,l1712,20170123,10060,10060,0,0,0,10060,10060,0,0,0,0,4
1220,l1712,20170124,10060,10060,0,0,0,10060,10060,0,0,0,0,4
1221,l1712,20170125,10060,10060,0,0,0,10060,10060,0,0,0,0,4
1222,l1712,20170126,10060,10060,10115,10115,10115,10115,10115,55,55,2,101150,4
1223,l1712,20170203,10115,10115,0,0,0,10115,10115,0,0,0,0,4
1224,l1712,20170206,10115,10115,0,0,0,10115,10115,0,0,0,0,4
1225,l1712,20170207,10115,10115,0,0,0,10115,10115,0,0,0,0,4
1226,l1712,20170208,10115,10115,0,0,0,10090,10090,-25,-25,0,0,4
1227,l1712,20170209,10090,10090,0,0,0,10090,10090,0,0,0,0,4
1228,l1712,20170210,10090,10090,10280,10280,10280,10280,10280,190,190,2,102800,6
1229,l1712,20170213,10280,10280,0,0,0,10535,10535,255,255,0,0,6
1230,l1712,20170214,10535,10535,0,0,0,10535,10535,0,0,0,0,6
1231,l1712,20170215,10535,10535,10410,10410,10410,10410,10410,-125,-125,2,104100,6
1232,l1712,20170216,10410,10410,0,0,0,10185,10185,-225,-225,0,0,6
1233,l1712,20170217,10185,10185,0,0,0,10185,10185,0,0,0,0,6
1234,l1712,20170220,10185,10185,0,0,0,10185,10185,0,0,0,0,6
1235,l1712,20170221,10185,10185,0,0,0,10120,10120,-65,-65,0,0,6
1236,l1712,20170222,10120,10120,0,0,0,10120,10120,0,0,0,0,6
1237,l1712,20170223,10120,10120,0,0,0,10010,10010,-110,-110,0,0,6
1238,l1712,20170224,10010,10010,0,0,0,10010,10010,0,0,0,0,6
1239,l1712,20170227,10010,10010,0,0,0,10010,10010,0,0,0,0,6
1240,l1712,20170228,10010,10010,0,0,0,9920,9920,-90,-90,0,0,6
1241,l1712,20170301,9920,9920,0,0,0,9920,9920,0,0,0,0,6
1242,l1712,20170302,9920,9920,0,0,0,9910,9910,-10,-10,0,0,6
1243,l1712,20170303,9910,9910,0,0,0,9910,9910,0,0,0,0,6
1244,l1712,20170306,9910,9910,0,0,0,9910,9910,0,0,0,0,6
1245,l1712,20170307,9910,9910,0,0,0,9910,9910,0,0,0,0,6
1246,l1712,20170308,9910,9910,9555,9555,9555,9555,9555,-355,-355,2,95550,6
1247,l1712,20170309,9555,9555,9175,9325,9175,9325,9250,-230,-305,4,185000,6
1248,l1712,20170310,9325,9250,0,0,0,9250,9250,0,0,0,0,6
1249,l1712,20170313,9250,9250,0,0,0,9250,9250,0,0,0,0,6
1250,l1712,20170314,9250,9250,0,0,0,9250,9250,0,0,0,0,6
1251,l1712,20170315,9250,9250,0,0,0,9250,9250,0,0,0,0,6
1252,l1712,20170316,9250,9250,0,0,0,9290,9290,40,40,0,0,6
1253,l1712,20170317,9290,9290,0,0,0,9340,9340,50,50,0,0,6
1254,l1712,20170320,9340,9340,0,0,0,9295,9295,-45,-45,0,0,6
1255,l1712,20170321,9295,9295,9475,9475,9475,9475,9475,180,180,2,94750,4
1256,l1712,20170322,9475,9475,0,0,0,9345,9345,-130,-130,0,0,4
1257,l1712,20170323,9345,9345,9320,9320,9320,9320,9320,-25,-25,2,93200,4
1258,l1712,20170324,9320,9320,0,0,0,9145,9145,-175,-175,0,0,4
1259,l1712,20170327,9145,9145,0,0,0,8900,8900,-245,-245,0,0,4
1260,l1712,20170328,8900,8900,8925,8925,8925,8925,8925,25,25,2,89250,2
1261,l1712,20170329,8925,8925,9130,9130,9130,9130,9130,205,205,2,91300,2
1262,l1712,20170330,9130,9130,0,0,0,9130,9130,0,0,0,0,2
1263,l1712,20170331,9130,9130,0,0,0,9110,9110,-20,-20,0,0,2
1264,l1712,20170405,9110,9110,0,0,0,9110,9110,0,0,0,0,2
1265,l1712,20170406,9110,9110,0,0,0,9250,9250,140,140,0,0,2
1266,l1712,20170407,9250,9250,0,0,0,9325,9325,75,75,0,0,2
1267,l1712,20170410,9325,9325,0,0,0,9195,9195,-130,-130,0,0,2
1268,l1712,20170411,9195,9195,0,0,0,9065,9065,-130,-130,0,0,2
1269,l1712,20170412,9065,9065,0,0,0,9065,9065,0,0,0,0,2
1270,l1712,20170413,9065,9065,0,0,0,9140,9140,75,75,0,0,2
1271,l1712,20170414,9140,9140,8705,8705,8705,8705,8705,-435,-435,2,87050,4
1272,l1712,20170417,8705,8705,0,0,0,8665,8665,-40,-40,0,0,4
1273,l1712,20170418,8665,8665,0,0,0,8480,8480,-185,-185,0,0,4
1274,l1712,20170419,8480,8480,0,0,0,8200,8200,-280,-280,0,0,4
1275,l1712,20170420,8200,8200,0,0,0,8195,8195,-5,-5,0,0,4
1276,l1712,20170421,8195,8195,0,0,0,8260,8260,65,65,0,0,4
1277,l1712,20170424,8260,8260,0,0,0,8065,8065,-195,-195,0,0,4
1278,l1712,20170425,8065,8065,0,0,0,8075,8075,10,10,0,0,4
1279,l1712,20170426,8075,8075,0,0,0,8090,8090,15,15,0,0,4
1280,l1712,20170427,8090,8090,0,0,0,8085,8085,-5,-5,0,0,4
1281,l1712,20170428,8085,8085,0,0,0,8235,8235,150,150,0,0,4
1282,l1712,20170502,8235,8235,0,0,0,8230,8230,-5,-5,0,0,4
1283,l1712,20170503,8230,8230,8630,8630,8630,8630,8630,400,400,4,172600,8
1284,l1712,20170504,8630,8630,8705,8705,8705,8705,8705,75,75,4,174100,6
1285,l1712,20170505,8705,8705,0,0,0,8490,8490,-215,-215,0,0,6
1286,l1712,20170508,8490,8490,0,0,0,8630,8630,140,140,0,0,6
1287,l1712,20170509,8630,8630,0,0,0,8555,8555,-75,-75,0,0,6
1288,l1712,20170510,8555,8555,0,0,0,8550,8550,-5,-5,0,0,6
1289,l1712,20170511,8550,8550,0,0,0,8615,8615,65,65,0,0,6
1290,l1712,20170512,8615,8615,0,0,0,8700,8700,85,85,0,0,6
1291,l1712,20170515,8700,8700,0,0,0,8990,8990,290,290,0,0,6
1292,l1712,20170516,8990,8990,0,0,0,9125,9125,135,135,0,0,6
1293,l1712,20170517,9125,9125,0,0,0,9175,9175,50,50,0,0,6
1294,l1712,20170518,9175,9175,0,0,0,9345,9345,170,170,0,0,6
1295,l1712,20170519,9345,9345,0,0,0,9695,9695,350,350,0,0,6
1296,l1712,20170522,9695,9695,0,0,0,9805,9805,110,110,0,0,6
1297,l1712,20170523,9805,9805,9325,9325,9325,9325,9325,-480,-480,4,186500,4
1298,l1712,20170524,9325,9325,0,0,0,9165,9165,-160,-160,0,0,4
1299,l1712,20170525,9165,9165,0,0,0,9225,9225,60,60,0,0,4
1300,l1712,20170526,9225,9225,0,0,0,9075,9075,-150,-150,0,0,4
1301,l1712,20170531,9075,9075,0,0,0,9055,9055,-20,-20,0,0,4
1302,l1712,20170601,9055,9055,0,0,0,9045,9045,-10,-10,0,0,4
1303,l1712,20170602,9045,9045,9055,9055,9055,9055,9055,10,10,2,90550,6
1304,l1712,20170605,9055,9055,0,0,0,8940,8940,-115,-115,0,0,6
1305,l1712,20170606,8940,8940,0,0,0,8910,8910,-30,-30,0,0,6
1306,l1712,20170607,8910,8910,0,0,0,8880,8880,-30,-30,0,0,6
1307,l1712,20170608,8880,8880,0,0,0,8880,8880,0,0,0,0,6
1308,l1712,20170609,8880,8880,0,0,0,8880,8880,0,0,0,0,6
1309,l1712,20170612,8880,8880,0,0,0,9080,9080,200,200,0,0,6
1310,l1712,20170613,9080,9080,9050,9050,9050,9050,9050,-30,-30,4,181000,4
1311,l1712,20170614,9050,9050,0,0,0,9050,9050,0,0,0,0,4
1312,l1712,20170615,9050,9050,0,0,0,8965,8965,-85,-85,0,0,4
1313,l1712,20170616,8965,8965,0,0,0,8955,8955,-10,-10,0,0,4
1314,l1712,20170619,8955,8955,0,0,0,8830,8830,-125,-125,0,0,4
1315,l1712,20170620,8830,8830,0,0,0,8830,8830,0,0,0,0,4
1316,l1712,20170621,8830,8830,0,0,0,8830,8830,0,0,0,0,4
1317,l1712,20170622,8830,8830,0,0,0,8760,8760,-70,-70,0,0,4
1318,l1712,20170623,8760,8760,0,0,0,8705,8705,-55,-55,0,0,4
1319,l1712,20170626,8705,8705,0,0,0,8780,8780,75,75,0,0,4
1320,l1712,20170627,8780,8780,0,0,0,8780,8780,0,0,0,0,4
1321,l1712,20170628,8780,8780,0,0,0,8780,8780,0,0,0,0,4
1322,l1712,20170629,8780,8780,0,0,0,8890,8890,110,110,0,0,4
1323,l1712,20170630,8890,8890,0,0,0,8910,8910,20,20,0,0,4
1324,l1712,20170703,8910,8910,0,0,0,8930,8930,20,20,0,0,4
1325,l1712,20170704,8930,8930,0,0,0,8745,8745,-185,-185,0,0,4
1326,l1712,20170705,8745,8745,0,0,0,8790,8790,45,45,0,0,4
1327,l1712,20170706,8790,8790,0,0,0,8795,8795,5,5,0,0,4
1328,l1712,20170707,8795,8795,0,0,0,8910,8910,115,115,0,0,4
1329,l1712,20170710,8910,8910,0,0,0,8910,8910,0,0,0,0,4
1330,l1712,20170711,8910,8910,0,0,0,8825,8825,-85,-85,0,0,4
1331,l1712,20170712,8825,8825,0,0,0,8960,8960,135,135,0,0,4
1332,l1712,20170713,8960,8960,0,0,0,9250,9250,290,290,0,0,4
1333,l1712,20170714,9250,9250,0,0,0,9250,9250,0,0,0,0,4
1334,l1712,20170717,9250,9250,0,0,0,9225,9225,-25,-25,0,0,4
1335,l1712,20170718,9225,9225,0,0,0,9225,9225,0,0,0,0,4
1336,l1712,20170719,9225,9225,0,0,0,9225,9225,0,0,0,0,4
1337,l1712,20170720,9225,9225,0,0,0,9565,9565,340,340,0,0,4
1338,l1712,20170721,9565,9565,9655,9655,9655,9655,9655,90,90,2,96550,4
1339,l1712,20170724,9655,9655,0,0,0,9760,9760,105,105,0,0,4
1340,l1712,20170725,9760,9760,0,0,0,9760,9760,0,0,0,0,4
1341,l1712,20170726,9760,9760,0,0,0,9760,9760,0,0,0,0,4
1342,l1712,20170727,9760,9760,0,0,0,9760,9760,0,0,0,0,4
1343,l1712,20170728,9760,9760,9675,9675,9440,9440,9555,-320,-205,4,191150,4
1344,l1712,20170731,9440,9555,0,0,0,9535,9535,-20,-20,0,0,4
1345,l1712,20170801,9535,9535,0,0,0,9675,9675,140,140,0,0,4
1346,l1712,20170802,9675,9675,0,0,0,9635,9635,-40,-40,0,0,4
1347,l1712,20170803,9635,9635,0,0,0,9635,9635,0,0,0,0,4
1348,l1712,20170804,9635,9635,0,0,0,9695,9695,60,60,0,0,4
1349,l1712,20170807,9695,9695,0,0,0,9695,9695,0,0,0,0,4
1350,l1712,20170808,9695,9695,0,0,0,9760,9760,65,65,0,0,4
1351,l1712,20170809,9760,9760,9840,10010,9800,9860,9900,100,140,28,1386050,4
1352,l1712,20170810,9860,9900,0,0,0,9900,9900,0,0,0,0,4
1353,l1712,20170811,9900,9900,0,0,0,9765,9765,-135,-135,0,0,4
1354,l1712,20170814,9765,9765,0,0,0,9695,9695,-70,-70,0,0,4
1355,l1712,20170815,9695,9695,0,0,0,9535,9535,-160,-160,0,0,4
1356,l1712,20170816,9535,9535,0,0,0,9535,9535,0,0,0,0,4
1357,l1712,20170817,9535,9535,0,0,0,9690,9690,155,155,0,0,4
1358,l1712,20170818,9690,9690,0,0,0,9720,9720,30,30,0,0,4
1359,l1712,20170821,9720,9720,0,0,0,9815,9815,95,95,0,0,4
1360,l1712,20170822,9815,9815,9880,10105,9880,10105,9990,290,175,4,199850,4
1361,l1712,20170823,10105,9990,0,0,0,9990,9990,0,0,0,0,4
1362,l1712,20170824,9990,9990,0,0,0,9990,9990,0,0,0,0,4
1363,l1712,20170825,9990,9990,0,0,0,9990,9990,0,0,0,0,4
1364,l1712,20170828,9990,9990,0,0,0,9990,9990,0,0,0,0,4
1365,l1712,20170829,9990,9990,0,0,0,10085,10085,95,95,0,0,4
1366,l1712,20170830,10085,10085,0,0,0,10085,10085,0,0,0,0,4
1367,l1712,20170831,10085,10085,10010,10140,10010,10140,10095,55,10,6,302850,10
1368,l1712,20170901,10140,10095,0,0,0,10095,10095,0,0,0,0,10
1369,l1712,20170904,10095,10095,0,0,0,10095,10095,0,0,0,0,10
1370,l1712,20170905,10095,10095,0,0,0,10595,10595,500,500,0,0,10
1371,l1712,20170906,10595,10595,0,0,0,10145,10145,-450,-450,0,0,10
1372,l1712,20170907,10145,10145,0,0,0,10145,10145,0,0,0,0,10
1373,l1712,20170908,10145,10145,0,0,0,10040,10040,-105,-105,0,0,10
1374,l1712,20170911,10040,10040,0,0,0,10040,10040,0,0,0,0,10
1375,l1712,20170912,10040,10040,0,0,0,10090,10090,50,50,0,0,10
1376,l1712,20170913,10090,10090,0,0,0,10190,10190,100,100,0,0,10
1377,l1712,20170914,10190,10190,0,0,0,10265,10265,75,75,0,0,10
1378,l1712,20170915,10265,10265,0,0,0,10265,10265,0,0,0,0,10
1379,l1712,20170918,10265,10265,0,0,0,10265,10265,0,0,0,0,10
1380,l1712,20170919,10265,10265,0,0,0,9895,9895,-370,-370,0,0,10
1381,l1712,20170920,9895,9895,0,0,0,9895,9895,0,0,0,0,10
1382,l1712,20170921,9895,9895,0,0,0,9895,9895,0,0,0,0,10
1383,l1712,20170922,9895,9895,0,0,0,9895,9895,0,0,0,0,10
1384,l1712,20170925,9895,9895,0,0,0,9665,9665,-230,-230,0,0,10
1385,l1712,20170926,9665,9665,0,0,0,9665,9665,0,0,0,0,10
1386,l1712,20170927,9665,9665,0,0,0,9665,9665,0,0,0,0,10
1387,l1712,20170928,9665,9665,0,0,0,9665,9665,0,0,0,0,10
1388,l1712,20170929,9665,9665,0,0,0,9500,9500,-165,-165,0,0,10
1389,l1712,20171009,9500,9500,0,0,0,9500,9500,0,0,0,0,10
1390,l1712,20171010,9500,9500,0,0,0,9500,9500,0,0,0,0,10
1391,l1712,20171011,9500,9500,9565,9565,9565,9565,9565,65,65,2,95650,8
1392,l1712,20171012,9565,9565,0,0,0,9565,9565,0,0,0,0,8
1393,l1712,20171013,9565,9565,0,0,0,9565,9565,0,0,0,0,8
1394,l1712,20171016,9565,9565,0,0,0,9565,9565,0,0,0,0,8
1395,l1712,20171017,9565,9565,0,0,0,9565,9565,0,0,0,0,8
1396,l1712,20171018,9565,9565,0,0,0,9590,9590,25,25,0,0,8
1397,l1712,20171019,9590,9590,9610,9700,9610,9700,9670,110,80,6,290100,6
1398,l1712,20171020,9700,9670,0,0,0,9670,9670,0,0,0,0,6
1399,l1712,20171023,9670,9670,0,0,0,9670,9670,0,0,0,0,6
1400,l1712,20171024,9670,9670,0,0,0,9670,9670,0,0,0,0,6
1401,l1712,20171025,9670,9670,0,0,0,9670,9670,0,0,0,0,6
1402,l1712,20171026,9670,9670,0,0,0,9670,9670,0,0,0,0,6
1403,l1712,20171027,9670,9670,0,0,0,9670,9670,0,0,0,0,6
1404,l1712,20171030,9670,9670,0,0,0,9705,9705,35,35,0,0,6
1405,l1712,20171031,9705,9705,0,0,0,9715,9715,10,10,0,0,6
1406,l1712,20171101,9715,9715,0,0,0,9715,9715,0,0,0,0,6
1407,l1712,20171102,9715,9715,0,0,0,9715,9715,0,0,0,0,6
1408,l1712,20171103,9715,9715,0,0,0,9715,9715,0,0,0,0,6
1409,l1712,20171106,9715,9715,0,0,0,9715,9715,0,0,0,0,6
1410,l1712,20171107,9715,9715,0,0,0,9715,9715,0,0,0,0,6
1411,l1712,20171108,9715,9715,0,0,0,9715,9715,0,0,0,0,6
1412,l1712,20171109,9715,9715,0,0,0,9715,9715,0,0,0,0,6
1413,l1712,20171110,9715,9715,0,0,0,9715,9715,0,0,0,0,6
1414,l1712,20171113,9715,9715,0,0,0,9715,9715,0,0,0,0,6
1415,l1712,20171114,9715,9715,0,0,0,9715,9715,0,0,0,0,6
1416,l1712,20171115,9715,9715,0,0,0,9715,9715,0,0,0,0,6
1417,l1712,20171116,9715,9715,0,0,0,9715,9715,0,0,0,0,6
1418,l1712,20171117,9715,9715,0,0,0,9715,9715,0,0,0,0,6
1419,l1712,20171120,9715,9715,0,0,0,9715,9715,0,0,0,0,6
1420,l1712,20171121,9715,9715,0,0,0,9715,9715,0,0,0,0,6
1421,l1712,20171122,9715,9715,0,0,0,9715,9715,0,0,0,0,6
1422,l1712,20171123,9715,9715,0,0,0,9715,9715,0,0,0,0,6
1423,l1712,20171124,9715,9715,9645,9645,9645,9645,9645,-70,-70,2,96450,6
1424,l1712,20171127,9645,9645,9445,9705,9445,9500,9590,-145,-55,12,575500,2
1425,l1712,20171128,9500,9590,0,0,0,9590,9590,0,0,0,0,2
1426,l1712,20171129,9590,9590,0,0,0,9590,9590,0,0,0,0,2
1427,l1712,20171130,9590,9590,0,0,0,9590,9590,0,0,0,0,2
1428,l1712,20171201,9590,9590,0,0,0,9590,9590,0,0,0,0,2
1429,l1712,20171204,9590,9590,0,0,0,9590,9590,0,0,0,0,2
1430,l1712,20171205,9590,9590,0,0,0,9590,9590,0,0,0,0,2
1431,l1712,20171206,9590,9590,0,0,0,9590,9590,0,0,0,0,2
1432,l1712,20171207,9590,9590,0,0,0,9590,9590,0,0,0,0,2
1433,l1712,20171208,9590,9590,0,0,0,9590,9590,0,0,0,0,2
1434,l1712,20171211,9590,9590,9495,9495,9495,9495,9495,-95,-95,2,94950,2
1435,l1712,20171212,9495,9495,0,0,0,9495,9495,0,0,0,0,2
1436,l1712,20171213,9495,9495,0,0,0,9495,9495,0,0,0,0,2
1437,l1712,20171214,9495,9495,0,0,0,9495,9495,0,0,0,0,0
1438,l1801,20170117,10060,10060,9900,9955,9775,9780,9875,-280,-185,792,39105000,434
1439,l1801,20170118,9780,9875,9805,9905,9785,9870,9845,-5,-30,348,17133300,476
1440,l1801,20170119,9870,9845,9865,9865,9750,9795,9800,-50,-45,312,15293950,586
1441,l1801,20170120,9795,9800,9815,9985,9805,9905,9905,105,105,488,24175600,502
1442,l1801,20170123,9905,9905,9970,10060,9910,9985,10000,80,95,244,12201500,514
1443,l1801,20170124,9985,10000,9985,10010,9880,9930,9925,-70,-75,284,14098500,646
1444,l1801,20170125,9930,9925,9920,10085,9920,10080,10005,155,80,194,9705050,640
1445,l1801,20170126,10080,10005,10100,10110,9950,10005,10000,0,-5,268,13401500,690
1446,l1801,20170203,10005,10000,10025,10090,9900,9960,9960,-40,-40,304,15145100,702
1447,l1801,20170206,9960,9960,9965,10130,9910,10110,10060,150,100,698,35109450,1060
1448,l1801,20170207,10110,10060,10120,10240,10100,10125,10175,65,115,1400,71255300,2000
1449,l1801,20170208,10125,10175,10095,10245,10090,10210,10200,35,25,1746,89070850,2362
1450,l1801,20170209,10210,10200,10210,10325,10205,10275,10280,75,80,1386,71243400,2828
1451,l1801,20170210,10275,10280,10285,10320,10165,10290,10260,10,-20,986,50599950,3030
1452,l1801,20170213,10290,10260,10365,10600,10360,10580,10505,320,245,1472,77329250,3710
1453,l1801,20170214,10580,10505,10565,10595,10500,10570,10545,65,40,386,20355650,3702
1454,l1801,20170215,10570,10545,10550,10550,10380,10380,10445,-165,-100,2038,106453050,3958
1455,l1801,20170216,10380,10445,10350,10355,10100,10100,10270,-345,-175,2530,129954900,4236
1456,l1801,20170217,10100,10270,10130,10200,10045,10065,10130,-205,-140,498,25228900,4374
1457,l1801,20170220,10065,10130,10065,10165,10050,10085,10105,-45,-25,410,20723300,4386
1458,l1801,20170221,10085,10105,10120,10155,9945,9965,10055,-140,-50,600,30172100,4468
1459,l1801,20170222,9965,10055,9985,10050,9965,10015,10015,-40,-40,302,15125500,4508
1460,l1801,20170223,10015,10015,10020,10060,9800,9845,9935,-170,-80,640,31792400,4622
1461,l1801,20170224,9845,9935,9805,9900,9745,9855,9855,-80,-80,712,35097750,4658
1462,l1801,20170227,9855,9855,9885,9975,9855,9880,9910,25,55,610,30240100,4768
1463,l1801,20170228,9880,9910,9870,9945,9740,9805,9840,-105,-70,554,27258000,4818
1464,l1801,20170301,9805,9840,9825,9875,9735,9770,9810,-70,-30,826,40534200,4876
1465,l1801,20170302,9770,9810,9775,9820,9745,9800,9775,-10,-35,520,25426850,4970
1466,l1801,20170303,9800,9775,9745,9880,9700,9840,9820,65,45,724,35561650,4902
1467,l1801,20170306,9840,9820,9845,9950,9845,9910,9900,90,80,926,45846050,4988
1468,l1801,20170307,9910,9900,9920,9930,9805,9845,9845,-55,-55,518,25501250,5080
1469,l1801,20170308,9845,9845,9805,9805,9485,9500,9605,-345,-240,2144,102976300,5928
1470,l1801,20170309,9500,9605,9410,9450,9305,9380,9390,-225,-215,1736,81536950,5938
1471,l1801,20170310,9380,9390,9405,9425,9190,9200,9305,-190,-85,1316,61248850,5832
1472,l1801,20170313,9200,9305,9160,9280,9120,9280,9185,-25,-120,2006,92163300,6158
1473,l1801,20170314,9280,9185,9210,9370,9210,9295,9310,110,125,1218,56718200,6222
1474,l1801,20170315,9295,9310,9305,9430,9305,9355,9385,45,75,1494,70110250,6062
1475,l1801,20170316,9355,9385,9370,9480,9370,9465,9435,80,50,1290,60858050,6206
1476,l1801,20170317,9465,9435,9465,9515,9440,9480,9475,45,40,792,37538450,6164
1477,l1801,20170320,9480,9475,9465,9515,9365,9510,9420,35,-55,716,33735500,6160
1478,l1801,20170321,9510,9420,9485,9530,9430,9430,9475,10,55,946,44839700,6156
1479,l1801,20170322,9430,9475,9425,9425,9235,9265,9280,-210,-195,2140,99306150,6470
1480,l1801,20170323,9265,9280,9285,9385,9185,9200,9310,-80,30,4244,197600650,7310
1481,l1801,20170324,9200,9310,9200,9250,9115,9135,9180,-175,-130,3766,172868000,8440
1482,l1801,20170327,9135,9180,9105,9105,8815,8935,8930,-245,-250,5982,267155850,10462
1483,l1801,20170328,8935,8930,8955,9030,8915,8945,8965,15,35,2456,110132700,10778
1484,l1801,20170329,8945,8965,9005,9105,9005,9100,9060,135,95,4438,201068400,10658
1485,l1801,20170330,9100,9060,9100,9175,9005,9015,9060,-45,0,4292,194495100,11184
1486,l1801,20170331,9015,9060,9060,9140,8930,8960,9070,-100,10,5764,261493150,13658
1487,l1801,20170405,8960,9070,9020,9260,8985,9235,9110,165,40,5698,259674500,13368
1488,l1801,20170406,9235,9110,9200,9345,9185,9345,9270,235,160,4534,210164550,13920
1489,l1801,20170407,9345,9270,9290,9450,9215,9255,9335,-15,65,10518,490942000,13610
1490,l1801,20170410,9255,9335,9275,9335,9045,9045,9195,-290,-140,8122,373444600,15718
1491,l1801,20170411,9045,9195,9075,9105,9010,9025,9055,-170,-140,9680,438342700,19704
1492,l1801,20170412,9025,9055,9075,9110,8910,8925,8990,-130,-65,7626,342817500,21644
1493,l1801,20170413,8925,8990,8905,9000,8870,8890,8925,-100,-65,6002,267927000,22942
1494,l1801,20170414,8890,8925,8920,8960,8555,8630,8715,-295,-210,25092,1093406600,33916
1495,l1801,20170417,8630,8715,8665,8710,8585,8625,8645,-90,-70,13390,579107550,38450
1496,l1801,20170418,8625,8645,8650,8695,8525,8640,8605,-5,-40,16784,722491100,40948
1497,l1801,20170419,8640,8605,8625,8650,8500,8600,8570,-5,-35,15472,663185500,43488
1498,l1801,20170420,8600,8570,8615,8690,8500,8650,8585,80,15,27032,1160953200,46186
1499,l1801,20170421,8650,8585,8665,8720,8580,8605,8665,20,80,20382,883416800,48594
1500,l1801,20170424,8605,8665,8590,8600,8410,8510,8475,-155,-190,30672,1300256500,51248
1501,l1801,20170425,8510,8475,8500,8565,8460,8495,8510,20,35,24592,1046487750,56796
1502,l1801,20170426,8495,8510,8500,8625,8455,8565,8550,55,40,23048,985761800,55930
1503,l1801,20170427,8565,8550,8550,8645,8550,8635,8610,85,60,21612,930851550,58342
1504,l1801,20170428,8635,8610,8650,8860,8650,8845,8795,235,185,31050,1365847800,54568
1505,l1801,20170502,8845,8795,8820,8885,8740,8855,8825,60,30,20196,891276150,54530
1506,l1801,20170503,8855,8825,8835,8890,8755,8795,8830,-30,5,24510,1082178900,57914
1507,l1801,20170504,8795,8830,8700,8700,8560,8680,8645,-150,-185,26162,1130968150,58604
1508,l1801,20170505,8680,8645,8630,8690,8580,8640,8630,-5,-15,17478,754458900,57766
1509,l1801,20170508,8640,8630,8735,8835,8660,8675,8755,45,125,23514,1029552550,57250
1510,l1801,20170509,8675,8755,8725,8725,8635,8665,8670,-90,-85,12778,554068800,60636
1511,l1801,20170510,8665,8670,8680,8700,8490,8575,8555,-95,-115,35072,1500493800,64716
1512,l1801,20170511,8575,8555,8575,8715,8545,8715,8630,160,75,17994,776447600,62694
1513,l1801,20170512,8715,8630,8675,8795,8660,8770,8745,140,115,28354,1239847100,60694
1514,l1801,20170515,8770,8745,8795,9005,8795,9005,8895,260,150,38946,1732334600,65174
1515,l1801,20170516,9005,8895,9005,9095,8950,9095,9010,200,115,23998,1081451950,62820
1516,l1801,20170517,9095,9010,9055,9125,9030,9055,9060,45,50,20248,917655750,63606
1517,l1801,20170518,9055,9060,9040,9175,8985,9160,9080,100,20,28498,1294193600,63970
1518,l1801,20170519,9160,9080,9280,9375,9190,9320,9260,240,180,32782,1517814650,66030
1519,l1801,20170522,9320,9260,9360,9380,9205,9270,9280,10,20,24932,1157345950,64548
1520,l1801,20170523,9270,9280,9260,9325,9205,9240,9255,-40,-25,24920,1153425650,64056
1521,l1801,20170524,9240,9255,9245,9285,9060,9155,9165,-100,-90,30826,1412831350,62146
1522,l1801,20170525,9155,9165,9160,9245,9095,9100,9165,-65,0,34962,1602178650,65088
1523,l1801,20170526,9100,9165,9030,9075,8975,9060,9025,-105,-140,21638,976872050,65440
1524,l1801,20170531,9060,9025,9095,9150,8925,8945,9060,-80,35,32902,1490843850,64250
1525,l1801,20170601,8945,9060,8955,9155,8950,9125,9060,65,0,23348,1057678600,65884
1526,l1801,20170602,9125,9060,9085,9110,8850,8860,8970,-200,-90,30132,1351885100,66452
1527,l1801,20170605,8860,8970,8880,8910,8800,8815,8845,-155,-125,30076,1330132450,71748
1528,l1801,20170606,8815,8845,8830,8870,8765,8820,8820,-25,-25,20338,897151300,70542
1529,l1801,20170607,8820,8820,8845,8880,8750,8775,8795,-45,-25,23044,1013581200,75220
1530,l1801,20170608,8775,8795,8750,8880,8695,8800,8770,5,-25,32506,1425425200,78356
1531,l1801,20170609,8800,8770,8795,8850,8755,8795,8810,25,40,20608,907830250,81314
1532,l1801,20170612,8795,8810,8825,8980,8825,8945,8930,135,120,34280,1530895950,83226
1533,l1801,20170613,8945,8930,8935,8990,8755,8775,8920,-155,-10,36188,1614550350,86824
1534,l1801,20170614,8775,8920,8800,8895,8750,8810,8810,-110,-110,42076,1854141450,88376
1535,l1801,20170615,8810,8810,8760,8815,8710,8715,8760,-95,-50,29962,1312473400,95238
1536,l1801,20170616,8715,8760,8720,8805,8695,8730,8755,-30,-5,42746,1871263800,98096
1537,l1801,20170619,8730,8755,8730,8835,8710,8760,8770,5,15,44700,1960607000,97322
1538,l1801,20170620,8760,8770,8755,8795,8700,8740,8750,-30,-20,29922,1309763400,95916
1539,l1801,20170621,8740,8750,8700,8795,8665,8705,8715,-45,-35,35038,1526946400,100716
1540,l1801,20170622,8705,8715,8715,8745,8535,8545,8630,-170,-85,55996,2417031450,112420
1541,l1801,20170623,8545,8630,8565,8615,8545,8600,8570,-30,-60,31366,1344714150,116566
1542,l1801,20170626,8600,8570,8600,8700,8600,8680,8655,110,85,30776,1332460800,115392
1543,l1801,20170627,8680,8655,8665,8760,8660,8735,8710,80,55,30900,1346425900,115958
1544,l1801,20170628,8735,8710,8765,8805,8645,8695,8715,-15,5,37888,1651822500,118522
1545,l1801,20170629,8695,8715,8730,8910,8720,8835,8815,120,100,59354,2617212250,114130
1546,l1801,20170630,8835,8815,8830,8900,8780,8880,8840,65,25,35760,1581340200,115786
1547,l1801,20170703,8880,8840,8930,8975,8850,8885,8900,45,60,48664,2166420950,119750
1548,l1801,20170704,8885,8900,8880,8890,8685,8705,8760,-195,-140,77448,3394033600,131336
1549,l1801,20170705,8705,8760,8740,8825,8735,8750,8775,-10,15,55866,2451960800,136552
1550,l1801,20170706,8750,8775,8710,8880,8710,8870,8800,95,25,55740,2453613250,139168
1551,l1801,20170707,8870,8800,8840,8940,8830,8920,8890,120,90,69634,3096253700,127700
1552,l1801,20170710,8920,8890,8905,8990,8815,8830,8895,-60,5,76252,3391528550,135836
1553,l1801,20170711,8830,8895,8885,8975,8845,8960,8915,65,20,61328,2734326750,140920
1554,l1801,20170712,8960,8915,9010,9080,8965,9010,9015,95,100,89480,4034972300,152286
1555,l1801,20170713,9010,9015,8985,9130,8955,9055,9050,40,35,74642,3378045650,161060
1556,l1801,20170714,9055,9050,9060,9120,9025,9090,9075,40,25,67672,3071973100,174804
1557,l1801,20170717,9090,9075,9110,9205,9090,9115,9150,40,75,77922,3566286550,176108
1558,l1801,20170718,9115,9150,9135,9195,9115,9155,9150,5,0,58220,2664855100,174264
1559,l1801,20170719,9155,9150,9180,9250,9155,9220,9200,70,50,63430,2919301100,172700
1560,l1801,20170720,9220,9200,9295,9660,9270,9660,9530,460,330,323164,15400744850,250522
1561,l1801,20170721,9660,9530,9605,9805,9490,9755,9640,225,110,292972,14127246750,295402
1562,l1801,20170724,9755,9640,9660,9775,9625,9695,9705,55,65,196608,9543159550,309986
1563,l1801,20170725,9695,9705,9740,9775,9655,9705,9705,0,0,123634,6001719000,310138
1564,l1801,20170726,9705,9705,9785,9845,9565,9620,9695,-85,-10,196018,9505841700,308372
1565,l1801,20170727,9620,9695,9635,9650,9530,9625,9600,-70,-95,133254,6397039250,317014
1566,l1801,20170728,9625,9600,9635,9640,9450,9475,9530,-125,-70,186966,8909495200,307328
1567,l1801,20170731,9475,9530,9525,9600,9430,9560,9520,30,-10,231092,11005476700,331520
1568,l1801,20170801,9560,9520,9600,9805,9545,9655,9695,135,175,336180,16304342000,369348
1569,l1801,20170802,9655,9695,9600,9720,9575,9665,9650,-30,-45,254390,12274423200,380894
1570,l1801,20170803,9665,9650,9705,9730,9490,9525,9615,-125,-35,439056,21110069050,397886
1571,l1801,20170804,9525,9615,9545,9775,9535,9700,9675,85,60,441806,21375943550,422420
1572,l1801,20170807,9700,9675,9760,9830,9550,9575,9630,-100,-45,509884,24552269950,414914
1573,l1801,20170808,9575,9630,9615,9820,9605,9780,9725,150,95,616222,29968547050,470254
1574,l1801,20170809,9780,9725,9850,9960,9730,9805,9845,80,120,539200,26555217600,463686
1575,l1801,20170810,9805,9845,9820,9880,9745,9820,9800,-25,-45,420660,20620098700,457868
1576,l1801,20170811,9820,9800,9745,9770,9480,9555,9625,-245,-175,600550,28909538400,420300
1577,l1801,20170814,9555,9625,9585,9620,9510,9545,9570,-80,-55,336070,16085645450,432874
1578,l1801,20170815,9545,9570,9495,9515,9325,9450,9420,-120,-150,583920,27513284100,410332
1579,l1801,20170816,9450,9420,9450,9515,9400,9455,9470,35,50,318628,15087065250,423286
1580,l1801,20170817,9455,9470,9560,9750,9555,9675,9655,205,185,498946,24095575750,428002
1581,l1801,20170818,9675,9655,9680,9735,9645,9735,9695,80,40,297454,14423777800,434592
1582,l1801,20170821,9735,9695,9805,9855,9760,9805,9810,110,115,359956,17656085400,456350
1583,l1801,20170822,9805,9810,9795,10075,9690,10040,9895,230,85,815126,40333407350,524522
1584,l1801,20170823,10040,9895,9985,10035,9910,9945,9970,50,75,516788,25768733300,527838
1585,l1801,20170824,9945,9970,9980,10045,9920,9940,9975,-30,5,375046,18714520400,508236
1586,l1801,20170825,9940,9975,9975,10130,9935,9955,10065,-20,90,494334,24884819950,527448
1587,l1801,20170828,9955,10065,9900,9975,9830,9955,9905,-110,-160,325500,16122963450,500786
1588,l1801,20170829,9955,9905,9970,10105,9945,10060,10030,155,125,501842,25178174500,522980
1589,l1801,20170830,10060,10030,10040,10100,9980,10065,10045,35,15,314928,15821072200,493144
1590,l1801,20170831,10065,10045,10040,10245,9985,10175,10140,130,95,524200,26584392200,542920
1591,l1801,20170901,10175,10140,10220,10375,10165,10360,10260,220,120,398594,20450509950,525652
1592,l1801,20170904,10360,10260,10550,10605,10350,10395,10440,135,180,450094,23496080900,522240
1593,l1801,20170905,10395,10440,10385,10480,10330,10440,10410,0,-30,369598,19239671800,490608
1594,l1801,20170906,10440,10410,10380,10395,10240,10285,10315,-125,-95,496786,25626169000,499882
1595,l1801,20170907,10285,10315,10320,10345,10085,10160,10210,-155,-105,482420,24632540050,478192
1596,l1801,20170908,10160,10210,10200,10210,10000,10075,10105,-135,-105,445580,22518258700,496434
1597,l1801,20170911,10075,10105,9990,10075,9915,10020,9985,-85,-120,446342,22290824550,450340
1598,l1801,20170912,10020,9985,10100,10215,10050,10180,10140,195,155,425644,21586058900,461044
1599,l1801,20170913,10180,10140,10195,10215,9895,9935,10030,-205,-110,511604,25664354000,451668
1600,l1801,20170914,9935,10030,9970,10000,9750,9765,9885,-265,-145,433594,21438724500,456314
1601,l1801,20170915,9765,9885,9775,9825,9690,9750,9755,-135,-130,419642,20470355600,447064
1602,l1801,20170918,9750,9755,9710,9860,9635,9790,9755,35,0,511100,24941660550,442800
1603,l1801,20170919,9790,9755,9790,9835,9660,9670,9755,-85,0,348114,16985137100,419114
1604,l1801,20170920,9670,9755,9720,9785,9645,9730,9710,-25,-45,419062,20353955900,436680
1605,l1801,20170921,9730,9710,9705,9710,9485,9520,9565,-190,-145,444992,21290235150,436282
1606,l1801,20170922,9520,9565,9520,9600,9465,9540,9540,-25,-25,380308,18142196250,444930
1607,l1801,20170925,9540,9540,9570,9630,9490,9590,9560,50,20,419526,20055564650,427394
1608,l1801,20170926,9590,9560,9645,9695,9555,9670,9640,110,80,361064,17406657250,431670
1609,l1801,20170927,9670,9640,9700,9720,9615,9665,9660,25,20,251388,12143001350,405310
1610,l1801,20170928,9665,9660,9560,9560,9245,9450,9415,-210,-245,614288,28932580500,394158
1611,l1801,20170929,9450,9415,9485,9540,9410,9510,9475,95,60,254664,12067147250,386506
1612,l1801,20171009,9510,9475,9560,9635,9425,9515,9515,40,40,380440,18108103450,396232
1613,l1801,20171010,9515,9515,9485,9640,9440,9455,9525,-60,10,428270,20401069250,406002
1614,l1801,20171011,9455,9525,9515,9520,9355,9365,9440,-160,-85,417942,19727305250,437754
1615,l1801,20171012,9365,9440,9395,9540,9300,9530,9410,90,-30,533218,25092990000,415372
1616,l1801,20171013,9530,9410,9560,9760,9540,9720,9650,310,240,519844,25094194150,408808
1617,l1801,20171016,9720,9650,9760,9810,9665,9795,9735,145,85,444784,21653620000,395494
1618,l1801,20171017,9795,9735,9640,9890,9630,9845,9790,110,55,561760,27510924850,421826
1619,l1801,20171018,9845,9790,9850,9920,9795,9860,9855,70,65,322536,15897772050,387470
1620,l1801,20171019,9860,9855,9805,9810,9620,9690,9695,-165,-160,521722,25299048600,379216
1621,l1801,20171020,9690,9695,9715,9955,9665,9940,9815,245,120,504616,24768800600,394622
1622,l1801,20171023,9940,9815,9870,9920,9800,9850,9860,35,45,391406,19302500300,392952
1623,l1801,20171024,9850,9860,9870,9930,9820,9835,9875,-25,15,349344,17249332950,387848
1624,l1801,20171025,9835,9875,9860,9915,9790,9885,9855,10,-20,404290,19930081300,403368
1625,l1801,20171026,9885,9855,9870,9980,9740,9760,9825,-95,-30,520804,25590609750,393778
1626,l1801,20171027,9760,9825,9780,9805,9590,9610,9695,-215,-130,418120,20272738400,363920
1627,l1801,20171030,9610,9695,9630,9670,9565,9595,9610,-100,-85,314930,15140218950,365264
1628,l1801,20171031,9595,9610,9595,9595,9450,9510,9500,-100,-110,311812,14815294150,371344
1629,l1801,20171101,9510,9500,9530,9625,9470,9485,9535,-15,35,319416,15230773750,379322
1630,l1801,20171102,9485,9535,9570,9665,9525,9645,9575,110,40,401758,19237929400,376274
1631,l1801,20171103,9645,9575,9660,9760,9630,9715,9695,140,120,428156,20755716850,370654
1632,l1801,20171106,9715,9695,9780,9880,9760,9870,9820,175,125,355534,17461079400,348606
1633,l1801,20171107,9870,9820,9895,9930,9805,9885,9860,65,40,286624,14130823850,366962
1634,l1801,20171108,9885,9860,9835,9925,9830,9850,9880,-10,20,276708,13669505200,356612
1635,l1801,20171109,9850,9880,9880,10015,9845,9915,9930,35,50,454888,22589462500,357682
1636,l1801,20171110,9915,9930,9930,9955,9775,9810,9850,-120,-80,420064,20688606500,345994
1637,l1801,20171113,9810,9850,9815,9850,9715,9845,9785,-5,-65,355744,17412430700,345982
1638,l1801,20171114,9845,9785,9860,9890,9765,9805,9820,20,35,297436,14604531250,336644
1639,l1801,20171115,9805,9820,9605,9735,9565,9660,9650,-160,-170,430140,20764834850,312728
1640,l1801,20171116,9660,9650,9685,9690,9535,9555,9590,-95,-60,306992,14726006800,318174
1641,l1801,20171117,9555,9590,9535,9635,9505,9620,9575,30,-15,325944,15608399500,296580
1642,l1801,20171120,9620,9575,9650,9750,9580,9705,9665,130,90,318018,15369832850,295884
1643,l1801,20171121,9705,9665,9705,9800,9705,9780,9760,115,95,236484,11544946300,288014
1644,l1801,20171122,9780,9760,9805,9855,9720,9825,9790,65,30,289188,14162067350,285618
1645,l1801,20171123,9825,9790,9855,9905,9675,9725,9805,-65,15,264342,12963438050,274848
1646,l1801,20171124,9725,9805,9745,9795,9705,9780,9750,-25,-55,175288,8546270050,264334
1647,l1801,20171127,9780,9750,9790,9895,9500,9530,9715,-220,-35,436782,21222620200,243910
1648,l1801,20171128,9530,9715,9570,9570,9475,9510,9530,-205,-185,238040,11343346200,226232
1649,l1801,20171129,9510,9530,9510,9615,9500,9595,9560,65,30,217380,10393951150,190890
1650,l1801,20171130,9595,9560,9610,9660,9515,9600,9580,40,20,135826,6509268300,165694
1651,l1801,20171201,9600,9580,9605,9715,9570,9650,9645,70,65,102770,4957717700,149284
1652,l1801,20171204,9650,9645,9695,9770,9685,9765,9735,120,90,70420,3429108050,135328
1653,l1801,20171205,9765,9735,9750,9785,9655,9665,9725,-70,-10,53018,2578612600,121532
1654,l1801,20171206,9665,9725,9655,9715,9605,9625,9660,-100,-65,48098,2323850000,108526
1655,l1801,20171207,9625,9660,9600,9610,9460,9515,9525,-145,-135,58586,2791524700,91616
1656,l1801,20171208,9515,9525,9525,9640,9510,9590,9575,65,50,37568,1799342650,84714
1657,l1801,20171211,9590,9575,9595,9675,9520,9560,9590,-15,15,47930,2299222700,77320
1658,l1801,20171212,9560,9590,9595,9665,9590,9660,9625,70,35,29136,1402538950,68770
1659,l1801,20171213,9660,9625,9630,9675,9530,9580,9570,-45,-55,22020,1054207400,65300
1660,l1801,20171214,9580,9570,9510,9645,9510,9555,9575,-15,5,22144,1060432500,57486
1661,l1801,20171215,9555,9575,9535,9610,9490,9525,9540,-50,-35,18532,884127350,53454
1662,l1801,20171218,9525,9540,9580,9595,9505,9565,9550,25,10,13990,668064250,48330
1663,l1801,20171219,9565,9550,9550,9665,9500,9620,9590,70,40,29842,1431066600,37598
1664,l1801,20171220,9620,9590,9640,9675,9575,9640,9620,50,30,14234,684745800,29982
1665,l1801,20171221,9640,9620,9630,9650,9560,9615,9610,-5,-10,12362,594248150,26712
1666,l1801,20171222,9615,9610,9620,9645,9510,9540,9545,-70,-65,10958,523063250,22518
1667,l1801,20171225,9540,9545,9400,9540,9400,9435,9490,-110,-55,10526,499480800,18170
1668,l1801,20171226,9435,9490,9485,9570,9370,9565,9470,75,-20,10328,489170650,13882
1669,l1801,20171227,9565,9470,9575,9590,9515,9520,9545,50,75,5262,251188650,10744
1670,l1801,20171228,9520,9545,9530,9590,9485,9540,9555,-5,10,5434,259708200,8794
1671,l1801,20171229,9540,9555,9560,9580,9515,9560,9545,5,-10,4394,209761900,7622
1672,l1802,20170217,10270,10270,0,0,0,10270,10270,0,0,0,0,0
1673,l1802,20170220,10270,10270,0,0,0,10270,10270,0,0,0,0,0
1674,l1802,20170221,10270,10270,0,0,0,10270,10270,0,0,0,0,0
1675,l1802,20170222,10270,10270,0,0,0,10270,10270,0,0,0,0,0
1676,l1802,20170223,10270,10270,0,0,0,10270,10270,0,0,0,0,0
1677,l1802,20170224,10270,10270,0,0,0,10270,10270,0,0,0,0,0
1678,l1802,20170227,10270,10270,0,0,0,10270,10270,0,0,0,0,0
1679,l1802,20170228,10270,10270,0,0,0,10260,10260,-10,-10,0,0,0
1680,l1802,20170301,10260,10260,9980,9980,9980,9980,9980,-280,-280,6,299400,6
1681,l1802,20170302,9980,9980,0,0,0,9980,9980,0,0,0,0,6
1682,l1802,20170303,9980,9980,0,0,0,9980,9980,0,0,0,0,6
1683,l1802,20170306,9980,9980,0,0,0,9980,9980,0,0,0,0,6
1684,l1802,20170307,9980,9980,0,0,0,9980,9980,0,0,0,0,6
1685,l1802,20170308,9980,9980,0,0,0,9740,9740,-240,-240,0,0,6
1686,l1802,20170309,9740,9740,0,0,0,9525,9525,-215,-215,0,0,6
1687,l1802,20170310,9525,9525,0,0,0,9440,9440,-85,-85,0,0,6
1688,l1802,20170313,9440,9440,9265,9275,9265,9275,9270,-165,-170,4,185400,6
1689,l1802,20170314,9275,9270,0,0,0,9270,9270,0,0,0,0,6
1690,l1802,20170315,9270,9270,0,0,0,9340,9340,70,70,0,0,6
1691,l1802,20170316,9340,9340,0,0,0,9385,9385,45,45,0,0,6
1692,l1802,20170317,9385,9385,0,0,0,9420,9420,35,35,0,0,6
1693,l1802,20170320,9420,9420,0,0,0,9370,9370,-50,-50,0,0,6
1694,l1802,20170321,9370,9370,0,0,0,9420,9420,50,50,0,0,6
1695,l1802,20170322,9420,9420,0,0,0,9420,9420,0,0,0,0,6
1696,l1802,20170323,9420,9420,9465,9465,9380,9380,9405,-40,-15,6,282250,12
1697,l1802,20170324,9380,9405,0,0,0,9275,9275,-130,-130,0,0,12
1698,l1802,20170327,9275,9275,0,0,0,9025,9025,-250,-250,0,0,12
1699,l1802,20170328,9025,9025,0,0,0,9025,9025,0,0,0,0,12
1700,l1802,20170329,9025,9025,0,0,0,9120,9120,95,95,0,0,12
1701,l1802,20170330,9120,9120,0,0,0,9120,9120,0,0,0,0,12
1702,l1802,20170331,9120,9120,0,0,0,9130,9130,10,10,0,0,12
1703,l1802,20170405,9130,9130,9130,9130,9130,9130,9130,0,0,2,91300,12
1704,l1802,20170406,9130,9130,0,0,0,9290,9290,160,160,0,0,12
1705,l1802,20170407,9290,9290,0,0,0,9355,9355,65,65,0,0,12
1706,l1802,20170410,9355,9355,0,0,0,9215,9215,-140,-140,0,0,12
1707,l1802,20170411,9215,9215,9245,9245,9245,9245,9245,30,30,2,92450,14
1708,l1802,20170412,9245,9245,0,0,0,9245,9245,0,0,0,0,14
1709,l1802,20170413,9245,9245,0,0,0,9180,9180,-65,-65,0,0,14
1710,l1802,20170414,9180,9180,0,0,0,8965,8965,-215,-215,0,0,14
1711,l1802,20170417,8965,8965,8780,8780,8780,8780,8780,-185,-185,4,175600,14
1712,l1802,20170418,8780,8780,0,0,0,8780,8780,0,0,0,0,14
1713,l1802,20170419,8780,8780,0,0,0,8780,8780,0,0,0,0,14
1714,l1802,20170420,8780,8780,0,0,0,8780,8780,0,0,0,0,14
1715,l1802,20170421,8780,8780,0,0,0,8860,8860,80,80,0,0,14
1716,l1802,20170424,8860,8860,0,0,0,8670,8670,-190,-190,0,0,14
1717,l1802,20170425,8670,8670,0,0,0,8705,8705,35,35,0,0,14
1718,l1802,20170426,8705,8705,8495,8495,8495,8495,8495,-210,-210,8,339800,6
1719,l1802,20170427,8495,8495,0,0,0,8550,8550,55,55,0,0,6
1720,l1802,20170428,8550,8550,0,0,0,8730,8730,180,180,0,0,6
1721,l1802,20170502,8730,8730,0,0,0,8755,8755,25,25,0,0,6
1722,l1802,20170503,8755,8755,0,0,0,8755,8755,0,0,0,0,6
1723,l1802,20170504,8755,8755,0,0,0,8755,8755,0,0,0,0,6
1724,l1802,20170505,8755,8755,0,0,0,8740,8740,-15,-15,0,0,6
1725,l1802,20170508,8740,8740,0,0,0,8740,8740,0,0,0,0,6
1726,l1802,20170509,8740,8740,0,0,0,8740,8740,0,0,0,0,6
1727,l1802,20170510,8740,8740,0,0,0,8740,8740,0,0,0,0,6
1728,l1802,20170511,8740,8740,0,0,0,8740,8740,0,0,0,0,6
1729,l1802,20170512,8740,8740,0,0,0,8740,8740,0,0,0,0,6
1730,l1802,20170515,8740,8740,0,0,0,8835,8835,95,95,0,0,6
1731,l1802,20170516,8835,8835,0,0,0,8945,8945,110,110,0,0,6
1732,l1802,20170517,8945,8945,0,0,0,8990,8990,45,45,0,0,6
1733,l1802,20170518,8990,8990,0,0,0,9005,9005,15,15,0,0,6
1734,l1802,20170519,9005,9005,0,0,0,9180,9180,175,175,0,0,6
1735,l1802,20170522,9180,9180,0,0,0,9195,9195,15,15,0,0,6
1736,l1802,20170523,9195,9195,0,0,0,9175,9175,-20,-20,0,0,6
1737,l1802,20170524,9175,9175,0,0,0,9175,9175,0,0,0,0,6
1738,l1802,20170525,9175,9175,0,0,0,9175,9175,0,0,0,0,6
1739,l1802,20170526,9175,9175,0,0,0,9035,9035,-140,-140,0,0,6
1740,l1802,20170531,9035,9035,8835,8835,8835,8835,8835,-200,-200,6,265050,12
1741,l1802,20170601,8835,8835,0,0,0,8835,8835,0,0,0,0,12
1742,l1802,20170602,8835,8835,0,0,0,8835,8835,0,0,0,0,12
1743,l1802,20170605,8835,8835,0,0,0,8835,8835,0,0,0,0,12
1744,l1802,20170606,8835,8835,8835,8835,8835,8835,8835,0,0,4,176700,8
1745,l1802,20170607,8835,8835,8835,8835,8835,8835,8835,0,0,2,88350,8
1746,l1802,20170608,8835,8835,0,0,0,8835,8835,0,0,0,0,8
1747,l1802,20170609,8835,8835,0,0,0,8835,8835,0,0,0,0,8
1748,l1802,20170612,8835,8835,0,0,0,8955,8955,120,120,0,0,8
1749,l1802,20170613,8955,8955,0,0,0,8945,8945,-10,-10,0,0,8
1750,l1802,20170614,8945,8945,0,0,0,8835,8835,-110,-110,0,0,8
1751,l1802,20170615,8835,8835,0,0,0,8785,8785,-50,-50,0,0,8
1752,l1802,20170616,8785,8785,8705,8780,8700,8780,8740,-5,-45,8,349600,8
1753,l1802,20170619,8780,8740,0,0,0,8750,8750,10,10,0,0,8
1754,l1802,20170620,8750,8750,0,0,0,8750,8750,0,0,0,0,8
1755,l1802,20170621,8750,8750,0,0,0,8750,8750,0,0,0,0,8
1756,l1802,20170622,8750,8750,0,0,0,8665,8665,-85,-85,0,0,8
1757,l1802,20170623,8665,8665,8710,8710,8620,8625,8675,-40,10,16,694150,18
1758,l1802,20170626,8625,8675,0,0,0,8675,8675,0,0,0,0,18
1759,l1802,20170627,8675,8675,8715,8715,8680,8680,8705,5,30,10,435400,8
1760,l1802,20170628,8680,8705,0,0,0,8705,8705,0,0,0,0,8
1761,l1802,20170629,8705,8705,0,0,0,8800,8800,95,95,0,0,8
1762,l1802,20170630,8800,8800,0,0,0,8820,8820,20,20,0,0,8
1763,l1802,20170703,8820,8820,0,0,0,8875,8875,55,55,0,0,8
1764,l1802,20170704,8875,8875,0,0,0,8740,8740,-135,-135,0,0,8
1765,l1802,20170705,8740,8740,0,0,0,8740,8740,0,0,0,0,8
1766,l1802,20170706,8740,8740,0,0,0,8760,8760,20,20,0,0,8
1767,l1802,20170707,8760,8760,8840,8840,8840,8840,8840,80,80,10,442000,14
1768,l1802,20170710,8840,8840,0,0,0,8840,8840,0,0,0,0,14
1769,l1802,20170711,8840,8840,0,0,0,8855,8855,15,15,0,0,14
1770,l1802,20170712,8855,8855,0,0,0,8950,8950,95,95,0,0,14
1771,l1802,20170713,8950,8950,0,0,0,8980,8980,30,30,0,0,14
1772,l1802,20170714,8980,8980,0,0,0,9000,9000,20,20,0,0,14
1773,l1802,20170717,9000,9000,0,0,0,9070,9070,70,70,0,0,14
1774,l1802,20170718,9070,9070,0,0,0,9070,9070,0,0,0,0,14
1775,l1802,20170719,9070,9070,9165,9230,9165,9230,9195,160,125,4,183950,12
1776,l1802,20170720,9230,9195,0,0,0,9520,9520,325,325,0,0,12
1777,l1802,20170721,9520,9520,9630,9745,9630,9745,9685,225,165,12,581250,12
1778,l1802,20170724,9745,9685,0,0,0,9685,9685,0,0,0,0,12
1779,l1802,20170725,9685,9685,0,0,0,9685,9685,0,0,0,0,12
1780,l1802,20170726,9685,9685,0,0,0,9680,9680,-5,-5,0,0,12
1781,l1802,20170727,9680,9680,0,0,0,9590,9590,-90,-90,0,0,12
1782,l1802,20170728,9590,9590,0,0,0,9525,9525,-65,-65,0,0,12
1783,l1802,20170731,9525,9525,0,0,0,9525,9525,0,0,0,0,12
1784,l1802,20170801,9525,9525,9920,9920,9920,9920,9920,395,395,2,99200,12
1785,l1802,20170802,9920,9920,0,0,0,9875,9875,-45,-45,0,0,12
1786,l1802,20170803,9875,9875,0,0,0,9840,9840,-35,-35,0,0,12
1787,l1802,20170804,9840,9840,0,0,0,9900,9900,60,60,0,0,12
1788,l1802,20170807,9900,9900,9480,9525,9480,9525,9500,-375,-400,4,190050,12
1789,l1802,20170808,9525,9500,9765,9765,9765,9765,9765,265,265,2,97650,12
1790,l1802,20170809,9765,9765,9860,9860,9700,9700,9805,-65,40,14,686600,14
1791,l1802,20170810,9700,9805,9800,9800,9645,9705,9715,-100,-90,6,291500,14
1792,l1802,20170811,9705,9715,9550,9550,9550,9550,9550,-165,-165,2,95500,14
1793,l1802,20170814,9550,9550,9440,9440,9440,9440,9440,-110,-110,2,94400,14
1794,l1802,20170815,9440,9440,0,0,0,9440,9440,0,0,0,0,14
1795,l1802,20170816,9440,9440,0,0,0,9490,9490,50,50,0,0,14
1796,l1802,20170817,9490,9490,0,0,0,9490,9490,0,0,0,0,14
1797,l1802,20170818,9490,9490,0,0,0,9490,9490,0,0,0,0,14
1798,l1802,20170821,9490,9490,0,0,0,9510,9510,20,20,0,0,14
1799,l1802,20170822,9510,9510,9950,9985,9950,9985,9965,475,455,4,199350,16
1800,l1802,20170823,9985,9965,10005,10005,10005,10005,10005,40,40,10,500250,6
1801,l1802,20170824,10005,10005,0,0,0,10010,10010,5,5,0,0,6
1802,l1802,20170825,10010,10010,0,0,0,10010,10010,0,0,0,0,6
1803,l1802,20170828,10010,10010,9725,9965,9725,9955,9795,-55,-215,142,6957900,56
1804,l1802,20170829,9955,9795,10040,10110,10040,10070,10060,275,265,86,4327350,10
1805,l1802,20170830,10070,10060,9995,9995,9995,9995,9995,-65,-65,2,99950,8
1806,l1802,20170831,9995,9995,0,0,0,10085,10085,90,90,0,0,8
1807,l1802,20170901,10085,10085,0,0,0,10180,10180,95,95,0,0,8
1808,l1802,20170904,10180,10180,10400,10400,10400,10400,10400,220,220,2,104000,10
1809,l1802,20170905,10400,10400,10565,10565,10405,10405,10485,5,85,4,209700,10
1810,l1802,20170906,10405,10485,0,0,0,10390,10390,-95,-95,0,0,10
1811,l1802,20170907,10390,10390,10125,10125,10055,10055,10090,-335,-300,4,201800,10
1812,l1802,20170908,10055,10090,0,0,0,9990,9990,-100,-100,0,0,10
1813,l1802,20170911,9990,9990,0,0,0,9990,9990,0,0,0,0,10
1814,l1802,20170912,9990,9990,0,0,0,10145,10145,155,155,0,0,10
1815,l1802,20170913,10145,10145,0,0,0,10035,10035,-110,-110,0,0,10
1816,l1802,20170914,10035,10035,9935,9935,9790,9790,9880,-245,-155,8,395300,10
1817,l1802,20170915,9790,9880,9665,9665,9665,9665,9665,-215,-215,2,96650,8
1818,l1802,20170918,9665,9665,9740,9740,9740,9740,9740,75,75,2,97400,10
1819,l1802,20170919,9740,9740,0,0,0,9740,9740,0,0,0,0,10
1820,l1802,20170920,9740,9740,0,0,0,9700,9700,-40,-40,0,0,10
1821,l1802,20170921,9700,9700,0,0,0,9700,9700,0,0,0,0,10
1822,l1802,20170922,9700,9700,0,0,0,9675,9675,-25,-25,0,0,10
1823,l1802,20170925,9675,9675,0,0,0,9695,9695,20,20,0,0,10
1824,l1802,20170926,9695,9695,0,0,0,9695,9695,0,0,0,0,10
1825,l1802,20170927,9695,9695,0,0,0,9715,9715,20,20,0,0,10
1826,l1802,20170928,9715,9715,0,0,0,9470,9470,-245,-245,0,0,10
1827,l1802,20170929,9470,9470,0,0,0,9470,9470,0,0,0,0,10
1828,l1802,20171009,9470,9470,0,0,0,9470,9470,0,0,0,0,10
1829,l1802,20171010,9470,9470,0,0,0,9475,9475,5,5,0,0,10
1830,l1802,20171011,9475,9475,0,0,0,9395,9395,-80,-80,0,0,10
1831,l1802,20171012,9395,9395,0,0,0,9395,9395,0,0,0,0,10
1832,l1802,20171013,9395,9395,0,0,0,9395,9395,0,0,0,0,10
1833,l1802,20171016,9395,9395,0,0,0,9395,9395,0,0,0,0,10
1834,l1802,20171017,9395,9395,9730,9730,9730,9730,9730,335,335,2,97300,8
1835,l1802,20171018,9730,9730,0,0,0,9730,9730,0,0,0,0,8
1836,l1802,20171019,9730,9730,9680,9680,9615,9615,9660,-115,-70,52,2511750,8
1837,l1802,20171020,9615,9660,0,0,0,9775,9775,115,115,0,0,8
1838,l1802,20171023,9775,9775,0,0,0,9775,9775,0,0,0,0,8
1839,l1802,20171024,9775,9775,0,0,0,9775,9775,0,0,0,0,8
1840,l1802,20171025,9775,9775,0,0,0,9775,9775,0,0,0,0,8
1841,l1802,20171026,9775,9775,0,0,0,9750,9750,-25,-25,0,0,8
1842,l1802,20171027,9750,9750,0,0,0,9750,9750,0,0,0,0,8
1843,l1802,20171030,9750,9750,0,0,0,9750,9750,0,0,0,0,8
1844,l1802,20171031,9750,9750,0,0,0,9640,9640,-110,-110,0,0,8
1845,l1802,20171101,9640,9640,0,0,0,9675,9675,35,35,0,0,8
1846,l1802,20171102,9675,9675,0,0,0,9675,9675,0,0,0,0,8
1847,l1802,20171103,9675,9675,9510,9605,9510,9605,9520,-70,-155,46,2190100,48
1848,l1802,20171106,9605,9520,0,0,0,9640,9640,120,120,0,0,48
1849,l1802,20171107,9640,9640,9810,9810,9810,9810,9810,170,170,2,98100,48
1850,l1802,20171108,9810,9810,9805,9805,9805,9805,9805,-5,-5,2,98050,48
1851,l1802,20171109,9805,9805,0,0,0,9805,9805,0,0,0,0,48
1852,l1802,20171110,9805,9805,0,0,0,9730,9730,-75,-75,0,0,48
1853,l1802,20171113,9730,9730,0,0,0,9730,9730,0,0,0,0,48
1854,l1802,20171114,9730,9730,0,0,0,9730,9730,0,0,0,0,48
1855,l1802,20171115,9730,9730,9650,9650,9650,9650,9650,-80,-80,2,96500,48
1856,l1802,20171116,9650,9650,9550,9605,9530,9545,9545,-105,-105,44,2100100,8
1857,l1802,20171117,9545,9545,0,0,0,9545,9545,0,0,0,0,8
1858,l1802,20171120,9545,9545,0,0,0,9545,9545,0,0,0,0,8
1859,l1802,20171121,9545,9545,9640,9640,9640,9640,9640,95,95,2,96400,8
1860,l1802,20171122,9640,9640,0,0,0,9640,9640,0,0,0,0,8
1861,l1802,20171123,9640,9640,0,0,0,9640,9640,0,0,0,0,8
1862,l1802,20171124,9640,9640,0,0,0,9590,9590,-50,-50,0,0,8
1863,l1802,20171127,9590,9590,9590,9590,9590,9590,9590,0,0,2,95900,6
1864,l1802,20171128,9590,9590,0,0,0,9410,9410,-180,-180,0,0,6
1865,l1802,20171129,9410,9410,0,0,0,9410,9410,0,0,0,0,6
1866,l1802,20171130,9410,9410,9510,9510,9510,9510,9510,100,100,2,95100,8
1867,l1802,20171201,9510,9510,0,0,0,9570,9570,60,60,0,0,8
1868,l1802,20171204,9570,9570,9790,9790,9790,9790,9790,220,220,2,97900,6
1869,l1802,20171205,9790,9790,0,0,0,9780,9780,-10,-10,0,0,6
1870,l1802,20171206,9780,9780,0,0,0,9715,9715,-65,-65,0,0,6
1871,l1802,20171207,9715,9715,0,0,0,9580,9580,-135,-135,0,0,6
1872,l1802,20171208,9580,9580,0,0,0,9580,9580,0,0,0,0,6
1873,l1802,20171211,9580,9580,0,0,0,9580,9580,0,0,0,0,6
1874,l1802,20171212,9580,9580,0,0,0,9610,9610,30,30,0,0,6
1875,l1802,20171213,9610,9610,0,0,0,9560,9560,-50,-50,0,0,6
1876,l1802,20171214,9560,9560,0,0,0,9560,9560,0,0,0,0,6
1877,l1802,20171215,9560,9560,0,0,0,9530,9530,-30,-30,0,0,6
1878,l1802,20171218,9530,9530,0,0,0,9530,9530,0,0,0,0,6
1879,l1802,20171219,9530,9530,0,0,0,9565,9565,35,35,0,0,6
1880,l1802,20171220,9565,9565,0,0,0,9590,9590,25,25,0,0,6
1881,l1802,20171221,9590,9590,0,0,0,9585,9585,-5,-5,0,0,6
1882,l1802,20171222,9585,9585,9760,9785,9395,9555,9575,-30,-10,48,2298750,4
1883,l1802,20171225,9555,9575,0,0,0,9520,9520,-55,-55,0,0,4
1884,l1802,20171226,9520,9520,0,0,0,9500,9500,-20,-20,0,0,4
1885,l1802,20171227,9500,9500,0,0,0,9575,9575,75,75,0,0,4
1886,l1802,20171228,9575,9575,0,0,0,9585,9585,10,10,0,0,4
1887,l1802,20171229,9585,9585,0,0,0,9575,9575,-10,-10,0,0,4
1888,l1803,20170315,9270,9270,0,0,0,9270,9270,0,0,0,0,0
1889,l1803,20170316,9270,9270,0,0,0,9270,9270,0,0,0,0,0
1890,l1803,20170317,9270,9270,0,0,0,9270,9270,0,0,0,0,0
1891,l1803,20170320,9270,9270,9435,9545,9435,9545,9490,275,220,4,189800,0
1892,l1803,20170321,9545,9490,0,0,0,9490,9490,0,0,0,0,0
1893,l1803,20170322,9490,9490,0,0,0,9295,9295,-195,-195,0,0,0
1894,l1803,20170323,9295,9295,0,0,0,9295,9295,0,0,0,0,0
1895,l1803,20170324,9295,9295,0,0,0,9170,9170,-125,-125,0,0,0
1896,l1803,20170327,9170,9170,0,0,0,8925,8925,-245,-245,0,0,0
1897,l1803,20170328,8925,8925,0,0,0,8955,8955,30,30,0,0,0
1898,l1803,20170329,8955,8955,0,0,0,9045,9045,90,90,0,0,0
1899,l1803,20170330,9045,9045,0,0,0,9045,9045,0,0,0,0,0
1900,l1803,20170331,9045,9045,0,0,0,9045,9045,0,0,0,0,0
1901,l1803,20170405,9045,9045,0,0,0,9045,9045,0,0,0,0,0
1902,l1803,20170406,9045,9045,0,0,0,9200,9200,155,155,0,0,0
1903,l1803,20170407,9200,9200,0,0,0,9260,9260,60,60,0,0,0
1904,l1803,20170410,9260,9260,0,0,0,9125,9125,-135,-135,0,0,0
1905,l1803,20170411,9125,9125,0,0,0,9125,9125,0,0,0,0,0
1906,l1803,20170412,9125,9125,0,0,0,9060,9060,-65,-65,0,0,0
1907,l1803,20170413,9060,9060,0,0,0,8995,8995,-65,-65,0,0,0
1908,l1803,20170414,8995,8995,0,0,0,8785,8785,-210,-210,0,0,0
1909,l1803,20170417,8785,8785,8880,8880,8880,8880,8880,95,95,2,88800,2
1910,l1803,20170418,8880,8880,0,0,0,8840,8840,-40,-40,0,0,2
1911,l1803,20170419,8840,8840,0,0,0,8805,8805,-35,-35,0,0,2
1912,l1803,20170420,8805,8805,0,0,0,8820,8820,15,15,0,0,2
1913,l1803,20170421,8820,8820,0,0,0,8900,8900,80,80,0,0,2
1914,l1803,20170424,8900,8900,0,0,0,8705,8705,-195,-195,0,0,2
1915,l1803,20170425,8705,8705,0,0,0,8740,8740,35,35,0,0,2
1916,l1803,20170426,8740,8740,0,0,0,8530,8530,-210,-210,0,0,2
1917,l1803,20170427,8530,8530,0,0,0,8585,8585,55,55,0,0,2
1918,l1803,20170428,8585,8585,0,0,0,8765,8765,180,180,0,0,2
1919,l1803,20170502,8765,8765,0,0,0,8790,8790,25,25,0,0,2
1920,l1803,20170503,8790,8790,8760,8875,8760,8875,8815,85,25,4,176350,4
1921,l1803,20170504,8875,8815,0,0,0,8815,8815,0,0,0,0,4
1922,l1803,20170505,8815,8815,0,0,0,8800,8800,-15,-15,0,0,4
1923,l1803,20170508,8800,8800,0,0,0,8925,8925,125,125,0,0,4
1924,l1803,20170509,8925,8925,0,0,0,8840,8840,-85,-85,0,0,4
1925,l1803,20170510,8840,8840,0,0,0,8725,8725,-115,-115,0,0,4
1926,l1803,20170511,8725,8725,0,0,0,8725,8725,0,0,0,0,4
1927,l1803,20170512,8725,8725,0,0,0,8725,8725,0,0,0,0,4
1928,l1803,20170515,8725,8725,0,0,0,8870,8870,145,145,0,0,4
1929,l1803,20170516,8870,8870,0,0,0,8980,8980,110,110,0,0,4
1930,l1803,20170517,8980,8980,0,0,0,9025,9025,45,45,0,0,4
1931,l1803,20170518,9025,9025,0,0,0,9040,9040,15,15,0,0,4
1932,l1803,20170519,9040,9040,0,0,0,9215,9215,175,175,0,0,4
1933,l1803,20170522,9215,9215,0,0,0,9230,9230,15,15,0,0,4
1934,l1803,20170523,9230,9230,0,0,0,9230,9230,0,0,0,0,4
1935,l1803,20170524,9230,9230,0,0,0,9145,9145,-85,-85,0,0,4
1936,l1803,20170525,9145,9145,0,0,0,9145,9145,0,0,0,0,4
1937,l1803,20170526,9145,9145,0,0,0,9010,9010,-135,-135,0,0,4
1938,l1803,20170531,9010,9010,0,0,0,8815,8815,-195,-195,0,0,4
1939,l1803,20170601,8815,8815,0,0,0,8815,8815,0,0,0,0,4
1940,l1803,20170602,8815,8815,0,0,0,8730,8730,-85,-85,0,0,4
1941,l1803,20170605,8730,8730,0,0,0,8610,8610,-120,-120,0,0,4
1942,l1803,20170606,8610,8610,0,0,0,8610,8610,0,0,0,0,4
1943,l1803,20170607,8610,8610,0,0,0,8610,8610,0,0,0,0,4
1944,l1803,20170608,8610,8610,0,0,0,8590,8590,-20,-20,0,0,4
1945,l1803,20170609,8590,8590,0,0,0,8625,8625,35,35,0,0,4
1946,l1803,20170612,8625,8625,0,0,0,8740,8740,115,115,0,0,4
1947,l1803,20170613,8740,8740,0,0,0,8735,8735,-5,-5,0,0,4
1948,l1803,20170614,8735,8735,0,0,0,8630,8630,-105,-105,0,0,4
1949,l1803,20170615,8630,8630,0,0,0,8585,8585,-45,-45,0,0,4
1950,l1803,20170616,8585,8585,0,0,0,8545,8545,-40,-40,0,0,4
1951,l1803,20170619,8545,8545,0,0,0,8555,8555,10,10,0,0,4
1952,l1803,20170620,8555,8555,0,0,0,8540,8540,-15,-15,0,0,4
1953,l1803,20170621,8540,8540,0,0,0,8510,8510,-30,-30,0,0,4
1954,l1803,20170622,8510,8510,0,0,0,8430,8430,-80,-80,0,0,4
1955,l1803,20170623,8430,8430,0,0,0,8435,8435,5,5,0,0,4
1956,l1803,20170626,8435,8435,0,0,0,8515,8515,80,80,0,0,4
1957,l1803,20170627,8515,8515,0,0,0,8540,8540,25,25,0,0,4
1958,l1803,20170628,8540,8540,0,0,0,8540,8540,0,0,0,0,4
1959,l1803,20170629,8540,8540,0,0,0,8635,8635,95,95,0,0,4
1960,l1803,20170630,8635,8635,0,0,0,8655,8655,20,20,0,0,4
1961,l1803,20170703,8655,8655,0,0,0,8710,8710,55,55,0,0,4
1962,l1803,20170704,8710,8710,0,0,0,8710,8710,0,0,0,0,4
1963,l1803,20170705,8710,8710,0,0,0,8710,8710,0,0,0,0,4
1964,l1803,20170706,8710,8710,0,0,0,8730,8730,20,20,0,0,4
1965,l1803,20170707,8730,8730,0,0,0,8805,8805,75,75,0,0,4
1966,l1803,20170710,8805,8805,0,0,0,8805,8805,0,0,0,0,4
1967,l1803,20170711,8805,8805,8840,8855,8840,8855,8845,50,40,4,176950,2
1968,l1803,20170712,8855,8845,0,0,0,8940,8940,95,95,0,0,2
1969,l1803,20170713,8940,8940,0,0,0,8970,8970,30,30,0,0,2
1970,l1803,20170714,8970,8970,0,0,0,8990,8990,20,20,0,0,2
1971,l1803,20170717,8990,8990,0,0,0,9060,9060,70,70,0,0,2
1972,l1803,20170718,9060,9060,0,0,0,9060,9060,0,0,0,0,2
1973,l1803,20170719,9060,9060,0,0,0,9180,9180,120,120,0,0,2
1974,l1803,20170720,9180,9180,9635,9635,9635,9635,9635,455,455,2,96350,4
1975,l1803,20170721,9635,9635,0,0,0,9800,9800,165,165,0,0,4
1976,l1803,20170724,9800,9800,0,0,0,9865,9865,65,65,0,0,4
1977,l1803,20170725,9865,9865,0,0,0,9865,9865,0,0,0,0,4
1978,l1803,20170726,9865,9865,0,0,0,9855,9855,-10,-10,0,0,4
1979,l1803,20170727,9855,9855,0,0,0,9760,9760,-95,-95,0,0,4
1980,l1803,20170728,9760,9760,0,0,0,9690,9690,-70,-70,0,0,4
1981,l1803,20170731,9690,9690,0,0,0,9680,9680,-10,-10,0,0,4
1982,l1803,20170801,9680,9680,0,0,0,9680,9680,0,0,0,0,4
1983,l1803,20170802,9680,9680,9615,9690,9615,9690,9650,10,-30,4,193050,4
1984,l1803,20170803,9690,9650,0,0,0,9615,9615,-35,-35,0,0,4
1985,l1803,20170804,9615,9615,0,0,0,9670,9670,55,55,0,0,4
1986,l1803,20170807,9670,9670,0,0,0,9280,9280,-390,-390,0,0,4
1987,l1803,20170808,9280,9280,9740,9740,9740,9740,9740,460,460,2,97400,6
1988,l1803,20170809,9740,9740,0,0,0,9740,9740,0,0,0,0,6
1989,l1803,20170810,9740,9740,0,0,0,9655,9655,-85,-85,0,0,6
1990,l1803,20170811,9655,9655,0,0,0,9495,9495,-160,-160,0,0,6
1991,l1803,20170814,9495,9495,0,0,0,9495,9495,0,0,0,0,6
1992,l1803,20170815,9495,9495,0,0,0,9350,9350,-145,-145,0,0,6
1993,l1803,20170816,9350,9350,0,0,0,9395,9395,45,45,0,0,6
1994,l1803,20170817,9395,9395,0,0,0,9575,9575,180,180,0,0,6
1995,l1803,20170818,9575,9575,0,0,0,9610,9610,35,35,0,0,6
1996,l1803,20170821,9610,9610,0,0,0,9720,9720,110,110,0,0,6
1997,l1803,20170822,9720,9720,0,0,0,10185,10185,465,465,0,0,6
1998,l1803,20170823,10185,10185,0,0,0,10225,10225,40,40,0,0,6
1999,l1803,20170824,10225,10225,0,0,0,10230,10230,5,5,0,0,6
2000,l1803,20170825,10230,10230,0,0,0,10320,10320,90,90,0,0,6
2001,l1803,20170828,10320,10320,0,0,0,10320,10320,0,0,0,0,6
2002,l1803,20170829,10320,10320,0,0,0,10595,10595,275,275,0,0,6
2003,l1803,20170830,10595,10595,0,0,0,10530,10530,-65,-65,0,0,6
2004,l1803,20170831,10530,10530,0,0,0,10625,10625,95,95,0,0,6
2005,l1803,20170901,10625,10625,0,0,0,10750,10750,125,125,0,0,6
2006,l1803,20170904,10750,10750,0,0,0,10980,10980,230,230,0,0,6
2007,l1803,20170905,10980,10980,0,0,0,11065,11065,85,85,0,0,6
2008,l1803,20170906,11065,11065,0,0,0,10965,10965,-100,-100,0,0,6
2009,l1803,20170907,10965,10965,0,0,0,10650,10650,-315,-315,0,0,6
2010,l1803,20170908,10650,10650,10145,10190,10145,10190,10165,-460,-485,6,305000,4
2011,l1803,20170911,10190,10165,0,0,0,10045,10045,-120,-120,0,0,4
2012,l1803,20170912,10045,10045,0,0,0,10200,10200,155,155,0,0,4
2013,l1803,20170913,10200,10200,9970,10180,9765,9765,9970,-435,-230,8,398950,6
2014,l1803,20170914,9765,9970,0,0,0,9820,9820,-150,-150,0,0,6
2015,l1803,20170915,9820,9820,9805,9805,9805,9805,9805,-15,-15,2,98050,4
2016,l1803,20170918,9805,9805,0,0,0,9805,9805,0,0,0,0,4
2017,l1803,20170919,9805,9805,0,0,0,9805,9805,0,0,0,0,4
2018,l1803,20170920,9805,9805,0,0,0,9760,9760,-45,-45,0,0,4
2019,l1803,20170921,9760,9760,9490,9490,9490,9490,9490,-270,-270,2,94900,6
2020,l1803,20170922,9490,9490,0,0,0,9490,9490,0,0,0,0,6
2021,l1803,20170925,9490,9490,0,0,0,9505,9505,15,15,0,0,6
2022,l1803,20170926,9505,9505,0,0,0,9580,9580,75,75,0,0,6
2023,l1803,20170927,9580,9580,0,0,0,9580,9580,0,0,0,0,6
2024,l1803,20170928,9580,9580,0,0,0,9340,9340,-240,-240,0,0,6
2025,l1803,20170929,9340,9340,0,0,0,9395,9395,55,55,0,0,6
2026,l1803,20171009,9395,9395,0,0,0,9395,9395,0,0,0,0,6
2027,l1803,20171010,9395,9395,0,0,0,9395,9395,0,0,0,0,6
2028,l1803,20171011,9395,9395,0,0,0,9315,9315,-80,-80,0,0,6
2029,l1803,20171012,9315,9315,0,0,0,9290,9290,-25,-25,0,0,6
2030,l1803,20171013,9290,9290,9535,9535,9535,9535,9535,245,245,2,95350,8
2031,l1803,20171016,9535,9535,0,0,0,9615,9615,80,80,0,0,8
2032,l1803,20171017,9615,9615,0,0,0,9955,9955,340,340,0,0,8
2033,l1803,20171018,9955,9955,0,0,0,10020,10020,65,65,0,0,8
2034,l1803,20171019,10020,10020,0,0,0,9950,9950,-70,-70,0,0,8
2035,l1803,20171020,9950,9950,0,0,0,9950,9950,0,0,0,0,8
2036,l1803,20171023,9950,9950,9835,9835,9835,9835,9835,-115,-115,2,98350,6
2037,l1803,20171024,9835,9835,0,0,0,9835,9835,0,0,0,0,6
2038,l1803,20171025,9835,9835,0,0,0,9835,9835,0,0,0,0,6
2039,l1803,20171026,9835,9835,0,0,0,9810,9810,-25,-25,0,0,6
2040,l1803,20171027,9810,9810,0,0,0,9810,9810,0,0,0,0,6
2041,l1803,20171030,9810,9810,0,0,0,9725,9725,-85,-85,0,0,6
2042,l1803,20171031,9725,9725,0,0,0,9615,9615,-110,-110,0,0,6
2043,l1803,20171101,9615,9615,0,0,0,9650,9650,35,35,0,0,6
2044,l1803,20171102,9650,9650,0,0,0,9650,9650,0,0,0,0,6
2045,l1803,20171103,9650,9650,0,0,0,9650,9650,0,0,0,0,6
2046,l1803,20171106,9650,9650,0,0,0,9770,9770,120,120,0,0,6
2047,l1803,20171107,9770,9770,0,0,0,9940,9940,170,170,0,0,6
2048,l1803,20171108,9940,9940,0,0,0,9935,9935,-5,-5,0,0,6
2049,l1803,20171109,9935,9935,0,0,0,9985,9985,50,50,0,0,6
2050,l1803,20171110,9985,9985,0,0,0,9905,9905,-80,-80,0,0,6
2051,l1803,20171113,9905,9905,0,0,0,9840,9840,-65,-65,0,0,6
2052,l1803,20171114,9840,9840,0,0,0,9840,9840,0,0,0,0,6
2053,l1803,20171115,9840,9840,0,0,0,9760,9760,-80,-80,0,0,6
2054,l1803,20171116,9760,9760,9615,9615,9535,9535,9575,-225,-185,4,191500,6
2055,l1803,20171117,9535,9575,0,0,0,9575,9575,0,0,0,0,6
2056,l1803,20171120,9575,9575,0,0,0,9660,9660,85,85,0,0,6
2057,l1803,20171121,9660,9660,0,0,0,9755,9755,95,95,0,0,6
2058,l1803,20171122,9755,9755,0,0,0,9755,9755,0,0,0,0,6
2059,l1803,20171123,9755,9755,0,0,0,9755,9755,0,0,0,0,6
2060,l1803,20171124,9755,9755,0,0,0,9755,9755,0,0,0,0,6
2061,l1803,20171127,9755,9755,0,0,0,9755,9755,0,0,0,0,6
2062,l1803,20171128,9755,9755,9445,9445,9445,9445,9445,-310,-310,2,94450,8
2063,l1803,20171129,9445,9445,0,0,0,9470,9470,25,25,0,0,8
2064,l1803,20171130,9470,9470,0,0,0,9570,9570,100,100,0,0,8
2065,l1803,20171201,9570,9570,9520,9520,9510,9510,9515,-60,-55,10,475750,16
2066,l1803,20171204,9510,9515,9635,9700,9635,9700,9670,185,155,6,290200,10
2067,l1803,20171205,9700,9670,9705,9705,9700,9700,9700,30,30,4,194050,6
2068,l1803,20171206,9700,9700,0,0,0,9640,9640,-60,-60,0,0,6
2069,l1803,20171207,9640,9640,0,0,0,9510,9510,-130,-130,0,0,6
2070,l1803,20171208,9510,9510,0,0,0,9555,9555,45,45,0,0,6
2071,l1803,20171211,9555,9555,9560,9725,9560,9725,9620,170,65,8,384900,6
2072,l1803,20171212,9725,9620,0,0,0,9620,9620,0,0,0,0,6
2073,l1803,20171213,9620,9620,0,0,0,9570,9570,-50,-50,0,0,6
2074,l1803,20171214,9570,9570,0,0,0,9570,9570,0,0,0,0,6
2075,l1803,20171215,9570,9570,0,0,0,9540,9540,-30,-30,0,0,6
2076,l1803,20171218,9540,9540,9645,9645,9420,9490,9540,-50,0,48,2290450,6
2077,l1803,20171219,9490,9540,0,0,0,9575,9575,35,35,0,0,6
2078,l1803,20171220,9575,9575,0,0,0,9600,9600,25,25,0,0,6
2079,l1803,20171221,9600,9600,0,0,0,9595,9595,-5,-5,0,0,6
2080,l1803,20171222,9595,9595,9640,9640,9640,9640,9640,45,45,2,96400,8
2081,l1803,20171225,9640,9640,9630,9630,9630,9630,9630,-10,-10,2,96300,10
2082,l1803,20171226,9630,9630,0,0,0,9630,9630,0,0,0,0,10
2083,l1803,20171227,9630,9630,9755,9755,9755,9755,9755,125,125,2,97550,12
2084,l1803,20171228,9755,9755,0,0,0,9765,9765,10,10,0,0,12
2085,l1803,20171229,9765,9765,0,0,0,9765,9765,0,0,0,0,12
2086,l1804,20170419,8840,8840,0,0,0,8840,8840,0,0,0,0,0
2087,l1804,20170420,8840,8840,0,0,0,8840,8840,0,0,0,0,0
2088,l1804,20170421,8840,8840,0,0,0,8840,8840,0,0,0,0,0
2089,l1804,20170424,8840,8840,0,0,0,8650,8650,-190,-190,0,0,0
2090,l1804,20170425,8650,8650,0,0,0,8650,8650,0,0,0,0,0
2091,l1804,20170426,8650,8650,0,0,0,8650,8650,0,0,0,0,0
2092,l1804,20170427,8650,8650,0,0,0,8650,8650,0,0,0,0,0
2093,l1804,20170428,8650,8650,0,0,0,8650,8650,0,0,0,0,0
2094,l1804,20170502,8650,8650,0,0,0,8650,8650,0,0,0,0,0
2095,l1804,20170503,8650,8650,0,0,0,8650,8650,0,0,0,0,0
2096,l1804,20170504,8650,8650,0,0,0,8650,8650,0,0,0,0,0
2097,l1804,20170505,8650,8650,0,0,0,8650,8650,0,0,0,0,0
2098,l1804,20170508,8650,8650,0,0,0,8650,8650,0,0,0,0,0
2099,l1804,20170509,8650,8650,0,0,0,8650,8650,0,0,0,0,0
2100,l1804,20170510,8650,8650,0,0,0,8650,8650,0,0,0,0,0
2101,l1804,20170511,8650,8650,0,0,0,8650,8650,0,0,0,0,0
2102,l1804,20170512,8650,8650,0,0,0,8650,8650,0,0,0,0,0
2103,l1804,20170515,8650,8650,0,0,0,8795,8795,145,145,0,0,0
2104,l1804,20170516,8795,8795,0,0,0,8905,8905,110,110,0,0,0
2105,l1804,20170517,8905,8905,0,0,0,8905,8905,0,0,0,0,0
2106,l1804,20170518,8905,8905,0,0,0,8905,8905,0,0,0,0,0
2107,l1804,20170519,8905,8905,0,0,0,9080,9080,175,175,0,0,0
2108,l1804,20170522,9080,9080,0,0,0,9080,9080,0,0,0,0,0
2109,l1804,20170523,9080,9080,0,0,0,9080,9080,0,0,0,0,0
2110,l1804,20170524,9080,9080,0,0,0,9080,9080,0,0,0,0,0
2111,l1804,20170525,9080,9080,0,0,0,9080,9080,0,0,0,0,0
2112,l1804,20170526,9080,9080,0,0,0,9080,9080,0,0,0,0,0
2113,l1804,20170531,9080,9080,0,0,0,9080,9080,0,0,0,0,0
2114,l1804,20170601,9080,9080,0,0,0,9080,9080,0,0,0,0,0
2115,l1804,20170602,9080,9080,0,0,0,9080,9080,0,0,0,0,0
2116,l1804,20170605,9080,9080,0,0,0,9080,9080,0,0,0,0,0
2117,l1804,20170606,9080,9080,0,0,0,9080,9080,0,0,0,0,0
2118,l1804,20170607,9080,9080,0,0,0,9080,9080,0,0,0,0,0
2119,l1804,20170608,9080,9080,0,0,0,9080,9080,0,0,0,0,0
2120,l1804,20170609,9080,9080,0,0,0,9080,9080,0,0,0,0,0
2121,l1804,20170612,9080,9080,0,0,0,9080,9080,0,0,0,0,0
2122,l1804,20170613,9080,9080,0,0,0,9080,9080,0,0,0,0,0
2123,l1804,20170614,9080,9080,0,0,0,9080,9080,0,0,0,0,0
2124,l1804,20170615,9080,9080,0,0,0,9030,9030,-50,-50,0,0,0
2125,l1804,20170616,9030,9030,0,0,0,9030,9030,0,0,0,0,0
2126,l1804,20170619,9030,9030,0,0,0,9030,9030,0,0,0,0,0
2127,l1804,20170620,9030,9030,0,0,0,9030,9030,0,0,0,0,0
2128,l1804,20170621,9030,9030,0,0,0,9030,9030,0,0,0,0,0
2129,l1804,20170622,9030,9030,0,0,0,8945,8945,-85,-85,0,0,0
2130,l1804,20170623,8945,8945,0,0,0,8945,8945,0,0,0,0,0
2131,l1804,20170626,8945,8945,0,0,0,8945,8945,0,0,0,0,0
2132,l1804,20170627,8945,8945,0,0,0,8945,8945,0,0,0,0,0
2133,l1804,20170628,8945,8945,0,0,0,8945,8945,0,0,0,0,0
2134,l1804,20170629,8945,8945,0,0,0,8945,8945,0,0,0,0,0
2135,l1804,20170630,8945,8945,0,0,0,8945,8945,0,0,0,0,0
2136,l1804,20170703,8945,8945,0,0,0,8945,8945,0,0,0,0,0
2137,l1804,20170704,8945,8945,0,0,0,8945,8945,0,0,0,0,0
2138,l1804,20170705,8945,8945,0,0,0,8945,8945,0,0,0,0,0
2139,l1804,20170706,8945,8945,0,0,0,8945,8945,0,0,0,0,0
2140,l1804,20170707,8945,8945,0,0,0,8945,8945,0,0,0,0,0
2141,l1804,20170710,8945,8945,0,0,0,8945,8945,0,0,0,0,0
2142,l1804,20170711,8945,8945,0,0,0,8945,8945,0,0,0,0,0
2143,l1804,20170712,8945,8945,0,0,0,8945,8945,0,0,0,0,0
2144,l1804,20170713,8945,8945,0,0,0,8945,8945,0,0,0,0,0
2145,l1804,20170714,8945,8945,0,0,0,8945,8945,0,0,0,0,0
2146,l1804,20170717,8945,8945,0,0,0,8945,8945,0,0,0,0,0
2147,l1804,20170718,8945,8945,0,0,0,8945,8945,0,0,0,0,0
2148,l1804,20170719,8945,8945,9245,9245,9245,9245,9245,300,300,2,92450,2
2149,l1804,20170720,9245,9245,0,0,0,9700,9700,455,455,0,0,2
2150,l1804,20170721,9700,9700,0,0,0,9865,9865,165,165,0,0,2
2151,l1804,20170724,9865,9865,0,0,0,9930,9930,65,65,0,0,2
2152,l1804,20170725,9930,9930,0,0,0,9930,9930,0,0,0,0,2
2153,l1804,20170726,9930,9930,0,0,0,9920,9920,-10,-10,0,0,2
2154,l1804,20170727,9920,9920,0,0,0,9825,9825,-95,-95,0,0,2
2155,l1804,20170728,9825,9825,0,0,0,9755,9755,-70,-70,0,0,2
2156,l1804,20170731,9755,9755,9495,9495,9495,9495,9495,-260,-260,2,94950,0
2157,l1804,20170801,9495,9495,0,0,0,9885,9885,390,390,0,0,0
2158,l1804,20170802,9885,9885,0,0,0,9855,9855,-30,-30,0,0,0
2159,l1804,20170803,9855,9855,0,0,0,9820,9820,-35,-35,0,0,0
2160,l1804,20170804,9820,9820,0,0,0,9880,9880,60,60,0,0,0
2161,l1804,20170807,9880,9880,0,0,0,9485,9485,-395,-395,0,0,0
2162,l1804,20170808,9485,9485,0,0,0,9955,9955,470,470,0,0,0
2163,l1804,20170809,9955,9955,0,0,0,9995,9995,40,40,0,0,0
2164,l1804,20170810,9995,9995,0,0,0,9905,9905,-90,-90,0,0,0
2165,l1804,20170811,9905,9905,0,0,0,9740,9740,-165,-165,0,0,0
2166,l1804,20170814,9740,9740,0,0,0,9630,9630,-110,-110,0,0,0
2167,l1804,20170815,9630,9630,0,0,0,9480,9480,-150,-150,0,0,0
2168,l1804,20170816,9480,9480,0,0,0,9530,9530,50,50,0,0,0
2169,l1804,20170817,9530,9530,0,0,0,9715,9715,185,185,0,0,0
2170,l1804,20170818,9715,9715,0,0,0,9755,9755,40,40,0,0,0
2171,l1804,20170821,9755,9755,0,0,0,9870,9870,115,115,0,0,0
2172,l1804,20170822,9870,9870,0,0,0,10340,10340,470,470,0,0,0
2173,l1804,20170823,10340,10340,0,0,0,10380,10380,40,40,0,0,0
2174,l1804,20170824,10380,10380,0,0,0,10385,10385,5,5,0,0,0
2175,l1804,20170825,10385,10385,0,0,0,10475,10475,90,90,0,0,0
2176,l1804,20170828,10475,10475,0,0,0,10255,10255,-220,-220,0,0,0
2177,l1804,20170829,10255,10255,0,0,0,10530,10530,275,275,0,0,0
2178,l1804,20170830,10530,10530,0,0,0,10465,10465,-65,-65,0,0,0
2179,l1804,20170831,10465,10465,0,0,0,10560,10560,95,95,0,0,0
2180,l1804,20170901,10560,10560,0,0,0,10680,10680,120,120,0,0,0
2181,l1804,20170904,10680,10680,0,0,0,10910,10910,230,230,0,0,0
2182,l1804,20170905,10910,10910,0,0,0,10995,10995,85,85,0,0,0
2183,l1804,20170906,10995,10995,0,0,0,10895,10895,-100,-100,0,0,0
2184,l1804,20170907,10895,10895,0,0,0,10585,10585,-310,-310,0,0,0
2185,l1804,20170908,10585,10585,0,0,0,10105,10105,-480,-480,0,0,0
2186,l1804,20170911,10105,10105,9995,10115,9965,10110,10040,5,-65,12,602450,2
2187,l1804,20170912,10110,10040,0,0,0,10195,10195,155,155,0,0,2
2188,l1804,20170913,10195,10195,10190,10335,10190,10335,10260,140,65,4,205250,2
2189,l1804,20170914,10335,10260,0,0,0,10105,10105,-155,-155,0,0,2
2190,l1804,20170915,10105,10105,0,0,0,10090,10090,-15,-15,0,0,2
2191,l1804,20170918,10090,10090,0,0,0,10165,10165,75,75,0,0,2
2192,l1804,20170919,10165,10165,0,0,0,10165,10165,0,0,0,0,2
2193,l1804,20170920,10165,10165,0,0,0,10120,10120,-45,-45,0,0,2
2194,l1804,20170921,10120,10120,0,0,0,9845,9845,-275,-275,0,0,2
2195,l1804,20170922,9845,9845,0,0,0,9820,9820,-25,-25,0,0,2
2196,l1804,20170925,9820,9820,0,0,0,9840,9840,20,20,0,0,2
2197,l1804,20170926,9840,9840,0,0,0,9920,9920,80,80,0,0,2
2198,l1804,20170927,9920,9920,0,0,0,9940,9940,20,20,0,0,2
2199,l1804,20170928,9940,9940,0,0,0,9690,9690,-250,-250,0,0,2
2200,l1804,20170929,9690,9690,9410,9505,9410,9505,9455,-185,-235,4,189150,2
2201,l1804,20171009,9505,9455,0,0,0,9490,9490,35,35,0,0,2
2202,l1804,20171010,9490,9490,0,0,0,9490,9490,0,0,0,0,2
2203,l1804,20171011,9490,9490,0,0,0,9410,9410,-80,-80,0,0,2
2204,l1804,20171012,9410,9410,9405,9405,9395,9395,9400,-15,-10,10,470050,4
2205,l1804,20171013,9395,9400,0,0,0,9645,9645,245,245,0,0,4
2206,l1804,20171016,9645,9645,0,0,0,9725,9725,80,80,0,0,4
2207,l1804,20171017,9725,9725,0,0,0,9725,9725,0,0,0,0,4
2208,l1804,20171018,9725,9725,0,0,0,9725,9725,0,0,0,0,4
2209,l1804,20171019,9725,9725,0,0,0,9660,9660,-65,-65,0,0,4
2210,l1804,20171020,9660,9660,0,0,0,9775,9775,115,115,0,0,4
2211,l1804,20171023,9775,9775,9835,9835,9835,9835,9835,60,60,2,98350,4
2212,l1804,20171024,9835,9835,0,0,0,9845,9845,10,10,0,0,4
2213,l1804,20171025,9845,9845,0,0,0,9845,9845,0,0,0,0,4
2214,l1804,20171026,9845,9845,0,0,0,9820,9820,-25,-25,0,0,4
2215,l1804,20171027,9820,9820,9745,9745,9745,9745,9745,-75,-75,4,194900,2
2216,l1804,20171030,9745,9745,0,0,0,9660,9660,-85,-85,0,0,2
2217,l1804,20171031,9660,9660,0,0,0,9550,9550,-110,-110,0,0,2
2218,l1804,20171101,9550,9550,0,0,0,9550,9550,0,0,0,0,2
2219,l1804,20171102,9550,9550,0,0,0,9590,9590,40,40,0,0,2
2220,l1804,20171103,9590,9590,0,0,0,9440,9440,-150,-150,0,0,2
2221,l1804,20171106,9440,9440,0,0,0,9560,9560,120,120,0,0,2
2222,l1804,20171107,9560,9560,0,0,0,9725,9725,165,165,0,0,2
2223,l1804,20171108,9725,9725,0,0,0,9725,9725,0,0,0,0,2
2224,l1804,20171109,9725,9725,0,0,0,9770,9770,45,45,0,0,2
2225,l1804,20171110,9770,9770,0,0,0,9695,9695,-75,-75,0,0,2
2226,l1804,20171113,9695,9695,0,0,0,9635,9635,-60,-60,0,0,2
2227,l1804,20171114,9635,9635,0,0,0,9665,9665,30,30,0,0,2
2228,l1804,20171115,9665,9665,0,0,0,9665,9665,0,0,0,0,2
2229,l1804,20171116,9665,9665,0,0,0,9485,9485,-180,-180,0,0,2
2230,l1804,20171117,9485,9485,0,0,0,9475,9475,-10,-10,0,0,2
2231,l1804,20171120,9475,9475,0,0,0,9560,9560,85,85,0,0,2
2232,l1804,20171121,9560,9560,0,0,0,9655,9655,95,95,0,0,2
2233,l1804,20171122,9655,9655,0,0,0,9680,9680,25,25,0,0,2
2234,l1804,20171123,9680,9680,0,0,0,9690,9690,10,10,0,0,2
2235,l1804,20171124,9690,9690,9840,9875,9705,9705,9790,15,100,14,685600,2
2236,l1804,20171127,9705,9790,0,0,0,9790,9790,0,0,0,0,2
2237,l1804,20171128,9790,9790,0,0,0,9480,9480,-310,-310,0,0,2
2238,l1804,20171129,9480,9480,0,0,0,9480,9480,0,0,0,0,2
2239,l1804,20171130,9480,9480,0,0,0,9580,9580,100,100,0,0,2
2240,l1804,20171201,9580,9580,9395,9395,9395,9395,9395,-185,-185,2,93950,0
2241,l1804,20171204,9395,9395,0,0,0,9545,9545,150,150,0,0,0
2242,l1804,20171205,9545,9545,0,0,0,9545,9545,0,0,0,0,0
2243,l1804,20171206,9545,9545,0,0,0,9545,9545,0,0,0,0,0
2244,l1804,20171207,9545,9545,0,0,0,9415,9415,-130,-130,0,0,0
2245,l1804,20171208,9415,9415,0,0,0,9460,9460,45,45,0,0,0
2246,l1804,20171211,9460,9460,0,0,0,9460,9460,0,0,0,0,0
2247,l1804,20171212,9460,9460,0,0,0,9490,9490,30,30,0,0,0
2248,l1804,20171213,9490,9490,0,0,0,9490,9490,0,0,0,0,0
2249,l1804,20171214,9490,9490,0,0,0,9490,9490,0,0,0,0,0
2250,l1804,20171215,9490,9490,0,0,0,9460,9460,-30,-30,0,0,0
2251,l1804,20171218,9460,9460,0,0,0,9460,9460,0,0,0,0,0
2252,l1804,20171219,9460,9460,0,0,0,9495,9495,35,35,0,0,0
2253,l1804,20171220,9495,9495,0,0,0,9520,9520,25,25,0,0,0
2254,l1804,20171221,9520,9520,0,0,0,9515,9515,-5,-5,0,0,0
2255,l1804,20171222,9515,9515,0,0,0,9555,9555,40,40,0,0,0
2256,l1804,20171225,9555,9555,0,0,0,9555,9555,0,0,0,0,0
2257,l1804,20171226,9555,9555,0,0,0,9535,9535,-20,-20,0,0,0
2258,l1804,20171227,9535,9535,0,0,0,9655,9655,120,120,0,0,0
2259,l1804,20171228,9655,9655,0,0,0,9665,9665,10,10,0,0,0
2260,l1804,20171229,9665,9665,0,0,0,9655,9655,-10,-10,0,0,0
2261,l1805,20170516,8795,8795,9045,9065,8950,9065,8985,270,190,356,15994050,314
2262,l1805,20170517,9065,8985,9015,9085,9000,9040,9025,55,40,198,8937600,364
2263,l1805,20170518,9040,9025,9025,9125,8965,9125,9025,100,0,192,8666850,394
2264,l1805,20170519,9125,9025,9130,9315,9130,9265,9205,240,180,316,14549600,412
2265,l1805,20170522,9265,9205,9330,9330,9190,9225,9230,20,25,80,3693700,406
2266,l1805,20170523,9225,9230,9230,9260,9155,9200,9200,-30,-30,388,17854150,544
2267,l1805,20170524,9200,9200,9230,9230,9055,9145,9105,-55,-95,166,7559850,646
2268,l1805,20170525,9145,9105,9145,9215,9075,9080,9140,-25,35,336,15362350,888
2269,l1805,20170526,9080,9140,9025,9035,8945,9000,9005,-140,-135,82,3693750,892
2270,l1805,20170531,9000,9005,9045,9100,8905,8905,9030,-100,25,280,12642350,928
2271,l1805,20170601,8905,9030,8930,9100,8930,9080,9040,50,10,198,8952400,922
2272,l1805,20170602,9080,9040,9070,9070,8815,8825,8935,-215,-105,350,15643100,1098
2273,l1805,20170605,8825,8935,8855,8875,8770,8775,8810,-160,-125,452,19910900,1410
2274,l1805,20170606,8775,8810,8790,8830,8745,8800,8785,-10,-25,546,23994250,1470
2275,l1805,20170607,8800,8785,8830,8830,8725,8760,8760,-25,-25,236,10339900,1592
2276,l1805,20170608,8760,8760,8705,8825,8650,8770,8700,10,-60,830,36111850,1744
2277,l1805,20170609,8770,8700,8750,8800,8720,8740,8765,40,65,214,9381350,1816
2278,l1805,20170612,8740,8765,8790,8915,8790,8870,8865,105,100,342,15164700,1850
2279,l1805,20170613,8870,8865,8880,8920,8730,8730,8850,-135,-15,838,37086250,2198
2280,l1805,20170614,8730,8850,8730,8840,8710,8770,8755,-80,-95,754,33019800,2212
2281,l1805,20170615,8770,8755,8710,8760,8675,8685,8710,-70,-45,750,32673450,2720
2282,l1805,20170616,8685,8710,8695,8760,8665,8680,8700,-30,-10,612,26636750,3014
2283,l1805,20170619,8680,8700,8700,8795,8680,8720,8740,20,40,768,33571850,3020
2284,l1805,20170620,8720,8740,8720,8755,8670,8715,8715,-25,-25,362,15776250,3198
2285,l1805,20170621,8715,8715,8670,8750,8640,8675,8690,-40,-25,826,35898350,3212
2286,l1805,20170622,8675,8690,8675,8700,8515,8530,8580,-160,-110,1492,64018600,4326
2287,l1805,20170623,8530,8580,8555,8590,8535,8565,8555,-15,-25,620,26526500,4580
2288,l1805,20170626,8565,8555,8580,8670,8580,8660,8635,105,80,972,41985800,4676
2289,l1805,20170627,8660,8635,8645,8720,8640,8695,8680,60,45,730,31695250,4434
2290,l1805,20170628,8695,8680,8725,8770,8630,8660,8660,-20,-20,1364,59068650,4560
2291,l1805,20170629,8660,8660,8700,8850,8685,8780,8760,120,100,1698,74379700,4668
2292,l1805,20170630,8780,8760,8780,8840,8740,8830,8795,70,35,598,26311900,4698
2293,l1805,20170703,8830,8795,8875,8925,8805,8835,8845,40,50,1216,53800400,5054
2294,l1805,20170704,8835,8845,8835,8835,8660,8680,8720,-165,-125,1572,68557850,5722
2295,l1805,20170705,8680,8720,8720,8775,8700,8710,8735,-10,15,1752,76554850,5956
2296,l1805,20170706,8710,8735,8685,8840,8685,8820,8775,85,40,1318,57831550,5674
2297,l1805,20170707,8820,8775,8790,8890,8790,8875,8850,100,75,1026,45417650,5712
2298,l1805,20170710,8875,8850,8875,8940,8780,8820,8840,-30,-10,2586,114320250,6094
2299,l1805,20170711,8820,8840,8840,8945,8830,8930,8880,90,40,3076,136637450,6786
2300,l1805,20170712,8930,8880,8965,9035,8920,8940,8960,60,80,3522,157866200,6950
2301,l1805,20170713,8940,8960,8990,9025,8900,8955,8965,-5,5,2678,120073450,7458
2302,l1805,20170714,8955,8965,8965,9030,8945,9015,8990,50,25,1950,87681900,7930
2303,l1805,20170717,9015,8990,9020,9095,9010,9035,9060,45,70,1664,75393050,8270
2304,l1805,20170718,9035,9060,9075,9095,9020,9050,9060,-10,0,882,39969950,8280
2305,l1805,20170719,9050,9060,9060,9125,9050,9100,9085,40,25,1056,47984750,8382
2306,l1805,20170720,9100,9085,9125,9535,9125,9535,9395,450,310,9312,437653200,10808
2307,l1805,20170721,9535,9395,9490,9690,9395,9655,9555,260,160,11062,528641100,14318
2308,l1805,20170724,9655,9555,9600,9695,9540,9615,9625,60,70,6614,318344950,15034
2309,l1805,20170725,9615,9625,9625,9690,9565,9610,9615,-15,-10,5160,248152700,15402
2310,l1805,20170726,9610,9615,9690,9745,9475,9525,9620,-90,5,6090,292985250,17076
2311,l1805,20170727,9525,9620,9555,9630,9465,9550,9525,-70,-95,6228,296724650,18748
2312,l1805,20170728,9550,9525,9525,9585,9400,9420,9480,-105,-45,5986,283865400,20162
2313,l1805,20170731,9420,9480,9425,9585,9405,9550,9495,70,15,5858,278221300,21304
2314,l1805,20170801,9550,9495,9570,9820,9530,9710,9695,215,200,8542,414170400,22542
2315,l1805,20170802,9710,9695,9690,9750,9610,9710,9680,15,-15,7248,350965950,21982
2316,l1805,20170803,9710,9680,9750,9775,9555,9585,9670,-95,-10,7360,355882950,21490
2317,l1805,20170804,9585,9670,9615,9825,9565,9770,9720,100,50,7246,352200300,23566
2318,l1805,20170807,9770,9720,9815,9870,9615,9635,9690,-85,-30,7790,377460150,23356
2319,l1805,20170808,9635,9690,9625,9860,9625,9835,9770,145,80,8298,405518150,25226
2320,l1805,20170809,9835,9770,9880,10000,9800,9880,9905,110,135,9820,486403050,24790
2321,l1805,20170810,9880,9905,9895,9940,9800,9880,9855,-25,-50,12826,632189850,28116
2322,l1805,20170811,9880,9855,9800,9840,9580,9635,9705,-220,-150,13192,640192750,28232
2323,l1805,20170814,9635,9705,9695,9700,9610,9640,9650,-65,-55,3976,191933100,28598
2324,l1805,20170815,9640,9650,9590,9600,9420,9515,9500,-135,-150,9686,460110300,26820
2325,l1805,20170816,9515,9500,9500,9565,9460,9520,9525,20,25,4600,219121750,26866
2326,l1805,20170817,9520,9525,9610,9805,9610,9755,9725,230,200,12046,585816500,27978
2327,l1805,20170818,9755,9725,9730,9810,9715,9810,9765,85,40,4264,208231150,28114
2328,l1805,20170821,9810,9765,9850,9930,9830,9890,9880,125,115,4834,238864750,28264
2329,l1805,20170822,9890,9880,9870,10110,9770,10085,9980,205,100,22188,1107395050,36718
2330,l1805,20170823,10085,9980,10030,10085,9975,10005,10030,25,50,14030,703763700,35796
2331,l1805,20170824,10005,10030,10030,10085,9995,10015,10045,-15,15,16910,849546950,37980
2332,l1805,20170825,10015,10045,10050,10190,10035,10050,10130,5,85,24276,1229835500,41552
2333,l1805,20170828,10050,10130,10025,10060,9930,10045,9980,-85,-150,19848,990712750,37748
2334,l1805,20170829,10045,9980,9995,10170,9995,10130,10110,150,130,22744,1149760600,41688
2335,l1805,20170830,10130,10110,10110,10165,10065,10145,10120,35,10,10608,536883950,39528
2336,l1805,20170831,10145,10120,10145,10290,10060,10225,10215,105,95,21664,1106601700,45872
2337,l1805,20170901,10225,10215,10250,10395,10220,10390,10300,175,85,15078,776662200,46070
2338,l1805,20170904,10390,10300,10500,10590,10370,10415,10450,115,150,24298,1269729850,50084
2339,l1805,20170905,10415,10450,10410,10490,10335,10450,10410,0,-40,27384,1425987500,54436
2340,l1805,20170906,10450,10410,10410,10410,10260,10280,10335,-130,-75,23422,1210479400,58010
2341,l1805,20170907,10280,10335,10305,10325,10120,10165,10215,-170,-120,31602,1614548650,58130
2342,l1805,20170908,10165,10215,10185,10225,10025,10090,10120,-125,-95,20718,1048609450,54664
2343,l1805,20170911,10090,10120,10015,10090,9930,10050,10015,-70,-105,22390,1121187750,52416
2344,l1805,20170912,10050,10015,10110,10220,10085,10190,10160,175,145,19118,971233300,51860
2345,l1805,20170913,10190,10160,10185,10225,9935,9965,10050,-195,-110,24232,1217985450,50760
2346,l1805,20170914,9965,10050,9990,10030,9800,9800,9910,-250,-140,16674,826601500,50182
2347,l1805,20170915,9800,9910,9820,9860,9730,9785,9790,-125,-120,17442,854124150,48004
2348,l1805,20170918,9785,9790,9750,9865,9675,9820,9785,30,-5,21942,1073640650,48418
2349,l1805,20170919,9820,9785,9825,9860,9685,9690,9780,-95,-5,16480,806197200,48732
2350,l1805,20170920,9690,9780,9720,9755,9620,9665,9690,-115,-90,43404,2103223800,63698
2351,l1805,20170921,9665,9690,9685,9685,9430,9465,9510,-225,-180,37250,1771461250,63490
2352,l1805,20170922,9465,9510,9450,9530,9395,9470,9460,-40,-50,18072,855225250,63938
2353,l1805,20170925,9470,9460,9460,9540,9405,9485,9470,25,10,23008,1089839600,64100
2354,l1805,20170926,9485,9470,9600,9600,9480,9580,9550,110,80,22186,1059440200,62448
2355,l1805,20170927,9580,9550,9565,9620,9550,9615,9590,65,40,15818,758649600,63504
2356,l1805,20170928,9615,9590,9550,9550,9215,9380,9365,-210,-225,41412,1939636800,60792
2357,l1805,20170929,9380,9365,9390,9460,9355,9435,9410,70,45,14676,690560100,61786
2358,l1805,20171009,9435,9410,9430,9540,9390,9470,9470,60,60,32180,1524445650,62382
2359,l1805,20171010,9470,9470,9400,9550,9390,9400,9460,-70,-10,28484,1347798500,64490
2360,l1805,20171011,9400,9460,9440,9460,9305,9320,9380,-140,-80,27044,1268754250,66018
2361,l1805,20171012,9320,9380,9335,9410,9255,9400,9335,20,-45,35314,1648752350,65444
2362,l1805,20171013,9400,9335,9410,9680,9405,9635,9545,300,210,37098,1771248450,64732
2363,l1805,20171016,9635,9545,9650,9745,9610,9735,9675,190,130,39512,1911606350,68826
2364,l1805,20171017,9735,9675,9660,9795,9590,9765,9730,90,55,52470,2552671700,77322
2365,l1805,20171018,9765,9730,9745,9835,9725,9780,9780,50,50,28814,1409139600,79850
2366,l1805,20171019,9780,9780,9725,9735,9570,9620,9620,-160,-160,53692,2583021700,84730
2367,l1805,20171020,9620,9620,9660,9860,9585,9845,9720,225,100,41824,2033434200,87190
2368,l1805,20171023,9845,9720,9785,9875,9755,9820,9820,100,100,58274,2862486550,99382
2369,l1805,20171024,9820,9820,9840,9925,9810,9825,9875,5,55,53956,2664329300,107220
2370,l1805,20171025,9825,9875,9870,9890,9765,9860,9840,-15,-35,38174,1878466850,109658
2371,l1805,20171026,9860,9840,9860,9940,9730,9750,9800,-90,-40,44544,2182668150,115000
2372,l1805,20171027,9750,9800,9765,9775,9550,9560,9655,-240,-145,53558,2585611700,109674
2373,l1805,20171030,9560,9655,9580,9625,9530,9550,9575,-105,-80,36386,1742234150,112608
2374,l1805,20171031,9550,9575,9540,9550,9425,9480,9465,-95,-110,40852,1934180100,118406
2375,l1805,20171101,9480,9465,9540,9595,9485,9495,9525,30,60,38648,1841515950,117924
2376,l1805,20171102,9495,9525,9565,9660,9530,9645,9580,120,55,55670,2667879700,128370
2377,l1805,20171103,9645,9580,9660,9725,9605,9710,9670,130,90,62520,3023343400,132262
2378,l1805,20171106,9710,9670,9780,9855,9740,9845,9800,175,130,54016,2647129200,130930
2379,l1805,20171107,9845,9800,9885,9910,9800,9885,9850,85,50,46250,2278517350,137296
2380,l1805,20171108,9885,9850,9850,9930,9830,9865,9880,15,30,49182,2430020550,142504
2381,l1805,20171109,9865,9880,9920,10020,9855,9905,9935,25,55,83074,4127093550,151768
2382,l1805,20171110,9905,9935,9910,9950,9775,9800,9840,-135,-95,68542,3373060400,158906
2383,l1805,20171113,9800,9840,9810,9850,9710,9845,9785,5,-55,63182,3092145250,160366
2384,l1805,20171114,9845,9785,9840,9885,9785,9810,9830,25,45,72366,3558582250,166784
2385,l1805,20171115,9810,9830,9680,9700,9560,9605,9635,-225,-195,97994,4721866850,164008
2386,l1805,20171116,9605,9635,9600,9640,9510,9525,9575,-110,-60,65436,3133660450,171786
2387,l1805,20171117,9525,9575,9530,9610,9465,9570,9540,-5,-35,99382,4740658800,186448
2388,l1805,20171120,9570,9540,9590,9695,9560,9680,9625,140,85,87448,4208998450,194838
2389,l1805,20171121,9680,9625,9705,9755,9685,9750,9720,125,95,63260,3075827900,197876
2390,l1805,20171122,9750,9720,9815,9815,9670,9805,9755,85,35,102566,5003280250,208196
2391,l1805,20171123,9805,9755,9845,9880,9685,9710,9790,-45,35,96560,4728426200,214472
2392,l1805,20171124,9710,9790,9715,9780,9715,9775,9745,-15,-45,73904,3602432050,223540
2393,l1805,20171127,9775,9745,9790,9900,9435,9435,9680,-310,-65,257706,12476664550,254802
2394,l1805,20171128,9435,9680,9405,9480,9350,9375,9425,-305,-255,209552,9875697000,281294
2395,l1805,20171129,9375,9425,9370,9515,9360,9435,9430,10,5,231444,10918028300,314848
2396,l1805,20171130,9435,9430,9480,9495,9235,9305,9365,-125,-65,418012,19580754150,370292
2397,l1805,20171201,9305,9365,9335,9450,9280,9390,9370,25,5,325814,15268827200,387066
2398,l1805,20171204,9390,9370,9480,9620,9460,9575,9540,205,170,437786,20891030800,376856
2399,l1805,20171205,9575,9540,9570,9650,9505,9520,9580,-20,40,355494,17032411950,390842
2400,l1805,20171206,9520,9580,9480,9630,9470,9510,9550,-70,-30,399134,19062776850,374792
2401,l1805,20171207,9510,9550,9455,9480,9305,9355,9375,-195,-175,471410,22105266600,405988
2402,l1805,20171208,9355,9375,9355,9525,9335,9465,9435,90,60,465984,21986845700,397328
2403,l1805,20171211,9465,9435,9480,9580,9380,9455,9480,20,45,457520,21695810600,420318
2404,l1805,20171212,9455,9480,9510,9575,9490,9570,9525,90,45,366978,17480630600,406902
2405,l1805,20171213,9570,9525,9560,9590,9365,9455,9435,-70,-90,435024,20531056800,430762
2406,l1805,20171214,9455,9435,9450,9525,9390,9415,9450,-20,15,397734,18801132100,416538
2407,l1805,20171215,9415,9450,9430,9455,9330,9370,9395,-80,-55,356256,16743914550,445474
2408,l1805,20171218,9370,9395,9440,9495,9365,9460,9435,65,40,404128,19069011700,421496
2409,l1805,20171219,9460,9435,9480,9685,9440,9640,9565,205,130,589980,28221772750,454568
2410,l1805,20171220,9640,9565,9650,9690,9615,9670,9655,105,90,297986,14388109600,433346
2411,l1805,20171221,9670,9655,9630,9710,9600,9675,9660,20,5,371236,17938300200,430420
2412,l1805,20171222,9675,9660,9695,9720,9540,9620,9600,-40,-60,399446,19178390900,412828
2413,l1805,20171225,9620,9600,9630,9690,9525,9530,9605,-70,5,334826,16085040800,383404
2414,l1805,20171226,9530,9605,9560,9815,9530,9795,9690,190,85,643370,31180195250,506416
2415,l1805,20171227,9795,9690,9800,9810,9715,9745,9765,55,75,379262,18521874100,472706
2416,l1805,20171228,9745,9765,9755,9825,9705,9760,9770,-5,5,382954,18712700200,480470
2417,l1805,20171229,9760,9770,9780,9805,9735,9800,9770,30,0,302284,14773890600,474078
2418,l1806,20170615,8755,8755,0,0,0,8755,8755,0,0,0,0,0
2419,l1806,20170616,8755,8755,0,0,0,8755,8755,0,0,0,0,0
2420,l1806,20170619,8755,8755,0,0,0,8755,8755,0,0,0,0,0
2421,l1806,20170620,8755,8755,0,0,0,8755,8755,0,0,0,0,0
2422,l1806,20170621,8755,8755,0,0,0,8755,8755,0,0,0,0,0
2423,l1806,20170622,8755,8755,0,0,0,8755,8755,0,0,0,0,0
2424,l1806,20170623,8755,8755,0,0,0,8755,8755,0,0,0,0,0
2425,l1806,20170626,8755,8755,0,0,0,8755,8755,0,0,0,0,0
2426,l1806,20170627,8755,8755,0,0,0,8755,8755,0,0,0,0,0
2427,l1806,20170628,8755,8755,0,0,0,8755,8755,0,0,0,0,0
2428,l1806,20170629,8755,8755,0,0,0,8755,8755,0,0,0,0,0
2429,l1806,20170630,8755,8755,0,0,0,8755,8755,0,0,0,0,0
2430,l1806,20170703,8755,8755,0,0,0,8755,8755,0,0,0,0,0
2431,l1806,20170704,8755,8755,0,0,0,8755,8755,0,0,0,0,0
2432,l1806,20170705,8755,8755,0,0,0,8755,8755,0,0,0,0,0
2433,l1806,20170706,8755,8755,0,0,0,8755,8755,0,0,0,0,0
2434,l1806,20170707,8755,8755,0,0,0,8755,8755,0,0,0,0,0
2435,l1806,20170710,8755,8755,0,0,0,8755,8755,0,0,0,0,0
2436,l1806,20170711,8755,8755,0,0,0,8755,8755,0,0,0,0,0
2437,l1806,20170712,8755,8755,0,0,0,8755,8755,0,0,0,0,0
2438,l1806,20170713,8755,8755,0,0,0,8755,8755,0,0,0,0,0
2439,l1806,20170714,8755,8755,0,0,0,8755,8755,0,0,0,0,0
2440,l1806,20170717,8755,8755,0,0,0,8755,8755,0,0,0,0,0
2441,l1806,20170718,8755,8755,0,0,0,8755,8755,0,0,0,0,0
2442,l1806,20170719,8755,8755,0,0,0,8775,8775,20,20,0,0,0
2443,l1806,20170720,8775,8775,9475,9475,9475,9475,9475,700,700,2,94750,2
2444,l1806,20170721,9475,9475,0,0,0,9635,9635,160,160,0,0,2
2445,l1806,20170724,9635,9635,0,0,0,9635,9635,0,0,0,0,2
2446,l1806,20170725,9635,9635,0,0,0,9625,9625,-10,-10,0,0,2
2447,l1806,20170726,9625,9625,0,0,0,9630,9630,5,5,0,0,2
2448,l1806,20170727,9630,9630,0,0,0,9535,9535,-95,-95,0,0,2
2449,l1806,20170728,9535,9535,0,0,0,9490,9490,-45,-45,0,0,2
2450,l1806,20170731,9490,9490,0,0,0,9505,9505,15,15,0,0,2
2451,l1806,20170801,9505,9505,0,0,0,9705,9705,200,200,0,0,2
2452,l1806,20170802,9705,9705,0,0,0,9690,9690,-15,-15,0,0,2
2453,l1806,20170803,9690,9690,0,0,0,9680,9680,-10,-10,0,0,2
2454,l1806,20170804,9680,9680,0,0,0,9680,9680,0,0,0,0,2
2455,l1806,20170807,9680,9680,9585,9585,9585,9585,9585,-95,-95,2,95850,4
2456,l1806,20170808,9585,9585,0,0,0,9660,9660,75,75,0,0,4
2457,l1806,20170809,9660,9660,9895,9895,9895,9895,9895,235,235,2,98950,6
2458,l1806,20170810,9895,9895,0,0,0,9850,9850,-45,-45,0,0,6
2459,l1806,20170811,9850,9850,9530,9530,9530,9530,9530,-320,-320,2,95300,8
2460,l1806,20170814,9530,9530,0,0,0,9530,9530,0,0,0,0,8
2461,l1806,20170815,9530,9530,0,0,0,9385,9385,-145,-145,0,0,8
2462,l1806,20170816,9385,9385,0,0,0,9405,9405,20,20,0,0,8
2463,l1806,20170817,9405,9405,0,0,0,9600,9600,195,195,0,0,8
2464,l1806,20170818,9600,9600,0,0,0,9635,9635,35,35,0,0,8
2465,l1806,20170821,9635,9635,0,0,0,9745,9745,110,110,0,0,8
2466,l1806,20170822,9745,9745,0,0,0,9840,9840,95,95,0,0,8
2467,l1806,20170823,9840,9840,0,0,0,9885,9885,45,45,0,0,8
2468,l1806,20170824,9885,9885,0,0,0,9895,9895,10,10,0,0,8
2469,l1806,20170825,9895,9895,0,0,0,9975,9975,80,80,0,0,8
2470,l1806,20170828,9975,9975,0,0,0,9975,9975,0,0,0,0,8
2471,l1806,20170829,9975,9975,0,0,0,10100,10100,125,125,0,0,8
2472,l1806,20170830,10100,10100,0,0,0,10100,10100,0,0,0,0,8
2473,l1806,20170831,10100,10100,0,0,0,10190,10190,90,90,0,0,8
2474,l1806,20170901,10190,10190,10195,10195,10195,10195,10195,5,5,2,101950,6
2475,l1806,20170904,10195,10195,0,0,0,10340,10340,145,145,0,0,6
2476,l1806,20170905,10340,10340,0,0,0,10305,10305,-35,-35,0,0,6
2477,l1806,20170906,10305,10305,0,0,0,10235,10235,-70,-70,0,0,6
2478,l1806,20170907,10235,10235,10260,10260,10260,10260,10260,25,25,2,102600,4
2479,l1806,20170908,10260,10260,0,0,0,10165,10165,-95,-95,0,0,4
2480,l1806,20170911,10165,10165,0,0,0,10060,10060,-105,-105,0,0,4
2481,l1806,20170912,10060,10060,0,0,0,10205,10205,145,145,0,0,4
2482,l1806,20170913,10205,10205,0,0,0,10095,10095,-110,-110,0,0,4
2483,l1806,20170914,10095,10095,0,0,0,9955,9955,-140,-140,0,0,4
2484,l1806,20170915,9955,9955,0,0,0,9835,9835,-120,-120,0,0,4
2485,l1806,20170918,9835,9835,0,0,0,9830,9830,-5,-5,0,0,4
2486,l1806,20170919,9830,9830,0,0,0,9825,9825,-5,-5,0,0,4
2487,l1806,20170920,9825,9825,0,0,0,9735,9735,-90,-90,0,0,4
2488,l1806,20170921,9735,9735,0,0,0,9555,9555,-180,-180,0,0,4
2489,l1806,20170922,9555,9555,0,0,0,9555,9555,0,0,0,0,4
2490,l1806,20170925,9555,9555,0,0,0,9555,9555,0,0,0,0,4
2491,l1806,20170926,9555,9555,0,0,0,9635,9635,80,80,0,0,4
2492,l1806,20170927,9635,9635,0,0,0,9635,9635,0,0,0,0,4
2493,l1806,20170928,9635,9635,0,0,0,9410,9410,-225,-225,0,0,4
2494,l1806,20170929,9410,9410,0,0,0,9410,9410,0,0,0,0,4
2495,l1806,20171009,9410,9410,0,0,0,9410,9410,0,0,0,0,4
2496,l1806,20171010,9410,9410,0,0,0,9410,9410,0,0,0,0,4
2497,l1806,20171011,9410,9410,0,0,0,9335,9335,-75,-75,0,0,4
2498,l1806,20171012,9335,9335,0,0,0,9295,9295,-40,-40,0,0,4
2499,l1806,20171013,9295,9295,9510,9510,9510,9510,9510,215,215,2,95100,2
2500,l1806,20171016,9510,9510,0,0,0,9635,9635,125,125,0,0,2
2501,l1806,20171017,9635,9635,0,0,0,9685,9685,50,50,0,0,2
2502,l1806,20171018,9685,9685,0,0,0,9685,9685,0,0,0,0,2
2503,l1806,20171019,9685,9685,0,0,0,9530,9530,-155,-155,0,0,2
2504,l1806,20171020,9530,9530,0,0,0,9625,9625,95,95,0,0,2
2505,l1806,20171023,9625,9625,0,0,0,9625,9625,0,0,0,0,2
2506,l1806,20171024,9625,9625,0,0,0,9675,9675,50,50,0,0,2
2507,l1806,20171025,9675,9675,0,0,0,9645,9645,-30,-30,0,0,2
2508,l1806,20171026,9645,9645,0,0,0,9610,9610,-35,-35,0,0,2
2509,l1806,20171027,9610,9610,0,0,0,9610,9610,0,0,0,0,2
2510,l1806,20171030,9610,9610,0,0,0,9610,9610,0,0,0,0,2
2511,l1806,20171031,9610,9610,0,0,0,9500,9500,-110,-110,0,0,2
2512,l1806,20171101,9500,9500,9610,9610,9515,9515,9560,15,60,4,191250,2
2513,l1806,20171102,9515,9560,0,0,0,9560,9560,0,0,0,0,2
2514,l1806,20171103,9560,9560,0,0,0,9645,9645,85,85,0,0,2
2515,l1806,20171106,9645,9645,0,0,0,9770,9770,125,125,0,0,2
2516,l1806,20171107,9770,9770,0,0,0,9815,9815,45,45,0,0,2
2517,l1806,20171108,9815,9815,0,0,0,9840,9840,25,25,0,0,2
2518,l1806,20171109,9840,9840,0,0,0,9840,9840,0,0,0,0,2
2519,l1806,20171110,9840,9840,0,0,0,9750,9750,-90,-90,0,0,2
2520,l1806,20171113,9750,9750,0,0,0,9700,9700,-50,-50,0,0,2
2521,l1806,20171114,9700,9700,0,0,0,9740,9740,40,40,0,0,2
2522,l1806,20171115,9740,9740,0,0,0,9550,9550,-190,-190,0,0,2
2523,l1806,20171116,9550,9550,0,0,0,9550,9550,0,0,0,0,2
2524,l1806,20171117,9550,9550,0,0,0,9520,9520,-30,-30,0,0,2
2525,l1806,20171120,9520,9520,0,0,0,9600,9600,80,80,0,0,2
2526,l1806,20171121,9600,9600,0,0,0,9690,9690,90,90,0,0,2
2527,l1806,20171122,9690,9690,0,0,0,9720,9720,30,30,0,0,2
2528,l1806,20171123,9720,9720,0,0,0,9750,9750,30,30,0,0,2
2529,l1806,20171124,9750,9750,0,0,0,9710,9710,-40,-40,0,0,2
2530,l1806,20171127,9710,9710,0,0,0,9650,9650,-60,-60,0,0,2
2531,l1806,20171128,9650,9650,0,0,0,9400,9400,-250,-250,0,0,2
2532,l1806,20171129,9400,9400,0,0,0,9400,9400,0,0,0,0,2
2533,l1806,20171130,9400,9400,0,0,0,9400,9400,0,0,0,0,2
2534,l1806,20171201,9400,9400,0,0,0,9400,9400,0,0,0,0,2
2535,l1806,20171204,9400,9400,9640,9640,9540,9540,9590,140,190,4,191800,4
2536,l1806,20171205,9540,9590,0,0,0,9590,9590,0,0,0,0,4
2537,l1806,20171206,9590,9590,0,0,0,9590,9590,0,0,0,0,4
2538,l1806,20171207,9590,9590,0,0,0,9415,9415,-175,-175,0,0,4
2539,l1806,20171208,9415,9415,0,0,0,9415,9415,0,0,0,0,4
2540,l1806,20171211,9415,9415,0,0,0,9415,9415,0,0,0,0,4
2541,l1806,20171212,9415,9415,0,0,0,9455,9455,40,40,0,0,4
2542,l1806,20171213,9455,9455,0,0,0,9455,9455,0,0,0,0,4
2543,l1806,20171214,9455,9455,0,0,0,9455,9455,0,0,0,0,4
2544,l1806,20171215,9455,9455,0,0,0,9400,9400,-55,-55,0,0,4
2545,l1806,20171218,9400,9400,0,0,0,9400,9400,0,0,0,0,4
2546,l1806,20171219,9400,9400,0,0,0,9525,9525,125,125,0,0,4
2547,l1806,20171220,9525,9525,0,0,0,9610,9610,85,85,0,0,4
2548,l1806,20171221,9610,9610,0,0,0,9610,9610,0,0,0,0,4
2549,l1806,20171222,9610,9610,0,0,0,9610,9610,0,0,0,0,4
2550,l1806,20171225,9610,9610,0,0,0,9615,9615,5,5,0,0,4
2551,l1806,20171226,9615,9615,9840,9840,9840,9840,9840,225,225,2,98400,6
2552,l1806,20171227,9840,9840,0,0,0,9915,9915,75,75,0,0,6
2553,l1806,20171228,9915,9915,9735,9735,9735,9735,9735,-180,-180,2,97350,4
2554,l1806,20171229,9735,9735,0,0,0,9735,9735,0,0,0,0,4
2555,l1807,20170717,8755,8755,0,0,0,8755,8755,0,0,0,0,0
2556,l1807,20170718,8755,8755,0,0,0,8755,8755,0,0,0,0,0
2557,l1807,20170719,8755,8755,0,0,0,8775,8775,20,20,0,0,0
2558,l1807,20170720,8775,8775,0,0,0,9470,9470,695,695,0,0,0
2559,l1807,20170721,9470,9470,0,0,0,9470,9470,0,0,0,0,0
2560,l1807,20170724,9470,9470,0,0,0,9470,9470,0,0,0,0,0
2561,l1807,20170725,9470,9470,0,0,0,9515,9515,45,45,0,0,0
2562,l1807,20170726,9515,9515,0,0,0,9515,9515,0,0,0,0,0
2563,l1807,20170727,9515,9515,0,0,0,9515,9515,0,0,0,0,0
2564,l1807,20170728,9515,9515,0,0,0,9515,9515,0,0,0,0,0
2565,l1807,20170731,9515,9515,9530,9530,9530,9530,9530,15,15,2,95300,2
2566,l1807,20170801,9530,9530,0,0,0,9730,9730,200,200,0,0,2
2567,l1807,20170802,9730,9730,0,0,0,9730,9730,0,0,0,0,2
2568,l1807,20170803,9730,9730,0,0,0,9720,9720,-10,-10,0,0,2
2569,l1807,20170804,9720,9720,9920,9920,9535,9535,9725,-185,5,4,194550,2
2570,l1807,20170807,9535,9725,9630,9630,9630,9630,9630,-95,-95,2,96300,0
2571,l1807,20170808,9630,9630,0,0,0,9705,9705,75,75,0,0,0
2572,l1807,20170809,9705,9705,0,0,0,9940,9940,235,235,0,0,0
2573,l1807,20170810,9940,9940,0,0,0,9890,9890,-50,-50,0,0,0
2574,l1807,20170811,9890,9890,0,0,0,9570,9570,-320,-320,0,0,0
2575,l1807,20170814,9570,9570,0,0,0,9570,9570,0,0,0,0,0
2576,l1807,20170815,9570,9570,0,0,0,9425,9425,-145,-145,0,0,0
2577,l1807,20170816,9425,9425,0,0,0,9445,9445,20,20,0,0,0
2578,l1807,20170817,9445,9445,0,0,0,9640,9640,195,195,0,0,0
2579,l1807,20170818,9640,9640,0,0,0,9675,9675,35,35,0,0,0
2580,l1807,20170821,9675,9675,0,0,0,9785,9785,110,110,0,0,0
2581,l1807,20170822,9785,9785,0,0,0,9880,9880,95,95,0,0,0
2582,l1807,20170823,9880,9880,0,0,0,9925,9925,45,45,0,0,0
2583,l1807,20170824,9925,9925,0,0,0,9935,9935,10,10,0,0,0
2584,l1807,20170825,9935,9935,0,0,0,9935,9935,0,0,0,0,0
2585,l1807,20170828,9935,9935,0,0,0,9790,9790,-145,-145,0,0,0
2586,l1807,20170829,9790,9790,0,0,0,9915,9915,125,125,0,0,0
2587,l1807,20170830,9915,9915,0,0,0,9920,9920,5,5,0,0,0
2588,l1807,20170831,9920,9920,0,0,0,10010,10010,90,90,0,0,0
2589,l1807,20170901,10010,10010,0,0,0,10010,10010,0,0,0,0,0
2590,l1807,20170904,10010,10010,0,0,0,10155,10155,145,145,0,0,0
2591,l1807,20170905,10155,10155,0,0,0,10120,10120,-35,-35,0,0,0
2592,l1807,20170906,10120,10120,0,0,0,10050,10050,-70,-70,0,0,0
2593,l1807,20170907,10050,10050,0,0,0,10070,10070,20,20,0,0,0
2594,l1807,20170908,10070,10070,0,0,0,10070,10070,0,0,0,0,0
2595,l1807,20170911,10070,10070,0,0,0,9970,9970,-100,-100,0,0,0
2596,l1807,20170912,9970,9970,0,0,0,10110,10110,140,140,0,0,0
2597,l1807,20170913,10110,10110,0,0,0,10005,10005,-105,-105,0,0,0
2598,l1807,20170914,10005,10005,0,0,0,9870,9870,-135,-135,0,0,0
2599,l1807,20170915,9870,9870,0,0,0,9755,9755,-115,-115,0,0,0
2600,l1807,20170918,9755,9755,0,0,0,9755,9755,0,0,0,0,0
2601,l1807,20170919,9755,9755,0,0,0,9755,9755,0,0,0,0,0
2602,l1807,20170920,9755,9755,0,0,0,9670,9670,-85,-85,0,0,0
2603,l1807,20170921,9670,9670,0,0,0,9495,9495,-175,-175,0,0,0
2604,l1807,20170922,9495,9495,0,0,0,9495,9495,0,0,0,0,0
2605,l1807,20170925,9495,9495,0,0,0,9495,9495,0,0,0,0,0
2606,l1807,20170926,9495,9495,0,0,0,9575,9575,80,80,0,0,0
2607,l1807,20170927,9575,9575,0,0,0,9575,9575,0,0,0,0,0
2608,l1807,20170928,9575,9575,0,0,0,9355,9355,-220,-220,0,0,0
2609,l1807,20170929,9355,9355,0,0,0,9395,9395,40,40,0,0,0
2610,l1807,20171009,9395,9395,0,0,0,9395,9395,0,0,0,0,0
2611,l1807,20171010,9395,9395,0,0,0,9395,9395,0,0,0,0,0
2612,l1807,20171011,9395,9395,0,0,0,9320,9320,-75,-75,0,0,0
2613,l1807,20171012,9320,9320,0,0,0,9280,9280,-40,-40,0,0,0
2614,l1807,20171013,9280,9280,0,0,0,9490,9490,210,210,0,0,0
2615,l1807,20171016,9490,9490,0,0,0,9615,9615,125,125,0,0,0
2616,l1807,20171017,9615,9615,0,0,0,9665,9665,50,50,0,0,0
2617,l1807,20171018,9665,9665,0,0,0,9710,9710,45,45,0,0,0
2618,l1807,20171019,9710,9710,0,0,0,9555,9555,-155,-155,0,0,0
2619,l1807,20171020,9555,9555,0,0,0,9650,9650,95,95,0,0,0
2620,l1807,20171023,9650,9650,0,0,0,9745,9745,95,95,0,0,0
2621,l1807,20171024,9745,9745,0,0,0,9795,9795,50,50,0,0,0
2622,l1807,20171025,9795,9795,0,0,0,9765,9765,-30,-30,0,0,0
2623,l1807,20171026,9765,9765,0,0,0,9765,9765,0,0,0,0,0
2624,l1807,20171027,9765,9765,0,0,0,9765,9765,0,0,0,0,0
2625,l1807,20171030,9765,9765,0,0,0,9685,9685,-80,-80,0,0,0
2626,l1807,20171031,9685,9685,0,0,0,9575,9575,-110,-110,0,0,0
2627,l1807,20171101,9575,9575,0,0,0,9635,9635,60,60,0,0,0
2628,l1807,20171102,9635,9635,0,0,0,9635,9635,0,0,0,0,0
2629,l1807,20171103,9635,9635,0,0,0,9725,9725,90,90,0,0,0
2630,l1807,20171106,9725,9725,0,0,0,9855,9855,130,130,0,0,0
2631,l1807,20171107,9855,9855,0,0,0,9855,9855,0,0,0,0,0
2632,l1807,20171108,9855,9855,0,0,0,9855,9855,0,0,0,0,0
2633,l1807,20171109,9855,9855,0,0,0,9855,9855,0,0,0,0,0
2634,l1807,20171110,9855,9855,0,0,0,9765,9765,-90,-90,0,0,0
2635,l1807,20171113,9765,9765,0,0,0,9715,9715,-50,-50,0,0,0
2636,l1807,20171114,9715,9715,0,0,0,9755,9755,40,40,0,0,0
2637,l1807,20171115,9755,9755,0,0,0,9565,9565,-190,-190,0,0,0
2638,l1807,20171116,9565,9565,0,0,0,9565,9565,0,0,0,0,0
2639,l1807,20171117,9565,9565,0,0,0,9565,9565,0,0,0,0,0
2640,l1807,20171120,9565,9565,0,0,0,9650,9650,85,85,0,0,0
2641,l1807,20171121,9650,9650,0,0,0,9745,9745,95,95,0,0,0
2642,l1807,20171122,9745,9745,0,0,0,9780,9780,35,35,0,0,0
2643,l1807,20171123,9780,9780,0,0,0,9780,9780,0,0,0,0,0
2644,l1807,20171124,9780,9780,0,0,0,9780,9780,0,0,0,0,0
2645,l1807,20171127,9780,9780,0,0,0,9715,9715,-65,-65,0,0,0
2646,l1807,20171128,9715,9715,0,0,0,9460,9460,-255,-255,0,0,0
2647,l1807,20171129,9460,9460,0,0,0,9460,9460,0,0,0,0,0
2648,l1807,20171130,9460,9460,0,0,0,9395,9395,-65,-65,0,0,0
2649,l1807,20171201,9395,9395,0,0,0,9395,9395,0,0,0,0,0
2650,l1807,20171204,9395,9395,0,0,0,9580,9580,185,185,0,0,0
2651,l1807,20171205,9580,9580,0,0,0,9580,9580,0,0,0,0,0
2652,l1807,20171206,9580,9580,0,0,0,9580,9580,0,0,0,0,0
2653,l1807,20171207,9580,9580,0,0,0,9580,9580,0,0,0,0,0
2654,l1807,20171208,9580,9580,0,0,0,9640,9640,60,60,0,0,0
2655,l1807,20171211,9640,9640,0,0,0,9685,9685,45,45,0,0,0
2656,l1807,20171212,9685,9685,9480,9480,9480,9480,9480,-205,-205,2,94800,2
2657,l1807,20171213,9480,9480,0,0,0,9395,9395,-85,-85,0,0,2
2658,l1807,20171214,9395,9395,0,0,0,9395,9395,0,0,0,0,2
2659,l1807,20171215,9395,9395,0,0,0,9345,9345,-50,-50,0,0,2
2660,l1807,20171218,9345,9345,0,0,0,9380,9380,35,35,0,0,2
2661,l1807,20171219,9380,9380,0,0,0,9505,9505,125,125,0,0,2
2662,l1807,20171220,9505,9505,0,0,0,9590,9590,85,85,0,0,2
2663,l1807,20171221,9590,9590,0,0,0,9590,9590,0,0,0,0,2
2664,l1807,20171222,9590,9590,0,0,0,9590,9590,0,0,0,0,2
2665,l1807,20171225,9590,9590,0,0,0,9590,9590,0,0,0,0,2
2666,l1807,20171226,9590,9590,0,0,0,9810,9810,220,220,0,0,2
2667,l1807,20171227,9810,9810,0,0,0,9885,9885,75,75,0,0,2
2668,l1807,20171228,9885,9885,0,0,0,9885,9885,0,0,0,0,2
2669,l1807,20171229,9885,9885,0,0,0,9885,9885,0,0,0,0,2
2670,l1808,20170815,9570,9570,0,0,0,9570,9570,0,0,0,0,0
2671,l1808,20170816,9570,9570,0,0,0,9570,9570,0,0,0,0,0
2672,l1808,20170817,9570,9570,0,0,0,9570,9570,0,0,0,0,0
2673,l1808,20170818,9570,9570,0,0,0,9570,9570,0,0,0,0,0
2674,l1808,20170821,9570,9570,0,0,0,9570,9570,0,0,0,0,0
2675,l1808,20170822,9570,9570,0,0,0,9665,9665,95,95,0,0,0
2676,l1808,20170823,9665,9665,0,0,0,9710,9710,45,45,0,0,0
2677,l1808,20170824,9710,9710,0,0,0,9710,9710,0,0,0,0,0
2678,l1808,20170825,9710,9710,0,0,0,9710,9710,0,0,0,0,0
2679,l1808,20170828,9710,9710,0,0,0,9730,9730,20,20,0,0,0
2680,l1808,20170829,9730,9730,9980,10195,9980,9995,10055,265,325,6,301700,2
2681,l1808,20170830,9995,10055,0,0,0,10060,10060,5,5,0,0,2
2682,l1808,20170831,10060,10060,9995,10215,9995,10215,10105,155,45,4,202100,2
2683,l1808,20170901,10215,10105,0,0,0,10105,10105,0,0,0,0,2
2684,l1808,20170904,10105,10105,0,0,0,10250,10250,145,145,0,0,2
2685,l1808,20170905,10250,10250,0,0,0,10250,10250,0,0,0,0,2
2686,l1808,20170906,10250,10250,10290,10290,10290,10290,10290,40,40,2,102900,4
2687,l1808,20170907,10290,10290,0,0,0,10315,10315,25,25,0,0,4
2688,l1808,20170908,10315,10315,10015,10015,10015,10015,10015,-300,-300,2,100150,4
2689,l1808,20170911,10015,10015,10095,10095,10095,10095,10095,80,80,4,201900,4
2690,l1808,20170912,10095,10095,0,0,0,10095,10095,0,0,0,0,4
2691,l1808,20170913,10095,10095,0,0,0,9990,9990,-105,-105,0,0,4
2692,l1808,20170914,9990,9990,0,0,0,9990,9990,0,0,0,0,4
2693,l1808,20170915,9990,9990,0,0,0,9870,9870,-120,-120,0,0,4
2694,l1808,20170918,9870,9870,0,0,0,9870,9870,0,0,0,0,4
2695,l1808,20170919,9870,9870,0,0,0,9870,9870,0,0,0,0,4
2696,l1808,20170920,9870,9870,0,0,0,9870,9870,0,0,0,0,4
2697,l1808,20170921,9870,9870,0,0,0,9690,9690,-180,-180,0,0,4
2698,l1808,20170922,9690,9690,0,0,0,9690,9690,0,0,0,0,4
2699,l1808,20170925,9690,9690,0,0,0,9700,9700,10,10,0,0,4
2700,l1808,20170926,9700,9700,0,0,0,9700,9700,0,0,0,0,4
2701,l1808,20170927,9700,9700,0,0,0,9700,9700,0,0,0,0,4
2702,l1808,20170928,9700,9700,0,0,0,9475,9475,-225,-225,0,0,4
2703,l1808,20170929,9475,9475,0,0,0,9475,9475,0,0,0,0,4
2704,l1808,20171009,9475,9475,0,0,0,9475,9475,0,0,0,0,4
2705,l1808,20171010,9475,9475,0,0,0,9475,9475,0,0,0,0,4
2706,l1808,20171011,9475,9475,0,0,0,9475,9475,0,0,0,0,4
2707,l1808,20171012,9475,9475,0,0,0,9475,9475,0,0,0,0,4
2708,l1808,20171013,9475,9475,0,0,0,9475,9475,0,0,0,0,4
2709,l1808,20171016,9475,9475,0,0,0,9600,9600,125,125,0,0,4
2710,l1808,20171017,9600,9600,0,0,0,9600,9600,0,0,0,0,4
2711,l1808,20171018,9600,9600,0,0,0,9600,9600,0,0,0,0,4
2712,l1808,20171019,9600,9600,0,0,0,9600,9600,0,0,0,0,4
2713,l1808,20171020,9600,9600,0,0,0,9695,9695,95,95,0,0,4
2714,l1808,20171023,9695,9695,9620,9950,9620,9900,9800,205,105,8,392150,2
2715,l1808,20171024,9900,9800,0,0,0,9800,9800,0,0,0,0,2
2716,l1808,20171025,9800,9800,0,0,0,9800,9800,0,0,0,0,2
2717,l1808,20171026,9800,9800,0,0,0,9800,9800,0,0,0,0,2
2718,l1808,20171027,9800,9800,0,0,0,9655,9655,-145,-145,0,0,2
2719,l1808,20171030,9655,9655,0,0,0,9655,9655,0,0,0,0,2
2720,l1808,20171031,9655,9655,0,0,0,9655,9655,0,0,0,0,2
2721,l1808,20171101,9655,9655,0,0,0,9655,9655,0,0,0,0,2
2722,l1808,20171102,9655,9655,0,0,0,9655,9655,0,0,0,0,2
2723,l1808,20171103,9655,9655,0,0,0,9655,9655,0,0,0,0,2
2724,l1808,20171106,9655,9655,0,0,0,9655,9655,0,0,0,0,2
2725,l1808,20171107,9655,9655,0,0,0,9655,9655,0,0,0,0,2
2726,l1808,20171108,9655,9655,0,0,0,9655,9655,0,0,0,0,2
2727,l1808,20171109,9655,9655,0,0,0,9655,9655,0,0,0,0,2
2728,l1808,20171110,9655,9655,0,0,0,9655,9655,0,0,0,0,2
2729,l1808,20171113,9655,9655,0,0,0,9655,9655,0,0,0,0,2
2730,l1808,20171114,9655,9655,0,0,0,9655,9655,0,0,0,0,2
2731,l1808,20171115,9655,9655,9535,9665,9535,9665,9600,10,-55,4,192000,4
2732,l1808,20171116,9665,9600,0,0,0,9600,9600,0,0,0,0,4
2733,l1808,20171117,9600,9600,0,0,0,9600,9600,0,0,0,0,4
2734,l1808,20171120,9600,9600,0,0,0,9600,9600,0,0,0,0,4
2735,l1808,20171121,9600,9600,0,0,0,9600,9600,0,0,0,0,4
2736,l1808,20171122,9600,9600,0,0,0,9600,9600,0,0,0,0,4
2737,l1808,20171123,9600,9600,0,0,0,9600,9600,0,0,0,0,4
2738,l1808,20171124,9600,9600,0,0,0,9600,9600,0,0,0,0,4
2739,l1808,20171127,9600,9600,0,0,0,9540,9540,-60,-60,0,0,4
2740,l1808,20171128,9540,9540,0,0,0,9290,9290,-250,-250,0,0,4
2741,l1808,20171129,9290,9290,0,0,0,9290,9290,0,0,0,0,4
2742,l1808,20171130,9290,9290,0,0,0,9290,9290,0,0,0,0,4
2743,l1808,20171201,9290,9290,0,0,0,9290,9290,0,0,0,0,4
2744,l1808,20171204,9290,9290,0,0,0,9475,9475,185,185,0,0,4
2745,l1808,20171205,9475,9475,0,0,0,9475,9475,0,0,0,0,4
2746,l1808,20171206,9475,9475,0,0,0,9475,9475,0,0,0,0,4
2747,l1808,20171207,9475,9475,0,0,0,9475,9475,0,0,0,0,4
2748,l1808,20171208,9475,9475,0,0,0,9475,9475,0,0,0,0,4
2749,l1808,20171211,9475,9475,0,0,0,9475,9475,0,0,0,0,4
2750,l1808,20171212,9475,9475,9395,9395,9395,9395,9395,-80,-80,2,93950,6
2751,l1808,20171213,9395,9395,0,0,0,9395,9395,0,0,0,0,6
2752,l1808,20171214,9395,9395,0,0,0,9405,9405,10,10,0,0,6
2753,l1808,20171215,9405,9405,0,0,0,9405,9405,0,0,0,0,6
2754,l1808,20171218,9405,9405,0,0,0,9405,9405,0,0,0,0,6
2755,l1808,20171219,9405,9405,0,0,0,9530,9530,125,125,0,0,6
2756,l1808,20171220,9530,9530,0,0,0,9530,9530,0,0,0,0,6
2757,l1808,20171221,9530,9530,0,0,0,9530,9530,0,0,0,0,6
2758,l1808,20171222,9530,9530,0,0,0,9530,9530,0,0,0,0,6
2759,l1808,20171225,9530,9530,0,0,0,9530,9530,0,0,0,0,6
2760,l1808,20171226,9530,9530,0,0,0,9750,9750,220,220,0,0,6
2761,l1808,20171227,9750,9750,0,0,0,9750,9750,0,0,0,0,6
2762,l1808,20171228,9750,9750,0,0,0,9750,9750,0,0,0,0,6
2763,l1808,20171229,9750,9750,0,0,0,9750,9750,0,0,0,0,6
2764,l1809,20170915,9990,9990,9730,9730,9730,9730,9730,-260,-260,4,194600,4
2765,l1809,20170918,9730,9730,9810,9825,9680,9800,9750,70,20,132,6437850,70
2766,l1809,20170919,9800,9750,9800,9810,9665,9665,9755,-85,5,136,6636750,102
2767,l1809,20170920,9665,9755,9605,9660,9605,9655,9640,-100,-115,114,5496550,162
2768,l1809,20170921,9655,9640,9600,9600,9405,9405,9485,-235,-155,192,9106850,286
2769,l1809,20170922,9405,9485,9420,9490,9390,9445,9440,-40,-45,104,4911300,274
2770,l1809,20170925,9445,9440,9440,9500,9400,9450,9450,10,10,220,10395600,306
2771,l1809,20170926,9450,9450,9365,9560,9365,9560,9475,110,25,266,12602000,336
2772,l1809,20170927,9560,9475,9555,9590,9540,9590,9565,115,90,122,5837500,330
2773,l1809,20170928,9590,9565,9455,9470,9220,9360,9340,-205,-225,382,17841850,450
2774,l1809,20170929,9360,9340,9340,9435,9340,9415,9400,75,60,28,1316300,440
2775,l1809,20171009,9415,9400,9445,9515,9380,9410,9450,10,50,250,11814000,426
2776,l1809,20171010,9410,9450,9395,9520,9390,9390,9435,-60,-15,248,11702150,440
2777,l1809,20171011,9390,9435,9390,9415,9305,9305,9355,-130,-80,168,7861700,510
2778,l1809,20171012,9305,9355,9325,9390,9255,9355,9335,0,-20,168,7841450,536
2779,l1809,20171013,9355,9335,9420,9645,9420,9600,9530,265,195,366,17447600,536
2780,l1809,20171016,9600,9530,9605,9700,9605,9690,9650,160,120,310,14961000,532
2781,l1809,20171017,9690,9650,9660,9750,9585,9740,9695,90,45,184,8921050,564
2782,l1809,20171018,9740,9695,9745,9780,9720,9745,9745,50,50,146,7113850,590
2783,l1809,20171019,9745,9745,9680,9680,9550,9600,9615,-145,-130,340,16345750,634
2784,l1809,20171020,9600,9615,9570,9795,9550,9795,9690,180,75,346,16764450,650
2785,l1809,20171023,9795,9690,9750,9835,9730,9780,9790,90,100,292,14294150,708
2786,l1809,20171024,9780,9790,9825,9885,9765,9770,9825,-20,35,372,18281750,660
2787,l1809,20171025,9770,9825,9785,9830,9710,9815,9780,-10,-45,230,11248500,658
2788,l1809,20171026,9815,9780,9800,9860,9690,9725,9735,-55,-45,390,18986300,724
2789,l1809,20171027,9725,9735,9710,9720,9515,9540,9610,-195,-125,540,25956650,734
2790,l1809,20171030,9540,9610,9580,9590,9515,9515,9545,-95,-65,288,13748500,810
2791,l1809,20171031,9515,9545,9470,9485,9405,9450,9440,-95,-105,280,13217350,880
2792,l1809,20171101,9450,9440,9485,9550,9480,9480,9505,40,65,330,15684850,894
2793,l1809,20171102,9480,9505,9525,9620,9525,9620,9565,115,60,494,23637600,852
2794,l1809,20171103,9620,9565,9630,9685,9590,9675,9650,110,85,316,15250900,818
2795,l1809,20171106,9675,9650,9715,9800,9715,9800,9755,150,105,474,23129500,896
2796,l1809,20171107,9800,9755,9815,9855,9770,9840,9815,85,60,436,21398750,986
2797,l1809,20171108,9840,9815,9810,9885,9805,9830,9840,15,25,390,19191550,1000
2798,l1809,20171109,9830,9840,9865,9965,9810,9855,9890,15,50,696,34433800,1056
2799,l1809,20171110,9855,9890,9860,9875,9740,9765,9820,-125,-70,718,35256050,1206
2800,l1809,20171113,9765,9820,9755,9805,9680,9805,9750,-15,-70,856,41747850,1524
2801,l1809,20171114,9805,9750,9800,9830,9750,9775,9785,25,35,420,20558250,1544
2802,l1809,20171115,9775,9785,9630,9655,9540,9575,9605,-210,-180,1236,59360700,1844
2803,l1809,20171116,9575,9605,9575,9585,9480,9485,9530,-120,-75,1230,58630400,2354
2804,l1809,20171117,9485,9530,9495,9560,9435,9520,9500,-10,-30,752,35724450,2462
2805,l1809,20171120,9520,9500,9555,9625,9510,9610,9560,110,60,994,47532000,2626
2806,l1809,20171121,9610,9560,9640,9680,9620,9675,9645,115,85,1200,57891600,2800
2807,l1809,20171122,9675,9645,9695,9745,9630,9730,9695,85,50,1420,68843000,2908
2808,l1809,20171123,9730,9695,9740,9805,9660,9680,9740,-15,45,1762,85847550,3270
2809,l1809,20171124,9680,9740,9685,9730,9680,9730,9700,-10,-40,916,44431000,3358
2810,l1809,20171127,9730,9700,9740,9840,9405,9410,9620,-290,-80,2808,135064950,4518
2811,l1809,20171128,9410,9620,9455,9455,9300,9330,9375,-290,-245,4058,190234450,5966
2812,l1809,20171129,9330,9375,9330,9455,9315,9380,9375,5,0,2948,138226850,6382
2813,l1809,20171130,9380,9375,9380,9435,9195,9260,9290,-115,-85,5404,251141800,9038
2814,l1809,20171201,9260,9290,9275,9375,9240,9325,9310,35,20,3060,142461450,9480
2815,l1809,20171204,9325,9310,9355,9555,9355,9430,9440,120,130,12868,607534200,12630
2816,l1809,20171205,9430,9440,9425,9500,9385,9400,9440,-40,0,6068,286532100,13360
2817,l1809,20171206,9400,9440,9370,9500,9290,9315,9380,-125,-60,12234,573989950,18412
2818,l1809,20171207,9315,9380,9265,9280,9130,9180,9210,-200,-170,10878,500966050,21944
2819,l1809,20171208,9180,9210,9190,9360,9170,9285,9265,75,55,10630,492618100,24708
2820,l1809,20171211,9285,9265,9300,9385,9220,9290,9300,25,35,5932,275976500,25496
2821,l1809,20171212,9290,9300,9325,9380,9305,9380,9340,80,40,7388,345057100,25208
2822,l1809,20171213,9380,9340,9330,9395,9205,9270,9260,-70,-80,7896,365652450,27576
2823,l1809,20171214,9270,9260,9270,9340,9215,9240,9255,-20,-5,7624,352986800,29262
2824,l1809,20171215,9240,9255,9260,9270,9170,9210,9220,-45,-35,6038,278452550,31266
2825,l1809,20171218,9210,9220,9260,9315,9210,9280,9270,60,50,7808,361902600,31498
2826,l1809,20171219,9280,9270,9280,9480,9260,9445,9375,175,105,10916,511831700,28664
2827,l1809,20171220,9445,9375,9450,9490,9430,9470,9460,95,85,4900,231863750,28184
2828,l1809,20171221,9470,9460,9460,9525,9410,9515,9480,55,20,9528,451792000,29476
2829,l1809,20171222,9515,9480,9530,9545,9420,9475,9470,-5,-10,5986,283456600,30698
2830,l1809,20171225,9475,9470,9475,9540,9400,9415,9475,-55,5,6658,315563900,30792
2831,l1809,20171226,9415,9475,9425,9665,9410,9650,9545,175,70,9142,436450750,31172
2832,l1809,20171227,9650,9545,9635,9655,9520,9550,9570,5,25,17634,843986850,38054
2833,l1809,20171228,9550,9570,9560,9620,9525,9575,9575,5,5,10500,502895700,38848
2834,l1809,20171229,9575,9575,9610,9625,9565,9610,9585,35,10,5918,283690800,39846
2835,l1810,20171023,9690,9690,0,0,0,9690,9690,0,0,0,0,0
2836,l1810,20171024,9690,9690,0,0,0,9690,9690,0,0,0,0,0
2837,l1810,20171025,9690,9690,0,0,0,9690,9690,0,0,0,0,0
2838,l1810,20171026,9690,9690,0,0,0,9690,9690,0,0,0,0,0
2839,l1810,20171027,9690,9690,8920,9675,8920,9675,9295,-15,-395,8,371900,0
2840,l1810,20171030,9675,9295,0,0,0,9235,9235,-60,-60,0,0,0
2841,l1810,20171031,9235,9235,0,0,0,9135,9135,-100,-100,0,0,0
2842,l1810,20171101,9135,9135,0,0,0,9195,9195,60,60,0,0,0
2843,l1810,20171102,9195,9195,0,0,0,9250,9250,55,55,0,0,0
2844,l1810,20171103,9250,9250,0,0,0,9330,9330,80,80,0,0,0
2845,l1810,20171106,9330,9330,0,0,0,9430,9430,100,100,0,0,0
2846,l1810,20171107,9430,9430,9705,9805,9705,9805,9755,375,325,40,1951000,0
2847,l1810,20171108,9805,9755,0,0,0,9755,9755,0,0,0,0,0
2848,l1810,20171109,9755,9755,0,0,0,9755,9755,0,0,0,0,0
2849,l1810,20171110,9755,9755,0,0,0,9755,9755,0,0,0,0,0
2850,l1810,20171113,9755,9755,0,0,0,9755,9755,0,0,0,0,0
2851,l1810,20171114,9755,9755,0,0,0,9755,9755,0,0,0,0,0
2852,l1810,20171115,9755,9755,0,0,0,9755,9755,0,0,0,0,0
2853,l1810,20171116,9755,9755,0,0,0,9680,9680,-75,-75,0,0,0
2854,l1810,20171117,9680,9680,0,0,0,9680,9680,0,0,0,0,0
2855,l1810,20171120,9680,9680,0,0,0,9680,9680,0,0,0,0,0
2856,l1810,20171121,9680,9680,0,0,0,9680,9680,0,0,0,0,0
2857,l1810,20171122,9680,9680,0,0,0,9680,9680,0,0,0,0,0
2858,l1810,20171123,9680,9680,0,0,0,9680,9680,0,0,0,0,0
2859,l1810,20171124,9680,9680,0,0,0,9680,9680,0,0,0,0,0
2860,l1810,20171127,9680,9680,9575,9575,9270,9270,9420,-410,-260,4,188450,2
2861,l1810,20171128,9270,9420,0,0,0,9420,9420,0,0,0,0,2
2862,l1810,20171129,9420,9420,0,0,0,9420,9420,0,0,0,0,2
2863,l1810,20171130,9420,9420,0,0,0,9335,9335,-85,-85,0,0,2
2864,l1810,20171201,9335,9335,0,0,0,9335,9335,0,0,0,0,2
2865,l1810,20171204,9335,9335,0,0,0,9335,9335,0,0,0,0,2
2866,l1810,20171205,9335,9335,0,0,0,9335,9335,0,0,0,0,2
2867,l1810,20171206,9335,9335,0,0,0,9280,9280,-55,-55,0,0,2
2868,l1810,20171207,9280,9280,0,0,0,9280,9280,0,0,0,0,2
2869,l1810,20171208,9280,9280,0,0,0,9280,9280,0,0,0,0,2
2870,l1810,20171211,9280,9280,0,0,0,9280,9280,0,0,0,0,2
2871,l1810,20171212,9280,9280,0,0,0,9280,9280,0,0,0,0,2
2872,l1810,20171213,9280,9280,0,0,0,9280,9280,0,0,0,0,2
2873,l1810,20171214,9280,9280,0,0,0,9275,9275,-5,-5,0,0,2
2874,l1810,20171215,9275,9275,0,0,0,9275,9275,0,0,0,0,2
2875,l1810,20171218,9275,9275,0,0,0,9275,9275,0,0,0,0,2
2876,l1810,20171219,9275,9275,0,0,0,9380,9380,105,105,0,0,2
2877,l1810,20171220,9380,9380,0,0,0,9380,9380,0,0,0,0,2
2878,l1810,20171221,9380,9380,0,0,0,9380,9380,0,0,0,0,2
2879,l1810,20171222,9380,9380,0,0,0,9380,9380,0,0,0,0,2
2880,l1810,20171225,9380,9380,0,0,0,9380,9380,0,0,0,0,2
2881,l1810,20171226,9380,9380,0,0,0,9445,9445,65,65,0,0,2
2882,l1810,20171227,9445,9445,9660,9815,9520,9520,9610,75,165,28,1345700,6
2883,l1810,20171228,9520,9610,0,0,0,9610,9610,0,0,0,0,6
2884,l1810,20171229,9610,9610,0,0,0,9610,9610,0,0,0,0,6
2885,l1811,20171115,9755,9755,0,0,0,9755,9755,0,0,0,0,0
2886,l1811,20171116,9755,9755,0,0,0,9755,9755,0,0,0,0,0
2887,l1811,20171117,9755,9755,0,0,0,9755,9755,0,0,0,0,0
2888,l1811,20171120,9755,9755,0,0,0,9755,9755,0,0,0,0,0
2889,l1811,20171121,9755,9755,0,0,0,9755,9755,0,0,0,0,0
2890,l1811,20171122,9755,9755,0,0,0,9755,9755,0,0,0,0,0
2891,l1811,20171123,9755,9755,0,0,0,9755,9755,0,0,0,0,0
2892,l1811,20171124,9755,9755,0,0,0,9755,9755,0,0,0,0,0
2893,l1811,20171127,9755,9755,0,0,0,9755,9755,0,0,0,0,0
2894,l1811,20171128,9755,9755,0,0,0,9510,9510,-245,-245,0,0,0
2895,l1811,20171129,9510,9510,0,0,0,9510,9510,0,0,0,0,0
2896,l1811,20171130,9510,9510,0,0,0,9510,9510,0,0,0,0,0
2897,l1811,20171201,9510,9510,0,0,0,9510,9510,0,0,0,0,0
2898,l1811,20171204,9510,9510,0,0,0,9510,9510,0,0,0,0,0
2899,l1811,20171205,9510,9510,0,0,0,9510,9510,0,0,0,0,0
2900,l1811,20171206,9510,9510,0,0,0,9510,9510,0,0,0,0,0
2901,l1811,20171207,9510,9510,0,0,0,9510,9510,0,0,0,0,0
2902,l1811,20171208,9510,9510,0,0,0,9510,9510,0,0,0,0,0
2903,l1811,20171211,9510,9510,0,0,0,9510,9510,0,0,0,0,0
2904,l1811,20171212,9510,9510,0,0,0,9510,9510,0,0,0,0,0
2905,l1811,20171213,9510,9510,0,0,0,9510,9510,0,0,0,0,0
2906,l1811,20171214,9510,9510,0,0,0,9510,9510,0,0,0,0,0
2907,l1811,20171215,9510,9510,0,0,0,9510,9510,0,0,0,0,0
2908,l1811,20171218,9510,9510,0,0,0,9510,9510,0,0,0,0,0
2909,l1811,20171219,9510,9510,0,0,0,9510,9510,0,0,0,0,0
2910,l1811,20171220,9510,9510,0,0,0,9510,9510,0,0,0,0,0
2911,l1811,20171221,9510,9510,0,0,0,9510,9510,0,0,0,0,0
2912,l1811,20171222,9510,9510,0,0,0,9510,9510,0,0,0,0,0
2913,l1811,20171225,9510,9510,0,0,0,9510,9510,0,0,0,0,0
2914,l1811,20171226,9510,9510,0,0,0,9510,9510,0,0,0,0,0
2915,l1811,20171227,9510,9510,0,0,0,9510,9510,0,0,0,0,0
2916,l1811,20171228,9510,9510,0,0,0,9510,9510,0,0,0,0,0
2917,l1811,20171229,9510,9510,0,0,0,9510,9510,0,0,0,0,0
2918,l1812,20171215,9510,9510,0,0,0,9510,9510,0,0,0,0,0
2919,l1812,20171218,9510,9510,0,0,0,9510,9510,0,0,0,0,0
2920,l1812,20171219,9510,9510,0,0,0,9510,9510,0,0,0,0,0
2921,l1812,20171220,9510,9510,0,0,0,9510,9510,0,0,0,0,0
2922,l1812,20171221,9510,9510,0,0,0,9510,9510,0,0,0,0,0
2923,l1812,20171222,9510,9510,0,0,0,9510,9510,0,0,0,0,0
2924,l1812,20171225,9510,9510,0,0,0,9510,9510,0,0,0,0,0
2925,l1812,20171226,9510,9510,0,0,0,9510,9510,0,0,0,0,0
2926,l1812,20171227,9510,9510,0,0,0,9510,9510,0,0,0,0,0
2927,l1812,20171228,9510,9510,0,0,0,9510,9510,0,0,0,0,0
2928,l1812,20171229,9510,9510,9600,9600,9600,9600,9600,90,90,2,96000,2
