   ,合约,日期,前收盘价,前结算价,开盘价,最高价,最低价,收盘价,结算价,涨跌1,涨跌2,成交量,成交金额,持仓量
1,jm1307,20130322,0,1300,1300,1300,1235,1237,1254,-63,-46,828,62316000,294
2,jm1307,20130325,1237,1254,1234,1246,1228,1231,1238,-23,-16,120,8913600,304
3,jm1307,20130326,1231,1238,1228,1242,1228,1239,1236,1,-2,138,10241520,280
4,jm1307,20130327,1239,1236,1245,1245,1227,1230,1232,-6,-4,28,2070720,272
5,jm1307,20130328,1230,1232,1228,1239,1226,1234,1232,2,0,142,10502160,220
6,jm1307,20130329,1234,1232,1227,1241,1218,1228,1229,-4,-3,60,4427640,196
7,jm1307,20130401,1228,1229,1215,1215,1180,1191,1205,-38,-24,308,22271040,176
8,jm1307,20130402,1191,1205,1194,1221,1188,1215,1203,10,-2,184,13284240,102
9,jm1307,20130403,1215,1203,1204,1217,1204,1210,1211,7,8,30,2181120,88
10,jm1307,20130408,1210,1211,1210,1210,1191,1206,1199,-5,-12,24,1727640,76
11,jm1307,20130409,1206,1199,1215,1218,1205,1209,1213,10,14,38,2766480,52
12,jm1307,20130410,1209,1213,1213,1213,1212,1212,1212,-1,-1,6,436440,52
13,jm1307,20130411,1212,1212,1212,1212,1204,1204,1210,-8,-2,8,580800,48
14,jm1307,20130412,1204,1210,1204,1204,1199,1201,1201,-9,-9,18,1297200,46
15,jm1307,20130415,1201,1201,1182,1182,1156,1163,1165,-38,-36,34,2377320,38
16,jm1307,20130416,1163,1165,1138,1159,1133,1159,1142,-6,-23,30,2056800,34
17,jm1307,20130417,1159,1142,1147,1147,1133,1144,1139,2,-3,8,546840,28
18,jm1307,20130418,1144,1139,1144,1144,1131,1134,1135,-5,-4,8,544920,28
19,jm1307,20130419,1134,1135,1134,1134,1133,1133,1133,-2,-2,6,408000,24
20,jm1307,20130422,1133,1133,0,0,0,1129,1129,-4,-4,0,0,24
21,jm1307,20130423,1129,1129,1107,1107,1107,1107,1107,-22,-22,4,265680,24
22,jm1307,20130424,1107,1107,1104,1108,1104,1108,1106,1,-1,8,531120,24
23,jm1307,20130425,1108,1106,0,0,0,1106,1106,0,0,0,0,24
24,jm1307,20130426,1106,1106,1121,1121,1096,1096,1108,-10,2,4,266040,24
25,jm1307,20130502,1096,1108,0,0,0,1088,1088,-20,-20,0,0,24
26,jm1307,20130503,1088,1088,0,0,0,1088,1088,0,0,0,0,24
27,jm1307,20130506,1088,1088,0,0,0,1088,1088,0,0,0,0,24
28,jm1307,20130507,1088,1088,1087,1088,1087,1088,1087,0,-1,4,261000,24
29,jm1307,20130508,1088,1087,0,0,0,1087,1087,0,0,0,0,24
30,jm1307,20130509,1087,1087,1073,1073,1070,1071,1071,-16,-16,8,514200,22
31,jm1307,20130510,1071,1071,0,0,0,1071,1071,0,0,0,0,22
32,jm1307,20130513,1071,1071,1110,1110,1110,1110,1110,39,39,2,133200,22
33,jm1307,20130514,1110,1110,0,0,0,1110,1110,0,0,0,0,22
34,jm1307,20130515,1110,1110,0,0,0,1110,1110,0,0,0,0,22
35,jm1307,20130516,1110,1110,1066,1066,1066,1066,1066,-44,-44,4,255840,22
36,jm1307,20130517,1066,1066,1075,1075,1075,1075,1075,9,9,2,129000,22
37,jm1307,20130520,1075,1075,0,0,0,1075,1075,0,0,0,0,22
38,jm1307,20130521,1075,1075,0,0,0,1075,1075,0,0,0,0,22
39,jm1307,20130522,1075,1075,0,0,0,1075,1075,0,0,0,0,22
40,jm1307,20130523,1075,1075,0,0,0,1075,1075,0,0,0,0,22
41,jm1307,20130524,1075,1075,0,0,0,1075,1075,0,0,0,0,22
42,jm1307,20130527,1075,1075,0,0,0,1075,1075,0,0,0,0,22
43,jm1307,20130528,1075,1075,1072,1072,1061,1061,1064,-14,-11,6,383280,18
44,jm1307,20130529,1061,1064,1080,1080,1080,1080,1080,16,16,2,129600,18
45,jm1307,20130530,1080,1080,0,0,0,1079,1079,-1,-1,0,0,18
46,jm1307,20130531,1079,1079,0,0,0,1079,1079,0,0,0,0,18
47,jm1307,20130603,1079,1079,1043,1043,1043,1043,1043,-36,-36,2,125160,20
48,jm1307,20130604,1043,1043,1060,1060,1060,1060,1060,17,17,2,127200,22
49,jm1307,20130605,1060,1060,1038,1057,1035,1035,1044,-25,-16,26,1629000,20
50,jm1307,20130606,1035,1044,0,0,0,1044,1044,0,0,0,0,20
51,jm1307,20130607,1044,1044,1040,1040,1040,1040,1040,-4,-4,2,124800,20
52,jm1307,20130613,1040,1040,0,0,0,1040,1040,0,0,0,0,20
53,jm1307,20130614,1040,1040,999,999,999,999,999,-41,-41,8,479520,14
54,jm1307,20130617,999,999,0,0,0,999,999,0,0,0,0,14
55,jm1307,20130618,999,999,0,0,0,999,999,0,0,0,0,14
56,jm1307,20130619,999,999,0,0,0,999,999,0,0,0,0,14
57,jm1307,20130620,999,999,1021,1021,1004,1004,1012,5,13,12,729000,20
58,jm1307,20130621,1004,1012,0,0,0,1012,1012,0,0,0,0,20
59,jm1307,20130624,1012,1012,973,973,973,973,973,-39,-39,6,350280,14
60,jm1307,20130625,973,973,0,0,0,980,980,7,7,0,0,14
61,jm1307,20130626,980,980,0,0,0,980,980,0,0,0,0,14
62,jm1307,20130627,980,980,1000,1000,1000,1000,1000,20,20,2,120000,14
63,jm1307,20130628,1000,1000,1006,1007,960,960,991,-40,-9,12,713520,8
64,jm1307,20130701,960,991,932,932,932,932,932,-59,-59,8,447360,8
65,jm1307,20130702,932,932,987,987,987,987,987,55,55,2,118440,8
66,jm1307,20130703,987,987,0,0,0,987,987,0,0,0,0,8
67,jm1307,20130704,987,987,0,0,0,987,987,0,0,0,0,8
68,jm1307,20130705,987,987,0,0,0,987,987,0,0,0,0,8
69,jm1307,20130708,987,987,0,0,0,987,987,0,0,0,0,8
70,jm1307,20130709,987,987,0,0,0,987,987,0,0,0,0,8
71,jm1307,20130710,987,987,987,987,987,987,987,0,0,8,473760,0
72,jm1307,20130711,987,987,0,0,0,987,987,0,0,0,0,0
73,jm1307,20130712,987,987,0,0,0,962,962,-25,-25,0,0,0
74,jm1308,20130322,0,1320,1315,1315,1241,1266,1283,-54,-37,42,3233160,24
75,jm1308,20130325,1266,1283,1267,1268,1241,1251,1253,-32,-30,24,1804440,28
76,jm1308,20130326,1251,1253,1254,1265,1252,1259,1255,6,2,16,1205160,26
77,jm1308,20130327,1259,1255,1259,1259,1252,1252,1256,-3,1,6,452400,30
78,jm1308,20130328,1252,1256,1255,1263,1249,1249,1255,-7,-1,62,4670760,22
79,jm1308,20130329,1249,1255,1234,1244,1234,1235,1237,-20,-18,8,593880,20
80,jm1308,20130401,1235,1237,1234,1234,1197,1203,1219,-34,-18,62,4535520,20
81,jm1308,20130402,1203,1219,1202,1210,1176,1210,1192,-9,-27,364,26042160,108
82,jm1308,20130403,1210,1192,1209,1209,1192,1195,1200,3,8,106,7633920,104
83,jm1308,20130408,1195,1200,1188,1194,1181,1194,1189,-6,-11,88,6280920,104
84,jm1308,20130409,1194,1189,1197,1202,1193,1198,1196,9,7,18,1292400,104
85,jm1308,20130410,1198,1196,1197,1213,1187,1187,1197,-9,1,112,8046600,104
86,jm1308,20130411,1187,1197,1192,1193,1181,1181,1189,-16,-8,16,1142160,104
87,jm1308,20130412,1181,1189,1188,1188,1185,1188,1186,-1,-3,8,569640,106
88,jm1308,20130415,1188,1186,1195,1195,1143,1143,1161,-43,-25,22,1533000,104
89,jm1308,20130416,1143,1161,1122,1155,1122,1147,1142,-14,-19,18,1233840,104
90,jm1308,20130417,1147,1142,1135,1137,1135,1137,1136,-5,-6,4,272640,104
91,jm1308,20130418,1137,1136,1132,1132,1101,1122,1120,-14,-16,32,2150760,104
92,jm1308,20130419,1122,1120,1137,1138,1120,1126,1130,6,10,20,1356960,104
93,jm1308,20130422,1126,1130,1118,1118,1111,1111,1113,-19,-17,8,534240,104
94,jm1308,20130423,1111,1113,1107,1107,1094,1094,1100,-19,-13,6,396000,104
95,jm1308,20130424,1094,1100,1089,1136,1089,1107,1112,7,12,126,8411640,104
96,jm1308,20130425,1107,1112,1107,1112,1095,1112,1100,0,-12,24,1585200,104
97,jm1308,20130426,1112,1100,1100,1100,1097,1097,1098,-3,-2,6,395280,106
98,jm1308,20130502,1097,1098,1075,1077,1075,1077,1076,-21,-22,22,1420800,106
99,jm1308,20130503,1077,1076,1099,1099,1086,1086,1092,10,16,8,524400,106
100,jm1308,20130506,1086,1092,0,0,0,1092,1092,0,0,0,0,106
101,jm1308,20130507,1092,1092,1104,1104,1096,1104,1101,12,9,6,396480,106
102,jm1308,20130508,1104,1101,1091,1109,1091,1109,1098,8,-3,14,922320,108
103,jm1308,20130509,1109,1098,1100,1103,1100,1100,1102,2,4,16,1058160,108
104,jm1308,20130510,1100,1102,1101,1101,1101,1101,1101,-1,-1,2,132120,106
105,jm1308,20130513,1101,1101,1114,1144,1106,1129,1125,28,24,22,1485480,106
106,jm1308,20130514,1129,1125,1134,1134,1130,1134,1131,9,6,12,814560,106
107,jm1308,20130515,1134,1131,0,0,0,1131,1131,0,0,0,0,106
108,jm1308,20130516,1131,1131,1093,1126,1091,1107,1099,-24,-32,26,1714680,106
109,jm1308,20130517,1107,1099,1104,1125,1104,1125,1121,26,22,12,807480,112
110,jm1308,20130520,1125,1121,1121,1121,1121,1121,1121,0,0,4,269040,112
111,jm1308,20130521,1121,1121,1146,1146,1110,1111,1118,-10,-3,20,1342200,108
112,jm1308,20130522,1111,1118,1117,1117,1117,1117,1117,-1,-1,2,134040,108
113,jm1308,20130523,1117,1117,1116,1118,1104,1105,1112,-12,-5,18,1201920,104
114,jm1308,20130524,1105,1112,0,0,0,1112,1112,0,0,0,0,104
115,jm1308,20130527,1112,1112,1112,1112,1112,1112,1112,0,0,2,133440,104
116,jm1308,20130528,1112,1112,1073,1082,1073,1082,1078,-30,-34,12,776640,104
117,jm1308,20130529,1082,1078,1076,1076,1076,1076,1076,-2,-2,2,129120,104
118,jm1308,20130530,1076,1076,1061,1068,1057,1068,1061,-8,-15,10,636600,104
119,jm1308,20130531,1068,1061,1056,1056,1056,1056,1056,-5,-5,2,126720,104
120,jm1308,20130603,1056,1056,1050,1057,1043,1043,1048,-13,-8,8,503160,104
121,jm1308,20130604,1043,1048,1051,1058,1012,1046,1035,-2,-13,28,1739400,104
122,jm1308,20130605,1046,1035,1053,1053,1052,1052,1052,17,17,4,252600,104
123,jm1308,20130606,1052,1052,1026,1026,1010,1010,1013,-42,-39,20,1215600,102
124,jm1308,20130607,1010,1013,1002,1013,986,1000,999,-13,-14,26,1559280,100
125,jm1308,20130613,1000,999,993,995,992,995,993,-4,-6,8,477000,104
126,jm1308,20130614,995,993,996,996,992,996,995,3,2,16,955680,98
127,jm1308,20130617,996,995,999,1011,999,1001,1004,6,9,22,1326360,92
128,jm1308,20130618,1001,1004,995,999,992,992,996,-12,-8,8,478200,92
129,jm1308,20130619,992,996,992,992,987,990,989,-6,-7,10,593400,94
130,jm1308,20130620,990,989,985,989,965,980,981,-9,-8,66,3887520,62
131,jm1308,20130621,980,981,970,981,970,978,976,-3,-5,14,819840,54
132,jm1308,20130624,978,976,991,1002,977,990,992,14,16,74,4404840,28
133,jm1308,20130625,990,992,0,0,0,992,992,0,0,0,0,28
134,jm1308,20130626,992,992,985,1005,985,1004,996,12,4,8,478080,30
135,jm1308,20130627,1004,996,996,996,996,996,996,0,0,4,239040,28
136,jm1308,20130628,996,996,0,0,0,996,996,0,0,0,0,28
137,jm1308,20130701,996,996,988,988,987,987,987,-9,-9,10,592320,26
138,jm1308,20130702,987,987,996,996,985,985,990,-2,3,4,237720,26
139,jm1308,20130703,985,990,0,0,0,990,990,0,0,0,0,26
140,jm1308,20130704,990,990,1002,1004,1002,1004,1002,14,12,8,481320,18
141,jm1308,20130705,1004,1002,1003,1013,1003,1010,1007,8,5,12,725280,16
142,jm1308,20130708,1010,1007,1016,1016,1016,1016,1016,9,9,2,121920,18
143,jm1308,20130709,1016,1016,1005,1013,997,1013,1005,-3,-11,16,965040,12
144,jm1308,20130710,1013,1005,1008,1008,1008,1008,1008,3,3,2,120960,10
145,jm1308,20130711,1008,1008,0,0,0,1008,1008,0,0,0,0,10
146,jm1308,20130712,1008,1008,1010,1010,1010,1010,1010,2,2,6,363600,10
147,jm1308,20130715,1010,1010,995,995,995,995,995,-15,-15,2,119400,10
148,jm1308,20130716,995,995,998,998,998,998,998,3,3,2,119760,8
149,jm1308,20130717,998,998,0,0,0,998,998,0,0,0,0,8
150,jm1308,20130718,998,998,1006,1006,962,1000,989,2,-9,6,356160,8
151,jm1308,20130719,1000,989,0,0,0,989,989,0,0,0,0,8
152,jm1308,20130722,989,989,0,0,0,993,993,4,4,0,0,8
153,jm1308,20130723,993,993,0,0,0,993,993,0,0,0,0,8
154,jm1308,20130724,993,993,1008,1008,1008,1008,1008,15,15,6,362880,2
155,jm1308,20130725,1008,1008,0,0,0,1008,1008,0,0,0,0,2
156,jm1308,20130726,1008,1008,0,0,0,1008,1008,0,0,0,0,2
157,jm1308,20130729,1008,1008,0,0,0,1008,1008,0,0,0,0,2
158,jm1308,20130730,1008,1008,0,0,0,1008,1008,0,0,0,0,2
159,jm1308,20130731,1008,1008,1048,1048,1048,1048,1048,40,40,2,125760,0
160,jm1308,20130801,1048,1048,0,0,0,1048,1048,0,0,0,0,0
161,jm1308,20130802,1048,1048,0,0,0,1048,1048,0,0,0,0,0
162,jm1308,20130805,1048,1048,0,0,0,1048,1048,0,0,0,0,0
163,jm1308,20130806,1048,1048,0,0,0,1048,1048,0,0,0,0,0
164,jm1308,20130807,1048,1048,0,0,0,1048,1048,0,0,0,0,0
165,jm1308,20130808,1048,1048,0,0,0,1048,1048,0,0,0,0,0
166,jm1308,20130809,1048,1048,0,0,0,1048,1048,0,0,0,0,0
167,jm1308,20130812,1048,1048,0,0,0,1048,1048,0,0,0,0,0
168,jm1308,20130813,1048,1048,0,0,0,1048,1048,0,0,0,0,0
169,jm1308,20130814,1048,1048,0,0,0,1048,1048,0,0,0,0,0
170,jm1309,20130322,0,1340,1280,1304,1257,1267,1276,-73,-64,845512,64781058120,96086
171,jm1309,20130325,1267,1276,1276,1286,1251,1258,1266,-18,-10,722022,54874344480,139712
172,jm1309,20130326,1258,1266,1255,1276,1249,1272,1265,6,-1,835326,63447633960,141544
173,jm1309,20130327,1272,1265,1279,1279,1260,1261,1266,-4,1,499234,37939174560,126094
174,jm1309,20130328,1261,1266,1264,1273,1248,1259,1263,-7,-3,646266,48998378400,99004
175,jm1309,20130329,1259,1263,1257,1268,1231,1240,1252,-23,-11,734728,55198605600,96024
176,jm1309,20130401,1240,1252,1235,1242,1202,1202,1215,-50,-37,710132,51791801880,155262
177,jm1309,20130402,1202,1215,1197,1231,1192,1228,1209,13,-6,1049448,76140051120,130106
178,jm1309,20130403,1228,1209,1225,1233,1214,1216,1221,7,12,606564,44471813880,103114
179,jm1309,20130408,1216,1221,1199,1223,1197,1220,1211,-1,-10,555970,40406335800,121180
180,jm1309,20130409,1220,1211,1222,1232,1213,1223,1223,12,12,551698,40512897240,143828
181,jm1309,20130410,1223,1223,1225,1227,1211,1215,1218,-8,-5,377802,27628031760,133686
182,jm1309,20130411,1215,1218,1209,1225,1202,1206,1214,-12,-4,403510,29397528360,137344
183,jm1309,20130412,1206,1214,1206,1220,1203,1209,1212,-5,-2,462186,33620987040,137526
184,jm1309,20130415,1209,1212,1191,1195,1164,1174,1181,-38,-31,442460,31359669360,128974
185,jm1309,20130416,1174,1181,1160,1180,1151,1179,1170,-2,-11,326226,22904003400,118742
186,jm1309,20130417,1179,1170,1182,1189,1148,1165,1163,-5,-7,702122,49036004160,121140
187,jm1309,20130418,1165,1163,1149,1169,1127,1157,1145,-6,-18,571028,39248124360,123652
188,jm1309,20130419,1157,1145,1160,1167,1148,1163,1158,18,13,428568,29790256800,123092
189,jm1309,20130422,1163,1158,1161,1164,1146,1146,1150,-12,-8,273978,18918689280,112424
190,jm1309,20130423,1146,1150,1151,1153,1129,1134,1139,-16,-11,239490,16378952760,104430
191,jm1309,20130424,1134,1139,1134,1158,1129,1145,1141,6,2,410522,28117974600,98632
192,jm1309,20130425,1145,1141,1144,1148,1137,1142,1142,1,1,158444,10865461800,87468
193,jm1309,20130426,1142,1142,1147,1155,1136,1138,1145,-4,3,165514,11373639960,76072
194,jm1309,20130502,1138,1145,1123,1123,1102,1119,1118,-26,-27,111004,7448520120,82206
195,jm1309,20130503,1119,1118,1128,1138,1124,1129,1129,11,11,182180,12347654400,91990
196,jm1309,20130506,1129,1129,1147,1149,1135,1140,1141,11,12,119430,8176386720,86880
197,jm1309,20130507,1140,1141,1135,1148,1131,1134,1138,-7,-3,108358,7399214400,82130
198,jm1309,20130508,1134,1138,1133,1149,1132,1148,1140,10,2,89126,6101386920,85916
199,jm1309,20130509,1148,1140,1146,1150,1138,1142,1143,2,3,89712,6156320880,83144
200,jm1309,20130510,1142,1143,1142,1153,1137,1150,1144,7,1,87178,5986623360,81344
201,jm1309,20130513,1150,1144,1150,1187,1146,1178,1172,34,28,339222,23863902120,90620
202,jm1309,20130514,1178,1172,1179,1185,1161,1180,1174,8,2,298132,21006587160,89308
203,jm1309,20130515,1180,1174,1176,1180,1143,1145,1164,-29,-10,312422,21829410840,82016
204,jm1309,20130516,1145,1164,1146,1157,1125,1146,1144,-18,-20,321066,22051566960,83884
205,jm1309,20130517,1146,1144,1150,1165,1142,1163,1154,19,10,346354,23997977880,80466
206,jm1309,20130520,1163,1154,1161,1173,1160,1162,1166,8,12,207376,14512015560,84028
207,jm1309,20130521,1162,1166,1166,1171,1151,1163,1160,-3,-6,204500,14239373520,87446
208,jm1309,20130522,1163,1160,1159,1175,1158,1170,1167,10,7,171670,12027928800,88040
209,jm1309,20130523,1170,1167,1159,1164,1145,1145,1156,-22,-11,175054,12144569040,82002
210,jm1309,20130524,1145,1156,1149,1156,1143,1144,1151,-12,-5,136242,9411669360,82428
211,jm1309,20130527,1144,1151,1141,1141,1126,1127,1134,-24,-17,133258,9074042160,79374
212,jm1309,20130528,1127,1134,1128,1131,1119,1125,1124,-9,-10,123140,8305266600,83870
213,jm1309,20130529,1125,1124,1125,1130,1108,1111,1121,-13,-3,153690,10339403400,92118
214,jm1309,20130530,1111,1121,1103,1114,1100,1108,1107,-13,-14,182216,12105801720,92916
215,jm1309,20130531,1108,1107,1115,1115,1093,1094,1102,-13,-5,162744,10765921680,100388
216,jm1309,20130603,1094,1102,1094,1105,1084,1098,1093,-4,-9,213142,13989922440,97522
217,jm1309,20130604,1098,1093,1101,1102,1090,1102,1096,9,3,154230,10148997600,99082
218,jm1309,20130605,1102,1096,1105,1105,1092,1100,1100,4,4,140344,9264804840,100090
219,jm1309,20130606,1100,1100,1096,1096,1056,1056,1067,-44,-33,299564,19187020200,131436
220,jm1309,20130607,1056,1067,1050,1054,1032,1042,1043,-25,-24,293122,18359890800,123800
221,jm1309,20130613,1042,1043,1033,1042,1025,1035,1033,-8,-10,187906,11651722800,129210
222,jm1309,20130614,1035,1033,1039,1040,1024,1030,1031,-3,-2,220264,13634615640,143904
223,jm1309,20130617,1030,1031,1034,1059,1031,1041,1045,10,14,269668,16918576440,131400
224,jm1309,20130618,1041,1045,1045,1045,1035,1041,1040,-4,-5,143168,8938470720,133542
225,jm1309,20130619,1041,1040,1040,1041,1023,1033,1029,-7,-11,330166,20393489640,154298
226,jm1309,20130620,1033,1029,1025,1027,998,1005,1011,-24,-18,382750,23226059400,173054
227,jm1309,20130621,1005,1011,995,1015,989,1006,1003,-5,-8,265770,15996672360,154314
228,jm1309,20130624,1006,1003,1008,1018,996,998,1006,-5,3,257564,15561692160,142646
229,jm1309,20130625,998,1006,1001,1013,996,1011,1004,5,-2,165938,10001287920,126368
230,jm1309,20130626,1011,1004,1015,1019,1000,1004,1005,0,1,102428,6180603240,119844
231,jm1309,20130627,1004,1005,1005,1011,999,1006,1005,1,0,58000,3497531520,110328
232,jm1309,20130628,1006,1005,1004,1009,1000,1001,1004,-4,-1,35986,2168405040,101306
233,jm1309,20130701,1001,1004,1000,1006,987,996,995,-8,-9,58046,3468680280,99076
234,jm1309,20130702,996,995,998,1003,991,997,996,2,1,58896,3523043880,82194
235,jm1309,20130703,997,996,1000,1004,992,1001,998,5,2,30356,1818719640,76534
236,jm1309,20130704,1001,998,1001,1017,998,1015,1008,17,10,37426,2265488520,64236
237,jm1309,20130705,1015,1008,1015,1019,1012,1017,1015,9,7,16522,1007072400,58778
238,jm1309,20130708,1017,1015,1019,1019,1006,1009,1010,-6,-5,9442,572365440,57534
239,jm1309,20130709,1009,1010,1010,1013,1005,1005,1009,-5,-1,6102,369738960,55986
240,jm1309,20130710,1005,1009,1003,1024,999,1019,1013,10,4,28690,1744330800,50432
241,jm1309,20130711,1019,1013,1024,1038,1021,1025,1028,12,15,36110,2227394160,37774
242,jm1309,20130712,1025,1028,1026,1026,1015,1017,1021,-11,-7,7302,447432000,36710
243,jm1309,20130715,1017,1021,1012,1018,1004,1004,1009,-17,-12,5410,327771600,34918
244,jm1309,20130716,1004,1009,1004,1009,1002,1005,1005,-4,-4,3016,181874280,34356
245,jm1309,20130717,1005,1005,1005,1020,1004,1016,1013,11,8,11650,708691920,32628
246,jm1309,20130718,1016,1013,1017,1020,1010,1016,1014,3,1,9308,566596440,32044
247,jm1309,20130719,1016,1014,1020,1025,1014,1015,1019,1,5,5482,335286360,31268
248,jm1309,20130722,1015,1019,1018,1027,1012,1020,1022,1,3,9170,562434360,27804
249,jm1309,20130723,1020,1022,1019,1023,1014,1015,1016,-7,-6,8018,489029400,26546
250,jm1309,20130724,1015,1016,1015,1018,1007,1010,1012,-6,-4,5292,321559320,24772
251,jm1309,20130725,1010,1012,1009,1015,1008,1010,1011,-2,-1,3384,205313760,23098
252,jm1309,20130726,1010,1011,1013,1017,1008,1011,1012,0,1,9462,575004000,21040
253,jm1309,20130729,1011,1012,1010,1010,996,996,1002,-16,-10,9004,541635000,16182
254,jm1309,20130730,996,1002,996,1000,993,995,996,-7,-6,3372,201511800,15748
255,jm1309,20130731,995,996,994,998,993,996,995,0,-1,1376,82200840,15746
256,jm1309,20130801,996,995,997,1005,996,1005,1002,10,7,4940,297016560,13788
257,jm1309,20130802,1005,1002,1008,1011,1006,1011,1008,9,6,1986,120225480,13104
258,jm1309,20130805,1011,1008,1007,1015,1007,1012,1011,4,3,1870,113521560,13078
259,jm1309,20130806,1012,1011,1013,1015,1006,1015,1011,4,0,1744,105844680,11844
260,jm1309,20130807,1015,1011,1013,1018,1009,1018,1014,7,3,2768,168548040,10190
261,jm1309,20130808,1018,1014,1018,1029,1017,1026,1023,12,9,3784,232396560,9662
262,jm1309,20130809,1026,1023,1029,1030,1011,1020,1018,-3,-5,2848,174048960,9810
263,jm1309,20130812,1020,1018,1025,1030,1016,1028,1024,10,6,3076,189018840,10034
264,jm1309,20130813,1028,1024,1040,1040,1022,1031,1028,7,4,3650,225338880,9234
265,jm1309,20130814,1031,1028,1028,1033,1022,1022,1025,-6,-3,1678,103239360,8524
266,jm1309,20130815,1022,1025,1022,1040,1022,1025,1029,0,4,1482,91512720,7770
267,jm1309,20130816,1025,1029,1025,1029,1019,1021,1021,-8,-8,1310,80280840,6844
268,jm1309,20130819,1021,1021,1018,1030,1017,1023,1025,2,4,982,60398880,6398
269,jm1309,20130820,1023,1025,1022,1030,1017,1026,1024,1,-1,1050,64566720,6316
270,jm1309,20130821,1026,1024,1028,1030,1021,1025,1024,1,0,416,25576200,6114
271,jm1309,20130822,1025,1024,1021,1030,1020,1023,1024,-1,0,872,53588640,5768
272,jm1309,20130823,1023,1024,1026,1028,1002,1006,1018,-18,-6,1654,101054280,5036
273,jm1309,20130826,1006,1018,1015,1015,1000,1007,1006,-11,-12,1172,70806600,4772
274,jm1309,20130827,1007,1006,1003,1005,1000,1002,1002,-4,-4,694,41738760,4432
275,jm1309,20130828,1002,1002,999,1000,962,965,985,-37,-17,1054,62324400,3658
276,jm1309,20130829,965,985,964,964,950,952,953,-33,-32,970,55506960,3136
277,jm1309,20130830,952,953,950,970,938,940,957,-13,4,1226,70434840,2800
278,jm1309,20130902,940,957,950,1013,950,995,1002,38,45,540,32467080,2400
279,jm1309,20130903,995,1002,1000,1035,1000,1007,1019,5,17,484,29607360,2200
280,jm1309,20130904,1007,1019,1015,1015,1000,1000,1006,-19,-13,18,1087200,2200
281,jm1309,20130905,1000,1006,995,995,966,985,982,-21,-24,266,15686760,2202
282,jm1309,20130906,985,982,980,980,955,955,967,-27,-15,88,5109120,2200
283,jm1309,20130909,955,967,955,955,950,955,952,-12,-15,400,22864800,1980
284,jm1309,20130910,955,952,970,1000,970,1000,981,48,29,80,4710000,1900
285,jm1309,20130911,1000,981,0,0,0,981,981,0,0,0,0,1900
286,jm1309,20130912,981,981,985,985,985,985,985,4,4,100,5910000,1800
287,jm1309,20130913,985,985,0,0,0,990,990,5,5,0,0,0
288,jm1310,20130322,0,1360,1300,1333,1261,1301,1293,-59,-67,292,22658880,44
289,jm1310,20130325,1301,1293,1275,1327,1275,1277,1287,-16,-6,98,7570080,12
290,jm1310,20130326,1277,1287,1279,1279,1279,1279,1279,-8,-8,6,460440,10
291,jm1310,20130327,1279,1279,1286,1290,1286,1289,1288,10,9,12,927480,14
292,jm1310,20130328,1289,1288,1289,1291,1271,1271,1285,-17,-3,22,1696680,12
293,jm1310,20130329,1271,1285,1273,1295,1268,1268,1281,-17,-4,16,1230360,12
294,jm1310,20130401,1268,1281,1256,1256,1238,1238,1247,-43,-34,4,299280,12
295,jm1310,20130402,1238,1247,1235,1250,1235,1250,1241,3,-6,8,595920,16
296,jm1310,20130403,1250,1241,1242,1252,1242,1248,1246,7,5,12,897360,14
297,jm1310,20130408,1248,1246,1224,1239,1224,1227,1230,-19,-16,6,442800,14
298,jm1310,20130409,1227,1230,1229,1251,1229,1238,1242,8,12,46,3430200,24
299,jm1310,20130410,1238,1242,1245,1250,1242,1242,1246,0,4,20,1496280,14
300,jm1310,20130411,1242,1246,1243,1246,1241,1242,1243,-4,-3,16,1193280,20
301,jm1310,20130412,1242,1243,1239,1239,1237,1237,1237,-6,-6,6,445560,14
302,jm1310,20130415,1237,1237,1209,1209,1198,1198,1199,-39,-38,12,863880,4
303,jm1310,20130416,1198,1199,1203,1203,1193,1203,1199,4,0,10,719400,6
304,jm1310,20130417,1203,1199,1204,1204,1154,1175,1189,-24,-10,110,7853280,6
305,jm1310,20130418,1175,1189,0,0,0,1171,1171,-18,-18,0,0,6
306,jm1310,20130419,1171,1171,1192,1192,1170,1170,1184,-1,13,26,1847520,8
307,jm1310,20130422,1170,1184,0,0,0,1176,1176,-8,-8,0,0,8
308,jm1310,20130423,1176,1176,0,0,0,1165,1165,-11,-11,0,0,8
309,jm1310,20130424,1165,1165,0,0,0,1165,1165,0,0,0,0,8
310,jm1310,20130425,1165,1165,1149,1165,1149,1165,1154,0,-11,6,415560,6
311,jm1310,20130426,1165,1154,1165,1165,1165,1165,1165,11,11,2,139800,6
312,jm1310,20130502,1165,1165,0,0,0,1138,1138,-27,-27,0,0,6
313,jm1310,20130503,1138,1138,0,0,0,1149,1149,11,11,0,0,6
314,jm1310,20130506,1149,1149,0,0,0,1161,1161,12,12,0,0,6
315,jm1310,20130507,1161,1161,1144,1157,1144,1157,1149,-4,-12,20,1379760,4
316,jm1310,20130508,1157,1149,0,0,0,1151,1151,2,2,0,0,4
317,jm1310,20130509,1151,1151,1151,1151,1141,1141,1147,-10,-4,8,550560,8
318,jm1310,20130510,1141,1147,1166,1166,1166,1166,1166,19,19,2,139920,8
319,jm1310,20130513,1166,1166,1152,1197,1152,1191,1170,25,4,58,4074480,8
320,jm1310,20130514,1191,1170,1178,1202,1178,1191,1191,21,21,12,857880,10
321,jm1310,20130515,1191,1191,1198,1198,1172,1172,1189,-19,-2,6,428160,8
322,jm1310,20130516,1172,1189,1184,1184,1158,1158,1171,-31,-18,4,281040,8
323,jm1310,20130517,1158,1171,1193,1193,1180,1192,1188,21,17,6,427800,8
324,jm1310,20130520,1192,1188,1184,1184,1184,1184,1184,-4,-4,2,142080,8
325,jm1310,20130521,1184,1184,1184,1184,1166,1166,1178,-18,-6,6,424080,8
326,jm1310,20130522,1166,1178,1168,1192,1168,1192,1180,14,2,4,283200,10
327,jm1310,20130523,1192,1180,1169,1178,1167,1167,1170,-13,-10,10,702240,8
328,jm1310,20130524,1167,1170,0,0,0,1165,1165,-5,-5,0,0,8
329,jm1310,20130527,1165,1165,0,0,0,1148,1148,-17,-17,0,0,8
330,jm1310,20130528,1148,1148,1125,1154,1125,1154,1143,6,-5,6,411600,10
331,jm1310,20130529,1154,1143,1131,1131,1131,1131,1131,-12,-12,2,135720,8
332,jm1310,20130530,1131,1131,0,0,0,1117,1117,-14,-14,0,0,8
333,jm1310,20130531,1117,1117,0,0,0,1112,1112,-5,-5,0,0,8
334,jm1310,20130603,1112,1112,0,0,0,1103,1103,-9,-9,0,0,8
335,jm1310,20130604,1103,1103,1103,1109,1096,1109,1102,6,-1,12,793680,16
336,jm1310,20130605,1109,1102,1103,1103,1103,1103,1103,1,1,10,661800,20
337,jm1310,20130606,1103,1103,1102,1103,1080,1081,1096,-22,-7,20,1315440,14
338,jm1310,20130607,1081,1096,1050,1064,1050,1064,1057,-32,-39,4,253680,12
339,jm1310,20130613,1064,1057,0,0,0,1057,1057,0,0,0,0,12
340,jm1310,20130614,1057,1057,1050,1050,1040,1040,1045,-17,-12,4,250800,14
341,jm1310,20130617,1040,1045,1056,1056,1042,1051,1049,6,4,6,377880,12
342,jm1310,20130618,1051,1049,1051,1051,1051,1051,1051,2,2,2,126120,10
343,jm1310,20130619,1051,1051,0,0,0,1040,1040,-11,-11,0,0,10
344,jm1310,20130620,1040,1040,1019,1031,1019,1031,1025,-9,-15,20,1230000,10
345,jm1310,20130621,1031,1025,0,0,0,1017,1017,-8,-8,0,0,10
346,jm1310,20130624,1017,1017,1010,1031,1001,1001,1015,-16,-2,14,853080,10
347,jm1310,20130625,1001,1015,1005,1005,1005,1005,1005,-10,-10,2,120600,12
348,jm1310,20130626,1005,1005,1013,1013,1013,1013,1013,8,8,2,121560,10
349,jm1310,20130627,1013,1013,1020,1020,1020,1020,1020,7,7,10,612000,10
350,jm1310,20130628,1020,1020,1016,1016,1016,1016,1016,-4,-4,2,121920,8
351,jm1310,20130701,1016,1016,1011,1011,1011,1011,1011,-5,-5,6,363960,8
352,jm1310,20130702,1011,1011,1001,1004,1001,1004,1002,-7,-9,4,240600,10
353,jm1310,20130703,1004,1002,1014,1014,996,1012,1004,10,2,12,723120,10
354,jm1310,20130704,1012,1004,0,0,0,1014,1014,10,10,0,0,10
355,jm1310,20130705,1014,1014,0,0,0,1021,1021,7,7,0,0,10
356,jm1310,20130708,1021,1021,0,0,0,1016,1016,-5,-5,0,0,10
357,jm1310,20130709,1016,1016,0,0,0,1015,1015,-1,-1,0,0,10
358,jm1310,20130710,1015,1015,1030,1030,1022,1022,1026,7,11,4,246240,10
359,jm1310,20130711,1022,1026,1058,1058,1036,1050,1047,24,21,40,2514240,12
360,jm1310,20130712,1050,1047,0,0,0,1040,1040,-7,-7,0,0,12
361,jm1310,20130715,1040,1040,0,0,0,1028,1028,-12,-12,0,0,12
362,jm1310,20130716,1028,1028,0,0,0,1024,1024,-4,-4,0,0,12
363,jm1310,20130717,1024,1024,0,0,0,1032,1032,8,8,0,0,12
364,jm1310,20130718,1032,1032,1034,1034,1034,1034,1034,2,2,4,248160,8
365,jm1310,20130719,1034,1034,0,0,0,1039,1039,5,5,0,0,8
366,jm1310,20130722,1039,1039,0,0,0,1042,1042,3,3,0,0,8
367,jm1310,20130723,1042,1042,0,0,0,1036,1036,-6,-6,0,0,8
368,jm1310,20130724,1036,1036,0,0,0,1032,1032,-4,-4,0,0,8
369,jm1310,20130725,1032,1032,1019,1019,1019,1019,1019,-13,-13,2,122280,8
370,jm1310,20130726,1019,1019,0,0,0,1020,1020,1,1,0,0,8
371,jm1310,20130729,1020,1020,1010,1010,1010,1010,1010,-10,-10,2,121200,8
372,jm1310,20130730,1010,1010,0,0,0,1004,1004,-6,-6,0,0,8
373,jm1310,20130731,1004,1004,0,0,0,1003,1003,-1,-1,0,0,8
374,jm1310,20130801,1003,1003,0,0,0,1010,1010,7,7,0,0,8
375,jm1310,20130802,1010,1010,1017,1026,1017,1026,1021,16,11,4,245160,8
376,jm1310,20130805,1026,1021,0,0,0,1024,1024,3,3,0,0,8
377,jm1310,20130806,1024,1024,0,0,0,1024,1024,0,0,0,0,8
378,jm1310,20130807,1024,1024,0,0,0,1027,1027,3,3,0,0,8
379,jm1310,20130808,1027,1027,1046,1046,1046,1046,1046,19,19,10,627600,6
380,jm1310,20130809,1046,1046,1043,1043,1043,1043,1043,-3,-3,2,125160,6
381,jm1310,20130812,1043,1043,0,0,0,1049,1049,6,6,0,0,6
382,jm1310,20130813,1049,1049,1090,1090,1090,1090,1090,41,41,2,130800,8
383,jm1310,20130814,1090,1090,1085,1085,1085,1085,1085,-5,-5,2,130200,10
384,jm1310,20130815,1085,1085,1081,1081,1081,1081,1081,-4,-4,2,129720,12
385,jm1310,20130816,1081,1081,1051,1074,1050,1071,1062,-10,-19,12,764640,8
386,jm1310,20130819,1071,1062,1038,1039,1020,1020,1028,-42,-34,234,14433720,200
387,jm1310,20130820,1020,1028,1020,1030,1016,1021,1021,-7,-7,72,4412640,204
388,jm1310,20130821,1021,1021,1027,1027,1013,1016,1020,-5,-1,40,2449920,206
389,jm1310,20130822,1016,1020,1020,1026,1016,1016,1021,-4,1,30,1839360,206
390,jm1310,20130823,1016,1021,1025,1028,997,1008,1015,-13,-6,66,4022760,208
391,jm1310,20130826,1008,1015,1018,1036,1013,1017,1022,2,7,58,3558720,222
392,jm1310,20130827,1017,1022,1008,1022,1007,1020,1016,-2,-6,74,4512840,222
393,jm1310,20130828,1020,1016,1014,1014,984,984,999,-32,-17,80,4796880,234
394,jm1310,20130829,984,999,980,980,961,965,968,-34,-31,60,3486600,256
395,jm1310,20130830,965,968,968,973,963,972,969,4,1,32,1860960,256
396,jm1310,20130902,972,969,979,1007,979,1007,995,38,26,48,2867760,258
397,jm1310,20130903,1007,995,1004,1010,1004,1005,1005,10,10,24,1448280,254
398,jm1310,20130904,1005,1005,1005,1005,1002,1004,1004,-1,-1,24,1446000,266
399,jm1310,20130905,1004,1004,1004,1017,1004,1012,1011,8,7,18,1092720,262
400,jm1310,20130906,1012,1011,1007,1008,988,1008,1001,-3,-10,24,1441560,262
401,jm1310,20130909,1008,1001,999,999,993,993,997,-8,-4,14,837840,256
402,jm1310,20130910,993,997,998,1005,995,1000,999,3,2,14,839280,256
403,jm1310,20130911,1000,999,999,1001,999,1001,1000,2,1,6,360120,254
404,jm1310,20130912,1001,1000,988,998,972,974,983,-26,-17,42,2479320,252
405,jm1310,20130913,974,983,961,974,960,968,965,-15,-18,34,1970160,244
406,jm1310,20130916,968,965,945,970,945,963,965,-2,0,34,1969920,248
407,jm1310,20130917,963,965,968,979,966,966,972,1,7,18,1050600,250
408,jm1310,20130918,966,972,966,972,966,972,967,0,-5,8,464400,244
409,jm1310,20130923,972,967,955,980,955,980,973,13,6,14,817440,244
410,jm1310,20130924,980,973,990,990,981,987,986,14,13,28,1657080,224
411,jm1310,20130925,987,986,980,984,979,979,980,-7,-6,8,470760,224
412,jm1310,20130926,979,980,975,975,975,975,975,-5,-5,6,351000,224
413,jm1310,20130927,975,975,975,989,971,989,978,14,3,40,2347440,200
414,jm1310,20130930,989,978,970,990,965,965,986,-13,8,88,5206200,200
415,jm1310,20131008,965,986,960,960,950,950,958,-36,-28,12,690000,200
416,jm1310,20131009,950,958,0,0,0,958,958,0,0,0,0,200
417,jm1310,20131010,958,958,1010,1010,1010,1010,1010,52,52,10,606000,200
418,jm1310,20131011,1010,1010,980,980,980,980,980,-30,-30,200,11760000,200
419,jm1310,20131014,980,980,0,0,0,980,980,0,0,0,0,200
420,jm1310,20131015,980,980,0,0,0,980,980,0,0,0,0,200
421,jm1310,20131016,980,980,0,0,0,980,980,0,0,0,0,200
422,jm1310,20131017,980,980,1010,1010,1010,1010,1010,30,30,22,1333200,178
423,jm1310,20131018,1010,1010,1012,1012,1012,1012,1012,2,2,10,607200,168
424,jm1310,20131021,1012,1012,1030,1036,1030,1036,1003,24,-9,168,10420680,0
425,jm1311,20130322,0,1380,1365,1365,1308,1311,1339,-69,-41,56,4499400,16
426,jm1311,20130325,1311,1339,1323,1323,1309,1309,1314,-30,-25,6,473040,16
427,jm1311,20130326,1309,1314,1305,1323,1305,1313,1314,-1,0,26,2049960,8
428,jm1311,20130327,1313,1314,0,0,0,1314,1314,0,0,0,0,8
429,jm1311,20130328,1314,1314,1304,1304,1302,1302,1303,-12,-11,6,469080,4
430,jm1311,20130329,1302,1303,1279,1286,1279,1286,1282,-17,-21,6,461520,6
431,jm1311,20130401,1286,1282,1240,1240,1240,1240,1240,-42,-42,2,148800,8
432,jm1311,20130402,1240,1240,1244,1251,1244,1251,1248,11,8,6,449520,6
433,jm1311,20130403,1251,1248,0,0,0,1248,1248,0,0,0,0,6
434,jm1311,20130408,1248,1248,1205,1242,1205,1242,1220,-6,-28,222,16263000,68
435,jm1311,20130409,1242,1220,1243,1258,1243,1250,1251,30,31,64,4804800,12
436,jm1311,20130410,1250,1251,1250,1250,1244,1244,1246,-7,-5,14,1047120,4
437,jm1311,20130411,1244,1246,0,0,0,1246,1246,0,0,0,0,4
438,jm1311,20130412,1246,1246,0,0,0,1246,1246,0,0,0,0,4
439,jm1311,20130415,1246,1246,1204,1204,1204,1204,1204,-42,-42,4,288960,2
440,jm1311,20130416,1204,1204,0,0,0,1204,1204,0,0,0,0,2
441,jm1311,20130417,1204,1204,1190,1190,1190,1190,1190,-14,-14,2,142800,4
442,jm1311,20130418,1190,1190,1169,1169,1169,1169,1169,-21,-21,2,140280,2
443,jm1311,20130419,1169,1169,0,0,0,1181,1181,12,12,0,0,2
444,jm1311,20130422,1181,1181,0,0,0,1173,1173,-8,-8,0,0,2
445,jm1311,20130423,1173,1173,0,0,0,1162,1162,-11,-11,0,0,2
446,jm1311,20130424,1162,1162,1157,1174,1157,1174,1165,12,3,8,559320,4
447,jm1311,20130425,1174,1165,0,0,0,1155,1155,-10,-10,0,0,4
448,jm1311,20130426,1155,1155,0,0,0,1166,1166,11,11,0,0,4
449,jm1311,20130502,1166,1166,0,0,0,1139,1139,-27,-27,0,0,4
450,jm1311,20130503,1139,1139,0,0,0,1150,1150,11,11,0,0,4
451,jm1311,20130506,1150,1150,0,0,0,1162,1162,12,12,0,0,4
452,jm1311,20130507,1162,1162,0,0,0,1150,1150,-12,-12,0,0,4
453,jm1311,20130508,1150,1150,0,0,0,1152,1152,2,2,0,0,4
454,jm1311,20130509,1152,1152,0,0,0,1148,1148,-4,-4,0,0,4
455,jm1311,20130510,1148,1148,0,0,0,1167,1167,19,19,0,0,4
456,jm1311,20130513,1167,1167,0,0,0,1171,1171,4,4,0,0,4
457,jm1311,20130514,1171,1171,0,0,0,1192,1192,21,21,0,0,4
458,jm1311,20130515,1192,1192,0,0,0,1190,1190,-2,-2,0,0,4
459,jm1311,20130516,1190,1190,0,0,0,1172,1172,-18,-18,0,0,4
460,jm1311,20130517,1172,1172,0,0,0,1189,1189,17,17,0,0,4
461,jm1311,20130520,1189,1189,0,0,0,1185,1185,-4,-4,0,0,4
462,jm1311,20130521,1185,1185,0,0,0,1179,1179,-6,-6,0,0,4
463,jm1311,20130522,1179,1179,0,0,0,1181,1181,2,2,0,0,4
464,jm1311,20130523,1181,1181,0,0,0,1171,1171,-10,-10,0,0,4
465,jm1311,20130524,1171,1171,0,0,0,1166,1166,-5,-5,0,0,4
466,jm1311,20130527,1166,1166,0,0,0,1149,1149,-17,-17,0,0,4
467,jm1311,20130528,1149,1149,0,0,0,1144,1144,-5,-5,0,0,4
468,jm1311,20130529,1144,1144,0,0,0,1132,1132,-12,-12,0,0,4
469,jm1311,20130530,1132,1132,0,0,0,1118,1118,-14,-14,0,0,4
470,jm1311,20130531,1118,1118,0,0,0,1113,1113,-5,-5,0,0,4
471,jm1311,20130603,1113,1113,0,0,0,1104,1104,-9,-9,0,0,4
472,jm1311,20130604,1104,1104,0,0,0,1103,1103,-1,-1,0,0,4
473,jm1311,20130605,1103,1103,0,0,0,1104,1104,1,1,0,0,4
474,jm1311,20130606,1104,1104,1104,1104,1104,1104,1104,0,0,2,132480,4
475,jm1311,20130607,1104,1104,0,0,0,1065,1065,-39,-39,0,0,4
476,jm1311,20130613,1065,1065,0,0,0,1055,1055,-10,-10,0,0,4
477,jm1311,20130614,1055,1055,0,0,0,1044,1044,-11,-11,0,0,4
478,jm1311,20130617,1044,1044,0,0,0,1047,1047,3,3,0,0,4
479,jm1311,20130618,1047,1047,0,0,0,1048,1048,1,1,0,0,4
480,jm1311,20130619,1048,1048,0,0,0,1037,1037,-11,-11,0,0,4
481,jm1311,20130620,1037,1037,0,0,0,1023,1023,-14,-14,0,0,4
482,jm1311,20130621,1023,1023,0,0,0,1015,1015,-8,-8,0,0,4
483,jm1311,20130624,1015,1015,0,0,0,1014,1014,-1,-1,0,0,4
484,jm1311,20130625,1014,1014,0,0,0,1005,1005,-9,-9,0,0,4
485,jm1311,20130626,1005,1005,0,0,0,1012,1012,7,7,0,0,4
486,jm1311,20130627,1012,1012,0,0,0,1018,1018,6,6,0,0,4
487,jm1311,20130628,1018,1018,0,0,0,1015,1015,-3,-3,0,0,4
488,jm1311,20130701,1015,1015,0,0,0,1011,1011,-4,-4,0,0,4
489,jm1311,20130702,1011,1011,0,0,0,1003,1003,-8,-8,0,0,4
490,jm1311,20130703,1003,1003,1020,1020,1020,1020,1020,17,17,2,122400,4
491,jm1311,20130704,1020,1020,0,0,0,1030,1030,10,10,0,0,4
492,jm1311,20130705,1030,1030,0,0,0,1037,1037,7,7,0,0,4
493,jm1311,20130708,1037,1037,1034,1034,1034,1034,1034,-3,-3,4,248160,6
494,jm1311,20130709,1034,1034,0,0,0,1033,1033,-1,-1,0,0,6
495,jm1311,20130710,1033,1033,1019,1047,1019,1047,1037,14,4,6,373320,4
496,jm1311,20130711,1047,1037,1057,1057,1057,1057,1057,20,20,4,253680,6
497,jm1311,20130712,1057,1057,0,0,0,1050,1050,-7,-7,0,0,6
498,jm1311,20130715,1050,1050,0,0,0,1038,1038,-12,-12,0,0,6
499,jm1311,20130716,1038,1038,0,0,0,1034,1034,-4,-4,0,0,6
500,jm1311,20130717,1034,1034,0,0,0,1042,1042,8,8,0,0,6
501,jm1311,20130718,1042,1042,1050,1050,1050,1050,1050,8,8,4,252000,2
502,jm1311,20130719,1050,1050,0,0,0,1055,1055,5,5,0,0,2
503,jm1311,20130722,1055,1055,1075,1075,1054,1054,1064,-1,9,4,255480,2
504,jm1311,20130723,1054,1064,0,0,0,1064,1064,0,0,0,0,2
505,jm1311,20130724,1064,1064,0,0,0,1060,1060,-4,-4,0,0,2
506,jm1311,20130725,1060,1060,0,0,0,1047,1047,-13,-13,0,0,2
507,jm1311,20130726,1047,1047,0,0,0,1048,1048,1,1,0,0,2
508,jm1311,20130729,1048,1048,0,0,0,1038,1038,-10,-10,0,0,2
509,jm1311,20130730,1038,1038,0,0,0,1032,1032,-6,-6,0,0,2
510,jm1311,20130731,1032,1032,0,0,0,1031,1031,-1,-1,0,0,2
511,jm1311,20130801,1031,1031,0,0,0,1038,1038,7,7,0,0,2
512,jm1311,20130802,1038,1038,0,0,0,1049,1049,11,11,0,0,2
513,jm1311,20130805,1049,1049,0,0,0,1052,1052,3,3,0,0,2
514,jm1311,20130806,1052,1052,0,0,0,1052,1052,0,0,0,0,2
515,jm1311,20130807,1052,1052,0,0,0,1055,1055,3,3,0,0,2
516,jm1311,20130808,1055,1055,0,0,0,1074,1074,19,19,0,0,2
517,jm1311,20130809,1074,1074,0,0,0,1071,1071,-3,-3,0,0,2
518,jm1311,20130812,1071,1071,1113,1113,1113,1113,1113,42,42,2,133560,2
519,jm1311,20130813,1113,1113,0,0,0,1156,1156,43,43,0,0,2
520,jm1311,20130814,1156,1156,1156,1156,1156,1156,1156,0,0,2,138720,0
521,jm1311,20130815,1156,1156,0,0,0,1152,1152,-4,-4,0,0,0
522,jm1311,20130816,1152,1152,0,0,0,1152,1152,0,0,0,0,0
523,jm1311,20130819,1152,1152,1111,1138,1106,1106,1109,-46,-43,88,5860200,70
524,jm1311,20130820,1106,1109,1090,1120,1090,1120,1103,11,-6,16,1059240,70
525,jm1311,20130821,1120,1103,1104,1104,1090,1090,1099,-13,-4,6,395640,72
526,jm1311,20130822,1090,1099,1091,1091,1091,1091,1091,-8,-8,16,1047360,74
527,jm1311,20130823,1091,1091,0,0,0,1091,1091,0,0,0,0,74
528,jm1311,20130826,1091,1091,0,0,0,1091,1091,0,0,0,0,74
529,jm1311,20130827,1091,1091,1061,1070,1061,1070,1065,-21,-26,10,639120,72
530,jm1311,20130828,1070,1065,1061,1061,1031,1031,1049,-34,-16,8,503760,64
531,jm1311,20130829,1031,1049,1008,1034,1008,1034,1011,-15,-38,22,1334880,64
532,jm1311,20130830,1034,1011,1011,1018,1011,1018,1014,7,3,6,365160,60
533,jm1311,20130902,1018,1014,1021,1052,1021,1028,1036,14,22,10,621840,58
534,jm1311,20130903,1028,1036,1047,1047,1010,1022,1029,-14,-7,22,1359240,66
535,jm1311,20130904,1022,1029,1025,1033,1001,1019,1021,-10,-8,140,8576760,184
536,jm1311,20130905,1019,1021,1018,1055,1018,1031,1031,10,10,50,3093720,202
537,jm1311,20130906,1031,1031,1031,1032,1027,1027,1030,-4,-1,6,370800,200
538,jm1311,20130909,1027,1030,1038,1044,1038,1044,1040,14,10,8,499200,200
539,jm1311,20130910,1044,1040,1039,1039,1032,1032,1035,-8,-5,6,372600,204
540,jm1311,20130911,1032,1035,0,0,0,1035,1035,0,0,0,0,204
541,jm1311,20130912,1035,1035,1020,1020,1018,1018,1018,-17,-17,8,488880,200
542,jm1311,20130913,1018,1018,0,0,0,1000,1000,-18,-18,0,0,200
543,jm1311,20130916,1000,1000,0,0,0,1000,1000,0,0,0,0,200
544,jm1311,20130917,1000,1000,992,1008,983,1006,995,6,-5,44,2628480,206
545,jm1311,20130918,1006,995,1005,1018,996,1018,1005,23,10,30,1810680,200
546,jm1311,20130923,1018,1005,999,1020,999,1020,1012,15,7,10,607560,200
547,jm1311,20130924,1020,1012,0,0,0,1016,1016,4,4,0,0,200
548,jm1311,20130925,1016,1016,1018,1020,1018,1020,1019,4,3,4,244560,200
549,jm1311,20130926,1020,1019,1022,1022,1022,1022,1022,3,3,10,613200,200
550,jm1311,20130927,1022,1022,1016,1017,1007,1007,1012,-15,-10,30,1822080,200
551,jm1311,20130930,1007,1012,1011,1011,995,995,1007,-17,-5,10,604680,208
552,jm1311,20131008,995,1007,977,990,977,986,983,-21,-24,36,2124480,208
553,jm1311,20131009,986,983,0,0,0,983,983,0,0,0,0,208
554,jm1311,20131010,983,983,996,996,995,995,995,12,12,4,238920,206
555,jm1311,20131011,995,995,999,1000,986,986,996,-9,1,12,717600,206
556,jm1311,20131014,986,996,998,1002,998,1002,1000,6,4,10,600240,202
557,jm1311,20131015,1002,1000,1016,1016,989,1003,1002,3,2,6,360960,200
558,jm1311,20131016,1003,1002,996,996,996,996,996,-6,-6,2,119520,202
559,jm1311,20131017,996,996,1002,1002,1002,1002,1002,6,6,10,601200,208
560,jm1311,20131018,1002,1002,995,1018,995,1018,1006,16,4,4,241560,206
561,jm1311,20131021,1018,1006,1028,1028,1009,1009,1015,3,9,6,365640,206
562,jm1311,20131022,1009,1015,0,0,0,1015,1015,0,0,0,0,206
563,jm1311,20131023,1015,1015,0,0,0,1015,1015,0,0,0,0,206
564,jm1311,20131024,1015,1015,0,0,0,1015,1015,0,0,0,0,206
565,jm1311,20131025,1015,1015,0,0,0,1015,1015,0,0,0,0,206
566,jm1311,20131028,1015,1015,0,0,0,1015,1015,0,0,0,0,206
567,jm1311,20131029,1015,1015,1004,1004,976,976,994,-39,-21,8,477240,206
568,jm1311,20131030,976,994,0,0,0,994,994,0,0,0,0,206
569,jm1311,20131031,994,994,1007,1007,962,1007,1006,13,12,192,11589960,206
570,jm1311,20131101,1007,1006,0,0,0,1006,1006,0,0,0,0,206
571,jm1311,20131104,1006,1006,0,0,0,1006,1006,0,0,0,0,206
572,jm1311,20131105,1006,1006,0,0,0,1006,1006,0,0,0,0,206
573,jm1311,20131106,1006,1006,946,1060,946,1060,989,54,-17,10,593760,204
574,jm1311,20131107,1060,989,1047,1047,1047,1047,1047,58,58,2,125640,206
575,jm1311,20131108,1047,1047,0,0,0,1047,1047,0,0,0,0,206
576,jm1311,20131111,1047,1047,0,0,0,1047,1047,0,0,0,0,206
577,jm1311,20131112,1047,1047,1109,1109,1109,1109,1109,62,62,2,133080,204
578,jm1311,20131113,1109,1109,1070,1070,1070,1070,1070,-39,-39,4,256800,204
579,jm1311,20131114,1070,1070,1042,1071,1042,1071,1036,1,-34,8,507120,0
580,jm1312,20130322,0,1380,1378,1378,1300,1323,1337,-57,-43,72,5777760,14
581,jm1312,20130325,1323,1337,1339,1339,1304,1304,1327,-33,-10,26,2070840,4
582,jm1312,20130326,1304,1327,1326,1326,1314,1314,1320,-13,-7,4,316800,4
583,jm1312,20130327,1314,1320,0,0,0,1320,1320,0,0,0,0,4
584,jm1312,20130328,1320,1320,1317,1317,1317,1317,1317,-3,-3,4,316080,2
585,jm1312,20130329,1317,1317,0,0,0,1317,1317,0,0,0,0,2
586,jm1312,20130401,1317,1317,1272,1272,1265,1265,1267,-52,-50,6,456240,4
587,jm1312,20130402,1265,1267,0,0,0,1267,1267,0,0,0,0,4
588,jm1312,20130403,1267,1267,1277,1277,1277,1277,1277,10,10,2,153240,4
589,jm1312,20130408,1277,1277,0,0,0,1277,1277,0,0,0,0,4
590,jm1312,20130409,1277,1277,1269,1282,1265,1265,1272,-12,-5,18,1374120,2
591,jm1312,20130410,1265,1272,0,0,0,1272,1272,0,0,0,0,2
592,jm1312,20130411,1272,1272,1318,1318,1241,1241,1279,-31,7,12,921240,2
593,jm1312,20130412,1241,1279,0,0,0,1279,1279,0,0,0,0,2
594,jm1312,20130415,1279,1279,0,0,0,1236,1236,-43,-43,0,0,2
595,jm1312,20130416,1236,1236,0,0,0,1236,1236,0,0,0,0,2
596,jm1312,20130417,1236,1236,0,0,0,1222,1222,-14,-14,0,0,2
597,jm1312,20130418,1222,1222,1174,1189,1174,1189,1181,-33,-41,4,283560,2
598,jm1312,20130419,1189,1181,0,0,0,1194,1194,13,13,0,0,2
599,jm1312,20130422,1194,1194,0,0,0,1186,1186,-8,-8,0,0,2
600,jm1312,20130423,1186,1186,1197,1197,1197,1197,1197,11,11,2,143640,2
601,jm1312,20130424,1197,1197,0,0,0,1200,1200,3,3,0,0,2
602,jm1312,20130425,1200,1200,0,0,0,1189,1189,-11,-11,0,0,2
603,jm1312,20130426,1189,1189,0,0,0,1200,1200,11,11,0,0,2
604,jm1312,20130502,1200,1200,0,0,0,1172,1172,-28,-28,0,0,2
605,jm1312,20130503,1172,1172,0,0,0,1183,1183,11,11,0,0,2
606,jm1312,20130506,1183,1183,0,0,0,1195,1195,12,12,0,0,2
607,jm1312,20130507,1195,1195,0,0,0,1183,1183,-12,-12,0,0,2
608,jm1312,20130508,1183,1183,0,0,0,1185,1185,2,2,0,0,2
609,jm1312,20130509,1185,1185,0,0,0,1181,1181,-4,-4,0,0,2
610,jm1312,20130510,1181,1181,0,0,0,1200,1200,19,19,0,0,2
611,jm1312,20130513,1200,1200,1227,1227,1227,1227,1227,27,27,4,294480,2
612,jm1312,20130514,1227,1227,0,0,0,1249,1249,22,22,0,0,2
613,jm1312,20130515,1249,1249,1207,1227,1202,1219,1216,-30,-33,22,1605960,6
614,jm1312,20130516,1219,1216,0,0,0,1198,1198,-18,-18,0,0,6
615,jm1312,20130517,1198,1198,0,0,0,1215,1215,17,17,0,0,6
616,jm1312,20130520,1215,1215,1206,1206,1206,1206,1206,-9,-9,2,144720,4
617,jm1312,20130521,1206,1206,0,0,0,1200,1200,-6,-6,0,0,4
618,jm1312,20130522,1200,1200,0,0,0,1202,1202,2,2,0,0,4
619,jm1312,20130523,1202,1202,0,0,0,1192,1192,-10,-10,0,0,4
620,jm1312,20130524,1192,1192,1212,1212,1200,1200,1207,8,15,12,869280,6
621,jm1312,20130527,1200,1207,1185,1185,1185,1185,1185,-22,-22,2,142200,6
622,jm1312,20130528,1185,1185,0,0,0,1180,1180,-5,-5,0,0,6
623,jm1312,20130529,1180,1180,0,0,0,1168,1168,-12,-12,0,0,6
624,jm1312,20130530,1168,1168,0,0,0,1154,1154,-14,-14,0,0,6
625,jm1312,20130531,1154,1154,0,0,0,1149,1149,-5,-5,0,0,6
626,jm1312,20130603,1149,1149,0,0,0,1140,1140,-9,-9,0,0,6
627,jm1312,20130604,1140,1140,1152,1152,1152,1152,1152,12,12,2,138240,4
628,jm1312,20130605,1152,1152,0,0,0,1153,1153,1,1,0,0,4
629,jm1312,20130606,1153,1153,0,0,0,1153,1153,0,0,0,0,4
630,jm1312,20130607,1153,1153,0,0,0,1112,1112,-41,-41,0,0,4
631,jm1312,20130613,1112,1112,1110,1110,1110,1110,1110,-2,-2,2,133200,6
632,jm1312,20130614,1110,1110,0,0,0,1098,1098,-12,-12,0,0,6
633,jm1312,20130617,1098,1098,1115,1115,1115,1115,1115,17,17,2,133800,4
634,jm1312,20130618,1115,1115,1114,1114,1108,1108,1112,-7,-3,6,400320,6
635,jm1312,20130619,1108,1112,0,0,0,1101,1101,-11,-11,0,0,6
636,jm1312,20130620,1101,1101,1060,1060,1060,1060,1060,-41,-41,2,127200,4
637,jm1312,20130621,1060,1060,0,0,0,1052,1052,-8,-8,0,0,4
638,jm1312,20130624,1052,1052,0,0,0,1050,1050,-2,-2,0,0,4
639,jm1312,20130625,1050,1050,0,0,0,1040,1040,-10,-10,0,0,4
640,jm1312,20130626,1040,1040,0,0,0,1048,1048,8,8,0,0,4
641,jm1312,20130627,1048,1048,0,0,0,1055,1055,7,7,0,0,4
642,jm1312,20130628,1055,1055,0,0,0,1051,1051,-4,-4,0,0,4
643,jm1312,20130701,1051,1051,0,0,0,1046,1046,-5,-5,0,0,4
644,jm1312,20130702,1046,1046,0,0,0,1037,1037,-9,-9,0,0,4
645,jm1312,20130703,1037,1037,1032,1032,1032,1032,1032,-5,-5,2,123840,6
646,jm1312,20130704,1032,1032,0,0,0,1042,1042,10,10,0,0,6
647,jm1312,20130705,1042,1042,0,0,0,1049,1049,7,7,0,0,6
648,jm1312,20130708,1049,1049,1034,1034,1034,1034,1034,-15,-15,2,124080,4
649,jm1312,20130709,1034,1034,0,0,0,1033,1033,-1,-1,0,0,4
650,jm1312,20130710,1033,1033,0,0,0,1036,1036,3,3,0,0,4
651,jm1312,20130711,1036,1036,0,0,0,1055,1055,19,19,0,0,4
652,jm1312,20130712,1055,1055,1062,1062,1050,1050,1056,-5,1,8,506880,2
653,jm1312,20130715,1050,1056,0,0,0,1044,1044,-12,-12,0,0,2
654,jm1312,20130716,1044,1044,0,0,0,1040,1040,-4,-4,0,0,2
655,jm1312,20130717,1040,1040,0,0,0,1048,1048,8,8,0,0,2
656,jm1312,20130718,1048,1048,0,0,0,1056,1056,8,8,0,0,2
657,jm1312,20130719,1056,1056,1068,1075,1068,1069,1071,13,15,8,514320,2
658,jm1312,20130722,1069,1071,1073,1075,1073,1075,1074,4,3,4,257760,2
659,jm1312,20130723,1075,1074,0,0,0,1074,1074,0,0,0,0,2
660,jm1312,20130724,1074,1074,0,0,0,1070,1070,-4,-4,0,0,2
661,jm1312,20130725,1070,1070,1075,1076,1073,1073,1074,3,4,6,386880,4
662,jm1312,20130726,1073,1074,1065,1071,1065,1071,1068,-3,-6,4,256320,2
663,jm1312,20130729,1071,1068,1051,1061,1044,1044,1052,-24,-16,12,757800,4
664,jm1312,20130730,1044,1052,1043,1053,1040,1042,1044,-10,-8,8,501360,4
665,jm1312,20130731,1042,1044,1048,1054,1041,1051,1048,7,4,20,1258440,2
666,jm1312,20130801,1051,1048,0,0,0,1055,1055,7,7,0,0,2
667,jm1312,20130802,1055,1055,1074,1074,1065,1065,1069,10,14,4,256680,4
668,jm1312,20130805,1065,1069,1076,1082,1070,1070,1076,1,7,16,1033440,4
669,jm1312,20130806,1070,1076,1079,1079,1079,1079,1079,3,3,4,258960,4
670,jm1312,20130807,1079,1079,1074,1074,1074,1074,1074,-5,-5,4,257760,2
671,jm1312,20130808,1074,1074,1091,1108,1091,1099,1101,25,27,8,528480,2
672,jm1312,20130809,1099,1101,1103,1103,1103,1103,1103,2,2,2,132360,4
673,jm1312,20130812,1103,1103,1132,1145,1132,1143,1137,40,34,12,818880,2
674,jm1312,20130813,1143,1137,1153,1178,1146,1170,1161,33,24,16,1114680,4
675,jm1312,20130814,1170,1161,1165,1165,1165,1165,1165,4,4,2,139800,4
676,jm1312,20130815,1165,1165,1169,1175,1161,1165,1167,0,2,34,2382360,4
677,jm1312,20130816,1165,1167,1161,1161,1161,1161,1161,-6,-6,8,557280,4
678,jm1312,20130819,1161,1161,1167,1167,1115,1123,1141,-38,-20,64,4382280,36
679,jm1312,20130820,1123,1141,1114,1164,1114,1128,1135,-13,-6,78,5314680,58
680,jm1312,20130821,1128,1135,1126,1129,1114,1115,1120,-20,-15,38,2554080,84
681,jm1312,20130822,1115,1120,1111,1124,1109,1117,1119,-3,-1,26,1746240,92
682,jm1312,20130823,1117,1119,1119,1125,1108,1114,1116,-5,-3,24,1607880,102
683,jm1312,20130826,1114,1116,1136,1136,1121,1121,1130,5,14,6,407040,102
684,jm1312,20130827,1121,1130,1110,1113,1110,1113,1111,-17,-19,8,533520,102
685,jm1312,20130828,1113,1111,1105,1109,1094,1109,1104,-2,-7,22,1458480,104
686,jm1312,20130829,1109,1104,1065,1066,1060,1066,1061,-38,-43,20,1273800,102
687,jm1312,20130830,1066,1061,1064,1064,1055,1061,1058,0,-3,30,1905360,100
688,jm1312,20130902,1061,1058,1065,1088,1065,1087,1076,29,18,42,2713200,110
689,jm1312,20130903,1087,1076,1088,1088,1075,1075,1079,-1,3,24,1554240,114
690,jm1312,20130904,1075,1079,1082,1082,1067,1073,1072,-6,-7,124,7982040,220
691,jm1312,20130905,1073,1072,1079,1088,1079,1088,1081,16,9,10,648840,218
692,jm1312,20130906,1088,1081,1088,1092,1083,1083,1086,2,5,10,651720,216
693,jm1312,20130909,1083,1086,1086,1086,1086,1086,1086,0,0,2,130320,218
694,jm1312,20130910,1086,1086,1081,1081,1081,1081,1081,-5,-5,2,129720,220
695,jm1312,20130911,1081,1081,1081,1081,1081,1081,1081,0,0,2,129720,218
696,jm1312,20130912,1081,1081,1074,1076,1071,1076,1074,-5,-7,18,1160040,220
697,jm1312,20130913,1076,1074,1073,1073,1066,1066,1069,-8,-5,14,898200,220
698,jm1312,20130916,1066,1069,1069,1072,1063,1063,1069,-6,0,18,1154520,216
699,jm1312,20130917,1063,1069,1063,1067,1062,1066,1063,-3,-6,12,765960,222
700,jm1312,20130918,1066,1063,1072,1078,1070,1078,1073,15,10,28,1803120,220
701,jm1312,20130923,1078,1073,0,0,0,1094,1094,21,21,0,0,220
702,jm1312,20130924,1094,1094,1086,1086,1086,1086,1086,-8,-8,6,390960,226
703,jm1312,20130925,1086,1086,1092,1092,1086,1089,1089,3,3,24,1569480,222
704,jm1312,20130926,1089,1089,0,0,0,1089,1089,0,0,0,0,222
705,jm1312,20130927,1089,1089,1088,1088,1078,1078,1083,-11,-6,4,259920,220
706,jm1312,20130930,1078,1083,1069,1069,1063,1063,1065,-20,-18,6,383400,218
707,jm1312,20131008,1063,1065,1054,1060,1031,1060,1048,-5,-17,10,628800,218
708,jm1312,20131009,1060,1048,1059,1059,1055,1059,1057,11,9,12,761640,222
709,jm1312,20131010,1059,1057,1058,1069,1057,1064,1061,7,4,24,1529160,234
710,jm1312,20131011,1064,1061,1076,1076,1065,1072,1072,11,11,8,514560,236
711,jm1312,20131014,1072,1072,1061,1085,1061,1079,1076,7,4,32,2067480,246
712,jm1312,20131015,1079,1076,1091,1096,1073,1080,1081,4,5,64,4154040,254
713,jm1312,20131016,1080,1081,1080,1080,1076,1076,1079,-5,-2,14,906720,262
714,jm1312,20131017,1076,1079,1075,1087,1075,1080,1079,1,0,10,647760,262
715,jm1312,20131018,1080,1079,1083,1083,1076,1076,1078,-3,-1,18,1164240,250
716,jm1312,20131021,1076,1078,1082,1086,1082,1086,1084,8,6,20,1301520,236
717,jm1312,20131022,1086,1084,1071,1071,1071,1071,1071,-13,-13,2,128520,236
718,jm1312,20131023,1071,1071,1059,1061,1046,1046,1058,-25,-13,28,1777680,226
719,jm1312,20131024,1046,1058,1043,1043,1043,1043,1043,-15,-15,4,250320,226
720,jm1312,20131025,1043,1043,1042,1042,1027,1027,1037,-16,-6,8,498000,226
721,jm1312,20131028,1027,1037,1033,1033,1033,1033,1033,-4,-4,2,123960,226
722,jm1312,20131029,1033,1033,1006,1018,1006,1018,1010,-15,-23,6,363600,226
723,jm1312,20131030,1018,1010,1034,1034,1021,1021,1027,11,17,4,246600,226
724,jm1312,20131031,1021,1027,1009,1009,1009,1009,1009,-18,-18,6,363240,230
725,jm1312,20131101,1009,1009,1009,1011,1002,1002,1008,-7,-1,10,605040,228
726,jm1312,20131104,1002,1008,1009,1009,1000,1007,1006,-1,-2,12,724680,230
727,jm1312,20131105,1007,1006,1001,1001,1001,1001,1001,-5,-5,2,120120,228
728,jm1312,20131106,1001,1001,1011,1011,1011,1011,1011,10,10,2,121320,228
729,jm1312,20131107,1011,1011,1013,1013,1013,1013,1013,2,2,2,121560,226
730,jm1312,20131108,1013,1013,1034,1035,1018,1024,1029,11,16,14,864480,218
731,jm1312,20131111,1024,1029,0,0,0,1029,1029,0,0,0,0,218
732,jm1312,20131112,1029,1029,1029,1042,1029,1038,1037,9,8,84,5230200,142
733,jm1312,20131113,1038,1037,1047,1048,1047,1048,1047,11,10,136,8551200,14
734,jm1312,20131114,1048,1047,1048,1048,1048,1048,1048,1,1,2,125760,12
735,jm1312,20131115,1048,1048,1087,1087,1020,1040,1052,-8,4,22,1388880,4
736,jm1312,20131118,1040,1052,1011,1088,1011,1088,1027,36,-25,328,20225760,4
737,jm1312,20131119,1088,1027,0,0,0,1027,1027,0,0,0,0,4
738,jm1312,20131120,1027,1027,0,0,0,1027,1027,0,0,0,0,4
739,jm1312,20131121,1027,1027,0,0,0,1027,1027,0,0,0,0,4
740,jm1312,20131122,1027,1027,0,0,0,1027,1027,0,0,0,0,4
741,jm1312,20131125,1027,1027,0,0,0,1027,1027,0,0,0,0,4
742,jm1312,20131126,1027,1027,989,1027,989,1027,1014,0,-13,6,365160,2
743,jm1312,20131127,1027,1014,0,0,0,1014,1014,0,0,0,0,2
744,jm1312,20131128,1014,1014,0,0,0,1014,1014,0,0,0,0,2
745,jm1312,20131129,1014,1014,1014,1014,1014,1014,1014,0,0,2,121680,2
746,jm1312,20131202,1014,1014,954,954,954,954,954,-60,-60,2,114480,0
747,jm1312,20131203,954,954,0,0,0,954,954,0,0,0,0,0
748,jm1312,20131204,954,954,0,0,0,954,954,0,0,0,0,0
749,jm1312,20131205,954,954,0,0,0,954,954,0,0,0,0,0
750,jm1312,20131206,954,954,0,0,0,954,954,0,0,0,0,0
751,jm1312,20131209,954,954,0,0,0,954,954,0,0,0,0,0
752,jm1312,20131210,954,954,0,0,0,954,954,0,0,0,0,0
753,jm1312,20131211,954,954,0,0,0,954,954,0,0,0,0,0
754,jm1312,20131212,954,954,0,0,0,954,954,0,0,0,0,0
755,jm1312,20131213,954,954,0,0,0,954,954,0,0,0,0,0
756,jm1401,20130322,0,1380,1330,1350,1308,1320,1323,-60,-57,2042,162162000,888
757,jm1401,20130325,1320,1323,1301,1335,1300,1305,1307,-18,-16,3074,241078320,2782
758,jm1401,20130326,1305,1307,1293,1321,1293,1316,1312,9,5,1300,102378720,3050
759,jm1401,20130327,1316,1312,1320,1322,1308,1310,1312,-2,0,446,35131920,3102
760,jm1401,20130328,1310,1312,1315,1319,1302,1312,1314,0,2,1118,88164360,3670
761,jm1401,20130329,1312,1314,1309,1327,1290,1305,1317,-9,3,5302,419146080,2852
762,jm1401,20130401,1305,1317,1300,1309,1265,1265,1283,-52,-34,2342,180319080,3086
763,jm1401,20130402,1265,1283,1257,1283,1249,1281,1265,-2,-18,1104,83807400,3088
764,jm1401,20130403,1281,1265,1276,1282,1266,1270,1273,5,8,1016,77629680,3192
765,jm1401,20130408,1270,1273,1260,1276,1251,1275,1262,2,-11,560,42425520,3000
766,jm1401,20130409,1275,1262,1275,1282,1270,1275,1277,13,15,788,60421800,3222
767,jm1401,20130410,1275,1277,1280,1281,1266,1272,1276,-5,-1,644,49306680,3218
768,jm1401,20130411,1272,1276,1267,1280,1263,1267,1271,-9,-5,364,27760680,3244
769,jm1401,20130412,1267,1271,1260,1275,1260,1268,1267,-3,-4,334,25400880,3290
770,jm1401,20130415,1268,1267,1249,1255,1222,1232,1239,-35,-28,918,68247000,3152
771,jm1401,20130416,1232,1239,1215,1235,1207,1232,1221,-7,-18,420,30776280,3204
772,jm1401,20130417,1232,1221,1236,1242,1201,1215,1211,-6,-10,1916,139259880,3606
773,jm1401,20130418,1215,1211,1204,1222,1187,1220,1205,9,-6,1388,100357200,3616
774,jm1401,20130419,1220,1205,1221,1228,1211,1225,1220,20,15,436,31930920,3556
775,jm1401,20130422,1225,1220,1221,1227,1209,1209,1214,-11,-6,370,26970840,3436
776,jm1401,20130423,1209,1214,1209,1216,1192,1197,1202,-17,-12,522,37671120,3556
777,jm1401,20130424,1197,1202,1196,1210,1192,1203,1200,1,-2,682,49131240,3496
778,jm1401,20130425,1203,1200,1203,1209,1195,1204,1202,4,2,456,32911200,3428
779,jm1401,20130426,1204,1202,1217,1217,1198,1201,1207,-1,5,528,38266200,3312
780,jm1401,20130502,1201,1207,1185,1186,1163,1178,1179,-29,-28,688,48675360,3602
781,jm1401,20130503,1178,1179,1183,1197,1182,1189,1189,10,10,590,42100920,3590
782,jm1401,20130506,1189,1189,1200,1207,1196,1199,1200,10,11,462,33270360,3654
783,jm1401,20130507,1199,1200,1196,1208,1191,1196,1199,-4,-1,644,46333800,3698
784,jm1401,20130508,1196,1199,1200,1213,1200,1212,1204,13,5,394,28483200,3756
785,jm1401,20130509,1212,1204,1211,1212,1203,1208,1207,4,3,390,28250760,3802
786,jm1401,20130510,1208,1207,1203,1217,1200,1215,1208,8,1,516,37418640,3792
787,jm1401,20130513,1215,1208,1217,1249,1209,1241,1232,33,24,3032,224240760,3950
788,jm1401,20130514,1241,1232,1244,1244,1222,1235,1235,3,3,1754,129989160,3886
789,jm1401,20130515,1235,1235,1236,1236,1205,1205,1226,-30,-9,2748,202210080,4748
790,jm1401,20130516,1205,1226,1210,1216,1188,1208,1204,-18,-22,1788,129213120,4596
791,jm1401,20130517,1208,1204,1210,1225,1203,1224,1215,20,11,1908,139167120,4624
792,jm1401,20130520,1224,1215,1220,1234,1220,1223,1226,8,11,6696,492789000,7530
793,jm1401,20130521,1223,1226,1228,1238,1220,1230,1229,4,3,4678,344992200,9036
794,jm1401,20130522,1230,1229,1228,1242,1227,1241,1234,12,5,3684,272847000,9814
795,jm1401,20130523,1241,1234,1236,1236,1212,1213,1224,-21,-10,4504,330936840,9546
796,jm1401,20130524,1213,1224,1218,1224,1213,1215,1220,-9,-4,2252,164850600,9974
797,jm1401,20130527,1215,1220,1209,1210,1197,1197,1204,-23,-16,2672,193037280,10258
798,jm1401,20130528,1197,1204,1200,1202,1185,1190,1191,-14,-13,3722,266015520,10782
799,jm1401,20130529,1190,1191,1193,1197,1167,1169,1184,-22,-7,5708,405813840,11306
800,jm1401,20130530,1169,1184,1163,1176,1154,1169,1165,-15,-19,5970,417610920,11462
801,jm1401,20130531,1169,1165,1171,1177,1150,1152,1162,-13,-3,5480,382127520,11932
802,jm1401,20130603,1152,1162,1155,1165,1148,1162,1157,0,-5,4168,289392120,11724
803,jm1401,20130604,1162,1157,1164,1167,1155,1166,1160,9,3,3922,273143640,11508
804,jm1401,20130605,1166,1160,1168,1177,1161,1176,1170,16,10,7910,555414240,12302
805,jm1401,20130606,1176,1170,1167,1168,1124,1124,1136,-46,-34,14702,1002838680,14408
806,jm1401,20130607,1124,1136,1121,1122,1093,1105,1107,-31,-29,22196,1474349400,16008
807,jm1401,20130613,1105,1107,1089,1107,1085,1095,1095,-12,-12,18540,1218089880,17476
808,jm1401,20130614,1095,1095,1102,1103,1090,1095,1096,0,1,16442,1081770960,17890
809,jm1401,20130617,1095,1096,1100,1130,1096,1109,1115,13,19,41734,2793527040,21724
810,jm1401,20130618,1109,1115,1110,1117,1104,1111,1111,-4,-4,30728,2048563800,26398
811,jm1401,20130619,1111,1111,1112,1114,1098,1109,1103,-2,-8,38528,2551387440,29674
812,jm1401,20130620,1109,1103,1100,1102,1059,1059,1075,-44,-28,67466,4355331600,39714
813,jm1401,20130621,1059,1075,1048,1084,1044,1069,1066,-6,-9,94370,6036742200,45390
814,jm1401,20130624,1069,1066,1068,1087,1048,1051,1065,-15,-1,265708,16984778640,80244
815,jm1401,20130625,1051,1065,1056,1073,1051,1071,1062,6,-3,303826,19375914360,115178
816,jm1401,20130626,1071,1062,1075,1076,1040,1053,1054,-9,-8,359328,22742986440,110394
817,jm1401,20130627,1053,1054,1055,1062,1038,1057,1050,3,-4,342566,21600093000,110322
818,jm1401,20130628,1057,1050,1050,1062,1046,1052,1053,2,3,223258,14109293640,111328
819,jm1401,20130701,1052,1053,1045,1059,1028,1040,1040,-13,-13,447934,27977197680,141094
820,jm1401,20130702,1040,1040,1045,1046,1024,1034,1034,-6,-6,642864,39912013680,185388
821,jm1401,20130703,1034,1034,1033,1038,1024,1031,1030,-3,-4,393988,24362642040,159814
822,jm1401,20130704,1031,1030,1032,1048,1025,1045,1038,15,8,637786,39730995240,185202
823,jm1401,20130705,1045,1038,1045,1049,1042,1046,1044,8,6,279232,17507329320,174086
824,jm1401,20130708,1046,1044,1045,1046,1028,1037,1035,-7,-9,250400,15556723680,152284
825,jm1401,20130709,1037,1035,1037,1042,1027,1029,1035,-6,0,212060,13181544720,159752
826,jm1401,20130710,1029,1035,1028,1066,1020,1061,1045,26,10,694288,43568385480,174408
827,jm1401,20130711,1061,1045,1066,1085,1058,1064,1070,19,25,797750,51221654280,156340
828,jm1401,20130712,1064,1070,1060,1069,1053,1053,1060,-17,-10,433538,27597031560,145058
829,jm1401,20130715,1053,1060,1051,1058,1042,1042,1050,-18,-10,313418,19746872880,145574
830,jm1401,20130716,1042,1050,1045,1049,1036,1046,1043,-4,-7,308792,19330585800,152908
831,jm1401,20130717,1046,1043,1045,1070,1044,1065,1059,22,16,547440,34814090280,172096
832,jm1401,20130718,1065,1059,1064,1072,1058,1071,1064,12,5,492622,31463491560,173966
833,jm1401,20130719,1071,1064,1075,1084,1070,1076,1076,12,12,423318,27352225560,139332
834,jm1401,20130722,1076,1076,1081,1089,1070,1079,1081,3,5,452384,29357266440,147804
835,jm1401,20130723,1079,1081,1076,1084,1075,1084,1079,3,-2,247790,16055710680,140918
836,jm1401,20130724,1084,1079,1085,1090,1067,1077,1078,-2,-1,425754,27548777160,132482
837,jm1401,20130725,1077,1078,1073,1082,1069,1074,1074,-4,-4,279292,18009194040,134326
838,jm1401,20130726,1074,1074,1074,1077,1066,1068,1072,-6,-2,194854,12534933840,121432
839,jm1401,20130729,1068,1072,1062,1064,1050,1053,1056,-19,-16,166010,10525727760,115976
840,jm1401,20130730,1053,1056,1054,1060,1046,1053,1052,-3,-4,188244,11884405080,118826
841,jm1401,20130731,1053,1052,1050,1061,1049,1059,1056,7,4,176874,11207699640,123630
842,jm1401,20130801,1059,1056,1065,1074,1061,1070,1068,14,12,206966,13264610520,123088
843,jm1401,20130802,1070,1068,1075,1079,1071,1079,1075,11,7,151062,9748580520,126724
844,jm1401,20130805,1079,1075,1078,1088,1077,1084,1082,9,7,168768,10964835480,139266
845,jm1401,20130806,1084,1082,1085,1086,1075,1081,1080,-1,-2,162926,10557901560,128674
846,jm1401,20130807,1081,1080,1078,1087,1073,1084,1081,4,1,204110,13243270680,133734
847,jm1401,20130808,1084,1081,1086,1115,1086,1111,1105,30,24,324006,21483416640,134010
848,jm1401,20130809,1111,1105,1110,1135,1106,1132,1118,27,13,425882,28577304000,180350
849,jm1401,20130812,1132,1118,1138,1162,1135,1162,1148,44,30,519568,35800044840,200586
850,jm1401,20130813,1162,1148,1166,1183,1155,1176,1166,28,18,517010,36175302240,184146
851,jm1401,20130814,1176,1166,1173,1185,1160,1166,1170,0,4,611144,42933336120,185650
852,jm1401,20130815,1166,1170,1171,1196,1166,1172,1178,2,8,852382,60252590880,232922
853,jm1401,20130816,1172,1178,1170,1178,1145,1153,1160,-25,-18,975660,67937039280,234766
854,jm1401,20130819,1153,1160,1150,1181,1147,1162,1167,2,7,675832,47325750600,240800
855,jm1401,20130820,1162,1167,1165,1184,1157,1173,1170,6,3,978976,68774908200,266100
856,jm1401,20130821,1173,1170,1177,1181,1167,1174,1174,4,4,553172,38978267880,257480
857,jm1401,20130822,1174,1174,1171,1188,1168,1171,1176,-3,2,647076,45661438920,253114
858,jm1401,20130823,1171,1176,1171,1196,1171,1187,1187,11,11,747558,53241434160,282206
859,jm1401,20130826,1187,1187,1196,1222,1194,1196,1205,9,18,719398,52046067000,301216
860,jm1401,20130827,1196,1205,1190,1196,1179,1183,1188,-22,-17,510744,36411750120,296640
861,jm1401,20130828,1183,1188,1183,1187,1141,1141,1171,-47,-17,768088,53987060160,301238
862,jm1401,20130829,1141,1171,1136,1144,1119,1136,1134,-35,-37,835978,56884201920,267574
863,jm1401,20130830,1136,1134,1135,1140,1121,1134,1131,0,-3,541112,36720024960,271564
864,jm1401,20130902,1134,1131,1142,1171,1142,1165,1154,34,23,526488,36458996880,264524
865,jm1401,20130903,1165,1154,1167,1172,1145,1159,1159,5,5,465348,32371068480,260414
866,jm1401,20130904,1159,1159,1163,1167,1146,1153,1154,-6,-5,419446,29063705160,241332
867,jm1401,20130905,1153,1154,1147,1167,1147,1163,1159,9,5,478020,33255699480,239984
868,jm1401,20130906,1163,1159,1165,1170,1148,1156,1157,-3,-2,482108,33475407000,241928
869,jm1401,20130909,1156,1157,1164,1172,1161,1167,1166,10,9,321348,22485644760,236506
870,jm1401,20130910,1167,1166,1167,1168,1150,1156,1156,-10,-10,345458,23979576600,239270
871,jm1401,20130911,1156,1156,1160,1160,1150,1158,1155,2,-1,326132,22605001680,257594
872,jm1401,20130912,1158,1155,1158,1158,1143,1145,1148,-10,-7,336610,23204793960,254836
873,jm1401,20130913,1145,1148,1143,1143,1133,1133,1138,-15,-10,235948,16113811080,255260
874,jm1401,20130916,1133,1138,1136,1147,1131,1134,1137,-4,-1,215408,14704551480,259426
875,jm1401,20130917,1134,1137,1130,1145,1122,1142,1135,5,-2,360750,24579436440,254566
876,jm1401,20130918,1142,1135,1138,1160,1135,1160,1146,25,11,329600,22668782160,266166
877,jm1401,20130923,1160,1146,1154,1172,1148,1170,1162,24,16,346172,24149246280,292076
878,jm1401,20130924,1170,1162,1169,1176,1158,1163,1165,1,3,387654,27108260520,311728
879,jm1401,20130925,1163,1165,1163,1170,1156,1167,1163,2,-2,489386,34170423960,346614
880,jm1401,20130926,1167,1163,1168,1168,1160,1163,1163,0,0,236540,16508779440,342448
881,jm1401,20130927,1163,1163,1163,1163,1143,1146,1153,-17,-10,246720,17081943480,321998
882,jm1401,20130930,1146,1153,1146,1155,1134,1137,1142,-16,-11,192290,13177048800,291690
883,jm1401,20131008,1137,1142,1140,1143,1113,1137,1124,-5,-18,273560,18464625480,293098
884,jm1401,20131009,1137,1124,1135,1138,1124,1127,1130,3,6,345210,23410495680,379404
885,jm1401,20131010,1127,1130,1125,1140,1122,1130,1130,0,0,301668,20459036640,372144
886,jm1401,20131011,1130,1130,1131,1139,1120,1125,1129,-5,-1,240038,16262363760,386846
887,jm1401,20131014,1125,1129,1124,1146,1123,1146,1135,17,6,222328,15145905600,372720
888,jm1401,20131015,1146,1135,1152,1164,1134,1138,1147,3,12,290022,19965294120,381088
889,jm1401,20131016,1138,1147,1140,1141,1129,1130,1134,-17,-13,145660,9912273840,373900
890,jm1401,20131017,1130,1134,1134,1137,1126,1128,1130,-6,-4,147782,10021776960,377316
891,jm1401,20131018,1128,1130,1130,1136,1126,1129,1130,-1,0,112974,7663185840,375242
892,jm1401,20131021,1129,1130,1127,1145,1124,1142,1135,12,5,168318,11472206880,357546
893,jm1401,20131022,1142,1135,1141,1141,1127,1129,1132,-6,-3,144152,9799117920,389910
894,jm1401,20131023,1129,1132,1130,1131,1104,1118,1114,-14,-18,289364,19345374240,432850
895,jm1401,20131024,1118,1114,1116,1116,1095,1100,1102,-14,-12,221390,14645007360,407684
896,jm1401,20131025,1100,1102,1100,1107,1088,1091,1097,-11,-5,137522,9059541360,383814
897,jm1401,20131028,1091,1097,1094,1103,1091,1092,1093,-5,-4,98492,6464143800,347934
898,jm1401,20131029,1092,1093,1091,1094,1069,1081,1078,-12,-15,195752,12668698440,327428
899,jm1401,20131030,1081,1078,1083,1086,1075,1082,1081,4,3,96190,6240610560,317568
900,jm1401,20131031,1082,1081,1080,1083,1068,1068,1076,-13,-5,112482,7263017640,298788
901,jm1401,20131101,1068,1076,1068,1076,1066,1072,1070,-4,-6,95576,6139989120,261540
902,jm1401,20131104,1072,1070,1072,1075,1059,1065,1064,-5,-6,79448,5074380000,251348
903,jm1401,20131105,1065,1064,1067,1070,1060,1068,1065,4,1,81494,5207675520,243776
904,jm1401,20131106,1068,1065,1068,1079,1066,1074,1074,9,9,95670,6168807720,249982
905,jm1401,20131107,1074,1074,1078,1084,1073,1084,1079,10,5,64964,4208090520,238220
906,jm1401,20131108,1084,1079,1082,1085,1074,1074,1080,-5,1,45294,2935862160,230788
907,jm1401,20131111,1074,1080,1074,1078,1071,1076,1075,-4,-5,23726,1531333080,226104
908,jm1401,20131112,1076,1075,1074,1085,1074,1084,1080,9,5,29088,1886291640,221888
909,jm1401,20131113,1084,1080,1082,1086,1080,1082,1083,2,3,17768,1154601960,218216
910,jm1401,20131114,1082,1083,1082,1087,1079,1083,1083,0,0,18800,1221914280,213286
911,jm1401,20131115,1083,1083,1084,1086,1080,1081,1082,-2,-1,17370,1128507600,211136
912,jm1401,20131118,1081,1082,1082,1086,1080,1084,1083,2,1,23260,1512365160,208966
913,jm1401,20131119,1084,1083,1081,1087,1081,1086,1083,3,0,12584,818418240,203784
914,jm1401,20131120,1086,1083,1087,1095,1086,1095,1090,12,7,20970,1372080600,200754
915,jm1401,20131121,1095,1090,1093,1096,1084,1084,1086,-6,-4,15062,982042440,202938
916,jm1401,20131122,1084,1086,1085,1085,1080,1083,1082,-3,-4,12012,780235920,203648
917,jm1401,20131125,1083,1082,1084,1085,1076,1077,1079,-5,-3,9844,637560360,202188
918,jm1401,20131126,1077,1079,1077,1083,1076,1077,1080,-2,1,20392,1321984200,197332
919,jm1401,20131127,1077,1080,1078,1078,1068,1074,1072,-6,-8,22960,1477464240,192404
920,jm1401,20131128,1074,1072,1071,1083,1071,1078,1078,6,6,21700,1404756120,188638
921,jm1401,20131129,1078,1078,1078,1081,1076,1076,1078,-2,0,28304,1830767760,184374
922,jm1401,20131202,1076,1078,1080,1081,1074,1079,1078,1,0,28928,1871496840,177128
923,jm1401,20131203,1079,1078,1078,1084,1076,1082,1081,4,3,18396,1193894040,167296
924,jm1401,20131204,1082,1081,1083,1093,1082,1089,1087,8,6,13668,892185120,159426
925,jm1401,20131205,1089,1087,1092,1093,1084,1085,1088,-2,1,26098,1704331200,154326
926,jm1401,20131206,1085,1088,1086,1087,1077,1079,1081,-9,-7,12202,791804520,149420
927,jm1401,20131209,1079,1081,1078,1083,1078,1081,1080,0,-1,20068,1300588680,138948
928,jm1401,20131210,1081,1080,1081,1082,1078,1078,1080,-2,0,13060,846503640,132806
929,jm1401,20131211,1078,1080,1079,1079,1065,1065,1072,-15,-8,29984,1930284960,122230
930,jm1401,20131212,1065,1072,1065,1070,1046,1047,1057,-25,-15,34896,2214529800,101264
931,jm1401,20131213,1047,1057,1046,1048,1031,1040,1039,-17,-18,26864,1675502640,88662
932,jm1401,20131216,1040,1039,1043,1049,1039,1042,1043,3,4,7830,490406520,83612
933,jm1401,20131217,1042,1043,1040,1043,1038,1039,1040,-4,-3,5066,316139760,80000
934,jm1401,20131218,1039,1040,1038,1042,1035,1040,1039,0,-1,8232,513419760,74114
935,jm1401,20131219,1040,1039,1040,1042,1027,1031,1033,-8,-6,12084,749349360,64884
936,jm1401,20131220,1031,1033,1028,1031,1018,1020,1024,-13,-9,8174,502431000,59802
937,jm1401,20131223,1020,1024,1019,1024,1010,1019,1017,-5,-7,6634,404871360,55236
938,jm1401,20131224,1019,1017,1020,1023,1018,1020,1020,3,3,4326,264909240,51636
939,jm1401,20131225,1020,1020,1018,1025,1007,1015,1015,-5,-5,10806,658684320,44140
940,jm1401,20131226,1015,1015,1013,1013,1002,1004,1005,-11,-10,9046,545929560,37338
941,jm1401,20131227,1004,1005,1003,1004,986,988,993,-17,-12,10216,608899680,30040
942,jm1401,20131230,988,993,993,993,985,990,987,-3,-6,10752,636838320,24878
943,jm1401,20131231,990,987,987,990,950,957,968,-30,-19,11070,643057440,16650
944,jm1402,20130322,0,1380,1402,1402,1320,1350,1357,-30,-23,30,2443200,0
945,jm1402,20130325,1350,1357,0,0,0,1357,1357,0,0,0,0,0
946,jm1402,20130326,1357,1357,0,0,0,1357,1357,0,0,0,0,0
947,jm1402,20130327,1357,1357,0,0,0,1357,1357,0,0,0,0,0
948,jm1402,20130328,1357,1357,0,0,0,1357,1357,0,0,0,0,0
949,jm1402,20130329,1357,1357,0,0,0,1357,1357,0,0,0,0,0
950,jm1402,20130401,1357,1357,1304,1304,1304,1304,1304,-53,-53,2,156480,2
951,jm1402,20130402,1304,1304,0,0,0,1304,1304,0,0,0,0,2
952,jm1402,20130403,1304,1304,1288,1288,1272,1272,1283,-32,-21,10,770040,8
953,jm1402,20130408,1272,1283,1251,1281,1251,1281,1271,-2,-12,12,915600,12
954,jm1402,20130409,1281,1271,1284,1285,1284,1285,1284,14,13,4,308280,14
955,jm1402,20130410,1285,1284,1285,1285,1273,1273,1279,-11,-5,10,767520,14
956,jm1402,20130411,1273,1279,1273,1273,1268,1269,1270,-10,-9,8,609720,20
957,jm1402,20130412,1269,1270,0,0,0,1270,1270,0,0,0,0,20
958,jm1402,20130415,1270,1270,1270,1270,1238,1238,1254,-32,-16,4,300960,18
959,jm1402,20130416,1238,1254,0,0,0,1238,1238,-16,-16,0,0,18
960,jm1402,20130417,1238,1238,1211,1212,1211,1212,1211,-26,-27,4,290760,16
961,jm1402,20130418,1212,1211,1212,1214,1209,1212,1211,1,0,12,872400,16
962,jm1402,20130419,1212,1211,1216,1216,1216,1216,1216,5,5,2,145920,16
963,jm1402,20130422,1216,1216,1202,1202,1202,1202,1202,-14,-14,2,144240,18
964,jm1402,20130423,1202,1202,0,0,0,1202,1202,0,0,0,0,18
965,jm1402,20130424,1202,1202,1184,1209,1184,1189,1193,-13,-9,18,1288920,16
966,jm1402,20130425,1189,1193,1191,1191,1191,1191,1191,-2,-2,2,142920,18
967,jm1402,20130426,1191,1191,0,0,0,1191,1191,0,0,0,0,18
968,jm1402,20130502,1191,1191,0,0,0,1178,1178,-13,-13,0,0,18
969,jm1402,20130503,1178,1178,0,0,0,1187,1187,9,9,0,0,18
970,jm1402,20130506,1187,1187,1194,1194,1194,1194,1194,7,7,2,143280,18
971,jm1402,20130507,1194,1194,0,0,0,1194,1194,0,0,0,0,18
972,jm1402,20130508,1194,1194,0,0,0,1198,1198,4,4,0,0,18
973,jm1402,20130509,1198,1198,0,0,0,1200,1200,2,2,0,0,18
974,jm1402,20130510,1200,1200,0,0,0,1200,1200,0,0,0,0,18
975,jm1402,20130513,1200,1200,1238,1238,1230,1231,1233,31,33,6,443880,18
976,jm1402,20130514,1231,1233,1222,1223,1215,1215,1220,-18,-13,6,439200,18
977,jm1402,20130515,1215,1220,0,0,0,1212,1212,-8,-8,0,0,18
978,jm1402,20130516,1212,1212,1212,1212,1204,1204,1208,-8,-4,4,289920,18
979,jm1402,20130517,1204,1208,0,0,0,1208,1208,0,0,0,0,18
980,jm1402,20130520,1208,1208,0,0,0,1218,1218,10,10,0,0,18
981,jm1402,20130521,1218,1218,0,0,0,1220,1220,2,2,0,0,18
982,jm1402,20130522,1220,1220,1225,1226,1225,1226,1225,6,5,12,882360,18
983,jm1402,20130523,1226,1225,0,0,0,1216,1216,-9,-9,0,0,18
984,jm1402,20130524,1216,1216,0,0,0,1213,1213,-3,-3,0,0,18
985,jm1402,20130527,1213,1213,0,0,0,1198,1198,-15,-15,0,0,18
986,jm1402,20130528,1198,1198,0,0,0,1186,1186,-12,-12,0,0,18
987,jm1402,20130529,1186,1186,0,0,0,1180,1180,-6,-6,0,0,18
988,jm1402,20130530,1180,1180,0,0,0,1162,1162,-18,-18,0,0,18
989,jm1402,20130531,1162,1162,0,0,0,1160,1160,-2,-2,0,0,18
990,jm1402,20130603,1160,1160,0,0,0,1156,1156,-4,-4,0,0,18
991,jm1402,20130604,1156,1156,0,0,0,1156,1156,0,0,0,0,18
992,jm1402,20130605,1156,1156,0,0,0,1156,1156,0,0,0,0,18
993,jm1402,20130606,1156,1156,0,0,0,1123,1123,-33,-33,0,0,18
994,jm1402,20130607,1123,1123,0,0,0,1095,1095,-28,-28,0,0,18
995,jm1402,20130613,1095,1095,0,0,0,1084,1084,-11,-11,0,0,18
996,jm1402,20130614,1084,1084,0,0,0,1084,1084,0,0,0,0,18
997,jm1402,20130617,1084,1084,1084,1110,1056,1101,1090,17,6,50,3271200,20
998,jm1402,20130618,1101,1090,1109,1109,1103,1103,1106,13,16,4,265440,24
999,jm1402,20130619,1103,1106,0,0,0,1106,1106,0,0,0,0,24
1000,jm1402,20130620,1106,1106,1066,1066,1062,1063,1063,-43,-43,8,510480,26
1001,jm1402,20130621,1063,1063,1066,1066,1066,1066,1066,3,3,2,127920,24
1002,jm1402,20130624,1066,1066,1046,1046,1037,1037,1041,-29,-25,4,249960,22
1003,jm1402,20130625,1037,1041,1057,1057,1053,1053,1055,12,14,6,380040,24
1004,jm1402,20130626,1053,1055,0,0,0,1048,1048,-7,-7,0,0,24
1005,jm1402,20130627,1048,1048,0,0,0,1045,1045,-3,-3,0,0,24
1006,jm1402,20130628,1045,1045,1051,1061,1051,1061,1054,16,9,134,8475480,14
1007,jm1402,20130701,1061,1054,1053,1071,1029,1058,1038,4,-16,50,3116400,10
1008,jm1402,20130702,1058,1038,1047,1050,1036,1043,1044,5,6,28,1754280,4
1009,jm1402,20130703,1043,1044,0,0,0,1040,1040,-4,-4,0,0,4
1010,jm1402,20130704,1040,1040,1042,1051,1042,1051,1046,11,6,12,753480,4
1011,jm1402,20130705,1051,1046,0,0,0,1052,1052,6,6,0,0,4
1012,jm1402,20130708,1052,1052,1039,1039,1036,1036,1037,-16,-15,4,249000,6
1013,jm1402,20130709,1036,1037,1040,1048,1040,1045,1043,8,6,16,1001760,6
1014,jm1402,20130710,1045,1043,1060,1060,1060,1060,1060,17,17,2,127200,8
1015,jm1402,20130711,1060,1060,0,0,0,1085,1085,25,25,0,0,8
1016,jm1402,20130712,1085,1085,1043,1070,1042,1061,1060,-24,-25,52,3308400,10
1017,jm1402,20130715,1061,1060,0,0,0,1050,1050,-10,-10,0,0,10
1018,jm1402,20130716,1050,1050,1044,1050,1044,1050,1047,0,-3,4,251280,8
1019,jm1402,20130717,1050,1047,1050,1080,1050,1074,1066,27,19,8,512040,8
1020,jm1402,20130718,1074,1066,1066,1078,1066,1078,1072,12,6,4,257280,8
1021,jm1402,20130719,1078,1072,1078,1089,1076,1080,1082,8,10,14,909480,8
1022,jm1402,20130722,1080,1082,0,0,0,1087,1087,5,5,0,0,8
1023,jm1402,20130723,1087,1087,1083,1088,1082,1088,1083,1,-4,12,780120,14
1024,jm1402,20130724,1088,1083,1086,1095,1080,1081,1085,-2,2,42,2735280,8
1025,jm1402,20130725,1081,1085,0,0,0,1081,1081,-4,-4,0,0,8
1026,jm1402,20130726,1081,1081,1076,1085,1076,1081,1080,0,-1,6,389040,6
1027,jm1402,20130729,1081,1080,0,0,0,1064,1064,-16,-16,0,0,6
1028,jm1402,20130730,1064,1064,0,0,0,1060,1060,-4,-4,0,0,6
1029,jm1402,20130731,1060,1060,0,0,0,1060,1060,0,0,0,0,6
1030,jm1402,20130801,1060,1060,0,0,0,1072,1072,12,12,0,0,6
1031,jm1402,20130802,1072,1072,0,0,0,1079,1079,7,7,0,0,6
1032,jm1402,20130805,1079,1079,1084,1087,1084,1087,1084,8,5,8,520680,8
1033,jm1402,20130806,1087,1084,1085,1090,1082,1090,1085,6,1,12,781680,4
1034,jm1402,20130807,1090,1085,1082,1088,1082,1086,1084,1,-1,20,1301400,12
1035,jm1402,20130808,1086,1084,1104,1127,1104,1117,1113,33,29,8,534240,16
1036,jm1402,20130809,1117,1113,1127,1155,1124,1124,1129,11,16,52,3524280,18
1037,jm1402,20130812,1124,1129,1149,1150,1149,1150,1149,21,20,4,275880,18
1038,jm1402,20130813,1150,1149,1177,1190,1177,1190,1184,41,35,8,568680,18
1039,jm1402,20130814,1190,1184,1186,1186,1186,1186,1186,2,2,4,284640,14
1040,jm1402,20130815,1186,1186,1197,1197,1180,1180,1188,-6,2,4,285240,16
1041,jm1402,20130816,1180,1188,1169,1174,1158,1158,1167,-30,-21,30,2102040,20
1042,jm1402,20130819,1158,1167,1157,1183,1145,1176,1166,9,-1,62,4337520,14
1043,jm1402,20130820,1176,1166,1174,1180,1174,1178,1177,12,11,6,423840,12
1044,jm1402,20130821,1178,1177,1178,1186,1178,1184,1182,7,5,20,1419480,16
1045,jm1402,20130822,1184,1182,1197,1197,1182,1182,1192,0,10,16,1144440,24
1046,jm1402,20130823,1182,1192,1192,1199,1192,1198,1195,6,3,8,573720,26
1047,jm1402,20130826,1198,1195,1228,1228,1210,1212,1217,17,22,20,1460640,16
1048,jm1402,20130827,1212,1217,1197,1209,1195,1200,1202,-17,-15,34,2453160,14
1049,jm1402,20130828,1200,1202,1187,1187,1156,1156,1169,-46,-33,10,701640,14
1050,jm1402,20130829,1156,1169,1149,1149,1139,1143,1143,-26,-26,10,686160,14
1051,jm1402,20130830,1143,1143,0,0,0,1143,1143,0,0,0,0,14
1052,jm1402,20130902,1143,1143,0,0,0,1166,1166,23,23,0,0,14
1053,jm1402,20130903,1166,1166,1169,1169,1169,1169,1169,3,3,2,140280,12
1054,jm1402,20130904,1169,1169,1169,1174,1169,1174,1171,5,2,4,281160,12
1055,jm1402,20130905,1174,1171,1172,1173,1163,1173,1169,2,-2,6,420960,12
1056,jm1402,20130906,1173,1169,1166,1166,1166,1166,1166,-3,-3,4,279840,12
1057,jm1402,20130909,1166,1166,1170,1192,1170,1192,1178,26,12,10,707040,14
1058,jm1402,20130910,1192,1178,0,0,0,1168,1168,-10,-10,0,0,14
1059,jm1402,20130911,1168,1168,1168,1173,1154,1173,1155,5,-13,164,11365560,166
1060,jm1402,20130912,1173,1155,1125,1178,1125,1162,1165,7,10,190,13291560,20
1061,jm1402,20130913,1162,1165,1149,1154,1149,1154,1151,-11,-14,4,276360,18
1062,jm1402,20130916,1154,1151,0,0,0,1151,1151,0,0,0,0,18
1063,jm1402,20130917,1151,1151,1154,1154,1154,1154,1154,3,3,8,553920,16
1064,jm1402,20130918,1154,1154,1151,1158,1147,1158,1153,4,-1,18,1245480,14
1065,jm1402,20130923,1158,1153,1152,1180,1152,1175,1167,22,14,36,2522640,14
1066,jm1402,20130924,1175,1167,1181,1181,1175,1180,1178,13,11,6,424320,12
1067,jm1402,20130925,1180,1178,1177,1177,1177,1177,1177,-1,-1,4,282480,16
1068,jm1402,20130926,1177,1177,0,0,0,1177,1177,0,0,0,0,16
1069,jm1402,20130927,1177,1177,1167,1167,1167,1167,1167,-10,-10,2,140040,14
1070,jm1402,20130930,1167,1167,1154,1162,1150,1155,1155,-12,-12,12,831720,12
1071,jm1402,20131008,1155,1155,0,0,0,1137,1137,-18,-18,0,0,12
1072,jm1402,20131009,1137,1137,0,0,0,1143,1143,6,6,0,0,12
1073,jm1402,20131010,1143,1143,0,0,0,1143,1143,0,0,0,0,12
1074,jm1402,20131011,1143,1143,1136,1145,1136,1145,1140,2,-3,8,547440,12
1075,jm1402,20131014,1145,1140,0,0,0,1146,1146,6,6,0,0,12
1076,jm1402,20131015,1146,1146,1186,1186,1154,1171,1171,25,25,60,4217280,14
1077,jm1402,20131016,1171,1171,1143,1143,1143,1143,1143,-28,-28,2,137160,14
1078,jm1402,20131017,1143,1143,1142,1143,1142,1143,1142,0,-1,4,274200,14
1079,jm1402,20131018,1143,1142,0,0,0,1142,1142,0,0,0,0,14
1080,jm1402,20131021,1142,1142,0,0,0,1147,1147,5,5,0,0,14
1081,jm1402,20131022,1147,1147,1156,1156,1149,1149,1152,2,5,4,276600,14
1082,jm1402,20131023,1149,1152,1139,1171,1132,1132,1145,-20,-7,24,1648920,18
1083,jm1402,20131024,1132,1145,1124,1148,1119,1119,1138,-26,-7,22,1502880,34
1084,jm1402,20131025,1119,1138,1127,1127,1124,1124,1125,-14,-13,12,810000,40
1085,jm1402,20131028,1124,1125,1116,1117,1113,1113,1115,-12,-10,6,401520,40
1086,jm1402,20131029,1113,1115,1103,1103,1098,1098,1099,-17,-16,10,659640,36
1087,jm1402,20131030,1098,1099,1096,1113,1094,1111,1098,12,-1,22,1449720,28
1088,jm1402,20131031,1111,1098,1099,1099,1078,1093,1092,-5,-6,36,2358960,20
1089,jm1402,20131101,1093,1092,0,0,0,1086,1086,-6,-6,0,0,20
1090,jm1402,20131104,1086,1086,0,0,0,1086,1086,0,0,0,0,20
1091,jm1402,20131105,1086,1086,0,0,0,1086,1086,0,0,0,0,20
1092,jm1402,20131106,1086,1086,1098,1098,1098,1098,1098,12,12,2,131760,22
1093,jm1402,20131107,1098,1098,1090,1099,1090,1099,1096,1,-2,6,394560,20
1094,jm1402,20131108,1099,1096,0,0,0,1090,1090,-6,-6,0,0,20
1095,jm1402,20131111,1090,1090,0,0,0,1085,1085,-5,-5,0,0,20
1096,jm1402,20131112,1085,1085,0,0,0,1090,1090,5,5,0,0,20
1097,jm1402,20131113,1090,1090,0,0,0,1093,1093,3,3,0,0,20
1098,jm1402,20131114,1093,1093,1081,1081,1081,1081,1081,-12,-12,2,129720,22
1099,jm1402,20131115,1081,1081,1094,1102,1092,1092,1096,11,15,6,394560,20
1100,jm1402,20131118,1092,1096,0,0,0,1097,1097,1,1,0,0,20
1101,jm1402,20131119,1097,1097,1103,1103,1103,1103,1103,6,6,4,264720,18
1102,jm1402,20131120,1103,1103,0,0,0,1103,1103,0,0,0,0,18
1103,jm1402,20131121,1103,1103,1102,1102,1101,1101,1101,-2,-2,6,396600,14
1104,jm1402,20131122,1101,1101,0,0,0,1097,1097,-4,-4,0,0,14
1105,jm1402,20131125,1097,1097,0,0,0,1094,1094,-3,-3,0,0,14
1106,jm1402,20131126,1094,1094,0,0,0,1095,1095,1,1,0,0,14
1107,jm1402,20131127,1095,1095,1093,1093,1093,1093,1093,-2,-2,2,131160,14
1108,jm1402,20131128,1093,1093,1091,1098,1091,1094,1094,1,1,6,393960,14
1109,jm1402,20131129,1094,1094,1096,1096,1096,1096,1096,2,2,4,263040,14
1110,jm1402,20131202,1096,1096,0,0,0,1096,1096,0,0,0,0,14
1111,jm1402,20131203,1096,1096,0,0,0,1099,1099,3,3,0,0,14
1112,jm1402,20131204,1099,1099,1110,1110,1110,1110,1110,11,11,2,133200,14
1113,jm1402,20131205,1110,1110,0,0,0,1111,1111,1,1,0,0,14
1114,jm1402,20131206,1111,1111,1096,1096,1096,1096,1096,-15,-15,4,263040,14
1115,jm1402,20131209,1096,1096,0,0,0,1096,1096,0,0,0,0,14
1116,jm1402,20131210,1096,1096,1105,1105,1105,1105,1105,9,9,2,132600,16
1117,jm1402,20131211,1105,1105,1093,1099,1093,1099,1097,-6,-8,6,394920,14
1118,jm1402,20131212,1099,1097,1096,1096,1091,1091,1093,-6,-4,4,262440,16
1119,jm1402,20131213,1091,1093,1067,1067,1067,1067,1067,-26,-26,2,128040,16
1120,jm1402,20131216,1067,1067,0,0,0,1071,1071,4,4,0,0,16
1121,jm1402,20131217,1071,1071,1066,1066,1066,1066,1066,-5,-5,2,127920,14
1122,jm1402,20131218,1066,1066,0,0,0,1066,1066,0,0,0,0,14
1123,jm1402,20131219,1066,1066,0,0,0,1060,1060,-6,-6,0,0,14
1124,jm1402,20131220,1060,1060,1043,1043,1043,1043,1043,-17,-17,4,250320,12
1125,jm1402,20131223,1043,1043,1037,1037,1037,1037,1037,-6,-6,2,124440,12
1126,jm1402,20131224,1037,1037,1041,1041,1041,1041,1041,4,4,4,249840,8
1127,jm1402,20131225,1041,1041,1037,1037,1037,1037,1037,-4,-4,2,124440,8
1128,jm1402,20131226,1037,1037,1038,1038,1038,1038,1038,1,1,2,124560,8
1129,jm1402,20131227,1038,1038,0,0,0,1026,1026,-12,-12,0,0,8
1130,jm1402,20131230,1026,1026,0,0,0,1020,1020,-6,-6,0,0,8
1131,jm1402,20131231,1020,1020,0,0,0,1001,1001,-19,-19,0,0,8
1132,jm1403,20130322,0,1380,1490,1490,1318,1342,1372,-38,-8,48,3953760,20
1133,jm1403,20130325,1342,1372,1345,1345,1329,1329,1339,-43,-33,12,964560,14
1134,jm1403,20130326,1329,1339,1345,1345,1323,1334,1335,-5,-4,24,1922640,8
1135,jm1403,20130327,1334,1335,1342,1344,1320,1320,1341,-15,6,110,8854920,106
1136,jm1403,20130328,1320,1341,1322,1329,1322,1328,1326,-13,-15,108,8598240,16
1137,jm1403,20130329,1328,1326,1327,1353,1318,1318,1330,-8,4,38,3033720,26
1138,jm1403,20130401,1318,1330,1320,1320,1277,1277,1294,-53,-36,46,3571920,26
1139,jm1403,20130402,1277,1294,1275,1302,1275,1302,1283,8,-11,42,3234000,26
1140,jm1403,20130403,1302,1283,1331,1331,1288,1293,1299,10,16,18,1403040,22
1141,jm1403,20130408,1293,1299,1292,1292,1277,1292,1286,-7,-13,8,617400,24
1142,jm1403,20130409,1292,1286,1295,1295,1295,1295,1295,9,9,2,155400,26
1143,jm1403,20130410,1295,1295,1304,1304,1294,1294,1297,-1,2,6,467160,24
1144,jm1403,20130411,1294,1297,1285,1285,1285,1285,1285,-12,-12,2,154200,22
1145,jm1403,20130412,1285,1285,0,0,0,1285,1285,0,0,0,0,22
1146,jm1403,20130415,1285,1285,1275,1275,1256,1262,1266,-23,-19,20,1520040,22
1147,jm1403,20130416,1262,1266,1232,1253,1232,1253,1244,-13,-22,16,1195080,22
1148,jm1403,20130417,1253,1244,1273,1273,1233,1237,1252,-7,8,38,2855040,38
1149,jm1403,20130418,1237,1252,1223,1227,1214,1227,1221,-25,-31,34,2491440,54
1150,jm1403,20130419,1227,1221,1220,1235,1220,1235,1222,14,1,14,1026600,54
1151,jm1403,20130422,1235,1222,0,0,0,1208,1208,-14,-14,0,0,54
1152,jm1403,20130423,1208,1208,1223,1223,1181,1181,1202,-27,-6,4,288480,54
1153,jm1403,20130424,1181,1202,1202,1204,1202,1204,1203,2,1,4,288720,54
1154,jm1403,20130425,1204,1203,1205,1205,1205,1205,1205,2,2,4,289200,50
1155,jm1403,20130426,1205,1205,1218,1218,1218,1218,1218,13,13,2,146160,50
1156,jm1403,20130502,1218,1218,0,0,0,1190,1190,-28,-28,0,0,50
1157,jm1403,20130503,1190,1190,0,0,0,1190,1190,0,0,0,0,50
1158,jm1403,20130506,1190,1190,0,0,0,1197,1197,7,7,0,0,50
1159,jm1403,20130507,1197,1197,1201,1205,1199,1199,1202,2,5,8,577200,52
1160,jm1403,20130508,1199,1202,0,0,0,1207,1207,5,5,0,0,52
1161,jm1403,20130509,1207,1207,0,0,0,1210,1210,3,3,0,0,52
1162,jm1403,20130510,1210,1210,1220,1220,1220,1220,1220,10,10,6,439200,52
1163,jm1403,20130513,1220,1220,1228,1250,1228,1250,1241,30,21,8,595920,52
1164,jm1403,20130514,1250,1241,1240,1240,1240,1240,1240,-1,-1,2,148800,52
1165,jm1403,20130515,1240,1240,0,0,0,1229,1229,-11,-11,0,0,52
1166,jm1403,20130516,1229,1229,1202,1202,1202,1202,1202,-27,-27,2,144240,54
1167,jm1403,20130517,1202,1202,1219,1219,1219,1219,1219,17,17,4,292560,56
1168,jm1403,20130520,1219,1219,0,0,0,1219,1219,0,0,0,0,56
1169,jm1403,20130521,1219,1219,1241,1241,1241,1241,1241,22,22,2,148920,54
1170,jm1403,20130522,1241,1241,1244,1244,1244,1244,1244,3,3,2,149280,54
1171,jm1403,20130523,1244,1244,1224,1224,1224,1224,1224,-20,-20,4,293760,56
1172,jm1403,20130524,1224,1224,1225,1225,1225,1225,1225,1,1,2,147000,56
1173,jm1403,20130527,1225,1225,0,0,0,1209,1209,-16,-16,0,0,56
1174,jm1403,20130528,1209,1209,1207,1207,1201,1201,1204,-8,-5,10,722760,56
1175,jm1403,20130529,1201,1204,1195,1195,1181,1181,1192,-23,-12,14,1001640,54
1176,jm1403,20130530,1181,1192,1187,1187,1172,1175,1176,-17,-16,10,706080,46
1177,jm1403,20130531,1175,1176,1181,1181,1167,1167,1173,-9,-3,8,563160,52
1178,jm1403,20130603,1167,1173,1172,1172,1159,1159,1166,-14,-7,10,700080,54
1179,jm1403,20130604,1159,1166,0,0,0,1166,1166,0,0,0,0,54
1180,jm1403,20130605,1166,1166,1172,1180,1172,1180,1176,14,10,4,282240,52
1181,jm1403,20130606,1180,1176,1158,1158,1130,1130,1146,-46,-30,20,1375680,52
1182,jm1403,20130607,1130,1146,1139,1140,1114,1124,1130,-22,-16,14,949560,56
1183,jm1403,20130613,1124,1130,0,0,0,1118,1118,-12,-12,0,0,56
1184,jm1403,20130614,1118,1118,1113,1113,1113,1113,1113,-5,-5,2,133560,56
1185,jm1403,20130617,1113,1113,0,0,0,1113,1113,0,0,0,0,56
1186,jm1403,20130618,1113,1113,0,0,0,1122,1122,9,9,0,0,56
1187,jm1403,20130619,1122,1122,0,0,0,1114,1114,-8,-8,0,0,56
1188,jm1403,20130620,1114,1114,1108,1108,1085,1085,1095,-29,-19,8,525960,56
1189,jm1403,20130621,1085,1095,1070,1070,1070,1070,1070,-25,-25,2,128400,56
1190,jm1403,20130624,1070,1070,1080,1080,1066,1066,1074,-4,4,6,386880,56
1191,jm1403,20130625,1066,1074,0,0,0,1088,1088,14,14,0,0,56
1192,jm1403,20130626,1088,1088,1085,1090,1069,1078,1083,-10,-5,30,1949400,54
1193,jm1403,20130627,1078,1083,0,0,0,1083,1083,0,0,0,0,54
1194,jm1403,20130628,1083,1083,1073,1073,1073,1073,1073,-10,-10,2,128760,54
1195,jm1403,20130701,1073,1073,1076,1076,1062,1062,1068,-11,-5,6,384600,56
1196,jm1403,20130702,1062,1068,1069,1069,1066,1066,1067,-2,-1,4,256200,54
1197,jm1403,20130703,1066,1067,1056,1064,1056,1064,1061,-3,-6,6,382080,56
1198,jm1403,20130704,1064,1061,1062,1071,1062,1071,1065,10,4,8,511560,56
1199,jm1403,20130705,1071,1065,0,0,0,1068,1068,3,3,0,0,56
1200,jm1403,20130708,1068,1068,1066,1067,1057,1061,1062,-7,-6,22,1401840,60
1201,jm1403,20130709,1061,1062,1068,1069,1055,1056,1064,-6,2,18,1149120,60
1202,jm1403,20130710,1056,1064,0,0,0,1064,1064,0,0,0,0,60
1203,jm1403,20130711,1064,1064,1064,1064,1064,1064,1064,0,0,2,127680,60
1204,jm1403,20130712,1064,1064,1070,1070,1070,1070,1070,6,6,4,256800,58
1205,jm1403,20130715,1070,1070,1066,1066,1064,1064,1065,-6,-5,10,639120,52
1206,jm1403,20130716,1064,1065,0,0,0,1062,1062,-3,-3,0,0,52
1207,jm1403,20130717,1062,1062,1086,1086,1086,1086,1086,24,24,6,390960,58
1208,jm1403,20130718,1086,1086,1087,1094,1087,1094,1090,8,4,4,261720,58
1209,jm1403,20130719,1094,1090,1095,1095,1095,1095,1095,5,5,6,394200,54
1210,jm1403,20130722,1095,1095,0,0,0,1100,1100,5,5,0,0,54
1211,jm1403,20130723,1100,1100,1108,1108,1106,1106,1107,6,7,4,265680,54
1212,jm1403,20130724,1106,1107,1098,1098,1098,1098,1098,-9,-9,2,131760,54
1213,jm1403,20130725,1098,1098,1097,1097,1080,1096,1092,-2,-6,8,524400,52
1214,jm1403,20130726,1096,1092,0,0,0,1091,1091,-1,-1,0,0,52
1215,jm1403,20130729,1091,1091,0,0,0,1075,1075,-16,-16,0,0,52
1216,jm1403,20130730,1075,1075,1079,1079,1079,1079,1079,4,4,2,129480,52
1217,jm1403,20130731,1079,1079,0,0,0,1083,1083,4,4,0,0,52
1218,jm1403,20130801,1083,1083,0,0,0,1095,1095,12,12,0,0,52
1219,jm1403,20130802,1095,1095,1105,1107,1105,1107,1105,12,10,12,795960,52
1220,jm1403,20130805,1107,1105,0,0,0,1110,1110,5,5,0,0,52
1221,jm1403,20130806,1110,1110,0,0,0,1111,1111,1,1,0,0,52
1222,jm1403,20130807,1111,1111,1106,1106,1106,1106,1106,-5,-5,2,132720,52
1223,jm1403,20130808,1106,1106,0,0,0,1135,1135,29,29,0,0,52
1224,jm1403,20130809,1135,1135,1140,1140,1140,1140,1140,5,5,2,136800,52
1225,jm1403,20130812,1140,1140,1140,1184,1140,1175,1168,35,28,8,560760,52
1226,jm1403,20130813,1175,1168,0,0,0,1203,1203,35,35,0,0,52
1227,jm1403,20130814,1203,1203,1219,1219,1219,1219,1219,16,16,2,146280,52
1228,jm1403,20130815,1219,1219,1215,1215,1209,1215,1214,-4,-5,12,874080,44
1229,jm1403,20130816,1215,1214,0,0,0,1211,1211,-3,-3,0,0,44
1230,jm1403,20130819,1211,1211,1193,1193,1193,1193,1193,-18,-18,2,143160,44
1231,jm1403,20130820,1193,1193,1202,1202,1200,1200,1200,7,7,30,2160480,24
1232,jm1403,20130821,1200,1200,0,0,0,1205,1205,5,5,0,0,24
1233,jm1403,20130822,1205,1205,1202,1202,1202,1202,1202,-3,-3,2,144240,24
1234,jm1403,20130823,1202,1202,1217,1224,1211,1224,1219,22,17,14,1024080,22
1235,jm1403,20130826,1224,1219,1232,1232,1232,1232,1232,13,13,2,147840,22
1236,jm1403,20130827,1232,1232,0,0,0,1217,1217,-15,-15,0,0,22
1237,jm1403,20130828,1217,1217,1207,1207,1181,1181,1193,-36,-24,10,716280,22
1238,jm1403,20130829,1181,1193,1154,1165,1154,1165,1158,-28,-35,8,555960,16
1239,jm1403,20130830,1165,1158,1164,1164,1164,1164,1164,6,6,4,279360,16
1240,jm1403,20130902,1164,1164,0,0,0,1187,1187,23,23,0,0,16
1241,jm1403,20130903,1187,1187,1193,1201,1193,1201,1197,14,10,4,287280,18
1242,jm1403,20130904,1201,1197,0,0,0,1199,1199,2,2,0,0,18
1243,jm1403,20130905,1199,1199,0,0,0,1199,1199,0,0,0,0,18
1244,jm1403,20130906,1199,1199,0,0,0,1196,1196,-3,-3,0,0,18
1245,jm1403,20130909,1196,1196,1206,1206,1206,1206,1206,10,10,4,289440,16
1246,jm1403,20130910,1206,1206,1194,1194,1188,1188,1191,-18,-15,4,285840,16
1247,jm1403,20130911,1188,1191,0,0,0,1178,1178,-13,-13,0,0,16
1248,jm1403,20130912,1178,1178,0,0,0,1188,1188,10,10,0,0,16
1249,jm1403,20130913,1188,1188,0,0,0,1174,1174,-14,-14,0,0,16
1250,jm1403,20130916,1174,1174,0,0,0,1173,1173,-1,-1,0,0,16
1251,jm1403,20130917,1173,1173,0,0,0,1173,1173,0,0,0,0,16
1252,jm1403,20130918,1173,1173,1163,1178,1144,1178,1157,5,-16,282,19577040,154
1253,jm1403,20130923,1178,1157,1176,1190,1176,1190,1184,33,27,14,995280,150
1254,jm1403,20130924,1190,1184,0,0,0,1184,1184,0,0,0,0,150
1255,jm1403,20130925,1184,1184,1189,1189,1180,1186,1182,2,-2,22,1560840,162
1256,jm1403,20130926,1186,1182,0,0,0,1182,1182,0,0,0,0,162
1257,jm1403,20130927,1182,1182,1151,1167,1151,1167,1159,-15,-23,4,278160,164
1258,jm1403,20130930,1167,1159,1172,1172,1151,1151,1161,-8,2,4,278760,166
1259,jm1403,20131008,1151,1161,1141,1141,1139,1139,1139,-22,-22,84,5741040,86
1260,jm1403,20131009,1139,1139,1144,1147,1144,1147,1146,8,7,10,687720,96
1261,jm1403,20131010,1147,1146,1141,1141,1141,1141,1141,-5,-5,2,136920,96
1262,jm1403,20131011,1141,1141,1140,1140,1140,1140,1140,-1,-1,96,6566400,92
1263,jm1403,20131014,1140,1140,1143,1153,1143,1152,1149,12,9,6,413760,94
1264,jm1403,20131015,1152,1149,1154,1154,1154,1154,1154,5,5,2,138480,92
1265,jm1403,20131016,1154,1154,0,0,0,1154,1154,0,0,0,0,92
1266,jm1403,20131017,1154,1154,0,0,0,1154,1154,0,0,0,0,92
1267,jm1403,20131018,1154,1154,1142,1143,1142,1143,1142,-11,-12,4,274200,92
1268,jm1403,20131021,1143,1142,0,0,0,1147,1147,5,5,0,0,92
1269,jm1403,20131022,1147,1147,1149,1150,1141,1141,1147,-6,0,22,1515120,70
1270,jm1403,20131023,1141,1147,0,0,0,1141,1141,-6,-6,0,0,70
1271,jm1403,20131024,1141,1141,1117,1119,1108,1118,1114,-23,-27,16,1070040,72
1272,jm1403,20131025,1118,1114,1120,1120,1107,1107,1117,-7,3,12,804840,72
1273,jm1403,20131028,1107,1117,0,0,0,1117,1117,0,0,0,0,72
1274,jm1403,20131029,1117,1117,1099,1104,1094,1096,1098,-21,-19,20,1318680,74
1275,jm1403,20131030,1096,1098,1098,1107,1096,1107,1101,9,3,12,792720,70
1276,jm1403,20131031,1107,1101,1099,1099,1099,1099,1099,-2,-2,4,263760,66
1277,jm1403,20131101,1099,1099,0,0,0,1099,1099,0,0,0,0,66
1278,jm1403,20131104,1099,1099,0,0,0,1099,1099,0,0,0,0,66
1279,jm1403,20131105,1099,1099,1099,1099,1084,1084,1093,-15,-6,38,2492400,60
1280,jm1403,20131106,1084,1093,1096,1097,1096,1097,1096,4,3,4,263160,60
1281,jm1403,20131107,1097,1096,0,0,0,1096,1096,0,0,0,0,60
1282,jm1403,20131108,1096,1096,0,0,0,1097,1097,1,1,0,0,60
1283,jm1403,20131111,1097,1097,1089,1089,1089,1089,1089,-8,-8,4,261360,60
1284,jm1403,20131112,1089,1089,1085,1093,1085,1093,1088,4,-1,14,913920,66
1285,jm1403,20131113,1093,1088,1093,1093,1093,1093,1093,5,5,2,131160,66
1286,jm1403,20131114,1093,1093,0,0,0,1093,1093,0,0,0,0,66
1287,jm1403,20131115,1093,1093,0,0,0,1093,1093,0,0,0,0,66
1288,jm1403,20131118,1093,1093,1091,1091,1091,1091,1091,-2,-2,4,261840,66
1289,jm1403,20131119,1091,1091,1091,1091,1091,1091,1091,0,0,2,130920,66
1290,jm1403,20131120,1091,1091,1103,1106,1100,1105,1102,14,11,30,1983600,44
1291,jm1403,20131121,1105,1102,1092,1095,1092,1094,1093,-8,-9,6,393720,44
1292,jm1403,20131122,1094,1093,0,0,0,1089,1089,-4,-4,0,0,44
1293,jm1403,20131125,1089,1089,0,0,0,1086,1086,-3,-3,0,0,44
1294,jm1403,20131126,1086,1086,1089,1092,1089,1092,1090,6,4,4,261720,42
1295,jm1403,20131127,1092,1090,1075,1084,1075,1084,1078,-6,-12,12,776160,50
1296,jm1403,20131128,1084,1078,1089,1089,1087,1087,1088,9,10,6,391800,48
1297,jm1403,20131129,1087,1088,1085,1085,1085,1085,1085,-3,-3,4,260400,44
1298,jm1403,20131202,1085,1085,0,0,0,1085,1085,0,0,0,0,44
1299,jm1403,20131203,1085,1085,1090,1090,1085,1085,1087,0,2,4,261000,44
1300,jm1403,20131204,1085,1087,1100,1102,1099,1099,1100,12,13,14,924360,38
1301,jm1403,20131205,1099,1100,0,0,0,1101,1101,1,1,0,0,38
1302,jm1403,20131206,1101,1101,0,0,0,1087,1087,-14,-14,0,0,38
1303,jm1403,20131209,1087,1087,0,0,0,1086,1086,-1,-1,0,0,38
1304,jm1403,20131210,1086,1086,0,0,0,1086,1086,0,0,0,0,38
1305,jm1403,20131211,1086,1086,0,0,0,1079,1079,-7,-7,0,0,38
1306,jm1403,20131212,1079,1079,1082,1087,1072,1084,1077,5,-2,34,2198160,30
1307,jm1403,20131213,1084,1077,1060,1060,1060,1060,1060,-17,-17,2,127200,30
1308,jm1403,20131216,1060,1060,0,0,0,1056,1056,-4,-4,0,0,30
1309,jm1403,20131217,1056,1056,1051,1051,1051,1051,1051,-5,-5,2,126120,30
1310,jm1403,20131218,1051,1051,1044,1044,1044,1044,1044,-7,-7,2,125280,28
1311,jm1403,20131219,1044,1044,0,0,0,1044,1044,0,0,0,0,28
1312,jm1403,20131220,1044,1044,0,0,0,1026,1026,-18,-18,0,0,28
1313,jm1403,20131223,1026,1026,1018,1020,1018,1020,1018,-6,-8,8,488880,34
1314,jm1403,20131224,1020,1018,1021,1031,1021,1031,1026,13,8,16,985200,36
1315,jm1403,20131225,1031,1026,0,0,0,1026,1026,0,0,0,0,36
1316,jm1403,20131226,1026,1026,0,0,0,1026,1026,0,0,0,0,36
1317,jm1403,20131227,1026,1026,0,0,0,1026,1026,0,0,0,0,36
1318,jm1403,20131230,1026,1026,0,0,0,1026,1026,0,0,0,0,36
1319,jm1403,20131231,1026,1026,1003,1005,990,990,999,-36,-27,6,359760,40
1320,jm1404,20130418,1246,1246,0,0,0,1246,1246,0,0,0,0,0
1321,jm1404,20130419,1246,1246,0,0,0,1246,1246,0,0,0,0,0
1322,jm1404,20130422,1246,1246,0,0,0,1232,1232,-14,-14,0,0,0
1323,jm1404,20130423,1232,1232,0,0,0,1232,1232,0,0,0,0,0
1324,jm1404,20130424,1232,1232,1212,1212,1212,1212,1212,-20,-20,2,145440,2
1325,jm1404,20130425,1212,1212,1190,1201,1190,1201,1195,-11,-17,4,286920,4
1326,jm1404,20130426,1201,1195,0,0,0,1207,1207,12,12,0,0,4
1327,jm1404,20130502,1207,1207,1202,1202,1202,1202,1202,-5,-5,2,144240,2
1328,jm1404,20130503,1202,1202,0,0,0,1212,1212,10,10,0,0,2
1329,jm1404,20130506,1212,1212,0,0,0,1219,1219,7,7,0,0,2
1330,jm1404,20130507,1219,1219,0,0,0,1224,1224,5,5,0,0,2
1331,jm1404,20130508,1224,1224,0,0,0,1229,1229,5,5,0,0,2
1332,jm1404,20130509,1229,1229,0,0,0,1232,1232,3,3,0,0,2
1333,jm1404,20130510,1232,1232,0,0,0,1242,1242,10,10,0,0,2
1334,jm1404,20130513,1242,1242,0,0,0,1242,1242,0,0,0,0,2
1335,jm1404,20130514,1242,1242,0,0,0,1241,1241,-1,-1,0,0,2
1336,jm1404,20130515,1241,1241,1223,1223,1205,1205,1219,-36,-22,38,2779800,32
1337,jm1404,20130516,1205,1219,0,0,0,1193,1193,-26,-26,0,0,32
1338,jm1404,20130517,1193,1193,1226,1227,1226,1227,1226,34,33,4,294360,32
1339,jm1404,20130520,1227,1226,1243,1243,1225,1227,1228,1,2,20,1473720,32
1340,jm1404,20130521,1227,1228,1237,1254,1235,1254,1242,26,14,6,447120,34
1341,jm1404,20130522,1254,1242,1243,1258,1243,1258,1249,16,7,6,449880,38
1342,jm1404,20130523,1258,1249,0,0,0,1229,1229,-20,-20,0,0,38
1343,jm1404,20130524,1229,1229,1220,1228,1220,1226,1224,-3,-5,10,734400,40
1344,jm1404,20130527,1226,1224,0,0,0,1224,1224,0,0,0,0,40
1345,jm1404,20130528,1224,1224,1211,1211,1208,1208,1209,-16,-15,6,435360,36
1346,jm1404,20130529,1208,1209,1205,1215,1205,1215,1208,6,-1,6,435000,42
1347,jm1404,20130530,1215,1208,1181,1181,1181,1181,1181,-27,-27,2,141720,42
1348,jm1404,20130531,1181,1181,1189,1189,1166,1166,1178,-15,-3,14,990000,32
1349,jm1404,20130603,1166,1178,1189,1189,1167,1167,1172,-11,-6,10,703440,30
1350,jm1404,20130604,1167,1172,1181,1181,1177,1178,1177,6,5,26,1836840,10
1351,jm1404,20130605,1178,1177,0,0,0,1189,1189,12,12,0,0,10
1352,jm1404,20130606,1189,1189,1144,1160,1144,1150,1149,-39,-40,8,551760,10
1353,jm1404,20130607,1150,1149,1140,1140,1140,1140,1140,-9,-9,4,273600,10
1354,jm1404,20130613,1140,1140,0,0,0,1140,1140,0,0,0,0,10
1355,jm1404,20130614,1140,1140,0,0,0,1135,1135,-5,-5,0,0,10
1356,jm1404,20130617,1135,1135,1136,1139,1136,1139,1138,4,3,6,409680,10
1357,jm1404,20130618,1139,1138,0,0,0,1154,1154,16,16,0,0,10
1358,jm1404,20130619,1154,1154,0,0,0,1146,1146,-8,-8,0,0,10
1359,jm1404,20130620,1146,1146,0,0,0,1127,1127,-19,-19,0,0,10
1360,jm1404,20130621,1127,1127,0,0,0,1102,1102,-25,-25,0,0,10
1361,jm1404,20130624,1102,1102,0,0,0,1102,1102,0,0,0,0,10
1362,jm1404,20130625,1102,1102,0,0,0,1116,1116,14,14,0,0,10
1363,jm1404,20130626,1116,1116,1074,1082,1074,1082,1077,-34,-39,8,517320,18
1364,jm1404,20130627,1082,1077,1081,1086,1081,1086,1082,9,5,6,389760,16
1365,jm1404,20130628,1086,1082,1075,1076,1075,1076,1075,-6,-7,10,645240,14
1366,jm1404,20130701,1076,1075,0,0,0,1075,1075,0,0,0,0,14
1367,jm1404,20130702,1075,1075,1068,1068,1068,1068,1068,-7,-7,2,128160,14
1368,jm1404,20130703,1068,1068,1065,1066,1065,1066,1065,-2,-3,4,255720,16
1369,jm1404,20130704,1066,1065,1066,1073,1066,1073,1068,8,3,8,513000,12
1370,jm1404,20130705,1073,1068,1079,1079,1079,1079,1079,11,11,4,258960,10
1371,jm1404,20130708,1079,1079,0,0,0,1073,1073,-6,-6,0,0,10
1372,jm1404,20130709,1073,1073,1068,1071,1045,1045,1059,-28,-14,12,763080,18
1373,jm1404,20130710,1045,1059,1038,1088,1038,1076,1065,17,6,52,3325200,22
1374,jm1404,20130711,1076,1065,1080,1086,1080,1086,1083,21,18,4,259920,22
1375,jm1404,20130712,1086,1083,1079,1087,1072,1072,1077,-11,-6,30,1939440,18
1376,jm1404,20130715,1072,1077,1073,1073,1064,1064,1068,-13,-9,8,513000,16
1377,jm1404,20130716,1064,1068,1056,1056,1055,1055,1055,-13,-13,4,253320,18
1378,jm1404,20130717,1055,1055,1079,1094,1068,1076,1077,21,22,98,6335040,20
1379,jm1404,20130718,1076,1077,0,0,0,1077,1077,0,0,0,0,20
1380,jm1404,20130719,1077,1077,0,0,0,1077,1077,0,0,0,0,20
1381,jm1404,20130722,1077,1077,0,0,0,1077,1077,0,0,0,0,20
1382,jm1404,20130723,1077,1077,0,0,0,1077,1077,0,0,0,0,20
1383,jm1404,20130724,1077,1077,0,0,0,1069,1069,-8,-8,0,0,20
1384,jm1404,20130725,1069,1069,1083,1095,1083,1095,1093,26,24,12,786960,22
1385,jm1404,20130726,1095,1093,1086,1086,1086,1086,1086,-7,-7,2,130320,22
1386,jm1404,20130729,1086,1086,1085,1085,1077,1077,1080,-9,-6,10,648120,24
1387,jm1404,20130730,1077,1080,1067,1087,1067,1076,1080,-4,0,16,1037520,20
1388,jm1404,20130731,1076,1080,1085,1085,1085,1085,1085,5,5,2,130200,18
1389,jm1404,20130801,1085,1085,0,0,0,1085,1085,0,0,0,0,18
1390,jm1404,20130802,1085,1085,0,0,0,1085,1085,0,0,0,0,18
1391,jm1404,20130805,1085,1085,0,0,0,1085,1085,0,0,0,0,18
1392,jm1404,20130806,1085,1085,0,0,0,1085,1085,0,0,0,0,18
1393,jm1404,20130807,1085,1085,0,0,0,1081,1081,-4,-4,0,0,18
1394,jm1404,20130808,1081,1081,1113,1113,1113,1113,1113,32,32,2,133560,18
1395,jm1404,20130809,1113,1113,1157,1157,1157,1157,1157,44,44,4,277680,22
1396,jm1404,20130812,1157,1157,1183,1183,1171,1171,1177,14,20,4,282480,24
1397,jm1404,20130813,1171,1177,1179,1193,1179,1193,1183,16,6,10,709800,24
1398,jm1404,20130814,1193,1183,0,0,0,1183,1183,0,0,0,0,24
1399,jm1404,20130815,1183,1183,0,0,0,1179,1179,-4,-4,0,0,24
1400,jm1404,20130816,1179,1179,1200,1208,1196,1202,1202,23,23,28,2019600,16
1401,jm1404,20130819,1202,1202,0,0,0,1185,1185,-17,-17,0,0,16
1402,jm1404,20130820,1185,1185,0,0,0,1191,1191,6,6,0,0,16
1403,jm1404,20130821,1191,1191,1219,1219,1219,1219,1219,28,28,2,146280,18
1404,jm1404,20130822,1219,1219,1219,1219,1186,1211,1194,-8,-25,210,15049200,170
1405,jm1404,20130823,1211,1194,1214,1232,1209,1228,1222,34,28,96,7042920,170
1406,jm1404,20130826,1228,1222,1235,1236,1230,1230,1233,8,11,12,888240,170
1407,jm1404,20130827,1230,1233,1226,1226,1224,1224,1225,-9,-8,6,441120,170
1408,jm1404,20130828,1224,1225,1210,1218,1180,1180,1194,-45,-31,316,22644720,46
1409,jm1404,20130829,1180,1194,1181,1190,1168,1185,1184,-9,-10,56,3978480,30
1410,jm1404,20130830,1185,1184,1185,1187,1180,1180,1185,-4,1,20,1422000,14
1411,jm1404,20130902,1180,1185,1180,1203,1180,1203,1191,18,6,4,285960,16
1412,jm1404,20130903,1203,1191,1211,1211,1211,1211,1211,20,20,2,145320,14
1413,jm1404,20130904,1211,1211,1227,1227,1200,1210,1214,-1,3,10,728760,10
1414,jm1404,20130905,1210,1214,0,0,0,1214,1214,0,0,0,0,10
1415,jm1404,20130906,1214,1214,1214,1214,1205,1205,1209,-9,-5,4,290280,8
1416,jm1404,20130909,1205,1209,0,0,0,1209,1209,0,0,0,0,8
1417,jm1404,20130910,1209,1209,0,0,0,1209,1209,0,0,0,0,8
1418,jm1404,20130911,1209,1209,0,0,0,1196,1196,-13,-13,0,0,8
1419,jm1404,20130912,1196,1196,0,0,0,1196,1196,0,0,0,0,8
1420,jm1404,20130913,1196,1196,1200,1200,1190,1193,1194,-3,-2,6,429960,6
1421,jm1404,20130916,1193,1194,1183,1193,1180,1193,1187,-1,-7,8,569880,6
1422,jm1404,20130917,1193,1187,1191,1191,1191,1191,1191,4,4,2,142920,6
1423,jm1404,20130918,1191,1191,0,0,0,1175,1175,-16,-16,0,0,6
1424,jm1404,20130923,1175,1175,1208,1208,1206,1206,1207,31,32,6,434520,8
1425,jm1404,20130924,1206,1207,1207,1207,1204,1204,1205,-3,-2,4,289320,10
1426,jm1404,20130925,1204,1205,1206,1228,1204,1214,1211,9,6,18,1308840,16
1427,jm1404,20130926,1214,1211,1210,1211,1210,1211,1210,0,-1,4,290520,14
1428,jm1404,20130927,1211,1210,1203,1203,1198,1198,1200,-12,-10,4,288120,14
1429,jm1404,20130930,1198,1200,1198,1198,1191,1191,1193,-9,-7,6,429720,12
1430,jm1404,20131008,1191,1193,1182,1182,1182,1182,1182,-11,-11,4,283680,10
1431,jm1404,20131009,1182,1182,0,0,0,1189,1189,7,7,0,0,10
1432,jm1404,20131010,1189,1189,0,0,0,1184,1184,-5,-5,0,0,10
1433,jm1404,20131011,1184,1184,0,0,0,1183,1183,-1,-1,0,0,10
1434,jm1404,20131014,1183,1183,0,0,0,1192,1192,9,9,0,0,10
1435,jm1404,20131015,1192,1192,0,0,0,1197,1197,5,5,0,0,10
1436,jm1404,20131016,1197,1197,0,0,0,1197,1197,0,0,0,0,10
1437,jm1404,20131017,1197,1197,0,0,0,1197,1197,0,0,0,0,10
1438,jm1404,20131018,1197,1197,0,0,0,1197,1197,0,0,0,0,10
1439,jm1404,20131021,1197,1197,0,0,0,1197,1197,0,0,0,0,10
1440,jm1404,20131022,1197,1197,0,0,0,1197,1197,0,0,0,0,10
1441,jm1404,20131023,1197,1197,0,0,0,1190,1190,-7,-7,0,0,10
1442,jm1404,20131024,1190,1190,1143,1145,1143,1145,1144,-45,-46,22,1510320,6
1443,jm1404,20131025,1145,1144,0,0,0,1147,1147,3,3,0,0,6
1444,jm1404,20131028,1147,1147,1133,1143,1133,1140,1138,-7,-9,14,955920,6
1445,jm1404,20131029,1140,1138,1122,1127,1109,1124,1120,-14,-18,26,1747200,8
1446,jm1404,20131030,1124,1120,1130,1130,1130,1130,1130,10,10,4,271200,8
1447,jm1404,20131031,1130,1130,1138,1138,1136,1136,1137,6,7,6,409440,4
1448,jm1404,20131101,1136,1137,1136,1136,1127,1127,1130,-10,-7,18,1220640,4
1449,jm1404,20131104,1127,1130,0,0,0,1124,1124,-6,-6,0,0,4
1450,jm1404,20131105,1124,1124,1110,1116,1104,1108,1109,-16,-15,8,532560,8
1451,jm1404,20131106,1108,1109,1106,1106,1104,1105,1105,-4,-4,8,530400,10
1452,jm1404,20131107,1105,1105,1108,1108,1108,1108,1108,3,3,4,265920,8
1453,jm1404,20131108,1108,1108,1113,1113,1113,1113,1113,5,5,2,133560,10
1454,jm1404,20131111,1113,1113,0,0,0,1105,1105,-8,-8,0,0,10
1455,jm1404,20131112,1105,1105,1104,1104,1098,1098,1101,-7,-4,4,264240,10
1456,jm1404,20131113,1098,1101,1105,1121,1104,1104,1110,3,9,6,399600,10
1457,jm1404,20131114,1104,1110,1125,1125,1107,1116,1113,6,3,16,1069320,8
1458,jm1404,20131115,1116,1113,0,0,0,1128,1128,15,15,0,0,8
1459,jm1404,20131118,1128,1128,0,0,0,1126,1126,-2,-2,0,0,8
1460,jm1404,20131119,1126,1126,1103,1113,1103,1113,1108,-13,-18,8,532200,10
1461,jm1404,20131120,1113,1108,1113,1113,1113,1113,1113,5,5,2,133560,10
1462,jm1404,20131121,1113,1113,0,0,0,1104,1104,-9,-9,0,0,10
1463,jm1404,20131122,1104,1104,0,0,0,1100,1100,-4,-4,0,0,10
1464,jm1404,20131125,1100,1100,1111,1111,1111,1111,1111,11,11,2,133320,12
1465,jm1404,20131126,1111,1111,1109,1109,1108,1108,1108,-3,-3,4,266040,12
1466,jm1404,20131127,1108,1108,1100,1110,1094,1094,1103,-14,-5,22,1456080,10
1467,jm1404,20131128,1094,1103,0,0,0,1113,1113,10,10,0,0,10
1468,jm1404,20131129,1113,1113,1106,1106,1100,1100,1104,-13,-9,6,397440,8
1469,jm1404,20131202,1100,1104,0,0,0,1104,1104,0,0,0,0,8
1470,jm1404,20131203,1104,1104,1108,1108,1098,1099,1101,-5,-3,6,396600,8
1471,jm1404,20131204,1099,1101,0,0,0,1114,1114,13,13,0,0,8
1472,jm1404,20131205,1114,1114,1111,1111,1111,1111,1111,-3,-3,2,133320,6
1473,jm1404,20131206,1111,1111,1096,1096,1096,1096,1096,-15,-15,2,131520,6
1474,jm1404,20131209,1096,1096,1097,1103,1097,1101,1100,5,4,12,792120,10
1475,jm1404,20131210,1101,1100,0,0,0,1100,1100,0,0,0,0,10
1476,jm1404,20131211,1100,1100,1092,1096,1089,1089,1092,-11,-8,12,786360,8
1477,jm1404,20131212,1089,1092,1098,1098,1089,1092,1093,0,1,6,393480,8
1478,jm1404,20131213,1092,1093,1068,1068,1053,1064,1060,-29,-33,26,1653960,6
1479,jm1404,20131216,1064,1060,0,0,0,1060,1060,0,0,0,0,6
1480,jm1404,20131217,1060,1060,0,0,0,1060,1060,0,0,0,0,6
1481,jm1404,20131218,1060,1060,1067,1067,1067,1067,1067,7,7,2,128040,6
1482,jm1404,20131219,1067,1067,1067,1067,1054,1055,1058,-12,-9,6,381120,6
1483,jm1404,20131220,1055,1058,0,0,0,1041,1041,-17,-17,0,0,6
1484,jm1404,20131223,1041,1041,0,0,0,1036,1036,-5,-5,0,0,6
1485,jm1404,20131224,1036,1036,0,0,0,1036,1036,0,0,0,0,6
1486,jm1404,20131225,1036,1036,1044,1045,1031,1031,1039,-5,3,54,3366600,6
1487,jm1404,20131226,1031,1039,1038,1038,1032,1035,1034,-4,-5,24,1490280,6
1488,jm1404,20131227,1035,1034,0,0,0,1028,1028,-6,-6,0,0,6
1489,jm1404,20131230,1028,1028,0,0,0,1015,1015,-13,-13,0,0,6
1490,jm1404,20131231,1015,1015,1013,1013,1013,1013,1013,-2,-2,2,121560,8
1491,jm1405,20130517,1245,1241,1260,1267,1260,1267,1263,26,22,4,303240,6
1492,jm1405,20130520,1267,1263,1268,1269,1268,1269,1268,6,5,4,304440,10
1493,jm1405,20130521,1269,1268,1266,1275,1260,1268,1265,0,-3,20,1518960,20
1494,jm1405,20130522,1268,1265,1270,1280,1270,1280,1273,15,8,10,764040,26
1495,jm1405,20130523,1280,1273,1272,1272,1260,1260,1266,-13,-7,16,1215360,32
1496,jm1405,20130524,1260,1266,1264,1264,1264,1264,1264,-2,-2,2,151680,32
1497,jm1405,20130527,1264,1264,1253,1255,1245,1245,1250,-19,-14,12,900480,30
1498,jm1405,20130528,1245,1250,1243,1243,1230,1235,1235,-15,-15,30,2224560,34
1499,jm1405,20130529,1235,1235,1231,1231,1209,1216,1218,-19,-17,10,731160,36
1500,jm1405,20130530,1216,1218,1210,1210,1203,1210,1207,-8,-11,18,1304040,44
1501,jm1405,20130531,1210,1207,1200,1201,1185,1191,1194,-16,-13,16,1146600,50
1502,jm1405,20130603,1191,1194,1199,1200,1190,1200,1196,6,2,18,1291680,60
1503,jm1405,20130604,1200,1196,1200,1207,1196,1207,1199,11,3,28,2015640,66
1504,jm1405,20130605,1207,1199,1201,1223,1200,1215,1212,16,13,54,3928080,82
1505,jm1405,20130606,1215,1212,1195,1195,1164,1164,1179,-48,-33,32,2264520,86
1506,jm1405,20130607,1164,1179,1169,1175,1157,1169,1163,-10,-16,72,5025120,58
1507,jm1405,20130613,1169,1163,1116,1154,1116,1154,1148,-9,-15,28,1929600,66
1508,jm1405,20130614,1154,1148,1149,1152,1146,1152,1149,4,1,6,413640,70
1509,jm1405,20130617,1152,1149,1163,1176,1158,1160,1164,11,15,70,4889280,118
1510,jm1405,20130618,1160,1164,1162,1166,1154,1159,1160,-5,-4,26,1810200,120
1511,jm1405,20130619,1159,1160,1155,1160,1150,1160,1155,0,-5,46,3188880,124
1512,jm1405,20130620,1160,1155,1147,1147,1112,1118,1133,-37,-22,124,8436240,132
1513,jm1405,20130621,1118,1133,1100,1131,1100,1127,1118,-6,-15,80,5369160,136
1514,jm1405,20130624,1127,1118,1123,1141,1104,1106,1123,-12,5,208,14020920,150
1515,jm1405,20130625,1106,1123,1124,1128,1110,1124,1119,1,-4,86,5776560,172
1516,jm1405,20130626,1124,1119,1124,1125,1095,1106,1104,-13,-15,138,9144720,222
1517,jm1405,20130627,1106,1104,1108,1113,1095,1111,1104,7,0,80,5303520,228
1518,jm1405,20130628,1111,1104,1110,1112,1100,1103,1108,-1,4,76,5052840,236
1519,jm1405,20130701,1103,1108,1108,1108,1082,1092,1094,-16,-14,172,11290800,288
1520,jm1405,20130702,1092,1094,1093,1096,1078,1085,1085,-9,-9,140,9116640,354
1521,jm1405,20130703,1085,1085,1079,1084,1074,1080,1078,-5,-7,136,8800200,362
1522,jm1405,20130704,1080,1078,1076,1092,1074,1090,1085,12,7,236,15365880,474
1523,jm1405,20130705,1090,1085,1089,1096,1087,1088,1090,3,5,92,6017520,486
1524,jm1405,20130708,1088,1090,1084,1084,1071,1076,1076,-14,-14,172,11106960,504
1525,jm1405,20130709,1076,1076,1075,1079,1066,1068,1074,-8,-2,142,9154320,504
1526,jm1405,20130710,1068,1074,1060,1106,1058,1101,1085,27,11,760,49502040,712
1527,jm1405,20130711,1101,1085,1106,1124,1100,1102,1110,17,25,512,34104120,702
1528,jm1405,20130712,1102,1110,1100,1108,1092,1092,1099,-18,-11,280,18472800,858
1529,jm1405,20130715,1092,1099,1093,1097,1082,1083,1089,-16,-10,120,7841880,850
1530,jm1405,20130716,1083,1089,1080,1086,1076,1083,1083,-6,-6,166,10794120,950
1531,jm1405,20130717,1083,1083,1086,1106,1085,1102,1098,19,15,434,28617240,1034
1532,jm1405,20130718,1102,1098,1100,1108,1095,1105,1100,7,2,300,19809840,1100
1533,jm1405,20130719,1105,1100,1112,1119,1109,1112,1114,12,14,222,14844120,1046
1534,jm1405,20130722,1112,1114,1116,1125,1107,1117,1120,3,6,822,55246680,1116
1535,jm1405,20130723,1117,1120,1119,1123,1115,1123,1119,3,-1,492,33054960,1138
1536,jm1405,20130724,1123,1119,1124,1129,1109,1116,1116,-3,-3,380,25447200,1178
1537,jm1405,20130725,1116,1116,1112,1121,1108,1114,1112,-2,-4,180,12019440,1224
1538,jm1405,20130726,1114,1112,1114,1114,1105,1106,1109,-6,-3,270,17981760,1148
1539,jm1405,20130729,1106,1109,1097,1104,1090,1091,1097,-18,-12,240,15799200,1122
1540,jm1405,20130730,1091,1097,1091,1097,1087,1091,1091,-6,-6,152,9952080,1120
1541,jm1405,20130731,1091,1091,1091,1101,1091,1101,1096,10,5,96,6317400,1136
1542,jm1405,20130801,1101,1096,1102,1113,1102,1112,1109,16,13,248,16511880,1180
1543,jm1405,20130802,1112,1109,1112,1119,1112,1118,1116,9,7,136,9108240,1166
1544,jm1405,20130805,1118,1116,1117,1130,1117,1130,1126,14,10,194,13110840,1268
1545,jm1405,20130806,1130,1126,1127,1128,1121,1126,1124,0,-2,526,35495640,1286
1546,jm1405,20130807,1126,1124,1126,1130,1122,1129,1127,5,3,206,13939560,1354
1547,jm1405,20130808,1129,1127,1138,1164,1138,1160,1152,33,25,934,64591080,1244
1548,jm1405,20130809,1160,1152,1161,1186,1158,1186,1168,34,16,1220,85563720,1568
1549,jm1405,20130812,1186,1168,1186,1214,1186,1214,1207,46,39,3346,242409480,3358
1550,jm1405,20130813,1214,1207,1223,1241,1213,1234,1223,27,16,3606,264789480,3426
1551,jm1405,20130814,1234,1223,1230,1244,1216,1224,1228,1,5,7472,550732320,5926
1552,jm1405,20130815,1224,1228,1238,1248,1223,1229,1234,1,6,6712,497239560,6362
1553,jm1405,20130816,1229,1234,1232,1235,1213,1218,1222,-16,-12,4550,333630120,6330
1554,jm1405,20130819,1218,1222,1220,1245,1215,1230,1234,8,12,4500,333427440,6668
1555,jm1405,20130820,1230,1234,1228,1242,1218,1233,1232,-1,-2,9244,683517240,11526
1556,jm1405,20130821,1233,1232,1233,1242,1225,1236,1232,4,0,8036,594431760,15178
1557,jm1405,20130822,1236,1232,1232,1248,1228,1236,1239,4,7,8864,659272080,15562
1558,jm1405,20130823,1236,1239,1238,1275,1238,1266,1261,27,22,27164,2056830480,21540
1559,jm1405,20130826,1266,1261,1285,1298,1269,1273,1282,12,21,22748,1750214520,24684
1560,jm1405,20130827,1273,1282,1262,1271,1253,1258,1261,-24,-21,14826,1122358320,24158
1561,jm1405,20130828,1258,1261,1250,1264,1211,1211,1246,-50,-15,18252,1364999520,23342
1562,jm1405,20130829,1211,1246,1202,1218,1192,1208,1209,-38,-37,18408,1335606600,22420
1563,jm1405,20130830,1208,1209,1208,1216,1201,1210,1208,1,-1,14428,1046055000,24688
1564,jm1405,20130902,1210,1208,1215,1249,1215,1245,1232,37,24,16104,1190496480,27184
1565,jm1405,20130903,1245,1232,1250,1252,1227,1238,1240,6,8,13994,1041240960,28104
1566,jm1405,20130904,1238,1240,1241,1247,1226,1233,1234,-7,-6,10310,763916280,29458
1567,jm1405,20130905,1233,1234,1233,1243,1228,1241,1237,7,3,11086,823060200,29478
1568,jm1405,20130906,1241,1237,1244,1247,1226,1231,1234,-6,-3,10330,765389520,27380
1569,jm1405,20130909,1231,1234,1233,1247,1233,1247,1243,13,9,13578,1013193000,26378
1570,jm1405,20130910,1247,1243,1243,1247,1228,1238,1235,-5,-8,13990,1036806000,26216
1571,jm1405,20130911,1238,1235,1237,1241,1230,1239,1235,4,0,9612,712404720,28078
1572,jm1405,20130912,1239,1235,1237,1239,1223,1224,1229,-11,-6,14000,1033178760,29402
1573,jm1405,20130913,1224,1229,1221,1225,1207,1209,1216,-20,-13,12976,947006640,29354
1574,jm1405,20130916,1209,1216,1212,1220,1202,1205,1209,-11,-7,16062,1165731480,31888
1575,jm1405,20130917,1205,1209,1205,1215,1193,1214,1205,5,-4,22182,1604398680,33814
1576,jm1405,20130918,1214,1205,1212,1232,1208,1231,1218,26,13,13988,1022630880,34394
1577,jm1405,20130923,1231,1218,1227,1245,1219,1244,1234,26,16,18350,1359206280,38100
1578,jm1405,20130924,1244,1234,1245,1250,1230,1235,1239,1,5,18280,1359171240,39826
1579,jm1405,20130925,1235,1239,1235,1246,1231,1244,1238,5,-1,22300,1657348560,44278
1580,jm1405,20130926,1244,1238,1245,1246,1236,1238,1240,0,2,14276,1062182640,44244
1581,jm1405,20130927,1238,1240,1239,1239,1216,1219,1229,-21,-11,19818,1462129920,41328
1582,jm1405,20130930,1219,1229,1218,1228,1209,1215,1216,-14,-13,22740,1659149640,45580
1583,jm1405,20131008,1215,1216,1213,1219,1193,1215,1202,-1,-14,24814,1790806560,51358
1584,jm1405,20131009,1215,1202,1215,1217,1205,1208,1212,6,10,23760,1727946480,57182
1585,jm1405,20131010,1208,1212,1202,1214,1198,1208,1206,-4,-6,32456,2348761560,62666
1586,jm1405,20131011,1208,1206,1210,1219,1200,1202,1209,-4,3,21950,1593000840,65088
1587,jm1405,20131014,1202,1209,1204,1242,1202,1235,1226,26,17,45302,3334173240,72586
1588,jm1405,20131015,1235,1226,1266,1266,1222,1225,1236,-1,10,63158,4684660440,81134
1589,jm1405,20131016,1225,1236,1228,1228,1213,1216,1219,-20,-17,48328,3536906400,78812
1590,jm1405,20131017,1216,1219,1221,1227,1205,1209,1214,-10,-5,64366,4688800200,89420
1591,jm1405,20131018,1209,1214,1209,1216,1201,1205,1207,-9,-7,52022,3770154600,94922
1592,jm1405,20131021,1205,1207,1203,1225,1194,1224,1211,17,4,113894,8279637720,121424
1593,jm1405,20131022,1224,1211,1222,1223,1189,1200,1202,-11,-9,181224,13073068440,157528
1594,jm1405,20131023,1200,1202,1202,1204,1177,1186,1186,-16,-16,246108,17521831920,197064
1595,jm1405,20131024,1186,1186,1181,1183,1150,1159,1161,-27,-25,337180,23504147280,209702
1596,jm1405,20131025,1159,1161,1157,1168,1147,1150,1157,-11,-4,248484,17255811240,211122
1597,jm1405,20131028,1150,1157,1154,1168,1149,1158,1155,1,-2,186766,12949588560,206474
1598,jm1405,20131029,1158,1155,1159,1161,1137,1153,1147,-2,-8,376316,25907707440,198252
1599,jm1405,20131030,1153,1147,1156,1162,1148,1157,1155,10,8,212152,14706684960,198486
1600,jm1405,20131031,1157,1155,1155,1164,1143,1144,1151,-11,-4,322486,22287696960,203546
1601,jm1405,20131101,1144,1151,1142,1158,1142,1153,1151,2,0,280356,19369947960,216548
1602,jm1405,20131104,1153,1151,1153,1157,1127,1129,1135,-22,-16,412232,28092442200,280612
1603,jm1405,20131105,1129,1135,1126,1132,1115,1122,1122,-13,-13,335748,22608209760,285762
1604,jm1405,20131106,1122,1122,1121,1133,1120,1123,1126,1,4,270378,18279363240,263400
1605,jm1405,20131107,1123,1126,1124,1135,1115,1130,1127,4,1,300690,20342841480,233320
1606,jm1405,20131108,1130,1127,1130,1137,1113,1114,1127,-13,0,329998,22315222560,247960
1607,jm1405,20131111,1114,1127,1116,1120,1110,1116,1115,-11,-12,164496,11012900280,250708
1608,jm1405,20131112,1116,1115,1115,1125,1112,1122,1119,7,4,192390,12920619960,248752
1609,jm1405,20131113,1122,1119,1120,1129,1117,1123,1123,4,4,204766,13797667920,259844
1610,jm1405,20131114,1123,1123,1124,1133,1119,1125,1125,2,2,190154,12841012560,273224
1611,jm1405,20131115,1125,1125,1121,1128,1116,1117,1121,-8,-4,203624,13697506920,302470
1612,jm1405,20131118,1117,1121,1117,1121,1113,1116,1117,-5,-4,158016,10595190360,312566
1613,jm1405,20131119,1116,1117,1114,1127,1114,1126,1119,9,2,141760,9524545800,311508
1614,jm1405,20131120,1126,1119,1126,1141,1126,1139,1133,20,14,307588,20915643120,321714
1615,jm1405,20131121,1139,1133,1137,1139,1122,1122,1128,-11,-5,234756,15894170520,324636
1616,jm1405,20131122,1122,1128,1124,1129,1121,1123,1124,-5,-4,148756,10040763840,329164
1617,jm1405,20131125,1123,1124,1123,1126,1115,1119,1121,-5,-3,147080,9894247680,333238
1618,jm1405,20131126,1119,1121,1118,1128,1118,1119,1122,-2,1,219238,14771962200,347328
1619,jm1405,20131127,1119,1122,1117,1119,1101,1107,1108,-15,-14,397456,26426942400,369828
1620,jm1405,20131128,1107,1108,1106,1123,1106,1112,1116,4,8,354948,23772873960,353496
1621,jm1405,20131129,1112,1116,1112,1116,1109,1113,1112,-3,-4,168632,11261202960,358634
1622,jm1405,20131202,1113,1112,1113,1120,1113,1118,1116,6,4,148752,9963887280,354072
1623,jm1405,20131203,1118,1116,1119,1121,1110,1111,1113,-5,-3,188452,12593648520,352474
1624,jm1405,20131204,1111,1113,1111,1131,1111,1124,1122,11,9,294282,19815837120,344332
1625,jm1405,20131205,1124,1122,1127,1133,1122,1125,1128,3,6,211822,14342316120,351524
1626,jm1405,20131206,1125,1128,1125,1125,1105,1112,1114,-16,-14,296950,19863429600,319234
1627,jm1405,20131209,1112,1114,1114,1118,1105,1109,1111,-5,-3,158914,10594310160,336522
1628,jm1405,20131210,1109,1111,1111,1115,1109,1113,1111,2,0,125590,8378980440,325954
1629,jm1405,20131211,1113,1111,1113,1113,1102,1105,1107,-6,-4,171034,11364992040,354030
1630,jm1405,20131212,1105,1107,1104,1118,1101,1103,1108,-4,1,251738,16750613400,352876
1631,jm1405,20131213,1103,1108,1102,1103,1064,1076,1076,-32,-32,475064,30683163480,297632
1632,jm1405,20131216,1076,1076,1078,1083,1076,1078,1078,2,2,142854,9246317400,285790
1633,jm1405,20131217,1078,1078,1079,1082,1073,1076,1077,-2,-1,142818,9237177720,286748
1634,jm1405,20131218,1076,1077,1075,1081,1068,1076,1074,-1,-3,188196,12136064280,247966
1635,jm1405,20131219,1076,1074,1078,1082,1060,1071,1069,-3,-5,201116,12909938040,257764
1636,jm1405,20131220,1071,1069,1066,1072,1045,1047,1059,-22,-10,222986,14172227040,274392
1637,jm1405,20131223,1047,1059,1049,1049,1039,1044,1044,-15,-15,206982,12968913000,269290
1638,jm1405,20131224,1044,1044,1046,1054,1040,1049,1046,5,2,174832,10977676560,262764
1639,jm1405,20131225,1049,1046,1050,1060,1041,1047,1051,1,5,248726,15690523200,232092
1640,jm1405,20131226,1047,1051,1048,1052,1041,1045,1045,-6,-6,148420,9310600320,218150
1641,jm1405,20131227,1045,1045,1043,1046,1030,1035,1036,-10,-9,260308,16190075880,237192
1642,jm1405,20131230,1035,1036,1034,1036,1021,1022,1030,-14,-6,154418,9548875320,239044
1643,jm1405,20131231,1022,1030,1020,1023,1002,1005,1011,-25,-19,334770,20321343000,230676
1644,jm1406,20130621,1152,1152,0,0,0,1152,1152,0,0,0,0,0
1645,jm1406,20130624,1152,1152,0,0,0,1152,1152,0,0,0,0,0
1646,jm1406,20130625,1152,1152,0,0,0,1152,1152,0,0,0,0,0
1647,jm1406,20130626,1152,1152,1109,1109,1109,1109,1109,-43,-43,2,133080,2
1648,jm1406,20130627,1109,1109,0,0,0,1109,1109,0,0,0,0,2
1649,jm1406,20130628,1109,1109,0,0,0,1113,1113,4,4,0,0,2
1650,jm1406,20130701,1113,1113,0,0,0,1099,1099,-14,-14,0,0,2
1651,jm1406,20130702,1099,1099,0,0,0,1099,1099,0,0,0,0,2
1652,jm1406,20130703,1099,1099,0,0,0,1092,1092,-7,-7,0,0,2
1653,jm1406,20130704,1092,1092,1091,1091,1091,1091,1091,-1,-1,2,130920,0
1654,jm1406,20130705,1091,1091,0,0,0,1096,1096,5,5,0,0,0
1655,jm1406,20130708,1096,1096,0,0,0,1082,1082,-14,-14,0,0,0
1656,jm1406,20130709,1082,1082,0,0,0,1080,1080,-2,-2,0,0,0
1657,jm1406,20130710,1080,1080,0,0,0,1091,1091,11,11,0,0,0
1658,jm1406,20130711,1091,1091,0,0,0,1116,1116,25,25,0,0,0
1659,jm1406,20130712,1116,1116,0,0,0,1105,1105,-11,-11,0,0,0
1660,jm1406,20130715,1105,1105,0,0,0,1095,1095,-10,-10,0,0,0
1661,jm1406,20130716,1095,1095,0,0,0,1089,1089,-6,-6,0,0,0
1662,jm1406,20130717,1089,1089,0,0,0,1104,1104,15,15,0,0,0
1663,jm1406,20130718,1104,1104,0,0,0,1106,1106,2,2,0,0,0
1664,jm1406,20130719,1106,1106,0,0,0,1120,1120,14,14,0,0,0
1665,jm1406,20130722,1120,1120,0,0,0,1126,1126,6,6,0,0,0
1666,jm1406,20130723,1126,1126,0,0,0,1125,1125,-1,-1,0,0,0
1667,jm1406,20130724,1125,1125,0,0,0,1122,1122,-3,-3,0,0,0
1668,jm1406,20130725,1122,1122,0,0,0,1118,1118,-4,-4,0,0,0
1669,jm1406,20130726,1118,1118,0,0,0,1115,1115,-3,-3,0,0,0
1670,jm1406,20130729,1115,1115,0,0,0,1103,1103,-12,-12,0,0,0
1671,jm1406,20130730,1103,1103,0,0,0,1097,1097,-6,-6,0,0,0
1672,jm1406,20130731,1097,1097,0,0,0,1102,1102,5,5,0,0,0
1673,jm1406,20130801,1102,1102,0,0,0,1115,1115,13,13,0,0,0
1674,jm1406,20130802,1115,1115,0,0,0,1122,1122,7,7,0,0,0
1675,jm1406,20130805,1122,1122,0,0,0,1132,1132,10,10,0,0,0
1676,jm1406,20130806,1132,1132,0,0,0,1130,1130,-2,-2,0,0,0
1677,jm1406,20130807,1130,1130,0,0,0,1133,1133,3,3,0,0,0
1678,jm1406,20130808,1133,1133,1153,1159,1153,1159,1156,26,23,4,277440,2
1679,jm1406,20130809,1159,1156,0,0,0,1172,1172,16,16,0,0,2
1680,jm1406,20130812,1172,1172,0,0,0,1211,1211,39,39,0,0,2
1681,jm1406,20130813,1211,1211,0,0,0,1227,1227,16,16,0,0,2
1682,jm1406,20130814,1227,1227,0,0,0,1232,1232,5,5,0,0,2
1683,jm1406,20130815,1232,1232,0,0,0,1238,1238,6,6,0,0,2
1684,jm1406,20130816,1238,1238,0,0,0,1238,1238,0,0,0,0,2
1685,jm1406,20130819,1238,1238,0,0,0,1250,1250,12,12,0,0,2
1686,jm1406,20130820,1250,1250,1239,1239,1239,1239,1239,-11,-11,2,148680,4
1687,jm1406,20130821,1239,1239,0,0,0,1239,1239,0,0,0,0,4
1688,jm1406,20130822,1239,1239,0,0,0,1239,1239,0,0,0,0,4
1689,jm1406,20130823,1239,1239,0,0,0,1260,1260,21,21,0,0,4
1690,jm1406,20130826,1260,1260,1273,1273,1273,1273,1273,13,13,2,152760,4
1691,jm1406,20130827,1273,1273,1274,1274,1258,1258,1266,-15,-7,4,303840,2
1692,jm1406,20130828,1258,1266,0,0,0,1251,1251,-15,-15,0,0,2
1693,jm1406,20130829,1251,1251,1251,1251,1219,1219,1232,-32,-19,6,443520,2
1694,jm1406,20130830,1219,1232,0,0,0,1231,1231,-1,-1,0,0,2
1695,jm1406,20130902,1231,1231,0,0,0,1255,1255,24,24,0,0,2
1696,jm1406,20130903,1255,1255,0,0,0,1263,1263,8,8,0,0,2
1697,jm1406,20130904,1263,1263,0,0,0,1257,1257,-6,-6,0,0,2
1698,jm1406,20130905,1257,1257,0,0,0,1260,1260,3,3,0,0,2
1699,jm1406,20130906,1260,1260,0,0,0,1257,1257,-3,-3,0,0,2
1700,jm1406,20130909,1257,1257,0,0,0,1266,1266,9,9,0,0,2
1701,jm1406,20130910,1266,1266,0,0,0,1266,1266,0,0,0,0,2
1702,jm1406,20130911,1266,1266,0,0,0,1266,1266,0,0,0,0,2
1703,jm1406,20130912,1266,1266,0,0,0,1260,1260,-6,-6,0,0,2
1704,jm1406,20130913,1260,1260,0,0,0,1247,1247,-13,-13,0,0,2
1705,jm1406,20130916,1247,1247,0,0,0,1240,1240,-7,-7,0,0,2
1706,jm1406,20130917,1240,1240,0,0,0,1236,1236,-4,-4,0,0,2
1707,jm1406,20130918,1236,1236,0,0,0,1249,1249,13,13,0,0,2
1708,jm1406,20130923,1249,1249,0,0,0,1265,1265,16,16,0,0,2
1709,jm1406,20130924,1265,1265,0,0,0,1270,1270,5,5,0,0,2
1710,jm1406,20130925,1270,1270,0,0,0,1269,1269,-1,-1,0,0,2
1711,jm1406,20130926,1269,1269,0,0,0,1269,1269,0,0,0,0,2
1712,jm1406,20130927,1269,1269,1237,1237,1237,1237,1237,-32,-32,2,148440,4
1713,jm1406,20130930,1237,1237,1231,1231,1231,1231,1231,-6,-6,2,147720,4
1714,jm1406,20131008,1231,1231,0,0,0,1217,1217,-14,-14,0,0,4
1715,jm1406,20131009,1217,1217,1217,1225,1217,1225,1221,8,4,4,293040,4
1716,jm1406,20131010,1225,1221,1216,1216,1216,1216,1216,-5,-5,2,145920,4
1717,jm1406,20131011,1216,1216,0,0,0,1219,1219,3,3,0,0,4
1718,jm1406,20131014,1219,1219,0,0,0,1236,1236,17,17,0,0,4
1719,jm1406,20131015,1236,1236,0,0,0,1246,1246,10,10,0,0,4
1720,jm1406,20131016,1246,1246,0,0,0,1246,1246,0,0,0,0,4
1721,jm1406,20131017,1246,1246,1225,1225,1225,1225,1225,-21,-21,2,147000,2
1722,jm1406,20131018,1225,1225,0,0,0,1218,1218,-7,-7,0,0,2
1723,jm1406,20131021,1218,1218,1218,1223,1214,1223,1218,5,0,14,1023840,8
1724,jm1406,20131022,1223,1218,0,0,0,1209,1209,-9,-9,0,0,8
1725,jm1406,20131023,1209,1209,1192,1192,1192,1192,1192,-17,-17,4,286080,8
1726,jm1406,20131024,1192,1192,1183,1205,1167,1167,1182,-25,-10,16,1134720,4
1727,jm1406,20131025,1167,1182,1173,1173,1173,1173,1173,-9,-9,2,140760,4
1728,jm1406,20131028,1173,1173,0,0,0,1171,1171,-2,-2,0,0,4
1729,jm1406,20131029,1171,1171,0,0,0,1163,1163,-8,-8,0,0,4
1730,jm1406,20131030,1163,1163,1162,1165,1161,1165,1162,2,-1,6,418560,10
1731,jm1406,20131031,1165,1162,1164,1164,1160,1160,1162,-2,0,4,278880,6
1732,jm1406,20131101,1160,1162,0,0,0,1162,1162,0,0,0,0,6
1733,jm1406,20131104,1162,1162,1153,1153,1153,1153,1153,-9,-9,2,138360,6
1734,jm1406,20131105,1153,1153,0,0,0,1140,1140,-13,-13,0,0,6
1735,jm1406,20131106,1140,1140,0,0,0,1140,1140,0,0,0,0,6
1736,jm1406,20131107,1140,1140,0,0,0,1140,1140,0,0,0,0,6
1737,jm1406,20131108,1140,1140,0,0,0,1140,1140,0,0,0,0,6
1738,jm1406,20131111,1140,1140,0,0,0,1128,1128,-12,-12,0,0,6
1739,jm1406,20131112,1128,1128,1143,1143,1132,1132,1139,4,11,6,410160,8
1740,jm1406,20131113,1132,1139,1138,1138,1138,1138,1138,-1,-1,2,136560,6
1741,jm1406,20131114,1138,1138,1139,1139,1139,1139,1139,1,1,2,136680,6
1742,jm1406,20131115,1139,1139,0,0,0,1135,1135,-4,-4,0,0,6
1743,jm1406,20131118,1135,1135,1120,1125,1120,1123,1122,-12,-13,8,538800,6
1744,jm1406,20131119,1123,1122,0,0,0,1124,1124,2,2,0,0,6
1745,jm1406,20131120,1124,1124,0,0,0,1138,1138,14,14,0,0,6
1746,jm1406,20131121,1138,1138,0,0,0,1133,1133,-5,-5,0,0,6
1747,jm1406,20131122,1133,1133,1125,1138,1121,1128,1130,-5,-3,54,3662280,6
1748,jm1406,20131125,1128,1130,0,0,0,1127,1127,-3,-3,0,0,6
1749,jm1406,20131126,1127,1127,1135,1141,1127,1141,1134,14,7,6,408360,4
1750,jm1406,20131127,1141,1134,1110,1110,1107,1107,1109,-27,-25,6,399240,10
1751,jm1406,20131128,1107,1109,1126,1126,1125,1125,1125,16,16,4,270120,8
1752,jm1406,20131129,1125,1125,1134,1134,1122,1122,1125,-3,0,8,540360,8
1753,jm1406,20131202,1122,1125,1122,1122,1122,1122,1122,-3,-3,2,134640,6
1754,jm1406,20131203,1122,1122,0,0,0,1119,1119,-3,-3,0,0,6
1755,jm1406,20131204,1119,1119,1125,1128,1125,1128,1127,9,8,6,405720,6
1756,jm1406,20131205,1128,1127,1130,1137,1130,1137,1133,10,6,4,272040,6
1757,jm1406,20131206,1137,1133,1128,1128,1128,1128,1128,-5,-5,4,270720,4
1758,jm1406,20131209,1128,1128,1133,1133,1125,1125,1129,-3,1,24,1625880,4
1759,jm1406,20131210,1125,1129,1126,1129,1121,1123,1125,-6,-4,24,1620000,8
1760,jm1406,20131211,1123,1125,1115,1117,1115,1117,1116,-8,-9,4,267840,4
1761,jm1406,20131212,1117,1116,0,0,0,1116,1116,0,0,0,0,4
1762,jm1406,20131213,1116,1116,1093,1093,1090,1090,1091,-26,-25,6,393000,2
1763,jm1406,20131216,1090,1091,0,0,0,1091,1091,0,0,0,0,2
1764,jm1406,20131217,1091,1091,0,0,0,1090,1090,-1,-1,0,0,2
1765,jm1406,20131218,1090,1090,0,0,0,1090,1090,0,0,0,0,2
1766,jm1406,20131219,1090,1090,0,0,0,1086,1086,-4,-4,0,0,2
1767,jm1406,20131220,1086,1086,0,0,0,1065,1065,-21,-21,0,0,2
1768,jm1406,20131223,1065,1065,0,0,0,1065,1065,0,0,0,0,2
1769,jm1406,20131224,1065,1065,1048,1074,1039,1059,1051,-6,-14,1102,69517440,96
1770,jm1406,20131225,1059,1051,1068,1070,1058,1059,1067,8,16,110,7044120,6
1771,jm1406,20131226,1059,1067,1052,1064,1052,1064,1057,-3,-10,6,380640,4
1772,jm1406,20131227,1064,1057,1044,1051,1042,1051,1046,-6,-11,22,1381320,2
1773,jm1406,20131230,1051,1046,0,0,0,1042,1042,-4,-4,0,0,2
1774,jm1406,20131231,1042,1042,0,0,0,1023,1023,-19,-19,0,0,2
1775,jm1407,20130716,1109,1109,0,0,0,1103,1103,-6,-6,0,0,0
1776,jm1407,20130717,1103,1103,0,0,0,1103,1103,0,0,0,0,0
1777,jm1407,20130718,1103,1103,0,0,0,1103,1103,0,0,0,0,0
1778,jm1407,20130719,1103,1103,0,0,0,1103,1103,0,0,0,0,0
1779,jm1407,20130722,1103,1103,0,0,0,1108,1108,5,5,0,0,0
1780,jm1407,20130723,1108,1108,0,0,0,1108,1108,0,0,0,0,0
1781,jm1407,20130724,1108,1108,0,0,0,1106,1106,-2,-2,0,0,0
1782,jm1407,20130725,1106,1106,0,0,0,1103,1103,-3,-3,0,0,0
1783,jm1407,20130726,1103,1103,0,0,0,1101,1101,-2,-2,0,0,0
1784,jm1407,20130729,1101,1101,0,0,0,1090,1090,-11,-11,0,0,0
1785,jm1407,20130730,1090,1090,0,0,0,1085,1085,-5,-5,0,0,0
1786,jm1407,20130731,1085,1085,0,0,0,1089,1089,4,4,0,0,0
1787,jm1407,20130801,1089,1089,0,0,0,1101,1101,12,12,0,0,0
1788,jm1407,20130802,1101,1101,0,0,0,1107,1107,6,6,0,0,0
1789,jm1407,20130805,1107,1107,0,0,0,1116,1116,9,9,0,0,0
1790,jm1407,20130806,1116,1116,0,0,0,1116,1116,0,0,0,0,0
1791,jm1407,20130807,1116,1116,0,0,0,1118,1118,2,2,0,0,0
1792,jm1407,20130808,1118,1118,0,0,0,1118,1118,0,0,0,0,0
1793,jm1407,20130809,1118,1118,0,0,0,1133,1133,15,15,0,0,0
1794,jm1407,20130812,1133,1133,1221,1223,1213,1223,1220,90,87,16,1171680,14
1795,jm1407,20130813,1223,1220,1225,1245,1219,1245,1227,25,7,30,2208720,30
1796,jm1407,20130814,1245,1227,1235,1240,1227,1227,1233,0,6,12,888120,22
1797,jm1407,20130815,1227,1233,1236,1237,1236,1237,1236,4,3,4,296760,20
1798,jm1407,20130816,1237,1236,1227,1227,1218,1218,1222,-18,-14,4,293400,22
1799,jm1407,20130819,1218,1222,1254,1254,1254,1254,1254,32,32,2,150480,24
1800,jm1407,20130820,1254,1254,0,0,0,1243,1243,-11,-11,0,0,24
1801,jm1407,20130821,1243,1243,0,0,0,1243,1243,0,0,0,0,24
1802,jm1407,20130822,1243,1243,0,0,0,1243,1243,0,0,0,0,24
1803,jm1407,20130823,1243,1243,1266,1274,1257,1272,1269,29,26,14,1066080,26
1804,jm1407,20130826,1272,1269,1286,1289,1279,1279,1282,10,13,14,1077480,36
1805,jm1407,20130827,1279,1282,1275,1277,1267,1267,1271,-15,-11,12,915240,32
1806,jm1407,20130828,1267,1271,1268,1268,1229,1229,1248,-42,-23,8,599040,28
1807,jm1407,20130829,1229,1248,1222,1222,1218,1218,1220,-30,-28,8,585600,24
1808,jm1407,20130830,1218,1220,1227,1227,1221,1225,1224,5,4,6,440760,24
1809,jm1407,20130902,1225,1224,1243,1245,1243,1245,1244,21,20,4,298560,28
1810,jm1407,20130903,1245,1244,1259,1259,1259,1259,1259,15,15,4,302160,24
1811,jm1407,20130904,1259,1259,1242,1242,1242,1242,1242,-17,-17,6,447120,28
1812,jm1407,20130905,1242,1242,0,0,0,1245,1245,3,3,0,0,28
1813,jm1407,20130906,1245,1245,0,0,0,1242,1242,-3,-3,0,0,28
1814,jm1407,20130909,1242,1242,0,0,0,1251,1251,9,9,0,0,28
1815,jm1407,20130910,1251,1251,0,0,0,1251,1251,0,0,0,0,28
1816,jm1407,20130911,1251,1251,0,0,0,1251,1251,0,0,0,0,28
1817,jm1407,20130912,1251,1251,0,0,0,1245,1245,-6,-6,0,0,28
1818,jm1407,20130913,1245,1245,0,0,0,1228,1228,-17,-17,0,0,28
1819,jm1407,20130916,1228,1228,1227,1227,1223,1224,1224,-4,-4,6,440880,24
1820,jm1407,20130917,1224,1224,1225,1225,1225,1225,1225,1,1,4,294000,24
1821,jm1407,20130918,1225,1225,0,0,0,1238,1238,13,13,0,0,24
1822,jm1407,20130923,1238,1238,0,0,0,1254,1254,16,16,0,0,24
1823,jm1407,20130924,1254,1254,0,0,0,1259,1259,5,5,0,0,24
1824,jm1407,20130925,1259,1259,0,0,0,1258,1258,-1,-1,0,0,24
1825,jm1407,20130926,1258,1258,0,0,0,1258,1258,0,0,0,0,24
1826,jm1407,20130927,1258,1258,0,0,0,1227,1227,-31,-31,0,0,24
1827,jm1407,20130930,1227,1227,0,0,0,1222,1222,-5,-5,0,0,24
1828,jm1407,20131008,1222,1222,1221,1226,1207,1226,1213,4,-9,40,2911440,28
1829,jm1407,20131009,1226,1213,0,0,0,1216,1216,3,3,0,0,28
1830,jm1407,20131010,1216,1216,1223,1230,1223,1230,1225,14,9,12,882120,32
1831,jm1407,20131011,1230,1225,1245,1245,1245,1245,1245,20,20,2,149400,32
1832,jm1407,20131014,1245,1245,0,0,0,1262,1262,17,17,0,0,32
1833,jm1407,20131015,1262,1262,1266,1266,1266,1266,1266,4,4,2,151920,30
1834,jm1407,20131016,1266,1266,0,0,0,1266,1266,0,0,0,0,30
1835,jm1407,20131017,1266,1266,1243,1243,1243,1243,1243,-23,-23,4,298320,34
1836,jm1407,20131018,1243,1243,1237,1238,1234,1238,1236,-5,-7,20,1483440,24
1837,jm1407,20131021,1238,1236,1217,1245,1217,1235,1232,-1,-4,22,1626480,14
1838,jm1407,20131022,1235,1232,0,0,0,1223,1223,-9,-9,0,0,14
1839,jm1407,20131023,1223,1223,1203,1203,1203,1203,1203,-20,-20,2,144360,16
1840,jm1407,20131024,1203,1203,1183,1188,1182,1182,1184,-21,-19,18,1279440,6
1841,jm1407,20131025,1182,1184,1178,1183,1173,1174,1177,-10,-7,18,1271640,12
1842,jm1407,20131028,1174,1177,0,0,0,1175,1175,-2,-2,0,0,12
1843,jm1407,20131029,1175,1175,0,0,0,1167,1167,-8,-8,0,0,12
1844,jm1407,20131030,1167,1167,0,0,0,1166,1166,-1,-1,0,0,12
1845,jm1407,20131031,1166,1166,0,0,0,1166,1166,0,0,0,0,12
1846,jm1407,20131101,1166,1166,0,0,0,1166,1166,0,0,0,0,12
1847,jm1407,20131104,1166,1166,1148,1148,1148,1148,1148,-18,-18,2,137760,14
1848,jm1407,20131105,1148,1148,1140,1140,1140,1140,1140,-8,-8,2,136800,12
1849,jm1407,20131106,1140,1140,0,0,0,1140,1140,0,0,0,0,12
1850,jm1407,20131107,1140,1140,1138,1138,1138,1138,1138,-2,-2,2,136560,14
1851,jm1407,20131108,1138,1138,1145,1153,1145,1146,1148,8,10,20,1378080,14
1852,jm1407,20131111,1146,1148,0,0,0,1136,1136,-12,-12,0,0,14
1853,jm1407,20131112,1136,1136,1129,1129,1129,1129,1129,-7,-7,2,135480,14
1854,jm1407,20131113,1129,1129,1138,1138,1138,1138,1138,9,9,2,136560,14
1855,jm1407,20131114,1138,1138,0,0,0,1139,1139,1,1,0,0,14
1856,jm1407,20131115,1139,1139,1151,1151,1131,1131,1146,-8,7,10,687840,8
1857,jm1407,20131118,1131,1146,1127,1130,1127,1129,1128,-17,-18,6,406320,12
1858,jm1407,20131119,1129,1128,1130,1130,1127,1127,1128,-1,0,4,270840,10
1859,jm1407,20131120,1127,1128,1148,1148,1148,1148,1148,20,20,2,137760,12
1860,jm1407,20131121,1148,1148,0,0,0,1143,1143,-5,-5,0,0,12
1861,jm1407,20131122,1143,1143,0,0,0,1140,1140,-3,-3,0,0,12
1862,jm1407,20131125,1140,1140,0,0,0,1137,1137,-3,-3,0,0,12
1863,jm1407,20131126,1137,1137,0,0,0,1144,1144,7,7,0,0,12
1864,jm1407,20131127,1144,1144,1114,1130,1114,1130,1122,-14,-22,8,538920,16
1865,jm1407,20131128,1130,1122,0,0,0,1138,1138,16,16,0,0,16
1866,jm1407,20131129,1138,1138,0,0,0,1138,1138,0,0,0,0,16
1867,jm1407,20131202,1138,1138,1128,1128,1128,1128,1128,-10,-10,2,135360,14
1868,jm1407,20131203,1128,1128,0,0,0,1125,1125,-3,-3,0,0,14
1869,jm1407,20131204,1125,1125,1129,1129,1129,1129,1129,4,4,2,135480,14
1870,jm1407,20131205,1129,1129,1140,1140,1140,1140,1140,11,11,2,136800,12
1871,jm1407,20131206,1140,1140,1128,1129,1128,1129,1128,-11,-12,4,270840,8
1872,jm1407,20131209,1129,1128,1138,1138,1138,1138,1138,10,10,2,136560,8
1873,jm1407,20131210,1138,1138,0,0,0,1136,1136,-2,-2,0,0,8
1874,jm1407,20131211,1136,1136,0,0,0,1129,1129,-7,-7,0,0,8
1875,jm1407,20131212,1129,1129,1125,1125,1125,1125,1125,-4,-4,2,135000,10
1876,jm1407,20131213,1125,1125,1105,1109,1105,1109,1106,-16,-19,8,531000,10
1877,jm1407,20131216,1109,1106,0,0,0,1108,1108,2,2,0,0,10
1878,jm1407,20131217,1108,1108,0,0,0,1105,1105,-3,-3,0,0,10
1879,jm1407,20131218,1105,1105,0,0,0,1096,1096,-9,-9,0,0,10
1880,jm1407,20131219,1096,1096,0,0,0,1091,1091,-5,-5,0,0,10
1881,jm1407,20131220,1091,1091,1087,1088,1087,1088,1087,-3,-4,4,261000,12
1882,jm1407,20131223,1088,1087,0,0,0,1072,1072,-15,-15,0,0,12
1883,jm1407,20131224,1072,1072,1061,1061,1061,1061,1061,-11,-11,2,127320,10
1884,jm1407,20131225,1061,1061,1073,1074,1073,1074,1073,13,12,4,257640,10
1885,jm1407,20131226,1074,1073,0,0,0,1063,1063,-10,-10,0,0,10
1886,jm1407,20131227,1063,1063,0,0,0,1057,1057,-6,-6,0,0,10
1887,jm1407,20131230,1057,1057,0,0,0,1043,1043,-14,-14,0,0,10
1888,jm1407,20131231,1043,1043,0,0,0,1028,1028,-15,-15,0,0,10
1889,jm1408,20130816,1222,1222,0,0,0,1222,1222,0,0,0,0,0
1890,jm1408,20130819,1222,1222,0,0,0,1254,1254,32,32,0,0,0
1891,jm1408,20130820,1254,1254,0,0,0,1243,1243,-11,-11,0,0,0
1892,jm1408,20130821,1243,1243,0,0,0,1243,1243,0,0,0,0,0
1893,jm1408,20130822,1243,1243,0,0,0,1243,1243,0,0,0,0,0
1894,jm1408,20130823,1243,1243,0,0,0,1243,1243,0,0,0,0,0
1895,jm1408,20130826,1243,1243,0,0,0,1243,1243,0,0,0,0,0
1896,jm1408,20130827,1243,1243,1279,1284,1267,1280,1277,37,34,8,613200,2
1897,jm1408,20130828,1280,1277,0,0,0,1254,1254,-23,-23,0,0,2
1898,jm1408,20130829,1254,1254,0,0,0,1226,1226,-28,-28,0,0,2
1899,jm1408,20130830,1226,1226,1216,1216,1216,1216,1216,-10,-10,4,291840,4
1900,jm1408,20130902,1216,1216,0,0,0,1235,1235,19,19,0,0,4
1901,jm1408,20130903,1235,1235,0,0,0,1249,1249,14,14,0,0,4
1902,jm1408,20130904,1249,1249,0,0,0,1249,1249,0,0,0,0,4
1903,jm1408,20130905,1249,1249,0,0,0,1249,1249,0,0,0,0,4
1904,jm1408,20130906,1249,1249,0,0,0,1249,1249,0,0,0,0,4
1905,jm1408,20130909,1249,1249,1272,1272,1272,1272,1272,23,23,4,305280,2
1906,jm1408,20130910,1272,1272,0,0,0,1272,1272,0,0,0,0,2
1907,jm1408,20130911,1272,1272,0,0,0,1272,1272,0,0,0,0,2
1908,jm1408,20130912,1272,1272,0,0,0,1266,1266,-6,-6,0,0,2
1909,jm1408,20130913,1266,1266,0,0,0,1253,1253,-13,-13,0,0,2
1910,jm1408,20130916,1253,1253,0,0,0,1249,1249,-4,-4,0,0,2
1911,jm1408,20130917,1249,1249,0,0,0,1250,1250,1,1,0,0,2
1912,jm1408,20130918,1250,1250,1253,1253,1243,1243,1248,-7,-2,4,299520,2
1913,jm1408,20130923,1243,1248,0,0,0,1264,1264,16,16,0,0,2
1914,jm1408,20130924,1264,1264,0,0,0,1269,1269,5,5,0,0,2
1915,jm1408,20130925,1269,1269,0,0,0,1268,1268,-1,-1,0,0,2
1916,jm1408,20130926,1268,1268,0,0,0,1268,1268,0,0,0,0,2
1917,jm1408,20130927,1268,1268,0,0,0,1237,1237,-31,-31,0,0,2
1918,jm1408,20130930,1237,1237,0,0,0,1232,1232,-5,-5,0,0,2
1919,jm1408,20131008,1232,1232,0,0,0,1223,1223,-9,-9,0,0,2
1920,jm1408,20131009,1223,1223,0,0,0,1227,1227,4,4,0,0,2
1921,jm1408,20131010,1227,1227,1251,1251,1251,1251,1251,24,24,4,300240,6
1922,jm1408,20131011,1251,1251,0,0,0,1271,1271,20,20,0,0,6
1923,jm1408,20131014,1271,1271,1258,1270,1258,1270,1264,-1,-7,4,303360,8
1924,jm1408,20131015,1270,1264,0,0,0,1268,1268,4,4,0,0,8
1925,jm1408,20131016,1268,1268,1263,1263,1263,1263,1263,-5,-5,2,151560,6
1926,jm1408,20131017,1263,1263,0,0,0,1263,1263,0,0,0,0,6
1927,jm1408,20131018,1263,1263,0,0,0,1256,1256,-7,-7,0,0,6
1928,jm1408,20131021,1256,1256,1263,1263,1244,1257,1255,1,-1,8,602400,4
1929,jm1408,20131022,1257,1255,1233,1233,1233,1233,1233,-22,-22,6,443880,10
1930,jm1408,20131023,1233,1233,1216,1216,1216,1216,1216,-17,-17,2,145920,8
1931,jm1408,20131024,1216,1216,1193,1196,1193,1196,1194,-20,-22,8,573480,8
1932,jm1408,20131025,1196,1194,0,0,0,1187,1187,-7,-7,0,0,8
1933,jm1408,20131028,1187,1187,0,0,0,1185,1185,-2,-2,0,0,8
1934,jm1408,20131029,1185,1185,1183,1183,1183,1183,1183,-2,-2,4,283920,8
1935,jm1408,20131030,1183,1183,0,0,0,1182,1182,-1,-1,0,0,8
1936,jm1408,20131031,1182,1182,0,0,0,1182,1182,0,0,0,0,8
1937,jm1408,20131101,1182,1182,0,0,0,1182,1182,0,0,0,0,8
1938,jm1408,20131104,1182,1182,0,0,0,1164,1164,-18,-18,0,0,8
1939,jm1408,20131105,1164,1164,0,0,0,1156,1156,-8,-8,0,0,8
1940,jm1408,20131106,1156,1156,0,0,0,1156,1156,0,0,0,0,8
1941,jm1408,20131107,1156,1156,1147,1148,1147,1148,1147,-8,-9,4,275400,10
1942,jm1408,20131108,1148,1147,0,0,0,1157,1157,10,10,0,0,10
1943,jm1408,20131111,1157,1157,0,0,0,1145,1145,-12,-12,0,0,10
1944,jm1408,20131112,1145,1145,0,0,0,1138,1138,-7,-7,0,0,10
1945,jm1408,20131113,1138,1138,0,0,0,1147,1147,9,9,0,0,10
1946,jm1408,20131114,1147,1147,0,0,0,1148,1148,1,1,0,0,10
1947,jm1408,20131115,1148,1148,1164,1164,1164,1164,1164,16,16,2,139680,10
1948,jm1408,20131118,1164,1164,1135,1135,1135,1135,1135,-29,-29,2,136200,10
1949,jm1408,20131119,1135,1135,1145,1145,1145,1145,1145,10,10,2,137400,12
1950,jm1408,20131120,1145,1145,1146,1153,1146,1153,1149,8,4,4,275880,12
1951,jm1408,20131121,1153,1149,0,0,0,1144,1144,-5,-5,0,0,12
1952,jm1408,20131122,1144,1144,0,0,0,1141,1141,-3,-3,0,0,12
1953,jm1408,20131125,1141,1141,0,0,0,1138,1138,-3,-3,0,0,12
1954,jm1408,20131126,1138,1138,0,0,0,1145,1145,7,7,0,0,12
1955,jm1408,20131127,1145,1145,0,0,0,1123,1123,-22,-22,0,0,12
1956,jm1408,20131128,1123,1123,0,0,0,1139,1139,16,16,0,0,12
1957,jm1408,20131129,1139,1139,0,0,0,1139,1139,0,0,0,0,12
1958,jm1408,20131202,1139,1139,0,0,0,1139,1139,0,0,0,0,12
1959,jm1408,20131203,1139,1139,0,0,0,1136,1136,-3,-3,0,0,12
1960,jm1408,20131204,1136,1136,0,0,0,1140,1140,4,4,0,0,12
1961,jm1408,20131205,1140,1140,0,0,0,1151,1151,11,11,0,0,12
1962,jm1408,20131206,1151,1151,0,0,0,1139,1139,-12,-12,0,0,12
1963,jm1408,20131209,1139,1139,0,0,0,1139,1139,0,0,0,0,12
1964,jm1408,20131210,1139,1139,0,0,0,1148,1148,9,9,0,0,12
1965,jm1408,20131211,1148,1148,0,0,0,1139,1139,-9,-9,0,0,12
1966,jm1408,20131212,1139,1139,0,0,0,1139,1139,0,0,0,0,12
1967,jm1408,20131213,1139,1139,1119,1119,1119,1119,1119,-20,-20,2,134280,14
1968,jm1408,20131216,1119,1119,0,0,0,1114,1114,-5,-5,0,0,14
1969,jm1408,20131217,1114,1114,0,0,0,1111,1111,-3,-3,0,0,14
1970,jm1408,20131218,1111,1111,0,0,0,1111,1111,0,0,0,0,14
1971,jm1408,20131219,1111,1111,0,0,0,1105,1105,-6,-6,0,0,14
1972,jm1408,20131220,1105,1105,1101,1101,1101,1101,1101,-4,-4,4,264240,14
1973,jm1408,20131223,1101,1101,0,0,0,1082,1082,-19,-19,0,0,14
1974,jm1408,20131224,1082,1082,1081,1091,1071,1091,1077,9,-5,12,775560,14
1975,jm1408,20131225,1091,1077,0,0,0,1077,1077,0,0,0,0,14
1976,jm1408,20131226,1077,1077,0,0,0,1077,1077,0,0,0,0,14
1977,jm1408,20131227,1077,1077,0,0,0,1072,1072,-5,-5,0,0,14
1978,jm1408,20131230,1072,1072,0,0,0,1057,1057,-15,-15,0,0,14
1979,jm1408,20131231,1057,1057,0,0,0,1038,1038,-19,-19,0,0,14
1980,jm1409,20130917,1254,1256,1252,1262,1244,1262,1255,6,-1,342,25755000,334
1981,jm1409,20130918,1262,1255,1259,1280,1257,1280,1266,25,11,290,22030800,450
1982,jm1409,20130923,1280,1266,1275,1289,1270,1289,1283,23,17,494,38036040,758
1983,jm1409,20130924,1289,1283,1288,1293,1276,1280,1284,-3,1,224,17269200,820
1984,jm1409,20130925,1280,1284,1279,1287,1272,1285,1280,1,-4,418,32107320,1050
1985,jm1409,20130926,1285,1280,1290,1290,1276,1280,1281,0,1,432,33225840,1090
1986,jm1409,20130927,1280,1281,1279,1279,1262,1262,1272,-19,-9,152,11601720,1068
1987,jm1409,20130930,1262,1272,1260,1270,1255,1258,1258,-14,-14,316,23862840,1162
1988,jm1409,20131008,1258,1258,1260,1269,1242,1269,1250,11,-8,756,56723280,1462
1989,jm1409,20131009,1269,1250,1261,1267,1258,1262,1263,12,13,890,67452840,1916
1990,jm1409,20131010,1262,1263,1260,1276,1256,1272,1269,9,6,1852,141011400,3188
1991,jm1409,20131011,1272,1269,1276,1280,1266,1267,1270,-2,1,1074,81892800,3956
1992,jm1409,20131014,1267,1270,1267,1305,1266,1304,1290,34,20,1264,97889160,4140
1993,jm1409,20131015,1304,1290,1300,1320,1296,1301,1304,11,14,1490,116603760,4754
1994,jm1409,20131016,1301,1304,1300,1301,1287,1290,1294,-14,-10,1074,83385960,4638
1995,jm1409,20131017,1290,1294,1290,1298,1276,1281,1286,-13,-8,908,70065960,4654
1996,jm1409,20131018,1281,1286,1280,1284,1263,1267,1272,-19,-14,1466,111904800,5134
1997,jm1409,20131021,1267,1272,1265,1277,1253,1274,1268,2,-4,1290,98168040,5774
1998,jm1409,20131022,1274,1268,1274,1274,1244,1253,1258,-15,-10,1324,99990240,5706
1999,jm1409,20131023,1253,1258,1253,1255,1227,1238,1240,-20,-18,2792,207885600,6586
2000,jm1409,20131024,1238,1240,1236,1236,1199,1208,1209,-32,-31,3514,255061320,6400
2001,jm1409,20131025,1208,1209,1205,1216,1195,1198,1206,-11,-3,2022,146369640,6782
2002,jm1409,20131028,1198,1206,1196,1211,1196,1207,1202,1,-4,2310,166721760,7388
2003,jm1409,20131029,1207,1202,1206,1208,1187,1203,1197,1,-5,2464,176985600,7656
2004,jm1409,20131030,1203,1197,1204,1216,1198,1212,1208,15,11,1844,133736400,7516
2005,jm1409,20131031,1212,1208,1210,1215,1195,1201,1205,-7,-3,2294,165861480,7578
2006,jm1409,20131101,1201,1205,1202,1210,1199,1206,1205,1,0,2218,160432560,7786
2007,jm1409,20131104,1206,1205,1208,1209,1182,1186,1188,-19,-17,4196,299280840,8354
2008,jm1409,20131105,1186,1188,1184,1187,1168,1175,1175,-13,-13,4882,344287200,8558
2009,jm1409,20131106,1175,1175,1173,1183,1170,1171,1176,-4,1,3776,266557440,8800
2010,jm1409,20131107,1171,1176,1174,1180,1161,1175,1171,-1,-5,3338,234634680,8826
2011,jm1409,20131108,1175,1171,1175,1184,1158,1158,1173,-13,2,4886,344104440,9642
2012,jm1409,20131111,1158,1173,1170,1170,1154,1156,1159,-17,-14,3654,254281920,9734
2013,jm1409,20131112,1156,1159,1155,1166,1151,1164,1157,5,-2,3254,226054440,9924
2014,jm1409,20131113,1164,1157,1162,1172,1158,1169,1166,12,9,3490,244221600,9752
2015,jm1409,20131114,1169,1166,1168,1172,1163,1164,1166,-2,0,6582,460691520,10970
2016,jm1409,20131115,1164,1166,1165,1168,1150,1150,1158,-16,-8,4562,317013960,11574
2017,jm1409,20131118,1150,1158,1150,1155,1142,1144,1148,-14,-10,9836,677571720,16766
2018,jm1409,20131119,1144,1148,1140,1162,1140,1157,1152,9,4,5722,395569800,17430
2019,jm1409,20131120,1157,1152,1160,1169,1156,1169,1161,17,9,9766,680329200,22902
2020,jm1409,20131121,1169,1161,1172,1172,1154,1156,1159,-5,-2,6662,463405080,23874
2021,jm1409,20131122,1156,1159,1157,1163,1154,1155,1158,-4,-1,2810,195288120,23700
2022,jm1409,20131125,1155,1158,1157,1160,1147,1151,1153,-7,-5,2810,194511480,23954
2023,jm1409,20131126,1151,1153,1147,1163,1147,1154,1156,1,3,7288,505821960,26468
2024,jm1409,20131127,1154,1156,1153,1153,1132,1137,1139,-19,-17,9616,657696240,28352
2025,jm1409,20131128,1137,1139,1135,1155,1135,1144,1146,5,7,8408,578213520,31034
2026,jm1409,20131129,1144,1146,1146,1148,1140,1143,1143,-3,-3,5680,389598240,33180
2027,jm1409,20131202,1143,1143,1141,1151,1141,1148,1146,5,3,5460,375635640,35240
2028,jm1409,20131203,1148,1146,1149,1151,1142,1146,1145,0,-1,5458,375148080,36190
2029,jm1409,20131204,1146,1145,1144,1168,1144,1164,1158,19,13,6276,436104360,37768
2030,jm1409,20131205,1164,1158,1162,1175,1162,1168,1170,10,12,14074,988148160,42932
2031,jm1409,20131206,1168,1170,1168,1168,1152,1163,1160,-7,-10,10772,749761920,42742
2032,jm1409,20131209,1163,1160,1162,1170,1154,1157,1161,-3,1,16894,1177848120,50662
2033,jm1409,20131210,1157,1161,1157,1163,1157,1161,1159,0,-2,4470,311047560,52020
2034,jm1409,20131211,1161,1159,1162,1162,1148,1151,1153,-8,-6,7876,545255040,53920
2035,jm1409,20131212,1151,1153,1153,1162,1144,1144,1150,-9,-3,13368,923136360,57944
2036,jm1409,20131213,1144,1150,1141,1142,1107,1122,1119,-28,-31,17442,1171513200,56594
2037,jm1409,20131216,1122,1119,1116,1125,1116,1121,1120,2,1,7150,480747600,56324
2038,jm1409,20131217,1121,1120,1123,1125,1116,1118,1119,-2,-1,4608,309557760,56540
2039,jm1409,20131218,1118,1119,1119,1121,1111,1118,1116,-1,-3,11606,777174600,57214
2040,jm1409,20131219,1118,1116,1119,1124,1107,1116,1115,0,-1,7956,532468080,56608
2041,jm1409,20131220,1116,1115,1115,1120,1093,1093,1111,-22,-4,15852,1056783960,52918
2042,jm1409,20131223,1093,1111,1096,1096,1084,1085,1089,-26,-22,11198,732052200,56008
2043,jm1409,20131224,1085,1089,1087,1095,1082,1089,1087,0,-2,13318,868924920,58062
2044,jm1409,20131225,1089,1087,1090,1099,1082,1087,1089,0,2,14650,957957000,57360
2045,jm1409,20131226,1087,1089,1087,1090,1080,1084,1084,-5,-5,9212,599217120,57866
2046,jm1409,20131227,1084,1084,1084,1085,1069,1072,1074,-12,-10,16286,1049860200,61342
2047,jm1409,20131230,1072,1074,1071,1074,1060,1061,1067,-13,-7,7976,511008600,62392
2048,jm1409,20131231,1061,1067,1060,1060,1042,1044,1051,-23,-16,16892,1065846000,58752
2049,jm1410,20131023,1249,1253,1240,1241,1236,1236,1239,-17,-14,8,594840,8
2050,jm1410,20131024,1236,1239,1228,1231,1207,1207,1223,-32,-16,10,733800,4
2051,jm1410,20131025,1207,1223,0,0,0,1220,1220,-3,-3,0,0,4
2052,jm1410,20131028,1220,1220,0,0,0,1220,1220,0,0,0,0,4
2053,jm1410,20131029,1220,1220,0,0,0,1215,1215,-5,-5,0,0,4
2054,jm1410,20131030,1215,1215,1215,1224,1215,1224,1218,9,3,6,438600,8
2055,jm1410,20131031,1224,1218,0,0,0,1215,1215,-3,-3,0,0,8
2056,jm1410,20131101,1215,1215,1217,1219,1217,1219,1218,4,3,6,438600,12
2057,jm1410,20131104,1219,1218,1206,1206,1196,1196,1201,-22,-17,12,864960,12
2058,jm1410,20131105,1196,1201,0,0,0,1201,1201,0,0,0,0,12
2059,jm1410,20131106,1201,1201,0,0,0,1201,1201,0,0,0,0,12
2060,jm1410,20131107,1201,1201,0,0,0,1199,1199,-2,-2,0,0,12
2061,jm1410,20131108,1199,1199,0,0,0,1179,1179,-20,-20,0,0,12
2062,jm1410,20131111,1179,1179,1177,1177,1175,1175,1176,-4,-3,6,423480,16
2063,jm1410,20131112,1175,1176,1183,1199,1183,1199,1191,23,15,4,285840,18
2064,jm1410,20131113,1199,1191,0,0,0,1191,1191,0,0,0,0,18
2065,jm1410,20131114,1191,1191,1175,1182,1175,1182,1178,-9,-13,4,282840,18
2066,jm1410,20131115,1182,1178,1182,1182,1177,1177,1180,-1,2,6,424920,20
2067,jm1410,20131118,1177,1180,0,0,0,1180,1180,0,0,0,0,20
2068,jm1410,20131119,1180,1180,1166,1179,1163,1176,1169,-4,-11,18,1262880,24
2069,jm1410,20131120,1176,1169,1177,1180,1176,1180,1178,11,9,12,848400,24
2070,jm1410,20131121,1180,1178,0,0,0,1178,1178,0,0,0,0,24
2071,jm1410,20131122,1178,1178,0,0,0,1178,1178,0,0,0,0,24
2072,jm1410,20131125,1178,1178,0,0,0,1178,1178,0,0,0,0,24
2073,jm1410,20131126,1178,1178,0,0,0,1181,1181,3,3,0,0,24
2074,jm1410,20131127,1181,1181,1154,1154,1154,1154,1154,-27,-27,2,138480,24
2075,jm1410,20131128,1154,1154,1161,1169,1161,1169,1163,15,9,6,418920,26
2076,jm1410,20131129,1169,1163,0,0,0,1163,1163,0,0,0,0,26
2077,jm1410,20131202,1163,1163,0,0,0,1163,1163,0,0,0,0,26
2078,jm1410,20131203,1163,1163,0,0,0,1163,1163,0,0,0,0,26
2079,jm1410,20131204,1163,1163,1167,1180,1167,1177,1173,14,10,10,703920,24
2080,jm1410,20131205,1177,1173,1186,1186,1186,1186,1186,13,13,2,142320,24
2081,jm1410,20131206,1186,1186,0,0,0,1186,1186,0,0,0,0,24
2082,jm1410,20131209,1186,1186,0,0,0,1187,1187,1,1,0,0,24
2083,jm1410,20131210,1187,1187,0,0,0,1183,1183,-4,-4,0,0,24
2084,jm1410,20131211,1183,1183,0,0,0,1172,1172,-11,-11,0,0,24
2085,jm1410,20131212,1172,1172,0,0,0,1169,1169,-3,-3,0,0,24
2086,jm1410,20131213,1169,1169,1148,1148,1123,1127,1126,-42,-43,18,1216920,26
2087,jm1410,20131216,1127,1126,1138,1138,1138,1138,1138,12,12,2,136560,26
2088,jm1410,20131217,1138,1138,0,0,0,1136,1136,-2,-2,0,0,26
2089,jm1410,20131218,1136,1136,1124,1133,1120,1127,1126,-9,-10,46,3110040,22
2090,jm1410,20131219,1127,1126,1122,1122,1121,1121,1121,-5,-5,10,672960,12
2091,jm1410,20131220,1121,1121,1125,1125,1122,1122,1123,1,2,6,404400,10
2092,jm1410,20131223,1122,1123,1095,1100,1095,1100,1097,-23,-26,4,263400,10
2093,jm1410,20131224,1100,1097,1101,1101,1101,1101,1101,4,4,2,132120,12
2094,jm1410,20131225,1101,1101,1093,1093,1093,1093,1093,-8,-8,2,131160,10
2095,jm1410,20131226,1093,1093,1092,1092,1092,1092,1092,-1,-1,2,131040,8
2096,jm1410,20131227,1092,1092,0,0,0,1084,1084,-8,-8,0,0,8
2097,jm1410,20131230,1084,1084,0,0,0,1073,1073,-11,-11,0,0,8
2098,jm1410,20131231,1073,1073,0,0,0,1055,1055,-18,-18,0,0,8
2099,jm1411,20131118,1165,1165,1184,1184,1184,1184,1184,19,19,2,142080,2
2100,jm1411,20131119,1184,1184,1170,1170,1161,1161,1165,-23,-19,4,279720,4
2101,jm1411,20131120,1161,1165,1175,1178,1175,1178,1176,13,11,4,282360,4
2102,jm1411,20131121,1178,1176,0,0,0,1176,1176,0,0,0,0,4
2103,jm1411,20131122,1176,1176,1180,1183,1173,1183,1178,7,2,6,424320,4
2104,jm1411,20131125,1183,1178,0,0,0,1173,1173,-5,-5,0,0,4
2105,jm1411,20131126,1173,1173,1169,1180,1169,1180,1174,7,1,4,281880,6
2106,jm1411,20131127,1180,1174,0,0,0,1174,1174,0,0,0,0,6
2107,jm1411,20131128,1174,1174,0,0,0,1183,1183,9,9,0,0,6
2108,jm1411,20131129,1183,1183,0,0,0,1180,1180,-3,-3,0,0,6
2109,jm1411,20131202,1180,1180,0,0,0,1180,1180,0,0,0,0,6
2110,jm1411,20131203,1180,1180,0,0,0,1179,1179,-1,-1,0,0,6
2111,jm1411,20131204,1179,1179,0,0,0,1189,1189,10,10,0,0,6
2112,jm1411,20131205,1189,1189,0,0,0,1202,1202,13,13,0,0,6
2113,jm1411,20131206,1202,1202,0,0,0,1202,1202,0,0,0,0,6
2114,jm1411,20131209,1202,1202,0,0,0,1183,1183,-19,-19,0,0,6
2115,jm1411,20131210,1183,1183,0,0,0,1183,1183,0,0,0,0,6
2116,jm1411,20131211,1183,1183,0,0,0,1181,1181,-2,-2,0,0,6
2117,jm1411,20131212,1181,1181,0,0,0,1176,1176,-5,-5,0,0,6
2118,jm1411,20131213,1176,1176,1144,1144,1144,1144,1144,-32,-32,2,137280,6
2119,jm1411,20131216,1144,1144,1137,1137,1134,1135,1135,-9,-9,6,408720,4
2120,jm1411,20131217,1135,1135,0,0,0,1135,1135,0,0,0,0,4
2121,jm1411,20131218,1135,1135,1127,1133,1127,1133,1130,-2,-5,4,271200,6
2122,jm1411,20131219,1133,1130,0,0,0,1130,1130,0,0,0,0,6
2123,jm1411,20131220,1130,1130,1131,1131,1129,1129,1130,-1,0,4,271200,4
2124,jm1411,20131223,1129,1130,1105,1110,1105,1110,1107,-20,-23,4,265800,2
2125,jm1411,20131224,1110,1107,0,0,0,1107,1107,0,0,0,0,2
2126,jm1411,20131225,1107,1107,0,0,0,1107,1107,0,0,0,0,2
2127,jm1411,20131226,1107,1107,0,0,0,1107,1107,0,0,0,0,2
2128,jm1411,20131227,1107,1107,0,0,0,1102,1102,-5,-5,0,0,2
2129,jm1411,20131230,1102,1102,0,0,0,1079,1079,-23,-23,0,0,2
2130,jm1411,20131231,1079,1079,0,0,0,1068,1068,-11,-11,0,0,2
2131,jm1412,20131217,1150,1150,0,0,0,1147,1147,-3,-3,0,0,0
2132,jm1412,20131218,1147,1147,0,0,0,1146,1146,-1,-1,0,0,0
2133,jm1412,20131219,1146,1146,1135,1135,1134,1134,1134,-12,-12,4,272280,2
2134,jm1412,20131220,1134,1134,1136,1136,1136,1136,1136,2,2,2,136320,4
2135,jm1412,20131223,1136,1136,1106,1108,1105,1105,1106,-31,-30,12,796680,8
2136,jm1412,20131224,1105,1106,1112,1112,1105,1105,1108,-1,2,6,398880,10
2137,jm1412,20131225,1105,1108,1111,1112,1104,1104,1107,-4,-1,14,929880,10
2138,jm1412,20131226,1104,1107,0,0,0,1106,1106,-1,-1,0,0,10
2139,jm1412,20131227,1106,1106,0,0,0,1096,1096,-10,-10,0,0,10
2140,jm1412,20131230,1096,1096,0,0,0,1084,1084,-12,-12,0,0,10
2141,jm1412,20131231,1084,1084,0,0,0,1068,1068,-16,-16,0,0,10
