合约,日期,前收盘,前结算,开盘价,最高价,最低价,收盘价,结算价,涨跌1,涨跌2,成交量,成交金额,持仓量
ag1301,20130104,6150,6153,6002,6112,5922,5977,5967,-176,-186,6004,"53,739.86",27524
,20130107,5977,5967,6057,6172,6057,6132,6139,165,172,5784,"53,265.24",25340
,20130108,6132,6139,6160,6160,6108,6126,6127,-13,-12,4496,"41,324.69",23440
,20130109,6126,6127,6168,6187,6153,6178,6169,51,42,6024,"55,748.47",21800
,20130110,6178,6169,6163,6179,6081,6171,6154,2,-15,3448,"31,828.72",20564
,20130111,6171,6154,6246,6256,6112,6225,6244,71,90,2132,"19,968.56",19496
,20130114,6225,6244,6219,6240,6202,6240,6222,-4,-22,1900,"17,733.38",18796
,20130115,6240,6222,6280,6322,6272,6300,6293,78,71,1312,"12,384.84",19028
ag1302,20130104,6218,6208,6051,6073,5988,6030,6019,-178,-189,1196,"10,799.02",4828
,20130107,6030,6019,6125,6228,6121,6190,6193,171,174,1662,"15,441.03",5160
,20130108,6190,6193,6206,6225,6155,6166,6178,-27,-15,1194,"11,066.41",5416
,20130109,6166,6178,6209,6233,6199,6221,6213,43,35,1944,"18,119.93",6006
,20130110,6221,6213,6181,6227,6178,6227,6203,14,-10,970,"9,026.02",6088
,20130111,6227,6203,6273,6309,6260,6268,6287,65,84,2106,"19,863.45",6290
,20130114,6268,6287,6222,6282,6221,6280,6261,-7,-26,1294,"12,154.45",6698
,20130115,6280,6261,6340,6385,6308,6356,6342,95,81,1636,"15,563.50",6928
,20130116,6356,6342,6415,6417,6385,6390,6397,48,55,1310,"12,571.82",6980
,20130117,6390,6397,6312,6412,6312,6371,6379,-26,-18,1166,"11,157.85",6842
,20130118,6371,6379,6400,6462,6400,6448,6443,69,64,1470,"14,209.01",7046
,20130121,6448,6443,6477,6501,6450,6450,6481,7,38,2484,"24,151.80",7044
,20130122,6450,6481,6474,6506,6473,6495,6488,14,7,2328,"22,659.21",7680
,20130123,6495,6488,6518,6518,6485,6493,6496,5,8,1448,"14,110.93",7930
,20130124,6493,6496,6470,6470,6410,6420,6436,-76,-60,1978,"19,097.51",7778
,20130125,6420,6436,6420,6420,6360,6387,6375,-49,-61,1746,"16,697.15",8074
,20130128,6387,6375,6302,6332,6302,6331,6322,-44,-53,814,"7,719.92",8338
,20130129,6331,6322,6287,6340,6287,6337,6307,15,-15,1560,"14,759.78",8550
,20130130,6337,6307,6379,6379,6351,6351,6368,44,61,986,"9,419.26",8590
,20130131,6351,6368,6455,6480,6454,6480,6470,112,102,1764,"17,120.49",9216
,20130201,6480,6470,6341,6465,6341,6378,6380,-92,-90,872,"8,345.86",9360
,20130204,6378,6380,6408,6445,6370,6422,6415,42,35,1868,"17,975.50",8812
,20130205,6422,6415,6421,6438,6416,6430,6425,15,10,896,"8,636.48",8984
,20130206,6430,6425,6434,6434,6341,6415,6417,-10,-8,1180,"11,359.45",9012
,20130207,6415,6417,6339,6443,6339,6426,6423,9,6,1036,"9,981.94",9548
,20130208,6426,6423,6358,6370,6350,6370,6358,-53,-65,460,"4,387.07",9552
,20130218,6370,6358,6108,6108,6004,6085,6083,-273,-275,1020,"9,308.00",9540
ag1303,20130104,6268,6263,6166,6166,6051,6086,6081,-177,-182,444,"4,050.14",3642
,20130107,6086,6081,5998,6281,5998,6240,6243,159,162,344,"3,221.51",3678
,20130108,6240,6243,6250,6250,6212,6212,6232,-31,-11,128,"1,196.71",3730
,20130109,6212,6232,6269,6284,6255,6272,6264,40,32,114,"1,071.20",3718
,20130110,6272,6264,6250,6281,6230,6273,6254,9,-10,470,"4,409.51",3990
,20130111,6273,6254,6358,6358,6322,6322,6341,68,87,314,"2,987.03",4012
,20130114,6322,6341,6287,6334,6287,6334,6313,-7,-28,134,"1,268.93",4046
,20130115,6334,6313,6375,6431,6365,6411,6395,98,82,250,"2,398.29",4028
,20130116,6411,6395,6466,6486,6431,6446,6452,51,57,176,"1,703.40",3964
,20130117,6446,6452,6452,6461,6412,6434,6431,-18,-21,94,906.8,3940
,20130118,6434,6431,6490,6511,6477,6505,6491,74,60,210,"2,044.84",3750
,20130121,6505,6491,6525,6544,6513,6523,6531,32,40,652,"6,387.54",3338
,20130122,6523,6531,6531,6555,6524,6538,6534,7,3,176,"1,725.05",3332
,20130123,6538,6534,6558,6558,6537,6538,6550,4,16,170,"1,670.45",3412
,20130124,6538,6550,6483,6513,6458,6465,6487,-85,-63,490,"4,768.45",3512
,20130125,6465,6487,6422,6439,6410,6439,6421,-48,-66,268,"2,581.62",3640
,20130128,6439,6421,6354,6375,6354,6375,6367,-46,-54,66,630.37,3656
,20130129,6375,6367,6349,6381,6341,6381,6362,14,-5,178,"1,698.69",3652
,20130130,6381,6362,6416,6424,6408,6410,6413,48,51,40,384.79,3662
,20130131,6410,6413,6519,6522,6495,6522,6508,109,95,848,"8,278.46",3908
,20130201,6522,6508,6408,6422,6387,6421,6407,-87,-101,488,"4,690.26",4096
,20130204,6421,6407,6452,6489,6449,6467,6474,60,67,574,"5,574.23",4234
,20130205,6467,6474,6455,6483,6453,6468,6472,-6,-2,376,"3,650.51",4250
,20130206,6468,6472,6471,6477,6450,6450,6460,-22,-12,218,"2,112.71",4250
,20130207,6450,6460,6471,6493,6465,6465,6478,5,18,206,"2,001.80",4212
,20130208,6465,6478,6410,6433,6389,6410,6399,-68,-79,644,"6,181.56",4128
,20130218,6410,6399,6280,6280,6106,6132,6136,-267,-263,782,"7,198.08",4172
,20130219,6132,6136,6136,6148,6132,6132,6136,-4,0,1024,"9,425.48",4134
,20130220,6132,6136,6083,6092,6073,6086,6080,-50,-56,768,"7,004.58",4348
,20130221,6086,6080,5976,5976,5845,5868,5868,-212,-212,1842,"16,215.52",4928
,20130222,5868,5868,5895,5938,5883,5937,5918,69,50,946,"8,398.06",5220
,20130225,5937,5918,5912,5945,5895,5928,5928,10,10,882,"7,843.57",4978
,20130226,5928,5928,5965,5981,5919,5920,5955,-8,27,920,"8,218.43",5208
,20130227,5920,5955,5995,6007,5983,5986,5990,31,35,956,"8,590.66",5278
,20130228,5986,5990,5960,5980,5959,5980,5964,-10,-26,1304,"11,667.26",5244
,20130301,5980,5964,5942,5942,5850,5884,5869,-80,-95,2340,"20,600.80",6124
,20130304,5884,5869,5929,5960,5897,5915,5909,46,40,660,"5,850.25",6260
,20130305,5915,5909,5909,5950,5900,5950,5918,41,9,808,"7,173.22",6124
,20130306,5950,5918,5950,6010,5934,5938,5943,20,25,1716,"15,299.19",5636
,20130307,5938,5943,5947,5964,5941,5962,5951,19,8,916,"8,176.98",5880
,20130308,5962,5951,5927,5928,5908,5923,5922,-28,-29,872,"7,745.98",6152
,20130311,5923,5922,5962,5972,5950,5970,5963,48,41,832,"7,442.24",6376
,20130312,5970,5963,5964,5970,5944,5944,5950,-19,-13,1620,"14,460.77",6048
,20130313,5944,5950,5973,5974,5958,5970,5969,20,19,360,"3,223.67",6104
,20130314,5970,5969,5930,5930,5760,5887,5872,-82,-97,2000,"17,617.71",6796
,20130315,5887,5872,5884,5948,5874,5948,5904,76,32,1020,"9,033.39",6904
ag1304,20130104,6323,6340,6323,6323,6137,6137,6153,-203,-187,22,203.08,336
,20130107,6137,6153,6349,6349,6300,6303,6312,150,159,276,"2,613.22",426
,20130108,6303,6312,6289,6296,6275,6294,6285,-18,-27,132,"1,244.47",392
,20130109,6294,6285,6329,6339,6314,6324,6325,39,40,40,379.52,376
,20130110,6324,6325,,,,6325,6325,0,0,0,0,376
,20130111,6325,6325,6400,6428,6375,6375,6392,50,67,146,"1,399.88",366
,20130114,6375,6392,6349,6405,6349,6390,6367,-2,-25,46,439.34,388
,20130115,6390,6367,6420,6480,6420,6480,6436,113,69,26,251.03,388
,20130116,6480,6436,,,,6489,6489,53,53,0,0,388
,20130117,6489,6489,6504,6504,6479,6479,6491,-10,2,8,77.9,388
,20130118,6479,6491,6545,6575,6545,6569,6561,78,70,16,157.46,384
,20130121,6569,6561,6579,6593,6560,6568,6585,7,24,58,572.94,386
,20130122,6568,6585,6586,6592,6584,6592,6590,7,5,34,336.1,406
,20130123,6592,6590,6599,6599,6589,6593,6592,3,2,16,158.22,400
,20130124,6593,6592,6550,6568,6508,6523,6540,-69,-52,174,"1,707.16",452
,20130125,6523,6540,6472,6490,6471,6490,6476,-50,-64,26,252.58,468
,20130128,6490,6476,6404,6422,6404,6422,6419,-54,-57,12,115.54,468
,20130129,6422,6419,6418,6447,6400,6447,6422,28,3,44,423.88,488
,20130130,6447,6422,6460,6469,6460,6469,6463,47,41,20,193.91,494
,20130131,6469,6463,6563,6578,6561,6565,6568,102,105,100,985.31,524
,20130201,6565,6568,6437,6469,6437,6469,6451,-99,-117,96,928.99,566
,20130204,6469,6451,6520,6537,6520,6537,6529,86,78,28,274.23,570
,20130205,6537,6529,6502,6527,6502,6520,6514,-9,-15,10,97.71,568
,20130206,6520,6514,,,,6514,6514,0,0,0,0,568
,20130207,6514,6514,6524,6531,6519,6530,6528,16,14,158,"1,547.34",676
,20130208,6530,6528,6442,6446,6439,6439,6444,-89,-84,12,116,674
,20130218,6439,6444,6181,6207,6176,6179,6188,-265,-256,68,631.2,708
,20130219,6179,6188,6180,6190,6179,6189,6185,1,-3,118,"1,094.82",708
,20130220,6189,6185,6114,6127,6114,6121,6120,-64,-65,24,220.35,716
,20130221,6121,6120,5948,5948,5886,5913,5909,-207,-211,96,850.94,700
,20130222,5913,5909,5967,5978,5957,5978,5969,69,60,26,232.82,702
,20130225,5978,5969,5923,6000,5923,5975,5972,6,3,78,698.84,704
,20130226,5975,5972,6013,6024,5970,5970,6003,-2,31,28,252.15,704
,20130227,5970,6003,,,,6017,6017,14,14,0,0,704
,20130228,6017,6017,6007,6018,6007,6018,6014,1,-3,36,324.78,704
,20130301,6018,6014,5917,5917,5917,5917,5917,-97,-97,16,142.01,710
,20130304,5917,5917,5961,5964,5940,5957,5953,40,36,44,392.92,708
,20130305,5957,5953,5941,5964,5941,5964,5947,11,-6,30,267.65,708
,20130306,5964,5947,5984,5984,5980,5980,5982,33,35,14,125.63,708
,20130307,5980,5982,5982,6003,5982,6003,5998,21,16,16,143.96,692
,20130308,6003,5998,5983,5983,5954,5962,5962,-36,-36,20,178.88,686
,20130311,5962,5962,5994,6016,5994,6016,6007,54,45,18,162.19,684
,20130312,6016,6007,,,,6007,6007,0,0,0,0,684
,20130313,6007,6007,6013,6019,6000,6002,6008,-5,1,56,504.7,690
,20130314,6002,6008,5939,5939,5877,5928,5928,-80,-80,222,"1,974.08",702
,20130315,5928,5928,5928,5948,5926,5948,5930,20,2,126,"1,120.89",738
,20130318,5948,5930,5936,5964,5866,5898,5894,-32,-36,280,"2,475.62",800
,20130319,5898,5894,5929,5938,5916,5918,5929,24,35,246,"2,187.87",848
,20130320,5918,5929,5972,5972,5912,5944,5932,15,3,420,"3,737.40",908
,20130321,5944,5932,5917,5983,5917,5939,5940,7,8,244,"2,174.31",934
,20130322,5939,5940,5970,5975,5956,5956,5966,16,26,872,"7,804.64",1564
,20130325,5956,5966,5910,5932,5900,5901,5914,-65,-52,154,"1,366.34",1564
,20130326,5901,5914,5915,5916,5900,5904,5907,-10,-7,388,"3,437.97",1738
,20130327,5904,5907,5901,5901,5777,5777,5851,-130,-56,1122,"9,848.04",2308
,20130328,5777,5851,5850,5886,5843,5865,5869,14,18,876,"7,712.24",2442
,20130329,5865,5869,5753,5775,5725,5769,5756,-100,-113,532,"4,593.99",2760
,20130401,5769,5756,5764,5764,5683,5683,5728,-73,-28,664,"5,705.22",3088
,20130402,5683,5728,5740,5740,5685,5697,5715,-31,-13,568,"4,869.32",3352
,20130403,5697,5715,5532,5532,5482,5482,5503,-233,-212,272,"2,245.52",3432
,20130408,5482,5503,5550,5574,5537,5568,5551,65,48,480,"3,996.77",3572
,20130409,5568,5551,5572,5604,5570,5595,5581,44,30,600,"5,023.45",3992
,20130410,5595,5581,5678,5700,5672,5695,5685,114,104,984,"8,391.15",4400
,20130411,5695,5685,5621,5622,5600,5600,5612,-85,-73,332,"2,795.06",4648
,20130412,5600,5612,5620,5626,5606,5626,5618,14,6,720,"6,068.02",4652
,20130415,5626,5618,5280,5280,5280,5280,5280,-338,-338,4,31.68,4652
ag1305,20130104,6375,6373,6292,6292,6147,6182,6185,-191,-188,1002,"9,297.08",2178
,20130107,6182,6185,6285,6383,6280,6338,6329,153,144,1808,"17,164.63",2058
,20130108,6338,6329,6367,6371,6308,6318,6333,-11,4,954,"9,062.54",2082
,20130109,6318,6333,6376,6387,6354,6374,6375,41,42,546,"5,221.81",1924
,20130110,6374,6375,6341,6380,6332,6380,6357,5,-18,414,"3,948.30",1978
,20130111,6380,6357,6431,6498,6409,6419,6440,62,83,924,"8,926.52",1864
,20130114,6419,6440,6348,6441,6348,6439,6406,-1,-34,730,"7,015.55",1930
,20130115,6439,6406,6485,6538,6461,6495,6502,89,96,606,"5,910.38",1786
,20130116,6495,6502,6560,6570,6536,6548,6549,46,47,698,"6,857.66",1706
,20130117,6548,6549,6597,6597,6491,6531,6532,-18,-17,236,"2,312.46",1696
,20130118,6531,6532,6578,6612,6573,6610,6599,78,67,368,"3,643.07",1712
,20130121,6610,6599,6631,6644,6602,6602,6628,3,29,546,"5,429.00",1718
,20130122,6602,6628,6616,6650,6612,6642,6626,14,-2,538,"5,347.46",1586
,20130123,6642,6626,6653,6656,6631,6631,6644,5,18,230,"2,292.33",1598
,20130124,6631,6644,6610,6610,6536,6553,6573,-91,-71,448,"4,417.13",1556
,20130125,6553,6573,6478,6534,6475,6528,6509,-45,-64,318,"3,104.80",1596
,20130128,6528,6509,6443,6488,6441,6457,6454,-52,-55,430,"4,163.32",1586
,20130129,6457,6454,6427,6479,6424,6471,6446,17,-8,422,"4,080.44",1586
,20130130,6471,6446,6499,6511,6488,6497,6499,51,53,432,"4,211.72",1566
,20130131,6497,6499,6602,6621,6592,6618,6607,119,108,488,"4,836.36",1458
,20130201,6618,6607,6536,6545,6491,6516,6507,-91,-100,1064,"10,386.42",1626
,20130204,6516,6507,6555,6589,6531,6572,6564,65,57,1016,"10,003.60",1574
,20130205,6572,6564,6550,6580,6548,6562,6562,-2,-2,658,"6,477.16",1640
,20130206,6562,6562,6562,6577,6547,6557,6566,-5,4,308,"3,033.85",1552
,20130207,6557,6566,6566,6582,6556,6558,6570,-8,4,226,"2,227.51",1520
,20130208,6558,6570,6472,6523,6465,6518,6499,-52,-71,136,"1,325.90",1524
,20130218,6518,6499,6289,6289,6194,6230,6228,-269,-271,736,"6,875.72",1656
,20130219,6230,6228,6229,6245,6221,6230,6233,2,5,350,"3,272.51",1766
,20130220,6230,6233,6155,6177,6155,6161,6164,-72,-69,306,"2,829.70",1816
,20130221,6161,6164,6056,6056,5915,5947,5947,-217,-217,384,"3,425.66",1788
,20130222,5947,5947,5978,6015,5978,6011,6000,64,53,288,"2,592.26",1772
,20130225,6011,6000,5970,6029,5970,6004,6011,4,11,734,"6,618.86",1840
,20130226,6004,6011,6062,6066,6003,6008,6057,-3,46,248,"2,253.56",1844
,20130227,6008,6057,6093,6093,6065,6075,6075,18,18,186,"1,695.08",1844
,20130228,6075,6075,6046,6052,6043,6050,6048,-25,-27,126,"1,143.20",1848
,20130301,6050,6048,5988,6001,5933,5963,5959,-85,-89,206,"1,841.33",1872
,20130304,5963,5959,5963,6010,5963,5989,5987,30,28,92,826.24,1824
,20130305,5989,5987,5990,6005,5979,6005,5989,18,2,124,"1,114.08",1848
,20130306,6005,5989,6028,6051,6015,6016,6029,27,40,292,"2,640.94",1814
,20130307,6016,6029,6046,6047,6026,6037,6032,8,3,330,"2,986.30",1700
,20130308,6037,6032,6030,6030,5995,6003,6012,-29,-20,110,992.07,1660
,20130311,6003,6012,6030,6050,6030,6048,6039,36,27,208,"1,884.32",1644
,20130312,6048,6039,6040,6042,6013,6013,6029,-26,-10,220,"1,989.90",1546
,20130313,6013,6029,6051,6058,6040,6040,6049,11,20,70,635.16,1520
,20130314,6040,6049,6010,6010,5901,5969,5960,-80,-89,232,"2,074.30",1564
,20130315,5969,5960,5967,5998,5955,5989,5976,29,16,106,950.28,1542
,20130318,5989,5976,5984,5984,5900,5938,5934,-38,-42,168,"1,495.50",1542
,20130319,5938,5934,5963,5979,5960,5970,5968,36,34,22,196.97,1532
,20130320,5970,5968,5960,5987,5947,5977,5970,9,2,80,716.4,1524
,20130321,5977,5970,5943,5985,5943,5977,5963,7,-7,52,465.12,1516
,20130322,5977,5963,6009,6020,5997,5997,6007,34,44,164,"1,477.79",1510
,20130325,5997,6007,5955,5975,5942,5942,5959,-65,-48,104,929.7,1544
,20130326,5942,5959,5949,5962,5931,5936,5943,-23,-16,74,659.7,1520
,20130327,5936,5943,5940,5940,5810,5810,5881,-133,-62,242,"2,134.94",1536
,20130328,5810,5881,5870,5930,5870,5895,5907,14,26,64,567.1,1512
,20130329,5895,5907,5831,5831,5751,5795,5791,-112,-116,56,486.44,1518
,20130401,5795,5791,5794,5823,5701,5706,5760,-85,-31,440,"3,801.87",1424
,20130402,5706,5760,5757,5757,5710,5716,5727,-44,-33,92,790.42,1426
,20130403,5716,5727,5569,5569,5506,5510,5539,-217,-188,250,"2,077.14",1432
,20130408,5510,5539,5560,5612,5560,5598,5578,59,39,100,836.84,1424
,20130409,5598,5578,5584,5629,5584,5629,5601,51,23,132,"1,109.09",1422
,20130410,5629,5601,5714,5734,5697,5734,5705,133,104,202,"1,728.83",1350
,20130411,5734,5705,5650,5657,5605,5627,5630,-78,-75,174,"1,469.51",1322
,20130412,5627,5630,5641,5652,5641,5652,5643,22,13,14,118.5,1322
,20130415,5652,5643,5333,5333,5304,5304,5311,-339,-332,18,143.42,1328
,20130416,5304,5311,4833,4833,4833,4833,4833,-478,-478,40,289.98,1312
,20130417,4833,4833,4712,4860,4700,4740,4765,-93,-68,2192,"15,670.37",1626
,20130418,4740,4765,4649,4758,4502,4678,4623,-87,-142,1348,"9,349.60",1874
,20130419,4678,4623,4646,4810,4646,4763,4729,140,106,2330,"16,529.19",2698
,20130422,4763,4729,4763,4763,4706,4726,4738,-3,9,1256,"8,926.92",3020
,20130423,4726,4738,4724,4741,4537,4574,4653,-164,-85,2088,"14,575.98",3990
,20130424,4574,4653,4639,4705,4575,4688,4642,35,-11,1466,"10,208.44",4202
,20130425,4688,4642,4669,4722,4660,4683,4686,41,44,936,"6,579.30",4568
,20130426,4683,4686,4974,4992,4862,4886,4909,200,223,800,"5,891.67",4908
,20130502,4886,4909,4703,4825,4693,4724,4737,-185,-172,2556,"18,164.58",5188
,20130503,4724,4737,4755,4836,4734,4825,4794,88,57,860,"6,184.75",5588
,20130506,4825,4794,4900,4905,4818,4845,4851,51,57,624,"4,541.35",5800
,20130507,4845,4851,4793,4793,4699,4699,4742,-152,-109,920,"6,544.21",6136
,20130508,4699,4742,4756,4780,4709,4767,4756,25,14,1056,"7,534.59",6676
,20130509,4767,4756,4760,4825,4759,4808,4798,52,42,780,"5,614.32",6928
,20130510,4808,4798,4738,4808,4738,4776,4762,-22,-36,848,"6,057.61",7092
,20130513,4776,4762,4775,4779,4730,4730,4749,-32,-13,660,"4,702.28",7216
,20130514,4730,4749,4770,4770,4731,4731,4750,-18,1,144,"1,026.20",7300
,20130515,4731,4750,4651,4777,4521,4590,4640,-160,-110,424,"2,951.06",7528
ag1306,20130104,6427,6420,6306,6307,6193,6226,6231,-194,-189,258306,"2,414,276.24",214758
,20130107,6226,6231,6330,6433,6321,6392,6393,161,162,288146,"2,763,602.22",206106
,20130108,6392,6393,6418,6420,6358,6371,6382,-22,-11,195804,"1,874,639.27",207996
,20130109,6371,6382,6416,6438,6402,6429,6420,47,38,174856,"1,684,089.06",204540
,20130110,6429,6420,6398,6427,6378,6425,6403,5,-17,142480,"1,368,639.13",206606
,20130111,6425,6403,6490,6515,6458,6469,6489,66,86,208212,"2,026,662.07",207524
,20130114,6469,6489,6419,6492,6409,6479,6457,-10,-32,173020,"1,675,964.52",219970
,20130115,6479,6457,6555,6592,6506,6545,6551,88,94,264790,"2,602,163.43",222448
,20130116,6545,6551,6630,6632,6585,6599,6601,48,50,178166,"1,764,183.40",214850
,20130117,6599,6601,6612,6612,6555,6580,6580,-21,-21,150812,"1,488,589.12",205140
,20130118,6580,6580,6632,6665,6619,6663,6644,83,64,183112,"1,825,048.43",208860
,20130121,6663,6644,6681,6698,6648,6651,6677,7,33,151058,"1,512,945.83",204884
,20130122,6651,6677,6675,6707,6665,6694,6682,17,5,145342,"1,456,964.33",203428
,20130123,6694,6682,6710,6715,6675,6686,6692,4,10,93064,"934,181.21",199808
,20130124,6686,6692,6623,6655,6588,6602,6626,-90,-66,159904,"1,589,305.96",193888
,20130125,6602,6626,6538,6582,6534,6573,6554,-53,-72,122532,"1,204,704.71",189640
,20130128,6573,6554,6503,6515,6483,6503,6499,-51,-55,106206,"1,035,481.01",189740
,20130129,6503,6499,6480,6518,6466,6516,6488,17,-11,134520,"1,309,306.42",192032
,20130130,6516,6488,6530,6550,6530,6538,6541,50,53,105238,"1,032,557.99",194098
,20130131,6538,6541,6632,6669,6625,6666,6649,125,108,119448,"1,191,488.03",190944
,20130201,6666,6649,6560,6562,6530,6556,6543,-93,-106,136754,"1,342,343.87",201918
,20130204,6556,6543,6598,6633,6581,6607,6607,64,64,142104,"1,408,434.78",204394
,20130205,6607,6607,6594,6626,6583,6618,6607,11,0,119484,"1,184,259.37",200330
,20130206,6618,6607,6619,6622,6585,6597,6603,-10,-4,88676,"878,301.04",201450
,20130207,6597,6603,6611,6633,6596,6602,6615,-1,12,106976,"1,061,477.32",195180
,20130208,6602,6615,6530,6570,6500,6552,6539,-63,-76,98408,"965,319.71",195676
,20130218,6552,6539,6289,6294,6242,6270,6268,-269,-271,136064,"1,279,465.28",210238
,20130219,6270,6268,6267,6288,6260,6275,6274,7,6,93268,"877,757.32",220772
,20130220,6275,6274,6203,6222,6180,6207,6204,-67,-70,167676,"1,560,567.62",255642
,20130221,6207,6204,6088,6088,5952,5992,5996,-212,-208,260814,"2,345,935.37",265654
,20130222,5992,5996,6026,6056,6018,6046,6041,50,45,148990,"1,350,076.68",257060
,20130225,6046,6041,6019,6074,6000,6044,6043,3,2,160606,"1,455,918.95",254796
,20130226,6044,6043,6075,6108,6036,6045,6075,2,32,160482,"1,462,419.60",254654
,20130227,6045,6075,6140,6142,6096,6112,6113,37,38,140766,"1,290,831.79",246488
,20130228,6112,6113,6086,6096,6075,6080,6085,-33,-28,104102,"950,214.29",247858
,20130301,6080,6085,5999,6016,5964,5992,5991,-93,-94,134078,"1,204,989.15",256610
,20130304,5992,5991,6045,6050,6003,6028,6025,37,34,120306,"1,087,413.63",253010
,20130305,6028,6025,6024,6094,6015,6089,6044,64,19,147038,"1,333,111.65",266720
,20130306,6089,6044,6045,6093,6045,6062,6066,18,22,158216,"1,439,770.12",269176
,20130307,6062,6066,6098,6100,6058,6074,6076,8,10,134436,"1,225,296.24",256576
,20130308,6074,6076,6063,6070,6025,6044,6043,-32,-33,131012,"1,187,730.50",264348
,20130311,6044,6043,6070,6096,6058,6090,6081,47,38,132830,"1,211,648.77",252768
,20130312,6090,6081,6081,6086,6045,6045,6069,-36,-12,96506,"878,609.08",250538
,20130313,6045,6069,6100,6100,6071,6085,6085,16,16,131258,"1,198,177.55",254510
,20130314,6085,6085,6049,6049,5940,6014,5996,-71,-89,198510,"1,785,428.95",238228
,20130315,6014,5996,6014,6041,5991,6030,6015,34,19,136176,"1,228,691.00",245058
,20130318,6030,6015,6039,6040,5933,5979,5972,-36,-43,218586,"1,958,294.51",245904
,20130319,5979,5972,6010,6021,5990,6020,6007,48,35,104700,"943,401.16",233230
,20130320,6020,6007,6013,6028,5985,6019,6008,12,1,102868,"927,153.14",235130
,20130321,6019,6008,5980,6026,5971,6016,6004,8,-4,127120,"1,145,011.52",243874
,20130322,6016,6004,6057,6060,6032,6044,6044,40,40,115434,"1,046,553.53",232204
,20130325,6044,6044,5970,6012,5964,5984,5992,-60,-52,113320,"1,018,564.35",245632
,20130326,5984,5992,5985,5997,5962,5971,5982,-21,-10,105996,"951,166.70",237556
,20130327,5971,5982,5983,5987,5836,5842,5901,-140,-81,319702,"2,830,261.04",299622
,20130328,5842,5901,5917,5962,5908,5932,5937,31,36,250694,"2,232,700.96",230978
,20130329,5932,5937,5850,5870,5791,5832,5821,-105,-116,176690,"1,542,990.72",240292
,20130401,5832,5821,5831,5838,5730,5737,5784,-84,-37,201872,"1,751,640.00",245178
,20130402,5737,5784,5781,5795,5741,5764,5766,-20,-18,172648,"1,493,257.61",236768
,20130403,5764,5766,5610,5611,5538,5547,5567,-219,-199,261454,"2,183,357.68",246532
,20130408,5547,5567,5619,5640,5591,5627,5610,60,43,176572,"1,485,999.65",227208
,20130409,5627,5610,5610,5665,5609,5661,5643,51,33,162138,"1,372,506.77",228744
,20130410,5661,5643,5752,5765,5730,5765,5745,122,102,151478,"1,305,455.85",226972
,20130411,5765,5745,5664,5690,5644,5659,5666,-86,-79,158282,"1,345,341.71",219680
,20130412,5659,5666,5690,5690,5662,5672,5675,6,9,100244,"853,348.31",215596
,20130415,5672,5675,5334,5334,5334,5334,5334,-341,-341,14618,"116,958.62",210542
,20130416,5334,5334,4853,4853,4853,4853,4853,-481,-481,56066,"408,132.45",193570
,20130417,4853,4853,4840,4883,4725,4764,4812,-89,-41,612936,"4,424,496.01",183914
,20130418,4764,4812,4672,4746,4526,4710,4652,-102,-160,659300,"4,601,378.71",172780
,20130419,4710,4652,4702,4842,4686,4788,4760,136,108,477892,"3,412,801.52",158322
,20130422,4788,4760,4770,4798,4724,4735,4759,-25,-1,304622,"2,174,564.75",165912
,20130423,4735,4759,4735,4759,4551,4587,4653,-172,-106,528696,"3,690,056.33",189518
,20130424,4587,4653,4618,4722,4579,4690,4648,37,-5,496746,"3,463,446.77",162964
,20130425,4690,4648,4693,4743,4664,4693,4702,45,54,363126,"2,561,380.32",143814
,20130426,4693,4702,4943,5030,4873,4885,4937,183,235,406698,"3,012,022.10",124786
,20130502,4885,4937,4735,4763,4682,4742,4722,-195,-215,213340,"1,511,373.08",117446
,20130503,4742,4722,4760,4856,4749,4854,4812,132,90,232054,"1,675,109.28",119630
,20130506,4854,4812,4890,4964,4820,4845,4861,33,49,173466,"1,264,940.53",114024
,20130507,4845,4861,4813,4826,4705,4716,4759,-145,-102,227160,"1,621,791.26",106226
,20130508,4716,4759,4759,4803,4732,4787,4770,28,11,138318,"989,862.81",90268
,20130509,4787,4770,4770,4847,4768,4816,4817,46,47,115016,"831,216.99",85538
,20130510,4816,4817,4766,4809,4720,4809,4771,-8,-46,67776,"485,102.69",82702
,20130513,4809,4771,4777,4801,4735,4740,4761,-31,-10,85336,"609,474.25",80296
,20130514,4740,4761,4764,4784,4741,4741,4766,-20,5,57060,"407,984.43",74416
,20130515,4741,4766,4701,4715,4615,4620,4674,-146,-92,67546,"473,576.76",71586
,20130516,4620,4674,4578,4605,4551,4573,4576,-101,-98,56148,"385,469.87",69780
,20130517,4573,4576,4591,4603,4548,4549,4574,-27,-2,45662,"313,312.49",68250
,20130520,4549,4574,4383,4453,4300,4344,4367,-230,-207,78018,"511,117.86",61670
,20130521,4344,4367,4567,4605,4500,4566,4539,199,172,60770,"413,808.11",54570
,20130522,4566,4539,4553,4571,4512,4557,4537,18,-2,32900,"223,928.86",53558
,20130523,4557,4537,4480,4490,4430,4487,4457,-50,-80,37366,"249,854.18",50916
,20130524,4487,4457,4506,4540,4478,4515,4510,58,53,28966,"195,985.76",49438
,20130527,4515,4510,4490,4556,4462,4545,4526,35,16,22748,"154,456.24",46618
,20130528,4545,4526,4510,4548,4510,4519,4527,-7,1,16478,"111,908.30",43540
,20130529,4519,4527,4525,4525,4461,4461,4489,-66,-38,27846,"187,542.59",40412
,20130530,4461,4489,4485,4549,4482,4536,4517,47,28,24706,"167,399.66",35274
,20130531,4536,4517,4543,4575,4543,4561,4566,44,49,19962,"136,723.92",31622
,20130603,4561,4566,4508,4519,4292,4505,4485,-61,-81,6722,"45,224.59",29916
,20130604,4505,4485,4556,4565,4519,4519,4535,34,50,6344,"43,163.51",29324
,20130605,4519,4535,4518,4530,4491,4513,4512,-22,-23,4832,"32,708.80",27760
,20130606,4513,4512,4499,4505,4472,4475,4493,-37,-19,6340,"42,732.09",25788
,20130607,4475,4493,4528,4544,4507,4523,4532,30,39,6244,"42,449.57",23740
,20130613,4523,4532,4295,4399,4295,4385,4383,-147,-149,2588,"17,018.08",22592
,20130614,4385,4383,4370,4370,4352,4370,4364,-13,-19,2260,"14,795.98",22460
,20130617,4370,4364,4372,4400,4372,4399,4395,35,31,2840,"18,725.82",22196
ag1307,20130104,6463,6473,6279,6280,6250,6280,6265,-193,-208,150,"1,409.85",114
,20130107,6280,6265,6411,6467,6407,6435,6433,170,168,52,501.82,124
,20130108,6435,6433,6468,6468,6399,6410,6415,-23,-18,136,"1,308.78",158
,20130109,6410,6415,6470,6470,6454,6461,6463,46,48,26,252.08,168
,20130110,6461,6463,6442,6442,6437,6437,6439,-26,-24,4,38.64,168
,20130111,6437,6439,6534,6542,6529,6542,6533,103,94,24,235.2,168
,20130114,6542,6533,6283,6518,6283,6518,6470,-15,-63,20,194.13,166
,20130115,6518,6470,6581,6600,6545,6600,6586,130,116,20,197.61,172
,20130116,6600,6586,6641,6646,6637,6637,6641,51,55,14,139.47,176
,20130117,6637,6641,6627,6628,6627,6628,6627,-13,-14,6,59.65,180
,20130118,6628,6627,6672,6691,6670,6691,6680,64,53,24,240.48,174
,20130121,6691,6680,6713,6713,6711,6711,6711,31,31,8,80.54,172
,20130122,6711,6711,6737,6738,6716,6725,6728,14,17,16,161.49,176
,20130123,6725,6728,,,,6728,6728,0,0,0,0,176
,20130124,6728,6728,6680,6680,6651,6651,6664,-77,-64,12,119.97,174
,20130125,6651,6664,6556,6602,6556,6595,6591,-69,-73,18,177.96,166
,20130128,6595,6591,6534,6534,6526,6526,6530,-65,-61,4,39.18,164
,20130129,6526,6530,,,,6530,6530,0,0,0,0,164
,20130130,6530,6530,,,,6530,6530,0,0,0,0,164
,20130131,6530,6530,6674,6695,6663,6691,6684,161,154,30,300.8,166
,20130201,6691,6684,6575,6765,6575,6582,6613,-102,-71,22,218.23,164
,20130204,6582,6613,6658,6669,6646,6646,6664,33,51,28,279.89,164
,20130205,6646,6664,6657,6658,6646,6646,6654,-18,-10,8,79.85,156
,20130206,6646,6654,6648,6649,6638,6638,6645,-16,-9,10,99.68,154
,20130207,6638,6645,6651,6651,6631,6631,6641,-14,-4,4,39.85,152
,20130208,6631,6641,6569,6612,6569,6609,6605,-32,-36,24,237.81,174
,20130218,6609,6605,6314,6321,6284,6309,6302,-296,-303,72,680.67,172
,20130219,6309,6302,6315,6315,6304,6304,6309,2,7,4,37.86,176
,20130220,6304,6309,6242,6250,6240,6249,6244,-60,-65,38,355.95,204
,20130221,6249,6244,6064,6091,6000,6025,6039,-219,-205,262,"2,373.48",204
,20130222,6025,6039,6085,6090,6080,6080,6084,41,45,14,127.77,200
,20130225,6080,6084,6090,6090,6090,6090,6090,6,6,2,18.27,200
,20130226,6090,6090,6115,6133,6095,6095,6109,5,19,54,494.87,204
,20130227,6095,6109,6150,6154,6111,6135,6122,26,13,170,"1,561.23",290
,20130228,6135,6122,6110,6118,6110,6110,6114,-12,-8,46,421.9,262
,20130301,6110,6114,6023,6033,6010,6010,6021,-104,-93,84,758.72,230
,20130304,6010,6021,6037,6051,6037,6041,6044,20,23,244,"2,212.18",228
,20130305,6041,6044,6069,6095,6069,6095,6077,51,33,16,145.86,226
,20130306,6095,6077,6095,6095,6085,6085,6086,8,9,50,456.5,206
,20130307,6085,6086,6105,6110,6102,6102,6106,16,20,8,73.28,204
,20130308,6102,6106,6069,6076,6060,6060,6069,-46,-37,8,72.84,206
,20130311,6060,6069,6110,6110,6101,6102,6104,33,35,10,91.57,204
,20130312,6102,6104,6110,6110,6098,6098,6101,-6,-3,140,"1,281.39",268
,20130313,6098,6101,6123,6125,6115,6115,6122,14,21,8,73.46,266
,20130314,6115,6122,6068,6070,5990,6040,6024,-82,-98,78,704.87,260
,20130315,6040,6024,6042,6054,6026,6053,6042,29,18,98,888.26,250
,20130318,6053,6042,6030,6041,5993,6005,6013,-37,-29,152,"1,371.07",352
,20130319,6005,6013,6036,6050,6033,6047,6043,34,30,178,"1,613.55",306
,20130320,6047,6043,6033,6055,6000,6051,6028,8,-15,254,"2,296.81",298
,20130321,6051,6028,6029,6050,6026,6050,6042,22,14,38,344.39,314
,20130322,6050,6042,6079,6081,6067,6076,6075,34,33,24,218.73,322
,20130325,6076,6075,6020,6048,6020,6020,6029,-55,-46,68,615.03,328
,20130326,6020,6029,6027,6027,6027,6027,6027,-2,-2,4,36.16,326
,20130327,6027,6027,6015,6020,5875,5880,5949,-147,-78,186,"1,659.97",376
,20130328,5880,5949,5912,5984,5912,5984,5963,35,14,46,411.46,352
,20130329,5984,5963,5889,5889,5828,5840,5852,-123,-111,56,491.62,328
,20130401,5840,5852,5864,5866,5771,5781,5819,-71,-33,58,506.34,326
,20130402,5781,5819,5824,5834,5790,5790,5803,-29,-16,72,626.82,310
,20130403,5790,5803,5640,5640,5575,5587,5609,-216,-194,114,959.2,356
,20130408,5587,5609,5647,5671,5625,5671,5642,62,33,74,626.34,352
,20130409,5671,5642,5662,5700,5660,5688,5680,46,38,126,"1,073.53",368
,20130410,5688,5680,5799,5799,5764,5796,5778,116,98,88,762.71,372
,20130411,5796,5778,5730,5730,5683,5688,5709,-90,-69,166,"1,421.78",480
,20130412,5688,5709,5710,5710,5700,5708,5702,-1,-7,190,"1,625.23",392
,20130415,5708,5702,5382,5383,5359,5359,5365,-343,-337,60,482.9,410
,20130416,5359,5365,4882,4890,4882,4882,4884,-483,-481,170,"1,245.50",450
,20130417,4882,4884,4886,4919,4763,4798,4853,-86,-31,678,"4,935.79",558
,20130418,4798,4853,4790,4790,4561,4746,4641,-107,-212,576,"4,010.64",546
,20130419,4746,4641,4759,4859,4710,4803,4781,162,140,532,"3,815.38",650
,20130422,4803,4781,4781,4819,4757,4775,4775,-6,-6,286,"2,048.90",688
,20130423,4775,4775,4776,4780,4587,4622,4698,-153,-77,480,"3,382.68",678
,20130424,4622,4698,4653,4731,4627,4731,4665,33,-33,622,"4,352.66",902
,20130425,4731,4665,4716,4755,4700,4719,4731,54,66,242,"1,717.40",906
,20130426,4719,4731,5020,5024,4908,4910,4966,179,235,370,"2,756.51",816
,20130502,4910,4966,4750,4769,4711,4769,4745,-197,-221,116,825.73,832
,20130503,4769,4745,4777,4864,4777,4864,4822,119,77,228,"1,649.22",842
,20130506,4864,4822,4931,4931,4860,4870,4876,48,54,174,"1,272.75",888
,20130507,4870,4876,4806,4818,4728,4740,4769,-136,-107,300,"2,146.09",946
,20130508,4740,4769,4768,4822,4755,4810,4790,41,21,230,"1,652.78",890
,20130509,4810,4790,4815,4870,4813,4834,4849,44,59,168,"1,222.07",900
,20130510,4834,4849,4744,4806,4742,4806,4772,-43,-77,84,601.3,878
,20130513,4806,4772,4819,4819,4752,4754,4783,-18,11,228,"1,636.03",928
,20130514,4754,4783,5044,5044,4770,4770,4802,-13,19,58,417.8,920
,20130515,4770,4802,4729,4729,4633,4633,4699,-169,-103,486,"3,425.67",1130
,20130516,4633,4699,4611,4624,4572,4588,4591,-111,-108,130,895.34,1134
,20130517,4588,4591,4611,4623,4567,4567,4594,-24,3,174,"1,199.14",1104
,20130520,4567,4594,4452,4453,4325,4350,4411,-244,-183,686,"4,539.43",1196
,20130521,4350,4411,4545,4621,4515,4583,4542,172,131,644,"4,388.25",1150
,20130522,4583,4542,4572,4621,4543,4570,4554,28,12,276,"1,885.76",1154
,20130523,4570,4554,4482,4496,4446,4494,4464,-60,-90,274,"1,835.09",1220
,20130524,4494,4464,4499,4540,4496,4535,4525,71,61,136,923.29,1234
,20130527,4535,4525,4489,4564,4489,4563,4536,38,11,104,707.72,1274
,20130528,4563,4536,4537,4546,4528,4535,4540,-1,4,90,612.98,1298
,20130529,4535,4540,4533,4535,4481,4488,4500,-52,-40,168,"1,134.06",1288
,20130530,4488,4500,4506,4551,4506,4551,4525,51,25,226,"1,534.02",1364
,20130531,4551,4525,4565,4588,4564,4588,4581,63,56,232,"1,594.36",1352
,20130603,4588,4581,4515,4554,4501,4517,4512,-64,-69,70,473.82,1374
,20130604,4517,4512,4573,4573,4538,4543,4556,31,44,50,341.77,1368
,20130605,4543,4556,4522,4542,4522,4542,4533,-14,-23,22,149.62,1364
,20130606,4542,4533,4527,4527,4493,4494,4512,-39,-21,70,473.77,1402
,20130607,4494,4512,4529,4562,4529,4543,4550,31,38,222,"1,515.41",1468
,20130613,4543,4550,4398,4409,4392,4404,4398,-146,-152,78,514.63,1456
,20130614,4404,4398,4380,4381,4368,4381,4377,-17,-21,178,"1,168.91",1426
,20130617,4381,4377,4430,4430,4410,4415,4416,38,39,206,"1,364.85",1322
,20130618,4415,4416,4408,4415,4379,4384,4405,-32,-11,128,845.9,1368
,20130619,4384,4405,4366,4380,4342,4380,4354,-25,-51,342,"2,233.98",1444
,20130620,4380,4354,4270,4312,4218,4218,4280,-136,-74,270,"1,733.63",1410
,20130621,4218,4280,4023,4023,4023,4023,4023,-257,-257,122,736.21,1372
,20130624,4023,4023,4036,4052,3914,3929,3972,-94,-51,778,"4,635.56",1566
,20130625,3929,3972,3943,3984,3910,3935,3948,-37,-24,840,"4,975.43",1542
,20130626,3935,3948,3935,3935,3733,3779,3799,-169,-149,1542,"8,788.28",1632
,20130627,3779,3799,3768,3798,3726,3763,3766,-36,-33,898,"5,073.99",1812
,20130628,3763,3766,3642,3799,3634,3745,3713,-21,-53,706,"3,932.08",1774
,20130701,3745,3713,3866,3935,3866,3935,3905,222,192,654,"3,831.73",1676
,20130702,3935,3905,3923,3946,3918,3946,3933,41,28,64,377.64,1700
,20130703,3946,3933,3948,3948,3905,3921,3910,-12,-23,384,"2,252.20",1884
,20130704,3921,3910,3973,3973,3932,3932,3938,22,28,420,"2,481.52",2060
,20130705,3932,3938,3921,3921,3818,3840,3853,-98,-85,420,"2,427.43",2308
,20130708,3840,3853,3801,3801,3755,3766,3767,-87,-86,444,"2,509.04",2288
,20130709,3766,3767,3800,3893,3800,3872,3859,105,92,612,"3,543.17",2184
,20130710,3872,3859,3839,3888,3805,3822,3816,-37,-43,1020,"5,839.75",2332
,20130711,3822,3816,3822,4040,3822,4040,3983,224,167,272,"1,625.18",2444
,20130712,4040,3983,3976,3978,3945,3945,3974,-38,-9,200,"1,192.35",2552
,20130715,3945,3974,4050,4050,3980,3980,4005,6,31,228,"1,369.77",2752
ag1308,20130104,6486,6488,6281,6326,6281,6303,6307,-185,-181,26,245.99,130
,20130107,6303,6307,6458,6488,6458,6488,6470,181,163,10,97.05,128
,20130108,6488,6470,6460,6460,6460,6460,6460,-10,-10,4,38.76,132
,20130109,6460,6460,,,,6460,6460,0,0,0,0,132
,20130110,6460,6460,,,,6460,6460,0,0,0,0,132
,20130111,6460,6460,6580,6580,6547,6556,6565,96,105,10,98.49,128
,20130114,6556,6565,6208,6542,6208,6542,6489,-23,-76,16,155.74,134
,20130115,6542,6489,6627,6627,6621,6621,6623,132,134,14,139.1,132
,20130116,6621,6623,6666,6666,6666,6666,6666,43,43,8,79.99,132
,20130117,6666,6666,,,,6666,6666,0,0,0,0,132
,20130118,6666,6666,6703,6713,6703,6713,6708,47,42,4,40.25,132
,20130121,6713,6708,,,,6708,6708,0,0,0,0,132
,20130122,6708,6708,6753,6753,6753,6753,6753,45,45,2,20.26,132
,20130123,6753,6753,,,,6753,6753,0,0,0,0,132
,20130124,6753,6753,6712,6712,6712,6712,6712,-41,-41,2,20.14,132
,20130125,6712,6712,6591,6622,6589,6622,6600,-90,-112,8,79.2,130
,20130128,6622,6600,,,,6600,6600,0,0,0,0,130
,20130129,6600,6600,6537,6551,6537,6551,6544,-49,-56,4,39.26,128
,20130130,6551,6544,,,,6569,6569,25,25,0,0,128
,20130131,6569,6569,6700,6718,6697,6718,6703,149,134,16,160.87,114
,20130201,6718,6703,6612,6617,6611,6617,6615,-86,-88,14,138.92,126
,20130204,6617,6615,6642,6680,6642,6679,6674,64,59,16,160.18,134
,20130205,6679,6674,6680,6694,6671,6685,6681,11,7,22,220.5,126
,20130206,6685,6681,6685,6685,6647,6668,6667,-13,-14,28,280.04,130
,20130207,6668,6667,6700,6700,6680,6692,6686,25,19,30,300.9,138
,20130208,6692,6686,6597,6597,6597,6597,6597,-89,-89,2,19.79,136
,20130218,6597,6597,6316,6334,6313,6329,6325,-268,-272,18,170.8,138
,20130219,6329,6325,6333,6333,6333,6333,6333,8,8,2,19,138
,20130220,6333,6333,6272,6272,6272,6272,6272,-61,-61,2,18.82,140
,20130221,6272,6272,6073,6073,6023,6042,6048,-230,-224,26,235.89,142
,20130222,6042,6048,6042,6122,6042,6122,6103,74,55,10,91.55,142
,20130225,6122,6103,6116,6116,6116,6116,6116,13,13,2,18.35,140
,20130226,6116,6116,6162,6173,6161,6161,6163,45,47,16,147.92,138
,20130227,6161,6163,6180,6192,6169,6169,6176,6,13,16,148.25,134
,20130228,6169,6176,6157,6161,6157,6157,6157,-19,-19,12,110.84,136
,20130301,6157,6157,6078,6078,6064,6064,6069,-93,-88,24,218.48,140
,20130304,6064,6069,6085,6085,6076,6076,6082,7,13,12,109.49,136
,20130305,6076,6082,6136,6154,6136,6154,6145,72,63,4,36.87,136
,20130306,6154,6145,6161,6161,6125,6137,6142,-8,-3,22,202.71,138
,20130307,6137,6142,6122,6160,6122,6159,6147,17,5,8,73.77,140
,20130308,6159,6147,,,,6118,6118,-29,-29,0,0,140
,20130311,6118,6118,6150,6150,6150,6150,6150,32,32,6,55.35,134
,20130312,6150,6150,6147,6147,6147,6147,6147,-3,-3,8,73.76,134
,20130313,6147,6147,6150,6150,6150,6150,6150,3,3,2,18.45,132
,20130314,6150,6150,6079,6079,6021,6067,6047,-83,-103,22,199.56,128
,20130315,6067,6047,6071,6088,6068,6088,6071,41,24,18,163.94,126
,20130318,6088,6071,6027,6027,6013,6013,6020,-58,-51,4,36.12,126
,20130319,6013,6020,,,,6020,6020,0,0,0,0,126
,20130320,6020,6020,6034,6093,6034,6093,6068,73,48,14,127.43,126
,20130321,6093,6068,6065,6065,6065,6065,6065,-3,-3,2,18.2,124
,20130322,6065,6065,6108,6108,6108,6108,6108,43,43,2,18.32,122
,20130325,6108,6108,6067,6068,6053,6053,6062,-55,-46,14,127.31,122
,20130326,6053,6062,6062,6062,6062,6062,6062,0,0,2,18.19,124
,20130327,6062,6062,6033,6033,5918,5918,5970,-144,-92,22,197.01,132
,20130328,5918,5970,5960,6011,5960,5987,5991,17,21,34,305.55,134
,20130329,5987,5991,5885,5904,5852,5904,5895,-87,-96,28,247.62,132
,20130401,5904,5895,5904,5904,5828,5828,5874,-67,-21,20,176.23,136
,20130402,5828,5874,5849,5849,5815,5815,5834,-59,-40,24,210.05,132
,20130403,5815,5834,5661,5661,5590,5598,5613,-236,-221,50,421.03,144
,20130408,5598,5613,5681,5681,5648,5648,5655,35,42,36,305.41,132
,20130409,5648,5655,5719,5722,5719,5722,5720,67,65,4,34.32,134
,20130410,5722,5720,5817,5834,5800,5834,5814,114,94,90,784.92,148
,20130411,5834,5814,5735,5751,5720,5720,5738,-94,-76,66,568.07,164
,20130412,5720,5738,5744,5750,5739,5739,5743,1,5,58,499.7,206
,20130415,5739,5743,5398,5398,5398,5398,5398,-345,-345,34,275.3,236
,20130416,5398,5398,4912,4932,4912,4912,4915,-486,-483,96,707.86,284
,20130417,4912,4915,4922,4946,4758,4814,4837,-101,-78,622,"4,513.76",280
,20130418,4814,4837,4700,4787,4575,4748,4690,-89,-147,282,"1,984.14",272
,20130419,4748,4690,4746,4879,4740,4837,4777,147,87,80,573.29,240
,20130422,4837,4777,4786,4830,4783,4794,4817,17,40,26,187.9,230
,20130423,4794,4817,4804,4804,4622,4622,4741,-195,-76,212,"1,507.67",368
,20130424,4622,4741,4667,4756,4664,4727,4701,-14,-40,126,888.59,376
,20130425,4727,4701,4749,4796,4739,4752,4760,51,59,208,"1,485.24",328
,20130426,4752,4760,5053,5053,4931,4954,4947,194,187,390,"2,894.36",350
,20130502,4954,4947,4768,4792,4745,4790,4769,-157,-178,220,"1,573.93",376
,20130503,4790,4769,4809,4879,4807,4877,4846,108,77,120,872.34,352
,20130506,4877,4846,4906,4940,4887,4909,4912,63,66,28,206.33,342
,20130507,4909,4912,4823,4838,4745,4756,4808,-156,-104,118,851.1,352
,20130508,4756,4808,4833,4833,4798,4798,4826,-10,18,24,173.75,362
,20130509,4798,4826,4850,4892,4850,4857,4870,31,44,102,745.13,370
,20130510,4857,4870,4752,4847,4752,4847,4814,-23,-56,28,202.2,376
,20130513,4847,4814,4825,4832,4783,4783,4795,-31,-19,78,561.1,394
,20130514,4783,4795,4813,4827,4784,4791,4807,-4,12,54,389.42,370
,20130515,4791,4807,4721,4740,4648,4654,4692,-153,-115,92,647.61,344
,20130516,4654,4692,4610,4625,4580,4625,4604,-67,-88,12,82.87,336
,20130517,4625,4604,4622,4624,4616,4617,4619,13,15,10,69.29,336
,20130520,4617,4619,4476,4476,4354,4364,4392,-255,-227,40,263.57,342
,20130521,4364,4392,4515,4606,4515,4603,4543,211,151,142,967.67,344
,20130522,4603,4543,4603,4637,4557,4589,4603,46,60,122,842.49,310
,20130523,4589,4603,4500,4520,4472,4516,4499,-87,-104,56,377.95,320
,20130524,4516,4499,4523,4572,4523,4565,4554,66,55,52,355.27,320
,20130527,4565,4554,4565,4576,4558,4576,4561,22,7,54,369.51,344
,20130528,4576,4561,4551,4566,4551,4560,4558,-1,-3,28,191.47,338
,20130529,4560,4558,4522,4522,4494,4503,4504,-55,-54,52,351.35,348
,20130530,4503,4504,4527,4581,4527,4578,4568,74,64,56,383.72,344
,20130531,4578,4568,4622,4624,4596,4613,4616,45,48,86,595.52,340
,20130603,4613,4616,4538,4546,4530,4543,4540,-73,-76,38,258.81,358
,20130604,4543,4540,4570,4570,4570,4570,4570,30,30,6,41.13,358
,20130605,4570,4570,4536,4571,4536,4565,4550,-5,-20,38,259.39,376
,20130606,4565,4550,4543,4544,4513,4513,4531,-37,-19,12,81.57,384
,20130607,4513,4531,4576,4588,4562,4562,4579,31,48,218,"1,497.43",498
,20130613,4562,4579,4420,4420,4413,4413,4416,-166,-163,52,344.5,504
,20130614,4413,4416,4399,4399,4380,4394,4390,-22,-26,46,302.95,486
,20130617,4394,4390,4430,4434,4424,4428,4430,38,40,90,598.18,412
,20130618,4428,4430,4432,4432,4398,4398,4410,-32,-20,16,105.84,414
,20130619,4398,4410,4393,4393,4357,4390,4372,-20,-38,64,419.78,420
,20130620,4390,4372,4293,4303,4256,4256,4297,-116,-75,110,709.16,400
,20130621,4256,4297,4039,4039,4039,4039,4039,-258,-258,166,"1,005.71",372
,20130624,4039,4039,4064,4072,3933,3939,4002,-100,-37,266,"1,596.98",382
,20130625,3939,4002,3945,3980,3945,3965,3959,-37,-43,16,95.02,380
,20130626,3965,3959,3910,3910,3749,3799,3803,-160,-156,18,102.69,382
,20130627,3799,3803,3764,3784,3752,3769,3766,-34,-37,130,734.55,388
,20130628,3769,3766,3659,3775,3659,3775,3715,9,-51,58,323.24,394
,20130701,3775,3715,3904,3933,3902,3930,3921,215,206,48,282.32,372
,20130702,3930,3921,3949,3978,3928,3975,3950,54,29,142,841.39,386
,20130703,3975,3950,3942,3980,3907,3980,3946,30,-4,44,260.48,382
,20130704,3980,3946,3955,3966,3944,3952,3954,6,8,32,189.8,390
,20130705,3952,3954,3926,3926,3825,3850,3869,-104,-85,66,383.11,378
,20130708,3850,3869,3802,3802,3747,3766,3779,-103,-90,152,861.74,368
,20130709,3766,3779,3811,3912,3809,3883,3848,104,69,56,323.3,360
,20130710,3883,3848,3838,3849,3803,3833,3831,-15,-17,88,505.73,356
,20130711,3833,3831,3850,4028,3849,4028,3966,197,135,78,464.07,370
,20130712,4028,3966,4023,4023,3962,3962,3996,-4,30,82,491.56,376
,20130715,3962,3996,3964,4018,3964,3984,3997,-12,1,38,227.83,362
,20130716,3984,3997,4057,4057,3943,3974,3969,-23,-28,708,"4,215.08",558
,20130717,3974,3969,4005,4010,3975,3984,3990,15,21,170,"1,017.47",616
,20130718,3984,3990,4062,4062,3870,3887,3892,-103,-98,812,"4,741.66",904
,20130719,3887,3892,3899,3926,3682,3890,3882,-2,-10,990,"5,765.52",1046
,20130722,3890,3882,3902,4007,3890,3993,3958,111,76,242,"1,437.07",1034
,20130723,3993,3958,4062,4070,4026,4030,4051,72,93,1002,"6,089.00",1766
,20130724,4030,4051,4018,4059,4014,4046,4034,-5,-17,3110,"18,820.09",3964
,20130725,4046,4034,4029,4033,3988,4008,4012,-26,-22,530,"3,189.95",4240
,20130726,4008,4012,4016,4047,4010,4021,4028,9,16,366,"2,211.38",4298
,20130729,4021,4028,3976,3996,3924,3928,3949,-100,-79,1608,"9,527.39",4862
,20130730,3928,3949,3955,3963,3942,3945,3952,-4,3,1880,"11,147.01",5896
,20130731,3945,3952,3962,3998,3910,3916,3964,-36,12,994,"5,910.57",5816
,20130801,3916,3964,3948,3956,3905,3925,3934,-39,-30,524,"3,092.48",5820
,20130802,3925,3934,3948,3950,3865,3868,3903,-66,-31,1388,"8,127.19",6356
,20130805,3868,3903,3979,4100,3962,3976,3987,73,84,504,"3,014.52",6204
,20130806,3976,3987,3936,3945,3914,3927,3928,-60,-59,540,"3,182.17",5852
,20130807,3927,3928,3919,3934,3884,3896,3897,-32,-31,736,"4,302.32",5584
,20130808,3896,3897,3907,3976,3907,3960,3949,63,52,400,"2,369.79",5552
,20130809,3960,3949,3984,4088,3971,4007,4039,58,90,2480,"15,025.73",6288
,20130812,4007,4039,4040,4230,4040,4230,4175,191,136,652,"4,083.50",6428
,20130813,4230,4175,4250,4389,4210,4389,4241,214,66,2464,"15,677.89",8332
,20130814,4389,4241,4376,4376,4233,4291,4286,50,45,408,"2,623.24",8316
,20130815,4291,4286,4363,4440,4313,4398,4401,112,115,860,"5,677.30",8568
ag1309,20130104,6512,6516,6452,6452,6287,6338,6335,-178,-181,126,"1,197.40",702
,20130107,6338,6335,6455,6525,6434,6485,6489,150,154,92,895.52,674
,20130108,6485,6489,6507,6507,6469,6469,6475,-20,-14,52,505.06,680
,20130109,6469,6475,6543,6543,6519,6530,6525,55,50,84,822.22,716
,20130110,6530,6525,6503,6513,6503,6513,6508,-12,-17,4,39.05,716
,20130111,6513,6508,6571,6606,6570,6575,6585,67,77,108,"1,066.83",726
,20130114,6575,6585,6548,6588,6548,6588,6572,3,-13,56,552.06,750
,20130115,6588,6572,6643,6686,6629,6653,6656,81,84,32,319.5,752
,20130116,6653,6656,6697,6726,6695,6698,6709,42,53,78,785.06,762
,20130117,6698,6709,6700,6700,6677,6688,6691,-21,-18,90,903.42,806
,20130118,6688,6691,6688,6773,6688,6764,6758,73,67,90,912.45,814
,20130121,6764,6758,6791,6804,6762,6765,6783,7,25,268,"2,726.87",896
,20130122,6765,6783,6783,6797,6779,6797,6782,14,-1,44,447.67,904
,20130123,6797,6782,6804,6804,6785,6785,6789,3,7,52,529.57,916
,20130124,6785,6789,6755,6755,6687,6687,6715,-102,-74,168,"1,692.29",882
,20130125,6687,6715,6632,6655,6632,6653,6645,-62,-70,38,378.81,888
,20130128,6653,6645,6600,6606,6594,6602,6598,-43,-47,54,534.49,894
,20130129,6602,6598,6587,6607,6573,6607,6584,9,-14,32,316.07,902
,20130130,6607,6584,6641,6643,6630,6630,6635,46,51,28,278.69,910
,20130131,6630,6635,6650,6752,6650,6750,6728,115,93,80,807.47,920
,20130201,6750,6728,6600,6647,6600,6647,6642,-81,-86,134,"1,335.21",956
,20130204,6647,6642,6686,6716,6657,6690,6676,48,34,254,"2,543.75",902
,20130205,6690,6676,6698,6708,6689,6703,6698,27,22,36,361.74,886
,20130206,6703,6698,6696,6696,6631,6683,6672,-15,-26,124,"1,241.02",916
,20130207,6683,6672,6700,6717,6655,6689,6697,17,25,144,"1,446.67",882
,20130208,6689,6697,6605,6647,6594,6643,6613,-54,-84,132,"1,309.39",898
,20130218,6643,6613,6352,6374,6335,6374,6361,-239,-252,190,"1,813.07",914
,20130219,6374,6361,6369,6377,6361,6361,6369,0,8,94,898.16,926
,20130220,6361,6369,6304,6323,6290,6299,6301,-70,-68,334,"3,157.15",980
,20130221,6299,6301,6183,6183,6052,6093,6085,-208,-216,362,"3,304.30",1050
,20130222,6093,6085,6121,6145,6120,6132,6133,47,48,334,"3,073.11",1136
,20130225,6132,6133,6129,6153,6095,6124,6133,-9,0,446,"4,103.20",1332
,20130226,6124,6133,6094,6193,6094,6127,6138,-6,5,664,"6,113.83",1550
,20130227,6127,6138,6184,6247,6162,6208,6206,70,68,244,"2,271.43",1558
,20130228,6208,6206,6238,6238,6178,6183,6185,-23,-21,518,"4,806.24",1490
,20130301,6183,6185,6051,6114,6051,6100,6083,-85,-102,676,"6,168.42",1574
,20130304,6100,6083,6118,6149,6111,6135,6125,52,42,468,"4,299.83",1752
,20130305,6135,6125,6128,6185,6116,6185,6133,60,8,328,"3,017.53",1870
,20130306,6185,6133,6132,6190,6132,6150,6168,17,35,212,"1,961.48",1884
,20130307,6150,6168,6168,6203,6154,6177,6173,9,5,386,"3,574.19",1864
,20130308,6177,6173,6163,6163,6122,6142,6138,-31,-35,790,"7,273.76",1932
,20130311,6142,6138,6170,6189,6156,6181,6175,43,37,536,"4,964.81",1848
,20130312,6181,6175,6167,6181,6116,6133,6162,-42,-13,266,"2,458.91",1832
,20130313,6133,6162,6184,6186,6160,6174,6179,12,17,356,"3,299.92",1736
,20130314,6174,6179,6135,6135,6035,6105,6096,-74,-83,560,"5,120.77",1642
,20130315,6105,6096,6105,6136,6090,6128,6109,32,13,416,"3,812.55",1746
,20130318,6128,6109,6120,6120,6030,6071,6060,-38,-49,738,"6,709.46",1718
,20130319,6071,6060,6085,6115,6055,6114,6099,54,39,152,"1,390.73",1706
,20130320,6114,6099,6150,6150,6082,6114,6102,15,3,570,"5,217.40",1664
,20130321,6114,6102,6041,6117,6041,6105,6100,3,-2,326,"2,983.29",1664
,20130322,6105,6100,6136,6155,6133,6144,6141,44,41,834,"7,683.59",1968
,20130325,6144,6141,6050,6106,6050,6073,6077,-68,-64,596,"5,433.38",1854
,20130326,6073,6077,6077,6087,6032,6064,6068,-13,-9,512,"4,660.32",1756
,20130327,6064,6068,6076,6076,5862,5933,5959,-135,-109,4410,"39,423.21",1960
,20130328,5933,5959,6004,6055,5952,6028,6020,69,61,1348,"12,172.51",1660
,20130329,6028,6020,5863,5956,5857,5925,5900,-95,-120,1420,"12,567.83",1656
,20130401,5925,5900,5910,5927,5820,5835,5878,-65,-22,644,"5,678.66",1604
,20130402,5835,5878,5863,5888,5838,5872,5856,-6,-22,484,"4,251.80",1712
,20130403,5872,5856,5714,5714,5618,5640,5661,-216,-195,2212,"18,785.04",2224
,20130408,5640,5661,5678,5739,5676,5717,5698,56,37,1108,"9,470.48",2194
,20130409,5717,5698,5698,5753,5698,5744,5727,46,29,434,"3,728.42",2070
,20130410,5744,5727,5796,5860,5796,5854,5829,127,102,630,"5,509.31",2122
,20130411,5854,5829,5739,5781,5731,5745,5753,-84,-76,506,"4,367.19",2178
,20130412,5745,5753,5772,5772,5756,5767,5763,14,10,150,"1,296.88",2176
,20130415,5767,5763,5422,5422,5417,5417,5417,-346,-346,354,"2,876.66",2342
,20130416,5417,5417,4929,4948,4929,4941,4931,-476,-486,1556,"11,510.88",2596
,20130417,4941,4931,4910,4967,4814,4849,4903,-82,-28,7062,"51,938.49",3896
,20130418,4849,4903,4779,4830,4610,4776,4725,-127,-178,5370,"38,060.81",4742
,20130419,4776,4725,4776,4918,4759,4869,4837,144,112,3658,"26,542.07",4440
,20130422,4869,4837,4850,4878,4797,4810,4836,-27,-1,2100,"15,234.60",4496
,20130423,4810,4836,4817,4835,4630,4660,4716,-176,-120,3096,"21,905.21",4978
,20130424,4660,4716,4697,4790,4661,4770,4724,54,8,1876,"13,295.05",4882
,20130425,4770,4724,4763,4817,4746,4763,4776,39,52,2180,"15,620.51",5294
,20130426,4763,4776,5003,5098,4946,4957,5028,181,252,3420,"25,797.10",4760
,20130502,4957,5028,4805,4897,4749,4795,4791,-233,-237,1734,"12,462.07",4822
,20130503,4795,4791,4810,4909,4807,4909,4861,118,70,2048,"14,935.62",4512
,20130506,4909,4861,4985,4986,4886,4899,4922,38,61,1404,"10,366.56",4306
,20130507,4899,4922,4884,4884,4754,4764,4813,-158,-109,2124,"15,334.79",4966
,20130508,4764,4813,4786,4849,4783,4842,4814,29,1,1650,"11,916.66",4684
,20130509,4842,4814,4868,4904,4819,4866,4881,52,67,1478,"10,822.73",4580
,20130510,4866,4881,4786,4860,4778,4860,4820,-21,-61,1066,"7,708.69",4474
,20130513,4860,4820,4820,4860,4792,4801,4820,-19,0,2468,"17,846.75",4958
,20130514,4801,4820,4810,4849,4802,4808,4828,-12,8,896,"6,489.56",4924
,20130515,4808,4828,4786,4786,4660,4662,4718,-166,-110,2074,"14,677.79",5300
,20130516,4662,4718,4601,4650,4597,4620,4624,-98,-94,2680,"18,590.55",5422
,20130517,4620,4624,4656,4656,4591,4596,4622,-28,-2,2178,"15,100.31",5600
,20130520,4596,4622,4441,4494,4356,4386,4419,-236,-203,3482,"23,085.57",5848
,20130521,4386,4419,4639,4651,4544,4615,4585,196,166,3546,"24,391.23",5630
,20130522,4615,4585,4552,4627,4552,4603,4584,18,-1,1144,"7,866.80",5538
,20130523,4603,4584,4535,4537,4472,4531,4500,-53,-84,2386,"16,108.84",5282
,20130524,4531,4500,4549,4586,4514,4557,4549,57,49,2072,"14,138.45",5378
,20130527,4557,4549,4531,4604,4525,4598,4570,49,21,902,"6,184.43",5354
,20130528,4598,4570,4555,4593,4555,4570,4575,0,5,982,"6,739.80",5166
,20130529,4570,4575,4558,4568,4506,4506,4529,-69,-46,1796,"12,202.76",5128
,20130530,4506,4529,4527,4596,4526,4588,4572,59,43,2622,"17,982.39",5324
,20130531,4588,4572,4610,4638,4593,4623,4621,51,49,1428,"9,898.63",5470
,20130603,4623,4621,4501,4577,4501,4553,4551,-68,-70,1430,"9,762.23",5488
,20130604,4553,4551,4612,4615,4570,4580,4595,29,44,820,"5,652.13",5466
,20130605,4580,4595,4580,4588,4548,4581,4572,-14,-23,938,"6,433.57",5544
,20130606,4581,4572,4571,4571,4525,4526,4543,-46,-29,908,"6,188.83",5666
,20130607,4526,4543,4564,4627,4564,4572,4594,29,51,1992,"13,727.91",6118
,20130613,4572,4594,4394,4452,4353,4436,4435,-158,-159,1012,"6,733.35",5912
,20130614,4436,4435,4436,4441,4400,4415,4413,-20,-22,710,"4,699.89",5918
,20130617,4415,4413,4439,4458,4438,4446,4450,33,37,704,"4,699.49",5658
,20130618,4446,4450,4454,4454,4415,4422,4434,-28,-16,472,"3,139.54",5578
,20130619,4422,4434,4420,4420,4376,4407,4393,-27,-41,882,"5,811.98",5586
,20130620,4407,4393,4321,4326,4139,4242,4268,-151,-125,2454,"15,711.83",5438
,20130621,4242,4268,4011,4055,4011,4033,4022,-235,-246,1910,"11,523.35",5256
,20130624,4033,4022,4067,4074,3938,3953,4000,-69,-22,2296,"13,776.75",5072
,20130625,3953,4000,3975,3993,3934,3966,3965,-34,-35,2086,"12,409.15",5090
,20130626,3966,3965,3965,3965,3755,3801,3822,-164,-143,3690,"21,160.26",5182
,20130627,3801,3822,3781,3817,3742,3786,3787,-36,-35,3402,"19,325.68",4648
,20130628,3786,3787,3699,3810,3659,3779,3752,-8,-35,2492,"14,028.40",4444
,20130701,3779,3752,3901,3977,3873,3976,3937,224,185,2352,"13,891.83",4326
,20130702,3976,3937,3950,3987,3936,3978,3962,41,25,1238,"7,358.79",4274
,20130703,3978,3962,3911,3961,3911,3944,3940,-18,-22,1112,"6,573.15",4234
,20130704,3944,3940,3996,3996,3948,3952,3962,12,22,712,"4,232.18",4204
,20130705,3952,3962,3942,3949,3845,3871,3880,-91,-82,1858,"10,814.46",3998
,20130708,3871,3880,3826,3826,3763,3773,3789,-107,-91,1766,"10,039.37",3898
,20130709,3773,3789,3815,3927,3815,3880,3866,91,77,1746,"10,126.29",3930
,20130710,3880,3866,3866,3875,3815,3850,3846,-16,-20,1424,"8,216.68",3882
,20130711,3850,3846,3873,4076,3834,4021,3983,175,137,1998,"11,939.92",3930
,20130712,4021,3983,4050,4050,3969,3979,4009,-4,26,1462,"8,793.47",3896
,20130715,3979,4009,3978,4052,3975,4000,4008,-9,-1,974,"5,855.74",3710
,20130716,4000,4008,3992,4002,3956,3987,3981,-21,-27,486,"2,902.36",3688
,20130717,3987,3981,4016,4018,3980,4000,3995,19,14,976,"5,848.90",3572
,20130718,4000,3995,4048,4048,3863,3887,3899,-108,-96,902,"5,276.15",3538
,20130719,3887,3899,3927,3941,3866,3892,3908,-7,9,1202,"7,047.62",3444
,20130722,3892,3908,3900,4017,3900,3996,3971,88,63,376,"2,239.72",3384
,20130723,3996,3971,4075,4079,4030,4037,4063,66,92,788,"4,802.96",3360
,20130724,4037,4063,4028,4062,4028,4054,4044,-9,-19,384,"2,329.49",3394
,20130725,4054,4044,4022,4032,3989,4013,4009,-31,-35,430,"2,585.95",3388
,20130726,4013,4009,4013,4039,4010,4018,4026,9,17,492,"2,971.62",3512
,20130729,4018,4026,3975,3988,3934,3939,3951,-87,-75,1008,"5,975.27",3816
,20130730,3939,3951,3939,3966,3939,3947,3954,-4,3,568,"3,369.12",3860
,20130731,3947,3954,3953,3995,3937,3977,3961,23,7,294,"1,746.87",3770
,20130801,3977,3961,3959,3963,3923,3935,3939,-26,-22,226,"1,335.40",3758
,20130802,3935,3939,3947,3947,3869,3877,3903,-62,-36,218,"1,276.46",3722
,20130805,3877,3903,4006,4006,3966,3978,3978,75,75,266,"1,587.57",3708
,20130806,3978,3978,3950,3955,3921,3937,3947,-41,-31,208,"1,231.69",3718
,20130807,3937,3947,3931,3938,3892,3912,3905,-35,-42,306,"1,792.51",3682
,20130808,3912,3905,3909,3999,3909,3961,3967,56,62,990,"5,891.40",3298
,20130809,3961,3967,3990,4063,3982,4034,4018,67,51,246,"1,482.77",3204
,20130812,4034,4018,4026,4244,4026,4226,4168,208,150,608,"3,801.68",2996
,20130813,4226,4168,4238,4340,4222,4326,4268,158,100,992,"6,351.51",2956
,20130814,4326,4268,4336,4336,4271,4279,4295,11,27,348,"2,241.99",2874
,20130815,4279,4295,4305,4438,4304,4409,4367,114,72,344,"2,253.77",2848
,20130816,4409,4367,4354,4629,4352,4595,4564,228,197,680,"4,656.20",2908
,20130819,4595,4564,4575,4712,4575,4602,4656,38,92,612,"4,274.83",2906
,20130820,4602,4656,4600,4628,4426,4485,4539,-171,-117,500,"3,404.72",3012
,20130821,4485,4539,4566,4608,4528,4562,4574,23,35,322,"2,209.70",2942
,20130822,4562,4574,4597,4597,4503,4559,4530,-15,-44,642,"4,362.74",3004
,20130823,4559,4530,4614,4628,4574,4613,4598,83,68,916,"6,318.37",3112
,20130826,4613,4598,4619,4873,4619,4860,4837,262,239,1100,"7,981.59",3108
,20130827,4860,4837,4874,4920,4791,4858,4856,21,19,1042,"7,591.46",3298
,20130828,4858,4856,4975,5024,4919,4995,4970,139,114,1274,"9,498.14",3546
,20130829,4995,4970,4963,5025,4726,4799,4850,-171,-120,926,"6,737.27",3496
,20130830,4799,4850,4831,4831,4672,4725,4742,-125,-108,574,"4,083.03",3258
,20130902,4725,4742,4651,4847,4651,4836,4811,94,69,674,"4,864.54",3644
,20130903,4836,4811,4836,4866,4808,4820,4832,9,21,1556,"11,279.29",3848
,20130904,4820,4832,4930,4930,4755,4804,4854,-28,22,612,"4,456.66",3844
,20130905,4804,4854,4703,4730,4666,4666,4721,-188,-133,124,878.14,3924
,20130906,4666,4721,4659,4665,4610,4650,4646,-71,-75,412,"2,871.35",3904
,20130909,4650,4646,4752,4772,4731,4755,4756,109,110,648,"4,623.63",4244
,20130910,4755,4756,4741,4741,4644,4670,4702,-86,-54,816,"5,755.72",4472
,20130911,4670,4702,4596,4625,4558,4625,4602,-77,-100,316,"2,181.43",4688
,20130912,4625,4602,4719,4719,4575,4578,4643,-24,41,216,"1,504.49",4672
,20130913,4578,4643,4600,4600,4365,4365,4411,-278,-232,308,"2,037.91",4708
,20130916,4365,4411,4400,4619,4400,4420,4445,9,34,124,826.84,4708
ag1310,20130104,6589,6589,6383,6401,6383,6401,6392,-188,-197,4,38.35,72
,20130107,6401,6392,6530,6562,6523,6523,6542,131,150,22,215.91,80
,20130108,6523,6542,,,,6528,6528,-14,-14,0,0,80
,20130109,6528,6528,6555,6555,6551,6551,6553,23,25,4,39.32,80
,20130110,6551,6553,6538,6538,6538,6538,6538,-15,-15,4,39.23,76
,20130111,6538,6538,6637,6652,6625,6625,6638,87,100,6,59.74,76
,20130114,6625,6638,,,,6638,6638,0,0,0,0,76
,20130115,6638,6638,6699,6699,6699,6699,6699,61,61,2,20.1,76
,20130116,6699,6699,6769,6769,6718,6718,6743,19,44,8,80.92,76
,20130117,6718,6743,,,,6743,6743,0,0,0,0,76
,20130118,6743,6743,6807,6807,6805,6805,6806,62,63,4,40.84,76
,20130121,6805,6806,6831,6831,6801,6807,6811,1,5,24,245.2,76
,20130122,6807,6811,6817,6817,6813,6813,6815,2,4,4,40.89,76
,20130123,6813,6815,6822,6822,6810,6810,6816,-5,1,4,40.9,74
,20130124,6810,6816,,,,6742,6742,-74,-74,0,0,74
,20130125,6742,6742,6684,6684,6684,6684,6684,-58,-58,2,20.05,76
,20130128,6684,6684,,,,6637,6637,-47,-47,0,0,76
,20130129,6637,6637,6601,6606,6597,6606,6602,-31,-35,14,138.64,74
,20130130,6606,6602,6665,6665,6665,6665,6665,63,63,2,20,74
,20130131,6665,6665,6745,6777,6738,6777,6755,112,90,8,81.06,72
,20130201,6777,6755,6653,6666,6652,6666,6659,-89,-96,8,79.91,72
,20130204,6666,6659,,,,6693,6693,34,34,0,0,72
,20130205,6693,6693,,,,6715,6715,22,22,0,0,72
,20130206,6715,6715,,,,6689,6689,-26,-26,0,0,72
,20130207,6689,6689,6701,6735,6701,6734,6727,45,38,36,363.26,60
,20130208,6734,6727,6639,6672,6639,6665,6657,-62,-70,12,119.84,56
,20130218,6665,6657,,,,6403,6403,-254,-254,0,0,56
,20130219,6403,6403,,,,6412,6412,9,9,0,0,56
,20130220,6412,6412,,,,6344,6344,-68,-68,0,0,56
,20130221,6344,6344,6084,6095,6084,6095,6089,-249,-255,4,36.54,60
,20130222,6095,6089,6174,6174,6174,6174,6174,85,85,2,18.52,58
,20130225,6174,6174,,,,6174,6174,0,0,0,0,58
,20130226,6174,6174,,,,6179,6179,5,5,0,0,58
,20130227,6179,6179,,,,6247,6247,68,68,0,0,58
,20130228,6247,6247,6218,6220,6218,6220,6219,-27,-28,14,130.61,56
,20130301,6220,6219,6124,6124,6105,6124,6117,-95,-102,6,55.06,60
,20130304,6124,6117,6167,6167,6141,6152,6151,35,34,82,756.59,78
,20130305,6152,6151,6142,6186,6142,6186,6150,35,-1,10,92.26,72
,20130306,6186,6150,6214,6217,6190,6201,6208,51,58,68,633.23,90
,20130307,6201,6208,6210,6222,6203,6215,6218,7,10,108,"1,007.47",146
,20130308,6215,6218,6185,6189,6173,6180,6178,-38,-40,124,"1,149.19",100
,20130311,6180,6178,6180,6220,6180,6220,6211,42,33,12,111.8,100
,20130312,6220,6211,,,,6211,6211,0,0,0,0,100
,20130313,6211,6211,,,,6211,6211,0,0,0,0,100
,20130314,6211,6211,6150,6150,6097,6135,6124,-76,-87,12,110.24,106
,20130315,6135,6124,,,,6137,6137,13,13,0,0,106
,20130318,6137,6137,,,,6137,6137,0,0,0,0,106
,20130319,6137,6137,,,,6137,6137,0,0,0,0,106
,20130320,6137,6137,6137,6137,6137,6137,6137,0,0,4,36.82,102
,20130321,6137,6137,6144,6144,6144,6144,6144,7,7,2,18.43,100
,20130322,6144,6144,6170,6173,6170,6170,6171,26,27,6,55.54,100
,20130325,6170,6171,,,,6171,6171,0,0,0,0,100
,20130326,6171,6171,6103,6103,6103,6103,6103,-68,-68,2,18.31,98
,20130327,6103,6103,6056,6067,5959,5968,6014,-135,-89,428,"3,861.50",210
,20130328,5968,6014,6068,6070,6055,6064,6062,50,48,22,200.06,196
,20130329,6064,6062,5970,5970,5940,5953,5963,-109,-99,110,983.91,176
,20130401,5953,5963,5908,5908,5908,5908,5908,-55,-55,20,177.24,156
,20130402,5908,5908,,,,5886,5886,-22,-22,0,0,156
,20130403,5886,5886,5677,5678,5674,5678,5676,-208,-210,10,85.14,156
,20130408,5678,5676,5729,5753,5718,5746,5735,70,59,180,"1,548.62",188
,20130409,5746,5735,5746,5756,5746,5756,5748,21,13,38,327.69,162
,20130410,5756,5748,5866,5871,5840,5871,5859,123,111,24,210.95,162
,20130411,5871,5859,5795,5795,5795,5795,5795,-64,-64,2,17.39,162
,20130412,5795,5795,,,,5805,5805,10,10,0,0,162
,20130415,5805,5805,5456,5456,5456,5456,5456,-349,-349,14,114.58,174
,20130416,5456,5456,4964,4970,4964,4970,4965,-486,-491,10,74.48,166
,20130417,4970,4965,4991,4999,4853,4861,4918,-104,-47,190,"1,401.76",182
,20130418,4861,4918,4744,4850,4657,4823,4764,-95,-154,114,814.67,194
,20130419,4823,4764,4842,4933,4830,4905,4879,141,115,80,585.53,172
,20130422,4905,4879,4855,4887,4854,4880,4869,1,-10,20,146.07,156
,20130423,4880,4869,4861,4861,4670,4670,4770,-199,-99,18,128.8,150
,20130424,4670,4770,4695,4796,4695,4796,4731,26,-39,170,"1,206.43",184
,20130425,4796,4731,4786,4828,4784,4793,4811,62,80,72,519.63,212
,20130426,4793,4811,5099,5099,4980,4993,5035,182,224,34,256.79,202
,20130502,4993,5035,4839,4839,4785,4809,4815,-226,-220,116,837.87,258
,20130503,4809,4815,4760,4920,4759,4901,4874,86,59,166,"1,213.78",286
,20130506,4901,4874,4941,4941,4914,4933,4927,59,53,12,88.7,280
,20130507,4933,4927,4904,4904,4751,4760,4841,-167,-86,98,711.69,288
,20130508,4760,4841,4808,4855,4784,4850,4827,9,-14,142,"1,028.17",264
,20130509,4850,4827,4859,4919,4859,4891,4895,64,68,148,"1,086.71",330
,20130510,4891,4895,4811,4872,4811,4861,4847,-34,-48,28,203.61,330
,20130513,4861,4847,4843,4859,4811,4811,4842,-36,-5,72,523.03,304
,20130514,4811,4842,4851,4854,4843,4843,4849,1,7,8,58.2,304
,20130515,4843,4849,4778,4778,4672,4672,4741,-177,-108,128,910.45,292
,20130516,4672,4741,4638,4654,4617,4625,4630,-116,-111,80,555.68,294
,20130517,4625,4630,4658,4658,4645,4645,4649,15,19,6,41.84,292
,20130520,4645,4649,4645,4645,4385,4389,4455,-260,-194,136,908.93,344
,20130521,4389,4455,4575,4660,4562,4628,4624,173,169,154,"1,068.29",350
,20130522,4628,4624,4621,4625,4585,4619,4606,-5,-18,84,580.45,334
,20130523,4619,4606,4707,4707,4498,4520,4536,-86,-70,40,272.17,338
,20130524,4520,4536,4609,4609,4573,4596,4589,60,53,22,151.44,342
,20130527,4596,4589,4577,4620,4576,4620,4602,31,13,28,193.31,346
,20130528,4620,4602,4610,4610,4587,4598,4598,-4,-4,56,386.25,372
,20130529,4598,4598,4542,4596,4522,4540,4545,-58,-53,100,681.76,376
,20130530,4540,4545,4565,4614,4558,4609,4603,64,58,146,"1,008.17",468
,20130531,4609,4603,4646,4654,4630,4641,4645,38,42,434,"3,024.13",470
,20130603,4641,4645,4565,4586,4556,4586,4568,-59,-77,58,397.48,466
,20130604,4586,4568,4625,4630,4594,4594,4605,26,37,156,"1,077.62",518
,20130605,4594,4605,4601,4610,4576,4603,4588,-2,-17,122,839.63,508
,20130606,4603,4588,4577,4589,4577,4582,4581,-6,-7,56,384.8,502
,20130607,4582,4581,4627,4630,4621,4621,4627,40,46,64,444.26,510
,20130613,4621,4627,4451,4483,4451,4465,4465,-162,-162,44,294.75,506
,20130614,4465,4465,4470,4470,4431,4444,4444,-21,-21,54,359.97,516
,20130617,4444,4444,4476,4488,4471,4485,4482,41,38,172,"1,156.51",616
,20130618,4485,4482,4466,4471,4440,4445,4451,-37,-31,36,240.38,594
,20130619,4445,4451,4413,4434,4406,4434,4414,-17,-37,22,145.68,594
,20130620,4434,4414,4149,4349,4149,4264,4302,-150,-112,410,"2,645.79",630
,20130621,4264,4302,4043,4090,4043,4055,4063,-247,-239,140,853.42,642
,20130624,4055,4063,4096,4096,3968,3978,4056,-85,-7,508,"3,091.17",676
,20130625,3978,4056,3986,4007,3980,4000,3993,-56,-63,54,323.49,692
,20130626,4000,3993,3993,3993,3777,3814,3822,-179,-171,162,928.79,712
,20130627,3814,3822,3815,3839,3779,3779,3810,-43,-12,174,994.52,654
,20130628,3779,3810,3770,3846,3692,3811,3790,1,-20,68,386.61,656
,20130701,3811,3790,3852,4002,3852,4002,3954,212,164,440,"2,610.28",690
,20130702,4002,3954,4005,4008,3979,4008,3997,54,43,92,551.72,632
,20130703,4008,3997,3979,3985,3941,3985,3970,-12,-27,228,"1,358.05",710
,20130704,3985,3970,4016,4016,3985,3992,3997,22,27,204,"1,223.21",610
,20130705,3992,3997,3964,3971,3873,3889,3942,-108,-55,70,413.91,604
,20130708,3889,3942,3835,3835,3794,3796,3813,-146,-129,104,594.87,606
,20130709,3796,3813,3853,3930,3840,3918,3877,105,64,126,732.86,594
,20130710,3918,3877,3847,3902,3837,3868,3889,-9,12,412,"2,403.78",630
,20130711,3868,3889,3892,4115,3890,4061,4039,172,150,438,"2,654.22",666
,20130712,4061,4039,4069,4069,3994,3994,4041,-45,2,332,"2,012.72",728
,20130715,3994,4041,4009,4069,4000,4030,4027,-11,-14,188,"1,135.63",676
,20130716,4030,4027,4015,4022,3978,4007,4001,-20,-26,28,168.07,684
,20130717,4007,4001,4031,4047,4004,4014,4023,13,22,84,506.91,696
,20130718,4014,4023,3969,3969,3881,3904,3903,-119,-120,44,257.65,674
,20130719,3904,3903,3884,3936,3884,3915,3926,12,23,40,235.6,656
,20130722,3915,3926,3925,4040,3833,4034,4005,108,79,66,396.55,654
,20130723,4034,4005,4090,4096,4050,4060,4079,55,74,44,269.22,664
,20130724,4060,4079,4051,4074,4051,4056,4065,-23,-14,36,219.54,672
,20130725,4056,4065,4043,4043,4013,4027,4027,-38,-38,116,700.8,676
,20130726,4027,4027,4036,4053,4029,4029,4043,2,16,74,448.83,618
,20130729,4029,4043,3955,3966,3938,3938,3952,-105,-91,76,450.59,656
,20130730,3938,3952,3957,3963,3944,3944,3956,-8,4,398,"2,361.95",602
,20130731,3944,3956,3942,3979,3932,3975,3960,19,4,104,617.77,598
,20130801,3975,3960,3955,3962,3917,3935,3942,-25,-18,126,745.13,574
,20130802,3935,3942,3952,3952,3866,3879,3910,-63,-32,42,246.38,578
,20130805,3879,3910,4004,4004,3967,3991,3979,81,69,46,274.59,550
,20130806,3991,3979,3954,3954,3926,3940,3945,-39,-34,34,201.23,556
,20130807,3940,3945,3905,3909,3899,3909,3902,-36,-43,62,362.93,556
,20130808,3909,3902,3909,3982,3901,3970,3955,68,53,74,439.04,514
,20130809,3970,3955,3995,4065,3995,4048,4042,93,87,84,509.38,486
,20130812,4048,4042,4021,4257,4021,4248,4162,206,120,142,886.62,500
,20130813,4248,4162,4288,4360,4248,4340,4284,178,122,522,"3,354.63",464
,20130814,4340,4284,4334,4340,4285,4290,4308,6,24,94,607.47,426
,20130815,4290,4308,4316,4430,4316,4412,4371,104,63,122,799.96,400
,20130816,4412,4371,4369,4633,4369,4608,4589,237,218,86,592.02,392
,20130819,4608,4589,4634,4715,4614,4614,4659,25,70,84,587.07,368
,20130820,4614,4659,4616,4647,4440,4501,4562,-158,-97,140,958.04,340
,20130821,4501,4562,4572,4619,4542,4577,4588,15,26,90,619.44,338
,20130822,4577,4588,4539,4571,4499,4557,4551,-31,-37,60,409.67,326
,20130823,4557,4551,4635,4639,4585,4610,4624,59,73,58,402.33,330
,20130826,4610,4624,4660,4898,4660,4868,4861,244,237,498,"3,631.61",666
,20130827,4868,4861,4988,4988,4843,4866,4871,5,10,708,"5,173.06",1188
,20130828,4866,4871,4982,5041,4934,4993,4955,122,84,428,"3,181.34",1426
,20130829,4993,4955,5005,5005,4705,4776,4853,-179,-102,330,"2,402.53",1384
,20130830,4776,4853,4808,4808,4695,4707,4715,-146,-138,344,"2,433.18",1362
,20130902,4707,4715,4658,4880,4655,4852,4734,137,19,314,"2,229.86",1346
,20130903,4852,4734,4855,4861,4824,4830,4845,96,111,198,"1,439.24",1304
,20130904,4830,4845,4900,4901,4773,4773,4866,-72,21,62,452.57,1298
,20130905,4773,4866,4707,4740,4682,4682,4708,-184,-158,56,395.55,1286
,20130906,4682,4708,4670,4670,4652,4652,4665,-56,-43,8,55.99,1282
,20130909,4652,4665,4777,4777,4777,4777,4777,112,112,2,14.33,1282
,20130910,4777,4777,4765,4765,4706,4708,4720,-69,-57,40,283.25,1292
,20130911,4708,4720,4595,4638,4578,4625,4594,-95,-126,48,330.8,1288
,20130912,4625,4594,4647,4647,4591,4591,4626,-3,32,30,208.18,1282
,20130913,4591,4626,4410,4425,4364,4389,4388,-237,-238,76,500.24,1312
,20130916,4389,4388,4385,4454,4375,4384,4411,-4,23,134,886.72,1302
,20130917,4384,4411,4428,4438,4376,4411,4415,0,4,770,"5,100.04",1704
,20130918,4411,4415,4387,4397,4295,4388,4360,-27,-55,912,"5,965.67",1578
,20130923,4388,4360,4327,4393,4283,4375,4306,15,-54,314,"2,028.53",1634
,20130924,4375,4306,4366,4430,4356,4356,4396,50,90,512,"3,376.51",1794
,20130925,4356,4396,4312,4410,4288,4389,4346,-7,-50,1026,"6,689.76",1942
,20130926,4389,4346,4383,4426,4359,4376,4394,30,48,390,"2,571.01",1936
,20130927,4376,4394,4381,4395,4330,4337,4355,-57,-39,188,"1,228.14",1908
,20130930,4337,4355,4381,4440,4339,4439,4370,84,15,124,812.91,1916
,20131008,4439,4370,4482,4533,4460,4500,4489,130,119,604,"4,067.83",2188
,20131009,4500,4489,4502,4515,4450,4492,4488,3,-1,328,"2,208.19",2256
,20131010,4492,4488,4441,4453,4390,4420,4439,-68,-49,164,"1,092.20",2196
,20131011,4420,4439,4350,4375,4350,4360,4364,-79,-75,112,733.3,2188
,20131014,4360,4364,4202,4265,4202,4265,4242,-99,-122,124,789.13,2160
,20131015,4265,4242,4358,4358,4230,4230,4325,-12,83,96,622.88,2152
ag1311,20130104,6580,6575,6382,6400,6382,6400,6392,-175,-183,8,76.7,72
,20130107,6400,6392,6548,6548,6548,6548,6548,156,156,2,19.64,74
,20130108,6548,6548,,,,6533,6533,-15,-15,0,0,74
,20130109,6533,6533,,,,6533,6533,0,0,0,0,74
,20130110,6533,6533,6568,6568,6568,6568,6568,35,35,2,19.7,74
,20130111,6568,6568,6660,6660,6660,6660,6660,92,92,2,19.98,76
,20130114,6660,6660,6592,6617,6592,6617,6608,-43,-52,6,59.48,76
,20130115,6617,6608,,,,6668,6668,60,60,0,0,76
,20130116,6668,6668,,,,6668,6668,0,0,0,0,76
,20130117,6668,6668,,,,6668,6668,0,0,0,0,76
,20130118,6668,6668,6841,6841,6841,6841,6841,173,173,4,41.05,74
,20130121,6841,6841,6852,6852,6821,6821,6846,-20,5,12,123.24,72
,20130122,6821,6846,,,,6846,6846,0,0,0,0,72
,20130123,6846,6846,6849,6849,6841,6841,6844,-5,-2,12,123.2,62
,20130124,6841,6844,6810,6811,6764,6764,6803,-80,-41,14,142.88,50
,20130125,6764,6803,6724,6724,6724,6724,6724,-79,-79,2,20.17,48
,20130128,6724,6724,,,,6724,6724,0,0,0,0,48
,20130129,6724,6724,6646,6646,6643,6643,6644,-81,-80,6,59.8,50
,20130130,6643,6644,6705,6705,6698,6698,6699,54,55,10,100.49,56
,20130131,6698,6699,6800,6813,6800,6813,6806,114,107,4,40.84,56
,20130201,6813,6806,6693,6693,6693,6693,6693,-113,-113,2,20.08,54
,20130204,6693,6693,,,,6693,6693,0,0,0,0,54
,20130205,6693,6693,6719,6719,6719,6719,6719,26,26,2,20.16,52
,20130206,6719,6719,6757,6757,6757,6757,6757,38,38,2,20.27,52
,20130207,6757,6757,6764,6769,6758,6769,6762,12,5,16,162.29,44
,20130208,6769,6762,,,,6692,6692,-70,-70,0,0,44
,20130218,6692,6692,6427,6427,6427,6427,6427,-265,-265,8,77.12,50
,20130219,6427,6427,,,,6436,6436,9,9,0,0,50
,20130220,6436,6436,,,,6367,6367,-69,-69,0,0,50
,20130221,6367,6367,6159,6160,6159,6160,6159,-207,-208,4,36.96,50
,20130222,6160,6159,6186,6215,6186,6213,6207,54,48,10,93.11,50
,20130225,6213,6207,6211,6219,6211,6211,6214,4,7,8,74.57,46
,20130226,6211,6214,6219,6219,6219,6219,6219,5,5,2,18.66,44
,20130227,6219,6219,6275,6275,6274,6274,6274,55,55,6,56.47,48
,20130228,6274,6274,,,,6274,6274,0,0,0,0,48
,20130301,6274,6274,6140,6140,6140,6140,6140,-134,-134,2,18.42,48
,20130304,6140,6140,,,,6140,6140,0,0,0,0,48
,20130305,6140,6140,6199,6199,6199,6199,6199,59,59,2,18.6,48
,20130306,6199,6199,6229,6233,6228,6233,6230,34,31,6,56.07,54
,20130307,6233,6230,6237,6237,6237,6237,6237,7,7,2,18.71,52
,20130308,6237,6237,6204,6204,6204,6204,6204,-33,-33,2,18.61,50
,20130311,6204,6204,,,,6233,6233,29,29,0,0,50
,20130312,6233,6233,,,,6233,6233,0,0,0,0,50
,20130313,6233,6233,6250,6250,6250,6250,6250,17,17,4,37.5,48
,20130314,6250,6250,,,,6250,6250,0,0,0,0,48
,20130315,6250,6250,6167,6167,6167,6167,6167,-83,-83,2,18.5,48
,20130318,6167,6167,,,,6167,6167,0,0,0,0,48
,20130319,6167,6167,,,,6207,6207,40,40,0,0,48
,20130320,6207,6207,,,,6207,6207,0,0,0,0,48
,20130321,6207,6207,,,,6207,6207,0,0,0,0,48
,20130322,6207,6207,,,,6207,6207,0,0,0,0,48
,20130325,6207,6207,,,,6142,6142,-65,-65,0,0,48
,20130326,6142,6142,,,,6074,6074,-68,-68,0,0,48
,20130327,6074,6074,6089,6089,5968,5968,6018,-106,-56,8,72.22,50
,20130328,5968,6018,6126,6126,6089,6089,6113,71,95,6,55.02,46
,20130329,6089,6113,,,,6013,6013,-100,-100,0,0,46
,20130401,6013,6013,5945,5945,5945,5945,5945,-68,-68,2,17.84,48
,20130402,5945,5945,,,,5923,5923,-22,-22,0,0,48
,20130403,5923,5923,5721,5721,5721,5721,5721,-202,-202,14,120.14,62
,20130408,5721,5721,5772,5774,5736,5767,5765,46,44,18,155.68,50
,20130409,5767,5765,5760,5798,5760,5798,5772,33,7,6,51.95,46
,20130410,5798,5772,5887,5887,5887,5887,5887,115,115,2,17.66,44
,20130411,5887,5887,5828,5828,5828,5828,5828,-59,-59,2,17.48,46
,20130412,5828,5828,,,,5839,5839,11,11,0,0,46
,20130415,5839,5839,,,,5488,5488,-351,-351,0,0,46
,20130416,5488,5488,,,,5158,5158,-330,-330,0,0,46
,20130417,5158,5158,4970,4970,4900,4900,4922,-258,-236,10,73.83,44
,20130418,4900,4922,4900,4900,4721,4808,4806,-114,-116,64,461.45,72
,20130419,4808,4806,4830,4938,4830,4938,4859,132,53,74,539.42,50
,20130422,4938,4859,4856,4897,4856,4897,4881,38,22,6,43.93,50
,20130423,4897,4881,4741,4741,4717,4717,4719,-164,-162,22,155.73,70
,20130424,4717,4719,4739,4821,4718,4778,4760,59,41,46,328.51,64
,20130425,4778,4760,4830,4864,4782,4806,4835,46,75,14,101.54,62
,20130426,4806,4835,5100,5121,5006,5006,5092,171,257,22,168.05,54
,20130502,5006,5092,4842,4842,4798,4815,4817,-277,-275,16,115.63,60
,20130503,4815,4817,4899,4899,4899,4899,4899,82,82,8,58.79,60
,20130506,4899,4899,4984,4995,4972,4991,4985,92,86,8,59.83,64
,20130507,4991,4985,4880,4880,4803,4810,4852,-175,-133,24,174.71,68
,20130508,4810,4852,4853,4888,4844,4888,4862,36,10,30,218.82,82
,20130509,4888,4862,4872,4948,4872,4925,4917,63,55,44,324.55,68
,20130510,4925,4917,4845,4879,4811,4872,4851,-45,-66,118,858.77,78
,20130513,4872,4851,4851,4851,4843,4843,4849,-8,-2,12,87.29,70
,20130514,4843,4849,4865,4865,4841,4841,4854,-8,5,6,43.69,68
,20130515,4841,4854,4758,4802,4730,4739,4775,-115,-79,100,716.4,64
,20130516,4739,4775,4652,4652,4640,4645,4644,-130,-131,8,55.73,68
,20130517,4645,4644,4643,4643,4629,4629,4633,-15,-11,6,41.7,70
,20130520,4629,4633,4464,4464,4410,4410,4433,-223,-200,10,66.5,74
,20130521,4410,4433,4594,4690,4581,4643,4633,210,200,62,430.95,86
,20130522,4643,4633,4643,4643,4607,4635,4624,2,-9,46,319.07,86
,20130523,4635,4624,4507,4534,4480,4513,4500,-111,-124,42,283.53,86
,20130524,4513,4500,4598,4610,4598,4610,4606,110,106,6,41.45,84
,20130527,4610,4606,4624,4624,4610,4610,4617,4,11,8,55.4,84
,20130528,4610,4617,4614,4614,4598,4598,4601,-19,-16,10,69.02,86
,20130529,4598,4601,4585,4585,4539,4539,4563,-62,-38,32,219.05,90
,20130530,4539,4563,4559,4630,4559,4621,4609,58,46,96,663.81,88
,20130531,4621,4609,4657,4657,4650,4656,4655,47,46,48,335.17,102
,20130603,4656,4655,4582,4587,4572,4583,4576,-72,-79,40,274.59,86
,20130604,4583,4576,4634,4634,4599,4599,4611,23,35,12,83,86
,20130605,4599,4611,4601,4625,4579,4620,4611,9,0,32,221.37,98
,20130606,4620,4611,4598,4598,4594,4594,4597,-17,-14,12,82.75,86
,20130607,4594,4597,4635,4635,4635,4635,4635,38,38,2,13.91,86
,20130613,4635,4635,4485,4488,4472,4473,4480,-162,-155,20,134.4,88
,20130614,4473,4480,4454,4454,4454,4454,4454,-26,-26,8,53.45,88
,20130617,4454,4454,,,,4473,4473,19,19,0,0,88
,20130618,4473,4473,4474,4474,4450,4460,4461,-13,-12,18,120.46,90
,20130619,4460,4461,4444,4455,4435,4455,4442,-6,-19,10,66.64,92
,20130620,4455,4442,4353,4359,4336,4336,4353,-106,-89,100,653.02,106
,20130621,4336,4353,4091,4091,4091,4091,4091,-262,-262,82,503.19,142
,20130624,4091,4091,4100,4117,3988,3988,4078,-103,-13,62,379.32,126
,20130625,3988,4078,4013,4047,3979,4022,4008,-56,-70,42,252.54,130
,20130626,4022,4008,3971,3971,3800,3827,3847,-181,-161,166,958.03,152
,20130627,3827,3847,3847,3847,3772,3814,3799,-33,-48,116,661.1,150
,20130628,3814,3799,3712,3844,3705,3829,3789,30,-10,112,636.61,116
,20130701,3829,3789,3962,3994,3957,3993,3974,204,185,92,548.42,120
,20130702,3993,3974,4009,4013,3989,3994,4003,20,29,232,"1,393.19",304
,20130703,3994,4003,3988,4005,3967,3988,3983,-15,-20,56,334.58,302
,20130704,3988,3983,4010,4012,4005,4005,4005,22,22,226,"1,357.79",302
,20130705,4005,4005,3961,3972,3893,3912,3939,-93,-66,74,437.24,312
,20130708,3912,3939,3849,3857,3815,3815,3834,-124,-105,70,402.61,322
,20130709,3815,3834,3872,3952,3872,3933,3938,99,104,264,"1,559.56",266
,20130710,3933,3938,3933,3933,3861,3886,3895,-52,-43,108,630.99,286
,20130711,3886,3895,3903,4111,3900,4063,4037,168,142,476,"2,882.66",242
,20130712,4063,4037,4064,4077,4019,4019,4062,-18,25,236,"1,438.02",262
,20130715,4019,4062,4027,4095,4026,4045,4044,-17,-18,62,376.1,260
,20130716,4045,4044,4022,4040,3996,4016,4021,-28,-23,50,301.6,246
,20130717,4016,4021,4058,4073,4022,4028,4042,7,21,60,363.79,240
,20130718,4028,4042,4063,4072,3902,3935,3962,-107,-80,178,"1,058.09",294
,20130719,3935,3962,3957,3972,3907,3933,3946,-29,-16,192,"1,136.49",252
,20130722,3933,3946,3944,4058,3944,4031,4007,85,61,94,565.12,234
,20130723,4031,4007,4108,4120,4069,4084,4097,77,90,278,"1,708.61",236
,20130724,4084,4097,4060,4103,4060,4077,4078,-20,-19,150,917.58,200
,20130725,4077,4078,4057,4069,4028,4051,4052,-27,-26,132,802.35,190
,20130726,4051,4052,4049,4070,4040,4040,4055,-12,3,98,596.16,210
,20130729,4040,4055,4007,4014,3950,3950,3969,-105,-86,70,416.84,236
,20130730,3950,3969,3950,3980,3939,3939,3965,-30,-4,310,"1,843.76",222
,20130731,3939,3965,3923,4005,3923,3973,3970,8,5,80,476.41,216
,20130801,3973,3970,3940,3956,3910,3929,3929,-41,-41,402,"2,369.21",262
,20130802,3929,3929,3949,3956,3824,3824,3934,-105,5,484,"2,856.32",280
,20130805,3824,3934,4018,4020,3969,3990,3991,56,57,374,"2,239.22",224
,20130806,3990,3991,3952,3959,3931,3937,3948,-54,-43,88,521.18,242
,20130807,3937,3948,3935,3935,3894,3894,3920,-54,-28,6,35.28,244
,20130808,3894,3920,3907,3991,3901,3973,3947,53,27,180,"1,065.87",226
,20130809,3973,3947,4015,4095,3988,4057,4032,110,85,666,"4,028.36",260
,20130812,4057,4032,4051,4264,4051,4254,4161,222,129,424,"2,646.90",248
,20130813,4254,4161,4254,4356,4254,4350,4303,189,142,696,"4,493.05",320
,20130814,4350,4303,4314,4370,4302,4307,4328,4,25,258,"1,675.25",314
,20130815,4307,4328,4369,4456,4322,4437,4384,109,56,364,"2,393.76",266
,20130816,4437,4384,4387,4639,4361,4618,4533,234,149,272,"1,849.57",220
,20130819,4618,4533,4657,4745,4618,4637,4665,104,132,304,"2,127.53",214
,20130820,4637,4665,4646,4660,4483,4527,4619,-138,-46,364,"2,522.20",170
,20130821,4527,4619,4597,4635,4555,4583,4579,-36,-40,420,"2,884.81",178
,20130822,4583,4579,4615,4615,4534,4573,4570,-6,-9,292,"2,001.70",176
,20130823,4573,4570,4615,4648,4594,4596,4617,26,47,186,"1,288.25",178
,20130826,4596,4617,4611,4894,4611,4892,4687,275,70,1302,"9,154.21",186
,20130827,4892,4687,4892,4957,4847,4900,4892,213,205,668,"4,902.00",322
,20130828,4900,4892,5017,5069,4965,5031,4992,139,100,322,"2,411.20",304
,20130829,5031,4992,5058,5063,4738,4816,4939,-176,-53,716,"5,305.33",396
,20130830,4816,4939,4815,4833,4716,4729,4783,-210,-156,280,"2,008.99",318
,20130902,4729,4783,4688,4903,4675,4881,4750,98,-33,306,"2,180.54",234
,20130903,4881,4750,4884,4891,4845,4845,4873,95,123,280,"2,046.90",208
,20130904,4845,4873,4924,4938,4792,4824,4915,-49,42,364,"2,683.96",164
,20130905,4824,4915,4740,4770,4673,4692,4726,-223,-189,258,"1,829.33",244
,20130906,4692,4726,4692,4720,4663,4699,4687,-27,-39,130,914.04,242
,20130909,4699,4687,4789,4816,4786,4796,4800,109,113,232,"1,670.43",220
,20130910,4796,4800,4796,4796,4701,4710,4759,-90,-41,114,813.89,220
,20130911,4710,4759,4640,4688,4598,4653,4628,-106,-131,540,"3,749.36",252
,20130912,4653,4628,4668,4668,4599,4599,4654,-29,26,68,474.73,232
,20130913,4599,4654,4500,4500,4379,4394,4423,-260,-231,272,"1,804.69",222
,20130916,4394,4423,4416,4491,4370,4397,4440,-26,17,270,"1,798.34",198
,20130917,4397,4440,4407,4452,4402,4418,4425,-22,-15,66,438.15,192
,20130918,4418,4425,4444,4444,4321,4382,4381,-43,-44,150,985.79,198
,20130923,4382,4381,4479,4479,4287,4397,4338,16,-43,196,"1,275.42",200
,20130924,4397,4338,4384,4419,4384,4406,4400,68,62,56,369.63,202
,20130925,4406,4400,4320,4408,4318,4398,4372,-2,-28,108,708.32,190
,20130926,4398,4372,4387,4407,4374,4398,4398,26,26,192,"1,266.71",244
,20130927,4398,4398,4412,4413,4354,4364,4394,-34,-4,346,"2,280.63",242
,20130930,4364,4394,4394,4399,4367,4380,4388,-14,-6,48,315.95,234
,20131008,4380,4388,4478,4521,4473,4521,4498,133,110,212,"1,430.43",310
,20131009,4521,4498,4525,4529,4501,4502,4515,4,17,138,934.66,220
,20131010,4502,4515,4442,4444,4419,4419,4426,-96,-89,72,478.11,200
,20131011,4419,4426,4434,4436,4358,4358,4409,-68,-17,232,"1,534.55",190
,20131014,4358,4409,4304,4311,4272,4311,4299,-98,-110,66,425.69,182
,20131015,4311,4299,4333,4335,4256,4256,4293,-43,-6,64,412.13,174
,20131016,4256,4293,4256,4311,4242,4300,4268,7,-25,142,909.24,170
,20131017,4300,4268,4313,4360,4281,4293,4305,25,37,150,968.74,170
,20131018,4293,4305,4412,4412,4374,4384,4387,79,82,230,"1,513.77",174
,20131021,4384,4387,4405,4481,4396,4479,4443,92,56,388,"2,585.99",292
,20131022,4479,4443,4477,4493,4451,4466,4462,23,19,484,"3,240.11",458
,20131023,4466,4462,4499,4578,4420,4555,4553,93,91,694,"4,740.64",658
,20131024,4555,4553,4567,4571,4535,4568,4554,15,1,2130,"14,550.23",1932
,20131025,4568,4554,4568,4571,4474,4488,4537,-66,-17,1928,"13,121.63",2756
,20131028,4488,4537,4466,4525,4460,4502,4489,-35,-48,1526,"10,276.48",3142
,20131029,4502,4489,4510,4519,4480,4496,4497,7,8,1284,"8,662.33",3512
,20131030,4496,4497,4508,4553,4471,4542,4498,45,1,1324,"8,933.64",4142
,20131031,4542,4498,4598,4628,4436,4439,4563,-59,65,396,"2,710.94",4276
,20131101,4439,4563,4413,4430,4394,4394,4422,-169,-141,188,"1,247.02",4240
,20131104,4394,4422,4388,4388,4353,4354,4364,-68,-58,368,"2,409.13",4268
,20131105,4354,4364,4390,4390,4349,4364,4362,0,-2,132,863.74,4288
,20131106,4364,4362,4366,4373,4359,4366,4363,4,1,68,445.11,4288
,20131107,4366,4363,4398,4400,4367,4400,4394,37,31,196,"1,291.85",4348
,20131108,4400,4394,4398,4398,4353,4372,4365,-22,-29,368,"2,410.03",4548
,20131111,4372,4365,4391,4391,4281,4290,4312,-75,-53,1000,"6,468.41",4712
,20131112,4290,4312,4254,4330,4254,4298,4291,-14,-21,436,"2,806.47",4792
,20131113,4298,4291,4235,4295,4180,4255,4225,-36,-66,1040,"6,591.40",5084
,20131114,4255,4225,4255,4261,4223,4252,4248,27,23,428,"2,727.85",4948
,20131115,4252,4248,4246,4256,4232,4232,4243,-16,-5,292,"1,858.85",4960
ag1312,20130104,6605,6609,6419,6440,6411,6430,6424,-179,-185,116,"1,117.85",834
,20130107,6430,6424,6530,6624,6530,6593,6593,169,169,132,"1,305.47",892
,20130108,6593,6593,6575,6612,6557,6560,6575,-33,-18,78,769.31,930
,20130109,6560,6575,6607,6654,6607,6625,6616,50,41,104,"1,032.15",964
,20130110,6625,6616,6580,6614,6580,6614,6588,-2,-28,78,770.83,1018
,20130111,6614,6588,6703,6703,6666,6666,6689,78,101,116,"1,163.90",1084
,20130114,6666,6689,6620,6680,6616,6680,6644,-9,-45,218,"2,172.69",1120
,20130115,6680,6644,6947,6947,6707,6746,6757,102,113,160,"1,621.72",1138
,20130116,6746,6757,6821,6838,6786,6803,6808,46,51,164,"1,674.94",1172
,20130117,6803,6808,6803,6803,6757,6766,6781,-42,-27,180,"1,831.09",1250
,20130118,6766,6781,6830,6865,6820,6859,6830,78,49,678,"6,946.86",1680
,20130121,6859,6830,6872,6893,6824,6840,6871,10,41,618,"6,369.57",2016
,20130122,6840,6871,6870,6880,6844,6867,6861,-4,-10,884,"9,098.17",2624
,20130123,6867,6861,6891,6891,6859,6862,6870,1,9,446,"4,596.47",2794
,20130124,6862,6870,6815,6830,6772,6793,6805,-77,-65,866,"8,839.71",2722
,20130125,6793,6805,6736,6771,6730,6760,6746,-45,-59,338,"3,420.68",2730
,20130128,6760,6746,6675,6697,6670,6686,6686,-60,-60,326,"3,269.74",2878
,20130129,6686,6686,6670,6698,6658,6692,6674,6,-12,324,"3,243.77",2926
,20130130,6692,6674,6700,6734,6700,6733,6728,59,54,266,"2,684.61",3004
,20130131,6733,6728,6816,6857,6816,6856,6844,128,116,504,"5,174.53",2904
,20130201,6856,6844,6730,6747,6726,6741,6736,-103,-108,256,"2,586.73",2972
,20130204,6741,6736,6767,6828,6767,6790,6791,54,55,528,"5,378.60",3082
,20130205,6790,6791,6812,6819,6787,6811,6799,20,8,128,"1,305.41",3074
,20130206,6811,6799,6808,6810,6783,6794,6794,-5,-5,166,"1,691.90",3084
,20130207,6794,6794,6805,6821,6800,6807,6809,13,15,200,"2,042.78",3108
,20130208,6807,6809,6726,6766,6706,6754,6733,-55,-76,292,"2,949.45",3144
,20130218,6754,6733,6510,6510,6444,6462,6468,-271,-265,588,"5,705.54",3364
,20130219,6462,6468,6457,6483,6454,6471,6470,3,2,640,"6,211.38",3818
,20130220,6471,6470,6416,6416,6393,6403,6401,-67,-69,1134,"10,889.39",4298
,20130221,6403,6401,6210,6266,6151,6184,6200,-217,-201,1522,"14,155.13",4848
,20130222,6184,6200,6216,6253,6210,6245,6230,45,30,1160,"10,840.48",5218
,20130225,6245,6230,6230,6261,6194,6229,6233,-1,3,1006,"9,406.80",5300
,20130226,6229,6233,6260,6293,6221,6232,6260,-1,27,962,"9,034.22",5396
,20130227,6232,6260,6310,6330,6293,6305,6305,45,45,964,"9,117.71",5484
,20130228,6305,6305,6266,6300,6266,6287,6281,-18,-24,440,"4,145.97",5638
,20130301,6287,6281,6112,6211,6112,6182,6186,-99,-95,2118,"19,653.04",6450
,20130304,6182,6186,6222,6248,6202,6228,6227,42,41,1468,"13,713.94",6416
,20130305,6228,6227,6225,6288,6215,6288,6238,61,11,746,"6,980.36",6436
,20130306,6288,6238,6272,6290,6248,6256,6267,18,29,1384,"13,010.76",6698
,20130307,6256,6267,6280,6298,6256,6269,6269,2,2,732,"6,884.43",6782
,20130308,6269,6269,6257,6262,6220,6235,6237,-34,-32,624,"5,837.84",6800
,20130311,6235,6237,6272,6283,6249,6275,6269,38,32,586,"5,510.50",6890
,20130312,6275,6269,6276,6276,6233,6233,6258,-36,-11,768,"7,209.57",6798
,20130313,6233,6258,6314,6314,6260,6272,6275,14,17,2074,"19,522.54",7368
,20130314,6272,6275,6230,6231,6130,6200,6186,-75,-89,3220,"29,881.65",8562
,20130315,6200,6186,6201,6230,6177,6217,6200,31,14,1724,"16,035.28",8570
,20130318,6217,6200,6229,6229,6125,6162,6162,-38,-38,3710,"34,294.02",9076
,20130319,6162,6162,6189,6208,6168,6175,6192,13,30,1328,"12,334.84",9150
,20130320,6175,6192,6188,6209,6172,6199,6190,7,-2,2020,"18,757.99",9126
,20130321,6199,6190,6160,6206,6158,6196,6188,6,-2,1932,"17,933.54",9552
,20130322,6196,6188,6233,6259,6216,6231,6230,43,42,2468,"23,066.47",9248
,20130325,6231,6230,6165,6198,6159,6163,6177,-67,-53,2298,"21,292.81",10002
,20130326,6163,6177,6176,6180,6120,6155,6162,-22,-15,1766,"16,324.43",10380
,20130327,6155,6162,6165,6168,6025,6034,6090,-128,-72,6048,"55,255.39",11896
,20130328,6034,6090,6108,6151,6096,6120,6126,30,36,6834,"62,798.27",13208
,20130329,6120,6126,6038,6051,5982,6013,6010,-113,-116,6312,"56,908.85",14454
,20130401,6013,6010,6013,6019,5914,5915,5972,-95,-38,8684,"77,794.40",16032
,20130402,5915,5972,5961,5976,5923,5942,5949,-30,-23,6442,"57,489.82",16182
,20130403,5942,5949,5780,5800,5707,5716,5739,-233,-210,15066,"129,708.89",20200
,20130408,5716,5739,5780,5804,5752,5797,5772,58,33,14774,"127,919.82",22610
,20130409,5797,5772,5767,5836,5767,5835,5813,63,41,13184,"114,959.35",23808
,20130410,5835,5813,5923,5935,5903,5935,5919,122,106,13746,"122,046.93",25576
,20130411,5935,5919,5825,5859,5820,5833,5838,-86,-81,13770,"120,595.97",26000
,20130412,5833,5838,5859,5859,5836,5850,5849,12,11,8808,"77,279.92",28188
,20130415,5850,5849,5498,5498,5498,5498,5498,-351,-351,5110,"42,142.17",29450
,20130416,5498,5498,5003,5020,5003,5003,5004,-495,-494,23130,"173,615.22",35022
,20130417,5003,5004,5004,5048,4901,4930,4974,-74,-30,91956,"686,173.35",49816
,20130418,4930,4974,4833,4904,4691,4851,4803,-123,-171,91360,"658,322.05",51506
,20130419,4851,4803,4848,5000,4837,4939,4914,136,111,71076,"523,957.93",50930
,20130422,4939,4914,4900,4947,4871,4895,4917,-19,3,58616,"432,323.51",59356
,20130423,4895,4917,4890,4910,4701,4740,4796,-177,-121,102022,"734,079.65",73930
,20130424,4740,4796,4770,4858,4728,4835,4790,39,-6,119578,"859,306.73",75960
,20130425,4835,4790,4835,4882,4805,4833,4841,43,51,82648,"600,182.15",73034
,20130426,4833,4841,5179,5179,5012,5032,5094,191,253,130476,"997,098.14",72076
,20130502,5032,5094,4900,4903,4800,4864,4844,-230,-250,115008,"835,676.89",89716
,20130503,4864,4844,4887,4988,4860,4985,4938,141,94,187570,"1,389,341.29",102922
,20130506,4985,4938,5028,5054,4950,4968,4989,30,51,205634,"1,539,074.63",120924
,20130507,4968,4989,4932,4945,4789,4802,4856,-187,-133,543370,"3,958,187.69",202412
,20130508,4802,4856,4860,4904,4832,4882,4866,26,10,456092,"3,329,016.54",192834
,20130509,4882,4866,4860,4965,4858,4928,4928,62,62,503712,"3,723,969.11",165516
,20130510,4928,4928,4850,4920,4830,4919,4878,-9,-50,387560,"2,836,057.89",174654
,20130513,4919,4878,4890,4925,4840,4846,4870,-32,-8,448140,"3,274,288.12",191524
,20130514,4846,4870,4880,4898,4846,4851,4874,-19,4,359648,"2,629,821.62",197280
,20130515,4851,4874,4801,4818,4693,4701,4760,-173,-114,552498,"3,945,172.21",258702
,20130516,4701,4760,4659,4690,4624,4656,4657,-104,-103,570488,"3,985,165.58",275932
,20130517,4656,4657,4671,4696,4625,4632,4659,-25,2,558146,"3,900,738.21",285722
,20130520,4632,4659,4450,4535,4383,4422,4447,-237,-212,842816,"5,623,103.91",286228
,20130521,4422,4447,4650,4698,4581,4664,4632,217,185,802662,"5,577,497.91",237546
,20130522,4664,4632,4640,4662,4602,4650,4631,18,-1,479390,"3,330,688.60",228884
,20130523,4650,4631,4558,4585,4515,4579,4548,-52,-83,561584,"3,831,668.18",235464
,20130524,4579,4548,4600,4636,4568,4603,4602,55,54,464634,"3,207,541.90",230814
,20130527,4603,4602,4572,4654,4560,4644,4619,42,17,352650,"2,443,524.59",229820
,20130528,4644,4619,4618,4644,4605,4611,4621,-8,2,327356,"2,269,078.58",225094
,20130529,4611,4621,4603,4615,4542,4544,4575,-77,-46,523550,"3,593,424.38",248654
,20130530,4544,4575,4580,4646,4570,4633,4615,58,40,479300,"3,318,259.99",226530
,20130531,4633,4615,4649,4687,4641,4668,4668,53,53,327216,"2,291,209.48",205674
,20130603,4668,4668,4610,4624,4580,4601,4599,-67,-69,296834,"2,047,884.48",207604
,20130604,4601,4599,4656,4665,4617,4625,4639,26,40,235944,"1,641,936.04",210678
,20130605,4625,4639,4616,4644,4592,4627,4618,-12,-21,277668,"1,923,606.98",210758
,20130606,4627,4618,4610,4616,4570,4582,4595,-36,-23,226454,"1,561,085.46",212580
,20130607,4582,4595,4638,4664,4625,4633,4645,38,50,260218,"1,813,296.73",184518
,20130613,4633,4645,4463,4510,4460,4493,4490,-152,-155,215416,"1,451,104.18",190272
,20130614,4493,4490,4490,4494,4452,4465,4468,-25,-22,210800,"1,412,802.06",203200
,20130617,4465,4468,4501,4515,4491,4492,4502,24,34,149758,"1,011,432.54",200076
,20130618,4492,4502,4490,4499,4462,4473,4480,-29,-22,187186,"1,257,929.39",220982
,20130619,4473,4480,4460,4469,4421,4464,4443,-16,-37,236998,"1,579,523.22",227010
,20130620,4464,4443,4368,4376,4228,4293,4341,-150,-102,298892,"1,946,449.19",250684
,20130621,4293,4341,4080,4120,4080,4082,4082,-259,-259,304670,"1,865,609.10",241040
,20130624,4082,4082,4122,4130,3984,3998,4052,-84,-30,500922,"3,045,355.08",249028
,20130625,3998,4052,4020,4045,3981,4022,4017,-30,-35,442052,"2,663,731.72",239350
,20130626,4022,4017,4006,4011,3797,3856,3870,-161,-147,1142838,"6,634,370.53",290462
,20130627,3856,3870,3832,3874,3795,3838,3837,-32,-33,849368,"4,888,969.18",281474
,20130628,3838,3837,3769,3865,3710,3839,3806,2,-31,1111408,"6,346,356.25",272408
,20130701,3839,3806,3955,4034,3926,4034,3992,228,186,896516,"5,369,094.29",247566
,20130702,4034,3992,4030,4044,3990,4038,4017,46,25,647658,"3,903,187.67",247418
,20130703,4038,4017,3998,4019,3971,4006,3996,-11,-21,586626,"3,516,361.28",241134
,20130704,4006,3996,4036,4040,4005,4008,4019,12,23,342352,"2,063,905.81",233452
,20130705,4008,4019,4000,4008,3892,3918,3933,-101,-86,917482,"5,413,795.20",283586
,20130708,3918,3933,3869,3874,3812,3826,3843,-107,-90,1939664,"11,181,820.64",295128
,20130709,3826,3843,3900,3985,3872,3940,3916,97,73,1773534,"10,418,482.07",293266
,20130710,3940,3916,3917,3932,3866,3904,3906,-12,-10,1997926,"11,708,669.44",298810
,20130711,3904,3906,3924,4140,3890,4076,4007,170,101,2227978,"13,391,717.49",312686
,20130712,4076,4007,4089,4103,4019,4031,4070,24,63,1985888,"12,126,028.45",309352
,20130715,4031,4070,4033,4110,4030,4050,4057,-20,-13,1938500,"11,799,306.22",316494
,20130716,4050,4057,4034,4060,4006,4044,4038,-13,-19,1565754,"9,485,719.64",301828
,20130717,4044,4038,4060,4077,4032,4049,4056,11,18,1512418,"9,203,459.57",283814
,20130718,4049,4056,4072,4093,3914,3939,3988,-117,-68,2875250,"17,202,864.24",344550
,20130719,3939,3988,3963,3992,3912,3942,3953,-46,-35,3087694,"18,309,831.90",343310
,20130722,3942,3953,3953,4072,3945,4052,3996,99,43,2064822,"12,378,126.65",328462
,20130723,4052,3996,4122,4134,4079,4088,4111,92,115,1995634,"12,307,019.43",308580
,20130724,4088,4111,4068,4119,4065,4100,4088,-11,-23,1492750,"9,155,714.62",316984
,20130725,4100,4088,4070,4086,4040,4059,4066,-29,-22,1668404,"10,177,345.27",314184
,20130726,4059,4066,4068,4086,4051,4056,4068,-10,2,1051696,"6,418,275.02",298806
,20130729,4056,4068,4010,4030,3953,3960,3988,-108,-80,1780284,"10,649,782.81",348344
,20130730,3960,3988,3995,3995,3947,3951,3972,-37,-16,1271962,"7,579,883.69",361666
,20130731,3951,3972,3964,4009,3935,3990,3963,18,-9,1438120,"8,549,106.23",334168
,20130801,3990,3963,3961,3979,3911,3941,3940,-22,-23,2428990,"14,355,968.49",355080
,20130802,3941,3940,3968,3969,3869,3887,3932,-53,-8,1928122,"11,373,590.14",378464
,20130805,3887,3932,4018,4030,3972,3991,3990,59,58,1808828,"10,826,584.76",341410
,20130806,3991,3990,3950,3964,3927,3945,3950,-45,-40,1154302,"6,839,643.18",364330
,20130807,3945,3950,3946,3947,3892,3918,3923,-32,-27,1056722,"6,218,399.75",370348
,20130808,3918,3923,3900,4005,3897,3972,3946,49,23,1369088,"8,104,550.48",363770
,20130809,3972,3946,4003,4088,3991,4046,4042,100,96,2204684,"13,367,384.44",374752
,20130812,4046,4042,4055,4279,4047,4259,4155,217,113,3397322,"21,177,676.31",413778
,20130813,4259,4155,4249,4383,4249,4355,4300,200,145,2750170,"17,742,408.77",466774
,20130814,4355,4300,4357,4378,4300,4308,4330,8,30,4039498,"26,242,348.43",478218
,20130815,4308,4330,4358,4474,4326,4431,4385,101,55,3774164,"24,828,980.48",474152
,20130816,4431,4385,4385,4648,4376,4628,4512,243,127,4233794,"28,656,996.45",443220
,20130819,4628,4512,4620,4759,4610,4650,4675,138,163,5088030,"35,683,795.61",464844
,20130820,4650,4675,4650,4671,4455,4533,4604,-142,-71,5042070,"34,820,818.48",464134
,20130821,4533,4604,4610,4654,4555,4597,4611,-7,7,4948762,"34,234,344.24",469890
,20130822,4597,4611,4611,4625,4528,4592,4589,-19,-22,4599914,"31,666,308.91",484708
,20130823,4592,4589,4628,4668,4591,4645,4637,56,48,3426000,"23,832,599.32",470834
,20130826,4645,4637,4638,4913,4635,4904,4794,267,157,5119342,"36,813,988.73",475770
,20130827,4904,4794,4896,4985,4851,4914,4912,120,118,5141320,"37,881,326.27",500642
,20130828,4914,4912,4990,5103,4971,5062,5015,150,103,4964648,"37,347,369.30",572410
,20130829,5062,5015,5066,5085,4736,4848,4896,-167,-119,6379402,"46,853,493.61",446092
,20130830,4848,4896,4866,4866,4736,4760,4801,-136,-95,5609278,"40,401,722.41",478076
,20130902,4760,4801,4730,4936,4685,4903,4770,102,-31,5498110,"39,345,619.41",495464
,20130903,4903,4770,4901,4919,4846,4882,4892,112,122,3789120,"27,804,612.58",505264
,20130904,4882,4892,4945,4966,4796,4847,4901,-45,9,4064880,"29,885,771.47",560402
,20130905,4847,4901,4760,4790,4672,4717,4734,-184,-167,3873272,"27,507,456.91",544046
,20130906,4717,4734,4734,4739,4662,4719,4701,-15,-33,4127394,"29,106,668.11",554414
,20130909,4719,4701,4800,4840,4782,4821,4817,120,116,3240356,"23,413,703.41",514166
,20130910,4821,4817,4776,4821,4703,4738,4771,-79,-46,3133352,"22,424,367.56",544340
,20130911,4738,4771,4682,4714,4606,4684,4655,-87,-116,3805662,"26,574,262.76",544422
,20130912,4684,4655,4668,4692,4604,4606,4662,-49,7,2774396,"19,404,929.39",555910
,20130913,4606,4662,4450,4489,4382,4415,4453,-247,-209,3534604,"23,610,794.07",485938
,20130916,4415,4453,4443,4512,4379,4414,4439,-39,-14,3789360,"25,234,817.87",533336
,20130917,4414,4439,4405,4478,4401,4455,4446,16,7,3682646,"24,562,194.81",535920
,20130918,4455,4446,4422,4443,4337,4419,4394,-27,-52,3723242,"24,540,574.57",472906
,20130923,4419,4394,4400,4426,4215,4396,4365,2,-29,1706022,"11,172,287.15",463634
,20130924,4396,4365,4391,4468,4385,4392,4421,27,56,3469360,"23,008,436.40",488268
,20130925,4392,4421,4325,4437,4316,4409,4383,-12,-38,3210934,"21,111,224.51",483276
,20130926,4409,4383,4383,4443,4379,4398,4410,15,27,2829900,"18,723,193.79",443136
,20130927,4398,4410,4432,4433,4358,4362,4399,-48,-11,2117576,"13,973,492.58",395604
,20130930,4362,4399,4410,4418,4374,4400,4402,1,3,1342150,"8,863,251.07",314850
,20131008,4400,4402,4490,4545,4473,4532,4513,130,111,863480,"5,845,622.17",359980
,20131009,4532,4513,4532,4553,4506,4516,4533,3,20,1806840,"12,285,957.46",417220
,20131010,4516,4533,4438,4466,4423,4437,4444,-96,-89,1773790,"11,825,171.11",418980
,20131011,4437,4444,4443,4454,4364,4367,4417,-77,-27,1823428,"12,082,604.80",461552
,20131014,4367,4417,4305,4348,4282,4331,4313,-86,-104,2306044,"14,919,940.23",465370
,20131015,4331,4313,4355,4361,4260,4279,4317,-34,4,2030902,"13,152,022.05",503742
,20131016,4279,4317,4247,4335,4246,4329,4298,12,-19,2678470,"17,269,818.39",478422
,20131017,4329,4298,4324,4383,4280,4281,4321,-17,23,3397410,"22,021,675.35",486870
,20131018,4281,4321,4410,4431,4378,4430,4400,109,79,2315668,"15,286,866.58",431834
,20131021,4430,4400,4430,4508,4413,4496,4451,96,51,1885758,"12,591,194.73",466234
,20131022,4496,4451,4497,4517,4461,4477,4493,26,42,1854220,"12,498,317.52",457564
,20131023,4477,4493,4518,4605,4513,4578,4572,85,79,2799262,"19,198,588.18",476372
,20131024,4578,4572,4585,4597,4550,4584,4570,12,-2,2160304,"14,809,430.22",455274
,20131025,4584,4570,4581,4595,4494,4512,4562,-58,-8,1956162,"13,386,089.12",368684
,20131028,4512,4562,4508,4555,4475,4517,4514,-45,-48,2382762,"16,136,719.41",379528
,20131029,4517,4514,4517,4537,4497,4534,4518,20,4,1832958,"12,424,034.97",370668
,20131030,4534,4518,4520,4573,4492,4563,4528,45,10,1973714,"13,405,829.91",407518
,20131031,4563,4528,4600,4636,4457,4483,4556,-45,28,2674172,"18,278,212.03",319214
,20131101,4483,4556,4395,4434,4383,4412,4414,-144,-142,1662600,"11,009,642.13",303770
,20131104,4412,4414,4401,4413,4366,4375,4394,-39,-20,1463956,"9,649,214.65",316190
,20131105,4375,4394,4400,4413,4351,4374,4381,-20,-13,1247130,"8,196,765.06",298924
,20131106,4374,4381,4380,4392,4361,4387,4374,6,-7,1090478,"7,156,192.17",309362
,20131107,4387,4374,4420,4425,4380,4416,4402,42,28,1097966,"7,249,893.95",300662
,20131108,4416,4402,4434,4438,4310,4385,4371,-17,-31,1923370,"12,612,906.57",281928
,20131111,4385,4371,4387,4419,4311,4325,4341,-46,-30,2084728,"13,575,440.45",319704
,20131112,4325,4341,4321,4332,4263,4300,4306,-41,-35,1200020,"7,751,482.06",329096
,20131113,4300,4306,4300,4309,4203,4233,4259,-73,-47,1642810,"10,496,361.04",349446
,20131114,4233,4259,4245,4282,4205,4257,4235,-2,-24,1788150,"11,361,642.59",333870
,20131115,4257,4235,4243,4273,4229,4242,4253,7,18,1593220,"10,166,111.99",331208
,20131118,4242,4253,4245,4255,4224,4244,4243,-9,-10,1010004,"6,428,701.49",295596
,20131119,4244,4243,4220,4232,4157,4184,4198,-59,-45,1248374,"7,862,744.11",313452
,20131120,4184,4198,4200,4233,4184,4227,4200,29,2,1260504,"7,941,905.43",299168
,20131121,4227,4200,4202,4220,4123,4146,4182,-54,-18,1534776,"9,629,376.97",256518
,20131122,4146,4182,4155,4167,4133,4146,4147,-36,-35,986980,"6,140,749.24",233232
,20131125,4146,4147,4150,4165,4092,4098,4137,-49,-10,874790,"5,429,607.63",240300
,20131126,4098,4137,4117,4181,4096,4169,4133,32,-4,930452,"5,768,699.92",166420
,20131127,4169,4133,4145,4158,4137,4154,4149,21,16,559096,"3,480,056.72",143514
,20131128,4154,4149,4155,4164,4120,4136,4142,-13,-7,384024,"2,386,482.89",111684
,20131129,4136,4142,4143,4143,4101,4102,4125,-40,-17,157116,"972,262.24",67874
,20131202,4102,4125,4143,4147,4098,4115,4125,-10,0,58210,"360,218.52",44552
,20131203,4115,4125,4099,4099,3877,4025,4048,-100,-77,25120,"152,549.26",37744
,20131204,4025,4048,4021,4025,3980,3999,4002,-49,-46,15136,"90,865.27",35644
,20131205,3999,4002,4008,4080,3886,4048,4037,46,35,14956,"90,586.13",32552
,20131206,4048,4037,4027,4066,4008,4047,4034,10,-3,8184,"49,521.88",30228
,20131209,4047,4034,4043,4084,3997,4053,4050,19,16,8600,"52,254.15",27452
,20131210,4053,4050,4058,4120,4057,4112,4076,62,26,9992,"61,099.40",25200
,20131211,4112,4076,4180,4200,4124,4156,4161,80,85,8816,"55,027.54",23868
,20131212,4156,4161,4157,4262,4112,4262,4161,101,0,1628,"10,163.24",23396
,20131213,4262,4161,4099,4099,4000,4010,4040,-151,-121,916,"5,552.32",23256
,20131216,4010,4040,4020,4025,4015,4022,4018,-18,-22,1952,"11,767.51",22588
ag1401,20130116,6757,6757,6830,6830,6830,6830,6830,73,73,2,20.49,2
,20130117,6830,6830,6850,6850,6850,6850,6850,20,20,2,20.55,4
,20130118,6850,6850,6942,6942,6899,6899,6920,49,70,4,41.52,6
,20130121,6899,6920,,,,6961,6961,41,41,0,0,6
,20130122,6961,6961,,,,6929,6929,-32,-32,0,0,6
,20130123,6929,6929,,,,6927,6927,-2,-2,0,0,6
,20130124,6927,6927,,,,6861,6861,-66,-66,0,0,6
,20130125,6861,6861,6799,6799,6787,6789,6792,-72,-69,12,122.27,10
,20130128,6789,6792,,,,6732,6732,-60,-60,0,0,10
,20130129,6732,6732,6711,6711,6711,6711,6711,-21,-21,2,20.13,10
,20130130,6711,6711,,,,6711,6711,0,0,0,0,10
,20130131,6711,6711,6860,6873,6860,6873,6866,162,155,4,41.2,10
,20130201,6873,6866,,,,6772,6772,-94,-94,0,0,10
,20130204,6772,6772,,,,6772,6772,0,0,0,0,10
,20130205,6772,6772,6772,6829,6772,6812,6809,40,37,30,306.41,24
,20130206,6812,6809,,,,6809,6809,0,0,0,0,24
,20130207,6809,6809,6830,6830,6830,6830,6830,21,21,4,40.98,24
,20130208,6830,6830,,,,6830,6830,0,0,0,0,24
,20130218,6830,6830,6497,6497,6497,6497,6497,-333,-333,2,19.49,22
,20130219,6497,6497,6700,6700,6471,6495,6529,-2,32,10,97.94,26
,20130220,6495,6529,6412,6412,6398,6403,6403,-126,-126,14,134.47,36
,20130221,6403,6403,6179,6183,6146,6167,6171,-236,-232,58,536.92,78
,20130222,6167,6171,6219,6386,6219,6270,6302,99,131,36,340.31,88
,20130225,6270,6302,6269,6299,6258,6264,6270,-38,-32,14,131.68,86
,20130226,6264,6270,6283,6283,6283,6283,6283,13,13,2,18.85,86
,20130227,6283,6283,6377,6377,6327,6327,6352,44,69,4,38.11,84
,20130228,6327,6352,,,,6324,6324,-28,-28,0,0,84
,20130301,6324,6324,6250,6250,6186,6225,6224,-99,-100,28,261.42,74
,20130304,6225,6224,6259,6259,6241,6254,6247,30,23,14,131.2,76
,20130305,6254,6247,,,,6247,6247,0,0,0,0,76
,20130306,6247,6247,6294,6300,6294,6300,6296,53,49,6,56.66,74
,20130307,6300,6296,6311,6311,6311,6311,6311,15,15,2,18.93,74
,20130308,6311,6311,6269,6269,6269,6269,6269,-42,-42,2,18.81,72
,20130311,6269,6269,6306,6321,6306,6315,6313,46,44,10,94.7,74
,20130312,6315,6313,6313,6313,6301,6301,6307,-12,-6,4,37.84,74
,20130313,6301,6307,6310,6310,6299,6299,6304,-8,-3,4,37.83,70
,20130314,6299,6304,6258,6258,6225,6244,6240,-60,-64,18,168.5,70
,20130315,6244,6240,6238,6251,6224,6246,6235,6,-5,36,336.71,74
,20130318,6246,6235,6220,6221,6187,6187,6206,-48,-29,28,260.69,62
,20130319,6187,6206,6219,6219,6219,6219,6219,13,13,4,37.31,62
,20130320,6219,6219,6223,6233,6223,6233,6226,14,7,6,56.04,64
,20130321,6233,6226,6220,6250,6220,6224,6226,-2,0,18,168.12,66
,20130322,6224,6226,6256,6256,6256,6256,6256,30,30,2,18.77,68
,20130325,6256,6256,,,,6256,6256,0,0,0,0,68
,20130326,6256,6256,,,,6256,6256,0,0,0,0,68
,20130327,6256,6256,6190,6190,6173,6173,6181,-83,-75,4,37.09,68
,20130328,6173,6181,6168,6168,6142,6163,6159,-18,-22,8,73.91,70
,20130329,6163,6159,5988,6053,5988,6048,6030,-111,-129,10,90.45,64
,20130401,6048,6030,6042,6042,5995,5995,6005,-35,-25,28,252.21,72
,20130402,5995,6005,5980,5980,5980,5980,5980,-25,-25,2,17.94,72
,20130403,5980,5980,5810,5810,5742,5754,5769,-226,-211,54,467.3,78
,20130408,5754,5769,5765,5810,5765,5810,5798,41,29,18,156.56,74
,20130409,5810,5798,5882,5882,5827,5827,5851,29,53,12,105.32,74
,20130410,5827,5851,5934,5948,5913,5946,5935,95,84,46,409.55,64
,20130411,5946,5935,5875,5880,5861,5871,5871,-64,-64,12,105.68,66
,20130412,5871,5871,5869,5878,5869,5878,5873,7,2,10,88.11,66
,20130415,5878,5873,5520,5520,5520,5520,5520,-353,-353,2,16.56,66
,20130416,5520,5520,5023,5053,5023,5036,5025,-484,-495,50,376.94,80
,20130417,5036,5025,5050,5060,4920,4939,4992,-86,-33,198,"1,482.70",142
,20130418,4939,4992,4807,4897,4722,4864,4821,-128,-171,228,"1,648.86",166
,20130419,4864,4821,4849,5006,4849,4950,4946,129,125,204,"1,513.68",132
,20130422,4950,4946,4900,4960,4900,4938,4924,-8,-22,82,605.66,144
,20130423,4938,4924,4900,4923,4683,4749,4811,-175,-113,160,"1,154.82",146
,20130424,4749,4811,4771,4857,4771,4850,4828,39,17,126,912.65,146
,20130425,4850,4828,4839,4904,4838,4874,4850,46,22,116,844.04,120
,20130426,4874,4850,5187,5189,5058,5071,5153,221,303,196,"1,515.23",114
,20130502,5071,5153,4889,4909,4827,4883,4865,-270,-288,68,496.27,102
,20130503,4883,4865,4905,5000,4905,5000,4976,135,111,46,343.41,88
,20130506,5000,4976,5010,5024,5009,5024,5015,48,39,20,150.47,100
,20130507,5024,5015,4921,4929,4810,4813,4844,-202,-171,216,"1,569.75",138
,20130508,4813,4844,4848,4908,4830,4907,4886,63,42,124,908.85,112
,20130509,4907,4886,4899,4976,4893,4953,4942,67,56,178,"1,319.67",106
,20130510,4953,4942,4753,4941,4753,4941,4893,-1,-49,186,"1,365.33",138
,20130513,4941,4893,4887,4916,4865,4873,4892,-20,-1,134,983.48,138
,20130514,4873,4892,4889,4915,4889,4897,4902,5,10,34,250.03,126
,20130515,4897,4902,4833,4838,4721,4729,4791,-173,-111,44,316.23,138
,20130516,4729,4791,4707,4707,4647,4667,4676,-124,-115,112,785.6,148
,20130517,4667,4676,4694,4694,4641,4649,4671,-27,-5,34,238.24,142
,20130520,4649,4671,4519,4549,4413,4446,4466,-225,-205,308,"2,063.71",200
,20130521,4446,4466,4659,4702,4568,4686,4652,220,186,226,"1,577.31",196
,20130522,4686,4652,4640,4662,4626,4652,4645,0,-7,32,222.98,196
,20130523,4652,4645,4560,4576,4535,4576,4553,-69,-92,48,327.87,202
,20130524,4576,4553,4597,4646,4585,4623,4621,70,68,56,388.19,228
,20130527,4623,4621,4590,4658,4590,4653,4621,32,0,64,443.69,244
,20130528,4653,4621,4631,4654,4626,4626,4638,5,17,14,97.4,244
,20130529,4626,4638,4628,4635,4567,4580,4598,-58,-40,230,"1,586.36",300
,20130530,4580,4598,4598,4659,4598,4649,4630,51,32,260,"1,805.80",320
,20130531,4649,4630,4664,4694,4656,4681,4672,51,42,188,"1,317.59",320
,20130603,4681,4672,4631,4634,4600,4620,4618,-52,-54,152,"1,053.13",306
,20130604,4620,4618,4728,4728,4631,4639,4653,21,35,82,572.4,310
,20130605,4639,4653,4615,4639,4612,4639,4619,-14,-34,32,221.75,312
,20130606,4639,4619,4620,4626,4596,4597,4605,-22,-14,78,538.83,312
,20130607,4597,4605,4656,4671,4649,4657,4658,52,53,264,"1,844.66",314
,20130613,4657,4658,4485,4516,4485,4511,4509,-147,-149,116,784.59,334
,20130614,4511,4509,4574,4574,4477,4480,4489,-29,-20,110,740.7,322
,20130617,4480,4489,4513,4534,4511,4518,4523,29,34,50,339.3,320
,20130618,4518,4523,4517,4518,4481,4487,4491,-36,-32,38,256.01,328
,20130619,4487,4491,4531,4531,4450,4464,4474,-27,-17,68,456.42,338
,20130620,4464,4474,4283,4411,4283,4312,4340,-162,-134,180,"1,172.07",384
,20130621,4312,4340,4079,4126,4079,4103,4093,-237,-247,692,"4,249.46",506
,20130624,4103,4093,4152,4152,4008,4015,4084,-78,-9,398,"2,438.51",508
,20130625,4015,4084,4036,4061,4005,4050,4041,-34,-43,358,"2,170.48",486
,20130626,4050,4041,4021,4021,3827,3860,3893,-181,-148,718,"4,193.35",526
,20130627,3860,3893,3839,3896,3803,3865,3851,-28,-42,940,"5,430.76",526
,20130628,3865,3851,3754,3883,3726,3854,3788,3,-63,2120,"12,047.57",556
,20130701,3854,3788,3993,4015,3949,4015,3996,227,208,764,"4,579.66",626
,20130702,4015,3996,4055,4061,4010,4058,4037,62,41,764,"4,627.41",588
,20130703,4058,4037,4025,4036,3990,4022,4017,-15,-20,852,"5,134.72",586
,20130704,4022,4017,4059,4059,4031,4031,4044,14,27,592,"3,591.92",570
,20130705,4031,4044,4009,4033,3916,3943,3950,-101,-94,1866,"11,056.74",714
,20130708,3943,3950,3902,3902,3830,3835,3868,-115,-82,5972,"34,651.97",1298
,20130709,3835,3868,3900,4003,3891,3961,3933,93,65,4174,"24,629.03",1214
,20130710,3961,3933,3934,3949,3886,3920,3924,-13,-9,4164,"24,514.85",1180
,20130711,3920,3924,3937,4159,3915,4091,4080,167,156,6836,"41,845.62",1388
,20130712,4091,4080,4100,4123,4040,4054,4086,-26,6,4128,"25,304.30",1486
,20130715,4054,4086,4053,4126,4050,4066,4080,-20,-6,4368,"26,732.87",1604
,20130716,4066,4080,4049,4077,4027,4067,4056,-13,-24,3458,"21,042.62",2164
,20130717,4067,4056,4074,4095,4054,4072,4077,16,21,4098,"25,062.32",1644
,20130718,4072,4077,4086,4112,3932,3958,4004,-119,-73,6376,"38,298.11",2544
,20130719,3958,4004,3981,4012,3935,3961,3976,-43,-28,8686,"51,811.38",2350
,20130722,3961,3976,3966,4090,3965,4077,4028,101,52,6072,"36,688.11",1982
,20130723,4077,4028,4170,4170,4095,4109,4127,81,99,4918,"30,447.55",1922
,20130724,4109,4127,4084,4134,4082,4116,4108,-11,-19,3500,"21,569.84",1932
,20130725,4116,4108,4100,4104,4060,4084,4080,-24,-28,4538,"27,772.83",2878
,20130726,4084,4080,4088,4102,4066,4068,4084,-12,4,3372,"20,657.19",2020
,20130729,4068,4084,4019,4044,3969,3972,3998,-112,-86,3924,"23,532.63",1976
,20130730,3972,3998,4013,4013,3965,3966,3984,-32,-14,3978,"23,777.21",2104
,20130731,3966,3984,3973,4022,3942,4008,3983,24,-1,4646,"27,757.69",3010
,20130801,4008,3983,3969,3988,3928,3958,3956,-25,-27,9626,"57,127.75",3898
,20130802,3958,3956,3985,3985,3886,3896,3934,-60,-22,4874,"28,765.82",4046
,20130805,3896,3934,4034,4039,3985,4007,4010,73,76,7864,"47,303.82",5228
,20130806,4007,4010,3966,3977,3941,3961,3963,-49,-47,4606,"27,381.14",5796
,20130807,3961,3963,3958,3959,3908,3931,3930,-32,-33,4012,"23,653.86",6260
,20130808,3931,3930,3921,4015,3915,3986,3965,56,35,4394,"26,138.42",6264
,20130809,3986,3965,4011,4098,3995,4060,4055,95,90,8516,"51,808.25",6634
,20130812,4060,4055,4066,4280,4058,4264,4200,209,145,15944,"100,458.26",8398
,20130813,4264,4200,4255,4389,4251,4361,4306,161,106,12988,"83,893.94",9128
,20130814,4361,4306,4354,4385,4310,4315,4341,9,35,16424,"106,954.62",9618
,20130815,4315,4341,4352,4480,4333,4438,4416,97,75,18994,"125,820.90",10824
,20130816,4438,4416,4395,4680,4380,4630,4578,214,162,31294,"214,912.85",13284
,20130819,4630,4578,4624,4849,4614,4656,4694,78,116,38088,"268,194.78",13884
,20130820,4656,4694,4654,4677,4450,4532,4570,-162,-124,53506,"366,790.64",17506
,20130821,4532,4570,4604,4646,4556,4595,4604,25,34,45086,"311,366.89",18436
,20130822,4595,4604,4608,4621,4528,4601,4586,-3,-18,45956,"316,193.70",16828
,20130823,4601,4586,4617,4673,4598,4655,4640,69,54,33088,"230,340.60",16370
,20130826,4655,4640,4653,4915,4642,4911,4817,271,177,49178,"355,361.38",17604
,20130827,4911,4817,4900,4988,4863,4922,4917,105,100,53426,"394,107.14",16782
,20130828,4922,4917,4992,5106,4983,5061,5028,144,111,66844,"504,193.71",19254
,20130829,5061,5028,5068,5087,4742,4854,4901,-174,-127,79816,"586,779.22",18806
,20130830,4854,4901,4871,4871,4741,4762,4805,-139,-96,66264,"477,604.01",18226
,20130902,4762,4805,4730,4943,4692,4913,4807,108,2,88518,"638,385.87",24094
,20130903,4913,4807,4914,4927,4854,4890,4898,83,91,55500,"407,773.31",23688
,20130904,4890,4898,4950,4971,4804,4855,4891,-43,-7,63782,"467,938.19",23144
,20130905,4855,4891,4770,4796,4681,4721,4740,-170,-151,49758,"353,810.21",22916
,20130906,4721,4740,4742,4745,4672,4728,4709,-12,-31,54006,"381,549.80",22934
,20130909,4728,4709,4800,4845,4788,4826,4822,117,113,52556,"380,153.12",23742
,20130910,4826,4822,4780,4826,4709,4743,4771,-79,-51,42062,"301,052.24",23720
,20130911,4743,4771,4696,4716,4614,4693,4662,-78,-109,50070,"350,179.83",23188
,20130912,4693,4662,4677,4698,4612,4612,4662,-50,0,38392,"268,529.55",24156
,20130913,4612,4662,4474,4496,4400,4425,4453,-237,-209,56214,"375,538.70",24718
,20130916,4425,4453,4441,4521,4393,4424,4462,-29,9,61388,"410,874.94",24612
,20130917,4424,4462,4420,4487,4417,4464,4452,2,-10,47508,"317,290.46",24394
,20130918,4464,4452,4439,4451,4350,4430,4396,-22,-56,55808,"368,010.86",24156
,20130923,4430,4396,4409,4436,4301,4407,4370,11,-26,33690,"220,863.02",24598
,20130924,4407,4370,4400,4476,4396,4403,4430,33,60,49972,"332,075.37",25364
,20130925,4403,4430,4350,4444,4320,4418,4395,-12,-35,46588,"307,159.36",25226
,20130926,4418,4395,4386,4448,4386,4405,4416,10,21,44556,"295,172.96",23716
,20130927,4405,4416,4438,4439,4373,4380,4402,-36,-14,28036,"185,146.27",23128
,20130930,4380,4402,4423,4428,4383,4409,4410,7,8,22220,"147,010.10",21926
,20131008,4409,4410,4490,4550,4485,4540,4520,130,110,26918,"182,510.54",23272
,20131009,4540,4520,4537,4561,4513,4526,4538,6,18,36000,"245,090.95",25030
,20131010,4526,4538,4448,4474,4432,4450,4453,-88,-85,34288,"229,057.98",26342
,20131011,4450,4453,4460,4465,4377,4382,4421,-71,-32,39228,"260,192.26",29404
,20131014,4382,4421,4333,4361,4298,4347,4326,-74,-95,46030,"298,728.05",32296
,20131015,4347,4326,4369,4375,4278,4295,4322,-31,-4,48802,"316,386.35",36562
,20131016,4295,4322,4272,4348,4263,4342,4316,20,-6,61780,"400,018.11",36352
,20131017,4342,4316,4338,4391,4281,4292,4332,-24,16,70094,"455,549.46",37714
,20131018,4292,4332,4414,4439,4387,4436,4407,104,75,58366,"385,908.80",34888
,20131021,4436,4407,4431,4515,4420,4505,4466,98,59,63234,"423,680.97",36488
,20131022,4505,4466,4509,4528,4470,4487,4499,21,33,57626,"388,955.99",38398
,20131023,4487,4499,4534,4611,4527,4586,4580,87,81,81628,"560,793.16",42996
,20131024,4586,4580,4589,4601,4559,4593,4579,13,-1,59720,"410,257.55",42810
,20131025,4593,4579,4589,4602,4502,4518,4560,-61,-19,66308,"453,596.22",37650
,20131028,4518,4560,4520,4559,4485,4528,4521,-32,-39,72582,"492,257.98",39400
,20131029,4528,4521,4531,4555,4514,4551,4533,30,12,76108,"517,579.94",49858
,20131030,4551,4533,4541,4586,4511,4574,4544,41,11,87964,"599,619.27",56212
,20131031,4574,4544,4614,4646,4466,4486,4529,-58,-15,144060,"978,692.35",59070
,20131101,4486,4529,4407,4440,4391,4416,4417,-113,-112,132856,"880,297.67",61762
,20131104,4416,4417,4400,4420,4375,4382,4399,-35,-18,107992,"712,732.66",65198
,20131105,4382,4399,4405,4416,4360,4384,4388,-15,-11,113454,"746,905.59",65436
,20131106,4384,4388,4390,4399,4372,4398,4384,10,-4,89572,"589,093.41",70000
,20131107,4398,4384,4428,4432,4388,4422,4408,38,24,106116,"701,643.33",71870
,20131108,4422,4408,4436,4443,4325,4393,4381,-15,-27,180456,"1,185,987.27",81552
,20131111,4393,4381,4396,4424,4312,4332,4346,-49,-35,203218,"1,324,971.72",95542
,20131112,4332,4346,4332,4339,4270,4306,4304,-40,-42,154120,"995,164.42",107310
,20131113,4306,4304,4306,4317,4212,4242,4257,-62,-47,233344,"1,490,125.55",122336
,20131114,4242,4257,4243,4288,4207,4264,4248,7,-9,264672,"1,686,695.56",127040
,20131115,4264,4248,4247,4278,4239,4242,4258,-6,10,242080,"1,546,451.82",138994
,20131118,4242,4258,4245,4255,4221,4242,4240,-16,-18,185790,"1,181,892.15",131538
,20131119,4242,4240,4223,4228,4155,4181,4191,-59,-49,344830,"2,167,857.32",155656
,20131120,4181,4191,4202,4231,4182,4226,4200,35,9,271576,"1,710,928.97",155504
,20131121,4226,4200,4200,4220,4124,4142,4172,-58,-28,413776,"2,589,983.23",172814
,20131122,4142,4172,4143,4167,4130,4143,4147,-29,-25,287236,"1,787,013.66",177108
,20131125,4143,4147,4149,4162,4086,4091,4126,-56,-21,303782,"1,880,374.02",189984
,20131126,4091,4126,4106,4182,4087,4173,4139,47,13,451488,"2,803,730.18",189216
,20131127,4173,4139,4145,4161,4136,4155,4150,16,11,246982,"1,537,788.21",187404
,20131128,4155,4150,4160,4166,4115,4136,4142,-14,-8,245278,"1,524,066.55",187888
,20131129,4136,4142,4138,4145,4110,4125,4128,-17,-14,159594,"988,240.80",169960
,20131202,4125,4128,4159,4173,4120,4135,4139,7,11,170786,"1,060,481.87",148572
,20131203,4135,4139,4116,4119,4027,4041,4070,-98,-69,173946,"1,062,009.03",144536
,20131204,4041,4070,4041,4044,4003,4020,4021,-50,-49,157202,"948,326.77",140964
,20131205,4020,4021,4038,4110,4019,4069,4062,48,41,155426,"947,114.91",126076
,20131206,4069,4062,4049,4094,4029,4066,4055,4,-7,159002,"967,194.37",122282
,20131209,4066,4055,4061,4111,4019,4078,4074,23,19,193474,"1,182,351.58",112280
,20131210,4078,4074,4078,4143,4078,4139,4102,65,28,102004,"627,757.19",97618
,20131211,4139,4102,4166,4213,4154,4187,4187,85,85,121698,"764,401.27",86310
,20131212,4187,4187,4182,4219,4178,4192,4195,5,8,63410,"399,015.71",84150
,20131213,4192,4195,4103,4119,4017,4033,4062,-162,-133,99212,"604,589.37",80690
,20131216,4033,4062,4056,4068,4033,4044,4050,-18,-12,56218,"341,526.86",76796
,20131217,4044,4050,4053,4178,4053,4132,4118,82,68,115930,"716,204.37",64312
,20131218,4132,4118,4107,4158,4072,4113,4110,-5,-8,70470,"434,552.52",60994
,20131219,4113,4110,4110,4138,4013,4044,4075,-66,-35,64486,"394,196.39",53300
,20131220,4044,4075,4008,4008,3966,3977,3985,-98,-90,42668,"255,049.51",50904
,20131223,3977,3985,3985,4034,3960,4012,4005,27,20,42442,"255,002.62",44656
,20131224,4012,4005,4029,4031,3983,3988,4003,-17,-2,30416,"182,636.95",41688
,20131225,3988,4003,3995,4021,3987,4009,4006,6,3,24532,"147,436.74",39420
,20131226,4009,4006,4014,4024,3996,4012,4009,6,3,13286,"79,914.35",37582
,20131227,4012,4009,4012,4104,4012,4098,4065,89,56,44520,"271,462.31",33046
,20131230,4098,4065,4089,4133,4056,4063,4097,-2,32,35810,"220,079.29",28410
,20131231,4063,4097,4048,4073,3988,4006,4031,-91,-66,33718,"203,918.25",21360
ag1402,20130219,6497,6497,6400,6544,6400,6500,6477,3,-20,18,174.89,8
,20130220,6500,6477,6443,6443,6443,6443,6443,-34,-34,8,77.32,16
,20130221,6443,6443,6333,6333,6265,6265,6299,-178,-144,4,37.79,14
,20130222,6265,6299,6299,6309,6299,6309,6301,10,2,10,94.52,14
,20130225,6309,6301,6298,6298,6298,6298,6298,-3,-3,4,37.79,12
,20130226,6298,6298,,,,6311,6311,13,13,0,0,12
,20130227,6311,6311,,,,6380,6380,69,69,0,0,12
,20130228,6380,6380,,,,6356,6356,-24,-24,0,0,12
,20130301,6356,6356,,,,6255,6255,-101,-101,0,0,12
,20130304,6255,6255,6264,6264,6264,6264,6264,9,9,2,18.79,14
,20130305,6264,6264,,,,6275,6275,11,11,0,0,14
,20130306,6275,6275,,,,6324,6324,49,49,0,0,14
,20130307,6324,6324,,,,6339,6339,15,15,0,0,14
,20130308,6339,6339,,,,6296,6296,-43,-43,0,0,14
,20130311,6296,6296,6327,6338,6320,6338,6327,42,31,8,75.93,20
,20130312,6338,6327,6337,6340,6337,6340,6338,13,11,4,38.03,18
,20130313,6340,6338,6341,6341,6329,6329,6335,-9,-3,4,38.01,18
,20130314,6329,6335,6273,6273,6273,6273,6273,-62,-62,2,18.82,18
,20130315,6273,6273,,,,6268,6268,-5,-5,0,0,18
,20130318,6268,6268,,,,6239,6239,-29,-29,0,0,18
,20130319,6239,6239,6250,6250,6249,6250,6249,11,10,6,56.25,16
,20130320,6250,6249,,,,6256,6256,7,7,0,0,16
,20130321,6256,6256,,,,6256,6256,0,0,0,0,16
,20130322,6256,6256,,,,6286,6286,30,30,0,0,16
,20130325,6286,6286,,,,6232,6232,-54,-54,0,0,16
,20130326,6232,6232,,,,6217,6217,-15,-15,0,0,16
,20130327,6217,6217,6165,6165,6165,6165,6165,-52,-52,2,18.5,18
,20130328,6165,6165,6180,6183,6180,6183,6181,18,16,4,37.09,18
,20130329,6183,6181,6067,6086,6067,6073,6074,-108,-107,8,72.9,20
,20130401,6073,6074,,,,6048,6048,-26,-26,0,0,20
,20130402,6048,6048,,,,6022,6022,-26,-26,0,0,20
,20130403,6022,6022,5804,5804,5799,5799,5801,-223,-221,4,34.81,22
,20130408,5799,5801,,,,5830,5830,29,29,0,0,22
,20130409,5830,5830,5898,5901,5898,5901,5899,71,69,4,35.4,26
,20130410,5901,5899,5961,5966,5960,5966,5962,67,63,6,53.66,22
,20130411,5966,5962,,,,5897,5897,-65,-65,0,0,22
,20130412,5897,5897,5922,5924,5898,5898,5920,1,23,16,142.08,24
,20130415,5898,5920,5564,5564,5564,5564,5564,-356,-356,4,33.38,24
,20130416,5564,5564,5063,5063,5063,5063,5063,-501,-501,2,15.19,22
,20130417,5063,5063,4748,5067,4748,5018,4962,-45,-101,22,163.78,20
,20130418,5018,4962,4790,4910,4790,4910,4835,-52,-127,6,43.52,20
,20130419,4910,4835,4911,5004,4894,5004,4953,169,118,8,59.44,20
,20130422,5004,4953,,,,4953,4953,0,0,0,0,20
,20130423,4953,4953,4799,4801,4737,4749,4779,-204,-174,48,344.14,36
,20130424,4749,4779,4755,4828,4755,4788,4805,9,26,18,129.74,36
,20130425,4788,4805,5004,5004,4886,4886,4938,81,133,10,74.08,38
,20130426,4886,4938,5269,5269,5080,5080,5177,142,239,16,124.27,36
,20130502,5080,5177,4916,4937,4882,4937,4904,-240,-273,110,809.23,52
,20130503,4937,4904,4976,5041,4945,5002,4990,98,86,82,613.88,78
,20130506,5002,4990,5049,5049,5043,5043,5046,53,56,4,30.28,76
,20130507,5043,5046,4962,4989,4857,4857,4936,-189,-110,8,59.23,78
,20130508,4857,4936,,,,4936,4936,0,0,0,0,78
,20130509,4936,4936,4947,5011,4947,4977,4987,41,51,22,164.6,88
,20130510,4977,4987,4910,4917,4910,4917,4913,-70,-74,4,29.48,90
,20130513,4917,4913,,,,4912,4912,-1,-1,0,0,90
,20130514,4912,4912,4920,4920,4915,4915,4917,3,5,12,88.52,90
,20130515,4915,4917,4804,4804,4767,4767,4775,-150,-142,58,415.45,96
,20130516,4767,4775,4721,4721,4665,4665,4692,-110,-83,28,197.06,82
,20130517,4665,4692,,,,4692,4692,0,0,0,0,82
,20130520,4692,4692,4511,4511,4458,4458,4493,-234,-199,6,40.44,82
,20130521,4458,4493,4636,4636,4636,4636,4636,143,143,2,13.91,80
,20130522,4636,4636,4648,4648,4648,4648,4648,12,12,12,83.66,80
,20130523,4648,4648,4560,4560,4560,4560,4560,-88,-88,2,13.68,80
,20130524,4560,4560,4642,4642,4642,4642,4642,82,82,2,13.93,80
,20130527,4642,4642,4638,4670,4638,4670,4659,28,17,10,69.9,80
,20130528,4670,4659,4651,4651,4651,4651,4651,-8,-8,6,41.86,74
,20130529,4651,4651,4586,4592,4573,4588,4584,-63,-67,50,343.86,72
,20130530,4588,4584,4659,4659,4659,4659,4659,75,75,6,41.93,72
,20130531,4659,4659,4693,4693,4693,4693,4693,34,34,6,42.24,66
,20130603,4693,4693,,,,4639,4639,-54,-54,0,0,66
,20130604,4639,4639,4671,4671,4671,4671,4671,32,32,6,42.04,60
,20130605,4671,4671,4629,4672,4629,4656,4647,-15,-24,16,111.53,56
,20130606,4656,4647,,,,4633,4633,-14,-14,0,0,56
,20130607,4633,4633,4690,4690,4690,4690,4690,57,57,2,14.07,54
,20130613,4690,4690,4528,4528,4528,4528,4528,-162,-162,2,13.58,56
,20130614,4528,4528,,,,4528,4528,0,0,0,0,56
,20130617,4528,4528,,,,4563,4563,35,35,0,0,56
,20130618,4563,4563,4506,4506,4506,4506,4506,-57,-57,2,13.52,56
,20130619,4506,4506,4466,4473,4466,4473,4468,-33,-38,6,40.22,62
,20130620,4473,4468,4395,4406,4321,4321,4374,-147,-94,6,39.37,62
,20130621,4321,4374,4111,4111,4111,4111,4111,-263,-263,8,49.33,64
,20130624,4111,4111,4100,4100,4047,4047,4081,-64,-30,6,36.73,64
,20130625,4047,4081,4067,4067,4032,4054,4051,-27,-30,6,36.46,68
,20130626,4054,4051,3971,3971,3867,3877,3915,-174,-136,18,105.72,74
,20130627,3877,3915,3880,3908,3838,3846,3867,-69,-48,26,150.84,80
,20130628,3846,3867,3805,3870,3805,3870,3848,3,-19,6,34.64,80
,20130701,3870,3848,4050,4050,3981,4027,4024,179,176,12,72.44,74
,20130702,4027,4024,4087,4087,4040,4041,4051,17,27,14,85.07,78
,20130703,4041,4051,4030,4045,4017,4017,4028,-34,-23,20,120.84,82
,20130704,4017,4028,4063,4063,4063,4063,4063,35,35,2,12.19,82
,20130705,4063,4063,4021,4021,3961,3961,3983,-102,-80,16,95.6,88
,20130708,3961,3983,3966,3966,3864,3864,3887,-119,-96,40,233.26,92
,20130709,3864,3887,3921,4009,3921,4009,3979,122,92,6,35.82,90
,20130710,4009,3979,3943,3952,3943,3952,3947,-27,-32,10,59.21,90
,20130711,3952,3947,3961,4163,3958,4135,4101,188,154,142,873.62,138
,20130712,4135,4101,4128,4128,4080,4080,4106,-21,5,34,209.45,134
,20130715,4080,4106,4083,4130,4071,4099,4106,-7,0,446,"2,747.06",264
,20130716,4099,4106,4088,4101,4064,4078,4081,-28,-25,48,293.86,264
,20130717,4078,4081,4078,4092,4078,4090,4082,9,1,84,514.39,254
,20130718,4090,4082,4124,4128,3961,3974,4062,-108,-20,96,584.98,246
,20130719,3974,4062,3997,4020,3969,3989,4001,-73,-61,124,744.29,244
,20130722,3989,4001,4084,4094,4084,4089,4090,88,89,16,98.18,236
,20130723,4089,4090,4110,4185,4110,4132,4150,42,60,98,610.17,244
,20130724,4132,4150,4118,4144,4115,4144,4133,-6,-17,20,124,238
,20130725,4144,4133,4116,4116,4080,4086,4093,-47,-40,124,761.45,234
,20130726,4086,4093,4099,4108,4089,4092,4101,-1,8,128,787.42,324
,20130729,4092,4101,4051,4053,3988,3988,4029,-113,-72,176,"1,063.72",304
,20130730,3988,4029,4001,4001,3982,3982,3993,-47,-36,34,203.67,328
,20130731,3982,3993,4003,4003,4003,4003,4003,10,10,2,12.01,328
,20130801,4003,4003,3983,3983,3960,3963,3968,-40,-35,18,107.14,336
,20130802,3963,3968,3963,3986,3909,3912,3951,-56,-17,62,367.48,334
,20130805,3912,3951,4019,4033,4009,4033,4014,82,63,34,204.74,346
,20130806,4033,4014,3989,3990,3960,3967,3973,-47,-41,20,119.21,342
,20130807,3967,3973,3943,3943,3925,3925,3930,-48,-43,10,58.96,340
,20130808,3925,3930,3948,4013,3948,4013,3983,83,53,26,155.37,342
,20130809,4013,3983,4017,4116,4017,4060,4068,77,85,78,476,382
,20130812,4060,4068,4080,4283,4080,4268,4244,200,176,532,"3,387.38",444
,20130813,4268,4244,4274,4371,4274,4371,4306,127,62,106,684.78,420
,20130814,4371,4306,4384,4384,4322,4325,4344,19,38,38,247.63,416
,20130815,4325,4344,4346,4448,4346,4436,4414,92,70,20,132.43,414
,20130816,4436,4414,4404,4678,4396,4641,4554,227,140,114,778.9,420
,20130819,4641,4554,4658,4755,4640,4654,4691,100,137,98,689.65,416
,20130820,4654,4691,4639,4724,4479,4724,4618,33,-73,98,678.91,416
,20130821,4724,4618,4615,4647,4572,4615,4621,-3,3,284,"1,968.96",492
,20130822,4615,4621,4627,4627,4549,4607,4599,-14,-22,154,"1,062.51",436
,20130823,4607,4599,4678,4678,4622,4637,4656,38,57,88,614.66,464
,20130826,4637,4656,4678,4920,4678,4897,4835,241,179,62,449.67,458
,20130827,4897,4835,4950,4988,4889,4928,4921,93,86,232,"1,712.62",432
,20130828,4928,4921,5006,5114,4995,5078,5044,157,123,326,"2,466.70",504
,20130829,5078,5044,5042,5042,4776,4864,4861,-180,-183,288,"2,099.96",478
,20130830,4864,4861,4855,4867,4760,4767,4819,-94,-42,122,881.96,476
,20130902,4767,4819,4760,4908,4724,4880,4829,61,10,44,318.76,476
,20130903,4880,4829,4880,4921,4868,4890,4902,61,73,146,"1,073.73",580
,20130904,4890,4902,4963,4970,4819,4827,4901,-75,-1,40,294.07,572
,20130905,4827,4901,4760,4775,4698,4741,4728,-160,-173,40,283.72,568
,20130906,4741,4728,4729,4733,4702,4710,4724,-18,-4,156,"1,105.53",636
,20130909,4710,4724,4835,4835,4824,4824,4824,100,100,104,752.61,684
,20130910,4824,4824,4800,4816,4731,4740,4778,-84,-46,58,415.7,674
,20130911,4740,4778,4676,4704,4646,4696,4673,-82,-105,176,"1,233.93",630
,20130912,4696,4673,4692,4696,4668,4668,4687,-5,14,170,"1,195.39",610
,20130913,4668,4687,4476,4501,4416,4420,4455,-267,-232,340,"2,272.44",584
,20130916,4420,4455,4428,4508,4425,4435,4456,-20,1,128,855.65,526
,20130917,4435,4456,4456,4489,4442,4445,4468,-11,12,52,348.57,528
,20130918,4445,4468,4439,4443,4364,4429,4415,-39,-53,30,198.69,518
,20130923,4429,4415,4340,4441,4338,4441,4365,26,-50,22,144.05,524
,20130924,4441,4365,4425,4482,4403,4415,4436,50,71,34,226.25,512
,20130925,4415,4436,4369,4435,4343,4431,4405,-5,-31,48,317.19,512
,20130926,4431,4405,4432,4434,4408,4424,4424,19,19,74,491.14,452
,20130927,4424,4424,4436,4437,4395,4395,4418,-29,-6,50,331.4,448
,20130930,4395,4418,4426,4433,4400,4400,4421,-18,3,34,225.47,458
,20131008,4400,4421,4510,4544,4510,4544,4530,123,109,16,108.72,456
,20131009,4544,4530,4564,4564,4529,4529,4544,-1,14,62,422.65,458
,20131010,4529,4544,4469,4477,4458,4474,4467,-70,-77,10,67.01,458
,20131011,4474,4467,4457,4463,4406,4406,4431,-61,-36,62,412.14,466
,20131014,4406,4431,4335,4368,4311,4361,4321,-70,-110,568,"3,681.51",720
,20131015,4361,4321,4463,4463,4293,4299,4323,-22,2,220,"1,426.81",748
,20131016,4299,4323,4305,4330,4304,4328,4318,5,-5,106,686.65,804
,20131017,4328,4318,4336,4382,4302,4302,4324,-16,6,176,"1,141.65",848
,20131018,4302,4324,4410,4430,4401,4430,4407,106,83,238,"1,573.45",796
,20131021,4430,4407,4456,4519,4426,4510,4492,103,85,236,"1,590.28",766
,20131022,4510,4492,4511,4533,4485,4503,4520,11,28,306,"2,074.95",766
,20131023,4503,4520,4554,4624,4554,4592,4599,72,79,434,"2,993.96",896
,20131024,4592,4599,4572,4606,4572,4606,4583,7,-16,48,330.02,902
,20131025,4606,4583,4600,4604,4545,4545,4574,-38,-9,18,123.51,898
,20131028,4545,4574,4525,4543,4525,4543,4537,-31,-37,12,81.67,896
,20131029,4543,4537,4537,4548,4532,4548,4540,11,3,138,939.93,890
,20131030,4548,4540,4552,4585,4522,4585,4541,45,1,36,245.25,884
,20131031,4585,4541,4644,4653,4483,4489,4575,-52,34,216,"1,482.38",852
,20131101,4489,4575,4418,4443,4418,4426,4428,-149,-147,118,783.87,868
,20131104,4426,4428,4409,4422,4385,4385,4395,-43,-33,52,342.86,882
,20131105,4385,4395,4398,4400,4381,4396,4391,1,-4,26,171.29,868
,20131106,4396,4391,4401,4401,4385,4393,4393,2,2,6,39.54,866
,20131107,4393,4393,4427,4440,4406,4440,4418,47,25,44,291.64,868
,20131108,4440,4418,4437,4437,4363,4392,4382,-26,-36,96,631.03,866
,20131111,4392,4382,4429,4429,4331,4338,4353,-44,-29,90,587.69,896
,20131112,4338,4353,4307,4307,4285,4302,4292,-51,-61,60,386.35,912
,20131113,4302,4292,4319,4327,4230,4251,4254,-41,-38,266,"1,697.38",1118
,20131114,4251,4254,4250,4290,4230,4277,4251,23,-3,314,"2,002.29",1102
,20131115,4277,4251,4263,4275,4257,4263,4264,12,13,262,"1,675.99",1154
,20131118,4263,4264,4252,4263,4230,4234,4242,-30,-22,194,"1,234.55",1222
,20131119,4234,4242,4209,4227,4161,4176,4191,-66,-51,414,"2,603.09",1202
,20131120,4176,4191,4198,4236,4193,4235,4205,44,14,284,"1,791.49",1228
,20131121,4235,4205,4204,4221,4133,4145,4169,-60,-36,190,"1,188.29",1228
,20131122,4145,4169,4147,4166,4134,4150,4153,-19,-16,138,859.72,1198
,20131125,4150,4153,4162,4164,4092,4095,4123,-58,-30,362,"2,238.82",1258
,20131126,4095,4123,4102,4200,4102,4200,4187,77,64,786,"4,936.50",1722
,20131127,4200,4187,4178,4178,4150,4161,4160,-26,-27,1008,"6,290.99",2414
,20131128,4161,4160,4167,4175,4130,4140,4140,-20,-20,3112,"19,329.98",4572
,20131129,4140,4140,4145,4149,4117,4120,4135,-20,-5,5134,"31,848.18",8172
,20131202,4120,4135,4145,4187,4129,4141,4150,6,15,644,"4,009.29",8218
,20131203,4141,4150,4120,4129,4040,4046,4075,-104,-75,932,"5,697.25",8244
,20131204,4046,4075,4045,4048,4014,4031,4029,-44,-46,374,"2,260.41",8124
,20131205,4031,4029,4056,4116,4037,4080,4071,51,42,732,"4,470.25",8064
,20131206,4080,4071,3920,4103,3920,4091,4072,20,1,490,"2,993.17",8090
,20131209,4091,4072,4079,4130,4041,4094,4096,22,24,1288,"7,914.87",8360
,20131210,4094,4096,4101,4163,4101,4154,4123,58,27,2296,"14,201.34",8388
,20131211,4154,4123,4161,4232,4161,4212,4210,89,87,4086,"25,808.60",8256
,20131212,4212,4210,4229,4245,4203,4218,4221,8,11,884,"5,598.29",8262
,20131213,4218,4221,4130,4140,4039,4055,4093,-166,-128,950,"5,832.61",8114
,20131216,4055,4093,4060,4090,4055,4063,4069,-30,-24,568,"3,467.31",8264
,20131217,4063,4069,4070,4199,4070,4154,4151,85,82,2912,"18,134.97",8380
,20131218,4154,4151,4107,4181,4100,4137,4133,-14,-18,686,"4,252.94",8424
,20131219,4137,4133,4145,4160,4042,4070,4089,-63,-44,1178,"7,225.96",8620
,20131220,4070,4089,4002,4020,3987,3999,4000,-90,-89,658,"3,948.17",8592
,20131223,3999,4000,3998,4054,3993,4035,4026,35,26,248,"1,498.00",8636
,20131224,4035,4026,4047,4053,4008,4010,4022,-16,-4,508,"3,064.81",8730
,20131225,4010,4022,4019,4044,4009,4033,4029,11,7,408,"2,466.23",8800
,20131226,4033,4029,4035,4042,4019,4035,4026,6,-3,3690,"22,286.87",8868
,20131227,4035,4026,4039,4130,4035,4120,4102,94,76,1870,"11,508.72",8918
,20131230,4120,4102,4108,4156,4082,4119,4128,17,26,1240,"7,679.91",8988
,20131231,4119,4128,4073,4099,4016,4033,4059,-95,-69,1004,"6,113.75",9010
ag1403,20130318,6268,6268,6240,6240,6238,6238,6239,-30,-29,4,37.43,2
,20130319,6238,6239,,,,6249,6249,10,10,0,0,2
,20130320,6249,6249,6279,6279,6279,6279,6279,30,30,4,37.67,4
,20130321,6279,6279,,,,6279,6279,0,0,0,0,4
,20130322,6279,6279,6363,6363,6351,6351,6357,72,78,4,38.14,4
,20130325,6351,6357,,,,6295,6295,-62,-62,0,0,4
,20130326,6295,6295,,,,6295,6295,0,0,0,0,4
,20130327,6295,6295,6179,6179,6179,6179,6179,-116,-116,2,18.54,6
,20130328,6179,6179,,,,6179,6179,0,0,0,0,6
,20130329,6179,6179,6107,6107,6107,6107,6107,-72,-72,2,18.32,6
,20130401,6107,6107,,,,6090,6090,-17,-17,0,0,6
,20130402,6090,6090,,,,6064,6064,-26,-26,0,0,6
,20130403,6064,6064,5824,5824,5824,5824,5824,-240,-240,2,17.47,6
,20130408,5824,5824,5874,5874,5874,5874,5874,50,50,2,17.62,8
,20130409,5874,5874,5890,5890,5890,5890,5890,16,16,2,17.67,10
,20130410,5890,5890,5950,5980,5950,5980,5965,90,75,4,35.79,10
,20130411,5980,5965,5908,5914,5898,5898,5907,-67,-58,8,70.88,14
,20130412,5898,5907,5907,5907,5907,5907,5907,0,0,2,17.72,14
,20130415,5907,5907,5555,5555,5555,5555,5555,-352,-352,2,16.67,14
,20130416,5555,5555,,,,5221,5221,-334,-334,0,0,14
,20130417,5221,5221,5221,5221,4990,4990,5056,-231,-165,14,106.19,24
,20130418,4990,5056,4776,4929,4776,4929,4839,-127,-217,16,116.15,24
,20130419,4929,4839,4888,4943,4888,4926,4919,87,80,6,44.27,22
,20130422,4926,4919,4928,5000,4928,4970,4960,51,41,112,833.39,84
,20130423,4970,4960,4958,4958,4800,4800,4920,-160,-40,14,103.34,90
,20130424,4800,4920,4850,4917,4800,4890,4802,-30,-118,906,"6,527.13",972
,20130425,4890,4802,4910,4953,4892,4918,4914,116,112,112,825.7,1036
,20130426,4918,4914,5249,5249,5098,5126,5184,212,270,232,"1,804.12",1090
,20130502,5126,5184,4960,4970,4896,4928,4919,-256,-265,746,"5,505.36",1540
,20130503,4928,4919,4961,5056,4955,5056,4971,137,52,118,880.03,1544
,20130506,5056,4971,5132,5132,5057,5073,5076,102,105,18,137.07,1540
,20130507,5073,5076,4973,4973,4869,4869,4916,-207,-160,46,339.22,1548
,20130508,4869,4916,4932,4947,4914,4914,4930,-2,14,46,340.24,1550
,20130509,4914,4930,4932,5017,4932,4981,4971,51,41,20,149.16,1550
,20130510,4981,4971,4925,4967,4919,4967,4929,-4,-42,34,251.4,1536
,20130513,4967,4929,4936,4940,4888,4889,4917,-40,-12,42,309.79,1546
,20130514,4889,4917,4927,4942,4927,4932,4932,15,15,160,"1,183.70",1534
,20130515,4932,4932,4857,4857,4789,4789,4825,-143,-107,20,144.76,1540
,20130516,4789,4825,4660,4741,4660,4687,4692,-138,-133,24,168.95,1548
,20130517,4687,4692,4716,4730,4716,4730,4720,38,28,8,56.64,1544
,20130520,4730,4720,4553,4581,4459,4459,4529,-261,-191,86,584.29,1572
,20130521,4459,4529,4649,4726,4630,4713,4667,184,138,74,518.09,1570
,20130522,4713,4667,4681,4681,4646,4680,4675,13,8,68,476.92,1558
,20130523,4680,4675,4675,4675,4565,4610,4609,-65,-66,56,387.2,1542
,20130524,4610,4609,4633,4691,4633,4678,4678,69,69,66,463.17,1528
,20130527,4678,4678,4667,4701,4639,4699,4681,21,3,52,365.13,1528
,20130528,4699,4681,4682,4682,4673,4673,4678,-8,-3,6,42.11,1528
,20130529,4673,4678,4672,4672,4606,4618,4631,-60,-47,122,847.61,1588
,20130530,4618,4631,4640,4691,4636,4683,4671,52,40,48,336.35,1584
,20130531,4683,4671,4721,4732,4701,4709,4712,38,41,134,947.14,1564
,20130603,4709,4712,4668,4668,4637,4658,4650,-54,-62,30,209.26,1558
,20130604,4658,4650,4695,4695,4672,4675,4677,25,27,58,406.91,1522
,20130605,4675,4677,4646,4684,4646,4684,4677,7,0,88,617.37,1478
,20130606,4684,4677,4658,4661,4636,4636,4654,-41,-23,230,"1,605.97",1356
,20130607,4636,4654,4702,4717,4702,4707,4709,53,55,556,"3,927.98",1080
,20130613,4707,4709,4545,4569,4545,4553,4556,-156,-153,98,669.76,1094
,20130614,4553,4556,4526,4535,4523,4535,4531,-21,-25,80,543.81,1126
,20130617,4535,4531,4558,4573,4558,4558,4566,27,35,42,287.69,1138
,20130618,4558,4566,4556,4556,4532,4533,4536,-33,-30,20,136.09,1144
,20130619,4533,4536,4515,4515,4489,4515,4503,-21,-33,58,391.84,1166
,20130620,4515,4503,4425,4442,4377,4379,4414,-124,-89,88,582.74,1166
,20130621,4379,4414,4149,4169,4149,4151,4150,-263,-264,130,809.39,1204
,20130624,4151,4150,4168,4194,4045,4064,4115,-86,-35,110,678.99,1228
,20130625,4064,4115,4078,4096,4058,4096,4076,-19,-39,94,574.82,1214
,20130626,4096,4076,4067,4071,3873,3903,3912,-173,-164,176,"1,032.79",1174
,20130627,3903,3912,3899,3925,3883,3898,3900,-14,-12,116,678.67,1174
,20130628,3898,3900,3837,3907,3830,3900,3885,0,-15,56,326.35,1172
,20130701,3900,3885,3998,4084,3998,4084,4047,199,162,508,"3,083.93",1300
,20130702,4084,4047,4093,4098,4054,4098,4075,51,28,32,195.61,1296
,20130703,4098,4075,4061,4067,4038,4063,4056,-12,-19,48,292.03,1288
,20130704,4063,4056,4075,4080,4069,4069,4075,13,19,24,146.72,1270
,20130705,4069,4075,4042,4042,3970,3987,3996,-88,-79,56,335.7,1290
,20130708,3987,3996,3918,3931,3886,3886,3902,-110,-94,44,257.57,1296
,20130709,3886,3902,3905,4030,3905,3999,3987,97,85,122,729.69,1266
,20130710,3999,3987,3974,3989,3940,3960,3965,-27,-22,182,"1,082.61",1284
,20130711,3960,3965,3974,4193,3961,4149,4079,184,114,138,844.44,1264
,20130712,4149,4079,4139,4143,4088,4088,4122,9,43,116,717.29,1290
,20130715,4088,4122,4096,4170,4096,4107,4129,-15,7,76,470.8,1294
,20130716,4107,4129,4107,4109,4091,4091,4101,-38,-28,16,98.44,1296
,20130717,4091,4101,4098,4132,4097,4115,4110,14,9,62,382.32,1296
,20130718,4115,4110,4142,4142,3976,3980,4013,-130,-97,122,734.46,1294
,20130719,3980,4013,4006,4035,3995,3995,4011,-18,-2,58,349.03,1276
,20130722,3995,4011,4019,4114,4019,4101,4076,90,65,116,709.36,1274
,20130723,4101,4076,4166,4189,4137,4139,4170,63,94,114,713.16,1280
,20130724,4139,4170,4144,4166,4144,4166,4149,-4,-21,48,298.78,1274
,20130725,4166,4149,4135,4135,4095,4106,4101,-43,-48,172,"1,058.18",1334
,20130726,4106,4101,4112,4137,4089,4101,4113,0,12,190,"1,172.21",1424
,20130729,4101,4113,4020,4028,4003,4003,4018,-110,-95,72,433.97,1374
,20130730,4003,4018,4015,4015,3999,3999,4007,-19,-11,14,84.16,1372
,20130731,3999,4007,3991,4025,3989,4025,3995,18,-12,74,443.53,1368
,20130801,4025,3995,3987,4009,3976,3983,3994,-12,-1,50,299.62,1346
,20130802,3983,3994,3997,3997,3920,3922,3937,-72,-57,56,330.73,1312
,20130805,3922,3937,4030,4038,4018,4038,4025,101,88,84,507.17,1298
,20130806,4038,4025,3999,3999,3970,3985,3978,-40,-47,130,775.85,1204
,20130807,3985,3978,3939,3962,3933,3954,3941,-24,-37,28,165.53,1204
,20130808,3954,3941,3945,4031,3945,4020,4004,79,63,98,588.62,1146
,20130809,4020,4004,4034,4122,4034,4095,4089,91,85,104,637.92,1176
,20130812,4095,4089,4089,4298,4089,4274,4207,185,118,112,706.82,1192
,20130813,4274,4207,4304,4404,4275,4404,4322,197,115,52,337.18,1192
,20130814,4404,4322,4385,4392,4323,4340,4353,18,31,196,"1,280.07",1062
,20130815,4340,4353,4382,4478,4357,4461,4439,108,86,168,"1,118.71",1012
,20130816,4461,4439,4422,4705,4422,4649,4641,210,202,970,"6,753.84",1406
,20130819,4649,4641,4712,4771,4658,4700,4710,59,69,212,"1,497.99",1468
,20130820,4700,4710,4670,4690,4480,4555,4652,-155,-58,1038,"7,243.27",1626
,20130821,4555,4652,4613,4656,4575,4609,4601,-43,-51,328,"2,263.82",1620
,20130822,4609,4601,4609,4622,4551,4596,4605,-5,4,624,"4,310.62",1496
,20130823,4596,4605,4676,4676,4622,4645,4653,40,48,212,"1,479.71",1450
,20130826,4645,4653,4705,4920,4705,4901,4854,248,201,238,"1,733.06",1474
,20130827,4901,4854,4939,4998,4880,4938,4927,84,73,568,"4,197.83",1776
,20130828,4938,4927,5017,5112,4997,5076,5030,149,103,570,"4,301.06",1964
,20130829,5076,5030,5030,5030,4773,4878,4873,-152,-157,306,"2,236.74",1942
,20130830,4878,4873,4827,4857,4768,4768,4820,-105,-53,196,"1,417.35",1940
,20130902,4768,4820,4728,4910,4718,4899,4832,79,12,218,"1,580.07",1916
,20130903,4899,4832,4917,4925,4879,4903,4903,71,71,274,"2,015.19",1902
,20130904,4903,4903,4964,4973,4827,4849,4896,-54,-7,204,"1,498.37",1890
,20130905,4849,4896,4770,4800,4700,4738,4762,-158,-134,296,"2,114.39",1872
,20130906,4738,4762,4732,4741,4705,4720,4720,-42,-42,192,"1,359.45",1898
,20130909,4720,4720,4827,4858,4811,4817,4833,97,113,170,"1,232.49",1908
,20130910,4817,4833,4806,4832,4737,4752,4784,-81,-49,112,803.72,1920
,20130911,4752,4784,4686,4722,4632,4687,4664,-97,-120,204,"1,427.48",1934
,20130912,4687,4664,4692,4700,4649,4649,4673,-15,9,240,"1,682.53",1948
,20130913,4649,4673,4458,4495,4421,4443,4464,-230,-209,498,"3,335.26",1966
,20130916,4443,4464,4441,4522,4438,4450,4457,-14,-7,524,"3,503.41",2008
,20130917,4450,4457,4480,4480,4429,4477,4444,20,-13,242,"1,613.48",2090
,20130918,4477,4444,4422,4428,4365,4415,4392,-29,-52,264,"1,739.32",2170
,20130923,4415,4392,4382,4450,4345,4428,4375,36,-17,254,"1,666.93",2208
,20130924,4428,4375,4428,4488,4409,4420,4435,45,60,488,"3,247.08",2356
,20130925,4420,4435,4420,4452,4347,4432,4423,-3,-12,482,"3,198.42",2396
,20130926,4432,4423,4429,4442,4418,4423,4432,0,9,186,"1,236.62",2386
,20130927,4423,4432,4445,4449,4375,4400,4401,-32,-31,136,898.01,2386
,20130930,4400,4401,4428,4429,4401,4419,4415,18,14,136,900.84,2426
,20131008,4419,4415,4500,4566,4500,4553,4523,138,108,142,963.48,2420
,20131009,4553,4523,4564,4571,4527,4528,4550,5,27,266,"1,815.64",2414
,20131010,4528,4550,4468,4485,4445,4464,4462,-86,-88,84,562.31,2428
,20131011,4464,4462,4456,4460,4400,4402,4423,-60,-39,220,"1,459.90",2424
,20131014,4402,4423,4356,4365,4318,4365,4336,-58,-87,186,"1,209.87",2436
,20131015,4365,4336,4375,4387,4299,4310,4335,-26,-1,66,429.2,2442
,20131016,4310,4335,4286,4357,4285,4357,4326,22,-9,56,363.43,2450
,20131017,4357,4326,4352,4405,4314,4314,4354,-12,28,274,"1,789.79",2386
,20131018,4314,4354,4410,4458,4410,4458,4421,104,67,162,"1,074.46",2352
,20131021,4458,4421,4450,4520,4445,4518,4486,97,65,424,"2,853.59",2514
,20131022,4518,4486,4525,4531,4491,4510,4507,24,21,272,"1,838.90",2544
,20131023,4510,4507,4554,4615,4554,4589,4600,82,93,302,"2,083.88",2648
,20131024,4589,4600,4602,4605,4566,4604,4584,4,-16,190,"1,306.58",2608
,20131025,4604,4584,4601,4605,4521,4524,4564,-60,-20,48,328.62,2598
,20131028,4524,4564,4518,4558,4500,4550,4548,-14,-16,194,"1,323.68",2504
,20131029,4550,4548,4549,4561,4532,4561,4549,13,1,136,928.04,2448
,20131030,4561,4549,4557,4591,4523,4591,4536,42,-13,198,"1,347.23",2368
,20131031,4591,4536,4649,4665,4490,4500,4528,-36,-8,344,"2,336.55",2388
,20131101,4500,4528,4451,4451,4409,4428,4437,-100,-91,150,998.35,2340
,20131104,4428,4437,4413,4415,4395,4398,4407,-39,-30,70,462.8,2334
,20131105,4398,4407,4401,4412,4382,4408,4396,1,-11,154,"1,015.67",2302
,20131106,4408,4396,4412,4412,4393,4408,4402,12,6,88,581.12,2286
,20131107,4408,4402,4416,4417,4408,4408,4412,6,10,88,582.41,2294
,20131108,4408,4412,4425,4425,4365,4411,4400,-1,-12,126,831.69,2290
,20131111,4411,4400,4367,4367,4340,4358,4352,-42,-48,182,"1,188.21",2258
,20131112,4358,4352,4349,4356,4295,4328,4304,-24,-48,184,"1,188.05",2284
,20131113,4328,4304,4327,4337,4234,4249,4251,-55,-53,340,"2,168.27",2292
,20131114,4249,4251,4257,4295,4244,4274,4271,23,20,338,"2,165.72",2242
,20131115,4274,4271,4266,4286,4265,4268,4272,-3,1,88,563.99,2240
,20131118,4268,4272,4263,4263,4238,4239,4247,-33,-25,276,"1,758.62",2362
,20131119,4239,4247,4234,4237,4162,4168,4181,-79,-66,262,"1,643.28",2396
,20131120,4168,4181,4203,4222,4200,4222,4210,41,29,134,846.27,2366
,20131121,4222,4210,4207,4211,4123,4143,4149,-67,-61,548,"3,411.22",2294
,20131122,4143,4149,4145,4169,4143,4157,4160,8,11,364,"2,271.63",2230
,20131125,4157,4160,4164,4169,4102,4104,4134,-56,-26,74,458.93,2244
,20131126,4104,4134,4104,4200,4100,4200,4181,66,47,762,"4,779.53",2654
,20131127,4200,4181,4177,4178,4149,4160,4164,-21,-17,564,"3,523.13",2766
,20131128,4160,4164,4172,4174,4130,4146,4141,-18,-23,1306,"8,113.60",3812
,20131129,4146,4141,4151,4154,4125,4130,4139,-11,-2,1916,"11,896.17",5194
,20131202,4130,4139,4182,4182,4136,4146,4146,7,7,810,"5,037.66",5184
,20131203,4146,4146,4135,4136,4048,4057,4070,-89,-76,262,"1,599.69",5220
,20131204,4057,4070,4052,4052,4024,4038,4038,-32,-32,190,"1,150.87",5156
,20131205,4038,4038,4061,4116,4049,4086,4083,48,45,234,"1,433.41",5150
,20131206,4086,4083,4060,4115,4048,4089,4077,6,-6,294,"1,798.02",5154
,20131209,4089,4077,4110,4130,4054,4102,4105,25,28,360,"2,216.80",5258
,20131210,4102,4105,4118,4180,4113,4175,4136,70,31,204,"1,265.85",5338
,20131211,4175,4136,4200,4242,4193,4225,4225,89,89,744,"4,715.60",5384
,20131212,4225,4225,4219,4258,4219,4237,4234,12,9,330,"2,096.09",5348
,20131213,4237,4234,4166,4166,4055,4068,4096,-166,-138,1010,"6,206.25",5480
,20131216,4068,4096,4086,4111,4075,4079,4089,-17,-7,190,"1,165.44",5416
,20131217,4079,4089,4107,4219,4107,4175,4180,86,91,616,"3,862.92",5408
,20131218,4175,4180,4135,4191,4114,4153,4142,-27,-38,554,"3,442.48",5372
,20131219,4153,4142,4165,4176,4052,4093,4111,-49,-31,422,"2,602.44",5464
,20131220,4093,4111,4025,4042,4011,4017,4026,-94,-85,196,"1,183.81",5496
,20131223,4017,4026,4024,4075,4020,4055,4055,29,29,230,"1,399.23",5598
,20131224,4055,4055,4063,4069,4023,4034,4038,-21,-17,206,"1,247.93",5546
,20131225,4034,4038,4038,4062,4032,4056,4047,18,9,82,497.8,5550
,20131226,4056,4047,4062,4062,4043,4054,4053,7,6,132,802.52,5564
,20131227,4054,4053,4060,4149,4055,4146,4113,93,60,510,"3,146.87",5630
,20131230,4146,4113,4125,4175,4105,4105,4142,-8,29,314,"1,951.00",5542
,20131231,4105,4142,4096,4118,4037,4057,4078,-85,-64,492,"3,010.02",5528
ag1404,20130416,5555,5555,4888,5068,4888,5067,4985,-488,-570,660,"4,935.41",192
,20130417,5067,4985,5076,5108,4985,4992,5064,7,79,156,"1,185.20",148
,20130418,4992,5064,4930,4988,4791,4921,4876,-143,-188,54,395.01,150
,20130419,4921,4876,4920,5041,4920,5026,4995,150,119,26,194.84,146
,20130422,5026,4995,5010,5010,4923,4977,4972,-18,-23,14,104.43,150
,20130423,4977,4972,4930,4937,4818,4818,4908,-154,-64,76,559.62,186
,20130424,4818,4908,4883,4884,4854,4854,4881,-54,-27,26,190.38,186
,20130425,4854,4881,4917,4953,4917,4953,4923,72,42,38,280.66,162
,20130426,4953,4923,5200,5236,5106,5140,5177,217,254,156,"1,211.59",148
,20130502,5140,5177,4997,4997,4930,4948,4951,-229,-226,22,163.4,148
,20130503,4948,4951,5003,5039,5003,5039,5028,88,77,16,120.69,146
,20130506,5039,5028,,,,5134,5134,106,106,0,0,146
,20130507,5134,5134,4977,5008,4905,4912,4944,-222,-190,48,356,160
,20130508,4912,4944,4944,4972,4923,4961,4943,17,-1,40,296.58,160
,20130509,4961,4943,4956,5035,4956,5002,5001,59,58,64,480.13,146
,20130510,5002,5001,4911,4958,4911,4958,4945,-43,-56,48,356.06,150
,20130513,4958,4945,4956,4956,4943,4943,4953,-2,8,26,193.18,146
,20130514,4943,4953,4945,4945,4921,4921,4942,-32,-11,22,163.11,148
,20130515,4921,4942,4870,4870,4790,4790,4826,-152,-116,106,767.39,174
,20130516,4790,4826,4759,4759,4705,4707,4722,-119,-104,214,"1,515.84",258
,20130517,4707,4722,4742,4742,4700,4700,4722,-22,0,24,170.01,266
,20130520,4700,4722,4563,4563,4476,4476,4527,-246,-195,56,380.34,280
,20130521,4476,4527,4678,4746,4648,4715,4677,188,150,52,364.88,242
,20130522,4715,4677,4688,4705,4667,4683,4689,6,12,102,717.43,190
,20130523,4683,4689,,,,4689,4689,0,0,0,0,190
,20130524,4689,4689,4631,4681,4631,4679,4664,-10,-25,16,111.95,188
,20130527,4679,4664,4690,4690,4690,4690,4690,26,26,2,14.07,188
,20130528,4690,4690,4679,4694,4678,4682,4683,-8,-7,22,154.56,196
,20130529,4682,4683,4652,4653,4638,4638,4650,-45,-33,14,97.65,206
,20130530,4638,4650,4690,4716,4690,4716,4707,66,57,20,141.23,194
,20130531,4716,4707,4735,4743,4730,4730,4737,23,30,36,255.8,196
,20130603,4730,4737,4686,4686,4686,4686,4686,-51,-51,2,14.06,196
,20130604,4686,4686,4699,4699,4699,4699,4699,13,13,2,14.1,196
,20130605,4699,4699,4680,4700,4680,4700,4686,1,-13,6,42.18,192
,20130606,4700,4686,4680,4680,4666,4666,4674,-20,-12,18,126.21,188
,20130607,4666,4674,4719,4725,4719,4723,4722,49,48,6,42.5,186
,20130613,4723,4722,4576,4576,4576,4576,4576,-146,-146,4,27.46,190
,20130614,4576,4576,4573,4573,4548,4553,4560,-23,-16,38,259.96,204
,20130617,4553,4560,4574,4574,4574,4574,4574,14,14,2,13.72,204
,20130618,4574,4574,4582,4582,4553,4554,4556,-20,-18,48,328.04,244
,20130619,4554,4556,4535,4535,4510,4516,4524,-40,-32,52,352.89,278
,20130620,4516,4524,4451,4451,4399,4399,4436,-125,-88,46,306.11,292
,20130621,4399,4436,4169,4173,4169,4173,4170,-263,-266,6,37.53,288
,20130624,4173,4170,4190,4190,4115,4115,4152,-55,-18,6,37.37,288
,20130625,4115,4152,4081,4093,4073,4093,4083,-59,-69,10,61.26,290
,20130626,4093,4083,3979,3979,3891,3915,3914,-168,-169,12,70.46,292
,20130627,3915,3914,3939,3942,3887,3919,3917,5,3,44,258.56,294
,20130628,3919,3917,3882,3934,3882,3919,3919,2,2,14,82.31,294
,20130701,3919,3919,4056,4101,4056,4098,4082,179,163,14,85.73,290
,20130702,4098,4082,4100,4115,4097,4115,4109,33,27,26,160.27,306
,20130703,4115,4109,,,,4109,4109,0,0,0,0,306
,20130704,4109,4109,4092,4092,4092,4092,4092,-17,-17,4,24.55,306
,20130705,4092,4092,,,,4092,4092,0,0,0,0,306
,20130708,4092,4092,3941,3941,3890,3916,3909,-176,-183,28,164.19,314
,20130709,3916,3909,3971,4037,3971,4030,4009,121,100,42,252.59,316
,20130710,4030,4009,3988,4000,3941,3977,3979,-32,-30,54,322.3,310
,20130711,3977,3979,3989,4187,3989,4169,4123,190,144,16,98.97,312
,20130712,4169,4123,4169,4169,4151,4162,4162,39,39,32,199.81,312
,20130715,4162,4162,4115,4115,4111,4111,4113,-51,-49,4,24.68,312
,20130716,4111,4113,4113,4113,4085,4111,4101,-2,-12,16,98.44,320
,20130717,4111,4101,4117,4153,4117,4118,4129,17,28,12,74.33,320
,20130718,4118,4129,4160,4160,3993,3993,4083,-136,-46,12,73.5,320
,20130719,3993,4083,4009,4133,4009,4018,4048,-65,-35,38,230.76,324
,20130722,4018,4048,4121,4126,4121,4121,4124,73,76,12,74.23,320
,20130723,4121,4124,4192,4202,4161,4161,4183,37,59,36,225.9,324
,20130724,4161,4183,4152,4176,4152,4176,4166,-7,-17,6,37.5,326
,20130725,4176,4166,4140,4148,4112,4113,4118,-53,-48,78,481.81,382
,20130726,4113,4118,4124,4142,4101,4105,4129,-13,11,98,607.09,466
,20130729,4105,4129,4028,4043,4016,4018,4033,-111,-96,54,326.68,434
,20130730,4018,4033,4028,4041,4013,4013,4030,-20,-3,26,157.17,434
,20130731,4013,4030,4002,4038,3999,4038,4011,8,-19,8,48.13,434
,20130801,4038,4011,3999,4019,3990,3993,3995,-18,-16,62,371.6,404
,20130802,3993,3995,4005,4005,3932,3943,3941,-52,-54,56,331.08,402
,20130805,3943,3941,4047,4049,4039,4043,4044,102,103,44,266.91,414
,20130806,4043,4044,4015,4027,3990,3998,4012,-46,-32,18,108.35,410
,20130807,3998,4012,3959,3973,3959,3971,3966,-41,-46,28,166.58,406
,20130808,3971,3966,3968,4043,3968,4027,4013,61,47,22,132.45,418
,20130809,4027,4013,4048,4140,4048,4087,4079,74,66,70,428.34,466
,20130812,4087,4079,4128,4294,4118,4283,4231,204,152,74,469.67,466
,20130813,4283,4231,4293,4346,4290,4346,4308,115,77,152,982.33,394
,20130814,4346,4308,4357,4383,4340,4340,4365,32,57,86,563.11,396
,20130815,4340,4365,4387,4468,4374,4452,4442,87,77,102,679.66,380
,20130816,4452,4442,4417,4708,4417,4658,4626,216,184,52,360.84,378
,20130819,4658,4626,4745,4774,4689,4689,4759,63,133,28,199.91,376
,20130820,4689,4759,4663,4663,4495,4561,4535,-198,-224,36,244.94,372
,20130821,4561,4535,4646,4646,4608,4612,4614,77,79,18,124.6,374
,20130822,4612,4614,,,,4614,4614,0,0,0,0,374
,20130823,4614,4614,4690,4698,4647,4673,4674,59,60,50,350.6,366
,20130826,4673,4674,4916,4916,4916,4916,4916,242,242,2,14.75,368
,20130827,4916,4916,4976,5000,4901,4942,4930,26,14,48,355.02,366
,20130828,4942,4930,5042,5099,5005,5071,5043,141,113,56,423.68,356
,20130829,5071,5043,4942,4942,4770,4770,4882,-273,-161,26,190.4,350
,20130830,4770,4882,4847,4847,4780,4780,4818,-102,-64,6,43.37,348
,20130902,4780,4818,4870,4870,4870,4870,4870,52,52,4,29.22,348
,20130903,4870,4870,4930,4936,4896,4912,4919,42,49,34,250.88,352
,20130904,4912,4919,4975,4976,4851,4853,4933,-66,14,84,621.56,320
,20130905,4853,4933,4794,4794,4720,4720,4744,-213,-189,6,42.7,320
,20130906,4720,4744,4732,4732,4732,4732,4732,-12,-12,2,14.2,318
,20130909,4732,4732,4841,4841,4839,4839,4840,107,108,4,29.04,316
,20130910,4839,4840,,,,4790,4790,-50,-50,0,0,316
,20130911,4790,4790,4662,4709,4655,4709,4659,-81,-131,48,335.47,310
,20130912,4709,4659,4707,4710,4685,4685,4700,26,41,6,42.31,308
,20130913,4685,4700,4477,4488,4458,4458,4475,-242,-225,8,53.7,306
,20130916,4458,4475,4464,4524,4464,4494,4508,19,33,42,284,290
,20130917,4494,4508,4463,4480,4463,4480,4469,-28,-39,18,120.66,290
,20130918,4480,4469,4385,4441,4385,4441,4413,-28,-56,8,52.96,282
,20130923,4441,4413,4357,4444,4357,4440,4388,27,-25,20,131.65,276
,20130924,4440,4388,4463,4467,4423,4423,4451,35,63,6,40.06,272
,20130925,4423,4451,4429,4443,4429,4443,4441,-8,-10,28,186.54,252
,20130926,4443,4441,4435,4462,4429,4453,4445,12,4,84,560.07,216
,20130927,4453,4445,4425,4440,4401,4412,4412,-33,-33,56,370.68,200
,20130930,4412,4412,,,,4426,4426,14,14,0,0,200
,20131008,4426,4426,4555,4559,4555,4559,4557,133,131,8,54.68,200
,20131009,4559,4557,4574,4582,4548,4556,4564,-1,7,34,232.79,190
,20131010,4556,4564,4485,4485,4467,4481,4476,-83,-88,12,80.58,186
,20131011,4481,4476,4472,4472,4434,4442,4446,-34,-30,50,333.51,188
,20131014,4442,4446,4356,4357,4351,4357,4353,-89,-93,10,65.3,192
,20131015,4357,4353,4333,4333,4333,4333,4333,-20,-20,2,13,190
,20131016,4333,4333,4359,4359,4359,4359,4359,26,26,2,13.08,190
,20131017,4359,4359,4395,4395,4357,4357,4369,-2,10,6,39.33,192
,20131018,4357,4369,4404,4440,4404,4422,4418,53,49,52,344.66,204
,20131021,4422,4418,4454,4525,4453,4525,4490,107,72,78,525.34,208
,20131022,4525,4490,4527,4535,4499,4508,4527,18,37,44,298.8,196
,20131023,4508,4527,4569,4611,4569,4611,4606,84,79,20,138.2,194
,20131024,4611,4606,4602,4609,4586,4609,4597,3,-9,12,82.76,192
,20131025,4609,4597,,,,4577,4577,-20,-20,0,0,192
,20131028,4577,4577,,,,4561,4561,-16,-16,0,0,192
,20131029,4561,4561,4544,4555,4537,4555,4546,-6,-15,94,641.1,234
,20131030,4555,4546,4594,4594,4594,4594,4594,48,48,2,13.78,234
,20131031,4594,4594,4653,4656,4506,4507,4538,-87,-56,50,340.37,218
,20131101,4507,4538,4442,4447,4437,4441,4441,-97,-97,10,66.62,214
,20131104,4441,4441,4422,4422,4421,4421,4421,-20,-20,6,39.8,216
,20131105,4421,4421,4410,4419,4399,4419,4411,-2,-10,14,92.64,212
,20131106,4419,4411,4407,4417,4407,4417,4413,6,2,6,39.72,216
,20131107,4417,4413,4450,4450,4419,4441,4441,28,28,36,239.84,216
,20131108,4441,4441,4449,4449,4372,4410,4434,-31,-7,44,292.67,210
,20131111,4410,4434,4418,4418,4349,4355,4367,-79,-67,10,65.51,210
,20131112,4355,4367,4325,4327,4324,4324,4325,-43,-42,60,389.26,226
,20131113,4324,4325,4325,4336,4236,4240,4274,-85,-51,18,115.41,214
,20131114,4240,4274,4272,4302,4272,4297,4292,23,18,8,51.5,216
,20131115,4297,4292,4292,4294,4275,4276,4279,-16,-13,16,102.72,222
,20131118,4276,4279,4271,4271,4250,4250,4261,-29,-18,48,306.82,238
,20131119,4250,4261,4223,4223,4173,4173,4190,-88,-71,32,201.16,246
,20131120,4173,4190,4210,4223,4210,4221,4214,31,24,28,177.02,256
,20131121,4221,4214,4219,4220,4136,4148,4183,-66,-31,98,614.95,256
,20131122,4148,4183,4141,4167,4141,4155,4164,-28,-19,126,787.17,326
,20131125,4155,4164,4132,4132,4100,4100,4121,-64,-43,6,37.09,328
,20131126,4100,4121,4172,4191,4160,4191,4179,70,58,26,162.98,320
,20131127,4191,4179,4164,4164,4164,4164,4164,-15,-15,2,12.49,320
,20131128,4164,4164,4164,4177,4133,4141,4150,-23,-14,150,933.76,374
,20131129,4141,4150,4155,4155,4136,4140,4147,-10,-3,180,"1,119.77",358
,20131202,4140,4147,4186,4189,4150,4162,4173,15,26,78,488.32,360
,20131203,4162,4173,4143,4144,4062,4068,4102,-105,-71,110,676.97,376
,20131204,4068,4102,4070,4070,4039,4039,4044,-63,-58,152,922.05,356
,20131205,4039,4044,4064,4145,4062,4102,4103,58,59,92,566.3,344
,20131206,4102,4103,4065,4105,4059,4079,4074,-24,-29,82,501.13,290
,20131209,4079,4074,4116,4130,4099,4118,4115,44,41,26,160.52,298
,20131210,4118,4115,4136,4204,4136,4204,4160,89,45,36,224.66,308
,20131211,4204,4160,4244,4265,4232,4239,4246,79,86,54,343.98,306
,20131212,4239,4246,4255,4275,4239,4253,4257,7,11,56,357.65,302
,20131213,4253,4257,4169,4169,4068,4068,4106,-189,-151,36,221.76,290
,20131216,4068,4106,4087,4088,4087,4088,4087,-18,-19,4,24.53,290
,20131217,4088,4087,4179,4225,4145,4208,4191,121,104,70,440.15,302
,20131218,4208,4191,4167,4205,4129,4177,4151,-14,-40,40,249.1,306
,20131219,4177,4151,4189,4189,4084,4112,4102,-39,-49,44,270.78,316
,20131220,4112,4102,4040,4061,4039,4040,4043,-62,-59,16,97.05,314
,20131223,4040,4043,4055,4102,4051,4102,4096,59,53,114,700.49,414
,20131224,4102,4096,4090,4090,4037,4043,4070,-53,-26,216,"1,318.93",324
,20131225,4043,4070,,,,4070,4070,0,0,0,0,324
,20131226,4070,4070,4063,4063,4062,4062,4062,-8,-8,10,60.94,314
,20131227,4062,4062,4099,4169,4099,4169,4130,107,68,20,123.92,314
,20131230,4169,4130,4151,4198,4127,4127,4154,-3,24,28,174.48,312
,20131231,4127,4154,4110,4121,4076,4077,4089,-77,-65,78,478.43,346
ag1405,20130516,4826,4826,,,,4826,4826,0,0,0,0,0
,20130517,4826,4826,,,,4826,4826,0,0,0,0,0
,20130520,4826,4826,,,,4627,4627,-199,-199,0,0,0
,20130521,4627,4627,,,,4627,4627,0,0,0,0,0
,20130522,4627,4627,4692,4695,4678,4695,4688,68,61,6,42.2,6
,20130523,4695,4688,4626,4634,4612,4634,4624,-54,-64,6,41.62,4
,20130524,4634,4624,4690,4694,4690,4694,4692,70,68,4,28.15,8
,20130527,4694,4692,4627,4711,4578,4711,4671,19,-21,22,154.17,16
,20130528,4711,4671,4682,4682,4682,4682,4682,11,11,16,112.37,32
,20130529,4682,4682,4678,4678,4670,4670,4674,-12,-8,4,28.04,32
,20130530,4670,4674,4683,4715,4680,4715,4699,41,25,10,70.49,36
,20130531,4715,4699,4839,4839,4749,4749,4787,50,88,12,86.18,36
,20130603,4749,4787,,,,4735,4735,-52,-52,0,0,36
,20130604,4735,4735,,,,4748,4748,13,13,0,0,36
,20130605,4748,4748,4700,4730,4689,4730,4702,-18,-46,8,56.43,34
,20130606,4730,4702,4700,4700,4682,4682,4692,-20,-10,6,42.23,32
,20130607,4682,4692,4730,4730,4730,4730,4730,38,38,2,14.19,34
,20130613,4730,4730,4560,4601,4560,4601,4590,-129,-140,8,55.08,38
,20130614,4601,4590,4587,4587,4567,4567,4576,-23,-14,12,82.37,40
,20130617,4567,4576,4601,4604,4596,4596,4601,20,25,12,82.83,46
,20130618,4596,4601,4601,4601,4569,4570,4574,-31,-27,24,164.69,56
,20130619,4570,4574,4563,4563,4526,4526,4555,-48,-19,16,109.32,56
,20130620,4526,4555,4453,4453,4375,4375,4447,-180,-108,34,226.82,72
,20130621,4375,4447,4180,4186,4180,4186,4180,-261,-267,68,426.38,112
,20130624,4186,4180,4248,4248,4087,4104,4125,-76,-55,50,309.43,110
,20130625,4104,4125,4095,4143,4095,4130,4125,5,0,34,210.39,104
,20130626,4130,4125,4045,4045,3916,3950,3973,-175,-152,52,309.94,100
,20130627,3950,3973,3939,3950,3911,3927,3930,-46,-43,26,153.29,102
,20130628,3927,3930,3808,3948,3808,3926,3891,-4,-39,34,198.46,106
,20130701,3926,3891,4036,4116,4036,4116,4082,225,191,24,146.95,92
,20130702,4116,4082,4104,4104,4104,4104,4104,22,22,2,12.31,92
,20130703,4104,4104,4097,4100,4062,4086,4075,-18,-29,22,134.5,94
,20130704,4086,4075,4109,4109,4109,4109,4109,34,34,2,12.33,94
,20130705,4109,4109,4026,4026,4002,4015,4014,-94,-95,16,96.34,96
,20130708,4015,4014,3954,3956,3889,3903,3925,-111,-89,16,94.21,102
,20130709,3903,3925,3903,4066,3903,4035,4016,110,91,44,265.06,102
,20130710,4035,4016,3996,4022,3965,3999,4002,-17,-14,46,276.2,106
,20130711,3999,4002,4107,4198,4105,4172,4153,170,151,26,161.98,102
,20130712,4172,4153,4157,4160,4119,4119,4152,-34,-1,12,74.74,100
,20130715,4119,4152,4135,4181,4122,4146,4146,-6,-6,14,87.07,94
,20130716,4146,4146,4142,4142,4099,4137,4119,-9,-27,32,197.76,96
,20130717,4137,4119,4129,4148,4128,4133,4134,14,15,20,124.02,94
,20130718,4133,4134,4169,4174,4015,4015,4049,-119,-85,26,157.93,102
,20130719,4015,4049,4020,4062,4020,4038,4042,-11,-7,20,121.27,104
,20130722,4038,4042,4115,4115,4105,4105,4108,63,66,6,36.98,100
,20130723,4105,4108,4205,4210,4205,4210,4207,102,99,4,25.25,96
,20130724,4210,4207,4175,4195,4166,4187,4178,-20,-29,54,338.45,102
,20130725,4187,4178,4160,4166,4119,4119,4135,-59,-43,136,843.73,192
,20130726,4119,4135,4148,4148,4115,4122,4132,-13,-3,122,756.16,276
,20130729,4122,4132,4041,4042,4017,4033,4030,-99,-102,28,169.3,264
,20130730,4033,4030,4039,4039,4027,4027,4030,-3,0,10,60.45,258
,20130731,4027,4030,4014,4054,4006,4040,4020,10,-10,30,180.93,254
,20130801,4040,4020,3995,4026,3995,4014,4003,-6,-17,44,264.23,242
,20130802,4014,4003,3951,3961,3950,3950,3953,-53,-50,14,83.02,238
,20130805,3950,3953,4066,4066,4039,4057,4048,104,95,38,230.79,242
,20130806,4057,4048,4016,4016,4016,4016,4016,-32,-32,10,60.24,238
,20130807,4016,4016,3980,3980,3977,3977,3979,-39,-37,6,35.81,234
,20130808,3977,3979,3989,4057,3989,4040,4028,61,49,14,84.61,230
,20130809,4040,4028,4131,4134,4117,4119,4123,91,95,54,334.03,276
,20130812,4119,4123,4172,4311,4164,4303,4247,180,124,26,165.65,280
,20130813,4303,4247,4347,4403,4324,4403,4338,156,91,18,117.13,294
,20130814,4403,4338,4395,4395,4383,4383,4385,45,47,12,78.93,304
,20130815,4383,4385,4400,4510,4400,4471,4476,86,91,34,228.32,300
,20130816,4471,4476,4596,4710,4596,4671,4681,195,205,76,533.73,300
,20130819,4671,4681,4706,4802,4679,4709,4750,28,69,68,484.54,292
,20130820,4709,4750,4709,4709,4504,4590,4625,-160,-125,26,180.41,296
,20130821,4590,4625,4625,4687,4625,4659,4663,34,38,20,139.91,294
,20130822,4659,4663,4644,4653,4595,4627,4630,-36,-33,18,125.01,284
,20130823,4627,4630,4673,4691,4673,4691,4681,61,51,16,112.36,286
,20130826,4691,4681,4885,4930,4885,4922,4916,241,235,24,176.99,300
,20130827,4922,4916,4967,4984,4933,4959,4958,43,42,20,148.75,302
,20130828,4959,4958,5040,5114,5007,5114,5086,156,128,26,198.38,304
,20130829,5114,5086,4923,4951,4854,4854,4901,-232,-185,64,470.55,294
,20130830,4854,4901,4847,4847,4832,4832,4837,-69,-64,6,43.53,294
,20130902,4832,4837,4775,4948,4757,4929,4868,92,31,42,306.69,292
,20130903,4929,4868,4934,4945,4897,4897,4931,29,63,10,73.97,292
,20130904,4897,4931,4971,4991,4860,4860,4968,-71,37,30,223.56,294
,20130905,4860,4968,4789,4801,4694,4759,4759,-209,-209,38,271.29,292
,20130906,4759,4759,4763,4763,4718,4743,4739,-16,-20,16,113.74,286
,20130909,4743,4739,4876,4876,4804,4832,4841,93,102,62,450.27,296
,20130910,4832,4841,4813,4840,4807,4808,4822,-33,-19,66,477.46,298
,20130911,4808,4822,4684,4748,4661,4748,4704,-74,-118,34,239.94,300
,20130912,4748,4704,4706,4721,4626,4642,4697,-62,-7,48,338.25,304
,20130913,4642,4697,4504,4516,4450,4456,4481,-241,-216,76,510.93,286
,20130916,4456,4481,4475,4547,4460,4473,4498,-8,17,86,580.26,286
,20130917,4473,4498,4460,4485,4460,4485,4473,-13,-25,24,161.05,294
,20130918,4485,4473,4412,4431,4412,4431,4419,-42,-54,6,39.78,290
,20130923,4431,4419,4364,4454,4342,4454,4386,35,-33,16,105.27,284
,20130924,4454,4386,4448,4482,4448,4455,4464,69,78,14,93.76,280
,20130925,4455,4464,4484,4484,4435,4470,4456,6,-8,8,53.47,280
,20130926,4470,4456,4440,4460,4440,4460,4459,4,3,46,307.68,274
,20130927,4460,4459,4459,4459,4424,4424,4453,-35,-6,34,227.12,260
,20130930,4424,4453,,,,4468,4468,15,15,0,0,260
,20131008,4468,4468,4545,4566,4517,4556,4536,88,68,44,299.42,254
,20131009,4556,4536,4574,4582,4533,4554,4565,18,29,56,383.52,254
,20131010,4554,4565,4491,4491,4450,4479,4476,-86,-89,30,201.45,260
,20131011,4479,4476,4473,4473,4444,4444,4451,-32,-25,24,160.25,260
,20131014,4444,4451,4373,4387,4336,4387,4338,-64,-113,216,"1,405.71",462
,20131015,4387,4338,4405,4405,4310,4311,4340,-27,2,52,338.54,450
,20131016,4311,4340,4311,4371,4311,4367,4354,27,14,36,235.16,450
,20131017,4367,4354,4342,4415,4324,4324,4374,-30,20,44,288.71,454
,20131018,4324,4374,4436,4456,4418,4456,4434,82,60,76,505.5,466
,20131021,4456,4434,4460,4532,4457,4527,4494,93,60,142,957.23,504
,20131022,4527,4494,4540,4557,4495,4524,4530,30,36,92,625.18,490
,20131023,4524,4530,4577,4633,4565,4600,4603,70,73,298,"2,057.83",550
,20131024,4600,4603,4590,4619,4581,4619,4592,16,-11,126,867.91,464
,20131025,4619,4592,4637,4637,4535,4535,4584,-57,-8,60,412.61,468
,20131028,4535,4584,4509,4573,4509,4571,4542,-13,-42,70,476.96,450
,20131029,4571,4542,4535,4567,4535,4558,4551,16,9,420,"2,867.57",566
,20131030,4558,4551,4558,4616,4546,4598,4583,47,32,320,"2,200.28",466
,20131031,4598,4583,4672,4672,4498,4507,4550,-76,-33,312,"2,129.76",454
,20131101,4507,4550,4450,4464,4418,4431,4441,-119,-109,320,"2,132.04",490
,20131104,4431,4441,4427,4435,4400,4409,4418,-32,-23,168,"1,113.52",484
,20131105,4409,4418,4450,4450,4387,4427,4419,9,1,140,928.17,468
,20131106,4427,4419,4417,4428,4415,4421,4421,2,2,56,371.4,464
,20131107,4421,4421,4453,4455,4421,4455,4439,34,18,144,959.04,466
,20131108,4455,4439,4480,4480,4380,4416,4422,-23,-17,130,862.41,460
,20131111,4416,4422,4389,4465,4361,4363,4398,-59,-24,150,989.7,466
,20131112,4363,4398,4369,4375,4318,4340,4347,-58,-51,156,"1,017.23",492
,20131113,4340,4347,4340,4346,4257,4278,4282,-69,-65,148,950.63,488
,20131114,4278,4282,4282,4320,4253,4302,4282,20,0,118,758.08,490
,20131115,4302,4282,4291,4312,4275,4275,4292,-7,10,118,759.81,524
,20131118,4275,4292,4276,4283,4253,4270,4268,-22,-24,84,537.8,542
,20131119,4270,4268,4229,4246,4180,4196,4217,-72,-51,288,"1,822.06",594
,20131120,4196,4217,4203,4231,4197,4231,4214,14,-3,146,923.06,596
,20131121,4231,4214,4198,4220,4135,4157,4167,-57,-47,256,"1,600.26",676
,20131122,4157,4167,4159,4180,4144,4152,4166,-15,-1,902,"5,636.77",698
,20131125,4152,4166,4152,4176,4101,4109,4147,-57,-19,414,"2,575.69",712
,20131126,4109,4147,4111,4201,4106,4191,4178,44,31,608,"3,811.05",774
,20131127,4191,4178,4170,4183,4153,4168,4163,-10,-15,576,"3,596.93",696
,20131128,4168,4163,4180,4184,4125,4150,4152,-13,-11,376,"2,342.22",760
,20131129,4150,4152,4157,4165,4138,4139,4148,-13,-4,222,"1,381.61",786
,20131202,4139,4148,4175,4195,4147,4164,4171,16,23,838,"5,243.63",756
,20131203,4164,4171,4158,4158,4062,4074,4101,-97,-70,800,"4,921.58",846
,20131204,4074,4101,4073,4076,4044,4063,4058,-38,-43,1110,"6,756.90",1090
,20131205,4063,4058,4081,4136,4068,4102,4097,44,39,4274,"26,270.62",974
,20131206,4102,4097,4065,4132,4065,4116,4100,19,3,714,"4,391.66",952
,20131209,4116,4100,4108,4156,4079,4147,4128,47,28,850,"5,264.03",988
,20131210,4147,4128,4161,4224,4146,4220,4172,92,44,1546,"9,676.40",1030
,20131211,4220,4172,4233,4281,4233,4258,4259,86,87,1742,"11,129.20",1228
,20131212,4258,4259,4256,4288,4250,4265,4265,6,6,466,"2,981.39",1212
,20131213,4265,4265,4200,4200,4071,4093,4123,-172,-142,1392,"8,609.94",1188
,20131216,4093,4123,4123,4126,4093,4099,4106,-24,-17,1594,"9,817.67",1294
,20131217,4099,4106,4116,4255,4116,4209,4194,103,88,2956,"18,598.78",1360
,20131218,4209,4194,4180,4230,4144,4191,4177,-3,-17,1444,"9,048.38",1404
,20131219,4191,4177,4180,4217,4073,4123,4127,-54,-50,5818,"36,017.13",1644
,20131220,4123,4127,4071,4074,4037,4047,4053,-80,-74,1560,"9,485.39",1654
,20131223,4047,4053,4059,4115,4041,4095,4082,42,29,1370,"8,389.32",1644
,20131224,4095,4082,4103,4107,4054,4054,4071,-28,-11,1184,"7,231.56",1918
,20131225,4054,4071,4069,4092,4057,4087,4080,16,9,1820,"11,139.14",1768
,20131226,4087,4080,4092,4099,4066,4079,4085,-1,5,796,"4,877.86",1718
,20131227,4079,4085,4088,4183,4088,4174,4145,89,60,1374,"8,543.56",1778
,20131230,4174,4145,4164,4214,4132,4139,4169,-6,24,1810,"11,321.24",1970
,20131231,4139,4169,4117,4151,4063,4077,4102,-92,-67,3542,"21,796.04",2024
ag1406,20130618,4601,4601,4643,4643,4556,4575,4579,-26,-22,44,302.27,22
,20130619,4575,4579,4569,4569,4527,4560,4547,-19,-32,126,859.55,68
,20130620,4560,4547,4450,4496,4390,4399,4449,-148,-98,320,"2,135.65",172
,20130621,4399,4449,4182,4209,4182,4195,4189,-254,-260,616,"3,870.94",378
,20130624,4195,4189,4222,4236,4096,4109,4162,-80,-27,322,"2,010.60",398
,20130625,4109,4162,4135,4148,4096,4139,4117,-23,-45,200,"1,235.31",428
,20130626,4139,4117,4105,4108,3909,3955,3981,-162,-136,692,"4,132.33",554
,20130627,3955,3981,3933,3980,3903,3939,3943,-42,-38,374,"2,212.46",618
,20130628,3939,3943,3867,3968,3817,3943,3902,0,-41,402,"2,353.47",624
,20130701,3943,3902,4040,4136,4032,4136,4088,234,186,608,"3,728.60",588
,20130702,4136,4088,4116,4148,4089,4137,4119,49,31,230,"1,421.26",600
,20130703,4137,4119,4116,4120,4083,4110,4104,-9,-15,200,"1,231.22",652
,20130704,4110,4104,4114,4140,4114,4114,4121,10,17,86,531.65,654
,20130705,4114,4121,4105,4105,4001,4033,4042,-88,-79,316,"1,916.02",746
,20130708,4033,4042,3972,3975,3928,3935,3948,-107,-94,528,"3,127.09",754
,20130709,3935,3948,3983,4084,3978,4048,4022,100,74,468,"2,823.97",614
,20130710,4048,4022,4051,4051,3973,4010,4007,-12,-15,190,"1,142.22",618
,20130711,4010,4007,4025,4244,3997,4182,4154,175,147,482,"3,003.75",518
,20130712,4182,4154,4192,4217,4134,4140,4177,-14,23,230,"1,441.08",510
,20130715,4140,4177,4137,4207,4136,4160,4180,-17,3,178,"1,116.11",536
,20130716,4160,4180,4147,4158,4122,4136,4144,-44,-36,110,683.82,564
,20130717,4136,4144,4163,4180,4142,4156,4160,12,16,268,"1,672.35",580
,20130718,4156,4160,4185,4193,4014,4039,4049,-121,-111,692,"4,203.19",846
,20130719,4039,4049,4065,4084,4012,4035,4051,-14,2,384,"2,333.83",820
,20130722,4035,4051,4051,4167,4041,4152,4129,101,78,720,"4,459.77",842
,20130723,4152,4129,4209,4228,4179,4184,4209,55,80,550,"3,473.03",862
,20130724,4184,4209,4166,4201,4166,4200,4191,-9,-18,238,"1,496.22",910
,20130725,4200,4191,4170,4173,4119,4126,4144,-65,-47,2062,"12,819.19",1966
,20130726,4126,4144,4141,4149,4100,4119,4127,-25,-17,1278,"7,912.71",2384
,20130729,4119,4127,4075,4079,4018,4020,4038,-107,-89,886,"5,366.71",2330
,20130730,4020,4038,4065,4065,4025,4026,4041,-12,3,752,"4,558.69",2060
,20130731,4026,4041,4033,4088,4024,4066,4040,25,-1,706,"4,278.89",1922
,20130801,4066,4040,4049,4086,4006,4022,4023,-18,-17,1820,"10,983.50",1522
,20130802,4022,4023,4058,4058,3958,3973,3998,-50,-25,914,"5,482.16",1608
,20130805,3973,3998,4087,4106,4049,4071,4067,73,69,768,"4,685.69",1548
,20130806,4071,4067,4012,4042,4008,4025,4028,-42,-39,374,"2,260.07",1580
,20130807,4025,4028,4020,4023,3975,3993,3996,-35,-32,532,"3,189.26",1670
,20130808,3993,3996,3987,4076,3984,4048,4035,52,39,528,"3,195.73",1834
,20130809,4048,4035,4080,4150,4060,4110,4117,75,82,1156,"7,139.35",2242
,20130812,4110,4117,4107,4336,4107,4329,4257,212,140,1232,"7,867.82",2152
,20130813,4329,4257,4336,4444,4319,4419,4358,162,101,1362,"8,904.53",2608
,20130814,4419,4358,4430,4442,4366,4372,4399,14,41,860,"5,674.97",2674
,20130815,4372,4399,4435,4530,4391,4497,4479,98,80,894,"6,006.69",2766
,20130816,4497,4479,4449,4747,4444,4694,4669,215,190,2926,"20,492.29",2512
,20130819,4694,4669,4707,4824,4691,4729,4763,60,94,2082,"14,877.78",2168
,20130820,4729,4763,4710,4743,4537,4605,4651,-158,-112,1666,"11,623.09",2232
,20130821,4605,4651,4658,4724,4635,4670,4673,19,22,1038,"7,275.98",2176
,20130822,4670,4673,4660,4698,4600,4660,4643,-13,-30,1330,"9,264.69",2244
,20130823,4660,4643,4715,4731,4660,4713,4703,70,60,1152,"8,128.48",2170
,20130826,4713,4703,4708,4970,4698,4966,4901,263,198,1214,"8,926.42",2406
,20130827,4966,4901,4959,5028,4899,4966,4962,65,61,4446,"33,094.83",3604
,20130828,4966,4962,5030,5149,5010,5102,5073,140,111,5448,"41,460.76",4910
,20130829,5102,5073,5102,5119,4790,4898,4926,-175,-147,6068,"44,837.78",4178
,20130830,4898,4926,4917,4917,4793,4817,4851,-109,-75,1454,"10,580.95",4152
,20130902,4817,4851,4776,4986,4739,4963,4871,112,20,1710,"12,494.53",4326
,20130903,4963,4871,4968,4972,4904,4940,4943,69,72,1210,"8,971.79",4376
,20130904,4940,4943,5008,5017,4848,4891,4953,-52,10,4156,"30,881.44",5998
,20130905,4891,4953,4799,4838,4731,4760,4784,-193,-169,1610,"11,554.38",5852
,20130906,4760,4784,4774,4777,4713,4768,4751,-16,-33,976,"6,956.24",5810
,20130909,4768,4751,4850,4887,4830,4866,4860,115,109,1382,"10,076.77",5904
,20130910,4866,4860,4842,4868,4752,4779,4807,-81,-53,878,"6,330.95",5876
,20130911,4779,4807,4734,4756,4659,4729,4709,-78,-98,2092,"14,777.58",5968
,20130912,4729,4709,4719,4739,4651,4657,4697,-52,-12,872,"6,143.71",5956
,20130913,4657,4697,4552,4552,4449,4470,4498,-227,-199,3450,"23,277.31",5894
,20130916,4470,4498,4500,4567,4450,4473,4516,-25,18,2170,"14,701.17",5932
,20130917,4473,4516,4473,4536,4472,4511,4499,-5,-17,1168,"7,883.83",5828
,20130918,4511,4499,4491,4501,4397,4467,4438,-32,-61,1904,"12,677.58",5956
,20130923,4467,4438,4435,4488,4359,4458,4421,20,-17,2514,"16,671.71",6154
,20130924,4458,4421,4453,4520,4447,4454,4482,33,61,2144,"14,415.44",6286
,20130925,4454,4482,4398,4492,4372,4470,4450,-12,-32,1468,"9,799.41",6208
,20130926,4470,4450,4453,4501,4445,4466,4471,16,21,1658,"11,119.64",6232
,20130927,4466,4471,4486,4493,4422,4422,4449,-49,-22,1476,"9,850.61",5898
,20130930,4422,4449,4475,4477,4429,4456,4450,7,1,1680,"11,215.34",6082
,20131008,4456,4450,4518,4582,4518,4573,4554,123,104,2074,"14,169.41",6360
,20131009,4573,4554,4574,4586,4545,4558,4568,4,14,4626,"31,698.96",8774
,20131010,4558,4568,4488,4510,4474,4487,4487,-81,-81,3420,"23,021.10",8568
,20131011,4487,4487,4493,4498,4405,4413,4454,-74,-33,3636,"24,294.16",9088
,20131014,4413,4454,4360,4394,4333,4380,4359,-74,-95,6374,"41,678.69",10768
,20131015,4380,4359,4410,4410,4312,4331,4350,-28,-9,5258,"34,313.24",11496
,20131016,4331,4350,4300,4380,4300,4377,4351,27,1,5450,"35,576.83",12236
,20131017,4377,4351,4368,4425,4329,4331,4371,-20,20,7464,"48,943.23",12686
,20131018,4331,4371,4453,4474,4425,4474,4447,103,76,7308,"48,752.80",12982
,20131021,4474,4447,4487,4549,4455,4535,4499,88,52,7090,"47,851.84",14510
,20131022,4535,4499,4521,4555,4500,4519,4523,20,24,6878,"46,671.71",15960
,20131023,4519,4523,4565,4639,4558,4610,4610,87,87,11810,"81,679.65",17908
,20131024,4610,4610,4630,4630,4588,4626,4607,16,-3,9422,"65,113.85",18068
,20131025,4626,4607,4607,4634,4540,4553,4594,-54,-13,10008,"68,972.31",18268
,20131028,4553,4594,4541,4594,4523,4566,4556,-28,-38,11100,"75,869.62",18012
,20131029,4566,4556,4567,4585,4556,4580,4568,24,12,10622,"72,797.80",19070
,20131030,4580,4568,4569,4614,4542,4606,4572,38,4,8924,"61,212.30",20676
,20131031,4606,4572,4650,4675,4490,4503,4538,-69,-34,50834,"346,062.09",49038
,20131101,4503,4538,4420,4458,4407,4439,4436,-99,-102,41740,"277,790.34",60416
,20131104,4439,4436,4435,4442,4404,4406,4422,-30,-14,31640,"209,875.81",58514
,20131105,4406,4422,4427,4440,4398,4427,4421,5,-1,48132,"319,235.93",43196
,20131106,4427,4421,4428,4438,4412,4438,4424,17,3,24754,"164,296.52",42666
,20131107,4438,4424,4465,4469,4425,4459,4446,35,22,29204,"194,775.07",44762
,20131108,4459,4446,4472,4480,4370,4432,4419,-14,-27,39786,"263,751.07",46476
,20131111,4432,4419,4428,4464,4365,4373,4389,-46,-30,50440,"332,091.27",49084
,20131112,4373,4389,4370,4380,4316,4350,4346,-39,-43,43480,"283,448.04",54506
,20131113,4350,4346,4345,4362,4249,4271,4290,-75,-56,70232,"451,970.46",67818
,20131114,4271,4290,4280,4325,4243,4302,4289,12,-1,73266,"471,434.59",73776
,20131115,4302,4289,4289,4316,4278,4278,4294,-11,5,72712,"468,404.38",84462
,20131118,4278,4294,4284,4290,4252,4269,4273,-25,-21,66892,"428,817.12",96644
,20131119,4269,4273,4254,4257,4171,4192,4206,-81,-67,118724,"749,151.22",120522
,20131120,4192,4206,4210,4246,4202,4244,4220,38,14,109822,"695,182.27",136254
,20131121,4244,4220,4218,4227,4131,4150,4177,-70,-43,216364,"1,355,656.36",157562
,20131122,4150,4177,4156,4177,4137,4157,4158,-20,-19,147360,"919,090.59",156470
,20131125,4157,4158,4160,4171,4098,4103,4134,-55,-24,191064,"1,185,020.22",186678
,20131126,4103,4134,4114,4202,4099,4190,4162,56,28,352746,"2,202,230.84",198586
,20131127,4190,4162,4172,4183,4149,4169,4167,7,5,406552,"2,541,590.49",228204
,20131128,4169,4167,4173,4185,4126,4150,4157,-17,-10,799684,"4,986,908.81",298750
,20131129,4150,4157,4152,4162,4132,4147,4146,-10,-11,616656,"3,835,755.46",341668
,20131202,4147,4146,4200,4200,4150,4170,4175,24,29,935634,"5,860,425.86",376868
,20131203,4170,4175,4146,4151,4061,4078,4105,-97,-70,1435238,"8,838,653.15",465478
,20131204,4078,4105,4074,4079,4043,4063,4063,-42,-42,1531380,"9,333,784.22",493428
,20131205,4063,4063,4082,4150,4063,4114,4103,51,40,2001458,"12,318,469.49",478288
,20131206,4114,4103,4095,4143,4075,4122,4103,19,0,2343196,"14,423,073.43",511952
,20131209,4122,4103,4116,4181,4083,4152,4140,49,37,3018118,"18,746,663.07",562338
,20131210,4152,4140,4153,4236,4152,4232,4181,92,41,2048834,"12,851,393.10",613734
,20131211,4232,4181,4251,4294,4248,4276,4277,95,96,2453760,"15,743,170.04",597932
,20131212,4276,4277,4267,4310,4263,4281,4283,4,6,2052732,"13,188,364.94",606276
,20131213,4281,4283,4193,4203,4084,4102,4149,-181,-134,3156432,"19,644,472.01",598110
,20131216,4102,4149,4118,4144,4104,4116,4123,-33,-26,2245612,"13,890,588.96",594870
,20131217,4116,4123,4128,4272,4126,4219,4199,96,76,4046964,"25,490,962.76",594490
,20131218,4219,4199,4196,4247,4152,4205,4195,6,-4,3755048,"23,633,682.47",618996
,20131219,4205,4195,4201,4234,4095,4138,4177,-57,-18,3439356,"21,554,146.32",651792
,20131220,4138,4177,4080,4092,4046,4059,4073,-118,-104,2712018,"16,571,660.13",672522
,20131223,4059,4073,4065,4130,4055,4101,4093,28,20,2783272,"17,089,795.92",702166
,20131224,4101,4093,4114,4125,4065,4076,4099,-17,6,1930942,"11,873,235.85",699852
,20131225,4076,4099,4084,4113,4070,4102,4093,3,-6,1564986,"9,610,265.41",652948
,20131226,4102,4093,4106,4115,4082,4099,4098,6,5,1179044,"7,248,165.57",649654
,20131227,4099,4098,4104,4202,4101,4196,4155,98,57,2904058,"18,103,270.61",676200
,20131230,4196,4155,4184,4233,4149,4159,4200,4,45,2886732,"18,188,310.05",648554
,20131231,4159,4200,4140,4174,4079,4099,4136,-101,-64,2712884,"16,831,337.39",625272
ag1407,20130716,4180,4180,,,,4180,4180,0,0,0,0,0
,20130717,4180,4180,,,,4180,4180,0,0,0,0,0
,20130718,4180,4180,,,,4180,4180,0,0,0,0,0
,20130719,4180,4180,4030,4061,4030,4061,4045,-119,-135,8,48.55,6
,20130722,4061,4045,4055,4149,4040,4149,4081,104,36,28,171.4,10
,20130723,4149,4081,4190,4247,4162,4196,4184,115,103,78,489.63,10
,20130724,4196,4184,4185,4200,4185,4198,4194,14,10,6,37.75,8
,20130725,4198,4194,4203,4203,4177,4177,4190,-17,-4,4,25.14,10
,20130726,4177,4190,4150,4156,4111,4128,4140,-62,-50,30,186.33,22
,20130729,4128,4140,4062,4075,4031,4056,4050,-84,-90,12,72.91,18
,20130730,4056,4050,,,,4053,4053,3,3,0,0,18
,20130731,4053,4053,4034,4063,4032,4063,4049,10,-4,18,109.33,8
,20130801,4063,4049,4023,4041,4012,4012,4025,-37,-24,6,36.23,8
,20130802,4012,4025,4054,4054,3970,3970,4005,-55,-20,6,36.05,10
,20130805,3970,4005,4070,4076,4070,4076,4073,71,68,4,24.44,8
,20130806,4076,4073,4034,4034,4034,4034,4034,-39,-39,2,12.1,8
,20130807,4034,4034,4051,4051,4009,4010,4023,-24,-11,12,72.41,10
,20130808,4010,4023,4070,4070,4070,4070,4070,47,47,2,12.21,10
,20130809,4070,4070,4078,4154,4078,4135,4135,65,65,60,372.21,22
,20130812,4135,4135,4165,4302,4165,4302,4250,167,115,10,63.75,28
,20130813,4302,4250,4366,4415,4339,4415,4370,165,120,18,117.99,32
,20130814,4415,4370,4424,4424,4391,4395,4397,25,27,22,145.13,34
,20130815,4395,4397,4427,4476,4419,4476,4433,79,36,14,93.1,28
,20130816,4476,4433,4464,4698,4464,4698,4625,265,192,24,166.52,36
,20130819,4698,4625,4706,4849,4706,4720,4769,95,144,30,214.64,32
,20130820,4720,4769,4732,4732,4551,4552,4649,-217,-120,26,181.31,34
,20130821,4552,4649,4676,4716,4650,4679,4683,30,34,18,126.46,30
,20130822,4679,4683,4686,4686,4599,4683,4656,0,-27,34,237.47,34
,20130823,4683,4656,4717,4734,4689,4689,4719,33,63,34,240.71,38
,20130826,4689,4719,4829,4953,4829,4945,4882,226,163,42,307.58,38
,20130827,4945,4882,5000,5013,4934,4934,4969,52,87,32,238.56,42
,20130828,4934,4969,5040,5125,5040,5100,5097,131,128,22,168.23,40
,20130829,5100,5097,4950,4990,4820,4918,4924,-179,-173,18,132.95,34
,20130830,4918,4924,4802,4825,4795,4825,4807,-99,-117,20,144.24,34
,20130902,4825,4807,4777,4998,4749,4944,4853,137,46,46,334.87,48
,20130903,4944,4853,4954,4978,4932,4932,4958,79,105,36,267.74,50
,20130904,4932,4958,5019,5019,4850,4881,4945,-77,-13,14,103.85,48
,20130905,4881,4945,4797,4813,4760,4760,4796,-185,-149,70,503.63,50
,20130906,4760,4796,4781,4781,4751,4759,4760,-37,-36,20,142.8,46
,20130909,4759,4760,4889,4889,4806,4865,4840,105,80,46,333.97,56
,20130910,4865,4840,4850,4852,4819,4819,4836,-21,-4,16,116.08,58
,20130911,4819,4836,4707,4707,4691,4694,4699,-142,-137,18,126.87,62
,20130912,4694,4699,4733,4746,4700,4700,4726,1,27,26,184.33,58
,20130913,4700,4726,4526,4526,4471,4471,4498,-255,-228,4,26.99,58
,20130916,4471,4498,4488,4543,4487,4488,4503,-10,5,12,81.06,58
,20130917,4488,4503,4528,4528,4526,4526,4527,23,24,4,27.16,56
,20130918,4526,4527,4419,4419,4419,4419,4419,-108,-108,6,39.77,56
,20130923,4419,4419,4384,4483,4384,4483,4426,64,7,12,79.67,52
,20130924,4483,4426,4468,4495,4468,4485,4482,59,56,6,40.34,52
,20130925,4485,4482,4503,4509,4481,4488,4492,6,10,268,"1,805.81",242
,20130926,4488,4492,4487,4515,4470,4490,4492,-2,0,220,"1,482.59",286
,20130927,4490,4492,4497,4505,4457,4457,4490,-35,-2,48,323.29,270
,20130930,4457,4490,4473,4473,4444,4458,4456,-32,-34,380,"2,540.20",200
,20131008,4458,4456,4531,4572,4531,4570,4553,114,97,14,95.63,208
,20131009,4570,4553,4585,4598,4567,4573,4584,20,31,48,330.08,200
,20131010,4573,4584,4481,4510,4479,4510,4488,-74,-96,38,255.87,186
,20131011,4510,4488,4476,4476,4434,4437,4447,-51,-41,10,66.71,186
,20131014,4437,4447,4368,4370,4343,4367,4353,-80,-94,46,300.38,160
,20131015,4367,4353,4393,4393,4332,4332,4358,-21,5,10,65.37,156
,20131016,4332,4358,,,,4358,4358,0,0,0,0,156
,20131017,4358,4358,4382,4382,4347,4356,4364,-2,6,34,222.6,148
,20131018,4356,4364,4451,4451,4434,4434,4441,70,77,8,53.29,148
,20131021,4434,4441,4467,4538,4467,4538,4487,97,46,8,53.85,150
,20131022,4538,4487,4541,4541,4517,4532,4530,45,43,6,40.77,150
,20131023,4532,4530,4577,4633,4577,4615,4593,85,63,40,275.62,150
,20131024,4615,4593,4590,4630,4584,4626,4602,33,9,36,248.54,148
,20131025,4626,4602,4628,4628,4602,4607,4622,5,20,88,610.15,196
,20131028,4607,4622,4535,4568,4522,4568,4539,-54,-83,180,"1,225.64",238
,20131029,4568,4539,4581,4581,4562,4570,4571,31,32,26,178.29,228
,20131030,4570,4571,4578,4614,4555,4614,4580,43,9,56,384.79,184
,20131031,4614,4580,4677,4677,4512,4516,4563,-64,-17,132,903.52,192
,20131101,4516,4563,4450,4460,4419,4419,4446,-144,-117,26,173.4,190
,20131104,4419,4446,4437,4437,4406,4416,4421,-30,-25,78,517.36,154
,20131105,4416,4421,4427,4433,4400,4433,4417,12,-4,48,318.07,148
,20131106,4433,4417,4422,4435,4422,4435,4427,18,10,10,66.41,154
,20131107,4435,4427,,,,4449,4449,22,22,0,0,154
,20131108,4449,4449,4423,4432,4423,4432,4426,-17,-23,10,66.4,152
,20131111,4432,4426,4454,4454,4378,4380,4421,-46,-5,36,238.74,146
,20131112,4380,4421,4341,4343,4335,4343,4338,-78,-83,8,52.06,142
,20131113,4343,4338,4311,4311,4284,4284,4296,-54,-42,18,116.02,142
,20131114,4284,4296,4267,4304,4265,4293,4284,-3,-12,22,141.38,124
,20131115,4293,4284,4305,4370,4285,4285,4305,1,21,20,129.17,126
,20131118,4285,4305,4289,4289,4265,4271,4276,-34,-29,38,243.76,150
,20131119,4271,4276,4233,4233,4188,4188,4207,-88,-69,36,227.21,162
,20131120,4188,4207,4217,4239,4217,4233,4226,26,19,10,63.39,160
,20131121,4233,4226,4217,4224,4157,4157,4208,-69,-18,22,138.88,170
,20131122,4157,4208,4161,4161,4161,4161,4161,-47,-47,4,24.97,166
,20131125,4161,4161,4159,4167,4120,4120,4137,-41,-24,22,136.52,166
,20131126,4120,4137,4110,4202,4109,4202,4155,65,18,34,211.91,168
,20131127,4202,4155,4170,4170,4170,4170,4170,15,15,2,12.51,168
,20131128,4170,4170,4173,4173,4151,4160,4159,-10,-11,22,137.25,168
,20131129,4160,4159,4163,4163,4144,4146,4153,-13,-6,10,62.3,166
,20131202,4146,4153,4196,4198,4155,4166,4176,13,23,28,175.4,158
,20131203,4166,4176,4150,4150,4090,4090,4123,-86,-53,50,309.28,142
,20131204,4090,4123,4083,4084,4057,4072,4064,-51,-59,66,402.36,134
,20131205,4072,4064,4089,4132,4089,4128,4098,64,34,48,295.06,146
,20131206,4128,4098,4092,4137,4092,4097,4109,-1,11,50,308.21,150
,20131209,4097,4109,4133,4164,4133,4146,4151,37,42,200,"1,245.53",142
,20131210,4146,4151,4166,4239,4166,4238,4192,87,41,364,"2,288.92",292
,20131211,4238,4192,4275,4301,4270,4280,4289,88,97,236,"1,518.52",160
,20131212,4280,4289,4283,4305,4278,4286,4284,-3,-5,94,604.12,158
,20131213,4286,4284,4201,4201,4100,4113,4132,-171,-152,52,322.35,172
,20131216,4113,4132,4113,4152,4113,4115,4131,-17,-1,56,347.05,168
,20131217,4115,4131,4178,4275,4145,4236,4181,105,50,604,"3,788.44",274
,20131218,4236,4181,4178,4248,4173,4219,4194,38,13,114,717.19,246
,20131219,4219,4194,4223,4236,4132,4132,4192,-62,-2,62,389.86,244
,20131220,4132,4192,4132,4132,4057,4057,4087,-135,-105,190,"1,165.06",214
,20131223,4057,4087,4063,4125,4063,4110,4090,23,3,588,"3,608.23",518
,20131224,4110,4090,4110,4121,4078,4078,4106,-12,16,92,566.65,512
,20131225,4078,4106,4090,4113,4090,4093,4098,-13,-8,12,73.78,510
,20131226,4093,4098,4114,4114,4093,4100,4103,2,5,14,86.18,512
,20131227,4100,4103,4120,4195,4120,4195,4160,92,57,40,249.62,510
,20131230,4195,4160,4190,4230,4157,4164,4198,4,38,124,780.83,510
,20131231,4164,4198,4157,4164,4104,4110,4146,-88,-52,52,323.39,508
ag1408,20130816,4433,4433,4433,4723,4433,4723,4578,290,145,4,27.47,2
,20130819,4723,4578,4729,4790,4700,4701,4744,123,166,74,526.65,46
,20130820,4701,4744,4772,4772,4584,4638,4672,-106,-72,170,"1,191.53",56
,20130821,4638,4672,4718,4734,4660,4660,4693,-12,21,98,689.93,40
,20130822,4660,4693,4690,4690,4650,4668,4666,-25,-27,12,83.99,42
,20130823,4668,4666,4747,4747,4679,4688,4723,22,57,90,637.69,72
,20130826,4688,4723,4715,4999,4715,4984,4930,261,207,56,414.14,96
,20130827,4984,4930,4990,5043,4925,4957,4983,27,53,44,328.89,98
,20130828,4957,4983,5067,5121,5059,5098,5091,115,108,20,152.75,108
,20130829,5098,5091,5065,5065,4863,4878,4922,-213,-169,550,"4,061.24",110
,20130830,4878,4922,4890,4927,4811,4811,4854,-111,-68,56,407.77,98
,20130902,4811,4854,4744,4980,4744,4960,4869,106,15,22,160.68,102
,20130903,4960,4869,4958,4971,4915,4964,4959,95,90,20,148.79,100
,20130904,4964,4959,5014,5014,4974,4976,4991,17,32,8,59.9,96
,20130905,4976,4991,4818,4837,4748,4775,4782,-216,-209,82,588.23,96
,20130906,4775,4782,4790,4790,4748,4757,4768,-25,-14,32,228.9,100
,20130909,4757,4768,4886,4893,4858,4877,4869,109,101,106,774.32,120
,20130910,4877,4869,4868,4882,4826,4826,4861,-43,-8,10,72.93,118
,20130911,4826,4861,4736,4736,4693,4729,4710,-132,-151,24,169.56,116
,20130912,4729,4710,4741,4741,4695,4695,4717,-15,7,12,84.92,116
,20130913,4695,4717,4525,4525,4480,4499,4500,-218,-217,80,540.01,140
,20130916,4499,4500,4508,4566,4495,4495,4549,-5,49,26,177.44,130
,20130917,4495,4549,4507,4556,4504,4504,4523,-45,-26,24,162.85,128
,20130918,4504,4523,4488,4499,4414,4432,4457,-91,-66,30,200.6,130
,20130923,4432,4457,4433,4482,4407,4482,4438,25,-19,14,93.2,130
,20130924,4482,4438,4480,4538,4479,4479,4499,41,61,10,67.49,132
,20130925,4479,4499,4423,4506,4407,4494,4472,-5,-27,84,563.5,130
,20130926,4494,4472,4495,4513,4491,4503,4504,31,32,26,175.68,130
,20130927,4503,4504,4506,4506,4475,4475,4499,-29,-5,16,108,128
,20130930,4475,4499,4493,4493,4469,4491,4480,-8,-19,48,322.58,124
,20131008,4491,4480,4563,4601,4563,4579,4575,99,95,26,178.43,142
,20131009,4579,4575,4600,4616,4577,4577,4592,2,17,90,619.98,172
,20131010,4577,4592,4494,4520,4494,4510,4507,-82,-85,12,81.14,172
,20131011,4510,4507,4503,4509,4455,4455,4482,-52,-25,10,67.24,170
,20131014,4455,4482,4379,4394,4355,4394,4376,-88,-106,24,157.55,162
,20131015,4394,4376,4368,4368,4350,4350,4359,-26,-17,4,26.15,160
,20131016,4350,4359,4327,4384,4327,4382,4366,23,7,16,104.79,162
,20131017,4382,4366,4363,4434,4363,4393,4394,27,28,20,131.83,176
,20131018,4393,4394,4456,4456,4453,4453,4455,59,61,8,53.46,170
,20131021,4453,4455,4480,4545,4480,4545,4513,90,58,16,108.32,174
,20131022,4545,4513,4521,4533,4521,4533,4525,20,12,6,40.73,180
,20131023,4533,4525,4599,4645,4599,4621,4623,96,98,32,221.9,198
,20131024,4621,4623,4634,4634,4634,4634,4634,11,11,2,13.9,198
,20131025,4634,4634,4627,4634,4571,4571,4602,-63,-32,22,151.89,192
,20131028,4571,4602,4549,4588,4549,4574,4570,-28,-32,24,164.53,178
,20131029,4574,4570,4584,4584,4565,4577,4572,7,2,28,192.04,180
,20131030,4577,4572,4589,4619,4589,4619,4596,47,24,8,55.16,174
,20131031,4619,4596,4674,4674,4517,4520,4555,-76,-41,60,409.96,198
,20131101,4520,4555,4456,4476,4456,4458,4465,-97,-90,22,147.36,198
,20131104,4458,4465,4450,4450,4405,4405,4431,-60,-34,16,106.34,194
,20131105,4405,4431,4409,4437,4409,4437,4426,6,-5,30,199.19,186
,20131106,4437,4426,4420,4427,4420,4427,4425,1,-1,8,53.1,188
,20131107,4427,4425,,,,4425,4425,0,0,0,0,188
,20131108,4425,4425,4392,4435,4392,4435,4414,10,-11,10,66.21,194
,20131111,4435,4414,4382,4389,4380,4389,4383,-25,-31,18,118.36,198
,20131112,4389,4383,4350,4350,4340,4340,4344,-43,-39,6,39.1,198
,20131113,4340,4344,4363,4369,4287,4296,4318,-48,-26,18,116.59,196
,20131114,4296,4318,4294,4332,4287,4323,4303,5,-15,30,193.65,196
,20131115,4323,4303,4316,4316,4291,4291,4305,-12,2,22,142.09,192
,20131118,4291,4305,4289,4289,4274,4274,4285,-31,-20,30,192.86,204
,20131119,4274,4285,4245,4245,4193,4193,4211,-92,-74,80,505.32,266
,20131120,4193,4211,4230,4250,4230,4250,4243,39,32,10,63.65,266
,20131121,4250,4243,4233,4233,4152,4154,4197,-89,-46,34,214.05,266
,20131122,4154,4197,4149,4176,4149,4165,4167,-32,-30,16,100.03,258
,20131125,4165,4167,4146,4146,4106,4112,4123,-55,-44,12,74.22,254
,20131126,4112,4123,4176,4204,4176,4200,4188,77,65,36,226.19,246
,20131127,4200,4188,4175,4184,4171,4171,4175,-17,-13,10,62.63,246
,20131128,4171,4175,4191,4191,4155,4158,4167,-17,-8,14,87.51,250
,20131129,4158,4167,4167,4167,4142,4151,4163,-16,-4,72,449.69,286
,20131202,4151,4163,4203,4210,4176,4181,4192,18,29,32,201.23,266
,20131203,4181,4192,4156,4156,4088,4088,4136,-104,-56,22,136.49,252
,20131204,4088,4136,4084,4084,4062,4071,4072,-65,-64,32,195.49,240
,20131205,4071,4072,4096,4148,4096,4148,4105,76,33,16,98.54,236
,20131206,4148,4105,4104,4137,4099,4136,4112,31,7,30,185.04,234
,20131209,4136,4112,4143,4167,4143,4161,4156,49,44,14,87.28,232
,20131210,4161,4156,,,,4201,4201,45,45,0,0,232
,20131211,4201,4201,4298,4305,4281,4286,4285,85,84,48,308.56,244
,20131212,4286,4285,4296,4316,4286,4300,4299,15,14,20,128.98,244
,20131213,4300,4299,4210,4210,4105,4117,4149,-182,-150,14,87.14,246
,20131216,4117,4149,4139,4139,4131,4131,4134,-18,-15,6,37.21,246
,20131217,4131,4134,4245,4275,4194,4275,4229,141,95,8,50.75,244
,20131218,4275,4229,4192,4233,4187,4217,4205,-12,-24,28,176.61,242
,20131219,4217,4205,4227,4233,4135,4139,4187,-66,-18,24,150.74,240
,20131220,4139,4187,4088,4094,4088,4093,4091,-94,-96,6,36.83,242
,20131223,4093,4091,4117,4117,4105,4105,4111,14,20,4,24.67,242
,20131224,4105,4111,4108,4125,4085,4089,4101,-22,-10,20,123.05,242
,20131225,4089,4101,,,,4101,4101,0,0,0,0,242
,20131226,4101,4101,4115,4115,4102,4102,4104,1,3,88,541.83,314
,20131227,4102,4104,4160,4205,4142,4205,4172,101,68,58,362.96,314
,20131230,4205,4172,4230,4230,4166,4166,4189,-6,17,14,87.99,310
,20131231,4166,4189,4157,4168,4098,4119,4138,-70,-51,20,124.16,312
ag1409,20130917,4549,4549,,,,4546,4546,-3,-3,0,0,0
,20130918,4546,4546,,,,4480,4480,-66,-66,0,0,0
,20130923,4480,4480,,,,4461,4461,-19,-19,0,0,0
,20130924,4461,4461,4471,4540,4471,4508,4510,47,49,20,135.31,4
,20130925,4508,4510,4420,4510,4420,4500,4459,-10,-51,138,923.04,8
,20130926,4500,4459,4480,4523,4467,4496,4495,37,36,104,701.29,8
,20130927,4496,4495,4529,4529,4399,4471,4476,-24,-19,118,792.27,18
,20130930,4471,4476,4488,4513,4473,4488,4492,12,16,50,336.93,18
,20131008,4488,4492,4566,4621,4566,4607,4593,115,101,24,165.37,20
,20131009,4607,4593,4605,4620,4586,4587,4604,-6,11,80,552.57,40
,20131010,4587,4604,4500,4516,4486,4515,4505,-89,-99,10,67.58,40
,20131011,4515,4505,4492,4518,4438,4438,4473,-67,-32,44,295.26,50
,20131014,4438,4473,4352,4410,4352,4410,4367,-63,-106,20,131.03,52
,20131015,4410,4367,4370,4379,4340,4348,4359,-19,-8,48,313.88,58
,20131016,4348,4359,4370,4400,4362,4400,4379,41,20,22,144.53,56
,20131017,4400,4379,4375,4442,4334,4347,4376,-32,-3,74,485.81,72
,20131018,4347,4376,4466,4476,4444,4476,4464,100,88,52,348.24,86
,20131021,4476,4464,4496,4550,4473,4550,4507,86,43,72,486.76,96
,20131022,4550,4507,4560,4562,4511,4523,4534,16,27,26,176.86,104
,20131023,4523,4534,4583,4643,4583,4613,4626,79,92,56,388.65,124
,20131024,4613,4626,4613,4620,4603,4615,4613,-11,-13,28,193.79,108
,20131025,4615,4613,4620,4629,4552,4567,4592,-46,-21,56,385.8,102
,20131028,4567,4592,4540,4600,4540,4595,4577,3,-15,34,233.47,108
,20131029,4595,4577,4591,4600,4586,4600,4595,23,18,16,110.28,104
,20131030,4600,4595,4602,4621,4575,4621,4596,26,1,16,110.33,106
,20131031,4621,4596,4668,4679,4518,4518,4550,-78,-46,112,764.54,140
,20131101,4518,4550,4468,4468,4445,4455,4457,-95,-93,18,120.36,136
,20131104,4455,4457,4463,4463,4420,4420,4446,-37,-11,74,493.55,150
,20131105,4420,4446,4440,4450,4410,4450,4441,4,-5,40,266.47,162
,20131106,4450,4441,4426,4450,4426,4450,4440,9,-1,28,186.52,176
,20131107,4450,4440,4483,4483,4473,4477,4477,37,37,8,53.72,176
,20131108,4477,4477,4470,4470,4421,4455,4436,-22,-41,36,239.59,182
,20131111,4455,4436,4430,4455,4386,4403,4406,-33,-30,46,304.06,188
,20131112,4403,4406,4375,4380,4342,4380,4357,-26,-49,30,196.09,202
,20131113,4380,4357,4380,4380,4277,4309,4307,-48,-50,54,348.87,220
,20131114,4309,4307,4312,4330,4281,4330,4302,23,-5,42,271.04,220
,20131115,4330,4302,4318,4329,4300,4302,4312,0,10,14,90.57,224
,20131118,4302,4312,4291,4305,4274,4290,4288,-22,-24,26,167.26,238
,20131119,4290,4288,4303,4303,4200,4200,4228,-88,-60,50,317.13,260
,20131120,4200,4228,4195,4260,4195,4260,4218,32,-10,66,417.64,258
,20131121,4260,4218,4228,4236,4152,4169,4189,-49,-29,74,465,278
,20131122,4169,4189,4160,4190,4160,4168,4176,-21,-13,22,137.83,286
,20131125,4168,4176,4166,4174,4120,4120,4141,-56,-35,18,111.82,292
,20131126,4120,4141,4115,4220,4115,4202,4191,61,50,44,276.65,284
,20131127,4202,4191,4191,4192,4163,4189,4180,-2,-11,20,125.42,280
,20131128,4189,4180,4200,4200,4154,4172,4173,-8,-7,42,262.91,300
,20131129,4172,4173,4171,4181,4161,4166,4172,-7,-1,28,175.26,308
,20131202,4166,4172,4214,4218,4184,4199,4197,27,25,60,377.76,308
,20131203,4199,4197,4154,4181,4089,4106,4127,-91,-70,178,"1,102.04",338
,20131204,4106,4127,4103,4105,4081,4093,4091,-34,-36,26,159.57,334
,20131205,4093,4091,4100,4168,4100,4142,4138,51,47,30,186.24,322
,20131206,4142,4138,4142,4160,4109,4144,4122,6,-16,34,210.26,326
,20131209,4144,4122,4160,4175,4155,4171,4159,49,37,60,374.39,312
,20131210,4171,4159,4181,4244,4181,4233,4206,74,47,126,794.94,280
,20131211,4233,4206,4271,4312,4271,4285,4295,79,89,90,579.96,266
,20131212,4285,4295,4283,4316,4283,4293,4295,-2,0,28,180.42,264
,20131213,4293,4295,4207,4222,4122,4149,4171,-146,-124,100,625.76,282
,20131216,4149,4171,4100,4173,4100,4146,4148,-25,-23,110,684.44,290
,20131217,4146,4148,4146,4282,4146,4268,4219,120,71,80,506.29,290
,20131218,4268,4219,4200,4257,4198,4233,4229,14,10,48,304.49,286
,20131219,4233,4229,4250,4265,4123,4155,4201,-74,-28,64,403.35,296
,20131220,4155,4201,4105,4109,4082,4082,4096,-119,-105,422,"2,592.97",654
,20131223,4082,4096,4092,4138,4091,4130,4113,34,17,54,333.2,646
,20131224,4130,4113,4136,4144,4091,4093,4122,-20,9,62,383.39,638
,20131225,4093,4122,4110,4114,4094,4113,4110,-9,-12,24,147.98,638
,20131226,4113,4110,4111,4118,4111,4114,4114,4,4,10,61.72,638
,20131227,4114,4114,4114,4210,4114,4210,4170,96,56,92,575.56,622
,20131230,4210,4170,4202,4240,4186,4186,4209,16,39,70,442.02,616
,20131231,4186,4209,4159,4174,4102,4121,4129,-88,-80,132,817.62,608
ag1410,20131016,4359,4359,,,,4359,4359,0,0,0,0,0
,20131017,4359,4359,4390,4435,4360,4400,4392,41,33,30,197.65,0
,20131018,4400,4392,4485,4500,4485,4500,4492,108,100,8,53.9,8
,20131021,4500,4492,4499,4575,4495,4550,4530,58,38,50,339.77,14
,20131022,4550,4530,4544,4544,4525,4525,4534,-5,4,4,27.21,12
,20131023,4525,4534,4650,4651,4644,4644,4648,110,114,6,41.84,16
,20131024,4644,4648,,,,4635,4635,-13,-13,0,0,16
,20131025,4635,4635,4601,4601,4594,4594,4597,-41,-38,4,27.59,14
,20131028,4594,4597,4570,4641,4570,4641,4604,44,7,20,138.13,20
,20131029,4641,4604,4577,4577,4577,4577,4577,-27,-27,2,13.73,20
,20131030,4577,4577,4578,4644,4578,4644,4596,67,19,8,55.16,16
,20131031,4644,4596,4644,4708,4539,4549,4587,-47,-9,22,151.4,18
,20131101,4549,4587,4477,4477,4425,4476,4463,-111,-124,8,53.57,20
,20131104,4476,4463,4418,4453,4418,4453,4433,-10,-30,6,39.9,24
,20131105,4453,4433,4441,4453,4391,4442,4435,9,2,28,186.29,14
,20131106,4442,4435,4449,4449,4447,4447,4448,12,13,6,40.04,18
,20131107,4447,4448,4468,4470,4468,4470,4469,22,21,4,26.81,18
,20131108,4470,4469,4440,4460,4440,4460,4450,-9,-19,4,26.7,16
,20131111,4460,4450,4405,4405,4400,4400,4402,-50,-48,4,26.42,18
,20131112,4400,4402,4412,4412,4412,4412,4412,10,10,2,13.24,18
,20131113,4412,4412,4385,4385,4287,4288,4332,-124,-80,8,51.99,16
,20131114,4288,4332,4313,4323,4300,4309,4308,-23,-24,80,516.96,24
,20131115,4309,4308,4347,4347,4250,4290,4303,-18,-5,88,568.02,34
,20131118,4290,4303,4288,4317,4272,4275,4286,-28,-17,42,270.05,34
,20131119,4275,4286,4261,4270,4197,4199,4220,-87,-66,36,227.89,50
,20131120,4199,4220,4199,4267,4199,4200,4250,-20,30,162,"1,032.77",166
,20131121,4200,4250,4225,4238,4152,4152,4198,-98,-52,42,264.49,170
,20131122,4152,4198,4173,4192,4159,4173,4176,-25,-22,16,100.24,168
,20131125,4173,4176,4190,4190,4138,4139,4161,-37,-15,38,237.21,194
,20131126,4139,4161,4130,4228,4130,4224,4171,63,10,38,237.79,200
,20131127,4224,4171,4194,4202,4175,4194,4190,23,19,16,100.57,202
,20131128,4194,4190,4190,4190,4154,4168,4171,-22,-19,22,137.66,206
,20131129,4168,4171,4179,4179,4164,4168,4168,-3,-3,10,62.52,200
,20131202,4168,4168,4209,4247,4186,4197,4209,29,41,26,164.15,198
,20131203,4197,4209,4187,4188,4140,4140,4164,-69,-45,18,112.45,210
,20131204,4140,4164,4120,4120,4094,4107,4104,-57,-60,38,233.95,216
,20131205,4107,4104,4121,4176,4121,4166,4155,62,51,32,199.44,214
,20131206,4166,4155,4125,4166,4121,4152,4143,-3,-12,12,74.58,216
,20131209,4152,4143,4180,4198,4177,4186,4186,43,43,48,301.41,218
,20131210,4186,4186,4205,4230,4199,4230,4211,44,25,14,88.43,222
,20131211,4230,4211,4323,4323,4295,4295,4308,84,97,16,103.4,224
,20131212,4295,4308,4312,4312,4312,4312,4312,4,4,2,12.94,222
,20131213,4312,4312,4225,4225,4134,4138,4178,-174,-134,22,137.89,218
,20131216,4138,4178,4180,4180,4155,4155,4164,-23,-14,6,37.48,220
,20131217,4155,4164,4236,4288,4208,4288,4236,124,72,10,63.55,218
,20131218,4288,4236,4235,4247,4220,4234,4235,-2,-1,68,432.02,232
,20131219,4234,4235,4257,4257,4150,4150,4204,-85,-31,12,75.69,232
,20131220,4150,4204,4113,4113,4099,4099,4108,-105,-96,6,36.98,230
,20131223,4099,4108,4107,4143,4101,4129,4128,21,20,40,247.72,244
,20131224,4129,4128,4100,4100,4100,4100,4100,-28,-28,6,36.9,250
,20131225,4100,4100,4123,4123,4117,4117,4120,17,20,8,49.44,250
,20131226,4117,4120,4117,4117,4117,4117,4117,-3,-3,98,605.2,346
,20131227,4117,4117,4175,4190,4166,4190,4176,73,59,42,263.14,316
,20131230,4190,4176,4201,4250,4180,4180,4216,4,40,34,215.06,308
,20131231,4180,4216,4166,4182,4135,4135,4146,-81,-70,74,460.28,250
ag1411,20131118,4303,4303,,,,4303,4303,0,0,0,0,0
,20131119,4303,4303,,,,4303,4303,0,0,0,0,0
,20131120,4303,4303,4259,4259,4259,4259,4259,-44,-44,2,12.78,2
,20131121,4259,4259,4259,4301,4171,4175,4221,-84,-38,54,341.91,14
,20131122,4175,4221,4180,4180,4174,4174,4176,-47,-45,6,37.58,12
,20131125,4174,4176,,,,4161,4161,-15,-15,0,0,12
,20131126,4161,4161,4145,4210,4103,4210,4155,49,-6,8,49.86,18
,20131127,4210,4155,4202,4208,4182,4200,4195,45,40,20,125.85,18
,20131128,4200,4195,4187,4212,4178,4210,4188,15,-7,18,113.1,26
,20131129,4210,4188,4194,4197,4174,4174,4184,-14,-4,24,150.63,36
,20131202,4174,4184,4233,4235,4194,4194,4213,10,29,74,467.67,46
,20131203,4194,4213,4191,4191,4111,4121,4147,-92,-66,22,136.85,54
,20131204,4121,4147,4121,4121,4099,4100,4105,-47,-42,28,172.43,62
,20131205,4100,4105,4123,4196,4123,4159,4164,54,59,36,224.9,54
,20131206,4159,4164,4141,4162,4133,4159,4145,-5,-19,18,111.94,54
,20131209,4159,4145,4200,4206,4190,4191,4195,46,50,22,138.47,60
,20131210,4191,4195,4207,4259,4207,4259,4227,64,32,20,126.83,64
,20131211,4259,4227,4330,4332,4305,4323,4322,96,95,8,51.87,66
,20131212,4323,4322,4312,4328,4312,4316,4324,-6,2,16,103.78,64
,20131213,4316,4324,4202,4202,4130,4160,4158,-164,-166,40,249.52,82
,20131216,4160,4158,4148,4179,4148,4168,4162,10,4,22,137.35,82
,20131217,4168,4162,4205,4287,4177,4269,4217,107,55,70,442.79,88
,20131218,4269,4217,4222,4252,4210,4252,4220,35,3,22,139.28,86
,20131219,4252,4220,4255,4255,4141,4141,4188,-79,-32,22,138.23,94
,20131220,4141,4188,4131,4131,4100,4100,4112,-88,-76,38,234.43,80
,20131223,4100,4112,4101,4148,4101,4138,4116,26,4,38,234.66,92
,20131224,4138,4116,4106,4112,4105,4105,4105,-11,-11,234,"1,440.97",316
,20131225,4105,4105,,,,4105,4105,0,0,0,0,316
,20131226,4105,4105,4122,4122,4122,4122,4122,17,17,2,12.37,316
,20131227,4122,4122,,,,4205,4205,83,83,0,0,316
,20131230,4205,4205,4209,4209,4193,4193,4201,-12,-4,4,25.21,314
,20131231,4193,4201,4175,4175,4138,4138,4151,-63,-50,12,74.73,306
ag1412,20131217,4162,4162,4200,4416,4180,4275,4269,113,107,620,"3,970.56",454
,20131218,4275,4269,4224,4282,4202,4259,4251,-10,-18,426,"2,716.48",642
,20131219,4259,4251,4262,4278,4148,4188,4230,-63,-21,816,"5,177.93",1078
,20131220,4188,4230,4120,4137,4094,4104,4116,-126,-114,1082,"6,681.81",1732
,20131223,4104,4116,4111,4162,4101,4140,4131,24,15,1972,"12,221.32",2926
,20131224,4140,4131,4130,4166,4106,4113,4122,-18,-9,1318,"8,150.50",3654
,20131225,4113,4122,4121,4149,4111,4133,4132,11,10,286,"1,772.80",3682
,20131226,4133,4132,4141,4151,4125,4139,4132,7,0,1266,"7,847.04",4380
,20131227,4139,4132,4129,4245,4129,4244,4189,112,57,1446,"9,087.24",4418
,20131230,4244,4189,4241,4273,4195,4203,4231,14,42,1318,"8,366.37",4466
,20131231,4203,4231,4197,4212,4128,4142,4168,-89,-63,1472,"9,204.36",4658
al1301,20130104,15130,15120,15210,15210,15120,15120,15125,0,5,2830,"21,407.08",36380
,20130107,15120,15125,15120,15120,15075,15075,15095,-50,-30,2320,"17,510.98",35390
,20130108,15075,15095,15090,15090,15050,15050,15065,-45,-30,4300,"32,400.48",34000
,20130109,15050,15065,15090,15090,15040,15040,15060,-25,-5,4040,"30,427.35",32040
,20130110,15040,15060,15060,15060,15035,15050,15050,-10,-10,5410,"40,712.15",28830
,20130111,15050,15050,15095,15095,15045,15060,15060,10,10,4830,"36,373.35",27420
,20130114,15060,15060,15040,15050,15010,15010,15025,-50,-35,6080,"45,689.30",24200
,20130115,15010,15025,14990,15000,14915,14915,14945,-110,-80,7560,"56,496.43",20930
al1302,20130104,15255,15240,15295,15310,15170,15240,15240,0,0,4890,"37,270.71",38112
,20130107,15240,15240,15210,15225,15170,15170,15195,-70,-45,3212,"24,410.24",37472
,20130108,15170,15195,15180,15180,15145,15155,15160,-40,-35,2714,"20,574.44",37890
,20130109,15155,15160,15155,15165,15155,15160,15155,0,-5,3168,"24,012.43",38496
,20130110,15160,15155,15160,15170,15150,15150,15160,-5,5,5384,"40,812.24",40284
,20130111,15150,15160,15190,15195,15155,15155,15170,-5,10,3038,"23,045.10",40170
,20130114,15155,15170,15150,15150,15115,15125,15135,-45,-35,2830,"21,416.53",40370
,20130115,15125,15135,15110,15115,15025,15045,15055,-90,-80,5802,"43,679.98",39890
,20130116,15045,15055,15065,15085,15035,15045,15055,-10,0,2732,"20,571.20",38788
,20130117,15045,15055,14980,15050,14945,15045,15035,-10,-20,3764,"28,299.16",37558
,20130118,15045,15035,15065,15085,15065,15085,15070,50,35,3406,"25,671.93",36958
,20130121,15085,15070,15085,15110,15060,15060,15075,-10,5,2212,"16,674.79",36776
,20130122,15060,15075,15080,15080,15050,15065,15060,-10,-15,3216,"24,220.88",36236
,20130123,15065,15060,15080,15080,15055,15060,15060,0,0,2120,"15,965.37",35936
,20130124,15060,15060,15040,15045,15015,15025,15020,-35,-40,2362,"17,740.30",34840
,20130125,15025,15020,15020,15030,15015,15020,15020,0,0,2352,"17,668.74",33094
,20130128,15020,15020,15000,15000,14970,14975,14980,-45,-40,1910,"14,310.30",32066
,20130129,14975,14980,14980,14980,14955,14980,14965,0,-15,4676,"34,989.68",30624
,20130130,14980,14965,14970,15010,14970,14990,14990,25,25,4144,"31,068.07",28878
,20130131,14990,14990,15025,15030,15015,15030,15020,40,30,4844,"36,380.72",26630
,20130201,15030,15020,15005,15005,14980,14995,14985,-25,-35,1570,"11,765.48",25820
,20130204,14995,14985,15000,15035,14980,14990,14995,5,10,6300,"47,246.90",22050
,20130205,14990,14995,14855,14960,14855,14945,14930,-50,-65,2460,"18,365.58",20290
,20130206,14945,14930,14945,14945,14905,14910,14930,-20,0,1460,"10,899.05",19920
,20130207,14910,14930,14890,14890,14845,14870,14860,-60,-70,1730,"12,857.40",19000
,20130208,14870,14860,14860,14915,14850,14860,14860,0,0,760,"5,647.70",18850
,20130218,14860,14860,14900,14910,14770,14775,14815,-85,-45,5730,"42,451.65",17430
al1303,20130104,15365,15335,15395,15420,15270,15315,15350,-20,15,6806,"52,236.38",65588
,20130107,15315,15350,15310,15320,15265,15265,15295,-85,-55,5556,"42,490.89",65636
,20130108,15265,15295,15290,15295,15240,15240,15260,-55,-35,5922,"45,188.70",64618
,20130109,15240,15260,15255,15265,15240,15245,15255,-15,-5,3710,"28,298.29",62778
,20130110,15245,15255,15255,15275,15245,15270,15255,15,0,6538,"49,874.41",62494
,20130111,15270,15255,15295,15305,15250,15250,15275,-5,20,8978,"68,580.48",62258
,20130114,15250,15275,15270,15270,15230,15235,15240,-40,-35,7604,"57,946.99",62370
,20130115,15235,15240,15190,15235,15130,15130,15160,-110,-80,20090,"152,322.45",64054
,20130116,15130,15160,15150,15205,15130,15155,15155,-5,-5,9182,"69,595.20",61522
,20130117,15155,15155,15140,15155,15120,15155,15135,0,-20,8508,"64,393.40",60660
,20130118,15155,15135,15190,15195,15155,15190,15175,55,40,5478,"41,575.59",59004
,20130121,15190,15175,15245,15245,15150,15160,15180,-15,5,4678,"35,510.69",58140
,20130122,15160,15180,15170,15185,15150,15175,15165,-5,-15,5398,"40,939.89",56670
,20130123,15175,15165,15180,15190,15150,15155,15160,-10,-5,3120,"23,656.46",55992
,20130124,15155,15160,15150,15150,15115,15125,15125,-35,-35,5042,"38,132.64",55710
,20130125,15125,15125,15130,15140,15120,15125,15130,0,5,4342,"32,852.37",54376
,20130128,15125,15130,15115,15115,15060,15075,15085,-55,-45,3046,"22,979.24",54122
,20130129,15075,15085,15055,15080,15050,15080,15065,-5,-20,3980,"29,979.95",53390
,20130130,15080,15065,15080,15125,15075,15110,15100,45,35,8312,"62,771.02",51424
,20130131,15110,15100,15140,15155,15130,15155,15135,55,35,6710,"50,793.49",50418
,20130201,15155,15135,15100,15120,15075,15095,15090,-40,-45,4408,"33,262.14",49070
,20130204,15095,15090,15120,15145,15100,15110,15120,20,30,8194,"61,952.20",48180
,20130205,15110,15120,15115,15115,14980,15050,15050,-70,-70,4158,"31,291.10",47180
,20130206,15050,15050,15040,15050,15005,15010,15025,-40,-25,4374,"32,867.06",45060
,20130207,15010,15025,14980,14995,14955,14970,14975,-55,-50,3900,"29,202.00",45122
,20130208,14970,14975,14940,15010,14940,15010,14980,35,5,3280,"24,570.57",44286
,20130218,15010,14980,15010,15025,14890,14890,14960,-90,-20,6854,"51,272.65",43770
,20130219,14890,14960,14900,14915,14845,14855,14890,-105,-70,4764,"35,468.50",42588
,20130220,14855,14890,14880,14900,14840,14860,14860,-30,-30,4162,"30,933.40",41664
,20130221,14860,14860,14755,14780,14670,14725,14700,-135,-160,5262,"38,684.32",39474
,20130222,14725,14700,14720,14750,14710,14750,14735,50,35,6914,"50,947.83",40228
,20130225,14750,14735,14700,14700,14630,14630,14650,-105,-85,4558,"33,397.96",39046
,20130226,14630,14650,14620,14640,14590,14625,14620,-25,-30,2506,"18,320.88",37356
,20130227,14625,14620,14650,14660,14630,14640,14640,20,20,4272,"31,276.42",34396
,20130228,14640,14640,14640,14640,14575,14620,14600,-20,-40,5020,"36,654.90",31030
,20130301,14620,14600,14590,14590,14450,14495,14470,-105,-130,3820,"27,645.80",30660
,20130304,14495,14470,14470,14470,14355,14415,14410,-55,-60,4140,"29,834.55",30300
,20130305,14415,14410,14440,14555,14415,14500,14435,90,25,3850,"27,792.95",31090
,20130306,14500,14435,14550,14600,14530,14600,14550,165,115,6800,"49,476.05",33620
,20130307,14600,14550,14510,14690,14510,14690,14625,140,75,7180,"52,507.93",33100
,20130308,14690,14625,14730,14730,14655,14720,14690,95,65,4110,"30,194.68",32970
,20130311,14720,14690,14700,14700,14620,14665,14650,-25,-40,2940,"21,539.28",32940
,20130312,14665,14650,14605,14615,14585,14600,14600,-50,-50,4450,"32,489.33",33030
,20130313,14600,14600,14600,14670,14590,14670,14620,70,20,2790,"20,397.23",32440
,20130314,14670,14620,14625,14635,14565,14635,14595,15,-25,3190,"23,284.05",31590
,20130315,14635,14595,14610,14625,14570,14600,14595,5,0,3460,"25,252.75",30810
al1304,20130104,15465,15435,15535,15535,15380,15425,15440,-10,5,6856,"52,941.06",23276
,20130107,15425,15440,15360,15420,15360,15375,15395,-65,-45,5074,"39,062.44",25980
,20130108,15375,15395,15395,15400,15330,15340,15355,-55,-40,5734,"44,026.43",27910
,20130109,15340,15355,15345,15355,15330,15330,15340,-25,-15,3832,"29,395.20",28638
,20130110,15330,15340,15340,15365,15320,15360,15340,20,0,8210,"62,973.89",31534
,20130111,15360,15340,15390,15400,15325,15325,15355,-15,15,7702,"59,149.13",33528
,20130114,15325,15355,15325,15350,15295,15325,15320,-30,-35,5702,"43,679.42",35164
,20130115,15325,15320,15270,15325,15200,15205,15240,-115,-80,14710,"112,118.82",38414
,20130116,15205,15240,15225,15300,15210,15255,15240,15,0,6372,"48,569.72",38294
,20130117,15255,15240,15235,15255,15205,15240,15225,0,-15,7018,"53,438.86",39720
,20130118,15240,15225,15250,15295,15250,15285,15270,60,45,5940,"45,364.72",39356
,20130121,15285,15270,15300,15335,15255,15255,15280,-15,10,5526,"42,224.36",39626
,20130122,15255,15280,15270,15290,15245,15265,15265,-15,-15,8324,"63,542.34",42230
,20130123,15265,15265,15285,15285,15245,15255,15260,-10,-5,7728,"58,970.45",44338
,20130124,15255,15260,15240,15250,15205,15230,15220,-30,-40,6976,"53,089.45",46520
,20130125,15230,15220,15235,15240,15215,15225,15225,5,5,6334,"48,219.38",49498
,20130128,15225,15225,15200,15200,15155,15165,15170,-60,-55,6862,"52,064.94",52878
,20130129,15165,15170,15160,15185,15135,15170,15155,0,-15,5426,"41,122.27",54102
,20130130,15170,15155,15180,15240,15170,15215,15200,60,45,8414,"63,951.92",53666
,20130131,15215,15200,15260,15265,15225,15250,15245,50,45,7550,"57,553.11",52066
,20130201,15250,15245,15235,15240,15175,15205,15190,-40,-55,4180,"31,756.98",51558
,20130204,15205,15190,15210,15260,15210,15220,15230,30,40,7792,"59,340.60",52346
,20130205,15220,15230,15200,15200,15090,15150,15155,-80,-75,5378,"40,763.94",52562
,20130206,15150,15155,15160,15170,15115,15130,15145,-25,-10,4134,"31,309.44",51984
,20130207,15130,15145,15110,15115,15070,15090,15090,-55,-55,6848,"51,680.82",50614
,20130208,15090,15090,15085,15145,15065,15140,15100,50,10,4980,"37,605.18",50556
,20130218,15140,15100,15130,15155,15010,15020,15075,-80,-25,8540,"64,386.76",50352
,20130219,15020,15075,15025,15035,14965,14965,15005,-110,-70,5778,"43,358.54",49870
,20130220,14965,15005,14965,15030,14950,14970,14975,-35,-30,3880,"29,057.65",50146
,20130221,14970,14975,14930,14930,14775,14845,14810,-130,-165,8046,"59,597.16",48066
,20130222,14845,14810,14820,14860,14820,14850,14840,40,30,4536,"33,660.22",47234
,20130225,14850,14840,14800,14800,14735,14740,14755,-100,-85,4138,"30,531.35",46268
,20130226,14740,14755,14700,14745,14700,14710,14720,-45,-35,5706,"42,004.49",45586
,20130227,14710,14720,14735,14770,14730,14750,14750,30,30,6166,"45,482.59",45018
,20130228,14750,14750,14750,14750,14690,14705,14705,-45,-45,5392,"39,650.72",43314
,20130301,14705,14705,14705,14705,14540,14595,14575,-110,-130,5842,"42,573.72",42452
,20130304,14595,14575,14560,14575,14435,14495,14510,-80,-65,3914,"28,398.35",41864
,20130305,14495,14510,14530,14570,14515,14570,14535,60,25,6830,"49,637.55",39994
,20130306,14570,14535,14580,14795,14560,14775,14640,240,105,8302,"60,781.93",41558
,20130307,14775,14640,14775,14790,14625,14765,14725,125,85,6980,"51,401.19",39650
,20130308,14765,14725,14810,14820,14735,14800,14770,75,45,4944,"36,523.16",39872
,20130311,14800,14770,14780,14785,14700,14710,14740,-60,-30,2698,"19,887.07",40218
,20130312,14710,14740,14700,14700,14640,14640,14680,-100,-60,5244,"38,503.80",39924
,20130313,14640,14680,14700,14745,14670,14740,14700,60,20,5248,"38,582.20",38590
,20130314,14740,14700,14710,14720,14625,14680,14665,-20,-35,5100,"37,397.41",37436
,20130315,14680,14665,14685,14685,14625,14665,14655,0,-10,4962,"36,361.25",38196
,20130318,14665,14655,14580,14590,14460,14535,14535,-120,-120,4724,"34,339.40",37136
,20130319,14535,14535,14535,14565,14530,14540,14545,5,10,2522,"18,341.69",37340
,20130320,14540,14545,14545,14610,14535,14580,14575,35,30,3430,"25,004.46",35746
,20130321,14580,14575,14630,14650,14625,14650,14635,75,60,3074,"22,494.25",34802
,20130322,14650,14635,14550,14650,14550,14630,14605,-5,-30,2158,"15,763.43",34216
,20130325,14630,14605,14660,14660,14610,14610,14625,5,20,4160,"30,423.21",32836
,20130326,14610,14625,14620,14620,14595,14615,14610,-10,-15,2478,"18,102.20",32510
,20130327,14615,14610,14575,14590,14560,14565,14570,-45,-40,3120,"22,730.18",31366
,20130328,14565,14570,14595,14600,14515,14570,14545,0,-25,4136,"30,088.58",29348
,20130329,14570,14545,14500,14550,14495,14530,14520,-15,-25,2988,"21,695.14",27900
,20130401,14530,14520,14450,14480,14450,14480,14460,-40,-60,3050,"22,054.65",27410
,20130402,14480,14460,14500,14550,14465,14550,14480,90,20,1810,"13,108.53",27330
,20130403,14550,14480,14470,14530,14455,14530,14485,50,5,3170,"22,960.95",27810
,20130408,14530,14485,14490,14540,14485,14540,14500,55,15,2720,"19,721.03",28120
,20130409,14540,14500,14550,14585,14550,14585,14560,85,60,2010,"14,633.95",27820
,20130410,14585,14560,14585,14600,14575,14585,14590,25,30,2190,"15,977.60",27200
,20130411,14585,14590,14600,14680,14600,14630,14640,40,50,2780,"20,351.33",25790
,20130412,14630,14640,14625,14660,14620,14650,14635,10,-5,2030,"14,855.93",26330
,20130415,14650,14635,14635,14635,14430,14430,14505,-205,-130,2800,"20,309.73",26050
al1305,20130104,15565,15530,15610,15610,15510,15510,15540,-20,10,1128,"8,766.84",6608
,20130107,15510,15540,15500,15510,15460,15480,15490,-60,-50,1408,"10,908.22",7004
,20130108,15480,15490,15480,15480,15405,15420,15445,-70,-45,1298,"10,026.63",7584
,20130109,15420,15445,15435,15440,15400,15400,15420,-45,-25,1644,"12,676.24",8394
,20130110,15400,15420,15420,15435,15385,15435,15400,15,-20,3266,"25,154.74",10484
,20130111,15435,15400,15485,15485,15400,15400,15430,0,30,2620,"20,219.62",11838
,20130114,15400,15430,15380,15405,15360,15385,15380,-45,-50,3010,"23,152.88",13392
,20130115,15385,15380,15380,15380,15270,15270,15305,-110,-75,5530,"42,330.83",15188
,20130116,15270,15305,15305,15350,15280,15330,15310,25,5,6060,"46,397.72",17688
,20130117,15330,15310,15320,15340,15280,15325,15305,15,-5,4356,"33,337.68",19218
,20130118,15325,15305,15360,15385,15330,15365,15355,60,50,2808,"21,561.15",19806
,20130121,15365,15355,15325,15405,15325,15335,15355,-20,0,2522,"19,363.57",20604
,20130122,15335,15355,15345,15360,15320,15350,15335,-5,-20,3794,"29,096.94",22306
,20130123,15350,15335,15380,15380,15325,15330,15335,-5,0,1978,"15,171.00",23138
,20130124,15330,15335,15325,15330,15285,15295,15300,-40,-35,2772,"21,207.69",24316
,20130125,15295,15300,15305,15320,15295,15305,15310,5,10,3674,"28,125.20",26204
,20130128,15305,15310,15290,15290,15240,15255,15255,-55,-55,3502,"26,716.77",27786
,20130129,15255,15255,15245,15260,15225,15255,15240,0,-15,5078,"38,704.35",29958
,20130130,15255,15240,15265,15360,15255,15305,15290,65,50,11514,"88,053.24",35530
,20130131,15305,15290,15360,15375,15330,15365,15345,75,55,12426,"95,366.26",42720
,20130201,15365,15345,15345,15350,15260,15315,15290,-30,-55,12186,"93,182.90",44688
,20130204,15315,15290,15335,15375,15320,15330,15340,40,50,19444,"149,165.85",55112
,20130205,15330,15340,15300,15320,15190,15275,15265,-65,-75,14788,"112,890.72",58776
,20130206,15275,15265,15285,15285,15220,15230,15255,-35,-10,10622,"81,027.41",61950
,20130207,15230,15255,15210,15245,15175,15205,15205,-50,-50,11790,"89,642.68",64668
,20130208,15205,15205,15210,15240,15180,15240,15210,35,5,7838,"59,620.63",67826
,20130218,15240,15210,15260,15290,15125,15140,15205,-70,-5,18316,"139,256.23",74930
,20130219,15140,15205,15120,15155,15075,15090,15115,-115,-90,21604,"163,297.27",82244
,20130220,15090,15115,15130,15150,15060,15080,15090,-35,-25,16908,"127,607.50",83256
,20130221,15080,15090,15010,15040,14890,14965,14935,-125,-155,27944,"208,708.86",88532
,20130222,14965,14935,14920,14975,14920,14960,14950,25,15,16858,"126,037.45",91134
,20130225,14960,14950,14910,14910,14825,14840,14855,-110,-95,17806,"132,262.44",89060
,20130226,14840,14855,14760,14855,14760,14810,14825,-45,-30,10784,"79,950.44",89612
,20130227,14810,14825,14850,14880,14830,14855,14850,30,25,7894,"58,622.80",88734
,20130228,14855,14850,14850,14860,14780,14795,14815,-55,-35,10858,"80,435.54",89858
,20130301,14795,14815,14775,14775,14625,14675,14670,-140,-145,13826,"101,447.33",88812
,20130304,14675,14670,14615,14665,14520,14575,14595,-95,-75,10154,"74,099.47",88068
,20130305,14575,14595,14630,14665,14600,14665,14635,70,40,10666,"78,065.34",86378
,20130306,14665,14635,14680,14775,14680,14770,14740,135,105,17936,"132,225.70",84790
,20130307,14770,14740,14735,14900,14720,14885,14815,145,75,17382,"128,793.72",78730
,20130308,14885,14815,14900,14950,14820,14900,14875,85,60,9574,"71,207.09",76938
,20130311,14900,14875,14900,14900,14800,14800,14830,-75,-45,6908,"51,237.52",77550
,20130312,14800,14830,14805,14805,14745,14750,14775,-80,-55,10176,"75,192.42",76722
,20130313,14750,14775,14800,14845,14760,14835,14805,60,30,10490,"77,669.14",72938
,20130314,14835,14805,14825,14825,14710,14780,14755,-25,-50,9058,"66,826.16",69714
,20130315,14780,14755,14775,14800,14720,14750,14745,-5,-10,7104,"52,385.84",69000
,20130318,14750,14745,14730,14735,14550,14610,14615,-135,-130,10204,"74,579.76",65908
,20130319,14610,14615,14615,14635,14590,14595,14605,-20,-10,4404,"32,168.96",65580
,20130320,14595,14605,14590,14680,14580,14660,14635,55,30,5504,"40,277.78",64740
,20130321,14660,14635,14700,14710,14680,14685,14685,50,50,3514,"25,809.00",63962
,20130322,14685,14685,14685,14700,14635,14660,14655,-25,-30,4928,"36,112.44",62406
,20130325,14660,14655,14730,14735,14675,14680,14685,25,30,3514,"25,809.52",61768
,20130326,14680,14685,14665,14680,14650,14670,14665,-15,-20,2342,"17,175.14",61284
,20130327,14670,14665,14650,14660,14615,14615,14625,-50,-40,2870,"20,988.64",61382
,20130328,14615,14625,14670,14675,14580,14585,14615,-40,-10,8232,"60,168.31",60238
,20130329,14585,14615,14550,14590,14530,14570,14560,-45,-55,4210,"30,656.78",58608
,20130401,14570,14560,14530,14530,14480,14495,14505,-65,-55,4138,"30,013.56",56492
,20130402,14495,14505,14505,14580,14500,14580,14520,75,15,2256,"16,381.99",55476
,20130403,14580,14520,14545,14545,14500,14530,14525,10,5,2886,"20,965.08",54508
,20130408,14530,14525,14510,14615,14510,14615,14575,90,50,4956,"36,118.47",52752
,20130409,14615,14575,14620,14630,14610,14620,14615,45,40,5380,"39,327.24",51788
,20130410,14620,14615,14620,14650,14620,14635,14635,20,20,3066,"22,442.00",51078
,20130411,14635,14635,14635,14750,14635,14695,14700,60,65,7156,"52,609.81",48568
,20130412,14695,14700,14695,14700,14675,14675,14685,-25,-15,2608,"19,151.83",48344
,20130415,14675,14685,14510,14595,14460,14490,14540,-195,-145,9042,"65,749.89",46196
,20130416,14490,14540,14025,14590,14025,14590,14480,50,-60,8244,"59,692.02",42032
,20130417,14590,14480,14550,14565,14540,14565,14550,85,70,4890,"35,575.27",40262
,20130418,14565,14550,14395,14550,14245,14540,14440,-10,-110,8048,"58,125.96",39192
,20130419,14540,14440,14580,14580,14485,14565,14520,125,80,5428,"39,413.25",38080
,20130422,14565,14520,14450,14520,14425,14475,14495,-45,-25,4506,"32,662.96",35792
,20130423,14475,14495,14500,14550,14490,14550,14500,55,5,4460,"32,342.76",34674
,20130424,14550,14500,14530,14550,14495,14550,14520,50,20,5606,"40,700.97",32784
,20130425,14550,14520,14550,14585,14540,14570,14555,50,35,3726,"27,122.18",31918
,20130426,14570,14555,14565,14620,14565,14580,14590,25,35,5880,"42,906.29",28552
,20130502,14580,14590,14375,14460,14375,14460,14430,-130,-160,5182,"37,396.80",27760
,20130503,14460,14430,14440,14500,14400,14500,14450,70,20,4570,"33,023.08",26970
,20130506,14500,14450,14550,14550,14520,14540,14530,90,80,2140,"15,549.20",26070
,20130507,14540,14530,14530,14545,14510,14515,14525,-15,-5,930,"6,755.78",25610
,20130508,14515,14525,14500,14550,14500,14550,14525,25,0,1730,"12,566.90",24880
,20130509,14550,14525,14535,14565,14520,14565,14540,40,15,2230,"16,214.63",23890
,20130510,14565,14540,14535,14570,14520,14570,14545,30,5,3550,"25,817.83",23530
,20130513,14570,14545,14540,14550,14530,14540,14535,-5,-10,1740,"12,648.30",22430
,20130514,14540,14535,14520,14535,14520,14535,14525,0,-10,2200,"15,982.33",20790
,20130515,14535,14525,14500,14540,14500,14535,14525,10,0,2320,"16,852.28",19560
al1306,20130104,15625,15640,15620,15690,15620,15630,15655,-10,15,116,908.17,542
,20130107,15630,15655,15570,15570,15570,15570,15570,-85,-85,24,186.84,542
,20130108,15570,15570,15565,15585,15505,15505,15535,-65,-35,144,"1,118.53",588
,20130109,15505,15535,15525,15525,15440,15480,15495,-55,-40,196,"1,518.85",642
,20130110,15480,15495,15470,15490,15460,15475,15465,-20,-30,232,"1,794.13",700
,20130111,15475,15465,15510,15520,15450,15475,15500,10,35,304,"2,356.00",836
,20130114,15475,15500,15480,15480,15435,15435,15445,-65,-55,862,"6,657.46",1472
,20130115,15435,15445,15445,15445,15310,15320,15370,-125,-75,1974,"15,173.64",2702
,20130116,15320,15370,15365,15390,15345,15390,15360,20,-10,1788,"13,735.43",4202
,20130117,15390,15360,15390,15410,15340,15410,15365,50,5,2710,"20,821.84",6068
,20130118,15410,15365,15450,15450,15390,15435,15420,70,55,1598,"12,323.69",7296
,20130121,15435,15420,15430,15430,15410,15410,15420,-10,0,112,863.53,7374
,20130122,15410,15420,15420,15420,15390,15395,15405,-25,-15,452,"3,482.24",7608
,20130123,15395,15405,15410,15410,15390,15400,15400,-5,-5,296,"2,279.45",7644
,20130124,15400,15400,15390,15395,15360,15370,15365,-30,-35,352,"2,704.76",7668
,20130125,15370,15365,15375,15390,15375,15385,15380,20,15,216,"1,661.45",7728
,20130128,15385,15380,15350,15350,15315,15325,15330,-55,-50,1552,"11,897.38",8134
,20130129,15325,15330,15315,15330,15295,15330,15305,0,-25,1836,"14,051.64",9066
,20130130,15330,15305,15335,15400,15320,15370,15365,65,60,1722,"13,229.33",9914
,20130131,15370,15365,15405,15450,15405,15450,15425,85,60,2422,"18,680.11",11142
,20130201,15450,15425,15415,15415,15345,15390,15370,-35,-55,1542,"11,854.06",11484
,20130204,15390,15370,15410,15455,15400,15435,15430,65,60,3386,"26,127.20",13384
,20130205,15435,15430,15440,15440,15300,15360,15365,-70,-65,3402,"26,141.53",14698
,20130206,15360,15365,15360,15385,15320,15350,15365,-15,0,1838,"14,123.01",15666
,20130207,15350,15365,15310,15340,15270,15310,15310,-55,-55,8262,"63,247.42",20760
,20130208,15310,15310,15300,15340,15275,15330,15310,20,0,2594,"19,857.08",21946
,20130218,15330,15310,15375,15395,15235,15240,15300,-70,-10,7574,"57,949.47",26460
,20130219,15240,15300,15250,15255,15180,15195,15220,-105,-80,11678,"88,886.56",32054
,20130220,15195,15220,15240,15250,15155,15185,15185,-35,-35,9200,"69,863.91",37514
,20130221,15185,15185,15130,15130,14980,15060,15025,-125,-160,20228,"152,005.56",45944
,20130222,15060,15025,15055,15070,15020,15045,15045,20,20,11686,"87,921.59",51246
,20130225,15045,15045,14985,14995,14895,14920,14925,-125,-120,21554,"160,899.49",59746
,20130226,14920,14925,14895,14940,14875,14895,14905,-30,-20,13524,"100,814.22",64468
,20130227,14895,14905,14935,14970,14915,14940,14945,35,40,10328,"77,177.94",63524
,20130228,14940,14945,14935,14955,14870,14900,14900,-45,-45,16848,"125,551.48",69196
,20130301,14900,14900,14850,14860,14710,14750,14760,-150,-140,22766,"168,056.58",75410
,20130304,14750,14760,14725,14750,14590,14650,14660,-110,-100,20496,"150,276.81",78022
,20130305,14650,14660,14680,14765,14670,14760,14720,100,60,15424,"113,555.43",78490
,20130306,14760,14720,14775,14880,14765,14880,14835,160,115,35032,"259,928.36",84842
,20130307,14880,14835,14840,15000,14810,14985,14920,150,85,60090,"448,355.50",90960
,20130308,14985,14920,15030,15030,14905,14990,14965,70,45,27426,"205,244.24",91612
,20130311,14990,14965,14960,14980,14885,14895,14925,-70,-40,20080,"149,862.25",93412
,20130312,14895,14925,14920,14920,14815,14815,14860,-110,-65,24202,"179,872.61",93594
,20130313,14815,14860,14865,14945,14845,14925,14900,65,40,28278,"210,682.46",97582
,20130314,14925,14900,14895,14920,14800,14885,14845,-15,-55,21574,"160,174.29",97938
,20130315,14885,14845,14900,14900,14800,14840,14840,-5,-5,18360,"136,242.32",100226
,20130318,14840,14840,14780,14780,14595,14685,14695,-155,-145,27096,"199,096.19",99342
,20130319,14685,14695,14695,14710,14640,14655,14675,-40,-20,17002,"124,753.64",98016
,20130320,14655,14675,14650,14720,14635,14720,14685,45,10,10494,"77,062.60",95568
,20130321,14720,14685,14690,14775,14690,14730,14745,45,60,12954,"95,520.43",92608
,20130322,14730,14745,14705,14725,14665,14700,14700,-45,-45,8198,"60,259.74",93158
,20130325,14700,14700,14750,14755,14720,14725,14735,25,35,6098,"44,929.74",93912
,20130326,14725,14735,14690,14740,14680,14705,14705,-30,-30,6638,"48,813.67",93498
,20130327,14705,14705,14665,14700,14645,14655,14665,-50,-40,6338,"46,478.77",94496
,20130328,14655,14665,14655,14725,14615,14620,14645,-45,-20,6836,"50,065.02",94592
,20130329,14620,14645,14600,14630,14550,14610,14600,-35,-45,6812,"49,743.48",93398
,20130401,14610,14600,14590,14590,14535,14545,14545,-55,-55,6642,"48,319.34",92184
,20130402,14545,14545,14555,14615,14545,14605,14570,60,25,4844,"35,288.66",91026
,20130403,14605,14570,14590,14600,14535,14565,14555,-5,-15,4170,"30,354.61",90392
,20130408,14565,14555,14570,14650,14555,14650,14605,95,50,4514,"32,972.39",88878
,20130409,14650,14605,14670,14670,14640,14655,14650,50,45,5014,"36,735.60",88322
,20130410,14655,14650,14665,14700,14645,14670,14675,20,25,3936,"28,883.56",86650
,20130411,14670,14675,14655,14790,14655,14740,14730,65,55,10330,"76,087.00",83164
,20130412,14740,14730,14750,14750,14700,14715,14715,-15,-15,5268,"38,762.87",80932
,20130415,14715,14715,14620,14620,14490,14505,14545,-210,-170,10526,"76,571.62",78764
,20130416,14505,14545,14550,14565,14460,14560,14505,15,-40,7524,"54,573.63",76222
,20130417,14560,14505,14610,14610,14545,14550,14560,45,55,8034,"58,501.22",72326
,20130418,14550,14560,14500,14575,14220,14525,14450,-35,-110,10666,"77,066.03",70044
,20130419,14525,14450,14575,14610,14515,14595,14560,145,110,6548,"47,670.70",68448
,20130422,14595,14560,14575,14575,14510,14515,14535,-45,-25,4288,"31,168.01",66750
,20130423,14515,14535,14525,14555,14510,14540,14535,5,0,6818,"49,550.34",64028
,20130424,14540,14535,14575,14590,14540,14590,14560,55,25,7362,"53,601.60",60268
,20130425,14590,14560,14605,14630,14585,14605,14605,45,45,8386,"61,251.31",58248
,20130426,14605,14605,14700,14700,14615,14630,14650,25,45,7554,"55,334.62",56358
,20130502,14630,14650,14405,14490,14330,14455,14445,-195,-205,8406,"60,713.14",55864
,20130503,14455,14445,14415,14515,14415,14515,14475,70,30,4750,"34,385.67",55316
,20130506,14515,14475,14600,14630,14520,14565,14565,90,90,4978,"36,256.70",53694
,20130507,14565,14565,14565,14575,14530,14530,14560,-35,-5,3124,"22,748.03",52404
,20130508,14530,14560,14545,14580,14540,14580,14560,20,0,2250,"16,380.43",51286
,20130509,14580,14560,14560,14585,14560,14585,14575,25,15,1984,"14,461.17",50284
,20130510,14585,14575,14570,14615,14560,14600,14580,25,5,2128,"15,514.86",49640
,20130513,14600,14580,14540,14585,14535,14540,14555,-40,-25,4178,"30,407.51",47258
,20130514,14540,14555,14540,14570,14540,14540,14550,-15,-5,3774,"27,459.55",45546
,20130515,14540,14550,14535,14555,14535,14535,14545,-15,-5,5764,"41,921.11",44494
,20130516,14535,14545,14540,14545,14510,14545,14520,0,-25,4574,"33,215.60",41774
,20130517,14545,14520,14540,14595,14535,14595,14550,75,30,3610,"26,270.00",39390
,20130520,14595,14550,14545,14575,14540,14575,14555,25,5,3560,"25,908.35",37050
,20130521,14575,14555,14580,14615,14575,14615,14585,60,30,2612,"19,054.43",35964
,20130522,14615,14585,14600,14680,14600,14680,14630,95,45,3818,"27,936.15",34340
,20130523,14680,14630,14650,14655,14630,14630,14645,0,15,4112,"30,111.60",32706
,20130524,14630,14645,14640,14680,14640,14680,14655,35,10,2670,"19,569.51",31326
,20130527,14680,14655,14640,14700,14640,14655,14660,0,5,4758,"34,885.80",29894
,20130528,14655,14660,14655,14670,14630,14665,14645,5,-15,4310,"31,565.72",26334
,20130529,14665,14645,14660,14700,14660,14700,14675,55,30,3662,"26,870.16",24248
,20130530,14700,14675,14690,14725,14675,14725,14690,50,15,4690,"34,455.70",21976
,20130531,14725,14690,14830,14840,14735,14840,14780,150,90,6354,"46,958.14",19002
,20130603,14840,14780,14810,14845,14800,14845,14820,65,40,4652,"34,477.96",15680
,20130604,14845,14820,14815,14855,14225,14840,14790,20,-30,5200,"38,465.10",15480
,20130605,14840,14790,14840,14900,14840,14900,14865,110,75,5510,"40,957.03",14360
,20130606,14900,14865,14860,14935,14860,14910,14910,45,45,3580,"26,689.23",12600
,20130607,14910,14910,14910,14940,14900,14930,14915,20,5,6660,"49,679.18",14590
,20130613,14930,14915,14820,14840,14750,14810,14795,-105,-120,2860,"21,157.95",13530
,20130614,14810,14795,14730,14775,14730,14775,14750,-20,-45,1830,"13,496.83",12460
,20130617,14775,14750,14750,14800,14750,14765,14780,15,30,3030,"22,396.10",12040
al1307,20130104,15710,15710,,,,15710,15710,0,0,0,0,400
,20130107,15710,15710,15710,15710,15670,15670,15700,-40,-10,12,94.22,402
,20130108,15670,15700,15675,15675,15580,15580,15610,-120,-90,134,"1,045.89",434
,20130109,15580,15610,15585,15585,15585,15585,15585,-25,-25,6,46.76,432
,20130110,15585,15585,15535,15540,15535,15535,15535,-50,-50,336,"2,610.29",650
,20130111,15535,15535,15540,15540,15540,15540,15540,5,5,4,31.08,646
,20130114,15540,15540,15520,15520,15510,15515,15515,-25,-25,70,543.16,684
,20130115,15515,15515,15450,15460,15410,15430,15430,-85,-85,516,"3,981.35",890
,20130116,15430,15430,15450,15460,15410,15410,15435,-20,5,140,"1,080.77",1006
,20130117,15410,15435,15435,15455,15420,15445,15420,10,-15,380,"2,930.56",1190
,20130118,15445,15420,15510,15510,15470,15470,15500,50,80,106,821.65,1288
,20130121,15470,15500,15475,15480,15470,15470,15475,-30,-25,10,77.38,1290
,20130122,15470,15475,15505,15505,15450,15480,15465,5,-10,96,742.55,1288
,20130123,15480,15465,15465,15465,15455,15455,15460,-10,-5,40,309.25,1274
,20130124,15455,15460,15440,15440,15430,15430,15430,-30,-30,118,910.66,1300
,20130125,15430,15430,,,,15440,15440,10,10,0,0,1300
,20130128,15440,15440,15420,15420,15395,15395,15395,-45,-45,12,92.4,1302
,20130129,15395,15395,15410,15410,15380,15385,15385,-10,-10,72,553.94,1326
,20130130,15385,15385,15425,15480,15420,15470,15445,85,60,136,"1,050.41",1384
,20130131,15470,15445,15485,15530,15480,15530,15505,85,60,382,"2,961.49",1646
,20130201,15530,15505,15500,15500,15445,15450,15460,-55,-45,10,77.31,1648
,20130204,15450,15460,15530,15545,15505,15515,15515,55,55,178,"1,381.13",1728
,20130205,15515,15515,15400,15485,15400,15470,15435,-45,-80,500,"3,859.57",1926
,20130206,15470,15435,15465,15465,15435,15435,15450,0,15,48,370.91,1930
,20130207,15435,15450,15390,15420,15390,15395,15400,-55,-50,290,"2,233.53",1998
,20130208,15395,15400,15400,15420,15400,15420,15405,20,5,176,"1,356.05",2168
,20130218,15420,15405,15420,15470,15330,15340,15385,-65,-20,478,"3,677.80",2316
,20130219,15340,15385,15340,15355,15275,15295,15310,-90,-75,1514,"11,591.18",2976
,20130220,15295,15310,15320,15335,15255,15280,15280,-30,-30,978,"7,472.99",3388
,20130221,15280,15280,15240,15240,15065,15165,15130,-115,-150,2014,"15,240.69",3656
,20130222,15165,15130,15150,15155,15120,15145,15140,15,10,632,"4,784.77",3868
,20130225,15145,15140,15090,15090,14985,15010,15010,-130,-130,3240,"24,323.96",5808
,20130226,15010,15010,14995,15025,14990,14995,15000,-15,-10,3066,"22,997.83",7870
,20130227,14995,15000,15025,15055,15010,15035,15035,35,35,3452,"25,956.12",9262
,20130228,15035,15035,15030,15040,14955,14990,14975,-45,-60,7490,"56,082.10",13842
,20130301,14990,14975,14930,14975,14790,14825,14830,-150,-145,5686,"42,174.13",16402
,20130304,14825,14830,14780,14850,14650,14710,14725,-120,-105,5274,"38,840.22",17954
,20130305,14710,14725,14750,14835,14745,14835,14790,110,65,3572,"26,420.63",19080
,20130306,14835,14790,14840,14950,14840,14935,14910,145,120,7810,"58,238.35",18718
,20130307,14935,14910,14885,15060,14875,15040,14975,130,65,5384,"40,320.92",19072
,20130308,15040,14975,15070,15095,14965,15040,15015,65,40,2568,"19,283.43",19872
,20130311,15040,15015,15010,15050,14950,14950,14980,-65,-35,3006,"22,516.43",21354
,20130312,14950,14980,14955,14960,14890,14890,14925,-90,-55,4564,"34,062.82",23040
,20130313,14890,14925,14965,15020,14920,15000,14975,75,50,5780,"43,279.97",24554
,20130314,15000,14975,14975,14980,14880,14950,14915,-25,-60,4458,"33,249.69",25562
,20130315,14950,14915,15005,15045,14875,14910,14905,-5,-10,5794,"43,192.57",26510
,20130318,14910,14905,14870,14870,14695,14760,14770,-145,-135,11026,"81,439.88",30320
,20130319,14760,14770,14785,14800,14700,14700,14750,-70,-20,7640,"56,349.29",33504
,20130320,14700,14750,14735,14775,14685,14770,14745,20,-5,8442,"62,248.90",36088
,20130321,14770,14745,14775,14850,14775,14785,14800,40,55,9488,"70,233.27",37728
,20130322,14785,14800,14730,14775,14710,14735,14745,-65,-55,6652,"49,048.50",39032
,20130325,14735,14745,14795,14800,14765,14765,14775,20,30,5276,"38,986.77",39856
,20130326,14765,14775,14720,14775,14705,14750,14745,-25,-30,4222,"31,135.44",40778
,20130327,14750,14745,14700,14780,14690,14695,14705,-50,-40,6160,"45,300.68",41890
,20130328,14695,14705,14715,14750,14645,14660,14680,-45,-25,9832,"72,189.98",44960
,20130329,14660,14680,14610,14675,14605,14645,14645,-35,-35,7452,"54,580.81",45264
,20130401,14645,14645,14625,14625,14575,14590,14590,-55,-55,6154,"44,895.85",46978
,20130402,14590,14590,14590,14660,14590,14660,14620,70,30,6466,"47,267.77",47922
,20130403,14660,14620,14650,14650,14560,14580,14590,-40,-30,12408,"90,530.52",52294
,20130408,14580,14590,14590,14670,14580,14665,14625,75,35,9966,"72,883.39",51798
,20130409,14665,14625,14665,14705,14650,14690,14675,65,50,8736,"64,120.17",53600
,20130410,14690,14675,14705,14730,14680,14715,14710,40,35,9620,"70,759.31",54380
,20130411,14715,14710,14700,14825,14690,14760,14775,50,65,20114,"148,621.14",53906
,20130412,14760,14775,14785,14785,14735,14750,14750,-25,-25,10760,"79,356.38",57156
,20130415,14750,14750,14660,14660,14505,14530,14575,-220,-175,23958,"174,648.47",64172
,20130416,14530,14575,14540,14600,14480,14595,14545,20,-30,14038,"102,117.77",63554
,20130417,14595,14545,14645,14645,14560,14575,14600,30,55,9430,"68,857.37",63156
,20130418,14575,14600,14430,14610,14200,14550,14455,-50,-145,24740,"178,870.04",59806
,20130419,14550,14455,14590,14635,14530,14615,14580,160,125,14034,"102,340.50",59800
,20130422,14615,14580,14550,14600,14530,14540,14560,-40,-20,5874,"42,772.87",59626
,20130423,14540,14560,14555,14585,14540,14580,14560,20,0,8074,"58,779.08",59384
,20130424,14580,14560,14590,14645,14565,14620,14595,60,35,8412,"61,401.11",59320
,20130425,14620,14595,14645,14660,14615,14645,14635,50,40,8972,"65,674.79",59578
,20130426,14645,14635,14665,14715,14640,14670,14675,35,40,14274,"104,769.72",55284
,20130502,14670,14675,14400,14505,14310,14470,14460,-205,-215,12152,"87,886.15",55322
,20130503,14470,14460,14470,14545,14450,14535,14505,75,45,8032,"58,258.38",53004
,20130506,14535,14505,14610,14685,14570,14600,14610,95,105,8052,"58,834.89",52714
,20130507,14600,14610,14605,14620,14550,14550,14590,-60,-20,4128,"30,121.78",52512
,20130508,14550,14590,14550,14625,14550,14615,14600,25,10,3598,"26,266.15",52068
,20130509,14615,14600,14650,14650,14600,14620,14615,20,15,4182,"30,560.79",51154
,20130510,14620,14615,14595,14660,14595,14635,14615,20,0,3418,"24,979.45",50196
,20130513,14635,14615,14630,14630,14570,14570,14600,-45,-15,4372,"31,923.16",49486
,20130514,14570,14600,14590,14615,14560,14565,14585,-35,-15,3184,"23,219.82",48650
,20130515,14565,14585,14580,14585,14540,14540,14555,-45,-30,2624,"19,099.64",48448
,20130516,14540,14555,14540,14545,14500,14520,14515,-35,-40,3008,"21,837.09",48016
,20130517,14520,14515,14555,14580,14530,14550,14545,35,30,2922,"21,256.25",46950
,20130520,14550,14545,14540,14560,14525,14545,14550,0,5,3638,"26,467.96",45634
,20130521,14545,14550,14560,14600,14560,14600,14585,50,35,2622,"19,121.49",44654
,20130522,14600,14585,14600,14665,14590,14660,14630,75,45,2596,"18,993.29",44628
,20130523,14660,14630,14660,14665,14615,14620,14635,-10,5,2290,"16,757.39",43788
,20130524,14620,14635,14645,14650,14630,14650,14635,15,0,1376,"10,070.15",44114
,20130527,14650,14635,14635,14660,14620,14620,14640,-15,5,2406,"17,612.21",43480
,20130528,14620,14640,14620,14645,14610,14645,14620,5,-20,2884,"21,086.54",42628
,20130529,14645,14620,14630,14665,14630,14660,14650,40,30,4002,"29,323.27",41542
,20130530,14660,14650,14665,14700,14660,14700,14675,50,25,3644,"26,740.36",40390
,20130531,14700,14675,14780,14815,14730,14805,14755,130,80,5682,"41,921.67",38266
,20130603,14805,14755,14805,14880,14795,14880,14845,125,90,3456,"25,658.80",36892
,20130604,14880,14845,14845,14865,14790,14830,14820,-15,-25,6966,"51,633.70",34356
,20130605,14830,14820,14870,14930,14855,14930,14885,110,65,7376,"54,905.74",31308
,20130606,14930,14885,14935,14950,14845,14905,14915,20,30,5138,"38,327.20",29160
,20130607,14905,14915,14930,14950,14890,14920,14920,5,5,4652,"34,715.15",28866
,20130613,14920,14920,14760,14795,14675,14750,14765,-170,-155,3760,"27,764.85",28692
,20130614,14750,14765,14750,14770,14705,14720,14735,-45,-30,2758,"20,324.26",28458
,20130617,14720,14735,14740,14770,14735,14745,14750,10,15,3352,"24,724.82",28296
,20130618,14745,14750,14725,14725,14625,14660,14650,-90,-100,4408,"32,295.86",29944
,20130619,14660,14650,14635,14655,14620,14650,14635,0,-15,5888,"43,098.13",27496
,20130620,14650,14635,14580,14585,14460,14490,14540,-145,-95,4288,"31,179.40",26286
,20130621,14490,14540,14440,14520,14385,14520,14445,-20,-95,2884,"20,835.69",25098
,20130624,14520,14445,14455,14455,14360,14360,14410,-85,-35,3020,"21,759.15",23638
,20130625,14360,14410,14330,14425,14315,14410,14385,0,-25,3814,"27,433.18",22378
,20130626,14410,14385,14390,14410,14335,14365,14360,-20,-25,2550,"18,313.16",21000
,20130627,14365,14360,14380,14400,14370,14390,14380,30,20,2584,"18,584.99",19604
,20130628,14390,14380,14350,14370,14305,14360,14350,-20,-30,1556,"11,167.85",19100
,20130701,14360,14350,14370,14450,14370,14450,14385,100,35,1510,"10,862.78",17930
,20130702,14450,14385,14460,14480,14460,14470,14465,85,80,2750,"19,894.90",16370
,20130703,14470,14465,14460,14480,14455,14480,14465,15,0,1680,"12,152.10",15840
,20130704,14480,14465,14420,14425,14400,14410,14410,-55,-55,2100,"15,132.45",15220
,20130705,14410,14410,14400,14405,14390,14400,14390,-10,-20,2580,"18,567.03",13310
,20130708,14400,14390,14330,14350,14320,14320,14335,-70,-55,1760,"12,618.40",13320
,20130709,14320,14335,14360,14375,14340,14340,14360,5,25,1000,"7,181.65",12650
,20130710,14340,14360,14300,14350,14300,14345,14320,-15,-40,3180,"22,775.65",14020
,20130711,14345,14320,14400,14470,14390,14450,14430,130,110,3910,"28,215.05",10980
,20130712,14450,14430,14400,14425,14350,14395,14395,-35,-35,1620,"11,661.38",9750
,20130715,14395,14395,14380,14380,14330,14330,14355,-65,-40,2590,"18,595.20",8180
al1308,20130104,15730,15730,,,,15745,15745,15,15,0,0,214
,20130107,15745,15745,15620,15735,15620,15735,15670,-10,-75,6,47.02,216
,20130108,15735,15670,15720,15720,15720,15720,15720,50,50,4,31.44,216
,20130109,15720,15720,,,,15720,15720,0,0,0,0,216
,20130110,15720,15720,,,,15720,15720,0,0,0,0,216
,20130111,15720,15720,15650,15650,15650,15650,15650,-70,-70,2,15.65,214
,20130114,15650,15650,,,,15625,15625,-25,-25,0,0,214
,20130115,15625,15625,15500,15500,15500,15500,15500,-125,-125,4,31,216
,20130116,15500,15500,15530,15530,15530,15530,15530,30,30,16,124.24,216
,20130117,15530,15530,15490,15530,15490,15530,15520,0,-10,8,62.08,218
,20130118,15530,15520,,,,15520,15520,0,0,0,0,218
,20130121,15520,15520,,,,15520,15520,0,0,0,0,218
,20130122,15520,15520,,,,15520,15520,0,0,0,0,218
,20130123,15520,15520,15530,15530,15530,15530,15530,10,10,4,31.06,218
,20130124,15530,15530,,,,15530,15530,0,0,0,0,218
,20130125,15530,15530,15535,15535,15535,15535,15535,5,5,2,15.54,220
,20130128,15535,15535,15515,15515,15515,15515,15515,-20,-20,2,15.52,222
,20130129,15515,15515,15450,15485,15450,15460,15470,-55,-45,38,294.01,250
,20130130,15460,15470,15525,15545,15525,15545,15530,75,60,48,372.78,280
,20130131,15545,15530,15560,15590,15560,15585,15580,55,50,66,514.25,316
,20130201,15585,15580,15550,15575,15545,15545,15550,-35,-30,22,171.06,324
,20130204,15545,15550,,,,15590,15590,40,40,0,0,324
,20130205,15590,15590,15570,15570,15570,15570,15570,-20,-20,2,15.57,324
,20130206,15570,15570,15530,15530,15530,15530,15530,-40,-40,4,31.06,320
,20130207,15530,15530,15495,15515,15480,15480,15500,-50,-30,14,108.51,314
,20130208,15480,15500,15500,15500,15500,15500,15500,0,0,2,15.5,314
,20130218,15500,15500,15550,15550,15420,15420,15495,-80,-5,106,821.41,354
,20130219,15420,15495,15410,15435,15380,15390,15415,-105,-80,248,"1,911.48",452
,20130220,15390,15415,15395,15400,15380,15380,15385,-35,-30,26,200.03,450
,20130221,15380,15385,15305,15305,15210,15235,15230,-150,-155,244,"1,858.38",504
,20130222,15235,15230,15260,15260,15220,15245,15245,15,15,70,533.64,522
,20130225,15245,15245,15160,15160,15090,15110,15125,-135,-120,326,"2,465.38",632
,20130226,15110,15125,15090,15120,15085,15090,15100,-35,-25,220,"1,661.04",772
,20130227,15090,15100,15140,15150,15110,15115,15120,15,20,156,"1,179.56",794
,20130228,15115,15120,15135,15135,15055,15055,15065,-65,-55,258,"1,943.63",836
,20130301,15055,15065,15025,15025,14900,14910,14920,-155,-145,902,"6,730.30",1602
,20130304,14910,14920,14870,14875,14700,14755,14765,-165,-155,2574,"19,007.78",2710
,20130305,14755,14765,14815,14890,14810,14890,14865,125,100,476,"3,538.07",2780
,20130306,14890,14865,14940,15000,14910,14995,14960,130,95,4822,"36,078.07",5752
,20130307,14995,14960,14960,15105,14920,15090,14990,130,30,3280,"24,590.32",8048
,20130308,15090,14990,15115,15125,15000,15095,15060,105,70,2676,"20,150.58",9742
,20130311,15095,15060,15060,15095,15010,15010,15030,-50,-30,384,"2,886.58",9722
,20130312,15010,15030,15050,15050,14950,14950,14975,-80,-55,840,"6,291.09",9874
,20130313,14950,14975,14950,15060,14950,15055,15005,80,30,546,"4,097.10",9798
,20130314,15055,15005,15010,15010,14930,14995,14980,-10,-25,1206,"9,034.05",10396
,20130315,14995,14980,15015,15015,14930,14960,14950,-20,-30,704,"5,263.93",10550
,20130318,14960,14950,14940,14940,14705,14820,14830,-130,-120,3818,"28,317.83",11064
,20130319,14820,14830,14825,14850,14760,14760,14820,-70,-10,856,"6,343.48",11400
,20130320,14760,14820,14760,14820,14760,14815,14800,-5,-20,1078,"7,978.21",11252
,20130321,14815,14800,14865,14890,14830,14835,14860,35,60,504,"3,745.51",11338
,20130322,14835,14860,14780,14820,14765,14765,14790,-95,-70,822,"6,079.47",11660
,20130325,14765,14790,14825,14845,14795,14795,14820,5,30,904,"6,698.91",12236
,20130326,14795,14820,14750,14830,14750,14780,14780,-40,-40,898,"6,637.47",12378
,20130327,14780,14780,14770,14770,14730,14740,14745,-40,-35,1622,"11,960.73",13044
,20130328,14740,14745,14775,14775,14685,14710,14710,-35,-35,1384,"10,180.80",13660
,20130329,14710,14710,14660,14715,14645,14715,14690,5,-20,2180,"16,013.97",14606
,20130401,14715,14690,14675,14680,14620,14640,14630,-50,-60,1436,"10,507.54",15050
,20130402,14640,14630,14655,14695,14635,14695,14660,65,30,2078,"15,236.87",16072
,20130403,14695,14660,14655,14690,14600,14605,14625,-55,-35,3448,"25,222.04",17824
,20130408,14605,14625,14620,14695,14610,14690,14655,65,30,3840,"28,138.66",19506
,20130409,14690,14655,14690,14800,14690,14725,14705,70,50,4436,"32,620.21",21472
,20130410,14725,14705,14760,14760,14660,14745,14740,40,35,4832,"35,612.80",23888
,20130411,14745,14740,14730,14860,14730,14790,14800,50,60,7494,"55,472.36",25330
,20130412,14790,14800,14840,14840,14760,14780,14775,-20,-25,6604,"48,793.40",28692
,20130415,14780,14775,14650,14680,14510,14555,14585,-220,-190,17214,"125,559.71",38156
,20130416,14555,14585,14500,14635,14490,14625,14575,40,-10,18220,"132,816.38",41714
,20130417,14625,14575,14700,14700,14580,14585,14615,10,40,8672,"63,386.60",44696
,20130418,14585,14615,14350,14615,14250,14545,14465,-70,-150,26928,"194,810.05",48066
,20130419,14545,14465,14645,14645,14535,14620,14590,155,125,15326,"111,813.80",47132
,20130422,14620,14590,14570,14605,14535,14540,14565,-50,-25,6632,"48,300.25",48980
,20130423,14540,14565,14575,14590,14450,14590,14555,25,-10,12190,"88,742.09",51438
,20130424,14590,14555,14585,14655,14570,14630,14610,75,55,10554,"77,113.53",52474
,20130425,14630,14610,14655,14695,14620,14670,14655,60,45,10388,"76,123.95",51164
,20130426,14670,14655,14715,14745,14645,14670,14685,15,30,18020,"132,354.58",47312
,20130502,14670,14685,14300,14500,14285,14480,14445,-205,-240,25374,"183,303.76",57392
,20130503,14480,14445,14480,14560,14460,14550,14515,105,70,12930,"93,849.89",59446
,20130506,14550,14515,14655,14700,14610,14630,14635,115,120,14462,"105,833.01",59766
,20130507,14630,14635,14590,14655,14580,14585,14620,-50,-15,8526,"62,328.87",60802
,20130508,14585,14620,14600,14670,14595,14665,14635,45,15,10134,"74,176.32",57924
,20130509,14665,14635,14690,14690,14635,14660,14645,25,10,6596,"48,315.67",58044
,20130510,14660,14645,14640,14700,14625,14670,14650,25,5,7254,"53,146.15",59660
,20130513,14670,14650,14635,14660,14610,14610,14635,-40,-15,7468,"54,647.92",61404
,20130514,14610,14635,14635,14655,14580,14590,14605,-45,-30,5930,"43,309.03",62560
,20130515,14590,14605,14575,14600,14545,14545,14570,-60,-35,6542,"47,668.78",64768
,20130516,14545,14570,14570,14570,14500,14525,14520,-45,-50,6680,"48,506.01",65632
,20130517,14525,14520,14485,14580,14485,14560,14545,40,25,6048,"43,994.67",66178
,20130520,14560,14545,14550,14560,14520,14550,14545,5,0,4296,"31,242.73",66284
,20130521,14550,14545,14580,14610,14570,14600,14585,55,40,4080,"29,759.25",65550
,20130522,14600,14585,14600,14665,14580,14660,14630,75,45,8844,"64,698.07",63408
,20130523,14660,14630,14675,14675,14610,14610,14625,-20,-5,5864,"42,887.22",63296
,20130524,14610,14625,14630,14655,14610,14650,14630,25,5,2788,"20,399.65",62962
,20130527,14650,14630,14625,14650,14600,14615,14620,-15,-10,3288,"24,035.54",62274
,20130528,14615,14620,14615,14630,14585,14620,14600,0,-20,3374,"24,638.61",61176
,20130529,14620,14600,14600,14650,14600,14640,14635,40,35,5154,"37,724.42",58324
,20130530,14640,14635,14660,14690,14650,14690,14665,55,30,6244,"45,797.89",56066
,20130531,14690,14665,14750,14830,14740,14830,14770,165,105,11372,"83,987.55",51592
,20130603,14830,14770,14840,14905,14815,14905,14860,135,90,8056,"59,866.85",48980
,20130604,14905,14860,14830,14885,14795,14860,14840,0,-20,4976,"36,934.19",48008
,20130605,14860,14840,14895,14960,14875,14960,14895,120,55,13580,"101,163.17",42536
,20130606,14960,14895,14895,14965,14850,14910,14925,15,30,13474,"100,578.04",38736
,20130607,14910,14925,14940,14975,14915,14940,14940,15,15,7092,"52,992.18",38252
,20130613,14940,14940,14625,14800,14625,14730,14730,-210,-210,7306,"53,820.45",37378
,20130614,14730,14730,14705,14730,14685,14690,14705,-40,-25,4466,"32,843.06",36942
,20130617,14690,14705,14690,14735,14690,14705,14715,0,10,2142,"15,763.96",36540
,20130618,14705,14715,14705,14705,14545,14555,14600,-160,-115,8210,"59,944.06",33948
,20130619,14555,14600,14570,14580,14550,14565,14560,-35,-40,3802,"27,687.85",32626
,20130620,14565,14560,14505,14505,14380,14385,14445,-175,-115,2672,"19,299.09",33008
,20130621,14385,14445,14330,14425,14280,14390,14355,-55,-90,4454,"31,978.21",33216
,20130624,14390,14355,14350,14365,14275,14285,14325,-70,-30,3692,"26,450.53",33346
,20130625,14285,14325,14290,14340,14225,14330,14285,5,-40,4510,"32,215.38",33812
,20130626,14330,14285,14330,14340,14230,14245,14300,-40,15,2712,"19,390.94",33846
,20130627,14245,14300,14280,14310,14280,14305,14295,5,-5,2150,"15,369.01",33610
,20130628,14305,14295,14255,14280,14205,14250,14265,-45,-30,1722,"12,285.43",33620
,20130701,14250,14265,14250,14345,14250,14335,14315,70,50,1710,"12,239.82",32876
,20130702,14335,14315,14340,14420,14325,14400,14400,85,85,2980,"21,458.42",31466
,20130703,14400,14400,14400,14455,14390,14415,14400,15,0,1346,"9,691.64",30870
,20130704,14415,14400,14360,14385,14345,14365,14365,-35,-35,1200,"8,620.89",31140
,20130705,14365,14365,14375,14375,14335,14340,14345,-25,-20,836,"5,997.33",31030
,20130708,14340,14345,14265,14285,14250,14250,14270,-95,-75,2054,"14,659.98",30636
,20130709,14250,14270,14310,14350,14300,14300,14320,30,50,1990,"14,252.81",30202
,20130710,14300,14320,14305,14320,14280,14315,14295,-5,-25,1674,"11,965.47",29898
,20130711,14315,14295,14475,14490,14380,14430,14425,135,130,6702,"48,345.02",26714
,20130712,14430,14425,14405,14410,14360,14370,14385,-55,-40,1138,"8,186.61",26662
,20130715,14370,14385,14400,14400,14330,14330,14375,-55,-10,3784,"27,202.96",24994
,20130716,14330,14375,14315,14370,14300,14365,14345,-10,-30,3324,"23,847.80",24452
,20130717,14365,14345,14350,14375,14330,14330,14350,-15,5,3432,"24,626.71",22702
,20130718,14330,14350,14315,14360,14315,14325,14330,-25,-20,1630,"11,681.07",21946
,20130719,14325,14330,14350,14365,14340,14360,14355,30,25,1754,"12,589.71",21486
,20130722,14360,14355,14580,14580,14370,14380,14385,25,30,2202,"15,841.05",21836
,20130723,14380,14385,14400,14410,14390,14400,14395,15,10,3288,"23,673.11",21144
,20130724,14400,14395,14385,14385,14360,14370,14370,-25,-25,1030,"7,400.66",20806
,20130725,14370,14370,14375,14395,14370,14395,14380,25,10,1800,"12,943.74",20894
,20130726,14395,14380,14370,14380,14345,14370,14365,-10,-15,1192,"8,562.80",20334
,20130729,14370,14365,14340,14340,14235,14265,14285,-100,-80,2800,"20,005.38",19958
,20130730,14265,14285,14265,14280,14245,14250,14255,-35,-30,1886,"13,445.75",19434
,20130731,14250,14255,14205,14220,14150,14155,14195,-100,-60,1690,"11,995.22",18320
,20130801,14155,14195,14200,14290,14200,14290,14250,95,55,2440,"17,386.23",16950
,20130802,14290,14250,14290,14290,14250,14260,14255,10,5,1660,"11,835.23",15640
,20130805,14260,14255,14280,14285,14255,14255,14270,0,15,1800,"12,844.80",14560
,20130806,14255,14270,14255,14255,14240,14255,14245,-15,-25,1260,"8,977.13",13700
,20130807,14255,14245,14230,14230,14205,14210,14210,-35,-35,3260,"23,166.23",12900
,20130808,14210,14210,14240,14245,14210,14240,14225,30,15,3220,"22,906.23",11920
,20130809,14240,14225,14260,14295,14260,14280,14280,55,55,4070,"29,063.75",13040
,20130812,14280,14280,14300,14335,14300,14335,14320,55,40,3770,"26,995.88",14540
,20130813,14335,14320,14360,14360,14335,14345,14350,25,30,2270,"16,288.18",13920
,20130814,14345,14350,14400,14400,14280,14305,14315,-45,-35,2880,"20,619.65",12000
,20130815,14305,14315,14350,14355,14345,14350,14350,35,35,1840,"13,202.18",10660
al1309,20130104,15850,15850,,,,15850,15850,0,0,0,0,132
,20130107,15850,15850,,,,15850,15850,0,0,0,0,132
,20130108,15850,15850,,,,15830,15830,-20,-20,0,0,132
,20130109,15830,15830,,,,15830,15830,0,0,0,0,132
,20130110,15830,15830,15690,15690,15690,15690,15690,-140,-140,20,156.9,152
,20130111,15690,15690,15695,15695,15690,15690,15690,0,0,8,62.78,146
,20130114,15690,15690,15680,15680,15680,15680,15680,-10,-10,40,313.6,180
,20130115,15680,15680,15560,15580,15560,15580,15570,-100,-110,6,46.72,182
,20130116,15580,15570,,,,15570,15570,0,0,0,0,182
,20130117,15570,15570,15545,15640,15545,15640,15615,70,45,8,62.47,188
,20130118,15640,15615,15625,15625,15625,15625,15625,10,10,4,31.25,192
,20130121,15625,15625,15660,15700,15660,15700,15680,75,55,4,31.36,192
,20130122,15700,15680,15660,15660,15660,15660,15660,-20,-20,2,15.66,192
,20130123,15660,15660,,,,15670,15670,10,10,0,0,192
,20130124,15670,15670,,,,15670,15670,0,0,0,0,192
,20130125,15670,15670,,,,15675,15675,5,5,0,0,192
,20130128,15675,15675,15500,15500,15500,15500,15500,-175,-175,2,15.5,190
,20130129,15500,15500,,,,15505,15505,5,5,0,0,190
,20130130,15505,15505,15600,15645,15600,15620,15615,115,110,54,421.72,210
,20130131,15620,15615,15690,15750,15650,15700,15695,85,80,118,926.02,258
,20130201,15700,15695,15650,15660,15650,15660,15650,-35,-45,24,187.82,262
,20130204,15660,15650,15680,15685,15680,15685,15680,35,30,4,31.37,260
,20130205,15685,15680,15675,15675,15505,15665,15585,-15,-95,82,639.07,262
,20130206,15665,15585,15650,15650,15650,15650,15650,65,65,10,78.25,262
,20130207,15650,15650,,,,15650,15650,0,0,0,0,262
,20130208,15650,15650,,,,15650,15650,0,0,0,0,262
,20130218,15650,15650,15560,15665,15560,15560,15605,-90,-45,56,436.97,266
,20130219,15560,15605,15515,15525,15515,15525,15520,-80,-85,40,310.4,268
,20130220,15525,15520,15450,15455,15450,15455,15450,-65,-70,48,370.82,272
,20130221,15455,15450,15270,15370,15270,15355,15330,-95,-120,166,"1,272.74",358
,20130222,15355,15330,15335,15350,15320,15330,15320,0,-10,188,"1,440.17",488
,20130225,15330,15320,15195,15200,15175,15195,15190,-125,-130,22,167.14,486
,20130226,15195,15190,15190,15190,15165,15180,15175,-10,-15,10,75.9,482
,20130227,15180,15175,15210,15230,15200,15200,15210,25,35,152,"1,156.25",582
,20130228,15200,15210,15220,15220,15130,15155,15165,-55,-45,22,166.85,584
,20130301,15155,15165,15110,15110,14990,15010,15025,-155,-140,586,"4,403.52",580
,20130304,15010,15025,14940,14975,14760,14835,14880,-190,-145,298,"2,217.35",668
,20130305,14835,14880,14875,14980,14875,14965,14945,85,65,62,463.43,650
,20130306,14965,14945,15060,15305,15000,15060,15055,115,110,658,"4,953.63",1102
,20130307,15060,15055,15080,15155,14995,15155,15080,100,25,628,"4,736.20",1376
,20130308,15155,15080,15155,15155,15030,15150,15130,70,50,576,"4,357.48",1802
,20130311,15150,15130,15130,15135,15060,15060,15120,-70,-10,200,"1,512.40",1802
,20130312,15060,15120,15080,15080,15015,15025,15050,-95,-70,64,481.61,1844
,20130313,15025,15050,15030,15115,15030,15115,15065,65,15,60,452.01,1838
,20130314,15115,15065,15060,15060,14990,15060,15010,-5,-55,1358,"10,193.74",2606
,20130315,15060,15010,15040,15040,14980,15020,15005,10,-5,1128,"8,465.35",2934
,20130318,15020,15005,14980,14980,14750,14880,14895,-125,-110,1602,"11,934.47",2410
,20130319,14880,14895,14910,14910,14810,14820,14850,-75,-45,120,891.13,2368
,20130320,14820,14850,14860,14880,14850,14870,14865,20,15,880,"6,541.24",2896
,20130321,14870,14865,14965,14965,14895,14895,14935,30,70,104,776.66,2976
,20130322,14895,14935,14885,14885,14840,14840,14855,-95,-80,304,"2,258.19",3094
,20130325,14840,14855,14870,14895,14830,14865,14875,10,20,66,490.95,3040
,20130326,14865,14875,14885,14885,14830,14835,14855,-40,-20,58,430.93,3060
,20130327,14835,14855,14825,14825,14780,14805,14800,-50,-55,2720,"20,129.13",5258
,20130328,14805,14800,14820,14825,14720,14770,14775,-30,-25,1004,"7,417.94",5924
,20130329,14770,14775,14700,14775,14700,14730,14745,-45,-30,1994,"14,700.90",6946
,20130401,14730,14745,14685,14705,14675,14705,14685,-40,-60,1188,"8,724.48",7918
,20130402,14705,14685,14670,14750,14670,14750,14730,65,45,528,"3,890.00",8010
,20130403,14750,14730,14700,14715,14660,14660,14690,-70,-40,1354,"9,947.73",8748
,20130408,14660,14690,14690,14740,14670,14730,14685,40,-5,860,"6,315.45",9178
,20130409,14730,14685,14755,14775,14735,14770,14750,85,65,516,"3,806.36",9490
,20130410,14770,14750,14780,14820,14755,14820,14785,70,35,414,"3,060.87",9694
,20130411,14820,14785,14820,14910,14810,14840,14860,55,75,460,"3,418.86",9634
,20130412,14840,14860,14840,14840,14805,14830,14815,-30,-45,566,"4,193.90",9812
,20130415,14830,14815,14735,14735,14550,14580,14635,-235,-180,3216,"23,539.56",11960
,20130416,14580,14635,14570,14760,14510,14645,14640,10,5,3716,"27,204.75",12940
,20130417,14645,14640,14675,14780,14610,14610,14640,-30,0,2348,"17,191.52",14388
,20130418,14610,14640,14570,14620,14290,14575,14485,-65,-155,5582,"40,429.86",16400
,20130419,14575,14485,14605,14650,14555,14650,14605,165,120,3282,"23,973.02",16912
,20130422,14650,14605,14605,14630,14560,14570,14590,-35,-15,1618,"11,807.00",17464
,20130423,14570,14590,14590,14600,14550,14595,14575,5,-15,1812,"13,207.97",17870
,20130424,14595,14575,14635,14670,14600,14640,14625,65,50,1302,"9,522.25",18216
,20130425,14640,14625,14650,14700,14640,14690,14660,65,35,3844,"28,184.88",18884
,20130426,14690,14660,14710,14760,14655,14660,14700,0,40,5942,"43,679.25",20320
,20130502,14660,14700,14500,14500,14335,14495,14460,-205,-240,8784,"63,518.18",24102
,20130503,14495,14460,14490,14575,14465,14560,14520,100,60,5846,"42,453.45",25064
,20130506,14560,14520,14695,14720,14625,14650,14650,130,130,7166,"52,496.70",25254
,20130507,14650,14650,14645,14680,14610,14610,14645,-40,-5,5804,"42,502.84",25896
,20130508,14610,14645,14610,14695,14610,14695,14660,50,15,4014,"29,430.91",26022
,20130509,14695,14660,14700,14740,14665,14675,14680,15,20,2136,"15,681.55",26684
,20130510,14675,14680,14655,14740,14655,14720,14690,40,10,3260,"23,950.21",27526
,20130513,14720,14690,14700,14705,14655,14670,14670,-20,-20,4622,"33,907.79",29048
,20130514,14670,14670,14680,14690,14610,14610,14635,-60,-35,4194,"30,699.76",29918
,20130515,14610,14635,14630,14635,14565,14565,14590,-70,-45,5870,"42,824.10",31986
,20130516,14565,14590,14585,14585,14525,14540,14540,-50,-50,6362,"46,267.48",33848
,20130517,14540,14540,14545,14600,14535,14580,14570,40,30,6300,"45,896.80",36590
,20130520,14580,14570,14565,14575,14530,14555,14555,-15,-15,4606,"33,521.78",37594
,20130521,14555,14555,14590,14615,14580,14610,14595,55,40,3272,"23,882.75",38076
,20130522,14610,14595,14590,14670,14590,14670,14635,75,40,5972,"43,701.56",39070
,20130523,14670,14635,14660,14660,14615,14615,14630,-20,-5,5862,"42,882.69",40472
,20130524,14615,14630,14625,14665,14625,14660,14640,30,10,5476,"40,090.10",42190
,20130527,14660,14640,14620,14660,14600,14610,14625,-30,-15,5690,"41,618.80",44466
,20130528,14610,14625,14610,14625,14580,14610,14595,-15,-30,7004,"51,124.01",45830
,20130529,14610,14595,14615,14640,14595,14640,14625,45,30,5020,"36,717.23",45772
,20130530,14640,14625,14655,14690,14645,14690,14665,65,40,8240,"60,432.40",46606
,20130531,14690,14665,14770,14845,14745,14840,14780,175,115,12216,"90,298.78",47146
,20130603,14840,14780,14845,14920,14815,14915,14875,135,95,10526,"78,297.04",49376
,20130604,14915,14875,14900,14905,14750,14860,14855,-15,-20,12638,"93,877.19",48752
,20130605,14860,14855,14895,14975,14870,14970,14910,115,55,13800,"102,891.46",47558
,20130606,14970,14910,14925,14975,14840,14910,14920,0,10,19252,"143,665.75",41714
,20130607,14910,14920,14945,14980,14900,14945,14940,25,20,12170,"90,928.45",39286
,20130613,14945,14940,14680,14800,14680,14705,14725,-235,-215,21956,"161,660.82",41748
,20130614,14705,14725,14700,14725,14660,14670,14695,-55,-30,9384,"68,958.17",43372
,20130617,14670,14695,14690,14715,14660,14660,14695,-35,0,5454,"40,074.27",44168
,20130618,14660,14695,14665,14675,14500,14500,14580,-195,-115,10314,"75,192.87",42668
,20130619,14500,14580,14515,14565,14510,14540,14530,-40,-50,5206,"37,828.94",42400
,20130620,14540,14530,14460,14470,14345,14370,14410,-160,-120,7886,"56,832.60",46148
,20130621,14370,14410,14340,14395,14210,14355,14335,-55,-75,6198,"44,436.97",45336
,20130624,14355,14335,14335,14345,14245,14270,14290,-65,-45,4410,"31,511.70",44774
,20130625,14270,14290,14270,14320,14195,14295,14265,5,-25,7112,"50,737.32",45272
,20130626,14295,14265,14385,14385,14230,14230,14270,-35,5,3498,"24,966.78",45502
,20130627,14230,14270,14250,14305,14250,14285,14270,15,0,1744,"12,446.05",45360
,20130628,14285,14270,14170,14260,14130,14230,14240,-40,-30,2444,"17,403.41",45006
,20130701,14230,14240,14250,14315,14230,14310,14285,70,45,4204,"30,030.46",43456
,20130702,14310,14285,14355,14395,14310,14370,14370,85,85,7690,"55,258.48",41582
,20130703,14370,14370,14360,14395,14360,14380,14375,10,5,3024,"21,739.53",41336
,20130704,14380,14375,14385,14385,14315,14335,14335,-40,-40,2738,"19,626.38",41484
,20130705,14335,14335,14340,14340,14300,14310,14305,-25,-30,1180,"8,442.56",41234
,20130708,14310,14305,14215,14250,14215,14225,14230,-80,-75,2322,"16,525.85",41474
,20130709,14225,14230,14260,14315,14245,14250,14275,20,45,3028,"21,614.07",40796
,20130710,14250,14275,14265,14285,14230,14275,14250,0,-25,3050,"21,734.99",39732
,20130711,14275,14250,14395,14455,14370,14415,14395,165,145,10158,"73,125.12",36228
,20130712,14415,14395,14415,14415,14340,14360,14360,-35,-35,2146,"15,410.17",35212
,20130715,14360,14360,14370,14380,14320,14340,14360,-20,0,3880,"27,861.27",33896
,20130716,14340,14360,14315,14350,14280,14345,14310,-15,-50,1144,"8,188.16",33498
,20130717,14345,14310,14315,14375,14310,14320,14335,10,25,1240,"8,889.32",33432
,20130718,14320,14335,14310,14350,14290,14305,14310,-30,-25,836,"5,982.52",33382
,20130719,14305,14310,14335,14360,14315,14350,14335,40,25,3720,"26,672.23",33086
,20130722,14350,14335,14380,14385,14365,14370,14375,35,40,1652,"11,876.59",32686
,20130723,14370,14375,14400,14420,14395,14400,14400,25,25,2724,"19,618.44",31552
,20130724,14400,14400,14440,14440,14360,14375,14375,-25,-25,1238,"8,898.70",31044
,20130725,14375,14375,14385,14415,14380,14410,14395,35,20,1888,"13,588.98",30298
,20130726,14410,14395,14385,14385,14350,14360,14370,-35,-25,556,"3,995.46",30138
,20130729,14360,14370,14335,14335,14255,14265,14295,-105,-75,2102,"15,026.96",29296
,20130730,14265,14295,14275,14285,14255,14255,14260,-40,-35,1164,"8,302.14",28814
,20130731,14255,14260,14150,14220,13800,14175,14180,-85,-80,3190,"22,622.41",28304
,20130801,14175,14180,14215,14280,14215,14275,14245,95,65,2026,"14,431.47",27398
,20130802,14275,14245,14245,14265,14240,14250,14250,5,5,1352,"9,635.98",26976
,20130805,14250,14250,14290,14290,14240,14260,14270,10,20,2140,"15,272.62",26702
,20130806,14260,14270,14240,14260,14235,14245,14245,-25,-25,966,"6,881.57",26652
,20130807,14245,14245,14260,14260,14195,14195,14210,-50,-35,1040,"7,391.16",26468
,20130808,14195,14210,14250,14270,14245,14265,14255,55,45,1276,"9,095.94",26290
,20130809,14265,14255,14360,14360,14305,14325,14315,70,60,3026,"21,662.24",25182
,20130812,14325,14315,14275,14400,13900,14395,14375,80,60,2538,"18,242.14",25254
,20130813,14395,14375,14420,14430,14380,14390,14400,15,25,2478,"17,847.30",24794
,20130814,14390,14400,14380,14380,14300,14330,14335,-70,-65,3362,"24,097.46",23894
,20130815,14330,14335,14385,14395,14370,14390,14380,55,45,2368,"17,026.58",23658
,20130816,14390,14380,14430,14445,14410,14435,14425,55,45,2950,"21,280.05",22972
,20130819,14435,14425,14480,14485,14455,14460,14465,35,40,1610,"11,646.46",22404
,20130820,14460,14465,14420,14430,14365,14370,14405,-95,-60,1202,"8,657.41",21534
,20130821,14370,14405,14380,14405,14380,14405,14395,0,-10,1352,"9,731.49",21012
,20130822,14405,14395,14365,14415,14365,14415,14395,20,0,2028,"14,597.69",20286
,20130823,14415,14395,14415,14415,14395,14415,14405,20,10,1438,"10,358.37",19546
,20130826,14415,14405,14430,14450,14430,14445,14440,40,35,1086,"7,841.49",18634
,20130827,14445,14440,14405,14420,14405,14420,14410,-20,-30,1786,"12,870.17",18210
,20130828,14420,14410,14410,14425,14390,14405,14410,-5,0,1884,"13,574.33",17020
,20130829,14405,14410,14405,14405,14350,14370,14365,-40,-45,2710,"19,471.11",16006
,20130830,14370,14365,14310,14310,14280,14300,14295,-65,-70,2500,"17,868.96",14880
,20130902,14300,14295,14270,14330,14270,14305,14285,10,-10,2530,"18,070.93",13690
,20130903,14305,14285,14310,14320,14290,14310,14300,25,15,1990,"14,228.83",12860
,20130904,14310,14300,14310,14320,14275,14310,14300,10,0,2260,"16,164.05",11890
,20130905,14310,14300,14265,14270,14220,14250,14230,-50,-70,3920,"27,898.33",8750
,20130906,14250,14230,14230,14320,14205,14320,14255,90,25,1690,"12,049.28",8160
,20130909,14320,14255,14300,14330,14300,14330,14320,75,65,2220,"15,897.15",7620
,20130910,14330,14320,14290,14370,14290,14320,14315,0,-5,2110,"15,107.20",7630
,20130911,14320,14315,14320,14340,14320,14340,14330,25,15,2400,"17,197.53",6910
,20130912,14340,14330,14330,14350,14330,14350,14340,20,10,770,"5,520.93",6260
,20130913,14350,14340,14275,14425,14275,14425,14345,85,5,2400,"17,216.53",4640
,20130916,14425,14345,14400,14440,14350,14420,14405,75,60,1690,"12,174.55",3590
al1310,20130104,15880,15880,,,,15880,15880,0,0,0,0,68
,20130107,15880,15880,,,,15880,15880,0,0,0,0,68
,20130108,15880,15880,,,,15880,15880,0,0,0,0,68
,20130109,15880,15880,,,,15880,15880,0,0,0,0,68
,20130110,15880,15880,15860,15860,15800,15800,15805,-80,-75,278,"2,197.49",264
,20130111,15800,15805,15810,15810,15810,15810,15810,5,5,2,15.81,266
,20130114,15810,15810,15785,15785,15775,15775,15780,-35,-30,4,31.56,270
,20130115,15775,15780,15700,15700,15640,15640,15645,-140,-135,30,234.68,276
,20130116,15640,15645,15610,15730,15610,15730,15670,85,25,20,156.7,276
,20130117,15730,15670,15690,15690,15690,15690,15690,20,20,8,62.76,284
,20130118,15690,15690,15630,15785,15630,15780,15705,90,15,8,62.83,282
,20130121,15780,15705,15690,15690,15690,15690,15690,-15,-15,6,47.07,282
,20130122,15690,15690,,,,15690,15690,0,0,0,0,282
,20130123,15690,15690,,,,15690,15690,0,0,0,0,282
,20130124,15690,15690,,,,15690,15690,0,0,0,0,282
,20130125,15690,15690,,,,15695,15695,5,5,0,0,282
,20130128,15695,15695,15660,15660,15660,15660,15660,-35,-35,2,15.66,284
,20130129,15660,15660,15700,15700,15680,15680,15690,20,30,24,188.33,308
,20130130,15680,15690,15705,15745,15690,15710,15695,20,5,84,659.33,320
,20130131,15710,15695,15765,15830,15765,15810,15805,115,110,86,679.63,378
,20130201,15810,15805,15730,15730,15730,15730,15730,-75,-75,4,31.46,382
,20130204,15730,15730,15760,15770,15745,15770,15755,40,25,52,409.65,378
,20130205,15770,15755,,,,15750,15750,-5,-5,0,0,378
,20130206,15750,15750,15750,15750,15700,15700,15700,-50,-50,28,219.85,372
,20130207,15700,15700,15670,15670,15670,15670,15670,-30,-30,14,109.69,376
,20130208,15670,15670,,,,15670,15670,0,0,0,0,376
,20130218,15670,15670,,,,15625,15625,-45,-45,0,0,376
,20130219,15625,15625,,,,15625,15625,0,0,0,0,376
,20130220,15625,15625,15520,15610,15520,15610,15600,-15,-25,18,140.4,392
,20130221,15610,15600,15335,15440,15335,15420,15415,-180,-185,94,724.6,434
,20130222,15420,15415,,,,15405,15405,-10,-10,0,0,434
,20130225,15405,15405,15250,15310,15250,15290,15285,-115,-120,86,657.27,454
,20130226,15290,15285,15240,15290,15240,15270,15270,-15,-15,26,198.51,456
,20130227,15270,15270,15290,15290,15290,15290,15290,20,20,2,15.29,454
,20130228,15290,15290,15215,15245,15215,15245,15230,-45,-60,4,30.46,456
,20130301,15245,15230,15200,15200,15055,15055,15105,-175,-125,28,211.51,476
,20130304,15055,15105,15075,15075,14880,14910,14925,-195,-180,102,761.32,530
,20130305,14910,14925,14930,15040,14930,15040,14985,115,60,4,29.97,528
,20130306,15040,14985,15040,15120,15040,15105,15080,120,95,72,542.9,526
,20130307,15105,15080,14885,15245,14885,15190,15215,110,135,268,"2,039.41",696
,20130308,15190,15215,15235,15235,15180,15190,15205,-25,-10,116,882.11,748
,20130311,15190,15205,15205,15205,15165,15165,15185,-40,-20,20,151.88,748
,20130312,15165,15185,15170,15170,15120,15120,15155,-65,-30,14,106.09,750
,20130313,15120,15155,15170,15185,15170,15185,15175,30,20,24,182.13,740
,20130314,15185,15175,15130,15130,15065,15100,15085,-75,-90,96,724.31,740
,20130315,15100,15085,,,,15085,15085,0,0,0,0,740
,20130318,15085,15085,14990,14990,14930,14930,14945,-155,-140,40,298.98,746
,20130319,14930,14945,14965,14980,14880,14880,14910,-65,-35,56,417.51,782
,20130320,14880,14910,14940,14940,14925,14940,14925,30,15,34,253.77,782
,20130321,14940,14925,,,,14925,14925,0,0,0,0,782
,20130322,14925,14925,14940,14940,14900,14900,14915,-25,-10,86,641.54,802
,20130325,14900,14915,14930,14950,14930,14930,14935,15,20,50,373.44,832
,20130326,14930,14935,14890,14890,14880,14880,14880,-55,-55,72,535.83,888
,20130327,14880,14880,14850,14850,14850,14850,14850,-30,-30,2,14.85,888
,20130328,14850,14850,14850,14850,14810,14810,14830,-40,-20,4,29.66,892
,20130329,14810,14830,14800,14830,14800,14800,14805,-30,-25,30,222.09,898
,20130401,14800,14805,14740,14790,14740,14770,14765,-35,-40,304,"2,244.58",1182
,20130402,14770,14765,14770,14890,14760,14825,14770,60,5,734,"5,421.00",1582
,20130403,14825,14770,14880,14880,14720,14720,14760,-50,-10,208,"1,535.37",1710
,20130408,14720,14760,14720,14780,14720,14780,14740,20,-20,784,"5,779.59",2064
,20130409,14780,14740,14800,14805,14800,14800,14800,60,60,204,"1,509.61",2266
,20130410,14800,14800,14820,14820,14810,14810,14810,10,10,26,192.56,2286
,20130411,14810,14810,14840,14940,14840,14875,14860,65,50,544,"4,042.71",2556
,20130412,14875,14860,14850,14870,14850,14860,14850,0,-10,484,"3,594.32",2952
,20130415,14860,14850,14765,14765,14600,14620,14675,-230,-175,496,"3,640.28",3118
,20130416,14620,14675,14600,14740,14600,14700,14625,25,-50,986,"7,211.03",3800
,20130417,14700,14625,14710,14730,14645,14645,14670,20,45,368,"2,699.99",3926
,20130418,14645,14670,14600,14610,14120,14580,14510,-90,-160,1672,"12,130.43",4718
,20130419,14580,14510,14645,14655,14590,14640,14615,130,105,496,"3,624.71",4976
,20130422,14640,14615,14630,14635,14590,14595,14610,-20,-5,488,"3,565.25",4974
,20130423,14595,14610,14605,14630,14580,14585,14600,-25,-10,356,"2,598.80",4886
,20130424,14585,14600,14635,14700,14625,14650,14650,50,50,206,"1,508.97",5012
,20130425,14650,14650,14655,14710,14650,14710,14660,60,10,622,"4,560.43",5386
,20130426,14710,14660,14710,14735,14660,14680,14705,20,45,852,"6,266.09",5806
,20130502,14680,14705,14510,14510,14400,14505,14455,-200,-250,2948,"21,313.37",7726
,20130503,14505,14455,14480,14575,14470,14560,14530,105,75,464,"3,371.45",7848
,20130506,14560,14530,14645,14700,14630,14665,14660,135,130,1976,"14,486.88",7680
,20130507,14665,14660,14655,14690,14640,14640,14655,-20,-5,2066,"15,138.84",6920
,20130508,14640,14655,14655,14745,14650,14735,14690,80,35,1554,"11,416.93",6876
,20130509,14735,14690,14725,14730,14695,14705,14705,15,15,1796,"13,206.68",7384
,20130510,14705,14705,14690,14775,14680,14745,14705,40,0,866,"6,368.55",7646
,20130513,14745,14705,14730,14730,14685,14685,14700,-20,-5,1074,"7,894.09",8134
,20130514,14685,14700,14690,14710,14635,14635,14670,-65,-30,778,"5,707.51",8574
,20130515,14635,14670,14665,14665,14560,14565,14600,-105,-70,1832,"13,376.40",9450
,20130516,14565,14600,14625,14625,14545,14550,14555,-50,-45,2238,"16,290.95",10838
,20130517,14550,14555,14575,14610,14550,14585,14575,30,20,702,"5,116.07",11102
,20130520,14585,14575,14570,14590,14550,14555,14560,-20,-15,1746,"12,714.16",12288
,20130521,14555,14560,14595,14620,14590,14620,14600,60,40,1242,"9,068.95",12276
,20130522,14620,14600,14605,14680,14605,14675,14640,75,40,1394,"10,207.20",12218
,20130523,14675,14640,14660,14660,14620,14620,14640,-20,0,2302,"16,850.90",12486
,20130524,14620,14640,14615,14665,14615,14655,14645,15,5,2308,"16,902.50",13604
,20130527,14655,14645,14635,14660,14595,14615,14615,-30,-30,2718,"19,868.06",15468
,20130528,14615,14615,14600,14620,14580,14605,14595,-10,-20,3634,"26,522.83",17610
,20130529,14605,14595,14600,14640,14600,14635,14625,40,30,1320,"9,655.72",17952
,20130530,14635,14625,14640,14680,14640,14680,14665,55,40,2730,"20,022.18",18754
,20130531,14680,14665,14740,14870,14740,14860,14795,195,130,10962,"81,107.77",21876
,20130603,14860,14795,14875,14935,14820,14930,14880,135,85,6706,"49,905.41",23116
,20130604,14930,14880,14910,14910,14775,14875,14855,-5,-25,4396,"32,660.16",23382
,20130605,14875,14855,14920,14990,14880,14990,14925,135,70,9142,"68,227.24",25454
,20130606,14990,14925,14925,14970,14855,14905,14915,-20,-10,10700,"79,817.34",27598
,20130607,14905,14915,14925,14970,14900,14955,14940,40,25,9684,"72,350.81",26900
,20130613,14955,14940,14745,14790,14660,14700,14725,-240,-215,20774,"152,988.10",36588
,20130614,14700,14725,14700,14725,14655,14655,14685,-70,-40,11098,"81,505.90",39082
,20130617,14655,14685,14665,14710,14660,14680,14685,-5,0,6012,"44,150.21",40706
,20130618,14680,14685,14660,14665,14490,14500,14550,-185,-135,21788,"158,548.11",49938
,20130619,14500,14550,14550,14550,14505,14525,14520,-25,-30,14362,"104,273.35",55166
,20130620,14525,14520,14460,14465,14350,14360,14405,-160,-115,16400,"118,138.55",60652
,20130621,14360,14405,14280,14400,14220,14365,14325,-40,-80,14396,"103,138.33",63710
,20130624,14365,14325,14325,14345,14235,14255,14285,-70,-40,10426,"74,482.06",66964
,20130625,14255,14285,14300,14335,14180,14305,14260,20,-25,12164,"86,738.16",68396
,20130626,14305,14260,14330,14330,14230,14240,14260,-20,0,8442,"60,211.33",69866
,20130627,14240,14260,14245,14320,14240,14290,14270,30,10,6712,"47,904.31",70448
,20130628,14290,14270,14240,14260,14160,14215,14230,-55,-40,4964,"35,330.72",71750
,20130701,14215,14230,14230,14320,14210,14315,14290,85,60,6548,"46,793.75",72754
,20130702,14315,14290,14365,14395,14260,14360,14355,70,65,13740,"98,648.59",69090
,20130703,14360,14355,14345,14390,14345,14390,14370,35,15,6442,"46,296.34",67764
,20130704,14390,14370,14325,14350,14310,14330,14330,-40,-40,4190,"30,021.52",68284
,20130705,14330,14330,14335,14340,14280,14300,14295,-30,-35,4532,"32,400.63",69242
,20130708,14300,14295,14200,14250,14200,14200,14220,-95,-75,7356,"52,305.90",72766
,20130709,14200,14220,14260,14300,14225,14225,14260,5,40,6672,"47,579.20",72968
,20130710,14225,14260,14230,14270,14200,14260,14235,0,-25,6192,"44,073.83",73118
,20130711,14260,14235,14390,14445,14350,14400,14385,165,150,18096,"130,161.68",70684
,20130712,14400,14385,14390,14390,14320,14330,14350,-55,-35,5490,"39,391.29",69464
,20130715,14330,14350,14350,14370,14305,14345,14355,-5,5,6060,"43,503.64",69160
,20130716,14345,14355,14315,14355,14270,14340,14310,-15,-45,6650,"47,597.10",67520
,20130717,14340,14310,14325,14375,14295,14310,14330,0,20,3788,"27,141.71",67456
,20130718,14310,14330,14305,14350,14285,14295,14310,-35,-20,4118,"29,467.97",66566
,20130719,14295,14310,14315,14350,14310,14345,14330,35,20,2990,"21,426.31",66782
,20130722,14345,14330,14370,14385,14360,14375,14370,45,40,3746,"26,919.90",65564
,20130723,14375,14370,14420,14445,14390,14415,14400,45,30,5896,"42,462.87",64830
,20130724,14415,14400,14415,14415,14360,14380,14375,-20,-25,2570,"18,472.50",64700
,20130725,14380,14375,14375,14415,14375,14400,14390,25,15,4804,"34,576.04",64920
,20130726,14400,14390,14400,14400,14345,14360,14365,-30,-25,2584,"18,560.17",64538
,20130729,14360,14365,14275,14320,14250,14260,14290,-105,-75,5292,"37,815.16",63886
,20130730,14260,14290,14280,14280,14250,14255,14260,-35,-30,5398,"38,497.52",63732
,20130731,14255,14260,14210,14230,14140,14170,14195,-90,-65,5950,"42,241.10",63448
,20130801,14170,14195,14200,14270,14200,14270,14245,75,50,5846,"41,643.71",61876
,20130802,14270,14245,14290,14290,14230,14240,14250,-5,5,2720,"19,382.95",61072
,20130805,14240,14250,14260,14270,14240,14240,14255,-10,5,3444,"24,549.66",59450
,20130806,14240,14255,14245,14250,14210,14235,14235,-20,-20,2410,"17,155.34",59002
,20130807,14235,14235,14210,14220,14195,14200,14205,-35,-30,2902,"20,611.46",58172
,20130808,14200,14205,14200,14285,14200,14250,14255,45,50,5050,"35,995.45",57480
,20130809,14250,14255,14300,14340,14300,14335,14325,80,70,8458,"60,583.95",55980
,20130812,14335,14325,14410,14430,14385,14420,14395,95,70,10560,"76,017.51",54966
,20130813,14420,14395,14450,14460,14410,14425,14435,30,40,10488,"75,719.48",53032
,20130814,14425,14435,14435,14435,14345,14370,14375,-65,-60,7186,"51,654.65",50762
,20130815,14370,14375,14400,14440,14400,14435,14420,60,45,5668,"40,875.21",50158
,20130816,14435,14420,14455,14490,14450,14475,14475,55,55,7204,"52,140.07",48616
,20130819,14475,14475,14530,14590,14480,14495,14515,20,40,9472,"68,760.27",44250
,20130820,14495,14515,14455,14470,14400,14405,14450,-110,-65,2814,"20,336.49",42726
,20130821,14405,14450,14435,14440,14415,14440,14420,-10,-30,2940,"21,203.60",40542
,20130822,14440,14420,14395,14445,14390,14440,14415,20,-5,2628,"18,947.52",40222
,20130823,14440,14415,14400,14445,14400,14445,14425,30,10,2486,"17,935.69",39256
,20130826,14445,14425,14485,14485,14460,14465,14470,40,45,3366,"24,353.63",38716
,20130827,14465,14470,14455,14460,14430,14430,14440,-40,-30,1960,"14,151.55",38230
,20130828,14430,14440,14410,14445,14410,14425,14430,-15,-10,2070,"14,935.35",38274
,20130829,14425,14430,14420,14420,14350,14350,14375,-80,-55,2692,"19,354.76",36586
,20130830,14350,14375,14310,14310,14265,14280,14295,-95,-80,2602,"18,600.78",35470
,20130902,14280,14295,14300,14315,14260,14305,14280,10,-15,2836,"20,251.58",35604
,20130903,14305,14280,14300,14310,14275,14290,14285,10,5,2272,"16,231.36",35410
,20130904,14290,14285,14280,14290,14255,14255,14275,-30,-10,2630,"18,774.21",36288
,20130905,14255,14275,14215,14225,14195,14205,14210,-70,-65,2898,"20,592.21",35540
,20130906,14205,14210,14200,14255,14185,14245,14215,35,5,2426,"17,247.88",35258
,20130909,14245,14215,14250,14290,14250,14290,14265,75,50,1486,"10,602.25",34990
,20130910,14290,14265,14250,14250,14230,14245,14235,-20,-30,3400,"24,207.07",34304
,20130911,14245,14235,14255,14260,14245,14260,14250,25,15,1734,"12,357.57",34202
,20130912,14260,14250,14235,14260,14235,14255,14250,5,0,1178,"8,393.48",34438
,20130913,14255,14250,14230,14330,14230,14330,14285,80,35,3252,"23,228.17",35124
,20130916,14330,14285,14310,14350,14300,14310,14320,25,35,3724,"26,664.56",34898
,20130917,14310,14320,14300,14310,14240,14310,14275,-10,-45,3516,"25,096.65",32656
,20130918,14310,14275,14295,14320,14290,14320,14300,45,25,3890,"27,815.75",30544
,20130923,14320,14300,14305,14350,14300,14350,14330,50,30,3962,"28,389.60",28288
,20130924,14350,14330,14370,14390,14355,14390,14380,60,50,2924,"21,023.99",26228
,20130925,14390,14380,14380,14395,14370,14390,14385,10,5,3358,"24,154.81",23628
,20130926,14390,14385,14380,14430,14360,14430,14385,45,0,3110,"22,375.41",22184
,20130927,14430,14385,14410,14440,14350,14440,14425,55,40,4980,"35,921.21",19128
,20130930,14440,14425,14430,14450,14420,14450,14430,25,5,4188,"30,225.62",17528
,20131008,14450,14430,14485,14520,14430,14515,14500,85,70,2878,"20,866.18",15740
,20131009,14515,14500,14565,14580,14540,14580,14555,80,55,3110,"22,637.53",14690
,20131010,14580,14555,14570,14650,14565,14565,14580,10,25,5010,"36,534.85",13800
,20131011,14565,14580,14620,14640,14570,14620,14620,40,40,2260,"16,523.73",12520
,20131014,14620,14620,14620,14630,14550,14550,14600,-70,-20,2970,"21,684.10",10720
,20131015,14550,14600,14555,14555,14400,14415,14450,-185,-150,2590,"18,714.75",9830
al1311,20130104,16045,16045,,,,16045,16045,0,0,0,0,16
,20130107,16045,16045,,,,16045,16045,0,0,0,0,16
,20130108,16045,16045,,,,16000,16000,-45,-45,0,0,16
,20130109,16000,16000,15840,15840,15840,15840,15840,-160,-160,4,31.68,16
,20130110,15840,15840,,,,15840,15840,0,0,0,0,16
,20130111,15840,15840,,,,15840,15840,0,0,0,0,16
,20130114,15840,15840,,,,15805,15805,-35,-35,0,0,16
,20130115,15805,15805,,,,15805,15805,0,0,0,0,16
,20130116,15805,15805,,,,15805,15805,0,0,0,0,16
,20130117,15805,15805,15800,15800,15800,15800,15800,-5,-5,8,63.2,24
,20130118,15800,15800,,,,15815,15815,15,15,0,0,24
,20130121,15815,15815,,,,15815,15815,0,0,0,0,24
,20130122,15815,15815,,,,15815,15815,0,0,0,0,24
,20130123,15815,15815,,,,15825,15825,10,10,0,0,24
,20130124,15825,15825,,,,15825,15825,0,0,0,0,24
,20130125,15825,15825,,,,15830,15830,5,5,0,0,24
,20130128,15830,15830,,,,15830,15830,0,0,0,0,24
,20130129,15830,15830,,,,15830,15830,0,0,0,0,24
,20130130,15830,15830,,,,15830,15830,0,0,0,0,24
,20130131,15830,15830,15905,15905,15905,15905,15905,75,75,2,15.91,26
,20130201,15905,15905,15855,15855,15855,15855,15855,-50,-50,2,15.86,26
,20130204,15855,15855,,,,15880,15880,25,25,0,0,26
,20130205,15880,15880,,,,15785,15785,-95,-95,0,0,26
,20130206,15785,15785,,,,15735,15735,-50,-50,0,0,26
,20130207,15735,15735,,,,15700,15700,-35,-35,0,0,26
,20130208,15700,15700,,,,15700,15700,0,0,0,0,26
,20130218,15700,15700,,,,15655,15655,-45,-45,0,0,26
,20130219,15655,15655,,,,15565,15565,-90,-90,0,0,26
,20130220,15565,15565,15640,15640,15625,15625,15630,60,65,10,78.17,30
,20130221,15625,15630,15535,15535,15465,15465,15515,-165,-115,8,62.07,32
,20130222,15465,15515,15525,15525,15515,15515,15520,0,5,4,31.04,32
,20130225,15515,15520,15360,15370,15360,15370,15365,-150,-155,4,30.73,32
,20130226,15370,15365,15395,15395,15395,15395,15395,30,30,2,15.4,34
,20130227,15395,15395,15325,15325,15325,15325,15325,-70,-70,2,15.33,32
,20130228,15325,15325,,,,15260,15260,-65,-65,0,0,32
,20130301,15260,15260,15200,15200,15200,15200,15200,-60,-60,40,304,72
,20130304,15200,15200,15050,15050,15000,15000,15040,-200,-160,12,90.25,76
,20130305,15000,15040,15005,15080,15005,15080,15045,40,5,10,75.23,74
,20130306,15080,15045,15130,15130,15130,15130,15130,85,85,2,15.13,72
,20130307,15130,15130,15200,15300,15200,15290,15280,160,150,24,183.4,94
,20130308,15290,15280,15280,15280,15280,15280,15280,0,0,20,152.8,94
,20130311,15280,15280,,,,15270,15270,-10,-10,0,0,94
,20130312,15270,15270,,,,15270,15270,0,0,0,0,94
,20130313,15270,15270,,,,15270,15270,0,0,0,0,94
,20130314,15270,15270,15130,15180,15130,15180,15140,-90,-130,26,196.84,94
,20130315,15180,15140,,,,15135,15135,-5,-5,0,0,94
,20130318,15135,15135,15040,15040,15040,15040,15040,-95,-95,6,45.12,100
,20130319,15040,15040,14995,15005,14995,15005,15000,-35,-40,14,105.02,114
,20130320,15005,15000,14995,15000,14990,15000,14995,0,-5,76,569.87,134
,20130321,15000,14995,,,,14995,14995,0,0,0,0,134
,20130322,14995,14995,,,,14995,14995,0,0,0,0,134
,20130325,14995,14995,,,,14995,14995,0,0,0,0,134
,20130326,14995,14995,14950,14950,14950,14950,14950,-45,-45,2,14.95,136
,20130327,14950,14950,14940,14940,14900,14900,14910,-50,-40,6,44.74,136
,20130328,14900,14910,14870,14870,14870,14870,14870,-40,-40,2,14.87,138
,20130329,14870,14870,14825,14860,14825,14860,14840,-10,-30,4,29.69,140
,20130401,14860,14840,14840,14870,14790,14810,14815,-30,-25,150,"1,111.43",190
,20130402,14810,14815,14850,14850,14815,14840,14820,25,5,20,148.24,192
,20130403,14840,14820,14870,14870,14750,14800,14830,-20,10,318,"2,358.63",482
,20130408,14800,14830,14770,14790,14770,14790,14780,-40,-50,40,295.6,508
,20130409,14790,14780,14820,14870,14820,14870,14860,90,80,14,104.03,518
,20130410,14870,14860,14900,14900,14900,14900,14900,40,40,22,163.9,516
,20130411,14900,14900,14915,14990,14915,14930,14955,30,55,36,269.19,514
,20130412,14930,14955,,,,14955,14955,0,0,0,0,514
,20130415,14955,14955,14800,14800,14650,14680,14750,-275,-205,382,"2,817.33",776
,20130416,14680,14750,14700,14745,14675,14745,14685,-5,-65,38,279.11,756
,20130417,14745,14685,14780,14780,14720,14720,14755,35,70,12,88.55,758
,20130418,14720,14755,14695,14695,14360,14610,14565,-145,-190,452,"3,292.63",906
,20130419,14610,14565,14675,14695,14610,14670,14655,105,90,372,"2,726.55",962
,20130422,14670,14655,14655,14655,14625,14625,14645,-30,-10,292,"2,138.60",1072
,20130423,14625,14645,14615,14625,14600,14620,14610,-25,-35,814,"5,946.65",1744
,20130424,14620,14610,14655,14690,14630,14660,14655,50,45,842,"6,171.54",2116
,20130425,14660,14655,14690,14720,14660,14700,14680,45,25,1754,"12,877.35",2966
,20130426,14700,14680,14700,14780,14670,14675,14720,-5,40,2592,"19,079.94",5124
,20130502,14675,14720,14520,14520,14350,14500,14470,-220,-250,1002,"7,251.22",5614
,20130503,14500,14470,14510,14580,14470,14575,14505,105,35,52,377.19,5618
,20130506,14575,14505,14700,14715,14650,14675,14670,170,165,924,"6,778.31",5916
,20130507,14675,14670,14655,14715,14650,14650,14680,-20,10,1202,"8,825.15",6064
,20130508,14650,14680,14695,14750,14690,14750,14705,70,25,448,"3,294.40",6360
,20130509,14750,14705,14750,14750,14710,14715,14720,10,15,656,"4,829.46",6844
,20130510,14715,14720,14695,14770,14695,14770,14725,50,5,200,"1,472.61",6858
,20130513,14770,14725,14725,14730,14710,14730,14720,5,-5,82,603.59,6906
,20130514,14730,14720,14700,14700,14655,14655,14670,-65,-50,16,117.38,6908
,20130515,14655,14670,14630,14630,14600,14600,14610,-70,-60,16,116.92,6906
,20130516,14600,14610,14590,14590,14565,14570,14580,-40,-30,762,"5,555.71",7378
,20130517,14570,14580,14575,14610,14575,14610,14595,30,15,144,"1,050.91",7456
,20130520,14610,14595,14580,14580,14580,14580,14580,-15,-15,26,189.54,7456
,20130521,14580,14580,14595,14615,14595,14615,14610,35,30,16,116.9,7458
,20130522,14615,14610,14640,14670,14640,14670,14650,60,40,20,146.54,7460
,20130523,14670,14650,14670,14670,14640,14640,14640,-10,-10,34,248.93,7458
,20130524,14640,14640,14650,14665,14650,14665,14650,25,10,28,205.14,7460
,20130527,14665,14650,14655,14670,14610,14610,14635,-40,-15,262,"1,917.29",7658
,20130528,14610,14635,14595,14620,14595,14615,14595,-20,-40,1182,"8,628.24",8302
,20130529,14615,14595,14610,14650,14610,14650,14630,55,35,130,951.11,8358
,20130530,14650,14630,14675,14695,14670,14695,14675,65,45,190,"1,394.47",8414
,20130531,14695,14675,14780,14865,14780,14865,14815,190,140,306,"2,267.28",8432
,20130603,14865,14815,14905,14950,14860,14945,14900,130,85,678,"5,052.64",8234
,20130604,14945,14900,14900,14910,14855,14890,14870,-10,-30,456,"3,391.24",8182
,20130605,14890,14870,14910,15000,14900,15000,14960,130,90,112,838.03,8100
,20130606,15000,14960,14960,14975,14880,14910,14935,-50,-25,900,"6,722.25",8352
,20130607,14910,14935,14915,15000,14915,14950,14965,15,30,1810,"13,546.55",9206
,20130613,14950,14965,14700,14805,14700,14720,14765,-245,-200,2050,"15,138.07",9788
,20130614,14720,14765,14710,14720,14665,14665,14695,-100,-70,3282,"24,115.65",10936
,20130617,14665,14695,14680,14710,14670,14675,14685,-20,-10,2258,"16,580.67",11892
,20130618,14675,14685,14665,14665,14500,14510,14560,-175,-125,8760,"63,792.93",17496
,20130619,14510,14560,14505,14535,14500,14530,14520,-30,-40,4552,"33,055.81",19378
,20130620,14530,14520,14495,14495,14360,14370,14405,-150,-115,5552,"40,001.37",22604
,20130621,14370,14405,14305,14405,14255,14345,14340,-60,-65,6458,"46,305.49",25524
,20130624,14345,14340,14330,14335,14230,14260,14280,-80,-60,5004,"35,734.40",27900
,20130625,14260,14280,14260,14320,14195,14305,14265,25,-15,4626,"32,995.92",29220
,20130626,14305,14265,14310,14310,14235,14245,14260,-20,-5,4750,"33,875.41",31656
,20130627,14245,14260,14225,14305,14225,14285,14270,25,10,2530,"18,057.41",32300
,20130628,14285,14270,14215,14260,14200,14225,14235,-45,-35,3044,"21,669.84",33922
,20130701,14225,14235,14205,14320,14205,14320,14285,85,50,2766,"19,759.20",34998
,20130702,14320,14285,14400,14400,14305,14360,14365,75,80,6312,"45,347.31",36966
,20130703,14360,14365,14360,14390,14355,14390,14370,25,5,3340,"23,998.20",37274
,20130704,14390,14370,14360,14360,14310,14330,14330,-40,-40,3092,"22,155.47",38146
,20130705,14330,14330,14335,14345,14285,14295,14290,-35,-40,3324,"23,758.16",39176
,20130708,14295,14290,14260,14260,14195,14195,14220,-95,-70,3932,"27,962.15",41028
,20130709,14195,14220,14260,14285,14220,14225,14250,5,30,3416,"24,343.73",41334
,20130710,14225,14250,14230,14265,14200,14250,14235,0,-15,1392,"9,907.80",41358
,20130711,14250,14235,14370,14420,14335,14395,14375,160,140,10350,"74,400.84",41450
,20130712,14395,14375,14395,14395,14310,14330,14335,-45,-40,2620,"18,785.29",42152
,20130715,14330,14335,14345,14370,14330,14355,14350,20,15,3450,"24,760.75",41908
,20130716,14355,14350,14325,14350,14270,14345,14315,-5,-35,4364,"31,241.55",42554
,20130717,14345,14315,14320,14380,14300,14310,14335,-5,20,4376,"31,373.61",44122
,20130718,14310,14335,14300,14345,14285,14300,14305,-35,-30,3364,"24,066.43",45552
,20130719,14300,14305,14335,14345,14305,14335,14330,30,25,3780,"27,086.46",46238
,20130722,14335,14330,14380,14385,14355,14375,14370,45,40,4284,"30,783.11",45550
,20130723,14375,14370,14410,14415,14375,14405,14400,35,30,3676,"26,468.52",44998
,20130724,14405,14400,14415,14415,14355,14375,14370,-25,-30,3512,"25,241.12",44934
,20130725,14375,14370,14400,14410,14375,14400,14390,30,20,4276,"30,766.28",43350
,20130726,14400,14390,14360,14375,14340,14355,14355,-35,-35,4628,"33,223.69",44312
,20130729,14355,14355,14285,14320,14245,14255,14280,-100,-75,7256,"51,824.90",46190
,20130730,14255,14280,14255,14285,14245,14250,14260,-30,-20,4574,"32,617.59",46966
,20130731,14250,14260,14215,14230,14140,14160,14190,-100,-70,14376,"102,020.25",51590
,20130801,14160,14190,14200,14265,14200,14265,14240,75,50,8928,"63,580.18",50646
,20130802,14265,14240,14265,14275,14230,14240,14245,0,5,5056,"36,019.97",49590
,20130805,14240,14245,14260,14275,14240,14240,14255,-5,10,4982,"35,509.36",50354
,20130806,14240,14255,14245,14255,14220,14225,14230,-30,-25,3754,"26,717.32",51504
,20130807,14225,14230,14195,14230,14190,14195,14200,-35,-30,6918,"49,121.70",53678
,20130808,14195,14200,14230,14285,14230,14255,14250,55,50,10626,"75,734.28",53300
,20130809,14255,14250,14360,14360,14305,14330,14325,80,75,12530,"89,766.70",50554
,20130812,14330,14325,14400,14425,14380,14425,14395,100,70,10702,"77,042.86",50168
,20130813,14425,14395,14425,14450,14405,14425,14430,30,35,7954,"57,391.93",50636
,20130814,14425,14430,14405,14430,14340,14365,14375,-65,-55,7698,"55,336.30",48312
,20130815,14365,14375,14405,14445,14400,14435,14425,60,50,9294,"67,050.61",47892
,20130816,14435,14425,14465,14495,14460,14475,14475,50,50,13166,"95,309.57",49626
,20130819,14475,14475,14550,14550,14505,14510,14520,35,45,20840,"151,332.88",48910
,20130820,14510,14520,14465,14480,14400,14415,14445,-105,-75,6582,"47,544.38",48048
,20130821,14415,14445,14450,14450,14415,14435,14425,-10,-20,3536,"25,509.31",47438
,20130822,14435,14425,14400,14440,14390,14440,14420,15,-5,3538,"25,511.24",46664
,20130823,14440,14420,14410,14460,14410,14450,14430,30,10,3110,"22,444.66",46158
,20130826,14450,14430,14445,14500,14445,14485,14480,55,50,4168,"30,179.20",45422
,20130827,14485,14480,14460,14465,14435,14455,14445,-25,-35,1986,"14,347.00",45110
,20130828,14455,14445,14435,14460,14410,14425,14435,-20,-10,2688,"19,400.80",44362
,20130829,14425,14435,14420,14420,14350,14350,14380,-85,-55,4164,"29,941.50",43038
,20130830,14350,14380,14365,14365,14265,14270,14295,-110,-85,7004,"50,073.74",41854
,20130902,14270,14295,14300,14325,14255,14300,14280,5,-15,5020,"35,844.58",40976
,20130903,14300,14280,14315,14315,14270,14280,14280,0,0,4400,"31,416.08",39966
,20130904,14280,14280,14280,14285,14250,14255,14275,-25,-5,1918,"13,691.42",39816
,20130905,14255,14275,14230,14230,14180,14180,14200,-95,-75,5876,"41,724.93",39610
,20130906,14180,14200,14225,14225,14150,14225,14190,25,-10,1992,"14,134.98",38986
,20130909,14225,14190,14220,14260,14220,14260,14245,70,55,1894,"13,490.91",38528
,20130910,14260,14245,14230,14230,14195,14205,14200,-40,-45,2392,"16,986.65",37826
,20130911,14205,14200,14215,14225,14200,14215,14215,15,15,1260,"8,956.53",37590
,20130912,14215,14215,14210,14220,14195,14200,14205,-15,-10,1392,"9,887.03",37468
,20130913,14200,14205,14200,14265,14190,14260,14245,55,40,3318,"23,633.57",37848
,20130916,14260,14245,14250,14270,14225,14225,14245,-20,0,2076,"14,789.97",37534
,20130917,14225,14245,14200,14205,14125,14180,14170,-65,-75,2812,"19,924.34",37422
,20130918,14180,14170,14190,14215,14190,14215,14200,45,30,1646,"11,687.30",37428
,20130923,14215,14200,14215,14250,14195,14245,14220,45,20,2860,"20,337.60",37444
,20130924,14245,14220,14265,14290,14260,14290,14275,70,55,3284,"23,440.28",36686
,20130925,14290,14275,14255,14290,14255,14280,14275,5,0,1886,"13,465.66",36452
,20130926,14280,14275,14275,14320,14250,14320,14285,45,10,2590,"18,499.22",36058
,20130927,14320,14285,14315,14345,14315,14330,14325,45,40,2410,"17,263.60",35250
,20130930,14330,14325,14340,14375,13610,14305,14355,-20,30,4956,"35,578.03",34292
,20131008,14305,14355,14390,14420,14385,14420,14400,65,45,2706,"19,484.16",33378
,20131009,14420,14400,14415,14450,14410,14430,14430,30,30,1498,"10,810.58",33112
,20131010,14430,14430,14425,14450,14420,14420,14430,-10,0,1680,"12,123.62",33102
,20131011,14420,14430,14450,14540,14450,14500,14500,70,70,6202,"44,969.43",31366
,20131014,14500,14500,14510,14520,14475,14500,14500,0,0,3134,"22,727.16",30886
,20131015,14500,14500,14520,14520,14400,14440,14430,-60,-70,3876,"27,973.75",30432
,20131016,14440,14430,14400,14445,14365,14445,14380,15,-50,2610,"18,770.78",30044
,20131017,14445,14380,14435,14445,14400,14445,14415,65,35,4158,"29,971.26",29322
,20131018,14445,14415,14440,14450,14420,14450,14435,35,20,2452,"17,698.08",29920
,20131021,14450,14435,14420,14460,14420,14460,14435,25,0,1500,"10,826.52",29490
,20131022,14460,14435,14445,14480,14430,14470,14455,35,20,3880,"28,043.69",26166
,20131023,14470,14455,14500,14510,14465,14485,14495,30,40,3528,"25,571.31",25132
,20131024,14485,14495,14405,14495,14405,14495,14470,0,-25,2020,"14,615.81",24644
,20131025,14495,14470,14490,14490,14440,14460,14470,-10,0,1956,"14,152.16",23564
,20131028,14460,14470,14460,14495,14460,14485,14485,15,15,3358,"24,323.52",22588
,20131029,14485,14485,14510,14515,14490,14505,14505,20,20,4250,"30,829.03",21582
,20131030,14505,14505,14480,14500,14130,14470,14465,-35,-40,2292,"16,581.14",20596
,20131031,14470,14465,14430,14455,14420,14455,14435,-10,-30,2992,"21,598.62",18182
,20131101,14455,14435,14410,14470,14405,14470,14435,35,0,1472,"10,626.48",17330
,20131104,14470,14435,14420,14430,14410,14420,14415,-15,-20,2060,"14,847.85",15410
,20131105,14420,14415,14405,14420,14395,14415,14405,0,-10,1880,"13,544.05",14790
,20131106,14415,14405,14400,14420,14385,14420,14385,15,-20,2540,"18,274.63",12900
,20131107,14420,14385,14420,14420,14395,14420,14405,35,20,1460,"10,516.20",11580
,20131108,14420,14405,14390,14410,14390,14400,14395,-5,-10,760,"5,471.53",10940
,20131111,14400,14395,14390,14400,14390,14400,14390,5,-5,2900,"20,866.00",8810
,20131112,14400,14390,14415,14415,14360,14375,14375,-15,-15,3320,"23,868.45",5600
,20131113,14375,14375,14360,14400,14355,14400,14370,25,-5,1710,"12,287.75",4070
,20131114,14400,14370,14380,14405,14380,14405,14395,35,25,1160,"8,350.53",2970
,20131115,14405,14395,14400,14400,14260,14300,14325,-95,-70,1480,"10,603.83",2250
al1312,20130104,16015,16015,,,,16015,16015,0,0,0,0,6
,20130107,16015,16015,,,,16015,16015,0,0,0,0,6
,20130108,16015,16015,,,,16015,16015,0,0,0,0,6
,20130109,16015,16015,,,,16015,16015,0,0,0,0,6
,20130110,16015,16015,,,,16015,16015,0,0,0,0,6
,20130111,16015,16015,,,,16015,16015,0,0,0,0,6
,20130114,16015,16015,,,,15980,15980,-35,-35,0,0,6
,20130115,15980,15980,,,,15980,15980,0,0,0,0,6
,20130116,15980,15980,,,,15980,15980,0,0,0,0,6
,20130117,15980,15980,15910,15910,15910,15910,15910,-70,-70,8,63.64,14
,20130118,15910,15910,,,,15910,15910,0,0,0,0,14
,20130121,15910,15910,,,,15910,15910,0,0,0,0,14
,20130122,15910,15910,,,,15910,15910,0,0,0,0,14
,20130123,15910,15910,,,,15910,15910,0,0,0,0,14
,20130124,15910,15910,,,,15910,15910,0,0,0,0,14
,20130125,15910,15910,,,,15910,15910,0,0,0,0,14
,20130128,15910,15910,,,,15910,15910,0,0,0,0,14
,20130129,15910,15910,,,,15940,15940,30,30,0,0,14
,20130130,15940,15940,,,,15940,15940,0,0,0,0,14
,20130131,15940,15940,,,,15940,15940,0,0,0,0,14
,20130201,15940,15940,,,,15940,15940,0,0,0,0,14
,20130204,15940,15940,15920,15920,15920,15920,15920,-20,-20,40,318.4,54
,20130205,15920,15920,,,,15900,15900,-20,-20,0,0,54
,20130206,15900,15900,15895,15895,15885,15885,15890,-15,-10,4,31.78,56
,20130207,15885,15890,,,,15855,15855,-35,-35,0,0,56
,20130208,15855,15855,,,,15855,15855,0,0,0,0,56
,20130218,15855,15855,,,,15810,15810,-45,-45,0,0,56
,20130219,15810,15810,,,,15720,15720,-90,-90,0,0,56
,20130220,15720,15720,15680,15685,15680,15685,15680,-35,-40,28,219.56,76
,20130221,15685,15680,15600,15600,15515,15560,15545,-120,-135,32,248.79,94
,20130222,15560,15545,15545,15600,15545,15560,15560,15,15,70,544.62,144
,20130225,15560,15560,15420,15420,15420,15420,15420,-140,-140,6,46.26,150
,20130226,15420,15420,,,,15420,15420,0,0,0,0,150
,20130227,15420,15420,,,,15420,15420,0,0,0,0,150
,20130228,15420,15420,15385,15385,15385,15385,15385,-35,-35,6,46.16,154
,20130301,15385,15385,15235,15235,15230,15230,15230,-155,-155,4,30.47,154
,20130304,15230,15230,,,,15230,15230,0,0,0,0,154
,20130305,15230,15230,,,,15205,15205,-25,-25,0,0,154
,20130306,15205,15205,15210,15230,15195,15210,15210,5,5,12,91.28,164
,20130307,15210,15210,15205,15360,15200,15315,15300,105,90,62,474.36,196
,20130308,15315,15300,15325,15325,15320,15320,15320,20,20,12,91.93,184
,20130311,15320,15320,,,,15295,15295,-25,-25,0,0,184
,20130312,15295,15295,15280,15280,15220,15220,15250,-75,-45,4,30.5,180
,20130313,15220,15250,15305,15315,15305,15315,15310,65,60,12,91.86,184
,20130314,15315,15310,,,,15310,15310,0,0,0,0,184
,20130315,15310,15310,,,,15310,15310,0,0,0,0,184
,20130318,15310,15310,15160,15160,15020,15090,15065,-220,-245,54,406.84,206
,20130319,15090,15065,15060,15060,15000,15000,15030,-65,-35,14,105.23,192
,20130320,15000,15030,15035,15035,15035,15035,15035,5,5,2,15.04,192
,20130321,15035,15035,,,,15035,15035,0,0,0,0,192
,20130322,15035,15035,,,,15035,15035,0,0,0,0,192
,20130325,15035,15035,15045,15045,15045,15045,15045,10,10,2,15.05,192
,20130326,15045,15045,,,,15045,15045,0,0,0,0,192
,20130327,15045,15045,14960,14960,14960,14960,14960,-85,-85,4,29.92,194
,20130328,14960,14960,,,,14960,14960,0,0,0,0,194
,20130329,14960,14960,,,,14910,14910,-50,-50,0,0,194
,20130401,14910,14910,14835,14870,14835,14870,14865,-40,-45,26,193.27,174
,20130402,14870,14865,,,,14865,14865,0,0,0,0,174
,20130403,14865,14865,14850,14850,14850,14850,14850,-15,-15,42,311.85,212
,20130408,14850,14850,14885,14885,14880,14880,14880,30,30,62,461.29,210
,20130409,14880,14880,14900,14900,14900,14900,14900,20,20,42,312.9,224
,20130410,14900,14900,14960,14965,14945,14945,14955,45,55,98,733.01,284
,20130411,14945,14955,15010,15080,14950,14960,14985,5,30,78,584.45,312
,20130412,14960,14985,,,,14955,14955,-30,-30,0,0,312
,20130415,14955,14955,14805,14815,14715,14740,14740,-215,-215,32,235.88,312
,20130416,14740,14740,14760,14770,14760,14770,14760,30,20,34,250.99,324
,20130417,14770,14760,14815,14815,14775,14775,14795,15,35,4,29.59,324
,20130418,14775,14795,14500,14685,14500,14655,14620,-140,-175,248,"1,813.41",396
,20130419,14655,14620,14665,14725,14665,14720,14690,100,70,14,102.85,394
,20130422,14720,14690,14650,14650,14645,14645,14645,-45,-45,14,102.54,384
,20130423,14645,14645,14695,14695,14645,14645,14675,0,30,6,44.04,384
,20130424,14645,14675,,,,14675,14675,0,0,0,0,384
,20130425,14675,14675,14700,14750,14690,14750,14730,75,55,80,589.34,422
,20130426,14750,14730,,,,14770,14770,40,40,0,0,422
,20130502,14770,14770,14495,14520,14495,14505,14505,-265,-265,64,464.25,472
,20130503,14505,14505,14580,14700,14565,14630,14620,125,115,24,175.47,484
,20130506,14630,14620,14710,14745,14670,14745,14720,125,100,36,265.01,498
,20130507,14745,14720,14720,14720,14690,14690,14690,-30,-30,78,572.98,568
,20130508,14690,14690,14720,14765,14720,14765,14725,75,35,50,368.2,594
,20130509,14765,14725,14750,14770,14740,14740,14750,15,25,204,"1,504.51",794
,20130510,14740,14750,14750,14780,14750,14780,14750,30,0,50,368.83,790
,20130513,14780,14750,,,,14750,14750,0,0,0,0,790
,20130514,14750,14750,14715,14715,14700,14700,14705,-50,-45,4,29.42,792
,20130515,14700,14705,14655,14660,14625,14660,14645,-45,-60,8,58.6,796
,20130516,14660,14645,14600,14605,14600,14600,14600,-45,-45,46,335.81,800
,20130517,14600,14600,14605,14635,14600,14635,14600,35,0,198,"1,445.69",908
,20130520,14635,14600,14600,14600,14585,14585,14590,-15,-10,28,204.32,928
,20130521,14585,14590,14560,14695,14560,14625,14640,35,50,72,527.15,950
,20130522,14625,14640,14670,14670,14670,14670,14670,30,30,20,146.7,962
,20130523,14670,14670,14625,14710,14625,14690,14670,20,0,34,249.4,958
,20130524,14690,14670,14680,14680,14655,14680,14675,10,5,366,"2,685.78",1218
,20130527,14680,14675,14660,14660,14630,14630,14650,-45,-25,336,"2,461.24",1412
,20130528,14630,14650,14630,14640,14600,14620,14615,-30,-35,386,"2,820.90",1558
,20130529,14620,14615,14635,14675,14635,14675,14655,60,40,86,630.36,1592
,20130530,14675,14655,14680,14720,14680,14705,14680,50,25,134,983.72,1514
,20130531,14705,14680,14790,14880,14790,14860,14825,180,145,138,"1,023.12",1540
,20130603,14860,14825,14910,14955,14885,14955,14900,130,75,56,417.33,1540
,20130604,14955,14900,14905,14915,14860,14860,14885,-40,-15,432,"3,215.67",1910
,20130605,14860,14885,14960,14985,14960,14980,14980,95,95,14,104.87,1918
,20130606,14980,14980,14925,14985,14925,14950,14935,-30,-45,108,806.72,1866
,20130607,14950,14935,14990,15005,14955,14980,14980,45,45,450,"3,371.11",1998
,20130613,14980,14980,14660,14815,14660,14720,14745,-260,-235,468,"3,451.48",2300
,20130614,14720,14745,14725,14730,14680,14690,14700,-55,-45,1430,"10,512.47",3042
,20130617,14690,14700,14700,14720,14685,14690,14700,-10,0,322,"2,366.81",3260
,20130618,14690,14700,14685,14685,14500,14500,14560,-200,-140,1982,"14,431.58",4730
,20130619,14500,14560,14525,14540,14510,14530,14525,-30,-35,1542,"11,202.62",4778
,20130620,14530,14525,14445,14455,14370,14375,14420,-150,-105,1684,"12,142.74",5698
,20130621,14375,14420,14300,14400,14270,14345,14355,-75,-65,2058,"14,771.95",7014
,20130624,14345,14355,14320,14325,14240,14260,14285,-95,-70,1414,"10,101.43",7788
,20130625,14260,14285,14295,14315,14210,14305,14270,20,-15,1156,"8,249.51",7896
,20130626,14305,14270,14305,14305,14220,14260,14275,-10,5,1850,"13,208.03",9002
,20130627,14260,14275,14285,14330,14270,14330,14280,55,5,1040,"7,428.16",9434
,20130628,14330,14280,14250,14260,14225,14230,14240,-50,-40,1206,"8,588.69",10094
,20130701,14230,14240,14265,14345,14265,14340,14320,100,80,842,"6,029.72",10378
,20130702,14340,14320,14445,14445,14325,14365,14375,45,55,2702,"19,423.87",11472
,20130703,14365,14375,14380,14385,14360,14385,14365,10,-10,508,"3,649.95",11426
,20130704,14385,14365,14340,14355,14305,14320,14325,-45,-40,808,"5,788.73",11678
,20130705,14320,14325,14330,14330,14285,14295,14290,-30,-35,1238,"8,846.07",12600
,20130708,14295,14290,14190,14235,14190,14200,14215,-90,-75,1476,"10,493.68",13438
,20130709,14200,14215,14250,14315,14225,14230,14250,15,35,1468,"10,461.09",13736
,20130710,14230,14250,14250,14270,14200,14260,14225,10,-25,1828,"13,006.04",14636
,20130711,14260,14225,14330,14415,14330,14380,14365,155,140,2038,"14,642.72",14724
,20130712,14380,14365,14365,14365,14315,14330,14335,-35,-30,658,"4,717.78",14642
,20130715,14330,14335,14355,14370,14330,14355,14350,20,15,2398,"17,210.34",15700
,20130716,14355,14350,14305,14360,14285,14340,14330,-10,-20,2284,"16,369.27",16664
,20130717,14340,14330,14330,14370,14310,14320,14340,-10,10,3890,"27,891.64",19928
,20130718,14320,14340,14300,14350,14280,14295,14305,-45,-35,2192,"15,681.94",21356
,20130719,14295,14305,14335,14345,14310,14335,14335,30,30,976,"6,995.75",21840
,20130722,14335,14335,14350,14385,14350,14380,14365,45,30,1148,"8,247.50",22120
,20130723,14380,14365,14385,14415,14380,14390,14400,25,35,2570,"18,505.42",23770
,20130724,14390,14400,14400,14400,14355,14370,14365,-30,-35,1128,"8,104.57",24436
,20130725,14370,14365,14370,14405,14370,14400,14385,35,20,1852,"13,324.64",24220
,20130726,14400,14385,14380,14380,14335,14340,14355,-45,-30,1278,"9,174.67",24890
,20130729,14340,14355,14305,14315,14245,14255,14280,-100,-75,3172,"22,655.52",26616
,20130730,14255,14280,14260,14285,14250,14255,14260,-25,-20,2812,"20,054.33",28042
,20130731,14255,14260,14240,14240,14140,14170,14195,-90,-65,5320,"37,760.23",30986
,20130801,14170,14195,14220,14290,14210,14290,14245,95,50,3772,"26,866.10",31248
,20130802,14290,14245,14255,14285,14225,14235,14245,-10,0,3214,"22,896.82",32174
,20130805,14235,14245,14250,14275,14235,14240,14250,-5,5,3730,"26,584.94",33922
,20130806,14240,14250,14225,14250,14215,14235,14235,-15,-15,3460,"24,631.33",34898
,20130807,14235,14235,14220,14220,14190,14195,14200,-40,-35,4744,"33,687.47",37040
,20130808,14195,14200,14225,14285,14225,14255,14250,55,50,6608,"47,097.43",38644
,20130809,14255,14250,14300,14340,14300,14325,14315,75,65,9050,"64,793.17",37740
,20130812,14325,14315,14400,14440,14355,14425,14395,110,80,7238,"52,102.30",40160
,20130813,14425,14395,14440,14460,14400,14435,14430,40,35,7962,"57,447.67",41980
,20130814,14435,14430,14440,14440,14340,14370,14370,-60,-60,5156,"37,058.26",42782
,20130815,14370,14370,14415,14450,14410,14430,14425,60,55,7136,"51,483.97",42566
,20130816,14430,14425,14460,14500,14460,14475,14480,50,55,9788,"70,868.13",46088
,20130819,14475,14480,14545,14545,14505,14510,14520,30,40,13524,"98,216.61",47470
,20130820,14510,14520,14480,14490,14400,14415,14440,-105,-80,8390,"60,590.76",47456
,20130821,14415,14440,14440,14445,14410,14430,14425,-10,-15,4216,"30,410.86",48502
,20130822,14430,14425,14380,14445,14380,14440,14420,15,-5,6324,"45,606.46",47154
,20130823,14440,14420,14420,14450,14410,14450,14430,30,10,5322,"38,402.71",47164
,20130826,14450,14430,14480,14500,14465,14485,14480,55,50,9456,"68,479.06",48714
,20130827,14485,14480,14475,14475,14440,14460,14450,-20,-30,5636,"40,726.88",50560
,20130828,14460,14450,14430,14470,14410,14430,14440,-20,-10,5956,"43,003.98",50874
,20130829,14430,14440,14415,14415,14350,14350,14380,-90,-60,8180,"58,831.50",53260
,20130830,14350,14380,14305,14340,14250,14255,14285,-125,-95,19600,"140,018.08",59158
,20130902,14255,14285,14250,14320,14240,14295,14270,10,-15,17300,"123,474.40",60538
,20130903,14295,14270,14300,14305,14255,14275,14270,5,0,8900,"63,518.01",63322
,20130904,14275,14270,14260,14285,14240,14245,14260,-25,-10,7218,"51,476.40",65712
,20130905,14245,14260,14200,14220,14160,14170,14190,-90,-70,16460,"116,790.22",70862
,20130906,14170,14190,14175,14215,14145,14210,14180,20,-10,6904,"48,964.19",71174
,20130909,14210,14180,14240,14250,14215,14230,14230,50,50,8912,"63,426.97",69452
,20130910,14230,14230,14205,14210,14180,14180,14190,-50,-40,10188,"72,288.07",72966
,20130911,14180,14190,14190,14210,14185,14190,14195,0,5,4790,"34,005.79",73752
,20130912,14190,14195,14190,14200,14175,14180,14185,-15,-10,3664,"25,992.44",74760
,20130913,14180,14185,14200,14260,14175,14260,14215,75,30,10292,"73,162.18",74250
,20130916,14260,14215,14250,14250,14190,14195,14215,-20,0,6808,"48,398.86",74948
,20130917,14195,14215,14175,14175,14005,14130,14115,-85,-100,14496,"102,318.40",79688
,20130918,14130,14115,14100,14160,14095,14150,14140,35,25,6016,"42,542.54",80222
,20130923,14150,14140,14160,14170,14125,14170,14145,30,5,4328,"30,613.85",81270
,20130924,14170,14145,14200,14215,14180,14210,14195,65,50,6700,"47,566.11",80950
,20130925,14210,14195,14170,14215,14170,14205,14195,10,0,4948,"35,127.41",81440
,20130926,14205,14195,14200,14250,14175,14240,14215,45,20,6256,"44,469.09",79032
,20130927,14240,14215,14265,14275,14230,14260,14255,45,40,6960,"49,620.92",77132
,20130930,14260,14255,14290,14320,14270,14315,14285,60,30,7200,"51,440.90",73842
,20131008,14315,14285,14370,14370,14325,14355,14355,70,70,7534,"54,082.93",71484
,20131009,14355,14355,14370,14400,14340,14345,14370,-10,15,7304,"52,483.66",69870
,20131010,14345,14370,14360,14395,14335,14360,14370,-10,0,5698,"40,940.32",69446
,20131011,14360,14370,14370,14480,14370,14465,14435,95,65,9412,"67,933.55",68050
,20131014,14465,14435,14465,14465,14420,14440,14435,5,0,5604,"40,455.51",66562
,20131015,14440,14435,14445,14445,14330,14350,14370,-85,-65,5688,"40,872.54",66276
,20131016,14350,14370,14350,14350,14295,14315,14310,-55,-60,4166,"29,811.06",65554
,20131017,14315,14310,14345,14365,14330,14360,14345,50,35,4386,"31,467.52",63446
,20131018,14360,14345,14410,14410,14350,14375,14365,30,20,2372,"17,038.18",61802
,20131021,14375,14365,14340,14395,14340,14385,14380,20,15,2684,"19,298.16",60518
,20131022,14385,14380,14380,14415,14375,14405,14395,25,15,2218,"15,967.34",59998
,20131023,14405,14395,14450,14455,14420,14425,14440,30,45,6232,"45,004.47",55920
,20131024,14425,14440,14365,14430,14365,14425,14410,-15,-30,4104,"29,573.99",54296
,20131025,14425,14410,14435,14440,14380,14385,14415,-25,5,3822,"27,547.61",52826
,20131028,14385,14415,14420,14455,14420,14450,14440,35,25,6530,"47,154.46",49744
,20131029,14450,14440,14480,14500,14470,14500,14485,60,45,9160,"66,345.17",45066
,20131030,14500,14485,14450,14510,14425,14480,14470,-5,-15,4526,"32,750.01",43298
,20131031,14480,14470,14490,14490,14400,14430,14430,-40,-40,4838,"34,910.94",41570
,20131101,14430,14430,14400,14450,14400,14450,14430,20,0,3982,"28,735.82",39198
,20131104,14450,14430,14400,14420,14380,14385,14395,-45,-35,3404,"24,501.21",39036
,20131105,14385,14395,14375,14380,14350,14350,14365,-45,-30,1864,"13,390.06",39454
,20131106,14350,14365,14350,14365,14320,14345,14325,-20,-40,3180,"22,784.48",38622
,20131107,14345,14325,14330,14380,14330,14360,14340,35,15,1722,"12,350.19",38952
,20131108,14360,14340,14335,14350,14325,14350,14335,10,-5,1530,"10,966.49",38856
,20131111,14350,14335,14335,14335,14320,14330,14325,-5,-10,1264,"9,056.41",39236
,20131112,14330,14325,14300,14300,14275,14280,14285,-45,-40,3364,"24,032.62",40794
,20131113,14280,14285,14250,14325,14250,14270,14260,-15,-25,3048,"21,735.23",40534
,20131114,14270,14260,14250,14295,14220,14290,14245,30,-15,3242,"23,098.55",40848
,20131115,14290,14245,14250,14285,14250,14275,14265,30,20,2834,"20,218.16",40582
,20131118,14275,14265,14290,14305,14290,14295,14295,30,30,1640,"11,724.29",39424
,20131119,14295,14295,14275,14280,14255,14270,14265,-25,-30,1448,"10,331.47",38912
,20131120,14270,14265,14285,14365,14285,14360,14325,95,60,6452,"46,219.86",34804
,20131121,14360,14325,14315,14315,14290,14310,14300,-15,-25,3308,"23,655.11",32818
,20131122,14310,14300,14290,14300,14280,14290,14285,-10,-15,784,"5,601.35",32504
,20131125,14290,14285,14310,14310,14265,14265,14275,-20,-10,484,"3,454.96",32254
,20131126,14265,14275,14250,14280,14245,14270,14260,-5,-15,3134,"22,350.13",30232
,20131127,14270,14260,14275,14280,14240,14265,14250,5,-10,2866,"20,426.24",27846
,20131128,14265,14250,14190,14215,14180,14180,14200,-70,-50,6078,"43,163.03",23056
,20131129,14180,14200,14170,14205,14170,14180,14190,-20,-10,2904,"20,607.11",21346
,20131202,14180,14190,14170,14175,14165,14170,14170,-20,-20,1756,"12,443.45",20080
,20131203,14170,14170,14145,14190,14130,14180,14165,10,-5,2110,"14,945.85",18220
,20131204,14180,14165,14185,14185,14170,14185,14175,20,10,3230,"22,900.63",15820
,20131205,14185,14175,14200,14265,14200,14240,14225,65,50,2980,"21,199.58",13270
,20131206,14240,14225,14210,14245,14210,14245,14235,20,10,1700,"12,102.73",11630
,20131209,14245,14235,14185,14315,14185,14295,14290,60,55,4520,"32,301.25",7980
,20131210,14295,14290,14365,14365,14315,14325,14340,35,50,4010,"28,754.45",5340
,20131211,14325,14340,14330,14335,14260,14260,14300,-80,-40,1320,"9,439.80",4570
,20131212,14260,14300,14255,14270,14245,14245,14255,-55,-45,1110,"7,911.98",4120
,20131213,14245,14255,14220,14220,14180,14180,14200,-75,-55,1110,"7,881.25",3350
,20131216,14180,14200,14150,14265,14110,14110,14225,-90,25,990,"7,041.55",2490
al1401,20130116,15980,15980,,,,15980,15980,0,0,0,0,0
,20130117,15980,15980,16075,16075,16075,16075,16075,95,95,2,16.08,2
,20130118,16075,16075,,,,16090,16090,15,15,0,0,2
,20130121,16090,16090,,,,16090,16090,0,0,0,0,2
,20130122,16090,16090,,,,16090,16090,0,0,0,0,2
,20130123,16090,16090,,,,16100,16100,10,10,0,0,2
,20130124,16100,16100,,,,16100,16100,0,0,0,0,2
,20130125,16100,16100,,,,16105,16105,5,5,0,0,2
,20130128,16105,16105,15935,15935,15935,15935,15935,-170,-170,2,15.94,2
,20130129,15935,15935,15900,15900,15900,15900,15900,-35,-35,2,15.9,4
,20130130,15900,15900,,,,15900,15900,0,0,0,0,4
,20130131,15900,15900,16095,16095,15865,15865,15980,-35,80,4,31.96,4
,20130201,15865,15980,,,,15980,15980,0,0,0,0,4
,20130204,15980,15980,16095,16095,16095,16095,16095,115,115,2,16.1,6
,20130205,16095,16095,,,,15995,15995,-100,-100,0,0,6
,20130206,15995,15995,,,,15980,15980,-15,-15,0,0,6
,20130207,15980,15980,,,,15980,15980,0,0,0,0,6
,20130208,15980,15980,,,,15980,15980,0,0,0,0,6
,20130218,15980,15980,,,,15935,15935,-45,-45,0,0,6
,20130219,15935,15935,,,,15845,15845,-90,-90,0,0,6
,20130220,15845,15845,,,,15805,15805,-40,-40,0,0,6
,20130221,15805,15805,,,,15670,15670,-135,-135,0,0,6
,20130222,15670,15670,15695,15695,15695,15695,15695,25,25,2,15.7,8
,20130225,15695,15695,15450,15460,15450,15460,15455,-235,-240,4,30.91,8
,20130226,15460,15455,,,,15455,15455,0,0,0,0,8
,20130227,15455,15455,15470,15470,15470,15470,15470,15,15,2,15.47,8
,20130228,15470,15470,,,,15430,15430,-40,-40,0,0,8
,20130301,15430,15430,15300,15300,15300,15300,15300,-130,-130,18,137.7,24
,20130304,15300,15300,,,,15140,15140,-160,-160,0,0,24
,20130305,15140,15140,15250,15250,15250,15250,15250,110,110,2,15.25,24
,20130306,15250,15250,,,,15260,15260,10,10,0,0,24
,20130307,15260,15260,15460,15460,15460,15460,15460,200,200,2,15.46,26
,20130308,15460,15460,15395,15395,15395,15395,15395,-65,-65,2,15.4,24
,20130311,15395,15395,15345,15345,15345,15345,15345,-50,-50,10,76.73,34
,20130312,15345,15345,,,,15345,15345,0,0,0,0,34
,20130313,15345,15345,15315,15315,15315,15315,15315,-30,-30,4,30.63,36
,20130314,15315,15315,,,,15315,15315,0,0,0,0,36
,20130315,15315,15315,,,,15310,15310,-5,-5,0,0,36
,20130318,15310,15310,,,,15310,15310,0,0,0,0,36
,20130319,15310,15310,15175,15175,15105,15105,15140,-205,-170,8,60.56,36
,20130320,15105,15140,,,,15140,15140,0,0,0,0,36
,20130321,15140,15140,,,,15140,15140,0,0,0,0,36
,20130322,15140,15140,,,,15140,15140,0,0,0,0,36
,20130325,15140,15140,,,,15140,15140,0,0,0,0,36
,20130326,15140,15140,15055,15090,15040,15090,15070,-50,-70,10,75.37,40
,20130327,15090,15070,,,,15070,15070,0,0,0,0,40
,20130328,15070,15070,,,,15025,15025,-45,-45,0,0,40
,20130329,15025,15025,,,,14950,14950,-75,-75,0,0,40
,20130401,14950,14950,14945,14945,14865,14945,14915,-5,-35,6,44.76,42
,20130402,14945,14915,,,,14915,14915,0,0,0,0,42
,20130403,14915,14915,,,,14915,14915,0,0,0,0,42
,20130408,14915,14915,,,,14915,14915,0,0,0,0,42
,20130409,14915,14915,14945,14945,14945,14945,14945,30,30,4,29.89,42
,20130410,14945,14945,15005,15005,15000,15000,15000,55,55,24,180.01,46
,20130411,15000,15000,,,,15000,15000,0,0,0,0,46
,20130412,15000,15000,,,,15000,15000,0,0,0,0,46
,20130415,15000,15000,14870,14875,14750,14750,14840,-250,-160,38,281.98,76
,20130416,14750,14840,,,,14840,14840,0,0,0,0,76
,20130417,14840,14840,14910,14910,14910,14910,14910,70,70,2,14.91,78
,20130418,14910,14910,14535,14690,14505,14620,14630,-290,-280,114,834,140
,20130419,14620,14630,14715,14735,14705,14705,14720,75,90,28,206.08,134
,20130422,14705,14720,14705,14705,14705,14705,14705,-15,-15,8,58.82,132
,20130423,14705,14705,14700,14700,14700,14700,14700,-5,-5,2,14.7,130
,20130424,14700,14700,,,,14700,14700,0,0,0,0,130
,20130425,14700,14700,14700,14760,14700,14735,14725,35,25,36,265.08,132
,20130426,14735,14725,14790,14790,14750,14750,14770,25,45,4,29.54,136
,20130502,14750,14770,14515,14545,14515,14545,14530,-225,-240,6,43.6,140
,20130503,14545,14530,14510,14610,14510,14610,14580,80,50,58,422.89,174
,20130506,14610,14580,14730,14730,14730,14730,14730,150,150,6,44.19,178
,20130507,14730,14730,14720,14720,14720,14720,14720,-10,-10,6,44.16,184
,20130508,14720,14720,14780,14780,14780,14780,14780,60,60,4,29.56,180
,20130509,14780,14780,,,,14780,14780,0,0,0,0,180
,20130510,14780,14780,,,,14780,14780,0,0,0,0,180
,20130513,14780,14780,,,,14780,14780,0,0,0,0,180
,20130514,14780,14780,14720,14720,14715,14720,14715,-60,-65,40,294.4,180
,20130515,14720,14715,14705,14705,14705,14705,14705,-10,-10,2,14.71,178
,20130516,14705,14705,14660,14660,14660,14660,14660,-45,-45,2,14.66,178
,20130517,14660,14660,,,,14660,14660,0,0,0,0,178
,20130520,14660,14660,14600,14600,14595,14595,14595,-65,-65,20,145.96,198
,20130521,14595,14595,,,,14595,14595,0,0,0,0,198
,20130522,14595,14595,14700,14700,14695,14700,14695,105,100,20,146.99,202
,20130523,14700,14695,14715,14715,14705,14705,14705,10,10,12,88.25,210
,20130524,14705,14705,14715,14715,14700,14700,14705,-5,0,40,294.13,238
,20130527,14700,14705,14660,14660,14645,14645,14655,-60,-50,12,87.95,248
,20130528,14645,14655,14645,14645,14640,14640,14640,-15,-15,4,29.29,244
,20130529,14640,14640,14685,14685,14660,14660,14660,20,20,24,175.97,226
,20130530,14660,14660,,,,14700,14700,40,40,0,0,226
,20130531,14700,14700,14815,14840,14815,14840,14825,140,125,6,44.48,224
,20130603,14840,14825,14900,14970,14900,14960,14940,135,115,66,493.09,226
,20130604,14960,14940,14920,14985,14900,14900,14935,-40,-5,132,985.79,300
,20130605,14900,14935,14955,15060,14955,15060,14970,125,35,16,119.79,304
,20130606,15060,14970,14985,14995,14965,14965,14975,-5,5,166,"1,243.31",436
,20130607,14965,14975,15060,15060,15010,15010,15035,35,60,12,90.21,442
,20130613,15010,15035,14880,14880,14760,14760,14805,-275,-230,240,"1,776.98",594
,20130614,14760,14805,14780,14780,14715,14715,14750,-90,-55,644,"4,750.91",1178
,20130617,14715,14750,14740,14750,14710,14730,14730,-20,-20,330,"2,430.51",1292
,20130618,14730,14730,14680,14680,14520,14525,14595,-205,-135,378,"2,759.17",1482
,20130619,14525,14595,14560,14560,14540,14560,14550,-35,-45,82,596.66,1510
,20130620,14560,14550,14480,14480,14380,14395,14415,-155,-135,240,"1,730.21",1646
,20130621,14395,14415,14350,14410,14280,14380,14395,-35,-20,334,"2,404.04",1886
,20130624,14380,14395,14380,14380,14265,14300,14310,-95,-85,212,"1,517.03",2016
,20130625,14300,14310,14265,14350,14250,14335,14280,25,-30,132,942.8,2126
,20130626,14335,14280,14300,14300,14280,14280,14295,0,15,120,857.86,2242
,20130627,14280,14295,14330,14330,14330,14330,14330,35,35,2,14.33,2242
,20130628,14330,14330,14250,14310,14250,14275,14275,-55,-55,16,114.21,2252
,20130701,14275,14275,14340,14360,14295,14360,14320,85,45,388,"2,778.42",2320
,20130702,14360,14320,14400,14450,14380,14390,14415,70,95,82,591.08,2308
,20130703,14390,14415,14375,14415,14375,14415,14400,0,-15,26,187.22,2284
,20130704,14415,14400,14350,14355,14330,14330,14350,-70,-50,40,287,2300
,20130705,14330,14350,14305,14310,14305,14310,14305,-40,-45,12,85.84,2300
,20130708,14310,14305,14250,14255,14225,14225,14235,-80,-70,414,"2,947.36",2678
,20130709,14225,14235,14275,14295,14250,14250,14265,15,30,114,813.39,2714
,20130710,14250,14265,14230,14270,14225,14270,14245,5,-20,120,854.9,2756
,20130711,14270,14245,14360,14425,14360,14400,14380,155,135,384,"2,761.64",2760
,20130712,14400,14380,14380,14380,14320,14320,14335,-60,-45,148,"1,061.15",2854
,20130715,14320,14335,14355,14380,14355,14380,14370,45,35,274,"1,968.74",2722
,20130716,14380,14370,14320,14355,14300,14355,14320,-15,-50,138,988.12,2722
,20130717,14355,14320,14325,14365,14325,14355,14350,35,30,104,746.24,2774
,20130718,14355,14350,14325,14350,14315,14315,14325,-35,-25,326,"2,335.57",2902
,20130719,14315,14325,14370,14370,14330,14340,14340,15,15,10,71.72,2902
,20130722,14340,14340,14380,14380,14360,14365,14365,25,25,8,57.47,2898
,20130723,14365,14365,14425,14440,14395,14405,14405,40,40,796,"5,733.69",2908
,20130724,14405,14405,14395,14395,14360,14385,14380,-20,-25,214,"1,538.77",3032
,20130725,14385,14380,14385,14405,14385,14405,14395,25,15,830,"5,975.81",3168
,20130726,14405,14395,14395,14395,14340,14360,14370,-35,-25,1150,"8,263.62",3734
,20130729,14360,14370,14305,14325,14265,14265,14300,-105,-70,1014,"7,251.89",4528
,20130730,14265,14300,14270,14300,14270,14280,14285,-20,-15,132,942.92,4582
,20130731,14280,14285,14230,14255,14160,14205,14220,-80,-65,570,"4,053.16",5018
,20130801,14205,14220,14200,14280,14200,14270,14255,50,35,284,"2,024.78",5202
,20130802,14270,14255,14275,14275,14245,14245,14265,-10,10,492,"3,509.36",5232
,20130805,14245,14265,14280,14285,14250,14250,14265,-15,0,78,556.41,5286
,20130806,14250,14265,14265,14265,14240,14250,14245,-15,-20,846,"6,027.16",5436
,20130807,14250,14245,14210,14220,14210,14210,14210,-35,-35,464,"3,297.34",5656
,20130808,14210,14210,14240,14290,14240,14265,14270,55,60,2190,"15,628.46",6884
,20130809,14265,14270,14310,14345,14310,14335,14325,65,55,1502,"10,761.32",7712
,20130812,14335,14325,14400,14425,14360,14425,14395,100,70,2452,"17,652.60",8552
,20130813,14425,14395,14430,14450,14405,14430,14430,35,35,1794,"12,946.00",9576
,20130814,14430,14430,14410,14415,14340,14370,14360,-60,-70,2272,"16,317.45",9656
,20130815,14370,14360,14410,14450,14405,14430,14420,70,60,3424,"24,695.40",11358
,20130816,14430,14420,14420,14495,14420,14485,14480,65,60,3552,"25,716.92",12972
,20130819,14485,14480,14510,14570,14510,14520,14520,40,40,4316,"31,344.22",14820
,20130820,14520,14520,14500,14500,14395,14415,14440,-105,-80,2824,"20,393.72",15900
,20130821,14415,14440,14420,14440,14410,14435,14425,-5,-15,1670,"12,047.42",15932
,20130822,14435,14425,14405,14450,14380,14440,14425,15,0,1010,"7,286.41",15976
,20130823,14440,14425,14425,14455,14405,14455,14425,30,0,1136,"8,193.48",16008
,20130826,14455,14425,14480,14500,14470,14500,14485,75,60,2614,"18,933.40",16624
,20130827,14500,14485,14490,14490,14450,14455,14455,-30,-30,1548,"11,190.39",17170
,20130828,14455,14455,14450,14475,14415,14440,14445,-15,-10,3552,"25,662.49",18958
,20130829,14440,14445,14420,14425,14350,14360,14380,-85,-65,3820,"27,469.98",19548
,20130830,14360,14380,14325,14325,14255,14260,14285,-120,-95,5404,"38,610.15",22656
,20130902,14260,14285,14235,14315,14235,14300,14270,15,-15,4472,"31,913.18",23544
,20130903,14300,14270,14300,14300,14255,14275,14270,5,0,2678,"19,113.72",24806
,20130904,14275,14270,14275,14285,14245,14255,14255,-15,-15,2314,"16,498.81",25724
,20130905,14255,14255,14220,14220,14165,14170,14190,-85,-65,10540,"74,783.49",31084
,20130906,14170,14190,14190,14210,14145,14200,14185,10,-5,5184,"36,771.63",33806
,20130909,14200,14185,14240,14240,14205,14230,14225,45,40,8352,"59,415.23",37190
,20130910,14230,14225,14205,14210,14165,14175,14175,-50,-50,7282,"51,625.97",40628
,20130911,14175,14175,14175,14205,14175,14205,14190,30,15,4402,"31,239.26",40586
,20130912,14205,14190,14210,14210,14175,14185,14185,-5,-5,2214,"15,703.42",41152
,20130913,14185,14185,14200,14230,14180,14230,14205,45,20,3902,"27,721.64",42094
,20130916,14230,14205,14225,14225,14175,14180,14200,-25,-5,4230,"30,036.25",43934
,20130917,14180,14200,14170,14170,14035,14115,14105,-85,-95,16048,"113,208.27",49360
,20130918,14115,14105,14100,14145,14060,14130,14115,25,10,7000,"49,411.84",52556
,20130923,14130,14115,14130,14145,14090,14120,14105,5,-10,5124,"36,147.21",52592
,20130924,14120,14105,14150,14175,14135,14160,14155,55,50,4360,"30,862.89",53860
,20130925,14160,14155,14155,14180,14135,14180,14160,25,5,3328,"23,567.53",54096
,20130926,14180,14160,14195,14220,14145,14210,14185,50,25,2786,"19,759.76",53496
,20130927,14210,14185,14210,14245,14195,14230,14220,45,35,7142,"50,780.20",51908
,20130930,14230,14220,14250,14285,14230,14285,14250,65,30,6202,"44,199.18",51482
,20131008,14285,14250,14295,14340,14275,14320,14315,70,65,8298,"59,398.28",52172
,20131009,14320,14315,14350,14355,14285,14325,14330,10,15,8490,"60,839.72",54612
,20131010,14325,14330,14320,14360,14305,14315,14325,-15,-5,9456,"67,748.70",56152
,20131011,14315,14325,14350,14435,14350,14420,14390,95,65,11704,"84,235.35",57410
,20131014,14420,14390,14420,14420,14365,14395,14395,5,5,6208,"44,683.41",57536
,20131015,14395,14395,14395,14395,14300,14300,14340,-95,-55,5874,"42,123.28",58444
,20131016,14300,14340,14290,14305,14260,14290,14275,-50,-65,6762,"48,280.01",57128
,20131017,14290,14275,14320,14345,14265,14320,14310,45,35,6420,"45,947.06",57868
,20131018,14320,14310,14320,14340,14305,14335,14320,25,10,3098,"22,187.89",58078
,20131021,14335,14320,14320,14375,14300,14375,14345,55,25,5292,"37,960.22",58458
,20131022,14375,14345,14345,14385,14345,14380,14365,35,20,3456,"24,826.84",58626
,20131023,14380,14365,14410,14430,14380,14395,14400,30,35,8808,"63,422.39",58950
,20131024,14395,14400,14355,14395,14340,14390,14365,-10,-35,4164,"29,916.76",59058
,20131025,14390,14365,14400,14400,14340,14360,14365,-5,0,7328,"52,645.30",57468
,20131028,14360,14365,14400,14430,14355,14430,14405,65,40,7968,"57,400.48",58412
,20131029,14430,14405,14440,14470,14440,14460,14455,55,50,11888,"85,924.68",56728
,20131030,14460,14455,14445,14490,14390,14460,14445,5,-10,7094,"51,245.15",56934
,20131031,14460,14445,14445,14460,14390,14400,14410,-45,-35,7740,"55,784.58",54642
,20131101,14400,14410,14385,14440,14375,14440,14395,30,-15,4760,"34,269.64",53626
,20131104,14440,14395,14395,14400,14365,14380,14375,-15,-20,6718,"48,294.70",50986
,20131105,14380,14375,14350,14375,14325,14335,14340,-40,-35,9370,"67,202.40",47486
,20131106,14335,14340,14315,14320,14285,14300,14295,-40,-45,6966,"49,802.12",44556
,20131107,14300,14295,14310,14320,14280,14300,14305,5,10,3990,"28,548.41",43128
,20131108,14300,14305,14290,14320,14290,14305,14300,0,-5,2386,"17,063.32",42606
,20131111,14305,14300,14325,14325,14290,14305,14295,5,-5,3424,"24,476.36",43134
,20131112,14305,14295,14285,14290,14240,14255,14255,-40,-40,5558,"39,624.58",42964
,20131113,14255,14255,14250,14250,14205,14225,14220,-30,-35,8496,"60,410.49",42650
,20131114,14225,14220,14210,14240,14165,14220,14190,0,-30,9146,"64,896.96",44358
,20131115,14220,14190,14195,14225,14180,14195,14200,5,10,9886,"70,193.15",45656
,20131118,14195,14200,14195,14230,14195,14215,14220,15,20,5478,"38,957.82",44690
,20131119,14215,14220,14260,14260,14180,14185,14190,-35,-30,4904,"34,798.65",45070
,20131120,14185,14190,14205,14285,14205,14285,14235,95,45,6548,"46,609.95",43998
,20131121,14285,14235,14260,14260,14180,14200,14200,-35,-35,4256,"30,222.23",45490
,20131122,14200,14200,14200,14235,14175,14180,14190,-20,-10,1114,"7,906.19",45876
,20131125,14180,14190,14200,14210,14140,14140,14160,-50,-30,2264,"16,033.74",45676
,20131126,14140,14160,14150,14160,14125,14140,14140,-20,-20,1802,"12,744.57",45848
,20131127,14140,14140,14140,14160,14135,14150,14145,10,5,3422,"24,202.77",46422
,20131128,14150,14145,14105,14115,14055,14055,14095,-90,-50,5630,"39,686.72",46896
,20131129,14055,14095,14075,14115,14065,14070,14075,-25,-20,5476,"38,544.25",47002
,20131202,14070,14075,14070,14070,14035,14050,14045,-25,-30,3176,"22,310.59",46270
,20131203,14050,14045,14010,14065,14010,14060,14030,15,-15,4058,"28,475.05",44910
,20131204,14060,14030,14100,14100,14060,14070,14070,40,40,2286,"16,082.64",45228
,20131205,14070,14070,14150,14150,14100,14130,14125,60,55,3062,"21,631.43",44126
,20131206,14130,14125,14125,14140,14105,14130,14120,5,-5,2320,"16,380.64",44230
,20131209,14130,14120,14155,14200,14155,14200,14180,80,60,4608,"32,672.01",42464
,20131210,14200,14180,14235,14250,14180,14245,14235,65,55,3676,"26,172.24",40836
,20131211,14245,14235,14290,14295,14220,14235,14235,0,0,3390,"24,133.78",39484
,20131212,14235,14235,14260,14265,14210,14240,14245,5,10,4426,"31,529.88",37918
,20131213,14240,14245,14175,14210,14150,14155,14175,-90,-70,3076,"21,807.33",36712
,20131216,14155,14175,14165,14175,14145,14175,14155,0,-20,2670,"18,900.80",34780
,20131217,14175,14155,14160,14160,14110,14110,14130,-45,-25,2006,"14,174.77",33622
,20131218,14110,14130,14130,14140,14125,14135,14130,5,0,2376,"16,790.20",32348
,20131219,14135,14130,14170,14170,14105,14145,14140,15,10,2572,"18,184.11",30698
,20131220,14145,14140,14090,14145,14090,14145,14115,5,-25,3420,"24,139.16",28910
,20131223,14145,14115,14200,14200,14050,14050,14080,-65,-35,3616,"25,460.21",27246
,20131224,14050,14080,14000,14050,13985,14025,14015,-55,-65,3716,"26,047.89",25420
,20131225,14025,14015,14030,14060,14005,14060,14035,45,20,3438,"24,132.89",23228
,20131226,14060,14035,14045,14045,14015,14020,14020,-15,-15,1146,"8,035.60",22842
,20131227,14020,14020,14005,14080,14005,14070,14045,50,25,3670,"25,777.35",20032
,20131230,14070,14045,14180,14190,14120,14130,14140,85,95,5358,"37,884.11",18668
,20131231,14130,14140,14110,14125,14095,14125,14115,-15,-25,2366,"16,698.42",17910
al1402,20130219,15935,15935,,,,15935,15935,0,0,0,0,0
,20130220,15935,15935,,,,15910,15910,-25,-25,0,0,0
,20130221,15910,15910,,,,15775,15775,-135,-135,0,0,0
,20130222,15775,15775,,,,15800,15800,25,25,0,0,0
,20130225,15800,15800,,,,15800,15800,0,0,0,0,0
,20130226,15800,15800,,,,15830,15830,30,30,0,0,0
,20130227,15830,15830,15580,15580,15580,15580,15580,-250,-250,66,514.14,66
,20130228,15580,15580,15570,15570,15570,15570,15570,-10,-10,6,46.71,66
,20130301,15570,15570,15355,15395,15355,15355,15365,-215,-205,8,61.48,70
,20130304,15355,15365,15515,15515,15290,15325,15395,-40,30,8,61.58,68
,20130305,15325,15395,15350,15350,15350,15350,15350,-45,-45,2,15.35,68
,20130306,15350,15350,15410,15410,15410,15410,15410,60,60,2,15.41,70
,20130307,15410,15410,,,,15410,15410,0,0,0,0,70
,20130308,15410,15410,15515,15515,15400,15400,15455,-10,45,4,30.92,70
,20130311,15400,15455,15360,15360,15360,15360,15360,-95,-95,6,46.08,74
,20130312,15360,15360,15350,15350,15350,15350,15350,-10,-10,4,30.7,78
,20130313,15350,15350,,,,15355,15355,5,5,0,0,78
,20130314,15355,15355,15315,15315,15315,15315,15315,-40,-40,2,15.32,78
,20130315,15315,15315,15330,15330,15330,15330,15330,15,15,2,15.33,76
,20130318,15330,15330,15275,15280,15155,15155,15220,-175,-110,12,91.35,70
,20130319,15155,15220,,,,15220,15220,0,0,0,0,70
,20130320,15220,15220,15180,15190,15175,15175,15175,-45,-45,28,212.51,48
,20130321,15175,15175,,,,15175,15175,0,0,0,0,48
,20130322,15175,15175,15160,15160,15160,15160,15160,-15,-15,2,15.16,48
,20130325,15160,15160,,,,15170,15170,10,10,0,0,48
,20130326,15170,15170,,,,15100,15100,-70,-70,0,0,48
,20130327,15100,15100,,,,15010,15010,-90,-90,0,0,48
,20130328,15010,15010,15030,15030,15030,15030,15030,20,20,2,15.03,48
,20130329,15030,15030,15000,15000,15000,15000,15000,-30,-30,2,15,46
,20130401,15000,15000,14975,14975,14975,14975,14975,-25,-25,2,14.98,48
,20130402,14975,14975,,,,14975,14975,0,0,0,0,48
,20130403,14975,14975,,,,14975,14975,0,0,0,0,48
,20130408,14975,14975,,,,14975,14975,0,0,0,0,48
,20130409,14975,14975,,,,14975,14975,0,0,0,0,48
,20130410,14975,14975,,,,14985,14985,10,10,0,0,48
,20130411,14985,14985,,,,14985,14985,0,0,0,0,48
,20130412,14985,14985,,,,14985,14985,0,0,0,0,48
,20130415,14985,14985,14905,14905,14905,14905,14905,-80,-80,2,14.91,46
,20130416,14905,14905,14870,14870,14870,14870,14870,-35,-35,4,29.74,50
,20130417,14870,14870,15000,15000,14910,14910,14940,40,70,6,44.82,52
,20130418,14910,14940,14590,14760,14590,14760,14675,-180,-265,4,29.35,52
,20130419,14760,14675,,,,14675,14675,0,0,0,0,52
,20130422,14675,14675,14755,14755,14755,14755,14755,80,80,4,29.51,52
,20130423,14755,14755,,,,14745,14745,-10,-10,0,0,52
,20130424,14745,14745,,,,14745,14745,0,0,0,0,52
,20130425,14745,14745,14750,14845,14750,14810,14810,65,65,64,474.02,86
,20130426,14810,14810,,,,14855,14855,45,45,0,0,86
,20130502,14855,14855,14550,14580,14550,14555,14565,-300,-290,106,772.17,102
,20130503,14555,14565,14605,14605,14605,14605,14605,40,40,4,29.21,102
,20130506,14605,14605,,,,14670,14670,65,65,0,0,102
,20130507,14670,14670,14725,14725,14725,14725,14725,55,55,12,88.35,100
,20130508,14725,14725,14775,14800,14775,14800,14795,75,70,12,88.78,98
,20130509,14800,14795,14825,14825,14825,14825,14825,30,30,2,14.83,98
,20130510,14825,14825,14830,14830,14830,14830,14830,5,5,2,14.83,98
,20130513,14830,14830,14835,14835,14785,14785,14810,-45,-20,4,29.62,98
,20130514,14785,14810,,,,14810,14810,0,0,0,0,98
,20130515,14810,14810,,,,14810,14810,0,0,0,0,98
,20130516,14810,14810,,,,14810,14810,0,0,0,0,98
,20130517,14810,14810,,,,14810,14810,0,0,0,0,98
,20130520,14810,14810,,,,14680,14680,-130,-130,0,0,98
,20130521,14680,14680,,,,14680,14680,0,0,0,0,98
,20130522,14680,14680,,,,14680,14680,0,0,0,0,98
,20130523,14680,14680,,,,14680,14680,0,0,0,0,98
,20130524,14680,14680,,,,14680,14680,0,0,0,0,98
,20130527,14680,14680,14675,14675,14675,14675,14675,-5,-5,10,73.38,98
,20130528,14675,14675,,,,14670,14670,-5,-5,0,0,98
,20130529,14670,14670,,,,14670,14670,0,0,0,0,98
,20130530,14670,14670,,,,14670,14670,0,0,0,0,98
,20130531,14670,14670,,,,14795,14795,125,125,0,0,98
,20130603,14795,14795,14830,14945,14830,14915,14880,120,85,18,133.96,100
,20130604,14915,14880,14930,14930,14930,14930,14930,50,50,4,29.86,100
,20130605,14930,14930,14955,15025,14955,15015,15005,85,75,12,90.05,106
,20130606,15015,15005,14995,14995,14995,14995,14995,-10,-10,2,15,104
,20130607,14995,14995,15120,15120,15120,15120,15120,125,125,4,30.24,100
,20130613,15120,15120,14860,14860,14780,14780,14820,-340,-300,80,592.8,174
,20130614,14780,14820,14780,14780,14765,14765,14770,-55,-50,18,132.94,178
,20130617,14765,14770,14785,14785,14740,14745,14750,-25,-20,34,250.81,184
,20130618,14745,14750,14625,14730,14550,14550,14575,-200,-175,68,495.7,232
,20130619,14550,14575,,,,14575,14575,0,0,0,0,232
,20130620,14575,14575,14460,14460,14455,14455,14455,-120,-120,10,72.3,242
,20130621,14455,14455,14385,14495,14355,14420,14425,-35,-30,96,692.58,318
,20130624,14420,14425,14365,14365,14300,14300,14355,-125,-70,82,588.6,328
,20130625,14300,14355,14400,14400,14280,14395,14300,40,-55,128,915.47,422
,20130626,14395,14300,14315,14320,14275,14275,14310,-25,10,116,830.26,494
,20130627,14275,14310,14335,14335,14335,14335,14335,25,25,2,14.34,494
,20130628,14335,14335,14315,14315,14300,14300,14305,-35,-30,4,28.62,498
,20130701,14300,14305,,,,14305,14305,0,0,0,0,498
,20130702,14305,14305,14435,14450,14435,14445,14440,140,135,10,72.22,500
,20130703,14445,14440,14435,14435,14435,14435,14435,-5,-5,2,14.44,500
,20130704,14435,14435,14390,14390,14390,14390,14390,-45,-45,2,14.39,498
,20130705,14390,14390,,,,14365,14365,-25,-25,0,0,498
,20130708,14365,14365,14280,14280,14240,14240,14260,-125,-105,4,28.52,498
,20130709,14240,14260,,,,14260,14260,0,0,0,0,498
,20130710,14260,14260,,,,14260,14260,0,0,0,0,498
,20130711,14260,14260,14445,14480,14415,14420,14435,160,175,44,317.61,498
,20130712,14420,14435,14385,14385,14385,14385,14385,-50,-50,2,14.39,496
,20130715,14385,14385,14385,14390,14365,14365,14370,-20,-15,50,359.27,540
,20130716,14365,14370,14365,14380,14365,14380,14375,10,5,22,158.17,542
,20130717,14380,14375,,,,14375,14375,0,0,0,0,542
,20130718,14375,14375,,,,14375,14375,0,0,0,0,542
,20130719,14375,14375,,,,14390,14390,15,15,0,0,542
,20130722,14390,14390,14400,14400,14400,14400,14400,10,10,2,14.4,544
,20130723,14400,14400,14430,14430,14430,14430,14430,30,30,2,14.43,546
,20130724,14430,14430,,,,14415,14415,-15,-15,0,0,546
,20130725,14415,14415,,,,14415,14415,0,0,0,0,546
,20130726,14415,14415,14370,14370,14370,14370,14370,-45,-45,2,14.37,548
,20130729,14370,14370,14335,14340,14300,14300,14330,-70,-40,240,"1,719.99",754
,20130730,14300,14330,,,,14315,14315,-15,-15,0,0,754
,20130731,14315,14315,14270,14280,14200,14200,14260,-115,-55,230,"1,640.27",932
,20130801,14200,14260,14290,14315,14290,14315,14295,55,35,16,114.36,944
,20130802,14315,14295,14300,14305,14280,14280,14295,-15,0,50,357.48,944
,20130805,14280,14295,,,,14295,14295,0,0,0,0,944
,20130806,14295,14295,14285,14285,14260,14265,14265,-30,-30,94,670.61,946
,20130807,14265,14265,14240,14240,14235,14235,14235,-30,-30,84,598.06,1010
,20130808,14235,14235,14260,14300,14260,14285,14270,50,35,262,"1,869.91",1076
,20130809,14285,14270,14330,14360,14325,14340,14345,70,75,668,"4,792.78",1272
,20130812,14340,14345,14400,14430,14400,14430,14415,85,70,182,"1,311.87",1308
,20130813,14430,14415,14450,14460,14430,14440,14440,25,25,322,"2,324.96",1530
,20130814,14440,14440,14405,14410,14370,14385,14390,-55,-50,228,"1,641.00",1598
,20130815,14385,14390,14425,14455,14420,14440,14430,50,40,154,"1,111.30",1620
,20130816,14440,14430,14480,14500,14465,14500,14485,70,55,840,"6,084.44",1866
,20130819,14500,14485,14540,14550,14505,14530,14535,45,50,278,"2,020.43",1892
,20130820,14530,14535,14530,14535,14400,14420,14445,-115,-90,986,"7,123.00",2646
,20130821,14420,14445,14445,14450,14410,14435,14425,-10,-20,590,"4,256.73",2968
,20130822,14435,14425,14415,14435,14405,14435,14420,10,-5,128,923.03,2966
,20130823,14435,14420,14420,14445,14415,14430,14420,10,0,262,"1,889.24",2966
,20130826,14430,14420,14480,14515,14480,14505,14490,85,70,1166,"8,450.20",3584
,20130827,14505,14490,14480,14485,14465,14475,14470,-15,-20,234,"1,693.11",3728
,20130828,14475,14470,14470,14480,14420,14430,14450,-40,-20,844,"6,098.55",4340
,20130829,14430,14450,14430,14430,14360,14365,14385,-85,-65,2198,"15,811.28",6086
,20130830,14365,14385,14300,14315,14255,14255,14285,-130,-100,1808,"12,915.75",7042
,20130902,14255,14285,14260,14315,14250,14300,14285,15,0,860,"6,142.92",7322
,20130903,14300,14285,14295,14295,14265,14285,14270,0,-15,800,"5,709.96",7674
,20130904,14285,14270,14275,14285,14255,14255,14260,-15,-10,380,"2,710.04",7736
,20130905,14255,14260,14200,14210,14170,14170,14195,-90,-65,1724,"12,237.67",8714
,20130906,14170,14195,14165,14200,14160,14200,14190,5,-5,934,"6,627.00",8866
,20130909,14200,14190,14225,14260,14210,14255,14225,65,35,536,"3,813.15",9158
,20130910,14255,14225,14205,14205,14160,14165,14180,-60,-45,1718,"12,181.39",10550
,20130911,14165,14180,14185,14210,14170,14200,14200,20,20,1632,"11,587.73",11830
,20130912,14200,14200,14185,14200,14180,14180,14190,-20,-10,286,"2,029.30",12016
,20130913,14180,14190,14180,14225,14180,14225,14195,35,5,674,"4,785.38",12122
,20130916,14225,14195,14215,14215,14180,14210,14200,15,5,344,"2,442.74",12236
,20130917,14210,14200,14140,14140,14060,14120,14105,-80,-95,1318,"9,296.18",12682
,20130918,14120,14105,14120,14145,14105,14125,14115,20,10,1602,"11,308.96",13630
,20130923,14125,14115,14115,14125,14080,14120,14100,5,-15,1234,"8,701.40",13854
,20130924,14120,14100,14140,14180,14140,14175,14155,75,55,1536,"10,873.56",15092
,20130925,14175,14155,14140,14185,14140,14180,14160,25,5,2478,"17,547.19",17038
,20130926,14180,14160,14170,14215,14160,14205,14190,45,30,1482,"10,514.99",17788
,20130927,14205,14190,14210,14235,14185,14230,14215,40,25,2708,"19,252.86",18778
,20130930,14230,14215,14240,14285,14230,14285,14245,70,30,1452,"10,344.04",19400
,20131008,14285,14245,14285,14335,14275,14300,14315,55,70,720,"5,153.47",19740
,20131009,14300,14315,14320,14340,14285,14320,14315,5,0,1868,"13,374.29",20212
,20131010,14320,14315,14305,14340,14290,14300,14305,-15,-10,2370,"16,955.75",20288
,20131011,14300,14305,14340,14405,14340,14395,14370,90,65,3436,"24,688.09",21126
,20131014,14395,14370,14385,14395,14340,14375,14365,5,-5,2280,"16,378.50",22204
,20131015,14375,14365,14370,14370,14230,14230,14315,-135,-50,2700,"19,330.69",22274
,20131016,14230,14315,14265,14315,14240,14275,14260,-40,-55,1588,"11,324.44",22408
,20131017,14275,14260,14285,14315,14270,14285,14295,25,35,1612,"11,522.44",22490
,20131018,14285,14295,14300,14320,14285,14315,14300,20,5,1586,"11,342.63",22980
,20131021,14315,14300,14290,14345,14275,14345,14325,45,25,2366,"16,950.92",23578
,20131022,14345,14325,14335,14365,14325,14360,14345,35,20,2114,"15,164.52",24816
,20131023,14360,14345,14385,14400,14360,14375,14380,30,35,3382,"24,324.39",26080
,20131024,14375,14380,14320,14370,14320,14365,14345,-15,-35,3634,"26,070.14",26646
,20131025,14365,14345,14370,14380,14320,14330,14355,-15,10,2116,"15,188.18",26920
,20131028,14330,14355,14370,14410,14365,14410,14380,55,25,4788,"34,435.61",29158
,20131029,14410,14380,14420,14445,14420,14440,14430,60,50,6658,"48,053.37",31632
,20131030,14440,14430,14410,14460,14380,14455,14420,25,-10,2578,"18,590.14",31860
,20131031,14455,14420,14420,14425,14380,14400,14400,-20,-20,4896,"35,262.87",33104
,20131101,14400,14400,14390,14420,14375,14420,14390,20,-10,4796,"34,511.65",32696
,20131104,14420,14390,14375,14390,14345,14355,14360,-35,-30,5730,"41,143.25",34266
,20131105,14355,14360,14330,14345,14315,14315,14325,-45,-35,6664,"47,739.59",34662
,20131106,14315,14325,14270,14300,14270,14280,14280,-45,-45,6914,"49,376.62",34506
,20131107,14280,14280,14275,14305,14260,14290,14290,10,10,3444,"24,615.36",33878
,20131108,14290,14290,14285,14300,14270,14290,14285,0,-5,2792,"19,944.62",34056
,20131111,14290,14285,14260,14300,14260,14295,14280,10,-5,2260,"16,140.48",35294
,20131112,14295,14280,14280,14280,14225,14250,14240,-30,-40,3434,"24,453.46",36234
,20131113,14250,14240,14230,14230,14190,14210,14200,-30,-40,5606,"39,811.81",38046
,20131114,14210,14200,14195,14210,14155,14200,14175,0,-25,5158,"36,565.92",39220
,20131115,14200,14175,14190,14205,14160,14160,14180,-15,5,6438,"45,647.28",42020
,20131118,14160,14180,14185,14200,14180,14185,14190,5,10,4048,"28,721.48",43140
,20131119,14185,14190,14170,14170,14150,14150,14155,-40,-35,3998,"28,300.28",44348
,20131120,14150,14155,14185,14230,14165,14220,14195,65,40,9200,"65,303.82",43868
,20131121,14220,14195,14155,14200,14130,14155,14150,-40,-45,4746,"33,580.40",45604
,20131122,14155,14150,14170,14175,14125,14135,14140,-15,-10,5198,"36,757.08",47054
,20131125,14135,14140,14165,14170,14075,14085,14110,-55,-30,4368,"30,818.58",49838
,20131126,14085,14110,14080,14110,14070,14095,14085,-15,-25,4900,"34,516.11",50462
,20131127,14095,14085,14070,14110,14070,14080,14085,-5,0,4290,"30,221.08",51582
,20131128,14080,14085,14030,14050,13975,13985,14025,-100,-60,13650,"95,727.11",59526
,20131129,13985,14025,13985,14025,13980,14005,14000,-20,-25,7632,"53,437.65",61338
,20131202,14005,14000,13955,13995,13955,13985,13975,-15,-25,6086,"42,529.65",63982
,20131203,13985,13975,13930,13995,13930,13970,13960,-5,-15,8430,"58,843.60",64472
,20131204,13970,13960,13945,14010,13945,13990,13995,30,35,7100,"49,685.31",62764
,20131205,13990,13995,14080,14080,14040,14050,14055,55,60,6440,"45,268.78",60082
,20131206,14050,14055,14030,14050,14020,14040,14035,-15,-20,3562,"24,997.56",59302
,20131209,14040,14035,14090,14115,14065,14095,14085,60,50,5386,"37,933.92",58476
,20131210,14095,14085,14180,14180,14135,14165,14155,80,70,8250,"58,396.01",54822
,20131211,14165,14155,14180,14185,14140,14155,14155,0,0,7160,"50,691.99",52132
,20131212,14155,14155,14215,14215,14140,14155,14165,0,10,8990,"63,679.66",46300
,20131213,14155,14165,14100,14140,14080,14095,14100,-70,-65,4564,"32,187.54",44876
,20131216,14095,14100,14145,14145,14095,14100,14105,0,5,3512,"24,769.43",43554
,20131217,14100,14105,14120,14120,14055,14060,14065,-45,-40,3256,"22,905.45",43442
,20131218,14060,14065,14060,14080,14060,14075,14065,10,0,4156,"29,235.69",43228
,20131219,14075,14065,14105,14110,14045,14085,14065,20,0,4856,"34,161.67",42568
,20131220,14085,14065,14010,14075,14010,14075,14045,10,-20,4198,"29,487.73",42244
,20131223,14075,14045,14075,14085,13995,13995,14025,-50,-20,4550,"31,909.08",43406
,20131224,13995,14025,13830,14025,13830,13965,13960,-60,-65,7004,"48,888.57",41276
,20131225,13965,13960,13920,14000,13920,13995,13975,35,15,5488,"38,351.46",39388
,20131226,13995,13975,14000,14020,13945,13965,13960,-10,-15,2612,"18,232.49",39460
,20131227,13965,13960,13825,14035,13820,14005,13995,45,35,4856,"33,985.51",38504
,20131230,14005,13995,14175,14175,14065,14075,14080,80,85,5152,"36,277.75",39058
,20131231,14075,14080,14075,14075,14025,14040,14040,-40,-40,5814,"40,823.99",38508
al1403,20130318,15330,15330,,,,15330,15330,0,0,0,0,0
,20130319,15330,15330,,,,15155,15155,-175,-175,0,0,0
,20130320,15155,15155,,,,15155,15155,0,0,0,0,0
,20130321,15155,15155,,,,15165,15165,10,10,0,0,0
,20130322,15165,15165,,,,15150,15150,-15,-15,0,0,0
,20130325,15150,15150,,,,15160,15160,10,10,0,0,0
,20130326,15160,15160,15090,15260,15090,15260,15175,100,15,4,30.35,2
,20130327,15260,15175,,,,15175,15175,0,0,0,0,2
,20130328,15175,15175,,,,15175,15175,0,0,0,0,2
,20130329,15175,15175,14960,14960,14960,14960,14960,-215,-215,10,74.8,12
,20130401,14960,14960,15025,15025,15000,15000,15005,40,45,12,90.06,18
,20130402,15000,15005,,,,15005,15005,0,0,0,0,18
,20130403,15005,15005,,,,15005,15005,0,0,0,0,18
,20130408,15005,15005,,,,15005,15005,0,0,0,0,18
,20130409,15005,15005,14995,14995,14995,14995,14995,-10,-10,2,15,18
,20130410,14995,14995,,,,14995,14995,0,0,0,0,18
,20130411,14995,14995,,,,14995,14995,0,0,0,0,18
,20130412,14995,14995,,,,14995,14995,0,0,0,0,18
,20130415,14995,14995,14865,14870,14865,14870,14865,-125,-130,4,29.74,16
,20130416,14870,14865,14900,14905,14900,14905,14900,40,35,6,44.71,16
,20130417,14905,14900,15025,15050,14930,14930,15000,30,100,6,45.01,18
,20130418,14930,15000,14810,14820,14810,14820,14815,-180,-185,6,44.45,20
,20130419,14820,14815,15070,15070,14720,14760,14955,-55,140,58,433.76,20
,20130422,14760,14955,,,,14955,14955,0,0,0,0,20
,20130423,14955,14955,14740,14740,14740,14740,14740,-215,-215,6,44.22,20
,20130424,14740,14740,,,,14740,14740,0,0,0,0,20
,20130425,14740,14740,,,,14805,14805,65,65,0,0,20
,20130426,14805,14805,14815,14815,14815,14815,14815,10,10,4,29.63,22
,20130502,14815,14815,14580,14580,14580,14580,14580,-235,-235,4,29.16,24
,20130503,14580,14580,,,,14615,14615,35,35,0,0,24
,20130506,14615,14615,14815,14815,14815,14815,14815,200,200,6,44.45,24
,20130507,14815,14815,14770,14770,14770,14770,14770,-45,-45,4,29.54,22
,20130508,14770,14770,,,,14770,14770,0,0,0,0,22
,20130509,14770,14770,,,,14770,14770,0,0,0,0,22
,20130510,14770,14770,,,,14770,14770,0,0,0,0,22
,20130513,14770,14770,14840,14840,14840,14840,14840,70,70,4,29.68,20
,20130514,14840,14840,,,,14840,14840,0,0,0,0,20
,20130515,14840,14840,14715,14715,14715,14715,14715,-125,-125,2,14.72,18
,20130516,14715,14715,,,,14715,14715,0,0,0,0,18
,20130517,14715,14715,,,,14715,14715,0,0,0,0,18
,20130520,14715,14715,,,,14715,14715,0,0,0,0,18
,20130521,14715,14715,,,,14715,14715,0,0,0,0,18
,20130522,14715,14715,,,,14715,14715,0,0,0,0,18
,20130523,14715,14715,,,,14715,14715,0,0,0,0,18
,20130524,14715,14715,,,,14715,14715,0,0,0,0,18
,20130527,14715,14715,14695,14695,14685,14695,14690,-20,-25,32,235.07,50
,20130528,14695,14690,,,,14690,14690,0,0,0,0,50
,20130529,14690,14690,,,,14690,14690,0,0,0,0,50
,20130530,14690,14690,14760,14760,14760,14760,14760,70,70,2,14.76,48
,20130531,14760,14760,14860,14895,14855,14895,14860,135,100,14,104.04,48
,20130603,14895,14860,14805,15000,14805,15000,14945,140,85,26,194.32,46
,20130604,15000,14945,15010,15010,15010,15010,15010,65,65,2,15.01,46
,20130605,15010,15010,15195,15195,15040,15060,15100,50,90,12,90.62,42
,20130606,15060,15100,,,,15100,15100,0,0,0,0,42
,20130607,15100,15100,,,,15100,15100,0,0,0,0,42
,20130613,15100,15100,,,,15095,15095,-5,-5,0,0,42
,20130614,15095,15095,14780,14780,14780,14780,14780,-315,-315,4,29.56,42
,20130617,14780,14780,,,,14780,14780,0,0,0,0,42
,20130618,14780,14780,14625,14625,14605,14605,14615,-175,-165,4,29.23,42
,20130619,14605,14615,14610,14610,14610,14610,14610,-5,-5,2,14.61,42
,20130620,14610,14610,14460,14460,14460,14460,14460,-150,-150,2,14.46,44
,20130621,14460,14460,14475,14480,14475,14480,14475,20,15,8,57.92,44
,20130624,14480,14475,14305,14385,14305,14375,14360,-100,-115,58,416.45,72
,20130625,14375,14360,14250,14280,14250,14280,14265,-80,-95,8,57.06,72
,20130626,14280,14265,14330,14345,14330,14345,14330,80,65,104,745.18,174
,20130627,14345,14330,,,,14330,14330,0,0,0,0,174
,20130628,14330,14330,,,,14300,14300,-30,-30,0,0,174
,20130701,14300,14300,,,,14300,14300,0,0,0,0,174
,20130702,14300,14300,,,,14300,14300,0,0,0,0,174
,20130703,14300,14300,,,,14300,14300,0,0,0,0,174
,20130704,14300,14300,,,,14300,14300,0,0,0,0,174
,20130705,14300,14300,,,,14300,14300,0,0,0,0,174
,20130708,14300,14300,14300,14300,14300,14300,14300,0,0,22,157.3,154
,20130709,14300,14300,14330,14330,14330,14330,14330,30,30,4,28.66,158
,20130710,14330,14330,,,,14330,14330,0,0,0,0,158
,20130711,14330,14330,14445,14450,14405,14405,14435,75,105,8,57.75,162
,20130712,14405,14435,14380,14380,14375,14375,14375,-60,-60,14,100.63,176
,20130715,14375,14375,14380,14400,14380,14400,14385,25,10,24,172.66,186
,20130716,14400,14385,14355,14445,14355,14445,14400,60,15,4,28.8,184
,20130717,14445,14400,,,,14400,14400,0,0,0,0,184
,20130718,14400,14400,,,,14400,14400,0,0,0,0,184
,20130719,14400,14400,,,,14415,14415,15,15,0,0,184
,20130722,14415,14415,,,,14415,14415,0,0,0,0,184
,20130723,14415,14415,14445,14450,14445,14450,14445,35,30,22,158.95,164
,20130724,14450,14445,14405,14415,14405,14415,14410,-30,-35,4,28.82,166
,20130725,14415,14410,,,,14410,14410,0,0,0,0,166
,20130726,14410,14410,,,,14365,14365,-45,-45,0,0,166
,20130729,14365,14365,14365,14365,14310,14310,14325,-55,-40,104,744.91,254
,20130730,14310,14325,14335,14335,14335,14335,14335,10,10,2,14.34,254
,20130731,14335,14335,14300,14300,14240,14240,14270,-95,-65,88,627.92,336
,20130801,14240,14270,14300,14300,14300,14300,14300,30,30,22,157.3,336
,20130802,14300,14300,,,,14300,14300,0,0,0,0,336
,20130805,14300,14300,14310,14310,14310,14310,14310,10,10,20,143.1,356
,20130806,14310,14310,14295,14295,14295,14295,14295,-15,-15,10,71.48,366
,20130807,14295,14295,14285,14285,14260,14265,14280,-30,-15,118,842.55,482
,20130808,14265,14280,14330,14340,14310,14340,14320,60,40,10,71.61,476
,20130809,14340,14320,14400,14400,14360,14370,14380,50,60,120,863.09,518
,20130812,14370,14380,14445,14445,14445,14445,14445,65,65,4,28.89,518
,20130813,14445,14445,14550,14550,14465,14475,14480,30,35,162,"1,173.06",558
,20130814,14475,14480,,,,14430,14430,-50,-50,0,0,558
,20130815,14430,14430,,,,14450,14450,20,20,0,0,558
,20130816,14450,14450,14520,14550,14490,14550,14520,100,70,6,43.56,558
,20130819,14550,14520,14600,14600,14600,14600,14600,80,80,2,14.6,558
,20130820,14600,14600,14520,14520,14425,14425,14510,-175,-90,284,"2,060.54",676
,20130821,14425,14510,14470,14470,14440,14445,14455,-65,-55,1040,"7,517.85",1360
,20130822,14445,14455,14440,14440,14430,14440,14435,-15,-20,6,43.31,1360
,20130823,14440,14435,14450,14455,14440,14440,14450,5,15,108,780.41,1444
,20130826,14440,14450,14530,14530,14495,14520,14505,70,55,1188,"8,618.17",1964
,20130827,14520,14505,14525,14525,14480,14485,14480,-20,-25,412,"2,983.20",2174
,20130828,14485,14480,14480,14485,14425,14440,14460,-40,-20,642,"4,641.92",2682
,20130829,14440,14460,14420,14420,14370,14370,14390,-90,-70,266,"1,914.02",2914
,20130830,14370,14390,14325,14325,14255,14255,14280,-135,-110,1324,"9,454.19",3820
,20130902,14255,14280,14255,14315,14255,14300,14285,20,5,424,"3,029.33",4016
,20130903,14300,14285,14295,14295,14270,14295,14280,10,-5,1404,"10,025.69",4906
,20130904,14295,14280,14295,14295,14260,14260,14275,-20,-5,1160,"8,280.57",5960
,20130905,14260,14275,14240,14240,14170,14180,14205,-95,-70,1148,"8,154.20",6486
,20130906,14180,14205,14180,14200,14150,14200,14180,-5,-25,796,"5,644.39",6570
,20130909,14200,14180,14215,14240,14215,14235,14235,55,55,470,"3,345.61",6766
,20130910,14235,14235,14185,14205,14160,14170,14180,-65,-55,842,"5,971.07",7320
,20130911,14170,14180,14195,14210,14185,14190,14195,10,15,176,"1,249.42",7328
,20130912,14190,14195,14190,14200,14185,14185,14195,-10,0,172,"1,220.78",7364
,20130913,14185,14195,14200,14235,14180,14220,14200,25,5,236,"1,675.67",7404
,20130916,14220,14200,14205,14215,14180,14185,14190,-15,-10,558,"3,960.22",7432
,20130917,14185,14190,14145,14145,14070,14125,14115,-65,-75,354,"2,498.46",7534
,20130918,14125,14115,14130,14135,14120,14120,14125,5,10,228,"1,610.26",7568
,20130923,14120,14125,14130,14130,14095,14120,14105,-5,-20,824,"5,812.81",8048
,20130924,14120,14105,14140,14175,14140,14170,14165,65,60,1008,"7,140.21",8866
,20130925,14170,14165,14140,14190,14140,14190,14170,25,5,1172,"8,306.29",9622
,20130926,14190,14170,14165,14210,14165,14200,14185,30,15,1188,"8,427.37",10266
,20130927,14200,14185,14200,14235,14190,14235,14220,50,35,1094,"7,779.82",10712
,20130930,14235,14220,14235,14280,14225,14270,14240,50,20,800,"5,697.89",10986
,20131008,14270,14240,14330,14330,14315,14320,14320,80,80,152,"1,088.40",10938
,20131009,14320,14320,14335,14350,14290,14305,14325,-15,5,1414,"10,130.54",11712
,20131010,14305,14325,14310,14330,14280,14285,14300,-40,-25,560,"4,004.45",11918
,20131011,14285,14300,14340,14400,14340,14400,14365,100,65,1268,"9,108.55",12138
,20131014,14400,14365,14360,14390,14350,14375,14360,10,-5,494,"3,548.00",12338
,20131015,14375,14360,14355,14355,14275,14280,14300,-80,-60,998,"7,137.39",12602
,20131016,14280,14300,14250,14270,14245,14255,14260,-45,-40,686,"4,891.49",12910
,20131017,14255,14260,14310,14310,14260,14290,14280,30,20,664,"4,741.80",13058
,20131018,14290,14280,14300,14305,14280,14300,14290,20,10,408,"2,915.58",13274
,20131021,14300,14290,14300,14335,14300,14335,14320,45,30,1016,"7,275.86",13786
,20131022,14335,14320,14320,14360,14320,14360,14335,40,15,1846,"13,234.28",14616
,20131023,14360,14335,14390,14390,14360,14370,14375,35,40,1358,"9,763.97",15254
,20131024,14370,14375,14310,14365,14310,14355,14350,-20,-25,1350,"9,686.32",15724
,20131025,14355,14350,14370,14375,14320,14320,14345,-30,-5,648,"4,648.81",16016
,20131028,14320,14345,14355,14400,14355,14400,14375,55,30,1692,"12,164.79",16600
,20131029,14400,14375,14425,14430,14410,14430,14420,55,45,3726,"26,868.06",16748
,20131030,14430,14420,14375,14450,14370,14440,14430,20,10,1990,"14,360.91",17266
,20131031,14440,14430,14400,14430,14370,14395,14395,-35,-35,2166,"15,594.92",18002
,20131101,14395,14395,14360,14415,14360,14415,14395,20,0,1666,"11,994.28",17652
,20131104,14415,14395,14390,14390,14350,14360,14360,-35,-35,1146,"8,228.93",17794
,20131105,14360,14360,14340,14340,14320,14320,14325,-40,-35,1852,"13,268.01",18420
,20131106,14320,14325,14300,14300,14280,14295,14285,-30,-40,1734,"12,388.70",18852
,20131107,14295,14285,14305,14305,14285,14285,14295,0,10,876,"6,261.46",19128
,20131108,14285,14295,14280,14305,14275,14300,14285,5,-10,810,"5,786.26",19252
,20131111,14300,14285,14285,14300,14280,14300,14285,15,0,1226,"8,757.23",20086
,20131112,14300,14285,14275,14275,14225,14240,14240,-45,-45,3608,"25,697.94",22210
,20131113,14240,14240,14230,14230,14190,14200,14200,-40,-40,4402,"31,258.74",25106
,20131114,14200,14200,14195,14215,14150,14210,14170,10,-30,3660,"25,939.29",26804
,20131115,14210,14170,14180,14195,14160,14165,14180,-5,10,5630,"39,926.98",29004
,20131118,14165,14180,14175,14195,14175,14180,14180,0,0,2726,"19,332.62",29596
,20131119,14180,14180,14165,14165,14140,14150,14150,-30,-30,2688,"19,019.58",30562
,20131120,14150,14150,14175,14210,14165,14205,14175,55,25,5794,"41,075.42",32814
,20131121,14205,14175,14150,14180,14115,14125,14125,-50,-50,5574,"39,373.80",36564
,20131122,14125,14125,14140,14140,14110,14115,14120,-10,-5,2224,"15,704.81",37430
,20131125,14115,14120,14125,14130,14060,14065,14090,-55,-30,4346,"30,623.31",39610
,20131126,14065,14090,14075,14095,14045,14070,14065,-20,-25,4038,"28,398.70",40932
,20131127,14070,14065,14065,14085,14055,14065,14065,0,0,1642,"11,550.18",41128
,20131128,14065,14065,14005,14020,13955,13970,14000,-95,-65,8584,"60,088.67",46220
,20131129,13970,14000,13990,13995,13955,13975,13970,-25,-30,5580,"38,985.60",48024
,20131202,13975,13970,13950,13970,13935,13970,13955,0,-15,2170,"15,145.36",48430
,20131203,13970,13955,13945,13965,13915,13940,13935,-15,-20,5124,"35,708.03",49626
,20131204,13940,13935,13935,13970,13925,13960,13955,25,20,5994,"41,836.44",51320
,20131205,13960,13955,14010,14045,14010,14015,14020,60,65,5182,"36,334.09",49312
,20131206,14015,14020,13995,14005,13970,13985,13985,-35,-35,3126,"21,861.16",50656
,20131209,13985,13985,14000,14040,14000,14030,14020,45,35,2850,"19,985.29",50702
,20131210,14030,14020,14050,14095,14050,14090,14080,70,60,4678,"32,940.65",49744
,20131211,14090,14080,14115,14120,14065,14080,14090,0,10,4748,"33,451.39",49246
,20131212,14080,14090,14110,14125,14080,14100,14110,10,20,7388,"52,128.48",48142
,20131213,14100,14110,14020,14070,14015,14030,14035,-80,-75,3308,"23,215.98",48738
,20131216,14030,14035,14050,14055,14030,14035,14040,0,5,2358,"16,557.48",48628
,20131217,14035,14040,14045,14045,13990,14000,14010,-40,-30,2050,"14,363.12",49226
,20131218,14000,14010,13990,14020,13990,14015,14010,5,0,3104,"21,747.30",49204
,20131219,14015,14010,14050,14050,13985,14025,14010,15,0,4818,"33,758.24",49042
,20131220,14025,14010,13970,14025,13965,14020,14000,10,-10,4862,"34,041.54",48596
,20131223,14020,14000,14050,14060,13965,13965,14000,-35,0,6332,"44,331.47",49840
,20131224,13965,14000,13950,13960,13905,13930,13925,-70,-75,11684,"81,357.10",52378
,20131225,13930,13925,13905,13975,13875,13975,13935,50,10,11192,"78,003.98",51264
,20131226,13975,13935,13980,14000,13910,13935,13945,0,10,6608,"46,086.37",51794
,20131227,13935,13945,13925,14025,13910,13995,13970,50,25,11604,"81,067.73",53500
,20131230,13995,13970,14085,14125,14050,14060,14080,90,110,19334,"136,128.11",53934
,20131231,14060,14080,14070,14070,14000,14035,14020,-45,-60,13506,"94,690.29",53020
al1404,20130416,14865,14865,,,,14865,14865,0,0,0,0,0
,20130417,14865,14865,15120,15120,15120,15120,15120,255,255,2,15.12,2
,20130418,15120,15120,,,,15000,15000,-120,-120,0,0,2
,20130419,15000,15000,14965,15040,14965,15040,15015,40,15,6,45.05,8
,20130422,15040,15015,,,,15095,15095,80,80,0,0,8
,20130423,15095,15095,14905,14905,14905,14905,14905,-190,-190,4,29.81,4
,20130424,14905,14905,,,,14905,14905,0,0,0,0,4
,20130425,14905,14905,14835,14835,14835,14835,14835,-70,-70,4,29.67,6
,20130426,14835,14835,,,,14835,14835,0,0,0,0,6
,20130502,14835,14835,,,,14670,14670,-165,-165,0,0,6
,20130503,14670,14670,,,,14670,14670,0,0,0,0,6
,20130506,14670,14670,,,,14690,14690,20,20,0,0,6
,20130507,14690,14690,,,,14700,14700,10,10,0,0,6
,20130508,14700,14700,,,,14700,14700,0,0,0,0,6
,20130509,14700,14700,,,,14700,14700,0,0,0,0,6
,20130510,14700,14700,,,,14700,14700,0,0,0,0,6
,20130513,14700,14700,,,,14785,14785,85,85,0,0,6
,20130514,14785,14785,14785,14785,14785,14785,14785,0,0,2,14.79,8
,20130515,14785,14785,,,,14785,14785,0,0,0,0,8
,20130516,14785,14785,,,,14785,14785,0,0,0,0,8
,20130517,14785,14785,,,,14785,14785,0,0,0,0,8
,20130520,14785,14785,14800,14800,14640,14730,14720,-55,-65,10,73.61,10
,20130521,14730,14720,,,,14720,14720,0,0,0,0,10
,20130522,14720,14720,,,,14720,14720,0,0,0,0,10
,20130523,14720,14720,14735,14735,14735,14735,14735,15,15,2,14.74,12
,20130524,14735,14735,,,,14735,14735,0,0,0,0,12
,20130527,14735,14735,14760,14760,14735,14735,14740,0,5,16,117.96,28
,20130528,14735,14740,,,,14740,14740,0,0,0,0,28
,20130529,14740,14740,,,,14740,14740,0,0,0,0,28
,20130530,14740,14740,14760,14760,14760,14760,14760,20,20,2,14.76,30
,20130531,14760,14760,,,,14860,14860,100,100,0,0,30
,20130603,14860,14860,14995,15025,14995,15025,15010,165,150,4,30.02,28
,20130604,15025,15010,14985,14985,14985,14985,14985,-25,-25,2,14.99,26
,20130605,14985,14985,,,,14985,14985,0,0,0,0,26
,20130606,14985,14985,,,,14985,14985,0,0,0,0,26
,20130607,14985,14985,,,,15105,15105,120,120,0,0,26
,20130613,15105,15105,,,,15105,15105,0,0,0,0,26
,20130614,15105,15105,,,,15040,15040,-65,-65,0,0,26
,20130617,15040,15040,,,,14800,14800,-240,-240,0,0,26
,20130618,14800,14800,,,,14635,14635,-165,-165,0,0,26
,20130619,14635,14635,,,,14635,14635,0,0,0,0,26
,20130620,14635,14635,14480,14480,14480,14480,14480,-155,-155,2,14.48,28
,20130621,14480,14480,14380,14380,14380,14380,14380,-100,-100,2,14.38,30
,20130624,14380,14380,,,,14380,14380,0,0,0,0,30
,20130625,14380,14380,,,,14380,14380,0,0,0,0,30
,20130626,14380,14380,14255,14430,14255,14385,14355,5,-25,14,100.5,28
,20130627,14385,14355,,,,14355,14355,0,0,0,0,28
,20130628,14355,14355,14360,14360,14360,14360,14360,5,5,2,14.36,28
,20130701,14360,14360,,,,14360,14360,0,0,0,0,28
,20130702,14360,14360,,,,14360,14360,0,0,0,0,28
,20130703,14360,14360,,,,14360,14360,0,0,0,0,28
,20130704,14360,14360,,,,14360,14360,0,0,0,0,28
,20130705,14360,14360,,,,14360,14360,0,0,0,0,28
,20130708,14360,14360,14330,14330,14330,14330,14330,-30,-30,2,14.33,28
,20130709,14330,14330,,,,14330,14330,0,0,0,0,28
,20130710,14330,14330,,,,14330,14330,0,0,0,0,28
,20130711,14330,14330,14430,14455,14430,14455,14440,125,110,4,28.89,24
,20130712,14455,14440,14415,14415,14415,14415,14415,-25,-25,6,43.25,28
,20130715,14415,14415,,,,14425,14425,10,10,0,0,28
,20130716,14425,14425,,,,14425,14425,0,0,0,0,28
,20130717,14425,14425,,,,14425,14425,0,0,0,0,28
,20130718,14425,14425,,,,14425,14425,0,0,0,0,28
,20130719,14425,14425,,,,14440,14440,15,15,0,0,28
,20130722,14440,14440,,,,14440,14440,0,0,0,0,28
,20130723,14440,14440,,,,14440,14440,0,0,0,0,28
,20130724,14440,14440,,,,14440,14440,0,0,0,0,28
,20130725,14440,14440,,,,14440,14440,0,0,0,0,28
,20130726,14440,14440,,,,14390,14390,-50,-50,0,0,28
,20130729,14390,14390,14360,14365,14360,14365,14360,-25,-30,22,157.97,50
,20130730,14365,14360,,,,14370,14370,10,10,0,0,50
,20130731,14370,14370,14335,14335,14250,14280,14290,-90,-80,106,757.4,128
,20130801,14280,14290,,,,14320,14320,30,30,0,0,128
,20130802,14320,14320,14315,14315,14315,14315,14315,-5,-5,2,14.32,130
,20130805,14315,14315,,,,14325,14325,10,10,0,0,130
,20130806,14325,14325,,,,14305,14305,-20,-20,0,0,130
,20130807,14305,14305,,,,14290,14290,-15,-15,0,0,130
,20130808,14290,14290,,,,14330,14330,40,40,0,0,130
,20130809,14330,14330,14390,14420,14390,14405,14410,75,80,40,288.23,128
,20130812,14405,14410,14420,14480,14420,14480,14445,70,35,6,43.34,126
,20130813,14480,14445,14500,14500,14500,14500,14500,55,55,10,72.5,120
,20130814,14500,14500,14445,14445,14440,14440,14440,-60,-60,6,43.33,118
,20130815,14440,14440,14490,14490,14490,14490,14490,50,50,2,14.49,118
,20130816,14490,14490,,,,14560,14560,70,70,0,0,118
,20130819,14560,14560,,,,14640,14640,80,80,0,0,118
,20130820,14640,14640,14640,14640,14460,14460,14565,-180,-75,30,218.53,118
,20130821,14460,14565,14500,14500,14500,14500,14500,-65,-65,2,14.5,120
,20130822,14500,14500,14485,14485,14485,14485,14485,-15,-15,80,579.4,200
,20130823,14485,14485,,,,14500,14500,15,15,0,0,200
,20130826,14500,14500,14535,14535,14535,14535,14535,35,35,2,14.54,200
,20130827,14535,14535,14555,14555,14530,14530,14535,-5,0,24,174.44,214
,20130828,14530,14535,14520,14520,14480,14480,14510,-55,-25,28,203.17,218
,20130829,14480,14510,14430,14430,14420,14420,14425,-90,-85,6,43.28,218
,20130830,14420,14425,14330,14330,14285,14285,14310,-140,-115,444,"3,177.44",652
,20130902,14285,14310,,,,14310,14310,0,0,0,0,652
,20130903,14310,14310,14305,14320,14305,14320,14310,10,0,308,"2,204.35",940
,20130904,14320,14310,14320,14320,14290,14290,14295,-20,-15,744,"5,319.29",1468
,20130905,14290,14295,14270,14270,14180,14180,14210,-115,-85,1254,"8,910.24",1986
,20130906,14180,14210,14190,14210,14190,14200,14195,-10,-15,558,"3,961.48",2194
,20130909,14200,14195,14205,14240,14205,14240,14230,45,35,88,626.21,2244
,20130910,14240,14230,14185,14200,14170,14180,14180,-50,-50,116,822.52,2304
,20130911,14180,14180,14190,14210,14190,14200,14200,20,20,208,"1,476.81",2464
,20130912,14200,14200,14205,14205,14190,14190,14195,-10,-5,82,582.2,2526
,20130913,14190,14195,14200,14220,14180,14215,14190,20,-5,132,936.81,2624
,20130916,14215,14190,14185,14225,14180,14200,14200,10,10,248,"1,761.26",2670
,20130917,14200,14200,14120,14145,14080,14140,14115,-60,-85,200,"1,411.92",2792
,20130918,14140,14115,14130,14135,14110,14135,14115,20,0,58,409.43,2780
,20130923,14135,14115,14115,14145,14105,14145,14115,30,0,64,451.7,2820
,20130924,14145,14115,14150,14175,14150,14170,14165,55,50,30,212.49,2814
,20130925,14170,14165,14175,14195,14170,14190,14180,25,15,48,340.42,2836
,20130926,14190,14180,14220,14220,14210,14215,14210,35,30,168,"1,194.02",2848
,20130927,14215,14210,14205,14250,14205,14230,14240,20,30,606,"4,315.26",3200
,20130930,14230,14240,14230,14345,14230,14285,14250,45,10,458,"3,263.26",3346
,20131008,14285,14250,14300,14330,14300,14315,14320,65,70,96,687.56,3258
,20131009,14315,14320,14300,14335,14295,14300,14310,-20,-10,220,"1,574.54",3350
,20131010,14300,14310,14330,14330,14295,14305,14310,-5,0,50,357.82,3366
,20131011,14305,14310,14340,14400,14340,14395,14365,85,55,522,"3,750.26",3554
,20131014,14395,14365,14385,14395,14350,14360,14385,-5,20,334,"2,402.92",3738
,20131015,14360,14385,14350,14350,14285,14300,14320,-85,-65,458,"3,280.22",3950
,20131016,14300,14320,14265,14280,14240,14255,14255,-65,-65,114,812.6,3916
,20131017,14255,14255,14295,14300,14285,14285,14290,30,35,216,"1,543.80",4016
,20131018,14285,14290,14300,14305,14280,14305,14285,15,-5,152,"1,086.03",4120
,20131021,14305,14285,14330,14335,14320,14335,14330,50,45,90,644.95,4090
,20131022,14335,14330,14320,14355,14320,14340,14340,10,10,206,"1,477.25",4084
,20131023,14340,14340,14380,14385,14355,14360,14370,20,30,400,"2,874.73",4258
,20131024,14360,14370,14350,14350,14340,14350,14340,-20,-30,472,"3,385.07",4518
,20131025,14350,14340,14360,14360,14310,14320,14340,-20,0,228,"1,634.93",4670
,20131028,14320,14340,14375,14395,14370,14395,14375,55,35,662,"4,759.23",4908
,20131029,14395,14375,14425,14425,14410,14415,14415,40,40,584,"4,210.30",5216
,20131030,14415,14415,14385,14450,14385,14440,14430,25,15,1536,"11,084.44",6136
,20131031,14440,14430,14370,14425,14365,14395,14410,-35,-20,1510,"10,880.44",7162
,20131101,14395,14410,14395,14405,14385,14405,14390,-5,-20,280,"2,015.26",7286
,20131104,14405,14390,14375,14375,14355,14365,14360,-25,-30,238,"1,709.40",7318
,20131105,14365,14360,14320,14350,14320,14330,14330,-30,-30,242,"1,734.46",7466
,20131106,14330,14330,14290,14300,14285,14295,14290,-35,-40,380,"2,715.72",7550
,20131107,14295,14290,14300,14305,14290,14290,14295,0,5,496,"3,545.40",7538
,20131108,14290,14295,14280,14295,14280,14295,14285,0,-10,144,"1,028.66",7516
,20131111,14295,14285,14380,14380,14285,14305,14290,20,5,618,"4,416.43",8022
,20131112,14305,14290,14255,14260,14235,14250,14250,-40,-40,586,"4,175.80",8400
,20131113,14250,14250,14230,14230,14200,14200,14205,-50,-45,1610,"11,437.57",9068
,20131114,14200,14205,14190,14215,14160,14210,14180,5,-25,622,"4,410.67",9280
,20131115,14210,14180,14190,14200,14170,14170,14180,-10,0,720,"5,106.37",9616
,20131118,14170,14180,14195,14200,14180,14185,14185,5,5,432,"3,064.46",9670
,20131119,14185,14185,14160,14230,14145,14150,14150,-35,-35,564,"3,991.13",10052
,20131120,14150,14150,14175,14210,14170,14200,14180,50,30,1138,"8,070.12",10276
,20131121,14200,14180,14160,14160,14120,14140,14130,-40,-50,2052,"14,500.21",11706
,20131122,14140,14130,14155,14155,14110,14110,14125,-20,-5,940,"6,640.97",12138
,20131125,14110,14125,14130,14130,14070,14080,14090,-45,-35,1130,"7,963.04",12820
,20131126,14080,14090,14070,14085,14050,14080,14060,-10,-30,2624,"18,451.12",14244
,20131127,14080,14060,14060,14085,14055,14055,14060,-5,0,1272,"8,943.26",14714
,20131128,14055,14060,14000,14015,13960,13970,13995,-90,-65,6166,"43,150.71",19332
,20131129,13970,13995,13985,13995,13955,13970,13970,-25,-25,3026,"21,143.43",20492
,20131202,13970,13970,13950,13975,13940,13970,13960,0,-10,2350,"16,403.00",22250
,20131203,13970,13960,13930,13965,13910,13940,13935,-20,-25,3512,"24,471.35",24266
,20131204,13940,13935,13920,13970,13920,13955,13955,20,20,2232,"15,576.77",25758
,20131205,13955,13955,14000,14060,13995,13995,14005,40,50,1912,"13,391.19",25962
,20131206,13995,14005,13985,13990,13935,13960,13955,-45,-50,2564,"17,892.95",26998
,20131209,13960,13955,13975,14005,13975,14000,13985,45,30,1860,"13,008.87",27642
,20131210,14000,13985,14045,14060,14025,14050,14040,65,55,2834,"19,897.35",28586
,20131211,14050,14040,14060,14070,14010,14035,14035,-5,-5,4874,"34,205.49",30928
,20131212,14035,14035,14065,14075,14040,14050,14055,15,20,6214,"43,679.16",32848
,20131213,14050,14055,14005,14010,13965,13970,13980,-85,-75,4718,"32,990.35",35674
,20131216,13970,13980,14000,14005,13980,13995,13990,15,10,3868,"27,062.70",37578
,20131217,13995,13990,13990,13990,13945,13950,13960,-40,-30,2344,"16,363.74",39090
,20131218,13950,13960,13950,13965,13945,13955,13955,-5,-5,3028,"21,134.91",40322
,20131219,13955,13955,13980,13990,13930,13960,13955,5,0,4352,"30,370.40",43428
,20131220,13960,13955,13920,13975,13910,13965,13935,10,-20,3590,"25,021.59",44030
,20131223,13965,13935,14050,14050,13945,13945,13965,10,30,2684,"18,741.39",44488
,20131224,13945,13965,13920,13945,13895,13920,13915,-45,-50,6906,"48,059.11",46464
,20131225,13920,13915,13945,13955,13875,13950,13925,35,10,4096,"28,524.72",46068
,20131226,13950,13925,13965,13970,13900,13915,13920,-10,-5,2396,"16,678.97",46602
,20131227,13915,13920,13915,14000,13900,13965,13955,45,35,6090,"42,496.49",47064
,20131230,13965,13955,14000,14100,14000,14025,14050,70,95,7172,"50,388.44",48866
,20131231,14025,14050,14040,14040,13950,13990,13975,-60,-75,13328,"93,152.45",54700
al1405,20130516,14785,14785,,,,14785,14785,0,0,0,0,0
,20130517,14785,14785,,,,14785,14785,0,0,0,0,0
,20130520,14785,14785,,,,14785,14785,0,0,0,0,0
,20130521,14785,14785,,,,14785,14785,0,0,0,0,0
,20130522,14785,14785,14875,14875,14850,14850,14855,65,70,10,74.29,10
,20130523,14850,14855,14775,14775,14775,14775,14775,-80,-80,2,14.78,10
,20130524,14775,14775,,,,14775,14775,0,0,0,0,10
,20130527,14775,14775,14785,14785,14745,14745,14765,-30,-10,14,103.38,24
,20130528,14745,14765,14730,14730,14730,14730,14730,-35,-35,18,132.57,34
,20130529,14730,14730,,,,14730,14730,0,0,0,0,34
,20130530,14730,14730,14890,14890,14635,14800,14840,70,110,14,103.89,46
,20130531,14800,14840,14930,14930,14930,14930,14930,90,90,2,14.93,46
,20130603,14930,14930,15020,15055,15020,15055,15035,125,105,4,30.08,46
,20130604,15055,15035,15015,15015,15015,15015,15015,-20,-20,2,15.02,46
,20130605,15015,15015,15155,15155,15155,15155,15155,140,140,2,15.16,44
,20130606,15155,15155,15025,15120,15025,15120,15060,-35,-95,36,271.1,36
,20130607,15120,15060,,,,15060,15060,0,0,0,0,36
,20130613,15060,15060,,,,15020,15020,-40,-40,0,0,36
,20130614,15020,15020,,,,15020,15020,0,0,0,0,36
,20130617,15020,15020,,,,14850,14850,-170,-170,0,0,36
,20130618,14850,14850,14745,14745,14640,14640,14660,-210,-190,32,234.57,58
,20130619,14640,14660,,,,14660,14660,0,0,0,0,58
,20130620,14660,14660,14515,14515,14515,14515,14515,-145,-145,2,14.52,60
,20130621,14515,14515,14505,14505,14380,14500,14480,-15,-35,22,159.32,64
,20130624,14500,14480,14500,14500,14405,14405,14480,-75,0,36,260.72,86
,20130625,14405,14480,14400,14545,14400,14545,14475,65,-5,8,57.92,88
,20130626,14545,14475,14430,14430,14390,14390,14410,-85,-65,12,86.46,88
,20130627,14390,14410,14455,14480,14455,14480,14465,70,55,4,28.94,88
,20130628,14480,14465,14405,14405,14405,14405,14405,-60,-60,12,86.43,88
,20130701,14405,14405,,,,14405,14405,0,0,0,0,88
,20130702,14405,14405,14500,14505,14500,14505,14500,100,95,4,29.01,88
,20130703,14505,14500,14505,14515,14505,14515,14510,15,10,28,203.17,96
,20130704,14515,14510,,,,14510,14510,0,0,0,0,96
,20130705,14510,14510,14450,14450,14450,14450,14450,-60,-60,2,14.45,96
,20130708,14450,14450,14350,14350,14350,14350,14350,-100,-100,6,43.05,102
,20130709,14350,14350,,,,14350,14350,0,0,0,0,102
,20130710,14350,14350,,,,14350,14350,0,0,0,0,102
,20130711,14350,14350,14470,14470,14435,14435,14450,85,100,8,57.81,102
,20130712,14435,14450,,,,14450,14450,0,0,0,0,102
,20130715,14450,14450,14430,14430,14430,14430,14430,-20,-20,2,14.43,102
,20130716,14430,14430,14405,14405,14405,14405,14405,-25,-25,2,14.41,102
,20130717,14405,14405,14455,14455,14455,14455,14455,50,50,2,14.46,100
,20130718,14455,14455,,,,14455,14455,0,0,0,0,100
,20130719,14455,14455,,,,14470,14470,15,15,0,0,100
,20130722,14470,14470,,,,14470,14470,0,0,0,0,100
,20130723,14470,14470,,,,14470,14470,0,0,0,0,100
,20130724,14470,14470,,,,14470,14470,0,0,0,0,100
,20130725,14470,14470,,,,14470,14470,0,0,0,0,100
,20130726,14470,14470,,,,14470,14470,0,0,0,0,100
,20130729,14470,14470,14370,14370,14370,14370,14370,-100,-100,2,14.37,100
,20130730,14370,14370,,,,14370,14370,0,0,0,0,100
,20130731,14370,14370,14325,14325,14320,14320,14320,-50,-50,6,42.97,100
,20130801,14320,14320,,,,14320,14320,0,0,0,0,100
,20130802,14320,14320,,,,14320,14320,0,0,0,0,100
,20130805,14320,14320,,,,14320,14320,0,0,0,0,100
,20130806,14320,14320,,,,14320,14320,0,0,0,0,100
,20130807,14320,14320,,,,14305,14305,-15,-15,0,0,100
,20130808,14305,14305,,,,14340,14340,35,35,0,0,100
,20130809,14340,14340,14415,14550,14415,14455,14475,115,135,44,318.51,120
,20130812,14455,14475,,,,14475,14475,0,0,0,0,120
,20130813,14475,14475,14530,14550,14525,14550,14540,75,65,14,101.81,126
,20130814,14550,14540,14500,14500,14470,14475,14480,-65,-60,10,72.42,132
,20130815,14475,14480,14560,14585,14560,14580,14575,100,95,8,58.31,128
,20130816,14580,14575,14600,14600,14590,14590,14590,15,15,6,43.78,132
,20130819,14590,14590,,,,14590,14590,0,0,0,0,132
,20130820,14590,14590,14500,14500,14500,14500,14500,-90,-90,2,14.5,130
,20130821,14500,14500,,,,14505,14505,5,5,0,0,130
,20130822,14505,14505,14510,14510,14510,14510,14510,5,5,2,14.51,128
,20130823,14510,14510,,,,14525,14525,15,15,0,0,128
,20130826,14525,14525,,,,14525,14525,0,0,0,0,128
,20130827,14525,14525,14595,14595,14595,14595,14595,70,70,10,72.98,136
,20130828,14595,14595,14545,14545,14505,14505,14530,-90,-65,8,58.14,138
,20130829,14505,14530,14470,14470,14415,14460,14445,-70,-85,6,43.35,134
,20130830,14460,14445,14355,14375,14345,14375,14350,-70,-95,14,100.47,138
,20130902,14375,14350,14345,14345,14345,14345,14345,-5,-5,14,100.42,124
,20130903,14345,14345,14350,14350,14330,14330,14335,-15,-10,84,602.27,204
,20130904,14330,14335,,,,14335,14335,0,0,0,0,204
,20130905,14335,14335,14240,14245,14240,14240,14240,-95,-95,44,313.29,236
,20130906,14240,14240,14300,14300,14235,14235,14260,-5,20,26,185.44,260
,20130909,14235,14260,14275,14275,14255,14275,14270,15,10,392,"2,797.08",578
,20130910,14275,14270,14210,14210,14200,14210,14205,-60,-65,72,511.53,608
,20130911,14210,14205,14205,14230,14200,14220,14210,15,5,64,454.77,614
,20130912,14220,14210,14210,14210,14210,14210,14210,0,0,2,14.21,614
,20130913,14210,14210,14220,14220,14220,14220,14220,10,10,20,142.2,614
,20130916,14220,14220,14215,14215,14205,14210,14210,-10,-10,76,539.98,650
,20130917,14210,14210,14120,14160,14120,14150,14150,-60,-60,104,736.01,712
,20130918,14150,14150,14150,14160,14150,14150,14150,0,0,142,"1,004.80",786
,20130923,14150,14150,14150,14150,14115,14150,14145,0,-5,58,410.25,778
,20130924,14150,14145,14170,14250,14170,14175,14190,30,45,8,56.78,776
,20130925,14175,14190,,,,14190,14190,0,0,0,0,776
,20130926,14190,14190,14180,14210,14180,14210,14185,20,-5,270,"1,915.45",782
,20130927,14210,14185,14235,14250,14210,14230,14235,45,50,238,"1,694.13",940
,20130930,14230,14235,14200,14285,14200,14285,14270,50,35,114,813.44,1020
,20131008,14285,14270,14310,14325,14300,14300,14315,30,45,260,"1,861.51",926
,20131009,14300,14315,14330,14335,14290,14290,14320,-25,5,514,"3,680.93",1006
,20131010,14290,14320,14320,14320,14290,14290,14295,-30,-25,160,"1,143.86",1130
,20131011,14290,14295,14350,14400,14350,14400,14355,105,60,164,"1,177.49",1168
,20131014,14400,14355,14385,14390,14375,14375,14380,20,25,20,143.84,1168
,20131015,14375,14380,14350,14350,14300,14300,14315,-80,-65,502,"3,593.39",1550
,20131016,14300,14315,14275,14285,14260,14260,14265,-55,-50,614,"4,379.40",2128
,20131017,14260,14265,14290,14305,14280,14300,14290,35,25,336,"2,401.33",2156
,20131018,14300,14290,14300,14300,14280,14295,14285,5,-5,60,428.56,2158
,20131021,14295,14285,14325,14330,14325,14330,14325,45,40,4,28.66,2154
,20131022,14330,14325,14330,14360,14325,14360,14335,35,10,590,"4,230.05",2586
,20131023,14360,14335,14395,14395,14360,14365,14375,30,40,436,"3,133.79",2584
,20131024,14365,14375,14330,14350,14320,14350,14330,-25,-45,18,129,2584
,20131025,14350,14330,14330,14335,14320,14320,14325,-10,-5,96,687.64,2584
,20131028,14320,14325,14365,14385,14360,14385,14375,60,50,128,920.05,2584
,20131029,14385,14375,14410,14425,14410,14415,14420,40,45,334,"2,408.31",2644
,20131030,14415,14420,14420,14455,14420,14455,14440,35,20,46,332.13,2648
,20131031,14455,14440,14405,14425,14385,14395,14405,-45,-35,1234,"8,889.16",3520
,20131101,14395,14405,14390,14415,14390,14415,14395,10,-10,1374,"9,892.56",4690
,20131104,14415,14395,14380,14400,14360,14365,14370,-30,-25,1048,"7,531.47",5518
,20131105,14365,14370,14350,14355,14325,14325,14335,-45,-35,312,"2,236.75",5678
,20131106,14325,14335,14300,14310,14290,14295,14295,-40,-40,750,"5,361.52",6244
,20131107,14295,14295,14300,14305,14290,14290,14290,-5,-5,516,"3,687.74",6604
,20131108,14290,14290,14280,14305,14280,14300,14290,10,0,770,"5,501.96",7004
,20131111,14300,14290,14230,14305,14230,14305,14285,15,-5,98,700.11,6978
,20131112,14305,14285,14255,14265,14235,14255,14245,-30,-40,158,"1,125.65",7014
,20131113,14255,14245,14235,14235,14200,14200,14210,-45,-35,480,"3,410.44",7328
,20131114,14200,14210,14250,14250,14170,14210,14185,0,-25,658,"4,667.46",7652
,20131115,14210,14185,14280,14280,14170,14170,14190,-15,5,836,"5,931.76",8262
,20131118,14170,14190,14190,14200,14180,14185,14185,-5,-5,374,"2,652.83",8466
,20131119,14185,14185,14165,14170,14150,14160,14155,-25,-30,310,"2,194.44",8622
,20131120,14160,14155,14180,14210,14180,14210,14190,55,35,164,"1,163.59",8618
,20131121,14210,14190,14160,14180,14130,14150,14140,-40,-50,1138,"8,046.18",9532
,20131122,14150,14140,14145,14145,14125,14125,14135,-15,-5,176,"1,244.04",9612
,20131125,14125,14135,14125,14125,14080,14090,14100,-45,-35,246,"1,734.80",9736
,20131126,14090,14100,14100,14105,14065,14090,14080,-10,-20,938,"6,605.74",10458
,20131127,14090,14080,14065,14100,14065,14085,14075,5,-5,738,"5,194.49",10720
,20131128,14085,14075,14020,14025,13980,13985,14005,-90,-70,3594,"25,168.35",13024
,20131129,13985,14005,14000,14000,13970,13985,13985,-20,-20,808,"5,650.63",13580
,20131202,13985,13985,13950,13985,13935,13980,13970,-5,-15,1544,"10,787.26",13958
,20131203,13980,13970,13910,13970,13910,13950,13940,-20,-30,1804,"12,578.02",14868
,20131204,13950,13940,13945,13985,13945,13960,13960,20,20,1032,"7,205.09",15402
,20131205,13960,13960,14005,14075,13990,14000,14010,40,50,1170,"8,196.47",15712
,20131206,14000,14010,13980,13985,13930,13945,13950,-65,-60,1882,"13,129.42",16274
,20131209,13945,13950,13990,13995,13965,13990,13975,40,25,1776,"12,414.13",16928
,20131210,13990,13975,14040,14040,14010,14035,14025,60,50,1042,"7,308.67",16860
,20131211,14035,14025,14045,14045,13990,14010,14010,-15,-15,1076,"7,539.40",17136
,20131212,14010,14010,14045,14045,14015,14015,14025,5,15,1532,"10,746.66",17208
,20131213,14015,14025,13965,13980,13940,13945,13960,-80,-65,1466,"10,233.84",18202
,20131216,13945,13960,13960,13975,13960,13960,13965,0,5,2554,"17,836.01",18220
,20131217,13960,13965,13970,13975,13925,13935,13940,-30,-25,912,"6,357.46",18774
,20131218,13935,13940,13940,13950,13930,13940,13940,0,0,774,"5,395.25",19132
,20131219,13940,13940,13960,13960,13915,13930,13940,-10,0,1320,"9,201.21",19994
,20131220,13930,13940,13900,13950,13880,13945,13920,5,-20,2246,"15,635.06",21166
,20131223,13945,13920,13980,13980,13940,13940,13950,20,30,3496,"24,392.97",22366
,20131224,13940,13950,13925,13945,13900,13920,13915,-30,-35,3982,"27,712.32",24836
,20131225,13920,13915,13920,13955,13885,13955,13925,40,10,2876,"20,024.41",26012
,20131226,13955,13925,13960,13965,13900,13920,13920,-5,-5,1466,"10,205.28",26844
,20131227,13920,13920,13920,13990,13895,13965,13945,45,25,2454,"17,113.25",26676
,20131230,13965,13945,14005,14080,13980,14010,14035,65,90,4214,"29,573.26",27166
,20131231,14010,14035,14030,14030,13930,13970,13955,-65,-80,6378,"44,514.87",30202
al1406,20130618,14850,14850,,,,14850,14850,0,0,0,0,0
,20130619,14850,14850,,,,14850,14850,0,0,0,0,0
,20130620,14850,14850,,,,14850,14850,0,0,0,0,0
,20130621,14850,14850,,,,14815,14815,-35,-35,0,0,0
,20130624,14815,14815,,,,14815,14815,0,0,0,0,0
,20130625,14815,14815,,,,14815,14815,0,0,0,0,0
,20130626,14815,14815,,,,14745,14745,-70,-70,0,0,0
,20130627,14745,14745,,,,14745,14745,0,0,0,0,0
,20130628,14745,14745,,,,14680,14680,-65,-65,0,0,0
,20130701,14680,14680,,,,14680,14680,0,0,0,0,0
,20130702,14680,14680,,,,14680,14680,0,0,0,0,0
,20130703,14680,14680,,,,14680,14680,0,0,0,0,0
,20130704,14680,14680,,,,14680,14680,0,0,0,0,0
,20130705,14680,14680,,,,14680,14680,0,0,0,0,0
,20130708,14680,14680,,,,14575,14575,-105,-105,0,0,0
,20130709,14575,14575,14575,14685,14500,14500,14570,-75,-5,38,276.83,2
,20130710,14500,14570,,,,14570,14570,0,0,0,0,2
,20130711,14570,14570,,,,14570,14570,0,0,0,0,2
,20130712,14570,14570,,,,14570,14570,0,0,0,0,2
,20130715,14570,14570,14560,14565,14440,14495,14520,-75,-50,132,958.63,2
,20130716,14495,14520,,,,14520,14520,0,0,0,0,2
,20130717,14520,14520,,,,14520,14520,0,0,0,0,2
,20130718,14520,14520,,,,14520,14520,0,0,0,0,2
,20130719,14520,14520,,,,14535,14535,15,15,0,0,2
,20130722,14535,14535,,,,14535,14535,0,0,0,0,2
,20130723,14535,14535,,,,14535,14535,0,0,0,0,2
,20130724,14535,14535,,,,14495,14495,-40,-40,0,0,2
,20130725,14495,14495,14635,14635,14530,14530,14580,35,85,4,29.17,4
,20130726,14530,14580,14520,14520,14520,14520,14520,-60,-60,2,14.52,4
,20130729,14520,14520,14450,14450,14450,14450,14450,-70,-70,2,14.45,4
,20130730,14450,14450,,,,14460,14460,10,10,0,0,4
,20130731,14460,14460,,,,14410,14410,-50,-50,0,0,4
,20130801,14410,14410,,,,14440,14440,30,30,0,0,4
,20130802,14440,14440,,,,14430,14430,-10,-10,0,0,4
,20130805,14430,14430,,,,14440,14440,10,10,0,0,4
,20130806,14440,14440,,,,14420,14420,-20,-20,0,0,4
,20130807,14420,14420,,,,14405,14405,-15,-15,0,0,4
,20130808,14405,14405,,,,14445,14445,40,40,0,0,4
,20130809,14445,14445,,,,14580,14580,135,135,0,0,4
,20130812,14580,14580,,,,14615,14615,35,35,0,0,4
,20130813,14615,14615,,,,14680,14680,65,65,0,0,4
,20130814,14680,14680,,,,14620,14620,-60,-60,0,0,4
,20130815,14620,14620,14625,14625,14625,14625,14625,5,5,2,14.63,4
,20130816,14625,14625,,,,14640,14640,15,15,0,0,4
,20130819,14640,14640,14650,14650,14650,14650,14650,10,10,2,14.65,2
,20130820,14650,14650,,,,14555,14555,-95,-95,0,0,2
,20130821,14555,14555,,,,14490,14490,-65,-65,0,0,2
,20130822,14490,14490,,,,14490,14490,0,0,0,0,2
,20130823,14490,14490,,,,14505,14505,15,15,0,0,2
,20130826,14505,14505,,,,14505,14505,0,0,0,0,2
,20130827,14505,14505,14645,14645,14600,14600,14620,95,115,20,146.23,12
,20130828,14600,14620,,,,14620,14620,0,0,0,0,12
,20130829,14620,14620,,,,14620,14620,0,0,0,0,12
,20130830,14620,14620,,,,14410,14410,-210,-210,0,0,12
,20130902,14410,14410,,,,14410,14410,0,0,0,0,12
,20130903,14410,14410,,,,14410,14410,0,0,0,0,12
,20130904,14410,14410,,,,14410,14410,0,0,0,0,12
,20130905,14410,14410,,,,14270,14270,-140,-140,0,0,12
,20130906,14270,14270,14300,14300,14245,14285,14275,15,5,6,42.83,14
,20130909,14285,14275,,,,14275,14275,0,0,0,0,14
,20130910,14275,14275,,,,14260,14260,-15,-15,0,0,14
,20130911,14260,14260,,,,14250,14250,-10,-10,0,0,14
,20130912,14250,14250,,,,14250,14250,0,0,0,0,14
,20130913,14250,14250,,,,14260,14260,10,10,0,0,14
,20130916,14260,14260,,,,14250,14250,-10,-10,0,0,14
,20130917,14250,14250,14150,14150,14150,14150,14150,-100,-100,2,14.15,16
,20130918,14150,14150,,,,14150,14150,0,0,0,0,16
,20130923,14150,14150,14130,14175,14130,14165,14140,15,-10,44,311.17,38
,20130924,14165,14140,14200,14255,14200,14240,14225,100,85,8,56.91,36
,20130925,14240,14225,,,,14225,14225,0,0,0,0,36
,20130926,14225,14225,,,,14225,14225,0,0,0,0,36
,20130927,14225,14225,14250,14270,14250,14270,14260,45,35,8,57.04,28
,20130930,14270,14260,,,,14260,14260,0,0,0,0,28
,20131008,14260,14260,,,,14260,14260,0,0,0,0,28
,20131009,14260,14260,,,,14260,14260,0,0,0,0,28
,20131010,14260,14260,,,,14285,14285,25,25,0,0,28
,20131011,14285,14285,14380,14490,14380,14490,14380,205,95,46,330.85,74
,20131014,14490,14380,,,,14380,14380,0,0,0,0,74
,20131015,14380,14380,14330,14330,14330,14330,14330,-50,-50,2,14.33,76
,20131016,14330,14330,14275,14275,14275,14275,14275,-55,-55,2,14.28,78
,20131017,14275,14275,,,,14275,14275,0,0,0,0,78
,20131018,14275,14275,,,,14270,14270,-5,-5,0,0,78
,20131021,14270,14270,14350,14360,14350,14360,14355,90,85,6,43.07,78
,20131022,14360,14355,14385,14385,14385,14385,14385,30,30,10,71.93,88
,20131023,14385,14385,14385,14385,14385,14385,14385,0,0,22,158.24,100
,20131024,14385,14385,14365,14365,14360,14360,14360,-25,-25,4,28.73,102
,20131025,14360,14360,14380,14380,14345,14345,14365,-15,5,30,215.53,124
,20131028,14345,14365,14410,14410,14405,14405,14405,40,40,20,144.08,144
,20131029,14405,14405,14440,14440,14435,14435,14435,30,30,48,346.45,182
,20131030,14435,14435,14460,14460,14460,14460,14460,25,25,8,57.84,182
,20131031,14460,14460,14445,14445,14445,14445,14445,-15,-15,4,28.89,178
,20131101,14445,14445,,,,14435,14435,-10,-10,0,0,178
,20131104,14435,14435,14400,14400,14400,14400,14400,-35,-35,2,14.4,178
,20131105,14400,14400,14370,14370,14370,14370,14370,-30,-30,60,431.1,218
,20131106,14370,14370,14355,14355,14325,14330,14335,-40,-35,312,"2,236.73",408
,20131107,14330,14335,14340,14340,14320,14330,14330,-5,-5,20,143.3,416
,20131108,14330,14330,14320,14320,14315,14315,14315,-15,-15,60,429.48,476
,20131111,14315,14315,,,,14310,14310,-5,-5,0,0,476
,20131112,14310,14310,14280,14280,14280,14280,14280,-30,-30,30,214.2,506
,20131113,14280,14280,14280,14280,14230,14235,14240,-45,-40,162,"1,153.70",582
,20131114,14235,14240,14220,14235,14200,14230,14225,-10,-15,76,540.66,648
,20131115,14230,14225,14215,14220,14215,14220,14215,-5,-10,72,511.87,688
,20131118,14220,14215,14210,14230,14200,14230,14200,15,-15,100,710.22,688
,20131119,14230,14200,14165,14165,14165,14165,14165,-35,-35,40,283.3,688
,20131120,14165,14165,14205,14215,14205,14215,14210,50,45,26,184.77,714
,20131121,14215,14210,14165,14185,14150,14170,14160,-40,-50,344,"2,435.67",994
,20131122,14170,14160,14160,14160,14150,14150,14155,-10,-5,6,42.47,998
,20131125,14150,14155,14165,14170,14105,14105,14125,-50,-30,466,"3,291.84",1158
,20131126,14105,14125,14105,14120,14090,14110,14095,-15,-30,662,"4,666.24",1630
,20131127,14110,14095,14120,14120,14080,14080,14080,-15,-15,84,591.4,1688
,20131128,14080,14080,14010,14020,13995,13995,14005,-85,-75,1282,"8,978.74",2536
,20131129,13995,14005,13990,14005,13985,14005,13995,0,-10,266,"1,861.60",2648
,20131202,14005,13995,13975,13990,13975,13985,13980,-10,-15,718,"5,019.10",3144
,20131203,13985,13980,13950,13980,13940,13955,13950,-25,-30,1494,"10,424.12",4188
,20131204,13955,13950,13950,13995,13950,13970,13965,20,15,544,"3,799.33",4500
,20131205,13970,13965,14015,14025,13995,13995,14010,30,45,648,"4,540.22",4970
,20131206,13995,14010,13970,13970,13935,13950,13945,-60,-65,852,"5,942.34",5326
,20131209,13950,13945,14035,14035,13955,14000,13975,55,30,782,"5,464.48",5814
,20131210,14000,13975,14050,14050,14000,14030,14015,55,40,554,"3,883.32",6030
,20131211,14030,14015,14025,14025,13970,14005,14000,-10,-15,604,"4,228.78",6334
,20131212,14005,14000,14030,14030,13990,14005,14015,5,15,562,"3,938.64",6752
,20131213,14005,14015,13945,13965,13925,13945,13940,-70,-75,604,"4,210.55",7202
,20131216,13945,13940,13950,13970,13940,13955,13955,15,15,306,"2,135.50",7408
,20131217,13955,13955,13930,13950,13920,13920,13930,-35,-25,544,"3,789.75",7886
,20131218,13920,13930,13930,13960,13920,13940,13935,10,5,966,"6,730.66",8318
,20131219,13940,13935,13945,13945,13920,13940,13935,5,0,1090,"7,595.17",8928
,20131220,13940,13935,13885,13955,13885,13945,13925,10,-10,1172,"8,161.85",9612
,20131223,13945,13925,13945,13990,13940,13945,13955,20,30,2080,"14,518.35",10944
,20131224,13945,13955,13985,13985,13900,13930,13915,-25,-40,1668,"11,607.72",11928
,20131225,13930,13915,13900,13950,13890,13950,13920,35,5,1584,"11,026.27",11940
,20131226,13950,13920,13950,13965,13900,13920,13920,0,0,572,"3,982.53",12324
,20131227,13920,13920,13900,13995,13895,13965,13945,45,25,1862,"12,985.55",13192
,20131230,13965,13945,14020,14070,14010,14015,14040,70,95,1668,"11,711.51",13874
,20131231,14015,14040,14010,14010,13925,13975,13945,-65,-95,2172,"15,148.58",15170
al1407,20130716,14520,14520,,,,14520,14520,0,0,0,0,0
,20130717,14520,14520,,,,14520,14520,0,0,0,0,0
,20130718,14520,14520,,,,14520,14520,0,0,0,0,0
,20130719,14520,14520,,,,14520,14520,0,0,0,0,0
,20130722,14520,14520,,,,14520,14520,0,0,0,0,0
,20130723,14520,14520,,,,14520,14520,0,0,0,0,0
,20130724,14520,14520,,,,14520,14520,0,0,0,0,0
,20130725,14520,14520,,,,14520,14520,0,0,0,0,0
,20130726,14520,14520,,,,14460,14460,-60,-60,0,0,0
,20130729,14460,14460,,,,14390,14390,-70,-70,0,0,0
,20130730,14390,14390,,,,14400,14400,10,10,0,0,0
,20130731,14400,14400,,,,14350,14350,-50,-50,0,0,0
,20130801,14350,14350,,,,14350,14350,0,0,0,0,0
,20130802,14350,14350,,,,14340,14340,-10,-10,0,0,0
,20130805,14340,14340,14535,14535,14355,14355,14445,15,105,4,28.89,2
,20130806,14355,14445,,,,14425,14425,-20,-20,0,0,2
,20130807,14425,14425,,,,14410,14410,-15,-15,0,0,2
,20130808,14410,14410,,,,14450,14450,40,40,0,0,2
,20130809,14450,14450,,,,14585,14585,135,135,0,0,2
,20130812,14585,14585,,,,14620,14620,35,35,0,0,2
,20130813,14620,14620,,,,14685,14685,65,65,0,0,2
,20130814,14685,14685,,,,14625,14625,-60,-60,0,0,2
,20130815,14625,14625,,,,14630,14630,5,5,0,0,2
,20130816,14630,14630,,,,14645,14645,15,15,0,0,2
,20130819,14645,14645,,,,14655,14655,10,10,0,0,2
,20130820,14655,14655,,,,14560,14560,-95,-95,0,0,2
,20130821,14560,14560,,,,14495,14495,-65,-65,0,0,2
,20130822,14495,14495,,,,14495,14495,0,0,0,0,2
,20130823,14495,14495,,,,14510,14510,15,15,0,0,2
,20130826,14510,14510,,,,14510,14510,0,0,0,0,2
,20130827,14510,14510,,,,14510,14510,0,0,0,0,2
,20130828,14510,14510,,,,14510,14510,0,0,0,0,2
,20130829,14510,14510,,,,14510,14510,0,0,0,0,2
,20130830,14510,14510,14430,14430,14430,14430,14430,-80,-80,2,14.43,2
,20130902,14430,14430,14420,14420,14420,14420,14420,-10,-10,20,144.2,22
,20130903,14420,14420,,,,14420,14420,0,0,0,0,22
,20130904,14420,14420,,,,14420,14420,0,0,0,0,22
,20130905,14420,14420,,,,14300,14300,-120,-120,0,0,22
,20130906,14300,14300,,,,14300,14300,0,0,0,0,22
,20130909,14300,14300,,,,14300,14300,0,0,0,0,22
,20130910,14300,14300,,,,14280,14280,-20,-20,0,0,22
,20130911,14280,14280,,,,14280,14280,0,0,0,0,22
,20130912,14280,14280,,,,14280,14280,0,0,0,0,22
,20130913,14280,14280,,,,14290,14290,10,10,0,0,22
,20130916,14290,14290,,,,14280,14280,-10,-10,0,0,22
,20130917,14280,14280,,,,14235,14235,-45,-45,0,0,22
,20130918,14235,14235,,,,14235,14235,0,0,0,0,22
,20130923,14235,14235,14185,14195,14185,14195,14190,-40,-45,4,28.38,22
,20130924,14195,14190,14260,14260,14260,14260,14260,70,70,2,14.26,22
,20130925,14260,14260,14240,14240,14240,14240,14240,-20,-20,2,14.24,22
,20130926,14240,14240,,,,14240,14240,0,0,0,0,22
,20130927,14240,14240,14245,14245,14245,14245,14245,5,5,4,28.49,22
,20130930,14245,14245,,,,14280,14280,35,35,0,0,22
,20131008,14280,14280,,,,14280,14280,0,0,0,0,22
,20131009,14280,14280,,,,14280,14280,0,0,0,0,22
,20131010,14280,14280,14350,14350,14350,14350,14350,70,70,12,86.1,32
,20131011,14350,14350,,,,14450,14450,100,100,0,0,32
,20131014,14450,14450,14455,14455,14400,14400,14405,-50,-45,22,158.46,50
,20131015,14400,14405,14400,14400,14380,14380,14390,-25,-15,84,604.49,134
,20131016,14380,14390,14290,14290,14290,14290,14290,-100,-100,2,14.29,136
,20131017,14290,14290,,,,14290,14290,0,0,0,0,136
,20131018,14290,14290,,,,14300,14300,10,10,0,0,136
,20131021,14300,14300,14365,14370,14365,14370,14365,70,65,4,28.74,134
,20131022,14370,14365,,,,14365,14365,0,0,0,0,134
,20131023,14365,14365,,,,14365,14365,0,0,0,0,134
,20131024,14365,14365,,,,14365,14365,0,0,0,0,134
,20131025,14365,14365,14290,14290,14290,14290,14290,-75,-75,12,85.74,134
,20131028,14290,14290,14370,14425,14370,14425,14375,135,85,20,143.78,134
,20131029,14425,14375,14435,14435,14435,14435,14435,60,60,100,721.75,34
,20131030,14435,14435,14420,14470,14410,14470,14440,35,5,58,418.85,22
,20131031,14470,14440,14440,14440,14440,14440,14440,0,0,20,144.4,42
,20131101,14440,14440,,,,14440,14440,0,0,0,0,42
,20131104,14440,14440,14410,14410,14410,14410,14410,-30,-30,10,72.05,52
,20131105,14410,14410,,,,14410,14410,0,0,0,0,52
,20131106,14410,14410,14415,14415,14330,14330,14380,-80,-30,136,977.87,152
,20131107,14330,14380,14350,14350,14345,14345,14345,-35,-35,6,43.05,154
,20131108,14345,14345,,,,14330,14330,-15,-15,0,0,154
,20131111,14330,14330,,,,14325,14325,-5,-5,0,0,154
,20131112,14325,14325,14290,14300,14290,14300,14290,-25,-35,24,171.51,154
,20131113,14300,14290,14295,14295,14260,14260,14275,-30,-15,4,28.56,158
,20131114,14260,14275,14220,14290,14220,14275,14270,0,-5,144,"1,027.71",242
,20131115,14275,14270,14230,14240,14230,14240,14235,-30,-35,40,284.7,282
,20131118,14240,14235,14245,14245,14240,14240,14240,5,5,38,270.61,264
,20131119,14240,14240,14230,14230,14220,14225,14220,-15,-20,110,782.28,264
,20131120,14225,14220,,,,14265,14265,45,45,0,0,264
,20131121,14265,14265,14200,14200,14180,14180,14185,-85,-80,26,184.45,270
,20131122,14180,14185,14195,14195,14180,14180,14180,-5,-5,16,113.46,272
,20131125,14180,14180,14155,14155,14145,14145,14145,-35,-35,52,367.78,322
,20131126,14145,14145,,,,14115,14115,-30,-30,0,0,322
,20131127,14115,14115,,,,14100,14100,-15,-15,0,0,322
,20131128,14100,14100,14025,14025,14015,14015,14015,-85,-85,12,84.1,324
,20131129,14015,14015,14030,14035,14015,14030,14025,15,10,290,"2,034.32",568
,20131202,14030,14025,14030,14030,14010,14015,14020,-10,-5,252,"1,766.52",696
,20131203,14015,14020,13990,13990,13970,13970,13980,-50,-40,8,55.92,696
,20131204,13970,13980,13995,14000,13985,14000,13995,20,15,320,"2,239.30",738
,20131205,14000,13995,14010,14040,14000,14000,14015,5,20,500,"3,504.32",1008
,20131206,14000,14015,13990,13995,13940,13960,13950,-55,-65,324,"2,260.71",1162
,20131209,13960,13950,13980,13985,13955,13985,13965,35,15,88,614.64,1166
,20131210,13985,13965,14040,14040,14020,14025,14025,60,60,134,939.93,1222
,20131211,14025,14025,14035,14040,13985,14015,14010,-10,-15,344,"2,410.16",1480
,20131212,14015,14010,14100,14145,14000,14010,14040,0,30,224,"1,572.88",1564
,20131213,14010,14040,13955,13960,13930,13945,13945,-95,-95,108,753.12,1656
,20131216,13945,13945,13965,13965,13940,13960,13960,15,15,254,"1,773.07",1782
,20131217,13960,13960,13980,13980,13920,13935,13925,-25,-35,104,724.17,1836
,20131218,13935,13925,13900,13945,13900,13940,13935,15,10,688,"4,793.72",2288
,20131219,13940,13935,13905,13935,13905,13935,13925,0,-10,146,"1,016.89",2328
,20131220,13935,13925,13940,13945,13940,13945,13940,20,15,60,418.25,2374
,20131223,13945,13940,13960,13970,13950,13955,13960,15,20,250,"1,745.29",2442
,20131224,13955,13960,13925,13940,13900,13900,13925,-60,-35,208,"1,448.54",2504
,20131225,13900,13925,13915,13945,13905,13945,13935,20,10,210,"1,463.33",2654
,20131226,13945,13935,13950,13950,13905,13910,13910,-25,-25,76,528.7,2696
,20131227,13910,13910,13905,13990,13890,13975,13940,65,30,514,"3,583.34",3010
,20131230,13975,13940,14010,14080,14010,14020,14035,80,95,462,"3,242.57",3284
,20131231,14020,14035,13980,13980,13910,13980,13950,-55,-85,332,"2,316.22",3290
al1408,20130816,14630,14630,,,,14645,14645,15,15,0,0,0
,20130819,14645,14645,,,,14655,14655,10,10,0,0,0
,20130820,14655,14655,,,,14560,14560,-95,-95,0,0,0
,20130821,14560,14560,,,,14560,14560,0,0,0,0,0
,20130822,14560,14560,14650,14720,14550,14570,14620,10,60,20,146.23,2
,20130823,14570,14620,14605,14605,14605,14605,14605,-15,-15,2,14.61,2
,20130826,14605,14605,,,,14605,14605,0,0,0,0,2
,20130827,14605,14605,,,,14605,14605,0,0,0,0,2
,20130828,14605,14605,,,,14605,14605,0,0,0,0,2
,20130829,14605,14605,,,,14605,14605,0,0,0,0,2
,20130830,14605,14605,,,,14605,14605,0,0,0,0,2
,20130902,14605,14605,14455,14460,14450,14450,14455,-155,-150,36,260.22,30
,20130903,14450,14455,,,,14455,14455,0,0,0,0,30
,20130904,14455,14455,,,,14455,14455,0,0,0,0,30
,20130905,14455,14455,14375,14375,14375,14375,14375,-80,-80,2,14.38,30
,20130906,14375,14375,14350,14350,14300,14350,14325,-25,-50,16,114.6,36
,20130909,14350,14325,14310,14380,14310,14380,14350,55,25,16,114.83,30
,20130910,14380,14350,,,,14320,14320,-30,-30,0,0,30
,20130911,14320,14320,,,,14320,14320,0,0,0,0,30
,20130912,14320,14320,,,,14300,14300,-20,-20,0,0,30
,20130913,14300,14300,,,,14310,14310,10,10,0,0,30
,20130916,14310,14310,,,,14290,14290,-20,-20,0,0,30
,20130917,14290,14290,,,,14280,14280,-10,-10,0,0,30
,20130918,14280,14280,,,,14280,14280,0,0,0,0,30
,20130923,14280,14280,,,,14230,14230,-50,-50,0,0,30
,20130924,14230,14230,14320,14320,14320,14320,14320,90,90,2,14.32,30
,20130925,14320,14320,,,,14315,14315,-5,-5,0,0,30
,20130926,14315,14315,,,,14315,14315,0,0,0,0,30
,20130927,14315,14315,,,,14320,14320,5,5,0,0,30
,20130930,14320,14320,,,,14355,14355,35,35,0,0,30
,20131008,14355,14355,,,,14355,14355,0,0,0,0,30
,20131009,14355,14355,,,,14355,14355,0,0,0,0,30
,20131010,14355,14355,,,,14355,14355,0,0,0,0,30
,20131011,14355,14355,,,,14355,14355,0,0,0,0,30
,20131014,14355,14355,,,,14355,14355,0,0,0,0,30
,20131015,14355,14355,14440,14440,14415,14415,14435,60,80,34,245.4,62
,20131016,14415,14435,,,,14330,14330,-105,-105,0,0,62
,20131017,14330,14330,,,,14330,14330,0,0,0,0,62
,20131018,14330,14330,,,,14345,14345,15,15,0,0,62
,20131021,14345,14345,,,,14345,14345,0,0,0,0,62
,20131022,14345,14345,,,,14345,14345,0,0,0,0,62
,20131023,14345,14345,,,,14345,14345,0,0,0,0,62
,20131024,14345,14345,,,,14320,14320,-25,-25,0,0,62
,20131025,14320,14320,,,,14245,14245,-75,-75,0,0,62
,20131028,14245,14245,,,,14245,14245,0,0,0,0,62
,20131029,14245,14245,14425,14425,14425,14425,14425,180,180,2,14.43,62
,20131030,14425,14425,14485,14485,14480,14485,14480,60,55,36,260.73,60
,20131031,14485,14480,,,,14480,14480,0,0,0,0,60
,20131101,14480,14480,,,,14470,14470,-10,-10,0,0,60
,20131104,14470,14470,,,,14470,14470,0,0,0,0,60
,20131105,14470,14470,,,,14470,14470,0,0,0,0,60
,20131106,14470,14470,14350,14350,14350,14350,14350,-120,-120,2,14.35,58
,20131107,14350,14350,,,,14350,14350,0,0,0,0,58
,20131108,14350,14350,,,,14335,14335,-15,-15,0,0,58
,20131111,14335,14335,,,,14330,14330,-5,-5,0,0,58
,20131112,14330,14330,,,,14295,14295,-35,-35,0,0,58
,20131113,14295,14295,,,,14280,14280,-15,-15,0,0,58
,20131114,14280,14280,14280,14360,14280,14360,14315,80,35,62,443.8,104
,20131115,14360,14315,14285,14285,14285,14285,14285,-30,-30,2,14.29,104
,20131118,14285,14285,14260,14280,14260,14280,14275,-5,-10,18,128.48,100
,20131119,14280,14275,,,,14255,14255,-20,-20,0,0,100
,20131120,14255,14255,14280,14290,14280,14280,14280,25,25,60,428.5,140
,20131121,14280,14280,14215,14215,14215,14215,14215,-65,-65,2,14.22,138
,20131122,14215,14215,,,,14210,14210,-5,-5,0,0,138
,20131125,14210,14210,,,,14200,14200,-10,-10,0,0,138
,20131126,14200,14200,,,,14170,14170,-30,-30,0,0,138
,20131127,14170,14170,14150,14160,14150,14160,14150,-10,-20,44,311.36,140
,20131128,14160,14150,14060,14100,14055,14055,14065,-95,-85,126,886.12,218
,20131129,14055,14065,14060,14060,14060,14060,14060,-5,-5,2,14.06,218
,20131202,14060,14060,14065,14075,14055,14055,14065,-5,5,24,168.81,224
,20131203,14055,14065,14020,14020,14020,14020,14020,-45,-45,2,14.02,224
,20131204,14020,14020,14000,14020,14000,14005,14010,-15,-10,32,224.19,242
,20131205,14005,14010,,,,14010,14010,0,0,0,0,242
,20131206,14010,14010,13970,13970,13960,13970,13965,-40,-45,30,209.48,242
,20131209,13970,13965,13985,14005,13980,13980,13985,15,20,92,643.44,310
,20131210,13980,13985,14050,14050,14020,14020,14045,35,60,22,154.52,310
,20131211,14020,14045,14080,14080,14010,14030,14025,-15,-20,100,701.35,364
,20131212,14030,14025,,,,14025,14025,0,0,0,0,364
,20131213,14025,14025,13955,13960,13955,13955,13955,-70,-70,6,41.87,370
,20131216,13955,13955,13990,13990,13950,13955,13970,0,15,130,908.11,420
,20131217,13955,13970,13945,13945,13940,13940,13940,-30,-30,4,27.89,418
,20131218,13940,13940,13940,13950,13930,13930,13935,-10,-5,356,"2,480.88",732
,20131219,13930,13935,13950,13950,13925,13925,13925,-10,-10,82,571.08,732
,20131220,13925,13925,,,,13940,13940,15,15,0,0,732
,20131223,13940,13940,13940,13975,13940,13975,13960,35,20,328,"2,289.93",966
,20131224,13975,13960,13925,13950,13925,13950,13945,-10,-15,276,"1,924.88",1116
,20131225,13950,13945,13930,13950,13920,13950,13940,5,-5,286,"1,993.70",1308
,20131226,13950,13940,13980,13980,13905,13905,13915,-35,-25,58,403.67,1334
,20131227,13905,13915,13925,13995,13925,13980,13950,65,35,676,"4,715.45",1794
,20131230,13980,13950,14020,14130,14020,14025,14060,75,110,198,"1,392.09",1906
,20131231,14025,14060,13985,14000,13910,13995,13970,-65,-90,110,768.5,1938
al1409,20130917,14290,14290,,,,14290,14290,0,0,0,0,0
,20130918,14290,14290,,,,14290,14290,0,0,0,0,0
,20130923,14290,14290,,,,14290,14290,0,0,0,0,0
,20130924,14290,14290,14370,14370,14370,14370,14370,80,80,2,14.37,2
,20130925,14370,14370,14325,14325,14325,14325,14325,-45,-45,2,14.33,2
,20130926,14325,14325,,,,14325,14325,0,0,0,0,2
,20130927,14325,14325,,,,14330,14330,5,5,0,0,2
,20130930,14330,14330,,,,14365,14365,35,35,0,0,2
,20131008,14365,14365,,,,14365,14365,0,0,0,0,2
,20131009,14365,14365,,,,14365,14365,0,0,0,0,2
,20131010,14365,14365,14375,14375,14375,14375,14375,10,10,2,14.38,2
,20131011,14375,14375,,,,14475,14475,100,100,0,0,2
,20131014,14475,14475,,,,14475,14475,0,0,0,0,2
,20131015,14475,14475,14440,14440,14390,14390,14430,-85,-45,24,173.18,26
,20131016,14390,14430,,,,14325,14325,-105,-105,0,0,26
,20131017,14325,14325,,,,14325,14325,0,0,0,0,26
,20131018,14325,14325,,,,14325,14325,0,0,0,0,26
,20131021,14325,14325,,,,14390,14390,65,65,0,0,26
,20131022,14390,14390,,,,14390,14390,0,0,0,0,26
,20131023,14390,14390,,,,14390,14390,0,0,0,0,26
,20131024,14390,14390,,,,14365,14365,-25,-25,0,0,26
,20131025,14365,14365,,,,14290,14290,-75,-75,0,0,26
,20131028,14290,14290,,,,14290,14290,0,0,0,0,26
,20131029,14290,14290,,,,14440,14440,150,150,0,0,26
,20131030,14440,14440,,,,14440,14440,0,0,0,0,26
,20131031,14440,14440,,,,14440,14440,0,0,0,0,26
,20131101,14440,14440,,,,14440,14440,0,0,0,0,26
,20131104,14440,14440,14440,14440,14440,14440,14440,0,0,20,144.4,46
,20131105,14440,14440,,,,14440,14440,0,0,0,0,46
,20131106,14440,14440,,,,14440,14440,0,0,0,0,46
,20131107,14440,14440,,,,14440,14440,0,0,0,0,46
,20131108,14440,14440,,,,14425,14425,-15,-15,0,0,46
,20131111,14425,14425,,,,14420,14420,-5,-5,0,0,46
,20131112,14420,14420,,,,14420,14420,0,0,0,0,46
,20131113,14420,14420,,,,14405,14405,-15,-15,0,0,46
,20131114,14405,14405,14325,14350,14320,14320,14340,-85,-65,36,258.19,80
,20131115,14320,14340,14380,14380,14330,14330,14370,-10,30,34,244.32,108
,20131118,14330,14370,,,,14370,14370,0,0,0,0,108
,20131119,14370,14370,,,,14300,14300,-70,-70,0,0,108
,20131120,14300,14300,,,,14325,14325,25,25,0,0,108
,20131121,14325,14325,14250,14250,14250,14250,14250,-75,-75,8,57,108
,20131122,14250,14250,,,,14245,14245,-5,-5,0,0,108
,20131125,14245,14245,,,,14230,14230,-15,-15,0,0,108
,20131126,14230,14230,,,,14200,14200,-30,-30,0,0,108
,20131127,14200,14200,,,,14180,14180,-20,-20,0,0,108
,20131128,14180,14180,14110,14110,14090,14090,14100,-90,-80,38,267.99,146
,20131129,14090,14100,14100,14100,14090,14090,14095,-10,-5,82,577.9,228
,20131202,14090,14095,14090,14125,14085,14085,14095,-10,0,68,479.31,288
,20131203,14085,14095,14055,14055,14055,14055,14055,-40,-40,2,14.06,288
,20131204,14055,14055,,,,14055,14055,0,0,0,0,288
,20131205,14055,14055,14075,14085,14075,14085,14080,30,25,12,84.5,298
,20131206,14085,14080,14000,14000,13965,13990,13980,-90,-100,70,489.47,302
,20131209,13990,13980,14005,14025,14000,14000,14000,20,20,44,308.08,306
,20131210,14000,14000,14070,14070,14020,14055,14045,55,45,6,42.15,308
,20131211,14055,14045,14020,14035,14015,14035,14020,-10,-25,160,"1,122.00",366
,20131212,14035,14020,,,,14020,14020,0,0,0,0,366
,20131213,14020,14020,13960,13960,13960,13960,13960,-60,-60,36,251.28,402
,20131216,13960,13960,13960,13960,13955,13960,13955,0,-5,68,474.62,444
,20131217,13960,13955,13940,13940,13940,13940,13940,-15,-15,2,13.94,444
,20131218,13940,13940,13950,13950,13945,13945,13945,5,5,34,237.12,464
,20131219,13945,13945,13940,13945,13930,13935,13935,-10,-10,82,571.35,534
,20131220,13935,13935,,,,13950,13950,15,15,0,0,534
,20131223,13950,13950,13975,13975,13960,13970,13960,20,10,46,321.12,532
,20131224,13970,13960,,,,13960,13960,0,0,0,0,532
,20131225,13960,13960,,,,13960,13960,0,0,0,0,532
,20131226,13960,13960,13935,13935,13935,13935,13935,-25,-25,2,13.94,532
,20131227,13935,13935,,,,13970,13970,35,35,0,0,532
,20131230,13970,13970,14090,14090,14030,14035,14060,65,90,84,590.57,610
,20131231,14035,14060,13960,13960,13955,13955,13955,-105,-105,28,195.38,634
al1410,20131016,14430,14430,,,,14325,14325,-105,-105,0,0,0
,20131017,14325,14325,,,,14325,14325,0,0,0,0,0
,20131018,14325,14325,,,,14320,14320,-5,-5,0,0,0
,20131021,14320,14320,,,,14385,14385,65,65,0,0,0
,20131022,14385,14385,,,,14385,14385,0,0,0,0,0
,20131023,14385,14385,,,,14385,14385,0,0,0,0,0
,20131024,14385,14385,,,,14360,14360,-25,-25,0,0,0
,20131025,14360,14360,,,,14285,14285,-75,-75,0,0,0
,20131028,14285,14285,,,,14285,14285,0,0,0,0,0
,20131029,14285,14285,,,,14285,14285,0,0,0,0,0
,20131030,14285,14285,,,,14340,14340,55,55,0,0,0
,20131031,14340,14340,,,,14450,14450,110,110,0,0,0
,20131101,14450,14450,,,,14440,14440,-10,-10,0,0,0
,20131104,14440,14440,,,,14440,14440,0,0,0,0,0
,20131105,14440,14440,14280,14540,14280,14400,14405,-40,-35,12,86.44,0
,20131106,14400,14405,,,,14405,14405,0,0,0,0,0
,20131107,14405,14405,,,,14405,14405,0,0,0,0,0
,20131108,14405,14405,,,,14390,14390,-15,-15,0,0,0
,20131111,14390,14390,,,,14390,14390,0,0,0,0,0
,20131112,14390,14390,,,,14390,14390,0,0,0,0,0
,20131113,14390,14390,,,,14390,14390,0,0,0,0,0
,20131114,14390,14390,14345,14355,14345,14355,14350,-35,-40,4,28.7,4
,20131115,14355,14350,14445,14445,14380,14380,14405,30,55,88,633.84,62
,20131118,14380,14405,,,,14395,14395,-10,-10,0,0,62
,20131119,14395,14395,,,,14330,14330,-65,-65,0,0,62
,20131120,14330,14330,,,,14355,14355,25,25,0,0,62
,20131121,14355,14355,,,,14275,14275,-80,-80,0,0,62
,20131122,14275,14275,,,,14270,14270,-5,-5,0,0,62
,20131125,14270,14270,,,,14235,14235,-35,-35,0,0,62
,20131126,14235,14235,,,,14205,14205,-30,-30,0,0,62
,20131127,14205,14205,,,,14185,14185,-20,-20,0,0,62
,20131128,14185,14185,14120,14120,14110,14110,14115,-75,-70,36,254.08,98
,20131129,14110,14115,14100,14150,14100,14130,14125,15,10,30,211.93,122
,20131202,14130,14125,14130,14160,14110,14125,14125,0,0,66,466.25,160
,20131203,14125,14125,,,,14110,14110,-15,-15,0,0,160
,20131204,14110,14110,,,,14110,14110,0,0,0,0,160
,20131205,14110,14110,14110,14110,14110,14110,14110,0,0,6,42.33,160
,20131206,14110,14110,14030,14030,14030,14030,14030,-80,-80,2,14.03,160
,20131209,14030,14030,,,,14030,14030,0,0,0,0,160
,20131210,14030,14030,,,,14030,14030,0,0,0,0,160
,20131211,14030,14030,14065,14065,14030,14030,14050,0,20,20,140.51,172
,20131212,14030,14050,14050,14050,14050,14050,14050,0,0,2,14.05,174
,20131213,14050,14050,13980,13980,13980,13980,13980,-70,-70,36,251.64,210
,20131216,13980,13980,13975,13975,13975,13975,13975,-5,-5,2,13.98,212
,20131217,13975,13975,13940,13980,13935,13935,13940,-40,-35,142,989.77,302
,20131218,13935,13940,13950,13950,13950,13950,13950,10,10,10,69.75,312
,20131219,13950,13950,13940,13940,13930,13930,13935,-20,-15,200,"1,393.71",474
,20131220,13930,13935,,,,13935,13935,0,0,0,0,474
,20131223,13935,13935,13970,13980,13970,13975,13970,40,35,52,363.34,506
,20131224,13975,13970,,,,13960,13960,-10,-10,0,0,506
,20131225,13960,13960,,,,13960,13960,0,0,0,0,506
,20131226,13960,13960,,,,13960,13960,0,0,0,0,506
,20131227,13960,13960,13940,13940,13940,13940,13940,-20,-20,2,13.94,506
,20131230,13940,13940,14070,14090,14040,14040,14065,100,125,114,801.8,550
,20131231,14040,14065,13950,14000,13950,14000,13970,-65,-95,44,307.43,570
al1411,20131118,14405,14405,,,,14395,14395,-10,-10,0,0,0
,20131119,14395,14395,,,,14350,14350,-45,-45,0,0,0
,20131120,14350,14350,,,,14375,14375,25,25,0,0,0
,20131121,14375,14375,,,,14295,14295,-80,-80,0,0,0
,20131122,14295,14295,,,,14290,14290,-5,-5,0,0,0
,20131125,14290,14290,,,,14290,14290,0,0,0,0,0
,20131126,14290,14290,,,,14260,14260,-30,-30,0,0,0
,20131127,14260,14260,,,,14240,14240,-20,-20,0,0,0
,20131128,14240,14240,,,,14240,14240,0,0,0,0,0
,20131129,14240,14240,14170,14170,14170,14170,14170,-70,-70,20,141.7,20
,20131202,14170,14170,14215,14215,14215,14215,14215,45,45,18,127.94,38
,20131203,14215,14215,,,,14215,14215,0,0,0,0,38
,20131204,14215,14215,,,,14160,14160,-55,-55,0,0,38
,20131205,14160,14160,,,,14155,14155,-5,-5,0,0,38
,20131206,14155,14155,,,,14070,14070,-85,-85,0,0,38
,20131209,14070,14070,14065,14065,14065,14065,14065,-5,-5,10,70.33,38
,20131210,14065,14065,,,,14065,14065,0,0,0,0,38
,20131211,14065,14065,,,,14065,14065,0,0,0,0,38
,20131212,14065,14065,14080,14120,14080,14120,14100,55,35,40,282.06,78
,20131213,14120,14100,14010,14010,14000,14000,14000,-100,-100,64,448.13,64
,20131216,14000,14000,13985,13985,13985,13985,13985,-15,-15,2,13.99,66
,20131217,13985,13985,,,,13985,13985,0,0,0,0,66
,20131218,13985,13985,,,,13995,13995,10,10,0,0,66
,20131219,13995,13995,,,,13995,13995,0,0,0,0,66
,20131220,13995,13995,,,,14010,14010,15,15,0,0,66
,20131223,14010,14010,,,,14010,14010,0,0,0,0,66
,20131224,14010,14010,13970,13970,13970,13970,13970,-40,-40,2,13.97,66
,20131225,13970,13970,14020,14020,14005,14005,14010,35,40,4,28.03,68
,20131226,14005,14010,13980,13990,13980,13980,13980,-30,-30,8,55.93,60
,20131227,13980,13980,,,,13955,13955,-25,-25,0,0,60
,20131230,13955,13955,14055,14095,14055,14095,14070,140,115,12,84.42,64
,20131231,14095,14070,13970,13970,13970,13970,13970,-100,-100,4,27.94,68
al1412,20131217,13985,13985,,,,13985,13985,0,0,0,0,0
,20131218,13985,13985,,,,13985,13985,0,0,0,0,0
,20131219,13985,13985,14100,14100,13900,13900,14000,-85,15,8,56,4
,20131220,13900,14000,,,,14015,14015,15,15,0,0,4
,20131223,14015,14015,,,,14015,14015,0,0,0,0,4
,20131224,14015,14015,,,,14015,14015,0,0,0,0,4
,20131225,14015,14015,14030,14030,14020,14020,14025,5,10,4,28.05,8
,20131226,14020,14025,13950,13950,13950,13950,13950,-75,-75,4,27.9,4
,20131227,13950,13950,,,,13930,13930,-20,-20,0,0,4
,20131230,13930,13930,,,,14000,14000,70,70,0,0,4
,20131231,14000,14000,14000,14000,13995,13995,13995,-5,-5,6,42,10
au1301,20130104,334.08,332.79,327,330.35,327,330.35,329,-2.44,-3.79,58,"1,908.24",516
,20130107,330.35,329,331.62,333.85,331.62,333.6,333.16,4.6,4.16,24,799.6,516
,20130108,333.6,333.16,331,331.04,329.01,330.5,330.68,-2.66,-2.48,48,"1,587.29",510
,20130109,330.5,330.68,332.5,333.3,332.5,333.3,333.07,2.62,2.39,66,"2,198.27",510
,20130110,333.3,333.07,332.4,332.4,330.21,331.96,331.68,-1.11,-1.39,72,"2,388.10",486
,20130111,331.96,331.68,,,,334.11,334.11,2.43,2.43,0,0,486
,20130114,334.11,334.11,332.5,332.5,332.11,332.11,332.4,-2,-1.71,24,797.77,498
,20130115,332.11,332.4,334,334.6,333,334.6,333.9,2.2,1.5,78,"2,604.42",480
au1302,20130104,335.29,334.94,331.28,331.93,331.28,331.93,331.6,-3.01,-3.34,4,132.64,198
,20130107,331.93,331.6,334.68,334.69,333.24,333.62,333.89,2.02,2.29,10,333.9,198
,20130108,333.62,333.89,331.87,331.89,331.49,331.59,331.67,-2.3,-2.22,40,"1,326.69",170
,20130109,331.59,331.67,333.61,333.61,333.61,333.61,333.61,1.94,1.94,6,200.17,168
,20130110,333.61,333.61,332.49,333.7,332.49,333.7,332.7,0.09,-0.91,26,865.04,170
,20130111,333.7,332.7,335.97,335.97,335.97,335.97,335.97,3.27,3.27,2,67.19,168
,20130114,335.97,335.97,333.88,334.4,333.88,334.02,334.08,-1.95,-1.89,8,267.27,172
,20130115,334.02,334.08,335.06,335.08,334.91,335.08,335.01,1,0.93,24,804.04,176
,20130116,335.08,335.01,337.67,337.77,337.67,337.77,337.67,2.76,2.66,40,"1,350.70",176
,20130117,337.77,337.67,337.52,337.52,337.52,337.52,337.52,-0.15,-0.15,2,67.5,176
,20130118,337.52,337.52,338.85,338.85,338,338,338.42,0.48,0.9,4,135.37,174
,20130121,338,338.42,338.9,338.9,338.71,338.71,338.8,0.29,0.38,4,135.52,174
,20130122,338.71,338.8,,,,338.8,338.8,0,0,0,0,174
,20130123,338.8,338.8,339.21,339.54,339.2,339.54,339.25,0.74,0.45,14,474.95,172
,20130124,339.54,339.25,335.49,336.11,335.49,336.11,335.8,-3.14,-3.45,22,738.77,184
,20130125,336.11,335.8,334.89,335.46,333.78,335.02,334.87,-0.78,-0.93,28,937.66,186
,20130128,335.02,334.87,333.5,334.24,333.5,334.24,333.73,-0.63,-1.14,8,266.99,182
,20130129,334.24,333.73,334.18,334.22,334.18,334.22,334.2,0.49,0.47,4,133.68,178
,20130130,334.22,334.2,335.31,335.31,335.26,335.26,335.27,1.06,1.07,8,268.22,170
,20130131,335.26,335.27,335.27,338.75,335.27,336.5,335.92,1.23,0.65,22,739.03,156
,20130201,336.5,335.92,,,,335.92,335.92,0,0,0,0,156
,20130204,335.92,335.92,335.5,336.5,335.5,336.5,336,0.58,0.08,12,403.2,156
,20130205,336.5,336,336.5,336.5,336.5,336.5,336.5,0.5,0.5,6,201.9,156
,20130206,336.5,336.5,,,,336.5,336.5,0,0,0,0,156
,20130207,336.5,336.5,,,,336.5,336.5,0,0,0,0,156
,20130208,336.5,336.5,,,,336.5,336.5,0,0,0,0,156
,20130218,336.5,336.5,,,,336.5,336.5,0,0,0,0,156
au1303,20130104,336.45,335.75,332.15,332.98,332.03,332.98,332.34,-2.77,-3.41,48,"1,595.23",364
,20130107,332.98,332.34,334.68,335.59,334.68,334.93,335.17,2.59,2.83,20,670.35,364
,20130108,334.93,335.17,333.19,333.19,332.68,332.68,332.91,-2.49,-2.26,14,466.08,360
,20130109,332.68,332.91,334.19,335.38,334.18,334.98,334.84,2.07,1.93,16,535.74,358
,20130110,334.98,334.84,334.53,334.87,334.53,334.87,334.75,0.03,-0.09,6,200.85,356
,20130111,334.87,334.75,337.54,338.07,336.96,337.68,337.48,2.93,2.73,10,337.48,352
,20130114,337.68,337.48,335.8,335.8,335.8,335.8,335.8,-1.68,-1.68,4,134.32,350
,20130115,335.8,335.8,335.84,336,335.78,336,335.85,0.2,0.05,36,"1,209.08",344
,20130116,336,335.85,338.42,338.75,337.49,337.49,338.28,1.64,2.43,10,338.28,344
,20130117,337.49,338.28,,,,338.28,338.28,0,0,0,0,344
,20130118,338.28,338.28,338.43,339.5,338.17,338.93,339.03,0.65,0.75,58,"1,966.40",344
,20130121,338.93,339.03,339.08,339.84,338.61,339.03,339.53,0,0.5,94,"3,191.59",284
,20130122,339.03,339.53,339.54,340,339.54,340,339.66,0.47,0.13,10,339.66,288
,20130123,340,339.66,340.5,340.5,340,340.22,340.13,0.56,0.47,24,816.32,280
,20130124,340.22,340.13,338,338,338,338,338,-2.13,-2.13,4,135.2,280
,20130125,338,338,335.15,335.78,334.92,335.78,335.32,-2.22,-2.68,16,536.51,286
,20130128,335.78,335.32,334.01,335.08,334.01,334.31,334.32,-1.01,-1,28,936.1,288
,20130129,334.31,334.32,335.81,336.1,335,336,335.49,1.68,1.17,16,536.79,290
,20130130,336,335.49,336.97,337,336.06,337,336.24,1.51,0.75,38,"1,277.72",276
,20130131,337,336.24,339.15,339.15,339,339,339.1,2.76,2.86,6,203.46,276
,20130201,339,339.1,335.6,335.82,333.94,335.82,335.03,-3.28,-4.07,18,603.06,278
,20130204,335.82,335.03,335.82,335.82,335.82,335.82,335.82,0.79,0.79,6,201.49,278
,20130205,335.82,335.82,337.16,337.16,337.16,337.16,337.16,1.34,1.34,2,67.43,278
,20130206,337.16,337.16,337.2,337.2,337.2,337.2,337.2,0.04,0.04,2,67.44,278
,20130207,337.2,337.2,,,,337.2,337.2,0,0,0,0,278
,20130208,337.2,337.2,,,,337.2,337.2,0,0,0,0,278
,20130218,337.2,337.2,327.36,327.36,326.08,326.85,326.65,-10.35,-10.55,14,457.31,272
,20130219,326.85,326.65,324.67,326.59,324.67,325.51,326.21,-1.14,-0.44,50,"1,631.07",292
,20130220,325.51,326.21,322.22,326.44,322.22,325.67,325.2,-0.54,-1.01,66,"2,146.36",286
,20130221,325.67,325.2,319.7,319.7,314.82,317.59,316.46,-7.61,-8.74,26,822.8,276
,20130222,317.59,316.46,320.21,320.87,318.71,318.71,320.46,2.25,4,22,705.03,280
,20130225,318.71,320.46,319.72,321.93,319.72,321.62,320.97,1.16,0.51,24,770.33,286
,20130226,321.62,320.97,322.87,322.87,320.85,322.18,321.99,1.21,1.02,46,"1,481.19",286
,20130227,322.18,321.99,324.93,325.5,324.93,325.3,325.27,3.31,3.28,12,390.33,274
,20130228,325.3,325.27,324.88,324.88,313.32,320.5,321.98,-4.77,-3.29,18,579.58,270
,20130301,320.5,321.98,,,,321.98,321.98,0,0,0,0,270
,20130304,321.98,321.98,316.89,319.89,316.89,317.8,318.15,-4.18,-3.83,66,"2,099.83",276
,20130305,317.8,318.15,,,,318.15,318.15,0,0,0,0,276
,20130306,318.15,318.15,318,319,318,318.6,318.64,0.45,0.49,24,764.75,258
,20130307,318.6,318.64,,,,318.64,318.64,0,0,0,0,258
,20130308,318.64,318.64,317.02,317.02,317.02,317.02,317.02,-1.62,-1.62,6,190.21,258
,20130311,317.02,317.02,317.99,318.5,317.99,318.01,318.12,0.99,1.1,24,763.49,246
,20130312,318.01,318.12,318.3,323.99,317.52,323.99,319.45,5.87,1.33,24,766.69,240
,20130313,323.99,319.45,,,,319.45,319.45,0,0,0,0,240
,20130314,319.45,319.45,,,,319.45,319.45,0,0,0,0,240
,20130315,319.45,319.45,318,318,318,318,318,-1.45,-1.45,6,190.8,234
au1304,20130104,339.11,338,334.01,334.01,334.01,334.01,334.01,-3.99,-3.99,2,66.8,200
,20130107,334.01,334.01,337.83,337.97,337.83,337.97,337.91,3.96,3.9,20,675.83,192
,20130108,337.97,337.91,335.05,335.05,334.76,334.76,334.95,-3.15,-2.96,6,200.97,194
,20130109,334.76,334.95,336.9,336.9,336.81,336.81,336.85,1.86,1.9,4,134.74,198
,20130110,336.81,336.85,,,,336.85,336.85,0,0,0,0,198
,20130111,336.85,336.85,339.69,339.78,339.1,339.78,339.52,2.93,2.67,6,203.71,196
,20130114,339.78,339.52,,,,337.82,337.82,-1.7,-1.7,0,0,196
,20130115,337.82,337.82,354.65,354.69,337.53,337.53,345.26,-0.29,7.44,76,"2,624.04",202
,20130116,337.53,345.26,,,,341.18,341.18,-4.08,-4.08,0,0,202
,20130117,341.18,341.18,340.21,340.21,340.21,340.21,340.21,-0.97,-0.97,2,68.04,200
,20130118,340.21,340.21,341.05,341.05,340.75,340.75,340.97,0.54,0.76,10,340.98,206
,20130121,340.75,340.97,341.27,341.85,341.16,341.2,341.53,0.23,0.56,64,"2,185.79",216
,20130122,341.2,341.53,,,,341.53,341.53,0,0,0,0,216
,20130123,341.53,341.53,342.32,342.62,342.32,342.62,342.49,1.09,0.96,20,684.99,204
,20130124,342.62,342.49,,,,340.31,340.31,-2.18,-2.18,0,0,204
,20130125,340.31,340.31,,,,338.81,338.81,-1.5,-1.5,0,0,204
,20130128,338.81,338.81,,,,337.33,337.33,-1.48,-1.48,0,0,204
,20130129,337.33,337.33,336.38,336.38,336.38,336.38,336.38,-0.95,-0.95,2,67.28,204
,20130130,336.38,336.38,337.04,337.63,337.04,337.63,337.33,1.25,0.95,4,134.93,206
,20130131,337.63,337.33,,,,338.72,338.72,1.39,1.39,0,0,206
,20130201,338.72,338.72,336.6,336.6,336.6,336.6,336.6,-2.12,-2.12,2,67.32,208
,20130204,336.6,336.6,,,,336.6,336.6,0,0,0,0,208
,20130205,336.6,336.6,339.23,339.23,339.23,339.23,339.23,2.63,2.63,2,67.85,208
,20130206,339.23,339.23,339.19,339.2,338.96,338.96,339.07,-0.27,-0.16,8,271.26,200
,20130207,338.96,339.07,340.31,340.31,340.31,340.31,340.31,1.24,1.24,20,680.62,190
,20130208,340.31,340.31,,,,340.31,340.31,0,0,0,0,190
,20130218,340.31,340.31,328.36,328.79,328.08,328.08,328.33,-12.23,-11.98,8,262.67,188
,20130219,328.08,328.33,327.23,328,327.23,327.66,327.64,-0.67,-0.69,8,262.11,192
,20130220,327.66,327.64,321.21,327.23,321.21,327,325.14,-0.64,-2.5,6,195.09,194
,20130221,327,325.14,319.92,319.92,319.92,319.92,319.92,-5.22,-5.22,2,63.98,194
,20130222,319.92,319.92,321.56,322.53,321.56,321.77,321.95,1.85,2.03,14,450.74,192
,20130225,321.77,321.95,,,,322.46,322.46,0.51,0.51,0,0,192
,20130226,322.46,322.46,324.13,324.13,321.9,321.9,322.64,-0.56,0.18,6,193.59,192
,20130227,321.9,322.64,325.08,325.08,325.08,325.08,325.08,2.44,2.44,2,65.02,192
,20130228,325.08,325.08,,,,321.79,321.79,-3.29,-3.29,0,0,192
,20130301,321.79,321.79,321.89,322.15,321.89,322.15,322.01,0.36,0.22,12,386.42,182
,20130304,322.15,322.01,,,,318.18,318.18,-3.83,-3.83,0,0,182
,20130305,318.18,318.18,,,,318.18,318.18,0,0,0,0,182
,20130306,318.18,318.18,,,,318.28,318.28,0.1,0.1,0,0,182
,20130307,318.28,318.28,,,,318.28,318.28,0,0,0,0,182
,20130308,318.28,318.28,,,,318.28,318.28,0,0,0,0,182
,20130311,318.28,318.28,,,,318.68,318.68,0.4,0.4,0,0,182
,20130312,318.68,318.68,,,,318.68,318.68,0,0,0,0,182
,20130313,318.68,318.68,,,,318.68,318.68,0,0,0,0,182
,20130314,318.68,318.68,320.98,320.98,320.97,320.97,320.97,2.29,2.29,8,256.78,182
,20130315,320.97,320.97,,,,320.97,320.97,0,0,0,0,182
,20130318,320.97,320.97,321.18,321.18,321.18,321.18,321.18,0.21,0.21,2,64.24,180
,20130319,321.18,321.18,,,,321.77,321.77,0.59,0.59,0,0,180
,20130320,321.77,321.77,323.73,323.73,323.73,323.73,323.73,1.96,1.96,2,64.75,178
,20130321,323.73,323.73,323.21,324.06,322.43,322.53,323.25,-1.2,-0.48,10,323.26,178
,20130322,322.53,323.25,322.9,323.92,322.9,323.48,323.58,0.23,0.33,126,"4,077.11",106
,20130325,323.48,323.58,323.48,323.48,323.48,323.48,323.48,-0.1,-0.1,6,194.09,100
,20130326,323.48,323.48,320.53,321,320.47,321,320.65,-2.48,-2.83,18,577.17,90
,20130327,321,320.65,320.49,321.05,319.81,320.1,320.2,-0.55,-0.45,40,"1,280.82",62
,20130328,320.1,320.2,320.38,321.88,320.21,320.5,321.03,0.3,0.83,40,"1,284.13",46
,20130329,320.5,321.03,318.5,318.79,318.5,318.5,318.61,-2.53,-2.42,10,318.62,36
,20130401,318.5,318.61,,,,319.5,319.5,0.89,0.89,0,0,36
,20130402,319.5,319.5,,,,319.5,319.5,0,0,0,0,36
,20130403,319.5,319.5,,,,319.5,319.5,0,0,0,0,36
,20130408,319.5,319.5,315,315,315,315,315,-4.5,-4.5,12,378,24
,20130409,315,315,,,,315,315,0,0,0,0,24
,20130410,315,315,,,,315,315,0,0,0,0,24
,20130411,315,315,,,,315,315,0,0,0,0,24
,20130412,315,315,,,,315,315,0,0,0,0,24
,20130415,315,315,,,,315,315,0,0,0,0,24
au1305,20130104,339.58,338.76,339.58,339.58,334.74,335.86,335.6,-2.9,-3.16,130,"4,362.83",364
,20130107,335.86,335.6,337.49,338.92,337.17,337.3,337.92,1.7,2.32,120,"4,055.05",348
,20130108,337.3,337.92,335.97,336.1,335.54,335.68,335.81,-2.24,-2.11,42,"1,410.41",336
,20130109,335.68,335.81,337.75,339.16,337.5,337.5,338.08,1.69,2.27,44,"1,487.58",340
,20130110,337.5,338.08,336.34,338.3,336.34,338.3,337.59,0.22,-0.49,22,742.71,346
,20130111,338.3,337.59,340.62,340.68,340.27,340.46,340.53,2.87,2.94,26,885.4,338
,20130114,340.46,340.53,339.68,339.68,338.36,339.5,338.98,-1.03,-1.55,148,"5,016.98",338
,20130115,339.5,338.98,339.23,341.27,339.21,339.95,340.2,0.97,1.22,56,"1,905.13",352
,20130116,339.95,340.2,342.07,342.31,341.31,341.9,341.79,1.7,1.59,74,"2,529.31",338
,20130117,341.9,341.79,340.5,341.28,340.03,340.64,340.7,-1.15,-1.09,68,"2,316.78",332
,20130118,340.64,340.7,343.67,343.67,342.06,342.47,342.53,1.77,1.83,22,753.58,330
,20130121,342.47,342.53,342.47,342.92,342.3,342.92,342.54,0.39,0.01,40,"1,370.19",324
,20130122,342.92,342.54,342.59,344.18,342.59,344.18,343.32,1.64,0.78,42,"1,441.97",314
,20130123,344.18,343.32,343.8,343.8,343.3,343.5,343.6,0.18,0.28,24,824.66,300
,20130124,343.5,343.6,341.5,341.5,340.03,340.25,340.62,-3.35,-2.98,10,340.63,296
,20130125,340.25,340.62,338.22,338.4,337.52,338.4,337.89,-2.22,-2.73,58,"1,959.76",296
,20130128,338.4,337.89,337.9,337.9,336.45,336.45,337.34,-1.44,-0.55,10,337.34,296
,20130129,336.45,337.34,336.45,336.79,336.45,336.5,336.55,-0.84,-0.79,12,403.87,294
,20130130,336.5,336.55,337.43,337.97,337.43,337.97,337.62,1.42,1.07,8,270.1,294
,20130131,337.97,337.62,,,,339.17,339.17,1.55,1.55,0,0,294
,20130201,339.17,339.17,336.86,337.38,336.18,337.38,336.71,-1.79,-2.46,14,471.4,298
,20130204,337.38,336.71,337.95,339.49,337.95,338.96,338.73,2.25,2.02,56,"1,896.93",294
,20130205,338.96,338.73,339.99,340.1,338.53,340.1,339.53,1.37,0.8,50,"1,697.70",290
,20130206,340.1,339.53,339.05,339.21,338.82,338.82,339.06,-0.71,-0.47,8,271.25,292
,20130207,338.82,339.06,339.83,339.83,339.64,339.64,339.73,0.58,0.67,4,135.89,292
,20130208,339.64,339.73,339.82,339.82,338.58,339.4,339.24,-0.33,-0.49,18,610.63,290
,20130218,339.4,339.24,318.9,329.09,318.9,328.56,327.79,-10.68,-11.45,62,"2,032.32",286
,20130219,328.56,327.79,328.46,329.46,328.27,328.83,328.88,1.04,1.09,54,"1,776.00",290
,20130220,328.83,328.88,325.63,328.24,325.63,328.24,327.52,-0.64,-1.36,46,"1,506.61",292
,20130221,328.24,327.52,319.82,321.43,316.4,319.37,318.49,-8.15,-9.03,82,"2,611.68",306
,20130222,319.37,318.49,320.86,323.4,320.86,322.95,322.17,4.46,3.68,32,"1,030.95",302
,20130225,322.95,322.17,321.31,323.33,321.31,323.33,322.52,1.16,0.35,32,"1,032.09",304
,20130226,323.33,322.52,324.88,325.1,324.56,324.56,324.85,2.04,2.33,8,259.88,302
,20130227,324.56,324.85,327.1,327.3,326.07,326.38,326.91,1.53,2.06,34,"1,111.51",294
,20130228,326.38,326.91,324.6,325.38,324.6,325.38,324.99,-1.53,-1.92,4,130,296
,20130301,325.38,324.99,321.8,322.11,321.53,322.11,321.81,-2.88,-3.18,36,"1,158.53",320
,20130304,322.11,321.81,321.63,322.07,321.31,321.31,321.72,-0.5,-0.09,8,257.38,314
,20130305,321.31,321.72,321.01,321.51,321.01,321.51,321.26,-0.21,-0.46,4,128.5,310
,20130306,321.51,321.26,321.52,321.52,321.36,321.36,321.44,0.1,0.18,4,128.58,310
,20130307,321.36,321.44,,,,321.44,321.44,0,0,0,0,310
,20130308,321.44,321.44,,,,321.44,321.44,0,0,0,0,310
,20130311,321.44,321.44,,,,321.44,321.44,0,0,0,0,310
,20130312,321.44,321.44,321.46,321.46,320.88,320.88,321.17,-0.56,-0.27,4,128.47,310
,20130313,320.88,321.17,323.44,323.44,323.44,323.44,323.44,2.27,2.27,2,64.69,312
,20130314,323.44,323.44,321.98,321.98,320.71,321.95,321.57,-1.49,-1.87,40,"1,286.31",294
,20130315,321.95,321.57,,,,321.57,321.57,0,0,0,0,294
,20130318,321.57,321.57,322.78,322.78,322.26,322.26,322.52,0.69,0.95,4,129.01,294
,20130319,322.26,322.52,,,,322.52,322.52,0,0,0,0,294
,20130320,322.52,322.52,325.47,325.47,325.47,325.47,325.47,2.95,2.95,2,65.09,292
,20130321,325.47,325.47,324.59,324.59,324.59,324.59,324.59,-0.88,-0.88,8,259.67,288
,20130322,324.59,324.59,,,,324.59,324.59,0,0,0,0,288
,20130325,324.59,324.59,324.59,324.59,323.64,323.64,324.11,-0.95,-0.48,8,259.29,288
,20130326,323.64,324.11,323.57,323.57,323.57,323.57,323.57,-0.54,-0.54,2,64.71,290
,20130327,323.57,323.57,,,,323.08,323.08,-0.49,-0.49,0,0,290
,20130328,323.08,323.08,322.59,322.59,322.59,322.59,322.59,-0.49,-0.49,4,129.04,290
,20130329,322.59,322.59,320.6,320.72,320.6,320.72,320.61,-1.87,-1.98,22,705.34,270
,20130401,320.72,320.61,321.12,322.86,320.62,322.86,321.18,2.25,0.57,66,"2,119.81",254
,20130402,322.86,321.18,322.87,323.23,321.62,322.38,322.44,1.2,1.26,26,838.35,244
,20130403,322.38,322.44,314.04,314.04,314.04,314.04,314.04,-8.4,-8.4,2,62.81,244
,20130408,314.04,314.04,316.96,318.84,316.62,317.77,317.74,3.73,3.7,52,"1,652.27",254
,20130409,317.77,317.74,316.91,316.91,316.91,316.91,316.91,-0.83,-0.83,6,190.15,248
,20130410,316.91,316.91,317.39,318.47,317.3,318.32,317.88,1.41,0.97,62,"1,970.91",260
,20130411,318.32,317.88,312.37,313.76,312.37,312.49,313.2,-5.39,-4.68,20,626.42,258
,20130412,312.49,313.2,312.6,312.6,312.6,312.6,312.6,-0.6,-0.6,10,312.6,252
,20130415,312.6,312.6,,,,312.6,312.6,0,0,0,0,252
,20130416,312.6,312.6,,,,296.97,296.97,-15.63,-15.63,0,0,252
,20130417,296.97,296.97,,,,282.12,282.12,-14.85,-14.85,0,0,252
,20130418,282.12,282.12,270,276.05,268.11,275.5,269.33,-6.62,-12.79,316,"8,511.05",38
,20130419,275.5,269.33,274.85,282.79,274.85,282.19,280.9,12.86,11.57,60,"1,685.42",50
,20130422,282.19,280.9,281.69,287.63,281.68,283.32,283.51,2.42,2.61,114,"3,232.05",34
,20130423,283.32,283.51,284,285.84,280.02,282.31,282.96,-1.2,-0.55,44,"1,245.06",32
,20130424,282.31,282.96,285.07,285.07,283.32,284.91,284.31,1.95,1.35,28,796.07,26
,20130425,284.91,284.31,287.66,292.06,287.65,290.6,289.39,6.29,5.08,70,"2,025.75",20
,20130426,290.6,289.39,300.08,300.08,292.84,292.84,297.07,3.45,7.68,28,831.81,18
,20130502,292.84,297.07,301.6,301.6,284,286.66,293.42,-10.41,-3.65,24,704.22,12
,20130503,286.66,293.42,294.46,294.46,291.61,291.61,293.03,-1.81,-0.39,12,351.64,6
,20130506,291.61,293.03,,,,293.03,293.03,0,0,0,0,6
,20130507,293.03,293.03,,,,293.03,293.03,0,0,0,0,6
,20130508,293.03,293.03,293.03,293.03,293.03,293.03,293.03,0,0,6,175.82,6
,20130509,293.03,293.03,,,,293.03,293.03,0,0,0,0,6
,20130510,293.03,293.03,,,,293.03,293.03,0,0,0,0,6
,20130513,293.03,293.03,,,,293.03,293.03,0,0,0,0,6
,20130514,293.03,293.03,284.88,284.88,284.88,284.88,284.88,-8.15,-8.15,6,170.93,0
,20130515,284.88,284.88,,,,284.88,284.88,0,0,0,0,0
au1306,20130104,340.29,339.41,337.19,337.2,335.38,336.84,336.32,-2.57,-3.09,63218,"2,126,174.45",111832
,20130107,336.84,336.32,338.02,339.52,338,338.54,338.78,2.22,2.46,44956,"1,523,046.04",115250
,20130108,338.54,338.78,337,337.3,336.2,336.53,336.63,-2.25,-2.15,32290,"1,086,990.88",116024
,20130109,336.53,336.63,338.53,339.55,338.24,339.32,338.91,2.69,2.28,37642,"1,275,748.09",116542
,20130110,339.32,338.91,337.51,339.09,337.28,338.68,338.12,-0.23,-0.79,29456,"995,992.35",116226
,20130111,338.68,338.12,341.72,341.92,340.81,341.39,341.45,3.27,3.33,36272,"1,238,509.41",114900
,20130114,341.39,341.45,339.02,340.43,339.02,340.35,339.85,-1.1,-1.6,28512,"968,988.52",116048
,20130115,340.35,339.85,340.66,341.8,339.9,340.9,340.9,1.05,1.05,46930,"1,599,849.57",119718
,20130116,340.9,340.9,343.5,343.6,342.6,343.5,343.16,2.6,2.26,38706,"1,328,250.22",119046
,20130117,343.5,343.16,342.53,342.86,341.68,342.49,342.29,-0.67,-0.87,33994,"1,163,607.10",116190
,20130118,342.49,342.29,344,344.49,343.81,344.28,344.16,1.99,1.87,28408,"977,698.69",115798
,20130121,344.28,344.16,343.7,344.4,343.7,344.06,344.11,-0.1,-0.05,20808,"716,038.19",116826
,20130122,344.06,344.11,344.2,345.6,344.1,345.5,344.73,1.39,0.62,28632,"987,040.04",118774
,20130123,345.5,344.73,345.11,345.39,344.42,344.81,344.84,0.08,0.11,20290,"699,698.61",116992
,20130124,344.81,344.84,342,342.68,341.12,341.73,341.98,-3.11,-2.86,38244,"1,307,879.83",117842
,20130125,341.73,341.98,338.5,340.2,338.5,340.1,339.45,-1.88,-2.53,28120,"954,539.12",118380
,20130128,340.1,339.45,337.78,338.65,337.77,338.47,338.19,-0.98,-1.26,27998,"946,866.97",119350
,20130129,338.47,338.19,338,339.2,337.8,339.07,338.4,0.88,0.21,27830,"941,772.79",123574
,20130130,339.07,338.4,339.34,339.82,338.89,339.5,339.31,1.1,0.91,22760,"772,274.62",122040
,20130131,339.5,339.31,341.76,342.03,341.18,341.3,341.53,1.99,2.22,25778,"880,396.19",119608
,20130201,341.3,341.53,338.2,338.78,337.94,338.67,338.29,-2.86,-3.24,24454,"827,265.39",118892
,20130204,338.67,338.29,339.18,340.74,338.86,340.15,340.05,1.86,1.76,31138,"1,058,866.70",119688
,20130205,340.15,340.05,340.88,341.95,340.77,341.85,341.29,1.8,1.24,25824,"881,369.65",119760
,20130206,341.85,341.29,340.9,341.19,340.11,340.83,340.62,-0.46,-0.67,24604,"838,063.45",116026
,20130207,340.83,340.62,341.88,342.41,341.41,341.73,341.85,1.11,1.23,19554,"668,469.70",113938
,20130208,341.73,341.85,339.78,341.3,339.78,341.09,340.49,-0.76,-1.36,17576,"598,447.43",114412
,20130218,341.09,340.49,329.7,330.32,329.26,329.76,329.8,-10.73,-10.69,42594,"1,404,790.67",116630
,20130219,329.76,329.8,329.5,330.12,329.5,329.73,329.76,-0.07,-0.04,24126,"795,588.15",121892
,20130220,329.73,329.76,328.7,329.12,328.44,328.97,328.79,-0.79,-0.97,23096,"759,383.51",123546
,20130221,328.97,328.79,321.3,321.58,318,320.84,319.92,-7.95,-8.87,64880,"2,075,642.88",124052
,20130222,320.84,319.92,322.52,324.76,322.52,324.32,323.74,4.4,3.82,32438,"1,050,178.46",122004
,20130225,324.32,323.74,322.88,324.81,322.8,324.04,323.94,0.3,0.2,37884,"1,227,247.06",122646
,20130226,324.04,323.94,326.31,326.45,324.32,324.54,325.53,0.6,1.59,38824,"1,263,848.69",119806
,20130227,324.54,325.53,328.99,328.99,328,328.09,328.57,2.56,3.04,41952,"1,378,451.36",113704
,20130228,328.09,328.57,325.8,327.19,325.4,326.4,326.17,-2.17,-2.4,33604,"1,096,076.13",113420
,20130301,326.4,326.17,323.63,323.63,322.51,323.1,323.13,-3.07,-3.04,32316,"1,044,237.25",114478
,20130304,323.1,323.13,323.4,324.14,322.26,322.56,323.05,-0.57,-0.08,38268,"1,236,271.06",114798
,20130305,322.56,323.05,322.4,323.82,322.22,323.47,322.88,0.42,-0.17,35010,"1,130,419.42",117342
,20130306,323.47,322.88,322.68,323.06,322,322.33,322.56,-0.55,-0.32,33756,"1,088,845.52",119736
,20130307,322.33,322.56,323.16,323.59,322.58,323.05,323.06,0.49,0.5,40758,"1,316,730.56",119468
,20130308,323.05,323.06,322.18,322.66,321.02,321.3,321.73,-1.76,-1.33,44658,"1,436,811.71",120464
,20130311,321.3,321.73,321.5,322.88,321.44,322.74,322.33,1.01,0.6,35484,"1,143,763.56",114976
,20130312,322.74,322.33,321.72,322.83,321.72,322.11,322.35,-0.22,0.02,27724,"893,707.77",114422
,20130313,322.11,322.35,324.54,324.66,323,324.3,324.04,1.95,1.69,29128,"943,864.54",114200
,20130314,324.3,324.04,322.82,323.49,322.02,322.95,322.84,-1.09,-1.2,33144,"1,070,036.32",106400
,20130315,322.95,322.84,323.66,324.19,323.43,324.19,323.78,1.35,0.94,24082,"779,730.46",108660
,20130318,324.19,323.78,325.82,325.97,323.02,324.21,324.18,0.43,0.4,44560,"1,444,583.74",112410
,20130319,324.21,324.18,325.19,325.95,324.5,325.73,325.25,1.55,1.07,34172,"1,111,478.46",109644
,20130320,325.73,325.25,326.64,327.15,326.2,326.88,326.7,1.63,1.45,26116,"853,215.33",106998
,20130321,326.88,326.7,325.19,326.45,325.02,326.08,325.82,-0.62,-0.88,25004,"814,684.93",107618
,20130322,326.08,325.82,327,327.15,326.31,326.33,326.73,0.51,0.91,23060,"753,459.74",107730
,20130325,326.33,326.73,324.94,326.64,324.94,325.58,325.96,-1.15,-0.77,24792,"808,126.64",107646
,20130326,325.58,325.96,324.76,325.2,324.02,324.57,324.69,-1.39,-1.27,28382,"921,536.73",103488
,20130327,324.57,324.69,324.54,324.69,322.92,322.97,323.74,-1.72,-0.95,29518,"955,621.83",104624
,20130328,322.97,323.74,325.05,325.53,324.93,325.03,325.24,1.29,1.5,23738,"772,065.19",99396
,20130329,325.03,325.24,323,323.66,322.2,323.45,322.86,-1.79,-2.38,17616,"568,752.48",97060
,20130401,323.45,322.86,323.82,324.97,322.88,322.98,323.69,0.12,0.83,23182,"750,383.64",99264
,20130402,322.98,323.69,324.25,324.77,323.36,323.73,324.11,0.04,0.42,21740,"704,622.88",97188
,20130403,323.73,324.11,319,319.1,315.69,316.24,316.98,-7.87,-7.13,48494,"1,537,190.91",100256
,20130408,316.24,316.98,318.47,320.01,318.24,319.29,318.87,2.31,1.89,34714,"1,106,951.88",95036
,20130409,319.29,318.87,317.79,318.99,317.79,318.82,318.53,-0.05,-0.34,25110,"799,837.93",93606
,20130410,318.82,318.53,320.97,321,320.01,320.25,320.39,1.72,1.86,19836,"635,529.73",92394
,20130411,320.25,320.39,314.06,314.98,313.7,314.35,314.39,-6.04,-6,36508,"1,147,794.13",94276
,20130412,314.35,314.39,314.91,315.85,314.21,314.49,314.67,0.1,0.28,22016,"692,791.98",94120
,20130415,314.49,314.67,299,299,298.93,298.93,298.95,-15.74,-15.72,4482,"133,991.77",93778
,20130416,298.93,298.95,275.03,277.3,275.03,276.38,275.63,-22.57,-23.32,74334,"2,048,891.85",86292
,20130417,276.38,275.63,276,277.09,272.84,275.09,275.29,-0.54,-0.34,107104,"2,948,489.39",83782
,20130418,275.09,275.29,271.93,276.42,264.59,275.78,271.48,0.49,-3.81,157854,"4,285,537.48",69324
,20130419,275.78,271.48,277,285.01,275.92,282.28,280.33,10.8,8.85,121000,"3,392,024.90",62538
,20130422,282.28,280.33,283,284.6,282.38,282.7,283.55,2.37,3.22,82736,"2,345,998.88",61308
,20130423,282.7,283.55,283.57,284.46,279.32,281.14,282.17,-2.41,-1.38,88074,"2,485,186.28",58000
,20130424,281.14,282.17,282.13,285.98,282.03,284.8,283.67,2.63,1.5,59362,"1,683,960.61",44950
,20130425,284.8,283.67,286,289.46,285.55,288.76,287.79,5.09,4.12,48300,"1,390,063.95",34428
,20130426,288.76,287.79,295.84,298.88,293.97,294.68,296.04,6.89,8.25,50680,"1,500,342.29",29112
,20130502,294.68,296.04,290.99,290.99,288.21,290.5,289.53,-5.54,-6.51,19938,"577,277.98",27246
,20130503,290.5,289.53,292.1,294.77,292.1,294.75,293.63,5.22,4.1,16168,"474,741.53",24796
,20130506,294.75,293.63,294.87,295.9,293.37,293.46,294.32,-0.17,0.69,13348,"392,868.14",23966
,20130507,293.46,294.32,292.35,293.38,289.88,289.93,291.57,-4.39,-2.75,17658,"514,867.53",23198
,20130508,289.93,291.57,289.27,291.27,288.1,290.8,289.66,-0.77,-1.91,14130,"409,291.80",21338
,20130509,290.8,289.66,293.12,294.41,292.36,292.69,293.57,3.03,3.91,8750,"256,882.46",20344
,20130510,292.69,293.57,288.98,291.98,288.68,291.8,290.74,-1.77,-2.83,6368,"185,146.42",19726
,20130513,291.8,290.74,287.49,288.13,285.6,286.05,286.46,-4.69,-4.28,15264,"437,254.14",18242
,20130514,286.05,286.46,288.05,289.13,287.36,287.42,288.03,0.96,1.57,10098,"290,861.34",14858
,20130515,287.42,288.03,285.24,286,282.43,282.7,284.68,-5.33,-3.35,8478,"241,352.42",13416
,20130516,282.7,284.68,279.08,280.65,279.08,279.73,279.77,-4.95,-4.91,11052,"309,206.61",9664
,20130517,279.73,279.77,280.33,280.93,277.5,277.92,279.24,-1.85,-0.53,7630,"213,064.69",9116
,20130520,277.92,279.24,271.38,274.07,271.27,273.02,272.92,-6.22,-6.32,5744,"156,768.09",8786
,20130521,273.02,272.92,282.4,283.98,279.59,281.88,281.6,8.96,8.68,4746,"133,648.82",8004
,20130522,281.88,281.6,279.77,281.47,279.03,281.2,280.09,-0.4,-1.51,3146,"88,118.35",7920
,20130523,281.2,280.09,276.65,279.99,275.25,279.11,277.42,-0.98,-2.67,3916,"108,639.27",7492
,20130524,279.11,277.42,281.28,282.49,279.49,279.59,280.41,2.17,2.99,4166,"116,820.19",6944
,20130527,279.59,280.41,278.44,280.5,278.44,279.92,279.85,-0.49,-0.56,1854,"51,884.98",6806
,20130528,279.92,279.85,278.81,280.3,278.81,279.31,279.67,-0.54,-0.18,2426,"67,848.44",6230
,20130529,279.31,279.67,279.5,279.82,277.6,277.9,278.63,-1.77,-1.04,3972,"110,672.51",5160
,20130530,277.9,278.63,278.63,282.64,278.63,281.92,280.76,3.29,2.13,3320,"93,213.46",4284
,20130531,281.92,280.76,283.47,285.27,281,283.77,283.91,3.01,3.15,3574,"101,472.67",2882
,20130603,283.77,283.91,278.51,279.85,278.51,279.51,279.41,-4.4,-4.5,464,"12,965.06",2802
,20130604,279.51,279.41,283.49,284.86,280.3,280.79,282.31,1.38,2.9,1230,"34,725.25",2316
,20130605,280.79,282.31,279.45,280.75,279.01,279.9,279.85,-2.41,-2.46,504,"14,104.61",2052
,20130606,279.9,279.85,279.24,279.99,277.74,277.75,279.23,-2.1,-0.62,96,"2,680.61",2004
,20130607,277.75,279.23,281,281.25,278.83,279.3,280.33,0.07,1.1,540,"15,138.35",1638
,20130613,279.3,280.33,,,,280.33,280.33,0,0,0,0,1638
,20130614,280.33,280.33,276,276,275.1,275.1,275.4,-5.23,-4.93,18,495.72,1620
,20130617,275.1,275.4,276.3,276.32,276.3,276.31,276.3,0.91,0.9,792,"21,883.67",1218
au1307,20130104,340,340,336.33,337.15,336.33,337.15,337.01,-2.85,-2.99,12,404.42,102
,20130107,337.15,337.01,,,,339.48,339.48,2.47,2.47,0,0,102
,20130108,339.48,339.48,,,,337.32,337.32,-2.16,-2.16,0,0,102
,20130109,337.32,337.32,,,,339.61,339.61,2.29,2.29,0,0,102
,20130110,339.61,339.61,340.09,340.09,338.44,338.44,339.26,-1.17,-0.35,4,135.71,104
,20130111,338.44,339.26,,,,342.6,342.6,3.34,3.34,0,0,104
,20130114,342.6,342.6,,,,340.99,340.99,-1.61,-1.61,0,0,104
,20130115,340.99,340.99,341.72,341.72,341.61,341.61,341.66,0.62,0.67,4,136.67,102
,20130116,341.61,341.66,,,,343.92,343.92,2.26,2.26,0,0,102
,20130117,343.92,343.92,,,,343.05,343.05,-0.87,-0.87,0,0,102
,20130118,343.05,343.05,344.36,345.34,344.36,345.34,345.21,2.29,2.16,16,552.35,116
,20130121,345.34,345.21,345.19,345.34,345.19,345.34,345.26,0.13,0.05,4,138.11,112
,20130122,345.34,345.26,345.35,345.35,345.35,345.35,345.35,0.09,0.09,12,414.42,100
,20130123,345.35,345.35,,,,345.46,345.46,0.11,0.11,0,0,100
,20130124,345.46,345.46,,,,342.59,342.59,-2.87,-2.87,0,0,100
,20130125,342.59,342.59,341.2,341.2,339.81,339.81,340.5,-2.78,-2.09,4,136.2,100
,20130128,339.81,340.5,,,,339.23,339.23,-1.27,-1.27,0,0,100
,20130129,339.23,339.23,,,,339.44,339.44,0.21,0.21,0,0,100
,20130130,339.44,339.44,337.42,340.22,337.42,340.22,339.65,0.78,0.21,10,339.65,96
,20130131,340.22,339.65,,,,341.87,341.87,2.22,2.22,0,0,96
,20130201,341.87,341.87,,,,338.63,338.63,-3.24,-3.24,0,0,96
,20130204,338.63,338.63,,,,340.39,340.39,1.76,1.76,0,0,96
,20130205,340.39,340.39,,,,341.63,341.63,1.24,1.24,0,0,96
,20130206,341.63,341.63,,,,340.96,340.96,-0.67,-0.67,0,0,96
,20130207,340.96,340.96,,,,342.19,342.19,1.23,1.23,0,0,96
,20130208,342.19,342.19,,,,340.82,340.82,-1.37,-1.37,0,0,96
,20130218,340.82,340.82,330.65,330.65,330.65,330.65,330.65,-10.17,-10.17,2,66.13,98
,20130219,330.65,330.65,,,,330.61,330.61,-0.04,-0.04,0,0,98
,20130220,330.61,330.61,320.18,330.01,320.18,329.41,327.9,-1.2,-2.71,10,327.9,100
,20130221,329.41,327.9,320,321.68,320,321.68,320.84,-6.22,-7.06,4,128.34,104
,20130222,321.68,320.84,324.48,325.6,324.48,325.6,324.77,4.76,3.93,10,324.77,102
,20130225,325.6,324.77,,,,324.77,324.77,0,0,0,0,102
,20130226,324.77,324.77,325.92,325.92,325.79,325.79,325.87,1.02,1.1,34,"1,107.98",116
,20130227,325.79,325.87,329.21,329.63,329.21,329.22,329.35,3.35,3.48,6,197.61,116
,20130228,329.22,329.35,,,,329,329,-0.35,-0.35,0,0,116
,20130301,329,329,323.94,323.94,323.55,323.55,323.74,-5.45,-5.26,4,129.5,114
,20130304,323.55,323.74,,,,323.66,323.66,-0.08,-0.08,0,0,114
,20130305,323.66,323.66,,,,323.49,323.49,-0.17,-0.17,0,0,114
,20130306,323.49,323.49,323.52,323.52,322.61,322.61,323.06,-0.88,-0.43,4,129.23,116
,20130307,322.61,323.06,,,,323.06,323.06,0,0,0,0,116
,20130308,323.06,323.06,,,,323.06,323.06,0,0,0,0,116
,20130311,323.06,323.06,323.05,323.05,322.4,322.4,322.66,-0.66,-0.4,8,258.13,120
,20130312,322.4,322.66,,,,322.66,322.66,0,0,0,0,120
,20130313,322.66,322.66,323.87,323.87,323.87,323.87,323.87,1.21,1.21,40,"1,295.48",144
,20130314,323.87,323.87,323.77,323.78,323.27,323.67,323.64,-0.2,-0.23,52,"1,682.97",100
,20130315,323.67,323.64,,,,323.64,323.64,0,0,0,0,100
,20130318,323.64,323.64,,,,323.64,323.64,0,0,0,0,100
,20130319,323.64,323.64,325.08,325.81,325.08,325.81,325.44,2.17,1.8,4,130.18,104
,20130320,325.81,325.44,326.64,327.37,326.46,327.37,326.97,1.93,1.53,52,"1,700.25",108
,20130321,327.37,326.97,325.85,327.05,325.52,326.63,325.86,-0.34,-1.11,152,"4,953.16",108
,20130322,326.63,325.86,,,,325.86,325.86,0,0,0,0,108
,20130325,325.86,325.86,,,,325.86,325.86,0,0,0,0,108
,20130326,325.86,325.86,325,326.4,324.8,326.4,325.32,0.54,-0.54,8,260.26,110
,20130327,326.4,325.32,324.38,325.19,323.57,324.07,324.29,-1.25,-1.03,18,583.73,102
,20130328,324.07,324.29,325.49,325.49,325.49,325.49,325.49,1.2,1.2,2,65.1,104
,20130329,325.49,325.49,323.85,323.85,323.85,323.85,323.85,-1.64,-1.64,2,64.77,104
,20130401,323.85,323.85,323.14,323.14,322.9,322.9,323.02,-0.95,-0.83,4,129.21,108
,20130402,322.9,323.02,324.98,324.98,324.29,324.29,324.63,1.27,1.61,4,129.85,104
,20130403,324.29,324.63,319.93,319.93,316.63,316.99,317.78,-7.64,-6.85,26,826.25,114
,20130408,316.99,317.78,319.2,320.61,319.2,320.61,319.55,2.83,1.77,32,"1,022.58",118
,20130409,320.61,319.55,,,,319.21,319.21,-0.34,-0.34,0,0,118
,20130410,319.21,319.21,321.25,321.25,321.25,321.25,321.25,2.04,2.04,4,128.5,114
,20130411,321.25,321.25,316,316,315.27,315.27,315.71,-5.98,-5.54,8,252.57,122
,20130412,315.27,315.71,,,,315.99,315.99,0.28,0.28,0,0,122
,20130415,315.99,315.99,300.19,300.19,300.19,300.19,300.19,-15.8,-15.8,2,60.04,122
,20130416,300.19,300.19,276.2,278.24,276.17,276.65,276.75,-23.54,-23.44,56,"1,549.85",134
,20130417,276.65,276.75,276.45,278.03,273.79,274.59,276.64,-2.16,-0.11,46,"1,272.55",132
,20130418,274.59,276.64,272.11,275.55,268.31,275.41,270.96,-1.23,-5.68,96,"2,601.23",106
,20130419,275.41,270.96,277.97,284.49,277.97,283.5,282.52,12.54,11.56,14,395.54,108
,20130422,283.5,282.52,283.06,285.11,282.52,285.11,283.34,2.59,0.82,42,"1,190.04",104
,20130423,285.11,283.34,283.65,284.25,283.12,283.12,283.43,-0.22,0.09,20,566.87,96
,20130424,283.12,283.43,283.43,284.68,283.31,284.47,283.81,1.04,0.38,34,964.96,92
,20130425,284.47,283.81,287.3,289.07,285.8,289.07,287.44,5.26,3.63,26,747.37,90
,20130426,289.07,287.44,294.26,295.26,294.26,295.26,294.76,7.82,7.32,4,117.9,90
,20130502,295.26,294.76,289.91,289.91,288.35,288.35,288.78,-6.41,-5.98,38,"1,097.38",76
,20130503,288.35,288.78,291.1,293.91,291.1,293.06,292.72,4.28,3.94,30,878.17,74
,20130506,293.06,292.72,292.45,295.23,292.45,295.23,293.18,2.51,0.46,42,"1,231.38",60
,20130507,295.23,293.18,291.01,291.24,288.79,288.79,290.6,-4.39,-2.58,14,406.84,60
,20130508,288.79,290.6,288.81,290.46,288.27,290,289.41,-0.6,-1.19,24,694.59,58
,20130509,290,289.41,293.1,293.87,292.13,292.13,293.17,2.72,3.76,14,410.44,52
,20130510,292.13,293.17,,,,292.92,292.92,-0.25,-0.25,0,0,52
,20130513,292.92,292.92,284.75,284.75,284.75,284.75,284.75,-8.17,-8.17,2,56.95,52
,20130514,284.75,284.75,286.99,287.97,286.99,287.5,287.49,2.75,2.74,8,229.99,56
,20130515,287.5,287.49,284.89,285.57,280.59,283.23,284.52,-4.26,-2.97,54,"1,536.45",56
,20130516,283.23,284.52,281.2,281.2,275.69,279.22,279.34,-5.3,-5.18,16,446.96,58
,20130517,279.22,279.34,278,279.11,276.83,279.11,278.37,-0.23,-0.97,16,445.4,64
,20130520,279.11,278.37,268.71,270.5,268.7,270.49,269.5,-7.88,-8.87,14,377.3,60
,20130521,270.49,269.5,280.95,281.2,278.98,281.03,280.4,11.53,10.9,18,504.72,58
,20130522,281.03,280.4,,,,280.4,280.4,0,0,0,0,58
,20130523,280.4,280.4,278,278,278,278,278,-2.4,-2.4,2,55.6,58
,20130524,278,278,279.87,280.08,278.81,278.82,279.14,0.82,1.14,14,390.81,56
,20130527,278.82,279.14,279.23,280.6,279.23,279.97,279.94,0.83,0.8,18,503.89,56
,20130528,279.97,279.94,,,,279.76,279.76,-0.18,-0.18,0,0,56
,20130529,279.76,279.76,278.84,278.84,278.84,278.84,278.84,-0.92,-0.92,2,55.77,56
,20130530,278.84,278.84,280.59,282.3,279.91,282.3,280.87,3.46,2.03,14,393.23,54
,20130531,282.3,280.87,284.88,284.88,283.78,283.96,284.2,3.09,3.33,6,170.52,52
,20130603,283.96,284.2,279.61,279.61,279.61,279.61,279.61,-4.59,-4.59,2,55.92,52
,20130604,279.61,279.61,283.42,283.42,281.62,281.62,282.07,2.01,2.46,8,225.66,52
,20130605,281.62,282.07,281.01,281.53,281.01,281.53,281.27,-0.54,-0.8,4,112.51,50
,20130606,281.53,281.27,,,,280.64,280.64,-0.63,-0.63,0,0,50
,20130607,280.64,280.64,282.64,282.64,282.16,282.16,282.4,1.52,1.76,4,112.96,48
,20130613,282.16,282.4,280.05,280.06,278.72,278.72,279.39,-3.68,-3.01,8,223.51,44
,20130614,278.72,279.39,,,,274.47,274.47,-4.92,-4.92,0,0,44
,20130617,274.47,274.47,280.82,280.82,276.94,278.93,278.8,4.46,4.33,10,278.81,44
,20130618,278.93,278.8,275.84,275.84,275.84,275.84,275.84,-2.96,-2.96,2,55.17,46
,20130619,275.84,275.84,276,276,274.32,274.32,275.16,-1.52,-0.68,4,110.06,42
,20130620,274.32,275.16,270.24,270.24,270.24,270.24,270.24,-4.92,-4.92,4,108.1,40
,20130621,270.24,270.24,256.72,259.77,256.72,259.77,257.46,-10.47,-12.78,16,411.94,32
,20130624,259.77,257.46,257.15,257.5,257.15,257.5,257.32,0.04,-0.14,8,205.86,28
,20130625,257.5,257.3,257,259.05,257,259.05,257.95,1.75,0.65,10,257.96,24
,20130626,259.05,257.95,257.95,258.45,252.9,252.9,256.45,-5.05,-1.5,12,307.79,24
,20130627,252.9,256.45,249.05,252.05,248.8,252.05,249.6,-4.4,-6.85,40,998.41,12
,20130628,252.05,249.6,242.8,244,242.2,242.45,243.1,-7.15,-6.5,14,340.4,12
,20130701,242.45,243.1,245,255.05,245,252,251.1,8.9,8,48,"1,205.49",12
,20130702,252,251.1,,,,251.1,251.1,0,0,0,0,12
,20130703,251.1,251.1,,,,251.1,251.1,0,0,0,0,12
,20130704,251.1,251.1,,,,251.1,251.1,0,0,0,0,12
,20130705,251.1,251.1,,,,251.1,251.1,0,0,0,0,12
,20130708,251.1,251.1,,,,251.1,251.1,0,0,0,0,12
,20130709,251.1,251.1,251.5,253.05,251.5,253.05,252.5,1.95,1.4,18,454.56,0
,20130710,253.05,252.5,,,,252.5,252.5,0,0,0,0,0
,20130711,252.5,252.5,,,,252.5,252.5,0,0,0,0,0
,20130712,252.5,252.5,,,,252.5,252.5,0,0,0,0,0
,20130715,252.5,252.5,,,,252.5,252.5,0,0,0,0,0
au1308,20130104,341.35,341.35,,,,338.35,338.35,-3,-3,0,0,100
,20130107,338.35,338.35,,,,340.83,340.83,2.48,2.48,0,0,100
,20130108,340.83,340.83,,,,338.67,338.67,-2.16,-2.16,0,0,100
,20130109,338.67,338.67,,,,340.96,340.96,2.29,2.29,0,0,100
,20130110,340.96,340.96,341.47,341.47,341.47,341.47,341.47,0.51,0.51,2,68.29,102
,20130111,341.47,341.47,343.41,343.41,343.41,343.41,343.41,1.94,1.94,2,68.68,102
,20130114,343.41,343.41,,,,341.8,341.8,-1.61,-1.61,0,0,102
,20130115,341.8,341.8,343.57,343.57,343.03,343.03,343.22,1.23,1.42,6,205.93,102
,20130116,343.03,343.22,345.01,345.01,345.01,345.01,345.01,1.79,1.79,2,69,102
,20130117,345.01,345.01,,,,344.14,344.14,-0.87,-0.87,0,0,102
,20130118,344.14,344.14,,,,346.31,346.31,2.17,2.17,0,0,102
,20130121,346.31,346.31,,,,346.36,346.36,0.05,0.05,0,0,102
,20130122,346.36,346.36,345.83,345.83,345.83,345.83,345.83,-0.53,-0.53,4,138.33,104
,20130123,345.83,345.83,,,,345.94,345.94,0.11,0.11,0,0,104
,20130124,345.94,345.94,343.5,343.5,343.5,343.5,343.5,-2.44,-2.44,2,68.7,104
,20130125,343.5,343.5,342.09,342.09,342.09,342.09,342.09,-1.41,-1.41,2,68.42,104
,20130128,342.09,342.09,340.6,340.6,340.48,340.57,340.51,-1.52,-1.58,18,612.93,102
,20130129,340.57,340.51,340.66,341.33,340.66,341.33,341.07,0.82,0.56,8,272.86,102
,20130130,341.33,341.07,342.34,342.34,340.2,340.2,341.27,-0.87,0.2,4,136.51,102
,20130131,340.2,341.27,,,,341.27,341.27,0,0,0,0,102
,20130201,341.27,341.27,,,,338.03,338.03,-3.24,-3.24,0,0,102
,20130204,338.03,338.03,341.2,342.1,341.2,342,341.6,3.97,3.57,86,"2,937.83",118
,20130205,342,341.6,342.84,343,342.81,342.85,342.87,1.25,1.27,8,274.3,118
,20130206,342.85,342.87,341.82,341.89,341.82,341.89,341.85,-0.98,-1.02,4,136.74,118
,20130207,341.89,341.85,342.45,343.57,342.45,343.57,343.01,1.72,1.16,4,137.2,116
,20130208,343.57,343.01,,,,341.64,341.64,-1.37,-1.37,0,0,116
,20130218,341.64,341.64,334.78,334.78,331.7,331.82,333.18,-9.82,-8.46,272,"9,062.69",264
,20130219,331.82,333.18,332.27,332.37,331.78,331.78,332.09,-1.4,-1.09,22,730.61,272
,20130220,331.78,332.09,320.22,335.27,320.22,330.35,330.48,-1.74,-1.61,76,"2,511.66",324
,20130221,330.35,330.48,322.79,322.79,321.44,322.51,321.91,-7.97,-8.57,52,"1,673.95",362
,20130222,322.51,321.91,324.74,325.71,324.74,325.71,325.39,3.8,3.48,40,"1,301.58",368
,20130225,325.71,325.39,325.89,325.89,325.89,325.89,325.89,0.5,0.5,2,65.18,370
,20130226,325.89,325.89,327.89,328.69,325.95,325.95,326.51,0.06,0.62,56,"1,828.46",380
,20130227,325.95,326.51,330.21,330.47,329.35,329.4,330.01,2.89,3.5,20,660.04,368
,20130228,329.4,330.01,,,,330.01,330.01,0,0,0,0,368
,20130301,330.01,330.01,324.93,324.93,323.5,324.15,324.2,-5.86,-5.81,78,"2,528.80",396
,20130304,324.15,324.2,323.28,323.72,323.28,323.45,323.5,-0.75,-0.7,12,388.21,396
,20130305,323.45,323.5,,,,323.33,323.33,-0.17,-0.17,0,0,396
,20130306,323.33,323.33,323.74,323.74,323.74,323.74,323.74,0.41,0.41,2,64.75,398
,20130307,323.74,323.74,,,,323.74,323.74,0,0,0,0,398
,20130308,323.74,323.74,323.3,323.3,322.15,322.15,322.72,-1.59,-1.02,4,129.09,398
,20130311,322.15,322.72,323.29,323.29,323.29,323.29,323.29,0.57,0.57,2,64.66,396
,20130312,323.29,323.29,,,,323.29,323.29,0,0,0,0,396
,20130313,323.29,323.29,325.13,325.4,325.13,325.4,325.24,2.11,1.95,8,260.2,398
,20130314,325.4,325.24,323.86,323.86,323.86,323.86,323.86,-1.38,-1.38,2,64.77,396
,20130315,323.86,323.86,,,,324.8,324.8,0.94,0.94,0,0,396
,20130318,324.8,324.8,326,326,324,324.49,324.83,-0.31,0.03,6,194.9,396
,20130319,324.49,324.83,326.33,327.35,326.25,326.25,326.64,1.42,1.81,6,195.99,398
,20130320,326.25,326.64,327.29,328.31,327.29,328.31,327.41,1.67,0.77,24,785.79,388
,20130321,328.31,327.41,,,,327.41,327.41,0,0,0,0,388
,20130322,327.41,327.41,,,,327.41,327.41,0,0,0,0,388
,20130325,327.41,327.41,,,,327.41,327.41,0,0,0,0,388
,20130326,327.41,327.41,325.99,325.99,325.99,325.99,325.99,-1.42,-1.42,2,65.2,388
,20130327,325.99,325.99,325.23,325.23,325.23,325.23,325.23,-0.76,-0.76,2,65.05,386
,20130328,325.23,325.23,,,,326.43,326.43,1.2,1.2,0,0,386
,20130329,326.43,326.43,,,,324.78,324.78,-1.65,-1.65,0,0,386
,20130401,324.78,324.78,,,,323.94,323.94,-0.84,-0.84,0,0,386
,20130402,323.94,323.94,,,,325.55,325.55,1.61,1.61,0,0,386
,20130403,325.55,325.55,318.24,319.11,316.01,317.92,318.17,-7.63,-7.38,100,"3,181.76",422
,20130408,317.92,318.17,320.24,320.24,319.52,319.52,319.76,1.35,1.59,68,"2,174.42",450
,20130409,319.52,319.76,319.58,319.76,319.58,319.6,319.67,-0.16,-0.09,44,"1,406.55",472
,20130410,319.6,319.67,322.04,322.04,321.01,321.01,321.52,1.34,1.85,4,128.61,470
,20130411,321.01,321.52,316.55,316.6,315.44,315.61,316.05,-5.91,-5.47,88,"2,781.31",508
,20130412,315.61,316.05,315.61,316.49,315.61,316.49,316.42,0.44,0.37,28,886,520
,20130415,316.49,316.42,,,,300.59,300.59,-15.83,-15.83,0,0,520
,20130416,300.59,300.59,,,,285.56,285.56,-15.03,-15.03,0,0,520
,20130417,285.56,285.56,275.17,277,272.19,274.6,275.6,-10.96,-9.96,538,"14,827.53",328
,20130418,274.6,275.6,271.5,276.24,267.71,276.18,272.59,0.58,-3.01,108,"2,944.05",306
,20130419,276.18,272.59,277.01,285,276,282.58,280.92,9.99,8.33,72,"2,022.65",296
,20130422,282.58,280.92,283.42,286.52,283.22,284.21,284.17,3.29,3.25,128,"3,637.42",254
,20130423,284.21,284.17,284.7,285.1,279.01,280.15,282.96,-4.02,-1.21,152,"4,301.01",212
,20130424,280.15,282.96,282.95,285.21,282.95,284.9,284.42,1.94,1.46,40,"1,137.71",220
,20130425,284.9,284.42,285.2,289.06,285.02,289.06,286.66,4.64,2.24,72,"2,064.01",220
,20130426,289.06,286.66,296.59,298.01,294.06,295.02,295.34,8.36,8.68,52,"1,535.79",204
,20130502,295.02,295.34,290.13,290.13,287.18,288.9,288.74,-6.44,-6.6,56,"1,616.95",212
,20130503,288.9,288.74,291.13,292.98,291.13,292.4,292.13,3.66,3.39,34,993.24,216
,20130506,292.4,292.13,294.29,295.13,291.96,293.66,293.93,1.53,1.8,148,"4,350.17",190
,20130507,293.66,293.93,292.6,293.04,289.39,289.39,291.4,-4.54,-2.53,74,"2,156.41",194
,20130508,289.39,291.4,,,,291.4,291.4,0,0,0,0,194
,20130509,291.4,291.4,293.56,293.65,292.83,293.2,293.27,1.8,1.87,46,"1,349.04",176
,20130510,293.2,293.27,289.12,292.3,288.78,290.65,289.71,-2.62,-3.56,28,811.2,188
,20130513,290.65,289.71,287.65,287.65,284.72,285.4,286.16,-4.31,-3.55,10,286.16,192
,20130514,285.4,286.16,288.18,288.86,287.14,287.14,288.07,0.98,1.91,40,"1,152.31",190
,20130515,287.14,288.07,285.06,285.06,281.92,281.92,283.11,-6.15,-4.96,8,226.49,190
,20130516,281.92,283.11,280.14,280.14,279.01,279.98,279.51,-3.13,-3.6,36,"1,006.27",184
,20130517,279.98,279.51,280.02,280.29,277,278.2,278.44,-1.31,-1.07,40,"1,113.79",182
,20130520,278.2,278.44,272.06,272.06,270.85,271.34,271.27,-7.1,-7.17,24,651.06,192
,20130521,271.34,271.27,280,281.5,278.24,281,278.98,9.73,7.71,138,"3,849.99",164
,20130522,281,278.98,277.88,279.6,277.88,279.6,278.54,0.62,-0.44,20,557.08,156
,20130523,279.6,278.54,274.44,277.55,273.34,277.55,275.18,-0.99,-3.36,32,880.6,156
,20130524,277.55,275.18,278.59,280.55,278.59,279.52,279.42,4.34,4.24,26,726.51,160
,20130527,279.52,279.42,278.25,280.45,278.25,280.45,279.39,1.03,-0.03,8,223.52,156
,20130528,280.45,279.39,278.61,278.61,278.61,278.61,278.61,-0.78,-0.78,4,111.44,152
,20130529,278.61,278.61,278.34,278.4,278.34,278.4,278.37,-0.21,-0.24,4,111.35,150
,20130530,278.4,278.37,279.95,282.65,279.81,282.65,280.7,4.28,2.33,18,505.27,146
,20130531,282.65,280.7,284.93,284.93,283.6,283.67,284.43,2.97,3.73,24,682.64,148
,20130603,283.67,284.43,279.65,279.76,279.59,279.65,279.66,-4.78,-4.77,8,223.73,148
,20130604,279.65,279.66,,,,279.66,279.66,0,0,0,0,148
,20130605,279.66,279.66,279.91,281.64,279.91,280.8,281.03,1.14,1.37,14,393.45,152
,20130606,280.8,281.03,277.84,277.84,277.84,277.84,277.84,-3.19,-3.19,2,55.57,154
,20130607,277.84,277.84,284.86,284.86,281.55,282,282.36,4.16,4.52,46,"1,298.88",170
,20130613,282,282.36,278.56,278.56,278.56,278.56,278.56,-3.8,-3.8,4,111.42,170
,20130614,278.56,278.56,277.26,277.6,277.26,277.6,277.49,-0.96,-1.07,12,332.99,166
,20130617,277.6,277.49,276.86,279,276.86,278.51,278.12,1.02,0.63,12,333.75,164
,20130618,278.51,278.12,277.05,279.09,276.14,276.14,277.6,-1.98,-0.52,12,333.13,166
,20130619,276.14,277.6,273.9,274,273.9,274,273.95,-3.6,-3.65,4,109.58,162
,20130620,274,273.95,269.16,269.64,269.16,269.52,269.47,-4.43,-4.48,8,215.58,162
,20130621,269.52,269.47,256,260.12,256,259.99,258.78,-9.48,-10.69,38,983.37,166
,20130624,259.99,258.78,259.8,259.8,259.8,259.8,259.8,1.02,1.02,8,207.84,160
,20130625,259.8,259.8,257.75,258.75,257.7,257.7,257.85,-2.1,-1.95,20,515.77,146
,20130626,257.7,257.85,254.6,254.6,250.45,251.25,251.65,-6.6,-6.2,36,905.97,136
,20130627,251.25,251.65,251,251.4,251,251.4,251.3,-0.25,-0.35,8,201.04,128
,20130628,251.4,251.3,242.2,245.7,242.2,244.2,244.9,-7.1,-6.4,32,783.7,130
,20130701,244.2,244.9,251.15,253.25,251.15,253.25,251.85,8.35,6.95,20,503.76,126
,20130702,253.25,251.85,255.5,256.55,255.5,256.55,255.8,4.7,3.95,40,"1,023.22",142
,20130703,256.55,255.8,253.7,254,253.1,254,253.6,-1.8,-2.2,20,507.25,134
,20130704,254,253.6,254.65,254.65,254.65,254.65,254.65,1.05,1.05,6,152.79,128
,20130705,254.65,254.65,252.4,252.4,252.05,252.05,252.2,-2.6,-2.45,4,100.89,128
,20130708,252.05,252.2,246.3,248.3,245.2,246.9,246.2,-5.3,-6,94,"2,314.36",100
,20130709,246.9,246.2,249.7,254.85,249.1,254.85,252.2,8.65,6,52,"1,311.68",86
,20130710,254.85,252.2,253.55,253.55,251.2,251.85,252.05,-0.35,-0.15,14,352.93,84
,20130711,251.85,252.05,257.45,262.4,257.45,262.4,260,10.35,7.95,14,364.04,88
,20130712,262.4,260,259.85,259.85,259.7,259.7,259.7,-0.3,-0.3,8,207.79,88
,20130715,259.7,259.7,258.9,260.25,258.7,259.9,259.65,0.2,-0.05,36,934.9,82
,20130716,259.9,259.65,257.65,260.9,257.4,258.3,258.75,-1.35,-0.9,14,362.29,78
,20130717,258.3,258.75,262.05,262.05,259.75,259.85,260.5,1.1,1.75,30,781.62,74
,20130718,259.85,260.5,260.3,260.3,255,255,258.5,-5.5,-2,6,155.11,74
,20130719,255,258.5,258.5,259.05,256.4,258.8,258.25,0.3,-0.25,14,361.59,72
,20130722,258.8,258.25,258.25,262.7,258.25,262.4,260.55,4.15,2.3,28,729.67,66
,20130723,262.4,260.55,264.15,266.4,264.15,265.6,265.55,5.05,5,46,"1,221.65",60
,20130724,265.6,265.55,265.85,268.2,265.3,266.1,266.55,0.55,1,22,586.42,60
,20130725,266.1,266.55,265.75,266.35,263.1,263.15,264.7,-3.4,-1.85,24,635.36,56
,20130726,263.15,264.7,264.4,266.35,262.45,266.35,265.35,1.65,0.65,68,"1,804.51",60
,20130729,266.35,265.35,261.45,265.15,261.05,263.65,263.1,-1.7,-2.25,510,"13,419.10",120
,20130730,263.65,263.1,264.4,266,261.55,264.65,264.6,1.55,1.5,62,"1,640.82",78
,20130731,264.65,264.6,265.2,268.7,262.85,268.05,265.1,3.45,0.5,42,"1,113.53",66
,20130801,268.05,265.1,,,,265.1,265.1,0,0,0,0,66
,20130802,265.1,265.1,261,261,254.4,254.4,258.65,-10.7,-6.45,54,"1,396.86",48
,20130805,254.4,258.65,,,,262,262,3.35,3.35,0,0,48
,20130806,262,262,260.1,260.1,258.6,258.6,259.35,-3.4,-2.65,12,311.22,36
,20130807,258.6,259.35,256.5,256.5,256.5,256.5,256.5,-2.85,-2.85,6,153.9,36
,20130808,256.5,256.5,257.05,257.05,257.05,257.05,257.05,0.55,0.55,6,154.23,36
,20130809,257.05,257.05,,,,257.05,257.05,0,0,0,0,36
,20130812,257.05,257.05,262,267,262,267,265.1,9.95,8.05,36,954.51,24
,20130813,267,265.1,268.1,268.1,268.1,268.1,268.1,3,3,24,643.44,24
,20130814,268.1,268.1,,,,268.1,268.1,0,0,0,0,24
,20130815,268.1,268.1,,,,268.1,268.1,0,0,0,0,24
au1309,20130104,340.5,340.55,,,,337.55,337.55,-3,-3,0,0,134
,20130107,337.55,337.55,341.44,341.44,341.44,341.44,341.44,3.89,3.89,4,136.58,134
,20130108,341.44,341.44,,,,339.27,339.27,-2.17,-2.17,0,0,134
,20130109,339.27,339.27,,,,339.27,339.27,0,0,0,0,134
,20130110,339.27,339.27,341.14,341.38,341.14,341.38,341.3,2.11,2.03,6,204.78,134
,20130111,341.38,341.3,343.97,343.97,343.97,343.97,343.97,2.67,2.67,2,68.79,134
,20130114,343.97,343.97,343.08,343.08,343.08,343.08,343.08,-0.89,-0.89,2,68.62,134
,20130115,343.08,343.08,342.75,343.27,342.75,343.27,343.03,0.19,-0.05,8,274.43,134
,20130116,343.27,343.03,345.82,345.82,344.87,344.87,345.58,1.84,2.55,8,276.47,130
,20130117,344.87,345.58,344.45,344.45,344.45,344.45,344.45,-1.13,-1.13,2,68.89,130
,20130118,344.45,344.45,,,,346.62,346.62,2.17,2.17,0,0,130
,20130121,346.62,346.62,346.15,346.15,345.31,345.35,345.66,-1.27,-0.96,38,"1,313.52",144
,20130122,345.35,345.66,345.67,345.86,345.67,345.86,345.76,0.2,0.1,4,138.31,140
,20130123,345.86,345.76,,,,345.87,345.87,0.11,0.11,0,0,140
,20130124,345.87,345.87,343.8,343.8,342.53,343,343.11,-2.87,-2.76,6,205.87,140
,20130125,343,343.11,341.09,341.65,341.09,341.65,341.37,-1.46,-1.74,4,136.55,138
,20130128,341.65,341.37,340.07,340.07,340.07,340.07,340.07,-1.3,-1.3,4,136.03,142
,20130129,340.07,340.07,340.07,340.41,340.07,340.41,340.1,0.34,0.03,46,"1,564.47",178
,20130130,340.41,340.1,341.2,341.63,341.2,341.24,341.35,1.14,1.25,6,204.81,178
,20130131,341.24,341.35,342.77,343.91,342.77,343.6,343.5,2.25,2.15,24,824.41,190
,20130201,343.6,343.5,340.56,340.92,340.53,340.9,340.73,-2.6,-2.77,10,340.73,192
,20130204,340.9,340.73,341.7,342.03,341.6,342.01,341.86,1.28,1.13,44,"1,504.22",204
,20130205,342.01,341.86,343.19,343.29,343.19,343.29,343.22,1.43,1.36,6,205.93,206
,20130206,343.29,343.22,342.91,343.05,341.62,341.88,342.01,-1.34,-1.21,20,684.03,214
,20130207,341.88,342.01,342.87,343.07,342.03,342.03,342.69,0.02,0.68,56,"1,919.11",208
,20130208,342.03,342.69,340.81,340.93,340.81,340.93,340.89,-1.76,-1.8,6,204.53,206
,20130218,340.93,340.89,330.43,331.29,330.41,331,330.76,-9.89,-10.13,18,595.37,210
,20130219,331,330.76,331.28,331.38,331,331,331.16,0.24,0.4,8,264.93,214
,20130220,331,331.16,321.03,330.11,321.03,330.11,328.5,-1.05,-2.66,36,"1,182.62",222
,20130221,330.11,328.5,322.4,322.56,319.76,321.98,320.85,-6.52,-7.65,30,962.56,224
,20130222,321.98,320.85,324.18,326.34,324.18,325.7,325.23,4.85,4.38,44,"1,431.04",206
,20130225,325.7,325.23,324.18,326.11,324.18,326,325.69,0.77,0.46,16,521.11,210
,20130226,326,325.69,326,328.51,325.64,325.64,326.91,-0.05,1.22,106,"3,465.25",252
,20130227,325.64,326.91,329.88,329.88,328.92,329.1,329.36,2.19,2.45,12,395.24,254
,20130228,329.1,329.36,326.55,329.87,326.55,328.12,327.58,-1.24,-1.78,30,982.76,260
,20130301,328.12,327.58,326.32,326.32,323.71,324.5,324.55,-3.08,-3.03,42,"1,363.11",250
,20130304,324.5,324.55,324.56,324.56,323.66,323.66,323.86,-0.89,-0.69,16,518.18,252
,20130305,323.66,323.86,324.62,324.68,323.87,323.87,324.26,0.01,0.4,18,583.67,258
,20130306,323.87,324.26,323.74,323.81,323.19,323.19,323.57,-1.07,-0.69,8,258.86,258
,20130307,323.19,323.57,335.92,335.92,323.78,324.54,326.17,0.97,2.6,12,391.4,254
,20130308,324.54,326.17,322.16,323.1,322.16,322.61,322.62,-3.56,-3.55,26,838.83,256
,20130311,322.61,322.62,324.1,324.11,323.4,323.57,323.8,0.95,1.18,16,518.08,258
,20130312,323.57,323.8,323.04,324.16,323.03,323.32,323.57,-0.48,-0.23,28,906,262
,20130313,323.32,323.57,325.77,325.77,324.75,325.4,325.22,1.83,1.65,20,650.45,260
,20130314,325.4,325.22,324.37,324.49,323.23,323.97,323.79,-1.25,-1.43,34,"1,100.89",266
,20130315,323.97,323.79,324.96,325.31,324.11,325.31,324.85,1.52,1.06,18,584.75,264
,20130318,325.31,324.85,325.5,326.09,323.88,323.88,324.71,-0.97,-0.14,18,584.49,262
,20130319,323.88,324.71,325.26,326.67,325.26,326.04,325.99,1.33,1.28,6,195.59,262
,20130320,326.04,325.99,326.99,327.85,326.95,327.85,327.52,1.86,1.53,16,524.03,262
,20130321,327.85,327.52,326.73,326.84,326.53,326.84,326.68,-0.68,-0.84,10,326.68,264
,20130322,326.84,326.68,327.32,327.61,327.22,327.22,327.43,0.54,0.75,16,523.89,264
,20130325,327.22,327.43,327,327.54,326.32,326.74,326.8,-0.69,-0.63,16,522.89,268
,20130326,326.74,326.8,326.1,326.1,325.5,325.5,325.55,-1.3,-1.25,22,716.22,266
,20130327,325.5,325.55,326.17,326.17,323.81,323.81,324.99,-1.74,-0.56,16,520,264
,20130328,323.81,324.99,326.92,326.92,325.2,325.9,326.14,0.91,1.15,50,"1,630.71",282
,20130329,325.9,326.14,322.59,324.37,322.09,324.14,323.45,-2,-2.69,90,"2,911.12",286
,20130401,324.14,323.45,324.49,324.92,324.38,324.38,324.71,0.93,1.26,28,909.2,282
,20130402,324.38,324.71,325.24,325.44,324.78,325.44,325.03,0.73,0.32,66,"2,145.21",316
,20130403,325.44,325.03,319.39,319.39,317.2,318.19,318.23,-6.84,-6.8,80,"2,545.87",316
,20130408,318.19,318.23,318.13,321.17,318.13,320.85,319.75,2.62,1.52,38,"1,215.06",302
,20130409,320.85,319.75,320,320.34,319.98,319.99,320.03,0.24,0.28,18,576.06,310
,20130410,319.99,320.03,322.72,322.72,321.72,322,322.15,1.97,2.12,44,"1,417.47",320
,20130411,322,322.15,317.2,317.2,315.5,315.66,316.07,-6.49,-6.08,154,"4,867.61",378
,20130412,315.66,316.07,316.25,316.45,315.86,315.88,316.25,-0.19,0.18,44,"1,391.51",364
,20130415,315.88,316.25,300.52,301.28,300.43,300.43,300.75,-15.82,-15.5,66,"1,984.99",404
,20130416,300.43,300.75,276.69,278.84,276.69,276.95,276.93,-23.8,-23.82,256,"7,089.54",378
,20130417,276.95,276.93,276.87,277.87,263.24,275.58,276.1,-1.35,-0.83,248,"6,847.47",388
,20130418,275.58,276.1,275.58,276.99,265.5,276.99,272.32,0.89,-3.78,312,"8,496.47",432
,20130419,276.99,272.32,276.6,285.45,276.6,282.01,281.4,9.69,9.08,322,"9,061.39",418
,20130422,282.01,281.4,284.78,285.39,282.94,284.49,284.25,3.09,2.85,246,"6,992.60",368
,20130423,284.49,284.25,284.45,285.31,280.41,282.19,282.44,-2.06,-1.81,586,"16,551.47",476
,20130424,282.19,282.44,283.5,286.28,283.5,286.28,284.73,3.84,2.29,118,"3,359.92",468
,20130425,286.28,284.73,286,290.54,286,289.55,289.06,4.82,4.33,186,"5,376.66",476
,20130426,289.55,289.06,293,298.87,293,296.21,297.03,7.15,7.97,208,"6,178.32",480
,20130502,296.21,297.03,291.38,291.38,288.68,289.75,289.87,-7.28,-7.16,296,"8,580.42",500
,20130503,289.75,289.87,290.01,293.83,290.01,293.41,293.16,3.54,3.29,82,"2,403.92",500
,20130506,293.41,293.16,295.01,295.01,293.16,293.23,294.07,0.07,0.91,138,"4,058.24",484
,20130507,293.23,294.07,292.59,292.78,288.8,288.8,291.22,-5.27,-2.85,184,"5,358.57",470
,20130508,288.8,291.22,288.3,290.38,286.97,289.99,288.94,-1.23,-2.28,194,"5,605.54",486
,20130509,289.99,288.94,292.61,293.7,292.25,292.4,293.14,3.46,4.2,166,"4,866.22",466
,20130510,292.4,293.14,288.51,291.26,278.58,291.25,288.96,-1.89,-4.18,276,"7,975.39",462
,20130513,291.25,288.96,286.45,286.56,283.71,285.13,285.31,-3.83,-3.65,310,"8,844.76",504
,20130514,285.13,285.31,287.18,288.92,286,286,287.5,0.69,2.19,304,"8,740.15",432
,20130515,286,287.5,282.51,285.55,282,282,283.92,-5.5,-3.58,184,"5,224.30",434
,20130516,282,283.92,279.87,279.87,277.9,277.9,279.11,-6.02,-4.81,286,"7,982.57",406
,20130517,277.9,279.11,279.16,279.52,276.51,277.02,277.69,-2.09,-1.42,218,"6,053.72",444
,20130520,277.02,277.69,269.76,271.57,269.75,271.57,270.81,-6.12,-6.88,292,"7,907.78",516
,20130521,271.57,270.81,280,281.3,277.97,279.98,279.34,9.17,8.53,488,"13,632.10",378
,20130522,279.98,279.34,277.45,279.81,276.31,279.81,277.55,0.47,-1.79,144,"3,996.78",384
,20130523,279.81,277.55,274.24,276.35,272.84,275.87,274.36,-1.68,-3.19,286,"7,846.88",412
,20130524,275.87,274.36,277.94,279.33,277.55,278.4,278.47,4.04,4.11,270,"7,518.89",390
,20130527,278.4,278.47,277.33,278.97,277.05,278.87,278.26,0.4,-0.21,114,"3,172.16",388
,20130528,278.87,278.26,277.93,278.55,277.49,277.63,278,-0.63,-0.26,168,"4,670.53",370
,20130529,277.63,278,277.78,278.25,277,277.35,277.51,-0.65,-0.49,122,"3,385.64",372
,20130530,277.35,277.51,278.36,282.31,278.2,281.54,280.55,4.03,3.04,322,"9,033.95",360
,20130531,281.54,280.55,282.97,284.29,282.42,283.16,283.55,2.61,3,146,"4,139.90",358
,20130603,283.16,283.55,279.61,280.27,279,279.78,279.43,-3.77,-4.12,156,"4,359.11",362
,20130604,279.78,279.43,284.13,284.17,280.52,280.96,282.24,1.53,2.81,180,"5,080.46",360
,20130605,280.96,282.24,279.3,281.02,279.11,280.42,280.18,-1.82,-2.06,212,"5,939.96",366
,20130606,280.42,280.18,279.75,280.14,278.04,278.16,279.06,-2.02,-1.12,144,"4,018.57",372
,20130607,278.16,279.06,280.57,282.18,280.57,281.37,281.59,2.31,2.53,342,"9,630.44",346
,20130613,281.37,281.59,276.55,278.65,276.55,278.44,278.07,-3.15,-3.52,406,"11,289.91",406
,20130614,278.44,278.07,278.45,278.45,277.08,277.35,277.59,-0.72,-0.48,176,"4,885.75",400
,20130617,277.35,277.59,277.89,278.44,277.43,277.5,278.02,-0.09,0.43,184,"5,115.69",350
,20130618,277.5,278.02,277.21,277.25,275.64,276.21,276.39,-1.81,-1.63,208,"5,748.92",370
,20130619,276.21,276.39,274.36,274.75,273.64,274.75,274.16,-1.64,-2.23,122,"3,344.79",366
,20130620,274.75,274.16,269.43,270.27,267.22,267.22,269.65,-6.94,-4.51,252,"6,795.33",332
,20130621,267.22,269.65,256.16,261.7,256.16,261.13,259.74,-8.52,-9.91,266,"6,909.09",346
,20130624,261.13,259.74,261.78,261.78,256.05,256.27,259.15,-3.47,-0.59,252,"6,530.60",324
,20130625,256.25,259.15,257.25,259.05,256.5,257.8,257.5,-1.35,-1.65,102,"2,627.00",322
,20130626,257.8,257.5,256.1,256.1,249.6,250.55,252.3,-6.95,-5.2,292,"7,367.17",282
,20130627,250.55,252.3,247.15,251.35,247.15,250.25,249.9,-2.05,-2.4,112,"2,799.27",272
,20130628,250.25,249.9,241.95,244.8,240,243,242.5,-6.9,-7.4,524,"12,708.48",490
,20130701,243,242.5,247.6,253.2,247.55,252.8,250.85,10.3,8.35,426,"10,686.82",350
,20130702,252.8,250.85,254.6,255.25,253.8,254.55,254.55,3.7,3.7,96,"2,444.13",346
,20130703,254.55,254.55,255.3,255.3,252,252.95,253.75,-1.6,-0.8,122,"3,096.04",330
,20130704,252.95,253.75,254.5,254.7,253.1,253.8,254.05,0.05,0.3,60,"1,524.38",310
,20130705,253.8,254.05,253,253,251,251.7,251.75,-2.35,-2.3,48,"1,208.51",310
,20130708,251.7,251.75,247.7,248.55,245.45,246.15,246.7,-5.6,-5.05,112,"2,763.13",286
,20130709,246.15,246.7,248.4,253.8,248.4,253.15,250.95,6.45,4.25,110,"2,760.57",276
,20130710,253.15,250.95,251.5,252.15,251,251,251.65,0.05,0.7,24,604.02,274
,20130711,251,251.65,253.5,261.05,252.15,260.05,258.05,8.4,6.4,88,"2,271.02",258
,20130712,260.05,258.05,259.25,259.35,256.8,256.8,258.25,-1.25,0.2,28,723.15,258
,20130715,256.8,258.25,257.75,260.3,257.2,259.25,258.45,1,0.2,46,"1,189.00",250
,20130716,259.25,258.45,258.15,258.15,257.55,257.55,257.85,-0.9,-0.6,8,206.28,250
,20130717,257.55,257.85,259.65,260.05,258.45,258.45,259.5,0.6,1.65,50,"1,297.60",222
,20130718,258.45,259.5,255.9,257.8,255.4,256.1,256.2,-3.4,-3.3,66,"1,691.13",240
,20130719,256.1,256.2,257.8,259.1,256.95,258.75,257.75,2.55,1.55,32,824.85,226
,20130722,258.75,257.75,260,263.95,260,263.6,262.75,5.85,5,80,"2,102.13",214
,20130723,263.6,262.75,264.45,266.7,264.05,265.35,265.9,2.6,3.15,84,"2,233.61",220
,20130724,265.35,265.9,265.9,267.25,265.3,267.2,266.4,1.3,0.5,20,532.85,222
,20130725,267.2,266.4,263.5,263.9,263.2,263.55,263.4,-2.85,-3,16,421.45,218
,20130726,263.55,263.4,266.1,266.5,265.4,265.4,266.2,2,2.8,86,"2,289.47",244
,20130729,265.4,266.2,263.65,264.25,263.65,263.85,263.9,-2.35,-2.3,18,475.1,254
,20130730,263.85,263.9,,,,265.45,265.45,1.55,1.55,0,0,254
,20130731,265.45,265.45,265.45,265.95,265.35,265.95,265.55,0.5,0.1,12,318.7,250
,20130801,265.95,265.55,262.55,265.05,262.55,263.9,263.7,-1.65,-1.85,14,369.18,252
,20130802,263.9,263.7,261.1,261.8,257,257,260.25,-6.7,-3.45,28,728.81,234
,20130805,257,260.25,261.7,263.5,261.7,263,262.45,2.75,2.2,36,944.89,234
,20130806,263,262.45,258.4,258.7,258.4,258.7,258.55,-3.75,-3.9,6,155.14,232
,20130807,258.7,258.55,257.25,271.45,254.95,256.6,257.85,-1.95,-0.7,48,"1,237.80",220
,20130808,256.6,257.85,256.95,258.7,256.75,258.2,258.1,0.35,0.25,16,412.97,220
,20130809,258.2,258.1,258.75,262.9,258.7,261.1,260.4,3,2.3,12,312.49,216
,20130812,261.1,260.4,265.35,266.1,265.2,265.75,265.8,5.35,5.4,40,"1,063.31",206
,20130813,265.75,265.8,268.35,268.35,266.4,267.5,266.95,1.7,1.15,22,587.32,206
,20130814,267.5,266.95,266.95,266.95,263.95,264.4,265.25,-2.55,-1.7,60,"1,591.53",198
,20130815,264.4,265.25,263.35,268.35,263.35,268.35,266.25,3.1,1,8,213.02,194
,20130816,268.35,266.25,265.4,274.1,264.95,272.35,270.5,6.1,4.25,12,324.64,196
,20130819,272.35,270.5,274.75,276.5,274.5,274.5,275.55,4,5.05,30,826.75,196
,20130820,274.5,275.55,272.5,272.5,270.15,271.15,271.25,-4.4,-4.3,6,162.76,194
,20130821,271.15,271.25,273.15,273.55,273.15,273.55,273.4,2.3,2.15,16,437.44,190
,20130822,273.55,273.4,272.5,272.5,272.1,272.1,272.4,-1.3,-1,24,653.76,166
,20130823,272.1,272.4,276.1,276.1,273.75,275.2,275.1,2.8,2.7,212,"5,832.43",94
,20130826,275.2,275.1,278.75,279.25,276.25,279.25,278.05,4.15,2.95,10,278.07,90
,20130827,279.25,278.05,278,278.45,277.35,278.1,277.7,0.05,-0.35,46,"1,277.48",82
,20130828,278.1,277.7,282.55,284.7,281.25,284.25,282.35,6.55,4.65,78,"2,202.62",78
,20130829,284.25,282.35,282.35,282.35,279.75,281.55,280.75,-0.8,-1.6,14,393.06,74
,20130830,281.55,280.75,277.8,283.05,277.4,279,279.95,-1.75,-0.8,42,"1,175.89",66
,20130902,279,279.95,,,,279,279,-0.95,-0.95,0,0,66
,20130903,279,279,,,,279,279,0,0,0,0,66
,20130904,279,279,,,,279,279,0,0,0,0,66
,20130905,279,279,275,275,275,275,275,-4,-4,24,660,42
,20130906,275,275,272,272.5,272,272.5,272.1,-2.5,-2.9,24,653.1,18
,20130909,272.5,272.1,,,,272.1,272.1,0,0,0,0,18
,20130910,272.1,272.1,272.1,273,272,272,272.35,-0.1,0.25,18,490.26,12
,20130911,272,272.35,272.15,272.15,264,264,268.05,-8.35,-4.3,12,321.69,6
,20130912,264,268.05,,,,268.05,268.05,0,0,0,0,6
,20130913,268.05,268.05,,,,268.05,268.05,0,0,0,0,6
,20130916,268.05,268.05,,,,268.05,268.05,0,0,0,0,6
au1310,20130104,343.6,343.77,339.14,339.14,339.14,339.14,339.14,-4.63,-4.63,4,135.66,12
,20130107,339.14,339.14,342.18,342.57,342.18,342.57,342.31,3.43,3.17,6,205.39,14
,20130108,342.57,342.31,,,,340.14,340.14,-2.17,-2.17,0,0,14
,20130109,340.14,340.14,,,,342.44,342.44,2.3,2.3,0,0,14
,20130110,342.44,342.44,341.04,341.04,341.04,341.04,341.04,-1.4,-1.4,2,68.21,14
,20130111,341.04,341.04,,,,343.7,343.7,2.66,2.66,0,0,14
,20130114,343.7,343.7,342.1,342.1,342.1,342.1,342.1,-1.6,-1.6,10,342.1,14
,20130115,342.1,342.1,342.96,342.96,342.96,342.96,342.96,0.86,0.86,2,68.59,12
,20130116,342.96,342.96,345.61,345.61,345.61,345.61,345.61,2.65,2.65,2,69.12,12
,20130117,345.61,345.61,,,,344.47,344.47,-1.14,-1.14,0,0,12
,20130118,344.47,344.47,,,,346.64,346.64,2.17,2.17,0,0,12
,20130121,346.64,346.64,,,,345.68,345.68,-0.96,-0.96,0,0,12
,20130122,345.68,345.68,,,,345.68,345.68,0,0,0,0,12
,20130123,345.68,345.68,346.91,346.91,346.91,346.91,346.91,1.23,1.23,2,69.38,12
,20130124,346.91,346.91,,,,344.14,344.14,-2.77,-2.77,0,0,12
,20130125,344.14,344.14,,,,342.39,342.39,-1.75,-1.75,0,0,12
,20130128,342.39,342.39,,,,341.08,341.08,-1.31,-1.31,0,0,12
,20130129,341.08,341.08,,,,341.11,341.11,0.03,0.03,0,0,12
,20130130,341.11,341.11,,,,342.37,342.37,1.26,1.26,0,0,12
,20130131,342.37,342.37,,,,344.53,344.53,2.16,2.16,0,0,12
,20130201,344.53,344.53,,,,341.75,341.75,-2.78,-2.78,0,0,12
,20130204,341.75,341.75,342.45,342.45,342.42,342.42,342.43,0.67,0.68,4,136.97,10
,20130205,342.42,342.43,,,,343.79,343.79,1.36,1.36,0,0,10
,20130206,343.79,343.79,342.17,342.17,342.17,342.17,342.17,-1.62,-1.62,2,68.43,12
,20130207,342.17,342.17,343.78,343.78,343.28,343.28,343.53,1.11,1.36,4,137.41,14
,20130208,343.28,343.53,,,,341.72,341.72,-1.81,-1.81,0,0,14
,20130218,341.72,341.72,,,,331.56,331.56,-10.16,-10.16,0,0,14
,20130219,331.56,331.56,,,,331.96,331.96,0.4,0.4,0,0,14
,20130220,331.96,331.96,,,,329.29,329.29,-2.67,-2.67,0,0,14
,20130221,329.29,329.29,,,,321.62,321.62,-7.67,-7.67,0,0,14
,20130222,321.62,321.62,,,,326.01,326.01,4.39,4.39,0,0,14
,20130225,326.01,326.01,324.89,324.89,324.89,324.89,324.89,-1.12,-1.12,2,64.98,12
,20130226,324.89,324.89,,,,326.1,326.1,1.21,1.21,0,0,12
,20130227,326.1,326.1,,,,328.55,328.55,2.45,2.45,0,0,12
,20130228,328.55,328.55,,,,326.78,326.78,-1.77,-1.77,0,0,12
,20130301,326.78,326.78,,,,323.75,323.75,-3.03,-3.03,0,0,12
,20130304,323.75,323.75,,,,323.06,323.06,-0.69,-0.69,0,0,12
,20130305,323.06,323.06,,,,323.46,323.46,0.4,0.4,0,0,12
,20130306,323.46,323.46,,,,322.77,322.77,-0.69,-0.69,0,0,12
,20130307,322.77,322.77,,,,325.36,325.36,2.59,2.59,0,0,12
,20130308,325.36,325.36,,,,325.36,325.36,0,0,0,0,12
,20130311,325.36,325.36,,,,324.23,324.23,-1.13,-1.13,0,0,12
,20130312,324.23,324.23,,,,324.23,324.23,0,0,0,0,12
,20130313,324.23,324.23,,,,325.88,325.88,1.65,1.65,0,0,12
,20130314,325.88,325.88,,,,325.88,325.88,0,0,0,0,12
,20130315,325.88,325.88,,,,326.95,326.95,1.07,1.07,0,0,12
,20130318,326.95,326.95,,,,326.81,326.81,-0.14,-0.14,0,0,12
,20130319,326.81,326.81,,,,328.09,328.09,1.28,1.28,0,0,12
,20130320,328.09,328.09,328.11,328.11,328.11,328.11,328.11,0.02,0.02,2,65.62,14
,20130321,328.11,328.11,,,,328.11,328.11,0,0,0,0,14
,20130322,328.11,328.11,,,,328.11,328.11,0,0,0,0,14
,20130325,328.11,328.11,,,,327.48,327.48,-0.63,-0.63,0,0,14
,20130326,327.48,327.48,,,,326.23,326.23,-1.25,-1.25,0,0,14
,20130327,326.23,326.23,,,,325.67,325.67,-0.56,-0.56,0,0,14
,20130328,325.67,325.67,326.49,326.49,326.49,326.49,326.49,0.82,0.82,2,65.3,12
,20130329,326.49,326.49,324.92,324.92,324.39,324.39,324.65,-2.1,-1.84,4,129.86,12
,20130401,324.39,324.65,,,,325.91,325.91,1.26,1.26,0,0,12
,20130402,325.91,325.91,325.77,325.77,325.1,325.1,325.54,-0.81,-0.37,6,195.33,14
,20130403,325.1,325.54,,,,318.73,318.73,-6.81,-6.81,0,0,14
,20130408,318.73,318.73,320,320,320,320,320,1.27,1.27,2,64,14
,20130409,320,320,320.64,320.64,319.76,319.76,320.31,-0.24,0.31,6,192.19,14
,20130410,319.76,320.31,321.64,322.12,321.64,321.75,321.89,1.44,1.58,10,321.89,14
,20130411,321.75,321.89,316.4,316.4,316.36,316.36,316.37,-5.53,-5.52,6,189.82,16
,20130412,316.36,316.37,316.66,316.66,316.01,316.58,316.31,0.21,-0.06,8,253.05,14
,20130415,316.58,316.31,301,301,300.49,300.49,300.74,-15.82,-15.57,4,120.3,16
,20130416,300.49,300.74,276.68,278.75,276.68,278.17,277.69,-22.57,-23.05,76,"2,110.46",46
,20130417,278.17,277.69,275.76,277.81,275,275.37,276.02,-2.32,-1.67,14,386.44,40
,20130418,275.37,276.02,272.1,273.79,268.6,273.7,271.86,-2.32,-4.16,54,"1,468.06",46
,20130419,273.7,271.86,277.41,280.7,277.41,280.7,279.07,8.84,7.21,22,613.96,56
,20130422,280.7,279.07,283.86,285.52,283.86,284.83,284.58,5.76,5.51,18,512.25,58
,20130423,284.83,284.58,285.06,285.06,280,282,283.03,-2.58,-1.55,20,566.08,58
,20130424,282,283.03,284.2,286.24,284.05,285.4,285.05,2.37,2.02,14,399.08,58
,20130425,285.4,285.05,287.48,289.75,286.65,289.31,288.44,4.26,3.39,24,692.26,50
,20130426,289.31,288.44,298.81,298.81,297.53,298,298.11,9.56,9.67,6,178.87,50
,20130502,298,298.11,290.16,290.16,288.54,289.78,289.42,-8.33,-8.69,16,463.09,42
,20130503,289.78,289.42,293.69,294.35,293.69,294.35,294.01,4.93,4.59,6,176.41,42
,20130506,294.35,294.01,,,,294.92,294.92,0.91,0.91,0,0,42
,20130507,294.92,294.92,290.75,290.75,290.75,290.75,290.75,-4.17,-4.17,2,58.15,42
,20130508,290.75,290.75,288.54,289.88,288.54,289.88,288.95,-0.87,-1.8,64,"1,849.32",46
,20130509,289.88,288.95,292.72,293.64,292.72,293.64,293.33,4.69,4.38,6,176,46
,20130510,293.64,293.33,,,,289.15,289.15,-4.18,-4.18,0,0,46
,20130513,289.15,289.15,284.99,286.45,283.65,286.45,285.65,-2.7,-3.5,32,914.1,66
,20130514,286.45,285.65,287.68,288.24,286.83,287.89,287.53,2.24,1.88,54,"1,552.67",60
,20130515,287.89,287.53,282.75,282.75,282.49,282.49,282.54,-5.04,-4.99,10,282.54,56
,20130516,282.49,282.54,,,,277.75,277.75,-4.79,-4.79,0,0,56
,20130517,277.75,277.75,,,,276.34,276.34,-1.41,-1.41,0,0,56
,20130520,276.34,276.34,269.8,271.26,267.11,269.21,269.47,-7.13,-6.87,16,431.16,58
,20130521,269.21,269.47,278.44,281.46,277.53,277.86,278.35,8.39,8.88,20,556.71,58
,20130522,277.86,278.35,,,,276.57,276.57,-1.78,-1.78,0,0,58
,20130523,276.57,276.57,273.83,278.04,273.83,278.04,276.98,1.47,0.41,8,221.59,62
,20130524,278.04,276.98,278.45,280.57,278.45,279.97,279.57,2.99,2.59,24,670.98,64
,20130527,279.97,279.57,278.48,280.15,278.48,280.15,278.91,0.58,-0.66,32,892.54,66
,20130528,280.15,278.91,279.19,279.19,279.19,279.19,279.19,0.28,0.28,2,55.84,64
,20130529,279.19,279.19,278.65,278.7,278.65,278.7,278.67,-0.49,-0.52,4,111.47,68
,20130530,278.7,278.67,280.25,283.85,280.02,283.01,282.44,4.34,3.77,1176,"33,216.04",490
,20130531,283.01,282.44,284.61,284.76,283.35,283.9,284.26,1.46,1.82,586,"16,658.00",116
,20130603,283.9,284.26,279.85,281.31,279.29,279.57,279.9,-4.69,-4.36,16,447.85,114
,20130604,279.57,279.9,283.2,283.33,274.02,281.34,281.59,1.44,1.69,18,506.86,114
,20130605,281.34,281.59,279.64,279.64,279.64,279.64,279.64,-1.95,-1.95,2,55.93,112
,20130606,279.64,279.64,280.32,280.32,279.88,279.88,280.03,0.24,0.39,6,168.02,110
,20130607,279.88,280.03,,,,282.57,282.57,2.54,2.54,0,0,110
,20130613,282.57,282.57,278.56,278.87,278.5,278.5,278.66,-4.07,-3.91,10,278.66,110
,20130614,278.5,278.66,,,,278.18,278.18,-0.48,-0.48,0,0,110
,20130617,278.18,278.18,,,,278.61,278.61,0.43,0.43,0,0,110
,20130618,278.61,278.61,277.06,277.75,275.49,275.76,276.62,-2.85,-1.99,24,663.91,108
,20130619,275.76,276.62,273.9,274.48,273.9,274.48,274.1,-2.14,-2.52,10,274.11,108
,20130620,274.48,274.1,267.42,270.24,267.42,269.25,268.7,-4.85,-5.4,36,967.35,104
,20130621,269.25,268.7,257.62,261.44,256.58,260.43,258.69,-8.27,-10.01,38,983.03,98
,20130624,260.43,258.69,260.93,260.93,255.58,256.24,256.92,-2.45,-1.77,36,924.93,118
,20130625,256.25,256.9,257.3,258.6,257.25,258.2,258,1.3,1.1,78,"2,012.41",110
,20130626,258.2,258,254.05,254.05,249.85,250.7,250.3,-7.3,-7.7,134,"3,354.26",220
,20130627,250.7,250.3,250.35,252.1,249.75,250.8,251.1,0.5,0.8,86,"2,159.80",204
,20130628,250.8,251.1,239.25,245.5,239.25,244.7,241.85,-6.4,-9.25,150,"3,628.32",120
,20130701,244.7,241.85,247.45,253,247.45,253,249.2,11.15,7.35,70,"1,744.61",100
,20130702,253,249.2,254,254.3,254,254.3,254.15,5.1,4.95,18,457.49,94
,20130703,254.3,254.15,253,253,251.8,252.35,252.3,-1.8,-1.85,18,454.2,96
,20130704,252.35,252.3,254.15,254.25,253.9,253.9,254.05,1.6,1.75,8,203.24,100
,20130705,253.9,254.05,253.4,253.4,250.1,251.1,251.8,-2.95,-2.25,94,"2,367.22",100
,20130708,251.1,251.8,247.1,247.1,244.2,245.7,245.75,-6.1,-6.05,92,"2,261.26",96
,20130709,245.7,245.75,247.15,253.85,247.15,253.3,250.55,7.55,4.8,50,"1,252.97",88
,20130710,253.3,250.55,250.8,252.85,250.45,251.5,251.45,0.95,0.9,42,"1,056.12",92
,20130711,251.5,251.45,253.4,260.75,253.35,259.75,258.55,8.3,7.1,58,"1,499.66",90
,20130712,259.75,258.55,259.05,259.2,257.65,258.2,258.4,-0.35,-0.15,34,878.68,96
,20130715,258.2,258.4,257.3,259.7,257.3,259.7,258.5,1.3,0.1,4,103.4,92
,20130716,259.7,258.5,258.65,259.2,257.1,257.7,258.15,-0.8,-0.35,228,"5,886.78",82
,20130717,257.7,258.15,259.8,259.8,258.75,258.75,259.1,0.6,0.95,22,570.03,76
,20130718,258.75,259.1,259.8,260.6,255.55,255.55,258.05,-3.55,-1.05,24,619.35,80
,20130719,255.55,258.05,257.65,257.75,257.5,257.55,257.55,-0.5,-0.5,16,412.1,72
,20130722,257.55,257.55,260.6,263.85,260.6,263.6,263,6.05,5.45,38,999.46,64
,20130723,263.6,263,265.75,265.75,265.35,265.35,265.55,2.35,2.55,12,318.66,66
,20130724,265.35,265.55,265.65,268.4,265.65,267.2,267.15,1.65,1.6,14,374.04,66
,20130725,267.2,267.15,265.05,266.05,263.05,263.05,263.95,-4.1,-3.2,14,369.56,66
,20130726,263.05,263.95,265.5,266.3,265.5,265.85,265.9,1.9,1.95,22,584.99,74
,20130729,265.85,265.9,263.4,263.75,263.1,263.1,263.45,-2.8,-2.45,12,316.14,72
,20130730,263.1,263.45,263.45,264.25,263.3,263.3,263.65,-0.15,0.2,26,685.51,68
,20130731,263.3,263.65,263.45,265.3,262.8,265.3,263.85,1.65,0.2,6,158.31,64
,20130801,265.3,263.85,263.1,263.1,263.1,263.1,263.1,-0.75,-0.75,2,52.62,64
,20130802,263.1,263.1,263.1,263.1,256.3,257.2,261.25,-5.9,-1.85,150,"3,919.49",64
,20130805,257.2,261.25,261.75,262.65,261.35,262.65,262,1.4,0.75,18,471.63,62
,20130806,262.65,262,260.95,261.1,257.25,257.65,260.15,-4.35,-1.85,22,572.39,64
,20130807,257.65,260.15,255.75,255.75,254.95,255.2,255.5,-4.95,-4.65,18,459.97,68
,20130808,255.2,255.5,257.05,258.85,256.55,258.85,257.8,3.35,2.3,44,"1,134.51",38
,20130809,258.85,257.8,263.05,263.05,263.05,263.05,263.05,5.25,5.25,2,52.61,38
,20130812,263.05,263.05,264.85,265.95,264.85,265.85,265.6,2.8,2.55,20,531.23,32
,20130813,265.85,265.6,267.1,268.25,266.75,266.75,267.35,1.15,1.75,8,213.88,30
,20130814,266.75,267.35,264.1,264.1,264.1,264.1,264.1,-3.25,-3.25,2,52.82,32
,20130815,264.1,264.1,264.45,267.4,264.45,267.4,265.5,3.3,1.4,6,159.31,34
,20130816,267.4,265.5,,,,269.75,269.75,4.25,4.25,0,0,34
,20130819,269.75,269.75,275.6,276.2,275.6,275.6,275.75,5.85,6,8,220.6,32
,20130820,275.6,275.75,,,,271.45,271.45,-4.3,-4.3,0,0,32
,20130821,271.45,271.45,273.4,273.4,272.45,273.35,273.3,1.9,1.85,30,820,32
,20130822,273.35,273.3,272.6,272.6,271.55,272,272,-1.3,-1.3,16,435.23,20
,20130823,272,272,274.2,274.7,273.8,274.7,274.15,2.7,2.15,8,219.35,18
,20130826,274.7,274.15,,,,277.1,277.1,2.95,2.95,0,0,18
,20130827,277.1,277.1,278.25,278.25,278,278,278.05,0.9,0.95,28,778.55,28
,20130828,278,278.05,282.6,282.7,281.55,282.1,282,4.05,3.95,52,"1,466.46",42
,20130829,282.1,282,282.2,282.3,280.35,280.35,281.7,-1.65,-0.3,12,338.05,36
,20130830,280.35,281.7,280.35,281.2,280.35,281.2,280.75,-0.5,-0.95,4,112.31,36
,20130902,281.2,280.75,277.6,277.6,277.6,277.6,277.6,-3.15,-3.15,20,555.2,36
,20130903,277.6,277.6,277.7,277.7,277.1,277.1,277.4,-0.5,-0.2,8,221.92,36
,20130904,277.1,277.4,281.8,281.8,279.35,279.5,280,2.1,2.6,10,280.03,36
,20130905,279.5,280,277,277,275,275.15,275.65,-4.85,-4.35,10,275.66,30
,20130906,275.15,275.65,273,273,272.8,272.8,272.9,-2.85,-2.75,6,163.74,24
,20130909,272.8,272.9,276.5,276.5,275.8,276.2,276.15,3.3,3.25,6,165.7,22
,20130910,276.2,276.15,276.85,276.85,274,274.25,274.75,-1.9,-1.4,18,494.63,16
,20130911,274.25,274.75,271.5,272.25,271.25,271.65,271.7,-3.1,-3.05,16,434.78,12
,20130912,271.65,271.7,,,,271.7,271.7,0,0,0,0,12
,20130913,271.7,271.7,266.45,266.45,260.9,261,262.9,-10.7,-8.8,22,578.39,20
,20130916,261,262.9,263.1,264,261.3,264,262.9,1.1,0,20,525.85,20
,20130917,264,262.9,263.6,263.6,260.15,261.2,261.35,-1.7,-1.55,22,574.97,6
,20130918,261.2,261.35,,,,261.35,261.35,0,0,0,0,6
,20130923,261.35,261.35,261.55,262.2,261.55,262.2,261.85,0.85,0.5,4,104.75,6
,20130924,262.2,261.85,,,,262.6,262.6,0.75,0.75,0,0,6
,20130925,262.6,262.6,261.2,261.35,261.2,261.35,261.25,-1.25,-1.35,6,156.75,6
,20130926,261.35,261.25,263.8,263.8,263.8,263.8,263.8,2.55,2.55,2,52.76,6
,20130927,263.8,263.8,263.8,265.6,258.4,258.4,262.7,-5.4,-1.1,12,315.26,6
,20130930,258.4,262.7,259.5,263.85,259.5,263.05,262.1,0.35,-0.6,16,419.42,6
,20131008,263.05,262.1,256.7,256.7,256.7,256.7,256.7,-5.4,-5.4,6,154.02,6
,20131009,256.7,256.7,258.5,258.5,258.5,258.5,258.5,1.8,1.8,6,155.1,0
,20131010,258.5,258.5,,,,258.5,258.5,0,0,0,0,0
,20131011,258.5,258.5,,,,258.5,258.5,0,0,0,0,0
,20131014,258.5,258.5,,,,258.5,258.5,0,0,0,0,0
,20131015,258.5,258.5,,,,258.5,258.5,0,0,0,0,0
au1311,20130104,343.62,343.62,338.19,339.54,338.19,339.54,338.64,-4.08,-4.98,6,203.18,6
,20130107,339.54,338.64,342.58,342.58,342.58,342.58,342.58,3.94,3.94,2,68.52,6
,20130108,342.58,342.58,341.04,341.04,340,340,340.34,-2.58,-2.24,6,204.21,8
,20130109,340,340.34,341.37,341.99,341.37,341.99,341.68,1.65,1.34,4,136.67,8
,20130110,341.99,341.68,,,,340.28,340.28,-1.4,-1.4,0,0,8
,20130111,340.28,340.28,344.51,344.51,344.51,344.51,344.51,4.23,4.23,2,68.9,10
,20130114,344.51,344.51,342.91,342.91,342.9,342.9,342.9,-1.61,-1.61,4,137.16,14
,20130115,342.9,342.9,,,,343.76,343.76,0.86,0.86,0,0,14
,20130116,343.76,343.76,,,,346.41,346.41,2.65,2.65,0,0,14
,20130117,346.41,346.41,,,,345.27,345.27,-1.14,-1.14,0,0,14
,20130118,345.27,345.27,346.61,346.61,346.13,346.13,346.45,0.86,1.18,6,207.87,18
,20130121,346.13,346.45,346.44,346.44,346.44,346.44,346.44,-0.01,-0.01,2,69.29,16
,20130122,346.44,346.44,,,,346.54,346.54,0.1,0.1,0,0,16
,20130123,346.54,346.54,,,,347.77,347.77,1.23,1.23,0,0,16
,20130124,347.77,347.77,,,,344.99,344.99,-2.78,-2.78,0,0,16
,20130125,344.99,344.99,,,,343.24,343.24,-1.75,-1.75,0,0,16
,20130128,343.24,343.24,,,,341.93,341.93,-1.31,-1.31,0,0,16
,20130129,341.93,341.93,340.74,340.74,340.74,340.74,340.74,-1.19,-1.19,2,68.15,14
,20130130,340.74,340.74,,,,341.99,341.99,1.25,1.25,0,0,14
,20130131,341.99,341.99,,,,344.14,344.14,2.15,2.15,0,0,14
,20130201,344.14,344.14,,,,341.36,341.36,-2.78,-2.78,0,0,14
,20130204,341.36,341.36,,,,342.04,342.04,0.68,0.68,0,0,14
,20130205,342.04,342.04,,,,343.4,343.4,1.36,1.36,0,0,14
,20130206,343.4,343.4,342.25,342.25,342.01,342.01,342.09,-1.39,-1.31,6,205.26,18
,20130207,342.01,342.09,,,,343.44,343.44,1.35,1.35,0,0,18
,20130208,343.44,343.44,,,,341.63,341.63,-1.81,-1.81,0,0,18
,20130218,341.63,341.63,,,,331.47,331.47,-10.16,-10.16,0,0,18
,20130219,331.47,331.47,,,,331.87,331.87,0.4,0.4,0,0,18
,20130220,331.87,331.87,330.67,330.67,330.67,330.67,330.67,-1.2,-1.2,8,264.54,22
,20130221,330.67,330.67,,,,328.66,328.66,-2.01,-2.01,0,0,22
,20130222,328.66,328.66,,,,333.15,333.15,4.49,4.49,0,0,22
,20130225,333.15,333.15,,,,332,332,-1.15,-1.15,0,0,22
,20130226,332,332,328.54,328.54,326.2,326.3,327.24,-5.7,-4.76,26,850.82,22
,20130227,326.3,327.24,,,,329.69,329.69,2.45,2.45,0,0,22
,20130228,329.69,329.69,,,,327.91,327.91,-1.78,-1.78,0,0,22
,20130301,327.91,327.91,,,,324.87,324.87,-3.04,-3.04,0,0,22
,20130304,324.87,324.87,,,,324.18,324.18,-0.69,-0.69,0,0,22
,20130305,324.18,324.18,,,,324.58,324.58,0.4,0.4,0,0,22
,20130306,324.58,324.58,,,,323.88,323.88,-0.7,-0.7,0,0,22
,20130307,323.88,323.88,,,,323.88,323.88,0,0,0,0,22
,20130308,323.88,323.88,323.44,323.44,323.44,323.44,323.44,-0.44,-0.44,2,64.69,22
,20130311,323.44,323.44,,,,323.44,323.44,0,0,0,0,22
,20130312,323.44,323.44,,,,323.21,323.21,-0.23,-0.23,0,0,22
,20130313,323.21,323.21,325.42,325.42,325.42,325.42,325.42,2.21,2.21,2,65.08,24
,20130314,325.42,325.42,,,,323.99,323.99,-1.43,-1.43,0,0,24
,20130315,323.99,323.99,,,,325.05,325.05,1.06,1.06,0,0,24
,20130318,325.05,325.05,,,,324.91,324.91,-0.14,-0.14,0,0,24
,20130319,324.91,324.91,,,,326.19,326.19,1.28,1.28,0,0,24
,20130320,326.19,326.19,,,,326.2,326.2,0.01,0.01,0,0,24
,20130321,326.2,326.2,,,,325.36,325.36,-0.84,-0.84,0,0,24
,20130322,325.36,325.36,,,,326.1,326.1,0.74,0.74,0,0,24
,20130325,326.1,326.1,,,,325.47,325.47,-0.63,-0.63,0,0,24
,20130326,325.47,325.47,326.81,326.81,325.69,325.69,326.29,0.22,0.82,8,261.04,24
,20130327,325.69,326.29,325.29,325.29,325.29,325.29,325.29,-1,-1,2,65.06,24
,20130328,325.29,325.29,326.74,326.74,326.74,326.74,326.74,1.45,1.45,2,65.35,22
,20130329,326.74,326.74,324,324,324,324,324,-2.74,-2.74,2,64.8,22
,20130401,324,324,325.03,325.38,324.87,324.87,325.07,0.87,1.07,8,260.06,18
,20130402,324.87,325.07,325.06,325.06,325.06,325.06,325.06,-0.01,-0.01,2,65.01,20
,20130403,325.06,325.06,,,,318.26,318.26,-6.8,-6.8,0,0,20
,20130408,318.26,318.26,,,,319.52,319.52,1.26,1.26,0,0,20
,20130409,319.52,319.52,,,,319.83,319.83,0.31,0.31,0,0,20
,20130410,319.83,319.83,,,,319.83,319.83,0,0,0,0,20
,20130411,319.83,319.83,,,,319.83,319.83,0,0,0,0,20
,20130412,319.83,319.83,316.8,316.8,316.76,316.76,316.78,-3.07,-3.05,4,126.71,18
,20130415,316.76,316.78,,,,300.94,300.94,-15.84,-15.84,0,0,18
,20130416,300.94,300.94,,,,285.89,285.89,-15.05,-15.05,0,0,18
,20130417,285.89,285.89,275.29,277.17,275.17,277.17,276.14,-8.72,-9.75,22,607.51,24
,20130418,277.17,276.14,273.02,277.5,267.6,277.5,272.24,1.36,-3.9,12,326.69,28
,20130419,277.5,272.24,279.03,284.09,277.67,283.8,280.43,11.56,8.19,76,"2,131.28",50
,20130422,283.8,280.43,285.07,285.67,283.37,283.37,284.68,2.94,4.25,18,512.44,54
,20130423,283.37,284.68,286.06,286.06,286.06,286.06,286.06,1.38,1.38,4,114.42,50
,20130424,286.06,286.06,,,,288.1,288.1,2.04,2.04,0,0,50
,20130425,288.1,288.1,289.12,289.5,288.93,288.93,289.42,0.83,1.32,24,694.61,54
,20130426,288.93,289.42,297.68,298.74,295,295,297.35,5.58,7.93,12,356.83,58
,20130502,295,297.35,290.38,291.2,290.38,290.4,290.77,-6.95,-6.58,20,581.56,70
,20130503,290.4,290.77,,,,290.77,290.77,0,0,0,0,70
,20130506,290.77,290.77,294.02,294.02,293.56,293.56,293.71,2.79,2.94,6,176.23,70
,20130507,293.56,293.71,,,,289.55,289.55,-4.16,-4.16,0,0,70
,20130508,289.55,289.55,287.92,289.35,287.92,289.35,288.45,-0.2,-1.1,18,519.21,76
,20130509,289.35,288.45,292.96,293.69,292.96,293.01,293.33,4.56,4.88,8,234.67,76
,20130510,293.01,293.33,289.53,291.86,289.52,291.11,290.74,-2.22,-2.59,58,"1,686.31",102
,20130513,291.11,290.74,,,,287.22,287.22,-3.52,-3.52,0,0,102
,20130514,287.22,287.22,287.17,287.4,287.17,287.4,287.2,0.18,-0.02,12,344.65,92
,20130515,287.4,287.2,,,,282.21,282.21,-4.99,-4.99,0,0,92
,20130516,282.21,282.21,,,,277.42,277.42,-4.79,-4.79,0,0,92
,20130517,277.42,277.42,278.22,278.87,277.5,277.5,278.02,0.08,0.6,8,222.42,92
,20130520,277.5,278.02,270,270,270,270,270,-8.02,-8.02,2,54,92
,20130521,270,270,,,,278.9,278.9,8.9,8.9,0,0,92
,20130522,278.9,278.9,277.78,277.78,277.04,277.04,277.41,-1.86,-1.49,4,110.96,92
,20130523,277.04,277.41,,,,277.82,277.82,0.41,0.41,0,0,92
,20130524,277.82,277.82,,,,280.42,280.42,2.6,2.6,0,0,92
,20130527,280.42,280.42,,,,280.42,280.42,0,0,0,0,92
,20130528,280.42,280.42,,,,280.7,280.7,0.28,0.28,0,0,92
,20130529,280.7,280.7,,,,280.18,280.18,-0.52,-0.52,0,0,92
,20130530,280.18,280.18,279.16,281.42,279.16,281.42,280.13,1.24,-0.05,22,616.29,94
,20130531,281.42,280.13,284.98,284.98,283.83,284.5,284.36,4.37,4.23,50,"1,421.84",90
,20130603,284.5,284.36,,,,280,280,-4.36,-4.36,0,0,90
,20130604,280,280,,,,281.69,281.69,1.69,1.69,0,0,90
,20130605,281.69,281.69,,,,279.73,279.73,-1.96,-1.96,0,0,90
,20130606,279.73,279.73,,,,280.12,280.12,0.39,0.39,0,0,90
,20130607,280.12,280.12,283,283,283,283,283,2.88,2.88,10,283,80
,20130613,283,283,278.39,278.92,278.39,278.92,278.74,-4.08,-4.26,6,167.25,76
,20130614,278.92,278.74,,,,278.26,278.26,-0.48,-0.48,0,0,76
,20130617,278.26,278.26,278.3,278.32,278.3,278.32,278.3,0.06,0.04,6,166.98,78
,20130618,278.32,278.3,278.33,278.34,276.26,276.26,277.64,-2.04,-0.66,6,166.59,74
,20130619,276.26,277.64,,,,275.11,275.11,-2.53,-2.53,0,0,74
,20130620,275.11,275.11,,,,269.69,269.69,-5.42,-5.42,0,0,74
,20130621,269.69,269.69,256.2,260.97,256.2,260.97,259.23,-8.72,-10.46,22,570.31,80
,20130624,260.97,259.23,259.49,259.49,257.29,257.4,258.06,-1.83,-1.17,6,154.84,78
,20130625,257.4,258.05,257.85,260.4,257.85,259,258.75,0.95,0.7,16,414.01,74
,20130626,259,258.75,251.45,252.9,251.45,252.9,252.15,-5.85,-6.6,20,504.35,76
,20130627,252.9,252.15,249.45,250.9,249.15,250.25,249.75,-1.9,-2.4,38,949.12,66
,20130628,250.25,249.75,241.5,245.85,241.3,244.6,242.85,-5.15,-6.9,32,777.16,60
,20130701,244.6,242.85,249,250.55,249,250.55,249.7,7.7,6.85,8,199.76,54
,20130702,250.55,249.7,250.55,255,250.55,254.1,253.6,4.4,3.9,8,202.91,50
,20130703,254.1,253.6,251.9,253,251.9,252.3,252.3,-1.3,-1.3,20,504.66,52
,20130704,252.3,252.3,253,254.2,253,254.05,253.8,1.75,1.5,16,406.12,50
,20130705,254.05,253.8,253.8,253.8,251.25,251.25,251.9,-2.55,-1.9,12,302.29,54
,20130708,251.25,251.9,245.3,246.6,245.3,245.75,245.8,-6.15,-6.1,14,344.16,52
,20130709,245.75,245.8,248.45,253.65,248.45,253.65,250.6,7.85,4.8,16,400.97,50
,20130710,253.65,250.6,252.2,252.2,250.3,250.9,251.15,0.3,0.55,28,703.35,44
,20130711,250.9,251.15,253.6,262.2,252.5,260,258.25,8.85,7.1,136,"3,512.79",66
,20130712,260,258.25,258.25,258.95,256.45,257.85,258.25,-0.4,0,54,"1,394.75",60
,20130715,257.85,258.25,255.8,260.15,255.8,259.8,257.05,1.55,-1.2,132,"3,393.57",56
,20130716,259.8,257.05,258.25,258.25,257.9,257.9,258.05,0.85,1,4,103.23,54
,20130717,257.9,258.05,259.8,259.8,258.65,258.8,259.5,0.75,1.45,28,726.71,70
,20130718,258.8,259.5,259.85,260.9,254.55,255.8,259.15,-3.7,-0.35,84,"2,176.87",62
,20130719,255.8,259.15,258,258,256.75,257.55,257.45,-1.6,-1.7,24,617.92,62
,20130722,257.55,257.45,260.7,264.5,260.7,264.5,262.9,7.05,5.45,14,368.08,60
,20130723,264.5,262.9,264.55,266.7,264.25,265.45,266.05,2.55,3.15,86,"2,288.43",52
,20130724,265.45,266.05,266.1,267.2,265.05,267.2,266.25,1.15,0.2,40,"1,065.03",48
,20130725,267.2,266.25,263.75,263.75,263.25,263.25,263.55,-3,-2.7,12,316.26,44
,20130726,263.25,263.55,264.5,265.9,263.5,265.5,264.7,1.95,1.15,34,900.08,44
,20130729,265.5,264.7,262.75,263.5,262.05,262.05,263,-2.65,-1.7,24,631.22,56
,20130730,262.05,263,263.25,265.4,263.15,263.65,264.1,0.65,1.1,54,"1,426.33",44
,20130731,263.65,264.1,264.3,265.9,262.2,265.05,263.35,0.95,-0.75,68,"1,790.87",38
,20130801,265.05,263.35,262.85,265,261.2,263.5,263.4,0.15,0.05,48,"1,264.38",36
,20130802,263.5,263.4,263.9,263.9,256.15,257.3,261.55,-6.1,-1.85,188,"4,917.28",64
,20130805,257.3,261.55,262.55,263.8,261.9,262.9,263.3,1.35,1.75,142,"3,739.24",54
,20130806,262.9,263.3,260.95,261.8,258,258.35,260.3,-4.95,-3,20,520.67,52
,20130807,258.35,260.3,261.8,261.8,255.25,255.9,256.2,-4.4,-4.1,40,"1,024.81",46
,20130808,255.9,256.2,256.75,258.7,256.75,258.7,257.9,2.5,1.7,22,567.45,40
,20130809,258.7,257.9,258.9,262.65,258.9,261.1,259.5,3.2,1.6,230,"5,969.57",46
,20130812,261.1,259.5,261.1,265.9,261.1,265.9,264.55,6.4,5.05,12,317.46,40
,20130813,265.9,264.55,268.6,268.6,266.1,266.75,267.35,2.2,2.8,30,802.17,32
,20130814,266.75,267.35,267.3,267.3,263.3,264,264.5,-3.35,-2.85,34,899.38,36
,20130815,264,264.5,264.4,269.1,263.9,267.75,265.1,3.25,0.6,60,"1,590.81",38
,20130816,267.75,265.1,265.05,274.65,264.4,271.2,273.2,6.1,8.1,2432,"66,448.30",714
,20130819,271.2,273.2,272.6,275.85,272.15,273.5,274.65,0.3,1.45,114,"3,131.55",710
,20130820,273.5,274.65,272.2,273.4,271.6,272.2,272.3,-2.45,-2.35,24,653.62,704
,20130821,272.2,272.3,272.2,273.95,272.2,272.9,272.8,0.6,0.5,26,709.33,694
,20130822,272.9,272.8,272.35,272.35,270.5,271.6,271.45,-1.2,-1.35,104,"2,823.42",654
,20130823,271.6,271.45,273.1,273.75,273.05,273.25,273.35,1.8,1.9,18,492.11,650
,20130826,273.25,273.35,274.6,278.7,274.6,278.6,277.7,5.25,4.35,504,"13,996.11",762
,20130827,278.6,277.7,277.95,278.3,277.6,277.6,278.05,-0.1,0.35,116,"3,225.87",656
,20130828,277.6,278.05,282.2,284.55,281.5,283.9,283.45,5.85,5.4,46,"1,304.02",652
,20130829,283.9,283.45,283.7,283.7,279.7,281.1,282,-2.35,-1.45,46,"1,297.34",638
,20130830,281.1,282,280.1,280.1,279.8,279.8,279.85,-2.2,-2.15,10,279.86,634
,20130902,279.8,279.85,278.5,278.5,277.2,278.15,277.7,-1.7,-2.15,18,499.92,630
,20130903,278.15,277.7,277.55,277.9,277.1,277.1,277.4,-0.6,-0.3,32,887.69,614
,20130904,277.1,277.4,282.55,282.55,278.6,280.85,280.15,3.45,2.75,28,784.47,598
,20130905,280.85,280.15,277.15,277.15,274.85,275.8,276.05,-4.35,-4.1,32,883.46,592
,20130906,275.8,276.05,276.15,276.15,272.25,272.25,273.5,-3.8,-2.55,20,547.04,584
,20130909,272.25,273.5,276.35,276.7,275.85,276.55,276.3,3.05,2.8,26,718.4,578
,20130910,276.55,276.3,277.1,277.1,273.85,273.85,276.3,-2.45,0,74,"2,044.83",566
,20130911,273.85,276.3,272.1,272.2,272.1,272.2,272.1,-4.1,-4.2,6,163.28,566
,20130912,272.2,272.1,271.2,271.2,270.5,270.5,270.7,-1.6,-1.4,12,324.88,556
,20130913,270.5,270.7,264.6,264.6,264.6,264.6,264.6,-6.1,-6.1,2,52.92,556
,20130916,264.6,264.6,261.5,265.45,261.5,263.65,264.2,-0.95,-0.4,32,845.54,550
,20130917,263.65,264.2,263.7,263.7,260.05,261.7,261.15,-2.5,-3.05,120,"3,134.37",540
,20130918,261.7,261.15,260,260,257.75,258.9,258.75,-2.25,-2.4,14,362.26,532
,20130923,258.9,258.75,262.55,263,262.55,263,262.9,4.25,4.15,12,315.51,522
,20130924,263,262.9,263.6,264.4,263.55,264.25,263.85,1.35,0.95,48,"1,266.71",520
,20130925,264.25,263.85,260.9,263.9,260.9,263.9,261.4,0.05,-2.45,12,313.68,508
,20130926,263.9,261.4,263.3,266.8,263.3,265.3,265,3.9,3.6,24,636.08,512
,20130927,265.3,265,265,265.25,263.95,264.05,264.55,-0.95,-0.45,44,"1,164.19",484
,20130930,264.05,264.55,266,266.75,265.8,266.7,266.35,2.15,1.8,72,"1,917.85",458
,20131008,266.7,266.35,264.3,264.3,264.3,264.3,264.3,-2.05,-2.05,2,52.86,456
,20131009,264.3,264.3,263.75,265,263,263.15,263.65,-1.15,-0.65,130,"3,428.07",382
,20131010,263.15,263.65,260.7,260.7,260.7,260.7,260.7,-2.95,-2.95,6,156.42,382
,20131011,260.7,260.7,,,,260.7,260.7,0,0,0,0,382
,20131014,260.7,260.7,253.9,254.4,253,254.4,253.6,-6.3,-7.1,32,811.59,386
,20131015,254.4,253.6,256.5,256.5,254.1,254.6,254.65,1,1.05,42,"1,069.73",360
,20131016,254.6,254.65,255.65,255.8,255.45,255.5,255.6,0.85,0.95,28,715.74,346
,20131017,255.5,255.6,254.1,256.75,254,254,255.7,-1.6,0.1,44,"1,125.18",334
,20131018,254,255.7,260.1,263.35,260.1,263.2,261.8,7.5,6.1,156,"4,084.51",276
,20131021,263.2,261.8,261.65,262.5,261.45,261.85,261.9,0.05,0.1,118,"3,090.51",264
,20131022,261.85,261.9,,,,261.9,261.9,0,0,0,0,264
,20131023,261.9,261.9,261.9,264.8,260.85,263.8,262.8,1.9,0.9,38,998.71,262
,20131024,263.8,262.8,263.2,265,263.2,264.3,263.85,1.5,1.05,32,844.42,258
,20131025,264.3,263.85,263.9,264.15,263.85,264.15,263.85,0.3,0,30,791.64,232
,20131028,264.15,263.85,262.8,265.35,262.8,264.95,264.35,1.1,0.5,6,158.62,230
,20131029,264.95,264.35,264.5,266.25,264,265.85,265.55,1.5,1.2,20,531.19,232
,20131030,265.85,265.55,262.1,265.35,259.5,263.25,263.3,-2.3,-2.25,36,947.92,212
,20131031,263.25,263.3,266,268.65,261.95,262.8,264.95,-0.5,1.65,64,"1,695.88",204
,20131101,262.8,264.95,262,262,261.75,261.75,261.85,-3.2,-3.1,24,628.5,204
,20131104,261.75,261.85,,,,260.8,260.8,-1.05,-1.05,0,0,204
,20131105,260.8,260.8,,,,260.8,260.8,0,0,0,0,204
,20131106,260.8,260.8,,,,260.8,260.8,0,0,0,0,204
,20131107,260.8,260.8,259.15,259.2,259.15,259.15,259.15,-1.65,-1.65,24,621.99,186
,20131108,259.15,259.15,257.5,257.5,257.5,257.5,257.5,-1.65,-1.65,18,463.5,168
,20131111,257.5,257.5,253.75,253.75,253.75,253.75,253.75,-3.75,-3.75,6,152.25,162
,20131112,253.75,253.75,252.75,252.75,251,251,251.55,-2.75,-2.2,312,"7,849.35",12
,20131113,251,251.55,,,,251.55,251.55,0,0,0,0,12
,20131114,251.55,251.55,,,,251.55,251.55,0,0,0,0,12
,20131115,251.55,251.55,,,,251.55,251.55,0,0,0,0,12
au1312,20130104,342.91,341.64,339.7,340.44,338.4,340.44,339.3,-1.2,-2.34,100,"3,393.03",340
,20130107,340.44,339.3,341.73,343,341.73,342.37,342.54,3.07,3.24,52,"1,781.22",338
,20130108,342.37,342.54,340.99,340.99,339.61,339.8,340.11,-2.74,-2.43,100,"3,401.13",352
,20130109,339.8,340.11,341.99,342.57,341.43,342.57,341.95,2.46,1.84,60,"2,051.73",366
,20130110,342.57,341.95,342.99,342.99,340.51,342,341.24,0.05,-0.71,66,"2,252.20",398
,20130111,342,341.24,344.7,344.7,342.51,344.35,344.25,3.11,3.01,222,"7,642.52",542
,20130114,344.35,344.25,342.16,344.02,342.09,343.25,342.64,-1,-1.61,130,"4,454.32",606
,20130115,343.25,342.64,342.59,344.48,342.5,343.27,342.96,0.63,0.32,390,"13,375.80",844
,20130116,343.27,342.96,345.53,345.53,344.63,345.22,345.08,2.26,2.12,346,"11,939.82",1028
,20130117,345.22,345.08,345,345,343.77,343.95,344.1,-1.13,-0.98,176,"6,056.25",1162
,20130118,343.95,344.1,345.4,345.98,344.96,345.68,345.61,1.58,1.51,496,"17,142.46",1496
,20130121,345.68,345.61,344.39,346.53,344.39,346.53,346.01,0.92,0.4,462,"15,985.87",1732
,20130122,346.53,346.01,345.95,347.55,345.9,347.2,346.38,1.19,0.37,242,"8,382.55",1830
,20130123,347.2,346.38,346.64,346.73,346.21,346.37,346.5,-0.01,0.12,100,"3,465.05",1882
,20130124,346.37,346.5,346.37,346.37,343.21,343.54,344.03,-2.96,-2.47,116,"3,990.75",1876
,20130125,343.54,344.03,340.84,341.98,340.84,341.98,341.51,-2.05,-2.52,178,"6,078.93",1976
,20130128,341.98,341.51,341.59,341.59,339.68,340.2,340.08,-1.31,-1.43,78,"2,652.64",1986
,20130129,340.2,340.08,340.05,340.86,339.85,340.8,340.29,0.72,0.21,104,"3,539.09",1976
,20130130,340.8,340.29,341.1,341.49,340.93,341.25,341.27,0.96,0.98,190,"6,484.29",2044
,20130131,341.25,341.27,343.52,343.52,342.92,342.92,343.21,1.65,1.94,220,"7,550.75",2172
,20130201,342.92,343.21,340.01,340.39,339.56,340.2,340.06,-3.01,-3.15,210,"7,141.29",2282
,20130204,340.2,340.06,341.52,342.38,340.71,341.7,341.73,1.64,1.67,578,"19,752.09",2616
,20130205,341.7,341.73,342.28,343.17,342.28,343.08,342.69,1.35,0.96,370,"12,679.58",2896
,20130206,343.08,342.69,342.38,342.38,341.78,342.28,342.01,-0.41,-0.68,286,"9,781.70",3016
,20130207,342.28,342.01,342.28,343.8,342.28,343.2,343.31,1.19,1.3,1268,"43,531.71",4146
,20130208,343.2,343.31,341.37,342.59,341.11,342.59,341.75,-0.72,-1.56,690,"23,581.00",4658
,20130218,342.59,341.75,334.84,334.84,331.08,331.37,331.69,-10.38,-10.06,882,"29,255.12",5218
,20130219,331.37,331.69,331.6,332.09,331.08,331.15,331.37,-0.54,-0.32,578,"19,153.63",5568
,20130220,331.15,331.37,328.62,330.54,328.62,330.38,330.17,-0.99,-1.2,566,"18,687.93",5906
,20130221,330.38,330.17,323.78,323.78,319.99,322.36,321.54,-7.81,-8.63,1944,"62,508.67",7100
,20130222,322.36,321.54,323.58,326.11,323.58,325.6,325.04,4.06,3.5,1290,"41,931.06",7574
,20130225,325.6,325.04,324.1,325.79,315.05,325.06,324.6,0.02,-0.44,1610,"52,261.40",8296
,20130226,325.06,324.6,326.86,327.33,325.33,326.15,326.44,1.55,1.84,1836,"59,936.02",8988
,20130227,326.15,326.44,329.7,329.85,328.8,329.27,329.28,2.83,2.84,1654,"54,463.56",9556
,20130228,329.27,329.28,326.88,327.87,326.5,327.11,327,-2.17,-2.28,1336,"43,687.22",9916
,20130301,327.11,327,324.64,324.88,323.35,323.5,323.98,-3.5,-3.02,1334,"43,219.31",10524
,20130304,323.5,323.98,324,324.9,323,323.36,323.76,-0.62,-0.22,1238,"40,082.70",10914
,20130305,323.36,323.76,323.36,324.33,323.09,324.33,323.79,0.57,0.03,966,"31,278.84",11256
,20130306,324.33,323.79,323.97,324.05,323,323.3,323.54,-0.49,-0.25,904,"29,248.07",11544
,20130307,323.3,323.54,324.5,324.5,323.56,324,323.92,0.46,0.38,852,"27,598.81",11800
,20130308,324,323.92,323.33,323.54,321.81,322.4,322.48,-1.52,-1.44,1782,"57,466.32",12268
,20130311,322.4,322.48,322.98,323.84,322.55,323.64,323.43,1.16,0.95,1652,"53,431.11",12978
,20130312,323.64,323.43,323.64,323.71,323,323,323.33,-0.43,-0.1,1488,"48,111.70",13704
,20130313,323,323.33,325.01,325.94,324.16,325.25,324.96,1.92,1.63,1466,"47,640.20",14028
,20130314,325.25,324.96,323.11,324.35,323.07,323.9,323.88,-1.06,-1.08,2120,"68,663.15",15256
,20130315,323.9,323.88,323.99,325.23,323.99,325.13,324.65,1.25,0.77,1528,"49,607.96",15760
,20130318,325.13,324.65,326.68,326.87,324,324.92,325.09,0.27,0.44,2978,"96,812.15",16732
,20130319,324.92,325.09,325.91,326.75,325.09,326.64,326.05,1.55,0.96,1580,"51,516.27",17196
,20130320,326.64,326.05,327.14,328.23,326.96,327.94,327.75,1.89,1.7,2552,"83,643.70",18802
,20130321,327.94,327.75,326.13,327.5,326.06,327.12,326.87,-0.63,-0.88,2026,"66,225.00",19788
,20130322,327.12,326.87,328.11,328.12,327.41,327.52,327.79,0.65,0.92,2542,"83,325.59",21410
,20130325,327.52,327.79,326.28,327.94,326.26,327.01,327.34,-0.78,-0.45,2342,"76,663.29",22482
,20130326,327.01,327.34,326.47,326.5,325.65,325.9,325.99,-1.44,-1.35,3364,"109,665.08",24504
,20130327,325.9,325.99,325.78,325.99,323.93,323.95,324.87,-2.04,-1.12,2518,"81,803.08",25518
,20130328,323.95,324.87,325.88,326.79,325.88,326.6,326.47,1.73,1.6,2992,"97,681.35",25920
,20130329,326.6,326.47,323.56,324.9,323.37,324.66,324.02,-1.81,-2.45,2150,"69,664.98",26294
,20130401,324.66,324.02,325.15,325.45,324.03,324.19,324.88,0.17,0.86,2462,"79,986.09",27212
,20130402,324.19,324.88,326,326,324.86,325.3,325.45,0.42,0.57,3270,"106,422.79",28428
,20130403,325.3,325.45,320.49,320.49,316.9,317.85,318.21,-7.6,-7.24,8116,"258,267.22",31876
,20130408,317.85,318.21,320.3,321.3,320.01,321.17,320.52,2.96,2.31,6932,"222,186.64",32834
,20130409,321.17,320.52,319.96,320.79,319.6,320.69,320.37,0.17,-0.15,6718,"215,228.17",34892
,20130410,320.69,320.37,322.6,322.99,321.71,322,322.32,1.63,1.95,5840,"188,236.34",36164
,20130411,322,322.32,315.23,316.9,315.23,316.24,316.31,-6.08,-6.01,9942,"314,479.43",39966
,20130412,316.24,316.31,317,317.16,316.34,316.51,316.7,0.2,0.39,6792,"215,105.50",41590
,20130415,316.51,316.7,300.86,300.86,300.86,300.86,300.86,-15.84,-15.84,1598,"48,077.43",41516
,20130416,300.86,300.86,276.79,278.88,276.79,277.72,277.17,-23.14,-23.69,15138,"419,583.41",38912
,20130417,277.72,277.17,277.53,278.66,274.8,277.1,276.95,-0.07,-0.22,25788,"714,205.52",44860
,20130418,277.1,276.95,272,278.5,265.01,278.2,273.22,1.25,-3.73,47042,"1,285,290.47",53112
,20130419,278.2,273.22,278.2,286.88,278.2,284.31,282.65,11.09,9.43,55034,"1,555,569.71",61158
,20130422,284.31,282.65,284.46,287.15,284.46,285.6,285.94,2.95,3.29,58128,"1,662,121.90",71422
,20130423,285.6,285.94,286.77,287.19,281.43,283.31,284.49,-2.63,-1.45,90224,"2,566,805.31",82864
,20130424,283.31,284.49,284.5,287.9,284.3,286.49,285.7,2,1.21,73846,"2,109,830.56",77136
,20130425,286.49,285.7,287.96,292,287,290.35,289.49,4.65,3.79,56874,"1,646,486.36",77348
,20130426,290.35,289.49,297.54,299.77,295.78,296.15,297.48,6.66,7.99,82926,"2,466,921.32",77874
,20130502,296.15,297.48,292,292,289.74,290.9,290.64,-6.58,-6.84,65746,"1,910,846.98",88008
,20130503,290.9,290.64,293.21,295.59,293.14,295.41,294.58,4.77,3.94,61436,"1,809,800.80",87196
,20130506,295.41,294.58,295.41,296.5,294.15,294.15,295.13,-0.43,0.55,70272,"2,073,968.57",94328
,20130507,294.15,295.13,293.67,293.95,289.84,289.98,291.81,-5.15,-3.32,116040,"3,386,272.36",111526
,20130508,289.98,291.81,289,290.85,287.2,290.27,289.25,-1.54,-2.56,124912,"3,613,101.62",104658
,20130509,290.27,289.25,293.19,294.4,292.58,292.87,293.56,3.62,4.31,75494,"2,216,261.45",99068
,20130510,292.87,293.56,289.14,291.6,288.64,291.6,290.39,-1.96,-3.17,82266,"2,388,941.57",98180
,20130513,291.6,290.39,286.68,287.63,283.9,285.43,285.6,-4.96,-4.79,142078,"4,057,804.95",109834
,20130514,285.43,285.6,286.68,288.48,286,286.31,287.28,0.71,1.68,75890,"2,180,202.15",110086
,20130515,286.31,287.28,283.98,285.24,281.51,281.82,283.79,-5.46,-3.49,96854,"2,748,664.99",111232
,20130516,281.82,283.79,278.02,280,277.53,278.18,278.58,-5.61,-5.21,104736,"2,917,785.93",111370
,20130517,278.18,278.58,278.14,279.28,274.65,275.11,277.14,-3.47,-1.44,147690,"4,093,214.51",116412
,20130520,275.11,277.14,269.7,270.93,268.4,269.5,269.64,-7.64,-7.5,155846,"4,202,348.42",123308
,20130521,269.5,269.64,279.99,280.88,276.66,279.51,278.77,9.87,9.13,146816,"4,092,844.09",110018
,20130522,279.51,278.77,276.6,279.1,276.27,278.86,277.19,0.09,-1.58,89024,"2,467,666.46",109434
,20130523,278.86,277.19,273.52,276.62,272.4,276.23,274.47,-0.96,-2.72,127236,"3,492,364.75",110984
,20130524,276.23,274.47,279.02,279.88,277.91,278.36,278.81,3.89,4.34,94582,"2,637,105.98",108940
,20130527,278.36,278.81,277.04,279.55,277.04,279.32,278.7,0.51,-0.11,57426,"1,600,478.55",107220
,20130528,279.32,278.7,278.36,279.2,277.82,278.44,278.48,-0.26,-0.22,63016,"1,754,895.88",105162
,20130529,278.44,278.48,277.79,278.79,276.65,277.46,277.75,-1.02,-0.73,84464,"2,345,999.35",108914
,20130530,277.46,277.75,278.5,282.52,278.11,281.88,280.59,4.13,2.84,112980,"3,170,147.20",112018
,20130531,281.88,280.59,283.11,284.68,282.88,283.57,283.75,2.98,3.16,66136,"1,876,659.31",109442
,20130603,283.57,283.75,279.62,280.13,278.81,279.52,279.45,-4.23,-4.3,61714,"1,724,651.64",108908
,20130604,279.52,279.45,283.4,283.44,281.06,281.26,282.19,1.81,2.74,63018,"1,778,355.87",112554
,20130605,281.26,282.19,279.96,281.58,279.3,280.62,280.6,-1.57,-1.59,65502,"1,837,986.50",109626
,20130606,280.62,280.6,280.47,280.68,278.66,279.01,279.59,-1.59,-1.01,52378,"1,464,485.12",109286
,20130607,279.01,279.59,283.09,283.16,281.7,281.82,282.4,2.23,2.81,53088,"1,499,228.61",106366
,20130613,281.82,282.4,276.61,279.18,276.6,278.24,278.25,-4.16,-4.15,58694,"1,633,165.99",104994
,20130614,278.24,278.25,278,278.13,276.68,277.15,277.26,-1.1,-0.99,44294,"1,228,116.63",108076
,20130617,277.15,277.26,278.03,278.55,277.53,277.58,278.07,0.32,0.81,31652,"880,161.68",108396
,20130618,277.58,278.07,277.02,277.47,275.51,275.97,276.5,-2.1,-1.57,47930,"1,325,277.88",113888
,20130619,275.97,276.5,274.16,274.68,273.26,274.48,273.88,-2.02,-2.62,56836,"1,556,645.32",114234
,20130620,274.48,273.88,269.1,270.12,266.72,266.94,269.05,-6.94,-4.83,87300,"2,348,868.19",121268
,20130621,266.94,269.05,255.59,261.32,255.59,261.3,258.94,-7.75,-10.11,153406,"3,972,406.79",124974
,20130624,261.3,258.94,260.75,261.9,256.35,256.9,258.8,-2.04,-0.14,117220,"3,033,654.12",130486
,20130625,256.9,258.8,257.85,259.55,256.7,257.9,258,-0.9,-0.8,97416,"2,513,740.22",121454
,20130626,257.9,258,256.6,257,249.3,251.05,252.15,-6.95,-5.85,176738,"4,457,207.38",129166
,20130627,251.05,252.15,248.35,251.4,248.3,250.5,250,-1.65,-2.15,136470,"3,411,990.31",121770
,20130628,250.5,250,240.1,245.15,238.9,243.8,242.6,-6.2,-7.4,177536,"4,307,899.02",121334
,20130701,243.8,242.6,248.55,252.85,247.25,252.4,250.7,9.8,8.1,160940,"4,035,050.73",125312
,20130702,252.4,250.7,253.75,255.3,253.15,254.8,254.35,4.1,3.65,106224,"2,701,849.21",127000
,20130703,254.8,254.35,251.95,252.85,251.35,252.35,252.15,-2,-2.2,76396,"1,926,622.59",127038
,20130704,252.35,252.15,254,255.2,253.15,253.45,253.7,1.3,1.55,52880,"1,341,674.88",124860
,20130705,253.45,253.7,252.45,252.7,250.15,251.3,251.3,-2.4,-2.4,91826,"2,307,828.30",123082
,20130708,251.3,251.3,247.45,247.7,244.15,245.95,245.75,-5.35,-5.55,325148,"7,990,602.87",128916
,20130709,245.95,245.75,248.65,254.5,248,253.35,250.4,7.6,4.65,376336,"9,425,087.62",137366
,20130710,253.35,250.4,252.4,253.55,250.7,251.75,251.95,1.35,1.55,416328,"10,490,964.60",137538
,20130711,251.75,251.95,253,262.2,251.65,259.6,255.55,7.65,3.6,595642,"15,222,859.38",132624
,20130712,259.6,255.55,259.4,259.9,256.9,257.1,258.75,1.55,3.2,385378,"9,973,318.26",133318
,20130715,257.1,258.75,256.95,260.9,256.65,259.15,258.3,0.4,-0.45,418104,"10,800,744.09",136128
,20130716,259.15,258.3,258.6,259.4,257.4,258.45,258.75,0.15,0.45,280028,"7,246,431.24",131392
,20130717,258.45,258.75,260.1,261,259.05,259.35,260.15,0.6,1.4,312514,"8,130,644.28",130726
,20130718,259.35,260.15,260.35,261.5,255.1,256.6,258.3,-3.55,-1.85,533216,"13,773,899.41",141674
,20130719,256.6,258.3,258.15,259.75,257,258.55,258.1,0.25,-0.2,365774,"9,441,205.45",145082
,20130722,258.55,258.1,259,265.35,258.7,264.25,261.3,6.15,3.2,342482,"8,949,622.84",141496
,20130723,264.25,261.3,265,267.95,264.8,266.2,266.35,4.9,5.05,373296,"9,942,753.99",143768
,20130724,266.2,266.35,266.1,268.85,265.65,267.75,266.9,1.4,0.55,270080,"7,209,664.76",147660
,20130725,267.75,266.9,266.1,267.15,263.05,264.05,265.3,-2.85,-1.6,407820,"10,820,194.60",141380
,20130726,264.05,265.3,264.7,267.3,264.25,265.9,265.4,0.6,0.1,292150,"7,753,943.80",148990
,20130729,265.9,265.4,263.95,265.15,262,263.3,263.55,-2.1,-1.85,405422,"10,686,451.16",154216
,20130730,263.3,263.55,264.1,264.8,263.35,263.5,264.15,-0.05,0.6,219446,"5,796,935.02",157376
,20130731,263.5,264.15,263.85,266.85,262.6,265.9,264,1.75,-0.15,330774,"8,732,844.80",160864
,20130801,265.9,264,263.9,265.7,260.7,263.5,262.45,-0.5,-1.55,548972,"14,409,013.77",140806
,20130802,263.5,262.45,264.25,264.3,253.6,257.1,261.1,-5.35,-1.35,450170,"11,755,810.57",148400
,20130805,257.1,261.1,263,264,261.15,262.45,262,1.35,0.9,336498,"8,817,319.07",138948
,20130806,262.45,262,260.8,261.75,257.3,258.45,259.95,-3.55,-2.05,369748,"9,612,351.89",153190
,20130807,258.45,259.95,258,258,254.65,256.1,256.55,-3.85,-3.4,399322,"10,245,877.11",155932
,20130808,256.1,256.55,256.1,259.25,255.8,258.1,257.2,1.55,0.65,368892,"9,488,032.69",144032
,20130809,258.1,257.2,258.65,262.95,258.2,261.55,260.65,4.35,3.45,484956,"12,641,774.78",139264
,20130812,261.55,260.65,261.1,266.5,260.95,266.05,263.2,5.4,2.55,472514,"12,438,824.79",144636
,20130813,266.05,263.2,265.8,268.5,265.7,267.65,267.35,4.45,4.15,345448,"9,236,182.84",141398
,20130814,267.65,267.35,266.75,267.25,263.1,263.8,265,-3.55,-2.35,415492,"11,011,327.24",137578
,20130815,263.8,265,264.8,269.15,263.75,268.05,266.4,3.05,1.4,427342,"11,386,475.30",135062
,20130816,268.05,266.4,264.1,275.1,263.85,271.95,269.3,5.55,2.9,659102,"17,751,015.58",136030
,20130819,271.95,269.3,272.65,276.65,271,274.6,273.9,5.3,4.6,452264,"12,389,719.59",135974
,20130820,274.6,273.9,274.1,274.35,270,271.2,272.7,-2.7,-1.2,385060,"10,502,166.14",125864
,20130821,271.2,272.7,273.2,274.75,272.5,273.2,273.6,0.5,0.9,304550,"8,333,847.45",124654
,20130822,273.2,273.6,273,274.25,271.15,272.35,272.65,-1.25,-0.95,354840,"9,674,757.57",122544
,20130823,272.35,272.65,274.35,275.85,273,274.75,274.15,2.1,1.5,315836,"8,659,414.16",124494
,20130826,274.75,274.15,273.7,279.4,273.6,278.55,277.35,4.4,3.2,384020,"10,651,403.96",133060
,20130827,278.55,277.35,278.35,279.65,277.3,279.25,278.55,1.9,1.2,251828,"7,015,326.51",130974
,20130828,279.25,278.55,282.65,285.6,281.55,284.25,283.1,5.7,4.55,325808,"9,225,024.00",138800
,20130829,284.25,283.1,284.45,284.9,279.7,280.95,282.1,-2.15,-1,374840,"10,576,003.35",135208
,20130830,280.95,282.1,281.85,281.85,279.45,280.15,280.45,-1.95,-1.65,268242,"7,523,721.14",134746
,20130902,280.15,280.45,277.85,279.9,276.2,278.55,278.15,-1.9,-2.3,319910,"8,898,883.78",136622
,20130903,278.55,278.15,277.85,278.9,277.2,277.6,278.1,-0.55,-0.05,181690,"5,053,161.58",131732
,20130904,277.6,278.1,279.45,282.65,279.15,280.5,280.65,2.4,2.55,349940,"9,821,490.44",130680
,20130905,280.5,280.65,277.6,278.05,275,276.5,277,-4.15,-3.65,286456,"7,935,355.42",125012
,20130906,276.5,277,277.1,277.5,272.4,273.85,274.35,-3.15,-2.65,384252,"10,541,980.14",136724
,20130909,273.85,274.35,276.3,277.55,275.75,276.8,276.6,2.45,2.25,287488,"7,952,139.61",119502
,20130910,276.8,276.6,276.9,277.25,274.05,275.05,276.15,-1.55,-0.45,189900,"5,244,669.43",119008
,20130911,275.05,276.15,272.25,273.25,270.7,272.9,271.95,-3.25,-4.2,246846,"6,713,887.21",117198
,20130912,272.9,271.95,271.85,272.6,268.3,268.55,271.5,-3.4,-0.45,176102,"4,781,322.48",120678
,20130913,268.55,271.5,265.6,266.2,261.2,262.7,264.65,-8.8,-6.85,308492,"8,165,043.75",120912
,20130916,262.7,264.65,263.2,266.6,261.05,264.05,263.55,-0.6,-1.1,280158,"7,383,921.72",126164
,20130917,264.05,263.55,262,264.5,261.15,262.35,262.8,-1.2,-0.75,232768,"6,118,016.25",127714
,20130918,262.35,262.8,262.2,262.55,257.6,260.4,260.15,-2.4,-2.65,289294,"7,526,871.77",116440
,20130923,260.4,260.15,264.05,265.6,261.85,264.3,263.55,4.15,3.4,107966,"2,845,977.13",114050
,20130924,264.3,263.55,263.85,265.35,263,263.85,264.3,0.3,0.75,195178,"5,158,617.60",113206
,20130925,263.85,264.3,261,265.3,260.5,264.4,262.85,0.1,-1.45,205288,"5,396,185.16",113804
,20130926,264.4,262.85,263.7,266.95,263.45,265.35,265.4,2.5,2.55,207764,"5,514,295.06",111126
,20130927,265.35,265.4,266.15,266.45,263.35,264.2,264.6,-1.2,-0.8,162478,"4,299,631.03",102692
,20130930,264.2,264.6,266.5,267.75,266,267.4,266.9,2.8,2.3,120910,"3,227,525.16",96634
,20131008,267.4,266.9,266.4,266.4,264,264.9,264.65,-2,-2.25,52138,"1,380,072.27",98668
,20131009,264.9,264.65,263.9,265.65,263.05,263.45,264.35,-1.2,-0.3,178262,"4,712,696.88",103214
,20131010,263.45,264.35,261.2,262.8,259.4,260.7,260.75,-3.65,-3.6,212188,"5,533,225.03",103048
,20131011,260.7,260.75,259.6,260.5,257.45,257.85,259.2,-2.9,-1.55,225348,"5,841,360.17",111822
,20131014,257.85,259.2,253.95,255.4,253,255.2,253.95,-4,-5.25,267956,"6,804,916.38",109118
,20131015,255.2,253.95,256.7,257.25,253.3,254.25,255.5,0.3,1.55,203618,"5,202,864.62",112580
,20131016,254.25,255.5,252.5,257.3,252.25,257.25,254.7,1.75,-0.8,295954,"7,538,819.49",109580
,20131017,257.25,254.7,256.05,257.35,254,254.7,255.3,0,0.6,364506,"9,306,952.56",112254
,20131018,254.7,255.3,261.7,264.05,261.7,263.2,262.35,7.9,7.05,284092,"7,453,869.05",106194
,20131021,263.2,262.35,262.3,263.25,261.5,262.95,262.2,0.6,-0.15,178192,"4,673,055.26",104272
,20131022,262.95,262.2,262.25,262.85,261.45,262.05,262.2,-0.15,0,152296,"3,993,853.60",100148
,20131023,262.05,262.2,264.3,266.85,264.15,265.1,265.5,2.9,3.3,226200,"6,005,907.61",100534
,20131024,265.1,265.5,264.9,266,264.25,265.7,264.95,0.2,-0.55,154532,"4,094,354.18",101672
,20131025,265.7,264.95,265.7,266.6,264.4,264.6,265.6,-0.35,0.65,194084,"5,155,427.20",94536
,20131028,264.6,265.6,264.9,267,264.25,265.8,265.5,0.2,-0.1,192716,"5,116,955.24",87716
,20131029,265.8,265.5,266.2,267.5,265.55,266.25,266.4,0.75,0.9,216630,"5,771,717.51",85492
,20131030,266.25,266.4,265.15,265.95,263.5,265.3,265,-1.1,-1.4,208898,"5,536,831.77",80912
,20131031,265.3,265,266.55,267.75,262.35,263.25,265.4,-1.75,0.4,248604,"6,598,649.97",80314
,20131101,263.25,265.4,261.45,262.5,260.6,261.85,261.45,-3.55,-3.95,186812,"4,885,090.78",71148
,20131104,261.85,261.45,260,260.65,258.7,260.05,259.75,-1.4,-1.7,186686,"4,849,551.88",69976
,20131105,260.05,259.75,261.15,261.65,259.7,260.25,260.55,0.5,0.8,95418,"2,486,371.54",65220
,20131106,260.25,260.55,260.6,261,258.65,259.7,259.7,-0.85,-0.85,134732,"3,499,098.46",64144
,20131107,259.7,259.7,260.35,261.15,259.9,260.8,260.35,1.1,0.65,102206,"2,661,358.78",62458
,20131108,260.8,260.35,261.3,261.5,256.5,259.2,258.95,-1.15,-1.4,199276,"5,160,271.39",58822
,20131111,259.2,258.95,259.1,259.7,254.25,254.7,255.8,-4.25,-3.15,189744,"4,854,409.19",60570
,20131112,254.7,255.8,254.4,254.45,252.65,253.65,253.85,-2.15,-1.95,84264,"2,139,079.15",59696
,20131113,253.65,253.85,253.7,254.75,251.35,252.15,253,-1.7,-0.85,118566,"3,000,079.41",58318
,20131114,252.15,253,253.2,255.2,251.6,254.45,253.2,1.45,0.2,122202,"3,094,623.77",51540
,20131115,254.45,253.2,253.35,256.2,253.35,254.95,255,1.75,1.8,151866,"3,872,719.03",48372
,20131118,254.95,255,254.45,255.5,254.25,255.05,254.95,0.05,-0.05,83518,"2,129,427.48",46234
,20131119,255.05,254.95,254,254.55,251.8,252.6,253.2,-2.35,-1.75,101004,"2,557,422.70",46128
,20131120,252.6,253.2,253.15,253.45,252.55,253.25,252.95,0.05,-0.25,63244,"1,599,776.43",43792
,20131121,253.25,252.95,250.95,252.5,248.5,248.7,250.75,-4.25,-2.2,85392,"2,141,373.81",43566
,20131122,248.7,250.75,248.8,248.9,247.4,248.3,248.25,-2.45,-2.5,37800,"938,461.56",41592
,20131125,248.3,248.25,249.2,249.2,245.15,245.65,247.9,-2.6,-0.35,28234,"699,963.82",38642
,20131126,245.65,247.9,245.75,249.6,245,248.95,247.4,1.05,-0.5,44244,"1,094,813.15",31158
,20131127,248.95,247.4,247.8,248.25,247.05,247.15,247.65,-0.25,0.25,23392,"579,309.45",25846
,20131128,247.15,247.65,247.9,248.5,245.1,245.55,247.05,-2.1,-0.6,23264,"574,772.40",20556
,20131129,245.55,247.05,246.7,246.75,244.5,244.75,245.75,-2.3,-1.3,14604,"358,893.77",15360
,20131202,244.75,245.75,246.65,246.65,244.75,246.15,245.8,0.4,0.05,3528,"86,732.76",12714
,20131203,246.15,245.8,244.05,244.85,241.2,242.05,242.85,-3.75,-2.95,1704,"41,388.27",11664
,20131204,242.05,242.85,242.55,244.25,241.35,241.35,241.8,-1.5,-1.05,1632,"39,469.41",10674
,20131205,241.35,241.8,241.4,244.35,241.25,243.75,243.45,1.95,1.65,2958,"72,022.65",8316
,20131206,243.75,243.45,241.9,242.5,241.1,241.6,241.6,-1.85,-1.85,3438,"83,068.53",5418
,20131209,241.6,241.6,241.95,243.1,239.3,241.05,241.65,-0.55,0.05,2748,"66,416.70",2958
,20131210,241.05,241.65,242.35,243.75,240.35,243.75,242.5,2.1,0.85,1212,"29,395.80",2538
,20131211,243.75,242.5,244.6,247.45,244.6,245.45,245.5,2.95,3,732,"17,970.69",2178
,20131212,245.45,245.5,244,244,244,244,244,-1.5,-1.5,60,"1,464.00",2118
,20131213,244,244,241.3,241.3,239.6,239.8,239.85,-4.2,-4.15,78,"1,870.98",2118
,20131216,239.8,239.85,241,241,240.5,240.5,240.75,0.65,0.9,114,"2,744.70",2118
au1401,20130116,342.96,342.96,,,,344,344,1.04,1.04,0,0,0
,20130117,344,344,,,,343.02,343.02,-0.98,-0.98,0,0,0
,20130118,343.02,343.02,,,,343.02,343.02,0,0,0,0,0
,20130121,343.02,343.02,,,,343.02,343.02,0,0,0,0,0
,20130122,343.02,343.02,,,,343.02,343.02,0,0,0,0,0
,20130123,343.02,343.02,,,,343.02,343.02,0,0,0,0,0
,20130124,343.02,343.02,,,,340.57,340.57,-2.45,-2.45,0,0,0
,20130125,340.57,340.57,,,,340.57,340.57,0,0,0,0,0
,20130128,340.57,340.57,338.45,339.87,338.45,339.61,339.03,-0.96,-1.54,20,678.08,10
,20130129,339.61,339.03,,,,339.24,339.24,0.21,0.21,0,0,10
,20130130,339.24,339.24,340.68,340.69,340.68,340.69,340.68,1.45,1.44,6,204.41,8
,20130131,340.69,340.68,,,,342.62,342.62,1.94,1.94,0,0,8
,20130201,342.62,342.62,,,,339.47,339.47,-3.15,-3.15,0,0,8
,20130204,339.47,339.47,,,,341.13,341.13,1.66,1.66,0,0,8
,20130205,341.13,341.13,,,,342.08,342.08,0.95,0.95,0,0,8
,20130206,342.08,342.08,,,,341.4,341.4,-0.68,-0.68,0,0,8
,20130207,341.4,341.4,,,,342.69,342.69,1.29,1.29,0,0,8
,20130208,342.69,342.69,,,,341.13,341.13,-1.56,-1.56,0,0,8
,20130218,341.13,341.13,,,,331.08,331.08,-10.05,-10.05,0,0,8
,20130219,331.08,331.08,331.59,333.9,331.59,333.9,332.74,2.82,1.66,4,133.1,12
,20130220,333.9,332.74,330.01,330.01,330.01,330.01,330.01,-2.73,-2.73,2,66,10
,20130221,330.01,330.01,321.31,321.31,321.3,321.3,321.3,-8.71,-8.71,22,706.86,24
,20130222,321.3,321.3,325.41,327,325.41,327,326.2,5.7,4.9,4,130.48,26
,20130225,327,326.2,326.66,326.67,326.14,326.42,326.39,0.22,0.19,20,652.8,34
,20130226,326.42,326.39,327.9,327.9,327,327,327.7,0.61,1.31,10,327.71,34
,20130227,327,327.7,330.88,330.88,329.57,329.78,330.23,2.08,2.53,14,462.33,30
,20130228,329.78,330.23,,,,327.94,327.94,-2.29,-2.29,0,0,30
,20130301,327.94,327.94,324.52,324.91,324.5,324.91,324.75,-3.03,-3.19,10,324.75,26
,20130304,324.91,324.75,324.76,325.29,324.08,324.08,324.47,-0.67,-0.28,12,389.37,32
,20130305,324.08,324.47,324.69,324.92,324.12,324.92,324.51,0.45,0.04,12,389.42,32
,20130306,324.92,324.51,324.61,324.61,324.11,324.43,324.35,-0.08,-0.16,14,454.1,34
,20130307,324.43,324.35,324.49,324.75,324.49,324.73,324.65,0.38,0.3,8,259.72,34
,20130308,324.73,324.65,,,,323.62,323.62,-1.03,-1.03,0,0,34
,20130311,323.62,323.62,,,,324.12,324.12,0.5,0.5,0,0,34
,20130312,324.12,324.12,323.83,323.83,323.83,323.83,323.83,-0.29,-0.29,2,64.77,36
,20130313,323.83,323.83,326.49,326.49,325.57,326,325.96,2.17,2.13,14,456.35,32
,20130314,326,325.96,,,,325.96,325.96,0,0,0,0,32
,20130315,325.96,325.96,325.71,325.71,325.31,325.31,325.51,-0.65,-0.45,4,130.2,30
,20130318,325.31,325.51,324.75,325.93,324.75,325.54,325.4,0.03,-0.11,6,195.24,32
,20130319,325.54,325.4,,,,325.4,325.4,0,0,0,0,32
,20130320,325.4,325.4,,,,325.4,325.4,0,0,0,0,32
,20130321,325.4,325.4,,,,325.4,325.4,0,0,0,0,32
,20130322,325.4,325.4,328.13,328.5,328.13,328.5,328.31,3.1,2.91,4,131.33,32
,20130325,328.5,328.31,327.71,327.72,327.71,327.72,327.71,-0.59,-0.6,4,131.09,30
,20130326,327.72,327.71,,,,327.71,327.71,0,0,0,0,30
,20130327,327.71,327.71,325.89,325.89,325.06,325.06,325.47,-2.65,-2.24,4,130.19,30
,20130328,325.06,325.47,,,,327.07,327.07,1.6,1.6,0,0,30
,20130329,327.07,327.07,325.2,325.2,325.2,325.2,325.2,-1.87,-1.87,2,65.04,30
,20130401,325.2,325.2,311.11,326.34,311.11,322.72,323.39,-2.48,-1.81,16,517.44,32
,20130402,322.72,323.39,326.18,326.38,326.18,326.38,326.28,2.99,2.89,4,130.51,30
,20130403,326.38,326.28,319.4,319.4,318.29,318.29,318.56,-7.99,-7.72,8,254.85,32
,20130408,318.29,318.56,321.25,321.25,321.25,321.25,321.25,2.69,2.69,6,192.75,32
,20130409,321.25,321.25,,,,321.1,321.1,-0.15,-0.15,0,0,32
,20130410,321.1,321.1,322.98,322.98,322.95,322.98,322.96,1.88,1.86,12,387.56,38
,20130411,322.98,322.96,315.94,317.68,315.93,317.19,316.1,-5.77,-6.86,78,"2,465.65",92
,20130412,317.19,316.1,317.27,317.27,317.27,317.27,317.27,1.17,1.17,4,126.91,92
,20130415,317.27,317.27,301.53,302.99,301.4,301.4,301.6,-15.87,-15.67,70,"2,111.25",46
,20130416,301.4,301.6,277.47,280.84,277.47,279.37,278.46,-22.23,-23.14,182,"5,068.11",44
,20130417,279.37,278.46,279.37,279.61,275.42,277.18,278.22,-1.28,-0.24,42,"1,168.53",50
,20130418,277.18,278.22,274.03,278.5,270,278.5,274.23,0.28,-3.99,54,"1,480.86",50
,20130419,278.5,274.23,278.02,287.47,278.02,285,282.65,10.77,8.42,64,"1,808.99",42
,20130422,285,282.65,285.34,287.12,285.12,287,286.08,4.35,3.43,54,"1,544.85",50
,20130423,287,286.08,286.08,286.87,285.25,285.32,285.91,-0.76,-0.17,30,857.74,56
,20130424,285.32,285.91,285.98,287.68,284.81,286.35,285.77,0.44,-0.14,48,"1,371.72",52
,20130425,286.35,285.77,295.75,295.75,288.4,292.38,290.35,6.61,4.58,64,"1,858.29",32
,20130426,292.38,290.35,300.56,300.56,296.32,296.99,297.84,6.64,7.49,26,774.41,36
,20130502,296.99,297.84,291.34,291.48,290.35,291.48,290.76,-6.36,-7.08,20,581.53,36
,20130503,291.48,290.76,294.21,295.7,294.21,295.35,295.06,4.59,4.3,44,"1,298.30",34
,20130506,295.35,295.06,294.58,296.62,294.58,296.23,295.64,1.17,0.58,54,"1,596.49",44
,20130507,296.23,295.64,294.1,294.1,292.1,292.1,292.82,-3.54,-2.82,28,819.92,54
,20130508,292.1,292.82,288.14,290.42,288.14,289.96,289.22,-2.86,-3.6,14,404.92,58
,20130509,289.96,289.22,289.96,295.19,289.96,293,293.82,3.78,4.6,44,"1,292.81",58
,20130510,293,293.82,290.48,290.48,289.88,289.88,290.18,-3.94,-3.64,4,116.07,54
,20130513,289.88,290.18,285.23,287.11,285.23,287.11,285.84,-3.07,-4.34,22,628.85,60
,20130514,287.11,285.84,287.01,288,286.91,286.91,287.46,1.07,1.62,22,632.41,64
,20130515,286.91,287.46,284.99,285.96,283.93,284.44,285.14,-3.02,-2.32,28,798.41,52
,20130516,284.44,285.14,279.22,279.22,278,278.83,278.7,-6.31,-6.44,14,390.19,58
,20130517,278.83,278.7,279.41,279.41,274.68,274.68,277.44,-4.02,-1.26,60,"1,664.68",54
,20130520,274.68,277.44,271.97,271.97,269.29,270.13,270.45,-7.31,-6.99,28,757.27,66
,20130521,270.13,270.45,278.4,280.77,277.47,280.48,278.79,10.03,8.34,64,"1,784.29",76
,20130522,280.48,278.79,277.4,278.91,275.44,277.43,277.39,-1.36,-1.4,12,332.87,72
,20130523,277.43,277.39,274,277.42,273.75,276.4,275.69,-0.99,-1.7,32,882.22,76
,20130524,276.4,275.69,279.58,280.54,279,279,279.6,3.31,3.91,100,"2,796.09",100
,20130527,279,279.6,279.39,280.31,279.35,280.23,280.02,0.63,0.42,38,"1,064.11",96
,20130528,280.23,280.02,279.27,279.27,279.27,279.27,279.27,-0.75,-0.75,4,111.71,92
,20130529,279.27,279.27,279.25,280.04,278.4,278.49,279.11,-0.78,-0.16,76,"2,121.26",114
,20130530,278.49,279.11,279.82,283.09,279.74,282.64,281.08,3.53,1.97,26,730.83,102
,20130531,282.64,281.08,285.07,285.32,284.27,284.27,284.91,3.19,3.83,8,227.93,104
,20130603,284.27,284.91,281.23,281.23,280.38,280.67,280.89,-4.24,-4.02,12,337.07,100
,20130604,280.67,280.89,284.63,284.63,282.27,282.27,283.24,1.38,2.35,22,623.13,100
,20130605,282.27,283.24,280.79,282.32,280.69,282.05,281.23,-1.19,-2.01,12,337.48,96
,20130606,282.05,281.23,280.77,280.77,279.75,280.07,280.28,-1.16,-0.95,10,280.29,92
,20130607,280.07,280.28,283.54,283.76,282.87,282.93,283.3,2.65,3.02,24,679.93,84
,20130613,282.93,283.3,279.35,279.35,278.6,278.6,278.95,-4.7,-4.35,8,223.17,88
,20130614,278.6,278.95,278.65,278.65,275.85,277.08,277.79,-1.87,-1.16,22,611.15,88
,20130617,277.08,277.79,278.95,279.64,278.41,278.8,279.09,1.01,1.3,62,"1,730.39",96
,20130618,278.8,279.09,278.26,278.26,276.75,276.85,277.52,-2.24,-1.57,20,555.05,100
,20130619,276.85,277.52,275,275.06,274.29,274.81,274.64,-2.71,-2.88,202,"5,547.85",188
,20130620,274.81,274.64,268.89,271.35,268.89,269.45,270.61,-5.19,-4.03,546,"14,775.61",286
,20130621,269.45,270.61,257.07,262.71,257.07,262.56,260.37,-8.05,-10.24,704,"18,330.05",262
,20130624,262.56,260.37,263,263,257.73,257.85,260.22,-2.52,-0.15,326,"8,483.21",302
,20130625,257.85,260.2,259.4,260.3,257.6,259.05,259.1,-1.15,-1.1,352,"9,120.33",174
,20130626,259.05,259.1,257.65,257.65,251.3,252.3,253.75,-6.8,-5.35,316,"8,020.02",250
,20130627,252.3,253.75,250.35,252.4,250,251.65,251.3,-2.1,-2.45,212,"5,327.68",258
,20130628,251.65,251.3,239.05,246,238.9,245.35,243.65,-5.95,-7.65,322,"7,846.60",316
,20130701,245.35,243.65,249.65,254.05,248.05,253.5,252.35,9.85,8.7,418,"10,549.24",366
,20130702,253.5,252.35,254.8,256.65,254.8,255.65,255.8,3.3,3.45,628,"16,065.88",466
,20130703,255.65,255.8,254,254.5,252.2,253.75,253.8,-2.05,-2,194,"4,924.43",496
,20130704,253.75,253.8,253.9,256.45,253.9,255.25,255.2,1.45,1.4,184,"4,696.36",510
,20130705,255.25,255.2,253.45,254,251.8,252.9,252.85,-2.3,-2.35,206,"5,209.21",530
,20130708,252.9,252.85,249.7,249.7,245.75,247.4,247.25,-5.45,-5.6,794,"19,632.52",458
,20130709,247.4,247.25,249.25,255.15,249.25,254.05,251.8,6.8,4.55,862,"21,708.03",382
,20130710,254.05,251.8,253.15,254.05,251.2,252.4,252.5,0.6,0.7,666,"16,819.56",278
,20130711,252.4,252.5,253.25,263.45,252.7,260.35,260.1,7.85,7.6,1908,"49,628.47",706
,20130712,260.35,260.1,260.4,261.1,258.3,258.4,259.8,-1.7,-0.3,488,"12,678.43",686
,20130715,258.4,259.8,257.8,261.9,257.8,260.25,259.75,0.45,-0.05,468,"12,157.54",710
,20130716,260.25,259.75,259.45,260.55,258.9,259.55,259.75,-0.2,0,442,"11,482.24",682
,20130717,259.55,259.75,261.55,262.05,260.35,260.4,261.2,0.65,1.45,608,"15,881.83",632
,20130718,260.4,261.2,261.9,262.7,256.05,257.85,258.75,-3.35,-2.45,782,"20,235.81",582
,20130719,257.85,258.75,258.65,260.4,257.85,259.35,259.35,0.6,0.6,528,"13,695.89",518
,20130722,259.35,259.35,260.15,265.05,259.7,264.5,263.2,5.15,3.85,472,"12,425.07",462
,20130723,264.5,263.2,265.25,271.25,264.85,266.3,266.85,3.1,3.65,748,"19,962.36",394
,20130724,266.3,266.85,266.55,268.45,266.15,267.55,267.3,0.7,0.45,454,"12,137.22",442
,20130725,267.55,267.3,266.55,267.2,263.4,264.35,265.3,-2.95,-2,1050,"27,856.58",360
,20130726,264.35,265.3,264.45,267.15,264.45,266.2,266,0.9,0.7,864,"22,985.09",456
,20130729,266.2,266,263.7,265.2,262.45,263.45,263.8,-2.55,-2.2,598,"15,776.65",408
,20130730,263.45,263.8,263.75,264.45,263.25,263.5,264.05,-0.3,0.25,316,"8,344.30",382
,20130731,263.5,264.05,263.5,266.75,262.6,265.7,264.25,1.65,0.2,430,"11,364.36",382
,20130801,265.7,264.25,264.3,265.75,260.1,261,262.85,-3.25,-1.4,1146,"30,124.24",472
,20130802,261,262.85,264.45,264.45,254.55,257.8,259.15,-5.05,-3.7,1008,"26,126.90",574
,20130805,257.8,259.15,262.85,263.85,261.5,262.5,262.55,3.35,3.4,844,"22,161.06",458
,20130806,262.5,262.55,261,261.6,257.4,258.7,259.7,-3.85,-2.85,830,"21,558.10",428
,20130807,258.7,259.7,258,258,254.85,256.6,256.75,-3.1,-2.95,700,"17,975.54",474
,20130808,256.6,256.75,256.5,259.35,256.2,258.1,257.65,1.35,0.9,622,"16,028.59",444
,20130809,258.1,257.65,258.9,262.75,258.35,261.6,260.9,3.95,3.25,732,"19,098.19",406
,20130812,261.6,260.9,261.3,266.25,258.9,265.85,264,4.95,3.1,1038,"27,405.83",416
,20130813,265.85,264,265.7,268.25,265.7,267.75,267.3,3.75,3.3,868,"23,201.68",494
,20130814,267.75,267.3,266.8,267.15,263.45,263.75,264.6,-3.55,-2.7,1234,"32,655.45",516
,20130815,263.75,264.6,264.6,268.95,263.95,268,266.7,3.4,2.1,878,"23,420.30",442
,20130816,268,266.7,264.35,274.95,264.1,272.3,270.1,5.6,3.4,1382,"37,333.39",374
,20130819,272.3,270.1,272.9,276.6,271.15,274.2,273.8,4.1,3.7,1262,"34,555.13",432
,20130820,274.2,273.8,273.4,273.9,270.25,270.8,272.75,-3,-1.05,842,"22,966.28",382
,20130821,270.8,272.75,272.8,274.6,272.3,272.9,273.4,0.15,0.65,600,"16,406.43",388
,20130822,272.9,273.4,273.1,273.65,271.2,272.3,272.25,-1.1,-1.15,368,"10,019.41",386
,20130823,272.3,272.25,274.4,274.85,273,274.4,274,2.15,1.75,530,"14,523.56",420
,20130826,274.4,274,273.25,279.75,273.25,278.4,277.25,4.4,3.25,1020,"28,281.96",488
,20130827,278.4,277.25,278.1,279.2,277.2,278.95,278.3,1.7,1.05,788,"21,933.60",504
,20130828,278.95,278.3,282.5,285.3,281.3,284.15,282.9,5.85,4.6,1554,"43,968.43",600
,20130829,284.15,282.9,284.3,284.35,279.45,280.35,281.45,-2.55,-1.45,1936,"54,489.31",792
,20130830,280.35,281.45,281.2,281.2,278.95,279.2,279.75,-2.25,-1.7,1008,"28,200.84",812
,20130902,279.2,279.75,277,279,275.85,278.2,277.4,-1.55,-2.35,704,"19,530.50",832
,20130903,278.2,277.4,277.35,278.45,277,277.25,277.75,-0.15,0.35,526,"14,609.71",796
,20130904,277.25,277.75,278.85,281.7,278.8,279.4,280.05,1.65,2.3,1024,"28,679.64",902
,20130905,279.4,280.05,276.05,277.6,274.8,275.8,276.35,-4.25,-3.7,860,"23,767.55",844
,20130906,275.8,276.35,276.25,276.45,271.8,273.45,273.5,-2.9,-2.85,1006,"27,514.83",800
,20130909,273.45,273.5,275.9,276.9,275.45,276.55,276.25,3.05,2.75,702,"19,392.77",836
,20130910,276.55,276.25,276.55,276.75,274.2,274.65,275.15,-1.6,-1.1,400,"11,006.30",796
,20130911,274.65,275.15,271.65,273,270.65,272.7,272.05,-2.45,-3.1,714,"19,426.42",812
,20130912,272.7,272.05,271.7,272.2,268.45,268.7,271.05,-3.35,-1,616,"16,698.93",878
,20130913,268.7,271.05,266,266.25,261.65,263,264.55,-8.05,-6.5,1108,"29,314.69",698
,20130916,263,264.55,264.05,265.6,261.5,263.6,264.25,-0.95,-0.3,1258,"33,245.93",860
,20130917,263.6,264.25,261.75,264.1,261.3,262.3,262.4,-1.95,-1.85,860,"22,570.55",696
,20130918,262.3,262.4,262.05,262.3,257.75,260.55,259.7,-1.85,-2.7,502,"13,038.17",694
,20130923,260.55,259.7,263.35,265.55,262,264.45,263.65,4.75,3.95,386,"10,178.42",662
,20130924,264.45,263.65,263.75,265.2,263.25,263.8,264.35,0.15,0.7,508,"13,430.14",664
,20130925,263.8,264.35,261,265.2,261,264.4,263.05,0.05,-1.3,404,"10,628.46",638
,20130926,264.4,263.05,264,266.65,263.4,265.2,265.15,2.15,2.1,570,"15,115.78",606
,20130927,265.2,265.15,265.6,265.75,262.55,264,264.45,-1.15,-0.7,288,"7,617.11",582
,20130930,264,264.45,266.65,267.3,265.95,266.15,266.7,1.7,2.25,438,"11,681.86",574
,20131008,266.15,266.7,265.65,265.65,264.35,264.85,264.7,-1.85,-2,186,"4,923.66",550
,20131009,264.85,264.7,264.7,265.75,263,263,264.35,-1.7,-0.35,1082,"28,605.70",546
,20131010,263,264.35,260.85,262.5,259.35,261.1,260.7,-3.25,-3.65,924,"24,089.94",528
,20131011,261.1,260.7,259.25,260.4,257.9,258.55,259.15,-2.15,-1.55,1330,"34,471.68",666
,20131014,258.55,259.15,254.75,256.15,252.6,255.95,254.95,-3.2,-4.2,656,"16,725.04",732
,20131015,255.95,254.95,257.15,258,254.5,255.2,255.95,0.25,1,544,"13,925.95",756
,20131016,255.2,255.95,253.9,257.95,253.85,257.95,256.1,2,0.15,846,"21,668.83",734
,20131017,257.95,256.1,257.2,258.05,255,255.5,256.35,-0.6,0.25,834,"21,381.80",720
,20131018,255.5,256.35,262.9,264,262.2,263,262.9,6.65,6.55,932,"24,502.47",576
,20131021,263,262.9,262.8,263.5,262,263.4,262.6,0.5,-0.3,404,"10,609.11",556
,20131022,263.4,262.6,262.8,263.2,262.05,262.55,262.6,-0.05,0,364,"9,559.92",582
,20131023,262.55,262.6,264.9,266.8,264.45,265.2,265.65,2.6,3.05,696,"18,492.56",664
,20131024,265.2,265.65,265,266.05,264.5,265.75,265.15,0.1,-0.5,456,"12,092.15",584
,20131025,265.75,265.15,265.75,266.6,264.7,264.7,265.6,-0.45,0.45,374,"9,934.54",554
,20131028,264.7,265.6,264.65,267.3,264.5,265.8,265.85,0.2,0.25,430,"11,433.57",620
,20131029,265.8,265.85,267.2,267.45,265.8,266.3,266.5,0.45,0.65,598,"15,937.13",644
,20131030,266.3,266.5,266.2,266.2,263.75,265.65,265.05,-0.85,-1.45,400,"10,602.97",634
,20131031,265.65,265.05,266.45,268.05,262.6,264,266.05,-1.05,1,702,"18,678.32",596
,20131101,264,266.05,263.45,263.45,261.2,262.8,262.15,-3.25,-3.9,478,"12,531.28",588
,20131104,262.8,262.15,261.05,261.25,259.5,260.65,260.45,-1.5,-1.7,410,"10,679.10",610
,20131105,260.65,260.45,261.95,261.95,260.3,261.05,261.15,0.6,0.7,286,"7,469.39",566
,20131106,261.05,261.15,261.35,261.35,259.7,260.7,260.25,-0.45,-0.9,472,"12,284.74",576
,20131107,260.7,260.25,261.1,261.65,260.65,261.55,261.25,1.3,1,404,"10,556.13",492
,20131108,261.55,261.25,262.05,265,258,260.05,260.25,-1.2,-1,614,"15,980.34",570
,20131111,260.05,260.25,260.1,260.25,255,255.25,256.25,-5,-4,836,"21,423.92",708
,20131112,255.25,256.25,255.25,255.25,253.4,254.15,254.5,-2.1,-1.75,524,"13,337.83",752
,20131113,254.15,254.5,254.5,255.25,252.2,253.05,253.75,-1.45,-0.75,312,"7,917.93",766
,20131114,253.05,253.75,253.5,255.45,252.6,254.7,254.15,0.95,0.4,532,"13,521.40",772
,20131115,254.7,254.15,254.05,256.3,254.05,255.1,255.25,0.95,1.1,504,"12,867.05",726
,20131118,255.1,255.25,254.55,255.85,254.5,255.6,255.3,0.35,0.05,430,"10,978.80",738
,20131119,255.6,255.3,254.05,254.85,252.45,253.3,253.35,-2,-1.95,430,"10,895.70",770
,20131120,253.3,253.35,253.6,253.85,253.2,253.8,253.55,0.45,0.2,522,"13,236.54",778
,20131121,253.8,253.55,251.3,252.9,248.65,248.85,250.7,-4.7,-2.85,884,"22,162.26",878
,20131122,248.85,250.7,249.1,249.15,247.6,248.7,248.45,-2,-2.25,620,"15,406.90",886
,20131125,248.7,248.45,249.05,249.45,245.8,245.9,247.85,-2.55,-0.6,424,"10,509.09",840
,20131126,245.9,247.85,245.75,249.95,245.35,249.65,248.4,1.8,0.55,624,"15,501.97",834
,20131127,249.65,248.4,248.8,248.95,247.65,247.7,248.15,-0.7,-0.25,518,"12,855.88",932
,20131128,247.7,248.15,248.5,249.05,245.4,246.4,247.3,-1.75,-0.85,558,"13,800.08",1008
,20131129,246.4,247.3,247.3,247.55,246.05,246.3,246.75,-1,-0.55,520,"12,831.75",1134
,20131202,246.3,246.75,248.65,248.65,246.5,247.25,247.35,0.5,0.6,556,"13,753.53",1156
,20131203,247.25,247.35,246,246.05,243.2,243.5,244.4,-3.85,-2.95,804,"19,652.95",1102
,20131204,243.5,244.4,243.75,244.35,242.9,243.2,243.35,-1.2,-1.05,670,"16,304.71",1152
,20131205,243.2,243.35,243.35,247.6,242.45,245.4,245.1,2.05,1.75,1240,"30,396.50",1210
,20131206,245.4,245.1,244.95,244.95,241.85,242.8,243.25,-2.3,-1.85,894,"21,748.81",1160
,20131209,242.8,243.25,243.25,245.9,240.25,243.1,243.75,-0.15,0.5,958,"23,351.93",1174
,20131210,243.1,243.75,243.65,244.85,243.6,244.85,244.2,1.1,0.45,356,"8,694.16",1166
,20131211,244.85,244.2,244.3,249,244.3,247,246.9,2.8,2.7,868,"21,432.69",1094
,20131212,247,246.9,246.45,247.95,245.9,246.85,246.9,-0.05,0,492,"12,149.86",1040
,20131213,246.85,246.9,243.4,243.5,240.95,241.55,242,-5.35,-4.9,522,"12,633.84",1048
,20131216,241.55,242,242.65,243.5,241.6,242.9,242.5,0.9,0.5,352,"8,536.18",1046
,20131217,242.9,242.5,243.1,246,242.65,244.45,244.15,1.95,1.65,652,"15,920.52",1184
,20131218,244.45,244.15,242.5,244.7,241.75,242.5,242.65,-1.65,-1.5,344,"8,347.99",1178
,20131219,242.5,242.65,242.5,243.45,240.3,240.35,241.1,-2.3,-1.55,638,"15,383.31",1120
,20131220,240.35,241.1,237.75,238.2,235.8,235.8,236.85,-5.3,-4.25,680,"16,107.09",1004
,20131223,235.8,236.85,235.85,238.5,235.7,237.65,237.2,0.8,0.35,412,"9,772.77",976
,20131224,237.65,237.2,234.5,237.7,234.5,237,236.85,-0.2,-0.35,216,"5,116.71",984
,20131225,237,236.85,237,238.45,236.95,238.45,237.7,1.6,0.85,232,"5,514.95",974
,20131226,238.45,237.7,238.65,238.65,237.35,238.3,238.05,0.6,0.35,78,"1,856.82",972
,20131227,238.3,238.05,238.4,240.3,238.4,240.05,239.6,2,1.55,284,"6,804.72",934
,20131230,240.05,239.6,239.95,241,237.95,238.2,239.5,-1.4,-0.1,368,"8,814.13",906
,20131231,238.2,239.5,239.85,243.2,232.7,239.5,237.3,0,-2.2,370,"8,781.26",890
au1402,20130219,331.08,331.08,,,,332.74,332.74,1.66,1.66,0,0,0
,20130220,332.74,332.74,,,,330.01,330.01,-2.73,-2.73,0,0,0
,20130221,330.01,330.01,,,,321.3,321.3,-8.71,-8.71,0,0,0
,20130222,321.3,321.3,,,,326.2,326.2,4.9,4.9,0,0,0
,20130225,326.2,326.2,,,,326.39,326.39,0.19,0.19,0,0,0
,20130226,326.39,326.39,,,,327.7,327.7,1.31,1.31,0,0,0
,20130227,327.7,327.7,,,,330.23,330.23,2.53,2.53,0,0,0
,20130228,330.23,330.23,,,,327.94,327.94,-2.29,-2.29,0,0,0
,20130301,327.94,327.94,325.64,325.64,325.64,325.64,325.64,-2.3,-2.3,2,65.13,2
,20130304,325.64,325.64,,,,325.36,325.36,-0.28,-0.28,0,0,2
,20130305,325.36,325.36,,,,325.4,325.4,0.04,0.04,0,0,2
,20130306,325.4,325.4,,,,325.24,325.24,-0.16,-0.16,0,0,2
,20130307,325.24,325.24,,,,325.54,325.54,0.3,0.3,0,0,2
,20130308,325.54,325.54,,,,325.54,325.54,0,0,0,0,2
,20130311,325.54,325.54,,,,325.54,325.54,0,0,0,0,2
,20130312,325.54,325.54,,,,325.54,325.54,0,0,0,0,2
,20130313,325.54,325.54,,,,325.54,325.54,0,0,0,0,2
,20130314,325.54,325.54,,,,325.54,325.54,0,0,0,0,2
,20130315,325.54,325.54,,,,325.54,325.54,0,0,0,0,2
,20130318,325.54,325.54,,,,325.54,325.54,0,0,0,0,2
,20130319,325.54,325.54,,,,325.54,325.54,0,0,0,0,2
,20130320,325.54,325.54,,,,325.54,325.54,0,0,0,0,2
,20130321,325.54,325.54,,,,325.54,325.54,0,0,0,0,2
,20130322,325.54,325.54,327.99,327.99,327.99,327.99,327.99,2.45,2.45,2,65.6,0
,20130325,327.99,327.99,328.41,330.41,328.41,328.58,329.64,0.59,1.65,10,329.64,4
,20130326,328.58,329.64,326.88,326.88,326.88,326.88,326.88,-2.76,-2.76,2,65.38,4
,20130327,326.88,326.88,,,,326.88,326.88,0,0,0,0,4
,20130328,326.88,326.88,,,,328.49,328.49,1.61,1.61,0,0,4
,20130329,328.49,328.49,,,,326.61,326.61,-1.88,-1.88,0,0,4
,20130401,326.61,326.61,,,,324.8,324.8,-1.81,-1.81,0,0,4
,20130402,324.8,324.8,,,,327.7,327.7,2.9,2.9,0,0,4
,20130403,327.7,327.7,318.4,318.55,318.4,318.55,318.47,-9.15,-9.23,4,127.39,4
,20130408,318.55,318.47,,,,318.47,318.47,0,0,0,0,4
,20130409,318.47,318.47,,,,318.32,318.32,-0.15,-0.15,0,0,4
,20130410,318.32,318.32,321.2,323,321.2,323,322.36,4.68,4.04,6,193.42,6
,20130411,323,322.36,,,,315.52,315.52,-6.84,-6.84,0,0,6
,20130412,315.52,315.52,,,,315.52,315.52,0,0,0,0,6
,20130415,315.52,315.52,,,,299.74,299.74,-15.78,-15.78,0,0,6
,20130416,299.74,299.74,284.75,284.75,284.75,284.75,284.75,-14.99,-14.99,2,56.95,4
,20130417,284.75,284.75,277.57,279.84,277.57,279.84,278.7,-4.91,-6.05,4,111.48,4
,20130418,279.84,278.7,,,,274.7,274.7,-4,-4,0,0,4
,20130419,274.7,274.7,,,,283.13,283.13,8.43,8.43,0,0,4
,20130422,283.13,283.13,,,,286.56,286.56,3.43,3.43,0,0,4
,20130423,286.56,286.56,285.8,285.8,285.8,285.8,285.8,-0.76,-0.76,2,57.16,4
,20130424,285.8,285.8,,,,285.66,285.66,-0.14,-0.14,0,0,4
,20130425,285.66,285.66,,,,290.24,290.24,4.58,4.58,0,0,4
,20130426,290.24,290.24,298.29,300.2,298.29,300.2,299.09,9.96,8.85,6,179.45,4
,20130502,300.2,299.09,,,,291.98,291.98,-7.11,-7.11,0,0,4
,20130503,291.98,291.98,,,,296.3,296.3,4.32,4.32,0,0,4
,20130506,296.3,296.3,,,,296.88,296.88,0.58,0.58,0,0,4
,20130507,296.88,296.88,,,,294.05,294.05,-2.83,-2.83,0,0,4
,20130508,294.05,294.05,,,,290.44,290.44,-3.61,-3.61,0,0,4
,20130509,290.44,290.44,294.66,294.66,294.66,294.66,294.66,4.22,4.22,2,58.93,4
,20130510,294.66,294.66,,,,291,291,-3.66,-3.66,0,0,4
,20130513,291,291,287.08,287.26,286.43,287.26,287.02,-3.74,-3.98,10,287.03,6
,20130514,287.26,287.02,,,,288.64,288.64,1.62,1.62,0,0,6
,20130515,288.64,288.64,286.5,286.5,282.6,282.6,284.69,-6.04,-3.95,10,284.69,8
,20130516,282.6,284.69,278.97,279.98,278.97,279.45,279.52,-5.24,-5.17,8,223.62,6
,20130517,279.45,279.52,277.53,279.13,277.53,278.37,278.19,-1.15,-1.33,8,222.55,6
,20130520,278.37,278.19,269.95,270.04,269.95,270.04,269.99,-8.15,-8.2,4,108,4
,20130521,270.04,269.99,,,,278.32,278.32,8.33,8.33,0,0,4
,20130522,278.32,278.32,,,,276.92,276.92,-1.4,-1.4,0,0,4
,20130523,276.92,276.92,,,,275.22,275.22,-1.7,-1.7,0,0,4
,20130524,275.22,275.22,,,,279.13,279.13,3.91,3.91,0,0,4
,20130527,279.13,279.13,,,,279.13,279.13,0,0,0,0,4
,20130528,279.13,279.13,,,,278.38,278.38,-0.75,-0.75,0,0,4
,20130529,278.38,278.38,,,,278.22,278.22,-0.16,-0.16,0,0,4
,20130530,278.22,278.22,277.5,282.5,277.5,282.5,279.63,4.28,1.41,8,223.71,6
,20130531,282.5,279.63,,,,283.44,283.44,3.81,3.81,0,0,6
,20130603,283.44,283.44,,,,279.44,279.44,-4,-4,0,0,6
,20130604,279.44,279.44,,,,281.77,281.77,2.33,2.33,0,0,6
,20130605,281.77,281.77,,,,279.77,279.77,-2,-2,0,0,6
,20130606,279.77,279.77,,,,278.83,278.83,-0.94,-0.94,0,0,6
,20130607,278.83,278.83,,,,281.83,281.83,3,3,0,0,6
,20130613,281.83,281.83,,,,277.51,277.51,-4.32,-4.32,0,0,6
,20130614,277.51,277.51,,,,276.36,276.36,-1.15,-1.15,0,0,6
,20130617,276.36,276.36,,,,277.65,277.65,1.29,1.29,0,0,6
,20130618,277.65,277.65,,,,276.09,276.09,-1.56,-1.56,0,0,6
,20130619,276.09,276.09,,,,273.23,273.23,-2.86,-2.86,0,0,6
,20130620,273.23,273.23,270.19,270.4,270.19,270.4,270.29,-2.83,-2.94,4,108.12,8
,20130621,270.4,270.29,259.05,259.05,259.05,259.05,259.05,-11.24,-11.24,2,51.81,10
,20130624,259.05,259.05,261.76,261.76,261.58,261.58,261.67,2.53,2.62,4,104.67,10
,20130625,261.6,261.65,260.4,260.4,260.35,260.35,260.35,-1.3,-1.3,6,156.23,8
,20130626,260.35,260.35,254.85,255.6,252.05,252.05,254.15,-8.3,-6.2,6,152.5,8
,20130627,252.05,254.15,251.45,252.1,251.45,252.1,251.7,-2.05,-2.45,6,151.04,10
,20130628,252.1,251.7,,,,244.05,244.05,-7.65,-7.65,0,0,10
,20130701,244.05,244.05,,,,252.75,252.75,8.7,8.7,0,0,10
,20130702,252.75,252.75,,,,256.2,256.2,3.45,3.45,0,0,10
,20130703,256.2,256.2,,,,254.2,254.2,-2,-2,0,0,10
,20130704,254.2,254.2,241.55,241.55,241.55,241.55,241.55,-12.65,-12.65,4,96.62,14
,20130705,241.55,241.55,253.6,253.6,252.9,253.55,253.35,12,11.8,10,253.37,10
,20130708,253.55,253.35,,,,247.7,247.7,-5.65,-5.65,0,0,10
,20130709,247.7,247.7,249,255.25,249,255.25,252.05,7.55,4.35,12,302.48,6
,20130710,255.25,252.05,252.35,254,251.55,252.15,252.75,0.1,0.7,12,303.35,6
,20130711,252.15,252.75,254.3,262.05,254.3,262.05,258.7,9.3,5.95,6,155.22,8
,20130712,262.05,258.7,258.8,259.4,257.65,258.5,258.8,-0.2,0.1,44,"1,138.77",12
,20130715,258.5,258.8,259.3,259.3,259.2,259.2,259.25,0.4,0.45,4,103.7,12
,20130716,259.2,259.25,258.05,258.95,258.05,258.95,258.4,-0.3,-0.85,6,155.04,12
,20130717,258.95,258.4,259.6,261.7,259.6,261.7,260.65,3.3,2.25,4,104.26,12
,20130718,261.7,260.65,,,,258.2,258.2,-2.45,-2.45,0,0,12
,20130719,258.2,258.2,258.2,259.9,258.2,259.05,258.85,0.85,0.65,8,207.11,10
,20130722,259.05,258.85,262.2,265.1,262.2,265.1,264.15,6.25,5.3,12,317.02,6
,20130723,265.1,264.15,267.9,267.9,267.9,267.9,267.9,3.75,3.75,2,53.58,4
,20130724,267.9,267.9,,,,268.35,268.35,0.45,0.45,0,0,4
,20130725,268.35,268.35,,,,266.3,266.3,-2.05,-2.05,0,0,4
,20130726,266.3,266.3,264.95,265.35,264.95,265.25,265.15,-1.05,-1.15,6,159.11,4
,20130729,265.25,265.15,,,,262.95,262.95,-2.2,-2.2,0,0,4
,20130730,262.95,262.95,,,,263.2,263.2,0.25,0.25,0,0,4
,20130731,263.2,263.2,262.45,263.4,262.45,263.4,262.9,0.2,-0.3,4,105.17,4
,20130801,263.4,262.9,,,,261.5,261.5,-1.4,-1.4,0,0,4
,20130802,261.5,261.5,261.5,261.85,261.5,261.85,261.65,0.35,0.15,8,209.33,6
,20130805,261.85,261.65,261.35,263.2,261.35,263.2,262.4,1.55,0.75,16,419.9,10
,20130806,263.2,262.4,262.5,262.5,258.5,258.5,260.7,-3.9,-1.7,6,156.42,10
,20130807,258.5,260.7,257.1,257.6,255.05,256.7,256.15,-4,-4.55,36,922.31,10
,20130808,256.7,256.15,,,,257.05,257.05,0.9,0.9,0,0,10
,20130809,257.05,257.05,259.9,262.45,258.65,261.05,259.55,4,2.5,232,"6,022.56",84
,20130812,261.05,259.55,261.4,265.55,261.4,265.05,263,5.5,3.45,30,789,64
,20130813,265.05,263,267.75,267.75,266.15,266.85,267.05,3.85,4.05,16,427.35,54
,20130814,266.85,267.05,266.55,266.55,265.2,265.2,265.75,-1.85,-1.3,18,478.43,44
,20130815,265.2,265.75,265.75,268.65,265.75,267.2,266.9,1.45,1.15,28,747.32,34
,20130816,267.2,266.9,263.95,272.7,263.95,270.7,267.5,3.8,0.6,10,267.52,36
,20130819,270.7,267.5,273.9,275.35,273.6,275.2,274.2,7.7,6.7,16,438.79,42
,20130820,275.2,274.2,272.6,272.6,270.8,270.8,271.7,-3.4,-2.5,4,108.68,40
,20130821,270.8,271.7,272.75,273.3,271.7,273.3,272.7,1.6,1,8,218.18,40
,20130822,273.3,272.7,,,,271.55,271.55,-1.15,-1.15,0,0,40
,20130823,271.55,271.55,274.2,274.25,273.65,273.65,273.9,2.1,2.35,8,219.15,38
,20130826,273.65,273.9,278.7,278.7,278.05,278.6,278.4,4.7,4.5,10,278.42,36
,20130827,278.6,278.4,278.05,278.15,278,278.15,278,-0.25,-0.4,12,333.64,42
,20130828,278.15,278,281.25,281.85,281.25,281.85,281.5,3.85,3.5,8,225.2,36
,20130829,281.85,281.5,281,281,280.35,280.75,280.6,-0.75,-0.9,16,449.03,38
,20130830,280.75,280.6,279.65,280,279.65,280,279.8,-0.6,-0.8,4,111.93,36
,20130902,280,279.8,277.05,278.3,276.2,278.3,276.7,-1.5,-3.1,70,"1,937.10",40
,20130903,278.3,276.7,277.45,277.9,277.25,277.7,277.55,1,0.85,24,666.21,44
,20130904,277.7,277.55,281.1,281.1,281,281,281.05,3.45,3.5,6,168.64,38
,20130905,281,281.05,276.65,277.2,275,275,276.55,-6.05,-4.5,20,553.1,38
,20130906,275,276.55,274.6,274.6,273.65,274.4,274.15,-2.15,-2.4,10,274.18,38
,20130909,274.4,274.15,277.05,277.05,276.65,276.9,276.85,2.75,2.7,6,166.12,36
,20130910,276.9,276.85,,,,275.75,275.75,-1.1,-1.1,0,0,36
,20130911,275.75,275.75,271.1,271.85,271.1,271.85,271.45,-3.9,-4.3,4,108.59,38
,20130912,271.85,271.45,271.65,271.65,269.65,269.65,270.4,-1.8,-1.05,6,162.25,38
,20130913,269.65,270.4,,,,263.9,263.9,-6.5,-6.5,0,0,38
,20130916,263.9,263.9,263.85,266.2,263.85,265.55,264.6,1.65,0.7,24,635.11,42
,20130917,265.55,264.6,261.85,262.55,261.85,262.5,262.05,-2.1,-2.55,22,576.56,24
,20130918,262.5,262.05,260.95,260.95,260.95,260.95,260.95,-1.1,-1.1,2,52.19,24
,20130923,260.95,260.95,263.85,263.85,263.7,263.7,263.75,2.75,2.8,24,633.06,30
,20130924,263.7,263.75,263.75,265.1,263.75,263.85,264.4,0.1,0.65,28,740.33,28
,20130925,263.85,264.4,262.9,263.85,262.9,263.85,263.35,-0.55,-1.05,4,105.35,30
,20130926,263.85,263.35,264.25,264.85,264.25,264.85,264.55,1.5,1.2,6,158.74,26
,20130927,264.85,264.55,266,266,264.8,264.8,265.3,0.25,0.75,6,159.2,24
,20130930,264.8,265.3,266.85,267.5,265.3,267.5,266.95,2.2,1.65,12,320.38,20
,20131008,267.5,266.95,265.2,265.2,265.2,265.2,265.2,-1.75,-1.75,2,53.04,20
,20131009,265.2,265.2,264.15,264.15,263.9,263.9,264,-1.3,-1.2,4,105.61,22
,20131010,263.9,264,,,,260.35,260.35,-3.65,-3.65,0,0,22
,20131011,260.35,260.35,258.7,258.7,258.7,258.7,258.7,-1.65,-1.65,2,51.74,22
,20131014,258.7,258.7,255.25,255.25,255.25,255.25,255.25,-3.45,-3.45,2,51.05,22
,20131015,255.25,255.25,,,,256.25,256.25,1,1,0,0,22
,20131016,256.25,256.25,,,,256.4,256.4,0.15,0.15,0,0,22
,20131017,256.4,256.4,254.8,254.8,254.8,254.8,254.8,-1.6,-1.6,2,50.96,24
,20131018,254.8,254.8,263.65,263.8,261.95,261.95,262.7,7.15,7.9,10,262.73,24
,20131021,261.95,262.7,262.45,262.45,262.45,262.45,262.45,-0.25,-0.25,4,104.98,20
,20131022,262.45,262.45,262.7,262.85,262.7,262.85,262.75,0.4,0.3,4,105.11,20
,20131023,262.85,262.75,265.1,265.4,265.1,265.4,265.25,2.65,2.5,4,106.1,22
,20131024,265.4,265.25,,,,264.75,264.75,-0.5,-0.5,0,0,22
,20131025,264.75,264.75,,,,265.2,265.2,0.45,0.45,0,0,22
,20131028,265.2,265.2,,,,265.45,265.45,0.25,0.25,0,0,22
,20131029,265.45,265.45,266.4,266.4,266.4,266.4,266.4,0.95,0.95,2,53.28,20
,20131030,266.4,266.4,266.3,266.3,265.3,265.3,265.8,-1.1,-0.6,200,"5,316.00",14
,20131031,265.3,265.8,,,,266.8,266.8,1,1,0,0,14
,20131101,266.8,266.8,,,,262.85,262.85,-3.95,-3.95,0,0,14
,20131104,262.85,262.85,262.85,262.85,262.85,262.85,262.85,0,0,2,52.57,14
,20131105,262.85,262.85,,,,263.55,263.55,0.7,0.7,0,0,14
,20131106,263.55,263.55,,,,262.65,262.65,-0.9,-0.9,0,0,14
,20131107,262.65,262.65,,,,263.65,263.65,1,1,0,0,14
,20131108,263.65,263.65,258.95,258.95,258.95,258.95,258.95,-4.7,-4.7,2,51.79,14
,20131111,258.95,258.95,255.95,255.95,255.3,255.3,255.6,-3.65,-3.35,4,102.25,14
,20131112,255.3,255.6,253.6,253.6,253.6,253.6,253.6,-2,-2,2,50.72,14
,20131113,253.6,253.6,253.55,253.55,253.55,253.55,253.55,-0.05,-0.05,10,253.55,24
,20131114,253.55,253.55,255.35,255.55,255.35,255.55,255.45,2,1.9,4,102.18,24
,20131115,255.55,255.45,255.65,255.8,255.3,255.3,255.55,-0.15,0.1,6,153.35,24
,20131118,255.3,255.55,254.75,256.25,254.75,255.65,255.55,0.1,0,8,204.46,24
,20131119,255.65,255.55,253.6,254.3,253.05,253.05,253.75,-2.5,-1.8,14,355.26,22
,20131120,253.05,253.75,253.8,253.8,253.8,253.8,253.8,0.05,0.05,2,50.76,22
,20131121,253.8,253.8,251.2,252.6,249.4,249.4,250.2,-4.4,-3.6,112,"2,802.41",58
,20131122,249.4,250.2,246.55,249,246.55,249,248.5,-1.2,-1.7,30,745.57,46
,20131125,249,248.5,249.75,249.75,246.6,246.6,247.65,-1.9,-0.85,6,148.6,46
,20131126,246.6,247.65,245.8,250.3,245.8,250.1,248.55,2.45,0.9,8,198.87,46
,20131127,250.1,248.55,249.05,249.5,248.4,249.5,248.85,0.95,0.3,12,298.66,46
,20131128,249.5,248.85,249.9,249.9,247.2,247.5,247.55,-1.35,-1.3,30,742.74,52
,20131129,247.5,247.55,247.45,247.6,247,247,247.3,-0.55,-0.25,54,"1,335.55",60
,20131202,247,247.3,248.9,248.9,247.4,248,248.15,0.7,0.85,24,595.66,56
,20131203,248,248.15,246.15,246.25,243.95,244.35,244.6,-3.8,-3.55,46,"1,125.38",64
,20131204,244.35,244.6,244.8,244.8,243.85,243.9,244.1,-0.7,-0.5,22,537.1,74
,20131205,243.9,244.1,245,247.4,244.95,246.25,246.25,2.15,2.15,48,"1,182.08",74
,20131206,246.25,246.25,244,244,243.2,243.2,243.7,-3.05,-2.55,10,243.71,76
,20131209,243.2,243.7,244.25,245,243.45,244.4,244.15,0.7,0.45,22,537.16,68
,20131210,244.4,244.15,244.15,245.55,244.15,245.55,245.1,1.4,0.95,10,245.12,66
,20131211,245.55,245.1,248.1,248.15,248.05,248.15,248.05,3.05,2.95,14,347.31,72
,20131212,248.15,248.05,248,249.5,246.85,247.4,248.15,-0.65,0.1,32,794.2,84
,20131213,247.4,248.15,241.95,242.5,241.95,242.5,242.25,-5.65,-5.9,8,193.82,80
,20131216,242.5,242.25,243.4,243.4,243.05,243.05,243.2,0.8,0.95,4,97.29,80
,20131217,243.05,243.2,243.1,245.75,243.1,245.05,244.65,1.85,1.45,12,293.63,80
,20131218,245.05,244.65,245.25,245.25,242.65,243.55,243.65,-1.1,-1,8,194.95,84
,20131219,243.55,243.65,241.4,242,240.5,241,241.05,-2.65,-2.6,28,675.05,88
,20131220,241,241.05,236.5,238.35,236.5,236.9,237.1,-4.15,-3.95,18,426.82,92
,20131223,236.9,237.1,237.8,237.8,237.7,237.8,237.75,0.7,0.65,16,380.43,84
,20131224,237.8,237.75,235.25,236.8,235.25,236.6,235.95,-1.15,-1.8,8,188.78,82
,20131225,236.6,235.95,237.25,238.7,237,238.7,237.8,2.75,1.85,28,665.87,78
,20131226,238.7,237.8,238.05,238.4,238.05,238.4,238.15,0.6,0.35,6,142.9,76
,20131227,238.4,238.15,,,,239.7,239.7,1.55,1.55,0,0,76
,20131230,239.7,239.7,240.2,240.2,239.25,239.25,239.65,-0.45,-0.05,12,287.61,80
,20131231,239.25,239.65,238.45,238.45,236.05,237.3,237.35,-2.35,-2.3,20,474.72,82
au1403,20130318,325.54,325.54,,,,325.43,325.43,-0.11,-0.11,0,0,0
,20130319,325.43,325.43,,,,326.39,326.39,0.96,0.96,0,0,0
,20130320,326.39,326.39,,,,328.09,328.09,1.7,1.7,0,0,0
,20130321,328.09,328.09,,,,328.09,328.09,0,0,0,0,0
,20130322,328.09,328.09,,,,328.09,328.09,0,0,0,0,0
,20130325,328.09,328.09,,,,328.09,328.09,0,0,0,0,0
,20130326,328.09,328.09,,,,328.09,328.09,0,0,0,0,0
,20130327,328.09,328.09,,,,328.09,328.09,0,0,0,0,0
,20130328,328.09,328.09,,,,328.09,328.09,0,0,0,0,0
,20130329,328.09,328.09,,,,328.09,328.09,0,0,0,0,0
,20130401,328.09,328.09,,,,328.09,328.09,0,0,0,0,0
,20130402,328.09,328.09,,,,328.09,328.09,0,0,0,0,0
,20130403,328.09,328.09,,,,318.85,318.85,-9.24,-9.24,0,0,0
,20130408,318.85,318.85,,,,318.85,318.85,0,0,0,0,0
,20130409,318.85,318.85,,,,318.85,318.85,0,0,0,0,0
,20130410,318.85,318.85,,,,321.55,321.55,2.7,2.7,0,0,0
,20130411,321.55,321.55,321.55,321.55,317.26,317.26,318.53,-4.29,-3.02,10,318.54,4
,20130412,317.26,318.53,317.65,317.67,317.65,317.67,317.66,-0.86,-0.87,4,127.06,8
,20130415,317.67,317.66,302.66,302.66,302.66,302.66,302.66,-15,-15,2,60.53,8
,20130416,302.66,302.66,287.52,287.52,287.52,287.52,287.52,-15.14,-15.14,2,57.5,8
,20130417,287.52,287.52,277.55,277.97,276.66,276.9,277.09,-10.62,-10.43,14,387.93,16
,20130418,276.9,277.09,273.1,276.76,273.1,276.76,275.75,-0.33,-1.34,14,386.06,12
,20130419,276.76,275.75,282.63,288.29,282.63,285.8,285.36,10.05,9.61,10,285.37,10
,20130422,285.8,285.36,,,,288.82,288.82,3.46,3.46,0,0,10
,20130423,288.82,288.82,,,,288.05,288.05,-0.77,-0.77,0,0,10
,20130424,288.05,288.05,286.68,286.68,286.68,286.68,286.68,-1.37,-1.37,2,57.34,12
,20130425,286.68,286.68,291.45,291.45,291.3,291.3,291.35,4.62,4.67,6,174.81,12
,20130426,291.3,291.35,300.99,300.99,300.99,300.99,300.99,9.64,9.64,2,60.2,10
,20130502,300.99,300.99,291.37,291.37,291.36,291.37,291.36,-9.62,-9.63,6,174.82,14
,20130503,291.37,291.36,,,,295.67,295.67,4.31,4.31,0,0,14
,20130506,295.67,295.67,295.98,296.01,295.98,296.01,295.99,0.34,0.32,4,118.4,18
,20130507,296.01,295.99,292.37,292.37,292.37,292.37,292.37,-3.62,-3.62,2,58.47,18
,20130508,292.37,292.37,,,,288.78,288.78,-3.59,-3.59,0,0,18
,20130509,288.78,288.78,,,,292.97,292.97,4.19,4.19,0,0,18
,20130510,292.97,292.97,,,,289.34,289.34,-3.63,-3.63,0,0,18
,20130513,289.34,289.34,285.42,285.76,285.42,285.76,285.72,-3.58,-3.62,22,628.6,34
,20130514,285.76,285.72,287.68,288.27,287.68,288.27,287.97,2.55,2.25,4,115.19,32
,20130515,288.27,287.97,,,,284.03,284.03,-3.94,-3.94,0,0,32
,20130516,284.03,284.03,,,,278.87,278.87,-5.16,-5.16,0,0,32
,20130517,278.87,278.87,276.45,276.45,276.45,276.45,276.45,-2.42,-2.42,2,55.29,32
,20130520,276.45,276.45,,,,268.3,268.3,-8.15,-8.15,0,0,32
,20130521,268.3,268.3,278.67,279.37,278.64,279.37,278.89,11.07,10.59,6,167.34,34
,20130522,279.37,278.89,,,,277.49,277.49,-1.4,-1.4,0,0,34
,20130523,277.49,277.49,,,,275.79,275.79,-1.7,-1.7,0,0,34
,20130524,275.79,275.79,,,,279.71,279.71,3.92,3.92,0,0,34
,20130527,279.71,279.71,278.7,278.9,278.7,278.9,278.8,-0.81,-0.91,4,111.52,30
,20130528,278.9,278.8,,,,278.05,278.05,-0.75,-0.75,0,0,30
,20130529,278.05,278.05,278.89,278.89,278.89,278.89,278.89,0.84,0.84,2,55.78,30
,20130530,278.89,278.89,,,,280.31,280.31,1.42,1.42,0,0,30
,20130531,280.31,280.31,,,,284.13,284.13,3.82,3.82,0,0,30
,20130603,284.13,284.13,,,,280.12,280.12,-4.01,-4.01,0,0,30
,20130604,280.12,280.12,,,,282.46,282.46,2.34,2.34,0,0,30
,20130605,282.46,282.46,,,,280.46,280.46,-2,-2,0,0,30
,20130606,280.46,280.46,,,,279.52,279.52,-0.94,-0.94,0,0,30
,20130607,279.52,279.52,,,,282.53,282.53,3.01,3.01,0,0,30
,20130613,282.53,282.53,,,,278.19,278.19,-4.34,-4.34,0,0,30
,20130614,278.19,278.19,,,,277.03,277.03,-1.16,-1.16,0,0,30
,20130617,277.03,277.03,,,,278.33,278.33,1.3,1.3,0,0,30
,20130618,278.33,278.33,,,,276.76,276.76,-1.57,-1.57,0,0,30
,20130619,276.76,276.76,275.17,275.2,273.68,274.45,274.49,-2.31,-2.27,18,494.08,26
,20130620,274.45,274.49,270.4,271.04,270.4,271.04,270.87,-3.45,-3.62,8,216.7,22
,20130621,271.04,270.87,,,,259.6,259.6,-11.27,-11.27,0,0,22
,20130624,259.6,259.6,,,,262.22,262.22,2.62,2.62,0,0,22
,20130625,262.2,262.2,260.65,260.65,259.1,259.25,260.1,-2.95,-2.1,20,520.28,24
,20130626,259.25,260.1,,,,253.9,253.9,-6.2,-6.2,0,0,24
,20130627,253.9,253.9,,,,251.45,251.45,-2.45,-2.45,0,0,24
,20130628,251.45,251.45,243.2,245.85,243.2,245.85,244.75,-5.6,-6.7,12,293.73,26
,20130701,245.85,244.75,,,,253.5,253.5,8.75,8.75,0,0,26
,20130702,253.5,253.5,255.15,255.15,255.05,255.05,255.1,1.55,1.6,4,102.04,24
,20130703,255.05,255.1,,,,253.1,253.1,-2,-2,0,0,24
,20130704,253.1,253.1,,,,240.5,240.5,-12.6,-12.6,0,0,24
,20130705,240.5,240.5,252.5,252.5,252.4,252.5,252.45,12,11.95,18,454.46,24
,20130708,252.5,252.45,247.85,247.85,244.85,246.6,246.55,-5.85,-5.9,12,295.88,24
,20130709,246.6,246.55,255.5,255.55,255.5,255.55,255.5,9,8.95,4,102.21,24
,20130710,255.55,255.5,253.85,253.85,252.25,252.25,253.25,-3.25,-2.25,8,202.61,24
,20130711,252.25,253.25,253.95,261,253.95,261,257.5,7.75,4.25,18,463.56,30
,20130712,261,257.5,260.45,260.45,260.45,260.45,260.45,2.95,2.95,2,52.09,30
,20130715,260.45,260.45,,,,260.9,260.9,0.45,0.45,0,0,30
,20130716,260.9,260.9,,,,260,260,-0.9,-0.9,0,0,30
,20130717,260,260,,,,262.25,262.25,2.25,2.25,0,0,30
,20130718,262.25,262.25,,,,259.8,259.8,-2.45,-2.45,0,0,30
,20130719,259.8,259.8,,,,260.45,260.45,0.65,0.65,0,0,30
,20130722,260.45,260.45,262.2,264.55,262.2,264.1,263.6,3.65,3.15,6,158.17,30
,20130723,264.1,263.6,,,,267.3,267.3,3.7,3.7,0,0,30
,20130724,267.3,267.3,266.9,267.2,266.75,266.95,266.9,-0.35,-0.4,18,480.47,34
,20130725,266.95,266.9,,,,264.9,264.9,-2,-2,0,0,34
,20130726,264.9,264.9,265.85,267.4,265.3,266.8,266.4,1.9,1.5,28,746.03,32
,20130729,266.8,266.4,,,,264.2,264.2,-2.2,-2.2,0,0,32
,20130730,264.2,264.2,264.55,264.55,264.55,264.55,264.55,0.35,0.35,2,52.91,34
,20130731,264.55,264.55,266.3,266.3,266.15,266.15,266.2,1.6,1.65,6,159.74,34
,20130801,266.15,266.2,262.8,264.1,262.2,264.05,263.3,-2.15,-2.9,16,421.28,26
,20130802,264.05,263.3,261.95,261.95,257.85,257.85,259.9,-5.45,-3.4,4,103.96,26
,20130805,257.85,259.9,264.2,264.2,263.45,263.45,263.8,3.55,3.9,4,105.53,26
,20130806,263.45,263.8,261.7,262.05,261.7,262.05,261.85,-1.75,-1.95,4,104.75,26
,20130807,262.05,261.85,257.2,257.2,257.2,257.2,257.2,-4.65,-4.65,2,51.44,24
,20130808,257.2,257.2,257.25,258,257.25,258,257.7,0.8,0.5,6,154.64,26
,20130809,258,257.7,261.15,261.45,261.15,261.45,261.3,3.75,3.6,4,104.52,30
,20130812,261.45,261.3,264.75,264.75,264.75,264.75,264.75,3.45,3.45,4,105.9,26
,20130813,264.75,264.75,268.9,268.9,266.5,267.05,268.2,2.3,3.45,64,"1,716.62",64
,20130814,267.05,268.2,266.1,266.1,266.1,266.1,266.1,-2.1,-2.1,6,159.66,64
,20130815,266.1,266.1,266.5,268.65,266.5,268.35,267.8,2.25,1.7,6,160.7,62
,20130816,268.35,267.8,265.45,273.6,265.45,273.6,270.3,5.8,2.5,10,270.34,60
,20130819,273.6,270.3,273.1,276,272.95,276,273.95,5.7,3.65,20,547.91,58
,20130820,276,273.95,273.45,274.1,273.2,273.2,273.45,-0.75,-0.5,8,218.79,58
,20130821,273.2,273.45,,,,274.45,274.45,1,1,0,0,58
,20130822,274.45,274.45,272.35,272.55,272.35,272.55,272.45,-1.9,-2,12,326.97,54
,20130823,272.55,272.45,274.75,274.75,274.75,274.75,274.75,2.3,2.3,26,714.35,30
,20130826,274.75,274.75,,,,279.25,279.25,4.5,4.5,0,0,30
,20130827,279.25,279.25,278.55,279.25,278.55,279.25,278.7,0,-0.55,8,222.98,32
,20130828,279.25,278.7,282.6,282.6,282.4,282.4,282.5,3.7,3.8,6,169.51,30
,20130829,282.4,282.5,281.15,281.15,281.05,281.05,281.1,-1.45,-1.4,8,224.9,28
,20130830,281.05,281.1,281.15,281.15,280.5,280.5,280.7,-0.6,-0.4,6,168.43,28
,20130902,280.5,280.7,277,278,277,278,277.5,-2.7,-3.2,8,222,30
,20130903,278,277.5,278.35,278.35,278.35,278.35,278.35,0.85,0.85,2,55.67,32
,20130904,278.35,278.35,282.15,282.15,281.75,281.75,281.95,3.4,3.6,4,112.78,32
,20130905,281.75,281.95,277.1,277.1,277.1,277.1,277.1,-4.85,-4.85,4,110.84,36
,20130906,277.1,277.1,273.85,274.1,273.85,274.1,273.95,-3,-3.15,4,109.59,36
,20130909,274.1,273.95,,,,273.95,273.95,0,0,0,0,36
,20130910,273.95,273.95,275.05,275.1,275.05,275.1,275.05,1.15,1.1,6,165.05,34
,20130911,275.1,275.05,271.85,271.85,271.15,271.15,271.65,-3.9,-3.4,8,217.34,32
,20130912,271.15,271.65,269,269,269,269,269,-2.65,-2.65,2,53.8,34
,20130913,269,269,,,,269,269,0,0,0,0,34
,20130916,269,269,264.45,265.65,264.45,265.5,265.2,-3.5,-3.8,6,159.12,34
,20130917,265.5,265.2,262.45,262.45,262.3,262.3,262.35,-2.9,-2.85,4,104.95,32
,20130918,262.3,262.35,262.1,262.1,262.1,262.1,262.1,-0.25,-0.25,2,52.42,30
,20130923,262.1,262.1,,,,264.9,264.9,2.8,2.8,0,0,30
,20130924,264.9,264.9,,,,265.55,265.55,0.65,0.65,0,0,30
,20130925,265.55,265.55,265.55,265.55,262.4,264.4,263.55,-1.15,-2,10,263.57,34
,20130926,264.4,263.55,264.95,266.9,264.95,266.4,266.25,2.85,2.7,14,372.77,36
,20130927,266.4,266.25,266.85,266.85,264.7,264.7,265.5,-1.55,-0.75,6,159.31,38
,20130930,264.7,265.5,266.85,266.85,266.85,266.85,266.85,1.35,1.35,2,53.37,36
,20131008,266.85,266.85,,,,265.1,265.1,-1.75,-1.75,0,0,36
,20131009,265.1,265.1,,,,263.9,263.9,-1.2,-1.2,0,0,36
,20131010,263.9,263.9,259.95,261.85,259.95,261.85,260.8,-2.05,-3.1,16,417.31,38
,20131011,261.85,260.8,,,,259.1,259.1,-1.7,-1.7,0,0,38
,20131014,259.1,259.1,254.95,256.9,254.95,256.9,255.85,-2.2,-3.25,12,307.04,40
,20131015,256.9,255.85,257.5,257.5,257.5,257.5,257.5,1.65,1.65,2,51.5,40
,20131016,257.5,257.5,255,256.75,255,256.75,255.85,-0.75,-1.65,4,102.35,36
,20131017,256.75,255.85,257,257,255.6,256.1,256.3,0.25,0.45,10,256.3,38
,20131018,256.1,256.3,262.65,263.75,262.6,262.85,263,6.55,6.7,18,473.41,36
,20131021,262.85,263,263.1,263.15,263.1,263.15,263.1,0.15,0.1,4,105.25,36
,20131022,263.15,263.1,262.85,262.85,262.7,262.7,262.75,-0.4,-0.35,4,105.11,34
,20131023,262.7,262.75,266.85,266.85,266.85,266.85,266.85,4.1,4.1,2,53.37,32
,20131024,266.85,266.85,,,,266.35,266.35,-0.5,-0.5,0,0,32
,20131025,266.35,266.35,265.9,266.45,265.9,266.45,266.15,0.1,-0.2,4,106.47,32
,20131028,266.45,266.15,266.6,266.6,266.6,266.6,266.6,0.45,0.45,2,53.32,32
,20131029,266.6,266.6,266.8,266.85,266.7,266.7,266.75,0.1,0.15,6,160.07,32
,20131030,266.7,266.75,,,,266.1,266.1,-0.65,-0.65,0,0,32
,20131031,266.1,266.1,268.6,268.6,268.6,268.6,268.6,2.5,2.5,2,53.72,32
,20131101,268.6,268.6,263.2,263.2,262.7,262.7,263.05,-5.9,-5.55,30,789.15,42
,20131104,262.7,263.05,262.5,262.5,261.1,261.65,261.7,-1.4,-1.35,14,366.41,44
,20131105,261.65,261.7,262.9,262.9,262.9,262.9,262.9,1.2,1.2,2,52.58,44
,20131106,262.9,262.9,260.65,260.65,260.4,260.4,260.4,-2.5,-2.5,26,677.14,52
,20131107,260.4,260.4,261.05,261.05,261.05,261.05,261.05,0.65,0.65,2,52.21,50
,20131108,261.05,261.05,260,260,259.05,259.75,259.4,-1.3,-1.65,16,415.1,56
,20131111,259.75,259.4,258.55,258.55,255.65,255.95,257.45,-3.45,-1.95,10,257.45,50
,20131112,255.95,257.45,255.35,255.35,254.1,254.1,254.65,-3.35,-2.8,14,356.57,52
,20131113,254.1,254.65,,,,254.65,254.65,0,0,0,0,52
,20131114,254.65,254.65,255.9,255.9,255.75,255.75,255.8,1.1,1.15,4,102.33,50
,20131115,255.75,255.8,,,,255.9,255.9,0.1,0.1,0,0,50
,20131118,255.9,255.9,,,,255.9,255.9,0,0,0,0,50
,20131119,255.9,255.9,253.2,253.6,253.2,253.6,253.4,-2.3,-2.5,4,101.36,54
,20131120,253.6,253.4,253.35,253.35,253.35,253.35,253.35,-0.05,-0.05,2,50.67,52
,20131121,253.35,253.35,248.9,249.55,248.9,249.35,249.25,-4,-4.1,8,199.43,56
,20131122,249.35,249.25,249.1,249.1,248.8,249,248.9,-0.25,-0.35,34,846.39,78
,20131125,249,248.9,248.4,248.4,248.4,248.4,248.4,-0.5,-0.5,2,49.68,80
,20131126,248.4,248.4,245.95,250.1,245.95,250.1,249.15,1.7,0.75,24,598.02,70
,20131127,250.1,249.15,249.2,249.2,247.95,247.95,248.85,-1.2,-0.3,8,199.11,68
,20131128,247.95,248.85,249.55,249.65,247.15,247.15,247.8,-1.7,-1.05,34,842.58,78
,20131129,247.15,247.8,247.7,248,247.4,247.55,247.65,-0.25,-0.15,34,842.02,98
,20131202,247.55,247.65,249.1,249.5,247.9,248.45,248.6,0.8,0.95,64,"1,591.06",88
,20131203,248.45,248.6,246.85,247.15,244.15,244.2,245.55,-4.4,-3.05,88,"2,161.17",126
,20131204,244.2,245.55,244.3,244.9,244.3,244.4,244.45,-1.15,-1.1,10,244.47,124
,20131205,244.4,244.45,245.6,248.85,245.6,246.8,246.6,2.35,2.15,46,"1,134.48",124
,20131206,246.8,246.6,244.5,244.6,244.5,244.6,244.55,-2,-2.05,8,195.64,124
,20131209,244.6,244.55,245.65,245.65,244.65,245.05,245,0.5,0.45,10,245.02,126
,20131210,245.05,245,246.25,246.25,246.25,246.25,246.25,1.25,1.25,2,49.25,128
,20131211,246.25,246.25,247.2,249.15,247.2,249.1,248.75,2.85,2.5,16,398.03,126
,20131212,249.1,248.75,248,248.4,247.45,248.4,248.1,-0.35,-0.65,10,248.1,126
,20131213,248.4,248.1,,,,242.95,242.95,-5.15,-5.15,0,0,126
,20131216,242.95,242.95,244.05,244.05,243.9,243.9,243.95,0.95,1,4,97.59,128
,20131217,243.9,243.95,246.6,246.6,244.35,246,245.6,2.05,1.65,16,393,130
,20131218,246,245.6,243.65,243.9,243.65,243.85,243.8,-1.75,-1.8,8,195.04,128
,20131219,243.85,243.8,240.8,241.35,240.8,241.35,241.15,-2.45,-2.65,14,337.64,130
,20131220,241.35,241.15,238.5,238.5,236.45,236.95,237.45,-4.2,-3.7,58,"1,377.41",138
,20131223,236.95,237.45,236,238.2,236,238.1,237.1,0.65,-0.35,50,"1,185.52",148
,20131224,238.1,237.1,238.55,238.55,237.5,237.5,238,0.4,0.9,16,380.85,144
,20131225,237.5,238,238.45,239.45,238.45,239.2,239,1.2,1,38,908.22,152
,20131226,239.2,239,239,239.05,238.6,239.05,238.9,0.05,-0.1,14,334.46,148
,20131227,239.05,238.9,237.3,240.9,237.3,240.45,240.2,1.55,1.3,18,432.38,146
,20131230,240.45,240.2,241.75,241.75,239.35,239.35,240.2,-0.85,0,10,240.24,146
,20131231,239.35,240.2,238.55,239.35,237.35,238.05,238.4,-2.15,-1.8,44,"1,049.17",150
au1404,20130416,302.66,302.66,272.39,279.99,272.39,278.25,274.99,-24.41,-27.67,48,"1,319.97",14
,20130417,278.25,274.99,278.49,280.09,277.29,277.91,278.5,2.92,3.51,16,445.61,18
,20130418,277.91,278.5,,,,277.16,277.16,-1.34,-1.34,0,0,18
,20130419,277.16,277.16,278.59,288.03,278.59,284.82,283.43,7.66,6.27,26,736.92,26
,20130422,284.82,283.43,287,287.89,286.22,287.89,286.86,4.46,3.43,10,286.87,30
,20130423,287.89,286.86,287.68,287.68,285.11,285.11,286.82,-1.75,-0.04,6,172.09,28
,20130424,285.11,286.82,,,,285.45,285.45,-1.37,-1.37,0,0,28
,20130425,285.45,285.45,289.22,291.27,289.22,290.55,289.99,5.1,4.54,26,753.98,40
,20130426,290.55,289.99,301.13,301.13,298.6,298.6,299.59,8.61,9.6,10,299.59,34
,20130502,298.6,299.59,290.6,291.8,290.6,291.79,291.61,-7.8,-7.98,16,466.59,30
,20130503,291.79,291.61,,,,295.93,295.93,4.32,4.32,0,0,30
,20130506,295.93,295.93,295.33,295.86,295.33,295.86,295.59,-0.07,-0.34,4,118.24,32
,20130507,295.86,295.59,,,,291.97,291.97,-3.62,-3.62,0,0,32
,20130508,291.97,291.97,,,,288.38,288.38,-3.59,-3.59,0,0,32
,20130509,288.38,288.38,294.85,294.85,293,293.45,293.85,5.07,5.47,26,764.02,32
,20130510,293.45,293.85,290.11,292.23,290.11,292.23,291.04,-1.62,-2.81,8,232.83,30
,20130513,292.23,291.04,285.09,285.79,285.09,285.79,285.44,-5.25,-5.6,4,114.18,28
,20130514,285.79,285.44,288.05,288.68,287.01,287.41,287.66,1.97,2.22,104,"2,991.76",44
,20130515,287.41,287.66,285.71,286.7,283.4,283.4,286.08,-4.26,-1.58,32,915.48,48
,20130516,283.4,286.08,280.5,280.76,280.02,280.02,280.42,-6.06,-5.66,12,336.51,46
,20130517,280.02,280.42,280.02,280.02,280.02,280.02,280.02,-0.4,-0.4,2,56,46
,20130520,280.02,280.02,272.77,272.99,272.22,272.22,272.74,-7.8,-7.28,8,218.19,46
,20130521,272.22,272.74,279.77,282,279,281.3,280.12,8.56,7.38,24,672.3,46
,20130522,281.3,280.12,279.17,279.17,278.58,278.58,278.92,-1.54,-1.2,12,334.71,46
,20130523,278.58,278.92,274.61,275.43,274.61,275.2,275.08,-3.72,-3.84,6,165.05,46
,20130524,275.2,275.08,280.53,281,279.4,281,280.12,5.92,5.04,44,"1,232.55",54
,20130527,281,280.12,280.66,280.99,280.5,280.99,280.86,0.87,0.74,18,505.55,50
,20130528,280.99,280.86,279.51,279.51,279.51,279.51,279.51,-1.35,-1.35,2,55.9,50
,20130529,279.51,279.51,279.34,279.78,278.86,278.86,279.44,-0.65,-0.07,8,223.55,48
,20130530,278.86,279.44,283,284.51,283,284.51,283.75,5.07,4.31,4,113.5,46
,20130531,284.51,283.75,284.26,286.05,284.26,285.54,284.95,1.79,1.2,16,455.93,44
,20130603,285.54,284.95,282.45,282.45,280.9,281.21,281.37,-3.74,-3.58,8,225.1,44
,20130604,281.21,281.37,284.36,284.36,284.36,284.36,284.36,2.99,2.99,2,56.87,42
,20130605,284.36,284.36,281.02,281.02,281,281,281.01,-3.36,-3.35,6,168.61,42
,20130606,281,281.01,,,,280.06,280.06,-0.95,-0.95,0,0,42
,20130607,280.06,280.06,,,,283.08,283.08,3.02,3.02,0,0,42
,20130613,283.08,283.08,279.69,281.34,278.49,281.34,279.84,-1.74,-3.24,6,167.9,42
,20130614,281.34,279.84,278.66,278.66,278.66,278.66,278.66,-1.18,-1.18,4,111.46,44
,20130617,278.66,278.66,280.17,280.17,279,279.07,279.25,0.41,0.59,14,390.96,46
,20130618,279.07,279.25,,,,277.68,277.68,-1.57,-1.57,0,0,46
,20130619,277.68,277.68,,,,275.4,275.4,-2.28,-2.28,0,0,46
,20130620,275.4,275.4,270.73,270.73,270.7,270.7,270.71,-4.7,-4.69,4,108.29,46
,20130621,270.7,270.71,257.17,257.17,257.17,257.17,257.17,-13.54,-13.54,2,51.43,44
,20130624,257.17,257.17,262.73,262.73,262.73,262.73,262.73,5.56,5.56,8,210.18,40
,20130625,262.75,262.75,258.7,260.5,258.7,260.5,259.6,-2.25,-3.15,4,103.84,38
,20130626,260.5,259.6,,,,253.4,253.4,-6.2,-6.2,0,0,38
,20130627,253.4,253.4,251.35,251.6,251.35,251.6,251.45,-1.8,-1.95,4,100.59,36
,20130628,251.6,251.45,241.3,244.7,241.3,244.7,243.4,-6.75,-8.05,6,146.04,36
,20130701,244.7,243.4,252,252,252,252,252,8.6,8.6,2,50.4,34
,20130702,252,252,256.25,256.25,256.25,256.25,256.25,4.25,4.25,2,51.25,32
,20130703,256.25,256.25,,,,254.25,254.25,-2,-2,0,0,32
,20130704,254.25,254.25,,,,241.55,241.55,-12.7,-12.7,0,0,32
,20130705,241.55,241.55,253.4,253.45,253.4,253.45,253.4,11.9,11.85,4,101.37,30
,20130708,253.45,253.4,247.2,247.2,246.9,246.9,247.1,-6.5,-6.3,6,148.26,30
,20130709,246.9,247.1,250.05,255,250.05,255,252.15,7.9,5.05,12,302.58,30
,20130710,255,252.15,253.3,254.05,251.65,252.75,253,0.6,0.85,14,354.23,32
,20130711,252.75,253,253.8,262.35,253.8,262.35,257.45,9.35,4.45,26,669.49,36
,20130712,262.35,257.45,260,261.8,259.25,259.9,260,2.45,2.55,16,416.06,28
,20130715,259.9,260,260,260.4,260,260.4,260.2,0.4,0.2,4,104.08,28
,20130716,260.4,260.2,,,,259.3,259.3,-0.9,-0.9,0,0,28
,20130717,259.3,259.3,,,,261.55,261.55,2.25,2.25,0,0,28
,20130718,261.55,261.55,257.6,257.6,257.6,257.6,257.6,-3.95,-3.95,2,51.52,26
,20130719,257.6,257.6,258.9,258.9,258.9,258.9,258.9,1.3,1.3,2,51.78,28
,20130722,258.9,258.9,262.05,264.4,262.05,264.4,263.45,5.5,4.55,8,210.79,26
,20130723,264.4,263.45,267.85,267.85,267.85,267.85,267.85,4.4,4.4,2,53.57,24
,20130724,267.85,267.85,266.8,268.6,266.8,268.6,267.45,0.75,-0.4,6,160.49,24
,20130725,268.6,267.45,,,,265.4,265.4,-2.05,-2.05,0,0,24
,20130726,265.4,265.4,,,,266.9,266.9,1.5,1.5,0,0,24
,20130729,266.9,266.9,263.85,264.75,263.85,264.65,264.4,-2.25,-2.5,6,158.65,24
,20130730,264.65,264.4,265.2,265.2,265.2,265.2,265.2,0.8,0.8,2,53.04,24
,20130731,265.2,265.2,265.7,265.7,265.7,265.7,265.7,0.5,0.5,2,53.14,24
,20130801,265.7,265.7,261.5,261.85,261.5,261.85,261.65,-3.85,-4.05,4,104.67,24
,20130802,261.85,261.65,,,,258.25,258.25,-3.4,-3.4,0,0,24
,20130805,258.25,258.25,263,263.4,262.95,263.4,263.1,5.15,4.85,6,157.87,24
,20130806,263.4,263.1,260.1,260.1,259.3,259.8,259.7,-3.3,-3.4,6,155.84,24
,20130807,259.8,259.7,257.4,258.25,255.9,256.9,257.2,-2.8,-2.5,16,411.57,26
,20130808,256.9,257.2,,,,257.7,257.7,0.5,0.5,0,0,26
,20130809,257.7,257.7,,,,261.3,261.3,3.6,3.6,0,0,26
,20130812,261.3,261.3,,,,264.75,264.75,3.45,3.45,0,0,26
,20130813,264.75,264.75,,,,268.2,268.2,3.45,3.45,0,0,26
,20130814,268.2,268.2,264.8,264.8,264.8,264.8,264.8,-3.4,-3.4,2,52.96,26
,20130815,264.8,264.8,264.9,264.9,264.9,264.9,264.9,0.1,0.1,2,52.98,24
,20130816,264.9,264.9,,,,267.4,267.4,2.5,2.5,0,0,24
,20130819,267.4,267.4,254,276.55,254,274.4,272.9,7,5.5,74,"2,019.63",24
,20130820,274.4,272.9,272.5,273.2,270.8,270.8,272.05,-2.1,-0.85,40,"1,088.21",44
,20130821,270.8,272.05,,,,273.05,273.05,1,1,0,0,44
,20130822,273.05,273.05,271.8,272.45,271.8,272.35,271.95,-0.7,-1.1,18,489.52,42
,20130823,272.35,271.95,,,,274.2,274.2,2.25,2.25,0,0,42
,20130826,274.2,274.2,279.1,280.1,279.1,280.1,279.6,5.9,5.4,4,111.84,40
,20130827,280.1,279.6,279.05,279.05,279.05,279.05,279.05,-0.55,-0.55,2,55.81,40
,20130828,279.05,279.05,,,,282.85,282.85,3.8,3.8,0,0,40
,20130829,282.85,282.85,282.8,282.8,282.8,282.8,282.8,-0.05,-0.05,2,56.56,40
,20130830,282.8,282.8,280.65,280.65,280.65,280.65,280.65,-2.15,-2.15,4,112.26,44
,20130902,280.65,280.65,280.65,280.65,280.65,280.65,280.65,0,0,2,56.13,42
,20130903,280.65,280.65,278.9,278.9,278.9,278.9,278.9,-1.75,-1.75,4,111.56,42
,20130904,278.9,278.9,282.8,283,281.75,281.75,282.6,2.85,3.7,8,226.11,44
,20130905,281.75,282.6,277.75,277.95,277.65,277.95,277.75,-4.65,-4.85,8,222.2,40
,20130906,277.95,277.75,,,,277.75,277.75,0,0,0,0,40
,20130909,277.75,277.75,,,,277.75,277.75,0,0,0,0,40
,20130910,277.75,277.75,,,,277.75,277.75,0,0,0,0,40
,20130911,277.75,277.75,272.75,272.75,272.35,272.35,272.55,-5.4,-5.2,4,109.02,40
,20130912,272.35,272.55,273.35,273.35,271.95,271.95,272.65,-0.6,0.1,4,109.06,42
,20130913,271.95,272.65,265.95,266.75,265.95,266.75,266.4,-5.9,-6.25,18,479.6,50
,20130916,266.75,266.4,264.45,266.25,264.45,266.25,264.85,-0.15,-1.55,10,264.88,54
,20130917,266.25,264.85,,,,262,262,-2.85,-2.85,0,0,54
,20130918,262,262,259.65,259.85,259,259.85,259.5,-2.15,-2.5,6,155.7,48
,20130923,259.85,259.5,,,,262.3,262.3,2.8,2.8,0,0,48
,20130924,262.3,262.3,265.55,265.9,265.35,265.9,265.55,3.6,3.25,10,265.55,44
,20130925,265.9,265.55,262.75,262.75,262.75,262.75,262.75,-2.8,-2.8,2,52.55,44
,20130926,262.75,262.75,266.85,266.85,265.95,266.35,266.35,3.6,3.6,18,479.47,34
,20130927,266.35,266.35,265.2,265.2,265.1,265.1,265.15,-1.25,-1.2,4,106.06,30
,20130930,265.1,265.15,,,,266.45,266.45,1.3,1.3,0,0,30
,20131008,266.45,266.45,265.3,265.3,265.3,265.3,265.3,-1.15,-1.15,4,106.12,30
,20131009,265.3,265.3,264.05,264.05,263.9,263.9,263.95,-1.4,-1.35,4,105.59,32
,20131010,263.9,263.95,262.45,262.45,260.05,261.15,261.05,-2.8,-2.9,8,208.85,32
,20131011,261.15,261.05,,,,259.35,259.35,-1.7,-1.7,0,0,32
,20131014,259.35,259.35,254.4,255.1,253.4,255.1,253.95,-4.25,-5.4,36,914.29,22
,20131015,255.1,253.95,256.95,257.35,255.1,255.1,256.45,1.15,2.5,6,153.88,16
,20131016,255.1,256.45,256.3,257.15,256.3,257.15,256.7,0.7,0.25,6,154.03,16
,20131017,257.15,256.7,255.1,255.5,254.95,255.5,255.15,-1.2,-1.55,6,153.11,14
,20131018,255.5,255.15,263.5,263.7,262.5,263.7,263.15,8.55,8,10,263.16,16
,20131021,263.7,263.15,262.8,262.8,262.5,262.5,262.65,-0.65,-0.5,6,157.6,16
,20131022,262.5,262.65,262.45,262.45,262.45,262.45,262.45,-0.2,-0.2,4,104.98,16
,20131023,262.45,262.45,,,,266.5,266.5,4.05,4.05,0,0,16
,20131024,266.5,266.5,,,,266,266,-0.5,-0.5,0,0,16
,20131025,266,266,,,,265.8,265.8,-0.2,-0.2,0,0,16
,20131028,265.8,265.8,,,,266.2,266.2,0.4,0.4,0,0,16
,20131029,266.2,266.2,,,,266.35,266.35,0.15,0.15,0,0,16
,20131030,266.35,266.35,,,,265.75,265.75,-0.6,-0.6,0,0,16
,20131031,265.75,265.75,264.25,264.55,264.25,264.55,264.4,-1.2,-1.35,6,158.64,20
,20131101,264.55,264.4,263.4,263.4,263.4,263.4,263.4,-1,-1,2,52.68,20
,20131104,263.4,263.4,261.2,261.5,261.2,261.5,261.35,-1.9,-2.05,4,104.54,18
,20131105,261.5,261.35,262.15,262.15,262.15,262.15,262.15,0.8,0.8,2,52.43,16
,20131106,262.15,262.15,,,,259.65,259.65,-2.5,-2.5,0,0,16
,20131107,259.65,259.65,,,,260.25,260.25,0.6,0.6,0,0,16
,20131108,260.25,260.25,259.2,260,259.2,260,259.65,-0.25,-0.6,10,259.66,14
,20131111,260,259.65,255.85,255.85,255.85,255.85,255.85,-3.8,-3.8,6,153.51,20
,20131112,255.85,255.85,,,,253.1,253.1,-2.75,-2.75,0,0,20
,20131113,253.1,253.1,255.3,255.3,255.3,255.3,255.3,2.2,2.2,6,153.18,22
,20131114,255.3,255.3,254.35,255.9,254.15,255.85,255,0.55,-0.3,14,357.06,20
,20131115,255.85,255,256.35,256.35,256.35,256.35,256.35,1.35,1.35,4,102.54,16
,20131118,256.35,256.35,256.35,256.35,255.15,255.9,255.8,-0.45,-0.55,6,153.48,18
,20131119,255.9,255.8,254.65,254.65,254.65,254.65,254.65,-1.15,-1.15,2,50.93,18
,20131120,254.65,254.65,,,,254.55,254.55,-0.1,-0.1,0,0,18
,20131121,254.55,254.55,249.1,249.1,249.1,249.1,249.1,-5.45,-5.45,4,99.64,18
,20131122,249.1,249.1,,,,248.75,248.75,-0.35,-0.35,0,0,18
,20131125,248.75,248.75,,,,248.25,248.25,-0.5,-0.5,0,0,18
,20131126,248.25,248.25,245.6,245.6,245.6,245.6,245.6,-2.65,-2.65,2,49.12,18
,20131127,245.6,245.6,249.1,249.1,248.9,248.9,249,3.3,3.4,6,149.42,16
,20131128,248.9,249,,,,247.95,247.95,-1.05,-1.05,0,0,16
,20131129,247.95,247.95,248.35,248.4,247.8,247.8,248.05,-0.15,0.1,14,347.3,22
,20131202,247.8,248.05,249.7,250.05,248.3,248.3,249.55,0.25,1.5,14,349.42,30
,20131203,248.3,249.55,244.9,245.3,244.4,244.4,244.65,-5.15,-4.9,16,391.51,36
,20131204,244.4,244.65,244.4,244.45,244.4,244.45,244.4,-0.2,-0.25,4,97.77,36
,20131205,244.45,244.4,245.5,247.75,245.5,247.55,247.25,3.15,2.85,12,296.75,44
,20131206,247.55,247.25,242.9,246,242.9,244.9,244.45,-2.35,-2.8,10,244.46,46
,20131209,244.9,244.45,,,,244.9,244.9,0.45,0.45,0,0,46
,20131210,244.9,244.9,,,,246.7,246.7,1.8,1.8,0,0,46
,20131211,246.7,246.7,250.2,251.2,249.4,249.4,250.15,2.7,3.45,24,600.46,48
,20131212,249.4,250.15,,,,249.45,249.45,-0.7,-0.7,0,0,48
,20131213,249.45,249.45,245.65,245.65,243.65,243.75,244.1,-5.7,-5.35,10,244.11,40
,20131216,243.75,244.1,,,,244.1,244.1,0,0,0,0,40
,20131217,244.1,244.1,247.05,247.05,247,247,247,2.9,2.9,4,98.81,44
,20131218,247,247,,,,245.5,245.5,-1.5,-1.5,0,0,44
,20131219,245.5,245.5,242.25,242.75,242.25,242.75,242.4,-2.75,-3.1,6,145.45,46
,20131220,242.75,242.4,239.8,239.9,239.05,239.05,239.45,-3.35,-2.95,8,191.56,48
,20131223,239.05,239.45,238.05,238.75,238.05,238.75,238.4,-0.7,-1.05,4,95.36,46
,20131224,238.75,238.4,238.5,238.5,238.5,238.5,238.5,0.1,0.1,4,95.4,50
,20131225,238.5,238.5,239.5,239.5,239.5,239.5,239.5,1,1,4,95.8,46
,20131226,239.5,239.5,,,,239.5,239.5,0,0,0,0,46
,20131227,239.5,239.5,241.8,241.8,241.35,241.55,241.55,2.05,2.05,8,193.26,50
,20131230,241.55,241.55,241.75,242.75,239.9,239.9,241.3,-1.65,-0.25,18,434.42,62
,20131231,239.9,241.3,239.35,239.35,239.25,239.25,239.3,-2.05,-2,4,95.72,60
au1405,20130516,286.08,286.08,274.34,274.34,274.34,274.34,274.34,-11.74,-11.74,2,54.87,2
,20130517,274.34,274.34,278,280.38,274.27,280.38,277.55,6.04,3.21,6,166.53,4
,20130520,280.38,277.55,,,,270.33,270.33,-7.22,-7.22,0,0,4
,20130521,270.33,270.33,,,,277.64,277.64,7.31,7.31,0,0,4
,20130522,277.64,277.64,,,,277.64,277.64,0,0,0,0,4
,20130523,277.64,277.64,,,,273.81,273.81,-3.83,-3.83,0,0,4
,20130524,273.81,273.81,,,,278.83,278.83,5.02,5.02,0,0,4
,20130527,278.83,278.83,279.07,279.07,279.05,279.05,279.06,0.22,0.23,4,111.62,6
,20130528,279.05,279.06,279.79,279.79,279.79,279.79,279.79,0.73,0.73,2,55.96,8
,20130529,279.79,279.79,,,,279.71,279.71,-0.08,-0.08,0,0,8
,20130530,279.71,279.71,,,,280.03,280.03,0.32,0.32,0,0,8
,20130531,280.03,280.03,,,,281.22,281.22,1.19,1.19,0,0,8
,20130603,281.22,281.22,279.67,281.43,279.67,281.43,280.55,0.21,-0.67,4,112.22,8
,20130604,281.43,280.55,,,,283.53,283.53,2.98,2.98,0,0,8
,20130605,283.53,283.53,,,,280.19,280.19,-3.34,-3.34,0,0,8
,20130606,280.19,280.19,,,,279.25,279.25,-0.94,-0.94,0,0,8
,20130607,279.25,279.25,278.61,283.63,278.61,283.54,282.12,4.29,2.87,8,225.7,8
,20130613,283.54,282.12,279.63,279.63,279.63,279.63,279.63,-2.49,-2.49,2,55.93,8
,20130614,279.63,279.63,278.82,278.99,278.62,278.62,278.83,-1.01,-0.8,8,223.07,8
,20130617,278.62,278.83,280.26,280.26,279.8,280.1,280.08,1.27,1.25,8,224.07,10
,20130618,280.1,280.08,277.47,277.48,276.93,277.22,277.24,-2.86,-2.84,10,277.24,10
,20130619,277.22,277.24,275.53,275.53,275.53,275.53,275.53,-1.71,-1.71,2,55.11,8
,20130620,275.53,275.53,,,,270.84,270.84,-4.69,-4.69,0,0,8
,20130621,270.84,270.84,257.29,262.45,257.29,262.45,260.39,-8.39,-10.45,12,312.47,14
,20130624,262.45,260.39,263.04,263.04,260.96,260.96,262.52,0.57,2.13,8,210.02,18
,20130625,260.95,262.5,,,,259.35,259.35,-3.15,-3.15,0,0,18
,20130626,259.35,259.35,,,,253.15,253.15,-6.2,-6.2,0,0,18
,20130627,253.15,253.15,251.5,251.85,251.5,251.85,251.65,-1.3,-1.5,4,100.67,20
,20130628,251.85,251.65,,,,243.55,243.55,-8.1,-8.1,0,0,20
,20130701,243.55,243.55,252.8,252.8,252.8,252.8,252.8,9.25,9.25,2,50.56,20
,20130702,252.8,252.8,255.45,255.45,255.45,255.45,255.45,2.65,2.65,4,102.18,24
,20130703,255.45,255.45,,,,253.45,253.45,-2,-2,0,0,24
,20130704,253.45,253.45,254.6,255.25,254.6,254.65,254.85,1.2,1.4,18,458.76,30
,20130705,254.65,254.85,,,,267.35,267.35,12.5,12.5,0,0,30
,20130708,267.35,267.35,,,,253.95,253.95,-13.4,-13.4,0,0,30
,20130709,253.95,253.95,250.8,251.05,250.8,251.05,250.95,-2.9,-3,12,301.16,26
,20130710,251.05,250.95,253.05,254.4,250.85,252.5,252.55,1.55,1.6,18,454.66,20
,20130711,252.5,252.55,259,262,258.95,262,259.85,9.45,7.3,14,363.85,22
,20130712,262,259.85,259.55,259.55,259.45,259.45,259.5,-0.4,-0.35,4,103.8,22
,20130715,259.45,259.5,258.45,260.95,258.45,260.75,260.1,1.25,0.6,8,208.1,20
,20130716,260.75,260.1,,,,259.2,259.2,-0.9,-0.9,0,0,20
,20130717,259.2,259.2,,,,261.45,261.45,2.25,2.25,0,0,20
,20130718,261.45,261.45,257.1,258.1,257.05,258.1,257.35,-3.35,-4.1,10,257.37,20
,20130719,258.1,257.35,258,259.2,258,259.2,258.7,1.85,1.35,10,258.72,24
,20130722,259.2,258.7,261.7,264.8,260.25,264.25,262.4,5.55,3.7,22,577.35,24
,20130723,264.25,262.4,267.75,268.6,267.5,267.5,267.95,5.1,5.55,24,643.16,40
,20130724,267.5,267.95,266.8,268.8,265.75,268.3,267.2,0.35,-0.75,26,694.81,32
,20130725,268.3,267.2,264.9,265,264.9,265,264.95,-2.2,-2.25,8,211.96,26
,20130726,265,264.95,265.5,267.35,265.1,267.35,265.95,2.4,1,6,159.59,24
,20130729,267.35,265.95,265.3,265.3,265.3,265.3,265.3,-0.65,-0.65,2,53.06,26
,20130730,265.3,265.3,264.6,264.6,264.6,264.6,264.6,-0.7,-0.7,2,52.92,26
,20130731,264.6,264.6,263.55,263.55,263.55,263.55,263.55,-1.05,-1.05,2,52.71,28
,20130801,263.55,263.55,,,,259.55,259.55,-4,-4,0,0,28
,20130802,259.55,259.55,262,262,257.65,258,259.15,-1.55,-0.4,14,362.87,28
,20130805,258,259.15,262.8,263.1,262.8,262.95,262.9,3.8,3.75,8,210.33,26
,20130806,262.95,262.9,260.85,261.05,260.85,261.05,260.95,-1.85,-1.95,4,104.38,24
,20130807,261.05,260.95,,,,258.45,258.45,-2.5,-2.5,0,0,24
,20130808,258.45,258.45,256.15,258.4,256.15,258.3,257,-0.15,-1.45,20,514.02,22
,20130809,258.3,257,,,,260.55,260.55,3.55,3.55,0,0,22
,20130812,260.55,260.55,,,,263.95,263.95,3.4,3.4,0,0,22
,20130813,263.95,263.95,,,,267.4,267.4,3.45,3.45,0,0,22
,20130814,267.4,267.4,,,,264,264,-3.4,-3.4,0,0,22
,20130815,264,264,,,,264.05,264.05,0.05,0.05,0,0,22
,20130816,264.05,264.05,265.4,274.1,265.4,272.85,271.6,8.8,7.55,10,271.63,22
,20130819,272.85,271.6,,,,277.2,277.2,5.6,5.6,0,0,22
,20130820,277.2,277.2,274.5,274.6,272.85,273.1,274,-4.1,-3.2,42,"1,150.99",18
,20130821,273.1,274,273.5,275,272.95,274.5,273.65,0.5,-0.35,22,602.11,16
,20130822,274.5,273.65,272.3,273.35,272.3,273.25,272.8,-0.4,-0.85,8,218.25,20
,20130823,273.25,272.8,274.3,275.25,273.65,274.8,274.45,2,1.65,38,"1,043.03",18
,20130826,274.8,274.45,274.5,279.6,274.1,279.15,277.65,4.7,3.2,12,333.22,16
,20130827,279.15,277.65,278.65,279.1,278.65,279.1,278.9,1.45,1.25,6,167.35,18
,20130828,279.1,278.9,282.95,284.45,282.95,284.45,283.35,5.55,4.45,26,736.77,18
,20130829,284.45,283.35,281.2,281.2,281.05,281.05,281.1,-2.3,-2.25,4,112.45,14
,20130830,281.05,281.1,281.4,281.95,281.4,281.95,281.65,0.85,0.55,4,112.67,14
,20130902,281.95,281.65,,,,281.65,281.65,0,0,0,0,14
,20130903,281.65,281.65,,,,279.85,279.85,-1.8,-1.8,0,0,14
,20130904,279.85,279.85,282,282,281.95,281.95,281.95,2.1,2.1,4,112.79,14
,20130905,281.95,281.95,277.9,277.9,277.5,277.5,277.7,-4.45,-4.25,8,222.16,16
,20130906,277.5,277.7,277.15,277.3,272.35,273.25,274.85,-4.45,-2.85,12,329.85,12
,20130909,273.25,274.85,276,276.65,276,276.65,276.3,1.8,1.45,4,110.53,12
,20130910,276.65,276.3,,,,277.4,277.4,1.1,1.1,0,0,12
,20130911,277.4,277.4,,,,272.2,272.2,-5.2,-5.2,0,0,12
,20130912,272.2,272.2,272,272,272,272,272,-0.2,-0.2,2,54.4,12
,20130913,272,272,,,,265.8,265.8,-6.2,-6.2,0,0,12
,20130916,265.8,265.8,264.95,265.75,264.05,264.05,264.9,-1.75,-0.9,18,476.87,10
,20130917,264.05,264.9,263.35,263.85,262.45,262.45,263.2,-2.45,-1.7,6,157.93,10
,20130918,262.45,263.2,,,,260.65,260.65,-2.55,-2.55,0,0,10
,20130923,260.65,260.65,,,,263.45,263.45,2.8,2.8,0,0,10
,20130924,263.45,263.45,,,,266.7,266.7,3.25,3.25,0,0,10
,20130925,266.7,266.7,,,,263.85,263.85,-2.85,-2.85,0,0,10
,20130926,263.85,263.85,265,265,265,265,265,1.15,1.15,2,53,10
,20130927,265,265,,,,263.8,263.8,-1.2,-1.2,0,0,10
,20130930,263.8,263.8,266.8,267.15,266.15,267.15,266.55,3.35,2.75,8,213.25,12
,20131008,267.15,266.55,,,,265.35,265.35,-1.2,-1.2,0,0,12
,20131009,265.35,265.35,264.5,264.5,264,264,264.25,-1.35,-1.1,4,105.7,14
,20131010,264,264.25,260.7,261.15,259.8,261.1,260.55,-3.15,-3.7,12,312.67,18
,20131011,261.1,260.55,,,,258.85,258.85,-1.7,-1.7,0,0,18
,20131014,258.85,258.85,254.85,255.35,254.65,255.35,254.9,-3.5,-3.95,12,305.89,14
,20131015,255.35,254.9,,,,257.4,257.4,2.5,2.5,0,0,14
,20131016,257.4,257.4,256.6,256.6,256.6,256.6,256.6,-0.8,-0.8,2,51.32,16
,20131017,256.6,256.6,256.55,256.55,256.55,256.55,256.55,-0.05,-0.05,2,51.31,16
,20131018,256.55,256.55,262.5,264.2,262.25,264.2,262.8,7.65,6.25,12,315.37,16
,20131021,264.2,262.8,262.65,262.65,262.65,262.65,262.65,-0.15,-0.15,2,52.53,16
,20131022,262.65,262.65,,,,262.45,262.45,-0.2,-0.2,0,0,16
,20131023,262.45,262.45,266.15,267.1,265.45,265.55,266.1,3.1,3.65,78,"2,075.67",16
,20131024,265.55,266.1,265,266.5,265,265.7,265.65,-0.4,-0.45,16,425.05,14
,20131025,265.7,265.65,265,265,265,265,265,-0.65,-0.65,4,106,18
,20131028,265,265,266.9,266.9,264.75,266.5,265.9,1.5,0.9,24,638.21,24
,20131029,266.5,265.9,268.8,268.8,266.5,267.15,267.15,1.25,1.25,30,801.46,36
,20131030,267.15,267.15,266,266.6,265,265.9,265.6,-1.25,-1.55,38,"1,009.40",16
,20131031,265.9,265.6,267.25,267.6,264,264.35,265.75,-1.25,0.15,102,"2,711.04",44
,20131101,264.35,265.75,264,264,262.15,262.25,262.8,-3.5,-2.95,10,262.84,48
,20131104,262.25,262.8,262.05,262.05,260.65,261.7,261.45,-1.1,-1.35,8,209.18,46
,20131105,261.7,261.45,262.75,263.35,261.8,261.9,262.1,0.45,0.65,28,733.88,28
,20131106,261.9,262.1,261.7,261.7,260.55,261.2,261.05,-0.9,-1.05,26,678.76,28
,20131107,261.2,261.05,261.2,262.4,261.2,262.4,261.9,1.35,0.85,14,366.7,24
,20131108,262.4,261.9,265.1,265.1,260.15,260.15,262.05,-1.75,0.15,24,628.95,28
,20131111,260.15,262.05,256.4,258.4,255,255.75,256.45,-6.3,-5.6,18,461.65,36
,20131112,255.75,256.45,255.6,255.6,253.15,254.85,254.7,-1.6,-1.75,88,"2,241.38",64
,20131113,254.85,254.7,255.5,256.3,252.85,253.1,254.2,-1.6,-0.5,190,"4,830.69",54
,20131114,253.1,254.2,255.05,255.65,255.05,255.6,255.1,1.4,0.9,148,"3,775.91",172
,20131115,255.6,255.1,254.55,257.35,254.55,256.05,256.65,0.95,1.55,146,"3,747.56",158
,20131118,256.05,256.65,255.95,256.2,255.9,256.1,256.05,-0.55,-0.6,12,307.29,160
,20131119,256.1,256.05,254.75,256.3,252.25,253.6,254,-2.45,-2.05,76,"1,930.69",150
,20131120,253.6,254,253.6,254.4,253.6,254.4,253.9,0.4,-0.1,26,660.23,150
,20131121,254.4,253.9,251.9,252.9,249.3,249.3,250.25,-4.6,-3.65,90,"2,252.55",176
,20131122,249.3,250.25,249.5,249.5,248,248.75,248.75,-1.5,-1.5,74,"1,840.95",164
,20131125,248.75,248.75,249.8,249.8,246,246.2,247.4,-2.55,-1.35,82,"2,029.05",152
,20131126,246.2,247.4,248.1,250.3,247.05,250.2,249.3,2.8,1.9,90,"2,243.70",132
,20131127,250.2,249.3,248.5,249.55,246.85,248.9,248.7,-0.4,-0.6,82,"2,039.70",98
,20131128,248.9,248.7,249.9,250.3,246.7,247.8,248.4,-0.9,-0.3,114,"2,831.77",108
,20131129,247.8,248.4,249.8,249.8,248,248.05,248.5,-0.35,0.1,96,"2,385.95",70
,20131202,248.05,248.5,249.75,250.3,248.6,249.1,249.7,0.6,1.2,26,649.31,68
,20131203,249.1,249.7,247.65,247.65,244.5,245.15,245.2,-4.55,-4.5,148,"3,629.69",94
,20131204,245.15,245.2,245.5,245.5,244.6,244.6,244.75,-0.6,-0.45,38,930.09,92
,20131205,244.6,244.75,249.5,249.5,244.75,248.2,246.1,3.45,1.35,136,"3,347.08",110
,20131206,248.2,246.1,246.55,247.3,245,246.2,245.75,0.1,-0.35,222,"5,456.51",130
,20131209,246.2,245.75,246.75,248,244,246.55,247,0.8,1.25,140,"3,458.61",110
,20131210,246.55,247,246.7,248.55,246.7,248.55,247.55,1.55,0.55,42,"1,039.77",100
,20131211,248.55,247.55,250.05,251,249.95,250.7,250.3,3.15,2.75,28,700.9,98
,20131212,250.7,250.3,249.5,251.4,249.35,249.8,250.2,-0.5,-0.1,60,"1,501.26",100
,20131213,249.8,250.2,246.15,248.6,243.45,244.6,244.3,-5.6,-5.9,156,"3,811.72",112
,20131216,244.6,244.3,244.9,245.5,243.5,245.2,245.05,0.9,0.75,190,"4,656.25",140
,20131217,245.2,245.05,245.65,248,245.2,247.45,246.7,2.4,1.65,168,"4,144.57",114
,20131218,247.45,246.7,245.5,245.5,244.7,245.15,245.05,-1.55,-1.65,78,"1,911.39",112
,20131219,245.15,245.05,245.5,245.5,242.3,243.5,243.2,-1.55,-1.85,112,"2,724.30",110
,20131220,243.5,243.2,239.9,240.1,237.95,238.5,238.85,-4.7,-4.35,128,"3,057.85",116
,20131223,238.5,238.85,238.55,240.4,236.7,239.55,239.35,0.7,0.5,64,"1,531.98",112
,20131224,239.55,239.35,239.25,239.25,237.95,238.85,238.6,-0.5,-0.75,60,"1,431.62",112
,20131225,238.85,238.6,240.1,240.65,239.95,240.25,240.15,1.65,1.55,62,"1,489.08",104
,20131226,240.25,240.15,239.65,240.35,239.65,240.3,240.05,0.15,-0.1,12,288.07,102
,20131227,240.3,240.05,241.55,242.8,241.35,242.8,242.05,2.75,2,54,"1,307.22",112
,20131230,242.8,242.05,242.35,243.55,240.55,240.55,242.4,-1.5,0.35,70,"1,697.02",112
,20131231,240.55,242.4,240.55,240.55,238.7,239.3,239.5,-3.1,-2.9,12,287.42,108
au1406,20130618,280.08,280.08,277.16,277.97,277.16,277.25,277.6,-2.83,-2.48,16,444.17,8
,20130619,277.25,277.6,274.89,275.1,274.65,275.09,274.92,-2.51,-2.68,22,604.84,6
,20130620,275.09,274.92,269.33,271.06,268,268,270.03,-6.92,-4.89,88,"2,376.28",46
,20130621,268,270.03,257,261.88,256.52,261.88,259.17,-8.15,-10.86,110,"2,850.88",82
,20130624,261.88,259.17,261.4,261.4,257.58,258.18,259.17,-0.99,0,66,"1,710.58",96
,20130625,258.2,259.15,258.3,260,258.3,258.95,259.1,-0.2,-0.05,44,"1,140.09",100
,20130626,258.95,259.1,257.35,257.35,251.05,253.5,253.65,-5.6,-5.45,68,"1,724.88",126
,20130627,253.5,253.65,251.25,252.35,249.4,251.6,251.15,-2.05,-2.5,206,"5,174.70",240
,20130628,251.6,251.15,241.1,246.15,238.9,245.15,243.65,-6,-7.5,192,"4,678.42",302
,20130701,245.15,243.65,249,253.45,249,252.85,251.65,9.2,8,178,"4,479.37",336
,20130702,252.85,251.65,255.45,255.8,254.4,255.05,255,3.4,3.35,76,"1,938.15",344
,20130703,255.05,255,253.15,253.35,252.2,252.7,252.9,-2.3,-2.1,24,606.97,344
,20130704,252.7,252.9,255.8,255.8,253.8,254.55,254.3,1.65,1.4,46,"1,169.84",344
,20130705,254.55,254.3,253.05,253.05,250.8,251.65,251.7,-2.65,-2.6,110,"2,769.07",390
,20130708,251.65,251.7,249.55,249.55,244.4,246.9,246.6,-4.8,-5.1,242,"5,968.33",418
,20130709,246.9,246.6,248.7,254.55,248.7,253.9,251.45,7.3,4.85,184,"4,627.08",454
,20130710,253.9,251.45,252.35,253.05,250.95,251.75,251.95,0.3,0.5,134,"3,376.28",484
,20130711,251.75,251.95,253.7,262,251.75,259.55,259.9,7.6,7.95,354,"9,201.90",514
,20130712,259.55,259.9,259.9,259.9,257.05,257.6,259.05,-2.3,-0.85,216,"5,595.95",562
,20130715,257.6,259.05,257.1,261.1,256.75,259.2,259.3,0.15,0.25,106,"2,748.86",574
,20130716,259.2,259.3,259.2,259.5,257.9,258.45,258.5,-0.85,-0.8,136,"3,515.61",604
,20130717,258.45,258.5,260.5,261.3,259.35,259.7,259.85,1.2,1.35,106,"2,754.69",594
,20130718,259.7,259.85,261.2,261.2,255.9,256.45,256.95,-3.4,-2.9,262,"6,733.04",688
,20130719,256.45,256.95,258.1,259.85,257.45,258.75,258.8,1.8,1.85,274,"7,091.14",666
,20130722,258.75,258.8,259.65,265.5,259.3,264.75,262.95,5.95,4.15,164,"4,312.67",660
,20130723,264.75,262.95,265.65,268.15,265.65,266.65,267,3.7,4.05,312,"8,330.64",724
,20130724,266.65,267,266.45,269,266.4,267.9,267.9,0.9,0.9,964,"25,827.95",1496
,20130725,267.9,267.9,266.25,266.85,263.4,264.4,264.65,-3.5,-3.25,186,"4,922.94",1532
,20130726,264.4,264.65,265.25,267.15,264.65,265.9,266.35,1.25,1.7,192,"5,113.93",1584
,20130729,265.9,266.35,264.1,265.3,262.25,263.85,264.1,-2.5,-2.25,222,"5,863.09",1680
,20130730,263.85,264.1,264.4,265.15,263.35,264.15,264.4,0.05,0.3,332,"8,779.65",1778
,20130731,264.15,264.4,264.3,266.65,262.95,266,264.95,1.6,0.55,230,"6,094.54",1836
,20130801,266,264.95,263.95,265.7,260.85,263.6,263.25,-1.35,-1.7,436,"11,478.57",2008
,20130802,263.6,263.25,263.8,263.8,256.65,257.05,259.2,-6.2,-4.05,300,"7,777.02",2056
,20130805,257.05,259.2,261.75,266,261.5,262.8,262.6,3.6,3.4,736,"19,330.62",2430
,20130806,262.8,262.6,261.25,261.6,257.6,257.9,259.5,-4.7,-3.1,1026,"26,628.70",2860
,20130807,257.9,259.5,257.75,257.75,254.9,256.5,255.8,-3,-3.7,584,"14,940.84",3166
,20130808,256.5,255.8,255.9,259.25,255.9,258.15,258.1,2.35,2.3,578,"14,918.66",3454
,20130809,258.15,258.1,258.6,262.9,258.4,261.75,261.45,3.65,3.35,710,"18,563.23",3756
,20130812,261.75,261.45,261.3,266.4,260.85,265.9,265.5,4.45,4.05,850,"22,568.38",4204
,20130813,265.9,265.5,266.4,268.2,266.05,267.6,267,2.1,1.5,1102,"29,424.02",4878
,20130814,267.6,267,266.9,266.9,263.3,264,264.65,-3,-2.35,688,"18,209.03",5146
,20130815,264,264.65,264.5,269.3,263.9,267.75,267.35,3.1,2.7,1688,"45,134.17",5914
,20130816,267.75,267.35,264.2,274.8,264.05,272.15,270.75,4.8,3.4,1102,"29,837.60",6276
,20130819,272.15,270.75,273.4,276.75,271.8,273.95,275.4,3.2,4.65,1080,"29,745.90",6868
,20130820,273.95,275.4,273.45,274.15,270.4,271.5,272.55,-3.9,-2.85,1102,"30,038.61",7220
,20130821,271.5,272.55,272.75,274.55,272.65,273.35,273.7,0.8,1.15,1612,"44,120.82",7992
,20130822,273.35,273.7,273.35,274,271.4,272.3,272.05,-1.4,-1.65,510,"13,876.50",8228
,20130823,272.3,272.05,274.1,274.8,273.15,274.45,274.3,2.4,2.25,1262,"34,618.27",8852
,20130826,274.45,274.3,273.6,280.05,273.6,278.35,278.15,4.05,3.85,1170,"32,545.92",9270
,20130827,278.35,278.15,279.7,279.7,277.05,279.05,278.7,0.9,0.55,856,"23,859.68",9510
,20130828,279.05,278.7,283,285.4,280.5,284.1,282.8,5.4,4.1,1914,"54,132.71",9984
,20130829,284.1,282.8,284.5,284.6,279.85,281.5,281.2,-1.3,-1.6,1730,"48,655.63",10394
,20130830,281.5,281.2,281.95,281.95,279.7,279.95,280.35,-1.25,-0.85,760,"21,307.85",10512
,20130902,279.95,280.35,278,279.7,276.25,278.6,278.05,-1.75,-2.3,1370,"38,098.83",11152
,20130903,278.6,278.05,277.5,279.2,277.3,277.45,278,-0.6,-0.05,602,"16,737.61",11310
,20130904,277.45,278,279.3,282.45,279.25,280.5,280.5,2.5,2.5,1692,"47,468.22",12098
,20130905,280.5,280.5,278.5,278.5,275.25,276.65,276.95,-3.85,-3.55,726,"20,107.51",12200
,20130906,276.65,276.95,277.2,277.2,272,273.6,274,-3.35,-2.95,1026,"28,114.59",12560
,20130909,273.6,274,277.1,277.5,276,276.9,276.85,2.9,2.85,1532,"42,418.82",13144
,20130910,276.9,276.85,277.15,277.4,274.6,274.95,275.95,-1.9,-0.9,1116,"30,799.23",13770
,20130911,274.95,275.95,271.1,273.3,270.85,273.3,271.95,-2.65,-4,1576,"42,864.07",14520
,20130912,273.3,271.95,272,272.6,268.6,268.85,271.35,-3.1,-0.6,1582,"42,931.44",15364
,20130913,268.85,271.35,265.5,266.15,261.5,262.95,264.2,-8.4,-7.15,2230,"58,917.18",16074
,20130916,262.95,264.2,263.75,266.3,261.1,264.2,264.6,0,0.4,2412,"63,825.87",17092
,20130917,264.2,264.6,263.15,264.35,261.4,262.5,262.3,-2.1,-2.3,1978,"51,885.53",18060
,20130918,262.5,262.3,262.15,262.65,257.9,260.25,259.7,-2.05,-2.6,2668,"69,300.83",18872
,20130923,260.25,259.7,263.75,265.55,261.45,264.55,263.9,4.85,4.2,3706,"97,818.86",20348
,20130924,264.55,263.9,264,265.65,263.15,264.5,264.85,0.6,0.95,3570,"94,568.40",22350
,20130925,264.5,264.85,262.2,265.7,261,265.1,263.55,0.25,-1.3,4278,"112,767.52",23976
,20130926,265.1,263.55,264.45,267,263.9,266.1,265.95,2.55,2.4,4396,"116,917.70",26440
,20130927,266.1,265.95,266.65,266.95,263.65,264.4,264.7,-1.55,-1.25,2680,"70,947.63",27730
,20130930,264.4,264.7,266.85,267.6,266.2,267.55,267.2,2.85,2.5,2960,"79,098.01",29162
,20131008,267.55,267.2,265.7,266,264.3,265.3,265.15,-1.9,-2.05,1096,"29,064.83",29336
,20131009,265.3,265.15,265.2,265.6,263.2,263.45,263.8,-1.7,-1.35,9768,"257,693.16",35972
,20131010,263.45,263.8,261.55,262.7,259.8,261.1,260.7,-2.7,-3.1,6114,"159,418.69",38956
,20131011,261.1,260.7,260.15,260.55,257.7,258,258.85,-2.7,-1.85,4366,"113,033.18",40378
,20131014,258,258.85,254,256.3,253.1,255.9,254.35,-2.95,-4.5,5692,"144,793.25",41966
,20131015,255.9,254.35,257.15,257.75,254.05,254.85,255.25,0.5,0.9,3966,"101,233.73",42594
,20131016,254.85,255.25,252.5,257.75,252.5,257.75,255.85,2.5,0.6,4058,"103,836.47",43124
,20131017,257.75,255.85,256.9,257.9,254.7,255.55,256.4,-0.3,0.55,4896,"125,535.58",44460
,20131018,255.55,256.4,262.6,264.6,261.4,263.85,262.9,7.45,6.5,6022,"158,346.49",44854
,20131021,263.85,262.9,263.5,264.2,262.25,263.95,263.25,1.05,0.35,3594,"94,613.63",45526
,20131022,263.95,263.25,263.25,263.75,262.45,263.05,262.95,-0.2,-0.3,3852,"101,294.51",45984
,20131023,263.05,262.95,265.05,267.9,265,265.95,266.65,3,3.7,7594,"202,501.58",47196
,20131024,265.95,266.65,266,266.65,264.55,266.4,265.7,-0.25,-0.95,4796,"127,452.33",49066
,20131025,266.4,265.7,266.75,267.15,265.05,265.35,265.8,-0.35,0.1,6578,"174,869.69",51596
,20131028,265.35,265.8,265.35,267.8,264.95,267.1,266.75,1.3,0.95,11682,"311,641.17",58724
,20131029,267.1,266.75,268,268.5,266.5,267.3,267.25,0.55,0.5,13808,"369,022.01",62478
,20131030,267.3,267.25,266.7,266.95,264.4,266.7,265.75,-0.55,-1.5,13350,"354,841.77",63988
,20131031,266.7,265.75,267.75,269.05,264,265.4,265.95,-0.35,0.2,19276,"512,673.24",69434
,20131101,265.4,265.95,263,264.55,262.45,263.85,263.4,-2.1,-2.55,17820,"469,404.84",71432
,20131104,263.85,263.4,261.9,262.55,260.1,261.75,261.5,-1.65,-1.9,19310,"504,990.02",74044
,20131105,261.75,261.5,262.85,263.3,261.35,261.8,262.15,0.3,0.65,19858,"520,673.46",77758
,20131106,261.8,262.15,262.1,262.5,260.3,261.35,261.2,-0.8,-0.95,21560,"563,236.60",80074
,20131107,261.35,261.2,262.2,262.75,261.6,262.55,262.15,1.35,0.95,26868,"704,379.23",81548
,20131108,262.55,262.15,263.05,263.45,258.35,260.4,260.45,-1.75,-1.7,51728,"1,347,300.07",88816
,20131111,260.4,260.45,260.2,261,255.6,256.2,256.75,-4.25,-3.7,52068,"1,337,076.99",94442
,20131112,256.2,256.75,255.75,255.8,253.8,254.9,254.9,-1.85,-1.85,36686,"935,226.55",96636
,20131113,254.9,254.9,254.95,255.85,252.7,253.45,254.15,-1.45,-0.75,55628,"1,413,914.53",100154
,20131114,253.45,254.15,254.5,256.5,253.05,255.5,254.75,1.35,0.6,67652,"1,723,542.27",100262
,20131115,255.5,254.75,254.7,257.3,254.6,256.15,256.1,1.4,1.35,74002,"1,895,430.53",100854
,20131118,256.15,256.1,255.4,256.55,255.25,256.25,256,0.15,-0.1,45590,"1,167,236.87",103514
,20131119,256.25,256,255,255.7,252.5,253.2,253.95,-2.8,-2.05,78710,"1,998,977.54",112754
,20131120,253.2,253.95,253.95,254.2,253.15,254,253.6,0.05,-0.35,69668,"1,767,022.07",113772
,20131121,254,253.6,251.35,253,248.55,248.75,250.75,-4.85,-2.85,181538,"4,552,262.73",125572
,20131122,248.75,250.75,248.85,249.1,247.15,248.75,248.25,-2,-2.5,162690,"4,039,140.97",130930
,20131125,248.75,248.25,249.1,249.35,245.25,245.75,247.95,-2.5,-0.3,115266,"2,858,094.43",136858
,20131126,245.75,247.95,246.1,250.5,245.15,250.15,247.8,2.2,-0.15,186750,"4,628,136.27",135764
,20131127,250.15,247.8,249,249.35,247.8,248.75,248.6,0.95,0.8,140414,"3,491,127.94",138890
,20131128,248.75,248.6,249.45,250.4,247,247.7,248.7,-0.9,0.1,197074,"4,901,664.11",146774
,20131129,247.7,248.7,248.35,248.8,247.9,248.1,248.4,-0.6,-0.3,78634,"1,953,314.35",147810
,20131202,248.1,248.4,250.35,250.35,248.6,249.25,249.65,0.85,1.25,108620,"2,711,960.37",146856
,20131203,249.25,249.65,247.2,247.7,244.45,245.3,246.25,-4.35,-3.4,209674,"5,163,469.03",161356
,20131204,245.3,246.25,245.35,245.6,244.4,244.95,245.05,-1.3,-1.2,154952,"3,797,699.59",165916
,20131205,244.95,245.05,245.4,250.3,244.05,247.9,246.75,2.85,1.7,273926,"6,759,140.51",164522
,20131206,247.9,246.75,246.5,247.6,244.55,246,246,-0.75,-0.75,290896,"7,157,191.32",170634
,20131209,246,246,246,249.25,242.4,246.75,246.9,0.75,0.9,386856,"9,553,002.98",180506
,20131210,246.75,246.9,246.8,249.35,246.7,249.25,247.85,2.35,0.95,181712,"4,503,943.79",178186
,20131211,249.25,247.85,249.8,252.15,249.55,251,251.1,3.15,3.25,245240,"6,159,034.86",170172
,20131212,251,251.1,250.3,251.9,249.6,250.1,250.85,-1,-0.25,213066,"5,345,352.21",174062
,20131213,250.1,250.85,246.75,247.15,244.4,244.75,245.65,-6.1,-5.2,243946,"5,993,474.91",174626
,20131216,244.75,245.65,245.2,246.35,244.8,245.75,245.65,0.1,0,156374,"3,841,353.89",167254
,20131217,245.75,245.65,245.8,249.45,245.7,248,247.5,2.35,1.85,277594,"6,871,040.27",168762
,20131218,248,247.5,246.35,247.9,245.1,245.65,246.05,-1.85,-1.45,254228,"6,255,421.01",165452
,20131219,245.65,246.05,245.75,246.85,242.9,243.75,244.85,-2.3,-1.2,240142,"5,880,510.55",172160
,20131220,243.75,244.85,240.3,240.9,238.2,238.35,239.5,-6.5,-5.35,293912,"7,040,634.77",185680
,20131223,238.35,239.5,238.8,240.95,237.9,240.2,239.4,0.7,-0.1,253480,"6,068,535.86",181110
,20131224,240.2,239.4,239.55,240.35,238.65,239,239.5,-0.4,0.1,157188,"3,765,408.69",179002
,20131225,239,239.5,239.5,240.9,239.2,240.9,239.9,1.4,0.4,87886,"2,108,631.72",175394
,20131226,240.9,239.9,240.95,241.05,240.2,240.6,240.55,0.7,0.65,50696,"1,219,589.17",176898
,20131227,240.6,240.55,240.65,243.2,240.6,242.85,242.2,2.3,1.65,161428,"3,909,943.69",175872
,20131230,242.85,242.2,242.5,243.85,241,241.05,242.75,-1.15,0.55,154926,"3,760,951.58",173322
,20131231,241.05,242.75,240.55,241.8,238.6,239.4,240.45,-3.35,-2.3,153486,"3,690,574.44",169098
au1407,20130716,259.3,259.3,,,,258.5,258.5,-0.8,-0.8,0,0,0
,20130717,258.5,258.5,259.65,261.15,259.65,261.15,260.4,2.65,1.9,4,104.16,2
,20130718,261.15,260.4,,,,257.5,257.5,-2.9,-2.9,0,0,2
,20130719,257.5,257.5,,,,259.35,259.35,1.85,1.85,0,0,2
,20130722,259.35,259.35,,,,263.5,263.5,4.15,4.15,0,0,2
,20130723,263.5,263.5,,,,267.55,267.55,4.05,4.05,0,0,2
,20130724,267.55,267.55,267.25,268.7,266.55,268.7,267.5,1.15,-0.05,6,160.5,4
,20130725,268.7,267.5,265.8,265.8,265.8,265.8,265.8,-1.7,-1.7,2,53.16,6
,20130726,265.8,265.8,267.6,267.65,267.6,267.65,267.6,1.85,1.8,4,107.05,6
,20130729,267.65,267.6,,,,265.3,265.3,-2.3,-2.3,0,0,6
,20130730,265.3,265.3,,,,265.6,265.6,0.3,0.3,0,0,6
,20130731,265.6,265.6,263.1,264.5,263.1,264.5,263.8,-1.1,-1.8,4,105.52,2
,20130801,264.5,263.8,,,,262.1,262.1,-1.7,-1.7,0,0,2
,20130802,262.1,262.1,,,,258.1,258.1,-4,-4,0,0,2
,20130805,258.1,258.1,,,,261.5,261.5,3.4,3.4,0,0,2
,20130806,261.5,261.5,,,,258.45,258.45,-3.05,-3.05,0,0,2
,20130807,258.45,258.45,,,,254.8,254.8,-3.65,-3.65,0,0,2
,20130808,254.8,254.8,,,,257.05,257.05,2.25,2.25,0,0,2
,20130809,257.05,257.05,261.45,262.8,261.45,262.75,262.1,5.7,5.05,8,209.69,6
,20130812,262.75,262.1,262.7,266.25,262.05,266.25,263.65,4.15,1.55,6,158.2,6
,20130813,266.25,263.65,,,,265.1,265.1,1.45,1.45,0,0,6
,20130814,265.1,265.1,,,,262.75,262.75,-2.35,-2.35,0,0,6
,20130815,262.75,262.75,269.4,269.4,268.25,268.8,268.75,6.05,6,12,322.55,2
,20130816,268.8,268.75,,,,272.15,272.15,3.4,3.4,0,0,2
,20130819,272.15,272.15,,,,276.8,276.8,4.65,4.65,0,0,2
,20130820,276.8,276.8,,,,273.95,273.95,-2.85,-2.85,0,0,2
,20130821,273.95,273.95,273.9,274.65,273.9,274.65,274.25,0.7,0.3,4,109.71,2
,20130822,274.65,274.25,272,272,272,272,272,-2.25,-2.25,2,54.4,4
,20130823,272,272,,,,274.25,274.25,2.25,2.25,0,0,4
,20130826,274.25,274.25,,,,278.1,278.1,3.85,3.85,0,0,4
,20130827,278.1,278.1,278.85,278.9,278.85,278.9,278.85,0.8,0.75,4,111.55,4
,20130828,278.9,278.85,284.9,284.9,284.9,284.9,284.9,6.05,6.05,4,113.96,6
,20130829,284.9,284.9,285.05,285.05,281.25,281.65,282.45,-3.25,-2.45,8,225.99,2
,20130830,281.65,282.45,,,,281.6,281.6,-0.85,-0.85,0,0,2
,20130902,281.6,281.6,,,,279.3,279.3,-2.3,-2.3,0,0,2
,20130903,279.3,279.3,,,,279.25,279.25,-0.05,-0.05,0,0,2
,20130904,279.25,279.25,,,,279.25,279.25,0,0,0,0,2
,20130905,279.25,279.25,,,,279.25,279.25,0,0,0,0,2
,20130906,279.25,279.25,,,,279.25,279.25,0,0,0,0,2
,20130909,279.25,279.25,,,,282.15,282.15,2.9,2.9,0,0,2
,20130910,282.15,282.15,,,,281.25,281.25,-0.9,-0.9,0,0,2
,20130911,281.25,281.25,,,,277.2,277.2,-4.05,-4.05,0,0,2
,20130912,277.2,277.2,272.45,272.45,270.55,271.15,271.4,-6.05,-5.8,38,"1,031.49",10
,20130913,271.15,271.4,265.5,265.5,263.1,263.1,264,-8.3,-7.4,12,316.83,10
,20130916,263.1,264,263.8,266.3,263.4,263.4,264.1,-0.6,0.1,24,633.89,16
,20130917,263.4,264.1,263.8,263.8,262,262.65,262.85,-1.45,-1.25,18,473.19,12
,20130918,262.65,262.85,262,262,261.95,261.95,261.95,-0.9,-0.9,4,104.79,16
,20130923,261.95,261.95,,,,266.2,266.2,4.25,4.25,0,0,16
,20130924,266.2,266.2,264.8,265.15,264.8,265.05,265,-1.15,-1.2,6,159,14
,20130925,265.05,265,,,,263.7,263.7,-1.3,-1.3,0,0,14
,20130926,263.7,263.7,265.25,265.25,265.25,265.25,265.25,1.55,1.55,2,53.05,14
,20130927,265.25,265.25,266.25,266.25,265.15,265.2,265.6,-0.05,0.35,22,584.38,4
,20130930,265.2,265.6,,,,268.1,268.1,2.5,2.5,0,0,4
,20131008,268.1,268.1,,,,266.05,266.05,-2.05,-2.05,0,0,4
,20131009,266.05,266.05,263.9,263.9,263.9,263.9,263.9,-2.15,-2.15,4,105.56,8
,20131010,263.9,263.9,261.8,261.8,260.5,260.5,260.95,-3.4,-2.95,6,156.59,12
,20131011,260.5,260.95,,,,259.1,259.1,-1.85,-1.85,0,0,12
,20131014,259.1,259.1,254.4,254.7,253.1,254.55,253.6,-4.55,-5.5,70,"1,775.47",48
,20131015,254.55,253.6,257.1,257.1,255.45,255.45,256.4,1.85,2.8,8,205.13,52
,20131016,255.45,256.4,254.05,255.7,254,255.7,254.85,-0.7,-1.55,8,203.88,50
,20131017,255.7,254.85,257.35,257.35,256.5,256.5,256.7,1.65,1.85,14,359.42,44
,20131018,256.5,256.7,262.1,262.65,262.1,262.65,262.45,5.95,5.75,6,157.48,42
,20131021,262.65,262.45,263,263.05,263,263,263,0.55,0.55,6,157.81,38
,20131022,263,263,,,,262.7,262.7,-0.3,-0.3,0,0,38
,20131023,262.7,262.7,266.1,267.3,265.55,265.55,266.9,2.85,4.2,62,"1,655.02",36
,20131024,265.55,266.9,265.5,266.5,265.5,266.5,265.9,-0.4,-1,30,797.8,22
,20131025,266.5,265.9,265.95,266.15,265.7,265.7,266,-0.2,0.1,10,266.02,14
,20131028,265.7,266,265.2,266.55,265.2,266.55,266,0.55,0,10,266.04,22
,20131029,266.55,266,268,268,266.8,266.8,267.3,0.8,1.3,10,267.3,20
,20131030,266.8,267.3,,,,265.8,265.8,-1.5,-1.5,0,0,20
,20131031,265.8,265.8,264.9,265.1,264.65,264.9,264.85,-0.9,-0.95,16,423.78,22
,20131101,264.9,264.85,264.2,264.2,263.25,263.6,263.7,-1.25,-1.15,16,421.93,22
,20131104,263.6,263.7,262.25,262.3,261.9,261.9,262.1,-1.8,-1.6,8,209.68,18
,20131105,261.9,262.1,262.9,262.9,260.05,261.6,261.3,-0.5,-0.8,52,"1,358.90",30
,20131106,261.6,261.3,261.8,261.8,260.85,260.85,261.3,-0.45,0,4,104.53,30
,20131107,260.85,261.3,263.15,263.15,263.15,263.15,263.15,1.85,1.85,2,52.63,28
,20131108,263.15,263.15,,,,261.45,261.45,-1.7,-1.7,0,0,28
,20131111,261.45,261.45,260.55,260.55,256.4,256.4,257.9,-5.05,-3.55,12,309.49,24
,20131112,256.4,257.9,255.6,255.6,255.6,255.6,255.6,-2.3,-2.3,2,51.12,26
,20131113,255.6,255.6,255.45,255.45,252.95,253.65,254,-1.95,-1.6,6,152.41,26
,20131114,253.65,254,254.3,256.15,254.3,256.15,254.95,2.15,0.95,6,152.98,26
,20131115,256.15,254.95,255.8,256.25,255.8,255.95,255.95,1,1,8,204.76,24
,20131118,255.95,255.95,,,,255.85,255.85,-0.1,-0.1,0,0,24
,20131119,255.85,255.85,253.05,253.05,253.05,253.05,253.05,-2.8,-2.8,2,50.61,22
,20131120,253.05,253.05,253.05,253.95,253,253.3,253.4,0.25,0.35,26,658.84,22
,20131121,253.3,253.4,,,,250.55,250.55,-2.85,-2.85,0,0,22
,20131122,250.55,250.55,248.45,248.45,248.45,248.45,248.45,-2.1,-2.1,2,49.69,20
,20131125,248.45,248.45,248.35,248.35,248.35,248.35,248.35,-0.1,-0.1,4,99.34,20
,20131126,248.35,248.35,250.3,250.3,250.3,250.3,250.3,1.95,1.95,4,100.12,20
,20131127,250.3,250.3,249.05,249.05,248.4,248.45,248.65,-1.85,-1.65,10,248.67,30
,20131128,248.45,248.65,,,,248.75,248.75,0.1,0.1,0,0,30
,20131129,248.75,248.75,248.75,249.2,248.5,248.5,248.85,-0.25,0.1,10,248.87,30
,20131202,248.5,248.85,250.55,250.55,250.55,250.55,250.55,1.7,1.7,2,50.11,32
,20131203,250.55,250.55,,,,247.1,247.1,-3.45,-3.45,0,0,32
,20131204,247.1,247.1,244.95,245.05,244.95,245.05,245,-2.05,-2.1,62,"1,519.09",88
,20131205,245.05,245,246.25,250,244.4,248.5,245.5,3.5,0.5,1384,"33,983.37",106
,20131206,248.5,245.5,247.4,248.25,245.85,246.3,246.95,0.8,1.45,38,938.57,104
,20131209,246.3,246.95,246.95,249.45,243.9,247.05,248.05,0.1,1.1,64,"1,587.56",104
,20131210,247.05,248.05,248.1,249.15,247.8,249.15,248.45,1.1,0.4,28,695.71,88
,20131211,249.15,248.45,250.35,252.25,250.35,251.3,251.55,2.85,3.1,54,"1,358.52",104
,20131212,251.3,251.55,251.7,252.2,250.85,250.85,251.55,-0.7,0,32,805.03,98
,20131213,250.85,251.55,245.6,245.6,245.5,245.5,245.55,-6.05,-6,16,392.92,104
,20131216,245.5,245.55,246.85,247,246.25,246.7,246.65,1.15,1.1,20,493.35,100
,20131217,246.7,246.65,247,247.7,246.7,247.7,247.15,1.05,0.5,10,247.19,100
,20131218,247.7,247.15,244.75,246.5,244.75,246.5,245.6,-0.65,-1.55,4,98.25,98
,20131219,246.5,245.6,244.35,244.7,243.7,244.15,244.2,-1.45,-1.4,28,683.87,96
,20131220,244.15,244.2,241.1,241.15,239,239,239.95,-5.2,-4.25,24,575.91,100
,20131223,239,239.95,238.95,240.6,238.75,240.15,239.4,0.2,-0.55,18,430.97,102
,20131224,240.15,239.4,240.2,240.2,239.45,239.5,239.8,0.1,0.4,14,335.78,94
,20131225,239.5,239.8,241.1,241.1,241.1,241.1,241.1,1.3,1.3,4,96.44,94
,20131226,241.1,241.1,241.1,241.15,241.1,241.1,241.1,0,0,8,192.9,88
,20131227,241.1,241.1,242.45,243.6,242.4,243.6,242.85,2.5,1.75,44,"1,068.70",78
,20131230,243.6,242.85,244.15,244.15,243,243.2,243.7,0.35,0.85,10,243.73,84
,20131231,243.2,243.7,241.75,242,240.05,240.75,241.4,-2.95,-2.3,48,"1,158.92",78
au1408,20130816,268.75,268.75,,,,270.5,270.5,1.75,1.75,0,0,0
,20130819,270.5,270.5,,,,270.5,270.5,0,0,0,0,0
,20130820,270.5,270.5,274,274,273,273,273.5,2.5,3,4,109.4,0
,20130821,273,273.5,274,274,273.3,273.3,273.65,-0.2,0.15,4,109.46,0
,20130822,273.3,273.65,273.5,273.5,271.5,272.2,272.35,-1.45,-1.3,18,490.3,2
,20130823,272.2,272.35,273.6,275.4,273.6,274.55,274.5,2.2,2.15,6,164.71,2
,20130826,274.55,274.5,,,,274.5,274.5,0,0,0,0,2
,20130827,274.5,274.5,,,,274.5,274.5,0,0,0,0,2
,20130828,274.5,274.5,283.65,283.75,282.15,283.65,283.1,9.15,8.6,10,283.12,2
,20130829,283.65,283.1,,,,280.7,280.7,-2.4,-2.4,0,0,2
,20130830,280.7,280.7,,,,280.7,280.7,0,0,0,0,2
,20130902,280.7,280.7,277.95,279.8,277.35,279.8,279.05,-0.9,-1.65,12,334.88,8
,20130903,279.8,279.05,279.4,279.4,278.55,278.55,278.95,-0.5,-0.1,4,111.59,8
,20130904,278.55,278.95,,,,278.95,278.95,0,0,0,0,8
,20130905,278.95,278.95,277.3,278.2,277.3,278.2,277.45,-0.75,-1.5,10,277.48,4
,20130906,278.2,277.45,,,,277.45,277.45,0,0,0,0,4
,20130909,277.45,277.45,,,,280.35,280.35,2.9,2.9,0,0,4
,20130910,280.35,280.35,,,,280.35,280.35,0,0,0,0,4
,20130911,280.35,280.35,272.5,272.5,272.5,272.5,272.5,-7.85,-7.85,2,54.5,2
,20130912,272.5,272.5,,,,266.8,266.8,-5.7,-5.7,0,0,2
,20130913,266.8,266.8,,,,259.55,259.55,-7.25,-7.25,0,0,2
,20130916,259.55,259.55,264.9,266.2,264.9,266.2,265.6,6.65,6.05,6,159.38,2
,20130917,266.2,265.6,,,,264.35,264.35,-1.25,-1.25,0,0,2
,20130918,264.35,264.35,258.9,258.9,258.9,258.9,258.9,-5.45,-5.45,2,51.78,4
,20130923,258.9,258.9,261.55,265.25,261.55,265.25,263.1,6.35,4.2,10,263.13,6
,20130924,265.25,263.1,,,,261.9,261.9,-1.2,-1.2,0,0,6
,20130925,261.9,261.9,,,,260.65,260.65,-1.25,-1.25,0,0,6
,20130926,260.65,260.65,,,,260.65,260.65,0,0,0,0,6
,20130927,260.65,260.65,,,,261,261,0.35,0.35,0,0,6
,20130930,261,261,267.7,267.7,267.6,267.6,267.65,6.6,6.65,4,107.06,8
,20131008,267.6,267.65,,,,265.6,265.6,-2.05,-2.05,0,0,8
,20131009,265.6,265.6,264,264.25,263.4,264.25,263.85,-1.35,-1.75,6,158.33,8
,20131010,264.25,263.85,259.75,261.8,259.75,261.8,260.75,-2.05,-3.1,4,104.31,10
,20131011,261.8,260.75,259.1,260.5,259.1,260.5,259.75,-0.25,-1,18,467.55,12
,20131014,260.5,259.75,254.3,255.25,253.5,255.25,253.9,-4.5,-5.85,22,558.66,14
,20131015,255.25,253.9,253.3,253.3,253.3,253.3,253.3,-0.6,-0.6,2,50.66,16
,20131016,253.3,253.3,256.8,257.5,256.8,257.5,257.15,4.2,3.85,4,102.86,16
,20131017,257.5,257.15,255.15,256.75,255.15,256.15,256.2,-1,-0.95,8,204.96,18
,20131018,256.15,256.2,262.45,263.2,262,263.2,262.5,7,6.3,8,210.02,14
,20131021,263.2,262.5,263.3,263.3,263.3,263.3,263.3,0.8,0.8,4,105.32,12
,20131022,263.3,263.3,262.75,262.75,262.75,262.75,262.75,-0.55,-0.55,2,52.55,14
,20131023,262.75,262.75,265.1,267.85,265.1,266.25,266.55,3.5,3.8,16,426.52,14
,20131024,266.25,266.55,264.95,266.6,264.95,266.3,265.9,-0.25,-0.65,36,957.25,24
,20131025,266.3,265.9,266.55,267.6,266.55,266.55,266.8,0.65,0.9,8,213.45,20
,20131028,266.55,266.8,,,,266.8,266.8,0,0,0,0,20
,20131029,266.8,266.8,267.35,267.35,267.1,267.1,267.15,0.3,0.35,6,160.31,24
,20131030,267.1,267.15,266.9,266.9,263.85,265.3,265.1,-1.85,-2.05,84,"2,227.24",22
,20131031,265.3,265.1,268.2,268.7,264.45,264.45,267.35,-0.65,2.25,16,427.77,30
,20131101,264.45,267.35,263.55,263.55,262.75,262.8,263,-4.55,-4.35,6,157.82,30
,20131104,262.8,263,261.8,261.8,261,261,261.25,-2,-1.75,6,156.76,30
,20131105,261,261.25,262.6,262.6,261.7,261.9,262.1,0.65,0.85,14,366.96,28
,20131106,261.9,262.1,,,,262.1,262.1,0,0,0,0,28
,20131107,262.1,262.1,262.25,262.25,261.9,261.9,262.1,-0.2,0,6,157.28,30
,20131108,261.9,262.1,260.05,260.05,260.05,260.05,260.05,-2.05,-2.05,8,208.04,22
,20131111,260.05,260.05,257.35,257.35,257.35,257.35,257.35,-2.7,-2.7,8,205.88,22
,20131112,257.35,257.35,255.2,255.2,255.2,255.2,255.2,-2.15,-2.15,2,51.04,22
,20131113,255.2,255.2,255.5,255.5,253.6,253.95,254.35,-1.25,-0.85,6,152.61,20
,20131114,253.95,254.35,256.05,256.1,256.05,256.1,256.05,1.75,1.7,8,204.85,22
,20131115,256.1,256.05,,,,257.05,257.05,1,1,0,0,22
,20131118,257.05,257.05,,,,256.95,256.95,-0.1,-0.1,0,0,22
,20131119,256.95,256.95,,,,254.1,254.1,-2.85,-2.85,0,0,22
,20131120,254.1,254.1,,,,254.45,254.45,0.35,0.35,0,0,22
,20131121,254.45,254.45,252,252,249.55,249.55,250,-4.9,-4.45,26,650,46
,20131122,249.55,250,248.2,249.55,248.2,249.35,249.4,-0.65,-0.6,48,"1,197.26",86
,20131125,249.35,249.4,249.85,249.85,249,249.25,249.25,-0.15,-0.15,28,697.98,108
,20131126,249.25,249.25,248.95,251.2,248.95,251.2,250.75,1.95,1.5,14,351.06,114
,20131127,251.2,250.75,249.3,250.3,249.25,249.95,249.6,-0.8,-1.15,20,499.2,114
,20131128,249.95,249.6,249.95,249.95,248.35,249.15,249,-0.45,-0.6,12,298.82,116
,20131129,249.15,249,249.35,249.35,248.95,248.95,249.1,-0.05,0.1,14,348.77,118
,20131202,248.95,249.1,249.65,249.8,249.6,249.6,249.7,0.5,0.6,22,549.36,120
,20131203,249.6,249.7,248.5,248.5,245.35,245.95,246.2,-3.75,-3.5,12,295.47,118
,20131204,245.95,246.2,246.05,246.55,246.05,246.25,246.25,0.05,0.05,6,147.77,122
,20131205,246.25,246.25,246.1,249.95,246.1,248.95,248.65,2.7,2.4,34,845.55,124
,20131206,248.95,248.65,247.6,247.6,247.6,247.6,247.6,-1.05,-1.05,2,49.52,124
,20131209,247.6,247.6,247.3,247.3,246.8,246.8,247.05,-0.8,-0.55,4,98.82,122
,20131210,246.8,247.05,,,,248.1,248.1,1.05,1.05,0,0,122
,20131211,248.1,248.1,251.4,252.3,251.2,252.2,251.55,4.1,3.45,30,754.65,136
,20131212,252.2,251.55,251.35,252.55,250.8,250.8,251.6,-0.75,0.05,8,201.3,132
,20131213,250.8,251.6,245.15,246.15,245.15,246.05,245.8,-5.55,-5.8,28,688.35,124
,20131216,246.05,245.8,246.55,246.55,246.35,246.35,246.5,0.55,0.7,8,197.2,116
,20131217,246.35,246.5,247.65,248,247.65,247.7,247.8,1.2,1.3,30,743.48,118
,20131218,247.7,247.8,246.95,247.25,246.95,247.1,247.05,-0.7,-0.75,22,543.54,114
,20131219,247.1,247.05,247.1,247.1,244.5,244.5,245.55,-2.55,-1.5,32,785.91,122
,20131220,244.5,245.55,241.15,241.15,240.05,240.1,240.3,-5.45,-5.25,8,192.27,126
,20131223,240.1,240.3,240.65,240.65,240.65,240.65,240.65,0.35,0.35,2,48.13,124
,20131224,240.65,240.65,,,,240.65,240.65,0,0,0,0,124
,20131225,240.65,240.65,,,,241.45,241.45,0.8,0.8,0,0,124
,20131226,241.45,241.45,241.65,242,241.3,241.95,241.7,0.5,0.25,16,386.72,122
,20131227,241.95,241.7,243.55,243.6,243.15,243.45,243.4,1.75,1.7,8,194.75,124
,20131230,243.45,243.4,242.9,244.45,242.7,242.7,243.65,-0.7,0.25,18,438.65,126
,20131231,242.7,243.65,,,,240.9,240.9,-2.75,-2.75,0,0,126
au1410,20131016,253.3,253.3,,,,253.3,253.3,0,0,0,0,0
,20131017,253.3,253.3,,,,253.3,253.3,0,0,0,0,0
,20131018,253.3,253.3,,,,259.55,259.55,6.25,6.25,0,0,0
,20131021,259.55,259.55,263.15,263.15,263.15,263.15,263.15,3.6,3.6,6,157.89,6
,20131022,263.15,263.15,262.25,265.25,262.25,265.25,263.75,2.1,0.6,4,105.5,6
,20131023,265.25,263.75,266.5,266.5,266.5,266.5,266.5,2.75,2.75,2,53.3,6
,20131024,266.5,266.5,,,,265.85,265.85,-0.65,-0.65,0,0,6
,20131025,265.85,265.85,,,,266.75,266.75,0.9,0.9,0,0,6
,20131028,266.75,266.75,,,,266.75,266.75,0,0,0,0,6
,20131029,266.75,266.75,,,,267.1,267.1,0.35,0.35,0,0,6
,20131030,267.1,267.1,,,,265.05,265.05,-2.05,-2.05,0,0,6
,20131031,265.05,265.05,265.2,265.2,265.2,265.2,265.2,0.15,0.15,2,53.04,6
,20131101,265.2,265.2,264.45,264.45,262.15,262.15,263.3,-3.05,-1.9,6,157.99,8
,20131104,262.15,263.3,,,,261.55,261.55,-1.75,-1.75,0,0,8
,20131105,261.55,261.55,,,,262.4,262.4,0.85,0.85,0,0,8
,20131106,262.4,262.4,,,,262.4,262.4,0,0,0,0,8
,20131107,262.4,262.4,,,,262.4,262.4,0,0,0,0,8
,20131108,262.4,262.4,,,,260.3,260.3,-2.1,-2.1,0,0,8
,20131111,260.3,260.3,261,261,257,257,259,-3.3,-1.3,4,103.6,8
,20131112,257,259,,,,256.8,256.8,-2.2,-2.2,0,0,8
,20131113,256.8,256.8,253.55,253.55,253.55,253.55,253.55,-3.25,-3.25,2,50.71,10
,20131114,253.55,253.55,255.5,255.5,255.5,255.5,255.5,1.95,1.95,2,51.1,10
,20131115,255.5,255.5,,,,256.5,256.5,1,1,0,0,10
,20131118,256.5,256.5,256.2,256.2,256.2,256.2,256.2,-0.3,-0.3,4,102.48,10
,20131119,256.2,256.2,,,,253.35,253.35,-2.85,-2.85,0,0,10
,20131120,253.35,253.35,255.45,255.45,255.45,255.45,255.45,2.1,2.1,2,51.09,12
,20131121,255.45,255.45,,,,250.95,250.95,-4.5,-4.5,0,0,12
,20131122,250.95,250.95,248.7,248.7,248.65,248.65,248.65,-2.3,-2.3,4,99.47,16
,20131125,248.65,248.65,248.45,248.45,248.05,248.05,248.25,-0.6,-0.4,4,99.3,14
,20131126,248.05,248.25,245.95,250.55,245.95,250.55,248.8,2.3,0.55,8,199.04,16
,20131127,250.55,248.8,250.05,250.05,248.9,249.65,249.6,0.85,0.8,10,249.64,16
,20131128,249.65,249.6,,,,249.6,249.6,0,0,0,0,16
,20131129,249.6,249.6,248.9,248.9,248.25,248.65,248.4,-0.95,-1.2,26,645.96,32
,20131202,248.65,248.4,250.5,250.5,249.7,249.7,250.2,1.3,1.8,6,150.14,34
,20131203,249.7,250.2,248,248,245.6,245.65,247.2,-4.55,-3,28,692.21,18
,20131204,245.65,247.2,245.8,245.85,244.7,245.85,245.25,-1.35,-1.95,8,196.22,24
,20131205,245.85,245.25,246.25,252.75,246.25,248.7,248.9,3.45,3.65,24,597.45,30
,20131206,248.7,248.9,247.3,248.1,247.3,248.1,247.55,-0.8,-1.35,6,148.54,34
,20131209,248.1,247.55,248.8,248.8,247.75,247.95,248.3,0.4,0.75,8,198.65,30
,20131210,247.95,248.3,249,251.15,249,250.5,250.25,2.2,1.95,42,"1,051.25",44
,20131211,250.5,250.25,253.45,253.45,252.1,252.1,252.4,1.85,2.15,40,"1,009.77",24
,20131212,252.1,252.4,252.65,252.65,251,251.2,251.6,-1.2,-0.8,6,150.97,26
,20131213,251.2,251.6,,,,245.8,245.8,-5.8,-5.8,0,0,26
,20131216,245.8,245.8,247.3,247.3,246.7,246.7,247,0.9,1.2,4,98.8,28
,20131217,246.7,247,247.85,248.8,247.85,248.8,248.3,1.8,1.3,4,99.33,26
,20131218,248.8,248.3,,,,247.55,247.55,-0.75,-0.75,0,0,26
,20131219,247.55,247.55,245.25,245.25,245.15,245.25,245.2,-2.3,-2.35,6,147.13,24
,20131220,245.25,245.2,240,240.35,240,240.05,240.1,-5.15,-5.1,10,240.11,26
,20131223,240.05,240.1,239.45,241.2,239.45,241.2,240.3,1.1,0.2,4,96.13,22
,20131224,241.2,240.3,240.25,240.25,240.25,240.25,240.25,-0.05,-0.05,2,48.05,22
,20131225,240.25,240.25,240.95,240.95,240.9,240.9,240.9,0.65,0.65,4,96.37,24
,20131226,240.9,240.9,,,,240.9,240.9,0,0,0,0,24
,20131227,240.9,240.9,244.7,244.7,243.15,243.15,243.65,2.25,2.75,8,194.93,22
,20131230,243.15,243.65,243.65,243.65,243.65,243.65,243.65,0,0,2,48.73,22
,20131231,243.65,243.65,,,,242.2,242.2,-1.45,-1.45,0,0,22
au1412,20131217,247,247,229.3,249.4,229.3,248.8,247.3,1.8,0.3,34,840.87,12
,20131218,248.8,247.3,247.25,248.9,246.25,246.75,247,-0.55,-0.3,130,"3,211.34",88
,20131219,246.75,247,247.8,247.8,243.9,244.75,244.75,-2.25,-2.25,210,"5,140.21",202
,20131220,244.75,244.75,242.3,242.3,239.7,240,240.2,-4.75,-4.55,190,"4,564.60",306
,20131223,240,240.2,239.85,241.9,239.4,241.9,240.35,1.7,0.15,58,"1,394.12",324
,20131224,241.9,240.35,241.4,241.6,240.25,240.6,240.7,0.25,0.35,70,"1,685.09",314
,20131225,240.6,240.7,240.9,241.7,240.7,241.7,241.35,1,0.65,48,"1,158.56",340
,20131226,241.7,241.35,242.25,242.45,241.6,242.1,242.05,0.75,0.7,38,919.83,344
,20131227,242.1,242.05,242.35,244.3,242.35,244.3,243.4,2.25,1.35,80,"1,947.45",348
,20131230,244.3,243.4,244.1,245.05,242.4,242.4,244,-1,0.6,108,"2,635.31",380
,20131231,242.4,244,242.2,243.15,240,240.95,241.75,-3.05,-2.25,126,"3,046.22",378
bu1402,20131009,4458,4458,4598,4658,4470,4476,4532,18,74,318682,"1,444,431.30",65246
,20131010,4476,4532,4460,4522,4452,4502,4494,-30,-38,204880,"921,073.73",54008
,20131011,4502,4494,4510,4524,4456,4466,4492,-28,-2,180100,"809,156.86",60936
,20131014,4466,4492,4476,4490,4434,4444,4456,-48,-36,148998,"664,122.62",67386
,20131015,4444,4456,4448,4494,4436,4442,4462,-14,6,201544,"899,332.13",63700
,20131016,4442,4462,4428,4484,4428,4432,4452,-30,-10,206374,"918,818.82",67078
,20131017,4432,4452,4448,4460,4408,4410,4434,-42,-18,142864,"633,465.31",73002
,20131018,4410,4434,4412,4430,4402,4404,4414,-30,-20,88740,"391,792.92",75164
,20131021,4404,4414,4410,4466,4406,4452,4448,38,34,154962,"689,381.82",58838
,20131022,4452,4448,4444,4454,4428,4440,4436,-8,-12,57890,"256,906.35",56140
,20131023,4440,4436,4432,4444,4408,4436,4426,0,-10,85280,"377,453.06",54076
,20131024,4436,4426,4434,4482,4426,4458,4458,32,32,161110,"718,463.39",53534
,20131025,4458,4458,4460,4464,4406,4406,4420,-52,-38,115570,"510,926.61",40222
,20131028,4406,4420,4410,4412,4250,4268,4306,-152,-114,355282,"1,530,347.04",93932
,20131029,4268,4306,4266,4288,4248,4270,4264,-36,-42,231734,"988,547.33",92778
,20131030,4270,4264,4270,4328,4228,4316,4278,52,14,391474,"1,674,866.32",60394
,20131031,4316,4278,4308,4324,4288,4292,4304,14,26,128838,"554,643.62",53198
,20131101,4292,4304,4288,4340,4256,4310,4306,6,2,191472,"824,498.14",42912
,20131104,4310,4306,4280,4336,4276,4314,4314,8,8,93718,"404,414.76",42202
,20131105,4314,4314,4310,4332,4264,4308,4296,-6,-18,125920,"541,100.66",39746
,20131106,4308,4296,4300,4316,4290,4308,4304,12,8,71154,"306,283.93",41692
,20131107,4308,4304,4312,4324,4268,4274,4292,-30,-12,113300,"486,358.17",61360
,20131108,4274,4292,4272,4284,4252,4260,4266,-32,-26,103258,"440,582.97",67934
,20131111,4260,4266,4262,4286,4254,4278,4272,12,6,61468,"262,623.84",63250
,20131112,4278,4272,4272,4308,4268,4304,4290,32,18,88114,"378,042.98",50388
,20131113,4304,4290,4280,4290,4262,4286,4274,-4,-16,65264,"278,983.74",52474
,20131114,4286,4274,4298,4302,4264,4266,4284,-8,10,51534,"220,866.85",56440
,20131115,4266,4284,4266,4284,4246,4270,4268,-14,-16,105770,"451,506.16",56028
,20131118,4270,4268,4278,4314,4272,4292,4294,24,26,49598,"212,976.78",51044
,20131119,4292,4294,4280,4306,4264,4296,4284,2,-10,72202,"309,445.55",53148
,20131120,4296,4284,4296,4326,4296,4310,4310,26,26,75654,"326,124.87",52326
,20131121,4310,4310,4306,4312,4288,4298,4300,-12,-10,33340,"143,374.10",50446
,20131122,4298,4300,4312,4350,4308,4338,4322,38,22,75342,"325,729.89",50256
,20131125,4338,4322,4336,4368,4316,4356,4338,34,16,84024,"364,509.48",51864
,20131126,4356,4338,4360,4444,4350,4370,4400,32,62,221656,"975,664.94",47304
,20131127,4370,4400,4366,4384,4332,4336,4348,-64,-52,76758,"333,890.84",43306
,20131128,4336,4348,4330,4358,4318,4346,4340,-2,-8,47474,"206,071.42",38930
,20131129,4346,4340,4352,4366,4332,4352,4348,12,8,41974,"182,580.90",36782
,20131202,4352,4348,4362,4372,4340,4354,4352,6,4,46012,"200,305.19",38472
,20131203,4354,4352,4360,4410,4352,4382,4380,30,28,81870,"358,712.12",41354
,20131204,4382,4380,4408,4412,4378,4388,4396,8,16,93100,"409,279.52",46282
,20131205,4388,4396,4398,4406,4372,4376,4386,-20,-10,57462,"252,044.10",39522
,20131206,4376,4386,4382,4430,4360,4424,4402,38,16,135882,"598,262.75",59890
,20131209,4424,4402,4426,4442,4376,4396,4406,-6,4,119214,"525,450.63",46882
,20131210,4396,4406,4398,4408,4380,4388,4392,-18,-14,50566,"222,135.88",46356
,20131211,4388,4392,4390,4404,4380,4390,4390,-2,-2,33290,"146,199.04",44676
,20131212,4390,4390,4398,4420,4372,4388,4392,-2,2,79410,"348,891.03",49622
,20131213,4388,4392,4388,4388,4302,4370,4352,-22,-40,86970,"378,583.15",46132
,20131216,4370,4352,4378,4382,4334,4360,4358,8,6,34804,"151,679.44",42952
,20131217,4360,4358,4360,4364,4328,4330,4344,-28,-14,35108,"152,514.35",42262
,20131218,4330,4344,4330,4340,4314,4334,4328,-10,-16,22778,"98,610.72",41638
,20131219,4334,4328,4334,4350,4326,4326,4336,-2,8,14012,"60,756.38",40540
,20131220,4326,4336,4326,4350,4314,4316,4328,-20,-8,30948,"133,973.60",43002
,20131223,4316,4328,4314,4330,4306,4330,4320,2,-8,22338,"96,501.77",41614
,20131224,4330,4320,4328,4334,4316,4326,4326,6,6,15596,"67,473.16",41882
,20131225,4326,4326,4326,4356,4324,4338,4336,12,10,16528,"71,690.39",43250
,20131226,4338,4336,4342,4344,4268,4282,4304,-54,-32,66716,"287,159.70",51334
,20131227,4282,4304,4276,4328,4262,4316,4298,12,-6,57464,"247,013.77",43832
,20131230,4316,4298,4320,4340,4312,4334,4326,36,28,22012,"95,266.29",38628
,20131231,4334,4326,4320,4324,4292,4304,4308,-22,-18,23528,"101,385.77",40424
bu1403,20131009,4458,4458,4650,4656,4528,4528,4604,70,146,26584,"122,396.16",4456
,20131010,4528,4604,4504,4568,4502,4546,4542,-58,-62,5788,"26,295.43",4218
,20131011,4546,4542,4560,4570,4512,4522,4538,-20,-4,4240,"19,249.36",3214
,20131014,4522,4538,4528,4540,4484,4486,4512,-52,-26,2846,"12,845.37",2720
,20131015,4486,4512,4506,4544,4492,4498,4512,-14,0,3302,"14,899.40",2544
,20131016,4498,4512,4498,4532,4480,4488,4506,-24,-6,1374,"6,191.31",2442
,20131017,4488,4506,4492,4510,4466,4466,4486,-40,-20,574,"2,576.04",2484
,20131018,4466,4486,4460,4478,4448,4448,4464,-38,-22,1602,"7,152.84",2628
,20131021,4448,4464,4454,4504,4454,4500,4486,36,22,1314,"5,895.60",2424
,20131022,4500,4486,4484,4490,4468,4476,4474,-10,-12,422,"1,888.64",2488
,20131023,4476,4474,4480,4480,4446,4472,4468,-2,-6,422,"1,885.51",2498
,20131024,4472,4468,4476,4508,4468,4482,4492,14,24,944,"4,241.28",2330
,20131025,4482,4492,4490,4490,4440,4442,4452,-50,-40,616,"2,743.50",2166
,20131028,4442,4452,4446,4446,4274,4290,4332,-162,-120,2072,"8,978.25",2482
,20131029,4290,4332,4290,4310,4278,4296,4290,-36,-42,756,"3,244.58",2368
,20131030,4296,4290,4298,4340,4238,4312,4292,22,2,1566,"6,724.37",2204
,20131031,4312,4292,4300,4332,4300,4300,4310,8,18,568,"2,448.91",2282
,20131101,4300,4310,4288,4342,4276,4310,4314,0,4,814,"3,511.78",2338
,20131104,4310,4314,4316,4332,4294,4320,4320,6,6,1148,"4,959.39",2238
,20131105,4320,4320,4330,4338,4284,4312,4302,-8,-18,496,"2,134.31",2240
,20131106,4312,4302,4304,4324,4302,4308,4310,6,8,194,836.21,2246
,20131107,4308,4310,4324,4328,4286,4298,4300,-12,-10,394,"1,694.82",2168
,20131108,4298,4300,4284,4296,4270,4280,4282,-20,-18,284,"1,216.57",2208
,20131111,4280,4282,4270,4300,4270,4296,4286,14,4,174,745.8,2190
,20131112,4296,4286,4294,4316,4288,4308,4302,22,16,210,903.55,2228
,20131113,4308,4302,4290,4308,4276,4308,4290,6,-12,304,"1,304.50",2186
,20131114,4308,4290,4304,4328,4300,4300,4314,10,24,424,"1,829.66",2172
,20131115,4300,4314,4292,4314,4280,4292,4298,-22,-16,256,"1,100.64",2198
,20131118,4292,4298,4304,4330,4304,4312,4316,14,18,282,"1,217.30",2136
,20131119,4312,4316,4308,4322,4294,4314,4306,-2,-10,340,"1,464.44",2134
,20131120,4314,4306,4320,4346,4318,4334,4332,28,26,406,"1,758.94",2104
,20131121,4334,4332,4332,4336,4320,4322,4326,-10,-6,140,605.87,2106
,20131122,4322,4326,4336,4374,4336,4364,4350,38,24,264,"1,148.45",2098
,20131125,4364,4350,4340,4392,4340,4388,4358,38,8,674,"2,938.53",2074
,20131126,4388,4358,4408,4468,4372,4394,4422,36,64,3688,"16,311.92",1670
,20131127,4394,4422,4382,4392,4350,4356,4368,-66,-54,612,"2,673.24",1656
,20131128,4356,4368,4348,4368,4344,4364,4352,-4,-16,266,"1,157.80",1634
,20131129,4364,4352,4364,4374,4350,4370,4364,18,12,142,619.7,1626
,20131202,4370,4364,4374,4380,4360,4370,4366,6,2,198,864.59,1610
,20131203,4370,4366,4366,4408,4366,4386,4384,20,18,558,"2,447.30",1706
,20131204,4386,4384,4400,4412,4390,4396,4402,12,18,514,"2,263.50",1720
,20131205,4396,4402,4404,4404,4378,4378,4390,-24,-12,20,87.82,1714
,20131206,4378,4390,4382,4428,4370,4402,4400,12,10,764,"3,362.30",2106
,20131209,4402,4400,4402,4428,4378,4398,4400,-2,0,596,"2,622.94",2090
,20131210,4398,4400,4394,4406,4382,4388,4392,-12,-8,106,465.66,2050
,20131211,4388,4392,4390,4396,4384,4394,4388,2,-4,62,272.14,2044
,20131212,4394,4388,4388,4414,4374,4384,4388,-4,0,502,"2,203.60",2006
,20131213,4384,4388,4380,4388,4328,4374,4358,-14,-30,880,"3,836.79",1718
,20131216,4374,4358,4386,4388,4350,4374,4372,16,14,70,306.06,1720
,20131217,4374,4372,4366,4370,4342,4342,4356,-30,-16,284,"1,237.13",1714
,20131218,4342,4356,4340,4356,4334,4356,4344,0,-12,266,"1,155.56",1714
,20131219,4356,4344,4356,4358,4338,4338,4348,-6,4,100,434.92,1706
,20131220,4338,4348,4338,4356,4330,4330,4340,-18,-8,94,408.03,1688
,20131223,4330,4340,4322,4352,4322,4336,4328,-4,-12,336,"1,454.41",1582
,20131224,4336,4328,4332,4334,4324,4334,4330,6,2,192,831.41,1558
,20131225,4334,4330,4340,4358,4334,4334,4344,4,14,144,625.75,1576
,20131226,4334,4344,4348,4348,4288,4300,4318,-44,-26,512,"2,211.24",1624
,20131227,4300,4318,4300,4344,4286,4332,4316,14,-2,536,"2,314.36",1674
,20131230,4332,4316,4334,4360,4332,4360,4346,44,30,120,521.55,1680
,20131231,4360,4346,4342,4346,4322,4322,4332,-24,-14,150,649.96,1724
bu1404,20131016,4512,4512,4508,4508,4508,4508,4508,-4,-4,2,9.02,2
,20131017,4508,4508,,,,4488,4488,-20,-20,0,0,2
,20131018,4488,4488,,,,4466,4466,-22,-22,0,0,2
,20131021,4466,4466,,,,4488,4488,22,22,0,0,2
,20131022,4488,4488,,,,4476,4476,-12,-12,0,0,2
,20131023,4476,4476,,,,4470,4470,-6,-6,0,0,2
,20131024,4470,4470,,,,4494,4494,24,24,0,0,2
,20131025,4494,4494,,,,4454,4454,-40,-40,0,0,2
,20131028,4454,4454,,,,4334,4334,-120,-120,0,0,2
,20131029,4334,4334,,,,4292,4292,-42,-42,0,0,2
,20131030,4292,4292,4360,4360,4360,4360,4360,68,68,2,8.72,2
,20131031,4360,4360,,,,4378,4378,18,18,0,0,2
,20131101,4378,4378,,,,4382,4382,4,4,0,0,2
,20131104,4382,4382,,,,4388,4388,6,6,0,0,2
,20131105,4388,4388,,,,4344,4344,-44,-44,0,0,2
,20131106,4344,4344,,,,4352,4352,8,8,0,0,2
,20131107,4352,4352,,,,4342,4342,-10,-10,0,0,2
,20131108,4342,4342,4290,4290,4290,4290,4290,-52,-52,2,8.58,2
,20131111,4290,4290,,,,4294,4294,4,4,0,0,2
,20131112,4294,4294,,,,4310,4310,16,16,0,0,2
,20131113,4310,4310,,,,4298,4298,-12,-12,0,0,2
,20131114,4298,4298,,,,4322,4322,24,24,0,0,2
,20131115,4322,4322,,,,4306,4306,-16,-16,0,0,2
,20131118,4306,4306,,,,4324,4324,18,18,0,0,2
,20131119,4324,4324,4318,4318,4316,4316,4316,-8,-8,8,34.54,8
,20131120,4316,4316,,,,4342,4342,26,26,0,0,8
,20131121,4342,4342,,,,4336,4336,-6,-6,0,0,8
,20131122,4336,4336,,,,4360,4360,24,24,0,0,8
,20131125,4360,4360,,,,4368,4368,8,8,0,0,8
,20131126,4368,4368,4464,4464,4428,4428,4450,60,82,16,71.2,8
,20131127,4428,4450,4382,4382,4382,4382,4382,-68,-68,2,8.76,6
,20131128,4382,4382,,,,4366,4366,-16,-16,0,0,6
,20131129,4366,4366,,,,4378,4378,12,12,0,0,6
,20131202,4378,4378,,,,4378,4378,0,0,0,0,6
,20131203,4378,4378,,,,4396,4396,18,18,0,0,6
,20131204,4396,4396,4422,4428,4422,4424,4424,28,28,12,53.09,12
,20131205,4424,4424,4414,4414,4414,4414,4414,-10,-10,2,8.83,10
,20131206,4414,4414,4410,4416,4410,4416,4412,2,-2,10,44.13,2
,20131209,4416,4412,,,,4412,4412,0,0,0,0,2
,20131210,4412,4412,,,,4412,4412,0,0,0,0,2
,20131211,4412,4412,,,,4416,4416,4,4,0,0,2
,20131212,4416,4416,4442,4442,4412,4412,4428,-4,12,8,35.42,0
,20131213,4412,4428,4386,4386,4386,4386,4386,-42,-42,6,26.32,6
,20131216,4386,4386,4440,4440,4396,4396,4422,10,36,8,35.39,2
,20131217,4396,4422,4344,4378,4344,4376,4360,-46,-62,8,34.88,0
,20131218,4376,4360,,,,4360,4360,0,0,0,0,0
,20131219,4360,4360,,,,4360,4360,0,0,0,0,0
,20131220,4360,4360,,,,4360,4360,0,0,0,0,0
,20131223,4360,4360,,,,4360,4360,0,0,0,0,0
,20131224,4360,4360,4366,4366,4364,4364,4364,4,4,4,17.46,4
,20131225,4364,4364,4372,4372,4366,4366,4368,2,4,4,17.48,0
,20131226,4366,4368,4356,4356,4356,4356,4356,-12,-12,4,17.42,4
,20131227,4356,4356,4334,4358,4334,4358,4346,2,-10,4,17.38,2
,20131230,4358,4346,4362,4362,4362,4362,4362,16,16,2,8.72,0
,20131231,4362,4362,4358,4358,4354,4354,4356,-8,-6,4,17.42,4
bu1405,20131118,4306,4306,4310,4310,4310,4310,4310,4,4,20,86.2,20
,20131119,4310,4310,4310,4430,4306,4366,4334,56,24,110,476.89,12
,20131120,4366,4334,4314,4400,4314,4360,4364,26,30,40,174.59,16
,20131121,4360,4364,4368,4426,4350,4400,4386,36,22,16,70.18,18
,20131122,4400,4386,4332,4418,4332,4410,4370,24,-16,24,104.88,20
,20131125,4410,4370,4302,4404,4302,4398,4364,28,-6,204,890.38,84
,20131126,4398,4364,4372,4478,4370,4408,4414,44,50,406,"1,792.55",90
,20131127,4408,4414,4436,4438,4376,4398,4402,-16,-12,126,554.9,38
,20131128,4398,4402,4348,4414,4348,4382,4354,-20,-48,322,"1,402.53",302
,20131129,4382,4354,4396,4402,4370,4386,4386,32,32,46,201.76,304
,20131202,4386,4386,4372,4406,4370,4382,4386,-4,0,76,333.42,318
,20131203,4382,4386,4402,4446,4382,4386,4404,0,18,206,907.56,400
,20131204,4386,4404,4418,4440,4398,4418,4414,14,10,252,"1,112.64",454
,20131205,4418,4414,4416,4416,4402,4402,4408,-12,-6,18,79.34,454
,20131206,4402,4408,4394,4474,4374,4452,4420,44,12,526,"2,325.20",286
,20131209,4452,4420,4450,4500,4414,4422,4456,2,36,162,721.95,268
,20131210,4422,4456,4442,4444,4422,4428,4428,-28,-28,172,761.75,270
,20131211,4428,4428,4416,4444,4416,4422,4428,-6,0,50,221.41,274
,20131212,4422,4428,4430,4446,4422,4426,4432,-2,4,126,558.47,312
,20131213,4426,4432,4414,4430,4384,4428,4408,-4,-24,240,"1,058.02",374
,20131216,4428,4408,4432,4452,4408,4440,4428,32,20,156,690.96,310
,20131217,4440,4428,4440,4444,4418,4418,4432,-10,4,96,425.55,298
,20131218,4418,4432,4436,4438,4420,4430,4428,-2,-4,58,256.88,298
,20131219,4430,4428,4422,4444,4400,4420,4426,-8,-2,38,168.21,286
,20131220,4420,4426,4404,4454,4404,4434,4432,8,6,106,469.82,302
,20131223,4434,4432,4420,4444,4382,4440,4424,8,-8,198,876.11,326
,20131224,4440,4424,4444,4444,4430,4430,4434,6,10,8,35.48,326
,20131225,4430,4434,4456,4466,4442,4458,4458,24,24,58,258.58,284
,20131226,4458,4458,4440,4450,4384,4406,4408,-52,-50,194,855.44,332
,20131227,4406,4408,4408,4452,4406,4450,4432,42,24,108,478.81,280
,20131230,4450,4432,4448,4466,4448,4466,4460,34,28,32,142.75,258
,20131231,4466,4460,4434,4454,4416,4448,4436,-12,-24,60,266.16,252
bu1406,20131009,4458,4458,4640,4678,4610,4610,4648,152,190,1850,"8,600.70",700
,20131010,4610,4648,4606,4648,4586,4628,4620,-20,-28,406,"1,876.18",648
,20131011,4628,4620,4620,4640,4602,4602,4616,-18,-4,222,"1,025.18",564
,20131014,4602,4616,4600,4616,4586,4588,4598,-28,-18,194,892.1,498
,20131015,4588,4598,4780,4780,4596,4606,4630,8,32,252,"1,166.90",514
,20131016,4606,4630,4598,4638,4596,4598,4610,-32,-20,276,"1,272.50",478
,20131017,4598,4610,4608,4614,4570,4572,4586,-38,-24,150,688.05,440
,20131018,4572,4586,4568,4578,4560,4560,4568,-26,-18,80,365.54,408
,20131021,4560,4568,4560,4602,4560,4594,4590,26,22,148,679.42,398
,20131022,4594,4590,4590,4592,4584,4584,4586,-6,-4,32,146.77,410
,20131023,4584,4586,4592,4592,4574,4578,4578,-8,-8,180,824.25,496
,20131024,4578,4578,4564,4602,4564,4578,4586,0,8,146,669.82,508
,20131025,4578,4586,4556,4558,4542,4544,4550,-42,-36,134,609.7,496
,20131028,4544,4550,4542,4542,4376,4382,4450,-168,-100,250,"1,112.70",550
,20131029,4382,4450,4396,4402,4370,4378,4384,-72,-66,116,508.61,566
,20131030,4378,4384,4386,4408,4342,4392,4368,8,-16,290,"1,266.87",566
,20131031,4392,4368,4376,4396,4372,4394,4382,26,14,122,534.84,608
,20131101,4394,4382,4374,4428,4360,4406,4404,24,22,192,845.67,626
,20131104,4406,4404,4390,4412,4390,4404,4404,0,0,88,387.6,658
,20131105,4404,4404,4428,4428,4362,4398,4378,-6,-26,912,"3,993.28",1318
,20131106,4398,4378,4388,4414,4382,4394,4398,16,20,300,"1,319.43",1450
,20131107,4394,4398,4406,4406,4362,4362,4380,-36,-18,452,"1,979.91",1406
,20131108,4362,4380,4358,4376,4348,4352,4358,-28,-22,692,"3,015.74",1866
,20131111,4352,4358,4282,4376,4282,4376,4354,18,-4,174,757.91,1888
,20131112,4376,4354,4364,4368,4330,4360,4344,6,-10,416,"1,807.55",2086
,20131113,4360,4344,4348,4360,4336,4356,4346,12,2,160,695.4,2106
,20131114,4356,4346,4406,4406,4350,4352,4358,6,12,208,906.52,2108
,20131115,4352,4358,4346,4370,4344,4368,4356,10,-2,152,662.13,2142
,20131118,4368,4356,4370,4396,4370,4374,4380,18,24,80,350.52,2154
,20131119,4374,4380,4382,4388,4364,4380,4376,0,-4,92,402.69,2160
,20131120,4380,4376,4386,4402,4378,4400,4392,24,16,282,"1,238.75",2020
,20131121,4400,4392,4382,4402,4380,4392,4394,0,2,104,457.14,1982
,20131122,4392,4394,4412,4430,4402,4430,4414,36,20,52,229.62,1976
,20131125,4430,4414,4414,4450,4410,4448,4422,34,8,120,530.87,1916
,20131126,4448,4422,4460,4524,4460,4478,4496,56,74,2174,"9,775.02",1056
,20131127,4478,4496,4476,4482,4444,4468,4460,-28,-36,160,713.88,1058
,20131128,4468,4460,4450,4468,4442,4462,4454,2,-6,56,249.48,1052
,20131129,4462,4454,4462,4472,4452,4456,4460,2,6,172,767.21,1056
,20131202,4456,4460,4446,4468,4446,4454,4462,-6,2,110,490.84,1056
,20131203,4454,4462,4468,4498,4460,4472,4466,10,4,376,"1,679.75",1252
,20131204,4472,4466,4472,4486,4464,4478,4480,12,14,246,"1,102.23",1300
,20131205,4478,4480,4466,4478,4462,4468,4470,-12,-10,96,429.29,1282
,20131206,4468,4470,4462,4506,4438,4490,4476,20,6,498,"2,229.52",1346
,20131209,4490,4476,4480,4504,4468,4476,4486,0,10,372,"1,668.95",1506
,20131210,4476,4486,4486,4486,4468,4468,4474,-18,-12,124,554.9,1526
,20131211,4468,4474,4470,4478,4464,4464,4472,-10,-2,50,223.65,1524
,20131212,4464,4472,4476,4498,4468,4484,4480,12,8,130,582.4,1538
,20131213,4484,4480,4480,4488,4432,4486,4462,6,-18,890,"3,972.19",1418
,20131216,4486,4462,4486,4488,4466,4488,4476,26,14,330,"1,477.26",1404
,20131217,4488,4476,4476,4500,4468,4478,4480,2,4,238,"1,066.67",1384
,20131218,4478,4480,4472,4496,4472,4482,4488,2,8,524,"2,351.76",1404
,20131219,4482,4488,4490,4496,4484,4492,4488,4,0,144,646.49,1410
,20131220,4492,4488,4480,4504,4480,4484,4490,-4,2,180,808.33,1414
,20131223,4484,4490,4468,4496,4468,4496,4486,6,-4,68,305.12,1390
,20131224,4496,4486,4476,4502,4476,4494,4488,8,2,76,341.16,1392
,20131225,4494,4488,4492,4512,4492,4506,4504,18,16,130,585.64,1400
,20131226,4506,4504,4502,4512,4456,4468,4480,-36,-24,386,"1,729.30",1448
,20131227,4468,4480,4466,4512,4464,4502,4478,22,-2,326,"1,459.93",1408
,20131230,4502,4478,4496,4520,4494,4512,4508,34,30,154,694.4,1402
,20131231,4512,4508,4512,4512,4460,4462,4480,-46,-28,472,"2,114.91",1508
bu1409,20131009,4458,4458,4716,4716,4604,4612,4652,154,194,402,"1,870.65",124
,20131010,4612,4652,4602,4630,4602,4612,4612,-40,-40,74,341.4,128
,20131011,4612,4612,4620,4650,4620,4620,4636,8,24,64,296.8,112
,20131014,4620,4636,4622,4622,4594,4600,4606,-36,-30,10,46.08,110
,20131015,4600,4606,4610,4650,4610,4618,4626,12,20,16,74.04,108
,20131016,4618,4626,4624,4646,4604,4610,4620,-16,-6,24,110.91,106
,20131017,4610,4620,4610,4610,4592,4592,4602,-28,-18,8,36.83,104
,20131018,4592,4602,4574,4578,4564,4564,4574,-38,-28,28,128.08,104
,20131021,4564,4574,4580,4598,4580,4582,4586,8,12,30,137.64,106
,20131022,4582,4586,4582,4582,4578,4580,4580,-6,-6,6,27.48,104
,20131023,4580,4580,4570,4580,4568,4576,4574,-4,-6,14,64.05,106
,20131024,4576,4574,4602,4608,4602,4606,4604,32,30,6,27.63,106
,20131025,4606,4604,4592,4592,4566,4566,4572,-38,-32,16,73.16,104
,20131028,4566,4572,4560,4560,4404,4434,4488,-138,-84,98,439.82,112
,20131029,4434,4488,4440,4448,4430,4430,4440,-58,-48,44,195.4,88
,20131030,4430,4440,4420,4428,4372,4412,4398,-28,-42,74,325.59,84
,20131031,4412,4398,4384,4398,4378,4398,4386,0,-12,16,70.18,80
,20131101,4398,4386,4370,4398,4370,4398,4378,12,-8,16,70.06,84
,20131104,4398,4378,4398,4414,4398,4402,4402,24,24,10,44.04,82
,20131105,4402,4402,4434,4434,4342,4410,4368,8,-34,152,663.96,98
,20131106,4410,4368,4406,4406,4404,4404,4404,36,36,14,61.66,86
,20131107,4404,4404,4394,4396,4384,4384,4390,-20,-14,12,52.7,78
,20131108,4384,4390,4346,4396,4346,4386,4386,-4,-4,14,61.42,80
,20131111,4386,4386,4384,4384,4366,4366,4374,-20,-12,10,43.75,74
,20131112,4366,4374,,,,4374,4374,0,0,0,0,74
,20131113,4374,4374,,,,4374,4374,0,0,0,0,74
,20131114,4374,4374,,,,4374,4374,0,0,0,0,74
,20131115,4374,4374,4384,4384,4384,4384,4384,10,10,4,17.54,74
,20131118,4384,4384,4402,4402,4402,4402,4402,18,18,2,8.8,76
,20131119,4402,4402,4400,4400,4396,4396,4398,-6,-4,4,17.59,78
,20131120,4396,4398,4426,4426,4420,4420,4422,22,24,4,17.69,76
,20131121,4420,4422,,,,4422,4422,0,0,0,0,76
,20131122,4422,4422,,,,4422,4422,0,0,0,0,76
,20131125,4422,4422,4428,4428,4428,4428,4428,6,6,2,8.86,78
,20131126,4428,4428,4476,4492,4464,4464,4482,36,54,18,80.7,72
,20131127,4464,4482,4436,4436,4436,4436,4436,-46,-46,2,8.87,70
,20131128,4436,4436,4432,4444,4426,4444,4434,8,-2,10,44.34,74
,20131129,4444,4434,4448,4448,4442,4442,4444,8,10,4,17.78,74
,20131202,4442,4444,,,,4444,4444,0,0,0,0,74
,20131203,4444,4444,4484,4486,4444,4466,4470,22,26,18,80.47,70
,20131204,4466,4470,4470,4470,4470,4470,4470,0,0,2,8.94,68
,20131205,4470,4470,,,,4470,4470,0,0,0,0,68
,20131206,4470,4470,4462,4506,4462,4498,4496,28,26,34,152.88,66
,20131209,4498,4496,,,,4480,4480,-16,-16,0,0,66
,20131210,4480,4480,4484,4484,4484,4484,4484,4,4,4,17.94,62
,20131211,4484,4484,,,,4484,4484,0,0,0,0,62
,20131212,4484,4484,,,,4484,4484,0,0,0,0,62
,20131213,4484,4484,4458,4458,4408,4408,4426,-76,-58,12,53.13,58
,20131216,4408,4426,4456,4456,4428,4430,4438,4,12,6,26.63,56
,20131217,4430,4438,4438,4438,4438,4438,4438,0,0,2,8.88,54
,20131218,4438,4438,4426,4428,4422,4428,4424,-10,-14,8,35.4,62
,20131219,4428,4424,4424,4424,4424,4424,4424,0,0,4,17.7,60
,20131220,4424,4424,4418,4418,4418,4418,4418,-6,-6,2,8.84,58
,20131223,4418,4418,4424,4424,4412,4414,4416,-4,-2,6,26.5,60
,20131224,4414,4416,,,,4416,4416,0,0,0,0,60
,20131225,4416,4416,,,,4424,4424,8,8,0,0,60
,20131226,4424,4424,4424,4424,4420,4420,4420,-4,-4,10,44.21,54
,20131227,4420,4420,4380,4420,4380,4420,4396,0,-24,18,79.15,64
,20131230,4420,4396,4436,4436,4436,4436,4436,40,40,2,8.87,64
,20131231,4436,4436,,,,4436,4436,0,0,0,0,64
bu1412,20131009,4458,4458,4676,4676,4538,4538,4602,80,144,286,"1,316.65",222
,20131010,4538,4602,4548,4560,4532,4540,4544,-62,-58,32,145.44,236
,20131011,4540,4544,4558,4558,4504,4510,4520,-34,-24,54,244.18,236
,20131014,4510,4520,4512,4522,4482,4488,4502,-32,-18,24,108.08,238
,20131015,4488,4502,4482,4520,4482,4486,4496,-16,-6,56,251.85,242
,20131016,4486,4496,4498,4514,4486,4488,4494,-8,-2,56,251.66,240
,20131017,4488,4494,4472,4474,4472,4474,4472,-20,-22,6,26.84,242
,20131018,4474,4472,4462,4464,4448,4452,4452,-20,-20,38,169.23,238
,20131021,4452,4452,4488,4488,4472,4480,4482,28,30,10,44.82,236
,20131022,4480,4482,4474,4476,4464,4474,4470,-8,-12,28,125.21,232
,20131023,4474,4470,4474,4474,4456,4464,4462,-6,-8,20,89.25,232
,20131024,4464,4462,4476,4510,4476,4482,4486,20,24,22,98.72,236
,20131025,4482,4486,4486,4486,4412,4424,4428,-62,-58,166,735.11,336
,20131028,4424,4428,4404,4410,4322,4322,4386,-106,-42,194,851.19,246
,20131029,4322,4386,4326,4330,4308,4330,4316,-56,-70,32,138.15,250
,20131030,4330,4316,4332,4366,4298,4352,4330,36,14,36,155.94,246
,20131031,4352,4330,4350,4350,4332,4332,4338,2,8,10,43.39,248
,20131101,4332,4338,4332,4358,4308,4340,4336,2,-2,30,130.1,246
,20131104,4340,4336,4338,4354,4330,4332,4338,-4,2,22,95.44,244
,20131105,4332,4338,4320,4336,4316,4336,4320,-2,-18,38,164.22,240
,20131106,4336,4320,4328,4346,4328,4346,4334,26,14,8,34.68,236
,20131107,4346,4334,4344,4344,4308,4318,4326,-16,-8,18,77.88,242
,20131108,4318,4326,4318,4318,4300,4310,4308,-16,-18,10,43.1,248
,20131111,4310,4308,4284,4320,4282,4320,4302,12,-6,22,94.68,248
,20131112,4320,4302,4320,4326,4318,4326,4320,24,18,16,69.13,244
,20131113,4326,4320,4308,4312,4304,4312,4308,-8,-12,8,34.47,248
,20131114,4312,4308,4324,4330,4312,4312,4320,4,12,10,43.2,250
,20131115,4312,4320,4308,4320,4304,4320,4310,0,-10,12,51.74,252
,20131118,4320,4310,4328,4328,4328,4328,4328,18,18,2,8.66,252
,20131119,4328,4328,4330,4342,4316,4342,4322,14,-6,20,86.48,254
,20131120,4342,4322,4344,4352,4344,4352,4346,30,24,6,26.08,248
,20131121,4352,4346,4352,4352,4352,4352,4352,6,6,2,8.7,250
,20131122,4352,4352,4360,4376,4352,4376,4362,24,10,8,34.91,246
,20131125,4376,4362,4392,4392,4358,4392,4380,30,18,12,52.57,250
,20131126,4392,4380,4398,4430,4380,4402,4404,22,24,90,396.49,222
,20131127,4402,4404,4360,4416,4360,4408,4392,4,-12,8,35.14,224
,20131128,4408,4392,,,,4392,4392,0,0,0,0,224
,20131129,4392,4392,4414,4414,4390,4412,4400,20,8,20,88.01,226
,20131202,4412,4400,4414,4414,4400,4414,4406,14,6,14,61.69,222
,20131203,4414,4406,4420,4450,4420,4442,4432,36,26,18,79.81,222
,20131204,4442,4432,4442,4456,4434,4436,4438,4,6,24,106.55,216
,20131205,4436,4438,4444,4448,4422,4428,4434,-10,-4,14,62.1,214
,20131206,4428,4434,4426,4466,4426,4466,4444,32,10,22,97.81,214
,20131209,4466,4444,4464,4470,4432,4432,4460,-12,16,22,98.14,212
,20131210,4432,4460,4422,4468,4422,4468,4446,8,-14,38,168.98,240
,20131211,4468,4446,4480,4480,4450,4454,4458,8,12,18,80.24,230
,20131212,4454,4458,4460,4472,4460,4472,4468,14,10,10,44.7,220
,20131213,4472,4468,4434,4434,4388,4420,4414,-48,-54,18,79.45,222
,20131216,4420,4414,4432,4480,4416,4434,4436,20,22,44,195.18,206
,20131217,4434,4436,4414,4414,4414,4414,4414,-22,-22,2,8.83,206
,20131218,4414,4414,4408,4448,4404,4448,4406,34,-8,82,361.38,136
,20131219,4448,4406,4404,4432,4400,4432,4406,26,0,14,61.7,128
,20131220,4432,4406,4428,4428,4382,4382,4404,-24,-2,4,17.62,128
,20131223,4382,4404,4416,4416,4416,4416,4416,12,12,2,8.83,130
,20131224,4416,4416,4412,4428,4364,4364,4410,-52,-6,36,158.77,100
,20131225,4364,4410,4418,4450,4418,4420,4428,10,18,8,35.43,100
,20131226,4420,4428,4402,4402,4402,4402,4402,-26,-26,4,17.61,102
,20131227,4402,4402,,,,4402,4402,0,0,0,0,102
,20131230,4402,4402,4410,4422,4408,4412,4412,10,10,10,44.12,96
,20131231,4412,4412,4404,4404,4404,4404,4404,-8,-8,2,8.81,96
bu1503,20131009,4458,4458,4678,4678,4612,4620,4642,162,184,240,"1,114.35",48
,20131010,4620,4642,4614,4680,4596,4622,4626,-20,-16,14,64.77,44
,20131011,4622,4626,4602,4602,4602,4602,4602,-24,-24,2,9.2,44
,20131014,4602,4602,,,,4602,4602,0,0,0,0,44
,20131015,4602,4602,,,,4602,4602,0,0,0,0,44
,20131016,4602,4602,4582,4582,4582,4582,4582,-20,-20,2,9.16,46
,20131017,4582,4582,,,,4582,4582,0,0,0,0,46
,20131018,4582,4582,4546,4546,4544,4544,4544,-38,-38,6,27.27,46
,20131021,4544,4544,,,,4544,4544,0,0,0,0,46
,20131022,4544,4544,,,,4558,4558,14,14,0,0,46
,20131023,4558,4558,,,,4558,4558,0,0,0,0,46
,20131024,4558,4558,4594,4594,4594,4594,4594,36,36,2,9.19,46
,20131025,4594,4594,,,,4594,4594,0,0,0,0,46
,20131028,4594,4594,4478,4488,4444,4444,4462,-150,-132,28,124.97,62
,20131029,4444,4462,4412,4412,4412,4412,4412,-50,-50,6,26.47,56
,20131030,4412,4412,4414,4460,4388,4442,4426,30,14,24,106.24,40
,20131031,4442,4426,4430,4430,4430,4430,4430,4,4,2,8.86,38
,20131101,4430,4430,,,,4430,4430,0,0,0,0,38
,20131104,4430,4430,,,,4432,4432,2,2,0,0,38
,20131105,4432,4432,,,,4432,4432,0,0,0,0,38
,20131106,4432,4432,,,,4432,4432,0,0,0,0,38
,20131107,4432,4432,4422,4422,4400,4400,4412,-32,-20,12,52.95,34
,20131108,4400,4412,,,,4400,4400,-12,-12,0,0,34
,20131111,4400,4400,,,,4400,4400,0,0,0,0,34
,20131112,4400,4400,4374,4374,4366,4366,4370,-34,-30,6,26.23,30
,20131113,4366,4370,,,,4370,4370,0,0,0,0,30
,20131114,4370,4370,,,,4370,4370,0,0,0,0,30
,20131115,4370,4370,,,,4370,4370,0,0,0,0,30
,20131118,4370,4370,,,,4388,4388,18,18,0,0,30
,20131119,4388,4388,,,,4382,4382,-6,-6,0,0,30
,20131120,4382,4382,,,,4386,4386,4,4,0,0,30
,20131121,4386,4386,,,,4386,4386,0,0,0,0,30
,20131122,4386,4386,,,,4386,4386,0,0,0,0,30
,20131125,4386,4386,,,,4404,4404,18,18,0,0,30
,20131126,4404,4404,4476,4520,4420,4420,4486,16,82,16,71.78,30
,20131127,4420,4486,4442,4484,4442,4484,4474,-2,-12,10,44.76,24
,20131128,4484,4474,4426,4434,4426,4434,4430,-40,-44,4,17.72,24
,20131129,4434,4430,4444,4446,4444,4446,4444,16,14,8,35.56,24
,20131202,4446,4444,,,,4444,4444,0,0,0,0,24
,20131203,4444,4444,4466,4480,4454,4454,4466,10,22,8,35.73,22
,20131204,4454,4466,,,,4472,4472,6,6,0,0,22
,20131205,4472,4472,,,,4472,4472,0,0,0,0,22
,20131206,4472,4472,4454,4540,4444,4540,4500,68,28,32,144.02,26
,20131209,4540,4500,4512,4574,4512,4532,4538,32,38,18,81.71,32
,20131210,4532,4538,4574,4574,4502,4572,4550,34,12,26,118.35,34
,20131211,4572,4550,4560,4560,4550,4556,4552,6,2,12,54.64,34
,20131212,4556,4552,4594,4594,4572,4572,4578,20,26,10,45.79,26
,20131213,4572,4578,4484,4484,4478,4482,4482,-96,-96,16,71.71,30
,20131216,4482,4482,4510,4528,4510,4528,4518,46,36,4,18.08,30
,20131217,4528,4518,4500,4500,4500,4500,4500,-18,-18,6,27,30
,20131218,4500,4500,,,,4500,4500,0,0,0,0,30
,20131219,4500,4500,,,,4500,4500,0,0,0,0,30
,20131220,4500,4500,4526,4526,4526,4526,4526,26,26,2,9.05,32
,20131223,4526,4526,4440,4498,4440,4498,4478,-28,-48,14,62.71,36
,20131224,4498,4478,4482,4504,4482,4504,4492,26,14,4,17.97,38
,20131225,4504,4492,4526,4526,4454,4454,4490,-38,-2,4,17.96,40
,20131226,4454,4490,,,,4462,4462,-28,-28,0,0,40
,20131227,4462,4462,4464,4464,4464,4464,4464,2,2,2,8.93,40
,20131230,4464,4464,4504,4504,4504,4504,4504,40,40,2,9.01,42
,20131231,4504,4504,4476,4476,4476,4476,4476,-28,-28,2,8.95,42
bu1506,20131009,4458,4458,4622,4632,4622,4632,4626,174,168,4,18.51,4
,20131010,4632,4626,4588,4630,4588,4630,4608,4,-18,8,36.88,10
,20131011,4630,4608,,,,4608,4608,0,0,0,0,10
,20131014,4608,4608,4592,4598,4592,4598,4592,-10,-16,8,36.75,18
,20131015,4598,4592,,,,4592,4592,0,0,0,0,18
,20131016,4592,4592,,,,4592,4592,0,0,0,0,18
,20131017,4592,4592,,,,4592,4592,0,0,0,0,18
,20131018,4592,4592,4592,4592,4592,4592,4592,0,0,2,9.18,20
,20131021,4592,4592,4592,4614,4592,4608,4602,16,10,8,36.82,24
,20131022,4608,4602,4616,4616,4616,4616,4616,14,14,2,9.23,22
,20131023,4616,4616,,,,4616,4616,0,0,0,0,22
,20131024,4616,4616,4626,4636,4618,4636,4626,20,10,6,27.76,24
,20131025,4636,4626,4586,4604,4586,4588,4594,-38,-32,8,36.75,22
,20131028,4588,4594,4570,4570,4472,4472,4496,-122,-98,12,53.96,28
,20131029,4472,4496,4434,4468,4434,4468,4450,-28,-46,4,17.8,28
,20131030,4468,4450,4464,4464,4464,4464,4464,14,14,2,8.93,28
,20131031,4464,4464,4466,4476,4466,4470,4470,6,6,6,26.82,26
,20131101,4470,4470,4468,4510,4468,4502,4494,32,24,12,53.95,32
,20131104,4502,4494,,,,4494,4494,0,0,0,0,32
,20131105,4494,4494,,,,4494,4494,0,0,0,0,32
,20131106,4494,4494,,,,4494,4494,0,0,0,0,32
,20131107,4494,4494,4478,4506,4460,4472,4480,-22,-14,24,107.52,34
,20131108,4472,4480,4440,4454,4418,4454,4436,-26,-44,6,26.62,32
,20131111,4454,4436,,,,4436,4436,0,0,0,0,32
,20131112,4436,4436,,,,4448,4448,12,12,0,0,32
,20131113,4448,4448,,,,4448,4448,0,0,0,0,32
,20131114,4448,4448,,,,4448,4448,0,0,0,0,32
,20131115,4448,4448,4448,4466,4448,4462,4456,14,8,8,35.65,30
,20131118,4462,4456,,,,4456,4456,0,0,0,0,30
,20131119,4456,4456,,,,4456,4456,0,0,0,0,30
,20131120,4456,4456,4490,4490,4490,4490,4490,34,34,2,8.98,30
,20131121,4490,4490,,,,4496,4496,6,6,0,0,30
,20131122,4496,4496,,,,4506,4506,10,10,0,0,30
,20131125,4506,4506,,,,4506,4506,0,0,0,0,30
,20131126,4506,4506,4556,4614,4540,4540,4564,34,58,24,109.54,36
,20131127,4540,4564,,,,4552,4552,-12,-12,0,0,36
,20131128,4552,4552,4496,4496,4496,4496,4496,-56,-56,2,8.99,38
,20131129,4496,4496,,,,4500,4500,4,4,0,0,38
,20131202,4500,4500,,,,4500,4500,0,0,0,0,38
,20131203,4500,4500,4558,4558,4558,4558,4558,58,58,2,9.12,38
,20131204,4558,4558,,,,4558,4558,0,0,0,0,38
,20131205,4558,4558,,,,4554,4554,-4,-4,0,0,38
,20131206,4554,4554,,,,4582,4582,28,28,0,0,38
,20131209,4582,4582,,,,4566,4566,-16,-16,0,0,38
,20131210,4566,4566,,,,4566,4566,0,0,0,0,38
,20131211,4566,4566,,,,4566,4566,0,0,0,0,38
,20131212,4566,4566,,,,4566,4566,0,0,0,0,38
,20131213,4566,4566,4500,4504,4500,4504,4502,-62,-64,4,18.01,34
,20131216,4504,4502,,,,4508,4508,6,6,0,0,34
,20131217,4508,4508,,,,4508,4508,0,0,0,0,34
,20131218,4508,4508,,,,4508,4508,0,0,0,0,34
,20131219,4508,4508,,,,4508,4508,0,0,0,0,34
,20131220,4508,4508,,,,4494,4494,-14,-14,0,0,34
,20131223,4494,4494,4494,4494,4494,4494,4494,0,0,4,17.98,32
,20131224,4494,4494,4508,4508,4500,4500,4504,6,10,4,18.02,34
,20131225,4500,4504,,,,4512,4512,8,8,0,0,34
,20131226,4512,4512,,,,4502,4502,-10,-10,0,0,34
,20131227,4502,4502,4476,4486,4476,4486,4480,-16,-22,4,17.92,36
,20131230,4486,4480,,,,4482,4482,2,2,0,0,36
,20131231,4482,4482,4498,4498,4498,4498,4498,16,16,2,9,38
bu1509,20131009,4458,4458,4668,4668,4588,4628,4646,170,188,36,167.32,26
,20131010,4628,4646,,,,4646,4646,0,0,0,0,26
,20131011,4646,4646,4628,4628,4604,4604,4616,-42,-30,4,18.46,24
,20131014,4604,4616,4600,4608,4600,4608,4604,-8,-12,4,18.42,26
,20131015,4608,4604,4622,4622,4622,4622,4622,18,18,2,9.24,24
,20131016,4622,4622,,,,4622,4622,0,0,0,0,24
,20131017,4622,4622,4558,4558,4558,4558,4558,-64,-64,2,9.12,24
,20131018,4558,4558,4566,4566,4566,4566,4566,8,8,6,27.4,30
,20131021,4566,4566,,,,4568,4568,2,2,0,0,30
,20131022,4568,4568,4582,4582,4582,4582,4582,14,14,2,9.16,30
,20131023,4582,4582,4584,4584,4584,4584,4584,2,2,6,27.5,24
,20131024,4584,4584,4578,4610,4578,4610,4594,26,10,4,18.38,20
,20131025,4610,4594,4568,4568,4568,4568,4568,-26,-26,2,9.14,18
,20131028,4568,4568,4534,4534,4488,4488,4508,-80,-60,20,90.18,16
,20131029,4488,4508,,,,4506,4506,-2,-2,0,0,16
,20131030,4506,4506,,,,4506,4506,0,0,0,0,16
,20131031,4506,4506,4452,4452,4452,4452,4452,-54,-54,2,8.9,14
,20131101,4452,4452,,,,4452,4452,0,0,0,0,14
,20131104,4452,4452,,,,4452,4452,0,0,0,0,14
,20131105,4452,4452,,,,4452,4452,0,0,0,0,14
,20131106,4452,4452,4458,4458,4458,4458,4458,6,6,6,26.75,10
,20131107,4458,4458,4458,4458,4440,4440,4448,-18,-10,4,17.8,8
,20131108,4440,4448,,,,4404,4404,-44,-44,0,0,8
,20131111,4404,4404,,,,4406,4406,2,2,0,0,8
,20131112,4406,4406,,,,4406,4406,0,0,0,0,8
,20131113,4406,4406,,,,4406,4406,0,0,0,0,8
,20131114,4406,4406,,,,4418,4418,12,12,0,0,8
,20131115,4418,4418,,,,4424,4424,6,6,0,0,8
,20131118,4424,4424,,,,4442,4442,18,18,0,0,8
,20131119,4442,4442,,,,4436,4436,-6,-6,0,0,8
,20131120,4436,4436,4480,4480,4480,4480,4480,44,44,2,8.96,6
,20131121,4480,4480,,,,4486,4486,6,6,0,0,6
,20131122,4486,4486,,,,4496,4496,10,10,0,0,6
,20131125,4496,4496,,,,4514,4514,18,18,0,0,6
,20131126,4514,4514,4582,4582,4508,4508,4544,-6,30,4,18.18,10
,20131127,4508,4544,4508,4508,4508,4508,4508,-36,-36,2,9.02,8
,20131128,4508,4508,,,,4452,4452,-56,-56,0,0,8
,20131129,4452,4452,,,,4466,4466,14,14,0,0,8
,20131202,4466,4466,,,,4466,4466,0,0,0,0,8
,20131203,4466,4466,,,,4522,4522,56,56,0,0,8
,20131204,4522,4522,,,,4528,4528,6,6,0,0,8
,20131205,4528,4528,,,,4524,4524,-4,-4,0,0,8
,20131206,4524,4524,,,,4552,4552,28,28,0,0,8
,20131209,4552,4552,,,,4552,4552,0,0,0,0,8
,20131210,4552,4552,4540,4540,4540,4540,4540,-12,-12,2,9.08,8
,20131211,4540,4540,,,,4540,4540,0,0,0,0,8
,20131212,4540,4540,,,,4540,4540,0,0,0,0,8
,20131213,4540,4540,4498,4498,4498,4498,4498,-42,-42,2,9,8
,20131216,4498,4498,,,,4498,4498,0,0,0,0,8
,20131217,4498,4498,,,,4498,4498,0,0,0,0,8
,20131218,4498,4498,,,,4468,4468,-30,-30,0,0,8
,20131219,4468,4468,,,,4468,4468,0,0,0,0,8
,20131220,4468,4468,,,,4468,4468,0,0,0,0,8
,20131223,4468,4468,,,,4468,4468,0,0,0,0,8
,20131224,4468,4468,,,,4468,4468,0,0,0,0,8
,20131225,4468,4468,,,,4468,4468,0,0,0,0,8
,20131226,4468,4468,4432,4432,4432,4432,4432,-36,-36,2,8.86,8
,20131227,4432,4432,,,,4444,4444,12,12,0,0,8
,20131230,4444,4444,,,,4444,4444,0,0,0,0,8
,20131231,4444,4444,,,,4446,4446,2,2,0,0,8
bu1512,20131217,4498,4498,,,,4480,4480,-18,-18,0,0,0
,20131218,4480,4480,,,,4472,4472,-8,-8,0,0,0
,20131219,4472,4472,,,,4472,4472,0,0,0,0,0
,20131220,4472,4472,,,,4496,4496,24,24,0,0,0
,20131223,4496,4496,,,,4496,4496,0,0,0,0,0
,20131224,4496,4496,,,,4506,4506,10,10,0,0,0
,20131225,4506,4506,,,,4502,4502,-4,-4,0,0,0
,20131226,4502,4502,4410,4480,4410,4480,4444,-22,-58,4,17.78,2
,20131227,4480,4444,,,,4422,4422,-22,-22,0,0,2
,20131230,4422,4422,,,,4422,4422,0,0,0,0,2
,20131231,4422,4422,,,,4422,4422,0,0,0,0,2
cu1301,20130104,57200,57200,58000,58000,57600,57730,57710,530,510,8820,"254,529.55",23750
,20130107,57730,57710,57580,57720,57500,57630,57640,-80,-70,7250,"208,957.95",23220
,20130108,57630,57640,57760,57780,57540,57660,57710,20,70,5290,"152,652.45",21960
,20130109,57660,57710,57680,57690,57570,57690,57640,-20,-70,3470,"100,018.80",20580
,20130110,57690,57640,57630,58000,57620,58000,57760,360,120,6760,"195,242.05",17890
,20130111,58000,57760,57800,58200,57750,57800,57940,40,180,5830,"168,921.45",14850
,20130114,57800,57940,57700,57850,57650,57750,57730,-190,-210,7030,"202,955.60",10820
,20130115,57750,57730,57490,57530,55400,57150,57350,-580,-380,5100,"146,261.55",8690
cu1302,20130104,57690,57520,58570,58570,57890,57900,58000,380,480,15976,"463,364.11",50944
,20130107,57900,58000,57890,58030,57700,57900,57900,-100,-100,7476,"216,449.26",51094
,20130108,57900,57900,57900,58050,57780,57920,57940,20,40,8616,"249,611.77",52026
,20130109,57920,57940,57940,57970,57810,57900,57870,-40,-70,6490,"187,791.68",53714
,20130110,57900,57870,57940,58310,57800,58310,58070,440,200,10050,"291,813.89",54662
,20130111,58310,58070,58330,58460,58020,58060,58210,-10,140,15112,"439,874.45",53740
,20130114,58060,58210,57860,58210,57860,58100,58020,-110,-190,14702,"426,556.45",55168
,20130115,58100,58020,57760,57870,57270,57400,57650,-620,-370,15998,"461,205.18",57018
,20130116,57400,57650,57510,57740,57500,57650,57630,0,-20,17638,"508,308.26",53274
,20130117,57650,57630,57530,57580,57320,57420,57430,-210,-200,16292,"467,825.06",48714
,20130118,57420,57430,57860,58030,57760,57950,57860,520,430,15508,"448,666.37",45674
,20130121,57950,57860,57900,57930,57790,57840,57840,-20,-20,6894,"199,400.20",44944
,20130122,57840,57840,57920,58340,57900,58290,58130,450,290,14078,"409,206.49",41578
,20130123,58290,58130,58350,58370,58100,58170,58150,40,20,8342,"242,549.15",40334
,20130124,58170,58150,58090,58190,57980,58100,58050,-50,-100,11474,"333,056.95",38704
,20130125,58100,58050,58090,58350,58090,58260,58270,210,220,9344,"272,248.75",37656
,20130128,58260,58270,58000,58140,57980,58130,58070,-140,-200,9380,"272,362.55",35682
,20130129,58130,58070,58130,58350,57990,58330,58130,260,60,14068,"408,931.65",32850
,20130130,58330,58130,58400,58670,58290,58620,58580,490,450,16276,"476,787.17",27490
,20130131,58620,58580,58950,59180,58790,58850,58880,270,300,11224,"330,444.74",24170
,20130201,58850,58880,58900,58970,58750,58970,58830,90,-50,6590,"193,854.25",22970
,20130204,58970,58830,59230,59500,59170,59170,59320,340,490,7390,"219,223.05",20020
,20130205,59170,59320,59080,59180,59000,59010,59070,-310,-250,6580,"194,361.20",17630
,20130206,59010,59070,59050,59260,58960,58990,59090,-80,20,3900,"115,233.45",16340
,20130207,58990,59090,58720,58900,58640,58900,58730,-190,-360,3350,"98,377.50",14890
,20130208,58900,58730,58880,59020,58800,58920,58930,190,200,1950,"57,465.90",13630
,20130218,58920,58930,58600,58650,58150,58390,58480,-540,-450,4950,"144,754.20",12230
cu1303,20130104,57770,57690,58500,58550,58090,58210,58240,520,550,34450,"1,003,274.40",98980
,20130107,58210,58240,58200,58270,57900,58090,58120,-150,-120,28086,"816,271.34",96638
,20130108,58090,58120,58140,58290,57990,58140,58160,20,40,23166,"673,669.03",94704
,20130109,58140,58160,58230,58260,58020,58160,58110,0,-50,12818,"372,436.30",94976
,20130110,58160,58110,58130,58550,58040,58540,58300,430,190,24372,"710,558.56",92516
,20130111,58540,58300,58570,58730,58230,58250,58430,-50,130,25324,"739,856.82",86878
,20130114,58250,58430,58120,58480,58110,58320,58240,-110,-190,20604,"600,039.08",84596
,20130115,58320,58240,58040,58100,57550,57580,57840,-660,-400,24378,"705,073.26",84556
,20130116,57580,57840,57740,57970,57610,57830,57830,-10,-10,13198,"381,644.36",84486
,20130117,57830,57830,57740,57770,57450,57620,57590,-210,-240,11828,"340,599.66",83740
,20130118,57620,57590,58010,58260,57940,58150,58080,560,490,17352,"503,975.79",80514
,20130121,58150,58080,58190,58190,57970,58000,58040,-80,-40,9794,"284,261.49",78682
,20130122,58000,58040,58120,58560,58060,58480,58330,440,290,17170,"500,797.35",72716
,20130123,58480,58330,58520,58540,58290,58400,58360,70,30,7720,"225,300.42",72374
,20130124,58400,58360,58270,58400,58160,58290,58250,-70,-110,10632,"309,676.65",70682
,20130125,58290,58250,58280,58560,58270,58470,58480,220,230,7540,"220,479.43",68450
,20130128,58470,58480,58180,58370,58170,58290,58270,-190,-210,8264,"240,792.67",68014
,20130129,58290,58270,58240,58550,58160,58490,58320,220,50,14956,"436,184.54",66420
,20130130,58490,58320,58620,58950,58500,58850,58840,530,520,22690,"667,627.36",63432
,20130131,58850,58840,59100,59320,59020,59230,59150,390,310,14194,"419,809.74",61654
,20130201,59230,59150,59150,59360,58980,59270,59120,120,-30,10918,"322,751.90",61344
,20130204,59270,59120,59540,59850,59470,59510,59600,390,480,16018,"477,407.72",59694
,20130205,59510,59600,59370,59540,59250,59280,59380,-320,-220,13560,"402,606.19",58468
,20130206,59280,59380,59380,59630,59260,59340,59410,-40,30,9372,"278,411.13",58776
,20130207,59340,59410,59220,59260,59020,59200,59100,-210,-310,10006,"295,695.49",59888
,20130208,59200,59100,59060,59390,59010,59200,59250,100,150,6466,"191,578.02",58794
,20130218,59200,59250,59230,59240,58500,58500,58720,-750,-530,16206,"475,813.34",57932
,20130219,58500,58720,58400,58650,58400,58430,58520,-290,-200,17704,"518,076.25",55388
,20130220,58430,58520,58430,58500,58240,58340,58350,-180,-170,27520,"802,981.89",52716
,20130221,58340,58350,57740,57740,57070,57410,57380,-940,-970,33696,"966,741.89",45042
,20130222,57410,57380,57100,57520,57100,57420,57390,40,10,13872,"398,066.52",44640
,20130225,57420,57390,57150,57190,56880,57050,57070,-340,-320,14634,"417,605.56",42644
,20130226,57050,57070,56920,57160,56900,56910,57060,-160,-10,15336,"437,561.37",39670
,20130227,56910,57060,57280,57430,57220,57250,57320,190,260,13840,"396,686.32",38216
,20130228,57250,57320,57300,57430,57260,57400,57370,80,50,10980,"314,978.17",37490
,20130301,57400,57370,56910,56960,56470,56590,56680,-780,-690,8430,"238,920.45",35560
,20130304,56590,56680,56400,56500,56070,56260,56260,-420,-420,9560,"268,937.05",32180
,20130305,56260,56260,56300,57690,56300,56820,56640,560,380,5940,"168,221.95",31200
,20130306,56820,56640,56900,56950,56550,56580,56690,-60,50,5850,"165,830.55",30210
,20130307,56580,56690,56400,56420,56170,56380,56260,-310,-430,5400,"151,927.20",28640
,20130308,56380,56260,56590,56650,56500,56620,56580,360,320,3820,"108,077.00",26930
,20130311,56620,56580,56540,56640,56410,56410,56560,-170,-20,6880,"194,585.70",25820
,20130312,56410,56560,56620,56680,56330,56330,56540,-230,-20,8770,"247,935.05",22930
,20130313,56330,56540,57100,57100,56510,56750,56780,210,240,7300,"207,271.75",19120
,20130314,56750,56780,56710,56710,56400,56580,56480,-200,-300,4540,"128,216.05",16660
,20130315,56580,56480,56800,56910,56690,56910,56780,430,300,4530,"128,617.15",14590
cu1304,20130104,57860,57810,58610,58610,58210,58360,58370,550,560,176256,"5,144,802.81",151252
,20130107,58360,58370,58330,58450,58030,58220,58270,-150,-100,157236,"4,581,656.62",156320
,20130108,58220,58270,58290,58480,58100,58300,58320,30,50,173288,"5,053,540.96",157780
,20130109,58300,58320,58350,58360,58160,58340,58260,20,-60,106456,"3,101,090.17",156868
,20130110,58340,58260,58300,58820,58190,58780,58500,520,240,196634,"5,752,069.77",178408
,20130111,58780,58500,58850,58980,58400,58440,58660,-60,160,200560,"5,882,441.86",167190
,20130114,58440,58660,58280,58730,58270,58520,58480,-140,-180,148282,"4,335,789.99",164936
,20130115,58520,58480,58220,58300,57680,57700,58030,-780,-450,192938,"5,598,481.20",173152
,20130116,57700,58030,57890,58150,57770,57940,57990,-90,-40,161464,"4,681,747.39",161882
,20130117,57940,57990,57890,57940,57570,57740,57720,-250,-270,129554,"3,739,318.47",162000
,20130118,57740,57720,58170,58500,58100,58380,58270,660,550,128444,"3,742,578.46",155870
,20130121,58380,58270,58380,58380,58150,58190,58260,-80,-10,56068,"1,633,267.37",151780
,20130122,58190,58260,58280,58780,58260,58690,58560,430,300,96422,"2,823,312.97",143774
,20130123,58690,58560,58750,58790,58460,58590,58570,30,10,43190,"1,264,980.36",136708
,20130124,58590,58570,58480,58600,58310,58430,58420,-140,-150,44846,"1,310,157.83",131612
,20130125,58430,58420,58450,58750,58410,58640,58630,220,210,27422,"803,941.50",128036
,20130128,58640,58630,58360,58510,58320,58450,58410,-180,-220,20976,"612,697.08",125022
,20130129,58450,58410,58580,58740,58280,58610,58500,200,90,31476,"920,694.04",123222
,20130130,58610,58500,58780,59150,58670,59050,59010,550,510,31448,"927,896.69",118774
,20130131,59050,59010,59330,59510,59220,59450,59350,440,340,27032,"802,232.68",114912
,20130201,59450,59350,59230,59470,59130,59470,59290,120,-60,17988,"533,330.77",113596
,20130204,59470,59290,59880,60000,59650,59710,59800,420,510,27418,"819,903.92",106738
,20130205,59710,59800,59500,59770,59480,59550,59620,-250,-180,15188,"452,780.25",103144
,20130206,59550,59620,59610,59900,59500,59600,59690,-20,70,12722,"379,691.63",99186
,20130207,59600,59690,59520,59520,59250,59460,59360,-230,-330,11410,"338,691.76",96694
,20130208,59460,59360,59350,59660,59260,59480,59510,120,150,9514,"283,121.91",94520
,20130218,59480,59510,59400,59520,58720,58740,58980,-770,-530,16200,"477,770.48",91622
,20130219,58740,58980,58650,58920,58570,58620,58720,-360,-260,13530,"397,302.61",90742
,20130220,58620,58720,58620,58700,58410,58520,58560,-200,-160,13280,"388,843.25",90360
,20130221,58520,58560,57970,57970,57160,57540,57520,-1020,-1040,41280,"1,187,337.69",88230
,20130222,57540,57520,57440,57670,57300,57550,57550,30,30,15250,"438,867.00",87416
,20130225,57550,57550,57120,57330,57000,57200,57170,-350,-380,18166,"519,310.80",83256
,20130226,57200,57170,57050,57340,56960,57050,57180,-120,10,19736,"564,288.60",77846
,20130227,57050,57180,57410,57580,57360,57390,57490,210,310,14728,"423,388.40",74942
,20130228,57390,57490,57520,57680,57410,57550,57550,60,60,13530,"389,347.27",73258
,20130301,57550,57550,57150,57150,56550,56660,56830,-890,-720,18012,"511,856.36",69226
,20130304,56660,56830,56610,56650,56090,56300,56340,-530,-490,20292,"571,639.39",64460
,20130305,56300,56340,56710,56900,56610,56900,56720,560,380,9520,"269,992.55",63584
,20130306,56900,56720,56900,57040,56630,56660,56800,-60,80,8020,"227,783.24",62844
,20130307,56660,56800,56500,56540,56250,56490,56360,-310,-440,9858,"277,814.71",61666
,20130308,56490,56360,56600,56790,56570,56690,56670,330,310,6582,"186,530.40",60746
,20130311,56690,56670,56360,56790,56360,56500,56620,-170,-50,6872,"194,562.40",59980
,20130312,56500,56620,56730,56790,56310,56320,56530,-300,-90,9446,"267,016.44",59358
,20130313,56320,56530,56760,57060,56730,56730,56850,200,320,13596,"386,529.70",57186
,20130314,56730,56850,56680,56780,56380,56780,56510,-70,-340,17276,"488,183.10",55520
,20130315,56780,56510,56800,57150,56780,57050,56920,540,410,13056,"371,623.09",51730
,20130318,57050,56920,56400,56400,55070,55380,55420,-1540,-1500,29124,"807,040.69",43786
,20130319,55380,55420,55560,55560,54980,55060,55260,-360,-160,13508,"373,279.00",42234
,20130320,55060,55260,54740,55500,54670,55480,55270,220,10,12376,"342,011.95",42042
,20130321,55480,55270,55600,56600,55590,55850,56070,580,800,14824,"415,620.41",40848
,20130322,55850,56070,55720,55980,55600,55700,55790,-370,-280,10118,"282,262.27",39556
,20130325,55700,55790,56120,56280,55970,55990,56100,200,310,12316,"345,521.25",36932
,20130326,55990,56100,55840,56000,55630,55800,55770,-300,-330,9434,"263,067.48",35608
,20130327,55800,55770,55950,55960,55540,55620,55700,-150,-70,9856,"274,500.54",33784
,20130328,55620,55700,55800,55920,55310,55410,55560,-290,-140,10654,"296,020.43",31060
,20130329,55410,55560,54900,55550,54850,55000,55170,-560,-390,12052,"332,460.40",29290
,20130401,55000,55170,54560,54620,53850,53860,54220,-1310,-950,13120,"355,688.60",27630
,20130402,53860,54220,54270,54650,54260,54630,54470,410,250,9620,"262,007.10",26590
,20130403,54630,54470,54510,54800,54160,54200,54550,-270,80,8810,"240,310.25",24220
,20130408,54200,54550,54500,54780,54390,54760,54520,210,-30,8820,"240,474.45",22480
,20130409,54760,54520,55060,55250,54900,55250,55090,730,570,10150,"279,600.75",18890
,20130410,55250,55090,55480,55560,55240,55300,55440,210,350,8890,"246,443.65",16330
,20130411,55300,55440,55130,55500,55130,55210,55320,-230,-120,6620,"183,125.70",12820
,20130412,55210,55320,55400,55420,55260,55300,55370,-20,50,6840,"189,369.20",8400
,20130415,55300,55370,54500,54600,53570,53630,54130,-1740,-1240,5470,"148,064.05",5290
cu1305,20130104,57930,57880,58640,58650,58290,58450,58450,570,570,24680,"721,296.27",43684
,20130107,58450,58450,58370,58520,58130,58360,58360,-90,-90,20268,"591,508.88",47210
,20130108,58360,58360,58370,58570,58220,58420,58430,60,70,21426,"626,052.12",50340
,20130109,58420,58430,58440,58470,58280,58440,58360,10,-70,13464,"392,909.29",51790
,20130110,58440,58360,58360,58920,58280,58880,58610,520,250,39918,"1,169,910.24",59976
,20130111,58880,58610,58960,59080,58500,58510,58760,-100,150,51556,"1,514,865.06",67818
,20130114,58510,58760,58380,58830,58380,58660,58570,-100,-190,41820,"1,224,900.30",71692
,20130115,58660,58570,58400,58440,57800,57810,58150,-760,-420,56256,"1,635,873.60",78132
,20130116,57810,58150,57990,58240,57900,58040,58090,-110,-60,57836,"1,679,889.68",82728
,20130117,58040,58090,58010,58040,57650,57850,57810,-240,-280,61804,"1,786,693.44",89004
,20130118,57850,57810,58260,58600,58220,58590,58410,780,600,80094,"2,339,344.80",102148
,20130121,58590,58410,58550,58550,58350,58380,58430,-30,20,53734,"1,569,878.50",105504
,20130122,58380,58430,58430,59020,58430,58910,58790,480,360,155144,"4,560,552.20",141004
,20130123,58910,58790,58960,58980,58650,58810,58770,20,-20,103966,"3,055,212.84",133900
,20130124,58810,58770,58690,58790,58470,58630,58590,-140,-180,155472,"4,555,107.85",137332
,20130125,58630,58590,58610,58970,58600,58830,58830,240,240,140794,"4,141,932.93",154610
,20130128,58830,58830,58500,58690,58500,58620,58590,-210,-240,107056,"3,136,393.11",158134
,20130129,58620,58590,58690,58950,58410,58850,58690,260,100,188414,"5,529,339.12",172710
,20130130,58850,58690,58990,59400,58860,59260,59220,570,530,196852,"5,829,330.10",197340
,20130131,59260,59220,59590,59740,59410,59690,59560,470,340,170712,"5,084,628.73",196988
,20130201,59690,59560,59480,59680,59310,59660,59500,100,-60,148292,"4,412,052.24",199348
,20130204,59660,59500,60020,60270,59900,59950,60050,450,550,161706,"4,855,734.46",200014
,20130205,59950,60050,59710,60030,59690,59750,59850,-300,-200,130708,"3,911,705.59",200384
,20130206,59750,59850,59850,60160,59700,59840,59890,-10,40,133064,"3,984,791.31",195038
,20130207,59840,59890,59700,59730,59460,59700,59590,-190,-300,92974,"2,770,465.89",194682
,20130208,59700,59590,59550,59890,59460,59690,59730,100,140,99306,"2,965,785.83",202970
,20130218,59690,59730,59730,59740,58870,58900,59170,-830,-560,140454,"4,155,879.89",188692
,20130219,58900,59170,58840,59100,58700,58780,58890,-390,-280,109090,"3,212,299.60",190630
,20130220,58780,58890,58800,58850,58540,58660,58700,-230,-190,108428,"3,182,633.81",189788
,20130221,58660,58700,58010,58050,57220,57620,57610,-1080,-1090,216824,"6,246,112.28",167148
,20130222,57620,57610,57570,57780,57360,57620,57620,10,10,96282,"2,774,360.29",160110
,20130225,57620,57620,57280,57420,57050,57280,57250,-340,-370,91262,"2,612,617.05",160108
,20130226,57280,57250,57050,57480,57030,57110,57270,-140,20,61610,"1,764,274.31",155918
,20130227,57110,57270,57510,57700,57410,57490,57570,220,300,37690,"1,085,040.08",152978
,20130228,57490,57570,57590,57780,57490,57630,57640,60,70,34894,"1,005,819.17",149140
,20130301,57630,57640,57180,57220,56610,56720,56890,-920,-750,48780,"1,387,624.30",149780
,20130304,56720,56890,56720,56720,56100,56350,56420,-540,-470,48526,"1,368,941.88",148266
,20130305,56350,56420,56720,57000,56660,56960,56810,540,390,23840,"677,258.77",144594
,20130306,56960,56810,56940,57120,56660,56730,56860,-80,50,19596,"557,170.06",142592
,20130307,56730,56860,56600,56600,56280,56540,56420,-320,-440,20448,"576,860.09",141688
,20130308,56540,56420,56750,56860,56620,56700,56750,280,330,12034,"341,499.55",140330
,20130311,56700,56750,56460,56870,56460,56480,56670,-270,-80,14450,"409,447.44",138796
,20130312,56480,56670,56800,56830,56360,56370,56610,-300,-60,23464,"664,162.24",133296
,20130313,56370,56610,56990,57150,56790,56830,56920,220,310,23662,"673,488.60",129122
,20130314,56830,56920,56750,56810,56370,56810,56560,-110,-360,26316,"744,217.42",125072
,20130315,56810,56560,56910,57230,56850,57150,57000,590,440,18534,"528,298.16",121774
,20130318,57150,57000,56410,56410,54940,55350,55440,-1650,-1560,44000,"1,219,757.68",114552
,20130319,55350,55440,55550,55550,54900,55070,55260,-370,-180,21004,"580,380.36",110472
,20130320,55070,55260,54830,55500,54620,55450,55220,190,-40,21042,"580,974.60",105832
,20130321,55450,55220,55500,56580,55500,55850,56040,630,820,23796,"666,771.85",103004
,20130322,55850,56040,55500,55990,55500,55730,55770,-310,-270,10316,"287,706.23",102638
,20130325,55730,55770,56100,56270,55930,55960,56090,190,320,13866,"388,924.36",99742
,20130326,55960,56090,55710,55990,55610,55780,55770,-310,-320,14522,"405,014.67",95966
,20130327,55780,55770,55870,55940,55510,55570,55690,-200,-80,14210,"395,707.53",91692
,20130328,55570,55690,55790,55890,55290,55450,55550,-240,-140,18378,"510,460.55",87378
,20130329,55450,55550,54850,55630,54800,54910,55120,-640,-430,18828,"518,900.02",82868
,20130401,54910,55120,54710,54710,53760,53830,54130,-1290,-990,29418,"796,217.10",72462
,20130402,53830,54130,54240,54600,54130,54570,54400,440,270,15658,"425,906.44",68412
,20130403,54570,54400,54570,54750,54020,54150,54480,-250,80,13896,"378,543.65",66310
,20130408,54150,54480,54180,54710,54120,54680,54460,200,-20,11004,"299,661.91",65274
,20130409,54680,54460,54900,55180,54820,55180,55030,720,570,12332,"339,343.57",65234
,20130410,55180,55030,55450,55510,55200,55200,55360,170,330,13446,"372,212.35",64050
,20130411,55200,55360,55010,55380,55010,55060,55170,-300,-190,11120,"306,796.49",65826
,20130412,55060,55170,55190,55330,55090,55250,55210,80,40,11706,"323,169.49",65344
,20130415,55250,55210,54290,54480,53290,53700,53790,-1510,-1420,31804,"855,493.45",60574
,20130416,53700,53790,52000,53240,52000,53150,52720,-640,-1070,24490,"645,588.09",55028
,20130417,53150,52720,53310,53390,52550,52570,52950,-150,230,20366,"539,285.44",51446
,20130418,52570,52950,50830,50850,50830,50830,50830,-2120,-2120,4306,"109,437.01",49130
,20130419,50830,50830,51070,51380,50210,51130,50900,300,70,26432,"672,706.77",42760
,20130422,51130,50900,50900,51150,49530,49800,50220,-1100,-680,14820,"372,187.84",40586
,20130423,49800,50220,49950,50340,49370,49720,49750,-500,-470,23946,"595,766.70",37898
,20130424,49720,49750,50020,51640,49640,51010,50380,1260,630,22960,"578,418.29",32448
,20130425,51010,50380,51110,51800,51080,51800,51460,1420,1080,17818,"458,520.53",30940
,20130426,51800,51460,52380,52880,51520,52150,52330,690,870,16422,"429,700.57",31486
,20130502,52150,52330,49710,50590,49710,50270,50260,-2060,-2070,12036,"302,513.38",29730
,20130503,50270,50260,50450,51780,50450,51610,51210,1350,950,9720,"248,921.15",30210
,20130506,51610,51210,53700,53770,52830,53310,53160,2100,1950,16220,"431,177.15",25940
,20130507,53310,53160,52830,53550,52810,52820,53150,-340,-10,10580,"281,171.00",24310
,20130508,52820,53150,53100,53500,52990,53490,53240,340,90,9280,"247,037.25",22160
,20130509,53490,53240,53800,53800,53360,53540,53540,300,300,11150,"298,485.85",19480
,20130510,53540,53540,53190,53950,53190,53900,53560,360,20,10230,"274,006.35",16990
,20130513,53900,53560,53800,54100,53700,54010,53870,450,310,7930,"213,603.40",15130
,20130514,54010,53870,54850,54850,53410,53420,53770,-450,-100,6480,"174,223.45",11390
,20130515,53420,53770,53310,53410,52800,52800,53230,-970,-540,4150,"110,460.40",8880
cu1306,20130104,58040,57970,58980,58980,58410,58530,58550,560,580,1842,"53,930.47",9896
,20130107,58530,58550,58500,58640,58250,58500,58490,-50,-60,2334,"68,262.31",10352
,20130108,58500,58490,58490,58690,58380,58570,58540,80,50,1582,"46,310.69",10802
,20130109,58570,58540,58550,58550,58400,58550,58480,10,-60,726,"21,229.45",10918
,20130110,58550,58480,58480,59040,58430,59000,58740,520,260,1898,"55,746.56",11528
,20130111,59000,58740,59130,59200,58600,58600,58870,-140,130,3150,"92,733.74",12022
,20130114,58600,58870,58440,58930,58440,58750,58680,-120,-190,1712,"50,237.77",12340
,20130115,58750,58680,58500,58530,57920,57950,58260,-730,-420,3972,"115,717.20",13232
,20130116,57950,58260,58110,58350,58010,58150,58200,-110,-60,2988,"86,962.24",13412
,20130117,58150,58200,58150,58150,57790,57910,57920,-290,-280,3252,"94,184.93",14244
,20130118,57910,57920,58370,58740,58330,58720,58530,800,610,4550,"133,175.69",14930
,20130121,58720,58530,58660,58660,58500,58540,58560,10,30,2928,"85,737.01",16206
,20130122,58540,58560,58520,59140,58520,59050,58920,490,360,6088,"179,356.04",18268
,20130123,59050,58920,59130,59130,58780,58920,58880,0,-40,3880,"114,241.25",19170
,20130124,58920,58880,58830,58910,58610,58700,58730,-180,-150,5796,"170,227.08",20430
,20130125,58700,58730,58720,59100,58720,58970,58960,240,230,6588,"194,247.05",22410
,20130128,58970,58960,58740,58800,58650,58730,58720,-230,-240,7318,"214,865.03",25130
,20130129,58730,58720,58760,59060,58550,58930,58820,210,100,12998,"382,293.60",29794
,20130130,58930,58820,59060,59500,59000,59360,59350,540,530,12320,"365,647.30",32482
,20130131,59360,59350,59660,59850,59530,59810,59690,460,340,13144,"392,344.23",33316
,20130201,59810,59690,59590,59820,59440,59810,59630,120,-60,20706,"617,451.14",41120
,20130204,59810,59630,60150,60400,60040,60060,60180,430,550,31538,"949,035.11",48342
,20130205,60060,60180,59840,60180,59810,59890,60010,-290,-170,28916,"867,629.18",52500
,20130206,59890,60010,59960,60310,59840,60030,60030,20,20,32828,"985,432.95",55250
,20130207,60030,60030,59840,59880,59620,59860,59760,-170,-270,20836,"622,586.12",55316
,20130208,59860,59760,59670,60040,59630,59820,59870,60,110,26436,"791,450.12",59582
,20130218,59820,59870,59850,59870,59000,59010,59340,-860,-530,51702,"1,534,223.01",61914
,20130219,59010,59340,58980,59210,58830,58900,59020,-440,-320,49458,"1,459,605.42",72732
,20130220,58900,59020,58900,59000,58660,58760,58810,-260,-210,60834,"1,788,976.88",80484
,20130221,58760,58810,58100,58160,57330,57670,57700,-1140,-1110,145930,"4,210,718.01",101440
,20130222,57670,57700,57600,57850,57450,57720,57700,20,0,126096,"3,638,230.66",131552
,20130225,57720,57700,57400,57520,57090,57320,57300,-380,-400,163144,"4,674,268.29",163298
,20130226,57320,57300,57070,57530,57040,57130,57310,-170,10,206690,"5,923,455.42",185142
,20130227,57130,57310,57510,57740,57420,57490,57600,180,290,178968,"5,154,916.23",195522
,20130228,57490,57600,57600,57850,57520,57680,57700,80,100,198140,"5,716,432.63",204042
,20130301,57680,57700,57200,57250,56610,56730,56910,-970,-790,289324,"8,234,009.68",228656
,20130304,56730,56910,56710,56750,56060,56310,56420,-600,-490,298752,"8,427,843.29",233918
,20130305,56310,56420,56700,57020,56660,56930,56820,510,400,156044,"4,433,630.83",222050
,20130306,56930,56820,56940,57150,56640,56700,56870,-120,50,166502,"4,735,107.44",212324
,20130307,56700,56870,56560,56600,56240,56530,56410,-340,-460,160026,"4,513,861.59",210934
,20130308,56530,56410,56740,56870,56620,56740,56750,330,340,128580,"3,649,016.49",204394
,20130311,56740,56750,56470,57070,56450,56470,56680,-280,-70,135646,"3,844,243.98",205380
,20130312,56470,56680,56800,56830,56320,56340,56600,-340,-80,157138,"4,447,639.97",197326
,20130313,56340,56600,56910,57160,56750,56850,56920,250,320,135726,"3,863,294.99",183268
,20130314,56850,56920,56730,56830,56370,56770,56580,-150,-340,106064,"3,000,562.69",178204
,20130315,56770,56580,56900,57280,56840,57120,57010,540,430,88656,"2,527,288.12",170988
,20130318,57120,57010,56330,56340,54810,55300,55390,-1710,-1620,143564,"3,976,209.06",163828
,20130319,55300,55390,55500,55500,54830,55000,55160,-390,-230,60576,"1,670,917.02",158696
,20130320,55000,55160,54680,55480,54610,55410,55180,250,20,76068,"2,099,083.59",153314
,20130321,55410,55180,55510,56580,55510,55800,56030,620,850,69858,"1,957,211.85",143854
,20130322,55800,56030,55620,55930,55510,55650,55740,-380,-290,25454,"709,438.03",143004
,20130325,55650,55740,56050,56270,55890,55890,56080,150,340,22934,"643,161.38",140204
,20130326,55890,56080,55720,55950,55560,55760,55740,-320,-340,19044,"530,841.36",139296
,20130327,55760,55740,55900,55920,55460,55600,55660,-140,-80,20728,"576,962.06",138150
,20130328,55600,55660,55830,55890,55240,55340,55560,-320,-100,20910,"580,945.65",136938
,20130329,55340,55560,54870,55620,54790,54880,55050,-680,-510,23566,"648,693.54",135052
,20130401,54880,55050,54580,54580,53730,53820,54110,-1230,-940,29526,"798,957.19",133440
,20130402,53820,54110,54300,54610,54120,54500,54340,390,230,29072,"790,026.55",131200
,20130403,54500,54340,54570,54740,53980,54070,54400,-270,60,22964,"624,702.72",127420
,20130408,54070,54400,54130,54670,54070,54650,54420,250,20,15982,"434,894.62",125696
,20130409,54650,54420,54880,55160,54770,55160,55000,740,580,22084,"607,413.67",121160
,20130410,55160,55000,55440,55500,55130,55220,55340,220,340,17546,"485,506.60",117692
,20130411,55220,55340,55090,55350,54950,54970,55140,-370,-200,14914,"411,187.18",116032
,20130412,54970,55140,55200,55300,55030,55220,55160,80,20,14344,"395,675.94",113904
,20130415,55220,55160,54120,54330,53150,53540,53770,-1620,-1390,39634,"1,065,581.23",107334
,20130416,53540,53770,52210,53200,52150,53040,52630,-730,-1140,25748,"677,587.99",101060
,20130417,53040,52630,53300,53350,52440,52460,52870,-170,240,21998,"581,569.49",96814
,20130418,52460,52870,50750,50750,50750,50750,50750,-2120,-2120,4110,"104,291.25",95266
,20130419,50750,50750,51100,51320,50110,50950,50830,200,80,40772,"1,036,283.55",83604
,20130422,50950,50830,50840,51000,49400,49500,50010,-1330,-820,28288,"707,446.99",78026
,20130423,49500,50010,49900,50160,49070,49640,49670,-370,-340,37126,"922,080.92",69150
,20130424,49640,49670,49740,51410,49530,50970,50340,1300,670,27424,"690,364.99",64672
,20130425,50970,50340,51000,51660,50870,51570,51300,1230,960,21732,"557,513.57",60556
,20130426,51570,51300,52260,52680,51600,52000,52090,700,790,18012,"469,186.40",58394
,20130502,52000,52090,49480,50350,49480,50000,49950,-2090,-2140,19066,"476,264.34",58730
,20130503,50000,49950,50170,51490,50130,51380,50890,1430,940,18316,"466,079.95",58350
,20130506,51380,50890,53200,53430,52660,53060,52940,2170,2050,22690,"600,713.35",56462
,20130507,53060,52940,52850,53470,52510,52540,52970,-400,30,16192,"428,872.59",56698
,20130508,52540,52970,52820,53310,52730,53300,53010,330,40,10968,"290,753.07",56714
,20130509,53300,53010,53690,53690,53060,53260,53330,250,320,19568,"521,874.00",57150
,20130510,53260,53330,53000,53770,52880,53700,53340,370,10,10580,"282,178.85",58166
,20130513,53700,53340,53580,54090,53390,53810,53710,470,370,18458,"495,711.27",57044
,20130514,53810,53710,53850,54110,53100,53100,53560,-610,-150,19264,"515,940.32",57162
,20130515,53100,53560,53150,53250,52470,52660,52890,-900,-670,15854,"419,282.43",56444
,20130516,52660,52890,52530,52890,52180,52670,52520,-220,-370,21536,"565,586.60",53812
,20130517,52670,52520,52800,53610,52800,53400,53120,880,600,16634,"441,874.01",52276
,20130520,53400,53120,53350,53430,52950,53020,53110,-100,-10,19750,"524,552.70",51140
,20130521,53020,53110,53630,53910,53530,53900,53720,790,610,22018,"591,485.61",47246
,20130522,53900,53720,53750,54220,53650,54050,53930,330,210,20344,"548,609.67",44956
,20130523,54050,53930,53730,53730,52750,52880,53200,-1050,-730,26802,"712,953.25",40520
,20130524,52880,53200,53250,53490,53000,53410,53320,210,120,14058,"374,814.58",40452
,20130527,53410,53320,53060,53240,52860,53050,53030,-270,-290,12072,"320,091.55",39868
,20130528,53050,53030,53140,53390,52650,53250,52910,220,-120,21858,"578,292.01",36066
,20130529,53250,52910,53140,53480,52870,52900,53230,-10,320,16076,"427,880.82",33076
,20130530,52900,53230,52500,53100,52500,53050,52860,-180,-370,19214,"507,826.54",28358
,20130531,53050,52860,53440,53610,53150,53430,53360,570,500,15658,"417,792.35",26572
,20130603,53430,53360,53700,53750,53390,53500,53490,140,130,10262,"274,497.75",26650
,20130604,53500,53490,53480,53680,53440,53600,53580,110,90,9420,"252,363.50",26030
,20130605,53600,53580,53800,54040,53750,54040,53860,460,280,11610,"312,694.40",25650
,20130606,54040,53860,53760,53930,53400,53510,53700,-350,-160,14830,"398,256.85",22780
,20130607,53510,53700,53480,53700,53400,53680,53520,-20,-180,10950,"293,076.65",17930
,20130613,53680,53520,52200,52570,52200,52310,52450,-1210,-1070,11250,"295,085.85",12860
,20130614,52310,52450,52450,52460,52340,52420,52410,-30,-40,6620,"173,496.80",9660
,20130617,52420,52410,53400,53400,52330,52400,52590,-10,180,4870,"128,065.20",6490
cu1307,20130104,58140,58100,58730,58800,58500,58660,58600,560,500,170,"4,981.14",2128
,20130107,58660,58600,58470,58680,58400,58400,58530,-200,-70,428,"12,526.73",2248
,20130108,58400,58530,58630,58700,58480,58680,58630,150,100,136,"3,987.46",2294
,20130109,58680,58630,58690,58700,58560,58600,58590,-30,-40,54,"1,582.00",2298
,20130110,58600,58590,58590,59120,58590,59100,58930,510,340,98,"2,887.75",2320
,20130111,59100,58930,59190,59260,58800,58840,58980,-90,50,190,"5,603.34",2356
,20130114,58840,58980,58750,59290,58650,58950,58890,-30,-90,274,"8,069.06",2442
,20130115,58950,58890,58950,58950,58070,58090,58360,-800,-530,166,"4,844.40",2482
,20130116,58090,58360,58240,58480,58200,58340,58330,-20,-30,580,"16,917.71",2502
,20130117,58340,58330,58030,58240,57830,57970,58020,-360,-310,362,"10,501.67",2544
,20130118,57970,58020,58500,58890,58450,58890,58640,870,620,532,"15,599.26",2818
,20130121,58890,58640,58730,58870,58620,58640,58680,0,40,464,"13,615.63",2984
,20130122,58640,58680,58750,59220,58750,59150,59020,470,340,506,"14,932.17",3236
,20130123,59150,59020,59170,59280,58900,59050,59010,30,-10,508,"14,989.77",3290
,20130124,59050,59010,59010,59040,58730,58880,58840,-130,-170,218,"6,413.85",3300
,20130125,58880,58840,58950,59180,58950,59080,59110,240,270,328,"9,694.17",3372
,20130128,59080,59110,58820,58910,58780,58890,58840,-220,-270,162,"4,766.23",3378
,20130129,58890,58840,58910,59170,58700,59110,58930,270,90,604,"17,798.58",3644
,20130130,59110,58930,59120,59640,59120,59480,59470,550,540,514,"15,283.82",3858
,20130131,59480,59470,59600,59970,59600,59880,59840,410,370,412,"12,327.14",3954
,20130201,59880,59840,59650,59890,59570,59890,59720,50,-120,758,"22,636.22",4250
,20130204,59890,59720,60160,60440,60130,60130,60260,410,540,826,"24,888.04",4538
,20130205,60130,60260,60000,60220,60000,60000,60100,-260,-160,846,"25,424.33",4802
,20130206,60000,60100,60130,60380,59980,60100,60100,0,0,630,"18,933.13",4992
,20130207,60100,60100,59930,60000,59730,59960,59820,-140,-280,1420,"42,476.46",5720
,20130208,59960,59820,59760,60150,59760,59880,59970,60,150,666,"19,972.33",5724
,20130218,59880,59970,59850,59880,59070,59100,59410,-870,-560,1240,"36,836.25",5858
,20130219,59100,59410,59030,59280,58950,59000,59120,-410,-290,2332,"68,938.55",6962
,20130220,59000,59120,59050,59060,58760,58840,58890,-280,-230,3044,"89,638.45",8208
,20130221,58840,58890,58250,58250,57450,57770,57780,-1120,-1110,12822,"370,456.02",14480
,20130222,57770,57780,57600,57930,57560,57800,57810,20,30,8346,"241,261.07",17348
,20130225,57800,57810,57520,57600,57210,57370,57380,-440,-430,7512,"215,534.78",20116
,20130226,57370,57380,57120,57580,57120,57200,57350,-180,-30,15836,"454,155.81",25774
,20130227,57200,57350,57610,57800,57510,57530,57670,180,320,11354,"327,443.13",26868
,20130228,57530,57670,57700,57880,57580,57760,57760,90,90,12928,"373,388.30",29158
,20130301,57760,57760,57300,57320,56650,56750,56930,-1010,-830,40550,"1,154,312.46",44622
,20130304,56750,56930,56700,56760,56070,56310,56420,-620,-510,74766,"2,109,192.84",65656
,20130305,56310,56420,56750,57040,56660,56960,56820,540,400,59966,"1,703,896.97",75406
,20130306,56960,56820,56950,57140,56620,56660,56830,-160,10,76702,"2,179,864.15",96674
,20130307,56660,56830,56500,56560,56210,56520,56370,-310,-460,79962,"2,254,040.21",107958
,20130308,56520,56370,56700,56820,56570,56720,56710,350,340,73462,"2,083,372.71",117788
,20130311,56720,56710,56480,56880,56390,56390,56640,-320,-70,89516,"2,535,198.77",128102
,20130312,56390,56640,56720,56800,56300,56310,56600,-330,-40,142136,"4,022,509.00",136432
,20130313,56310,56600,56900,57200,56720,56830,56910,230,310,164196,"4,672,830.29",138128
,20130314,56830,56910,56720,56820,56320,56800,56540,-110,-370,201162,"5,687,823.75",156006
,20130315,56800,56540,56950,57320,56830,57130,57030,590,490,196814,"5,612,318.01",150488
,20130318,57130,57030,56310,56350,54580,55190,55280,-1840,-1750,433658,"11,987,850.30",237742
,20130319,55190,55280,55430,55430,54710,54910,55040,-370,-240,309010,"8,504,597.95",274416
,20130320,54910,55040,54550,55470,54450,55350,55100,310,60,388670,"10,708,269.59",249816
,20130321,55350,55100,55450,56630,55450,55780,56030,680,930,447382,"12,533,464.84",222936
,20130322,55780,56030,55580,55940,55460,55630,55700,-400,-330,228348,"6,360,364.21",224508
,20130325,55630,55700,56050,56260,55870,55890,56080,190,380,235926,"6,615,498.74",227536
,20130326,55890,56080,55700,55950,55510,55760,55720,-320,-360,194786,"5,427,580.18",230024
,20130327,55760,55720,55900,55920,55430,55560,55640,-160,-80,219956,"6,119,187.32",239074
,20130328,55560,55640,55820,55880,55200,55300,55510,-340,-130,286642,"7,956,650.76",242478
,20130329,55300,55510,54790,55650,54720,54830,55030,-680,-480,291152,"8,011,879.52",250682
,20130401,54830,55030,54480,54500,53600,53740,54040,-1290,-990,338234,"9,140,623.36",268040
,20130402,53740,54040,54180,54550,54010,54480,54270,440,230,294366,"7,988,614.71",225410
,20130403,54480,54270,54470,54690,53930,54060,54370,-210,100,201120,"5,468,412.91",204710
,20130408,54060,54370,54110,54650,54000,54620,54380,250,10,119888,"3,259,824.15",195088
,20130409,54620,54380,54840,55140,54720,55100,54960,720,580,117166,"3,219,981.86",178756
,20130410,55100,54960,55450,55480,55100,55180,55290,220,330,81440,"2,251,702.08",165638
,20130411,55180,55290,54980,55340,54940,54950,55120,-340,-170,59514,"1,640,349.32",161602
,20130412,54950,55120,55180,55280,55000,55190,55140,70,20,45144,"1,244,773.34",155196
,20130415,55190,55140,54000,54260,53110,53530,53720,-1610,-1420,106368,"2,857,111.26",149408
,20130416,53530,53720,52510,53160,52090,53030,52620,-690,-1100,84456,"2,222,277.28",139722
,20130417,53030,52620,53230,53350,52380,52440,52800,-180,180,61290,"1,618,107.18",134344
,20130418,52440,52800,50680,50780,50680,50680,50680,-2120,-2120,17094,"433,195.22",128790
,20130419,50680,50680,51000,51300,50030,50900,50700,220,20,112592,"2,854,472.77",114570
,20130422,50900,50700,50620,50950,49210,49280,49960,-1420,-740,56770,"1,418,347.71",114994
,20130423,49280,49960,49700,49940,48790,49350,49450,-610,-510,72492,"1,792,366.83",113010
,20130424,49350,49450,49500,51370,49300,50810,50250,1360,800,73142,"1,837,832.50",103086
,20130425,50810,50250,50990,51550,50670,51500,51150,1250,900,66728,"1,706,901.44",97676
,20130426,51500,51150,52150,52600,51500,51940,52010,790,860,49200,"1,279,589.30",92510
,20130502,51940,52010,49510,50200,49500,49880,49840,-2130,-2170,37606,"937,184.39",89276
,20130503,49880,49840,50180,51380,50000,51340,50770,1500,930,44904,"1,139,929.66",84938
,20130506,51340,50770,53300,53300,52570,52970,52890,2200,2120,33168,"877,157.70",80986
,20130507,52970,52890,52730,53400,52410,52410,52890,-480,0,22208,"587,319.64",78316
,20130508,52410,52890,52610,53250,52610,53170,52890,280,0,16242,"429,577.24",75538
,20130509,53170,52890,53500,53640,52910,53230,53200,340,310,16942,"450,711.49",72722
,20130510,53230,53200,52800,53640,52780,53600,53190,400,-10,17366,"461,915.15",71590
,20130513,53600,53190,53480,53920,53240,53630,53540,440,350,14068,"376,616.54",70684
,20130514,53630,53540,53760,53900,52920,52920,53320,-620,-220,13664,"364,307.12",69318
,20130515,52920,53320,52800,53020,52240,52330,52670,-990,-650,12252,"322,677.93",67926
,20130516,52330,52670,52330,52750,51990,52450,52380,-220,-290,13558,"355,089.20",68232
,20130517,52450,52380,52640,53460,52620,53250,53000,870,620,12752,"337,949.15",67190
,20130520,53250,53000,53150,53270,52720,52820,52950,-180,-50,9928,"262,882.52",64834
,20130521,52820,52950,53460,53730,53340,53710,53550,760,600,10642,"284,958.78",62964
,20130522,53710,53550,53550,54050,53450,53880,53760,330,210,7256,"195,069.61",61856
,20130523,53880,53760,53700,53700,52480,52690,53000,-1070,-760,12472,"330,522.03",61100
,20130524,52690,53000,52820,53290,52760,53180,53080,180,80,8398,"222,893.10",59970
,20130527,53180,53080,52820,52980,52570,52880,52780,-200,-300,7640,"201,632.63",60378
,20130528,52880,52780,53060,53110,52390,53060,52640,280,-140,8952,"235,652.63",60140
,20130529,53060,52640,53000,53300,52660,52700,53040,60,400,20244,"536,964.90",55934
,20130530,52700,53040,52590,52880,52240,52800,52610,-240,-430,14130,"371,727.43",54894
,20130531,52800,52610,53210,53380,52910,53110,53130,500,520,7596,"201,815.15",53820
,20130603,53110,53130,53360,53560,53180,53350,53290,220,160,10574,"281,766.75",54014
,20130604,53350,53290,53350,53520,53240,53360,53380,70,90,7400,"197,519.44",53896
,20130605,53360,53380,53600,53850,53560,53840,53690,460,310,11976,"321,555.51",53938
,20130606,53840,53690,53530,53760,53170,53350,53490,-340,-200,17562,"469,705.95",53526
,20130607,53350,53490,53350,53520,53180,53460,53340,-30,-150,15942,"425,230.05",54382
,20130613,53460,53340,52000,52370,51960,52150,52190,-1190,-1150,26066,"680,319.78",56690
,20130614,52150,52190,52130,52260,51880,52100,52050,-90,-140,18734,"487,644.38",59238
,20130617,52100,52050,52170,52490,52130,52260,52260,210,210,15590,"407,435.83",59894
,20130618,52260,52260,52250,52270,51560,51610,51810,-650,-450,29032,"752,169.53",56586
,20130619,51610,51810,51510,51610,51170,51520,51310,-290,-500,21174,"543,299.99",53968
,20130620,51520,51310,50760,50840,50250,50320,50500,-990,-810,23154,"584,679.45",51776
,20130621,50320,50500,49560,50310,49050,50250,49840,-250,-660,24736,"616,449.41",51368
,20130624,50250,49840,49900,50080,48700,48750,49270,-1090,-570,24748,"609,749.32",50922
,20130625,48750,49270,48930,49480,48320,49360,48830,90,-440,29456,"719,188.99",47210
,20130626,49360,48830,49810,49810,48680,48750,49070,-80,240,24670,"605,341.24",46582
,20130627,48750,49070,48980,49470,48900,49390,49210,320,140,21048,"517,966.70",42546
,20130628,49390,49210,49000,49300,48580,49220,49070,10,-140,17782,"436,285.79",39670
,20130701,49220,49070,49100,50130,49100,50100,49700,1030,630,15180,"377,265.20",34670
,20130702,50100,49700,50360,50750,50300,50660,50530,960,830,14530,"367,152.85",30350
,20130703,50660,50530,50600,51050,50510,51030,50800,500,270,12470,"316,741.75",28510
,20130704,51030,50800,50920,50920,50640,50640,50730,-160,-70,8870,"225,017.45",27530
,20130705,50640,50730,50620,50620,50000,50020,50130,-710,-600,12140,"304,302.00",26880
,20130708,50020,50130,49800,49850,49400,49520,49530,-610,-600,19060,"472,071.60",22630
,20130709,49520,49530,49760,50010,49580,49810,49840,280,310,16540,"412,220.55",19010
,20130710,49810,49840,49700,49700,49030,49530,49310,-310,-530,15370,"379,022.00",14360
,20130711,49530,49310,50800,51550,50590,51250,50900,1940,1590,8120,"206,689.55",11440
,20130712,51250,50900,51120,51120,50450,50500,50840,-400,-60,4890,"124,327.00",8250
,20130715,50500,50840,50510,50700,50330,50560,50500,-280,-340,4510,"113,881.75",6110
cu1308,20130104,58250,58160,58790,58790,58570,58620,58650,460,490,180,"5,278.59",1210
,20130107,58620,58650,58590,58760,58450,58590,58580,-60,-70,348,"10,193.77",1200
,20130108,58590,58580,58680,58810,58620,58780,58760,200,180,86,"2,526.68",1220
,20130109,58780,58760,58770,58770,58620,58740,58700,-20,-60,52,"1,526.31",1224
,20130110,58740,58700,58710,59200,58710,59200,58930,500,230,52,"1,532.40",1234
,20130111,59200,58930,59140,59140,58890,58890,59000,-40,70,32,944.02,1234
,20130114,58890,59000,58850,59080,58780,59060,58960,60,-40,66,"1,945.72",1234
,20130115,59060,58960,58660,58730,58160,58160,58440,-800,-520,124,"3,623.41",1274
,20130116,58160,58440,58390,58540,58310,58480,58440,40,0,128,"3,740.30",1306
,20130117,58480,58440,58280,58280,57980,58160,58120,-280,-320,110,"3,197.06",1320
,20130118,58160,58120,58620,59000,58500,58980,58890,860,770,674,"19,847.44",1706
,20130121,58980,58890,58890,58970,58760,58760,58850,-130,-40,156,"4,590.63",1738
,20130122,58760,58850,58990,59360,58990,59360,59170,510,320,62,"1,834.37",1744
,20130123,59360,59170,59190,59220,59080,59180,59140,10,-30,118,"3,489.29",1748
,20130124,59180,59140,59120,59120,58870,58950,58950,-190,-190,86,"2,534.98",1768
,20130125,58950,58950,59150,59340,59150,59220,59230,270,280,114,"3,376.29",1768
,20130128,59220,59230,58970,59000,58910,58970,58970,-260,-260,94,"2,771.69",1802
,20130129,58970,58970,59150,59270,58820,59200,59030,230,60,102,"3,010.80",1812
,20130130,59200,59030,59300,59710,59200,59600,59560,570,530,492,"14,651.86",1956
,20130131,59600,59560,59740,60020,59740,60000,59930,440,370,872,"26,130.83",2382
,20130201,60000,59930,59850,59950,59670,59930,59830,0,-100,486,"14,539.87",2364
,20130204,59930,59830,60130,60510,60130,60250,60290,420,460,420,"12,660.99",2402
,20130205,60250,60290,60100,60270,60040,60040,60160,-250,-130,654,"19,672.67",2536
,20130206,60040,60160,60180,60420,60050,60070,60260,-90,100,142,"4,278.90",2610
,20130207,60070,60260,59950,60000,59820,59960,59910,-300,-350,146,"4,373.74",2592
,20130208,59960,59910,59860,60180,59860,60000,60060,90,150,144,"4,324.82",2584
,20130218,60000,60060,60000,60000,59150,59150,59490,-910,-570,392,"11,660.58",2678
,20130219,59150,59490,59000,59320,59000,59070,59220,-420,-270,626,"18,538.01",3026
,20130220,59070,59220,59020,59080,58840,58940,58950,-280,-270,484,"14,266.66",3138
,20130221,58940,58950,58410,58410,57510,57850,57850,-1100,-1100,1412,"40,846.55",3508
,20130222,57850,57850,57720,57980,57630,57820,57840,-30,-10,1202,"34,765.65",3910
,20130225,57820,57840,57690,57690,57250,57490,57470,-350,-370,1060,"30,461.98",4364
,20130226,57490,57470,57240,57640,57220,57280,57440,-190,-30,1368,"39,294.60",4512
,20130227,57280,57440,57650,57850,57570,57640,57720,200,280,320,"9,236.08",4492
,20130228,57640,57720,57740,57920,57640,57800,57770,80,50,1146,"33,107.57",4984
,20130301,57800,57770,57440,57440,56690,56820,57060,-950,-710,4668,"133,192.41",6238
,20130304,56820,57060,56710,56820,56120,56330,56480,-730,-580,3676,"103,824.92",7314
,20130305,56330,56480,56900,57130,56700,56980,56840,500,360,2044,"58,094.27",7934
,20130306,56980,56840,56900,57160,56640,56700,56870,-140,30,3832,"108,964.23",9796
,20130307,56700,56870,56560,56560,56200,56520,56360,-350,-510,6538,"184,252.62",12240
,20130308,56520,56360,56700,56800,56600,56740,56710,380,350,6356,"180,228.06",14520
,20130311,56740,56710,56460,56790,56450,56490,56650,-220,-60,9922,"281,087.89",20652
,20130312,56490,56650,56840,56840,56340,56340,56670,-310,20,13822,"391,647.48",25874
,20130313,56340,56670,56990,57240,56750,56890,56950,220,280,12004,"341,831.62",26638
,20130314,56890,56950,56720,56780,56330,56780,56550,-170,-400,17076,"482,901.62",30840
,20130315,56780,56550,56980,57280,56810,57120,57000,570,450,19532,"556,757.71",34674
,20130318,57120,57000,56250,56300,54680,55170,55290,-1830,-1710,74810,"2,068,323.08",65140
,20130319,55170,55290,55400,55400,54750,54910,55080,-380,-210,51150,"1,408,802.96",76262
,20130320,54910,55080,54600,55480,54500,55370,55120,290,40,71972,"1,983,879.37",78998
,20130321,55370,55120,55470,56640,55420,55810,56040,690,920,94814,"2,656,818.09",82662
,20130322,55810,56040,55640,55950,55490,55640,55720,-400,-320,53850,"1,500,353.75",92022
,20130325,55640,55720,56090,56260,55860,55860,56080,140,360,59014,"1,655,011.90",96530
,20130326,55860,56080,55740,55950,55520,55750,55730,-330,-350,63850,"1,779,450.55",105486
,20130327,55750,55730,55930,55960,55450,55590,55650,-140,-80,56998,"1,586,205.47",115056
,20130328,55590,55650,55900,55900,55200,55310,55510,-340,-140,94582,"2,625,516.03",125892
,20130329,55310,55510,54750,55510,54740,54820,55040,-690,-470,124822,"3,435,314.79",144852
,20130401,54820,55040,54430,54490,53620,53680,54060,-1360,-980,199002,"5,379,564.90",189292
,20130402,53680,54060,54110,54560,53990,54490,54270,430,210,214324,"5,816,623.31",204274
,20130403,54490,54270,54440,54680,53810,53990,54320,-280,50,225994,"6,138,899.25",225558
,20130408,53990,54320,53990,54620,53920,54590,54320,270,0,195442,"5,308,665.83",225128
,20130409,54590,54320,54850,55090,54680,55090,54920,770,600,266996,"7,331,881.75",235930
,20130410,55090,54920,55390,55460,55050,55140,55250,220,330,249846,"6,902,189.20",244254
,20130411,55140,55250,54900,55310,54870,54890,55050,-360,-200,230006,"6,331,769.94",252480
,20130412,54890,55050,55150,55250,54930,55150,55090,100,40,242132,"6,669,723.70",265648
,20130415,55150,55090,54000,54180,52960,53380,53530,-1710,-1560,595956,"15,953,362.40",310526
,20130416,53380,53530,52310,53060,51920,52900,52520,-630,-1010,586032,"15,391,723.17",310098
,20130417,52900,52520,53120,53260,52160,52230,52640,-290,120,524416,"13,805,200.76",367642
,20130418,52230,52640,50530,50590,50530,50530,50530,-2110,-2110,112446,"2,840,993.20",329948
,20130419,50530,50530,50790,51110,49750,50690,50470,160,-60,925182,"23,349,931.39",343514
,20130422,50690,50470,50440,50750,48970,49040,49730,-1430,-740,814766,"20,261,363.48",406798
,20130423,49040,49730,49500,49730,48460,49080,49130,-650,-600,972966,"23,905,062.52",418860
,20130424,49080,49130,49180,51090,48960,50600,49950,1470,820,989568,"24,715,443.40",360602
,20130425,50600,49950,50780,51400,50410,51280,50980,1330,1030,788666,"20,105,804.09",315656
,20130426,51280,50980,52060,52480,51280,51770,51810,790,830,662586,"17,164,735.20",281436
,20130502,51770,51810,49300,49990,49240,49680,49590,-2130,-2220,441492,"10,948,447.96",241816
,20130503,49680,49590,50020,51270,49820,51190,50600,1600,1010,428262,"10,836,594.54",207842
,20130506,51190,50600,53130,53130,52460,52930,52820,2330,2220,218090,"5,760,414.52",171334
,20130507,52930,52820,52640,53350,52320,52360,52800,-460,-20,186818,"4,932,795.51",158416
,20130508,52360,52800,52520,53160,52510,53110,52800,310,0,105470,"2,784,679.31",154350
,20130509,53110,52800,53520,53520,52810,53100,53100,300,300,97322,"2,584,361.55",146978
,20130510,53100,53100,52870,53550,52680,53500,53110,400,10,95524,"2,536,724.13",141044
,20130513,53500,53110,53410,53840,53170,53510,53450,400,340,82684,"2,209,863.65",133572
,20130514,53510,53450,53630,53810,52760,52820,53280,-630,-170,66540,"1,772,671.98",127946
,20130515,52820,53280,52700,52890,52110,52170,52570,-1110,-710,48034,"1,262,578.50",125864
,20130516,52170,52570,52170,52610,51850,52270,52200,-300,-370,49410,"1,289,689.14",124198
,20130517,52270,52200,52470,53320,52470,53100,52810,900,610,39028,"1,030,690.82",119442
,20130520,53100,52810,53030,53130,52570,52700,52800,-110,-10,29000,"765,689.80",117214
,20130521,52700,52800,53300,53610,53190,53560,53380,760,580,35230,"940,393.07",114182
,20130522,53560,53380,53400,53900,53290,53730,53610,350,230,19724,"528,775.53",114066
,20130523,53730,53610,53480,53480,52320,52460,52840,-1150,-770,36794,"972,208.84",107134
,20130524,52460,52840,52840,53140,52570,53000,52920,160,80,29492,"780,377.00",105398
,20130527,53000,52920,52730,52830,52380,52680,52600,-240,-320,19926,"524,144.79",105482
,20130528,52680,52600,52990,52990,52140,52900,52490,300,-110,22988,"603,432.16",104614
,20130529,52900,52490,52680,53100,52430,52450,52810,-40,320,20112,"531,153.14",104328
,20130530,52450,52810,52450,52680,52010,52610,52370,-200,-440,26978,"706,506.70",101268
,20130531,52610,52370,52920,53200,52720,52890,52940,520,570,12490,"330,669.53",99146
,20130603,52890,52940,53160,53370,52960,53180,53110,240,170,9830,"261,065.56",97910
,20130604,53180,53110,53200,53350,53050,53220,53190,110,80,12852,"341,856.54",95078
,20130605,53220,53190,53540,53750,53390,53740,53550,550,360,13104,"350,917.13",96206
,20130606,53740,53550,53500,53660,53030,53180,53360,-370,-190,22252,"593,692.14",94012
,20130607,53180,53360,53150,53390,53010,53330,53190,-30,-170,15176,"403,662.10",91626
,20130613,53330,53190,51850,52240,51650,51980,52030,-1210,-1160,30390,"790,699.55",86746
,20130614,51980,52030,51940,52110,51660,51840,51860,-190,-170,17838,"462,556.35",84932
,20130617,51840,51860,51940,52290,51920,52090,52070,230,210,7892,"205,501.96",84252
,20130618,52090,52070,51960,52070,51370,51430,51610,-640,-460,13670,"352,789.88",82592
,20130619,51430,51610,51200,51430,50970,51310,51140,-300,-470,13420,"343,213.29",82950
,20130620,51310,51140,50530,50660,50000,50070,50330,-1070,-810,27646,"695,760.01",77286
,20130621,50070,50330,49340,50040,48840,50020,49520,-310,-810,27278,"675,445.84",74188
,20130624,50020,49520,49880,49880,48400,48400,49070,-1120,-450,19322,"474,147.11",72680
,20130625,48400,49070,48550,49320,48020,48890,48610,-180,-460,20752,"504,412.78",69524
,20130626,48890,48610,49460,49630,48440,48560,48850,-50,240,12848,"313,876.19",69060
,20130627,48560,48850,48720,49280,48640,49190,49000,340,150,16972,"415,886.80",67772
,20130628,49190,49000,48650,49150,48360,49020,48850,20,-150,14590,"356,361.15",66312
,20130701,49020,48850,48850,49980,48750,49980,49520,1130,670,24698,"611,604.73",60844
,20130702,49980,49520,49520,50580,49520,50520,50360,1000,840,16714,"420,875.50",59700
,20130703,50520,50360,50490,50880,50330,50880,50570,520,210,12186,"308,155.36",59550
,20130704,50880,50570,50780,50870,50420,50440,50550,-130,-20,9470,"239,381.89",59460
,20130705,50440,50550,50420,50510,49790,49800,49970,-750,-580,9986,"249,529.00",58704
,20130708,49800,49970,49200,49610,49150,49210,49310,-760,-660,14634,"360,829.00",59362
,20130709,49210,49310,49480,49830,49290,49550,49600,240,290,14812,"367,389.13",60310
,20130710,49550,49600,49500,49500,48780,49300,49050,-300,-550,20908,"512,833.54",59966
,20130711,49300,49050,50230,51280,50230,51150,50760,2100,1710,31080,"788,821.83",60828
,20130712,51150,50760,51120,51120,50220,50230,50670,-530,-90,18658,"472,782.19",59642
,20130715,50230,50670,50230,50680,50180,50400,50440,-270,-230,22040,"555,877.09",60186
,20130716,50400,50440,50370,50730,50260,50700,50450,260,10,13394,"337,872.63",59790
,20130717,50700,50450,50770,51080,50340,50340,50700,-110,250,27702,"702,289.02",59316
,20130718,50340,50700,50050,50240,49910,50130,50020,-570,-680,18694,"467,597.15",59170
,20130719,50130,50020,50380,50660,50000,50040,50410,20,390,15348,"386,897.28",58014
,20130722,50040,50410,50530,50840,50400,50790,50660,380,250,16252,"411,685.31",55364
,20130723,50790,50660,50810,51100,50710,50750,50920,90,260,19844,"505,257.08",54108
,20130724,50750,50920,51040,51120,50660,50970,50880,50,-40,21754,"553,470.07",52682
,20130725,50970,50880,50760,51010,50690,50960,50870,80,-10,15380,"391,252.02",50082
,20130726,50960,50870,51100,51100,50420,50540,50710,-330,-160,18574,"470,973.42",46834
,20130729,50540,50710,49650,49920,49550,49800,49720,-910,-990,31428,"781,421.89",38648
,20130730,49800,49720,49910,49930,49560,49560,49790,-160,70,17022,"423,817.27",38304
,20130731,49560,49790,49250,49950,49250,49920,49580,130,-210,18964,"470,175.89",34808
,20130801,49920,49580,50250,50750,50250,50570,50460,990,880,10358,"261,368.35",32640
,20130802,50570,50460,50770,50800,50410,50600,50600,140,140,10700,"270,730.60",31210
,20130805,50600,50600,50700,50830,50520,50800,50720,200,120,9000,"228,280.45",29740
,20130806,50800,50720,50640,50880,50520,50880,50700,160,-20,7550,"191,396.35",28940
,20130807,50880,50700,50580,50740,50480,50670,50600,-30,-100,7930,"200,655.65",27340
,20130808,50670,50600,51100,51920,51080,51900,51600,1300,1000,21730,"560,725.40",24940
,20130809,51900,51600,52100,52240,51750,51920,51960,320,360,10690,"277,732.80",23520
,20130812,51920,51960,52290,52940,52200,52900,52380,940,420,14350,"375,864.55",17700
,20130813,52900,52380,52610,52880,52410,52600,52530,220,150,7830,"205,683.75",12130
,20130814,52600,52530,52420,52900,52410,52600,52640,70,110,6090,"160,292.60",8110
,20130815,52600,52640,52720,52830,52460,52550,52660,-90,20,3820,"100,594.05",6190
cu1309,20130104,58350,58330,58950,58950,58560,58770,58730,440,400,40,"1,174.62",928
,20130107,58770,58730,58620,58870,58500,58500,58710,-230,-20,54,"1,585.23",930
,20130108,58500,58710,58680,58930,58680,58710,58750,0,40,34,998.88,928
,20130109,58710,58750,58680,58820,58680,58800,58770,50,20,16,470.2,924
,20130110,58800,58770,58750,59350,58750,59330,59100,560,330,30,886.57,922
,20130111,59330,59100,59120,59140,58950,58950,59070,-150,-30,12,354.47,922
,20130114,58950,59070,59000,59150,58910,59060,59010,-10,-60,34,"1,003.23",918
,20130115,59060,59010,58790,58850,58420,58450,58670,-560,-340,66,"1,936.15",930
,20130116,58450,58670,58430,58660,58400,58610,58520,-60,-150,106,"3,101.84",976
,20130117,58610,58520,58350,58450,58100,58250,58250,-270,-270,42,"1,223.33",980
,20130118,58250,58250,58660,59130,58650,59130,58920,880,670,60,"1,767.87",978
,20130121,59130,58920,58980,59000,58870,58870,58950,-50,30,16,471.6,978
,20130122,58870,58950,58980,59400,58980,59400,59290,450,340,54,"1,600.90",994
,20130123,59400,59290,59360,59360,59100,59350,59210,60,-80,140,"4,145.36",1002
,20130124,59350,59210,59080,59210,59000,59100,59080,-110,-130,48,"1,418.06",1008
,20130125,59100,59080,59290,59450,59280,59280,59370,200,290,40,"1,187.42",1018
,20130128,59280,59370,59100,59160,59090,59140,59110,-230,-260,28,827.58,1012
,20130129,59140,59110,59170,59340,58990,59340,59110,230,0,80,"2,364.78",1034
,20130130,59340,59110,59360,59800,59360,59680,59620,570,510,220,"6,558.20",1116
,20130131,59680,59620,59950,60110,59890,60090,60020,470,400,102,"3,061.26",1088
,20130201,60090,60020,59910,60080,59800,60080,59890,60,-130,138,"4,132.97",1088
,20130204,60080,59890,60280,60620,60280,60330,60410,440,520,60,"1,812.37",1088
,20130205,60330,60410,60170,60330,60030,60130,60200,-280,-210,286,"8,609.21",1190
,20130206,60130,60200,60190,60500,60110,60220,60270,20,70,112,"3,375.16",1172
,20130207,60220,60270,60050,60060,59900,60020,59970,-250,-300,254,"7,616.73",1312
,20130208,60020,59970,60060,60250,60000,60210,60170,240,200,92,"2,768.19",1336
,20130218,60210,60170,59780,59830,59350,59350,59480,-820,-690,466,"13,859.42",1494
,20130219,59350,59480,59100,59410,59100,59150,59290,-330,-190,486,"14,408.46",1806
,20130220,59150,59290,59080,59180,58890,59020,59050,-270,-240,278,"8,208.56",1796
,20130221,59020,59050,58370,58370,57630,57980,57870,-1070,-1180,936,"27,084.39",2050
,20130222,57980,57870,57810,58050,57740,57950,57950,80,80,536,"15,532.44",2222
,20130225,57950,57950,57740,57740,57320,57540,57550,-410,-400,306,"8,805.25",2308
,20130226,57540,57550,57000,57740,57000,57300,57510,-250,-40,426,"12,251.28",2242
,20130227,57300,57510,57860,57900,57650,57750,57810,240,300,354,"10,232.49",2238
,20130228,57750,57810,57800,57960,57740,57890,57900,80,90,364,"10,539.31",2260
,20130301,57890,57900,57400,57440,56760,56800,57060,-1100,-840,1254,"35,779.11",2654
,20130304,56800,57060,56780,56860,56140,56390,56480,-670,-580,1158,"32,706.78",2692
,20130305,56390,56480,56720,57040,56700,56980,56870,500,390,550,"15,639.65",2794
,20130306,56980,56870,57160,57170,56670,56690,56870,-180,0,688,"19,564.62",2990
,20130307,56690,56870,56460,56580,56260,56520,56420,-350,-450,1700,"47,958.73",3568
,20130308,56520,56420,56800,56850,56610,56820,56730,400,310,1020,"28,936.61",3628
,20130311,56820,56730,56400,56870,56400,56500,56670,-230,-60,1398,"39,616.66",4014
,20130312,56500,56670,56710,56870,56400,56460,56670,-210,0,2054,"58,202.23",4830
,20130313,56460,56670,56910,57250,56760,56980,56960,310,290,1594,"45,401.28",4970
,20130314,56980,56960,56830,56830,56330,56760,56580,-200,-380,2828,"80,016.23",5858
,20130315,56760,56580,56860,57360,56810,57080,56980,500,400,2620,"74,654.95",6804
,20130318,57080,56980,56500,56500,54620,55210,55220,-1770,-1760,8770,"242,145.78",9894
,20130319,55210,55220,55300,55370,54790,54960,55090,-260,-130,6338,"174,601.17",12526
,20130320,54960,55090,54600,55480,54500,55370,55130,280,40,9082,"250,384.06",14324
,20130321,55370,55130,55480,56670,55480,55830,56010,700,880,8482,"237,566.72",14478
,20130322,55830,56010,55660,55950,55510,55640,55710,-370,-300,4906,"136,672.51",15702
,20130325,55640,55710,56010,56260,55900,55930,56090,220,380,6062,"170,030.79",17456
,20130326,55930,56090,55730,55970,55500,55810,55730,-280,-360,4446,"123,909.38",18006
,20130327,55810,55730,55950,55950,55500,55610,55670,-120,-60,8098,"225,410.34",21620
,20130328,55610,55670,55790,55920,55240,55330,55530,-340,-140,10108,"280,655.22",23872
,20130329,55330,55530,54750,55530,54610,54850,55050,-680,-480,16430,"452,288.67",26638
,20130401,54850,55050,54440,54520,53640,53730,54070,-1320,-980,31386,"848,622.16",39852
,20130402,53730,54070,54020,54560,53990,54500,54280,430,210,25584,"694,349.86",43394
,20130403,54500,54280,54550,54670,53870,54010,54330,-270,50,33916,"921,399.77",50552
,20130408,54010,54330,54000,54610,53950,54580,54300,250,-30,26546,"720,836.78",55288
,20130409,54580,54300,54840,55100,54700,55100,54910,800,610,37022,"1,016,551.27",60868
,20130410,55100,54910,55300,55440,55050,55150,55260,240,350,31688,"875,611.65",64110
,20130411,55150,55260,54880,55300,54880,54900,55050,-360,-210,25650,"706,077.70",68592
,20130412,54900,55050,55160,55250,54950,55150,55080,100,30,32278,"889,011.89",72782
,20130415,55150,55080,53950,54150,52920,53370,53530,-1710,-1550,132296,"3,541,201.91",104942
,20130416,53370,53530,52240,53080,51890,52910,52490,-620,-1040,137964,"3,621,127.73",121894
,20130417,52910,52490,53120,53250,52100,52180,52650,-310,160,140842,"3,707,831.99",137508
,20130418,52180,52650,50540,50540,50540,50540,50540,-2110,-2110,24514,"619,468.78",136132
,20130419,50540,50540,50760,50990,49710,50650,50430,110,-110,257080,"6,483,162.77",158928
,20130422,50650,50430,50400,50700,48820,48860,49650,-1570,-780,270390,"6,712,996.21",201216
,20130423,48860,49650,49400,49650,48410,49070,49030,-580,-620,370224,"9,077,033.79",229254
,20130424,49070,49030,49200,50990,48900,50520,49900,1490,870,451534,"11,265,888.71",248440
,20130425,50520,49900,50780,51300,50340,51230,50900,1330,1000,396946,"10,102,917.10",252282
,20130426,51230,50900,52100,52490,51220,51630,51780,730,880,437612,"11,331,777.12",253968
,20130502,51630,51780,49190,49820,49190,49520,49420,-2260,-2360,405468,"10,019,547.92",290364
,20130503,49520,49420,49920,51200,49630,51000,50480,1580,1060,830936,"20,976,414.69",307006
,20130506,51000,50480,53000,53000,52320,52850,52680,2370,2200,666256,"17,551,603.61",282702
,20130507,52850,52680,52610,53300,52160,52190,52680,-490,0,889338,"23,425,711.25",293326
,20130508,52190,52680,52380,53100,52380,53050,52680,370,0,781126,"20,577,865.45",286868
,20130509,53050,52680,53420,53430,52650,52960,52940,280,260,684632,"18,124,081.80",296484
,20130510,52960,52940,52700,53490,52520,53420,53000,480,60,799072,"21,176,398.15",278646
,20130513,53420,53000,53300,53770,53020,53400,53360,400,360,649302,"17,323,913.42",291116
,20130514,53400,53360,53500,53740,52610,52680,53100,-680,-260,760656,"20,197,091.99",290630
,20130515,52680,53100,52800,52850,51930,51990,52410,-1110,-690,711696,"18,650,791.46",302008
,20130516,51990,52410,52010,52480,51660,52150,52060,-260,-350,759762,"19,778,414.28",300668
,20130517,52150,52060,52360,53220,52310,52980,52680,920,620,604640,"15,927,156.38",291214
,20130520,52980,52680,52880,53000,52390,52530,52640,-150,-40,648316,"17,065,228.05",283872
,20130521,52530,52640,53150,53480,53010,53420,53230,780,590,602402,"16,034,247.81",274084
,20130522,53420,53230,53210,53810,53130,53580,53480,350,250,563356,"15,064,733.93",283234
,20130523,53580,53480,53310,53330,52130,52350,52640,-1130,-840,796470,"20,966,293.03",293710
,20130524,52350,52640,52690,53000,52410,52900,52750,260,110,669398,"17,658,569.76",273300
,20130527,52900,52750,52550,52680,52230,52510,52440,-240,-310,438730,"11,504,606.92",276706
,20130528,52510,52440,52720,52770,51930,52650,52300,210,-140,675902,"17,676,868.70",284936
,20130529,52650,52300,52510,52950,52230,52290,52620,-10,320,517290,"13,611,458.51",263848
,20130530,52290,52620,52300,52490,51790,52420,52220,-200,-400,695526,"18,163,196.36",253282
,20130531,52420,52220,52790,53050,52520,52720,52760,500,540,415890,"10,972,345.58",241966
,20130603,52720,52760,53000,53220,52790,53010,52970,250,210,318192,"8,427,888.36",233720
,20130604,53010,52970,52960,53250,52880,53090,53060,120,90,213948,"5,676,189.98",215234
,20130605,53090,53060,53350,53650,53250,53640,53430,580,370,203298,"5,431,418.27",204080
,20130606,53640,53430,53350,53580,52900,53070,53250,-360,-180,204376,"5,441,622.49",196264
,20130607,53070,53250,53100,53260,52880,53140,53060,-110,-190,141634,"3,757,747.97",177906
,20130613,53140,53060,51820,52140,51600,51730,51890,-1330,-1170,185486,"4,813,129.81",150538
,20130614,51730,51890,51680,51890,51460,51660,51680,-230,-210,80192,"2,072,400.38",147168
,20130617,51660,51680,51750,52110,51720,51890,51900,210,220,57708,"1,497,784.96",140794
,20130618,51890,51900,51750,51900,51170,51220,51440,-680,-460,80502,"2,070,758.09",139134
,20130619,51220,51440,51090,51260,50790,51160,50970,-280,-470,54922,"1,399,717.87",139110
,20130620,51160,50970,50420,50480,49850,49890,50120,-1080,-850,65980,"1,653,590.39",132076
,20130621,49890,50120,49150,49900,48650,49850,49310,-270,-810,85176,"2,100,225.99",123506
,20130624,49850,49310,49650,49720,48220,48290,48900,-1020,-410,67142,"1,641,663.46",116266
,20130625,48290,48900,48480,49140,47860,48780,48480,-120,-420,67458,"1,635,290.72",110230
,20130626,48780,48480,49380,49450,48250,48270,48740,-210,260,42660,"1,039,781.52",109374
,20130627,48270,48740,48580,49140,48440,49010,48800,270,60,35580,"868,190.58",105824
,20130628,49010,48800,48520,48970,48180,48850,48670,50,-130,29474,"717,286.99",103906
,20130701,48850,48670,48720,49800,48590,49710,49300,1040,630,46480,"1,145,931.08",99070
,20130702,49710,49300,50070,50420,49920,50380,50200,1080,900,39588,"993,704.21",94414
,20130703,50380,50200,50380,50780,50180,50750,50460,550,260,30770,"776,469.73",93478
,20130704,50750,50460,50680,50780,50280,50300,50440,-160,-20,28456,"717,726.61",92418
,20130705,50300,50440,50330,50390,48010,49620,49880,-820,-560,29960,"747,285.49",90166
,20130708,49620,49880,49490,49490,48960,49030,49150,-850,-730,24570,"603,861.45",85754
,20130709,49030,49150,49250,49640,49100,49310,49400,160,250,22058,"544,897.12",82686
,20130710,49310,49400,49100,49230,48510,49100,48830,-300,-570,26346,"643,252.58",77888
,20130711,49100,48830,49950,51220,49950,51000,50630,2170,1800,40590,"1,027,685.24",74202
,20130712,51000,50630,50970,51000,50060,50070,50580,-560,-50,23826,"602,601.96",69506
,20130715,50070,50580,50090,50560,50000,50240,50250,-340,-330,17394,"437,033.23",68436
,20130716,50240,50250,50300,50580,50070,50550,50320,300,70,12102,"304,493.54",68464
,20130717,50550,50320,50640,50970,50200,50230,50570,-90,250,25172,"636,581.18",67222
,20130718,50230,50570,50030,50110,49760,49990,49880,-580,-690,13288,"331,461.80",66834
,20130719,49990,49880,50150,50550,49860,49900,50270,20,390,11858,"298,077.00",65986
,20130722,49900,50270,50280,50670,50230,50640,50470,370,200,10974,"276,981.35",65050
,20130723,50640,50470,50710,50980,50550,50620,50780,150,310,15016,"381,259.90",63868
,20130724,50620,50780,50780,50990,50490,50840,50740,60,-40,14094,"357,580.42",62178
,20130725,50840,50740,50640,50900,50550,50870,50720,130,-20,8328,"211,215.94",61660
,20130726,50870,50720,50880,50960,50250,50380,50570,-340,-150,10644,"269,181.74",60254
,20130729,50380,50570,49780,49780,49390,49590,49550,-980,-1020,16278,"403,357.41",59414
,20130730,49590,49550,49710,49710,49230,49350,49580,-200,30,12622,"312,930.27",60360
,20130731,49350,49580,49050,49680,49030,49680,49380,100,-200,16364,"404,105.50",59610
,20130801,49680,49380,49800,50540,49800,50370,50240,990,860,14426,"362,409.87",56750
,20130802,50370,50240,50590,50620,50150,50400,50410,160,170,9718,"244,983.42",54378
,20130805,50400,50410,50410,50650,50300,50590,50510,180,100,7262,"183,414.97",53600
,20130806,50590,50510,50400,50590,50300,50580,50470,70,-40,5474,"138,162.38",52926
,20130807,50580,50470,50470,50520,50260,50480,50400,10,-70,6874,"173,235.62",52992
,20130808,50480,50400,50940,51830,50860,51810,51440,1410,1040,27968,"719,369.18",49932
,20130809,51810,51440,51870,52120,51600,51800,51840,360,400,17702,"458,849.02",50352
,20130812,51800,51840,51830,52790,51830,52680,52300,840,460,22972,"600,831.11",48744
,20130813,52680,52300,52530,52550,52230,52460,52410,160,110,17386,"455,634.61",49452
,20130814,52460,52410,52410,52870,52240,52490,52510,80,100,17816,"467,786.69",49430
,20130815,52490,52510,52510,52770,52350,52550,52600,40,90,15138,"398,144.57",50640
,20130816,52550,52600,52600,53510,52600,53380,53110,780,510,22578,"599,572.16",50922
,20130819,53380,53110,53350,53380,53050,53070,53200,-40,90,15070,"400,903.97",50428
,20130820,53070,53200,52940,53000,52480,52640,52750,-560,-450,14878,"392,409.29",49864
,20130821,52640,52750,52750,52900,52700,52870,52770,120,20,12086,"318,947.14",49570
,20130822,52870,52770,52530,53180,52500,53180,52970,410,200,19564,"518,172.35",50020
,20130823,53180,52970,52970,53100,52810,53070,52980,100,10,18172,"481,441.36",49764
,20130826,53070,52980,53540,53910,53460,53700,53570,720,590,17080,"457,538.16",49512
,20130827,53700,53570,53270,53410,53080,53200,53210,-370,-360,18528,"492,978.86",48492
,20130828,53200,53210,53070,53280,52710,52760,53080,-450,-130,20224,"536,820.90",47026
,20130829,52760,53080,52560,52870,52400,52740,52640,-340,-440,24802,"652,796.48",42414
,20130830,52740,52640,52200,53080,52180,52320,52270,-320,-370,18584,"485,759.67",39778
,20130902,52320,52270,52720,53040,52560,52850,52790,580,520,15828,"417,829.78",37400
,20130903,52850,52790,52330,53000,52330,52690,52730,-100,-60,10450,"275,542.65",34640
,20130904,52690,52730,52620,52620,52320,52380,52460,-350,-270,8390,"220,072.70",33130
,20130905,52380,52460,52130,52280,51900,52060,52020,-400,-440,16560,"430,796.00",31170
,20130906,52060,52020,52160,52250,52020,52250,52130,230,110,7490,"195,234.80",29570
,20130909,52250,52130,52460,52690,52400,52600,52580,470,450,13750,"361,540.25",27380
,20130910,52600,52580,52510,52510,52170,52330,52320,-250,-260,12780,"334,337.35",24330
,20130911,52330,52320,52420,52510,52220,52420,52390,100,70,11690,"306,240.55",21220
,20130912,52420,52390,52290,52290,51880,51880,52070,-510,-320,10730,"279,382.10",15610
,20130913,51880,52070,51650,51880,51620,51850,51680,-220,-390,7630,"197,166.35",10680
,20130916,51850,51680,52000,52080,51860,51880,52010,200,330,6920,"179,961.50",5970
cu1310,20130104,58430,58380,58870,58880,58720,58820,58790,440,410,48,"1,410.96",1296
,20130107,58820,58790,58660,58880,58560,58590,58740,-200,-50,42,"1,233.65",1308
,20130108,58590,58740,58770,58980,58740,58840,58820,100,80,114,"3,353.13",1306
,20130109,58840,58820,58830,58850,58800,58800,58830,-20,10,26,764.87,1302
,20130110,58800,58830,59020,59370,58920,59370,59110,540,280,58,"1,714.20",1312
,20130111,59370,59110,59520,59520,59060,59060,59290,-50,180,22,652.24,1314
,20130114,59060,59290,59000,59220,58980,59120,59090,-170,-200,20,590.92,1314
,20130115,59120,59090,58900,58900,58620,58620,58740,-470,-350,16,469.98,1312
,20130116,58620,58740,58570,58680,58530,58680,58560,-60,-180,22,644.24,1318
,20130117,58680,58560,58370,58410,58140,58380,58300,-180,-260,32,932.9,1316
,20130118,58380,58300,58830,59150,58780,59150,58950,850,650,22,648.53,1316
,20130121,59150,58950,59080,59100,59000,59000,59070,50,120,36,"1,063.26",1352
,20130122,59000,59070,59180,59500,59180,59500,59340,430,270,22,652.78,1356
,20130123,59500,59340,59330,59410,59320,59400,59370,60,30,54,"1,603.23",1366
,20130124,59400,59370,59300,59340,59110,59230,59210,-140,-160,128,"3,789.53",1378
,20130125,59230,59210,59300,59500,59300,59370,59420,160,210,36,"1,069.70",1384
,20130128,59370,59420,59250,59300,59180,59250,59240,-170,-180,22,651.64,1374
,20130129,59250,59240,59110,59440,59090,59440,59190,200,-50,28,828.68,1370
,20130130,59440,59190,59970,59970,59810,59880,59880,690,690,12,359.3,1360
,20130131,59880,59880,60290,60290,59990,60200,60080,320,200,170,"5,107.05",1450
,20130201,60200,60080,59970,60100,59840,60100,59970,20,-110,40,"1,199.45",1458
,20130204,60100,59970,60540,60670,60380,60390,60460,420,490,64,"1,934.97",1436
,20130205,60390,60460,60280,60360,60170,60360,60250,-100,-210,92,"2,771.63",1400
,20130206,60360,60250,60260,60520,60160,60310,60290,60,40,22,663.23,1404
,20130207,60310,60290,60010,60120,60000,60120,60060,-170,-230,12,360.36,1406
,20130208,60120,60060,60260,60310,60200,60220,60240,160,180,14,421.68,1408
,20130218,60220,60240,60170,60170,59500,59500,59590,-740,-650,144,"4,290.84",1436
,20130219,59500,59590,59230,59540,59180,59230,59280,-360,-310,558,"16,540.33",1756
,20130220,59230,59280,59220,59220,58970,59070,59050,-210,-230,24,708.61,1748
,20130221,59070,59050,58390,58390,57650,58000,57940,-1050,-1110,234,"6,779.61",1768
,20130222,58000,57940,57850,58140,57850,58030,58000,90,60,208,"6,032.95",1856
,20130225,58030,58000,57730,57740,57400,57580,57580,-420,-420,254,"7,313.20",1938
,20130226,57580,57580,57500,57750,57330,57330,57500,-250,-80,164,"4,715.35",1942
,20130227,57330,57500,57820,57940,57700,57720,57800,220,300,364,"10,521.12",2222
,20130228,57720,57800,58000,58000,57740,57920,57880,120,80,124,"3,588.71",2176
,20130301,57920,57880,57400,57400,56840,56990,57100,-890,-780,316,"9,022.48",2106
,20130304,56990,57100,56800,56840,56220,56470,56580,-630,-520,370,"10,468.67",2072
,20130305,56470,56580,56780,57050,56740,57030,56900,450,320,118,"3,357.32",2080
,20130306,57030,56900,57000,57190,56700,56700,56840,-200,-60,600,"17,054.85",2214
,20130307,56700,56840,56460,56600,56270,56580,56420,-260,-420,484,"13,653.83",2306
,20130308,56580,56420,56960,56960,56650,56780,56760,360,340,130,"3,689.82",2290
,20130311,56780,56760,56700,56890,56510,56510,56720,-250,-40,176,"4,991.36",2258
,20130312,56510,56720,56790,56880,56430,56530,56620,-190,-100,700,"19,819.98",2510
,20130313,56530,56620,57010,57240,56830,56900,57020,280,400,234,"6,672.13",2506
,20130314,56900,57020,56800,56800,56440,56800,56610,-220,-410,394,"11,153.65",2562
,20130315,56800,56610,56900,57230,56860,57120,57020,510,410,170,"4,846.91",2554
,20130318,57120,57020,56550,56550,54680,55240,55370,-1780,-1650,1412,"39,093.26",2932
,20130319,55240,55370,55450,55450,54850,55020,55160,-350,-210,2524,"69,616.28",3690
,20130320,55020,55160,54830,55550,54590,55450,55170,290,10,1516,"41,823.81",4022
,20130321,55450,55170,55680,56690,55680,55890,56090,720,920,444,"12,453.60",4024
,20130322,55890,56090,55670,55970,55550,55700,55760,-390,-330,752,"20,966.48",4374
,20130325,55700,55760,55960,56290,55950,55950,56110,190,350,556,"15,601.22",4528
,20130326,55950,56110,55810,56000,55600,55780,55770,-330,-340,542,"15,115.55",4446
,20130327,55780,55770,55910,55940,55550,55630,55680,-140,-90,744,"20,716.08",4704
,20130328,55630,55680,55800,55910,55260,55330,55580,-350,-100,932,"25,901.76",4916
,20130329,55330,55580,54860,55560,54860,54900,55080,-680,-500,1224,"33,709.81",5262
,20130401,54900,55080,54690,54690,53750,53750,54080,-1330,-1000,2280,"61,655.80",6318
,20130402,53750,54080,54110,54630,54110,54600,54370,520,290,1130,"30,720.95",6306
,20130403,54600,54370,54520,54680,53910,54190,54390,-180,20,2540,"69,087.08",6878
,20130408,54190,54390,54200,54620,53990,54610,54340,220,-50,2498,"67,878.80",7610
,20130409,54610,54340,54690,55090,54690,55050,54900,710,560,1898,"52,106.31",8118
,20130410,55050,54900,55310,55430,55040,55180,55240,280,340,2730,"75,410.92",8408
,20130411,55180,55240,55000,55280,54890,54900,55040,-340,-200,2884,"79,376.17",9246
,20130412,54900,55040,55150,55250,54980,55180,55110,140,70,3270,"90,105.90",10466
,20130415,55180,55110,54000,54360,52950,53380,53540,-1730,-1570,12794,"342,500.59",14640
,20130416,53380,53540,52400,53080,51960,52920,52520,-620,-1020,10464,"274,795.75",16874
,20130417,52920,52520,53070,53270,52130,52200,52630,-320,110,11474,"301,963.24",19120
,20130418,52200,52630,50520,50520,50520,50520,50520,-2110,-2110,3734,"94,320.84",18974
,20130419,50520,50520,50690,51000,49720,50710,50400,190,-120,29628,"746,661.75",23708
,20130422,50710,50400,50180,50670,48850,48900,49670,-1500,-730,29814,"740,518.76",30362
,20130423,48900,49670,49410,49630,48430,49030,48990,-640,-680,43642,"1,069,080.28",37238
,20130424,49030,48990,49210,50940,48940,50520,49940,1530,950,52670,"1,315,384.97",41548
,20130425,50520,49940,50810,51300,50360,51240,50920,1300,980,41968,"1,068,570.23",44932
,20130426,51240,50920,52000,52510,51200,51620,51780,700,860,52468,"1,358,398.79",49842
,20130502,51620,51780,49190,49760,49190,49500,49370,-2280,-2410,52650,"1,299,866.14",58858
,20130503,49500,49370,49870,51080,49610,50980,50380,1610,1010,87244,"2,197,961.08",65010
,20130506,50980,50380,52890,52890,52280,52830,52640,2450,2260,68180,"1,794,806.61",62904
,20130507,52830,52640,52550,53260,52110,52120,52650,-520,10,89580,"2,358,438.51",78000
,20130508,52120,52650,52360,53060,52320,52980,52640,330,-10,74610,"1,963,910.24",72710
,20130509,52980,52640,53390,53400,52600,52900,52900,260,260,58752,"1,554,255.89",75976
,20130510,52900,52900,52600,53450,52470,53410,52930,510,30,77394,"2,048,546.17",76592
,20130513,53410,52930,53260,53720,52980,53320,53320,390,390,69218,"1,845,432.91",80414
,20130514,53320,53320,53500,53670,52520,52580,53010,-740,-310,95036,"2,519,329.12",87606
,20130515,52580,53010,53100,53100,51880,51910,52350,-1100,-660,100920,"2,641,645.68",93890
,20130516,51910,52350,51960,52380,51580,52080,51980,-270,-370,114896,"2,986,493.25",98234
,20130517,52080,51980,52300,53150,52230,52930,52630,950,650,137918,"3,629,939.29",99480
,20130520,52930,52630,52800,52940,52300,52410,52530,-220,-100,174770,"4,590,347.75",129232
,20130521,52410,52530,53080,53380,52920,53350,53140,820,610,153080,"4,068,024.02",125228
,20130522,53350,53140,53110,53720,53050,53550,53370,410,230,120932,"3,227,414.66",126484
,20130523,53550,53370,53210,53230,52060,52230,52590,-1140,-780,193512,"5,088,776.13",146988
,20130524,52230,52590,52590,52900,52320,52800,52660,210,70,176282,"4,642,317.94",149114
,20130527,52800,52660,52400,52590,52170,52400,52360,-260,-300,148112,"3,877,767.38",159332
,20130528,52400,52360,52600,52670,51850,52540,52210,180,-150,235076,"6,136,724.69",168056
,20130529,52540,52210,52370,52850,52100,52120,52510,-90,300,202392,"5,313,952.95",175460
,20130530,52120,52510,52100,52350,51640,52270,52080,-240,-430,302790,"7,885,517.50",187768
,20130531,52270,52080,52620,52900,52390,52590,52630,510,550,199740,"5,257,006.46",183060
,20130603,52590,52630,52860,53150,52680,52940,52860,310,230,203514,"5,379,257.30",191450
,20130604,52940,52860,52900,53150,52730,52980,52950,120,90,248980,"6,592,692.11",197560
,20130605,52980,52950,53210,53550,53130,53520,53310,570,360,325556,"8,679,202.27",209562
,20130606,53520,53310,53200,53460,52710,52900,53090,-410,-220,506862,"13,455,319.33",240806
,20130607,52900,53090,52980,53150,52700,53050,52930,-40,-160,405392,"10,729,046.63",228346
,20130613,53050,52930,51520,51960,51350,51510,51670,-1420,-1260,527094,"13,619,018.25",283004
,20130614,51510,51670,51500,51720,51250,51450,51490,-220,-180,426044,"10,969,386.06",291974
,20130617,51450,51490,51550,51960,51520,51710,51720,220,230,366220,"9,471,652.37",276320
,20130618,51710,51720,51600,51720,50960,51030,51240,-690,-480,587294,"15,046,547.84",321538
,20130619,51030,51240,50910,51070,50580,50950,50770,-290,-470,486386,"12,349,284.08",325326
,20130620,50950,50770,50210,50300,49620,49720,49920,-1050,-850,533852,"13,325,724.38",362700
,20130621,49720,49920,48960,49700,48390,49650,49140,-270,-780,783580,"19,255,153.90",369552
,20130624,49650,49140,49470,49520,47900,47950,48620,-1190,-520,916760,"22,289,560.64",427122
,20130625,47950,48620,48100,48950,47560,48580,48200,-40,-420,1110176,"26,758,038.92",382018
,20130626,48580,48200,49230,49260,47960,48060,48460,-140,260,925342,"22,421,230.72",402712
,20130627,48060,48460,48300,48920,48160,48780,48560,320,100,779004,"18,917,971.23",369590
,20130628,48780,48560,48220,48780,47900,48580,48390,20,-170,634078,"15,344,398.18",351094
,20130701,48580,48390,48480,49520,48320,49420,49040,1030,650,673604,"16,518,967.74",353646
,20130702,49420,49040,49790,50210,49640,50100,49940,1060,900,584198,"14,587,935.59",301558
,20130703,50100,49940,50090,50580,49920,50550,50240,610,300,540168,"13,569,348.24",315366
,20130704,50550,50240,50430,50580,50080,50130,50240,-110,0,404508,"10,162,987.78",285690
,20130705,50130,50240,50110,50210,49390,49440,49680,-800,-560,346706,"8,613,331.03",257058
,20130708,49440,49680,49130,49260,48750,48860,48940,-820,-740,289934,"7,095,745.26",241980
,20130709,48860,48940,49060,49470,48880,49150,49200,210,260,243410,"5,988,477.91",218758
,20130710,49150,49200,48910,49010,48300,48890,48640,-310,-560,248154,"6,035,209.91",193462
,20130711,48890,48640,49800,51070,49770,50800,50480,2160,1840,246256,"6,215,721.58",174280
,20130712,50800,50480,50860,50860,49880,49910,50390,-570,-90,117150,"2,951,855.68",163872
,20130715,49910,50390,49970,50430,49820,50090,50110,-300,-280,97668,"2,447,517.80",159280
,20130716,50090,50110,50070,50400,49920,50400,50160,290,50,63152,"1,583,972.63",158182
,20130717,50400,50160,50480,50860,50030,50050,50410,-110,250,114962,"2,897,952.78",149002
,20130718,50050,50410,49950,49950,49590,49880,49720,-530,-690,67938,"1,689,006.28",142650
,20130719,49880,49720,50050,50400,49700,49730,50120,10,400,39248,"983,669.73",141502
,20130722,49730,50120,50250,50520,50080,50480,50340,360,220,38990,"981,387.01",136942
,20130723,50480,50340,50520,50850,50400,50450,50650,110,310,61924,"1,568,421.97",123220
,20130724,50450,50650,50730,50840,50360,50730,50590,80,-60,40174,"1,016,258.40",119488
,20130725,50730,50590,50540,50730,50400,50660,50570,70,-20,24296,"614,440.83",118362
,20130726,50660,50570,50700,50810,50090,50250,50410,-320,-160,28064,"707,482.33",117402
,20130729,50250,50410,49440,49580,49190,49340,49360,-1070,-1050,39894,"984,647.05",109622
,20130730,49340,49360,49460,49530,49170,49180,49380,-180,20,25334,"625,551.94",105402
,20130731,49180,49380,48800,49470,48800,49450,49150,70,-230,26978,"663,097.62",101620
,20130801,49450,49150,49760,50390,49750,50220,50070,1070,920,24622,"616,472.53",98316
,20130802,50220,50070,50440,50480,50000,50250,50240,180,170,17694,"444,476.80",95644
,20130805,50250,50240,50270,50490,50130,50360,50340,120,100,14360,"361,458.82",95256
,20130806,50360,50340,50200,50400,50110,50360,50280,20,-60,14376,"361,480.02",93940
,20130807,50360,50280,50210,50350,50070,50300,50190,20,-90,10748,"269,764.55",93176
,20130808,50300,50190,50620,51720,50620,51650,51300,1460,1110,36244,"929,725.78",88822
,20130809,51650,51300,51650,51990,51450,51680,51720,380,420,18104,"468,173.24",87134
,20130812,51680,51720,52150,52730,51960,52520,52250,800,530,24658,"644,263.78",81294
,20130813,52520,52250,52520,52520,52130,52350,52320,100,70,16682,"436,417.25",78600
,20130814,52350,52320,52260,52750,52150,52340,52390,20,70,16928,"443,492.51",78002
,20130815,52340,52390,52540,52680,52230,52310,52460,-80,70,11550,"302,992.01",76354
,20130816,52310,52460,52600,53450,52580,53390,53010,930,550,29002,"768,765.26",71256
,20130819,53390,53010,53340,53340,52950,52990,53120,-20,110,9298,"246,973.35",69860
,20130820,52990,53120,52730,52910,52330,52450,52610,-670,-510,8628,"226,976.17",69692
,20130821,52450,52610,52600,52770,52530,52680,52640,70,30,5716,"150,449.90",69930
,20130822,52680,52640,52400,53080,52360,52980,52830,340,190,11448,"302,427.67",70052
,20130823,52980,52830,52860,52990,52660,52960,52860,130,30,9354,"247,234.48",70608
,20130826,52960,52860,53500,53870,53340,53510,53470,650,610,12180,"325,667.21",67944
,20130827,53510,53470,53200,53300,52960,53020,53080,-450,-390,13248,"351,631.84",66672
,20130828,53020,53080,52930,53150,52560,52600,52950,-480,-130,8582,"227,217.75",66726
,20130829,52600,52950,52670,52790,52230,52610,52500,-340,-450,15824,"415,446.32",65108
,20130830,52610,52500,52120,52330,52040,52230,52140,-270,-360,12656,"329,976.29",64492
,20130902,52230,52140,52400,52920,52390,52700,52660,560,520,19896,"523,896.90",62642
,20130903,52700,52660,52700,52940,52440,52570,52610,-90,-50,9846,"259,018.49",63668
,20130904,52570,52610,52630,52630,52200,52240,52350,-370,-260,7942,"207,908.97",64026
,20130905,52240,52350,51920,52170,51760,51950,51930,-400,-420,16112,"418,373.61",64494
,20130906,51950,51930,51970,52130,51900,52100,52000,170,70,10888,"283,090.06",64684
,20130909,52100,52000,52100,52600,52100,52470,52500,470,500,10908,"286,344.62",64008
,20130910,52470,52500,52410,52420,52040,52180,52210,-320,-290,14686,"383,440.96",64868
,20130911,52180,52210,52310,52430,52080,52270,52270,60,60,14124,"369,191.70",68326
,20130912,52270,52270,52130,52200,51700,51710,51930,-560,-340,21482,"557,871.63",70754
,20130913,51710,51930,51550,51710,51370,51570,51480,-360,-450,22202,"571,576.32",68740
,20130916,51570,51480,51870,51940,51430,51600,51650,120,170,14366,"371,027.37",71102
,20130917,51600,51650,51490,51830,51240,51810,51560,160,-90,17830,"459,723.71",68242
,20130918,51810,51560,51690,52030,51520,52030,51700,470,140,21082,"545,006.55",65210
,20130923,52030,51700,52410,52410,52060,52380,52180,680,480,28980,"756,209.00",60452
,20130924,52380,52180,52260,52450,52140,52150,52300,-30,120,28942,"756,899.06",57540
,20130925,52150,52300,52160,52270,52030,52230,52120,-70,-180,23390,"609,633.83",51254
,20130926,52230,52120,52250,52620,52110,52560,52330,440,210,28442,"744,211.99",43312
,20130927,52560,52330,52550,52800,52500,52650,52620,320,290,25040,"658,854.85",38842
,20130930,52650,52620,52650,53050,52530,52990,52730,370,110,27978,"737,769.45",31324
,20131008,52990,52730,52750,52840,52570,52750,52660,20,-70,11724,"308,693.12",30670
,20131009,52750,52660,52450,52530,52090,52160,52300,-500,-360,15970,"417,661.20",27710
,20131010,52160,52300,51820,51990,51800,51950,51900,-350,-400,12510,"324,641.40",24550
,20131011,51950,51900,52180,52340,52030,52070,52150,170,250,9490,"247,475.75",19410
,20131014,52070,52150,52100,52720,51930,52630,52210,480,60,11240,"293,466.35",13600
,20131015,52630,52210,52630,52630,52300,52310,52440,100,230,5970,"156,550.45",10580
cu1311,20130104,58500,58440,58900,59060,58840,58970,58910,530,470,114,"3,358.09",602
,20130107,58970,58910,58820,58950,58820,58950,58930,40,20,26,766.09,612
,20130108,58950,58930,58810,59020,58810,58990,58950,60,20,22,648.52,628
,20130109,58990,58950,58950,58950,58860,58860,58900,-90,-50,4,117.81,626
,20130110,58860,58900,59030,59180,59030,59150,59130,250,230,14,413.96,628
,20130111,59150,59130,59550,59550,59250,59250,59350,120,220,8,237.4,628
,20130114,59250,59350,59130,59130,59130,59130,59130,-220,-220,2,59.13,628
,20130115,59130,59130,58870,58870,58520,58520,58720,-610,-410,32,939.53,626
,20130116,58520,58720,58650,58800,58630,58770,58690,50,-30,26,762.97,614
,20130117,58770,58690,58400,58410,58400,58410,58400,-280,-290,12,350.41,602
,20130118,58410,58400,58960,59200,58850,59200,59110,800,710,28,827.63,602
,20130121,59200,59110,59160,59160,59060,59060,59100,-50,-10,44,"1,300.22",628
,20130122,59060,59100,59350,59620,59350,59620,59510,520,410,14,416.6,634
,20130123,59620,59510,59750,59750,59340,59470,59490,-40,-20,48,"1,427.91",642
,20130124,59470,59490,59410,59420,59250,59300,59340,-190,-150,24,712.18,644
,20130125,59300,59340,59360,59660,59360,59560,59560,220,220,14,416.95,646
,20130128,59560,59560,59350,59350,59320,59320,59340,-240,-220,12,356.07,642
,20130129,59320,59340,59410,59560,59220,59500,59390,160,50,26,772.15,646
,20130130,59500,59390,59630,59940,59630,59900,59850,510,460,10,299.27,646
,20130131,59900,59850,60300,60300,60150,60200,60220,350,370,42,"1,264.66",652
,20130201,60200,60220,60010,60250,59880,60160,60060,-60,-160,106,"3,183.46",690
,20130204,60160,60060,60560,60750,60380,60380,60570,320,510,28,848.06,688
,20130205,60380,60570,60280,60450,60180,60180,60300,-390,-270,66,"1,990.10",716
,20130206,60180,60300,60310,60510,60240,60280,60410,-20,110,18,543.7,716
,20130207,60280,60410,60120,60160,60000,60160,60050,-250,-360,10,300.28,720
,20130208,60160,60050,60200,60330,60200,60260,60260,210,210,6,180.79,724
,20130218,60260,60260,60000,60000,59630,59630,59830,-630,-430,18,538.53,728
,20130219,59630,59830,59400,59560,59330,59330,59470,-500,-360,22,654.2,734
,20130220,59330,59470,59160,59250,59130,59210,59190,-260,-280,38,"1,124.76",762
,20130221,59210,59190,58150,58170,57720,58050,58000,-1140,-1190,142,"4,118.24",776
,20130222,58050,58000,57930,58230,57930,58120,58110,120,110,192,"5,579.18",796
,20130225,58120,58110,57840,57840,57540,57670,57640,-440,-470,198,"5,706.46",792
,20130226,57670,57640,57670,57800,57400,57400,57600,-240,-40,40,"1,152.09",798
,20130227,57400,57600,57820,57960,57780,57930,57900,330,300,52,"1,505.41",786
,20130228,57930,57900,57980,58000,57860,58000,57970,100,70,36,"1,043.52",782
,20130301,58000,57970,57580,57580,56920,57090,57050,-880,-920,134,"3,822.75",780
,20130304,57090,57050,56650,56850,56200,56500,56450,-550,-600,104,"2,935.76",804
,20130305,56500,56450,56840,57070,56810,57070,56980,620,530,84,"2,393.43",796
,20130306,57070,56980,57050,57200,56760,56870,56840,-110,-140,340,"9,663.16",1040
,20130307,56870,56840,56580,56610,56310,56600,56420,-240,-420,240,"6,771.21",1096
,20130308,56600,56420,56890,56910,56760,56780,56810,360,390,196,"5,567.56",1108
,20130311,56780,56810,56750,56850,56540,56580,56690,-230,-120,112,"3,175.14",1136
,20130312,56580,56690,56880,56880,56450,56500,56700,-190,10,152,"4,309.35",1146
,20130313,56500,56700,57180,57290,56310,57010,57020,310,320,190,"5,417.43",1144
,20130314,57010,57020,56820,56820,56480,56750,56610,-270,-410,212,"6,001.32",1178
,20130315,56750,56610,57020,57240,56890,57100,57060,490,450,66,"1,883.07",1210
,20130318,57100,57060,55790,55790,54920,55260,55320,-1800,-1740,494,"13,665.48",1526
,20130319,55260,55320,55290,55360,54990,55000,55190,-320,-130,638,"17,606.61",1910
,20130320,55000,55190,54800,55530,54750,55510,55220,320,30,232,"6,406.50",1936
,20130321,55510,55220,55560,56410,55560,55950,56020,730,800,308,"8,627.39",1970
,20130322,55950,56020,55790,56010,55650,55750,55820,-270,-200,120,"3,349.29",1992
,20130325,55750,55820,56280,56290,56020,56020,56160,200,340,98,"2,752.03",2010
,20130326,56020,56160,55950,55990,55650,55820,55820,-340,-340,268,"7,480.46",1914
,20130327,55820,55820,55930,55930,55570,55710,55750,-110,-70,90,"2,509.16",1916
,20130328,55710,55750,55860,55920,55310,55400,55580,-350,-170,230,"6,392.54",2024
,20130329,55400,55580,54880,55600,54880,54980,55160,-600,-420,536,"14,785.09",2182
,20130401,54980,55160,54570,54570,53860,53880,54080,-1280,-1080,694,"18,767.75",2594
,20130402,53880,54080,54320,54670,54200,54630,54410,550,330,604,"16,434.46",2714
,20130403,54630,54410,54440,54730,54010,54140,54430,-270,20,350,"9,526.61",2780
,20130408,54140,54430,54100,54660,54100,54630,54380,200,-50,178,"4,840.58",2834
,20130409,54630,54380,54880,55080,54780,55080,54930,700,550,738,"20,271.81",2530
,20130410,55080,54930,55310,55450,55110,55150,55280,220,350,346,"9,563.80",2492
,20130411,55150,55280,55020,55290,54930,54930,55040,-350,-240,166,"4,568.90",2578
,20130412,54930,55040,55140,55250,55010,55180,55090,140,50,418,"11,515.18",2836
,20130415,55180,55090,54000,54170,53000,53470,53590,-1620,-1500,3266,"87,525.88",4580
,20130416,53470,53590,52480,53140,52000,53040,52470,-550,-1120,2898,"76,037.74",5746
,20130417,53040,52470,53190,53290,52200,52300,52750,-170,280,946,"24,951.56",5914
,20130418,52300,52750,50640,50640,50640,50640,50640,-2110,-2110,254,"6,431.28",6052
,20130419,50640,50640,50940,51040,49770,50610,50540,-30,-100,3382,"85,474.71",6612
,20130422,50610,50540,50480,50690,48860,49010,49820,-1530,-720,3566,"88,832.75",7744
,20130423,49010,49820,49570,49620,48450,49060,48970,-760,-850,3938,"96,438.89",8660
,20130424,49060,48970,49110,50920,48930,50500,49780,1530,810,9818,"244,385.44",10616
,20130425,50500,49780,50900,51310,50370,51240,50960,1460,1180,4056,"103,348.67",11136
,20130426,51240,50960,51900,52500,51220,51580,51780,620,820,7302,"189,051.75",11514
,20130502,51580,51780,49190,49770,49190,49490,49410,-2290,-2370,5590,"138,120.81",12932
,20130503,49490,49410,49810,51070,49610,50920,50340,1510,930,6344,"159,705.63",13338
,20130506,50920,50340,52850,52850,52290,52770,52570,2430,2230,12040,"316,520.79",15674
,20130507,52770,52570,51600,53180,51580,52120,52590,-450,20,13108,"344,696.26",17584
,20130508,52120,52590,52400,53000,52300,52950,52570,360,-20,6240,"164,033.56",17372
,20130509,52950,52570,53220,53360,52590,52940,52860,370,290,6416,"169,598.04",18148
,20130510,52940,52860,52500,53430,52410,53400,52930,540,70,7162,"189,549.00",18518
,20130513,53400,52930,53140,53660,53000,53300,53260,370,330,6746,"179,658.57",19346
,20130514,53300,53260,53490,53630,52510,52540,52920,-720,-340,9610,"254,318.54",19962
,20130515,52540,52920,52500,52660,51850,51890,52250,-1030,-670,8358,"218,377.53",20924
,20130516,51890,52250,51850,52360,51570,52050,51950,-200,-300,7712,"200,332.70",21502
,20130517,52050,51950,52300,53110,52220,52900,52560,950,610,13352,"350,897.30",20914
,20130520,52900,52560,52760,52920,52250,52340,52480,-220,-80,13560,"355,829.13",22662
,20130521,52340,52480,53100,53320,52870,53190,53100,710,620,13376,"355,143.75",23868
,20130522,53190,53100,53150,53670,53020,53500,53330,400,230,11664,"311,057.65",25136
,20130523,53500,53330,53230,53230,52050,52190,52530,-1140,-800,25698,"675,067.89",27992
,20130524,52190,52530,52530,52870,52300,52730,52620,200,90,16192,"426,088.39",28482
,20130527,52730,52620,52480,52550,52140,52350,52310,-270,-310,12512,"327,295.51",29758
,20130528,52350,52310,52560,52690,51830,52490,52180,180,-130,19176,"500,387.01",31858
,20130529,52490,52180,52410,52790,52050,52100,52480,-80,300,17984,"471,947.42",33688
,20130530,52100,52480,52000,52300,51600,52220,52010,-260,-470,28892,"751,474.73",37696
,20130531,52220,52010,52590,52850,52340,52500,52570,490,560,18966,"498,535.42",38306
,20130603,52500,52570,52770,53060,52640,52890,52810,320,240,18584,"490,738.48",40446
,20130604,52890,52810,52880,53080,52710,52940,52900,130,90,15706,"415,456.03",41934
,20130605,52940,52900,53190,53500,53080,53470,53260,570,360,20254,"539,458.11",41938
,20130606,53470,53260,53140,53400,52680,52820,53050,-440,-210,28058,"744,283.38",45192
,20130607,52820,53050,52890,53120,52650,53030,52890,-20,-160,21628,"571,996.99",44726
,20130613,53030,52890,51450,51910,51310,51430,51600,-1460,-1290,45180,"1,165,844.13",51728
,20130614,51430,51600,51430,51640,51180,51330,51410,-270,-190,29640,"761,903.52",57494
,20130617,51330,51410,51460,51860,51430,51630,51640,220,230,30626,"790,782.77",57942
,20130618,51630,51640,51530,51620,50880,50950,51150,-690,-490,44466,"1,137,329.17",66536
,20130619,50950,51150,50870,50990,50500,50900,50690,-250,-460,42192,"1,069,558.32",68782
,20130620,50900,50690,50110,50200,49560,49620,49830,-1070,-860,59852,"1,491,314.84",79372
,20130621,49620,49830,48830,49590,48330,49570,49080,-260,-750,118042,"2,897,097.73",89542
,20130624,49570,49080,49370,49430,47850,47870,48560,-1210,-520,137788,"3,345,718.83",102266
,20130625,47870,48560,48010,48860,47470,48490,48060,-70,-500,193828,"4,657,889.02",103986
,20130626,48490,48060,49090,49140,47870,47950,48370,-110,310,179232,"4,334,750.29",119886
,20130627,47950,48370,48220,48770,48040,48670,48430,300,60,160572,"3,888,383.63",130788
,20130628,48670,48430,48000,48610,47760,48410,48240,-20,-190,184182,"4,442,784.79",144612
,20130701,48410,48240,48330,49380,48160,49300,48860,1060,620,199394,"4,871,490.68",161000
,20130702,49300,48860,49640,50050,49460,49970,49750,1110,890,285988,"7,115,320.65",182244
,20130703,49970,49750,49930,50450,49750,50420,50090,670,340,328738,"8,234,100.88",205680
,20130704,50420,50090,50350,50450,49890,49930,50070,-160,-20,321074,"8,039,223.11",215530
,20130705,49930,50070,49940,50030,49210,49220,49480,-850,-590,374304,"9,260,469.31",241218
,20130708,49220,49480,48920,49100,48510,48640,48740,-840,-740,524846,"12,790,691.38",285506
,20130709,48640,48740,48860,49260,48650,48910,49000,170,260,644212,"15,783,316.96",313072
,20130710,48910,49000,48680,48780,48020,48630,48380,-370,-620,822734,"19,905,826.79",342706
,20130711,48630,48380,49510,50790,49510,50700,50300,2320,1920,861172,"21,659,273.35",316932
,20130712,50700,50300,50700,50730,49680,49690,50230,-610,-70,578134,"14,520,212.06",311948
,20130715,49690,50230,49730,50290,49630,49890,49950,-340,-280,642844,"16,055,934.39",322974
,20130716,49890,49950,49900,50280,49720,50250,50000,300,50,532534,"13,315,332.63",326816
,20130717,50250,50000,50350,50760,49850,49890,50260,-110,260,1031218,"25,916,237.22",334164
,20130718,49890,50260,49750,49780,49370,49690,49540,-570,-720,623288,"15,441,588.07",338010
,20130719,49690,49540,49900,50260,49500,49540,49940,0,400,601718,"15,026,349.96",351128
,20130722,49540,49940,50100,50400,49900,50350,50180,410,240,554352,"13,908,722.43",333920
,20130723,50350,50180,50350,50690,50220,50260,50440,80,260,548064,"13,824,092.05",336294
,20130724,50260,50440,50560,50670,50150,50530,50400,90,-40,628748,"15,847,098.80",325082
,20130725,50530,50400,50320,50560,50210,50490,50400,90,0,467778,"11,789,214.84",337360
,20130726,50490,50400,50580,50690,49880,50040,50240,-360,-160,531162,"13,343,832.96",351042
,20130729,50040,50240,49200,49320,48920,49100,49110,-1140,-1130,528664,"12,981,515.05",365528
,20130730,49100,49110,49230,49310,48860,48900,49130,-210,20,408352,"10,031,205.40",381648
,20130731,48900,49130,48510,49240,48500,49200,48910,70,-220,517420,"12,654,885.63",332918
,20130801,49200,48910,49510,50190,49510,50020,49840,1110,930,553596,"13,796,344.61",309488
,20130802,50020,49840,50210,50330,49770,50040,50030,200,190,383864,"9,603,140.85",293122
,20130805,50040,50030,50030,50300,49920,50180,50130,150,100,325888,"8,169,933.47",289866
,20130806,50180,50130,50080,50220,49880,50180,50080,50,-50,288566,"7,226,647.07",280868
,20130807,50180,50080,50080,50150,49840,50070,49980,-10,-100,269160,"6,727,473.39",280146
,20130808,50070,49980,50480,51590,50420,51510,51140,1530,1160,603256,"15,426,233.08",282970
,20130809,51510,51140,51610,51870,51290,51520,51560,380,420,318838,"8,219,647.18",262702
,20130812,51520,51560,51990,52590,51820,52460,52110,900,550,285334,"7,434,593.84",245068
,20130813,52460,52110,52300,52330,51970,52180,52180,70,70,194134,"5,065,152.90",228988
,20130814,52180,52180,52110,52600,52000,52230,52260,50,80,193310,"5,051,678.24",221044
,20130815,52230,52260,52450,52590,52110,52180,52370,-80,110,141612,"3,708,466.06",213420
,20130816,52180,52370,52510,53310,52430,53220,52880,850,510,207128,"5,477,251.41",202398
,20130819,53220,52880,53050,53210,52820,52870,53000,-10,120,93364,"2,474,449.27",189340
,20130820,52870,53000,52750,52800,52180,52300,52470,-700,-530,84680,"2,221,642.65",178260
,20130821,52300,52470,52430,52650,52370,52600,52500,130,30,55394,"1,454,246.50",172958
,20130822,52600,52500,52250,52950,52210,52850,52640,350,140,76660,"2,017,948.55",169200
,20130823,52850,52640,52750,52880,52520,52830,52730,190,90,48722,"1,284,620.09",162778
,20130826,52830,52730,53630,53700,53240,53450,53380,720,650,52514,"1,401,641.61",153930
,20130827,53450,53380,53070,53190,52830,52940,52970,-440,-410,43982,"1,164,992.29",150804
,20130828,52940,52970,52870,53070,52420,52470,52820,-500,-150,48158,"1,271,978.47",145100
,20130829,52470,52820,52520,52670,52100,52490,52370,-330,-450,42162,"1,104,185.14",139152
,20130830,52490,52370,51900,52180,51890,52080,51990,-290,-380,42290,"1,099,479.90",131712
,20130902,52080,51990,52190,52840,52190,52580,52540,590,550,41612,"1,093,323.72",127998
,20130903,52580,52540,52620,52810,52320,52450,52510,-90,-30,28662,"752,610.69",124146
,20130904,52450,52510,52500,52530,52070,52150,52240,-360,-270,19432,"507,639.98",120998
,20130905,52150,52240,51950,52060,51620,51790,51810,-450,-430,29584,"766,437.43",119112
,20130906,51790,51810,51880,52000,51750,51980,51870,170,60,15948,"413,687.39",118712
,20130909,51980,51870,52250,52490,52110,52400,52350,530,480,27796,"727,574.02",119446
,20130910,52400,52350,52350,52350,51890,52120,52080,-230,-270,25530,"664,844.32",118074
,20130911,52120,52080,52200,53280,51970,52160,52150,80,70,12560,"327,542.89",117684
,20130912,52160,52150,52160,52160,51560,51590,51790,-560,-360,22900,"593,105.06",116204
,20130913,51590,51790,51430,51540,51200,51460,51330,-330,-460,46124,"1,183,909.69",106416
,20130916,51460,51330,51700,51790,51260,51320,51510,-10,180,21704,"559,044.00",102156
,20130917,51320,51510,51360,51670,51030,51660,51350,150,-160,22562,"579,281.81",97900
,20130918,51660,51350,51400,51850,51320,51840,51500,490,150,19666,"506,455.75",92728
,20130923,51840,51500,52300,52300,51890,52170,52020,670,520,25488,"663,014.19",86438
,20130924,52170,52020,52140,52280,51900,51900,52090,-120,70,19596,"510,453.76",83816
,20130925,51900,52090,51910,52050,51790,51950,51880,-140,-210,20384,"528,823.95",81558
,20130926,51950,51880,51990,52490,51850,52420,52140,540,260,22128,"576,923.36",74910
,20130927,52420,52140,52440,52670,52310,52490,52460,350,320,18668,"489,713.44",68854
,20130930,52490,52460,52520,52960,52410,52900,52670,440,210,15060,"396,671.22",66272
,20131008,52900,52670,52800,52800,52400,52670,52540,0,-130,16702,"438,768.99",63532
,20131009,52670,52540,52520,52520,51890,52000,52140,-540,-400,25914,"675,677.79",60202
,20131010,52000,52140,51700,51850,51600,51760,51740,-380,-400,20388,"527,449.88",58572
,20131011,51760,51740,51860,52190,51860,51950,52000,210,260,18510,"481,304.98",60526
,20131014,51950,52000,51990,52480,51680,52450,52150,450,150,25846,"673,954.25",62118
,20131015,52450,52150,52500,52590,52280,52420,52390,270,240,23428,"613,797.77",62372
,20131016,52420,52390,52400,52640,52220,52390,52410,0,20,22866,"599,237.06",61320
,20131017,52390,52410,52650,52800,51990,52040,52290,-370,-120,23110,"604,226.50",56618
,20131018,52040,52290,52200,52470,52180,52370,52370,80,80,16704,"437,405.47",57722
,20131021,52370,52370,52310,52530,52090,52510,52280,140,-90,16674,"435,903.01",57164
,20131022,52510,52280,52440,52540,52300,52360,52370,80,90,11262,"294,913.69",56760
,20131023,52360,52370,52670,52690,52220,52250,52420,-120,50,20722,"543,197.44",52558
,20131024,52250,52420,51800,52050,51710,51930,51880,-490,-540,24198,"627,812.63",45978
,20131025,51930,51880,51940,51960,51480,51500,51670,-380,-210,22828,"589,864.62",44038
,20131028,51500,51670,51770,51920,51660,51850,51800,180,130,11926,"308,917.34",42990
,20131029,51850,51800,51790,51800,51400,51800,51570,0,-230,19158,"494,035.97",40988
,20131030,51800,51570,51920,52340,51750,52290,52080,720,510,24932,"649,233.57",38666
,20131031,52290,52080,52210,52210,51860,51980,52030,-100,-50,17470,"454,487.14",37118
,20131101,51980,52030,51970,52350,51940,52300,52160,270,130,11358,"296,225.61",37090
,20131104,52300,52160,52110,52150,51730,51850,51920,-310,-240,10970,"284,807.80",33830
,20131105,51850,51920,51700,51890,51600,51780,51730,-140,-190,8420,"217,806.35",32790
,20131106,51780,51730,51750,51800,51550,51730,51660,0,-70,9220,"238,161.20",30870
,20131107,51730,51660,51510,51650,51420,51620,51520,-40,-140,9470,"243,961.10",29740
,20131108,51620,51520,51540,51810,51540,51600,51690,80,170,8530,"220,479.25",27160
,20131111,51600,51690,51800,52010,51670,51680,51750,-10,60,10330,"267,320.95",24400
,20131112,51680,51750,51670,51680,51430,51550,51520,-200,-230,13030,"335,685.55",19950
,20131113,51550,51520,51060,51090,50700,50750,50960,-770,-560,8230,"209,700.95",15380
,20131114,50750,50960,50650,50710,50600,50600,50640,-360,-320,6490,"164,334.45",13110
,20131115,50600,50640,50700,50850,50300,50350,50670,-290,30,4330,"109,722.15",10720
cu1312,20130104,58540,58470,59060,59080,58950,59030,59000,560,530,54,"1,593.26",238
,20130107,59030,59000,58900,59000,58750,58750,58860,-250,-140,36,"1,059.51",254
,20130108,58750,58860,59000,59130,58950,59030,59020,170,160,58,"1,711.74",282
,20130109,59030,59020,59000,59000,58940,58940,58950,-80,-70,94,"2,770.75",320
,20130110,58940,58950,59090,59500,59080,59500,59280,550,330,84,"2,489.99",372
,20130111,59500,59280,59450,59650,59170,59210,59410,-70,130,34,"1,009.98",380
,20130114,59210,59410,59220,59410,59100,59410,59230,0,-180,16,473.88,380
,20130115,59410,59230,59050,59110,58740,58740,58930,-490,-300,30,884.04,396
,20130116,58740,58930,58940,58940,58730,58820,58820,-110,-110,12,352.96,388
,20130117,58820,58820,58680,58680,58510,58510,58590,-310,-230,6,175.78,390
,20130118,58510,58590,58910,59280,58910,59270,59060,680,470,34,"1,004.17",388
,20130121,59270,59060,59200,59250,59100,59180,59160,120,100,40,"1,183.22",412
,20130122,59180,59160,59370,59660,59370,59640,59530,480,370,38,"1,131.12",418
,20130123,59640,59530,59640,59640,59460,59580,59540,50,10,16,476.33,424
,20130124,59580,59540,59370,59530,59310,59430,59410,-110,-130,40,"1,188.26",426
,20130125,59430,59410,59610,59700,59610,59650,59680,240,270,20,596.82,428
,20130128,59650,59680,59460,59460,59430,59430,59440,-250,-240,8,237.77,426
,20130129,59430,59440,59570,59610,59260,59610,59430,170,-10,16,475.44,422
,20130130,59610,59430,59640,60050,59640,59950,59970,520,540,52,"1,559.44",440
,20130131,59950,59970,60210,60370,60170,60300,60250,330,280,76,"2,289.65",458
,20130201,60300,60250,60120,60210,59920,60210,60080,-40,-170,88,"2,643.55",500
,20130204,60210,60080,60890,60890,60390,60390,60540,310,460,36,"1,089.81",520
,20130205,60390,60540,60290,60470,60230,60230,60320,-310,-220,212,"6,394.04",644
,20130206,60230,60320,60610,60610,60410,60410,60500,90,180,8,242,646
,20130207,60410,60500,60220,60230,60100,60200,60180,-300,-320,12,361.11,646
,20130208,60200,60180,60220,60400,60220,60340,60300,160,120,10,301.51,650
,20130218,60340,60300,60020,60050,59500,59500,59650,-800,-650,38,"1,133.42",668
,20130219,59500,59650,59530,59610,59400,59430,59500,-220,-150,28,833,672
,20130220,59430,59500,59290,59350,59100,59200,59160,-300,-340,34,"1,005.84",674
,20130221,59200,59160,58330,58330,57700,58180,58110,-980,-1050,134,"3,893.68",718
,20130222,58180,58110,58100,58230,58100,58180,58190,70,80,86,"2,502.28",756
,20130225,58180,58190,57930,57960,57600,57710,57720,-480,-470,142,"4,098.78",712
,20130226,57710,57720,57600,57810,57450,57450,57630,-270,-90,292,"8,415.02",828
,20130227,57450,57630,58000,58000,57720,57800,57890,170,260,168,"4,863.58",826
,20130228,57800,57890,57980,58170,57800,58000,58020,110,130,48,"1,392.51",838
,20130301,58000,58020,57520,57520,56920,57110,57190,-910,-830,190,"5,433.98",818
,20130304,57110,57190,56910,56960,56010,56010,56560,-1180,-630,326,"9,219.30",840
,20130305,56010,56560,56870,57070,56800,57060,56940,500,380,150,"4,270.57",830
,20130306,57060,56940,57150,57230,56770,56880,56860,-60,-80,526,"14,954.50",954
,20130307,56880,56860,56570,56630,56380,56560,56470,-300,-390,186,"5,251.98",962
,20130308,56560,56470,56820,56850,56730,56840,56790,370,320,30,851.86,982
,20130311,56840,56790,56590,56830,56590,56630,56720,-160,-70,58,"1,645.08",1004
,20130312,56630,56720,56850,57610,56500,56500,56750,-220,30,134,"3,802.51",1006
,20130313,56500,56750,56890,57280,56840,56950,57060,200,310,208,"5,935.27",1054
,20130314,56950,57060,56770,56840,56520,56790,56680,-270,-380,296,"8,388.68",1022
,20130315,56790,56680,56790,57140,56790,57140,57040,460,360,370,"10,552.43",1228
,20130318,57140,57040,56500,56500,54850,55340,55490,-1700,-1550,1156,"32,077.02",1326
,20130319,55340,55490,55280,55420,55000,55080,55250,-410,-240,210,"5,801.56",1356
,20130320,55080,55250,54750,55580,54750,55520,55250,270,0,104,"2,873.31",1360
,20130321,55520,55250,55730,56630,55730,56010,56130,760,880,214,"6,006.08",1364
,20130322,56010,56130,56030,56030,55700,55790,55800,-340,-330,134,"3,738.78",1370
,20130325,55790,55800,56280,56390,56140,56240,56280,440,480,48,"1,350.77",1380
,20130326,56240,56280,56000,56000,55770,55890,55880,-390,-400,154,"4,303.32",1426
,20130327,55890,55880,55980,56040,55620,55720,55860,-160,-20,74,"2,067.16",1432
,20130328,55720,55860,55870,55910,55400,55500,55530,-360,-330,198,"5,497.55",1536
,20130329,55500,55530,54980,55660,54880,55010,55210,-520,-320,244,"6,736.49",1624
,20130401,55010,55210,54520,54700,53940,53940,54190,-1270,-1020,254,"6,883.22",1754
,20130402,53940,54190,54260,54630,54070,54620,54460,430,270,96,"2,614.21",1756
,20130403,54620,54460,54520,54750,54130,54130,54480,-330,20,268,"7,300.46",1832
,20130408,54130,54480,54300,54770,54290,54770,54490,290,10,232,"6,321.75",1874
,20130409,54770,54490,55110,55120,54770,55050,55050,560,560,430,"11,835.83",1870
,20130410,55050,55050,55400,55500,55130,55180,55350,130,300,136,"3,764.20",1848
,20130411,55180,55350,55020,55340,54920,54920,55100,-430,-250,144,"3,967.61",1834
,20130412,54920,55100,55250,55250,55030,55130,55090,30,-10,88,"2,423.98",1844
,20130415,55130,55090,54120,54170,53040,53510,53540,-1580,-1550,632,"16,920.13",2070
,20130416,53510,53540,52800,53180,52100,53080,52630,-460,-910,1400,"36,845.39",2554
,20130417,53080,52630,53290,53400,52250,52350,52870,-280,240,1972,"52,137.68",3310
,20130418,52350,52870,50750,50750,50750,50750,50750,-2120,-2120,374,"9,490.25",3452
,20130419,50750,50750,50810,51130,49790,50790,50540,40,-210,2034,"51,399.42",3680
,20130422,50790,50540,50790,50850,48940,49000,49820,-1540,-720,2062,"51,366.28",4500
,20130423,49000,49820,49300,49780,48500,49120,49070,-700,-750,1736,"42,599.36",4886
,20130424,49120,49070,49180,51030,49020,50650,49940,1580,870,3070,"76,658.93",5626
,20130425,50650,49940,50750,51360,50440,51270,51030,1330,1090,2812,"71,751.50",6076
,20130426,51270,51030,52140,52530,51300,51600,51830,570,800,1932,"50,073.68",6326
,20130502,51600,51830,49230,49780,49230,49520,49410,-2310,-2420,600,"14,825.97",6348
,20130503,49520,49410,49760,51120,49700,50960,50280,1550,870,976,"24,541.26",6474
,20130506,50960,50280,52790,52790,52340,52730,52670,2450,2390,1982,"52,202.43",6508
,20130507,52730,52670,52730,53170,52100,52160,52620,-510,-50,1422,"37,414.17",6652
,20130508,52160,52620,52380,52990,52380,52970,52670,350,50,1772,"46,668.67",6598
,20130509,52970,52670,53300,53300,52440,52910,52910,240,240,1504,"39,788.69",6776
,20130510,52910,52910,52510,53450,52460,53420,53060,510,150,3502,"92,922.04",7428
,20130513,53420,53060,53360,53660,52980,53320,53320,260,260,4636,"123,611.99",7490
,20130514,53320,53320,53550,53630,52520,52600,53050,-720,-270,4576,"121,384.43",9210
,20130515,52600,53050,52470,52630,51850,51880,52380,-1170,-670,2780,"72,816.07",10108
,20130516,51880,52380,51920,52330,51590,52020,51970,-360,-410,1982,"51,504.16",10142
,20130517,52020,51970,52300,53110,52240,52880,52570,910,600,2930,"77,018.28",10216
,20130520,52880,52570,52860,52900,52250,52360,52480,-210,-90,3758,"98,611.19",11576
,20130521,52360,52480,53100,53340,52870,53290,53140,810,660,3202,"85,079.94",11712
,20130522,53290,53140,53020,53670,53010,53550,53480,410,340,5448,"145,679.70",11372
,20130523,53550,53480,53050,53100,52040,52220,52510,-1260,-970,3730,"97,939.00",12226
,20130524,52220,52510,52510,52850,52300,52720,52680,210,170,4404,"116,013.22",13226
,20130527,52720,52680,52400,52500,52100,52400,52320,-280,-360,2786,"72,885.85",13858
,20130528,52400,52320,52600,52620,51840,52510,52140,190,-180,4228,"110,233.63",14658
,20130529,52510,52140,52400,52750,52010,52060,52480,-80,340,6946,"182,287.30",16054
,20130530,52060,52480,52070,52260,51610,52200,52020,-280,-460,6060,"157,628.91",16940
,20130531,52200,52020,52580,52850,52330,52500,52560,480,540,3930,"103,289.86",17008
,20130603,52500,52560,52750,53030,52630,52850,52810,290,250,4828,"127,488.96",17384
,20130604,52850,52810,52850,53070,52730,52940,52890,130,80,3658,"96,746.21",17630
,20130605,52940,52890,53120,53490,53090,53450,53250,560,360,5536,"147,404.86",17020
,20130606,53450,53250,53100,53380,52670,52820,53050,-430,-200,7508,"199,178.00",17892
,20130607,52820,53050,52900,53120,52670,53040,52860,-10,-190,4470,"118,157.09",18468
,20130613,53040,52860,51800,51910,51330,51480,51620,-1380,-1240,14332,"369,931.20",23544
,20130614,51480,51620,51430,51630,51190,51280,51380,-340,-240,9086,"233,425.03",26240
,20130617,51280,51380,51400,51800,51400,51580,51600,200,220,5224,"134,783.39",26696
,20130618,51580,51600,51530,51580,50850,50880,51080,-720,-520,8928,"228,036.27",29508
,20130619,50880,51080,50800,50950,50500,50790,50660,-290,-420,9546,"241,839.52",32268
,20130620,50790,50660,50070,50160,49520,49590,49770,-1070,-890,11706,"291,326.86",35208
,20130621,49590,49770,48810,49540,48260,49520,49000,-250,-770,25860,"633,591.17",37440
,20130624,49520,49000,49400,49400,47860,47860,48530,-1140,-470,26502,"643,202.29",40580
,20130625,47860,48530,48000,48820,47460,48500,48120,-30,-410,28928,"696,095.28",41268
,20130626,48500,48120,49070,49150,47850,47920,48360,-200,240,29524,"713,991.99",45142
,20130627,47920,48360,48230,48750,48030,48680,48450,320,90,30716,"744,168.45",49518
,20130628,48680,48450,48080,48570,47770,48350,48220,-100,-230,28440,"685,770.98",54162
,20130701,48350,48220,48160,49320,48110,49260,48790,1040,570,26062,"635,847.94",54666
,20130702,49260,48790,49570,49960,49390,49910,49680,1120,890,27046,"671,832.20",56472
,20130703,49910,49680,49850,50380,49680,50330,50020,650,340,25764,"644,473.21",57072
,20130704,50330,50020,50300,50360,49770,49820,50000,-200,-20,20994,"524,873.87",57766
,20130705,49820,50000,49830,49930,49110,49110,49380,-890,-620,26160,"645,947.84",59312
,20130708,49110,49380,48850,48960,48400,48480,48600,-900,-780,33958,"825,335.24",62898
,20130709,48480,48600,48750,49130,48520,48770,48850,170,250,45072,"1,101,090.39",69412
,20130710,48770,48850,48500,48650,47880,48510,48250,-340,-600,73712,"1,778,517.69",77546
,20130711,48510,48250,49500,50660,49410,50620,50180,2370,1930,86502,"2,170,363.76",70148
,20130712,50620,50180,50620,50660,49550,49590,50070,-590,-110,47980,"1,201,283.49",74234
,20130715,49590,50070,49600,50160,49510,49750,49830,-320,-240,57238,"1,426,211.51",78736
,20130716,49750,49830,49800,50150,49600,50150,49850,320,20,54382,"1,355,737.24",79932
,20130717,50150,49850,50220,50630,49750,49780,50190,-70,340,85146,"2,136,771.49",85802
,20130718,49780,50190,49600,49660,49260,49580,49420,-610,-770,76692,"1,895,274.93",92050
,20130719,49580,49420,49800,50150,49430,49430,49840,10,420,85930,"2,141,744.55",97280
,20130722,49430,49840,50020,50310,49810,50250,50090,410,250,93442,"2,340,366.92",99488
,20130723,50250,50090,50250,50590,50110,50140,50340,50,250,100830,"2,537,904.79",106670
,20130724,50140,50340,50450,50550,50050,50430,50290,90,-50,111490,"2,803,517.41",107088
,20130725,50430,50290,50150,50430,50100,50370,50280,80,-10,86538,"2,175,652.82",117880
,20130726,50370,50280,50430,50520,49770,49930,50130,-350,-150,98854,"2,478,150.70",123370
,20130729,49930,50130,49000,49160,48800,48950,48970,-1180,-1160,134776,"3,300,388.55",144260
,20130730,48950,48970,49030,49170,48720,48750,48990,-220,20,102344,"2,507,375.61",161408
,20130731,48750,48990,48380,49100,48350,49100,48760,110,-230,163248,"3,980,770.74",172294
,20130801,49100,48760,49400,50050,49390,49880,49710,1120,950,216814,"5,389,516.56",172068
,20130802,49880,49710,50100,50150,49620,49900,49900,190,190,160320,"4,000,214.89",174792
,20130805,49900,49900,49880,50150,49760,50040,50000,140,100,148966,"3,724,370.30",172210
,20130806,50040,50000,49910,50070,49760,50030,49950,30,-50,139302,"3,479,478.17",179798
,20130807,50030,49950,49910,50000,49680,49900,49830,-50,-120,146958,"3,662,001.94",188944
,20130808,49900,49830,50350,51450,50290,51390,51010,1560,1180,354474,"9,042,170.71",175584
,20130809,51390,51010,51450,51750,51180,51380,51430,370,420,222888,"5,732,343.02",173298
,20130812,51380,51430,51850,52460,51680,52310,51980,880,550,304112,"7,905,048.95",184260
,20130813,52310,51980,52170,52220,51870,52120,52070,140,90,269588,"7,019,058.21",181272
,20130814,52120,52070,52010,52550,51880,52150,52180,80,110,361568,"9,433,845.84",192350
,20130815,52150,52180,52330,52510,51970,52050,52250,-130,70,352282,"9,204,506.73",202668
,20130816,52050,52250,52410,53240,52320,53130,52790,880,540,610806,"16,123,238.01",228004
,20130819,53130,52790,53050,53130,52700,52740,52880,-50,90,319988,"8,461,677.12",219602
,20130820,52740,52880,52600,52690,52020,52170,52340,-710,-540,328452,"8,596,232.91",212628
,20130821,52170,52340,52330,52530,52250,52470,52390,130,50,248740,"6,515,962.75",219434
,20130822,52470,52390,52110,52850,52080,52750,52570,360,180,357738,"9,403,240.51",247084
,20130823,52750,52570,52620,52780,52400,52690,52610,120,40,294058,"7,735,771.73",244116
,20130826,52690,52610,53530,53620,53100,53360,53270,750,660,317738,"8,464,296.78",235272
,20130827,53360,53270,52950,53090,52700,52820,52860,-450,-410,269844,"7,132,750.56",239530
,20130828,52820,52860,52720,52980,52310,52360,52710,-500,-150,339254,"8,941,473.59",240648
,20130829,52360,52710,52400,52580,51950,52370,52260,-340,-450,393832,"10,292,339.92",233766
,20130830,52370,52260,51800,52050,51750,51960,51860,-300,-400,319966,"8,297,178.73",243212
,20130902,51960,51860,52100,52780,52100,52500,52450,640,590,417480,"10,949,405.68",254612
,20130903,52500,52450,52580,52750,52220,52360,52420,-90,-30,298792,"7,831,572.79",253190
,20130904,52360,52420,52410,52460,51940,52020,52150,-400,-270,263414,"6,868,743.30",249180
,20130905,52020,52150,51780,51960,51460,51670,51680,-480,-470,348028,"8,994,297.98",253994
,20130906,51670,51680,51780,51900,51620,51850,51770,170,90,220754,"5,714,524.18",246902
,20130909,51850,51770,52130,52420,51990,52290,52260,520,490,275134,"7,189,888.26",238802
,20130910,52290,52260,52260,52260,51760,51990,51970,-270,-290,271958,"7,067,320.56",237858
,20130911,51990,51970,52050,52210,51830,52050,52040,80,70,223484,"5,815,325.07",240462
,20130912,52050,52040,51880,51960,51380,51410,51670,-630,-370,254708,"6,581,544.08",249316
,20130913,51410,51670,51300,51380,51010,51290,51180,-380,-490,282564,"7,232,160.05",247652
,20130916,51290,51180,51510,51670,51090,51180,51350,0,170,209776,"5,386,165.49",246708
,20130917,51180,51350,51160,51510,50860,51460,51170,110,-180,246146,"6,297,877.87",249736
,20130918,51460,51170,51400,51700,51140,51680,51400,510,230,199374,"5,124,028.65",233710
,20130923,51680,51400,52000,52140,51720,52060,51880,660,480,245548,"6,370,255.70",226828
,20130924,52060,51880,52030,52170,51730,51750,51940,-130,60,213812,"5,552,774.95",223716
,20130925,51750,51940,51770,51920,51600,51760,51730,-180,-210,182002,"4,708,064.19",217792
,20130926,51760,51730,51830,52360,51670,52280,52030,550,300,229020,"5,958,072.79",199372
,20130927,52280,52030,52290,52570,52150,52350,52330,320,300,169928,"4,446,957.27",175074
,20130930,52350,52330,52360,52860,52270,52800,52570,470,240,122308,"3,215,034.93",157848
,20131008,52800,52570,52560,52650,52300,52520,52440,-50,-130,74678,"1,958,059.98",150236
,20131009,52520,52440,52400,52440,51750,51840,52020,-600,-420,133498,"3,472,508.11",136048
,20131010,51840,52020,51500,51690,51430,51560,51570,-460,-450,64408,"1,660,768.34",125964
,20131011,51560,51570,51780,52020,51680,51790,51840,220,270,57424,"1,488,436.10",121076
,20131014,51790,51840,51800,52370,51510,52340,51980,500,140,67156,"1,745,385.91",118074
,20131015,52340,51980,52370,52480,52170,52260,52300,280,320,36976,"966,993.50",114378
,20131016,52260,52300,52260,52530,52110,52290,52310,-10,10,48310,"1,263,634.02",110626
,20131017,52290,52310,52600,52740,51860,51920,52190,-390,-120,46746,"1,220,049.01",107988
,20131018,51920,52190,52170,52390,52080,52330,52250,140,60,25974,"678,676.36",106584
,20131021,52330,52250,52180,52460,51980,52430,52200,180,-50,26668,"696,108.74",104526
,20131022,52430,52200,52330,52450,52230,52250,52300,50,100,18872,"493,537.00",102352
,20131023,52250,52300,52570,52640,52120,52180,52350,-120,50,36724,"961,360.38",102962
,20131024,52180,52350,51830,51960,51580,51850,51770,-500,-580,43040,"1,114,173.84",97920
,20131025,51850,51770,51870,51880,51290,51310,51550,-460,-220,36736,"947,024.41",92496
,20131028,51310,51550,51600,51780,51500,51680,51660,130,110,14102,"364,293.01",89436
,20131029,51680,51660,51660,51670,51240,51670,51430,10,-230,31068,"798,941.42",83096
,20131030,51670,51430,51730,52290,51630,52220,52030,790,600,27868,"725,028.81",79892
,20131031,52220,52030,52140,52140,51800,51950,51960,-80,-70,17610,"457,577.14",80998
,20131101,51950,51960,51900,52330,51860,52300,52140,340,180,16338,"425,963.64",79778
,20131104,52300,52140,52090,52140,51640,51800,51850,-340,-290,17620,"456,882.35",77452
,20131105,51800,51850,51750,51860,51510,51730,51690,-120,-160,14820,"383,041.36",76374
,20131106,51730,51690,51760,51790,51500,51690,51620,0,-70,14334,"370,002.70",75518
,20131107,51690,51620,51420,51640,51400,51610,51510,-10,-110,17338,"446,565.01",73782
,20131108,51610,51510,51490,51820,51470,51600,51670,90,160,15082,"389,698.99",73392
,20131111,51600,51670,51710,52010,51640,51720,51760,50,90,14598,"377,818.43",73920
,20131112,51720,51760,51620,51690,51430,51560,51550,-200,-210,15178,"391,218.73",74540
,20131113,51560,51550,51220,51220,50690,50730,50940,-820,-610,33832,"861,870.15",68402
,20131114,50730,50940,50460,50750,50460,50600,50640,-340,-300,17792,"450,555.11",66268
,20131115,50600,50640,50650,50880,50200,50230,50640,-410,0,25740,"651,774.46",66892
,20131118,50230,50640,50480,50580,50360,50550,50470,-90,-170,16944,"427,619.51",64922
,20131119,50550,50470,50180,50310,49950,50150,50100,-320,-370,23528,"589,430.97",61264
,20131120,50150,50100,50300,50780,50270,50660,50590,560,490,20186,"510,631.42",54650
,20131121,50660,50590,50400,50650,50250,50560,50400,-30,-190,14704,"370,551.54",53382
,20131122,50560,50400,50770,50980,50660,50800,50800,400,400,13408,"340,585.76",50518
,20131125,50800,50800,51270,51290,50750,50780,50960,-20,160,15850,"403,931.72",48610
,20131126,50780,50960,50960,51100,50860,51040,50980,80,20,13092,"333,778.12",45042
,20131127,51040,50980,50870,50920,50710,50860,50810,-120,-170,15448,"392,489.26",42196
,20131128,50860,50810,50710,50840,50560,50600,50720,-210,-90,17186,"435,855.38",37588
,20131129,50600,50720,50830,50880,50700,50850,50780,130,60,11692,"296,901.13",32894
,20131202,50850,50780,50750,50900,50700,50800,50790,20,10,7814,"198,451.98",30920
,20131203,50800,50790,50480,50510,50240,50330,50390,-460,-400,10520,"265,074.80",29690
,20131204,50330,50390,50380,50590,50380,50550,50480,160,90,8920,"225,170.60",26810
,20131205,50550,50480,50980,51020,50800,50810,50870,330,390,8480,"215,706.05",25000
,20131206,50810,50870,50850,51030,50740,51000,50830,130,-40,9350,"237,672.90",23630
,20131209,51000,50830,50960,51130,50880,50980,50970,150,140,8650,"220,464.75",20160
,20131210,50980,50970,51090,51210,51070,51190,51140,220,170,10610,"271,345.75",16890
,20131211,51190,51140,51270,51290,51060,51140,51180,0,40,7660,"196,024.80",13590
,20131212,51140,51180,51340,51510,51300,51510,51370,330,190,7230,"185,727.45",9340
,20131213,51510,51370,51380,51380,51010,51100,51150,-270,-220,4800,"122,763.25",7580
,20131216,51100,51150,50470,51590,50470,51250,51240,100,90,4230,"108,378.85",6980
cu1401,20130116,58930,58930,59000,59000,59000,59000,59000,70,70,2,59,2
,20130117,59000,59000,,,,58720,58720,-280,-280,0,0,2
,20130118,58720,58720,,,,59150,59150,430,430,0,0,2
,20130121,59150,59150,,,,59150,59150,0,0,0,0,2
,20130122,59150,59150,59560,59560,59560,59560,59560,410,410,2,59.56,4
,20130123,59560,59560,59830,59830,59530,59600,59640,40,80,66,"1,968.43",40
,20130124,59600,59640,,,,59570,59570,-70,-70,0,0,40
,20130125,59570,59570,59710,59800,59560,59750,59740,180,170,30,896.18,54
,20130128,59750,59740,59510,59620,59470,59500,59500,-240,-240,102,"3,034.82",122
,20130129,59500,59500,59600,59760,59440,59720,59560,220,60,32,953.08,140
,20130130,59720,59560,59790,60160,59720,60090,60000,530,440,44,"1,320.13",144
,20130131,60090,60000,60310,60400,60310,60350,60350,350,350,16,482.83,148
,20130201,60350,60350,60110,60240,60000,60240,60080,-110,-270,132,"3,965.88",224
,20130204,60240,60080,60690,60710,60590,60670,60650,590,570,16,485.23,230
,20130205,60670,60650,60380,60560,60300,60380,60350,-270,-300,64,"1,931.25",244
,20130206,60380,60350,60570,60570,60380,60450,60460,100,110,26,786.04,258
,20130207,60450,60460,60250,60300,60250,60300,60280,-160,-180,6,180.85,256
,20130208,60300,60280,60330,60550,60330,60450,60400,170,120,18,543.68,262
,20130218,60450,60400,60000,60000,59530,59540,59800,-860,-600,36,"1,076.55",270
,20130219,59540,59800,59540,59660,59440,59500,59520,-300,-280,32,952.47,274
,20130220,59500,59520,59390,59390,59350,59350,59370,-170,-150,4,118.74,272
,20130221,59350,59370,58190,58190,57890,58180,58000,-1190,-1370,28,812.02,274
,20130222,58180,58000,58000,58260,57960,58230,58140,230,140,30,872.12,278
,20130225,58230,58140,57920,57970,57550,57750,57790,-390,-350,110,"3,178.91",336
,20130226,57750,57790,57740,57850,54900,57670,57470,-120,-320,20,574.73,346
,20130227,57670,57470,57950,58010,57920,58010,57950,540,480,20,579.52,340
,20130228,58010,57950,58020,58150,58020,58150,58120,200,170,28,813.69,354
,20130301,58150,58120,57590,57590,57030,57090,57180,-1030,-940,48,"1,372.40",362
,20130304,57090,57180,57020,57020,56320,56470,56520,-710,-660,60,"1,695.81",372
,20130305,56470,56520,56930,57100,56870,57100,56980,580,460,42,"1,196.74",378
,20130306,57100,56980,57180,57180,56800,56900,56950,-80,-30,38,"1,082.09",382
,20130307,56900,56950,56450,56680,56350,56670,56480,-280,-470,84,"2,372.30",414
,20130308,56670,56480,56870,56900,56730,56900,56830,420,350,58,"1,648.29",428
,20130311,56900,56830,56790,56930,56780,56780,56840,-50,10,28,795.81,432
,20130312,56780,56840,56860,56870,56650,56680,56740,-160,-100,28,794.47,424
,20130313,56680,56740,57050,57210,56910,57100,57010,360,270,24,684.2,426
,20130314,57100,57010,56780,57000,56610,56760,56740,-250,-270,18,510.71,436
,20130315,56760,56740,55610,57180,55610,57180,56900,440,160,18,512.14,446
,20130318,57180,56900,56010,56010,55000,55280,55400,-1620,-1500,168,"4,653.69",468
,20130319,55280,55400,55350,55450,55020,55150,55280,-250,-120,76,"2,100.67",482
,20130320,55150,55280,54810,55500,54810,55480,55270,200,-10,16,442.23,488
,20130321,55480,55270,55800,56800,55800,56050,56150,780,880,202,"5,671.20",472
,20130322,56050,56150,56100,56110,55800,55820,55970,-330,-180,28,783.6,482
,20130325,55820,55970,56400,56450,56200,56230,56290,260,320,96,"2,701.92",508
,20130326,56230,56290,56010,56080,55750,55880,55900,-410,-390,38,"1,062.26",512
,20130327,55880,55900,55980,55980,55770,55770,55900,-130,0,54,"1,509.50",528
,20130328,55770,55900,55910,55910,55520,55520,55710,-380,-190,16,445.74,532
,20130329,55520,55710,55150,55540,55070,55070,55260,-640,-450,102,"2,818.62",566
,20130401,55070,55260,54410,54420,53990,54000,54260,-1260,-1000,128,"3,472.75",628
,20130402,54000,54260,54400,54670,54360,54630,54510,370,250,22,599.69,632
,20130403,54630,54510,54690,54720,54330,54330,54600,-180,90,340,"9,282.05",874
,20130408,54330,54600,54520,54820,54410,54820,54490,220,-110,154,"4,195.96",950
,20130409,54820,54490,55260,55260,54870,55060,55080,570,590,508,"13,991.86",1002
,20130410,55060,55080,55460,55500,55210,55210,55390,130,310,136,"3,766.83",1000
,20130411,55210,55390,55020,55300,55000,55000,55120,-390,-270,20,551.27,1000
,20130412,55000,55120,55090,55280,55090,55160,55210,40,90,24,662.52,986
,20130415,55160,55210,54060,54160,53120,53620,53430,-1590,-1780,334,"8,924.24",1168
,20130416,53620,53430,52510,53270,52310,53200,52880,-230,-550,130,"3,437.25",1164
,20130417,53200,52880,53310,53360,52350,52410,52650,-470,-230,154,"4,054.58",1218
,20130418,52410,52650,50540,50660,50540,50540,50540,-2110,-2110,2750,"69,504.25",3200
,20130419,50540,50540,51020,51240,49930,50800,50660,260,120,1406,"35,614.67",2792
,20130422,50800,50660,50680,50690,49020,49020,49820,-1640,-840,1318,"32,831.73",3002
,20130423,49020,49820,49350,49770,48560,49110,49170,-710,-650,2172,"53,401.43",2632
,20130424,49110,49170,49300,51130,49000,50700,49950,1530,780,1870,"46,707.33",3258
,20130425,50700,49950,50990,51450,50510,51370,51080,1420,1130,1056,"26,971.79",3280
,20130426,51370,51080,52740,52740,51280,51620,51890,540,810,634,"16,449.63",3246
,20130502,51620,51890,49290,49790,49290,49560,49420,-2330,-2470,548,"13,542.12",3272
,20130503,49560,49420,49800,51110,49700,51030,50550,1610,1130,874,"22,091.43",3224
,20130506,51030,50550,53070,53070,52430,52880,52760,2330,2210,1070,"28,231.50",3202
,20130507,52880,52760,52500,53160,52210,52270,52690,-490,-70,422,"11,118.60",3248
,20130508,52270,52690,52410,53020,52390,52930,52590,240,-100,284,"7,468.36",3274
,20130509,52930,52590,53190,53190,52630,52900,52870,310,280,266,"7,032.98",3304
,20130510,52900,52870,52560,53460,52560,53410,53000,540,130,276,"7,315.00",3298
,20130513,53410,53000,53250,53700,53020,53380,53300,380,300,398,"10,608.45",3288
,20130514,53380,53300,53450,53660,52560,52580,53030,-720,-270,508,"13,471.99",3352
,20130515,52580,53030,52800,52800,51900,51920,52250,-1110,-780,838,"21,893.02",3794
,20130516,51920,52250,51970,52370,51600,52080,51980,-170,-270,384,"9,980.47",3812
,20130517,52080,51980,52350,53100,52270,52880,52560,900,580,618,"16,243.96",3828
,20130520,52880,52560,52900,52900,52250,52350,52490,-210,-70,476,"12,493.39",3952
,20130521,52350,52490,53000,53350,52890,53200,53080,710,590,428,"11,361.05",4016
,20130522,53200,53080,53050,53670,53050,53520,53400,440,320,506,"13,512.21",3962
,20130523,53520,53400,53100,53100,52080,52290,52480,-1110,-920,1046,"27,450.28",4410
,20130524,52290,52480,52600,52890,52380,52750,52690,270,210,1146,"30,191.42",4788
,20130527,52750,52690,52500,52500,52150,52440,52350,-250,-340,208,"5,444.56",4794
,20130528,52440,52350,52550,52670,51900,52540,52230,190,-120,1776,"46,385.07",5666
,20130529,52540,52230,52420,52840,52100,52100,52570,-130,340,1080,"28,389.39",5922
,20130530,52100,52570,51560,52290,51560,52240,52080,-330,-490,1078,"28,074.07",6046
,20130531,52240,52080,52600,52830,52370,52530,52580,450,500,670,"17,615.88",6056
,20130603,52530,52580,52910,53060,52650,52830,52820,250,240,406,"10,722.75",6020
,20130604,52830,52820,52880,53100,52780,52960,52940,140,120,396,"10,484.05",6004
,20130605,52960,52940,53240,53500,53110,53500,53260,560,320,286,"7,616.99",6042
,20130606,53500,53260,53190,53410,52690,52820,53010,-440,-250,798,"21,152.74",6226
,20130607,52820,53010,52880,53130,52700,53090,52890,80,-120,756,"19,992.62",6188
,20130613,53090,52890,51200,51930,51200,51400,51510,-1490,-1380,3824,"98,498.05",6632
,20130614,51400,51510,51510,51620,51200,51300,51430,-210,-80,1242,"31,942.92",6676
,20130617,51300,51430,51490,51800,51410,51600,51600,170,170,1314,"33,904.27",7042
,20130618,51600,51600,51500,51520,50850,50900,51080,-700,-520,1498,"38,260.47",7876
,20130619,50900,51080,50900,50980,50490,50880,50670,-200,-410,2594,"65,722.82",8102
,20130620,50880,50670,50050,50180,49550,49580,49800,-1090,-870,2262,"56,324.74",8814
,20130621,49580,49800,48890,49580,48300,49550,49000,-250,-800,3236,"79,296.95",9222
,20130624,49550,49000,49410,49410,47880,47880,48510,-1120,-490,4534,"109,974.48",9888
,20130625,47880,48510,47920,48890,47510,48500,48100,-10,-410,5358,"128,863.05",10156
,20130626,48500,48100,49010,49160,47900,47970,48440,-130,340,3708,"89,824.46",10274
,20130627,47970,48440,48180,48800,48060,48700,48420,260,-20,3310,"80,135.92",10472
,20130628,48700,48420,48100,48590,47770,48310,48200,-110,-220,5504,"132,656.55",10936
,20130701,48310,48200,48180,49330,48110,49280,48850,1080,650,6344,"154,978.63",12084
,20130702,49280,48850,49800,49980,49410,49940,49750,1090,900,13520,"336,351.51",12196
,20130703,49940,49750,49910,50400,49700,50350,50060,600,310,11570,"289,633.18",12342
,20130704,50350,50060,50270,50370,49720,49800,49960,-260,-100,8150,"203,615.55",12826
,20130705,49800,49960,49700,49880,49100,49110,49360,-850,-600,8768,"216,409.83",13320
,20130708,49110,49360,48800,48960,48350,48420,48600,-940,-760,9296,"225,901.41",13730
,20130709,48420,48600,48620,49040,48480,48700,48800,100,200,8392,"204,770.51",14014
,20130710,48700,48800,48490,48560,47790,48400,48180,-400,-620,14094,"339,580.82",16492
,20130711,48400,48180,49400,50580,49300,50550,50140,2370,1960,16974,"425,550.10",16386
,20130712,50550,50140,50380,50530,49490,49510,50130,-630,-10,9082,"227,656.87",16856
,20130715,49510,50130,49400,50100,49400,49670,49750,-460,-380,8032,"199,819.04",17356
,20130716,49670,49750,49750,50080,49540,50080,49780,330,30,5438,"135,356.28",17858
,20130717,50080,49780,50230,50580,49690,49710,50130,-70,350,13550,"339,673.56",18250
,20130718,49710,50130,49620,49620,49190,49550,49370,-580,-760,8258,"203,866.51",19182
,20130719,49550,49370,49780,50070,49350,49360,49780,-10,410,6858,"170,707.99",19768
,20130722,49360,49780,50000,50220,49760,50200,50010,420,230,9150,"228,822.32",20776
,20130723,50200,50010,50220,50530,50060,50100,50270,90,260,9812,"246,659.68",22006
,20130724,50100,50270,50380,50500,50000,50420,50250,150,-20,9542,"239,770.82",22460
,20130725,50420,50250,50200,50390,50050,50330,50220,80,-30,7088,"177,999.41",23244
,20130726,50330,50220,50380,50490,49740,49920,50110,-300,-110,10654,"266,945.45",24360
,20130729,49920,50110,49000,49130,48760,48900,48940,-1210,-1170,17756,"434,513.03",28762
,20130730,48900,48940,49000,49130,48480,48710,48940,-230,0,9198,"225,076.78",30970
,20130731,48710,48940,48360,49000,48340,48990,48670,50,-270,21224,"516,499.37",31902
,20130801,48990,48670,49320,49970,49310,49790,49600,1120,930,17506,"434,191.66",32246
,20130802,49790,49600,50100,50100,49530,49800,49790,200,190,12372,"308,034.68",33490
,20130805,49800,49790,49880,50060,49680,49960,49920,170,130,10248,"255,812.68",33288
,20130806,49960,49920,49800,50000,49670,49940,49860,20,-60,9770,"243,593.02",34230
,20130807,49940,49860,49800,49910,49590,49820,49730,-40,-130,12568,"312,557.49",35546
,20130808,49820,49730,50150,51370,50150,51350,50930,1620,1200,33112,"843,359.72",34276
,20130809,51350,50930,51420,51670,51100,51300,51370,370,440,29554,"759,166.77",35378
,20130812,51300,51370,51850,52380,51620,52230,51910,860,540,26314,"683,034.14",37116
,20130813,52230,51910,52150,52150,51800,52050,51990,140,80,25756,"669,613.83",38722
,20130814,52050,51990,51970,52470,51820,52060,52100,70,110,29230,"761,568.04",41172
,20130815,52060,52100,52220,52450,51930,51980,52180,-120,80,27260,"711,220.13",42742
,20130816,51980,52180,52320,53160,52260,53050,52730,870,550,41418,"1,092,066.99",44772
,20130819,53050,52730,52980,53060,52650,52680,52820,-50,90,28382,"749,656.83",47396
,20130820,52680,52820,52520,52630,51980,52120,52250,-700,-570,37054,"968,127.54",54328
,20130821,52120,52250,52300,52480,52210,52400,52340,150,90,22146,"579,567.94",55090
,20130822,52400,52340,52000,52790,52000,52710,52490,370,150,42360,"1,111,900.84",57884
,20130823,52710,52490,52560,52720,52350,52660,52550,170,60,34678,"911,248.28",59494
,20130826,52660,52550,53480,53530,53100,53300,53240,750,690,46460,"1,236,961.47",64260
,20130827,53300,53240,52920,53030,52670,52800,52820,-440,-420,40958,"1,081,781.96",66950
,20130828,52800,52820,52670,52950,52270,52320,52670,-500,-150,50612,"1,333,048.04",71982
,20130829,52320,52670,52320,52510,51950,52330,52230,-340,-440,72540,"1,894,678.48",73138
,20130830,52330,52230,51740,52010,51720,51900,51830,-330,-400,63078,"1,634,831.07",78744
,20130902,51900,51830,52030,52750,52030,52510,52430,680,600,99466,"2,607,518.21",88976
,20130903,52510,52430,52570,52730,52210,52320,52400,-110,-30,69330,"1,816,542.97",91798
,20130904,52320,52400,52360,52420,51910,51980,52110,-420,-290,53130,"1,384,527.32",94604
,20130905,51980,52110,51780,51930,51430,51630,51640,-480,-470,79636,"2,056,410.85",99290
,20130906,51630,51640,51760,51850,51580,51780,51730,140,90,48062,"1,243,255.95",97002
,20130909,51780,51730,52080,52370,51960,52260,52220,530,490,62982,"1,644,614.35",96886
,20130910,52260,52220,52200,52220,51740,51940,51940,-280,-280,67452,"1,751,846.33",100338
,20130911,51940,51940,52000,52180,51800,52020,51990,80,50,57040,"1,483,023.17",105496
,20130912,52020,51990,51860,51920,51320,51350,51630,-640,-360,75518,"1,949,681.03",105426
,20130913,51350,51630,51250,51320,50950,51230,51120,-400,-510,81770,"2,090,256.69",111702
,20130916,51230,51120,51520,51610,51030,51090,51290,-30,170,65496,"1,679,935.97",116568
,20130917,51090,51290,51060,51450,50800,51430,51120,140,-170,83764,"2,141,329.67",116348
,20130918,51430,51120,51320,51690,51070,51670,51340,550,220,74832,"1,920,953.41",119486
,20130923,51670,51340,51960,52060,51650,51980,51800,640,460,127576,"3,304,796.56",125072
,20130924,51980,51800,51980,52130,51670,51690,51900,-110,100,112572,"2,921,691.97",130486
,20130925,51690,51900,51700,51880,51540,51710,51680,-190,-220,89814,"2,321,140.49",127362
,20130926,51710,51680,51760,52270,51620,52210,51950,530,270,129950,"3,376,075.77",134412
,20130927,52210,51950,52200,52490,52080,52250,52250,300,300,107638,"2,812,540.86",132250
,20130930,52250,52250,52300,52790,52180,52750,52470,500,220,112234,"2,944,563.81",124118
,20131008,52750,52470,52500,52580,52220,52470,52360,0,-110,125086,"3,274,754.77",136154
,20131009,52470,52360,52340,52350,51580,51680,51870,-680,-490,341456,"8,855,723.21",199722
,20131010,51680,51870,51350,51540,51260,51410,51410,-460,-460,233334,"5,997,964.40",217220
,20131011,51410,51410,51600,51890,51530,51650,51690,240,280,240120,"6,206,307.70",216542
,20131014,51650,51690,51720,52300,51330,52260,51880,570,190,305670,"7,929,197.80",230580
,20131015,52260,51880,52300,52390,52050,52150,52180,270,300,181940,"4,747,673.34",229246
,20131016,52150,52180,52200,52470,52000,52220,52200,40,20,280134,"7,312,177.49",233300
,20131017,52220,52200,52520,52660,51730,51800,52080,-400,-120,303022,"7,892,031.15",243970
,20131018,51800,52080,52020,52290,51960,52250,52150,170,70,253056,"6,599,102.53",240056
,20131021,52250,52150,52130,52380,51850,52330,52100,180,-50,236830,"6,170,486.92",246368
,20131022,52330,52100,52260,52370,52120,52160,52210,60,110,193666,"5,056,223.47",245972
,20131023,52160,52210,52490,52560,52030,52100,52270,-110,60,256910,"6,715,381.05",251294
,20131024,52100,52270,51780,51870,51430,51730,51680,-540,-590,335854,"8,680,079.50",254658
,20131025,51730,51680,51750,51790,51100,51150,51410,-530,-270,310890,"7,992,968.54",287056
,20131028,51150,51410,51420,51650,51330,51510,51500,100,90,209274,"5,389,796.33",279992
,20131029,51510,51500,51490,51550,51060,51510,51270,10,-230,375842,"9,636,582.09",300938
,20131030,51510,51270,51600,52200,51480,52080,51860,810,590,268758,"6,970,138.72",277850
,20131031,52080,51860,51960,52010,51660,51810,51830,-50,-30,263042,"6,817,429.81",282308
,20131101,51810,51830,51730,52290,51710,52240,52010,410,180,241622,"6,284,528.71",269706
,20131104,52240,52010,52010,52080,51520,51700,51760,-310,-250,247594,"6,408,432.54",270946
,20131105,51700,51760,51600,51770,51380,51600,51570,-160,-190,229422,"5,916,760.50",261638
,20131106,51600,51570,51610,51690,51360,51590,51520,20,-50,213124,"5,490,347.89",268652
,20131107,51590,51520,51350,51540,51250,51490,51380,-30,-140,174472,"4,482,377.52",263134
,20131108,51490,51380,51360,51720,51350,51490,51540,110,160,185294,"4,775,478.80",261930
,20131111,51490,51540,51700,51980,51530,51650,51690,110,150,156178,"4,036,923.28",259258
,20131112,51650,51690,51580,51620,51320,51480,51460,-210,-230,184204,"4,739,779.07",263190
,20131113,51480,51460,51080,51080,50550,50620,50800,-840,-660,317460,"8,063,674.65",274356
,20131114,50620,50800,50420,50660,50410,50450,50520,-350,-280,198510,"5,014,902.64",253796
,20131115,50450,50520,50530,50830,50060,50080,50510,-440,-10,222370,"5,616,616.90",244562
,20131118,50080,50510,50360,50490,50220,50420,50360,-90,-150,125636,"3,163,980.77",225690
,20131119,50420,50360,50070,50210,49770,50030,49970,-330,-390,137900,"3,445,661.30",198558
,20131120,50030,49970,50180,50670,50130,50590,50430,620,460,76706,"1,934,499.49",185238
,20131121,50590,50430,50380,50570,50110,50490,50310,60,-120,72010,"1,811,413.06",171364
,20131122,50490,50310,50780,50910,50580,50690,50740,380,430,71906,"1,824,302.50",153470
,20131125,50690,50740,51200,51260,50680,50710,50900,-30,160,60300,"1,534,818.95",146448
,20131126,50710,50900,50960,51060,50790,50950,50920,50,20,55666,"1,417,509.18",132924
,20131127,50950,50920,50820,50870,50640,50820,50760,-100,-160,36362,"922,952.14",125898
,20131128,50820,50760,50600,50820,50470,50560,50660,-200,-100,47108,"1,193,335.53",115630
,20131129,50560,50660,50760,50890,50680,50760,50760,100,100,32214,"817,739.88",108052
,20131202,50760,50760,50800,50900,50660,50780,50750,20,-10,23270,"590,515.52",102864
,20131203,50780,50750,50480,50480,50160,50310,50340,-440,-410,30294,"762,607.06",94008
,20131204,50310,50340,50310,50580,50300,50520,50460,180,120,22298,"562,621.82",90704
,20131205,50520,50460,50980,51050,50800,50830,50880,370,420,20686,"526,268.62",86958
,20131206,50830,50880,50880,51050,50710,51000,50860,120,-20,21692,"551,649.29",84720
,20131209,51000,50860,51000,51140,50870,50930,50980,70,120,17458,"445,026.20",83272
,20131210,50930,50980,51140,51240,51050,51130,51140,150,160,22366,"571,928.61",82070
,20131211,51130,51140,51280,51310,51030,51100,51180,-40,40,17730,"453,711.77",79632
,20131212,51100,51180,51320,51560,51270,51500,51390,320,210,30918,"794,469.56",72092
,20131213,51500,51390,51390,51400,51070,51130,51190,-260,-200,23838,"610,206.17",69036
,20131216,51130,51190,51390,51450,51270,51430,51350,240,160,17078,"438,511.35",64960
,20131217,51430,51350,51520,51680,51410,51430,51510,80,160,24106,"620,965.90",59488
,20131218,51430,51510,51360,51430,51090,51280,51180,-230,-330,19036,"487,176.68",55992
,20131219,51280,51180,51360,51360,50980,51120,51050,-60,-130,19600,"500,384.10",54234
,20131220,51120,51050,51110,51450,50980,51420,51220,370,170,17590,"450,563.85",52496
,20131223,51420,51220,51330,51540,51200,51300,51360,80,140,13456,"345,610.74",49912
,20131224,51300,51360,51300,51480,51090,51440,51390,80,30,16004,"411,302.29",46284
,20131225,51440,51390,51510,52490,51460,52270,51970,880,580,20052,"521,112.23",42676
,20131226,52270,51970,52360,52600,52010,52140,52210,170,240,17074,"445,754.26",40148
,20131227,52140,52210,52210,52380,52060,52380,52190,170,-20,12108,"315,980.81",36576
,20131230,52380,52190,52330,52480,52080,52300,52190,110,0,11704,"305,468.66",33832
,20131231,52300,52190,52200,52360,52040,52300,52260,110,70,10258,"268,070.94",30792
cu1402,20130219,59800,59800,59550,59550,59460,59460,59500,-340,-300,4,119.01,4
,20130220,59460,59500,59260,59300,59260,59300,59280,-200,-220,4,118.56,8
,20130221,59300,59280,58130,58300,58080,58160,58170,-1120,-1110,12,349.06,14
,20130222,58160,58170,58060,58300,58060,58290,58250,120,80,148,"4,310.51",148
,20130225,58290,58250,57960,57960,57780,57890,57790,-360,-460,122,"3,525.50",222
,20130226,57890,57790,57710,57710,57690,57690,57690,-100,-100,10,288.48,224
,20130227,57690,57690,58020,58040,57910,57940,57990,250,300,18,521.96,230
,20130228,57940,57990,58020,58210,58020,58210,58110,220,120,34,987.95,240
,20130301,58210,58110,57600,57620,57050,57100,57350,-1010,-760,52,"1,491.31",262
,20130304,57100,57350,56940,56960,56400,56600,56550,-750,-800,68,"1,922.74",298
,20130305,56600,56550,56900,57100,56900,57070,57010,520,460,36,"1,026.30",298
,20130306,57070,57010,57090,57090,56840,56870,56950,-140,-60,30,854.36,304
,20130307,56870,56950,56490,56690,56370,56690,56500,-260,-450,58,"1,638.64",324
,20130308,56690,56500,56890,56960,56870,56960,56870,460,370,46,"1,308.21",350
,20130311,56960,56870,56850,56850,56680,56680,56750,-190,-120,8,227.03,354
,20130312,56680,56750,56850,56950,56550,56550,56780,-200,30,6,170.35,354
,20130313,56550,56780,57000,57230,56940,57050,57140,270,360,52,"1,485.84",382
,20130314,57050,57140,56600,56770,56600,56620,56650,-520,-490,20,566.58,390
,20130315,56620,56650,57030,57280,56940,57190,57100,540,450,42,"1,199.28",414
,20130318,57190,57100,55010,55610,55010,55340,55390,-1760,-1710,102,"2,824.90",464
,20130319,55340,55390,55400,55460,55000,55150,55290,-240,-100,134,"3,704.69",522
,20130320,55150,55290,55170,55600,55170,55510,55400,220,110,20,554.01,520
,20130321,55510,55400,55750,56550,55750,56130,56170,730,770,76,"2,134.72",512
,20130322,56130,56170,56070,56180,55830,55900,55950,-270,-220,32,895.29,510
,20130325,55900,55950,56400,56480,56250,56250,56360,300,410,88,"2,479.88",512
,20130326,56250,56360,56060,56060,55850,56020,56010,-340,-350,34,952.32,518
,20130327,56020,56010,56140,56140,55800,55850,55910,-160,-100,18,503.25,522
,20130328,55850,55910,55990,55990,55500,55500,55770,-410,-140,8,223.09,524
,20130329,55500,55770,55100,55600,55100,55130,55340,-640,-430,58,"1,605.07",530
,20130401,55130,55340,54700,54700,54200,54270,54350,-1070,-990,60,"1,630.65",560
,20130402,54270,54350,54580,54720,54460,54660,54590,310,240,48,"1,310.33",558
,20130403,54660,54590,54670,54760,54520,54520,54620,-70,30,376,"10,268.79",796
,20130408,54520,54620,54670,55250,54500,55020,54910,400,290,548,"15,047.35",944
,20130409,55020,54910,55330,55330,54450,55150,54920,240,10,914,"25,100.89",1034
,20130410,55150,54920,55480,55550,55230,55340,55430,420,510,188,"5,210.54",926
,20130411,55340,55430,55350,55490,55130,55130,55310,-300,-120,10,276.56,922
,20130412,55130,55310,55310,55370,55180,55210,55260,-100,-50,16,442.13,910
,20130415,55210,55260,54180,54190,53120,53670,53480,-1590,-1780,224,"5,990.24",980
,20130416,53670,53480,52580,53290,52200,53290,52760,-190,-720,204,"5,381.63",1038
,20130417,53290,52760,53290,53290,52490,52490,52740,-270,-20,220,"5,802.08",1066
,20130418,52490,52740,50630,50680,50630,50630,50640,-2110,-2100,142,"3,595.86",1060
,20130419,50630,50640,50950,51210,49870,50610,50620,-30,-20,234,"5,922.86",1092
,20130422,50610,50620,50490,50490,49090,49090,49860,-1530,-760,412,"10,272.69",1260
,20130423,49090,49860,49350,49800,48660,49200,49200,-660,-660,270,"6,642.39",1294
,20130424,49200,49200,49330,51160,49050,50790,50320,1590,1120,254,"6,390.96",1278
,20130425,50790,50320,50910,51690,50620,51520,51120,1200,800,216,"5,521.23",1346
,20130426,51520,51120,52270,52680,50730,51730,51800,610,680,302,"7,822.26",1378
,20130502,51730,51800,49210,49970,49210,49600,49440,-2200,-2360,222,"5,488.46",1354
,20130503,49600,49440,49750,51050,49750,51010,50560,1570,1120,120,"3,033.66",1352
,20130506,51010,50560,53080,53080,52500,52900,52790,2340,2230,200,"5,279.07",1346
,20130507,52900,52790,52590,53240,52160,52160,52710,-630,-80,228,"6,010.05",1358
,20130508,52160,52710,52540,52930,52470,52920,52670,210,-40,112,"2,949.85",1356
,20130509,52920,52670,53100,53140,52760,52780,52940,110,270,54,"1,429.51",1360
,20130510,52780,52940,52750,53250,52700,53240,52960,300,20,78,"2,065.63",1358
,20130513,53240,52960,53120,53710,53050,53420,53370,460,410,204,"5,444.43",1364
,20130514,53420,53370,53580,53660,52590,52610,52960,-760,-410,178,"4,714.16",1378
,20130515,52610,52960,52650,52650,52010,52010,52290,-950,-670,184,"4,811.22",1370
,20130516,52010,52290,52030,52400,51670,52040,52140,-250,-150,568,"14,809.20",1366
,20130517,52040,52140,52320,53150,52320,52940,52720,800,580,162,"4,270.36",1370
,20130520,52940,52720,52880,52900,52340,52470,52530,-250,-190,116,"3,046.93",1368
,20130521,52470,52530,52970,53320,52970,53280,53090,750,560,122,"3,238.80",1356
,20130522,53280,53090,53220,53650,53140,53650,53360,560,270,50,"1,334.11",1346
,20130523,53650,53360,54220,54220,52150,52230,52540,-1130,-820,218,"5,726.90",1352
,20130524,52230,52540,52600,52870,52530,52770,52680,230,140,158,"4,161.73",1368
,20130527,52770,52680,51690,52520,51690,52520,52390,-160,-290,134,"3,510.62",1410
,20130528,52520,52390,52650,52650,51950,52450,52160,60,-230,330,"8,606.55",1574
,20130529,52450,52160,52600,52830,52150,52150,52600,-10,440,334,"8,785.34",1738
,20130530,52150,52600,51920,52260,51650,52150,52100,-450,-500,106,"2,761.47",1760
,20130531,52150,52100,52820,52820,52450,52510,52640,410,540,42,"1,105.46",1750
,20130603,52510,52640,53020,53050,52750,52770,52890,130,250,32,846.32,1742
,20130604,52770,52890,52870,53030,52800,52960,52910,70,20,34,899.55,1742
,20130605,52960,52910,53230,53500,53200,53490,53340,580,430,92,"2,453.66",1734
,20130606,53490,53340,53100,53410,52730,53000,53110,-340,-230,74,"1,965.32",1708
,20130607,53000,53110,52980,53120,52880,53090,52990,-20,-120,26,688.99,1708
,20130613,53090,52990,51780,52060,51400,51450,51610,-1540,-1380,140,"3,613.28",1732
,20130614,51450,51610,51600,51600,51290,51390,51380,-220,-230,178,"4,573.45",1796
,20130617,51390,51380,51600,51800,51500,51600,51590,220,210,78,"2,012.23",1796
,20130618,51600,51590,51400,51400,50950,50960,51210,-630,-380,862,"22,073.74",2284
,20130619,50960,51210,50900,50990,50570,50990,50740,-220,-470,240,"6,089.73",2354
,20130620,50990,50740,50020,50150,49600,49600,49780,-1140,-960,890,"22,156.15",2872
,20130621,49600,49780,48900,49590,48340,49590,49050,-190,-730,2202,"54,007.25",3884
,20130624,49590,49050,49270,49340,47950,47960,48440,-1090,-610,798,"19,329.84",3922
,20130625,47960,48440,48080,48930,47580,48780,48180,340,-260,2290,"55,177.22",4826
,20130626,48780,48180,49170,49170,48000,48040,48490,-140,310,1054,"25,559.06",5028
,20130627,48040,48490,48180,48890,48170,48760,48530,270,40,490,"11,891.04",4986
,20130628,48760,48530,48150,48700,47930,48430,48350,-100,-180,736,"17,795.14",4952
,20130701,48430,48350,48360,49360,48360,49360,48810,1010,460,648,"15,816.79",4902
,20130702,49360,48810,50000,50030,49470,49940,49730,1130,920,1188,"29,540.36",4580
,20130703,49940,49730,49860,50400,49770,50340,50070,610,340,552,"13,820.16",4192
,20130704,50340,50070,50370,50380,49830,49830,49990,-240,-80,2068,"51,694.70",3550
,20130705,49830,49990,49870,49870,49110,49110,49290,-880,-700,1888,"46,538.10",3904
,20130708,49110,49290,48960,48990,48340,48370,48530,-920,-760,4004,"97,167.22",4234
,20130709,48370,48530,48690,49000,48450,48700,48720,170,190,1524,"37,128.58",4318
,20130710,48700,48720,48540,48560,47790,48400,48140,-320,-580,4180,"100,628.55",4816
,20130711,48400,48140,48400,50540,48400,50510,49970,2370,1830,2376,"59,368.38",4344
,20130712,50510,49970,50590,50590,49510,49580,50030,-390,60,1482,"37,076.22",4398
,20130715,49580,50030,49560,50100,49480,49700,49740,-330,-290,2122,"52,780.46",4462
,20130716,49700,49740,49860,50100,49580,50100,49780,360,40,896,"22,304.60",4538
,20130717,50100,49780,50090,50530,49720,49720,50170,-60,390,1318,"33,062.50",4482
,20130718,49720,50170,49620,49620,49230,49530,49360,-640,-810,1124,"27,744.09",4580
,20130719,49530,49360,49520,50040,49360,49400,49770,40,410,2628,"65,409.15",4738
,20130722,49400,49770,49900,50200,49770,50200,50010,430,240,1222,"30,558.84",4708
,20130723,50200,50010,50110,50510,50090,50100,50290,90,280,1934,"48,634.95",4910
,20130724,50100,50290,50420,50480,50000,50340,50270,50,-20,1632,"41,021.67",5008
,20130725,50340,50270,50110,50390,50080,50330,50200,60,-70,2892,"72,592.91",5818
,20130726,50330,50200,50420,50430,49770,49940,50080,-260,-120,5368,"134,422.90",8048
,20130729,49940,50080,49490,49490,48780,48900,48970,-1180,-1110,4454,"109,066.96",8322
,20130730,48900,48970,49000,49130,48720,48730,48960,-240,-10,3406,"83,389.95",9710
,20130731,48730,48960,48480,49020,48400,48930,48590,-30,-370,3744,"90,962.65",9486
,20130801,48930,48590,49030,49960,49030,49780,49580,1190,990,3066,"76,013.66",10036
,20130802,49780,49580,50010,50040,49510,49790,49720,210,140,1986,"49,378.36",9804
,20130805,49790,49720,49740,50020,49650,49930,49890,210,170,1810,"45,156.18",9436
,20130806,49930,49890,49800,49960,49660,49910,49810,20,-80,1778,"44,289.96",9444
,20130807,49910,49810,49770,49870,49580,49750,49710,-60,-100,1408,"34,998.88",9394
,20130808,49750,49710,49960,51330,49960,51300,50820,1590,1110,5284,"134,274.93",9450
,20130809,51300,50820,51360,51650,51100,51360,51370,540,550,4246,"109,062.54",10518
,20130812,51360,51370,51860,52380,51630,52210,51920,840,550,2834,"73,580.06",10346
,20130813,52210,51920,52020,52140,51800,52060,51980,140,60,1818,"47,257.95",11118
,20130814,52060,51980,51940,52460,51810,52070,52040,90,60,3700,"96,285.19",12264
,20130815,52070,52040,52270,52450,51950,52000,52190,-40,150,2394,"62,473.67",12648
,20130816,52000,52190,52410,53170,52260,53110,52770,920,580,4624,"122,004.37",13042
,20130819,53110,52770,52990,53030,52690,52720,52840,-50,70,1368,"36,145.71",13314
,20130820,52720,52840,52580,52630,52000,52100,52260,-740,-580,2592,"67,737.85",13854
,20130821,52100,52260,52310,52450,52220,52430,52320,170,60,1174,"30,715.13",13846
,20130822,52430,52320,52040,52800,51980,52710,52480,390,160,2572,"67,494.21",13608
,20130823,52710,52480,52630,52720,52380,52700,52530,220,50,2508,"65,874.37",14530
,20130826,52700,52530,53330,53550,53090,53320,53240,790,710,3936,"104,778.77",14752
,20130827,53320,53240,52830,53020,52700,52780,52810,-460,-430,2524,"66,653.78",15204
,20130828,52780,52810,52690,52960,52300,52300,52580,-510,-230,2972,"78,143.98",14862
,20130829,52300,52580,52420,52500,51960,52350,52220,-230,-360,5328,"139,127.51",15242
,20130830,52350,52220,51810,52000,51720,51880,51830,-340,-390,4096,"106,152.44",15592
,20130902,51880,51830,52200,52730,52080,52490,52480,660,650,8252,"216,546.65",16834
,20130903,52490,52480,52600,52710,52210,52370,52400,-110,-80,5204,"136,357.53",17884
,20130904,52370,52400,52400,52430,51950,51990,52120,-410,-280,3020,"78,707.74",18140
,20130905,51990,52120,51720,51920,51450,51630,51620,-490,-500,5064,"130,702.62",18970
,20130906,51630,51620,51740,51850,51600,51820,51730,200,110,3654,"94,526.93",19096
,20130909,51820,51730,52070,52340,51970,52230,52240,500,510,5900,"154,113.17",19320
,20130910,52230,52240,52180,52180,51720,51920,51960,-320,-280,3578,"92,964.43",19716
,20130911,51920,51960,51980,52150,51800,52000,51980,40,20,2406,"62,539.90",19894
,20130912,52000,51980,51840,51900,51280,51280,51590,-700,-390,4402,"113,550.89",20838
,20130913,51280,51590,51120,51270,50930,51260,51070,-330,-520,10772,"275,110.54",23546
,20130916,51260,51070,51460,51560,51010,51100,51290,30,220,7384,"189,382.36",23650
,20130917,51100,51290,51150,51450,50810,51430,51120,140,-170,6850,"175,093.12",24750
,20130918,51430,51120,51270,51700,51100,51630,51290,510,170,5030,"129,010.71",24754
,20130923,51630,51290,52000,52070,51670,52000,51810,710,520,8462,"219,227.24",25564
,20130924,52000,51810,52050,52100,51690,51710,51900,-100,90,11600,"301,057.06",28610
,20130925,51710,51900,51760,51850,51550,51720,51670,-180,-230,6478,"167,373.24",29278
,20130926,51720,51670,51880,52230,51620,52170,51910,500,240,9558,"248,085.93",30708
,20130927,52170,51910,52180,52460,52060,52300,52240,390,330,9922,"259,174.35",30214
,20130930,52300,52240,52280,52740,52170,52710,52410,470,170,10856,"284,510.53",27862
,20131008,52710,52410,52380,52500,52170,52390,52290,-20,-120,8486,"221,872.99",29378
,20131009,52390,52290,52220,52260,51530,51610,51800,-680,-490,20004,"518,151.29",36758
,20131010,51610,51800,51300,51480,51200,51350,51340,-450,-460,14692,"377,198.88",41796
,20131011,51350,51340,51500,51840,51500,51590,51630,250,290,12874,"332,393.56",43594
,20131014,51590,51630,51660,52240,51300,52210,51850,580,220,16868,"437,344.02",43312
,20131015,52210,51850,52240,52350,52000,52100,52120,250,270,10752,"280,207.22",44492
,20131016,52100,52120,52080,52400,51960,52170,52150,50,30,18858,"491,727.84",46368
,20131017,52170,52150,52480,52580,51700,51740,52020,-410,-130,25822,"671,688.87",52518
,20131018,51740,52020,51980,52230,51920,52200,52100,180,80,20278,"528,282.98",53786
,20131021,52200,52100,52050,52310,51810,52280,52030,180,-70,25622,"666,634.57",55726
,20131022,52280,52030,52030,52320,52030,52140,52150,110,120,18084,"471,590.65",57596
,20131023,52140,52150,52470,52490,52010,52060,52240,-90,90,27076,"707,238.42",61426
,20131024,52060,52240,51740,51830,51410,51690,51640,-550,-600,57522,"1,485,385.07",75782
,20131025,51690,51640,51760,51760,51070,51130,51370,-510,-270,55164,"1,416,969.15",84484
,20131028,51130,51370,51380,51590,51290,51440,51450,70,80,48578,"1,249,735.71",83808
,20131029,51440,51450,51430,51500,51010,51480,51220,30,-230,73770,"1,889,264.76",88574
,20131030,51480,51220,51600,52150,51440,52030,51810,810,590,79768,"2,066,737.14",83456
,20131031,52030,51810,51870,51960,51600,51730,51780,-80,-30,68814,"1,781,817.70",87868
,20131101,51730,51780,51680,52250,51660,52180,51970,400,190,85810,"2,230,105.78",93772
,20131104,52180,51970,51960,52040,51470,51660,51730,-310,-240,88816,"2,297,367.52",99784
,20131105,51660,51730,51530,51730,51350,51560,51540,-170,-190,81944,"2,111,832.58",105692
,20131106,51560,51540,51610,51640,51320,51510,51470,-30,-70,77570,"1,996,580.52",112072
,20131107,51510,51470,51250,51470,51190,51420,51310,-50,-160,69780,"1,790,298.20",119246
,20131108,51420,51310,51270,51660,51270,51400,51490,90,180,72186,"1,858,544.61",121820
,20131111,51400,51490,51590,51890,51470,51570,51620,80,130,65250,"1,684,185.32",124022
,20131112,51570,51620,51550,51570,51250,51430,51380,-190,-240,94934,"2,439,214.21",135040
,20131113,51430,51380,50960,50990,50440,50510,50700,-870,-680,223606,"5,668,612.55",201258
,20131114,50510,50700,50300,50570,50300,50340,50430,-360,-270,180584,"4,553,521.38",213848
,20131115,50340,50430,50450,50770,49930,49960,50400,-470,-30,303112,"7,638,948.16",241636
,20131118,49960,50400,50280,50400,50120,50290,50250,-110,-150,268042,"6,735,748.75",259720
,20131119,50290,50250,49900,50000,49590,49810,49770,-440,-480,356028,"8,861,159.63",281116
,20131120,49810,49770,49980,50490,49930,50360,50260,590,490,280530,"7,049,808.48",270426
,20131121,50360,50260,50110,50380,49910,50280,50110,20,-150,300520,"7,529,918.56",287304
,20131122,50280,50110,50600,50720,50360,50470,50530,360,420,255306,"6,450,644.47",275080
,20131125,50470,50530,50990,51020,50480,50500,50700,-30,170,252702,"6,407,157.43",284754
,20131126,50500,50700,50810,50960,50610,50790,50770,90,70,263710,"6,695,139.11",265860
,20131127,50790,50770,50710,50740,50470,50660,50610,-110,-160,220912,"5,591,008.71",273648
,20131128,50660,50610,50470,50690,50320,50420,50490,-190,-120,252664,"6,379,631.67",282736
,20131129,50420,50490,50600,50740,50520,50600,50620,110,130,221126,"5,597,014.22",278122
,20131202,50600,50620,50690,50780,50500,50630,50610,10,-10,206364,"5,222,340.06",278480
,20131203,50630,50610,50300,50340,50000,50170,50170,-440,-440,256262,"6,429,255.83",295090
,20131204,50170,50170,50150,50470,50140,50360,50320,190,150,203048,"5,108,727.15",290264
,20131205,50360,50320,50900,50920,50680,50720,50770,400,450,178896,"4,541,607.41",266754
,20131206,50720,50770,50740,50990,50600,50910,50770,140,0,170774,"4,335,100.50",257360
,20131209,50910,50770,50960,51090,50780,50870,50900,100,130,169474,"4,313,313.63",250922
,20131210,50870,50900,51000,51220,50970,51100,51080,200,180,187024,"4,777,467.50",245828
,20131211,51100,51080,51250,51290,50990,51100,51150,20,70,153328,"3,921,668.06",242798
,20131212,51100,51150,51400,51580,51300,51560,51420,410,270,185806,"4,777,094.77",232544
,20131213,51560,51420,51430,51430,51070,51160,51220,-260,-200,173690,"4,448,804.95",226242
,20131216,51160,51220,51390,51450,51290,51410,51370,190,150,104716,"2,689,929.79",218492
,20131217,51410,51370,51550,51740,51400,51450,51540,80,170,104714,"2,698,785.06",212776
,20131218,51450,51540,51440,51460,51100,51300,51220,-240,-320,98134,"2,513,341.03",202482
,20131219,51300,51220,51400,51420,50930,51040,51060,-180,-160,100248,"2,559,494.99",192686
,20131220,51040,51060,51070,51440,50910,51370,51200,310,140,110388,"2,826,323.34",176804
,20131223,51370,51200,51440,51520,51150,51270,51330,70,130,64282,"1,649,943.81",167330
,20131224,51270,51330,51350,51450,51210,51410,51360,80,30,31558,"810,417.96",161558
,20131225,51410,51360,51510,52540,51440,52330,51990,970,630,65568,"1,704,440.16",143742
,20131226,52330,51990,52310,52700,52030,52170,52300,180,310,47822,"1,250,607.75",133292
,20131227,52170,52300,52260,52380,52070,52370,52230,70,-70,28980,"756,826.55",125660
,20131230,52370,52230,52330,52500,52100,52290,52270,60,40,31466,"822,387.37",115366
,20131231,52290,52270,52180,52400,52030,52300,52240,30,-30,40202,"1,050,269.37",100078
cu1403,20130318,57100,57100,,,,55500,55500,-1600,-1600,0,0,0
,20130319,55500,55500,55570,55570,55150,55200,55170,-300,-330,46,"1,269.03",46
,20130320,55200,55170,55260,55630,55260,55600,55530,430,360,10,277.69,54
,20130321,55600,55530,,,,56100,56100,570,570,0,0,54
,20130322,56100,56100,56190,56190,55830,55830,56040,-270,-60,6,168.12,60
,20130325,55830,56040,56450,56450,56230,56440,56390,400,350,8,225.56,66
,20130326,56440,56390,56140,56180,55980,56030,56010,-360,-380,92,"2,576.58",134
,20130327,56030,56010,56150,56150,55820,55900,55990,-110,-20,98,"2,743.59",200
,20130328,55900,55990,56000,56000,55650,55650,55780,-340,-210,22,613.6,202
,20130329,55650,55780,55510,55510,55240,55240,55400,-540,-380,24,664.86,200
,20130401,55240,55400,54350,54470,54220,54220,54380,-1180,-1020,90,"2,447.53",262
,20130402,54220,54380,54520,54800,54490,54800,54640,420,260,28,764.96,264
,20130403,54800,54640,54650,54920,54440,54440,54620,-200,-20,442,"12,073.09",600
,20130408,54440,54620,54670,55250,54530,55040,54850,420,230,428,"11,739.49",792
,20130409,55040,54850,55330,55480,54550,55190,55120,340,270,578,"15,931.38",702
,20130410,55190,55120,55460,55570,55250,55430,55440,310,320,180,"4,989.69",636
,20130411,55430,55440,55370,55500,55120,55120,55280,-320,-160,34,939.76,636
,20130412,55120,55280,55340,55450,55200,55200,55350,-80,70,20,553.52,636
,20130415,55200,55350,54370,54370,53200,53820,53600,-1530,-1750,316,"8,469.77",874
,20130416,53820,53600,52900,53390,52300,53390,52880,-210,-720,90,"2,379.86",878
,20130417,53390,52880,53380,53380,52520,52600,52790,-280,-90,206,"5,437.57",988
,20130418,52600,52790,50670,50680,50670,50670,50670,-2120,-2120,324,"8,208.68",1010
,20130419,50670,50670,51080,51080,50000,50900,50620,230,-50,142,"3,594.10",1032
,20130422,50900,50620,50220,50350,49150,49150,49990,-1470,-630,432,"10,799.44",1192
,20130423,49150,49990,49450,49750,48680,49080,49250,-910,-740,290,"7,141.86",1250
,20130424,49080,49250,49510,51140,49370,50760,50110,1510,860,204,"5,111.61",1256
,20130425,50760,50110,51000,51550,50610,51480,51300,1370,1190,210,"5,386.83",1300
,20130426,51480,51300,52000,52550,51560,51890,51890,590,590,140,"3,632.75",1276
,20130502,51890,51890,49300,49920,49290,49670,49540,-2220,-2350,126,"3,121.59",1264
,20130503,49670,49540,49850,51060,49850,51010,50770,1470,1230,90,"2,284.81",1292
,20130506,51010,50770,53290,53290,52600,52980,52900,2210,2130,92,"2,433.56",1310
,20130507,52980,52900,52600,53420,52270,52270,52810,-630,-90,174,"4,594.83",1276
,20130508,52270,52810,52710,53170,52500,53060,52750,250,-60,60,"1,582.51",1264
,20130509,53060,52750,53300,53300,52770,52880,52970,130,220,94,"2,489.75",1254
,20130510,52880,52970,52550,53520,52540,53520,53010,550,40,184,"4,877.15",1270
,20130513,53520,53010,53220,53560,53130,53490,53340,480,330,30,800.18,1264
,20130514,53490,53340,53500,53670,52630,52650,53170,-690,-170,122,"3,243.97",1254
,20130515,52650,53170,52610,52730,52000,52020,52380,-1150,-790,184,"4,819.85",1248
,20130516,52020,52380,52000,52410,51720,52180,52040,-200,-340,114,"2,966.82",1242
,20130517,52180,52040,52700,53080,52380,53080,52580,1040,540,114,"2,997.17",1232
,20130520,53080,52580,52950,52970,52340,52540,52540,-40,-40,90,"2,364.49",1256
,20130521,52540,52540,53070,53330,52950,53160,53080,620,540,48,"1,274.04",1234
,20130522,53160,53080,53220,53570,53150,53570,53250,490,170,40,"1,065.16",1228
,20130523,53570,53250,53080,53080,52150,52150,52620,-1100,-630,76,"1,999.75",1224
,20130524,52150,52620,52690,52880,52630,52780,52770,160,150,22,580.52,1232
,20130527,52780,52770,52510,52510,52230,52450,52470,-320,-300,88,"2,308.79",1288
,20130528,52450,52470,52530,52530,52000,52330,52230,-140,-240,26,679.06,1288
,20130529,52330,52230,52430,52890,52200,52200,52510,-30,280,60,"1,575.37",1292
,20130530,52200,52510,52000,52360,51780,52240,52120,-270,-390,94,"2,449.79",1304
,20130531,52240,52120,52800,52800,52450,52450,52600,330,480,8,210.43,1304
,20130603,52450,52600,52500,53030,52500,52780,52760,180,160,56,"1,477.44",1306
,20130604,52780,52760,52890,53030,52890,53030,52940,270,180,24,635.32,1300
,20130605,53030,52940,53240,53500,53240,53500,53370,560,430,20,533.71,1296
,20130606,53500,53370,53200,53320,52790,52840,53140,-530,-230,36,956.65,1310
,20130607,52840,53140,,,,53140,53140,0,0,0,0,1310
,20130613,53140,53140,52000,52000,51450,51490,51730,-1650,-1410,106,"2,741.97",1366
,20130614,51490,51730,51600,51660,51280,51400,51450,-330,-280,124,"3,190.25",1390
,20130617,51400,51450,51630,51870,51590,51660,51720,210,270,146,"3,775.58",1424
,20130618,51660,51720,51460,51460,51000,51000,51130,-720,-590,152,"3,885.90",1504
,20130619,51000,51130,50750,50990,50600,50990,50790,-140,-340,46,"1,168.27",1522
,20130620,50990,50790,50200,50220,49720,49780,49940,-1010,-850,432,"10,788.17",1668
,20130621,49780,49940,48900,49720,48610,49720,49130,-220,-810,1400,"34,396.58",2460
,20130624,49720,49130,49420,49420,48150,48150,48740,-980,-390,224,"5,459.70",2582
,20130625,48150,48740,48230,49030,47860,48870,48280,130,-460,1322,"31,917.19",3450
,20130626,48870,48280,49420,49420,48140,48160,48670,-120,390,604,"14,699.65",3506
,20130627,48160,48670,48440,48960,48340,48890,48730,220,60,656,"15,986.48",3612
,20130628,48890,48730,48300,48760,48010,48600,48460,-130,-270,930,"22,535.65",3850
,20130701,48600,48460,48540,49430,48540,49430,48980,970,520,354,"8,671.14",3874
,20130702,49430,48980,49800,50030,49560,49990,49800,1010,820,354,"8,814.69",3886
,20130703,49990,49800,49980,50450,49780,50450,50040,650,240,252,"6,305.24",3814
,20130704,50450,50040,50380,50470,49870,49870,50020,-170,-20,1318,"32,968.81",3634
,20130705,49870,50020,49950,49950,49190,49190,49460,-830,-560,648,"16,026.37",3990
,20130708,49190,49460,49000,49000,48400,48450,48530,-1010,-930,778,"18,880.41",4392
,20130709,48450,48530,48770,49050,48550,48750,48880,220,350,406,"9,923.53",4396
,20130710,48750,48880,48600,48600,47870,48430,48150,-450,-730,500,"12,037.50",4456
,20130711,48430,48150,49480,50550,49480,50550,50070,2400,1920,260,"6,509.43",4442
,20130712,50550,50070,50400,50500,49560,49620,50060,-450,-10,412,"10,313.26",4456
,20130715,49620,50060,49620,50050,49520,49760,49720,-300,-340,188,"4,673.81",4452
,20130716,49760,49720,49930,49970,49630,49900,49770,180,50,64,"1,592.69",4458
,20130717,49900,49770,50050,50560,49730,49730,49970,-40,200,334,"8,345.67",4460
,20130718,49730,49970,49520,49570,49260,49570,49360,-400,-610,312,"7,701.07",4476
,20130719,49570,49360,50090,50090,49420,49430,49670,70,310,272,"6,756.31",4466
,20130722,49430,49670,49930,50250,49930,50190,50020,520,350,184,"4,602.62",4472
,20130723,50190,50020,50260,50520,50110,50110,50290,90,270,186,"4,677.53",4476
,20130724,50110,50290,50400,50500,50080,50350,50220,60,-70,210,"5,273.77",4526
,20130725,50350,50220,50150,50400,50120,50330,50280,110,60,254,"6,385.57",4558
,20130726,50330,50280,50450,50450,49800,50020,50080,-260,-200,824,"20,635.58",5016
,20130729,50020,50080,49200,49200,48800,48940,48960,-1140,-1120,1536,"37,602.50",4404
,20130730,48940,48960,49050,49140,48800,48800,48960,-160,0,738,"18,067.13",4806
,20130731,48800,48960,48450,49010,48450,49010,48580,50,-380,866,"21,037.14",4532
,20130801,49010,48580,49030,49970,49030,49790,49570,1210,990,788,"19,531.53",4102
,20130802,49790,49570,50080,50080,49550,49790,49750,220,180,366,"9,105.22",4152
,20130805,49790,49750,49750,50020,49710,49950,49900,200,150,170,"4,242.22",4190
,20130806,49950,49900,49860,50000,49690,49980,49860,80,-40,158,"3,939.17",4202
,20130807,49980,49860,49760,49880,49600,49790,49720,-70,-140,292,"7,259.15",4220
,20130808,49790,49720,50250,51330,50230,51280,50950,1560,1230,1156,"29,453.74",4402
,20130809,51280,50950,51390,51640,51160,51350,51400,400,450,846,"21,745.52",4548
,20130812,51350,51400,51780,52380,51670,52340,51910,940,510,822,"21,338.29",4438
,20130813,52340,51910,52050,52150,51900,52100,51990,190,80,376,"9,775.09",4496
,20130814,52100,51990,51940,52420,51800,52100,51970,110,-20,2062,"53,581.16",4780
,20130815,52100,51970,52250,52420,51970,52110,52130,140,160,1056,"27,526.98",4718
,20130816,52110,52130,52370,53220,52280,53160,52860,1030,730,4822,"127,463.02",4836
,20130819,53160,52860,53000,53160,52750,52750,53000,-110,140,1054,"27,932.86",5248
,20130820,52750,53000,52580,52710,52050,52120,52330,-880,-670,1208,"31,612.52",5430
,20130821,52120,52330,52380,52490,52290,52400,52370,70,40,578,"15,136.34",5454
,20130822,52400,52370,52080,52820,52080,52740,52540,370,170,686,"18,021.26",5562
,20130823,52740,52540,52730,52750,52440,52730,52620,190,80,442,"11,630.60",5504
,20130826,52730,52620,53430,53430,53090,53280,53250,660,630,2954,"78,664.50",5214
,20130827,53280,53250,53130,53130,52720,52810,52860,-440,-390,968,"25,586.95",5418
,20130828,52810,52860,52720,52930,52330,52380,52650,-480,-210,822,"21,642.63",5430
,20130829,52380,52650,52490,52490,51950,52420,52240,-230,-410,1944,"50,783.09",5940
,20130830,52420,52240,51890,52030,51770,51900,51880,-340,-360,1098,"28,486.74",6078
,20130902,51900,51880,51900,52790,51900,52580,52420,700,540,3020,"79,165.28",6028
,20130903,52580,52420,52470,52720,52220,52220,52450,-200,30,3206,"84,087.27",6332
,20130904,52220,52450,52450,52460,51980,52010,52160,-440,-290,1028,"26,813.24",6496
,20130905,52010,52160,51790,51950,51500,51660,51720,-500,-440,1538,"39,779.19",6874
,20130906,51660,51720,51830,51890,51650,51860,51790,140,70,1086,"28,122.38",6934
,20130909,51860,51790,52120,52360,52030,52280,52250,490,460,2220,"58,001.23",7258
,20130910,52280,52250,52180,52180,51720,51920,51900,-330,-350,2148,"55,751.00",7368
,20130911,51920,51900,52010,52170,51780,51980,51960,80,60,2422,"62,931.66",7850
,20130912,51980,51960,51830,51890,51300,51300,51590,-660,-370,3140,"81,006.16",8256
,20130913,51300,51590,51190,51260,50920,51240,51060,-350,-530,4554,"116,282.83",9208
,20130916,51240,51060,51470,51600,51040,51080,51340,20,280,2890,"74,193.89",9914
,20130917,51080,51340,51110,51450,50830,51450,51140,110,-200,1638,"41,885.48",10208
,20130918,51450,51140,51270,51650,51140,51650,51310,510,170,2548,"65,370.19",10982
,20130923,51650,51310,52030,52090,51720,52020,51850,710,540,2446,"63,421.56",11394
,20130924,52020,51850,52000,52130,51730,51730,51960,-120,110,2930,"76,131.73",11666
,20130925,51730,51960,51820,51880,51600,51740,51690,-220,-270,1464,"37,840.53",11708
,20130926,51740,51690,51780,52240,51650,52150,51960,460,270,2470,"64,176.31",12236
,20130927,52150,51960,52150,52450,52070,52150,52240,190,280,5342,"139,556.74",13490
,20130930,52150,52240,52300,52720,52170,52710,52430,470,190,4620,"121,129.93",13756
,20131008,52710,52430,52390,52490,52110,52400,52270,-30,-160,2418,"63,205.20",14226
,20131009,52400,52270,52200,52220,51510,51590,51870,-680,-400,6846,"177,561.57",16892
,20131010,51590,51870,51340,51460,51180,51360,51320,-510,-550,5888,"151,114.20",18446
,20131011,51360,51320,51440,51800,51440,51560,51610,240,290,3466,"89,452.26",19752
,20131014,51560,51610,51650,52270,51310,52270,51900,660,290,5940,"154,145.36",20114
,20131015,52270,51900,52300,52340,52000,52090,52140,190,240,3122,"81,400.85",20328
,20131016,52090,52140,52160,52390,51990,52200,52180,60,40,4040,"105,414.14",20918
,20131017,52200,52180,52470,52570,51700,51780,52090,-400,-90,5614,"146,241.01",21984
,20131018,51780,52090,52000,52250,51940,52210,52110,120,20,5028,"131,019.67",22676
,20131021,52210,52110,52100,52310,51820,52280,52010,170,-100,3734,"97,104.06",23324
,20131022,52280,52010,52200,52300,52080,52160,52150,150,140,3266,"85,165.25",24088
,20131023,52160,52150,52460,52500,52040,52100,52280,-50,130,5458,"142,679.98",25040
,20131024,52100,52280,51780,51850,51480,51750,51670,-530,-610,7540,"194,802.65",27076
,20131025,51750,51670,51750,51760,51100,51140,51360,-530,-310,7174,"184,229.30",28190
,20131028,51140,51360,51370,51590,51320,51490,51460,130,100,3632,"93,465.26",28380
,20131029,51490,51460,51420,51560,51040,51560,51240,100,-220,5724,"146,651.10",30062
,20131030,51560,51240,51610,52160,51450,52060,51840,820,600,6536,"169,429.09",29166
,20131031,52060,51840,51960,51960,51630,51750,51830,-90,-10,4344,"112,578.85",29598
,20131101,51750,51830,51700,52290,51690,52250,52040,420,210,10794,"280,867.90",30062
,20131104,52250,52040,52000,52090,51520,51680,51780,-360,-260,6720,"173,985.15",30620
,20131105,51680,51780,51550,51770,51390,51620,51550,-160,-230,6102,"157,282.82",32568
,20131106,51620,51550,51590,51670,51360,51550,51510,0,-40,5206,"134,081.05",33536
,20131107,51550,51510,51280,51480,51220,51440,51350,-70,-160,5208,"133,718.73",34500
,20131108,51440,51350,51290,51650,51290,51430,51500,80,150,6526,"168,056.99",35686
,20131111,51430,51500,51600,51870,51500,51580,51630,80,130,6674,"172,291.14",35614
,20131112,51580,51630,51470,51560,51240,51420,51390,-210,-240,6962,"178,898.29",36638
,20131113,51420,51390,50980,51000,50470,50530,50720,-860,-670,21210,"537,972.82",43354
,20131114,50530,50720,50250,50570,50250,50360,50430,-360,-290,15282,"385,382.20",45772
,20131115,50360,50430,50430,50810,49930,50000,50480,-430,50,34400,"868,351.31",49814
,20131118,50000,50480,50340,50410,50150,50330,50290,-150,-190,21846,"549,342.27",49890
,20131119,50330,50290,49980,49980,49560,49740,49740,-550,-550,39998,"994,858.75",61524
,20131120,49740,49740,49910,50450,49880,50320,50210,580,470,42246,"1,060,785.68",67548
,20131121,50320,50210,50110,50310,49860,50250,50060,40,-150,43570,"1,090,724.44",76806
,20131122,50250,50060,50520,50660,50310,50420,50460,360,400,44112,"1,113,085.94",79956
,20131125,50420,50460,50920,50950,50430,50450,50640,-10,180,39816,"1,008,338.82",86098
,20131126,50450,50640,50780,50910,50580,50740,50730,100,90,48834,"1,238,780.04",88490
,20131127,50740,50730,50670,50680,50430,50590,50550,-140,-180,36294,"917,371.89",92516
,20131128,50590,50550,50400,50620,50270,50340,50420,-210,-130,50230,"1,266,545.22",99008
,20131129,50340,50420,50560,50690,50440,50530,50560,110,140,49206,"1,244,003.86",102068
,20131202,50530,50560,50600,50700,50450,50560,50540,0,-20,48452,"1,224,547.85",107918
,20131203,50560,50540,50200,50280,49930,50090,50110,-450,-430,77316,"1,937,361.92",118904
,20131204,50090,50110,50100,50420,50070,50310,50260,200,150,68990,"1,733,986.06",124238
,20131205,50310,50260,50850,50860,50600,50650,50710,390,450,62928,"1,595,542.45",120526
,20131206,50650,50710,50650,50910,50530,50830,50680,120,-30,59126,"1,498,393.65",118620
,20131209,50830,50680,50870,51000,50510,50800,50810,120,130,53530,"1,360,029.69",120054
,20131210,50800,50810,50920,51140,50880,51030,50990,220,180,67610,"1,723,961.42",124002
,20131211,51030,50990,51190,51190,50920,51040,51070,50,80,58656,"1,497,949.87",127286
,20131212,51040,51070,51300,51580,51250,51550,51380,480,310,88886,"2,283,739.02",129832
,20131213,51550,51380,51400,51420,51050,51110,51210,-270,-170,105844,"2,710,241.78",147290
,20131216,51110,51210,51360,51450,51270,51400,51350,190,140,84456,"2,168,701.63",157598
,20131217,51400,51350,51580,51740,51380,51410,51530,60,180,151728,"3,909,999.02",167528
,20131218,51410,51530,51420,51440,51090,51290,51200,-240,-330,161928,"4,146,009.55",186908
,20131219,51290,51200,51400,51420,50910,51030,51050,-170,-150,230138,"5,874,725.66",207172
,20131220,51030,51050,51050,51440,50880,51380,51180,330,130,290430,"7,432,855.99",213638
,20131223,51380,51180,51440,51540,51140,51270,51320,90,140,287244,"7,371,903.63",214264
,20131224,51270,51320,51380,51470,51200,51430,51350,110,30,181938,"4,671,437.35",217174
,20131225,51430,51350,51550,52640,51450,52360,52010,1010,660,292396,"7,604,205.78",213098
,20131226,52360,52010,52330,52770,52070,52210,52390,200,380,355928,"9,324,004.51",223944
,20131227,52210,52390,52320,52420,52130,52390,52270,0,-120,212466,"5,553,257.71",222646
,20131230,52390,52270,52330,52580,52120,52340,52310,70,40,220994,"5,780,730.06",223080
,20131231,52340,52310,52270,52470,52030,52280,52280,-30,-30,302256,"7,900,975.69",226906
cu1404,20130416,53600,53600,52500,53500,52480,53400,53070,-200,-530,250,"6,634.71",214
,20130417,53400,53070,53700,53810,52780,52780,53180,-290,110,172,"4,574.25",336
,20130418,52780,53180,51050,51050,51050,51050,51050,-2130,-2130,2,51.05,334
,20130419,51050,51050,51080,51300,50210,51010,50800,-40,-250,76,"1,930.66",350
,20130422,51010,50800,50470,50630,49200,49230,50070,-1570,-730,430,"10,766.32",606
,20130423,49230,50070,49600,49700,48900,49020,49300,-1050,-770,168,"4,141.61",580
,20130424,49020,49300,49390,51000,49390,50950,49910,1650,610,254,"6,338.58",646
,20130425,50950,49910,50800,51560,50700,51530,51050,1620,1140,146,"3,726.79",706
,20130426,51530,51050,52220,52620,51700,51800,52030,750,980,82,"2,133.23",708
,20130502,51800,52030,49420,50320,49420,49610,49680,-2420,-2350,122,"3,030.63",712
,20130503,49610,49680,50110,51180,50110,51100,50890,1420,1210,48,"1,221.40",736
,20130506,51100,50890,52860,53040,52540,53040,52900,2150,2010,92,"2,433.46",768
,20130507,53040,52900,52690,53370,52320,52330,52730,-570,-170,74,"1,951.18",792
,20130508,52330,52730,53190,53190,52600,53100,52910,370,180,186,"4,920.69",828
,20130509,53100,52910,53220,53220,52780,53050,53070,140,160,84,"2,229.04",806
,20130510,53050,53070,52870,53500,52790,53440,53100,370,30,94,"2,495.95",842
,20130513,53440,53100,53260,53710,53170,53460,53470,360,370,116,"3,101.39",866
,20130514,53460,53470,53550,53700,52650,52700,53030,-770,-440,436,"11,561.89",870
,20130515,52700,53030,52740,52740,52020,52020,52270,-1010,-760,276,"7,214.54",1076
,20130516,52020,52270,52110,52400,51750,51970,52160,-300,-110,254,"6,625.07",994
,20130517,51970,52160,52420,53220,52320,53070,52610,910,450,208,"5,472.02",996
,20130520,53070,52610,52490,52680,52430,52500,52530,-110,-80,42,"1,103.26",1008
,20130521,52500,52530,52980,53290,52980,53290,53130,760,600,64,"1,700.47",1030
,20130522,53290,53130,53290,53670,53290,53580,53540,450,410,14,374.81,1034
,20130523,53580,53540,52950,52950,52200,52260,52600,-1280,-940,108,"2,840.68",1032
,20130524,52260,52600,52870,52870,52440,52720,52650,120,50,60,"1,579.78",1046
,20130527,52720,52650,52420,52510,52260,52470,52440,-180,-210,48,"1,258.71",1052
,20130528,52470,52440,52510,52510,51930,52320,52120,-120,-320,100,"2,606.12",1030
,20130529,52320,52120,52710,52900,52270,52270,52710,150,590,78,"2,055.97",1020
,20130530,52270,52710,51980,52400,51740,52210,52130,-500,-580,50,"1,303.42",1020
,20130531,52210,52130,52800,52800,52490,52560,52590,430,460,46,"1,209.67",1018
,20130603,52560,52590,53030,53060,52770,52830,52860,240,270,30,792.96,1016
,20130604,52830,52860,53000,53020,52890,52940,52970,80,110,14,370.79,1022
,20130605,52940,52970,53350,53630,53200,53630,53370,660,400,178,"4,750.55",1162
,20130606,53630,53370,53450,53450,52880,53020,53040,-350,-330,180,"4,774.39",1142
,20130607,53020,53040,53000,53200,52930,53200,53020,160,-20,26,689.36,1142
,20130613,53200,53020,51910,52000,51510,51510,51680,-1510,-1340,82,"2,118.96",1158
,20130614,51510,51680,51600,51700,51420,51430,51510,-250,-170,76,"1,957.70",1156
,20130617,51430,51510,51610,51790,51610,51690,51680,180,170,32,826.97,1150
,20130618,51690,51680,51530,51530,51000,51000,51170,-680,-510,160,"4,094.35",1218
,20130619,51000,51170,50910,51080,50650,51080,50790,-90,-380,98,"2,488.88",1218
,20130620,51080,50790,50140,50300,49770,49810,50030,-980,-760,692,"17,310.40",1726
,20130621,49810,50030,49020,49830,48680,49810,49490,-220,-540,682,"16,876.84",1834
,20130624,49810,49490,49660,49730,48270,48270,48820,-1220,-670,392,"9,569.29",1940
,20130625,48270,48820,48280,49160,47970,48940,48350,120,-470,434,"10,493.08",1946
,20130626,48940,48350,49230,49270,48330,48330,48720,-20,370,148,"3,605.54",2006
,20130627,48330,48720,48710,49100,48520,49090,49010,370,290,748,"18,332.99",2622
,20130628,49090,49010,48500,48970,48350,48800,48700,-210,-310,940,"22,893.40",3058
,20130701,48800,48700,48760,49700,48730,49660,49060,960,360,366,"8,978.73",3090
,20130702,49660,49060,50020,50250,49790,50250,49960,1190,900,668,"16,688.97",3074
,20130703,50250,49960,50170,50550,49940,50550,50210,590,250,358,"8,988.14",3092
,20130704,50550,50210,50370,50390,49960,49970,50110,-240,-100,1006,"25,208.56",2766
,20130705,49970,50110,49960,49960,49290,49290,49550,-820,-560,250,"6,194.87",2784
,20130708,49290,49550,49100,49100,48460,48500,48710,-1050,-840,218,"5,310.06",2872
,20130709,48500,48710,48800,49130,48590,48890,48960,180,250,438,"10,723.68",2980
,20130710,48890,48960,48700,48700,47930,48530,48250,-430,-710,498,"12,015.33",3224
,20130711,48530,48250,49640,50660,49640,50540,50210,2290,1960,1020,"25,609.29",3504
,20130712,50540,50210,50670,50670,49690,49690,50100,-520,-110,374,"9,370.21",3618
,20130715,49690,50100,49690,50130,49540,49810,49780,-290,-320,420,"10,455.27",3612
,20130716,49810,49780,49950,51140,49660,50010,49810,230,30,108,"2,690.27",3640
,20130717,50010,49810,50080,50600,49800,49880,50090,70,280,326,"8,165.83",3642
,20130718,49880,50090,49440,49620,49340,49620,49420,-470,-670,128,"3,163.51",3674
,20130719,49620,49420,49920,50120,49420,49420,49780,0,360,190,"4,729.36",3696
,20130722,49420,49780,50110,50260,49830,50180,50030,400,250,310,"7,755.57",3714
,20130723,50180,50030,50280,50590,50160,50160,50340,130,310,248,"6,243.34",3724
,20130724,50160,50340,50460,50500,50100,50460,50320,120,-20,246,"6,189.62",3760
,20130725,50460,50320,50250,50420,50180,50370,50340,50,20,234,"5,889.95",3842
,20130726,50370,50340,50460,50460,49840,50000,50180,-340,-160,172,"4,316.07",3842
,20130729,50000,50180,48820,49180,48820,48950,49000,-1230,-1180,680,"16,661.37",4002
,20130730,48950,49000,49100,49180,48860,48890,49060,-110,60,230,"5,642.24",4046
,20130731,48890,49060,48330,49060,48330,49060,48710,0,-350,460,"11,205.16",4136
,20130801,49060,48710,49100,49990,49100,49820,49610,1110,900,768,"19,050.43",3732
,20130802,49820,49610,50010,50050,49590,49810,49840,200,230,308,"7,676.69",3704
,20130805,49810,49840,49730,50010,49730,49950,49950,110,110,160,"3,996.53",3742
,20130806,49950,49950,49900,50000,49740,50000,49910,50,-40,92,"2,296.29",3754
,20130807,50000,49910,49750,49850,49630,49770,49750,-140,-160,186,"4,627.05",3780
,20130808,49770,49750,50280,51370,50270,51320,50940,1570,1190,408,"10,391.94",3720
,20130809,51320,50940,51460,51700,51250,51420,51430,480,490,336,"8,640.84",3714
,20130812,51420,51430,51800,52170,51740,52170,51900,740,470,274,"7,111.16",3722
,20130813,52170,51900,52920,52920,51900,52140,52180,240,280,150,"3,914.01",3716
,20130814,52140,52180,51960,52440,51870,52100,52190,-80,10,152,"3,967.16",3762
,20130815,52100,52190,52310,52420,52080,52090,52210,-100,20,230,"6,005.27",3786
,20130816,52090,52210,52410,53250,52340,53250,52790,1040,580,400,"10,558.76",3778
,20130819,53250,52790,53150,53150,52780,52850,52960,60,170,116,"3,071.77",3774
,20130820,52850,52960,52740,52740,52110,52540,52280,-420,-680,256,"6,692.64",3784
,20130821,52540,52280,52340,52490,52340,52490,52400,210,120,74,"1,938.88",3778
,20130822,52490,52400,52190,52810,52080,52790,52650,390,250,358,"9,424.80",3768
,20130823,52790,52650,52810,52810,52490,52730,52620,80,-30,490,"12,891.92",3782
,20130826,52730,52620,53330,53400,53170,53340,53270,720,650,298,"7,938.50",3802
,20130827,53340,53270,53060,53110,52770,52840,52850,-430,-420,400,"10,571.70",3780
,20130828,52840,52850,52820,53000,52410,52460,52620,-390,-230,382,"10,051.12",3864
,20130829,52460,52620,52400,52540,52040,52430,52270,-190,-350,344,"8,991.77",3946
,20130830,52430,52270,51810,52010,51810,51950,51880,-320,-390,364,"9,443.43",4016
,20130902,51950,51880,52320,52800,52230,52630,52510,750,630,206,"5,409.55",4012
,20130903,52630,52510,52590,52780,52290,52300,52430,-210,-80,292,"7,655.96",4016
,20130904,52300,52430,52360,52370,52060,52080,52220,-350,-210,434,"11,332.36",4196
,20130905,52080,52220,51900,52010,51550,51690,51720,-530,-500,438,"11,326.93",4350
,20130906,51690,51720,51740,51920,51680,51900,51810,180,90,260,"6,735.73",4418
,20130909,51900,51810,52080,52430,52080,52360,52360,550,550,268,"7,016.58",4396
,20130910,52360,52360,52200,52210,51780,51980,51930,-380,-430,376,"9,763.20",4518
,20130911,51980,51930,52180,52180,51810,52040,51980,110,50,486,"12,631.45",4536
,20130912,52040,51980,51880,51910,51320,51320,51560,-660,-420,490,"12,632.60",4736
,20130913,51320,51560,51370,51370,50980,51270,51100,-290,-460,758,"19,370.40",5032
,20130916,51270,51100,51490,51530,51100,51140,51340,40,240,214,"5,494.17",5036
,20130917,51140,51340,51000,51450,50930,51450,51180,110,-160,264,"6,756.86",5206
,20130918,51450,51180,51370,51590,51180,51590,51290,410,110,1386,"35,550.48",5886
,20130923,51590,51290,52000,52150,51770,52130,51900,840,610,1174,"30,465.62",6462
,20130924,52130,51900,51980,52150,51800,51830,52000,-70,100,406,"10,556.74",6470
,20130925,51830,52000,51880,51920,51650,51850,51740,-150,-260,634,"16,403.05",6566
,20130926,51850,51740,51810,52320,51730,52230,51940,490,200,600,"15,584.33",6550
,20130927,52230,51940,52200,52530,52140,52320,52290,380,350,556,"14,537.47",6542
,20130930,52320,52290,52360,52770,52280,52770,52460,480,170,512,"13,430.24",6566
,20131008,52770,52460,52460,52530,52230,52440,52330,-20,-130,422,"11,043.19",6548
,20131009,52440,52330,52120,52130,51530,51550,51840,-780,-490,688,"17,836.11",6736
,20131010,51550,51840,51200,51450,51180,51330,51350,-510,-490,724,"18,589.30",7014
,20131011,51330,51350,51520,51800,51500,51560,51670,210,320,1442,"37,257.01",7506
,20131014,51560,51670,51530,52240,51310,52200,51830,530,160,906,"23,479.87",7498
,20131015,52200,51830,52190,52330,52050,52140,52160,310,330,448,"11,683.84",7632
,20131016,52140,52160,52160,52370,52000,52200,52150,40,-10,830,"21,646.00",7964
,20131017,52200,52150,52510,52590,51720,51720,52050,-430,-100,1056,"27,487.46",8240
,20131018,51720,52050,52020,52260,51980,52220,52130,170,80,1554,"40,510.77",9102
,20131021,52220,52130,52110,52360,51860,52310,52060,180,-70,766,"19,939.11",9320
,20131022,52310,52060,52250,52330,52130,52220,52200,160,140,888,"23,178.90",9712
,20131023,52220,52200,52500,52520,52080,52110,52260,-90,60,1620,"42,333.54",10330
,20131024,52110,52260,51610,51880,51530,51800,51700,-460,-560,1838,"47,519.45",11338
,20131025,51800,51700,51800,51800,51150,51170,51430,-530,-270,5036,"129,507.42",13322
,20131028,51170,51430,51470,51600,51350,51500,51500,70,70,986,"25,390.61",13582
,20131029,51500,51500,51490,51560,51080,51560,51270,60,-230,2870,"73,582.30",15006
,20131030,51560,51270,51560,52220,51530,52110,51860,840,590,2998,"77,742.39",15200
,20131031,52110,51860,51980,52000,51720,51750,51870,-110,10,2082,"54,001.83",15582
,20131101,51750,51870,51760,52320,51740,52320,52070,450,200,750,"19,526.96",15492
,20131104,52320,52070,52030,52080,51580,51760,51790,-310,-280,900,"23,309.38",15762
,20131105,51760,51790,51620,51800,51450,51630,51580,-160,-210,982,"25,326.77",15882
,20131106,51630,51580,51660,51710,51430,51610,51550,30,-30,654,"16,859.22",16104
,20131107,51610,51550,51340,51510,51230,51440,51350,-110,-200,2664,"68,400.77",16624
,20131108,51440,51350,51350,51660,51350,51420,51520,70,170,2254,"58,066.08",16878
,20131111,51420,51520,51600,51870,51510,51650,51650,130,130,1222,"31,562.17",17096
,20131112,51650,51650,51530,51580,51280,51450,51400,-200,-250,2080,"53,461.44",18064
,20131113,51450,51400,51140,51140,50510,50580,50800,-820,-600,5250,"133,350.36",20520
,20131114,50580,50800,50370,50620,50350,50400,50490,-400,-310,5270,"133,067.34",21104
,20131115,50400,50490,50490,50820,50010,50040,50540,-450,50,8372,"211,589.93",21936
,20131118,50040,50540,50300,50450,50180,50370,50330,-170,-210,3702,"93,162.62",23012
,20131119,50370,50330,50000,50000,49570,49760,49730,-570,-600,16722,"415,816.66",26932
,20131120,49760,49730,49910,50420,49900,50340,50220,610,490,7168,"180,007.39",27632
,20131121,50340,50220,50170,50300,49870,50240,50030,20,-190,7540,"188,643.48",29008
,20131122,50240,50030,50610,50670,50300,50420,50470,390,440,4674,"117,949.24",29346
,20131125,50420,50470,50920,50980,50420,50420,50660,-50,190,5118,"129,652.18",29674
,20131126,50420,50660,50710,50900,50580,50780,50740,120,80,3714,"94,234.57",29804
,20131127,50780,50740,50690,50690,50440,50600,50530,-140,-210,3484,"88,029.51",30454
,20131128,50600,50530,50360,50610,50280,50350,50430,-180,-100,5446,"137,336.05",32512
,20131129,50350,50430,50630,50670,50450,50530,50550,100,120,4796,"121,242.28",33488
,20131202,50530,50550,50610,50700,50480,50550,50550,0,0,5044,"127,492.36",34462
,20131203,50550,50550,50200,50260,49940,50080,50120,-470,-430,7744,"194,070.02",36254
,20131204,50080,50120,50100,50380,50050,50300,50230,180,110,6678,"167,735.37",36994
,20131205,50300,50230,50810,50850,50600,50650,50700,420,470,6542,"165,859.01",37082
,20131206,50650,50700,50640,50930,50500,50820,50640,120,-60,5022,"127,174.13",37594
,20131209,50820,50640,50820,50960,50690,50770,50780,130,140,5378,"136,554.74",38424
,20131210,50770,50780,50810,51100,50810,50960,50950,180,170,10468,"266,705.92",41348
,20131211,50960,50950,51100,51140,50900,51000,51030,50,80,9210,"235,015.40",43020
,20131212,51000,51030,51280,51580,51220,51550,51380,520,350,22056,"566,620.04",44204
,20131213,51550,51380,51380,51400,50990,51070,51140,-310,-240,22152,"566,482.86",53490
,20131216,51070,51140,51330,51410,51240,51370,51320,230,180,10354,"265,715.36",54106
,20131217,51370,51320,51550,51710,51340,51430,51530,110,210,21570,"555,780.16",55316
,20131218,51430,51530,51400,51420,51100,51290,51190,-240,-340,16750,"428,745.37",60342
,20131219,51290,51190,51360,51400,50910,51040,51050,-150,-140,24698,"630,451.13",66582
,20131220,51040,51050,51020,51420,50890,51390,51160,340,110,29710,"760,097.76",71144
,20131223,51390,51160,51420,51550,51160,51270,51350,110,190,30338,"778,979.43",76602
,20131224,51270,51350,51350,51490,51220,51440,51380,90,30,26460,"679,812.98",80412
,20131225,51440,51380,51560,52670,51470,52350,52080,970,700,63288,"1,648,253.47",86968
,20131226,52350,52080,52360,52800,52110,52250,52410,170,330,55646,"1,458,396.60",94914
,20131227,52250,52410,52310,52450,52180,52440,52300,30,-110,40496,"1,059,133.14",101220
,20131230,52440,52300,52380,52610,52160,52360,52330,60,30,48528,"1,269,747.11",107264
,20131231,52360,52330,52250,52490,52040,52310,52310,-20,-20,65242,"1,706,704.78",113604
cu1405,20130516,52270,52270,,,,52270,52270,0,0,0,0,0
,20130517,52270,52270,52650,52650,52650,52650,52650,380,380,2,52.65,2
,20130520,52650,52650,52430,52850,52430,52580,52600,-70,-50,8,210.43,2
,20130521,52580,52600,,,,52600,52600,0,0,0,0,2
,20130522,52600,52600,53180,53700,53180,53680,53520,1080,920,6,160.56,6
,20130523,53680,53520,52880,52890,52290,52390,52540,-1130,-980,60,"1,576.29",52
,20130524,52390,52540,52620,53000,52460,52830,52830,290,290,68,"1,796.33",92
,20130527,52830,52830,52540,52560,52390,52560,52500,-270,-330,28,735.11,100
,20130528,52560,52500,52720,52720,52020,52510,52260,10,-240,262,"6,846.41",248
,20130529,52510,52260,52750,52900,52300,52300,52750,40,490,138,"3,639.89",330
,20130530,52300,52750,52340,52400,51800,52200,52270,-550,-480,64,"1,672.91",340
,20130531,52200,52270,52850,52850,52460,52680,52610,410,340,18,473.54,348
,20130603,52680,52610,53000,53140,52870,52880,52930,270,320,42,"1,111.54",372
,20130604,52880,52930,52880,53060,52880,52950,52970,20,40,26,688.72,380
,20130605,52950,52970,53350,53640,53290,53640,53420,670,450,38,"1,015.02",378
,20130606,53640,53420,53320,53320,52890,53070,53100,-350,-320,26,690.31,380
,20130607,53070,53100,52340,53200,52340,53200,52960,100,-140,38,"1,006.39",378
,20130613,53200,52960,51850,52040,51560,51560,51860,-1400,-1100,68,"1,763.26",398
,20130614,51560,51860,51640,51640,51440,51550,51550,-310,-310,24,618.61,414
,20130617,51550,51550,51880,51890,51660,51760,51760,210,210,62,"1,604.66",434
,20130618,51760,51760,51650,51670,51060,51090,51280,-670,-480,82,"2,102.52",446
,20130619,51090,51280,50950,50950,50600,50840,50790,-440,-490,34,863.58,456
,20130620,50840,50790,50320,50420,49850,49900,50090,-890,-700,704,"17,633.04",926
,20130621,49900,50090,49040,49930,48700,49930,49590,-160,-500,410,"10,167.00",1054
,20130624,49930,49590,49710,49710,48300,48300,49020,-1290,-570,234,"5,735.74",1084
,20130625,48300,49020,48570,49240,48060,49150,48450,130,-570,196,"4,748.62",1110
,20130626,49150,48450,49500,49500,48420,48460,48790,10,340,242,"5,904.04",1174
,20130627,48460,48790,48600,49290,48600,49200,48980,410,190,278,"6,809.31",1278
,20130628,49200,48980,48410,49150,48400,48920,48820,-60,-160,352,"8,594.06",1282
,20130701,48920,48820,48890,49810,48880,49810,49350,990,530,288,"7,107.00",1282
,20130702,49810,49350,50000,50410,49910,50350,50130,1000,780,272,"6,818.84",1278
,20130703,50350,50130,50180,50630,50060,50590,50220,460,90,418,"10,496.76",1302
,20130704,50590,50220,50650,50650,50070,50070,50270,-150,50,180,"4,524.90",1318
,20130705,50070,50270,50180,50180,49350,49360,49570,-910,-700,244,"6,048.73",1346
,20130708,49360,49570,49100,49200,48470,48540,48750,-1030,-820,214,"5,216.35",1350
,20130709,48540,48750,48870,49220,48670,48850,49000,100,250,582,"14,259.47",1648
,20130710,48850,49000,48660,48660,47960,48550,48300,-450,-700,516,"12,461.93",1784
,20130711,48550,48300,50000,50710,49800,50680,50240,2380,1940,578,"14,520.65",1942
,20130712,50680,50240,50590,50630,49720,49730,50300,-510,60,402,"10,112.01",2020
,20130715,49730,50300,50110,50150,49700,49850,49910,-450,-390,184,"4,591.93",1994
,20130716,49850,49910,49770,50140,49720,50020,49900,110,-10,66,"1,647.02",1998
,20130717,50020,49900,50150,50640,49830,49870,50250,-30,350,210,"5,276.67",2022
,20130718,49870,50250,49500,49670,49380,49600,49490,-650,-760,162,"4,009.17",2040
,20130719,49600,49490,50000,50160,49480,49510,49890,20,400,142,"3,542.42",2048
,20130722,49510,49890,50050,50260,49910,50090,50090,200,200,100,"2,504.91",2042
,20130723,50090,50090,50360,50560,50180,50210,50360,120,270,74,"1,863.57",2046
,20130724,50210,50360,50550,50550,50170,50500,50270,140,-90,92,"2,312.82",2016
,20130725,50500,50270,50320,50480,50230,50410,50350,140,80,66,"1,661.56",2026
,20130726,50410,50350,50580,50580,49870,50010,50170,-340,-180,120,"3,010.37",2032
,20130729,50010,50170,49130,49210,48900,49070,49080,-1100,-1090,518,"12,712.37",2248
,20130730,49070,49080,49180,49220,48790,48790,49100,-290,20,148,"3,633.79",2308
,20130731,48790,49100,48630,49080,48520,49080,48770,-20,-330,246,"5,999.87",2338
,20130801,49080,48770,49530,50000,49470,49830,49710,1060,940,226,"5,617.45",2356
,20130802,49830,49710,50100,50100,49620,49870,49890,160,180,156,"3,892.00",2334
,20130805,49870,49890,49850,50110,49800,50090,50030,200,140,250,"6,254.86",2456
,20130806,50090,50030,49980,50060,49800,50050,49960,20,-70,204,"5,096.71",2474
,20130807,50050,49960,49800,49900,49680,49850,49770,-110,-190,134,"3,335.20",2506
,20130808,49850,49770,50060,51450,50060,51360,51020,1590,1250,580,"14,796.46",2700
,20130809,51360,51020,51430,51770,51250,51450,51490,430,470,236,"6,076.48",2650
,20130812,51450,51490,51810,52500,51800,52500,51920,1010,430,864,"22,432.12",3170
,20130813,52500,51920,52210,52250,51970,52230,52140,310,220,168,"4,380.12",3198
,20130814,52230,52140,52040,52550,51970,52210,52190,70,50,140,"3,653.91",3202
,20130815,52210,52190,52440,52540,52140,52150,52330,-40,140,258,"6,751.79",3172
,20130816,52150,52330,52470,53300,52390,53160,52840,830,510,320,"8,454.82",3168
,20130819,53160,52840,53100,53200,52850,52910,53050,70,210,162,"4,297.13",3206
,20130820,52910,53050,52730,52750,52230,52230,52380,-820,-670,194,"5,080.88",3216
,20130821,52230,52380,52390,52550,52370,52480,52450,100,70,98,"2,570.40",3204
,20130822,52480,52450,52180,52880,52160,52820,52580,370,130,124,"3,260.06",3218
,20130823,52820,52580,52820,52890,52530,52770,52750,190,170,252,"6,646.82",3242
,20130826,52770,52750,53950,53950,53210,53370,53330,620,580,232,"6,186.28",3262
,20130827,53370,53330,53170,53180,52810,52930,52910,-400,-420,962,"25,450.46",3294
,20130828,52930,52910,52810,53040,52440,52500,52760,-410,-150,162,"4,274.35",3312
,20130829,52500,52760,52490,52590,52130,52420,52380,-340,-380,222,"5,814.66",3384
,20130830,52420,52380,51950,52050,51910,51930,51950,-450,-430,342,"8,884.81",3474
,20130902,51930,51950,52360,52830,52280,52650,52510,700,560,170,"4,463.60",3484
,20130903,52650,52510,52750,52850,52360,52460,52500,-50,-10,152,"3,990.03",3494
,20130904,52460,52500,52360,52360,52080,52080,52200,-420,-300,168,"4,384.95",3494
,20130905,52080,52200,51730,51990,51610,51730,51770,-470,-430,528,"13,668.41",3726
,20130906,51730,51770,51990,51990,51730,51950,51880,180,110,134,"3,476.09",3714
,20130909,51950,51880,52300,52460,52220,52410,52380,530,500,170,"4,452.45",3746
,20130910,52410,52380,52280,52280,51820,52000,52020,-380,-360,342,"8,895.95",3764
,20130911,52000,52020,52030,52240,51890,52010,52070,-10,50,236,"6,145.16",3768
,20130912,52010,52070,51700,51750,51450,51460,51660,-610,-410,268,"6,922.86",3828
,20130913,51460,51660,51240,51360,51010,51300,51130,-360,-530,364,"9,306.08",3754
,20130916,51300,51130,51500,51610,51120,51160,51300,30,170,326,"8,363.10",3750
,20130917,51160,51300,51000,51500,50900,51500,51200,200,-100,492,"12,597.22",3806
,20130918,51500,51200,51280,51750,51220,51750,51340,550,140,366,"9,396.77",4032
,20130923,51750,51340,51940,52180,51870,52180,51960,840,620,586,"15,226.56",4306
,20130924,52180,51960,52070,52200,51860,51900,52050,-60,90,314,"8,172.14",4316
,20130925,51900,52050,51880,52000,51710,51840,51830,-210,-220,330,"8,552.42",4318
,20130926,51840,51830,51800,52350,51800,52280,52050,450,220,436,"11,348.75",4322
,20130927,52280,52050,52250,52580,52190,52380,52360,330,310,742,"19,426.90",4286
,20130930,52380,52360,52240,52860,52240,52860,52510,500,150,212,"5,566.23",4252
,20131008,52860,52510,52510,52560,52310,52480,52370,-30,-140,158,"4,137.34",4246
,20131009,52480,52370,52260,52260,51570,51600,51850,-770,-520,464,"12,030.59",4294
,20131010,51600,51850,51280,51470,51280,51390,51370,-460,-480,404,"10,377.62",4414
,20131011,51390,51370,51600,51850,51530,51620,51690,250,320,312,"8,063.88",4520
,20131014,51620,51690,51640,52280,51400,52280,51730,590,40,578,"14,952.54",4676
,20131015,52280,51730,52240,52310,52050,52160,52160,430,430,148,"3,860.17",4692
,20131016,52160,52160,52240,52400,52010,52140,52170,-20,10,254,"6,626.38",4724
,20131017,52140,52170,52500,52630,51770,51810,52090,-360,-80,224,"5,834.85",4772
,20131018,51810,52090,52070,52300,52000,52300,52160,210,70,182,"4,746.66",4790
,20131021,52300,52160,52100,52380,51890,52380,52060,220,-100,382,"9,943.95",4816
,20131022,52380,52060,52230,52340,52150,52190,52220,130,160,152,"3,969.47",4818
,20131023,52190,52220,52500,52520,52090,52170,52310,-50,90,406,"10,619.36",4808
,20131024,52170,52310,51750,51920,51580,51860,51740,-450,-570,654,"16,919.88",5118
,20131025,51860,51740,51780,51820,51180,51190,51470,-550,-270,504,"12,971.43",5182
,20131028,51190,51470,51430,51650,51430,51570,51530,100,60,378,"9,740.01",5220
,20131029,51570,51530,51470,51580,51150,51580,51320,50,-210,1478,"37,928.43",6038
,20131030,51580,51320,51660,52250,51580,52170,52020,850,700,1642,"42,714.68",6718
,20131031,52170,52020,52010,52060,51770,51880,51930,-140,-90,2570,"66,732.40",7884
,20131101,51880,51930,51810,52350,51810,52340,52030,410,100,1278,"33,250.13",7982
,20131104,52340,52030,52110,52160,51630,51800,51810,-230,-220,2030,"52,590.71",8054
,20131105,51800,51810,51490,51850,51490,51690,51640,-120,-170,1816,"46,890.10",8506
,20131106,51690,51640,51680,51770,51450,51620,51560,-20,-80,2150,"55,429.44",8574
,20131107,51620,51560,51250,51540,51250,51510,51400,-50,-160,2088,"53,662.05",8690
,20131108,51510,51400,51500,51690,51330,51470,51500,70,100,1314,"33,840.66",8620
,20131111,51470,51500,51580,51850,51530,51620,51660,120,160,934,"24,127.64",8682
,20131112,51620,51660,51620,51620,51340,51460,51450,-200,-210,858,"22,072.06",8726
,20131113,51460,51450,51100,51100,50530,50610,50790,-840,-660,2982,"75,734.69",9380
,20131114,50610,50790,50280,50650,50280,50450,50510,-340,-280,1534,"38,743.59",9640
,20131115,50450,50510,50450,50860,50070,50070,50530,-440,20,3292,"83,173.11",9952
,20131118,50070,50530,50310,50500,50230,50400,50360,-130,-170,2464,"62,046.87",10426
,20131119,50400,50360,50050,50070,49630,49820,49830,-540,-530,5042,"125,638.74",11998
,20131120,49820,49830,49970,50480,49970,50420,50250,590,420,2878,"72,313.57",12032
,20131121,50420,50250,50120,50320,49910,50260,50080,10,-170,4226,"105,832.20",11798
,20131122,50260,50080,50430,50680,50350,50430,50500,350,420,2634,"66,513.25",12004
,20131125,50430,50500,50870,50950,50450,50460,50670,-40,170,4004,"101,446.99",13012
,20131126,50460,50670,50750,50910,50600,50780,50740,110,70,3580,"90,833.73",13434
,20131127,50780,50740,50670,50670,50460,50600,50560,-140,-180,3060,"77,369.85",13820
,20131128,50600,50560,50440,50600,50290,50380,50450,-180,-110,2790,"70,379.73",14302
,20131129,50380,50450,50570,50680,50470,50540,50550,90,100,2428,"61,375.79",14370
,20131202,50540,50550,50630,50700,50470,50550,50540,0,-10,2912,"73,600.55",14694
,20131203,50550,50540,50180,50250,49930,50080,50110,-460,-430,6262,"156,914.22",16030
,20131204,50080,50110,50080,50370,50010,50270,50230,160,120,3286,"82,528.04",16846
,20131205,50270,50230,50800,50850,50600,50630,50690,400,460,2768,"70,163.92",17158
,20131206,50630,50690,50630,50860,50500,50840,50590,150,-100,4520,"114,343.30",18056
,20131209,50840,50590,50840,50980,50680,50770,50800,180,210,4836,"122,850.43",19504
,20131210,50770,50800,50920,51090,50860,50980,50950,180,150,3794,"96,664.44",20182
,20131211,50980,50950,51020,51130,50870,51000,51000,50,50,3524,"89,878.50",19834
,20131212,51000,51000,51300,51560,51200,51540,51360,540,360,4264,"109,513.30",20394
,20131213,51540,51360,51360,51380,50990,51060,51140,-300,-220,5338,"136,507.05",21450
,20131216,51060,51140,51450,51500,51200,51320,51300,180,160,2992,"76,759.05",21872
,20131217,51320,51300,51470,51680,51360,51400,51480,100,180,5904,"151,986.55",22676
,20131218,51400,51480,51350,51390,51100,51280,51190,-200,-290,6858,"175,539.16",23356
,20131219,51280,51190,51280,51400,50900,51010,51000,-180,-190,5060,"129,053.07",24052
,20131220,51010,51000,51010,51400,50870,51340,51120,340,120,7532,"192,550.85",25322
,20131223,51340,51120,51340,51520,51100,51220,51320,100,200,6374,"163,576.54",25862
,20131224,51220,51320,51320,51480,51200,51450,51370,130,50,5090,"130,751.71",26528
,20131225,51450,51370,51500,52660,51450,52350,52070,980,700,15302,"398,429.32",27540
,20131226,52350,52070,52200,52860,52140,52250,52530,180,460,18462,"484,960.34",27670
,20131227,52250,52530,52280,52460,52200,52450,52310,-80,-220,9434,"246,784.45",28172
,20131230,52450,52310,52430,52620,52170,52350,52340,40,30,7352,"192,433.98",29188
,20131231,52350,52340,52270,52470,52080,52300,52300,-40,-40,13760,"359,892.14",32570
cu1406,20130618,51760,51760,51170,51170,51170,51170,51170,-590,-590,10,255.85,10
,20130619,51170,51170,51000,51000,50790,50980,50960,-190,-210,14,356.72,4
,20130620,50980,50960,50590,50590,49880,49900,50070,-1060,-890,48,"1,201.76",30
,20130621,49900,50070,49280,50000,48800,49850,49730,-220,-340,322,"8,007.58",206
,20130624,49850,49730,49560,49560,48460,48490,49250,-1240,-480,516,"12,708.20",570
,20130625,48490,49250,48530,49350,48090,49350,48540,100,-710,334,"8,107.10",608
,20130626,49350,48540,49700,49700,48550,48730,49090,190,550,168,"4,123.89",674
,20130627,48730,49090,48790,49490,48740,49360,49160,270,70,300,"7,374.58",792
,20130628,49360,49160,48600,49300,48530,49020,49000,-140,-160,196,"4,802.66",822
,20130701,49020,49000,49090,49910,49050,49910,49410,910,410,160,"3,953.48",832
,20130702,49910,49410,50150,50520,49980,50520,50270,1110,860,102,"2,564.20",832
,20130703,50520,50270,50330,50750,50200,50730,50440,460,170,136,"3,430.38",838
,20130704,50730,50440,50750,50750,50220,50290,50400,-150,-40,182,"4,586.98",866
,20130705,50290,50400,50160,50160,49520,49520,49720,-880,-680,150,"3,729.62",890
,20130708,49520,49720,49150,49150,48630,48640,48840,-1080,-880,142,"3,467.69",882
,20130709,48640,48840,48890,49300,48710,49060,49050,220,210,150,"3,678.93",890
,20130710,49060,49050,48530,48710,48030,48620,48360,-430,-690,308,"7,448.43",918
,20130711,48620,48360,49550,50770,49550,50680,50460,2320,2100,424,"10,699.45",994
,20130712,50680,50460,50500,50500,49680,49680,50280,-780,-180,150,"3,771.10",1010
,20130715,49680,50280,49840,50280,49760,49900,49980,-380,-300,180,"4,498.72",1022
,20130716,49900,49980,50010,50190,49800,50190,49980,210,0,66,"1,649.56",1050
,20130717,50190,49980,50120,50720,49870,49870,50290,-110,310,134,"3,369.56",1062
,20130718,49870,50290,49780,49780,49410,49650,49560,-640,-730,84,"2,081.79",1076
,20130719,49650,49560,50090,50220,49540,49580,49940,20,380,60,"1,498.38",1074
,20130722,49580,49940,50110,50300,49910,50280,50150,340,210,114,"2,859.10",1088
,20130723,50280,50150,50460,50620,50210,50230,50380,80,230,192,"4,837.23",1146
,20130724,50230,50380,50560,50600,50180,50480,50420,100,40,90,"2,269.32",1130
,20130725,50480,50420,50310,50500,50230,50390,50390,-30,-30,84,"2,116.49",1138
,20130726,50390,50390,50560,50560,49910,49990,50210,-400,-180,52,"1,305.57",1132
,20130729,49990,50210,49210,49290,48960,49120,49130,-1090,-1080,276,"6,781.19",1202
,20130730,49120,49130,49140,49260,49000,49000,49160,-130,30,150,"3,687.10",1258
,20130731,49000,49160,48700,49150,48690,49150,48880,-10,-280,134,"3,275.28",1308
,20130801,49150,48880,49610,50040,49520,49760,49760,880,880,102,"2,538.18",1310
,20130802,49760,49760,50210,50210,49700,49940,49980,180,220,160,"3,998.92",1324
,20130805,49940,49980,49920,50160,49920,50120,50100,140,120,294,"7,364.95",1560
,20130806,50120,50100,50010,50100,49830,50100,49980,0,-120,46,"1,149.75",1570
,20130807,50100,49980,49850,50000,49760,49930,49870,-50,-110,92,"2,294.35",1558
,20130808,49930,49870,50430,51500,50430,51470,51080,1600,1210,458,"11,699.49",1744
,20130809,51470,51080,51560,51800,51340,51510,51540,430,460,82,"2,113.48",1736
,20130812,51510,51540,51950,52500,51850,52500,51990,960,450,488,"12,686.49",2032
,20130813,52500,51990,52240,52330,52020,52220,52160,230,170,78,"2,034.42",2032
,20130814,52220,52160,52030,52610,52000,52320,52290,160,130,116,"3,032.84",2032
,20130815,52320,52290,52540,52640,52220,52220,52370,-70,80,66,"1,728.21",2032
,20130816,52220,52370,52540,53300,52500,53220,52990,850,620,586,"15,528.43",2034
,20130819,53220,52990,53320,53320,52950,52970,53090,-20,100,124,"3,292.02",2038
,20130820,52970,53090,52690,52730,52260,52260,52440,-830,-650,104,"2,727.31",2034
,20130821,52260,52440,52520,52590,52460,52590,52490,150,50,36,944.96,2044
,20130822,52590,52490,52260,52930,52260,52910,52730,420,240,56,"1,476.48",2044
,20130823,52910,52730,52880,52950,52600,52850,52770,120,40,98,"2,586.06",2040
,20130826,52850,52770,53460,53530,53280,53420,53430,650,660,74,"1,976.96",2046
,20130827,53420,53430,53200,53200,52880,53000,52960,-430,-470,244,"6,462.22",2062
,20130828,53000,52960,52840,53100,52480,52480,52780,-480,-180,104,"2,744.60",2062
,20130829,52480,52780,52060,52620,52060,52420,52400,-360,-380,100,"2,620.34",2066
,20130830,52420,52400,52050,52110,51990,51990,52030,-410,-370,166,"4,318.82",2096
,20130902,51990,52030,52390,52860,52300,52680,52600,650,570,142,"3,734.69",2146
,20130903,52680,52600,52560,52560,52430,52500,52470,-100,-130,24,629.74,2142
,20130904,52500,52470,52470,52480,52150,52150,52310,-320,-160,56,"1,464.91",2122
,20130905,52150,52310,52080,52080,51700,51770,51810,-540,-500,256,"6,631.96",2224
,20130906,51770,51810,51920,51970,51890,51890,51920,80,110,24,623.1,2222
,20130909,51890,51920,52220,52500,52220,52430,52410,510,490,96,"2,515.72",2220
,20130910,52430,52410,52270,52310,51950,52000,52090,-410,-320,130,"3,386.21",2238
,20130911,52000,52090,52270,52270,51950,52100,52100,10,10,110,"2,865.64",2242
,20130912,52100,52100,51730,51760,51500,51510,51630,-590,-470,192,"4,956.93",2364
,20130913,51510,51630,51470,51470,51090,51190,51170,-440,-460,134,"3,428.87",2414
,20130916,51190,51170,51530,51590,51180,51180,51360,10,190,104,"2,671.07",2398
,20130917,51180,51360,51120,51350,51000,51300,51250,-60,-110,104,"2,665.06",2422
,20130918,51300,51250,51300,51700,51250,51690,51370,440,120,164,"4,213.02",2508
,20130923,51690,51370,51950,52140,51900,52000,51980,630,610,266,"6,914.41",2638
,20130924,52000,51980,52060,52270,51920,51920,52040,-60,60,122,"3,174.60",2638
,20130925,51920,52040,52000,52020,51800,51930,51870,-110,-170,150,"3,890.60",2648
,20130926,51930,51870,51960,52420,51880,52420,52130,550,260,206,"5,369.47",2706
,20130927,52420,52130,52360,52640,52240,52400,52430,270,300,300,"7,865.18",2700
,20130930,52400,52430,52550,52690,52340,52680,52550,250,120,138,"3,626.63",2712
,20131008,52680,52550,52540,52590,52340,52570,52430,20,-120,332,"8,703.62",2730
,20131009,52570,52430,52200,52310,51590,51600,51850,-830,-580,354,"9,178.56",2812
,20131010,51600,51850,51330,51520,51300,51460,51400,-390,-450,512,"13,159.51",3070
,20131011,51460,51400,51580,51900,51580,51620,51680,220,280,124,"3,204.28",3082
,20131014,51620,51680,51650,52140,51410,52130,51680,450,0,1338,"34,577.52",2556
,20131015,52130,51680,52230,52300,52110,52150,52200,470,520,138,"3,602.31",2572
,20131016,52150,52200,52220,52420,52100,52220,52230,20,30,72,"1,880.50",2578
,20131017,52220,52230,52620,52620,51810,51890,52090,-340,-140,120,"3,125.60",2572
,20131018,51890,52090,52060,52300,52060,52300,52190,210,100,108,"2,818.67",2602
,20131021,52300,52190,52060,52390,51930,52300,52210,110,20,180,"4,699.68",2654
,20131022,52300,52210,52350,52350,52190,52300,52250,90,40,52,"1,358.60",2664
,20131023,52300,52250,52550,52550,52140,52160,52310,-90,60,222,"5,806.66",2608
,20131024,52160,52310,51940,51940,51640,51840,51770,-470,-540,306,"7,922.31",2686
,20131025,51840,51770,51780,51800,51270,51280,51570,-490,-200,124,"3,197.34",2692
,20131028,51280,51570,51460,51650,51460,51610,51570,40,0,100,"2,578.61",2684
,20131029,51610,51570,51410,51600,51160,51600,51330,30,-240,636,"16,324.62",2804
,20131030,51600,51330,51730,52250,51550,52180,52020,850,690,214,"5,566.17",2848
,20131031,52180,52020,52010,52050,51790,51800,51970,-220,-50,362,"9,406.98",2808
,20131101,51800,51970,51820,52370,51820,52330,52050,360,80,204,"5,310.11",2850
,20131104,52330,52050,52000,52120,51680,51750,51840,-300,-210,208,"5,391.70",2824
,20131105,51750,51840,51700,51830,51510,51710,51640,-130,-200,60,"1,549.22",2834
,20131106,51710,51640,51710,51760,51520,51670,51610,30,-30,74,"1,909.89",2840
,20131107,51670,51610,51400,51550,51390,51550,51440,-60,-170,122,"3,138.15",2840
,20131108,51550,51440,51430,51670,51430,51480,51550,40,110,128,"3,299.35",2810
,20131111,51480,51550,51680,51760,51670,51700,51710,150,160,144,"3,723.60",2778
,20131112,51700,51710,51480,51520,51370,51520,51450,-190,-260,152,"3,910.40",2806
,20131113,51520,51450,51030,51030,50540,50590,50850,-860,-600,494,"12,561.09",2882
,20131114,50590,50850,50530,50650,50430,50540,50540,-310,-310,280,"7,075.94",2932
,20131115,50540,50540,50740,50830,50130,50130,50560,-410,20,582,"14,714.12",3092
,20131118,50130,50560,50350,50530,50250,50430,50390,-130,-170,208,"5,240.57",3162
,20131119,50430,50390,50080,50080,49700,49920,49830,-470,-560,440,"10,964.57",3282
,20131120,49920,49830,50130,50450,50050,50390,50220,560,390,224,"5,625.02",3328
,20131121,50390,50220,50200,50340,49960,50300,50150,80,-70,706,"17,704.31",3592
,20131122,50300,50150,50700,50700,50370,50460,50520,310,370,344,"8,690.69",3626
,20131125,50460,50520,50890,50890,50480,50480,50630,-40,110,200,"5,063.41",3626
,20131126,50480,50630,50720,50900,50610,50800,50720,170,90,2012,"51,029.35",4448
,20131127,50800,50720,50600,50690,50450,50610,50550,-110,-170,436,"11,020.80",4444
,20131128,50610,50550,50340,50610,50320,50380,50460,-170,-90,742,"18,720.81",4482
,20131129,50380,50460,50510,50640,50470,50520,50550,60,90,716,"18,100.38",4708
,20131202,50520,50550,50530,50710,50470,50610,50570,60,20,236,"5,967.34",4702
,20131203,50610,50570,50100,50260,49950,50050,50100,-520,-470,1004,"25,154.18",5046
,20131204,50050,50100,50110,50380,50110,50270,50220,170,120,696,"17,479.32",5332
,20131205,50270,50220,50920,50920,50590,50610,50700,390,480,700,"17,745.02",5372
,20131206,50610,50700,50630,50840,50510,50840,50620,140,-80,516,"13,061.49",5374
,20131209,50840,50620,50830,50950,50680,50760,50780,140,160,752,"19,093.94",5488
,20131210,50760,50780,50900,51100,50850,50970,50950,190,170,992,"25,273.49",5562
,20131211,50970,50950,51050,51100,50900,50980,51000,30,50,814,"20,760.11",5626
,20131212,50980,51000,51270,51550,51200,51540,51380,540,380,1150,"29,548.37",5572
,20131213,51540,51380,51450,51450,50990,51090,51180,-290,-200,1340,"34,295.42",5698
,20131216,51090,51180,51090,51410,50850,51330,51310,150,130,1078,"27,659.93",6046
,20131217,51330,51310,51500,51710,51380,51450,51510,140,200,1046,"26,944.07",6258
,20131218,51450,51510,51390,51410,51100,51250,51200,-260,-310,760,"19,459.33",6302
,20131219,51250,51200,51380,51380,50920,51000,51020,-200,-180,1238,"31,585.63",6272
,20131220,51000,51020,51000,51380,50860,51320,51120,300,100,1316,"33,642.03",6652
,20131223,51320,51120,51310,51510,51150,51220,51340,100,220,1492,"38,306.31",6848
,20131224,51220,51340,51420,51650,51200,51460,51340,120,0,900,"23,105.41",6740
,20131225,51460,51340,51250,52660,51250,52320,52080,980,740,3030,"78,901.50",7180
,20131226,52320,52080,52430,52820,52180,52260,52460,180,380,2666,"69,939.40",7104
,20131227,52260,52460,52300,52470,52190,52450,52330,-10,-130,1820,"47,627.68",7500
,20131230,52450,52330,52410,52610,52180,52360,52310,30,-20,2008,"52,520.57",8030
,20131231,52360,52310,52300,52480,52090,52300,52330,-10,20,1590,"41,602.98",8392
cu1407,20130716,49980,49980,49900,50160,49900,50160,50000,180,20,12,300.04,8
,20130717,50160,50000,,,,50000,50000,0,0,0,0,8
,20130718,50000,50000,49600,49600,49600,49600,49600,-400,-400,2,49.6,6
,20130719,49600,49600,,,,49600,49600,0,0,0,0,6
,20130722,49600,49600,,,,49600,49600,0,0,0,0,6
,20130723,49600,49600,50360,50360,50360,50360,50360,760,760,4,100.72,10
,20130724,50360,50360,50510,50660,50250,50540,50440,180,80,26,655.75,16
,20130725,50540,50440,50290,50580,50290,50580,50420,140,-20,50,"1,260.69",30
,20130726,50580,50420,50320,50320,49940,50040,50050,-380,-370,28,700.7,46
,20130729,50040,50050,49210,49350,49010,49210,49200,-840,-850,148,"3,641.20",116
,20130730,49210,49200,49180,49330,49000,49000,49190,-200,-10,64,"1,574.20",132
,20130731,49000,49190,48800,49220,48780,49220,48950,30,-240,74,"1,811.33",144
,20130801,49220,48950,49650,50200,49630,50200,49780,1250,830,54,"1,344.21",150
,20130802,50200,49780,50300,50300,49710,50000,49930,220,150,74,"1,847.49",154
,20130805,50000,49930,49920,50180,49900,50030,50050,100,120,58,"1,451.45",170
,20130806,50030,50050,50070,50160,49940,50160,50010,110,-40,60,"1,500.49",194
,20130807,50160,50010,49980,50040,49880,49960,49950,-50,-60,56,"1,398.68",204
,20130808,49960,49950,50560,51550,50560,51420,51090,1470,1140,112,"2,861.54",228
,20130809,51420,51090,51580,51810,51420,51540,51560,450,470,84,"2,165.87",262
,20130812,51540,51560,51910,52510,51860,52510,52100,950,540,92,"2,396.72",302
,20130813,52510,52100,52270,52370,52120,52330,52230,230,130,132,"3,447.34",366
,20130814,52330,52230,52140,52520,52080,52340,52320,110,90,118,"3,087.13",400
,20130815,52340,52320,52550,52680,52230,52240,52480,-80,160,106,"2,781.44",448
,20130816,52240,52480,52620,53350,52600,53350,52990,870,510,204,"5,405.93",504
,20130819,53350,52990,53340,53340,52930,52990,53130,0,140,260,"6,907.15",588
,20130820,52990,53130,52740,52770,52320,52320,52440,-810,-690,84,"2,202.82",610
,20130821,52320,52440,52590,52610,52500,52570,52540,130,100,32,840.73,606
,20130822,52570,52540,52300,52930,52280,52930,52720,390,180,24,632.74,610
,20130823,52930,52720,53010,53010,52670,52900,52830,180,110,36,951.08,602
,20130826,52900,52830,53520,53520,53350,53510,53400,680,570,110,"2,937.05",642
,20130827,53510,53400,53200,53230,52940,52980,53020,-420,-380,78,"2,067.78",654
,20130828,52980,53020,53020,53020,52580,52580,52730,-440,-290,14,369.15,658
,20130829,52580,52730,52580,52590,52200,52530,52460,-200,-270,58,"1,521.62",644
,20130830,52530,52460,52100,52180,51960,52030,52050,-430,-410,98,"2,550.63",616
,20130902,52030,52050,52410,52970,52410,52850,52640,800,590,52,"1,368.85",606
,20130903,52850,52640,52850,52850,52490,52540,52570,-100,-70,36,946.31,614
,20130904,52540,52570,52470,52470,52220,52220,52300,-350,-270,62,"1,621.36",634
,20130905,52220,52300,52130,52130,51730,51730,51950,-570,-350,106,"2,753.70",636
,20130906,51730,51950,51930,52020,51930,52010,51970,60,20,12,311.87,634
,20130909,52010,51970,52470,52550,52440,52460,52490,490,520,76,"1,994.62",620
,20130910,52460,52490,52300,52340,51980,52020,52130,-470,-360,74,"1,929.00",624
,20130911,52020,52130,52200,52220,51990,52150,52110,20,-20,54,"1,407.05",626
,20130912,52150,52110,51790,51870,51650,51670,51740,-440,-370,22,569.19,626
,20130913,51670,51740,51200,51290,51100,51270,51190,-470,-550,92,"2,354.92",624
,20130916,51270,51190,51610,51610,51240,51290,51450,100,260,96,"2,470.07",642
,20130917,51290,51450,51110,51480,50980,51480,51250,30,-200,60,"1,537.58",648
,20130918,51480,51250,51360,51700,51290,51700,51440,450,190,44,"1,131.84",656
,20130923,51700,51440,51990,52230,51880,52230,52030,790,590,84,"2,185.56",654
,20130924,52230,52030,52060,52230,51940,51980,52080,-50,50,44,"1,145.88",658
,20130925,51980,52080,51980,52020,51830,52000,51930,-80,-150,40,"1,038.70",664
,20130926,52000,51930,52010,52450,51930,52350,52110,420,180,52,"1,355.09",676
,20130927,52350,52110,52290,52660,52290,52420,52380,310,270,44,"1,152.51",656
,20130930,52420,52380,52520,53000,52410,53000,52630,620,250,54,"1,421.12",660
,20131008,53000,52630,52460,52650,52450,52600,52520,-30,-110,26,682.8,664
,20131009,52600,52520,52340,52350,51740,51760,51930,-760,-590,88,"2,285.34",658
,20131010,51760,51930,51350,51590,51350,51500,51530,-430,-400,212,"5,462.56",666
,20131011,51500,51530,51810,51850,51670,51670,51780,140,250,30,776.75,664
,20131014,51670,51780,51860,52270,51490,52270,51830,490,50,234,"6,064.44",822
,20131015,52270,51830,52330,52400,52180,52180,52290,350,460,100,"2,614.53",824
,20131016,52180,52290,52200,52470,52180,52180,52250,-110,-40,12,313.55,822
,20131017,52180,52250,52180,52610,51880,51930,52310,-320,60,150,"3,923.34",868
,20131018,51930,52310,52120,52390,52100,52350,52260,40,-50,180,"4,703.59",874
,20131021,52350,52260,52060,52410,52000,52410,52170,150,-90,108,"2,817.25",862
,20131022,52410,52170,52280,52380,52260,52360,52300,190,130,52,"1,360.03",868
,20131023,52360,52300,52510,52580,52160,52230,52410,-70,110,102,"2,673.28",870
,20131024,52230,52410,51770,51930,51690,51890,51810,-520,-600,136,"3,523.35",876
,20131025,51890,51810,51830,51880,51250,51250,51640,-560,-170,194,"5,009.33",880
,20131028,51250,51640,51710,51710,51560,51640,51630,0,-10,70,"1,807.31",890
,20131029,51640,51630,51480,51530,51200,51530,51390,-100,-240,62,"1,593.27",884
,20131030,51530,51390,51870,52310,51840,52290,52130,900,740,168,"4,379.59",972
,20131031,52290,52130,52080,52080,51840,51870,52030,-260,-100,114,"2,966.00",1000
,20131101,51870,52030,51940,52290,51940,52290,52080,260,50,32,833.31,990
,20131104,52290,52080,52090,52160,51740,51790,51870,-290,-210,28,726.29,978
,20131105,51790,51870,51780,51880,51580,51740,51640,-130,-230,126,"3,253.64",982
,20131106,51740,51640,51740,51830,51540,51690,51690,50,50,74,"1,912.57",980
,20131107,51690,51690,51420,51560,51380,51560,51430,-130,-260,202,"5,195.07",1046
,20131108,51560,51430,51490,51710,51480,51550,51570,120,140,60,"1,547.23",1050
,20131111,51550,51570,51850,51850,51620,51620,51710,50,140,52,"1,344.55",1062
,20131112,51620,51710,51600,51600,51440,51510,51500,-200,-210,80,"2,060.31",1044
,20131113,51510,51500,51000,51030,50630,50680,50850,-820,-650,184,"4,679.08",1090
,20131114,50680,50850,50540,50710,50500,50500,50600,-350,-250,150,"3,795.27",1112
,20131115,50500,50600,50810,50900,50240,50240,50670,-360,70,290,"7,347.59",1148
,20131118,50240,50670,50340,50610,50340,50480,50450,-190,-220,234,"5,903.02",1138
,20131119,50480,50450,50050,50130,49770,49940,49910,-510,-540,382,"9,534.51",1174
,20131120,49940,49910,50140,50560,50140,50450,50320,540,410,88,"2,214.26",1172
,20131121,50450,50320,50120,50370,50020,50290,50180,-30,-140,340,"8,531.74",1176
,20131122,50290,50180,50680,50690,50460,50500,50600,320,420,68,"1,720.56",1182
,20131125,50500,50600,50810,50850,50600,50600,50730,0,130,28,710.23,1184
,20131126,50600,50730,50690,50910,50680,50830,50830,100,100,146,"3,711.10",1196
,20131127,50830,50830,50620,50680,50550,50620,50600,-210,-230,92,"2,327.93",1224
,20131128,50620,50600,50450,50660,50380,50390,50510,-210,-90,168,"4,243.20",1230
,20131129,50390,50510,50600,50700,50510,50680,50620,170,110,22,556.87,1230
,20131202,50680,50620,50650,50660,50500,50560,50560,-60,-60,78,"1,971.95",1244
,20131203,50560,50560,50160,50300,49990,50080,50150,-480,-410,424,"10,633.25",1378
,20131204,50080,50150,50180,50380,50160,50300,50270,150,120,86,"2,161.73",1404
,20131205,50300,50270,50750,50870,50620,50620,50740,350,470,52,"1,319.28",1382
,20131206,50620,50740,50740,50850,50530,50850,50650,110,-90,62,"1,570.31",1410
,20131209,50850,50650,50730,50950,50670,50770,50790,120,140,84,"2,133.25",1410
,20131210,50770,50790,50860,51130,50860,50950,50990,160,200,32,815.85,1406
,20131211,50950,50990,51090,51090,50910,50980,51010,-10,20,188,"4,795.69",1458
,20131212,50980,51010,51220,51520,51210,51480,51320,470,310,292,"7,493.95",1410
,20131213,51480,51320,51300,51310,51000,51090,51100,-230,-220,94,"2,402.06",1394
,20131216,51090,51100,51380,51380,51300,51340,51330,240,230,30,770.06,1392
,20131217,51340,51330,51450,51700,51400,51470,51520,140,190,136,"3,503.54",1424
,20131218,51470,51520,51380,51380,51140,51220,51280,-300,-240,64,"1,641.02",1410
,20131219,51220,51280,51290,51290,50990,51020,51070,-260,-210,168,"4,290.50",1454
,20131220,51020,51070,51000,51390,50920,51320,51100,250,30,136,"3,475.03",1490
,20131223,51320,51100,51340,51470,51190,51220,51330,120,230,76,"1,950.85",1492
,20131224,51220,51330,51390,51490,51200,51430,51390,100,60,66,"1,695.98",1490
,20131225,51430,51390,51530,52660,51520,52460,52080,1070,690,340,"8,853.72",1560
,20131226,52460,52080,52810,52810,52210,52240,52490,160,410,220,"5,773.90",1580
,20131227,52240,52490,52200,52430,52200,52420,52340,-70,-150,62,"1,622.54",1590
,20131230,52420,52340,52500,52570,52220,52300,52370,-40,30,150,"3,928.02",1606
,20131231,52300,52370,52210,52490,52210,52280,52360,-90,-10,172,"4,503.68",1658
cu1408,20130816,52480,52480,53000,53330,53000,53330,53110,850,630,132,"3,505.56",108
,20130819,53330,53110,53180,53290,53050,53050,53170,-60,60,124,"3,296.91",212
,20130820,53050,53170,52740,52740,52400,52460,52540,-710,-630,18,472.87,220
,20130821,52460,52540,52610,52650,52590,52630,52610,90,70,34,894.4,234
,20130822,52630,52610,52320,53020,52320,53000,52830,390,220,50,"1,320.79",252
,20130823,53000,52830,52930,53000,52710,52970,52900,140,70,58,"1,534.34",266
,20130826,52970,52900,53650,53650,53400,53500,53450,600,550,124,"3,314.10",334
,20130827,53500,53450,53160,53160,52970,53000,53040,-450,-410,250,"6,631.10",490
,20130828,53000,53040,53000,53120,52590,52590,52940,-450,-100,62,"1,641.24",522
,20130829,52590,52940,52520,52600,52290,52570,52480,-370,-460,72,"1,889.57",552
,20130830,52570,52480,52050,52100,52030,52030,52080,-450,-400,38,989.55,572
,20130902,52030,52080,52530,52920,52460,52890,52780,810,700,58,"1,530.80",590
,20130903,52890,52780,52710,52710,52540,52590,52600,-190,-180,26,683.88,588
,20130904,52590,52600,52400,52420,52250,52250,52370,-350,-230,108,"2,828.35",596
,20130905,52250,52370,52080,52210,51770,51900,51950,-470,-420,84,"2,182.02",630
,20130906,51900,51950,51940,52040,51900,52040,51970,90,20,36,935.56,650
,20130909,52040,51970,52470,52600,52440,52490,52530,520,560,120,"3,151.81",714
,20130910,52490,52530,52340,52360,52000,52170,52080,-360,-450,350,"9,114.01",932
,20130911,52170,52080,52340,52380,51970,52150,52150,70,70,56,"1,460.32",938
,20130912,52150,52150,51850,51930,51680,51680,51790,-470,-360,44,"1,139.46",938
,20130913,51680,51790,51320,51360,51140,51360,51240,-430,-550,66,"1,691.14",962
,20130916,51360,51240,51830,51830,51280,51280,51500,40,260,42,"1,081.66",962
,20130917,51280,51500,51200,51500,51000,51500,51200,0,-300,76,"1,945.87",1000
,20130918,51500,51200,51360,51790,51300,51790,51510,590,310,164,"4,223.95",1104
,20130923,51790,51510,51810,52220,51810,52210,52050,700,540,118,"3,071.23",1116
,20130924,52210,52050,52150,52240,51950,51970,52100,-80,50,44,"1,146.25",1130
,20130925,51970,52100,52030,52130,51850,52040,51990,-60,-110,32,831.86,1126
,20130926,52040,51990,52040,52400,52000,52400,52130,410,140,14,364.95,1122
,20130927,52400,52130,52310,52580,52300,52480,52430,350,300,54,"1,415.83",1130
,20130930,52480,52430,52440,52940,52440,52940,52710,510,280,86,"2,266.65",1164
,20131008,52940,52710,52460,52630,52420,52620,52490,-90,-220,34,892.4,1168
,20131009,52620,52490,52400,52400,51660,51680,51960,-810,-530,110,"2,858.31",1140
,20131010,51680,51960,51420,51600,51420,51520,51520,-440,-440,284,"7,316.18",1048
,20131011,51520,51520,51930,51950,51610,51770,51840,250,320,28,725.77,1050
,20131014,51770,51840,51690,52320,51510,52320,51960,480,120,182,"4,728.76",1072
,20131015,52320,51960,52400,52420,52230,52240,52330,280,370,30,784.95,1068
,20131016,52240,52330,52310,52400,52120,52210,52240,-120,-90,42,"1,097.17",1060
,20131017,52210,52240,52580,52600,51940,52000,52070,-240,-170,310,"8,071.50",1178
,20131018,52000,52070,52200,52390,52160,52300,52260,230,190,68,"1,777.15",1178
,20131021,52300,52260,52080,52470,52080,52470,52200,210,-60,240,"6,264.08",1054
,20131022,52470,52200,52310,52380,52270,52370,52340,170,140,56,"1,465.53",1058
,20131023,52370,52340,52610,52610,52200,52220,52370,-120,30,264,"6,913.43",1118
,20131024,52220,52370,51970,52060,51700,51960,51880,-410,-490,282,"7,315.70",1166
,20131025,51960,51880,51840,51920,51360,51390,51540,-490,-340,176,"4,536.21",1250
,20131028,51390,51540,51430,51790,51430,51650,51630,110,90,320,"8,261.32",1092
,20131029,51650,51630,51500,51610,51290,51580,51420,-50,-210,118,"3,033.97",1094
,20131030,51580,51420,51660,52320,51620,52300,52080,880,660,468,"12,188.78",1358
,20131031,52300,52080,52000,52120,51890,51980,52000,-100,-80,274,"7,124.92",1280
,20131101,51980,52000,51990,52360,51980,52350,52220,350,220,84,"2,193.28",1268
,20131104,52350,52220,52140,52180,51740,51860,51890,-360,-330,182,"4,722.73",1238
,20131105,51860,51890,51860,51910,51660,51880,51820,-10,-70,140,"3,627.58",1274
,20131106,51880,51820,51750,51790,51550,51700,51690,-120,-130,88,"2,274.55",1298
,20131107,51700,51690,51510,51620,51440,51610,51550,-80,-140,286,"7,372.58",1372
,20131108,51610,51550,51530,51700,51500,51630,51610,80,60,42,"1,083.94",1374
,20131111,51630,51610,51810,51820,51620,51730,51730,120,120,38,982.92,1378
,20131112,51730,51730,51520,51610,51450,51570,51500,-160,-230,154,"3,966.04",1428
,20131113,51570,51500,51020,51040,50590,50590,50790,-910,-710,200,"5,079.36",1402
,20131114,50590,50790,50600,50790,50520,50590,50680,-200,-110,346,"8,769.32",1354
,20131115,50590,50680,50790,50970,50200,50200,50710,-480,30,170,"4,311.12",1368
,20131118,50200,50710,50460,50600,50380,50580,50470,-130,-240,84,"2,120.07",1372
,20131119,50580,50470,50000,50130,49820,49910,49920,-560,-550,240,"5,991.05",1406
,20131120,49910,49920,50110,50630,50110,50490,50450,570,530,82,"2,068.79",1398
,20131121,50490,50450,50200,50340,50070,50320,50180,-130,-270,182,"4,566.82",1420
,20131122,50320,50180,50680,50700,50500,50540,50590,360,410,78,"1,973.28",1434
,20131125,50540,50590,50840,50870,50600,50600,50730,10,140,70,"1,775.70",1448
,20131126,50600,50730,50750,50920,50740,50850,50840,120,110,84,"2,135.51",1452
,20131127,50850,50840,50700,50700,50570,50650,50630,-190,-210,100,"2,531.73",1466
,20131128,50650,50630,50550,50690,50360,50400,50490,-230,-140,96,"2,423.53",1444
,20131129,50400,50490,50670,50680,50560,50660,50610,170,120,34,860.45,1438
,20131202,50660,50610,50650,50650,50560,50560,50610,-50,0,10,253.08,1438
,20131203,50560,50610,50300,50300,49960,50120,50160,-490,-450,454,"11,386.44",1428
,20131204,50120,50160,50160,50400,50160,50400,50290,240,130,18,452.69,1426
,20131205,50400,50290,50790,50790,50700,50700,50750,410,460,8,203,1426
,20131206,50700,50750,50700,50770,50610,50770,50680,20,-70,48,"1,216.33",1428
,20131209,50770,50680,50740,50970,50730,50800,50820,120,140,56,"1,423.02",1422
,20131210,50800,50820,50910,51120,50910,51040,51030,220,210,28,714.43,1420
,20131211,51040,51030,51110,51110,50930,50930,51050,-100,20,50,"1,276.41",1436
,20131212,50930,51050,51310,51510,51240,51500,51350,450,300,76,"1,951.38",1426
,20131213,51500,51350,51330,51330,51080,51100,51250,-250,-100,60,"1,537.61",1432
,20131216,51100,51250,51400,51400,51290,51310,51350,60,100,12,308.12,1430
,20131217,51310,51350,51450,51720,51400,51590,51530,240,180,34,876.15,1430
,20131218,51590,51530,51350,51380,51140,51170,51220,-360,-310,26,665.97,1432
,20131219,51170,51220,51030,51120,50930,50940,51040,-280,-180,38,969.78,1434
,20131220,50940,51040,51000,51390,50960,51390,51160,350,120,84,"2,149.09",1450
,20131223,51390,51160,51420,51500,51200,51280,51370,120,210,66,"1,695.34",1448
,20131224,51280,51370,51320,51500,51320,51500,51460,130,90,106,"2,727.82",1478
,20131225,51500,51460,52250,53170,51970,52690,52220,1230,760,126,"3,290.41",1478
,20131226,52690,52220,52630,52750,52280,52280,52470,60,250,78,"2,046.46",1508
,20131227,52280,52470,52410,52500,52380,52470,52430,0,-40,34,891.36,1508
,20131230,52470,52430,52490,52690,52290,52360,52460,-70,30,70,"1,836.36",1508
,20131231,52360,52460,52430,52540,52270,52360,52470,-100,10,128,"3,358.19",1574
cu1409,20130917,51500,51500,,,,51200,51200,-300,-300,0,0,0
,20130918,51200,51200,51690,51690,51690,51690,51690,490,490,2,51.69,2
,20130923,51690,51690,52140,52200,52110,52200,52160,510,470,26,678.18,26
,20130924,52200,52160,52260,52300,52070,52070,52130,-90,-30,56,"1,459.72",68
,20130925,52070,52130,51950,52100,51880,52100,52000,-30,-130,116,"3,016.05",142
,20130926,52100,52000,51980,52420,51920,52330,52080,330,80,206,"5,364.37",286
,20130927,52330,52080,52420,52730,52350,52550,52470,470,390,108,"2,833.62",300
,20130930,52550,52470,52400,52980,52400,52980,52690,510,220,234,"6,165.17",474
,20131008,52980,52690,52500,52700,52470,52660,52540,-30,-150,50,"1,313.59",488
,20131009,52660,52540,52240,52260,51710,51720,51960,-820,-580,100,"2,598.01",476
,20131010,51720,51960,51460,51610,51420,51600,51530,-360,-430,98,"2,525.02",512
,20131011,51600,51530,51920,52000,51690,51770,51810,240,280,96,"2,487.01",530
,20131014,51770,51810,51590,52370,51580,52340,51980,530,170,166,"4,314.65",558
,20131015,52340,51980,52190,52450,52190,52220,52320,240,340,142,"3,715.01",578
,20131016,52220,52320,52260,52500,52180,52330,52270,10,-50,94,"2,456.95",602
,20131017,52330,52270,52400,52420,51980,52020,52200,-250,-70,108,"2,818.87",606
,20131018,52020,52200,52350,52440,52230,52380,52330,180,130,62,"1,622.45",608
,20131021,52380,52330,52030,52520,52030,52510,52220,180,-110,42,"1,096.69",608
,20131022,52510,52220,52480,52480,52310,52330,52370,110,150,54,"1,414.15",608
,20131023,52330,52370,52610,52610,52240,52240,52380,-130,10,34,890.5,610
,20131024,52240,52380,52020,52020,51750,51900,51870,-480,-510,88,"2,282.50",634
,20131025,51900,51870,51900,51900,51330,51330,51570,-540,-300,110,"2,836.35",696
,20131028,51330,51570,51630,51820,51600,51630,51670,60,100,64,"1,653.70",708
,20131029,51630,51670,51350,51590,51330,51590,51420,-80,-250,52,"1,336.97",710
,20131030,51590,51420,51820,52310,51820,52310,52140,890,720,94,"2,450.86",714
,20131031,52310,52140,52090,52130,51880,51970,52020,-170,-120,166,"4,318.45",720
,20131101,51970,52020,51930,52420,51930,52420,52150,400,130,76,"1,981.96",702
,20131104,52420,52150,52170,52170,51750,51910,51880,-240,-270,68,"1,764.06",718
,20131105,51910,51880,51700,51920,51610,51920,51750,40,-130,66,"1,707.76",738
,20131106,51920,51750,51650,51840,51610,51720,51690,-30,-60,44,"1,137.25",744
,20131107,51720,51690,51500,51650,51470,51640,51560,-50,-130,80,"2,062.42",738
,20131108,51640,51560,51800,51800,51560,51620,51660,60,100,18,464.95,732
,20131111,51620,51660,51900,51900,51730,51790,51790,130,130,18,466.16,730
,20131112,51790,51790,51540,51660,51420,51660,51520,-130,-270,48,"1,236.68",734
,20131113,51660,51520,51070,51070,50680,50700,50840,-820,-680,134,"3,406.46",748
,20131114,50700,50840,49210,50750,49210,50630,50620,-210,-220,88,"2,227.63",778
,20131115,50630,50620,50800,50970,50250,50250,50570,-370,-50,90,"2,275.66",796
,20131118,50250,50570,50470,50620,50420,50560,50550,-10,-20,82,"2,072.58",818
,20131119,50560,50550,50000,50180,49830,50020,49980,-530,-570,78,"1,949.29",794
,20131120,50020,49980,50300,50630,50300,50540,50510,560,530,98,"2,475.27",780
,20131121,50540,50510,50310,50470,50100,50450,50260,-60,-250,108,"2,714.11",778
,20131122,50450,50260,50750,50770,50520,50650,50680,390,420,64,"1,621.91",774
,20131125,50650,50680,51020,51020,50680,50680,50800,0,120,58,"1,473.30",772
,20131126,50680,50800,50790,51000,50780,50890,50910,90,110,58,"1,476.60",786
,20131127,50890,50910,50700,50750,50610,50720,50670,-190,-240,82,"2,077.82",806
,20131128,50720,50670,50600,50770,50440,50450,50560,-220,-110,88,"2,224.92",788
,20131129,50450,50560,50630,50740,50580,50720,50650,160,90,52,"1,317.02",782
,20131202,50720,50650,50590,50650,50590,50650,50610,0,-40,24,607.35,798
,20131203,50650,50610,50300,50310,50020,50170,50220,-440,-390,164,"4,118.45",840
,20131204,50170,50220,50240,50450,50240,50350,50330,130,110,42,"1,057.04",850
,20131205,50350,50330,50770,50770,50700,50700,50730,370,400,4,101.47,848
,20131206,50700,50730,50620,50840,50580,50840,50640,110,-90,50,"1,266.03",824
,20131209,50840,50640,50800,51010,50750,50770,50820,130,180,44,"1,118.22",822
,20131210,50770,50820,50910,51140,50910,51020,51040,200,220,38,969.87,820
,20131211,51020,51040,51110,51130,50940,51050,51030,10,-10,56,"1,429.08",818
,20131212,51050,51030,51210,51600,51210,51600,51340,570,310,68,"1,745.61",806
,20131213,51600,51340,51320,51340,51070,51100,51230,-240,-110,126,"3,227.51",840
,20131216,51100,51230,51100,51390,51100,51350,51320,120,90,14,359.25,838
,20131217,51350,51320,51450,51710,51410,51520,51500,200,180,28,721.13,850
,20131218,51520,51500,51430,51430,51100,51230,51190,-270,-310,64,"1,638.18",858
,20131219,51230,51190,51270,51270,50940,51060,51120,-130,-70,104,"2,658.46",852
,20131220,51060,51120,51110,51360,50950,51350,51120,230,0,136,"3,476.60",880
,20131223,51350,51120,51290,51530,51190,51270,51330,150,210,96,"2,464.25",892
,20131224,51270,51330,51280,51520,51280,51500,51460,170,130,308,"7,924.96",1058
,20131225,51500,51460,51540,52660,51540,52550,52200,1090,740,322,"8,404.29",928
,20131226,52550,52200,52500,52770,52300,52330,52480,130,280,68,"1,784.47",924
,20131227,52330,52480,52470,52560,52300,52520,52420,40,-60,72,"1,887.45",924
,20131230,52520,52420,52470,52690,52310,52360,52460,-60,40,130,"3,410.48",942
,20131231,52360,52460,52460,52540,52300,52380,52430,-80,-30,94,"2,464.29",970
cu1410,20131016,52320,52320,52380,52470,52380,52470,52450,150,130,48,"1,258.83",48
,20131017,52470,52450,52640,52700,52010,52060,52260,-390,-190,196,"5,121.57",134
,20131018,52060,52260,51750,52480,51750,52450,52230,190,-30,96,"2,507.43",148
,20131021,52450,52230,52290,52530,52180,52530,52240,300,10,104,"2,716.95",178
,20131022,52530,52240,52490,52510,52320,52370,52400,130,160,168,"4,401.63",272
,20131023,52370,52400,52580,52650,52240,52280,52350,-120,-50,108,"2,827.33",328
,20131024,52280,52350,51830,52040,51810,52020,51920,-330,-430,88,"2,284.70",336
,20131025,52020,51920,51890,51960,51400,51400,51780,-520,-140,162,"4,194.36",426
,20131028,51400,51780,51650,51840,51600,51700,51710,-80,-70,74,"1,913.28",446
,20131029,51700,51710,51480,51570,51290,51550,51440,-160,-270,130,"3,344.04",500
,20131030,51550,51440,51660,52370,51660,52350,52100,910,660,124,"3,230.63",550
,20131031,52350,52100,52140,52150,51910,52010,52060,-90,-40,196,"5,102.25",566
,20131101,52010,52060,52040,52410,52040,52410,52180,350,120,114,"2,974.51",628
,20131104,52410,52180,52190,52240,51800,51930,51960,-250,-220,172,"4,469.35",682
,20131105,51930,51960,51830,51950,51680,51850,51760,-110,-200,104,"2,691.89",706
,20131106,51850,51760,51850,51990,51620,51800,51760,40,0,68,"1,760.14",752
,20131107,51800,51760,51500,51670,51500,51620,51570,-140,-190,36,928.39,754
,20131108,51620,51570,51610,51820,51600,51650,51710,80,140,46,"1,189.52",760
,20131111,51650,51710,51980,51980,51760,51760,51830,50,120,18,466.48,762
,20131112,51760,51830,51520,51730,51480,51690,51640,-140,-190,212,"5,474.41",864
,20131113,51690,51640,51140,51140,50690,50700,50940,-940,-700,144,"3,667.77",900
,20131114,50700,50940,50570,50740,50560,50590,50660,-350,-280,94,"2,381.37",950
,20131115,50590,50660,50800,50960,50330,50330,50720,-330,60,130,"3,297.28",1000
,20131118,50330,50720,50520,50710,50470,50550,50590,-170,-130,178,"4,502.99",1030
,20131119,50550,50590,50030,50220,49900,49970,50020,-620,-570,112,"2,801.23",1038
,20131120,49970,50020,50180,50660,50180,50570,50510,550,490,162,"4,091.45",1034
,20131121,50570,50510,50280,50430,50110,50430,50260,-80,-250,98,"2,463.05",1054
,20131122,50430,50260,50750,50820,50510,50640,50700,380,440,136,"3,447.94",1048
,20131125,50640,50700,50940,50940,50720,50720,50840,20,140,60,"1,525.32",1048
,20131126,50720,50840,50890,50990,50730,50960,50860,120,20,64,"1,627.77",1064
,20131127,50960,50860,50680,50870,50600,50710,50710,-150,-150,238,"6,035.19",1108
,20131128,50710,50710,50650,50660,50440,50450,50580,-260,-130,24,606.96,1112
,20131129,50450,50580,50720,50750,50600,50620,50660,40,80,128,"3,242.80",1160
,20131202,50620,50660,50860,50860,50550,50680,50640,20,-20,96,"2,430.86",1214
,20131203,50680,50640,50210,50330,50070,50070,50260,-570,-380,232,"5,830.20",1170
,20131204,50070,50260,50270,50430,50270,50330,50350,70,90,126,"3,172.52",1194
,20131205,50330,50350,50920,50920,50710,50720,50800,370,450,56,"1,422.46",1196
,20131206,50720,50800,50750,50780,50620,50760,50660,-40,-140,66,"1,672.10",1188
,20131209,50760,50660,50820,52670,50770,50870,50900,210,240,102,"2,596.01",1200
,20131210,50870,50900,50820,51110,50820,51050,51030,150,130,40,"1,020.67",1210
,20131211,51050,51030,51200,51200,50950,51040,51070,10,40,48,"1,225.70",1210
,20131212,51040,51070,51260,51560,51260,51560,51450,490,380,56,"1,440.77",1200
,20131213,51560,51450,51390,51390,51140,51140,51290,-310,-160,30,769.35,1200
,20131216,51140,51290,51390,51420,51360,51360,51380,70,90,20,513.89,1200
,20131217,51360,51380,51470,51730,51440,51520,51530,140,150,28,721.49,1196
,20131218,51520,51530,51400,51410,51190,51200,51340,-330,-190,26,667.49,1196
,20131219,51200,51340,51210,51210,51000,51000,51130,-340,-210,58,"1,483.04",1200
,20131220,51000,51130,51000,51450,50990,51400,51290,270,160,44,"1,128.48",1198
,20131223,51400,51290,51300,51530,51210,51330,51350,40,60,32,821.72,1198
,20131224,51330,51350,51470,51520,51430,51510,51480,160,130,42,"1,081.08",1198
,20131225,51510,51480,52060,52720,51960,52600,52190,1120,710,180,"4,697.46",1196
,20131226,52600,52190,52500,52790,52260,52310,52490,120,300,296,"7,769.73",1072
,20131227,52310,52490,52440,52550,52330,52500,52410,10,-80,54,"1,415.09",1064
,20131230,52500,52410,52650,52700,52320,52450,52470,40,60,40,"1,049.47",1062
,20131231,52450,52470,52260,52590,52260,52430,52480,-40,10,112,"2,939.05",1114
cu1411,20131118,50720,50720,50550,50700,50550,50700,50650,-20,-70,6,151.95,6
,20131119,50700,50650,50050,50050,49690,49890,49880,-760,-770,22,548.72,22
,20131120,49890,49880,50630,50630,50460,50570,50530,690,650,20,505.34,40
,20131121,50570,50530,50180,50410,50150,50410,50270,-120,-260,38,955.14,66
,20131122,50410,50270,50820,50820,50600,50680,50690,410,420,28,709.73,84
,20131125,50680,50690,51130,51130,50700,50700,50780,10,90,128,"3,250.47",170
,20131126,50700,50780,50880,51020,50880,51020,50980,240,200,24,611.76,178
,20131127,51020,50980,50840,50840,50640,50750,50720,-230,-260,44,"1,115.85",208
,20131128,50750,50720,50640,50690,50420,50490,50490,-230,-230,40,"1,009.81",232
,20131129,50490,50490,50700,50770,50620,50760,50710,270,220,12,304.31,234
,20131202,50760,50710,50690,50690,50600,50630,50630,-80,-80,32,810.19,260
,20131203,50630,50630,50300,50340,50120,50160,50230,-470,-400,88,"2,210.39",312
,20131204,50160,50230,50260,50460,50260,50360,50370,130,140,102,"2,569.01",386
,20131205,50360,50370,50730,50920,50730,50760,50840,390,470,24,610.12,380
,20131206,50760,50840,50760,50910,50640,50910,50740,70,-100,52,"1,319.32",398
,20131209,50910,50740,50830,51000,50790,50820,50870,80,130,98,"2,492.82",454
,20131210,50820,50870,51010,51090,51000,51040,51030,170,160,74,"1,888.39",474
,20131211,51040,51030,51090,51090,50980,51010,51040,-20,10,38,969.87,482
,20131212,51010,51040,51180,51560,51180,51560,51360,520,320,88,"2,260.19",484
,20131213,51560,51360,51410,51410,51120,51140,51250,-220,-110,78,"1,998.98",462
,20131216,51140,51250,51400,51450,51350,51350,51400,100,150,14,359.81,468
,20131217,51350,51400,51480,51710,51440,51500,51540,100,140,40,"1,030.83",484
,20131218,51500,51540,51380,51410,51160,51250,51290,-290,-250,62,"1,590.05",482
,20131219,51250,51290,51450,51450,50980,51030,51080,-260,-210,144,"3,677.92",516
,20131220,51030,51080,50990,51390,50980,51380,51170,300,90,90,"2,302.84",554
,20131223,51380,51170,51480,51510,51240,51330,51410,160,240,64,"1,645.42",566
,20131224,51330,51410,51460,51530,51460,51510,51510,100,100,250,"6,438.98",618
,20131225,51510,51510,51600,52530,51600,52530,52160,1020,650,156,"4,069.09",634
,20131226,52530,52160,52500,52800,52260,52310,52550,150,390,212,"5,570.76",600
,20131227,52310,52550,52450,52610,52290,52530,52480,-20,-70,74,"1,941.92",578
,20131230,52530,52480,52470,52480,52440,52440,52460,-40,-20,8,209.85,576
,20131231,52440,52460,52350,52600,52330,52400,52490,-60,30,196,"5,144.69",528
cu1412,20131217,51400,51400,51710,51710,51710,51710,51710,310,310,2,51.71,2
,20131218,51710,51710,51300,51310,51170,51270,51260,-440,-450,80,"2,050.51",66
,20131219,51270,51260,51060,51060,51050,51050,51050,-210,-210,8,204.21,72
,20131220,51050,51050,51050,51410,51050,51410,51130,360,80,42,"1,073.76",94
,20131223,51410,51130,51780,51780,51300,51300,51340,170,210,48,"1,232.17",138
,20131224,51300,51340,51330,51530,51330,51530,51490,190,150,220,"5,664.70",340
,20131225,51530,51490,52040,52660,52040,52660,52290,1170,800,170,"4,445.49",382
,20131226,52660,52290,52680,52880,52340,52360,52620,70,330,126,"3,315.35",404
,20131227,52360,52620,52530,52640,52530,52640,52610,20,-10,16,420.95,400
,20131230,52640,52610,52610,52700,52370,52370,52660,-240,50,30,789.98,400
,20131231,52370,52660,52290,52600,52290,52380,52460,-280,-200,22,577.11,400
fu1303,20130104,5015,5015,,,,5015,5015,0,0,0,0,6
,20130107,5015,5015,,,,5015,5015,0,0,0,0,6
,20130108,5015,5015,5150,5150,5150,5150,5150,135,135,4,103,6
,20130109,5150,5150,,,,5150,5150,0,0,0,0,6
,20130110,5150,5150,,,,5150,5150,0,0,0,0,6
,20130111,5150,5150,,,,5150,5150,0,0,0,0,6
,20130114,5150,5150,,,,5150,5150,0,0,0,0,6
,20130115,5150,5150,,,,5150,5150,0,0,0,0,6
,20130116,5150,5150,,,,5150,5150,0,0,0,0,6
,20130117,5150,5150,4841,5170,4841,4841,4950,-309,-200,6,148.52,6
,20130118,4841,4950,,,,4950,4950,0,0,0,0,6
,20130121,4950,4950,,,,4950,4950,0,0,0,0,6
,20130122,4950,4950,4910,4910,4910,4910,4910,-40,-40,4,98.2,2
,20130123,4910,4910,,,,4910,4910,0,0,0,0,2
,20130124,4910,4910,,,,4910,4910,0,0,0,0,2
,20130125,4910,4910,,,,4910,4910,0,0,0,0,2
,20130128,4910,4910,,,,4910,4910,0,0,0,0,2
,20130129,4910,4910,,,,4910,4910,0,0,0,0,2
,20130130,4910,4910,,,,4910,4910,0,0,0,0,2
,20130131,4910,4910,,,,4910,4910,0,0,0,0,2
,20130201,4910,4910,,,,4910,4910,0,0,0,0,2
,20130204,4910,4910,,,,4910,4910,0,0,0,0,2
,20130205,4910,4910,4900,5204,4900,5204,5052,294,142,4,101.04,2
,20130206,5204,5052,,,,5052,5052,0,0,0,0,2
,20130207,5052,5052,,,,5052,5052,0,0,0,0,2
,20130208,5052,5052,,,,5052,5052,0,0,0,0,2
,20130218,5052,5052,,,,5052,5052,0,0,0,0,2
,20130219,5052,5052,,,,5052,5052,0,0,0,0,2
,20130220,5052,5052,,,,5052,5052,0,0,0,0,2
,20130221,5052,5052,,,,5052,5052,0,0,0,0,2
,20130222,5052,5052,,,,5052,5052,0,0,0,0,2
,20130225,5052,5052,5200,5200,5200,5200,5200,148,148,2,52,0
,20130226,5200,5200,,,,5200,5200,0,0,0,0,0
,20130227,5200,5200,,,,5200,5200,0,0,0,0,0
,20130228,5200,5200,,,,5200,5200,0,0,0,0,0
fu1304,20130104,5050,5050,,,,5050,5050,0,0,0,0,2
,20130107,5050,5050,,,,5050,5050,0,0,0,0,2
,20130108,5050,5050,,,,5050,5050,0,0,0,0,2
,20130109,5050,5050,,,,5050,5050,0,0,0,0,2
,20130110,5050,5050,,,,5050,5050,0,0,0,0,2
,20130111,5050,5050,,,,5050,5050,0,0,0,0,2
,20130114,5050,5050,,,,5050,5050,0,0,0,0,2
,20130115,5050,5050,,,,5050,5050,0,0,0,0,2
,20130116,5050,5050,,,,5050,5050,0,0,0,0,2
,20130117,5050,5050,,,,5050,5050,0,0,0,0,2
,20130118,5050,5050,,,,5050,5050,0,0,0,0,2
,20130121,5050,5050,,,,5050,5050,0,0,0,0,2
,20130122,5050,5050,,,,5050,5050,0,0,0,0,2
,20130123,5050,5050,,,,5050,5050,0,0,0,0,2
,20130124,5050,5050,,,,5050,5050,0,0,0,0,2
,20130125,5050,5050,,,,5050,5050,0,0,0,0,2
,20130128,5050,5050,,,,5050,5050,0,0,0,0,2
,20130129,5050,5050,,,,5050,5050,0,0,0,0,2
,20130130,5050,5050,5040,5040,5040,5040,5040,-10,-10,2,50.4,0
,20130131,5040,5040,,,,5040,5040,0,0,0,0,0
,20130201,5040,5040,,,,5040,5040,0,0,0,0,0
,20130204,5040,5040,,,,5040,5040,0,0,0,0,0
,20130205,5040,5040,,,,5185,5185,145,145,0,0,0
,20130206,5185,5185,,,,5185,5185,0,0,0,0,0
,20130207,5185,5185,,,,5185,5185,0,0,0,0,0
,20130208,5185,5185,,,,5185,5185,0,0,0,0,0
,20130218,5185,5185,,,,5185,5185,0,0,0,0,0
,20130219,5185,5185,,,,5185,5185,0,0,0,0,0
,20130220,5185,5185,,,,5185,5185,0,0,0,0,0
,20130221,5185,5185,,,,5185,5185,0,0,0,0,0
,20130222,5185,5185,,,,5185,5185,0,0,0,0,0
,20130225,5185,5185,,,,5185,5185,0,0,0,0,0
,20130226,5185,5185,,,,5185,5185,0,0,0,0,0
,20130227,5185,5185,,,,5185,5185,0,0,0,0,0
,20130228,5185,5185,,,,5185,5185,0,0,0,0,0
,20130301,5185,5185,,,,5185,5185,0,0,0,0,0
,20130304,5185,5185,,,,5185,5185,0,0,0,0,0
,20130305,5185,5185,,,,5185,5185,0,0,0,0,0
,20130306,5185,5185,,,,5185,5185,0,0,0,0,0
,20130307,5185,5185,,,,5185,5185,0,0,0,0,0
,20130308,5185,5185,,,,5185,5185,0,0,0,0,0
,20130311,5185,5185,,,,5185,5185,0,0,0,0,0
,20130312,5185,5185,,,,5185,5185,0,0,0,0,0
,20130313,5185,5185,,,,5185,5185,0,0,0,0,0
,20130314,5185,5185,,,,5185,5185,0,0,0,0,0
,20130315,5185,5185,,,,5185,5185,0,0,0,0,0
,20130318,5185,5185,,,,5185,5185,0,0,0,0,0
,20130319,5185,5185,,,,5185,5185,0,0,0,0,0
,20130320,5185,5185,,,,5185,5185,0,0,0,0,0
,20130321,5185,5185,,,,5185,5185,0,0,0,0,0
,20130322,5185,5185,,,,5185,5185,0,0,0,0,0
,20130325,5185,5185,,,,5185,5185,0,0,0,0,0
,20130326,5185,5185,,,,5185,5185,0,0,0,0,0
,20130327,5185,5185,,,,5185,5185,0,0,0,0,0
,20130328,5185,5185,,,,5185,5185,0,0,0,0,0
,20130329,5185,5185,,,,5185,5185,0,0,0,0,0
fu1305,20130104,5046,5045,5041,5041,5041,5041,5041,-4,-4,6,151.23,46
,20130107,5041,5041,5149,5150,5089,5089,5130,48,89,34,872.18,44
,20130108,5089,5130,5112,5133,5076,5133,5107,3,-23,6,153.21,44
,20130109,5133,5107,,,,5107,5107,0,0,0,0,44
,20130110,5107,5107,5099,5099,5099,5099,5099,-8,-8,2,50.99,44
,20130111,5099,5099,5125,5125,5048,5060,5083,-39,-16,8,203.32,44
,20130114,5060,5083,5148,5148,5041,5082,5092,-1,9,10,254.61,42
,20130115,5082,5092,,,,5092,5092,0,0,0,0,42
,20130116,5092,5092,5082,5119,5082,5119,5096,27,4,12,305.78,40
,20130117,5119,5096,5118,5118,5089,5089,5103,-7,7,4,102.07,42
,20130118,5089,5103,5134,5134,5134,5134,5134,31,31,2,51.34,42
,20130121,5134,5134,5215,5215,5103,5169,5162,35,28,6,154.87,44
,20130122,5169,5162,5123,5123,5123,5123,5123,-39,-39,2,51.23,42
,20130123,5123,5123,5120,5120,5115,5115,5117,-8,-6,4,102.35,38
,20130124,5115,5117,5133,5133,5133,5133,5133,16,16,2,51.33,40
,20130125,5133,5133,5220,5398,5054,5067,5185,-66,52,74,"1,918.48",42
,20130128,5067,5185,5128,5128,5099,5100,5108,-85,-77,12,306.51,34
,20130129,5100,5108,5170,5173,5145,5151,5158,43,50,12,309.51,36
,20130130,5151,5158,5200,5243,5176,5220,5205,62,47,10,260.28,36
,20130131,5220,5205,5204,5204,5204,5204,5204,-1,-1,2,52.04,34
,20130201,5204,5204,5244,5244,5225,5225,5237,21,33,10,261.87,34
,20130204,5225,5237,5249,5300,5240,5300,5263,63,26,18,473.74,44
,20130205,5300,5263,5276,5276,5230,5232,5247,-31,-16,8,209.88,44
,20130206,5232,5247,5225,5225,5225,5225,5225,-22,-22,2,52.25,44
,20130207,5225,5225,,,,5225,5225,0,0,0,0,44
,20130208,5225,5225,5151,5253,5151,5243,5183,18,-42,12,311.01,44
,20130218,5243,5183,5160,5216,5160,5197,5184,14,1,10,259.23,42
,20130219,5197,5184,5219,5220,5200,5218,5216,34,32,22,573.77,58
,20130220,5218,5216,5230,5230,5213,5213,5228,-3,12,20,522.83,76
,20130221,5213,5228,5200,5200,5151,5190,5173,-38,-55,8,206.92,78
,20130222,5190,5173,5200,5200,5192,5192,5197,19,24,6,155.92,78
,20130225,5192,5197,5171,5171,5170,5170,5170,-27,-27,4,103.41,80
,20130226,5170,5170,,,,5170,5170,0,0,0,0,80
,20130227,5170,5170,5203,5203,5165,5189,5191,19,21,24,623.01,76
,20130228,5189,5191,5175,5194,5175,5180,5183,-11,-8,16,414.65,78
,20130301,5180,5183,5180,5193,5171,5171,5179,-12,-4,32,828.76,86
,20130304,5171,5179,5135,5135,5135,5135,5135,-44,-44,2,51.35,86
,20130305,5135,5135,5163,5172,5150,5150,5156,15,21,26,670.28,94
,20130306,5150,5156,5150,5150,5150,5150,5150,-6,-6,4,103,98
,20130307,5150,5150,5156,5156,5155,5155,5155,5,5,4,103.11,98
,20130308,5155,5155,5168,5168,5168,5168,5168,13,13,2,51.68,100
,20130311,5168,5168,5165,5165,5164,5164,5164,-4,-4,6,154.93,102
,20130312,5164,5164,5152,5161,5152,5157,5155,-7,-9,14,360.89,102
,20130313,5157,5155,,,,5157,5157,2,2,0,0,102
,20130314,5157,5157,5184,5378,5171,5179,5201,22,44,22,572.13,100
,20130315,5179,5201,5178,5199,5171,5175,5180,-26,-21,14,362.66,96
,20130318,5175,5180,5169,5172,5153,5153,5161,-27,-19,16,412.92,94
,20130319,5153,5161,5172,5186,5168,5186,5175,25,14,6,155.26,92
,20130320,5186,5175,,,,5175,5175,0,0,0,0,92
,20130321,5175,5175,,,,5175,5175,0,0,0,0,92
,20130322,5175,5175,5001,5173,5001,5126,5105,-49,-70,8,204.2,94
,20130325,5126,5105,5157,5157,5150,5150,5153,45,48,4,103.07,92
,20130326,5150,5153,,,,5153,5153,0,0,0,0,92
,20130327,5153,5153,,,,5153,5153,0,0,0,0,92
,20130328,5153,5153,,,,5153,5153,0,0,0,0,92
,20130329,5153,5153,5178,5179,5115,5145,5157,-8,4,26,670.52,90
,20130401,5145,5157,5133,5133,5115,5115,5124,-42,-33,4,102.48,90
,20130402,5115,5124,,,,5124,5124,0,0,0,0,90
,20130403,5124,5124,,,,5124,5124,0,0,0,0,90
,20130408,5124,5124,5140,5140,5140,5140,5140,16,16,2,51.4,90
,20130409,5140,5140,,,,5140,5140,0,0,0,0,90
,20130410,5140,5140,,,,5140,5140,0,0,0,0,90
,20130411,5140,5140,,,,5140,5140,0,0,0,0,90
,20130412,5140,5140,,,,5119,5119,-21,-21,0,0,90
,20130415,5119,5119,5119,5119,4950,4950,5034,-169,-85,4,100.69,88
,20130416,4950,5034,4790,4790,4790,4790,4790,-244,-244,2,47.9,86
,20130417,4790,4790,,,,4790,4790,0,0,0,0,86
,20130418,4790,4790,,,,4790,4790,0,0,0,0,86
,20130419,4790,4790,4560,4560,4560,4560,4560,-230,-230,2,45.6,84
,20130422,4560,4560,4600,4600,4600,4600,4600,40,40,2,46,84
,20130423,4600,4600,4830,4830,4830,4830,4830,230,230,2,48.3,82
,20130424,4830,4830,5071,5071,5071,5071,5071,241,241,6,152.13,80
,20130425,5071,5071,,,,5071,5071,0,0,0,0,80
,20130426,5071,5071,,,,4810,4810,-261,-261,0,0,80
fu1306,20130104,4879,4879,,,,4875,4875,-4,-4,0,0,0
,20130107,4875,4875,,,,4961,4961,86,86,0,0,0
,20130108,4961,4961,,,,4961,4961,0,0,0,0,0
,20130109,4961,4961,,,,4961,4961,0,0,0,0,0
,20130110,4961,4961,,,,4961,4961,0,0,0,0,0
,20130111,4961,4961,5258,5258,5258,5258,5258,297,297,2,52.58,2
,20130114,5258,5258,,,,5258,5258,0,0,0,0,2
,20130115,5258,5258,,,,5258,5258,0,0,0,0,2
,20130116,5258,5258,,,,5258,5258,0,0,0,0,2
,20130117,5258,5258,,,,5258,5258,0,0,0,0,2
,20130118,5258,5258,5100,5370,5100,5200,5223,-58,-35,6,156.7,2
,20130121,5200,5223,,,,5223,5223,0,0,0,0,2
,20130122,5223,5223,,,,5223,5223,0,0,0,0,2
,20130123,5223,5223,,,,5223,5223,0,0,0,0,2
,20130124,5223,5223,,,,5223,5223,0,0,0,0,2
,20130125,5223,5223,,,,5223,5223,0,0,0,0,2
,20130128,5223,5223,,,,5223,5223,0,0,0,0,2
,20130129,5223,5223,,,,5223,5223,0,0,0,0,2
,20130130,5223,5223,,,,5223,5223,0,0,0,0,2
,20130131,5223,5223,,,,5223,5223,0,0,0,0,2
,20130201,5223,5223,,,,5223,5223,0,0,0,0,2
,20130204,5223,5223,,,,5249,5249,26,26,0,0,2
,20130205,5249,5249,,,,5249,5249,0,0,0,0,2
,20130206,5249,5249,,,,5249,5249,0,0,0,0,2
,20130207,5249,5249,,,,5249,5249,0,0,0,0,2
,20130208,5249,5249,,,,5249,5249,0,0,0,0,2
,20130218,5249,5249,,,,5249,5249,0,0,0,0,2
,20130219,5249,5249,,,,5249,5249,0,0,0,0,2
,20130220,5249,5249,,,,5249,5249,0,0,0,0,2
,20130221,5249,5249,,,,5249,5249,0,0,0,0,2
,20130222,5249,5249,,,,5249,5249,0,0,0,0,2
,20130225,5249,5249,,,,5249,5249,0,0,0,0,2
,20130226,5249,5249,,,,5249,5249,0,0,0,0,2
,20130227,5249,5249,,,,5249,5249,0,0,0,0,2
,20130228,5249,5249,,,,5249,5249,0,0,0,0,2
,20130301,5249,5249,,,,5245,5245,-4,-4,0,0,2
,20130304,5245,5245,,,,5245,5245,0,0,0,0,2
,20130305,5245,5245,,,,5245,5245,0,0,0,0,2
,20130306,5245,5245,,,,5245,5245,0,0,0,0,2
,20130307,5245,5245,,,,5245,5245,0,0,0,0,2
,20130308,5245,5245,,,,5245,5245,0,0,0,0,2
,20130311,5245,5245,,,,5245,5245,0,0,0,0,2
,20130312,5245,5245,,,,5245,5245,0,0,0,0,2
,20130313,5245,5245,,,,5245,5245,0,0,0,0,2
,20130314,5245,5245,,,,5245,5245,0,0,0,0,2
,20130315,5245,5245,5429,5507,5300,5300,5411,55,166,14,378.82,12
,20130318,5300,5411,5143,5257,5143,5220,5193,-191,-218,38,986.67,8
,20130319,5220,5193,5044,5044,5044,5044,5044,-149,-149,4,100.88,10
,20130320,5044,5044,5250,5250,5250,5250,5250,206,206,2,52.5,10
,20130321,5250,5250,,,,5250,5250,0,0,0,0,10
,20130322,5250,5250,,,,5250,5250,0,0,0,0,10
,20130325,5250,5250,,,,5250,5250,0,0,0,0,10
,20130326,5250,5250,,,,5249,5249,-1,-1,0,0,10
,20130327,5249,5249,,,,5249,5249,0,0,0,0,10
,20130328,5249,5249,,,,5249,5249,0,0,0,0,10
,20130329,5249,5249,5290,5290,5290,5290,5290,41,41,2,52.9,10
,20130401,5290,5290,5025,5343,5025,5140,5152,-150,-138,24,618.24,10
,20130402,5140,5152,,,,5152,5152,0,0,0,0,10
,20130403,5152,5152,5099,5425,5002,5002,5190,-150,38,10,259.53,4
,20130408,5002,5190,,,,5190,5190,0,0,0,0,4
,20130409,5190,5190,5448,5448,5448,5448,5448,258,258,2,54.48,4
,20130410,5448,5448,,,,5448,5448,0,0,0,0,4
,20130411,5448,5448,,,,5448,5448,0,0,0,0,4
,20130412,5448,5448,,,,5448,5448,0,0,0,0,4
,20130415,5448,5448,,,,5358,5358,-90,-90,0,0,4
,20130416,5358,5358,,,,5098,5098,-260,-260,0,0,4
,20130417,5098,5098,,,,5098,5098,0,0,0,0,4
,20130418,5098,5098,,,,5098,5098,0,0,0,0,4
,20130419,5098,5098,,,,4853,4853,-245,-245,0,0,4
,20130422,4853,4853,5093,5093,5093,5093,5093,240,240,2,50.93,4
,20130423,5093,5093,,,,5347,5347,254,254,0,0,4
,20130424,5347,5347,,,,5613,5613,266,266,0,0,4
,20130425,5613,5613,,,,5332,5332,-281,-281,0,0,4
,20130426,5332,5332,5593,5593,5593,5593,5593,261,261,2,55.93,4
,20130502,5593,5593,,,,5593,5593,0,0,0,0,4
,20130503,5593,5593,,,,5313,5313,-280,-280,0,0,4
,20130506,5313,5313,,,,5313,5313,0,0,0,0,4
,20130507,5313,5313,,,,5313,5313,0,0,0,0,4
,20130508,5313,5313,,,,5313,5313,0,0,0,0,4
,20130509,5313,5313,,,,5313,5313,0,0,0,0,4
,20130510,5313,5313,,,,5313,5313,0,0,0,0,4
,20130513,5313,5313,,,,5313,5313,0,0,0,0,4
,20130514,5313,5313,,,,5313,5313,0,0,0,0,4
,20130515,5313,5313,5210,5210,5210,5210,5210,-103,-103,2,52.1,4
,20130516,5210,5210,,,,5210,5210,0,0,0,0,4
,20130517,5210,5210,,,,5210,5210,0,0,0,0,4
,20130520,5210,5210,,,,5210,5210,0,0,0,0,4
,20130521,5210,5210,,,,5210,5210,0,0,0,0,4
,20130522,5210,5210,,,,5210,5210,0,0,0,0,4
,20130523,5210,5210,,,,5210,5210,0,0,0,0,4
,20130524,5210,5210,5100,5100,5100,5100,5100,-110,-110,2,51,4
,20130527,5100,5100,,,,5100,5100,0,0,0,0,4
,20130528,5100,5100,4878,4898,4878,4898,4888,-202,-212,4,97.76,2
,20130529,4898,4888,4646,4646,4646,4646,4646,-242,-242,2,46.46,0
,20130530,4646,4646,,,,4646,4646,0,0,0,0,0
,20130531,4646,4646,,,,4646,4646,0,0,0,0,0
fu1307,20130104,4879,4879,,,,4875,4875,-4,-4,0,0,0
,20130107,4875,4875,,,,4961,4961,86,86,0,0,0
,20130108,4961,4961,,,,4961,4961,0,0,0,0,0
,20130109,4961,4961,,,,4961,4961,0,0,0,0,0
,20130110,4961,4961,,,,4961,4961,0,0,0,0,0
,20130111,4961,4961,,,,4961,4961,0,0,0,0,0
,20130114,4961,4961,,,,4961,4961,0,0,0,0,0
,20130115,4961,4961,,,,4961,4961,0,0,0,0,0
,20130116,4961,4961,,,,4961,4961,0,0,0,0,0
,20130117,4961,4961,,,,4961,4961,0,0,0,0,0
,20130118,4961,4961,,,,4961,4961,0,0,0,0,0
,20130121,4961,4961,,,,4988,4988,27,27,0,0,0
,20130122,4988,4988,,,,4988,4988,0,0,0,0,0
,20130123,4988,4988,,,,4988,4988,0,0,0,0,0
,20130124,4988,4988,,,,5003,5003,15,15,0,0,0
,20130125,5003,5003,,,,5053,5053,50,50,0,0,0
,20130128,5053,5053,,,,5053,5053,0,0,0,0,0
,20130129,5053,5053,,,,5053,5053,0,0,0,0,0
,20130130,5053,5053,,,,5099,5099,46,46,0,0,0
,20130131,5099,5099,,,,5099,5099,0,0,0,0,0
,20130201,5099,5099,,,,5099,5099,0,0,0,0,0
,20130204,5099,5099,,,,5125,5125,26,26,0,0,0
,20130205,5125,5125,,,,5109,5109,-16,-16,0,0,0
,20130206,5109,5109,,,,5109,5109,0,0,0,0,0
,20130207,5109,5109,,,,5109,5109,0,0,0,0,0
,20130208,5109,5109,,,,5068,5068,-41,-41,0,0,0
,20130218,5068,5068,,,,5068,5068,0,0,0,0,0
,20130219,5068,5068,,,,5099,5099,31,31,0,0,0
,20130220,5099,5099,,,,5111,5111,12,12,0,0,0
,20130221,5111,5111,,,,5111,5111,0,0,0,0,0
,20130222,5111,5111,,,,5135,5135,24,24,0,0,0
,20130225,5135,5135,,,,5135,5135,0,0,0,0,0
,20130226,5135,5135,,,,5135,5135,0,0,0,0,0
,20130227,5135,5135,,,,5135,5135,0,0,0,0,0
,20130228,5135,5135,,,,5135,5135,0,0,0,0,0
,20130301,5135,5135,,,,5131,5131,-4,-4,0,0,0
,20130304,5131,5131,,,,5131,5131,0,0,0,0,0
,20130305,5131,5131,,,,5131,5131,0,0,0,0,0
,20130306,5131,5131,,,,5131,5131,0,0,0,0,0
,20130307,5131,5131,,,,5131,5131,0,0,0,0,0
,20130308,5131,5131,,,,5143,5143,12,12,0,0,0
,20130311,5143,5143,,,,5143,5143,0,0,0,0,0
,20130312,5143,5143,,,,5143,5143,0,0,0,0,0
,20130313,5143,5143,,,,5143,5143,0,0,0,0,0
,20130314,5143,5143,,,,5143,5143,0,0,0,0,0
,20130315,5143,5143,,,,5143,5143,0,0,0,0,0
,20130318,5143,5143,,,,5143,5143,0,0,0,0,0
,20130319,5143,5143,,,,5143,5143,0,0,0,0,0
,20130320,5143,5143,,,,5143,5143,0,0,0,0,0
,20130321,5143,5143,,,,5143,5143,0,0,0,0,0
,20130322,5143,5143,,,,5143,5143,0,0,0,0,0
,20130325,5143,5143,,,,5143,5143,0,0,0,0,0
,20130326,5143,5143,,,,5143,5143,0,0,0,0,0
,20130327,5143,5143,,,,5143,5143,0,0,0,0,0
,20130328,5143,5143,,,,5143,5143,0,0,0,0,0
,20130329,5143,5143,,,,5143,5143,0,0,0,0,0
,20130401,5143,5143,,,,5143,5143,0,0,0,0,0
,20130402,5143,5143,,,,5143,5143,0,0,0,0,0
,20130403,5143,5143,,,,5143,5143,0,0,0,0,0
,20130408,5143,5143,,,,5143,5143,0,0,0,0,0
,20130409,5143,5143,,,,5143,5143,0,0,0,0,0
,20130410,5143,5143,,,,5143,5143,0,0,0,0,0
,20130411,5143,5143,,,,5143,5143,0,0,0,0,0
,20130412,5143,5143,,,,5143,5143,0,0,0,0,0
,20130415,5143,5143,,,,5143,5143,0,0,0,0,0
,20130416,5143,5143,,,,5143,5143,0,0,0,0,0
,20130417,5143,5143,,,,5143,5143,0,0,0,0,0
,20130418,5143,5143,,,,5143,5143,0,0,0,0,0
,20130419,5143,5143,,,,4896,4896,-247,-247,0,0,0
,20130422,4896,4896,,,,4896,4896,0,0,0,0,0
,20130423,4896,4896,,,,4896,4896,0,0,0,0,0
,20130424,4896,4896,,,,4896,4896,0,0,0,0,0
,20130425,4896,4896,,,,4896,4896,0,0,0,0,0
,20130426,4896,4896,,,,4896,4896,0,0,0,0,0
,20130502,4896,4896,,,,4896,4896,0,0,0,0,0
,20130503,4896,4896,,,,4896,4896,0,0,0,0,0
,20130506,4896,4896,,,,4896,4896,0,0,0,0,0
,20130507,4896,4896,,,,4896,4896,0,0,0,0,0
,20130508,4896,4896,,,,4896,4896,0,0,0,0,0
,20130509,4896,4896,,,,4896,4896,0,0,0,0,0
,20130510,4896,4896,,,,4896,4896,0,0,0,0,0
,20130513,4896,4896,,,,4896,4896,0,0,0,0,0
,20130514,4896,4896,,,,4896,4896,0,0,0,0,0
,20130515,4896,4896,,,,4801,4801,-95,-95,0,0,0
,20130516,4801,4801,,,,4801,4801,0,0,0,0,0
,20130517,4801,4801,,,,4801,4801,0,0,0,0,0
,20130520,4801,4801,,,,4801,4801,0,0,0,0,0
,20130521,4801,4801,,,,4801,4801,0,0,0,0,0
,20130522,4801,4801,,,,4801,4801,0,0,0,0,0
,20130523,4801,4801,,,,4801,4801,0,0,0,0,0
,20130524,4801,4801,,,,4699,4699,-102,-102,0,0,0
,20130527,4699,4699,,,,4699,4699,0,0,0,0,0
,20130528,4699,4699,,,,4503,4503,-196,-196,0,0,0
,20130529,4503,4503,,,,4280,4280,-223,-223,0,0,0
,20130530,4280,4280,,,,4494,4494,214,214,0,0,0
,20130531,4494,4494,,,,4494,4494,0,0,0,0,0
,20130603,4494,4494,,,,4494,4494,0,0,0,0,0
,20130604,4494,4494,,,,4494,4494,0,0,0,0,0
,20130605,4494,4494,,,,4494,4494,0,0,0,0,0
,20130606,4494,4494,,,,4494,4494,0,0,0,0,0
,20130607,4494,4494,,,,4494,4494,0,0,0,0,0
,20130613,4494,4494,,,,4494,4494,0,0,0,0,0
,20130614,4494,4494,,,,4494,4494,0,0,0,0,0
,20130617,4494,4494,,,,4494,4494,0,0,0,0,0
,20130618,4494,4494,,,,4494,4494,0,0,0,0,0
,20130619,4494,4494,,,,4494,4494,0,0,0,0,0
,20130620,4494,4494,,,,4494,4494,0,0,0,0,0
,20130621,4494,4494,,,,4494,4494,0,0,0,0,0
,20130624,4494,4494,,,,4494,4494,0,0,0,0,0
,20130625,4494,4494,,,,4494,4494,0,0,0,0,0
,20130626,4494,4494,,,,4494,4494,0,0,0,0,0
,20130627,4494,4494,,,,4494,4494,0,0,0,0,0
,20130628,4494,4494,,,,4494,4494,0,0,0,0,0
fu1308,20130104,5000,5010,,,,5006,5006,-4,-4,0,0,0
,20130107,5006,5006,,,,5094,5094,88,88,0,0,0
,20130108,5094,5094,,,,5071,5071,-23,-23,0,0,0
,20130109,5071,5071,,,,5071,5071,0,0,0,0,0
,20130110,5071,5071,,,,5071,5071,0,0,0,0,0
,20130111,5071,5071,,,,5071,5071,0,0,0,0,0
,20130114,5071,5071,,,,5071,5071,0,0,0,0,0
,20130115,5071,5071,,,,5071,5071,0,0,0,0,0
,20130116,5071,5071,,,,5071,5071,0,0,0,0,0
,20130117,5071,5071,,,,5071,5071,0,0,0,0,0
,20130118,5071,5071,,,,5071,5071,0,0,0,0,0
,20130121,5071,5071,,,,5071,5071,0,0,0,0,0
,20130122,5071,5071,,,,5071,5071,0,0,0,0,0
,20130123,5071,5071,,,,5071,5071,0,0,0,0,0
,20130124,5071,5071,,,,5071,5071,0,0,0,0,0
,20130125,5071,5071,,,,5071,5071,0,0,0,0,0
,20130128,5071,5071,,,,5071,5071,0,0,0,0,0
,20130129,5071,5071,,,,5071,5071,0,0,0,0,0
,20130130,5071,5071,,,,5071,5071,0,0,0,0,0
,20130131,5071,5071,,,,5070,5070,-1,-1,0,0,0
,20130201,5070,5070,,,,5102,5102,32,32,0,0,0
,20130204,5102,5102,,,,5128,5128,26,26,0,0,0
,20130205,5128,5128,,,,5128,5128,0,0,0,0,0
,20130206,5128,5128,,,,5128,5128,0,0,0,0,0
,20130207,5128,5128,,,,5128,5128,0,0,0,0,0
,20130208,5128,5128,,,,5087,5087,-41,-41,0,0,0
,20130218,5087,5087,,,,5087,5087,0,0,0,0,0
,20130219,5087,5087,,,,5118,5118,31,31,0,0,0
,20130220,5118,5118,,,,5130,5130,12,12,0,0,0
,20130221,5130,5130,,,,5130,5130,0,0,0,0,0
,20130222,5130,5130,,,,5130,5130,0,0,0,0,0
,20130225,5130,5130,,,,5130,5130,0,0,0,0,0
,20130226,5130,5130,,,,5130,5130,0,0,0,0,0
,20130227,5130,5130,,,,5130,5130,0,0,0,0,0
,20130228,5130,5130,,,,5130,5130,0,0,0,0,0
,20130301,5130,5130,,,,5126,5126,-4,-4,0,0,0
,20130304,5126,5126,,,,5126,5126,0,0,0,0,0
,20130305,5126,5126,,,,5126,5126,0,0,0,0,0
,20130306,5126,5126,,,,5126,5126,0,0,0,0,0
,20130307,5126,5126,,,,5126,5126,0,0,0,0,0
,20130308,5126,5126,,,,5138,5138,12,12,0,0,0
,20130311,5138,5138,,,,5138,5138,0,0,0,0,0
,20130312,5138,5138,,,,5138,5138,0,0,0,0,0
,20130313,5138,5138,,,,5138,5138,0,0,0,0,0
,20130314,5138,5138,,,,5138,5138,0,0,0,0,0
,20130315,5138,5138,,,,5138,5138,0,0,0,0,0
,20130318,5138,5138,,,,5138,5138,0,0,0,0,0
,20130319,5138,5138,,,,5138,5138,0,0,0,0,0
,20130320,5138,5138,,,,5138,5138,0,0,0,0,0
,20130321,5138,5138,,,,5138,5138,0,0,0,0,0
,20130322,5138,5138,,,,5138,5138,0,0,0,0,0
,20130325,5138,5138,,,,5138,5138,0,0,0,0,0
,20130326,5138,5138,,,,5138,5138,0,0,0,0,0
,20130327,5138,5138,,,,5138,5138,0,0,0,0,0
,20130328,5138,5138,,,,5138,5138,0,0,0,0,0
,20130329,5138,5138,,,,5138,5138,0,0,0,0,0
,20130401,5138,5138,,,,5138,5138,0,0,0,0,0
,20130402,5138,5138,,,,5138,5138,0,0,0,0,0
,20130403,5138,5138,,,,5138,5138,0,0,0,0,0
,20130408,5138,5138,,,,5138,5138,0,0,0,0,0
,20130409,5138,5138,,,,5138,5138,0,0,0,0,0
,20130410,5138,5138,,,,5138,5138,0,0,0,0,0
,20130411,5138,5138,,,,5138,5138,0,0,0,0,0
,20130412,5138,5138,,,,5138,5138,0,0,0,0,0
,20130415,5138,5138,,,,5138,5138,0,0,0,0,0
,20130416,5138,5138,,,,5138,5138,0,0,0,0,0
,20130417,5138,5138,,,,5138,5138,0,0,0,0,0
,20130418,5138,5138,,,,5138,5138,0,0,0,0,0
,20130419,5138,5138,,,,4891,4891,-247,-247,0,0,0
,20130422,4891,4891,,,,4891,4891,0,0,0,0,0
,20130423,4891,4891,,,,4891,4891,0,0,0,0,0
,20130424,4891,4891,,,,4891,4891,0,0,0,0,0
,20130425,4891,4891,,,,4891,4891,0,0,0,0,0
,20130426,4891,4891,,,,4891,4891,0,0,0,0,0
,20130502,4891,4891,,,,4891,4891,0,0,0,0,0
,20130503,4891,4891,,,,4891,4891,0,0,0,0,0
,20130506,4891,4891,,,,4891,4891,0,0,0,0,0
,20130507,4891,4891,,,,4891,4891,0,0,0,0,0
,20130508,4891,4891,,,,4891,4891,0,0,0,0,0
,20130509,4891,4891,,,,4891,4891,0,0,0,0,0
,20130510,4891,4891,,,,4891,4891,0,0,0,0,0
,20130513,4891,4891,,,,4891,4891,0,0,0,0,0
,20130514,4891,4891,,,,4891,4891,0,0,0,0,0
,20130515,4891,4891,,,,4891,4891,0,0,0,0,0
,20130516,4891,4891,,,,4891,4891,0,0,0,0,0
,20130517,4891,4891,,,,4891,4891,0,0,0,0,0
,20130520,4891,4891,,,,4891,4891,0,0,0,0,0
,20130521,4891,4891,,,,4891,4891,0,0,0,0,0
,20130522,4891,4891,,,,4891,4891,0,0,0,0,0
,20130523,4891,4891,,,,4891,4891,0,0,0,0,0
,20130524,4891,4891,,,,4891,4891,0,0,0,0,0
,20130527,4891,4891,,,,4891,4891,0,0,0,0,0
,20130528,4891,4891,,,,4891,4891,0,0,0,0,0
,20130529,4891,4891,,,,4891,4891,0,0,0,0,0
,20130530,4891,4891,,,,4891,4891,0,0,0,0,0
,20130531,4891,4891,5128,5135,4800,4910,4986,19,95,34,847.66,0
,20130603,4910,4986,,,,4986,4986,0,0,0,0,0
,20130604,4986,4986,,,,4986,4986,0,0,0,0,0
,20130605,4986,4986,,,,4986,4986,0,0,0,0,0
,20130606,4986,4986,,,,4986,4986,0,0,0,0,0
,20130607,4986,4986,,,,4986,4986,0,0,0,0,0
,20130613,4986,4986,,,,4986,4986,0,0,0,0,0
,20130614,4986,4986,,,,4986,4986,0,0,0,0,0
,20130617,4986,4986,,,,4986,4986,0,0,0,0,0
,20130618,4986,4986,,,,4986,4986,0,0,0,0,0
,20130619,4986,4986,,,,4986,4986,0,0,0,0,0
,20130620,4986,4986,,,,4986,4986,0,0,0,0,0
,20130621,4986,4986,,,,4986,4986,0,0,0,0,0
,20130624,4986,4986,,,,4986,4986,0,0,0,0,0
,20130625,4986,4986,,,,4986,4986,0,0,0,0,0
,20130626,4986,4986,,,,4986,4986,0,0,0,0,0
,20130627,4986,4986,,,,4986,4986,0,0,0,0,0
,20130628,4986,4986,,,,4986,4986,0,0,0,0,0
,20130701,4986,4986,,,,4986,4986,0,0,0,0,0
,20130702,4986,4986,,,,4986,4986,0,0,0,0,0
,20130703,4986,4986,,,,4986,4986,0,0,0,0,0
,20130704,4986,4986,,,,4986,4986,0,0,0,0,0
,20130705,4986,4986,,,,4986,4986,0,0,0,0,0
,20130708,4986,4986,,,,4986,4986,0,0,0,0,0
,20130709,4986,4986,,,,4986,4986,0,0,0,0,0
,20130710,4986,4986,,,,4986,4986,0,0,0,0,0
,20130711,4986,4986,,,,4986,4986,0,0,0,0,0
,20130712,4986,4986,,,,4986,4986,0,0,0,0,0
,20130715,4986,4986,,,,4986,4986,0,0,0,0,0
,20130716,4986,4986,,,,4986,4986,0,0,0,0,0
,20130717,4986,4986,,,,4986,4986,0,0,0,0,0
,20130718,4986,4986,,,,4986,4986,0,0,0,0,0
,20130719,4986,4986,,,,4986,4986,0,0,0,0,0
,20130722,4986,4986,,,,4986,4986,0,0,0,0,0
,20130723,4986,4986,,,,4986,4986,0,0,0,0,0
,20130724,4986,4986,,,,4986,4986,0,0,0,0,0
,20130725,4986,4986,,,,4986,4986,0,0,0,0,0
,20130726,4986,4986,,,,4986,4986,0,0,0,0,0
,20130729,4986,4986,,,,4986,4986,0,0,0,0,0
,20130730,4986,4986,,,,4986,4986,0,0,0,0,0
,20130731,4986,4986,,,,4986,4986,0,0,0,0,0
fu1309,20130104,5010,5010,,,,5006,5006,-4,-4,0,0,0
,20130107,5006,5006,,,,5094,5094,88,88,0,0,0
,20130108,5094,5094,,,,5094,5094,0,0,0,0,0
,20130109,5094,5094,,,,5094,5094,0,0,0,0,0
,20130110,5094,5094,,,,5094,5094,0,0,0,0,0
,20130111,5094,5094,5365,5365,5365,5365,5365,271,271,2,53.65,2
,20130114,5365,5365,,,,5374,5374,9,9,0,0,2
,20130115,5374,5374,,,,5374,5374,0,0,0,0,2
,20130116,5374,5374,,,,5378,5378,4,4,0,0,2
,20130117,5378,5378,,,,5385,5385,7,7,0,0,2
,20130118,5385,5385,,,,5349,5349,-36,-36,0,0,2
,20130121,5349,5349,,,,5378,5378,29,29,0,0,2
,20130122,5378,5378,,,,5337,5337,-41,-41,0,0,2
,20130123,5337,5337,,,,5327,5327,-10,-10,0,0,2
,20130124,5327,5327,,,,5343,5343,16,16,0,0,2
,20130125,5343,5343,,,,5290,5290,-53,-53,0,0,2
,20130128,5290,5290,,,,5211,5211,-79,-79,0,0,2
,20130129,5211,5211,,,,5262,5262,51,51,0,0,2
,20130130,5262,5262,5321,5321,5321,5321,5321,59,59,2,53.21,2
,20130131,5321,5321,5187,5200,5187,5200,5193,-121,-128,4,103.87,0
,20130201,5200,5193,,,,5193,5193,0,0,0,0,0
,20130204,5193,5193,5311,5311,5311,5311,5311,118,118,2,53.11,2
,20130205,5311,5311,,,,5311,5311,0,0,0,0,2
,20130206,5311,5311,,,,5311,5311,0,0,0,0,2
,20130207,5311,5311,,,,5311,5311,0,0,0,0,2
,20130208,5311,5311,,,,5268,5268,-43,-43,0,0,2
,20130218,5268,5268,,,,5268,5268,0,0,0,0,2
,20130219,5268,5268,,,,5268,5268,0,0,0,0,2
,20130220,5268,5268,5364,5364,5364,5364,5364,96,96,2,53.64,4
,20130221,5364,5364,,,,5349,5349,-15,-15,0,0,4
,20130222,5349,5349,5455,5455,5201,5385,5347,36,-2,6,160.41,4
,20130225,5385,5347,,,,5338,5338,-9,-9,0,0,4
,20130226,5338,5338,,,,5338,5338,0,0,0,0,4
,20130227,5338,5338,,,,5338,5338,0,0,0,0,4
,20130228,5338,5338,,,,5337,5337,-1,-1,0,0,4
,20130301,5337,5337,5160,5292,5160,5292,5219,-45,-118,8,208.77,6
,20130304,5292,5219,,,,5219,5219,0,0,0,0,6
,20130305,5219,5219,5279,5279,5279,5279,5279,60,60,4,105.58,6
,20130306,5279,5279,,,,5276,5276,-3,-3,0,0,6
,20130307,5276,5276,,,,5276,5276,0,0,0,0,6
,20130308,5276,5276,,,,5276,5276,0,0,0,0,6
,20130311,5276,5276,,,,5276,5276,0,0,0,0,6
,20130312,5276,5276,,,,5276,5276,0,0,0,0,6
,20130313,5276,5276,5173,5262,5173,5262,5217,-14,-59,4,104.35,8
,20130314,5262,5217,5277,5277,5180,5189,5215,-28,-2,18,469.42,8
,20130315,5189,5215,5208,5215,5208,5215,5211,0,-4,4,104.23,4
,20130318,5215,5211,,,,5204,5204,-7,-7,0,0,4
,20130319,5204,5204,,,,5204,5204,0,0,0,0,4
,20130320,5204,5204,,,,5204,5204,0,0,0,0,4
,20130321,5204,5204,,,,5204,5204,0,0,0,0,4
,20130322,5204,5204,5114,5114,5114,5114,5114,-90,-90,2,51.14,6
,20130325,5114,5114,5206,5206,5206,5206,5206,92,92,2,52.06,6
,20130326,5206,5206,5162,5162,5162,5162,5162,-44,-44,2,51.62,6
,20130327,5162,5162,,,,5162,5162,0,0,0,0,6
,20130328,5162,5162,,,,5162,5162,0,0,0,0,6
,20130329,5162,5162,5195,5195,5170,5170,5182,8,20,4,103.65,6
,20130401,5170,5182,,,,5182,5182,0,0,0,0,6
,20130402,5182,5182,,,,5182,5182,0,0,0,0,6
,20130403,5182,5182,5197,5197,5197,5197,5197,15,15,2,51.97,6
,20130408,5197,5197,5198,5198,5198,5198,5198,1,1,2,51.98,6
,20130409,5198,5198,,,,5188,5188,-10,-10,0,0,6
,20130410,5188,5188,,,,5188,5188,0,0,0,0,6
,20130411,5188,5188,,,,5188,5188,0,0,0,0,6
,20130412,5188,5188,5158,5158,5158,5158,5158,-30,-30,2,51.58,4
,20130415,5158,5158,5152,5152,5152,5152,5152,-6,-6,2,51.52,4
,20130416,5152,5152,,,,5152,5152,0,0,0,0,4
,20130417,5152,5152,5022,5022,5022,5022,5022,-130,-130,2,50.22,4
,20130418,5022,5022,4978,5000,4921,4921,4966,-101,-56,6,148.99,8
,20130419,4921,4966,5187,5187,4950,4999,5033,33,67,8,201.35,6
,20130422,4999,5033,,,,4954,4954,-79,-79,0,0,6
,20130423,4954,4954,,,,4954,4954,0,0,0,0,6
,20130424,4954,4954,4954,4954,4954,4954,4954,0,0,2,49.54,8
,20130425,4954,4954,,,,4954,4954,0,0,0,0,8
,20130426,4954,4954,5205,5205,4952,5000,5052,46,98,6,151.57,8
,20130502,5000,5052,,,,5000,5000,-52,-52,0,0,8
,20130503,5000,5000,,,,4967,4967,-33,-33,0,0,8
,20130506,4967,4967,5040,5040,5040,5040,5040,73,73,2,50.4,6
,20130507,5040,5040,,,,5040,5040,0,0,0,0,6
,20130508,5040,5040,,,,5040,5040,0,0,0,0,6
,20130509,5040,5040,4791,5048,4791,5048,4919,8,-121,4,98.39,6
,20130510,5048,4919,4959,4959,4950,4950,4954,31,35,4,99.09,6
,20130513,4950,4954,5170,5170,4744,5000,4983,46,29,16,398.64,12
,20130514,5000,4983,4895,4950,4895,4950,4922,-33,-61,4,98.45,12
,20130515,4950,4922,4925,4925,4925,4925,4925,3,3,2,49.25,14
,20130516,4925,4925,,,,4925,4925,0,0,0,0,14
,20130517,4925,4925,,,,4925,4925,0,0,0,0,14
,20130520,4925,4925,4934,4934,4934,4934,4934,9,9,2,49.34,14
,20130521,4934,4934,4974,4980,4974,4980,4977,46,43,4,99.54,14
,20130522,4980,4977,4976,4977,4940,4977,4967,0,-10,8,198.69,12
,20130523,4977,4967,,,,4954,4954,-13,-13,0,0,12
,20130524,4954,4954,,,,4954,4954,0,0,0,0,12
,20130527,4954,4954,,,,4954,4954,0,0,0,0,12
,20130528,4954,4954,,,,4954,4954,0,0,0,0,12
,20130529,4954,4954,,,,4954,4954,0,0,0,0,12
,20130530,4954,4954,,,,4954,4954,0,0,0,0,12
,20130531,4954,4954,,,,4954,4954,0,0,0,0,12
,20130603,4954,4954,,,,4954,4954,0,0,0,0,12
,20130604,4954,4954,,,,4954,4954,0,0,0,0,12
,20130605,4954,4954,,,,4954,4954,0,0,0,0,12
,20130606,4954,4954,4706,4850,4706,4760,4736,-194,-218,18,426.31,6
,20130607,4760,4736,4750,4750,4750,4750,4750,14,14,2,47.5,6
,20130613,4750,4750,4950,4950,4792,4792,4871,42,121,4,97.42,6
,20130614,4792,4871,4774,4774,4774,4774,4774,-97,-97,2,47.74,6
,20130617,4774,4774,4990,4990,4668,4668,4829,-106,55,4,96.58,8
,20130618,4668,4829,4900,4900,4756,4756,4828,-73,-1,4,96.56,8
,20130619,4756,4828,4766,4767,4756,4764,4763,-64,-65,10,238.16,4
,20130620,4764,4763,,,,4763,4763,0,0,0,0,4
,20130621,4763,4763,4695,4695,4695,4695,4695,-68,-68,2,46.95,4
,20130624,4695,4695,4800,4800,4800,4800,4800,105,105,2,48,4
,20130625,4800,4800,5028,5028,4560,4962,4744,162,-56,20,474.47,4
,20130626,4962,4744,,,,4744,4744,0,0,0,0,4
,20130627,4744,4744,,,,4744,4744,0,0,0,0,4
,20130628,4744,4744,,,,4744,4744,0,0,0,0,4
,20130701,4744,4744,,,,4744,4744,0,0,0,0,4
,20130702,4744,4744,,,,4744,4744,0,0,0,0,4
,20130703,4744,4744,,,,4744,4744,0,0,0,0,4
,20130704,4744,4744,,,,4744,4744,0,0,0,0,4
,20130705,4744,4744,,,,4744,4744,0,0,0,0,4
,20130708,4744,4744,,,,4744,4744,0,0,0,0,4
,20130709,4744,4744,,,,4744,4744,0,0,0,0,4
,20130710,4744,4744,,,,4744,4744,0,0,0,0,4
,20130711,4744,4744,,,,4744,4744,0,0,0,0,4
,20130712,4744,4744,,,,4744,4744,0,0,0,0,4
,20130715,4744,4744,,,,4744,4744,0,0,0,0,4
,20130716,4744,4744,,,,4744,4744,0,0,0,0,4
,20130717,4744,4744,,,,4744,4744,0,0,0,0,4
,20130718,4744,4744,,,,4744,4744,0,0,0,0,4
,20130719,4744,4744,,,,4744,4744,0,0,0,0,4
,20130722,4744,4744,,,,4744,4744,0,0,0,0,4
,20130723,4744,4744,4650,4650,4650,4650,4650,-94,-94,2,46.5,4
,20130724,4650,4650,4417,4879,4417,4720,4640,70,-10,12,278.41,4
,20130725,4720,4640,,,,4640,4640,0,0,0,0,4
,20130726,4640,4640,,,,4640,4640,0,0,0,0,4
,20130729,4640,4640,,,,4640,4640,0,0,0,0,4
,20130730,4640,4640,,,,4640,4640,0,0,0,0,4
,20130731,4640,4640,,,,4600,4600,-40,-40,0,0,4
,20130801,4600,4600,,,,4600,4600,0,0,0,0,4
,20130802,4600,4600,,,,4600,4600,0,0,0,0,4
,20130805,4600,4600,,,,4600,4600,0,0,0,0,4
,20130806,4600,4600,,,,4600,4600,0,0,0,0,4
,20130807,4600,4600,,,,4600,4600,0,0,0,0,4
,20130808,4600,4600,,,,4600,4600,0,0,0,0,4
,20130809,4600,4600,,,,4600,4600,0,0,0,0,4
,20130812,4600,4600,,,,4599,4599,-1,-1,0,0,4
,20130813,4599,4599,,,,4599,4599,0,0,0,0,4
,20130814,4599,4599,4599,4599,4505,4505,4552,-94,-47,4,91.04,2
,20130815,4505,4552,,,,4552,4552,0,0,0,0,2
,20130816,4552,4552,,,,4552,4552,0,0,0,0,2
,20130819,4552,4552,,,,4552,4552,0,0,0,0,2
,20130820,4552,4552,,,,4552,4552,0,0,0,0,2
,20130821,4552,4552,,,,4552,4552,0,0,0,0,2
,20130822,4552,4552,4324,4779,4324,4779,4551,227,-1,4,91.03,2
,20130823,4779,4551,4778,4778,4778,4778,4778,227,227,2,47.78,2
,20130826,4778,4778,,,,4778,4778,0,0,0,0,2
,20130827,4778,4778,,,,4778,4778,0,0,0,0,2
,20130828,4778,4778,4539,4539,4539,4539,4539,-239,-239,2,45.39,2
,20130829,4539,4539,,,,4539,4539,0,0,0,0,2
,20130830,4539,4539,,,,4539,4539,0,0,0,0,2
fu1310,20130104,4968,4968,,,,4964,4964,-4,-4,0,0,0
,20130107,4964,4964,,,,5052,5052,88,88,0,0,0
,20130108,5052,5052,,,,5029,5029,-23,-23,0,0,0
,20130109,5029,5029,,,,5029,5029,0,0,0,0,0
,20130110,5029,5029,,,,5021,5021,-8,-8,0,0,0
,20130111,5021,5021,,,,5288,5288,267,267,0,0,0
,20130114,5288,5288,,,,5297,5297,9,9,0,0,0
,20130115,5297,5297,,,,5297,5297,0,0,0,0,0
,20130116,5297,5297,,,,5301,5301,4,4,0,0,0
,20130117,5301,5301,,,,5308,5308,7,7,0,0,0
,20130118,5308,5308,,,,5273,5273,-35,-35,0,0,0
,20130121,5273,5273,,,,5302,5302,29,29,0,0,0
,20130122,5302,5302,,,,5261,5261,-41,-41,0,0,0
,20130123,5261,5261,,,,5255,5255,-6,-6,0,0,0
,20130124,5255,5255,,,,5271,5271,16,16,0,0,0
,20130125,5271,5271,,,,5324,5324,53,53,0,0,0
,20130128,5324,5324,,,,5245,5245,-79,-79,0,0,0
,20130129,5245,5245,,,,5296,5296,51,51,0,0,0
,20130130,5296,5296,,,,5355,5355,59,59,0,0,0
,20130131,5355,5355,,,,5226,5226,-129,-129,0,0,0
,20130201,5226,5226,,,,5259,5259,33,33,0,0,0
,20130204,5259,5259,,,,5378,5378,119,119,0,0,0
,20130205,5378,5378,,,,5361,5361,-17,-17,0,0,0
,20130206,5361,5361,,,,5338,5338,-23,-23,0,0,0
,20130207,5338,5338,,,,5338,5338,0,0,0,0,0
,20130208,5338,5338,,,,5295,5295,-43,-43,0,0,0
,20130218,5295,5295,,,,5296,5296,1,1,0,0,0
,20130219,5296,5296,,,,5328,5328,32,32,0,0,0
,20130220,5328,5328,,,,5425,5425,97,97,0,0,0
,20130221,5425,5425,,,,5367,5367,-58,-58,0,0,0
,20130222,5367,5367,,,,5364,5364,-3,-3,0,0,0
,20130225,5364,5364,,,,5336,5336,-28,-28,0,0,0
,20130226,5336,5336,,,,5336,5336,0,0,0,0,0
,20130227,5336,5336,,,,5358,5358,22,22,0,0,0
,20130228,5358,5358,,,,5349,5349,-9,-9,0,0,0
,20130301,5349,5349,,,,5230,5230,-119,-119,0,0,0
,20130304,5230,5230,,,,5185,5185,-45,-45,0,0,0
,20130305,5185,5185,,,,5244,5244,59,59,0,0,0
,20130306,5244,5244,,,,5237,5237,-7,-7,0,0,0
,20130307,5237,5237,,,,5242,5242,5,5,0,0,0
,20130308,5242,5242,,,,5255,5255,13,13,0,0,0
,20130311,5255,5255,,,,5251,5251,-4,-4,0,0,0
,20130312,5251,5251,,,,5242,5242,-9,-9,0,0,0
,20130313,5242,5242,,,,5183,5183,-59,-59,0,0,0
,20130314,5183,5183,,,,5181,5181,-2,-2,0,0,0
,20130315,5181,5181,,,,5177,5177,-4,-4,0,0,0
,20130318,5177,5177,,,,4968,4968,-209,-209,0,0,0
,20130319,4968,4968,,,,4825,4825,-143,-143,0,0,0
,20130320,4825,4825,,,,5066,5066,241,241,0,0,0
,20130321,5066,5066,,,,5066,5066,0,0,0,0,0
,20130322,5066,5066,,,,4978,4978,-88,-88,0,0,0
,20130325,4978,4978,,,,5067,5067,89,89,0,0,0
,20130326,5067,5067,,,,5024,5024,-43,-43,0,0,0
,20130327,5024,5024,,,,5024,5024,0,0,0,0,0
,20130328,5024,5024,,,,5024,5024,0,0,0,0,0
,20130329,5024,5024,4801,5264,4801,5264,5032,240,8,4,100.65,0
,20130401,5264,5032,,,,4900,4900,-132,-132,0,0,0
,20130402,4900,4900,,,,4900,4900,0,0,0,0,0
,20130403,4900,4900,,,,4914,4914,14,14,0,0,0
,20130408,4914,4914,,,,4914,4914,0,0,0,0,0
,20130409,4914,4914,,,,5158,5158,244,244,0,0,0
,20130410,5158,5158,,,,5158,5158,0,0,0,0,0
,20130411,5158,5158,5415,5415,5001,5027,5246,-131,88,10,262.3,2
,20130412,5027,5246,,,,5246,5246,0,0,0,0,2
,20130415,5246,5246,,,,5246,5246,0,0,0,0,2
,20130416,5246,5246,,,,5246,5246,0,0,0,0,2
,20130417,5246,5246,,,,5246,5246,0,0,0,0,2
,20130418,5246,5246,5150,5150,5150,5150,5150,-96,-96,2,51.5,2
,20130419,5150,5150,,,,5150,5150,0,0,0,0,2
,20130422,5150,5150,,,,5404,5404,254,254,0,0,2
,20130423,5404,5404,,,,5674,5674,270,270,0,0,2
,20130424,5674,5674,,,,5390,5390,-284,-284,0,0,2
,20130425,5390,5390,,,,5390,5390,0,0,0,0,2
,20130426,5390,5390,,,,5496,5496,106,106,0,0,2
,20130502,5496,5496,,,,5496,5496,0,0,0,0,2
,20130503,5496,5496,,,,5496,5496,0,0,0,0,2
,20130506,5496,5496,5221,5221,5221,5221,5221,-275,-275,2,52.21,2
,20130507,5221,5221,,,,5221,5221,0,0,0,0,2
,20130508,5221,5221,4959,5100,4959,5100,5029,-121,-192,4,100.59,0
,20130509,5100,5029,,,,5029,5029,0,0,0,0,0
,20130510,5029,5029,5280,5280,4901,4901,5090,-128,61,4,101.81,0
,20130513,4901,5090,,,,5090,5090,0,0,0,0,0
,20130514,5090,5090,,,,5090,5090,0,0,0,0,0
,20130515,5090,5090,,,,5090,5090,0,0,0,0,0
,20130516,5090,5090,,,,5090,5090,0,0,0,0,0
,20130517,5090,5090,4835,4835,4835,4835,4835,-255,-255,2,48.35,2
,20130520,4835,4835,,,,4835,4835,0,0,0,0,2
,20130521,4835,4835,,,,4835,4835,0,0,0,0,2
,20130522,4835,4835,5068,5068,5068,5068,5068,233,233,2,50.68,2
,20130523,5068,5068,4814,5253,4814,5028,5032,-40,-36,10,251.61,2
,20130524,5028,5032,,,,5032,5032,0,0,0,0,2
,20130527,5032,5032,,,,5023,5023,-9,-9,0,0,2
,20130528,5023,5023,,,,5023,5023,0,0,0,0,2
,20130529,5023,5023,,,,5023,5023,0,0,0,0,2
,20130530,5023,5023,,,,5023,5023,0,0,0,0,2
,20130531,5023,5023,5274,5274,5274,5274,5274,251,251,2,52.74,2
,20130603,5274,5274,,,,5274,5274,0,0,0,0,2
,20130604,5274,5274,,,,5274,5274,0,0,0,0,2
,20130605,5274,5274,,,,5274,5274,0,0,0,0,2
,20130606,5274,5274,,,,5042,5042,-232,-232,0,0,2
,20130607,5042,5042,,,,5042,5042,0,0,0,0,2
,20130613,5042,5042,5343,5343,4853,4860,5018,-182,-24,6,150.56,2
,20130614,4860,5018,,,,5018,5018,0,0,0,0,2
,20130617,5018,5018,,,,5018,5018,0,0,0,0,2
,20130618,5018,5018,,,,5018,5018,0,0,0,0,2
,20130619,5018,5018,,,,5018,5018,0,0,0,0,2
,20130620,5018,5018,,,,5018,5018,0,0,0,0,2
,20130621,5018,5018,4767,4767,4767,4767,4767,-251,-251,2,47.67,2
,20130624,4767,4767,,,,4767,4767,0,0,0,0,2
,20130625,4767,4767,,,,4712,4712,-55,-55,0,0,2
,20130626,4712,4712,,,,4712,4712,0,0,0,0,2
,20130627,4712,4712,,,,4712,4712,0,0,0,0,2
,20130628,4712,4712,,,,4712,4712,0,0,0,0,2
,20130701,4712,4712,,,,4712,4712,0,0,0,0,2
,20130702,4712,4712,4476,4725,4476,4725,4656,13,-56,8,186.27,2
,20130703,4725,4656,,,,4656,4656,0,0,0,0,2
,20130704,4656,4656,,,,4656,4656,0,0,0,0,2
,20130705,4656,4656,,,,4656,4656,0,0,0,0,2
,20130708,4656,4656,,,,4656,4656,0,0,0,0,2
,20130709,4656,4656,,,,4656,4656,0,0,0,0,2
,20130710,4656,4656,,,,4656,4656,0,0,0,0,2
,20130711,4656,4656,,,,4656,4656,0,0,0,0,2
,20130712,4656,4656,,,,4656,4656,0,0,0,0,2
,20130715,4656,4656,,,,4656,4656,0,0,0,0,2
,20130716,4656,4656,,,,4656,4656,0,0,0,0,2
,20130717,4656,4656,,,,4656,4656,0,0,0,0,2
,20130718,4656,4656,,,,4656,4656,0,0,0,0,2
,20130719,4656,4656,,,,4656,4656,0,0,0,0,2
,20130722,4656,4656,,,,4656,4656,0,0,0,0,2
,20130723,4656,4656,,,,4656,4656,0,0,0,0,2
,20130724,4656,4656,,,,4646,4646,-10,-10,0,0,2
,20130725,4646,4646,,,,4646,4646,0,0,0,0,2
,20130726,4646,4646,4878,4878,4878,4878,4878,232,232,2,48.78,0
,20130729,4878,4878,,,,4878,4878,0,0,0,0,0
,20130730,4878,4878,,,,4878,4878,0,0,0,0,0
,20130731,4878,4878,,,,4720,4720,-158,-158,0,0,0
,20130801,4720,4720,,,,4720,4720,0,0,0,0,0
,20130802,4720,4720,,,,4720,4720,0,0,0,0,0
,20130805,4720,4720,,,,4720,4720,0,0,0,0,0
,20130806,4720,4720,,,,4720,4720,0,0,0,0,0
,20130807,4720,4720,,,,4720,4720,0,0,0,0,0
,20130808,4720,4720,4550,4950,4493,4493,4710,-227,-10,8,188.43,2
,20130809,4493,4710,4720,4720,4720,4720,4720,10,10,2,47.2,0
,20130812,4720,4720,,,,4720,4720,0,0,0,0,0
,20130813,4720,4720,,,,4720,4720,0,0,0,0,0
,20130814,4720,4720,,,,4720,4720,0,0,0,0,0
,20130815,4720,4720,,,,4720,4720,0,0,0,0,0
,20130816,4720,4720,,,,4720,4720,0,0,0,0,0
,20130819,4720,4720,,,,4720,4720,0,0,0,0,0
,20130820,4720,4720,,,,4720,4720,0,0,0,0,0
,20130821,4720,4720,,,,4720,4720,0,0,0,0,0
,20130822,4720,4720,,,,4720,4720,0,0,0,0,0
,20130823,4720,4720,,,,4720,4720,0,0,0,0,0
,20130826,4720,4720,4484,4571,4484,4487,4506,-233,-214,22,495.73,14
,20130827,4487,4506,,,,4481,4481,-25,-25,0,0,14
,20130828,4481,4481,4467,4584,4361,4361,4469,-120,-12,10,223.46,18
,20130829,4361,4469,4430,4430,4430,4430,4430,-39,-39,2,44.3,18
,20130830,4430,4430,,,,4359,4359,-71,-71,0,0,18
,20130902,4359,4359,4299,4338,4269,4338,4302,-21,-57,6,129.06,18
,20130903,4338,4302,4399,4514,4304,4350,4377,48,75,12,262.67,20
,20130904,4350,4377,4182,4449,4158,4449,4229,72,-148,14,296.03,22
,20130905,4449,4229,4230,4298,4230,4298,4264,69,35,4,85.28,20
,20130906,4298,4264,,,,4264,4264,0,0,0,0,20
,20130909,4264,4264,4271,4271,4271,4271,4271,7,7,2,42.71,20
,20130910,4271,4271,4131,4131,4131,4131,4131,-140,-140,2,41.31,20
,20130911,4131,4131,4081,4173,4081,4173,4127,42,-4,4,82.54,20
,20130912,4173,4127,4178,4318,4178,4318,4276,191,149,8,171.04,16
,20130913,4318,4276,,,,4276,4276,0,0,0,0,16
,20130916,4276,4276,,,,4276,4276,0,0,0,0,16
,20130917,4276,4276,,,,4276,4276,0,0,0,0,16
,20130918,4276,4276,4071,4297,4071,4297,4169,21,-107,12,250.14,16
,20130923,4297,4169,4280,4280,3919,3919,4089,-250,-80,10,204.49,16
,20130924,3919,4089,3843,4328,3843,3876,4017,-213,-72,14,281.23,14
,20130925,3876,4017,,,,4017,4017,0,0,0,0,14
,20130926,4017,4017,,,,4017,4017,0,0,0,0,14
,20130927,4017,4017,,,,4017,4017,0,0,0,0,14
,20130930,4017,4017,,,,4017,4017,0,0,0,0,14
fu1311,20130104,4968,4968,,,,4964,4964,-4,-4,0,0,0
,20130107,4964,4964,,,,5052,5052,88,88,0,0,0
,20130108,5052,5052,,,,5029,5029,-23,-23,0,0,0
,20130109,5029,5029,,,,5029,5029,0,0,0,0,0
,20130110,5029,5029,,,,5021,5021,-8,-8,0,0,0
,20130111,5021,5021,,,,5288,5288,267,267,0,0,0
,20130114,5288,5288,,,,5297,5297,9,9,0,0,0
,20130115,5297,5297,,,,5297,5297,0,0,0,0,0
,20130116,5297,5297,,,,5301,5301,4,4,0,0,0
,20130117,5301,5301,,,,5308,5308,7,7,0,0,0
,20130118,5308,5308,,,,5273,5273,-35,-35,0,0,0
,20130121,5273,5273,,,,5302,5302,29,29,0,0,0
,20130122,5302,5302,,,,5261,5261,-41,-41,0,0,0
,20130123,5261,5261,,,,5255,5255,-6,-6,0,0,0
,20130124,5255,5255,,,,5271,5271,16,16,0,0,0
,20130125,5271,5271,,,,5324,5324,53,53,0,0,0
,20130128,5324,5324,,,,5245,5245,-79,-79,0,0,0
,20130129,5245,5245,,,,5296,5296,51,51,0,0,0
,20130130,5296,5296,,,,5355,5355,59,59,0,0,0
,20130131,5355,5355,,,,5226,5226,-129,-129,0,0,0
,20130201,5226,5226,,,,5259,5259,33,33,0,0,0
,20130204,5259,5259,,,,5378,5378,119,119,0,0,0
,20130205,5378,5378,,,,5361,5361,-17,-17,0,0,0
,20130206,5361,5361,,,,5338,5338,-23,-23,0,0,0
,20130207,5338,5338,,,,5338,5338,0,0,0,0,0
,20130208,5338,5338,,,,5295,5295,-43,-43,0,0,0
,20130218,5295,5295,,,,5296,5296,1,1,0,0,0
,20130219,5296,5296,,,,5328,5328,32,32,0,0,0
,20130220,5328,5328,,,,5425,5425,97,97,0,0,0
,20130221,5425,5425,,,,5367,5367,-58,-58,0,0,0
,20130222,5367,5367,,,,5364,5364,-3,-3,0,0,0
,20130225,5364,5364,,,,5336,5336,-28,-28,0,0,0
,20130226,5336,5336,,,,5336,5336,0,0,0,0,0
,20130227,5336,5336,,,,5358,5358,22,22,0,0,0
,20130228,5358,5358,,,,5349,5349,-9,-9,0,0,0
,20130301,5349,5349,,,,5230,5230,-119,-119,0,0,0
,20130304,5230,5230,,,,5185,5185,-45,-45,0,0,0
,20130305,5185,5185,,,,5244,5244,59,59,0,0,0
,20130306,5244,5244,,,,5237,5237,-7,-7,0,0,0
,20130307,5237,5237,,,,5242,5242,5,5,0,0,0
,20130308,5242,5242,,,,5255,5255,13,13,0,0,0
,20130311,5255,5255,,,,5251,5251,-4,-4,0,0,0
,20130312,5251,5251,,,,5242,5242,-9,-9,0,0,0
,20130313,5242,5242,,,,5183,5183,-59,-59,0,0,0
,20130314,5183,5183,,,,5181,5181,-2,-2,0,0,0
,20130315,5181,5181,,,,5177,5177,-4,-4,0,0,0
,20130318,5177,5177,,,,4968,4968,-209,-209,0,0,0
,20130319,4968,4968,,,,4825,4825,-143,-143,0,0,0
,20130320,4825,4825,,,,5022,5022,197,197,0,0,0
,20130321,5022,5022,,,,5022,5022,0,0,0,0,0
,20130322,5022,5022,,,,4935,4935,-87,-87,0,0,0
,20130325,4935,4935,,,,5023,5023,88,88,0,0,0
,20130326,5023,5023,,,,4980,4980,-43,-43,0,0,0
,20130327,4980,4980,,,,4980,4980,0,0,0,0,0
,20130328,4980,4980,,,,4980,4980,0,0,0,0,0
,20130329,4980,4980,4511,5300,4511,5245,5018,265,38,6,150.56,0
,20130401,5245,5018,,,,4887,4887,-131,-131,0,0,0
,20130402,4887,4887,,,,4887,4887,0,0,0,0,0
,20130403,4887,4887,,,,4901,4901,14,14,0,0,0
,20130408,4901,4901,,,,4901,4901,0,0,0,0,0
,20130409,4901,4901,,,,5144,5144,243,243,0,0,0
,20130410,5144,5144,,,,5144,5144,0,0,0,0,0
,20130411,5144,5144,,,,5144,5144,0,0,0,0,0
,20130412,5144,5144,,,,5144,5144,0,0,0,0,0
,20130415,5144,5144,,,,5138,5138,-6,-6,0,0,0
,20130416,5138,5138,,,,4888,4888,-250,-250,0,0,0
,20130417,4888,4888,,,,4764,4764,-124,-124,0,0,0
,20130418,4764,4764,,,,4676,4676,-88,-88,0,0,0
,20130419,4676,4676,,,,4739,4739,63,63,0,0,0
,20130422,4739,4739,,,,4973,4973,234,234,0,0,0
,20130423,4973,4973,,,,5221,5221,248,248,0,0,0
,20130424,5221,5221,,,,5221,5221,0,0,0,0,0
,20130425,5221,5221,,,,5221,5221,0,0,0,0,0
,20130426,5221,5221,,,,5324,5324,103,103,0,0,0
,20130502,5324,5324,,,,5324,5324,0,0,0,0,0
,20130503,5324,5324,,,,5324,5324,0,0,0,0,0
,20130506,5324,5324,,,,5057,5057,-267,-267,0,0,0
,20130507,5057,5057,,,,5057,5057,0,0,0,0,0
,20130508,5057,5057,,,,5057,5057,0,0,0,0,0
,20130509,5057,5057,,,,5057,5057,0,0,0,0,0
,20130510,5057,5057,,,,5057,5057,0,0,0,0,0
,20130513,5057,5057,,,,5057,5057,0,0,0,0,0
,20130514,5057,5057,,,,5057,5057,0,0,0,0,0
,20130515,5057,5057,,,,5057,5057,0,0,0,0,0
,20130516,5057,5057,,,,5057,5057,0,0,0,0,0
,20130517,5057,5057,,,,5057,5057,0,0,0,0,0
,20130520,5057,5057,,,,5057,5057,0,0,0,0,0
,20130521,5057,5057,,,,5057,5057,0,0,0,0,0
,20130522,5057,5057,,,,5057,5057,0,0,0,0,0
,20130523,5057,5057,5000,5000,5000,5000,5000,-57,-57,2,50,2
,20130524,5000,5000,5000,5000,5000,5000,5000,0,0,2,50,0
,20130527,5000,5000,,,,5000,5000,0,0,0,0,0
,20130528,5000,5000,,,,5000,5000,0,0,0,0,0
,20130529,5000,5000,,,,5000,5000,0,0,0,0,0
,20130530,5000,5000,,,,5000,5000,0,0,0,0,0
,20130531,5000,5000,,,,5000,5000,0,0,0,0,0
,20130603,5000,5000,,,,5000,5000,0,0,0,0,0
,20130604,5000,5000,,,,5000,5000,0,0,0,0,0
,20130605,5000,5000,,,,5000,5000,0,0,0,0,0
,20130606,5000,5000,,,,5000,5000,0,0,0,0,0
,20130607,5000,5000,,,,5000,5000,0,0,0,0,0
,20130613,5000,5000,,,,5000,5000,0,0,0,0,0
,20130614,5000,5000,,,,5000,5000,0,0,0,0,0
,20130617,5000,5000,,,,5057,5057,57,57,0,0,0
,20130618,5057,5057,,,,5057,5057,0,0,0,0,0
,20130619,5057,5057,,,,5057,5057,0,0,0,0,0
,20130620,5057,5057,,,,5057,5057,0,0,0,0,0
,20130621,5057,5057,,,,5057,5057,0,0,0,0,0
,20130624,5057,5057,,,,5170,5170,113,113,0,0,0
,20130625,5170,5170,,,,5110,5110,-60,-60,0,0,0
,20130626,5110,5110,,,,5110,5110,0,0,0,0,0
,20130627,5110,5110,,,,5110,5110,0,0,0,0,0
,20130628,5110,5110,,,,5110,5110,0,0,0,0,0
,20130701,5110,5110,5365,5365,4856,4856,5110,-254,0,12,306.63,6
,20130702,4856,5110,5080,5080,5080,5080,5080,-30,-30,6,152.4,6
,20130703,5080,5080,5099,5099,5099,5099,5099,19,19,6,152.97,0
,20130704,5099,5099,,,,5099,5099,0,0,0,0,0
,20130705,5099,5099,,,,5099,5099,0,0,0,0,0
,20130708,5099,5099,,,,5099,5099,0,0,0,0,0
,20130709,5099,5099,,,,5099,5099,0,0,0,0,0
,20130710,5099,5099,,,,5099,5099,0,0,0,0,0
,20130711,5099,5099,,,,5099,5099,0,0,0,0,0
,20130712,5099,5099,,,,5099,5099,0,0,0,0,0
,20130715,5099,5099,,,,5099,5099,0,0,0,0,0
,20130716,5099,5099,,,,5099,5099,0,0,0,0,0
,20130717,5099,5099,,,,5099,5099,0,0,0,0,0
,20130718,5099,5099,5353,5353,5353,5353,5353,254,254,2,53.53,2
,20130719,5353,5353,,,,5353,5353,0,0,0,0,2
,20130722,5353,5353,5086,5086,5086,5086,5086,-267,-267,2,50.86,2
,20130723,5086,5086,,,,5086,5086,0,0,0,0,2
,20130724,5086,5086,,,,5086,5086,0,0,0,0,2
,20130725,5086,5086,4832,4832,4832,4832,4832,-254,-254,2,48.32,2
,20130726,4832,4832,4590,4590,4590,4590,4590,-242,-242,2,45.9,0
,20130729,4590,4590,,,,4590,4590,0,0,0,0,0
,20130730,4590,4590,4360,4809,4360,4652,4607,62,17,6,138.21,0
,20130731,4652,4607,,,,4607,4607,0,0,0,0,0
,20130801,4607,4607,,,,4607,4607,0,0,0,0,0
,20130802,4607,4607,,,,4607,4607,0,0,0,0,0
,20130805,4607,4607,,,,4607,4607,0,0,0,0,0
,20130806,4607,4607,,,,4607,4607,0,0,0,0,0
,20130807,4607,4607,,,,4607,4607,0,0,0,0,0
,20130808,4607,4607,4400,4400,4400,4400,4400,-207,-207,2,44,2
,20130809,4400,4400,,,,4620,4620,220,220,0,0,2
,20130812,4620,4620,,,,4620,4620,0,0,0,0,2
,20130813,4620,4620,4851,4851,4458,4651,4679,31,59,30,701.95,4
,20130814,4651,4679,4700,4700,4700,4700,4700,21,21,2,47,2
,20130815,4700,4700,,,,4700,4700,0,0,0,0,2
,20130816,4700,4700,,,,4700,4700,0,0,0,0,2
,20130819,4700,4700,,,,4700,4700,0,0,0,0,2
,20130820,4700,4700,4700,4700,4700,4700,4700,0,0,2,47,0
,20130821,4700,4700,,,,4700,4700,0,0,0,0,0
,20130822,4700,4700,,,,4700,4700,0,0,0,0,0
,20130823,4700,4700,,,,4700,4700,0,0,0,0,0
,20130826,4700,4700,,,,4700,4700,0,0,0,0,0
,20130827,4700,4700,,,,4700,4700,0,0,0,0,0
,20130828,4700,4700,,,,4700,4700,0,0,0,0,0
,20130829,4700,4700,,,,4700,4700,0,0,0,0,0
,20130830,4700,4700,,,,4700,4700,0,0,0,0,0
,20130902,4700,4700,,,,4700,4700,0,0,0,0,0
,20130903,4700,4700,,,,4700,4700,0,0,0,0,0
,20130904,4700,4700,,,,4541,4541,-159,-159,0,0,0
,20130905,4541,4541,,,,4541,4541,0,0,0,0,0
,20130906,4541,4541,,,,4541,4541,0,0,0,0,0
,20130909,4541,4541,,,,4541,4541,0,0,0,0,0
,20130910,4541,4541,,,,4541,4541,0,0,0,0,0
,20130911,4541,4541,,,,4541,4541,0,0,0,0,0
,20130912,4541,4541,,,,4541,4541,0,0,0,0,0
,20130913,4541,4541,,,,4541,4541,0,0,0,0,0
,20130916,4541,4541,,,,4541,4541,0,0,0,0,0
,20130917,4541,4541,,,,4541,4541,0,0,0,0,0
,20130918,4541,4541,,,,4541,4541,0,0,0,0,0
,20130923,4541,4541,4268,4268,4268,4268,4268,-273,-273,2,42.68,2
,20130924,4268,4268,4011,4509,4011,4011,4177,-257,-91,6,125.31,4
,20130925,4011,4177,,,,4177,4177,0,0,0,0,4
,20130926,4177,4177,,,,4177,4177,0,0,0,0,4
,20130927,4177,4177,,,,4177,4177,0,0,0,0,4
,20130930,4177,4177,,,,4177,4177,0,0,0,0,4
,20131008,4177,4177,,,,4177,4177,0,0,0,0,4
,20131009,4177,4177,,,,4177,4177,0,0,0,0,4
,20131010,4177,4177,4177,4177,4177,4177,4177,0,0,4,83.54,4
,20131011,4177,4177,,,,4177,4177,0,0,0,0,4
,20131014,4177,4177,,,,4177,4177,0,0,0,0,4
,20131015,4177,4177,,,,4177,4177,0,0,0,0,4
,20131016,4177,4177,,,,4177,4177,0,0,0,0,4
,20131017,4177,4177,,,,4177,4177,0,0,0,0,4
,20131018,4177,4177,,,,4177,4177,0,0,0,0,4
,20131021,4177,4177,,,,4177,4177,0,0,0,0,4
,20131022,4177,4177,,,,4177,4177,0,0,0,0,4
,20131023,4177,4177,,,,3968,3968,-209,-209,0,0,4
,20131024,3968,3968,,,,3769,3769,-199,-199,0,0,4
,20131025,3769,3769,3580,3580,3580,3580,3580,-189,-189,6,107.4,2
,20131028,3580,3580,3759,3759,3759,3759,3759,179,179,2,37.59,2
,20131029,3759,3759,,,,4056,4056,297,297,0,0,2
,20131030,4056,4056,,,,4056,4056,0,0,0,0,2
,20131031,4056,4056,,,,4056,4056,0,0,0,0,2
fu1312,20130104,4968,4968,,,,4964,4964,-4,-4,0,0,0
,20130107,4964,4964,,,,5052,5052,88,88,0,0,0
,20130108,5052,5052,,,,5029,5029,-23,-23,0,0,0
,20130109,5029,5029,,,,5029,5029,0,0,0,0,0
,20130110,5029,5029,,,,5021,5021,-8,-8,0,0,0
,20130111,5021,5021,,,,5288,5288,267,267,0,0,0
,20130114,5288,5288,,,,5297,5297,9,9,0,0,0
,20130115,5297,5297,,,,5297,5297,0,0,0,0,0
,20130116,5297,5297,,,,5301,5301,4,4,0,0,0
,20130117,5301,5301,,,,5308,5308,7,7,0,0,0
,20130118,5308,5308,,,,5273,5273,-35,-35,0,0,0
,20130121,5273,5273,,,,5302,5302,29,29,0,0,0
,20130122,5302,5302,,,,5261,5261,-41,-41,0,0,0
,20130123,5261,5261,,,,5255,5255,-6,-6,0,0,0
,20130124,5255,5255,,,,5271,5271,16,16,0,0,0
,20130125,5271,5271,,,,5271,5271,0,0,0,0,0
,20130128,5271,5271,,,,5193,5193,-78,-78,0,0,0
,20130129,5193,5193,,,,5244,5244,51,51,0,0,0
,20130130,5244,5244,,,,5302,5302,58,58,0,0,0
,20130131,5302,5302,,,,5174,5174,-128,-128,0,0,0
,20130201,5174,5174,,,,5207,5207,33,33,0,0,0
,20130204,5207,5207,,,,5325,5325,118,118,0,0,0
,20130205,5325,5325,,,,5308,5308,-17,-17,0,0,0
,20130206,5308,5308,,,,5285,5285,-23,-23,0,0,0
,20130207,5285,5285,,,,5285,5285,0,0,0,0,0
,20130208,5285,5285,,,,5243,5243,-42,-42,0,0,0
,20130218,5243,5243,,,,5244,5244,1,1,0,0,0
,20130219,5244,5244,,,,5276,5276,32,32,0,0,0
,20130220,5276,5276,,,,5372,5372,96,96,0,0,0
,20130221,5372,5372,,,,5315,5315,-57,-57,0,0,0
,20130222,5315,5315,,,,5313,5313,-2,-2,0,0,0
,20130225,5313,5313,,,,5285,5285,-28,-28,0,0,0
,20130226,5285,5285,,,,5285,5285,0,0,0,0,0
,20130227,5285,5285,,,,5307,5307,22,22,0,0,0
,20130228,5307,5307,,,,5298,5298,-9,-9,0,0,0
,20130301,5298,5298,,,,5181,5181,-117,-117,0,0,0
,20130304,5181,5181,,,,5136,5136,-45,-45,0,0,0
,20130305,5136,5136,,,,5195,5195,59,59,0,0,0
,20130306,5195,5195,,,,5188,5188,-7,-7,0,0,0
,20130307,5188,5188,,,,5193,5193,5,5,0,0,0
,20130308,5193,5193,,,,5206,5206,13,13,0,0,0
,20130311,5206,5206,,,,5202,5202,-4,-4,0,0,0
,20130312,5202,5202,,,,5193,5193,-9,-9,0,0,0
,20130313,5193,5193,,,,5135,5135,-58,-58,0,0,0
,20130314,5135,5135,,,,5133,5133,-2,-2,0,0,0
,20130315,5133,5133,,,,5129,5129,-4,-4,0,0,0
,20130318,5129,5129,,,,4922,4922,-207,-207,0,0,0
,20130319,4922,4922,,,,4780,4780,-142,-142,0,0,0
,20130320,4780,4780,,,,4975,4975,195,195,0,0,0
,20130321,4975,4975,,,,4975,4975,0,0,0,0,0
,20130322,4975,4975,,,,4888,4888,-87,-87,0,0,0
,20130325,4888,4888,,,,4975,4975,87,87,0,0,0
,20130326,4975,4975,,,,4932,4932,-43,-43,0,0,0
,20130327,4932,4932,,,,4932,4932,0,0,0,0,0
,20130328,4932,4932,,,,4932,4932,0,0,0,0,0
,20130329,4932,4932,4501,5369,4501,5250,5040,318,108,6,151.2,0
,20130401,5250,5040,,,,4908,4908,-132,-132,0,0,0
,20130402,4908,4908,,,,4908,4908,0,0,0,0,0
,20130403,4908,4908,,,,4922,4922,14,14,0,0,0
,20130408,4922,4922,,,,4922,4922,0,0,0,0,0
,20130409,4922,4922,,,,5166,5166,244,244,0,0,0
,20130410,5166,5166,,,,5166,5166,0,0,0,0,0
,20130411,5166,5166,,,,5166,5166,0,0,0,0,0
,20130412,5166,5166,,,,5166,5166,0,0,0,0,0
,20130415,5166,5166,,,,5159,5159,-7,-7,0,0,0
,20130416,5159,5159,,,,4908,4908,-251,-251,0,0,0
,20130417,4908,4908,,,,4784,4784,-124,-124,0,0,0
,20130418,4784,4784,,,,4696,4696,-88,-88,0,0,0
,20130419,4696,4696,,,,4760,4760,64,64,0,0,0
,20130422,4760,4760,,,,4995,4995,235,235,0,0,0
,20130423,4995,4995,,,,5244,5244,249,249,0,0,0
,20130424,5244,5244,,,,5244,5244,0,0,0,0,0
,20130425,5244,5244,,,,5244,5244,0,0,0,0,0
,20130426,5244,5244,,,,5348,5348,104,104,0,0,0
,20130502,5348,5348,,,,5348,5348,0,0,0,0,0
,20130503,5348,5348,,,,5348,5348,0,0,0,0,0
,20130506,5348,5348,,,,5080,5080,-268,-268,0,0,0
,20130507,5080,5080,,,,5080,5080,0,0,0,0,0
,20130508,5080,5080,4826,5100,4826,5100,4963,20,-117,4,99.26,0
,20130509,5100,4963,,,,4844,4844,-119,-119,0,0,0
,20130510,4844,4844,,,,4903,4903,59,59,0,0,0
,20130513,4903,4903,,,,4931,4931,28,28,0,0,0
,20130514,4931,4931,4685,5177,4685,5177,4931,246,0,4,98.62,2
,20130515,5177,4931,,,,4934,4934,3,3,0,0,2
,20130516,4934,4934,,,,4934,4934,0,0,0,0,2
,20130517,4934,4934,,,,4687,4687,-247,-247,0,0,2
,20130520,4687,4687,,,,4695,4695,8,8,0,0,2
,20130521,4695,4695,,,,4735,4735,40,40,0,0,2
,20130522,4735,4735,,,,4963,4963,228,228,0,0,2
,20130523,4963,4963,,,,4963,4963,0,0,0,0,2
,20130524,4963,4963,,,,4963,4963,0,0,0,0,2
,20130527,4963,4963,,,,4963,4963,0,0,0,0,2
,20130528,4963,4963,,,,4756,4756,-207,-207,0,0,2
,20130529,4756,4756,,,,4520,4520,-236,-236,0,0,2
,20130530,4520,4520,,,,4746,4746,226,226,0,0,2
,20130531,4746,4746,,,,4983,4983,237,237,0,0,2
,20130603,4983,4983,,,,4983,4983,0,0,0,0,2
,20130604,4983,4983,,,,4983,4983,0,0,0,0,2
,20130605,4983,4983,,,,4983,4983,0,0,0,0,2
,20130606,4983,4983,5000,5000,5000,5000,5000,17,17,2,50,0
,20130607,5000,5000,,,,5000,5000,0,0,0,0,0
,20130613,5000,5000,,,,5000,5000,0,0,0,0,0
,20130614,5000,5000,,,,5000,5000,0,0,0,0,0
,20130617,5000,5000,,,,5000,5000,0,0,0,0,0
,20130618,5000,5000,,,,5000,5000,0,0,0,0,0
,20130619,5000,5000,,,,5000,5000,0,0,0,0,0
,20130620,5000,5000,,,,5000,5000,0,0,0,0,0
,20130621,5000,5000,4753,4753,4753,4753,4753,-247,-247,2,47.53,2
,20130624,4753,4753,,,,4859,4859,106,106,0,0,2
,20130625,4859,4859,,,,4859,4859,0,0,0,0,2
,20130626,4859,4859,,,,4859,4859,0,0,0,0,2
,20130627,4859,4859,,,,4859,4859,0,0,0,0,2
,20130628,4859,4859,,,,4859,4859,0,0,0,0,2
,20130701,4859,4859,,,,4859,4859,0,0,0,0,2
,20130702,4859,4859,,,,4859,4859,0,0,0,0,2
,20130703,4859,4859,,,,4859,4859,0,0,0,0,2
,20130704,4859,4859,,,,4859,4859,0,0,0,0,2
,20130705,4859,4859,,,,4859,4859,0,0,0,0,2
,20130708,4859,4859,,,,4859,4859,0,0,0,0,2
,20130709,4859,4859,,,,4859,4859,0,0,0,0,2
,20130710,4859,4859,,,,4859,4859,0,0,0,0,2
,20130711,4859,4859,,,,4859,4859,0,0,0,0,2
,20130712,4859,4859,,,,4859,4859,0,0,0,0,2
,20130715,4859,4859,4700,4700,4700,4700,4700,-159,-159,2,47,0
,20130716,4700,4700,,,,4700,4700,0,0,0,0,0
,20130717,4700,4700,,,,4700,4700,0,0,0,0,0
,20130718,4700,4700,,,,4934,4934,234,234,0,0,0
,20130719,4934,4934,,,,4934,4934,0,0,0,0,0
,20130722,4934,4934,,,,4934,4934,0,0,0,0,0
,20130723,4934,4934,,,,4934,4934,0,0,0,0,0
,20130724,4934,4934,5180,5180,4705,4705,4942,-229,8,4,98.85,0
,20130725,4705,4942,,,,4942,4942,0,0,0,0,0
,20130726,4942,4942,5189,5189,4695,4695,4942,-247,0,4,98.84,0
,20130729,4695,4942,,,,4942,4942,0,0,0,0,0
,20130730,4942,4942,,,,4942,4942,0,0,0,0,0
,20130731,4942,4942,,,,4941,4941,-1,-1,0,0,0
,20130801,4941,4941,,,,4941,4941,0,0,0,0,0
,20130802,4941,4941,,,,4941,4941,0,0,0,0,0
,20130805,4941,4941,,,,4941,4941,0,0,0,0,0
,20130806,4941,4941,,,,4941,4941,0,0,0,0,0
,20130807,4941,4941,,,,4941,4941,0,0,0,0,0
,20130808,4941,4941,,,,4941,4941,0,0,0,0,0
,20130809,4941,4941,,,,4941,4941,0,0,0,0,0
,20130812,4941,4941,,,,4941,4941,0,0,0,0,0
,20130813,4941,4941,,,,4941,4941,0,0,0,0,0
,20130814,4941,4941,,,,4941,4941,0,0,0,0,0
,20130815,4941,4941,,,,4941,4941,0,0,0,0,0
,20130816,4941,4941,,,,4941,4941,0,0,0,0,0
,20130819,4941,4941,,,,4941,4941,0,0,0,0,0
,20130820,4941,4941,,,,4941,4941,0,0,0,0,0
,20130821,4941,4941,,,,4941,4941,0,0,0,0,0
,20130822,4941,4941,,,,4941,4941,0,0,0,0,0
,20130823,4941,4941,,,,4941,4941,0,0,0,0,0
,20130826,4941,4941,4693,4693,4693,4693,4693,-248,-248,2,46.93,2
,20130827,4693,4693,,,,4693,4693,0,0,0,0,2
,20130828,4693,4693,4760,4870,4467,4870,4665,177,-28,10,233.29,6
,20130829,4870,4665,4672,4672,4672,4672,4672,7,7,2,46.72,4
,20130830,4672,4672,,,,4672,4672,0,0,0,0,4
,20130902,4672,4672,4905,4905,4905,4905,4905,233,233,2,49.05,4
,20130903,4905,4905,,,,4991,4991,86,86,0,0,4
,20130904,4991,4991,,,,4822,4822,-169,-169,0,0,4
,20130905,4822,4822,,,,4861,4861,39,39,0,0,4
,20130906,4861,4861,,,,4861,4861,0,0,0,0,4
,20130909,4861,4861,,,,4861,4861,0,0,0,0,4
,20130910,4861,4861,,,,4861,4861,0,0,0,0,4
,20130911,4861,4861,5102,5102,4617,4617,4778,-244,-83,6,143.36,6
,20130912,4617,4778,4541,4541,4540,4540,4540,-238,-238,4,90.81,10
,20130913,4540,4540,4334,4578,4334,4578,4456,38,-84,4,89.12,10
,20130916,4578,4456,,,,4456,4456,0,0,0,0,10
,20130917,4456,4456,,,,4456,4456,0,0,0,0,10
,20130918,4456,4456,4458,4458,4458,4458,4458,2,2,2,44.58,12
,20130923,4458,4458,,,,4458,4458,0,0,0,0,12
,20130924,4458,4458,4190,4190,4190,4190,4190,-268,-268,4,83.8,16
,20130925,4190,4190,,,,4139,4139,-51,-51,0,0,16
,20130926,4139,4139,3916,4202,3906,3906,4063,-233,-76,10,203.18,20
,20130927,3906,4063,4063,4063,4063,4063,4063,0,0,4,81.26,16
,20130930,4063,4063,3800,3800,3800,3800,3800,-263,-263,2,38,14
,20131008,3800,3800,4065,4065,4065,4065,4065,265,265,2,40.65,14
,20131009,4065,4065,,,,4065,4065,0,0,0,0,14
,20131010,4065,4065,4189,4189,4189,4189,4189,124,124,4,83.78,14
,20131011,4189,4189,,,,4189,4189,0,0,0,0,14
,20131014,4189,4189,,,,4189,4189,0,0,0,0,14
,20131015,4189,4189,,,,4189,4189,0,0,0,0,14
,20131016,4189,4189,,,,4189,4189,0,0,0,0,14
,20131017,4189,4189,,,,4189,4189,0,0,0,0,14
,20131018,4189,4189,,,,4189,4189,0,0,0,0,14
,20131021,4189,4189,,,,4189,4189,0,0,0,0,14
,20131022,4189,4189,,,,4189,4189,0,0,0,0,14
,20131023,4189,4189,,,,4189,4189,0,0,0,0,14
,20131024,4189,4189,,,,4189,4189,0,0,0,0,14
,20131025,4189,4189,,,,3979,3979,-210,-210,0,0,14
,20131028,3979,3979,,,,4177,4177,198,198,0,0,14
,20131029,4177,4177,3968,3968,3968,3968,3968,-209,-209,2,39.68,12
,20131030,3968,3968,,,,3968,3968,0,0,0,0,12
,20131031,3968,3968,,,,3959,3959,-9,-9,0,0,12
,20131101,3959,3959,3955,3955,3764,3764,3891,-195,-68,6,116.74,12
,20131104,3764,3891,,,,3891,3891,0,0,0,0,12
,20131105,3891,3891,,,,3698,3698,-193,-193,0,0,12
,20131106,3698,3698,,,,3698,3698,0,0,0,0,12
,20131107,3698,3698,3762,3762,3762,3762,3762,64,64,2,37.62,10
,20131108,3762,3762,3799,3799,3799,3799,3799,37,37,2,37.99,10
,20131111,3799,3799,3609,3609,3609,3609,3609,-190,-190,2,36.09,10
,20131112,3609,3609,3789,3789,3789,3789,3789,180,180,4,75.78,6
,20131113,3789,3789,,,,3789,3789,0,0,0,0,6
,20131114,3789,3789,,,,3789,3789,0,0,0,0,6
,20131115,3789,3789,3978,3978,3599,3599,3788,-190,-1,4,75.77,6
,20131118,3599,3788,,,,3788,3788,0,0,0,0,6
,20131119,3788,3788,,,,3788,3788,0,0,0,0,6
,20131120,3788,3788,3598,3598,3598,3598,3598,-190,-190,4,71.96,6
,20131121,3598,3598,,,,3598,3598,0,0,0,0,6
,20131122,3598,3598,,,,3598,3598,0,0,0,0,6
,20131125,3598,3598,,,,3598,3598,0,0,0,0,6
,20131126,3598,3598,,,,3598,3598,0,0,0,0,6
,20131127,3598,3598,,,,3598,3598,0,0,0,0,6
,20131128,3598,3598,,,,3598,3598,0,0,0,0,6
,20131129,3598,3598,,,,3598,3598,0,0,0,0,6
fu1402,20130201,5174,5174,,,,5207,5207,33,33,0,0,0
,20130204,5207,5207,,,,5325,5325,118,118,0,0,0
,20130205,5325,5325,,,,5308,5308,-17,-17,0,0,0
,20130206,5308,5308,,,,5285,5285,-23,-23,0,0,0
,20130207,5285,5285,,,,5285,5285,0,0,0,0,0
,20130208,5285,5285,,,,5243,5243,-42,-42,0,0,0
,20130218,5243,5243,,,,5244,5244,1,1,0,0,0
,20130219,5244,5244,,,,5276,5276,32,32,0,0,0
,20130220,5276,5276,,,,5372,5372,96,96,0,0,0
,20130221,5372,5372,,,,5315,5315,-57,-57,0,0,0
,20130222,5315,5315,,,,5313,5313,-2,-2,0,0,0
,20130225,5313,5313,,,,5285,5285,-28,-28,0,0,0
,20130226,5285,5285,,,,5285,5285,0,0,0,0,0
,20130227,5285,5285,,,,5307,5307,22,22,0,0,0
,20130228,5307,5307,,,,5298,5298,-9,-9,0,0,0
,20130301,5298,5298,,,,5298,5298,0,0,0,0,0
,20130304,5298,5298,,,,5252,5252,-46,-46,0,0,0
,20130305,5252,5252,,,,5312,5312,60,60,0,0,0
,20130306,5312,5312,,,,5305,5305,-7,-7,0,0,0
,20130307,5305,5305,,,,5310,5310,5,5,0,0,0
,20130308,5310,5310,,,,5323,5323,13,13,0,0,0
,20130311,5323,5323,,,,5319,5319,-4,-4,0,0,0
,20130312,5319,5319,,,,5310,5310,-9,-9,0,0,0
,20130313,5310,5310,,,,5251,5251,-59,-59,0,0,0
,20130314,5251,5251,,,,5249,5249,-2,-2,0,0,0
,20130315,5249,5249,,,,5245,5245,-4,-4,0,0,0
,20130318,5245,5245,,,,5033,5033,-212,-212,0,0,0
,20130319,5033,5033,,,,4888,4888,-145,-145,0,0,0
,20130320,4888,4888,,,,5087,5087,199,199,0,0,0
,20130321,5087,5087,,,,5087,5087,0,0,0,0,0
,20130322,5087,5087,,,,4999,4999,-88,-88,0,0,0
,20130325,4999,4999,,,,5088,5088,89,89,0,0,0
,20130326,5088,5088,,,,5044,5044,-44,-44,0,0,0
,20130327,5044,5044,,,,5044,5044,0,0,0,0,0
,20130328,5044,5044,,,,5044,5044,0,0,0,0,0
,20130329,5044,5044,,,,5044,5044,0,0,0,0,0
,20130401,5044,5044,,,,4912,4912,-132,-132,0,0,0
,20130402,4912,4912,,,,4912,4912,0,0,0,0,0
,20130403,4912,4912,,,,4912,4912,0,0,0,0,0
,20130408,4912,4912,5402,5402,5101,5180,5227,268,315,6,156.83,4
,20130409,5180,5227,,,,5227,5227,0,0,0,0,4
,20130410,5227,5227,,,,5227,5227,0,0,0,0,4
,20130411,5227,5227,,,,5227,5227,0,0,0,0,4
,20130412,5227,5227,,,,5227,5227,0,0,0,0,4
,20130415,5227,5227,,,,5227,5227,0,0,0,0,4
,20130416,5227,5227,,,,5227,5227,0,0,0,0,4
,20130417,5227,5227,5111,5111,5111,5111,5111,-116,-116,2,51.11,2
,20130418,5111,5111,,,,5111,5111,0,0,0,0,2
,20130419,5111,5111,5119,5119,4901,4901,5010,-210,-101,4,100.2,0
,20130422,4901,5010,,,,5257,5257,247,247,0,0,0
,20130423,5257,5257,,,,5519,5519,262,262,0,0,0
,20130424,5519,5519,5243,5243,5243,5243,5243,-276,-276,2,52.43,2
,20130425,5243,5243,,,,5243,5243,0,0,0,0,2
,20130426,5243,5243,,,,5347,5347,104,104,0,0,2
,20130502,5347,5347,,,,5347,5347,0,0,0,0,2
,20130503,5347,5347,,,,5347,5347,0,0,0,0,2
,20130506,5347,5347,,,,5079,5079,-268,-268,0,0,2
,20130507,5079,5079,,,,5079,5079,0,0,0,0,2
,20130508,5079,5079,,,,5079,5079,0,0,0,0,2
,20130509,5079,5079,,,,5079,5079,0,0,0,0,2
,20130510,5079,5079,,,,5079,5079,0,0,0,0,2
,20130513,5079,5079,,,,5079,5079,0,0,0,0,2
,20130514,5079,5079,,,,5079,5079,0,0,0,0,2
,20130515,5079,5079,,,,5082,5082,3,3,0,0,2
,20130516,5082,5082,,,,5082,5082,0,0,0,0,2
,20130517,5082,5082,,,,4827,4827,-255,-255,0,0,2
,20130520,4827,4827,,,,4835,4835,8,8,0,0,2
,20130521,4835,4835,,,,4877,4877,42,42,0,0,2
,20130522,4877,4877,,,,5112,5112,235,235,0,0,2
,20130523,5112,5112,,,,5112,5112,0,0,0,0,2
,20130524,5112,5112,,,,5112,5112,0,0,0,0,2
,20130527,5112,5112,,,,5112,5112,0,0,0,0,2
,20130528,5112,5112,,,,4899,4899,-213,-213,0,0,2
,20130529,4899,4899,,,,4656,4656,-243,-243,0,0,2
,20130530,4656,4656,,,,4888,4888,232,232,0,0,2
,20130531,4888,4888,,,,5132,5132,244,244,0,0,2
,20130603,5132,5132,,,,5132,5132,0,0,0,0,2
,20130604,5132,5132,,,,5132,5132,0,0,0,0,2
,20130605,5132,5132,,,,5132,5132,0,0,0,0,2
,20130606,5132,5132,4930,5012,4930,5012,4971,-120,-161,12,298.26,2
,20130607,5012,4971,,,,4971,4971,0,0,0,0,2
,20130613,4971,4971,,,,4971,4971,0,0,0,0,2
,20130614,4971,4971,5000,5000,5000,5000,5000,29,29,2,50,2
,20130617,5000,5000,,,,5000,5000,0,0,0,0,2
,20130618,5000,5000,,,,5000,5000,0,0,0,0,2
,20130619,5000,5000,,,,5000,5000,0,0,0,0,2
,20130620,5000,5000,,,,5000,5000,0,0,0,0,2
,20130621,5000,5000,5250,5250,5050,5050,5150,50,150,4,103,2
,20130624,5050,5150,5407,5407,5043,5043,5225,-107,75,4,104.5,2
,20130625,5043,5225,,,,5225,5225,0,0,0,0,2
,20130626,5225,5225,,,,5225,5225,0,0,0,0,2
,20130627,5225,5225,,,,5225,5225,0,0,0,0,2
,20130628,5225,5225,,,,5225,5225,0,0,0,0,2
,20130701,5225,5225,,,,5225,5225,0,0,0,0,2
,20130702,5225,5225,,,,5194,5194,-31,-31,0,0,2
,20130703,5194,5194,,,,5194,5194,0,0,0,0,2
,20130704,5194,5194,,,,5194,5194,0,0,0,0,2
,20130705,5194,5194,,,,5194,5194,0,0,0,0,2
,20130708,5194,5194,,,,5194,5194,0,0,0,0,2
,20130709,5194,5194,,,,5194,5194,0,0,0,0,2
,20130710,5194,5194,,,,5194,5194,0,0,0,0,2
,20130711,5194,5194,,,,5194,5194,0,0,0,0,2
,20130712,5194,5194,,,,5194,5194,0,0,0,0,2
,20130715,5194,5194,,,,5194,5194,0,0,0,0,2
,20130716,5194,5194,,,,5194,5194,0,0,0,0,2
,20130717,5194,5194,,,,5194,5194,0,0,0,0,2
,20130718,5194,5194,,,,5452,5452,258,258,0,0,2
,20130719,5452,5452,,,,5452,5452,0,0,0,0,2
,20130722,5452,5452,,,,5180,5180,-272,-272,0,0,2
,20130723,5180,5180,,,,5077,5077,-103,-103,0,0,2
,20130724,5077,5077,,,,5077,5077,0,0,0,0,2
,20130725,5077,5077,,,,5077,5077,0,0,0,0,2
,20130726,5077,5077,,,,5077,5077,0,0,0,0,2
,20130729,5077,5077,,,,5077,5077,0,0,0,0,2
,20130730,5077,5077,,,,5077,5077,0,0,0,0,2
,20130731,5077,5077,,,,5077,5077,0,0,0,0,2
,20130801,5077,5077,,,,5077,5077,0,0,0,0,2
,20130802,5077,5077,,,,5077,5077,0,0,0,0,2
,20130805,5077,5077,,,,5077,5077,0,0,0,0,2
,20130806,5077,5077,,,,5077,5077,0,0,0,0,2
,20130807,5077,5077,,,,5077,5077,0,0,0,0,2
,20130808,5077,5077,,,,5077,5077,0,0,0,0,2
,20130809,5077,5077,,,,5077,5077,0,0,0,0,2
,20130812,5077,5077,,,,5077,5077,0,0,0,0,2
,20130813,5077,5077,,,,5077,5077,0,0,0,0,2
,20130814,5077,5077,,,,5077,5077,0,0,0,0,2
,20130815,5077,5077,,,,5077,5077,0,0,0,0,2
,20130816,5077,5077,,,,5077,5077,0,0,0,0,2
,20130819,5077,5077,,,,5077,5077,0,0,0,0,2
,20130820,5077,5077,,,,5077,5077,0,0,0,0,2
,20130821,5077,5077,,,,5077,5077,0,0,0,0,2
,20130822,5077,5077,,,,4872,4872,-205,-205,0,0,2
,20130823,4872,4872,,,,4872,4872,0,0,0,0,2
,20130826,4872,4872,,,,4872,4872,0,0,0,0,2
,20130827,4872,4872,,,,4872,4872,0,0,0,0,2
,20130828,4872,4872,5115,5115,4682,4747,4876,-125,4,64,"1,560.49",4
,20130829,4747,4876,,,,4719,4719,-157,-157,0,0,4
,20130830,4719,4719,4719,4954,4698,4698,4790,-21,71,6,143.71,2
,20130902,4698,4790,,,,4709,4709,-81,-81,0,0,2
,20130903,4709,4709,,,,4709,4709,0,0,0,0,2
,20130904,4709,4709,,,,4549,4549,-160,-160,0,0,2
,20130905,4549,4549,,,,4549,4549,0,0,0,0,2
,20130906,4549,4549,,,,4549,4549,0,0,0,0,2
,20130909,4549,4549,,,,4556,4556,7,7,0,0,2
,20130910,4556,4556,,,,4406,4406,-150,-150,0,0,2
,20130911,4406,4406,,,,4331,4331,-75,-75,0,0,2
,20130912,4331,4331,,,,4115,4115,-216,-216,0,0,2
,20130913,4115,4115,,,,4038,4038,-77,-77,0,0,2
,20130916,4038,4038,,,,4239,4239,201,201,0,0,2
,20130917,4239,4239,,,,4450,4450,211,211,0,0,2
,20130918,4450,4450,,,,4451,4451,1,1,0,0,2
,20130923,4451,4451,,,,4183,4183,-268,-268,0,0,2
,20130924,4183,4183,,,,3932,3932,-251,-251,0,0,2
,20130925,3932,3932,,,,4167,4167,235,235,0,0,2
,20130926,4167,4167,,,,4091,4091,-76,-76,0,0,2
,20130927,4091,4091,,,,4091,4091,0,0,0,0,2
,20130930,4091,4091,,,,3826,3826,-265,-265,0,0,2
,20131008,3826,3826,,,,4092,4092,266,266,0,0,2
,20131009,4092,4092,,,,4092,4092,0,0,0,0,2
,20131010,4092,4092,,,,4092,4092,0,0,0,0,2
,20131011,4092,4092,,,,4092,4092,0,0,0,0,2
,20131014,4092,4092,,,,4092,4092,0,0,0,0,2
,20131015,4092,4092,,,,4092,4092,0,0,0,0,2
,20131016,4092,4092,,,,4092,4092,0,0,0,0,2
,20131017,4092,4092,,,,4092,4092,0,0,0,0,2
,20131018,4092,4092,,,,4092,4092,0,0,0,0,2
,20131021,4092,4092,,,,4092,4092,0,0,0,0,2
,20131022,4092,4092,,,,4092,4092,0,0,0,0,2
,20131023,4092,4092,,,,4092,4092,0,0,0,0,2
,20131024,4092,4092,,,,4092,4092,0,0,0,0,2
,20131025,4092,4092,3960,3960,3960,3960,3960,-132,-132,2,39.6,2
,20131028,3960,3960,,,,3960,3960,0,0,0,0,2
,20131029,3960,3960,,,,3960,3960,0,0,0,0,2
,20131030,3960,3960,4158,4158,4158,4158,4158,198,198,4,83.16,6
,20131031,4158,4158,,,,4157,4157,-1,-1,0,0,6
,20131101,4157,4157,,,,4157,4157,0,0,0,0,6
,20131104,4157,4157,,,,4150,4150,-7,-7,0,0,6
,20131105,4150,4150,,,,4150,4150,0,0,0,0,6
,20131106,4150,4150,4150,4150,4150,4150,4150,0,0,2,41.5,8
,20131107,4150,4150,3942,3942,3942,3942,3942,-208,-208,2,39.42,8
,20131108,3942,3942,,,,3942,3942,0,0,0,0,8
,20131111,3942,3942,,,,3942,3942,0,0,0,0,8
,20131112,3942,3942,4139,4139,3744,3942,3941,0,-1,6,118.25,8
,20131113,3942,3941,,,,3941,3941,0,0,0,0,8
,20131114,3941,3941,,,,3941,3941,0,0,0,0,8
,20131115,3941,3941,,,,3941,3941,0,0,0,0,8
,20131118,3941,3941,,,,3941,3941,0,0,0,0,8
,20131119,3941,3941,,,,3941,3941,0,0,0,0,8
,20131120,3941,3941,,,,3941,3941,0,0,0,0,8
,20131121,3941,3941,,,,3941,3941,0,0,0,0,8
,20131122,3941,3941,,,,3941,3941,0,0,0,0,8
,20131125,3941,3941,,,,3941,3941,0,0,0,0,8
,20131126,3941,3941,,,,3941,3941,0,0,0,0,8
,20131127,3941,3941,,,,3941,3941,0,0,0,0,8
,20131128,3941,3941,,,,3941,3941,0,0,0,0,8
,20131129,3941,3941,,,,3941,3941,0,0,0,0,8
,20131202,3941,3941,,,,3941,3941,0,0,0,0,8
,20131203,3941,3941,,,,3941,3941,0,0,0,0,8
,20131204,3941,3941,,,,3941,3941,0,0,0,0,8
,20131205,3941,3941,,,,3941,3941,0,0,0,0,8
,20131206,3941,3941,,,,3941,3941,0,0,0,0,8
,20131209,3941,3941,,,,3941,3941,0,0,0,0,8
,20131210,3941,3941,,,,3941,3941,0,0,0,0,8
,20131211,3941,3941,,,,3941,3941,0,0,0,0,8
,20131212,3941,3941,,,,3941,3941,0,0,0,0,8
,20131213,3941,3941,,,,3941,3941,0,0,0,0,8
,20131216,3941,3941,,,,3941,3941,0,0,0,0,8
,20131217,3941,3941,,,,3941,3941,0,0,0,0,8
,20131218,3941,3941,,,,3941,3941,0,0,0,0,8
,20131219,3941,3941,,,,3941,3941,0,0,0,0,8
,20131220,3941,3941,,,,3941,3941,0,0,0,0,8
,20131223,3941,3941,3800,3800,3800,3800,3800,-141,-141,2,38,6
,20131224,3800,3800,,,,3800,3800,0,0,0,0,6
,20131225,3800,3800,,,,3800,3800,0,0,0,0,6
,20131226,3800,3800,,,,3800,3800,0,0,0,0,6
,20131227,3800,3800,,,,3800,3800,0,0,0,0,6
,20131230,3800,3800,,,,3800,3800,0,0,0,0,6
,20131231,3800,3800,,,,3800,3800,0,0,0,0,6
fu1403,20130301,5298,5298,,,,5181,5181,-117,-117,0,0,0
,20130304,5181,5181,,,,5136,5136,-45,-45,0,0,0
,20130305,5136,5136,,,,5195,5195,59,59,0,0,0
,20130306,5195,5195,,,,5188,5188,-7,-7,0,0,0
,20130307,5188,5188,,,,5193,5193,5,5,0,0,0
,20130308,5193,5193,,,,5206,5206,13,13,0,0,0
,20130311,5206,5206,,,,5202,5202,-4,-4,0,0,0
,20130312,5202,5202,,,,5193,5193,-9,-9,0,0,0
,20130313,5193,5193,,,,5135,5135,-58,-58,0,0,0
,20130314,5135,5135,,,,5133,5133,-2,-2,0,0,0
,20130315,5133,5133,,,,5129,5129,-4,-4,0,0,0
,20130318,5129,5129,,,,4922,4922,-207,-207,0,0,0
,20130319,4922,4922,,,,4780,4780,-142,-142,0,0,0
,20130320,4780,4780,,,,4975,4975,195,195,0,0,0
,20130321,4975,4975,,,,4975,4975,0,0,0,0,0
,20130322,4975,4975,4478,5471,4477,5121,5020,146,45,14,351.42,0
,20130325,5121,5020,,,,5110,5110,90,90,0,0,0
,20130326,5110,5110,,,,5066,5066,-44,-44,0,0,0
,20130327,5066,5066,,,,5066,5066,0,0,0,0,0
,20130328,5066,5066,,,,5066,5066,0,0,0,0,0
,20130329,5066,5066,,,,5176,5176,110,110,0,0,0
,20130401,5176,5176,,,,5040,5040,-136,-136,0,0,0
,20130402,5040,5040,,,,5040,5040,0,0,0,0,0
,20130403,5040,5040,,,,5054,5054,14,14,0,0,0
,20130408,5054,5054,,,,5357,5357,303,303,0,0,0
,20130409,5357,5357,,,,5623,5623,266,266,0,0,0
,20130410,5623,5623,,,,5623,5623,0,0,0,0,0
,20130411,5623,5623,,,,5718,5718,95,95,0,0,0
,20130412,5718,5718,,,,5432,5432,-286,-286,0,0,0
,20130415,5432,5432,,,,5425,5425,-7,-7,0,0,0
,20130416,5425,5425,,,,5162,5162,-263,-263,0,0,0
,20130417,5162,5162,,,,5047,5047,-115,-115,0,0,0
,20130418,5047,5047,,,,4954,4954,-93,-93,0,0,0
,20130419,4954,4954,,,,4856,4856,-98,-98,0,0,0
,20130422,4856,4856,,,,5096,5096,240,240,0,0,0
,20130423,5096,5096,,,,5350,5350,254,254,0,0,0
,20130424,5350,5350,,,,5082,5082,-268,-268,0,0,0
,20130425,5082,5082,,,,5082,5082,0,0,0,0,0
,20130426,5082,5082,,,,5182,5182,100,100,0,0,0
,20130502,5182,5182,,,,5182,5182,0,0,0,0,0
,20130503,5182,5182,,,,5182,5182,0,0,0,0,0
,20130506,5182,5182,,,,4922,4922,-260,-260,0,0,0
,20130507,4922,4922,,,,4922,4922,0,0,0,0,0
,20130508,4922,4922,,,,4808,4808,-114,-114,0,0,0
,20130509,4808,4808,,,,4693,4693,-115,-115,0,0,0
,20130510,4693,4693,,,,4750,4750,57,57,0,0,0
,20130513,4750,4750,,,,4777,4777,27,27,0,0,0
,20130514,4777,4777,,,,4777,4777,0,0,0,0,0
,20130515,4777,4777,,,,4779,4779,2,2,0,0,0
,20130516,4779,4779,,,,4779,4779,0,0,0,0,0
,20130517,4779,4779,,,,4540,4540,-239,-239,0,0,0
,20130520,4540,4540,,,,4767,4767,227,227,0,0,0
,20130521,4767,4767,,,,4808,4808,41,41,0,0,0
,20130522,4808,4808,,,,5039,5039,231,231,0,0,0
,20130523,5039,5039,,,,4982,4982,-57,-57,0,0,0
,20130524,4982,4982,,,,4982,4982,0,0,0,0,0
,20130527,4982,4982,,,,4982,4982,0,0,0,0,0
,20130528,4982,4982,,,,4774,4774,-208,-208,0,0,0
,20130529,4774,4774,,,,4537,4537,-237,-237,0,0,0
,20130530,4537,4537,,,,4537,4537,0,0,0,0,0
,20130531,4537,4537,,,,4763,4763,226,226,0,0,0
,20130603,4763,4763,,,,4763,4763,0,0,0,0,0
,20130604,4763,4763,,,,4763,4763,0,0,0,0,0
,20130605,4763,4763,,,,4763,4763,0,0,0,0,0
,20130606,4763,4763,,,,4613,4613,-150,-150,0,0,0
,20130607,4613,4613,,,,4626,4626,13,13,0,0,0
,20130613,4626,4626,,,,4604,4604,-22,-22,0,0,0
,20130614,4604,4604,,,,4630,4630,26,26,0,0,0
,20130617,4630,4630,,,,4683,4683,53,53,0,0,0
,20130618,4683,4683,,,,4682,4682,-1,-1,0,0,0
,20130619,4682,4682,,,,4619,4619,-63,-63,0,0,0
,20130620,4619,4619,,,,4619,4619,0,0,0,0,0
,20130621,4619,4619,,,,4757,4757,138,138,0,0,0
,20130624,4757,4757,,,,4826,4826,69,69,0,0,0
,20130625,4826,4826,,,,4770,4770,-56,-56,0,0,0
,20130626,4770,4770,,,,4770,4770,0,0,0,0,0
,20130627,4770,4770,,,,4770,4770,0,0,0,0,0
,20130628,4770,4770,,,,4770,4770,0,0,0,0,0
,20130701,4770,4770,,,,4770,4770,0,0,0,0,0
,20130702,4770,4770,,,,4741,4741,-29,-29,0,0,0
,20130703,4741,4741,,,,4758,4758,17,17,0,0,0
,20130704,4758,4758,,,,4758,4758,0,0,0,0,0
,20130705,4758,4758,,,,4758,4758,0,0,0,0,0
,20130708,4758,4758,,,,4758,4758,0,0,0,0,0
,20130709,4758,4758,,,,4758,4758,0,0,0,0,0
,20130710,4758,4758,,,,4758,4758,0,0,0,0,0
,20130711,4758,4758,,,,4758,4758,0,0,0,0,0
,20130712,4758,4758,,,,4758,4758,0,0,0,0,0
,20130715,4758,4758,,,,4602,4602,-156,-156,0,0,0
,20130716,4602,4602,,,,4602,4602,0,0,0,0,0
,20130717,4602,4602,,,,4602,4602,0,0,0,0,0
,20130718,4602,4602,,,,4831,4831,229,229,0,0,0
,20130719,4831,4831,,,,4831,4831,0,0,0,0,0
,20130722,4831,4831,,,,4590,4590,-241,-241,0,0,0
,20130723,4590,4590,,,,4499,4499,-91,-91,0,0,0
,20130724,4499,4499,,,,4506,4506,7,7,0,0,0
,20130725,4506,4506,,,,4280,4280,-226,-226,0,0,0
,20130726,4280,4280,,,,4280,4280,0,0,0,0,0
,20130729,4280,4280,,,,4494,4494,214,214,0,0,0
,20130730,4494,4494,,,,4510,4510,16,16,0,0,0
,20130731,4510,4510,,,,4510,4510,0,0,0,0,0
,20130801,4510,4510,,,,4510,4510,0,0,0,0,0
,20130802,4510,4510,4516,4735,4516,4735,4680,225,170,8,187.21,0
,20130805,4735,4680,,,,4680,4680,0,0,0,0,0
,20130806,4680,4680,,,,4680,4680,0,0,0,0,0
,20130807,4680,4680,,,,4680,4680,0,0,0,0,0
,20130808,4680,4680,,,,4469,4469,-211,-211,0,0,0
,20130809,4469,4469,,,,4478,4478,9,9,0,0,0
,20130812,4478,4478,,,,4478,4478,0,0,0,0,0
,20130813,4478,4478,,,,4535,4535,57,57,0,0,0
,20130814,4535,4535,,,,4555,4555,20,20,0,0,0
,20130815,4555,4555,,,,4782,4782,227,227,0,0,0
,20130816,4782,4782,,,,4782,4782,0,0,0,0,0
,20130819,4782,4782,,,,4796,4796,14,14,0,0,0
,20130820,4796,4796,,,,4796,4796,0,0,0,0,0
,20130821,4796,4796,4820,4820,4820,4820,4820,24,24,2,48.2,2
,20130822,4820,4820,,,,4820,4820,0,0,0,0,2
,20130823,4820,4820,,,,4820,4820,0,0,0,0,2
,20130826,4820,4820,,,,4820,4820,0,0,0,0,2
,20130827,4820,4820,,,,4820,4820,0,0,0,0,2
,20130828,4820,4820,,,,4820,4820,0,0,0,0,2
,20130829,4820,4820,,,,4820,4820,0,0,0,0,2
,20130830,4820,4820,,,,4820,4820,0,0,0,0,2
,20130902,4820,4820,,,,4820,4820,0,0,0,0,2
,20130903,4820,4820,,,,4820,4820,0,0,0,0,2
,20130904,4820,4820,,,,4820,4820,0,0,0,0,2
,20130905,4820,4820,,,,4820,4820,0,0,0,0,2
,20130906,4820,4820,,,,4820,4820,0,0,0,0,2
,20130909,4820,4820,,,,4820,4820,0,0,0,0,2
,20130910,4820,4820,,,,4820,4820,0,0,0,0,2
,20130911,4820,4820,5061,5061,4579,4579,4820,-241,0,4,96.4,2
,20130912,4579,4820,,,,4820,4820,0,0,0,0,2
,20130913,4820,4820,,,,4820,4820,0,0,0,0,2
,20130916,4820,4820,,,,4820,4820,0,0,0,0,2
,20130917,4820,4820,,,,4820,4820,0,0,0,0,2
,20130918,4820,4820,,,,4820,4820,0,0,0,0,2
,20130923,4820,4820,,,,4820,4820,0,0,0,0,2
,20130924,4820,4820,,,,4530,4530,-290,-290,0,0,2
,20130925,4530,4530,,,,4530,4530,0,0,0,0,2
,20130926,4530,4530,,,,4530,4530,0,0,0,0,2
,20130927,4530,4530,,,,4530,4530,0,0,0,0,2
,20130930,4530,4530,,,,4530,4530,0,0,0,0,2
,20131008,4530,4530,,,,4530,4530,0,0,0,0,2
,20131009,4530,4530,,,,4530,4530,0,0,0,0,2
,20131010,4530,4530,,,,4530,4530,0,0,0,0,2
,20131011,4530,4530,,,,4530,4530,0,0,0,0,2
,20131014,4530,4530,,,,4530,4530,0,0,0,0,2
,20131015,4530,4530,,,,4530,4530,0,0,0,0,2
,20131016,4530,4530,,,,4530,4530,0,0,0,0,2
,20131017,4530,4530,,,,4530,4530,0,0,0,0,2
,20131018,4530,4530,4303,4303,4303,4303,4303,-227,-227,2,43.03,2
,20131021,4303,4303,,,,4303,4303,0,0,0,0,2
,20131022,4303,4303,,,,4303,4303,0,0,0,0,2
,20131023,4303,4303,,,,4303,4303,0,0,0,0,2
,20131024,4303,4303,,,,4303,4303,0,0,0,0,2
,20131025,4303,4303,,,,4164,4164,-139,-139,0,0,2
,20131028,4164,4164,,,,4372,4372,208,208,0,0,2
,20131029,4372,4372,,,,4153,4153,-219,-219,0,0,2
,20131030,4153,4153,,,,4360,4360,207,207,0,0,2
,20131031,4360,4360,,,,4360,4360,0,0,0,0,2
,20131101,4360,4360,,,,4285,4285,-75,-75,0,0,2
,20131104,4285,4285,,,,4285,4285,0,0,0,0,2
,20131105,4285,4285,,,,4285,4285,0,0,0,0,2
,20131106,4285,4285,,,,4285,4285,0,0,0,0,2
,20131107,4285,4285,,,,4070,4070,-215,-215,0,0,2
,20131108,4070,4070,,,,4070,4070,0,0,0,0,2
,20131111,4070,4070,,,,4070,4070,0,0,0,0,2
,20131112,4070,4070,,,,4070,4070,0,0,0,0,2
,20131113,4070,4070,,,,4070,4070,0,0,0,0,2
,20131114,4070,4070,,,,4070,4070,0,0,0,0,2
,20131115,4070,4070,,,,4070,4070,0,0,0,0,2
,20131118,4070,4070,,,,4070,4070,0,0,0,0,2
,20131119,4070,4070,,,,4070,4070,0,0,0,0,2
,20131120,4070,4070,,,,4070,4070,0,0,0,0,2
,20131121,4070,4070,,,,4070,4070,0,0,0,0,2
,20131122,4070,4070,,,,4070,4070,0,0,0,0,2
,20131125,4070,4070,,,,4070,4070,0,0,0,0,2
,20131126,4070,4070,,,,4070,4070,0,0,0,0,2
,20131127,4070,4070,,,,4070,4070,0,0,0,0,2
,20131128,4070,4070,,,,4070,4070,0,0,0,0,2
,20131129,4070,4070,,,,4070,4070,0,0,0,0,2
,20131202,4070,4070,,,,4070,4070,0,0,0,0,2
,20131203,4070,4070,,,,4070,4070,0,0,0,0,2
,20131204,4070,4070,,,,4070,4070,0,0,0,0,2
,20131205,4070,4070,,,,4070,4070,0,0,0,0,2
,20131206,4070,4070,,,,4070,4070,0,0,0,0,2
,20131209,4070,4070,,,,4070,4070,0,0,0,0,2
,20131210,4070,4070,,,,4070,4070,0,0,0,0,2
,20131211,4070,4070,,,,4070,4070,0,0,0,0,2
,20131212,4070,4070,,,,4070,4070,0,0,0,0,2
,20131213,4070,4070,,,,4070,4070,0,0,0,0,2
,20131216,4070,4070,,,,4070,4070,0,0,0,0,2
,20131217,4070,4070,,,,4070,4070,0,0,0,0,2
,20131218,4070,4070,,,,4070,4070,0,0,0,0,2
,20131219,4070,4070,,,,4070,4070,0,0,0,0,2
,20131220,4070,4070,,,,4070,4070,0,0,0,0,2
,20131223,4070,4070,,,,4070,4070,0,0,0,0,2
,20131224,4070,4070,,,,4070,4070,0,0,0,0,2
,20131225,4070,4070,,,,4070,4070,0,0,0,0,2
,20131226,4070,4070,,,,4070,4070,0,0,0,0,2
,20131227,4070,4070,,,,4070,4070,0,0,0,0,2
,20131230,4070,4070,,,,4070,4070,0,0,0,0,2
,20131231,4070,4070,,,,4070,4070,0,0,0,0,2
fu1404,20130401,5176,5176,,,,5176,5176,0,0,0,0,0
,20130402,5176,5176,,,,5176,5176,0,0,0,0,0
,20130403,5176,5176,,,,5176,5176,0,0,0,0,0
,20130408,5176,5176,,,,5176,5176,0,0,0,0,0
,20130409,5176,5176,,,,5176,5176,0,0,0,0,0
,20130410,5176,5176,,,,5176,5176,0,0,0,0,0
,20130411,5176,5176,,,,5176,5176,0,0,0,0,0
,20130412,5176,5176,,,,5176,5176,0,0,0,0,0
,20130415,5176,5176,,,,5176,5176,0,0,0,0,0
,20130416,5176,5176,,,,5176,5176,0,0,0,0,0
,20130417,5176,5176,,,,5176,5176,0,0,0,0,0
,20130418,5176,5176,,,,5176,5176,0,0,0,0,0
,20130419,5176,5176,,,,5176,5176,0,0,0,0,0
,20130422,5176,5176,,,,5176,5176,0,0,0,0,0
,20130423,5176,5176,,,,5176,5176,0,0,0,0,0
,20130424,5176,5176,,,,5176,5176,0,0,0,0,0
,20130425,5176,5176,,,,5176,5176,0,0,0,0,0
,20130426,5176,5176,,,,5176,5176,0,0,0,0,0
,20130502,5176,5176,,,,5176,5176,0,0,0,0,0
,20130503,5176,5176,,,,5176,5176,0,0,0,0,0
,20130506,5176,5176,,,,5176,5176,0,0,0,0,0
,20130507,5176,5176,,,,5176,5176,0,0,0,0,0
,20130508,5176,5176,,,,5176,5176,0,0,0,0,0
,20130509,5176,5176,5599,5599,4661,5161,5132,-15,-44,26,667.21,6
,20130510,5161,5132,5370,5370,5370,5370,5370,238,238,4,107.4,2
,20130513,5370,5370,,,,5401,5401,31,31,0,0,2
,20130514,5401,5401,5130,5130,5130,5130,5130,-271,-271,2,51.3,0
,20130515,5130,5130,,,,5130,5130,0,0,0,0,0
,20130516,5130,5130,,,,5130,5130,0,0,0,0,0
,20130517,5130,5130,,,,5130,5130,0,0,0,0,0
,20130520,5130,5130,,,,5139,5139,9,9,0,0,0
,20130521,5139,5139,,,,5183,5183,44,44,0,0,0
,20130522,5183,5183,,,,5183,5183,0,0,0,0,0
,20130523,5183,5183,,,,5183,5183,0,0,0,0,0
,20130524,5183,5183,,,,5183,5183,0,0,0,0,0
,20130527,5183,5183,,,,5183,5183,0,0,0,0,0
,20130528,5183,5183,,,,5183,5183,0,0,0,0,0
,20130529,5183,5183,,,,5183,5183,0,0,0,0,0
,20130530,5183,5183,,,,5183,5183,0,0,0,0,0
,20130531,5183,5183,,,,5183,5183,0,0,0,0,0
,20130603,5183,5183,,,,5183,5183,0,0,0,0,0
,20130604,5183,5183,,,,5183,5183,0,0,0,0,0
,20130605,5183,5183,,,,5183,5183,0,0,0,0,0
,20130606,5183,5183,,,,5020,5020,-163,-163,0,0,0
,20130607,5020,5020,,,,5020,5020,0,0,0,0,0
,20130613,5020,5020,,,,5020,5020,0,0,0,0,0
,20130614,5020,5020,,,,5020,5020,0,0,0,0,0
,20130617,5020,5020,,,,5020,5020,0,0,0,0,0
,20130618,5020,5020,,,,5020,5020,0,0,0,0,0
,20130619,5020,5020,,,,5020,5020,0,0,0,0,0
,20130620,5020,5020,,,,5020,5020,0,0,0,0,0
,20130621,5020,5020,4771,4771,4771,4771,4771,-249,-249,2,47.71,2
,20130624,4771,4771,,,,4840,4840,69,69,0,0,2
,20130625,4840,4840,,,,4784,4784,-56,-56,0,0,2
,20130626,4784,4784,4545,4545,4545,4545,4545,-239,-239,2,45.45,0
,20130627,4545,4545,,,,4545,4545,0,0,0,0,0
,20130628,4545,4545,,,,4545,4545,0,0,0,0,0
,20130701,4545,4545,,,,4545,4545,0,0,0,0,0
,20130702,4545,4545,4772,4772,4772,4772,4772,227,227,2,47.72,2
,20130703,4772,4772,,,,4789,4789,17,17,0,0,2
,20130704,4789,4789,,,,4789,4789,0,0,0,0,2
,20130705,4789,4789,,,,4789,4789,0,0,0,0,2
,20130708,4789,4789,,,,4796,4796,7,7,0,0,2
,20130709,4796,4796,,,,4805,4805,9,9,0,0,2
,20130710,4805,4805,4915,4915,4915,4915,4915,110,110,2,49.15,0
,20130711,4915,4915,,,,4915,4915,0,0,0,0,0
,20130712,4915,4915,,,,4915,4915,0,0,0,0,0
,20130715,4915,4915,,,,4915,4915,0,0,0,0,0
,20130716,4915,4915,,,,4915,4915,0,0,0,0,0
,20130717,4915,4915,,,,4915,4915,0,0,0,0,0
,20130718,4915,4915,,,,4915,4915,0,0,0,0,0
,20130719,4915,4915,,,,4915,4915,0,0,0,0,0
,20130722,4915,4915,,,,4915,4915,0,0,0,0,0
,20130723,4915,4915,,,,4915,4915,0,0,0,0,0
,20130724,4915,4915,,,,4915,4915,0,0,0,0,0
,20130725,4915,4915,,,,4915,4915,0,0,0,0,0
,20130726,4915,4915,,,,4915,4915,0,0,0,0,0
,20130729,4915,4915,,,,4915,4915,0,0,0,0,0
,20130730,4915,4915,,,,4915,4915,0,0,0,0,0
,20130731,4915,4915,,,,4915,4915,0,0,0,0,0
,20130801,4915,4915,,,,4915,4915,0,0,0,0,0
,20130802,4915,4915,,,,4915,4915,0,0,0,0,0
,20130805,4915,4915,,,,4915,4915,0,0,0,0,0
,20130806,4915,4915,,,,4915,4915,0,0,0,0,0
,20130807,4915,4915,,,,4915,4915,0,0,0,0,0
,20130808,4915,4915,4690,5129,4690,4998,4939,83,24,6,148.17,0
,20130809,4998,4939,,,,4939,4939,0,0,0,0,0
,20130812,4939,4939,,,,4939,4939,0,0,0,0,0
,20130813,4939,4939,,,,4939,4939,0,0,0,0,0
,20130814,4939,4939,,,,4939,4939,0,0,0,0,0
,20130815,4939,4939,,,,4939,4939,0,0,0,0,0
,20130816,4939,4939,,,,4939,4939,0,0,0,0,0
,20130819,4939,4939,,,,4939,4939,0,0,0,0,0
,20130820,4939,4939,,,,4939,4939,0,0,0,0,0
,20130821,4939,4939,,,,4939,4939,0,0,0,0,0
,20130822,4939,4939,,,,4939,4939,0,0,0,0,0
,20130823,4939,4939,,,,4939,4939,0,0,0,0,0
,20130826,4939,4939,,,,4939,4939,0,0,0,0,0
,20130827,4939,4939,,,,4939,4939,0,0,0,0,0
,20130828,4939,4939,,,,4939,4939,0,0,0,0,0
,20130829,4939,4939,,,,4939,4939,0,0,0,0,0
,20130830,4939,4939,,,,4939,4939,0,0,0,0,0
,20130902,4939,4939,,,,4939,4939,0,0,0,0,0
,20130903,4939,4939,,,,4939,4939,0,0,0,0,0
,20130904,4939,4939,,,,4939,4939,0,0,0,0,0
,20130905,4939,4939,,,,4939,4939,0,0,0,0,0
,20130906,4939,4939,,,,4939,4939,0,0,0,0,0
,20130909,4939,4939,,,,4939,4939,0,0,0,0,0
,20130910,4939,4939,,,,4939,4939,0,0,0,0,0
,20130911,4939,4939,,,,4939,4939,0,0,0,0,0
,20130912,4939,4939,,,,4939,4939,0,0,0,0,0
,20130913,4939,4939,,,,4939,4939,0,0,0,0,0
,20130916,4939,4939,,,,4939,4939,0,0,0,0,0
,20130917,4939,4939,,,,4939,4939,0,0,0,0,0
,20130918,4939,4939,,,,4939,4939,0,0,0,0,0
,20130923,4939,4939,,,,4939,4939,0,0,0,0,0
,20130924,4939,4939,,,,4642,4642,-297,-297,0,0,0
,20130925,4642,4642,,,,4642,4642,0,0,0,0,0
,20130926,4642,4642,,,,4642,4642,0,0,0,0,0
,20130927,4642,4642,,,,4642,4642,0,0,0,0,0
,20130930,4642,4642,4317,4317,4317,4317,4317,-325,-325,2,43.17,2
,20131008,4317,4317,,,,4317,4317,0,0,0,0,2
,20131009,4317,4317,,,,4317,4317,0,0,0,0,2
,20131010,4317,4317,,,,4317,4317,0,0,0,0,2
,20131011,4317,4317,4318,4318,4318,4318,4318,1,1,2,43.18,2
,20131014,4318,4318,,,,4318,4318,0,0,0,0,2
,20131015,4318,4318,,,,4318,4318,0,0,0,0,2
,20131016,4318,4318,,,,4318,4318,0,0,0,0,2
,20131017,4318,4318,,,,4318,4318,0,0,0,0,2
,20131018,4318,4318,,,,4318,4318,0,0,0,0,2
,20131021,4318,4318,,,,4318,4318,0,0,0,0,2
,20131022,4318,4318,,,,4318,4318,0,0,0,0,2
,20131023,4318,4318,,,,4318,4318,0,0,0,0,2
,20131024,4318,4318,,,,4318,4318,0,0,0,0,2
,20131025,4318,4318,,,,4178,4178,-140,-140,0,0,2
,20131028,4178,4178,,,,4386,4386,208,208,0,0,2
,20131029,4386,4386,,,,4166,4166,-220,-220,0,0,2
,20131030,4166,4166,,,,4374,4374,208,208,0,0,2
,20131031,4374,4374,4315,4410,4315,4410,4362,36,-12,4,87.25,2
,20131101,4410,4362,,,,4287,4287,-75,-75,0,0,2
,20131104,4287,4287,4395,4401,4395,4401,4398,114,111,4,87.96,6
,20131105,4401,4398,4598,4599,4180,4181,4366,-217,-32,18,392.99,4
,20131106,4181,4366,4399,4399,4399,4399,4399,33,33,2,43.99,2
,20131107,4399,4399,4299,4300,4299,4300,4299,-99,-100,4,85.99,6
,20131108,4300,4299,4300,4300,4280,4280,4290,-19,-9,4,85.8,6
,20131111,4280,4290,4453,4453,4453,4453,4453,163,163,2,44.53,8
,20131112,4453,4453,4230,4607,4230,4230,4397,-223,-56,18,395.77,8
,20131113,4230,4397,,,,4397,4397,0,0,0,0,8
,20131114,4397,4397,,,,4397,4397,0,0,0,0,8
,20131115,4397,4397,,,,4396,4396,-1,-1,0,0,8
,20131118,4396,4396,4299,4299,4299,4299,4299,-97,-97,2,42.99,10
,20131119,4299,4299,,,,4299,4299,0,0,0,0,10
,20131120,4299,4299,4084,4084,4084,4084,4084,-215,-215,4,81.68,14
,20131121,4084,4084,4084,4084,4084,4084,4084,0,0,2,40.84,12
,20131122,4084,4084,,,,4084,4084,0,0,0,0,12
,20131125,4084,4084,4150,4150,4150,4150,4150,66,66,2,41.5,14
,20131126,4150,4150,,,,4150,4150,0,0,0,0,14
,20131127,4150,4150,,,,4150,4150,0,0,0,0,14
,20131128,4150,4150,,,,4150,4150,0,0,0,0,14
,20131129,4150,4150,,,,4150,4150,0,0,0,0,14
,20131202,4150,4150,,,,4150,4150,0,0,0,0,14
,20131203,4150,4150,,,,4150,4150,0,0,0,0,14
,20131204,4150,4150,,,,4150,4150,0,0,0,0,14
,20131205,4150,4150,,,,4150,4150,0,0,0,0,14
,20131206,4150,4150,,,,4150,4150,0,0,0,0,14
,20131209,4150,4150,,,,4150,4150,0,0,0,0,14
,20131210,4150,4150,,,,4150,4150,0,0,0,0,14
,20131211,4150,4150,4180,4199,4129,4199,4182,49,32,14,292.76,14
,20131212,4199,4182,,,,4182,4182,0,0,0,0,14
,20131213,4182,4182,,,,4182,4182,0,0,0,0,14
,20131216,4182,4182,,,,4182,4182,0,0,0,0,14
,20131217,4182,4182,,,,4182,4182,0,0,0,0,14
,20131218,4182,4182,4151,4151,4151,4151,4151,-31,-31,2,41.51,12
,20131219,4151,4151,,,,4151,4151,0,0,0,0,12
,20131220,4151,4151,,,,4151,4151,0,0,0,0,12
,20131223,4151,4151,,,,4151,4151,0,0,0,0,12
,20131224,4151,4151,,,,4151,4151,0,0,0,0,12
,20131225,4151,4151,,,,4151,4151,0,0,0,0,12
,20131226,4151,4151,,,,4151,4151,0,0,0,0,12
,20131227,4151,4151,,,,4151,4151,0,0,0,0,12
,20131230,4151,4151,,,,4151,4151,0,0,0,0,12
,20131231,4151,4151,,,,4151,4151,0,0,0,0,12
fu1405,20130502,5176,5176,,,,5176,5176,0,0,0,0,0
,20130503,5176,5176,,,,5176,5176,0,0,0,0,0
,20130506,5176,5176,,,,5176,5176,0,0,0,0,0
,20130507,5176,5176,,,,5176,5176,0,0,0,0,0
,20130508,5176,5176,,,,5176,5176,0,0,0,0,0
,20130509,5176,5176,,,,5176,5176,0,0,0,0,0
,20130510,5176,5176,,,,5176,5176,0,0,0,0,0
,20130513,5176,5176,,,,5176,5176,0,0,0,0,0
,20130514,5176,5176,,,,5176,5176,0,0,0,0,0
,20130515,5176,5176,,,,5176,5176,0,0,0,0,0
,20130516,5176,5176,,,,5176,5176,0,0,0,0,0
,20130517,5176,5176,,,,5176,5176,0,0,0,0,0
,20130520,5176,5176,,,,5176,5176,0,0,0,0,0
,20130521,5176,5176,,,,5176,5176,0,0,0,0,0
,20130522,5176,5176,,,,5176,5176,0,0,0,0,0
,20130523,5176,5176,,,,5176,5176,0,0,0,0,0
,20130524,5176,5176,4700,5500,4700,5500,5100,324,-76,4,102,0
,20130527,5500,5100,,,,5100,5100,0,0,0,0,0
,20130528,5100,5100,,,,4888,4888,-212,-212,0,0,0
,20130529,4888,4888,,,,4646,4646,-242,-242,0,0,0
,20130530,4646,4646,4878,4878,4878,4878,4878,232,232,2,48.78,2
,20130531,4878,4878,5121,5121,4903,5050,5017,172,139,14,351.22,2
,20130603,5050,5017,,,,5017,5017,0,0,0,0,2
,20130604,5017,5017,,,,5017,5017,0,0,0,0,2
,20130605,5017,5017,,,,5017,5017,0,0,0,0,2
,20130606,5017,5017,,,,5017,5017,0,0,0,0,2
,20130607,5017,5017,,,,5017,5017,0,0,0,0,2
,20130613,5017,5017,,,,5017,5017,0,0,0,0,2
,20130614,5017,5017,,,,5017,5017,0,0,0,0,2
,20130617,5017,5017,,,,5017,5017,0,0,0,0,2
,20130618,5017,5017,,,,5017,5017,0,0,0,0,2
,20130619,5017,5017,,,,5017,5017,0,0,0,0,2
,20130620,5017,5017,,,,5017,5017,0,0,0,0,2
,20130621,5017,5017,4769,4769,4769,4769,4769,-248,-248,2,47.69,4
,20130624,4769,4769,,,,4838,4838,69,69,0,0,4
,20130625,4838,4838,,,,4782,4782,-56,-56,0,0,4
,20130626,4782,4782,5021,5021,5021,5021,5021,239,239,2,50.21,4
,20130627,5021,5021,4771,4771,4771,4771,4771,-250,-250,2,47.71,2
,20130628,4771,4771,,,,4771,4771,0,0,0,0,2
,20130701,4771,4771,,,,4771,4771,0,0,0,0,2
,20130702,4771,4771,,,,5009,5009,238,238,0,0,2
,20130703,5009,5009,,,,5009,5009,0,0,0,0,2
,20130704,5009,5009,,,,5009,5009,0,0,0,0,2
,20130705,5009,5009,,,,5009,5009,0,0,0,0,2
,20130708,5009,5009,,,,5009,5009,0,0,0,0,2
,20130709,5009,5009,,,,5009,5009,0,0,0,0,2
,20130710,5009,5009,,,,5009,5009,0,0,0,0,2
,20130711,5009,5009,,,,5009,5009,0,0,0,0,2
,20130712,5009,5009,,,,5009,5009,0,0,0,0,2
,20130715,5009,5009,,,,5009,5009,0,0,0,0,2
,20130716,5009,5009,,,,5009,5009,0,0,0,0,2
,20130717,5009,5009,,,,5009,5009,0,0,0,0,2
,20130718,5009,5009,,,,5009,5009,0,0,0,0,2
,20130719,5009,5009,,,,5009,5009,0,0,0,0,2
,20130722,5009,5009,,,,5009,5009,0,0,0,0,2
,20130723,5009,5009,,,,5009,5009,0,0,0,0,2
,20130724,5009,5009,,,,5009,5009,0,0,0,0,2
,20130725,5009,5009,,,,5009,5009,0,0,0,0,2
,20130726,5009,5009,,,,5009,5009,0,0,0,0,2
,20130729,5009,5009,,,,5009,5009,0,0,0,0,2
,20130730,5009,5009,,,,5009,5009,0,0,0,0,2
,20130731,5009,5009,,,,5009,5009,0,0,0,0,2
,20130801,5009,5009,,,,5009,5009,0,0,0,0,2
,20130802,5009,5009,,,,5009,5009,0,0,0,0,2
,20130805,5009,5009,,,,5009,5009,0,0,0,0,2
,20130806,5009,5009,,,,5009,5009,0,0,0,0,2
,20130807,5009,5009,,,,5009,5009,0,0,0,0,2
,20130808,5009,5009,,,,5009,5009,0,0,0,0,2
,20130809,5009,5009,,,,5009,5009,0,0,0,0,2
,20130812,5009,5009,4786,5210,4786,5210,4998,201,-11,4,99.96,2
,20130813,5210,4998,,,,4998,4998,0,0,0,0,2
,20130814,4998,4998,,,,4998,4998,0,0,0,0,2
,20130815,4998,4998,,,,4998,4998,0,0,0,0,2
,20130816,4998,4998,,,,4998,4998,0,0,0,0,2
,20130819,4998,4998,,,,4998,4998,0,0,0,0,2
,20130820,4998,4998,,,,4998,4998,0,0,0,0,2
,20130821,4998,4998,,,,4998,4998,0,0,0,0,2
,20130822,4998,4998,,,,4998,4998,0,0,0,0,2
,20130823,4998,4998,,,,4998,4998,0,0,0,0,2
,20130826,4998,4998,,,,4998,4998,0,0,0,0,2
,20130827,4998,4998,,,,4998,4998,0,0,0,0,2
,20130828,4998,4998,,,,4998,4998,0,0,0,0,2
,20130829,4998,4998,,,,4998,4998,0,0,0,0,2
,20130830,4998,4998,,,,4998,4998,0,0,0,0,2
,20130902,4998,4998,,,,4998,4998,0,0,0,0,2
,20130903,4998,4998,,,,4998,4998,0,0,0,0,2
,20130904,4998,4998,,,,4998,4998,0,0,0,0,2
,20130905,4998,4998,,,,4998,4998,0,0,0,0,2
,20130906,4998,4998,,,,4998,4998,0,0,0,0,2
,20130909,4998,4998,,,,4998,4998,0,0,0,0,2
,20130910,4998,4998,,,,4998,4998,0,0,0,0,2
,20130911,4998,4998,,,,4998,4998,0,0,0,0,2
,20130912,4998,4998,,,,4998,4998,0,0,0,0,2
,20130913,4998,4998,,,,4998,4998,0,0,0,0,2
,20130916,4998,4998,,,,4998,4998,0,0,0,0,2
,20130917,4998,4998,,,,4998,4998,0,0,0,0,2
,20130918,4998,4998,,,,4998,4998,0,0,0,0,2
,20130923,4998,4998,,,,4698,4698,-300,-300,0,0,2
,20130924,4698,4698,,,,4698,4698,0,0,0,0,2
,20130925,4698,4698,,,,4698,4698,0,0,0,0,2
,20130926,4698,4698,,,,4698,4698,0,0,0,0,2
,20130927,4698,4698,,,,4698,4698,0,0,0,0,2
,20130930,4698,4698,,,,4698,4698,0,0,0,0,2
,20131008,4698,4698,,,,5025,5025,327,327,0,0,2
,20131009,5025,5025,,,,5025,5025,0,0,0,0,2
,20131010,5025,5025,,,,4773,4773,-252,-252,0,0,2
,20131011,4773,4773,,,,4774,4774,1,1,0,0,2
,20131014,4774,4774,,,,4774,4774,0,0,0,0,2
,20131015,4774,4774,,,,4774,4774,0,0,0,0,2
,20131016,4774,4774,,,,4774,4774,0,0,0,0,2
,20131017,4774,4774,,,,4774,4774,0,0,0,0,2
,20131018,4774,4774,,,,4535,4535,-239,-239,0,0,2
,20131021,4535,4535,,,,4535,4535,0,0,0,0,2
,20131022,4535,4535,,,,4535,4535,0,0,0,0,2
,20131023,4535,4535,,,,4535,4535,0,0,0,0,2
,20131024,4535,4535,,,,4535,4535,0,0,0,0,2
,20131025,4535,4535,,,,4388,4388,-147,-147,0,0,2
,20131028,4388,4388,,,,4607,4607,219,219,0,0,2
,20131029,4607,4607,,,,4376,4376,-231,-231,0,0,2
,20131030,4376,4376,,,,4594,4594,218,218,0,0,2
,20131031,4594,4594,,,,4581,4581,-13,-13,0,0,2
,20131101,4581,4581,,,,4502,4502,-79,-79,0,0,2
,20131104,4502,4502,,,,4618,4618,116,116,0,0,2
,20131105,4618,4618,,,,4584,4584,-34,-34,0,0,2
,20131106,4584,4584,,,,4618,4618,34,34,0,0,2
,20131107,4618,4618,,,,4513,4513,-105,-105,0,0,2
,20131108,4513,4513,,,,4503,4503,-10,-10,0,0,2
,20131111,4503,4503,,,,4674,4674,171,171,0,0,2
,20131112,4674,4674,,,,4615,4615,-59,-59,0,0,2
,20131113,4615,4615,,,,4615,4615,0,0,0,0,2
,20131114,4615,4615,,,,4615,4615,0,0,0,0,2
,20131115,4615,4615,,,,4614,4614,-1,-1,0,0,2
,20131118,4614,4614,,,,4512,4512,-102,-102,0,0,2
,20131119,4512,4512,,,,4512,4512,0,0,0,0,2
,20131120,4512,4512,,,,4286,4286,-226,-226,0,0,2
,20131121,4286,4286,,,,4286,4286,0,0,0,0,2
,20131122,4286,4286,,,,4286,4286,0,0,0,0,2
,20131125,4286,4286,,,,4355,4355,69,69,0,0,2
,20131126,4355,4355,,,,4355,4355,0,0,0,0,2
,20131127,4355,4355,,,,4355,4355,0,0,0,0,2
,20131128,4355,4355,,,,4355,4355,0,0,0,0,2
,20131129,4355,4355,,,,4355,4355,0,0,0,0,2
,20131202,4355,4355,,,,4355,4355,0,0,0,0,2
,20131203,4355,4355,,,,4355,4355,0,0,0,0,2
,20131204,4355,4355,,,,4355,4355,0,0,0,0,2
,20131205,4355,4355,,,,4355,4355,0,0,0,0,2
,20131206,4355,4355,,,,4355,4355,0,0,0,0,2
,20131209,4355,4355,,,,4355,4355,0,0,0,0,2
,20131210,4355,4355,,,,4355,4355,0,0,0,0,2
,20131211,4355,4355,,,,4355,4355,0,0,0,0,2
,20131212,4355,4355,,,,4355,4355,0,0,0,0,2
,20131213,4355,4355,,,,4355,4355,0,0,0,0,2
,20131216,4355,4355,,,,4355,4355,0,0,0,0,2
,20131217,4355,4355,,,,4355,4355,0,0,0,0,2
,20131218,4355,4355,,,,4322,4322,-33,-33,0,0,2
,20131219,4322,4322,,,,4322,4322,0,0,0,0,2
,20131220,4322,4322,,,,4322,4322,0,0,0,0,2
,20131223,4322,4322,,,,4167,4167,-155,-155,0,0,2
,20131224,4167,4167,,,,4167,4167,0,0,0,0,2
,20131225,4167,4167,,,,4167,4167,0,0,0,0,2
,20131226,4167,4167,,,,4167,4167,0,0,0,0,2
,20131227,4167,4167,,,,4167,4167,0,0,0,0,2
,20131230,4167,4167,,,,4167,4167,0,0,0,0,2
,20131231,4167,4167,,,,4167,4167,0,0,0,0,2
fu1406,20130603,5017,5017,,,,5017,5017,0,0,0,0,0
,20130604,5017,5017,,,,5017,5017,0,0,0,0,0
,20130605,5017,5017,,,,5017,5017,0,0,0,0,0
,20130606,5017,5017,,,,5017,5017,0,0,0,0,0
,20130607,5017,5017,,,,5017,5017,0,0,0,0,0
,20130613,5017,5017,,,,5017,5017,0,0,0,0,0
,20130614,5017,5017,,,,5017,5017,0,0,0,0,0
,20130617,5017,5017,,,,5017,5017,0,0,0,0,0
,20130618,5017,5017,,,,5017,5017,0,0,0,0,0
,20130619,5017,5017,,,,5017,5017,0,0,0,0,0
,20130620,5017,5017,,,,5017,5017,0,0,0,0,0
,20130621,5017,5017,,,,5017,5017,0,0,0,0,0
,20130624,5017,5017,,,,5017,5017,0,0,0,0,0
,20130625,5017,5017,,,,5017,5017,0,0,0,0,0
,20130626,5017,5017,,,,5017,5017,0,0,0,0,0
,20130627,5017,5017,,,,5017,5017,0,0,0,0,0
,20130628,5017,5017,,,,5017,5017,0,0,0,0,0
,20130701,5017,5017,,,,5017,5017,0,0,0,0,0
,20130702,5017,5017,,,,5267,5267,250,250,0,0,0
,20130703,5267,5267,,,,5267,5267,0,0,0,0,0
,20130704,5267,5267,,,,5267,5267,0,0,0,0,0
,20130705,5267,5267,,,,5267,5267,0,0,0,0,0
,20130708,5267,5267,,,,5267,5267,0,0,0,0,0
,20130709,5267,5267,,,,5267,5267,0,0,0,0,0
,20130710,5267,5267,,,,5267,5267,0,0,0,0,0
,20130711,5267,5267,4760,5729,4743,4743,5077,-524,-190,6,152.32,0
,20130712,4743,5077,,,,5077,5077,0,0,0,0,0
,20130715,5077,5077,,,,5077,5077,0,0,0,0,0
,20130716,5077,5077,,,,5077,5077,0,0,0,0,0
,20130717,5077,5077,,,,5077,5077,0,0,0,0,0
,20130718,5077,5077,,,,5077,5077,0,0,0,0,0
,20130719,5077,5077,,,,5077,5077,0,0,0,0,0
,20130722,5077,5077,,,,5077,5077,0,0,0,0,0
,20130723,5077,5077,,,,5077,5077,0,0,0,0,0
,20130724,5077,5077,,,,5077,5077,0,0,0,0,0
,20130725,5077,5077,,,,5077,5077,0,0,0,0,0
,20130726,5077,5077,,,,5077,5077,0,0,0,0,0
,20130729,5077,5077,,,,5077,5077,0,0,0,0,0
,20130730,5077,5077,,,,5077,5077,0,0,0,0,0
,20130731,5077,5077,,,,5077,5077,0,0,0,0,0
,20130801,5077,5077,,,,5077,5077,0,0,0,0,0
,20130802,5077,5077,,,,5077,5077,0,0,0,0,0
,20130805,5077,5077,,,,5077,5077,0,0,0,0,0
,20130806,5077,5077,,,,5077,5077,0,0,0,0,0
,20130807,5077,5077,,,,5077,5077,0,0,0,0,0
,20130808,5077,5077,,,,5077,5077,0,0,0,0,0
,20130809,5077,5077,,,,5077,5077,0,0,0,0,0
,20130812,5077,5077,,,,5077,5077,0,0,0,0,0
,20130813,5077,5077,,,,5077,5077,0,0,0,0,0
,20130814,5077,5077,,,,5077,5077,0,0,0,0,0
,20130815,5077,5077,,,,5077,5077,0,0,0,0,0
,20130816,5077,5077,,,,5077,5077,0,0,0,0,0
,20130819,5077,5077,,,,5077,5077,0,0,0,0,0
,20130820,5077,5077,,,,5077,5077,0,0,0,0,0
,20130821,5077,5077,,,,5077,5077,0,0,0,0,0
,20130822,5077,5077,,,,5077,5077,0,0,0,0,0
,20130823,5077,5077,,,,5077,5077,0,0,0,0,0
,20130826,5077,5077,,,,4823,4823,-254,-254,0,0,0
,20130827,4823,4823,,,,4823,4823,0,0,0,0,0
,20130828,4823,4823,,,,4823,4823,0,0,0,0,0
,20130829,4823,4823,,,,4823,4823,0,0,0,0,0
,20130830,4823,4823,,,,4823,4823,0,0,0,0,0
,20130902,4823,4823,,,,4823,4823,0,0,0,0,0
,20130903,4823,4823,,,,4823,4823,0,0,0,0,0
,20130904,4823,4823,,,,4823,4823,0,0,0,0,0
,20130905,4823,4823,,,,4823,4823,0,0,0,0,0
,20130906,4823,4823,,,,4823,4823,0,0,0,0,0
,20130909,4823,4823,,,,4823,4823,0,0,0,0,0
,20130910,4823,4823,,,,4823,4823,0,0,0,0,0
,20130911,4823,4823,,,,4823,4823,0,0,0,0,0
,20130912,4823,4823,,,,4823,4823,0,0,0,0,0
,20130913,4823,4823,,,,4823,4823,0,0,0,0,0
,20130916,4823,4823,,,,4823,4823,0,0,0,0,0
,20130917,4823,4823,,,,4823,4823,0,0,0,0,0
,20130918,4823,4823,,,,4823,4823,0,0,0,0,0
,20130923,4823,4823,,,,4823,4823,0,0,0,0,0
,20130924,4823,4823,,,,4823,4823,0,0,0,0,0
,20130925,4823,4823,,,,4823,4823,0,0,0,0,0
,20130926,4823,4823,,,,4823,4823,0,0,0,0,0
,20130927,4823,4823,,,,4823,4823,0,0,0,0,0
,20130930,4823,4823,,,,4823,4823,0,0,0,0,0
,20131008,4823,4823,,,,5159,5159,336,336,0,0,0
,20131009,5159,5159,,,,5159,5159,0,0,0,0,0
,20131010,5159,5159,,,,4901,4901,-258,-258,0,0,0
,20131011,4901,4901,,,,4902,4902,1,1,0,0,0
,20131014,4902,4902,,,,4902,4902,0,0,0,0,0
,20131015,4902,4902,,,,4902,4902,0,0,0,0,0
,20131016,4902,4902,,,,4902,4902,0,0,0,0,0
,20131017,4902,4902,,,,4902,4902,0,0,0,0,0
,20131018,4902,4902,,,,4656,4656,-246,-246,0,0,0
,20131021,4656,4656,,,,4656,4656,0,0,0,0,0
,20131022,4656,4656,,,,4656,4656,0,0,0,0,0
,20131023,4656,4656,,,,4656,4656,0,0,0,0,0
,20131024,4656,4656,,,,4656,4656,0,0,0,0,0
,20131025,4656,4656,,,,4505,4505,-151,-151,0,0,0
,20131028,4505,4505,,,,4730,4730,225,225,0,0,0
,20131029,4730,4730,,,,4493,4493,-237,-237,0,0,0
,20131030,4493,4493,,,,4717,4717,224,224,0,0,0
,20131031,4717,4717,,,,4704,4704,-13,-13,0,0,0
,20131101,4704,4704,,,,4623,4623,-81,-81,0,0,0
,20131104,4623,4623,,,,4742,4742,119,119,0,0,0
,20131105,4742,4742,,,,4708,4708,-34,-34,0,0,0
,20131106,4708,4708,,,,4743,4743,35,35,0,0,0
,20131107,4743,4743,,,,4635,4635,-108,-108,0,0,0
,20131108,4635,4635,,,,4625,4625,-10,-10,0,0,0
,20131111,4625,4625,,,,4800,4800,175,175,0,0,0
,20131112,4800,4800,,,,4740,4740,-60,-60,0,0,0
,20131113,4740,4740,,,,4740,4740,0,0,0,0,0
,20131114,4740,4740,,,,4740,4740,0,0,0,0,0
,20131115,4740,4740,,,,4739,4739,-1,-1,0,0,0
,20131118,4739,4739,,,,4634,4634,-105,-105,0,0,0
,20131119,4634,4634,,,,4634,4634,0,0,0,0,0
,20131120,4634,4634,,,,4402,4402,-232,-232,0,0,0
,20131121,4402,4402,,,,4402,4402,0,0,0,0,0
,20131122,4402,4402,,,,4402,4402,0,0,0,0,0
,20131125,4402,4402,,,,4473,4473,71,71,0,0,0
,20131126,4473,4473,,,,4473,4473,0,0,0,0,0
,20131127,4473,4473,,,,4473,4473,0,0,0,0,0
,20131128,4473,4473,,,,4473,4473,0,0,0,0,0
,20131129,4473,4473,,,,4473,4473,0,0,0,0,0
,20131202,4473,4473,,,,4473,4473,0,0,0,0,0
,20131203,4473,4473,,,,4473,4473,0,0,0,0,0
,20131204,4473,4473,,,,4473,4473,0,0,0,0,0
,20131205,4473,4473,,,,4473,4473,0,0,0,0,0
,20131206,4473,4473,,,,4473,4473,0,0,0,0,0
,20131209,4473,4473,,,,4473,4473,0,0,0,0,0
,20131210,4473,4473,,,,4473,4473,0,0,0,0,0
,20131211,4473,4473,,,,4507,4507,34,34,0,0,0
,20131212,4507,4507,,,,4507,4507,0,0,0,0,0
,20131213,4507,4507,,,,4507,4507,0,0,0,0,0
,20131216,4507,4507,,,,4507,4507,0,0,0,0,0
,20131217,4507,4507,4551,4551,4551,4551,4551,44,44,4,91.02,4
,20131218,4551,4551,4765,4767,4402,4431,4545,-120,-6,16,363.65,4
,20131219,4431,4545,4435,4435,4380,4380,4415,-165,-130,6,132.46,4
,20131220,4380,4415,,,,4415,4415,0,0,0,0,4
,20131223,4415,4415,,,,4415,4415,0,0,0,0,4
,20131224,4415,4415,,,,4415,4415,0,0,0,0,4
,20131225,4415,4415,,,,4415,4415,0,0,0,0,4
,20131226,4415,4415,4440,4440,4440,4440,4440,25,25,2,44.4,2
,20131227,4440,4440,,,,4440,4440,0,0,0,0,2
,20131230,4440,4440,,,,4440,4440,0,0,0,0,2
,20131231,4440,4440,,,,4440,4440,0,0,0,0,2
fu1407,20130701,5017,5017,,,,5017,5017,0,0,0,0,0
,20130702,5017,5017,,,,5017,5017,0,0,0,0,0
,20130703,5017,5017,,,,5017,5017,0,0,0,0,0
,20130704,5017,5017,,,,5017,5017,0,0,0,0,0
,20130705,5017,5017,,,,5017,5017,0,0,0,0,0
,20130708,5017,5017,,,,5017,5017,0,0,0,0,0
,20130709,5017,5017,,,,5017,5017,0,0,0,0,0
,20130710,5017,5017,,,,5017,5017,0,0,0,0,0
,20130711,5017,5017,4525,5293,4525,4950,4922,-67,-95,10,246.11,2
,20130712,4950,4922,,,,4922,4922,0,0,0,0,2
,20130715,4922,4922,4900,4900,4900,4900,4900,-22,-22,2,49,2
,20130716,4900,4900,4935,4935,4935,4935,4935,35,35,2,49.35,0
,20130717,4935,4935,,,,4935,4935,0,0,0,0,0
,20130718,4935,4935,,,,4935,4935,0,0,0,0,0
,20130719,4935,4935,,,,4935,4935,0,0,0,0,0
,20130722,4935,4935,,,,4935,4935,0,0,0,0,0
,20130723,4935,4935,,,,4935,4935,0,0,0,0,0
,20130724,4935,4935,,,,4935,4935,0,0,0,0,0
,20130725,4935,4935,,,,4935,4935,0,0,0,0,0
,20130726,4935,4935,,,,4935,4935,0,0,0,0,0
,20130729,4935,4935,,,,4935,4935,0,0,0,0,0
,20130730,4935,4935,,,,4935,4935,0,0,0,0,0
,20130731,4935,4935,,,,4935,4935,0,0,0,0,0
,20130801,4935,4935,,,,4935,4935,0,0,0,0,0
,20130802,4935,4935,,,,4935,4935,0,0,0,0,0
,20130805,4935,4935,,,,4935,4935,0,0,0,0,0
,20130806,4935,4935,,,,4935,4935,0,0,0,0,0
,20130807,4935,4935,,,,4935,4935,0,0,0,0,0
,20130808,4935,4935,,,,4935,4935,0,0,0,0,0
,20130809,4935,4935,,,,4935,4935,0,0,0,0,0
,20130812,4935,4935,,,,4935,4935,0,0,0,0,0
,20130813,4935,4935,,,,4935,4935,0,0,0,0,0
,20130814,4935,4935,,,,4935,4935,0,0,0,0,0
,20130815,4935,4935,,,,4935,4935,0,0,0,0,0
,20130816,4935,4935,,,,4935,4935,0,0,0,0,0
,20130819,4935,4935,,,,4935,4935,0,0,0,0,0
,20130820,4935,4935,,,,4935,4935,0,0,0,0,0
,20130821,4935,4935,,,,4935,4935,0,0,0,0,0
,20130822,4935,4935,,,,4935,4935,0,0,0,0,0
,20130823,4935,4935,,,,4935,4935,0,0,0,0,0
,20130826,4935,4935,,,,4935,4935,0,0,0,0,0
,20130827,4935,4935,,,,4935,4935,0,0,0,0,0
,20130828,4935,4935,,,,4935,4935,0,0,0,0,0
,20130829,4935,4935,,,,4935,4935,0,0,0,0,0
,20130830,4935,4935,,,,4935,4935,0,0,0,0,0
,20130902,4935,4935,,,,4935,4935,0,0,0,0,0
,20130903,4935,4935,,,,4935,4935,0,0,0,0,0
,20130904,4935,4935,,,,4935,4935,0,0,0,0,0
,20130905,4935,4935,,,,4935,4935,0,0,0,0,0
,20130906,4935,4935,,,,4935,4935,0,0,0,0,0
,20130909,4935,4935,,,,4935,4935,0,0,0,0,0
,20130910,4935,4935,,,,4935,4935,0,0,0,0,0
,20130911,4935,4935,,,,4935,4935,0,0,0,0,0
,20130912,4935,4935,,,,4935,4935,0,0,0,0,0
,20130913,4935,4935,,,,4935,4935,0,0,0,0,0
,20130916,4935,4935,,,,4935,4935,0,0,0,0,0
,20130917,4935,4935,,,,4935,4935,0,0,0,0,0
,20130918,4935,4935,,,,4935,4935,0,0,0,0,0
,20130923,4935,4935,,,,4935,4935,0,0,0,0,0
,20130924,4935,4935,,,,4638,4638,-297,-297,0,0,0
,20130925,4638,4638,,,,4638,4638,0,0,0,0,0
,20130926,4638,4638,,,,4638,4638,0,0,0,0,0
,20130927,4638,4638,,,,4638,4638,0,0,0,0,0
,20130930,4638,4638,,,,4638,4638,0,0,0,0,0
,20131008,4638,4638,,,,4638,4638,0,0,0,0,0
,20131009,4638,4638,,,,4638,4638,0,0,0,0,0
,20131010,4638,4638,,,,4779,4779,141,141,0,0,0
,20131011,4779,4779,,,,4780,4780,1,1,0,0,0
,20131014,4780,4780,,,,4780,4780,0,0,0,0,0
,20131015,4780,4780,,,,4780,4780,0,0,0,0,0
,20131016,4780,4780,,,,4780,4780,0,0,0,0,0
,20131017,4780,4780,,,,4780,4780,0,0,0,0,0
,20131018,4780,4780,,,,4541,4541,-239,-239,0,0,0
,20131021,4541,4541,,,,4541,4541,0,0,0,0,0
,20131022,4541,4541,,,,4541,4541,0,0,0,0,0
,20131023,4541,4541,,,,4541,4541,0,0,0,0,0
,20131024,4541,4541,,,,4541,4541,0,0,0,0,0
,20131025,4541,4541,,,,4394,4394,-147,-147,0,0,0
,20131028,4394,4394,,,,4613,4613,219,219,0,0,0
,20131029,4613,4613,,,,4382,4382,-231,-231,0,0,0
,20131030,4382,4382,,,,4601,4601,219,219,0,0,0
,20131031,4601,4601,,,,4588,4588,-13,-13,0,0,0
,20131101,4588,4588,,,,4509,4509,-79,-79,0,0,0
,20131104,4509,4509,,,,4625,4625,116,116,0,0,0
,20131105,4625,4625,,,,4591,4591,-34,-34,0,0,0
,20131106,4591,4591,,,,4625,4625,34,34,0,0,0
,20131107,4625,4625,,,,4520,4520,-105,-105,0,0,0
,20131108,4520,4520,,,,4510,4510,-10,-10,0,0,0
,20131111,4510,4510,,,,4681,4681,171,171,0,0,0
,20131112,4681,4681,,,,4622,4622,-59,-59,0,0,0
,20131113,4622,4622,,,,4622,4622,0,0,0,0,0
,20131114,4622,4622,,,,4622,4622,0,0,0,0,0
,20131115,4622,4622,,,,4621,4621,-1,-1,0,0,0
,20131118,4621,4621,,,,4519,4519,-102,-102,0,0,0
,20131119,4519,4519,,,,4519,4519,0,0,0,0,0
,20131120,4519,4519,,,,4293,4293,-226,-226,0,0,0
,20131121,4293,4293,,,,4293,4293,0,0,0,0,0
,20131122,4293,4293,,,,4293,4293,0,0,0,0,0
,20131125,4293,4293,4450,4450,4450,4450,4450,157,157,2,44.5,2
,20131126,4450,4450,4498,4498,4498,4498,4498,48,48,2,44.98,4
,20131127,4498,4498,4658,4658,4658,4658,4658,160,160,2,46.58,6
,20131128,4658,4658,,,,4658,4658,0,0,0,0,6
,20131129,4658,4658,4799,4868,4425,4542,4601,-116,-57,26,598.14,6
,20131202,4542,4601,,,,4601,4601,0,0,0,0,6
,20131203,4601,4601,,,,4601,4601,0,0,0,0,6
,20131204,4601,4601,,,,4601,4601,0,0,0,0,6
,20131205,4601,4601,,,,4601,4601,0,0,0,0,6
,20131206,4601,4601,,,,4601,4601,0,0,0,0,6
,20131209,4601,4601,4586,4734,4371,4734,4518,133,-83,26,587.41,8
,20131210,4734,4518,4519,4519,4517,4517,4518,-1,0,4,90.36,4
,20131211,4517,4518,4714,4715,4460,4462,4613,-56,95,10,230.65,8
,20131212,4462,4613,,,,4500,4500,-113,-113,0,0,8
,20131213,4500,4500,,,,4500,4500,0,0,0,0,8
,20131216,4500,4500,,,,4500,4500,0,0,0,0,8
,20131217,4500,4500,,,,4500,4500,0,0,0,0,8
,20131218,4500,4500,4300,4463,4300,4463,4340,-37,-160,8,173.63,0
,20131219,4463,4340,,,,4340,4340,0,0,0,0,0
,20131220,4340,4340,,,,4340,4340,0,0,0,0,0
,20131223,4340,4340,,,,4340,4340,0,0,0,0,0
,20131224,4340,4340,,,,4340,4340,0,0,0,0,0
,20131225,4340,4340,,,,4340,4340,0,0,0,0,0
,20131226,4340,4340,,,,4340,4340,0,0,0,0,0
,20131227,4340,4340,,,,4340,4340,0,0,0,0,0
,20131230,4340,4340,,,,4340,4340,0,0,0,0,0
,20131231,4340,4340,,,,4340,4340,0,0,0,0,0
fu1408,20130801,4935,4935,,,,4935,4935,0,0,0,0,0
,20130802,4935,4935,,,,4935,4935,0,0,0,0,0
,20130805,4935,4935,,,,4935,4935,0,0,0,0,0
,20130806,4935,4935,4452,5272,4452,5272,4862,337,-73,4,97.24,2
,20130807,5272,4862,4862,4862,4862,4862,4862,0,0,2,48.62,0
,20130808,4862,4862,,,,4862,4862,0,0,0,0,0
,20130809,4862,4862,,,,4862,4862,0,0,0,0,0
,20130812,4862,4862,,,,4862,4862,0,0,0,0,0
,20130813,4862,4862,,,,4862,4862,0,0,0,0,0
,20130814,4862,4862,,,,4862,4862,0,0,0,0,0
,20130815,4862,4862,,,,4862,4862,0,0,0,0,0
,20130816,4862,4862,,,,4862,4862,0,0,0,0,0
,20130819,4862,4862,,,,4862,4862,0,0,0,0,0
,20130820,4862,4862,,,,4862,4862,0,0,0,0,0
,20130821,4862,4862,,,,4862,4862,0,0,0,0,0
,20130822,4862,4862,,,,4862,4862,0,0,0,0,0
,20130823,4862,4862,,,,4862,4862,0,0,0,0,0
,20130826,4862,4862,,,,4862,4862,0,0,0,0,0
,20130827,4862,4862,,,,4862,4862,0,0,0,0,0
,20130828,4862,4862,,,,4862,4862,0,0,0,0,0
,20130829,4862,4862,,,,4862,4862,0,0,0,0,0
,20130830,4862,4862,,,,4862,4862,0,0,0,0,0
,20130902,4862,4862,,,,4862,4862,0,0,0,0,0
,20130903,4862,4862,,,,4862,4862,0,0,0,0,0
,20130904,4862,4862,,,,4862,4862,0,0,0,0,0
,20130905,4862,4862,,,,4862,4862,0,0,0,0,0
,20130906,4862,4862,,,,4862,4862,0,0,0,0,0
,20130909,4862,4862,,,,4862,4862,0,0,0,0,0
,20130910,4862,4862,,,,4862,4862,0,0,0,0,0
,20130911,4862,4862,,,,4862,4862,0,0,0,0,0
,20130912,4862,4862,,,,4862,4862,0,0,0,0,0
,20130913,4862,4862,,,,4862,4862,0,0,0,0,0
,20130916,4862,4862,,,,4862,4862,0,0,0,0,0
,20130917,4862,4862,,,,4862,4862,0,0,0,0,0
,20130918,4862,4862,,,,4862,4862,0,0,0,0,0
,20130923,4862,4862,,,,4862,4862,0,0,0,0,0
,20130924,4862,4862,,,,4862,4862,0,0,0,0,0
,20130925,4862,4862,,,,4862,4862,0,0,0,0,0
,20130926,4862,4862,,,,4862,4862,0,0,0,0,0
,20130927,4862,4862,,,,4862,4862,0,0,0,0,0
,20130930,4862,4862,,,,4862,4862,0,0,0,0,0
,20131008,4862,4862,,,,5201,5201,339,339,0,0,0
,20131009,5201,5201,,,,5201,5201,0,0,0,0,0
,20131010,5201,5201,,,,4940,4940,-261,-261,0,0,0
,20131011,4940,4940,4693,4693,4693,4693,4693,-247,-247,2,46.93,2
,20131014,4693,4693,4458,4458,4458,4458,4458,-235,-235,2,44.58,0
,20131015,4458,4458,,,,4458,4458,0,0,0,0,0
,20131016,4458,4458,,,,4458,4458,0,0,0,0,0
,20131017,4458,4458,,,,4458,4458,0,0,0,0,0
,20131018,4458,4458,4235,4235,4235,4235,4235,-223,-223,12,254.1,12
,20131021,4235,4235,,,,4235,4235,0,0,0,0,12
,20131022,4235,4235,,,,4235,4235,0,0,0,0,12
,20131023,4235,4235,4437,4437,4437,4437,4437,202,202,2,44.37,14
,20131024,4437,4437,4600,4600,4600,4600,4600,163,163,2,46,14
,20131025,4600,4600,,,,4451,4451,-149,-149,0,0,14
,20131028,4451,4451,4306,4343,4306,4343,4324,-108,-127,4,86.49,18
,20131029,4343,4324,,,,4324,4324,0,0,0,0,18
,20131030,4324,4324,,,,4324,4324,0,0,0,0,18
,20131031,4324,4324,4356,4356,4356,4356,4356,32,32,2,43.56,16
,20131101,4356,4356,4312,4312,4312,4312,4312,-44,-44,2,43.12,16
,20131104,4312,4312,,,,4312,4312,0,0,0,0,16
,20131105,4312,4312,,,,4312,4312,0,0,0,0,16
,20131106,4312,4312,,,,4312,4312,0,0,0,0,16
,20131107,4312,4312,,,,4312,4312,0,0,0,0,16
,20131108,4312,4312,,,,4312,4312,0,0,0,0,16
,20131111,4312,4312,,,,4312,4312,0,0,0,0,16
,20131112,4312,4312,,,,4312,4312,0,0,0,0,16
,20131113,4312,4312,,,,4312,4312,0,0,0,0,16
,20131114,4312,4312,,,,4312,4312,0,0,0,0,16
,20131115,4312,4312,4303,4303,4303,4303,4303,-9,-9,2,43.03,16
,20131118,4303,4303,,,,4228,4228,-75,-75,0,0,16
,20131119,4228,4228,,,,4250,4250,22,22,0,0,16
,20131120,4250,4250,,,,4250,4250,0,0,0,0,16
,20131121,4250,4250,4461,4461,4461,4461,4461,211,211,2,44.61,16
,20131122,4461,4461,,,,4461,4461,0,0,0,0,16
,20131125,4461,4461,,,,4461,4461,0,0,0,0,16
,20131126,4461,4461,,,,4461,4461,0,0,0,0,16
,20131127,4461,4461,,,,4308,4308,-153,-153,0,0,16
,20131128,4308,4308,,,,4308,4308,0,0,0,0,16
,20131129,4308,4308,,,,4330,4330,22,22,0,0,16
,20131202,4330,4330,,,,4330,4330,0,0,0,0,16
,20131203,4330,4330,4546,4546,4546,4546,4546,216,216,2,45.46,16
,20131204,4546,4546,4771,4771,4771,4771,4771,225,225,2,47.71,16
,20131205,4771,4771,,,,4620,4620,-151,-151,0,0,16
,20131206,4620,4620,4447,4447,4447,4447,4447,-173,-173,2,44.47,16
,20131209,4447,4447,4406,4406,4405,4405,4405,-42,-42,4,88.11,12
,20131210,4405,4405,4384,4562,4384,4562,4473,157,68,4,89.46,12
,20131211,4562,4473,,,,4473,4473,0,0,0,0,12
,20131212,4473,4473,,,,4473,4473,0,0,0,0,12
,20131213,4473,4473,,,,4473,4473,0,0,0,0,12
,20131216,4473,4473,,,,4473,4473,0,0,0,0,12
,20131217,4473,4473,4385,4385,4385,4385,4385,-88,-88,2,43.85,12
,20131218,4385,4385,,,,4389,4389,4,4,0,0,12
,20131219,4389,4389,,,,4389,4389,0,0,0,0,12
,20131220,4389,4389,4608,4608,4608,4608,4608,219,219,2,46.08,12
,20131223,4608,4608,,,,4608,4608,0,0,0,0,12
,20131224,4608,4608,,,,4608,4608,0,0,0,0,12
,20131225,4608,4608,4388,4388,4388,4388,4388,-220,-220,2,43.88,10
,20131226,4388,4388,4596,4596,4596,4596,4596,208,208,2,45.96,12
,20131227,4596,4596,4384,4587,4384,4587,4485,-9,-111,4,89.71,12
,20131230,4587,4485,,,,4485,4485,0,0,0,0,12
,20131231,4485,4485,,,,4485,4485,0,0,0,0,12
fu1409,20130902,4862,4862,,,,4862,4862,0,0,0,0,0
,20130903,4862,4862,,,,4862,4862,0,0,0,0,0
,20130904,4862,4862,4400,4999,4400,4900,4763,38,-99,10,238.19,0
,20130905,4900,4763,,,,4763,4763,0,0,0,0,0
,20130906,4763,4763,4578,4942,4578,4705,4745,-58,-18,22,521.95,2
,20130909,4705,4745,4745,4745,4745,4745,4745,0,0,2,47.45,0
,20130910,4745,4745,,,,4745,4745,0,0,0,0,0
,20130911,4745,4745,,,,4745,4745,0,0,0,0,0
,20130912,4745,4745,,,,4745,4745,0,0,0,0,0
,20130913,4745,4745,,,,4745,4745,0,0,0,0,0
,20130916,4745,4745,,,,4745,4745,0,0,0,0,0
,20130917,4745,4745,,,,4745,4745,0,0,0,0,0
,20130918,4745,4745,,,,4745,4745,0,0,0,0,0
,20130923,4745,4745,,,,4745,4745,0,0,0,0,0
,20130924,4745,4745,,,,4745,4745,0,0,0,0,0
,20130925,4745,4745,,,,4745,4745,0,0,0,0,0
,20130926,4745,4745,,,,4745,4745,0,0,0,0,0
,20130927,4745,4745,,,,4745,4745,0,0,0,0,0
,20130930,4745,4745,,,,4745,4745,0,0,0,0,0
,20131008,4745,4745,,,,5075,5075,330,330,0,0,0
,20131009,5075,5075,,,,5075,5075,0,0,0,0,0
,20131010,5075,5075,,,,4821,4821,-254,-254,0,0,0
,20131011,4821,4821,,,,4579,4579,-242,-242,0,0,0
,20131014,4579,4579,,,,4350,4350,-229,-229,0,0,0
,20131015,4350,4350,,,,4350,4350,0,0,0,0,0
,20131016,4350,4350,,,,4350,4350,0,0,0,0,0
,20131017,4350,4350,,,,4350,4350,0,0,0,0,0
,20131018,4350,4350,,,,4350,4350,0,0,0,0,0
,20131021,4350,4350,4142,4142,4142,4142,4142,-208,-208,2,41.42,2
,20131022,4142,4142,,,,4142,4142,0,0,0,0,2
,20131023,4142,4142,4041,4041,4041,4041,4041,-101,-101,2,40.41,4
,20131024,4041,4041,,,,4041,4041,0,0,0,0,4
,20131025,4041,4041,4243,4243,3855,4135,4086,94,45,16,326.95,2
,20131028,4135,4086,4086,4086,4086,4086,4086,0,0,2,40.86,0
,20131029,4086,4086,4267,4289,4267,4289,4278,203,192,4,85.56,4
,20131030,4289,4278,4489,4490,4065,4065,4247,-213,-31,14,297.29,6
,20131031,4065,4247,4247,4247,4247,4247,4247,0,0,6,127.41,0
,20131101,4247,4247,,,,4247,4247,0,0,0,0,0
,20131104,4247,4247,,,,4247,4247,0,0,0,0,0
,20131105,4247,4247,,,,4247,4247,0,0,0,0,0
,20131106,4247,4247,,,,4247,4247,0,0,0,0,0
,20131107,4247,4247,,,,4247,4247,0,0,0,0,0
,20131108,4247,4247,,,,4247,4247,0,0,0,0,0
,20131111,4247,4247,,,,4247,4247,0,0,0,0,0
,20131112,4247,4247,,,,4247,4247,0,0,0,0,0
,20131113,4247,4247,,,,4247,4247,0,0,0,0,0
,20131114,4247,4247,,,,4247,4247,0,0,0,0,0
,20131115,4247,4247,,,,4247,4247,0,0,0,0,0
,20131118,4247,4247,4366,4397,4366,4397,4381,150,134,4,87.63,4
,20131119,4397,4381,4549,4549,4173,4266,4350,-115,-31,26,565.54,2
,20131120,4266,4350,,,,4350,4350,0,0,0,0,2
,20131121,4350,4350,,,,4565,4565,215,215,0,0,2
,20131122,4565,4565,,,,4565,4565,0,0,0,0,2
,20131125,4565,4565,4400,4663,4336,4336,4479,-229,-86,20,447.94,0
,20131126,4336,4479,,,,4527,4527,48,48,0,0,0
,20131127,4527,4527,,,,4688,4688,161,161,0,0,0
,20131128,4688,4688,,,,4688,4688,0,0,0,0,0
,20131129,4688,4688,4456,4807,4456,4807,4689,119,1,12,281.38,8
,20131202,4807,4689,,,,4689,4689,0,0,0,0,8
,20131203,4689,4689,,,,4922,4922,233,233,0,0,8
,20131204,4922,4922,,,,4675,4675,-247,-247,0,0,8
,20131205,4675,4675,,,,4675,4675,0,0,0,0,8
,20131206,4675,4675,,,,4600,4600,-75,-75,0,0,8
,20131209,4600,4600,4500,4500,4400,4400,4450,-200,-150,8,178,0
,20131210,4400,4450,,,,4518,4518,68,68,0,0,0
,20131211,4518,4518,,,,4613,4613,95,95,0,0,0
,20131212,4613,4613,,,,4613,4613,0,0,0,0,0
,20131213,4613,4613,,,,4613,4613,0,0,0,0,0
,20131216,4613,4613,,,,4613,4613,0,0,0,0,0
,20131217,4613,4613,,,,4522,4522,-91,-91,0,0,0
,20131218,4522,4522,,,,4361,4361,-161,-161,0,0,0
,20131219,4361,4361,,,,4361,4361,0,0,0,0,0
,20131220,4361,4361,,,,4361,4361,0,0,0,0,0
,20131223,4361,4361,,,,4361,4361,0,0,0,0,0
,20131224,4361,4361,,,,4361,4361,0,0,0,0,0
,20131225,4361,4361,,,,4361,4361,0,0,0,0,0
,20131226,4361,4361,,,,4361,4361,0,0,0,0,0
,20131227,4361,4361,,,,4361,4361,0,0,0,0,0
,20131230,4361,4361,,,,4361,4361,0,0,0,0,0
,20131231,4361,4361,,,,4361,4361,0,0,0,0,0
fu1410,20131008,4745,4745,,,,4745,4745,0,0,0,0,0
,20131009,4745,4745,,,,4745,4745,0,0,0,0,0
,20131010,4745,4745,,,,4745,4745,0,0,0,0,0
,20131011,4745,4745,,,,4507,4507,-238,-238,0,0,0
,20131014,4507,4507,,,,4507,4507,0,0,0,0,0
,20131015,4507,4507,,,,4507,4507,0,0,0,0,0
,20131016,4507,4507,,,,4507,4507,0,0,0,0,0
,20131017,4507,4507,,,,4507,4507,0,0,0,0,0
,20131018,4507,4507,,,,4507,4507,0,0,0,0,0
,20131021,4507,4507,,,,4507,4507,0,0,0,0,0
,20131022,4507,4507,,,,4507,4507,0,0,0,0,0
,20131023,4507,4507,,,,4507,4507,0,0,0,0,0
,20131024,4507,4507,,,,4507,4507,0,0,0,0,0
,20131025,4507,4507,,,,4558,4558,51,51,0,0,0
,20131028,4558,4558,,,,4558,4558,0,0,0,0,0
,20131029,4558,4558,,,,4772,4772,214,214,0,0,0
,20131030,4772,4772,,,,4737,4737,-35,-35,0,0,0
,20131031,4737,4737,,,,4737,4737,0,0,0,0,0
,20131101,4737,4737,,,,4737,4737,0,0,0,0,0
,20131104,4737,4737,,,,4859,4859,122,122,0,0,0
,20131105,4859,4859,,,,4824,4824,-35,-35,0,0,0
,20131106,4824,4824,,,,4860,4860,36,36,0,0,0
,20131107,4860,4860,,,,4750,4750,-110,-110,0,0,0
,20131108,4750,4750,,,,4750,4750,0,0,0,0,0
,20131111,4750,4750,,,,4750,4750,0,0,0,0,0
,20131112,4750,4750,,,,4690,4690,-60,-60,0,0,0
,20131113,4690,4690,,,,4690,4690,0,0,0,0,0
,20131114,4690,4690,,,,4690,4690,0,0,0,0,0
,20131115,4690,4690,,,,4680,4680,-10,-10,0,0,0
,20131118,4680,4680,,,,4828,4828,148,148,0,0,0
,20131119,4828,4828,,,,4794,4794,-34,-34,0,0,0
,20131120,4794,4794,,,,4554,4554,-240,-240,0,0,0
,20131121,4554,4554,,,,4554,4554,0,0,0,0,0
,20131122,4554,4554,,,,4554,4554,0,0,0,0,0
,20131125,4554,4554,,,,4554,4554,0,0,0,0,0
,20131126,4554,4554,,,,4554,4554,0,0,0,0,0
,20131127,4554,4554,,,,4554,4554,0,0,0,0,0
,20131128,4554,4554,,,,4554,4554,0,0,0,0,0
,20131129,4554,4554,,,,4554,4554,0,0,0,0,0
,20131202,4554,4554,,,,4554,4554,0,0,0,0,0
,20131203,4554,4554,,,,4554,4554,0,0,0,0,0
,20131204,4554,4554,,,,4554,4554,0,0,0,0,0
,20131205,4554,4554,,,,4554,4554,0,0,0,0,0
,20131206,4554,4554,,,,4554,4554,0,0,0,0,0
,20131209,4554,4554,,,,4554,4554,0,0,0,0,0
,20131210,4554,4554,,,,4554,4554,0,0,0,0,0
,20131211,4554,4554,,,,4554,4554,0,0,0,0,0
,20131212,4554,4554,,,,4554,4554,0,0,0,0,0
,20131213,4554,4554,,,,4554,4554,0,0,0,0,0
,20131216,4554,4554,,,,4554,4554,0,0,0,0,0
,20131217,4554,4554,,,,4554,4554,0,0,0,0,0
,20131218,4554,4554,,,,4554,4554,0,0,0,0,0
,20131219,4554,4554,,,,4554,4554,0,0,0,0,0
,20131220,4554,4554,,,,4554,4554,0,0,0,0,0
,20131223,4554,4554,,,,4554,4554,0,0,0,0,0
,20131224,4554,4554,,,,4554,4554,0,0,0,0,0
,20131225,4554,4554,,,,4554,4554,0,0,0,0,0
,20131226,4554,4554,,,,4554,4554,0,0,0,0,0
,20131227,4554,4554,,,,4554,4554,0,0,0,0,0
,20131230,4554,4554,,,,4554,4554,0,0,0,0,0
,20131231,4554,4554,4098,4599,4098,4305,4334,-249,-220,6,130.02,0
fu1411,20131101,4737,4737,,,,4689,4689,-48,-48,0,0,0
,20131104,4689,4689,,,,4810,4810,121,121,0,0,0
,20131105,4810,4810,,,,4775,4775,-35,-35,0,0,0
,20131106,4775,4775,,,,4811,4811,36,36,0,0,0
,20131107,4811,4811,,,,4702,4702,-109,-109,0,0,0
,20131108,4702,4702,,,,4692,4692,-10,-10,0,0,0
,20131111,4692,4692,,,,4870,4870,178,178,0,0,0
,20131112,4870,4870,,,,4809,4809,-61,-61,0,0,0
,20131113,4809,4809,,,,4809,4809,0,0,0,0,0
,20131114,4809,4809,,,,4809,4809,0,0,0,0,0
,20131115,4809,4809,,,,4798,4798,-11,-11,0,0,0
,20131118,4798,4798,,,,4949,4949,151,151,0,0,0
,20131119,4949,4949,,,,4914,4914,-35,-35,0,0,0
,20131120,4914,4914,,,,4668,4668,-246,-246,0,0,0
,20131121,4668,4668,,,,4899,4899,231,231,0,0,0
,20131122,4899,4899,,,,4899,4899,0,0,0,0,0
,20131125,4899,4899,,,,4807,4807,-92,-92,0,0,0
,20131126,4807,4807,,,,4858,4858,51,51,0,0,0
,20131127,4858,4858,,,,5030,5030,172,172,0,0,0
,20131128,5030,5030,,,,5030,5030,0,0,0,0,0
,20131129,5030,5030,,,,5031,5031,1,1,0,0,0
,20131202,5031,5031,,,,5031,5031,0,0,0,0,0
,20131203,5031,5031,4747,4747,4747,4747,4747,-284,-284,4,94.94,4
,20131204,4747,4747,4968,4969,4510,4510,4815,-237,68,12,288.94,4
,20131205,4510,4815,,,,4815,4815,0,0,0,0,4
,20131206,4815,4815,,,,4634,4634,-181,-181,0,0,4
,20131209,4634,4634,,,,4482,4482,-152,-152,0,0,4
,20131210,4482,4482,,,,4482,4482,0,0,0,0,4
,20131211,4482,4482,,,,4482,4482,0,0,0,0,4
,20131212,4482,4482,,,,4482,4482,0,0,0,0,4
,20131213,4482,4482,,,,4482,4482,0,0,0,0,4
,20131216,4482,4482,,,,4482,4482,0,0,0,0,4
,20131217,4482,4482,,,,4482,4482,0,0,0,0,4
,20131218,4482,4482,,,,4482,4482,0,0,0,0,4
,20131219,4482,4482,,,,4482,4482,0,0,0,0,4
,20131220,4482,4482,,,,4482,4482,0,0,0,0,4
,20131223,4482,4482,,,,4482,4482,0,0,0,0,4
,20131224,4482,4482,,,,4482,4482,0,0,0,0,4
,20131225,4482,4482,,,,4482,4482,0,0,0,0,4
,20131226,4482,4482,,,,4482,4482,0,0,0,0,4
,20131227,4482,4482,,,,4482,4482,0,0,0,0,4
,20131230,4482,4482,,,,4482,4482,0,0,0,0,4
,20131231,4482,4482,,,,4482,4482,0,0,0,0,4
fu1412,20131202,5031,5031,,,,5031,5031,0,0,0,0,0
,20131203,5031,5031,,,,4747,4747,-284,-284,0,0,0
,20131204,4747,4747,,,,4815,4815,68,68,0,0,0
,20131205,4815,4815,,,,4815,4815,0,0,0,0,0
,20131206,4815,4815,,,,4634,4634,-181,-181,0,0,0
,20131209,4634,4634,,,,4482,4482,-152,-152,0,0,0
,20131210,4482,4482,,,,4482,4482,0,0,0,0,0
,20131211,4482,4482,,,,4482,4482,0,0,0,0,0
,20131212,4482,4482,,,,4482,4482,0,0,0,0,0
,20131213,4482,4482,,,,4482,4482,0,0,0,0,0
,20131216,4482,4482,,,,4482,4482,0,0,0,0,0
,20131217,4482,4482,,,,4482,4482,0,0,0,0,0
,20131218,4482,4482,,,,4482,4482,0,0,0,0,0
,20131219,4482,4482,,,,4482,4482,0,0,0,0,0
,20131220,4482,4482,,,,4482,4482,0,0,0,0,0
,20131223,4482,4482,,,,4482,4482,0,0,0,0,0
,20131224,4482,4482,,,,4482,4482,0,0,0,0,0
,20131225,4482,4482,,,,4482,4482,0,0,0,0,0
,20131226,4482,4482,,,,4482,4482,0,0,0,0,0
,20131227,4482,4482,,,,4482,4482,0,0,0,0,0
,20131230,4482,4482,,,,4482,4482,0,0,0,0,0
,20131231,4482,4482,,,,4482,4482,0,0,0,0,0
pb1301,20130104,15180,15080,15145,15150,15075,15090,15095,10,15,112,"4,226.63",1638
,20130107,15090,15095,15075,15080,15040,15060,15060,-35,-35,138,"5,196.38",1644
,20130108,15060,15060,15045,15055,15000,15000,15045,-60,-15,96,"3,611.20",1640
,20130109,15000,15045,15000,15005,14990,15000,14995,-45,-50,104,"3,899.95",1614
,20130110,15000,14995,15015,15100,15000,15100,15050,105,55,304,"11,438.33",1658
,20130111,15100,15050,15100,15100,15050,15070,15085,20,35,112,"4,223.88",1612
,20130114,15070,15085,15030,15030,14900,14960,14965,-125,-120,70,"2,618.95",1578
,20130115,14960,14965,15000,15000,14850,14850,14895,-115,-70,134,"4,990.98",1538
pb1302,20130104,15265,15240,15315,15315,15225,15250,15250,10,10,402,"15,329.78",2388
,20130107,15250,15250,15235,15235,15165,15170,15190,-80,-60,266,"10,102.73",2344
,20130108,15170,15190,15225,15225,15120,15120,15150,-70,-40,134,"5,076.35",2288
,20130109,15120,15150,15100,15130,15100,15125,15110,-25,-40,124,"4,684.98",2210
,20130110,15125,15110,15120,15200,15120,15200,15155,90,45,136,"5,153.95",2198
,20130111,15200,15155,15225,15225,15140,15190,15180,35,25,172,"6,529.13",2202
,20130114,15190,15180,15100,15125,15025,15110,15105,-70,-75,206,"7,779.70",2108
,20130115,15110,15105,15030,15060,14960,14970,15005,-135,-100,208,"7,803.35",2012
,20130116,14970,15005,15030,15040,14995,15020,15015,15,10,164,"6,156.83",1964
,20130117,15020,15015,14985,14990,14940,14970,14960,-45,-55,356,"13,317.70",1750
,20130118,14970,14960,15030,15050,14990,15040,15020,80,60,72,"2,704.45",1752
,20130121,15040,15020,15045,15050,15010,15040,15030,20,10,42,"1,578.28",1750
,20130122,15040,15030,15100,15250,15045,15070,15080,40,50,444,"16,739.28",1678
,20130123,15070,15080,15090,15110,15060,15110,15080,30,0,176,"6,637.13",1660
,20130124,15110,15080,15070,15120,15070,15100,15100,20,20,156,"5,889.13",1702
,20130125,15100,15100,15150,15195,15145,15190,15165,90,65,178,"6,748.75",1778
,20130128,15190,15165,15160,15160,15115,15140,15135,-25,-30,46,"1,740.60",1752
,20130129,15140,15135,15100,15160,15100,15150,15135,15,0,78,"2,951.60",1766
,20130130,15150,15135,15150,15270,15135,15200,15210,65,75,202,"7,683.00",1818
,20130131,15200,15210,15285,15300,15255,15300,15275,90,65,532,"20,317.08",2008
,20130201,15300,15275,15200,15280,15155,15180,15200,-95,-75,16,608,2004
,20130204,15180,15200,15300,15320,15260,15270,15290,70,90,76,"2,905.10",1986
,20130205,15270,15290,15200,15210,15180,15190,15190,-100,-100,124,"4,709.05",1930
,20130206,15190,15190,15190,15270,15130,15130,15185,-60,-5,36,"1,366.83",1918
,20130207,15130,15185,15050,15050,15050,15050,15050,-135,-135,4,150.5,1916
,20130208,15050,15050,15065,15085,15065,15085,15075,35,25,8,301.5,1912
,20130218,15085,15075,15065,15065,15030,15050,15035,-25,-40,108,"4,060.70",1934
pb1303,20130104,15390,15390,15690,15690,15370,15410,15400,20,10,366,"14,094.95",1748
,20130107,15410,15400,15385,15385,15300,15330,15340,-70,-60,258,"9,894.73",1814
,20130108,15330,15340,15300,15365,15270,15270,15300,-70,-40,118,"4,514.38",1856
,20130109,15270,15300,15260,15270,15255,15260,15260,-40,-40,148,"5,646.48",1870
,20130110,15260,15260,15265,15340,15265,15340,15305,80,45,86,"3,290.85",1884
,20130111,15340,15305,15365,15375,15320,15345,15350,40,45,270,"10,361.30",2102
,20130114,15345,15350,15260,15300,15240,15270,15255,-80,-95,222,"8,469.08",2170
,20130115,15270,15255,15220,15220,15110,15130,15155,-125,-100,270,"10,232.90",2190
,20130116,15130,15155,15205,15205,15140,15170,15155,15,0,124,"4,699.58",2182
,20130117,15170,15155,15130,15130,15035,15100,15090,-55,-65,116,"4,377.00",2174
,20130118,15100,15090,15195,15195,15130,15190,15175,100,85,70,"2,655.88",2204
,20130121,15190,15175,15270,15270,15140,15140,15205,-35,30,36,"1,368.80",2220
,20130122,15140,15205,15200,15300,15190,15205,15215,0,10,400,"15,216.65",2286
,20130123,15205,15215,15250,15250,15150,15250,15210,35,-5,184,"6,997.03",2228
,20130124,15250,15210,15275,15275,15190,15220,15210,10,0,240,"9,127.38",2248
,20130125,15220,15210,15250,15505,15225,15340,15300,130,90,286,"10,940.88",2298
,20130128,15340,15300,15295,15305,15245,15245,15265,-55,-35,70,"2,671.93",2300
,20130129,15245,15265,15245,15290,15230,15280,15260,15,-5,136,"5,189.05",2272
,20130130,15280,15260,15295,15390,15295,15350,15350,90,90,168,"6,447.60",2240
,20130131,15350,15350,15420,15450,15380,15430,15410,80,60,190,"7,320.88",2166
,20130201,15430,15410,15410,15410,15295,15350,15320,-60,-90,130,"4,979.40",2144
,20130204,15350,15320,15440,15460,15375,15405,15410,85,90,342,"13,179.45",2000
,20130205,15405,15410,15315,15355,15300,15315,15315,-95,-95,168,"6,433.88",1970
,20130206,15315,15315,15305,15350,15270,15270,15295,-45,-20,60,"2,294.28",1954
,20130207,15270,15295,14545,15220,14545,15190,15135,-105,-160,134,"5,071.50",1938
,20130208,15190,15135,15170,15250,15170,15250,15220,115,85,34,"1,293.93",1932
,20130218,15250,15220,15245,15250,15180,15210,15200,-10,-20,200,"7,601.85",1976
,20130219,15210,15200,15215,15215,15140,15155,15165,-45,-35,58,"2,199.38",1966
,20130220,15155,15165,15135,15165,15115,15155,15150,-10,-15,110,"4,166.35",1972
,20130221,15155,15150,15080,15080,14895,14900,14925,-250,-225,136,"5,075.53",1926
,20130222,14900,14925,14880,14985,14880,14980,14940,55,15,242,"9,040.60",1866
,20130225,14980,14940,14910,14910,14860,14895,14885,-45,-55,174,"6,475.28",1826
,20130226,14895,14885,14905,14910,14830,14830,14890,-55,5,112,"4,170.05",1778
,20130227,14830,14890,14980,15000,14900,14905,14930,15,40,124,"4,629.05",1768
,20130228,14905,14930,14855,14890,14855,14870,14870,-60,-60,266,"9,891.50",1888
,20130301,14870,14870,14800,14805,14720,14730,14750,-140,-120,240,"8,852.08",1952
,20130304,14730,14750,14695,14695,14600,14630,14650,-120,-100,328,"12,014.45",1838
,20130305,14630,14650,14655,14660,14630,14645,14645,-5,-5,112,"4,101.83",1806
,20130306,14645,14645,14640,14700,14580,14615,14620,-30,-25,46,"1,681.45",1804
,20130307,14615,14620,14500,14595,14500,14545,14550,-75,-70,196,"7,130.90",1808
,20130308,14545,14550,14540,14625,14540,14605,14585,55,35,122,"4,449.70",1820
,20130311,14605,14585,14585,14585,14545,14560,14560,-25,-25,44,"1,601.60",1846
,20130312,14560,14560,14525,14555,14505,14505,14530,-55,-30,50,"1,816.35",1856
,20130313,14505,14530,14520,14580,14520,14560,14555,30,25,16,582.35,1854
,20130314,14560,14555,14500,14500,14460,14480,14485,-75,-70,154,"5,577.63",1754
,20130315,14480,14485,14500,14530,14480,14480,14510,-5,25,142,"5,151.65",1828
pb1304,20130104,15530,15525,15555,15570,15535,15535,15560,10,35,34,"1,322.88",154
,20130107,15535,15560,15505,15520,15450,15475,15485,-85,-75,166,"6,427.73",304
,20130108,15475,15485,15510,15510,15420,15420,15450,-65,-35,92,"3,554.60",386
,20130109,15420,15450,15400,15415,15400,15415,15400,-35,-50,182,"7,009.25",554
,20130110,15415,15400,15410,15455,15410,15455,15445,55,45,52,"2,007.93",600
,20130111,15455,15445,15500,15500,15465,15475,15480,30,35,56,"2,167.23",646
,20130114,15475,15480,15410,15415,15380,15410,15400,-70,-80,130,"5,005.68",742
,20130115,15410,15400,15350,15355,15260,15270,15295,-130,-105,252,"9,636.25",862
,20130116,15270,15295,15335,15335,15290,15310,15300,15,5,130,"4,973.20",962
,20130117,15310,15300,15270,15270,15230,15230,15250,-70,-50,160,"6,101.28",1084
,20130118,15230,15250,15290,15350,15275,15325,15305,75,55,98,"3,750.10",1164
,20130121,15325,15305,15305,15305,15300,15300,15300,-5,-5,4,153.03,1162
,20130122,15300,15300,15315,15375,15315,15360,15335,60,35,312,"11,962.88",1436
,20130123,15360,15335,15360,15370,15320,15365,15350,30,15,278,"10,669.08",1576
,20130124,15365,15350,15315,15350,15305,15330,15335,-20,-15,144,"5,520.95",1632
,20130125,15330,15335,15390,15495,15390,15460,15425,125,90,412,"15,891.13",1944
,20130128,15460,15425,15420,15425,15375,15385,15395,-40,-30,100,"3,849.30",1932
,20130129,15385,15395,15390,15430,15350,15405,15400,10,5,120,"4,620.38",1988
,20130130,15405,15400,15425,15545,15410,15470,15490,70,90,184,"7,125.48",2084
,20130131,15470,15490,15620,15625,15510,15545,15545,55,55,304,"11,816.90",2272
,20130201,15545,15545,15500,15505,15415,15505,15460,-40,-85,162,"6,262.75",2306
,20130204,15505,15460,15600,15600,15515,15535,15550,75,90,336,"13,065.68",2418
,20130205,15535,15550,15470,15490,15440,15450,15450,-100,-100,218,"8,422.85",2432
,20130206,15450,15450,15500,15500,15395,15400,15430,-50,-20,56,"2,160.48",2442
,20130207,15400,15430,15400,15400,15260,15345,15305,-85,-125,72,"2,755.75",2458
,20130208,15345,15305,15350,15390,15300,15390,15355,85,50,40,"1,535.63",2466
,20130218,15390,15355,15275,15375,15275,15330,15340,-25,-15,270,"10,356.73",2444
,20130219,15330,15340,15320,15355,15275,15290,15305,-50,-35,174,"6,658.23",2540
,20130220,15290,15305,15300,15300,15260,15275,15275,-30,-30,164,"6,264.65",2586
,20130221,15275,15275,15150,15150,15020,15040,15060,-235,-215,270,"10,166.83",2434
,20130222,15040,15060,15090,15115,15030,15115,15085,55,25,400,"15,085.28",2332
,20130225,15115,15085,14945,15175,14650,15175,15010,90,-75,196,"7,356.90",2254
,20130226,15175,15010,15050,15050,14940,14970,15025,-40,15,204,"7,663.80",2168
,20130227,14970,15025,14970,15095,14840,15030,15030,5,5,196,"7,365.63",2132
,20130228,15030,15030,15050,15050,14990,14990,15010,-40,-20,148,"5,554.80",2124
,20130301,14990,15010,14890,14910,14805,14860,14840,-150,-170,382,"14,176.25",1992
,20130304,14860,14840,14840,14840,14740,14760,14775,-80,-65,178,"6,575.55",1986
,20130305,14760,14775,14780,14780,14750,14765,14765,-10,-10,150,"5,537.35",1978
,20130306,14765,14765,14750,14750,14695,14745,14715,-20,-50,154,"5,665.40",1988
,20130307,14745,14715,14620,14685,14580,14645,14650,-70,-65,376,"13,775.45",2026
,20130308,14645,14650,14685,14715,14650,14695,14675,45,25,304,"11,154.55",2052
,20130311,14695,14675,14650,14680,14645,14650,14650,-25,-25,208,"7,619.35",2018
,20130312,14650,14650,14625,14645,14595,14600,14625,-50,-25,160,"5,850.13",2012
,20130313,14600,14625,14660,14690,14640,14645,14670,20,45,62,"2,274.20",1980
,20130314,14645,14670,14570,14610,14570,14600,14590,-70,-80,54,"1,969.80",1978
,20130315,14600,14590,14615,14630,14580,14605,14615,15,25,106,"3,873.10",1950
,20130318,14605,14615,14300,14430,14300,14425,14405,-190,-210,144,"5,186.15",1944
,20130319,14425,14405,14420,14430,14410,14420,14415,15,10,128,"4,614.08",1928
,20130320,14420,14415,14410,14460,14410,14460,14425,45,10,62,"2,236.45",1892
,20130321,14460,14425,14450,14520,14450,14500,14495,75,70,44,"1,594.75",1878
,20130322,14500,14495,14435,14440,14410,14420,14425,-75,-70,56,"2,019.65",1838
,20130325,14420,14425,14450,14515,14440,14500,14460,75,35,212,"7,665.43",1788
,20130326,14500,14460,14435,14500,14435,14500,14450,40,-10,78,"2,817.75",1746
,20130327,14500,14450,14400,14415,14345,14345,14380,-105,-70,278,"9,994.13",1736
,20130328,14345,14380,14330,14400,14325,14380,14370,0,-10,198,"7,115.38",1662
,20130329,14380,14370,14305,14325,14220,14250,14265,-120,-105,194,"6,919.35",1586
,20130401,14250,14265,14140,14275,14140,14205,14195,-60,-70,88,"3,123.68",1536
,20130402,14205,14195,14205,14280,14200,14260,14250,65,55,176,"6,270.30",1434
,20130403,14260,14250,14150,14215,14150,14190,14190,-60,-60,20,709.68,1428
,20130408,14190,14190,14200,14240,14130,14240,14185,50,-5,128,"4,539.53",1384
,20130409,14240,14185,14280,14280,14240,14275,14250,90,65,146,"5,201.65",1468
,20130410,14275,14250,14265,14300,14265,14300,14275,50,25,76,"2,712.35",1422
,20130411,14300,14275,14300,14300,14250,14250,14280,-25,5,70,"2,499.60",1402
,20130412,14250,14280,14260,14270,14225,14250,14245,-30,-35,152,"5,414.38",1406
,20130415,14250,14245,14085,14100,13805,13850,13965,-395,-280,128,"4,469.65",1478
pb1305,20130104,15615,15615,,,,15615,15615,0,0,0,0,2
,20130107,15615,15615,15550,15550,15550,15550,15550,-65,-65,2,77.75,4
,20130108,15550,15550,,,,15550,15550,0,0,0,0,4
,20130109,15550,15550,,,,15550,15550,0,0,0,0,4
,20130110,15550,15550,,,,15550,15550,0,0,0,0,4
,20130111,15550,15550,,,,15550,15550,0,0,0,0,4
,20130114,15550,15550,,,,15550,15550,0,0,0,0,4
,20130115,15550,15550,15400,15415,15395,15415,15400,-135,-150,6,231.05,4
,20130116,15415,15400,,,,15400,15400,0,0,0,0,4
,20130117,15400,15400,,,,15400,15400,0,0,0,0,4
,20130118,15400,15400,15470,15470,15470,15470,15470,70,70,2,77.35,4
,20130121,15470,15470,15370,15370,15370,15370,15370,-100,-100,2,76.85,6
,20130122,15370,15370,15480,15480,15480,15480,15480,110,110,2,77.4,6
,20130123,15480,15480,15415,15485,15400,15485,15455,5,-25,20,772.8,26
,20130124,15485,15455,15455,15470,15455,15470,15460,15,5,10,386.53,32
,20130125,15470,15460,15550,15590,15550,15580,15580,120,120,30,"1,168.50",56
,20130128,15580,15580,15500,15525,15500,15515,15510,-65,-70,22,853.28,72
,20130129,15515,15510,15530,15560,15465,15545,15515,35,5,62,"2,405.13",124
,20130130,15545,15515,15550,15680,15550,15600,15610,85,95,102,"3,981.20",190
,20130131,15600,15610,15690,15705,15650,15700,15680,90,70,210,"8,232.63",340
,20130201,15700,15680,15680,15680,15560,15625,15595,-55,-85,90,"3,509.00",388
,20130204,15625,15595,15800,15800,15650,15665,15695,70,100,266,"10,437.80",588
,20130205,15665,15695,15585,15640,15555,15580,15585,-115,-110,130,"5,066.03",656
,20130206,15580,15585,15615,15630,15530,15530,15575,-55,-10,76,"2,959.43",684
,20130207,15530,15575,15450,15475,15400,15470,15435,-105,-140,132,"5,095.05",736
,20130208,15470,15435,15500,15515,15490,15515,15495,80,60,28,"1,084.90",750
,20130218,15515,15495,15505,15510,15445,15465,15470,-30,-25,128,"4,951.00",828
,20130219,15465,15470,15400,15480,15370,15415,15430,-55,-40,112,"4,321.33",912
,20130220,15415,15430,15410,15430,15390,15415,15415,-15,-15,64,"2,466.50",964
,20130221,15415,15415,15290,15290,15115,15185,15200,-230,-215,304,"11,552.40",1172
,20130222,15185,15200,15205,15240,15180,15235,15210,35,10,444,"16,887.75",1506
,20130225,15235,15210,15160,15220,15145,15170,15165,-40,-45,218,"8,265.23",1608
,20130226,15170,15165,15170,15175,15065,15085,15135,-80,-30,96,"3,632.53",1652
,20130227,15085,15135,15160,15200,15150,15155,15170,20,35,204,"7,737.08",1778
,20130228,15155,15170,15175,15210,15125,15125,15155,-45,-15,144,"5,457.35",1850
,20130301,15125,15155,15035,15040,14930,15010,14985,-145,-170,222,"8,318.05",1908
,20130304,15010,14985,14965,15000,14880,14885,14935,-100,-50,210,"7,841.10",2026
,20130305,14885,14935,15000,15000,14870,14900,14905,-35,-30,196,"7,305.73",2078
,20130306,14900,14905,14900,14900,14835,14880,14855,-25,-50,96,"3,565.38",2068
,20130307,14880,14855,14755,14865,14710,14775,14795,-80,-60,350,"12,949.93",2236
,20130308,14775,14795,14820,14830,14785,14830,14805,35,10,144,"5,331.08",2262
,20130311,14830,14805,14560,14800,14560,14765,14765,-40,-40,212,"7,827.78",2356
,20130312,14765,14765,14765,14770,14715,14720,14735,-45,-30,140,"5,158.40",2372
,20130313,14720,14735,14780,14800,14750,14750,14780,15,45,110,"4,065.08",2334
,20130314,14750,14780,14630,14730,14630,14730,14700,-50,-80,136,"4,999.63",2314
,20130315,14730,14700,14820,14820,14705,14735,14745,35,45,222,"8,186.08",2244
,20130318,14735,14745,14650,14650,14450,14490,14490,-255,-255,302,"10,943.38",2184
,20130319,14490,14490,14410,14540,14410,14515,14515,25,25,194,"7,040.15",2174
,20130320,14515,14515,14490,14550,14490,14550,14520,35,5,258,"9,367.30",2160
,20130321,14550,14520,14570,14610,14560,14590,14585,70,65,88,"3,209.25",2146
,20130322,14590,14585,14500,14540,14485,14500,14510,-85,-75,106,"3,845.58",2098
,20130325,14500,14510,14540,14595,14530,14585,14565,75,55,86,"3,132.23",2106
,20130326,14585,14565,14545,14570,14475,14570,14525,5,-40,174,"6,320.38",2018
,20130327,14570,14525,14485,14505,14450,14450,14480,-75,-45,232,"8,399.38",2018
,20130328,14450,14480,14460,14480,14430,14430,14445,-50,-35,248,"8,958.00",1902
,20130329,14430,14445,14380,14470,14330,14350,14385,-95,-60,378,"13,595.65",1956
,20130401,14350,14385,14300,14310,14215,14290,14270,-95,-115,130,"4,638.18",1934
,20130402,14290,14270,14390,14390,14315,14365,14350,95,80,314,"11,266.45",2030
,20130403,14365,14350,14290,14350,14255,14255,14295,-95,-55,288,"10,293.40",1954
,20130408,14255,14295,14295,14310,14270,14310,14280,15,-15,116,"4,141.93",1886
,20130409,14310,14280,14365,14370,14310,14370,14350,90,70,124,"4,449.03",1918
,20130410,14370,14350,14385,14385,14340,14350,14355,0,5,24,861.33,1924
,20130411,14350,14355,14350,14365,14320,14320,14335,-35,-20,48,"1,720.73",1920
,20130412,14320,14335,14345,14345,14295,14300,14315,-35,-20,76,"2,720.08",1916
,20130415,14300,14315,14125,14165,13930,13930,14055,-385,-260,178,"6,255.60",1908
,20130416,13930,14055,13900,14000,13870,13935,13945,-120,-110,314,"10,949.30",1848
,20130417,13935,13945,13935,14000,13865,13880,13955,-65,10,216,"7,536.85",1876
,20130418,13880,13955,13435,13655,13350,13560,13550,-395,-405,250,"8,468.85",1836
,20130419,13560,13550,13625,13800,13625,13800,13665,250,115,126,"4,305.55",1822
,20130422,13800,13665,13735,13735,13650,13650,13695,-15,30,98,"3,355.60",1814
,20130423,13650,13695,13600,13630,13600,13630,13615,-65,-80,76,"2,587.60",1790
,20130424,13630,13615,13740,13750,13665,13750,13730,135,115,340,"11,671.15",1838
,20130425,13750,13730,13790,13800,13755,13800,13770,70,40,62,"2,134.90",1804
,20130426,13800,13770,13855,13855,13775,13800,13790,30,20,264,"9,102.60",1752
,20130502,13800,13790,13525,13735,13420,13640,13665,-150,-125,206,"7,039.53",1788
,20130503,13640,13665,13670,13705,13650,13690,13685,25,20,134,"4,585.60",1722
,20130506,13690,13685,13770,13815,13770,13800,13790,115,105,52,"1,792.73",1724
,20130507,13800,13790,13800,13800,13765,13790,13790,0,0,34,"1,172.55",1718
,20130508,13790,13790,13780,13830,13780,13800,13805,10,15,46,"1,587.90",1704
,20130509,13800,13805,13790,13790,13770,13770,13780,-35,-25,28,964.9,1702
,20130510,13770,13780,13780,13800,13750,13800,13775,20,-5,90,"3,099.90",1696
,20130513,13800,13775,13775,13795,13760,13795,13780,20,5,28,964.83,1686
,20130514,13795,13780,13760,13780,13700,13700,13740,-80,-40,98,"3,367.10",1658
,20130515,13700,13740,13695,13700,13660,13695,13675,-45,-65,294,"10,052.60",1676
pb1306,20130104,15580,15580,,,,15580,15580,0,0,0,0,12
,20130107,15580,15580,,,,15580,15580,0,0,0,0,12
,20130108,15580,15580,,,,15580,15580,0,0,0,0,12
,20130109,15580,15580,,,,15580,15580,0,0,0,0,12
,20130110,15580,15580,,,,15580,15580,0,0,0,0,12
,20130111,15580,15580,,,,15580,15580,0,0,0,0,12
,20130114,15580,15580,,,,15580,15580,0,0,0,0,12
,20130115,15580,15580,,,,15555,15555,-25,-25,0,0,12
,20130116,15555,15555,,,,15555,15555,0,0,0,0,12
,20130117,15555,15555,,,,15555,15555,0,0,0,0,12
,20130118,15555,15555,,,,15625,15625,70,70,0,0,12
,20130121,15625,15625,,,,15625,15625,0,0,0,0,12
,20130122,15625,15625,15540,15540,15540,15540,15540,-85,-85,4,155.4,16
,20130123,15540,15540,,,,15540,15540,0,0,0,0,16
,20130124,15540,15540,,,,15540,15540,0,0,0,0,16
,20130125,15540,15540,,,,15640,15640,100,100,0,0,16
,20130128,15640,15640,,,,15640,15640,0,0,0,0,16
,20130129,15640,15640,,,,15640,15640,0,0,0,0,16
,20130130,15640,15640,15720,15860,15710,15775,15755,135,115,10,393.93,16
,20130131,15775,15755,15950,15950,15840,15840,15875,85,120,6,238.15,20
,20130201,15840,15875,,,,15800,15800,-75,-75,0,0,20
,20130204,15800,15800,,,,15800,15800,0,0,0,0,20
,20130205,15800,15800,,,,15730,15730,-70,-70,0,0,20
,20130206,15730,15730,15800,15800,15345,15660,15670,-70,-60,50,"1,959.03",30
,20130207,15660,15670,,,,15645,15645,-25,-25,0,0,30
,20130208,15645,15645,,,,15645,15645,0,0,0,0,30
,20130218,15645,15645,,,,15620,15620,-25,-25,0,0,30
,20130219,15620,15620,,,,15600,15600,-20,-20,0,0,30
,20130220,15600,15600,,,,15570,15570,-30,-30,0,0,30
,20130221,15570,15570,,,,15395,15395,-175,-175,0,0,30
,20130222,15395,15395,15305,15360,15305,15350,15345,-45,-50,94,"3,606.75",122
,20130225,15350,15345,15275,15300,15275,15300,15285,-45,-60,26,993.78,142
,20130226,15300,15285,15300,15300,15180,15240,15275,-45,-10,90,"3,437.30",190
,20130227,15240,15275,15300,15320,15300,15305,15305,30,30,34,"1,301.15",220
,20130228,15305,15305,15300,15310,15300,15310,15305,5,0,4,153.05,218
,20130301,15310,15305,15160,15160,15090,15135,15115,-170,-190,48,"1,813.98",250
,20130304,15135,15115,15125,15125,15000,15000,15010,-115,-105,124,"4,654.45",330
,20130305,15000,15010,15030,15050,15000,15045,15025,35,15,50,"1,878.58",354
,20130306,15045,15025,15065,15065,14960,14980,14975,-45,-50,62,"2,321.60",398
,20130307,14980,14975,14900,14930,14830,14910,14895,-65,-80,108,"4,021.70",480
,20130308,14910,14895,14910,14940,14895,14920,14915,25,20,88,"3,281.38",556
,20130311,14920,14915,14875,14910,14870,14900,14890,-15,-25,108,"4,020.78",632
,20130312,14900,14890,14880,14900,14840,14840,14865,-50,-25,52,"1,932.73",654
,20130313,14840,14865,14885,14920,14885,14890,14900,25,35,64,"2,384.23",680
,20130314,14890,14900,14890,14890,14820,14840,14840,-60,-60,60,"2,226.05",706
,20130315,14840,14840,14860,14880,14820,14820,14865,-20,25,146,"5,426.00",820
,20130318,14820,14865,14730,14730,14450,14620,14615,-245,-250,210,"7,673.78",954
,20130319,14620,14615,14625,14700,14625,14635,14650,20,35,122,"4,468.75",1000
,20130320,14635,14650,14610,14685,14610,14670,14645,20,-5,218,"7,983.73",1146
,20130321,14670,14645,14720,14725,14700,14705,14705,60,60,66,"2,426.93",1170
,20130322,14705,14705,14640,14650,14605,14620,14620,-85,-85,114,"4,167.70",1256
,20130325,14620,14620,14680,14730,14650,14725,14690,105,70,188,"6,904.43",1374
,20130326,14725,14690,14650,14680,14650,14680,14660,-10,-30,112,"4,105.48",1452
,20130327,14680,14660,14615,14665,14430,14540,14585,-120,-75,266,"9,700.88",1550
,20130328,14540,14585,14555,14580,14540,14570,14555,-15,-30,84,"3,056.73",1544
,20130329,14570,14555,14445,14550,14440,14450,14495,-105,-60,114,"4,131.48",1606
,20130401,14450,14495,14400,14470,14375,14395,14415,-100,-80,124,"4,469.50",1664
,20130402,14395,14415,14500,14535,14420,14475,14465,60,50,282,"10,200.60",1870
,20130403,14475,14465,14365,14430,14350,14350,14400,-115,-65,206,"7,418.25",2018
,20130408,14350,14400,14340,14425,14340,14425,14395,25,-5,134,"4,823.28",2066
,20130409,14425,14395,14500,14500,14415,14480,14460,85,65,82,"2,964.53",2124
,20130410,14480,14460,14500,14500,14450,14480,14465,20,5,62,"2,242.75",2130
,20130411,14480,14465,14400,14490,14400,14440,14465,-25,0,94,"3,399.43",2142
,20130412,14440,14465,14405,14450,14380,14410,14420,-55,-45,76,"2,740.63",2162
,20130415,14410,14420,14230,14270,14015,14020,14135,-400,-285,156,"5,512.88",2156
,20130416,14020,14135,13805,14125,13805,14035,14035,-100,-100,392,"13,756.73",2132
,20130417,14035,14035,14070,14090,13950,13955,14010,-80,-25,262,"9,177.05",2128
,20130418,13955,14010,13425,13705,13425,13610,13610,-400,-400,196,"6,670.30",2164
,20130419,13610,13610,13785,13875,13680,13865,13740,255,130,212,"7,284.63",2122
,20130422,13865,13740,13830,13830,13670,13700,13760,-40,20,426,"14,659.20",2036
,20130423,13700,13760,13745,13760,13650,13690,13680,-70,-80,100,"3,420.95",2048
,20130424,13690,13680,13820,13835,13745,13810,13805,130,125,152,"5,247.20",2114
,20130425,13810,13805,13850,13895,13825,13870,13855,65,50,94,"3,256.28",2108
,20130426,13870,13855,13945,13990,13840,13875,13880,20,25,188,"6,524.95",2146
,20130502,13875,13880,13480,13850,13480,13630,13700,-250,-180,454,"15,551.50",2138
,20130503,13630,13700,13715,13765,13685,13720,13730,20,30,186,"6,386.38",2150
,20130506,13720,13730,13765,13895,13765,13840,13845,110,115,320,"11,078.95",2090
,20130507,13840,13845,13855,13880,13810,13870,13840,25,-5,126,"4,360.43",2034
,20130508,13870,13840,13900,13925,13835,13885,13880,45,40,118,"4,095.48",2040
,20130509,13885,13880,13855,13860,13815,13815,13845,-65,-35,278,"9,623.50",2226
,20130510,13815,13845,13800,13870,13800,13850,13825,5,-20,162,"5,600.98",2322
,20130513,13850,13825,13800,13830,13780,13825,13805,0,-20,106,"3,658.55",2284
,20130514,13825,13805,13815,13815,13790,13790,13800,-15,-5,42,"1,449.20",2268
,20130515,13790,13800,13750,13770,13745,13770,13755,-30,-45,270,"9,285.78",2196
,20130516,13770,13755,13735,13770,13700,13770,13740,15,-15,100,"3,435.10",2158
,20130517,13770,13740,13405,13845,13405,13790,13650,50,-90,66,"2,252.83",2144
,20130520,13790,13650,13800,13800,13765,13785,13780,135,130,32,"1,102.40",2144
,20130521,13785,13780,13850,13880,13820,13820,13830,40,50,44,"1,521.83",2136
,20130522,13820,13830,13850,13880,13835,13880,13860,50,30,10,346.5,2134
,20130523,13880,13860,13830,13830,13775,13775,13785,-85,-75,32,"1,102.98",2110
,20130524,13775,13785,13800,13840,13740,13805,13800,20,15,82,"2,829.28",2060
,20130527,13805,13800,13790,13800,13790,13790,13795,-10,-5,204,"7,036.08",1922
,20130528,13790,13795,13800,13800,13765,13765,13790,-30,-5,54,"1,861.70",1902
,20130529,13765,13790,13810,13845,13800,13820,13815,30,25,116,"4,006.73",1878
,20130530,13820,13815,13860,13880,13840,13865,13855,50,40,298,"10,323.08",1934
,20130531,13865,13855,13880,13995,13880,13935,13925,80,70,92,"3,202.88",1902
,20130603,13935,13925,13965,13990,13935,13990,13955,65,30,82,"2,861.38",1918
,20130604,13990,13955,14000,14020,14000,14020,14000,65,45,332,"11,621.75",1772
,20130605,14020,14000,14065,14125,14050,14120,14085,120,85,222,"7,817.45",1834
,20130606,14120,14085,14050,14050,14000,14025,14025,-60,-60,104,"3,647.78",1834
,20130607,14025,14025,13965,14045,13965,14045,14005,20,-20,56,"1,961.25",1818
,20130613,14045,14005,13825,13850,13810,13850,13835,-155,-170,64,"2,214.18",1814
,20130614,13850,13835,13805,13820,13800,13820,13805,-15,-30,46,"1,587.65",1782
,20130617,13820,13805,13880,13900,13880,13895,13885,90,80,36,"1,250.00",1782
pb1307,20130104,15600,15600,,,,15635,15635,35,35,0,0,6
,20130107,15635,15635,,,,15565,15565,-70,-70,0,0,6
,20130108,15565,15565,,,,15565,15565,0,0,0,0,6
,20130109,15565,15565,,,,15590,15590,25,25,0,0,6
,20130110,15590,15590,,,,15630,15630,40,40,0,0,6
,20130111,15630,15630,,,,15665,15665,35,35,0,0,6
,20130114,15665,15665,,,,15585,15585,-80,-80,0,0,6
,20130115,15585,15585,,,,15585,15585,0,0,0,0,6
,20130116,15585,15585,,,,15585,15585,0,0,0,0,6
,20130117,15585,15585,,,,15585,15585,0,0,0,0,6
,20130118,15585,15585,,,,15655,15655,70,70,0,0,6
,20130121,15655,15655,,,,15655,15655,0,0,0,0,6
,20130122,15655,15655,15865,15960,15600,15760,15855,105,200,144,"5,708.63",100
,20130123,15760,15855,15785,15785,15725,15730,15740,-125,-115,10,393.6,98
,20130124,15730,15740,15705,15760,15700,15700,15720,-40,-20,22,864.83,98
,20130125,15700,15720,15770,15800,15770,15800,15785,80,65,28,"1,105.05",94
,20130128,15800,15785,,,,15785,15785,0,0,0,0,94
,20130129,15785,15785,15705,15705,15705,15705,15705,-80,-80,4,157.05,94
,20130130,15705,15705,,,,15750,15750,45,45,0,0,94
,20130131,15750,15750,,,,15825,15825,75,75,0,0,94
,20130201,15825,15825,15770,15780,15770,15780,15770,-45,-55,14,552,94
,20130204,15780,15770,15860,15860,15860,15860,15860,90,90,4,158.6,94
,20130205,15860,15860,15750,15750,15750,15750,15750,-110,-110,2,78.75,92
,20130206,15750,15750,,,,15750,15750,0,0,0,0,92
,20130207,15750,15750,15615,15615,15615,15615,15615,-135,-135,2,78.08,90
,20130208,15615,15615,,,,15650,15650,35,35,0,0,90
,20130218,15650,15650,,,,15650,15650,0,0,0,0,90
,20130219,15650,15650,,,,15650,15650,0,0,0,0,90
,20130220,15650,15650,,,,15635,15635,-15,-15,0,0,90
,20130221,15635,15635,,,,15595,15595,-40,-40,0,0,90
,20130222,15595,15595,15430,15435,15430,15430,15430,-165,-165,10,385.8,96
,20130225,15430,15430,15385,15385,15350,15350,15360,-80,-70,6,230.43,96
,20130226,15350,15360,,,,15355,15355,-5,-5,0,0,96
,20130227,15355,15355,15395,15400,15395,15400,15395,45,40,4,153.98,98
,20130228,15400,15395,15370,15370,15370,15370,15370,-25,-25,4,153.7,102
,20130301,15370,15370,15200,15200,15200,15200,15200,-170,-170,2,76,100
,20130304,15200,15200,,,,15200,15200,0,0,0,0,100
,20130305,15200,15200,,,,15155,15155,-45,-45,0,0,100
,20130306,15155,15155,,,,15105,15105,-50,-50,0,0,100
,20130307,15105,15105,14930,15075,14930,15075,15000,-30,-105,8,300.05,104
,20130308,15075,15000,15075,15075,15075,15075,15075,75,75,2,75.38,104
,20130311,15075,15075,,,,15030,15030,-45,-45,0,0,104
,20130312,15030,15030,,,,14990,14990,-40,-40,0,0,104
,20130313,14990,14990,,,,15025,15025,35,35,0,0,104
,20130314,15025,15025,15060,15060,14920,14920,14940,-105,-85,32,"1,195.23",126
,20130315,14920,14940,,,,14940,14940,0,0,0,0,126
,20130318,14940,14940,14700,14700,14700,14700,14700,-240,-240,6,220.5,132
,20130319,14700,14700,14710,14750,14710,14750,14735,50,35,56,"2,063.10",172
,20130320,14750,14735,14750,14775,14750,14775,14750,40,15,58,"2,138.95",220
,20130321,14775,14750,14820,14830,14805,14820,14815,70,65,46,"1,704.15",240
,20130322,14820,14815,14730,14760,14705,14735,14735,-80,-80,56,"2,063.25",278
,20130325,14735,14735,14755,14830,14755,14825,14795,90,60,18,665.83,292
,20130326,14825,14795,14765,14785,14765,14780,14770,-15,-25,20,738.6,308
,20130327,14780,14770,14710,14730,14650,14650,14710,-120,-60,114,"4,192.40",406
,20130328,14650,14710,14700,14700,14650,14660,14665,-50,-45,168,"6,159.45",530
,20130329,14660,14665,14600,14615,14580,14580,14605,-85,-60,116,"4,235.63",612
,20130401,14580,14605,14510,14540,14480,14495,14500,-110,-105,40,"1,450.18",612
,20130402,14495,14500,14515,14585,14515,14585,14565,85,65,96,"3,496.58",650
,20130403,14585,14565,14480,14525,14480,14490,14495,-75,-70,126,"4,566.45",760
,20130408,14490,14495,14490,14515,14480,14515,14490,20,-5,44,"1,594.43",798
,20130409,14515,14490,14575,14595,14515,14570,14555,80,65,80,"2,911.15",860
,20130410,14570,14555,14600,14600,14555,14555,14570,0,15,24,874.45,864
,20130411,14555,14570,14560,14565,14520,14520,14545,-50,-25,6,218.23,864
,20130412,14520,14545,14515,14515,14470,14515,14485,-30,-60,48,"1,738.65",908
,20130415,14515,14485,14320,14320,14115,14120,14245,-365,-240,76,"2,706.78",918
,20130416,14120,14245,14130,14200,14080,14130,14140,-115,-105,164,"5,798.35",998
,20130417,14130,14140,14205,14205,14070,14070,14135,-70,-5,266,"9,402.10",1136
,20130418,14070,14135,13700,13920,13595,13755,13740,-380,-395,282,"9,688.03",1242
,20130419,13755,13740,13855,13940,13775,13940,13865,200,125,180,"6,240.50",1296
,20130422,13940,13865,13965,13965,13770,13785,13885,-80,20,278,"9,653.03",1488
,20130423,13785,13885,13825,13825,13750,13750,13770,-135,-115,24,826.45,1498
,20130424,13750,13770,13920,13930,13860,13930,13900,160,130,154,"5,351.55",1606
,20130425,13930,13900,13950,13970,13920,13970,13935,70,35,104,"3,623.93",1642
,20130426,13970,13935,14010,14070,13935,13975,13975,40,40,94,"3,285.15",1670
,20130502,13975,13975,13820,13865,13630,13770,13800,-205,-175,188,"6,487.50",1724
,20130503,13770,13800,13775,13855,13775,13825,13830,25,30,114,"3,942.25",1750
,20130506,13825,13830,13975,14000,13900,13930,13945,100,115,260,"9,067.45",1846
,20130507,13930,13945,13910,13950,13890,13915,13910,-30,-35,132,"4,590.60",1838
,20130508,13915,13910,13970,13980,13930,13980,13950,70,40,78,"2,720.70",1856
,20130509,13980,13950,13970,13970,13900,13900,13915,-50,-35,134,"4,661.90",1924
,20130510,13900,13915,13900,13955,13900,13955,13930,40,15,60,"2,089.93",1952
,20130513,13955,13930,13895,13905,13845,13865,13870,-65,-60,312,"10,819.58",2064
,20130514,13865,13870,13960,13960,13825,13870,13880,0,10,54,"1,874.40",2060
,20130515,13870,13880,13800,13815,13780,13800,13800,-80,-80,72,"2,484.03",2062
,20130516,13800,13800,13810,13840,13705,13840,13785,40,-15,308,"10,614.53",2130
,20130517,13840,13785,13825,13895,13800,13885,13830,100,45,108,"3,734.25",2122
,20130520,13885,13830,13990,13990,13800,13810,13820,-20,-10,136,"4,699.08",2118
,20130521,13810,13820,13900,13910,13880,13880,13895,60,75,62,"2,154.05",2082
,20130522,13880,13895,13840,13915,13840,13905,13885,10,-10,46,"1,597.30",2088
,20130523,13905,13885,13850,13860,13800,13825,13845,-60,-40,164,"5,676.60",2060
,20130524,13825,13845,13880,13890,13845,13875,13870,30,25,110,"3,814.25",2046
,20130527,13875,13870,13840,13875,13840,13870,13860,0,-10,28,970.38,2040
,20130528,13870,13860,13870,13870,13845,13850,13855,-10,-5,32,"1,108.45",2052
,20130529,13850,13855,13880,13915,13865,13870,13890,15,35,80,"2,778.50",2074
,20130530,13870,13890,13900,13945,13900,13920,13925,30,35,234,"8,146.20",2080
,20130531,13920,13925,14040,14060,13990,14005,14025,80,100,208,"7,293.10",2092
,20130603,14005,14025,14060,14090,14025,14090,14045,65,20,120,"4,214.93",2104
,20130604,14090,14045,14075,14120,14055,14100,14090,55,45,618,"21,771.35",1822
,20130605,14100,14090,14165,14195,14150,14195,14160,105,70,256,"9,064.20",1812
,20130606,14195,14160,14000,14130,13995,14100,14100,-60,-60,202,"7,121.08",1804
,20130607,14100,14100,14015,14100,14015,14080,14060,-20,-40,112,"3,937.45",1788
,20130613,14080,14060,13655,13970,13655,13905,13920,-155,-140,218,"7,587.33",1696
,20130614,13905,13920,13885,13950,13885,13950,13910,30,-10,106,"3,687.15",1642
,20130617,13950,13910,13950,14015,13950,13965,13985,55,75,60,"2,097.75",1654
,20130618,13965,13985,13990,13990,13950,13950,13965,-35,-20,140,"4,888.48",1548
,20130619,13950,13965,13930,13990,13930,13990,13960,25,-5,138,"4,816.25",1496
,20130620,13990,13960,13775,13940,13775,13800,13880,-160,-80,256,"8,886.00",1404
,20130621,13800,13880,13750,13830,13650,13805,13760,-75,-120,100,"3,441.08",1354
,20130624,13805,13760,13760,13775,13745,13770,13760,10,0,54,"1,858.03",1344
,20130625,13770,13760,13720,13745,13700,13720,13720,-40,-40,68,"2,332.40",1316
,20130626,13720,13720,13760,13760,13720,13740,13740,20,20,54,"1,855.25",1312
,20130627,13740,13740,13740,13750,13730,13740,13740,0,0,96,"3,298.45",1286
,20130628,13740,13740,13740,13740,13690,13690,13720,-50,-20,62,"2,126.78",1264
,20130701,13690,13720,13730,13750,13725,13750,13735,30,15,148,"5,082.38",1212
,20130702,13750,13735,13750,13795,13750,13795,13770,60,35,102,"3,512.18",1182
,20130703,13795,13770,13800,13800,13730,13800,13765,30,-5,150,"5,163.65",1218
,20130704,13800,13765,13750,13760,13740,13740,13745,-25,-20,108,"3,712.00",1198
,20130705,13740,13745,13735,13735,13680,13685,13695,-60,-50,110,"3,767.15",1216
,20130708,13685,13695,13650,13670,13630,13655,13655,-40,-40,236,"8,056.88",1202
,20130709,13655,13655,13750,13750,13700,13700,13710,45,55,76,"2,605.40",1160
,20130710,13700,13710,13660,13660,13620,13660,13640,-50,-70,40,"1,364.35",1160
,20130711,13660,13640,13700,13755,13700,13755,13735,115,95,84,"2,884.85",1180
,20130712,13755,13735,13700,13725,13680,13680,13705,-55,-30,78,"2,672.60",1190
,20130715,13680,13705,13705,13730,13700,13710,13715,5,10,126,"4,320.95",1236
pb1308,20130104,15790,15790,,,,15825,15825,35,35,0,0,4
,20130107,15825,15825,,,,15755,15755,-70,-70,0,0,4
,20130108,15755,15755,,,,15720,15720,-35,-35,0,0,4
,20130109,15720,15720,,,,15720,15720,0,0,0,0,4
,20130110,15720,15720,,,,15720,15720,0,0,0,0,4
,20130111,15720,15720,,,,15720,15720,0,0,0,0,4
,20130114,15720,15720,,,,15720,15720,0,0,0,0,4
,20130115,15720,15720,15580,15580,15580,15580,15580,-140,-140,2,77.9,6
,20130116,15580,15580,,,,15580,15580,0,0,0,0,6
,20130117,15580,15580,,,,15580,15580,0,0,0,0,6
,20130118,15580,15580,,,,15580,15580,0,0,0,0,6
,20130121,15580,15580,,,,15580,15580,0,0,0,0,6
,20130122,15580,15580,,,,15610,15610,30,30,0,0,6
,20130123,15610,15610,,,,15630,15630,20,20,0,0,6
,20130124,15630,15630,,,,15630,15630,0,0,0,0,6
,20130125,15630,15630,,,,15755,15755,125,125,0,0,6
,20130128,15755,15755,,,,15755,15755,0,0,0,0,6
,20130129,15755,15755,,,,15755,15755,0,0,0,0,6
,20130130,15755,15755,,,,15825,15825,70,70,0,0,6
,20130131,15825,15825,,,,15940,15940,115,115,0,0,6
,20130201,15940,15940,,,,15940,15940,0,0,0,0,6
,20130204,15940,15940,,,,16030,16030,90,90,0,0,6
,20130205,16030,16030,,,,15985,15985,-45,-45,0,0,6
,20130206,15985,15985,,,,15970,15970,-15,-15,0,0,6
,20130207,15970,15970,,,,15890,15890,-80,-80,0,0,6
,20130208,15890,15890,,,,15955,15955,65,65,0,0,6
,20130218,15955,15955,,,,15930,15930,-25,-25,0,0,6
,20130219,15930,15930,,,,15780,15780,-150,-150,0,0,6
,20130220,15780,15780,,,,15765,15765,-15,-15,0,0,6
,20130221,15765,15765,,,,15645,15645,-120,-120,0,0,6
,20130222,15645,15645,,,,15480,15480,-165,-165,0,0,6
,20130225,15480,15480,,,,15480,15480,0,0,0,0,6
,20130226,15480,15480,15450,15450,15450,15450,15450,-30,-30,2,77.25,6
,20130227,15450,15450,,,,15490,15490,40,40,0,0,6
,20130228,15490,15490,,,,15460,15460,-30,-30,0,0,6
,20130301,15460,15460,,,,15285,15285,-175,-175,0,0,6
,20130304,15285,15285,,,,15285,15285,0,0,0,0,6
,20130305,15285,15285,,,,15300,15300,15,15,0,0,6
,20130306,15300,15300,,,,15250,15250,-50,-50,0,0,6
,20130307,15250,15250,,,,15210,15210,-40,-40,0,0,6
,20130308,15210,15210,,,,15210,15210,0,0,0,0,6
,20130311,15210,15210,,,,15210,15210,0,0,0,0,6
,20130312,15210,15210,15180,15180,15050,15050,15100,-160,-110,8,302.05,6
,20130313,15050,15100,,,,15135,15135,35,35,0,0,6
,20130314,15135,15135,,,,15045,15045,-90,-90,0,0,6
,20130315,15045,15045,,,,15070,15070,25,25,0,0,6
,20130318,15070,15070,14845,14845,14845,14845,14845,-225,-225,2,74.23,8
,20130319,14845,14845,,,,14845,14845,0,0,0,0,8
,20130320,14845,14845,,,,14845,14845,0,0,0,0,8
,20130321,14845,14845,,,,14845,14845,0,0,0,0,8
,20130322,14845,14845,,,,14765,14765,-80,-80,0,0,8
,20130325,14765,14765,,,,14765,14765,0,0,0,0,8
,20130326,14765,14765,,,,14815,14815,50,50,0,0,8
,20130327,14815,14815,,,,14815,14815,0,0,0,0,8
,20130328,14815,14815,,,,14815,14815,0,0,0,0,8
,20130329,14815,14815,,,,14745,14745,-70,-70,0,0,8
,20130401,14745,14745,,,,14640,14640,-105,-105,0,0,8
,20130402,14640,14640,,,,14640,14640,0,0,0,0,8
,20130403,14640,14640,14505,14610,14505,14605,14570,-35,-70,6,218.6,8
,20130408,14605,14570,,,,14575,14575,5,5,0,0,8
,20130409,14575,14575,14630,14650,14630,14650,14635,75,60,12,439.05,16
,20130410,14650,14635,14660,14660,14650,14660,14655,25,20,14,513.05,24
,20130411,14660,14655,14665,14665,14645,14645,14655,-10,0,4,146.55,26
,20130412,14645,14655,14630,14630,14600,14600,14605,-55,-50,10,365.15,34
,20130415,14600,14605,14330,14330,14250,14250,14310,-355,-295,10,357.83,42
,20130416,14250,14310,14235,14235,14145,14145,14165,-165,-145,8,283.35,40
,20130417,14145,14165,14235,14235,14120,14120,14180,-45,15,96,"3,403.95",102
,20130418,14120,14180,13820,13825,13810,13810,13810,-370,-370,24,828.85,112
,20130419,13810,13810,13920,14000,13890,13890,13915,80,105,22,765.55,116
,20130422,13890,13915,13980,13990,13825,13870,13920,-45,5,20,696.08,122
,20130423,13870,13920,13880,13895,13815,13830,13855,-90,-65,22,762.25,136
,20130424,13830,13855,13960,14010,13955,14010,13965,155,110,58,"2,024.98",180
,20130425,14010,13965,14050,14085,14040,14085,14055,120,90,14,491.98,186
,20130426,14085,14055,14140,14140,14030,14075,14045,20,-10,48,"1,685.90",192
,20130502,14075,14045,13820,13980,13760,13845,13915,-200,-130,260,"9,047.98",370
,20130503,13845,13915,13875,13960,13855,13915,13925,0,10,158,"5,500.40",470
,20130506,13915,13925,14085,14095,13640,14050,14020,125,95,48,"1,682.98",470
,20130507,14050,14020,14000,14005,14000,14005,14000,-15,-20,6,210.03,470
,20130508,14005,14000,14070,14070,14070,14070,14070,70,70,2,70.35,472
,20130509,14070,14070,14005,14005,14000,14000,14000,-70,-70,44,"1,540.20",502
,20130510,14000,14000,14020,14040,14000,14040,14020,40,20,20,701.05,504
,20130513,14040,14020,13985,14005,13920,13970,13965,-50,-55,54,"1,885.73",516
,20130514,13970,13965,13930,13965,13930,13950,13945,-15,-20,16,557.98,514
,20130515,13950,13945,13880,13900,13880,13900,13885,-45,-60,38,"1,319.48",512
,20130516,13900,13885,13920,13925,13860,13925,13880,40,-5,42,"1,457.53",528
,20130517,13925,13880,13930,13990,13890,13990,13930,110,50,120,"4,179.98",602
,20130520,13990,13930,13915,13945,13900,13920,13915,-10,-15,34,"1,183.13",600
,20130521,13920,13915,13950,14010,13940,13940,13970,25,55,88,"3,073.98",628
,20130522,13940,13970,13980,14035,13980,14035,13995,65,25,24,839.85,632
,20130523,14035,13995,14035,14150,13900,13925,13945,-70,-50,148,"5,159.68",734
,20130524,13925,13945,13955,13985,13935,13965,13965,20,20,106,"3,700.95",790
,20130527,13965,13965,13930,13975,13930,13975,13955,10,-10,58,"2,024.00",826
,20130528,13975,13955,13985,13985,13940,13940,13955,-15,0,38,"1,325.98",836
,20130529,13940,13955,13990,14000,13955,13955,13980,0,25,112,"3,915.30",888
,20130530,13955,13980,13990,14030,13990,14030,14015,50,35,162,"5,676.48",976
,20130531,14030,14015,14090,14150,14070,14110,14105,95,90,162,"5,712.58",1032
,20130603,14110,14105,14200,14200,14130,14155,14145,50,40,136,"4,810.88",1114
,20130604,14155,14145,14155,14220,14155,14200,14175,55,30,134,"4,748.65",1144
,20130605,14200,14175,14295,14295,14240,14285,14260,110,85,106,"3,779.33",1198
,20130606,14285,14260,14180,14225,14005,14195,14195,-65,-65,86,"3,052.70",1230
,20130607,14195,14195,14200,14215,14145,14200,14190,5,-5,142,"5,037.60",1326
,20130613,14200,14190,13950,14040,13950,14005,14015,-185,-175,128,"4,485.88",1362
,20130614,14005,14015,14015,14035,13950,14035,13995,20,-20,238,"8,327.48",1312
,20130617,14035,13995,14060,14120,14060,14080,14085,85,90,50,"1,760.80",1296
,20130618,14080,14085,14090,14090,14055,14055,14070,-30,-15,56,"1,970.00",1292
,20130619,14055,14070,14035,14075,14035,14075,14060,5,-10,20,703.15,1290
,20130620,14075,14060,14005,14010,13885,13900,13960,-160,-100,292,"10,192.90",1156
,20130621,13900,13960,13895,13920,13895,13920,13900,-40,-60,30,"1,042.73",1150
,20130624,13920,13900,13860,13860,13805,13810,13825,-90,-75,76,"2,627.43",1118
,20130625,13810,13825,13780,13800,13735,13790,13775,-35,-50,150,"5,166.95",1064
,20130626,13790,13775,13800,13810,13780,13780,13795,5,20,84,"2,897.55",1044
,20130627,13780,13795,13810,13835,13800,13830,13815,35,20,48,"1,658.20",1038
,20130628,13830,13815,13815,13815,13785,13785,13800,-30,-15,56,"1,932.28",1014
,20130701,13785,13800,13825,13855,13805,13825,13820,25,20,56,"1,935.03",1040
,20130702,13825,13820,13855,13880,13850,13880,13855,60,35,34,"1,177.78",1064
,20130703,13880,13855,13870,13870,13820,13860,13845,5,-10,48,"1,661.85",1072
,20130704,13860,13845,13810,13845,13810,13825,13825,-20,-20,60,"2,074.20",1090
,20130705,13825,13825,13835,13835,13740,13760,13785,-65,-40,172,"5,928.00",1230
,20130708,13760,13785,13745,13760,13730,13750,13745,-35,-40,166,"5,704.75",1216
,20130709,13750,13745,13810,13810,13785,13790,13795,45,50,68,"2,345.88",1210
,20130710,13790,13795,13730,13760,13720,13760,13740,-35,-55,82,"2,816.88",1216
,20130711,13760,13740,13845,13845,13820,13840,13830,100,90,118,"4,079.88",1230
,20130712,13840,13830,13805,13805,13770,13770,13780,-60,-50,64,"2,205.15",1236
,20130715,13770,13780,13775,13810,13775,13795,13795,15,15,94,"3,242.15",1254
,20130716,13795,13795,13790,13800,13790,13800,13790,5,-5,28,965.4,1258
,20130717,13800,13790,13800,13810,13785,13805,13795,15,5,56,"1,931.75",1250
,20130718,13805,13795,13755,13775,13730,13750,13745,-45,-50,232,"7,974.58",1262
,20130719,13750,13745,13790,13790,13725,13735,13770,-10,25,122,"4,200.45",1210
,20130722,13735,13770,13775,13785,13775,13785,13775,15,5,114,"3,926.95",1160
,20130723,13785,13775,13795,13795,13770,13770,13780,-5,5,40,"1,378.18",1156
,20130724,13770,13780,13790,13790,13750,13770,13765,-10,-15,186,"6,402.68",1124
,20130725,13770,13765,13770,13780,13760,13780,13770,15,5,188,"6,473.53",1114
,20130726,13780,13770,13770,13780,13765,13770,13770,0,0,176,"6,059.73",1104
,20130729,13770,13770,13680,13705,13680,13690,13695,-80,-75,78,"2,671.08",1122
,20130730,13690,13695,13690,13720,13690,13695,13700,0,5,80,"2,740.45",1144
,20130731,13695,13700,13690,13695,13680,13685,13690,-15,-10,38,"1,300.55",1144
,20130801,13685,13690,13685,13890,13685,13795,13780,105,90,298,"10,268.63",1272
,20130802,13795,13780,13845,13850,13790,13795,13800,15,20,66,"2,277.68",1316
,20130805,13795,13800,13830,13850,13830,13850,13840,50,40,70,"2,422.53",1352
,20130806,13850,13840,13850,13865,13840,13860,13850,20,10,176,"6,094.70",1374
,20130807,13860,13850,13855,13880,13855,13875,13870,25,20,160,"5,548.18",1376
,20130808,13875,13870,13900,14050,13900,14025,13970,155,100,246,"8,592.35",1378
,20130809,14025,13970,13905,14170,13905,14170,14080,200,110,78,"2,745.95",1392
,20130812,14170,14080,14400,14400,14100,14245,14190,165,110,220,"7,804.93",1488
,20130813,14245,14190,14295,14295,14245,14285,14255,95,65,188,"6,700.75",1502
,20130814,14285,14255,14165,14260,14165,14240,14235,-15,-20,94,"3,346.10",1540
,20130815,14240,14235,14240,14450,14240,14440,14365,205,130,116,"4,166.80",1604
pb1309,20130104,15790,15790,,,,15825,15825,35,35,0,0,0
,20130107,15825,15825,,,,15755,15755,-70,-70,0,0,0
,20130108,15755,15755,,,,15720,15720,-35,-35,0,0,0
,20130109,15720,15720,,,,15670,15670,-50,-50,0,0,0
,20130110,15670,15670,,,,15715,15715,45,45,0,0,0
,20130111,15715,15715,15280,15950,15280,15950,15615,235,-100,4,156.15,2
,20130114,15950,15615,,,,15650,15650,35,35,0,0,2
,20130115,15650,15650,,,,15510,15510,-140,-140,0,0,2
,20130116,15510,15510,,,,15515,15515,5,5,0,0,2
,20130117,15515,15515,,,,15465,15465,-50,-50,0,0,2
,20130118,15465,15465,,,,15535,15535,70,70,0,0,2
,20130121,15535,15535,,,,15430,15430,-105,-105,0,0,2
,20130122,15430,15430,,,,15610,15610,180,180,0,0,2
,20130123,15610,15610,,,,15500,15500,-110,-110,0,0,2
,20130124,15500,15500,,,,15480,15480,-20,-20,0,0,2
,20130125,15480,15480,,,,15545,15545,65,65,0,0,2
,20130128,15545,15545,,,,15475,15475,-70,-70,0,0,2
,20130129,15475,15475,,,,15395,15395,-80,-80,0,0,2
,20130130,15395,15395,,,,15510,15510,115,115,0,0,2
,20130131,15510,15510,,,,15625,15625,115,115,0,0,2
,20130201,15625,15625,,,,15570,15570,-55,-55,0,0,2
,20130204,15570,15570,,,,15655,15655,85,85,0,0,2
,20130205,15655,15655,,,,15545,15545,-110,-110,0,0,2
,20130206,15545,15545,,,,15815,15815,270,270,0,0,2
,20130207,15815,15815,,,,15815,15815,0,0,0,0,2
,20130208,15815,15815,,,,15880,15880,65,65,0,0,2
,20130218,15880,15880,,,,15855,15855,-25,-25,0,0,2
,20130219,15855,15855,,,,15815,15815,-40,-40,0,0,2
,20130220,15815,15815,,,,15800,15800,-15,-15,0,0,2
,20130221,15800,15800,,,,15580,15580,-220,-220,0,0,2
,20130222,15580,15580,,,,15415,15415,-165,-165,0,0,2
,20130225,15415,15415,,,,15345,15345,-70,-70,0,0,2
,20130226,15345,15345,,,,15315,15315,-30,-30,0,0,2
,20130227,15315,15315,,,,15355,15355,40,40,0,0,2
,20130228,15355,15355,,,,15330,15330,-25,-25,0,0,2
,20130301,15330,15330,,,,15160,15160,-170,-170,0,0,2
,20130304,15160,15160,,,,15055,15055,-105,-105,0,0,2
,20130305,15055,15055,,,,15070,15070,15,15,0,0,2
,20130306,15070,15070,,,,15020,15020,-50,-50,0,0,2
,20130307,15020,15020,,,,15100,15100,80,80,0,0,2
,20130308,15100,15100,,,,15175,15175,75,75,0,0,2
,20130311,15175,15175,,,,15175,15175,0,0,0,0,2
,20130312,15175,15175,,,,15065,15065,-110,-110,0,0,2
,20130313,15065,15065,,,,15100,15100,35,35,0,0,2
,20130314,15100,15100,,,,15100,15100,0,0,0,0,2
,20130315,15100,15100,,,,15125,15125,25,25,0,0,2
,20130318,15125,15125,,,,15000,15000,-125,-125,0,0,2
,20130319,15000,15000,,,,15000,15000,0,0,0,0,2
,20130320,15000,15000,,,,15015,15015,15,15,0,0,2
,20130321,15015,15015,,,,15080,15080,65,65,0,0,2
,20130322,15080,15080,,,,15075,15075,-5,-5,0,0,2
,20130325,15075,15075,,,,15135,15135,60,60,0,0,2
,20130326,15135,15135,,,,15100,15100,-35,-35,0,0,2
,20130327,15100,15100,,,,15035,15035,-65,-65,0,0,2
,20130328,15035,15035,,,,14985,14985,-50,-50,0,0,2
,20130329,14985,14985,,,,14930,14930,-55,-55,0,0,2
,20130401,14930,14930,,,,14845,14845,-85,-85,0,0,2
,20130402,14845,14845,,,,14915,14915,70,70,0,0,2
,20130403,14915,14915,,,,14845,14845,-70,-70,0,0,2
,20130408,14845,14845,,,,14840,14840,-5,-5,0,0,2
,20130409,14840,14840,14910,14910,14750,14805,14790,-35,-50,16,591.63,2
,20130410,14805,14790,14910,14910,14810,14810,14860,20,70,4,148.6,4
,20130411,14810,14860,,,,14785,14785,-75,-75,0,0,4
,20130412,14785,14785,,,,14775,14775,-10,-10,0,0,4
,20130415,14775,14775,,,,14475,14475,-300,-300,0,0,4
,20130416,14475,14475,,,,14445,14445,-30,-30,0,0,4
,20130417,14445,14445,,,,14380,14380,-65,-65,0,0,4
,20130418,14380,14380,,,,14005,14005,-375,-375,0,0,4
,20130419,14005,14005,,,,14055,14055,50,50,0,0,4
,20130422,14055,14055,14220,14220,13920,13920,14045,-135,-10,14,491.63,12
,20130423,13920,14045,13940,13995,13940,13995,13955,-50,-90,6,209.38,18
,20130424,13995,13955,14020,14065,14020,14065,14040,110,85,12,421.25,22
,20130425,14065,14040,14105,14105,14105,14105,14105,65,65,2,70.53,22
,20130426,14105,14105,,,,14105,14105,0,0,0,0,22
,20130502,14105,14105,,,,14035,14035,-70,-70,0,0,22
,20130503,14035,14035,,,,14035,14035,0,0,0,0,22
,20130506,14035,14035,14435,14435,14045,14095,14130,60,95,166,"5,864.50",126
,20130507,14095,14130,14100,14130,14075,14100,14100,-30,-30,70,"2,467.53",176
,20130508,14100,14100,14150,14155,14100,14155,14120,55,20,20,706.18,194
,20130509,14155,14120,14105,14110,14080,14080,14095,-40,-25,28,986.83,216
,20130510,14080,14095,14100,14120,14090,14120,14105,25,10,24,846.38,228
,20130513,14120,14105,14040,14095,14040,14060,14065,-45,-40,50,"1,758.73",264
,20130514,14060,14065,14000,14000,14000,14000,14000,-65,-65,2,70,266
,20130515,14000,14000,13955,13955,13930,13945,13945,-55,-55,40,"1,394.58",268
,20130516,13945,13945,13925,13950,13925,13950,13935,5,-10,16,557.53,274
,20130517,13950,13935,13945,14035,13940,14015,13970,80,35,38,"1,327.30",298
,20130520,14015,13970,14000,14000,13945,13945,13955,-25,-15,52,"1,814.70",330
,20130521,13945,13955,13990,14060,13990,14035,14030,80,75,82,"2,876.55",362
,20130522,14035,14030,13975,14050,13975,14050,14010,20,-20,14,490.38,366
,20130523,14050,14010,14155,14155,13975,13975,14020,-35,10,24,841.2,376
,20130524,13975,14020,14025,14025,14025,14025,14025,5,5,4,140.25,378
,20130527,14025,14025,14020,14045,14020,14025,14030,0,5,10,350.8,382
,20130528,14025,14030,14010,14010,14010,14010,14010,-20,-20,2,70.05,384
,20130529,14010,14010,14095,14095,14050,14050,14060,40,50,44,"1,546.95",404
,20130530,14050,14060,14080,14125,14080,14085,14095,25,35,38,"1,339.23",424
,20130531,14085,14095,14230,14230,14160,14185,14175,90,80,308,"10,916.15",678
,20130603,14185,14175,14255,14255,14205,14250,14230,75,55,86,"3,060.25",732
,20130604,14250,14230,14260,14300,14255,14290,14270,60,40,180,"6,422.80",858
,20130605,14290,14270,14390,14390,14315,14360,14345,90,75,274,"9,826.83",1052
,20130606,14360,14345,14250,14305,14245,14275,14280,-70,-65,176,"6,283.88",1132
,20130607,14275,14280,14235,14280,14235,14250,14255,-30,-25,94,"3,349.95",1174
,20130613,14250,14255,14050,14120,14050,14075,14085,-180,-170,286,"10,073.48",1146
,20130614,14075,14085,14050,14130,14030,14110,14060,25,-25,282,"9,915.10",1240
,20130617,14110,14060,14170,14170,14135,14160,14150,100,90,62,"2,193.90",1264
,20130618,14160,14150,14150,14175,14150,14155,14155,5,5,110,"3,892.68",1346
,20130619,14155,14155,14115,14165,14115,14160,14140,5,-15,160,"5,656.10",1462
,20130620,14160,14140,14080,14375,13980,13995,14060,-145,-80,502,"17,650.40",1582
,20130621,13995,14060,13915,14005,13900,13980,13960,-80,-100,178,"6,213.53",1660
,20130624,13980,13960,13935,13945,13900,13915,13920,-45,-40,306,"10,648.85",1784
,20130625,13915,13920,13950,13950,13820,13900,13875,-20,-45,180,"6,245.53",1820
,20130626,13900,13875,13905,13915,13870,13870,13895,-5,20,122,"4,239.10",1870
,20130627,13870,13895,13930,13945,13885,13940,13920,45,25,148,"5,151.13",1902
,20130628,13940,13920,13905,13925,13880,13900,13895,-20,-25,182,"6,323.73",1936
,20130701,13900,13895,13920,13950,13900,13940,13915,45,20,66,"2,296.30",1956
,20130702,13940,13915,13935,14280,13935,14280,13955,365,40,98,"3,420.05",1970
,20130703,14280,13955,13955,13965,13920,13965,13935,10,-20,64,"2,230.35",1970
,20130704,13965,13935,13920,13950,13900,13945,13920,10,-15,106,"3,689.43",2006
,20130705,13945,13920,13905,13910,13840,13880,13885,-40,-35,156,"5,416.80",2122
,20130708,13880,13885,13845,13860,13830,13850,13845,-35,-40,236,"8,170.18",2324
,20130709,13850,13845,13900,13915,13885,13890,13895,45,50,106,"3,683.03",2358
,20130710,13890,13895,13830,13860,13815,13850,13830,-45,-65,172,"5,948.15",2408
,20130711,13850,13830,13940,13960,13890,13950,13925,120,95,158,"5,502.03",2450
,20130712,13950,13925,13905,13905,13865,13875,13880,-50,-45,84,"2,915.60",2478
,20130715,13875,13880,13900,13905,13870,13890,13885,10,5,66,"2,291.20",2500
,20130716,13890,13885,13880,13890,13875,13890,13875,5,-10,12,416.35,2500
,20130717,13890,13875,13880,13900,13880,13880,13885,5,10,42,"1,458.10",2526
,20130718,13880,13885,13855,13870,13830,13845,13845,-40,-40,226,"7,822.50",2488
,20130719,13845,13845,13890,13890,13820,13825,13855,-20,10,50,"1,732.00",2508
,20130722,13825,13855,13865,13885,13865,13875,13870,20,15,118,"4,091.93",2574
,20130723,13875,13870,13880,13890,13850,13860,13865,-10,-5,84,"2,911.68",2550
,20130724,13860,13865,13865,13865,13840,13845,13855,-20,-10,128,"4,433.68",2568
,20130725,13845,13855,13865,13865,13840,13865,13860,10,5,122,"4,227.45",2548
,20130726,13865,13860,13855,13865,13840,13845,13850,-15,-10,78,"2,700.90",2532
,20130729,13845,13850,13450,13790,13450,13770,13605,-80,-245,202,"6,872.95",2472
,20130730,13770,13605,13760,13785,13750,13780,13765,175,160,90,"3,097.13",2432
,20130731,13780,13765,13720,13785,13720,13785,13750,20,-15,158,"5,431.58",2322
,20130801,13785,13750,13800,13875,13800,13860,13850,110,100,320,"11,083.00",2316
,20130802,13860,13850,13905,13905,13850,13865,13865,15,15,284,"9,847.05",2132
,20130805,13865,13865,13890,13920,13890,13920,13905,55,40,78,"2,711.68",2122
,20130806,13920,13905,13910,13945,13910,13940,13930,35,25,200,"6,965.55",2178
,20130807,13940,13930,13910,13950,13910,13945,13935,15,5,148,"5,157.35",2180
,20130808,13945,13935,13970,14085,13970,14080,14035,145,100,324,"11,371.10",2178
,20130809,14080,14035,14170,14250,14135,14250,14165,215,130,138,"4,887.23",2188
,20130812,14250,14165,14400,14400,14210,14300,14245,135,80,784,"27,925.55",2438
,20130813,14300,14245,14260,14370,14260,14370,14315,125,70,278,"9,949.55",2568
,20130814,14370,14315,14320,14320,14230,14230,14285,-85,-30,78,"2,786.48",2558
,20130815,14230,14285,14355,14495,14355,14480,14450,195,165,376,"13,583.40",2580
,20130816,14480,14450,14505,14850,14505,14850,14680,400,230,154,"5,652.65",2510
,20130819,14850,14680,14800,14960,14800,14865,14865,185,185,160,"5,946.10",2432
,20130820,14865,14865,14710,14785,14565,14695,14740,-170,-125,238,"8,770.43",2328
,20130821,14695,14740,14695,14720,14630,14715,14675,-25,-65,206,"7,558.23",2240
,20130822,14715,14675,14685,14825,14625,14720,14695,45,20,228,"8,377.28",2236
,20130823,14720,14695,14800,14800,14680,14700,14720,5,25,74,"2,723.23",2206
,20130826,14700,14720,14715,14850,14715,14850,14830,130,110,92,"3,411.35",2166
,20130827,14850,14830,14760,14770,14750,14760,14760,-70,-70,94,"3,468.80",2090
,20130828,14760,14760,14755,14780,14735,14735,14765,-25,5,182,"6,719.90",1948
,20130829,14735,14765,14700,14730,14680,14730,14705,-35,-60,134,"4,927.80",1938
,20130830,14730,14705,14670,14670,14605,14605,14655,-100,-50,402,"14,728.70",1924
,20130902,14605,14655,14600,14650,14600,14640,14625,-15,-30,480,"3,510.55",9520
,20130903,14640,14625,14620,14620,14435,14485,14510,-140,-115,280,"2,032.03",9490
,20130904,14485,14510,14340,14370,14320,14345,14345,-165,-165,640,"4,590.88",9420
,20130905,14345,14345,14375,14375,14300,14300,14315,-45,-30,730,"5,225.38",9190
,20130906,14300,14315,14220,14280,14220,14280,14240,-35,-75,470,"3,347.45",9190
,20130909,14280,14240,14370,14415,14330,14400,14385,160,145,660,"4,747.58",8850
,20130910,14400,14385,14310,14320,14270,14290,14290,-95,-95,430,"3,072.70",8500
,20130911,14290,14290,14280,14280,14260,14275,14270,-15,-20,1040,"7,421.83",8060
,20130912,14275,14270,14235,14235,14155,14155,14195,-115,-75,590,"4,187.65",7860
,20130913,14155,14195,14105,14150,14100,14125,14125,-70,-70,1270,"8,970.73",7380
,20130916,14125,14125,14115,14115,13805,13850,13970,-275,-155,1030,"7,195.63",7110
pb1310,20130104,15800,15800,,,,15835,15835,35,35,0,0,2
,20130107,15835,15835,,,,15765,15765,-70,-70,0,0,2
,20130108,15765,15765,,,,15730,15730,-35,-35,0,0,2
,20130109,15730,15730,,,,15730,15730,0,0,0,0,2
,20130110,15730,15730,,,,15730,15730,0,0,0,0,2
,20130111,15730,15730,,,,15730,15730,0,0,0,0,2
,20130114,15730,15730,,,,15730,15730,0,0,0,0,2
,20130115,15730,15730,,,,15585,15585,-145,-145,0,0,2
,20130116,15585,15585,,,,15585,15585,0,0,0,0,2
,20130117,15585,15585,,,,15585,15585,0,0,0,0,2
,20130118,15585,15585,,,,15655,15655,70,70,0,0,2
,20130121,15655,15655,,,,15655,15655,0,0,0,0,2
,20130122,15655,15655,,,,15655,15655,0,0,0,0,2
,20130123,15655,15655,,,,15655,15655,0,0,0,0,2
,20130124,15655,15655,,,,15655,15655,0,0,0,0,2
,20130125,15655,15655,,,,15760,15760,105,105,0,0,2
,20130128,15760,15760,,,,15760,15760,0,0,0,0,2
,20130129,15760,15760,,,,15760,15760,0,0,0,0,2
,20130130,15760,15760,15965,15980,15965,15980,15970,220,210,4,159.73,6
,20130131,15980,15970,,,,16000,16000,30,30,0,0,6
,20130201,16000,16000,,,,16000,16000,0,0,0,0,6
,20130204,16000,16000,,,,16000,16000,0,0,0,0,6
,20130205,16000,16000,,,,16000,16000,0,0,0,0,6
,20130206,16000,16000,,,,16000,16000,0,0,0,0,6
,20130207,16000,16000,16095,16095,16095,16095,16095,95,95,2,80.48,8
,20130208,16095,16095,,,,16095,16095,0,0,0,0,8
,20130218,16095,16095,,,,16070,16070,-25,-25,0,0,8
,20130219,16070,16070,,,,16030,16030,-40,-40,0,0,8
,20130220,16030,16030,,,,16015,16015,-15,-15,0,0,8
,20130221,16015,16015,,,,15790,15790,-225,-225,0,0,8
,20130222,15790,15790,,,,15620,15620,-170,-170,0,0,8
,20130225,15620,15620,,,,15620,15620,0,0,0,0,8
,20130226,15620,15620,,,,15585,15585,-35,-35,0,0,8
,20130227,15585,15585,,,,15625,15625,40,40,0,0,8
,20130228,15625,15625,,,,15595,15595,-30,-30,0,0,8
,20130301,15595,15595,,,,15420,15420,-175,-175,0,0,8
,20130304,15420,15420,,,,15315,15315,-105,-105,0,0,8
,20130305,15315,15315,15510,15510,15445,15445,15475,130,160,4,154.78,8
,20130306,15445,15475,15535,15535,15535,15535,15535,60,60,2,77.68,8
,20130307,15535,15535,15380,15485,15380,15410,15420,-125,-115,8,308.48,10
,20130308,15410,15420,,,,15420,15420,0,0,0,0,10
,20130311,15420,15420,,,,15420,15420,0,0,0,0,10
,20130312,15420,15420,,,,15395,15395,-25,-25,0,0,10
,20130313,15395,15395,15310,15310,15310,15310,15310,-85,-85,2,76.55,10
,20130314,15310,15310,14550,15345,14550,15345,14945,35,-365,4,149.48,8
,20130315,15345,14945,,,,15205,15205,260,260,0,0,8
,20130318,15205,15205,,,,15200,15200,-5,-5,0,0,8
,20130319,15200,15200,,,,15150,15150,-50,-50,0,0,8
,20130320,15150,15150,,,,15150,15150,0,0,0,0,8
,20130321,15150,15150,,,,15220,15220,70,70,0,0,8
,20130322,15220,15220,,,,15220,15220,0,0,0,0,8
,20130325,15220,15220,,,,15220,15220,0,0,0,0,8
,20130326,15220,15220,,,,15200,15200,-20,-20,0,0,8
,20130327,15200,15200,,,,15200,15200,0,0,0,0,8
,20130328,15200,15200,,,,15100,15100,-100,-100,0,0,8
,20130329,15100,15100,15100,15855,14345,14870,15030,-230,-70,120,"4,509.78",40
,20130401,14870,15030,14800,14800,14800,14800,14800,-230,-230,34,"1,258.00",6
,20130402,14800,14800,14795,14795,14795,14795,14795,-5,-5,2,73.98,8
,20130403,14795,14795,,,,14795,14795,0,0,0,0,8
,20130408,14795,14795,14980,14980,14980,14980,14980,185,185,2,74.9,8
,20130409,14980,14980,,,,14980,14980,0,0,0,0,8
,20130410,14980,14980,,,,14980,14980,0,0,0,0,8
,20130411,14980,14980,14435,14435,14435,14435,14435,-545,-545,2,72.18,6
,20130412,14435,14435,,,,14780,14780,345,345,0,0,6
,20130415,14780,14780,,,,14670,14670,-110,-110,0,0,6
,20130416,14670,14670,,,,14585,14585,-85,-85,0,0,6
,20130417,14585,14585,,,,14510,14510,-75,-75,0,0,6
,20130418,14510,14510,,,,14200,14200,-310,-310,0,0,6
,20130419,14200,14200,13980,14240,13980,14190,14135,-10,-65,6,212.05,6
,20130422,14190,14135,,,,14135,14135,0,0,0,0,6
,20130423,14135,14135,,,,14100,14100,-35,-35,0,0,6
,20130424,14100,14100,,,,14100,14100,0,0,0,0,6
,20130425,14100,14100,,,,14165,14165,65,65,0,0,6
,20130426,14165,14165,,,,14165,14165,0,0,0,0,6
,20130502,14165,14165,,,,14165,14165,0,0,0,0,6
,20130503,14165,14165,,,,14175,14175,10,10,0,0,6
,20130506,14175,14175,,,,14270,14270,95,95,0,0,6
,20130507,14270,14270,,,,14270,14270,0,0,0,0,6
,20130508,14270,14270,,,,14290,14290,20,20,0,0,6
,20130509,14290,14290,,,,14245,14245,-45,-45,0,0,6
,20130510,14245,14245,,,,14245,14245,0,0,0,0,6
,20130513,14245,14245,,,,14245,14245,0,0,0,0,6
,20130514,14245,14245,,,,14175,14175,-70,-70,0,0,6
,20130515,14175,14175,,,,14175,14175,0,0,0,0,6
,20130516,14175,14175,,,,14120,14120,-55,-55,0,0,6
,20130517,14120,14120,14080,14090,14080,14090,14085,-30,-35,4,140.85,10
,20130520,14090,14085,14045,14045,14030,14030,14035,-55,-50,6,210.58,12
,20130521,14030,14035,14075,14100,14060,14070,14070,35,35,22,773.95,34
,20130522,14070,14070,14095,14115,14095,14115,14100,45,30,24,846.13,54
,20130523,14115,14100,,,,14090,14090,-10,-10,0,0,54
,20130524,14090,14090,,,,14090,14090,0,0,0,0,54
,20130527,14090,14090,14105,14105,14105,14105,14105,15,15,2,70.53,56
,20130528,14105,14105,,,,14105,14105,0,0,0,0,56
,20130529,14105,14105,14135,14135,14135,14135,14135,30,30,10,353.38,64
,20130530,14135,14135,14070,14165,14070,14165,14140,30,5,16,565.68,78
,20130531,14165,14140,14230,14230,14215,14220,14220,80,80,22,782.23,90
,20130603,14220,14220,14320,14355,14285,14335,14320,115,100,56,"2,005.35",108
,20130604,14335,14320,14350,14350,14350,14350,14350,30,30,2,71.75,108
,20130605,14350,14350,,,,14400,14400,50,50,0,0,108
,20130606,14400,14400,14360,14360,14360,14360,14360,-40,-40,4,143.6,106
,20130607,14360,14360,,,,14360,14360,0,0,0,0,106
,20130613,14360,14360,14210,14210,14210,14210,14210,-150,-150,4,142.1,110
,20130614,14210,14210,14100,14190,14100,14190,14145,-20,-65,4,141.45,110
,20130617,14190,14145,,,,14205,14205,60,60,0,0,110
,20130618,14205,14205,14230,14230,14215,14215,14220,10,15,12,426.68,116
,20130619,14215,14220,14200,14200,14200,14200,14200,-20,-20,2,71,118
,20130620,14200,14200,14150,14150,14080,14080,14125,-120,-75,56,"1,977.78",154
,20130621,14080,14125,13985,14015,13985,14015,14005,-110,-120,6,210.08,158
,20130624,14015,14005,14000,14000,13940,13985,13975,-20,-30,20,698.85,166
,20130625,13985,13975,13960,13960,13920,13930,13940,-45,-35,10,348.58,166
,20130626,13930,13940,13965,13965,13940,13950,13955,10,15,8,279.1,166
,20130627,13950,13955,13995,13995,13980,13980,13985,25,30,4,139.88,166
,20130628,13980,13985,,,,13980,13980,-5,-5,0,0,166
,20130701,13980,13980,,,,13980,13980,0,0,0,0,166
,20130702,13980,13980,13985,14035,13985,14015,14005,35,25,52,"1,820.80",214
,20130703,14015,14005,14015,14035,13980,14005,13995,0,-10,72,"2,519.58",266
,20130704,14005,13995,13965,14005,13965,14005,13980,10,-15,40,"1,398.35",266
,20130705,14005,13980,13960,13970,13920,13970,13955,-10,-25,50,"1,744.48",250
,20130708,13970,13955,13950,13950,13925,13935,13940,-20,-15,92,"3,206.80",290
,20130709,13935,13940,13975,13975,13970,13970,13970,30,30,28,977.93,318
,20130710,13970,13970,13910,13945,13890,13945,13905,-25,-65,54,"1,877.28",336
,20130711,13945,13905,14000,14050,13990,14000,14015,95,110,78,"2,733.78",362
,20130712,14000,14015,13980,13980,13950,13950,13965,-65,-50,8,279.3,362
,20130715,13950,13965,13960,13980,13960,13960,13975,-5,10,28,978.38,386
,20130716,13960,13975,13960,13960,13950,13960,13955,-15,-20,96,"3,349.65",482
,20130717,13960,13955,13970,13990,13970,13985,13975,30,20,30,"1,048.23",504
,20130718,13985,13975,13950,13965,13930,13945,13945,-30,-30,254,"8,856.35",618
,20130719,13945,13945,13995,14000,13910,13920,13950,-25,5,190,"6,628.58",746
,20130722,13920,13950,13950,13950,13950,13950,13950,0,0,6,209.25,746
,20130723,13950,13950,13960,13960,13960,13960,13960,10,10,10,349,752
,20130724,13960,13960,13960,13960,13940,13955,13955,-5,-5,46,"1,604.93",794
,20130725,13955,13955,13950,13950,13940,13940,13940,-15,-15,16,557.75,800
,20130726,13940,13940,13940,13950,13920,13920,13935,-20,-5,94,"3,275.83",832
,20130729,13920,13935,13860,13885,13825,13860,13850,-75,-85,86,"2,978.30",900
,20130730,13860,13850,13870,13870,13805,13820,13835,-30,-15,132,"4,565.70",986
,20130731,13820,13835,13820,13825,13810,13825,13815,-10,-20,138,"4,766.98",1084
,20130801,13825,13815,13870,13955,13870,13950,13930,135,115,290,"10,100.43",1266
,20130802,13950,13930,14015,14015,13905,13950,13945,20,15,82,"2,859.20",1302
,20130805,13950,13945,13970,13990,13970,13975,13975,30,30,80,"2,795.58",1286
,20130806,13975,13975,13985,14010,13975,14010,13990,35,15,100,"3,498.33",1332
,20130807,14010,13990,13990,14020,13990,14020,14010,30,20,150,"5,254.35",1368
,20130808,14020,14010,14050,14125,14050,14125,14070,115,60,52,"1,829.58",1364
,20130809,14125,14070,14125,14370,14125,14280,14210,210,140,198,"7,034.90",1444
,20130812,14280,14210,14500,14500,14290,14390,14340,180,130,392,"14,053.58",1462
,20130813,14390,14340,14345,14415,14330,14405,14355,65,15,116,"4,163.90",1450
,20130814,14405,14355,14340,14365,14330,14330,14340,-25,-15,70,"2,510.30",1438
,20130815,14330,14340,14420,14580,14410,14550,14495,210,155,208,"7,539.43",1482
,20130816,14550,14495,14550,14925,14550,14925,14805,430,310,246,"9,106.95",1572
,20130819,14925,14805,14925,15115,14880,14905,14935,100,130,276,"10,306.83",1674
,20130820,14905,14935,14795,14860,14640,14685,14760,-250,-175,176,"6,495.48",1680
,20130821,14685,14760,14740,14760,14675,14750,14720,-10,-40,146,"5,373.88",1692
,20130822,14750,14720,14740,14865,14730,14780,14785,60,65,80,"2,957.70",1674
,20130823,14780,14785,14935,14935,14760,14800,14785,15,0,84,"3,105.65",1632
,20130826,14800,14785,14870,14935,14870,14920,14905,135,120,54,"2,012.23",1614
,20130827,14920,14905,14870,14870,14790,14790,14815,-115,-90,172,"6,370.63",1510
,20130828,14790,14815,14815,14850,14800,14800,14825,-15,10,150,"5,560.30",1450
,20130829,14800,14825,14735,14770,14735,14755,14750,-70,-75,76,"2,802.88",1412
,20130830,14755,14750,14700,14715,14635,14635,14675,-115,-75,72,"2,642.08",1412
,20130902,14635,14675,14890,14890,14620,14665,14670,-10,-5,490,"3,595.12",6822
,20130903,14665,14670,14630,14630,14525,14530,14550,-140,-120,82,596.69,6810
,20130904,14530,14550,14440,14440,14400,14405,14410,-145,-140,128,922.45,6826
,20130905,14405,14410,14370,14370,14320,14330,14345,-80,-65,1286,"9,224.65",6800
,20130906,14330,14345,14310,14310,14275,14310,14290,-35,-55,524,"3,745.29",6794
,20130909,14310,14290,14470,14470,14400,14430,14430,140,140,420,"3,030.37",6748
,20130910,14430,14430,14350,14360,14305,14305,14325,-125,-105,740,"5,301.04",6358
,20130911,14305,14325,14310,14315,14295,14315,14305,-10,-20,1144,"8,183.75",6120
,20130912,14315,14305,14270,14270,14190,14190,14220,-115,-85,596,"4,238.08",5714
,20130913,14190,14220,14170,14235,14095,14190,14175,-30,-45,484,"3,430.67",5898
,20130916,14190,14175,14135,14135,13920,13920,14030,-255,-145,1080,"7,578.43",6060
,20130917,13920,14030,13985,13985,13825,13830,13860,-200,-170,1418,"9,830.27",5878
,20130918,13830,13860,13830,13900,13830,13900,13860,40,0,778,"5,392.44",5944
,20130923,13900,13860,13890,14030,13880,14015,13960,155,100,608,"4,244.11",5626
,20130924,14015,13960,14000,14040,14000,14010,14020,50,60,988,"6,927.83",5804
,20130925,14010,14020,13965,14015,13965,14000,13985,-20,-35,586,"4,098.96",5510
,20130926,14000,13985,13995,14000,13960,13980,13975,-5,-10,616,"4,304.52",5330
,20130927,13980,13975,14080,14080,13990,14010,14000,35,25,280,"1,960.69",5200
,20130930,14010,14000,14010,14075,14000,14000,14030,0,30,826,"5,794.81",5070
,20131008,14000,14030,13850,13985,13850,13985,13965,-45,-65,370,"2,583.63",5010
,20131009,13985,13965,13980,14000,13975,13980,13980,15,15,600,"4,194.48",4780
,20131010,13980,13980,13970,14000,13970,13995,13985,15,5,730,"5,106.33",4670
,20131011,13995,13985,14010,14015,13985,13990,13995,5,10,350,"2,449.60",4600
,20131014,13990,13995,13950,14040,13950,14040,13990,45,-5,350,"2,448.98",4500
,20131015,14040,13990,14100,14150,14100,14110,14130,120,140,670,"4,735.05",4780
pb1311,20130104,15815,15815,,,,15815,15815,0,0,0,0,6
,20130107,15815,15815,,,,15815,15815,0,0,0,0,6
,20130108,15815,15815,,,,15815,15815,0,0,0,0,6
,20130109,15815,15815,,,,15815,15815,0,0,0,0,6
,20130110,15815,15815,,,,15815,15815,0,0,0,0,6
,20130111,15815,15815,,,,15815,15815,0,0,0,0,6
,20130114,15815,15815,,,,15815,15815,0,0,0,0,6
,20130115,15815,15815,15820,15820,15820,15820,15820,5,5,2,79.1,4
,20130116,15820,15820,15805,15805,15805,15805,15805,-15,-15,2,79.03,4
,20130117,15805,15805,15760,15760,15755,15755,15755,-50,-50,4,157.58,4
,20130118,15755,15755,,,,15755,15755,0,0,0,0,4
,20130121,15755,15755,,,,15770,15770,15,15,0,0,4
,20130122,15770,15770,,,,15775,15775,5,5,0,0,4
,20130123,15775,15775,,,,15820,15820,45,45,0,0,4
,20130124,15820,15820,,,,15820,15820,0,0,0,0,4
,20130125,15820,15820,,,,15820,15820,0,0,0,0,4
,20130128,15820,15820,,,,15820,15820,0,0,0,0,4
,20130129,15820,15820,15685,16000,15685,16000,15860,180,40,8,317.2,4
,20130130,16000,15860,16080,16080,16080,16080,16080,220,220,2,80.4,4
,20130131,16080,16080,,,,16200,16200,120,120,0,0,4
,20130201,16200,16200,,,,16145,16145,-55,-55,0,0,4
,20130204,16145,16145,16230,16230,16230,16230,16230,85,85,2,81.15,4
,20130205,16230,16230,,,,16115,16115,-115,-115,0,0,4
,20130206,16115,16115,,,,16055,16055,-60,-60,0,0,4
,20130207,16055,16055,16130,16130,16130,16130,16130,75,75,2,80.65,4
,20130208,16130,16130,,,,16195,16195,65,65,0,0,4
,20130218,16195,16195,,,,16190,16190,-5,-5,0,0,4
,20130219,16190,16190,,,,16160,16160,-30,-30,0,0,4
,20130220,16160,16160,,,,16140,16140,-20,-20,0,0,4
,20130221,16140,16140,,,,15915,15915,-225,-225,0,0,4
,20130222,15915,15915,,,,15745,15745,-170,-170,0,0,4
,20130225,15745,15745,,,,15745,15745,0,0,0,0,4
,20130226,15745,15745,,,,15710,15710,-35,-35,0,0,4
,20130227,15710,15710,,,,15710,15710,0,0,0,0,4
,20130228,15710,15710,,,,15680,15680,-30,-30,0,0,4
,20130301,15680,15680,15660,15660,15600,15600,15635,-80,-45,6,234.58,4
,20130304,15600,15635,,,,15635,15635,0,0,0,0,4
,20130305,15635,15635,,,,15635,15635,0,0,0,0,4
,20130306,15635,15635,,,,15695,15695,60,60,0,0,4
,20130307,15695,15695,,,,15600,15600,-95,-95,0,0,4
,20130308,15600,15600,,,,15675,15675,75,75,0,0,4
,20130311,15675,15675,15540,15540,15540,15540,15540,-135,-135,2,77.7,6
,20130312,15540,15540,,,,15500,15500,-40,-40,0,0,6
,20130313,15500,15500,,,,15410,15410,-90,-90,0,0,6
,20130314,15410,15410,,,,15045,15045,-365,-365,0,0,6
,20130315,15045,15045,,,,15070,15070,25,25,0,0,6
,20130318,15070,15070,,,,15070,15070,0,0,0,0,6
,20130319,15070,15070,15180,15180,15180,15180,15180,110,110,2,75.9,4
,20130320,15180,15180,,,,15195,15195,15,15,0,0,4
,20130321,15195,15195,,,,15265,15265,70,70,0,0,4
,20130322,15265,15265,,,,15250,15250,-15,-15,0,0,4
,20130325,15250,15250,,,,15310,15310,60,60,0,0,4
,20130326,15310,15310,,,,15285,15285,-25,-25,0,0,4
,20130327,15285,15285,,,,15220,15220,-65,-65,0,0,4
,20130328,15220,15220,,,,15170,15170,-50,-50,0,0,4
,20130329,15170,15170,,,,15100,15100,-70,-70,0,0,4
,20130401,15100,15100,,,,14865,14865,-235,-235,0,0,4
,20130402,14865,14865,,,,14855,14855,-10,-10,0,0,4
,20130403,14855,14855,,,,14785,14785,-70,-70,0,0,4
,20130408,14785,14785,,,,14965,14965,180,180,0,0,4
,20130409,14965,14965,,,,14915,14915,-50,-50,0,0,4
,20130410,14915,14915,,,,14985,14985,70,70,0,0,4
,20130411,14985,14985,,,,14435,14435,-550,-550,0,0,4
,20130412,14435,14435,,,,14805,14805,370,370,0,0,4
,20130415,14805,14805,,,,14805,14805,0,0,0,0,4
,20130416,14805,14805,,,,14655,14655,-150,-150,0,0,4
,20130417,14655,14655,,,,14670,14670,15,15,0,0,4
,20130418,14670,14670,,,,14290,14290,-380,-380,0,0,4
,20130419,14290,14290,,,,14225,14225,-65,-65,0,0,4
,20130422,14225,14225,,,,14215,14215,-10,-10,0,0,4
,20130423,14215,14215,,,,14215,14215,0,0,0,0,4
,20130424,14215,14215,,,,14215,14215,0,0,0,0,4
,20130425,14215,14215,,,,14280,14280,65,65,0,0,4
,20130426,14280,14280,,,,14280,14280,0,0,0,0,4
,20130502,14280,14280,,,,14280,14280,0,0,0,0,4
,20130503,14280,14280,,,,14290,14290,10,10,0,0,4
,20130506,14290,14290,,,,14385,14385,95,95,0,0,4
,20130507,14385,14385,,,,14350,14350,-35,-35,0,0,4
,20130508,14350,14350,,,,14370,14370,20,20,0,0,4
,20130509,14370,14370,,,,14370,14370,0,0,0,0,4
,20130510,14370,14370,,,,14380,14380,10,10,0,0,4
,20130513,14380,14380,,,,14350,14350,-30,-30,0,0,4
,20130514,14350,14350,,,,14280,14280,-70,-70,0,0,4
,20130515,14280,14280,,,,14220,14220,-60,-60,0,0,4
,20130516,14220,14220,,,,14220,14220,0,0,0,0,4
,20130517,14220,14220,,,,14180,14180,-40,-40,0,0,4
,20130520,14180,14180,,,,14180,14180,0,0,0,0,4
,20130521,14180,14180,14305,14305,14200,14200,14245,20,65,6,213.7,4
,20130522,14200,14245,14200,14200,14200,14200,14200,-45,-45,2,71,6
,20130523,14200,14200,,,,14200,14200,0,0,0,0,6
,20130524,14200,14200,,,,14200,14200,0,0,0,0,6
,20130527,14200,14200,,,,14200,14200,0,0,0,0,6
,20130528,14200,14200,,,,14175,14175,-25,-25,0,0,6
,20130529,14175,14175,,,,14205,14205,30,30,0,0,6
,20130530,14205,14205,,,,14210,14210,5,5,0,0,6
,20130531,14210,14210,,,,14280,14280,70,70,0,0,6
,20130603,14280,14280,,,,14350,14350,70,70,0,0,6
,20130604,14350,14350,,,,14385,14385,35,35,0,0,6
,20130605,14385,14385,14540,14545,14540,14545,14540,160,155,4,145.43,4
,20130606,14545,14540,,,,14495,14495,-45,-45,0,0,4
,20130607,14495,14495,,,,14465,14465,-30,-30,0,0,4
,20130613,14465,14465,,,,14310,14310,-155,-155,0,0,4
,20130614,14310,14310,,,,14240,14240,-70,-70,0,0,4
,20130617,14240,14240,,,,14335,14335,95,95,0,0,4
,20130618,14335,14335,,,,14335,14335,0,0,0,0,4
,20130619,14335,14335,,,,14335,14335,0,0,0,0,4
,20130620,14335,14335,14280,14280,14180,14180,14245,-155,-90,10,356.15,10
,20130621,14180,14245,14090,14090,14090,14090,14090,-155,-155,4,140.9,6
,20130624,14090,14090,,,,14060,14060,-30,-30,0,0,6
,20130625,14060,14060,14000,14000,14000,14000,14000,-60,-60,4,140,10
,20130626,14000,14000,,,,14015,14015,15,15,0,0,10
,20130627,14015,14015,,,,14045,14045,30,30,0,0,10
,20130628,14045,14045,,,,14020,14020,-25,-25,0,0,10
,20130701,14020,14020,14130,14130,14130,14130,14130,110,110,4,141.3,10
,20130702,14130,14130,,,,14155,14155,25,25,0,0,10
,20130703,14155,14155,14050,14050,14050,14050,14050,-105,-105,2,70.25,12
,20130704,14050,14050,13850,14065,13850,14020,13970,-30,-80,16,558.85,14
,20130705,14020,13970,13995,14015,13995,14015,14005,45,35,4,140.05,16
,20130708,14015,14005,14025,14025,14025,14025,14025,20,20,2,70.13,16
,20130709,14025,14025,,,,14025,14025,0,0,0,0,16
,20130710,14025,14025,,,,14025,14025,0,0,0,0,16
,20130711,14025,14025,,,,14045,14045,20,20,0,0,16
,20130712,14045,14045,,,,14045,14045,0,0,0,0,16
,20130715,14045,14045,14090,14090,14090,14090,14090,45,45,2,70.45,16
,20130716,14090,14090,,,,14090,14090,0,0,0,0,16
,20130717,14090,14090,,,,14090,14090,0,0,0,0,16
,20130718,14090,14090,,,,14040,14040,-50,-50,0,0,16
,20130719,14040,14040,13995,13995,13975,13975,13985,-65,-55,8,279.7,24
,20130722,13975,13985,13995,14010,13995,13995,13995,10,10,10,349.98,32
,20130723,13995,13995,14020,14045,13990,13990,14010,-5,15,16,560.55,40
,20130724,13990,14010,14000,14020,13985,14020,13995,10,-15,18,629.9,52
,20130725,14020,13995,14005,14015,13990,13995,13995,0,0,24,839.85,68
,20130726,13995,13995,13980,13990,13965,13965,13975,-30,-20,24,838.53,82
,20130729,13965,13975,13920,13920,13885,13900,13895,-75,-80,38,"1,320.48",110
,20130730,13900,13895,13910,13910,13880,13880,13890,-15,-5,88,"3,056.45",162
,20130731,13880,13890,13860,13865,13860,13865,13860,-25,-30,8,277.25,166
,20130801,13865,13860,13920,13970,13905,13960,13940,100,80,50,"1,742.88",202
,20130802,13960,13940,13980,13980,13950,13960,13960,20,20,34,"1,186.60",226
,20130805,13960,13960,14000,14020,13985,14005,13995,45,35,28,979.98,244
,20130806,14005,13995,14000,14040,14000,14040,14015,45,20,58,"2,032.70",260
,20130807,14040,14015,14035,14035,14020,14035,14025,20,10,30,"1,052.15",280
,20130808,14035,14025,14100,14150,14025,14150,14105,125,80,76,"2,680.25",318
,20130809,14150,14105,14180,14300,14180,14300,14225,195,120,138,"4,908.48",416
,20130812,14300,14225,14500,14520,14370,14445,14410,220,185,384,"13,835.63",610
,20130813,14445,14410,14460,14475,14400,14470,14435,60,25,146,"5,268.78",660
,20130814,14470,14435,14380,14435,14380,14400,14405,-35,-30,84,"3,026.05",686
,20130815,14400,14405,14500,14630,14500,14620,14590,215,185,84,"3,064.28",726
,20130816,14620,14590,14660,14920,14660,14910,14795,320,205,104,"3,846.73",782
,20130819,14910,14795,15000,15000,14920,14940,14950,145,155,138,"5,158.60",802
,20130820,14940,14950,14855,14875,14655,14725,14785,-225,-165,104,"3,845.23",822
,20130821,14725,14785,14800,14800,14740,14795,14770,10,-15,148,"5,465.73",842
,20130822,14795,14770,14665,14915,14655,14815,14785,45,15,212,"7,837.38",838
,20130823,14815,14785,14795,14845,14795,14830,14815,45,30,140,"5,186.10",910
,20130826,14830,14815,14915,14955,14905,14930,14935,115,120,96,"3,584.40",922
,20130827,14930,14935,14855,14875,14850,14850,14855,-85,-80,172,"6,389.15",938
,20130828,14850,14855,14850,14890,14820,14820,14875,-35,20,248,"9,222.68",1034
,20130829,14820,14875,14780,14780,14770,14780,14775,-95,-100,28,"1,034.55",1032
,20130830,14780,14775,14775,14775,14645,14670,14685,-105,-90,56,"2,056.00",1014
,20130902,14670,14685,14720,14730,14650,14700,14700,15,15,544,"3,998.83",4816
,20130903,14700,14700,14665,14670,14560,14570,14635,-130,-65,596,"4,362.38",4938
,20130904,14570,14635,14500,14500,14445,14450,14465,-185,-170,308,"2,227.68",4962
,20130905,14450,14465,14440,14440,14350,14350,14385,-115,-80,190,"1,366.98",4990
,20130906,14350,14385,14320,14365,14320,14360,14355,-25,-30,754,"5,412.05",4858
,20130909,14360,14355,14465,14490,14450,14485,14470,130,115,500,"3,617.52",4900
,20130910,14485,14470,14420,14420,14365,14365,14390,-105,-80,200,"1,439.19",4898
,20130911,14365,14390,14355,14370,14350,14360,14355,-30,-35,294,"2,110.26",4928
,20130912,14360,14355,14330,14335,14235,14235,14275,-120,-80,334,"2,384.68",4838
,20130913,14235,14275,14270,14275,14230,14275,14250,0,-25,648,"4,618.31",4794
,20130916,14275,14250,14250,14250,14000,14015,14130,-235,-120,780,"5,510.92",4784
,20130917,14015,14130,13925,13985,13840,13920,13930,-210,-200,1012,"7,050.07",4912
,20130918,13920,13930,13900,13980,13880,13960,13935,30,5,766,"5,338.08",4824
,20130923,13960,13935,13960,14145,13930,14070,14035,135,100,798,"5,601.46",5000
,20130924,14070,14035,14045,14105,14045,14060,14080,25,45,528,"3,718.15",5026
,20130925,14060,14080,14070,14070,14045,14070,14060,-10,-20,310,"2,179.38",5092
,20130926,14070,14060,14050,14070,14020,14050,14040,-10,-20,486,"3,412.88",5178
,20130927,14050,14040,14045,14060,14040,14060,14050,20,10,240,"1,686.47",5134
,20130930,14060,14050,14090,14090,14065,14080,14075,30,25,544,"3,829.09",5470
,20131008,14080,14075,13980,14030,13980,14020,14000,-55,-75,234,"1,638.13",5510
,20131009,14020,14000,14040,14070,14030,14050,14045,50,45,328,"2,304.12",5592
,20131010,14050,14045,14040,14070,14040,14060,14055,15,10,398,"2,797.50",5662
,20131011,14060,14055,14080,14110,14050,14065,14070,10,15,502,"3,532.68",5678
,20131014,14065,14070,14050,14130,14050,14115,14080,45,10,250,"1,760.24",5718
,20131015,14115,14080,14190,14190,14130,14145,14150,65,70,228,"1,613.62",5602
,20131016,14145,14150,14295,14295,14110,14170,14165,20,15,1126,"7,977.21",5604
,20131017,14170,14165,14225,14265,14115,14205,14255,40,90,1066,"7,599.77",5990
,20131018,14205,14255,14295,14350,14295,14305,14320,50,65,572,"4,096.33",6356
,20131021,14305,14320,14350,14415,14350,14415,14380,95,60,1320,"9,491.09",5954
,20131022,14415,14380,14435,14445,14400,14445,14415,65,35,1138,"8,204.09",6094
,20131023,14445,14415,14445,14475,14380,14385,14425,-30,10,750,"5,411.14",6366
,20131024,14385,14425,14330,14350,14320,14330,14335,-95,-90,782,"5,605.28",6464
,20131025,14330,14335,14355,14360,14255,14255,14340,-80,5,444,"3,184.55",6602
,20131028,14255,14340,14315,14395,14315,14385,14370,45,30,822,"5,907.12",6744
,20131029,14385,14370,14375,14410,14145,14400,14350,30,-20,266,"1,909.15",6694
,20131030,14400,14350,14360,14420,14360,14420,14365,70,15,1702,"12,228.09",6642
,20131031,14420,14365,14210,14320,14100,14320,14295,-45,-70,328,"2,344.53",6460
,20131101,14320,14295,14350,14370,14340,14360,14355,65,60,190,"1,364.15",6310
,20131104,14360,14355,14320,14340,14300,14300,14325,-55,-30,720,"5,157.25",6290
,20131105,14300,14325,14270,14270,14260,14270,14265,-55,-60,340,"2,425.60",6210
,20131106,14270,14265,14270,14270,14270,14270,14270,5,5,430,"3,068.05",5880
,20131107,14270,14270,14260,14270,14260,14270,14260,0,-10,180,"1,283.70",6060
,20131108,14270,14260,14240,14240,14180,14180,14220,-80,-40,170,"1,208.98",6000
,20131111,14180,14220,14205,14205,14160,14160,14175,-60,-45,430,"3,048.08",5970
,20131112,14160,14175,14095,14095,14035,14050,14065,-125,-110,70,492.43,5940
,20131113,14050,14065,13965,13980,13950,13970,13955,-95,-110,540,"3,769.15",6050
,20131114,13970,13955,13990,14000,13800,13980,13920,25,-35,510,"3,550.23",6030
,20131115,13980,13920,13990,13990,13925,13940,13940,20,20,750,"5,228.28",6230
pb1312,20130104,15915,15915,,,,15950,15950,35,35,0,0,2
,20130107,15950,15950,,,,15880,15880,-70,-70,0,0,2
,20130108,15880,15880,,,,15845,15845,-35,-35,0,0,2
,20130109,15845,15845,,,,15845,15845,0,0,0,0,2
,20130110,15845,15845,,,,15845,15845,0,0,0,0,2
,20130111,15845,15845,,,,15740,15740,-105,-105,0,0,2
,20130114,15740,15740,,,,15660,15660,-80,-80,0,0,2
,20130115,15660,15660,,,,15660,15660,0,0,0,0,2
,20130116,15660,15660,,,,15660,15660,0,0,0,0,2
,20130117,15660,15660,,,,15610,15610,-50,-50,0,0,2
,20130118,15610,15610,,,,15680,15680,70,70,0,0,2
,20130121,15680,15680,,,,15685,15685,5,5,0,0,2
,20130122,15685,15685,,,,15790,15790,105,105,0,0,2
,20130123,15790,15790,,,,15810,15810,20,20,0,0,2
,20130124,15810,15810,,,,15790,15790,-20,-20,0,0,2
,20130125,15790,15790,,,,15870,15870,80,80,0,0,2
,20130128,15870,15870,,,,15910,15910,40,40,0,0,2
,20130129,15910,15910,,,,15950,15950,40,40,0,0,2
,20130130,15950,15950,,,,15950,15950,0,0,0,0,2
,20130131,15950,15950,,,,16070,16070,120,120,0,0,2
,20130201,16070,16070,,,,16070,16070,0,0,0,0,2
,20130204,16070,16070,,,,16150,16150,80,80,0,0,2
,20130205,16150,16150,,,,16035,16035,-115,-115,0,0,2
,20130206,16035,16035,,,,15975,15975,-60,-60,0,0,2
,20130207,15975,15975,,,,15975,15975,0,0,0,0,2
,20130208,15975,15975,,,,16040,16040,65,65,0,0,2
,20130218,16040,16040,,,,16015,16015,-25,-25,0,0,2
,20130219,16015,16015,,,,16015,16015,0,0,0,0,2
,20130220,16015,16015,,,,16015,16015,0,0,0,0,2
,20130221,16015,16015,,,,15790,15790,-225,-225,0,0,2
,20130222,15790,15790,,,,15620,15620,-170,-170,0,0,2
,20130225,15620,15620,,,,15720,15720,100,100,0,0,2
,20130226,15720,15720,,,,15685,15685,-35,-35,0,0,2
,20130227,15685,15685,15680,15680,15680,15680,15680,-5,-5,2,78.4,2
,20130228,15680,15680,,,,15680,15680,0,0,0,0,2
,20130301,15680,15680,,,,15680,15680,0,0,0,0,2
,20130304,15680,15680,,,,15680,15680,0,0,0,0,2
,20130305,15680,15680,,,,15680,15680,0,0,0,0,2
,20130306,15680,15680,,,,15740,15740,60,60,0,0,2
,20130307,15740,15740,15565,15565,15565,15565,15565,-175,-175,2,77.83,4
,20130308,15565,15565,,,,15565,15565,0,0,0,0,4
,20130311,15565,15565,,,,15565,15565,0,0,0,0,4
,20130312,15565,15565,,,,15565,15565,0,0,0,0,4
,20130313,15565,15565,,,,15565,15565,0,0,0,0,4
,20130314,15565,15565,,,,15195,15195,-370,-370,0,0,4
,20130315,15195,15195,,,,15220,15220,25,25,0,0,4
,20130318,15220,15220,,,,15220,15220,0,0,0,0,4
,20130319,15220,15220,,,,15330,15330,110,110,0,0,4
,20130320,15330,15330,,,,15330,15330,0,0,0,0,4
,20130321,15330,15330,,,,15400,15400,70,70,0,0,4
,20130322,15400,15400,,,,15370,15370,-30,-30,0,0,4
,20130325,15370,15370,,,,15430,15430,60,60,0,0,4
,20130326,15430,15430,,,,15430,15430,0,0,0,0,4
,20130327,15430,15430,,,,15320,15320,-110,-110,0,0,4
,20130328,15320,15320,,,,15270,15270,-50,-50,0,0,4
,20130329,15270,15270,,,,15200,15200,-70,-70,0,0,4
,20130401,15200,15200,,,,14965,14965,-235,-235,0,0,4
,20130402,14965,14965,,,,14965,14965,0,0,0,0,4
,20130403,14965,14965,,,,14965,14965,0,0,0,0,4
,20130408,14965,14965,,,,15150,15150,185,185,0,0,4
,20130409,15150,15150,,,,15095,15095,-55,-55,0,0,4
,20130410,15095,15095,,,,15165,15165,70,70,0,0,4
,20130411,15165,15165,,,,14610,14610,-555,-555,0,0,4
,20130412,14610,14610,,,,14900,14900,290,290,0,0,4
,20130415,14900,14900,14895,14895,14610,14610,14750,-290,-150,4,147.53,4
,20130416,14610,14750,,,,14750,14750,0,0,0,0,4
,20130417,14750,14750,,,,14765,14765,15,15,0,0,4
,20130418,14765,14765,,,,14380,14380,-385,-385,0,0,4
,20130419,14380,14380,,,,14315,14315,-65,-65,0,0,4
,20130422,14315,14315,,,,14305,14305,-10,-10,0,0,4
,20130423,14305,14305,,,,14215,14215,-90,-90,0,0,4
,20130424,14215,14215,,,,14300,14300,85,85,0,0,4
,20130425,14300,14300,,,,14365,14365,65,65,0,0,4
,20130426,14365,14365,,,,14365,14365,0,0,0,0,4
,20130502,14365,14365,,,,14365,14365,0,0,0,0,4
,20130503,14365,14365,,,,14375,14375,10,10,0,0,4
,20130506,14375,14375,,,,14470,14470,95,95,0,0,4
,20130507,14470,14470,14440,14440,14440,14440,14440,-30,-30,2,72.2,2
,20130508,14440,14440,,,,14460,14460,20,20,0,0,2
,20130509,14460,14460,,,,14435,14435,-25,-25,0,0,2
,20130510,14435,14435,,,,14445,14445,10,10,0,0,2
,20130513,14445,14445,,,,14405,14405,-40,-40,0,0,2
,20130514,14405,14405,,,,14335,14335,-70,-70,0,0,2
,20130515,14335,14335,,,,14275,14275,-60,-60,0,0,2
,20130516,14275,14275,,,,14265,14265,-10,-10,0,0,2
,20130517,14265,14265,,,,14225,14225,-40,-40,0,0,2
,20130520,14225,14225,13950,14195,13950,14195,14070,-30,-155,4,140.73,4
,20130521,14195,14070,,,,14130,14130,60,60,0,0,4
,20130522,14130,14130,,,,14085,14085,-45,-45,0,0,4
,20130523,14085,14085,,,,14095,14095,10,10,0,0,4
,20130524,14095,14095,,,,14100,14100,5,5,0,0,4
,20130527,14100,14100,,,,14100,14100,0,0,0,0,4
,20130528,14100,14100,,,,14075,14075,-25,-25,0,0,4
,20130529,14075,14075,,,,14100,14100,25,25,0,0,4
,20130530,14100,14100,,,,14180,14180,80,80,0,0,4
,20130531,14180,14180,14500,14500,14375,14375,14435,195,255,4,144.38,4
,20130603,14375,14435,,,,14450,14450,15,15,0,0,4
,20130604,14450,14450,,,,14480,14480,30,30,0,0,4
,20130605,14480,14480,14625,14625,14625,14625,14625,145,145,2,73.13,2
,20130606,14625,14625,,,,14625,14625,0,0,0,0,2
,20130607,14625,14625,,,,14625,14625,0,0,0,0,2
,20130613,14625,14625,,,,14620,14620,-5,-5,0,0,2
,20130614,14620,14620,,,,14600,14600,-20,-20,0,0,2
,20130617,14600,14600,,,,14600,14600,0,0,0,0,2
,20130618,14600,14600,,,,14600,14600,0,0,0,0,2
,20130619,14600,14600,,,,14600,14600,0,0,0,0,2
,20130620,14600,14600,,,,14505,14505,-95,-95,0,0,2
,20130621,14505,14505,,,,14360,14360,-145,-145,0,0,2
,20130624,14360,14360,,,,14330,14330,-30,-30,0,0,2
,20130625,14330,14330,,,,14300,14300,-30,-30,0,0,2
,20130626,14300,14300,,,,14315,14315,15,15,0,0,2
,20130627,14315,14315,,,,14235,14235,-80,-80,0,0,2
,20130628,14235,14235,,,,14210,14210,-25,-25,0,0,2
,20130701,14210,14210,,,,14210,14210,0,0,0,0,2
,20130702,14210,14210,14310,14315,14175,14175,14250,-35,40,20,712.73,6
,20130703,14175,14250,,,,14240,14240,-10,-10,0,0,6
,20130704,14240,14240,,,,14160,14160,-80,-80,0,0,6
,20130705,14160,14160,,,,14195,14195,35,35,0,0,6
,20130708,14195,14195,,,,14155,14155,-40,-40,0,0,6
,20130709,14155,14155,14230,14230,14080,14080,14155,-75,0,4,141.55,6
,20130710,14080,14155,,,,14140,14140,-15,-15,0,0,6
,20130711,14140,14140,14220,14225,14145,14145,14185,5,45,8,283.75,6
,20130712,14145,14185,,,,14165,14165,-20,-20,0,0,6
,20130715,14165,14165,,,,14165,14165,0,0,0,0,6
,20130716,14165,14165,,,,14165,14165,0,0,0,0,6
,20130717,14165,14165,,,,14165,14165,0,0,0,0,6
,20130718,14165,14165,,,,14165,14165,0,0,0,0,6
,20130719,14165,14165,14095,14095,14050,14050,14075,-115,-90,12,422.28,14
,20130722,14050,14075,,,,14080,14080,5,5,0,0,14
,20130723,14080,14080,,,,14080,14080,0,0,0,0,14
,20130724,14080,14080,14145,14145,14145,14145,14145,65,65,2,70.73,14
,20130725,14145,14145,,,,14130,14130,-15,-15,0,0,14
,20130726,14130,14130,,,,14100,14100,-30,-30,0,0,14
,20130729,14100,14100,,,,14015,14015,-85,-85,0,0,14
,20130730,14015,14015,,,,14010,14010,-5,-5,0,0,14
,20130731,14010,14010,,,,13980,13980,-30,-30,0,0,14
,20130801,13980,13980,,,,14040,14040,60,60,0,0,14
,20130802,14040,14040,,,,14040,14040,0,0,0,0,14
,20130805,14040,14040,14075,14075,14075,14075,14075,35,35,8,281.5,22
,20130806,14075,14075,,,,14085,14085,10,10,0,0,22
,20130807,14085,14085,,,,14095,14095,10,10,0,0,22
,20130808,14095,14095,,,,14205,14205,110,110,0,0,22
,20130809,14205,14205,14290,14390,14290,14390,14315,185,110,82,"2,935.50",86
,20130812,14390,14315,14480,14510,14450,14510,14480,195,165,58,"2,099.95",128
,20130813,14510,14480,14495,14560,14495,14560,14530,80,50,58,"2,107.00",172
,20130814,14560,14530,14500,14500,14495,14500,14495,-30,-35,12,434.95,180
,20130815,14500,14495,14590,14665,14590,14640,14620,145,125,48,"1,754.78",188
,20130816,14640,14620,14685,14985,14685,14985,14860,365,240,282,"10,476.95",392
,20130819,14985,14860,15050,15120,14980,14980,15005,120,145,108,"4,052.18",442
,20130820,14980,15005,14975,14980,14720,14720,14865,-285,-140,196,"7,286.10",492
,20130821,14720,14865,14875,14875,14790,14830,14835,-35,-30,82,"3,041.63",514
,20130822,14830,14835,14760,15000,14740,14835,14800,0,-35,200,"7,400.30",490
,20130823,14835,14800,14850,14895,14800,14890,14835,90,35,66,"2,447.88",516
,20130826,14890,14835,15000,15000,14930,14950,14970,115,135,36,"1,347.35",530
,20130827,14950,14970,14900,14900,14870,14880,14875,-90,-95,20,743.98,530
,20130828,14880,14875,14905,14930,14805,14805,14885,-70,10,88,"3,275.50",558
,20130829,14805,14885,14740,14815,14740,14775,14785,-110,-100,50,"1,848.35",562
,20130830,14775,14785,14755,14755,14605,14605,14700,-180,-85,66,"2,425.83",580
,20130902,14605,14700,14685,14800,14670,14750,14720,50,20,1528,"11,247.64",3214
,20130903,14750,14720,14750,14750,14595,14605,14655,-115,-65,528,"3,870.07",3332
,20130904,14605,14655,14515,14600,14485,14500,14515,-155,-140,926,"6,722.46",3262
,20130905,14500,14515,14400,14500,14400,14410,14435,-105,-80,266,"1,920.26",3386
,20130906,14410,14435,14385,14420,14360,14360,14380,-75,-55,644,"4,631.81",3780
,20130909,14360,14380,14420,14545,14420,14540,14515,160,135,1254,"9,103.12",4388
,20130910,14540,14515,14500,14500,14390,14395,14420,-120,-95,1178,"8,494.62",5048
,20130911,14395,14420,14400,14425,14370,14405,14405,-15,-15,1420,"10,229.71",5884
,20130912,14405,14405,14385,14410,14250,14260,14325,-145,-80,1362,"9,755.95",6222
,20130913,14260,14325,14265,14365,14265,14365,14295,40,-30,746,"5,332.59",6258
,20130916,14365,14295,14335,14335,14065,14080,14190,-215,-105,1260,"8,940.49",6722
,20130917,14080,14190,14000,14060,13915,13975,13975,-215,-215,3604,"25,190.97",7684
,20130918,13975,13975,13950,14040,13935,14040,13985,65,10,1298,"9,078.94",7852
,20130923,14040,13985,14050,14215,13970,14130,14115,145,130,3210,"22,660.94",7966
,20130924,14130,14115,14100,14195,14100,14110,14145,-5,30,1432,"10,128.46",8276
,20130925,14110,14145,14105,14155,14045,14125,14105,-20,-40,1444,"10,183.97",8330
,20130926,14125,14105,14110,14135,14080,14135,14095,30,-10,890,"6,273.61",8620
,20130927,14135,14095,14100,14130,14085,14100,14105,5,10,686,"4,838.07",8300
,20130930,14100,14105,14125,14150,14115,14120,14130,15,25,438,"3,095.04",8314
,20131008,14120,14130,14050,14080,14025,14055,14045,-75,-85,492,"3,455.13",8380
,20131009,14055,14045,14095,14155,14085,14095,14105,50,60,420,"2,962.09",8404
,20131010,14095,14105,14050,14160,14020,14145,14120,40,15,636,"4,490.88",8520
,20131011,14145,14120,14140,14180,14110,14145,14130,25,10,1232,"8,706.57",8792
,20131014,14145,14130,14145,14420,14100,14420,14145,290,15,876,"6,196.61",9014
,20131015,14420,14145,14300,14300,14160,14215,14245,70,100,586,"4,174.12",9020
,20131016,14215,14245,14220,14285,14190,14220,14225,-25,-20,1202,"8,552.10",9280
,20131017,14220,14225,14295,14350,14220,14280,14310,55,85,1080,"7,728.83",9546
,20131018,14280,14310,14350,14420,14320,14395,14375,85,65,1392,"10,008.08",10042
,20131021,14395,14375,14405,14470,14360,14455,14430,80,55,1402,"10,117.27",10010
,20131022,14455,14430,14465,14500,14435,14490,14465,60,35,1924,"13,918.75",10552
,20131023,14490,14465,14550,14550,14330,14430,14465,-35,0,1242,"8,985.85",10582
,20131024,14430,14465,14400,14405,14330,14390,14380,-75,-85,680,"4,889.21",10484
,20131025,14390,14380,14390,14425,14280,14320,14385,-60,5,696,"5,006.68",10680
,20131028,14320,14385,14385,14465,14385,14435,14435,50,50,1532,"11,060.29",11382
,20131029,14435,14435,14445,14480,14400,14480,14450,45,15,1618,"11,691.41",11518
,20131030,14480,14450,14400,14530,14400,14470,14465,20,15,650,"4,701.17",11678
,20131031,14470,14465,14430,14430,14005,14375,14335,-90,-130,1490,"10,682.75",11440
,20131101,14375,14335,14315,14475,14315,14425,14395,90,60,558,"4,016.43",11242
,20131104,14425,14395,14350,14390,14345,14365,14360,-30,-35,1072,"7,698.23",10824
,20131105,14365,14360,14365,14365,14305,14330,14315,-30,-45,1084,"7,760.37",10292
,20131106,14330,14315,14350,14350,14305,14330,14315,15,0,744,"5,326.21",9766
,20131107,14330,14315,14280,14320,14280,14310,14310,-5,-5,412,"2,948.54",9458
,20131108,14310,14310,14280,14290,14245,14250,14275,-60,-35,312,"2,226.93",9286
,20131111,14250,14275,14290,14290,14210,14210,14235,-65,-40,436,"3,103.84",9128
,20131112,14210,14235,14180,14180,14100,14105,14125,-130,-110,616,"4,350.96",8934
,20131113,14105,14125,14050,14050,13995,14000,14010,-125,-115,1248,"8,743.32",8660
,20131114,14000,14010,14020,14100,14020,14045,14045,35,35,820,"5,759.50",8484
,20131115,14045,14045,14070,14070,14000,14020,14025,-25,-20,348,"2,440.41",8470
,20131118,14020,14025,14065,14065,13980,13985,13995,-40,-30,1184,"8,287.86",8272
,20131119,13985,13995,13960,14550,13830,13865,14030,-130,35,3864,"27,113.85",7724
,20131120,13865,14030,13920,13960,13880,13940,13935,-90,-95,1482,"10,327.93",7780
,20131121,13940,13935,13895,13965,13845,13875,13880,-60,-55,2454,"17,032.55",8528
,20131122,13875,13880,13885,13905,13835,13905,13865,25,-15,1312,"9,098.38",8904
,20131125,13905,13865,13890,13925,13855,13855,13880,-10,15,788,"5,470.12",8760
,20131126,13855,13880,13870,13910,13850,13890,13870,10,-10,1702,"11,806.58",9114
,20131127,13890,13870,13860,13880,13860,13865,13865,-5,-5,1810,"12,548.33",8280
,20131128,13865,13865,13865,13865,13830,13845,13845,-20,-20,960,"6,646.97",8420
,20131129,13845,13845,13775,13900,13775,13865,13830,20,-15,806,"5,574.97",8310
,20131202,13865,13830,13830,13850,13830,13850,13835,20,5,300,"2,075.60",8310
,20131203,13850,13835,13785,13785,13750,13785,13775,-50,-60,510,"3,512.75",8220
,20131204,13785,13775,13790,13840,13790,13840,13810,65,35,440,"3,038.88",8000
,20131205,13840,13810,13835,13835,13825,13825,13825,15,15,320,"2,212.63",7980
,20131206,13825,13825,13805,13855,13805,13855,13820,30,-5,420,"2,902.40",7810
,20131209,13855,13820,13845,13845,13830,13830,13835,10,15,720,"4,981.98",7570
,20131210,13830,13835,13885,13930,13885,13920,13905,85,70,820,"5,702.15",7730
,20131211,13920,13905,13930,13945,13900,13920,13905,15,0,350,"2,433.50",7600
,20131212,13920,13905,13950,13980,13935,13980,13945,75,40,610,"4,254.48",7900
,20131213,13980,13945,13910,13910,13910,13910,13910,-35,-35,60,417.3,7870
,20131216,13910,13910,13955,14020,13900,14020,13960,110,50,260,"1,815.20",7990
pb1401,20130116,15660,15660,,,,15660,15660,0,0,0,0,0
,20130117,15660,15660,,,,15610,15610,-50,-50,0,0,0
,20130118,15610,15610,,,,15610,15610,0,0,0,0,0
,20130121,15610,15610,,,,15700,15700,90,90,0,0,0
,20130122,15700,15700,,,,15700,15700,0,0,0,0,0
,20130123,15700,15700,,,,15700,15700,0,0,0,0,0
,20130124,15700,15700,,,,15680,15680,-20,-20,0,0,0
,20130125,15680,15680,,,,15800,15800,120,120,0,0,0
,20130128,15800,15800,,,,15730,15730,-70,-70,0,0,0
,20130129,15730,15730,,,,15780,15780,50,50,0,0,0
,20130130,15780,15780,,,,15995,15995,215,215,0,0,0
,20130131,15995,15995,,,,16115,16115,120,120,0,0,0
,20130201,16115,16115,,,,16060,16060,-55,-55,0,0,0
,20130204,16060,16060,,,,16140,16140,80,80,0,0,0
,20130205,16140,16140,,,,16025,16025,-115,-115,0,0,0
,20130206,16025,16025,,,,15965,15965,-60,-60,0,0,0
,20130207,15965,15965,,,,16035,16035,70,70,0,0,0
,20130208,16035,16035,,,,16100,16100,65,65,0,0,0
,20130218,16100,16100,,,,16075,16075,-25,-25,0,0,0
,20130219,16075,16075,,,,16035,16035,-40,-40,0,0,0
,20130220,16035,16035,,,,16020,16020,-15,-15,0,0,0
,20130221,16020,16020,,,,15795,15795,-225,-225,0,0,0
,20130222,15795,15795,,,,15625,15625,-170,-170,0,0,0
,20130225,15625,15625,,,,15555,15555,-70,-70,0,0,0
,20130226,15555,15555,,,,15520,15520,-35,-35,0,0,0
,20130227,15520,15520,,,,15515,15515,-5,-5,0,0,0
,20130228,15515,15515,,,,15485,15485,-30,-30,0,0,0
,20130301,15485,15485,,,,15440,15440,-45,-45,0,0,0
,20130304,15440,15440,,,,15335,15335,-105,-105,0,0,0
,20130305,15335,15335,,,,15495,15495,160,160,0,0,0
,20130306,15495,15495,,,,15555,15555,60,60,0,0,0
,20130307,15555,15555,,,,15380,15380,-175,-175,0,0,0
,20130308,15380,15380,,,,15455,15455,75,75,0,0,0
,20130311,15455,15455,,,,15320,15320,-135,-135,0,0,0
,20130312,15320,15320,,,,15210,15210,-110,-110,0,0,0
,20130313,15210,15210,,,,15125,15125,-85,-85,0,0,0
,20130314,15125,15125,,,,14765,14765,-360,-360,0,0,0
,20130315,14765,14765,,,,14790,14790,25,25,0,0,0
,20130318,14790,14790,,,,14565,14565,-225,-225,0,0,0
,20130319,14565,14565,,,,14670,14670,105,105,0,0,0
,20130320,14670,14670,,,,15100,15100,430,430,0,0,0
,20130321,15100,15100,,,,15170,15170,70,70,0,0,0
,20130322,15170,15170,,,,15090,15090,-80,-80,0,0,0
,20130325,15090,15090,,,,15150,15150,60,60,0,0,0
,20130326,15150,15150,,,,15125,15125,-25,-25,0,0,0
,20130327,15125,15125,,,,15060,15060,-65,-65,0,0,0
,20130328,15060,15060,,,,15010,15010,-50,-50,0,0,0
,20130329,15010,15010,,,,14940,14940,-70,-70,0,0,0
,20130401,14940,14940,,,,14710,14710,-230,-230,0,0,0
,20130402,14710,14710,,,,14705,14705,-5,-5,0,0,0
,20130403,14705,14705,,,,14635,14635,-70,-70,0,0,0
,20130408,14635,14635,,,,14815,14815,180,180,0,0,0
,20130409,14815,14815,,,,14765,14765,-50,-50,0,0,0
,20130410,14765,14765,,,,14765,14765,0,0,0,0,0
,20130411,14765,14765,,,,14225,14225,-540,-540,0,0,0
,20130412,14225,14225,,,,14175,14175,-50,-50,0,0,0
,20130415,14175,14175,,,,14030,14030,-145,-145,0,0,0
,20130416,14030,14030,,,,13890,13890,-140,-140,0,0,0
,20130417,13890,13890,,,,13905,13905,15,15,0,0,0
,20130418,13905,13905,,,,13545,13545,-360,-360,0,0,0
,20130419,13545,13545,,,,13480,13480,-65,-65,0,0,0
,20130422,13480,13480,,,,13470,13470,-10,-10,0,0,0
,20130423,13470,13470,,,,14000,14000,530,530,0,0,0
,20130424,14000,14000,,,,14085,14085,85,85,0,0,0
,20130425,14085,14085,,,,14300,14300,215,215,0,0,0
,20130426,14300,14300,,,,14290,14290,-10,-10,0,0,0
,20130502,14290,14290,,,,14160,14160,-130,-130,0,0,0
,20130503,14160,14160,,,,14170,14170,10,10,0,0,0
,20130506,14170,14170,,,,14265,14265,95,95,0,0,0
,20130507,14265,14265,,,,14235,14235,-30,-30,0,0,0
,20130508,14235,14235,,,,14255,14255,20,20,0,0,0
,20130509,14255,14255,,,,14230,14230,-25,-25,0,0,0
,20130510,14230,14230,,,,14240,14240,10,10,0,0,0
,20130513,14240,14240,,,,14200,14200,-40,-40,0,0,0
,20130514,14200,14200,,,,14130,14130,-70,-70,0,0,0
,20130515,14130,14130,,,,14075,14075,-55,-55,0,0,0
,20130516,14075,14075,,,,14110,14110,35,35,0,0,0
,20130517,14110,14110,,,,14075,14075,-35,-35,0,0,0
,20130520,14075,14075,,,,13920,13920,-155,-155,0,0,0
,20130521,13920,13920,,,,13985,13985,65,65,0,0,0
,20130522,13985,13985,,,,13940,13940,-45,-45,0,0,0
,20130523,13940,13940,,,,13945,13945,5,5,0,0,0
,20130524,13945,13945,,,,13945,13945,0,0,0,0,0
,20130527,13945,13945,,,,13945,13945,0,0,0,0,0
,20130528,13945,13945,,,,13925,13925,-20,-20,0,0,0
,20130529,13925,13925,,,,13950,13950,25,25,0,0,0
,20130530,13950,13950,,,,13955,13955,5,5,0,0,0
,20130531,13955,13955,,,,14205,14205,250,250,0,0,0
,20130603,14205,14205,,,,14305,14305,100,100,0,0,0
,20130604,14305,14305,,,,14330,14330,25,25,0,0,0
,20130605,14330,14330,,,,14470,14470,140,140,0,0,0
,20130606,14470,14470,,,,14425,14425,-45,-45,0,0,0
,20130607,14425,14425,,,,14395,14395,-30,-30,0,0,0
,20130613,14395,14395,,,,14240,14240,-155,-155,0,0,0
,20130614,14240,14240,,,,14170,14170,-70,-70,0,0,0
,20130617,14170,14170,,,,14260,14260,90,90,0,0,0
,20130618,14260,14260,,,,14275,14275,15,15,0,0,0
,20130619,14275,14275,,,,14250,14250,-25,-25,0,0,0
,20130620,14250,14250,,,,14160,14160,-90,-90,0,0,0
,20130621,14160,14160,,,,14005,14005,-155,-155,0,0,0
,20130624,14005,14005,,,,13975,13975,-30,-30,0,0,0
,20130625,13975,13975,14545,14545,14265,14265,14405,290,430,4,144.05,0
,20130626,14265,14405,,,,14350,14350,-55,-55,0,0,0
,20130627,14350,14350,,,,14380,14380,30,30,0,0,0
,20130628,14380,14380,,,,14355,14355,-25,-25,0,0,0
,20130701,14355,14355,,,,14465,14465,110,110,0,0,0
,20130702,14465,14465,,,,14510,14510,45,45,0,0,0
,20130703,14510,14510,,,,14400,14400,-110,-110,0,0,0
,20130704,14400,14400,,,,14315,14315,-85,-85,0,0,0
,20130705,14315,14315,,,,14350,14350,35,35,0,0,0
,20130708,14350,14350,,,,14370,14370,20,20,0,0,0
,20130709,14370,14370,,,,14370,14370,0,0,0,0,0
,20130710,14370,14370,,,,14300,14300,-70,-70,0,0,0
,20130711,14300,14300,14130,14590,14125,14230,14320,-70,20,26,930.98,8
,20130712,14230,14320,14215,14215,14215,14215,14215,-105,-105,2,71.08,8
,20130715,14215,14215,14250,14250,14220,14220,14235,5,20,4,142.35,8
,20130716,14220,14235,,,,14235,14235,0,0,0,0,8
,20130717,14235,14235,,,,14255,14255,20,20,0,0,8
,20130718,14255,14255,,,,14240,14240,-15,-15,0,0,8
,20130719,14240,14240,14200,14200,14165,14165,14180,-75,-60,8,283.6,0
,20130722,14165,14180,,,,14180,14180,0,0,0,0,0
,20130723,14180,14180,,,,14195,14195,15,15,0,0,0
,20130724,14195,14195,,,,14260,14260,65,65,0,0,0
,20130725,14260,14260,,,,14260,14260,0,0,0,0,0
,20130726,14260,14260,,,,14240,14240,-20,-20,0,0,0
,20130729,14240,14240,,,,14150,14150,-90,-90,0,0,0
,20130730,14150,14150,,,,14145,14145,-5,-5,0,0,0
,20130731,14145,14145,,,,14115,14115,-30,-30,0,0,0
,20130801,14115,14115,,,,14195,14195,80,80,0,0,0
,20130802,14195,14195,,,,14215,14215,20,20,0,0,0
,20130805,14215,14215,,,,14250,14250,35,35,0,0,0
,20130806,14250,14250,,,,14270,14270,20,20,0,0,0
,20130807,14270,14270,,,,14280,14280,10,10,0,0,0
,20130808,14280,14280,14425,14425,14200,14200,14310,-80,30,14,500.85,6
,20130809,14200,14310,14430,14430,14430,14430,14430,120,120,2,72.15,8
,20130812,14430,14430,,,,14595,14595,165,165,0,0,8
,20130813,14595,14595,14650,14650,14435,14585,14545,-10,-50,22,800.05,8
,20130814,14585,14545,,,,14545,14545,0,0,0,0,8
,20130815,14545,14545,14545,14715,14545,14655,14595,110,50,36,"1,313.60",26
,20130816,14655,14595,14795,15000,14725,15000,14860,405,265,36,"1,337.43",40
,20130819,15000,14860,15000,15015,14995,14995,15000,135,140,8,300.03,44
,20130820,14995,15000,14960,14960,14785,14830,14890,-170,-110,56,"2,085.25",58
,20130821,14830,14890,14910,14910,14800,14855,14850,-35,-40,28,"1,039.68",72
,20130822,14855,14850,14950,14985,14775,14775,14845,-75,-5,46,"1,707.23",100
,20130823,14775,14845,14815,14815,14790,14790,14800,-55,-45,4,148.03,98
,20130826,14790,14800,14940,14990,14940,14990,14950,190,150,68,"2,542.00",104
,20130827,14990,14950,14890,14890,14865,14865,14870,-85,-80,16,594.95,114
,20130828,14865,14870,14925,14925,14915,14920,14915,50,45,26,969.73,128
,20130829,14920,14915,14870,14870,14870,14870,14870,-45,-45,2,74.35,128
,20130830,14870,14870,,,,14785,14785,-85,-85,0,0,128
,20130902,14785,14785,14895,14895,14725,14810,14760,25,-25,212,"1,564.59",642
,20130903,14810,14760,14630,14650,14630,14650,14635,-110,-125,6,43.92,638
,20130904,14650,14635,14600,14600,14555,14565,14565,-70,-70,146,"1,063.38",608
,20130905,14565,14565,14505,14505,14470,14470,14485,-95,-80,10,72.44,612
,20130906,14470,14485,14410,14455,14405,14440,14440,-45,-45,62,447.66,646
,20130909,14440,14440,14535,14590,14535,14590,14560,150,120,24,174.76,642
,20130910,14590,14560,14590,14590,14465,14470,14480,-90,-80,46,333.1,662
,20130911,14470,14480,14440,14465,14440,14465,14450,-15,-30,40,289.09,662
,20130912,14465,14450,14405,14405,14315,14315,14365,-135,-85,210,"1,508.45",754
,20130913,14315,14365,14310,14380,14305,14380,14330,15,-35,52,372.59,772
,20130916,14380,14330,14335,14335,14120,14120,14225,-210,-105,84,597.48,796
,20130917,14120,14225,14080,14100,13970,14025,14030,-200,-195,366,"2,567.93",1004
,20130918,14025,14030,14000,14075,14000,14075,14030,45,0,52,364.82,1018
,20130923,14075,14030,14075,14275,14050,14185,14125,155,95,454,"3,207.14",1168
,20130924,14185,14125,14150,14210,14145,14145,14180,20,55,226,"1,602.45",1206
,20130925,14145,14180,14120,14175,14110,14170,14150,-10,-30,158,"1,117.85",1222
,20130926,14170,14150,14125,14200,14120,14195,14145,45,-5,368,"2,602.87",1460
,20130927,14195,14145,14195,14200,14130,14160,14165,15,20,74,524.17,1500
,20130930,14160,14165,14235,14235,13360,14180,14155,15,-10,144,"1,019.41",1478
,20131008,14180,14155,14100,14135,14085,14125,14100,-30,-55,88,620.54,1498
,20131009,14125,14100,14140,14355,14140,14155,14160,55,60,286,"2,025.35",1706
,20131010,14155,14160,14140,14195,14115,14185,14165,25,5,96,679.96,1774
,20131011,14185,14165,14200,14250,14170,14205,14205,40,40,290,"2,060.14",1964
,20131014,14205,14205,14235,14285,14160,14285,14190,80,-15,98,695.55,1954
,20131015,14285,14190,14345,14345,14265,14265,14310,75,120,122,873.02,1998
,20131016,14265,14310,14315,14370,14260,14285,14295,-25,-15,390,"2,788.09",2204
,20131017,14285,14295,14360,14390,14325,14335,14360,40,65,586,"4,208.93",2380
,20131018,14335,14360,14425,14475,14380,14440,14430,80,70,430,"3,103.19",2452
,20131021,14440,14430,14455,14525,14420,14505,14490,75,60,1032,"7,477.72",3092
,20131022,14505,14490,14525,14565,14480,14550,14520,60,30,1344,"9,760.20",3946
,20131023,14550,14520,14550,14575,14330,14470,14525,-50,5,734,"5,330.87",4198
,20131024,14470,14525,14400,14460,14390,14430,14415,-95,-110,316,"2,278.11",4188
,20131025,14430,14415,14460,14485,14310,14330,14400,-85,-15,728,"5,242.34",4430
,20131028,14330,14400,14425,14495,14415,14465,14465,65,65,832,"6,017.86",4744
,20131029,14465,14465,14465,14515,14440,14510,14485,45,20,968,"7,011.24",5344
,20131030,14510,14485,14500,14550,14460,14540,14500,55,15,464,"3,364.73",5612
,20131031,14540,14500,14465,14475,14100,14375,14375,-125,-125,1372,"9,863.99",6000
,20131101,14375,14375,14380,14500,14375,14495,14435,120,60,704,"5,082.33",6142
,20131104,14495,14435,14420,14440,14390,14420,14410,-15,-25,1038,"7,478.85",6484
,20131105,14420,14410,14395,14395,14340,14385,14360,-25,-50,840,"6,031.49",6884
,20131106,14385,14360,14395,14395,14350,14370,14365,10,5,908,"6,521.81",7544
,20131107,14370,14365,14355,14370,14355,14360,14360,-5,-5,522,"3,748.79",7762
,20131108,14360,14360,14350,14355,14290,14310,14325,-50,-35,410,"2,937.24",7982
,20131111,14310,14325,14390,14390,14260,14265,14275,-60,-50,796,"5,683.26",8464
,20131112,14265,14275,14235,14235,14150,14160,14170,-115,-105,768,"5,442.90",8636
,20131113,14160,14170,14120,14130,14050,14070,14065,-100,-105,872,"6,133.15",8860
,20131114,14070,14065,14090,14150,14090,14120,14105,55,40,1746,"12,317.99",9446
,20131115,14120,14105,14120,14135,14050,14075,14095,-30,-10,1078,"7,597.23",9660
,20131118,14075,14095,14115,14115,14045,14045,14065,-50,-30,382,"2,686.73",9722
,20131119,14045,14065,14005,14010,13905,13910,13960,-155,-105,1768,"12,344.07",10332
,20131120,13910,13960,13975,14020,13960,14015,14005,55,45,958,"6,708.52",10520
,20131121,14015,14005,14015,14015,13920,13950,13960,-55,-45,1138,"7,945.25",10526
,20131122,13950,13960,14000,14010,13925,13980,13950,20,-10,844,"5,888.18",10754
,20131125,13980,13950,13995,14000,13930,13935,13960,-15,10,528,"3,686.19",10578
,20131126,13935,13960,13940,14000,13930,13970,13960,10,0,970,"6,772.65",10454
,20131127,13970,13960,13980,13980,13945,13965,13950,5,-10,956,"6,669.92",11092
,20131128,13965,13950,13915,13945,13905,13910,13925,-40,-25,1056,"7,352.60",11086
,20131129,13910,13925,13910,13950,13905,13905,13915,-20,-10,1010,"7,028.62",11102
,20131202,13905,13915,13905,13950,13850,13925,13915,10,0,1014,"7,056.51",10668
,20131203,13925,13915,13905,13905,13840,13840,13860,-75,-55,1106,"7,664.67",10458
,20131204,13840,13860,13890,13900,13870,13885,13885,25,25,512,"3,555.11",10202
,20131205,13885,13885,13940,13940,13900,13905,13915,20,30,548,"3,813.67",9842
,20131206,13905,13915,13885,13925,13870,13925,13895,10,-20,670,"4,655.54",9628
,20131209,13925,13895,13965,13965,13915,13930,13920,35,25,1036,"7,212.71",9244
,20131210,13930,13920,13970,13995,13960,13985,13975,65,55,1000,"6,988.43",8792
,20131211,13985,13975,14050,14050,13955,13975,13985,0,10,1316,"9,202.48",8004
,20131212,13975,13985,14020,14045,14000,14045,14025,60,40,1674,"11,740.99",7788
,20131213,14045,14025,14030,14030,13960,13990,13985,-35,-40,766,"5,357.75",7516
,20131216,13990,13985,14040,14085,14025,14065,14040,80,55,1526,"10,715.81",7044
,20131217,14065,14040,14165,14290,14140,14280,14200,240,160,2962,"21,034.16",7352
,20131218,14280,14200,14290,14345,14180,14230,14235,30,35,1762,"12,543.93",7786
,20131219,14230,14235,14300,14300,14100,14175,14150,-60,-85,736,"5,207.88",7894
,20131220,14175,14150,14200,14280,14140,14270,14235,120,85,1560,"11,105.94",8132
,20131223,14270,14235,14330,14375,14240,14270,14290,35,55,988,"7,061.67",8310
,20131224,14270,14290,14265,14305,14205,14300,14265,10,-25,756,"5,392.51",8082
,20131225,14300,14265,14340,14390,14315,14360,14350,95,85,914,"6,559.00",7714
,20131226,14360,14350,14395,14395,14260,14260,14325,-90,-25,804,"5,760.22",7574
,20131227,14260,14325,14255,14320,14240,14270,14285,-55,-40,508,"3,628.57",7360
,20131230,14270,14285,14345,14395,14310,14340,14355,55,70,290,"2,082.14",7304
,20131231,14340,14355,14295,14400,14250,14400,14285,45,-70,250,"1,786.24",7170
pb1402,20130219,16075,16075,,,,16075,16075,0,0,0,0,0
,20130220,16075,16075,,,,16060,16060,-15,-15,0,0,0
,20130221,16060,16060,,,,15835,15835,-225,-225,0,0,0
,20130222,15835,15835,,,,15665,15665,-170,-170,0,0,0
,20130225,15665,15665,,,,15595,15595,-70,-70,0,0,0
,20130226,15595,15595,,,,15560,15560,-35,-35,0,0,0
,20130227,15560,15560,,,,15555,15555,-5,-5,0,0,0
,20130228,15555,15555,,,,15525,15525,-30,-30,0,0,0
,20130301,15525,15525,,,,15480,15480,-45,-45,0,0,0
,20130304,15480,15480,,,,15375,15375,-105,-105,0,0,0
,20130305,15375,15375,,,,15535,15535,160,160,0,0,0
,20130306,15535,15535,,,,15595,15595,60,60,0,0,0
,20130307,15595,15595,,,,15420,15420,-175,-175,0,0,0
,20130308,15420,15420,,,,15495,15495,75,75,0,0,0
,20130311,15495,15495,,,,15360,15360,-135,-135,0,0,0
,20130312,15360,15360,,,,15250,15250,-110,-110,0,0,0
,20130313,15250,15250,,,,15165,15165,-85,-85,0,0,0
,20130314,15165,15165,,,,14805,14805,-360,-360,0,0,0
,20130315,14805,14805,,,,14830,14830,25,25,0,0,0
,20130318,14830,14830,,,,14605,14605,-225,-225,0,0,0
,20130319,14605,14605,,,,14710,14710,105,105,0,0,0
,20130320,14710,14710,15370,15370,15370,15370,15370,660,660,2,76.85,2
,20130321,15370,15370,,,,15440,15440,70,70,0,0,2
,20130322,15440,15440,,,,15355,15355,-85,-85,0,0,2
,20130325,15355,15355,,,,15415,15415,60,60,0,0,2
,20130326,15415,15415,,,,15390,15390,-25,-25,0,0,2
,20130327,15390,15390,,,,15325,15325,-65,-65,0,0,2
,20130328,15325,15325,,,,15275,15275,-50,-50,0,0,2
,20130329,15275,15275,,,,15205,15205,-70,-70,0,0,2
,20130401,15205,15205,,,,14970,14970,-235,-235,0,0,2
,20130402,14970,14970,,,,14960,14960,-10,-10,0,0,2
,20130403,14960,14960,,,,14890,14890,-70,-70,0,0,2
,20130408,14890,14890,,,,15075,15075,185,185,0,0,2
,20130409,15075,15075,,,,15020,15020,-55,-55,0,0,2
,20130410,15020,15020,,,,15090,15090,70,70,0,0,2
,20130411,15090,15090,,,,14540,14540,-550,-550,0,0,2
,20130412,14540,14540,,,,14490,14490,-50,-50,0,0,2
,20130415,14490,14490,,,,14345,14345,-145,-145,0,0,2
,20130416,14345,14345,,,,14200,14200,-145,-145,0,0,2
,20130417,14200,14200,,,,14215,14215,15,15,0,0,2
,20130418,14215,14215,,,,13845,13845,-370,-370,0,0,2
,20130419,13845,13845,,,,13780,13780,-65,-65,0,0,2
,20130422,13780,13780,,,,13770,13770,-10,-10,0,0,2
,20130423,13770,13770,,,,13685,13685,-85,-85,0,0,2
,20130424,13685,13685,,,,14365,14365,680,680,0,0,2
,20130425,14365,14365,14600,14600,14600,14600,14600,235,235,2,73,0
,20130426,14600,14600,,,,14600,14600,0,0,0,0,0
,20130502,14600,14600,,,,14600,14600,0,0,0,0,0
,20130503,14600,14600,,,,14610,14610,10,10,0,0,0
,20130506,14610,14610,,,,14710,14710,100,100,0,0,0
,20130507,14710,14710,,,,14675,14675,-35,-35,0,0,0
,20130508,14675,14675,,,,14695,14695,20,20,0,0,0
,20130509,14695,14695,,,,14670,14670,-25,-25,0,0,0
,20130510,14670,14670,,,,14680,14680,10,10,0,0,0
,20130513,14680,14680,,,,14640,14640,-40,-40,0,0,0
,20130514,14640,14640,,,,14570,14570,-70,-70,0,0,0
,20130515,14570,14570,,,,14510,14510,-60,-60,0,0,0
,20130516,14510,14510,,,,14500,14500,-10,-10,0,0,0
,20130517,14500,14500,,,,14460,14460,-40,-40,0,0,0
,20130520,14460,14460,,,,14300,14300,-160,-160,0,0,0
,20130521,14300,14300,,,,14365,14365,65,65,0,0,0
,20130522,14365,14365,,,,14315,14315,-50,-50,0,0,0
,20130523,14315,14315,,,,14325,14325,10,10,0,0,0
,20130524,14325,14325,,,,14330,14330,5,5,0,0,0
,20130527,14330,14330,,,,14345,14345,15,15,0,0,0
,20130528,14345,14345,,,,14320,14320,-25,-25,0,0,0
,20130529,14320,14320,,,,14350,14350,30,30,0,0,0
,20130530,14350,14350,,,,14490,14490,140,140,0,0,0
,20130531,14490,14490,,,,14750,14750,260,260,0,0,0
,20130603,14750,14750,,,,14855,14855,105,105,0,0,0
,20130604,14855,14855,,,,14885,14885,30,30,0,0,0
,20130605,14885,14885,,,,15030,15030,145,145,0,0,0
,20130606,15030,15030,,,,14985,14985,-45,-45,0,0,0
,20130607,14985,14985,,,,14955,14955,-30,-30,0,0,0
,20130613,14955,14955,,,,14795,14795,-160,-160,0,0,0
,20130614,14795,14795,,,,14725,14725,-70,-70,0,0,0
,20130617,14725,14725,,,,14715,14715,-10,-10,0,0,0
,20130618,14715,14715,,,,14730,14730,15,15,0,0,0
,20130619,14730,14730,,,,14705,14705,-25,-25,0,0,0
,20130620,14705,14705,,,,14610,14610,-95,-95,0,0,0
,20130621,14610,14610,,,,14450,14450,-160,-160,0,0,0
,20130624,14450,14450,,,,14420,14420,-30,-30,0,0,0
,20130625,14420,14420,,,,14860,14860,440,440,0,0,0
,20130626,14860,14860,,,,14875,14875,15,15,0,0,0
,20130627,14875,14875,,,,14905,14905,30,30,0,0,0
,20130628,14905,14905,,,,14880,14880,-25,-25,0,0,0
,20130701,14880,14880,,,,14995,14995,115,115,0,0,0
,20130702,14995,14995,,,,15040,15040,45,45,0,0,0
,20130703,15040,15040,,,,14925,14925,-115,-115,0,0,0
,20130704,14925,14925,,,,14840,14840,-85,-85,0,0,0
,20130705,14840,14840,,,,14875,14875,35,35,0,0,0
,20130708,14875,14875,,,,14895,14895,20,20,0,0,0
,20130709,14895,14895,,,,14895,14895,0,0,0,0,0
,20130710,14895,14895,,,,14825,14825,-70,-70,0,0,0
,20130711,14825,14825,,,,14845,14845,20,20,0,0,0
,20130712,14845,14845,14345,14345,14345,14345,14345,-500,-500,2,71.73,2
,20130715,14345,14345,,,,14345,14345,0,0,0,0,2
,20130716,14345,14345,,,,14345,14345,0,0,0,0,2
,20130717,14345,14345,,,,14345,14345,0,0,0,0,2
,20130718,14345,14345,,,,14345,14345,0,0,0,0,2
,20130719,14345,14345,,,,14310,14310,-35,-35,0,0,2
,20130722,14310,14310,,,,14310,14310,0,0,0,0,2
,20130723,14310,14310,,,,14310,14310,0,0,0,0,2
,20130724,14310,14310,,,,14310,14310,0,0,0,0,2
,20130725,14310,14310,,,,14310,14310,0,0,0,0,2
,20130726,14310,14310,14310,14310,14310,14310,14310,0,0,2,71.55,4
,20130729,14310,14310,,,,14265,14265,-45,-45,0,0,4
,20130730,14265,14265,,,,14250,14250,-15,-15,0,0,4
,20130731,14250,14250,,,,14215,14215,-35,-35,0,0,4
,20130801,14215,14215,,,,14300,14300,85,85,0,0,4
,20130802,14300,14300,14240,14240,14240,14240,14240,-60,-60,2,71.2,6
,20130805,14240,14240,,,,14275,14275,35,35,0,0,6
,20130806,14275,14275,,,,14295,14295,20,20,0,0,6
,20130807,14295,14295,,,,14305,14305,10,10,0,0,6
,20130808,14305,14305,,,,14335,14335,30,30,0,0,6
,20130809,14335,14335,,,,14530,14530,195,195,0,0,6
,20130812,14530,14530,,,,14570,14570,40,40,0,0,6
,20130813,14570,14570,,,,14570,14570,0,0,0,0,6
,20130814,14570,14570,,,,14535,14535,-35,-35,0,0,6
,20130815,14535,14535,14940,14940,14720,14720,14765,185,230,16,590.75,14
,20130816,14720,14765,14910,14910,14910,14910,14910,145,145,8,298.2,18
,20130819,14910,14910,14910,15030,14910,15030,14985,120,75,14,524.55,26
,20130820,15030,14985,,,,14935,14935,-50,-50,0,0,26
,20130821,14935,14935,14860,14905,14860,14905,14865,-30,-70,14,520.33,38
,20130822,14905,14865,14940,14960,14940,14950,14945,85,80,10,373.73,32
,20130823,14950,14945,,,,14945,14945,0,0,0,0,32
,20130826,14945,14945,15200,15200,14805,15000,15035,55,90,18,676.65,22
,20130827,15000,15035,,,,14955,14955,-80,-80,0,0,22
,20130828,14955,14955,14820,14820,14820,14820,14820,-135,-135,8,296.4,30
,20130829,14820,14820,14830,14920,14830,14920,14890,100,70,6,223.35,26
,20130830,14920,14890,14900,14900,14880,14880,14890,-10,0,8,297.8,18
,20130902,14880,14890,,,,14875,14875,-15,-15,0,0,90
,20130903,14875,14875,,,,14735,14735,-140,-140,0,0,90
,20130904,14735,14735,14615,14615,14615,14615,14615,-120,-120,88,643.06,50
,20130905,14615,14615,,,,14570,14570,-45,-45,0,0,50
,20130906,14570,14570,,,,14525,14525,-45,-45,0,0,50
,20130909,14525,14525,14620,14650,14615,14650,14630,125,105,42,307.29,60
,20130910,14650,14630,,,,14545,14545,-85,-85,0,0,60
,20130911,14545,14545,,,,14540,14540,-5,-5,0,0,60
,20130912,14540,14540,14380,14380,14380,14380,14380,-160,-160,4,28.76,60
,20130913,14380,14380,14380,14430,14300,14360,14345,-20,-35,98,702.91,84
,20130916,14360,14345,14320,14320,14150,14165,14230,-180,-115,166,"1,181.37",138
,20130917,14165,14230,14080,14080,14035,14035,14055,-195,-175,98,688.73,188
,20130918,14035,14055,14045,14045,14045,14045,14045,-10,-10,20,140.45,208
,20130923,14045,14045,14100,14195,14100,14195,14140,150,95,18,127.27,206
,20130924,14195,14140,14215,14215,14160,14160,14190,20,50,242,"1,717.04",386
,20130925,14160,14190,14180,14195,14155,14155,14170,-35,-20,208,"1,473.69",432
,20130926,14155,14170,14155,14160,14155,14160,14155,-10,-15,14,99.09,434
,20130927,14160,14155,14160,14180,14160,14160,14160,5,5,94,665.64,476
,20130930,14160,14160,14195,14200,14190,14200,14195,40,35,24,170.35,478
,20131008,14200,14195,,,,14175,14175,-20,-20,0,0,478
,20131009,14175,14175,14170,14170,14170,14170,14170,-5,-5,20,141.7,498
,20131010,14170,14170,,,,14190,14190,20,20,0,0,498
,20131011,14190,14190,14290,14295,14290,14295,14290,105,100,32,228.72,498
,20131014,14295,14290,,,,14290,14290,0,0,0,0,498
,20131015,14290,14290,14245,14365,14245,14345,14315,55,25,36,257.7,518
,20131016,14345,14315,,,,14315,14315,0,0,0,0,518
,20131017,14315,14315,14390,14390,14370,14385,14385,70,70,28,201.42,498
,20131018,14385,14385,14495,14495,14475,14485,14480,100,95,32,231.74,504
,20131021,14485,14480,14520,14570,14520,14570,14545,90,65,4,29.09,502
,20131022,14570,14545,14570,14570,14555,14555,14560,10,15,38,276.65,498
,20131023,14555,14560,14615,14615,14525,14530,14590,-30,30,104,758.72,560
,20131024,14530,14590,14470,14485,14470,14485,14480,-105,-110,6,43.44,558
,20131025,14485,14480,14505,14505,14505,14505,14505,25,25,8,58.02,558
,20131028,14505,14505,14490,14545,14475,14510,14520,5,15,106,769.64,558
,20131029,14510,14520,14520,14530,14520,14530,14525,10,5,14,101.69,568
,20131030,14530,14525,14520,14540,14520,14540,14535,15,10,22,159.92,588
,20131031,14540,14535,14455,14455,14455,14455,14455,-80,-80,20,144.55,568
,20131101,14455,14455,14500,14500,14495,14500,14495,45,40,22,159.5,568
,20131104,14500,14495,14445,14465,14445,14465,14445,-30,-50,34,245.59,566
,20131105,14465,14445,14420,14420,14380,14380,14390,-65,-55,76,546.95,588
,20131106,14380,14390,14400,14415,14390,14415,14395,25,5,70,503.89,632
,20131107,14415,14395,14395,14415,14385,14390,14390,-5,-5,98,705.3,684
,20131108,14390,14390,14360,14360,14320,14320,14320,-70,-70,50,358.07,718
,20131111,14320,14320,14325,14325,14325,14325,14325,5,5,6,42.98,720
,20131112,14325,14325,14255,14255,14185,14185,14205,-140,-120,118,838.11,766
,20131113,14185,14205,14085,14150,14085,14110,14105,-95,-100,116,818.1,822
,20131114,14110,14105,14140,14180,14130,14180,14145,75,40,250,"1,768.53",950
,20131115,14180,14145,14130,14180,14120,14120,14150,-25,5,206,"1,457.79",1056
,20131118,14120,14150,14135,14135,14100,14100,14105,-50,-45,80,564.37,1078
,20131119,14100,14105,14035,14070,13980,13980,14035,-125,-70,308,"2,161.77",1258
,20131120,13980,14035,14050,14090,14050,14090,14065,55,30,430,"3,024.89",1574
,20131121,14090,14065,14070,14070,13980,14030,14015,-35,-50,242,"1,696.32",1670
,20131122,14030,14015,14030,14040,14000,14040,14015,25,0,408,"2,859.80",1818
,20131125,14040,14015,14035,14060,14000,14000,14015,-15,0,308,"2,158.80",1968
,20131126,14000,14015,14010,14065,14010,14055,14040,40,25,482,"3,384.07",2322
,20131127,14055,14040,14035,14045,14015,14025,14020,-15,-20,142,995.63,2394
,20131128,14025,14020,14005,14015,13985,13990,13995,-30,-25,902,"6,313.08",2876
,20131129,13990,13995,14000,14015,13960,13960,13980,-35,-15,1168,"8,166.45",3388
,20131202,13960,13980,13910,14010,13910,13990,13980,10,0,542,"3,789.02",3686
,20131203,13990,13980,13925,13960,13910,13935,13930,-45,-50,714,"4,974.30",4098
,20131204,13935,13930,13960,13975,13945,13945,13960,15,30,752,"5,250.05",4336
,20131205,13945,13960,13975,14020,13965,13965,13990,5,30,498,"3,484.62",4578
,20131206,13965,13990,13950,13985,13950,13985,13970,-5,-20,512,"3,576.75",4804
,20131209,13985,13970,13985,14045,13985,14005,14000,35,30,904,"6,329.29",5268
,20131210,14005,14000,14050,14075,14040,14075,14055,75,55,820,"5,763.82",5508
,20131211,14075,14055,14080,14150,14035,14065,14065,10,10,1070,"7,525.82",6226
,20131212,14065,14065,14150,14150,14090,14130,14105,65,40,958,"6,757.73",6684
,20131213,14130,14105,14080,14085,14040,14070,14055,-35,-50,968,"6,802.96",6676
,20131216,14070,14055,14105,14170,14090,14170,14115,115,60,846,"5,971.45",6832
,20131217,14170,14115,14220,14370,14200,14350,14270,235,155,1884,"13,443.65",6818
,20131218,14350,14270,14340,14410,14205,14280,14310,10,40,2566,"18,361.50",7508
,20131219,14280,14310,14305,14360,14140,14230,14200,-80,-110,1888,"13,404.83",7934
,20131220,14230,14200,14250,14350,14165,14330,14280,130,80,2738,"19,554.83",8154
,20131223,14330,14280,14500,14500,14270,14330,14390,50,110,6016,"43,290.87",8352
,20131224,14330,14390,14360,14375,14225,14345,14310,-45,-80,3020,"21,612.34",7886
,20131225,14345,14310,14355,14520,14230,14400,14395,90,85,3690,"26,566.41",7958
,20131226,14400,14395,14415,14490,14285,14310,14390,-85,-5,2230,"16,047.00",7680
,20131227,14310,14390,14285,14335,14230,14330,14300,-60,-90,1798,"12,859.36",7844
,20131230,14330,14300,14355,14480,14335,14360,14385,60,85,1416,"10,185.27",7722
,20131231,14360,14385,14340,14350,14250,14275,14300,-110,-85,724,"5,178.08",7550
pb1403,20130318,14830,14830,,,,14605,14605,-225,-225,0,0,0
,20130319,14605,14605,,,,15150,15150,545,545,0,0,0
,20130320,15150,15150,,,,15825,15825,675,675,0,0,0
,20130321,15825,15825,,,,15895,15895,70,70,0,0,0
,20130322,15895,15895,,,,15810,15810,-85,-85,0,0,0
,20130325,15810,15810,,,,15875,15875,65,65,0,0,0
,20130326,15875,15875,,,,15850,15850,-25,-25,0,0,0
,20130327,15850,15850,,,,15785,15785,-65,-65,0,0,0
,20130328,15785,15785,,,,15735,15735,-50,-50,0,0,0
,20130329,15735,15735,,,,15660,15660,-75,-75,0,0,0
,20130401,15660,15660,,,,15420,15420,-240,-240,0,0,0
,20130402,15420,15420,,,,15410,15410,-10,-10,0,0,0
,20130403,15410,15410,,,,15335,15335,-75,-75,0,0,0
,20130408,15335,15335,,,,15525,15525,190,190,0,0,0
,20130409,15525,15525,,,,15470,15470,-55,-55,0,0,0
,20130410,15470,15470,,,,15540,15540,70,70,0,0,0
,20130411,15540,15540,,,,14970,14970,-570,-570,0,0,0
,20130412,14970,14970,,,,14915,14915,-55,-55,0,0,0
,20130415,14915,14915,,,,14765,14765,-150,-150,0,0,0
,20130416,14765,14765,,,,14615,14615,-150,-150,0,0,0
,20130417,14615,14615,,,,14630,14630,15,15,0,0,0
,20130418,14630,14630,,,,14250,14250,-380,-380,0,0,0
,20130419,14250,14250,,,,14185,14185,-65,-65,0,0,0
,20130422,14185,14185,,,,14175,14175,-10,-10,0,0,0
,20130423,14175,14175,,,,14085,14085,-90,-90,0,0,0
,20130424,14085,14085,,,,14170,14170,85,85,0,0,0
,20130425,14170,14170,,,,14400,14400,230,230,0,0,0
,20130426,14400,14400,14400,14900,14280,14750,14645,350,245,30,"1,098.48",0
,20130502,14750,14645,,,,14645,14645,0,0,0,0,0
,20130503,14645,14645,,,,14655,14655,10,10,0,0,0
,20130506,14655,14655,,,,14755,14755,100,100,0,0,0
,20130507,14755,14755,,,,14720,14720,-35,-35,0,0,0
,20130508,14720,14720,,,,14740,14740,20,20,0,0,0
,20130509,14740,14740,,,,14715,14715,-25,-25,0,0,0
,20130510,14715,14715,,,,14725,14725,10,10,0,0,0
,20130513,14725,14725,,,,14685,14685,-40,-40,0,0,0
,20130514,14685,14685,,,,14615,14615,-70,-70,0,0,0
,20130515,14615,14615,,,,14555,14555,-60,-60,0,0,0
,20130516,14555,14555,,,,14545,14545,-10,-10,0,0,0
,20130517,14545,14545,,,,14505,14505,-40,-40,0,0,0
,20130520,14505,14505,,,,14345,14345,-160,-160,0,0,0
,20130521,14345,14345,,,,14410,14410,65,65,0,0,0
,20130522,14410,14410,,,,14360,14360,-50,-50,0,0,0
,20130523,14360,14360,,,,14370,14370,10,10,0,0,0
,20130524,14370,14370,,,,14375,14375,5,5,0,0,0
,20130527,14375,14375,,,,14390,14390,15,15,0,0,0
,20130528,14390,14390,,,,14365,14365,-25,-25,0,0,0
,20130529,14365,14365,,,,14395,14395,30,30,0,0,0
,20130530,14395,14395,,,,14400,14400,5,5,0,0,0
,20130531,14400,14400,,,,14660,14660,260,260,0,0,0
,20130603,14660,14660,,,,14765,14765,105,105,0,0,0
,20130604,14765,14765,,,,14795,14795,30,30,0,0,0
,20130605,14795,14795,,,,14940,14940,145,145,0,0,0
,20130606,14940,14940,,,,14895,14895,-45,-45,0,0,0
,20130607,14895,14895,,,,14865,14865,-30,-30,0,0,0
,20130613,14865,14865,,,,14705,14705,-160,-160,0,0,0
,20130614,14705,14705,,,,14635,14635,-70,-70,0,0,0
,20130617,14635,14635,,,,14730,14730,95,95,0,0,0
,20130618,14730,14730,,,,14745,14745,15,15,0,0,0
,20130619,14745,14745,,,,14720,14720,-25,-25,0,0,0
,20130620,14720,14720,,,,14625,14625,-95,-95,0,0,0
,20130621,14625,14625,,,,14465,14465,-160,-160,0,0,0
,20130624,14465,14465,,,,14435,14435,-30,-30,0,0,0
,20130625,14435,14435,,,,14875,14875,440,440,0,0,0
,20130626,14875,14875,,,,14890,14890,15,15,0,0,0
,20130627,14890,14890,,,,14920,14920,30,30,0,0,0
,20130628,14920,14920,,,,14895,14895,-25,-25,0,0,0
,20130701,14895,14895,,,,15010,15010,115,115,0,0,0
,20130702,15010,15010,,,,15055,15055,45,45,0,0,0
,20130703,15055,15055,,,,14940,14940,-115,-115,0,0,0
,20130704,14940,14940,,,,14855,14855,-85,-85,0,0,0
,20130705,14855,14855,,,,14890,14890,35,35,0,0,0
,20130708,14890,14890,,,,14910,14910,20,20,0,0,0
,20130709,14910,14910,,,,14910,14910,0,0,0,0,0
,20130710,14910,14910,,,,14840,14840,-70,-70,0,0,0
,20130711,14840,14840,,,,14860,14860,20,20,0,0,0
,20130712,14860,14860,,,,14355,14355,-505,-505,0,0,0
,20130715,14355,14355,,,,14375,14375,20,20,0,0,0
,20130716,14375,14375,,,,14355,14355,-20,-20,0,0,0
,20130717,14355,14355,,,,14400,14400,45,45,0,0,0
,20130718,14400,14400,,,,14370,14370,-30,-30,0,0,0
,20130719,14370,14370,14390,14390,14390,14390,14390,20,20,2,71.95,2
,20130722,14390,14390,,,,14390,14390,0,0,0,0,2
,20130723,14390,14390,,,,14390,14390,0,0,0,0,2
,20130724,14390,14390,,,,14390,14390,0,0,0,0,2
,20130725,14390,14390,,,,14390,14390,0,0,0,0,2
,20130726,14390,14390,,,,14390,14390,0,0,0,0,2
,20130729,14390,14390,,,,14390,14390,0,0,0,0,2
,20130730,14390,14390,,,,14385,14385,-5,-5,0,0,2
,20130731,14385,14385,,,,14365,14365,-20,-20,0,0,2
,20130801,14365,14365,,,,14365,14365,0,0,0,0,2
,20130802,14365,14365,14385,14385,14385,14385,14385,20,20,2,71.93,4
,20130805,14385,14385,,,,14385,14385,0,0,0,0,4
,20130806,14385,14385,,,,14385,14385,0,0,0,0,4
,20130807,14385,14385,,,,14385,14385,0,0,0,0,4
,20130808,14385,14385,,,,14415,14415,30,30,0,0,4
,20130809,14415,14415,14580,14580,14580,14580,14580,165,165,2,72.9,4
,20130812,14580,14580,,,,14750,14750,170,170,0,0,4
,20130813,14750,14750,,,,14700,14700,-50,-50,0,0,4
,20130814,14700,14700,,,,14665,14665,-35,-35,0,0,4
,20130815,14665,14665,,,,14820,14820,155,155,0,0,4
,20130816,14820,14820,,,,14965,14965,145,145,0,0,4
,20130819,14965,14965,,,,15080,15080,115,115,0,0,4
,20130820,15080,15080,,,,15080,15080,0,0,0,0,4
,20130821,15080,15080,,,,15050,15050,-30,-30,0,0,4
,20130822,15050,15050,,,,15135,15135,85,85,0,0,4
,20130823,15135,15135,,,,15090,15090,-45,-45,0,0,4
,20130826,15090,15090,,,,15090,15090,0,0,0,0,4
,20130827,15090,15090,,,,15010,15010,-80,-80,0,0,4
,20130828,15010,15010,,,,15010,15010,0,0,0,0,4
,20130829,15010,15010,,,,14990,14990,-20,-20,0,0,4
,20130830,14990,14990,,,,14945,14945,-45,-45,0,0,4
,20130902,14945,14945,,,,14945,14945,0,0,0,0,20
,20130903,14945,14945,,,,14830,14830,-115,-115,0,0,20
,20130904,14830,14830,,,,14700,14700,-130,-130,0,0,20
,20130905,14700,14700,,,,14685,14685,-15,-15,0,0,20
,20130906,14685,14685,,,,14630,14630,-55,-55,0,0,20
,20130909,14630,14630,,,,14630,14630,0,0,0,0,20
,20130910,14630,14630,,,,14630,14630,0,0,0,0,20
,20130911,14630,14630,,,,14630,14630,0,0,0,0,20
,20130912,14630,14630,,,,14545,14545,-85,-85,0,0,20
,20130913,14545,14545,,,,14500,14500,-45,-45,0,0,20
,20130916,14500,14500,,,,14350,14350,-150,-150,0,0,20
,20130917,14350,14350,,,,14185,14185,-165,-165,0,0,20
,20130918,14185,14185,,,,14185,14185,0,0,0,0,20
,20130923,14185,14185,,,,14185,14185,0,0,0,0,20
,20130924,14185,14185,,,,14185,14185,0,0,0,0,20
,20130925,14185,14185,,,,14185,14185,0,0,0,0,20
,20130926,14185,14185,,,,14185,14185,0,0,0,0,20
,20130927,14185,14185,,,,14185,14185,0,0,0,0,20
,20130930,14185,14185,,,,14185,14185,0,0,0,0,20
,20131008,14185,14185,,,,14185,14185,0,0,0,0,20
,20131009,14185,14185,,,,14185,14185,0,0,0,0,20
,20131010,14185,14185,,,,14190,14190,5,5,0,0,20
,20131011,14190,14190,,,,14250,14250,60,60,0,0,20
,20131014,14250,14250,,,,14235,14235,-15,-15,0,0,20
,20131015,14235,14235,,,,14315,14315,80,80,0,0,20
,20131016,14315,14315,14305,14305,14305,14305,14305,-10,-10,20,143.05,40
,20131017,14305,14305,14465,14465,14465,14465,14465,160,160,20,144.65,20
,20131018,14465,14465,14500,14500,14500,14500,14500,35,35,10,72.5,30
,20131021,14500,14500,14520,14595,14520,14580,14575,80,75,22,160.36,22
,20131022,14580,14575,14600,14695,14585,14600,14615,25,40,54,394.61,50
,20131023,14600,14615,14600,14600,14600,14600,14600,-15,-15,2,14.6,52
,20131024,14600,14600,,,,14550,14550,-50,-50,0,0,52
,20131025,14550,14550,,,,14490,14490,-60,-60,0,0,52
,20131028,14490,14490,,,,14490,14490,0,0,0,0,52
,20131029,14490,14490,,,,14495,14495,5,5,0,0,52
,20131030,14495,14495,,,,14505,14505,10,10,0,0,52
,20131031,14505,14505,,,,14425,14425,-80,-80,0,0,52
,20131101,14425,14425,,,,14500,14500,75,75,0,0,52
,20131104,14500,14500,14350,14500,14350,14500,14355,0,-145,34,244.1,52
,20131105,14500,14355,,,,14435,14435,80,80,0,0,52
,20131106,14435,14435,,,,14435,14435,0,0,0,0,52
,20131107,14435,14435,,,,14430,14430,-5,-5,0,0,52
,20131108,14430,14430,,,,14430,14430,0,0,0,0,52
,20131111,14430,14430,,,,14435,14435,5,5,0,0,52
,20131112,14435,14435,,,,14310,14310,-125,-125,0,0,52
,20131113,14310,14310,14245,14245,14245,14245,14245,-65,-65,12,85.47,50
,20131114,14245,14245,,,,14285,14285,40,40,0,0,50
,20131115,14285,14285,14165,14165,14165,14165,14165,-120,-120,2,14.17,48
,20131118,14165,14165,14155,14175,14135,14135,14150,-30,-15,154,"1,089.62",102
,20131119,14135,14150,14080,14085,14040,14040,14065,-110,-85,44,309.49,124
,20131120,14040,14065,14120,14130,14080,14090,14100,25,35,192,"1,353.88",208
,20131121,14090,14100,14110,14110,14020,14080,14070,-20,-30,276,"1,941.87",318
,20131122,14080,14070,14135,14135,14050,14070,14070,0,0,160,"1,125.93",346
,20131125,14070,14070,14090,14105,14065,14070,14080,0,10,206,"1,450.51",424
,20131126,14070,14080,14125,14130,14070,14120,14090,40,10,110,774.98,466
,20131127,14120,14090,14100,14100,14065,14065,14075,-25,-15,100,703.85,520
,20131128,14065,14075,14035,14060,14035,14060,14045,-15,-30,138,969.43,614
,20131129,14060,14045,14045,14085,14020,14020,14030,-25,-15,166,"1,164.62",688
,20131202,14020,14030,14050,14060,14040,14040,14045,10,15,32,224.72,714
,20131203,14040,14045,13970,14000,13970,13985,13975,-60,-70,154,"1,076.21",800
,20131204,13985,13975,,,,13980,13980,5,5,0,0,800
,20131205,13980,13980,14030,14040,14010,14035,14020,55,40,256,"1,794.88",896
,20131206,14035,14020,14020,14020,14000,14020,14005,0,-15,82,574.23,930
,20131209,14020,14005,14060,14060,14035,14050,14045,45,40,192,"1,348.43",1006
,20131210,14050,14045,14105,14120,14080,14110,14095,65,50,404,"2,847.87",1270
,20131211,14110,14095,14150,14150,14090,14105,14110,10,15,306,"2,158.84",1424
,20131212,14105,14110,14150,14180,14130,14165,14150,55,40,248,"1,754.63",1490
,20131213,14165,14150,14110,14120,14100,14105,14100,-45,-50,90,634.68,1540
,20131216,14105,14100,14115,14175,14115,14170,14140,70,40,152,"1,074.83",1644
,20131217,14170,14140,14255,14410,14240,14390,14295,250,155,850,"6,076.65",2114
,20131218,14390,14295,14360,14450,14255,14310,14330,15,35,1306,"9,360.15",2724
,20131219,14310,14330,14360,14360,14175,14225,14220,-105,-110,1478,"10,512.03",3108
,20131220,14225,14220,14260,14380,14235,14355,14315,135,95,1236,"8,849.29",3430
,20131223,14355,14315,14450,14500,14320,14350,14420,35,105,1602,"11,552.51",3642
,20131224,14350,14420,14420,14435,14215,14370,14350,-50,-70,1058,"7,591.21",3704
,20131225,14370,14350,14385,14500,14360,14450,14440,100,90,2742,"19,803.80",4464
,20131226,14450,14440,14460,14535,14340,14350,14430,-90,-10,1476,"10,652.72",4536
,20131227,14350,14430,14350,14390,14300,14380,14350,-50,-80,992,"7,119.55",4814
,20131230,14380,14350,14415,14500,14385,14420,14435,70,85,2210,"15,955.57",5280
,20131231,14420,14435,14380,14410,14300,14315,14355,-120,-80,2142,"15,378.65",5394
pb1404,20130416,14765,14765,,,,14615,14615,-150,-150,0,0,0
,20130417,14615,14615,,,,14630,14630,15,15,0,0,0
,20130418,14630,14630,,,,14250,14250,-380,-380,0,0,0
,20130419,14250,14250,,,,14185,14185,-65,-65,0,0,0
,20130422,14185,14185,,,,14175,14175,-10,-10,0,0,0
,20130423,14175,14175,,,,14085,14085,-90,-90,0,0,0
,20130424,14085,14085,,,,14170,14170,85,85,0,0,0
,20130425,14170,14170,,,,14400,14400,230,230,0,0,0
,20130426,14400,14400,14400,14900,14300,14900,14615,500,215,12,438.5,0
,20130502,14900,14615,,,,14615,14615,0,0,0,0,0
,20130503,14615,14615,,,,14625,14625,10,10,0,0,0
,20130506,14625,14625,,,,14725,14725,100,100,0,0,0
,20130507,14725,14725,,,,14690,14690,-35,-35,0,0,0
,20130508,14690,14690,,,,14710,14710,20,20,0,0,0
,20130509,14710,14710,,,,14685,14685,-25,-25,0,0,0
,20130510,14685,14685,,,,14695,14695,10,10,0,0,0
,20130513,14695,14695,,,,14655,14655,-40,-40,0,0,0
,20130514,14655,14655,,,,14585,14585,-70,-70,0,0,0
,20130515,14585,14585,,,,14525,14525,-60,-60,0,0,0
,20130516,14525,14525,,,,14515,14515,-10,-10,0,0,0
,20130517,14515,14515,,,,14475,14475,-40,-40,0,0,0
,20130520,14475,14475,,,,14315,14315,-160,-160,0,0,0
,20130521,14315,14315,,,,14380,14380,65,65,0,0,0
,20130522,14380,14380,,,,14330,14330,-50,-50,0,0,0
,20130523,14330,14330,,,,14340,14340,10,10,0,0,0
,20130524,14340,14340,,,,14345,14345,5,5,0,0,0
,20130527,14345,14345,,,,14360,14360,15,15,0,0,0
,20130528,14360,14360,,,,14335,14335,-25,-25,0,0,0
,20130529,14335,14335,,,,14365,14365,30,30,0,0,0
,20130530,14365,14365,,,,14370,14370,5,5,0,0,0
,20130531,14370,14370,,,,14630,14630,260,260,0,0,0
,20130603,14630,14630,,,,14735,14735,105,105,0,0,0
,20130604,14735,14735,,,,14765,14765,30,30,0,0,0
,20130605,14765,14765,,,,14910,14910,145,145,0,0,0
,20130606,14910,14910,,,,14865,14865,-45,-45,0,0,0
,20130607,14865,14865,,,,14835,14835,-30,-30,0,0,0
,20130613,14835,14835,,,,14680,14680,-155,-155,0,0,0
,20130614,14680,14680,,,,14610,14610,-70,-70,0,0,0
,20130617,14610,14610,,,,14705,14705,95,95,0,0,0
,20130618,14705,14705,,,,14720,14720,15,15,0,0,0
,20130619,14720,14720,,,,14695,14695,-25,-25,0,0,0
,20130620,14695,14695,,,,14600,14600,-95,-95,0,0,0
,20130621,14600,14600,,,,14440,14440,-160,-160,0,0,0
,20130624,14440,14440,,,,14410,14410,-30,-30,0,0,0
,20130625,14410,14410,,,,14850,14850,440,440,0,0,0
,20130626,14850,14850,,,,14865,14865,15,15,0,0,0
,20130627,14865,14865,,,,14895,14895,30,30,0,0,0
,20130628,14895,14895,,,,14870,14870,-25,-25,0,0,0
,20130701,14870,14870,,,,14985,14985,115,115,0,0,0
,20130702,14985,14985,,,,15030,15030,45,45,0,0,0
,20130703,15030,15030,,,,14915,14915,-115,-115,0,0,0
,20130704,14915,14915,,,,14830,14830,-85,-85,0,0,0
,20130705,14830,14830,,,,14865,14865,35,35,0,0,0
,20130708,14865,14865,,,,14885,14885,20,20,0,0,0
,20130709,14885,14885,,,,14885,14885,0,0,0,0,0
,20130710,14885,14885,,,,14815,14815,-70,-70,0,0,0
,20130711,14815,14815,,,,14835,14835,20,20,0,0,0
,20130712,14835,14835,,,,14335,14335,-500,-500,0,0,0
,20130715,14335,14335,,,,14355,14355,20,20,0,0,0
,20130716,14355,14355,,,,14335,14335,-20,-20,0,0,0
,20130717,14335,14335,,,,14355,14355,20,20,0,0,0
,20130718,14355,14355,,,,14325,14325,-30,-30,0,0,0
,20130719,14325,14325,,,,14340,14340,15,15,0,0,0
,20130722,14340,14340,,,,14350,14350,10,10,0,0,0
,20130723,14350,14350,,,,14365,14365,15,15,0,0,0
,20130724,14365,14365,,,,14430,14430,65,65,0,0,0
,20130725,14430,14430,,,,14430,14430,0,0,0,0,0
,20130726,14430,14430,,,,14430,14430,0,0,0,0,0
,20130729,14430,14430,,,,14350,14350,-80,-80,0,0,0
,20130730,14350,14350,,,,14345,14345,-5,-5,0,0,0
,20130731,14345,14345,,,,14315,14315,-30,-30,0,0,0
,20130801,14315,14315,,,,14400,14400,85,85,0,0,0
,20130802,14400,14400,,,,14420,14420,20,20,0,0,0
,20130805,14420,14420,,,,14455,14455,35,35,0,0,0
,20130806,14455,14455,,,,14475,14475,20,20,0,0,0
,20130807,14475,14475,,,,14485,14485,10,10,0,0,0
,20130808,14485,14485,,,,14515,14515,30,30,0,0,0
,20130809,14515,14515,,,,14680,14680,165,165,0,0,0
,20130812,14680,14680,,,,14850,14850,170,170,0,0,0
,20130813,14850,14850,,,,14800,14800,-50,-50,0,0,0
,20130814,14800,14800,,,,14765,14765,-35,-35,0,0,0
,20130815,14765,14765,,,,15000,15000,235,235,0,0,0
,20130816,15000,15000,,,,15145,15145,145,145,0,0,0
,20130819,15145,15145,,,,15220,15220,75,75,0,0,0
,20130820,15220,15220,,,,15110,15110,-110,-110,0,0,0
,20130821,15110,15110,,,,15040,15040,-70,-70,0,0,0
,20130822,15040,15040,,,,15120,15120,80,80,0,0,0
,20130823,15120,15120,,,,15075,15075,-45,-45,0,0,0
,20130826,15075,15075,,,,15165,15165,90,90,0,0,0
,20130827,15165,15165,,,,15085,15085,-80,-80,0,0,0
,20130828,15085,15085,,,,14945,14945,-140,-140,0,0,0
,20130829,14945,14945,,,,15015,15015,70,70,0,0,0
,20130830,15015,15015,,,,15015,15015,0,0,0,0,0
,20130902,15015,15015,,,,14985,14985,-30,-30,0,0,0
,20130903,14985,14985,,,,14860,14860,-125,-125,0,0,0
,20130904,14860,14860,,,,14735,14735,-125,-125,0,0,0
,20130905,14735,14735,,,,14655,14655,-80,-80,0,0,0
,20130906,14655,14655,,,,14605,14605,-50,-50,0,0,0
,20130909,14605,14605,,,,14710,14710,105,105,0,0,0
,20130910,14710,14710,,,,14630,14630,-80,-80,0,0,0
,20130911,14630,14630,,,,14600,14600,-30,-30,0,0,0
,20130912,14600,14600,,,,14435,14435,-165,-165,0,0,0
,20130913,14435,14435,,,,14395,14395,-40,-40,0,0,0
,20130916,14395,14395,,,,14280,14280,-115,-115,0,0,0
,20130917,14280,14280,,,,14100,14100,-180,-180,0,0,0
,20130918,14100,14100,,,,14100,14100,0,0,0,0,0
,20130923,14100,14100,,,,14195,14195,95,95,0,0,0
,20130924,14195,14195,,,,14245,14245,50,50,0,0,0
,20130925,14245,14245,,,,14245,14245,0,0,0,0,0
,20130926,14245,14245,,,,14230,14230,-15,-15,0,0,0
,20130927,14230,14230,,,,14230,14230,0,0,0,0,0
,20130930,14230,14230,,,,14265,14265,35,35,0,0,0
,20131008,14265,14265,,,,14210,14210,-55,-55,0,0,0
,20131009,14210,14210,,,,14200,14200,-10,-10,0,0,0
,20131010,14200,14200,,,,14205,14205,5,5,0,0,0
,20131011,14205,14205,,,,14305,14305,100,100,0,0,0
,20131014,14305,14305,,,,14290,14290,-15,-15,0,0,0
,20131015,14290,14290,,,,14315,14315,25,25,0,0,0
,20131016,14315,14315,,,,14305,14305,-10,-10,0,0,0
,20131017,14305,14305,,,,14465,14465,160,160,0,0,0
,20131018,14465,14465,,,,14500,14500,35,35,0,0,0
,20131021,14500,14500,,,,14590,14590,90,90,0,0,0
,20131022,14590,14590,,,,14590,14590,0,0,0,0,0
,20131023,14590,14590,,,,14590,14590,0,0,0,0,0
,20131024,14590,14590,,,,14590,14590,0,0,0,0,0
,20131025,14590,14590,,,,14615,14615,25,25,0,0,0
,20131028,14615,14615,,,,14630,14630,15,15,0,0,0
,20131029,14630,14630,,,,14635,14635,5,5,0,0,0
,20131030,14635,14635,,,,14645,14645,10,10,0,0,0
,20131031,14645,14645,,,,14560,14560,-85,-85,0,0,0
,20131101,14560,14560,,,,14600,14600,40,40,0,0,0
,20131104,14600,14600,14600,14600,14525,14525,14560,-75,-40,4,29.13,0
,20131105,14525,14560,,,,14505,14505,-55,-55,0,0,0
,20131106,14505,14505,,,,14510,14510,5,5,0,0,0
,20131107,14510,14510,,,,14505,14505,-5,-5,0,0,0
,20131108,14505,14505,,,,14435,14435,-70,-70,0,0,0
,20131111,14435,14435,,,,14435,14435,0,0,0,0,0
,20131112,14435,14435,,,,14310,14310,-125,-125,0,0,0
,20131113,14310,14310,14310,14310,14130,14130,14220,-180,-90,4,28.44,2
,20131114,14130,14220,,,,14220,14220,0,0,0,0,2
,20131115,14220,14220,,,,14220,14220,0,0,0,0,2
,20131118,14220,14220,,,,14220,14220,0,0,0,0,2
,20131119,14220,14220,,,,14150,14150,-70,-70,0,0,2
,20131120,14150,14150,,,,14150,14150,0,0,0,0,2
,20131121,14150,14150,,,,14150,14150,0,0,0,0,2
,20131122,14150,14150,14105,14105,14105,14105,14105,-45,-45,2,14.11,2
,20131125,14105,14105,,,,14105,14105,0,0,0,0,2
,20131126,14105,14105,,,,14115,14115,10,10,0,0,2
,20131127,14115,14115,14080,14160,14080,14160,14100,45,-15,106,747.56,44
,20131128,14160,14100,14100,14160,14080,14080,14110,-20,10,88,620.97,58
,20131129,14080,14110,13890,14145,13890,14060,14040,-50,-70,26,182.53,56
,20131202,14060,14040,14015,14090,14015,14050,14045,10,5,116,814.85,124
,20131203,14050,14045,13990,14000,13980,14000,13985,-45,-60,190,"1,328.76",256
,20131204,14000,13985,14050,14050,14000,14000,14020,15,35,154,"1,079.63",330
,20131205,14000,14020,14030,14130,14030,14035,14050,15,30,140,983.53,398
,20131206,14035,14050,14020,14060,14020,14055,14040,5,-10,200,"1,404.09",510
,20131209,14055,14040,14110,14115,14055,14100,14085,60,45,352,"2,479.28",658
,20131210,14100,14085,14140,14180,14130,14150,14140,65,55,532,"3,762.08",1096
,20131211,14150,14140,14245,14245,14140,14145,14155,5,15,1084,"7,672.93",1922
,20131212,14145,14155,14230,14245,14180,14245,14195,90,40,636,"4,515.58",2382
,20131213,14245,14195,14185,14230,14145,14165,14160,-30,-35,946,"6,699.57",2964
,20131216,14165,14160,14260,14260,14190,14220,14205,60,45,540,"3,835.67",3292
,20131217,14220,14205,14280,14480,14280,14445,14370,240,165,1008,"7,243.99",3780
,20131218,14445,14370,14450,14500,14310,14360,14375,-10,5,1104,"7,937.63",4058
,20131219,14360,14375,14380,14380,14220,14290,14250,-85,-125,918,"6,542.11",4312
,20131220,14290,14250,14300,14425,14270,14395,14365,145,115,1528,"10,975.81",4548
,20131223,14395,14365,14455,14580,14350,14365,14425,0,60,764,"5,511.28",4648
,20131224,14365,14425,14425,14440,14285,14400,14380,-25,-45,1996,"14,354.90",4836
,20131225,14400,14380,14420,14530,14390,14500,14475,120,95,1856,"13,432.86",5406
,20131226,14500,14475,14545,14560,14370,14370,14490,-105,15,870,"6,303.73",5088
,20131227,14370,14490,14395,14435,14340,14435,14400,-55,-90,768,"5,531.31",5298
,20131230,14435,14400,14495,14565,14430,14465,14485,65,85,994,"7,201.22",5450
,20131231,14465,14485,14390,14430,14335,14355,14390,-130,-95,512,"3,684.49",5462
pb1405,20130516,14525,14525,,,,14515,14515,-10,-10,0,0,0
,20130517,14515,14515,,,,14515,14515,0,0,0,0,0
,20130520,14515,14515,,,,14355,14355,-160,-160,0,0,0
,20130521,14355,14355,,,,14420,14420,65,65,0,0,0
,20130522,14420,14420,,,,14370,14370,-50,-50,0,0,0
,20130523,14370,14370,,,,14380,14380,10,10,0,0,0
,20130524,14380,14380,,,,14385,14385,5,5,0,0,0
,20130527,14385,14385,,,,14400,14400,15,15,0,0,0
,20130528,14400,14400,,,,14375,14375,-25,-25,0,0,0
,20130529,14375,14375,,,,14405,14405,30,30,0,0,0
,20130530,14405,14405,,,,14410,14410,5,5,0,0,0
,20130531,14410,14410,,,,14670,14670,260,260,0,0,0
,20130603,14670,14670,,,,14775,14775,105,105,0,0,0
,20130604,14775,14775,,,,14805,14805,30,30,0,0,0
,20130605,14805,14805,,,,14950,14950,145,145,0,0,0
,20130606,14950,14950,14480,15330,14480,15330,14905,380,-45,4,149.05,0
,20130607,15330,14905,,,,14905,14905,0,0,0,0,0
,20130613,14905,14905,,,,14745,14745,-160,-160,0,0,0
,20130614,14745,14745,,,,14745,14745,0,0,0,0,0
,20130617,14745,14745,,,,14840,14840,95,95,0,0,0
,20130618,14840,14840,,,,14855,14855,15,15,0,0,0
,20130619,14855,14855,,,,14830,14830,-25,-25,0,0,0
,20130620,14830,14830,,,,14735,14735,-95,-95,0,0,0
,20130621,14735,14735,,,,14570,14570,-165,-165,0,0,0
,20130624,14570,14570,,,,14540,14540,-30,-30,0,0,0
,20130625,14540,14540,,,,14985,14985,445,445,0,0,0
,20130626,14985,14985,,,,15000,15000,15,15,0,0,0
,20130627,15000,15000,,,,15030,15030,30,30,0,0,0
,20130628,15030,15030,,,,15005,15005,-25,-25,0,0,0
,20130701,15005,15005,,,,15120,15120,115,115,0,0,0
,20130702,15120,15120,,,,15165,15165,45,45,0,0,0
,20130703,15165,15165,,,,15050,15050,-115,-115,0,0,0
,20130704,15050,15050,,,,14965,14965,-85,-85,0,0,0
,20130705,14965,14965,,,,15000,15000,35,35,0,0,0
,20130708,15000,15000,,,,15020,15020,20,20,0,0,0
,20130709,15020,15020,,,,15020,15020,0,0,0,0,0
,20130710,15020,15020,,,,14950,14950,-70,-70,0,0,0
,20130711,14950,14950,,,,14970,14970,20,20,0,0,0
,20130712,14970,14970,,,,14465,14465,-505,-505,0,0,0
,20130715,14465,14465,,,,14485,14485,20,20,0,0,0
,20130716,14485,14485,,,,14465,14465,-20,-20,0,0,0
,20130717,14465,14465,,,,14485,14485,20,20,0,0,0
,20130718,14485,14485,,,,14455,14455,-30,-30,0,0,0
,20130719,14455,14455,,,,14475,14475,20,20,0,0,0
,20130722,14475,14475,,,,14485,14485,10,10,0,0,0
,20130723,14485,14485,,,,14500,14500,15,15,0,0,0
,20130724,14500,14500,,,,14565,14565,65,65,0,0,0
,20130725,14565,14565,,,,14565,14565,0,0,0,0,0
,20130726,14565,14565,,,,14565,14565,0,0,0,0,0
,20130729,14565,14565,,,,14485,14485,-80,-80,0,0,0
,20130730,14485,14485,,,,14480,14480,-5,-5,0,0,0
,20130731,14480,14480,,,,14450,14450,-30,-30,0,0,0
,20130801,14450,14450,,,,14535,14535,85,85,0,0,0
,20130802,14535,14535,,,,14555,14555,20,20,0,0,0
,20130805,14555,14555,,,,14590,14590,35,35,0,0,0
,20130806,14590,14590,,,,14610,14610,20,20,0,0,0
,20130807,14610,14610,,,,14620,14620,10,10,0,0,0
,20130808,14620,14620,,,,14650,14650,30,30,0,0,0
,20130809,14650,14650,,,,14815,14815,165,165,0,0,0
,20130812,14815,14815,,,,14985,14985,170,170,0,0,0
,20130813,14985,14985,,,,14935,14935,-50,-50,0,0,0
,20130814,14935,14935,,,,14900,14900,-35,-35,0,0,0
,20130815,14900,14900,,,,15135,15135,235,235,0,0,0
,20130816,15135,15135,,,,15280,15280,145,145,0,0,0
,20130819,15280,15280,,,,15355,15355,75,75,0,0,0
,20130820,15355,15355,,,,15245,15245,-110,-110,0,0,0
,20130821,15245,15245,,,,15175,15175,-70,-70,0,0,0
,20130822,15175,15175,,,,15260,15260,85,85,0,0,0
,20130823,15260,15260,,,,15215,15215,-45,-45,0,0,0
,20130826,15215,15215,,,,15305,15305,90,90,0,0,0
,20130827,15305,15305,,,,15225,15225,-80,-80,0,0,0
,20130828,15225,15225,,,,15085,15085,-140,-140,0,0,0
,20130829,15085,15085,,,,15155,15155,70,70,0,0,0
,20130830,15155,15155,,,,15155,15155,0,0,0,0,0
,20130902,15155,15155,,,,15125,15125,-30,-30,0,0,0
,20130903,15125,15125,,,,15000,15000,-125,-125,0,0,0
,20130904,15000,15000,,,,14875,14875,-125,-125,0,0,0
,20130905,14875,14875,,,,14795,14795,-80,-80,0,0,0
,20130906,14795,14795,,,,14745,14745,-50,-50,0,0,0
,20130909,14745,14745,,,,14850,14850,105,105,0,0,0
,20130910,14850,14850,,,,14770,14770,-80,-80,0,0,0
,20130911,14770,14770,,,,14740,14740,-30,-30,0,0,0
,20130912,14740,14740,,,,14575,14575,-165,-165,0,0,0
,20130913,14575,14575,,,,14535,14535,-40,-40,0,0,0
,20130916,14535,14535,,,,14420,14420,-115,-115,0,0,0
,20130917,14420,14420,,,,14240,14240,-180,-180,0,0,0
,20130918,14240,14240,,,,14240,14240,0,0,0,0,0
,20130923,14240,14240,,,,14335,14335,95,95,0,0,0
,20130924,14335,14335,,,,14385,14385,50,50,0,0,0
,20130925,14385,14385,,,,14385,14385,0,0,0,0,0
,20130926,14385,14385,,,,14370,14370,-15,-15,0,0,0
,20130927,14370,14370,,,,14370,14370,0,0,0,0,0
,20130930,14370,14370,,,,14405,14405,35,35,0,0,0
,20131008,14405,14405,,,,14350,14350,-55,-55,0,0,0
,20131009,14350,14350,,,,14340,14340,-10,-10,0,0,0
,20131010,14340,14340,,,,14345,14345,5,5,0,0,0
,20131011,14345,14345,,,,14345,14345,0,0,0,0,0
,20131014,14345,14345,,,,14330,14330,-15,-15,0,0,0
,20131015,14330,14330,,,,14355,14355,25,25,0,0,0
,20131016,14355,14355,,,,14340,14340,-15,-15,0,0,0
,20131017,14340,14340,,,,14500,14500,160,160,0,0,0
,20131018,14500,14500,,,,14535,14535,35,35,0,0,0
,20131021,14535,14535,14785,14785,14625,14635,14670,100,135,16,117.36,14
,20131022,14635,14670,,,,14670,14670,0,0,0,0,14
,20131023,14670,14670,14800,14825,14735,14735,14780,65,110,24,177.41,20
,20131024,14735,14780,14585,14785,14500,14585,14605,-195,-175,64,467.45,18
,20131025,14585,14605,14590,14590,14545,14545,14565,-60,-40,4,29.14,18
,20131028,14545,14565,14660,14660,14660,14660,14660,95,95,2,14.66,18
,20131029,14660,14660,,,,14660,14660,0,0,0,0,18
,20131030,14660,14660,,,,14670,14670,10,10,0,0,18
,20131031,14670,14670,,,,14585,14585,-85,-85,0,0,18
,20131101,14585,14585,,,,14625,14625,40,40,0,0,18
,20131104,14625,14625,,,,14585,14585,-40,-40,0,0,18
,20131105,14585,14585,,,,14530,14530,-55,-55,0,0,18
,20131106,14530,14530,,,,14535,14535,5,5,0,0,18
,20131107,14535,14535,,,,14530,14530,-5,-5,0,0,18
,20131108,14530,14530,14460,14460,14460,14460,14460,-70,-70,10,72.3,26
,20131111,14460,14460,14635,14635,14410,14410,14535,-50,75,18,130.82,26
,20131112,14410,14535,14485,14485,14485,14485,14485,-50,-50,8,57.94,26
,20131113,14485,14485,,,,14360,14360,-125,-125,0,0,26
,20131114,14360,14360,,,,14400,14400,40,40,0,0,26
,20131115,14400,14400,14205,14205,14205,14205,14205,-195,-195,2,14.21,28
,20131118,14205,14205,14400,14400,14230,14270,14310,65,105,24,171.77,12
,20131119,14270,14310,,,,14215,14215,-95,-95,0,0,12
,20131120,14215,14215,,,,14215,14215,0,0,0,0,12
,20131121,14215,14215,,,,14215,14215,0,0,0,0,12
,20131122,14215,14215,14120,14120,14120,14120,14120,-95,-95,2,14.12,12
,20131125,14120,14120,,,,14135,14135,15,15,0,0,12
,20131126,14135,14135,,,,14145,14145,10,10,0,0,12
,20131127,14145,14145,,,,14145,14145,0,0,0,0,12
,20131128,14145,14145,14180,14180,14175,14175,14175,30,30,8,56.71,4
,20131129,14175,14175,,,,14175,14175,0,0,0,0,4
,20131202,14175,14175,14015,14170,14015,14170,14080,-5,-95,12,84.51,6
,20131203,14170,14080,14075,14075,14075,14075,14075,-5,-5,2,14.08,4
,20131204,14075,14075,,,,14075,14075,0,0,0,0,4
,20131205,14075,14075,14145,14150,14100,14150,14125,75,50,10,70.63,8
,20131206,14150,14125,,,,14125,14125,0,0,0,0,8
,20131209,14125,14125,,,,14125,14125,0,0,0,0,8
,20131210,14125,14125,14250,14250,14245,14245,14245,120,120,6,42.75,12
,20131211,14245,14245,14190,14235,14190,14235,14220,-10,-25,6,42.66,14
,20131212,14235,14220,14300,14310,14245,14310,14270,90,50,58,413.94,52
,20131213,14310,14270,14235,14240,14215,14220,14225,-50,-45,42,298.76,80
,20131216,14220,14225,14280,14280,14235,14265,14265,40,40,28,199.76,92
,20131217,14265,14265,14370,14390,14370,14390,14380,125,115,8,57.52,90
,20131218,14390,14380,14530,14530,14375,14400,14395,20,15,88,633.52,98
,20131219,14400,14395,14355,14355,14275,14335,14300,-60,-95,44,314.7,114
,20131220,14335,14300,14340,14460,14290,14460,14345,160,45,48,344.29,122
,20131223,14460,14345,14450,14555,14380,14380,14460,35,115,144,"1,041.34",190
,20131224,14380,14460,14525,14525,14330,14370,14390,-90,-70,126,906.8,216
,20131225,14370,14390,14410,14535,14410,14500,14435,110,45,52,375.41,218
,20131226,14500,14435,14530,14565,14390,14390,14515,-45,80,170,"1,234.11",250
,20131227,14390,14515,14405,14460,14405,14455,14445,-60,-70,8,57.78,250
,20131230,14455,14445,14485,14580,14420,14490,14495,45,50,180,"1,304.94",350
,20131231,14490,14495,14445,14445,14355,14400,14395,-95,-100,134,964.61,382
pb1406,20130618,14840,14840,,,,14840,14840,0,0,0,0,0
,20130619,14840,14840,,,,14815,14815,-25,-25,0,0,0
,20130620,14815,14815,,,,14720,14720,-95,-95,0,0,0
,20130621,14720,14720,,,,14555,14555,-165,-165,0,0,0
,20130624,14555,14555,,,,14525,14525,-30,-30,0,0,0
,20130625,14525,14525,,,,14970,14970,445,445,0,0,0
,20130626,14970,14970,,,,14985,14985,15,15,0,0,0
,20130627,14985,14985,,,,15015,15015,30,30,0,0,0
,20130628,15015,15015,,,,14990,14990,-25,-25,0,0,0
,20130701,14990,14990,,,,15105,15105,115,115,0,0,0
,20130702,15105,15105,,,,15150,15150,45,45,0,0,0
,20130703,15150,15150,,,,15035,15035,-115,-115,0,0,0
,20130704,15035,15035,,,,14950,14950,-85,-85,0,0,0
,20130705,14950,14950,,,,14985,14985,35,35,0,0,0
,20130708,14985,14985,,,,15005,15005,20,20,0,0,0
,20130709,15005,15005,,,,15005,15005,0,0,0,0,0
,20130710,15005,15005,,,,14935,14935,-70,-70,0,0,0
,20130711,14935,14935,,,,14955,14955,20,20,0,0,0
,20130712,14955,14955,,,,14450,14450,-505,-505,0,0,0
,20130715,14450,14450,,,,14470,14470,20,20,0,0,0
,20130716,14470,14470,,,,14450,14450,-20,-20,0,0,0
,20130717,14450,14450,,,,14470,14470,20,20,0,0,0
,20130718,14470,14470,,,,14440,14440,-30,-30,0,0,0
,20130719,14440,14440,,,,14460,14460,20,20,0,0,0
,20130722,14460,14460,,,,14470,14470,10,10,0,0,0
,20130723,14470,14470,,,,14485,14485,15,15,0,0,0
,20130724,14485,14485,,,,14550,14550,65,65,0,0,0
,20130725,14550,14550,,,,14550,14550,0,0,0,0,0
,20130726,14550,14550,,,,14550,14550,0,0,0,0,0
,20130729,14550,14550,,,,14470,14470,-80,-80,0,0,0
,20130730,14470,14470,,,,14465,14465,-5,-5,0,0,0
,20130731,14465,14465,,,,14435,14435,-30,-30,0,0,0
,20130801,14435,14435,,,,14520,14520,85,85,0,0,0
,20130802,14520,14520,,,,14540,14540,20,20,0,0,0
,20130805,14540,14540,,,,14575,14575,35,35,0,0,0
,20130806,14575,14575,,,,14595,14595,20,20,0,0,0
,20130807,14595,14595,,,,14605,14605,10,10,0,0,0
,20130808,14605,14605,,,,14635,14635,30,30,0,0,0
,20130809,14635,14635,,,,14800,14800,165,165,0,0,0
,20130812,14800,14800,,,,14970,14970,170,170,0,0,0
,20130813,14970,14970,,,,14920,14920,-50,-50,0,0,0
,20130814,14920,14920,,,,14885,14885,-35,-35,0,0,0
,20130815,14885,14885,,,,15120,15120,235,235,0,0,0
,20130816,15120,15120,,,,15265,15265,145,145,0,0,0
,20130819,15265,15265,,,,15340,15340,75,75,0,0,0
,20130820,15340,15340,,,,15230,15230,-110,-110,0,0,0
,20130821,15230,15230,,,,15160,15160,-70,-70,0,0,0
,20130822,15160,15160,,,,15245,15245,85,85,0,0,0
,20130823,15245,15245,,,,15200,15200,-45,-45,0,0,0
,20130826,15200,15200,,,,15290,15290,90,90,0,0,0
,20130827,15290,15290,15430,15430,15430,15430,15430,140,140,2,77.15,2
,20130828,15430,15430,,,,15290,15290,-140,-140,0,0,2
,20130829,15290,15290,15085,15085,15085,15085,15085,-205,-205,2,75.43,2
,20130830,15085,15085,,,,15085,15085,0,0,0,0,2
,20130902,15085,15085,,,,15055,15055,-30,-30,0,0,10
,20130903,15055,15055,,,,15055,15055,0,0,0,0,10
,20130904,15055,15055,,,,14930,14930,-125,-125,0,0,10
,20130905,14930,14930,,,,14850,14850,-80,-80,0,0,10
,20130906,14850,14850,,,,14835,14835,-15,-15,0,0,10
,20130909,14835,14835,,,,14945,14945,110,110,0,0,10
,20130910,14945,14945,,,,14865,14865,-80,-80,0,0,10
,20130911,14865,14865,,,,14835,14835,-30,-30,0,0,10
,20130912,14835,14835,,,,14670,14670,-165,-165,0,0,10
,20130913,14670,14670,,,,14630,14630,-40,-40,0,0,10
,20130916,14630,14630,,,,14515,14515,-115,-115,0,0,10
,20130917,14515,14515,,,,14335,14335,-180,-180,0,0,10
,20130918,14335,14335,,,,14335,14335,0,0,0,0,10
,20130923,14335,14335,,,,14430,14430,95,95,0,0,10
,20130924,14430,14430,,,,14480,14480,50,50,0,0,10
,20130925,14480,14480,,,,14455,14455,-25,-25,0,0,10
,20130926,14455,14455,,,,14440,14440,-15,-15,0,0,10
,20130927,14440,14440,,,,14445,14445,5,5,0,0,10
,20130930,14445,14445,,,,14480,14480,35,35,0,0,10
,20131008,14480,14480,,,,14425,14425,-55,-55,0,0,10
,20131009,14425,14425,,,,14415,14415,-10,-10,0,0,10
,20131010,14415,14415,,,,14420,14420,5,5,0,0,10
,20131011,14420,14420,,,,14525,14525,105,105,0,0,10
,20131014,14525,14525,,,,14510,14510,-15,-15,0,0,10
,20131015,14510,14510,,,,14535,14535,25,25,0,0,10
,20131016,14535,14535,,,,14520,14520,-15,-15,0,0,10
,20131017,14520,14520,,,,14520,14520,0,0,0,0,10
,20131018,14520,14520,,,,14555,14555,35,35,0,0,10
,20131021,14555,14555,14805,14805,14805,14805,14805,250,250,6,44.42,16
,20131022,14805,14805,14660,14785,14660,14785,14690,-20,-115,8,58.77,10
,20131023,14785,14690,,,,14690,14690,0,0,0,0,10
,20131024,14690,14690,,,,14690,14690,0,0,0,0,10
,20131025,14690,14690,,,,14690,14690,0,0,0,0,10
,20131028,14690,14690,,,,14690,14690,0,0,0,0,10
,20131029,14690,14690,,,,14695,14695,5,5,0,0,10
,20131030,14695,14695,,,,14705,14705,10,10,0,0,10
,20131031,14705,14705,,,,14620,14620,-85,-85,0,0,10
,20131101,14620,14620,,,,14620,14620,0,0,0,0,10
,20131104,14620,14620,,,,14620,14620,0,0,0,0,10
,20131105,14620,14620,,,,14620,14620,0,0,0,0,10
,20131106,14620,14620,,,,14625,14625,5,5,0,0,10
,20131107,14625,14625,,,,14620,14620,-5,-5,0,0,10
,20131108,14620,14620,,,,14620,14620,0,0,0,0,10
,20131111,14620,14620,,,,14620,14620,0,0,0,0,10
,20131112,14620,14620,,,,14545,14545,-75,-75,0,0,10
,20131113,14545,14545,,,,14425,14425,-120,-120,0,0,10
,20131114,14425,14425,,,,14410,14410,-15,-15,0,0,10
,20131115,14410,14410,,,,14410,14410,0,0,0,0,10
,20131118,14410,14410,,,,14360,14360,-50,-50,0,0,10
,20131119,14360,14360,,,,14345,14345,-15,-15,0,0,10
,20131120,14345,14345,,,,14345,14345,0,0,0,0,10
,20131121,14345,14345,,,,14315,14315,-30,-30,0,0,10
,20131122,14315,14315,,,,14295,14295,-20,-20,0,0,10
,20131125,14295,14295,,,,14295,14295,0,0,0,0,10
,20131126,14295,14295,,,,14295,14295,0,0,0,0,10
,20131127,14295,14295,,,,14280,14280,-15,-15,0,0,10
,20131128,14280,14280,,,,14280,14280,0,0,0,0,10
,20131129,14280,14280,,,,14280,14280,0,0,0,0,10
,20131202,14280,14280,,,,14280,14280,0,0,0,0,10
,20131203,14280,14280,,,,14230,14230,-50,-50,0,0,10
,20131204,14230,14230,14040,14040,14040,14040,14040,-190,-190,4,28.08,10
,20131205,14040,14040,,,,14120,14120,80,80,0,0,10
,20131206,14120,14120,,,,14120,14120,0,0,0,0,10
,20131209,14120,14120,14200,14245,14200,14245,14220,125,100,4,28.45,14
,20131210,14245,14220,14300,14300,14300,14300,14300,80,80,4,28.6,14
,20131211,14300,14300,,,,14300,14300,0,0,0,0,14
,20131212,14300,14300,,,,14300,14300,0,0,0,0,14
,20131213,14300,14300,,,,14300,14300,0,0,0,0,14
,20131216,14300,14300,,,,14300,14300,0,0,0,0,14
,20131217,14300,14300,,,,14455,14455,155,155,0,0,14
,20131218,14455,14455,,,,14455,14455,0,0,0,0,14
,20131219,14455,14455,,,,14420,14420,-35,-35,0,0,14
,20131220,14420,14420,14470,14470,14470,14470,14470,50,50,2,14.47,16
,20131223,14470,14470,14640,14640,14450,14450,14520,-20,50,56,406.69,58
,20131224,14450,14520,,,,14520,14520,0,0,0,0,58
,20131225,14520,14520,,,,14520,14520,0,0,0,0,58
,20131226,14520,14520,14520,14530,14480,14480,14510,-40,-10,34,246.71,44
,20131227,14480,14510,14420,14440,14420,14440,14425,-70,-85,10,72.14,48
,20131230,14440,14425,,,,14480,14480,55,55,0,0,48
,20131231,14480,14480,,,,14475,14475,-5,-5,0,0,48
pb1407,20130716,14470,14470,,,,14450,14450,-20,-20,0,0,0
,20130717,14450,14450,,,,14470,14470,20,20,0,0,0
,20130718,14470,14470,,,,14440,14440,-30,-30,0,0,0
,20130719,14440,14440,,,,14460,14460,20,20,0,0,0
,20130722,14460,14460,,,,14470,14470,10,10,0,0,0
,20130723,14470,14470,,,,14485,14485,15,15,0,0,0
,20130724,14485,14485,,,,14550,14550,65,65,0,0,0
,20130725,14550,14550,,,,14550,14550,0,0,0,0,0
,20130726,14550,14550,,,,14550,14550,0,0,0,0,0
,20130729,14550,14550,,,,14470,14470,-80,-80,0,0,0
,20130730,14470,14470,,,,14465,14465,-5,-5,0,0,0
,20130731,14465,14465,,,,14435,14435,-30,-30,0,0,0
,20130801,14435,14435,,,,14520,14520,85,85,0,0,0
,20130802,14520,14520,,,,14540,14540,20,20,0,0,0
,20130805,14540,14540,,,,14575,14575,35,35,0,0,0
,20130806,14575,14575,,,,14595,14595,20,20,0,0,0
,20130807,14595,14595,,,,14605,14605,10,10,0,0,0
,20130808,14605,14605,,,,14635,14635,30,30,0,0,0
,20130809,14635,14635,,,,14800,14800,165,165,0,0,0
,20130812,14800,14800,,,,14970,14970,170,170,0,0,0
,20130813,14970,14970,,,,14920,14920,-50,-50,0,0,0
,20130814,14920,14920,,,,14885,14885,-35,-35,0,0,0
,20130815,14885,14885,,,,15120,15120,235,235,0,0,0
,20130816,15120,15120,,,,15265,15265,145,145,0,0,0
,20130819,15265,15265,,,,15340,15340,75,75,0,0,0
,20130820,15340,15340,,,,15230,15230,-110,-110,0,0,0
,20130821,15230,15230,,,,15160,15160,-70,-70,0,0,0
,20130822,15160,15160,,,,15245,15245,85,85,0,0,0
,20130823,15245,15245,,,,15200,15200,-45,-45,0,0,0
,20130826,15200,15200,,,,15290,15290,90,90,0,0,0
,20130827,15290,15290,,,,15430,15430,140,140,0,0,0
,20130828,15430,15430,,,,15290,15290,-140,-140,0,0,0
,20130829,15290,15290,,,,15085,15085,-205,-205,0,0,0
,20130830,15085,15085,,,,15085,15085,0,0,0,0,0
,20130902,15085,15085,,,,15055,15055,-30,-30,0,0,0
,20130903,15055,15055,,,,14930,14930,-125,-125,0,0,0
,20130904,14930,14930,,,,14805,14805,-125,-125,0,0,0
,20130905,14805,14805,,,,14725,14725,-80,-80,0,0,0
,20130906,14725,14725,,,,14675,14675,-50,-50,0,0,0
,20130909,14675,14675,,,,14780,14780,105,105,0,0,0
,20130910,14780,14780,,,,14700,14700,-80,-80,0,0,0
,20130911,14700,14700,,,,14670,14670,-30,-30,0,0,0
,20130912,14670,14670,,,,14505,14505,-165,-165,0,0,0
,20130913,14505,14505,,,,14465,14465,-40,-40,0,0,0
,20130916,14465,14465,,,,14350,14350,-115,-115,0,0,0
,20130917,14350,14350,14495,14495,14340,14340,14435,-10,85,6,43.31,0
,20130918,14340,14435,,,,14435,14435,0,0,0,0,0
,20130923,14435,14435,,,,14530,14530,95,95,0,0,0
,20130924,14530,14530,,,,14580,14580,50,50,0,0,0
,20130925,14580,14580,,,,14580,14580,0,0,0,0,0
,20130926,14580,14580,,,,14565,14565,-15,-15,0,0,0
,20130927,14565,14565,,,,14570,14570,5,5,0,0,0
,20130930,14570,14570,,,,14605,14605,35,35,0,0,0
,20131008,14605,14605,,,,14550,14550,-55,-55,0,0,0
,20131009,14550,14550,,,,14540,14540,-10,-10,0,0,0
,20131010,14540,14540,,,,14545,14545,5,5,0,0,0
,20131011,14545,14545,,,,14650,14650,105,105,0,0,0
,20131014,14650,14650,,,,14635,14635,-15,-15,0,0,0
,20131015,14635,14635,,,,14660,14660,25,25,0,0,0
,20131016,14660,14660,,,,14645,14645,-15,-15,0,0,0
,20131017,14645,14645,,,,14805,14805,160,160,0,0,0
,20131018,14805,14805,,,,14840,14840,35,35,0,0,0
,20131021,14840,14840,,,,14840,14840,0,0,0,0,0
,20131022,14840,14840,,,,14725,14725,-115,-115,0,0,0
,20131023,14725,14725,,,,14725,14725,0,0,0,0,0
,20131024,14725,14725,,,,14550,14550,-175,-175,0,0,0
,20131025,14550,14550,,,,14510,14510,-40,-40,0,0,0
,20131028,14510,14510,,,,14600,14600,90,90,0,0,0
,20131029,14600,14600,,,,14605,14605,5,5,0,0,0
,20131030,14605,14605,,,,14615,14615,10,10,0,0,0
,20131031,14615,14615,,,,14530,14530,-85,-85,0,0,0
,20131101,14530,14530,,,,14570,14570,40,40,0,0,0
,20131104,14570,14570,,,,14530,14530,-40,-40,0,0,0
,20131105,14530,14530,,,,14475,14475,-55,-55,0,0,0
,20131106,14475,14475,,,,14480,14480,5,5,0,0,0
,20131107,14480,14480,,,,14475,14475,-5,-5,0,0,0
,20131108,14475,14475,,,,14405,14405,-70,-70,0,0,0
,20131111,14405,14405,,,,14475,14475,70,70,0,0,0
,20131112,14475,14475,,,,14425,14425,-50,-50,0,0,0
,20131113,14425,14425,,,,14330,14330,-95,-95,0,0,0
,20131114,14330,14330,,,,14370,14370,40,40,0,0,0
,20131115,14370,14370,,,,14370,14370,0,0,0,0,0
,20131118,14370,14370,,,,14480,14480,110,110,0,0,0
,20131119,14480,14480,,,,14395,14395,-85,-85,0,0,0
,20131120,14395,14395,,,,14395,14395,0,0,0,0,0
,20131121,14395,14395,,,,14395,14395,0,0,0,0,0
,20131122,14395,14395,,,,14360,14360,-35,-35,0,0,0
,20131125,14360,14360,,,,14370,14370,10,10,0,0,0
,20131126,14370,14370,,,,14380,14380,10,10,0,0,0
,20131127,14380,14380,,,,14365,14365,-15,-15,0,0,0
,20131128,14365,14365,,,,14365,14365,0,0,0,0,0
,20131129,14365,14365,,,,14290,14290,-75,-75,0,0,0
,20131202,14290,14290,,,,14290,14290,0,0,0,0,0
,20131203,14290,14290,14290,14290,14205,14205,14245,-85,-45,4,28.5,2
,20131204,14205,14245,,,,14245,14245,0,0,0,0,2
,20131205,14245,14245,,,,14245,14245,0,0,0,0,2
,20131206,14245,14245,,,,14245,14245,0,0,0,0,2
,20131209,14245,14245,,,,14245,14245,0,0,0,0,2
,20131210,14245,14245,,,,14245,14245,0,0,0,0,2
,20131211,14245,14245,,,,14250,14250,5,5,0,0,2
,20131212,14250,14250,,,,14290,14290,40,40,0,0,2
,20131213,14290,14290,,,,14290,14290,0,0,0,0,2
,20131216,14290,14290,,,,14315,14315,25,25,0,0,2
,20131217,14315,14315,,,,14515,14515,200,200,0,0,2
,20131218,14515,14515,,,,14515,14515,0,0,0,0,2
,20131219,14515,14515,,,,14500,14500,-15,-15,0,0,2
,20131220,14500,14500,14500,14500,14500,14500,14500,0,0,2,14.5,2
,20131223,14500,14500,,,,14500,14500,0,0,0,0,2
,20131224,14500,14500,14550,14550,14550,14550,14550,50,50,2,14.55,4
,20131225,14550,14550,,,,14550,14550,0,0,0,0,4
,20131226,14550,14550,,,,14550,14550,0,0,0,0,4
,20131227,14550,14550,,,,14550,14550,0,0,0,0,4
,20131230,14550,14550,,,,14550,14550,0,0,0,0,4
,20131231,14550,14550,,,,14550,14550,0,0,0,0,4
pb1408,20130816,15120,15120,,,,15265,15265,145,145,0,0,0
,20130819,15265,15265,,,,15340,15340,75,75,0,0,0
,20130820,15340,15340,,,,15230,15230,-110,-110,0,0,0
,20130821,15230,15230,,,,15160,15160,-70,-70,0,0,0
,20130822,15160,15160,,,,15245,15245,85,85,0,0,0
,20130823,15245,15245,,,,15200,15200,-45,-45,0,0,0
,20130826,15200,15200,,,,15290,15290,90,90,0,0,0
,20130827,15290,15290,,,,15430,15430,140,140,0,0,0
,20130828,15430,15430,,,,15290,15290,-140,-140,0,0,0
,20130829,15290,15290,,,,15085,15085,-205,-205,0,0,0
,20130830,15085,15085,,,,15085,15085,0,0,0,0,0
,20130902,15085,15085,,,,15055,15055,-30,-30,0,0,0
,20130903,15055,15055,,,,14930,14930,-125,-125,0,0,0
,20130904,14930,14930,,,,14805,14805,-125,-125,0,0,0
,20130905,14805,14805,14960,14960,14960,14960,14960,155,155,2,14.96,2
,20130906,14960,14960,14725,14725,14725,14725,14725,-235,-235,2,14.73,2
,20130909,14725,14725,,,,14830,14830,105,105,0,0,2
,20130910,14830,14830,,,,14750,14750,-80,-80,0,0,2
,20130911,14750,14750,,,,14720,14720,-30,-30,0,0,2
,20130912,14720,14720,,,,14555,14555,-165,-165,0,0,2
,20130913,14555,14555,,,,14515,14515,-40,-40,0,0,2
,20130916,14515,14515,,,,14400,14400,-115,-115,0,0,2
,20130917,14400,14400,,,,14485,14485,85,85,0,0,2
,20130918,14485,14485,,,,14485,14485,0,0,0,0,2
,20130923,14485,14485,,,,14580,14580,95,95,0,0,2
,20130924,14580,14580,,,,14630,14630,50,50,0,0,2
,20130925,14630,14630,,,,14605,14605,-25,-25,0,0,2
,20130926,14605,14605,,,,14590,14590,-15,-15,0,0,2
,20130927,14590,14590,,,,14590,14590,0,0,0,0,2
,20130930,14590,14590,,,,14625,14625,35,35,0,0,2
,20131008,14625,14625,,,,14570,14570,-55,-55,0,0,2
,20131009,14570,14570,,,,14560,14560,-10,-10,0,0,2
,20131010,14560,14560,,,,14565,14565,5,5,0,0,2
,20131011,14565,14565,,,,14670,14670,105,105,0,0,2
,20131014,14670,14670,,,,14655,14655,-15,-15,0,0,2
,20131015,14655,14655,,,,14680,14680,25,25,0,0,2
,20131016,14680,14680,,,,14665,14665,-15,-15,0,0,2
,20131017,14665,14665,,,,14825,14825,160,160,0,0,2
,20131018,14825,14825,,,,14860,14860,35,35,0,0,2
,20131021,14860,14860,,,,15115,15115,255,255,0,0,2
,20131022,15115,15115,,,,14995,14995,-120,-120,0,0,2
,20131023,14995,14995,,,,14985,14985,-10,-10,0,0,2
,20131024,14985,14985,,,,14810,14810,-175,-175,0,0,2
,20131025,14810,14810,,,,14770,14770,-40,-40,0,0,2
,20131028,14770,14770,,,,14865,14865,95,95,0,0,2
,20131029,14865,14865,,,,14870,14870,5,5,0,0,2
,20131030,14870,14870,,,,14880,14880,10,10,0,0,2
,20131031,14880,14880,,,,14795,14795,-85,-85,0,0,2
,20131101,14795,14795,,,,14840,14840,45,45,0,0,2
,20131104,14840,14840,,,,14800,14800,-40,-40,0,0,2
,20131105,14800,14800,,,,14745,14745,-55,-55,0,0,2
,20131106,14745,14745,,,,14750,14750,5,5,0,0,2
,20131107,14750,14750,,,,14745,14745,-5,-5,0,0,2
,20131108,14745,14745,,,,14670,14670,-75,-75,0,0,2
,20131111,14670,14670,,,,14745,14745,75,75,0,0,2
,20131112,14745,14745,,,,14690,14690,-55,-55,0,0,2
,20131113,14690,14690,,,,14595,14595,-95,-95,0,0,2
,20131114,14595,14595,,,,14635,14635,40,40,0,0,2
,20131115,14635,14635,,,,14435,14435,-200,-200,0,0,2
,20131118,14435,14435,,,,14545,14545,110,110,0,0,2
,20131119,14545,14545,,,,14460,14460,-85,-85,0,0,2
,20131120,14460,14460,14130,14130,14130,14130,14130,-330,-330,2,14.13,2
,20131121,14130,14130,,,,14190,14190,60,60,0,0,2
,20131122,14190,14190,,,,14190,14190,0,0,0,0,2
,20131125,14190,14190,,,,14200,14200,10,10,0,0,2
,20131126,14200,14200,,,,14210,14210,10,10,0,0,2
,20131127,14210,14210,,,,14195,14195,-15,-15,0,0,2
,20131128,14195,14195,,,,14195,14195,0,0,0,0,2
,20131129,14195,14195,,,,14195,14195,0,0,0,0,2
,20131202,14195,14195,,,,14195,14195,0,0,0,0,2
,20131203,14195,14195,,,,14195,14195,0,0,0,0,2
,20131204,14195,14195,,,,14195,14195,0,0,0,0,2
,20131205,14195,14195,,,,14195,14195,0,0,0,0,2
,20131206,14195,14195,,,,14195,14195,0,0,0,0,2
,20131209,14195,14195,,,,14195,14195,0,0,0,0,2
,20131210,14195,14195,,,,14290,14290,95,95,0,0,2
,20131211,14290,14290,,,,14290,14290,0,0,0,0,2
,20131212,14290,14290,,,,14290,14290,0,0,0,0,2
,20131213,14290,14290,,,,14290,14290,0,0,0,0,2
,20131216,14290,14290,,,,14310,14310,20,20,0,0,2
,20131217,14310,14310,14540,14540,14540,14540,14540,230,230,2,14.54,0
,20131218,14540,14540,,,,14540,14540,0,0,0,0,0
,20131219,14540,14540,,,,14540,14540,0,0,0,0,0
,20131220,14540,14540,,,,14540,14540,0,0,0,0,0
,20131223,14540,14540,,,,14540,14540,0,0,0,0,0
,20131224,14540,14540,,,,14540,14540,0,0,0,0,0
,20131225,14540,14540,,,,14580,14580,40,40,0,0,0
,20131226,14580,14580,,,,14580,14580,0,0,0,0,0
,20131227,14580,14580,,,,14580,14580,0,0,0,0,0
,20131230,14580,14580,,,,14580,14580,0,0,0,0,0
,20131231,14580,14580,,,,14480,14480,-100,-100,0,0,0
pb1409,20130917,14400,14400,,,,14400,14400,0,0,0,0,0
,20130918,14400,14400,,,,14400,14400,0,0,0,0,0
,20130923,14400,14400,,,,14495,14495,95,95,0,0,0
,20130924,14495,14495,,,,14545,14545,50,50,0,0,0
,20130925,14545,14545,,,,14520,14520,-25,-25,0,0,0
,20130926,14520,14520,,,,14505,14505,-15,-15,0,0,0
,20130927,14505,14505,,,,14510,14510,5,5,0,0,0
,20130930,14510,14510,,,,14545,14545,35,35,0,0,0
,20131008,14545,14545,,,,14490,14490,-55,-55,0,0,0
,20131009,14490,14490,,,,14480,14480,-10,-10,0,0,0
,20131010,14480,14480,,,,14485,14485,5,5,0,0,0
,20131011,14485,14485,,,,14590,14590,105,105,0,0,0
,20131014,14590,14590,,,,14575,14575,-15,-15,0,0,0
,20131015,14575,14575,,,,14600,14600,25,25,0,0,0
,20131016,14600,14600,,,,14585,14585,-15,-15,0,0,0
,20131017,14585,14585,,,,14745,14745,160,160,0,0,0
,20131018,14745,14745,,,,14780,14780,35,35,0,0,0
,20131021,14780,14780,,,,15030,15030,250,250,0,0,0
,20131022,15030,15030,,,,14910,14910,-120,-120,0,0,0
,20131023,14910,14910,,,,14910,14910,0,0,0,0,0
,20131024,14910,14910,,,,14735,14735,-175,-175,0,0,0
,20131025,14735,14735,,,,14695,14695,-40,-40,0,0,0
,20131028,14695,14695,,,,14790,14790,95,95,0,0,0
,20131029,14790,14790,,,,14795,14795,5,5,0,0,0
,20131030,14795,14795,,,,14805,14805,10,10,0,0,0
,20131031,14805,14805,,,,14720,14720,-85,-85,0,0,0
,20131101,14720,14720,,,,14765,14765,45,45,0,0,0
,20131104,14765,14765,,,,14725,14725,-40,-40,0,0,0
,20131105,14725,14725,,,,14670,14670,-55,-55,0,0,0
,20131106,14670,14670,,,,14675,14675,5,5,0,0,0
,20131107,14675,14675,,,,14670,14670,-5,-5,0,0,0
,20131108,14670,14670,,,,14595,14595,-75,-75,0,0,0
,20131111,14595,14595,,,,14670,14670,75,75,0,0,0
,20131112,14670,14670,,,,14615,14615,-55,-55,0,0,0
,20131113,14615,14615,,,,14520,14520,-95,-95,0,0,0
,20131114,14520,14520,,,,14560,14560,40,40,0,0,0
,20131115,14560,14560,,,,14360,14360,-200,-200,0,0,0
,20131118,14360,14360,,,,14470,14470,110,110,0,0,0
,20131119,14470,14470,,,,14385,14385,-85,-85,0,0,0
,20131120,14385,14385,,,,14385,14385,0,0,0,0,0
,20131121,14385,14385,,,,14355,14355,-30,-30,0,0,0
,20131122,14355,14355,,,,14255,14255,-100,-100,0,0,0
,20131125,14255,14255,,,,14265,14265,10,10,0,0,0
,20131126,14265,14265,,,,14275,14275,10,10,0,0,0
,20131127,14275,14275,,,,14260,14260,-15,-15,0,0,0
,20131128,14260,14260,,,,14290,14290,30,30,0,0,0
,20131129,14290,14290,,,,14215,14215,-75,-75,0,0,0
,20131202,14215,14215,,,,14120,14120,-95,-95,0,0,0
,20131203,14120,14120,,,,14075,14075,-45,-45,0,0,0
,20131204,14075,14075,,,,13885,13885,-190,-190,0,0,0
,20131205,13885,13885,,,,14190,14190,305,305,0,0,0
,20131206,14190,14190,,,,14190,14190,0,0,0,0,0
,20131209,14190,14190,,,,14215,14215,25,25,0,0,0
,20131210,14215,14215,,,,14270,14270,55,55,0,0,0
,20131211,14270,14270,,,,14285,14285,15,15,0,0,0
,20131212,14285,14285,,,,14325,14325,40,40,0,0,0
,20131213,14325,14325,,,,14325,14325,0,0,0,0,0
,20131216,14325,14325,,,,14350,14350,25,25,0,0,0
,20131217,14350,14350,,,,14550,14550,200,200,0,0,0
,20131218,14550,14550,,,,14550,14550,0,0,0,0,0
,20131219,14550,14550,,,,14550,14550,0,0,0,0,0
,20131220,14550,14550,,,,14550,14550,0,0,0,0,0
,20131223,14550,14550,,,,14550,14550,0,0,0,0,0
,20131224,14550,14550,,,,14550,14550,0,0,0,0,0
,20131225,14550,14550,,,,14630,14630,80,80,0,0,0
,20131226,14630,14630,,,,14630,14630,0,0,0,0,0
,20131227,14630,14630,,,,14630,14630,0,0,0,0,0
,20131230,14630,14630,,,,14630,14630,0,0,0,0,0
,20131231,14630,14630,,,,14530,14530,-100,-100,0,0,0
pb1410,20131016,14600,14600,,,,14585,14585,-15,-15,0,0,0
,20131017,14585,14585,,,,14745,14745,160,160,0,0,0
,20131018,14745,14745,,,,14780,14780,35,35,0,0,0
,20131021,14780,14780,,,,15030,15030,250,250,0,0,0
,20131022,15030,15030,,,,14910,14910,-120,-120,0,0,0
,20131023,14910,14910,,,,14910,14910,0,0,0,0,0
,20131024,14910,14910,,,,14735,14735,-175,-175,0,0,0
,20131025,14735,14735,14625,14955,14625,14955,14790,220,55,4,29.58,0
,20131028,14955,14790,,,,14790,14790,0,0,0,0,0
,20131029,14790,14790,,,,14795,14795,5,5,0,0,0
,20131030,14795,14795,,,,14805,14805,10,10,0,0,0
,20131031,14805,14805,,,,14720,14720,-85,-85,0,0,0
,20131101,14720,14720,,,,14765,14765,45,45,0,0,0
,20131104,14765,14765,,,,14725,14725,-40,-40,0,0,0
,20131105,14725,14725,,,,14670,14670,-55,-55,0,0,0
,20131106,14670,14670,,,,14675,14675,5,5,0,0,0
,20131107,14675,14675,,,,14670,14670,-5,-5,0,0,0
,20131108,14670,14670,,,,14670,14670,0,0,0,0,0
,20131111,14670,14670,,,,14745,14745,75,75,0,0,0
,20131112,14745,14745,,,,14690,14690,-55,-55,0,0,0
,20131113,14690,14690,,,,14595,14595,-95,-95,0,0,0
,20131114,14595,14595,,,,14635,14635,40,40,0,0,0
,20131115,14635,14635,,,,14435,14435,-200,-200,0,0,0
,20131118,14435,14435,,,,14545,14545,110,110,0,0,0
,20131119,14545,14545,,,,14460,14460,-85,-85,0,0,0
,20131120,14460,14460,,,,14460,14460,0,0,0,0,0
,20131121,14460,14460,,,,14430,14430,-30,-30,0,0,0
,20131122,14430,14430,,,,14330,14330,-100,-100,0,0,0
,20131125,14330,14330,,,,14340,14340,10,10,0,0,0
,20131126,14340,14340,,,,14350,14350,10,10,0,0,0
,20131127,14350,14350,,,,14335,14335,-15,-15,0,0,0
,20131128,14335,14335,,,,14365,14365,30,30,0,0,0
,20131129,14365,14365,,,,14290,14290,-75,-75,0,0,0
,20131202,14290,14290,,,,14195,14195,-95,-95,0,0,0
,20131203,14195,14195,,,,14150,14150,-45,-45,0,0,0
,20131204,14150,14150,,,,13960,13960,-190,-190,0,0,0
,20131205,13960,13960,,,,14235,14235,275,275,0,0,0
,20131206,14235,14235,,,,14235,14235,0,0,0,0,0
,20131209,14235,14235,,,,14265,14265,30,30,0,0,0
,20131210,14265,14265,,,,14320,14320,55,55,0,0,0
,20131211,14320,14320,,,,14335,14335,15,15,0,0,0
,20131212,14335,14335,,,,14380,14380,45,45,0,0,0
,20131213,14380,14380,,,,14380,14380,0,0,0,0,0
,20131216,14380,14380,,,,14400,14400,20,20,0,0,0
,20131217,14400,14400,,,,14590,14590,190,190,0,0,0
,20131218,14590,14590,,,,14590,14590,0,0,0,0,0
,20131219,14590,14590,,,,14590,14590,0,0,0,0,0
,20131220,14590,14590,,,,14590,14590,0,0,0,0,0
,20131223,14590,14590,,,,14640,14640,50,50,0,0,0
,20131224,14640,14640,,,,14640,14640,0,0,0,0,0
,20131225,14640,14640,,,,14685,14685,45,45,0,0,0
,20131226,14685,14685,,,,14675,14675,-10,-10,0,0,0
,20131227,14675,14675,,,,14590,14590,-85,-85,0,0,0
,20131230,14590,14590,,,,14640,14640,50,50,0,0,0
,20131231,14640,14640,,,,14540,14540,-100,-100,0,0,0
pb1411,20131118,14435,14435,,,,14435,14435,0,0,0,0,0
,20131119,14435,14435,,,,14350,14350,-85,-85,0,0,0
,20131120,14350,14350,,,,14350,14350,0,0,0,0,0
,20131121,14350,14350,,,,14320,14320,-30,-30,0,0,0
,20131122,14320,14320,,,,14220,14220,-100,-100,0,0,0
,20131125,14220,14220,,,,14230,14230,10,10,0,0,0
,20131126,14230,14230,,,,14240,14240,10,10,0,0,0
,20131127,14240,14240,,,,14225,14225,-15,-15,0,0,0
,20131128,14225,14225,,,,14255,14255,30,30,0,0,0
,20131129,14255,14255,,,,14180,14180,-75,-75,0,0,0
,20131202,14180,14180,,,,14085,14085,-95,-95,0,0,0
,20131203,14085,14085,,,,14040,14040,-45,-45,0,0,0
,20131204,14040,14040,,,,13850,13850,-190,-190,0,0,0
,20131205,13850,13850,,,,14260,14260,410,410,0,0,0
,20131206,14260,14260,,,,14260,14260,0,0,0,0,0
,20131209,14260,14260,,,,14275,14275,15,15,0,0,0
,20131210,14275,14275,,,,14355,14355,80,80,0,0,0
,20131211,14355,14355,,,,14355,14355,0,0,0,0,0
,20131212,14355,14355,,,,14375,14375,20,20,0,0,0
,20131213,14375,14375,,,,14375,14375,0,0,0,0,0
,20131216,14375,14375,,,,14400,14400,25,25,0,0,0
,20131217,14400,14400,,,,14615,14615,215,215,0,0,0
,20131218,14615,14615,,,,14615,14615,0,0,0,0,0
,20131219,14615,14615,,,,14615,14615,0,0,0,0,0
,20131220,14615,14615,,,,14615,14615,0,0,0,0,0
,20131223,14615,14615,,,,14615,14615,0,0,0,0,0
,20131224,14615,14615,,,,14615,14615,0,0,0,0,0
,20131225,14615,14615,,,,14660,14660,45,45,0,0,0
,20131226,14660,14660,,,,14650,14650,-10,-10,0,0,0
,20131227,14650,14650,,,,14565,14565,-85,-85,0,0,0
,20131230,14565,14565,,,,14565,14565,0,0,0,0,0
,20131231,14565,14565,,,,14465,14465,-100,-100,0,0,0
pb1412,20131217,14400,14400,,,,14445,14445,45,45,0,0,0
,20131218,14445,14445,,,,14575,14575,130,130,0,0,0
,20131219,14575,14575,,,,14480,14480,-95,-95,0,0,0
,20131220,14480,14480,,,,14480,14480,0,0,0,0,0
,20131223,14480,14480,,,,14530,14530,50,50,0,0,0
,20131224,14530,14530,14890,14890,14540,14540,14715,10,185,4,29.43,0
,20131225,14540,14715,,,,14760,14760,45,45,0,0,0
,20131226,14760,14760,,,,14750,14750,-10,-10,0,0,0
,20131227,14750,14750,,,,14665,14665,-85,-85,0,0,0
,20131230,14665,14665,,,,14665,14665,0,0,0,0,0
,20131231,14665,14665,,,,14565,14565,-100,-100,0,0,0
rb1301,20130104,3860,3824,3896,3896,3834,3869,3867,45,43,552,"2,134.74",19860
,20130107,3869,3867,3850,3910,3850,3880,3877,13,10,660,"2,559.06",19260
,20130108,3880,3877,3835,3860,3821,3860,3842,-17,-35,1080,"4,149.90",18600
,20130109,3860,3842,3870,3870,3855,3855,3860,13,18,540,"2,084.70",18060
,20130110,3855,3860,3870,3870,3816,3825,3849,-35,-11,1980,"7,622.94",17160
,20130111,3825,3849,3821,3833,3811,3816,3819,-33,-30,1440,"5,500.38",15840
,20130114,3816,3819,3805,3875,3796,3825,3828,6,9,480,"1,837.62",15480
,20130115,3825,3828,3865,3865,3811,3850,3854,22,26,540,"2,081.16",15480
rb1302,20130104,3828,3830,3858,3860,3806,3828,3818,-2,-12,396,"1,512.30",4940
,20130107,3828,3818,3853,3885,3827,3827,3865,9,47,78,301.5,4946
,20130108,3827,3865,3820,3860,3810,3856,3832,-9,-33,314,"1,203.38",4846
,20130109,3856,3832,3838,3855,3830,3855,3850,23,18,190,731.6,4846
,20130110,3855,3850,3855,3875,3855,3875,3864,25,14,442,"1,708.22",4788
,20130111,3875,3864,3856,3859,3821,3822,3832,-42,-32,188,720.51,4814
,20130114,3822,3832,3838,3865,3809,3865,3839,33,7,240,921.48,4624
,20130115,3865,3839,3865,3865,3848,3848,3858,9,19,40,154.35,4626
,20130116,3848,3858,3810,3828,3810,3828,3813,-30,-45,112,427.15,4634
,20130117,3828,3813,3828,3828,3803,3820,3820,7,7,172,657.1,4590
,20130118,3820,3820,3820,3829,3811,3825,3823,5,3,170,650.06,4678
,20130121,3825,3823,3837,3838,3801,3820,3825,-3,2,330,"1,262.52",4450
,20130122,3820,3825,3820,3849,3803,3825,3820,0,-5,44,168.1,4446
,20130123,3825,3820,3825,3899,3803,3870,3829,50,9,1540,"5,897.25",3548
,20130124,3870,3829,3817,3833,3812,3830,3823,1,-6,1492,"5,703.97",3154
,20130125,3830,3823,3821,3845,3821,3830,3833,7,10,442,"1,694.46",2878
,20130128,3830,3833,3830,3845,3830,3842,3841,9,8,824,"3,165.01",2586
,20130129,3842,3841,3836,3850,3836,3850,3848,9,7,196,754.27,2450
,20130130,3850,3848,3842,3890,3842,3881,3882,33,34,378,"1,467.61",2124
,20130131,3881,3882,3888,3895,3789,3831,3881,-51,-1,188,729.77,2042
,20130201,3831,3881,3890,3910,3890,3910,3896,29,15,362,"1,410.42",1920
,20130204,3910,3896,3950,3960,3950,3960,3955,64,59,120,474.6,1920
,20130205,3960,3955,3910,3960,3910,3960,3918,5,-37,360,"1,410.60",1920
,20130206,3960,3918,3910,3910,3890,3890,3892,-28,-26,1320,"5,137.80",2040
,20130207,3890,3892,,,,3892,3892,0,0,0,0,2040
,20130208,3892,3892,,,,3892,3892,0,0,0,0,2040
,20130218,3892,3892,3880,3885,3871,3871,3881,-21,-11,600,"2,328.60",2040
rb1303,20130104,3889,3875,3921,3921,3834,3897,3887,22,12,176,684.27,2092
,20130107,3897,3887,3930,3930,3901,3915,3914,28,27,108,422.76,2096
,20130108,3915,3914,3910,3920,3890,3904,3905,-10,-9,210,820.11,2202
,20130109,3904,3905,3906,3906,3887,3900,3897,-5,-8,136,530.12,2214
,20130110,3900,3897,3898,3929,3898,3916,3910,19,13,210,821.19,2294
,20130111,3916,3910,3876,3876,3834,3834,3853,-76,-57,8,30.83,2290
,20130114,3834,3853,3839,3900,3836,3885,3867,32,14,144,556.89,2262
,20130115,3885,3867,3885,3885,3861,3861,3876,-6,9,46,178.33,2260
,20130116,3861,3876,3840,3847,3795,3828,3824,-48,-52,286,"1,093.82",2242
,20130117,3828,3824,3814,3830,3814,3830,3825,6,1,186,711.54,2148
,20130118,3830,3825,3888,3888,3834,3862,3850,37,25,344,"1,324.48",2260
,20130121,3862,3850,3840,3857,3822,3826,3843,-24,-7,350,"1,345.17",2260
,20130122,3826,3843,3825,3836,3815,3835,3832,-8,-11,140,536.59,2258
,20130123,3835,3832,3840,3895,3830,3883,3847,51,15,238,915.71,2260
,20130124,3883,3847,3880,3880,3835,3846,3851,-1,4,410,"1,579.17",2496
,20130125,3846,3851,3865,3905,3859,3905,3896,54,45,632,"2,462.62",2980
,20130128,3905,3896,3899,3899,3884,3892,3890,-4,-6,262,"1,019.41",3100
,20130129,3892,3890,3880,3893,3879,3886,3883,-4,-7,804,"3,122.08",3204
,20130130,3886,3883,3900,3937,3900,3937,3920,54,37,392,"1,536.83",3500
,20130131,3937,3920,3930,3936,3921,3931,3927,11,7,24,94.27,3494
,20130201,3931,3927,3925,3968,3925,3968,3946,41,19,22,86.82,3496
,20130204,3968,3946,4004,4013,3990,4007,4003,61,57,326,"1,305.09",3674
,20130205,4007,4003,3986,3992,3926,3955,3969,-48,-34,318,"1,262.27",3878
,20130206,3955,3969,3939,3940,3903,3919,3915,-50,-54,276,"1,080.72",4026
,20130207,3919,3915,3898,3920,3898,3915,3910,0,-5,252,985.42,4142
,20130208,3915,3910,3948,3955,3948,3955,3951,45,41,166,655.92,4186
,20130218,3955,3951,3913,3920,3881,3881,3913,-70,-38,270,"1,056.76",4004
,20130219,3881,3913,3902,3915,3901,3905,3907,-8,-6,250,976.89,3948
,20130220,3905,3907,3906,3919,3900,3914,3907,7,0,142,554.91,3930
,20130221,3914,3907,3885,3889,3841,3866,3865,-41,-42,600,"2,319.19",3552
,20130222,3866,3865,3851,3855,3835,3835,3848,-30,-17,192,738.82,3528
,20130225,3835,3848,3839,3860,3803,3822,3823,-26,-25,610,"2,332.08",3300
,20130226,3822,3823,3761,3829,3754,3800,3804,-23,-19,1248,"4,748.62",3302
,20130227,3800,3804,3808,3816,3761,3780,3800,-24,-4,1568,"5,959.45",3280
,20130228,3780,3800,3735,3820,3720,3800,3791,0,-9,696,"2,639.14",3240
,20130301,3800,3791,3770,3770,3770,3770,3770,-21,-21,60,226.2,3180
,20130304,3770,3770,3700,3700,3700,3700,3700,-70,-70,60,222,3180
,20130305,3700,3700,3730,3730,3730,3730,3730,30,30,120,447.6,3180
,20130306,3730,3730,3730,3730,3730,3730,3730,0,0,120,447.6,3180
,20130307,3730,3730,3731,3731,3731,3731,3731,1,1,240,895.44,3180
,20130308,3731,3731,3720,3720,3720,3720,3720,-11,-11,60,223.2,3120
,20130311,3720,3720,3720,3720,3720,3720,3720,0,0,60,223.2,3060
,20130312,3720,3720,3710,3710,3700,3705,3706,-15,-14,540,"2,001.60",2940
,20130313,3705,3706,3660,3660,3600,3600,3620,-106,-86,540,"1,954.92",2880
,20130314,3600,3620,3580,3590,3501,3590,3550,-30,-70,360,"1,278.06",2880
,20130315,3590,3550,3680,3680,3670,3672,3674,122,124,180,661.32,2880
rb1304,20130104,3920,3913,3911,4047,3911,3938,3938,25,25,700,"2,757.29",3488
,20130107,3938,3938,3958,3973,3953,3959,3965,21,27,86,341,3486
,20130108,3959,3965,3926,3963,3905,3963,3940,-2,-25,192,756.55,3540
,20130109,3963,3940,3931,3980,3931,3940,3942,0,2,262,"1,032.87",3518
,20130110,3940,3942,3937,3995,3936,3969,3955,27,13,310,"1,226.24",3562
,20130111,3969,3955,3964,3966,3873,3874,3927,-81,-28,282,"1,107.43",3536
,20130114,3874,3927,3861,3955,3861,3945,3924,18,-3,562,"2,205.52",3822
,20130115,3945,3924,3921,3953,3913,3919,3930,-5,6,218,856.87,3808
,20130116,3919,3930,3881,3889,3845,3868,3870,-62,-60,496,"1,919.90",3848
,20130117,3868,3870,3866,3890,3842,3875,3861,5,-9,528,"2,038.61",3824
,20130118,3875,3861,3911,3920,3890,3920,3905,59,44,322,"1,257.71",3862
,20130121,3920,3905,3913,3925,3894,3894,3916,-11,11,134,524.86,3870
,20130122,3894,3916,3876,3907,3876,3907,3895,-9,-21,52,202.57,3864
,20130123,3907,3895,3912,3967,3909,3967,3938,72,43,212,834.93,3924
,20130124,3967,3938,3971,4020,3930,3950,3969,12,31,252,"1,000.23",3826
,20130125,3950,3969,3982,4039,3977,4003,3997,34,28,1162,"4,645.45",3908
,20130128,4003,3997,4002,4028,3975,3982,3991,-15,-6,482,"1,924.12",3932
,20130129,3982,3991,3974,3990,3971,3974,3975,-17,-16,182,723.61,4046
,20130130,3974,3975,3981,4028,3981,4016,4014,41,39,162,650.37,4084
,20130131,4016,4014,4014,4042,4008,4023,4017,9,3,164,658.89,4070
,20130201,4023,4017,4017,4077,4007,4067,4043,50,26,172,695.56,4090
,20130204,4067,4043,4073,4131,4073,4105,4106,62,63,460,"1,888.79",4098
,20130205,4105,4106,4106,4106,4023,4043,4078,-63,-28,396,"1,615.06",4094
,20130206,4043,4078,4040,4040,4003,4012,4018,-66,-60,330,"1,326.00",4006
,20130207,4012,4018,4003,4027,3993,4022,4013,4,-5,40,160.53,4002
,20130208,4022,4013,4028,4043,4012,4036,4034,23,21,88,355.06,4030
,20130218,4036,4034,4000,4017,3966,3966,3986,-68,-48,136,542.19,4026
,20130219,3966,3986,3992,4003,3992,4002,4001,16,15,28,112.04,4032
,20130220,4002,4001,4013,4017,3997,4008,4008,7,7,164,657.4,4044
,20130221,4008,4008,3991,3991,3931,3957,3949,-51,-59,726,"2,867.18",3598
,20130222,3957,3949,3932,3932,3912,3919,3921,-30,-28,54,211.76,3594
,20130225,3919,3921,3871,3929,3871,3889,3887,-32,-34,200,777.59,3438
,20130226,3889,3887,3880,3905,3870,3882,3886,-5,-1,408,"1,585.84",3440
,20130227,3882,3886,3905,3924,3891,3902,3904,16,18,360,"1,405.59",3258
,20130228,3902,3904,3926,3939,3919,3939,3929,35,25,34,133.6,3246
,20130301,3939,3929,3929,3930,3894,3930,3907,1,-22,296,"1,156.71",3112
,20130304,3930,3907,3897,3897,3842,3849,3849,-58,-58,520,"2,001.90",2704
,20130305,3849,3849,3866,3898,3859,3883,3878,34,29,98,380.06,2654
,20130306,3883,3878,3920,3920,3891,3895,3893,17,15,50,194.67,2644
,20130307,3895,3893,3881,3882,3881,3882,3881,-11,-12,6,23.29,2638
,20130308,3882,3881,,,,3881,3881,0,0,0,0,2638
,20130311,3881,3881,3853,3875,3853,3865,3864,-16,-17,76,293.73,2640
,20130312,3865,3864,3867,3867,3851,3851,3853,-13,-11,70,269.75,2630
,20130313,3851,3853,3851,3851,3782,3799,3826,-54,-27,614,"2,349.68",2332
,20130314,3799,3826,3781,3788,3737,3737,3754,-89,-72,550,"2,064.91",1880
,20130315,3737,3754,3777,3860,3770,3821,3835,67,81,330,"1,265.70",1742
,20130318,3821,3835,3780,3828,3771,3828,3786,-7,-49,180,681.56,1578
,20130319,3828,3786,3794,3794,3794,3794,3794,8,8,2,7.59,1576
,20130320,3794,3794,3800,3815,3800,3801,3809,7,15,54,205.7,1568
,20130321,3801,3809,3840,3840,3812,3812,3825,3,16,8,30.6,1566
,20130322,3812,3825,3783,3790,3783,3790,3788,-35,-37,120,454.66,1446
,20130325,3790,3788,3815,3820,3791,3801,3809,13,21,154,586.71,1396
,20130326,3801,3809,3789,3809,3781,3789,3788,-20,-21,112,424.26,1298
,20130327,3789,3788,3795,3795,3761,3777,3773,-11,-15,180,679.3,1210
,20130328,3777,3773,3761,3761,3741,3741,3755,-32,-18,170,638.36,1056
,20130329,3741,3755,3735,3810,3648,3701,3734,-54,-21,282,"1,053.23",960
,20130401,3701,3734,3631,3631,3631,3631,3631,-103,-103,60,217.86,900
,20130402,3631,3631,3650,3650,3650,3650,3650,19,19,60,219,900
,20130403,3650,3650,3700,3720,3700,3720,3710,70,60,120,445.2,840
,20130408,3720,3710,3720,3720,3720,3720,3720,10,10,60,223.2,840
,20130409,3720,3720,3730,3750,3730,3730,3735,10,15,240,896.4,780
,20130410,3730,3735,,,,3735,3735,0,0,0,0,780
,20130411,3735,3735,,,,3735,3735,0,0,0,0,780
,20130412,3735,3735,3680,3730,3680,3730,3705,-5,-30,120,444.6,840
,20130415,3730,3705,3680,3680,3618,3630,3638,-75,-67,480,"1,746.24",720
rb1305,20130104,3988,3958,4018,4023,3966,3990,3990,32,32,2305966,"9,201,680.37",1208310
,20130107,3990,3990,4029,4047,3994,4004,4015,14,25,2896484,"11,631,531.04",1391856
,20130108,4004,4015,4014,4020,3968,4010,3998,-5,-17,2523894,"10,092,158.31",1372826
,20130109,4010,3998,4009,4015,3976,3998,3990,0,-8,2208806,"8,813,633.40",1368910
,20130110,3998,3990,3994,4030,3982,4020,4012,30,22,2885508,"11,576,825.70",1431692
,20130111,4020,4012,4022,4029,3918,3925,3966,-87,-46,3186202,"12,638,727.04",1280732
,20130114,3925,3966,3930,4026,3893,4004,3972,38,6,3884908,"15,434,192.97",1342386
,20130115,4004,3972,4005,4012,3969,3977,3988,5,16,2434790,"9,710,881.82",1356304
,20130116,3977,3988,3965,3969,3896,3934,3935,-54,-53,2696402,"10,612,654.41",1325568
,20130117,3934,3935,3930,3948,3899,3946,3925,11,-10,2441574,"9,583,829.50",1307512
,20130118,3946,3925,3960,4004,3952,4002,3970,77,45,2346678,"9,318,210.72",1286920
,20130121,4002,3970,3991,4012,3962,3965,3990,-5,20,2373354,"9,470,416.10",1305804
,20130122,3965,3990,3969,3990,3945,3987,3968,-3,-22,2299268,"9,123,714.62",1304862
,20130123,3987,3968,3990,4055,3980,4053,4006,85,38,2698600,"10,810,751.91",1479668
,20130124,4053,4006,4053,4067,3997,4032,4036,26,30,3701298,"14,939,509.36",1433814
,20130125,4032,4036,4040,4085,4035,4076,4060,40,24,3541296,"14,380,790.31",1579068
,20130128,4076,4060,4075,4080,4056,4068,4069,8,9,1843148,"7,501,164.19",1430354
,20130129,4068,4069,4061,4075,4043,4069,4061,0,-8,1691260,"6,868,225.55",1395986
,20130130,4069,4061,4071,4131,4071,4114,4109,53,48,2323038,"9,547,143.44",1437552
,20130131,4114,4109,4126,4130,4100,4127,4114,18,5,1470028,"6,047,773.48",1332500
,20130201,4127,4114,4121,4170,4111,4168,4136,54,22,2108662,"8,722,303.89",1376852
,20130204,4168,4136,4179,4235,4174,4221,4201,85,65,1635588,"6,872,616.42",1213904
,20130205,4221,4201,4201,4205,4117,4140,4171,-61,-30,2017310,"8,415,114.59",918566
,20130206,4140,4171,4150,4151,4094,4109,4118,-62,-53,1140156,"4,695,216.48",832292
,20130207,4109,4118,4114,4135,4086,4124,4105,6,-13,698148,"2,866,193.42",686640
,20130208,4124,4105,4125,4139,4115,4127,4128,22,23,313548,"1,294,327.94",605274
,20130218,4127,4128,4130,4150,4055,4059,4092,-69,-36,363908,"1,489,436.32",566734
,20130219,4059,4092,4062,4118,4062,4090,4094,-2,2,310334,"1,270,719.77",554748
,20130220,4090,4094,4097,4117,4086,4096,4102,2,8,243576,"999,308.84",543828
,20130221,4096,4102,4064,4083,3990,4014,4021,-88,-81,390126,"1,569,064.68",454428
,20130222,4014,4021,4000,4027,3966,3977,4001,-44,-20,176090,"704,589.40",413038
,20130225,3977,4001,3972,3977,3931,3937,3949,-64,-52,199896,"789,559.09",349110
,20130226,3937,3949,3920,3955,3901,3903,3928,-46,-21,176692,"694,217.04",308054
,20130227,3903,3928,3911,3939,3899,3929,3922,1,-6,131644,"516,402.04",290282
,20130228,3929,3922,3928,3988,3928,3980,3963,58,41,97862,"387,876.59",266614
,20130301,3980,3963,3974,3979,3911,3953,3945,-10,-18,105846,"417,639.69",243148
,20130304,3953,3945,3921,3928,3868,3875,3887,-70,-58,155382,"604,124.72",204654
,20130305,3875,3887,3878,3916,3877,3915,3893,28,6,76186,"296,620.15",184220
,20130306,3915,3893,3920,3933,3895,3917,3914,24,21,79164,"309,906.14",165550
,20130307,3917,3914,3910,3925,3900,3908,3910,-6,-4,56906,"222,543.34",155544
,20130308,3908,3910,3916,3932,3886,3912,3908,2,-2,60240,"235,425.21",146150
,20130311,3912,3908,3904,3918,3871,3893,3892,-15,-16,66868,"260,263.44",132184
,20130312,3893,3892,3893,3905,3878,3891,3890,-1,-2,56976,"221,653.32",118256
,20130313,3891,3890,3895,3895,3797,3803,3839,-87,-51,85470,"328,157.97",98216
,20130314,3803,3839,3797,3799,3725,3746,3753,-93,-86,68718,"257,931.78",81358
,20130315,3746,3753,3746,3859,3742,3807,3795,54,42,62206,"236,084.91",69910
,20130318,3807,3795,3798,3817,3751,3786,3788,-9,-7,36326,"137,612.79",63076
,20130319,3786,3788,3790,3798,3777,3795,3789,7,1,14784,"56,016.94",61174
,20130320,3795,3789,3795,3837,3780,3828,3817,39,28,19610,"74,869.29",57460
,20130321,3828,3817,3830,3865,3830,3840,3852,23,35,22198,"85,520.41",59280
,20130322,3840,3852,3836,3850,3806,3806,3827,-46,-25,11986,"45,875.96",56696
,20130325,3806,3827,3818,3848,3813,3836,3836,9,9,12590,"48,301.11",55040
,20130326,3836,3836,3831,3862,3810,3820,3833,-16,-3,13842,"53,064.00",55052
,20130327,3820,3833,3828,3848,3821,3831,3836,-2,3,14662,"56,245.47",51354
,20130328,3831,3836,3836,3841,3773,3780,3800,-56,-36,17706,"67,299.57",49484
,20130329,3780,3800,3772,3795,3740,3762,3770,-38,-30,11052,"41,668.66",47190
,20130401,3762,3770,3745,3754,3661,3667,3691,-103,-79,24742,"91,324.39",39038
,20130402,3667,3691,3667,3715,3661,3710,3689,19,-2,15830,"58,405.66",34140
,20130403,3710,3689,3707,3755,3701,3738,3732,49,43,18962,"70,779.27",29750
,20130408,3738,3732,3728,3756,3725,3750,3744,18,12,7296,"27,322.25",29304
,20130409,3750,3744,3767,3767,3735,3740,3745,-4,1,6146,"23,019.54",27896
,20130410,3740,3745,3744,3752,3716,3721,3731,-24,-14,3394,"12,666.15",27598
,20130411,3721,3731,3720,3750,3702,3702,3725,-29,-6,4374,"16,297.47",27108
,20130412,3702,3725,3706,3714,3696,3712,3702,-13,-23,3696,"13,685.60",25752
,20130415,3712,3702,3698,3700,3632,3645,3665,-57,-37,8992,"32,964.34",22438
,20130416,3645,3665,3620,3620,3553,3581,3579,-84,-86,16300,"58,351.83",17808
,20130417,3581,3579,3581,3599,3551,3562,3567,-17,-12,5396,"19,248.69",16536
,20130418,3562,3567,3520,3520,3444,3494,3490,-73,-77,5820,"20,313.58",15488
,20130419,3494,3490,3506,3529,3491,3516,3511,26,21,2496,"8,765.53",14758
,20130422,3516,3511,3537,3552,3500,3503,3522,-8,11,1702,"5,995.59",14396
,20130423,3503,3522,3503,3509,3465,3471,3473,-51,-49,4314,"14,986.49",13626
,20130424,3471,3473,3471,3498,3466,3477,3474,4,1,2994,"10,402.49",12962
,20130425,3477,3474,3480,3489,3467,3467,3472,-7,-2,1696,"5,889.35",12506
,20130426,3467,3472,3488,3500,3418,3500,3451,28,-21,4854,"16,754.97",12540
,20130502,3500,3451,3459,3475,3425,3450,3443,-1,-8,3420,"11,776.92",10080
,20130503,3450,3443,3450,3469,3450,3465,3461,22,18,1020,"3,530.34",9240
,20130506,3465,3461,3485,3485,3435,3447,3448,-14,-13,480,"1,655.22",9240
,20130507,3447,3448,3471,3480,3471,3480,3475,32,27,120,417.06,9180
,20130508,3480,3475,3480,3480,3477,3478,3478,3,3,300,"1,043.46",9180
,20130509,3478,3478,3480,3490,3400,3430,3458,-48,-20,540,"1,867.56",9060
,20130510,3430,3458,3465,3470,3401,3401,3439,-57,-19,540,"1,857.48",9000
,20130513,3401,3439,3401,3469,3401,3469,3440,30,1,720,"2,476.80",8940
,20130514,3469,3440,3462,3462,3405,3405,3427,-35,-13,420,"1,439.58",8880
,20130515,3405,3427,3401,3410,3391,3395,3400,-32,-27,1080,"3,672.48",8880
rb1306,20130104,3996,3975,3996,4022,3975,3999,3997,24,22,238,951.35,414
,20130107,3999,3997,4005,4053,3981,4007,4013,10,16,802,"3,218.97",372
,20130108,4007,4013,4004,4025,3980,4009,4015,-4,2,292,"1,172.63",372
,20130109,4009,4015,4004,4008,3982,3994,3991,-21,-24,254,"1,013.86",388
,20130110,3994,3991,3999,4036,3995,4016,4018,25,27,122,490.26,364
,20130111,4016,4018,4016,4025,3920,3928,3981,-90,-37,220,875.87,342
,20130114,3928,3981,3900,4025,3860,4010,3932,29,-49,644,"2,532.21",346
,20130115,4010,3932,4008,4008,3970,3980,3989,48,57,124,494.64,320
,20130116,3980,3989,3977,3977,3911,3940,3954,-49,-35,728,"2,879.16",406
,20130117,3940,3954,3954,3954,3910,3951,3930,-3,-24,170,668.17,326
,20130118,3951,3930,3985,3999,3969,3999,3984,69,54,214,852.58,324
,20130121,3999,3984,4000,4007,3971,3987,3994,3,10,264,"1,054.48",350
,20130122,3987,3994,3978,3991,3954,3986,3966,-8,-28,158,626.75,352
,20130123,3986,3966,3988,4048,3983,4048,4016,82,50,172,690.75,404
,20130124,4048,4016,4049,4060,4012,4040,4033,24,17,434,"1,750.55",404
,20130125,4040,4033,4045,4092,4042,4092,4064,59,31,688,"2,796.07",582
,20130128,4092,4064,4102,4102,4069,4084,4075,20,11,414,"1,687.28",444
,20130129,4084,4075,4070,4083,4062,4080,4072,5,-3,664,"2,704.23",338
,20130130,4080,4072,4115,4135,4111,4128,4127,56,55,62,255.91,346
,20130131,4128,4127,4122,4131,4114,4131,4121,4,-6,128,527.51,372
,20130201,4131,4121,4132,4172,4127,4172,4139,51,18,100,413.97,366
,20130204,4172,4139,4187,4230,4181,4220,4198,81,59,616,"2,586.33",714
,20130205,4220,4198,4189,4205,4123,4151,4172,-47,-26,454,"1,894.35",772
,20130206,4151,4172,4147,4149,4103,4103,4117,-69,-55,236,971.83,846
,20130207,4103,4117,4113,4137,4089,4129,4106,12,-11,234,960.85,776
,20130208,4129,4106,4156,4169,4135,4151,4155,45,49,242,"1,005.72",788
,20130218,4151,4155,4146,4146,4070,4070,4100,-85,-55,538,"2,206.09",994
,20130219,4070,4100,4081,4125,4081,4096,4106,-4,6,514,"2,110.93",1026
,20130220,4096,4106,4110,4118,4091,4099,4106,-7,0,168,689.88,1078
,20130221,4099,4106,4092,4092,4004,4032,4057,-74,-49,608,"2,466.81",800
,20130222,4032,4057,4036,4043,3992,3994,4017,-63,-40,370,"1,486.37",904
,20130225,3994,4017,3989,3998,3960,3968,3973,-49,-44,488,"1,939.25",770
,20130226,3968,3973,3950,3980,3940,3940,3965,-33,-8,58,229.97,778
,20130227,3940,3965,3950,3964,3925,3953,3934,-12,-31,480,"1,888.47",810
,20130228,3953,3934,3972,4015,3963,4007,3984,73,50,156,621.53,802
,20130301,4007,3984,3998,3998,3943,3966,3977,-18,-7,60,238.68,818
,20130304,3966,3977,3947,3952,3888,3893,3905,-84,-72,492,"1,921.43",762
,20130305,3893,3905,3858,3920,3858,3912,3911,7,6,104,406.85,754
,20130306,3912,3911,3938,3938,3933,3935,3935,24,24,20,78.7,768
,20130307,3935,3935,3911,3926,3911,3923,3919,-12,-16,56,219.5,748
,20130308,3923,3919,3907,3932,3895,3932,3914,13,-5,22,86.11,752
,20130311,3932,3914,3887,3928,3887,3924,3901,10,-13,84,327.75,728
,20130312,3924,3901,3910,3910,3903,3906,3905,5,4,62,242.13,696
,20130313,3906,3905,3890,4013,3821,3828,3872,-77,-33,242,937.04,768
,20130314,3828,3872,3787,3787,3754,3780,3772,-92,-100,72,271.61,772
,20130315,3780,3772,3787,3884,3780,3834,3826,62,54,166,635.25,808
,20130318,3834,3826,3826,3840,3781,3807,3800,-19,-26,242,919.7,774
,20130319,3807,3800,3812,3814,3804,3808,3808,8,8,38,144.72,780
,20130320,3808,3808,3795,3868,3792,3834,3843,26,35,310,"1,191.54",722
,20130321,3834,3843,3858,3892,3858,3885,3869,42,26,66,255.41,698
,20130322,3885,3869,3873,3873,3850,3860,3859,-9,-10,32,123.49,700
,20130325,3860,3859,3909,3948,3876,3895,3894,36,35,70,272.61,706
,20130326,3895,3894,3889,3920,3860,3879,3879,-15,-15,226,876.76,652
,20130327,3879,3879,3874,3886,3866,3874,3877,-5,-2,120,465.35,662
,20130328,3874,3877,3875,3880,3849,3857,3863,-20,-14,22,85,670
,20130329,3857,3863,3801,3807,3792,3792,3803,-71,-60,12,45.64,666
,20130401,3792,3803,3617,3764,3617,3736,3713,-67,-90,8,29.71,664
,20130402,3736,3713,3706,3726,3700,3726,3713,13,0,22,81.7,644
,20130403,3726,3713,3736,3774,3735,3761,3765,48,52,30,112.96,640
,20130408,3761,3765,3766,3823,3715,3771,3775,6,10,98,369.96,632
,20130409,3771,3775,3793,3793,3792,3793,3792,18,17,8,30.34,628
,20130410,3793,3792,3783,3783,3764,3781,3780,-11,-12,42,158.8,626
,20130411,3781,3780,3805,3820,3770,3770,3802,-10,22,64,243.35,630
,20130412,3770,3802,3764,3770,3763,3769,3768,-33,-34,60,226.13,624
,20130415,3769,3768,3722,3722,3661,3691,3686,-77,-82,24,88.47,608
,20130416,3691,3686,3660,3671,3620,3650,3643,-36,-43,156,568.38,692
,20130417,3650,3643,3669,3669,3577,3598,3632,-45,-11,134,486.72,666
,20130418,3598,3632,3503,3533,3503,3520,3520,-112,-112,76,267.59,646
,20130419,3520,3520,3549,3549,3517,3549,3534,29,14,200,706.82,472
,20130422,3549,3534,3565,3583,3541,3554,3565,20,31,410,"1,461.84",610
,20130423,3554,3565,3605,3605,3484,3505,3499,-60,-66,390,"1,364.69",474
,20130424,3505,3499,3496,3531,3495,3518,3508,19,9,20,70.17,470
,20130425,3518,3508,3508,3614,3503,3541,3549,33,41,104,369.17,482
,20130426,3541,3549,3538,3557,3484,3503,3530,-46,-19,192,677.92,476
,20130502,3503,3530,3535,3541,3451,3460,3468,-70,-62,132,457.83,410
,20130503,3460,3468,3467,3520,3467,3512,3505,44,37,84,294.46,404
,20130506,3512,3505,3544,3550,3476,3516,3521,11,16,40,140.85,398
,20130507,3516,3521,3472,3509,3472,3487,3487,-34,-34,14,48.82,398
,20130508,3487,3487,3491,3506,3491,3506,3499,19,12,22,76.98,388
,20130509,3506,3499,3501,3506,3490,3495,3495,-4,-4,116,405.46,286
,20130510,3495,3495,3482,3495,3482,3495,3488,0,-7,4,13.95,284
,20130513,3495,3488,3491,3521,3491,3518,3509,30,21,24,84.23,276
,20130514,3518,3509,3472,3480,3471,3471,3473,-38,-36,36,125.05,260
,20130515,3471,3473,3461,3471,3451,3453,3460,-20,-13,48,166.09,238
,20130516,3453,3460,3420,3438,3407,3413,3418,-47,-42,82,280.34,230
,20130517,3413,3418,3445,3476,3425,3476,3450,58,32,60,207.04,184
,20130520,3476,3450,3452,3456,3452,3456,3454,6,4,10,34.55,182
,20130521,3456,3454,3508,3545,3440,3440,3511,-14,57,146,512.64,222
,20130522,3440,3511,3510,3510,3432,3455,3478,-56,-33,22,76.53,224
,20130523,3455,3478,3484,3484,3421,3431,3443,-47,-35,106,364.97,222
,20130524,3431,3443,3418,3453,3418,3424,3428,-19,-15,8,27.43,220
,20130527,3424,3428,3365,3510,3365,3401,3454,-27,26,1812,"6,258.79",694
,20130528,3401,3454,3420,3420,3333,3387,3391,-67,-63,154,522.36,684
,20130529,3387,3391,3365,3396,3337,3337,3386,-54,-5,160,541.91,558
,20130530,3337,3386,3370,3370,3331,3347,3355,-39,-31,336,"1,127.52",494
,20130531,3347,3355,3331,3338,3187,3196,3244,-159,-111,478,"1,550.69",420
,20130603,3196,3244,3081,3250,3081,3250,3177,6,-67,360,"1,143.84",360
,20130604,3250,3177,3220,3227,3220,3227,3224,50,47,180,580.38,360
,20130605,3227,3224,3239,3239,3239,3239,3239,15,15,60,194.34,300
,20130606,3239,3239,,,,3235,3235,-4,-4,0,0,300
,20130607,3235,3235,,,,3231,3231,-4,-4,0,0,300
,20130613,3231,3231,,,,3230,3230,-1,-1,0,0,300
,20130614,3230,3230,,,,3210,3210,-20,-20,0,0,300
,20130617,3210,3210,,,,3210,3210,0,0,0,0,300
rb1307,20130104,3977,3948,3998,4008,3994,3994,3996,46,48,32,127.89,146
,20130107,3994,3996,4038,4038,3995,4033,4025,37,29,18,72.45,152
,20130108,4033,4025,3988,4028,3983,4024,4007,-1,-18,42,168.31,140
,20130109,4024,4007,3988,3999,3988,3999,3994,-8,-13,8,31.95,140
,20130110,3999,3994,4005,4019,4005,4019,4012,25,18,4,16.05,140
,20130111,4019,4012,3939,3939,3933,3933,3935,-79,-77,18,70.84,138
,20130114,3933,3935,4002,4002,4002,4002,4002,67,67,2,8,138
,20130115,4002,4002,3978,3989,3978,3985,3984,-17,-18,18,71.72,142
,20130116,3985,3984,3925,3925,3917,3917,3921,-67,-63,4,15.68,140
,20130117,3917,3921,3940,3940,3940,3940,3940,19,19,2,7.88,140
,20130118,3940,3940,,,,3994,3994,54,54,0,0,140
,20130121,3994,3994,,,,4004,4004,10,10,0,0,140
,20130122,4004,4004,3937,3995,3937,3995,3958,-9,-46,1866,"7,386.36",226
,20130123,3995,3958,3978,3992,3976,3992,3979,34,21,22,87.54,218
,20130124,3992,3979,4053,4053,4030,4038,4042,59,63,108,436.57,234
,20130125,4038,4042,4053,4149,4031,4067,4049,25,7,80,323.97,228
,20130128,4067,4049,4075,4080,4059,4080,4074,31,25,24,97.78,218
,20130129,4080,4074,4068,4074,4064,4072,4071,-2,-3,88,358.29,234
,20130130,4072,4071,4112,4147,4112,4140,4137,69,66,26,107.57,230
,20130131,4140,4137,4145,4146,4120,4120,4135,-17,-2,76,314.29,232
,20130201,4120,4135,4160,4168,4128,4168,4148,33,13,80,331.87,240
,20130204,4168,4148,4182,4231,4182,4231,4206,83,58,28,117.78,234
,20130205,4231,4206,4195,4205,4110,4155,4162,-51,-44,66,274.75,204
,20130206,4155,4162,4158,4177,4123,4135,4140,-27,-22,74,306.43,180
,20130207,4135,4140,4130,4135,4130,4135,4131,-5,-9,14,57.84,176
,20130208,4135,4131,4163,4175,4155,4175,4164,44,33,8,33.31,180
,20130218,4175,4164,4130,4130,4094,4094,4109,-70,-55,20,82.19,180
,20130219,4094,4109,4120,4121,4110,4110,4119,1,10,18,74.15,194
,20130220,4110,4119,4120,4130,4115,4115,4121,-4,2,6,24.73,192
,20130221,4115,4121,4016,4041,4016,4037,4034,-84,-87,26,104.9,184
,20130222,4037,4034,4023,4035,4000,4000,4019,-34,-15,24,96.48,204
,20130225,4000,4019,3992,4010,3986,3986,3997,-33,-22,28,111.94,204
,20130226,3986,3997,3965,4004,3958,3960,3972,-37,-25,128,508.52,242
,20130227,3960,3972,3963,3985,3937,3972,3969,0,-3,120,476.28,220
,20130228,3972,3969,3999,4031,3999,4031,4011,62,42,36,144.4,240
,20130301,4031,4011,4007,4008,3960,3975,3995,-36,-16,100,399.51,246
,20130304,3975,3995,3931,3938,3890,3908,3921,-87,-74,72,282.31,256
,20130305,3908,3921,3905,3931,3891,3911,3914,-10,-7,52,203.54,260
,20130306,3911,3914,3935,3946,3926,3946,3929,32,15,38,149.31,228
,20130307,3946,3929,3931,3932,3902,3902,3913,-27,-16,26,101.74,230
,20130308,3902,3913,3923,3925,3837,3915,3916,2,3,68,266.35,200
,20130311,3915,3916,3896,3933,3880,3908,3904,-8,-12,38,148.36,200
,20130312,3908,3904,,,,3904,3904,0,0,0,0,200
,20130313,3904,3904,3904,3904,3841,3865,3877,-39,-27,26,100.8,198
,20130314,3865,3877,3837,3837,3779,3779,3793,-98,-84,18,68.28,200
,20130315,3779,3793,3873,3919,3837,3859,3865,66,72,88,340.19,222
,20130318,3859,3865,3865,3875,3814,3851,3847,-14,-18,106,407.83,232
,20130319,3851,3847,3832,3832,3832,3832,3832,-15,-15,2,7.66,230
,20130320,3832,3832,,,,3845,3845,13,13,0,0,230
,20130321,3845,3845,3905,3921,3885,3885,3897,40,52,66,257.25,182
,20130322,3885,3897,3881,3892,3869,3869,3879,-28,-18,20,77.59,186
,20130325,3869,3879,3882,3894,3882,3893,3892,14,13,14,54.49,196
,20130326,3893,3892,3931,3931,3862,3886,3888,-6,-4,18,69.99,204
,20130327,3886,3888,3886,3898,3886,3886,3891,-2,3,8,31.13,202
,20130328,3886,3891,3859,3859,3794,3857,3849,-34,-42,38,146.28,192
,20130329,3857,3849,3823,3823,3817,3817,3819,-32,-30,6,22.91,190
,20130401,3817,3819,3733,3734,3722,3734,3724,-85,-95,36,134.07,172
,20130402,3734,3724,3723,3752,3723,3725,3736,1,12,8,29.89,168
,20130403,3725,3736,3781,3836,3762,3807,3808,71,72,58,220.91,194
,20130408,3807,3808,3781,3833,3781,3832,3813,24,5,126,480.49,214
,20130409,3832,3813,3848,3848,3846,3846,3847,33,34,12,46.17,212
,20130410,3846,3847,3834,3834,3817,3817,3832,-30,-15,22,84.31,192
,20130411,3817,3832,3859,3862,3808,3808,3844,-24,12,16,61.51,186
,20130412,3808,3844,3813,3827,3800,3800,3819,-44,-25,22,84.03,184
,20130415,3800,3819,3750,3750,3711,3711,3727,-108,-92,32,119.27,184
,20130416,3711,3727,3670,3700,3655,3700,3674,-27,-53,18,66.15,182
,20130417,3700,3674,3702,3704,3634,3650,3688,-24,14,82,302.48,242
,20130418,3650,3688,3562,3601,3562,3575,3571,-113,-117,30,107.14,240
,20130419,3575,3571,3564,3593,3564,3573,3583,2,12,164,587.71,236
,20130422,3573,3583,3606,3625,3570,3580,3593,-3,10,92,330.57,220
,20130423,3580,3593,3579,3579,3522,3522,3538,-71,-55,46,162.78,222
,20130424,3522,3538,3521,3550,3510,3550,3531,12,-7,36,127.15,214
,20130425,3550,3531,3553,3572,3552,3572,3562,41,31,56,199.48,172
,20130426,3572,3562,3572,3585,3521,3551,3547,-11,-15,54,191.55,152
,20130502,3551,3547,3486,3486,3486,3486,3486,-61,-61,4,13.94,148
,20130503,3486,3486,3506,3544,3503,3526,3520,40,34,16,56.33,146
,20130506,3526,3520,3565,3565,3541,3557,3556,37,36,10,35.56,144
,20130507,3557,3556,3594,3594,3585,3585,3589,29,33,4,14.36,146
,20130508,3585,3589,,,,3589,3589,0,0,0,0,146
,20130509,3589,3589,3589,3589,3553,3570,3568,-19,-21,20,71.38,144
,20130510,3570,3568,3555,3606,3529,3606,3562,38,-6,22,78.38,144
,20130513,3606,3562,3606,3633,3572,3611,3606,49,44,238,858.35,134
,20130514,3611,3606,3572,3588,3572,3588,3575,-18,-31,10,35.76,136
,20130515,3588,3575,3557,3579,3535,3539,3543,-36,-32,86,304.74,136
,20130516,3539,3543,3501,3529,3501,3528,3520,-15,-23,44,154.89,124
,20130517,3528,3520,3533,3580,3505,3580,3548,60,28,32,113.55,118
,20130520,3580,3548,3580,3585,3570,3575,3575,27,27,56,200.22,140
,20130521,3575,3575,3542,3551,3523,3525,3538,-50,-37,146,516.64,182
,20130522,3525,3538,3515,3569,3491,3528,3532,-10,-6,218,770.12,206
,20130523,3528,3532,3488,3519,3488,3519,3502,-13,-30,12,42.02,202
,20130524,3519,3502,3496,3496,3495,3495,3495,-7,-7,18,62.92,194
,20130527,3495,3495,,,,3474,3474,-21,-21,0,0,194
,20130528,3474,3474,3425,3450,3425,3440,3438,-34,-36,206,708.41,318
,20130529,3440,3438,3399,3405,3387,3387,3396,-51,-42,10,33.96,312
,20130530,3387,3396,3384,3407,3384,3391,3395,-5,-1,26,88.27,296
,20130531,3391,3395,3403,3403,3339,3339,3377,-56,-18,126,425.52,248
,20130603,3339,3377,3370,3370,3338,3369,3360,-8,-17,178,598.09,250
,20130604,3369,3360,3374,3374,3349,3351,3360,-9,0,56,188.16,282
,20130605,3351,3360,3351,3351,3310,3316,3326,-44,-34,138,459.05,284
,20130606,3316,3326,3299,3299,3217,3227,3241,-99,-85,48,155.61,274
,20130607,3227,3241,3226,3316,3222,3243,3245,2,4,106,344.06,220
,20130613,3243,3245,3230,3268,3230,3268,3260,23,15,104,339.1,146
,20130614,3268,3260,3260,3288,3260,3275,3276,15,16,30,98.28,132
,20130617,3275,3276,3299,3350,3299,3305,3320,29,44,212,703.96,132
,20130618,3305,3320,3309,3309,3302,3302,3304,-18,-16,6,19.83,130
,20130619,3302,3304,3314,3314,3314,3314,3314,10,10,2,6.63,130
,20130620,3314,3314,3300,3317,3300,3300,3305,-14,-9,36,118.99,126
,20130621,3300,3305,3238,3327,3238,3305,3296,0,-9,46,151.64,120
,20130624,3305,3296,3196,3196,3196,3196,3196,-100,-100,2,6.39,120
,20130625,3196,3196,3240,3252,3200,3249,3209,53,13,80,256.72,172
,20130626,3249,3209,3209,3257,3161,3188,3199,-21,-10,82,262.4,166
,20130627,3188,3199,3180,3220,3180,3190,3201,-9,2,12,38.42,166
,20130628,3190,3201,3120,3212,3120,3162,3165,-39,-36,58,183.57,132
,20130701,3162,3165,3162,3162,3162,3162,3162,-3,-3,12,37.94,120
,20130702,3162,3162,,,,3162,3162,0,0,0,0,120
,20130703,3162,3162,,,,3162,3162,0,0,0,0,120
,20130704,3162,3162,,,,3162,3162,0,0,0,0,120
,20130705,3162,3162,,,,3162,3162,0,0,0,0,120
,20130708,3162,3162,,,,3162,3162,0,0,0,0,120
,20130709,3162,3162,,,,3162,3162,0,0,0,0,120
,20130710,3162,3162,,,,3162,3162,0,0,0,0,120
,20130711,3162,3162,,,,3162,3162,0,0,0,0,120
,20130712,3162,3162,,,,3162,3162,0,0,0,0,120
,20130715,3162,3162,,,,3162,3162,0,0,0,0,120
rb1308,20130104,3979,3978,4014,4014,3971,4001,3989,23,11,38,151.6,136
,20130107,4001,3989,4045,4045,4001,4024,4020,35,31,50,201.03,142
,20130108,4024,4020,4016,4018,3990,4018,4007,-2,-13,18,72.13,134
,20130109,4018,4007,4007,4007,3989,3990,3992,-17,-15,12,47.91,142
,20130110,3990,3992,,,,4009,4009,17,17,0,0,142
,20130111,4009,4009,3998,3998,3922,3945,3971,-64,-38,16,63.54,142
,20130114,3945,3971,3904,4012,3904,4002,3978,31,7,8,31.83,138
,20130115,4002,3978,3979,3987,3972,3983,3978,5,0,220,875.17,140
,20130116,3983,3978,3942,3942,3912,3932,3929,-46,-49,14,55.01,140
,20130117,3932,3929,3926,3935,3926,3935,3930,6,1,4,15.72,138
,20130118,3935,3930,,,,3984,3984,54,54,0,0,138
,20130121,3984,3984,3992,3992,3980,3989,3990,5,6,38,151.62,166
,20130122,3989,3990,3959,3959,3959,3959,3959,-31,-31,14,55.43,156
,20130123,3959,3959,3959,3959,3959,3959,3959,0,0,2,7.92,156
,20130124,3959,3959,,,,3960,3960,1,1,0,0,156
,20130125,3960,3960,4063,4063,4033,4063,4046,103,86,12,48.56,154
,20130128,4063,4046,4079,4097,4067,4087,4084,41,38,1150,"4,696.74",194
,20130129,4087,4084,4066,4091,4066,4091,4080,7,-4,32,130.58,188
,20130130,4091,4080,4120,4148,4120,4143,4141,63,61,36,149.1,204
,20130131,4143,4141,4131,4133,4125,4133,4128,-8,-13,26,107.35,192
,20130201,4133,4128,4130,4174,4130,4174,4142,46,14,14,57.99,190
,20130204,4174,4142,4189,4235,4189,4235,4203,93,61,22,92.47,184
,20130205,4235,4203,4194,4233,4194,4200,4214,-3,11,54,227.6,178
,20130206,4200,4214,4153,4221,4126,4149,4167,-65,-47,28,116.69,176
,20130207,4149,4167,4161,4206,4150,4195,4171,28,4,22,91.78,170
,20130208,4195,4171,4210,4210,4188,4188,4203,17,32,10,42.03,166
,20130218,4188,4203,4168,4168,4121,4121,4143,-82,-60,14,58.01,164
,20130219,4121,4143,4132,4142,4123,4135,4135,-8,-8,20,82.72,162
,20130220,4135,4135,4135,4135,4119,4129,4127,-6,-8,12,49.52,158
,20130221,4129,4127,4087,4101,4031,4048,4069,-79,-58,62,252.28,146
,20130222,4048,4069,4048,4048,4020,4025,4035,-44,-34,38,153.34,142
,20130225,4025,4035,,,,4024,4024,-11,-11,0,0,142
,20130226,4024,4024,4015,4015,4015,4015,4015,-9,-9,2,8.03,142
,20130227,4015,4015,3961,3981,3959,3959,3965,-56,-50,94,372.79,212
,20130228,3959,3965,4003,4041,3996,4033,4015,68,50,32,128.48,208
,20130301,4033,4015,4035,4035,3981,3981,4012,-34,-3,34,136.41,228
,20130304,3981,4012,3910,3910,3870,3891,3886,-121,-126,26,101.05,222
,20130305,3891,3886,3895,3916,3890,3916,3902,30,16,40,156.1,208
,20130306,3916,3902,3953,3953,3919,3919,3934,17,32,28,110.16,208
,20130307,3919,3934,3916,3935,3913,3913,3922,-21,-12,16,62.76,206
,20130308,3913,3922,3906,3906,3890,3891,3895,-31,-27,6,23.37,208
,20130311,3891,3895,3891,3920,3872,3906,3887,11,-8,34,132.18,212
,20130312,3906,3887,3912,3931,3894,3902,3914,15,27,30,117.45,202
,20130313,3902,3914,3870,3870,3841,3849,3861,-65,-53,16,61.78,192
,20130314,3849,3861,3792,3818,3778,3785,3791,-76,-70,82,310.91,200
,20130315,3785,3791,3872,3886,3832,3886,3858,95,67,24,92.61,200
,20130318,3886,3858,3838,3879,3822,3822,3855,-36,-3,20,77.12,196
,20130319,3822,3855,3851,3851,3847,3847,3848,-8,-7,8,30.78,190
,20130320,3847,3848,3862,3895,3862,3895,3871,47,23,42,162.62,204
,20130321,3895,3871,3921,3952,3921,3928,3932,57,61,24,94.39,202
,20130322,3928,3932,3915,3918,3910,3910,3917,-22,-15,26,101.85,206
,20130325,3910,3917,3936,3936,3903,3921,3921,4,4,60,235.29,210
,20130326,3921,3921,3938,3939,3876,3903,3905,-18,-16,64,249.92,214
,20130327,3903,3905,3900,3920,3889,3889,3909,-16,4,36,140.74,210
,20130328,3889,3909,3911,3911,3836,3836,3841,-73,-68,146,560.8,330
,20130329,3836,3841,3822,3822,3822,3822,3822,-19,-19,2,7.64,328
,20130401,3822,3822,3775,3776,3718,3759,3749,-63,-73,36,134.99,340
,20130402,3759,3749,3764,3774,3741,3754,3752,5,3,32,120.09,344
,20130403,3754,3752,3768,3874,3761,3803,3795,51,43,220,835.03,334
,20130408,3803,3795,3787,3845,3761,3845,3800,50,5,74,281.21,336
,20130409,3845,3800,3863,3863,3841,3849,3850,49,50,22,84.72,338
,20130410,3849,3850,3844,3844,3836,3836,3839,-14,-11,10,38.4,334
,20130411,3836,3839,3867,3884,3815,3815,3866,-24,27,26,100.52,332
,20130412,3815,3866,3811,3832,3802,3802,3814,-64,-52,12,45.78,326
,20130415,3802,3814,3755,3768,3712,3717,3732,-97,-82,50,186.61,340
,20130416,3717,3732,3655,3725,3643,3725,3678,-7,-54,96,353.15,366
,20130417,3725,3678,3730,3758,3631,3646,3720,-32,42,990,"3,682.85",420
,20130418,3646,3720,3569,3640,3560,3624,3602,-96,-118,52,187.31,424
,20130419,3624,3602,3443,3648,3443,3635,3612,33,10,34,122.82,422
,20130422,3635,3612,3632,3641,3606,3606,3622,-6,10,24,86.94,428
,20130423,3606,3622,3562,3608,3541,3541,3573,-81,-49,38,135.78,422
,20130424,3541,3573,3561,3632,3533,3622,3599,49,26,104,374.37,456
,20130425,3622,3599,3626,3627,3599,3605,3602,6,3,106,381.91,520
,20130426,3605,3602,3641,3653,3562,3573,3617,-29,15,48,173.65,516
,20130502,3573,3617,3513,3525,3498,3498,3510,-119,-107,32,112.34,520
,20130503,3498,3510,3548,3566,3534,3557,3547,47,37,28,99.32,510
,20130506,3557,3547,3652,3688,3590,3593,3606,46,59,78,281.3,510
,20130507,3593,3606,3593,3616,3593,3597,3603,-9,-3,150,540.46,516
,20130508,3597,3603,3606,3628,3605,3620,3617,17,14,38,137.45,486
,20130509,3620,3617,3606,3611,3563,3588,3592,-29,-25,86,308.96,474
,20130510,3588,3592,3578,3592,3571,3592,3582,0,-10,20,71.64,476
,20130513,3592,3582,3676,3676,3656,3656,3666,74,84,4,14.66,474
,20130514,3656,3666,3654,3654,3591,3627,3634,-39,-32,114,414.35,554
,20130515,3627,3634,3600,3600,3554,3554,3582,-80,-52,38,136.13,548
,20130516,3554,3582,3545,3569,3521,3548,3551,-34,-31,180,639.29,426
,20130517,3548,3551,3570,3605,3570,3605,3577,54,26,76,271.88,418
,20130520,3605,3577,3640,3645,3585,3603,3621,26,44,28,101.39,422
,20130521,3603,3621,3592,3592,3589,3589,3591,-32,-30,26,93.38,426
,20130522,3589,3591,3565,3565,3565,3565,3565,-26,-26,2,7.13,424
,20130523,3565,3565,3553,3553,3539,3543,3547,-22,-18,12,42.56,420
,20130524,3543,3547,3519,3557,3519,3554,3553,7,6,64,227.44,446
,20130527,3554,3553,3479,3515,3478,3485,3499,-68,-54,252,881.94,446
,20130528,3485,3499,3467,3490,3467,3490,3474,-9,-25,6,20.85,446
,20130529,3490,3474,3487,3487,3430,3430,3469,-44,-5,70,242.84,412
,20130530,3430,3469,3442,3446,3434,3436,3438,-33,-31,10,34.39,414
,20130531,3436,3438,3440,3440,3408,3408,3417,-30,-21,10,34.17,410
,20130603,3408,3417,3413,3431,3406,3419,3420,2,3,128,437.77,434
,20130604,3419,3420,3427,3430,3409,3417,3418,-3,-2,70,239.3,440
,20130605,3417,3418,3420,3420,3392,3401,3400,-17,-18,92,312.87,474
,20130606,3401,3400,3390,3390,3313,3318,3343,-82,-57,352,"1,176.83",406
,20130607,3318,3343,3385,3385,3290,3335,3335,-8,-8,350,"1,167.36",482
,20130613,3335,3335,3390,3390,3345,3367,3357,32,22,162,543.87,426
,20130614,3367,3357,3367,3375,3326,3375,3356,18,-1,16,53.71,426
,20130617,3375,3356,3399,3445,3399,3425,3433,69,77,94,322.77,368
,20130618,3425,3433,3427,3430,3426,3430,3427,-3,-6,6,20.57,368
,20130619,3430,3427,3430,3450,3423,3450,3432,23,5,46,157.88,372
,20130620,3450,3432,3425,3425,3378,3395,3396,-37,-36,102,346.46,354
,20130621,3395,3396,3368,3464,3235,3410,3348,14,-48,234,783.52,220
,20130624,3410,3348,3402,3402,3340,3340,3351,-8,3,108,361.93,168
,20130625,3340,3351,3338,3357,3324,3357,3335,6,-16,30,100.07,158
,20130626,3357,3335,,,,3325,3325,-10,-10,0,0,158
,20130627,3325,3325,3324,3370,3324,3370,3345,45,20,10,33.45,158
,20130628,3370,3345,3363,3393,3359,3361,3371,16,26,38,128.1,172
,20130701,3361,3371,3354,3393,3341,3369,3361,-2,-10,46,154.62,166
,20130702,3369,3361,3379,3389,3379,3387,3382,26,21,20,67.66,156
,20130703,3387,3382,3409,3433,3403,3433,3414,51,32,14,47.81,152
,20130704,3433,3414,3428,3453,3428,3438,3438,24,24,48,165.04,144
,20130705,3438,3438,3436,3436,3436,3436,3436,-2,-2,8,27.49,140
,20130708,3436,3436,3400,3410,3395,3395,3401,-41,-35,32,108.86,126
,20130709,3395,3401,3382,3409,3378,3388,3391,-13,-10,30,101.76,110
,20130710,3388,3391,3364,3394,3364,3394,3383,3,-8,8,27.06,104
,20130711,3394,3383,3416,3443,3399,3443,3424,60,41,26,89.03,102
,20130712,3443,3424,3428,3431,3402,3431,3420,7,-4,20,68.41,102
,20130715,3431,3420,3451,3454,3421,3421,3433,1,13,14,48.07,100
,20130716,3421,3433,3432,3441,3417,3441,3431,8,-2,48,164.73,82
,20130717,3441,3431,3459,3530,3459,3500,3490,69,59,26,90.76,78
,20130718,3500,3490,3494,3494,3494,3494,3494,4,4,4,13.98,78
,20130719,3494,3494,3533,3540,3533,3540,3536,46,42,4,14.15,80
,20130722,3540,3536,3511,3560,3502,3518,3526,-18,-10,22,77.57,76
,20130723,3518,3526,3527,3533,3500,3500,3509,-26,-17,20,70.2,66
,20130724,3500,3509,3470,3494,3470,3484,3479,-25,-30,8,27.84,68
,20130725,3484,3479,3450,3450,3450,3450,3450,-29,-29,2,6.9,66
,20130726,3450,3450,3537,3537,3396,3410,3428,-40,-22,148,507.38,30
,20130729,3410,3428,3411,3413,3411,3413,3412,-15,-16,4,13.65,26
,20130730,3413,3412,3405,3405,3405,3405,3405,-7,-7,6,20.43,20
,20130731,3405,3405,3380,3387,3380,3380,3381,-25,-24,26,87.92,0
,20130801,3380,3381,,,,3381,3381,0,0,0,0,0
,20130802,3381,3381,,,,3381,3381,0,0,0,0,0
,20130805,3381,3381,,,,3381,3381,0,0,0,0,0
,20130806,3381,3381,,,,3381,3381,0,0,0,0,0
,20130807,3381,3381,,,,3381,3381,0,0,0,0,0
,20130808,3381,3381,,,,3381,3381,0,0,0,0,0
,20130809,3381,3381,,,,3381,3381,0,0,0,0,0
,20130812,3381,3381,,,,3381,3381,0,0,0,0,0
,20130813,3381,3381,,,,3381,3381,0,0,0,0,0
,20130814,3381,3381,,,,3381,3381,0,0,0,0,0
,20130815,3381,3381,,,,3381,3381,0,0,0,0,0
rb1309,20130104,3992,3976,4043,4043,3979,4002,4005,26,29,546,"2,186.91",938
,20130107,4002,4005,4009,4050,4009,4020,4031,15,26,1098,"4,426.92",968
,20130108,4020,4031,4019,4030,3987,4022,4004,-9,-27,1104,"4,421.32",1166
,20130109,4022,4004,4025,4025,3997,4011,4009,7,5,560,"2,245.24",1054
,20130110,4011,4009,4035,4037,4010,4030,4024,21,15,840,"3,380.55",1078
,20130111,4030,4024,4030,4035,3920,3934,3990,-90,-34,2174,"8,674.89",1140
,20130114,3934,3990,3935,4029,3900,4004,3984,14,-6,1458,"5,809.89",1140
,20130115,4004,3984,4025,4025,3970,3988,3993,4,9,778,"3,107.09",1120
,20130116,3988,3993,3980,3980,3912,3945,3949,-48,-44,686,"2,709.03",1172
,20130117,3945,3949,3952,3960,3916,3950,3935,1,-14,754,"2,967.52",1156
,20130118,3950,3935,3970,4008,3966,4008,3983,73,48,890,"3,545.46",1160
,20130121,4008,3983,3987,4017,3976,3985,3999,2,16,868,"3,471.31",1228
,20130122,3985,3999,3983,3999,3966,3996,3981,-3,-18,674,"2,683.37",1262
,20130123,3996,3981,3992,4059,3992,4056,4012,75,31,1294,"5,192.17",1352
,20130124,4056,4012,4061,4072,4017,4042,4045,30,33,2380,"9,628.88",1486
,20130125,4042,4045,4116,4116,4045,4085,4069,40,24,1356,"5,518.15",1638
,20130128,4085,4069,4078,4098,4069,4095,4085,26,16,1626,"6,643.46",1724
,20130129,4095,4085,4088,4112,4069,4093,4086,8,1,688,"2,811.58",1714
,20130130,4093,4086,4115,4159,4104,4141,4136,55,50,1986,"8,214.30",1900
,20130131,4141,4136,4149,4168,4119,4142,4137,6,1,1038,"4,295.24",2000
,20130201,4142,4137,4120,4194,4120,4186,4158,49,21,2270,"9,440.12",2192
,20130204,4186,4158,4217,4241,4184,4236,4217,78,59,2560,"10,797.25",2276
,20130205,4236,4217,4200,4269,4182,4238,4243,21,26,13302,"56,447.87",2598
,20130206,4238,4243,4295,4295,4180,4190,4224,-53,-19,10680,"45,116.32",3596
,20130207,4190,4224,4200,4240,4170,4220,4205,-4,-19,8582,"36,089.91",3188
,20130208,4220,4205,4241,4241,4201,4211,4223,6,18,6724,"28,400.10",2220
,20130218,4211,4223,4239,4239,4022,4132,4180,-91,-43,5484,"22,924.28",2604
,20130219,4132,4180,4144,4180,4131,4151,4153,-29,-27,6094,"25,311.67",2874
,20130220,4151,4153,4157,4187,4118,4136,4147,-17,-6,4684,"19,429.22",2942
,20130221,4136,4147,4116,4120,4025,4064,4059,-83,-88,17854,"72,483.17",3648
,20130222,4064,4059,4040,4069,4008,4012,4041,-47,-18,5470,"22,105.81",3384
,20130225,4012,4041,4029,4030,3976,3996,4006,-45,-35,6254,"25,057.62",3468
,20130226,3996,4006,3988,4007,3930,3935,3971,-71,-35,5818,"23,103.80",3100
,20130227,3935,3971,3960,3994,3922,3973,3963,2,-8,7428,"29,439.56",2720
,20130228,3973,3963,3986,4048,3976,4039,4027,76,64,12292,"49,502.37",2906
,20130301,4039,4027,4027,4033,3947,4002,3993,-25,-34,5182,"20,694.26",3028
,20130304,4002,3993,3943,3970,3865,3899,3899,-94,-94,15914,"62,054.93",3290
,20130305,3899,3899,3899,3942,3876,3923,3911,24,12,10862,"42,487.16",3334
,20130306,3923,3911,3939,3960,3909,3932,3938,21,27,7660,"30,168.71",3124
,20130307,3932,3938,3934,3944,3912,3926,3931,-12,-7,11686,"45,948.65",3272
,20130308,3926,3931,3935,3954,3864,3930,3921,-1,-10,7806,"30,610.80",3188
,20130311,3930,3921,3925,3943,3880,3917,3910,-4,-11,11018,"43,090.15",3458
,20130312,3917,3910,3905,3925,3881,3904,3903,-6,-7,11566,"45,149.86",3600
,20130313,3904,3903,3893,3909,3837,3848,3870,-55,-33,14896,"57,651.79",4644
,20130314,3848,3870,3827,3838,3750,3784,3789,-86,-81,20818,"78,895.20",6164
,20130315,3784,3789,3800,3931,3785,3877,3853,88,64,14268,"54,980.73",4866
,20130318,3877,3853,3851,3875,3802,3841,3843,-12,-10,9092,"34,941.13",4388
,20130319,3841,3843,3829,3865,3811,3859,3845,16,2,5064,"19,475.06",4114
,20130320,3859,3845,3844,3899,3839,3888,3875,43,30,4962,"19,232.06",3834
,20130321,3888,3875,3891,3946,3891,3919,3923,44,48,6404,"25,125.74",3886
,20130322,3919,3923,3893,3942,3887,3891,3909,-32,-14,5356,"20,938.86",3386
,20130325,3891,3909,3882,3929,3882,3916,3916,7,7,5186,"20,311.08",3430
,20130326,3916,3916,3910,3955,3881,3891,3911,-25,-5,8498,"33,238.06",3588
,20130327,3891,3911,3891,3919,3884,3890,3904,-21,-7,5634,"21,998.75",3448
,20130328,3890,3904,3902,3911,3816,3823,3850,-81,-54,11234,"43,251.92",3974
,20130329,3823,3850,3793,3834,3730,3804,3805,-46,-45,9742,"37,072.64",4136
,20130401,3804,3805,3792,3792,3717,3730,3750,-75,-55,14720,"55,204.35",4080
,20130402,3730,3750,3730,3768,3702,3762,3735,12,-15,12322,"46,030.46",3870
,20130403,3762,3735,3765,3821,3749,3800,3792,65,57,25114,"95,245.76",4340
,20130408,3800,3792,3780,3844,3763,3832,3803,40,11,17286,"65,749.08",4660
,20130409,3832,3803,3851,3858,3820,3844,3841,41,38,18688,"71,782.00",5030
,20130410,3844,3841,3865,3865,3817,3838,3837,-3,-4,8720,"33,464.94",4386
,20130411,3838,3837,3848,3879,3806,3813,3855,-24,18,12132,"46,774.90",4186
,20130412,3813,3855,3824,3834,3805,3827,3819,-28,-36,8622,"32,930.56",4196
,20130415,3827,3819,3793,3793,3699,3722,3744,-97,-75,13968,"52,309.06",4406
,20130416,3722,3744,3660,3745,3650,3731,3703,-13,-41,18730,"69,358.59",4112
,20130417,3731,3703,3760,3773,3660,3682,3703,-21,0,15200,"56,295.00",4442
,20130418,3682,3703,3600,3666,3582,3630,3620,-73,-83,21946,"79,453.28",4410
,20130419,3630,3620,3637,3679,3621,3667,3647,47,27,13242,"48,293.96",4092
,20130422,3667,3647,3693,3694,3623,3627,3650,-20,3,9124,"33,309.96",4272
,20130423,3627,3650,3670,3670,3564,3580,3603,-70,-47,14652,"52,805.76",4232
,20130424,3580,3603,3590,3662,3561,3625,3597,22,-6,12012,"43,213.47",4258
,20130425,3625,3597,3630,3645,3605,3623,3624,26,27,8438,"30,581.21",4094
,20130426,3623,3624,3635,3670,3590,3592,3622,-32,-2,10312,"37,354.52",3992
,20130502,3592,3622,3546,3560,3522,3533,3537,-89,-85,6450,"22,814.78",3860
,20130503,3533,3537,3541,3601,3533,3568,3570,31,33,11646,"41,580.96",3650
,20130506,3568,3570,3613,3640,3596,3611,3609,41,39,7070,"25,519.02",3508
,20130507,3611,3609,3609,3644,3588,3615,3613,6,4,6412,"23,168.31",3672
,20130508,3615,3613,3615,3663,3612,3663,3638,50,25,7640,"27,800.38",3976
,20130509,3663,3638,3670,3670,3602,3612,3623,-26,-15,9344,"33,855.80",3800
,20130510,3612,3623,3612,3640,3582,3631,3613,8,-10,15688,"56,681.21",4250
,20130513,3631,3613,3631,3680,3621,3652,3650,39,37,18312,"66,844.04",4306
,20130514,3652,3650,3660,3665,3610,3629,3636,-21,-14,11686,"42,494.68",4060
,20130515,3629,3636,3629,3629,3551,3553,3584,-83,-52,12206,"43,754.56",5190
,20130516,3553,3584,3553,3584,3526,3552,3556,-32,-28,17088,"60,772.89",6124
,20130517,3552,3556,3522,3622,3522,3610,3580,54,24,26938,"96,440.10",5372
,20130520,3610,3580,3626,3635,3581,3592,3610,12,30,11462,"41,384.30",5260
,20130521,3592,3610,3600,3611,3556,3573,3581,-37,-29,10916,"39,099.40",5490
,20130522,3573,3581,3570,3602,3556,3589,3584,8,3,9568,"34,294.01",5226
,20130523,3589,3584,3587,3587,3540,3550,3564,-34,-20,13448,"47,930.95",5468
,20130524,3550,3564,3560,3583,3541,3567,3565,3,1,4880,"17,400.76",5196
,20130527,3567,3565,3556,3693,3501,3501,3518,-64,-47,15890,"55,903.63",6460
,20130528,3501,3518,3510,3511,3488,3494,3496,-24,-22,8644,"30,225.30",6368
,20130529,3494,3496,3483,3503,3439,3448,3478,-48,-18,9842,"34,231.38",6192
,20130530,3448,3478,3443,3460,3422,3447,3446,-31,-32,6274,"21,621.25",6220
,20130531,3447,3446,3490,3490,3413,3422,3440,-24,-6,7374,"25,371.51",5642
,20130603,3422,3440,3429,3477,3420,3472,3451,32,11,10340,"35,689.12",5574
,20130604,3472,3451,3480,3486,3446,3462,3463,11,12,6744,"23,355.18",5646
,20130605,3462,3463,3450,3477,3450,3465,3465,2,2,3400,"11,783.93",5450
,20130606,3465,3465,3443,3456,3388,3392,3415,-73,-50,9586,"32,738.76",5980
,20130607,3392,3415,3392,3404,3365,3403,3386,-12,-29,5536,"18,747.07",5414
,20130613,3403,3386,3386,3424,3373,3400,3405,14,19,7110,"24,214.33",4712
,20130614,3400,3405,3405,3414,3371,3411,3400,6,-5,3556,"12,092.82",4762
,20130617,3411,3400,3420,3483,3420,3453,3462,53,62,4428,"15,333.95",4344
,20130618,3453,3462,3469,3469,3449,3462,3460,0,-2,2320,"8,027.88",4376
,20130619,3462,3460,3470,3495,3441,3494,3473,34,13,5448,"18,923.03",5152
,20130620,3494,3473,3470,3475,3416,3440,3444,-33,-29,5724,"19,716.13",5868
,20130621,3440,3444,3380,3499,3380,3464,3452,20,8,8866,"30,608.52",5612
,20130624,3464,3452,3488,3488,3400,3406,3440,-46,-12,5644,"19,417.28",4328
,20130625,3406,3440,3381,3426,3381,3416,3402,-24,-38,6352,"21,613.62",4030
,20130626,3416,3402,3414,3427,3380,3400,3395,-2,-7,5728,"19,451.66",3816
,20130627,3400,3395,3405,3455,3384,3440,3429,45,34,5740,"19,683.47",3750
,20130628,3440,3429,3422,3468,3422,3449,3447,20,18,3510,"12,101.38",3750
,20130701,3449,3447,3450,3459,3426,3451,3443,4,-4,2514,"8,657.17",3704
,20130702,3451,3443,3462,3470,3450,3460,3461,17,18,2334,"8,079.92",3416
,20130703,3460,3461,3464,3514,3458,3501,3486,40,25,3562,"12,417.47",3386
,20130704,3501,3486,3501,3516,3494,3501,3504,15,18,1850,"6,483.62",3386
,20130705,3501,3504,3509,3517,3498,3500,3505,-4,1,1562,"5,476.32",3316
,20130708,3500,3505,3493,3507,3466,3490,3484,-15,-21,1664,"5,798.41",3170
,20130709,3490,3484,3495,3509,3471,3493,3493,9,9,1226,"4,283.11",3188
,20130710,3493,3493,3488,3518,3470,3515,3496,22,3,1582,"5,530.78",3200
,20130711,3515,3496,3519,3562,3507,3509,3528,13,32,1850,"6,527.16",3130
,20130712,3509,3528,3514,3523,3507,3510,3515,-18,-13,608,"2,137.23",3156
,20130715,3510,3515,3520,3540,3519,3519,3529,4,14,742,"2,618.57",3146
,20130716,3519,3529,3528,3540,3521,3531,3528,2,-1,522,"1,841.69",3126
,20130717,3531,3528,3532,3570,3532,3532,3540,4,12,700,"2,478.66",3028
,20130718,3532,3540,3529,3536,3524,3536,3530,-4,-10,268,946.17,2932
,20130719,3536,3530,3547,3578,3546,3553,3559,23,29,776,"2,761.94",2676
,20130722,3553,3559,3541,3557,3510,3557,3531,-2,-28,482,"1,702.41",2638
,20130723,3557,3531,3548,3560,3544,3552,3550,21,19,228,809.57,2586
,20130724,3552,3550,3560,3571,3544,3551,3558,1,8,294,"1,046.28",2572
,20130725,3551,3558,3538,3558,3538,3548,3546,-10,-12,114,404.31,2566
,20130726,3548,3546,3546,3546,3521,3527,3531,-19,-15,396,"1,398.35",2566
,20130729,3527,3531,3503,3520,3492,3504,3506,-27,-25,382,"1,339.63",2468
,20130730,3504,3506,3505,3505,3490,3490,3497,-16,-9,246,860.48,2416
,20130731,3490,3497,3480,3527,3480,3504,3513,7,16,690,"2,424.52",2296
,20130801,3504,3513,3518,3519,3505,3505,3510,-8,-3,62,217.68,2254
,20130802,3505,3510,3514,3580,3514,3514,3525,4,15,186,655.66,2244
,20130805,3514,3525,3529,3530,3519,3521,3522,-4,-3,254,894.64,2252
,20130806,3521,3522,3522,3530,3511,3521,3519,-1,-3,170,598.27,2228
,20130807,3521,3519,3517,3537,3513,3523,3525,4,6,356,"1,255.01",2216
,20130808,3523,3525,3536,3553,3534,3551,3542,26,17,342,"1,211.44",2084
,20130809,3551,3542,3538,3556,3514,3554,3537,12,-5,254,898.45,2050
,20130812,3554,3537,3553,3611,3546,3573,3573,36,36,336,"1,200.61",1982
,20130813,3573,3573,3600,3600,3570,3585,3576,12,3,316,"1,130.20",1938
,20130814,3585,3576,3581,3593,3549,3564,3570,-12,-6,306,"1,092.67",1894
,20130815,3564,3570,3556,3556,3531,3531,3551,-39,-19,56,198.86,1842
,20130816,3531,3551,3545,3545,3494,3505,3505,-46,-46,60,210.33,1838
,20130819,3505,3505,3500,3557,3500,3505,3523,0,18,184,648.38,1822
,20130820,3505,3523,3503,3535,3502,3503,3523,-20,0,538,"1,895.64",1798
,20130821,3503,3523,3506,3506,3500,3500,3505,-23,-18,582,"2,040.20",1730
,20130822,3500,3505,3483,3500,3428,3452,3467,-53,-38,146,506.19,1718
,20130823,3452,3467,3505,3509,3413,3454,3454,-13,-13,188,649.43,1704
,20130826,3454,3454,3487,3487,3421,3430,3443,-24,-11,80,275.51,1696
,20130827,3430,3443,3435,3457,3435,3457,3438,14,-5,134,460.76,1700
,20130828,3457,3438,3445,3448,3400,3401,3434,-37,-4,238,817.35,1684
,20130829,3401,3434,3400,3400,3352,3386,3385,-48,-49,176,595.92,1684
,20130830,3386,3385,3380,3471,3309,3393,3392,8,7,182,617.43,1680
,20130902,3393,3392,3470,3470,3470,3470,3470,78,78,60,208.2,1680
,20130903,3470,3470,3411,3411,3411,3411,3411,-59,-59,60,204.66,1680
,20130904,3411,3411,3411,3411,3404,3404,3407,-7,-4,120,408.9,1680
,20130905,3404,3407,3418,3418,3418,3418,3418,11,11,60,205.08,1680
,20130906,3418,3418,,,,3418,3418,0,0,0,0,1680
,20130909,3418,3418,3411,3411,3411,3411,3411,-7,-7,60,204.66,1680
,20130910,3411,3411,3400,3410,3400,3410,3405,-1,-6,360,"1,226.10",1680
,20130911,3410,3405,3419,3419,3392,3405,3404,0,-1,240,816.96,1680
,20130912,3405,3404,3405,3405,3402,3402,3403,-2,-1,120,408.42,1680
,20130913,3402,3403,3390,3398,3390,3398,3394,-5,-9,120,407.28,1680
,20130916,3398,3394,,,,3389,3389,-5,-5,0,0,1680
rb1310,20130104,4020,3994,4059,4059,4003,4028,4027,34,33,12624,"50,840.31",24478
,20130107,4028,4027,4060,4087,4033,4042,4054,15,27,24412,"98,990.38",32078
,20130108,4042,4054,4050,4058,4012,4049,4039,-5,-15,17082,"68,997.16",35554
,20130109,4049,4039,4050,4054,4015,4035,4030,-4,-9,14326,"57,735.40",38436
,20130110,4035,4030,4034,4066,4025,4053,4047,23,17,24636,"99,704.92",47410
,20130111,4053,4047,4061,4061,3938,3950,3986,-97,-61,48470,"193,231.71",58494
,20130114,3950,3986,3950,4047,3916,4029,3993,43,7,54566,"217,900.50",62308
,20130115,4029,3993,4032,4036,3992,4006,4013,13,20,33314,"133,699.80",66382
,20130116,4006,4013,4000,4002,3930,3957,3966,-56,-47,55786,"221,251.98",79350
,20130117,3957,3966,3950,3980,3930,3972,3955,6,-11,38866,"153,721.93",81944
,20130118,3972,3955,3990,4025,3980,4025,4003,70,48,38484,"154,079.38",83478
,20130121,4025,4003,4012,4037,3995,3996,4016,-7,13,43046,"172,904.54",83608
,20130122,3996,4016,4004,4023,3981,4018,4002,2,-14,45022,"180,184.98",85974
,20130123,4018,4002,4017,4082,4014,4081,4039,79,37,47482,"191,820.61",87748
,20130124,4081,4039,4080,4097,4031,4064,4068,25,29,71648,"291,469.94",95696
,20130125,4064,4068,4067,4117,4056,4116,4095,48,27,73798,"302,227.03",110116
,20130128,4116,4095,4110,4134,4096,4127,4120,32,25,72728,"299,686.95",129086
,20130129,4127,4120,4120,4130,4105,4128,4119,8,-1,41168,"169,575.29",130522
,20130130,4128,4119,4134,4198,4131,4179,4175,60,56,119674,"499,693.45",153578
,20130131,4179,4175,4186,4193,4160,4189,4180,14,5,128896,"538,817.85",175684
,20130201,4189,4180,4179,4225,4167,4221,4197,41,17,143864,"603,807.11",213698
,20130204,4221,4197,4231,4272,4226,4257,4247,60,50,263554,"1,119,561.27",289184
,20130205,4257,4247,4244,4298,4226,4284,4274,37,27,933086,"3,988,419.04",446112
,20130206,4284,4274,4291,4292,4197,4214,4240,-60,-34,1270340,"5,387,247.75",492362
,20130207,4214,4240,4200,4273,4191,4254,4233,14,-7,1508496,"6,386,519.40",586476
,20130208,4254,4233,4249,4297,4244,4275,4275,42,42,1230546,"5,261,773.44",625286
,20130218,4275,4275,4280,4288,4166,4173,4208,-102,-67,1711926,"7,203,854.36",684774
,20130219,4173,4208,4176,4215,4170,4186,4191,-22,-17,2235174,"9,369,633.46",824122
,20130220,4186,4191,4186,4204,4151,4171,4180,-20,-11,2488120,"10,402,289.42",937888
,20130221,4171,4180,4150,4158,4048,4085,4095,-95,-85,3687920,"15,105,294.57",930782
,20130222,4085,4095,4070,4086,4028,4036,4067,-59,-28,2204304,"8,966,340.29",896062
,20130225,4036,4067,4040,4049,3998,4016,4026,-51,-41,2454538,"9,883,339.70",1013830
,20130226,4016,4026,3981,4029,3952,3956,3994,-70,-32,2555394,"10,208,336.66",1008308
,20130227,3956,3994,3970,4012,3950,3985,3982,-9,-12,3189356,"12,702,988.94",1050706
,20130228,3985,3982,3990,4065,3990,4053,4032,71,50,2850614,"11,494,939.71",1054902
,20130301,4053,4032,4042,4048,3961,4020,4006,-12,-26,3355966,"13,444,403.27",1082892
,20130304,4020,4006,3975,3988,3886,3905,3926,-101,-80,3849710,"15,114,075.35",1059834
,20130305,3905,3926,3915,3949,3891,3939,3921,13,-5,2716096,"10,650,055.09",1037108
,20130306,3939,3921,3940,3966,3912,3937,3941,16,20,2898962,"11,427,280.54",982080
,20130307,3937,3941,3937,3950,3916,3932,3934,-9,-7,2965220,"11,665,991.43",1072756
,20130308,3932,3934,3954,3961,3890,3928,3927,-6,-7,3281084,"12,887,900.96",1092024
,20130311,3928,3927,3910,3939,3867,3908,3906,-19,-21,3337874,"13,039,309.13",1133562
,20130312,3908,3906,3903,3925,3873,3892,3897,-14,-9,3068960,"11,961,580.01",1171904
,20130313,3892,3897,3897,3899,3820,3833,3854,-64,-43,3500908,"13,493,664.78",1366146
,20130314,3833,3854,3822,3825,3741,3765,3774,-89,-80,4004748,"15,117,539.54",1364686
,20130315,3765,3774,3771,3920,3766,3860,3832,86,58,5026726,"19,266,612.30",1271742
,20130318,3860,3832,3833,3863,3784,3829,3830,-3,-2,3577042,"13,702,253.23",1195430
,20130319,3829,3830,3830,3849,3818,3843,3832,13,2,2203092,"8,444,378.41",1204186
,20130320,3843,3832,3820,3885,3818,3869,3859,37,27,2625516,"10,132,712.88",1220062
,20130321,3869,3859,3885,3928,3873,3902,3903,43,44,3353754,"13,092,008.33",1297650
,20130322,3902,3903,3886,3922,3875,3878,3892,-25,-11,2310298,"8,992,572.13",1256686
,20130325,3878,3892,3883,3926,3883,3912,3907,20,15,2660564,"10,397,298.08",1326226
,20130326,3912,3907,3905,3945,3863,3882,3893,-25,-14,3247988,"12,644,821.89",1350068
,20130327,3882,3893,3892,3916,3880,3889,3898,-4,5,2457468,"9,580,766.04",1359820
,20130328,3889,3898,3900,3907,3813,3824,3850,-74,-48,3561236,"13,713,228.39",1322634
,20130329,3824,3850,3788,3840,3767,3810,3813,-40,-37,3018070,"11,509,060.45",1236224
,20130401,3810,3813,3793,3797,3710,3723,3747,-90,-66,3542394,"13,276,003.86",1306514
,20130402,3723,3747,3735,3773,3705,3769,3738,22,-9,3538772,"13,228,079.19",1270064
,20130403,3769,3738,3760,3819,3754,3798,3790,60,52,3385088,"12,832,665.02",1213050
,20130408,3798,3790,3780,3845,3767,3835,3806,45,16,3242552,"12,343,152.41",1234734
,20130409,3835,3806,3845,3861,3820,3847,3844,41,38,2947542,"11,330,680.66",1266528
,20130410,3847,3844,3859,3862,3823,3847,3841,3,-3,2389752,"9,180,029.93",1263392
,20130411,3847,3841,3845,3888,3825,3825,3860,-16,19,3273172,"12,635,788.85",1305330
,20130412,3825,3860,3825,3844,3813,3838,3830,-22,-30,2996150,"11,476,484.51",1303604
,20130415,3838,3830,3800,3803,3711,3738,3758,-92,-72,3987768,"14,988,880.59",1343486
,20130416,3738,3758,3680,3763,3665,3750,3720,-8,-38,3767686,"14,017,076.84",1246650
,20130417,3750,3720,3766,3776,3678,3699,3720,-21,0,4528234,"16,848,270.01",1385760
,20130418,3699,3720,3621,3685,3598,3651,3643,-69,-77,4790564,"17,453,126.14",1309182
,20130419,3651,3643,3667,3697,3640,3686,3669,43,26,3372174,"12,375,588.02",1237650
,20130422,3686,3669,3703,3717,3644,3647,3671,-22,2,2922738,"10,730,058.74",1316448
,20130423,3647,3671,3653,3664,3584,3600,3616,-71,-55,3521808,"12,737,437.33",1419388
,20130424,3600,3616,3604,3684,3578,3645,3617,29,1,4241852,"15,344,087.15",1386522
,20130425,3645,3617,3646,3669,3625,3648,3646,31,29,2396330,"8,738,198.94",1354752
,20130426,3648,3646,3671,3683,3600,3600,3636,-46,-10,2970358,"10,801,145.29",1354180
,20130502,3600,3636,3550,3573,3530,3542,3546,-94,-90,2305084,"8,174,927.89",1483374
,20130503,3542,3546,3552,3610,3545,3581,3579,35,33,3389276,"12,130,355.38",1508334
,20130506,3581,3579,3630,3650,3610,3622,3625,43,46,3028888,"10,981,091.33",1586646
,20130507,3622,3625,3614,3658,3600,3624,3627,-1,2,3265900,"11,845,699.94",1523294
,20130508,3624,3627,3625,3670,3622,3669,3646,42,19,2720554,"9,919,753.29",1506188
,20130509,3669,3646,3666,3674,3606,3621,3631,-25,-15,2967078,"10,775,073.51",1582518
,20130510,3621,3631,3610,3646,3587,3639,3616,8,-15,3589116,"12,979,372.70",1592226
,20130513,3639,3616,3630,3687,3622,3656,3654,40,38,4345924,"15,882,819.46",1602764
,20130514,3656,3654,3658,3668,3611,3633,3639,-21,-15,3436982,"12,509,628.21",1574890
,20130515,3633,3639,3620,3628,3553,3554,3595,-85,-44,3618224,"13,008,570.90",1799162
,20130516,3554,3595,3552,3582,3526,3549,3555,-46,-40,3824096,"13,595,142.14",1907684
,20130517,3549,3555,3555,3628,3523,3622,3578,67,23,6341490,"22,689,916.55",1729264
,20130520,3622,3578,3611,3644,3602,3606,3619,28,41,3901306,"14,119,749.00",1753440
,20130521,3606,3619,3616,3626,3567,3590,3595,-29,-24,3908044,"14,049,899.22",1762772
,20130522,3590,3595,3585,3613,3564,3594,3593,-1,-2,4240470,"15,238,909.56",1821140
,20130523,3594,3593,3581,3586,3551,3553,3567,-40,-26,3435060,"12,253,863.26",1757896
,20130524,3553,3567,3559,3584,3555,3571,3570,4,3,2843938,"10,154,258.32",1675270
,20130527,3571,3570,3553,3554,3496,3496,3515,-74,-55,3902784,"13,720,006.52",1986072
,20130528,3496,3515,3499,3508,3479,3491,3491,-24,-24,3063140,"10,695,102.14",2004210
,20130529,3491,3491,3478,3500,3433,3439,3474,-52,-17,3584080,"12,452,494.93",2243676
,20130530,3439,3474,3422,3455,3420,3438,3439,-36,-35,3320608,"11,419,629.01",2219482
,20130531,3438,3439,3441,3459,3411,3416,3431,-23,-8,3382890,"11,608,399.05",2255896
,20130603,3416,3431,3430,3485,3430,3483,3459,52,28,3917834,"13,552,428.35",2072250
,20130604,3483,3459,3488,3494,3456,3478,3473,19,14,2956270,"10,267,831.92",1991328
,20130605,3478,3473,3479,3490,3463,3482,3477,9,4,2330462,"8,105,023.85",1893602
,20130606,3482,3477,3465,3471,3411,3421,3434,-56,-43,3189430,"10,954,400.17",1888554
,20130607,3421,3434,3419,3425,3391,3421,3409,-13,-25,2436136,"8,306,450.48",1795652
,20130613,3421,3409,3391,3442,3386,3422,3423,13,14,2399476,"8,214,200.94",1734358
,20130614,3422,3423,3419,3432,3382,3424,3411,1,-12,2815678,"9,605,665.20",1779256
,20130617,3424,3411,3460,3508,3453,3477,3483,66,72,3047306,"10,614,258.10",1792016
,20130618,3477,3483,3483,3492,3472,3485,3483,2,0,1845984,"6,429,883.96",1815248
,20130619,3485,3483,3486,3530,3464,3526,3498,43,15,3455300,"12,086,803.59",1995066
,20130620,3526,3498,3512,3515,3454,3482,3483,-16,-15,3944130,"13,740,664.41",1791418
,20130621,3482,3483,3450,3547,3431,3516,3493,33,10,5428592,"18,962,934.65",1880368
,20130624,3516,3493,3501,3505,3442,3450,3468,-43,-25,4130862,"14,327,864.25",1673382
,20130625,3450,3468,3459,3466,3415,3456,3442,-12,-26,3419640,"11,771,043.34",1513390
,20130626,3456,3442,3456,3469,3418,3425,3435,-17,-7,2039478,"7,006,742.01",1494826
,20130627,3425,3435,3435,3486,3415,3471,3459,36,24,2095732,"7,251,121.74",1285126
,20130628,3471,3459,3463,3502,3460,3488,3481,29,22,1223880,"4,261,448.92",1115988
,20130701,3488,3481,3481,3496,3465,3484,3481,3,0,758412,"2,640,352.57",1032918
,20130702,3484,3481,3500,3507,3486,3504,3499,23,18,546146,"1,910,976.48",967294
,20130703,3504,3499,3508,3555,3500,3548,3528,49,29,673242,"2,375,509.78",853096
,20130704,3548,3528,3553,3562,3538,3549,3549,21,21,367060,"1,302,769.34",792328
,20130705,3549,3549,3557,3562,3541,3545,3552,-4,3,200008,"710,546.27",755254
,20130708,3545,3552,3540,3554,3518,3537,3532,-15,-20,272072,"960,997.59",683166
,20130709,3537,3532,3540,3559,3521,3533,3539,1,7,248770,"880,570.22",646422
,20130710,3533,3539,3535,3568,3521,3560,3547,21,8,241478,"856,622.50",620386
,20130711,3560,3547,3570,3610,3555,3564,3579,17,32,304910,"1,091,458.40",591316
,20130712,3564,3579,3568,3585,3555,3575,3572,-4,-7,141724,"506,244.76",560918
,20130715,3575,3572,3578,3606,3578,3581,3593,9,21,150674,"541,460.95",544388
,20130716,3581,3593,3585,3598,3576,3588,3588,-5,-5,85112,"305,414.92",527654
,20130717,3588,3588,3590,3610,3589,3595,3597,7,9,98720,"355,152.40",509966
,20130718,3595,3597,3590,3595,3578,3590,3586,-7,-11,54292,"194,710.99",494812
,20130719,3590,3586,3600,3614,3596,3598,3603,12,17,89656,"323,078.73",466132
,20130722,3598,3603,3598,3608,3573,3589,3586,-14,-17,63510,"227,770.56",444202
,20130723,3589,3586,3588,3597,3583,3593,3591,7,5,58846,"211,319.33",419874
,20130724,3593,3591,3596,3610,3588,3606,3600,15,9,63834,"229,821.87",402666
,20130725,3606,3600,3596,3609,3595,3598,3600,-2,0,42564,"153,266.73",385846
,20130726,3598,3600,3596,3599,3578,3583,3586,-17,-14,57874,"207,569.26",357348
,20130729,3583,3586,3570,3575,3558,3566,3566,-20,-20,46428,"165,569.60",335900
,20130730,3566,3566,3571,3573,3556,3561,3563,-5,-3,34732,"123,761.86",326238
,20130731,3561,3563,3555,3588,3542,3564,3568,1,5,51574,"184,056.29",315784
,20130801,3564,3568,3566,3582,3561,3574,3572,6,4,21538,"76,946.28",311828
,20130802,3574,3572,3579,3598,3577,3594,3589,22,17,37204,"133,552.75",308490
,20130805,3594,3589,3597,3608,3596,3605,3604,16,15,32778,"118,137.06",293894
,20130806,3605,3604,3612,3612,3590,3607,3602,3,-2,36302,"130,765.68",283166
,20130807,3607,3602,3608,3635,3603,3628,3621,26,19,52714,"190,896.53",266490
,20130808,3628,3621,3632,3671,3632,3669,3655,48,34,64296,"235,039.64",247966
,20130809,3669,3655,3675,3677,3648,3675,3665,20,10,42156,"154,531.06",237340
,20130812,3675,3665,3681,3718,3681,3717,3698,52,33,65362,"241,762.45",207530
,20130813,3717,3698,3718,3738,3711,3727,3724,29,26,43940,"163,644.55",197058
,20130814,3727,3724,3737,3738,3700,3718,3722,-6,-2,37964,"141,339.27",183470
,20130815,3718,3722,3730,3730,3700,3700,3713,-22,-9,27684,"102,812.53",174646
,20130816,3700,3713,3714,3714,3669,3672,3683,-41,-30,36236,"133,463.06",168362
,20130819,3672,3683,3673,3684,3658,3658,3667,-25,-16,34770,"127,511.18",158044
,20130820,3658,3667,3667,3667,3650,3653,3657,-14,-10,28242,"103,306.97",149494
,20130821,3653,3657,3658,3658,3631,3632,3647,-25,-10,17390,"63,436.63",142148
,20130822,3632,3647,3634,3634,3595,3597,3610,-50,-37,36306,"131,098.42",131172
,20130823,3597,3610,3603,3638,3599,3627,3619,17,9,21518,"77,882.33",129212
,20130826,3627,3619,3635,3647,3613,3621,3627,2,8,23146,"83,959.76",128486
,20130827,3621,3627,3618,3635,3600,3622,3619,-5,-8,18628,"67,415.40",122878
,20130828,3622,3619,3615,3627,3583,3585,3602,-34,-17,26216,"94,441.45",117464
,20130829,3585,3602,3593,3593,3563,3569,3574,-33,-28,23254,"83,118.42",110582
,20130830,3569,3574,3569,3570,3548,3560,3557,-14,-17,16514,"58,755.59",107046
,20130902,3560,3557,3566,3582,3558,3562,3566,5,9,14392,"51,335.35",107614
,20130903,3562,3566,3568,3574,3544,3552,3554,-14,-12,19114,"67,941.74",102426
,20130904,3552,3554,3548,3556,3541,3549,3547,-5,-7,10756,"38,157.65",98652
,20130905,3549,3547,3540,3554,3540,3551,3548,4,1,11638,"41,294.53",91294
,20130906,3551,3548,3547,3551,3535,3540,3540,-8,-8,7938,"28,107.64",86632
,20130909,3540,3540,3546,3560,3539,3551,3552,11,12,7130,"25,329.09",83570
,20130910,3551,3552,3544,3553,3539,3543,3543,-9,-9,6274,"22,233.48",81772
,20130911,3543,3543,3542,3551,3538,3541,3542,-2,-1,2946,"10,435.76",80788
,20130912,3541,3542,3535,3548,3535,3541,3541,-1,-1,7792,"27,595.44",79270
,20130913,3541,3541,3537,3540,3519,3522,3524,-19,-17,12942,"45,619.56",73918
,20130916,3522,3524,3520,3532,3503,3515,3512,-9,-12,9346,"32,823.30",67738
,20130917,3515,3512,3517,3525,3504,3507,3508,-5,-4,5254,"18,431.73",64032
,20130918,3507,3508,3502,3514,3501,3510,3506,2,-2,8880,"31,139.52",58528
,20130923,3510,3506,3510,3517,3500,3511,3510,5,4,8996,"31,576.58",52280
,20130924,3511,3510,3511,3514,3501,3503,3505,-7,-5,5824,"20,415.90",47762
,20130925,3503,3505,3505,3505,3491,3494,3498,-11,-7,10210,"35,716.59",39762
,20130926,3494,3498,3490,3497,3479,3479,3486,-19,-12,16472,"57,428.34",31136
,20130927,3479,3486,3480,3480,3450,3451,3461,-35,-25,10836,"37,509.07",23582
,20130930,3451,3461,3492,3492,3437,3442,3450,-19,-11,9336,"32,216.15",16664
,20131008,3442,3450,3442,3442,3396,3411,3419,-39,-31,3344,"11,435.86",13500
,20131009,3411,3419,3401,3410,3388,3390,3395,-29,-24,4200,"14,262.54",9960
,20131010,3390,3395,3390,3390,3376,3376,3385,-19,-10,1620,"5,484.18",8340
,20131011,3376,3385,3382,3415,3382,3395,3396,10,11,840,"2,852.64",7620
,20131014,3395,3396,3400,3400,3371,3371,3386,-25,-10,600,"2,031.90",7080
,20131015,3371,3386,3366,3375,3365,3375,3371,-11,-15,360,"1,213.86",6840
rb1311,20130104,3983,3980,4049,4049,4015,4034,4035,54,55,28,112.98,228
,20130107,4034,4035,4075,4075,4068,4068,4071,33,36,4,16.29,230
,20130108,4068,4071,4027,4068,4027,4050,4050,-21,-21,14,56.7,228
,20130109,4050,4050,4030,4030,4029,4029,4029,-21,-21,4,16.12,224
,20130110,4029,4029,4061,4061,4048,4048,4052,19,23,8,32.42,228
,20130111,4048,4052,4041,4041,3938,3938,4006,-114,-46,20,80.14,228
,20130114,3938,4006,3942,4079,3942,4046,3995,40,-11,40,159.82,226
,20130115,4046,3995,4023,4025,4008,4023,4016,28,21,244,980.09,178
,20130116,4023,4016,3982,3982,3942,3968,3966,-48,-50,14,55.53,168
,20130117,3968,3966,,,,3966,3966,0,0,0,0,168
,20130118,3966,3966,4006,4025,4005,4025,4010,59,44,12,48.13,166
,20130121,4025,4010,4027,4027,4026,4026,4026,16,16,8,32.21,172
,20130122,4026,4026,4000,4008,4000,4008,4001,-18,-25,14,56.02,168
,20130123,4008,4001,4013,4013,4013,4013,4013,12,12,2,8.03,168
,20130124,4013,4013,4063,4101,4049,4049,4076,36,63,176,717.44,248
,20130125,4049,4076,4080,4110,4080,4110,4090,34,14,78,319.08,294
,20130128,4110,4090,4114,4126,4112,4112,4119,22,29,22,90.62,298
,20130129,4112,4119,4103,4121,4103,4120,4116,1,-3,22,90.56,298
,20130130,4120,4116,4140,4197,4136,4195,4171,79,55,44,183.56,282
,20130131,4195,4171,4195,4195,4178,4178,4189,7,18,68,284.85,290
,20130201,4178,4189,4198,4214,4194,4214,4201,25,12,16,67.22,290
,20130204,4214,4201,4250,4259,4250,4253,4255,52,54,16,68.09,294
,20130205,4253,4255,4230,4292,4230,4263,4254,8,-1,200,851,308
,20130206,4263,4254,4236,4236,4196,4196,4223,-58,-31,124,523.75,304
,20130207,4196,4223,4207,4254,4200,4250,4228,27,5,60,253.73,310
,20130208,4250,4228,4258,4271,4247,4271,4252,43,24,32,136.08,302
,20130218,4271,4252,4249,4249,4166,4166,4183,-86,-69,210,878.46,280
,20130219,4166,4183,4179,4204,4178,4184,4188,1,5,40,167.56,292
,20130220,4184,4188,4195,4195,4151,4165,4190,-23,2,46,192.76,304
,20130221,4165,4190,4199,4199,4066,4088,4119,-102,-71,24,98.87,302
,20130222,4088,4119,4066,4076,4033,4033,4053,-86,-66,60,243.23,252
,20130225,4033,4053,4018,4038,4018,4023,4027,-30,-26,22,88.6,248
,20130226,4023,4027,3980,4026,3973,3973,4000,-54,-27,14,56,244
,20130227,3973,4000,3964,3989,3964,3982,3980,-18,-20,40,159.21,246
,20130228,3982,3980,4033,4072,4011,4054,4039,74,59,66,266.59,252
,20130301,4054,4039,4054,4054,3966,4013,4004,-26,-35,84,336.36,260
,20130304,4013,4004,3925,3925,3891,3902,3901,-102,-103,22,85.83,256
,20130305,3902,3901,3909,3947,3899,3940,3920,39,19,36,141.13,262
,20130306,3940,3920,3920,3950,3920,3936,3934,16,14,38,149.49,270
,20130307,3936,3934,3915,3934,3915,3934,3925,0,-9,20,78.51,260
,20130308,3934,3925,3912,3939,3899,3934,3921,9,-4,176,690.2,282
,20130311,3934,3921,3888,3914,3871,3906,3888,-15,-33,92,357.76,276
,20130312,3906,3888,3909,3910,3881,3898,3893,10,5,40,155.75,272
,20130313,3898,3893,3867,3876,3833,3842,3855,-51,-38,70,269.86,256
,20130314,3842,3855,3812,3815,3745,3768,3774,-87,-81,510,"1,924.99",358
,20130315,3768,3774,3799,3899,3781,3854,3840,80,66,108,414.78,330
,20130318,3854,3840,3845,3874,3822,3840,3849,0,9,56,215.55,322
,20130319,3840,3849,3833,3849,3833,3838,3842,-11,-7,36,138.34,330
,20130320,3838,3842,3834,3887,3820,3887,3853,45,11,5050,"19,458.89",862
,20130321,3887,3853,3955,3955,3871,3913,3926,60,73,556,"2,182.88",586
,20130322,3913,3926,3909,3922,3886,3911,3907,-15,-19,132,515.77,574
,20130325,3911,3907,3930,3959,3917,3944,3938,37,31,334,"1,315.34",506
,20130326,3944,3938,3960,3960,3902,3913,3912,-25,-26,74,289.53,494
,20130327,3913,3912,3937,3942,3910,3915,3919,3,7,94,368.44,488
,20130328,3915,3919,3937,3937,3835,3855,3873,-64,-46,130,503.56,472
,20130329,3855,3873,3826,3865,3805,3844,3837,-29,-36,164,629.32,440
,20130401,3844,3837,3780,3807,3748,3751,3778,-86,-59,72,272.08,422
,20130402,3751,3778,3778,3795,3771,3795,3780,17,2,48,181.45,420
,20130403,3795,3780,3791,3842,3791,3820,3818,40,38,122,465.84,402
,20130408,3820,3818,3820,3820,3820,3820,3820,2,2,30,114.6,402
,20130409,3820,3820,3820,3875,3820,3866,3851,46,31,44,169.47,400
,20130410,3866,3851,3857,3857,3857,3857,3857,6,6,8,30.86,400
,20130411,3857,3857,3875,3895,3841,3841,3860,-16,3,54,208.46,396
,20130412,3841,3860,3856,3859,3845,3849,3848,-11,-12,84,323.28,434
,20130415,3849,3848,3810,3810,3747,3762,3774,-86,-74,84,317.09,420
,20130416,3762,3774,3701,3790,3701,3790,3729,16,-45,24,89.51,422
,20130417,3790,3729,3807,3807,3699,3733,3725,4,-4,246,916.55,418
,20130418,3733,3725,3635,3720,3635,3676,3664,-49,-61,532,"1,949.78",504
,20130419,3676,3664,3683,3742,3677,3710,3725,46,61,722,"2,689.76",584
,20130422,3710,3725,3710,3710,3678,3683,3690,-42,-35,14,51.67,580
,20130423,3683,3690,3659,3659,3627,3635,3641,-55,-49,102,371.42,560
,20130424,3635,3641,3629,3668,3612,3668,3627,27,-14,58,210.4,564
,20130425,3668,3627,3663,3701,3650,3682,3678,55,51,338,"1,243.23",554
,20130426,3682,3678,3682,3715,3636,3636,3677,-42,-1,212,779.55,554
,20130502,3636,3677,3636,3636,3552,3552,3581,-125,-96,10,35.82,558
,20130503,3552,3581,3595,3632,3595,3603,3619,22,38,82,296.81,528
,20130506,3603,3619,3659,3663,3631,3646,3646,27,27,146,532.37,482
,20130507,3646,3646,3645,3666,3631,3647,3647,1,1,32,116.71,474
,20130508,3647,3647,3647,3688,3647,3677,3668,30,21,152,557.63,442
,20130509,3677,3668,3664,3669,3647,3648,3660,-20,-8,116,424.58,424
,20130510,3648,3660,3638,3662,3633,3661,3648,1,-12,40,145.95,424
,20130513,3661,3648,3666,3705,3662,3684,3691,36,43,590,"2,177.93",428
,20130514,3684,3691,3690,3691,3650,3665,3675,-26,-16,104,382.24,414
,20130515,3665,3675,3649,3656,3581,3598,3638,-77,-37,116,422.07,406
,20130516,3598,3638,3574,3604,3561,3579,3591,-59,-47,128,459.67,440
,20130517,3579,3591,3584,3606,3568,3606,3586,15,-5,192,688.7,440
,20130520,3606,3586,3637,3665,3634,3639,3652,53,66,130,474.79,404
,20130521,3639,3652,3644,3653,3602,3603,3622,-49,-30,36,130.42,408
,20130522,3603,3622,3614,3633,3607,3633,3624,11,2,26,94.24,392
,20130523,3633,3624,3605,3612,3576,3587,3592,-37,-32,116,416.73,456
,20130524,3587,3592,3591,3607,3591,3607,3600,15,8,102,367.28,480
,20130527,3607,3600,3571,3571,3542,3542,3547,-58,-53,62,219.96,496
,20130528,3542,3547,3530,3530,3516,3520,3521,-27,-26,36,126.77,502
,20130529,3520,3521,3518,3523,3489,3489,3510,-32,-11,196,688.15,574
,20130530,3489,3510,3460,3484,3460,3472,3469,-38,-41,26,90.2,572
,20130531,3472,3469,3461,3469,3454,3455,3458,-14,-11,382,"1,321.19",704
,20130603,3455,3458,3460,3479,3460,3476,3474,18,16,50,173.73,680
,20130604,3476,3474,3500,3513,3493,3509,3498,35,24,464,"1,623.49",770
,20130605,3509,3498,3517,3555,3490,3522,3512,24,14,636,"2,233.71",604
,20130606,3522,3512,3505,3505,3452,3453,3472,-59,-40,86,298.65,616
,20130607,3453,3472,3445,3470,3423,3451,3459,-21,-13,408,"1,411.57",670
,20130613,3451,3459,3446,3475,3434,3459,3462,0,3,82,283.88,672
,20130614,3459,3462,3460,3463,3425,3460,3453,-2,-9,134,462.8,662
,20130617,3460,3453,3409,3528,3409,3513,3512,60,59,396,"1,390.96",624
,20130618,3513,3512,3520,3523,3516,3522,3518,10,6,34,119.62,612
,20130619,3522,3518,3503,3535,3503,3535,3526,17,8,38,134,608
,20130620,3535,3526,3531,3531,3480,3506,3498,-20,-28,92,321.89,596
,20130621,3506,3498,3470,3565,3452,3548,3508,50,10,980,"3,438.44",624
,20130624,3548,3508,3531,3531,3493,3495,3508,-13,0,148,519.26,622
,20130625,3495,3508,3481,3491,3446,3480,3472,-28,-36,268,930.72,716
,20130626,3480,3472,3484,3486,3447,3453,3453,-19,-19,150,518.08,708
,20130627,3453,3453,3418,3503,3418,3502,3469,49,16,244,846.63,760
,20130628,3502,3469,3510,3521,3502,3511,3512,42,43,30,105.37,750
,20130701,3511,3512,3511,3516,3485,3509,3500,-3,-12,190,665.09,680
,20130702,3509,3500,3519,3528,3516,3522,3526,22,26,62,218.65,660
,20130703,3522,3526,3522,3570,3522,3570,3545,44,19,220,779.96,602
,20130704,3570,3545,3581,3581,3569,3572,3578,27,33,66,236.21,620
,20130705,3572,3578,3576,3588,3576,3576,3580,-2,2,30,107.4,620
,20130708,3576,3580,3561,3569,3542,3563,3559,-17,-21,300,"1,067.97",822
,20130709,3563,3559,3586,3586,3560,3563,3564,4,5,110,392.06,802
,20130710,3563,3564,3565,3608,3563,3599,3582,35,18,118,422.71,838
,20130711,3599,3582,3614,3645,3602,3609,3617,27,35,160,578.88,820
,20130712,3609,3617,3607,3617,3593,3611,3613,-6,-4,80,289.12,806
,20130715,3611,3613,3646,3646,3618,3624,3630,11,17,46,167.01,784
,20130716,3624,3630,3621,3624,3621,3624,3622,-6,-8,16,57.97,796
,20130717,3624,3622,3630,3644,3622,3637,3633,15,11,58,210.72,786
,20130718,3637,3633,3622,3622,3620,3621,3620,-12,-13,18,65.17,794
,20130719,3621,3620,3647,3647,3636,3636,3642,16,22,32,116.56,782
,20130722,3636,3642,3629,3629,3617,3617,3621,-25,-21,6,21.73,780
,20130723,3617,3621,3631,3632,3627,3631,3630,10,9,116,421.08,822
,20130724,3631,3630,3639,3649,3639,3641,3642,11,12,18,65.56,816
,20130725,3641,3642,3639,3639,3639,3639,3639,-3,-3,2,7.28,814
,20130726,3639,3639,3627,3630,3625,3625,3628,-14,-11,8,29.02,808
,20130729,3625,3628,3598,3609,3594,3599,3600,-29,-28,168,604.93,812
,20130730,3599,3600,3596,3596,3566,3589,3580,-11,-20,156,558.55,822
,20130731,3589,3580,3599,3610,3599,3610,3604,30,24,52,187.43,824
,20130801,3610,3604,3613,3613,3606,3606,3608,2,4,12,43.3,832
,20130802,3606,3608,3606,3621,3606,3621,3612,13,4,20,72.25,824
,20130805,3621,3612,3631,3633,3626,3631,3630,19,18,10,36.3,822
,20130806,3631,3630,3630,3631,3627,3627,3629,-3,-1,12,43.56,826
,20130807,3627,3629,3634,3660,3634,3660,3638,31,9,128,465.68,816
,20130808,3660,3638,3675,3680,3675,3680,3678,42,40,46,169.19,776
,20130809,3680,3678,3689,3701,3689,3701,3698,23,20,28,103.55,780
,20130812,3701,3698,3716,3736,3708,3736,3719,38,21,24,89.27,778
,20130813,3736,3719,3749,3763,3746,3760,3753,41,34,66,247.71,780
,20130814,3760,3753,3740,3768,3740,3749,3756,-4,3,60,225.42,768
,20130815,3749,3756,,,,3749,3749,-7,-7,0,0,768
,20130816,3749,3749,3720,3724,3696,3700,3706,-49,-43,102,378.05,766
,20130819,3700,3706,3700,3700,3685,3688,3691,-18,-15,52,191.96,762
,20130820,3688,3691,3683,3686,3675,3686,3681,-5,-10,22,80.98,756
,20130821,3686,3681,3667,3671,3667,3671,3669,-10,-12,8,29.35,756
,20130822,3671,3669,3651,3651,3614,3621,3630,-48,-39,100,363.01,726
,20130823,3621,3630,3644,3655,3632,3650,3645,20,15,126,459.36,710
,20130826,3650,3645,3718,3718,3626,3641,3652,-4,7,46,168,712
,20130827,3641,3652,3632,3648,3632,3646,3640,-6,-12,44,160.16,696
,20130828,3646,3640,3639,3645,3631,3645,3635,5,-5,38,138.16,696
,20130829,3645,3635,3587,3590,3562,3586,3584,-49,-51,32,114.69,694
,20130830,3586,3584,3581,3581,3581,3581,3581,-3,-3,4,14.32,694
,20130902,3581,3581,3596,3596,3578,3582,3583,1,2,30,107.52,694
,20130903,3582,3583,3629,3629,3579,3579,3601,-4,18,12,43.22,698
,20130904,3579,3601,3565,3565,3565,3565,3565,-36,-36,2,7.13,700
,20130905,3565,3565,3574,3574,3574,3574,3574,9,9,20,71.48,720
,20130906,3574,3574,,,,3567,3567,-7,-7,0,0,720
,20130909,3567,3567,3564,3580,3556,3569,3572,2,5,48,171.46,736
,20130910,3569,3572,3557,3560,3554,3560,3557,-12,-15,6,21.34,732
,20130911,3560,3557,3552,3552,3545,3545,3548,-12,-9,14,49.68,720
,20130912,3545,3548,3546,3557,3543,3544,3544,-4,-4,60,212.69,728
,20130913,3544,3544,3539,3543,3523,3523,3529,-21,-15,240,846.97,710
,20130916,3523,3529,3522,3530,3509,3530,3519,1,-10,68,239.33,698
,20130917,3530,3519,3519,3519,3519,3519,3519,0,0,104,365.98,604
,20130918,3519,3519,3515,3515,3515,3515,3515,-4,-4,60,210.9,544
,20130923,3515,3515,,,,3518,3518,3,3,0,0,544
,20130924,3518,3518,3515,3515,3514,3514,3514,-4,-4,24,84.35,538
,20130925,3514,3514,3513,3513,3512,3512,3512,-2,-2,222,779.83,362
,20130926,3512,3512,,,,3510,3510,-2,-2,0,0,362
,20130927,3510,3510,3423,3455,3423,3437,3440,-73,-70,26,89.46,356
,20130930,3437,3440,3454,3458,3452,3455,3454,15,14,30,103.63,366
,20131008,3455,3454,3438,3440,3438,3440,3439,-14,-15,14,48.15,372
,20131009,3440,3439,3492,3492,3432,3450,3457,11,18,174,601.53,414
,20131010,3450,3457,3437,3437,3437,3437,3437,-20,-20,2,6.87,416
,20131011,3437,3437,3413,3449,3412,3412,3428,-25,-9,14,47.99,416
,20131014,3412,3428,3431,3451,3431,3433,3436,5,8,46,158.09,408
,20131015,3433,3436,,,,3436,3436,0,0,0,0,408
,20131016,3436,3436,3430,3430,3341,3349,3363,-87,-73,140,470.91,392
,20131017,3349,3363,3345,3352,3302,3317,3327,-46,-36,56,186.33,380
,20131018,3317,3327,3293,3316,3290,3315,3301,-12,-26,358,"1,181.83",420
,20131021,3315,3301,3366,3366,3288,3288,3304,-13,3,110,363.45,494
,20131022,3288,3304,3299,3299,3277,3280,3285,-24,-19,66,216.87,514
,20131023,3280,3285,3265,3267,3257,3260,3262,-25,-23,116,378.42,490
,20131024,3260,3262,3220,3265,3208,3260,3253,-2,-9,264,858.97,558
,20131025,3260,3253,3216,3287,3216,3230,3233,-23,-20,26,84.06,550
,20131028,3230,3233,3220,3220,3190,3210,3203,-23,-30,62,198.61,554
,20131029,3210,3203,3189,3237,3189,3202,3205,-1,2,114,365.48,550
,20131030,3202,3205,3213,3245,3211,3237,3218,32,13,226,727.37,546
,20131031,3237,3218,3258,3346,3230,3230,3296,12,78,110,362.66,540
,20131101,3230,3296,,,,3296,3296,0,0,0,0,540
,20131104,3296,3296,,,,3296,3296,0,0,0,0,540
,20131105,3296,3296,3313,3313,3303,3303,3309,7,13,180,595.74,540
,20131106,3303,3309,,,,3313,3313,4,4,0,0,540
,20131107,3313,3313,3400,3400,3400,3400,3400,87,87,60,204,540
,20131108,3400,3400,,,,3400,3400,0,0,0,0,540
,20131111,3400,3400,,,,3400,3400,0,0,0,0,540
,20131112,3400,3400,,,,3400,3400,0,0,0,0,540
,20131113,3400,3400,,,,3400,3400,0,0,0,0,540
,20131114,3400,3400,,,,3400,3400,0,0,0,0,540
,20131115,3400,3400,,,,3400,3400,0,0,0,0,540
rb1312,20130104,3996,3989,4030,4032,4027,4027,4030,38,41,10,40.3,12
,20130107,4027,4030,4049,4078,4045,4045,4059,15,29,16,64.94,16
,20130108,4045,4059,4036,4057,4036,4057,4050,-2,-9,6,24.3,18
,20130109,4057,4050,4050,4050,4025,4025,4034,-25,-16,10,40.34,20
,20130110,4025,4034,,,,4057,4057,23,23,0,0,20
,20130111,4057,4057,4038,4038,3948,3948,3982,-109,-75,20,79.65,28
,20130114,3948,3982,3921,4030,3921,4030,3991,48,9,18,71.85,32
,20130115,4030,3991,4019,4019,4003,4004,4007,13,16,10,40.08,34
,20130116,4004,4007,3931,3959,3931,3959,3945,-48,-62,4,15.78,36
,20130117,3959,3945,3937,3942,3927,3927,3936,-18,-9,8,31.49,34
,20130118,3927,3936,3998,3998,3998,3998,3998,62,62,2,8,34
,20130121,3998,3998,,,,3998,3998,0,0,0,0,34
,20130122,3998,3998,4002,4002,4002,4002,4002,4,4,2,8,34
,20130123,4002,4002,4023,4066,4023,4066,4046,64,44,6,24.28,38
,20130124,4066,4046,4064,4064,4047,4047,4055,1,9,4,16.22,36
,20130125,4047,4055,4092,4093,4092,4093,4092,38,37,4,16.37,32
,20130128,4093,4092,4100,4105,4100,4105,4102,13,10,4,16.41,32
,20130129,4105,4102,4118,4122,4111,4111,4117,9,15,48,197.65,64
,20130130,4111,4117,4135,4190,4135,4174,4160,57,43,14,58.25,58
,20130131,4174,4160,4178,4192,4168,4187,4179,27,19,46,192.26,30
,20130201,4187,4179,4172,4197,4172,4179,4182,0,3,6,25.1,28
,20130204,4179,4182,4260,4263,4257,4261,4259,79,77,12,51.12,34
,20130205,4261,4259,4255,4260,4243,4245,4254,-14,-5,46,195.69,48
,20130206,4245,4254,4241,4248,4210,4210,4234,-44,-20,428,"1,812.48",448
,20130207,4210,4234,4242,4242,4242,4242,4242,8,8,10,42.42,458
,20130208,4242,4242,4266,4270,4266,4270,4268,28,26,4,17.07,458
,20130218,4270,4268,4269,4269,4174,4174,4197,-94,-71,20,83.95,462
,20130219,4174,4197,4181,4203,4170,4170,4181,-27,-16,8,33.45,464
,20130220,4170,4181,4161,4161,4140,4140,4150,-41,-31,4,16.6,464
,20130221,4140,4150,4134,4134,4061,4078,4086,-72,-64,168,686.51,562
,20130222,4078,4086,4078,4078,4018,4018,4060,-68,-26,10,40.6,564
,20130225,4018,4060,4030,4030,4020,4020,4021,-40,-39,18,72.38,550
,20130226,4020,4021,3983,4016,3970,3970,3986,-51,-35,18,71.76,550
,20130227,3970,3986,3960,3960,3960,3960,3960,-26,-26,2,7.92,548
,20130228,3960,3960,4020,4062,4018,4062,4036,102,76,18,72.66,546
,20130301,4062,4036,4010,4010,3977,3979,3990,-57,-46,8,31.92,544
,20130304,3979,3990,3982,3982,3892,3895,3898,-95,-92,454,"1,770.00",338
,20130305,3895,3898,3908,3938,3907,3936,3915,38,17,22,86.15,332
,20130306,3936,3915,3965,3965,3938,3938,3943,23,28,16,63.1,336
,20130307,3938,3943,3931,3953,3926,3926,3944,-17,1,1234,"4,867.90",838
,20130308,3926,3944,3955,3964,3920,3933,3938,-11,-6,112,441.15,760
,20130311,3933,3938,3930,3940,3930,3940,3935,2,-3,4,15.74,760
,20130312,3940,3935,3912,3920,3912,3920,3918,-15,-17,10,39.18,760
,20130313,3920,3918,3842,3842,3829,3830,3830,-88,-88,44,168.53,782
,20130314,3830,3830,3822,3827,3763,3790,3801,-40,-29,188,714.74,748
,20130315,3790,3801,3804,3900,3802,3890,3872,89,71,26,100.69,736
,20130318,3890,3872,3847,3855,3847,3848,3848,-24,-24,16,61.58,734
,20130319,3848,3848,,,,3841,3841,-7,-7,0,0,734
,20130320,3841,3841,3841,3885,3841,3885,3855,44,14,118,454.96,666
,20130321,3885,3855,3940,3947,3940,3947,3943,92,88,4,15.77,662
,20130322,3947,3943,3927,3927,3906,3906,3912,-37,-31,14,54.78,660
,20130325,3906,3912,3927,3930,3927,3929,3928,17,16,8,31.43,656
,20130326,3929,3928,3887,3912,3887,3912,3900,-16,-28,8,31.21,656
,20130327,3912,3900,3934,3934,3934,3934,3934,34,34,4,15.74,656
,20130328,3934,3934,,,,3867,3867,-67,-67,0,0,656
,20130329,3867,3867,3846,3855,3846,3855,3850,-12,-17,4,15.4,654
,20130401,3855,3850,3812,3812,3773,3773,3787,-77,-63,16,60.6,654
,20130402,3773,3787,3781,3781,3781,3781,3781,-6,-6,6,22.69,654
,20130403,3781,3781,3817,3844,3817,3829,3830,48,49,18,68.94,652
,20130408,3829,3830,3822,3875,3822,3875,3857,45,27,38,146.59,624
,20130409,3875,3857,3907,3907,3883,3889,3894,32,37,32,124.62,604
,20130410,3889,3894,3860,3950,3860,3867,3881,-27,-13,48,186.29,602
,20130411,3867,3881,3907,3907,3868,3874,3877,-7,-4,16,62.04,606
,20130412,3874,3877,3874,3878,3868,3878,3873,1,-4,24,92.97,600
,20130415,3878,3873,3836,3836,3770,3772,3785,-101,-88,18,68.14,600
,20130416,3772,3785,3771,3783,3767,3783,3776,-2,-9,18,67.98,592
,20130417,3783,3776,,,,3772,3772,-4,-4,0,0,592
,20130418,3772,3772,,,,3710,3710,-62,-62,0,0,592
,20130419,3710,3710,3712,3712,3700,3712,3704,2,-6,10,37.05,586
,20130422,3712,3704,3717,3717,3700,3700,3713,-4,9,10,37.14,586
,20130423,3700,3713,3665,3665,3665,3665,3665,-48,-48,2,7.33,586
,20130424,3665,3665,3621,3685,3621,3685,3649,20,-16,6,21.9,588
,20130425,3685,3649,3703,3703,3679,3681,3683,32,34,56,206.28,582
,20130426,3681,3683,3724,3724,3683,3683,3697,0,14,14,51.77,578
,20130502,3683,3697,3609,3616,3588,3588,3609,-109,-88,376,"1,357.27",576
,20130503,3588,3609,3614,3662,3614,3631,3633,22,24,16,58.14,582
,20130506,3631,3633,3660,3673,3660,3668,3664,35,31,10,36.64,580
,20130507,3668,3664,,,,3665,3665,1,1,0,0,580
,20130508,3665,3665,3695,3695,3695,3695,3695,30,30,2,7.39,582
,20130509,3695,3695,3703,3703,3666,3666,3674,-29,-21,40,146.99,576
,20130510,3666,3674,3660,3679,3629,3679,3668,5,-6,92,337.52,576
,20130513,3679,3668,3682,3723,3681,3723,3691,55,23,10,36.91,572
,20130514,3723,3691,3673,3673,3660,3660,3672,-31,-19,42,154.24,612
,20130515,3660,3672,3663,3664,3600,3600,3652,-72,-20,58,211.87,606
,20130516,3600,3652,3593,3624,3559,3598,3588,-54,-64,90,322.95,622
,20130517,3598,3588,3599,3664,3585,3664,3662,76,74,622,"2,277.87",914
,20130520,3664,3662,3662,3689,3662,3662,3670,0,8,38,139.46,906
,20130521,3662,3670,3639,3639,3632,3632,3633,-38,-37,8,29.07,902
,20130522,3632,3633,3644,3661,3624,3661,3642,28,9,132,480.81,876
,20130523,3661,3642,3615,3639,3603,3614,3616,-28,-26,46,166.36,866
,20130524,3614,3616,3617,3646,3610,3623,3623,7,7,80,289.9,872
,20130527,3623,3623,3590,3592,3552,3558,3570,-65,-53,128,457,840
,20130528,3558,3570,3554,3558,3537,3555,3550,-15,-20,168,596.48,754
,20130529,3555,3550,3561,3561,3486,3486,3513,-64,-37,394,"1,384.28",612
,20130530,3486,3513,3450,3506,3450,3493,3488,-20,-25,302,"1,053.52",574
,20130531,3493,3488,3495,3507,3444,3469,3483,-19,-5,44,153.25,586
,20130603,3469,3483,3527,3530,3478,3530,3519,47,36,292,"1,027.76",654
,20130604,3530,3519,3535,3545,3531,3540,3536,21,17,158,558.79,648
,20130605,3540,3536,3530,3535,3527,3535,3532,-1,-4,26,91.83,628
,20130606,3535,3532,3532,3532,3475,3476,3493,-56,-39,240,838.43,684
,20130607,3476,3493,3476,3477,3422,3471,3467,-22,-26,108,374.52,690
,20130613,3471,3467,3390,3496,3390,3472,3462,5,-5,26,90.03,688
,20130614,3472,3462,3483,3485,3483,3484,3484,22,22,6,20.9,688
,20130617,3484,3484,3541,3584,3541,3550,3554,66,70,124,440.79,676
,20130618,3550,3554,3554,3559,3547,3555,3554,1,0,36,127.95,678
,20130619,3555,3554,3553,3579,3553,3579,3571,25,17,14,50,670
,20130620,3579,3571,3558,3570,3527,3543,3558,-28,-13,160,569.43,704
,20130621,3543,3558,3485,3581,3485,3577,3528,19,-30,230,811.55,670
,20130624,3577,3528,3556,3556,3515,3519,3535,-9,7,46,162.65,666
,20130625,3519,3535,3510,3515,3473,3515,3504,-20,-31,366,"1,282.79",738
,20130626,3515,3504,3495,3495,3450,3465,3466,-39,-38,122,422.88,782
,20130627,3465,3466,3447,3530,3445,3513,3500,47,34,150,525.03,710
,20130628,3513,3500,3523,3549,3513,3520,3522,20,22,226,796.11,726
,20130701,3520,3522,3510,3516,3491,3504,3501,-18,-21,42,147.05,708
,20130702,3504,3501,3545,3548,3534,3543,3541,42,40,174,616.19,708
,20130703,3543,3541,3559,3591,3552,3590,3573,49,32,64,228.72,684
,20130704,3590,3573,3600,3606,3598,3598,3600,25,27,28,100.81,674
,20130705,3598,3600,3590,3610,3590,3610,3602,10,2,32,115.29,686
,20130708,3610,3602,3576,3606,3554,3588,3571,-14,-31,714,"2,550.35",690
,20130709,3588,3571,3604,3609,3575,3579,3598,8,27,36,129.55,694
,20130710,3579,3598,3549,3627,3549,3619,3605,21,7,136,490.32,704
,20130711,3619,3605,3641,3676,3562,3639,3640,34,35,326,"1,186.76",764
,20130712,3639,3640,3638,3650,3628,3647,3640,7,0,456,"1,659.99",902
,20130715,3647,3640,3661,3675,3641,3649,3658,9,18,30,109.76,896
,20130716,3649,3658,3649,3662,3645,3653,3655,-5,-3,82,299.75,880
,20130717,3653,3655,3655,3673,3655,3668,3664,13,9,110,403.12,892
,20130718,3668,3664,3651,3661,3651,3661,3655,-3,-9,58,212.01,890
,20130719,3661,3655,3662,3687,3662,3676,3678,21,23,290,"1,066.86",860
,20130722,3676,3678,3670,3670,3647,3653,3655,-25,-23,218,796.97,906
,20130723,3653,3655,3661,3671,3660,3666,3664,11,9,50,183.24,898
,20130724,3666,3664,3682,3682,3656,3663,3660,-1,-4,466,"1,705.74",1210
,20130725,3663,3660,3656,3668,3656,3659,3662,-1,2,54,197.79,1198
,20130726,3659,3662,3652,3660,3635,3640,3646,-22,-16,584,"2,129.41",1158
,20130729,3640,3646,3629,3629,3607,3618,3618,-28,-28,46,166.43,1150
,20130730,3618,3618,3615,3624,3615,3615,3618,-3,0,116,419.78,1164
,20130731,3615,3618,3618,3628,3615,3628,3621,10,3,28,101.39,1156
,20130801,3628,3621,3631,3639,3621,3632,3632,11,11,24,87.17,1156
,20130802,3632,3632,3648,3650,3643,3650,3648,18,16,76,277.26,1140
,20130805,3650,3648,3657,3663,3657,3660,3658,12,10,56,204.87,1120
,20130806,3660,3658,3665,3665,3658,3660,3660,2,2,16,58.57,1120
,20130807,3660,3660,3671,3720,3671,3692,3699,32,39,82,303.38,1144
,20130808,3692,3699,3700,3712,3696,3702,3707,3,8,238,882.35,1196
,20130809,3702,3707,3697,3712,3691,3712,3706,5,-1,270,"1,000.76",1218
,20130812,3712,3706,3712,3750,3711,3750,3728,44,22,360,"1,342.18",1292
,20130813,3750,3728,3813,3813,3732,3766,3763,38,35,464,"1,746.32",1242
,20130814,3766,3763,3774,3779,3750,3750,3759,-13,-4,132,496.3,1282
,20130815,3750,3759,3757,3757,3742,3755,3749,-4,-10,30,112.47,1290
,20130816,3755,3749,3743,3743,3729,3733,3734,-16,-15,42,156.87,1298
,20130819,3733,3734,3710,3743,3710,3733,3729,-1,-5,136,507.26,1282
,20130820,3733,3729,3732,3732,3729,3729,3729,0,0,22,82.04,1282
,20130821,3729,3729,3703,3722,3703,3721,3711,-8,-18,36,133.6,1282
,20130822,3721,3711,3741,3741,3679,3679,3688,-32,-23,216,796.66,1344
,20130823,3679,3688,3701,3726,3701,3718,3723,30,35,100,372.36,1258
,20130826,3718,3723,3735,3738,3710,3715,3721,-8,-2,254,945.35,1262
,20130827,3715,3721,3715,3716,3684,3714,3707,-7,-14,244,904.74,1274
,20130828,3714,3707,3707,3710,3673,3673,3695,-34,-12,86,317.82,1272
,20130829,3673,3695,3666,3669,3618,3635,3640,-60,-55,76,276.68,1278
,20130830,3635,3640,3688,3688,3624,3635,3636,-5,-4,172,625.56,1252
,20130902,3635,3636,3670,3678,3654,3673,3662,37,26,210,769.13,1258
,20130903,3673,3662,3668,3668,3637,3644,3647,-18,-15,86,313.71,1256
,20130904,3644,3647,3647,3647,3620,3626,3635,-21,-12,96,349,1268
,20130905,3626,3635,3643,3643,3620,3621,3626,-14,-9,92,333.59,1286
,20130906,3621,3626,3621,3685,3611,3613,3633,-13,7,110,399.67,1312
,20130909,3613,3633,3632,3649,3632,3644,3647,11,14,108,393.89,1286
,20130910,3644,3647,3627,3632,3623,3632,3626,-15,-21,134,485.93,1352
,20130911,3632,3626,3636,3636,3617,3620,3622,-6,-4,78,282.54,1350
,20130912,3620,3622,3623,3623,3609,3611,3614,-11,-8,46,166.25,1338
,20130913,3611,3614,3607,3607,3556,3567,3568,-47,-46,154,549.59,1388
,20130916,3567,3568,3567,3575,3538,3547,3556,-21,-12,84,298.78,1372
,20130917,3547,3556,3551,3559,3539,3544,3547,-12,-9,118,418.58,1366
,20130918,3544,3547,3540,3543,3530,3533,3534,-14,-13,202,713.95,1316
,20130923,3533,3534,3533,3555,3530,3550,3543,16,9,82,290.61,1320
,20130924,3550,3543,3558,3569,3527,3534,3552,-9,9,122,433.4,1316
,20130925,3534,3552,3506,3543,3506,3525,3526,-27,-26,360,"1,269.66",1352
,20130926,3525,3526,3534,3534,3505,3516,3522,-10,-4,678,"2,388.44",1392
,20130927,3516,3522,3494,3494,3464,3475,3481,-47,-41,260,905.31,1288
,20130930,3475,3481,3486,3489,3448,3476,3477,-5,-4,176,612.12,1354
,20131008,3476,3477,3461,3478,3447,3478,3459,1,-18,442,"1,529.04",1718
,20131009,3478,3459,3460,3481,3437,3474,3466,15,7,818,"2,835.20",2164
,20131010,3474,3466,3456,3473,3456,3460,3461,-6,-5,292,"1,010.89",2304
,20131011,3460,3461,3470,3475,3450,3456,3469,-5,8,360,"1,248.99",2612
,20131014,3456,3469,3470,3475,3460,3464,3468,-5,-1,710,"2,462.57",3000
,20131015,3464,3468,3474,3478,3442,3462,3468,-6,0,728,"2,525.42",3228
,20131016,3462,3468,3458,3458,3421,3436,3447,-32,-21,502,"1,730.60",3428
,20131017,3436,3447,3433,3443,3415,3419,3433,-28,-14,82,281.52,3422
,20131018,3419,3433,3403,3429,3395,3429,3418,-4,-15,266,909.32,3490
,20131021,3429,3418,3432,3432,3410,3418,3421,0,3,376,"1,286.67",3562
,20131022,3418,3421,3411,3420,3408,3414,3413,-7,-8,106,361.78,3586
,20131023,3414,3413,3428,3428,3396,3396,3411,-17,-2,152,518.48,3516
,20131024,3396,3411,3377,3382,3368,3368,3378,-43,-33,244,824.32,3530
,20131025,3368,3378,3374,3376,3355,3355,3365,-23,-13,448,"1,507.60",3270
,20131028,3355,3365,3357,3359,3349,3357,3353,-8,-12,252,845.03,3138
,20131029,3357,3353,3350,3358,3340,3340,3345,-13,-8,206,689.1,3010
,20131030,3340,3345,3347,3368,3340,3368,3353,23,8,148,496.25,3030
,20131031,3368,3353,3367,3382,3363,3382,3370,29,17,180,606.77,3020
,20131101,3382,3370,3370,3393,3330,3390,3380,20,10,406,"1,372.65",2958
,20131104,3390,3380,3395,3407,3394,3407,3399,27,19,314,"1,067.42",2744
,20131105,3407,3399,3410,3416,3401,3406,3409,7,10,156,531.86,2716
,20131106,3406,3409,3415,3417,3402,3415,3409,6,0,668,"2,277.43",2328
,20131107,3415,3409,3406,3471,3406,3471,3441,62,32,964,"3,317.76",1458
,20131108,3471,3441,3461,3474,3460,3460,3464,19,23,48,166.28,1428
,20131111,3460,3464,3460,3468,3445,3468,3459,4,-5,102,352.83,1396
,20131112,3468,3459,3463,3470,3463,3468,3465,9,6,50,173.27,1400
,20131113,3468,3465,3477,3479,3470,3471,3477,6,12,372,"1,293.66",1030
,20131114,3471,3477,3461,3476,3440,3443,3451,-34,-26,44,151.84,1010
,20131115,3443,3451,3443,3457,3430,3430,3439,-21,-12,116,399.03,920
,20131118,3430,3439,3438,3446,3438,3446,3440,7,1,86,295.84,842
,20131119,3446,3440,3443,3455,3443,3455,3448,15,8,122,420.76,732
,20131120,3455,3448,3447,3458,3447,3458,3452,10,4,8,27.62,726
,20131121,3458,3452,3444,3462,3444,3462,3458,10,6,22,76.08,714
,20131122,3462,3458,3455,3480,3454,3469,3464,11,6,176,609.77,568
,20131125,3469,3464,3461,3482,3461,3482,3477,18,13,50,173.85,538
,20131126,3482,3477,3533,3533,3475,3492,3500,15,23,118,413.06,530
,20131127,3492,3500,3493,3493,3493,3493,3493,-7,-7,6,20.96,524
,20131128,3493,3493,3500,3553,3500,3520,3524,27,31,60,211.48,514
,20131129,3520,3524,3513,3590,3440,3450,3487,-74,-37,88,306.94,480
,20131202,3450,3487,,,,3487,3487,0,0,0,0,480
,20131203,3487,3487,3550,3556,3541,3541,3549,54,62,180,638.82,420
,20131204,3541,3549,3585,3585,3550,3550,3567,1,18,120,428.1,360
,20131205,3550,3567,,,,3500,3500,-67,-67,0,0,360
,20131206,3500,3500,,,,3500,3500,0,0,0,0,360
,20131209,3500,3500,,,,3500,3500,0,0,0,0,360
,20131210,3500,3500,,,,3500,3500,0,0,0,0,360
,20131211,3500,3500,,,,3500,3500,0,0,0,0,360
,20131212,3500,3500,,,,3500,3500,0,0,0,0,360
,20131213,3500,3500,,,,3500,3500,0,0,0,0,360
,20131216,3500,3500,3400,3400,3400,3400,3400,-100,-100,60,204,420
rb1401,20130116,4007,4007,3934,3942,3934,3942,3938,-65,-69,12,47.26,10
,20130117,3942,3938,3940,3986,3936,3986,3956,48,18,72,284.88,18
,20130118,3986,3956,4000,4010,3962,4010,3993,54,37,12,47.92,24
,20130121,4010,3993,4000,4000,4000,4000,4000,7,7,4,16,20
,20130122,4000,4000,3990,3990,3990,3990,3990,-10,-10,2,7.98,20
,20130123,3990,3990,4019,4054,4019,4051,4038,61,48,10,40.39,28
,20130124,4051,4038,4125,4125,4109,4109,4121,71,83,10,41.21,26
,20130125,4109,4121,4085,4122,4072,4122,4100,1,-21,68,278.8,58
,20130128,4122,4100,4103,4133,4042,4133,4109,33,9,114,468.47,100
,20130129,4133,4109,4134,4140,4122,4139,4132,30,23,40,165.31,120
,20130130,4139,4132,4153,4210,4153,4192,4197,60,65,194,814.25,210
,20130131,4192,4197,4200,4203,4187,4198,4196,1,-1,114,478.45,256
,20130201,4198,4196,4192,4235,4183,4225,4213,29,17,410,"1,727.44",496
,20130204,4225,4213,4259,4278,4240,4267,4265,54,52,540,"2,303.47",792
,20130205,4267,4265,4255,4308,4242,4295,4287,30,22,780,"3,344.30",1246
,20130206,4295,4287,4303,4305,4232,4232,4281,-55,-6,1456,"6,233.55",1478
,20130207,4232,4281,4241,4299,4222,4287,4264,6,-17,688,"2,933.98",1546
,20130208,4287,4264,4280,4330,4279,4316,4314,52,50,884,"3,814.00",1994
,20130218,4316,4314,4335,4335,4200,4207,4245,-107,-69,1082,"4,594.07",2206
,20130219,4207,4245,4202,4244,4172,4217,4220,-28,-25,2088,"8,812.38",2824
,20130220,4217,4220,4249,4249,4181,4201,4208,-19,-12,1106,"4,654.67",2700
,20130221,4201,4208,4192,4192,4070,4105,4110,-103,-98,5512,"22,655.51",3362
,20130222,4105,4110,4095,4122,4050,4064,4096,-46,-14,2222,"9,102.42",3266
,20130225,4064,4096,4063,4070,4020,4038,4045,-58,-51,2882,"11,659.93",4086
,20130226,4038,4045,4200,4200,3980,3980,4028,-65,-17,6842,"27,563.72",4124
,20130227,3980,4028,3999,4036,3980,4009,4009,-19,-19,1470,"5,894.31",4256
,20130228,4009,4009,4018,4087,4018,4077,4054,68,45,1520,"6,163.54",4458
,20130301,4077,4054,4067,4071,3991,4044,4038,-10,-16,1614,"6,517.60",4438
,20130304,4044,4038,4012,4013,3906,3920,3950,-118,-88,3150,"12,444.77",4914
,20130305,3920,3950,3940,3969,3910,3962,3942,12,-8,1936,"7,631.93",4850
,20130306,3962,3942,3976,3987,3936,3964,3962,22,20,1078,"4,271.43",4938
,20130307,3964,3962,3960,3970,3925,3950,3952,-12,-10,1082,"4,276.88",5024
,20130308,3950,3952,3975,3986,3907,3948,3943,-4,-9,2102,"8,288.88",5208
,20130311,3948,3943,3955,3955,3890,3924,3915,-19,-28,1470,"5,756.04",5326
,20130312,3924,3915,3930,3935,3894,3910,3911,-5,-4,1222,"4,780.20",5546
,20130313,3910,3911,3925,3925,3845,3865,3874,-46,-37,1780,"6,897.47",5872
,20130314,3865,3874,3858,3858,3764,3795,3798,-79,-76,2262,"8,592.55",6392
,20130315,3795,3798,3800,3948,3782,3881,3855,83,57,2648,"10,208.40",7012
,20130318,3881,3855,3890,3890,3820,3850,3851,-5,-4,2512,"9,674.86",7448
,20130319,3850,3851,3851,3870,3845,3861,3856,10,5,890,"3,432.08",7498
,20130320,3861,3856,3849,3900,3848,3889,3879,33,23,1530,"5,935.80",7668
,20130321,3889,3879,3899,3945,3895,3923,3922,44,43,1406,"5,514.96",7610
,20130322,3923,3922,3907,3937,3901,3903,3913,-19,-9,1132,"4,430.56",7606
,20130325,3903,3913,3919,3949,3912,3936,3931,23,18,2502,"9,837.29",8310
,20130326,3936,3931,3929,3969,3891,3908,3921,-23,-10,2512,"9,849.89",8240
,20130327,3908,3921,3915,3938,3909,3913,3924,-8,3,1272,"4,991.94",8240
,20130328,3913,3924,3919,3934,3840,3848,3860,-76,-64,4646,"17,936.07",8462
,20130329,3848,3860,3822,3860,3800,3843,3838,-17,-22,2898,"11,124.91",8796
,20130401,3843,3838,3850,3850,3747,3758,3772,-80,-66,13484,"50,872.08",8706
,20130402,3758,3772,3761,3800,3741,3796,3771,24,-1,2454,"9,254.99",8396
,20130403,3796,3771,3780,3845,3780,3823,3817,52,46,2662,"10,162.75",8254
,20130408,3823,3817,3800,3869,3787,3863,3832,46,15,2332,"8,937.79",8370
,20130409,3863,3832,3866,3887,3850,3882,3875,50,43,2838,"10,997.55",8140
,20130410,3882,3875,3885,3894,3860,3879,3875,4,0,1336,"5,177.49",8252
,20130411,3879,3875,3880,3920,3867,3867,3893,-8,18,4364,"16,990.17",8948
,20130412,3867,3893,3852,3889,3847,3878,3868,-15,-25,2278,"8,813.52",9246
,20130415,3878,3868,3828,3836,3744,3765,3785,-103,-83,8810,"33,352.83",10250
,20130416,3765,3785,3700,3809,3686,3797,3758,12,-27,10170,"38,227.87",11710
,20130417,3797,3758,3815,3824,3727,3746,3768,-12,10,9526,"35,900.58",11542
,20130418,3746,3768,3696,3739,3640,3708,3691,-60,-77,9918,"36,610.22",12858
,20130419,3708,3691,3711,3750,3701,3733,3725,42,34,7668,"28,567.62",12796
,20130422,3733,3725,3759,3769,3695,3698,3721,-27,-4,6166,"22,949.34",12800
,20130423,3698,3721,3701,3715,3641,3657,3666,-64,-55,7090,"25,997.84",13098
,20130424,3657,3666,3657,3849,3600,3701,3676,35,10,10304,"37,879.11",12986
,20130425,3701,3676,3700,3723,3681,3710,3699,34,23,4546,"16,820.09",13100
,20130426,3710,3699,3718,3742,3670,3673,3700,-26,1,5486,"20,303.49",13416
,20130502,3673,3700,3610,3639,3600,3611,3610,-89,-90,9792,"35,357.36",14138
,20130503,3611,3610,3617,3662,3613,3637,3642,27,32,15078,"54,915.46",17366
,20130506,3637,3642,3688,3714,3677,3690,3693,48,51,12032,"44,435.14",16428
,20130507,3690,3693,3687,3717,3662,3680,3687,-13,-6,15818,"58,321.69",20734
,20130508,3680,3687,3681,3725,3681,3725,3703,38,16,10494,"38,866.15",21718
,20130509,3725,3703,3733,3733,3662,3671,3684,-32,-19,18174,"66,961.27",26752
,20130510,3671,3684,3656,3700,3646,3695,3673,11,-11,17728,"65,122.58",28264
,20130513,3695,3673,3692,3738,3680,3713,3707,40,34,23846,"88,416.01",29898
,20130514,3713,3707,3713,3725,3672,3685,3698,-22,-9,19596,"72,473.16",31238
,20130515,3685,3698,3671,3684,3601,3604,3643,-94,-55,59892,"218,204.00",50782
,20130516,3604,3643,3598,3629,3578,3597,3605,-46,-38,47548,"171,431.31",60040
,20130517,3597,3605,3600,3690,3572,3688,3633,83,28,85952,"312,267.57",64198
,20130520,3688,3633,3680,3695,3657,3665,3677,32,44,46184,"169,847.81",68964
,20130521,3665,3677,3680,3685,3629,3654,3655,-23,-22,44738,"163,546.56",76802
,20130522,3654,3655,3649,3680,3629,3657,3658,2,3,72858,"266,524.16",82164
,20130523,3657,3658,3650,3650,3601,3610,3629,-48,-29,54494,"197,782.86",84930
,20130524,3610,3629,3620,3645,3611,3630,3631,1,2,38956,"141,457.08",87206
,20130527,3630,3631,3610,3633,3558,3558,3589,-73,-42,236460,"848,841.37",121710
,20130528,3558,3589,3558,3568,3538,3553,3552,-36,-37,79996,"284,161.04",131298
,20130529,3553,3552,3549,3565,3486,3496,3526,-56,-26,182112,"642,191.42",184110
,20130530,3496,3526,3483,3515,3480,3499,3500,-27,-26,121552,"425,504.94",190502
,20130531,3499,3500,3507,3521,3470,3476,3490,-24,-10,140786,"491,466.74",210518
,20130603,3476,3490,3493,3560,3488,3559,3531,69,41,249606,"881,446.91",217416
,20130604,3559,3531,3558,3570,3534,3562,3552,31,21,213848,"759,786.23",220010
,20130605,3562,3552,3566,3584,3547,3566,3565,14,13,213330,"760,606.85",225504
,20130606,3566,3565,3548,3550,3479,3483,3506,-82,-59,313626,"1,099,699.60",266176
,20130607,3483,3506,3482,3493,3467,3486,3480,-20,-26,200844,"699,065.22",273380
,20130613,3486,3480,3470,3507,3461,3481,3487,1,7,169756,"592,023.41",283148
,20130614,3481,3487,3485,3503,3450,3492,3483,5,-4,213734,"744,438.07",298794
,20130617,3492,3483,3522,3595,3522,3558,3564,75,81,376828,"1,343,303.93",270320
,20130618,3558,3564,3560,3578,3551,3568,3565,4,1,206286,"735,534.84",282798
,20130619,3568,3565,3573,3602,3551,3602,3578,37,13,466982,"1,671,004.60",323692
,20130620,3602,3578,3589,3590,3531,3550,3559,-28,-19,506292,"1,802,284.15",344514
,20130621,3550,3559,3481,3616,3481,3610,3572,51,13,1272786,"4,547,372.32",486192
,20130624,3610,3572,3598,3599,3531,3537,3556,-35,-16,1060688,"3,772,497.27",456458
,20130625,3537,3556,3540,3550,3483,3520,3507,-36,-49,1707844,"5,991,028.07",644890
,20130626,3520,3507,3521,3530,3453,3473,3484,-34,-23,1408246,"4,906,774.80",786782
,20130627,3473,3484,3482,3547,3442,3531,3508,47,24,2713646,"9,520,866.90",841920
,20130628,3531,3508,3519,3566,3509,3535,3536,27,28,2468258,"8,729,058.06",890670
,20130701,3535,3536,3531,3545,3501,3533,3522,-3,-14,2346576,"8,266,956.04",943024
,20130702,3533,3522,3549,3567,3538,3561,3554,39,32,2353976,"8,368,140.69",1005474
,20130703,3561,3554,3566,3628,3558,3616,3592,62,38,3680300,"13,222,322.39",1288434
,20130704,3616,3592,3621,3635,3599,3621,3617,29,25,2839812,"10,273,865.18",1246056
,20130705,3621,3617,3623,3638,3616,3621,3625,4,8,2329886,"8,448,152.76",1201610
,20130708,3621,3625,3618,3623,3575,3608,3595,-17,-30,3275272,"11,777,634.01",1155656
,20130709,3608,3595,3612,3624,3587,3597,3606,2,11,2856884,"10,303,042.85",1207044
,20130710,3597,3606,3594,3650,3579,3638,3614,32,8,3901094,"14,101,169.85",1394478
,20130711,3638,3614,3649,3700,3631,3646,3659,32,45,4498942,"16,461,685.40",1411580
,20130712,3646,3659,3646,3668,3637,3656,3655,-3,-4,2696638,"9,858,514.10",1381970
,20130715,3656,3655,3666,3694,3659,3661,3675,6,20,2989772,"10,989,554.18",1405440
,20130716,3661,3675,3665,3683,3653,3677,3670,2,-5,2363288,"8,673,666.76",1449548
,20130717,3677,3670,3681,3705,3675,3679,3686,9,16,2799256,"10,319,654.93",1369088
,20130718,3679,3686,3675,3682,3662,3680,3671,-6,-15,1863518,"6,842,587.88",1309816
,20130719,3680,3671,3688,3712,3685,3692,3696,21,25,2201432,"8,137,473.99",1344314
,20130722,3692,3696,3694,3697,3661,3678,3676,-18,-20,1821040,"6,695,361.46",1408464
,20130723,3678,3676,3676,3692,3673,3688,3685,12,9,1597738,"5,888,715.99",1452482
,20130724,3688,3685,3691,3708,3675,3694,3693,9,8,2284502,"8,438,889.45",1425146
,20130725,3694,3693,3687,3702,3683,3685,3691,-8,-2,1396490,"5,154,972.12",1427222
,20130726,3685,3691,3690,3691,3658,3669,3671,-22,-20,1479516,"5,432,751.71",1387950
,20130729,3669,3671,3650,3653,3627,3637,3641,-34,-30,1477246,"5,379,042.07",1321388
,20130730,3637,3641,3640,3647,3630,3633,3639,-8,-2,1279040,"4,654,517.02",1357868
,20130731,3633,3639,3613,3663,3613,3644,3641,5,2,1869274,"6,807,086.89",1356836
,20130801,3644,3641,3655,3660,3636,3647,3649,6,8,1295006,"4,726,770.57",1365752
,20130802,3647,3649,3651,3678,3651,3677,3668,28,19,1708558,"6,267,735.04",1390302
,20130805,3677,3668,3680,3688,3676,3685,3682,17,14,965688,"3,556,595.47",1359146
,20130806,3685,3682,3687,3693,3671,3691,3682,9,0,1206102,"4,442,036.43",1367800
,20130807,3691,3682,3693,3720,3685,3715,3704,33,22,1876022,"6,949,270.02",1515188
,20130808,3715,3704,3725,3748,3721,3743,3736,39,32,1660164,"6,202,911.96",1588342
,20130809,3743,3736,3744,3758,3718,3755,3739,19,3,1876310,"7,016,471.12",1538328
,20130812,3755,3739,3768,3812,3760,3810,3781,71,42,2069502,"7,824,979.62",1619916
,20130813,3810,3781,3819,3842,3804,3838,3822,57,41,2064072,"7,889,168.79",1654412
,20130814,3838,3822,3838,3848,3805,3819,3828,-3,6,1789832,"6,851,683.52",1658296
,20130815,3819,3828,3825,3833,3815,3819,3823,-9,-5,1497976,"5,727,547.04",1593880
,20130816,3819,3823,3823,3838,3802,3811,3813,-12,-10,1833066,"6,990,855.27",1508824
,20130819,3811,3813,3802,3843,3785,3812,3814,-1,1,1892324,"7,218,164.20",1552992
,20130820,3812,3814,3810,3828,3792,3796,3811,-18,-3,1517702,"5,784,803.35",1548418
,20130821,3796,3811,3796,3807,3786,3789,3797,-22,-14,1150250,"4,367,518.33",1559268
,20130822,3789,3797,3777,3799,3762,3769,3777,-28,-20,1747080,"6,599,955.24",1579348
,20130823,3769,3777,3772,3820,3771,3817,3803,40,26,2136050,"8,124,172.95",1553756
,20130826,3817,3803,3827,3848,3802,3813,3822,10,19,2048358,"7,830,723.95",1536606
,20130827,3813,3822,3801,3830,3776,3818,3802,-4,-20,2137384,"8,128,020.20",1451724
,20130828,3818,3802,3817,3835,3765,3767,3806,-35,4,2350504,"8,947,911.40",1388152
,20130829,3767,3806,3768,3790,3727,3749,3757,-57,-49,2330452,"8,757,385.34",1356098
,20130830,3749,3757,3733,3769,3732,3753,3754,-4,-3,1441268,"5,410,877.47",1321394
,20130902,3753,3754,3765,3797,3763,3787,3782,33,28,1452760,"5,494,883.26",1261620
,20130903,3787,3782,3793,3799,3741,3745,3764,-37,-18,2010496,"7,568,904.62",1476768
,20130904,3745,3764,3744,3756,3729,3737,3743,-27,-21,1309680,"4,902,240.75",1490822
,20130905,3737,3743,3731,3748,3723,3732,3735,-11,-8,1201718,"4,488,930.61",1429706
,20130906,3732,3735,3729,3733,3705,3723,3720,-12,-15,1544364,"5,745,834.06",1447746
,20130909,3723,3720,3732,3764,3732,3752,3751,32,31,1343182,"5,039,597.47",1423692
,20130910,3752,3751,3751,3755,3721,3736,3736,-15,-15,1186452,"4,432,609.30",1422682
,20130911,3736,3736,3731,3742,3716,3727,3726,-9,-10,1304284,"4,860,813.33",1514582
,20130912,3727,3726,3723,3734,3710,3713,3719,-13,-7,1060552,"3,945,117.65",1524132
,20130913,3713,3719,3709,3710,3655,3657,3676,-62,-43,1823146,"6,702,854.12",1548012
,20130916,3657,3676,3661,3668,3628,3647,3649,-29,-27,1416362,"5,169,324.29",1501692
,20130917,3647,3649,3645,3661,3636,3647,3646,-2,-3,1199380,"4,374,137.86",1520864
,20130918,3647,3646,3640,3643,3618,3633,3631,-13,-15,1376762,"4,999,667.50",1461740
,20130923,3633,3631,3629,3656,3612,3655,3637,24,6,1429956,"5,201,951.48",1540458
,20130924,3655,3637,3653,3664,3626,3627,3642,-10,5,1224802,"4,461,865.05",1594662
,20130925,3627,3642,3627,3637,3617,3626,3625,-16,-17,1026100,"3,720,296.25",1564742
,20130926,3626,3625,3625,3628,3605,3613,3616,-12,-9,1024020,"3,703,347.05",1542336
,20130927,3613,3616,3610,3612,3570,3576,3586,-40,-30,1164922,"4,178,204.20",1498626
,20130930,3576,3586,3586,3598,3581,3587,3588,1,2,648414,"2,326,964.84",1384192
,20131008,3587,3588,3579,3600,3541,3599,3563,11,-25,1071150,"3,816,677.55",1412986
,20131009,3599,3563,3594,3621,3580,3589,3599,26,36,1716768,"6,178,817.74",1482090
,20131010,3589,3599,3587,3608,3584,3597,3596,-2,-3,1022460,"3,677,007.33",1461730
,20131011,3597,3596,3603,3621,3590,3601,3607,5,11,1156954,"4,173,678.36",1507714
,20131014,3601,3607,3602,3628,3598,3625,3612,18,5,1129852,"4,081,579.98",1455458
,20131015,3625,3612,3626,3636,3585,3606,3613,-6,1,1206938,"4,361,797.60",1479608
,20131016,3606,3613,3610,3612,3560,3567,3582,-46,-31,1254510,"4,494,445.45",1503134
,20131017,3567,3582,3577,3586,3557,3558,3570,-24,-12,991812,"3,541,579.03",1409634
,20131018,3558,3570,3563,3581,3539,3568,3561,-2,-9,1365830,"4,863,856.81",1306888
,20131021,3568,3561,3558,3583,3551,3570,3566,9,5,769944,"2,746,374.83",1283468
,20131022,3570,3566,3565,3577,3555,3557,3562,-9,-4,476304,"1,696,867.38",1288314
,20131023,3557,3562,3559,3572,3536,3537,3554,-25,-8,518390,"1,842,590.73",1243242
,20131024,3537,3554,3520,3538,3516,3519,3525,-35,-29,443932,"1,565,298.41",1253902
,20131025,3519,3525,3521,3530,3485,3486,3510,-39,-15,392180,"1,376,612.60",1203870
,20131028,3486,3510,3490,3500,3479,3485,3489,-25,-21,260978,"910,608.60",1183736
,20131029,3485,3489,3482,3498,3470,3494,3484,5,-5,405792,"1,414,068.69",1144182
,20131030,3494,3484,3498,3521,3487,3521,3500,37,16,431352,"1,509,925.71",1041342
,20131031,3521,3500,3519,3520,3497,3506,3509,6,9,226800,"795,859.29",1009314
,20131101,3506,3509,3502,3544,3502,3542,3525,33,16,458978,"1,618,241.94",859552
,20131104,3542,3525,3544,3548,3522,3536,3536,11,11,216314,"764,893.15",776096
,20131105,3536,3536,3542,3548,3523,3534,3531,-2,-5,160442,"566,667.95",714504
,20131106,3534,3531,3536,3537,3510,3521,3522,-10,-9,167854,"591,219.26",670952
,20131107,3521,3522,3524,3593,3520,3580,3561,58,39,364950,"1,299,807.14",577106
,20131108,3580,3561,3583,3583,3562,3566,3571,5,10,168598,"602,199.94",542160
,20131111,3566,3571,3558,3571,3540,3563,3555,-8,-16,105786,"376,074.94",533660
,20131112,3563,3555,3569,3575,3553,3557,3561,2,6,61790,"220,084.42",526326
,20131113,3557,3561,3553,3562,3540,3544,3549,-17,-12,71928,"255,343.34",509656
,20131114,3544,3549,3540,3543,3520,3521,3530,-28,-19,79664,"281,281.29",487806
,20131115,3521,3530,3525,3538,3504,3506,3520,-24,-10,98002,"344,968.37",458042
,20131118,3506,3520,3510,3515,3501,3506,3507,-14,-13,64616,"226,608.35",436332
,20131119,3506,3507,3505,3532,3500,3532,3516,25,9,66704,"234,538.77",415912
,20131120,3532,3516,3535,3545,3530,3544,3538,28,22,47586,"168,362.40",404072
,20131121,3544,3538,3541,3546,3524,3529,3530,-9,-8,48072,"169,702.33",392780
,20131122,3529,3530,3531,3543,3526,3528,3533,-2,3,39906,"141,000.79",379818
,20131125,3528,3533,3530,3549,3528,3534,3536,1,3,48742,"172,354.16",361866
,20131126,3534,3536,3541,3554,3537,3546,3547,10,11,68554,"243,168.75",332736
,20131127,3546,3547,3548,3550,3539,3540,3542,-7,-5,34126,"120,882.23",316180
,20131128,3540,3542,3540,3560,3535,3557,3551,15,9,41948,"148,958.85",295244
,20131129,3557,3551,3558,3561,3547,3550,3550,-1,-1,41762,"148,287.38",268284
,20131202,3550,3550,3550,3571,3550,3569,3561,19,11,75386,"268,504.96",218648
,20131203,3569,3561,3572,3582,3565,3582,3574,21,13,37014,"132,315.20",202628
,20131204,3582,3574,3583,3590,3578,3581,3584,7,10,26984,"96,728.41",189970
,20131205,3581,3584,3581,3581,3563,3563,3570,-21,-14,29720,"106,108.07",173446
,20131206,3563,3570,3562,3563,3554,3560,3558,-10,-12,19282,"68,608.47",165184
,20131209,3560,3558,3562,3578,3562,3575,3572,17,14,23904,"85,405.85",150846
,20131210,3575,3572,3600,3600,3565,3578,3576,6,4,23052,"82,453.81",137720
,20131211,3578,3576,3579,3595,3569,3595,3582,19,6,32114,"115,041.61",119610
,20131212,3595,3582,3595,3605,3590,3593,3597,11,15,19956,"71,797.89",108004
,20131213,3593,3597,3586,3589,3557,3559,3569,-38,-28,35622,"127,144.89",90710
,20131216,3559,3569,3559,3582,3545,3545,3561,-24,-8,16220,"57,762.14",87428
,20131217,3545,3561,3554,3558,3538,3538,3545,-23,-16,10284,"36,457.86",84238
,20131218,3538,3545,3538,3542,3521,3540,3530,-5,-15,11110,"39,226.68",78258
,20131219,3540,3530,3550,3550,3530,3531,3540,1,10,7820,"27,686.58",74650
,20131220,3531,3540,3531,3545,3530,3535,3537,-5,-3,15350,"54,294.05",69850
,20131223,3535,3537,3522,3529,3488,3489,3506,-48,-31,19146,"67,136.01",58392
,20131224,3489,3506,3489,3507,3485,3485,3498,-21,-8,12974,"45,384.64",52066
,20131225,3485,3498,3492,3493,3450,3451,3465,-47,-33,16038,"55,586.44",43132
,20131226,3451,3465,3451,3451,3424,3434,3435,-31,-30,18520,"63,627.28",32998
,20131227,3434,3435,3433,3446,3433,3438,3439,3,4,10438,"35,897.33",28076
,20131230,3438,3439,3437,3445,3354,3379,3417,-60,-22,13880,"47,436.04",19358
,20131231,3379,3417,3374,3380,3290,3347,3344,-70,-73,14230,"47,590.47",13264
rb1402,20130219,4245,4245,4110,4219,4110,4205,4186,-40,-59,10,41.87,6
,20130220,4205,4186,4210,4236,4210,4236,4231,50,45,12,50.78,16
,20130221,4236,4231,4176,4176,4125,4140,4162,-91,-69,16,66.6,24
,20130222,4140,4162,4116,4116,4035,4035,4083,-127,-79,16,65.33,26
,20130225,4035,4083,4070,4070,4015,4030,4037,-53,-46,42,169.59,22
,20130226,4030,4037,4019,4020,3971,3971,4009,-66,-28,14,56.14,20
,20130227,3971,4009,3952,4016,3952,4000,3989,-9,-20,6,23.94,20
,20130228,4000,3989,4031,4092,4031,4080,4061,91,72,18,73.1,30
,20130301,4080,4061,4048,4048,3857,3999,3995,-62,-66,30,119.87,24
,20130304,3999,3995,3981,3981,3915,3915,3918,-80,-77,122,478.04,136
,20130305,3915,3918,3929,3950,3929,3950,3938,32,20,8,31.51,134
,20130306,3950,3938,3966,3971,3960,3960,3964,22,26,12,47.58,136
,20130307,3960,3964,3958,3960,3958,3960,3958,-4,-6,16,63.34,132
,20130308,3960,3958,3955,3955,3939,3939,3951,-19,-7,8,31.61,128
,20130311,3939,3951,3903,3942,3903,3916,3921,-35,-30,18,70.58,128
,20130312,3916,3921,3903,3964,3900,3914,3909,-7,-12,62,242.37,158
,20130313,3914,3909,3874,3874,3850,3855,3854,-54,-55,24,92.51,172
,20130314,3855,3854,3821,3832,3782,3798,3792,-56,-62,290,"1,099.74",270
,20130315,3798,3792,3815,3908,3810,3908,3884,116,92,16,62.15,274
,20130318,3908,3884,3858,3858,3849,3849,3851,-35,-33,26,100.14,282
,20130319,3849,3851,3856,3864,3853,3854,3856,3,5,16,61.7,278
,20130320,3854,3856,3860,3891,3860,3891,3870,35,14,6,23.22,276
,20130321,3891,3870,3912,3933,3912,3933,3925,63,55,20,78.5,268
,20130322,3933,3925,3920,3920,3901,3911,3911,-14,-14,80,312.95,238
,20130325,3911,3911,3934,3937,3934,3937,3936,26,25,14,55.11,242
,20130326,3937,3936,3892,3915,3892,3915,3907,-21,-29,6,23.44,244
,20130327,3915,3907,3908,3919,3908,3919,3913,12,6,8,31.31,242
,20130328,3919,3913,3847,3847,3847,3847,3847,-66,-66,2,7.69,244
,20130329,3847,3847,3862,3862,3860,3860,3861,13,14,12,46.34,240
,20130401,3860,3861,3820,3820,3783,3783,3801,-78,-60,104,395.35,244
,20130402,3783,3801,3800,3800,3800,3800,3800,-1,-1,2,7.6,242
,20130403,3800,3800,3813,3864,3813,3852,3841,52,41,58,222.78,234
,20130408,3852,3841,3830,3887,3830,3887,3870,46,29,34,131.58,212
,20130409,3887,3870,3900,3900,3900,3900,3900,30,30,14,54.6,198
,20130410,3900,3900,,,,3900,3900,0,0,0,0,198
,20130411,3900,3900,3910,3910,3910,3910,3910,10,10,2,7.82,198
,20130412,3910,3910,3899,3899,3899,3899,3899,-11,-11,8,31.19,194
,20130415,3899,3899,3840,3840,3789,3789,3814,-110,-85,4,15.26,194
,20130416,3789,3814,3712,3820,3712,3812,3781,-2,-33,318,"1,202.40",228
,20130417,3812,3781,3807,3807,3770,3770,3786,-11,5,46,174.18,214
,20130418,3770,3786,3678,3767,3678,3746,3734,-40,-52,302,"1,127.68",288
,20130419,3746,3734,3771,3771,3735,3739,3752,5,18,12,45.03,284
,20130422,3739,3752,3732,3752,3727,3729,3737,-23,-15,52,194.37,274
,20130423,3729,3737,3690,3695,3676,3676,3687,-61,-50,28,103.26,258
,20130424,3676,3687,3711,3729,3711,3728,3728,41,41,86,320.62,260
,20130425,3728,3728,,,,3733,3733,5,5,0,0,260
,20130426,3733,3733,3696,3700,3696,3700,3698,-33,-35,4,14.79,262
,20130502,3700,3698,,,,3608,3608,-90,-90,0,0,262
,20130503,3608,3608,3689,3689,3689,3689,3689,81,81,2,7.38,264
,20130506,3689,3689,3720,3735,3720,3735,3733,46,44,48,179.19,262
,20130507,3735,3733,3723,3750,3620,3724,3699,-9,-34,144,532.71,274
,20130508,3724,3699,3740,3740,3740,3740,3740,41,41,10,37.4,264
,20130509,3740,3740,3726,3726,3704,3704,3711,-36,-29,6,22.27,266
,20130510,3704,3711,3703,3721,3703,3715,3713,4,2,6,22.28,268
,20130513,3715,3713,3740,3755,3740,3755,3747,42,34,4,14.99,266
,20130514,3755,3747,3730,3752,3716,3724,3732,-23,-15,12,44.79,266
,20130515,3724,3732,3701,3701,3632,3632,3660,-100,-72,8,29.28,264
,20130516,3632,3660,,,,3632,3632,-28,-28,0,0,264
,20130517,3632,3632,3608,3718,3608,3718,3654,86,22,12,43.86,264
,20130520,3718,3654,3705,3705,3705,3705,3705,51,51,2,7.41,264
,20130521,3705,3705,3664,3666,3664,3666,3665,-39,-40,4,14.66,266
,20130522,3666,3665,3700,3700,3700,3700,3700,35,35,2,7.4,266
,20130523,3700,3700,3672,3672,3655,3655,3663,-45,-37,4,14.65,264
,20130524,3655,3663,3644,3644,3644,3644,3644,-19,-19,2,7.29,262
,20130527,3644,3644,3624,3628,3581,3581,3604,-63,-40,16,57.67,268
,20130528,3581,3604,3580,3603,3566,3603,3578,-1,-26,20,71.56,272
,20130529,3603,3578,3600,3600,3564,3564,3581,-14,3,6,21.49,270
,20130530,3564,3581,3542,3558,3541,3541,3542,-40,-39,128,453.5,360
,20130531,3541,3542,3550,3550,3517,3524,3528,-18,-14,26,91.73,360
,20130603,3524,3528,3563,3602,3563,3602,3579,74,51,52,186.15,376
,20130604,3602,3579,3605,3605,3581,3591,3592,12,13,76,273.07,364
,20130605,3591,3592,3605,3610,3600,3610,3603,18,11,74,266.65,384
,20130606,3610,3603,3568,3574,3521,3521,3557,-82,-46,16,56.92,382
,20130607,3521,3557,3530,3540,3519,3519,3526,-38,-31,12,42.32,374
,20130613,3519,3526,3539,3547,3523,3523,3536,-3,10,40,141.47,388
,20130614,3523,3536,3523,3530,3513,3530,3523,-6,-13,218,768.1,360
,20130617,3530,3523,3586,3603,3586,3595,3591,72,68,38,136.48,342
,20130618,3595,3591,3598,3602,3598,3602,3600,11,9,36,129.62,334
,20130619,3602,3600,3596,3608,3596,3608,3599,8,-1,26,93.59,332
,20130620,3608,3599,3607,3607,3570,3585,3590,-14,-9,42,150.81,346
,20130621,3585,3590,3581,3628,3581,3624,3606,34,16,24,86.56,336
,20130624,3624,3606,3621,3621,3575,3576,3595,-30,-11,196,704.77,354
,20130625,3576,3595,3578,3578,3521,3561,3551,-34,-44,154,546.92,400
,20130626,3561,3551,3544,3547,3496,3508,3519,-43,-32,82,288.61,384
,20130627,3508,3519,3494,3575,3492,3560,3532,41,13,68,240.23,372
,20130628,3560,3532,3560,3578,3550,3558,3562,26,30,76,270.76,344
,20130701,3558,3562,3563,3566,3542,3566,3550,4,-12,26,92.32,336
,20130702,3566,3550,3579,3590,3569,3579,3579,29,29,66,236.22,332
,20130703,3579,3579,3599,3651,3592,3627,3621,48,42,158,572.17,318
,20130704,3627,3621,3642,3655,3628,3652,3641,31,20,102,371.4,316
,20130705,3652,3641,3650,3656,3646,3646,3650,5,9,42,153.31,312
,20130708,3646,3650,3667,3667,3611,3635,3630,-15,-20,138,501.05,292
,20130709,3635,3630,3651,3657,3624,3624,3638,-6,8,126,458.44,304
,20130710,3624,3638,3632,3672,3610,3666,3644,28,6,138,502.93,340
,20130711,3666,3644,3697,3715,3671,3685,3690,41,46,108,398.56,342
,20130712,3685,3690,3673,3688,3669,3686,3678,-4,-12,96,353.16,336
,20130715,3686,3678,3689,3726,3684,3684,3698,6,20,140,517.74,358
,20130716,3684,3698,3689,3702,3678,3692,3695,-6,-3,118,436.05,330
,20130717,3692,3695,3698,3712,3698,3703,3703,8,8,64,237,346
,20130718,3703,3703,3695,3703,3693,3699,3696,-4,-7,24,88.71,346
,20130719,3699,3696,3712,3723,3693,3717,3709,21,13,156,578.72,358
,20130722,3717,3709,3698,3698,3688,3690,3692,-19,-17,420,"1,551.00",380
,20130723,3690,3692,3697,3735,3697,3700,3707,8,15,98,363.34,364
,20130724,3700,3707,3715,3728,3697,3711,3704,4,-3,772,"2,860.17",338
,20130725,3711,3704,3709,3714,3707,3708,3711,4,7,18,66.8,336
,20130726,3708,3711,3704,3704,3688,3688,3692,-23,-19,174,642.52,306
,20130729,3688,3692,3672,3674,3649,3658,3659,-34,-33,88,322.05,310
,20130730,3658,3659,3662,3662,3656,3656,3657,-3,-2,8,29.26,312
,20130731,3656,3657,3669,3680,3661,3663,3673,6,16,130,477.59,356
,20130801,3663,3673,3664,3676,3660,3660,3663,-13,-10,80,293.06,352
,20130802,3660,3663,3684,3692,3684,3692,3690,29,27,10,36.9,352
,20130805,3692,3690,,,,3705,3705,15,15,0,0,352
,20130806,3705,3705,3692,3701,3692,3701,3697,-4,-8,48,177.46,384
,20130807,3701,3697,3715,3734,3714,3734,3717,37,20,52,193.32,372
,20130808,3734,3717,3756,3766,3748,3766,3757,49,40,88,330.64,382
,20130809,3766,3757,3765,3771,3745,3767,3764,10,7,38,143.05,382
,20130812,3767,3764,3790,3821,3786,3821,3810,57,46,266,"1,013.57",554
,20130813,3821,3810,3823,3842,3812,3842,3828,32,18,1218,"4,663.46",1156
,20130814,3842,3828,3849,3850,3810,3820,3833,-8,5,204,781.98,1114
,20130815,3820,3833,3833,3833,3814,3814,3826,-19,-7,180,688.78,1114
,20130816,3814,3826,3806,3828,3806,3812,3814,-14,-12,164,625.5,1110
,20130819,3812,3814,3796,3856,3796,3821,3833,7,19,5482,"21,016.55",2092
,20130820,3821,3833,3818,3828,3805,3809,3821,-24,-12,490,"1,872.50",1954
,20130821,3809,3821,3806,3811,3792,3792,3801,-29,-20,160,608.21,1900
,20130822,3792,3801,3780,3797,3770,3775,3779,-26,-22,128,483.77,1840
,20130823,3775,3779,3788,3820,3788,3820,3807,41,28,88,335.05,1832
,20130826,3820,3807,3832,3847,3812,3812,3830,5,23,32,122.56,1814
,20130827,3812,3830,3799,3830,3784,3823,3796,-7,-34,592,"2,247.53",1684
,20130828,3823,3796,3823,3833,3776,3776,3822,-20,26,258,986.16,1594
,20130829,3776,3822,3780,3780,3745,3766,3762,-56,-60,136,511.68,1558
,20130830,3766,3762,3756,3766,3745,3754,3758,-8,-4,40,150.32,1564
,20130902,3754,3758,3793,3797,3775,3790,3780,32,22,166,627.56,1556
,20130903,3790,3780,3799,3799,3749,3749,3767,-31,-13,154,580.25,1558
,20130904,3749,3767,3759,3763,3738,3738,3755,-29,-12,62,232.85,1550
,20130905,3738,3755,3746,3748,3731,3742,3743,-13,-12,42,157.21,1548
,20130906,3742,3743,3733,3741,3712,3721,3730,-22,-13,30,111.9,1532
,20130909,3721,3730,3752,3765,3748,3764,3753,34,23,74,277.79,1524
,20130910,3764,3753,3732,3740,3731,3731,3735,-22,-18,10,37.35,1530
,20130911,3731,3735,3725,3736,3725,3736,3729,1,-6,14,52.21,1528
,20130912,3736,3729,3730,3730,3720,3724,3724,-5,-5,34,126.63,1518
,20130913,3724,3724,3690,3691,3674,3674,3679,-50,-45,60,220.76,1500
,20130916,3674,3679,3670,3673,3629,3638,3653,-41,-26,156,569.98,1506
,20130917,3638,3653,3658,3658,3658,3658,3658,5,5,2,7.32,1504
,20130918,3658,3658,3631,3642,3630,3640,3633,-18,-25,118,428.69,1532
,20130923,3640,3633,3624,3662,3617,3655,3653,22,20,1832,"6,693.65",3314
,20130924,3655,3653,3656,3663,3630,3632,3651,-21,-2,656,"2,395.62",3778
,20130925,3632,3651,3632,3639,3620,3624,3627,-27,-24,164,594.89,3776
,20130926,3624,3627,3622,3626,3611,3613,3620,-14,-7,200,724.09,3776
,20130927,3613,3620,3610,3610,3582,3584,3593,-36,-27,228,819.22,3704
,20130930,3584,3593,3594,3596,3584,3590,3589,-3,-4,68,244.1,3708
,20131008,3590,3589,3639,3639,3547,3592,3573,3,-16,398,"1,422.14",3708
,20131009,3592,3573,3590,3622,3581,3591,3599,18,26,1566,"5,636.62",3998
,20131010,3591,3599,3601,3605,3586,3597,3597,-2,-2,138,496.42,4000
,20131011,3597,3597,3618,3618,3595,3604,3612,7,15,522,"1,885.57",4410
,20131014,3604,3612,3610,3625,3605,3621,3617,9,5,660,"2,387.46",4944
,20131015,3621,3617,3633,3633,3583,3598,3614,-19,-3,312,"1,127.58",4946
,20131016,3598,3614,3599,3599,3560,3566,3579,-48,-35,440,"1,574.77",4944
,20131017,3566,3579,3570,3578,3551,3553,3569,-26,-10,902,"3,219.80",4948
,20131018,3553,3569,3555,3602,3533,3558,3552,-11,-17,470,"1,669.45",4952
,20131021,3558,3552,3550,3567,3547,3565,3554,13,2,118,419.45,4956
,20131022,3565,3554,3555,3568,3552,3555,3561,1,7,48,170.94,4958
,20131023,3555,3561,3556,3561,3532,3532,3537,-29,-24,118,417.46,4948
,20131024,3532,3537,3500,3526,3499,3524,3516,-13,-21,86,302.43,4950
,20131025,3524,3516,3522,3522,3480,3480,3501,-36,-15,90,315.17,4950
,20131028,3480,3501,3480,3488,3473,3480,3479,-21,-22,112,389.73,4910
,20131029,3480,3479,3482,3486,3465,3483,3473,4,-6,114,395.98,4830
,20131030,3483,3473,3503,3511,3485,3511,3490,38,17,148,516.62,4774
,20131031,3511,3490,3499,3505,3492,3499,3499,9,9,48,167.99,4766
,20131101,3499,3499,3505,3532,3497,3532,3508,33,9,138,484.24,4740
,20131104,3532,3508,3527,3530,3517,3522,3523,14,15,66,232.57,4736
,20131105,3522,3523,3517,3525,3511,3520,3517,-3,-6,42,147.75,4734
,20131106,3520,3517,3517,3518,3500,3502,3505,-15,-12,92,322.54,4726
,20131107,3502,3505,3522,3579,3512,3579,3535,74,30,288,"1,018.13",4734
,20131108,3579,3535,3546,3546,3529,3531,3537,-4,2,136,481.05,4728
,20131111,3531,3537,3531,3533,3510,3528,3523,-9,-14,156,549.62,4736
,20131112,3528,3523,3535,3535,3518,3528,3524,5,1,156,549.77,4732
,20131113,3528,3524,3525,3528,3504,3508,3516,-16,-8,302,"1,061.98",4716
,20131114,3508,3516,3504,3504,3481,3488,3488,-28,-28,294,"1,025.56",4684
,20131115,3488,3488,3488,3497,3475,3475,3485,-13,-3,502,"1,749.91",4362
,20131118,3475,3485,3469,3482,3462,3465,3469,-20,-16,152,527.3,4342
,20131119,3465,3469,3471,3479,3471,3479,3475,10,6,92,319.72,4350
,20131120,3479,3475,3494,3500,3480,3488,3490,13,15,156,544.51,4346
,20131121,3488,3490,3489,3491,3467,3476,3477,-14,-13,74,257.31,4344
,20131122,3476,3477,3484,3490,3474,3478,3481,1,4,82,285.46,4342
,20131125,3478,3481,3485,3490,3477,3480,3482,-1,1,74,257.69,4344
,20131126,3480,3482,3483,3516,3483,3507,3504,25,22,432,"1,514.01",4502
,20131127,3507,3504,3503,3505,3494,3495,3501,-9,-3,118,413.18,4494
,20131128,3495,3501,3502,3521,3502,3512,3512,11,11,214,751.75,4346
,20131129,3512,3512,3509,3516,3507,3511,3512,-1,0,116,407.47,4346
,20131202,3511,3512,3515,3530,3513,3530,3520,18,8,38,133.78,4344
,20131203,3530,3520,3527,3543,3525,3543,3531,23,11,174,614.41,4352
,20131204,3543,3531,3544,3556,3538,3545,3547,14,16,174,617.28,4352
,20131205,3545,3547,3543,3543,3526,3533,3533,-14,-14,62,219.1,4348
,20131206,3533,3533,3516,3525,3516,3523,3522,-10,-11,28,98.63,4352
,20131209,3523,3522,3537,3541,3531,3538,3536,16,14,138,487.97,4356
,20131210,3538,3536,3548,3548,3533,3538,3541,2,5,110,389.53,4346
,20131211,3538,3541,3527,3554,3523,3548,3541,7,0,92,325.79,4352
,20131212,3548,3541,3553,3560,3551,3551,3554,10,13,52,184.85,4346
,20131213,3551,3554,3518,3572,3500,3505,3519,-49,-35,50,175.99,4344
,20131216,3505,3519,3534,3534,3491,3497,3501,-22,-18,80,280.11,4344
,20131217,3497,3501,3481,3499,3481,3481,3489,-20,-12,224,781.64,4406
,20131218,3481,3489,3472,3484,3471,3483,3472,-6,-17,72,250.05,4404
,20131219,3483,3472,3484,3494,3470,3471,3485,-1,13,96,334.56,4400
,20131220,3471,3485,3474,3474,3454,3454,3465,-31,-20,144,499.07,4344
,20131223,3454,3465,3444,3459,3435,3435,3441,-30,-24,198,681.41,4326
,20131224,3435,3441,3432,3443,3430,3430,3434,-11,-7,42,144.26,4318
,20131225,3430,3434,3440,3440,3420,3423,3424,-11,-10,104,356.14,4314
,20131226,3423,3424,3423,3424,3411,3413,3417,-11,-7,110,375.91,4288
,20131227,3413,3417,3414,3420,3413,3418,3416,1,-1,74,252.8,4288
,20131230,3418,3416,3419,3425,3370,3373,3395,-43,-21,416,"1,412.63",4292
,20131231,3373,3395,3363,3377,3339,3339,3351,-56,-44,490,"1,642.04",4444
rb1403,20130318,3884,3884,,,,3884,3884,0,0,0,0,0
,20130319,3884,3884,,,,3889,3889,5,5,0,0,0
,20130320,3889,3889,3910,3910,3847,3905,3887,16,-2,6,23.32,0
,20130321,3905,3887,,,,3914,3914,27,27,0,0,0
,20130322,3914,3914,,,,3914,3914,0,0,0,0,0
,20130325,3914,3914,,,,3916,3916,2,2,0,0,0
,20130326,3916,3916,3916,3922,3916,3922,3919,6,3,10,39.2,10
,20130327,3922,3919,3928,3928,3928,3928,3928,9,9,6,23.57,14
,20130328,3928,3928,3900,3922,3854,3854,3895,-74,-33,28,109.07,26
,20130329,3854,3895,,,,3879,3879,-16,-16,0,0,26
,20130401,3879,3879,3814,3814,3791,3797,3797,-82,-82,36,136.72,52
,20130402,3797,3797,3792,3806,3761,3801,3794,4,-3,32,121.43,72
,20130403,3801,3794,3818,3862,3818,3861,3855,67,61,34,131.1,90
,20130408,3861,3855,3867,3888,3867,3877,3875,22,20,24,93.02,88
,20130409,3877,3875,3877,3908,3877,3905,3898,30,23,24,93.55,90
,20130410,3905,3898,3898,3898,3878,3889,3895,-9,-3,138,537.58,198
,20130411,3889,3895,3915,3936,3886,3886,3913,-9,18,138,540.04,210
,20130412,3886,3913,3875,3897,3875,3891,3885,-22,-28,10,38.86,208
,20130415,3891,3885,3846,3846,3782,3800,3810,-85,-75,12,45.72,208
,20130416,3800,3810,3726,3827,3726,3825,3796,15,-14,194,736.61,330
,20130417,3825,3796,3845,3870,3780,3816,3821,20,25,200,764.3,314
,20130418,3816,3821,3714,3765,3701,3759,3737,-62,-84,132,493.31,354
,20130419,3759,3737,3747,3780,3747,3780,3758,43,21,32,120.28,368
,20130422,3780,3758,3789,3801,3749,3750,3763,-8,5,34,127.95,366
,20130423,3750,3763,3734,3734,3687,3691,3716,-72,-47,14,52.02,368
,20130424,3691,3716,3709,3745,3709,3745,3740,29,24,48,179.54,348
,20130425,3745,3740,3740,3782,3740,3767,3755,27,15,36,135.21,336
,20130426,3767,3755,3779,3785,3738,3738,3771,-17,16,26,98.05,334
,20130502,3738,3771,3669,3669,3669,3669,3669,-102,-102,2,7.34,332
,20130503,3669,3669,3722,3722,3695,3695,3713,26,44,6,22.28,334
,20130506,3695,3713,3753,3759,3734,3749,3751,36,38,22,82.54,332
,20130507,3749,3751,3748,3765,3740,3765,3749,14,-2,20,75,332
,20130508,3765,3749,3772,3772,3753,3759,3766,10,17,22,82.86,334
,20130509,3759,3766,3744,3755,3730,3730,3741,-36,-25,12,44.89,334
,20130510,3730,3741,3735,3773,3735,3748,3747,7,6,10,37.47,334
,20130513,3748,3747,3752,3752,3752,3752,3752,5,5,2,7.5,332
,20130514,3752,3752,,,,3737,3737,-15,-15,0,0,332
,20130515,3737,3737,3732,3739,3685,3685,3714,-52,-23,24,89.14,332
,20130516,3685,3714,3669,3705,3644,3665,3671,-49,-43,18,66.09,330
,20130517,3665,3671,3675,3699,3668,3694,3681,23,10,86,316.62,318
,20130520,3694,3681,3737,3737,3735,3735,3736,54,55,8,29.89,320
,20130521,3735,3736,3707,3712,3700,3708,3706,-28,-30,24,88.97,316
,20130522,3708,3706,3710,3726,3701,3719,3713,13,7,46,170.8,308
,20130523,3719,3713,3692,3692,3660,3660,3678,-53,-35,20,73.56,300
,20130524,3660,3678,3675,3682,3675,3682,3680,4,2,10,36.8,300
,20130527,3682,3680,3650,3664,3634,3645,3645,-35,-35,74,269.79,294
,20130528,3645,3645,3640,3640,3620,3627,3626,-18,-19,66,239.36,292
,20130529,3627,3626,3650,3665,3578,3580,3623,-46,-3,72,260.88,282
,20130530,3580,3623,3576,3580,3559,3575,3571,-48,-52,24,85.73,280
,20130531,3575,3571,3580,3580,3558,3558,3569,-13,-2,4,14.28,278
,20130603,3558,3569,3581,3601,3578,3595,3586,26,17,10,35.87,280
,20130604,3595,3586,3600,3600,3600,3600,3600,14,14,2,7.2,278
,20130605,3600,3600,3622,3633,3620,3633,3625,33,25,62,224.76,272
,20130606,3633,3625,3580,3580,3560,3560,3572,-65,-53,64,228.65,312
,20130607,3560,3572,3563,3570,3522,3570,3561,-2,-11,86,306.32,362
,20130613,3570,3561,3567,3567,3552,3552,3559,-9,-2,10,35.6,362
,20130614,3552,3559,3563,3563,3563,3563,3563,4,4,12,42.76,366
,20130617,3563,3563,3626,3646,3622,3622,3631,59,68,18,65.37,358
,20130618,3622,3631,3622,3630,3622,3628,3626,-3,-5,6,21.76,356
,20130619,3628,3626,3622,3625,3622,3625,3623,-1,-3,52,188.42,378
,20130620,3625,3623,3632,3632,3595,3600,3616,-23,-7,36,130.2,362
,20130621,3600,3616,3549,3644,3546,3644,3593,28,-23,48,172.51,330
,20130624,3644,3593,3633,3633,3593,3606,3606,13,13,16,57.7,330
,20130625,3606,3606,3592,3592,3530,3556,3557,-50,-49,8,28.46,328
,20130626,3556,3557,3557,3557,3519,3519,3534,-38,-23,10,35.34,328
,20130627,3519,3534,3511,3575,3511,3575,3564,41,30,252,898.33,404
,20130628,3575,3564,3576,3595,3576,3588,3581,24,17,50,179.09,390
,20130701,3588,3581,3564,3584,3564,3584,3575,3,-6,14,50.05,392
,20130702,3584,3575,3603,3609,3603,3604,3605,29,30,16,57.69,378
,20130703,3604,3605,3622,3671,3622,3671,3650,66,45,24,87.61,376
,20130704,3671,3650,3670,3670,3653,3653,3666,3,16,10,36.66,378
,20130705,3653,3666,3670,3670,3669,3669,3669,3,3,4,14.68,378
,20130708,3669,3669,3618,3645,3618,3629,3629,-40,-40,8,29.04,374
,20130709,3629,3629,3650,3650,3637,3637,3640,8,11,10,36.4,380
,20130710,3637,3640,3642,3681,3642,3681,3661,41,21,4,14.65,380
,20130711,3681,3661,3681,3721,3681,3711,3711,50,50,30,111.33,378
,20130712,3711,3711,3705,3705,3701,3701,3703,-10,-8,30,111.09,388
,20130715,3701,3703,3725,3726,3702,3702,3712,-1,9,20,74.24,386
,20130716,3702,3712,3700,3705,3699,3699,3701,-13,-11,12,44.41,382
,20130717,3699,3701,3720,3720,3714,3715,3717,14,16,24,89.21,362
,20130718,3715,3717,3708,3710,3705,3705,3707,-12,-10,38,140.87,340
,20130719,3705,3707,,,,3707,3707,0,0,0,0,340
,20130722,3707,3707,3707,3712,3707,3708,3708,1,1,16,59.33,342
,20130723,3708,3708,3730,3730,3719,3725,3724,17,16,34,126.62,346
,20130724,3725,3724,3725,3738,3721,3721,3729,-3,5,8,29.83,344
,20130725,3721,3729,3720,3720,3720,3720,3720,-9,-9,2,7.44,344
,20130726,3720,3720,3703,3703,3696,3696,3699,-24,-21,4,14.8,344
,20130729,3696,3699,3676,3676,3674,3674,3675,-25,-24,4,14.7,340
,20130730,3674,3675,3666,3666,3666,3666,3666,-9,-9,2,7.33,340
,20130731,3666,3666,3668,3675,3668,3675,3670,9,4,6,22.02,338
,20130801,3675,3670,3685,3685,3670,3670,3681,0,11,16,58.91,334
,20130802,3670,3681,3662,3679,3662,3679,3670,-2,-11,24,88.09,334
,20130805,3679,3670,,,,3684,3684,14,14,0,0,334
,20130806,3684,3684,3704,3704,3701,3704,3702,20,18,12,44.43,326
,20130807,3704,3702,3728,3744,3728,3737,3737,35,35,28,104.66,320
,20130808,3737,3737,3758,3788,3736,3782,3771,45,34,100,377.19,320
,20130809,3782,3771,3780,3780,3769,3776,3775,5,4,20,75.51,326
,20130812,3776,3775,3776,3800,3773,3800,3778,25,3,60,226.73,332
,20130813,3800,3778,3878,3878,3815,3853,3849,75,71,82,315.63,392
,20130814,3853,3849,3852,3866,3831,3833,3845,-16,-4,84,323.05,358
,20130815,3833,3845,3830,3830,3830,3830,3830,-15,-15,2,7.66,358
,20130816,3830,3830,3821,3822,3810,3822,3819,-8,-11,34,129.87,338
,20130819,3822,3819,3797,3841,3792,3841,3824,22,5,32,122.37,324
,20130820,3841,3824,3830,3830,3828,3828,3829,4,5,36,137.84,324
,20130821,3828,3829,3830,3830,3818,3818,3828,-11,-1,26,99.53,324
,20130822,3818,3828,3810,3810,3810,3810,3810,-18,-18,2,7.62,324
,20130823,3810,3810,3841,3841,3841,3841,3841,31,31,2,7.68,322
,20130826,3841,3841,3844,3859,3844,3851,3857,10,16,134,516.96,312
,20130827,3851,3857,3830,3871,3829,3871,3839,14,-18,16,61.43,312
,20130828,3871,3839,3872,3872,3847,3847,3859,8,20,10,38.6,310
,20130829,3847,3859,3806,3806,3775,3798,3791,-61,-68,78,295.76,312
,20130830,3798,3791,3793,3799,3784,3786,3790,-5,-1,8,30.32,308
,20130902,3786,3790,3822,3831,3822,3831,3826,41,36,4,15.31,306
,20130903,3831,3826,3824,3824,3790,3790,3810,-36,-16,12,45.72,302
,20130904,3790,3810,3794,3794,3776,3776,3787,-34,-23,6,22.72,302
,20130905,3776,3787,,,,3774,3774,-13,-13,0,0,302
,20130906,3774,3774,3762,3762,3762,3762,3762,-12,-12,4,15.05,302
,20130909,3762,3762,3784,3794,3784,3794,3791,32,29,8,30.33,302
,20130910,3794,3791,3779,3779,3779,3779,3779,-12,-12,2,7.56,302
,20130911,3779,3779,3765,3768,3765,3768,3766,-11,-13,8,30.13,302
,20130912,3768,3766,3758,3759,3758,3759,3758,-7,-8,6,22.55,302
,20130913,3759,3758,3716,3716,3713,3713,3714,-45,-44,8,29.72,302
,20130916,3713,3714,3683,3683,3672,3675,3675,-39,-39,48,176.43,302
,20130917,3675,3675,,,,3680,3680,5,5,0,0,302
,20130918,3680,3680,3662,3662,3662,3662,3662,-18,-18,4,14.65,302
,20130923,3662,3662,3633,3689,3630,3687,3646,25,-16,2440,"8,896.46",828
,20130924,3687,3646,3683,3683,3683,3683,3683,37,37,2,7.37,826
,20130925,3683,3683,3666,3669,3666,3669,3668,-14,-15,8,29.35,824
,20130926,3669,3668,3655,3655,3651,3651,3653,-17,-15,46,168.08,778
,20130927,3651,3653,3626,3626,3611,3611,3614,-42,-39,56,202.42,752
,20130930,3611,3614,3622,3623,3611,3611,3616,-3,2,88,318.26,744
,20131008,3611,3616,3598,3598,3583,3590,3585,-26,-31,28,100.39,742
,20131009,3590,3585,3607,3632,3607,3632,3626,47,41,108,391.7,826
,20131010,3632,3626,3606,3617,3606,3617,3607,-9,-19,22,79.35,816
,20131011,3617,3607,3618,3627,3615,3619,3619,12,12,46,166.49,796
,20131014,3619,3619,3621,3621,3621,3621,3621,2,2,8,28.97,788
,20131015,3621,3621,3646,3646,3620,3620,3640,-1,19,100,364.03,724
,20131016,3620,3640,3610,3610,3600,3600,3607,-40,-33,14,50.5,718
,20131017,3600,3607,3589,3590,3580,3580,3581,-27,-26,56,200.59,710
,20131018,3580,3581,3583,3583,3579,3579,3581,-2,0,220,787.94,736
,20131021,3579,3581,3579,3584,3578,3578,3579,-3,-2,30,107.38,724
,20131022,3578,3579,3582,3583,3579,3579,3581,0,2,10,35.81,726
,20131023,3579,3581,3580,3586,3574,3574,3579,-7,-2,16,57.26,724
,20131024,3574,3579,3531,3570,3531,3554,3549,-25,-30,26,92.29,716
,20131025,3554,3549,3550,3550,3543,3543,3546,-6,-3,22,78.03,708
,20131028,3543,3546,3498,3521,3498,3521,3505,-25,-41,6,21.03,710
,20131029,3521,3505,3510,3513,3510,3513,3512,8,7,26,91.32,710
,20131030,3513,3512,3555,3555,3506,3522,3530,10,18,30,105.91,718
,20131031,3522,3530,3538,3549,3538,3540,3542,10,12,26,92.11,700
,20131101,3540,3542,3540,3573,3540,3563,3562,21,20,8,28.5,700
,20131104,3563,3562,3562,3576,3561,3565,3568,3,6,88,314.02,702
,20131105,3565,3568,3581,3649,3534,3569,3587,1,19,200,717.46,684
,20131106,3569,3587,3560,3560,3559,3559,3559,-28,-28,18,64.08,702
,20131107,3559,3559,3580,3580,3580,3580,3580,21,21,2,7.16,700
,20131108,3580,3580,3583,3583,3575,3575,3580,-5,0,14,50.12,686
,20131111,3575,3580,3563,3603,3563,3567,3570,-13,-10,24,85.69,666
,20131112,3567,3570,3546,3546,3546,3546,3546,-24,-24,4,14.18,666
,20131113,3546,3546,3548,3548,3548,3548,3548,2,2,2,7.1,668
,20131114,3548,3548,3529,3545,3526,3530,3538,-18,-10,16,56.62,674
,20131115,3530,3538,3535,3535,3524,3524,3533,-14,-5,12,42.4,674
,20131118,3524,3533,3500,3521,3500,3521,3514,-12,-19,16,56.23,684
,20131119,3521,3514,3500,3521,3500,3521,3514,7,0,38,133.55,674
,20131120,3521,3514,3524,3544,3524,3544,3532,30,18,20,70.66,664
,20131121,3544,3532,,,,3532,3532,0,0,0,0,664
,20131122,3532,3532,3518,3518,3518,3518,3518,-14,-14,10,35.18,666
,20131125,3518,3518,,,,3518,3518,0,0,0,0,666
,20131126,3518,3518,3543,3567,3543,3567,3549,49,31,8,28.39,664
,20131127,3567,3549,3555,3555,3555,3555,3555,6,6,2,7.11,662
,20131128,3555,3555,,,,3567,3567,12,12,0,0,662
,20131129,3567,3567,,,,3570,3570,3,3,0,0,662
,20131202,3570,3570,3576,3576,3576,3576,3576,6,6,2,7.15,660
,20131203,3576,3576,3594,3597,3591,3597,3593,21,17,22,79.05,654
,20131204,3597,3593,,,,3609,3609,16,16,0,0,654
,20131205,3609,3609,3607,3607,3473,3571,3550,-38,-59,116,411.8,692
,20131206,3571,3550,3569,3569,3561,3561,3565,11,15,14,49.92,690
,20131209,3561,3565,3561,3590,3561,3590,3585,25,20,44,157.77,674
,20131210,3590,3585,,,,3585,3585,0,0,0,0,674
,20131211,3585,3585,,,,3585,3585,0,0,0,0,674
,20131212,3585,3585,3594,3594,3594,3594,3594,9,9,2,7.19,674
,20131213,3594,3594,3575,3575,3547,3547,3565,-47,-29,6,21.39,672
,20131216,3547,3565,3547,3547,3547,3547,3547,-18,-18,2,7.09,672
,20131217,3547,3547,,,,3541,3541,-6,-6,0,0,672
,20131218,3541,3541,3527,3533,3527,3533,3531,-8,-10,8,28.25,668
,20131219,3533,3531,3531,3531,3531,3531,3531,0,0,40,141.24,628
,20131220,3531,3531,3514,3514,3514,3514,3514,-17,-17,4,14.06,624
,20131223,3514,3514,3530,3530,3530,3530,3530,16,16,2,7.06,624
,20131224,3530,3530,3486,3498,3486,3496,3493,-34,-37,14,48.91,618
,20131225,3496,3493,3477,3477,3477,3477,3477,-16,-16,64,222.53,622
,20131226,3477,3477,,,,3477,3477,0,0,0,0,622
,20131227,3477,3477,3515,3515,3470,3493,3494,16,17,10,34.94,622
,20131230,3493,3494,3481,3481,3481,3481,3481,-13,-13,2,6.96,622
,20131231,3481,3481,3460,3460,3442,3442,3450,-39,-31,16,55.21,630
rb1404,20130416,3810,3810,3665,3829,3665,3829,3742,19,-68,64,239.52,24
,20130417,3829,3742,3830,3830,3695,3810,3780,68,38,72,272.2,32
,20130418,3810,3780,3760,3780,3754,3780,3766,0,-14,10,37.67,38
,20130419,3780,3766,3780,3823,3768,3792,3792,26,26,22,83.44,46
,20130422,3792,3792,3796,3805,3725,3786,3777,-6,-15,20,75.55,46
,20130423,3786,3777,3745,3772,3671,3695,3704,-82,-73,90,333.39,102
,20130424,3695,3704,3720,3749,3682,3749,3709,45,5,36,133.53,110
,20130425,3749,3709,3748,3760,3733,3757,3749,48,40,18,67.49,116
,20130426,3757,3749,3780,3780,3736,3757,3756,8,7,14,52.6,116
,20130502,3757,3756,3675,3686,3675,3686,3681,-70,-75,8,29.45,116
,20130503,3686,3681,3700,3746,3700,3725,3722,44,41,18,67.01,120
,20130506,3725,3722,3754,3772,3754,3765,3760,43,38,20,75.21,130
,20130507,3765,3760,3789,3805,3768,3776,3791,16,31,322,"1,220.74",274
,20130508,3776,3791,3792,3799,3770,3777,3782,-14,-9,144,544.64,210
,20130509,3777,3782,3788,3788,3742,3755,3760,-27,-22,30,112.82,206
,20130510,3755,3760,3744,3755,3738,3755,3745,-5,-15,10,37.45,206
,20130513,3755,3745,3770,3800,3770,3789,3788,44,43,30,113.64,218
,20130514,3789,3788,3768,3768,3745,3761,3756,-27,-32,32,120.19,230
,20130515,3761,3756,3743,3744,3702,3702,3722,-54,-34,46,171.24,228
,20130516,3702,3722,3690,3719,3668,3719,3692,-3,-30,26,96.01,232
,20130517,3719,3692,3685,3741,3668,3729,3699,37,7,58,214.6,232
,20130520,3729,3699,3752,3799,3730,3749,3757,50,58,46,172.85,248
,20130521,3749,3757,3723,3723,3705,3723,3717,-34,-40,12,44.61,246
,20130522,3723,3717,3712,3723,3705,3710,3712,-7,-5,20,74.26,242
,20130523,3710,3712,3679,3680,3639,3673,3664,-39,-48,224,820.74,262
,20130524,3673,3664,3665,3683,3665,3683,3672,19,8,6,22.04,260
,20130527,3683,3672,3645,3658,3623,3623,3640,-49,-32,16,58.25,260
,20130528,3623,3640,3616,3629,3610,3626,3622,-14,-18,16,57.96,262
,20130529,3626,3622,3645,3652,3570,3570,3617,-52,-5,106,383.46,220
,20130530,3570,3617,3573,3587,3570,3579,3580,-38,-37,46,164.72,234
,20130531,3579,3580,3614,3614,3555,3564,3567,-16,-13,12,42.81,228
,20130603,3564,3567,3607,3609,3585,3604,3596,37,29,24,86.31,226
,20130604,3604,3596,3613,3630,3606,3626,3619,30,23,40,144.78,216
,20130605,3626,3619,3647,3650,3624,3645,3638,26,19,24,87.32,220
,20130606,3645,3638,3625,3625,3582,3582,3603,-56,-35,26,93.7,218
,20130607,3582,3603,3583,3583,3560,3560,3566,-43,-37,98,349.48,226
,20130613,3560,3566,3586,3586,3568,3568,3572,2,6,34,121.46,206
,20130614,3568,3572,3571,3578,3534,3573,3558,1,-14,22,78.29,198
,20130617,3573,3558,3612,3685,3402,3643,3584,85,26,742,"2,659.50",252
,20130618,3643,3584,3651,3656,3638,3648,3648,64,64,34,124.03,254
,20130619,3648,3648,3645,3666,3645,3650,3654,2,6,12,43.85,250
,20130620,3650,3654,3658,3658,3622,3636,3631,-18,-23,30,108.94,244
,20130621,3636,3631,3593,3681,3591,3680,3632,49,1,44,159.81,250
,20130624,3680,3632,3640,3651,3611,3616,3621,-16,-11,56,202.81,242
,20130625,3616,3621,3584,3600,3577,3598,3593,-23,-28,16,57.49,238
,20130626,3598,3593,3566,3566,3535,3552,3552,-41,-41,24,85.25,230
,20130627,3552,3552,3610,3610,3588,3598,3599,46,47,18,64.8,226
,20130628,3598,3599,3628,3628,3593,3599,3601,0,2,16,57.62,226
,20130701,3599,3601,3609,3609,3609,3609,3609,8,8,2,7.22,226
,20130702,3609,3609,3630,3635,3630,3635,3634,26,25,14,50.88,232
,20130703,3635,3634,3678,3681,3673,3681,3676,47,42,22,80.89,234
,20130704,3681,3676,3674,3703,3663,3679,3682,3,6,20,73.66,236
,20130705,3679,3682,3679,3686,3679,3682,3683,0,1,8,29.47,238
,20130708,3682,3683,3644,3667,3641,3654,3654,-29,-29,54,197.32,232
,20130709,3654,3654,3674,3684,3650,3656,3664,2,10,22,80.63,234
,20130710,3656,3664,3698,3698,3682,3682,3692,18,28,6,22.16,236
,20130711,3682,3692,3705,3711,3705,3711,3705,19,13,18,66.7,232
,20130712,3711,3705,3729,3729,3700,3708,3714,3,9,26,96.57,244
,20130715,3708,3714,3695,3730,3695,3702,3712,-12,-2,20,74.26,232
,20130716,3702,3712,3710,3719,3709,3714,3713,2,1,26,96.55,220
,20130717,3714,3713,3714,3728,3714,3725,3721,12,8,22,81.88,216
,20130718,3725,3721,3719,3719,3716,3716,3717,-5,-4,10,37.18,214
,20130719,3716,3717,,,,3730,3730,13,13,0,0,214
,20130722,3730,3730,3748,3748,3715,3715,3723,-15,-7,18,67.03,212
,20130723,3715,3723,3733,3737,3726,3727,3729,4,6,66,246.14,216
,20130724,3727,3729,3729,3756,3724,3734,3737,5,8,92,343.83,214
,20130725,3734,3737,3702,3738,3702,3738,3731,1,-6,26,97.01,208
,20130726,3738,3731,3707,3713,3674,3705,3704,-26,-27,46,170.4,208
,20130729,3705,3704,3684,3684,3684,3684,3684,-20,-20,6,22.1,214
,20130730,3684,3684,3678,3685,3608,3681,3658,-3,-26,68,248.77,222
,20130731,3681,3658,3689,3698,3673,3684,3686,26,28,44,162.23,220
,20130801,3684,3686,3700,3703,3687,3690,3698,4,12,20,73.97,220
,20130802,3690,3698,3707,3721,3705,3721,3712,23,14,14,51.98,216
,20130805,3721,3712,3726,3727,3726,3727,3726,15,14,10,37.26,224
,20130806,3727,3726,3716,3725,3716,3725,3722,-1,-4,10,37.23,218
,20130807,3725,3722,,,,3728,3728,6,6,0,0,218
,20130808,3728,3728,,,,3762,3762,34,34,0,0,218
,20130809,3762,3762,3756,3772,3751,3751,3761,-11,-1,16,60.19,218
,20130812,3751,3761,3834,3834,3796,3831,3817,70,56,12,45.81,216
,20130813,3831,3817,3838,3874,3838,3858,3857,41,40,40,154.31,232
,20130814,3858,3857,3864,3864,3837,3861,3855,4,-2,28,107.94,218
,20130815,3861,3855,3847,3858,3847,3850,3849,-5,-6,12,46.2,218
,20130816,3850,3849,3828,3841,3828,3838,3837,-11,-12,10,38.37,218
,20130819,3838,3837,3856,3866,3849,3853,3858,16,21,234,903,222
,20130820,3853,3858,3850,3852,3849,3849,3851,-9,-7,26,100.14,242
,20130821,3849,3851,3854,3854,3842,3842,3849,-9,-2,18,69.29,242
,20130822,3842,3849,3840,3840,3824,3829,3832,-20,-17,30,114.97,242
,20130823,3829,3832,3850,3866,3844,3851,3855,19,23,14,53.97,236
,20130826,3851,3855,,,,3855,3855,0,0,0,0,236
,20130827,3855,3855,3818,3865,3818,3865,3840,10,-15,10,38.41,240
,20130828,3865,3840,3868,3868,3818,3818,3861,-22,21,110,424.78,262
,20130829,3818,3861,3832,3832,3797,3805,3808,-56,-53,20,76.17,258
,20130830,3805,3808,3806,3806,3779,3805,3802,-3,-6,18,68.44,268
,20130902,3805,3802,3835,3847,3831,3847,3837,45,35,6,23.03,268
,20130903,3847,3837,3843,3843,3820,3821,3826,-16,-11,16,61.22,270
,20130904,3821,3826,3826,3826,3808,3808,3819,-18,-7,12,45.83,270
,20130905,3808,3819,3805,3805,3805,3805,3805,-14,-14,2,7.61,270
,20130906,3805,3805,3803,3803,3784,3784,3793,-21,-12,4,15.17,270
,20130909,3784,3793,3803,3819,3803,3819,3815,26,22,8,30.52,268
,20130910,3819,3815,3801,3801,3793,3793,3797,-22,-18,10,37.98,266
,20130911,3793,3797,3799,3799,3794,3798,3797,1,0,6,22.78,266
,20130912,3798,3797,3788,3788,3782,3782,3785,-15,-12,4,15.14,262
,20130913,3782,3785,3742,3742,3714,3729,3727,-56,-58,12,44.73,258
,20130916,3729,3727,3729,3729,3697,3697,3705,-30,-22,12,44.47,264
,20130917,3697,3705,3693,3709,3693,3709,3707,4,2,108,400.42,262
,20130918,3709,3707,3691,3710,3687,3710,3696,3,-11,70,258.75,262
,20130923,3710,3696,3716,3730,3695,3729,3708,33,12,84,311.47,238
,20130924,3729,3708,3715,3724,3699,3700,3711,-8,3,134,497.4,220
,20130925,3700,3711,3692,3696,3689,3696,3692,-15,-19,16,59.08,210
,20130926,3696,3692,3695,3695,3682,3684,3687,-8,-5,20,73.74,202
,20130927,3684,3687,3680,3680,3656,3656,3664,-31,-23,40,146.59,188
,20130930,3656,3664,3667,3675,3666,3675,3668,11,4,12,44.02,188
,20131008,3675,3668,3637,3771,3566,3654,3659,-14,-9,142,519.69,222
,20131009,3654,3659,3655,3675,3655,3663,3659,4,0,70,256.16,192
,20131010,3663,3659,3600,3650,3600,3650,3630,-9,-29,6,21.78,192
,20131011,3650,3630,,,,3630,3630,0,0,0,0,192
,20131014,3630,3630,3686,3686,3657,3668,3670,38,40,24,88.09,192
,20131015,3668,3670,3701,3701,3667,3667,3676,-3,6,10,36.77,194
,20131016,3667,3676,3650,3652,3647,3647,3650,-29,-26,10,36.51,190
,20131017,3647,3650,3651,3651,3648,3649,3649,-1,-1,12,43.79,188
,20131018,3649,3649,3619,3622,3619,3622,3620,-27,-29,4,14.48,184
,20131021,3622,3620,3622,3622,3608,3608,3615,-12,-5,8,28.92,184
,20131022,3608,3615,3630,3630,3623,3623,3625,8,10,54,195.75,228
,20131023,3623,3625,3642,3642,3603,3609,3612,-16,-13,14,50.57,240
,20131024,3609,3612,3580,3581,3580,3581,3580,-31,-32,4,14.32,240
,20131025,3581,3580,3576,3577,3576,3577,3576,-3,-4,10,35.76,244
,20131028,3577,3576,3553,3553,3553,3553,3553,-23,-23,4,14.21,244
,20131029,3553,3553,3560,3569,3560,3569,3562,16,9,8,28.5,248
,20131030,3569,3562,3581,3588,3570,3588,3579,26,17,10,35.8,248
,20131031,3588,3579,3599,3599,3599,3599,3599,20,20,2,7.2,250
,20131101,3599,3599,3622,3627,3598,3627,3614,28,15,242,874.67,254
,20131104,3627,3614,3624,3625,3613,3613,3623,-1,9,34,123.21,254
,20131105,3613,3623,3620,3624,3597,3613,3616,-10,-7,34,122.96,252
,20131106,3613,3616,3620,3620,3587,3587,3600,-29,-16,22,79.21,252
,20131107,3587,3600,3620,3647,3619,3639,3629,39,29,70,254.08,266
,20131108,3639,3629,3644,3644,3614,3635,3626,6,-3,16,58.02,262
,20131111,3635,3626,3608,3633,3580,3626,3607,0,-19,14,50.5,262
,20131112,3626,3607,3597,3639,3597,3622,3625,15,18,94,340.77,256
,20131113,3622,3625,3596,3629,3596,3607,3610,-18,-15,6,21.66,254
,20131114,3607,3610,3608,3625,3567,3595,3589,-15,-21,92,330.21,246
,20131115,3595,3589,3572,3593,3562,3562,3576,-27,-13,20,71.54,244
,20131118,3562,3576,3550,3579,3550,3570,3569,-6,-7,8,28.56,248
,20131119,3570,3569,3536,3587,3536,3578,3564,9,-5,32,114.07,230
,20131120,3578,3564,3613,3613,3573,3597,3596,33,32,42,151.06,222
,20131121,3597,3596,3594,3594,3586,3586,3590,-10,-6,4,14.36,222
,20131122,3586,3590,3579,3579,3579,3579,3579,-11,-11,2,7.16,220
,20131125,3579,3579,,,,3580,3580,1,1,0,0,220
,20131126,3580,3580,3611,3631,3611,3628,3623,48,43,16,57.97,220
,20131127,3628,3623,3613,3614,3606,3606,3612,-17,-11,16,57.8,218
,20131128,3606,3612,3576,3626,3576,3626,3614,14,2,14,50.6,216
,20131129,3626,3614,3641,3641,3624,3624,3632,10,18,4,14.53,218
,20131202,3624,3632,3616,3659,3616,3646,3653,14,21,52,189.99,254
,20131203,3646,3653,3649,3655,3647,3655,3654,2,1,54,197.32,218
,20131204,3655,3654,3664,3664,3664,3664,3664,10,10,2,7.33,220
,20131205,3664,3664,3666,3679,3650,3650,3661,-14,-3,8,29.29,220
,20131206,3650,3661,3683,3690,3633,3641,3661,-20,0,328,"1,200.82",228
,20131209,3641,3661,3662,3662,3657,3660,3659,-1,-2,42,153.71,224
,20131210,3660,3659,,,,3659,3659,0,0,0,0,224
,20131211,3659,3659,3641,3665,3641,3665,3663,6,4,28,102.57,222
,20131212,3665,3663,3660,3677,3654,3666,3661,3,-2,22,80.55,216
,20131213,3666,3661,3666,3666,3615,3615,3630,-46,-31,12,43.56,210
,20131216,3615,3630,3608,3629,3608,3629,3617,-1,-13,260,940.59,222
,20131217,3629,3617,,,,3605,3605,-12,-12,0,0,222
,20131218,3605,3605,,,,3595,3595,-10,-10,0,0,222
,20131219,3595,3595,3595,3640,3587,3595,3603,0,8,200,720.75,264
,20131220,3595,3603,3606,3610,3589,3589,3598,-14,-5,24,86.37,248
,20131223,3589,3598,3565,3566,3563,3565,3564,-33,-34,48,171.12,282
,20131224,3565,3564,3566,3566,3566,3566,3566,2,2,4,14.26,284
,20131225,3566,3566,3566,3566,3542,3545,3551,-21,-15,40,142.05,302
,20131226,3545,3551,3548,3548,3539,3539,3542,-12,-9,8,28.34,300
,20131227,3539,3542,3544,3560,3544,3548,3551,6,9,32,113.64,290
,20131230,3548,3551,3553,3555,3526,3526,3541,-25,-10,70,247.93,320
,20131231,3526,3541,3534,3536,3510,3535,3524,-6,-17,126,444.1,384
rb1405,20130516,3722,3722,3700,3793,3680,3695,3707,-27,-15,42,155.7,24
,20130517,3695,3707,3705,3737,3658,3737,3692,30,-15,470,"1,735.36",194
,20130520,3737,3692,3724,3750,3719,3738,3733,46,41,122,455.53,242
,20130521,3738,3733,3738,3738,3701,3723,3720,-10,-13,112,416.7,228
,20130522,3723,3720,3703,3729,3680,3712,3705,-8,-15,626,"2,319.85",622
,20130523,3712,3705,3687,3694,3660,3669,3672,-36,-33,760,"2,791.33",702
,20130524,3669,3672,3675,3688,3661,3685,3677,13,5,336,"1,235.61",770
,20130527,3685,3677,3670,3679,3631,3645,3654,-32,-23,890,"3,252.16",794
,20130528,3645,3654,3645,3649,3624,3638,3635,-16,-19,616,"2,239.77",800
,20130529,3638,3635,3626,3648,3586,3586,3611,-49,-24,1392,"5,027.25",872
,20130530,3586,3611,3573,3596,3562,3580,3577,-31,-34,1318,"4,714.89",1212
,20130531,3580,3577,3580,3593,3547,3557,3565,-20,-12,1338,"4,770.06",1346
,20130603,3557,3565,3568,3628,3568,3628,3600,63,35,1316,"4,738.14",1288
,20130604,3628,3600,3626,3643,3613,3641,3629,41,29,1182,"4,289.58",1292
,20130605,3641,3629,3671,3671,3640,3655,3651,26,22,990,"3,615.07",1634
,20130606,3655,3651,3641,3641,3580,3583,3602,-68,-49,2044,"7,363.66",2232
,20130607,3583,3602,3582,3589,3564,3588,3578,-14,-24,1000,"3,578.19",2460
,20130613,3588,3578,3557,3596,3557,3570,3577,-8,-1,666,"2,382.82",2620
,20130614,3570,3577,3583,3595,3550,3587,3581,10,4,1026,"3,674.55",2952
,20130617,3587,3581,3596,3678,3596,3643,3646,62,65,1644,"5,995.02",3016
,20130618,3643,3646,3654,3662,3641,3659,3653,13,7,472,"1,724.51",3028
,20130619,3659,3653,3660,3687,3640,3687,3670,34,17,624,"2,290.52",3028
,20130620,3687,3670,3673,3678,3626,3647,3653,-23,-17,1518,"5,546.70",3166
,20130621,3647,3653,3636,3696,3590,3696,3653,43,0,3172,"11,587.80",3166
,20130624,3696,3653,3687,3687,3627,3627,3656,-26,3,1290,"4,716.31",3176
,20130625,3627,3656,3631,3645,3580,3616,3603,-40,-53,1800,"6,485.62",3510
,20130626,3616,3603,3624,3624,3546,3561,3570,-42,-33,2252,"8,040.40",4098
,20130627,3561,3570,3563,3621,3538,3609,3587,39,17,2810,"10,079.94",3928
,20130628,3609,3587,3606,3635,3595,3616,3613,29,26,1368,"4,943.59",4092
,20130701,3616,3613,3611,3624,3587,3619,3604,6,-9,1228,"4,426.72",4186
,20130702,3619,3604,3625,3646,3619,3644,3634,40,30,1242,"4,514.67",4292
,20130703,3644,3634,3649,3698,3643,3687,3674,53,40,2548,"9,363.12",4530
,20130704,3687,3674,3681,3701,3680,3690,3691,16,17,1716,"6,335.34",4596
,20130705,3690,3691,3691,3705,3690,3693,3695,2,4,1376,"5,085.48",4548
,20130708,3693,3695,3691,3696,3657,3681,3674,-14,-21,2658,"9,766.77",4558
,20130709,3681,3674,3663,3695,3663,3672,3681,-2,7,1336,"4,918.07",4552
,20130710,3672,3681,3674,3712,3659,3706,3687,25,6,2848,"10,502.12",5220
,20130711,3706,3687,3724,3762,3702,3716,3725,29,38,3382,"12,600.59",5146
,20130712,3716,3725,3703,3731,3699,3705,3713,-20,-12,6016,"22,343.03",7980
,20130715,3705,3713,3712,3740,3708,3709,3724,-4,11,2762,"10,287.47",8368
,20130716,3709,3724,3715,3730,3701,3724,3714,0,-10,2222,"8,254.02",8924
,20130717,3724,3714,3719,3749,3719,3737,3735,23,21,3376,"12,611.54",9716
,20130718,3737,3735,3727,3735,3717,3733,3726,-2,-9,1868,"6,960.29",9590
,20130719,3733,3726,3732,3758,3732,3746,3747,20,21,1992,"7,464.20",9854
,20130722,3746,3747,3747,3749,3717,3723,3725,-24,-22,5202,"19,378.83",12032
,20130723,3723,3725,3727,3740,3725,3734,3735,9,10,1922,"7,178.68",12324
,20130724,3734,3735,3738,3755,3724,3748,3742,13,7,3152,"11,797.81",12284
,20130725,3748,3742,3740,3751,3734,3736,3742,-6,0,1286,"4,812.54",12382
,20130726,3736,3742,3739,3742,3712,3721,3724,-21,-18,2106,"7,843.06",12272
,20130729,3721,3724,3700,3709,3680,3683,3691,-41,-33,3988,"14,722.40",12912
,20130730,3683,3691,3682,3695,3678,3680,3689,-11,-2,3312,"12,218.05",14618
,20130731,3680,3689,3662,3709,3662,3689,3691,0,2,7772,"28,688.31",15188
,20130801,3689,3691,3700,3710,3687,3699,3700,8,9,4012,"14,846.18",14690
,20130802,3699,3700,3710,3724,3703,3721,3714,21,14,7806,"28,998.80",17296
,20130805,3721,3714,3717,3734,3717,3729,3728,15,14,2652,"9,888.09",17718
,20130806,3729,3728,3728,3738,3718,3733,3729,5,1,3020,"11,262.68",17748
,20130807,3733,3729,3727,3764,3727,3759,3746,30,17,6882,"25,785.39",20770
,20130808,3759,3746,3762,3795,3762,3793,3783,47,37,7240,"27,392.11",19558
,20130809,3793,3783,3799,3802,3765,3802,3787,19,4,10762,"40,762.81",22092
,20130812,3802,3787,3838,3858,3806,3858,3826,71,39,5670,"21,694.15",22950
,20130813,3858,3826,3859,3885,3850,3883,3869,57,43,25946,"100,407.51",30052
,20130814,3883,3869,3883,3895,3854,3864,3876,-5,7,8994,"34,864.42",31836
,20130815,3864,3876,3869,3877,3860,3865,3869,-11,-7,6460,"24,995.36",33582
,20130816,3865,3869,3861,3882,3850,3861,3860,-8,-9,9910,"38,257.09",35090
,20130819,3861,3860,3856,3890,3837,3861,3864,1,4,18984,"73,356.62",42710
,20130820,3861,3864,3864,3880,3854,3858,3869,-6,5,20658,"79,931.14",52694
,20130821,3858,3869,3860,3872,3853,3854,3864,-15,-5,8334,"32,208.79",53856
,20130822,3854,3864,3850,3868,3835,3840,3848,-24,-16,13162,"50,658.15",52448
,20130823,3840,3848,3836,3893,3836,3887,3877,39,29,20364,"78,954.54",54606
,20130826,3887,3877,3896,3923,3876,3882,3896,5,19,23370,"91,063.79",55756
,20130827,3882,3896,3882,3898,3849,3889,3873,-7,-23,19328,"74,874.72",55818
,20130828,3889,3873,3894,3904,3836,3837,3875,-36,2,24966,"96,755.20",56790
,20130829,3837,3875,3836,3860,3803,3819,3831,-56,-44,29316,"112,336.09",60200
,20130830,3819,3831,3818,3843,3808,3824,3825,-7,-6,15450,"59,111.48",61332
,20130902,3824,3825,3846,3880,3840,3880,3863,55,38,23922,"92,423.76",64604
,20130903,3880,3863,3890,3890,3841,3844,3855,-19,-8,22866,"88,159.94",65656
,20130904,3844,3855,3845,3857,3834,3840,3844,-15,-11,17600,"67,664.81",69274
,20130905,3840,3844,3824,3850,3824,3826,3835,-18,-9,22382,"85,855.03",69710
,20130906,3826,3835,3818,3829,3797,3805,3811,-30,-24,31702,"120,833.95",77344
,20130909,3805,3811,3813,3843,3813,3832,3832,21,21,28000,"107,321.78",83654
,20130910,3832,3832,3830,3838,3805,3818,3817,-14,-15,19472,"74,334.92",84650
,20130911,3818,3817,3819,3837,3810,3821,3821,4,4,25304,"96,687.37",84540
,20130912,3821,3821,3815,3825,3800,3801,3808,-20,-13,18540,"70,610.74",88672
,20130913,3801,3808,3795,3798,3738,3739,3762,-69,-46,78138,"293,956.42",102364
,20130916,3739,3762,3741,3752,3707,3721,3729,-41,-33,36336,"135,517.15",104210
,20130917,3721,3729,3733,3739,3711,3724,3722,-5,-7,30474,"113,445.45",104742
,20130918,3724,3722,3719,3735,3703,3721,3718,-1,-4,43572,"162,022.19",99484
,20130923,3721,3718,3710,3752,3704,3750,3735,32,17,54418,"203,295.11",106778
,20130924,3750,3735,3745,3757,3712,3712,3733,-23,-2,52490,"195,979.50",107862
,20130925,3712,3733,3712,3725,3705,3714,3712,-19,-21,29932,"111,122.33",106308
,20130926,3714,3712,3705,3716,3690,3699,3703,-13,-9,34312,"127,073.89",105670
,20130927,3699,3703,3695,3698,3669,3672,3680,-31,-23,39496,"145,374.56",105012
,20130930,3672,3680,3676,3697,3676,3691,3689,11,9,29140,"107,512.18",100726
,20131008,3691,3689,3685,3694,3637,3694,3656,5,-33,71806,"262,588.48",123704
,20131009,3694,3656,3694,3718,3669,3670,3693,14,37,205618,"759,491.02",232574
,20131010,3670,3693,3666,3695,3664,3686,3683,-7,-10,97930,"360,770.00",247660
,20131011,3686,3683,3693,3709,3660,3681,3686,-2,3,160100,"590,159.73",305650
,20131014,3681,3686,3685,3725,3677,3723,3704,37,18,228990,"848,233.89",360554
,20131015,3723,3704,3718,3744,3695,3711,3722,7,18,403052,"1,500,325.16",423612
,20131016,3711,3722,3714,3719,3680,3690,3700,-32,-22,372164,"1,377,086.98",501174
,20131017,3690,3700,3700,3708,3668,3669,3690,-31,-10,460630,"1,700,026.43",588084
,20131018,3669,3690,3671,3675,3639,3643,3652,-47,-38,879848,"3,214,015.39",755226
,20131021,3643,3652,3628,3656,3623,3644,3640,-8,-12,819270,"2,982,278.69",802692
,20131022,3644,3640,3638,3659,3635,3642,3646,2,6,617844,"2,253,012.17",859838
,20131023,3642,3646,3645,3661,3624,3634,3643,-12,-3,911702,"3,321,642.42",864280
,20131024,3634,3643,3619,3628,3601,3617,3614,-26,-29,954872,"3,451,052.55",891736
,20131025,3617,3614,3615,3624,3582,3585,3604,-29,-10,796812,"2,871,998.64",926726
,20131028,3585,3604,3587,3595,3575,3586,3585,-18,-19,589820,"2,115,019.25",949062
,20131029,3586,3585,3588,3608,3576,3608,3593,23,8,1083038,"3,891,784.16",1017406
,20131030,3608,3593,3610,3645,3607,3645,3623,52,30,1190512,"4,314,328.18",1151774
,20131031,3645,3623,3640,3651,3623,3636,3637,13,14,1152622,"4,192,123.73",1199354
,20131101,3636,3637,3638,3681,3632,3671,3665,34,28,1771784,"6,494,031.21",1326042
,20131104,3671,3665,3675,3685,3661,3677,3673,12,8,1256126,"4,613,930.93",1439576
,20131105,3677,3673,3682,3692,3654,3669,3670,-4,-3,1371586,"5,034,497.00",1517904
,20131106,3669,3670,3670,3677,3636,3642,3655,-28,-15,1492144,"5,453,941.98",1526576
,20131107,3642,3655,3643,3688,3643,3679,3668,24,13,1910172,"7,008,040.93",1501678
,20131108,3679,3668,3680,3686,3658,3661,3671,-7,3,1341632,"4,926,358.27",1513220
,20131111,3661,3671,3650,3677,3633,3668,3656,-3,-15,1523286,"5,569,203.10",1466372
,20131112,3668,3656,3668,3681,3657,3670,3669,14,13,1267998,"4,652,645.06",1483652
,20131113,3670,3669,3660,3678,3647,3647,3663,-22,-6,1582304,"5,797,300.19",1519674
,20131114,3647,3663,3641,3650,3614,3620,3629,-43,-34,1902964,"6,907,489.35",1519356
,20131115,3620,3629,3624,3636,3590,3591,3614,-38,-15,1936398,"6,998,989.70",1601814
,20131118,3591,3614,3596,3608,3583,3592,3595,-22,-19,1339696,"4,816,766.39",1572632
,20131119,3592,3595,3585,3625,3585,3624,3604,29,9,1689192,"6,089,011.82",1538180
,20131120,3624,3604,3630,3651,3623,3646,3637,42,33,1905328,"6,931,280.40",1632208
,20131121,3646,3637,3644,3646,3607,3612,3623,-25,-14,1674888,"6,069,234.39",1624172
,20131122,3612,3623,3616,3635,3610,3614,3621,-9,-2,1222570,"4,427,422.26",1571758
,20131125,3614,3621,3624,3642,3614,3636,3628,15,7,1475922,"5,356,119.81",1571414
,20131126,3636,3628,3640,3677,3636,3660,3657,32,29,2424668,"8,868,306.67",1609358
,20131127,3660,3657,3658,3664,3645,3650,3654,-7,-3,1382060,"5,050,468.57",1632286
,20131128,3650,3654,3648,3682,3646,3670,3667,16,13,1725370,"6,328,046.14",1544494
,20131129,3670,3667,3674,3680,3662,3670,3670,3,3,935964,"3,435,375.26",1523448
,20131202,3670,3670,3671,3698,3670,3695,3686,25,16,1520018,"5,603,406.49",1543206
,20131203,3695,3686,3690,3709,3687,3709,3697,23,11,1341546,"4,960,987.96",1557234
,20131204,3709,3697,3710,3727,3708,3713,3718,16,21,1475374,"5,486,004.22",1591704
,20131205,3713,3718,3716,3718,3692,3693,3704,-25,-14,1243242,"4,605,227.03",1591636
,20131206,3693,3704,3692,3704,3683,3702,3690,-2,-14,1151966,"4,251,900.30",1592986
,20131209,3702,3690,3703,3726,3703,3722,3717,32,27,1356200,"5,041,214.78",1663624
,20131210,3722,3717,3726,3737,3708,3716,3719,-1,2,1122538,"4,175,802.21",1661188
,20131211,3716,3719,3718,3738,3691,3735,3716,16,-3,1933408,"7,184,653.47",1672764
,20131212,3735,3716,3741,3745,3725,3729,3734,13,18,1238166,"4,623,324.89",1724520
,20131213,3729,3734,3728,3729,3661,3676,3689,-58,-45,2446196,"9,024,630.94",1528546
,20131216,3676,3689,3680,3694,3668,3671,3679,-18,-10,1300370,"4,785,258.50",1482104
,20131217,3671,3679,3675,3689,3662,3663,3676,-16,-3,1377856,"5,066,364.64",1527492
,20131218,3663,3676,3663,3663,3644,3656,3653,-20,-23,1292080,"4,720,571.22",1450908
,20131219,3656,3653,3661,3672,3642,3652,3657,-1,4,1024508,"3,746,959.81",1461744
,20131220,3652,3657,3651,3665,3626,3627,3650,-30,-7,1285518,"4,693,211.19",1402016
,20131223,3627,3650,3616,3624,3603,3612,3615,-38,-35,1107832,"4,005,083.68",1408834
,20131224,3612,3615,3609,3632,3608,3628,3623,13,8,984078,"3,565,474.13",1425882
,20131225,3628,3623,3632,3640,3592,3603,3611,-20,-12,1342694,"4,849,765.23",1464490
,20131226,3603,3611,3601,3610,3583,3604,3598,-7,-13,1270188,"4,571,163.81",1456790
,20131227,3604,3598,3603,3621,3596,3612,3609,14,11,1316292,"4,751,497.65",1458702
,20131230,3612,3609,3612,3628,3567,3573,3602,-36,-7,1487060,"5,357,100.70",1535764
,20131231,3573,3602,3574,3592,3562,3570,3575,-32,-27,1260888,"4,507,687.54",1419640
rb1406,20130618,3646,3646,,,,3646,3646,0,0,0,0,0
,20130619,3646,3646,,,,3646,3646,0,0,0,0,0
,20130620,3646,3646,,,,3630,3630,-16,-16,0,0,0
,20130621,3630,3630,,,,3655,3655,25,25,0,0,0
,20130624,3655,3655,3650,3650,3650,3650,3650,-5,-5,2,7.3,2
,20130625,3650,3650,,,,3650,3650,0,0,0,0,2
,20130626,3650,3650,,,,3616,3616,-34,-34,0,0,2
,20130627,3616,3616,3599,3599,3599,3599,3599,-17,-17,2,7.2,4
,20130628,3599,3599,,,,3604,3604,5,5,0,0,4
,20130701,3604,3604,3653,3653,3606,3624,3629,20,25,712,"2,584.05",4
,20130702,3624,3629,3637,3658,3637,3644,3648,15,19,10,36.48,10
,20130703,3644,3648,3650,3694,3650,3694,3668,46,20,16,58.69,8
,20130704,3694,3668,3698,3698,3698,3698,3698,30,30,2,7.4,10
,20130705,3698,3698,,,,3698,3698,0,0,0,0,10
,20130708,3698,3698,3685,3691,3685,3691,3688,-7,-10,4,14.75,8
,20130709,3691,3688,3668,3668,3668,3668,3668,-20,-20,2,7.34,10
,20130710,3668,3668,3691,3691,3691,3691,3691,23,23,2,7.38,8
,20130711,3691,3691,3691,3747,3691,3734,3727,43,36,16,59.64,14
,20130712,3734,3727,3723,3723,3723,3723,3723,-4,-4,2,7.45,14
,20130715,3723,3723,,,,3723,3723,0,0,0,0,14
,20130716,3723,3723,3734,3736,3734,3736,3735,13,12,4,14.94,16
,20130717,3736,3735,,,,3735,3735,0,0,0,0,16
,20130718,3735,3735,,,,3735,3735,0,0,0,0,16
,20130719,3735,3735,3760,3760,3760,3760,3760,25,25,2,7.52,16
,20130722,3760,3760,3748,3748,3748,3748,3748,-12,-12,2,7.5,16
,20130723,3748,3748,3762,3762,3744,3744,3755,-4,7,26,97.65,18
,20130724,3744,3755,3750,3750,3750,3750,3750,-5,-5,2,7.5,18
,20130725,3750,3750,,,,3750,3750,0,0,0,0,18
,20130726,3750,3750,,,,3750,3750,0,0,0,0,18
,20130729,3750,3750,,,,3733,3733,-17,-17,0,0,18
,20130730,3733,3733,,,,3731,3731,-2,-2,0,0,18
,20130731,3731,3731,3712,3712,3712,3712,3712,-19,-19,2,7.42,16
,20130801,3712,3712,,,,3712,3712,0,0,0,0,16
,20130802,3712,3712,3727,3727,3727,3727,3727,15,15,2,7.45,18
,20130805,3727,3727,3749,3749,3743,3743,3745,16,18,6,22.47,22
,20130806,3743,3745,3739,3739,3738,3738,3738,-7,-7,4,14.95,26
,20130807,3738,3738,,,,3745,3745,7,7,0,0,26
,20130808,3745,3745,3792,3797,3792,3793,3794,48,49,6,22.76,30
,20130809,3793,3794,,,,3798,3798,4,4,0,0,30
,20130812,3798,3798,3813,3839,3813,3839,3826,41,28,4,15.3,34
,20130813,3839,3826,3863,3863,3863,3863,3863,37,37,2,7.73,34
,20130814,3863,3863,3875,3875,3875,3875,3875,12,12,2,7.75,36
,20130815,3875,3875,3874,3874,3868,3868,3871,-7,-4,12,46.46,42
,20130816,3868,3871,3876,3876,3876,3876,3876,5,5,6,23.26,42
,20130819,3876,3876,3863,3885,3863,3873,3875,-3,-1,60,232.53,52
,20130820,3873,3875,3867,3876,3867,3876,3874,1,-1,12,46.49,50
,20130821,3876,3874,3875,3875,3871,3871,3872,-3,-2,14,54.22,44
,20130822,3871,3872,3859,3859,3826,3856,3847,-16,-25,6,23.08,44
,20130823,3856,3847,3899,3899,3877,3880,3884,33,37,8,31.08,46
,20130826,3880,3884,,,,3884,3884,0,0,0,0,46
,20130827,3884,3884,3899,3904,3899,3904,3901,20,17,4,15.61,46
,20130828,3904,3901,,,,3903,3903,2,2,0,0,46
,20130829,3903,3903,3834,3853,3831,3853,3837,-50,-66,20,76.75,46
,20130830,3853,3837,,,,3837,3837,0,0,0,0,46
,20130902,3837,3837,3877,3877,3877,3877,3877,40,40,2,7.75,48
,20130903,3877,3877,3877,3877,3848,3848,3863,-29,-14,6,23.18,46
,20130904,3848,3863,3856,3856,3850,3850,3853,-13,-10,4,15.41,46
,20130905,3850,3853,3845,3845,3839,3839,3841,-14,-12,8,30.73,42
,20130906,3839,3841,3853,3853,3813,3813,3829,-28,-12,16,61.27,42
,20130909,3813,3829,3835,3848,3835,3848,3841,19,12,4,15.37,38
,20130910,3848,3841,,,,3826,3826,-15,-15,0,0,38
,20130911,3826,3826,,,,3829,3829,3,3,0,0,38
,20130912,3829,3829,3826,3826,3819,3820,3821,-9,-8,8,30.57,38
,20130913,3820,3821,3795,3795,3763,3763,3775,-58,-46,16,60.41,34
,20130916,3763,3775,3741,3750,3738,3743,3745,-32,-30,30,112.38,24
,20130917,3743,3745,,,,3745,3745,0,0,0,0,24
,20130918,3745,3745,3738,3745,3738,3741,3741,-4,-4,6,22.45,24
,20130923,3741,3741,3745,3745,3745,3745,3745,4,4,2,7.49,22
,20130924,3745,3745,,,,3743,3743,-2,-2,0,0,22
,20130925,3743,3743,3732,3732,3732,3732,3732,-11,-11,4,14.93,24
,20130926,3732,3732,3713,3713,3713,3713,3713,-19,-19,4,14.85,24
,20130927,3713,3713,3691,3691,3691,3691,3691,-22,-22,8,29.53,24
,20130930,3691,3691,,,,3691,3691,0,0,0,0,24
,20131008,3691,3691,3681,3681,3660,3660,3670,-31,-21,40,146.82,34
,20131009,3660,3670,3719,3719,3719,3719,3719,49,49,2,7.44,34
,20131010,3719,3719,3698,3698,3696,3698,3696,-21,-23,12,44.36,24
,20131011,3698,3696,,,,3696,3696,0,0,0,0,24
,20131014,3696,3696,,,,3714,3714,18,18,0,0,24
,20131015,3714,3714,3730,3730,3730,3730,3730,16,16,2,7.46,24
,20131016,3730,3730,3716,3716,3704,3704,3710,-26,-20,4,14.84,24
,20131017,3704,3710,3711,3711,3680,3680,3701,-30,-9,8,29.61,28
,20131018,3680,3701,3657,3674,3651,3654,3658,-47,-43,40,146.33,38
,20131021,3654,3658,3626,3646,3626,3646,3637,-12,-21,6,21.82,36
,20131022,3646,3637,3652,3652,3644,3649,3648,12,11,18,65.68,36
,20131023,3649,3648,3636,3636,3636,3636,3636,-12,-12,2,7.27,36
,20131024,3636,3636,3613,3623,3607,3607,3614,-29,-22,6,21.69,38
,20131025,3607,3614,3616,3625,3603,3603,3618,-11,4,30,108.54,38
,20131028,3603,3618,3595,3595,3595,3595,3595,-23,-23,4,14.38,42
,20131029,3595,3595,3619,3619,3619,3619,3619,24,24,4,14.48,38
,20131030,3619,3619,3616,3622,3616,3622,3617,3,-2,20,72.36,48
,20131031,3622,3617,3649,3649,3635,3635,3639,18,22,6,21.84,48
,20131101,3635,3639,3676,3676,3668,3668,3669,29,30,24,88.06,68
,20131104,3668,3669,3699,3699,3658,3684,3672,15,3,18,66.11,70
,20131105,3684,3672,3662,3663,3662,3663,3662,-9,-10,4,14.65,72
,20131106,3663,3662,3647,3647,3647,3647,3647,-15,-15,2,7.29,72
,20131107,3647,3647,3674,3689,3672,3679,3677,32,30,38,139.76,60
,20131108,3679,3677,3681,3684,3677,3677,3680,0,3,18,66.25,64
,20131111,3677,3680,3659,3670,3631,3662,3648,-18,-32,72,262.71,64
,20131112,3662,3648,3661,3673,3657,3673,3667,25,19,42,154.04,92
,20131113,3673,3667,3667,3671,3657,3657,3663,-10,-4,46,168.53,100
,20131114,3657,3663,3640,3656,3624,3635,3639,-28,-24,66,240.18,124
,20131115,3635,3639,3621,3641,3597,3597,3622,-42,-17,30,108.68,128
,20131118,3597,3622,3599,3608,3599,3601,3602,-21,-20,10,36.02,128
,20131119,3601,3602,,,,3607,3607,5,5,0,0,128
,20131120,3607,3607,3642,3642,3642,3642,3642,35,35,6,21.85,128
,20131121,3642,3642,3639,3646,3639,3640,3640,-2,-2,24,87.37,128
,20131122,3640,3640,3617,3617,3617,3617,3617,-23,-23,8,28.94,126
,20131125,3617,3617,3620,3639,3620,3639,3622,22,5,42,152.14,148
,20131126,3639,3622,3663,3663,3663,3663,3663,41,41,14,51.28,152
,20131127,3663,3663,3666,3666,3635,3659,3657,-4,-6,44,160.95,162
,20131128,3659,3657,3614,3687,3614,3674,3679,17,22,190,699.08,188
,20131129,3674,3679,3675,3681,3671,3681,3675,2,-4,14,51.46,180
,20131202,3681,3675,3679,3697,3676,3690,3688,15,13,196,722.96,152
,20131203,3690,3688,3700,3716,3691,3704,3705,16,17,16,59.28,146
,20131204,3704,3705,3723,3736,3714,3719,3721,14,16,160,595.51,156
,20131205,3719,3721,3718,3718,3702,3703,3710,-18,-11,18,66.79,154
,20131206,3703,3710,3689,3704,3689,3691,3693,-19,-17,316,"1,167.06",354
,20131209,3691,3693,3724,3724,3714,3720,3720,27,27,28,104.19,360
,20131210,3720,3720,3730,3730,3720,3720,3723,0,3,34,126.59,356
,20131211,3720,3723,3711,3742,3704,3731,3720,8,-3,108,401.86,392
,20131212,3731,3720,3736,3742,3727,3732,3734,12,14,50,186.7,368
,20131213,3732,3734,3725,3725,3665,3677,3699,-57,-35,346,"1,280.02",394
,20131216,3677,3699,3684,3691,3673,3673,3682,-26,-17,8,29.46,392
,20131217,3673,3682,3679,3679,3666,3666,3677,-16,-5,1026,"3,773.53",614
,20131218,3666,3677,3650,3654,3643,3652,3648,-25,-29,250,912.22,464
,20131219,3652,3648,3653,3663,3639,3643,3650,-5,2,80,292.01,444
,20131220,3643,3650,3650,3657,3634,3634,3642,-16,-8,242,881.44,290
,20131223,3634,3642,3613,3615,3606,3606,3611,-36,-31,108,390.08,274
,20131224,3606,3611,3610,3625,3610,3622,3617,11,6,50,180.88,270
,20131225,3622,3617,3623,3629,3599,3599,3608,-18,-9,76,274.24,262
,20131226,3599,3608,3615,3615,3590,3609,3599,1,-9,20,71.99,268
,20131227,3609,3599,3607,3622,3598,3613,3608,14,9,130,469.05,228
,20131230,3613,3608,3613,3652,3578,3578,3619,-30,11,128,463.29,278
,20131231,3578,3619,3568,3580,3567,3580,3572,-39,-47,28,100.02,280
rb1407,20130716,3723,3723,,,,3723,3723,0,0,0,0,0
,20130717,3723,3723,,,,3744,3744,21,21,0,0,0
,20130718,3744,3744,,,,3744,3744,0,0,0,0,0
,20130719,3744,3744,3760,3790,3735,3735,3764,-9,20,18,67.76,8
,20130722,3735,3764,3759,3759,3735,3736,3752,-28,-12,14,52.53,2
,20130723,3736,3752,3766,3766,3743,3743,3756,-9,4,16,60.1,4
,20130724,3743,3756,3765,3765,3750,3750,3758,-6,2,10,37.58,8
,20130725,3750,3758,3758,3758,3758,3758,3758,0,0,2,7.52,8
,20130726,3758,3758,3748,3748,3746,3746,3747,-12,-11,4,14.99,12
,20130729,3746,3747,3728,3728,3714,3714,3719,-33,-28,6,22.32,10
,20130730,3714,3719,3706,3706,3706,3706,3706,-13,-13,2,7.41,8
,20130731,3706,3706,,,,3706,3706,0,0,0,0,8
,20130801,3706,3706,,,,3715,3715,9,9,0,0,8
,20130802,3715,3715,3734,3739,3733,3739,3735,24,20,6,22.41,12
,20130805,3739,3735,3740,3740,3740,3740,3740,5,5,2,7.48,10
,20130806,3740,3740,,,,3740,3740,0,0,0,0,10
,20130807,3740,3740,3775,3787,3775,3787,3779,47,39,12,45.35,12
,20130808,3787,3779,3805,3811,3805,3810,3806,31,27,126,479.57,114
,20130809,3810,3806,3804,3804,3804,3804,3804,-2,-2,2,7.61,116
,20130812,3804,3804,3832,3851,3812,3851,3840,47,36,32,122.9,134
,20130813,3851,3840,3882,3898,3876,3898,3881,58,41,144,558.98,258
,20130814,3898,3881,3899,3899,3885,3885,3892,4,11,20,77.85,264
,20130815,3885,3892,3884,3897,3884,3884,3890,-8,-2,16,62.24,264
,20130816,3884,3890,,,,3890,3890,0,0,0,0,264
,20130819,3890,3890,3888,3895,3874,3885,3886,-5,-4,28,108.83,266
,20130820,3885,3886,3890,3890,3876,3876,3879,-10,-7,14,54.31,276
,20130821,3876,3879,3880,3887,3873,3878,3877,-1,-2,24,93.06,282
,20130822,3878,3877,3870,3876,3869,3869,3872,-8,-5,16,61.96,292
,20130823,3869,3872,3893,3893,3890,3890,3891,18,19,4,15.57,290
,20130826,3890,3891,3924,3926,3913,3914,3918,23,27,14,54.85,294
,20130827,3914,3918,3891,3905,3891,3905,3900,-13,-18,6,23.4,294
,20130828,3905,3900,3921,3921,3885,3885,3903,-15,3,4,15.61,294
,20130829,3885,3903,,,,3867,3867,-36,-36,0,0,294
,20130830,3867,3867,,,,3861,3861,-6,-6,0,0,294
,20130902,3861,3861,3895,3895,3895,3895,3895,34,34,4,15.58,298
,20130903,3895,3895,3900,3900,3869,3869,3882,-26,-13,14,54.35,304
,20130904,3869,3882,3864,3876,3857,3858,3867,-24,-15,20,77.35,304
,20130905,3858,3867,3869,3869,3846,3849,3858,-18,-9,8,30.87,304
,20130906,3849,3858,3845,3845,3845,3845,3845,-13,-13,2,7.69,306
,20130909,3845,3845,,,,3845,3845,0,0,0,0,306
,20130910,3845,3845,,,,3845,3845,0,0,0,0,306
,20130911,3845,3845,3833,3833,3833,3833,3833,-12,-12,2,7.67,306
,20130912,3833,3833,,,,3833,3833,0,0,0,0,306
,20130913,3833,3833,3800,3801,3775,3780,3787,-53,-46,28,106.05,296
,20130916,3780,3787,3779,3779,3759,3765,3767,-22,-20,30,113.02,290
,20130917,3765,3767,,,,3767,3767,0,0,0,0,290
,20130918,3767,3767,3763,3773,3737,3749,3752,-18,-15,28,105.06,282
,20130923,3749,3752,3761,3776,3761,3776,3770,24,18,6,22.62,280
,20130924,3776,3770,3750,3750,3741,3741,3745,-29,-25,4,14.98,280
,20130925,3741,3745,3726,3726,3726,3726,3726,-19,-19,4,14.9,276
,20130926,3726,3726,3717,3717,3717,3717,3717,-9,-9,2,7.43,278
,20130927,3717,3717,3691,3694,3691,3693,3693,-24,-24,14,51.7,268
,20130930,3693,3693,,,,3699,3699,6,6,0,0,268
,20131008,3699,3699,3665,3675,3665,3675,3672,-24,-27,8,29.38,266
,20131009,3675,3672,3725,3725,3725,3725,3725,53,53,2,7.45,266
,20131010,3725,3725,3696,3696,3696,3696,3696,-29,-29,6,22.18,270
,20131011,3696,3696,3711,3715,3711,3715,3713,19,17,4,14.85,270
,20131014,3715,3713,,,,3731,3731,18,18,0,0,270
,20131015,3731,3731,,,,3747,3747,16,16,0,0,270
,20131016,3747,3747,3720,3732,3720,3723,3725,-24,-22,10,37.25,268
,20131017,3723,3725,3710,3742,3710,3712,3716,-13,-9,12,44.6,268
,20131018,3712,3716,,,,3690,3690,-26,-26,0,0,268
,20131021,3690,3690,3673,3682,3647,3670,3664,-20,-26,26,95.26,268
,20131022,3670,3664,3665,3665,3654,3659,3660,-5,-4,8,29.28,268
,20131023,3659,3660,3648,3648,3648,3648,3648,-12,-12,2,7.3,268
,20131024,3648,3648,3626,3647,3615,3626,3637,-22,-11,66,240.09,262
,20131025,3626,3637,3600,3601,3600,3601,3600,-36,-37,44,158.44,218
,20131028,3601,3600,3587,3587,3587,3587,3587,-13,-13,2,7.17,220
,20131029,3587,3587,3600,3600,3600,3600,3600,13,13,2,7.2,218
,20131030,3600,3600,3634,3634,3634,3634,3634,34,34,2,7.27,220
,20131031,3634,3634,3646,3646,3646,3646,3646,12,12,2,7.29,220
,20131101,3646,3646,3699,3699,3669,3669,3682,23,36,6,22.09,222
,20131104,3669,3682,3676,3676,3676,3676,3676,-6,-6,4,14.7,218
,20131105,3676,3676,3665,3675,3665,3673,3671,-3,-5,14,51.4,222
,20131106,3673,3671,3651,3651,3651,3651,3651,-20,-20,4,14.6,218
,20131107,3651,3651,,,,3670,3670,19,19,0,0,218
,20131108,3670,3670,,,,3670,3670,0,0,0,0,218
,20131111,3670,3670,3646,3646,3646,3646,3646,-24,-24,4,14.58,214
,20131112,3646,3646,,,,3665,3665,19,19,0,0,214
,20131113,3665,3665,,,,3661,3661,-4,-4,0,0,214
,20131114,3661,3661,3628,3629,3620,3629,3625,-32,-36,12,43.51,210
,20131115,3629,3625,3611,3620,3600,3620,3613,-5,-12,50,180.69,212
,20131118,3620,3613,3602,3602,3602,3602,3602,-11,-11,2,7.2,212
,20131119,3602,3602,3623,3623,3623,3623,3623,21,21,2,7.25,214
,20131120,3623,3623,3634,3640,3634,3640,3637,17,14,4,14.55,212
,20131121,3640,3637,,,,3637,3637,0,0,0,0,212
,20131122,3637,3637,3630,3630,3630,3630,3630,-7,-7,2,7.26,212
,20131125,3630,3630,,,,3635,3635,5,5,0,0,212
,20131126,3635,3635,3686,3686,3676,3676,3685,41,50,22,81.07,230
,20131127,3676,3685,,,,3679,3679,-6,-6,0,0,230
,20131128,3679,3679,,,,3701,3701,22,22,0,0,230
,20131129,3701,3701,,,,3697,3697,-4,-4,0,0,230
,20131202,3697,3697,,,,3697,3697,0,0,0,0,230
,20131203,3697,3697,3713,3713,3713,3713,3713,16,16,2,7.43,230
,20131204,3713,3713,3728,3733,3728,3733,3730,20,17,4,14.92,230
,20131205,3733,3730,3713,3713,3713,3713,3713,-17,-17,4,14.85,226
,20131206,3713,3713,3697,3701,3697,3701,3699,-12,-14,4,14.8,230
,20131209,3701,3699,3724,3727,3719,3719,3724,20,25,16,59.59,232
,20131210,3719,3724,3722,3722,3722,3722,3722,-2,-2,40,148.88,264
,20131211,3722,3722,3705,3717,3705,3717,3705,-5,-17,42,155.63,264
,20131212,3717,3705,3744,3744,3744,3744,3744,39,39,2,7.49,264
,20131213,3744,3744,3702,3702,3702,3702,3702,-42,-42,2,7.4,262
,20131216,3702,3702,3683,3683,3679,3679,3682,-23,-20,10,36.82,254
,20131217,3679,3682,,,,3682,3682,0,0,0,0,254
,20131218,3682,3682,3657,3657,3656,3656,3656,-26,-26,10,36.56,244
,20131219,3656,3656,,,,3656,3656,0,0,0,0,244
,20131220,3656,3656,3652,3659,3649,3649,3653,-7,-3,6,21.92,242
,20131223,3649,3653,3632,3632,3625,3625,3628,-28,-25,26,94.34,228
,20131224,3625,3628,3639,3639,3639,3639,3639,11,11,8,29.11,228
,20131225,3639,3639,3638,3638,3614,3614,3626,-25,-13,4,14.5,230
,20131226,3614,3626,3616,3619,3616,3619,3617,-7,-9,4,14.47,228
,20131227,3619,3617,3627,3631,3627,3631,3628,14,11,14,50.79,230
,20131230,3631,3628,3605,3605,3605,3605,3605,-23,-23,2,7.21,230
,20131231,3605,3605,,,,3558,3558,-47,-47,0,0,230
rb1408,20130816,3890,3890,3929,3929,3858,3858,3893,-32,3,4,15.57,2
,20130819,3858,3893,3871,3871,3871,3871,3871,-22,-22,2,7.74,4
,20130820,3871,3871,3907,3907,3884,3890,3891,19,20,14,54.48,12
,20130821,3890,3891,,,,3889,3889,-2,-2,0,0,12
,20130822,3889,3889,3885,3885,3885,3885,3885,-4,-4,2,7.77,14
,20130823,3885,3885,3918,3918,3911,3911,3914,26,29,4,15.66,16
,20130826,3911,3914,4000,4000,3906,3920,3936,6,22,38,149.59,24
,20130827,3920,3936,3872,3919,3870,3919,3899,-17,-37,10,39,28
,20130828,3919,3899,3934,3934,3899,3900,3911,1,12,6,23.47,32
,20130829,3900,3911,3868,3915,3850,3888,3873,-23,-38,18,69.72,40
,20130830,3888,3873,3875,3875,3848,3848,3864,-25,-9,20,77.3,46
,20130902,3848,3864,3892,3918,3889,3902,3901,38,37,22,85.84,54
,20130903,3902,3901,3924,3924,3893,3897,3917,-4,16,26,101.85,76
,20130904,3897,3917,3896,3896,3872,3881,3883,-36,-34,34,132.05,94
,20130905,3881,3883,3876,3881,3873,3873,3875,-10,-8,12,46.5,96
,20130906,3873,3875,3864,3864,3864,3864,3864,-11,-11,8,30.91,96
,20130909,3864,3864,3884,3884,3874,3874,3880,10,16,6,23.28,98
,20130910,3874,3880,,,,3870,3870,-10,-10,0,0,98
,20130911,3870,3870,3865,3865,3865,3865,3865,-5,-5,4,15.46,102
,20130912,3865,3865,,,,3856,3856,-9,-9,0,0,102
,20130913,3856,3856,3828,3830,3786,3794,3807,-62,-49,18,68.53,106
,20130916,3794,3807,3786,3795,3768,3768,3784,-39,-23,20,75.68,106
,20130917,3768,3784,3786,3786,3786,3786,3786,2,2,6,22.72,106
,20130918,3786,3786,3774,3779,3768,3779,3772,-7,-14,18,67.9,108
,20130923,3779,3772,3776,3794,3776,3794,3785,22,13,4,15.14,108
,20130924,3794,3785,,,,3785,3785,0,0,0,0,108
,20130925,3785,3785,3739,3739,3739,3739,3739,-46,-46,6,22.43,106
,20130926,3739,3739,,,,3729,3729,-10,-10,0,0,106
,20130927,3729,3729,3703,3704,3703,3704,3703,-25,-26,6,22.22,100
,20130930,3704,3703,,,,3712,3712,9,9,0,0,100
,20131008,3712,3712,,,,3685,3685,-27,-27,0,0,100
,20131009,3685,3685,,,,3738,3738,53,53,0,0,100
,20131010,3738,3738,3729,3730,3700,3730,3711,-8,-27,34,126.2,116
,20131011,3730,3711,3734,3734,3731,3731,3732,20,21,10,37.32,114
,20131014,3731,3732,,,,3732,3732,0,0,0,0,114
,20131015,3732,3732,3760,3760,3755,3755,3756,23,24,6,22.54,108
,20131016,3755,3756,3750,3758,3744,3756,3748,0,-8,32,119.95,92
,20131017,3756,3748,3746,3749,3744,3744,3746,-4,-2,10,37.47,86
,20131018,3744,3746,3680,3714,3671,3685,3695,-61,-51,68,251.27,90
,20131021,3685,3695,3677,3685,3672,3685,3678,-10,-17,6,22.07,86
,20131022,3685,3678,,,,3678,3678,0,0,0,0,86
,20131023,3678,3678,3659,3666,3659,3659,3660,-19,-18,10,36.61,90
,20131024,3659,3660,3624,3643,3624,3633,3630,-27,-30,18,65.34,90
,20131025,3633,3630,3616,3616,3615,3615,3615,-15,-15,16,57.85,90
,20131028,3615,3615,,,,3601,3601,-14,-14,0,0,90
,20131029,3601,3601,,,,3614,3614,13,13,0,0,90
,20131030,3614,3614,,,,3648,3648,34,34,0,0,90
,20131031,3648,3648,3645,3651,3645,3649,3648,1,0,48,175.14,90
,20131101,3649,3648,3686,3707,3668,3707,3677,59,29,60,220.65,92
,20131104,3707,3677,3695,3695,3668,3686,3683,9,6,22,81.03,92
,20131105,3686,3683,3676,3676,3676,3676,3676,-7,-7,2,7.35,92
,20131106,3676,3676,3663,3663,3663,3663,3663,-13,-13,2,7.33,92
,20131107,3663,3663,,,,3693,3693,30,30,0,0,92
,20131108,3693,3693,3685,3685,3685,3685,3685,-8,-8,4,14.74,94
,20131111,3685,3685,3651,3651,3651,3651,3651,-34,-34,2,7.3,92
,20131112,3651,3651,,,,3670,3670,19,19,0,0,92
,20131113,3670,3670,,,,3667,3667,-3,-3,0,0,92
,20131114,3667,3667,3655,3655,3655,3655,3655,-12,-12,2,7.31,92
,20131115,3655,3655,3615,3615,3597,3597,3606,-58,-49,8,28.85,96
,20131118,3597,3606,,,,3606,3606,0,0,0,0,96
,20131119,3606,3606,,,,3627,3627,21,21,0,0,96
,20131120,3627,3627,3648,3658,3648,3658,3653,31,26,4,14.61,96
,20131121,3658,3653,3635,3635,3635,3635,3635,-18,-18,400,"1,454.00",488
,20131122,3635,3635,,,,3635,3635,0,0,0,0,488
,20131125,3635,3635,3644,3644,3644,3644,3644,9,9,2,7.29,488
,20131126,3644,3644,,,,3694,3694,50,50,0,0,488
,20131127,3694,3694,3684,3684,3684,3684,3684,-10,-10,2,7.37,490
,20131128,3684,3684,3692,3692,3683,3683,3684,-1,0,10,36.85,490
,20131129,3683,3684,3687,3687,3687,3687,3687,3,3,16,58.99,490
,20131202,3687,3687,3699,3699,3699,3699,3699,12,12,2,7.4,490
,20131203,3699,3699,3699,3716,3699,3716,3699,17,0,406,"1,501.89",134
,20131204,3716,3699,,,,3716,3716,17,17,0,0,134
,20131205,3716,3716,3715,3715,3715,3715,3715,-1,-1,4,14.86,138
,20131206,3715,3715,,,,3700,3700,-15,-15,0,0,138
,20131209,3700,3700,3736,3736,3723,3723,3727,23,27,12,44.73,134
,20131210,3723,3727,,,,3727,3727,0,0,0,0,134
,20131211,3727,3727,3725,3725,3724,3724,3724,-3,-3,18,67.03,134
,20131212,3724,3724,3740,3744,3739,3742,3741,18,17,24,89.79,116
,20131213,3742,3741,3705,3705,3703,3703,3703,-38,-38,10,37.04,110
,20131216,3703,3703,3693,3693,3693,3693,3693,-10,-10,6,22.16,106
,20131217,3693,3693,,,,3693,3693,0,0,0,0,106
,20131218,3693,3693,,,,3693,3693,0,0,0,0,106
,20131219,3693,3693,,,,3695,3695,2,2,0,0,106
,20131220,3695,3695,3650,3650,3650,3650,3650,-45,-45,4,14.6,106
,20131223,3650,3650,,,,3646,3646,-4,-4,0,0,106
,20131224,3646,3646,3657,3657,3657,3657,3657,11,11,2,7.31,106
,20131225,3657,3657,3629,3629,3629,3629,3629,-28,-28,4,14.52,110
,20131226,3629,3629,,,,3629,3629,0,0,0,0,110
,20131227,3629,3629,3630,3661,3629,3635,3637,6,8,14,50.93,110
,20131230,3635,3637,3635,3635,3621,3621,3634,-16,-3,32,116.29,78
,20131231,3621,3634,3605,3605,3605,3605,3605,-29,-29,2,7.21,76
rb1409,20130917,3784,3784,,,,3786,3786,2,2,0,0,0
,20130918,3786,3786,3746,3804,3746,3804,3775,18,-11,4,15.1,2
,20130923,3804,3775,3787,3816,3780,3814,3796,39,21,10,37.97,6
,20130924,3814,3796,3782,3782,3769,3769,3775,-27,-21,10,37.76,8
,20130925,3769,3775,3755,3760,3744,3758,3753,-17,-22,116,435.46,104
,20130926,3758,3753,3749,3755,3726,3740,3734,-13,-19,64,239.03,154
,20130927,3740,3734,3715,3729,3708,3708,3715,-26,-19,22,81.74,162
,20130930,3708,3715,3714,3732,3714,3730,3724,15,9,58,216,192
,20131008,3730,3724,3715,3732,3668,3732,3703,8,-21,44,162.97,200
,20131009,3732,3703,3732,3763,3730,3730,3742,27,39,118,441.58,230
,20131010,3730,3742,3732,3746,3710,3738,3734,-4,-8,66,246.5,238
,20131011,3738,3734,3750,3760,3726,3726,3742,-8,8,72,269.48,244
,20131014,3726,3742,3739,3768,3739,3768,3757,26,15,78,293.08,280
,20131015,3768,3757,3786,3794,3751,3765,3777,8,20,222,838.52,324
,20131016,3765,3777,3771,3774,3742,3746,3758,-31,-19,222,834.34,408
,20131017,3746,3758,3761,3766,3721,3730,3748,-28,-10,208,779.66,410
,20131018,3730,3748,3731,3731,3675,3683,3694,-65,-54,1468,"5,424.06",772
,20131021,3683,3694,3683,3683,3660,3679,3671,-15,-23,1178,"4,324.69",580
,20131022,3679,3671,3671,3687,3671,3681,3677,10,6,582,"2,140.21",562
,20131023,3681,3677,3679,3687,3642,3662,3668,-15,-9,852,"3,125.52",862
,20131024,3662,3668,3642,3655,3638,3652,3641,-16,-27,276,"1,005.13",968
,20131025,3652,3641,3650,3656,3621,3621,3638,-20,-3,204,742.21,1066
,20131028,3621,3638,3626,3632,3615,3623,3624,-15,-14,176,637.92,1062
,20131029,3623,3624,3623,3636,3622,3636,3627,12,3,94,341.03,1096
,20131030,3636,3627,3650,3660,3645,3659,3653,32,26,1302,"4,757.39",2162
,20131031,3659,3653,3664,3664,3651,3661,3657,8,4,180,658.36,2186
,20131101,3661,3657,3667,3715,3666,3701,3687,44,30,158,582.57,2178
,20131104,3701,3687,3696,3698,3680,3692,3690,5,3,134,494.5,2226
,20131105,3692,3690,3702,3703,3682,3692,3688,2,-2,122,450.05,2230
,20131106,3692,3688,3695,3695,3658,3662,3676,-26,-12,128,470.55,2172
,20131107,3662,3676,3670,3700,3670,3690,3689,14,13,62,228.72,2176
,20131108,3690,3689,3691,3708,3680,3680,3688,-9,-1,326,"1,202.47",2006
,20131111,3680,3688,3680,3690,3662,3685,3670,-3,-18,80,293.66,1984
,20131112,3685,3670,3689,3698,3675,3682,3681,12,11,94,346.02,1968
,20131113,3682,3681,3678,3686,3661,3661,3675,-20,-6,80,294.06,1972
,20131114,3661,3675,3660,3662,3629,3629,3647,-46,-28,448,"1,634.12",1784
,20131115,3629,3647,3639,3649,3612,3613,3626,-34,-21,226,819.65,1656
,20131118,3613,3626,3607,3633,3607,3611,3622,-15,-4,104,376.74,1626
,20131119,3611,3622,3606,3640,3606,3640,3626,18,4,98,355.4,1612
,20131120,3640,3626,3641,3660,3640,3659,3649,33,23,132,481.77,1616
,20131121,3659,3649,3649,3662,3632,3633,3650,-16,1,96,350.42,1624
,20131122,3633,3650,3641,3655,3636,3640,3643,-10,-7,76,276.87,1596
,20131125,3640,3643,3649,3660,3638,3658,3649,15,6,326,"1,189.89",1552
,20131126,3658,3649,3676,3704,3662,3694,3681,45,32,392,"1,443.03",1452
,20131127,3694,3681,3678,3695,3678,3678,3681,-3,0,78,287.17,1420
,20131128,3678,3681,3687,3699,3683,3690,3692,9,11,42,155.08,1416
,20131129,3690,3692,3686,3694,3684,3692,3689,0,-3,70,258.29,1408
,20131202,3692,3689,3696,3723,3696,3716,3706,27,17,322,"1,193.63",1292
,20131203,3716,3706,3713,3726,3711,3725,3719,19,13,76,282.7,1302
,20131204,3725,3719,3734,3756,3728,3741,3738,22,19,162,605.7,1318
,20131205,3741,3738,3730,3730,3717,3725,3724,-13,-14,48,178.78,1322
,20131206,3725,3724,3709,3709,3699,3699,3703,-25,-21,36,133.34,1318
,20131209,3699,3703,3725,3732,3721,3732,3725,29,22,176,655.71,1282
,20131210,3732,3725,3732,3771,3729,3736,3735,11,10,78,291.39,1242
,20131211,3736,3735,3730,3758,3726,3758,3741,23,6,74,276.9,1220
,20131212,3758,3741,3722,3765,3722,3750,3755,9,14,68,255.39,1230
,20131213,3750,3755,3724,3749,3696,3700,3709,-55,-46,236,875.55,1212
,20131216,3700,3709,3719,3721,3704,3706,3712,-3,3,160,594.05,1184
,20131217,3706,3712,3713,3722,3705,3705,3712,-7,0,100,371.26,1186
,20131218,3705,3712,3700,3714,3686,3693,3693,-19,-19,126,465.43,1118
,20131219,3693,3693,3641,3713,3641,3688,3699,-5,6,102,377.33,1122
,20131220,3688,3699,3697,3697,3663,3669,3677,-30,-22,26,95.61,1116
,20131223,3669,3677,3657,3662,3646,3646,3653,-31,-24,92,336.12,1170
,20131224,3646,3653,3674,3674,3653,3664,3661,11,8,194,710.24,1174
,20131225,3664,3661,3670,3670,3641,3651,3648,-10,-13,132,481.6,1202
,20131226,3651,3648,3651,3665,3630,3646,3642,-2,-6,72,262.25,1208
,20131227,3646,3642,3652,3663,3640,3656,3651,14,9,144,525.74,1244
,20131230,3656,3651,3656,3679,3630,3635,3658,-16,7,316,"1,156.11",1246
,20131231,3635,3658,3613,3642,3613,3630,3637,-28,-21,550,"2,000.38",1420
rb1410,20131016,3777,3777,3808,3808,3764,3765,3778,-12,1,274,"1,035.42",174
,20131017,3765,3778,3780,3790,3754,3754,3773,-24,-5,224,845.26,268
,20131018,3754,3773,3748,3759,3672,3682,3684,-91,-89,20328,"74,902.81",12950
,20131021,3682,3684,3671,3687,3660,3678,3669,-6,-15,13032,"47,815.83",19322
,20131022,3678,3669,3679,3695,3660,3673,3679,4,10,5492,"20,207.21",20964
,20131023,3673,3679,3685,3694,3667,3673,3683,-6,4,5664,"20,864.33",22722
,20131024,3673,3683,3660,3667,3647,3659,3655,-24,-28,3432,"12,544.75",22750
,20131025,3659,3655,3660,3669,3648,3650,3658,-5,3,6474,"23,685.93",23450
,20131028,3650,3658,3650,3655,3625,3643,3639,-15,-19,4178,"15,207.57",22554
,20131029,3643,3639,3639,3659,3631,3659,3643,20,4,3218,"11,725.25",23358
,20131030,3659,3643,3659,3698,3658,3696,3677,53,34,5840,"21,478.59",24552
,20131031,3696,3677,3695,3702,3685,3694,3695,17,18,4826,"17,833.74",26504
,20131101,3694,3695,3691,3732,3691,3730,3715,35,20,10644,"39,549.14",30204
,20131104,3730,3715,3730,3735,3720,3733,3729,18,14,6338,"23,634.52",31626
,20131105,3733,3729,3739,3747,3718,3727,3730,-2,1,5464,"20,382.17",33220
,20131106,3727,3730,3726,3733,3688,3693,3703,-37,-27,18494,"68,483.40",39686
,20131107,3693,3703,3693,3727,3693,3719,3718,16,15,33542,"124,720.88",63300
,20131108,3719,3718,3719,3726,3700,3701,3711,-17,-7,30806,"114,328.08",88070
,20131111,3701,3711,3702,3715,3679,3700,3702,-11,-9,30356,"112,381.00",108750
,20131112,3700,3702,3701,3714,3694,3699,3704,-3,2,20256,"75,036.14",121912
,20131113,3699,3704,3695,3706,3674,3674,3692,-30,-12,28258,"104,355.71",138336
,20131114,3674,3692,3680,3681,3636,3644,3652,-48,-40,40578,"148,194.63",160268
,20131115,3644,3652,3647,3665,3619,3624,3645,-28,-7,40518,"147,716.72",172526
,20131118,3624,3645,3625,3653,3621,3629,3638,-16,-7,35256,"128,273.37",182934
,20131119,3629,3638,3626,3664,3621,3661,3652,23,14,39708,"145,037.97",204124
,20131120,3661,3652,3663,3688,3663,3682,3677,30,25,30670,"112,780.12",217178
,20131121,3682,3677,3682,3682,3648,3653,3663,-24,-14,17586,"64,434.66",219060
,20131122,3653,3663,3660,3675,3655,3657,3662,-6,-1,12564,"46,019.61",218782
,20131125,3657,3662,3669,3681,3657,3671,3669,9,7,17812,"65,356.84",224722
,20131126,3671,3669,3670,3719,3670,3704,3700,35,31,73876,"273,401.99",252694
,20131127,3704,3700,3702,3708,3692,3698,3700,-2,0,19108,"70,703.28",257288
,20131128,3698,3700,3687,3722,3687,3710,3711,10,11,32872,"122,011.23",274796
,20131129,3710,3711,3710,3718,3703,3708,3709,-3,-2,22698,"84,200.22",283284
,20131202,3708,3709,3710,3736,3710,3733,3723,24,14,51062,"190,145.17",305870
,20131203,3733,3723,3735,3749,3728,3748,3737,25,14,35216,"131,615.35",319042
,20131204,3748,3737,3748,3762,3745,3748,3755,11,18,88924,"333,939.70",377170
,20131205,3748,3755,3750,3752,3730,3731,3742,-24,-13,49640,"185,755.07",393596
,20131206,3731,3742,3730,3731,3711,3719,3720,-23,-22,119938,"446,262.37",476074
,20131209,3719,3720,3722,3748,3721,3746,3739,26,19,61250,"229,042.68",490884
,20131210,3746,3739,3750,3757,3735,3744,3743,5,4,31590,"118,262.46",498104
,20131211,3744,3743,3746,3774,3726,3772,3752,29,9,128356,"481,688.56",524836
,20131212,3772,3752,3773,3778,3749,3749,3763,-3,11,112422,"423,054.51",575844
,20131213,3749,3763,3749,3752,3701,3711,3719,-52,-44,144816,"538,669.85",569916
,20131216,3711,3719,3715,3729,3707,3711,3716,-8,-3,53132,"197,470.82",568408
,20131217,3711,3716,3718,3728,3709,3710,3718,-6,2,60222,"223,932.54",574948
,20131218,3710,3718,3708,3710,3693,3702,3701,-16,-17,72100,"266,849.15",565548
,20131219,3702,3701,3703,3715,3691,3694,3702,-7,1,85698,"317,333.33",572240
,20131220,3694,3702,3695,3708,3677,3679,3696,-23,-6,74940,"277,001.92",569982
,20131223,3679,3696,3671,3673,3652,3659,3663,-37,-33,99592,"364,834.52",563224
,20131224,3659,3663,3658,3685,3657,3680,3675,17,12,47368,"174,081.85",568366
,20131225,3680,3675,3689,3690,3654,3663,3669,-12,-6,62370,"228,888.12",561372
,20131226,3663,3669,3660,3674,3646,3667,3661,-2,-8,80440,"294,493.76",561640
,20131227,3667,3661,3669,3685,3659,3673,3673,12,12,81592,"299,733.14",576340
,20131230,3673,3673,3673,3687,3645,3645,3665,-28,-8,104370,"382,620.24",587072
,20131231,3645,3665,3645,3670,3638,3645,3650,-20,-15,111684,"407,740.90",579452
rb1411,20131118,3645,3645,,,,3645,3645,0,0,0,0,0
,20131119,3645,3645,,,,3659,3659,14,14,0,0,0
,20131120,3659,3659,,,,3667,3667,8,8,0,0,0
,20131121,3667,3667,,,,3667,3667,0,0,0,0,0
,20131122,3667,3667,3690,3690,3690,3690,3690,23,23,2,7.38,2
,20131125,3690,3690,,,,3697,3697,7,7,0,0,2
,20131126,3697,3697,3697,3697,3697,3697,3697,0,0,2,7.39,2
,20131127,3697,3697,3697,3697,3697,3697,3697,0,0,4,14.79,6
,20131128,3697,3697,3728,3728,3704,3704,3715,7,18,8,29.72,6
,20131129,3704,3715,3710,3710,3710,3710,3710,-5,-5,8,29.68,10
,20131202,3710,3710,3718,3718,3718,3718,3718,8,8,2,7.44,12
,20131203,3718,3718,,,,3728,3728,10,10,0,0,12
,20131204,3728,3728,3754,3754,3754,3754,3754,26,26,4,15.02,16
,20131205,3754,3754,3739,3739,3739,3739,3739,-15,-15,2,7.48,16
,20131206,3739,3739,3726,3726,3726,3726,3726,-13,-13,6,22.36,16
,20131209,3726,3726,3743,3754,3739,3739,3745,13,19,6,22.47,20
,20131210,3739,3745,3747,3747,3740,3740,3744,-5,-1,26,97.35,44
,20131211,3740,3744,3771,3771,3768,3768,3769,24,25,4,15.08,44
,20131212,3768,3769,3769,3801,3752,3752,3768,-17,-1,20,75.36,54
,20131213,3752,3768,3726,3726,3715,3718,3719,-50,-49,8,29.75,52
,20131216,3718,3719,3717,3717,3717,3717,3717,-2,-2,2,7.43,50
,20131217,3717,3717,3743,3743,3717,3717,3740,0,23,344,"1,286.74",342
,20131218,3717,3740,3707,3707,3700,3700,3706,-40,-34,282,"1,045.32",344
,20131219,3700,3706,3716,3716,3700,3701,3705,-5,-1,54,200.09,348
,20131220,3701,3705,3705,3711,3680,3680,3704,-25,-1,52,192.65,358
,20131223,3680,3704,3663,3667,3655,3655,3661,-49,-43,12,43.94,358
,20131224,3655,3661,3688,3688,3688,3688,3688,27,27,2,7.38,358
,20131225,3688,3688,3669,3669,3669,3669,3669,-19,-19,2,7.34,358
,20131226,3669,3669,3673,3673,3673,3673,3673,4,4,2,7.35,356
,20131227,3673,3673,3676,3676,3676,3676,3676,3,3,2,7.35,354
,20131230,3676,3676,3672,3672,3628,3628,3648,-48,-28,8,29.19,360
,20131231,3628,3648,3648,3653,3648,3653,3648,5,0,104,379.4,462
rb1412,20131217,3717,3717,3730,3748,3725,3740,3736,23,19,12,44.84,8
,20131218,3740,3736,3722,3722,3718,3718,3720,-18,-16,6,22.32,8
,20131219,3718,3720,,,,3720,3720,0,0,0,0,8
,20131220,3720,3720,3713,3713,3713,3713,3713,-7,-7,2,7.43,10
,20131223,3713,3713,3693,3713,3663,3685,3688,-28,-25,8,29.51,8
,20131224,3685,3688,3688,3688,3688,3688,3688,0,0,2,7.38,10
,20131225,3688,3688,3701,3701,3675,3675,3684,-13,-4,26,95.8,18
,20131226,3675,3684,3675,3675,3670,3670,3673,-14,-11,8,29.39,22
,20131227,3670,3673,3682,3687,3676,3676,3681,3,8,12,44.17,18
,20131230,3676,3681,3690,3690,3652,3653,3669,-28,-12,16,58.7,20
,20131231,3653,3669,3657,3670,3657,3660,3662,-9,-7,6,21.97,20
ru1301,20130104,25780,25595,26245,26245,25750,25795,25865,200,270,344,"8,898.20",4466
,20130107,25795,25865,25790,25790,25500,25500,25695,-365,-170,214,"5,499.19",4432
,20130108,25500,25695,25620,26045,25305,25610,25550,-85,-145,384,"9,813.07",4644
,20130109,25610,25550,25610,25680,25450,25620,25585,70,35,412,"10,541.26",4602
,20130110,25620,25585,25635,25780,25605,25725,25665,140,80,270,"6,930.53",4508
,20130111,25725,25665,25605,25800,25265,25265,25590,-400,-75,182,"4,657.84",4552
,20130114,25265,25590,25255,25450,25200,25450,25265,-140,-325,218,"5,508.33",4572
,20130115,25450,25265,25500,25500,25195,25210,25210,-55,-55,228,"5,748.68",4552
ru1303,20130104,26095,26055,26135,26285,25905,25930,26025,-125,-30,802,"20,872.24",5550
,20130107,25930,26025,25920,26075,25605,25675,25860,-350,-165,614,"15,879.83",5294
,20130108,25675,25860,25710,25900,25500,25850,25700,-10,-160,548,"14,085.00",5080
,20130109,25850,25700,25915,25915,25680,25740,25795,40,95,400,"10,319.12",4898
,20130110,25740,25795,25890,25935,25800,25890,25860,95,65,606,"15,673.13",4886
,20130111,25890,25860,26000,26160,25490,25495,25785,-365,-75,582,"15,008.03",4758
,20130114,25495,25785,25490,25770,25345,25680,25495,-105,-290,532,"13,565.45",4568
,20130115,25680,25495,25500,25550,25295,25300,25450,-195,-45,188,"4,785.34",4554
,20130116,25300,25450,25225,25275,25005,25250,25175,-200,-275,90,"2,265.85",4582
,20130117,25250,25175,25300,25310,25205,25280,25265,105,90,74,"1,869.89",4578
,20130118,25280,25265,25500,25605,25480,25520,25525,255,260,2118,"54,066.40",4308
,20130121,25520,25525,25425,25425,25240,25305,25320,-220,-205,418,"10,584.73",4216
,20130122,25305,25320,25370,25720,25370,25670,25640,350,320,848,"21,743.45",4188
,20130123,25670,25640,25750,25750,25590,25680,25655,40,15,516,"13,238.07",4170
,20130124,25680,25655,25655,25675,25140,25300,25340,-355,-315,530,"13,431.52",4182
,20130125,25300,25340,25310,25320,25215,25230,25275,-110,-65,38,960.52,4192
,20130128,25230,25275,25100,25255,25100,25210,25140,-65,-135,942,"23,681.96",4192
,20130129,25210,25140,25185,25530,25150,25525,25400,385,260,892,"22,657.42",4160
,20130130,25525,25400,25630,25775,25610,25700,25675,300,275,984,"25,266.88",3912
,20130131,25700,25675,25755,25915,25600,25755,25785,80,110,1078,"27,799.84",3906
,20130201,25755,25785,25735,25980,25600,25975,25730,190,-55,930,"23,932.47",3810
,20130204,25975,25730,26195,26400,26115,26270,26260,540,530,644,"16,912.69",3810
,20130205,26270,26260,26030,26410,26015,26300,26235,40,-25,226,"5,929.90",3862
,20130206,26300,26235,26375,26445,26095,26130,26270,-105,35,276,"7,251.53",3896
,20130207,26130,26270,26140,26140,25830,26020,25955,-250,-315,196,"5,087.60",3862
,20130208,26020,25955,26000,26180,25850,25850,25985,-105,30,122,"3,170.58",3804
,20130218,25850,25985,25725,25725,25405,25405,25560,-580,-425,468,"11,963.89",3684
,20130219,25405,25560,25455,25455,25210,25250,25320,-310,-240,174,"4,406.31",3648
,20130220,25250,25320,25330,25330,24950,25040,25145,-280,-175,358,"9,002.08",3644
,20130221,25040,25145,24915,24915,24035,24350,24340,-795,-805,1240,"30,182.93",3692
,20130222,24350,24340,24420,24475,24310,24315,24395,-25,55,244,"5,952.67",3746
,20130225,24315,24395,24080,24125,23900,23990,24015,-405,-380,760,"18,251.53",3660
,20130226,23990,24015,23740,23915,23670,23670,23820,-345,-195,764,"18,201.82",3528
,20130227,23670,23820,23910,24100,23800,24010,23985,190,165,1052,"25,234.24",3598
,20130228,24010,23985,24255,24350,24035,24160,24155,175,170,1770,"42,762.07",3282
,20130301,24160,24155,23970,23980,23290,23585,23585,-570,-570,528,"12,454.14",3284
,20130304,23585,23585,23660,23660,23360,23450,23420,-135,-165,932,"21,829.59",2500
,20130305,23450,23420,23710,23800,23600,23800,23675,380,255,816,"19,322.40",2266
,20130306,23800,23675,23850,23900,23500,23720,23755,45,80,128,"3,040.64",2208
,20130307,23720,23755,23710,23710,23450,23500,23580,-255,-175,172,"4,056.32",2180
,20130308,23500,23580,23525,23580,23350,23580,23435,0,-145,122,"2,859.34",2188
,20130311,23580,23435,23645,23660,23490,23565,23605,130,170,150,"3,541.11",2202
,20130312,23565,23605,23425,23425,22805,22805,23095,-800,-510,300,"6,929.71",2266
,20130313,22805,23095,22700,22730,22500,22520,22690,-575,-405,196,"4,447.98",2324
,20130314,22520,22690,22200,22490,22050,22300,22260,-390,-430,210,"4,675.01",2336
,20130315,22300,22260,22500,22500,22050,22400,22320,140,60,426,"9,510.02",2152
ru1304,20130104,26380,26295,26520,26520,26130,26235,26255,-60,-40,24,630.21,290
,20130107,26235,26255,26150,26240,25735,25830,25950,-425,-305,54,"1,401.56",292
,20130108,25830,25950,25810,26130,25700,26005,25965,55,15,48,"1,246.40",266
,20130109,26005,25965,25890,26020,25845,25865,25900,-100,-65,40,"1,036.05",260
,20130110,25865,25900,26095,26100,25930,25930,25985,30,85,36,935.61,246
,20130111,25930,25985,26450,26450,25610,25650,26255,-335,270,430,"11,291.63",260
,20130114,25650,26255,25565,25805,25495,25805,25580,-450,-675,70,"1,790.80",242
,20130115,25805,25580,25590,25640,25350,25410,25535,-170,-45,26,663.95,232
,20130116,25410,25535,,,,25535,25535,0,0,0,0,232
,20130117,25535,25535,25535,25535,25260,25430,25455,-105,-80,110,"2,800.26",228
,20130118,25430,25455,25640,25790,25640,25750,25730,295,275,38,977.79,242
,20130121,25750,25730,25645,25645,25535,25575,25595,-155,-135,12,307.17,238
,20130122,25575,25595,25705,25955,25705,25850,25885,255,290,66,"1,708.69",250
,20130123,25850,25885,,,,25885,25885,0,0,0,0,250
,20130124,25885,25885,25490,25545,25400,25470,25465,-415,-420,30,764.03,240
,20130125,25470,25465,25560,25560,25560,25560,25560,95,95,4,102.24,240
,20130128,25560,25560,25230,25485,25230,25485,25400,-75,-160,42,"1,066.90",244
,20130129,25485,25400,25605,25775,25500,25685,25585,285,185,218,"5,578.54",292
,20130130,25685,25585,25895,25975,25875,25930,25925,345,340,38,985.19,288
,20130131,25930,25925,25940,26075,25830,26000,26010,75,85,114,"2,965.60",296
,20130201,26000,26010,26025,26240,26025,26240,26105,230,95,28,731.04,320
,20130204,26240,26105,26580,26675,26360,26535,26520,430,415,168,"4,456.00",356
,20130205,26535,26520,26395,26615,26330,26615,26475,95,-45,44,"1,165.06",362
,20130206,26615,26475,26670,26670,26365,26365,26520,-110,45,14,371.3,360
,20130207,26365,26520,26255,26295,26175,26175,26250,-345,-270,56,"1,470.05",328
,20130208,26175,26250,26300,26300,26210,26240,26230,-10,-20,24,629.58,326
,20130218,26240,26230,25920,25980,25685,25735,25790,-495,-440,42,"1,083.25",324
,20130219,25735,25790,25600,25620,25475,25475,25580,-315,-210,30,767.49,300
,20130220,25475,25580,25650,25650,25175,25240,25315,-340,-265,38,962.1,300
,20130221,25240,25315,24915,24915,24240,24635,24630,-680,-685,130,"3,202.53",268
,20130222,24635,24630,24625,24690,24600,24600,24635,-30,5,20,492.71,266
,20130225,24600,24635,24455,24455,24285,24340,24330,-295,-305,34,827.23,290
,20130226,24340,24330,24035,24070,23840,23865,23995,-465,-335,28,671.86,282
,20130227,23865,23995,24150,24250,24150,24250,24210,255,215,64,"1,549.53",312
,20130228,24250,24210,24530,24530,24380,24380,24460,170,250,28,685,306
,20130301,24380,24460,24110,24210,23795,23795,24020,-665,-440,46,"1,105.00",322
,20130304,23795,24020,,,,24020,24020,0,0,0,0,322
,20130305,24020,24020,23985,23985,23985,23985,23985,-35,-35,2,47.97,324
,20130306,23985,23985,23820,23850,23820,23850,23835,-135,-150,4,95.34,324
,20130307,23850,23835,23630,23680,23600,23670,23630,-165,-205,52,"1,228.89",350
,20130308,23670,23630,23720,23775,23690,23755,23745,125,115,14,332.44,354
,20130311,23755,23745,23695,23780,23660,23660,23715,-85,-30,12,284.63,350
,20130312,23660,23715,23665,23665,23105,23130,23330,-585,-385,30,699.92,348
,20130313,23130,23330,,,,22920,22920,-410,-410,0,0,348
,20130314,22920,22920,22280,22435,22275,22370,22370,-550,-550,550,"12,303.54",642
,20130315,22370,22370,22500,22695,22355,22600,22490,230,120,410,"9,222.49",730
,20130318,22600,22490,22020,22020,21650,21855,21825,-635,-665,30,654.78,740
,20130319,21855,21825,21950,22120,21870,22000,22050,175,225,122,"2,690.59",744
,20130320,22000,22050,21995,22385,21995,22385,22255,335,205,112,"2,492.99",774
,20130321,22385,22255,22495,22595,22350,22350,22495,95,240,226,"5,084.35",754
,20130322,22350,22495,22135,22315,22135,22300,22275,-195,-220,138,"3,074.19",734
,20130325,22300,22275,22390,22515,22205,22240,22400,-35,125,348,"7,796.74",592
,20130326,22240,22400,22205,22205,22000,22195,22115,-205,-285,30,663.57,590
,20130327,22195,22115,22635,22635,22060,22065,22180,-50,65,162,"3,593.63",580
,20130328,22065,22180,22100,22100,21565,21580,21980,-600,-200,200,"4,396.29",538
,20130329,21580,21980,21350,21505,21160,21405,21340,-575,-640,196,"4,183.57",602
,20130401,21405,21340,21440,21470,20840,20840,21095,-500,-245,126,"2,658.38",644
,20130402,20840,21095,20890,21040,20450,20975,20740,-120,-355,78,"1,617.83",680
,20130403,20975,20740,20700,20850,20605,20605,20740,-135,0,46,954.1,700
,20130408,20605,20740,20550,20975,20480,20950,20775,210,35,234,"4,861.44",806
,20130409,20950,20775,21030,21150,20975,21015,21045,240,270,66,"1,389.22",818
,20130410,21015,21045,21005,21180,20955,21085,21105,40,60,70,"1,477.65",848
,20130411,21085,21105,21065,21190,20770,20775,21055,-330,-50,46,968.63,876
,20130412,20775,21055,20800,20815,20665,20670,20740,-385,-315,66,"1,369.15",890
,20130415,20670,20740,20115,20115,19700,19710,19885,-1030,-855,156,"3,102.44",834
ru1305,20130104,26510,26415,26530,26700,26300,26350,26510,-65,95,253494,"6,720,536.29",142344
,20130107,26350,26510,26400,26490,25975,26075,26245,-435,-265,378260,"9,928,630.45",146208
,20130108,26075,26245,26150,26365,25820,26180,26100,-65,-145,358170,"9,348,588.85",141280
,20130109,26180,26100,26260,26320,25970,26035,26110,-65,10,310256,"8,102,108.06",139732
,20130110,26035,26110,26210,26280,26055,26205,26165,95,55,280448,"7,339,283.59",145112
,20130111,26205,26165,26400,26565,25710,25710,26160,-455,-5,400080,"10,466,364.84",135562
,20130114,25710,26160,25780,26045,25560,25840,25805,-320,-355,349848,"9,029,115.72",135356
,20130115,25840,25805,25820,26010,25460,25480,25745,-325,-60,427780,"11,014,372.97",141186
,20130116,25480,25745,25480,25630,25230,25495,25475,-250,-270,350832,"8,937,604.46",132226
,20130117,25495,25475,25560,25660,25395,25585,25535,110,60,272300,"6,954,258.44",132224
,20130118,25585,25535,25800,26000,25760,25960,25870,425,335,282882,"7,318,607.58",127184
,20130121,25960,25870,25900,25900,25680,25765,25780,-105,-90,202064,"5,209,792.79",128734
,20130122,25765,25780,25790,26195,25765,26110,26065,330,285,297090,"7,744,707.10",128684
,20130123,26110,26065,26190,26230,25970,26085,26090,20,25,166216,"4,336,631.67",130498
,20130124,26085,26090,26050,26110,25505,25640,25730,-450,-360,298740,"7,687,334.97",126072
,20130125,25640,25730,25715,25810,25560,25565,25705,-165,-25,186352,"4,791,014.28",132494
,20130128,25565,25705,25585,25695,25380,25595,25585,-110,-120,214772,"5,495,214.41",128158
,20130129,25595,25585,25580,25995,25520,25955,25825,370,240,251966,"6,507,062.96",129714
,20130130,25955,25825,26050,26250,26030,26180,26155,355,330,183602,"4,802,696.20",126804
,20130131,26180,26155,26215,26355,26040,26285,26235,130,80,189682,"4,976,671.63",119450
,20130201,26285,26235,26235,26505,26060,26465,26290,230,55,238504,"6,270,938.49",118884
,20130204,26465,26290,26880,26965,26580,26780,26770,490,480,220938,"5,914,928.45",115174
,20130205,26780,26770,26525,26980,26525,26810,26785,40,15,206520,"5,532,362.37",105118
,20130206,26810,26785,26910,27040,26585,26655,26775,-130,-10,148234,"3,969,570.40",95742
,20130207,26655,26775,26700,26700,26305,26475,26455,-300,-320,104830,"2,773,712.04",77794
,20130208,26475,26455,26360,26655,26275,26275,26490,-180,35,60672,"1,607,463.86",69706
,20130218,26275,26490,26190,26345,25850,25855,26065,-635,-425,48808,"1,272,328.44",65842
,20130219,25855,26065,25740,25920,25645,25680,25780,-385,-285,36248,"934,573.32",64188
,20130220,25680,25780,25705,25800,25400,25480,25610,-300,-170,32256,"826,134.62",61582
,20130221,25480,25610,25390,25400,24370,24775,24765,-835,-845,67060,"1,660,836.47",51362
,20130222,24775,24765,24735,24930,24660,24710,24825,-55,60,29570,"734,158.65",50836
,20130225,24710,24825,24710,24710,24300,24430,24490,-395,-335,28278,"692,631.65",49338
,20130226,24430,24490,24190,24390,24000,24035,24230,-455,-260,25378,"614,954.79",47496
,20130227,24035,24230,24065,24515,24065,24445,24355,215,125,35084,"854,509.03",50964
,20130228,24445,24355,24630,24810,24455,24665,24660,310,305,22746,"560,923.24",49648
,20130301,24665,24660,24400,24475,23670,23910,24110,-750,-550,27972,"674,438.30",45684
,20130304,23910,24110,24000,24085,23690,23830,23860,-280,-250,20964,"500,300.33",43974
,20130305,23830,23860,23995,24225,23985,24185,24130,325,270,17686,"426,821.64",40750
,20130306,24185,24130,24240,24300,23855,23990,24075,-140,-55,14792,"356,164.20",39568
,20130307,23990,24075,24050,24095,23780,23830,23905,-245,-170,12538,"299,770.21",38568
,20130308,23830,23905,24000,24000,23700,23985,23875,80,-30,10686,"255,160.11",38324
,20130311,23985,23875,24045,24120,23825,23845,23980,-30,105,11020,"264,260.75",37338
,20130312,23845,23980,23845,23885,23150,23150,23500,-830,-480,18528,"435,488.22",35180
,20130313,23150,23500,23155,23210,22720,22755,22990,-745,-510,17364,"399,252.01",32704
,20130314,22755,22990,22685,22685,22305,22510,22460,-480,-530,16922,"380,073.21",28890
,20130315,22510,22460,22610,22990,22375,22785,22640,325,180,13000,"294,333.99",26874
,20130318,22785,22640,22545,22545,21560,22035,22000,-605,-640,12576,"276,676.72",24660
,20130319,22035,22000,22215,22345,22090,22240,22215,240,215,5416,"120,329.01",24314
,20130320,22240,22215,21995,22575,21995,22495,22380,280,165,8192,"183,345.42",22696
,20130321,22495,22380,22600,22825,22505,22540,22670,160,290,5088,"115,353.97",22054
,20130322,22540,22670,22300,22610,22300,22390,22440,-280,-230,5592,"125,484.94",21420
,20130325,22390,22440,22485,22720,22395,22500,22560,60,120,4938,"111,405.67",21418
,20130326,22500,22560,22450,22525,22175,22400,22350,-160,-210,6028,"134,729.21",21010
,20130327,22400,22350,22495,22595,22260,22280,22390,-70,40,6592,"147,621.97",20608
,20130328,22280,22390,22215,22350,21700,21735,21945,-655,-445,9710,"213,126.43",20134
,20130329,21735,21945,21550,21850,21255,21720,21605,-225,-340,9572,"206,842.94",18602
,20130401,21720,21605,21650,21800,20925,20930,21270,-675,-335,6600,"140,410.38",17386
,20130402,20930,21270,20990,21175,20595,21060,20910,-210,-360,4116,"86,086.05",16928
,20130403,21060,20910,21000,21100,20715,20800,20915,-110,5,3180,"66,514.81",16442
,20130408,20800,20915,20640,21210,20400,21110,20890,195,-25,3042,"63,561.77",16528
,20130409,21110,20890,21430,21430,21035,21110,21220,220,330,2104,"44,656.40",16136
,20130410,21110,21220,21165,21405,21130,21220,21280,0,60,2008,"42,736.41",15768
,20130411,21220,21280,21325,21420,20935,20950,21225,-330,-55,1760,"37,361.58",15314
,20130412,20950,21225,20965,21030,20715,20815,20870,-410,-355,1664,"34,731.25",14772
,20130415,20815,20870,20470,20470,19825,19825,20035,-1045,-835,4150,"83,147.41",13360
,20130416,19825,20035,18660,19430,18540,19330,18985,-705,-1050,5082,"96,503.80",11680
,20130417,19330,18985,19525,19525,18600,18675,18970,-310,-15,2054,"38,970.88",11314
,20130418,18675,18970,18125,18530,18020,18175,18205,-795,-765,1694,"30,840.62",11020
,20130419,18175,18205,18420,18830,18260,18800,18595,595,390,1468,"27,301.98",10402
,20130422,18800,18595,18765,18800,18110,18110,18480,-485,-115,892,"16,487.65",10098
,20130423,18110,18480,18155,18400,17880,18140,18125,-340,-355,1048,"18,995.08",9680
,20130424,18140,18125,18350,18780,18215,18550,18425,425,300,1652,"30,443.02",8912
,20130425,18550,18425,18640,18840,18420,18700,18675,275,250,1378,"25,737.68",8390
,20130426,18700,18675,19250,19250,18585,18720,18895,45,220,1542,"29,137.16",7944
,20130502,18720,18895,18450,18675,18155,18675,18420,-220,-475,330,"6,079.17",7776
,20130503,18675,18420,18905,19340,18760,19340,19160,920,740,436,"8,355.90",7672
,20130506,19340,19160,19810,19945,19470,19520,19670,360,510,606,"11,920.19",7406
,20130507,19520,19670,19335,19850,19335,19410,19500,-260,-170,700,"13,652.96",7322
,20130508,19410,19500,19600,19920,19560,19880,19725,380,225,306,"6,036.48",7208
,20130509,19880,19725,20000,20050,19730,19830,19920,105,195,340,"6,773.57",7200
,20130510,19830,19920,20010,20375,19945,20350,20050,430,130,438,"8,783.64",6960
,20130513,20350,20050,20300,20420,20200,20200,20320,150,270,202,"4,104.96",6942
,20130514,20200,20320,20000,20080,19850,19900,19995,-420,-325,204,"4,079.73",6986
,20130515,19900,19995,20000,20000,19700,19700,19820,-295,-175,238,"4,717.77",6984
ru1306,20130104,26500,26365,26785,26785,26430,26430,26515,65,150,46,"1,219.83",630
,20130107,26430,26515,26280,26365,25925,25975,26190,-540,-325,366,"9,586.11",618
,20130108,25975,26190,26065,26150,26005,26150,26070,-40,-120,10,260.71,614
,20130109,26150,26070,26165,26165,25980,25980,26085,-90,15,62,"1,617.35",614
,20130110,25980,26085,26130,26130,26065,26065,26100,-20,15,10,261,616
,20130111,26065,26100,26400,26400,25730,25785,26030,-315,-70,22,572.69,608
,20130114,25785,26030,25710,25850,25555,25785,25635,-245,-395,76,"1,948.59",606
,20130115,25785,25635,25680,25680,25530,25640,25605,5,-30,20,512.19,610
,20130116,25640,25605,25390,25475,25115,25335,25375,-270,-230,184,"4,669.55",596
,20130117,25335,25375,25430,25430,25300,25410,25385,35,10,12,304.66,592
,20130118,25410,25385,25610,25775,25610,25770,25685,385,300,96,"2,466.00",598
,20130121,25770,25685,25665,25790,25540,25790,25630,105,-55,18,461.4,598
,20130122,25790,25630,25725,26000,25725,25900,25895,270,265,28,725.19,590
,20130123,25900,25895,26100,26100,25850,25875,25950,-20,55,28,726.73,592
,20130124,25875,25950,25800,25800,25400,25460,25560,-490,-390,12,306.73,590
,20130125,25460,25560,25600,25620,25430,25430,25570,-130,10,68,"1,738.76",602
,20130128,25430,25570,25085,25530,25085,25465,25405,-105,-165,54,"1,372.01",618
,20130129,25465,25405,25600,25800,25600,25800,25750,395,345,80,"2,060.25",578
,20130130,25800,25750,25960,26080,25960,26035,26020,285,270,36,936.72,576
,20130131,26035,26020,26130,26135,26015,26105,26065,85,45,18,469.18,572
,20130201,26105,26065,26000,26315,25970,26315,26055,250,-10,36,938.09,566
,20130204,26315,26055,26530,26750,26400,26590,26555,535,500,70,"1,858.99",566
,20130205,26590,26555,26555,26820,26475,26635,26670,80,115,184,"4,907.81",596
,20130206,26635,26670,26775,26815,26480,26590,26685,-80,15,102,"2,722.30",604
,20130207,26590,26685,26380,26560,26260,26405,26360,-280,-325,46,"1,212.68",590
,20130208,26405,26360,26550,26560,26420,26480,26505,120,145,14,371.08,594
,20130218,26480,26505,26435,26435,25800,25800,26180,-705,-325,74,"1,937.44",574
,20130219,25800,26180,25790,25840,25585,25705,25680,-475,-500,44,"1,130.08",568
,20130220,25705,25680,25815,25815,25420,25430,25495,-250,-185,26,662.88,570
,20130221,25430,25495,25270,25270,24430,24720,24690,-775,-805,62,"1,530.85",570
,20130222,24720,24690,24720,24720,24720,24720,24720,30,30,4,98.88,574
,20130225,24720,24720,24375,24585,24215,24455,24440,-265,-280,56,"1,368.74",584
,20130226,24455,24440,24355,24355,23985,23985,24205,-455,-235,96,"2,324.06",568
,20130227,23985,24205,24180,24470,24180,24445,24270,240,65,50,"1,213.72",560
,20130228,24445,24270,24045,24725,24035,24550,24515,280,245,30,735.47,554
,20130301,24550,24515,24225,24285,23640,23825,23895,-690,-620,120,"2,867.64",548
,20130304,23825,23895,23835,23840,23610,23750,23720,-145,-175,146,"3,463.83",504
,20130305,23750,23720,24050,24275,24050,24200,24145,480,425,88,"2,124.91",462
,20130306,24200,24145,24240,24280,23915,24040,24200,-105,55,32,774.46,460
,20130307,24040,24200,24200,24200,23630,23715,23805,-485,-395,158,"3,761.75",430
,20130308,23715,23805,23805,23920,23740,23920,23830,115,25,46,"1,096.39",434
,20130311,23920,23830,23970,24015,23845,23860,23900,30,70,28,669.23,422
,20130312,23860,23900,23755,23800,23220,23250,23585,-650,-315,278,"6,557.32",328
,20130313,23250,23585,23175,23200,22780,22780,23075,-805,-510,160,"3,692.50",296
,20130314,22780,23075,22390,22665,22390,22500,22490,-575,-585,272,"6,117.89",232
,20130315,22500,22490,22650,22925,22585,22795,22715,305,225,82,"1,862.79",224
,20130318,22795,22715,22395,22395,21965,22065,22090,-650,-625,122,"2,695.16",196
,20130319,22065,22090,22245,22380,22190,22245,22270,155,180,170,"3,786.01",210
,20130320,22245,22270,22085,22660,22085,22660,22370,390,100,152,"3,400.85",214
,20130321,22660,22370,22755,22860,22675,22790,22795,420,425,30,683.85,212
,20130322,22790,22795,22790,22790,22435,22670,22575,-125,-220,104,"2,347.94",204
,20130325,22670,22575,22685,22745,22520,22580,22595,5,20,34,768.23,182
,20130326,22580,22595,22500,22500,22330,22440,22405,-155,-190,8,179.24,180
,20130327,22440,22405,22350,22350,22350,22350,22350,-55,-55,2,44.7,180
,20130328,22350,22350,22290,22365,21840,21840,22215,-510,-135,240,"5,332.20",268
,20130329,21840,22215,21410,21845,21315,21840,21755,-375,-460,74,"1,609.95",294
,20130401,21840,21755,21755,21765,21050,21065,21340,-690,-415,42,896.46,300
,20130402,21065,21340,21060,21300,20785,20965,21160,-375,-180,46,973.5,308
,20130403,20965,21160,21160,21160,20790,20930,20990,-230,-170,20,419.89,308
,20130408,20930,20990,20840,21355,20765,21245,20985,255,-5,32,671.54,298
,20130409,21245,20985,21440,21600,21280,21345,21435,360,450,272,"5,831.29",274
,20130410,21345,21435,20960,21540,20960,21440,21410,5,-25,98,"2,098.58",246
,20130411,21440,21410,21460,21460,21180,21205,21375,-205,-35,14,299.25,244
,20130412,21205,21375,20990,20990,20990,20990,20990,-385,-385,4,83.96,244
,20130415,20990,20990,20305,20320,19940,19940,20200,-1050,-790,38,767.68,234
,20130416,19940,20200,18750,19345,18650,19340,19055,-860,-1145,112,"2,134.64",220
,20130417,19340,19055,19790,19790,18755,18850,18975,-205,-80,194,"3,682.03",278
,20130418,18850,18975,18050,18720,18025,18245,18355,-730,-620,78,"1,431.83",284
,20130419,18245,18355,18550,18965,18460,18965,18770,610,415,70,"1,314.07",268
,20130422,18965,18770,18795,18795,18215,18215,18470,-555,-300,48,886.63,264
,20130423,18215,18470,18470,18480,18020,18260,18195,-210,-275,90,"1,637.92",290
,20130424,18260,18195,18410,18790,18385,18605,18540,410,345,66,"1,223.71",292
,20130425,18605,18540,18545,18800,18540,18760,18645,220,105,94,"1,752.99",294
,20130426,18760,18645,18920,19180,18780,18780,19020,135,375,76,"1,445.82",252
,20130502,18780,19020,18280,18540,18280,18535,18475,-485,-545,36,665.13,248
,20130503,18535,18475,19075,19395,19050,19395,19155,920,680,56,"1,072.77",288
,20130506,19395,19155,19830,20325,19470,19470,19725,315,570,164,"3,235.06",290
,20130507,19470,19725,19360,19780,19360,19440,19610,-285,-115,156,"3,059.69",404
,20130508,19440,19610,19500,19920,19500,19920,19745,310,135,372,"7,345.45",636
,20130509,19920,19745,20010,20010,19700,19860,19845,115,100,102,"2,024.68",624
,20130510,19860,19845,19845,20385,19790,20300,20135,455,290,472,"9,504.04",852
,20130513,20300,20135,20135,20320,20025,20025,20165,-110,30,52,"1,048.83",854
,20130514,20025,20165,20020,20080,19800,19850,19875,-315,-290,56,"1,113.12",820
,20130515,19850,19875,19670,19670,19600,19600,19645,-275,-230,16,314.33,814
,20130516,19600,19645,19385,19600,19250,19400,19390,-245,-255,368,"7,137.08",1004
,20130517,19400,19390,19600,20100,19520,20045,19850,655,460,806,"15,999.87",1348
,20130520,20045,19850,19875,20150,19875,20000,19975,150,125,148,"2,956.49",1388
,20130521,20000,19975,20120,20155,19780,19920,20045,-55,70,738,"14,795.08",1854
,20130522,19920,20045,19850,20090,19750,20000,19865,-45,-180,244,"4,847.54",1870
,20130523,20000,19865,19600,19600,18870,18900,19035,-965,-830,324,"6,168.33",1784
,20130524,18900,19035,19075,19105,18785,18900,18970,-135,-65,692,"13,129.26",1356
,20130527,18900,18970,18565,18905,18565,18695,18790,-275,-180,314,"5,901.30",1382
,20130528,18695,18790,18815,18835,18550,18780,18730,-10,-60,66,"1,236.28",1420
,20130529,18780,18730,18880,18920,18450,18485,18840,-245,110,270,"5,088.09",1530
,20130530,18485,18840,18080,18360,18075,18360,18230,-480,-610,430,"7,840.94",1484
,20130531,18360,18230,18560,18675,18300,18320,18540,90,310,316,"5,859.19",1518
,20130603,18320,18540,18565,18595,18400,18495,18500,-45,-40,100,"1,850.00",1512
,20130604,18495,18500,18555,18740,18505,18615,18600,115,100,476,"8,854.92",1796
,20130605,18615,18600,18660,18735,18335,18335,18475,-265,-125,92,"1,699.97",1804
,20130606,18335,18475,18420,18420,17850,17850,17970,-625,-505,388,"6,972.45",1538
,20130607,17850,17970,17985,17985,17640,17760,17870,-210,-100,90,"1,608.40",1556
,20130613,17760,17870,17315,17350,17235,17350,17335,-520,-535,40,693.42,1570
,20130614,17350,17335,17305,17500,17305,17500,17385,165,50,16,278.16,1584
,20130617,17500,17385,17600,17740,17555,17600,17620,215,235,266,"4,687.45",1778
ru1307,20130104,26430,26435,26635,26635,26500,26500,26560,65,125,74,"1,965.45",120
,20130107,26500,26560,,,,26235,26235,-325,-325,0,0,120
,20130108,26235,26235,,,,26115,26115,-120,-120,0,0,120
,20130109,26115,26115,26180,26245,26105,26245,26175,130,60,6,157.06,120
,20130110,26245,26175,,,,26175,26175,0,0,0,0,120
,20130111,26175,26175,26380,26380,26245,26245,26290,70,115,12,315.48,124
,20130114,26245,26290,25730,25860,25505,25860,25670,-430,-620,30,770.16,122
,20130115,25860,25670,25635,25835,25460,25525,25590,-145,-80,10,255.93,124
,20130116,25525,25590,25320,25470,25260,25470,25400,-120,-190,18,457.24,130
,20130117,25470,25400,25395,25465,25395,25465,25440,65,40,6,152.65,130
,20130118,25465,25440,25825,25870,25805,25870,25830,430,390,6,155,132
,20130121,25870,25830,25660,25685,25660,25685,25670,-145,-160,4,102.69,132
,20130122,25685,25670,25970,25970,25910,25910,25930,240,260,8,207.46,132
,20130123,25910,25930,,,,25930,25930,0,0,0,0,132
,20130124,25930,25930,,,,25930,25930,0,0,0,0,132
,20130125,25930,25930,,,,25940,25940,10,10,0,0,132
,20130128,25940,25940,25515,25535,25500,25535,25525,-405,-415,22,561.6,142
,20130129,25535,25525,25620,25620,25620,25620,25620,95,95,12,307.44,130
,20130130,25620,25620,25880,26110,25880,26060,26040,440,420,18,468.72,136
,20130131,26060,26040,26105,26150,26105,26150,26130,110,90,10,261.33,134
,20130201,26150,26130,26080,26315,26080,26315,26215,185,85,10,262.19,134
,20130204,26315,26215,26730,26850,26545,26850,26760,635,545,20,535.23,136
,20130205,26850,26760,26840,27045,26795,26965,26910,205,150,30,807.36,128
,20130206,26965,26910,26930,26930,26930,26930,26930,20,20,2,53.86,130
,20130207,26930,26930,,,,26930,26930,0,0,0,0,130
,20130208,26930,26930,26780,26780,26780,26780,26780,-150,-150,8,214.24,134
,20130218,26780,26780,25950,26400,25855,26145,26130,-635,-650,14,365.84,126
,20130219,26145,26130,25935,25995,25935,25995,25965,-135,-165,4,103.86,128
,20130220,25995,25965,25835,25835,25640,25640,25785,-325,-180,26,670.42,134
,20130221,25640,25785,25170,25170,24595,24855,24770,-930,-1015,18,445.86,128
,20130222,24855,24770,24885,24885,24885,24885,24885,115,115,4,99.54,126
,20130225,24885,24885,24370,24585,24370,24435,24515,-450,-370,38,931.73,102
,20130226,24435,24515,24270,24320,24130,24130,24265,-385,-250,20,485.37,84
,20130227,24130,24265,24130,24195,24125,24195,24135,-70,-130,82,"1,979.20",88
,20130228,24195,24135,24705,24705,24440,24440,24570,305,435,4,98.29,88
,20130301,24440,24570,24065,24065,23495,23705,23840,-865,-730,14,333.79,90
,20130304,23705,23840,23870,23870,23615,23720,23700,-120,-140,12,284.44,82
,20130305,23720,23700,24080,24160,24080,24160,24120,460,420,18,434.2,90
,20130306,24160,24120,24000,24070,23740,24070,23930,-50,-190,22,526.5,88
,20130307,24070,23930,23995,23995,23860,23860,23915,-70,-15,16,382.69,80
,20130308,23860,23915,23810,24000,23700,23995,23820,80,-95,66,"1,572.19",80
,20130311,23995,23820,24100,24100,23965,24000,24030,180,210,26,624.83,72
,20130312,24000,24030,23565,23565,23350,23350,23465,-680,-565,6,140.81,66
,20130313,23350,23465,23150,23150,22800,22800,22820,-665,-645,108,"2,464.63",140
,20130314,22800,22820,22230,22590,22220,22590,22355,-230,-465,28,625.95,140
,20130315,22590,22355,22895,22905,22885,22905,22895,550,540,6,137.37,142
,20130318,22905,22895,22190,22190,21790,22100,22000,-795,-895,36,792.04,156
,20130319,22100,22000,22140,22210,22140,22210,22190,210,190,22,488.21,144
,20130320,22210,22190,22405,22650,22245,22650,22450,460,260,18,404.13,142
,20130321,22650,22450,22650,22950,22650,22800,22860,350,410,28,640.15,142
,20130322,22800,22860,22550,22700,22550,22700,22595,-160,-265,18,406.76,126
,20130325,22700,22595,22735,22810,22620,22660,22685,65,90,40,907.54,122
,20130326,22660,22685,22600,22600,22385,22480,22485,-205,-200,6,134.93,120
,20130327,22480,22485,22805,22805,22495,22495,22620,10,135,16,361.98,122
,20130328,22495,22620,22160,22160,21945,21945,22035,-675,-585,12,264.42,124
,20130329,21945,22035,21645,21990,21645,21990,21880,-45,-155,16,350.11,126
,20130401,21990,21880,21775,21995,21300,21300,21740,-580,-140,92,"2,000.14",158
,20130402,21300,21740,21260,21440,21055,21235,21310,-505,-430,160,"3,410.15",168
,20130403,21235,21310,21200,21480,21130,21205,21270,-105,-40,38,808.27,174
,20130408,21205,21270,21080,21500,20975,21395,21195,125,-75,84,"1,780.75",204
,20130409,21395,21195,21430,21595,21400,21470,21430,275,235,74,"1,585.96",186
,20130410,21470,21430,21560,21630,21505,21510,21565,80,135,38,819.53,190
,20130411,21510,21565,22375,22375,21650,21650,22010,85,445,4,88.05,190
,20130412,21650,22010,21300,21300,21070,21080,21150,-930,-860,14,296.12,194
,20130415,21080,21150,20300,20330,20090,20090,20225,-1060,-925,10,202.26,200
,20130416,20090,20225,19325,19765,19325,19765,19455,-460,-770,134,"2,607.56",242
,20130417,19765,19455,19650,19650,18935,19080,19200,-375,-255,54,"1,036.98",256
,20130418,19080,19200,18240,18560,18240,18450,18280,-750,-920,98,"1,791.78",202
,20130419,18450,18280,18685,19090,18685,18900,18895,620,615,40,755.81,178
,20130422,18900,18895,18770,18770,18295,18295,18360,-600,-535,26,477.36,196
,20130423,18295,18360,18450,18450,18220,18220,18390,-140,30,40,735.63,178
,20130424,18220,18390,18495,18800,18495,18800,18675,410,285,22,410.88,178
,20130425,18800,18675,18700,18755,18700,18755,18735,80,60,12,224.82,168
,20130426,18755,18735,19170,19245,18755,18815,19105,80,370,30,573.24,164
,20130502,18815,19105,18435,18625,18435,18625,18535,-480,-570,8,148.29,164
,20130503,18625,18535,19195,19460,19195,19460,19405,925,870,10,194.07,164
,20130506,19460,19405,20000,20000,19590,19800,19800,395,395,74,"1,465.20",202
,20130507,19800,19800,19605,19950,19500,19500,19690,-300,-110,138,"2,717.30",290
,20130508,19500,19690,19885,20100,19730,20100,19890,410,200,68,"1,352.68",300
,20130509,20100,19890,19985,20040,19845,19960,19970,70,80,36,719.05,304
,20130510,19960,19970,19975,20370,19975,20350,20265,380,295,54,"1,094.35",322
,20130513,20350,20265,20350,20410,20295,20360,20345,95,80,18,366.21,322
,20130514,20360,20345,20175,20225,19965,19970,20110,-375,-235,10,201.12,320
,20130515,19970,20110,19915,19915,19690,19690,19800,-420,-310,8,158.42,322
,20130516,19690,19800,19400,19600,19400,19600,19490,-200,-310,30,584.76,320
,20130517,19600,19490,19700,20270,19700,20200,20100,710,610,458,"9,207.07",608
,20130520,20200,20100,20100,20320,20050,20165,20180,65,80,292,"5,893.55",810
,20130521,20165,20180,20210,20305,19980,20085,20205,-95,25,346,"6,991.25",998
,20130522,20085,20205,20000,20250,19850,20150,20035,-55,-170,174,"3,486.09",1100
,20130523,20150,20035,19650,19650,19030,19070,19375,-965,-660,78,"1,511.58",1086
,20130524,19070,19375,19140,19230,18990,19125,19060,-250,-315,46,876.91,1074
,20130527,19125,19060,19105,19105,18880,18975,18970,-85,-90,484,"9,181.57",962
,20130528,18975,18970,19045,19095,18800,18940,18930,-30,-40,248,"4,695.64",858
,20130529,18940,18930,18930,19120,18450,18450,18955,-480,25,234,"4,436.03",924
,20130530,18450,18955,18385,18665,18260,18500,18490,-455,-465,462,"8,543.22",752
,20130531,18500,18490,18865,18945,18450,18530,18690,40,200,132,"2,467.67",748
,20130603,18530,18690,18595,18750,18590,18675,18690,-15,0,60,"1,121.40",790
,20130604,18675,18690,18850,18940,18725,18800,18820,110,130,402,"7,565.83",1036
,20130605,18800,18820,18880,18930,18500,18535,18825,-285,5,88,"1,657.02",1086
,20130606,18535,18825,18300,18405,17980,18050,18065,-775,-760,162,"2,927.14",1032
,20130607,18050,18065,18000,18080,17965,18080,18025,15,-40,114,"2,055.30",1016
,20130613,18080,18025,17420,17550,17355,17445,17425,-580,-600,58,"1,010.77",986
,20130614,17445,17425,17535,17645,17475,17585,17555,160,130,376,"6,601.64",1170
,20130617,17585,17555,17900,18000,17735,17800,17880,245,325,216,"3,862.47",1250
,20130618,17800,17880,17550,17850,17550,17800,17735,-80,-145,592,"10,499.23",1376
,20130619,17800,17735,17800,17950,17620,17950,17740,215,5,212,"3,761.21",1394
,20130620,17950,17740,17675,17720,17400,17450,17510,-290,-230,804,"14,078.91",932
,20130621,17450,17510,16820,17200,16820,17100,17020,-410,-490,140,"2,383.11",994
,20130624,17100,17020,17115,17115,16635,16710,16875,-310,-145,282,"4,759.80",986
,20130625,16710,16875,16660,17325,16600,17130,16735,255,-140,294,"4,920.41",1118
,20130626,17130,16735,17000,17035,16695,16820,16960,85,225,326,"5,528.99",1306
,20130627,16820,16960,16760,16880,16625,16695,16785,-265,-175,460,"7,721.11",1406
,20130628,16695,16785,16700,16785,16600,16610,16695,-175,-90,836,"13,957.27",1776
,20130701,16610,16695,16760,16875,16605,16860,16700,165,5,498,"8,318.66",1948
,20130702,16860,16700,17000,17075,16825,16940,16985,240,285,82,"1,392.98",1974
,20130703,16940,16985,17025,17025,16730,16920,16885,-65,-100,222,"3,748.90",1974
,20130704,16920,16885,16900,17005,16825,16980,16925,95,40,186,"3,148.16",2046
,20130705,16980,16925,16980,16980,16770,16770,16895,-155,-30,30,506.87,2048
,20130708,16770,16895,16595,16600,16275,16275,16420,-620,-475,690,"11,330.16",1580
,20130709,16275,16420,16260,16480,16200,16200,16335,-220,-85,236,"3,855.66",1590
,20130710,16200,16335,16000,16195,15925,16150,16020,-185,-315,352,"5,639.81",1382
,20130711,16150,16020,16450,16800,16350,16765,16600,745,580,98,"1,626.91",1440
,20130712,16765,16600,16610,16650,16320,16325,16475,-275,-125,214,"3,526.37",1600
,20130715,16325,16475,16210,16430,16100,16100,16200,-375,-275,894,"14,485.94",1814
ru1308,20130104,26580,26555,26820,26820,26680,26680,26750,125,195,4,107,252
,20130107,26680,26750,26590,26590,26590,26590,26590,-160,-160,2,53.18,252
,20130108,26590,26590,26380,26400,26110,26360,26345,-230,-245,18,474.26,248
,20130109,26360,26345,26280,26310,26140,26150,26200,-195,-145,34,890.82,244
,20130110,26150,26200,26375,26380,26360,26360,26370,160,170,6,158.23,244
,20130111,26360,26370,26750,26855,25965,25965,26360,-405,-10,22,580.01,244
,20130114,25965,26360,25800,26060,25650,25980,25910,-380,-450,210,"5,441.83",180
,20130115,25980,25910,25850,25895,25580,25580,25745,-330,-165,16,411.97,180
,20130116,25580,25745,25570,25570,25370,25520,25460,-225,-285,34,865.8,168
,20130117,25520,25460,25590,25590,25430,25580,25560,120,100,18,460.16,152
,20130118,25580,25560,25980,25980,25930,25930,25970,370,410,12,311.66,162
,20130121,25930,25970,25850,25945,25700,25780,25810,-190,-160,46,"1,187.46",146
,20130122,25780,25810,25930,26295,25930,26120,26175,310,365,114,"2,984.23",170
,20130123,26120,26175,26200,26200,26000,26030,26020,-145,-155,50,"1,301.15",130
,20130124,26030,26020,25980,25980,25585,25710,25680,-310,-340,22,564.97,128
,20130125,25710,25680,25770,25770,25770,25770,25770,90,90,2,51.54,128
,20130128,25770,25770,25550,25550,25500,25500,25510,-270,-260,10,255.1,128
,20130129,25500,25510,,,,25600,25600,90,90,0,0,128
,20130130,25600,25600,,,,26015,26015,415,415,0,0,128
,20130131,26015,26015,26180,26320,26180,26320,26260,305,245,22,577.81,134
,20130201,26320,26260,26160,26375,26160,26375,26250,115,-10,6,157.51,132
,20130204,26375,26250,26730,27000,26665,26970,26835,720,585,26,697.74,128
,20130205,26970,26835,26870,27265,26870,27115,27155,280,320,56,"1,520.93",150
,20130206,27115,27155,27245,27275,26940,26940,27135,-215,-20,36,976.95,128
,20130207,26940,27135,26700,26940,26700,26800,26800,-335,-335,30,804.02,128
,20130208,26800,26800,26965,26965,26965,26965,26965,165,165,4,107.86,130
,20130218,26965,26965,26400,26400,26395,26395,26395,-570,-570,6,158.38,128
,20130219,26395,26395,25960,26100,25855,25855,26020,-540,-375,38,988.79,138
,20130220,25855,26020,26050,26050,25545,25550,25775,-470,-245,704,"18,148.71",602
,20130221,25550,25775,25380,25385,24515,24900,24810,-875,-965,366,"9,081.75",314
,20130222,24900,24810,24900,25035,24850,24850,24995,40,185,146,"3,649.34",428
,20130225,24850,24995,24700,24700,24400,24475,24420,-520,-575,232,"5,665.91",606
,20130226,24475,24420,24265,24355,24080,24080,24280,-340,-140,40,971.2,606
,20130227,24080,24280,24155,24340,24155,24335,24295,55,15,28,680.34,606
,20130228,24335,24295,24560,24560,24365,24495,24500,200,205,46,"1,127.01",602
,20130301,24495,24500,24150,24220,23750,23905,24145,-595,-355,708,"17,095.79",320
,20130304,23905,24145,24030,24035,23650,23855,23865,-290,-280,70,"1,670.88",314
,20130305,23855,23865,24020,24305,24020,24280,24190,415,325,46,"1,112.80",294
,20130306,24280,24190,24285,24375,23960,24000,24065,-190,-125,370,"8,904.99",334
,20130307,24000,24065,24210,24210,23665,23750,23880,-315,-185,298,"7,116.69",516
,20130308,23750,23880,23805,24140,23690,23980,23865,100,-15,384,"9,166.00",464
,20130311,23980,23865,24160,24160,23855,23855,23950,-10,85,328,"7,856.03",640
,20130312,23855,23950,23865,23865,23070,23070,23325,-880,-625,344,"8,024.85",600
,20130313,23070,23325,23000,23100,22700,22700,22845,-625,-480,1298,"29,656.17",418
,20130314,22700,22845,22385,22590,22385,22550,22460,-295,-385,26,584.06,412
,20130315,22550,22460,22835,23020,22650,22925,22790,465,330,58,"1,322.00",418
,20130318,22925,22790,22440,22440,21820,22135,22160,-655,-630,430,"9,530.02",412
,20130319,22135,22160,22240,22405,22225,22300,22300,140,140,10,223,408
,20130320,22300,22300,22500,22695,22500,22695,22605,395,305,8,180.87,404
,20130321,22695,22605,22805,23055,22805,22900,22895,295,290,30,686.96,410
,20130322,22900,22895,22550,22870,22550,22870,22720,-25,-175,58,"1,318.04",388
,20130325,22870,22720,22875,23055,22755,22855,22935,135,215,42,963.28,378
,20130326,22855,22935,22590,22950,22440,22655,22675,-280,-260,36,816.37,376
,20130327,22655,22675,22670,22800,22465,22520,22565,-155,-110,176,"3,971.72",384
,20130328,22520,22565,22445,22700,22010,22060,22385,-505,-180,270,"6,044.14",394
,20130329,22060,22385,21725,22110,21725,22085,22005,-300,-380,136,"2,992.93",384
,20130401,22085,22005,21970,21975,21400,21400,21765,-605,-240,254,"5,528.45",376
,20130402,21400,21765,21450,21530,21120,21240,21430,-525,-335,198,"4,243.91",418
,20130403,21240,21430,21315,21530,21200,21200,21390,-230,-40,96,"2,053.81",422
,20130408,21200,21390,21070,21685,21000,21580,21300,190,-90,776,"16,530.14",666
,20130409,21580,21300,21700,21765,21455,21455,21615,155,315,162,"3,502.24",596
,20130410,21455,21615,21650,21825,21600,21665,21715,50,100,178,"3,865.32",626
,20130411,21665,21715,21695,21755,21340,21400,21445,-315,-270,128,"2,745.09",546
,20130412,21400,21445,21300,21420,21270,21270,21355,-175,-90,26,555.33,534
,20130415,21270,21355,20535,20630,20330,20335,20480,-1020,-875,130,"2,662.94",532
,20130416,20335,20480,19455,19885,19455,19780,19590,-700,-890,48,940.41,526
,20130417,19780,19590,19590,19675,19030,19110,19125,-480,-465,126,"2,410.19",548
,20130418,19110,19125,18280,18950,18165,18635,18530,-490,-595,268,"4,967.01",640
,20130419,18635,18530,18890,19190,18625,19075,18990,545,460,370,"7,027.14",600
,20130422,19075,18990,19060,19145,18440,18440,18985,-550,-5,648,"12,305.01",600
,20130423,18440,18985,18075,18750,18075,18140,18455,-845,-530,78,"1,439.71",588
,20130424,18140,18455,18460,18925,18425,18925,18610,470,155,122,"2,270.80",570
,20130425,18925,18610,19000,19165,18845,19165,18945,555,335,80,"1,515.65",564
,20130426,19165,18945,19450,19460,18900,19030,19215,85,270,376,"7,224.92",466
,20130502,19030,19215,18335,19110,18335,19110,18695,-105,-520,330,"6,170.75",436
,20130503,19110,18695,19105,19625,19105,19625,19455,930,760,52,"1,011.81",422
,20130506,19625,19455,20215,20215,19790,19790,19925,335,470,100,"1,992.97",440
,20130507,19790,19925,19735,20730,19685,19815,19990,-110,65,82,"1,639.31",442
,20130508,19815,19990,19815,20300,19815,20300,20135,310,145,68,"1,369.30",454
,20130509,20300,20135,20290,20300,19935,20060,20155,-75,20,106,"2,136.59",480
,20130510,20060,20155,20220,20720,20190,20660,20385,505,230,340,"6,931.86",496
,20130513,20660,20385,20490,20640,20445,20600,20535,215,150,72,"1,478.53",444
,20130514,20600,20535,20430,20430,20080,20080,20215,-455,-320,42,849.2,454
,20130515,20080,20215,20130,20150,19675,19675,20065,-540,-150,58,"1,163.89",458
,20130516,19675,20065,19780,19930,19690,19880,19770,-185,-295,22,435.01,468
,20130517,19880,19770,19875,20450,19875,20380,20310,610,540,100,"2,031.19",516
,20130520,20380,20310,20360,20500,20250,20275,20340,-35,30,506,"10,293.53",878
,20130521,20275,20340,20505,20550,20105,20250,20350,-90,10,452,"9,199.82",1184
,20130522,20250,20350,20200,20385,19980,20310,20160,-40,-190,246,"4,960.16",1282
,20130523,20310,20160,19870,19870,19150,19150,19455,-1010,-705,260,"5,058.52",1400
,20130524,19150,19455,19300,19420,19060,19230,19235,-225,-220,334,"6,424.54",1380
,20130527,19230,19235,18900,19200,18790,18990,19050,-245,-185,988,"18,822.85",1306
,20130528,18990,19050,19135,19185,18815,19040,18995,-10,-55,276,"5,243.10",1144
,20130529,19040,18995,19035,19255,18530,18530,19140,-465,145,352,"6,738.11",1156
,20130530,18530,19140,18410,18795,18395,18735,18585,-405,-555,878,"16,321.63",922
,20130531,18735,18585,19000,19025,18570,18585,18770,0,185,224,"4,204.54",902
,20130603,18585,18770,18515,18920,18515,18775,18755,5,-15,974,"18,268.83",888
,20130604,18775,18755,18950,19080,18885,18960,18935,205,180,324,"6,136.13",1064
,20130605,18960,18935,19030,19080,18630,18700,18750,-235,-185,66,"1,237.76",1062
,20130606,18700,18750,18500,18575,18100,18150,18155,-600,-595,472,"8,571.06",880
,20130607,18150,18155,18200,18250,18105,18225,18190,70,35,346,"6,294.98",912
,20130613,18225,18190,17845,17845,17500,17620,17540,-570,-650,170,"2,982.46",888
,20130614,17620,17540,17780,17820,17635,17805,17740,265,200,238,"4,222.20",938
,20130617,17805,17740,18030,18170,17950,17950,18065,210,325,108,"1,951.48",942
,20130618,17950,18065,18000,18015,17760,18010,17930,-55,-135,222,"3,980.64",1018
,20130619,18010,17930,17955,18130,17800,18130,17950,200,20,114,"2,046.82",1032
,20130620,18130,17950,17815,17875,17545,17600,17650,-350,-300,320,"5,648.90",848
,20130621,17600,17650,17110,17345,16995,17270,17205,-380,-445,214,"3,682.85",894
,20130624,17270,17205,17280,17280,16715,16800,16795,-405,-410,1244,"20,895.17",822
,20130625,16800,16795,16900,17325,16700,17235,16980,440,185,362,"6,146.93",926
,20130626,17235,16980,17310,17310,16750,16750,17110,-230,130,606,"10,368.67",1366
,20130627,16750,17110,16945,17085,16760,16870,16955,-240,-155,596,"10,106.44",1826
,20130628,16870,16955,16785,16995,16785,16820,16900,-135,-55,748,"12,642.72",2474
,20130701,16820,16900,16875,17050,16810,17050,16930,150,30,238,"4,029.74",2580
,20130702,17050,16930,17150,17245,17005,17065,17155,135,225,414,"7,103.94",2684
,20130703,17065,17155,17175,17175,16880,17075,17060,-80,-95,258,"4,401.93",2622
,20130704,17075,17060,16945,17180,16945,17175,17105,115,45,150,"2,566.13",2582
,20130705,17175,17105,17050,17080,16910,16930,16995,-175,-110,116,"1,971.57",2588
,20130708,16930,16995,16900,16900,16355,16365,16650,-630,-345,1154,"19,215.23",1670
,20130709,16365,16650,16365,16690,16350,16350,16445,-300,-205,556,"9,144.52",1584
,20130710,16350,16445,16200,16300,16110,16300,16190,-145,-255,810,"13,114.13",1064
,20130711,16300,16190,16450,16995,16445,16910,16650,720,460,170,"2,830.91",1032
,20130712,16910,16650,16800,16830,16420,16420,16775,-230,125,356,"5,971.95",1172
,20130715,16420,16775,16480,16550,16285,16325,16375,-450,-400,982,"16,084.72",1956
,20130716,16325,16375,16400,16555,16215,16555,16375,180,0,760,"12,448.45",2276
,20130717,16555,16375,16580,17125,16510,17070,16710,695,335,494,"8,256.20",2282
,20130718,17070,16710,17020,17150,16915,17100,17025,390,315,138,"2,350.06",2230
,20130719,17100,17025,17435,17650,17340,17340,17475,315,450,224,"3,915.31",2204
,20130722,17340,17475,17420,17500,17405,17500,17430,25,-45,288,"5,020.09",2220
,20130723,17500,17430,17380,17550,17260,17260,17395,-170,-35,494,"8,593.41",2288
,20130724,17260,17395,17200,17420,17020,17420,17155,25,-240,278,"4,770.05",2094
,20130725,17420,17155,17300,17530,17300,17430,17380,275,225,978,"17,000.73",1682
,20130726,17430,17380,17410,17465,16985,17010,17305,-370,-75,560,"9,691.47",1432
,20130729,17010,17305,17270,17270,16455,16520,16670,-785,-635,140,"2,334.05",1388
,20130730,16520,16670,16615,16615,16500,16545,16550,-125,-120,146,"2,416.48",1272
,20130731,16545,16550,16405,16750,16405,16750,16595,200,45,680,"11,285.96",1766
,20130801,16750,16595,16850,16970,16715,16875,16880,280,285,442,"7,462.42",1588
,20130802,16875,16880,17000,17005,16800,16800,16980,-80,100,24,407.62,1574
,20130805,16800,16980,17115,17115,17100,17105,17100,125,120,36,615.74,1578
,20130806,17105,17100,17080,17200,17080,17200,17155,100,55,20,343.18,1558
,20130807,17200,17155,17155,17200,17095,17095,17125,-60,-30,38,650.88,1542
,20130808,17095,17125,17360,17945,17360,17820,17670,695,545,78,"1,378.56",1566
,20130809,17820,17670,18085,18085,18085,18085,18085,415,415,10,180.85,1576
,20130812,18085,18085,18880,18880,17525,18340,18210,255,125,164,"2,986.55",1526
,20130813,18340,18210,,,,18210,18210,0,0,0,0,1526
,20130814,18210,18210,18300,18440,18050,18230,18290,20,80,434,"7,938.90",1522
,20130815,18230,18290,18300,18300,18050,18060,18185,-230,-105,74,"1,346.00",1456
ru1309,20130104,26620,26565,26725,26860,26550,26580,26690,15,125,20426,"545,183.10",21766
,20130107,26580,26690,26560,26770,26290,26345,26540,-345,-150,26408,"700,934.61",23572
,20130108,26345,26540,26390,26530,26150,26435,26375,-105,-165,26278,"693,116.18",25094
,20130109,26435,26375,26500,26535,26225,26265,26355,-110,-20,19834,"522,818.74",25274
,20130110,26265,26355,26420,26550,26310,26495,26430,140,75,20132,"532,183.82",26518
,20130111,26495,26430,26685,26815,25800,25800,26325,-630,-105,36904,"971,599.36",27882
,20130114,25800,26325,25840,26150,25615,25920,25855,-405,-470,36384,"940,867.46",27764
,20130115,25920,25855,25950,26050,25565,25570,25845,-285,-10,36606,"946,245.54",29314
,20130116,25570,25845,25585,25715,25330,25575,25535,-270,-310,33708,"860,884.81",29876
,20130117,25575,25535,25650,25745,25450,25635,25610,100,75,29454,"754,352.02",31300
,20130118,25635,25610,25895,26015,25810,25990,25925,380,315,29836,"773,611.90",31254
,20130121,25990,25925,25925,25955,25780,25805,25870,-120,-55,21742,"562,520.78",31938
,20130122,25805,25870,25860,26215,25840,26180,26110,310,240,30436,"794,710.80",32650
,20130123,26180,26110,26230,26250,25980,26140,26110,30,0,20682,"540,101.95",32616
,20130124,26140,26110,26110,26110,25660,25755,25810,-355,-300,34478,"889,882.50",33088
,20130125,25755,25810,25860,25940,25710,25710,25830,-100,20,18126,"468,256.88",33970
,20130128,25710,25830,25650,25790,25550,25740,25690,-90,-140,25566,"656,794.26",35038
,20130129,25740,25690,25695,26050,25655,26015,25915,325,225,29774,"771,634.77",35746
,20130130,26015,25915,26065,26340,26065,26295,26225,380,310,27718,"727,038.74",35820
,20130131,26295,26225,26325,26445,26220,26390,26360,165,135,27910,"735,802.33",37698
,20130201,26390,26360,26360,26560,26170,26540,26365,180,5,35882,"946,183.78",38672
,20130204,26540,26365,26900,27265,26680,27125,26955,760,590,56672,"1,527,782.07",39392
,20130205,27125,26955,26900,27560,26830,27260,27225,305,270,100226,"2,728,786.66",53312
,20130206,27260,27225,27360,27540,26985,27075,27275,-150,50,126696,"3,455,908.23",61192
,20130207,27075,27275,27120,27145,26705,27030,26940,-245,-335,128644,"3,465,954.29",62300
,20130208,27030,26940,26885,27225,26705,26720,27045,-220,105,143146,"3,871,507.49",64894
,20130218,26720,27045,26580,26650,26195,26215,26430,-830,-615,152056,"4,019,413.34",80046
,20130219,26215,26430,26060,26280,25980,26090,26135,-340,-295,191986,"5,017,611.70",96558
,20130220,26090,26135,26160,26230,25765,25805,25990,-330,-145,209598,"5,448,155.52",109388
,20130221,25805,25990,25685,25700,24725,25085,25100,-905,-890,343394,"8,620,305.43",99270
,20130222,25085,25100,25075,25280,24985,25035,25165,-65,65,186748,"4,700,234.39",98326
,20130225,25035,25165,24995,25010,24510,24650,24735,-515,-430,256940,"6,356,280.31",108156
,20130226,24650,24735,24440,24630,24100,24155,24435,-580,-300,252498,"6,170,880.32",112292
,20130227,24155,24435,24285,24630,24250,24515,24480,80,45,311510,"7,626,158.58",117840
,20130228,24515,24480,24745,24855,24475,24710,24690,230,210,259924,"6,418,514.44",120042
,20130301,24710,24690,24505,24520,23555,23965,24035,-725,-655,425134,"10,219,025.28",123866
,20130304,23965,24035,24050,24115,23720,23935,23900,-100,-135,348126,"8,320,357.30",129884
,20130305,23935,23900,24095,24390,24090,24300,24270,400,370,278576,"6,761,918.74",127848
,20130306,24300,24270,24380,24450,23955,24120,24190,-150,-80,370996,"8,975,629.20",130938
,20130307,24120,24190,24205,24245,23850,23920,24030,-270,-160,296710,"7,131,083.59",138024
,20130308,23920,24030,24095,24185,23785,24150,24010,120,-20,352030,"8,453,654.52",138058
,20130311,24150,24010,24220,24335,23965,23995,24170,-15,160,274152,"6,627,528.49",136862
,20130312,23995,24170,24045,24070,23220,23240,23585,-930,-585,506842,"11,954,579.65",164466
,20130313,23240,23585,23315,23380,22805,22840,23110,-745,-475,437574,"10,113,713.12",169394
,20130314,22840,23110,22680,22825,22405,22785,22625,-325,-485,403176,"9,121,862.36",155070
,20130315,22785,22625,22980,23320,22650,23110,22950,485,325,419124,"9,619,944.62",148488
,20130318,23110,22950,22750,22810,21800,22260,22285,-690,-665,412414,"9,191,255.73",139054
,20130319,22260,22285,22420,22620,22310,22470,22455,185,170,326124,"7,323,532.29",130436
,20130320,22470,22455,22355,22905,22290,22810,22670,355,215,360900,"8,182,732.62",131942
,20130321,22810,22670,22900,23225,22860,22900,23020,230,350,343186,"7,901,005.06",134810
,20130322,22900,23020,22710,23020,22645,22805,22830,-215,-190,297654,"6,796,432.38",131094
,20130325,22805,22830,23000,23180,22810,22910,22975,80,145,290840,"6,683,281.41",139256
,20130326,22910,22975,22835,22945,22530,22760,22730,-215,-245,300848,"6,838,353.45",137456
,20130327,22760,22730,22910,22980,22580,22640,22770,-90,40,291176,"6,630,940.62",144792
,20130328,22640,22770,22680,22740,22030,22100,22300,-670,-470,400384,"8,928,884.59",161140
,20130329,22100,22300,21900,22275,21645,22165,22025,-135,-275,427478,"9,415,965.07",142584
,20130401,22165,22025,22050,22190,21425,21460,21740,-565,-285,380876,"8,282,057.59",154694
,20130402,21460,21740,21500,21695,21080,21585,21425,-155,-315,515132,"11,037,978.87",158952
,20130403,21585,21425,21550,21675,21300,21340,21460,-85,35,470886,"10,107,449.61",158804
,20130408,21340,21460,20990,21815,20950,21735,21485,275,25,514648,"11,059,760.53",176706
,20130409,21735,21485,21885,21950,21600,21685,21775,200,290,483768,"10,535,415.84",187340
,20130410,21685,21775,21730,22030,21690,21820,21865,45,90,498034,"10,889,517.04",184588
,20130411,21820,21865,21800,22010,21430,21460,21755,-405,-110,510256,"11,101,232.50",189584
,20130412,21460,21755,21500,21595,21250,21350,21430,-405,-325,505258,"10,829,492.62",197066
,20130415,21350,21430,20920,20945,20355,20355,20560,-1075,-870,267152,"5,492,722.77",204322
,20130416,20355,20560,19500,20060,19260,19915,19730,-645,-830,624276,"12,318,019.25",170206
,20130417,19915,19730,20020,20140,19150,19230,19555,-500,-175,749946,"14,667,495.81",194110
,20130418,19230,19555,18605,19130,18575,18725,18780,-830,-775,571112,"10,726,477.83",176716
,20130419,18725,18780,19075,19350,18740,19325,19030,545,250,716216,"13,632,221.02",160410
,20130422,19325,19030,19320,19340,18580,18615,18960,-415,-70,541130,"10,261,576.58",171022
,20130423,18615,18960,18715,18890,18210,18465,18570,-495,-390,741400,"13,769,727.85",177240
,20130424,18465,18570,18615,19285,18540,18965,18785,395,215,645096,"12,121,052.51",168216
,20130425,18965,18785,19080,19315,18815,19135,19065,350,280,576936,"11,000,923.23",160612
,20130426,19135,19065,19500,19625,18835,19080,19280,15,215,592562,"11,427,254.91",148460
,20130502,19080,19280,18495,19120,18410,19120,18785,-160,-495,447302,"8,404,171.63",156842
,20130503,19120,18785,19250,19720,19165,19720,19480,935,695,407512,"7,939,484.03",153456
,20130506,19720,19480,20500,20650,19880,19950,20090,470,610,696226,"13,989,726.29",160672
,20130507,19950,20090,19880,20400,19760,19825,20005,-265,-85,754232,"15,089,168.68",164088
,20130508,19825,20005,19885,20535,19850,20505,20190,500,185,821318,"16,584,080.67",165612
,20130509,20505,20190,20700,20720,20105,20335,20315,145,125,654148,"13,291,643.40",158850
,20130510,20335,20315,20455,20920,20280,20875,20590,560,275,820268,"16,890,224.97",167482
,20130513,20875,20590,20800,20840,20510,20515,20675,-75,85,693014,"14,329,933.97",162762
,20130514,20515,20675,20530,20680,20170,20275,20360,-400,-315,699920,"14,253,520.60",164258
,20130515,20275,20360,20275,20410,19815,19875,20160,-485,-200,644238,"12,990,924.64",154670
,20130516,19875,20160,19880,20150,19675,19975,19930,-185,-230,691520,"13,784,411.72",155422
,20130517,19975,19930,20000,20665,19970,20595,20265,665,335,719142,"14,576,527.69",155528
,20130520,20595,20265,20565,20720,20410,20510,20530,245,265,580754,"11,922,897.88",157676
,20130521,20510,20530,20700,20750,20280,20485,20490,-45,-40,642760,"13,173,234.01",166238
,20130522,20485,20490,20400,20650,20160,20460,20415,-30,-75,692732,"14,143,922.97",165560
,20130523,20460,20415,20200,20210,19390,19390,19770,-1025,-645,730354,"14,440,943.96",179766
,20130524,19390,19770,19500,19615,19205,19360,19445,-410,-325,800176,"15,560,063.79",173190
,20130527,19360,19445,19200,19450,18980,19115,19220,-330,-225,668452,"12,849,918.86",186832
,20130528,19115,19220,19220,19320,18925,19155,19150,-65,-70,701956,"13,444,210.70",189278
,20130529,19155,19150,19100,19475,18705,18780,19200,-370,50,728910,"13,996,046.62",199680
,20130530,18780,19200,18530,18945,18500,18835,18760,-365,-440,778494,"14,604,822.32",189636
,20130531,18835,18760,19020,19185,18670,18740,18930,-20,170,733430,"13,885,340.23",189792
,20130603,18740,18930,18865,19080,18730,18955,18900,25,-30,627398,"11,860,055.62",188868
,20130604,18955,18900,18985,19270,18940,19155,19110,255,210,650098,"12,424,096.87",184460
,20130605,19155,19110,19200,19290,18760,18820,18990,-290,-120,727408,"13,814,455.70",204002
,20130606,18820,18990,18725,18805,18180,18240,18530,-750,-460,731820,"13,561,221.10",210936
,20130607,18240,18530,18325,18435,18175,18330,18310,-200,-220,566258,"10,370,523.01",191318
,20130613,18330,18310,17800,18080,17560,17750,17765,-560,-545,497004,"8,830,877.84",202376
,20130614,17750,17765,17900,18045,17745,17960,17910,195,145,472412,"8,461,649.80",201786
,20130617,17960,17910,17960,18370,17960,18110,18170,200,260,505230,"9,181,964.50",203376
,20130618,18110,18170,18130,18215,17850,18190,18095,20,-75,566078,"10,245,515.32",200474
,20130619,18190,18095,18250,18310,17915,18300,18115,205,20,512684,"9,287,960.58",189856
,20130620,18300,18115,18050,18115,17695,17765,17885,-350,-230,492408,"8,807,483.41",184802
,20130621,17765,17885,17415,17550,17000,17500,17350,-385,-535,495212,"8,592,806.20",158588
,20130624,17500,17350,17490,17525,16900,16905,17175,-445,-175,426120,"7,319,232.23",167578
,20130625,16905,17175,17000,17505,16835,17375,17115,200,-60,434486,"7,437,066.29",139076
,20130626,17375,17115,17500,17545,16920,16940,17165,-175,50,286990,"4,927,181.64",139118
,20130627,16940,17165,17065,17275,16825,17050,17065,-115,-100,242076,"4,131,991.30",127220
,20130628,17050,17065,16900,17190,16830,17005,17065,-60,0,176050,"3,004,302.51",121160
,20130701,17005,17065,16980,17285,16910,17275,17115,210,50,129356,"2,214,229.01",112012
,20130702,17275,17115,17380,17475,17205,17305,17330,190,215,101862,"1,765,724.87",108072
,20130703,17305,17330,17380,17425,17070,17205,17260,-125,-70,98474,"1,699,816.14",103412
,20130704,17205,17260,17265,17415,17115,17345,17295,85,35,91498,"1,582,470.13",98274
,20130705,17345,17295,17345,17390,17110,17120,17240,-175,-55,53130,"916,212.62",96764
,20130708,17120,17240,17150,17155,16470,16520,16780,-720,-460,73166,"1,227,737.52",98428
,20130709,16520,16780,16545,16710,16395,16420,16605,-360,-175,62888,"1,044,362.15",95904
,20130710,16420,16605,16370,16495,16155,16415,16345,-190,-260,75264,"1,230,407.56",91348
,20130711,16415,16345,16605,17160,16600,17125,16890,780,545,89950,"1,519,431.76",84774
,20130712,17125,16890,16980,17090,16580,16585,16870,-305,-20,67270,"1,135,081.95",79328
,20130715,16585,16870,16510,16820,16445,16525,16605,-345,-265,62474,"1,037,634.76",77576
,20130716,16525,16605,16505,16725,16400,16720,16550,115,-55,52032,"861,256.18",75794
,20130717,16720,16550,16775,17370,16685,17250,17125,700,575,96978,"1,661,025.11",68100
,20130718,17250,17125,17170,17450,17085,17360,17225,235,100,60104,"1,035,503.77",65174
,20130719,17360,17225,17600,17780,17405,17490,17615,265,390,59656,"1,051,080.11",58944
,20130722,17490,17615,17670,17750,17460,17690,17615,75,0,43644,"768,841.63",56254
,20130723,17690,17615,17615,17725,17450,17505,17585,-110,-30,36186,"636,352.99",54476
,20130724,17505,17585,17550,17610,17150,17585,17410,0,-175,49756,"866,268.84",52644
,20130725,17585,17410,17500,17625,17400,17550,17510,140,100,45704,"800,313.90",52256
,20130726,17550,17510,17580,17630,17015,17095,17300,-415,-210,39002,"674,857.62",49760
,20130729,17095,17300,16880,16880,16615,16670,16735,-630,-565,42676,"714,314.18",42466
,20130730,16670,16735,16700,16805,16615,16645,16700,-90,-35,35028,"585,128.71",38850
,20130731,16645,16700,16565,16915,16500,16865,16745,165,45,39466,"660,971.83",35944
,20130801,16865,16745,17100,17120,16855,17050,16995,305,250,30106,"511,700.37",34130
,20130802,17050,16995,17150,17265,16910,17015,17080,20,85,20968,"358,221.77",32356
,20130805,17015,17080,16925,17270,16860,17210,17145,130,65,18208,"312,194.96",30854
,20130806,17210,17145,17160,17425,17090,17395,17260,250,115,18656,"322,095.36",28388
,20130807,17395,17260,17245,17485,17230,17295,17340,35,80,14504,"251,513.26",27050
,20130808,17295,17340,17420,18150,17420,18010,17840,670,500,18932,"337,757.67",23420
,20130809,18010,17840,18105,18320,18035,18225,18190,385,350,11778,"214,266.43",21894
,20130812,18225,18190,18230,18610,18225,18525,18375,335,185,11330,"208,230.74",19784
,20130813,18525,18375,18465,18680,18435,18585,18545,210,170,8402,"155,817.19",18448
,20130814,18585,18545,18450,18650,18300,18330,18440,-215,-105,6844,"126,219.79",17594
,20130815,18330,18440,18380,18540,18185,18265,18335,-175,-105,6272,"115,013.35",16616
,20130816,18265,18335,18335,18730,18250,18485,18435,150,100,8876,"163,651.38",14936
,20130819,18485,18435,18600,18690,18400,18540,18550,105,115,5170,"95,923.21",13402
,20130820,18540,18550,18450,18630,18150,18260,18445,-290,-105,5160,"95,201.69",12142
,20130821,18260,18445,18360,18390,18190,18280,18275,-165,-170,2458,"44,927.09",12004
,20130822,18280,18275,18200,18630,18090,18490,18430,215,155,3644,"67,175.10",11318
,20130823,18490,18430,18600,18870,18490,18865,18695,435,265,4032,"75,382.33",10228
,20130826,18865,18695,19010,19395,19010,19385,19220,690,525,4960,"95,337.14",8992
,20130827,19385,19220,19285,19315,18935,19270,19175,50,-45,2128,"40,809.35",8342
,20130828,19270,19175,19175,19500,18885,18890,19280,-285,105,2752,"53,067.85",7610
,20130829,18890,19280,19060,19060,18620,18780,18845,-500,-435,1626,"30,648.45",7276
,20130830,18780,18845,18665,18830,18365,18525,18690,-320,-155,3356,"62,734.34",6152
,20130902,18525,18690,18915,19500,18655,19475,19155,785,465,1714,"32,839.47",5788
,20130903,19475,19155,19660,19675,19290,19500,19465,345,310,630,"12,263.05",5754
,20130904,19500,19465,19495,19495,19005,19080,19245,-385,-220,622,"11,972.50",5550
,20130905,19080,19245,19065,19250,18845,19110,19070,-135,-175,550,"10,488.81",5572
,20130906,19110,19070,19135,19260,19000,19160,19105,90,35,258,"4,930.29",5508
,20130909,19160,19105,19305,19330,19050,19160,19200,55,95,344,"6,606.25",5420
,20130910,19160,19200,18950,19040,18760,18760,18845,-440,-355,540,"10,178.10",5326
,20130911,18760,18845,18800,18905,18340,18460,18705,-385,-140,1428,"26,713.68",5238
,20130912,18460,18705,18600,18610,18305,18305,18505,-400,-200,90,"1,665.65",5196
,20130913,18305,18505,18300,18300,18000,18105,18065,-400,-440,122,"2,204.53",5156
,20130916,18105,18065,18150,18250,17980,18000,18040,-65,-25,146,"2,634.04",5130
ru1310,20130104,26700,26700,,,,26825,26825,125,125,0,0,188
,20130107,26825,26825,26630,26630,26300,26300,26440,-525,-385,12,317.32,190
,20130108,26300,26440,26315,26420,26260,26400,26360,-40,-80,30,790.8,192
,20130109,26400,26360,26160,26160,26100,26100,26125,-260,-235,8,209.03,192
,20130110,26100,26125,26250,26270,26220,26220,26245,95,120,8,209.96,192
,20130111,26220,26245,26150,26150,25675,25700,25815,-545,-430,10,258.16,196
,20130114,25700,25815,25400,25830,25400,25830,25560,15,-255,10,255.64,204
,20130115,25830,25560,25400,25400,25400,25400,25400,-160,-160,2,50.8,202
,20130116,25400,25400,,,,25330,25330,-70,-70,0,0,202
,20130117,25330,25330,,,,25405,25405,75,75,0,0,202
,20130118,25405,25405,25650,25650,25650,25650,25650,245,245,2,51.3,202
,20130121,25650,25650,25465,25650,25465,25585,25580,-65,-70,20,511.65,184
,20130122,25585,25580,25820,25820,25820,25820,25820,240,240,4,103.28,180
,20130123,25820,25820,,,,25820,25820,0,0,0,0,180
,20130124,25820,25820,25555,25555,25460,25460,25505,-360,-315,14,357.11,172
,20130125,25460,25505,25600,25600,25600,25600,25600,95,95,4,102.4,176
,20130128,25600,25600,25630,25630,25505,25505,25570,-95,-30,130,"3,324.25",170
,20130129,25505,25570,25720,25780,25650,25780,25685,210,115,12,308.27,172
,20130130,25780,25685,,,,25880,25880,195,195,0,0,172
,20130131,25880,25880,25965,26130,25960,26130,26030,250,150,26,676.86,174
,20130201,26130,26030,,,,26035,26035,5,5,0,0,174
,20130204,26035,26035,26655,26880,26505,26800,26680,765,645,28,747.11,170
,20130205,26800,26680,26700,27110,26700,26950,26985,270,305,60,"1,619.16",166
,20130206,26950,26985,27165,27180,26940,26940,27035,-45,50,40,"1,081.45",156
,20130207,26940,27035,26750,26940,26540,26835,26720,-200,-315,22,587.91,154
,20130208,26835,26720,,,,26720,26720,0,0,0,0,154
,20130218,26720,26720,26250,26370,26150,26160,26205,-560,-515,48,"1,257.88",162
,20130219,26160,26205,25785,26060,25725,25840,25970,-365,-235,98,"2,545.16",148
,20130220,25840,25970,25900,25900,25510,25540,25845,-430,-125,506,"13,078.10",462
,20130221,25540,25845,25230,25450,24550,24905,24825,-940,-1020,626,"15,540.57",338
,20130222,24905,24825,25050,25065,24900,24905,24995,80,170,44,"1,099.82",324
,20130225,24905,24995,24510,24620,24330,24500,24495,-495,-500,172,"4,213.34",450
,20130226,24500,24495,23980,24295,23980,24135,24220,-360,-275,236,"5,716.01",608
,20130227,24135,24220,24145,24325,24105,24210,24225,-10,5,282,"6,832.46",818
,20130228,24210,24225,24470,24470,24175,24360,24420,135,195,194,"4,737.62",926
,20130301,24360,24420,24000,24115,23300,23705,23870,-715,-550,392,"9,358.04",630
,20130304,23705,23870,23675,23675,23410,23635,23570,-235,-300,194,"4,572.58",740
,20130305,23635,23570,23775,24000,23775,23965,23925,395,355,70,"1,674.76",746
,20130306,23965,23925,24030,24030,23655,23795,23815,-130,-110,60,"1,429.11",738
,20130307,23795,23815,23800,23845,23560,23600,23710,-215,-105,124,"2,940.36",814
,20130308,23600,23710,23690,23830,23450,23755,23620,45,-90,74,"1,748.22",812
,20130311,23755,23620,23985,23985,23675,23770,23810,150,190,24,571.53,814
,20130312,23770,23810,23650,23650,22880,22905,23210,-905,-600,98,"2,274.80",812
,20130313,22905,23210,22810,22965,22500,22500,22710,-710,-500,90,"2,044.33",812
,20130314,22500,22710,22155,22405,22095,22340,22290,-370,-420,98,"2,184.84",824
,20130315,22340,22290,22655,23005,22560,22715,22665,425,375,572,"12,966.64",840
,20130318,22715,22665,22000,22190,21700,22060,22085,-605,-580,188,"4,152.91",932
,20130319,22060,22085,22250,22310,22100,22160,22255,75,170,218,"4,851.96",848
,20130320,22160,22255,22200,22580,22150,22580,22410,325,155,1322,"29,626.21",838
,20130321,22580,22410,22670,22925,22635,22690,22720,280,310,44,999.71,832
,20130322,22690,22720,22510,22800,22510,22775,22600,55,-120,892,"20,159.43",476
,20130325,22775,22600,22795,22995,22700,22700,22780,100,180,92,"2,096.14",434
,20130326,22700,22780,22800,22825,22510,22715,22720,-65,-60,76,"1,726.85",454
,20130327,22715,22720,22855,22900,22380,22575,22680,-145,-40,62,"1,406.16",452
,20130328,22575,22680,22520,22520,22000,22070,22150,-610,-530,146,"3,234.58",470
,20130329,22070,22150,21795,22200,21600,22070,21910,-80,-240,96,"2,103.71",426
,20130401,22070,21910,21975,21975,21500,21500,21620,-410,-290,98,"2,119.07",416
,20130402,21500,21620,21455,21620,21090,21500,21375,-120,-245,72,"1,539.12",418
,20130403,21500,21375,21550,21550,21280,21315,21385,-60,10,64,"1,368.91",418
,20130408,21315,21385,20960,21710,20960,21710,21335,325,-50,148,"3,157.64",418
,20130409,21710,21335,21665,21790,21665,21690,21710,355,375,20,434.27,416
,20130410,21690,21710,21790,21815,21755,21755,21785,45,75,6,130.72,414
,20130411,21755,21785,21820,21860,21435,21435,21645,-350,-140,72,"1,558.44",404
,20130412,21435,21645,21460,21530,21350,21350,21465,-295,-180,34,729.89,404
,20130415,21350,21465,20800,20800,20390,20490,20535,-975,-930,66,"1,355.49",432
,20130416,20490,20535,19850,20145,19505,20100,19845,-435,-690,264,"5,239.61",394
,20130417,20100,19845,20160,20260,19350,19390,19800,-455,-45,166,"3,286.83",376
,20130418,19390,19800,18850,19200,18810,18950,18940,-850,-860,184,"3,485.18",336
,20130419,18950,18940,19095,19470,18985,19470,19260,530,320,106,"2,041.92",328
,20130422,19470,19260,19345,19460,18765,18765,19130,-495,-130,158,"3,022.70",310
,20130423,18765,19130,18855,19000,18360,18435,18780,-695,-350,282,"5,296.38",322
,20130424,18435,18780,18790,19300,18705,19070,18925,290,145,106,"2,006.53",306
,20130425,19070,18925,19120,19340,18935,19180,19125,255,200,132,"2,525.00",308
,20130426,19180,19125,19860,19860,19055,19205,19380,80,255,130,"2,519.60",298
,20130502,19205,19380,18740,19170,18740,19170,18865,-210,-515,50,943.49,302
,20130503,19170,18865,19355,19805,19090,19805,19550,940,685,96,"1,877.27",296
,20130506,19805,19550,20400,20700,20040,20125,20240,575,690,158,"3,198.54",284
,20130507,20125,20240,19925,20450,19875,20020,20165,-220,-75,136,"2,743.05",288
,20130508,20020,20165,20070,20620,20070,20555,20345,390,180,88,"1,790.38",288
,20130509,20555,20345,20765,20765,20360,20435,20515,90,170,512,"10,505.93",310
,20130510,20435,20515,20500,21015,20425,21015,20770,500,255,210,"4,362.48",312
,20130513,21015,20770,20780,20960,20695,20695,20825,-75,55,106,"2,207.50",288
,20130514,20695,20825,20740,20795,20410,20440,20535,-385,-290,496,"10,187.01",544
,20130515,20440,20535,20480,20555,20000,20000,20360,-535,-175,64,"1,303.07",544
,20130516,20000,20360,20085,20265,19865,20115,20035,-245,-325,364,"7,294.20",290
,20130517,20115,20035,20195,20760,20170,20670,20460,635,425,108,"2,209.99",278
,20130520,20670,20460,20680,20820,20540,20660,20640,200,180,66,"1,362.35",272
,20130521,20660,20640,20790,20855,20450,20580,20645,-60,5,168,"3,469.15",292
,20130522,20580,20645,20350,20755,20260,20550,20540,-95,-105,146,"2,999.24",278
,20130523,20550,20540,20180,20235,19510,19510,19830,-1030,-710,270,"5,355.12",368
,20130524,19510,19830,19575,19695,18930,19485,19505,-345,-325,582,"11,354.55",388
,20130527,19485,19505,19345,19425,19055,19180,19250,-325,-255,178,"3,427.21",344
,20130528,19180,19250,19325,19390,19080,19235,19220,-15,-30,130,"2,499.15",354
,20130529,19235,19220,19270,19490,18800,18850,19185,-370,-35,214,"4,105.69",370
,20130530,18850,19185,18700,18935,18630,18840,18780,-345,-405,150,"2,817.26",338
,20130531,18840,18780,19145,19220,18770,18770,19035,-10,255,72,"1,370.66",344
,20130603,18770,19035,19260,19260,18800,18980,18980,-55,-55,178,"3,378.95",348
,20130604,18980,18980,19215,19300,19115,19115,19235,135,255,80,"1,539.19",378
,20130605,19115,19235,19295,19330,18835,18930,18990,-305,-245,190,"3,608.19",372
,20130606,18930,18990,18800,18870,18275,18350,18555,-640,-435,210,"3,896.98",358
,20130607,18350,18555,18395,18475,18305,18425,18410,-130,-145,302,"5,560.33",364
,20130613,18425,18410,18185,18185,17615,17820,17780,-590,-630,1008,"17,922.79",368
,20130614,17820,17780,18300,18310,17835,18055,17985,275,205,144,"2,590.23",382
,20130617,18055,17985,18135,18540,18135,18190,18290,205,305,358,"6,549.57",404
,20130618,18190,18290,18170,18340,17975,18275,18195,-15,-95,274,"4,986.40",400
,20130619,18275,18195,18360,18460,18095,18460,18290,265,95,150,"2,743.72",380
,20130620,18460,18290,18460,18460,17855,17885,18070,-405,-220,198,"3,577.95",360
,20130621,17885,18070,17655,17700,17165,17595,17475,-475,-595,266,"4,649.09",392
,20130624,17595,17475,17575,17615,17000,17000,17350,-475,-125,662,"11,486.13",394
,20130625,17000,17350,17100,17535,16890,17500,17255,150,-95,144,"2,484.96",368
,20130626,17500,17255,17670,17670,17035,17035,17310,-220,55,90,"1,558.05",368
,20130627,17035,17310,17245,17350,16950,17135,17150,-175,-160,160,"2,744.72",372
,20130628,17135,17150,17140,17285,17100,17150,17200,0,50,52,894.4,364
,20130701,17150,17200,17150,17445,17150,17435,17270,235,70,110,"1,899.72",398
,20130702,17435,17270,18130,18130,17400,17400,17565,130,295,68,"1,194.57",380
,20130703,17400,17565,17410,17485,17245,17485,17385,-80,-180,62,"1,077.87",380
,20130704,17485,17385,17350,17545,17315,17515,17440,130,55,74,"1,290.84",360
,20130705,17515,17440,17460,17470,17245,17265,17370,-175,-70,76,"1,320.31",350
,20130708,17265,17370,17120,17255,16515,16515,16780,-855,-590,282,"4,733.01",496
,20130709,16515,16780,16795,16860,16580,16580,16745,-200,-35,98,"1,641.12",484
,20130710,16580,16745,16500,16565,16205,16515,16480,-230,-265,332,"5,472.75",660
,20130711,16515,16480,16800,17280,16700,17205,17050,725,570,186,"3,171.56",656
,20130712,17205,17050,17000,17050,16665,16665,16970,-385,-80,62,"1,052.36",654
,20130715,16665,16970,16895,16895,16570,16570,16680,-400,-290,44,734.07,650
,20130716,16570,16680,16710,16780,16475,16780,16635,100,-45,50,831.9,642
,20130717,16780,16635,16745,17400,16745,17350,17115,715,480,132,"2,259.67",650
,20130718,17350,17115,17190,17445,17155,17360,17265,245,150,82,"1,415.97",630
,20130719,17360,17265,17670,17800,17320,17470,17580,205,315,96,"1,688.15",640
,20130722,17470,17580,17610,17685,17505,17650,17575,70,-5,30,527.38,640
,20130723,17650,17575,17635,17640,17490,17490,17560,-85,-15,38,667.41,638
,20130724,17490,17560,17455,17595,17210,17565,17405,5,-155,62,"1,079.32",630
,20130725,17565,17405,17480,17600,17450,17470,17515,65,110,38,665.74,630
,20130726,17470,17515,17515,17520,17055,17055,17340,-460,-175,56,971.18,630
,20130729,17055,17340,16765,16805,16700,16730,16790,-610,-550,722,"12,125.79",432
,20130730,16730,16790,16770,16810,16675,16675,16800,-115,10,68,"1,142.45",492
,20130731,16675,16800,16605,16895,16600,16895,16625,95,-175,640,"10,642.14",628
,20130801,16895,16625,16910,17125,16910,17100,17045,475,420,182,"3,102.61",632
,20130802,17100,17045,17200,17200,16940,17060,16985,15,-60,20,339.75,630
,20130805,17060,16985,17100,17280,17100,17280,17200,295,215,96,"1,651.62",622
,20130806,17280,17200,17175,17395,17160,17390,17270,190,70,76,"1,312.70",624
,20130807,17390,17270,17350,17450,17295,17320,17355,50,85,34,590.14,622
,20130808,17320,17355,17685,18130,17645,18115,17900,760,545,126,"2,255.44",630
,20130809,18115,17900,18115,18350,18115,18350,18255,450,355,274,"5,002.51",436
,20130812,18350,18255,18400,18660,18380,18660,18430,405,175,44,811.01,438
,20130813,18660,18430,18665,18750,18645,18710,18690,280,260,62,"1,159.05",444
,20130814,18710,18690,18670,18685,18465,18500,18585,-190,-105,40,743.45,436
,20130815,18500,18585,18690,18690,18335,18380,18565,-205,-20,108,"2,005.14",448
,20130816,18380,18565,18460,18900,18455,18660,18660,95,95,100,"1,866.15",504
,20130819,18660,18660,18640,18760,18625,18625,18695,-35,35,10,186.96,500
,20130820,18625,18695,18645,18725,18345,18350,18620,-345,-75,102,"1,899.69",486
,20130821,18350,18620,18450,18450,18395,18425,18435,-195,-185,26,479.31,488
,20130822,18425,18435,18260,18750,18260,18580,18550,145,115,24,445.23,486
,20130823,18580,18550,18905,18960,18660,18960,18840,410,290,6,113.05,486
,20130826,18960,18840,19395,19400,19265,19400,19375,560,535,354,"6,859.78",472
,20130827,19400,19375,19290,19405,19255,19405,19335,30,-40,26,502.76,470
,20130828,19405,19335,19300,19600,19030,19030,19270,-305,-65,222,"4,278.64",488
,20130829,19030,19270,19035,19145,18785,19100,18945,-170,-325,146,"2,766.36",438
,20130830,19100,18945,18855,18940,18595,18595,18840,-350,-105,82,"1,544.98",428
,20130902,18595,18840,18800,19595,18800,19555,19355,715,515,172,"3,329.06",440
,20130903,19555,19355,19780,19840,19400,19595,19560,240,205,190,"3,716.53",368
,20130904,19595,19560,19470,19485,19180,19180,19360,-380,-200,78,"1,510.27",352
,20130905,19180,19360,19295,19350,19000,19350,19195,-10,-165,48,921.57,364
,20130906,19350,19195,19170,19380,19150,19250,19275,55,80,40,771.17,342
,20130909,19250,19275,19400,19400,19335,19340,19350,65,75,14,270.95,332
,20130910,19340,19350,19100,19100,18970,19010,19025,-340,-325,54,"1,027.43",350
,20130911,19010,19025,19075,19150,18720,18795,18915,-230,-110,124,"2,345.98",422
,20130912,18795,18915,18750,18750,18495,18495,18685,-420,-230,60,"1,121.22",410
,20130913,18495,18685,18300,18315,18200,18285,18280,-400,-405,74,"1,352.77",408
,20130916,18285,18280,18450,18450,18100,18100,18260,-180,-20,38,693.91,412
,20130917,18100,18260,18115,18300,18115,18280,18225,20,-35,34,619.71,420
,20130918,18280,18225,18120,18535,18120,18535,18385,310,160,42,772.25,410
,20130923,18535,18385,18255,18500,18220,18500,18295,115,-90,272,"4,976.41",614
,20130924,18500,18295,18305,18500,18160,18290,18345,-5,50,88,"1,614.45",652
,20130925,18290,18345,18210,18470,18210,18470,18355,125,10,6,110.14,654
,20130926,18470,18355,18295,18390,18285,18390,18305,35,-50,38,695.7,674
,20130927,18390,18305,18310,18450,18200,18200,18340,-105,35,50,917.11,686
,20130930,18200,18340,17705,18140,17705,18025,18055,-315,-285,86,"1,552.84",646
,20131008,18025,18055,18000,18300,18000,18295,18265,240,210,20,365.37,646
,20131009,18295,18265,18300,18345,18250,18300,18290,35,25,76,"1,390.35",612
,20131010,18300,18290,18150,18245,18065,18115,18155,-175,-135,72,"1,307.43",624
,20131011,18115,18155,18300,18440,18300,18440,18375,285,220,60,"1,102.61",602
,20131014,18440,18375,18300,18595,18300,18550,18395,175,20,54,993.37,616
,20131015,18550,18395,18550,18690,18300,18505,18515,110,120,160,"2,962.57",600
ru1311,20130104,26350,26365,26430,26490,26340,26340,26405,-25,40,16,422.54,84
,20130107,26340,26405,26475,26485,26475,26485,26475,80,70,6,158.87,86
,20130108,26485,26475,26200,26200,25770,26050,26050,-425,-425,152,"3,960.08",194
,20130109,26050,26050,26145,26150,25750,25865,25955,-185,-95,152,"3,945.71",296
,20130110,25865,25955,25950,26000,25845,26000,25955,45,0,130,"3,374.36",366
,20130111,26000,25955,26100,26200,25400,25400,25880,-555,-75,166,"4,296.59",448
,20130114,25400,25880,25285,25450,25050,25300,25245,-580,-635,272,"6,867.90",608
,20130115,25300,25245,25350,25400,24940,24940,25145,-305,-100,136,"3,420.07",684
,20130116,24940,25145,24895,25090,24760,25000,24950,-145,-195,132,"3,293.44",718
,20130117,25000,24950,25030,25140,24900,25075,25045,125,95,96,"2,404.67",750
,20130118,25075,25045,25325,25480,25215,25400,25360,355,315,272,"6,898.34",878
,20130121,25400,25360,25300,25365,25235,25235,25305,-125,-55,198,"5,010.98",1022
,20130122,25235,25305,25320,25600,25320,25500,25480,195,175,272,"6,930.99",1036
,20130123,25500,25480,25510,25545,25400,25470,25490,-10,10,110,"2,804.04",1036
,20130124,25470,25490,25450,25475,25085,25170,25280,-320,-210,200,"5,056.10",1056
,20130125,25170,25280,25155,25290,25155,25165,25215,-115,-65,54,"1,361.68",1054
,20130128,25165,25215,25200,25220,25020,25205,25155,-10,-60,70,"1,760.98",1058
,20130129,25205,25155,25280,25415,25280,25415,25320,260,165,206,"5,215.95",1076
,20130130,25415,25320,25615,25680,25505,25675,25620,355,300,80,"2,049.88",1076
,20130131,25675,25620,25785,25835,25600,25765,25745,145,125,224,"5,767.18",1080
,20130201,25765,25745,25740,25930,25650,25915,25820,170,75,116,"2,995.51",1080
,20130204,25915,25820,26280,26575,26050,26465,26240,645,420,222,"5,826.21",1088
,20130205,26465,26240,26260,26850,26250,26600,26610,360,370,308,"8,197.35",1094
,20130206,26600,26610,26750,27020,26500,26535,26740,-75,130,200,"5,348.92",1090
,20130207,26535,26740,26385,26555,26220,26470,26395,-270,-345,86,"2,269.97",1092
,20130208,26470,26395,26300,26590,26230,26240,26430,-155,35,70,"1,850.42",1098
,20130218,26240,26430,26240,26240,25700,25795,25955,-635,-475,226,"5,865.98",1160
,20130219,25795,25955,25690,25775,25535,25600,25675,-355,-280,168,"4,314.14",1244
,20130220,25600,25675,25650,25675,25290,25310,25455,-365,-220,212,"5,396.50",1328
,20130221,25310,25455,25085,25155,24330,24565,24585,-890,-870,358,"8,803.21",1312
,20130222,24565,24585,24540,24700,24515,24515,24620,-70,35,102,"2,511.33",1326
,20130225,24515,24620,25260,25260,23935,24100,24160,-520,-460,222,"5,364.40",1342
,20130226,24100,24160,23860,24090,23665,23665,23945,-495,-215,248,"5,939.36",1364
,20130227,23665,23945,23900,24125,23870,24030,23995,85,50,208,"4,991.79",1366
,20130228,24030,23995,24310,24310,23980,24145,24110,150,115,158,"3,809.72",1414
,20130301,24145,24110,23980,24000,23080,23445,23520,-665,-590,298,"7,009.13",1460
,20130304,23445,23520,23525,23560,23220,23400,23360,-120,-160,266,"6,213.85",1466
,20130305,23400,23360,23975,23975,23570,23700,23680,340,320,102,"2,415.84",1478
,20130306,23700,23680,23945,23945,23500,23565,23650,-115,-30,106,"2,507.14",1484
,20130307,23565,23650,23625,23625,23325,23400,23445,-250,-205,120,"2,813.93",1496
,20130308,23400,23445,23560,23600,23300,23600,23505,155,60,144,"3,385.06",1524
,20130311,23600,23505,23660,23735,23435,23470,23585,-35,80,110,"2,594.54",1554
,20130312,23470,23585,23400,23400,22655,22705,22985,-880,-600,1158,"26,622.39",2064
,20130313,22705,22985,22635,22745,22300,22300,22555,-685,-430,328,"7,398.45",2074
,20130314,22300,22555,22300,22320,21925,22285,22135,-270,-420,416,"9,210.05",2088
,20130315,22285,22135,22395,22800,22280,22605,22515,470,380,570,"12,834.25",2208
,20130318,22605,22515,22390,22390,21485,21785,21845,-730,-670,846,"18,482.97",2112
,20130319,21785,21845,21860,22150,21860,22060,22025,215,180,462,"10,176.56",2170
,20130320,22060,22025,22050,22400,22050,22300,22240,275,215,872,"19,393.66",2494
,20130321,22300,22240,22395,22710,22390,22480,22580,240,340,962,"21,724.72",2670
,20130322,22480,22580,22310,22600,22310,22450,22445,-130,-135,648,"14,544.39",2760
,20130325,22450,22445,22570,22775,22500,22525,22630,80,185,718,"16,250.80",2960
,20130326,22525,22630,22530,22605,22265,22465,22390,-165,-240,440,"9,852.24",2994
,20130327,22465,22390,22600,22645,22225,22230,22435,-160,45,688,"15,436.64",3384
,20130328,22230,22435,22250,22310,21745,21800,21950,-635,-485,650,"14,268.04",3456
,20130329,21800,21950,21620,21900,21360,21830,21705,-120,-245,390,"8,466.32",3422
,20130401,21830,21705,21760,21790,21100,21120,21425,-585,-280,1182,"25,329.63",4050
,20130402,21120,21425,21085,21300,20765,21125,21100,-300,-325,962,"20,301.62",4218
,20130403,21125,21100,21125,21195,20895,20895,21010,-205,-90,798,"16,768.15",4424
,20130408,20895,21010,21000,21310,20595,21285,21015,275,5,1442,"30,305.70",4512
,20130409,21285,21015,21480,21505,21225,21265,21360,250,345,764,"16,320.40",4460
,20130410,21265,21360,21320,21555,21285,21390,21425,30,65,728,"15,599.35",4514
,20130411,21390,21425,21460,21550,21015,21150,21265,-275,-160,1820,"38,710.24",4418
,20130412,21150,21265,21110,21240,21020,21120,21130,-145,-135,742,"15,680.55",4384
,20130415,21120,21130,20610,20610,20070,20095,20255,-1035,-875,912,"18,477.09",4452
,20130416,20095,20255,19550,19965,19240,19860,19615,-395,-640,1688,"33,112.60",4220
,20130417,19860,19615,19905,20055,19380,19400,19655,-215,40,2350,"46,194.96",3400
,20130418,19400,19655,18915,19175,18670,18810,18850,-845,-805,1372,"25,867.68",3172
,20130419,18810,18850,19050,19400,18900,19390,19105,540,255,774,"14,790.48",3108
,20130422,19390,19105,19400,19415,18805,18805,19115,-300,10,912,"17,433.06",3282
,20130423,18805,19115,18805,19025,18155,18420,18475,-695,-640,2050,"37,876.11",3286
,20130424,18420,18475,18550,19105,18510,18860,18700,385,225,772,"14,437.14",3378
,20130425,18860,18700,19100,19200,18770,19000,19020,300,320,686,"13,048.06",3362
,20130426,19000,19020,19380,19605,18900,19180,19270,160,250,1726,"33,261.02",3202
,20130502,19180,19270,18500,19120,18200,19120,18735,-150,-535,748,"14,015.24",3132
,20130503,19120,18735,19245,19670,19220,19670,19465,935,730,500,"9,734.11",3138
,20130506,19670,19465,20380,20775,20000,20070,20220,605,755,586,"11,850.75",3192
,20130507,20070,20220,20035,20380,19805,19910,20015,-310,-205,1448,"28,982.70",3282
,20130508,19910,20015,19915,20550,19915,20520,20200,505,185,1056,"21,331.87",3166
,20130509,20520,20200,20520,20635,20155,20340,20370,140,170,366,"7,456.91",3172
,20130510,20340,20370,20355,20940,20355,20940,20630,570,260,788,"16,259.46",3198
,20130513,20940,20630,20835,20865,20580,20580,20720,-50,90,528,"10,942.72",3176
,20130514,20580,20720,20785,20785,20275,20325,20410,-395,-310,424,"8,655.85",3186
,20130515,20325,20410,20280,20420,19920,19920,20225,-490,-185,300,"6,068.50",3120
,20130516,19920,20225,19970,20180,19765,19990,19930,-235,-295,124,"2,471.58",3122
,20130517,19990,19930,20120,20635,20085,20590,20435,660,505,290,"5,926.73",3120
,20130520,20590,20435,20530,20680,20435,20540,20525,105,90,222,"4,557.17",3104
,20130521,20540,20525,20670,20720,20310,20495,20510,-30,-15,298,"6,113.39",3108
,20130522,20495,20510,20390,20600,20215,20535,20415,25,-95,238,"4,858.79",3114
,20130523,20535,20415,20315,20315,19390,19390,19710,-1025,-705,674,"13,285.48",3214
,20130524,19390,19710,19590,19630,19300,19430,19465,-280,-245,496,"9,656.13",3178
,20130527,19430,19465,19160,19425,19050,19175,19235,-290,-230,234,"4,501.08",3194
,20130528,19175,19235,19335,19380,19040,19240,19175,5,-60,288,"5,522.81",3214
,20130529,19240,19175,19325,19500,18835,18835,19180,-340,5,330,"6,330.83",3184
,20130530,18835,19180,18500,18975,18500,18910,18840,-270,-340,230,"4,333.97",3158
,20130531,18910,18840,19380,19380,18800,18850,19020,10,180,148,"2,815.69",3174
,20130603,18850,19020,19320,19320,18895,19070,19055,50,35,202,"3,849.37",3178
,20130604,19070,19055,19080,19335,19080,19210,19225,155,170,274,"5,268.09",3170
,20130605,19210,19225,19270,19380,18950,19025,19065,-200,-160,418,"7,969.42",3188
,20130606,19025,19065,18905,18980,18395,18405,18600,-660,-465,626,"11,643.89",3006
,20130607,18405,18600,18485,18575,18310,18400,18440,-200,-160,518,"9,554.23",2754
,20130613,18400,18440,17925,18050,17700,17855,17890,-585,-550,410,"7,335.92",2670
,20130614,17855,17890,17980,18200,17895,18120,18070,230,180,496,"8,964.02",2800
,20130617,18120,18070,18180,18515,18145,18230,18305,160,235,448,"8,201.42",2958
,20130618,18230,18305,18300,18430,18005,18430,18340,125,35,756,"13,865.81",2748
,20130619,18430,18340,18455,18590,18230,18590,18440,250,100,332,"6,122.27",2792
,20130620,18590,18440,18400,18400,17955,18010,18105,-430,-335,342,"6,192.09",2776
,20130621,18010,18105,17600,17745,17205,17720,17495,-385,-610,542,"9,484.64",2730
,20130624,17720,17495,17685,17685,16620,16990,17015,-505,-480,970,"16,504.61",2582
,20130625,16990,17015,17100,17600,16960,17485,17230,470,215,1148,"19,781.37",2382
,20130626,17485,17230,17625,17680,17045,17050,17250,-180,20,416,"7,177.22",2360
,20130627,17050,17250,17125,17375,16950,17130,17190,-120,-60,442,"7,599.51",2340
,20130628,17130,17190,17020,17310,16880,17150,17145,-40,-45,288,"4,938.73",2324
,20130701,17150,17145,17095,17440,17095,17440,17275,295,130,262,"4,526.20",2304
,20130702,17440,17275,17535,17620,17410,17500,17510,225,235,212,"3,712.66",2378
,20130703,17500,17510,17525,17620,17305,17440,17440,-70,-70,506,"8,825.79",2434
,20130704,17440,17440,17475,17650,17345,17570,17575,130,135,314,"5,519.24",2418
,20130705,17570,17575,17500,17620,17345,17345,17575,-230,0,632,"11,108.66",2818
,20130708,17345,17575,17270,17270,16695,16695,16930,-880,-645,732,"12,395.48",3180
,20130709,16695,16930,16845,16860,16605,16620,16760,-310,-170,940,"15,758.07",3416
,20130710,16620,16760,16555,16625,16300,16545,16490,-215,-270,1476,"24,343.09",3144
,20130711,16545,16490,16750,17310,16750,17280,16960,790,470,544,"9,228.48",2988
,20130712,17280,16960,17195,17200,16670,16715,16910,-245,-50,620,"10,487.29",2990
,20130715,16715,16910,16620,16880,16555,16605,16750,-305,-160,488,"8,175.70",2740
,20130716,16605,16750,16690,16820,16530,16765,16640,15,-110,462,"7,689.67",2934
,20130717,16765,16640,16850,17440,16770,17390,17215,750,575,866,"14,908.76",2954
,20130718,17390,17215,17250,17460,17210,17430,17330,215,115,360,"6,240.25",2890
,20130719,17430,17330,17680,17870,17475,17530,17715,200,385,404,"7,157.80",2898
,20130722,17530,17715,17715,17805,17550,17745,17665,30,-50,174,"3,073.99",2900
,20130723,17745,17665,17650,17745,17470,17515,17580,-150,-85,316,"5,555.35",2896
,20130724,17515,17580,17585,17665,17220,17630,17465,50,-115,446,"7,790.13",2908
,20130725,17630,17465,17465,17720,17465,17660,17590,195,125,222,"3,905.97",2904
,20130726,17660,17590,17700,17750,17155,17220,17405,-370,-185,372,"6,475.27",2882
,20130729,17220,17405,17000,17000,16705,16830,16875,-575,-530,1656,"27,946.76",2532
,20130730,16830,16875,16865,16960,16720,16740,16855,-135,-20,268,"4,517.37",2470
,20130731,16740,16855,16705,17095,16695,17065,16790,210,-65,1156,"19,413.20",2636
,20130801,17065,16790,17620,17620,17060,17215,17175,425,385,392,"6,733.58",2660
,20130802,17215,17175,17335,17400,17075,17155,17250,-20,75,186,"3,209.11",2654
,20130805,17155,17250,17050,17435,17050,17435,17310,185,60,436,"7,548.40",2684
,20130806,17435,17310,17375,17600,17280,17525,17410,215,100,274,"4,770.46",2624
,20130807,17525,17410,17440,17665,17380,17420,17505,10,95,202,"3,536.60",2646
,20130808,17420,17505,17650,18300,17650,18175,17980,670,475,526,"9,457.63",2670
,20130809,18175,17980,18260,18460,18220,18405,18360,425,380,538,"9,877.92",2532
,20130812,18405,18360,18525,18870,18420,18840,18655,480,295,390,"7,275.76",2632
,20130813,18840,18655,18815,18930,18740,18915,18820,260,165,988,"18,595.60",2890
,20130814,18915,18820,18820,18945,18610,18680,18760,-140,-60,844,"15,833.62",2980
,20130815,18680,18760,18860,18910,18500,18570,18640,-190,-120,664,"12,378.53",2868
,20130816,18570,18640,18600,19100,18600,18820,18790,180,150,988,"18,566.32",3022
,20130819,18820,18790,18815,18965,18700,18710,18820,-80,30,564,"10,615.92",2878
,20130820,18710,18820,18695,18880,18400,18470,18565,-350,-255,1288,"23,914.86",2822
,20130821,18470,18565,18560,18655,18460,18505,18550,-60,-15,230,"4,267.36",2832
,20130822,18505,18550,18400,18900,18350,18715,18680,165,130,386,"7,212.20",2884
,20130823,18715,18680,18810,19150,18750,19150,18955,470,275,356,"6,749.49",2880
,20130826,19150,18955,19500,19700,19340,19575,19500,620,545,914,"17,825.49",2886
,20130827,19575,19500,19480,19525,19240,19525,19425,25,-75,334,"6,488.64",2846
,20130828,19525,19425,19500,19800,19130,19150,19525,-275,100,384,"7,498.82",2874
,20130829,19150,19525,19215,19250,18820,19140,19095,-385,-430,482,"9,204.68",2858
,20130830,19140,19095,19050,19115,18325,18815,18915,-280,-180,632,"11,955.78",3132
,20130902,18815,18915,18990,19790,18990,19755,19460,840,545,716,"13,933.84",3228
,20130903,19755,19460,19900,19930,19505,19675,19695,215,235,628,"12,371.57",3220
,20130904,19675,19695,19740,19740,19260,19370,19480,-325,-215,312,"6,079.03",3206
,20130905,19370,19480,19315,19510,19060,19410,19310,-70,-170,348,"6,720.49",3236
,20130906,19410,19310,19365,19560,19220,19400,19360,90,50,242,"4,685.19",3236
,20130909,19400,19360,19580,19650,19360,19500,19480,140,120,672,"13,092.13",2910
,20130910,19500,19480,19300,19300,19065,19135,19180,-345,-300,412,"7,903.42",2878
,20130911,19135,19180,19185,19270,18875,19060,19055,-120,-125,1006,"19,172.38",3266
,20130912,19060,19055,18935,18970,18580,18580,18810,-475,-245,362,"6,810.25",3218
,20130913,18580,18810,18560,18560,18280,18355,18385,-455,-425,512,"9,414.24",3206
,20130916,18355,18385,18450,18575,18165,18340,18345,-45,-40,824,"15,118.67",3376
,20130917,18340,18345,18215,18495,18145,18375,18365,30,20,458,"8,413.45",3424
,20130918,18375,18365,18395,18515,18265,18480,18385,115,20,684,"12,578.43",3472
,20130923,18480,18385,18510,18520,18215,18405,18365,20,-20,578,"10,614.99",3552
,20130924,18405,18365,18335,18500,18325,18425,18400,60,35,668,"12,293.99",3700
,20130925,18425,18400,18360,18550,18360,18475,18450,75,50,300,"5,535.11",3684
,20130926,18475,18450,18410,18550,18315,18525,18430,75,-20,564,"10,394.59",3734
,20130927,18525,18430,18480,18530,18120,18245,18450,-185,20,1418,"26,166.76",3556
,20130930,18245,18450,17895,18350,17880,18150,18215,-300,-235,376,"6,849.81",3610
,20131008,18150,18215,18180,18495,18180,18350,18330,135,115,224,"4,106.72",3622
,20131009,18350,18330,18280,18525,18275,18485,18455,155,125,406,"7,492.76",3676
,20131010,18485,18455,18350,18410,18205,18285,18290,-170,-165,334,"6,110.33",3708
,20131011,18285,18290,18450,18615,18385,18530,18555,240,265,580,"10,763.00",3836
,20131014,18530,18555,18575,18675,18455,18660,18580,105,25,256,"4,756.57",3904
,20131015,18660,18580,18665,18700,18500,18600,18590,20,10,374,"6,954.34",3904
,20131016,18600,18590,18550,18600,18400,18450,18485,-140,-105,404,"7,469.12",3708
,20131017,18450,18485,18520,18540,18150,18200,18365,-285,-120,318,"5,840.75",3620
,20131018,18200,18365,18350,18350,18095,18230,18205,-135,-160,552,"10,051.55",3620
,20131021,18230,18205,18025,18500,18000,18500,18250,295,45,328,"5,986.17",3656
,20131022,18500,18250,18420,18505,18360,18360,18470,110,220,502,"9,272.22",3822
,20131023,18360,18470,18445,18445,18050,18100,18160,-370,-310,206,"3,741.64",3808
,20131024,18100,18160,18080,18140,17880,18060,18030,-100,-130,220,"3,967.16",3774
,20131025,18060,18030,18085,18085,17510,17650,17845,-380,-185,646,"11,528.53",3870
,20131028,17650,17845,17505,17590,17355,17495,17440,-350,-405,302,"5,267.91",3802
,20131029,17495,17440,17480,17480,17250,17445,17370,5,-70,414,"7,191.36",3716
,20131030,17445,17370,17455,17500,17280,17500,17375,130,5,426,"7,403.62",3722
,20131031,17500,17375,17265,17450,17265,17370,17380,-5,5,516,"8,969.00",3738
,20131101,17370,17380,17335,17460,17305,17430,17355,50,-25,350,"6,075.78",3724
,20131104,17430,17355,17400,17455,17305,17445,17350,90,-5,262,"4,545.76",3722
,20131105,17445,17350,17400,17400,17065,17400,17275,50,-75,284,"4,907.08",3776
,20131106,17400,17275,17385,17400,17250,17370,17345,95,70,112,"1,943.07",3722
,20131107,17370,17345,17325,17485,17325,17445,17425,100,80,218,"3,799.20",3676
,20131108,17445,17425,17410,17580,17410,17455,17495,30,70,254,"4,444.96",3616
,20131111,17455,17495,17525,17575,17445,17500,17490,5,-5,184,"3,218.19",3640
,20131112,17500,17490,17555,17560,17100,17100,17445,-390,-45,278,"4,850.92",3650
,20131113,17100,17445,17200,17250,17150,17155,17200,-290,-245,36,619.21,3654
,20131114,17155,17200,17250,17400,17250,17330,17315,130,115,74,"1,281.57",3618
,20131115,17330,17315,17305,17305,17200,17300,17290,-15,-25,232,"4,011.29",3814
ru1401,20130116,25145,25145,,,,25145,25145,0,0,0,0,0
,20130117,25145,25145,25470,25550,25435,25540,25495,395,350,26,662.9,20
,20130118,25540,25495,25870,25870,25870,25870,25870,375,375,2,51.74,20
,20130121,25870,25870,25750,25900,25740,25740,25815,-130,-55,178,"4,595.07",192
,20130122,25740,25815,26000,26000,26000,26000,26000,185,185,10,260,192
,20130123,26000,26000,26070,26070,26070,26070,26070,70,70,2,52.14,194
,20130124,26070,26070,25995,25995,25665,25730,25780,-340,-290,14,360.94,198
,20130125,25730,25780,25920,25925,25750,25750,25835,-30,55,46,"1,188.62",234
,20130128,25750,25835,25715,25800,25580,25700,25695,-135,-140,14,359.79,246
,20130129,25700,25695,25900,26065,25900,26040,25945,345,250,102,"2,646.89",318
,20130130,26040,25945,26180,26295,26180,26260,26245,315,300,30,787.37,328
,20130131,26260,26245,26300,26410,26300,26410,26370,165,125,18,474.68,326
,20130201,26410,26370,26330,26500,26220,26500,26300,130,-70,34,894.2,324
,20130204,26500,26300,26710,27190,26665,27190,26870,890,570,90,"2,418.48",356
,20130205,27190,26870,26835,27475,26835,27305,27220,435,350,76,"2,068.89",362
,20130206,27305,27220,27505,27515,27100,27200,27370,-20,150,68,"1,861.32",386
,20130207,27200,27370,27200,27200,26900,27120,26990,-250,-380,94,"2,537.24",436
,20130208,27120,26990,26950,27250,26800,26800,27105,-190,115,148,"4,011.71",538
,20130218,26800,27105,26540,26930,26200,26350,26440,-755,-665,300,"7,932.88",700
,20130219,26350,26440,26045,26370,26045,26175,26245,-265,-195,1468,"38,534.06",1854
,20130220,26175,26245,26250,26290,25855,25870,26195,-375,-50,986,"25,828.49",2674
,20130221,25870,26195,25750,25750,24890,25170,25180,-1025,-1015,560,"14,100.82",2924
,20130222,25170,25180,25145,25320,25015,25075,25235,-105,55,676,"17,058.89",3326
,20130225,25075,25235,24970,25075,24600,24705,24790,-530,-445,298,"7,388.33",3330
,20130226,24705,24790,24400,24675,24160,24185,24460,-605,-330,250,"6,115.64",3366
,20130227,24185,24460,24435,24650,24420,24570,24550,110,90,472,"11,589.55",3652
,20130228,24570,24550,24730,24835,24505,24660,24710,110,160,1420,"35,090.43",4532
,20130301,24660,24710,24495,24530,23470,23845,23980,-865,-730,1830,"43,885.10",5254
,20130304,23845,23980,23820,23990,23630,23800,23810,-180,-170,1584,"37,717.45",5644
,20130305,23800,23810,23965,24295,23965,24150,24150,340,340,1444,"34,878.27",5962
,20130306,24150,24150,24190,24350,23915,24130,24180,-20,30,2302,"55,673.73",6896
,20130307,24130,24180,24185,24230,23920,24060,24070,-120,-110,1706,"41,067.72",7468
,20130308,24060,24070,24145,24250,23915,24195,24110,125,40,1874,"45,183.24",8122
,20130311,24195,24110,24180,24350,24035,24055,24210,-55,100,1604,"38,835.50",8574
,20130312,24055,24210,24155,24155,23350,23350,23680,-860,-530,1862,"44,101.20",8794
,20130313,23350,23680,23300,23450,22900,22915,23155,-765,-525,2068,"47,887.22",8666
,20130314,22915,23155,22815,23030,22530,23000,22800,-155,-355,2430,"55,414.38",9406
,20130315,23000,22800,23185,23500,22600,23355,23170,555,370,4584,"106,230.55",10622
,20130318,23355,23170,22990,23000,22155,22560,22535,-610,-635,2634,"59,361.60",10904
,20130319,22560,22535,22610,22890,22610,22780,22760,245,225,1496,"34,049.72",10904
,20130320,22780,22760,22755,23190,22600,23120,22940,360,180,2318,"53,176.60",11098
,20130321,23120,22940,23240,23520,23160,23245,23355,305,415,2948,"68,858.51",11426
,20130322,23245,23355,23005,23435,23005,23270,23195,-85,-160,3968,"92,057.06",11254
,20130325,23270,23195,23485,23595,23300,23370,23435,175,240,3272,"76,689.67",11414
,20130326,23370,23435,23370,23405,22990,23220,23200,-215,-235,4466,"103,616.36",11186
,20130327,23220,23200,23380,23440,23035,23080,23240,-120,40,2394,"55,644.86",11270
,20130328,23080,23240,23100,23180,22470,22550,22740,-690,-500,5130,"116,659.73",12284
,20130329,22550,22740,22380,22700,22100,22645,22495,-95,-245,4096,"92,150.00",12462
,20130401,22645,22495,22630,22655,21955,21985,22250,-510,-245,3854,"85,764.91",12824
,20130402,21985,22250,21985,22190,21540,21900,21840,-350,-410,11540,"252,043.05",17244
,20130403,21900,21840,21880,21985,21695,21750,21835,-90,-5,12676,"276,818.13",18888
,20130408,21750,21835,21320,22240,21320,22225,21900,390,65,11776,"257,918.12",20198
,20130409,22225,21900,22410,22465,22100,22200,22290,300,390,12446,"277,428.72",21734
,20130410,22200,22290,22280,22490,22175,22335,22340,45,50,9686,"216,407.85",22042
,20130411,22335,22340,22360,22495,21970,22000,22260,-340,-80,13066,"290,896.48",22508
,20130412,22000,22260,22005,22120,21865,21945,21985,-315,-275,14378,"316,137.42",21548
,20130415,21945,21985,21525,21530,20885,20885,21085,-1100,-900,11640,"245,474.39",21940
,20130416,20885,21085,20130,20775,20030,20640,20395,-445,-690,22290,"454,634.60",20274
,20130417,20640,20395,20800,20870,19985,20045,20370,-350,-25,24676,"502,720.65",20004
,20130418,20045,20370,19380,19960,19350,19585,19580,-785,-790,31304,"613,053.46",19470
,20130419,19585,19580,19845,20175,19610,20170,19875,590,295,36432,"724,251.26",19862
,20130422,20170,19875,20130,20170,19440,19440,19815,-435,-60,26254,"520,319.08",20118
,20130423,19440,19815,19460,19745,18830,19085,19260,-730,-555,51218,"986,655.05",24074
,20130424,19085,19260,19205,19900,19165,19525,19410,265,150,46520,"903,115.50",24890
,20130425,19525,19410,19700,19935,19405,19815,19665,405,255,38046,"748,291.36",24784
,20130426,19815,19665,20115,20355,19420,19690,19955,25,290,38106,"760,425.69",24730
,20130502,19690,19955,19050,19780,19010,19780,19345,-175,-610,35964,"695,781.42",26928
,20130503,19780,19345,19930,20310,19850,20310,20095,965,750,24598,"494,396.48",27334
,20130506,20310,20095,21190,21280,20510,20615,20765,520,670,37206,"772,739.02",29702
,20130507,20615,20765,20430,20950,20345,20390,20535,-375,-230,49644,"1,019,620.97",30118
,20130508,20390,20535,20500,21195,20420,21130,20810,595,275,56752,"1,181,235.47",33816
,20130509,21130,20810,21305,21320,20735,20945,20945,135,135,58356,"1,222,420.04",33636
,20130510,20945,20945,21100,21525,20920,21500,21230,555,285,69856,"1,483,192.41",34128
,20130513,21500,21230,21390,21455,21110,21110,21300,-120,70,53588,"1,141,597.00",33330
,20130514,21110,21300,21125,21300,20775,20865,20965,-435,-335,68028,"1,426,218.10",36014
,20130515,20865,20965,20860,21000,20430,20465,20750,-500,-215,53080,"1,101,610.05",36170
,20130516,20465,20750,20505,20750,20280,20580,20540,-170,-210,64998,"1,335,195.77",36620
,20130517,20580,20540,20640,21220,20580,21160,20860,620,320,67906,"1,416,705.54",36736
,20130520,21160,20860,21120,21270,20955,21060,21080,200,220,59810,"1,261,037.52",40990
,20130521,21060,21080,21210,21290,20875,21065,21080,-15,0,64858,"1,367,267.22",42466
,20130522,21065,21080,20980,21210,20750,21055,21000,-25,-80,77354,"1,624,740.30",44298
,20130523,21055,21000,20860,20860,19950,19950,20370,-1050,-630,87342,"1,779,502.02",47982
,20130524,19950,20370,20020,20190,19805,19930,20020,-440,-350,88892,"1,779,618.83",49136
,20130527,19930,20020,19720,20060,19555,19735,19830,-285,-190,82640,"1,638,991.37",52930
,20130528,19735,19830,19830,19930,19580,19780,19745,-50,-85,97270,"1,920,602.14",57476
,20130529,19780,19745,19745,20090,19385,19420,19825,-325,80,89064,"1,765,747.42",55936
,20130530,19420,19825,19200,19580,19195,19475,19405,-350,-420,85934,"1,667,774.15",56870
,20130531,19475,19405,19675,19860,19345,19445,19620,40,215,91232,"1,790,184.61",56284
,20130603,19445,19620,19540,19745,19400,19620,19560,0,-60,83178,"1,627,277.88",56866
,20130604,19620,19560,19610,19890,19600,19795,19745,235,185,83824,"1,655,174.96",57682
,20130605,19795,19745,19850,19920,19465,19560,19680,-185,-65,90790,"1,787,134.53",61440
,20130606,19560,19680,19485,19550,18955,18985,19280,-695,-400,92040,"1,774,941.41",61556
,20130607,18985,19280,19020,19150,18905,19000,19035,-280,-245,80370,"1,530,019.48",62388
,20130613,19000,19035,18500,18720,18300,18450,18470,-585,-565,87378,"1,614,062.13",63838
,20130614,18450,18470,18570,19100,18500,18695,18705,225,235,107624,"2,013,387.62",67322
,20130617,18695,18705,18765,19145,18740,18930,18955,225,250,97362,"1,845,944.33",69410
,20130618,18930,18955,18910,19190,18700,19120,19005,165,50,171806,"3,265,602.95",78148
,20130619,19120,19005,19200,19335,18900,19320,19090,315,85,175122,"3,343,595.98",86514
,20130620,19320,19090,19090,19120,18505,18600,18790,-490,-300,232062,"4,360,929.86",92902
,20130621,18600,18790,18200,18415,17850,18300,18150,-490,-640,274424,"4,982,144.64",98346
,20130624,18300,18150,18260,18330,17565,17570,17950,-580,-200,292944,"5,258,776.37",105058
,20130625,17570,17950,17620,18375,17550,18215,17915,265,-35,485214,"8,693,597.80",107618
,20130626,18215,17915,18400,18460,17600,17635,17935,-280,20,585034,"10,495,290.57",129170
,20130627,17635,17935,17740,18070,17505,17760,17805,-175,-130,647202,"11,524,001.66",140406
,20130628,17760,17805,17650,17975,17475,17735,17790,-70,-15,667370,"11,873,698.71",143764
,20130701,17735,17790,17720,18170,17630,18130,17935,340,145,664312,"11,916,851.20",156210
,20130702,18130,17935,18270,18380,18070,18170,18215,235,280,582450,"10,610,129.94",156980
,20130703,18170,18215,18285,18330,17855,18040,18105,-175,-110,736620,"13,339,541.96",166206
,20130704,18040,18105,18070,18340,17940,18235,18170,130,65,705694,"12,822,833.47",153624
,20130705,18235,18170,18210,18290,17930,17935,18095,-235,-75,596708,"10,800,103.14",157190
,20130708,17935,18095,17935,17990,17225,17295,17570,-800,-525,777500,"13,661,967.67",187806
,20130709,17295,17570,17350,17520,17150,17180,17375,-390,-195,721404,"12,535,596.24",202870
,20130710,17180,17375,17110,17350,16925,17280,17145,-95,-230,830306,"14,238,276.28",187180
,20130711,17280,17145,17515,18000,17460,18000,17660,855,515,674242,"11,908,474.75",164738
,20130712,18000,17660,17980,18030,17450,17485,17780,-175,120,788596,"14,023,390.56",163228
,20130715,17485,17780,17460,17685,17280,17350,17485,-430,-295,709572,"12,409,548.73",166526
,20130716,17350,17485,17360,17650,17215,17625,17410,140,-75,770676,"13,420,495.95",173538
,20130717,17625,17410,17630,18280,17590,18260,18015,850,605,1002958,"18,068,628.12",182774
,20130718,18260,18015,18175,18445,18025,18345,18200,330,185,1002560,"18,250,264.86",178818
,20130719,18345,18200,18590,18800,18365,18460,18590,260,390,854846,"15,893,568.72",173862
,20130722,18460,18590,18690,18730,18390,18665,18580,75,-10,751664,"13,967,473.31",176960
,20130723,18665,18580,18610,18700,18335,18380,18515,-200,-65,740782,"13,718,538.64",186140
,20130724,18380,18515,18480,18610,18105,18590,18365,75,-150,1027204,"18,869,446.15",207830
,20130725,18590,18365,18470,18675,18380,18555,18515,190,150,883552,"16,363,045.74",207126
,20130726,18555,18515,18600,18640,18060,18165,18330,-350,-185,791840,"14,516,176.59",187968
,20130729,18165,18330,17900,17930,17490,17615,17690,-715,-640,686204,"12,140,135.79",179464
,20130730,17615,17690,17685,17795,17515,17520,17650,-170,-40,661568,"11,679,878.39",176560
,20130731,17520,17650,17430,17940,17400,17915,17710,265,60,852148,"15,094,111.53",181552
,20130801,17915,17710,17960,18190,17875,18110,18035,400,325,833566,"15,036,728.92",190414
,20130802,18110,18035,18225,18325,17890,18005,18110,-30,75,771168,"13,967,635.46",192896
,20130805,18005,18110,17900,18320,17860,18280,18180,170,70,759176,"13,803,488.85",205296
,20130806,18280,18180,18250,18445,18080,18400,18265,220,85,751394,"13,726,656.91",209006
,20130807,18400,18265,18300,18525,18215,18280,18335,15,70,789750,"14,483,633.48",186968
,20130808,18280,18335,18495,19245,18460,19070,18910,735,575,1040558,"19,681,425.58",188346
,20130809,19070,18910,19215,19420,19135,19330,19285,420,375,836314,"16,129,988.06",185686
,20130812,19330,19285,19400,19800,19320,19720,19520,435,235,762408,"14,885,819.35",194838
,20130813,19720,19520,19700,19925,19640,19855,19765,335,245,778900,"15,397,843.71",190860
,20130814,19855,19765,19805,19980,19575,19680,19740,-85,-25,758926,"14,983,811.68",184064
,20130815,19680,19740,19750,19920,19465,19525,19655,-215,-85,755312,"14,847,350.54",182614
,20130816,19525,19655,19615,20210,19560,19880,19805,225,150,1031700,"20,433,189.35",175300
,20130819,19880,19805,19900,20120,19765,19855,19945,50,140,738992,"14,741,056.84",178758
,20130820,19855,19945,19760,19860,19350,19470,19625,-475,-320,724828,"14,227,288.88",169448
,20130821,19470,19625,19550,19640,19430,19535,19530,-90,-95,643808,"12,576,360.24",174526
,20130822,19535,19530,19400,20050,19310,19865,19745,335,215,819514,"16,181,778.08",193850
,20130823,19865,19745,19920,20300,19805,20295,20065,550,320,892402,"17,906,420.14",202370
,20130826,20295,20065,20605,20875,20455,20700,20650,635,585,698268,"14,419,857.56",188142
,20130827,20700,20650,20615,20730,20350,20685,20560,35,-90,632828,"13,011,471.21",183250
,20130828,20685,20560,20600,20950,20150,20155,20615,-405,55,898028,"18,513,496.71",187148
,20130829,20155,20615,20280,20300,19820,20135,20135,-480,-480,745592,"15,015,634.47",177802
,20130830,20135,20135,20000,20245,19775,20000,20055,-135,-80,732466,"14,690,648.94",177498
,20130902,20000,20055,20110,21055,20110,21055,20685,1000,630,743790,"15,387,405.44",203672
,20130903,21055,20685,21150,21300,20760,21015,21010,330,325,730592,"15,351,710.79",189240
,20130904,21015,21010,21050,21080,20510,20690,20730,-320,-280,681370,"14,125,286.99",183088
,20130905,20690,20730,20650,20850,20380,20795,20645,65,-85,839996,"17,345,456.20",179090
,20130906,20795,20645,20780,20985,20565,20810,20745,165,100,686284,"14,237,158.64",170704
,20130909,20810,20745,21100,21180,20790,20870,20915,125,170,574652,"12,021,025.48",175608
,20130910,20870,20915,20845,20850,20435,20550,20595,-365,-320,621572,"12,802,517.26",173016
,20130911,20550,20595,20600,20780,20450,20735,20620,140,25,693856,"14,307,873.92",169320
,20130912,20735,20620,20615,20660,20210,20240,20475,-380,-145,619998,"12,697,031.13",173698
,20130913,20240,20475,20175,20300,20000,20220,20130,-255,-345,583650,"11,750,764.70",158212
,20130916,20220,20130,20365,20400,19985,20100,20200,-30,70,610090,"12,325,575.74",172040
,20130917,20100,20200,20075,20395,19905,20390,20190,190,-10,763790,"15,422,899.44",171190
,20130918,20390,20190,20315,20820,20170,20795,20445,605,255,756672,"15,472,662.88",165346
,20130923,20795,20445,20590,20950,20515,20900,20740,455,295,575300,"11,931,960.31",168654
,20130924,20900,20740,20760,20915,20550,20635,20740,-105,0,651610,"13,515,106.59",161426
,20130925,20635,20740,20620,20700,20470,20575,20585,-165,-155,583430,"12,010,346.74",154374
,20130926,20575,20585,20530,20700,20385,20620,20530,35,-55,594126,"12,199,275.15",146070
,20130927,20620,20530,20615,20915,20255,20260,20550,-270,20,622710,"12,797,201.76",136426
,20130930,20260,20550,20170,20340,20070,20080,20205,-470,-345,352632,"7,125,098.04",125770
,20131008,20080,20205,20010,20760,19990,20585,20490,380,285,410538,"8,412,214.19",131008
,20131009,20585,20490,20565,20620,20430,20545,20530,55,40,472300,"9,696,374.14",142004
,20131010,20545,20530,20410,20450,20175,20300,20310,-230,-220,455800,"9,259,382.00",151872
,20131011,20300,20310,20450,20890,20450,20655,20705,345,395,612938,"12,693,275.17",137930
,20131014,20655,20705,20755,21195,20570,21175,20800,470,95,626490,"13,034,037.49",172836
,20131015,21175,20800,21130,21250,20960,21175,21110,375,310,562340,"11,871,576.57",171072
,20131016,21175,21110,21070,21205,20675,20840,20910,-270,-200,591096,"12,359,980.62",150684
,20131017,20840,20910,21130,21170,20400,20405,20770,-505,-140,658006,"13,668,246.20",164870
,20131018,20405,20770,20450,20595,20350,20445,20480,-325,-290,478540,"9,802,401.79",163354
,20131021,20445,20480,20450,20645,20270,20605,20475,125,-5,500666,"10,253,008.31",153648
,20131022,20605,20475,20580,20680,20425,20455,20540,-20,65,426498,"8,761,393.54",151664
,20131023,20455,20540,20485,20570,20060,20105,20285,-435,-255,529886,"10,749,056.40",168746
,20131024,20105,20285,20100,20275,19820,20145,20095,-140,-190,517904,"10,408,077.00",170166
,20131025,20145,20095,20180,20215,19390,19405,19855,-690,-240,566710,"11,254,727.13",169618
,20131028,19405,19855,19510,19535,19230,19360,19390,-495,-465,386994,"7,505,378.07",161436
,20131029,19360,19390,19380,19580,19245,19465,19390,75,0,401056,"7,778,112.68",151604
,20131030,19465,19390,19620,19725,19440,19585,19575,195,185,293822,"5,752,345.60",137272
,20131031,19585,19575,19485,19490,19240,19335,19360,-240,-215,225126,"4,358,890.48",128188
,20131101,19335,19360,19260,19420,19165,19385,19295,25,-65,188640,"3,640,544.75",126928
,20131104,19385,19295,19275,19395,19150,19245,19260,-50,-35,114616,"2,208,044.18",116854
,20131105,19245,19260,19255,19300,18945,19050,19090,-210,-170,126290,"2,411,055.84",112580
,20131106,19050,19090,19065,19095,18915,18965,19010,-125,-80,82890,"1,575,869.05",111294
,20131107,18965,19010,18970,19150,18880,19110,19030,100,20,85212,"1,621,899.94",108254
,20131108,19110,19030,19035,19180,18950,18980,19070,-50,40,65150,"1,242,495.79",102522
,20131111,18980,19070,19120,19150,18905,18935,19000,-135,-70,61268,"1,164,277.95",102082
,20131112,18935,19000,18955,19000,18700,18785,18825,-215,-175,56914,"1,071,413.79",100138
,20131113,18785,18825,18730,18870,18650,18740,18740,-85,-85,49526,"928,168.24",98514
,20131114,18740,18740,18760,18865,18725,18790,18795,50,55,38156,"717,197.48",95010
,20131115,18790,18795,18830,18945,18580,18585,18820,-210,25,58758,"1,106,108.41",90440
,20131118,18585,18820,18610,18680,18505,18605,18605,-215,-215,36404,"677,364.36",84584
,20131119,18605,18605,18505,18670,18435,18640,18560,35,-45,34758,"645,188.09",81576
,20131120,18640,18560,18705,18850,18635,18805,18765,245,205,31086,"583,482.43",76852
,20131121,18805,18765,18750,18790,18550,18610,18640,-155,-125,33380,"622,280.19",75638
,20131122,18610,18640,18690,18805,18405,18485,18640,-155,0,38838,"724,007.78",76254
,20131125,18485,18640,18555,18585,18235,18245,18450,-395,-190,33392,"616,202.04",74640
,20131126,18245,18450,18275,18440,18205,18320,18310,-130,-140,33920,"621,080.78",71312
,20131127,18320,18310,18270,18410,18255,18380,18330,70,20,23328,"427,617.64",67188
,20131128,18380,18330,18340,18710,18340,18665,18585,335,255,46672,"867,586.00",55468
,20131129,18665,18585,18850,19130,18735,19045,18860,460,275,35122,"662,494.71",47498
,20131202,19045,18860,19095,19095,18920,19015,18990,155,130,17776,"337,634.50",46640
,20131203,19015,18990,18955,18975,18715,18770,18820,-220,-170,12902,"242,841.52",45122
,20131204,18770,18820,18845,18990,18740,18925,18860,105,40,11252,"212,214.25",43598
,20131205,18925,18860,19010,19040,18705,18730,18845,-130,-15,9006,"169,735.91",41836
,20131206,18730,18845,18730,18915,18635,18900,18770,55,-75,10536,"197,793.48",39312
,20131209,18900,18770,19005,19220,18895,19185,19105,415,335,14386,"274,884.87",34268
,20131210,19185,19105,19140,19210,19035,19115,19125,10,20,6922,"132,385.46",32726
,20131211,19115,19125,19130,19240,18920,18990,19045,-135,-80,4840,"92,180.07",31750
,20131212,18990,19045,18965,19470,18965,19430,19265,385,220,10402,"200,446.06",28360
,20131213,19430,19265,19430,19430,19040,19210,19180,-55,-85,6524,"125,161.80",26368
,20131216,19210,19180,19275,19365,19055,19100,19175,-80,-5,4854,"93,079.93",25754
,20131217,19100,19175,19160,19195,18735,18750,18915,-425,-260,5664,"107,141.73",25048
,20131218,18750,18915,18750,18790,18560,18560,18675,-355,-240,6750,"126,057.47",23996
,20131219,18560,18675,18600,18700,18405,18510,18550,-165,-125,5220,"96,834.03",23158
,20131220,18510,18550,18510,18605,18300,18300,18475,-250,-75,4018,"74,251.25",22506
,20131223,18300,18475,18395,18425,17900,17920,18110,-555,-365,6858,"124,228.53",20394
,20131224,17920,18110,17920,17920,17665,17720,17800,-390,-310,5652,"100,622.10",19360
,20131225,17720,17800,17800,17975,17600,17825,17815,25,15,6272,"111,764.56",18098
,20131226,17825,17815,17820,17915,17755,17780,17820,-35,5,3668,"65,371.41",17822
,20131227,17780,17820,17805,17985,17800,17830,17885,10,65,4376,"78,268.81",17066
,20131230,17830,17885,17835,17895,17575,17660,17745,-225,-140,4824,"85,614.85",15548
,20131231,17660,17745,17620,17710,17460,17490,17595,-255,-150,7412,"130,448.58",14042
ru1403,20130318,23170,23170,,,,23170,23170,0,0,0,0,0
,20130319,23170,23170,22795,23045,22545,22770,22785,-400,-385,8,182.31,4
,20130320,22770,22785,23150,23200,22905,23200,23070,415,285,38,876.71,22
,20130321,23200,23070,23345,23945,23345,23530,23655,460,585,40,946.24,16
,20130322,23530,23655,23385,23545,23170,23385,23390,-270,-265,46,"1,076.10",28
,20130325,23385,23390,23550,23550,23335,23430,23470,40,80,20,469.49,32
,20130326,23430,23470,23375,23390,23275,23275,23335,-195,-135,8,186.71,30
,20130327,23275,23335,23275,23275,23275,23275,23275,-60,-60,2,46.55,30
,20130328,23275,23275,22925,22925,22795,22795,22865,-480,-410,6,137.2,30
,20130329,22795,22865,22540,22565,22540,22565,22550,-300,-315,4,90.21,32
,20130401,22565,22550,22480,22480,22420,22420,22450,-130,-100,4,89.8,34
,20130402,22420,22450,22140,22140,21800,21880,21940,-570,-510,6,131.64,32
,20130403,21880,21940,21955,22010,21890,22010,21955,70,15,8,175.67,32
,20130408,22010,21955,22250,22250,22250,22250,22250,295,295,2,44.5,30
,20130409,22250,22250,22340,22340,22340,22340,22340,90,90,2,44.68,32
,20130410,22340,22340,22505,22550,22400,22400,22495,60,155,12,269.94,38
,20130411,22400,22495,22490,22535,22020,22020,22205,-475,-290,38,843.85,48
,20130412,22020,22205,22180,22180,21960,21980,22005,-225,-200,26,572.17,46
,20130415,21980,22005,21450,21450,20900,20900,21100,-1105,-905,56,"1,181.66",56
,20130416,20900,21100,20335,20820,20130,20820,20390,-280,-710,38,774.87,52
,20130417,20820,20390,20800,20800,20185,20190,20415,-200,25,60,"1,225.05",58
,20130418,20190,20415,19600,20115,19390,19770,19555,-645,-860,244,"4,771.96",164
,20130419,19770,19555,19895,20450,19880,20450,20145,895,590,36,725.39,156
,20130422,20450,20145,20080,20095,19690,19690,19900,-455,-245,50,995,146
,20130423,19690,19900,19835,19835,19155,19200,19390,-700,-510,58,"1,124.86",130
,20130424,19200,19390,19775,19775,19470,19660,19610,270,220,74,"1,451.29",114
,20130425,19660,19610,19600,19950,19505,19915,19740,305,130,40,789.7,106
,20130426,19915,19740,20060,20370,19825,19825,20225,85,485,30,606.87,112
,20130502,19825,20225,19475,19790,19410,19790,19490,-435,-735,20,389.83,112
,20130503,19790,19490,20210,20265,20210,20265,20235,775,745,4,80.95,108
,20130506,20265,20235,21110,21110,20735,20870,20910,635,675,24,501.85,104
,20130507,20870,20910,20350,21045,20350,20545,20650,-365,-260,30,619.58,112
,20130508,20545,20650,20790,21315,20790,21315,21125,665,475,8,169.03,112
,20130509,21315,21125,21140,21140,20945,20990,21030,-135,-95,8,168.27,108
,20130510,20990,21030,21060,21170,21060,21170,21115,140,85,4,84.46,108
,20130513,21170,21115,,,,21115,21115,0,0,0,0,108
,20130514,21115,21115,20915,20915,20915,20915,20915,-200,-200,2,41.83,108
,20130515,20915,20915,20855,20855,20535,20535,20590,-380,-325,16,329.5,108
,20130516,20535,20590,20655,20770,20500,20670,20665,80,75,10,206.67,110
,20130517,20670,20665,20895,21190,20790,21190,20980,525,315,18,377.66,116
,20130520,21190,20980,21160,21290,21120,21120,21205,140,225,12,254.49,116
,20130521,21120,21205,21285,21390,21030,21085,21190,-120,-15,24,508.58,114
,20130522,21085,21190,21200,21200,21200,21200,21200,10,10,2,42.4,116
,20130523,21200,21200,20585,20635,20250,20250,20470,-950,-730,28,573.29,134
,20130524,20250,20470,20230,20260,19900,20175,20190,-295,-280,28,565.35,126
,20130527,20175,20190,19760,20145,19760,19965,19965,-225,-225,14,279.57,124
,20130528,19965,19965,20065,20065,19715,19960,19890,-5,-75,32,636.63,120
,20130529,19960,19890,20030,20195,19525,19525,19750,-365,-140,20,395,128
,20130530,19525,19750,19505,19615,19385,19530,19515,-220,-235,36,702.59,144
,20130531,19530,19515,19790,19790,19560,19670,19650,155,135,10,196.52,154
,20130603,19670,19650,19735,19815,19575,19690,19685,40,35,22,433.14,156
,20130604,19690,19685,19780,19920,19780,19850,19850,165,165,22,436.75,144
,20130605,19850,19850,20000,20000,19720,19750,19775,-100,-75,32,632.84,154
,20130606,19750,19775,19650,19720,19180,19235,19325,-540,-450,24,463.85,144
,20130607,19235,19325,19250,19315,19115,19230,19210,-95,-115,60,"1,152.60",122
,20130613,19230,19210,18705,18820,18575,18640,18655,-570,-555,16,298.53,118
,20130614,18640,18655,18815,19050,18780,18990,18830,335,175,72,"1,355.78",86
,20130617,18990,18830,19140,19140,19140,19140,19140,310,310,2,38.28,84
,20130618,19140,19140,19050,19390,19050,19305,19270,165,130,56,"1,079.16",90
,20130619,19305,19270,19340,19530,19250,19530,19360,260,90,18,348.52,88
,20130620,19530,19360,19195,19205,18880,18900,18995,-460,-365,26,493.98,92
,20130621,18900,18995,18235,18645,18195,18590,18400,-405,-595,54,993.8,98
,20130624,18590,18400,18330,18335,17890,17890,18080,-510,-320,58,"1,048.77",84
,20130625,17890,18080,17990,18520,17990,18505,18330,425,250,38,696.59,86
,20130626,18505,18330,18500,18500,18225,18245,18355,-85,25,50,917.82,98
,20130627,18245,18355,18060,18280,17935,18120,18075,-235,-280,20,361.55,92
,20130628,18120,18075,18140,18140,17955,18030,18065,-45,-10,12,216.8,90
,20130701,18030,18065,18145,18375,18080,18375,18180,310,115,18,327.27,86
,20130702,18375,18180,18515,18565,18255,18470,18400,290,220,28,515.23,88
,20130703,18470,18400,18545,18570,18195,18400,18455,0,55,14,258.4,82
,20130704,18400,18455,18245,18620,18105,18535,18390,80,-65,178,"3,273.71",120
,20130705,18535,18390,18525,18525,18325,18325,18425,-65,35,16,294.84,118
,20130708,18325,18425,18140,18140,17570,17600,17820,-825,-605,70,"1,247.48",130
,20130709,17600,17820,17590,17800,17455,17455,17605,-365,-215,26,457.78,132
,20130710,17455,17605,17350,17600,17000,17600,17305,-5,-300,78,"1,350.17",138
,20130711,17600,17305,17810,18170,17760,18170,17940,865,635,30,538.32,136
,20130712,18170,17940,18170,18300,17870,17880,18080,-60,140,38,687.22,134
,20130715,17880,18080,17770,17890,17585,17635,17740,-445,-340,48,851.74,142
,20130716,17635,17740,17630,17900,17565,17900,17700,160,-40,22,389.4,140
,20130717,17900,17700,18015,18585,18005,18585,18410,885,710,116,"2,135.64",118
,20130718,18585,18410,18650,18650,18320,18650,18525,240,115,92,"1,704.57",128
,20130719,18650,18525,18960,19020,18695,18710,18885,185,360,62,"1,171.12",98
,20130722,18710,18885,18845,19115,18740,19115,18920,230,35,42,794.67,112
,20130723,19115,18920,18875,18960,18610,18610,18780,-310,-140,38,713.66,106
,20130724,18610,18780,18775,18845,18490,18845,18610,65,-170,20,372.22,102
,20130725,18845,18610,18780,18825,18720,18755,18750,145,140,34,637.62,114
,20130726,18755,18750,18775,18775,18390,18390,18620,-360,-130,12,223.48,110
,20130729,18390,18620,18085,18085,17890,17890,18035,-730,-585,38,685.49,104
,20130730,17890,18035,17970,18025,17830,17830,17905,-205,-130,32,573.07,104
,20130731,17830,17905,17955,18110,17900,18110,17990,205,85,34,611.76,116
,20130801,18110,17990,18320,18435,18220,18380,18365,390,375,60,"1,102.03",120
,20130802,18380,18365,18530,18530,18180,18260,18315,-105,-50,50,915.95,122
,20130805,18260,18315,18555,18555,18530,18530,18545,215,230,20,370.9,120
,20130806,18530,18545,18470,18685,18385,18685,18530,140,-15,42,778.42,102
,20130807,18685,18530,18780,18780,18560,18560,18630,30,100,30,558.91,102
,20130808,18560,18630,18745,19435,18745,19360,19105,730,475,56,"1,070.05",84
,20130809,19360,19105,19480,19630,19430,19430,19495,325,390,22,428.9,86
,20130812,19430,19495,19430,20075,19430,20075,19770,580,275,30,593.11,80
,20130813,20075,19770,19975,20065,19975,20050,20030,280,260,116,"2,323.82",146
,20130814,20050,20030,20135,20135,19860,20000,19995,-30,-35,16,319.96,140
,20130815,20000,19995,20035,20085,19800,19840,19965,-155,-30,48,958.39,118
,20130816,19840,19965,19920,19985,19920,19985,19950,20,-15,4,79.81,118
,20130819,19985,19950,19985,20370,19985,20295,20225,345,275,72,"1,456.26",118
,20130820,20295,20225,20100,20110,19705,19770,19870,-455,-355,52,"1,033.26",116
,20130821,19770,19870,19770,19850,19770,19820,19820,-50,-50,44,872.13,138
,20130822,19820,19820,19660,20175,19660,20090,20095,270,275,118,"2,371.49",138
,20130823,20090,20095,20415,20460,20195,20450,20320,355,225,42,853.5,150
,20130826,20450,20320,20945,21295,20945,20950,21010,630,690,16,336.21,146
,20130827,20950,21010,20830,20980,20685,20980,20830,-30,-180,40,833.22,150
,20130828,20980,20830,21140,21205,20655,20655,21040,-175,210,52,"1,094.22",152
,20130829,20655,21040,20430,20430,20115,20275,20215,-765,-825,18,363.93,146
,20130830,20275,20215,20450,20510,20135,20135,20330,-80,115,116,"2,358.68",146
,20130902,20135,20330,20680,21285,20680,21285,20995,955,665,34,713.95,150
,20130903,21285,20995,21625,21625,21250,21305,21385,310,390,58,"1,240.41",150
,20130904,21305,21385,21260,21260,20850,20850,21120,-535,-265,18,380.22,150
,20130905,20850,21120,21025,21025,20675,20990,20840,-130,-280,24,500.19,140
,20130906,20990,20840,20860,21085,20835,21010,20970,170,130,66,"1,384.26",140
,20130909,21010,20970,,,,20970,20970,0,0,0,0,140
,20130910,20970,20970,20950,20950,20560,20835,20740,-135,-230,74,"1,534.91",144
,20130911,20835,20740,20850,21040,20780,20785,20885,45,145,32,668.33,146
,20130912,20785,20885,20900,20900,20640,20640,20775,-245,-110,18,373.95,148
,20130913,20640,20775,20455,20485,20330,20480,20355,-295,-420,62,"1,262.19",150
,20130916,20480,20355,20585,20585,20445,20445,20525,90,170,16,328.43,140
,20130917,20445,20525,20560,20560,20560,20560,20560,35,35,2,41.12,142
,20130918,20560,20560,20495,20960,20380,20870,20720,310,160,102,"2,113.67",146
,20130923,20870,20720,20940,21045,20860,21040,20985,320,265,32,671.64,144
,20130924,21040,20985,21025,21160,20805,20860,21025,-125,40,36,756.98,140
,20130925,20860,21025,20835,20915,20795,20800,20825,-225,-200,32,666.52,142
,20130926,20800,20825,20735,20880,20630,20865,20725,40,-100,62,"1,285.15",142
,20130927,20865,20725,20805,20990,20545,20545,20750,-180,25,14,290.56,146
,20130930,20545,20750,20490,20545,20405,20435,20475,-315,-275,56,"1,146.83",146
,20131008,20435,20475,20830,20940,20655,20825,20780,350,305,70,"1,454.73",140
,20131009,20825,20780,20775,20800,20705,20760,20765,-20,-15,28,581.42,142
,20131010,20760,20765,20590,20590,20520,20520,20565,-245,-200,10,205.68,146
,20131011,20520,20565,20895,21025,20770,20895,20855,330,290,28,584.06,142
,20131014,20895,20855,21215,21370,20785,21305,21025,450,170,102,"2,144.77",174
,20131015,21305,21025,21380,21385,21275,21275,21320,250,295,40,852.86,162
,20131016,21275,21320,21300,21360,20950,21025,21145,-295,-175,68,"1,437.90",176
,20131017,21025,21145,21085,21300,20670,20675,20925,-470,-220,118,"2,469.22",156
,20131018,20675,20925,20630,20675,20555,20670,20640,-255,-285,10,206.41,156
,20131021,20670,20640,20485,20835,20485,20835,20690,195,50,38,786.4,178
,20131022,20835,20690,20840,20840,20635,20635,20730,-55,40,20,414.66,170
,20131023,20635,20730,20720,20720,20340,20340,20490,-390,-240,12,245.9,164
,20131024,20340,20490,20425,20495,20385,20430,20425,-60,-65,12,245.15,170
,20131025,20430,20425,20350,20510,19825,19825,20280,-600,-145,42,851.86,176
,20131028,19825,20280,19735,19735,19525,19530,19640,-750,-640,16,314.27,174
,20131029,19530,19640,19540,19745,19525,19715,19595,75,-45,26,509.58,172
,20131030,19715,19595,19750,19985,19485,19945,19660,350,65,178,"3,499.78",174
,20131031,19945,19660,19675,19675,19560,19665,19630,5,-30,28,549.64,168
,20131101,19665,19630,19520,19720,19520,19650,19640,20,10,130,"2,553.66",190
,20131104,19650,19640,19600,19635,19415,19530,19515,-110,-125,48,936.82,170
,20131105,19530,19515,19595,19595,19200,19425,19395,-90,-120,50,969.8,184
,20131106,19425,19395,19260,19295,19175,19175,19235,-220,-160,326,"6,270.88",172
,20131107,19175,19235,19240,19340,19240,19340,19285,105,50,6,115.73,176
,20131108,19340,19285,19405,19405,19380,19380,19395,95,110,6,116.38,178
,20131111,19380,19395,19220,19255,19105,19200,19190,-195,-205,18,345.49,172
,20131112,19200,19190,19095,19095,18925,18925,19005,-265,-185,8,152.05,170
,20131113,18925,19005,19050,19090,18990,18990,19030,-15,25,10,190.32,178
,20131114,18990,19030,19050,19130,19040,19055,19060,25,30,14,266.85,188
,20131115,19055,19060,19120,19205,19015,19025,19105,-35,45,34,649.73,194
,20131118,19025,19105,18795,18920,18770,18895,18855,-210,-250,42,792.07,212
,20131119,18895,18855,18730,18900,18730,18850,18820,-5,-35,28,527,212
,20131120,18850,18820,19080,19145,19080,19145,19100,325,280,6,114.61,216
,20131121,19145,19100,19050,19050,18885,18950,18940,-150,-160,30,568.28,224
,20131122,18950,18940,19090,19090,18830,18845,18945,-95,5,38,719.94,234
,20131125,18845,18945,18840,18850,18490,18490,18765,-455,-180,60,"1,126.08",264
,20131126,18490,18765,18550,18690,18525,18690,18575,-75,-190,48,891.76,276
,20131127,18690,18575,18600,18650,18565,18630,18595,55,20,106,"1,971.21",268
,20131128,18630,18595,18735,18980,18730,18955,18880,360,285,34,642.03,276
,20131129,18955,18880,19050,19365,19050,19350,19280,470,400,16,308.5,282
,20131202,19350,19280,19315,19330,19260,19310,19285,30,5,162,"3,124.63",344
,20131203,19310,19285,19260,19265,19070,19070,19180,-215,-105,66,"1,266.13",362
,20131204,19070,19180,19150,19360,19130,19305,19195,125,15,14,268.73,366
,20131205,19305,19195,19630,19630,19115,19160,19260,-35,65,26,500.86,358
,20131206,19160,19260,19110,19195,18970,19195,19070,-65,-190,16,305.19,358
,20131209,19195,19070,19260,19485,19230,19475,19415,405,345,82,"1,592.13",390
,20131210,19475,19415,19420,19495,19395,19395,19440,-20,25,18,349.95,384
,20131211,19395,19440,19485,19485,19305,19305,19390,-135,-50,62,"1,202.40",378
,20131212,19305,19390,19350,19805,19350,19805,19500,415,110,80,"1,560.17",398
,20131213,19805,19500,19680,19680,19495,19495,19580,-5,80,14,274.15,394
,20131216,19495,19580,19605,19605,19425,19425,19555,-155,-25,18,352.03,398
,20131217,19425,19555,19555,19555,19140,19140,19340,-415,-215,16,309.48,400
,20131218,19140,19340,19085,19085,18965,19035,19020,-305,-320,16,304.33,398
,20131219,19035,19020,19035,19035,18730,18745,18875,-275,-145,82,"1,547.78",416
,20131220,18745,18875,18875,18895,18875,18875,18875,0,0,22,415.29,394
,20131223,18875,18875,18370,18370,18295,18300,18320,-575,-555,6,109.93,396
,20131224,18300,18320,18200,18200,18025,18025,18175,-295,-145,54,981.67,432
,20131225,18025,18175,18130,18260,17930,18180,18185,5,10,98,"1,782.27",432
,20131226,18180,18185,18175,18225,18055,18125,18155,-60,-30,166,"3,013.89",464
,20131227,18125,18155,18145,18300,18125,18270,18215,115,60,58,"1,056.48",490
,20131230,18270,18215,18100,18100,17950,17995,18005,-220,-210,100,"1,800.96",430
,20131231,17995,18005,17965,17975,17875,17930,17925,-75,-80,10,179.26,430
ru1404,20130416,21100,21100,,,,21000,21000,-100,-100,0,0,0
,20130417,21000,21000,,,,21000,21000,0,0,0,0,0
,20130418,21000,21000,19210,20000,18965,19905,19620,-1095,-1380,14,274.69,6
,20130419,19905,19620,20450,20450,20450,20450,20450,830,830,2,40.9,8
,20130422,20450,20450,20020,20155,20020,20155,20085,-295,-365,4,80.35,6
,20130423,20155,20085,19560,19865,19280,19285,19580,-800,-505,12,234.98,12
,20130424,19285,19580,19970,20055,19205,19755,19645,175,65,32,628.78,14
,20130425,19755,19645,19690,19940,19665,19940,19765,295,120,6,118.59,16
,20130426,19940,19765,19990,19990,19990,19990,19990,225,225,2,39.98,16
,20130502,19990,19990,19470,19470,19470,19470,19470,-520,-520,2,38.94,14
,20130503,19470,19470,,,,20440,20440,970,970,0,0,14
,20130506,20440,20440,21000,21000,21000,21000,21000,560,560,2,42,14
,20130507,21000,21000,,,,21000,21000,0,0,0,0,14
,20130508,21000,21000,20820,20885,20820,20885,20860,-115,-140,6,125.18,16
,20130509,20885,20860,21035,21035,21030,21030,21030,170,170,6,126.19,14
,20130510,21030,21030,21125,21125,21110,21110,21115,80,85,4,84.47,12
,20130513,21110,21115,21400,21400,21400,21400,21400,285,285,2,42.8,12
,20130514,21400,21400,21415,21415,21205,21205,21310,-195,-90,4,85.24,16
,20130515,21205,21310,20935,20935,20875,20875,20905,-435,-405,4,83.62,14
,20130516,20875,20905,20510,20695,20510,20695,20600,-210,-305,4,82.41,16
,20130517,20695,20600,21160,21265,21160,21265,21210,665,610,4,84.85,20
,20130520,21265,21210,21440,21440,21235,21290,21335,80,125,14,298.69,24
,20130521,21290,21335,21395,21400,21135,21135,21310,-200,-25,6,127.86,26
,20130522,21135,21310,21195,21270,21085,21265,21200,-45,-110,10,212.03,24
,20130523,21265,21200,20940,20940,20140,20140,20360,-1060,-840,22,448.01,34
,20130524,20140,20360,21355,21355,20180,20180,20305,-180,-55,30,609.29,38
,20130527,20180,20305,19925,20250,19905,20200,20090,-105,-215,20,401.85,50
,20130528,20200,20090,20095,20095,19910,19910,19960,-180,-130,16,319.36,52
,20130529,19910,19960,19960,19960,19570,19570,19680,-390,-280,12,236.16,58
,20130530,19570,19680,19500,19600,19500,19600,19510,-80,-170,66,"1,287.66",122
,20130531,19600,19510,19900,19910,19570,19570,19795,60,285,42,831.56,146
,20130603,19570,19795,19755,19755,19700,19720,19725,-75,-70,6,118.35,144
,20130604,19720,19725,19990,19990,19970,19970,19980,245,255,6,119.9,142
,20130605,19970,19980,19800,19850,19800,19840,19820,-140,-160,18,356.82,148
,20130606,19840,19820,19740,19740,19280,19280,19510,-540,-310,4,78.04,148
,20130607,19280,19510,19140,19315,19140,19315,19235,-195,-275,36,692.54,150
,20130613,19315,19235,19000,19000,18685,18750,18800,-485,-435,22,413.7,150
,20130614,18750,18800,18890,19095,18875,19070,18970,270,170,28,531.17,142
,20130617,19070,18970,19230,19435,19230,19275,19300,305,330,24,463.24,126
,20130618,19275,19300,19160,19430,19160,19405,19295,105,-5,22,424.53,122
,20130619,19405,19295,19555,19555,19555,19555,19555,260,260,2,39.11,122
,20130620,19555,19555,19430,19430,19020,19020,19280,-535,-275,10,192.82,124
,20130621,19020,19280,18500,18800,18500,18720,18635,-560,-645,16,298.22,120
,20130624,18720,18635,18575,18575,18215,18240,18430,-395,-205,34,626.65,110
,20130625,18240,18430,18200,18550,17815,18520,18235,90,-195,22,401.19,100
,20130626,18520,18235,18440,18440,18075,18075,18235,-160,0,10,182.39,98
,20130627,18075,18235,18010,18300,18010,18050,18130,-185,-105,8,145.04,94
,20130628,18050,18130,18195,18200,18195,18200,18195,70,65,4,72.79,90
,20130701,18200,18195,18145,18330,18140,18300,18290,105,95,28,512.19,92
,20130702,18300,18290,,,,18290,18290,0,0,0,0,92
,20130703,18290,18290,,,,18290,18290,0,0,0,0,92
,20130704,18290,18290,18245,18865,18245,18645,18560,355,270,42,779.71,82
,20130705,18645,18560,18650,18650,18450,18450,18545,-110,-15,12,222.59,80
,20130708,18450,18545,18245,18405,17730,17730,18140,-815,-405,12,217.7,80
,20130709,17730,18140,17690,17975,17665,17665,17820,-475,-320,56,998.05,88
,20130710,17665,17820,17625,17700,17500,17700,17625,-120,-195,10,176.25,86
,20130711,17700,17625,17955,18505,17920,18465,18330,840,705,32,586.62,98
,20130712,18465,18330,18280,18415,18035,18035,18285,-295,-45,150,"2,743.06",152
,20130715,18035,18285,17995,18060,17730,17755,17925,-530,-360,46,824.6,126
,20130716,17755,17925,17835,17835,17835,17835,17835,-90,-90,2,35.67,126
,20130717,17835,17835,18000,18685,18000,18570,18315,735,480,70,"1,282.34",136
,20130718,18570,18315,18555,18555,18485,18485,18530,170,215,10,185.32,136
,20130719,18485,18530,19090,19090,18830,18830,19005,300,475,38,722.33,128
,20130722,18830,19005,18815,19030,18815,19010,18960,5,-45,28,530.91,114
,20130723,19010,18960,18915,18940,18720,18770,18780,-190,-180,472,"8,866.08",322
,20130724,18770,18780,18860,18860,18650,18675,18700,-105,-80,40,748.19,310
,20130725,18675,18700,18880,18950,18865,18950,18895,250,195,10,188.99,310
,20130726,18950,18895,18940,18940,18710,18725,18790,-170,-105,6,112.75,308
,20130729,18725,18790,18725,18725,18000,18005,18215,-785,-575,14,255.06,312
,20130730,18005,18215,18075,18175,17985,17990,18055,-225,-160,80,"1,444.77",344
,20130731,17990,18055,18145,18165,18135,18165,18145,110,90,18,326.69,344
,20130801,18165,18145,18315,18470,18185,18470,18385,325,240,22,404.55,340
,20130802,18470,18385,18625,18640,18325,18415,18420,30,35,148,"2,726.65",338
,20130805,18415,18420,18280,18630,18275,18630,18545,210,125,158,"2,930.36",362
,20130806,18630,18545,18600,18795,18480,18740,18585,195,40,28,520.42,360
,20130807,18740,18585,18805,18805,18610,18625,18660,40,75,14,261.24,348
,20130808,18625,18660,18800,19585,18800,19485,19220,825,560,32,615.09,350
,20130809,19485,19220,19625,19725,19610,19610,19640,390,420,16,314.25,360
,20130812,19610,19640,19765,20170,19765,20170,20090,530,450,46,924.31,364
,20130813,20170,20090,20095,20270,20095,20250,20175,160,85,18,363.15,356
,20130814,20250,20175,20180,20180,20120,20120,20150,-55,-25,4,80.6,356
,20130815,20120,20150,20185,20185,19930,19930,19980,-220,-170,10,199.83,352
,20130816,19930,19980,20070,20560,20070,20290,20250,310,270,88,"1,782.09",284
,20130819,20290,20250,20280,20410,20230,20310,20300,60,50,108,"2,192.64",248
,20130820,20310,20300,20005,20005,19900,19900,19925,-400,-375,8,159.41,250
,20130821,19900,19925,19965,19970,19965,19970,19965,45,40,4,79.87,246
,20130822,19970,19965,19890,20440,19890,20235,19970,270,5,142,"2,835.95",294
,20130823,20235,19970,20590,20590,20395,20590,20550,620,580,32,657.66,298
,20130826,20590,20550,21035,21140,20905,21120,21050,570,500,20,421.07,294
,20130827,21120,21050,20990,20990,20875,20990,20950,-60,-100,16,335.25,286
,20130828,20990,20950,21070,21175,20565,20565,21060,-385,110,20,421.23,282
,20130829,20565,21060,20675,20675,20610,20610,20645,-450,-415,6,123.88,280
,20130830,20610,20645,20595,20595,20225,20340,20365,-305,-280,12,244.42,280
,20130902,20340,20365,20500,21380,20500,21380,20975,1015,610,22,461.48,280
,20130903,21380,20975,21620,21650,21330,21425,21435,450,460,52,"1,114.87",246
,20130904,21425,21435,21040,21040,20985,21040,21025,-395,-410,16,336.42,248
,20130905,21040,21025,21140,21175,20890,21080,21040,55,15,74,"1,557.02",220
,20130906,21080,21040,21110,21150,21110,21150,21135,110,95,18,380.46,222
,20130909,21150,21135,21240,21290,21195,21280,21240,145,105,54,"1,147.03",202
,20130910,21280,21240,21010,21010,20870,20980,20950,-260,-290,6,125.72,200
,20130911,20980,20950,21055,21110,20895,21110,20970,160,20,34,713.08,192
,20130912,21110,20970,21015,21015,20620,20650,20830,-320,-140,36,749.99,180
,20130913,20650,20830,20595,20595,20425,20425,20540,-405,-290,14,287.56,172
,20130916,20425,20540,20660,20750,20560,20585,20590,45,50,152,"3,129.69",230
,20130917,20585,20590,20365,20670,20365,20620,20600,30,10,16,329.6,222
,20130918,20620,20600,21040,21130,20965,21130,21060,530,460,8,168.49,224
,20130923,21130,21060,20915,21255,20905,21255,21075,195,15,12,252.93,228
,20130924,21255,21075,21175,21175,21020,21020,21135,-55,60,14,295.89,220
,20130925,21020,21135,20875,20920,20845,20860,20885,-275,-250,20,417.77,222
,20130926,20860,20885,20795,20905,20730,20870,20795,-15,-90,32,665.54,218
,20130927,20870,20795,20865,21015,20535,20535,20785,-260,-10,36,748.43,204
,20130930,20535,20785,20535,20535,20400,20400,20405,-385,-380,42,857.07,164
,20131008,20400,20405,,,,20710,20710,305,305,0,0,164
,20131009,20710,20710,20770,20805,20770,20775,20785,65,75,18,374.14,156
,20131010,20775,20785,20630,20630,20620,20620,20625,-165,-160,14,288.77,156
,20131011,20620,20625,21080,21080,20875,20875,20920,250,295,10,209.2,156
,20131014,20875,20920,20870,20870,20830,20830,20850,-90,-70,4,83.4,152
,20131015,20830,20850,21290,21385,21235,21305,21300,455,450,26,553.87,148
,20131016,21305,21300,21345,21400,21090,21100,21235,-200,-65,32,679.54,138
,20131017,21100,21235,21280,21330,20705,20705,20990,-530,-245,36,755.65,120
,20131018,20705,20990,20620,20720,20555,20720,20625,-270,-365,10,206.29,118
,20131021,20720,20625,20595,20955,20595,20905,20820,280,195,12,249.87,116
,20131022,20905,20820,20780,20780,20720,20735,20740,-85,-80,12,248.91,108
,20131023,20735,20740,20470,20470,20355,20355,20390,-385,-350,24,489.38,86
,20131024,20355,20390,20115,20305,20115,20305,20210,-85,-180,4,80.84,82
,20131025,20305,20210,20400,20455,19800,19800,20255,-410,45,364,"7,373.53",136
,20131028,19800,20255,19740,19825,19685,19685,19745,-570,-510,12,236.97,132
,20131029,19685,19745,19605,19795,19605,19755,19705,10,-40,56,"1,103.60",88
,20131030,19755,19705,19860,20000,19860,20000,19950,295,245,6,119.72,82
,20131031,20000,19950,19780,19800,19540,19650,19655,-300,-295,40,786.34,68
,20131101,19650,19655,19580,19810,19580,19810,19700,155,45,18,354.6,64
,20131104,19810,19700,19700,19760,19510,19590,19660,-110,-40,84,"1,651.63",70
,20131105,19590,19660,19270,19570,19220,19470,19450,-190,-210,46,894.89,72
,20131106,19470,19450,19385,19465,19295,19295,19390,-155,-60,28,542.97,74
,20131107,19295,19390,19585,19585,19495,19495,19545,105,155,6,117.28,74
,20131108,19495,19545,19480,19575,19480,19520,19535,-25,-10,26,507.92,76
,20131111,19520,19535,19540,19540,19310,19370,19425,-165,-110,36,699.44,82
,20131112,19370,19425,19350,19350,19110,19150,19190,-275,-235,16,307.05,92
,20131113,19150,19190,19150,19230,19150,19180,19175,-10,-15,12,230.11,92
,20131114,19180,19175,19315,19315,19210,19210,19260,35,85,44,847.51,80
,20131115,19210,19260,19310,19450,19215,19220,19300,-40,40,20,386.04,86
,20131118,19220,19300,19055,19055,19055,19055,19055,-245,-245,2,38.11,86
,20131119,19055,19055,18890,19015,18890,19015,18960,-40,-95,16,303.38,86
,20131120,19015,18960,,,,18960,18960,0,0,0,0,86
,20131121,18960,18960,19115,19135,19045,19135,19095,175,135,22,420.1,92
,20131122,19135,19095,,,,19045,19045,-50,-50,0,0,92
,20131125,19045,19045,19060,19060,18770,18770,18970,-275,-75,16,303.55,92
,20131126,18770,18970,18770,18780,18770,18775,18775,-195,-195,12,225.31,90
,20131127,18775,18775,18815,18840,18740,18825,18790,50,15,24,451,96
,20131128,18825,18790,18925,19145,18925,19125,19070,335,280,18,343.26,94
,20131129,19125,19070,19195,19350,19195,19350,19240,280,170,14,269.42,90
,20131202,19350,19240,19460,19500,19460,19500,19480,260,240,36,701.33,90
,20131203,19500,19480,19330,19340,19260,19260,19310,-220,-170,6,115.86,86
,20131204,19260,19310,19300,19490,19235,19465,19335,155,25,16,309.43,86
,20131205,19465,19335,19370,19380,19300,19315,19325,-20,-10,16,309.25,84
,20131206,19315,19325,19165,19285,19145,19145,19210,-180,-115,30,576.42,84
,20131209,19145,19210,19670,19670,19590,19590,19630,380,420,4,78.52,86
,20131210,19590,19630,19650,19650,19555,19555,19615,-75,-15,6,117.71,88
,20131211,19555,19615,19620,19620,19550,19570,19590,-45,-25,40,783.62,90
,20131212,19570,19590,19905,19980,19800,19980,19900,390,310,34,676.71,96
,20131213,19980,19900,19745,19770,19630,19650,19715,-250,-185,40,788.79,96
,20131216,19650,19715,19610,19630,19610,19630,19620,-85,-95,4,78.48,96
,20131217,19630,19620,19580,19580,19255,19255,19440,-365,-180,12,233.31,92
,20131218,19255,19440,19180,19210,19075,19100,19150,-340,-290,54,"1,034.19",102
,20131219,19100,19150,19105,19115,18880,18930,18935,-220,-215,182,"3,446.60",98
,20131220,18930,18935,,,,18935,18935,0,0,0,0,98
,20131223,18935,18935,18650,18650,18375,18390,18470,-545,-465,24,443.29,88
,20131224,18390,18470,18375,18375,18225,18225,18310,-245,-160,20,366.26,88
,20131225,18225,18310,18310,18415,18005,18250,18270,-60,-40,34,621.25,88
,20131226,18250,18270,18270,18270,18235,18235,18250,-35,-20,4,73.01,88
,20131227,18235,18250,18295,18365,18120,18365,18260,115,10,8,146.09,88
,20131230,18365,18260,18095,18205,18080,18160,18135,-100,-125,20,362.75,90
,20131231,18160,18135,18015,18095,17970,17970,18030,-165,-105,10,180.31,92
ru1405,20130516,20905,20905,20295,20815,20295,20760,20655,-145,-250,8,165.24,0
,20130517,20760,20655,,,,21050,21050,395,395,0,0,0
,20130520,21050,21050,21320,21560,21320,21400,21500,350,450,42,903.14,34
,20130521,21400,21500,21400,21710,21185,21335,21500,-165,0,26,559.08,36
,20130522,21335,21500,21490,21490,21265,21265,21375,-235,-125,4,85.51,36
,20130523,21265,21375,21055,21055,20305,20335,20615,-1040,-760,144,"2,968.95",100
,20130524,20335,20615,20380,20550,20220,20300,20350,-315,-265,110,"2,238.87",118
,20130527,20300,20350,20050,20290,19960,20070,20130,-280,-220,44,885.76,124
,20130528,20070,20130,20240,20240,19920,20100,20105,-30,-25,38,763.99,138
,20130529,20100,20105,20105,20390,19700,19770,20080,-335,-25,64,"1,285.14",152
,20130530,19770,20080,19420,19865,19415,19865,19645,-215,-435,54,"1,060.88",150
,20130531,19865,19645,20070,20135,19705,19705,19960,60,315,120,"2,395.20",202
,20130603,19705,19960,19780,19930,19780,19900,19865,-60,-95,42,834.37,214
,20130604,19900,19865,20030,20205,19960,20060,20090,195,225,52,"1,044.83",234
,20130605,20060,20090,20150,20210,19880,19965,20015,-125,-75,60,"1,200.92",250
,20130606,19965,20015,19780,19850,19330,19350,19565,-665,-450,124,"2,426.61",274
,20130607,19350,19565,19465,19465,19280,19405,19375,-160,-190,100,"1,937.86",306
,20130613,19405,19375,18880,19190,18760,18885,18940,-490,-435,160,"3,030.43",380
,20130614,18885,18940,18980,19385,18960,19385,19100,445,160,68,"1,299.12",394
,20130617,19385,19100,19245,19510,19210,19350,19355,250,255,88,"1,703.66",380
,20130618,19350,19355,19215,19580,19190,19580,19480,225,125,258,"5,026.88",494
,20130619,19580,19480,19645,19870,19410,19850,19575,370,95,322,"6,304.24",586
,20130620,19850,19575,19560,19645,19110,19150,19355,-425,-220,514,"9,948.52",724
,20130621,19150,19355,18850,19040,18385,18995,18745,-360,-610,996,"18,670.27",976
,20130624,18995,18745,18905,18980,18085,18085,18520,-660,-225,1040,"19,265.79",1034
,20130625,18085,18520,18195,18780,18025,18680,18415,160,-105,1106,"20,369.14",1088
,20130626,18680,18415,18820,18875,18085,18085,18435,-330,20,778,"14,344.71",1080
,20130627,18085,18435,18155,18500,18050,18245,18255,-190,-180,764,"13,950.47",1096
,20130628,18245,18255,18130,18465,17965,18270,18295,15,40,508,"9,294.75",1168
,20130701,18270,18295,18250,18685,18175,18650,18445,355,150,554,"10,220.10",1178
,20130702,18650,18445,18900,18900,18600,18680,18730,235,285,612,"11,463.32",1224
,20130703,18680,18730,18795,18830,18390,18580,18615,-150,-115,940,"17,500.23",1334
,20130704,18580,18615,18590,18830,18465,18750,18710,135,95,1492,"27,916.87",1432
,20130705,18750,18710,18710,18800,18430,18455,18625,-255,-85,1734,"32,302.45",1718
,20130708,18455,18625,18495,18500,17755,17820,18045,-805,-580,2252,"40,648.23",2052
,20130709,17820,18045,17945,18025,17680,17705,17880,-340,-165,1718,"30,726.17",2320
,20130710,17705,17880,17650,17850,17455,17830,17660,-50,-220,2638,"46,587.45",2384
,20130711,17830,17660,18040,18540,17990,18540,18250,880,590,3800,"69,353.48",2296
,20130712,18540,18250,18535,18535,17980,17980,18300,-270,50,2770,"50,693.62",2464
,20130715,17980,18300,17980,18200,17800,17865,18015,-435,-285,3810,"68,651.29",2406
,20130716,17865,18015,17920,18175,17745,18145,17925,130,-90,4140,"74,219.98",2680
,20130717,18145,17925,18190,18820,18110,18785,18560,860,635,5366,"99,603.31",2848
,20130718,18785,18560,18610,18920,18550,18880,18715,320,155,4570,"85,540.46",2924
,20130719,18880,18715,19260,19310,18875,18960,19120,245,405,4518,"86,394.05",3208
,20130722,18960,19120,19200,19230,18910,19160,19095,40,-25,3594,"68,631.17",3342
,20130723,19160,19095,19000,19200,18780,18820,18990,-275,-105,6142,"116,643.89",4580
,20130724,18820,18990,18770,19075,18580,19060,18800,70,-190,7946,"149,409.36",5202
,20130725,19060,18800,18950,19110,18820,19005,18955,205,155,7188,"136,272.03",5938
,20130726,19005,18955,19005,19080,18515,18580,18755,-375,-200,7954,"149,211.47",6500
,20130729,18580,18755,18220,18305,17940,18050,18145,-705,-610,7100,"128,856.74",6462
,20130730,18050,18145,18100,18225,17955,17955,18085,-190,-60,6092,"110,201.33",6962
,20130731,17955,18085,17880,18360,17850,18335,18130,250,45,11330,"205,430.19",7356
,20130801,18335,18130,18350,18620,18310,18535,18455,405,325,12426,"229,376.40",7668
,20130802,18535,18455,18600,18745,18310,18420,18540,-35,85,13088,"242,656.35",8142
,20130805,18420,18540,18400,18750,18265,18720,18595,180,55,12476,"232,017.02",8510
,20130806,18720,18595,18665,18880,18520,18850,18700,255,105,12726,"238,033.38",8806
,20130807,18850,18700,18760,18940,18650,18700,18765,0,65,17512,"328,617.74",8738
,20130808,18700,18765,18870,19660,18870,19525,19370,760,605,35968,"696,759.00",9136
,20130809,19525,19370,19600,19850,19585,19780,19720,410,350,30890,"609,258.24",10052
,20130812,19780,19720,19885,20320,19760,20205,19980,485,260,26214,"523,834.66",11194
,20130813,20205,19980,20170,20390,20115,20280,20240,300,260,24574,"497,476.90",11604
,20130814,20280,20240,20280,20430,20030,20140,20195,-100,-45,29050,"586,734.65",11626
,20130815,20140,20195,20225,20365,19930,19995,20110,-200,-85,28424,"571,629.48",12326
,20130816,19995,20110,20110,20750,20040,20365,20295,255,185,43110,"875,072.82",13632
,20130819,20365,20295,20430,20610,20260,20350,20430,55,135,32042,"654,725.44",14570
,20130820,20350,20430,20220,20335,19855,19990,20110,-440,-320,33866,"681,096.27",16360
,20130821,19990,20110,20075,20155,19950,20060,20045,-50,-65,30914,"619,702.23",17750
,20130822,20060,20045,19920,20540,19840,20400,20280,355,235,44388,"900,287.87",19862
,20130823,20400,20280,20430,20835,20365,20825,20610,545,330,56174,"1,157,925.59",19998
,20130826,20825,20610,21200,21330,20945,21140,21140,530,530,42578,"900,242.06",19954
,20130827,21140,21140,21000,21200,20810,21150,21015,10,-125,39548,"831,164.82",20330
,20130828,21150,21015,21115,21420,20645,20670,21075,-345,60,57214,"1,206,063.62",20640
,20130829,20670,21075,20700,20790,20335,20655,20625,-420,-450,57056,"1,177,028.51",21632
,20130830,20655,20625,20510,20745,20280,20495,20550,-130,-75,52102,"1,070,733.57",23176
,20130902,20495,20550,20650,21575,20615,21575,21205,1025,655,76556,"1,623,651.64",34782
,20130903,21575,21205,21680,21860,21285,21565,21555,360,350,70220,"1,513,630.89",33146
,20130904,21565,21555,21675,21675,21075,21200,21310,-355,-245,73624,"1,569,172.54",35252
,20130905,21200,21310,21155,21340,20800,21225,21095,-85,-215,87464,"1,845,133.45",37288
,20130906,21225,21095,21215,21330,20940,21220,21125,125,30,64722,"1,367,281.08",38352
,20130909,21220,21125,21470,21570,21180,21260,21310,135,185,53736,"1,145,248.89",39838
,20130910,21260,21310,21200,21215,20835,21050,21000,-260,-310,71918,"1,510,618.49",39390
,20130911,21050,21000,21080,21290,20920,21255,21120,255,120,104442,"2,205,970.21",43668
,20130912,21255,21120,21095,21140,20685,20685,20940,-435,-180,86462,"1,810,719.04",43582
,20130913,20685,20940,20645,20755,20465,20685,20620,-255,-320,85570,"1,764,557.57",43410
,20130916,20685,20620,20795,20900,20450,20565,20705,-55,85,79482,"1,646,023.15",41172
,20130917,20565,20705,20510,20850,20350,20850,20660,145,-45,97010,"2,004,238.50",41114
,20130918,20850,20660,20800,21220,20605,21190,20875,530,215,98686,"2,060,429.39",40802
,20130923,21190,20875,20955,21350,20885,21300,21145,425,270,88302,"1,867,385.18",47156
,20130924,21300,21145,21195,21325,20920,20975,21115,-170,-30,92824,"1,960,436.08",49032
,20130925,20975,21115,20915,21045,20805,20825,20905,-290,-210,84530,"1,767,479.42",49074
,20130926,20825,20905,20750,20970,20675,20860,20790,-45,-115,76554,"1,591,569.32",46924
,20130927,20860,20790,20890,21030,20430,20500,20715,-290,-75,74246,"1,538,086.93",45608
,20130930,20500,20715,20380,20650,20355,20370,20490,-345,-225,38076,"780,290.72",43132
,20131008,20370,20490,20250,21060,20225,20860,20745,370,255,46042,"955,292.72",44596
,20131009,20860,20745,20850,20890,20705,20845,20805,100,60,49688,"1,033,960.32",49440
,20131010,20845,20805,20680,20750,20505,20615,20630,-190,-175,54112,"1,116,568.23",52628
,20131011,20615,20630,20735,21195,20730,20860,20955,230,325,95982,"2,011,451.99",50890
,20131014,20860,20955,20905,21450,20785,21395,21080,440,125,118202,"2,492,287.24",59378
,20131015,21395,21080,21400,21450,21205,21360,21335,280,255,99224,"2,117,261.42",59760
,20131016,21360,21335,21260,21490,20900,21095,21195,-240,-140,123154,"2,610,259.42",61086
,20131017,21095,21195,21355,21415,20610,20620,21010,-575,-185,158216,"3,324,230.30",58660
,20131018,20620,21010,20660,20800,20535,20690,20685,-320,-325,128062,"2,648,985.41",58484
,20131021,20690,20685,20655,21035,20550,20975,20810,290,125,155032,"3,226,726.85",69872
,20131022,20975,20810,20950,21055,20645,20655,20860,-155,50,170436,"3,555,380.77",68564
,20131023,20655,20860,20720,20835,20325,20355,20540,-505,-320,220742,"4,534,639.33",77326
,20131024,20355,20540,20370,20575,20035,20465,20365,-75,-175,301086,"6,133,081.19",91508
,20131025,20465,20365,20500,20550,19750,19755,20215,-610,-150,340536,"6,884,575.63",97946
,20131028,19755,20215,19885,19900,19590,19690,19750,-525,-465,262618,"5,187,917.69",99862
,20131029,19690,19750,19700,19965,19600,19840,19770,90,20,377578,"7,466,410.15",109292
,20131030,19840,19770,19965,20200,19790,20075,20000,305,230,454308,"9,086,601.20",118940
,20131031,20075,20000,19950,19960,19580,19725,19745,-275,-255,520166,"10,272,112.68",125542
,20131101,19725,19745,19630,19945,19505,19920,19770,175,25,527926,"10,437,947.84",132120
,20131104,19920,19770,19840,19915,19605,19725,19735,-45,-35,455432,"8,988,550.90",133686
,20131105,19725,19735,19700,19780,19300,19480,19515,-255,-220,563586,"11,000,110.18",145488
,20131106,19480,19515,19510,19575,19365,19425,19465,-90,-50,514662,"10,018,671.12",152236
,20131107,19425,19465,19430,19680,19315,19615,19525,150,60,530160,"10,351,471.10",157654
,20131108,19615,19525,19555,19700,19435,19470,19575,-55,50,525690,"10,292,093.99",152278
,20131111,19470,19575,19640,19655,19320,19410,19460,-165,-115,502018,"9,770,235.91",167218
,20131112,19410,19460,19415,19465,19150,19260,19280,-200,-180,503100,"9,700,685.91",177174
,20131113,19260,19280,19165,19390,19090,19250,19230,-30,-50,491340,"9,449,785.69",165036
,20131114,19250,19230,19290,19435,19250,19320,19330,90,100,418792,"8,096,881.77",171634
,20131115,19320,19330,19395,19530,19145,19150,19375,-180,45,543572,"10,532,185.84",174740
,20131118,19150,19375,19210,19225,19045,19130,19150,-245,-225,369678,"7,080,098.79",175866
,20131119,19130,19150,19000,19250,18960,19230,19105,80,-45,447752,"8,555,925.13",178854
,20131120,19230,19105,19200,19435,19190,19365,19340,260,235,438990,"8,490,598.43",179386
,20131121,19365,19340,19340,19355,19110,19195,19215,-145,-125,429786,"8,259,963.52",182318
,20131122,19195,19215,19320,19495,19030,19095,19265,-120,50,484702,"9,339,192.60",195828
,20131125,19095,19265,19200,19210,18835,18850,19060,-415,-205,488890,"9,320,507.64",208894
,20131126,18850,19060,18905,19080,18820,18935,18935,-125,-125,480746,"9,104,430.27",200860
,20131127,18935,18935,18875,19030,18850,18980,18935,45,0,383176,"7,256,364.24",200586
,20131128,18980,18935,18935,19330,18935,19265,19200,330,265,555302,"10,663,656.46",187730
,20131129,19265,19200,19485,19765,19325,19695,19500,495,300,545714,"10,642,264.01",197138
,20131202,19695,19500,19700,19745,19570,19690,19655,190,155,385570,"7,580,040.46",194242
,20131203,19690,19655,19610,19640,19380,19450,19485,-205,-170,439402,"8,563,866.03",196810
,20131204,19450,19485,19480,19690,19405,19615,19550,130,65,466912,"9,129,319.43",205498
,20131205,19615,19550,19740,19750,19360,19410,19520,-140,-30,461116,"9,001,188.51",218960
,20131206,19410,19520,19405,19595,19285,19545,19425,25,-95,495774,"9,631,210.46",215394
,20131209,19545,19425,19650,19875,19560,19830,19760,405,335,449806,"8,890,053.68",218308
,20131210,19830,19760,19800,19885,19700,19795,19790,35,30,361060,"7,147,102.33",216966
,20131211,19795,19790,19840,19930,19590,19635,19710,-155,-80,398814,"7,861,674.85",206710
,20131212,19635,19710,19685,20180,19660,20130,19945,420,235,559016,"11,151,260.15",214556
,20131213,20130,19945,20085,20100,19705,19885,19850,-60,-95,531814,"10,558,771.01",190524
,20131216,19885,19850,19990,20050,19730,19795,19850,-55,0,366246,"7,271,308.64",188734
,20131217,19795,19850,19860,19880,19375,19410,19590,-440,-260,515480,"10,100,686.90",203910
,20131218,19410,19590,19405,19445,19140,19150,19295,-440,-295,422798,"8,157,894.03",203766
,20131219,19150,19295,19210,19315,18975,19055,19145,-240,-150,460308,"8,813,681.53",207294
,20131220,19055,19145,19100,19195,18845,18850,19065,-295,-80,470696,"8,974,145.19",201250
,20131223,18850,19065,18880,18995,18470,18520,18690,-545,-375,527682,"9,862,403.22",218194
,20131224,18520,18690,18500,18510,18255,18310,18380,-380,-310,401512,"7,380,854.93",221236
,20131225,18310,18380,18410,18580,18155,18415,18385,35,5,543094,"9,985,200.14",215090
,20131226,18415,18385,18450,18545,18315,18365,18410,-20,25,423596,"7,800,117.22",215734
,20131227,18365,18410,18400,18625,18360,18430,18475,20,65,407796,"7,535,403.05",207288
,20131230,18430,18475,18475,18535,18145,18265,18325,-210,-150,385832,"7,071,598.45",216406
,20131231,18265,18325,18225,18345,18060,18140,18205,-185,-120,427804,"7,790,180.33",209922
ru1406,20130618,19355,19355,19380,19600,19380,19600,19490,245,135,4,77.96,4
,20130619,19600,19490,19590,19695,19590,19695,19630,205,140,8,157.04,6
,20130620,19695,19630,,,,19350,19350,-280,-280,0,0,6
,20130621,19350,19350,18995,19000,18920,18920,18970,-430,-380,6,113.83,8
,20130624,18920,18970,,,,18745,18745,-225,-225,0,0,8
,20130625,18745,18745,,,,18640,18640,-105,-105,0,0,8
,20130626,18640,18640,,,,18660,18660,20,20,0,0,8
,20130627,18660,18660,18485,18485,18485,18485,18485,-175,-175,2,36.97,8
,20130628,18485,18485,,,,18525,18525,40,40,0,0,8
,20130701,18525,18525,,,,18525,18525,0,0,0,0,8
,20130702,18525,18525,18715,18715,18660,18660,18670,135,145,8,149.39,12
,20130703,18660,18670,,,,18670,18670,0,0,0,0,12
,20130704,18670,18670,,,,18670,18670,0,0,0,0,12
,20130705,18670,18670,,,,18670,18670,0,0,0,0,12
,20130708,18670,18670,,,,18090,18090,-580,-580,0,0,12
,20130709,18090,18090,17900,17990,17865,17865,17930,-225,-160,10,179.3,16
,20130710,17865,17930,17600,17600,17600,17600,17600,-330,-330,2,35.2,14
,20130711,17600,17600,18120,18120,18040,18040,18070,440,470,6,108.43,18
,20130712,18040,18070,18445,18445,18430,18430,18435,360,365,4,73.75,16
,20130715,18430,18435,17990,17990,17990,17990,17990,-445,-445,4,71.96,18
,20130716,17990,17990,,,,17990,17990,0,0,0,0,18
,20130717,17990,17990,18200,18705,18200,18685,18555,695,565,8,148.45,22
,20130718,18685,18555,18750,18820,18680,18680,18750,125,195,6,112.5,20
,20130719,18680,18750,19090,19090,19090,19090,19090,340,340,2,38.18,22
,20130722,19090,19090,19140,19140,19140,19140,19140,50,50,2,38.28,20
,20130723,19140,19140,19000,19000,19000,19000,19000,-140,-140,4,76,20
,20130724,19000,19000,,,,18810,18810,-190,-190,0,0,20
,20130725,18810,18810,,,,18965,18965,155,155,0,0,20
,20130726,18965,18965,18740,18740,18640,18640,18675,-325,-290,6,112.06,24
,20130729,18640,18675,18245,18245,17880,17950,18010,-725,-665,592,"10,662.34",450
,20130730,17950,18010,17950,17970,17795,17850,17930,-160,-80,554,"9,934.03",844
,20130731,17850,17930,17830,17985,17715,17975,17845,45,-85,240,"4,283.49",1004
,20130801,17975,17845,18035,18310,17980,18180,18155,335,310,132,"2,396.79",1004
,20130802,18180,18155,18330,18330,18020,18135,18225,-20,70,52,947.93,1008
,20130805,18135,18225,18105,18440,18105,18410,18270,185,45,46,840.42,1008
,20130806,18410,18270,18370,18570,18320,18570,18480,300,210,24,443.63,1008
,20130807,18570,18480,18475,18600,18470,18500,18510,20,30,24,444.28,1006
,20130808,18500,18510,18730,19295,18730,19265,19055,755,545,22,419.26,1004
,20130809,19265,19055,19500,19540,19425,19520,19500,465,445,18,351.04,1004
,20130812,19520,19500,19665,20015,19640,20000,19840,500,340,1020,"20,239.33",368
,20130813,20000,19840,20100,20120,20100,20120,20110,280,270,4,80.44,368
,20130814,20120,20110,20060,20150,19900,19975,19990,-135,-120,46,919.62,346
,20130815,19975,19990,20075,20075,19765,19845,19895,-145,-95,6,119.37,348
,20130816,19845,19895,19965,20265,19965,20230,20115,335,220,10,201.15,346
,20130819,20230,20115,20385,20385,20385,20385,20385,270,270,2,40.77,346
,20130820,20385,20385,20000,20085,19810,19860,20010,-525,-375,26,520.3,338
,20130821,19860,20010,19990,19990,19930,19930,19965,-80,-45,8,159.74,334
,20130822,19930,19965,19910,20360,19910,20330,20300,365,335,28,568.42,326
,20130823,20330,20300,20460,20720,20445,20720,20560,420,260,56,"1,151.54",304
,20130826,20720,20560,21130,21230,21045,21185,21115,625,555,44,929.23,282
,20130827,21185,21115,20955,21100,20955,21085,20980,-30,-135,22,461.64,266
,20130828,21085,20980,21245,21300,20730,20730,21140,-250,160,18,380.6,264
,20130829,20730,21140,20775,20845,20500,20695,20685,-445,-455,18,372.36,262
,20130830,20695,20685,20700,20735,20450,20450,20585,-235,-100,16,329.43,256
,20130902,20450,20585,20900,21605,20900,21605,21245,1020,660,38,807.32,248
,20130903,21605,21245,21765,21840,21385,21585,21545,340,300,68,"1,465.24",244
,20130904,21585,21545,21530,21565,21280,21280,21450,-265,-95,28,600.67,228
,20130905,21280,21450,21325,21390,21000,21300,21270,-150,-180,40,850.97,200
,20130906,21300,21270,21195,21300,21090,21215,21230,-55,-40,40,849.37,194
,20130909,21215,21230,21260,21440,21260,21330,21355,100,125,16,341.68,186
,20130910,21330,21355,21120,21125,21105,21105,21115,-250,-240,16,337.84,176
,20130911,21105,21115,21265,21335,21145,21185,21265,70,150,48,"1,020.85",142
,20130912,21185,21265,21200,21200,21040,21040,21070,-225,-195,36,758.56,142
,20130913,21040,21070,20800,20800,20680,20680,20760,-390,-310,12,249.16,140
,20130916,20680,20760,20850,20915,20470,20500,20670,-260,-90,872,"18,025.06",848
,20130917,20500,20670,20440,20715,20280,20705,20405,35,-265,312,"6,367.46",1020
,20130918,20705,20405,20640,21120,20640,21120,20915,715,510,26,543.88,1016
,20130923,21120,20915,20930,21200,20855,21200,21040,285,125,44,925.86,1018
,20130924,21200,21040,21130,21175,20900,20900,21065,-140,25,22,463.49,1016
,20130925,20900,21065,20870,20980,20745,20745,20840,-320,-225,48,"1,000.46",1016
,20130926,20745,20840,20600,20780,20575,20750,20615,-90,-225,28,577.32,1016
,20130927,20750,20615,20665,20820,20290,20315,20595,-300,-20,66,"1,359.30",1016
,20130930,20315,20595,20345,20420,20250,20285,20315,-310,-280,34,690.76,1016
,20131008,20285,20315,20535,20535,20530,20530,20530,215,215,12,246.37,1016
,20131009,20530,20530,20595,20630,20525,20600,20590,70,60,88,"1,812.04",1018
,20131010,20600,20590,20390,20445,20370,20445,20400,-145,-190,16,326.47,1020
,20131011,20445,20400,20800,20915,20565,20615,20790,215,390,58,"1,206.03",1018
,20131014,20615,20790,20800,20950,20795,20950,20855,160,65,50,"1,042.88",1016
,20131015,20950,20855,21200,21270,21190,21225,21245,370,390,1056,"22,438.84",166
,20131016,21225,21245,21395,21430,20865,21090,21195,-155,-50,8,169.56,164
,20131017,21090,21195,21285,21285,20595,20660,20980,-535,-215,34,713.36,168
,20131018,20660,20980,20675,20675,20675,20675,20675,-305,-305,2,41.35,166
,20131021,20675,20675,20630,20945,20630,20945,20820,270,145,10,208.21,168
,20131022,20945,20820,20905,20905,20860,20860,20890,40,70,6,125.34,168
,20131023,20860,20890,20600,20600,20365,20365,20470,-525,-420,6,122.83,164
,20131024,20365,20470,20465,20480,20450,20450,20465,-20,-5,6,122.79,166
,20131025,20450,20465,20320,20320,19890,19890,20130,-575,-335,16,322.09,166
,20131028,19890,20130,19755,19780,19660,19760,19730,-370,-400,10,197.31,168
,20131029,19760,19730,19705,19855,19650,19790,19745,60,15,28,552.93,162
,20131030,19790,19745,19835,20060,19750,20060,19900,315,155,16,318.46,172
,20131031,20060,19900,19825,19825,19480,19680,19665,-220,-235,46,904.62,178
,20131101,19680,19665,19695,19860,19520,19855,19785,190,120,64,"1,266.31",170
,20131104,19855,19785,19790,19865,19590,19590,19720,-195,-65,38,749.54,168
,20131105,19590,19720,19360,19590,19360,19475,19440,-245,-280,48,933.24,186
,20131106,19475,19440,19475,19665,19395,19395,19555,-45,115,38,743.14,172
,20131107,19395,19555,19520,19650,19410,19640,19535,85,-20,124,"2,422.70",174
,20131108,19640,19535,19440,19630,19430,19430,19580,-105,45,98,"1,919.06",172
,20131111,19430,19580,19585,19585,19380,19435,19475,-145,-105,64,"1,246.53",202
,20131112,19435,19475,19470,19470,19170,19270,19275,-205,-200,58,"1,118.13",186
,20131113,19270,19275,19265,19275,19205,19270,19245,-5,-30,34,654.33,182
,20131114,19270,19245,19320,19425,19320,19380,19375,135,130,8,155.01,180
,20131115,19380,19375,19380,19465,19190,19190,19385,-185,10,50,969.48,174
,20131118,19190,19385,19100,19185,19100,19130,19140,-255,-245,8,153.12,168
,20131119,19130,19140,19075,19300,19040,19300,19180,160,40,68,"1,304.50",210
,20131120,19300,19180,19300,19410,19300,19405,19355,225,175,70,"1,355.15",226
,20131121,19405,19355,19190,19245,19130,19135,19170,-220,-185,44,843.61,216
,20131122,19135,19170,19390,19420,19150,19200,19220,30,50,38,730.39,200
,20131125,19200,19220,19170,19170,18975,18975,19100,-245,-120,34,649.51,198
,20131126,18975,19100,18925,19085,18850,19000,18945,-100,-155,58,"1,098.84",188
,20131127,19000,18945,18930,18975,18930,18975,18935,30,-10,16,302.97,180
,20131128,18975,18935,19125,19300,19125,19300,19235,365,300,72,"1,384.97",174
,20131129,19300,19235,19440,19765,19360,19715,19680,480,445,170,"3,346.33",174
,20131202,19715,19680,19650,19725,19640,19680,19675,0,-5,20,393.57,178
,20131203,19680,19675,19585,19590,19405,19440,19525,-235,-150,14,273.38,170
,20131204,19440,19525,19460,19695,19460,19680,19595,155,70,124,"2,429.99",178
,20131205,19680,19595,19660,19660,19470,19470,19555,-125,-40,64,"1,251.78",174
,20131206,19470,19555,19435,19590,19315,19590,19405,35,-150,122,"2,367.84",170
,20131209,19590,19405,19675,19830,19560,19775,19720,370,315,90,"1,774.88",176
,20131210,19775,19720,19725,19875,19725,19750,19795,30,75,60,"1,187.96",176
,20131211,19750,19795,19825,19825,19645,19645,19710,-150,-85,32,630.87,174
,20131212,19645,19710,19760,20160,19750,20160,19920,450,210,56,"1,115.74",168
,20131213,20160,19920,19975,19975,19815,19830,19900,-90,-20,70,"1,393.19",160
,20131216,19830,19900,19940,19970,19750,19770,19810,-130,-90,64,"1,267.90",156
,20131217,19770,19810,19675,19675,19475,19475,19600,-335,-210,96,"1,881.75",172
,20131218,19475,19600,19400,19400,19200,19200,19285,-400,-315,90,"1,735.71",168
,20131219,19200,19285,19185,19315,19055,19065,19205,-220,-80,64,"1,229.12",176
,20131220,19065,19205,19070,19180,18940,18940,19090,-265,-115,20,381.84,172
,20131223,18940,19090,18835,18835,18470,18470,18705,-620,-385,162,"3,030.46",236
,20131224,18470,18705,18435,18435,18265,18265,18350,-440,-355,108,"1,982.33",244
,20131225,18265,18350,18385,18475,18135,18370,18325,20,-25,234,"4,288.50",336
,20131226,18370,18325,18375,18505,18290,18375,18365,50,40,202,"3,710.70",380
,20131227,18375,18365,18365,18585,18365,18445,18440,80,75,86,"1,586.15",380
,20131230,18445,18440,18390,18390,18230,18230,18270,-210,-170,96,"1,754.08",398
,20131231,18230,18270,18190,18290,18110,18130,18245,-140,-25,160,"2,919.96",410
ru1407,20130716,17990,17990,,,,17990,17990,0,0,0,0,0
,20130717,17990,17990,18515,18515,18515,18515,18515,525,525,2,37.03,2
,20130718,18515,18515,18880,18935,18770,18770,18865,255,350,10,188.69,6
,20130719,18770,18865,19100,19100,19100,19100,19100,235,235,2,38.2,8
,20130722,19100,19100,19065,19065,19065,19065,19065,-35,-35,2,38.13,10
,20130723,19065,19065,,,,18925,18925,-140,-140,0,0,10
,20130724,18925,18925,18990,18990,18945,18945,18965,20,40,4,75.87,8
,20130725,18945,18965,19020,19020,19020,19020,19020,55,55,2,38.04,8
,20130726,19020,19020,,,,18730,18730,-290,-290,0,0,8
,20130729,18730,18730,18330,18330,17985,18000,18080,-730,-650,20,361.64,22
,20130730,18000,18080,17940,18030,17935,17935,17975,-145,-105,8,143.83,24
,20130731,17935,17975,17900,18180,17765,18180,17975,205,0,20,359.51,34
,20130801,18180,17975,18110,18230,18110,18145,18185,170,210,10,181.89,32
,20130802,18145,18185,,,,18185,18185,0,0,0,0,32
,20130805,18185,18185,18155,18250,18155,18250,18200,65,15,4,72.81,34
,20130806,18250,18200,18315,18570,18285,18560,18465,360,265,28,517.14,38
,20130807,18560,18465,18465,18475,18465,18470,18470,5,5,16,295.52,50
,20130808,18470,18470,18670,19305,18670,19305,19015,835,545,10,190.15,48
,20130809,19305,19015,19480,19480,19400,19450,19430,435,415,12,233.16,46
,20130812,19450,19430,19705,20000,19705,20000,19865,570,435,40,794.71,38
,20130813,20000,19865,19955,20000,19955,20000,19975,135,110,4,79.91,40
,20130814,20000,19975,20160,20160,19890,19975,19980,0,5,44,879.33,44
,20130815,19975,19980,19910,19910,19775,19810,19840,-170,-140,28,555.56,64
,20130816,19810,19840,20050,20200,19925,20200,20060,360,220,100,"2,006.11",48
,20130819,20200,20060,20285,20455,20165,20165,20310,105,250,8,162.49,50
,20130820,20165,20310,20080,20130,19810,19910,19975,-400,-335,60,"1,198.59",72
,20130821,19910,19975,19990,20080,19970,20000,20005,25,30,92,"1,840.59",78
,20130822,20000,20005,19890,20420,19890,20395,20195,390,190,62,"1,252.35",78
,20130823,20395,20195,20755,20755,20580,20580,20665,385,470,4,82.67,80
,20130826,20580,20665,21370,21370,21370,21370,21370,705,705,2,42.74,80
,20130827,21370,21370,21035,21120,21035,21120,21075,-250,-295,4,84.31,80
,20130828,21120,21075,,,,21075,21075,0,0,0,0,80
,20130829,21075,21075,20735,20810,20560,20700,20725,-375,-350,18,373.09,82
,20130830,20700,20725,20760,20875,20425,20425,20735,-300,10,18,373.26,82
,20130902,20425,20735,20825,21770,20825,21765,21560,1030,825,20,431.28,90
,20130903,21765,21560,21885,21935,21425,21660,21675,100,115,28,607,86
,20130904,21660,21675,21600,21600,21275,21280,21430,-395,-245,12,257.21,88
,20130905,21280,21430,21165,21165,21165,21165,21165,-265,-265,2,42.33,88
,20130906,21165,21165,21285,21285,21285,21285,21285,120,120,2,42.57,86
,20130909,21285,21285,21410,21410,21405,21405,21405,120,120,4,85.63,84
,20130910,21405,21405,21145,21200,21145,21200,21170,-205,-235,6,127.04,84
,20130911,21200,21170,21300,21300,21110,21130,21180,-40,10,6,127.08,84
,20130912,21130,21180,,,,20985,20985,-195,-195,0,0,84
,20130913,20985,20985,20810,20810,20725,20780,20770,-205,-215,6,124.63,86
,20130916,20780,20770,20980,20980,20620,20650,20735,-120,-35,12,248.86,86
,20130917,20650,20735,20455,20760,20405,20760,20495,25,-240,10,204.96,90
,20130918,20760,20495,21110,21110,21110,21110,21110,615,615,2,42.22,90
,20130923,21110,21110,21000,21310,21000,21310,21185,200,75,14,296.65,88
,20130924,21310,21185,21195,21285,21015,21075,21120,-110,-65,16,337.92,82
,20130925,21075,21120,20900,21015,20875,20885,20920,-235,-200,16,334.73,88
,20130926,20885,20920,20735,20900,20725,20900,20755,-20,-165,16,332.1,88
,20130927,20900,20755,20955,20955,20550,20550,20710,-205,-45,6,124.28,86
,20130930,20550,20710,20510,20520,20450,20450,20495,-260,-215,8,163.98,86
,20131008,20450,20495,,,,20710,20710,215,215,0,0,86
,20131009,20710,20710,20760,20760,20760,20760,20760,50,50,14,290.64,88
,20131010,20760,20760,20575,20575,20575,20575,20575,-185,-185,2,41.15,90
,20131011,20575,20575,20800,20800,20800,20800,20800,225,225,2,41.6,90
,20131014,20800,20800,20900,20900,20900,20900,20900,100,100,2,41.8,90
,20131015,20900,20900,21365,21365,21300,21300,21340,400,440,14,298.8,82
,20131016,21300,21340,21130,21130,21130,21130,21130,-210,-210,2,42.26,82
,20131017,21130,21130,21225,21225,20945,20945,21085,-185,-45,4,84.34,80
,20131018,20945,21085,20800,20800,20800,20800,20800,-285,-285,2,41.6,80
,20131021,20800,20800,20845,20845,20845,20845,20845,45,45,2,41.69,80
,20131022,20845,20845,,,,20915,20915,70,70,0,0,80
,20131023,20915,20915,20785,20785,20450,20450,20650,-465,-265,8,165.22,76
,20131024,20450,20650,,,,20640,20640,-10,-10,0,0,76
,20131025,20640,20640,20565,20565,20000,20000,20195,-640,-445,6,121.17,76
,20131028,20000,20195,19935,19935,19935,19935,19935,-260,-260,2,39.87,76
,20131029,19935,19935,,,,19950,19950,15,15,0,0,76
,20131030,19950,19950,19950,19950,19950,19950,19950,0,0,2,39.9,76
,20131031,19950,19950,19820,19820,19820,19820,19820,-130,-130,2,39.64,76
,20131101,19820,19820,19795,19970,19795,19860,19875,40,55,6,119.25,78
,20131104,19860,19875,,,,19810,19810,-65,-65,0,0,78
,20131105,19810,19810,19580,19580,19580,19580,19580,-230,-230,2,39.16,78
,20131106,19580,19580,,,,19695,19695,115,115,0,0,78
,20131107,19695,19695,,,,19675,19675,-20,-20,0,0,78
,20131108,19675,19675,19675,19770,19590,19590,19670,-85,-5,12,236.08,78
,20131111,19590,19670,19550,19720,19530,19530,19575,-140,-95,10,195.75,76
,20131112,19530,19575,19350,19350,19350,19350,19350,-225,-225,2,38.7,76
,20131113,19350,19350,,,,19315,19315,-35,-35,0,0,76
,20131114,19315,19315,19510,19520,19510,19520,19510,205,195,8,156.1,76
,20131115,19520,19510,19565,19565,19565,19565,19565,55,55,2,39.13,78
,20131118,19565,19565,19360,19360,19280,19280,19320,-285,-245,8,154.56,78
,20131119,19280,19320,,,,19360,19360,40,40,0,0,78
,20131120,19360,19360,19440,19465,19390,19390,19430,30,70,8,155.47,82
,20131121,19390,19430,19320,19320,19320,19320,19320,-110,-110,2,38.64,80
,20131122,19320,19320,19430,19440,19145,19220,19360,-100,40,22,425.99,90
,20131125,19220,19360,19150,19150,19150,19150,19150,-210,-210,4,76.6,88
,20131126,19150,19150,18920,18920,18920,18920,18920,-230,-230,14,264.88,94
,20131127,18920,18920,19045,19045,19045,19045,19045,125,125,2,38.09,96
,20131128,19045,19045,19285,19385,19230,19370,19295,325,250,18,347.31,86
,20131129,19370,19295,,,,19745,19745,450,450,0,0,86
,20131202,19745,19745,19655,19845,19655,19845,19750,100,5,4,79,86
,20131203,19845,19750,19645,19665,19640,19665,19650,-85,-100,6,117.9,86
,20131204,19665,19650,,,,19720,19720,70,70,0,0,86
,20131205,19720,19720,19650,19650,19650,19650,19650,-70,-70,2,39.3,86
,20131206,19650,19650,19505,19640,19430,19640,19520,-10,-130,14,273.33,84
,20131209,19640,19520,19920,19920,19890,19890,19905,370,385,4,79.62,80
,20131210,19890,19905,,,,19905,19905,0,0,0,0,80
,20131211,19905,19905,19915,19915,19745,19745,19830,-160,-75,16,317.28,86
,20131212,19745,19830,19830,19830,19830,19830,19830,0,0,2,39.66,84
,20131213,19830,19830,,,,19830,19830,0,0,0,0,84
,20131216,19830,19830,,,,19835,19835,5,5,0,0,84
,20131217,19835,19835,19700,19700,19685,19685,19690,-150,-145,10,196.94,86
,20131218,19685,19690,19490,19490,19395,19420,19435,-270,-255,10,194.35,90
,20131219,19420,19435,19320,19320,19320,19320,19320,-115,-115,2,38.64,88
,20131220,19320,19320,,,,19070,19070,-250,-250,0,0,88
,20131223,19070,19070,18890,18890,18615,18615,18730,-455,-340,24,449.63,98
,20131224,18615,18730,18475,18495,18435,18435,18465,-295,-265,6,110.81,96
,20131225,18435,18465,18460,18535,18360,18500,18445,35,-20,248,"4,574.76",278
,20131226,18500,18445,18505,18505,18400,18420,18430,-25,-15,8,147.45,278
,20131227,18420,18430,,,,18430,18430,0,0,0,0,278
,20131230,18430,18430,18270,18445,18270,18300,18340,-130,-90,20,366.8,276
,20131231,18300,18340,18300,18300,18300,18300,18300,-40,-40,122,"2,232.60",376
ru1408,20130816,19840,19840,19950,19950,19950,19950,19950,110,110,4,79.8,2
,20130819,19950,19950,,,,20195,20195,245,245,0,0,2
,20130820,20195,20195,20080,20220,19890,19900,20120,-295,-75,62,"1,247.45",64
,20130821,19900,20120,19990,20060,19990,20020,20015,-100,-105,14,280.24,74
,20130822,20020,20015,19740,20435,19740,20360,20215,345,200,36,727.83,86
,20130823,20360,20215,20555,20690,20525,20690,20590,475,375,6,123.54,88
,20130826,20690,20590,,,,21290,21290,700,700,0,0,88
,20130827,21290,21290,21145,21145,21145,21145,21145,-145,-145,4,84.58,88
,20130828,21145,21145,21150,21470,20850,20850,21245,-295,100,20,424.98,90
,20130829,20850,21245,20600,20825,20600,20800,20740,-445,-505,10,207.41,94
,20130830,20800,20740,20825,20855,20580,20580,20740,-160,0,10,207.43,100
,20130902,20580,20740,20825,21700,20825,21700,21195,960,455,16,339.18,108
,20130903,21700,21195,21900,21900,21705,21705,21795,510,600,10,217.97,114
,20130904,21705,21795,21620,21700,21330,21350,21490,-445,-305,34,730.81,122
,20130905,21350,21490,21500,21500,21155,21370,21250,-120,-240,54,"1,147.61",134
,20130906,21370,21250,21300,21300,21300,21300,21300,50,50,8,170.4,132
,20130909,21300,21300,21450,21545,21430,21545,21465,245,165,10,214.67,130
,20130910,21545,21465,21200,21235,21070,21235,21160,-230,-305,26,550.23,140
,20130911,21235,21160,21470,21470,21295,21295,21405,135,245,8,171.25,148
,20130912,21295,21405,21165,21165,21050,21050,21135,-355,-270,16,338.16,148
,20130913,21050,21135,20830,20850,20810,20810,20830,-325,-305,10,208.33,148
,20130916,20810,20830,21050,21060,20655,20750,20860,-80,30,40,834.41,146
,20130917,20750,20860,20540,20950,20535,20950,20815,90,-45,44,916.02,140
,20130918,20950,20815,21170,21350,21160,21350,21205,535,390,40,848.34,128
,20130923,21350,21205,21105,21340,21105,21340,21240,135,35,8,169.92,128
,20130924,21340,21240,21165,21165,21165,21165,21165,-75,-75,2,42.33,126
,20130925,21165,21165,21210,21210,21070,21070,21160,-95,-5,6,126.98,128
,20130926,21070,21160,20840,21025,20840,21025,20960,-135,-200,12,251.56,138
,20130927,21025,20960,20855,20935,20530,20530,20780,-430,-180,12,249.39,132
,20130930,20530,20780,20530,20585,20405,20480,20475,-300,-305,14,286.7,132
,20131008,20480,20475,20660,20700,20660,20700,20680,225,205,8,165.45,130
,20131009,20700,20680,20850,20850,20770,20770,20775,90,95,32,664.8,128
,20131010,20770,20775,20640,20640,20640,20640,20640,-135,-135,2,41.28,128
,20131011,20640,20640,20860,20935,20860,20935,20895,295,255,4,83.59,126
,20131014,20935,20895,20925,20925,20925,20925,20925,30,30,2,41.85,124
,20131015,20925,20925,21370,21390,21320,21335,21355,410,430,16,341.69,122
,20131016,21335,21355,21080,21115,21080,21115,21095,-240,-260,4,84.39,122
,20131017,21115,21095,21200,21200,20975,20975,21085,-120,-10,4,84.35,120
,20131018,20975,21085,20620,20620,20620,20620,20620,-465,-465,2,41.24,118
,20131021,20620,20620,21025,21025,21025,21025,21025,405,405,2,42.05,116
,20131022,21025,21025,,,,21025,21025,0,0,0,0,116
,20131023,21025,21025,20520,20560,20520,20560,20540,-465,-485,4,82.16,118
,20131024,20560,20540,20635,20635,20555,20555,20605,15,65,6,123.65,118
,20131025,20555,20605,20520,20520,20240,20240,20380,-365,-225,4,81.52,118
,20131028,20240,20380,19915,19915,19805,19805,19865,-575,-515,6,119.19,120
,20131029,19805,19865,19875,19875,19875,19875,19875,10,10,2,39.75,120
,20131030,19875,19875,,,,19875,19875,0,0,0,0,120
,20131031,19875,19875,,,,19745,19745,-130,-130,0,0,120
,20131101,19745,19745,,,,19745,19745,0,0,0,0,120
,20131104,19745,19745,19730,19925,19730,19840,19805,95,60,8,158.45,122
,20131105,19840,19805,19720,19740,19605,19655,19650,-150,-155,16,314.44,124
,20131106,19655,19650,19655,19660,19655,19660,19655,10,5,4,78.63,122
,20131107,19660,19655,19825,19825,19825,19825,19825,170,170,2,39.65,122
,20131108,19825,19825,,,,19825,19825,0,0,0,0,122
,20131111,19825,19825,19620,19620,19620,19620,19620,-205,-205,2,39.24,122
,20131112,19620,19620,,,,19520,19520,-100,-100,0,0,122
,20131113,19520,19520,,,,19485,19485,-35,-35,0,0,122
,20131114,19485,19485,19595,19620,19595,19620,19605,135,120,6,117.65,122
,20131115,19620,19605,19595,19710,19595,19610,19635,5,30,6,117.83,122
,20131118,19610,19635,19360,19360,19330,19330,19345,-305,-290,16,309.54,118
,20131119,19330,19345,19300,19300,19230,19230,19280,-115,-65,8,154.26,118
,20131120,19230,19280,19455,19505,19450,19450,19470,170,190,6,116.82,114
,20131121,19450,19470,19300,19350,19300,19350,19325,-120,-145,4,77.3,112
,20131122,19350,19325,19415,19415,19150,19150,19250,-175,-75,22,423.59,120
,20131125,19150,19250,19170,19170,19130,19135,19145,-115,-105,6,114.87,118
,20131126,19135,19145,18855,19030,18820,18920,18850,-225,-295,256,"4,826.30",222
,20131127,18920,18850,19025,19025,18985,19000,18995,150,145,14,265.99,226
,20131128,19000,18995,19240,19440,19240,19395,19390,400,395,230,"4,459.91",142
,20131129,19395,19390,19500,19665,19500,19665,19580,275,190,4,78.33,140
,20131202,19665,19580,19840,19845,19840,19845,19840,265,260,4,79.37,140
,20131203,19845,19840,19645,19680,19600,19600,19635,-240,-205,12,235.63,140
,20131204,19600,19635,19620,19800,19585,19800,19650,165,15,22,432.34,136
,20131205,19800,19650,19610,19670,19610,19660,19640,10,-10,8,157.12,138
,20131206,19660,19640,19525,19525,19525,19525,19525,-115,-115,2,39.05,136
,20131209,19525,19525,19690,19930,19690,19930,19810,405,285,4,79.24,136
,20131210,19930,19810,19960,19960,19900,19910,19915,100,105,20,398.32,122
,20131211,19910,19915,19860,19860,19795,19795,19825,-120,-90,4,79.31,118
,20131212,19795,19825,,,,20190,20190,365,365,0,0,118
,20131213,20190,20190,20150,20150,19870,19870,19930,-320,-260,14,279.06,118
,20131216,19870,19930,20085,20085,19885,19885,20055,-45,125,48,962.81,120
,20131217,19885,20055,19725,19725,19595,19595,19680,-460,-375,6,118.09,118
,20131218,19595,19680,,,,19400,19400,-280,-280,0,0,118
,20131219,19400,19400,19250,19250,19250,19250,19250,-150,-150,2,38.5,118
,20131220,19250,19250,19350,19355,19350,19355,19350,105,100,16,309.61,118
,20131223,19355,19350,18960,18960,18585,18640,18795,-710,-555,1186,"22,294.32",916
,20131224,18640,18795,18450,18540,18305,18380,18405,-415,-390,1196,"22,017.47",1112
,20131225,18380,18405,18460,18555,18430,18440,18510,35,105,462,"8,553.40",1404
,20131226,18440,18510,18525,18525,18360,18410,18445,-100,-65,506,"9,335.40",1788
,20131227,18410,18445,18470,18645,18415,18645,18505,200,60,166,"3,072.61",1786
,20131230,18645,18505,18590,18590,18230,18245,18350,-260,-155,930,"17,069.45",2586
,20131231,18245,18350,18310,18420,18200,18370,18320,20,-30,450,"8,244.34",2898
ru1409,20130917,20860,20860,20535,21105,20285,21050,20845,190,-15,174,"3,627.20",132
,20130918,21050,20845,20915,21355,20880,21355,21215,510,370,278,"5,897.84",292
,20130923,21355,21215,21510,21510,21200,21490,21345,275,130,330,"7,044.61",386
,20130924,21490,21345,21380,21435,21090,21165,21245,-180,-100,86,"1,827.22",410
,20130925,21165,21245,21160,21160,20970,20980,21025,-265,-220,64,"1,345.91",406
,20130926,20980,21025,20800,21060,20760,20970,20870,-55,-155,76,"1,586.38",432
,20130927,20970,20870,20780,21090,20550,20575,20870,-295,0,138,"2,880.60",476
,20130930,20575,20870,20500,20665,20500,20530,20585,-340,-285,40,823.5,468
,20131008,20530,20585,20320,21055,20320,20915,20805,330,220,192,"3,994.87",568
,20131009,20915,20805,20880,20890,20760,20875,20835,70,30,148,"3,083.59",660
,20131010,20875,20835,20730,20765,20550,20670,20655,-165,-180,174,"3,594.29",726
,20131011,20670,20655,20880,21215,20820,20875,20970,220,315,108,"2,265.27",732
,20131014,20875,20970,20865,21455,20845,21340,21200,370,230,132,"2,798.97",754
,20131015,21340,21200,21395,21500,21350,21480,21425,280,225,186,"3,985.21",856
,20131016,21480,21425,21385,21520,21030,21170,21225,-255,-200,228,"4,839.93",858
,20131017,21170,21225,21475,21475,20775,20775,21105,-450,-120,404,"8,527.95",882
,20131018,20775,21105,20810,20980,20605,20800,20800,-305,-305,232,"4,826.57",900
,20131021,20800,20800,20700,21100,20675,21095,20975,295,175,260,"5,454.19",864
,20131022,21095,20975,21035,21140,20830,20830,20995,-145,20,252,"5,291.40",960
,20131023,20830,20995,20860,20955,20500,20590,20690,-405,-305,298,"6,166.09",1020
,20131024,20590,20690,20530,20685,20250,20615,20455,-75,-235,560,"11,454.89",1078
,20131025,20615,20455,20625,20690,19935,19965,20380,-490,-75,1128,"22,992.69",1280
,20131028,19965,20380,20005,20075,19765,19850,19930,-530,-450,692,"13,794.79",1360
,20131029,19850,19930,19900,20135,19820,20050,19975,120,45,556,"11,107.18",1428
,20131030,20050,19975,20170,20365,20000,20260,20200,285,225,834,"16,847.45",1542
,20131031,20260,20200,20180,20180,19805,19930,19915,-270,-285,1036,"20,634.32",1730
,20131101,19930,19915,19875,20140,19715,20120,19965,205,50,2080,"41,535.69",1896
,20131104,20120,19965,19995,20150,19835,19950,19980,-15,15,2290,"45,761.50",2324
,20131105,19950,19980,19905,19995,19590,19760,19745,-220,-235,3082,"60,860.50",2788
,20131106,19760,19745,19760,19885,19680,19745,19780,0,35,2690,"53,216.38",3046
,20131107,19745,19780,19740,19945,19660,19900,19835,120,55,2846,"56,457.13",3706
,20131108,19900,19835,19780,19975,19710,19730,19835,-105,0,2464,"48,879.72",3754
,20131111,19730,19835,19890,19925,19610,19680,19770,-155,-65,2072,"40,970.01",3736
,20131112,19680,19770,19700,19740,19420,19550,19555,-220,-215,3288,"64,300.97",4374
,20131113,19550,19555,19460,19650,19390,19535,19500,-20,-55,3506,"68,380.11",4634
,20131114,19535,19500,19545,19765,19540,19655,19650,155,150,4380,"86,074.57",4926
,20131115,19655,19650,19735,19845,19490,19490,19715,-160,65,4762,"93,887.42",5398
,20131118,19490,19715,19515,19545,19365,19425,19430,-290,-285,6520,"126,711.98",6502
,20131119,19425,19430,19250,19410,19200,19390,19295,-40,-135,12102,"233,567.68",10684
,20131120,19390,19295,19385,19575,19355,19520,19485,225,190,7466,"145,497.67",11900
,20131121,19520,19485,19470,19495,19270,19300,19355,-185,-130,9862,"190,913.22",13446
,20131122,19300,19355,19440,19530,19155,19175,19345,-180,-10,11752,"227,397.38",14476
,20131125,19175,19345,19245,19285,18900,18920,19130,-425,-215,19376,"370,668.08",20138
,20131126,18920,19130,18980,19175,18895,19050,19010,-80,-120,15072,"286,552.33",21832
,20131127,19050,19010,19020,19170,18980,19105,19070,95,60,12930,"246,595.84",22518
,20131128,19105,19070,19065,19490,19060,19395,19350,325,280,25878,"500,743.86",23664
,20131129,19395,19350,19600,19920,19470,19870,19640,520,290,24872,"488,556.72",26062
,20131202,19870,19640,19895,19905,19740,19880,19820,240,180,21534,"426,890.57",28694
,20131203,19880,19820,19800,19820,19535,19595,19660,-225,-160,33298,"654,658.52",32294
,20131204,19595,19660,19610,19865,19555,19800,19705,140,45,36694,"723,142.79",36314
,20131205,19800,19705,19955,19955,19500,19545,19680,-160,-25,43546,"857,097.10",44744
,20131206,19545,19680,19510,19745,19415,19700,19560,20,-120,47992,"938,730.62",46648
,20131209,19700,19560,19800,20040,19680,20020,19915,460,355,44030,"876,991.09",47942
,20131210,20020,19915,19990,20070,19870,19985,19970,70,55,37170,"742,344.30",47550
,20131211,19985,19970,20000,20090,19765,19855,19890,-115,-80,38390,"763,666.11",46368
,20131212,19855,19890,19880,20350,19860,20315,20155,425,265,65484,"1,319,863.42",44444
,20131213,20315,20155,20245,20280,19870,20080,20020,-75,-135,65672,"1,314,805.75",45988
,20131216,20080,20020,20165,20210,19900,19945,20025,-75,5,41942,"839,909.81",48752
,20131217,19945,20025,20045,20045,19580,19610,19790,-415,-235,65324,"1,293,009.35",49906
,20131218,19610,19790,19560,19635,19385,19395,19515,-395,-275,51440,"1,004,018.87",51700
,20131219,19395,19515,19460,19555,19265,19315,19415,-200,-100,57764,"1,121,621.27",52560
,20131220,19315,19415,19350,19475,19130,19130,19350,-285,-65,59186,"1,145,389.78",51904
,20131223,19130,19350,19160,19250,18720,18755,18945,-595,-405,73474,"1,392,143.52",57360
,20131224,18755,18945,18745,18750,18385,18535,18600,-410,-345,59926,"1,114,682.21",62506
,20131225,18535,18600,18630,18790,18400,18645,18605,45,5,73896,"1,375,101.71",65254
,20131226,18645,18605,18645,18765,18545,18605,18650,0,45,66176,"1,234,251.54",66278
,20131227,18605,18650,18645,18850,18605,18705,18710,55,60,58828,"1,100,711.36",66624
,20131230,18705,18710,18720,18780,18420,18530,18600,-180,-110,61062,"1,135,869.13",66590
,20131231,18530,18600,18505,18660,18360,18450,18505,-150,-95,70928,"1,312,559.96",62734
ru1410,20131016,21425,21425,20865,20865,20865,20865,20865,-560,-560,2,41.73,2
,20131017,20865,20865,21600,21600,20920,20920,21250,55,385,8,170.01,4
,20131018,20920,21250,20775,20775,20650,20650,20690,-600,-560,6,124.15,10
,20131021,20650,20690,20675,20855,20675,20855,20740,165,50,6,124.46,8
,20131022,20855,20740,20945,21085,20855,20855,20960,115,220,6,125.77,8
,20131023,20855,20960,20615,20615,20615,20615,20615,-345,-345,2,41.23,10
,20131024,20615,20615,,,,20380,20380,-235,-235,0,0,10
,20131025,20380,20380,20475,20745,19950,19950,20280,-430,-100,8,162.24,12
,20131028,19950,20280,19900,19975,19700,19900,19845,-380,-435,14,277.85,12
,20131029,19900,19845,19895,20100,19890,20100,20020,255,175,34,680.78,22
,20131030,20100,20020,20150,20150,20150,20150,20150,130,130,6,120.9,16
,20131031,20150,20150,19825,19825,19825,19825,19825,-325,-325,2,39.65,16
,20131101,19825,19825,,,,19875,19875,50,50,0,0,16
,20131104,19875,19875,19805,19805,19805,19805,19805,-70,-70,2,39.61,18
,20131105,19805,19805,19695,19770,19695,19770,19730,-35,-75,4,78.93,18
,20131106,19770,19730,,,,19765,19765,35,35,0,0,18
,20131107,19765,19765,,,,19820,19820,55,55,0,0,18
,20131108,19820,19820,,,,19820,19820,0,0,0,0,18
,20131111,19820,19820,,,,19755,19755,-65,-65,0,0,18
,20131112,19755,19755,,,,19600,19600,-155,-155,0,0,18
,20131113,19600,19600,,,,19545,19545,-55,-55,0,0,18
,20131114,19545,19545,,,,19545,19545,0,0,0,0,18
,20131115,19545,19545,,,,19610,19610,65,65,0,0,18
,20131118,19610,19610,,,,19460,19460,-150,-150,0,0,18
,20131119,19460,19460,19265,19265,19265,19265,19265,-195,-195,2,38.53,16
,20131120,19265,19265,19465,19510,19465,19510,19480,245,215,6,116.9,18
,20131121,19510,19480,,,,19350,19350,-130,-130,0,0,18
,20131122,19350,19350,19505,19505,19160,19160,19375,-190,25,60,"1,162.71",40
,20131125,19160,19375,,,,19155,19155,-220,-220,0,0,40
,20131126,19155,19155,18950,19105,18950,19105,18985,-50,-170,10,189.88,38
,20131127,19105,18985,18960,19035,18960,19035,19010,50,25,8,152.09,38
,20131128,19035,19010,19120,19555,19120,19370,19305,360,295,56,"1,081.22",62
,20131129,19370,19305,19585,19585,19585,19585,19585,280,280,2,39.17,62
,20131202,19585,19585,,,,19660,19660,75,75,0,0,62
,20131203,19660,19660,19710,19710,19605,19605,19655,-55,-5,4,78.63,64
,20131204,19605,19655,19620,19810,19620,19810,19710,155,55,6,118.27,62
,20131205,19810,19710,19725,19725,19725,19725,19725,15,15,2,39.45,62
,20131206,19725,19725,19540,19540,19540,19540,19540,-185,-185,2,39.08,62
,20131209,19540,19540,19700,19750,19700,19750,19735,210,195,34,670.99,96
,20131210,19750,19735,20000,20000,19945,19945,19990,210,255,16,319.87,108
,20131211,19945,19990,19900,19900,19900,19900,19900,-90,-90,2,39.8,108
,20131212,19900,19900,19950,20325,19905,20300,20185,400,285,40,807.59,138
,20131213,20300,20185,20070,20070,19895,19895,19980,-290,-205,8,159.86,136
,20131216,19895,19980,19960,19960,19960,19960,19960,-20,-20,2,39.92,136
,20131217,19960,19960,19750,19760,19640,19680,19690,-280,-270,26,512.05,148
,20131218,19680,19690,19470,19470,19295,19295,19370,-395,-320,28,542.47,156
,20131219,19295,19370,19370,19395,19335,19335,19370,-35,0,14,271.18,148
,20131220,19335,19370,19285,19285,19215,19225,19240,-145,-130,6,115.45,146
,20131223,19225,19240,18870,18870,18600,18600,18700,-640,-540,12,224.44,148
,20131224,18600,18700,18550,18570,18515,18515,18545,-185,-155,10,185.45,138
,20131225,18515,18545,18460,18460,18330,18340,18375,-205,-170,6,110.26,136
,20131226,18340,18375,,,,18375,18375,0,0,0,0,136
,20131227,18375,18375,,,,18520,18520,145,145,0,0,136
,20131230,18520,18520,18395,18500,18395,18500,18445,-20,-75,4,73.79,132
,20131231,18500,18445,,,,18445,18445,0,0,0,0,132
ru1411,20131118,19610,19610,,,,19330,19330,-280,-280,0,0,0
,20131119,19330,19330,19220,19220,19220,19220,19220,-110,-110,2,38.44,2
,20131120,19220,19220,19450,19450,19420,19420,19435,200,215,8,155.49,6
,20131121,19420,19435,19350,19440,19260,19260,19325,-175,-110,8,154.62,12
,20131122,19260,19325,19395,19395,19205,19245,19285,-80,-40,10,192.88,16
,20131125,19245,19285,19095,19095,19080,19080,19085,-205,-200,4,76.35,16
,20131126,19080,19085,18900,19015,18900,19015,18980,-70,-105,8,151.85,20
,20131127,19015,18980,19070,19070,19070,19070,19070,90,90,2,38.14,20
,20131128,19070,19070,19120,19450,19110,19370,19345,300,275,104,"2,012.03",114
,20131129,19370,19345,19500,19560,19500,19515,19515,170,170,8,156.15,112
,20131202,19515,19515,19795,19845,19785,19785,19795,270,280,14,277.13,122
,20131203,19785,19795,19660,19660,19600,19600,19630,-195,-165,4,78.52,124
,20131204,19600,19630,19635,19795,19635,19795,19715,165,85,8,157.72,120
,20131205,19795,19715,19655,19655,19655,19655,19655,-60,-60,2,39.31,120
,20131206,19655,19655,19540,19540,19450,19450,19525,-205,-130,12,234.3,120
,20131209,19450,19525,19650,20020,19650,19985,19775,460,250,74,"1,463.43",140
,20131210,19985,19775,19980,20010,19770,19815,19935,40,160,210,"4,187.15",288
,20131211,19815,19935,19845,19850,19660,19750,19800,-185,-135,76,"1,505.07",322
,20131212,19750,19800,19840,20220,19780,20220,20055,420,255,104,"2,085.86",384
,20131213,20220,20055,19985,19985,19800,19900,19870,-155,-185,40,794.82,406
,20131216,19900,19870,19970,19990,19730,19780,19865,-90,-5,90,"1,787.85",468
,20131217,19780,19865,19705,19705,19335,19335,19500,-530,-365,130,"2,535.55",548
,20131218,19335,19500,19245,19270,19135,19135,19200,-365,-300,26,499.3,552
,20131219,19135,19200,19210,19245,18940,19000,19080,-200,-120,66,"1,259.33",574
,20131220,19000,19080,19050,19140,18850,18865,19010,-215,-70,44,836.55,596
,20131223,18865,19010,18850,18850,18505,18530,18615,-480,-395,134,"2,494.53",634
,20131224,18530,18615,18480,18480,18250,18290,18370,-325,-245,120,"2,204.60",630
,20131225,18290,18370,18395,18520,18160,18425,18350,55,-20,64,"1,174.51",630
,20131226,18425,18350,18490,18500,18380,18400,18425,50,75,44,810.76,646
,20131227,18400,18425,18480,18600,18430,18530,18495,105,70,24,443.91,652
,20131230,18530,18495,18495,18500,18225,18300,18270,-195,-225,332,"6,065.92",650
,20131231,18300,18270,18350,18350,18100,18150,18195,-120,-75,468,"8,517.58",868
wr1301,20130104,3690,3690,,,,3690,3690,0,0,0,0,0
,20130107,3690,3690,,,,3690,3690,0,0,0,0,0
,20130108,3690,3690,,,,3690,3690,0,0,0,0,0
,20130109,3690,3690,,,,3690,3690,0,0,0,0,0
,20130110,3690,3690,,,,3690,3690,0,0,0,0,0
,20130111,3690,3690,,,,3690,3690,0,0,0,0,0
,20130114,3690,3690,,,,3690,3690,0,0,0,0,0
,20130115,3690,3690,,,,3690,3690,0,0,0,0,0
wr1302,20130104,3935,3910,,,,3910,3910,0,0,0,0,2
,20130107,3910,3910,,,,3910,3910,0,0,0,0,2
,20130108,3910,3910,,,,3910,3910,0,0,0,0,2
,20130109,3910,3910,,,,3910,3910,0,0,0,0,2
,20130110,3910,3910,,,,3910,3910,0,0,0,0,2
,20130111,3910,3910,,,,3910,3910,0,0,0,0,2
,20130114,3910,3910,,,,3910,3910,0,0,0,0,2
,20130115,3910,3910,,,,3910,3910,0,0,0,0,2
,20130116,3910,3910,,,,3910,3910,0,0,0,0,2
,20130117,3910,3910,,,,3910,3910,0,0,0,0,2
,20130118,3910,3910,,,,3910,3910,0,0,0,0,2
,20130121,3910,3910,,,,3910,3910,0,0,0,0,2
,20130122,3910,3910,,,,3910,3910,0,0,0,0,2
,20130123,3910,3910,,,,3910,3910,0,0,0,0,2
,20130124,3910,3910,,,,3910,3910,0,0,0,0,2
,20130125,3910,3910,,,,3910,3910,0,0,0,0,2
,20130128,3910,3910,,,,3910,3910,0,0,0,0,2
,20130129,3910,3910,,,,3910,3910,0,0,0,0,2
,20130130,3910,3910,3842,3842,3842,3842,3842,-68,-68,2,7.68,0
,20130131,3842,3842,,,,3842,3842,0,0,0,0,0
,20130201,3842,3842,,,,3842,3842,0,0,0,0,0
,20130204,3842,3842,,,,3842,3842,0,0,0,0,0
,20130205,3842,3842,,,,3842,3842,0,0,0,0,0
,20130206,3842,3842,,,,3842,3842,0,0,0,0,0
,20130207,3842,3842,,,,3842,3842,0,0,0,0,0
,20130208,3842,3842,,,,3842,3842,0,0,0,0,0
,20130218,3842,3842,,,,3842,3842,0,0,0,0,0
wr1303,20130104,4040,4025,,,,4025,4025,0,0,0,0,2
,20130107,4025,4025,4199,4199,4199,4199,4199,174,174,2,8.4,2
,20130108,4199,4199,,,,4199,4199,0,0,0,0,2
,20130109,4199,4199,,,,4199,4199,0,0,0,0,2
,20130110,4199,4199,,,,4199,4199,0,0,0,0,2
,20130111,4199,4199,,,,4199,4199,0,0,0,0,2
,20130114,4199,4199,,,,4199,4199,0,0,0,0,2
,20130115,4199,4199,,,,4199,4199,0,0,0,0,2
,20130116,4199,4199,,,,4199,4199,0,0,0,0,2
,20130117,4199,4199,,,,4199,4199,0,0,0,0,2
,20130118,4199,4199,,,,4199,4199,0,0,0,0,2
,20130121,4199,4199,,,,4199,4199,0,0,0,0,2
,20130122,4199,4199,,,,4199,4199,0,0,0,0,2
,20130123,4199,4199,,,,4199,4199,0,0,0,0,2
,20130124,4199,4199,4346,4357,3992,4199,4223,0,24,8,33.79,2
,20130125,4199,4223,4335,4335,4011,4012,4037,-211,-186,30,121.12,26
,20130128,4012,4037,3950,4037,3950,4037,3993,0,-44,4,15.97,26
,20130129,4037,3993,4095,4095,4095,4095,4095,102,102,4,16.38,26
,20130130,4095,4095,,,,4023,4023,-72,-72,0,0,26
,20130131,4023,4023,,,,4023,4023,0,0,0,0,26
,20130201,4023,4023,,,,4019,4019,-4,-4,0,0,26
,20130204,4019,4019,4019,4124,4019,4124,4071,105,52,8,32.57,28
,20130205,4124,4071,4250,4250,3912,4184,4149,113,78,8,33.19,28
,20130206,4184,4149,4222,4222,4222,4222,4222,73,73,4,16.89,28
,20130207,4222,4222,,,,4222,4222,0,0,0,0,28
,20130208,4222,4222,3968,4225,3968,4002,4090,-220,-132,26,106.36,28
,20130218,4002,4090,4000,4000,4000,4000,4000,-90,-90,6,24,28
,20130219,4000,4000,,,,4000,4000,0,0,0,0,28
,20130220,4000,4000,,,,3999,3999,-1,-1,0,0,28
,20130221,3999,3999,,,,3999,3999,0,0,0,0,28
,20130222,3999,3999,,,,3999,3999,0,0,0,0,28
,20130225,3999,3999,,,,3990,3990,-9,-9,0,0,28
,20130226,3990,3990,3975,3975,3975,3975,3975,-15,-15,2,7.95,28
,20130227,3975,3975,4023,4023,4023,4023,4023,48,48,2,8.05,28
,20130228,4023,4023,3970,4140,3949,4140,4027,117,4,22,88.6,22
,20130301,4140,4027,4140,4140,4140,4140,4140,113,113,22,91.08,0
,20130304,4140,4140,,,,4140,4140,0,0,0,0,0
,20130305,4140,4140,,,,4140,4140,0,0,0,0,0
,20130306,4140,4140,,,,4140,4140,0,0,0,0,0
,20130307,4140,4140,,,,4140,4140,0,0,0,0,0
,20130308,4140,4140,,,,4140,4140,0,0,0,0,0
,20130311,4140,4140,,,,4140,4140,0,0,0,0,0
,20130312,4140,4140,,,,4140,4140,0,0,0,0,0
,20130313,4140,4140,,,,4140,4140,0,0,0,0,0
,20130314,4140,4140,,,,4140,4140,0,0,0,0,0
,20130315,4140,4140,,,,4140,4140,0,0,0,0,0
wr1304,20130104,4149,4149,,,,4149,4149,0,0,0,0,0
,20130107,4149,4149,,,,4100,4100,-49,-49,0,0,0
,20130108,4100,4100,,,,4084,4084,-16,-16,0,0,0
,20130109,4084,4084,,,,4084,4084,0,0,0,0,0
,20130110,4084,4084,,,,4084,4084,0,0,0,0,0
,20130111,4084,4084,,,,4084,4084,0,0,0,0,0
,20130114,4084,4084,,,,4084,4084,0,0,0,0,0
,20130115,4084,4084,,,,4084,4084,0,0,0,0,0
,20130116,4084,4084,,,,4084,4084,0,0,0,0,0
,20130117,4084,4084,,,,4084,4084,0,0,0,0,0
,20130118,4084,4084,,,,4084,4084,0,0,0,0,0
,20130121,4084,4084,,,,4084,4084,0,0,0,0,0
,20130122,4084,4084,,,,4084,4084,0,0,0,0,0
,20130123,4084,4084,,,,4084,4084,0,0,0,0,0
,20130124,4084,4084,,,,4107,4107,23,23,0,0,0
,20130125,4107,4107,,,,3926,3926,-181,-181,0,0,0
,20130128,3926,3926,3925,4041,3925,4041,3963,115,37,6,23.78,2
,20130129,4041,3963,3963,3963,3963,3963,3963,0,0,2,7.93,4
,20130130,3963,3963,4136,4136,4030,4030,4100,67,137,6,24.6,4
,20130131,4030,4100,,,,4100,4100,0,0,0,0,4
,20130201,4100,4100,,,,4100,4100,0,0,0,0,4
,20130204,4100,4100,,,,4153,4153,53,53,0,0,4
,20130205,4153,4153,,,,4232,4232,79,79,0,0,4
,20130206,4232,4232,4020,4020,4020,4020,4020,-212,-212,2,8.04,4
,20130207,4020,4020,,,,4020,4020,0,0,0,0,4
,20130208,4020,4020,,,,4020,4020,0,0,0,0,4
,20130218,4020,4020,,,,4020,4020,0,0,0,0,4
,20130219,4020,4020,,,,4020,4020,0,0,0,0,4
,20130220,4020,4020,,,,4020,4020,0,0,0,0,4
,20130221,4020,4020,4196,4196,4196,4196,4196,176,176,2,8.39,4
,20130222,4196,4196,,,,4196,4196,0,0,0,0,4
,20130225,4196,4196,,,,4196,4196,0,0,0,0,4
,20130226,4196,4196,,,,4180,4180,-16,-16,0,0,4
,20130227,4180,4180,,,,4230,4230,50,50,0,0,4
,20130228,4230,4230,,,,4234,4234,4,4,0,0,4
,20130301,4234,4234,,,,4352,4352,118,118,0,0,4
,20130304,4352,4352,,,,4352,4352,0,0,0,0,4
,20130305,4352,4352,4134,4134,4134,4134,4134,-218,-218,2,8.27,4
,20130306,4134,4134,3943,3943,3941,3941,3942,-193,-192,4,15.77,2
,20130307,3941,3942,,,,3942,3942,0,0,0,0,2
,20130308,3942,3942,3962,3962,3962,3962,3962,20,20,2,7.92,0
,20130311,3962,3962,,,,3962,3962,0,0,0,0,0
,20130312,3962,3962,,,,3962,3962,0,0,0,0,0
,20130313,3962,3962,,,,3962,3962,0,0,0,0,0
,20130314,3962,3962,,,,3962,3962,0,0,0,0,0
,20130315,3962,3962,,,,3962,3962,0,0,0,0,0
,20130318,3962,3962,,,,3962,3962,0,0,0,0,0
,20130319,3962,3962,,,,3962,3962,0,0,0,0,0
,20130320,3962,3962,,,,3962,3962,0,0,0,0,0
,20130321,3962,3962,,,,3962,3962,0,0,0,0,0
,20130322,3962,3962,,,,3962,3962,0,0,0,0,0
,20130325,3962,3962,,,,3962,3962,0,0,0,0,0
,20130326,3962,3962,,,,3962,3962,0,0,0,0,0
,20130327,3962,3962,,,,3962,3962,0,0,0,0,0
,20130328,3962,3962,,,,3962,3962,0,0,0,0,0
,20130329,3962,3962,,,,3962,3962,0,0,0,0,0
,20130401,3962,3962,,,,3962,3962,0,0,0,0,0
,20130402,3962,3962,,,,3962,3962,0,0,0,0,0
,20130403,3962,3962,,,,3962,3962,0,0,0,0,0
,20130408,3962,3962,,,,3962,3962,0,0,0,0,0
,20130409,3962,3962,,,,3962,3962,0,0,0,0,0
,20130410,3962,3962,,,,3962,3962,0,0,0,0,0
,20130411,3962,3962,,,,3962,3962,0,0,0,0,0
,20130412,3962,3962,,,,3962,3962,0,0,0,0,0
,20130415,3962,3962,,,,3962,3962,0,0,0,0,0
wr1305,20130104,3953,3958,3966,3988,3966,3981,3979,23,21,10,39.79,10
,20130107,3981,3979,3949,4049,3949,4046,4020,67,41,8,32.17,12
,20130108,4046,4020,,,,4020,4020,0,0,0,0,12
,20130109,4020,4020,,,,4020,4020,0,0,0,0,12
,20130110,4020,4020,4001,4025,4000,4025,4008,5,-12,12,48.1,10
,20130111,4025,4008,3930,3934,3930,3934,3931,-74,-77,6,23.59,10
,20130114,3934,3931,3888,3888,3888,3888,3888,-43,-43,2,7.78,10
,20130115,3888,3888,3977,3995,3975,3975,3979,87,91,12,47.75,16
,20130116,3975,3979,3950,3974,3950,3974,3958,-5,-21,6,23.75,10
,20130117,3974,3958,,,,3958,3958,0,0,0,0,10
,20130118,3958,3958,,,,3958,3958,0,0,0,0,10
,20130121,3958,3958,,,,3958,3958,0,0,0,0,10
,20130122,3958,3958,3985,4044,3985,4044,3992,86,34,64,255.54,42
,20130123,4044,3992,4039,4039,3989,4030,3999,38,7,70,279.94,16
,20130124,4030,3999,4022,4049,3994,4016,4019,17,20,18,72.35,18
,20130125,4016,4019,4011,4020,4000,4000,4007,-19,-12,12,48.09,30
,20130128,4000,4007,,,,4007,4007,0,0,0,0,30
,20130129,4007,4007,3992,3999,3983,3984,3987,-23,-20,18,71.77,36
,20130130,3984,3987,3995,4009,3789,3985,3914,-2,-73,40,156.56,48
,20130131,3985,3914,4025,4085,3975,3997,4050,83,136,20,81,34
,20130201,3997,4050,,,,4046,4046,-4,-4,0,0,34
,20130204,4046,4046,4017,4017,4017,4017,4017,-29,-29,6,24.1,34
,20130205,4017,4017,4017,4020,4015,4015,4016,-2,-1,8,32.13,38
,20130206,4015,4016,4015,4015,4015,4015,4015,-1,-1,4,16.06,38
,20130207,4015,4015,3919,3919,3919,3919,3919,-96,-96,2,7.84,38
,20130208,3919,3919,,,,3919,3919,0,0,0,0,38
,20130218,3919,3919,3967,3967,3965,3965,3966,46,47,8,31.73,36
,20130219,3965,3966,,,,3966,3966,0,0,0,0,36
,20130220,3966,3966,,,,3966,3966,0,0,0,0,36
,20130221,3966,3966,3905,3954,3905,3954,3936,-12,-30,6,23.62,32
,20130222,3954,3936,3950,3954,3950,3954,3952,18,16,4,15.81,30
,20130225,3954,3952,,,,3952,3952,0,0,0,0,30
,20130226,3952,3952,,,,3952,3952,0,0,0,0,30
,20130227,3952,3952,,,,3952,3952,0,0,0,0,30
,20130228,3952,3952,,,,3952,3952,0,0,0,0,30
,20130301,3952,3952,3945,4005,3945,4005,3983,53,31,42,167.33,12
,20130304,4005,3983,3995,3995,3995,3995,3995,12,12,2,7.99,12
,20130305,3995,3995,3986,3986,3986,3986,3986,-9,-9,4,15.94,8
,20130306,3986,3986,3970,3995,3970,3995,3978,9,-8,6,23.87,8
,20130307,3995,3978,,,,3978,3978,0,0,0,0,8
,20130308,3978,3978,,,,3978,3978,0,0,0,0,8
,20130311,3978,3978,,,,3978,3978,0,0,0,0,8
,20130312,3978,3978,,,,3978,3978,0,0,0,0,8
,20130313,3978,3978,3990,3990,3953,3953,3977,-25,-1,6,23.87,8
,20130314,3953,3977,3851,3936,3851,3936,3893,-41,-84,4,15.57,8
,20130315,3936,3893,,,,3893,3893,0,0,0,0,8
,20130318,3893,3893,3860,3942,3860,3942,3897,49,4,6,23.39,6
,20130319,3942,3897,,,,3898,3898,1,1,0,0,6
,20130320,3898,3898,3969,3969,3901,3901,3935,3,37,4,15.74,6
,20130321,3901,3935,,,,3935,3935,0,0,0,0,6
,20130322,3935,3935,3932,3932,3932,3932,3932,-3,-3,2,7.86,8
,20130325,3932,3932,3883,3883,3883,3883,3883,-49,-49,2,7.77,6
,20130326,3883,3883,,,,3883,3883,0,0,0,0,6
,20130327,3883,3883,,,,3883,3883,0,0,0,0,6
,20130328,3883,3883,,,,3883,3883,0,0,0,0,6
,20130329,3883,3883,,,,3883,3883,0,0,0,0,6
,20130401,3883,3883,3893,3893,3893,3893,3893,10,10,2,7.79,6
,20130402,3893,3893,3888,3888,3888,3888,3888,-5,-5,2,7.78,6
,20130403,3888,3888,,,,3888,3888,0,0,0,0,6
,20130408,3888,3888,,,,3888,3888,0,0,0,0,6
,20130409,3888,3888,,,,3888,3888,0,0,0,0,6
,20130410,3888,3888,,,,3888,3888,0,0,0,0,6
,20130411,3888,3888,,,,3888,3888,0,0,0,0,6
,20130412,3888,3888,,,,3888,3888,0,0,0,0,6
,20130415,3888,3888,,,,3807,3807,-81,-81,0,0,6
,20130416,3807,3807,,,,3807,3807,0,0,0,0,6
,20130417,3807,3807,3713,3713,3713,3713,3713,-94,-94,2,7.43,6
,20130418,3713,3713,,,,3713,3713,0,0,0,0,6
,20130419,3713,3713,,,,3713,3713,0,0,0,0,6
,20130422,3713,3713,,,,3713,3713,0,0,0,0,6
,20130423,3713,3713,3825,3825,3825,3825,3825,112,112,2,7.65,6
,20130424,3825,3825,,,,3773,3773,-52,-52,0,0,6
,20130425,3773,3773,3601,3601,3600,3600,3600,-173,-173,4,14.4,2
,20130426,3600,3600,3810,3810,3810,3810,3810,210,210,2,7.62,0
,20130502,3810,3810,,,,3810,3810,0,0,0,0,0
,20130503,3810,3810,,,,3810,3810,0,0,0,0,0
,20130506,3810,3810,,,,3810,3810,0,0,0,0,0
,20130507,3810,3810,,,,3810,3810,0,0,0,0,0
,20130508,3810,3810,,,,3810,3810,0,0,0,0,0
,20130509,3810,3810,,,,3810,3810,0,0,0,0,0
,20130510,3810,3810,,,,3810,3810,0,0,0,0,0
,20130513,3810,3810,,,,3810,3810,0,0,0,0,0
,20130514,3810,3810,,,,3810,3810,0,0,0,0,0
,20130515,3810,3810,,,,3810,3810,0,0,0,0,0
wr1306,20130104,3891,3891,,,,3911,3911,20,20,0,0,0
,20130107,3911,3911,,,,3952,3952,41,41,0,0,0
,20130108,3952,3952,,,,3988,3988,36,36,0,0,0
,20130109,3988,3988,,,,3988,3988,0,0,0,0,0
,20130110,3988,3988,,,,3976,3976,-12,-12,0,0,0
,20130111,3976,3976,,,,3899,3899,-77,-77,0,0,0
,20130114,3899,3899,,,,3899,3899,0,0,0,0,0
,20130115,3899,3899,,,,3990,3990,91,91,0,0,0
,20130116,3990,3990,,,,3968,3968,-22,-22,0,0,0
,20130117,3968,3968,,,,3968,3968,0,0,0,0,0
,20130118,3968,3968,,,,3968,3968,0,0,0,0,0
,20130121,3968,3968,,,,3968,3968,0,0,0,0,0
,20130122,3968,3968,,,,4002,4002,34,34,0,0,0
,20130123,4002,4002,,,,4009,4009,7,7,0,0,0
,20130124,4009,4009,,,,4029,4029,20,20,0,0,0
,20130125,4029,4029,,,,4017,4017,-12,-12,0,0,0
,20130128,4017,4017,,,,4055,4055,38,38,0,0,0
,20130129,4055,4055,,,,4034,4034,-21,-21,0,0,0
,20130130,4034,4034,,,,3960,3960,-74,-74,0,0,0
,20130131,3960,3960,,,,4097,4097,137,137,0,0,0
,20130201,4097,4097,,,,4097,4097,0,0,0,0,0
,20130204,4097,4097,,,,4067,4067,-30,-30,0,0,0
,20130205,4067,4067,,,,4066,4066,-1,-1,0,0,0
,20130206,4066,4066,,,,4064,4064,-2,-2,0,0,0
,20130207,4064,4064,,,,4064,4064,0,0,0,0,0
,20130208,4064,4064,,,,4064,4064,0,0,0,0,0
,20130218,4064,4064,,,,4112,4112,48,48,0,0,0
,20130219,4112,4112,,,,4112,4112,0,0,0,0,0
,20130220,4112,4112,,,,4112,4112,0,0,0,0,0
,20130221,4112,4112,,,,4081,4081,-31,-31,0,0,0
,20130222,4081,4081,,,,4097,4097,16,16,0,0,0
,20130225,4097,4097,,,,4097,4097,0,0,0,0,0
,20130226,4097,4097,,,,4081,4081,-16,-16,0,0,0
,20130227,4081,4081,,,,4130,4130,49,49,0,0,0
,20130228,4130,4130,,,,4134,4134,4,4,0,0,0
,20130301,4134,4134,,,,4167,4167,33,33,0,0,0
,20130304,4167,4167,,,,4179,4179,12,12,0,0,0
,20130305,4179,4179,,,,4169,4169,-10,-10,0,0,0
,20130306,4169,4169,,,,4161,4161,-8,-8,0,0,0
,20130307,4161,4161,,,,4161,4161,0,0,0,0,0
,20130308,4161,4161,,,,4182,4182,21,21,0,0,0
,20130311,4182,4182,,,,4182,4182,0,0,0,0,0
,20130312,4182,4182,,,,4182,4182,0,0,0,0,0
,20130313,4182,4182,,,,4181,4181,-1,-1,0,0,0
,20130314,4181,4181,,,,4093,4093,-88,-88,0,0,0
,20130315,4093,4093,,,,4093,4093,0,0,0,0,0
,20130318,4093,4093,,,,4097,4097,4,4,0,0,0
,20130319,4097,4097,,,,4097,4097,0,0,0,0,0
,20130320,4097,4097,,,,4135,4135,38,38,0,0,0
,20130321,4135,4135,,,,4135,4135,0,0,0,0,0
,20130322,4135,4135,,,,4131,4131,-4,-4,0,0,0
,20130325,4131,4131,,,,4079,4079,-52,-52,0,0,0
,20130326,4079,4079,,,,4079,4079,0,0,0,0,0
,20130327,4079,4079,,,,4079,4079,0,0,0,0,0
,20130328,4079,4079,,,,4079,4079,0,0,0,0,0
,20130329,4079,4079,,,,4079,4079,0,0,0,0,0
,20130401,4079,4079,,,,4089,4089,10,10,0,0,0
,20130402,4089,4089,,,,4083,4083,-6,-6,0,0,0
,20130403,4083,4083,,,,4083,4083,0,0,0,0,0
,20130408,4083,4083,,,,4083,4083,0,0,0,0,0
,20130409,4083,4083,,,,4083,4083,0,0,0,0,0
,20130410,4083,4083,,,,4083,4083,0,0,0,0,0
,20130411,4083,4083,,,,4083,4083,0,0,0,0,0
,20130412,4083,4083,,,,4083,4083,0,0,0,0,0
,20130415,4083,4083,,,,4083,4083,0,0,0,0,0
,20130416,4083,4083,,,,4083,4083,0,0,0,0,0
,20130417,4083,4083,,,,3982,3982,-101,-101,0,0,0
,20130418,3982,3982,,,,3982,3982,0,0,0,0,0
,20130419,3982,3982,,,,3982,3982,0,0,0,0,0
,20130422,3982,3982,4078,4078,3791,3791,3934,-191,-48,4,15.74,0
,20130423,3791,3934,,,,4052,4052,118,118,0,0,0
,20130424,4052,4052,,,,4052,4052,0,0,0,0,0
,20130425,4052,4052,,,,3866,3866,-186,-186,0,0,0
,20130426,3866,3866,,,,4091,4091,225,225,0,0,0
,20130502,4091,4091,,,,4091,4091,0,0,0,0,0
,20130503,4091,4091,,,,4091,4091,0,0,0,0,0
,20130506,4091,4091,3845,4091,3845,3980,3940,-111,-151,16,63.04,4
,20130507,3980,3940,3707,3707,3707,3707,3707,-233,-233,4,14.83,0
,20130508,3707,3707,,,,3707,3707,0,0,0,0,0
,20130509,3707,3707,,,,3707,3707,0,0,0,0,0
,20130510,3707,3707,,,,3707,3707,0,0,0,0,0
,20130513,3707,3707,,,,3707,3707,0,0,0,0,0
,20130514,3707,3707,,,,3707,3707,0,0,0,0,0
,20130515,3707,3707,3900,3900,3500,3500,3700,-207,-7,8,29.6,0
,20130516,3500,3700,,,,3700,3700,0,0,0,0,0
,20130517,3700,3700,,,,3700,3700,0,0,0,0,0
,20130520,3700,3700,,,,3700,3700,0,0,0,0,0
,20130521,3700,3700,,,,3700,3700,0,0,0,0,0
,20130522,3700,3700,,,,3700,3700,0,0,0,0,0
,20130523,3700,3700,,,,3700,3700,0,0,0,0,0
,20130524,3700,3700,,,,3700,3700,0,0,0,0,0
,20130527,3700,3700,,,,3700,3700,0,0,0,0,0
,20130528,3700,3700,,,,3700,3700,0,0,0,0,0
,20130529,3700,3700,,,,3700,3700,0,0,0,0,0
,20130530,3700,3700,,,,3700,3700,0,0,0,0,0
,20130531,3700,3700,,,,3700,3700,0,0,0,0,0
,20130603,3700,3700,,,,3700,3700,0,0,0,0,0
,20130604,3700,3700,,,,3700,3700,0,0,0,0,0
,20130605,3700,3700,,,,3700,3700,0,0,0,0,0
,20130606,3700,3700,,,,3700,3700,0,0,0,0,0
,20130607,3700,3700,,,,3700,3700,0,0,0,0,0
,20130613,3700,3700,,,,3700,3700,0,0,0,0,0
,20130614,3700,3700,,,,3700,3700,0,0,0,0,0
,20130617,3700,3700,,,,3700,3700,0,0,0,0,0
wr1307,20130104,3876,3876,,,,3896,3896,20,20,0,0,0
,20130107,3896,3896,,,,3936,3936,40,40,0,0,0
,20130108,3936,3936,,,,3936,3936,0,0,0,0,0
,20130109,3936,3936,,,,3936,3936,0,0,0,0,0
,20130110,3936,3936,,,,3924,3924,-12,-12,0,0,0
,20130111,3924,3924,,,,3924,3924,0,0,0,0,0
,20130114,3924,3924,,,,3881,3881,-43,-43,0,0,0
,20130115,3881,3881,,,,3971,3971,90,90,0,0,0
,20130116,3971,3971,4005,4005,4005,4005,4005,34,34,2,8.01,2
,20130117,4005,4005,3874,3874,3874,3874,3874,-131,-131,2,7.75,0
,20130118,3874,3874,,,,3874,3874,0,0,0,0,0
,20130121,3874,3874,,,,3874,3874,0,0,0,0,0
,20130122,3874,3874,,,,3908,3908,34,34,0,0,0
,20130123,3908,3908,,,,3915,3915,7,7,0,0,0
,20130124,3915,3915,,,,3934,3934,19,19,0,0,0
,20130125,3934,3934,,,,3922,3922,-12,-12,0,0,0
,20130128,3922,3922,,,,3959,3959,37,37,0,0,0
,20130129,3959,3959,,,,3939,3939,-20,-20,0,0,0
,20130130,3939,3939,,,,3866,3866,-73,-73,0,0,0
,20130131,3866,3866,,,,4000,4000,134,134,0,0,0
,20130201,4000,4000,,,,4000,4000,0,0,0,0,0
,20130204,4000,4000,,,,3971,3971,-29,-29,0,0,0
,20130205,3971,3971,,,,3970,3970,-1,-1,0,0,0
,20130206,3970,3970,,,,3969,3969,-1,-1,0,0,0
,20130207,3969,3969,,,,3969,3969,0,0,0,0,0
,20130208,3969,3969,,,,3845,3845,-124,-124,0,0,0
,20130218,3845,3845,,,,3891,3891,46,46,0,0,0
,20130219,3891,3891,,,,3891,3891,0,0,0,0,0
,20130220,3891,3891,,,,3891,3891,0,0,0,0,0
,20130221,3891,3891,,,,3861,3861,-30,-30,0,0,0
,20130222,3861,3861,,,,3876,3876,15,15,0,0,0
,20130225,3876,3876,,,,3876,3876,0,0,0,0,0
,20130226,3876,3876,,,,3861,3861,-15,-15,0,0,0
,20130227,3861,3861,,,,3907,3907,46,46,0,0,0
,20130228,3907,3907,,,,3910,3910,3,3,0,0,0
,20130301,3910,3910,,,,3941,3941,31,31,0,0,0
,20130304,3941,3941,,,,3952,3952,11,11,0,0,0
,20130305,3952,3952,,,,3943,3943,-9,-9,0,0,0
,20130306,3943,3943,,,,3935,3935,-8,-8,0,0,0
,20130307,3935,3935,,,,3935,3935,0,0,0,0,0
,20130308,3935,3935,,,,3954,3954,19,19,0,0,0
,20130311,3954,3954,,,,3954,3954,0,0,0,0,0
,20130312,3954,3954,,,,3954,3954,0,0,0,0,0
,20130313,3954,3954,,,,3953,3953,-1,-1,0,0,0
,20130314,3953,3953,,,,3870,3870,-83,-83,0,0,0
,20130315,3870,3870,,,,3870,3870,0,0,0,0,0
,20130318,3870,3870,,,,3874,3874,4,4,0,0,0
,20130319,3874,3874,,,,3874,3874,0,0,0,0,0
,20130320,3874,3874,,,,3910,3910,36,36,0,0,0
,20130321,3910,3910,,,,3910,3910,0,0,0,0,0
,20130322,3910,3910,,,,3910,3910,0,0,0,0,0
,20130325,3910,3910,,,,3861,3861,-49,-49,0,0,0
,20130326,3861,3861,,,,3861,3861,0,0,0,0,0
,20130327,3861,3861,,,,3861,3861,0,0,0,0,0
,20130328,3861,3861,,,,3861,3861,0,0,0,0,0
,20130329,3861,3861,,,,3861,3861,0,0,0,0,0
,20130401,3861,3861,,,,3870,3870,9,9,0,0,0
,20130402,3870,3870,,,,3865,3865,-5,-5,0,0,0
,20130403,3865,3865,,,,3865,3865,0,0,0,0,0
,20130408,3865,3865,,,,3865,3865,0,0,0,0,0
,20130409,3865,3865,,,,3865,3865,0,0,0,0,0
,20130410,3865,3865,,,,3865,3865,0,0,0,0,0
,20130411,3865,3865,,,,3865,3865,0,0,0,0,0
,20130412,3865,3865,,,,3865,3865,0,0,0,0,0
,20130415,3865,3865,,,,3865,3865,0,0,0,0,0
,20130416,3865,3865,,,,3865,3865,0,0,0,0,0
,20130417,3865,3865,,,,3769,3769,-96,-96,0,0,0
,20130418,3769,3769,,,,3769,3769,0,0,0,0,0
,20130419,3769,3769,,,,3769,3769,0,0,0,0,0
,20130422,3769,3769,,,,3724,3724,-45,-45,0,0,0
,20130423,3724,3724,,,,3836,3836,112,112,0,0,0
,20130424,3836,3836,,,,3836,3836,0,0,0,0,0
,20130425,3836,3836,,,,3660,3660,-176,-176,0,0,0
,20130426,3660,3660,,,,3660,3660,0,0,0,0,0
,20130502,3660,3660,,,,3660,3660,0,0,0,0,0
,20130503,3660,3660,,,,3660,3660,0,0,0,0,0
,20130506,3660,3660,,,,3660,3660,0,0,0,0,0
,20130507,3660,3660,,,,3660,3660,0,0,0,0,0
,20130508,3660,3660,,,,3660,3660,0,0,0,0,0
,20130509,3660,3660,,,,3660,3660,0,0,0,0,0
,20130510,3660,3660,,,,3660,3660,0,0,0,0,0
,20130513,3660,3660,,,,3660,3660,0,0,0,0,0
,20130514,3660,3660,,,,3660,3660,0,0,0,0,0
,20130515,3660,3660,,,,3653,3653,-7,-7,0,0,0
,20130516,3653,3653,,,,3653,3653,0,0,0,0,0
,20130517,3653,3653,,,,3653,3653,0,0,0,0,0
,20130520,3653,3653,,,,3653,3653,0,0,0,0,0
,20130521,3653,3653,,,,3653,3653,0,0,0,0,0
,20130522,3653,3653,,,,3653,3653,0,0,0,0,0
,20130523,3653,3653,,,,3653,3653,0,0,0,0,0
,20130524,3653,3653,,,,3653,3653,0,0,0,0,0
,20130527,3653,3653,,,,3653,3653,0,0,0,0,0
,20130528,3653,3653,,,,3653,3653,0,0,0,0,0
,20130529,3653,3653,,,,3653,3653,0,0,0,0,0
,20130530,3653,3653,,,,3653,3653,0,0,0,0,0
,20130531,3653,3653,,,,3653,3653,0,0,0,0,0
,20130603,3653,3653,,,,3653,3653,0,0,0,0,0
,20130604,3653,3653,,,,3653,3653,0,0,0,0,0
,20130605,3653,3653,,,,3653,3653,0,0,0,0,0
,20130606,3653,3653,,,,3653,3653,0,0,0,0,0
,20130607,3653,3653,,,,3653,3653,0,0,0,0,0
,20130613,3653,3653,,,,3653,3653,0,0,0,0,0
,20130614,3653,3653,,,,3653,3653,0,0,0,0,0
,20130617,3653,3653,,,,3653,3653,0,0,0,0,0
,20130618,3653,3653,,,,3653,3653,0,0,0,0,0
,20130619,3653,3653,3451,3604,3451,3477,3500,-176,-153,14,49,2
,20130620,3477,3500,3525,3525,3525,3525,3525,25,25,2,7.05,0
,20130621,3525,3525,,,,3525,3525,0,0,0,0,0
,20130624,3525,3525,,,,3525,3525,0,0,0,0,0
,20130625,3525,3525,,,,3525,3525,0,0,0,0,0
,20130626,3525,3525,,,,3525,3525,0,0,0,0,0
,20130627,3525,3525,,,,3525,3525,0,0,0,0,0
,20130628,3525,3525,,,,3525,3525,0,0,0,0,0
,20130701,3525,3525,,,,3525,3525,0,0,0,0,0
,20130702,3525,3525,,,,3525,3525,0,0,0,0,0
,20130703,3525,3525,,,,3525,3525,0,0,0,0,0
,20130704,3525,3525,,,,3525,3525,0,0,0,0,0
,20130705,3525,3525,,,,3525,3525,0,0,0,0,0
,20130708,3525,3525,,,,3525,3525,0,0,0,0,0
,20130709,3525,3525,,,,3525,3525,0,0,0,0,0
,20130710,3525,3525,,,,3525,3525,0,0,0,0,0
,20130711,3525,3525,,,,3525,3525,0,0,0,0,0
,20130712,3525,3525,,,,3525,3525,0,0,0,0,0
,20130715,3525,3525,,,,3525,3525,0,0,0,0,0
wr1308,20130104,3953,3953,,,,3973,3973,20,20,0,0,2
,20130107,3973,3973,,,,4014,4014,41,41,0,0,2
,20130108,4014,4014,,,,4014,4014,0,0,0,0,2
,20130109,4014,4014,,,,4014,4014,0,0,0,0,2
,20130110,4014,4014,4014,4014,4014,4014,4014,0,0,2,8.03,2
,20130111,4014,4014,,,,3980,3980,-34,-34,0,0,2
,20130114,3980,3980,,,,3980,3980,0,0,0,0,2
,20130115,3980,3980,,,,3980,3980,0,0,0,0,2
,20130116,3980,3980,,,,3970,3970,-10,-10,0,0,2
,20130117,3970,3970,,,,3970,3970,0,0,0,0,2
,20130118,3970,3970,,,,3970,3970,0,0,0,0,2
,20130121,3970,3970,,,,3970,3970,0,0,0,0,2
,20130122,3970,3970,,,,3970,3970,0,0,0,0,2
,20130123,3970,3970,,,,3977,3977,7,7,0,0,2
,20130124,3977,3977,,,,3977,3977,0,0,0,0,2
,20130125,3977,3977,,,,3977,3977,0,0,0,0,2
,20130128,3977,3977,,,,3977,3977,0,0,0,0,2
,20130129,3977,3977,,,,3977,3977,0,0,0,0,2
,20130130,3977,3977,,,,3977,3977,0,0,0,0,2
,20130131,3977,3977,,,,3977,3977,0,0,0,0,2
,20130201,3977,3977,,,,3977,3977,0,0,0,0,2
,20130204,3977,3977,,,,3948,3948,-29,-29,0,0,2
,20130205,3948,3948,,,,3947,3947,-1,-1,0,0,2
,20130206,3947,3947,,,,3946,3946,-1,-1,0,0,2
,20130207,3946,3946,,,,3946,3946,0,0,0,0,2
,20130208,3946,3946,,,,3823,3823,-123,-123,0,0,2
,20130218,3823,3823,,,,3869,3869,46,46,0,0,2
,20130219,3869,3869,,,,3869,3869,0,0,0,0,2
,20130220,3869,3869,,,,3869,3869,0,0,0,0,2
,20130221,3869,3869,,,,3869,3869,0,0,0,0,2
,20130222,3869,3869,,,,3869,3869,0,0,0,0,2
,20130225,3869,3869,,,,3869,3869,0,0,0,0,2
,20130226,3869,3869,,,,3869,3869,0,0,0,0,2
,20130227,3869,3869,,,,3869,3869,0,0,0,0,2
,20130228,3869,3869,,,,3869,3869,0,0,0,0,2
,20130301,3869,3869,,,,3869,3869,0,0,0,0,2
,20130304,3869,3869,,,,3869,3869,0,0,0,0,2
,20130305,3869,3869,,,,3870,3870,1,1,0,0,2
,20130306,3870,3870,,,,3870,3870,0,0,0,0,2
,20130307,3870,3870,,,,3871,3871,1,1,0,0,2
,20130308,3871,3871,,,,3871,3871,0,0,0,0,2
,20130311,3871,3871,,,,3880,3880,9,9,0,0,2
,20130312,3880,3880,,,,3880,3880,0,0,0,0,2
,20130313,3880,3880,,,,3880,3880,0,0,0,0,2
,20130314,3880,3880,,,,3880,3880,0,0,0,0,2
,20130315,3880,3880,3880,3930,3785,3902,3863,22,-17,14,54.09,2
,20130318,3902,3863,,,,3863,3863,0,0,0,0,2
,20130319,3863,3863,,,,3863,3863,0,0,0,0,2
,20130320,3863,3863,,,,3863,3863,0,0,0,0,2
,20130321,3863,3863,,,,3864,3864,1,1,0,0,2
,20130322,3864,3864,,,,3864,3864,0,0,0,0,2
,20130325,3864,3864,,,,3869,3869,5,5,0,0,2
,20130326,3869,3869,,,,3870,3870,1,1,0,0,2
,20130327,3870,3870,,,,3871,3871,1,1,0,0,2
,20130328,3871,3871,,,,3871,3871,0,0,0,0,2
,20130329,3871,3871,,,,3871,3871,0,0,0,0,2
,20130401,3871,3871,,,,3871,3871,0,0,0,0,2
,20130402,3871,3871,,,,3870,3870,-1,-1,0,0,2
,20130403,3870,3870,,,,3870,3870,0,0,0,0,2
,20130408,3870,3870,,,,3870,3870,0,0,0,0,2
,20130409,3870,3870,,,,3870,3870,0,0,0,0,2
,20130410,3870,3870,,,,3870,3870,0,0,0,0,2
,20130411,3870,3870,,,,3870,3870,0,0,0,0,2
,20130412,3870,3870,,,,3870,3870,0,0,0,0,2
,20130415,3870,3870,,,,3870,3870,0,0,0,0,2
,20130416,3870,3870,,,,3866,3866,-4,-4,0,0,2
,20130417,3866,3866,,,,3770,3770,-96,-96,0,0,2
,20130418,3770,3770,,,,3770,3770,0,0,0,0,2
,20130419,3770,3770,,,,3770,3770,0,0,0,0,2
,20130422,3770,3770,,,,3770,3770,0,0,0,0,2
,20130423,3770,3770,,,,3770,3770,0,0,0,0,2
,20130424,3770,3770,,,,3770,3770,0,0,0,0,2
,20130425,3770,3770,,,,3770,3770,0,0,0,0,2
,20130426,3770,3770,,,,3770,3770,0,0,0,0,2
,20130502,3770,3770,,,,3770,3770,0,0,0,0,2
,20130503,3770,3770,,,,3750,3750,-20,-20,0,0,2
,20130506,3750,3750,,,,3750,3750,0,0,0,0,2
,20130507,3750,3750,,,,3750,3750,0,0,0,0,2
,20130508,3750,3750,,,,3750,3750,0,0,0,0,2
,20130509,3750,3750,,,,3750,3750,0,0,0,0,2
,20130510,3750,3750,,,,3750,3750,0,0,0,0,2
,20130513,3750,3750,3657,3742,3657,3742,3699,-8,-51,4,14.8,2
,20130514,3742,3699,3726,3726,3726,3726,3726,27,27,2,7.45,2
,20130515,3726,3726,3628,3628,3628,3628,3628,-98,-98,2,7.26,2
,20130516,3628,3628,,,,3628,3628,0,0,0,0,2
,20130517,3628,3628,,,,3628,3628,0,0,0,0,2
,20130520,3628,3628,3531,3531,3531,3531,3531,-97,-97,2,7.06,2
,20130521,3531,3531,,,,3613,3613,82,82,0,0,2
,20130522,3613,3613,,,,3625,3625,12,12,0,0,2
,20130523,3625,3625,,,,3625,3625,0,0,0,0,2
,20130524,3625,3625,,,,3625,3625,0,0,0,0,2
,20130527,3625,3625,3600,3600,3474,3600,3558,-25,-67,6,21.35,2
,20130528,3600,3558,,,,3558,3558,0,0,0,0,2
,20130529,3558,3558,,,,3558,3558,0,0,0,0,2
,20130530,3558,3558,3437,3437,3437,3437,3437,-121,-121,2,6.87,2
,20130531,3437,3437,,,,3477,3477,40,40,0,0,2
,20130603,3477,3477,,,,3501,3501,24,24,0,0,2
,20130604,3501,3501,,,,3501,3501,0,0,0,0,2
,20130605,3501,3501,,,,3501,3501,0,0,0,0,2
,20130606,3501,3501,3400,3550,3400,3550,3475,49,-26,4,13.9,2
,20130607,3550,3475,,,,3475,3475,0,0,0,0,2
,20130613,3475,3475,,,,3475,3475,0,0,0,0,2
,20130614,3475,3475,,,,3475,3475,0,0,0,0,2
,20130617,3475,3475,,,,3475,3475,0,0,0,0,2
,20130618,3475,3475,3668,3668,3508,3566,3591,91,116,14,50.28,2
,20130619,3566,3591,,,,3591,3591,0,0,0,0,2
,20130620,3591,3591,,,,3591,3591,0,0,0,0,2
,20130621,3591,3591,,,,3591,3591,0,0,0,0,2
,20130624,3591,3591,,,,3591,3591,0,0,0,0,2
,20130625,3591,3591,,,,3591,3591,0,0,0,0,2
,20130626,3591,3591,,,,3591,3591,0,0,0,0,2
,20130627,3591,3591,,,,3592,3592,1,1,0,0,2
,20130628,3592,3592,,,,3592,3592,0,0,0,0,2
,20130701,3592,3592,,,,3592,3592,0,0,0,0,2
,20130702,3592,3592,,,,3592,3592,0,0,0,0,2
,20130703,3592,3592,,,,3592,3592,0,0,0,0,2
,20130704,3592,3592,,,,3592,3592,0,0,0,0,2
,20130705,3592,3592,,,,3600,3600,8,8,0,0,2
,20130708,3600,3600,,,,3625,3625,25,25,0,0,2
,20130709,3625,3625,,,,3625,3625,0,0,0,0,2
,20130710,3625,3625,,,,3625,3625,0,0,0,0,2
,20130711,3625,3625,,,,3625,3625,0,0,0,0,2
,20130712,3625,3625,,,,3650,3650,25,25,0,0,2
,20130715,3650,3650,,,,3650,3650,0,0,0,0,2
,20130716,3650,3650,,,,3650,3650,0,0,0,0,2
,20130717,3650,3650,3766,3766,3766,3766,3766,116,116,2,7.53,2
,20130718,3766,3766,,,,3730,3730,-36,-36,0,0,2
,20130719,3730,3730,,,,3730,3730,0,0,0,0,2
,20130722,3730,3730,,,,3730,3730,0,0,0,0,2
,20130723,3730,3730,,,,3730,3730,0,0,0,0,2
,20130724,3730,3730,,,,3730,3730,0,0,0,0,2
,20130725,3730,3730,,,,3700,3700,-30,-30,0,0,2
,20130726,3700,3700,,,,3700,3700,0,0,0,0,2
,20130729,3700,3700,,,,3700,3700,0,0,0,0,2
,20130730,3700,3700,,,,3700,3700,0,0,0,0,2
,20130731,3700,3700,3800,3800,3800,3800,3800,100,100,2,7.6,2
,20130801,3800,3800,3800,3800,3800,3800,3800,0,0,2,7.6,0
,20130802,3800,3800,,,,3800,3800,0,0,0,0,0
,20130805,3800,3800,,,,3800,3800,0,0,0,0,0
,20130806,3800,3800,,,,3800,3800,0,0,0,0,0
,20130807,3800,3800,,,,3800,3800,0,0,0,0,0
,20130808,3800,3800,,,,3800,3800,0,0,0,0,0
,20130809,3800,3800,,,,3800,3800,0,0,0,0,0
,20130812,3800,3800,,,,3800,3800,0,0,0,0,0
,20130813,3800,3800,,,,3800,3800,0,0,0,0,0
,20130814,3800,3800,,,,3800,3800,0,0,0,0,0
,20130815,3800,3800,,,,3800,3800,0,0,0,0,0
wr1309,20130104,3933,3933,,,,3975,3975,42,42,0,0,2
,20130107,3975,3975,,,,3980,3980,5,5,0,0,2
,20130108,3980,3980,,,,3995,3995,15,15,0,0,2
,20130109,3995,3995,,,,3995,3995,0,0,0,0,2
,20130110,3995,3995,,,,3997,3997,2,2,0,0,2
,20130111,3997,3997,,,,3973,3973,-24,-24,0,0,2
,20130114,3973,3973,,,,3973,3973,0,0,0,0,2
,20130115,3973,3973,,,,3973,3973,0,0,0,0,2
,20130116,3973,3973,,,,3973,3973,0,0,0,0,2
,20130117,3973,3973,,,,3973,3973,0,0,0,0,2
,20130118,3973,3973,,,,3973,3973,0,0,0,0,2
,20130121,3973,3973,,,,3973,3973,0,0,0,0,2
,20130122,3973,3973,,,,3973,3973,0,0,0,0,2
,20130123,3973,3973,,,,3980,3980,7,7,0,0,2
,20130124,3980,3980,,,,3980,3980,0,0,0,0,2
,20130125,3980,3980,,,,3980,3980,0,0,0,0,2
,20130128,3980,3980,,,,3980,3980,0,0,0,0,2
,20130129,3980,3980,,,,3980,3980,0,0,0,0,2
,20130130,3980,3980,,,,3980,3980,0,0,0,0,2
,20130131,3980,3980,,,,3980,3980,0,0,0,0,2
,20130201,3980,3980,,,,3980,3980,0,0,0,0,2
,20130204,3980,3980,,,,3951,3951,-29,-29,0,0,2
,20130205,3951,3951,,,,3950,3950,-1,-1,0,0,2
,20130206,3950,3950,,,,3949,3949,-1,-1,0,0,2
,20130207,3949,3949,,,,3949,3949,0,0,0,0,2
,20130208,3949,3949,,,,3826,3826,-123,-123,0,0,2
,20130218,3826,3826,3850,3850,3850,3850,3850,24,24,4,15.4,6
,20130219,3850,3850,,,,3850,3850,0,0,0,0,6
,20130220,3850,3850,,,,3850,3850,0,0,0,0,6
,20130221,3850,3850,,,,3850,3850,0,0,0,0,6
,20130222,3850,3850,,,,3850,3850,0,0,0,0,6
,20130225,3850,3850,3850,3850,3850,3850,3850,0,0,2,7.7,4
,20130226,3850,3850,,,,3850,3850,0,0,0,0,4
,20130227,3850,3850,3851,3935,3851,3851,3879,1,29,6,23.27,0
,20130228,3851,3879,,,,3882,3882,3,3,0,0,0
,20130301,3882,3882,,,,3913,3913,31,31,0,0,0
,20130304,3913,3913,,,,3924,3924,11,11,0,0,0
,20130305,3924,3924,,,,3915,3915,-9,-9,0,0,0
,20130306,3915,3915,,,,3907,3907,-8,-8,0,0,0
,20130307,3907,3907,,,,3907,3907,0,0,0,0,0
,20130308,3907,3907,,,,3926,3926,19,19,0,0,0
,20130311,3926,3926,,,,3926,3926,0,0,0,0,0
,20130312,3926,3926,,,,3926,3926,0,0,0,0,0
,20130313,3926,3926,,,,3925,3925,-1,-1,0,0,0
,20130314,3925,3925,,,,3842,3842,-83,-83,0,0,0
,20130315,3842,3842,,,,3825,3825,-17,-17,0,0,0
,20130318,3825,3825,,,,3829,3829,4,4,0,0,0
,20130319,3829,3829,4020,4020,3786,3786,3903,-43,74,4,15.61,0
,20130320,3786,3903,,,,3940,3940,37,37,0,0,0
,20130321,3940,3940,,,,3940,3940,0,0,0,0,0
,20130322,3940,3940,,,,3940,3940,0,0,0,0,0
,20130325,3940,3940,,,,3940,3940,0,0,0,0,0
,20130326,3940,3940,,,,3940,3940,0,0,0,0,0
,20130327,3940,3940,,,,3940,3940,0,0,0,0,0
,20130328,3940,3940,,,,3940,3940,0,0,0,0,0
,20130329,3940,3940,,,,3940,3940,0,0,0,0,0
,20130401,3940,3940,,,,3950,3950,10,10,0,0,0
,20130402,3950,3950,,,,3944,3944,-6,-6,0,0,0
,20130403,3944,3944,,,,3944,3944,0,0,0,0,0
,20130408,3944,3944,,,,3944,3944,0,0,0,0,0
,20130409,3944,3944,,,,3944,3944,0,0,0,0,0
,20130410,3944,3944,,,,3944,3944,0,0,0,0,0
,20130411,3944,3944,,,,3942,3942,-2,-2,0,0,0
,20130412,3942,3942,,,,3942,3942,0,0,0,0,0
,20130415,3942,3942,3819,3838,3819,3834,3833,-108,-109,18,69.01,18
,20130416,3834,3833,3733,3824,3733,3740,3764,-93,-69,12,45.17,14
,20130417,3740,3764,3833,3857,3789,3789,3837,25,73,12,46.05,26
,20130418,3789,3837,3648,3667,3648,3667,3654,-170,-183,22,80.4,4
,20130419,3667,3654,3687,3753,3687,3753,3706,99,52,56,207.58,48
,20130422,3753,3706,3789,3789,3685,3723,3766,17,60,58,218.44,0
,20130423,3723,3766,3758,3760,3650,3705,3725,-61,-41,86,320.42,0
,20130424,3705,3725,,,,3725,3725,0,0,0,0,0
,20130425,3725,3725,,,,3554,3554,-171,-171,0,0,0
,20130426,3554,3554,3727,3727,3581,3581,3654,27,100,4,14.62,0
,20130502,3581,3654,,,,3654,3654,0,0,0,0,0
,20130503,3654,3654,,,,3654,3654,0,0,0,0,0
,20130506,3654,3654,,,,3519,3519,-135,-135,0,0,0
,20130507,3519,3519,,,,3618,3618,99,99,0,0,0
,20130508,3618,3618,3617,3742,3617,3710,3694,92,76,26,96.05,2
,20130509,3710,3694,3690,3690,3690,3690,3690,-4,-4,2,7.38,0
,20130510,3690,3690,,,,3690,3690,0,0,0,0,0
,20130513,3690,3690,,,,3690,3690,0,0,0,0,0
,20130514,3690,3690,,,,3690,3690,0,0,0,0,0
,20130515,3690,3690,3787,3787,3694,3694,3740,4,50,20,74.81,0
,20130516,3694,3740,,,,3740,3740,0,0,0,0,0
,20130517,3740,3740,,,,3740,3740,0,0,0,0,0
,20130520,3740,3740,,,,3740,3740,0,0,0,0,0
,20130521,3740,3740,3748,3798,3631,3651,3711,-89,-29,64,237.52,0
,20130522,3651,3711,,,,3711,3711,0,0,0,0,0
,20130523,3711,3711,,,,3711,3711,0,0,0,0,0
,20130524,3711,3711,3565,3680,3565,3680,3622,-31,-89,4,14.49,0
,20130527,3680,3622,,,,3622,3622,0,0,0,0,0
,20130528,3622,3622,,,,3622,3622,0,0,0,0,0
,20130529,3622,3622,,,,3622,3622,0,0,0,0,0
,20130530,3622,3622,,,,3498,3498,-124,-124,0,0,0
,20130531,3498,3498,,,,3498,3498,0,0,0,0,0
,20130603,3498,3498,,,,3498,3498,0,0,0,0,0
,20130604,3498,3498,,,,3498,3498,0,0,0,0,0
,20130605,3498,3498,,,,3499,3499,1,1,0,0,0
,20130606,3499,3499,3593,3593,3593,3593,3593,94,94,4,14.37,4
,20130607,3593,3593,3419,3419,3419,3419,3419,-174,-174,4,13.68,0
,20130613,3419,3419,,,,3419,3419,0,0,0,0,0
,20130614,3419,3419,,,,3419,3419,0,0,0,0,0
,20130617,3419,3419,,,,3460,3460,41,41,0,0,0
,20130618,3460,3460,,,,3576,3576,116,116,0,0,0
,20130619,3576,3576,,,,3576,3576,0,0,0,0,0
,20130620,3576,3576,,,,3601,3601,25,25,0,0,0
,20130621,3601,3601,,,,3601,3601,0,0,0,0,0
,20130624,3601,3601,,,,3601,3601,0,0,0,0,0
,20130625,3601,3601,3411,3585,3411,3585,3498,-16,-103,4,13.99,0
,20130626,3585,3498,,,,3498,3498,0,0,0,0,0
,20130627,3498,3498,,,,3498,3498,0,0,0,0,0
,20130628,3498,3498,,,,3498,3498,0,0,0,0,0
,20130701,3498,3498,,,,3498,3498,0,0,0,0,0
,20130702,3498,3498,,,,3498,3498,0,0,0,0,0
,20130703,3498,3498,,,,3498,3498,0,0,0,0,0
,20130704,3498,3498,,,,3498,3498,0,0,0,0,0
,20130705,3498,3498,,,,3498,3498,0,0,0,0,0
,20130708,3498,3498,,,,3498,3498,0,0,0,0,0
,20130709,3498,3498,,,,3498,3498,0,0,0,0,0
,20130710,3498,3498,,,,3498,3498,0,0,0,0,0
,20130711,3498,3498,,,,3498,3498,0,0,0,0,0
,20130712,3498,3498,,,,3498,3498,0,0,0,0,0
,20130715,3498,3498,,,,3498,3498,0,0,0,0,0
,20130716,3498,3498,,,,3498,3498,0,0,0,0,0
,20130717,3498,3498,,,,3609,3609,111,111,0,0,0
,20130718,3609,3609,,,,3609,3609,0,0,0,0,0
,20130719,3609,3609,,,,3609,3609,0,0,0,0,0
,20130722,3609,3609,3570,3696,3570,3616,3655,7,46,12,43.86,0
,20130723,3616,3655,,,,3655,3655,0,0,0,0,0
,20130724,3655,3655,,,,3655,3655,0,0,0,0,0
,20130725,3655,3655,3610,3656,3610,3656,3625,1,-30,6,21.75,2
,20130726,3656,3625,,,,3625,3625,0,0,0,0,2
,20130729,3625,3625,,,,3625,3625,0,0,0,0,2
,20130730,3625,3625,,,,3625,3625,0,0,0,0,2
,20130731,3625,3625,,,,3722,3722,97,97,0,0,2
,20130801,3722,3722,,,,3690,3690,-32,-32,0,0,2
,20130802,3690,3690,3910,3910,3614,3645,3687,-45,-3,34,125.37,0
,20130805,3645,3687,,,,3687,3687,0,0,0,0,0
,20130806,3687,3687,,,,3687,3687,0,0,0,0,0
,20130807,3687,3687,,,,3687,3687,0,0,0,0,0
,20130808,3687,3687,,,,3687,3687,0,0,0,0,0
,20130809,3687,3687,,,,3687,3687,0,0,0,0,0
,20130812,3687,3687,,,,3687,3687,0,0,0,0,0
,20130813,3687,3687,,,,3687,3687,0,0,0,0,0
,20130814,3687,3687,,,,3687,3687,0,0,0,0,0
,20130815,3687,3687,,,,3687,3687,0,0,0,0,0
,20130816,3687,3687,,,,3687,3687,0,0,0,0,0
,20130819,3687,3687,,,,3687,3687,0,0,0,0,0
,20130820,3687,3687,,,,3687,3687,0,0,0,0,0
,20130821,3687,3687,,,,3687,3687,0,0,0,0,0
,20130822,3687,3687,,,,3687,3687,0,0,0,0,0
,20130823,3687,3687,,,,3687,3687,0,0,0,0,0
,20130826,3687,3687,,,,3687,3687,0,0,0,0,0
,20130827,3687,3687,,,,3687,3687,0,0,0,0,0
,20130828,3687,3687,,,,3687,3687,0,0,0,0,0
,20130829,3687,3687,,,,3687,3687,0,0,0,0,0
,20130830,3687,3687,,,,3687,3687,0,0,0,0,0
,20130902,3687,3687,,,,3687,3687,0,0,0,0,0
,20130903,3687,3687,,,,3687,3687,0,0,0,0,0
,20130904,3687,3687,,,,3687,3687,0,0,0,0,0
,20130905,3687,3687,,,,3687,3687,0,0,0,0,0
,20130906,3687,3687,,,,3687,3687,0,0,0,0,0
,20130909,3687,3687,,,,3687,3687,0,0,0,0,0
,20130910,3687,3687,,,,3687,3687,0,0,0,0,0
,20130911,3687,3687,,,,3687,3687,0,0,0,0,0
,20130912,3687,3687,,,,3687,3687,0,0,0,0,0
,20130913,3687,3687,,,,3687,3687,0,0,0,0,0
,20130916,3687,3687,,,,3687,3687,0,0,0,0,0
wr1310,20130104,3933,3933,,,,3975,3975,42,42,0,0,0
,20130107,3975,3975,,,,3980,3980,5,5,0,0,0
,20130108,3980,3980,,,,3980,3980,0,0,0,0,0
,20130109,3980,3980,,,,3980,3980,0,0,0,0,0
,20130110,3980,3980,,,,3995,3995,15,15,0,0,0
,20130111,3995,3995,,,,3978,3978,-17,-17,0,0,0
,20130114,3978,3978,,,,3934,3934,-44,-44,0,0,0
,20130115,3934,3934,3933,3933,3933,3933,3933,-1,-1,2,7.87,2
,20130116,3933,3933,,,,3933,3933,0,0,0,0,2
,20130117,3933,3933,,,,3933,3933,0,0,0,0,2
,20130118,3933,3933,,,,3935,3935,2,2,0,0,2
,20130121,3935,3935,,,,3935,3935,0,0,0,0,2
,20130122,3935,3935,,,,3955,3955,20,20,0,0,2
,20130123,3955,3955,,,,3962,3962,7,7,0,0,2
,20130124,3962,3962,,,,3962,3962,0,0,0,0,2
,20130125,3962,3962,,,,3950,3950,-12,-12,0,0,2
,20130128,3950,3950,,,,3987,3987,37,37,0,0,2
,20130129,3987,3987,,,,3967,3967,-20,-20,0,0,2
,20130130,3967,3967,,,,3894,3894,-73,-73,0,0,2
,20130131,3894,3894,,,,4029,4029,135,135,0,0,2
,20130201,4029,4029,,,,4029,4029,0,0,0,0,2
,20130204,4029,4029,,,,4000,4000,-29,-29,0,0,2
,20130205,4000,4000,4092,4092,4092,4092,4092,92,92,2,8.18,4
,20130206,4092,4092,4080,4146,4080,4146,4113,54,21,12,49.36,2
,20130207,4146,4113,,,,4014,4014,-99,-99,0,0,2
,20130208,4014,4014,,,,3889,3889,-125,-125,0,0,2
,20130218,3889,3889,,,,3913,3913,24,24,0,0,2
,20130219,3913,3913,,,,3913,3913,0,0,0,0,2
,20130220,3913,3913,,,,3913,3913,0,0,0,0,2
,20130221,3913,3913,,,,3913,3913,0,0,0,0,2
,20130222,3913,3913,3718,3826,3717,3826,3724,-87,-189,562,"2,092.95",500
,20130225,3826,3724,3841,3865,3826,3853,3851,129,127,28,107.85,482
,20130226,3853,3851,3658,3855,3658,3855,3767,4,-84,56,210.96,474
,20130227,3855,3767,3918,3928,3860,3870,3911,103,144,40,156.45,456
,20130228,3870,3911,3949,3949,3843,3869,3869,-42,-42,128,495.35,446
,20130301,3869,3869,3870,3873,3870,3873,3871,4,2,4,15.49,446
,20130304,3873,3871,3845,3932,3830,3885,3846,14,-25,482,"1,853.90",6
,20130305,3885,3846,3865,3899,3865,3899,3882,53,36,8,31.06,4
,20130306,3899,3882,3883,3925,3883,3925,3907,43,25,36,140.68,4
,20130307,3925,3907,,,,3907,3907,0,0,0,0,4
,20130308,3907,3907,3935,3975,3855,3895,3903,-12,-4,112,437.23,4
,20130311,3895,3903,3918,3918,3918,3918,3918,15,15,10,39.18,12
,20130312,3918,3918,3900,3900,3899,3899,3899,-19,-19,10,39,16
,20130313,3899,3899,3897,3900,3890,3890,3896,-9,-3,10,38.96,12
,20130314,3890,3896,3825,3881,3811,3881,3837,-15,-59,18,69.07,14
,20130315,3881,3837,3821,3898,3810,3850,3827,13,-10,182,696.64,36
,20130318,3850,3827,3844,3844,3791,3815,3812,-12,-15,56,213.52,20
,20130319,3815,3812,3823,3823,3823,3823,3823,11,11,2,7.65,18
,20130320,3823,3823,3900,3911,3900,3911,3901,88,78,30,117.05,12
,20130321,3911,3901,3950,3965,3941,3946,3953,45,52,10,39.53,10
,20130322,3946,3953,3925,3925,3925,3925,3925,-28,-28,2,7.85,10
,20130325,3925,3925,3928,3965,3928,3965,3938,40,13,8,31.51,10
,20130326,3965,3938,3931,3931,3927,3927,3929,-11,-9,4,15.72,10
,20130327,3927,3929,,,,3929,3929,0,0,0,0,10
,20130328,3929,3929,3900,3919,3900,3919,3912,-10,-17,6,23.47,10
,20130329,3919,3912,3808,3908,3808,3908,3858,-4,-54,4,15.43,10
,20130401,3908,3858,3858,3865,3801,3865,3838,7,-20,16,61.42,10
,20130402,3865,3838,3869,3869,3839,3860,3855,22,17,10,38.56,10
,20130403,3860,3855,3890,3929,3866,3902,3899,47,44,28,109.2,12
,20130408,3902,3899,,,,3899,3899,0,0,0,0,12
,20130409,3899,3899,3969,3969,3908,3920,3932,21,33,10,39.32,14
,20130410,3920,3932,3889,3889,3889,3889,3889,-43,-43,4,15.56,16
,20130411,3889,3889,3902,3964,3888,3888,3917,-1,28,20,78.35,16
,20130412,3888,3917,3906,3910,3906,3910,3908,-7,-9,4,15.63,14
,20130415,3910,3908,,,,3864,3864,-44,-44,0,0,14
,20130416,3864,3864,3710,3810,3710,3795,3763,-69,-101,20,75.27,14
,20130417,3795,3763,3766,3799,3750,3768,3768,5,5,32,120.6,12
,20130418,3768,3768,3752,3768,3731,3768,3747,0,-21,18,67.45,12
,20130419,3768,3747,3765,3771,3765,3771,3767,24,20,6,22.6,12
,20130422,3771,3767,,,,3767,3767,0,0,0,0,12
,20130423,3767,3767,3711,3718,3711,3718,3714,-49,-53,12,44.57,12
,20130424,3718,3714,,,,3715,3715,1,1,0,0,12
,20130425,3715,3715,3714,3714,3713,3713,3713,-2,-2,6,22.28,14
,20130426,3713,3713,3797,3797,3742,3742,3782,29,69,30,113.47,12
,20130502,3742,3782,3666,3673,3635,3635,3652,-147,-130,8,29.22,14
,20130503,3635,3652,3696,3702,3646,3676,3672,24,20,62,227.69,20
,20130506,3676,3672,3671,3759,3671,3750,3724,78,52,16,59.6,22
,20130507,3750,3724,,,,3725,3725,1,1,0,0,22
,20130508,3725,3725,3725,3745,3725,3745,3728,20,3,12,44.74,14
,20130509,3745,3728,3744,3744,3711,3713,3725,-15,-3,24,89.4,14
,20130510,3713,3725,3725,3725,3725,3725,3725,0,0,2,7.45,12
,20130513,3725,3725,3750,3750,3750,3750,3750,25,25,2,7.5,12
,20130514,3750,3750,,,,3750,3750,0,0,0,0,12
,20130515,3750,3750,3739,3739,3676,3676,3707,-74,-43,4,14.83,12
,20130516,3676,3707,,,,3707,3707,0,0,0,0,12
,20130517,3707,3707,3693,3714,3658,3714,3675,7,-32,86,316.1,16
,20130520,3714,3675,3705,3767,3683,3720,3732,45,57,30,111.98,12
,20130521,3720,3732,,,,3732,3732,0,0,0,0,12
,20130522,3732,3732,,,,3732,3732,0,0,0,0,12
,20130523,3732,3732,,,,3700,3700,-32,-32,0,0,12
,20130524,3700,3700,3600,3700,3600,3670,3665,-30,-35,14,51.32,12
,20130527,3670,3665,3636,3636,3636,3636,3636,-29,-29,2,7.27,12
,20130528,3636,3636,,,,3636,3636,0,0,0,0,12
,20130529,3636,3636,,,,3580,3580,-56,-56,0,0,12
,20130530,3580,3580,,,,3580,3580,0,0,0,0,12
,20130531,3580,3580,3665,3665,3551,3564,3578,-16,-2,86,307.76,34
,20130603,3564,3578,3563,3563,3560,3560,3561,-18,-17,24,85.47,12
,20130604,3560,3561,3620,3620,3563,3583,3587,22,26,68,243.97,38
,20130605,3583,3587,3582,3604,3561,3587,3574,0,-13,152,543.31,14
,20130606,3587,3574,3525,3600,3510,3600,3560,26,-14,16,56.97,14
,20130607,3600,3560,3554,3554,3554,3554,3554,-6,-6,4,14.22,14
,20130613,3554,3554,,,,3554,3554,0,0,0,0,14
,20130614,3554,3554,3527,3557,3516,3516,3533,-38,-21,6,21.2,14
,20130617,3516,3533,3620,3620,3567,3567,3593,34,60,4,14.37,14
,20130618,3567,3593,,,,3593,3593,0,0,0,0,14
,20130619,3593,3593,3615,3615,3615,3615,3615,22,22,2,7.23,16
,20130620,3615,3615,,,,3615,3615,0,0,0,0,16
,20130621,3615,3615,3480,3628,3480,3628,3561,13,-54,50,178.09,16
,20130624,3628,3561,3619,3621,3606,3621,3616,60,55,10,36.17,16
,20130625,3621,3616,,,,3600,3600,-16,-16,0,0,16
,20130626,3600,3600,3599,3599,3599,3599,3599,-1,-1,2,7.2,16
,20130627,3599,3599,3579,3579,3579,3579,3579,-20,-20,2,7.16,16
,20130628,3579,3579,,,,3579,3579,0,0,0,0,16
,20130701,3579,3579,,,,3581,3581,2,2,0,0,16
,20130702,3581,3581,3620,3620,3620,3620,3620,39,39,2,7.24,14
,20130703,3620,3620,3610,3610,3506,3570,3533,-50,-87,98,346.24,60
,20130704,3570,3533,3520,3552,3520,3521,3531,-12,-2,6,21.19,60
,20130705,3521,3531,3523,3530,3517,3530,3525,-1,-6,10,35.25,56
,20130708,3530,3525,3524,3530,3520,3530,3527,5,2,16,56.43,42
,20130709,3530,3527,,,,3527,3527,0,0,0,0,42
,20130710,3527,3527,3547,3548,3535,3535,3545,8,18,10,35.45,34
,20130711,3535,3545,,,,3565,3565,20,20,0,0,34
,20130712,3565,3565,,,,3565,3565,0,0,0,0,34
,20130715,3565,3565,3566,3566,3566,3566,3566,1,1,4,14.26,32
,20130716,3566,3566,,,,3566,3566,0,0,0,0,32
,20130717,3566,3566,,,,3566,3566,0,0,0,0,32
,20130718,3566,3566,3545,3545,3545,3545,3545,-21,-21,4,14.18,32
,20130719,3545,3545,3595,3609,3545,3585,3582,40,37,20,71.66,32
,20130722,3585,3582,,,,3582,3582,0,0,0,0,32
,20130723,3582,3582,3582,3582,3582,3582,3582,0,0,8,28.66,24
,20130724,3582,3582,,,,3582,3582,0,0,0,0,24
,20130725,3582,3582,,,,3582,3582,0,0,0,0,24
,20130726,3582,3582,,,,3582,3582,0,0,0,0,24
,20130729,3582,3582,3582,3606,3582,3606,3594,24,12,18,64.69,14
,20130730,3606,3594,,,,3594,3594,0,0,0,0,14
,20130731,3594,3594,3590,3600,3512,3600,3569,6,-25,16,57.11,4
,20130801,3600,3569,,,,3569,3569,0,0,0,0,4
,20130802,3569,3569,,,,3590,3590,21,21,0,0,4
,20130805,3590,3590,,,,3599,3599,9,9,0,0,4
,20130806,3599,3599,,,,3601,3601,2,2,0,0,4
,20130807,3601,3601,,,,3610,3610,9,9,0,0,4
,20130808,3610,3610,,,,3646,3646,36,36,0,0,4
,20130809,3646,3646,,,,3655,3655,9,9,0,0,4
,20130812,3655,3655,3596,3680,3596,3680,3638,25,-17,4,14.55,4
,20130813,3680,3638,,,,3674,3674,36,36,0,0,4
,20130814,3674,3674,,,,3674,3674,0,0,0,0,4
,20130815,3674,3674,3674,3674,3674,3674,3674,0,0,2,7.35,4
,20130816,3674,3674,,,,3674,3674,0,0,0,0,4
,20130819,3674,3674,,,,3674,3674,0,0,0,0,4
,20130820,3674,3674,3695,3695,3695,3695,3695,21,21,2,7.39,2
,20130821,3695,3695,3825,3840,3715,3715,3793,20,98,6,22.76,0
,20130822,3715,3793,,,,3793,3793,0,0,0,0,0
,20130823,3793,3793,,,,3793,3793,0,0,0,0,0
,20130826,3793,3793,,,,3793,3793,0,0,0,0,0
,20130827,3793,3793,,,,3793,3793,0,0,0,0,0
,20130828,3793,3793,,,,3793,3793,0,0,0,0,0
,20130829,3793,3793,,,,3793,3793,0,0,0,0,0
,20130830,3793,3793,,,,3793,3793,0,0,0,0,0
,20130902,3793,3793,,,,3793,3793,0,0,0,0,0
,20130903,3793,3793,,,,3793,3793,0,0,0,0,0
,20130904,3793,3793,,,,3793,3793,0,0,0,0,0
,20130905,3793,3793,,,,3793,3793,0,0,0,0,0
,20130906,3793,3793,,,,3793,3793,0,0,0,0,0
,20130909,3793,3793,,,,3793,3793,0,0,0,0,0
,20130910,3793,3793,,,,3793,3793,0,0,0,0,0
,20130911,3793,3793,,,,3793,3793,0,0,0,0,0
,20130912,3793,3793,,,,3793,3793,0,0,0,0,0
,20130913,3793,3793,,,,3745,3745,-48,-48,0,0,0
,20130916,3745,3745,,,,3745,3745,0,0,0,0,0
,20130917,3745,3745,,,,3745,3745,0,0,0,0,0
,20130918,3745,3745,3520,3969,3520,3886,3722,141,-23,104,387.11,0
,20130923,3886,3722,,,,3722,3722,0,0,0,0,0
,20130924,3722,3722,,,,3722,3722,0,0,0,0,0
,20130925,3722,3722,,,,3722,3722,0,0,0,0,0
,20130926,3722,3722,,,,3722,3722,0,0,0,0,0
,20130927,3722,3722,,,,3722,3722,0,0,0,0,0
,20130930,3722,3722,,,,3722,3722,0,0,0,0,0
,20131008,3722,3722,,,,3722,3722,0,0,0,0,0
,20131009,3722,3722,,,,3722,3722,0,0,0,0,0
,20131010,3722,3722,,,,3722,3722,0,0,0,0,0
,20131011,3722,3722,,,,3722,3722,0,0,0,0,0
,20131014,3722,3722,,,,3722,3722,0,0,0,0,0
,20131015,3722,3722,,,,3722,3722,0,0,0,0,0
wr1311,20130104,3933,3933,,,,3975,3975,42,42,0,0,0
,20130107,3975,3975,,,,3980,3980,5,5,0,0,0
,20130108,3980,3980,,,,3980,3980,0,0,0,0,0
,20130109,3980,3980,,,,3980,3980,0,0,0,0,0
,20130110,3980,3980,,,,3980,3980,0,0,0,0,0
,20130111,3980,3980,,,,3903,3903,-77,-77,0,0,0
,20130114,3903,3903,,,,3860,3860,-43,-43,0,0,0
,20130115,3860,3860,,,,3939,3939,79,79,0,0,0
,20130116,3939,3939,,,,3972,3972,33,33,0,0,0
,20130117,3972,3972,,,,3972,3972,0,0,0,0,0
,20130118,3972,3972,,,,3972,3972,0,0,0,0,0
,20130121,3972,3972,,,,3972,3972,0,0,0,0,0
,20130122,3972,3972,,,,4006,4006,34,34,0,0,0
,20130123,4006,4006,,,,4013,4013,7,7,0,0,0
,20130124,4013,4013,,,,4013,4013,0,0,0,0,0
,20130125,4013,4013,,,,4013,4013,0,0,0,0,0
,20130128,4013,4013,,,,4051,4051,38,38,0,0,0
,20130129,4051,4051,,,,4030,4030,-21,-21,0,0,0
,20130130,4030,4030,,,,3956,3956,-74,-74,0,0,0
,20130131,3956,3956,,,,3956,3956,0,0,0,0,0
,20130201,3956,3956,,,,3956,3956,0,0,0,0,0
,20130204,3956,3956,,,,3927,3927,-29,-29,0,0,0
,20130205,3927,3927,,,,4017,4017,90,90,0,0,0
,20130206,4017,4017,,,,4017,4017,0,0,0,0,0
,20130207,4017,4017,,,,3920,3920,-97,-97,0,0,0
,20130208,3920,3920,4216,4216,4200,4200,4208,280,288,4,16.83,0
,20130218,4200,4208,,,,4234,4234,26,26,0,0,0
,20130219,4234,4234,,,,4234,4234,0,0,0,0,0
,20130220,4234,4234,,,,4234,4234,0,0,0,0,0
,20130221,4234,4234,,,,4202,4202,-32,-32,0,0,0
,20130222,4202,4202,,,,3999,3999,-203,-203,0,0,0
,20130225,3999,3999,,,,4136,4136,137,137,0,0,0
,20130226,4136,4136,,,,4045,4045,-91,-91,0,0,0
,20130227,4045,4045,,,,4199,4199,154,154,0,0,0
,20130228,4199,4199,,,,4154,4154,-45,-45,0,0,0
,20130301,4154,4154,,,,4156,4156,2,2,0,0,0
,20130304,4156,4156,,,,4129,4129,-27,-27,0,0,0
,20130305,4129,4129,,,,4167,4167,38,38,0,0,0
,20130306,4167,4167,,,,4194,4194,27,27,0,0,0
,20130307,4194,4194,,,,4194,4194,0,0,0,0,0
,20130308,4194,4194,,,,4190,4190,-4,-4,0,0,0
,20130311,4190,4190,,,,4206,4206,16,16,0,0,0
,20130312,4206,4206,,,,4186,4186,-20,-20,0,0,0
,20130313,4186,4186,4245,4245,3976,3976,4029,-210,-157,10,40.3,8
,20130314,3976,4029,,,,3920,3920,-109,-109,0,0,8
,20130315,3920,3920,,,,3920,3920,0,0,0,0,8
,20130318,3920,3920,3919,3919,3919,3919,3919,-1,-1,2,7.84,8
,20130319,3919,3919,,,,3919,3919,0,0,0,0,8
,20130320,3919,3919,,,,3999,3999,80,80,0,0,8
,20130321,3999,3999,,,,4052,4052,53,53,0,0,8
,20130322,4052,4052,,,,3983,3983,-69,-69,0,0,8
,20130325,3983,3983,3989,3989,3989,3989,3989,6,6,2,7.98,8
,20130326,3989,3989,,,,3966,3966,-23,-23,0,0,8
,20130327,3966,3966,3959,3959,3959,3959,3959,-7,-7,2,7.92,8
,20130328,3959,3959,,,,3958,3958,-1,-1,0,0,8
,20130329,3958,3958,,,,3955,3955,-3,-3,0,0,8
,20130401,3955,3955,,,,3865,3865,-90,-90,0,0,8
,20130402,3865,3865,,,,3865,3865,0,0,0,0,8
,20130403,3865,3865,,,,3909,3909,44,44,0,0,8
,20130408,3909,3909,,,,3909,3909,0,0,0,0,8
,20130409,3909,3909,,,,3909,3909,0,0,0,0,8
,20130410,3909,3909,,,,3909,3909,0,0,0,0,8
,20130411,3909,3909,,,,3909,3909,0,0,0,0,8
,20130412,3909,3909,,,,3909,3909,0,0,0,0,8
,20130415,3909,3909,,,,3870,3870,-39,-39,0,0,8
,20130416,3870,3870,3844,3844,3844,3844,3844,-26,-26,2,7.69,8
,20130417,3844,3844,3796,3796,3796,3796,3796,-48,-48,2,7.59,6
,20130418,3796,3796,,,,3796,3796,0,0,0,0,6
,20130419,3796,3796,,,,3796,3796,0,0,0,0,6
,20130422,3796,3796,,,,3790,3790,-6,-6,0,0,6
,20130423,3790,3790,,,,3751,3751,-39,-39,0,0,6
,20130424,3751,3751,,,,3751,3751,0,0,0,0,6
,20130425,3751,3751,,,,3751,3751,0,0,0,0,6
,20130426,3751,3751,,,,3821,3821,70,70,0,0,6
,20130502,3821,3821,,,,3800,3800,-21,-21,0,0,6
,20130503,3800,3800,,,,3789,3789,-11,-11,0,0,6
,20130506,3789,3789,,,,3843,3843,54,54,0,0,6
,20130507,3843,3843,,,,3773,3773,-70,-70,0,0,6
,20130508,3773,3773,,,,3773,3773,0,0,0,0,6
,20130509,3773,3773,,,,3743,3743,-30,-30,0,0,6
,20130510,3743,3743,,,,3743,3743,0,0,0,0,6
,20130513,3743,3743,3710,3710,3710,3710,3710,-33,-33,2,7.42,4
,20130514,3710,3710,,,,3710,3710,0,0,0,0,4
,20130515,3710,3710,,,,3700,3700,-10,-10,0,0,4
,20130516,3700,3700,,,,3700,3700,0,0,0,0,4
,20130517,3700,3700,,,,3700,3700,0,0,0,0,4
,20130520,3700,3700,,,,3700,3700,0,0,0,0,4
,20130521,3700,3700,,,,3700,3700,0,0,0,0,4
,20130522,3700,3700,,,,3700,3700,0,0,0,0,4
,20130523,3700,3700,,,,3700,3700,0,0,0,0,4
,20130524,3700,3700,,,,3700,3700,0,0,0,0,4
,20130527,3700,3700,,,,3670,3670,-30,-30,0,0,4
,20130528,3670,3670,,,,3670,3670,0,0,0,0,4
,20130529,3670,3670,,,,3670,3670,0,0,0,0,4
,20130530,3670,3670,,,,3545,3545,-125,-125,0,0,4
,20130531,3545,3545,3414,3500,3414,3430,3448,-115,-97,6,20.69,4
,20130603,3430,3448,,,,3524,3524,76,76,0,0,4
,20130604,3524,3524,3625,3625,3625,3625,3625,101,101,4,14.5,4
,20130605,3625,3625,,,,3625,3625,0,0,0,0,4
,20130606,3625,3625,,,,3581,3581,-44,-44,0,0,4
,20130607,3581,3581,,,,3581,3581,0,0,0,0,4
,20130613,3581,3581,,,,3581,3581,0,0,0,0,4
,20130614,3581,3581,,,,3581,3581,0,0,0,0,4
,20130617,3581,3581,,,,3581,3581,0,0,0,0,4
,20130618,3581,3581,,,,3581,3581,0,0,0,0,4
,20130619,3581,3581,,,,3581,3581,0,0,0,0,4
,20130620,3581,3581,,,,3581,3581,0,0,0,0,4
,20130621,3581,3581,3523,3599,3523,3570,3548,-11,-33,16,56.78,10
,20130624,3570,3548,,,,3548,3548,0,0,0,0,10
,20130625,3548,3548,,,,3548,3548,0,0,0,0,10
,20130626,3548,3548,3550,3550,3550,3550,3550,2,2,6,21.3,6
,20130627,3550,3550,,,,3550,3550,0,0,0,0,6
,20130628,3550,3550,,,,3550,3550,0,0,0,0,6
,20130701,3550,3550,,,,3550,3550,0,0,0,0,6
,20130702,3550,3550,,,,3550,3550,0,0,0,0,6
,20130703,3550,3550,,,,3550,3550,0,0,0,0,6
,20130704,3550,3550,,,,3550,3550,0,0,0,0,6
,20130705,3550,3550,,,,3550,3550,0,0,0,0,6
,20130708,3550,3550,,,,3550,3550,0,0,0,0,6
,20130709,3550,3550,,,,3550,3550,0,0,0,0,6
,20130710,3550,3550,,,,3550,3550,0,0,0,0,6
,20130711,3550,3550,,,,3550,3550,0,0,0,0,6
,20130712,3550,3550,,,,3550,3550,0,0,0,0,6
,20130715,3550,3550,,,,3550,3550,0,0,0,0,6
,20130716,3550,3550,,,,3550,3550,0,0,0,0,6
,20130717,3550,3550,,,,3611,3611,61,61,0,0,6
,20130718,3611,3611,3594,3594,3594,3594,3594,-17,-17,2,7.19,4
,20130719,3594,3594,,,,3625,3625,31,31,0,0,4
,20130722,3625,3625,3600,3678,3600,3678,3632,53,7,10,36.32,4
,20130723,3678,3632,,,,3632,3632,0,0,0,0,4
,20130724,3632,3632,,,,3632,3632,0,0,0,0,4
,20130725,3632,3632,,,,3632,3632,0,0,0,0,4
,20130726,3632,3632,,,,3632,3632,0,0,0,0,4
,20130729,3632,3632,,,,3632,3632,0,0,0,0,4
,20130730,3632,3632,,,,3632,3632,0,0,0,0,4
,20130731,3632,3632,,,,3632,3632,0,0,0,0,4
,20130801,3632,3632,,,,3632,3632,0,0,0,0,4
,20130802,3632,3632,3596,3685,3596,3670,3632,38,0,36,130.76,4
,20130805,3670,3632,,,,3632,3632,0,0,0,0,4
,20130806,3632,3632,,,,3632,3632,0,0,0,0,4
,20130807,3632,3632,,,,3632,3632,0,0,0,0,4
,20130808,3632,3632,,,,3632,3632,0,0,0,0,4
,20130809,3632,3632,,,,3632,3632,0,0,0,0,4
,20130812,3632,3632,3692,3786,3692,3772,3737,140,105,8,29.9,4
,20130813,3772,3737,,,,3742,3742,5,5,0,0,4
,20130814,3742,3742,,,,3742,3742,0,0,0,0,4
,20130815,3742,3742,,,,3742,3742,0,0,0,0,4
,20130816,3742,3742,,,,3742,3742,0,0,0,0,4
,20130819,3742,3742,,,,3742,3742,0,0,0,0,4
,20130820,3742,3742,,,,3742,3742,0,0,0,0,4
,20130821,3742,3742,,,,3742,3742,0,0,0,0,4
,20130822,3742,3742,,,,3742,3742,0,0,0,0,4
,20130823,3742,3742,,,,3742,3742,0,0,0,0,4
,20130826,3742,3742,,,,3742,3742,0,0,0,0,4
,20130827,3742,3742,,,,3742,3742,0,0,0,0,4
,20130828,3742,3742,3745,3745,3719,3719,3736,-23,-6,6,22.42,8
,20130829,3719,3736,3847,3847,3733,3733,3790,-3,54,4,15.16,8
,20130830,3733,3790,,,,3790,3790,0,0,0,0,8
,20130902,3790,3790,,,,3790,3790,0,0,0,0,8
,20130903,3790,3790,,,,3788,3788,-2,-2,0,0,8
,20130904,3788,3788,,,,3782,3782,-6,-6,0,0,8
,20130905,3782,3782,,,,3782,3782,0,0,0,0,8
,20130906,3782,3782,,,,3767,3767,-15,-15,0,0,8
,20130909,3767,3767,,,,3767,3767,0,0,0,0,8
,20130910,3767,3767,,,,3767,3767,0,0,0,0,8
,20130911,3767,3767,,,,3767,3767,0,0,0,0,8
,20130912,3767,3767,,,,3767,3767,0,0,0,0,8
,20130913,3767,3767,,,,3767,3767,0,0,0,0,8
,20130916,3767,3767,,,,3767,3767,0,0,0,0,8
,20130917,3767,3767,,,,3725,3725,-42,-42,0,0,8
,20130918,3725,3725,,,,3725,3725,0,0,0,0,8
,20130923,3725,3725,,,,3725,3725,0,0,0,0,8
,20130924,3725,3725,,,,3725,3725,0,0,0,0,8
,20130925,3725,3725,3725,3725,3670,3675,3690,-50,-35,6,22.14,6
,20130926,3675,3690,,,,3690,3690,0,0,0,0,6
,20130927,3690,3690,,,,3690,3690,0,0,0,0,6
,20130930,3690,3690,,,,3690,3690,0,0,0,0,6
,20131008,3690,3690,,,,3690,3690,0,0,0,0,6
,20131009,3690,3690,3700,3700,3700,3700,3700,10,10,2,7.4,4
,20131010,3700,3700,,,,3700,3700,0,0,0,0,4
,20131011,3700,3700,,,,3700,3700,0,0,0,0,4
,20131014,3700,3700,3742,3742,3742,3742,3742,42,42,2,7.48,2
,20131015,3742,3742,,,,3742,3742,0,0,0,0,2
,20131016,3742,3742,,,,3742,3742,0,0,0,0,2
,20131017,3742,3742,,,,3742,3742,0,0,0,0,2
,20131018,3742,3742,,,,3742,3742,0,0,0,0,2
,20131021,3742,3742,,,,3742,3742,0,0,0,0,2
,20131022,3742,3742,,,,3742,3742,0,0,0,0,2
,20131023,3742,3742,,,,3742,3742,0,0,0,0,2
,20131024,3742,3742,,,,3742,3742,0,0,0,0,2
,20131025,3742,3742,3750,3750,3750,3750,3750,8,8,2,7.5,0
,20131028,3750,3750,,,,3750,3750,0,0,0,0,0
,20131029,3750,3750,,,,3750,3750,0,0,0,0,0
,20131030,3750,3750,,,,3750,3750,0,0,0,0,0
,20131031,3750,3750,,,,3750,3750,0,0,0,0,0
,20131101,3750,3750,,,,3750,3750,0,0,0,0,0
,20131104,3750,3750,,,,3750,3750,0,0,0,0,0
,20131105,3750,3750,,,,3750,3750,0,0,0,0,0
,20131106,3750,3750,,,,3750,3750,0,0,0,0,0
,20131107,3750,3750,,,,3750,3750,0,0,0,0,0
,20131108,3750,3750,,,,3750,3750,0,0,0,0,0
,20131111,3750,3750,,,,3750,3750,0,0,0,0,0
,20131112,3750,3750,,,,3750,3750,0,0,0,0,0
,20131113,3750,3750,,,,3750,3750,0,0,0,0,0
,20131114,3750,3750,,,,3750,3750,0,0,0,0,0
,20131115,3750,3750,,,,3750,3750,0,0,0,0,0
wr1312,20130104,4018,4018,,,,4039,4039,21,21,0,0,0
,20130107,4039,4039,,,,4081,4081,42,42,0,0,0
,20130108,4081,4081,,,,4081,4081,0,0,0,0,0
,20130109,4081,4081,,,,4081,4081,0,0,0,0,0
,20130110,4081,4081,,,,4081,4081,0,0,0,0,0
,20130111,4081,4081,,,,4002,4002,-79,-79,0,0,0
,20130114,4002,4002,,,,3958,3958,-44,-44,0,0,0
,20130115,3958,3958,,,,3956,3956,-2,-2,0,0,0
,20130116,3956,3956,,,,3989,3989,33,33,0,0,0
,20130117,3989,3989,,,,3989,3989,0,0,0,0,0
,20130118,3989,3989,,,,3989,3989,0,0,0,0,0
,20130121,3989,3989,3798,4045,3798,4030,3984,41,-5,22,87.66,2
,20130122,4030,3984,3925,3990,3925,3990,3963,6,-21,6,23.78,2
,20130123,3990,3963,,,,3986,3986,23,23,0,0,2
,20130124,3986,3986,,,,3989,3989,3,3,0,0,2
,20130125,3989,3989,,,,3989,3989,0,0,0,0,2
,20130128,3989,3989,,,,3989,3989,0,0,0,0,2
,20130129,3989,3989,,,,3989,3989,0,0,0,0,2
,20130130,3989,3989,,,,3989,3989,0,0,0,0,2
,20130131,3989,3989,,,,3989,3989,0,0,0,0,2
,20130201,3989,3989,,,,3989,3989,0,0,0,0,2
,20130204,3989,3989,,,,3960,3960,-29,-29,0,0,2
,20130205,3960,3960,,,,4051,4051,91,91,0,0,2
,20130206,4051,4051,,,,4051,4051,0,0,0,0,2
,20130207,4051,4051,,,,3954,3954,-97,-97,0,0,2
,20130208,3954,3954,,,,4191,4191,237,237,0,0,2
,20130218,4191,4191,,,,4191,4191,0,0,0,0,2
,20130219,4191,4191,,,,4190,4190,-1,-1,0,0,2
,20130220,4190,4190,,,,4190,4190,0,0,0,0,2
,20130221,4190,4190,,,,4189,4189,-1,-1,0,0,2
,20130222,4189,4189,,,,4128,4128,-61,-61,0,0,2
,20130225,4128,4128,,,,4118,4118,-10,-10,0,0,2
,20130226,4118,4118,,,,4020,4020,-98,-98,0,0,2
,20130227,4020,4020,,,,4018,4018,-2,-2,0,0,2
,20130228,4018,4018,,,,4018,4018,0,0,0,0,2
,20130301,4018,4018,,,,4018,4018,0,0,0,0,2
,20130304,4018,4018,,,,4000,4000,-18,-18,0,0,2
,20130305,4000,4000,,,,4000,4000,0,0,0,0,2
,20130306,4000,4000,,,,4000,4000,0,0,0,0,2
,20130307,4000,4000,,,,4000,4000,0,0,0,0,2
,20130308,4000,4000,,,,4000,4000,0,0,0,0,2
,20130311,4000,4000,,,,4000,4000,0,0,0,0,2
,20130312,4000,4000,,,,4000,4000,0,0,0,0,2
,20130313,4000,4000,,,,4000,4000,0,0,0,0,2
,20130314,4000,4000,,,,4000,4000,0,0,0,0,2
,20130315,4000,4000,,,,3998,3998,-2,-2,0,0,2
,20130318,3998,3998,,,,3827,3827,-171,-171,0,0,2
,20130319,3827,3827,3923,3923,3861,3861,3892,34,65,4,15.57,2
,20130320,3861,3892,,,,3892,3892,0,0,0,0,2
,20130321,3892,3892,,,,3892,3892,0,0,0,0,2
,20130322,3892,3892,,,,3892,3892,0,0,0,0,2
,20130325,3892,3892,,,,3892,3892,0,0,0,0,2
,20130326,3892,3892,,,,3892,3892,0,0,0,0,2
,20130327,3892,3892,,,,3892,3892,0,0,0,0,2
,20130328,3892,3892,,,,3892,3892,0,0,0,0,2
,20130329,3892,3892,,,,3892,3892,0,0,0,0,2
,20130401,3892,3892,,,,3880,3880,-12,-12,0,0,2
,20130402,3880,3880,,,,3872,3872,-8,-8,0,0,2
,20130403,3872,3872,,,,3872,3872,0,0,0,0,2
,20130408,3872,3872,,,,3872,3872,0,0,0,0,2
,20130409,3872,3872,,,,3872,3872,0,0,0,0,2
,20130410,3872,3872,,,,3872,3872,0,0,0,0,2
,20130411,3872,3872,3737,3737,3737,3737,3737,-135,-135,2,7.47,4
,20130412,3737,3737,3800,3800,3800,3800,3800,63,63,2,7.6,4
,20130415,3800,3800,,,,3800,3800,0,0,0,0,4
,20130416,3800,3800,,,,3800,3800,0,0,0,0,4
,20130417,3800,3800,,,,3756,3756,-44,-44,0,0,4
,20130418,3756,3756,,,,3710,3710,-46,-46,0,0,4
,20130419,3710,3710,3746,3746,3722,3722,3733,12,23,8,29.87,8
,20130422,3722,3733,3678,3678,3678,3678,3678,-55,-55,2,7.36,8
,20130423,3678,3678,,,,3640,3640,-38,-38,0,0,8
,20130424,3640,3640,3509,3689,3509,3689,3599,49,-41,4,14.4,8
,20130425,3689,3599,3704,3704,3704,3704,3704,105,105,2,7.41,10
,20130426,3704,3704,3720,3720,3670,3670,3695,-34,-9,4,14.78,10
,20130502,3670,3695,,,,3600,3600,-95,-95,0,0,10
,20130503,3600,3600,,,,3600,3600,0,0,0,0,10
,20130506,3600,3600,,,,3631,3631,31,31,0,0,10
,20130507,3631,3631,,,,3631,3631,0,0,0,0,10
,20130508,3631,3631,,,,3665,3665,34,34,0,0,10
,20130509,3665,3665,3622,3653,3578,3653,3617,-12,-48,6,21.71,6
,20130510,3653,3617,,,,3666,3666,49,49,0,0,6
,20130513,3666,3666,3705,3705,3705,3705,3705,39,39,2,7.41,6
,20130514,3705,3705,3619,3703,3619,3703,3672,-2,-33,6,22.04,6
,20130515,3703,3672,,,,3672,3672,0,0,0,0,6
,20130516,3672,3672,,,,3672,3672,0,0,0,0,6
,20130517,3672,3672,,,,3672,3672,0,0,0,0,6
,20130520,3672,3672,,,,3672,3672,0,0,0,0,6
,20130521,3672,3672,,,,3672,3672,0,0,0,0,6
,20130522,3672,3672,,,,3672,3672,0,0,0,0,6
,20130523,3672,3672,,,,3672,3672,0,0,0,0,6
,20130524,3672,3672,,,,3672,3672,0,0,0,0,6
,20130527,3672,3672,,,,3642,3642,-30,-30,0,0,6
,20130528,3642,3642,,,,3642,3642,0,0,0,0,6
,20130529,3642,3642,,,,3615,3615,-27,-27,0,0,6
,20130530,3615,3615,,,,3492,3492,-123,-123,0,0,6
,20130531,3492,3492,,,,3492,3492,0,0,0,0,6
,20130603,3492,3492,,,,3546,3546,54,54,0,0,6
,20130604,3546,3546,,,,3546,3546,0,0,0,0,6
,20130605,3546,3546,,,,3555,3555,9,9,0,0,6
,20130606,3555,3555,,,,3549,3549,-6,-6,0,0,6
,20130607,3549,3549,,,,3549,3549,0,0,0,0,6
,20130613,3549,3549,,,,3549,3549,0,0,0,0,6
,20130614,3549,3549,,,,3549,3549,0,0,0,0,6
,20130617,3549,3549,,,,3559,3559,10,10,0,0,6
,20130618,3559,3559,,,,3559,3559,0,0,0,0,6
,20130619,3559,3559,,,,3559,3559,0,0,0,0,6
,20130620,3559,3559,,,,3559,3559,0,0,0,0,6
,20130621,3559,3559,,,,3559,3559,0,0,0,0,6
,20130624,3559,3559,3600,3600,3600,3600,3600,41,41,2,7.2,8
,20130625,3600,3600,3557,3557,3519,3555,3542,-45,-58,16,56.67,12
,20130626,3555,3542,3493,3493,3485,3485,3489,-57,-53,4,13.96,10
,20130627,3485,3489,,,,3489,3489,0,0,0,0,10
,20130628,3489,3489,,,,3524,3524,35,35,0,0,10
,20130701,3524,3524,,,,3534,3534,10,10,0,0,10
,20130702,3534,3534,,,,3550,3550,16,16,0,0,10
,20130703,3550,3550,3600,3600,3600,3600,3600,50,50,2,7.2,8
,20130704,3600,3600,,,,3600,3600,0,0,0,0,8
,20130705,3600,3600,,,,3600,3600,0,0,0,0,8
,20130708,3600,3600,,,,3600,3600,0,0,0,0,8
,20130709,3600,3600,,,,3600,3600,0,0,0,0,8
,20130710,3600,3600,,,,3600,3600,0,0,0,0,8
,20130711,3600,3600,,,,3600,3600,0,0,0,0,8
,20130712,3600,3600,,,,3600,3600,0,0,0,0,8
,20130715,3600,3600,,,,3600,3600,0,0,0,0,8
,20130716,3600,3600,,,,3600,3600,0,0,0,0,8
,20130717,3600,3600,,,,3600,3600,0,0,0,0,8
,20130718,3600,3600,,,,3600,3600,0,0,0,0,8
,20130719,3600,3600,,,,3600,3600,0,0,0,0,8
,20130722,3600,3600,,,,3600,3600,0,0,0,0,8
,20130723,3600,3600,,,,3600,3600,0,0,0,0,8
,20130724,3600,3600,,,,3600,3600,0,0,0,0,8
,20130725,3600,3600,,,,3600,3600,0,0,0,0,8
,20130726,3600,3600,,,,3600,3600,0,0,0,0,8
,20130729,3600,3600,,,,3600,3600,0,0,0,0,8
,20130730,3600,3600,,,,3626,3626,26,26,0,0,8
,20130731,3626,3626,,,,3626,3626,0,0,0,0,8
,20130801,3626,3626,,,,3626,3626,0,0,0,0,8
,20130802,3626,3626,,,,3626,3626,0,0,0,0,8
,20130805,3626,3626,,,,3626,3626,0,0,0,0,8
,20130806,3626,3626,,,,3626,3626,0,0,0,0,8
,20130807,3626,3626,,,,3626,3626,0,0,0,0,8
,20130808,3626,3626,,,,3626,3626,0,0,0,0,8
,20130809,3626,3626,,,,3626,3626,0,0,0,0,8
,20130812,3626,3626,,,,3626,3626,0,0,0,0,8
,20130813,3626,3626,,,,3775,3775,149,149,0,0,8
,20130814,3775,3775,,,,3785,3785,10,10,0,0,8
,20130815,3785,3785,,,,3785,3785,0,0,0,0,8
,20130816,3785,3785,,,,3785,3785,0,0,0,0,8
,20130819,3785,3785,3825,3825,3825,3825,3825,40,40,2,7.65,6
,20130820,3825,3825,,,,3825,3825,0,0,0,0,6
,20130821,3825,3825,,,,3825,3825,0,0,0,0,6
,20130822,3825,3825,,,,3769,3769,-56,-56,0,0,6
,20130823,3769,3769,,,,3770,3770,1,1,0,0,6
,20130826,3770,3770,,,,3770,3770,0,0,0,0,6
,20130827,3770,3770,,,,3770,3770,0,0,0,0,6
,20130828,3770,3770,,,,3770,3770,0,0,0,0,6
,20130829,3770,3770,,,,3770,3770,0,0,0,0,6
,20130830,3770,3770,,,,3770,3770,0,0,0,0,6
,20130902,3770,3770,,,,3770,3770,0,0,0,0,6
,20130903,3770,3770,,,,3770,3770,0,0,0,0,6
,20130904,3770,3770,,,,3770,3770,0,0,0,0,6
,20130905,3770,3770,,,,3770,3770,0,0,0,0,6
,20130906,3770,3770,,,,3770,3770,0,0,0,0,6
,20130909,3770,3770,,,,3770,3770,0,0,0,0,6
,20130910,3770,3770,,,,3770,3770,0,0,0,0,6
,20130911,3770,3770,,,,3770,3770,0,0,0,0,6
,20130912,3770,3770,,,,3770,3770,0,0,0,0,6
,20130913,3770,3770,,,,3770,3770,0,0,0,0,6
,20130916,3770,3770,,,,3770,3770,0,0,0,0,6
,20130917,3770,3770,,,,3707,3707,-63,-63,0,0,6
,20130918,3707,3707,,,,3707,3707,0,0,0,0,6
,20130923,3707,3707,,,,3707,3707,0,0,0,0,6
,20130924,3707,3707,,,,3707,3707,0,0,0,0,6
,20130925,3707,3707,,,,3707,3707,0,0,0,0,6
,20130926,3707,3707,,,,3707,3707,0,0,0,0,6
,20130927,3707,3707,,,,3707,3707,0,0,0,0,6
,20130930,3707,3707,,,,3700,3700,-7,-7,0,0,6
,20131008,3700,3700,,,,3700,3700,0,0,0,0,6
,20131009,3700,3700,,,,3693,3693,-7,-7,0,0,6
,20131010,3693,3693,,,,3666,3666,-27,-27,0,0,6
,20131011,3666,3666,,,,3666,3666,0,0,0,0,6
,20131014,3666,3666,,,,3666,3666,0,0,0,0,6
,20131015,3666,3666,,,,3666,3666,0,0,0,0,6
,20131016,3666,3666,,,,3666,3666,0,0,0,0,6
,20131017,3666,3666,,,,3666,3666,0,0,0,0,6
,20131018,3666,3666,,,,3666,3666,0,0,0,0,6
,20131021,3666,3666,,,,3666,3666,0,0,0,0,6
,20131022,3666,3666,,,,3666,3666,0,0,0,0,6
,20131023,3666,3666,,,,3666,3666,0,0,0,0,6
,20131024,3666,3666,,,,3666,3666,0,0,0,0,6
,20131025,3666,3666,,,,3663,3663,-3,-3,0,0,6
,20131028,3663,3663,,,,3663,3663,0,0,0,0,6
,20131029,3663,3663,,,,3663,3663,0,0,0,0,6
,20131030,3663,3663,,,,3663,3663,0,0,0,0,6
,20131031,3663,3663,,,,3663,3663,0,0,0,0,6
,20131101,3663,3663,,,,3663,3663,0,0,0,0,6
,20131104,3663,3663,,,,3663,3663,0,0,0,0,6
,20131105,3663,3663,,,,3663,3663,0,0,0,0,6
,20131106,3663,3663,,,,3663,3663,0,0,0,0,6
,20131107,3663,3663,3690,3691,3690,3691,3690,28,27,4,14.76,2
,20131108,3691,3690,,,,3690,3690,0,0,0,0,2
,20131111,3690,3690,,,,3690,3690,0,0,0,0,2
,20131112,3690,3690,,,,3690,3690,0,0,0,0,2
,20131113,3690,3690,,,,3690,3690,0,0,0,0,2
,20131114,3690,3690,,,,3690,3690,0,0,0,0,2
,20131115,3690,3690,,,,3640,3640,-50,-50,0,0,2
,20131118,3640,3640,,,,3640,3640,0,0,0,0,2
,20131119,3640,3640,,,,3640,3640,0,0,0,0,2
,20131120,3640,3640,,,,3590,3590,-50,-50,0,0,2
,20131121,3590,3590,,,,3590,3590,0,0,0,0,2
,20131122,3590,3590,,,,3590,3590,0,0,0,0,2
,20131125,3590,3590,,,,3590,3590,0,0,0,0,2
,20131126,3590,3590,,,,3590,3590,0,0,0,0,2
,20131127,3590,3590,,,,3590,3590,0,0,0,0,2
,20131128,3590,3590,,,,3590,3590,0,0,0,0,2
,20131129,3590,3590,3590,3590,3590,3590,3590,0,0,2,7.18,0
,20131202,3590,3590,,,,3590,3590,0,0,0,0,0
,20131203,3590,3590,,,,3590,3590,0,0,0,0,0
,20131204,3590,3590,,,,3590,3590,0,0,0,0,0
,20131205,3590,3590,,,,3590,3590,0,0,0,0,0
,20131206,3590,3590,,,,3590,3590,0,0,0,0,0
,20131209,3590,3590,,,,3590,3590,0,0,0,0,0
,20131210,3590,3590,,,,3590,3590,0,0,0,0,0
,20131211,3590,3590,,,,3590,3590,0,0,0,0,0
,20131212,3590,3590,,,,3590,3590,0,0,0,0,0
,20131213,3590,3590,,,,3590,3590,0,0,0,0,0
,20131216,3590,3590,,,,3590,3590,0,0,0,0,0
wr1401,20130116,3956,3956,,,,3989,3989,33,33,0,0,0
,20130117,3989,3989,,,,3989,3989,0,0,0,0,0
,20130118,3989,3989,,,,3989,3989,0,0,0,0,0
,20130121,3989,3989,,,,3989,3989,0,0,0,0,0
,20130122,3989,3989,,,,3968,3968,-21,-21,0,0,0
,20130123,3968,3968,,,,3975,3975,7,7,0,0,0
,20130124,3975,3975,,,,3975,3975,0,0,0,0,0
,20130125,3975,3975,,,,3963,3963,-12,-12,0,0,0
,20130128,3963,3963,,,,4001,4001,38,38,0,0,0
,20130129,4001,4001,,,,3981,3981,-20,-20,0,0,0
,20130130,3981,3981,,,,3908,3908,-73,-73,0,0,0
,20130131,3908,3908,,,,4043,4043,135,135,0,0,0
,20130201,4043,4043,,,,4043,4043,0,0,0,0,0
,20130204,4043,4043,,,,4014,4014,-29,-29,0,0,0
,20130205,4014,4014,,,,4106,4106,92,92,0,0,0
,20130206,4106,4106,,,,4127,4127,21,21,0,0,0
,20130207,4127,4127,,,,4028,4028,-99,-99,0,0,0
,20130208,4028,4028,,,,4323,4323,295,295,0,0,0
,20130218,4323,4323,,,,4350,4350,27,27,0,0,0
,20130219,4350,4350,,,,4350,4350,0,0,0,0,0
,20130220,4350,4350,,,,4350,4350,0,0,0,0,0
,20130221,4350,4350,,,,4317,4317,-33,-33,0,0,0
,20130222,4317,4317,,,,4108,4108,-209,-209,0,0,0
,20130225,4108,4108,,,,4100,4100,-8,-8,0,0,0
,20130226,4100,4100,,,,4010,4010,-90,-90,0,0,0
,20130227,4010,4010,,,,4163,4163,153,153,0,0,0
,20130228,4163,4163,,,,4119,4119,-44,-44,0,0,0
,20130301,4119,4119,,,,4117,4117,-2,-2,0,0,0
,20130304,4117,4117,,,,4090,4090,-27,-27,0,0,0
,20130305,4090,4090,,,,4128,4128,38,38,0,0,0
,20130306,4128,4128,,,,4155,4155,27,27,0,0,0
,20130307,4155,4155,4094,4094,3838,3838,3966,-317,-189,4,15.86,2
,20130308,3838,3966,3888,3888,3888,3888,3888,-78,-78,2,7.78,0
,20130311,3888,3888,,,,3888,3888,0,0,0,0,0
,20130312,3888,3888,,,,3888,3888,0,0,0,0,0
,20130313,3888,3888,,,,3888,3888,0,0,0,0,0
,20130314,3888,3888,,,,3888,3888,0,0,0,0,0
,20130315,3888,3888,,,,3888,3888,0,0,0,0,0
,20130318,3888,3888,,,,3887,3887,-1,-1,0,0,0
,20130319,3887,3887,,,,3953,3953,66,66,0,0,0
,20130320,3953,3953,,,,4034,4034,81,81,0,0,0
,20130321,4034,4034,,,,4087,4087,53,53,0,0,0
,20130322,4087,4087,,,,4058,4058,-29,-29,0,0,0
,20130325,4058,4058,,,,4064,4064,6,6,0,0,0
,20130326,4064,4064,,,,4054,4054,-10,-10,0,0,0
,20130327,4054,4054,,,,4046,4046,-8,-8,0,0,0
,20130328,4046,4046,,,,4028,4028,-18,-18,0,0,0
,20130329,4028,4028,,,,3972,3972,-56,-56,0,0,0
,20130401,3972,3972,,,,3952,3952,-20,-20,0,0,0
,20130402,3952,3952,,,,3970,3970,18,18,0,0,0
,20130403,3970,3970,,,,3970,3970,0,0,0,0,0
,20130408,3970,3970,,,,3970,3970,0,0,0,0,0
,20130409,3970,3970,,,,3963,3963,-7,-7,0,0,0
,20130410,3963,3963,,,,3919,3919,-44,-44,0,0,0
,20130411,3919,3919,,,,3782,3782,-137,-137,0,0,0
,20130412,3782,3782,,,,3845,3845,63,63,0,0,0
,20130415,3845,3845,,,,3845,3845,0,0,0,0,0
,20130416,3845,3845,,,,3819,3819,-26,-26,0,0,0
,20130417,3819,3819,,,,3819,3819,0,0,0,0,0
,20130418,3819,3819,,,,3798,3798,-21,-21,0,0,0
,20130419,3798,3798,,,,3821,3821,23,23,0,0,0
,20130422,3821,3821,,,,3764,3764,-57,-57,0,0,0
,20130423,3764,3764,,,,3711,3711,-53,-53,0,0,0
,20130424,3711,3711,,,,3711,3711,0,0,0,0,0
,20130425,3711,3711,3788,3788,3627,3627,3707,-84,-4,8,29.66,0
,20130426,3627,3707,,,,3697,3697,-10,-10,0,0,0
,20130502,3697,3697,,,,3697,3697,0,0,0,0,0
,20130503,3697,3697,,,,3697,3697,0,0,0,0,0
,20130506,3697,3697,,,,3697,3697,0,0,0,0,0
,20130507,3697,3697,,,,3697,3697,0,0,0,0,0
,20130508,3697,3697,,,,3697,3697,0,0,0,0,0
,20130509,3697,3697,3608,3608,3608,3608,3608,-89,-89,2,7.22,2
,20130510,3608,3608,,,,3620,3620,12,12,0,0,2
,20130513,3620,3620,,,,3648,3648,28,28,0,0,2
,20130514,3648,3648,,,,3648,3648,0,0,0,0,2
,20130515,3648,3648,3740,3740,3656,3656,3698,8,50,4,14.79,4
,20130516,3656,3698,3607,3607,3607,3607,3607,-91,-91,2,7.21,2
,20130517,3607,3607,3470,3673,3470,3623,3588,16,-19,8,28.71,2
,20130520,3623,3588,,,,3646,3646,58,58,0,0,2
,20130521,3646,3646,3745,3745,3611,3640,3670,-6,24,20,73.41,12
,20130522,3640,3670,3650,3672,3650,3671,3662,1,-8,12,43.95,8
,20130523,3671,3662,3656,3659,3640,3640,3650,-22,-12,14,51.1,10
,20130524,3640,3650,3609,3628,3595,3628,3618,-22,-32,14,50.66,10
,20130527,3628,3618,3606,3606,3600,3605,3603,-13,-15,6,21.62,16
,20130528,3605,3603,,,,3580,3580,-23,-23,0,0,16
,20130529,3580,3580,3584,3584,3569,3569,3578,-11,-2,8,28.62,24
,20130530,3569,3578,,,,3560,3560,-18,-18,0,0,24
,20130531,3560,3560,,,,3558,3558,-2,-2,0,0,24
,20130603,3558,3558,3595,3595,3549,3549,3572,-9,14,4,14.29,24
,20130604,3549,3572,,,,3572,3572,0,0,0,0,24
,20130605,3572,3572,3574,3574,3574,3574,3574,2,2,8,28.59,16
,20130606,3574,3574,3553,3554,3553,3554,3553,-20,-21,12,42.64,16
,20130607,3554,3553,,,,3553,3553,0,0,0,0,16
,20130613,3553,3553,,,,3553,3553,0,0,0,0,16
,20130614,3553,3553,,,,3553,3553,0,0,0,0,16
,20130617,3553,3553,,,,3568,3568,15,15,0,0,16
,20130618,3568,3568,,,,3579,3579,11,11,0,0,16
,20130619,3579,3579,3610,3610,3605,3605,3606,26,27,6,21.64,14
,20130620,3605,3606,3607,3607,3556,3556,3561,-50,-45,26,92.6,18
,20130621,3556,3561,3556,3616,3531,3616,3578,55,17,26,93.03,6
,20130624,3616,3578,,,,3578,3578,0,0,0,0,6
,20130625,3578,3578,3539,3539,3508,3531,3524,-47,-54,44,155.07,10
,20130626,3531,3524,3499,3503,3499,3503,3501,-21,-23,4,14,10
,20130627,3503,3501,3537,3537,3537,3537,3537,36,36,2,7.07,8
,20130628,3537,3537,3575,3575,3567,3567,3572,30,35,6,21.43,6
,20130701,3567,3572,,,,3572,3572,0,0,0,0,6
,20130702,3572,3572,,,,3572,3572,0,0,0,0,6
,20130703,3572,3572,3572,3572,3572,3572,3572,0,0,2,7.14,4
,20130704,3572,3572,,,,3569,3569,-3,-3,0,0,4
,20130705,3569,3569,3669,3669,3623,3623,3646,54,77,4,14.58,4
,20130708,3623,3646,3609,3650,3609,3610,3623,-36,-23,6,21.74,6
,20130709,3610,3623,,,,3623,3623,0,0,0,0,6
,20130710,3623,3623,3636,3661,3592,3639,3614,16,-9,210,759.08,8
,20130711,3639,3614,3652,3670,3652,3670,3661,56,47,4,14.64,4
,20130712,3670,3661,,,,3661,3661,0,0,0,0,4
,20130715,3661,3661,,,,3662,3662,1,1,0,0,4
,20130716,3662,3662,3662,3700,3662,3700,3681,38,19,4,14.72,2
,20130717,3700,3681,,,,3681,3681,0,0,0,0,2
,20130718,3681,3681,,,,3681,3681,0,0,0,0,2
,20130719,3681,3681,3692,3700,3692,3700,3696,19,15,4,14.78,4
,20130722,3700,3696,3728,3728,3728,3728,3728,32,32,2,7.46,4
,20130723,3728,3728,3684,3773,3684,3717,3715,-11,-13,22,81.73,12
,20130724,3717,3715,3715,3715,3715,3715,3715,0,0,4,14.86,8
,20130725,3715,3715,,,,3715,3715,0,0,0,0,8
,20130726,3715,3715,3677,3706,3677,3702,3690,-13,-25,22,81.19,2
,20130729,3702,3690,3670,3670,3670,3670,3670,-20,-20,2,7.34,2
,20130730,3670,3670,,,,3670,3670,0,0,0,0,2
,20130731,3670,3670,3666,3666,3641,3653,3654,-17,-16,18,65.78,0
,20130801,3653,3654,,,,3654,3654,0,0,0,0,0
,20130802,3654,3654,3676,3832,3676,3693,3733,39,79,12,44.8,0
,20130805,3693,3733,,,,3733,3733,0,0,0,0,0
,20130806,3733,3733,,,,3733,3733,0,0,0,0,0
,20130807,3733,3733,3733,3733,3704,3704,3718,-29,-15,4,14.87,0
,20130808,3704,3718,3754,3754,3724,3724,3739,6,21,4,14.96,0
,20130809,3724,3739,3735,3844,3735,3757,3766,18,27,10,37.66,0
,20130812,3757,3766,,,,3875,3875,109,109,0,0,0
,20130813,3875,3875,,,,3875,3875,0,0,0,0,0
,20130814,3875,3875,,,,3875,3875,0,0,0,0,0
,20130815,3875,3875,,,,3875,3875,0,0,0,0,0
,20130816,3875,3875,,,,3873,3873,-2,-2,0,0,0
,20130819,3873,3873,,,,3913,3913,40,40,0,0,0
,20130820,3913,3913,,,,3866,3866,-47,-47,0,0,0
,20130821,3866,3866,,,,3866,3866,0,0,0,0,0
,20130822,3866,3866,,,,3801,3801,-65,-65,0,0,0
,20130823,3801,3801,3816,3826,3810,3826,3817,25,16,10,38.18,0
,20130826,3826,3817,3817,3843,3817,3841,3828,24,11,28,107.21,10
,20130827,3841,3828,3784,3784,3784,3784,3784,-44,-44,4,15.14,6
,20130828,3784,3784,3817,3817,3817,3817,3817,33,33,2,7.63,6
,20130829,3817,3817,3800,3800,3743,3743,3757,-74,-60,8,30.06,10
,20130830,3743,3757,3775,3775,3775,3775,3775,18,18,6,22.65,4
,20130902,3775,3775,3781,3812,3781,3812,3796,37,21,8,30.37,4
,20130903,3812,3796,3767,3767,3767,3767,3767,-29,-29,2,7.53,6
,20130904,3767,3767,3737,3737,3737,3737,3737,-30,-30,2,7.47,8
,20130905,3737,3737,3749,3749,3749,3749,3749,12,12,2,7.5,6
,20130906,3749,3749,3712,3740,3712,3740,3723,-9,-26,42,156.38,4
,20130909,3740,3723,3775,3775,3752,3752,3763,29,40,4,15.05,6
,20130910,3752,3763,,,,3750,3750,-13,-13,0,0,6
,20130911,3750,3750,,,,3750,3750,0,0,0,0,6
,20130912,3750,3750,3717,3740,3717,3740,3728,-10,-22,32,119.31,4
,20130913,3740,3728,3718,3718,3696,3696,3707,-32,-21,4,14.83,4
,20130916,3696,3707,,,,3707,3707,0,0,0,0,4
,20130917,3707,3707,,,,3707,3707,0,0,0,0,4
,20130918,3707,3707,3707,3707,3625,3625,3666,-82,-41,8,29.33,6
,20130923,3625,3666,3675,3675,3675,3675,3675,9,9,2,7.35,4
,20130924,3675,3675,,,,3675,3675,0,0,0,0,4
,20130925,3675,3675,,,,3675,3675,0,0,0,0,4
,20130926,3675,3675,,,,3675,3675,0,0,0,0,4
,20130927,3675,3675,3647,3647,3600,3600,3631,-75,-44,6,21.79,2
,20130930,3600,3631,,,,3631,3631,0,0,0,0,2
,20131008,3631,3631,3623,3774,3623,3774,3674,143,43,6,22.04,2
,20131009,3774,3674,3698,3698,3601,3677,3650,3,-24,10,36.51,2
,20131010,3677,3650,,,,3650,3650,0,0,0,0,2
,20131011,3650,3650,,,,3650,3650,0,0,0,0,2
,20131014,3650,3650,,,,3650,3650,0,0,0,0,2
,20131015,3650,3650,,,,3650,3650,0,0,0,0,2
,20131016,3650,3650,3674,3674,3608,3625,3646,-25,-4,70,255.23,2
,20131017,3625,3646,,,,3646,3646,0,0,0,0,2
,20131018,3646,3646,,,,3646,3646,0,0,0,0,2
,20131021,3646,3646,3575,3625,3575,3625,3600,-21,-46,4,14.4,2
,20131022,3625,3600,,,,3600,3600,0,0,0,0,2
,20131023,3600,3600,,,,3600,3600,0,0,0,0,2
,20131024,3600,3600,,,,3600,3600,0,0,0,0,2
,20131025,3600,3600,,,,3600,3600,0,0,0,0,2
,20131028,3600,3600,,,,3600,3600,0,0,0,0,2
,20131029,3600,3600,,,,3600,3600,0,0,0,0,2
,20131030,3600,3600,,,,3600,3600,0,0,0,0,2
,20131031,3600,3600,,,,3600,3600,0,0,0,0,2
,20131101,3600,3600,,,,3600,3600,0,0,0,0,2
,20131104,3600,3600,,,,3600,3600,0,0,0,0,2
,20131105,3600,3600,,,,3600,3600,0,0,0,0,2
,20131106,3600,3600,,,,3600,3600,0,0,0,0,2
,20131107,3600,3600,,,,3600,3600,0,0,0,0,2
,20131108,3600,3600,,,,3601,3601,1,1,0,0,2
,20131111,3601,3601,,,,3601,3601,0,0,0,0,2
,20131112,3601,3601,,,,3606,3606,5,5,0,0,2
,20131113,3606,3606,,,,3606,3606,0,0,0,0,2
,20131114,3606,3606,,,,3606,3606,0,0,0,0,2
,20131115,3606,3606,,,,3606,3606,0,0,0,0,2
,20131118,3606,3606,,,,3606,3606,0,0,0,0,2
,20131119,3606,3606,,,,3606,3606,0,0,0,0,2
,20131120,3606,3606,,,,3606,3606,0,0,0,0,2
,20131121,3606,3606,,,,3606,3606,0,0,0,0,2
,20131122,3606,3606,,,,3606,3606,0,0,0,0,2
,20131125,3606,3606,,,,3606,3606,0,0,0,0,2
,20131126,3606,3606,,,,3606,3606,0,0,0,0,2
,20131127,3606,3606,,,,3606,3606,0,0,0,0,2
,20131128,3606,3606,,,,3606,3606,0,0,0,0,2
,20131129,3606,3606,3760,3760,3630,3630,3690,24,84,8,29.52,2
,20131202,3630,3690,,,,3690,3690,0,0,0,0,2
,20131203,3690,3690,,,,3690,3690,0,0,0,0,2
,20131204,3690,3690,,,,3690,3690,0,0,0,0,2
,20131205,3690,3690,,,,3690,3690,0,0,0,0,2
,20131206,3690,3690,,,,3690,3690,0,0,0,0,2
,20131209,3690,3690,,,,3690,3690,0,0,0,0,2
,20131210,3690,3690,,,,3690,3690,0,0,0,0,2
,20131211,3690,3690,,,,3690,3690,0,0,0,0,2
,20131212,3690,3690,,,,3690,3690,0,0,0,0,2
,20131213,3690,3690,,,,3690,3690,0,0,0,0,2
,20131216,3690,3690,,,,3690,3690,0,0,0,0,2
,20131217,3690,3690,,,,3690,3690,0,0,0,0,2
,20131218,3690,3690,,,,3690,3690,0,0,0,0,2
,20131219,3690,3690,,,,3690,3690,0,0,0,0,2
,20131220,3690,3690,,,,3690,3690,0,0,0,0,2
,20131223,3690,3690,,,,3690,3690,0,0,0,0,2
,20131224,3690,3690,,,,3690,3690,0,0,0,0,2
,20131225,3690,3690,,,,3690,3690,0,0,0,0,2
,20131226,3690,3690,,,,3690,3690,0,0,0,0,2
,20131227,3690,3690,,,,3690,3690,0,0,0,0,2
,20131230,3690,3690,,,,3690,3690,0,0,0,0,2
,20131231,3690,3690,3690,3690,3690,3690,3690,0,0,2,7.38,0
wr1402,20130219,4350,4350,,,,4350,4350,0,0,0,0,0
,20130220,4350,4350,,,,4350,4350,0,0,0,0,0
,20130221,4350,4350,,,,4317,4317,-33,-33,0,0,0
,20130222,4317,4317,,,,4108,4108,-209,-209,0,0,0
,20130225,4108,4108,,,,4249,4249,141,141,0,0,0
,20130226,4249,4249,,,,4156,4156,-93,-93,0,0,0
,20130227,4156,4156,,,,4315,4315,159,159,0,0,0
,20130228,4315,4315,,,,4269,4269,-46,-46,0,0,0
,20130301,4269,4269,,,,4271,4271,2,2,0,0,0
,20130304,4271,4271,,,,4243,4243,-28,-28,0,0,0
,20130305,4243,4243,,,,4085,4085,-158,-158,0,0,0
,20130306,4085,4085,,,,4112,4112,27,27,0,0,0
,20130307,4112,4112,3750,3945,3750,3945,3856,-167,-256,6,23.14,0
,20130308,3945,3856,,,,3780,3780,-76,-76,0,0,0
,20130311,3780,3780,,,,3794,3794,14,14,0,0,0
,20130312,3794,3794,,,,3818,3818,24,24,0,0,0
,20130313,3818,3818,,,,3675,3675,-143,-143,0,0,0
,20130314,3675,3675,,,,3619,3619,-56,-56,0,0,0
,20130315,3619,3619,,,,3799,3799,180,180,0,0,0
,20130318,3799,3799,,,,3798,3798,-1,-1,0,0,0
,20130319,3798,3798,,,,3862,3862,64,64,0,0,0
,20130320,3862,3862,,,,3941,3941,79,79,0,0,0
,20130321,3941,3941,3865,4136,3744,3889,3937,-52,-4,1196,"4,708.98",8
,20130322,3889,3937,3866,3867,3866,3867,3866,-70,-71,4,15.47,4
,20130325,3867,3866,,,,3866,3866,0,0,0,0,4
,20130326,3866,3866,,,,3866,3866,0,0,0,0,4
,20130327,3866,3866,3862,3862,3862,3862,3862,-4,-4,2,7.72,2
,20130328,3862,3862,,,,3862,3862,0,0,0,0,2
,20130329,3862,3862,,,,3862,3862,0,0,0,0,2
,20130401,3862,3862,,,,3862,3862,0,0,0,0,2
,20130402,3862,3862,,,,3862,3862,0,0,0,0,2
,20130403,3862,3862,,,,3862,3862,0,0,0,0,2
,20130408,3862,3862,,,,3862,3862,0,0,0,0,2
,20130409,3862,3862,,,,3862,3862,0,0,0,0,2
,20130410,3862,3862,,,,3819,3819,-43,-43,0,0,2
,20130411,3819,3819,,,,3819,3819,0,0,0,0,2
,20130412,3819,3819,,,,3819,3819,0,0,0,0,2
,20130415,3819,3819,,,,3819,3819,0,0,0,0,2
,20130416,3819,3819,,,,3819,3819,0,0,0,0,2
,20130417,3819,3819,,,,3819,3819,0,0,0,0,2
,20130418,3819,3819,,,,3819,3819,0,0,0,0,2
,20130419,3819,3819,,,,3818,3818,-1,-1,0,0,2
,20130422,3818,3818,,,,3818,3818,0,0,0,0,2
,20130423,3818,3818,,,,3764,3764,-54,-54,0,0,2
,20130424,3764,3764,,,,3764,3764,0,0,0,0,2
,20130425,3764,3764,,,,3764,3764,0,0,0,0,2
,20130426,3764,3764,,,,3764,3764,0,0,0,0,2
,20130502,3764,3764,,,,3634,3634,-130,-130,0,0,2
,20130503,3634,3634,,,,3634,3634,0,0,0,0,2
,20130506,3634,3634,,,,3646,3646,12,12,0,0,2
,20130507,3646,3646,,,,3646,3646,0,0,0,0,2
,20130508,3646,3646,3811,3811,3582,3582,3696,-64,50,8,29.57,2
,20130509,3582,3696,,,,3696,3696,0,0,0,0,2
,20130510,3696,3696,,,,3696,3696,0,0,0,0,2
,20130513,3696,3696,,,,3696,3696,0,0,0,0,2
,20130514,3696,3696,,,,3696,3696,0,0,0,0,2
,20130515,3696,3696,3641,3641,3641,3641,3641,-55,-55,10,36.41,12
,20130516,3641,3641,,,,3641,3641,0,0,0,0,12
,20130517,3641,3641,3614,3651,3614,3651,3627,10,-14,16,58.04,28
,20130520,3651,3627,3644,3721,3644,3721,3658,94,31,26,95.12,50
,20130521,3721,3658,3666,3725,3666,3709,3697,51,39,10,36.98,54
,20130522,3709,3697,3714,3714,3713,3713,3713,16,16,4,14.85,56
,20130523,3713,3713,3747,3747,3680,3683,3727,-30,14,46,171.48,14
,20130524,3683,3727,3699,3708,3699,3708,3703,-19,-24,4,14.81,10
,20130527,3708,3703,3600,3689,3600,3612,3631,-91,-72,16,58.1,20
,20130528,3612,3631,,,,3631,3631,0,0,0,0,20
,20130529,3631,3631,,,,3631,3631,0,0,0,0,20
,20130530,3631,3631,,,,3620,3620,-11,-11,0,0,20
,20130531,3620,3620,3620,3620,3620,3620,3620,0,0,10,36.2,10
,20130603,3620,3620,,,,3620,3620,0,0,0,0,10
,20130604,3620,3620,,,,3620,3620,0,0,0,0,10
,20130605,3620,3620,,,,3620,3620,0,0,0,0,10
,20130606,3620,3620,,,,3588,3588,-32,-32,0,0,10
,20130607,3588,3588,,,,3588,3588,0,0,0,0,10
,20130613,3588,3588,,,,3588,3588,0,0,0,0,10
,20130614,3588,3588,,,,3588,3588,0,0,0,0,10
,20130617,3588,3588,,,,3588,3588,0,0,0,0,10
,20130618,3588,3588,,,,3588,3588,0,0,0,0,10
,20130619,3588,3588,3686,3686,3602,3629,3639,41,51,6,21.83,10
,20130620,3629,3639,3555,3555,3555,3555,3555,-84,-84,2,7.11,10
,20130621,3555,3555,,,,3564,3564,9,9,0,0,10
,20130624,3564,3564,3673,3673,3576,3576,3624,12,60,4,14.5,10
,20130625,3576,3624,3520,3618,3520,3618,3569,-6,-55,4,14.28,10
,20130626,3618,3569,3554,3554,3554,3554,3554,-15,-15,2,7.11,10
,20130627,3554,3554,3527,3527,3527,3527,3527,-27,-27,2,7.05,10
,20130628,3527,3527,3606,3606,3599,3599,3602,72,75,4,14.41,8
,20130701,3599,3602,,,,3589,3589,-13,-13,0,0,8
,20130702,3589,3589,,,,3589,3589,0,0,0,0,8
,20130703,3589,3589,,,,3603,3603,14,14,0,0,8
,20130704,3603,3603,,,,3614,3614,11,11,0,0,8
,20130705,3614,3614,3627,3674,3627,3674,3642,60,28,6,21.86,8
,20130708,3674,3642,,,,3642,3642,0,0,0,0,8
,20130709,3642,3642,,,,3642,3642,0,0,0,0,8
,20130710,3642,3642,3642,3642,3642,3642,3642,0,0,2,7.28,6
,20130711,3642,3642,3699,3699,3650,3650,3671,8,29,6,22.03,4
,20130712,3650,3671,,,,3671,3671,0,0,0,0,4
,20130715,3671,3671,,,,3671,3671,0,0,0,0,4
,20130716,3671,3671,,,,3671,3671,0,0,0,0,4
,20130717,3671,3671,,,,3671,3671,0,0,0,0,4
,20130718,3671,3671,,,,3671,3671,0,0,0,0,4
,20130719,3671,3671,,,,3671,3671,0,0,0,0,4
,20130722,3671,3671,,,,3671,3671,0,0,0,0,4
,20130723,3671,3671,,,,3671,3671,0,0,0,0,4
,20130724,3671,3671,,,,3671,3671,0,0,0,0,4
,20130725,3671,3671,,,,3671,3671,0,0,0,0,4
,20130726,3671,3671,,,,3671,3671,0,0,0,0,4
,20130729,3671,3671,,,,3671,3671,0,0,0,0,4
,20130730,3671,3671,,,,3671,3671,0,0,0,0,4
,20130731,3671,3671,,,,3671,3671,0,0,0,0,4
,20130801,3671,3671,,,,3671,3671,0,0,0,0,4
,20130802,3671,3671,,,,3671,3671,0,0,0,0,4
,20130805,3671,3671,,,,3681,3681,10,10,0,0,4
,20130806,3681,3681,,,,3681,3681,0,0,0,0,4
,20130807,3681,3681,,,,3681,3681,0,0,0,0,4
,20130808,3681,3681,,,,3681,3681,0,0,0,0,4
,20130809,3681,3681,,,,3681,3681,0,0,0,0,4
,20130812,3681,3681,3829,3829,3791,3791,3810,110,129,8,30.48,4
,20130813,3791,3810,3850,3850,3850,3850,3850,40,40,2,7.7,2
,20130814,3850,3850,,,,3850,3850,0,0,0,0,2
,20130815,3850,3850,,,,3850,3850,0,0,0,0,2
,20130816,3850,3850,,,,3850,3850,0,0,0,0,2
,20130819,3850,3850,,,,3890,3890,40,40,0,0,2
,20130820,3890,3890,,,,3845,3845,-45,-45,0,0,2
,20130821,3845,3845,,,,3947,3947,102,102,0,0,2
,20130822,3947,3947,,,,3818,3818,-129,-129,0,0,2
,20130823,3818,3818,,,,3818,3818,0,0,0,0,2
,20130826,3818,3818,,,,3818,3818,0,0,0,0,2
,20130827,3818,3818,,,,3818,3818,0,0,0,0,2
,20130828,3818,3818,,,,3818,3818,0,0,0,0,2
,20130829,3818,3818,,,,3797,3797,-21,-21,0,0,2
,20130830,3797,3797,,,,3797,3797,0,0,0,0,2
,20130902,3797,3797,,,,3797,3797,0,0,0,0,2
,20130903,3797,3797,,,,3797,3797,0,0,0,0,2
,20130904,3797,3797,,,,3797,3797,0,0,0,0,2
,20130905,3797,3797,3691,3691,3691,3691,3691,-106,-106,2,7.38,4
,20130906,3691,3691,,,,3691,3691,0,0,0,0,4
,20130909,3691,3691,,,,3715,3715,24,24,0,0,4
,20130910,3715,3715,,,,3715,3715,0,0,0,0,4
,20130911,3715,3715,,,,3715,3715,0,0,0,0,4
,20130912,3715,3715,,,,3693,3693,-22,-22,0,0,4
,20130913,3693,3693,,,,3693,3693,0,0,0,0,4
,20130916,3693,3693,,,,3693,3693,0,0,0,0,4
,20130917,3693,3693,,,,3693,3693,0,0,0,0,4
,20130918,3693,3693,,,,3693,3693,0,0,0,0,4
,20130923,3693,3693,,,,3693,3693,0,0,0,0,4
,20130924,3693,3693,,,,3693,3693,0,0,0,0,4
,20130925,3693,3693,,,,3693,3693,0,0,0,0,4
,20130926,3693,3693,,,,3693,3693,0,0,0,0,4
,20130927,3693,3693,,,,3693,3693,0,0,0,0,4
,20130930,3693,3693,,,,3693,3693,0,0,0,0,4
,20131008,3693,3693,3646,3646,3646,3646,3646,-47,-47,2,7.29,2
,20131009,3646,3646,,,,3646,3646,0,0,0,0,2
,20131010,3646,3646,,,,3646,3646,0,0,0,0,2
,20131011,3646,3646,,,,3646,3646,0,0,0,0,2
,20131014,3646,3646,,,,3687,3687,41,41,0,0,2
,20131015,3687,3687,,,,3687,3687,0,0,0,0,2
,20131016,3687,3687,,,,3687,3687,0,0,0,0,2
,20131017,3687,3687,,,,3687,3687,0,0,0,0,2
,20131018,3687,3687,,,,3687,3687,0,0,0,0,2
,20131021,3687,3687,,,,3687,3687,0,0,0,0,2
,20131022,3687,3687,,,,3687,3687,0,0,0,0,2
,20131023,3687,3687,,,,3687,3687,0,0,0,0,2
,20131024,3687,3687,,,,3687,3687,0,0,0,0,2
,20131025,3687,3687,,,,3684,3684,-3,-3,0,0,2
,20131028,3684,3684,,,,3660,3660,-24,-24,0,0,2
,20131029,3660,3660,,,,3660,3660,0,0,0,0,2
,20131030,3660,3660,,,,3660,3660,0,0,0,0,2
,20131031,3660,3660,,,,3660,3660,0,0,0,0,2
,20131101,3660,3660,,,,3660,3660,0,0,0,0,2
,20131104,3660,3660,,,,3660,3660,0,0,0,0,2
,20131105,3660,3660,,,,3660,3660,0,0,0,0,2
,20131106,3660,3660,,,,3660,3660,0,0,0,0,2
,20131107,3660,3660,,,,3660,3660,0,0,0,0,2
,20131108,3660,3660,,,,3660,3660,0,0,0,0,2
,20131111,3660,3660,,,,3660,3660,0,0,0,0,2
,20131112,3660,3660,,,,3660,3660,0,0,0,0,2
,20131113,3660,3660,,,,3660,3660,0,0,0,0,2
,20131114,3660,3660,,,,3660,3660,0,0,0,0,2
,20131115,3660,3660,,,,3660,3660,0,0,0,0,2
,20131118,3660,3660,,,,3660,3660,0,0,0,0,2
,20131119,3660,3660,,,,3660,3660,0,0,0,0,2
,20131120,3660,3660,,,,3660,3660,0,0,0,0,2
,20131121,3660,3660,3724,3724,3718,3718,3721,58,61,4,14.88,6
,20131122,3718,3721,3539,3675,3539,3648,3610,-73,-111,8,28.88,0
,20131125,3648,3610,,,,3610,3610,0,0,0,0,0
,20131126,3610,3610,,,,3610,3610,0,0,0,0,0
,20131127,3610,3610,,,,3610,3610,0,0,0,0,0
,20131128,3610,3610,,,,3610,3610,0,0,0,0,0
,20131129,3610,3610,,,,3625,3625,15,15,0,0,0
,20131202,3625,3625,,,,3625,3625,0,0,0,0,0
,20131203,3625,3625,,,,3625,3625,0,0,0,0,0
,20131204,3625,3625,,,,3646,3646,21,21,0,0,0
,20131205,3646,3646,,,,3646,3646,0,0,0,0,0
,20131206,3646,3646,,,,3646,3646,0,0,0,0,0
,20131209,3646,3646,,,,3646,3646,0,0,0,0,0
,20131210,3646,3646,,,,3646,3646,0,0,0,0,0
,20131211,3646,3646,,,,3646,3646,0,0,0,0,0
,20131212,3646,3646,,,,3646,3646,0,0,0,0,0
,20131213,3646,3646,,,,3646,3646,0,0,0,0,0
,20131216,3646,3646,,,,3646,3646,0,0,0,0,0
,20131217,3646,3646,,,,3646,3646,0,0,0,0,0
,20131218,3646,3646,,,,3646,3646,0,0,0,0,0
,20131219,3646,3646,,,,3646,3646,0,0,0,0,0
,20131220,3646,3646,,,,3646,3646,0,0,0,0,0
,20131223,3646,3646,,,,3646,3646,0,0,0,0,0
,20131224,3646,3646,,,,3646,3646,0,0,0,0,0
,20131225,3646,3646,,,,3646,3646,0,0,0,0,0
,20131226,3646,3646,,,,3646,3646,0,0,0,0,0
,20131227,3646,3646,,,,3646,3646,0,0,0,0,0
,20131230,3646,3646,,,,3646,3646,0,0,0,0,0
,20131231,3646,3646,,,,3646,3646,0,0,0,0,0
wr1403,20130318,3799,3799,,,,3819,3819,20,20,0,0,0
,20130319,3819,3819,,,,3883,3883,64,64,0,0,0
,20130320,3883,3883,,,,3963,3963,80,80,0,0,0
,20130321,3963,3963,,,,3963,3963,0,0,0,0,0
,20130322,3963,3963,,,,3963,3963,0,0,0,0,0
,20130325,3963,3963,,,,3963,3963,0,0,0,0,0
,20130326,3963,3963,,,,3963,3963,0,0,0,0,0
,20130327,3963,3963,,,,3963,3963,0,0,0,0,0
,20130328,3963,3963,,,,3955,3955,-8,-8,0,0,0
,20130329,3955,3955,,,,3935,3935,-20,-20,0,0,0
,20130401,3935,3935,,,,3870,3870,-65,-65,0,0,0
,20130402,3870,3870,,,,3870,3870,0,0,0,0,0
,20130403,3870,3870,,,,3870,3870,0,0,0,0,0
,20130408,3870,3870,,,,3870,3870,0,0,0,0,0
,20130409,3870,3870,,,,3870,3870,0,0,0,0,0
,20130410,3870,3870,,,,3870,3870,0,0,0,0,0
,20130411,3870,3870,,,,3870,3870,0,0,0,0,0
,20130412,3870,3870,,,,3870,3870,0,0,0,0,0
,20130415,3870,3870,,,,3870,3870,0,0,0,0,0
,20130416,3870,3870,,,,3870,3870,0,0,0,0,0
,20130417,3870,3870,,,,3870,3870,0,0,0,0,0
,20130418,3870,3870,,,,3868,3868,-2,-2,0,0,0
,20130419,3868,3868,,,,3866,3866,-2,-2,0,0,0
,20130422,3866,3866,,,,3836,3836,-30,-30,0,0,0
,20130423,3836,3836,,,,3780,3780,-56,-56,0,0,0
,20130424,3780,3780,,,,3780,3780,0,0,0,0,0
,20130425,3780,3780,,,,3780,3780,0,0,0,0,0
,20130426,3780,3780,3617,3686,3617,3676,3663,-104,-117,84,307.74,80
,20130502,3676,3663,3693,3693,3693,3693,3693,30,30,80,295.44,0
,20130503,3693,3693,,,,3693,3693,0,0,0,0,0
,20130506,3693,3693,,,,3746,3746,53,53,0,0,0
,20130507,3746,3746,,,,3746,3746,0,0,0,0,0
,20130508,3746,3746,3828,3828,3647,3715,3726,-31,-20,20,74.52,12
,20130509,3715,3726,3653,3690,3653,3690,3671,-36,-55,4,14.69,12
,20130510,3690,3671,3611,3717,3611,3717,3682,46,11,12,44.19,12
,20130513,3717,3682,,,,3695,3695,13,13,0,0,12
,20130514,3695,3695,3690,3690,3690,3690,3690,-5,-5,2,7.38,10
,20130515,3690,3690,,,,3690,3690,0,0,0,0,10
,20130516,3690,3690,,,,3690,3690,0,0,0,0,10
,20130517,3690,3690,,,,3690,3690,0,0,0,0,10
,20130520,3690,3690,,,,3690,3690,0,0,0,0,10
,20130521,3690,3690,,,,3690,3690,0,0,0,0,10
,20130522,3690,3690,3884,3884,3700,3763,3782,73,92,6,22.69,10
,20130523,3763,3782,3684,3714,3680,3706,3703,-76,-79,26,96.28,30
,20130524,3706,3703,3644,3679,3644,3679,3674,-24,-29,14,51.44,40
,20130527,3679,3674,3669,3669,3607,3665,3631,-9,-43,66,239.7,10
,20130528,3665,3631,,,,3631,3631,0,0,0,0,10
,20130529,3631,3631,,,,3631,3631,0,0,0,0,10
,20130530,3631,3631,,,,3631,3631,0,0,0,0,10
,20130531,3631,3631,3534,3607,3534,3590,3565,-41,-66,10,35.66,10
,20130603,3590,3565,,,,3626,3626,61,61,0,0,10
,20130604,3626,3626,,,,3626,3626,0,0,0,0,10
,20130605,3626,3626,,,,3629,3629,3,3,0,0,10
,20130606,3629,3629,3616,3616,3616,3616,3616,-13,-13,2,7.23,10
,20130607,3616,3616,3533,3533,3533,3533,3533,-83,-83,2,7.07,8
,20130613,3533,3533,3535,3589,3534,3589,3546,56,13,44,156.05,8
,20130614,3589,3546,,,,3546,3546,0,0,0,0,8
,20130617,3546,3546,3588,3588,3588,3588,3588,42,42,2,7.18,6
,20130618,3588,3588,,,,3588,3588,0,0,0,0,6
,20130619,3588,3588,,,,3603,3603,15,15,0,0,6
,20130620,3603,3603,,,,3603,3603,0,0,0,0,6
,20130621,3603,3603,,,,3606,3606,3,3,0,0,6
,20130624,3606,3606,,,,3606,3606,0,0,0,0,6
,20130625,3606,3606,,,,3606,3606,0,0,0,0,6
,20130626,3606,3606,,,,3606,3606,0,0,0,0,6
,20130627,3606,3606,,,,3606,3606,0,0,0,0,6
,20130628,3606,3606,,,,3606,3606,0,0,0,0,6
,20130701,3606,3606,,,,3606,3606,0,0,0,0,6
,20130702,3606,3606,,,,3606,3606,0,0,0,0,6
,20130703,3606,3606,,,,3609,3609,3,3,0,0,6
,20130704,3609,3609,,,,3619,3619,10,10,0,0,6
,20130705,3619,3619,,,,3636,3636,17,17,0,0,6
,20130708,3636,3636,,,,3636,3636,0,0,0,0,6
,20130709,3636,3636,,,,3636,3636,0,0,0,0,6
,20130710,3636,3636,,,,3639,3639,3,3,0,0,6
,20130711,3639,3639,,,,3666,3666,27,27,0,0,6
,20130712,3666,3666,,,,3666,3666,0,0,0,0,6
,20130715,3666,3666,3700,3700,3700,3700,3700,34,34,2,7.4,4
,20130716,3700,3700,,,,3700,3700,0,0,0,0,4
,20130717,3700,3700,,,,3700,3700,0,0,0,0,4
,20130718,3700,3700,,,,3700,3700,0,0,0,0,4
,20130719,3700,3700,,,,3700,3700,0,0,0,0,4
,20130722,3700,3700,,,,3700,3700,0,0,0,0,4
,20130723,3700,3700,,,,3700,3700,0,0,0,0,4
,20130724,3700,3700,,,,3700,3700,0,0,0,0,4
,20130725,3700,3700,,,,3700,3700,0,0,0,0,4
,20130726,3700,3700,,,,3700,3700,0,0,0,0,4
,20130729,3700,3700,,,,3700,3700,0,0,0,0,4
,20130730,3700,3700,,,,3700,3700,0,0,0,0,4
,20130731,3700,3700,,,,3700,3700,0,0,0,0,4
,20130801,3700,3700,,,,3700,3700,0,0,0,0,4
,20130802,3700,3700,,,,3700,3700,0,0,0,0,4
,20130805,3700,3700,,,,3700,3700,0,0,0,0,4
,20130806,3700,3700,,,,3700,3700,0,0,0,0,4
,20130807,3700,3700,,,,3701,3701,1,1,0,0,4
,20130808,3701,3701,,,,3701,3701,0,0,0,0,4
,20130809,3701,3701,,,,3701,3701,0,0,0,0,4
,20130812,3701,3701,,,,3759,3759,58,58,0,0,4
,20130813,3759,3759,,,,3793,3793,34,34,0,0,4
,20130814,3793,3793,,,,3793,3793,0,0,0,0,4
,20130815,3793,3793,,,,3793,3793,0,0,0,0,4
,20130816,3793,3793,,,,3793,3793,0,0,0,0,4
,20130819,3793,3793,3850,3860,3763,3860,3824,67,31,6,22.95,4
,20130820,3860,3824,3759,3759,3759,3759,3759,-65,-65,2,7.52,2
,20130821,3759,3759,,,,3759,3759,0,0,0,0,2
,20130822,3759,3759,,,,3759,3759,0,0,0,0,2
,20130823,3759,3759,,,,3799,3799,40,40,0,0,2
,20130826,3799,3799,,,,3799,3799,0,0,0,0,2
,20130827,3799,3799,,,,3799,3799,0,0,0,0,2
,20130828,3799,3799,,,,3799,3799,0,0,0,0,2
,20130829,3799,3799,,,,3799,3799,0,0,0,0,2
,20130830,3799,3799,,,,3799,3799,0,0,0,0,2
,20130902,3799,3799,,,,3799,3799,0,0,0,0,2
,20130903,3799,3799,,,,3799,3799,0,0,0,0,2
,20130904,3799,3799,,,,3799,3799,0,0,0,0,2
,20130905,3799,3799,,,,3799,3799,0,0,0,0,2
,20130906,3799,3799,,,,3772,3772,-27,-27,0,0,2
,20130909,3772,3772,,,,3772,3772,0,0,0,0,2
,20130910,3772,3772,,,,3772,3772,0,0,0,0,2
,20130911,3772,3772,,,,3772,3772,0,0,0,0,2
,20130912,3772,3772,,,,3772,3772,0,0,0,0,2
,20130913,3772,3772,,,,3772,3772,0,0,0,0,2
,20130916,3772,3772,,,,3772,3772,0,0,0,0,2
,20130917,3772,3772,,,,3772,3772,0,0,0,0,2
,20130918,3772,3772,,,,3772,3772,0,0,0,0,2
,20130923,3772,3772,,,,3772,3772,0,0,0,0,2
,20130924,3772,3772,,,,3772,3772,0,0,0,0,2
,20130925,3772,3772,,,,3772,3772,0,0,0,0,2
,20130926,3772,3772,,,,3772,3772,0,0,0,0,2
,20130927,3772,3772,,,,3772,3772,0,0,0,0,2
,20130930,3772,3772,,,,3772,3772,0,0,0,0,2
,20131008,3772,3772,,,,3772,3772,0,0,0,0,2
,20131009,3772,3772,,,,3725,3725,-47,-47,0,0,2
,20131010,3725,3725,,,,3725,3725,0,0,0,0,2
,20131011,3725,3725,,,,3725,3725,0,0,0,0,2
,20131014,3725,3725,,,,3725,3725,0,0,0,0,2
,20131015,3725,3725,,,,3725,3725,0,0,0,0,2
,20131016,3725,3725,,,,3725,3725,0,0,0,0,2
,20131017,3725,3725,,,,3725,3725,0,0,0,0,2
,20131018,3725,3725,,,,3725,3725,0,0,0,0,2
,20131021,3725,3725,,,,3678,3678,-47,-47,0,0,2
,20131022,3678,3678,,,,3678,3678,0,0,0,0,2
,20131023,3678,3678,,,,3678,3678,0,0,0,0,2
,20131024,3678,3678,,,,3678,3678,0,0,0,0,2
,20131025,3678,3678,,,,3678,3678,0,0,0,0,2
,20131028,3678,3678,,,,3678,3678,0,0,0,0,2
,20131029,3678,3678,,,,3678,3678,0,0,0,0,2
,20131030,3678,3678,,,,3678,3678,0,0,0,0,2
,20131031,3678,3678,,,,3678,3678,0,0,0,0,2
,20131101,3678,3678,,,,3678,3678,0,0,0,0,2
,20131104,3678,3678,,,,3678,3678,0,0,0,0,2
,20131105,3678,3678,,,,3678,3678,0,0,0,0,2
,20131106,3678,3678,,,,3678,3678,0,0,0,0,2
,20131107,3678,3678,,,,3678,3678,0,0,0,0,2
,20131108,3678,3678,,,,3678,3678,0,0,0,0,2
,20131111,3678,3678,,,,3678,3678,0,0,0,0,2
,20131112,3678,3678,,,,3678,3678,0,0,0,0,2
,20131113,3678,3678,,,,3678,3678,0,0,0,0,2
,20131114,3678,3678,,,,3678,3678,0,0,0,0,2
,20131115,3678,3678,,,,3678,3678,0,0,0,0,2
,20131118,3678,3678,,,,3678,3678,0,0,0,0,2
,20131119,3678,3678,,,,3678,3678,0,0,0,0,2
,20131120,3678,3678,,,,3678,3678,0,0,0,0,2
,20131121,3678,3678,,,,3678,3678,0,0,0,0,2
,20131122,3678,3678,,,,3678,3678,0,0,0,0,2
,20131125,3678,3678,,,,3678,3678,0,0,0,0,2
,20131126,3678,3678,,,,3678,3678,0,0,0,0,2
,20131127,3678,3678,,,,3678,3678,0,0,0,0,2
,20131128,3678,3678,,,,3678,3678,0,0,0,0,2
,20131129,3678,3678,3789,3789,3650,3700,3717,22,39,64,237.94,2
,20131202,3700,3717,,,,3717,3717,0,0,0,0,2
,20131203,3717,3717,,,,3717,3717,0,0,0,0,2
,20131204,3717,3717,,,,3717,3717,0,0,0,0,2
,20131205,3717,3717,,,,3717,3717,0,0,0,0,2
,20131206,3717,3717,,,,3717,3717,0,0,0,0,2
,20131209,3717,3717,,,,3717,3717,0,0,0,0,2
,20131210,3717,3717,,,,3717,3717,0,0,0,0,2
,20131211,3717,3717,,,,3717,3717,0,0,0,0,2
,20131212,3717,3717,,,,3717,3717,0,0,0,0,2
,20131213,3717,3717,,,,3717,3717,0,0,0,0,2
,20131216,3717,3717,,,,3717,3717,0,0,0,0,2
,20131217,3717,3717,,,,3717,3717,0,0,0,0,2
,20131218,3717,3717,,,,3717,3717,0,0,0,0,2
,20131219,3717,3717,,,,3717,3717,0,0,0,0,2
,20131220,3717,3717,,,,3717,3717,0,0,0,0,2
,20131223,3717,3717,,,,3717,3717,0,0,0,0,2
,20131224,3717,3717,,,,3717,3717,0,0,0,0,2
,20131225,3717,3717,,,,3717,3717,0,0,0,0,2
,20131226,3717,3717,,,,3717,3717,0,0,0,0,2
,20131227,3717,3717,,,,3717,3717,0,0,0,0,2
,20131230,3717,3717,,,,3717,3717,0,0,0,0,2
,20131231,3717,3717,,,,3717,3717,0,0,0,0,2
wr1404,20130416,3870,3870,3700,3750,3700,3750,3725,-120,-145,4,14.9,0
,20130417,3750,3725,,,,3725,3725,0,0,0,0,0
,20130418,3725,3725,,,,3704,3704,-21,-21,0,0,0
,20130419,3704,3704,,,,3727,3727,23,23,0,0,0
,20130422,3727,3727,,,,3727,3727,0,0,0,0,0
,20130423,3727,3727,,,,3675,3675,-52,-52,0,0,0
,20130424,3675,3675,,,,3633,3633,-42,-42,0,0,0
,20130425,3633,3633,,,,3629,3629,-4,-4,0,0,0
,20130426,3629,3629,,,,3517,3517,-112,-112,0,0,0
,20130502,3517,3517,,,,3545,3545,28,28,0,0,0
,20130503,3545,3545,,,,3564,3564,19,19,0,0,0
,20130506,3564,3564,,,,3615,3615,51,51,0,0,0
,20130507,3615,3615,,,,3401,3401,-214,-214,0,0,0
,20130508,3401,3401,,,,3605,3605,204,204,0,0,0
,20130509,3605,3605,,,,3622,3622,17,17,0,0,0
,20130510,3622,3622,,,,3628,3628,6,6,0,0,0
,20130513,3628,3628,,,,3646,3646,18,18,0,0,0
,20130514,3646,3646,,,,3646,3646,0,0,0,0,0
,20130515,3646,3646,,,,3591,3591,-55,-55,0,0,0
,20130516,3591,3591,,,,3502,3502,-89,-89,0,0,0
,20130517,3502,3502,,,,3488,3488,-14,-14,0,0,0
,20130520,3488,3488,,,,3518,3518,30,30,0,0,0
,20130521,3518,3518,,,,3556,3556,38,38,0,0,0
,20130522,3556,3556,,,,3640,3640,84,84,0,0,0
,20130523,3640,3640,,,,3564,3564,-76,-76,0,0,0
,20130524,3564,3564,,,,3609,3609,45,45,0,0,0
,20130527,3609,3609,,,,3609,3609,0,0,0,0,0
,20130528,3609,3609,,,,3609,3609,0,0,0,0,0
,20130529,3609,3609,,,,3606,3606,-3,-3,0,0,0
,20130530,3606,3606,,,,3483,3483,-123,-123,0,0,0
,20130531,3483,3483,,,,3420,3420,-63,-63,0,0,0
,20130603,3420,3420,,,,3433,3433,13,13,0,0,0
,20130604,3433,3433,,,,3531,3531,98,98,0,0,0
,20130605,3531,3531,,,,3553,3553,22,22,0,0,0
,20130606,3553,3553,,,,3553,3553,0,0,0,0,0
,20130607,3553,3553,,,,3471,3471,-82,-82,0,0,0
,20130613,3471,3471,,,,3471,3471,0,0,0,0,0
,20130614,3471,3471,,,,3450,3450,-21,-21,0,0,0
,20130617,3450,3450,,,,3530,3530,80,80,0,0,0
,20130618,3530,3530,,,,3559,3559,29,29,0,0,0
,20130619,3559,3559,,,,3589,3589,30,30,0,0,0
,20130620,3589,3589,,,,3589,3589,0,0,0,0,0
,20130621,3589,3589,,,,3611,3611,22,22,0,0,0
,20130624,3611,3611,,,,3611,3611,0,0,0,0,0
,20130625,3611,3611,,,,3611,3611,0,0,0,0,0
,20130626,3611,3611,,,,3611,3611,0,0,0,0,0
,20130627,3611,3611,,,,3611,3611,0,0,0,0,0
,20130628,3611,3611,,,,3611,3611,0,0,0,0,0
,20130701,3611,3611,,,,3611,3611,0,0,0,0,0
,20130702,3611,3611,,,,3650,3650,39,39,0,0,0
,20130703,3650,3650,,,,3650,3650,0,0,0,0,0
,20130704,3650,3650,,,,3650,3650,0,0,0,0,0
,20130705,3650,3650,,,,3650,3650,0,0,0,0,0
,20130708,3650,3650,,,,3650,3650,0,0,0,0,0
,20130709,3650,3650,,,,3650,3650,0,0,0,0,0
,20130710,3650,3650,,,,3650,3650,0,0,0,0,0
,20130711,3650,3650,,,,3650,3650,0,0,0,0,0
,20130712,3650,3650,,,,3650,3650,0,0,0,0,0
,20130715,3650,3650,,,,3656,3656,6,6,0,0,0
,20130716,3656,3656,,,,3666,3666,10,10,0,0,0
,20130717,3666,3666,,,,3678,3678,12,12,0,0,0
,20130718,3678,3678,,,,3678,3678,0,0,0,0,0
,20130719,3678,3678,,,,3685,3685,7,7,0,0,0
,20130722,3685,3685,,,,3685,3685,0,0,0,0,0
,20130723,3685,3685,,,,3685,3685,0,0,0,0,0
,20130724,3685,3685,,,,3685,3685,0,0,0,0,0
,20130725,3685,3685,,,,3685,3685,0,0,0,0,0
,20130726,3685,3685,,,,3685,3685,0,0,0,0,0
,20130729,3685,3685,,,,3685,3685,0,0,0,0,0
,20130730,3685,3685,,,,3685,3685,0,0,0,0,0
,20130731,3685,3685,,,,3685,3685,0,0,0,0,0
,20130801,3685,3685,,,,3685,3685,0,0,0,0,0
,20130802,3685,3685,,,,3685,3685,0,0,0,0,0
,20130805,3685,3685,,,,3685,3685,0,0,0,0,0
,20130806,3685,3685,,,,3685,3685,0,0,0,0,0
,20130807,3685,3685,3703,3705,3703,3705,3704,20,19,4,14.82,4
,20130808,3705,3704,,,,3736,3736,32,32,0,0,4
,20130809,3736,3736,3740,3740,3740,3740,3740,4,4,2,7.48,4
,20130812,3740,3740,3833,3833,3798,3798,3814,58,74,8,30.51,8
,20130813,3798,3814,3848,3884,3848,3884,3866,70,52,4,15.46,8
,20130814,3884,3866,3870,3889,3867,3867,3875,1,9,6,23.25,8
,20130815,3867,3875,,,,3875,3875,0,0,0,0,8
,20130816,3875,3875,3879,3879,3854,3868,3869,-7,-6,8,30.96,4
,20130819,3868,3869,,,,3869,3869,0,0,0,0,4
,20130820,3869,3869,,,,3869,3869,0,0,0,0,4
,20130821,3869,3869,3821,3821,3815,3815,3818,-54,-51,4,15.27,0
,20130822,3815,3818,,,,3818,3818,0,0,0,0,0
,20130823,3818,3818,,,,3818,3818,0,0,0,0,0
,20130826,3818,3818,3889,3889,3885,3885,3887,67,69,6,23.33,6
,20130827,3885,3887,,,,3887,3887,0,0,0,0,6
,20130828,3887,3887,,,,3870,3870,-17,-17,0,0,6
,20130829,3870,3870,,,,3850,3850,-20,-20,0,0,6
,20130830,3850,3850,3832,3832,3829,3829,3831,-21,-19,16,61.3,22
,20130902,3829,3831,3854,3854,3789,3806,3826,-25,-5,124,474.44,12
,20130903,3806,3826,3827,3827,3827,3827,3827,1,1,10,38.27,2
,20130904,3827,3827,,,,3827,3827,0,0,0,0,2
,20130905,3827,3827,,,,3827,3827,0,0,0,0,2
,20130906,3827,3827,,,,3800,3800,-27,-27,0,0,2
,20130909,3800,3800,,,,3800,3800,0,0,0,0,2
,20130910,3800,3800,,,,3800,3800,0,0,0,0,2
,20130911,3800,3800,,,,3800,3800,0,0,0,0,2
,20130912,3800,3800,,,,3800,3800,0,0,0,0,2
,20130913,3800,3800,,,,3739,3739,-61,-61,0,0,2
,20130916,3739,3739,3743,3743,3743,3743,3743,4,4,2,7.49,2
,20130917,3743,3743,,,,3743,3743,0,0,0,0,2
,20130918,3743,3743,,,,3743,3743,0,0,0,0,2
,20130923,3743,3743,,,,3743,3743,0,0,0,0,2
,20130924,3743,3743,,,,3743,3743,0,0,0,0,2
,20130925,3743,3743,,,,3743,3743,0,0,0,0,2
,20130926,3743,3743,,,,3743,3743,0,0,0,0,2
,20130927,3743,3743,,,,3743,3743,0,0,0,0,2
,20130930,3743,3743,,,,3743,3743,0,0,0,0,2
,20131008,3743,3743,,,,3743,3743,0,0,0,0,2
,20131009,3743,3743,,,,3743,3743,0,0,0,0,2
,20131010,3743,3743,,,,3737,3737,-6,-6,0,0,2
,20131011,3737,3737,,,,3737,3737,0,0,0,0,2
,20131014,3737,3737,,,,3737,3737,0,0,0,0,2
,20131015,3737,3737,3658,3711,3658,3711,3687,-26,-50,18,66.37,2
,20131016,3711,3687,,,,3687,3687,0,0,0,0,2
,20131017,3687,3687,3700,3700,3700,3700,3700,13,13,2,7.4,2
,20131018,3700,3700,3609,3609,3609,3609,3609,-91,-91,2,7.22,2
,20131021,3609,3609,,,,3563,3563,-46,-46,0,0,2
,20131022,3563,3563,,,,3563,3563,0,0,0,0,2
,20131023,3563,3563,,,,3563,3563,0,0,0,0,2
,20131024,3563,3563,,,,3563,3563,0,0,0,0,2
,20131025,3563,3563,,,,3570,3570,7,7,0,0,2
,20131028,3570,3570,3491,3491,3491,3491,3491,-79,-79,2,6.98,2
,20131029,3491,3491,,,,3491,3491,0,0,0,0,2
,20131030,3491,3491,,,,3491,3491,0,0,0,0,2
,20131031,3491,3491,,,,3491,3491,0,0,0,0,2
,20131101,3491,3491,,,,3491,3491,0,0,0,0,2
,20131104,3491,3491,,,,3491,3491,0,0,0,0,2
,20131105,3491,3491,,,,3491,3491,0,0,0,0,2
,20131106,3491,3491,,,,3491,3491,0,0,0,0,2
,20131107,3491,3491,,,,3517,3517,26,26,0,0,2
,20131108,3517,3517,,,,3517,3517,0,0,0,0,2
,20131111,3517,3517,,,,3616,3616,99,99,0,0,2
,20131112,3616,3616,,,,3629,3629,13,13,0,0,2
,20131113,3629,3629,,,,3629,3629,0,0,0,0,2
,20131114,3629,3629,,,,3629,3629,0,0,0,0,2
,20131115,3629,3629,,,,3605,3605,-24,-24,0,0,2
,20131118,3605,3605,,,,3605,3605,0,0,0,0,2
,20131119,3605,3605,,,,3605,3605,0,0,0,0,2
,20131120,3605,3605,,,,3605,3605,0,0,0,0,2
,20131121,3605,3605,,,,3605,3605,0,0,0,0,2
,20131122,3605,3605,,,,3497,3497,-108,-108,0,0,2
,20131125,3497,3497,,,,3497,3497,0,0,0,0,2
,20131126,3497,3497,,,,3497,3497,0,0,0,0,2
,20131127,3497,3497,,,,3497,3497,0,0,0,0,2
,20131128,3497,3497,,,,3497,3497,0,0,0,0,2
,20131129,3497,3497,,,,3534,3534,37,37,0,0,2
,20131202,3534,3534,,,,3534,3534,0,0,0,0,2
,20131203,3534,3534,,,,3534,3534,0,0,0,0,2
,20131204,3534,3534,,,,3534,3534,0,0,0,0,2
,20131205,3534,3534,,,,3534,3534,0,0,0,0,2
,20131206,3534,3534,,,,3534,3534,0,0,0,0,2
,20131209,3534,3534,,,,3534,3534,0,0,0,0,2
,20131210,3534,3534,,,,3534,3534,0,0,0,0,2
,20131211,3534,3534,,,,3534,3534,0,0,0,0,2
,20131212,3534,3534,,,,3534,3534,0,0,0,0,2
,20131213,3534,3534,,,,3534,3534,0,0,0,0,2
,20131216,3534,3534,,,,3534,3534,0,0,0,0,2
,20131217,3534,3534,,,,3534,3534,0,0,0,0,2
,20131218,3534,3534,,,,3534,3534,0,0,0,0,2
,20131219,3534,3534,,,,3534,3534,0,0,0,0,2
,20131220,3534,3534,,,,3534,3534,0,0,0,0,2
,20131223,3534,3534,,,,3535,3535,1,1,0,0,2
,20131224,3535,3535,,,,3535,3535,0,0,0,0,2
,20131225,3535,3535,,,,3535,3535,0,0,0,0,2
,20131226,3535,3535,,,,3535,3535,0,0,0,0,2
,20131227,3535,3535,,,,3535,3535,0,0,0,0,2
,20131230,3535,3535,,,,3535,3535,0,0,0,0,2
,20131231,3535,3535,3460,3595,3460,3595,3532,60,-3,10,35.32,2
wr1405,20130516,3591,3591,,,,3591,3591,0,0,0,0,0
,20130517,3591,3591,,,,3599,3599,8,8,0,0,0
,20130520,3599,3599,,,,3623,3623,24,24,0,0,0
,20130521,3623,3623,,,,3623,3623,0,0,0,0,0
,20130522,3623,3623,,,,3623,3623,0,0,0,0,0
,20130523,3623,3623,,,,3623,3623,0,0,0,0,0
,20130524,3623,3623,,,,3623,3623,0,0,0,0,0
,20130527,3623,3623,,,,3623,3623,0,0,0,0,0
,20130528,3623,3623,,,,3623,3623,0,0,0,0,0
,20130529,3623,3623,,,,3623,3623,0,0,0,0,0
,20130530,3623,3623,3461,3729,3461,3729,3595,106,-28,4,14.38,2
,20130531,3729,3595,,,,3595,3595,0,0,0,0,2
,20130603,3595,3595,3636,3636,3553,3575,3588,-20,-7,6,21.53,0
,20130604,3575,3588,,,,3588,3588,0,0,0,0,0
,20130605,3588,3588,,,,3588,3588,0,0,0,0,0
,20130606,3588,3588,,,,3588,3588,0,0,0,0,0
,20130607,3588,3588,,,,3588,3588,0,0,0,0,0
,20130613,3588,3588,,,,3588,3588,0,0,0,0,0
,20130614,3588,3588,,,,3588,3588,0,0,0,0,0
,20130617,3588,3588,,,,3588,3588,0,0,0,0,0
,20130618,3588,3588,,,,3588,3588,0,0,0,0,0
,20130619,3588,3588,,,,3599,3599,11,11,0,0,0
,20130620,3599,3599,,,,3599,3599,0,0,0,0,0
,20130621,3599,3599,3503,3695,3503,3600,3599,1,0,6,21.6,2
,20130624,3600,3599,,,,3599,3599,0,0,0,0,2
,20130625,3599,3599,,,,3599,3599,0,0,0,0,2
,20130626,3599,3599,,,,3599,3599,0,0,0,0,2
,20130627,3599,3599,,,,3599,3599,0,0,0,0,2
,20130628,3599,3599,,,,3599,3599,0,0,0,0,2
,20130701,3599,3599,,,,3599,3599,0,0,0,0,2
,20130702,3599,3599,,,,3599,3599,0,0,0,0,2
,20130703,3599,3599,3619,3619,3619,3619,3619,20,20,2,7.24,2
,20130704,3619,3619,,,,3619,3619,0,0,0,0,2
,20130705,3619,3619,,,,3619,3619,0,0,0,0,2
,20130708,3619,3619,,,,3619,3619,0,0,0,0,2
,20130709,3619,3619,,,,3619,3619,0,0,0,0,2
,20130710,3619,3619,,,,3646,3646,27,27,0,0,2
,20130711,3646,3646,3768,3768,3669,3669,3718,23,72,4,14.87,4
,20130712,3669,3718,,,,3718,3718,0,0,0,0,4
,20130715,3718,3718,,,,3718,3718,0,0,0,0,4
,20130716,3718,3718,,,,3718,3718,0,0,0,0,4
,20130717,3718,3718,,,,3718,3718,0,0,0,0,4
,20130718,3718,3718,,,,3718,3718,0,0,0,0,4
,20130719,3718,3718,,,,3718,3718,0,0,0,0,4
,20130722,3718,3718,,,,3718,3718,0,0,0,0,4
,20130723,3718,3718,,,,3718,3718,0,0,0,0,4
,20130724,3718,3718,,,,3718,3718,0,0,0,0,4
,20130725,3718,3718,,,,3718,3718,0,0,0,0,4
,20130726,3718,3718,,,,3718,3718,0,0,0,0,4
,20130729,3718,3718,,,,3718,3718,0,0,0,0,4
,20130730,3718,3718,,,,3718,3718,0,0,0,0,4
,20130731,3718,3718,,,,3718,3718,0,0,0,0,4
,20130801,3718,3718,,,,3718,3718,0,0,0,0,4
,20130802,3718,3718,,,,3718,3718,0,0,0,0,4
,20130805,3718,3718,,,,3718,3718,0,0,0,0,4
,20130806,3718,3718,,,,3718,3718,0,0,0,0,4
,20130807,3718,3718,,,,3718,3718,0,0,0,0,4
,20130808,3718,3718,,,,3736,3736,18,18,0,0,4
,20130809,3736,3736,3733,3733,3733,3733,3733,-3,-3,2,7.47,2
,20130812,3733,3733,,,,3799,3799,66,66,0,0,2
,20130813,3799,3799,,,,3828,3828,29,29,0,0,2
,20130814,3828,3828,,,,3828,3828,0,0,0,0,2
,20130815,3828,3828,,,,3828,3828,0,0,0,0,2
,20130816,3828,3828,,,,3828,3828,0,0,0,0,2
,20130819,3828,3828,,,,3828,3828,0,0,0,0,2
,20130820,3828,3828,,,,3828,3828,0,0,0,0,2
,20130821,3828,3828,,,,3828,3828,0,0,0,0,2
,20130822,3828,3828,3800,3800,3800,3800,3800,-28,-28,2,7.6,0
,20130823,3800,3800,,,,3800,3800,0,0,0,0,0
,20130826,3800,3800,,,,3800,3800,0,0,0,0,0
,20130827,3800,3800,,,,3808,3808,8,8,0,0,0
,20130828,3808,3808,,,,3808,3808,0,0,0,0,0
,20130829,3808,3808,,,,3748,3748,-60,-60,0,0,0
,20130830,3748,3748,,,,3748,3748,0,0,0,0,0
,20130902,3748,3748,,,,3801,3801,53,53,0,0,0
,20130903,3801,3801,,,,3801,3801,0,0,0,0,0
,20130904,3801,3801,,,,3801,3801,0,0,0,0,0
,20130905,3801,3801,,,,3801,3801,0,0,0,0,0
,20130906,3801,3801,,,,3774,3774,-27,-27,0,0,0
,20130909,3774,3774,,,,3815,3815,41,41,0,0,0
,20130910,3815,3815,,,,3815,3815,0,0,0,0,0
,20130911,3815,3815,,,,3815,3815,0,0,0,0,0
,20130912,3815,3815,,,,3793,3793,-22,-22,0,0,0
,20130913,3793,3793,,,,3771,3771,-22,-22,0,0,0
,20130916,3771,3771,,,,3771,3771,0,0,0,0,0
,20130917,3771,3771,,,,3771,3771,0,0,0,0,0
,20130918,3771,3771,,,,3729,3729,-42,-42,0,0,0
,20130923,3729,3729,,,,3738,3738,9,9,0,0,0
,20130924,3738,3738,,,,3738,3738,0,0,0,0,0
,20130925,3738,3738,,,,3738,3738,0,0,0,0,0
,20130926,3738,3738,,,,3738,3738,0,0,0,0,0
,20130927,3738,3738,,,,3738,3738,0,0,0,0,0
,20130930,3738,3738,,,,3738,3738,0,0,0,0,0
,20131008,3738,3738,,,,3690,3690,-48,-48,0,0,0
,20131009,3690,3690,,,,3690,3690,0,0,0,0,0
,20131010,3690,3690,,,,3690,3690,0,0,0,0,0
,20131011,3690,3690,,,,3690,3690,0,0,0,0,0
,20131014,3690,3690,,,,3731,3731,41,41,0,0,0
,20131015,3731,3731,,,,3731,3731,0,0,0,0,0
,20131016,3731,3731,,,,3731,3731,0,0,0,0,0
,20131017,3731,3731,,,,3731,3731,0,0,0,0,0
,20131018,3731,3731,,,,3731,3731,0,0,0,0,0
,20131021,3731,3731,,,,3731,3731,0,0,0,0,0
,20131022,3731,3731,,,,3731,3731,0,0,0,0,0
,20131023,3731,3731,,,,3731,3731,0,0,0,0,0
,20131024,3731,3731,,,,3731,3731,0,0,0,0,0
,20131025,3731,3731,,,,3738,3738,7,7,0,0,0
,20131028,3738,3738,,,,3655,3655,-83,-83,0,0,0
,20131029,3655,3655,,,,3655,3655,0,0,0,0,0
,20131030,3655,3655,,,,3655,3655,0,0,0,0,0
,20131031,3655,3655,,,,3655,3655,0,0,0,0,0
,20131101,3655,3655,,,,3655,3655,0,0,0,0,0
,20131104,3655,3655,,,,3655,3655,0,0,0,0,0
,20131105,3655,3655,,,,3655,3655,0,0,0,0,0
,20131106,3655,3655,,,,3655,3655,0,0,0,0,0
,20131107,3655,3655,,,,3682,3682,27,27,0,0,0
,20131108,3682,3682,,,,3682,3682,0,0,0,0,0
,20131111,3682,3682,,,,3682,3682,0,0,0,0,0
,20131112,3682,3682,,,,3682,3682,0,0,0,0,0
,20131113,3682,3682,,,,3675,3675,-7,-7,0,0,0
,20131114,3675,3675,,,,3675,3675,0,0,0,0,0
,20131115,3675,3675,,,,3656,3656,-19,-19,0,0,0
,20131118,3656,3656,,,,3656,3656,0,0,0,0,0
,20131119,3656,3656,,,,3656,3656,0,0,0,0,0
,20131120,3656,3656,,,,3656,3656,0,0,0,0,0
,20131121,3656,3656,,,,3716,3716,60,60,0,0,0
,20131122,3716,3716,,,,3605,3605,-111,-111,0,0,0
,20131125,3605,3605,,,,3605,3605,0,0,0,0,0
,20131126,3605,3605,,,,3605,3605,0,0,0,0,0
,20131127,3605,3605,,,,3605,3605,0,0,0,0,0
,20131128,3605,3605,,,,3605,3605,0,0,0,0,0
,20131129,3605,3605,,,,3644,3644,39,39,0,0,0
,20131202,3644,3644,,,,3644,3644,0,0,0,0,0
,20131203,3644,3644,,,,3644,3644,0,0,0,0,0
,20131204,3644,3644,,,,3644,3644,0,0,0,0,0
,20131205,3644,3644,,,,3644,3644,0,0,0,0,0
,20131206,3644,3644,,,,3646,3646,2,2,0,0,0
,20131209,3646,3646,,,,3646,3646,0,0,0,0,0
,20131210,3646,3646,,,,3646,3646,0,0,0,0,0
,20131211,3646,3646,,,,3646,3646,0,0,0,0,0
,20131212,3646,3646,,,,3646,3646,0,0,0,0,0
,20131213,3646,3646,,,,3646,3646,0,0,0,0,0
,20131216,3646,3646,3614,3690,3614,3690,3646,44,0,20,72.94,0
,20131217,3690,3646,,,,3646,3646,0,0,0,0,0
,20131218,3646,3646,,,,3646,3646,0,0,0,0,0
,20131219,3646,3646,,,,3646,3646,0,0,0,0,0
,20131220,3646,3646,3689,3821,3671,3671,3692,25,46,44,162.45,0
,20131223,3671,3692,,,,3692,3692,0,0,0,0,0
,20131224,3692,3692,,,,3692,3692,0,0,0,0,0
,20131225,3692,3692,,,,3692,3692,0,0,0,0,0
,20131226,3692,3692,,,,3692,3692,0,0,0,0,0
,20131227,3692,3692,,,,3692,3692,0,0,0,0,0
,20131230,3692,3692,,,,3692,3692,0,0,0,0,0
,20131231,3692,3692,,,,3688,3688,-4,-4,0,0,0
wr1406,20130618,3588,3588,,,,3588,3588,0,0,0,0,0
,20130619,3588,3588,,,,3609,3609,21,21,0,0,0
,20130620,3609,3609,,,,3609,3609,0,0,0,0,0
,20130621,3609,3609,,,,3613,3613,4,4,0,0,0
,20130624,3613,3613,,,,3613,3613,0,0,0,0,0
,20130625,3613,3613,,,,3613,3613,0,0,0,0,0
,20130626,3613,3613,,,,3613,3613,0,0,0,0,0
,20130627,3613,3613,,,,3613,3613,0,0,0,0,0
,20130628,3613,3613,,,,3613,3613,0,0,0,0,0
,20130701,3613,3613,,,,3613,3613,0,0,0,0,0
,20130702,3613,3613,,,,3613,3613,0,0,0,0,0
,20130703,3613,3613,,,,3613,3613,0,0,0,0,0
,20130704,3613,3613,,,,3614,3614,1,1,0,0,0
,20130705,3614,3614,,,,3623,3623,9,9,0,0,0
,20130708,3623,3623,,,,3623,3623,0,0,0,0,0
,20130709,3623,3623,,,,3623,3623,0,0,0,0,0
,20130710,3623,3623,,,,3633,3633,10,10,0,0,0
,20130711,3633,3633,,,,3644,3644,11,11,0,0,0
,20130712,3644,3644,,,,3644,3644,0,0,0,0,0
,20130715,3644,3644,,,,3649,3649,5,5,0,0,0
,20130716,3649,3649,,,,3649,3649,0,0,0,0,0
,20130717,3649,3649,,,,3688,3688,39,39,0,0,0
,20130718,3688,3688,,,,3688,3688,0,0,0,0,0
,20130719,3688,3688,,,,3689,3689,1,1,0,0,0
,20130722,3689,3689,3676,3676,3676,3676,3676,-13,-13,2,7.35,2
,20130723,3676,3676,,,,3676,3676,0,0,0,0,2
,20130724,3676,3676,,,,3688,3688,12,12,0,0,2
,20130725,3688,3688,,,,3688,3688,0,0,0,0,2
,20130726,3688,3688,,,,3688,3688,0,0,0,0,2
,20130729,3688,3688,3725,3725,3639,3639,3682,-49,-6,4,14.73,2
,20130730,3639,3682,,,,3682,3682,0,0,0,0,2
,20130731,3682,3682,,,,3682,3682,0,0,0,0,2
,20130801,3682,3682,,,,3682,3682,0,0,0,0,2
,20130802,3682,3682,,,,3684,3684,2,2,0,0,2
,20130805,3684,3684,,,,3684,3684,0,0,0,0,2
,20130806,3684,3684,,,,3684,3684,0,0,0,0,2
,20130807,3684,3684,,,,3716,3716,32,32,0,0,2
,20130808,3716,3716,,,,3737,3737,21,21,0,0,2
,20130809,3737,3737,3741,3741,3741,3741,3741,4,4,2,7.48,2
,20130812,3741,3741,,,,3815,3815,74,74,0,0,2
,20130813,3815,3815,3884,3884,3884,3884,3884,69,69,2,7.77,2
,20130814,3884,3884,3849,3849,3849,3849,3849,-35,-35,2,7.7,2
,20130815,3849,3849,,,,3849,3849,0,0,0,0,2
,20130816,3849,3849,,,,3849,3849,0,0,0,0,2
,20130819,3849,3849,,,,3849,3849,0,0,0,0,2
,20130820,3849,3849,,,,3849,3849,0,0,0,0,2
,20130821,3849,3849,,,,3849,3849,0,0,0,0,2
,20130822,3849,3849,,,,3849,3849,0,0,0,0,2
,20130823,3849,3849,3866,3866,3866,3866,3866,17,17,2,7.73,0
,20130826,3866,3866,,,,3866,3866,0,0,0,0,0
,20130827,3866,3866,,,,3866,3866,0,0,0,0,0
,20130828,3866,3866,,,,3863,3863,-3,-3,0,0,0
,20130829,3863,3863,,,,3802,3802,-61,-61,0,0,0
,20130830,3802,3802,,,,3802,3802,0,0,0,0,0
,20130902,3802,3802,,,,3803,3803,1,1,0,0,0
,20130903,3803,3803,3851,3851,3851,3851,3851,48,48,2,7.7,2
,20130904,3851,3851,3778,3778,3778,3778,3778,-73,-73,2,7.56,2
,20130905,3778,3778,,,,3778,3778,0,0,0,0,2
,20130906,3778,3778,,,,3752,3752,-26,-26,0,0,2
,20130909,3752,3752,,,,3752,3752,0,0,0,0,2
,20130910,3752,3752,,,,3752,3752,0,0,0,0,2
,20130911,3752,3752,,,,3752,3752,0,0,0,0,2
,20130912,3752,3752,,,,3730,3730,-22,-22,0,0,2
,20130913,3730,3730,,,,3708,3708,-22,-22,0,0,2
,20130916,3708,3708,,,,3708,3708,0,0,0,0,2
,20130917,3708,3708,,,,3708,3708,0,0,0,0,2
,20130918,3708,3708,,,,3708,3708,0,0,0,0,2
,20130923,3708,3708,,,,3708,3708,0,0,0,0,2
,20130924,3708,3708,,,,3708,3708,0,0,0,0,2
,20130925,3708,3708,,,,3708,3708,0,0,0,0,2
,20130926,3708,3708,,,,3708,3708,0,0,0,0,2
,20130927,3708,3708,,,,3708,3708,0,0,0,0,2
,20130930,3708,3708,,,,3705,3705,-3,-3,0,0,2
,20131008,3705,3705,,,,3705,3705,0,0,0,0,2
,20131009,3705,3705,,,,3681,3681,-24,-24,0,0,2
,20131010,3681,3681,,,,3681,3681,0,0,0,0,2
,20131011,3681,3681,,,,3681,3681,0,0,0,0,2
,20131014,3681,3681,,,,3681,3681,0,0,0,0,2
,20131015,3681,3681,3720,3720,3720,3720,3720,39,39,2,7.44,0
,20131016,3720,3720,,,,3716,3716,-4,-4,0,0,0
,20131017,3716,3716,,,,3729,3729,13,13,0,0,0
,20131018,3729,3729,,,,3637,3637,-92,-92,0,0,0
,20131021,3637,3637,,,,3591,3591,-46,-46,0,0,0
,20131022,3591,3591,,,,3591,3591,0,0,0,0,0
,20131023,3591,3591,,,,3591,3591,0,0,0,0,0
,20131024,3591,3591,,,,3591,3591,0,0,0,0,0
,20131025,3591,3591,,,,3598,3598,7,7,0,0,0
,20131028,3598,3598,,,,3598,3598,0,0,0,0,0
,20131029,3598,3598,,,,3598,3598,0,0,0,0,0
,20131030,3598,3598,,,,3598,3598,0,0,0,0,0
,20131031,3598,3598,,,,3598,3598,0,0,0,0,0
,20131101,3598,3598,,,,3598,3598,0,0,0,0,0
,20131104,3598,3598,,,,3598,3598,0,0,0,0,0
,20131105,3598,3598,,,,3598,3598,0,0,0,0,0
,20131106,3598,3598,,,,3598,3598,0,0,0,0,0
,20131107,3598,3598,,,,3625,3625,27,27,0,0,0
,20131108,3625,3625,,,,3625,3625,0,0,0,0,0
,20131111,3625,3625,,,,3625,3625,0,0,0,0,0
,20131112,3625,3625,,,,3625,3625,0,0,0,0,0
,20131113,3625,3625,,,,3625,3625,0,0,0,0,0
,20131114,3625,3625,,,,3625,3625,0,0,0,0,0
,20131115,3625,3625,,,,3625,3625,0,0,0,0,0
,20131118,3625,3625,,,,3625,3625,0,0,0,0,0
,20131119,3625,3625,,,,3625,3625,0,0,0,0,0
,20131120,3625,3625,,,,3625,3625,0,0,0,0,0
,20131121,3625,3625,,,,3685,3685,60,60,0,0,0
,20131122,3685,3685,,,,3575,3575,-110,-110,0,0,0
,20131125,3575,3575,,,,3575,3575,0,0,0,0,0
,20131126,3575,3575,,,,3575,3575,0,0,0,0,0
,20131127,3575,3575,,,,3575,3575,0,0,0,0,0
,20131128,3575,3575,,,,3575,3575,0,0,0,0,0
,20131129,3575,3575,,,,3613,3613,38,38,0,0,0
,20131202,3613,3613,,,,3613,3613,0,0,0,0,0
,20131203,3613,3613,,,,3613,3613,0,0,0,0,0
,20131204,3613,3613,,,,3613,3613,0,0,0,0,0
,20131205,3613,3613,,,,3613,3613,0,0,0,0,0
,20131206,3613,3613,,,,3644,3644,31,31,0,0,0
,20131209,3644,3644,,,,3644,3644,0,0,0,0,0
,20131210,3644,3644,,,,3644,3644,0,0,0,0,0
,20131211,3644,3644,,,,3644,3644,0,0,0,0,0
,20131212,3644,3644,,,,3644,3644,0,0,0,0,0
,20131213,3644,3644,,,,3644,3644,0,0,0,0,0
,20131216,3644,3644,,,,3644,3644,0,0,0,0,0
,20131217,3644,3644,,,,3644,3644,0,0,0,0,0
,20131218,3644,3644,,,,3644,3644,0,0,0,0,0
,20131219,3644,3644,,,,3644,3644,0,0,0,0,0
,20131220,3644,3644,,,,3689,3689,45,45,0,0,0
,20131223,3689,3689,,,,3689,3689,0,0,0,0,0
,20131224,3689,3689,,,,3689,3689,0,0,0,0,0
,20131225,3689,3689,,,,3689,3689,0,0,0,0,0
,20131226,3689,3689,,,,3689,3689,0,0,0,0,0
,20131227,3689,3689,,,,3689,3689,0,0,0,0,0
,20131230,3689,3689,,,,3689,3689,0,0,0,0,0
,20131231,3689,3689,,,,3685,3685,-4,-4,0,0,0
wr1407,20130716,3649,3649,,,,3674,3674,25,25,0,0,0
,20130717,3674,3674,,,,3694,3694,20,20,0,0,0
,20130718,3694,3694,,,,3694,3694,0,0,0,0,0
,20130719,3694,3694,,,,3696,3696,2,2,0,0,0
,20130722,3696,3696,,,,3696,3696,0,0,0,0,0
,20130723,3696,3696,,,,3696,3696,0,0,0,0,0
,20130724,3696,3696,,,,3696,3696,0,0,0,0,0
,20130725,3696,3696,,,,3696,3696,0,0,0,0,0
,20130726,3696,3696,,,,3696,3696,0,0,0,0,0
,20130729,3696,3696,,,,3696,3696,0,0,0,0,0
,20130730,3696,3696,,,,3696,3696,0,0,0,0,0
,20130731,3696,3696,,,,3680,3680,-16,-16,0,0,0
,20130801,3680,3680,,,,3680,3680,0,0,0,0,0
,20130802,3680,3680,,,,3686,3686,6,6,0,0,0
,20130805,3686,3686,,,,3686,3686,0,0,0,0,0
,20130806,3686,3686,,,,3696,3696,10,10,0,0,0
,20130807,3696,3696,,,,3727,3727,31,31,0,0,0
,20130808,3727,3727,,,,3739,3739,12,12,0,0,0
,20130809,3739,3739,,,,3747,3747,8,8,0,0,0
,20130812,3747,3747,,,,3788,3788,41,41,0,0,0
,20130813,3788,3788,,,,3838,3838,50,50,0,0,0
,20130814,3838,3838,,,,3838,3838,0,0,0,0,0
,20130815,3838,3838,,,,3838,3838,0,0,0,0,0
,20130816,3838,3838,,,,3838,3838,0,0,0,0,0
,20130819,3838,3838,,,,3838,3838,0,0,0,0,0
,20130820,3838,3838,,,,3838,3838,0,0,0,0,0
,20130821,3838,3838,,,,3838,3838,0,0,0,0,0
,20130822,3838,3838,,,,3838,3838,0,0,0,0,0
,20130823,3838,3838,,,,3838,3838,0,0,0,0,0
,20130826,3838,3838,,,,3838,3838,0,0,0,0,0
,20130827,3838,3838,,,,3838,3838,0,0,0,0,0
,20130828,3838,3838,,,,3871,3871,33,33,0,0,0
,20130829,3871,3871,,,,3854,3854,-17,-17,0,0,0
,20130830,3854,3854,,,,3844,3844,-10,-10,0,0,0
,20130902,3844,3844,,,,3844,3844,0,0,0,0,0
,20130903,3844,3844,,,,3844,3844,0,0,0,0,0
,20130904,3844,3844,,,,3844,3844,0,0,0,0,0
,20130905,3844,3844,,,,3844,3844,0,0,0,0,0
,20130906,3844,3844,,,,3817,3817,-27,-27,0,0,0
,20130909,3817,3817,,,,3817,3817,0,0,0,0,0
,20130910,3817,3817,,,,3817,3817,0,0,0,0,0
,20130911,3817,3817,,,,3817,3817,0,0,0,0,0
,20130912,3817,3817,,,,3795,3795,-22,-22,0,0,0
,20130913,3795,3795,,,,3795,3795,0,0,0,0,0
,20130916,3795,3795,,,,3799,3799,4,4,0,0,0
,20130917,3799,3799,,,,3799,3799,0,0,0,0,0
,20130918,3799,3799,,,,3798,3798,-1,-1,0,0,0
,20130923,3798,3798,,,,3807,3807,9,9,0,0,0
,20130924,3807,3807,,,,3770,3770,-37,-37,0,0,0
,20130925,3770,3770,,,,3763,3763,-7,-7,0,0,0
,20130926,3763,3763,,,,3763,3763,0,0,0,0,0
,20130927,3763,3763,,,,3718,3718,-45,-45,0,0,0
,20130930,3718,3718,,,,3718,3718,0,0,0,0,0
,20131008,3718,3718,,,,3670,3670,-48,-48,0,0,0
,20131009,3670,3670,,,,3646,3646,-24,-24,0,0,0
,20131010,3646,3646,,,,3646,3646,0,0,0,0,0
,20131011,3646,3646,,,,3646,3646,0,0,0,0,0
,20131014,3646,3646,,,,3687,3687,41,41,0,0,0
,20131015,3687,3687,,,,3687,3687,0,0,0,0,0
,20131016,3687,3687,,,,3683,3683,-4,-4,0,0,0
,20131017,3683,3683,,,,3683,3683,0,0,0,0,0
,20131018,3683,3683,,,,3592,3592,-91,-91,0,0,0
,20131021,3592,3592,,,,3546,3546,-46,-46,0,0,0
,20131022,3546,3546,,,,3546,3546,0,0,0,0,0
,20131023,3546,3546,,,,3546,3546,0,0,0,0,0
,20131024,3546,3546,,,,3546,3546,0,0,0,0,0
,20131025,3546,3546,,,,3553,3553,7,7,0,0,0
,20131028,3553,3553,,,,3474,3474,-79,-79,0,0,0
,20131029,3474,3474,,,,3474,3474,0,0,0,0,0
,20131030,3474,3474,,,,3603,3603,129,129,0,0,0
,20131031,3603,3603,,,,3606,3606,3,3,0,0,0
,20131101,3606,3606,,,,3606,3606,0,0,0,0,0
,20131104,3606,3606,,,,3606,3606,0,0,0,0,0
,20131105,3606,3606,,,,3606,3606,0,0,0,0,0
,20131106,3606,3606,,,,3606,3606,0,0,0,0,0
,20131107,3606,3606,,,,3633,3633,27,27,0,0,0
,20131108,3633,3633,,,,3633,3633,0,0,0,0,0
,20131111,3633,3633,,,,3633,3633,0,0,0,0,0
,20131112,3633,3633,,,,3633,3633,0,0,0,0,0
,20131113,3633,3633,,,,3633,3633,0,0,0,0,0
,20131114,3633,3633,,,,3633,3633,0,0,0,0,0
,20131115,3633,3633,,,,3633,3633,0,0,0,0,0
,20131118,3633,3633,,,,3633,3633,0,0,0,0,0
,20131119,3633,3633,,,,3633,3633,0,0,0,0,0
,20131120,3633,3633,,,,3633,3633,0,0,0,0,0
,20131121,3633,3633,,,,3693,3693,60,60,0,0,0
,20131122,3693,3693,,,,3582,3582,-111,-111,0,0,0
,20131125,3582,3582,,,,3582,3582,0,0,0,0,0
,20131126,3582,3582,,,,3582,3582,0,0,0,0,0
,20131127,3582,3582,,,,3582,3582,0,0,0,0,0
,20131128,3582,3582,,,,3582,3582,0,0,0,0,0
,20131129,3582,3582,,,,3620,3620,38,38,0,0,0
,20131202,3620,3620,,,,3620,3620,0,0,0,0,0
,20131203,3620,3620,,,,3620,3620,0,0,0,0,0
,20131204,3620,3620,,,,3620,3620,0,0,0,0,0
,20131205,3620,3620,,,,3620,3620,0,0,0,0,0
,20131206,3620,3620,,,,3646,3646,26,26,0,0,0
,20131209,3646,3646,,,,3646,3646,0,0,0,0,0
,20131210,3646,3646,,,,3646,3646,0,0,0,0,0
,20131211,3646,3646,,,,3646,3646,0,0,0,0,0
,20131212,3646,3646,,,,3646,3646,0,0,0,0,0
,20131213,3646,3646,,,,3646,3646,0,0,0,0,0
,20131216,3646,3646,,,,3646,3646,0,0,0,0,0
,20131217,3646,3646,,,,3646,3646,0,0,0,0,0
,20131218,3646,3646,,,,3646,3646,0,0,0,0,0
,20131219,3646,3646,,,,3646,3646,0,0,0,0,0
,20131220,3646,3646,,,,3692,3692,46,46,0,0,0
,20131223,3692,3692,,,,3692,3692,0,0,0,0,0
,20131224,3692,3692,,,,3692,3692,0,0,0,0,0
,20131225,3692,3692,,,,3692,3692,0,0,0,0,0
,20131226,3692,3692,,,,3692,3692,0,0,0,0,0
,20131227,3692,3692,,,,3692,3692,0,0,0,0,0
,20131230,3692,3692,,,,3692,3692,0,0,0,0,0
,20131231,3692,3692,,,,3688,3688,-4,-4,0,0,0
wr1408,20130816,3838,3838,,,,3838,3838,0,0,0,0,0
,20130819,3838,3838,,,,3869,3869,31,31,0,0,0
,20130820,3869,3869,,,,3803,3803,-66,-66,0,0,0
,20130821,3803,3803,,,,3752,3752,-51,-51,0,0,0
,20130822,3752,3752,,,,3781,3781,29,29,0,0,0
,20130823,3781,3781,,,,3835,3835,54,54,0,0,0
,20130826,3835,3835,,,,3904,3904,69,69,0,0,0
,20130827,3904,3904,,,,3859,3859,-45,-45,0,0,0
,20130828,3859,3859,,,,3892,3892,33,33,0,0,0
,20130829,3892,3892,,,,3892,3892,0,0,0,0,0
,20130830,3892,3892,,,,3880,3880,-12,-12,0,0,0
,20130902,3880,3880,,,,3880,3880,0,0,0,0,0
,20130903,3880,3880,,,,3880,3880,0,0,0,0,0
,20130904,3880,3880,,,,3880,3880,0,0,0,0,0
,20130905,3880,3880,,,,3880,3880,0,0,0,0,0
,20130906,3880,3880,,,,3853,3853,-27,-27,0,0,0
,20130909,3853,3853,,,,3853,3853,0,0,0,0,0
,20130910,3853,3853,,,,3853,3853,0,0,0,0,0
,20130911,3853,3853,,,,3853,3853,0,0,0,0,0
,20130912,3853,3853,,,,3830,3830,-23,-23,0,0,0
,20130913,3830,3830,,,,3809,3809,-21,-21,0,0,0
,20130916,3809,3809,,,,3813,3813,4,4,0,0,0
,20130917,3813,3813,,,,3813,3813,0,0,0,0,0
,20130918,3813,3813,,,,3770,3770,-43,-43,0,0,0
,20130923,3770,3770,,,,3779,3779,9,9,0,0,0
,20130924,3779,3779,,,,3779,3779,0,0,0,0,0
,20130925,3779,3779,,,,3764,3764,-15,-15,0,0,0
,20130926,3764,3764,,,,3764,3764,0,0,0,0,0
,20130927,3764,3764,,,,3719,3719,-45,-45,0,0,0
,20130930,3719,3719,,,,3719,3719,0,0,0,0,0
,20131008,3719,3719,3601,3651,3601,3651,3626,-68,-93,4,14.5,0
,20131009,3651,3626,,,,3602,3602,-24,-24,0,0,0
,20131010,3602,3602,,,,3602,3602,0,0,0,0,0
,20131011,3602,3602,,,,3602,3602,0,0,0,0,0
,20131014,3602,3602,,,,3644,3644,42,42,0,0,0
,20131015,3644,3644,,,,3666,3666,22,22,0,0,0
,20131016,3666,3666,,,,3662,3662,-4,-4,0,0,0
,20131017,3662,3662,,,,3674,3674,12,12,0,0,0
,20131018,3674,3674,,,,3583,3583,-91,-91,0,0,0
,20131021,3583,3583,,,,3537,3537,-46,-46,0,0,0
,20131022,3537,3537,,,,3537,3537,0,0,0,0,0
,20131023,3537,3537,,,,3537,3537,0,0,0,0,0
,20131024,3537,3537,,,,3576,3576,39,39,0,0,0
,20131025,3576,3576,,,,3583,3583,7,7,0,0,0
,20131028,3583,3583,,,,3583,3583,0,0,0,0,0
,20131029,3583,3583,,,,3583,3583,0,0,0,0,0
,20131030,3583,3583,,,,3613,3613,30,30,0,0,0
,20131031,3613,3613,,,,3616,3616,3,3,0,0,0
,20131101,3616,3616,,,,3616,3616,0,0,0,0,0
,20131104,3616,3616,,,,3650,3650,34,34,0,0,0
,20131105,3650,3650,,,,3650,3650,0,0,0,0,0
,20131106,3650,3650,,,,3650,3650,0,0,0,0,0
,20131107,3650,3650,,,,3677,3677,27,27,0,0,0
,20131108,3677,3677,,,,3677,3677,0,0,0,0,0
,20131111,3677,3677,,,,3677,3677,0,0,0,0,0
,20131112,3677,3677,,,,3677,3677,0,0,0,0,0
,20131113,3677,3677,,,,3677,3677,0,0,0,0,0
,20131114,3677,3677,,,,3670,3670,-7,-7,0,0,0
,20131115,3670,3670,,,,3670,3670,0,0,0,0,0
,20131118,3670,3670,,,,3670,3670,0,0,0,0,0
,20131119,3670,3670,,,,3670,3670,0,0,0,0,0
,20131120,3670,3670,,,,3670,3670,0,0,0,0,0
,20131121,3670,3670,,,,3670,3670,0,0,0,0,0
,20131122,3670,3670,,,,3560,3560,-110,-110,0,0,0
,20131125,3560,3560,,,,3560,3560,0,0,0,0,0
,20131126,3560,3560,,,,3560,3560,0,0,0,0,0
,20131127,3560,3560,,,,3560,3560,0,0,0,0,0
,20131128,3560,3560,,,,3560,3560,0,0,0,0,0
,20131129,3560,3560,,,,3598,3598,38,38,0,0,0
,20131202,3598,3598,,,,3598,3598,0,0,0,0,0
,20131203,3598,3598,,,,3598,3598,0,0,0,0,0
,20131204,3598,3598,,,,3679,3679,81,81,0,0,0
,20131205,3679,3679,,,,3679,3679,0,0,0,0,0
,20131206,3679,3679,,,,3679,3679,0,0,0,0,0
,20131209,3679,3679,,,,3679,3679,0,0,0,0,0
,20131210,3679,3679,,,,3679,3679,0,0,0,0,0
,20131211,3679,3679,,,,3683,3683,4,4,0,0,0
,20131212,3683,3683,,,,3683,3683,0,0,0,0,0
,20131213,3683,3683,,,,3683,3683,0,0,0,0,0
,20131216,3683,3683,,,,3683,3683,0,0,0,0,0
,20131217,3683,3683,,,,3683,3683,0,0,0,0,0
,20131218,3683,3683,,,,3683,3683,0,0,0,0,0
,20131219,3683,3683,,,,3683,3683,0,0,0,0,0
,20131220,3683,3683,,,,3729,3729,46,46,0,0,0
,20131223,3729,3729,,,,3729,3729,0,0,0,0,0
,20131224,3729,3729,,,,3729,3729,0,0,0,0,0
,20131225,3729,3729,,,,3729,3729,0,0,0,0,0
,20131226,3729,3729,,,,3729,3729,0,0,0,0,0
,20131227,3729,3729,,,,3729,3729,0,0,0,0,0
,20131230,3729,3729,,,,3729,3729,0,0,0,0,0
,20131231,3729,3729,,,,3725,3725,-4,-4,0,0,0
wr1409,20130917,3813,3813,,,,3813,3813,0,0,0,0,0
,20130918,3813,3813,,,,3770,3770,-43,-43,0,0,0
,20130923,3770,3770,,,,3779,3779,9,9,0,0,0
,20130924,3779,3779,,,,3779,3779,0,0,0,0,0
,20130925,3779,3779,,,,3743,3743,-36,-36,0,0,0
,20130926,3743,3743,3607,3707,3607,3707,3657,-36,-86,4,14.63,0
,20130927,3707,3657,,,,3613,3613,-44,-44,0,0,0
,20130930,3613,3613,,,,3613,3613,0,0,0,0,0
,20131008,3613,3613,,,,3522,3522,-91,-91,0,0,0
,20131009,3522,3522,,,,3499,3499,-23,-23,0,0,0
,20131010,3499,3499,,,,3499,3499,0,0,0,0,0
,20131011,3499,3499,,,,3499,3499,0,0,0,0,0
,20131014,3499,3499,,,,3538,3538,39,39,0,0,0
,20131015,3538,3538,,,,3575,3575,37,37,0,0,0
,20131016,3575,3575,,,,3571,3571,-4,-4,0,0,0
,20131017,3571,3571,,,,3583,3583,12,12,0,0,0
,20131018,3583,3583,3629,3709,3629,3709,3669,126,86,4,14.68,2
,20131021,3709,3669,3633,3670,3633,3670,3651,1,-18,4,14.61,2
,20131022,3670,3651,,,,3666,3666,15,15,0,0,2
,20131023,3666,3666,3669,3669,3669,3669,3669,3,3,2,7.34,0
,20131024,3669,3669,,,,3669,3669,0,0,0,0,0
,20131025,3669,3669,,,,3676,3676,7,7,0,0,0
,20131028,3676,3676,,,,3676,3676,0,0,0,0,0
,20131029,3676,3676,,,,3676,3676,0,0,0,0,0
,20131030,3676,3676,,,,3676,3676,0,0,0,0,0
,20131031,3676,3676,,,,3676,3676,0,0,0,0,0
,20131101,3676,3676,,,,3676,3676,0,0,0,0,0
,20131104,3676,3676,,,,3676,3676,0,0,0,0,0
,20131105,3676,3676,,,,3676,3676,0,0,0,0,0
,20131106,3676,3676,,,,3676,3676,0,0,0,0,0
,20131107,3676,3676,,,,3703,3703,27,27,0,0,0
,20131108,3703,3703,,,,3703,3703,0,0,0,0,0
,20131111,3703,3703,,,,3703,3703,0,0,0,0,0
,20131112,3703,3703,,,,3703,3703,0,0,0,0,0
,20131113,3703,3703,,,,3703,3703,0,0,0,0,0
,20131114,3703,3703,,,,3695,3695,-8,-8,0,0,0
,20131115,3695,3695,,,,3672,3672,-23,-23,0,0,0
,20131118,3672,3672,,,,3672,3672,0,0,0,0,0
,20131119,3672,3672,3693,3736,3522,3648,3674,-24,2,170,624.71,8
,20131120,3648,3674,,,,3674,3674,0,0,0,0,8
,20131121,3674,3674,,,,3674,3674,0,0,0,0,8
,20131122,3674,3674,,,,3674,3674,0,0,0,0,8
,20131125,3674,3674,3627,3627,3627,3627,3627,-47,-47,2,7.25,8
,20131126,3627,3627,,,,3653,3653,26,26,0,0,8
,20131127,3653,3653,,,,3653,3653,0,0,0,0,8
,20131128,3653,3653,,,,3670,3670,17,17,0,0,8
,20131129,3670,3670,,,,3670,3670,0,0,0,0,8
,20131202,3670,3670,,,,3670,3670,0,0,0,0,8
,20131203,3670,3670,,,,3673,3673,3,3,0,0,8
,20131204,3673,3673,3690,3690,3690,3690,3690,17,17,2,7.38,6
,20131205,3690,3690,,,,3690,3690,0,0,0,0,6
,20131206,3690,3690,,,,3690,3690,0,0,0,0,6
,20131209,3690,3690,,,,3690,3690,0,0,0,0,6
,20131210,3690,3690,,,,3690,3690,0,0,0,0,6
,20131211,3690,3690,,,,3703,3703,13,13,0,0,6
,20131212,3703,3703,,,,3703,3703,0,0,0,0,6
,20131213,3703,3703,,,,3703,3703,0,0,0,0,6
,20131216,3703,3703,,,,3703,3703,0,0,0,0,6
,20131217,3703,3703,,,,3703,3703,0,0,0,0,6
,20131218,3703,3703,,,,3703,3703,0,0,0,0,6
,20131219,3703,3703,,,,3703,3703,0,0,0,0,6
,20131220,3703,3703,,,,3703,3703,0,0,0,0,6
,20131223,3703,3703,,,,3684,3684,-19,-19,0,0,6
,20131224,3684,3684,,,,3684,3684,0,0,0,0,6
,20131225,3684,3684,,,,3684,3684,0,0,0,0,6
,20131226,3684,3684,,,,3684,3684,0,0,0,0,6
,20131227,3684,3684,,,,3684,3684,0,0,0,0,6
,20131230,3684,3684,,,,3684,3684,0,0,0,0,6
,20131231,3684,3684,,,,3684,3684,0,0,0,0,6
wr1410,20131016,3575,3575,,,,3678,3678,103,103,0,0,0
,20131017,3678,3678,,,,3678,3678,0,0,0,0,0
,20131018,3678,3678,,,,3678,3678,0,0,0,0,0
,20131021,3678,3678,,,,3678,3678,0,0,0,0,0
,20131022,3678,3678,,,,3678,3678,0,0,0,0,0
,20131023,3678,3678,,,,3678,3678,0,0,0,0,0
,20131024,3678,3678,,,,3678,3678,0,0,0,0,0
,20131025,3678,3678,,,,3678,3678,0,0,0,0,0
,20131028,3678,3678,,,,3678,3678,0,0,0,0,0
,20131029,3678,3678,,,,3678,3678,0,0,0,0,0
,20131030,3678,3678,,,,3678,3678,0,0,0,0,0
,20131031,3678,3678,,,,3678,3678,0,0,0,0,0
,20131101,3678,3678,,,,3678,3678,0,0,0,0,0
,20131104,3678,3678,,,,3678,3678,0,0,0,0,0
,20131105,3678,3678,,,,3678,3678,0,0,0,0,0
,20131106,3678,3678,,,,3678,3678,0,0,0,0,0
,20131107,3678,3678,,,,3678,3678,0,0,0,0,0
,20131108,3678,3678,,,,3678,3678,0,0,0,0,0
,20131111,3678,3678,,,,3678,3678,0,0,0,0,0
,20131112,3678,3678,,,,3679,3679,1,1,0,0,0
,20131113,3679,3679,,,,3679,3679,0,0,0,0,0
,20131114,3679,3679,,,,3679,3679,0,0,0,0,0
,20131115,3679,3679,,,,3679,3679,0,0,0,0,0
,20131118,3679,3679,,,,3679,3679,0,0,0,0,0
,20131119,3679,3679,,,,3679,3679,0,0,0,0,0
,20131120,3679,3679,,,,3679,3679,0,0,0,0,0
,20131121,3679,3679,,,,3679,3679,0,0,0,0,0
,20131122,3679,3679,,,,3679,3679,0,0,0,0,0
,20131125,3679,3679,,,,3679,3679,0,0,0,0,0
,20131126,3679,3679,,,,3679,3679,0,0,0,0,0
,20131127,3679,3679,,,,3679,3679,0,0,0,0,0
,20131128,3679,3679,,,,3679,3679,0,0,0,0,0
,20131129,3679,3679,,,,3679,3679,0,0,0,0,0
,20131202,3679,3679,,,,3679,3679,0,0,0,0,0
,20131203,3679,3679,,,,3679,3679,0,0,0,0,0
,20131204,3679,3679,,,,3679,3679,0,0,0,0,0
,20131205,3679,3679,,,,3679,3679,0,0,0,0,0
,20131206,3679,3679,,,,3679,3679,0,0,0,0,0
,20131209,3679,3679,,,,3679,3679,0,0,0,0,0
,20131210,3679,3679,,,,3679,3679,0,0,0,0,0
,20131211,3679,3679,,,,3679,3679,0,0,0,0,0
,20131212,3679,3679,,,,3679,3679,0,0,0,0,0
,20131213,3679,3679,,,,3679,3679,0,0,0,0,0
,20131216,3679,3679,,,,3679,3679,0,0,0,0,0
,20131217,3679,3679,,,,3679,3679,0,0,0,0,0
,20131218,3679,3679,,,,3679,3679,0,0,0,0,0
,20131219,3679,3679,,,,3679,3679,0,0,0,0,0
,20131220,3679,3679,,,,3679,3679,0,0,0,0,0
,20131223,3679,3679,,,,3679,3679,0,0,0,0,0
,20131224,3679,3679,,,,3679,3679,0,0,0,0,0
,20131225,3679,3679,,,,3679,3679,0,0,0,0,0
,20131226,3679,3679,,,,3679,3679,0,0,0,0,0
,20131227,3679,3679,,,,3679,3679,0,0,0,0,0
,20131230,3679,3679,,,,3679,3679,0,0,0,0,0
,20131231,3679,3679,,,,3679,3679,0,0,0,0,0
wr1411,20131118,3679,3679,,,,3679,3679,0,0,0,0,0
,20131119,3679,3679,,,,3679,3679,0,0,0,0,0
,20131120,3679,3679,,,,3679,3679,0,0,0,0,0
,20131121,3679,3679,,,,3740,3740,61,61,0,0,0
,20131122,3740,3740,,,,3628,3628,-112,-112,0,0,0
,20131125,3628,3628,,,,3581,3581,-47,-47,0,0,0
,20131126,3581,3581,,,,3581,3581,0,0,0,0,0
,20131127,3581,3581,,,,3616,3616,35,35,0,0,0
,20131128,3616,3616,,,,3623,3623,7,7,0,0,0
,20131129,3623,3623,,,,3636,3636,13,13,0,0,0
,20131202,3636,3636,,,,3644,3644,8,8,0,0,0
,20131203,3644,3644,,,,3656,3656,12,12,0,0,0
,20131204,3656,3656,,,,3656,3656,0,0,0,0,0
,20131205,3656,3656,,,,3656,3656,0,0,0,0,0
,20131206,3656,3656,,,,3656,3656,0,0,0,0,0
,20131209,3656,3656,,,,3656,3656,0,0,0,0,0
,20131210,3656,3656,,,,3656,3656,0,0,0,0,0
,20131211,3656,3656,,,,3656,3656,0,0,0,0,0
,20131212,3656,3656,,,,3674,3674,18,18,0,0,0
,20131213,3674,3674,,,,3674,3674,0,0,0,0,0
,20131216,3674,3674,,,,3674,3674,0,0,0,0,0
,20131217,3674,3674,,,,3674,3674,0,0,0,0,0
,20131218,3674,3674,,,,3674,3674,0,0,0,0,0
,20131219,3674,3674,,,,3674,3674,0,0,0,0,0
,20131220,3674,3674,,,,3720,3720,46,46,0,0,0
,20131223,3720,3720,,,,3720,3720,0,0,0,0,0
,20131224,3720,3720,,,,3720,3720,0,0,0,0,0
,20131225,3720,3720,,,,3720,3720,0,0,0,0,0
,20131226,3720,3720,,,,3720,3720,0,0,0,0,0
,20131227,3720,3720,,,,3720,3720,0,0,0,0,0
,20131230,3720,3720,,,,3720,3720,0,0,0,0,0
,20131231,3720,3720,,,,3720,3720,0,0,0,0,0
wr1412,20131217,3674,3674,,,,3674,3674,0,0,0,0,0
,20131218,3674,3674,,,,3674,3674,0,0,0,0,0
,20131219,3674,3674,,,,3674,3674,0,0,0,0,0
,20131220,3674,3674,,,,3720,3720,46,46,0,0,0
,20131223,3720,3720,,,,3720,3720,0,0,0,0,0
,20131224,3720,3720,,,,3720,3720,0,0,0,0,0
,20131225,3720,3720,,,,3720,3720,0,0,0,0,0
,20131226,3720,3720,,,,3720,3720,0,0,0,0,0
,20131227,3720,3720,,,,3720,3720,0,0,0,0,0
,20131230,3720,3720,,,,3720,3720,0,0,0,0,0
,20131231,3720,3720,,,,3716,3716,-4,-4,0,0,0
zn1301,20130104,15300,15265,15370,15370,15275,15325,15310,60,45,1330,"10,182.65",12600
,20130107,15325,15310,15250,15285,15180,15185,15235,-125,-75,2010,"15,314.73",11590
,20130108,15185,15235,15215,15215,15140,15140,15170,-95,-65,2390,"18,131.83",10120
,20130109,15140,15170,15160,15170,15135,15140,15150,-30,-20,970,"7,348.43",9550
,20130110,15140,15150,15140,15200,15140,15200,15165,50,15,1690,"12,815.60",8680
,20130111,15200,15165,15230,15265,15170,15170,15225,5,60,900,"6,851.48",8140
,20130114,15170,15225,15125,15185,15090,15170,15125,-55,-100,1950,"14,750.25",7180
,20130115,15170,15125,15105,15125,14990,14990,15065,-135,-60,2250,"16,949.95",7450
zn1302,20130104,15410,15395,15400,15490,15380,15435,15430,40,35,4844,"37,372.55",36510
,20130107,15435,15430,15340,15400,15275,15280,15340,-150,-90,5642,"43,278.85",35146
,20130108,15280,15340,15260,15330,15210,15240,15260,-100,-80,9080,"69,300.29",30330
,20130109,15240,15260,15325,15325,15220,15230,15240,-30,-20,3210,"24,461.29",28948
,20130110,15230,15240,15235,15310,15225,15295,15255,55,15,3172,"24,198.18",27356
,20130111,15295,15255,15320,15375,15245,15255,15315,0,60,3592,"27,509.11",26154
,20130114,15255,15315,15200,15280,15145,15250,15215,-65,-100,3288,"25,018.45",25422
,20130115,15250,15215,15155,15215,15015,15025,15125,-190,-90,5426,"41,037.49",23838
,20130116,15025,15125,15080,15150,15030,15150,15080,25,-45,3974,"29,972.12",22964
,20130117,15150,15080,15085,15115,15060,15095,15080,15,0,3802,"28,671.70",21048
,20130118,15095,15080,15180,15260,15180,15240,15205,160,125,1774,"13,487.09",20462
,20130121,15240,15205,15225,15235,15175,15190,15195,-15,-10,1748,"13,284.45",20048
,20130122,15190,15195,15210,15290,15210,15275,15240,80,45,4160,"31,705.39",19590
,20130123,15275,15240,15315,15320,15270,15315,15290,75,50,2658,"20,324.66",19262
,20130124,15315,15290,15300,15315,15220,15260,15250,-30,-40,2434,"18,559.55",17912
,20130125,15260,15250,15280,15405,15280,15405,15350,155,100,8892,"68,249.40",17280
,20130128,15405,15350,15320,15410,15320,15350,15365,0,15,2930,"22,516.96",16630
,20130129,15350,15365,15365,15445,15345,15430,15395,65,30,3844,"29,597.06",14912
,20130130,15430,15395,15435,15650,15405,15600,15585,205,190,4084,"31,829.55",13302
,20130131,15600,15585,15745,15795,15640,15750,15700,165,115,2578,"20,242.50",12360
,20130201,15750,15700,15725,15750,15605,15690,15690,-10,-10,1310,"10,277.18",11500
,20130204,15690,15690,15850,15875,15780,15830,15845,140,155,1630,"12,914.20",11360
,20130205,15830,15845,15750,15760,15660,15670,15710,-175,-135,730,"5,735.18",11240
,20130206,15670,15710,15750,15785,15610,15615,15700,-95,-10,1040,"8,166.03",10740
,20130207,15615,15700,15575,15650,15540,15550,15570,-150,-130,300,"2,336.18",10800
,20130208,15550,15570,15625,15630,15625,15630,15625,60,55,20,156.28,10780
,20130218,15630,15625,15500,15575,15495,15495,15505,-130,-120,1790,"13,879.28",10650
zn1303,20130104,15520,15510,15545,15620,15490,15540,15545,30,35,50464,"392,278.65",81138
,20130107,15540,15545,15460,15510,15370,15380,15445,-165,-100,37252,"287,679.57",74058
,20130108,15380,15445,15385,15430,15310,15320,15365,-125,-80,33890,"260,398.76",64936
,20130109,15320,15365,15325,15380,15310,15325,15340,-40,-25,18882,"144,841.42",62092
,20130110,15325,15340,15310,15425,15310,15415,15365,75,25,15734,"120,913.13",60024
,20130111,15415,15365,15450,15500,15355,15365,15425,0,60,16370,"126,278.84",56740
,20130114,15365,15425,15340,15420,15245,15370,15325,-55,-100,19006,"145,667.71",54656
,20130115,15370,15325,15300,15325,15095,15095,15205,-230,-120,25940,"197,212.97",51350
,20130116,15095,15205,15160,15220,15100,15180,15170,-25,-35,12886,"97,747.89",47734
,20130117,15180,15170,15170,15200,15105,15180,15165,10,-5,9072,"68,791.54",44730
,20130118,15180,15165,15250,15340,15250,15320,15300,155,135,10194,"77,989.55",41192
,20130121,15320,15300,15370,15370,15260,15280,15285,-20,-15,4044,"30,914.88",40026
,20130122,15280,15285,15290,15400,15290,15385,15360,100,75,8304,"63,779.24",37848
,20130123,15385,15360,15425,15445,15375,15445,15400,85,40,5644,"43,472.08",36020
,20130124,15445,15400,15415,15435,15330,15370,15365,-30,-35,4304,"33,074.55",35916
,20130125,15370,15365,15410,15530,15410,15530,15475,165,110,9732,"75,311.00",33828
,20130128,15530,15475,15460,15530,15440,15470,15480,-5,5,5494,"42,537.24",32334
,20130129,15470,15480,15460,15535,15450,15515,15490,35,10,3628,"28,105.52",31248
,20130130,15515,15490,15550,15760,15515,15690,15685,200,195,8936,"70,088.02",30026
,20130131,15690,15685,15800,15920,15740,15875,15815,190,130,10836,"85,700.77",27536
,20130201,15875,15815,15830,15850,15720,15820,15795,5,-20,4664,"36,844.57",25570
,20130204,15820,15795,15945,16000,15850,15920,15955,125,160,4486,"35,792.96",24136
,20130205,15920,15955,15895,15895,15750,15750,15830,-205,-125,3180,"25,172.22",23584
,20130206,15750,15830,15820,15865,15700,15700,15770,-130,-60,2296,"18,108.96",23676
,20130207,15700,15770,15700,15700,15615,15655,15645,-115,-125,1594,"12,471.88",23292
,20130208,15655,15645,15620,15745,15610,15690,15710,45,65,1564,"12,288.36",22710
,20130218,15690,15710,15715,15715,15550,15550,15610,-160,-100,2882,"22,498.51",21618
,20130219,15550,15610,15545,15630,15545,15610,15600,0,-10,1264,"9,861.00",21254
,20130220,15610,15600,15595,15760,15595,15750,15670,150,70,1992,"15,609.91",20502
,20130221,15750,15670,15580,15625,15360,15460,15455,-210,-215,6374,"49,269.76",17366
,20130222,15460,15455,15490,15540,15485,15500,15505,45,50,826,"6,404.21",17078
,20130225,15500,15505,15495,15495,15315,15370,15375,-135,-130,1192,"9,164.50",16826
,20130226,15370,15375,15305,15425,15280,15315,15370,-60,-5,2500,"19,215.59",16062
,20130227,15315,15370,15445,15490,15415,15450,15455,80,85,3004,"23,218.06",14570
,20130228,15450,15455,15420,15465,15375,15420,15430,-35,-25,3334,"25,729.22",13540
,20130301,15420,15430,15320,15330,15235,15290,15280,-140,-150,2340,"17,881.65",13750
,20130304,15290,15280,15240,15240,15070,15105,15140,-175,-140,830,"6,283.85",13330
,20130305,15105,15140,15100,15200,15100,15180,15170,40,30,1030,"7,812.75",12910
,20130306,15180,15170,15185,15185,15095,15110,15120,-60,-50,1040,"7,864.70",12610
,20130307,15110,15120,15030,15030,14900,14980,14940,-140,-180,3070,"22,939.25",11620
,20130308,14980,14940,15000,15065,15000,15050,15045,110,105,1560,"11,736.40",11650
,20130311,15050,15045,14975,15005,14925,14950,14965,-95,-80,2750,"20,581.30",11520
,20130312,14950,14965,14940,14990,14910,14920,14945,-45,-20,3300,"24,662.50",10890
,20130313,14920,14945,15010,15030,15010,15020,15015,75,70,450,"3,379.08",10500
,20130314,15020,15015,14960,15000,14930,15000,14955,-15,-60,1640,"12,263.80",10960
,20130315,15000,14955,15000,15070,15000,15040,15030,85,75,960,"7,216.15",10850
zn1304,20130104,15630,15625,15600,15725,15590,15635,15640,10,15,68676,"537,205.18",79356
,20130107,15635,15640,15540,15615,15450,15470,15540,-170,-100,93136,"723,781.16",89150
,20130108,15470,15540,15500,15530,15395,15405,15465,-135,-75,89728,"693,864.22",89816
,20130109,15405,15465,15405,15470,15400,15415,15430,-50,-35,55604,"429,097.14",91416
,20130110,15415,15430,15410,15530,15400,15525,15465,95,35,71008,"549,178.89",94314
,20130111,15525,15465,15580,15605,15450,15455,15530,-10,65,80900,"628,275.52",92120
,20130114,15455,15530,15410,15495,15330,15455,15415,-75,-115,87892,"677,427.81",95472
,20130115,15455,15415,15365,15405,15165,15175,15280,-240,-135,137296,"1,049,060.93",110838
,20130116,15175,15280,15225,15300,15170,15265,15245,-15,-35,80284,"612,068.37",103290
,20130117,15265,15245,15245,15275,15195,15265,15240,20,-5,61730,"470,490.94",101786
,20130118,15265,15240,15370,15430,15355,15420,15385,180,145,68160,"524,456.31",93316
,20130121,15420,15385,15435,15455,15340,15365,15385,-20,0,47974,"369,075.21",93458
,20130122,15365,15385,15385,15500,15365,15485,15450,100,65,57412,"443,545.79",89000
,20130123,15485,15450,15540,15560,15470,15545,15505,95,55,40616,"314,953.46",89284
,20130124,15545,15505,15535,15540,15420,15470,15470,-35,-35,51288,"396,823.76",89976
,20130125,15470,15470,15500,15645,15500,15635,15580,165,110,61694,"480,637.36",90104
,20130128,15635,15580,15570,15640,15550,15570,15590,-10,10,43316,"337,743.70",77752
,20130129,15570,15590,15580,15645,15560,15625,15600,35,10,31514,"245,871.30",75550
,20130130,15625,15600,15650,15870,15630,15815,15780,215,180,45684,"360,486.69",71656
,20130131,15815,15780,15950,16040,15855,16015,15945,235,165,38650,"308,198.00",68344
,20130201,16015,15945,15930,15975,15830,15930,15910,-15,-35,25132,"199,951.61",60300
,20130204,15930,15910,16050,16130,15960,16040,16070,130,160,16618,"133,538.88",58220
,20130205,16040,16070,15955,16010,15855,15880,15930,-190,-140,15020,"119,670.65",55322
,20130206,15880,15930,15955,15975,15800,15850,15885,-80,-45,11540,"91,681.36",53836
,20130207,15850,15885,15835,15835,15730,15745,15760,-140,-125,8300,"65,407.79",51110
,20130208,15745,15760,15725,15855,15715,15780,15815,20,55,4550,"35,980.65",49854
,20130218,15780,15815,15800,15800,15650,15655,15710,-160,-105,8228,"64,634.86",48050
,20130219,15655,15710,15650,15730,15650,15680,15700,-30,-10,4704,"36,928.45",47136
,20130220,15680,15700,15695,15875,15695,15860,15790,160,90,6104,"48,195.91",45672
,20130221,15860,15790,15735,15740,15445,15560,15570,-230,-220,21214,"165,174.42",37920
,20130222,15560,15570,15550,15645,15515,15585,15600,15,30,3368,"26,271.23",36914
,20130225,15585,15600,15500,15515,15420,15460,15455,-140,-145,7388,"57,106.96",33358
,20130226,15460,15455,15430,15540,15380,15450,15475,-5,20,7780,"60,209.89",31502
,20130227,15450,15475,15570,15615,15540,15565,15570,90,95,5692,"44,322.01",30542
,20130228,15565,15570,15555,15600,15510,15520,15555,-50,-15,5524,"42,962.95",29376
,20130301,15520,15555,15450,15450,15330,15360,15390,-195,-165,4776,"36,760.24",27408
,20130304,15360,15390,15265,15350,15175,15190,15240,-200,-150,8362,"63,736.42",25750
,20130305,15190,15240,15210,15310,15200,15280,15245,40,5,6328,"48,247.02",22608
,20130306,15280,15245,15265,15290,15160,15200,15220,-45,-25,4082,"31,073.00",20842
,20130307,15200,15220,15115,15120,14980,15080,15050,-140,-170,7858,"59,144.91",21428
,20130308,15080,15050,15155,15175,15105,15150,15140,100,90,2948,"22,322.46",19980
,20130311,15150,15140,15155,15155,15005,15050,15060,-90,-80,1786,"13,450.18",20250
,20130312,15050,15060,15085,15085,14990,14990,15040,-70,-20,1442,"10,845.84",19798
,20130313,14990,15040,15075,15140,15070,15105,15100,65,60,908,"6,857.58",19436
,20130314,15105,15100,15060,15120,15005,15120,15040,20,-60,1342,"10,092.92",18918
,20130315,15120,15040,15105,15295,15095,15155,15135,115,95,2476,"18,740.72",18656
,20130318,15155,15135,14890,14925,14535,14725,14735,-410,-400,3886,"28,637.44",17706
,20130319,14725,14735,14765,14770,14680,14710,14745,-25,10,3524,"25,989.25",15894
,20130320,14710,14745,14725,14795,14725,14790,14765,45,20,972,"7,175.90",15454
,20130321,14790,14765,14815,14900,14810,14850,14855,85,90,1152,"8,556.82",14992
,20130322,14850,14855,14815,14820,14775,14805,14795,-50,-60,846,"6,259.64",14772
,20130325,14805,14795,14905,14910,14870,14880,14885,85,90,2604,"19,386.29",13880
,20130326,14880,14885,14830,14875,14810,14855,14835,-30,-50,1504,"11,159.41",14068
,20130327,14855,14835,14760,14845,14730,14730,14750,-105,-85,1780,"13,131.79",13714
,20130328,14730,14750,14760,14800,14710,14710,14740,-40,-10,1528,"11,262.16",13110
,20130329,14710,14740,14640,14740,14610,14740,14690,0,-50,2430,"17,850.48",12560
,20130401,14740,14690,14600,14600,14475,14530,14535,-160,-155,4250,"30,890.35",10910
,20130402,14530,14535,14535,14590,14535,14585,14565,50,30,2120,"15,444.05",9780
,20130403,14585,14565,14480,14540,14450,14450,14475,-115,-90,1910,"13,825.05",10000
,20130408,14450,14475,14560,14570,14460,14570,14510,95,35,1160,"8,415.80",9760
,20130409,14570,14510,14600,14700,14600,14700,14650,190,140,1890,"13,847.75",9190
,20130410,14700,14650,14700,14760,14700,14730,14735,80,85,2730,"20,118.25",8540
,20130411,14730,14735,14750,14750,14680,14680,14715,-55,-20,580,"4,267.38",8490
,20130412,14680,14715,14710,14710,14660,14670,14690,-45,-25,630,"4,627.93",8190
,20130415,14670,14690,14500,14500,14350,14360,14415,-330,-275,2190,"15,785.33",8590
zn1305,20130104,15735,15735,15805,15865,15685,15720,15740,-15,5,7868,"61,931.70",10992
,20130107,15720,15740,15600,15715,15535,15550,15640,-190,-100,5732,"44,829.13",12834
,20130108,15550,15640,15590,15615,15495,15495,15555,-145,-85,6852,"53,299.23",14180
,20130109,15495,15555,15505,15555,15495,15510,15520,-45,-35,4748,"36,855.88",14898
,20130110,15510,15520,15520,15675,15495,15640,15565,120,45,9630,"74,955.81",16932
,20130111,15640,15565,15675,15695,15545,15555,15625,-10,60,9738,"76,091.23",19596
,20130114,15555,15625,15510,15585,15420,15545,15515,-80,-110,12060,"93,580.54",21694
,20130115,15545,15515,15465,15500,15260,15265,15375,-250,-140,22066,"169,656.27",27980
,20130116,15265,15375,15310,15390,15260,15340,15335,-35,-40,15912,"122,043.21",28776
,20130117,15340,15335,15345,15360,15295,15355,15325,20,-10,14168,"108,580.16",29602
,20130118,15355,15325,15440,15515,15440,15500,15470,175,145,16934,"131,015.83",31324
,20130121,15500,15470,15505,15535,15435,15455,15465,-15,-5,11660,"90,175.78",33110
,20130122,15455,15465,15460,15595,15460,15580,15545,115,80,26390,"205,155.10",39344
,20130123,15580,15545,15625,15680,15565,15645,15600,100,55,19252,"150,194.93",43258
,20130124,15645,15600,15640,15640,15520,15575,15570,-25,-30,24952,"194,260.75",44920
,20130125,15575,15570,15615,15760,15605,15755,15690,185,120,41798,"327,959.20",63356
,20130128,15755,15690,15690,15745,15645,15680,15695,-10,5,61420,"482,109.64",74294
,20130129,15680,15695,15705,15755,15650,15725,15705,30,10,63646,"499,933.38",88074
,20130130,15725,15705,15760,15995,15725,15925,15905,220,200,150778,"1,199,214.55",124482
,20130131,15925,15905,16035,16170,15960,16150,16080,245,175,192320,"1,546,346.29",169930
,20130201,16150,16080,16080,16100,15940,16045,16035,-35,-45,153840,"1,233,447.02",177604
,20130204,16045,16035,16160,16255,16075,16170,16195,135,160,137510,"1,113,746.42",182456
,20130205,16170,16195,16100,16135,15960,15985,16045,-210,-150,129222,"1,036,883.33",173770
,20130206,15985,16045,16050,16095,15910,15960,16005,-85,-40,91526,"732,602.94",165110
,20130207,15960,16005,15935,15935,15830,15840,15865,-165,-140,68510,"543,595.59",151662
,20130208,15840,15865,15835,15980,15805,15870,15925,5,60,64844,"516,332.82",148284
,20130218,15870,15925,15880,15900,15750,15750,15820,-175,-105,77714,"614,760.88",144866
,20130219,15750,15820,15750,15840,15745,15785,15800,-35,-20,59138,"467,296.52",147142
,20130220,15785,15800,15785,15980,15780,15975,15900,175,100,122144,"971,081.83",170430
,20130221,15975,15900,15855,15875,15525,15640,15670,-260,-230,187662,"1,470,571.71",139248
,20130222,15640,15670,15660,15750,15600,15700,15695,30,25,66330,"520,667.73",135038
,20130225,15700,15695,15550,15660,15500,15550,15550,-145,-145,77986,"606,401.84",126870
,20130226,15550,15550,15550,15635,15455,15540,15575,-10,25,73640,"573,554.53",123494
,20130227,15540,15575,15685,15715,15635,15665,15670,90,95,59050,"462,662.32",119198
,20130228,15665,15670,15635,15695,15605,15655,15655,-15,-15,50708,"396,995.46",111376
,20130301,15655,15655,15560,15560,15425,15460,15480,-195,-175,45442,"351,777.96",104214
,20130304,15460,15480,15350,15450,15280,15295,15340,-185,-140,45812,"351,478.12",97248
,20130305,15295,15340,15295,15420,15295,15390,15360,50,20,32830,"252,158.80",90880
,20130306,15390,15360,15390,15395,15250,15285,15315,-75,-45,23994,"183,780.06",86394
,20130307,15285,15315,15210,15215,15065,15165,15140,-150,-175,40414,"306,008.63",76708
,20130308,15165,15140,15215,15275,15190,15220,15240,80,100,15566,"118,625.62",72904
,20130311,15220,15240,15180,15195,15095,15145,15155,-95,-85,16480,"124,877.98",71958
,20130312,15145,15155,15155,15190,15075,15075,15135,-80,-20,14428,"109,216.92",70038
,20130313,15075,15135,15165,15230,15160,15200,15195,65,60,13080,"99,404.35",67576
,20130314,15200,15195,15150,15200,15090,15195,15135,0,-60,8032,"60,789.41",66364
,20130315,15195,15135,15200,15280,15170,15260,15215,125,80,9546,"72,644.22",63906
,20130318,15260,15215,15160,15160,14520,14780,14810,-435,-405,18096,"134,004.89",59506
,20130319,14780,14810,14800,14850,14745,14775,14805,-35,-5,7504,"55,566.12",57890
,20130320,14775,14805,14775,14880,14720,14840,14835,35,30,9260,"68,702.57",55524
,20130321,14840,14835,14890,15000,14860,14920,14935,85,100,8220,"61,398.00",52944
,20130322,14920,14935,14900,14900,14815,14875,14865,-60,-70,3728,"27,712.07",52518
,20130325,14875,14865,14900,14985,14900,14960,14955,95,90,4024,"30,090.81",52084
,20130326,14960,14955,14945,14945,14860,14905,14895,-50,-60,4664,"34,735.25",50254
,20130327,14905,14895,14860,14860,14770,14770,14795,-125,-100,9842,"72,828.45",47100
,20130328,14770,14795,14800,14840,14750,14750,14785,-45,-10,4322,"31,957.77",46680
,20130329,14750,14785,14645,14785,14645,14700,14725,-85,-60,6078,"44,758.16",44304
,20130401,14700,14725,14705,14705,14545,14550,14585,-175,-140,13720,"100,084.72",36944
,20130402,14550,14585,14550,14630,14550,14620,14600,35,15,4592,"33,524.01",35718
,20130403,14620,14600,14510,14535,14460,14470,14500,-130,-100,5026,"36,441.73",33424
,20130408,14470,14500,14500,14610,14470,14610,14545,110,45,4644,"33,776.36",31100
,20130409,14610,14545,14620,14755,14620,14755,14685,210,140,5074,"37,265.84",29738
,20130410,14755,14685,14795,14795,14715,14745,14755,60,70,4978,"36,726.08",29934
,20130411,14745,14755,14705,14765,14685,14685,14715,-70,-40,2582,"19,002.01",29014
,20130412,14685,14715,14645,14740,14645,14680,14695,-35,-20,2070,"15,211.09",28074
,20130415,14680,14695,14410,14510,14350,14350,14415,-345,-280,8988,"64,800.09",25470
,20130416,14350,14415,14260,14525,14245,14480,14430,65,15,7346,"53,017.43",21462
,20130417,14480,14430,14500,14570,14445,14465,14500,35,70,3448,"25,004.55",19836
,20130418,14465,14500,14205,14335,13920,14210,14185,-290,-315,8642,"61,294.92",17748
,20130419,14210,14185,14345,14475,14260,14450,14380,265,195,4420,"31,786.86",17066
,20130422,14450,14380,14450,14480,14400,14415,14445,35,65,4068,"29,386.87",15914
,20130423,14415,14445,14415,14495,14355,14440,14420,-5,-25,2866,"20,666.43",15654
,20130424,14440,14420,14450,14525,14410,14525,14450,105,30,2778,"20,076.12",14660
,20130425,14525,14450,14610,14635,14550,14575,14565,125,115,2042,"14,873.43",14094
,20130426,14575,14565,14645,14700,14605,14630,14655,65,90,1698,"12,443.23",13390
,20130502,14630,14655,14160,14325,14160,14290,14290,-365,-365,2980,"21,299.53",12860
,20130503,14290,14290,14270,14400,14250,14395,14325,105,35,1920,"13,756.53",12220
,20130506,14395,14325,14600,14600,14520,14570,14550,245,225,2040,"14,844.35",11550
,20130507,14570,14550,14535,14580,14505,14520,14565,-30,15,2860,"20,829.58",9580
,20130508,14520,14565,14555,14590,14540,14565,14560,0,-5,2500,"18,200.55",9100
,20130509,14565,14560,14585,14585,14515,14525,14565,-35,5,1300,"9,467.35",8900
,20130510,14525,14565,14530,14580,14495,14580,14515,15,-50,1220,"8,855.43",9040
,20130513,14580,14515,14510,14545,14500,14535,14525,20,10,1260,"9,150.95",9500
,20130514,14535,14525,14545,14550,14380,14405,14490,-120,-35,1160,"8,404.58",9690
,20130515,14405,14490,14420,14435,14350,14350,14400,-140,-90,2910,"20,954.40",9860
zn1306,20130104,15835,15835,15870,15935,15805,15825,15835,-10,0,406,"3,215.30",1996
,20130107,15825,15835,15760,15810,15640,15655,15720,-180,-115,454,"3,568.82",2050
,20130108,15655,15720,15700,15710,15595,15600,15655,-120,-65,368,"2,881.25",2046
,20130109,15600,15655,15605,15650,15600,15615,15620,-40,-35,368,"2,874.50",2354
,20130110,15615,15620,15575,15725,15575,15725,15655,105,35,148,"1,158.81",2364
,20130111,15725,15655,15785,15790,15655,15670,15720,15,65,106,833.25,2358
,20130114,15670,15720,15630,15695,15540,15665,15625,-55,-95,302,"2,360.11",2386
,20130115,15665,15625,15580,15595,15365,15370,15475,-255,-150,694,"5,369.86",2696
,20130116,15370,15475,15430,15475,15375,15450,15435,-25,-40,238,"1,837.16",2730
,20130117,15450,15435,15455,15455,15390,15445,15430,10,-5,360,"2,777.61",2862
,20130118,15445,15430,15545,15650,15545,15610,15580,180,150,494,"3,849.45",3004
,20130121,15610,15580,15615,15645,15540,15570,15565,-10,-15,496,"3,861.30",3286
,20130122,15570,15565,15580,15690,15580,15680,15645,115,80,1842,"14,409.78",3732
,20130123,15680,15645,15760,15760,15660,15730,15705,85,60,1750,"13,743.69",4514
,20130124,15730,15705,15720,15720,15610,15650,15640,-55,-65,1338,"10,463.41",4758
,20130125,15650,15640,15600,15840,15600,15835,15775,195,135,2374,"18,726.76",5788
,20130128,15835,15775,15790,15830,15745,15770,15785,-5,10,2948,"23,268.04",7000
,20130129,15770,15785,15825,15845,15740,15835,15810,50,25,2704,"21,376.99",8466
,20130130,15835,15810,15880,16080,15825,16025,15990,215,180,3682,"29,442.19",9964
,20130131,16025,15990,16150,16250,16065,16235,16145,245,155,9286,"74,974.24",15206
,20130201,16235,16145,16190,16190,16030,16145,16125,0,-20,11738,"94,639.09",18796
,20130204,16145,16125,16280,16360,16190,16265,16295,140,170,16458,"134,124.05",26124
,20130205,16265,16295,16200,16230,16070,16080,16145,-215,-150,13280,"107,218.25",26842
,20130206,16080,16145,16160,16200,16015,16065,16125,-80,-20,12074,"97,354.05",29334
,20130207,16065,16125,16020,16040,15940,15950,15975,-175,-150,13528,"108,066.67",30042
,20130208,15950,15975,15935,16080,15920,15980,16035,5,60,14656,"117,520.58",32160
,20130218,15980,16035,16005,16020,15850,15850,15915,-185,-120,20482,"163,032.45",32968
,20130219,15850,15915,15850,15940,15845,15890,15905,-25,-10,16556,"131,673.96",38466
,20130220,15890,15905,15900,16080,15895,16065,16000,160,95,32266,"258,184.52",46810
,20130221,16065,16000,15950,15955,15630,15740,15775,-260,-225,52190,"411,741.49",50792
,20130222,15740,15775,15735,15845,15690,15780,15790,5,15,25502,"201,395.16",53800
,20130225,15780,15790,15635,15720,15580,15620,15640,-170,-150,32920,"257,500.05",58300
,20130226,15620,15640,15620,15725,15555,15625,15660,-15,20,37084,"290,410.56",61944
,20130227,15625,15660,15775,15810,15720,15750,15765,90,105,46168,"363,970.75",69984
,20130228,15750,15765,15750,15800,15705,15755,15755,-10,-10,57544,"453,410.32",76002
,20130301,15755,15755,15650,15650,15510,15545,15570,-210,-185,78930,"614,472.40",85784
,20130304,15545,15570,15455,15545,15355,15395,15430,-175,-140,90508,"698,354.56",92770
,20130305,15395,15430,15400,15520,15400,15485,15460,55,30,72024,"556,906.62",96938
,20130306,15485,15460,15465,15500,15335,15370,15410,-90,-50,86466,"666,399.27",106618
,20130307,15370,15410,15295,15315,15155,15265,15240,-145,-170,134184,"1,022,695.36",115812
,20130308,15265,15240,15330,15370,15285,15325,15330,85,90,67468,"517,260.73",116180
,20130311,15325,15330,15265,15285,15180,15220,15235,-110,-95,84466,"643,613.64",126892
,20130312,15220,15235,15250,15280,15155,15160,15215,-75,-20,86778,"660,368.31",126004
,20130313,15160,15215,15275,15330,15240,15290,15285,75,70,75462,"576,836.16",122866
,20130314,15290,15285,15260,15295,15175,15280,15220,-5,-65,72178,"549,388.04",127768
,20130315,15280,15220,15280,15365,15260,15345,15310,125,90,73472,"562,520.20",129288
,20130318,15345,15310,15150,15150,14570,14870,14895,-440,-415,149362,"1,112,626.64",141618
,20130319,14870,14895,14900,14930,14815,14850,14885,-45,-10,74068,"551,258.31",139474
,20130320,14850,14885,14810,14960,14785,14930,14905,45,20,66904,"498,618.30",137310
,20130321,14930,14905,14945,15095,14930,14995,15010,90,105,72432,"543,779.74",132074
,20130322,14995,15010,14960,14975,14890,14950,14945,-60,-65,46026,"343,941.53",132392
,20130325,14950,14945,15055,15075,15010,15030,15040,85,95,43036,"323,644.94",126230
,20130326,15030,15040,14975,15020,14930,14970,14970,-70,-70,34238,"256,334.32",123640
,20130327,14970,14970,14870,14915,14820,14835,14860,-135,-110,54426,"404,437.10",126530
,20130328,14835,14860,14885,14900,14765,14800,14840,-60,-20,35440,"263,040.04",123306
,20130329,14800,14840,14685,14835,14685,14755,14770,-85,-70,24982,"184,519.84",118794
,20130401,14755,14770,14725,14725,14595,14610,14640,-160,-130,27452,"200,993.65",115222
,20130402,14610,14640,14650,14700,14635,14685,14665,45,25,21156,"155,160.59",110218
,20130403,14685,14665,14580,14600,14510,14520,14560,-145,-105,22062,"160,620.11",107668
,20130408,14520,14560,14580,14685,14530,14680,14600,120,40,16386,"119,626.92",102308
,20130409,14680,14600,14740,14830,14710,14825,14760,225,160,16420,"121,213.89",98144
,20130410,14825,14760,14825,14885,14785,14805,14825,45,65,12914,"95,748.68",94956
,20130411,14805,14825,14795,14830,14730,14740,14785,-85,-40,11274,"83,365.87",92934
,20130412,14740,14785,14750,14810,14715,14745,14755,-40,-30,9956,"73,474.00",91126
,20130415,14745,14755,14540,14575,14360,14405,14465,-350,-290,18044,"130,504.38",86986
,20130416,14405,14465,14370,14600,14280,14545,14455,80,-10,22680,"163,973.72",79150
,20130417,14545,14455,14625,14640,14505,14525,14560,70,105,9202,"67,013.42",76188
,20130418,14525,14560,14270,14380,14020,14230,14195,-330,-365,26010,"184,621.48",67350
,20130419,14230,14195,14370,14540,14300,14515,14410,320,215,16878,"121,629.37",61746
,20130422,14515,14410,14525,14555,14420,14420,14490,10,80,6990,"50,650.47",59674
,20130423,14420,14490,14465,14560,14380,14480,14455,-10,-35,10140,"73,299.95",56468
,20130424,14480,14455,14455,14580,14410,14560,14490,105,35,15644,"113,360.88",49404
,20130425,14560,14490,14670,14670,14585,14640,14615,150,125,10144,"74,147.77",44920
,20130426,14640,14615,14685,14770,14675,14690,14720,75,105,11434,"84,155.46",40896
,20130502,14690,14720,14305,14360,14000,14345,14310,-375,-410,6298,"45,069.42",39540
,20130503,14345,14310,14315,14435,14275,14405,14355,95,45,6058,"43,484.69",37400
,20130506,14405,14355,14545,14725,14540,14585,14575,230,220,8788,"64,044.29",33612
,20130507,14585,14575,14530,14595,14510,14510,14550,-65,-25,4374,"31,826.43",32938
,20130508,14510,14550,14520,14600,14510,14600,14575,50,25,3214,"23,423.91",31454
,20130509,14600,14575,14700,14700,14510,14560,14560,-15,-15,4172,"30,374.58",30234
,20130510,14560,14560,14505,14575,14475,14575,14520,15,-40,1690,"12,272.60",29516
,20130513,14575,14520,14530,14560,14505,14535,14530,15,10,3342,"24,283.63",27600
,20130514,14535,14530,14530,14555,14440,14450,14495,-80,-35,6050,"43,855.91",25380
,20130515,14450,14495,14445,14480,14335,14335,14415,-160,-80,4310,"31,074.95",23220
,20130516,14335,14415,14330,14380,14265,14325,14320,-90,-95,3774,"27,024.03",22030
,20130517,14325,14320,14330,14420,14305,14400,14365,80,45,4266,"30,650.81",20660
,20130520,14400,14365,14355,14365,14300,14350,14325,-15,-40,2878,"20,616.97",20030
,20130521,14350,14325,14410,14435,14375,14405,14415,80,90,4302,"31,009.11",18832
,20130522,14405,14415,14410,14510,14390,14500,14475,85,60,4520,"32,715.90",16850
,20130523,14500,14475,14425,14440,14365,14385,14405,-90,-70,2358,"16,983.93",16340
,20130524,14385,14405,14460,14520,14430,14505,14490,100,85,1516,"10,984.12",15970
,20130527,14505,14490,14460,14490,14420,14480,14470,-10,-20,1158,"8,380.79",15586
,20130528,14480,14470,14515,14530,14460,14490,14475,20,5,1966,"14,233.38",15838
,20130529,14490,14475,14475,14535,14475,14480,14515,5,40,1846,"13,397.94",15110
,20130530,14480,14515,14530,14630,14470,14600,14585,85,70,4444,"32,412.07",15516
,20130531,14600,14585,14725,14760,14660,14715,14715,130,130,4724,"34,758.26",16420
,20130603,14715,14715,14805,14805,14740,14790,14770,75,55,1830,"13,515.18",16010
,20130604,14790,14770,14785,14835,14730,14730,14780,-40,10,2500,"18,477.70",15900
,20130605,14730,14780,14805,14845,14780,14830,14805,50,25,1930,"14,290.58",14990
,20130606,14830,14805,14760,14810,14760,14795,14780,-10,-25,1710,"12,639.15",14410
,20130607,14795,14780,14810,14825,14770,14805,14790,25,10,1540,"11,390.65",14250
,20130613,14805,14790,14560,14610,14510,14550,14570,-240,-220,3080,"22,438.40",12220
,20130614,14550,14570,14530,14530,14470,14500,14500,-70,-70,5280,"38,285.75",8330
,20130617,14500,14500,14525,14580,14525,14570,14560,70,60,2530,"18,422.53",8710
zn1307,20130104,15950,15910,16030,16030,15865,15900,15885,-10,-25,220,"1,747.67",944
,20130107,15900,15885,15905,15905,15785,15785,15855,-100,-30,50,396.42,946
,20130108,15785,15855,15810,15810,15725,15725,15765,-130,-90,258,"2,033.76",944
,20130109,15725,15765,15750,15760,15700,15730,15735,-35,-30,20,157.36,958
,20130110,15730,15735,15705,15815,15705,15815,15745,80,10,42,330.75,942
,20130111,15815,15745,15840,15840,15600,15760,15680,15,-65,306,"2,399.27",960
,20130114,15760,15680,15655,15750,15640,15740,15715,60,35,50,392.98,966
,20130115,15740,15715,15735,15735,15530,15550,15580,-165,-135,42,327.25,958
,20130116,15550,15580,15535,15570,15500,15540,15535,-40,-45,74,574.91,944
,20130117,15540,15535,15550,15550,15485,15545,15530,10,-5,10,77.66,952
,20130118,15545,15530,15650,15730,15650,15720,15690,190,160,112,878.65,1020
,20130121,15720,15690,15685,15695,15625,15635,15655,-55,-35,284,"2,223.47",1130
,20130122,15635,15655,15685,15760,15685,15760,15720,105,65,214,"1,682.45",1202
,20130123,15760,15720,15755,15830,15755,15810,15785,90,65,76,599.95,1200
,20130124,15810,15785,15810,15810,15700,15725,15720,-60,-65,66,518.84,1230
,20130125,15725,15720,15835,15900,15835,15900,15865,180,145,80,634.62,1206
,20130128,15900,15865,15865,15925,15845,15890,15870,25,5,216,"1,714.38",1336
,20130129,15890,15870,15870,15965,15870,15940,15915,70,45,50,397.92,1338
,20130130,15940,15915,15950,16190,15945,16115,16095,200,180,130,"1,046.47",1372
,20130131,16115,16095,16200,16345,16170,16300,16275,205,180,408,"3,320.43",1538
,20130201,16300,16275,16310,16310,16140,16250,16205,-25,-70,450,"3,646.88",1514
,20130204,16250,16205,16300,16420,16300,16385,16370,180,165,130,"1,064.14",1530
,20130205,16385,16370,16290,16325,16185,16185,16215,-185,-155,326,"2,643.56",1638
,20130206,16185,16215,16270,16275,16150,16160,16170,-55,-45,56,452.89,1638
,20130207,16160,16170,16105,16145,16035,16035,16065,-135,-105,106,851.71,1640
,20130208,16035,16065,15975,16185,15975,16115,16155,50,90,140,"1,131.18",1700
,20130218,16115,16155,16120,16120,15965,15965,16010,-190,-145,220,"1,761.34",1754
,20130219,15965,16010,15995,16040,15955,15995,16010,-15,0,250,"2,001.67",1862
,20130220,15995,16010,16040,16160,16030,16150,16105,140,95,484,"3,897.64",2110
,20130221,16150,16105,16050,16050,15750,15845,15890,-260,-215,374,"2,971.77",2132
,20130222,15845,15890,15810,15935,15795,15875,15895,-15,5,446,"3,545.14",2252
,20130225,15875,15895,15750,15795,15675,15725,15745,-170,-150,680,"5,353.98",2580
,20130226,15725,15745,15665,15810,15665,15730,15770,-15,25,722,"5,693.53",2958
,20130227,15730,15770,15850,15905,15830,15860,15860,90,90,762,"6,044.29",3192
,20130228,15860,15860,15835,15885,15815,15875,15860,15,0,1062,"8,422.37",3588
,20130301,15875,15860,15715,15735,15605,15630,15645,-230,-215,3306,"25,861.81",5088
,20130304,15630,15645,15525,15625,15450,15495,15520,-150,-125,2738,"21,248.32",5500
,20130305,15495,15520,15500,15605,15495,15590,15565,70,45,2566,"19,974.24",5990
,20130306,15590,15565,15610,15610,15450,15470,15505,-95,-60,5850,"45,362.66",8578
,20130307,15470,15505,15375,15400,15250,15360,15330,-145,-175,8260,"63,316.71",9876
,20130308,15360,15330,15430,15460,15385,15420,15430,90,100,6294,"48,559.00",11160
,20130311,15420,15430,15380,15380,15280,15290,15325,-140,-105,5858,"44,897.83",12594
,20130312,15290,15325,15335,15370,15240,15255,15295,-70,-30,10590,"80,990.35",15794
,20130313,15255,15295,15375,15420,15330,15385,15375,90,80,8038,"61,802.97",16852
,20130314,15385,15375,15320,15385,15265,15385,15310,10,-65,9350,"71,586.22",18884
,20130315,15385,15310,15370,15450,15340,15440,15400,130,90,14130,"108,805.43",23226
,20130318,15440,15400,15220,15235,14685,14945,14980,-455,-420,36184,"271,056.71",33258
,20130319,14945,14980,14990,15010,14885,14925,14960,-55,-20,25938,"194,052.73",41434
,20130320,14925,14960,14880,15030,14850,15010,14985,50,25,29136,"218,345.86",48846
,20130321,15010,14985,15015,15180,15015,15080,15095,95,110,31960,"241,289.77",54810
,20130322,15080,15095,15030,15065,14970,15045,15030,-50,-65,17464,"131,244.23",57884
,20130325,15045,15030,15125,15160,15095,15110,15120,80,90,17100,"129,305.83",62884
,20130326,15110,15120,15060,15100,15000,15055,15050,-65,-70,20116,"151,384.70",66614
,20130327,15055,15050,14935,14970,14870,14875,14920,-175,-130,53776,"401,293.65",89842
,20130328,14875,14920,14930,14955,14840,14845,14895,-75,-25,40672,"302,973.51",94708
,20130329,14845,14895,14760,14885,14735,14800,14815,-95,-80,42100,"311,918.24",96986
,20130401,14800,14815,14775,14775,14645,14660,14695,-155,-120,64440,"473,561.58",107706
,20130402,14660,14695,14745,14770,14695,14760,14730,65,35,52970,"390,214.55",110082
,20130403,14760,14730,14650,14660,14550,14555,14610,-175,-120,89488,"653,744.15",133390
,20130408,14555,14610,14650,14740,14575,14735,14655,125,45,64458,"472,390.36",130496
,20130409,14735,14655,14775,14895,14765,14890,14825,235,170,76790,"569,382.94",137740
,20130410,14890,14825,14925,14950,14840,14875,14890,50,65,51066,"380,196.54",135464
,20130411,14875,14890,14830,14890,14780,14790,14840,-100,-50,52898,"392,519.91",139454
,20130412,14790,14840,14820,14845,14760,14785,14805,-55,-35,45786,"338,961.90",142798
,20130415,14785,14805,14570,14625,14400,14455,14505,-350,-300,114576,"831,223.92",153590
,20130416,14455,14505,14380,14645,14320,14580,14500,75,-5,116146,"842,263.74",155498
,20130417,14580,14500,14675,14680,14550,14570,14605,70,105,67726,"494,701.47",149292
,20130418,14570,14605,14260,14440,14025,14290,14250,-315,-355,216092,"1,540,097.58",144914
,20130419,14290,14250,14410,14600,14350,14575,14475,325,225,109626,"793,425.33",131766
,20130422,14575,14475,14575,14620,14460,14480,14545,5,70,52528,"382,117.26",127974
,20130423,14480,14545,14540,14615,14415,14515,14495,-30,-50,43686,"316,685.87",125410
,20130424,14515,14495,14525,14650,14440,14610,14555,115,60,42934,"312,465.46",120898
,20130425,14610,14555,14665,14740,14640,14690,14670,135,115,31532,"231,330.75",113066
,20130426,14690,14670,14790,14835,14730,14745,14770,75,100,30660,"226,477.92",106672
,20130502,14745,14770,14200,14405,14150,14380,14345,-390,-425,23756,"170,438.32",104674
,20130503,14380,14345,14370,14465,14300,14430,14380,85,35,23802,"171,141.31",99316
,20130506,14430,14380,14685,14750,14580,14625,14620,245,240,16796,"122,812.46",94670
,20130507,14625,14620,14580,14635,14510,14525,14585,-95,-35,10978,"80,067.11",92812
,20130508,14525,14585,14550,14640,14545,14640,14595,55,10,10092,"73,650.39",89558
,20130509,14640,14595,14710,14710,14535,14550,14580,-45,-15,7844,"57,194.72",88504
,20130510,14550,14580,14530,14595,14495,14590,14535,10,-45,7770,"56,477.37",87726
,20130513,14590,14535,14550,14590,14515,14550,14550,15,15,7742,"56,336.83",85786
,20130514,14550,14550,14560,14575,14445,14450,14510,-100,-40,7604,"55,174.31",84024
,20130515,14450,14510,14455,14490,14355,14355,14410,-155,-100,8306,"59,850.03",81490
,20130516,14355,14410,14380,14390,14270,14335,14315,-75,-95,18020,"128,984.59",76810
,20130517,14335,14315,14365,14440,14315,14410,14365,95,50,6580,"47,273.40",74296
,20130520,14410,14365,14385,14390,14300,14360,14335,-5,-30,6856,"49,142.24",71824
,20130521,14360,14335,14385,14475,14375,14420,14420,85,85,7820,"56,388.89",69824
,20130522,14420,14420,14395,14525,14385,14520,14465,100,45,7988,"57,778.20",67566
,20130523,14520,14465,14495,14495,14370,14405,14410,-60,-55,8522,"61,409.39",63860
,20130524,14405,14410,14450,14530,14430,14510,14495,100,85,7146,"51,802.51",59912
,20130527,14510,14495,14455,14505,14430,14490,14475,-5,-20,5552,"40,192.20",57406
,20130528,14490,14475,14500,14535,14450,14490,14485,15,10,6316,"45,744.00",54224
,20130529,14490,14485,14485,14540,14465,14465,14520,-20,35,7104,"51,585.40",50492
,20130530,14465,14520,14550,14630,14500,14620,14580,100,60,10830,"78,955.42",44078
,20130531,14620,14580,14680,14770,14675,14710,14710,130,130,9858,"72,508.97",40442
,20130603,14710,14710,14805,14845,14755,14815,14785,105,75,9114,"67,378.47",35204
,20130604,14815,14785,14845,14865,14715,14750,14780,-35,-5,9614,"71,069.31",30676
,20130605,14750,14780,14840,14865,14800,14860,14820,80,40,6066,"44,955.70",27754
,20130606,14860,14820,14785,14835,14755,14815,14790,-5,-30,4484,"33,161.89",25678
,20130607,14815,14790,14795,14820,14775,14820,14795,30,5,2610,"19,311.77",24434
,20130613,14820,14795,14555,14585,14505,14560,14565,-235,-230,5306,"38,641.33",23160
,20130614,14560,14565,14550,14550,14480,14500,14500,-65,-65,3528,"25,584.92",21610
,20130617,14500,14500,14520,14580,14520,14560,14555,60,55,2650,"19,291.87",21234
,20130618,14560,14555,14560,14560,14490,14530,14525,-25,-30,3256,"23,652.01",19810
,20130619,14530,14525,14505,14530,14490,14530,14505,5,-20,2436,"17,672.85",18554
,20130620,14530,14505,14430,14465,14360,14385,14405,-120,-100,3620,"26,074.69",16668
,20130621,14385,14405,14405,14450,14270,14425,14375,20,-30,2604,"18,718.26",15774
,20130624,14425,14375,14410,14415,14300,14320,14360,-55,-15,2692,"19,329.57",14792
,20130625,14320,14360,14280,14400,14260,14390,14335,30,-25,3230,"23,153.80",13770
,20130626,14390,14335,14400,14445,14320,14325,14375,-10,40,2264,"16,274.39",13888
,20130627,14325,14375,14355,14435,14335,14435,14395,60,20,1562,"11,245.80",13450
,20130628,14435,14395,14385,14450,14360,14420,14410,25,15,2730,"19,673.70",11920
,20130701,14420,14410,14500,14540,14480,14540,14505,130,95,2310,"16,754.35",10830
,20130702,14540,14505,14570,14615,14555,14615,14590,110,85,1400,"10,213.85",9940
,20130703,14615,14590,14635,14635,14580,14630,14600,40,10,1160,"8,468.50",8890
,20130704,14630,14600,14560,14600,14550,14560,14560,-40,-40,560,"4,077.45",8860
,20130705,14560,14560,14515,14520,14490,14490,14505,-70,-55,1770,"12,838.40",7580
,20130708,14490,14505,14450,14470,14435,14450,14455,-55,-50,1460,"10,552.90",7150
,20130709,14450,14455,14540,14570,14530,14565,14550,110,95,550,"4,002.05",6720
,20130710,14565,14550,14505,14560,14485,14550,14510,0,-40,1050,"7,619.30",6140
,20130711,14550,14510,14700,14820,14650,14785,14735,275,225,2060,"15,180.70",5640
,20130712,14785,14735,14730,14730,14550,14550,14610,-185,-125,1080,"7,890.25",5470
,20130715,14550,14610,14650,14680,14650,14670,14665,60,55,2280,"16,723.13",5940
zn1308,20130104,16050,16030,16100,16100,15985,15985,16025,-45,-5,16,128.22,164
,20130107,15985,16025,16100,16100,15860,15860,15930,-165,-95,28,223.09,178
,20130108,15860,15930,15880,15880,15855,15855,15860,-75,-70,14,111.04,178
,20130109,15855,15860,15815,15815,15815,15815,15815,-45,-45,2,15.82,178
,20130110,15815,15815,15875,15875,15855,15855,15865,40,50,14,111.06,184
,20130111,15855,15865,15935,15945,15820,15850,15865,-15,0,20,158.66,192
,20130114,15850,15865,15855,15875,15855,15875,15865,10,0,4,31.73,196
,20130115,15875,15865,15755,15755,15570,15590,15660,-275,-205,120,939.62,262
,20130116,15590,15660,15630,15630,15550,15550,15600,-110,-60,22,171.64,264
,20130117,15550,15600,15615,15620,15615,15620,15615,20,15,8,62.47,264
,20130118,15620,15615,15785,15785,15735,15770,15765,155,150,20,157.67,256
,20130121,15770,15765,15735,15735,15700,15700,15715,-65,-50,4,31.44,254
,20130122,15700,15715,15870,15870,15805,15830,15825,115,110,26,205.73,246
,20130123,15830,15825,15860,15945,15860,15860,15880,35,55,14,111.18,252
,20130124,15860,15880,15800,15880,15800,15880,15835,0,-45,20,158.35,266
,20130125,15880,15835,15960,16005,15960,15990,15985,155,150,10,79.95,270
,20130128,15990,15985,15935,16020,15935,15985,15960,0,-25,136,"1,085.28",292
,20130129,15985,15960,16040,16060,15915,16060,16000,100,40,68,544.01,324
,20130130,16060,16000,16050,16270,16050,16210,16210,210,210,34,275.63,306
,20130131,16210,16210,16385,16385,16300,16360,16325,150,115,208,"1,698.18",382
,20130201,16360,16325,16350,16350,16260,16345,16315,20,-10,44,358.94,372
,20130204,16345,16315,16385,16490,16385,16450,16445,135,130,108,888.16,358
,20130205,16450,16445,16380,16400,16290,16300,16350,-145,-95,76,621.33,338
,20130206,16300,16350,16255,16260,16245,16245,16250,-105,-100,10,81.26,342
,20130207,16245,16250,16145,16175,16130,16160,16150,-90,-100,18,145.39,342
,20130208,16160,16150,16160,16270,16160,16230,16235,80,85,22,178.61,342
,20130218,16230,16235,16125,16185,16080,16100,16130,-135,-105,56,451.71,370
,20130219,16100,16130,16110,16125,16080,16080,16100,-50,-30,18,144.91,372
,20130220,16080,16100,16080,16270,16080,16270,16200,170,100,12,97.23,376
,20130221,16270,16200,16050,16095,15855,15920,15920,-280,-280,196,"1,560.44",476
,20130222,15920,15920,15890,16015,15890,15985,15990,65,70,82,655.64,488
,20130225,15985,15990,15800,15870,15800,15850,15855,-140,-135,30,237.87,474
,20130226,15850,15855,15895,15960,15815,15835,15865,-20,10,266,"2,110.28",660
,20130227,15835,15865,15925,15990,15900,15950,15940,85,75,114,908.66,710
,20130228,15950,15940,15950,15985,15925,15950,15955,10,15,120,957.33,750
,20130301,15950,15955,15850,15850,15720,15740,15795,-215,-160,300,"2,369.67",838
,20130304,15740,15795,15650,15670,15565,15565,15635,-230,-160,240,"1,876.55",940
,20130305,15565,15635,15640,15700,15640,15685,15655,50,20,1250,"9,785.95",1528
,20130306,15685,15655,15675,15690,15555,15605,15615,-50,-40,160,"1,249.57",1594
,20130307,15605,15615,15490,15500,15375,15460,15445,-155,-170,436,"3,367.54",1764
,20130308,15460,15445,15550,15550,15480,15505,15525,60,80,468,"3,633.49",2186
,20130311,15505,15525,15450,15465,15360,15375,15375,-150,-150,708,"5,444.14",2520
,20130312,15375,15375,15390,15415,15300,15300,15355,-75,-20,258,"1,981.20",2530
,20130313,15300,15355,15530,15530,15400,15465,15450,110,95,286,"2,209.57",2552
,20130314,15465,15450,15370,15440,15355,15440,15385,-10,-65,276,"2,123.81",2562
,20130315,15440,15385,15495,15695,15440,15535,15485,150,100,878,"6,798.56",2994
,20130318,15535,15485,15535,15535,14790,15040,15055,-445,-430,1224,"9,213.83",3366
,20130319,15040,15055,15060,15090,14965,15000,15050,-55,-5,3158,"23,771.14",5540
,20130320,15000,15050,14970,15120,14970,15110,15075,60,25,2238,"16,871.44",6516
,20130321,15110,15075,15115,15240,15115,15165,15185,90,110,2818,"21,400.57",7748
,20130322,15165,15185,15150,15150,15060,15125,15115,-60,-70,1014,"7,665.62",8124
,20130325,15125,15115,15230,15235,15180,15200,15205,85,90,1160,"8,821.17",8450
,20130326,15200,15205,15180,15185,15100,15140,15135,-65,-70,606,"4,586.44",8528
,20130327,15140,15135,15045,15050,14945,14945,14990,-190,-145,3312,"24,831.38",10318
,20130328,14945,14990,15000,15020,14905,14910,14960,-80,-30,4440,"33,220.84",12212
,20130329,14910,14960,14750,14930,14750,14850,14880,-110,-80,4174,"31,064.28",12264
,20130401,14850,14880,14845,14845,14705,14730,14760,-150,-120,6352,"46,882.13",14870
,20130402,14730,14760,14800,14850,14770,14830,14810,70,50,9962,"73,776.82",20428
,20130403,14830,14810,14685,14725,14605,14610,14675,-200,-135,23450,"172,092.13",32012
,20130408,14610,14675,14680,14800,14625,14800,14700,125,25,15280,"112,333.26",35950
,20130409,14800,14700,14810,14955,14810,14950,14890,250,190,17074,"127,142.19",40104
,20130410,14950,14890,15010,15010,14905,14935,14945,45,55,13844,"103,482.99",42260
,20130411,14935,14945,14870,14945,14835,14840,14895,-105,-50,14918,"111,110.51",44470
,20130412,14840,14895,14880,14895,14805,14840,14855,-55,-40,19420,"144,243.22",52860
,20130415,14840,14855,14620,14670,14455,14510,14555,-345,-300,53970,"392,833.81",66970
,20130416,14510,14555,14450,14705,14385,14630,14560,75,5,76452,"556,612.33",77832
,20130417,14630,14560,14705,14725,14590,14605,14650,45,90,50716,"371,621.37",80774
,20130418,14605,14650,14260,14480,14060,14325,14275,-325,-375,154486,"1,102,952.13",98776
,20130419,14325,14275,14450,14655,14370,14625,14525,350,250,134636,"978,101.00",99084
,20130422,14625,14525,14620,14670,14500,14515,14580,-10,55,100988,"736,402.73",110036
,20130423,14515,14580,14580,14665,14450,14550,14540,-30,-40,129306,"940,338.38",114246
,20130424,14550,14540,14585,14695,14475,14660,14595,120,55,124596,"909,438.35",113818
,20130425,14660,14595,14745,14780,14675,14735,14715,140,120,103040,"758,167.86",105292
,20130426,14735,14715,14805,14895,14770,14780,14820,65,105,97474,"722,454.82",104454
,20130502,14780,14820,14155,14440,14150,14410,14380,-410,-440,108804,"782,456.79",118682
,20130503,14410,14380,14380,14515,14335,14475,14430,95,50,128168,"924,779.10",137648
,20130506,14475,14430,14750,14800,14620,14670,14665,240,235,104446,"766,107.93",135612
,20130507,14670,14665,14635,14680,14550,14555,14620,-110,-45,87740,"641,425.02",137714
,20130508,14555,14620,14590,14675,14565,14675,14625,55,5,62804,"459,351.88",142324
,20130509,14675,14625,14700,14710,14555,14575,14610,-50,-15,68956,"503,762.42",141338
,20130510,14575,14610,14520,14625,14500,14625,14565,15,-45,74948,"545,838.10",144664
,20130513,14625,14565,14560,14620,14540,14575,14575,10,10,60226,"438,971.25",145576
,20130514,14575,14575,14590,14605,14460,14460,14535,-115,-40,57114,"415,140.79",150546
,20130515,14460,14535,14455,14530,14360,14370,14445,-165,-90,43812,"316,469.64",151966
,20130516,14370,14445,14370,14430,14305,14370,14365,-75,-80,52372,"376,234.05",150434
,20130517,14370,14365,14385,14475,14340,14450,14400,85,35,35284,"254,126.66",148008
,20130520,14450,14400,14420,14445,14330,14375,14360,-25,-40,24962,"179,285.19",144228
,20130521,14375,14360,14495,14495,14400,14455,14450,95,90,29658,"214,283.37",136280
,20130522,14455,14450,14425,14550,14410,14530,14490,80,40,19710,"142,815.74",133362
,20130523,14530,14490,14505,14505,14385,14415,14440,-75,-50,21518,"155,393.15",126838
,20130524,14415,14440,14450,14550,14445,14530,14515,90,75,23578,"171,139.93",120000
,20130527,14530,14515,14470,14530,14445,14515,14495,0,-20,11558,"83,785.48",117892
,20130528,14515,14495,14525,14570,14465,14510,14505,15,10,18560,"134,624.94",116174
,20130529,14510,14505,14510,14565,14480,14490,14530,-15,25,11686,"84,908.80",115228
,20130530,14490,14530,14530,14650,14520,14640,14595,110,65,29064,"212,110.42",110206
,20130531,14640,14595,14740,14790,14685,14720,14730,125,135,20552,"151,392.29",101994
,20130603,14720,14730,14830,14870,14770,14840,14810,110,80,24026,"177,920.70",90016
,20130604,14840,14810,14900,14900,14735,14760,14810,-50,0,26750,"198,098.44",77706
,20130605,14760,14810,14855,14895,14810,14880,14840,70,30,25436,"188,772.23",64778
,20130606,14880,14840,14850,14850,14780,14820,14815,-20,-25,12606,"93,399.95",58814
,20130607,14820,14815,14810,14830,14780,14820,14800,5,-15,8314,"61,539.91",56072
,20130613,14820,14800,14540,14595,14500,14545,14565,-255,-235,12372,"90,115.53",52958
,20130614,14545,14565,14490,14525,14475,14505,14500,-60,-65,7382,"53,521.17",51818
,20130617,14505,14500,14550,14585,14525,14560,14560,60,60,4516,"32,877.26",51400
,20130618,14560,14560,14550,14560,14490,14505,14525,-55,-35,4028,"29,257.65",50632
,20130619,14505,14525,14505,14520,14490,14515,14500,-10,-25,4354,"31,569.26",49108
,20130620,14515,14500,14420,14450,14335,14360,14390,-140,-110,8172,"58,806.04",47856
,20130621,14360,14390,14310,14425,14235,14415,14345,25,-45,6018,"43,173.47",45258
,20130624,14415,14345,14400,14410,14270,14275,14340,-70,-5,5310,"38,075.81",44368
,20130625,14275,14340,14290,14400,14225,14360,14325,20,-15,6540,"46,845.22",42192
,20130626,14360,14325,14450,14455,14300,14305,14350,-20,25,3738,"26,823.00",40550
,20130627,14305,14350,14325,14410,14310,14405,14370,55,20,1984,"14,258.11",39650
,20130628,14405,14370,14340,14410,14330,14395,14390,25,20,3958,"28,483.82",37978
,20130701,14395,14390,14405,14515,14395,14515,14480,125,90,4210,"30,488.28",36440
,20130702,14515,14480,14555,14650,14540,14650,14570,170,90,5294,"38,575.97",33596
,20130703,14650,14570,14635,14635,14570,14620,14595,50,25,3420,"24,961.02",31606
,20130704,14620,14595,14555,14560,14515,14535,14535,-60,-60,2054,"14,930.80",30390
,20130705,14535,14535,14525,14525,14450,14450,14490,-85,-45,2102,"15,233.15",29314
,20130708,14450,14490,14490,14495,14420,14420,14440,-70,-50,2176,"15,712.65",28396
,20130709,14420,14440,14500,14560,14500,14550,14530,110,90,3500,"25,430.11",26318
,20130710,14550,14530,14510,14560,14480,14560,14515,30,-15,2806,"20,367.96",24638
,20130711,14560,14515,14640,14835,14640,14770,14720,255,205,7624,"56,125.59",21026
,20130712,14770,14720,14710,14720,14605,14605,14675,-115,-45,2614,"19,186.19",19858
,20130715,14605,14675,14670,14700,14660,14680,14680,5,5,1914,"14,053.18",18632
,20130716,14680,14680,14675,14740,14635,14735,14670,55,-10,904,"6,631.07",18124
,20130717,14735,14670,14690,14700,14635,14650,14665,-20,-5,1792,"13,143.33",17384
,20130718,14650,14665,14580,14580,14505,14505,14535,-160,-130,3212,"23,344.04",16248
,20130719,14505,14535,14550,14560,14480,14490,14535,-45,0,808,"5,873.70",15878
,20130722,14490,14535,14545,14625,14545,14605,14580,70,45,1272,"9,275.83",15448
,20130723,14605,14580,14630,14645,14605,14620,14625,40,45,1484,"10,852.73",14560
,20130724,14620,14625,14640,14645,14595,14630,14615,5,-10,1352,"9,880.16",14160
,20130725,14630,14615,14630,14695,14605,14680,14655,65,40,2284,"16,738.59",13436
,20130726,14680,14655,14645,14650,14590,14595,14620,-60,-35,1684,"12,310.66",12546
,20130729,14595,14620,14520,14545,14500,14500,14520,-120,-100,1010,"7,333.60",12046
,20130730,14500,14520,14510,14530,14460,14460,14505,-60,-15,1764,"12,797.19",10822
,20130731,14460,14505,14440,14495,14430,14495,14455,-10,-50,1100,"7,951.77",10182
,20130801,14495,14455,14525,14540,14510,14530,14520,75,65,3482,"25,284.96",8420
,20130802,14530,14520,14550,14555,14520,14525,14530,5,10,1840,"13,368.60",7390
,20130805,14525,14530,14570,14610,14570,14610,14590,80,60,1940,"14,154.68",5880
,20130806,14610,14590,14600,14680,14580,14600,14595,10,5,840,"6,131.70",5730
,20130807,14600,14595,14545,14590,14545,14580,14570,-15,-25,1380,"10,055.05",5400
,20130808,14580,14570,14610,14680,14610,14670,14645,100,75,850,"6,225.38",5170
,20130809,14670,14645,14760,14780,14730,14765,14745,120,100,930,"6,857.60",5070
,20130812,14765,14745,14890,14930,14865,14930,14895,185,150,1710,"12,735.70",4320
,20130813,14930,14895,14890,14925,14890,14925,14895,30,0,1030,"7,671.68",4020
,20130814,14925,14895,14820,14920,14780,14860,14825,-35,-70,1250,"9,268.65",3100
,20130815,14860,14825,14900,14915,14890,14895,14900,70,75,900,"6,705.15",3050
zn1309,20130104,16095,16065,16245,16245,16110,16110,16155,45,90,6,48.47,836
,20130107,16110,16155,16135,16135,15975,15975,16045,-180,-110,18,144.44,834
,20130108,15975,16045,16080,16080,15980,15980,16025,-65,-20,22,176.31,836
,20130109,15980,16025,15920,15930,15900,15900,15915,-125,-110,8,63.67,836
,20130110,15900,15915,15900,15970,15900,15970,15930,55,15,20,159.34,826
,20130111,15970,15930,16075,16075,15965,15965,16030,35,100,10,80.16,826
,20130114,15965,16030,15890,15995,15845,15930,15910,-100,-120,22,175.02,836
,20130115,15930,15910,15825,15870,15635,15715,15735,-195,-175,50,393.47,828
,20130116,15715,15735,15730,15730,15680,15700,15705,-35,-30,44,345.51,822
,20130117,15700,15705,15695,15720,15680,15680,15695,-25,-10,20,156.98,820
,20130118,15680,15695,15810,15810,15810,15810,15810,115,115,4,31.62,820
,20130121,15810,15810,15920,15920,15805,15805,15865,-5,55,16,126.95,824
,20130122,15805,15865,15770,15970,15770,15970,15865,105,0,12,95.19,824
,20130123,15970,15865,16060,16060,15940,15975,15975,110,110,20,159.77,824
,20130124,15975,15975,15925,15970,15880,15955,15920,-20,-55,42,334.39,850
,20130125,15955,15920,16120,16120,16025,16080,16075,160,155,72,578.73,878
,20130128,16080,16075,16075,16085,16055,16080,16070,5,-5,22,176.81,884
,20130129,16080,16070,16090,16100,16010,16100,16040,30,-30,28,224.59,864
,20130130,16100,16040,16140,16335,16140,16290,16275,250,235,36,293.01,876
,20130131,16290,16275,16380,16505,16340,16475,16405,200,130,90,738.39,906
,20130201,16475,16405,16425,16450,16350,16420,16390,15,-15,54,442.66,890
,20130204,16420,16390,16590,16600,16495,16585,16550,195,160,114,943.48,982
,20130205,16585,16550,16520,16520,16370,16370,16430,-180,-120,60,492.93,986
,20130206,16370,16430,16435,16435,16290,16290,16365,-140,-65,16,130.93,986
,20130207,16290,16365,16260,16295,16230,16245,16260,-120,-105,38,308.94,982
,20130208,16245,16260,16295,16365,16295,16335,16330,75,70,50,408.36,1018
,20130218,16335,16330,16235,16315,16140,16150,16190,-180,-140,86,696.25,972
,20130219,16150,16190,16190,16230,16160,16220,16205,30,15,36,291.77,994
,20130220,16220,16205,16240,16380,16220,16380,16335,175,130,406,"3,316.17",1300
,20130221,16380,16335,16105,16190,15950,16050,16075,-285,-260,854,"6,865.80",1212
,20130222,16050,16075,16050,16150,16030,16080,16090,5,15,152,"1,222.86",1218
,20130225,16080,16090,16035,16035,15900,15900,15940,-190,-150,160,"1,275.24",1222
,20130226,15900,15940,15950,15980,15890,15890,15940,-50,0,202,"1,610.12",1212
,20130227,15890,15940,16000,16065,15975,16020,16030,80,90,228,"1,827.87",1274
,20130228,16020,16030,15995,16090,15980,16020,16005,-10,-25,338,"2,705.48",1440
,20130301,16020,16005,15940,15940,15815,15835,15850,-170,-155,96,761.01,1418
,20130304,15835,15850,15800,15800,15670,15690,15715,-160,-135,162,"1,273.11",1426
,20130305,15690,15715,15810,15810,15730,15800,15770,85,55,274,"2,160.84",1526
,20130306,15800,15770,15805,15805,15645,15685,15700,-85,-70,426,"3,344.20",1638
,20130307,15685,15700,15580,15580,15465,15540,15535,-160,-165,760,"5,904.52",1968
,20130308,15540,15535,15620,15690,15550,15595,15595,60,60,170,"1,325.63",1974
,20130311,15595,15595,15530,15530,15440,15460,15475,-135,-120,188,"1,454.84",2068
,20130312,15460,15475,15445,15495,15390,15400,15455,-75,-20,614,"4,745.53",2224
,20130313,15400,15455,15495,15585,15470,15525,15520,70,65,230,"1,784.98",2312
,20130314,15525,15520,15435,15515,15430,15500,15460,-20,-60,76,587.5,2314
,20130315,15500,15460,15505,15630,15495,15630,15570,170,110,684,"5,325.36",2562
,20130318,15630,15570,15270,15270,14870,15130,15145,-440,-425,656,"4,969.18",2702
,20130319,15130,15145,15165,15180,15050,15065,15155,-80,10,1780,"13,490.73",3952
,20130320,15065,15155,15060,15200,15060,15140,15170,-15,15,222,"1,684.23",4048
,20130321,15140,15170,15210,15320,15195,15265,15270,95,100,172,"1,313.41",4072
,20130322,15265,15270,15230,15230,15115,15195,15185,-75,-85,92,698.67,4072
,20130325,15195,15185,15325,15325,15270,15290,15295,105,110,102,780.16,4068
,20130326,15290,15295,15240,15240,15180,15220,15205,-75,-90,256,"1,946.28",4140
,20130327,15220,15205,15085,15125,15025,15025,15055,-180,-150,362,"2,725.31",4362
,20130328,15025,15055,15090,15090,14970,14975,15035,-80,-20,804,"6,045.52",4776
,20130329,14975,15035,14900,15000,14885,14915,14945,-120,-90,246,"1,838.36",4850
,20130401,14915,14945,14855,14880,14780,14820,14835,-125,-110,1778,"13,189.22",5686
,20130402,14820,14835,14840,14915,14840,14910,14885,75,50,680,"5,061.71",5904
,20130403,14910,14885,14850,14850,14670,14675,14755,-210,-130,2292,"16,913.45",7068
,20130408,14675,14755,14730,14875,14705,14875,14765,120,10,1498,"11,062.29",7700
,20130409,14875,14765,14930,15030,14905,15030,14975,265,210,2228,"16,687.43",8282
,20130410,15030,14975,15070,15070,14975,15020,15020,45,45,1108,"8,322.96",8326
,20130411,15020,15020,14960,15010,14910,14910,14960,-110,-60,420,"3,141.86",8414
,20130412,14910,14960,14970,14970,14865,14890,14900,-70,-60,1578,"11,759.77",9058
,20130415,14890,14900,14760,14760,14520,14570,14630,-330,-270,4718,"34,521.73",11520
,20130416,14570,14630,14455,14775,14450,14710,14645,80,15,3270,"23,950.58",12308
,20130417,14710,14645,14800,14800,14660,14670,14720,25,75,3948,"29,064.09",13012
,20130418,14670,14720,14220,14540,14130,14385,14345,-335,-375,18326,"131,476.79",17118
,20130419,14385,14345,14595,14720,14450,14695,14590,350,245,12662,"92,398.35",17934
,20130422,14695,14590,14675,14730,14560,14585,14640,-5,50,7304,"53,481.25",19730
,20130423,14585,14640,14635,14720,14510,14610,14585,-30,-55,11476,"83,703.02",21518
,20130424,14610,14585,14625,14765,14505,14735,14650,150,65,18352,"134,465.41",27320
,20130425,14735,14650,14780,14835,14745,14790,14775,140,125,13276,"98,097.70",27738
,20130426,14790,14775,14840,14955,14835,14845,14885,70,110,17788,"132,409.66",30824
,20130502,14845,14885,14140,14485,14140,14475,14410,-410,-475,27660,"199,318.11",36990
,20130503,14475,14410,14435,14555,14380,14515,14475,105,65,39452,"285,594.58",47860
,20130506,14515,14475,14800,14845,14655,14730,14715,255,240,29876,"219,829.62",52298
,20130507,14730,14715,14710,14740,14600,14600,14675,-115,-40,22072,"161,988.30",55020
,20130508,14600,14675,14615,14735,14610,14730,14675,55,0,21980,"161,301.46",62040
,20130509,14730,14675,14745,14745,14600,14625,14660,-50,-15,23326,"170,985.64",64904
,20130510,14625,14660,14590,14665,14550,14665,14605,5,-55,34240,"250,047.06",68598
,20130513,14665,14605,14615,14650,14580,14605,14610,0,5,29862,"218,177.21",74158
,20130514,14605,14610,14615,14645,14490,14510,14560,-100,-50,37784,"275,142.94",83842
,20130515,14510,14560,14510,14555,14410,14415,14470,-145,-90,35244,"255,072.89",92834
,20130516,14415,14470,14385,14465,14345,14400,14395,-70,-75,62248,"448,112.52",112018
,20130517,14400,14395,14420,14510,14370,14480,14445,85,50,68002,"491,264.95",128150
,20130520,14480,14445,14460,14470,14355,14400,14395,-45,-50,84796,"610,485.54",139112
,20130521,14400,14395,14510,14530,14435,14490,14485,95,90,77112,"558,644.70",140158
,20130522,14490,14485,14480,14595,14450,14575,14525,90,40,64490,"468,491.14",147674
,20130523,14575,14525,14530,14545,14415,14445,14470,-80,-55,81354,"588,729.68",151760
,20130524,14445,14470,14500,14595,14480,14570,14550,100,80,67682,"492,501.49",151028
,20130527,14570,14550,14500,14575,14480,14550,14535,0,-15,52216,"379,537.50",153106
,20130528,14550,14535,14585,14620,14495,14550,14545,15,10,63078,"458,799.38",155006
,20130529,14550,14545,14565,14620,14510,14520,14575,-25,30,61668,"449,467.27",159030
,20130530,14520,14575,14575,14705,14560,14690,14645,115,70,149140,"1,092,220.50",170336
,20130531,14690,14645,14780,14845,14730,14760,14775,115,130,88426,"653,413.79",170328
,20130603,14760,14775,14890,14915,14810,14880,14855,105,80,75282,"559,200.83",168202
,20130604,14880,14855,14920,14940,14770,14790,14850,-65,-5,92266,"685,144.97",144532
,20130605,14790,14850,14870,14930,14840,14915,14875,65,25,72952,"542,759.03",133228
,20130606,14915,14875,14865,14885,14810,14845,14840,-30,-35,62118,"461,039.15",123858
,20130607,14845,14840,14845,14855,14805,14840,14830,0,-10,41182,"305,451.04",119450
,20130613,14840,14830,14540,14620,14530,14570,14580,-260,-250,62072,"452,537.25",117080
,20130614,14570,14580,14515,14550,14480,14525,14510,-55,-70,43296,"314,192.23",121444
,20130617,14525,14510,14530,14610,14530,14580,14575,70,65,24258,"176,834.73",120498
,20130618,14580,14575,14565,14580,14500,14515,14540,-60,-35,26264,"190,991.35",119174
,20130619,14515,14540,14540,14540,14495,14530,14515,-10,-25,16104,"116,900.21",116668
,20130620,14530,14515,14465,14480,14340,14370,14385,-145,-130,32664,"234,969.92",111996
,20130621,14370,14385,14310,14440,14240,14430,14350,45,-35,29178,"209,423.40",108534
,20130624,14430,14350,14470,14470,14260,14285,14350,-65,0,28212,"202,432.55",106542
,20130625,14285,14350,14295,14410,14220,14370,14325,20,-25,21810,"156,268.12",105074
,20130626,14370,14325,14440,14465,14295,14315,14360,-10,35,25144,"180,542.50",98250
,20130627,14315,14360,14340,14410,14315,14410,14380,50,20,11920,"85,709.04",96288
,20130628,14410,14380,14375,14425,14330,14410,14385,30,5,10048,"72,272.90",94650
,20130701,14410,14385,14410,14530,14390,14510,14485,125,100,14698,"106,459.01",92710
,20130702,14510,14485,14550,14620,14535,14620,14575,135,90,19198,"139,928.14",84982
,20130703,14620,14575,14610,14645,14565,14630,14595,55,20,11790,"86,054.61",81144
,20130704,14630,14595,14575,14575,14510,14530,14535,-65,-60,6458,"46,938.33",81686
,20130705,14530,14535,14510,14530,14470,14470,14485,-65,-50,8452,"61,214.09",79884
,20130708,14470,14485,14470,14470,14410,14415,14425,-70,-60,11666,"84,169.63",76776
,20130709,14415,14425,14500,14555,14500,14535,14530,110,105,6966,"50,613.25",72866
,20130710,14535,14530,14500,14560,14470,14550,14505,20,-25,4968,"36,039.96",71464
,20130711,14550,14505,14685,14830,14665,14765,14735,260,230,27082,"199,539.74",58940
,20130712,14765,14735,14745,14750,14630,14655,14680,-80,-55,7452,"54,704.34",56030
,20130715,14655,14680,14680,14700,14650,14670,14680,-10,0,4654,"34,164.64",54638
,20130716,14670,14680,14640,14720,14640,14700,14665,20,-15,2900,"21,270.55",53264
,20130717,14700,14665,14715,14715,14625,14625,14660,-40,-5,3940,"28,882.39",51342
,20130718,14625,14660,14570,14570,14505,14520,14525,-140,-135,3144,"22,841.02",50426
,20130719,14520,14525,14550,14580,14500,14500,14545,-25,20,4620,"33,603.20",47800
,20130722,14500,14545,14550,14650,14550,14630,14600,85,55,2916,"21,292.11",46576
,20130723,14630,14600,14645,14655,14610,14630,14630,30,30,3610,"26,413.53",45620
,20130724,14630,14630,14655,14665,14590,14640,14630,10,0,4030,"29,485.99",42810
,20130725,14640,14630,14580,14705,14580,14680,14660,50,30,5684,"41,673.89",40396
,20130726,14680,14660,14655,14655,14600,14610,14625,-50,-35,2120,"15,503.73",39350
,20130729,14610,14625,14520,14550,14505,14515,14520,-110,-105,1760,"12,781.36",38462
,20130730,14515,14520,14510,14525,14460,14460,14505,-60,-15,4242,"30,771.32",35822
,20130731,14460,14505,14415,14490,14410,14485,14455,-20,-50,3474,"25,110.37",34914
,20130801,14485,14455,14500,14550,14495,14525,14515,70,60,3204,"23,259.25",33648
,20130802,14525,14515,14535,14545,14515,14530,14525,15,10,1028,"7,466.15",33050
,20130805,14530,14525,14545,14630,14545,14605,14585,80,60,2242,"16,351.39",31600
,20130806,14605,14585,14555,14600,14555,14595,14585,10,0,2940,"21,444.34",30964
,20130807,14595,14585,14535,14560,14525,14550,14550,-35,-35,1136,"8,264.78",30648
,20130808,14550,14550,14565,14665,14565,14655,14630,105,80,5474,"40,044.56",28670
,20130809,14655,14630,14725,14755,14705,14745,14730,115,100,4084,"30,087.58",26868
,20130812,14745,14730,14820,14945,14820,14930,14895,200,165,12646,"94,183.84",19452
,20130813,14930,14895,14900,14925,14865,14915,14890,20,-5,4984,"37,114.69",17816
,20130814,14915,14890,14870,14900,14825,14860,14855,-30,-35,4046,"30,054.42",16250
,20130815,14860,14855,14910,14950,14890,14930,14920,75,65,2832,"21,133.59",14974
,20130816,14930,14920,14980,15140,14980,15120,15070,200,150,5304,"39,977.78",13080
,20130819,15120,15070,15155,15180,15100,15130,15135,60,65,2100,"15,895.52",12776
,20130820,15130,15135,15090,15105,14975,14990,15035,-145,-100,3212,"24,148.11",11386
,20130821,14990,15035,15010,15060,14975,15040,15030,5,-5,776,"5,832.13",11182
,20130822,15040,15030,14910,15075,14910,15075,15010,45,-20,786,"5,899.52",10822
,20130823,15075,15010,15080,15100,15000,15030,15055,20,45,2340,"17,618.55",10522
,20130826,15030,15055,15160,15190,15110,15120,15130,65,75,1444,"10,924.73",10292
,20130827,15120,15130,15110,15145,15055,15080,15075,-50,-55,1838,"13,857.40",9712
,20130828,15080,15075,15050,15120,14995,14995,15075,-80,0,1736,"13,088.22",8680
,20130829,14995,15075,14975,14975,14890,14925,14930,-150,-145,2218,"16,562.10",7640
,20130830,14925,14930,14880,14890,14800,14810,14860,-120,-70,1826,"13,569.15",6730
,20130902,14810,14860,14825,14900,14825,14900,14860,40,0,900,"6,687.65",6030
,20130903,14900,14860,14855,14870,14835,14845,14850,-15,-10,1200,"8,910.70",5010
,20130904,14845,14850,14830,14830,14760,14785,14790,-65,-60,820,"6,065.60",4280
,20130905,14785,14790,14730,14730,14690,14690,14700,-100,-90,920,"6,762.45",3640
,20130906,14690,14700,14705,14720,14705,14710,14715,10,15,500,"3,678.83",3470
,20130909,14710,14715,14800,14835,14790,14830,14825,115,110,270,"2,001.50",3260
,20130910,14830,14825,14725,14745,14710,14745,14720,-80,-105,480,"3,533.60",3050
,20130911,14745,14720,14745,14745,14715,14720,14725,0,5,620,"4,565.00",2790
,20130912,14720,14725,14660,14700,14660,14700,14675,-25,-50,450,"3,302.75",2480
,20130913,14700,14675,14710,14720,14700,14720,14715,45,40,460,"3,384.70",2320
,20130916,14720,14715,14785,14835,14600,14600,14760,-115,45,620,"4,576.25",2210
zn1310,20130104,16135,16135,,,,16135,16135,0,0,0,0,78
,20130107,16135,16135,16140,16140,16095,16095,16125,-40,-10,8,64.51,80
,20130108,16095,16125,16140,16140,16140,16140,16140,15,15,4,32.28,76
,20130109,16140,16140,16100,16100,16000,16010,16025,-130,-115,8,64.11,74
,20130110,16010,16025,15945,16030,15945,16025,16005,0,-20,10,80.04,80
,20130111,16025,16005,16075,16075,16075,16075,16075,70,70,2,16.08,82
,20130114,16075,16075,,,,16075,16075,0,0,0,0,82
,20130115,16075,16075,,,,15810,15810,-265,-265,0,0,82
,20130116,15810,15810,15810,15810,15810,15810,15810,0,0,2,15.81,82
,20130117,15810,15810,15800,15800,15800,15800,15800,-10,-10,2,15.8,84
,20130118,15800,15800,,,,15900,15900,100,100,0,0,84
,20130121,15900,15900,15955,15955,15930,15930,15945,30,45,6,47.84,88
,20130122,15930,15945,15970,15970,15970,15970,15970,25,25,2,15.97,88
,20130123,15970,15970,16020,16020,16020,16020,16020,50,50,2,16.02,88
,20130124,16020,16020,,,,16020,16020,0,0,0,0,88
,20130125,16020,16020,16105,16175,16105,16140,16155,120,135,24,193.86,94
,20130128,16140,16155,16130,16185,16130,16185,16155,30,0,4,32.32,94
,20130129,16185,16155,,,,16155,16155,0,0,0,0,94
,20130130,16155,16155,16220,16350,16220,16350,16285,195,130,6,48.87,96
,20130131,16350,16285,16560,16560,16445,16510,16495,225,210,12,98.97,96
,20130201,16510,16495,16535,16535,16410,16410,16450,-85,-45,14,115.16,100
,20130204,16410,16450,16680,16680,16680,16680,16680,230,230,2,16.68,98
,20130205,16680,16680,,,,16520,16520,-160,-160,0,0,98
,20130206,16520,16520,,,,16470,16470,-50,-50,0,0,98
,20130207,16470,16470,,,,16365,16365,-105,-105,0,0,98
,20130208,16365,16365,,,,16365,16365,0,0,0,0,98
,20130218,16365,16365,16265,16265,16265,16265,16265,-100,-100,2,16.27,100
,20130219,16265,16265,,,,16280,16280,15,15,0,0,100
,20130220,16280,16280,16370,16380,16370,16380,16375,100,95,4,32.75,100
,20130221,16380,16375,16100,16195,16020,16020,16080,-355,-295,34,273.44,92
,20130222,16020,16080,16180,16200,16180,16200,16185,120,105,8,64.75,90
,20130225,16200,16185,16020,16020,16020,16020,16020,-165,-165,20,160.2,110
,20130226,16020,16020,16015,16015,16015,16015,16015,-5,-5,2,16.02,110
,20130227,16015,16015,16125,16200,16105,16125,16155,110,140,74,597.83,144
,20130228,16125,16155,16125,16150,16085,16130,16115,-25,-40,22,177.32,138
,20130301,16130,16115,15995,15995,15880,15895,15930,-220,-185,10,79.66,134
,20130304,15895,15930,15790,15880,15755,15755,15775,-175,-155,18,142.01,146
,20130305,15755,15775,15885,15885,15885,15885,15885,110,110,2,15.89,146
,20130306,15885,15885,15780,15780,15760,15760,15760,-125,-125,12,94.58,142
,20130307,15760,15760,15740,15740,15540,15655,15630,-105,-130,26,203.25,148
,20130308,15655,15630,15650,15680,15650,15680,15655,50,25,40,313.11,154
,20130311,15680,15655,15550,15650,15510,15510,15555,-145,-100,54,420.06,186
,20130312,15510,15555,15535,15550,15500,15500,15525,-55,-30,24,186.32,194
,20130313,15500,15525,15595,15630,15585,15600,15595,75,70,14,109.19,196
,20130314,15600,15595,15540,15550,15485,15550,15525,-45,-70,10,77.63,200
,20130315,15550,15525,15545,15655,15545,15630,15625,105,100,28,218.78,194
,20130318,15630,15625,15500,15500,15040,15200,15245,-425,-380,106,808.03,214
,20130319,15200,15245,15230,15250,15130,15130,15210,-115,-35,82,623.77,288
,20130320,15130,15210,15205,15255,15185,15255,15205,45,-5,16,121.66,282
,20130321,15255,15205,15250,15375,15250,15345,15345,140,140,20,153.45,284
,20130322,15345,15345,15250,15250,15250,15250,15250,-95,-95,2,15.25,286
,20130325,15250,15250,15355,15385,15350,15385,15365,135,115,16,122.94,292
,20130326,15385,15365,15265,15330,15265,15280,15290,-85,-75,32,244.68,310
,20130327,15280,15290,15150,15160,15120,15120,15135,-170,-155,30,227.08,334
,20130328,15120,15135,15150,15180,15040,15085,15110,-50,-25,242,"1,828.67",490
,20130329,15085,15110,15050,15065,14995,14995,15020,-115,-90,38,285.4,498
,20130401,14995,15020,14915,14945,14855,14885,14890,-135,-130,106,789.28,524
,20130402,14885,14890,15015,15015,14930,14970,14960,80,70,24,179.53,532
,20130403,14970,14960,14825,14860,14750,14750,14810,-210,-150,46,340.72,564
,20130408,14750,14810,14750,14910,14750,14910,14830,100,20,188,"1,394.32",712
,20130409,14910,14830,15000,15080,15000,15080,15030,250,200,48,360.72,728
,20130410,15080,15030,15100,15115,15050,15075,15060,45,30,440,"3,313.84",922
,20130411,15075,15060,15070,15070,15010,15010,15010,-50,-50,206,"1,546.16",824
,20130412,15010,15010,15020,15020,14940,14940,14970,-70,-40,244,"1,826.66",846
,20130415,14940,14970,14775,14775,14600,14630,14665,-340,-305,192,"1,407.91",938
,20130416,14630,14665,14580,14800,14580,14780,14670,115,5,286,"2,098.41",982
,20130417,14780,14670,14830,14840,14710,14760,14730,90,60,136,"1,001.78",1046
,20130418,14760,14730,14280,14605,14165,14460,14455,-270,-275,1690,"12,218.09",1998
,20130419,14460,14455,14545,14770,14500,14745,14645,290,190,680,"4,980.73",2122
,20130422,14745,14645,14765,14800,14640,14640,14715,-5,70,306,"2,252.01",2188
,20130423,14640,14715,14700,14765,14575,14710,14605,-5,-110,1010,"7,377.77",2858
,20130424,14710,14605,14700,14800,14570,14785,14685,180,80,1480,"10,869.40",2466
,20130425,14785,14685,14840,14880,14800,14830,14835,145,150,520,"3,858.20",2502
,20130426,14830,14835,14965,15020,14915,14920,14985,85,150,3174,"23,787.80",4346
,20130502,14920,14985,14430,14550,14380,14525,14495,-460,-490,5800,"42,043.14",5298
,20130503,14525,14495,14500,14595,14445,14555,14515,60,20,4800,"34,845.19",6474
,20130506,14555,14515,14985,14985,14705,14790,14760,275,245,6192,"45,699.00",9208
,20130507,14790,14760,14725,14795,14660,14670,14725,-90,-35,1764,"12,990.16",9776
,20130508,14670,14725,14700,14760,14690,14755,14715,30,-10,2442,"17,971.23",10746
,20130509,14755,14715,14760,14760,14635,14670,14690,-45,-25,1982,"14,561.13",11436
,20130510,14670,14690,14625,14710,14600,14700,14635,10,-55,3006,"22,002.41",12406
,20130513,14700,14635,14705,14705,14615,14645,14650,10,15,2752,"20,162.56",13106
,20130514,14645,14650,14695,14695,14530,14540,14615,-110,-35,3620,"26,453.72",14634
,20130515,14540,14615,14555,14570,14430,14430,14515,-185,-100,2578,"18,715.99",15588
,20130516,14430,14515,14450,14495,14360,14435,14430,-80,-85,4954,"35,749.67",17580
,20130517,14435,14430,14450,14535,14405,14505,14490,75,60,4500,"32,607.58",19492
,20130520,14505,14490,14495,14530,14385,14465,14430,-25,-60,7844,"56,601.99",21204
,20130521,14465,14430,14535,14560,14475,14535,14520,105,90,6552,"47,583.08",22244
,20130522,14535,14520,14515,14635,14490,14615,14565,95,45,7600,"55,360.08",24800
,20130523,14615,14565,14600,14600,14460,14490,14500,-75,-65,10348,"75,048.14",28796
,20130524,14490,14500,14530,14625,14530,14615,14585,115,85,7568,"55,199.06",28808
,20130527,14615,14585,14575,14615,14520,14590,14580,5,-5,7920,"57,749.00",32174
,20130528,14590,14580,14610,14650,14550,14595,14585,15,5,8314,"60,643.38",35908
,20130529,14595,14585,14620,14645,14550,14565,14615,-20,30,7774,"56,812.65",37094
,20130530,14565,14615,14610,14735,14600,14725,14685,110,70,18266,"134,148.80",41858
,20130531,14725,14685,14800,14880,14775,14800,14820,115,135,23684,"175,499.31",49320
,20130603,14800,14820,14950,14950,14840,14925,14890,105,70,14786,"110,106.04",51470
,20130604,14925,14890,14930,14975,14795,14835,14870,-55,-20,25800,"191,832.71",53946
,20130605,14835,14870,14900,14955,14860,14940,14910,70,40,25566,"190,600.05",57460
,20130606,14940,14910,14880,14920,14835,14865,14870,-45,-40,26338,"195,869.20",58724
,20130607,14865,14870,14870,14885,14835,14865,14860,-5,-10,20136,"149,640.26",60480
,20130613,14865,14860,14560,14650,14550,14585,14615,-275,-245,48672,"355,731.55",74228
,20130614,14585,14615,14560,14575,14505,14545,14540,-70,-75,39700,"288,685.22",86680
,20130617,14545,14540,14580,14640,14565,14615,14610,75,70,24876,"181,757.40",90822
,20130618,14615,14610,14600,14615,14515,14525,14565,-85,-45,38184,"278,166.94",99526
,20130619,14525,14565,14540,14560,14530,14560,14540,-5,-25,30970,"225,218.80",107372
,20130620,14560,14540,14480,14480,14355,14380,14410,-160,-130,68656,"494,773.88",124756
,20130621,14380,14410,14315,14470,14255,14440,14370,30,-40,88146,"633,525.26",139202
,20130624,14440,14370,14435,14440,14260,14280,14350,-90,-20,72218,"518,309.27",145914
,20130625,14280,14350,14310,14420,14225,14380,14335,30,-15,80096,"574,177.28",147622
,20130626,14380,14335,14435,14500,14305,14315,14370,-20,35,77182,"554,691.38",158128
,20130627,14315,14370,14370,14440,14330,14420,14395,50,25,53890,"387,966.22",159386
,20130628,14420,14395,14380,14445,14350,14420,14405,25,10,48820,"351,668.77",160580
,20130701,14420,14405,14420,14545,14405,14540,14505,135,100,54638,"396,274.30",160008
,20130702,14540,14505,14580,14645,14550,14640,14595,135,90,60204,"439,341.02",161420
,20130703,14640,14595,14600,14680,14580,14645,14615,50,20,51176,"374,038.79",157254
,20130704,14645,14615,14570,14595,14515,14550,14550,-65,-65,45732,"332,739.76",154640
,20130705,14550,14550,14520,14550,14470,14480,14495,-70,-55,46480,"336,916.09",156588
,20130708,14480,14495,14475,14480,14410,14425,14435,-70,-60,47586,"343,467.67",160452
,20130709,14425,14435,14500,14560,14500,14530,14535,95,100,56358,"409,609.02",155806
,20130710,14530,14535,14515,14585,14470,14560,14510,25,-25,50226,"364,505.93",156092
,20130711,14560,14510,14705,14880,14670,14785,14755,275,245,103444,"763,271.72",151646
,20130712,14785,14755,14765,14765,14620,14660,14690,-95,-65,45982,"337,801.49",154232
,20130715,14660,14690,14680,14720,14660,14690,14695,0,5,33194,"243,911.78",151056
,20130716,14690,14695,14680,14730,14650,14725,14680,30,-15,27710,"203,423.87",148788
,20130717,14725,14680,14715,14720,14620,14635,14665,-45,-15,39434,"289,213.83",144658
,20130718,14635,14665,14555,14575,14510,14520,14535,-145,-130,36368,"264,327.62",140950
,20130719,14520,14535,14535,14580,14490,14500,14545,-35,10,25742,"187,209.13",138130
,20130722,14500,14545,14560,14630,14550,14625,14600,80,55,33736,"246,299.85",127842
,20130723,14625,14600,14630,14665,14605,14620,14635,20,35,19172,"140,317.30",125502
,20130724,14620,14635,14655,14670,14590,14640,14625,5,-10,17730,"129,667.81",122334
,20130725,14640,14625,14645,14710,14600,14690,14665,65,40,20844,"152,849.67",119532
,20130726,14690,14665,14650,14670,14595,14605,14625,-60,-40,12876,"94,183.40",115566
,20130729,14605,14625,14520,14555,14495,14520,14525,-105,-100,22506,"163,458.90",112420
,20130730,14520,14525,14520,14535,14465,14470,14505,-55,-20,15962,"115,768.86",109170
,20130731,14470,14505,14435,14490,14410,14470,14455,-35,-50,15324,"110,788.81",106794
,20130801,14470,14455,14500,14550,14495,14515,14520,60,65,10794,"78,380.07",105080
,20130802,14515,14520,14520,14560,14505,14525,14520,5,0,4798,"34,844.41",104116
,20130805,14525,14520,14590,14610,14545,14610,14580,90,60,6950,"50,680.85",102464
,20130806,14610,14580,14580,14600,14565,14595,14580,15,0,4438,"32,354.38",101346
,20130807,14595,14580,14550,14570,14525,14560,14545,-20,-35,4076,"29,648.94",100248
,20130808,14560,14545,14550,14655,14550,14645,14615,100,70,14196,"103,756.34",94446
,20130809,14645,14615,14725,14755,14690,14740,14725,125,110,13760,"101,325.20",87676
,20130812,14740,14725,14915,14945,14875,14930,14895,205,170,29662,"220,963.74",70948
,20130813,14930,14895,14930,14935,14870,14900,14900,5,5,12890,"96,033.10",64482
,20130814,14900,14900,14850,14910,14835,14845,14855,-55,-45,10576,"78,576.39",60820
,20130815,14845,14855,14935,14945,14890,14915,14925,60,70,14502,"108,246.79",54900
,20130816,14915,14925,14975,15165,14975,15140,15090,215,165,24814,"187,257.79",41962
,20130819,15140,15090,15195,15255,15130,15175,15180,85,90,13454,"102,132.92",36238
,20130820,15175,15180,15155,15160,14970,14990,15060,-190,-120,7408,"55,796.45",34500
,20130821,14990,15060,15040,15085,15025,15060,15055,0,-5,4210,"31,693.55",32940
,20130822,15060,15055,14990,15100,14915,15100,15015,45,-40,5428,"40,755.58",31348
,20130823,15100,15015,15065,15125,15000,15040,15055,25,40,5486,"41,302.28",29456
,20130826,15040,15055,15195,15200,15100,15130,15140,75,85,6030,"45,659.79",28032
,20130827,15130,15140,15110,15120,15055,15060,15070,-80,-70,4648,"35,028.57",26588
,20130828,15060,15070,15050,15130,14980,15010,15055,-60,-15,2602,"19,591.94",25802
,20130829,15010,15055,14960,14960,14900,14920,14930,-135,-125,6230,"46,510.72",22622
,20130830,14920,14930,14850,14885,14810,14835,14850,-95,-80,4398,"32,658.00",20802
,20130902,14835,14850,14800,14920,14775,14890,14875,40,25,2634,"19,593.36",20006
,20130903,14890,14875,14865,14880,14835,14850,14855,-25,-20,2150,"15,969.34",19784
,20130904,14850,14855,14845,14845,14760,14800,14810,-55,-45,982,"7,273.35",19354
,20130905,14800,14810,14710,14740,14665,14685,14695,-125,-115,1852,"13,610.16",19006
,20130906,14685,14695,14695,14750,14660,14730,14715,35,20,1648,"12,128.57",18328
,20130909,14730,14715,14795,14845,14780,14840,14815,125,100,1644,"12,178.34",17468
,20130910,14840,14815,14760,14760,14715,14740,14730,-75,-85,1378,"10,152.13",16830
,20130911,14740,14730,14720,14755,14715,14735,14735,5,5,1320,"9,726.83",16394
,20130912,14735,14735,14710,14710,14655,14680,14690,-55,-45,2718,"19,969.28",15516
,20130913,14680,14690,14705,14790,14695,14740,14725,50,35,3336,"24,567.34",15276
,20130916,14740,14725,14765,14765,14650,14660,14675,-65,-50,2538,"18,623.12",13674
,20130917,14660,14675,14630,14675,14610,14675,14635,0,-40,1962,"14,358.31",12202
,20130918,14675,14635,14615,14695,14615,14685,14640,50,5,1590,"11,640.64",11594
,20130923,14685,14640,14610,14720,14605,14720,14665,80,25,3986,"29,227.63",9010
,20130924,14720,14665,14745,14770,14720,14730,14745,65,80,2448,"18,050.91",7310
,20130925,14730,14745,14740,14770,14725,14750,14745,5,0,1036,"7,637.97",6940
,20130926,14750,14745,14745,14785,14730,14775,14755,30,10,2198,"16,218.29",5010
,20130927,14775,14755,14770,14780,14755,14780,14765,25,10,1594,"11,770.80",3716
,20130930,14780,14765,14740,14880,14740,14790,14810,25,45,782,"5,790.85",3312
,20131008,14790,14810,14725,14795,14720,14780,14740,-30,-70,852,"6,279.84",3100
,20131009,14780,14740,14800,14845,14800,14805,14810,65,70,880,"6,517.35",2710
,20131010,14805,14810,14740,14850,14740,14850,14800,40,-10,270,"1,998.55",2590
,20131011,14850,14800,14960,14995,14930,14975,14965,175,165,710,"5,312.70",2340
,20131014,14975,14965,14975,15020,14975,14985,14990,20,25,1030,"7,720.18",2300
,20131015,14985,14990,15010,15050,14990,14990,15020,0,30,890,"6,685.83",2620
zn1311,20130104,16320,16320,16320,16320,16275,16275,16305,-45,-15,16,130.46,178
,20130107,16275,16305,16230,16250,16230,16230,16235,-75,-70,14,113.65,174
,20130108,16230,16235,16225,16225,16100,16100,16170,-135,-65,42,339.57,158
,20130109,16100,16170,16110,16120,16110,16110,16115,-60,-55,14,112.81,158
,20130110,16110,16115,16140,16140,15195,16105,15745,-10,-370,62,488.11,148
,20130111,16105,15745,16105,16195,16105,16110,16145,365,400,24,193.75,144
,20130114,16110,16145,16030,16060,16000,16060,16025,-85,-120,10,80.13,140
,20130115,16060,16025,16015,16015,15855,15855,15905,-170,-120,18,143.18,128
,20130116,15855,15905,15855,15925,15820,15860,15865,-45,-40,18,142.79,130
,20130117,15860,15865,15860,15860,15850,15850,15855,-15,-10,4,31.71,132
,20130118,15850,15855,15975,16010,15965,16010,15990,155,135,8,63.96,132
,20130121,16010,15990,,,,15970,15970,-20,-20,0,0,132
,20130122,15970,15970,,,,15970,15970,0,0,0,0,132
,20130123,15970,15970,16100,16100,16100,16100,16100,130,130,2,16.1,130
,20130124,16100,16100,16085,16095,16080,16095,16085,-5,-15,8,64.35,128
,20130125,16095,16085,16170,16240,16160,16230,16195,145,110,14,113.37,134
,20130128,16230,16195,,,,16195,16195,0,0,0,0,134
,20130129,16195,16195,16235,16235,16235,16235,16235,40,40,4,32.47,136
,20130130,16235,16235,16350,16475,16350,16475,16420,240,185,46,377.74,154
,20130131,16475,16420,16520,16630,16520,16620,16585,200,165,18,149.28,162
,20130201,16620,16585,16550,16585,16485,16585,16535,0,-50,14,115.76,168
,20130204,16585,16535,15820,16775,15820,16715,16640,180,105,20,166.41,158
,20130205,16715,16640,,,,16610,16610,-30,-30,0,0,158
,20130206,16610,16610,,,,16560,16560,-50,-50,0,0,158
,20130207,16560,16560,16420,16465,16420,16465,16440,-95,-120,4,32.89,158
,20130208,16465,16440,16480,16570,16480,16570,16550,130,110,46,380.74,186
,20130218,16570,16550,16355,16360,16355,16360,16355,-190,-195,6,49.07,184
,20130219,16360,16355,16395,16400,16350,16350,16385,-5,30,10,81.94,178
,20130220,16350,16385,16460,16475,16460,16475,16465,90,80,4,32.94,178
,20130221,16475,16465,16330,16335,16190,16200,16245,-265,-220,26,211.22,164
,20130222,16200,16245,,,,16350,16350,105,105,0,0,164
,20130225,16350,16350,16145,16145,16090,16135,16110,-215,-240,16,128.88,160
,20130226,16135,16110,16090,16140,16090,16090,16095,-20,-15,48,386.36,160
,20130227,16090,16095,16180,16180,16160,16160,16170,65,75,6,48.52,160
,20130228,16160,16170,16175,16185,16150,16150,16170,-20,0,8,64.7,164
,20130301,16150,16170,16080,16080,15960,15960,16020,-210,-150,56,448.58,192
,20130304,15960,16020,15930,15930,15865,15865,15885,-155,-135,12,95.32,182
,20130305,15865,15885,15900,15905,15900,15905,15900,20,15,4,31.81,182
,20130306,15905,15900,15830,15830,15830,15830,15830,-70,-70,2,15.83,184
,20130307,15830,15830,15655,15730,15650,15660,15670,-170,-160,16,125.36,184
,20130308,15660,15670,,,,15700,15700,30,30,0,0,184
,20130311,15700,15700,15620,15620,15620,15620,15620,-80,-80,4,31.24,184
,20130312,15620,15620,15610,15610,15550,15550,15580,-70,-40,12,93.49,186
,20130313,15550,15580,15620,15620,15620,15620,15620,40,40,2,15.62,186
,20130314,15620,15620,15535,15555,15535,15555,15545,-65,-75,8,62.18,186
,20130315,15555,15545,15580,15705,15580,15700,15650,155,105,18,140.88,188
,20130318,15700,15650,15085,15345,15085,15245,15250,-405,-400,50,381.26,210
,20130319,15245,15250,15250,15290,15250,15290,15275,40,25,30,229.15,206
,20130320,15290,15275,15270,15270,15270,15270,15270,-5,-5,2,15.27,206
,20130321,15270,15270,15350,15440,15350,15440,15395,170,125,4,30.79,206
,20130322,15440,15395,15360,15360,15360,15360,15360,-35,-35,4,30.72,210
,20130325,15360,15360,15410,15440,15400,15440,15425,80,65,26,200.58,206
,20130326,15440,15425,15365,15365,15355,15355,15355,-70,-70,16,122.85,204
,20130327,15355,15355,15205,15230,15180,15180,15200,-175,-155,48,364.88,198
,20130328,15180,15200,15210,15210,15200,15200,15205,0,5,4,30.41,200
,20130329,15200,15205,15120,15135,15120,15120,15125,-85,-80,32,242.08,200
,20130401,15120,15125,15005,15015,14960,14980,14995,-145,-130,76,569.97,236
,20130402,14980,14995,15035,15035,15020,15035,15025,40,30,12,90.17,242
,20130403,15035,15025,14930,14950,14860,14860,14900,-165,-125,204,"1,520.07",360
,20130408,14860,14900,14930,14950,14930,14950,14945,50,45,52,388.66,356
,20130409,14950,14945,15055,15140,15055,15140,15095,195,150,8,60.4,356
,20130410,15140,15095,15190,15200,15120,15130,15155,35,60,22,166.71,362
,20130411,15130,15155,,,,15155,15155,0,0,0,0,362
,20130412,15155,15155,15010,15015,15010,15015,15010,-140,-145,54,405.28,364
,20130415,15015,15010,14825,14830,14650,14650,14710,-360,-300,30,220.66,378
,20130416,14650,14710,14710,14865,14690,14865,14760,155,50,132,974.27,474
,20130417,14865,14760,14890,14890,14775,14790,14815,30,55,36,266.68,486
,20130418,14790,14815,14400,14605,14400,14500,14490,-315,-325,114,826.05,584
,20130419,14500,14490,14565,14795,14565,14770,14735,280,245,430,"3,168.22",866
,20130422,14770,14735,14810,14810,14720,14740,14745,5,10,118,870.2,954
,20130423,14740,14745,14690,14700,14640,14685,14665,-60,-80,684,"5,015.71",1556
,20130424,14685,14665,14780,14845,14695,14835,14720,170,55,822,"6,050.23",1204
,20130425,14835,14720,14880,14940,14850,14935,14890,215,170,200,"1,489.50",1276
,20130426,14935,14890,15035,15085,14990,15000,15040,110,150,1614,"12,139.12",2388
,20130502,15000,15040,14420,14605,14420,14575,14575,-465,-465,1096,"7,987.32",2374
,20130503,14575,14575,14525,14640,14525,14590,14570,15,-5,820,"5,975.47",2782
,20130506,14590,14570,14955,14955,14805,14850,14820,280,250,508,"3,765.04",3010
,20130507,14850,14820,14800,14840,14680,14680,14755,-140,-65,688,"5,077.23",3584
,20130508,14680,14755,14680,14780,14680,14780,14750,25,-5,932,"6,874.17",4228
,20130509,14780,14750,14755,14765,14690,14705,14745,-45,-5,416,"3,067.04",3978
,20130510,14705,14745,14650,14750,14640,14750,14675,5,-70,140,"1,027.54",3978
,20130513,14750,14675,14675,14715,14655,14700,14685,25,10,98,719.73,3976
,20130514,14700,14685,14735,14735,14570,14600,14640,-85,-45,258,"1,888.95",3980
,20130515,14600,14640,14600,14620,14100,14100,14565,-540,-75,288,"2,097.66",4134
,20130516,14100,14565,14435,14520,14420,14460,14475,-105,-90,1476,"10,684.87",5102
,20130517,14460,14475,14500,14590,14450,14560,14530,85,55,84,610.31,5098
,20130520,14560,14530,14530,14530,14445,14490,14480,-40,-50,128,926.93,5082
,20130521,14490,14480,14545,14590,14515,14565,14555,85,75,1444,"10,511.10",6234
,20130522,14565,14555,14520,14670,14520,14670,14590,115,35,194,"1,415.46",6232
,20130523,14670,14590,14670,14670,14500,14550,14550,-40,-40,284,"2,066.26",6160
,20130524,14550,14550,14580,14665,14555,14660,14615,110,65,930,"6,797.29",6684
,20130527,14660,14615,14595,14640,14595,14625,14625,10,10,158,"1,155.56",6686
,20130528,14625,14625,14655,14655,14605,14625,14630,0,5,366,"2,677.88",6864
,20130529,14625,14630,14680,14680,14600,14600,14655,-30,25,66,483.7,6870
,20130530,14600,14655,14645,14770,14645,14745,14715,90,60,2292,"16,869.03",8162
,20130531,14745,14715,14900,14915,14815,14830,14835,115,120,780,"5,786.73",8188
,20130603,14830,14835,14960,14960,14880,14950,14915,115,80,752,"5,608.54",8242
,20130604,14950,14915,14995,14995,14825,14850,14905,-65,-10,2004,"14,935.53",8404
,20130605,14850,14905,14920,14980,14890,14955,14930,50,25,920,"6,869.18",8534
,20130606,14955,14930,14900,14935,14870,14890,14900,-40,-30,1152,"8,585.24",8788
,20130607,14890,14900,14880,14910,14865,14905,14885,5,-15,792,"5,896.27",8774
,20130613,14905,14885,14750,14750,14600,14630,14645,-255,-240,1764,"12,919.20",9518
,20130614,14630,14645,14600,14610,14550,14580,14575,-65,-70,2710,"19,749.74",10614
,20130617,14580,14575,14620,14660,14615,14640,14645,65,70,2250,"16,478.53",11336
,20130618,14640,14645,14640,14645,14560,14570,14600,-75,-45,1014,"7,402.81",11828
,20130619,14570,14600,14580,14595,14560,14590,14575,-10,-25,2036,"14,839.42",13268
,20130620,14590,14575,14490,14510,14395,14430,14430,-145,-145,14486,"104,528.83",24188
,20130621,14430,14430,14400,14500,14300,14480,14400,50,-30,14100,"101,539.63",28890
,20130624,14480,14400,14470,14475,14300,14350,14385,-50,-15,4806,"34,573.66",29648
,20130625,14350,14385,14340,14440,14245,14405,14360,20,-25,8146,"58,496.40",32158
,20130626,14405,14360,14475,14500,14335,14350,14405,-10,45,6638,"47,817.36",33120
,20130627,14350,14405,14370,14455,14350,14440,14410,35,5,4660,"33,578.58",34092
,20130628,14440,14410,14395,14465,14370,14445,14430,35,20,8838,"63,785.50",38734
,20130701,14445,14430,14440,14565,14430,14560,14525,130,95,6312,"45,842.03",39448
,20130702,14560,14525,14580,14700,14575,14680,14620,155,95,10418,"76,159.67",42648
,20130703,14680,14620,14660,14685,14600,14665,14640,45,20,7368,"53,934.62",44190
,20130704,14665,14640,14620,14620,14535,14570,14575,-70,-65,8066,"58,782.98",46902
,20130705,14570,14575,14560,14570,14490,14490,14510,-85,-65,14238,"103,304.82",52436
,20130708,14490,14510,14495,14495,14430,14440,14450,-70,-60,16296,"117,766.50",60128
,20130709,14440,14450,14510,14580,14510,14545,14545,95,95,19098,"138,910.32",58528
,20130710,14545,14545,14540,14590,14480,14570,14520,25,-25,21116,"153,345.86",61756
,20130711,14570,14520,14750,14890,14690,14820,14780,300,260,47584,"351,694.52",69168
,20130712,14820,14780,14780,14785,14640,14670,14705,-110,-75,26372,"193,907.21",69900
,20130715,14670,14705,14700,14745,14675,14710,14710,5,5,23058,"169,644.20",74324
,20130716,14710,14710,14705,14745,14660,14745,14695,35,-15,20050,"147,358.37",77362
,20130717,14745,14695,14725,14735,14635,14635,14680,-60,-15,31006,"227,619.20",79392
,20130718,14635,14680,14580,14585,14515,14530,14540,-150,-140,40966,"297,885.43",86058
,20130719,14530,14540,14545,14590,14490,14490,14545,-50,5,31626,"230,061.77",91642
,20130722,14490,14545,14550,14645,14550,14640,14605,95,60,35618,"260,187.33",94146
,20130723,14640,14605,14640,14680,14615,14630,14645,25,40,24884,"182,236.14",95492
,20130724,14630,14645,14660,14680,14600,14655,14640,10,-5,29254,"214,161.79",96760
,20130725,14655,14640,14640,14730,14615,14715,14685,75,45,39546,"290,408.81",103376
,20130726,14715,14685,14680,14680,14600,14615,14635,-70,-50,36182,"264,848.50",104162
,20130729,14615,14635,14520,14575,14510,14525,14530,-110,-105,38222,"277,766.25",114430
,20130730,14525,14530,14520,14545,14460,14465,14505,-65,-25,39420,"285,906.48",127634
,20130731,14465,14505,14430,14510,14405,14485,14460,-20,-45,47576,"344,033.01",134236
,20130801,14485,14460,14520,14560,14500,14530,14525,70,65,37334,"271,139.88",135454
,20130802,14530,14525,14565,14565,14510,14525,14530,0,5,27948,"203,047.45",134816
,20130805,14525,14530,14575,14620,14555,14615,14590,85,60,32858,"239,746.32",132248
,20130806,14615,14590,14590,14605,14565,14595,14585,5,-5,21328,"155,543.02",133690
,20130807,14595,14585,14550,14580,14530,14550,14545,-35,-40,27540,"200,350.92",137716
,20130808,14550,14545,14560,14665,14560,14650,14625,105,80,63764,"466,363.86",137764
,20130809,14650,14625,14720,14760,14685,14735,14730,110,105,52122,"383,935.70",127066
,20130812,14735,14730,14935,14955,14875,14940,14905,210,175,90052,"671,321.61",120648
,20130813,14940,14905,14950,14950,14860,14910,14895,5,-10,54332,"404,727.26",118216
,20130814,14910,14895,14890,14920,14835,14855,14865,-40,-30,47728,"354,761.09",111220
,20130815,14855,14865,14950,14950,14895,14925,14925,60,60,47080,"351,370.52",107496
,20130816,14925,14925,14975,15210,14975,15170,15110,245,185,95042,"718,272.77",107226
,20130819,15170,15110,15265,15270,15160,15195,15200,85,90,51904,"394,585.03",97236
,20130820,15195,15200,15175,15175,14975,15000,15070,-200,-130,40844,"307,806.59",87374
,20130821,15000,15070,15070,15095,15030,15075,15060,5,-10,21642,"163,004.33",84070
,20130822,15075,15060,15000,15135,14900,15135,15040,75,-20,24870,"187,077.98",81584
,20130823,15135,15040,15085,15155,15025,15065,15085,25,45,19290,"145,538.02",79114
,20130826,15065,15085,15255,15260,15140,15160,15175,75,90,17608,"133,626.16",77016
,20130827,15160,15175,15155,15155,15070,15090,15100,-85,-75,12550,"94,782.06",74894
,20130828,15090,15100,15090,15175,14995,15000,15085,-100,-15,16220,"122,365.64",72896
,20130829,15000,15085,14960,14985,14905,14940,14935,-145,-150,21518,"160,727.35",65678
,20130830,14940,14935,14880,14900,14805,14820,14850,-115,-85,20672,"153,539.88",56288
,20130902,14820,14850,14805,14935,14780,14900,14875,50,25,12244,"91,071.26",53864
,20130903,14900,14875,14900,14900,14820,14840,14855,-35,-20,12830,"95,313.11",51386
,20130904,14840,14855,14850,14850,14760,14770,14800,-85,-55,5462,"40,425.80",50802
,20130905,14770,14800,14735,14740,14670,14675,14695,-125,-105,9382,"68,951.30",47870
,20130906,14675,14695,14710,14745,14665,14745,14700,50,5,5390,"39,629.51",46378
,20130909,14745,14700,14800,14855,14775,14850,14810,150,110,4048,"29,983.33",44882
,20130910,14850,14810,14770,14800,14720,14745,14740,-65,-70,4164,"30,690.68",44304
,20130911,14745,14740,14675,14755,14675,14740,14740,0,0,2662,"19,619.32",43518
,20130912,14740,14740,14735,14735,14640,14660,14685,-80,-55,3948,"28,988.52",41696
,20130913,14660,14685,14695,14790,14685,14760,14715,75,30,3556,"26,166.44",39950
,20130916,14760,14715,14750,14765,14645,14645,14685,-70,-30,6350,"46,633.23",36692
,20130917,14645,14685,14630,14695,14605,14650,14625,-35,-60,3238,"23,685.35",35102
,20130918,14650,14625,14620,14685,14610,14685,14640,60,15,3112,"22,781.34",34616
,20130923,14685,14640,14715,14715,14595,14700,14655,60,15,3020,"22,132.41",34266
,20130924,14700,14655,14740,14750,14695,14710,14720,55,65,3668,"27,004.97",33232
,20130925,14710,14720,14700,14760,14700,14735,14740,15,20,5072,"37,383.80",30462
,20130926,14735,14740,14735,14775,14705,14770,14740,30,0,4060,"29,924.66",28114
,20130927,14770,14740,14790,14790,14735,14775,14750,35,10,3246,"23,943.99",25724
,20130930,14775,14750,14780,14855,14770,14845,14810,95,60,3368,"24,948.02",23930
,20131008,14845,14810,14685,14760,14685,14755,14720,-55,-90,2658,"19,568.03",23226
,20131009,14755,14720,14750,14795,14750,14755,14775,35,55,3476,"25,682.89",21272
,20131010,14755,14775,14745,14830,14720,14825,14780,50,5,2296,"16,971.42",20082
,20131011,14825,14780,14850,14950,14850,14915,14910,135,130,5838,"43,535.99",19632
,20131014,14915,14910,14960,14980,14885,14960,14935,50,25,3018,"22,542.28",18128
,20131015,14960,14935,15000,15005,14935,14945,14970,10,35,4196,"31,412.86",15786
,20131016,14945,14970,14900,14965,14890,14945,14925,-25,-45,1528,"11,405.30",15248
,20131017,14945,14925,14995,15000,14900,14980,14935,55,10,2448,"18,285.19",13924
,20131018,14980,14935,14960,15000,14960,14980,14980,45,45,2180,"16,330.65",12788
,20131021,14980,14980,14995,15110,14950,15110,15060,130,80,2588,"19,491.31",11152
,20131022,15110,15060,15025,15095,15025,15070,15070,10,10,1906,"14,364.31",10276
,20131023,15070,15070,15125,15150,15060,15065,15105,-5,35,1388,"10,483.60",9506
,20131024,15065,15105,15005,15030,14950,15030,15000,-75,-105,1012,"7,591.32",9022
,20131025,15030,15000,15015,15090,14975,14995,15025,-5,25,1082,"8,131.17",8632
,20131028,14995,15025,15045,15095,15040,15070,15060,45,35,1640,"12,351.81",7754
,20131029,15070,15060,15110,15120,15070,15120,15090,60,30,3352,"25,298.05",6426
,20131030,15120,15090,15105,15180,15100,15140,15130,50,40,2138,"16,174.94",5988
,20131031,15140,15130,15110,15110,14810,14970,14970,-160,-160,1548,"11,589.67",5530
,20131101,14970,14970,14960,15050,14960,15040,15030,70,60,160,"1,202.68",5560
,20131104,15040,15030,14985,15015,14975,15000,14980,-30,-50,600,"4,495.38",5180
,20131105,15000,14980,14965,14990,14955,14980,14975,0,-5,450,"3,369.58",4800
,20131106,14980,14975,14955,14985,14950,14980,14970,5,-5,570,"4,266.90",4550
,20131107,14980,14970,14945,14975,14945,14965,14960,-5,-10,400,"2,992.70",4370
,20131108,14965,14960,14950,14950,14935,14940,14940,-20,-20,620,"4,631.58",4100
,20131111,14940,14940,14930,14940,14930,14930,14930,-10,-10,1210,"9,033.78",3240
,20131112,14930,14930,14900,14900,14870,14890,14890,-40,-40,990,"7,370.98",3110
,20131113,14890,14890,14860,14860,14780,14810,14805,-80,-85,410,"3,035.85",3160
,20131114,14810,14805,14840,14900,14840,14900,14880,95,75,590,"4,389.90",3080
,20131115,14900,14880,14890,14915,14865,14915,14890,35,10,340,"2,531.60",2810
zn1312,20130104,16350,16350,,,,16350,16350,0,0,0,0,2
,20130107,16350,16350,16255,16255,16255,16255,16255,-95,-95,2,16.26,2
,20130108,16255,16255,,,,16255,16255,0,0,0,0,2
,20130109,16255,16255,16160,16240,16160,16235,16210,-20,-45,6,48.64,4
,20130110,16235,16210,16235,16235,16235,16235,16235,25,25,2,16.24,6
,20130111,16235,16235,16310,16310,16260,16260,16285,25,50,4,32.57,8
,20130114,16260,16285,,,,16210,16210,-75,-75,0,0,8
,20130115,16210,16210,16185,16185,16120,16120,16145,-90,-65,6,48.44,8
,20130116,16120,16145,,,,16050,16050,-95,-95,0,0,8
,20130117,16050,16050,,,,16045,16045,-5,-5,0,0,8
,20130118,16045,16045,16030,16030,16030,16030,16030,-15,-15,2,16.03,10
,20130121,16030,16030,,,,16020,16020,-10,-10,0,0,10
,20130122,16020,16020,16105,16105,16105,16105,16105,85,85,2,16.11,10
,20130123,16105,16105,16175,16205,16175,16205,16195,100,90,24,194.4,30
,20130124,16205,16195,16155,16155,16150,16150,16150,-45,-45,4,32.31,28
,20130125,16150,16150,16300,16310,16300,16310,16305,160,155,8,65.22,36
,20130128,16310,16305,,,,16305,16305,0,0,0,0,36
,20130129,16305,16305,,,,16305,16305,0,0,0,0,36
,20130130,16305,16305,,,,16305,16305,0,0,0,0,36
,20130131,16305,16305,16685,16685,16660,16660,16665,355,360,10,83.34,38
,20130201,16660,16665,16645,16670,16605,16670,16635,5,-30,16,133.1,38
,20130204,16670,16635,16765,16765,16765,16765,16765,130,130,2,16.77,40
,20130205,16765,16765,,,,16640,16640,-125,-125,0,0,40
,20130206,16640,16640,16640,16640,16590,16590,16615,-50,-25,4,33.23,40
,20130207,16590,16615,16535,16540,16530,16530,16535,-85,-80,10,82.68,40
,20130208,16530,16535,16570,16610,16570,16610,16590,75,55,4,33.18,40
,20130218,16610,16590,16425,16425,16405,16405,16415,-185,-175,12,98.52,42
,20130219,16405,16415,16460,16460,16430,16430,16445,15,30,8,65.79,42
,20130220,16430,16445,16470,16575,16470,16575,16485,130,40,32,263.82,58
,20130221,16575,16485,16400,16400,16155,16180,16290,-305,-195,24,195.52,56
,20130222,16180,16290,16260,16395,16260,16340,16340,50,50,40,326.87,62
,20130225,16340,16340,16195,16235,16155,16155,16190,-185,-150,18,145.74,72
,20130226,16155,16190,16190,16190,16150,16150,16185,-40,-5,72,582.8,142
,20130227,16150,16185,16155,16265,16155,16260,16240,75,55,16,129.93,148
,20130228,16260,16240,16220,16220,16220,16220,16220,-20,-20,2,16.22,148
,20130301,16220,16220,16100,16100,16005,16020,16025,-200,-195,34,272.5,154
,20130304,16020,16025,15900,15900,15900,15900,15900,-125,-125,2,15.9,154
,20130305,15900,15900,15925,15990,15925,15985,15965,85,65,6,47.9,154
,20130306,15985,15965,15890,15900,15890,15900,15895,-65,-70,4,31.79,156
,20130307,15900,15895,15670,15810,15670,15760,15755,-135,-140,18,141.83,152
,20130308,15760,15755,15810,15810,15785,15800,15795,45,40,20,157.98,158
,20130311,15800,15795,15745,15765,15670,15670,15710,-125,-85,14,109.98,164
,20130312,15670,15710,,,,15685,15685,-25,-25,0,0,164
,20130313,15685,15685,15690,15690,15690,15690,15690,5,5,6,47.07,164
,20130314,15690,15690,15615,15640,15580,15640,15600,-50,-90,14,109.22,164
,20130315,15640,15600,15655,15755,15655,15755,15720,155,120,12,94.34,164
,20130318,15755,15720,15135,15405,15135,15295,15300,-425,-420,30,229.57,168
,20130319,15295,15300,15385,15390,15265,15265,15330,-35,30,22,168.68,164
,20130320,15265,15330,15310,15335,15310,15335,15310,5,-20,32,244.99,164
,20130321,15335,15310,15385,15445,15385,15445,15415,135,105,4,30.83,164
,20130322,15445,15415,15350,15395,15350,15385,15380,-30,-35,32,246.1,174
,20130325,15385,15380,15445,15485,15435,15485,15455,105,75,42,324.66,178
,20130326,15485,15455,,,,15385,15385,-70,-70,0,0,178
,20130327,15385,15385,15345,15345,15280,15280,15300,-105,-85,14,107.11,170
,20130328,15280,15300,15315,15315,15190,15190,15220,-110,-80,18,137.01,166
,20130329,15190,15220,15220,15220,15170,15170,15205,-50,-15,8,60.83,164
,20130401,15170,15205,15075,15075,15015,15015,15045,-190,-160,30,225.69,176
,20130402,15015,15045,15050,15075,15050,15075,15055,30,10,10,75.28,182
,20130403,15075,15055,14990,14990,14890,14890,14935,-165,-120,10,74.69,182
,20130408,14890,14935,14930,15010,14930,15010,14970,75,35,4,29.94,182
,20130409,15010,14970,15105,15155,15100,15155,15135,185,165,20,151.36,176
,20130410,15155,15135,15150,15155,15150,15155,15150,20,15,10,75.77,180
,20130411,15155,15150,15150,15175,15110,15110,15135,-40,-15,24,181.63,184
,20130412,15110,15135,15120,15120,15070,15070,15080,-65,-55,8,60.33,190
,20130415,15070,15080,14885,14885,14720,14740,14760,-340,-320,18,132.87,190
,20130416,14740,14760,14650,14900,14650,14900,14745,140,-15,56,412.98,226
,20130417,14900,14745,14955,14955,14820,14820,14860,75,115,18,133.78,222
,20130418,14820,14860,14470,14630,14310,14540,14480,-320,-380,44,318.57,228
,20130419,14540,14480,14605,14795,14605,14720,14750,240,270,56,413.01,256
,20130422,14720,14750,14830,14880,14805,14810,14840,60,90,52,385.85,284
,20130423,14810,14840,14860,14860,14700,14810,14765,-30,-75,36,265.78,282
,20130424,14810,14765,14780,14880,14780,14880,14840,115,75,26,192.97,276
,20130425,14880,14840,14950,14985,14935,14985,14960,145,120,54,403.97,308
,20130426,14985,14960,15105,15110,15020,15070,15080,110,120,20,150.85,314
,20130502,15070,15080,14520,14670,14520,14660,14630,-420,-450,38,277.98,318
,20130503,14660,14630,14630,14700,14630,14700,14635,70,5,180,"1,317.59",280
,20130506,14700,14635,14900,14935,14840,14935,14885,300,250,26,193.57,278
,20130507,14935,14885,14865,14900,14760,14765,14850,-120,-35,48,356.51,288
,20130508,14765,14850,14845,14845,14755,14820,14815,-30,-35,244,"1,807.89",428
,20130509,14820,14815,14800,14820,14790,14790,14800,-25,-15,8,59.21,424
,20130510,14790,14800,14735,14790,14670,14790,14700,-10,-100,36,264.62,434
,20130513,14790,14700,14715,14735,14710,14735,14730,35,30,40,294.64,466
,20130514,14735,14730,14760,14760,14640,14640,14670,-90,-60,236,"1,731.31",636
,20130515,14640,14670,14615,14615,14580,14585,14600,-85,-70,24,175.21,640
,20130516,14585,14600,14530,14560,14470,14505,14525,-95,-75,180,"1,307.44",742
,20130517,14505,14525,14570,14620,14480,14605,14555,80,30,162,"1,179.14",834
,20130520,14605,14555,14505,14605,14405,14525,14495,-30,-60,1164,"8,437.09",1150
,20130521,14525,14495,14630,14655,14590,14590,14610,95,115,182,"1,329.78",1090
,20130522,14590,14610,14600,14710,14590,14710,14650,100,40,110,805.87,1154
,20130523,14710,14650,14610,14625,14550,14580,14600,-70,-50,300,"2,190.22",1258
,20130524,14580,14600,14600,14705,14600,14690,14665,90,65,66,484.04,1264
,20130527,14690,14665,14645,14690,14615,14685,14670,20,5,486,"3,564.89",1590
,20130528,14685,14670,14665,14680,14645,14680,14670,10,0,110,806.97,1668
,20130529,14680,14670,14725,14730,14665,14665,14700,-5,30,78,573.32,1716
,20130530,14665,14700,14775,14815,14740,14800,14775,100,75,530,"3,916.17",1840
,20130531,14800,14775,14865,14930,14860,14890,14880,115,105,372,"2,768.20",2042
,20130603,14890,14880,14955,15025,14935,15000,14965,120,85,206,"1,541.75",2164
,20130604,15000,14965,14990,15025,14880,14905,14960,-60,-5,332,"2,483.98",2388
,20130605,14905,14960,15020,15020,14905,15015,14970,55,10,520,"3,893.13",2608
,20130606,15015,14970,14915,14995,14915,14930,14930,-40,-40,56,418.12,2612
,20130607,14930,14930,14975,14975,14920,14940,14940,10,10,80,597.74,2610
,20130613,14940,14940,14595,14760,14585,14695,14695,-245,-245,402,"2,954.56",2654
,20130614,14695,14695,14655,14655,14600,14625,14620,-70,-75,816,"5,966.12",2990
,20130617,14625,14620,14655,14700,14655,14690,14685,70,65,218,"1,600.73",3098
,20130618,14690,14685,14655,14680,14580,14615,14630,-70,-55,252,"1,843.91",3288
,20130619,14615,14630,14600,14640,14600,14610,14615,-20,-15,186,"1,359.40",3386
,20130620,14610,14615,14540,14545,14445,14465,14480,-150,-135,766,"5,546.32",3810
,20130621,14465,14480,14355,14530,14355,14510,14425,30,-55,604,"4,356.40",4038
,20130624,14510,14425,14490,14505,14350,14350,14430,-75,5,550,"3,968.45",4280
,20130625,14350,14430,14395,14460,14320,14460,14380,30,-50,1510,"10,860.01",5404
,20130626,14460,14380,14490,14490,14355,14355,14410,-25,30,712,"5,130.07",5822
,20130627,14355,14410,14400,14470,14400,14470,14430,60,20,686,"4,950.44",5960
,20130628,14470,14430,14405,14470,14385,14460,14450,30,20,528,"3,815.39",6096
,20130701,14460,14450,14470,14575,14470,14565,14550,115,100,822,"5,980.67",6180
,20130702,14565,14550,14615,14690,14605,14690,14640,140,90,852,"6,238.62",6150
,20130703,14690,14640,14645,14710,14640,14690,14685,50,45,600,"4,406.43",6208
,20130704,14690,14685,14630,14630,14570,14600,14595,-85,-90,218,"1,591.05",6380
,20130705,14600,14595,14540,14590,14515,14515,14530,-80,-65,256,"1,860.45",6486
,20130708,14515,14530,14430,14495,14430,14455,14465,-75,-65,788,"5,700.68",6920
,20130709,14455,14465,14595,14595,14535,14565,14570,100,105,790,"5,755.91",7284
,20130710,14565,14570,14565,14590,14500,14580,14540,10,-30,1374,"9,991.01",8202
,20130711,14580,14540,14710,14890,14710,14820,14800,280,260,7012,"51,889.82",8774
,20130712,14820,14800,14820,14820,14660,14695,14715,-105,-85,2140,"15,745.69",9192
,20130715,14695,14715,14695,14755,14695,14730,14730,15,15,1352,"9,960.66",10046
,20130716,14730,14730,14720,14750,14675,14750,14720,20,-10,2332,"17,163.76",11166
,20130717,14750,14720,14740,14740,14650,14670,14685,-50,-35,2070,"15,201.46",11694
,20130718,14670,14685,14630,14630,14535,14560,14550,-125,-135,8174,"59,482.91",16288
,20130719,14560,14550,14570,14600,14520,14520,14555,-30,5,3936,"28,647.01",18114
,20130722,14520,14555,14580,14670,14575,14665,14635,110,80,9818,"71,858.10",22260
,20130723,14665,14635,14660,14690,14625,14655,14655,20,20,4372,"32,045.04",22982
,20130724,14655,14655,14685,14695,14620,14670,14650,15,-5,5950,"43,589.72",24744
,20130725,14670,14650,14695,14745,14630,14730,14700,80,50,4952,"36,407.53",26564
,20130726,14730,14700,14685,14695,14615,14635,14650,-65,-50,6846,"50,161.69",28458
,20130729,14635,14650,14520,14580,14520,14545,14545,-105,-105,8478,"61,657.26",32608
,20130730,14545,14545,14545,14555,14480,14485,14525,-60,-20,9436,"68,530.41",37902
,20130731,14485,14525,14430,14510,14430,14490,14475,-35,-50,11592,"83,904.23",43320
,20130801,14490,14475,14515,14570,14510,14540,14535,65,60,9418,"68,462.33",46626
,20130802,14540,14535,14580,14580,14525,14540,14540,5,5,8856,"64,390.89",49660
,20130805,14540,14540,14560,14630,14560,14625,14600,85,60,6650,"48,553.67",50136
,20130806,14625,14600,14600,14615,14570,14600,14595,0,-5,5894,"43,012.85",52368
,20130807,14600,14595,14550,14580,14540,14560,14555,-35,-40,7016,"51,065.29",54150
,20130808,14560,14555,14585,14675,14560,14675,14635,120,80,23846,"174,539.88",61016
,20130809,14675,14635,14725,14775,14700,14755,14745,120,110,19348,"142,654.60",65492
,20130812,14755,14745,14980,14980,14885,14960,14920,215,175,35548,"265,238.23",68116
,20130813,14960,14920,14960,14960,14870,14925,14905,5,-15,29528,"220,118.78",70452
,20130814,14925,14905,14905,14925,14840,14870,14875,-35,-30,26068,"193,881.70",72036
,20130815,14870,14875,14950,14960,14900,14935,14935,60,60,24068,"179,739.48",74976
,20130816,14935,14935,14970,15265,14970,15205,15160,270,225,108662,"823,662.54",106122
,20130819,15205,15160,15280,15300,15185,15225,15230,65,70,68818,"524,181.57",104122
,20130820,15225,15230,15205,15225,15005,15025,15100,-205,-130,79232,"598,217.61",96792
,20130821,15025,15100,15080,15120,15045,15095,15080,-5,-20,39440,"297,449.42",96618
,20130822,15095,15080,15005,15175,14905,15160,15060,80,-20,60974,"459,209.01",101606
,20130823,15160,15060,15115,15195,15055,15100,15120,40,60,52104,"393,960.16",100988
,20130826,15100,15120,15285,15285,15180,15210,15220,90,100,54760,"416,753.82",109920
,20130827,15210,15220,15180,15200,15105,15130,15145,-90,-75,48382,"366,394.13",108496
,20130828,15130,15145,15120,15200,15020,15045,15130,-100,-15,75470,"570,955.42",109606
,20130829,15045,15130,15005,15015,14930,14965,14970,-165,-160,55432,"414,987.71",107220
,20130830,14965,14970,14900,14935,14820,14840,14880,-130,-90,59408,"442,055.16",101940
,20130902,14840,14880,14800,14975,14790,14940,14910,60,30,69648,"519,291.72",107336
,20130903,14940,14910,14935,14940,14840,14870,14885,-40,-25,46648,"347,204.12",109032
,20130904,14870,14885,14865,14880,14765,14800,14820,-85,-65,42310,"313,525.11",109124
,20130905,14800,14820,14720,14755,14685,14695,14715,-125,-105,59494,"437,733.98",118186
,20130906,14695,14715,14710,14760,14670,14750,14720,35,5,37210,"273,879.36",120258
,20130909,14750,14720,14805,14885,14790,14860,14835,140,115,40916,"303,545.00",118960
,20130910,14860,14835,14785,14795,14725,14750,14750,-85,-85,39064,"288,177.10",124144
,20130911,14750,14750,14720,14780,14720,14750,14745,0,-5,33982,"250,605.00",129578
,20130912,14750,14745,14720,14730,14640,14665,14690,-80,-55,34756,"255,346.16",132948
,20130913,14665,14690,14685,14800,14680,14790,14735,100,45,56176,"414,000.69",138632
,20130916,14790,14735,14760,14775,14650,14655,14695,-80,-40,55116,"405,020.98",136886
,20130917,14655,14695,14645,14670,14600,14660,14630,-35,-65,35964,"263,120.90",136766
,20130918,14660,14630,14630,14680,14610,14670,14640,40,10,24486,"179,275.63",140350
,20130923,14670,14640,14650,14720,14585,14705,14655,65,15,32260,"236,390.65",144740
,20130924,14705,14655,14765,14765,14695,14715,14725,60,70,20228,"148,969.58",141204
,20130925,14715,14725,14700,14765,14700,14740,14735,15,10,22872,"168,551.84",137626
,20130926,14740,14735,14735,14780,14705,14775,14740,40,5,22394,"165,082.69",131356
,20130927,14775,14740,14780,14800,14735,14765,14755,25,15,25074,"184,999.03",121878
,20130930,14765,14755,14785,14860,14770,14850,14815,95,60,24756,"183,434.48",113206
,20131008,14850,14815,14700,14760,14680,14745,14715,-70,-100,14586,"107,344.62",114174
,20131009,14745,14715,14750,14800,14750,14755,14770,40,55,12684,"93,683.07",113152
,20131010,14755,14770,14780,14825,14710,14820,14780,50,10,13230,"97,774.11",110662
,20131011,14820,14780,14830,14940,14830,14930,14900,150,120,20706,"154,308.71",108186
,20131014,14930,14900,14920,14960,14880,14960,14930,60,30,13300,"99,303.46",102174
,20131015,14960,14930,14980,14995,14905,14945,14955,15,25,23308,"174,341.39",89864
,20131016,14945,14955,14955,14955,14875,14925,14915,-30,-40,18558,"138,410.38",80678
,20131017,14925,14915,14970,14990,14865,14885,14915,-30,0,10862,"81,018.76",76374
,20131018,14885,14915,14950,14980,14930,14965,14955,50,40,8910,"66,628.22",74232
,20131021,14965,14955,14950,15095,14910,15090,15020,135,65,20080,"150,810.75",71474
,20131022,15090,15020,15060,15090,15030,15075,15050,55,30,8392,"63,164.11",67464
,20131023,15075,15050,15120,15140,15030,15030,15085,-20,35,14330,"108,115.33",59802
,20131024,15030,15085,15000,15005,14945,14995,14975,-90,-110,7296,"54,642.61",56444
,20131025,14995,14975,15020,15075,14945,14950,15000,-25,25,5686,"42,652.73",54348
,20131028,14950,15000,15030,15090,15020,15050,15045,50,45,9394,"70,677.37",49556
,20131029,15050,15045,15090,15130,15060,15130,15090,85,45,9624,"72,632.36",45160
,20131030,15130,15090,15095,15200,15095,15175,15150,85,60,13020,"98,655.10",38002
,20131031,15175,15150,15155,15155,14570,14980,14915,-170,-235,14808,"110,438.15",32504
,20131101,14980,14915,14955,15075,14935,15065,15015,150,100,4786,"35,935.68",29864
,20131104,15065,15015,15020,15020,14960,15000,14990,-15,-25,3270,"24,512.70",28538
,20131105,15000,14990,15000,15000,14960,14970,14975,-20,-15,1276,"9,554.57",28158
,20131106,14970,14975,14960,15000,14960,14980,14985,5,10,2180,"16,333.94",26692
,20131107,14980,14985,14930,14980,14930,14970,14965,-15,-20,1082,"8,097.28",25986
,20131108,14970,14965,14930,14945,14920,14940,14935,-25,-30,1986,"14,831.03",25012
,20131111,14940,14935,14965,14980,14915,14915,14925,-20,-10,1092,"8,150.46",24464
,20131112,14915,14925,14900,14900,14850,14850,14870,-75,-55,5028,"37,386.92",21762
,20131113,14850,14870,14825,14825,14775,14775,14795,-95,-75,3708,"27,434.82",20142
,20131114,14775,14795,14785,14870,14785,14850,14845,55,50,2206,"16,375.28",18860
,20131115,14850,14845,14855,14870,14830,14830,14845,-15,0,2678,"19,882.89",17124
,20131118,14830,14845,14850,14880,14840,14865,14860,20,15,2106,"15,648.83",15580
,20131119,14865,14860,14825,14850,14810,14830,14820,-30,-40,1158,"8,583.39",15268
,20131120,14830,14820,14860,14895,14855,14890,14880,70,60,1522,"11,324.57",14468
,20131121,14890,14880,14845,14850,14820,14850,14835,-30,-45,786,"5,832.01",14024
,20131122,14850,14835,14840,14880,14840,14855,14865,20,30,868,"6,452.28",13690
,20131125,14855,14865,14935,14950,14900,14905,14910,40,45,928,"6,918.37",13240
,20131126,14905,14910,14905,14910,14870,14885,14890,-25,-20,2960,"22,039.67",11814
,20131127,14885,14890,14840,14870,14830,14850,14850,-40,-40,1750,"12,995.94",10604
,20131128,14850,14850,14800,14835,14800,14835,14815,-15,-35,3308,"24,511.36",9910
,20131129,14835,14815,14850,14850,14805,14820,14820,5,5,2200,"16,302.58",8250
,20131202,14820,14820,14850,14855,14815,14820,14830,0,10,990,"7,342.70",7570
,20131203,14820,14830,14790,14825,14780,14815,14810,-15,-20,940,"6,961.78",6860
,20131204,14815,14810,14830,14835,14810,14810,14820,0,10,1290,"9,561.93",5920
,20131205,14810,14820,14770,14850,14770,14825,14830,5,10,1340,"9,938.43",5200
,20131206,14825,14830,14850,14870,14840,14870,14850,40,20,660,"4,901.63",4710
,20131209,14870,14850,14875,14880,14870,14880,14870,30,20,930,"6,915.98",4040
,20131210,14880,14870,14930,14980,14930,14980,14945,110,75,820,"6,129.48",3580
,20131211,14980,14945,14895,15045,14895,14980,14980,35,35,460,"3,446.05",3250
,20131212,14980,14980,15070,15100,15060,15100,15070,120,90,1390,"10,474.80",2170
,20131213,15100,15070,15000,15000,14960,15000,14995,-70,-75,440,"3,299.80",2120
,20131216,15000,14995,15050,15060,15030,15050,15045,55,50,320,"2,407.40",2080
zn1401,20130116,16145,16145,,,,16100,16100,-45,-45,0,0,0
,20130117,16100,16100,,,,16080,16080,-20,-20,0,0,0
,20130118,16080,16080,16095,16100,16095,16100,16095,20,15,4,32.2,4
,20130121,16100,16095,,,,16095,16095,0,0,0,0,4
,20130122,16095,16095,,,,16200,16200,105,105,0,0,4
,20130123,16200,16200,16200,16200,16200,16200,16200,0,0,2,16.2,6
,20130124,16200,16200,,,,16200,16200,0,0,0,0,6
,20130125,16200,16200,16305,16305,16305,16305,16305,105,105,2,16.31,8
,20130128,16305,16305,16390,16425,16215,16375,16365,70,60,30,245.53,14
,20130129,16375,16365,,,,16365,16365,0,0,0,0,14
,20130130,16365,16365,16500,16600,16500,16600,16530,235,165,6,49.6,20
,20130131,16600,16530,16705,16705,16705,16705,16705,175,175,2,16.71,22
,20130201,16705,16705,16755,16755,16680,16680,16705,-25,0,6,50.12,18
,20130204,16680,16705,16815,16850,16765,16765,16815,60,110,8,67.27,22
,20130205,16765,16815,16790,16800,16775,16790,16785,-25,-30,8,67.16,18
,20130206,16790,16785,16755,16755,16755,16755,16755,-30,-30,2,16.76,20
,20130207,16755,16755,16585,16660,16585,16660,16630,-95,-125,6,49.9,20
,20130208,16660,16630,,,,16630,16630,0,0,0,0,20
,20130218,16630,16630,,,,16535,16535,-95,-95,0,0,20
,20130219,16535,16535,16570,16570,16565,16565,16565,30,30,42,347.89,60
,20130220,16565,16565,16510,16510,16510,16510,16510,-55,-55,2,16.51,62
,20130221,16510,16510,16525,16525,16430,16430,16480,-80,-30,14,115.37,60
,20130222,16430,16480,16460,16465,16460,16465,16460,-15,-20,4,32.93,56
,20130225,16465,16460,16280,16280,16260,16260,16265,-200,-195,10,81.35,60
,20130226,16260,16265,,,,16265,16265,0,0,0,0,60
,20130227,16265,16265,16375,16375,16305,16325,16330,60,65,8,65.32,58
,20130228,16325,16330,16300,16300,16300,16300,16300,-30,-30,2,16.3,60
,20130301,16300,16300,16160,16160,16110,16110,16130,-190,-170,18,145.19,66
,20130304,16110,16130,15965,15965,15920,15935,15930,-195,-200,18,143.41,68
,20130305,15935,15930,16005,16040,16005,16040,16025,110,95,30,240.42,70
,20130306,16040,16025,15975,15975,15945,15965,15955,-60,-70,20,159.59,76
,20130307,15965,15955,15800,15850,15780,15850,15805,-105,-150,22,173.86,86
,20130308,15850,15805,15855,15890,15840,15880,15860,75,55,18,142.75,76
,20130311,15880,15860,15785,15785,15755,15760,15765,-100,-95,10,78.84,80
,20130312,15760,15765,15730,15785,15710,15710,15735,-55,-30,32,251.78,88
,20130313,15710,15735,15730,15765,15730,15765,15750,30,15,8,63.01,84
,20130314,15765,15750,15640,15680,15610,15680,15640,-70,-110,10,78.22,84
,20130315,15680,15640,15775,15810,15765,15805,15785,165,145,10,78.94,86
,20130318,15805,15785,15615,15615,15325,15390,15425,-395,-360,20,154.3,88
,20130319,15390,15425,15380,15410,15330,15330,15370,-95,-55,38,292.07,108
,20130320,15330,15370,,,,15380,15380,10,10,0,0,108
,20130321,15380,15380,15460,15535,15460,15530,15505,150,125,10,77.54,110
,20130322,15530,15505,15455,15465,15415,15415,15445,-90,-60,6,46.34,110
,20130325,15415,15445,,,,15490,15490,45,45,0,0,110
,20130326,15490,15490,,,,15490,15490,0,0,0,0,110
,20130327,15490,15490,15475,15475,15330,15330,15375,-160,-115,12,92.26,110
,20130328,15330,15375,15340,15340,15290,15290,15300,-85,-75,8,61.21,110
,20130329,15290,15300,15245,15245,15195,15195,15225,-105,-75,6,45.69,110
,20130401,15195,15225,15080,15085,15075,15080,15080,-145,-145,16,120.64,122
,20130402,15080,15080,15145,15145,15115,15145,15135,65,55,6,45.41,122
,20130403,15145,15135,15020,15050,14950,14950,15015,-185,-120,22,165.17,124
,20130408,14950,15015,15010,15020,14975,15020,14985,5,-30,16,119.89,122
,20130409,15020,14985,15135,15230,15130,15230,15170,245,185,18,136.54,122
,20130410,15230,15170,15235,15235,15200,15210,15215,40,45,20,152.16,136
,20130411,15210,15215,15245,15245,15190,15190,15200,-25,-15,14,106.4,136
,20130412,15190,15200,,,,15195,15195,-5,-5,0,0,136
,20130415,15195,15195,14940,14950,14795,14795,14900,-400,-295,44,327.87,148
,20130416,14795,14900,14685,14920,14685,14920,14790,20,-110,30,221.87,170
,20130417,14920,14790,14875,14925,14835,14865,14865,75,75,38,282.52,170
,20130418,14865,14865,14550,14650,14550,14600,14600,-265,-265,118,861.41,204
,20130419,14600,14600,14660,14935,14660,14830,14785,230,185,52,384.43,212
,20130422,14830,14785,14865,14915,14790,14850,14880,65,95,70,520.86,246
,20130423,14850,14880,14890,14925,14860,14860,14895,-20,15,16,119.16,246
,20130424,14860,14895,14610,14935,14610,14920,14825,25,-70,42,311.34,234
,20130425,14920,14825,14970,15035,14970,15010,15015,185,190,10,75.09,230
,20130426,15010,15015,15085,15130,15085,15120,15115,105,100,20,151.15,218
,20130502,15120,15115,14600,14720,14600,14700,14695,-415,-420,30,220.46,230
,20130503,14700,14695,14655,14750,14655,14750,14725,55,30,56,412.35,236
,20130506,14750,14725,14950,14995,14900,14900,14935,175,210,24,179.26,236
,20130507,14900,14935,14930,14930,14770,14770,14875,-165,-60,6,44.63,232
,20130508,14770,14875,14840,14890,14805,14890,14840,15,-35,60,445.23,274
,20130509,14890,14840,14865,14865,14840,14840,14855,0,15,10,74.28,282
,20130510,14840,14855,14715,14845,14715,14845,14765,-10,-90,32,236.31,294
,20130513,14845,14765,14800,14800,14755,14780,14775,15,10,6,44.34,292
,20130514,14780,14775,14830,14830,14715,14720,14760,-55,-15,16,118.1,294
,20130515,14720,14760,14720,14720,14615,14615,14675,-145,-85,24,176.11,306
,20130516,14615,14675,14550,14625,14550,14625,14575,-50,-100,6,43.73,306
,20130517,14625,14575,14575,14685,14570,14685,14635,110,60,22,160.99,310
,20130520,14685,14635,14600,14625,14505,14625,14570,-10,-65,38,276.92,312
,20130521,14625,14570,14645,14715,14630,14630,14660,60,90,12,87.96,306
,20130522,14630,14660,14690,14730,14690,14730,14700,70,40,8,58.81,304
,20130523,14730,14700,14730,14730,14600,14600,14655,-100,-45,62,454.39,336
,20130524,14600,14655,14655,14745,14655,14745,14685,90,30,6,44.06,334
,20130527,14745,14685,,,,14685,14685,0,0,0,0,334
,20130528,14685,14685,14725,14725,14705,14705,14715,20,30,4,29.43,334
,20130529,14705,14715,,,,14715,14715,0,0,0,0,334
,20130530,14715,14715,14815,14815,14755,14800,14785,85,70,30,221.78,334
,20130531,14800,14785,14985,14985,14905,14905,14925,120,140,22,164.21,338
,20130603,14905,14925,15195,15195,14975,14975,15035,50,110,18,135.36,340
,20130604,14975,15035,15005,15145,14950,14965,14980,-70,-55,104,779.17,396
,20130605,14965,14980,15040,15080,15015,15080,15035,100,55,198,"1,488.95",578
,20130606,15080,15035,14940,15030,14940,14975,14960,-60,-75,44,329.21,570
,20130607,14975,14960,14990,14990,14950,14975,14970,15,10,18,134.77,570
,20130613,14975,14970,14630,14785,14630,14695,14720,-275,-250,232,"1,707.65",616
,20130614,14695,14720,14675,14695,14625,14695,14665,-25,-55,112,821.36,722
,20130617,14695,14665,14765,14765,14705,14730,14710,65,45,120,882.81,774
,20130618,14730,14710,14680,14685,14650,14650,14660,-60,-50,86,630.57,834
,20130619,14650,14660,14645,14650,14635,14650,14640,-10,-20,82,600.34,898
,20130620,14650,14640,14600,14600,14455,14485,14535,-155,-105,60,436.09,910
,20130621,14485,14535,14465,14590,14400,14560,14525,25,-10,174,"1,263.90",982
,20130624,14560,14525,14625,14625,14400,14400,14505,-125,-20,536,"3,887.44",1168
,20130625,14400,14505,14460,14505,14360,14505,14450,0,-55,68,491.32,1196
,20130626,14505,14450,14525,14555,14400,14415,14445,-35,-5,220,"1,589.28",1278
,20130627,14415,14445,14460,14505,14440,14490,14480,45,35,60,434.51,1302
,20130628,14490,14480,14525,14525,14475,14505,14495,25,15,170,"1,232.44",1308
,20130701,14505,14495,14550,14630,14550,14610,14580,115,85,94,685.41,1324
,20130702,14610,14580,14625,14740,14625,14740,14685,160,105,40,293.74,1322
,20130703,14740,14685,14675,14745,14650,14725,14700,40,15,158,"1,161.65",1358
,20130704,14725,14700,14655,14660,14620,14630,14635,-70,-65,156,"1,141.91",1372
,20130705,14630,14635,14590,14680,14550,14550,14575,-85,-60,166,"1,210.01",1394
,20130708,14550,14575,14515,14515,14480,14485,14490,-90,-85,134,971.1,1440
,20130709,14485,14490,14580,14615,14545,14600,14585,110,95,246,"1,794.06",1528
,20130710,14600,14585,14520,14610,14520,14610,14575,25,-10,92,670.58,1574
,20130711,14610,14575,14830,14910,14710,14845,14810,270,235,746,"5,524.58",1818
,20130712,14845,14810,14845,14845,14700,14720,14745,-90,-65,992,"7,314.44",2594
,20130715,14720,14745,14710,14780,14710,14755,14760,10,15,170,"1,254.85",2670
,20130716,14755,14760,14750,14765,14700,14760,14745,0,-15,292,"2,153.24",2770
,20130717,14760,14745,14735,14750,14675,14685,14710,-60,-35,70,514.93,2780
,20130718,14685,14710,14600,14605,14550,14580,14580,-130,-130,324,"2,362.18",2974
,20130719,14580,14580,14615,14625,14540,14540,14590,-40,10,354,"2,582.84",2908
,20130722,14540,14590,14620,14690,14600,14690,14660,100,70,1310,"9,604.83",3984
,20130723,14690,14660,14700,14720,14640,14680,14680,20,20,626,"4,594.91",3964
,20130724,14680,14680,14695,14720,14650,14695,14690,15,10,336,"2,468.19",4046
,20130725,14695,14690,14680,14770,14645,14760,14720,70,30,320,"2,355.87",4142
,20130726,14760,14720,14705,14720,14640,14665,14695,-55,-25,632,"4,644.36",4592
,20130729,14665,14695,14540,14610,14540,14560,14570,-135,-125,324,"2,360.59",4674
,20130730,14560,14570,14525,14575,14505,14510,14550,-60,-20,260,"1,891.67",4770
,20130731,14510,14550,14470,14530,14455,14525,14495,-25,-55,928,"6,726.76",5318
,20130801,14525,14495,14545,15020,14535,14565,14595,70,100,2448,"17,865.42",6398
,20130802,14565,14595,14590,14590,14545,14550,14565,-45,-30,1648,"12,003.14",7540
,20130805,14550,14565,14590,14650,14585,14650,14625,85,60,1150,"8,410.72",8194
,20130806,14650,14625,14605,14635,14600,14635,14615,10,-10,452,"3,303.72",8468
,20130807,14635,14615,14590,14590,14560,14570,14570,-45,-45,1058,"7,709.31",8826
,20130808,14570,14570,14600,14735,14600,14695,14640,125,70,3338,"24,435.95",10166
,20130809,14695,14640,14780,14785,14715,14750,14760,110,120,2150,"15,869.52",10914
,20130812,14750,14760,14930,14975,14870,14970,14945,210,185,4614,"34,478.58",12138
,20130813,14970,14945,14945,14955,14885,14930,14910,-15,-35,2720,"20,281.59",12182
,20130814,14930,14910,14900,14930,14845,14880,14880,-30,-30,5010,"37,285.27",12814
,20130815,14880,14880,14930,14980,14905,14945,14940,65,60,3910,"29,209.84",13296
,20130816,14945,14940,14965,15290,14965,15230,15170,290,230,7912,"60,025.49",16172
,20130819,15230,15170,15375,15375,15200,15245,15250,75,80,7668,"58,486.37",17950
,20130820,15245,15250,15215,15230,15025,15035,15115,-215,-135,5984,"45,233.39",17518
,20130821,15035,15115,15060,15140,15060,15110,15105,-5,-10,6208,"46,899.11",18698
,20130822,15110,15105,15010,15190,14950,15180,15075,75,-30,5376,"40,534.54",20020
,20130823,15180,15075,15110,15220,15080,15130,15150,55,75,6512,"49,340.78",21602
,20130826,15130,15150,15330,15330,15205,15245,15240,95,90,5848,"44,574.55",22572
,20130827,15245,15240,15205,15225,15140,15150,15175,-90,-65,5198,"39,448.12",23934
,20130828,15150,15175,15130,15230,15055,15075,15150,-100,-25,8618,"65,294.52",26116
,20130829,15075,15150,15010,15050,14965,15000,15005,-150,-145,7846,"58,878.00",26828
,20130830,15000,15005,14945,14955,14855,14875,14915,-130,-90,12044,"89,818.57",29064
,20130902,14875,14915,14855,15000,14835,14955,14935,40,20,10450,"78,056.84",30748
,20130903,14955,14935,14955,14960,14875,14905,14915,-30,-20,9504,"70,884.62",34068
,20130904,14905,14915,14885,14905,14800,14810,14850,-105,-65,8022,"59,578.32",35722
,20130905,14810,14850,14720,14775,14700,14700,14730,-150,-120,24090,"177,466.32",44516
,20130906,14700,14730,14730,14780,14685,14775,14735,45,5,12726,"93,763.59",46298
,20130909,14775,14735,14815,14910,14805,14890,14865,155,130,21846,"162,374.04",54978
,20130910,14890,14865,14820,14825,14745,14765,14775,-100,-90,16492,"121,838.64",58162
,20130911,14765,14775,14765,14790,14745,14780,14770,5,-5,13016,"96,132.10",62744
,20130912,14780,14770,14750,14750,14665,14695,14710,-75,-60,18908,"139,104.61",67122
,20130913,14695,14710,14705,14810,14705,14805,14740,95,30,24994,"184,261.92",73706
,20130916,14805,14740,14775,14785,14665,14665,14705,-75,-35,24968,"183,617.20",76088
,20130917,14665,14705,14675,14685,14610,14680,14645,-25,-60,22230,"162,788.04",80218
,20130918,14680,14645,14640,14690,14625,14680,14655,35,10,19046,"139,575.17",86388
,20130923,14680,14655,14650,14725,14610,14715,14660,60,5,25226,"184,961.27",93768
,20130924,14715,14660,14760,14775,14710,14725,14740,65,80,20996,"154,753.82",94138
,20130925,14725,14740,14720,14780,14710,14760,14750,20,10,24612,"181,546.61",98500
,20130926,14760,14750,14770,14795,14720,14795,14760,45,10,24244,"178,979.38",102316
,20130927,14795,14760,14795,14815,14755,14785,14770,25,10,18386,"135,800.14",99560
,20130930,14785,14770,14810,14890,14760,14870,14840,100,70,26382,"195,785.21",99940
,20131008,14870,14840,14735,14785,14705,14765,14735,-75,-105,28132,"207,298.75",106016
,20131009,14765,14735,14780,14820,14760,14785,14790,50,55,31216,"230,855.32",115268
,20131010,14785,14790,14750,14850,14730,14845,14800,55,10,36180,"267,756.20",128270
,20131011,14845,14800,14865,14970,14860,14945,14930,145,130,74154,"553,580.41",144922
,20131014,14945,14930,14960,14995,14885,14980,14955,50,25,43832,"327,830.05",149166
,20131015,14980,14955,15025,15030,14915,14945,14975,-10,20,49856,"373,324.84",145564
,20131016,14945,14975,14960,14970,14865,14935,14915,-40,-60,47596,"355,033.15",139420
,20131017,14935,14915,14975,15005,14865,14890,14920,-25,5,41696,"311,094.70",130306
,20131018,14890,14920,14930,14985,14930,14950,14960,30,40,37274,"278,854.99",129018
,20131021,14950,14960,14960,15120,14910,15115,15045,155,85,92234,"693,998.65",152598
,20131022,15115,15045,15080,15110,15050,15095,15075,50,30,46916,"353,665.46",152892
,20131023,15095,15075,15150,15160,15040,15040,15095,-35,20,62016,"468,093.12",136990
,20131024,15040,15095,15000,15020,14930,15015,14985,-80,-110,40124,"300,724.31",131654
,20131025,15015,14985,15015,15095,14950,14950,15015,-35,30,57282,"430,067.97",129156
,20131028,14950,15015,15030,15100,15020,15070,15060,55,45,48040,"361,768.28",132056
,20131029,15070,15060,15105,15150,15065,15145,15100,85,40,53706,"405,606.88",130554
,20131030,15145,15100,15120,15225,15105,15180,15170,80,70,70756,"536,767.62",142670
,20131031,15180,15170,15160,15160,14560,14990,14965,-180,-205,109874,"822,216.95",115394
,20131101,14990,14965,14970,15085,14940,15075,15020,110,55,27142,"203,874.14",115302
,20131104,15075,15020,14990,15030,14970,15010,14995,-10,-25,30458,"228,428.37",111978
,20131105,15010,14995,14990,15005,14965,14980,14980,-15,-15,18908,"141,648.88",108622
,20131106,14980,14980,14965,15015,14965,14980,14985,0,5,20568,"154,132.75",107898
,20131107,14980,14985,14940,14990,14920,14975,14965,-10,-20,18098,"135,443.64",109544
,20131108,14975,14965,14930,14950,14930,14950,14940,-15,-25,21340,"159,410.87",106932
,20131111,14950,14940,14975,14985,14910,14920,14935,-20,-5,20442,"152,663.49",106330
,20131112,14920,14935,14900,14905,14835,14845,14855,-90,-80,31826,"236,454.23",101146
,20131113,14845,14855,14810,14835,14765,14765,14790,-90,-65,24452,"180,848.82",98758
,20131114,14765,14790,14790,14850,14775,14830,14820,40,30,21984,"162,934.96",90482
,20131115,14830,14820,14820,14860,14810,14810,14835,-10,15,14852,"110,173.75",89696
,20131118,14810,14835,14825,14875,14825,14845,14850,10,15,11584,"86,038.08",85040
,20131119,14845,14850,14830,14830,14775,14790,14795,-60,-55,13962,"103,315.54",82050
,20131120,14790,14795,14820,14885,14820,14880,14860,85,65,9052,"67,271.98",77700
,20131121,14880,14860,14855,14855,14805,14820,14815,-40,-45,8438,"62,519.63",74392
,20131122,14820,14815,14835,14870,14820,14835,14835,20,20,4626,"34,317.64",73380
,20131125,14835,14835,14900,14925,14835,14840,14875,5,40,7542,"56,110.40",70946
,20131126,14840,14875,14840,14870,14835,14850,14855,-25,-20,6124,"45,486.59",67962
,20131127,14850,14855,14820,14840,14800,14810,14815,-45,-40,7218,"53,480.12",64104
,20131128,14810,14815,14765,14795,14755,14770,14770,-45,-45,7618,"56,263.49",61942
,20131129,14770,14770,14820,14820,14745,14750,14765,-20,-5,12290,"90,750.65",54850
,20131202,14750,14765,14790,14805,14760,14790,14775,25,10,8326,"61,517.59",51026
,20131203,14790,14775,14790,14790,14750,14755,14765,-20,-10,4188,"30,918.50",48746
,20131204,14755,14765,14775,14790,14760,14765,14775,0,10,6330,"46,766.76",44690
,20131205,14765,14775,14825,14835,14800,14810,14810,35,35,8656,"64,112.30",38414
,20131206,14810,14810,14810,14850,14805,14850,14820,40,10,3566,"26,427.78",35356
,20131209,14850,14820,14850,14875,14835,14860,14855,40,35,5866,"43,574.23",31736
,20131210,14860,14855,14920,14965,14920,14965,14940,110,85,9432,"70,476.71",26598
,20131211,14965,14940,15060,15060,14970,14995,15010,55,70,7412,"55,629.99",21308
,20131212,14995,15010,15110,15110,15065,15080,15075,70,65,6784,"51,140.02",17120
,20131213,15080,15075,15050,15055,15000,15005,15020,-70,-55,3688,"27,699.59",14970
,20131216,15005,15020,15095,15100,15055,15070,15065,50,45,4436,"33,422.21",13168
,20131217,15070,15065,15125,15125,15085,15085,15100,20,35,3702,"27,952.61",11228
,20131218,15085,15100,15085,15105,15050,15060,15070,-40,-30,1556,"11,724.68",10420
,20131219,15060,15070,15060,15090,15045,15050,15050,-20,-20,1962,"14,766.81",9674
,20131220,15050,15050,15040,15160,15030,15095,15100,45,50,3572,"26,970.40",8520
,20131223,15095,15100,15200,15225,15105,15120,15160,20,60,3992,"30,259.64",7990
,20131224,15120,15160,15165,15215,15125,15200,15165,40,5,728,"5,521.29",7892
,20131225,15200,15165,15215,15345,15215,15320,15290,155,125,1700,"12,997.90",7734
,20131226,15320,15290,15360,15360,15105,15130,15200,-160,-90,1416,"10,763.99",7430
,20131227,15130,15200,15160,15205,14995,15185,15145,-15,-55,522,"3,954.02",7408
,20131230,15185,15145,15230,15250,15140,15175,15180,30,35,1268,"9,624.74",7004
,20131231,15175,15180,15140,15195,15115,15140,15145,-40,-35,894,"6,771.19",6640
zn1402,20130219,16535,16535,16665,16665,16625,16625,16645,90,110,4,33.29,4
,20130220,16625,16645,,,,16645,16645,0,0,0,0,4
,20130221,16645,16645,16380,16380,16380,16380,16380,-265,-265,2,16.38,6
,20130222,16380,16380,,,,16360,16360,-20,-20,0,0,6
,20130225,16360,16360,16330,16330,16330,16330,16330,-30,-30,2,16.33,6
,20130226,16330,16330,,,,16330,16330,0,0,0,0,6
,20130227,16330,16330,16430,16430,16430,16430,16430,100,100,2,16.43,6
,20130228,16430,16430,16400,16400,16400,16400,16400,-30,-30,2,16.4,8
,20130301,16400,16400,16135,16135,16130,16130,16130,-270,-270,4,32.27,8
,20130304,16130,16130,,,,16070,16070,-60,-60,0,0,8
,20130305,16070,16070,16095,16095,16095,16095,16095,25,25,2,16.1,8
,20130306,16095,16095,16065,16065,16065,16065,16065,-30,-30,2,16.07,8
,20130307,16065,16065,15845,15845,15845,15845,15845,-220,-220,6,47.54,12
,20130308,15845,15845,15900,15910,15900,15910,15905,65,60,12,95.44,14
,20130311,15910,15905,15885,15885,15770,15770,15820,-135,-85,30,237.33,34
,20130312,15770,15820,15765,15765,15750,15750,15755,-70,-65,4,31.52,38
,20130313,15750,15755,15820,15835,15790,15790,15815,35,60,6,47.45,40
,20130314,15790,15815,15695,15775,15675,15775,15690,-40,-125,16,125.55,48
,20130315,15775,15690,15755,15870,15755,15855,15815,165,125,22,174,62
,20130318,15855,15815,15430,15455,15385,15385,15420,-430,-395,40,308.42,98
,20130319,15385,15420,15440,15455,15380,15380,15435,-40,15,10,77.19,98
,20130320,15380,15435,15365,15455,15365,15455,15410,20,-25,4,30.82,100
,20130321,15455,15410,,,,15515,15515,105,105,0,0,100
,20130322,15515,15515,15500,15505,15500,15505,15500,-10,-15,6,46.51,100
,20130325,15505,15500,,,,15550,15550,50,50,0,0,100
,20130326,15550,15550,15500,15500,15500,15500,15500,-50,-50,4,31,100
,20130327,15500,15500,15420,15420,15420,15420,15420,-80,-80,2,15.42,98
,20130328,15420,15420,,,,15345,15345,-75,-75,0,0,98
,20130329,15345,15345,15105,15270,15105,15270,15175,-75,-170,6,45.54,100
,20130401,15270,15175,15200,15200,15085,15145,15125,-30,-50,16,121.01,100
,20130402,15145,15125,,,,15125,15125,0,0,0,0,100
,20130403,15125,15125,15085,15085,15085,15085,15085,-40,-40,2,15.09,102
,20130408,15085,15085,15070,15070,15070,15070,15070,-15,-15,2,15.07,102
,20130409,15070,15070,15240,15240,15210,15210,15230,140,160,8,60.93,100
,20130410,15210,15230,15295,15295,15295,15295,15295,65,65,12,91.77,112
,20130411,15295,15295,15230,15230,15230,15230,15230,-65,-65,2,15.23,112
,20130412,15230,15230,15200,15200,15200,15200,15200,-30,-30,2,15.2,114
,20130415,15200,15200,14990,15010,14755,14800,14900,-400,-300,40,298.05,122
,20130416,14800,14900,14640,14965,14640,14965,14820,65,-80,32,237.12,138
,20130417,14965,14820,14965,14965,14885,14885,14915,65,95,8,59.67,138
,20130418,14885,14915,14650,14680,14415,14635,14580,-280,-335,28,204.17,140
,20130419,14635,14580,14815,14860,14795,14860,14820,280,240,26,192.67,138
,20130422,14860,14820,14890,14905,14860,14860,14875,40,55,12,89.28,146
,20130423,14860,14875,14845,14845,14845,14845,14845,-30,-30,2,14.85,146
,20130424,14845,14845,14930,14930,14930,14930,14930,85,85,2,14.93,148
,20130425,14930,14930,15075,15130,15065,15130,15095,200,165,10,75.48,150
,20130426,15130,15095,15265,15265,15135,15190,15195,95,100,26,197.6,150
,20130502,15190,15195,14655,14795,14655,14795,14745,-400,-450,30,221.18,148
,20130503,14795,14745,14810,14810,14810,14810,14810,65,65,6,44.43,146
,20130506,14810,14810,14965,15025,14965,14985,14990,175,180,6,44.98,146
,20130507,14985,14990,14935,14935,14905,14905,14920,-85,-70,14,104.47,150
,20130508,14905,14920,14935,14935,14925,14925,14925,5,5,10,74.65,150
,20130509,14925,14925,14925,14925,14920,14920,14920,-5,-5,4,29.85,150
,20130510,14920,14920,14860,14875,14860,14875,14865,-45,-55,4,29.74,148
,20130513,14875,14865,14830,14865,14830,14865,14845,0,-20,4,29.7,146
,20130514,14865,14845,14800,14800,14800,14800,14800,-45,-45,2,14.8,144
,20130515,14800,14800,14760,14760,14710,14710,14725,-90,-75,6,44.18,142
,20130516,14710,14725,14605,14630,14605,14630,14610,-95,-115,8,58.45,140
,20130517,14630,14610,,,,14665,14665,55,55,0,0,140
,20130520,14665,14665,14600,14600,14600,14600,14600,-65,-65,2,14.6,140
,20130521,14600,14600,,,,14600,14600,0,0,0,0,140
,20130522,14600,14600,14710,14710,14710,14710,14710,110,110,4,29.42,144
,20130523,14710,14710,,,,14705,14705,-5,-5,0,0,144
,20130524,14705,14705,14750,14785,14750,14785,14765,80,60,14,103.36,144
,20130527,14785,14765,,,,14765,14765,0,0,0,0,144
,20130528,14765,14765,,,,14765,14765,0,0,0,0,144
,20130529,14765,14765,,,,14765,14765,0,0,0,0,144
,20130530,14765,14765,,,,14765,14765,0,0,0,0,144
,20130531,14765,14765,14940,14940,14940,14940,14940,175,175,14,104.58,144
,20130603,14940,14940,15025,15025,15025,15025,15025,85,85,6,45.08,144
,20130604,15025,15025,15025,15025,14995,14995,15010,-30,-15,18,135.11,144
,20130605,14995,15010,,,,15010,15010,0,0,0,0,144
,20130606,15010,15010,,,,15010,15010,0,0,0,0,144
,20130607,15010,15010,14975,15060,14975,15060,15015,50,5,4,30.04,144
,20130613,15060,15015,14830,14830,14750,14760,14765,-255,-250,42,310.15,156
,20130614,14760,14765,14700,14730,14700,14700,14715,-65,-50,40,294.33,176
,20130617,14700,14715,,,,14715,14715,0,0,0,0,176
,20130618,14715,14715,14740,14740,14690,14690,14715,-25,0,4,29.43,176
,20130619,14690,14715,14735,14735,14690,14690,14705,-25,-10,10,73.54,180
,20130620,14690,14705,14595,14610,14580,14580,14595,-125,-110,14,102.18,180
,20130621,14580,14595,14495,14625,14495,14625,14575,30,-20,42,306.09,206
,20130624,14625,14575,14575,14575,14430,14430,14525,-145,-50,48,348.69,224
,20130625,14430,14525,14490,14555,14415,14555,14470,30,-55,22,159.21,232
,20130626,14555,14470,14675,14675,14475,14475,14560,5,90,10,72.81,240
,20130627,14475,14560,,,,14560,14560,0,0,0,0,240
,20130628,14560,14560,14520,14520,14520,14520,14520,-40,-40,2,14.52,242
,20130701,14520,14520,14600,14600,14600,14600,14600,80,80,8,58.4,238
,20130702,14600,14600,14665,14730,14665,14730,14705,130,105,16,117.64,230
,20130703,14730,14705,14745,14745,14745,14745,14745,40,40,2,14.75,228
,20130704,14745,14745,14680,14700,14680,14700,14685,-45,-60,8,58.74,228
,20130705,14700,14685,14610,14610,14610,14610,14610,-75,-75,4,29.22,228
,20130708,14610,14610,,,,14540,14540,-70,-70,0,0,228
,20130709,14540,14540,14610,14610,14610,14610,14610,70,70,2,14.61,228
,20130710,14610,14610,14600,14620,14600,14620,14610,10,0,6,43.84,232
,20130711,14620,14610,14765,14905,14765,14880,14845,270,235,38,282.12,228
,20130712,14880,14845,,,,14765,14765,-80,-80,0,0,228
,20130715,14765,14765,14775,14775,14775,14775,14775,10,10,2,14.78,226
,20130716,14775,14775,14760,14760,14760,14760,14760,-15,-15,2,14.76,226
,20130717,14760,14760,,,,14760,14760,0,0,0,0,226
,20130718,14760,14760,14625,14635,14595,14595,14615,-165,-145,6,43.86,224
,20130719,14595,14615,14610,14610,14600,14600,14605,-15,-10,34,248.31,242
,20130722,14600,14605,14620,14660,14620,14650,14635,45,30,20,146.39,226
,20130723,14650,14635,14685,14685,14685,14685,14685,50,50,2,14.69,226
,20130724,14685,14685,,,,14685,14685,0,0,0,0,226
,20130725,14685,14685,,,,14685,14685,0,0,0,0,226
,20130726,14685,14685,14690,14690,14690,14690,14690,5,5,6,44.07,230
,20130729,14690,14690,14610,14610,14610,14610,14610,-80,-80,4,29.22,234
,20130730,14610,14610,14550,14550,14550,14550,14550,-60,-60,2,14.55,232
,20130731,14550,14550,,,,14550,14550,0,0,0,0,232
,20130801,14550,14550,,,,14550,14550,0,0,0,0,232
,20130802,14550,14550,,,,14520,14520,-30,-30,0,0,232
,20130805,14520,14520,14650,14670,14650,14670,14655,150,135,46,337.17,260
,20130806,14670,14655,14655,14655,14650,14655,14650,0,-5,38,278.44,296
,20130807,14655,14650,14600,14620,14600,14610,14600,-40,-50,16,116.84,298
,20130808,14610,14600,14685,14700,14670,14690,14685,90,85,20,146.89,308
,20130809,14690,14685,14785,14805,14755,14800,14785,115,100,116,857.55,376
,20130812,14800,14785,14955,14990,14940,14990,14955,205,170,72,538.55,426
,20130813,14990,14955,,,,14920,14920,-35,-35,0,0,426
,20130814,14920,14920,14875,14935,14875,14900,14910,-20,-10,38,283.35,432
,20130815,14900,14910,14995,14995,14945,14960,14975,50,65,12,89.86,436
,20130816,14960,14975,14980,15295,14980,15255,15225,280,250,352,"2,679.86",602
,20130819,15255,15225,15350,15355,15245,15265,15275,40,50,176,"1,344.51",632
,20130820,15265,15275,15225,15225,15080,15090,15140,-185,-135,98,741.98,634
,20130821,15090,15140,15125,15170,15110,15150,15130,10,-10,150,"1,134.86",688
,20130822,15150,15130,15055,15215,15010,15215,15115,85,-15,174,"1,315.32",698
,20130823,15215,15115,15160,15235,15120,15155,15175,40,60,108,819.55,726
,20130826,15155,15175,15280,15310,15255,15290,15285,115,110,246,"1,880.43",752
,20130827,15290,15285,15280,15280,15170,15170,15195,-115,-90,534,"4,057.83",808
,20130828,15170,15195,15170,15260,15100,15120,15165,-75,-30,228,"1,729.20",786
,20130829,15120,15165,15025,15070,15020,15035,15040,-130,-125,224,"1,684.56",854
,20130830,15035,15040,14975,14985,14900,14900,14955,-140,-85,378,"2,827.14",1096
,20130902,14900,14955,14955,15035,14915,15000,14970,45,15,570,"4,267.58",1356
,20130903,15000,14970,14985,14985,14925,14950,14955,-20,-15,524,"3,918.55",1482
,20130904,14950,14955,14950,14950,14850,14850,14885,-105,-70,550,"4,094.53",1722
,20130905,14850,14885,14785,14810,14735,14745,14760,-140,-125,770,"5,683.25",2154
,20130906,14745,14760,14745,14805,14720,14805,14780,45,20,272,"2,010.32",2188
,20130909,14805,14780,14865,14945,14865,14945,14900,165,120,166,"1,236.72",2194
,20130910,14945,14900,14840,14850,14790,14790,14805,-110,-95,264,"1,954.46",2282
,20130911,14790,14805,14820,14830,14780,14830,14805,25,0,160,"1,184.54",2386
,20130912,14830,14805,14765,14765,14700,14715,14725,-90,-80,452,"3,328.92",2618
,20130913,14715,14725,14740,14880,14740,14880,14770,155,45,520,"3,840.69",2750
,20130916,14880,14770,14790,14790,14690,14710,14740,-60,-30,824,"6,073.89",3296
,20130917,14710,14740,14670,14705,14640,14700,14675,-40,-65,1918,"14,073.61",4166
,20130918,14700,14675,14675,14720,14645,14720,14670,45,-5,1208,"8,862.03",4596
,20130923,14720,14670,14660,14740,14630,14715,14675,45,5,2816,"20,668.69",5982
,20130924,14715,14675,14770,14785,14725,14730,14755,55,80,3912,"28,864.22",7858
,20130925,14730,14755,14735,14790,14730,14755,14755,0,0,2286,"16,868.09",9098
,20130926,14755,14755,14775,14805,14740,14800,14760,45,5,1830,"13,509.70",9982
,20130927,14800,14760,14825,14825,14770,14800,14780,40,20,1110,"8,204.27",10078
,20130930,14800,14780,14820,14900,14805,14885,14860,105,80,1180,"8,768.39",10342
,20131008,14885,14860,14755,14790,14740,14790,14760,-70,-100,4100,"30,263.59",12754
,20131009,14790,14760,14800,14840,14785,14790,14805,30,45,3358,"24,864.49",14394
,20131010,14790,14805,14760,14865,14760,14865,14810,60,5,3282,"24,309.68",16320
,20131011,14865,14810,14880,14980,14880,14960,14940,150,130,10966,"81,932.95",22738
,20131014,14960,14940,14970,15000,14910,15000,14970,60,30,5564,"41,657.70",24792
,20131015,15000,14970,15050,15050,14925,14950,14985,-20,15,7282,"54,570.18",27950
,20131016,14950,14985,14955,14975,14875,14935,14920,-50,-65,9090,"67,817.49",31784
,20131017,14935,14920,15000,15005,14880,14905,14920,-15,0,9000,"67,148.54",31882
,20131018,14905,14920,14940,14990,14940,14960,14965,40,45,8530,"63,843.98",33820
,20131021,14960,14965,14860,15125,14860,15120,15055,155,90,16276,"122,537.15",39598
,20131022,15120,15055,15110,15110,15055,15100,15075,45,20,11274,"85,005.75",41328
,20131023,15100,15075,15160,15165,15050,15060,15095,-15,20,13830,"104,396.99",41220
,20131024,15060,15095,15000,15030,14960,15020,15000,-75,-95,10900,"81,756.44",41190
,20131025,15020,15000,15030,15095,14960,14970,15015,-30,15,10138,"76,119.82",41506
,20131028,14970,15015,15050,15095,15035,15070,15060,55,45,9570,"72,083.00",42786
,20131029,15070,15060,15105,15150,15070,15150,15105,90,45,15076,"113,884.37",44618
,20131030,15150,15105,15135,15220,15105,15175,15175,70,70,29120,"220,979.03",53822
,20131031,15175,15175,15165,15165,14575,15000,14975,-175,-200,34548,"258,697.31",49030
,20131101,15000,14975,14980,15090,14955,15080,15030,105,55,10372,"77,956.25",49682
,20131104,15080,15030,15030,15035,14975,15020,15005,-10,-25,14876,"111,610.95",53472
,20131105,15020,15005,14990,15010,14970,14990,14985,-15,-20,7184,"53,836.73",54592
,20131106,14990,14985,14985,15020,14960,14985,14990,0,5,7550,"56,601.74",55650
,20131107,14985,14990,14950,14995,14920,14975,14975,-15,-15,9316,"69,759.26",58896
,20131108,14975,14975,14930,14955,14920,14950,14945,-25,-30,16968,"126,801.17",65362
,20131111,14950,14945,14980,14985,14915,14925,14935,-20,-10,15014,"112,151.72",69286
,20131112,14925,14935,14905,14910,14835,14840,14855,-95,-80,24826,"184,449.42",80424
,20131113,14840,14855,14825,14835,14755,14755,14785,-100,-70,29122,"215,290.79",91238
,20131114,14755,14785,14785,14860,14780,14830,14825,45,40,29806,"221,001.61",91594
,20131115,14830,14825,14835,14865,14805,14805,14830,-20,5,30242,"224,315.47",98678
,20131118,14805,14830,14840,14880,14830,14865,14855,35,25,24056,"178,704.33",104014
,20131119,14865,14855,14790,14835,14775,14785,14795,-70,-60,31200,"230,819.31",112782
,20131120,14785,14795,14830,14895,14805,14870,14865,75,70,28246,"209,947.77",114024
,20131121,14870,14865,14845,14845,14790,14820,14810,-45,-55,27890,"206,545.19",116042
,20131122,14820,14810,14845,14850,14815,14830,14825,20,15,17812,"132,070.84",115646
,20131125,14830,14825,14900,14920,14830,14830,14870,5,45,19732,"146,740.25",115216
,20131126,14830,14870,14860,14860,14820,14840,14840,-30,-30,18896,"140,230.09",113956
,20131127,14840,14840,14800,14830,14790,14800,14805,-40,-35,19448,"143,977.69",118878
,20131128,14800,14805,14750,14780,14725,14760,14755,-45,-50,32644,"240,843.64",126296
,20131129,14760,14755,14780,14790,14735,14750,14750,-5,-5,32192,"237,462.25",131948
,20131202,14750,14750,14765,14785,14745,14785,14765,35,15,18010,"132,989.27",129698
,20131203,14785,14765,14750,14770,14730,14750,14745,-15,-20,19286,"142,198.94",133050
,20131204,14750,14745,14750,14780,14745,14755,14765,10,20,14562,"107,511.62",131422
,20131205,14755,14765,14815,14840,14790,14805,14805,40,40,20956,"155,149.82",123212
,20131206,14805,14805,14820,14850,14790,14840,14815,35,10,13542,"100,316.68",120358
,20131209,14840,14815,14840,14870,14830,14860,14845,45,30,15184,"112,737.82",117406
,20131210,14860,14845,14940,14980,14925,14970,14950,125,105,35632,"266,351.12",107672
,20131211,14970,14950,15050,15060,14930,15010,15015,60,65,35606,"267,324.26",94976
,20131212,15010,15015,15100,15100,15065,15080,15075,65,60,26632,"200,783.34",84900
,20131213,15080,15075,15060,15060,14990,15000,15015,-75,-60,30594,"229,718.15",74452
,20131216,15000,15015,15090,15095,15050,15070,15075,55,60,24070,"181,434.01",67528
,20131217,15070,15075,15120,15140,15085,15090,15110,15,35,27084,"204,642.76",60604
,20131218,15090,15110,15100,15125,15055,15070,15075,-40,-35,13742,"103,613.66",57274
,20131219,15070,15075,15070,15120,15055,15070,15070,-5,-5,14792,"111,479.55",55666
,20131220,15070,15070,15055,15205,15040,15110,15125,40,55,29702,"224,622.55",47182
,20131223,15110,15125,15250,15300,15135,15140,15195,15,70,16310,"123,941.20",41494
,20131224,15140,15195,15220,15250,15145,15235,15190,40,-5,12610,"95,794.43",38634
,20131225,15235,15190,15255,15400,15235,15350,15320,160,130,15250,"116,836.80",35886
,20131226,15350,15320,15380,15380,15145,15180,15245,-140,-75,9106,"69,412.21",32986
,20131227,15180,15245,15155,15250,15105,15225,15190,-20,-55,6670,"50,667.79",29954
,20131230,15225,15190,15295,15305,15180,15220,15220,30,30,9822,"74,765.94",24256
,20131231,15220,15220,15205,15240,15140,15160,15195,-60,-25,7306,"55,516.97",21046
zn1403,20130318,15815,15815,15815,15815,15465,15465,15625,-350,-190,42,328.17,20
,20130319,15465,15625,,,,15605,15605,-20,-20,0,0,20
,20130320,15605,15605,,,,15570,15570,-35,-35,0,0,20
,20130321,15570,15570,,,,15570,15570,0,0,0,0,20
,20130322,15570,15570,,,,15570,15570,0,0,0,0,20
,20130325,15570,15570,,,,15650,15650,80,80,0,0,20
,20130326,15650,15650,15600,15600,15595,15595,15595,-55,-55,4,31.2,20
,20130327,15595,15595,15465,15465,15465,15465,15465,-130,-130,4,30.93,20
,20130328,15465,15465,,,,15390,15390,-75,-75,0,0,20
,20130329,15390,15390,15390,15390,15390,15390,15390,0,0,4,30.78,24
,20130401,15390,15390,15200,15200,15170,15170,15175,-220,-215,20,151.79,40
,20130402,15170,15175,,,,15230,15230,55,55,0,0,40
,20130403,15230,15230,,,,15230,15230,0,0,0,0,40
,20130408,15230,15230,,,,15230,15230,0,0,0,0,40
,20130409,15230,15230,15230,15440,15230,15315,15315,85,85,12,91.9,40
,20130410,15315,15315,15370,15370,15365,15365,15365,50,50,4,30.74,44
,20130411,15365,15365,15290,15290,15290,15290,15290,-75,-75,2,15.29,42
,20130412,15290,15290,15315,15315,15315,15315,15315,25,25,8,61.26,42
,20130415,15315,15315,14910,14920,14860,14865,14885,-450,-430,14,104.2,50
,20130416,14865,14885,14735,14990,14735,14990,14800,105,-85,22,162.83,54
,20130417,14990,14800,14980,14980,14895,14945,14930,145,130,20,149.32,56
,20130418,14945,14930,14455,14525,14455,14525,14495,-405,-435,6,43.49,58
,20130419,14525,14495,14815,14955,14750,14815,14835,320,340,30,222.58,62
,20130422,14815,14835,14855,14970,14855,14970,14915,135,80,20,149.15,62
,20130423,14970,14915,14840,14840,14840,14840,14840,-75,-75,2,14.84,62
,20130424,14840,14840,,,,14840,14840,0,0,0,0,62
,20130425,14840,14840,15115,15115,15115,15115,15115,275,275,2,15.12,62
,20130426,15115,15115,15290,15290,15220,15230,15235,115,120,24,182.84,70
,20130502,15230,15235,,,,14780,14780,-455,-455,0,0,70
,20130503,14780,14780,14810,14875,14810,14870,14860,90,80,14,104.04,66
,20130506,14870,14860,14990,15080,14990,15080,15045,220,185,10,75.24,66
,20130507,15080,15045,15080,15080,15040,15040,15060,-5,15,4,30.12,66
,20130508,15040,15060,14990,15035,14965,15020,15000,-40,-60,28,210.05,76
,20130509,15020,15000,15000,15020,14915,14915,14985,-85,-15,24,179.84,78
,20130510,14915,14985,14915,14935,14880,14935,14915,-50,-70,10,74.59,80
,20130513,14935,14915,14865,14900,14865,14900,14875,-15,-40,30,223.15,92
,20130514,14900,14875,14915,14915,14810,14810,14890,-65,15,14,104.24,98
,20130515,14810,14890,14735,14735,14735,14735,14735,-155,-155,2,14.74,98
,20130516,14735,14735,14800,14800,14610,14650,14670,-85,-65,22,161.4,104
,20130517,14650,14670,,,,14720,14720,50,50,0,0,104
,20130520,14720,14720,14625,14690,14605,14690,14640,-30,-80,6,43.92,106
,20130521,14690,14640,14780,14780,14780,14780,14780,140,140,2,14.78,106
,20130522,14780,14780,,,,14780,14780,0,0,0,0,106
,20130523,14780,14780,14780,14780,14680,14680,14750,-100,-30,16,118,114
,20130524,14680,14750,14825,14840,14815,14840,14830,90,80,26,192.85,138
,20130527,14840,14830,,,,14830,14830,0,0,0,0,138
,20130528,14830,14830,,,,14830,14830,0,0,0,0,138
,20130529,14830,14830,14870,14870,14835,14835,14850,5,20,4,29.71,138
,20130530,14835,14850,,,,14850,14850,0,0,0,0,138
,20130531,14850,14850,14990,15020,14960,15020,14990,170,140,6,44.97,138
,20130603,15020,14990,,,,15075,15075,85,85,0,0,138
,20130604,15075,15075,15050,15050,15050,15050,15050,-25,-25,10,75.25,148
,20130605,15050,15050,15095,15100,15095,15100,15095,50,45,8,60.39,140
,20130606,15100,15095,15040,15040,15040,15040,15040,-55,-55,2,15.04,140
,20130607,15040,15040,15040,15040,15025,15040,15035,0,-5,6,45.11,138
,20130613,15040,15035,14760,14760,14760,14760,14760,-275,-275,2,14.76,138
,20130614,14760,14760,14705,14750,14705,14750,14735,-10,-25,6,44.21,140
,20130617,14750,14735,,,,14735,14735,0,0,0,0,140
,20130618,14735,14735,14795,14795,14745,14775,14770,40,35,6,44.32,142
,20130619,14775,14770,14730,14730,14730,14730,14730,-40,-40,2,14.73,142
,20130620,14730,14730,14595,14630,14545,14545,14580,-185,-150,28,204.14,152
,20130621,14545,14580,14550,14630,14550,14625,14600,45,20,14,102.23,154
,20130624,14625,14600,14565,14565,14490,14495,14535,-105,-65,10,72.68,156
,20130625,14495,14535,14525,14585,14440,14585,14495,50,-40,18,130.48,164
,20130626,14585,14495,14600,14600,14510,14510,14555,15,60,36,262.07,190
,20130627,14510,14555,14605,14605,14565,14565,14585,10,30,4,29.17,190
,20130628,14565,14585,14560,14560,14560,14560,14560,-25,-25,4,29.12,194
,20130701,14560,14560,,,,14560,14560,0,0,0,0,194
,20130702,14560,14560,14745,14745,14745,14745,14745,185,185,2,14.75,192
,20130703,14745,14745,14780,14780,14780,14780,14780,35,35,2,14.78,190
,20130704,14780,14780,,,,14780,14780,0,0,0,0,190
,20130705,14780,14780,14650,14650,14650,14650,14650,-130,-130,6,43.95,190
,20130708,14650,14650,14580,14580,14565,14580,14575,-70,-75,14,102.04,200
,20130709,14580,14575,14755,14755,14660,14700,14695,125,120,14,102.88,212
,20130710,14700,14695,,,,14695,14695,0,0,0,0,212
,20130711,14695,14695,14800,14985,14795,14940,14915,245,220,32,238.67,230
,20130712,14940,14915,14855,14855,14795,14795,14835,-120,-80,10,74.18,228
,20130715,14795,14835,14825,14825,14825,14825,14825,-10,-10,2,14.83,228
,20130716,14825,14825,14800,14800,14800,14800,14800,-25,-25,2,14.8,230
,20130717,14800,14800,14740,14740,14740,14740,14740,-60,-60,2,14.74,230
,20130718,14740,14740,14650,14650,14650,14650,14650,-90,-90,22,161.15,250
,20130719,14650,14650,14635,14635,14635,14635,14635,-15,-15,2,14.64,250
,20130722,14635,14635,14725,14725,14725,14725,14725,90,90,4,29.45,250
,20130723,14725,14725,14765,14765,14690,14730,14725,5,0,10,73.63,254
,20130724,14730,14725,,,,14725,14725,0,0,0,0,254
,20130725,14725,14725,14790,14790,14790,14790,14790,65,65,4,29.58,254
,20130726,14790,14790,14740,14740,14740,14740,14740,-50,-50,2,14.74,252
,20130729,14740,14740,14660,14660,14660,14660,14660,-80,-80,2,14.66,250
,20130730,14660,14660,14630,14630,14590,14590,14605,-70,-55,32,233.68,260
,20130731,14590,14605,14530,14530,14530,14530,14530,-75,-75,4,29.06,264
,20130801,14530,14530,14620,14620,14620,14620,14620,90,90,2,14.62,262
,20130802,14620,14620,14605,14605,14605,14605,14605,-15,-15,2,14.61,262
,20130805,14605,14605,14680,14695,14680,14695,14690,90,85,24,176.31,274
,20130806,14695,14690,14645,14645,14645,14645,14645,-45,-45,2,14.65,274
,20130807,14645,14645,,,,14645,14645,0,0,0,0,274
,20130808,14645,14645,14690,14725,14685,14725,14700,80,55,16,117.64,284
,20130809,14725,14700,14880,14880,14785,14785,14820,85,120,6,44.47,284
,20130812,14785,14820,15030,15030,15010,15010,15020,190,200,4,30.04,286
,20130813,15010,15020,14950,14995,14950,14995,14980,-25,-40,6,44.94,290
,20130814,14995,14980,14930,14930,14930,14930,14930,-50,-50,2,14.93,290
,20130815,14930,14930,14990,14990,14990,14990,14990,60,60,20,149.9,300
,20130816,14990,14990,15040,15305,15040,15305,15165,315,175,22,166.87,292
,20130819,15305,15165,15320,15320,15320,15320,15320,155,155,2,15.32,290
,20130820,15320,15320,15200,15200,15130,15130,15150,-190,-170,6,45.46,294
,20130821,15130,15150,15155,15155,15155,15155,15155,5,5,4,30.31,290
,20130822,15155,15155,15150,15165,15150,15165,15150,10,-5,22,166.67,288
,20130823,15165,15150,15160,15160,15160,15160,15160,10,10,2,15.16,288
,20130826,15160,15160,,,,15160,15160,0,0,0,0,288
,20130827,15160,15160,,,,15070,15070,-90,-90,0,0,288
,20130828,15070,15070,15120,15125,15120,15125,15120,55,50,6,45.37,288
,20130829,15125,15120,15115,15115,15010,15060,15060,-60,-60,72,542.22,340
,20130830,15060,15060,14995,15020,14965,14965,15000,-95,-60,272,"2,040.15",528
,20130902,14965,15000,15070,15070,15060,15060,15060,60,60,34,256.04,542
,20130903,15060,15060,14980,15000,14970,14970,14975,-90,-85,70,524.15,564
,20130904,14970,14975,14960,14960,14905,14905,14910,-70,-65,36,268.47,554
,20130905,14905,14910,14885,14885,14780,14800,14815,-110,-95,56,414.92,570
,20130906,14800,14815,14800,14845,14800,14845,14830,30,15,14,103.83,560
,20130909,14845,14830,14930,14975,14930,14975,14955,145,125,10,74.79,558
,20130910,14975,14955,14855,14870,14855,14860,14860,-95,-95,18,133.76,558
,20130911,14860,14860,14855,14870,14850,14870,14855,10,-5,16,118.85,562
,20130912,14870,14855,14800,14800,14755,14755,14790,-100,-65,90,665.77,572
,20130913,14755,14790,14800,14850,14780,14845,14805,55,15,160,"1,184.68",654
,20130916,14845,14805,14875,14875,14730,14730,14780,-75,-25,40,295.62,644
,20130917,14730,14780,14690,14700,14690,14690,14695,-90,-85,46,337.99,688
,20130918,14690,14695,14690,14730,14690,14720,14705,25,10,28,205.94,688
,20130923,14720,14705,14680,14740,14680,14740,14710,35,5,16,117.71,700
,20130924,14740,14710,14770,14800,14760,14760,14765,50,55,54,398.73,706
,20130925,14760,14765,14785,14785,14785,14785,14785,20,20,4,29.57,706
,20130926,14785,14785,14770,14800,14770,14800,14775,15,-10,10,73.88,696
,20130927,14800,14775,14800,14830,14800,14830,14805,55,30,64,473.81,670
,20130930,14830,14805,14875,14895,14865,14880,14875,75,70,10,74.39,668
,20131008,14880,14875,14770,14795,14765,14765,14780,-110,-95,106,783.4,684
,20131009,14765,14780,14825,14850,14820,14830,14835,50,55,162,"1,201.82",756
,20131010,14830,14835,14805,14880,14800,14880,14820,45,-15,48,355.77,778
,20131011,14880,14820,14950,14990,14935,14980,14965,160,145,654,"4,893.72",916
,20131014,14980,14965,14950,15015,14950,15000,14990,35,25,222,"1,664.00",1008
,20131015,15000,14990,15040,15055,14950,14980,15000,-10,10,558,"4,185.49",1308
,20131016,14980,15000,14995,14995,14895,14935,14925,-65,-75,706,"5,268.92",1848
,20131017,14935,14925,14990,14995,14890,14890,14935,-35,10,274,"2,046.74",1922
,20131018,14890,14935,14955,15000,14955,14985,14985,50,50,480,"3,597.21",2094
,20131021,14985,14985,14940,15125,14940,15120,15075,135,90,2012,"15,167.49",3098
,20131022,15120,15075,15100,15120,15070,15120,15100,45,25,1378,"10,406.29",3876
,20131023,15120,15100,15150,15170,15060,15060,15110,-40,10,468,"3,535.95",3814
,20131024,15060,15110,15030,15040,14980,15035,15015,-75,-95,1600,"12,013.78",4622
,20131025,15035,15015,15040,15090,14970,14970,15030,-45,15,2440,"18,337.53",5890
,20131028,14970,15030,15090,15100,15050,15070,15070,40,40,662,"4,989.05",6064
,20131029,15070,15070,15135,15150,15080,15145,15115,75,45,1930,"14,586.97",6572
,20131030,15145,15115,15045,15230,15045,15200,15180,85,65,1732,"13,149.63",7154
,20131031,15200,15180,15170,15170,14685,15020,14950,-160,-230,2676,"20,008.68",7652
,20131101,15020,14950,15000,15105,14975,15095,15035,145,85,1704,"12,812.55",7878
,20131104,15095,15035,15015,15040,14990,15030,15005,-5,-30,858,"6,438.66",8048
,20131105,15030,15005,15005,15015,14990,15010,15000,5,-5,520,"3,900.78",8378
,20131106,15010,15000,14990,15025,14990,15005,15010,5,10,1650,"12,385.10",9544
,20131107,15005,15010,14970,15010,14970,15000,14990,-10,-20,1030,"7,720.95",10088
,20131108,15000,14990,14960,14980,14955,14960,14965,-30,-25,1678,"12,556.03",10900
,20131111,14960,14965,14995,15005,14935,14950,14950,-15,-15,2118,"15,833.78",12366
,20131112,14950,14950,14925,14925,14850,14855,14875,-95,-75,4922,"36,608.91",15294
,20131113,14855,14875,14805,14840,14775,14775,14795,-100,-80,6370,"47,128.44",19322
,20131114,14775,14795,14790,14870,14790,14850,14840,55,45,6186,"45,911.81",22362
,20131115,14850,14840,14840,14875,14815,14820,14845,-20,5,3944,"29,274.55",23504
,20131118,14820,14845,14855,14880,14845,14880,14865,35,20,3242,"24,100.27",24504
,20131119,14880,14865,14805,14835,14780,14800,14800,-65,-65,5476,"40,533.79",27820
,20131120,14800,14800,14815,14890,14815,14880,14865,80,65,7320,"54,410.43",32092
,20131121,14880,14865,14840,14845,14795,14820,14810,-45,-55,11496,"85,132.57",33820
,20131122,14820,14810,14835,14845,14815,14830,14825,20,15,3506,"25,992.06",35066
,20131125,14830,14825,14890,14915,14835,14835,14870,10,45,5026,"37,374.55",36540
,20131126,14835,14870,14860,14860,14815,14845,14835,-25,-35,13552,"100,543.29",39948
,20131127,14845,14835,14800,14825,14790,14805,14805,-30,-30,8298,"61,433.14",44692
,20131128,14805,14805,14760,14780,14735,14775,14755,-30,-50,15218,"112,285.16",53602
,20131129,14775,14755,14775,14775,14735,14740,14750,-15,-5,8698,"64,167.79",57854
,20131202,14740,14750,14765,14785,14750,14775,14765,25,15,6948,"51,306.09",60864
,20131203,14775,14765,14760,14760,14725,14745,14740,-20,-25,8044,"59,299.94",64632
,20131204,14745,14740,14765,14775,14750,14750,14760,10,20,6086,"44,923.97",66916
,20131205,14750,14760,14810,14830,14795,14800,14805,40,45,11712,"86,700.38",69276
,20131206,14800,14805,14825,14840,14790,14840,14810,35,5,9822,"72,750.70",69248
,20131209,14840,14810,14830,14870,14830,14855,14845,45,35,11280,"83,750.11",70254
,20131210,14855,14845,14930,14980,14925,14970,14945,125,100,19062,"142,469.71",70358
,20131211,14970,14945,15030,15055,14970,15005,15010,60,65,21880,"164,247.01",65892
,20131212,15005,15010,15095,15095,15060,15080,15080,70,70,20360,"153,518.26",65578
,20131213,15080,15080,15070,15070,14990,15005,15015,-75,-65,19708,"147,962.88",63846
,20131216,15005,15015,15115,15115,15050,15065,15070,50,55,20810,"156,852.87",62552
,20131217,15065,15070,15130,15135,15095,15095,15110,25,40,31234,"236,010.63",66912
,20131218,15095,15110,15110,15125,15055,15070,15080,-40,-30,29574,"223,051.21",70112
,20131219,15070,15080,15070,15125,15050,15070,15075,-10,-5,34744,"261,882.98",74966
,20131220,15070,15075,15070,15245,15045,15120,15150,45,75,110058,"833,951.45",100076
,20131223,15120,15150,15280,15295,15150,15165,15225,15,75,130968,"997,109.32",102394
,20131224,15165,15225,15225,15280,15160,15260,15220,35,-5,103022,"784,090.50",113740
,20131225,15260,15220,15280,15465,15260,15405,15365,185,145,176742,"1,358,056.87",129096
,20131226,15405,15365,15410,15425,15180,15220,15300,-145,-65,129438,"990,415.99",114734
,20131227,15220,15300,15225,15280,15135,15260,15220,-40,-80,84914,"646,265.99",111752
,20131230,15260,15220,15295,15355,15215,15260,15290,40,70,99368,"759,855.97",113188
,20131231,15260,15290,15220,15285,15165,15195,15220,-95,-70,88138,"670,850.62",109006
zn1404,20130416,14885,14885,,,,14885,14885,0,0,0,0,0
,20130417,14885,14885,,,,15015,15015,130,130,0,0,0
,20130418,15015,15015,14650,14755,14400,14755,14595,-260,-420,26,189.8,6
,20130419,14755,14595,14930,14940,14930,14940,14935,345,340,4,29.87,4
,20130422,14940,14935,,,,14935,14935,0,0,0,0,4
,20130423,14935,14935,,,,14935,14935,0,0,0,0,4
,20130424,14935,14935,,,,14935,14935,0,0,0,0,4
,20130425,14935,14935,15300,15300,15300,15300,15300,365,365,2,15.3,6
,20130426,15300,15300,15125,15125,15125,15125,15125,-175,-175,2,15.13,8
,20130502,15125,15125,,,,15000,15000,-125,-125,0,0,8
,20130503,15000,15000,14860,15080,14860,15010,14960,10,-40,10,74.82,12
,20130506,15010,14960,15085,15125,14950,15065,15080,105,120,20,150.81,12
,20130507,15065,15080,,,,15080,15080,0,0,0,0,12
,20130508,15080,15080,15040,15040,15040,15040,15040,-40,-40,4,30.08,12
,20130509,15040,15040,,,,15040,15040,0,0,0,0,12
,20130510,15040,15040,,,,15020,15020,-20,-20,0,0,12
,20130513,15020,15020,,,,14975,14975,-45,-45,0,0,12
,20130514,14975,14975,,,,14900,14900,-75,-75,0,0,12
,20130515,14900,14900,,,,14800,14800,-100,-100,0,0,12
,20130516,14800,14800,14705,14710,14705,14710,14705,-90,-95,14,102.94,24
,20130517,14710,14705,14795,14795,14795,14795,14795,90,90,2,14.8,24
,20130520,14795,14795,14695,14705,14695,14705,14700,-90,-95,4,29.4,22
,20130521,14705,14700,,,,14700,14700,0,0,0,0,22
,20130522,14700,14700,,,,14760,14760,60,60,0,0,22
,20130523,14760,14760,14735,14735,14735,14735,14735,-25,-25,2,14.74,20
,20130524,14735,14735,,,,14800,14800,65,65,0,0,20
,20130527,14800,14800,14845,14845,14845,14845,14845,45,45,2,14.85,20
,20130528,14845,14845,,,,14845,14845,0,0,0,0,20
,20130529,14845,14845,,,,14845,14845,0,0,0,0,20
,20130530,14845,14845,,,,14845,14845,0,0,0,0,20
,20130531,14845,14845,15000,15000,15000,15000,15000,155,155,2,15,18
,20130603,15000,15000,15090,15115,15090,15115,15105,115,105,6,45.32,20
,20130604,15115,15105,,,,15105,15105,0,0,0,0,20
,20130605,15105,15105,,,,15105,15105,0,0,0,0,20
,20130606,15105,15105,,,,15105,15105,0,0,0,0,20
,20130607,15105,15105,,,,15105,15105,0,0,0,0,20
,20130613,15105,15105,14775,14775,14775,14775,14775,-330,-330,2,14.78,18
,20130614,14775,14775,,,,14775,14775,0,0,0,0,18
,20130617,14775,14775,,,,14775,14775,0,0,0,0,18
,20130618,14775,14775,14760,14760,14760,14760,14760,-15,-15,2,14.76,20
,20130619,14760,14760,,,,14760,14760,0,0,0,0,20
,20130620,14760,14760,14625,14625,14625,14625,14625,-135,-135,2,14.63,20
,20130621,14625,14625,14600,14650,14600,14645,14630,20,5,6,43.9,22
,20130624,14645,14630,,,,14540,14540,-90,-90,0,0,22
,20130625,14540,14540,,,,14500,14500,-40,-40,0,0,22
,20130626,14500,14500,14600,14600,14550,14550,14570,50,70,44,320.6,66
,20130627,14550,14570,14600,14600,14600,14600,14600,30,30,4,29.2,70
,20130628,14600,14600,,,,14600,14600,0,0,0,0,70
,20130701,14600,14600,,,,14720,14720,120,120,0,0,70
,20130702,14720,14720,14810,14810,14810,14810,14810,90,90,2,14.81,68
,20130703,14810,14810,,,,14810,14810,0,0,0,0,68
,20130704,14810,14810,14780,14780,14740,14740,14760,-70,-50,4,29.52,68
,20130705,14740,14760,14690,14690,14690,14690,14690,-70,-70,2,14.69,66
,20130708,14690,14690,14640,14640,14585,14590,14605,-100,-85,70,511.19,70
,20130709,14590,14605,14675,14675,14675,14675,14675,70,70,4,29.35,68
,20130710,14675,14675,14615,14675,14615,14675,14645,0,-30,4,29.29,68
,20130711,14675,14645,14950,14965,14950,14965,14955,320,310,6,44.87,68
,20130712,14965,14955,,,,14840,14840,-115,-115,0,0,68
,20130715,14840,14840,,,,14825,14825,-15,-15,0,0,68
,20130716,14825,14825,,,,14825,14825,0,0,0,0,68
,20130717,14825,14825,,,,14825,14825,0,0,0,0,68
,20130718,14825,14825,14700,14700,14700,14700,14700,-125,-125,20,147,88
,20130719,14700,14700,,,,14680,14680,-20,-20,0,0,88
,20130722,14680,14680,,,,14680,14680,0,0,0,0,88
,20130723,14680,14680,,,,14680,14680,0,0,0,0,88
,20130724,14680,14680,14770,14770,14770,14770,14770,90,90,2,14.77,88
,20130725,14770,14770,,,,14770,14770,0,0,0,0,88
,20130726,14770,14770,14750,14750,14750,14750,14750,-20,-20,8,59,94
,20130729,14750,14750,14735,14735,14735,14735,14735,-15,-15,4,29.47,98
,20130730,14735,14735,,,,14735,14735,0,0,0,0,98
,20130731,14735,14735,,,,14735,14735,0,0,0,0,98
,20130801,14735,14735,,,,14825,14825,90,90,0,0,98
,20130802,14825,14825,14635,14635,14635,14635,14635,-190,-190,2,14.64,98
,20130805,14635,14635,,,,14635,14635,0,0,0,0,98
,20130806,14635,14635,,,,14590,14590,-45,-45,0,0,98
,20130807,14590,14590,,,,14540,14540,-50,-50,0,0,98
,20130808,14540,14540,,,,14595,14595,55,55,0,0,98
,20130809,14595,14595,,,,14715,14715,120,120,0,0,98
,20130812,14715,14715,,,,14910,14910,195,195,0,0,98
,20130813,14910,14910,14985,14985,14970,14970,14975,60,65,6,44.94,96
,20130814,14970,14975,14960,14960,14960,14960,14960,-15,-15,2,14.96,96
,20130815,14960,14960,,,,15020,15020,60,60,0,0,96
,20130816,15020,15020,,,,15195,15195,175,175,0,0,96
,20130819,15195,15195,15365,15365,15365,15365,15365,170,170,4,30.73,96
,20130820,15365,15365,15305,15305,15305,15305,15305,-60,-60,10,76.53,102
,20130821,15305,15305,15240,15240,15210,15210,15230,-95,-75,12,91.4,104
,20130822,15210,15230,15200,15200,15175,15175,15190,-55,-40,26,197.53,94
,20130823,15175,15190,15270,15310,15270,15310,15300,120,110,12,91.8,102
,20130826,15310,15300,,,,15300,15300,0,0,0,0,102
,20130827,15300,15300,,,,15210,15210,-90,-90,0,0,102
,20130828,15210,15210,,,,15260,15260,50,50,0,0,102
,20130829,15260,15260,15130,15140,15080,15100,15120,-160,-140,30,226.82,118
,20130830,15100,15120,15035,15035,15035,15035,15035,-85,-85,2,15.04,116
,20130902,15035,15035,15080,15080,15030,15030,15055,-5,20,4,30.11,116
,20130903,15030,15055,,,,15055,15055,0,0,0,0,116
,20130904,15055,15055,14970,14970,14935,14935,14935,-120,-120,50,373.48,164
,20130905,14935,14935,14850,14855,14850,14855,14850,-80,-85,42,311.86,202
,20130906,14855,14850,14840,14890,14840,14860,14855,10,5,10,74.28,208
,20130909,14860,14855,14955,15015,14955,15015,14970,160,115,10,74.86,204
,20130910,15015,14970,14915,14915,14880,14880,14895,-90,-75,4,29.8,200
,20130911,14880,14895,,,,14895,14895,0,0,0,0,200
,20130912,14895,14895,14840,14840,14840,14840,14840,-55,-55,2,14.84,202
,20130913,14840,14840,,,,14855,14855,15,15,0,0,202
,20130916,14855,14855,,,,14830,14830,-25,-25,0,0,202
,20130917,14830,14830,14730,14730,14730,14730,14730,-100,-100,4,29.46,206
,20130918,14730,14730,14710,14745,14710,14745,14710,15,-20,22,161.85,198
,20130923,14745,14710,14745,14780,14745,14780,14760,70,50,8,59.05,202
,20130924,14780,14760,,,,14815,14815,55,55,0,0,202
,20130925,14815,14815,14825,14825,14825,14825,14825,10,10,2,14.83,202
,20130926,14825,14825,,,,14825,14825,0,0,0,0,202
,20130927,14825,14825,,,,14855,14855,30,30,0,0,202
,20130930,14855,14855,14925,14935,14925,14935,14925,80,70,8,59.71,202
,20131008,14935,14925,14825,14825,14825,14825,14825,-100,-100,24,177.9,204
,20131009,14825,14825,,,,14825,14825,0,0,0,0,204
,20131010,14825,14825,14840,14860,14840,14860,14845,35,20,30,222.7,234
,20131011,14860,14845,15010,15010,14985,14985,14990,140,145,6,44.98,238
,20131014,14985,14990,15030,15030,15030,15030,15030,40,40,2,15.03,238
,20131015,15030,15030,15000,15000,15000,15000,15000,-30,-30,2,15,240
,20131016,15000,15000,14920,14920,14920,14920,14920,-80,-80,2,14.92,242
,20131017,14920,14920,15010,15010,15010,15010,15010,90,90,2,15.01,242
,20131018,15010,15010,,,,15060,15060,50,50,0,0,242
,20131021,15060,15060,15085,15135,14985,15135,15100,75,40,90,679.54,286
,20131022,15135,15100,,,,15100,15100,0,0,0,0,286
,20131023,15100,15100,15100,15100,15100,15100,15100,0,0,2,15.1,288
,20131024,15100,15100,15075,15075,15015,15045,15040,-55,-60,30,225.63,280
,20131025,15045,15040,15000,15000,15000,15000,15000,-40,-40,2,15,278
,20131028,15000,15000,15095,15095,15095,15095,15095,95,95,2,15.1,278
,20131029,15095,15095,15130,15175,15105,15175,15135,80,40,22,166.53,294
,20131030,15175,15135,15150,15250,15150,15250,15235,115,100,62,472.31,326
,20131031,15250,15235,15180,15200,14905,15035,15070,-200,-165,196,"1,476.94",374
,20131101,15035,15070,15030,15140,15030,15135,15095,65,25,222,"1,675.71",450
,20131104,15135,15095,15050,15055,15025,15035,15035,-60,-60,66,496.25,460
,20131105,15035,15035,15040,15040,15015,15040,15025,5,-10,82,616.2,468
,20131106,15040,15025,15020,15055,15015,15040,15030,15,5,80,601.31,482
,20131107,15040,15030,15020,15035,15020,15020,15025,-10,-5,156,"1,172.16",544
,20131108,15020,15025,15015,15015,14980,14980,14985,-45,-40,138,"1,034.31",626
,20131111,14980,14985,14980,14980,14960,14960,14960,-25,-25,80,598.59,644
,20131112,14960,14960,14945,14945,14875,14885,14880,-75,-80,246,"1,830.85",746
,20131113,14885,14880,14825,14840,14800,14800,14815,-80,-65,132,977.82,790
,20131114,14800,14815,14845,14880,14845,14855,14855,40,40,976,"7,250.68",1618
,20131115,14855,14855,14850,14885,14840,14840,14880,-15,25,284,"2,113.10",1756
,20131118,14840,14880,14890,14890,14865,14880,14875,0,-5,216,"1,606.69",1904
,20131119,14880,14875,14810,14840,14795,14795,14820,-80,-55,386,"2,860.85",2106
,20131120,14795,14820,14865,14905,14865,14900,14885,80,65,594,"4,422.17",2204
,20131121,14900,14885,14835,14835,14805,14825,14815,-60,-70,668,"4,949.38",2270
,20131122,14825,14815,14830,14845,14820,14825,14830,10,15,332,"2,461.86",2408
,20131125,14825,14830,14850,14900,14850,14850,14870,20,40,280,"2,082.32",2534
,20131126,14850,14870,14830,14850,14825,14845,14840,-25,-30,1056,"7,836.14",2822
,20131127,14845,14840,14840,14840,14800,14815,14810,-25,-30,1150,"8,518.46",3410
,20131128,14815,14810,14775,14780,14750,14750,14765,-60,-45,1656,"12,226.43",4556
,20131129,14750,14765,14770,14770,14740,14750,14755,-15,-10,2214,"16,334.29",6216
,20131202,14750,14755,14780,14785,14750,14785,14775,30,20,1906,"14,080.79",7320
,20131203,14785,14775,14735,14770,14735,14740,14755,-35,-20,1504,"11,096.38",8050
,20131204,14740,14755,14740,14780,14740,14750,14770,-5,15,1050,"7,755.29",8734
,20131205,14750,14770,14850,14850,14795,14810,14810,40,40,2196,"16,261.56",10138
,20131206,14810,14810,14810,14840,14800,14835,14810,25,0,2056,"15,226.99",11256
,20131209,14835,14810,14830,14870,14830,14870,14855,60,45,2224,"16,519.26",12002
,20131210,14870,14855,14950,14970,14925,14970,14950,115,95,3098,"23,159.08",13450
,20131211,14970,14950,15060,15085,14970,15000,15020,50,70,3674,"27,593.30",13834
,20131212,15000,15020,15080,15090,15060,15090,15075,70,55,5464,"41,185.13",15890
,20131213,15090,15075,15045,15045,14990,15000,15005,-75,-70,3468,"26,025.34",15874
,20131216,15000,15005,15090,15100,15055,15070,15075,65,70,4626,"34,870.43",18050
,20131217,15070,15075,15125,15150,15095,15100,15110,25,35,5790,"43,745.92",19950
,20131218,15100,15110,15105,15135,15060,15065,15080,-45,-30,6448,"48,625.67",22776
,20131219,15065,15080,15075,15120,15055,15070,15085,-10,5,7202,"54,323.92",24886
,20131220,15070,15085,15075,15235,15060,15125,15155,40,70,15906,"120,544.58",31048
,20131223,15125,15155,15290,15290,15160,15170,15225,15,70,22406,"170,575.32",36134
,20131224,15170,15225,15250,15285,15175,15270,15235,45,10,16884,"128,617.29",42152
,20131225,15270,15235,15280,15475,15275,15425,15390,190,155,21378,"164,543.87",47178
,20131226,15425,15390,15415,15440,15210,15235,15300,-155,-90,14932,"114,252.78",46464
,20131227,15235,15300,15235,15295,15150,15280,15240,-20,-60,16928,"129,031.69",53140
,20131230,15280,15240,15295,15375,15240,15275,15300,35,60,12400,"94,862.82",55014
,20131231,15275,15300,15240,15310,15195,15215,15235,-85,-65,16188,"123,345.78",58812
zn1405,20130516,14800,14800,,,,14800,14800,0,0,0,0,0
,20130517,14800,14800,,,,14800,14800,0,0,0,0,0
,20130520,14800,14800,,,,14800,14800,0,0,0,0,0
,20130521,14800,14800,,,,14800,14800,0,0,0,0,0
,20130522,14800,14800,,,,14800,14800,0,0,0,0,0
,20130523,14800,14800,,,,14800,14800,0,0,0,0,0
,20130524,14800,14800,,,,14800,14800,0,0,0,0,0
,20130527,14800,14800,,,,14800,14800,0,0,0,0,0
,20130528,14800,14800,,,,14800,14800,0,0,0,0,0
,20130529,14800,14800,,,,14800,14800,0,0,0,0,0
,20130530,14800,14800,,,,14800,14800,0,0,0,0,0
,20130531,14800,14800,,,,14800,14800,0,0,0,0,0
,20130603,14800,14800,,,,14905,14905,105,105,0,0,0
,20130604,14905,14905,,,,14905,14905,0,0,0,0,0
,20130605,14905,14905,15165,15165,15140,15140,15145,235,240,18,136.32,18
,20130606,15140,15145,,,,15145,15145,0,0,0,0,18
,20130607,15145,15145,,,,15145,15145,0,0,0,0,18
,20130613,15145,15145,,,,15145,15145,0,0,0,0,18
,20130614,15145,15145,14830,14830,14830,14830,14830,-315,-315,4,29.66,20
,20130617,14830,14830,,,,14830,14830,0,0,0,0,20
,20130618,14830,14830,14790,14795,14790,14795,14790,-35,-40,4,29.59,22
,20130619,14795,14790,,,,14790,14790,0,0,0,0,22
,20130620,14790,14790,14685,14750,14685,14750,14715,-40,-75,4,29.44,22
,20130621,14750,14715,14640,14680,14640,14680,14660,-35,-55,4,29.32,20
,20130624,14680,14660,14705,14705,14600,14600,14645,-60,-15,16,117.18,20
,20130625,14600,14645,14605,14655,14535,14655,14595,10,-50,10,72.99,28
,20130626,14655,14595,,,,14665,14665,70,70,0,0,28
,20130627,14665,14665,14640,14640,14640,14640,14640,-25,-25,12,87.84,28
,20130628,14640,14640,14650,15200,14640,14750,14860,110,220,348,"2,586.47",146
,20130701,14750,14860,14810,14820,14755,14820,14770,-40,-90,94,694.27,166
,20130702,14820,14770,14875,14900,14840,14900,14870,130,100,20,148.74,158
,20130703,14900,14870,14850,14885,14850,14885,14855,15,-15,8,59.44,158
,20130704,14885,14855,,,,14815,14815,-40,-40,0,0,158
,20130705,14815,14815,14740,14740,14720,14720,14725,-95,-90,18,132.55,158
,20130708,14720,14725,14650,14650,14630,14630,14640,-95,-85,32,234.25,164
,20130709,14630,14640,,,,14720,14720,80,80,0,0,164
,20130710,14720,14720,,,,14720,14720,0,0,0,0,164
,20130711,14720,14720,,,,14720,14720,0,0,0,0,164
,20130712,14720,14720,14840,14840,14835,14835,14835,115,115,10,74.19,160
,20130715,14835,14835,14855,14885,14855,14875,14865,40,30,24,178.39,146
,20130716,14875,14865,14865,14865,14865,14865,14865,0,0,2,14.87,144
,20130717,14865,14865,,,,14865,14865,0,0,0,0,144
,20130718,14865,14865,14765,14765,14765,14765,14765,-100,-100,2,14.77,144
,20130719,14765,14765,,,,14745,14745,-20,-20,0,0,144
,20130722,14745,14745,,,,14745,14745,0,0,0,0,144
,20130723,14745,14745,,,,14745,14745,0,0,0,0,144
,20130724,14745,14745,14790,14815,14790,14815,14800,70,55,4,29.61,146
,20130725,14815,14800,14860,14900,14760,14900,14840,100,40,16,118.75,150
,20130726,14900,14840,14805,14840,14780,14780,14805,-60,-35,8,59.22,150
,20130729,14780,14805,14695,14695,14650,14650,14680,-155,-125,28,205.54,146
,20130730,14650,14680,14690,14690,14620,14620,14665,-60,-15,6,44,144
,20130731,14620,14665,14625,14625,14625,14625,14625,-40,-40,4,29.25,144
,20130801,14625,14625,,,,14715,14715,90,90,0,0,144
,20130802,14715,14715,14635,14635,14635,14635,14635,-80,-80,2,14.64,144
,20130805,14635,14635,14725,14725,14710,14710,14715,75,80,18,132.46,130
,20130806,14710,14715,,,,14665,14665,-50,-50,0,0,130
,20130807,14665,14665,14680,14680,14670,14670,14675,5,10,4,29.35,130
,20130808,14670,14675,14740,14745,14740,14745,14740,70,65,8,58.97,132
,20130809,14745,14740,14895,14895,14895,14895,14895,155,155,2,14.9,132
,20130812,14895,14895,15065,15065,15035,15040,15040,145,145,14,105.28,136
,20130813,15040,15040,15045,15055,15045,15055,15050,15,10,6,45.16,132
,20130814,15055,15050,14980,15050,14905,14985,14990,-65,-60,34,254.9,142
,20130815,14985,14990,,,,15050,15050,60,60,0,0,142
,20130816,15050,15050,15095,15350,15095,15350,15260,300,210,126,961.69,150
,20130819,15350,15260,15405,15410,15340,15410,15380,150,120,12,92.3,146
,20130820,15410,15380,,,,15380,15380,0,0,0,0,146
,20130821,15380,15380,15330,15330,15200,15250,15275,-130,-105,8,61.11,148
,20130822,15250,15275,15250,15250,15250,15250,15250,-25,-25,4,30.5,148
,20130823,15250,15250,15325,15325,15255,15255,15270,5,20,8,61.09,148
,20130826,15255,15270,15365,15385,15365,15385,15375,115,105,4,30.75,144
,20130827,15385,15375,,,,15285,15285,-90,-90,0,0,144
,20130828,15285,15285,15320,15320,15310,15310,15310,25,25,8,61.25,146
,20130829,15310,15310,15130,15180,15130,15180,15165,-130,-145,8,60.67,146
,20130830,15180,15165,15050,15050,15035,15035,15040,-130,-125,6,45.12,148
,20130902,15035,15040,15055,15065,15055,15065,15060,25,20,8,60.25,146
,20130903,15065,15060,15075,15075,15045,15045,15050,-15,-10,12,90.3,150
,20130904,15045,15050,15020,15030,14995,14995,15005,-55,-45,12,90.04,148
,20130905,14995,15005,14915,14915,14905,14905,14910,-100,-95,16,119.29,152
,20130906,14905,14910,14865,14885,14865,14885,14875,-25,-35,4,29.75,154
,20130909,14885,14875,15030,15050,15015,15050,15030,175,155,6,45.1,154
,20130910,15050,15030,14925,14925,14920,14925,14920,-105,-110,22,164.15,174
,20130911,14925,14920,,,,14920,14920,0,0,0,0,174
,20130912,14920,14920,14860,14880,14835,14835,14850,-85,-70,8,59.42,174
,20130913,14835,14850,,,,14850,14850,0,0,0,0,174
,20130916,14850,14850,14880,14880,14815,14815,14830,-35,-20,10,74.17,182
,20130917,14815,14830,14755,14800,14755,14760,14770,-70,-60,14,103.4,188
,20130918,14760,14770,14760,14760,14760,14760,14760,-10,-10,2,14.76,190
,20130923,14760,14760,14765,14800,14760,14800,14775,40,15,8,59.12,192
,20130924,14800,14775,14825,14825,14825,14825,14825,50,50,2,14.83,194
,20130925,14825,14825,14885,14885,14860,14880,14880,55,55,24,178.59,198
,20130926,14880,14880,14840,14905,14830,14905,14850,25,-30,12,89.13,196
,20130927,14905,14850,14850,14850,14850,14850,14850,0,0,22,163.35,212
,20130930,14850,14850,14835,14975,14835,14975,14905,125,55,4,29.81,210
,20131008,14975,14905,14860,14860,14830,14835,14840,-70,-65,38,281.99,230
,20131009,14835,14840,14885,14890,14855,14875,14875,35,35,10,74.4,230
,20131010,14875,14875,14895,14895,14895,14895,14895,20,20,2,14.9,232
,20131011,14895,14895,15015,15025,14960,14995,14990,100,95,60,449.82,248
,20131014,14995,14990,15040,15040,15040,15040,15040,50,50,2,15.04,250
,20131015,15040,15040,15115,15115,15015,15020,15050,-20,10,10,75.26,252
,20131016,15020,15050,15020,15050,14935,14965,14985,-85,-65,52,389.69,272
,20131017,14965,14985,15025,15025,14945,14945,14965,-40,-20,62,464.04,302
,20131018,14945,14965,,,,14965,14965,0,0,0,0,302
,20131021,14965,14965,15055,15180,15050,15180,15095,215,130,28,211.33,298
,20131022,15180,15095,15130,15130,15130,15130,15130,35,35,2,15.13,300
,20131023,15130,15130,15115,15155,15095,15110,15115,-20,-15,14,105.81,300
,20131024,15110,15115,15050,15070,15015,15070,15045,-45,-70,52,391.26,336
,20131025,15070,15045,15030,15030,15015,15015,15020,-30,-25,14,105.16,334
,20131028,15015,15020,,,,15020,15020,0,0,0,0,334
,20131029,15020,15020,15150,15170,15105,15170,15135,150,115,44,333.04,334
,20131030,15170,15135,15215,15250,15215,15250,15240,115,105,22,167.65,338
,20131031,15250,15240,15080,15125,14765,15060,14940,-180,-300,150,"1,120.82",356
,20131101,15060,14940,15060,15145,15060,15145,15075,205,135,26,195.98,354
,20131104,15145,15075,15070,15080,15050,15060,15065,-15,-10,16,120.56,344
,20131105,15060,15065,15065,15085,15025,15085,15035,20,-30,58,436.09,394
,20131106,15085,15035,15045,15095,15025,15055,15050,20,15,46,346.21,358
,20131107,15055,15050,15055,15065,15035,15035,15050,-15,0,6,45.16,358
,20131108,15035,15050,15010,15045,14980,15000,14995,-50,-55,156,"1,170.00",420
,20131111,15000,14995,15015,15015,14980,14995,14990,0,-5,56,419.84,456
,20131112,14995,14990,14875,14935,14875,14915,14920,-75,-70,44,328.3,462
,20131113,14915,14920,14850,14880,14825,14835,14840,-85,-80,96,712.48,462
,20131114,14835,14840,14875,14895,14865,14870,14885,30,45,24,178.62,476
,20131115,14870,14885,14360,14965,14360,14895,14810,10,-75,38,281.41,484
,20131118,14895,14810,14925,14930,14890,14930,14910,120,100,10,74.56,486
,20131119,14930,14910,14890,14890,14820,14850,14830,-60,-80,66,489.53,524
,20131120,14850,14830,14895,14925,14890,14925,14910,95,80,18,134.22,528
,20131121,14925,14910,14870,14885,14840,14870,14850,-40,-60,44,326.78,548
,20131122,14870,14850,14880,14880,14845,14845,14860,-5,10,20,148.62,550
,20131125,14845,14860,14910,14930,14850,14885,14900,25,40,46,342.77,550
,20131126,14885,14900,14880,14880,14850,14850,14855,-50,-45,80,594.26,572
,20131127,14850,14855,14840,14855,14820,14825,14835,-30,-20,52,385.8,582
,20131128,14825,14835,14755,14790,14755,14770,14775,-65,-60,104,768.38,658
,20131129,14770,14775,14780,14785,14760,14770,14775,-5,0,208,"1,536.64",842
,20131202,14770,14775,14790,14805,14770,14800,14790,25,15,476,"3,520.79",1318
,20131203,14800,14790,14770,14780,14750,14750,14765,-40,-25,456,"3,366.60",1602
,20131204,14750,14765,14790,14800,14770,14785,14780,20,15,130,960.89,1656
,20131205,14785,14780,14835,14850,14810,14820,14825,40,45,368,"2,728.30",1748
,20131206,14820,14825,14825,14845,14815,14845,14820,20,-5,194,"1,437.96",1670
,20131209,14845,14820,14880,14880,14855,14880,14865,60,45,608,"4,519.86",1862
,20131210,14880,14865,14950,14985,14945,14965,14960,100,95,424,"3,172.04",2012
,20131211,14965,14960,15125,15125,14980,15015,15030,55,70,510,"3,833.22",1996
,20131212,15015,15030,15095,15095,15060,15085,15080,55,50,374,"2,820.50",2124
,20131213,15085,15080,15005,15045,14995,15010,15015,-70,-65,586,"4,400.75",2106
,20131216,15010,15015,15100,15100,15070,15080,15075,65,60,140,"1,055.56",2100
,20131217,15080,15075,15135,15150,15105,15135,15130,60,55,1478,"11,182.99",3122
,20131218,15135,15130,15115,15120,15065,15075,15085,-55,-45,1264,"9,535.72",3938
,20131219,15075,15085,15080,15115,15045,15075,15080,-10,-5,1188,"8,959.80",3958
,20131220,15075,15080,15080,15225,15060,15130,15150,50,70,10812,"81,923.71",9674
,20131223,15130,15150,15220,15290,15160,15165,15220,15,70,7642,"58,158.30",13482
,20131224,15165,15220,15245,15290,15180,15280,15230,60,10,9428,"71,811.94",17384
,20131225,15280,15230,15290,15490,15275,15440,15405,210,175,8492,"65,411.62",20414
,20131226,15440,15405,15415,15460,15210,15240,15290,-165,-115,7078,"54,123.03",20820
,20131227,15240,15290,15240,15300,15160,15285,15250,-5,-40,8802,"67,117.02",26204
,20131230,15285,15250,15315,15375,15250,15280,15295,30,45,12316,"94,190.25",30460
,20131231,15280,15295,15280,15315,15190,15230,15255,-65,-40,9140,"69,736.35",31874
zn1406,20130618,14830,14830,,,,14830,14830,0,0,0,0,0
,20130619,14830,14830,15105,15105,14795,14795,14950,-35,120,4,29.9,0
,20130620,14795,14950,,,,14950,14950,0,0,0,0,0
,20130621,14950,14950,,,,14950,14950,0,0,0,0,0
,20130624,14950,14950,,,,14950,14950,0,0,0,0,0
,20130625,14950,14950,,,,14900,14900,-50,-50,0,0,0
,20130626,14900,14900,,,,14970,14970,70,70,0,0,0
,20130627,14970,14970,14790,14790,14665,14665,14725,-305,-245,4,29.46,2
,20130628,14665,14725,,,,14725,14725,0,0,0,0,2
,20130701,14725,14725,,,,14785,14785,60,60,0,0,2
,20130702,14785,14785,,,,14785,14785,0,0,0,0,2
,20130703,14785,14785,,,,14785,14785,0,0,0,0,2
,20130704,14785,14785,,,,14785,14785,0,0,0,0,2
,20130705,14785,14785,14780,14780,14780,14780,14780,-5,-5,2,14.78,2
,20130708,14780,14780,,,,14695,14695,-85,-85,0,0,2
,20130709,14695,14695,,,,14695,14695,0,0,0,0,2
,20130710,14695,14695,,,,14695,14695,0,0,0,0,2
,20130711,14695,14695,,,,14695,14695,0,0,0,0,2
,20130712,14695,14695,,,,14695,14695,0,0,0,0,2
,20130715,14695,14695,14875,14920,14830,14895,14880,200,185,106,788.78,4
,20130716,14895,14880,,,,14880,14880,0,0,0,0,4
,20130717,14880,14880,,,,14880,14880,0,0,0,0,4
,20130718,14880,14880,,,,14880,14880,0,0,0,0,4
,20130719,14880,14880,,,,14860,14860,-20,-20,0,0,4
,20130722,14860,14860,,,,14855,14855,-5,-5,0,0,4
,20130723,14855,14855,,,,14855,14855,0,0,0,0,4
,20130724,14855,14855,,,,14910,14910,55,55,0,0,4
,20130725,14910,14910,,,,14910,14910,0,0,0,0,4
,20130726,14910,14910,,,,14870,14870,-40,-40,0,0,4
,20130729,14870,14870,,,,14870,14870,0,0,0,0,4
,20130730,14870,14870,,,,14870,14870,0,0,0,0,4
,20130731,14870,14870,14635,14635,14635,14635,14635,-235,-235,2,14.64,4
,20130801,14635,14635,,,,14725,14725,90,90,0,0,4
,20130802,14725,14725,,,,14640,14640,-85,-85,0,0,4
,20130805,14640,14640,,,,14640,14640,0,0,0,0,4
,20130806,14640,14640,,,,14595,14595,-45,-45,0,0,4
,20130807,14595,14595,,,,14600,14600,5,5,0,0,4
,20130808,14600,14600,,,,14665,14665,65,65,0,0,4
,20130809,14665,14665,,,,14815,14815,150,150,0,0,4
,20130812,14815,14815,,,,14955,14955,140,140,0,0,4
,20130813,14955,14955,,,,14965,14965,10,10,0,0,4
,20130814,14965,14965,15010,15010,15010,15010,15010,45,45,2,15.01,4
,20130815,15010,15010,,,,15070,15070,60,60,0,0,4
,20130816,15070,15070,,,,15285,15285,215,215,0,0,4
,20130819,15285,15285,15360,15365,15360,15365,15360,80,75,4,30.73,6
,20130820,15365,15360,,,,15300,15300,-60,-60,0,0,6
,20130821,15300,15300,,,,15195,15195,-105,-105,0,0,6
,20130822,15195,15195,15195,15280,15140,15280,15200,85,5,48,364.82,28
,20130823,15280,15200,15320,15360,15320,15360,15345,160,145,6,46.04,30
,20130826,15360,15345,15390,15410,15390,15410,15400,65,55,6,46.21,36
,20130827,15410,15400,,,,15310,15310,-90,-90,0,0,36
,20130828,15310,15310,,,,15335,15335,25,25,0,0,36
,20130829,15335,15335,,,,15190,15190,-145,-145,0,0,36
,20130830,15190,15190,15100,15100,15075,15075,15090,-115,-100,38,286.75,22
,20130902,15075,15090,15105,15105,15105,15105,15105,15,15,2,15.11,22
,20130903,15105,15105,15080,15080,15080,15080,15080,-25,-25,2,15.08,22
,20130904,15080,15080,15005,15005,15005,15005,15005,-75,-75,2,15.01,20
,20130905,15005,15005,14985,14985,14945,14945,14960,-60,-45,10,74.81,22
,20130906,14945,14960,14905,14925,14905,14925,14915,-35,-45,6,44.76,26
,20130909,14925,14915,,,,15070,15070,155,155,0,0,26
,20130910,15070,15070,,,,15070,15070,0,0,0,0,26
,20130911,15070,15070,,,,15070,15070,0,0,0,0,26
,20130912,15070,15070,14915,14915,14915,14915,14915,-155,-155,4,29.83,30
,20130913,14915,14915,,,,14930,14930,15,15,0,0,30
,20130916,14930,14930,14885,14885,14885,14885,14885,-45,-45,2,14.89,30
,20130917,14885,14885,14815,14815,14800,14800,14810,-85,-75,14,103.68,34
,20130918,14800,14810,,,,14795,14795,-15,-15,0,0,34
,20130923,14795,14795,14795,14795,14790,14790,14790,-5,-5,6,44.38,38
,20130924,14790,14790,,,,14790,14790,0,0,0,0,38
,20130925,14790,14790,,,,14845,14845,55,55,0,0,38
,20130926,14845,14845,,,,14845,14845,0,0,0,0,38
,20130927,14845,14845,,,,14845,14845,0,0,0,0,38
,20130930,14845,14845,,,,14895,14895,50,50,0,0,38
,20131008,14895,14895,,,,14830,14830,-65,-65,0,0,38
,20131009,14830,14830,,,,14830,14830,0,0,0,0,38
,20131010,14830,14830,,,,14830,14830,0,0,0,0,38
,20131011,14830,14830,15050,15050,14990,14990,15020,160,190,4,30.04,40
,20131014,14990,15020,15050,15050,15050,15050,15050,30,30,2,15.05,40
,20131015,15050,15050,,,,15050,15050,0,0,0,0,40
,20131016,15050,15050,,,,14985,14985,-65,-65,0,0,40
,20131017,14985,14985,,,,14985,14985,0,0,0,0,40
,20131018,14985,14985,,,,15035,15035,50,50,0,0,40
,20131021,15035,15035,15155,15155,15155,15155,15155,120,120,2,15.16,40
,20131022,15155,15155,,,,15155,15155,0,0,0,0,40
,20131023,15155,15155,,,,15140,15140,-15,-15,0,0,40
,20131024,15140,15140,15040,15080,15040,15080,15045,-60,-95,18,135.41,40
,20131025,15080,15045,,,,15020,15020,-25,-25,0,0,40
,20131028,15020,15020,15130,15130,15130,15130,15130,110,110,2,15.13,40
,20131029,15130,15130,15155,15155,15155,15155,15155,25,25,2,15.16,38
,20131030,15155,15155,,,,15155,15155,0,0,0,0,38
,20131031,15155,15155,15080,15080,14780,15045,14955,-110,-200,16,119.65,38
,20131101,15045,14955,15140,15175,15140,15175,15155,220,200,4,30.32,40
,20131104,15175,15155,15060,15065,15050,15065,15060,-90,-95,8,60.24,40
,20131105,15065,15060,,,,15060,15060,0,0,0,0,40
,20131106,15060,15060,15090,15100,15055,15095,15075,35,15,18,135.71,46
,20131107,15095,15075,,,,15075,15075,0,0,0,0,46
,20131108,15075,15075,15010,15045,15010,15035,15030,-40,-45,6,45.09,46
,20131111,15035,15030,15080,15080,15010,15010,15045,-20,15,4,30.09,46
,20131112,15010,15045,14920,14955,14920,14955,14940,-90,-105,8,59.77,44
,20131113,14955,14940,14840,14895,14840,14850,14850,-90,-90,60,445.62,80
,20131114,14850,14850,14895,14895,14895,14895,14895,45,45,2,14.9,80
,20131115,14895,14895,14920,14920,14890,14890,14910,-5,15,10,74.56,82
,20131118,14890,14910,14920,14920,14920,14920,14920,10,10,2,14.92,82
,20131119,14920,14920,14805,14855,14805,14855,14835,-65,-85,6,44.51,82
,20131120,14855,14835,14890,14930,14890,14930,14920,95,85,10,74.6,84
,20131121,14930,14920,,,,14860,14860,-60,-60,0,0,84
,20131122,14860,14860,,,,14870,14870,10,10,0,0,84
,20131125,14870,14870,,,,14870,14870,0,0,0,0,84
,20131126,14870,14870,14895,14895,14885,14885,14890,15,20,42,312.79,122
,20131127,14885,14890,14855,14860,14855,14860,14855,-30,-35,4,29.72,126
,20131128,14860,14855,14810,14810,14810,14810,14810,-45,-45,6,44.43,126
,20131129,14810,14810,14775,14775,14775,14775,14775,-35,-35,8,59.1,134
,20131202,14775,14775,14835,14835,14790,14790,14820,15,45,16,118.57,140
,20131203,14790,14820,14770,14785,14760,14765,14770,-55,-50,44,324.98,136
,20131204,14765,14770,14790,14790,14790,14790,14790,20,20,2,14.79,138
,20131205,14790,14790,14855,14855,14855,14855,14855,65,65,2,14.86,136
,20131206,14855,14855,,,,14850,14850,-5,-5,0,0,136
,20131209,14850,14850,14895,15000,14890,14900,14935,50,85,242,"1,807.73",292
,20131210,14900,14935,15005,15005,14970,15000,14995,65,60,156,"1,169.69",412
,20131211,15000,14995,15075,15075,15035,15035,15060,40,65,14,105.45,414
,20131212,15035,15060,15110,15115,15105,15105,15110,45,50,26,196.48,432
,20131213,15105,15110,15035,15040,14955,15040,15015,-70,-95,56,420.51,404
,20131216,15040,15015,15070,15085,15070,15075,15075,60,60,134,"1,010.11",374
,20131217,15075,15075,15075,15145,15075,15145,15135,70,60,14,105.95,360
,20131218,15145,15135,15080,15080,15080,15080,15080,-55,-55,2,15.08,358
,20131219,15080,15080,15100,15100,15075,15075,15080,-5,0,6,45.25,360
,20131220,15075,15080,15085,15200,15060,15165,15115,85,35,30,226.78,360
,20131223,15165,15115,15265,15290,15205,15205,15265,90,150,108,824.47,390
,20131224,15205,15265,15230,15285,15190,15285,15235,20,-30,18,137.14,388
,20131225,15285,15235,15190,15485,15190,15435,15435,200,200,1094,"8,444.80",884
,20131226,15435,15435,15450,15450,15250,15250,15355,-185,-80,424,"3,256.08",1042
,20131227,15250,15355,15290,15310,15200,15310,15265,-45,-90,714,"5,451.16",1444
,20131230,15310,15265,15370,15385,15260,15300,15305,35,40,558,"4,270.97",1566
,20131231,15300,15305,15260,15330,15200,15255,15280,-50,-25,478,"3,651.95",1546
zn1407,20130716,14880,14880,,,,14880,14880,0,0,0,0,0
,20130717,14880,14880,,,,14880,14880,0,0,0,0,0
,20130718,14880,14880,,,,14880,14880,0,0,0,0,0
,20130719,14880,14880,,,,14880,14880,0,0,0,0,0
,20130722,14880,14880,,,,14880,14880,0,0,0,0,0
,20130723,14880,14880,,,,14880,14880,0,0,0,0,0
,20130724,14880,14880,,,,14880,14880,0,0,0,0,0
,20130725,14880,14880,,,,14880,14880,0,0,0,0,0
,20130726,14880,14880,,,,14840,14840,-40,-40,0,0,0
,20130729,14840,14840,,,,14840,14840,0,0,0,0,0
,20130730,14840,14840,,,,14840,14840,0,0,0,0,0
,20130731,14840,14840,,,,14840,14840,0,0,0,0,0
,20130801,14840,14840,,,,14930,14930,90,90,0,0,0
,20130802,14930,14930,,,,14845,14845,-85,-85,0,0,0
,20130805,14845,14845,,,,14845,14845,0,0,0,0,0
,20130806,14845,14845,,,,14795,14795,-50,-50,0,0,0
,20130807,14795,14795,,,,14805,14805,10,10,0,0,0
,20130808,14805,14805,,,,14870,14870,65,65,0,0,0
,20130809,14870,14870,,,,15025,15025,155,155,0,0,0
,20130812,15025,15025,,,,15170,15170,145,145,0,0,0
,20130813,15170,15170,,,,15180,15180,10,10,0,0,0
,20130814,15180,15180,,,,15225,15225,45,45,0,0,0
,20130815,15225,15225,15090,15090,15090,15090,15090,-135,-135,2,15.09,2
,20130816,15090,15090,,,,15305,15305,215,215,0,0,2
,20130819,15305,15305,,,,15380,15380,75,75,0,0,2
,20130820,15380,15380,,,,15315,15315,-65,-65,0,0,2
,20130821,15315,15315,,,,15210,15210,-105,-105,0,0,2
,20130822,15210,15210,,,,15215,15215,5,5,0,0,2
,20130823,15215,15215,,,,15215,15215,0,0,0,0,2
,20130826,15215,15215,,,,15270,15270,55,55,0,0,2
,20130827,15270,15270,,,,15180,15180,-90,-90,0,0,2
,20130828,15180,15180,,,,15205,15205,25,25,0,0,2
,20130829,15205,15205,15285,15285,15285,15285,15285,80,80,2,15.29,4
,20130830,15285,15285,,,,15285,15285,0,0,0,0,4
,20130902,15285,15285,,,,15285,15285,0,0,0,0,4
,20130903,15285,15285,,,,15285,15285,0,0,0,0,4
,20130904,15285,15285,,,,15205,15205,-80,-80,0,0,4
,20130905,15205,15205,,,,15160,15160,-45,-45,0,0,4
,20130906,15160,15160,,,,15160,15160,0,0,0,0,4
,20130909,15160,15160,,,,15315,15315,155,155,0,0,4
,20130910,15315,15315,,,,15315,15315,0,0,0,0,4
,20130911,15315,15315,,,,15315,15315,0,0,0,0,4
,20130912,15315,15315,,,,15315,15315,0,0,0,0,4
,20130913,15315,15315,,,,15330,15330,15,15,0,0,4
,20130916,15330,15330,,,,15280,15280,-50,-50,0,0,4
,20130917,15280,15280,,,,15200,15200,-80,-80,0,0,4
,20130918,15200,15200,,,,15185,15185,-15,-15,0,0,4
,20130923,15185,15185,,,,15180,15180,-5,-5,0,0,4
,20130924,15180,15180,,,,15180,15180,0,0,0,0,4
,20130925,15180,15180,14925,14925,14925,14925,14925,-255,-255,2,14.93,4
,20130926,14925,14925,,,,14925,14925,0,0,0,0,4
,20130927,14925,14925,,,,14925,14925,0,0,0,0,4
,20130930,14925,14925,,,,14980,14980,55,55,0,0,4
,20131008,14980,14980,,,,14915,14915,-65,-65,0,0,4
,20131009,14915,14915,,,,14915,14915,0,0,0,0,4
,20131010,14915,14915,,,,14915,14915,0,0,0,0,4
,20131011,14915,14915,,,,15105,15105,190,190,0,0,4
,20131014,15105,15105,,,,15105,15105,0,0,0,0,4
,20131015,15105,15105,,,,15105,15105,0,0,0,0,4
,20131016,15105,15105,15005,15005,14995,14995,14995,-110,-110,6,45,10
,20131017,14995,14995,,,,14995,14995,0,0,0,0,10
,20131018,14995,14995,15040,15040,15040,15040,15040,45,45,2,15.04,10
,20131021,15040,15040,15080,15205,15080,15205,15135,165,95,10,75.68,14
,20131022,15205,15135,,,,15135,15135,0,0,0,0,14
,20131023,15135,15135,,,,15120,15120,-15,-15,0,0,14
,20131024,15120,15120,15120,15125,15100,15100,15110,-20,-10,8,60.45,14
,20131025,15100,15110,15170,15170,15170,15170,15170,60,60,2,15.17,14
,20131028,15170,15170,,,,15170,15170,0,0,0,0,14
,20131029,15170,15170,,,,15170,15170,0,0,0,0,14
,20131030,15170,15170,15235,15235,15235,15235,15235,65,65,2,15.24,12
,20131031,15235,15235,15115,15125,14885,15055,15060,-180,-175,12,90.38,12
,20131101,15055,15060,15140,15140,15140,15140,15140,80,80,2,15.14,10
,20131104,15140,15140,,,,15140,15140,0,0,0,0,10
,20131105,15140,15140,,,,15140,15140,0,0,0,0,10
,20131106,15140,15140,,,,15140,15140,0,0,0,0,10
,20131107,15140,15140,,,,15140,15140,0,0,0,0,10
,20131108,15140,15140,,,,15095,15095,-45,-45,0,0,10
,20131111,15095,15095,,,,15110,15110,15,15,0,0,10
,20131112,15110,15110,14950,14950,14950,14950,14950,-160,-160,2,14.95,10
,20131113,14950,14950,14885,14885,14835,14835,14860,-115,-90,4,29.72,8
,20131114,14835,14860,14890,14890,14890,14890,14890,30,30,2,14.89,10
,20131115,14890,14890,,,,14905,14905,15,15,0,0,10
,20131118,14905,14905,14950,14985,14920,14920,14950,15,45,12,89.71,14
,20131119,14920,14950,14870,14870,14870,14870,14870,-80,-80,2,14.87,14
,20131120,14870,14870,,,,14870,14870,0,0,0,0,14
,20131121,14870,14870,,,,14810,14810,-60,-60,0,0,14
,20131122,14810,14810,,,,14820,14820,10,10,0,0,14
,20131125,14820,14820,,,,14860,14860,40,40,0,0,14
,20131126,14860,14860,14910,14910,14885,14885,14895,25,35,40,297.94,14
,20131127,14885,14895,14915,14925,14850,14905,14895,10,0,8,59.6,10
,20131128,14905,14895,14810,14810,14810,14810,14810,-85,-85,2,14.81,10
,20131129,14810,14810,14790,14790,14790,14790,14790,-20,-20,4,29.58,14
,20131202,14790,14790,,,,14790,14790,0,0,0,0,14
,20131203,14790,14790,14785,14785,14785,14785,14785,-5,-5,4,29.57,18
,20131204,14785,14785,14840,14840,14840,14840,14840,55,55,4,29.68,22
,20131205,14840,14840,,,,14840,14840,0,0,0,0,22
,20131206,14840,14840,,,,14835,14835,-5,-5,0,0,22
,20131209,14835,14835,,,,14835,14835,0,0,0,0,22
,20131210,14835,14835,,,,14835,14835,0,0,0,0,22
,20131211,14835,14835,15045,15045,15020,15045,15040,210,205,12,90.25,24
,20131212,15045,15040,,,,15060,15060,20,20,0,0,24
,20131213,15060,15060,,,,14965,14965,-95,-95,0,0,24
,20131216,14965,14965,,,,15070,15070,105,105,0,0,24
,20131217,15070,15070,,,,15120,15120,50,50,0,0,24
,20131218,15120,15120,,,,15065,15065,-55,-55,0,0,24
,20131219,15065,15065,,,,15065,15065,0,0,0,0,24
,20131220,15065,15065,15095,15225,15095,15190,15170,125,105,32,242.77,48
,20131223,15190,15170,15270,15310,15235,15235,15270,65,100,82,626.14,78
,20131224,15235,15270,15275,15280,15240,15280,15265,10,-5,72,549.61,76
,20131225,15280,15265,15350,15485,15350,15485,15435,220,170,310,"2,392.99",304
,20131226,15485,15435,15420,15460,15275,15275,15325,-160,-110,242,"1,854.70",400
,20131227,15275,15325,15290,15290,15260,15260,15285,-65,-40,44,336.35,418
,20131230,15260,15285,15380,15390,15290,15310,15325,25,40,38,291.25,422
,20131231,15310,15325,15340,15340,15215,15215,15245,-110,-80,16,121.97,424
zn1408,20130816,15090,15090,,,,15305,15305,215,215,0,0,0
,20130819,15305,15305,,,,15380,15380,75,75,0,0,0
,20130820,15380,15380,15380,15510,15380,15510,15455,130,75,6,46.38,2
,20130821,15510,15455,,,,15350,15350,-105,-105,0,0,2
,20130822,15350,15350,,,,15355,15355,5,5,0,0,2
,20130823,15355,15355,15240,15240,15240,15240,15240,-115,-115,2,15.24,2
,20130826,15240,15240,,,,15295,15295,55,55,0,0,2
,20130827,15295,15295,,,,15205,15205,-90,-90,0,0,2
,20130828,15205,15205,,,,15230,15230,25,25,0,0,2
,20130829,15230,15230,,,,15310,15310,80,80,0,0,2
,20130830,15310,15310,,,,15310,15310,0,0,0,0,2
,20130902,15310,15310,,,,15310,15310,0,0,0,0,2
,20130903,15310,15310,,,,15310,15310,0,0,0,0,2
,20130904,15310,15310,,,,15230,15230,-80,-80,0,0,2
,20130905,15230,15230,15020,15095,14990,14990,15035,-240,-195,6,45.11,4
,20130906,14990,15035,,,,15035,15035,0,0,0,0,4
,20130909,15035,15035,15105,15105,15105,15105,15105,70,70,2,15.11,2
,20130910,15105,15105,,,,15105,15105,0,0,0,0,2
,20130911,15105,15105,,,,15105,15105,0,0,0,0,2
,20130912,15105,15105,,,,15105,15105,0,0,0,0,2
,20130913,15105,15105,,,,15120,15120,15,15,0,0,2
,20130916,15120,15120,15035,15035,15035,15035,15035,-85,-85,2,15.04,4
,20130917,15035,15035,,,,14985,14985,-50,-50,0,0,4
,20130918,14985,14985,,,,14970,14970,-15,-15,0,0,4
,20130923,14970,14970,,,,14965,14965,-5,-5,0,0,4
,20130924,14965,14965,14950,14950,14950,14950,14950,-15,-15,2,14.95,4
,20130925,14950,14950,,,,14950,14950,0,0,0,0,4
,20130926,14950,14950,,,,14950,14950,0,0,0,0,4
,20130927,14950,14950,,,,14950,14950,0,0,0,0,4
,20130930,14950,14950,,,,15005,15005,55,55,0,0,4
,20131008,15005,15005,,,,14940,14940,-65,-65,0,0,4
,20131009,14940,14940,14905,14905,14905,14905,14905,-35,-35,2,14.91,4
,20131010,14905,14905,,,,14905,14905,0,0,0,0,4
,20131011,14905,14905,,,,15095,15095,190,190,0,0,4
,20131014,15095,15095,15135,15135,15000,15000,15110,-95,15,12,90.68,4
,20131015,15000,15110,15130,15130,15130,15130,15130,20,20,20,151.3,24
,20131016,15130,15130,15135,15140,15045,15045,15110,-85,-20,32,241.84,10
,20131017,15045,15110,,,,15110,15110,0,0,0,0,10
,20131018,15110,15110,,,,15155,15155,45,45,0,0,10
,20131021,15155,15155,,,,15155,15155,0,0,0,0,10
,20131022,15155,15155,,,,15155,15155,0,0,0,0,10
,20131023,15155,15155,15200,15200,15200,15200,15200,45,45,2,15.2,10
,20131024,15200,15200,15130,15130,15130,15130,15130,-70,-70,6,45.39,12
,20131025,15130,15130,,,,15190,15190,60,60,0,0,12
,20131028,15190,15190,,,,15190,15190,0,0,0,0,12
,20131029,15190,15190,,,,15190,15190,0,0,0,0,12
,20131030,15190,15190,,,,15190,15190,0,0,0,0,12
,20131031,15190,15190,15140,15140,14885,15120,15045,-70,-145,6,45.15,14
,20131101,15120,15045,,,,15045,15045,0,0,0,0,14
,20131104,15045,15045,,,,15070,15070,25,25,0,0,14
,20131105,15070,15070,,,,15070,15070,0,0,0,0,14
,20131106,15070,15070,,,,15070,15070,0,0,0,0,14
,20131107,15070,15070,15095,15095,15095,15095,15095,25,25,2,15.1,14
,20131108,15095,15095,15090,15090,15090,15090,15090,-5,-5,2,15.09,16
,20131111,15090,15090,,,,15090,15090,0,0,0,0,16
,20131112,15090,15090,,,,15025,15025,-65,-65,0,0,16
,20131113,15025,15025,,,,14930,14930,-95,-95,0,0,16
,20131114,14930,14930,14930,14930,14930,14930,14930,0,0,2,14.93,18
,20131115,14930,14930,14930,14930,14930,14930,14930,0,0,2,14.93,18
,20131118,14930,14930,,,,14930,14930,0,0,0,0,18
,20131119,14930,14930,14890,14890,14890,14890,14890,-40,-40,4,29.78,18
,20131120,14890,14890,,,,14975,14975,85,85,0,0,18
,20131121,14975,14975,,,,14915,14915,-60,-60,0,0,18
,20131122,14915,14915,,,,14925,14925,10,10,0,0,18
,20131125,14925,14925,,,,14965,14965,40,40,0,0,18
,20131126,14965,14965,14910,14910,14910,14910,14910,-55,-55,4,29.82,22
,20131127,14910,14910,14910,14910,14910,14910,14910,0,0,2,14.91,22
,20131128,14910,14910,14830,14830,14810,14810,14820,-100,-90,4,29.64,22
,20131129,14810,14820,,,,14795,14795,-25,-25,0,0,22
,20131202,14795,14795,,,,14795,14795,0,0,0,0,22
,20131203,14795,14795,,,,14785,14785,-10,-10,0,0,22
,20131204,14785,14785,,,,14785,14785,0,0,0,0,22
,20131205,14785,14785,,,,14785,14785,0,0,0,0,22
,20131206,14785,14785,,,,14780,14780,-5,-5,0,0,22
,20131209,14780,14780,,,,14780,14780,0,0,0,0,22
,20131210,14780,14780,15045,15045,15045,15045,15045,265,265,2,15.05,20
,20131211,15045,15045,15085,15100,15085,15100,15095,55,50,28,211.34,40
,20131212,15100,15095,15160,15160,15160,15160,15160,65,65,6,45.48,40
,20131213,15160,15160,15080,15080,15075,15075,15075,-85,-85,8,60.32,40
,20131216,15075,15075,,,,15075,15075,0,0,0,0,40
,20131217,15075,15075,15160,15195,15160,15195,15175,120,100,8,60.71,40
,20131218,15195,15175,,,,15175,15175,0,0,0,0,40
,20131219,15175,15175,,,,15140,15140,-35,-35,0,0,40
,20131220,15140,15140,15155,15250,15155,15250,15200,110,60,10,76,40
,20131223,15250,15200,,,,15200,15200,0,0,0,0,40
,20131224,15200,15200,15240,15275,15240,15275,15255,75,55,32,244.14,68
,20131225,15275,15255,15385,15510,15370,15490,15425,235,170,38,293.08,80
,20131226,15490,15425,15475,15485,15425,15425,15455,0,30,22,170.03,76
,20131227,15425,15455,15215,15385,15215,15265,15285,-190,-170,6,45.87,76
,20131230,15265,15285,15380,15385,15380,15385,15380,100,95,58,446.15,130
,20131231,15385,15380,,,,15380,15380,0,0,0,0,130
zn1409,20130917,15035,15035,,,,14955,14955,-80,-80,0,0,0
,20130918,14955,14955,,,,14940,14940,-15,-15,0,0,0
,20130923,14940,14940,,,,14935,14935,-5,-5,0,0,0
,20130924,14935,14935,,,,14935,14935,0,0,0,0,0
,20130925,14935,14935,,,,14935,14935,0,0,0,0,0
,20130926,14935,14935,,,,14935,14935,0,0,0,0,0
,20130927,14935,14935,,,,14935,14935,0,0,0,0,0
,20130930,14935,14935,,,,14990,14990,55,55,0,0,0
,20131008,14990,14990,,,,14925,14925,-65,-65,0,0,0
,20131009,14925,14925,,,,14890,14890,-35,-35,0,0,0
,20131010,14890,14890,,,,14890,14890,0,0,0,0,0
,20131011,14890,14890,,,,15080,15080,190,190,0,0,0
,20131014,15080,15080,,,,15080,15080,0,0,0,0,0
,20131015,15080,15080,,,,15080,15080,0,0,0,0,0
,20131016,15080,15080,15125,15125,15070,15070,15095,-10,15,4,30.2,0
,20131017,15070,15095,,,,15095,15095,0,0,0,0,0
,20131018,15095,15095,,,,15140,15140,45,45,0,0,0
,20131021,15140,15140,,,,15140,15140,0,0,0,0,0
,20131022,15140,15140,,,,15140,15140,0,0,0,0,0
,20131023,15140,15140,,,,15180,15180,40,40,0,0,0
,20131024,15180,15180,,,,15110,15110,-70,-70,0,0,0
,20131025,15110,15110,,,,15170,15170,60,60,0,0,0
,20131028,15170,15170,,,,15170,15170,0,0,0,0,0
,20131029,15170,15170,,,,15170,15170,0,0,0,0,0
,20131030,15170,15170,,,,15170,15170,0,0,0,0,0
,20131031,15170,15170,15210,15210,15155,15155,15180,-15,10,4,30.37,0
,20131101,15155,15180,,,,15260,15260,80,80,0,0,0
,20131104,15260,15260,,,,15195,15195,-65,-65,0,0,0
,20131105,15195,15195,,,,15195,15195,0,0,0,0,0
,20131106,15195,15195,,,,15195,15195,0,0,0,0,0
,20131107,15195,15195,,,,15220,15220,25,25,0,0,0
,20131108,15220,15220,,,,15210,15210,-10,-10,0,0,0
,20131111,15210,15210,,,,15225,15225,15,15,0,0,0
,20131112,15225,15225,,,,15060,15060,-165,-165,0,0,0
,20131113,15060,15060,,,,14965,14965,-95,-95,0,0,0
,20131114,14965,14965,,,,14965,14965,0,0,0,0,0
,20131115,14965,14965,,,,14965,14965,0,0,0,0,0
,20131118,14965,14965,14920,14920,14920,14920,14920,-45,-45,2,14.92,2
,20131119,14920,14920,14970,14970,14970,14970,14970,50,50,2,14.97,0
,20131120,14970,14970,,,,14970,14970,0,0,0,0,0
,20131121,14970,14970,,,,14910,14910,-60,-60,0,0,0
,20131122,14910,14910,,,,14910,14910,0,0,0,0,0
,20131125,14910,14910,,,,14910,14910,0,0,0,0,0
,20131126,14910,14910,14935,14935,14935,14935,14935,25,25,4,29.87,4
,20131127,14935,14935,,,,14935,14935,0,0,0,0,4
,20131128,14935,14935,14825,14945,14790,14820,14810,-115,-125,30,222.21,28
,20131129,14820,14810,14855,14855,14805,14805,14835,-5,25,14,103.87,26
,20131202,14805,14835,14840,14840,14840,14840,14840,5,5,2,14.84,26
,20131203,14840,14840,14795,14850,14795,14850,14820,10,-20,14,103.75,24
,20131204,14850,14820,,,,14820,14820,0,0,0,0,24
,20131205,14820,14820,,,,14820,14820,0,0,0,0,24
,20131206,14820,14820,,,,14815,14815,-5,-5,0,0,24
,20131209,14815,14815,14930,14930,14930,14930,14930,115,115,2,14.93,26
,20131210,14930,14930,14965,15065,14965,15065,15030,135,100,6,45.1,26
,20131211,15065,15030,,,,15030,15030,0,0,0,0,26
,20131212,15030,15030,,,,15030,15030,0,0,0,0,26
,20131213,15030,15030,15105,15105,15070,15070,15090,40,60,6,45.28,28
,20131216,15070,15090,,,,15090,15090,0,0,0,0,28
,20131217,15090,15090,,,,15090,15090,0,0,0,0,28
,20131218,15090,15090,,,,15090,15090,0,0,0,0,28
,20131219,15090,15090,15160,15160,15160,15160,15160,70,70,2,15.16,30
,20131220,15160,15160,,,,15160,15160,0,0,0,0,30
,20131223,15160,15160,15345,15345,15240,15240,15290,80,130,4,30.59,30
,20131224,15240,15290,15285,15285,15285,15285,15285,-5,-5,6,45.86,36
,20131225,15285,15285,,,,15285,15285,0,0,0,0,36
,20131226,15285,15285,,,,15315,15315,30,30,0,0,36
,20131227,15315,15315,,,,15145,15145,-170,-170,0,0,36
,20131230,15145,15145,,,,15310,15310,165,165,0,0,36
,20131231,15310,15310,,,,15310,15310,0,0,0,0,36
zn1410,20131016,15080,15080,,,,15095,15095,15,15,0,0,0
,20131017,15095,15095,,,,15095,15095,0,0,0,0,0
,20131018,15095,15095,,,,15140,15140,45,45,0,0,0
,20131021,15140,15140,,,,15140,15140,0,0,0,0,0
,20131022,15140,15140,,,,15140,15140,0,0,0,0,0
,20131023,15140,15140,,,,15180,15180,40,40,0,0,0
,20131024,15180,15180,,,,15110,15110,-70,-70,0,0,0
,20131025,15110,15110,,,,15170,15170,60,60,0,0,0
,20131028,15170,15170,,,,15170,15170,0,0,0,0,0
,20131029,15170,15170,15400,15400,15145,15275,15265,105,95,242,"1,847.64",60
,20131030,15275,15265,15250,15365,15250,15365,15255,100,-10,66,503.57,22
,20131031,15365,15255,15125,15165,14835,15015,15090,-240,-165,16,120.72,22
,20131101,15015,15090,,,,15090,15090,0,0,0,0,22
,20131104,15090,15090,,,,15090,15090,0,0,0,0,22
,20131105,15090,15090,,,,15090,15090,0,0,0,0,22
,20131106,15090,15090,,,,15105,15105,15,15,0,0,22
,20131107,15105,15105,,,,15130,15130,25,25,0,0,22
,20131108,15130,15130,,,,15120,15120,-10,-10,0,0,22
,20131111,15120,15120,,,,15135,15135,15,15,0,0,22
,20131112,15135,15135,15040,15050,15040,15050,15045,-85,-90,4,30.09,22
,20131113,15050,15045,14980,14980,14980,14980,14980,-65,-65,2,14.98,24
,20131114,14980,14980,15025,15025,15000,15000,15015,20,35,8,60.07,20
,20131115,15000,15015,15015,15020,14970,14970,15000,-45,-15,10,75.01,16
,20131118,14970,15000,,,,15000,15000,0,0,0,0,16
,20131119,15000,15000,14955,14955,14935,14935,14945,-65,-55,4,29.89,16
,20131120,14935,14945,15045,15045,15045,15045,15045,100,100,4,30.09,14
,20131121,15045,15045,14965,14965,14955,14955,14955,-90,-90,8,59.83,14
,20131122,14955,14955,15035,15035,14970,14970,15000,15,45,4,30.01,16
,20131125,14970,15000,15040,15040,15040,15040,15040,40,40,2,15.04,14
,20131126,15040,15040,,,,15065,15065,25,25,0,0,14
,20131127,15065,15065,,,,15065,15065,0,0,0,0,14
,20131128,15065,15065,14885,14885,14885,14885,14885,-180,-180,4,29.77,18
,20131129,14885,14885,14870,14875,14870,14875,14870,-10,-15,4,29.75,18
,20131202,14875,14870,14930,14930,14930,14930,14930,60,60,2,14.93,20
,20131203,14930,14930,14855,14865,14840,14840,14855,-90,-75,24,178.31,40
,20131204,14840,14855,14900,14900,14900,14900,14900,45,45,2,14.9,42
,20131205,14900,14900,,,,14900,14900,0,0,0,0,42
,20131206,14900,14900,14910,14910,14900,14900,14905,0,5,6,44.72,46
,20131209,14900,14905,14900,14930,14900,14930,14905,25,0,30,223.59,46
,20131210,14930,14905,15075,15080,15035,15075,15070,170,165,12,90.43,44
,20131211,15075,15070,,,,15070,15070,0,0,0,0,44
,20131212,15070,15070,15195,15195,15195,15195,15195,125,125,2,15.2,42
,20131213,15195,15195,15115,15115,15115,15115,15115,-80,-80,2,15.12,42
,20131216,15115,15115,15185,15185,15185,15185,15185,70,70,16,121.48,50
,20131217,15185,15185,15225,15225,15225,15225,15225,40,40,2,15.23,48
,20131218,15225,15225,,,,15165,15165,-60,-60,0,0,48
,20131219,15165,15165,15185,15185,15165,15165,15170,0,5,6,45.52,48
,20131220,15165,15170,15190,15235,15135,15235,15185,65,15,6,45.56,52
,20131223,15235,15185,15315,15315,15240,15240,15300,55,115,14,107.13,62
,20131224,15240,15300,15290,15295,15280,15280,15285,-20,-15,6,45.87,60
,20131225,15280,15285,15385,15490,15370,15465,15445,180,160,28,216.27,70
,20131226,15465,15445,15325,15325,15325,15325,15325,-120,-120,2,15.33,72
,20131227,15325,15325,,,,15155,15155,-170,-170,0,0,72
,20131230,15155,15155,,,,15300,15300,145,145,0,0,72
,20131231,15300,15300,15300,15300,15295,15295,15295,-5,-5,4,30.6,68
zn1411,20131118,15000,15000,,,,15000,15000,0,0,0,0,0
,20131119,15000,15000,,,,15000,15000,0,0,0,0,0
,20131120,15000,15000,,,,15100,15100,100,100,0,0,0
,20131121,15100,15100,,,,15090,15090,-10,-10,0,0,0
,20131122,15090,15090,,,,15135,15135,45,45,0,0,0
,20131125,15135,15135,,,,15175,15175,40,40,0,0,0
,20131126,15175,15175,,,,15200,15200,25,25,0,0,0
,20131127,15200,15200,,,,15200,15200,0,0,0,0,0
,20131128,15200,15200,,,,15015,15015,-185,-185,0,0,0
,20131129,15015,15015,,,,15000,15000,-15,-15,0,0,0
,20131202,15000,15000,,,,15000,15000,0,0,0,0,0
,20131203,15000,15000,,,,14925,14925,-75,-75,0,0,0
,20131204,14925,14925,,,,14925,14925,0,0,0,0,0
,20131205,14925,14925,15090,15090,14880,14880,14985,-45,60,4,29.97,0
,20131206,14880,14985,,,,14990,14990,5,5,0,0,0
,20131209,14990,14990,,,,14990,14990,0,0,0,0,0
,20131210,14990,14990,15110,15110,15015,15015,15080,25,90,28,211.16,6
,20131211,15015,15080,,,,15080,15080,0,0,0,0,6
,20131212,15080,15080,,,,15095,15095,15,15,0,0,6
,20131213,15095,15095,,,,15095,15095,0,0,0,0,6
,20131216,15095,15095,,,,15095,15095,0,0,0,0,6
,20131217,15095,15095,,,,15095,15095,0,0,0,0,6
,20131218,15095,15095,15115,15285,15115,15285,15200,190,105,24,182.4,8
,20131219,15285,15200,15200,15200,15120,15120,15165,-80,-35,88,667.27,54
,20131220,15120,15165,15150,15215,15150,15215,15150,50,-15,40,303.07,14
,20131223,15215,15150,15370,15425,15270,15270,15335,120,185,142,"1,088.92",14
,20131224,15270,15335,15285,15295,15285,15295,15290,-40,-45,4,30.58,14
,20131225,15295,15290,15480,15490,15480,15490,15485,200,195,32,247.82,10
,20131226,15490,15485,15450,15450,15450,15450,15450,-35,-35,2,15.45,10
,20131227,15450,15450,15345,15370,15270,15370,15310,-80,-140,54,413.45,24
,20131230,15370,15310,15265,15385,15265,15345,15330,35,20,34,260.69,28
,20131231,15345,15330,15370,15370,15370,15370,15370,40,40,2,15.37,28
zn1412,20131217,15095,15095,,,,15095,15095,0,0,0,0,0
,20131218,15095,15095,,,,15125,15125,30,30,0,0,0
,20131219,15125,15125,,,,15125,15125,0,0,0,0,0
,20131220,15125,15125,,,,15135,15135,10,10,0,0,0
,20131223,15135,15135,15295,15360,15280,15285,15310,150,175,26,199.04,8
,20131224,15285,15310,15260,15380,15260,15310,15335,0,25,18,138.04,10
,20131225,15310,15335,15460,15555,15460,15545,15495,210,160,26,201.49,26
,20131226,15545,15495,15490,15505,15435,15435,15475,-60,-20,30,232.16,22
,20131227,15435,15475,15340,15390,15340,15390,15365,-85,-110,4,30.73,24
,20131230,15390,15365,15460,15460,15460,15460,15460,95,95,2,15.46,24
,20131231,15460,15460,,,,15455,15455,-5,-5,0,0,24
