合约,日期,前收盘,前结算,开盘价,最高价,最低价,收盘价,结算价,涨跌1,涨跌2,成交量,成交金额,持仓量
ag1601,20160104,3196,3210,3182,3220,3182,3219,3205,9,-5,1660,"7,982.01",14040
,20160105,3219,3205,3224,3242,3202,3226,3225,21,20,1172,"5,670.22",14584
,20160106,3226,3225,3228,3235,3215,3227,3224,2,-1,2456,"11,877.76",15836
,20160107,3227,3224,3235,3292,3224,3271,3254,47,30,3784,"18,472.88",17968
,20160108,3271,3254,3277,3298,3264,3280,3281,26,27,2084,"10,258.69",17928
,20160111,3280,3281,3262,3280,3251,3265,3263,-16,-18,688,"3,367.91",16576
,20160112,3265,3263,3259,3259,3200,3202,3214,-61,-49,368,"1,774.13",16168
,20160113,3202,3214,3200,3240,3162,3212,3200,-2,-14,256,"1,229.02",15996
,20160114,3212,3200,3220,3258,3202,3230,3227,30,27,520,"2,517.76",16316
,20160115,3230,3227,3204,3215,3200,3211,3209,-16,-18,616,"2,965.88",16820
ag1602,20160104,3222,3225,3214,3235,3211,3229,3225,4,0,48,232.25,1036
,20160105,3229,3225,3243,3254,3219,3239,3239,14,14,162,787.11,994
,20160106,3239,3239,3231,3245,3229,3244,3236,5,-3,72,349.52,964
,20160107,3244,3236,3241,3306,3241,3285,3262,49,26,754,"3,689.66",1324
,20160108,3285,3262,3290,3310,3283,3283,3291,21,29,272,"1,342.90",1364
,20160111,3283,3291,3259,3291,3259,3275,3273,-16,-18,174,854.51,1438
,20160112,3275,3273,3272,3272,3201,3211,3243,-62,-30,358,"1,741.91",1606
,20160113,3211,3243,3199,3229,3199,3215,3211,-28,-32,132,635.96,1680
,20160114,3215,3211,3200,3260,3200,3240,3239,29,28,408,"1,982.54",1960
,20160115,3240,3239,3234,3234,3210,3225,3224,-14,-15,58,280.49,1968
,20160118,3225,3224,3227,3263,3226,3226,3235,2,11,496,"2,406.87",2388
,20160119,3226,3235,3227,3254,3227,3254,3235,19,0,398,"1,931.74",2656
,20160120,3254,3235,3254,3275,3219,3275,3243,40,8,442,"2,150.21",2908
,20160121,3275,3243,3269,3269,3244,3260,3252,17,9,1564,"7,630.04",4310
,20160122,3260,3252,3246,3275,3222,3258,3245,6,-7,302,"1,470.09",4466
,20160125,3258,3245,3252,3286,3243,3247,3260,2,15,754,"3,687.70",4892
,20160126,3247,3260,3256,3293,3245,3287,3266,27,6,2036,"9,975.04",6402
,20160127,3287,3266,3274,3303,3271,3285,3291,19,25,1264,"6,240.71",7282
,20160128,3285,3291,3277,3290,3258,3258,3281,-33,-10,1958,"9,636.66",7816
,20160129,3258,3281,3275,3275,3242,3257,3258,-24,-23,568,"2,776.13",8288
,20160201,3257,3258,3260,3271,3250,3271,3263,13,5,2992,"14,646.07",10272
,20160202,3271,3263,3267,3267,3251,3262,3263,-1,0,1252,"6,127.93",10816
,20160203,3262,3263,3259,3280,3250,3262,3258,-1,-5,1540,"7,527.04",11644
,20160204,3262,3258,3300,3310,3298,3307,3302,49,44,1616,"8,004.52",13208
,20160205,3307,3302,3340,3340,3314,3318,3317,16,15,224,"1,114.57",13404
,20160215,3318,3317,3580,3580,3385,3395,3410,78,93,524,"2,680.31",13856
ag1603,20160104,3246,3236,3249,3269,3215,3255,3248,19,12,22,107.19,166
,20160105,3255,3248,3277,3281,3250,3250,3270,2,22,46,225.69,178
,20160106,3250,3270,3250,3263,3245,3263,3252,-7,-18,14,68.30,176
,20160107,3263,3252,3272,3316,3257,3296,3284,44,32,48,236.48,176
,20160108,3296,3284,3305,3323,3291,3305,3302,21,18,42,208.06,188
,20160111,3305,3302,3272,3292,3272,3288,3287,-14,-15,32,157.79,184
,20160112,3288,3287,3285,3285,3230,3230,3258,-57,-29,8,39.10,184
,20160113,3230,3258,3216,3225,3216,3225,3222,-33,-36,6,29.00,184
,20160114,3225,3222,3222,3269,3222,3252,3257,30,35,36,175.90,190
,20160115,3252,3257,3245,3245,3245,3245,3245,-12,-12,2,9.74,192
,20160118,3245,3245,3256,3275,3242,3254,3255,9,10,40,195.31,204
,20160119,3254,3255,3242,3261,3242,3259,3251,4,-4,84,409.70,260
,20160120,3259,3251,3266,3302,3252,3254,3261,3,10,240,"1,174.00",462
,20160121,3254,3261,3266,3281,3244,3266,3261,5,0,76,371.86,468
,20160122,3266,3261,3239,3304,3239,3258,3266,-3,5,122,597.78,512
,20160125,3258,3266,3258,3260,3258,3260,3258,-6,-8,14,68.43,516
,20160126,3260,3258,3258,3300,3258,3300,3283,42,25,100,492.58,558
,20160127,3300,3283,3283,3315,3279,3305,3302,22,19,86,425.96,562
,20160128,3305,3302,3306,3310,3269,3292,3296,-10,-6,132,652.75,578
,20160129,3292,3296,3292,3292,3268,3268,3275,-28,-21,58,284.95,620
,20160201,3268,3275,,,,3275,3275,0,0,0,0.00,620
,20160202,3275,3275,3288,3288,3276,3276,3280,1,5,52,255.84,666
,20160203,3276,3280,3270,3280,3270,3272,3274,-8,-6,16,78.59,674
,20160204,3272,3274,3310,3329,3297,3318,3326,44,52,260,"1,297.38",914
,20160205,3318,3326,3330,3330,3324,3324,3327,-2,1,4,19.96,914
,20160215,3324,3327,3396,3427,3390,3421,3414,94,87,838,"4,292.52",1572
,20160216,3421,3414,3392,3394,3370,3394,3377,-20,-37,2238,"11,339.49",3722
,20160217,3394,3377,3401,3423,3375,3385,3390,8,13,2946,"14,982.28",5590
,20160218,3385,3390,3397,3403,3363,3388,3391,-2,1,1120,"5,698.42",6062
,20160219,3388,3391,3377,3409,3377,3408,3404,17,13,2472,"12,622.84",7810
,20160222,3408,3404,3401,3418,3343,3343,3387,-61,-17,752,"3,820.73",8082
,20160223,3343,3387,3377,3563,3341,3378,3379,-9,-8,334,"1,693.31",8266
,20160224,3378,3379,3378,3383,3372,3379,3378,0,-1,632,"3,202.74",8750
,20160225,3379,3378,3385,3409,3364,3370,3379,-8,1,1708,"8,657.75",9906
,20160226,3370,3379,3345,3363,3329,3345,3346,-34,-33,3404,"17,084.73",11596
,20160229,3345,3346,3345,3345,3171,3252,3278,-94,-68,1216,"5,979.36",12214
,20160301,3252,3278,3295,3299,3285,3299,3289,21,11,226,"1,114.97",12260
,20160302,3299,3289,3282,3289,3263,3271,3267,-18,-22,644,"3,156.25",12644
,20160303,3271,3267,3291,3300,3287,3297,3298,30,31,300,"1,484.42",12836
,20160304,3297,3298,3299,3368,3255,3368,3317,70,19,1988,"9,894.23",14148
,20160307,3368,3317,3333,3429,3333,3411,3406,94,89,920,"4,701.51",14780
,20160308,3411,3406,3430,3480,3375,3375,3431,-31,25,1528,"7,864.56",15760
,20160309,3375,3431,3367,3418,3317,3339,3331,-92,-100,228,"1,139.27",15828
,20160310,3339,3331,3339,3347,3330,3330,3337,-1,6,724,"3,624.72",16032
,20160311,3330,3337,3367,3367,3361,3361,3364,24,27,80,403.68,16072
,20160314,3361,3364,3429,3440,3365,3368,3377,4,13,408,"2,067.14",16084
,20160315,3368,3377,3337,3340,3324,3340,3332,-37,-45,748,"3,738.52",16136
ag1604,20160104,3282,3282,3249,3277,3249,3270,3263,-12,-19,20,97.91,144
,20160105,3270,3263,3294,3294,3287,3287,3290,24,27,4,19.74,140
,20160106,3287,3290,3262,3280,3238,3280,3258,-10,-32,12,58.65,140
,20160107,3280,3258,3273,3336,3273,3330,3312,72,54,26,129.18,132
,20160108,3330,3312,3325,3361,3325,3326,3335,14,23,8,40.03,128
,20160111,3326,3335,3314,3339,3304,3310,3316,-25,-19,8,39.80,132
,20160112,3310,3316,3273,3273,3239,3272,3261,-44,-55,8,39.14,132
,20160113,3272,3261,3245,3245,3245,3245,3245,-16,-16,4,19.47,128
,20160114,3245,3245,3282,3282,3282,3282,3282,37,37,20,98.46,142
,20160115,3282,3282,3282,3282,3265,3266,3276,-16,-6,30,147.44,164
,20160118,3266,3276,3296,3299,3271,3285,3290,9,14,72,355.37,204
,20160119,3285,3290,3280,3283,3274,3280,3280,-10,-10,60,295.23,218
,20160120,3280,3280,3294,3318,3272,3280,3292,0,12,52,256.79,232
,20160121,3280,3292,3298,3298,3293,3296,3295,4,3,16,79.10,226
,20160122,3296,3295,3275,3290,3241,3284,3277,-11,-18,66,324.47,202
,20160125,3284,3277,3287,3304,3273,3277,3284,0,7,234,"1,152.86",212
,20160126,3277,3284,3283,3304,3283,3304,3293,20,9,70,345.79,228
,20160127,3304,3293,3322,3322,3318,3318,3320,25,27,38,189.29,232
,20160128,3318,3320,3301,3316,3291,3315,3309,-5,-11,40,198.55,240
,20160129,3315,3309,,,,3288,3288,-21,-21,0,0.00,240
,20160201,3288,3288,,,,3292,3292,4,4,0,0.00,240
,20160202,3292,3292,3291,3297,3291,3297,3295,5,3,20,98.87,252
,20160203,3297,3295,3303,3311,3303,3308,3308,13,13,16,79.41,238
,20160204,3308,3308,3317,3350,3317,3334,3338,26,30,30,150.23,232
,20160205,3334,3338,3347,3377,3339,3339,3361,1,23,26,131.10,224
,20160215,3339,3361,3407,3443,3407,3443,3423,82,62,34,174.59,224
,20160216,3443,3423,3400,3429,3400,3410,3407,-13,-16,126,644.11,296
,20160217,3410,3407,3383,3415,3383,3410,3406,3,-1,386,"1,972.48",608
,20160218,3410,3406,3405,3407,3403,3403,3405,-3,-1,200,"1,021.77",806
,20160219,3403,3405,3410,3424,3410,3420,3420,15,15,146,749.00,938
,20160222,3420,3420,3420,3425,3397,3398,3417,-22,-3,264,"1,353.43",994
,20160223,3398,3417,3417,3417,3386,3394,3397,-23,-20,120,611.64,1086
,20160224,3394,3397,3399,3440,3374,3393,3400,-4,3,164,836.42,1168
,20160225,3393,3400,3425,3435,3372,3383,3408,-17,8,158,807.82,1204
,20160226,3383,3408,3369,3370,3243,3370,3348,-38,-60,110,552.42,1220
,20160229,3370,3348,3355,3355,3269,3269,3305,-79,-43,52,257.83,1218
,20160301,3269,3305,3278,3301,3278,3301,3297,-4,-8,16,79.14,1226
,20160302,3301,3297,3303,3303,3284,3289,3288,-8,-9,146,720.13,1208
,20160303,3289,3288,3300,3310,3294,3308,3300,20,12,158,782.18,1268
,20160304,3308,3300,3310,3368,3310,3368,3333,68,33,16,80.00,1268
,20160307,3368,3333,3363,3465,3363,3432,3437,99,104,68,350.65,1288
,20160308,3432,3437,3489,3495,3408,3408,3459,-29,22,370,"1,919.99",1538
,20160309,3408,3459,3408,3408,3340,3357,3353,-102,-106,124,623.80,1568
,20160310,3357,3353,3353,3374,3351,3351,3356,-2,3,172,865.94,1556
,20160311,3351,3356,3340,3419,3340,3403,3374,47,18,164,830.08,1568
,20160314,3403,3374,3376,3395,3351,3395,3384,21,10,2118,"10,753.87",3116
,20160315,3395,3384,3373,3375,3349,3350,3355,-34,-29,614,"3,090.84",3430
,20160316,3350,3355,3359,3360,3333,3360,3357,5,2,1752,"8,824.40",4748
,20160317,3360,3357,3364,3408,3347,3393,3388,36,31,1236,"6,282.04",5278
,20160318,3393,3388,3399,3486,3399,3483,3458,95,70,1150,"5,965.28",6046
,20160321,3483,3458,3445,3445,3421,3432,3432,-26,-26,670,"3,450.06",6514
,20160322,3432,3432,3442,3478,3427,3478,3449,46,17,796,"4,119.10",7134
,20160323,3478,3449,3454,3465,3427,3427,3448,-22,-1,710,"3,672.96",7704
,20160324,3427,3448,3375,3380,3372,3372,3374,-76,-74,52,263.18,7740
,20160325,3372,3374,3374,3377,3322,3364,3362,-10,-12,678,"3,419.99",8080
,20160328,3364,3362,3374,3396,3326,3373,3368,11,6,1384,"6,993.75",9204
,20160329,3373,3368,3375,3380,3345,3354,3365,-14,-3,1356,"6,846.10",10096
,20160330,3354,3365,3364,3389,3340,3378,3376,13,11,5806,"29,402.96",13408
,20160331,3378,3376,3367,3380,3344,3365,3366,-11,-10,1934,"9,766.09",14572
,20160401,3365,3366,3382,3382,3365,3378,3375,12,9,320,"1,620.10",14828
,20160405,3378,3375,3335,3339,3332,3336,3334,-39,-41,296,"1,480.54",15072
,20160406,3336,3334,3340,3347,3325,3327,3333,-7,-1,1172,"5,859.69",16164
,20160407,3327,3333,3335,3339,3332,3339,3333,6,0,928,"4,640.74",17080
,20160408,3339,3333,3350,3380,3335,3335,3362,2,29,2676,"13,495.58",18664
,20160411,3335,3362,3350,3382,3333,3380,3370,18,8,484,"2,446.68",18820
,20160412,3380,3370,3427,3427,3427,3427,3427,57,57,8,41.12,18828
,20160413,3427,3427,3442,3445,3400,3440,3438,13,11,1292,"6,663.76",19592
,20160414,3440,3438,3430,3438,3422,3422,3433,-16,-5,588,"3,028.06",20100
,20160415,3422,3433,3460,3460,3352,3451,3450,18,17,280,"1,449.27",20132
ag1605,20160104,3281,3287,3274,3297,3264,3293,3276,6,-11,5748,"28,253.15",1238
,20160105,3293,3276,3295,3319,3289,3296,3309,20,33,656,"3,256.95",1124
,20160106,3296,3309,3296,3307,3286,3306,3294,-3,-15,112,553.39,1116
,20160107,3306,3294,3306,3385,3300,3349,3339,55,45,948,"4,748.11",1150
,20160108,3349,3339,3353,3390,3335,3342,3352,3,13,786,"3,952.74",1224
,20160111,3342,3352,3330,3345,3315,3336,3328,-16,-24,574,"2,865.86",1218
,20160112,3336,3328,3323,3325,3270,3270,3283,-58,-45,140,689.44,1236
,20160113,3270,3283,3260,3277,3256,3258,3261,-25,-22,634,"3,101.83",1280
,20160114,3258,3261,3263,3327,3259,3303,3298,42,37,308,"1,523.78",1298
,20160115,3303,3298,3291,3293,3274,3282,3280,-16,-18,160,787.42,1288
,20160118,3282,3280,3297,3309,3108,3292,3294,12,14,456,"2,253.50",1390
,20160119,3292,3294,3290,3303,3287,3303,3294,9,0,110,543.52,1430
,20160120,3303,3294,3305,3316,3297,3301,3304,7,10,198,981.32,1416
,20160121,3301,3304,3327,3339,3307,3313,3313,9,9,152,755.40,1478
,20160122,3313,3313,3299,3309,3288,3306,3299,-7,-14,184,910.68,1512
,20160125,3306,3299,3310,3338,3300,3308,3317,9,18,154,766.43,1518
,20160126,3308,3317,3321,3339,3315,3339,3325,22,8,130,648.49,1518
,20160127,3339,3325,3331,3363,3331,3350,3346,25,21,844,"4,236.71",1620
,20160128,3350,3346,3348,3356,3329,3330,3342,-16,-4,370,"1,854.94",1656
,20160129,3330,3342,3331,3332,3313,3316,3319,-26,-23,80,398.34,1662
,20160201,3316,3319,3306,3343,3305,3316,3324,-3,5,368,"1,835.01",1736
,20160202,3316,3324,3316,3335,3313,3317,3316,-7,-8,260,"1,293.44",1734
,20160203,3317,3316,3322,3333,3311,3320,3323,4,7,88,438.67,1734
,20160204,3320,3323,3439,3439,3324,3368,3361,45,38,358,"1,804.98",1778
,20160205,3368,3361,3376,3399,3368,3369,3382,8,21,272,"1,380.14",1752
,20160215,3369,3382,3472,3472,3436,3450,3451,68,69,296,"1,532.30",1818
,20160216,3450,3451,3445,3462,3420,3434,3439,-17,-12,406,"2,094.91",1800
,20160217,3434,3439,3439,3445,3428,3437,3435,-2,-4,266,"1,370.70",1832
,20160218,3437,3435,3440,3446,3431,3431,3437,-4,2,568,"2,928.80",1980
,20160219,3431,3437,3432,3454,3428,3449,3445,12,8,730,"3,772.46",2274
,20160222,3449,3445,3455,3455,3302,3425,3433,-20,-12,360,"1,853.88",2202
,20160223,3425,3433,3411,3425,3407,3420,3418,-13,-15,62,317.95,2176
,20160224,3420,3418,3422,3433,3420,3423,3423,5,5,194,996.20,2180
,20160225,3423,3423,3423,3455,3407,3408,3427,-15,4,190,976.76,2216
,20160226,3408,3427,3417,3417,3370,3384,3390,-43,-37,360,"1,830.78",2170
,20160229,3384,3390,3375,3379,3276,3293,3314,-97,-76,240,"1,193.38",2174
,20160301,3293,3314,3306,3330,3294,3323,3318,9,4,140,696.90,2154
,20160302,3323,3318,3337,3337,3294,3307,3314,-11,-4,306,"1,521.31",2198
,20160303,3307,3314,3324,3338,3311,3326,3323,12,9,164,817.52,2208
,20160304,3326,3323,3327,3414,3325,3414,3356,91,33,436,"2,195.01",2212
,20160307,3414,3356,3401,3490,3367,3461,3463,105,107,1088,"5,652.11",2434
,20160308,3461,3463,3474,3536,3415,3427,3462,-36,-1,1606,"8,340.66",2374
,20160309,3427,3462,3438,3457,3344,3374,3385,-88,-77,1244,"6,318.19",2692
,20160310,3374,3385,3379,3406,3362,3372,3378,-13,-7,908,"4,600.96",3068
,20160311,3372,3378,3380,3444,3380,3406,3417,28,39,526,"2,696.50",3090
,20160314,3406,3417,3424,3425,3396,3418,3407,1,-10,448,"2,289.59",3302
,20160315,3418,3407,3427,3461,3360,3375,3389,-32,-18,254,"1,291.58",3248
,20160316,3375,3389,3381,3381,3362,3376,3375,-13,-14,778,"3,939.79",3822
,20160317,3376,3375,3376,3429,3362,3416,3411,41,36,304,"1,555.44",3788
,20160318,3416,3411,3424,3506,3424,3497,3472,86,61,720,"3,750.11",4080
,20160321,3497,3472,3477,3478,3430,3443,3451,-29,-21,374,"1,936.02",4056
,20160322,3443,3451,3459,3490,3447,3488,3465,37,14,542,"2,817.18",4356
,20160323,3488,3465,3476,3487,3440,3445,3461,-20,-4,302,"1,567.86",4392
,20160324,3445,3461,3400,3421,3381,3388,3398,-73,-63,574,"2,926.14",4256
,20160325,3388,3398,3410,3419,3378,3385,3394,-13,-4,730,"3,717.23",4302
,20160328,3385,3394,3381,3406,3380,3384,3391,-10,-3,642,"3,266.15",4394
,20160329,3384,3391,3393,3400,3368,3374,3379,-17,-12,1020,"5,170.74",4822
,20160330,3374,3379,3382,3408,3369,3408,3396,29,17,1902,"9,690.70",5962
,20160331,3408,3396,3392,3400,3372,3380,3381,-16,-15,632,"3,205.61",6430
,20160401,3380,3381,3405,3412,3388,3394,3396,13,15,520,"2,648.90",6632
,20160405,3394,3396,3394,3394,3336,3348,3351,-48,-45,688,"3,458.31",6978
,20160406,3348,3351,3359,3361,3349,3349,3355,-2,4,406,"2,043.63",7210
,20160407,3349,3355,3350,3358,3332,3354,3353,-1,-2,664,"3,340.38",7646
,20160408,3354,3353,3366,3380,3356,3358,3366,5,13,828,"4,180.74",8226
,20160411,3358,3366,3371,3403,3368,3397,3390,31,24,1118,"5,685.66",9064
,20160412,3397,3390,3422,3449,3418,3446,3429,56,39,566,"2,911.23",9396
,20160413,3446,3429,3462,3480,3450,3458,3463,29,34,1766,"9,173.97",9564
,20160414,3458,3463,3477,3500,3450,3459,3462,-4,-1,526,"2,731.89",9776
,20160415,3459,3462,3459,3470,3455,3466,3463,4,1,1196,"6,213.04",10516
,20160418,3466,3463,3461,3507,3453,3466,3470,3,7,2448,"12,744.53",11924
,20160419,3466,3470,3500,3630,3469,3626,3498,156,28,3368,"17,676.68",13492
,20160420,3626,3498,3653,3707,3630,3645,3673,147,175,1228,"6,767.29",13710
,20160421,3645,3673,3677,3810,3672,3808,3740,135,67,3136,"17,595.87",15678
,20160422,3808,3740,3847,3847,3652,3665,3706,-75,-34,2428,"13,498.79",15698
,20160425,3665,3706,3727,3736,3604,3664,3661,-42,-45,1158,"6,359.76",16354
,20160426,3664,3661,3671,3684,3605,3649,3660,-12,-1,970,"5,325.41",16420
,20160427,3649,3660,3660,3750,3659,3743,3719,83,59,1484,"8,280.46",17114
,20160428,3743,3719,3716,3797,3678,3734,3709,15,-10,1724,"9,592.94",18296
,20160429,3734,3709,3734,3869,3703,3810,3785,101,76,4992,"28,344.29",21112
,20160503,3810,3785,3800,3813,3769,3792,3788,7,3,5592,"31,780.21",25552
,20160504,3792,3788,3793,3797,3706,3722,3736,-66,-52,3256,"18,248.93",28032
,20160505,3722,3736,3736,3756,3728,3741,3745,5,9,2196,"12,339.02",28376
,20160506,3741,3745,3765,3773,3706,3710,3733,-35,-12,728,"4,076.77",28488
,20160509,3710,3733,3724,3741,3705,3707,3718,-26,-15,316,"1,762.64",28336
,20160510,3707,3718,3660,3660,3614,3634,3628,-84,-90,2712,"14,759.81",26892
,20160511,3634,3628,3672,3694,3672,3694,3678,66,50,28,154.49,26868
,20160512,3694,3678,3739,3739,3682,3705,3687,27,9,572,"3,163.91",26836
,20160513,3705,3687,3692,3705,3630,3650,3662,-37,-25,248,"1,362.29",26832
,20160516,3650,3662,3658,3689,3658,3670,3664,8,2,76,417.77,26836
ag1606,20160104,3290,3294,3302,3312,3250,3305,3293,11,-1,310492,"1,533,682.73",498550
,20160105,3305,3293,3303,3330,3294,3313,3313,20,20,574222,"2,853,811.65",480342
,20160106,3313,3313,3315,3321,3296,3314,3307,1,-6,409052,"2,029,631.14",499704
,20160107,3314,3307,3320,3385,3308,3357,3340,50,33,976372,"4,891,953.31",528526
,20160108,3357,3340,3360,3390,3345,3356,3364,16,24,759474,"3,833,039.84",491744
,20160111,3356,3364,3343,3362,3322,3349,3344,-15,-20,566072,"2,839,465.16",491476
,20160112,3349,3344,3343,3350,3280,3288,3315,-56,-29,492728,"2,450,096.76",491574
,20160113,3288,3315,3283,3288,3262,3274,3277,-41,-38,330408,"1,624,290.71",489438
,20160114,3274,3277,3275,3325,3270,3312,3307,35,30,643000,"3,190,504.79",477542
,20160115,3312,3307,3296,3309,3284,3294,3295,-13,-12,416502,"2,058,662.85",474618
,20160118,3294,3295,3296,3323,3296,3301,3309,6,14,534562,"2,653,607.27",474614
,20160119,3301,3309,3305,3321,3299,3317,3309,8,0,295732,"1,468,106.37",488636
,20160120,3317,3309,3317,3334,3311,3315,3320,6,11,434388,"2,163,282.09",474574
,20160121,3315,3320,3338,3340,3322,3331,3329,11,9,399366,"1,994,402.49",471280
,20160122,3331,3329,3319,3330,3301,3323,3315,-6,-14,458828,"2,281,899.34",481522
,20160125,3323,3315,3327,3354,3314,3323,3331,8,16,585878,"2,927,915.44",471768
,20160126,3323,3331,3331,3361,3326,3360,3342,29,11,518926,"2,601,574.86",506304
,20160127,3360,3342,3356,3378,3346,3365,3362,23,20,544132,"2,744,257.88",498196
,20160128,3365,3362,3361,3374,3347,3352,3361,-10,-1,358048,"1,805,260.55",485058
,20160129,3352,3361,3347,3357,3329,3333,3338,-28,-23,392284,"1,964,617.28",481378
,20160201,3333,3338,3329,3348,3322,3343,3335,5,-3,333956,"1,671,064.67",482956
,20160202,3343,3335,3345,3356,3329,3338,3342,3,7,304078,"1,524,436.40",481826
,20160203,3338,3342,3337,3353,3329,3341,3340,-1,-2,315100,"1,578,922.35",482866
,20160204,3341,3340,3350,3394,3335,3388,3368,48,28,737350,"3,725,864.99",497720
,20160205,3388,3368,3399,3422,3386,3389,3403,21,35,474598,"2,423,023.85",477858
,20160215,3389,3403,3480,3500,3456,3470,3473,67,70,389252,"2,028,130.06",481734
,20160216,3470,3473,3464,3474,3442,3463,3459,-10,-14,356966,"1,852,629.43",497130
,20160217,3463,3459,3470,3473,3449,3466,3462,7,3,300972,"1,563,051.53",505446
,20160218,3466,3462,3465,3472,3455,3455,3463,-7,1,250364,"1,300,708.04",511542
,20160219,3455,3463,3455,3478,3452,3472,3467,9,4,288542,"1,500,966.35",527076
,20160222,3472,3467,3476,3484,3443,3446,3464,-21,-3,406224,"2,110,998.34",524986
,20160223,3446,3464,3425,3452,3424,3444,3440,-20,-24,313294,"1,616,854.49",515584
,20160224,3444,3440,3444,3455,3438,3441,3447,1,7,273304,"1,413,178.70",533854
,20160225,3441,3447,3451,3478,3428,3433,3453,-14,6,675372,"3,498,595.02",575844
,20160226,3433,3453,3430,3432,3392,3408,3411,-45,-42,523638,"2,679,420.29",569722
,20160229,3408,3411,3409,3409,3304,3312,3347,-99,-64,776704,"3,899,555.69",559186
,20160301,3312,3347,3321,3355,3307,3346,3334,-1,-13,468556,"2,343,248.90",543062
,20160302,3346,3334,3353,3359,3313,3330,3331,-4,-3,488806,"2,442,868.66",553160
,20160303,3330,3331,3334,3364,3328,3347,3345,16,14,486506,"2,441,303.67",564056
,20160304,3347,3345,3350,3434,3339,3426,3382,81,37,779882,"3,956,423.36",626064
,20160307,3426,3382,3425,3516,3384,3481,3465,99,83,1664662,"8,653,933.26",643948
,20160308,3481,3465,3497,3550,3426,3450,3489,-15,24,1323092,"6,924,686.12",644694
,20160309,3450,3489,3459,3466,3366,3396,3416,-93,-73,793226,"4,065,233.18",594136
,20160310,3396,3416,3400,3420,3380,3391,3400,-25,-16,579998,"2,958,552.41",602394
,20160311,3391,3400,3389,3475,3372,3434,3432,34,32,997188,"5,134,829.00",617576
,20160314,3434,3432,3429,3448,3413,3433,3433,1,1,559172,"2,879,807.51",633430
,20160315,3433,3433,3446,3484,3383,3395,3425,-38,-8,874896,"4,495,913.24",617952
,20160316,3395,3425,3392,3406,3378,3404,3393,-21,-32,353844,"1,801,112.02",616076
,20160317,3404,3393,3396,3458,3387,3438,3421,45,28,472724,"2,426,454.99",635010
,20160318,3438,3421,3449,3543,3443,3521,3496,100,75,1425298,"7,475,176.79",752824
,20160321,3521,3496,3505,3508,3457,3470,3475,-26,-21,741118,"3,864,148.10",689568
,20160322,3470,3475,3470,3520,3469,3516,3491,41,16,568930,"2,979,978.25",742450
,20160323,3516,3491,3510,3515,3463,3469,3489,-22,-2,627798,"3,286,462.11",692722
,20160324,3469,3489,3431,3434,3405,3409,3419,-80,-70,685476,"3,515,768.37",607844
,20160325,3409,3419,3420,3425,3401,3410,3413,-9,-6,293002,"1,500,398.86",616024
,20160328,3410,3413,3404,3420,3400,3406,3410,-7,-3,256618,"1,312,818.63",609094
,20160329,3406,3410,3416,3428,3390,3393,3408,-17,-2,349684,"1,787,651.98",607560
,20160330,3393,3408,3392,3433,3392,3424,3413,16,5,522622,"2,676,314.60",583444
,20160331,3424,3413,3415,3428,3395,3406,3409,-7,-4,345438,"1,766,421.41",581458
,20160401,3406,3409,3431,3436,3410,3421,3421,12,12,392956,"2,016,803.76",577138
,20160405,3421,3421,3361,3382,3342,3370,3367,-51,-54,205890,"1,040,155.73",560710
,20160406,3370,3367,3384,3387,3367,3371,3377,4,10,217914,"1,104,060.19",566404
,20160407,3371,3377,3357,3387,3355,3377,3373,0,-4,267182,"1,352,181.31",566728
,20160408,3377,3373,3394,3405,3378,3380,3390,7,17,283456,"1,441,728.68",567292
,20160411,3380,3390,3386,3429,3381,3418,3407,28,17,408412,"2,087,291.49",587716
,20160412,3418,3407,3448,3471,3441,3467,3455,60,48,587910,"3,047,100.65",650158
,20160413,3467,3455,3489,3507,3472,3483,3488,28,33,713772,"3,734,793.66",666908
,20160414,3483,3488,3491,3528,3465,3485,3495,-3,7,703608,"3,689,488.04",678608
,20160415,3485,3495,3492,3506,3476,3492,3488,-3,-7,399568,"2,090,886.26",690528
,20160418,3492,3488,3488,3535,3472,3484,3500,-4,12,733228,"3,849,578.05",690902
,20160419,3484,3500,3505,3658,3490,3646,3543,146,43,949978,"5,049,470.26",790292
,20160420,3646,3543,3689,3755,3650,3679,3695,136,152,1648032,"9,136,442.12",712300
,20160421,3679,3695,3701,3849,3689,3811,3756,116,61,1587208,"8,942,644.05",705886
,20160422,3811,3756,3862,3877,3668,3708,3735,-48,-21,1490126,"8,349,866.17",577566
,20160425,3708,3735,3737,3768,3633,3693,3700,-42,-35,1237514,"6,869,297.44",559032
,20160426,3693,3700,3686,3710,3666,3671,3689,-29,-11,648582,"3,589,521.22",529962
,20160427,3671,3689,3677,3781,3675,3774,3727,85,38,841362,"4,704,895.42",559280
,20160428,3774,3727,3778,3785,3710,3757,3741,30,14,916786,"5,144,970.35",515250
,20160429,3757,3741,3757,3873,3745,3831,3812,90,71,937576,"5,361,957.92",489332
,20160503,3831,3812,3810,3839,3782,3827,3815,15,3,281040,"1,608,517.23",462218
,20160504,3827,3815,3801,3827,3739,3745,3777,-70,-38,521412,"2,954,608.11",419968
,20160505,3745,3777,3774,3778,3737,3761,3759,-16,-18,359362,"2,026,692.12",408474
,20160506,3761,3759,3793,3803,3706,3730,3747,-29,-12,610562,"3,432,339.40",387152
,20160509,3730,3747,3750,3776,3718,3723,3746,-24,-1,499960,"2,809,614.49",366992
,20160510,3723,3746,3694,3694,3620,3661,3654,-85,-92,390588,"2,141,084.83",327324
,20160511,3661,3654,3645,3716,3644,3699,3676,45,22,213130,"1,175,441.05",316058
,20160512,3699,3676,3732,3748,3703,3715,3725,39,49,181348,"1,013,376.67",307610
,20160513,3715,3725,3706,3738,3645,3682,3687,-43,-38,212162,"1,173,629.75",288464
,20160516,3682,3687,3657,3727,3650,3724,3686,37,-1,134022,"741,203.48",281588
,20160517,3724,3686,3734,3736,3690,3708,3709,22,23,84492,"470,179.79",268722
,20160518,3708,3709,3690,3728,3681,3681,3705,-28,-4,96178,"534,510.80",245704
,20160519,3681,3705,3678,3707,3596,3599,3657,-106,-48,128550,"705,260.57",223074
,20160520,3599,3657,3566,3596,3553,3576,3572,-81,-85,94082,"504,189.40",204156
,20160523,3576,3572,3592,3608,3530,3551,3568,-21,-4,87692,"469,372.45",186806
,20160524,3551,3568,3548,3561,3521,3525,3541,-43,-27,55948,"297,241.91",177520
,20160525,3525,3541,3526,3559,3520,3525,3533,-16,-8,55686,"295,151.82",166086
,20160526,3525,3533,3529,3570,3528,3564,3546,31,13,61912,"329,372.53",162268
,20160527,3564,3546,3566,3578,3503,3529,3535,-17,-11,56996,"302,306.10",153700
,20160530,3529,3535,3530,3537,3450,3462,3486,-73,-49,61664,"322,504.21",136932
,20160531,3462,3486,3461,3499,3461,3482,3480,-4,-6,40112,"209,421.18",128706
,20160601,3482,3480,3473,3489,3473,3483,3482,3,2,14222,"74,297.01",126388
,20160602,3483,3482,3488,3492,3445,3490,3482,8,0,20404,"106,586.47",118124
,20160603,3490,3482,3483,3498,3477,3497,3485,15,3,10024,"52,406.35",113340
,20160606,3497,3485,3550,3571,3544,3562,3559,77,74,13376,"71,424.17",108504
,20160607,3562,3559,3560,3585,3554,3565,3571,6,12,13212,"70,789.27",105128
,20160608,3565,3571,3545,3610,3545,3609,3582,38,11,9692,"52,085.94",101216
,20160613,3609,3582,3609,3780,3609,3730,3715,148,133,3180,"17,722.78",99620
,20160614,3730,3715,3753,3755,3732,3740,3742,25,27,2484,"13,943.22",98252
,20160615,3740,3742,3761,3761,3680,3755,3751,13,9,5048,"28,409.96",98640
ag1607,20160104,3312,3310,,,,3310,3310,0,0,0,0.00,40
,20160105,3310,3310,,,,3310,3310,0,0,0,0.00,40
,20160106,3310,3310,,,,3310,3310,0,0,0,0.00,40
,20160107,3310,3310,3333,3404,3322,3381,3357,71,47,48,241.76,48
,20160108,3381,3357,3365,3366,3365,3366,3365,9,8,14,70.67,42
,20160111,3366,3365,3345,3356,3345,3356,3350,-9,-15,4,20.10,42
,20160112,3356,3350,3344,3344,3300,3300,3314,-50,-36,6,29.83,44
,20160113,3300,3314,,,,3314,3314,0,0,0,0.00,44
,20160114,3314,3314,,,,3314,3314,0,0,0,0.00,44
,20160115,3314,3314,,,,3314,3314,0,0,0,0.00,44
,20160118,3314,3314,3314,3318,3314,3318,3316,4,2,4,19.90,46
,20160119,3318,3316,,,,3316,3316,0,0,0,0.00,46
,20160120,3316,3316,3340,3340,3315,3315,3335,-1,19,14,70.04,44
,20160121,3315,3335,3343,3343,3343,3343,3343,8,8,2,10.03,44
,20160122,3343,3343,,,,3343,3343,0,0,0,0.00,44
,20160125,3343,3343,3321,3321,3321,3321,3321,-22,-22,2,9.96,42
,20160126,3321,3321,,,,3321,3321,0,0,0,0.00,42
,20160127,3321,3321,3370,3387,3366,3377,3374,56,53,14,70.86,46
,20160128,3377,3374,3360,3360,3360,3360,3360,-14,-14,4,20.16,46
,20160129,3360,3360,,,,3337,3337,-23,-23,0,0.00,46
,20160201,3337,3337,,,,3337,3337,0,0,0,0.00,46
,20160202,3337,3337,3367,3367,3350,3350,3358,13,21,8,40.31,50
,20160203,3350,3358,3351,3351,3325,3334,3338,-24,-20,130,650.99,62
,20160204,3334,3338,3362,3398,3359,3398,3367,60,29,14,70.71,50
,20160205,3398,3367,3427,3427,3420,3420,3422,53,55,6,30.80,54
,20160215,3420,3422,3486,3488,3486,3488,3487,66,65,4,20.92,54
,20160216,3488,3487,3476,3476,3476,3476,3476,-11,-11,6,31.28,60
,20160217,3476,3476,,,,3476,3476,0,0,0,0.00,60
,20160218,3476,3476,3486,3486,3469,3469,3479,-7,3,10,52.19,62
,20160219,3469,3479,3489,3489,3488,3488,3488,9,9,6,31.40,56
,20160222,3488,3488,3491,3491,3465,3465,3477,-23,-11,10,52.16,54
,20160223,3465,3477,3445,3445,3445,3445,3445,-32,-32,6,31.01,52
,20160224,3445,3445,3472,3472,3458,3458,3466,13,21,22,114.39,58
,20160225,3458,3466,3469,3485,3446,3453,3468,-13,2,90,468.20,118
,20160226,3453,3468,3432,3438,3412,3422,3432,-46,-36,376,"1,935.69",160
,20160229,3422,3432,3334,3334,3330,3331,3331,-101,-101,8,39.98,154
,20160301,3331,3331,3365,3375,3361,3367,3366,36,35,12,60.60,154
,20160302,3367,3366,3378,3378,3337,3342,3343,-24,-23,36,180.57,144
,20160303,3342,3343,3368,3368,3363,3363,3367,20,24,82,414.25,220
,20160304,3363,3367,3360,3434,3360,3434,3410,67,43,158,808.36,344
,20160307,3434,3410,3408,3532,3408,3489,3486,79,76,172,899.62,360
,20160308,3489,3486,3506,3556,3445,3458,3470,-28,-16,180,936.98,320
,20160309,3458,3470,3473,3473,3401,3402,3443,-68,-27,44,227.30,296
,20160310,3402,3443,3422,3423,3403,3423,3414,-20,-29,24,122.92,298
,20160311,3423,3414,3416,3485,3416,3440,3461,26,47,630,"3,271.15",426
,20160314,3440,3461,3446,3464,3438,3438,3447,-23,-14,114,589.46,446
,20160315,3438,3447,3477,3498,3370,3400,3433,-47,-14,60,309.02,426
,20160316,3400,3433,3409,3409,3399,3399,3407,-34,-26,14,71.56,412
,20160317,3399,3407,3401,3461,3401,3441,3437,34,30,56,288.74,426
,20160318,3441,3437,3481,3551,3480,3551,3508,114,71,250,"1,315.79",430
,20160321,3551,3508,3505,3505,3479,3484,3490,-24,-18,196,"1,026.28",446
,20160322,3484,3490,3487,3518,3487,3517,3500,27,10,80,420.06,408
,20160323,3517,3500,3514,3523,3491,3498,3498,-2,-2,138,724.28,408
,20160324,3498,3498,3424,3441,3419,3419,3426,-79,-72,68,349.46,404
,20160325,3419,3426,3432,3434,3414,3414,3426,-12,0,38,195.30,404
,20160328,3414,3426,3422,3425,3410,3417,3419,-9,-7,32,164.15,408
,20160329,3417,3419,,,,3419,3419,0,0,0,0.00,408
,20160330,3419,3419,3435,3435,3432,3432,3432,13,13,10,51.49,408
,20160331,3432,3432,3430,3430,3407,3413,3425,-19,-7,38,195.23,408
,20160401,3413,3425,,,,3425,3425,0,0,0,0.00,408
,20160405,3425,3425,3382,3392,3381,3392,3383,-33,-42,20,101.52,428
,20160406,3392,3383,3383,3384,3377,3384,3380,1,-3,8,40.56,426
,20160407,3384,3380,3383,3391,3383,3384,3386,4,6,6,30.47,424
,20160408,3384,3386,3397,3412,3391,3391,3403,5,17,30,153.14,414
,20160411,3391,3403,3424,3424,3424,3424,3424,21,21,4,20.54,412
,20160412,3424,3424,3449,3474,3449,3474,3468,50,44,44,228.89,418
,20160413,3474,3468,3500,3502,3487,3494,3495,26,27,62,325.05,426
,20160414,3494,3495,3527,3544,3494,3494,3503,-1,8,86,451.97,420
,20160415,3494,3503,3516,3516,3489,3500,3498,-3,-5,54,283.41,420
,20160418,3500,3498,3488,3536,3488,3498,3508,0,10,172,905.24,450
,20160419,3498,3508,3519,3679,3503,3663,3594,155,86,200,"1,078.47",444
,20160420,3663,3594,3721,3772,3652,3710,3735,116,141,888,"4,976.01",560
,20160421,3710,3735,3711,3851,3708,3837,3774,102,39,114,645.41,534
,20160422,3837,3774,3948,3948,3666,3701,3743,-73,-31,198,"1,111.70",496
,20160425,3701,3743,3758,3773,3545,3707,3713,-36,-30,836,"4,657.20",650
,20160426,3707,3713,3698,3721,3697,3697,3710,-16,-3,30,166.95,650
,20160427,3697,3710,3718,3788,3707,3785,3725,75,15,1082,"6,046.82",632
,20160428,3785,3725,3788,3788,3729,3773,3752,48,27,110,619.16,572
,20160429,3773,3752,3766,3883,3766,3850,3857,98,105,278,"1,608.58",664
,20160503,3850,3857,3843,3849,3806,3840,3834,-17,-23,178,"1,023.74",752
,20160504,3840,3834,3837,3857,3756,3762,3811,-72,-23,432,"2,469.95",724
,20160505,3762,3811,3776,3793,3756,3777,3778,-34,-33,176,997.43,782
,20160506,3777,3778,3799,3813,3728,3743,3773,-35,-5,516,"2,920.82",856
,20160509,3743,3773,3774,3790,3743,3743,3761,-30,-12,202,"1,139.88",850
,20160510,3743,3761,3692,3706,3631,3676,3674,-85,-87,350,"1,928.95",900
,20160511,3676,3674,3677,3728,3662,3724,3710,50,36,358,"1,992.32",960
,20160512,3724,3710,3755,3759,3725,3732,3739,22,29,184,"1,032.23",912
,20160513,3732,3739,3715,3749,3664,3700,3703,-39,-36,124,688.94,898
,20160516,3700,3703,3679,3738,3679,3737,3719,34,16,158,881.62,854
,20160517,3737,3719,3750,3750,3708,3721,3722,2,3,32,178.70,856
,20160518,3721,3722,3725,3740,3705,3705,3726,-17,4,144,805.02,848
,20160519,3705,3726,3680,3710,3606,3610,3667,-116,-59,166,913.23,852
,20160520,3610,3667,3577,3596,3570,3586,3582,-81,-85,216,"1,160.85",898
,20160523,3586,3582,3609,3609,3546,3546,3584,-36,2,58,311.89,882
,20160524,3546,3584,3554,3571,3533,3543,3549,-41,-35,128,681.59,880
,20160525,3543,3549,3540,3546,3538,3538,3541,-11,-8,66,350.59,848
,20160526,3538,3541,3542,3579,3542,3566,3559,25,18,86,459.13,858
,20160527,3566,3559,3583,3583,3520,3537,3541,-22,-18,84,446.22,828
,20160530,3537,3541,3544,3544,3468,3474,3481,-67,-60,206,"1,075.88",820
,20160531,3474,3481,3470,3511,3470,3501,3492,20,11,258,"1,351.64",918
,20160601,3501,3492,3484,3507,3483,3501,3496,9,4,194,"1,017.52",986
,20160602,3501,3496,3502,3507,3495,3505,3500,9,4,172,903.16,1000
,20160603,3505,3500,3504,3518,3495,3518,3506,18,6,46,241.92,1000
,20160606,3518,3506,3570,3589,3564,3577,3576,71,70,276,"1,480.56",1100
,20160607,3577,3576,3591,3594,3578,3584,3585,8,9,116,623.92,1142
,20160608,3584,3585,3581,3620,3577,3620,3598,35,13,88,475.04,1138
,20160613,3620,3598,3735,3760,3710,3746,3734,148,136,320,"1,792.35",1106
,20160614,3746,3734,3762,3765,3733,3750,3751,16,17,162,911.59,1126
,20160615,3750,3751,3768,3781,3755,3771,3766,20,15,180,"1,016.92",1180
,20160616,3771,3766,3770,3844,3754,3840,3817,74,51,322,"1,843.64",1306
,20160617,3840,3817,3840,3840,3718,3741,3766,-76,-51,356,"2,011.34",1304
,20160620,3741,3766,3759,3769,3736,3750,3748,-16,-18,472,"2,654.25",1662
,20160621,3750,3748,3750,3780,3748,3756,3759,8,11,2122,"11,965.50",2848
,20160622,3756,3759,3722,3733,3680,3680,3718,-79,-41,872,"4,863.91",2858
,20160623,3680,3718,3714,3736,3706,3717,3722,-1,4,692,"3,863.76",2990
,20160624,3717,3722,3734,3826,3721,3809,3774,87,52,680,"3,849.71",3046
,20160627,3809,3774,3846,3846,3804,3830,3818,56,44,446,"2,554.62",3160
,20160628,3830,3818,3831,3832,3796,3808,3814,-10,-4,138,789.63,3204
,20160629,3808,3814,3824,3961,3824,3939,3865,125,51,746,"4,325.72",3644
,20160630,3939,3865,3977,3986,3929,3929,3958,64,93,308,"1,828.76",3622
,20160701,3929,3958,3979,4194,3943,4152,4087,194,129,238,"1,459.23",3604
,20160704,4152,4087,4138,4319,4138,4319,4246,232,159,44,280.24,3608
,20160705,4319,4246,4488,4488,4249,4330,4317,84,71,988,"6,399.16",4272
,20160706,4330,4317,4321,4489,4241,4417,4367,100,50,856,"5,607.97",4412
,20160707,4417,4367,4380,4400,4365,4374,4380,7,13,308,"2,023.76",3860
,20160708,4374,4380,4262,4404,4256,4260,4268,-120,-112,280,"1,792.90",3836
,20160711,4260,4268,4460,4470,4415,4415,4444,147,176,148,986.78,3948
,20160712,4415,4444,4405,4440,4404,4440,4420,-4,-24,268,"1,777.12",4040
,20160713,4440,4420,4338,4345,4338,4345,4338,-75,-82,132,859.05,4172
,20160714,4345,4338,,,,4338,4338,0,0,0,0.00,4172
,20160715,4338,4338,4370,4386,4355,4355,4370,17,32,44,288.43,4172
ag1608,20160104,3323,3323,,,,3322,3322,-1,-1,0,0.00,94
,20160105,3322,3322,,,,3342,3342,20,20,0,0.00,94
,20160106,3342,3342,3349,3349,3339,3342,3344,0,2,8,40.14,94
,20160107,3342,3344,,,,3392,3392,48,48,0,0.00,94
,20160108,3392,3392,3383,3394,3383,3387,3384,-5,-8,112,568.62,66
,20160111,3387,3384,,,,3369,3369,-15,-15,0,0.00,66
,20160112,3369,3369,,,,3333,3333,-36,-36,0,0.00,66
,20160113,3333,3333,,,,3295,3295,-38,-38,0,0.00,66
,20160114,3295,3295,,,,3326,3326,31,31,0,0.00,66
,20160115,3326,3326,,,,3314,3314,-12,-12,0,0.00,66
,20160118,3314,3314,3327,3327,3327,3327,3327,13,13,2,9.98,64
,20160119,3327,3327,,,,3327,3327,0,0,0,0.00,64
,20160120,3327,3327,3336,3336,3335,3336,3335,9,8,8,40.03,60
,20160121,3336,3335,3350,3350,3350,3350,3350,15,15,30,150.75,60
,20160122,3350,3350,,,,3336,3336,-14,-14,0,0.00,60
,20160125,3336,3336,,,,3314,3314,-22,-22,0,0.00,60
,20160126,3314,3314,3353,3370,3353,3370,3358,56,44,6,30.23,62
,20160127,3370,3358,,,,3412,3412,54,54,0,0.00,62
,20160128,3412,3412,,,,3397,3397,-15,-15,0,0.00,62
,20160129,3397,3397,,,,3374,3374,-23,-23,0,0.00,62
,20160201,3374,3374,,,,3371,3371,-3,-3,0,0.00,62
,20160202,3371,3371,3368,3368,3368,3368,3368,-3,-3,10,50.52,62
,20160203,3368,3368,,,,3348,3348,-20,-20,0,0.00,62
,20160204,3348,3348,,,,3377,3377,29,29,0,0.00,62
,20160205,3377,3377,,,,3432,3432,55,55,0,0.00,62
,20160215,3432,3432,,,,3497,3497,65,65,0,0.00,62
,20160216,3497,3497,3481,3481,3481,3481,3481,-16,-16,6,31.33,68
,20160217,3481,3481,,,,3484,3484,3,3,0,0.00,68
,20160218,3484,3484,3499,3499,3499,3499,3499,15,15,2,10.50,70
,20160219,3499,3499,3499,3499,3499,3499,3499,0,0,2,10.50,70
,20160222,3499,3499,3493,3493,3493,3493,3493,-6,-6,2,10.48,70
,20160223,3493,3493,3476,3476,3476,3476,3476,-17,-17,2,10.43,70
,20160224,3476,3476,3478,3478,3478,3478,3478,2,2,4,20.87,70
,20160225,3478,3478,3498,3498,3458,3458,3468,-20,-10,8,41.62,74
,20160226,3458,3468,,,,3432,3432,-36,-36,0,0.00,74
,20160229,3432,3432,3357,3360,3343,3347,3349,-85,-83,40,200.98,78
,20160301,3347,3349,3377,3377,3377,3377,3377,28,28,2,10.13,76
,20160302,3377,3377,3375,3375,3348,3350,3352,-27,-25,18,90.53,74
,20160303,3350,3352,,,,3376,3376,24,24,0,0.00,74
,20160304,3376,3376,3404,3459,3404,3424,3441,48,65,10,51.62,74
,20160307,3424,3441,3457,3536,3445,3520,3498,79,57,36,188.94,82
,20160308,3520,3498,3473,3477,3472,3472,3472,-26,-26,122,635.39,196
,20160309,3472,3472,3487,3487,3383,3439,3447,-33,-25,18,93.09,198
,20160310,3439,3447,3416,3416,3416,3416,3416,-31,-31,8,40.99,190
,20160311,3416,3416,3435,3435,3435,3435,3435,19,19,20,103.05,190
,20160314,3435,3435,3451,3451,3451,3451,3451,16,16,2,10.35,190
,20160315,3451,3451,,,,3437,3437,-14,-14,0,0.00,190
,20160316,3437,3437,3426,3426,3426,3426,3426,-11,-11,2,10.28,190
,20160317,3426,3426,3441,3464,3441,3455,3456,29,30,8,41.47,188
,20160318,3455,3456,3455,3550,3455,3550,3472,94,16,96,500.09,272
,20160321,3550,3472,3496,3496,3496,3496,3496,24,24,2,10.49,272
,20160322,3496,3496,3513,3528,3513,3528,3516,32,20,12,63.30,274
,20160323,3528,3516,3516,3538,3511,3538,3528,22,12,68,359.89,274
,20160324,3538,3528,3445,3445,3426,3426,3435,-102,-93,4,20.61,276
,20160325,3426,3435,3430,3430,3430,3430,3430,-5,-5,2,10.29,276
,20160328,3430,3430,3419,3419,3419,3419,3419,-11,-11,2,10.26,278
,20160329,3419,3419,3421,3421,3421,3421,3421,2,2,2,10.26,276
,20160330,3421,3421,3430,3430,3430,3430,3430,9,9,2,10.29,278
,20160331,3430,3430,3438,3440,3422,3438,3435,8,5,12,61.84,274
,20160401,3438,3435,,,,3435,3435,0,0,0,0.00,274
,20160405,3435,3435,3393,3393,3393,3393,3393,-42,-42,2,10.18,276
,20160406,3393,3393,,,,3390,3390,-3,-3,0,0.00,276
,20160407,3390,3390,,,,3396,3396,6,6,0,0.00,276
,20160408,3396,3396,3404,3428,3404,3428,3416,32,20,12,61.49,276
,20160411,3428,3416,3427,3451,3427,3446,3438,30,22,16,82.53,278
,20160412,3446,3438,3471,3512,3470,3481,3485,43,47,16,83.65,276
,20160413,3481,3485,3500,3549,3500,3509,3528,24,43,106,561.02,276
,20160414,3509,3528,3497,3497,3497,3497,3497,-31,-31,4,20.98,276
,20160415,3497,3497,3524,3524,3497,3517,3512,20,15,6,31.61,276
,20160418,3517,3512,,,,3512,3512,0,0,0,0.00,276
,20160419,3512,3512,3521,3597,3520,3597,3532,85,20,20,105.98,276
,20160420,3597,3532,3722,3743,3690,3690,3705,158,173,92,511.41,360
,20160421,3690,3705,3720,3927,3700,3927,3823,222,118,104,596.53,372
,20160422,3927,3823,3891,3916,3706,3729,3777,-94,-46,96,544.00,344
,20160425,3729,3777,3776,3776,3654,3722,3701,-55,-76,166,921.69,346
,20160426,3722,3701,3709,3725,3701,3703,3712,2,11,40,222.75,332
,20160427,3703,3712,3729,3788,3722,3788,3762,76,50,110,620.86,364
,20160428,3788,3762,3805,3805,3756,3762,3762,0,0,54,304.77,370
,20160429,3762,3762,3814,3881,3813,3881,3846,119,84,16,92.31,366
,20160503,3881,3846,3856,3856,3838,3846,3848,0,2,18,103.91,366
,20160504,3846,3848,3788,3788,3788,3788,3788,-60,-60,2,11.36,366
,20160505,3788,3788,3806,3806,3806,3806,3806,18,18,2,11.42,368
,20160506,3806,3806,3816,3820,3745,3760,3791,-46,-15,36,204.72,368
,20160509,3760,3791,3771,3851,3769,3771,3781,-20,-10,46,260.90,370
,20160510,3771,3781,3673,3688,3661,3688,3672,-93,-109,42,231.39,360
,20160511,3688,3672,3709,3736,3705,3730,3727,58,55,22,123.00,358
,20160512,3730,3727,3749,3749,3749,3749,3749,22,22,2,11.25,360
,20160513,3749,3749,3765,3765,3706,3710,3722,-39,-27,12,67.00,354
,20160516,3710,3722,3722,3745,3722,3745,3739,23,17,28,157.07,350
,20160517,3745,3739,3759,3759,3734,3734,3751,-5,12,14,78.77,350
,20160518,3734,3751,,,,3751,3751,0,0,0,0.00,350
,20160519,3751,3751,3712,3729,3645,3648,3711,-103,-40,422,"2,349.21",386
,20160520,3648,3711,3600,3614,3587,3610,3603,-101,-108,30,162.14,388
,20160523,3610,3603,3623,3626,3581,3581,3615,-22,12,18,97.61,380
,20160524,3581,3615,3582,3582,3566,3566,3574,-49,-41,4,21.44,382
,20160525,3566,3574,3564,3564,3551,3556,3557,-18,-17,12,64.04,372
,20160526,3556,3557,3586,3586,3583,3583,3584,26,27,4,21.51,374
,20160527,3583,3584,3605,3605,3529,3530,3562,-54,-22,24,128.24,370
,20160530,3530,3562,3564,3564,3492,3493,3510,-69,-52,26,136.91,382
,20160531,3493,3510,3500,3529,3500,3526,3509,16,-1,12,63.17,382
,20160601,3526,3509,3503,3521,3473,3514,3507,5,-2,24,126.27,368
,20160602,3514,3507,3516,3516,3498,3498,3508,-9,1,14,73.67,376
,20160603,3498,3508,3512,3518,3512,3518,3515,10,7,4,21.09,376
,20160606,3518,3515,3593,3605,3588,3598,3599,83,84,370,"1,997.82",534
,20160607,3598,3599,3616,3626,3607,3607,3610,8,11,60,324.99,534
,20160608,3607,3610,3601,3637,3597,3637,3606,27,-4,210,"1,136.19",372
,20160613,3637,3606,3744,3794,3730,3772,3759,166,153,34,191.71,364
,20160614,3772,3759,3786,3797,3765,3765,3775,6,16,168,951.33,446
,20160615,3765,3775,3791,3797,3748,3797,3785,22,10,96,545.14,442
,20160616,3797,3785,3802,3878,3802,3878,3836,93,51,86,494.89,454
,20160617,3878,3836,3855,3855,3745,3760,3775,-76,-61,272,"1,540.43",472
,20160620,3760,3775,3779,3787,3760,3766,3766,-9,-9,418,"2,361.48",800
,20160621,3766,3766,3772,3800,3765,3772,3784,6,18,340,"1,929.92",1042
,20160622,3772,3784,3746,3746,3726,3727,3740,-57,-44,162,908.96,1108
,20160623,3727,3740,3740,3747,3729,3744,3738,4,-2,292,"1,637.67",1294
,20160624,3744,3738,3747,3840,3744,3824,3769,86,31,228,"1,289.23",1342
,20160627,3824,3769,3862,3865,3823,3848,3833,79,64,90,517.52,1390
,20160628,3848,3833,3841,3846,3818,3825,3827,-8,-6,158,907.04,1416
,20160629,3825,3827,3838,3963,3838,3963,3884,136,57,58,337.99,1408
,20160630,3963,3884,3999,3999,3952,3989,3975,105,91,220,"1,311.81",1496
,20160701,3989,3975,3999,4189,3983,4162,4083,187,108,156,955.46,1548
,20160704,4162,4083,4182,4327,4176,4327,4273,244,190,90,576.95,1546
,20160705,4327,4273,4468,4516,4265,4356,4428,83,155,530,"3,520.82",1610
,20160706,4356,4428,4333,4501,4280,4456,4354,28,-74,78,509.53,1586
,20160707,4456,4354,4397,4445,4355,4406,4399,52,45,78,514.74,1590
,20160708,4406,4399,4338,4338,4261,4263,4303,-136,-96,82,529.32,1600
,20160711,4263,4303,4270,4493,4267,4429,4394,126,91,100,659.17,1590
,20160712,4429,4394,4387,4453,4387,4440,4437,46,43,94,625.68,1642
,20160713,4440,4437,4448,4448,4332,4436,4383,-1,-54,50,328.75,1664
,20160714,4436,4383,4436,4447,4405,4415,4424,32,41,38,252.22,1666
,20160715,4415,4424,4360,4406,4355,4376,4379,-48,-45,62,407.31,1664
,20160718,4376,4379,4391,4391,4319,4319,4341,-60,-38,70,455.84,1674
,20160719,4319,4341,4305,4338,4296,4304,4318,-37,-23,228,"1,477.10",1766
,20160720,4304,4318,4305,4331,4280,4280,4316,-38,-2,204,"1,320.80",1808
,20160721,4280,4316,4222,4230,4171,4205,4191,-111,-125,154,968.35,1812
,20160722,4205,4191,4187,4307,4185,4260,4233,69,42,182,"1,155.79",1810
,20160725,4260,4233,4260,4270,4207,4214,4223,-19,-10,382,"2,419.96",2068
,20160726,4214,4223,4202,4266,4202,4241,4241,18,18,66,419.87,2080
,20160727,4241,4241,4254,4257,4236,4249,4244,8,3,186,"1,184.23",2220
,20160728,4249,4244,4266,4410,4266,4410,4354,166,110,214,"1,397.81",2262
,20160729,4410,4354,4402,4452,4341,4372,4388,18,34,78,513.42,2240
,20160801,4372,4388,4450,4451,4450,4451,4450,63,62,28,186.91,2228
,20160802,4451,4450,4433,4455,4433,4455,4441,5,-9,56,373.08,2232
,20160803,4455,4441,4494,4501,4482,4501,4487,60,46,52,350.00,2232
,20160804,4501,4487,4480,4480,4383,4383,4391,-104,-96,88,579.72,2224
,20160805,4383,4391,4432,4433,4384,4384,4408,-7,17,24,158.69,2224
,20160808,4384,4408,4291,4298,4264,4264,4276,-144,-132,156,"1,000.63",2108
,20160809,4264,4276,,,,4276,4276,0,0,0,0.00,2108
,20160810,4276,4276,4299,4490,4299,4402,4344,126,68,280,"1,824.86",2176
,20160811,4402,4344,4346,4350,4346,4350,4347,6,3,368,"2,399.59",2436
,20160812,4350,4347,4360,4360,4340,4350,4351,3,4,528,"3,446.40",2836
,20160815,4350,4351,4310,4310,4310,4310,4310,-41,-41,4,25.86,2840
ag1609,20160104,3331,3331,3312,3329,3312,3329,3319,-2,-12,8,39.84,86
,20160105,3329,3319,3354,3354,3344,3344,3349,25,30,4,20.09,84
,20160106,3344,3349,,,,3351,3351,2,2,0,0.00,84
,20160107,3351,3351,3359,3433,3359,3401,3397,50,46,18,91.73,80
,20160108,3401,3397,3426,3426,3378,3408,3409,11,12,36,184.12,88
,20160111,3408,3409,,,,3394,3394,-15,-15,0,0.00,88
,20160112,3394,3394,3385,3385,3383,3383,3384,-11,-10,4,20.30,90
,20160113,3383,3384,,,,3345,3345,-39,-39,0,0.00,90
,20160114,3345,3345,,,,3376,3376,31,31,0,0.00,90
,20160115,3376,3376,,,,3363,3363,-13,-13,0,0.00,90
,20160118,3363,3363,3363,3363,3363,3363,3363,0,0,2,10.09,88
,20160119,3363,3363,,,,3363,3363,0,0,0,0.00,88
,20160120,3363,3363,3354,3369,3354,3363,3362,0,-1,8,40.35,86
,20160121,3363,3362,,,,3377,3377,15,15,0,0.00,86
,20160122,3377,3377,3361,3361,3361,3361,3361,-16,-16,2,10.08,86
,20160125,3361,3361,3364,3364,3364,3364,3364,3,3,4,20.18,82
,20160126,3364,3364,,,,3409,3409,45,45,0,0.00,82
,20160127,3409,3409,,,,3463,3463,54,54,0,0.00,82
,20160128,3463,3463,3359,3405,3359,3392,3389,-71,-74,20,101.69,78
,20160129,3392,3389,3381,3381,3381,3381,3381,-8,-8,2,10.14,78
,20160201,3381,3381,3370,3370,3370,3370,3370,-11,-11,10,50.55,70
,20160202,3370,3370,,,,3370,3370,0,0,0,0.00,70
,20160203,3370,3370,,,,3350,3350,-20,-20,0,0.00,70
,20160204,3350,3350,3370,3406,3370,3406,3391,56,41,10,50.87,72
,20160205,3406,3391,3406,3460,3400,3459,3431,68,40,8,41.18,72
,20160215,3459,3431,3517,3517,3517,3517,3517,86,86,2,10.55,70
,20160216,3517,3517,3496,3510,3490,3490,3500,-27,-17,14,73.51,74
,20160217,3490,3500,,,,3500,3500,0,0,0,0.00,74
,20160218,3500,3500,3506,3506,3505,3505,3505,5,5,12,63.10,78
,20160219,3505,3505,3502,3502,3502,3502,3502,-3,-3,4,21.01,76
,20160222,3502,3502,3501,3501,3501,3501,3501,-1,-1,2,10.50,76
,20160223,3501,3501,3467,3467,3467,3467,3467,-34,-34,2,10.40,74
,20160224,3467,3467,,,,3468,3468,1,1,0,0.00,74
,20160225,3468,3468,3506,3506,3476,3492,3490,24,22,8,41.88,78
,20160226,3492,3490,3466,3466,3446,3448,3454,-42,-36,8,41.46,82
,20160229,3448,3454,3378,3378,3365,3365,3371,-89,-83,4,20.23,82
,20160301,3365,3371,3365,3394,3354,3386,3373,15,2,350,"1,771.13",94
,20160302,3386,3373,3365,3365,3355,3365,3363,-8,-10,12,60.54,96
,20160303,3365,3363,3387,3394,3387,3394,3389,31,26,6,30.50,94
,20160304,3394,3389,3435,3471,3398,3468,3446,79,57,44,227.45,114
,20160307,3468,3446,3461,3555,3434,3533,3516,87,70,72,379.82,114
,20160308,3533,3516,3559,3585,3448,3498,3544,-18,28,68,361.53,118
,20160309,3498,3544,3462,3462,3425,3440,3438,-104,-106,8,41.26,116
,20160310,3440,3438,,,,3438,3438,0,0,0,0.00,116
,20160311,3438,3438,3463,3510,3431,3497,3488,59,50,14,73.25,118
,20160314,3497,3488,3487,3515,3467,3490,3476,2,-12,56,292.07,122
,20160315,3490,3476,3516,3522,3419,3433,3476,-43,0,28,146.00,122
,20160316,3433,3476,3434,3436,3433,3436,3434,-40,-42,8,41.21,126
,20160317,3436,3434,3432,3484,3432,3475,3464,41,30,14,72.74,128
,20160318,3475,3464,3495,3564,3483,3564,3518,100,54,90,475.04,132
,20160321,3564,3518,3520,3521,3466,3507,3505,-11,-13,96,504.74,126
,20160322,3507,3505,3519,3554,3502,3543,3531,38,26,164,868.84,140
,20160323,3543,3531,3536,3564,3513,3523,3546,-8,15,44,234.05,146
,20160324,3523,3546,3461,3478,3451,3460,3463,-86,-83,44,228.62,158
,20160325,3460,3463,3477,3477,3443,3462,3463,-1,0,50,259.78,158
,20160328,3462,3463,3458,3458,3435,3456,3446,-7,-17,12,62.03,162
,20160329,3456,3446,3441,3441,3440,3440,3440,-6,-6,6,30.97,160
,20160330,3440,3440,3451,3456,3450,3450,3452,10,12,6,31.07,160
,20160331,3450,3452,3345,3466,3345,3440,3448,-12,-4,268,"1,386.23",162
,20160401,3440,3448,3450,3477,3450,3450,3455,2,7,20,103.67,164
,20160405,3450,3455,3404,3404,3404,3404,3404,-51,-51,4,20.42,160
,20160406,3404,3404,,,,3401,3401,-3,-3,0,0.00,160
,20160407,3401,3401,,,,3407,3407,6,6,0,0.00,160
,20160408,3407,3407,3425,3425,3410,3410,3421,3,14,14,71.85,162
,20160411,3410,3421,3435,3464,3434,3462,3444,41,23,62,320.31,196
,20160412,3462,3444,3501,3532,3480,3500,3502,56,58,342,"1,796.71",206
,20160413,3500,3502,3519,3541,3514,3524,3525,22,23,62,327.90,192
,20160414,3524,3525,3546,3576,3518,3525,3548,0,23,132,702.62,254
,20160415,3525,3548,3534,3559,3515,3540,3537,-8,-11,150,796.04,264
,20160418,3540,3537,3521,3563,3521,3523,3545,-14,8,164,872.12,278
,20160419,3523,3545,3536,3699,3532,3699,3572,154,27,104,557.24,296
,20160420,3699,3572,3700,3786,3684,3719,3736,147,164,1076,"6,031.37",298
,20160421,3719,3736,3735,3891,3726,3874,3816,138,80,664,"3,801.61",334
,20160422,3874,3816,3913,3932,3717,3743,3800,-73,-16,756,"4,309.99",508
,20160425,3743,3800,3795,3831,3677,3734,3750,-66,-50,386,"2,171.75",458
,20160426,3734,3750,3744,3764,3653,3711,3740,-39,-10,398,"2,233.09",540
,20160427,3711,3740,3737,3825,3733,3821,3788,81,48,762,"4,329.98",508
,20160428,3821,3788,3807,3841,3756,3805,3802,17,14,1590,"9,068.88",600
,20160429,3805,3802,3813,3921,3795,3882,3864,80,62,592,"3,431.72",734
,20160503,3882,3864,3851,3892,3851,3880,3876,16,12,462,"2,686.14",754
,20160504,3880,3876,3871,3881,3789,3806,3846,-70,-30,1400,"8,077.31",1404
,20160505,3806,3846,3823,3839,3762,3831,3811,-15,-35,634,"3,625.11",1470
,20160506,3831,3811,3848,3856,3770,3786,3808,-25,-3,910,"5,198.76",1244
,20160509,3786,3808,3770,3843,3766,3766,3814,-42,6,1966,"11,247.71",1278
,20160510,3766,3814,3734,3741,3586,3710,3695,-104,-119,572,"3,170.68",1220
,20160511,3710,3695,3708,3765,3697,3765,3733,70,38,474,"2,654.57",1192
,20160512,3765,3733,3765,3820,3525,3770,3780,37,47,550,"3,119.10",1182
,20160513,3770,3780,3756,3790,3700,3731,3746,-49,-34,514,"2,888.28",1162
,20160516,3731,3746,3667,3786,3667,3774,3729,28,-17,236,"1,320.20",1148
,20160517,3774,3729,3789,3789,3746,3758,3766,29,37,82,463.25,1150
,20160518,3758,3766,3770,3781,3738,3740,3756,-26,-10,198,"1,115.77",1222
,20160519,3740,3756,3700,3756,3651,3651,3700,-105,-56,196,"1,087.82",1156
,20160520,3651,3700,3611,3664,3600,3630,3614,-70,-86,522,"2,830.47",1244
,20160523,3630,3614,3658,3658,3581,3595,3615,-19,1,612,"3,318.68",1160
,20160524,3595,3615,3590,3615,3570,3576,3580,-39,-35,296,"1,589.62",1170
,20160525,3576,3580,3566,3598,3566,3575,3578,-5,-2,56,300.62,1148
,20160526,3575,3578,3577,3622,3577,3622,3601,44,23,304,"1,642.07",1166
,20160527,3622,3601,3616,3628,3555,3577,3595,-24,-6,120,647.23,1146
,20160530,3577,3595,3578,3580,3498,3516,3527,-79,-68,284,"1,502.55",1262
,20160531,3516,3527,3520,3559,3518,3543,3532,16,5,280,"1,483.49",1326
,20160601,3543,3532,3526,3547,3519,3539,3532,7,0,660,"3,497.35",1640
,20160602,3539,3532,3535,3550,3511,3543,3537,11,5,202,"1,071.85",1690
,20160603,3543,3537,3535,3543,3524,3543,3535,6,-2,326,"1,728.69",1874
,20160606,3543,3535,3599,3621,3591,3614,3604,79,69,1742,"9,418.47",1856
,20160607,3614,3604,3635,3635,3607,3611,3620,7,16,846,"4,594.85",1808
,20160608,3611,3620,3608,3660,3606,3660,3625,40,5,942,"5,122.45",1888
,20160613,3660,3625,3818,3818,3743,3773,3770,148,145,662,"3,744.45",1922
,20160614,3773,3770,3804,3816,3756,3790,3797,20,27,644,"3,668.27",2020
,20160615,3790,3797,3808,3819,3787,3819,3805,22,8,358,"2,043.70",2088
,20160616,3819,3805,3816,3884,3805,3879,3856,74,51,1050,"6,073.96",2242
,20160617,3879,3856,3886,3886,3760,3774,3806,-82,-50,1828,"10,436.73",2384
,20160620,3774,3806,3792,3815,3769,3781,3792,-25,-14,1696,"9,648.45",2680
,20160621,3781,3792,3794,3829,3787,3802,3809,10,17,1130,"6,456.72",2672
,20160622,3802,3809,3765,3775,3730,3767,3763,-42,-46,686,"3,872.81",2874
,20160623,3767,3763,3758,3779,3752,3768,3765,5,2,770,"4,348.69",3174
,20160624,3768,3765,3763,3892,3761,3851,3819,86,54,2756,"15,791.58",3548
,20160627,3851,3819,3864,3899,3839,3873,3864,54,45,3880,"22,493.04",3492
,20160628,3873,3864,3880,3880,3823,3869,3843,5,-21,2358,"13,595.28",3228
,20160629,3869,3843,3919,4009,3851,4006,3910,163,67,2512,"14,733.72",3426
,20160630,4006,3910,4018,4025,3964,4017,3995,107,85,1688,"10,115.60",3376
,20160701,4017,3995,4006,4228,4005,4184,4144,189,149,1856,"11,536.95",3384
,20160704,4184,4144,4164,4392,4151,4392,4332,248,188,1592,"10,345.73",3602
,20160705,4392,4332,4458,4543,4225,4375,4430,43,98,2156,"14,327.95",3344
,20160706,4375,4430,4344,4514,4270,4451,4403,21,-27,1184,"7,821.09",3226
,20160707,4451,4403,4432,4452,4359,4403,4406,0,3,840,"5,552.64",3178
,20160708,4403,4406,4363,4363,4264,4279,4309,-127,-97,566,"3,658.68",3186
,20160711,4279,4309,4241,4520,4241,4452,4443,143,134,1012,"6,745.71",3212
,20160712,4452,4443,4428,4476,4407,4453,4447,10,4,498,"3,322.09",3156
,20160713,4453,4447,4471,4477,4344,4443,4444,-4,-3,1008,"6,719.67",3274
,20160714,4443,4444,4468,4482,4403,4441,4438,-3,-6,804,"5,352.98",3294
,20160715,4441,4438,4405,4428,4373,4404,4401,-34,-37,518,"3,420.00",3364
,20160718,4404,4401,4451,4451,4327,4344,4371,-57,-30,502,"3,291.57",3238
,20160719,4344,4371,4339,4359,4314,4339,4336,-32,-35,302,"1,964.25",3276
,20160720,4339,4336,4323,4354,4305,4305,4334,-31,-2,392,"2,548.71",3210
,20160721,4305,4334,4274,4274,4146,4214,4225,-120,-109,1786,"11,318.93",3760
,20160722,4214,4225,4203,4337,4203,4250,4274,25,49,578,"3,705.57",3740
,20160725,4250,4274,4267,4289,4215,4234,4236,-40,-38,1442,"9,163.62",3512
,20160726,4234,4236,4231,4293,4204,4270,4267,34,31,340,"2,176.61",3484
,20160727,4270,4267,4277,4281,4256,4271,4264,4,-3,282,"1,803.99",3536
,20160728,4271,4264,4286,4458,4286,4458,4362,194,98,370,"2,420.97",3574
,20160729,4458,4362,4431,4446,4372,4375,4403,13,41,228,"1,505.85",3580
,20160801,4375,4403,4427,4497,4391,4467,4447,64,44,370,"2,468.43",3570
,20160802,4467,4447,4463,4476,4445,4457,4459,10,12,300,"2,006.82",3568
,20160803,4457,4459,4513,4522,4490,4500,4505,41,46,266,"1,797.65",3588
,20160804,4500,4505,4487,4491,4384,4384,4431,-121,-74,350,"2,326.64",3538
,20160805,4384,4431,4430,4441,4418,4431,4431,0,0,100,664.73,3522
,20160808,4431,4431,4347,4354,4279,4285,4309,-146,-122,180,"1,163.62",3520
,20160809,4285,4309,4321,4326,4278,4278,4297,-31,-12,380,"2,449.48",3454
,20160810,4278,4297,4308,4417,4308,4404,4362,107,65,222,"1,452.69",3508
,20160811,4404,4362,4435,4436,4330,4372,4379,10,17,574,"3,770.59",3558
,20160812,4372,4379,4391,4391,4351,4367,4366,-12,-13,442,"2,895.05",3692
,20160815,4367,4366,4391,4391,4306,4323,4345,-43,-21,298,"1,942.27",3760
,20160816,4323,4345,4308,4379,4308,4359,4354,14,9,232,"1,515.35",3768
,20160817,4359,4354,4337,4352,4297,4310,4322,-44,-32,266,"1,724.58",3742
,20160818,4310,4322,4304,4356,4289,4326,4335,4,13,140,910.40,3728
,20160819,4326,4335,4332,4334,4298,4316,4314,-19,-21,296,"1,915.81",3836
,20160822,4316,4314,4260,4281,4148,4160,4215,-154,-99,602,"3,806.30",4052
,20160823,4160,4215,4175,4184,4159,4184,4169,-31,-46,66,412.78,4018
,20160824,4184,4169,4181,4189,4158,4161,4171,-8,2,122,763.44,4024
,20160825,4161,4171,4125,4127,4078,4092,4098,-79,-73,560,"3,442.74",4176
,20160826,4092,4098,4082,4111,4082,4092,4099,-6,1,600,"3,689.76",4112
,20160829,4092,4099,4113,4176,4061,4079,4084,-20,-15,408,"2,499.78",4120
,20160830,4079,4084,4099,4127,4099,4118,4120,34,36,116,717.05,4118
,20160831,4118,4120,4113,4175,4073,4073,4116,-47,-4,110,679.18,4080
,20160901,4073,4116,4120,4120,4110,4110,4114,-6,-2,44,271.55,4064
,20160902,4110,4114,4122,4122,4122,4122,4122,8,8,4,24.73,4064
,20160905,4122,4122,4244,4266,4244,4260,4255,138,133,576,"3,677.07",4384
,20160906,4260,4255,4275,4286,4271,4283,4277,28,22,232,"1,488.70",4572
,20160907,4283,4277,4328,4386,4301,4386,4333,109,56,108,702.02,4604
,20160908,4386,4333,4357,4360,4353,4356,4355,23,22,100,653.35,4604
,20160909,4356,4355,4330,4330,4295,4297,4309,-58,-46,100,646.42,4604
,20160912,4297,4309,4198,4205,4187,4200,4202,-109,-107,276,"1,739.92",4596
,20160913,4200,4202,3950,4307,3950,4250,4244,48,42,136,865.84,4688
,20160914,4250,4244,,,,4244,4244,0,0,0,0.00,4688
,20160919,4244,4244,4235,4244,4220,4220,4238,-24,-6,384,"2,441.11",5032
ag1610,20160104,3349,3349,3343,3363,3329,3363,3345,14,-4,6,30.11,128
,20160105,3363,3345,,,,3345,3345,0,0,0,0.00,128
,20160106,3345,3345,3338,3338,3338,3338,3338,-7,-7,2,10.01,128
,20160107,3338,3338,3435,3435,3403,3403,3429,65,91,18,92.59,126
,20160108,3403,3429,3410,3436,3406,3413,3416,-16,-13,14,71.74,120
,20160111,3413,3416,3402,3402,3385,3385,3395,-31,-21,6,30.56,120
,20160112,3385,3395,,,,3384,3384,-11,-11,0,0.00,120
,20160113,3384,3384,,,,3345,3345,-39,-39,0,0.00,120
,20160114,3345,3345,3368,3368,3327,3327,3347,-18,2,4,20.09,118
,20160115,3327,3347,,,,3335,3335,-12,-12,0,0.00,118
,20160118,3335,3335,,,,3335,3335,0,0,0,0.00,118
,20160119,3335,3335,,,,3335,3335,0,0,0,0.00,118
,20160120,3335,3335,3335,3335,3335,3335,3335,0,0,2,10.01,116
,20160121,3335,3335,,,,3350,3350,15,15,0,0.00,116
,20160122,3350,3350,3376,3376,3371,3371,3373,21,23,8,40.48,112
,20160125,3371,3373,,,,3376,3376,3,3,0,0.00,112
,20160126,3376,3376,,,,3421,3421,45,45,0,0.00,112
,20160127,3421,3421,3426,3429,3418,3418,3425,-3,4,8,41.11,118
,20160128,3418,3425,3419,3419,3419,3419,3419,-6,-6,8,41.03,118
,20160129,3419,3419,3431,3431,3431,3431,3431,12,12,8,41.17,118
,20160201,3431,3431,3420,3420,3420,3420,3420,-11,-11,2,10.26,116
,20160202,3420,3420,,,,3420,3420,0,0,0,0.00,116
,20160203,3420,3420,,,,3400,3400,-20,-20,0,0.00,116
,20160204,3400,3400,3441,3441,3439,3439,3440,39,40,4,20.64,114
,20160205,3439,3440,3446,3463,3446,3463,3458,23,18,16,83.00,112
,20160215,3463,3458,3529,3550,3528,3535,3530,77,72,108,571.91,184
,20160216,3535,3530,3526,3526,3512,3512,3522,-18,-8,8,42.27,190
,20160217,3512,3522,3514,3537,3512,3522,3519,0,-3,32,168.92,202
,20160218,3522,3519,3522,3522,3508,3518,3509,-1,-10,94,494.85,128
,20160219,3518,3509,,,,3505,3505,-4,-4,0,0.00,128
,20160222,3505,3505,3520,3520,3498,3498,3516,-7,11,12,63.29,136
,20160223,3498,3516,3481,3483,3481,3483,3481,-33,-35,32,167.12,136
,20160224,3483,3481,,,,3483,3483,2,2,0,0.00,136
,20160225,3483,3483,3537,3537,3500,3500,3524,17,41,18,95.15,126
,20160226,3500,3524,3470,3470,3469,3469,3469,-55,-55,4,20.82,126
,20160229,3469,3469,,,,3469,3469,0,0,0,0.00,126
,20160301,3469,3469,3456,3456,3369,3400,3408,-69,-61,6,30.68,126
,20160302,3400,3408,3371,3371,3371,3371,3371,-37,-37,2,10.11,124
,20160303,3371,3371,3383,3385,3383,3385,3384,14,13,4,20.30,126
,20160304,3385,3384,3412,3412,3412,3412,3412,28,28,2,10.24,126
,20160307,3412,3412,3544,3544,3544,3544,3544,132,132,2,10.63,126
,20160308,3544,3544,3600,3603,3513,3513,3578,-31,34,8,42.94,128
,20160309,3513,3578,,,,3471,3471,-107,-107,0,0.00,128
,20160310,3471,3471,,,,3439,3439,-32,-32,0,0.00,128
,20160311,3439,3439,,,,3489,3489,50,50,0,0.00,128
,20160314,3489,3489,3490,3490,3490,3490,3490,1,1,4,20.94,132
,20160315,3490,3490,3509,3556,3489,3489,3535,-1,45,268,"1,421.09",212
,20160316,3489,3535,,,,3492,3492,-43,-43,0,0.00,212
,20160317,3492,3492,,,,3522,3522,30,30,0,0.00,212
,20160318,3522,3522,3519,3561,3519,3561,3552,39,30,14,74.60,222
,20160321,3561,3552,3525,3525,3525,3525,3525,-27,-27,2,10.58,220
,20160322,3525,3525,,,,3552,3552,27,27,0,0.00,220
,20160323,3552,3552,,,,3567,3567,15,15,0,0.00,220
,20160324,3567,3567,3567,3567,3462,3462,3514,-105,-53,4,21.09,220
,20160325,3462,3514,,,,3514,3514,0,0,0,0.00,220
,20160328,3514,3514,3474,3474,3474,3474,3474,-40,-40,2,10.42,218
,20160329,3474,3474,,,,3468,3468,-6,-6,0,0.00,218
,20160330,3468,3468,3470,3474,3454,3468,3463,0,-5,20,103.90,218
,20160331,3468,3463,3467,3470,3442,3454,3460,-9,-3,30,155.74,214
,20160401,3454,3460,3478,3478,3471,3471,3476,11,16,26,135.58,198
,20160405,3471,3476,,,,3424,3424,-52,-52,0,0.00,198
,20160406,3424,3424,3430,3430,3430,3430,3430,6,6,2,10.29,196
,20160407,3430,3430,,,,3436,3436,6,6,0,0.00,196
,20160408,3436,3436,,,,3450,3450,14,14,0,0.00,196
,20160411,3450,3450,,,,3473,3473,23,23,0,0.00,196
,20160412,3473,3473,,,,3531,3531,58,58,0,0.00,196
,20160413,3531,3531,3560,3560,3528,3536,3544,5,13,102,542.24,198
,20160414,3536,3544,,,,3544,3544,0,0,0,0.00,198
,20160415,3544,3544,3401,3559,3401,3550,3530,6,-14,14,74.13,188
,20160418,3550,3530,3542,3596,3542,3545,3561,15,31,40,213.70,190
,20160419,3545,3561,3552,3595,3542,3595,3564,34,3,60,320.79,180
,20160420,3595,3564,3705,3749,3705,3728,3734,164,170,34,190.48,192
,20160421,3728,3734,3739,3918,3739,3863,3893,129,159,28,163.52,212
,20160422,3863,3893,3919,3923,3735,3791,3817,-102,-76,70,400.85,206
,20160425,3791,3817,3802,4037,3723,3750,3772,-67,-45,156,882.73,204
,20160426,3750,3772,3700,3754,3700,3730,3726,-42,-46,508,"2,839.34",364
,20160427,3730,3726,3756,3817,3756,3805,3791,79,65,44,250.22,374
,20160428,3805,3791,3810,3825,3783,3825,3797,34,6,44,250.63,384
,20160429,3825,3797,3812,3937,3812,3903,3906,106,109,52,304.70,378
,20160503,3903,3906,3888,3896,3866,3896,3879,-10,-27,1676,"9,753.92",590
,20160504,3896,3879,3900,3900,3821,3825,3850,-54,-29,158,912.52,582
,20160505,3825,3850,3843,3861,3822,3839,3841,-11,-9,114,656.93,576
,20160506,3839,3841,3867,3871,3803,3812,3819,-29,-22,248,"1,420.90",572
,20160509,3812,3819,3828,3877,3806,3806,3834,-13,15,562,"3,232.76",606
,20160510,3806,3834,3748,3759,3686,3686,3720,-148,-114,58,323.69,590
,20160511,3686,3720,3720,3785,3712,3775,3773,55,53,118,667.90,672
,20160512,3775,3773,3798,3812,3788,3799,3807,26,34,94,536.92,724
,20160513,3799,3807,3776,3811,3720,3752,3765,-55,-42,58,327.56,712
,20160516,3752,3765,3734,3793,3725,3781,3757,16,-8,96,541.01,712
,20160517,3781,3757,3800,3802,3769,3774,3784,17,27,28,158.95,712
,20160518,3774,3784,3767,3793,3751,3783,3773,-1,-11,46,260.37,704
,20160519,3783,3773,3747,3771,3668,3668,3751,-105,-22,60,337.63,698
,20160520,3668,3751,3628,3629,3619,3629,3624,-122,-127,14,76.12,690
,20160523,3629,3624,3663,3663,3591,3607,3625,-17,1,58,315.38,682
,20160524,3607,3625,3603,3622,3579,3595,3601,-30,-24,66,356.56,678
,20160525,3595,3601,3589,3589,3582,3582,3585,-19,-16,10,53.78,672
,20160526,3582,3585,3591,3600,3590,3590,3592,5,7,20,107.78,674
,20160527,3590,3592,,,,3586,3586,-6,-6,0,0.00,674
,20160530,3586,3586,3586,3595,3544,3544,3587,-42,1,38,204.48,682
,20160531,3544,3587,3530,3571,3530,3551,3540,-36,-47,34,180.56,662
,20160601,3551,3540,3553,3558,3552,3552,3553,12,13,22,117.27,654
,20160602,3552,3553,3557,3557,3551,3551,3554,-2,1,4,21.32,654
,20160603,3551,3554,,,,3554,3554,0,0,0,0.00,654
,20160606,3554,3554,3637,3638,3615,3631,3625,77,71,122,663.47,652
,20160607,3631,3625,3655,3655,3634,3634,3642,9,17,22,120.20,646
,20160608,3634,3642,3626,3631,3625,3625,3627,-17,-15,12,65.29,646
,20160613,3625,3627,3769,3840,3769,3800,3794,173,167,44,250.41,642
,20160614,3800,3794,3799,3799,3799,3799,3799,5,5,6,34.19,642
,20160615,3799,3799,3820,3820,3813,3814,3815,15,16,12,68.68,638
,20160616,3814,3815,3820,3890,3820,3872,3862,57,47,10,57.93,638
,20160617,3872,3862,3795,3795,3795,3795,3795,-67,-67,4,22.77,634
,20160620,3795,3795,3810,3816,3788,3788,3811,-7,16,22,125.77,624
,20160621,3788,3811,3809,3829,3809,3826,3821,15,10,10,57.32,622
,20160622,3826,3821,,,,3821,3821,0,0,0,0.00,622
,20160623,3821,3821,3781,3782,3768,3768,3776,-53,-45,14,79.30,626
,20160624,3768,3776,3781,3885,3781,3840,3826,64,50,30,172.18,628
,20160627,3840,3826,3899,3904,3862,3888,3876,62,50,40,232.61,618
,20160628,3888,3876,,,,3876,3876,0,0,0,0.00,618
,20160629,3876,3876,3944,3946,3944,3946,3945,70,69,6,35.51,612
,20160630,3946,3945,4001,4025,3999,4025,4002,80,57,26,156.11,612
,20160701,4025,4002,,,,4002,4002,0,0,0,0.00,612
,20160704,4002,4002,4210,4242,4210,4242,4238,240,236,124,788.36,662
,20160705,4242,4238,4494,4517,4286,4349,4397,111,159,314,"2,071.36",638
,20160706,4349,4397,4371,4514,4316,4514,4413,117,16,22,145.65,634
,20160707,4514,4413,4451,4459,4400,4457,4444,44,31,48,319.98,632
,20160708,4457,4444,4347,4347,4308,4328,4324,-116,-120,20,129.73,628
,20160711,4328,4324,4328,4582,4309,4469,4462,145,138,92,615.81,608
,20160712,4469,4462,4444,4490,4408,4464,4460,2,-2,112,749.44,646
,20160713,4464,4460,4375,4489,4358,4489,4466,29,6,178,"1,192.59",668
,20160714,4489,4466,4460,4525,4441,4443,4472,-23,6,60,402.53,648
,20160715,4443,4472,4403,4451,4369,4417,4412,-55,-60,40,264.74,648
,20160718,4417,4412,4423,4423,4399,4399,4419,-13,7,14,92.81,644
,20160719,4399,4419,4357,4370,4357,4370,4363,-49,-56,26,170.18,626
,20160720,4370,4363,4346,4346,4319,4319,4336,-44,-27,10,65.05,624
,20160721,4319,4336,4271,4274,4226,4240,4249,-96,-87,32,203.99,622
,20160722,4240,4249,4312,4315,4312,4315,4313,66,64,8,51.76,622
,20160725,4315,4313,4275,4278,4254,4255,4266,-58,-47,26,166.39,616
,20160726,4255,4266,,,,4266,4266,0,0,0,0.00,616
,20160727,4266,4266,4298,4298,4275,4275,4284,9,18,8,51.41,610
,20160728,4275,4284,4341,4447,4317,4447,4361,163,77,52,340.22,608
,20160729,4447,4361,4440,4442,4424,4427,4438,66,77,42,279.64,616
,20160801,4427,4438,4430,4481,4420,4475,4441,37,3,14,93.27,608
,20160802,4475,4441,4484,4484,4484,4484,4484,43,43,4,26.90,604
,20160803,4484,4484,4536,4536,4503,4526,4518,42,34,192,"1,301.24",690
,20160804,4526,4518,4498,4498,4407,4413,4440,-105,-78,116,772.67,678
,20160805,4413,4440,4448,4467,4442,4443,4446,3,6,52,346.84,670
,20160808,4443,4446,4367,4370,4305,4307,4342,-139,-104,54,351.76,652
,20160809,4307,4342,4324,4335,4308,4308,4323,-34,-19,14,90.80,650
,20160810,4308,4323,4358,4422,4358,4422,4387,99,64,8,52.65,650
,20160811,4422,4387,4441,4441,4356,4381,4386,-6,-1,64,421.08,640
,20160812,4381,4386,4400,4405,4375,4375,4396,-11,10,90,593.47,652
,20160815,4375,4396,4405,4410,4329,4332,4397,-64,1,68,448.58,676
,20160816,4332,4397,4332,4389,4332,4389,4345,-8,-52,78,508.40,700
,20160817,4389,4345,4331,4347,4331,4347,4341,2,-4,18,117.22,690
,20160818,4347,4341,4357,4370,4340,4340,4359,-1,18,8,52.31,692
,20160819,4340,4359,4344,4344,4328,4328,4337,-31,-22,6,39.04,688
,20160822,4328,4337,4282,4296,4165,4165,4225,-172,-112,20,126.76,686
,20160823,4165,4225,4183,4200,4183,4200,4188,-25,-37,16,100.52,682
,20160824,4200,4188,4177,4179,4167,4179,4174,-9,-14,34,212.92,680
,20160825,4179,4174,4123,4129,3936,4103,4102,-71,-72,86,529.27,668
,20160826,4103,4102,4095,4112,4095,4112,4100,10,-2,24,147.62,662
,20160829,4112,4100,4126,4156,4080,4080,4127,-20,27,14,86.68,662
,20160830,4080,4127,4111,4140,4107,4140,4129,13,2,12,74.33,656
,20160831,4140,4129,4140,4140,4140,4140,4140,11,11,2,12.42,654
,20160901,4140,4140,4130,4135,4123,4123,4130,-17,-10,24,148.71,638
,20160902,4123,4130,4125,4182,4125,4177,4164,47,34,106,662.19,668
,20160905,4177,4164,4252,4282,4251,4281,4275,117,111,302,"1,936.67",858
,20160906,4281,4275,4302,4306,4298,4305,4301,30,26,28,180.65,858
,20160907,4305,4301,4337,4410,4328,4386,4369,85,68,60,393.29,868
,20160908,4386,4369,4350,4379,4350,4369,4372,0,3,102,669.05,960
,20160909,4369,4372,4346,4357,4309,4309,4329,-63,-43,262,"1,701.49",1028
,20160912,4309,4329,4293,4302,4200,4211,4216,-118,-113,62,392.18,1056
,20160913,4211,4216,4206,4340,4195,4340,4256,124,40,112,715.02,1066
,20160914,4340,4256,4235,4235,4121,4215,4205,-41,-51,88,555.10,1086
,20160919,4215,4205,4191,4255,4191,4249,4234,44,29,1128,"7,164.94",2018
,20160920,4249,4234,4261,4268,4247,4260,4258,26,24,988,"6,311.54",2142
,20160921,4260,4258,4250,4303,4239,4295,4277,37,19,324,"2,079.04",2254
,20160922,4295,4277,4340,4385,4340,4349,4369,72,92,92,603.04,2248
,20160923,4349,4369,4374,4399,4343,4343,4374,-26,5,96,629.93,2274
,20160926,4343,4374,4351,4351,4278,4293,4322,-81,-52,514,"3,332.98",2324
,20160927,4293,4322,4295,4304,4276,4301,4292,-21,-30,502,"3,232.45",2614
,20160928,4301,4292,4254,4270,4220,4228,4231,-64,-61,1378,"8,746.06",3266
,20160929,4228,4231,4238,4270,4164,4245,4250,14,19,880,"5,610.84",3462
,20160930,4245,4250,4220,4300,4169,4169,4231,-81,-19,148,939.31,3450
,20161010,4169,4231,3892,3980,3892,3948,3930,-283,-301,1574,"9,280.25",4044
,20161011,3948,3930,3950,3963,3944,3963,3949,33,19,332,"1,966.76",4344
,20161012,3963,3949,3930,3985,3777,3954,3957,5,8,84,498.60,4356
,20161013,3954,3957,3952,3965,3952,3960,3958,3,1,188,"1,116.41",4428
,20161014,3960,3958,3950,3950,3938,3939,3946,-19,-12,200,"1,184.08",4628
,20161017,3939,3946,3940,3947,3940,3941,3941,-5,-5,516,"3,050.97",5120
ag1611,20160104,3360,3344,,,,3344,3344,0,0,0,0.00,66
,20160105,3344,3344,,,,3370,3370,26,26,0,0.00,66
,20160106,3370,3370,,,,3372,3372,2,2,0,0.00,66
,20160107,3372,3372,3399,3438,3399,3438,3428,66,56,18,92.57,60
,20160108,3438,3428,3415,3447,3415,3434,3432,6,4,6,30.89,60
,20160111,3434,3432,3425,3425,3425,3425,3425,-7,-7,2,10.28,60
,20160112,3425,3425,3368,3368,3368,3368,3368,-57,-57,2,10.10,60
,20160113,3368,3368,,,,3329,3329,-39,-39,0,0.00,60
,20160114,3329,3329,3390,3390,3390,3390,3390,61,61,2,10.17,60
,20160115,3390,3390,,,,3377,3377,-13,-13,0,0.00,60
,20160118,3377,3377,,,,3377,3377,0,0,0,0.00,60
,20160119,3377,3377,,,,3377,3377,0,0,0,0.00,60
,20160120,3377,3377,,,,3377,3377,0,0,0,0.00,60
,20160121,3377,3377,,,,3377,3377,0,0,0,0.00,60
,20160122,3377,3377,3387,3387,3387,3387,3387,10,10,2,10.16,60
,20160125,3387,3387,,,,3390,3390,3,3,0,0.00,60
,20160126,3390,3390,,,,3435,3435,45,45,0,0.00,60
,20160127,3435,3435,,,,3439,3439,4,4,0,0.00,60
,20160128,3439,3439,,,,3432,3432,-7,-7,0,0.00,60
,20160129,3432,3432,,,,3444,3444,12,12,0,0.00,60
,20160201,3444,3444,,,,3432,3432,-12,-12,0,0.00,60
,20160202,3432,3432,,,,3432,3432,0,0,0,0.00,60
,20160203,3432,3432,,,,3411,3411,-21,-21,0,0.00,60
,20160204,3411,3411,3429,3429,3429,3429,3429,18,18,2,10.29,60
,20160205,3429,3429,,,,3447,3447,18,18,0,0.00,60
,20160215,3447,3447,,,,3519,3519,72,72,0,0.00,60
,20160216,3519,3519,3526,3544,3526,3544,3535,25,16,12,63.63,70
,20160217,3544,3535,3528,3528,3528,3528,3528,-7,-7,2,10.58,70
,20160218,3528,3528,,,,3518,3518,-10,-10,0,0.00,70
,20160219,3518,3518,,,,3514,3514,-4,-4,0,0.00,70
,20160222,3514,3514,,,,3525,3525,11,11,0,0.00,70
,20160223,3525,3525,,,,3490,3490,-35,-35,0,0.00,70
,20160224,3490,3490,,,,3492,3492,2,2,0,0.00,70
,20160225,3492,3492,,,,3533,3533,41,41,0,0.00,70
,20160226,3533,3533,3483,3489,3483,3489,3484,-44,-49,10,52.26,68
,20160229,3489,3484,,,,3400,3400,-84,-84,0,0.00,68
,20160301,3400,3400,3398,3410,3397,3397,3405,-3,5,22,112.38,68
,20160302,3397,3405,3421,3421,3394,3394,3412,-11,7,6,30.71,68
,20160303,3394,3412,,,,3425,3425,13,13,0,0.00,68
,20160304,3425,3425,,,,3453,3453,28,28,0,0.00,68
,20160307,3453,3453,,,,3586,3586,133,133,0,0.00,68
,20160308,3586,3586,3601,3601,3555,3580,3581,-6,-5,10,53.72,68
,20160309,3580,3581,3469,3509,3469,3509,3489,-72,-92,4,20.93,68
,20160310,3509,3489,3468,3468,3468,3468,3468,-21,-21,6,31.21,74
,20160311,3468,3468,,,,3518,3518,50,50,0,0.00,74
,20160314,3518,3518,3500,3500,3500,3500,3500,-18,-18,6,31.50,74
,20160315,3500,3500,,,,3545,3545,45,45,0,0.00,74
,20160316,3545,3545,,,,3502,3502,-43,-43,0,0.00,74
,20160317,3502,3502,3465,3465,3465,3465,3465,-37,-37,2,10.40,74
,20160318,3465,3465,,,,3494,3494,29,29,0,0.00,74
,20160321,3494,3494,,,,3467,3467,-27,-27,0,0.00,74
,20160322,3467,3467,3562,3562,3562,3562,3562,95,95,2,10.69,74
,20160323,3562,3562,,,,3577,3577,15,15,0,0.00,74
,20160324,3577,3577,,,,3524,3524,-53,-53,0,0.00,74
,20160325,3524,3524,,,,3524,3524,0,0,0,0.00,74
,20160328,3524,3524,,,,3483,3483,-41,-41,0,0.00,74
,20160329,3483,3483,,,,3477,3477,-6,-6,0,0.00,74
,20160330,3477,3477,3490,3490,3488,3488,3489,11,12,20,104.67,92
,20160331,3488,3489,3467,3467,3467,3467,3467,-22,-22,8,41.60,98
,20160401,3467,3467,3486,3486,3480,3480,3482,13,15,14,73.13,112
,20160405,3480,3482,,,,3430,3430,-52,-52,0,0.00,112
,20160406,3430,3430,,,,3436,3436,6,6,0,0.00,112
,20160407,3436,3436,,,,3442,3442,6,6,0,0.00,112
,20160408,3442,3442,3461,3461,3456,3456,3459,14,17,6,31.13,114
,20160411,3456,3459,3477,3477,3477,3477,3477,18,18,2,10.43,112
,20160412,3477,3477,,,,3535,3535,58,58,0,0.00,112
,20160413,3535,3535,3566,3566,3566,3566,3566,31,31,6,32.09,106
,20160414,3566,3566,3550,3550,3550,3550,3550,-16,-16,6,31.95,100
,20160415,3550,3550,,,,3550,3550,0,0,0,0.00,100
,20160418,3550,3550,,,,3550,3550,0,0,0,0.00,100
,20160419,3550,3550,,,,3608,3608,58,58,0,0.00,100
,20160420,3608,3608,,,,3608,3608,0,0,0,0.00,100
,20160421,3608,3608,3785,3800,3778,3800,3786,192,178,8,45.44,102
,20160422,3800,3786,3935,3943,3759,3777,3848,-9,62,20,115.46,100
,20160425,3777,3848,3824,3851,3758,3765,3805,-83,-43,44,251.17,92
,20160426,3765,3805,3758,3781,3754,3755,3766,-50,-39,12,67.79,86
,20160427,3755,3766,3790,3831,3789,3831,3815,65,49,24,137.36,86
,20160428,3831,3815,,,,3815,3815,0,0,0,0.00,86
,20160429,3815,3815,3952,3952,3924,3924,3936,109,121,10,59.05,88
,20160503,3924,3936,3914,3921,3881,3915,3909,-21,-27,40,234.59,110
,20160504,3915,3909,3910,3910,3825,3825,3871,-84,-38,14,81.31,116
,20160505,3825,3871,3860,3860,3853,3853,3856,-18,-15,8,46.28,120
,20160506,3853,3856,3856,3903,3818,3818,3838,-38,-18,84,483.68,120
,20160509,3818,3838,3836,3859,3811,3828,3820,-10,-18,502,"2,877.08",176
,20160510,3828,3820,3763,3767,3707,3742,3751,-78,-69,40,225.06,158
,20160511,3742,3751,3738,3806,3738,3806,3761,55,10,54,304.67,132
,20160512,3806,3761,3817,3833,3810,3810,3828,49,67,222,"1,274.95",302
,20160513,3810,3828,3822,3825,3740,3750,3795,-78,-33,82,466.83,290
,20160516,3750,3795,3751,3798,3751,3798,3765,3,-30,22,124.27,290
,20160517,3798,3765,3813,3816,3813,3816,3815,51,50,16,91.58,296
,20160518,3816,3815,3786,3786,3772,3772,3775,-43,-40,16,90.61,296
,20160519,3772,3775,3760,3769,3760,3769,3764,-6,-11,4,22.59,294
,20160520,3769,3764,3646,3667,3635,3667,3644,-97,-120,20,109.32,280
,20160523,3667,3644,3681,3683,3681,3683,3681,39,37,14,77.31,282
,20160524,3683,3681,,,,3681,3681,0,0,0,0.00,282
,20160525,3681,3681,3611,3611,3611,3611,3611,-70,-70,4,21.67,282
,20160526,3611,3611,3602,3640,3602,3640,3621,29,10,4,21.73,278
,20160527,3640,3621,,,,3621,3621,0,0,0,0.00,278
,20160530,3621,3621,3613,3613,3604,3604,3608,-17,-13,20,108.25,270
,20160531,3604,3608,3538,3569,3538,3569,3547,-39,-61,8,42.57,274
,20160601,3569,3547,3560,3560,3560,3560,3560,13,13,4,21.36,274
,20160602,3560,3560,,,,3560,3560,0,0,0,0.00,274
,20160603,3560,3560,3567,3567,3567,3567,3567,7,7,4,21.40,274
,20160606,3567,3567,3637,3640,3633,3640,3636,73,69,16,87.27,272
,20160607,3640,3636,,,,3636,3636,0,0,0,0.00,272
,20160608,3636,3636,3670,3673,3656,3673,3670,37,34,14,77.07,272
,20160613,3673,3670,3786,3829,3786,3824,3797,154,127,36,205.05,272
,20160614,3824,3797,3839,3841,3811,3825,3825,28,28,12,68.86,272
,20160615,3825,3825,3851,3851,3833,3841,3838,16,13,14,80.61,268
,20160616,3841,3838,3893,3900,3893,3900,3897,62,59,6,35.08,268
,20160617,3900,3897,,,,3897,3897,0,0,0,0.00,268
,20160620,3897,3897,3835,3835,3805,3805,3825,-92,-72,6,34.43,268
,20160621,3805,3825,3846,3846,3839,3839,3842,14,17,4,23.06,268
,20160622,3839,3842,3761,3761,3761,3761,3761,-81,-81,2,11.28,268
,20160623,3761,3761,,,,3761,3761,0,0,0,0.00,268
,20160624,3761,3761,3819,3909,3816,3891,3883,130,122,124,722.39,360
,20160627,3891,3883,3921,3923,3886,3886,3905,3,22,10,58.59,358
,20160628,3886,3905,3902,3902,3902,3902,3902,-3,-3,4,23.41,362
,20160629,3902,3902,3900,4000,3899,3991,3944,89,42,18,106.51,362
,20160630,3991,3944,4051,4051,4011,4040,4030,96,86,46,278.12,362
,20160701,4040,4030,4056,4248,4056,4221,4187,191,157,80,502.49,366
,20160704,4221,4187,4230,4438,4228,4438,4406,251,219,256,"1,692.22",390
,20160705,4438,4406,4440,4540,4369,4388,4492,-18,86,338,"2,277.55",356
,20160706,4388,4492,4386,4554,4370,4554,4480,62,-12,136,914.07,360
,20160707,4554,4480,4474,4474,4431,4431,4460,-49,-20,20,133.80,358
,20160708,4431,4460,4375,4375,4276,4329,4318,-131,-142,16,103.64,356
,20160711,4329,4318,4244,4529,4244,4479,4382,161,64,154,"1,012.41",380
,20160712,4479,4382,4470,4547,4421,4473,4462,91,80,132,883.52,386
,20160713,4473,4462,4466,4509,4391,4493,4467,31,5,92,616.49,404
,20160714,4493,4467,4490,4515,4446,4460,4480,-7,13,88,591.47,398
,20160715,4460,4480,,,,4480,4480,0,0,0,0.00,398
,20160718,4480,4480,4404,4419,4395,4399,4404,-81,-76,58,383.16,406
,20160719,4399,4404,4381,4386,4350,4374,4374,-30,-30,226,"1,483.12",492
,20160720,4374,4374,4373,4375,4371,4375,4372,1,-2,32,209.90,500
,20160721,4375,4372,4281,4311,4237,4262,4256,-110,-116,50,319.21,512
,20160722,4262,4256,4255,4368,4255,4329,4314,73,58,30,194.15,496
,20160725,4329,4314,4259,4284,4259,4278,4269,-36,-45,24,153.71,498
,20160726,4278,4269,4313,4320,4304,4320,4315,51,46,14,90.62,504
,20160727,4320,4315,4295,4297,4295,4297,4296,-18,-19,4,25.78,500
,20160728,4297,4296,4352,4459,4349,4459,4376,163,80,26,170.67,486
,20160729,4459,4376,4448,4464,4416,4427,4439,51,63,40,266.35,490
,20160801,4427,4439,4443,4537,4418,4493,4494,54,55,84,566.29,486
,20160802,4493,4494,4506,4514,4500,4500,4507,6,13,14,94.65,482
,20160803,4500,4507,4546,4556,4528,4549,4539,42,32,576,"3,922.52",542
,20160804,4549,4539,4507,4507,4440,4444,4467,-95,-72,112,750.60,546
,20160805,4444,4467,4474,4474,4474,4474,4474,7,7,2,13.42,544
,20160808,4474,4474,4354,4357,4329,4329,4341,-145,-133,22,143.28,544
,20160809,4329,4341,4354,4354,4354,4354,4354,13,13,2,13.06,542
,20160810,4354,4354,4319,4450,4319,4450,4399,96,45,52,343.12,524
,20160811,4450,4399,4460,4460,4386,4398,4416,-1,17,36,238.48,516
,20160812,4398,4416,4420,4427,4390,4396,4402,-20,-14,194,"1,281.05",604
,20160815,4396,4402,4421,4430,4340,4352,4385,-50,-17,58,381.57,568
,20160816,4352,4385,4360,4412,4360,4403,4385,18,0,16,105.26,566
,20160817,4403,4385,4363,4363,4341,4341,4352,-44,-33,8,52.22,566
,20160818,4341,4352,4333,4386,4333,4381,4366,29,14,6,39.30,564
,20160819,4381,4366,4352,4352,4352,4352,4352,-14,-14,8,52.22,568
,20160822,4352,4352,4306,4306,4198,4198,4278,-154,-74,32,205.34,550
,20160823,4198,4278,4207,4215,4201,4215,4206,-63,-72,20,126.19,548
,20160824,4215,4206,4205,4205,4195,4195,4198,-11,-8,8,50.38,546
,20160825,4195,4198,4153,4153,4120,4121,4127,-77,-71,10,61.91,544
,20160826,4121,4127,4127,4127,4127,4127,4127,0,0,6,37.14,542
,20160829,4127,4127,4130,4130,4110,4111,4114,-16,-13,10,61.72,536
,20160830,4111,4114,4130,4147,4130,4147,4143,33,29,16,99.45,546
,20160831,4147,4143,4140,4140,4140,4140,4140,-3,-3,2,12.42,544
,20160901,4140,4140,4148,4159,4148,4159,4153,19,13,4,24.92,544
,20160902,4159,4153,4148,4218,4148,4187,4198,34,45,304,"1,914.66",712
,20160905,4187,4198,4255,4304,4255,4301,4294,103,96,660,"4,251.83",1104
,20160906,4301,4294,4305,4330,4299,4330,4314,36,20,56,362.41,1120
,20160907,4330,4314,4403,4413,4392,4403,4405,89,91,22,145.38,1130
,20160908,4403,4405,4373,4397,4369,4388,4388,-17,-17,510,"3,357.10",1280
,20160909,4388,4388,4373,4373,4327,4332,4349,-56,-39,250,"1,630.89",1388
,20160912,4332,4349,4318,4320,4220,4227,4258,-122,-91,100,638.73,1418
,20160913,4227,4258,4222,4291,4210,4260,4264,2,6,228,"1,458.35",1494
,20160914,4260,4264,4251,4251,4178,4230,4217,-34,-47,180,"1,138.83",1560
,20160919,4230,4217,4208,4277,4207,4261,4250,44,33,194,"1,236.94",1656
,20160920,4261,4250,4282,4288,4273,4277,4277,27,27,616,"3,952.68",2006
,20160921,4277,4277,4259,4321,4259,4315,4286,38,9,182,"1,170.24",2038
,20160922,4315,4286,4358,4401,4358,4367,4381,81,95,78,512.67,2062
,20160923,4367,4381,4410,4410,4396,4396,4405,15,24,8,52.87,2058
,20160926,4396,4405,4365,4365,4305,4318,4321,-87,-84,74,479.64,2092
,20160927,4318,4321,4325,4325,4294,4315,4311,-6,-10,222,"1,435.74",2210
,20160928,4315,4311,4279,4279,4236,4243,4249,-68,-62,348,"2,218.14",2252
,20160929,4243,4249,4249,4282,4225,4256,4255,7,6,266,"1,697.92",2134
,20160930,4256,4255,4260,4260,4246,4251,4252,-4,-3,100,637.94,2172
,20161010,4251,4252,3969,3970,3939,3964,3962,-288,-290,1330,"7,904.53",3314
,20161011,3964,3962,3963,3995,3960,3995,3967,33,5,412,"2,451.77",3470
,20161012,3995,3967,3961,3970,3961,3961,3966,-6,-1,784,"4,664.60",4208
,20161013,3961,3966,3966,3989,3956,3973,3975,7,9,742,"4,424.53",4776
,20161014,3973,3975,3965,3970,3946,3958,3964,-17,-11,572,"3,401.36",5164
,20161017,3958,3964,3960,3972,3949,3971,3961,7,-3,398,"2,364.94",5406
,20161018,3971,3961,3966,4017,3964,4017,3990,56,29,886,"5,302.99",6160
,20161019,4017,3990,4014,4023,3998,4004,4010,14,20,1334,"8,025.24",7336
,20161020,4004,4010,4032,4038,4020,4029,4025,19,15,236,"1,424.91",7326
,20161021,4029,4025,4013,4013,3968,3977,3978,-48,-47,78,465.53,7324
,20161024,3977,3978,3986,4011,3982,4010,3998,32,20,70,419.81,7324
,20161025,4010,3998,4038,4057,4012,4034,4036,36,38,632,"3,826.23",7416
,20161026,4034,4036,4051,4073,4033,4061,4052,25,16,980,"5,957.26",7552
,20161027,4061,4052,4052,4052,4026,4034,4038,-18,-14,384,"2,325.97",7552
,20161028,4034,4038,4051,4051,4035,4038,4043,0,5,144,873.39,7636
,20161031,4038,4043,4043,4090,4026,4061,4059,18,16,1962,"11,945.81",7892
,20161101,4061,4059,4056,4080,4056,4080,4070,21,11,120,732.68,7964
,20161102,4080,4070,4130,4162,4130,4161,4154,91,84,504,"3,140.92",8404
,20161103,4161,4154,4190,4196,4152,4154,4168,0,14,648,"4,052.09",9032
,20161104,4154,4168,4103,4135,4100,4100,4116,-68,-52,276,"1,704.04",8908
,20161107,4100,4116,4103,4107,4090,4098,4099,-18,-17,380,"2,336.95",8948
,20161108,4098,4099,4098,4109,4091,4109,4100,10,1,288,"1,771.32",9176
,20161109,4109,4100,4110,4260,4110,4248,4160,148,60,768,"4,793.41",9360
,20161110,4248,4160,4182,4232,4182,4232,4219,72,59,64,405.04,9368
,20161111,4232,4219,4250,4263,4150,4263,4225,44,6,444,"2,814.06",9388
,20161114,4263,4225,4130,4190,3975,3975,4016,-250,-209,308,"1,855.77",9472
,20161115,3975,4016,4000,4010,4000,4010,4006,-6,-10,12,72.12,9480
ag1612,20160104,3365,3369,3369,3383,3335,3380,3358,11,-11,442,"2,227.00",1302
,20160105,3380,3358,3372,3400,3362,3390,3383,32,25,950,"4,822.04",1810
,20160106,3390,3383,3398,3400,3371,3391,3386,8,3,636,"3,230.51",1852
,20160107,3391,3386,3394,3459,3381,3432,3416,46,30,1962,"10,055.63",2672
,20160108,3432,3416,3440,3462,3419,3430,3436,14,20,504,"2,598.02",2736
,20160111,3430,3436,3420,3427,3402,3422,3413,-14,-23,1060,"5,427.39",2776
,20160112,3422,3413,3422,3422,3360,3361,3380,-52,-33,984,"4,989.93",2932
,20160113,3361,3380,3354,3361,3342,3346,3350,-34,-30,486,"2,442.59",2908
,20160114,3346,3350,3349,3399,3349,3389,3381,39,31,544,"2,759.48",2976
,20160115,3389,3381,3371,3382,3362,3367,3368,-14,-13,328,"1,657.22",2920
,20160118,3367,3368,3375,3398,3371,3371,3382,3,14,194,984.25,2910
,20160119,3371,3382,3376,3395,3373,3392,3384,10,2,176,893.38,2912
,20160120,3392,3384,3396,3408,3388,3391,3394,7,10,398,"2,026.45",3030
,20160121,3391,3394,3408,3415,3397,3408,3405,14,11,396,"2,022.91",3146
,20160122,3408,3405,3395,3402,3380,3398,3388,-7,-17,496,"2,521.13",3202
,20160125,3398,3388,3405,3430,3391,3396,3402,8,14,600,"3,062.70",3268
,20160126,3396,3402,3412,3431,3402,3431,3419,29,17,526,"2,697.84",3352
,20160127,3431,3419,3431,3450,3422,3443,3439,24,20,630,"3,250.77",3444
,20160128,3443,3439,3438,3448,3425,3425,3433,-14,-6,398,"2,049.84",3316
,20160129,3425,3433,3426,3429,3408,3411,3415,-22,-18,922,"4,724.06",3722
,20160201,3411,3415,3392,3425,3392,3422,3415,7,0,252,"1,290.96",3776
,20160202,3422,3415,3424,3433,3410,3412,3420,-3,5,258,"1,323.54",3790
,20160203,3412,3420,3416,3430,3405,3416,3417,-4,-3,464,"2,378.44",3868
,20160204,3416,3417,3425,3470,3418,3466,3445,49,28,860,"4,444.96",3830
,20160205,3466,3445,3480,3498,3462,3468,3473,23,28,1356,"7,065.84",4354
,20160215,3468,3473,3566,3594,3534,3551,3551,78,78,2040,"10,867.57",4670
,20160216,3551,3551,3552,3552,3524,3542,3538,-9,-13,1394,"7,399.64",5210
,20160217,3542,3538,3548,3550,3530,3544,3537,6,-1,1678,"8,904.88",5160
,20160218,3544,3537,3544,3546,3534,3534,3540,-3,3,548,"2,909.95",5290
,20160219,3534,3540,3526,3555,3526,3553,3545,13,5,764,"4,063.34",5348
,20160222,3553,3545,3555,3561,3526,3526,3538,-19,-7,1110,"5,891.46",5528
,20160223,3526,3538,3505,3529,3502,3526,3518,-12,-20,1166,"6,153.62",5620
,20160224,3526,3518,3516,3533,3516,3522,3526,4,8,1058,"5,596.16",5774
,20160225,3522,3526,3530,3560,3509,3510,3530,-16,4,2556,"13,535.01",6648
,20160226,3510,3530,3508,3513,3475,3486,3492,-44,-38,1568,"8,213.23",6746
,20160229,3486,3492,3488,3490,3396,3404,3428,-88,-64,4064,"20,902.65",7906
,20160301,3404,3428,3417,3444,3400,3436,3424,8,-4,2148,"11,033.92",8172
,20160302,3436,3424,3436,3448,3398,3413,3421,-11,-3,9708,"49,817.75",12192
,20160303,3413,3421,3416,3444,3411,3427,3426,6,5,4042,"20,773.69",13118
,20160304,3427,3426,3432,3516,3420,3506,3462,80,36,7006,"36,385.04",14914
,20160307,3506,3462,3514,3596,3468,3563,3554,101,92,25188,"134,283.61",22326
,20160308,3563,3554,3589,3642,3518,3540,3581,-14,27,20978,"112,702.38",26988
,20160309,3540,3581,3552,3555,3455,3481,3502,-100,-79,12868,"67,600.64",26958
,20160310,3481,3502,3477,3507,3469,3480,3487,-22,-15,8360,"43,738.64",28266
,20160311,3480,3487,3480,3556,3460,3520,3519,33,32,15760,"83,192.92",27716
,20160314,3520,3519,3520,3531,3495,3520,3517,1,-2,9810,"51,755.86",28144
,20160315,3520,3517,3531,3565,3470,3480,3502,-37,-15,14402,"75,657.66",28582
,20160316,3480,3502,3480,3490,3466,3486,3479,-16,-23,3880,"20,250.79",28702
,20160317,3486,3479,3486,3535,3464,3520,3496,41,17,15228,"79,872.34",28022
,20160318,3520,3496,3526,3624,3526,3607,3581,111,85,33488,"179,921.67",35564
,20160321,3607,3581,3592,3592,3542,3554,3559,-27,-22,21036,"112,307.51",38592
,20160322,3554,3559,3558,3613,3554,3608,3581,49,22,23874,"128,271.37",48026
,20160323,3608,3581,3618,3618,3552,3555,3578,-26,-3,23756,"127,530.52",50310
,20160324,3555,3578,3515,3522,3490,3497,3504,-81,-74,28512,"149,900.04",46214
,20160325,3497,3504,3510,3514,3488,3497,3499,-7,-5,9964,"52,306.99",47556
,20160328,3497,3499,3497,3506,3488,3494,3496,-5,-3,9934,"52,101.34",47780
,20160329,3494,3496,3500,3514,3474,3477,3489,-19,-7,21374,"111,884.59",53000
,20160330,3477,3489,3480,3515,3472,3509,3497,20,8,19408,"101,826.54",55606
,20160331,3509,3497,3502,3512,3479,3488,3489,-9,-8,14642,"76,643.15",57540
,20160401,3488,3489,3518,3519,3491,3499,3501,10,12,19800,"103,996.34",61968
,20160405,3499,3501,3444,3461,3425,3449,3449,-52,-52,12432,"64,321.02",65042
,20160406,3449,3449,3456,3467,3446,3450,3455,1,6,12510,"64,851.83",68944
,20160407,3450,3455,3440,3465,3433,3456,3453,1,-2,10530,"54,551.58",70826
,20160408,3456,3453,3469,3486,3458,3458,3469,5,16,15868,"82,592.51",71766
,20160411,3458,3469,3464,3506,3462,3498,3489,29,20,28578,"149,599.97",75382
,20160412,3498,3489,3529,3550,3522,3550,3534,61,45,40276,"213,543.23",86854
,20160413,3550,3534,3565,3600,3556,3565,3571,31,37,105988,"567,794.73",120440
,20160414,3565,3571,3578,3611,3552,3570,3579,-1,8,75874,"407,337.14",140168
,20160415,3570,3579,3574,3592,3561,3582,3575,3,-4,58286,"312,589.24",156992
,20160418,3582,3575,3575,3620,3558,3567,3582,-8,7,84760,"455,432.69",171024
,20160419,3567,3582,3595,3742,3572,3733,3631,151,49,117264,"638,710.01",180802
,20160420,3733,3631,3785,3843,3735,3765,3784,134,153,245970,"1,396,125.96",220092
,20160421,3765,3784,3790,3935,3773,3898,3841,114,57,265194,"1,528,125.50",239574
,20160422,3898,3841,3945,3963,3749,3798,3819,-43,-22,301062,"1,724,957.45",229612
,20160425,3798,3819,3829,3863,3717,3781,3789,-38,-30,250722,"1,425,199.90",233010
,20160426,3781,3789,3778,3802,3761,3768,3783,-21,-6,152962,"868,012.70",262316
,20160427,3768,3783,3775,3878,3770,3869,3827,86,44,222154,"1,275,480.35",298844
,20160428,3869,3827,3879,3881,3803,3856,3837,29,10,237142,"1,364,926.91",307276
,20160429,3856,3837,3886,3978,3841,3933,3920,96,83,317750,"1,868,674.63",360992
,20160503,3933,3920,3917,3945,3888,3940,3922,20,2,167542,"985,885.47",378872
,20160504,3940,3922,3917,3935,3849,3856,3886,-66,-36,273600,"1,594,829.28",380332
,20160505,3856,3886,3883,3887,3841,3867,3867,-19,-19,219628,"1,274,218.10",376466
,20160506,3867,3867,3899,3914,3805,3834,3852,-33,-15,452204,"2,613,089.39",396520
,20160509,3834,3852,3859,3888,3821,3828,3849,-24,-3,459094,"2,651,147.58",433584
,20160510,3828,3849,3793,3795,3721,3768,3756,-81,-93,481554,"2,713,528.54",439960
,20160511,3768,3756,3756,3825,3746,3806,3787,50,31,469730,"2,668,332.75",479698
,20160512,3806,3787,3838,3858,3810,3822,3834,35,47,525870,"3,024,609.69",488434
,20160513,3822,3834,3812,3850,3747,3788,3792,-46,-42,737412,"4,194,674.67",482282
,20160516,3788,3792,3756,3838,3750,3834,3796,42,4,554168,"3,155,561.49",511264
,20160517,3834,3796,3845,3848,3796,3817,3818,21,22,432048,"2,474,802.74",503482
,20160518,3817,3818,3800,3842,3788,3788,3816,-30,-2,528952,"3,027,739.10",510900
,20160519,3788,3816,3786,3819,3698,3700,3765,-116,-51,764358,"4,317,633.04",527964
,20160520,3700,3765,3672,3697,3651,3678,3673,-87,-92,559092,"3,080,671.70",547112
,20160523,3678,3673,3699,3712,3630,3650,3670,-23,-3,583802,"3,214,319.47",554350
,20160524,3650,3670,3648,3664,3617,3622,3642,-48,-28,427062,"2,333,080.93",566640
,20160525,3622,3642,3630,3660,3612,3623,3632,-19,-10,469250,"2,556,923.05",564482
,20160526,3623,3632,3623,3674,3623,3665,3646,33,14,417958,"2,285,868.68",558236
,20160527,3665,3646,3672,3682,3600,3630,3639,-16,-7,525244,"2,867,487.73",571292
,20160530,3630,3639,3622,3640,3546,3565,3588,-74,-51,556390,"2,994,701.12",580080
,20160531,3565,3588,3571,3605,3560,3586,3583,-2,-5,378000,"2,031,869.20",592934
,20160601,3586,3583,3579,3597,3574,3590,3585,7,2,417804,"2,247,286.46",569358
,20160602,3590,3585,3588,3600,3561,3593,3585,8,0,484758,"2,607,189.96",538820
,20160603,3593,3585,3591,3605,3580,3601,3589,16,4,277354,"1,493,404.72",552946
,20160606,3601,3589,3660,3679,3651,3667,3664,78,75,500138,"2,748,838.14",528954
,20160607,3667,3664,3684,3693,3658,3677,3678,13,14,319352,"1,762,149.54",525504
,20160608,3677,3678,3665,3718,3661,3712,3690,34,12,348458,"1,928,919.51",531502
,20160613,3712,3690,3834,3864,3804,3847,3830,157,140,392728,"2,256,562.50",559942
,20160614,3847,3830,3867,3872,3831,3848,3853,18,23,417450,"2,413,258.15",580736
,20160615,3848,3853,3859,3878,3845,3869,3860,16,7,404858,"2,344,536.33",582470
,20160616,3869,3860,3871,3945,3835,3935,3900,75,40,684578,"4,005,543.79",623520
,20160617,3935,3900,3937,3941,3810,3836,3875,-64,-25,804894,"4,679,128.40",611744
,20160620,3836,3875,3846,3866,3816,3841,3842,-34,-33,457478,"2,636,626.17",624986
,20160621,3841,3842,3843,3882,3835,3850,3857,8,15,424710,"2,457,760.58",645754
,20160622,3850,3857,3813,3828,3780,3809,3810,-48,-47,458680,"2,621,721.43",620244
,20160623,3809,3810,3803,3827,3800,3811,3815,1,5,381220,"2,181,789.79",625016
,20160624,3811,3815,3810,3938,3808,3901,3868,86,53,1024378,"5,943,936.13",650062
,20160627,3901,3868,3935,3960,3894,3925,3924,57,56,684838,"4,030,983.35",650600
,20160628,3925,3924,3930,3934,3882,3909,3908,-15,-16,393308,"2,305,978.11",657096
,20160629,3909,3908,3915,4065,3912,4056,3979,148,71,1067420,"6,371,840.52",789134
,20160630,4056,3979,4078,4085,4021,4064,4052,85,73,823344,"5,005,030.57",767918
,20160701,4064,4052,4070,4285,4056,4230,4169,178,117,1518798,"9,498,786.58",738136
,20160704,4230,4169,4233,4419,4226,4419,4303,250,134,849340,"5,482,284.24",728592
,20160705,4419,4303,4588,4599,4315,4427,4469,124,166,1916788,"12,851,050.10",672990
,20160706,4427,4469,4382,4575,4338,4511,4449,42,-20,2088988,"13,942,302.71",687792
,20160707,4511,4449,4481,4508,4416,4455,4465,6,16,1162692,"7,788,612.17",679452
,20160708,4455,4465,4419,4422,4320,4340,4363,-125,-102,1276016,"8,351,252.13",667546
,20160711,4340,4363,4318,4580,4301,4506,4463,143,100,1900034,"12,720,786.65",744214
,20160712,4506,4463,4481,4538,4459,4517,4506,54,43,1181030,"7,982,944.01",760710
,20160713,4517,4506,4512,4537,4397,4523,4481,17,-25,1840992,"12,375,163.22",807440
,20160714,4523,4481,4518,4549,4459,4491,4496,10,15,1328388,"8,958,660.81",771988
,20160715,4491,4496,4446,4493,4430,4466,4465,-30,-31,884980,"5,928,333.14",758848
,20160718,4466,4465,4470,4472,4385,4395,4429,-70,-36,982928,"6,530,340.08",734200
,20160719,4395,4429,4389,4421,4369,4392,4397,-37,-32,769506,"5,075,798.00",731752
,20160720,4392,4397,4395,4416,4356,4358,4389,-39,-8,693650,"4,567,186.76",753062
,20160721,4358,4389,4308,4319,4243,4273,4286,-116,-103,958284,"6,161,300.88",697594
,20160722,4273,4286,4278,4402,4256,4333,4336,47,50,1049482,"6,826,193.32",696560
,20160725,4333,4336,4336,4352,4266,4297,4316,-39,-20,723750,"4,686,220.59",691712
,20160726,4297,4316,4293,4355,4266,4332,4321,16,5,796298,"5,161,400.47",694132
,20160727,4332,4321,4327,4351,4312,4326,4332,5,11,509950,"3,313,698.71",691762
,20160728,4326,4332,4340,4514,4338,4499,4430,167,98,1266174,"8,414,137.16",730820
,20160729,4499,4430,4492,4492,4432,4442,4465,12,35,791030,"5,298,237.96",723278
,20160801,4442,4465,4475,4558,4446,4530,4503,65,38,1140446,"7,704,262.10",756980
,20160802,4530,4503,4527,4545,4492,4531,4521,28,18,682914,"4,631,394.97",766558
,20160803,4531,4521,4578,4588,4545,4569,4565,48,44,741214,"5,076,531.01",782944
,20160804,4569,4565,4549,4554,4441,4451,4494,-114,-71,947548,"6,388,359.42",744762
,20160805,4451,4494,4494,4508,4469,4496,4490,2,-4,636060,"4,284,688.26",736830
,20160808,4496,4490,4421,4421,4335,4341,4374,-149,-116,906608,"5,949,550.28",707786
,20160809,4341,4374,4368,4384,4336,4342,4362,-32,-12,490220,"3,208,164.64",694686
,20160810,4342,4362,4338,4477,4327,4462,4406,100,44,805430,"5,323,289.50",717436
,20160811,4462,4406,4487,4498,4400,4428,4445,22,39,728440,"4,856,875.55",693398
,20160812,4428,4445,4439,4465,4404,4418,4432,-27,-13,613898,"4,081,196.43",699542
,20160815,4418,4432,4450,4458,4352,4377,4400,-55,-32,804808,"5,311,864.09",676820
,20160816,4377,4400,4365,4433,4361,4410,4395,10,-5,595176,"3,923,946.70",695148
,20160817,4410,4395,4390,4409,4348,4357,4380,-38,-15,736386,"4,838,322.56",702402
,20160818,4357,4380,4357,4420,4304,4382,4372,2,-8,817088,"5,359,294.84",693840
,20160819,4382,4372,4375,4393,4349,4367,4372,-5,0,466792,"3,061,335.83",694094
,20160822,4367,4372,4306,4335,4196,4204,4264,-168,-108,921556,"5,895,235.09",710638
,20160823,4204,4264,4214,4238,4204,4232,4222,-32,-42,434706,"2,753,426.97",700504
,20160824,4232,4222,4240,4245,4201,4209,4219,-13,-3,396934,"2,512,245.54",712760
,20160825,4209,4219,4200,4201,4040,4144,4149,-75,-70,719096,"4,476,234.23",715020
,20160826,4144,4149,4133,4163,4126,4148,4143,-1,-6,391840,"2,435,257.71",711772
,20160829,4148,4143,4172,4239,4101,4129,4169,-14,26,1264740,"7,910,533.63",683646
,20160830,4129,4169,4146,4196,4138,4160,4166,-9,-3,569632,"3,560,021.17",675058
,20160831,4160,4166,4166,4194,4141,4164,4165,-2,-1,604332,"3,775,670.12",656602
,20160901,4164,4165,4151,4188,4151,4172,4169,7,4,427672,"2,674,986.73",655104
,20160902,4172,4169,4159,4240,4158,4209,4200,40,31,723306,"4,557,150.16",666286
,20160905,4209,4200,4286,4323,4269,4317,4294,117,94,806166,"5,193,549.05",642888
,20160906,4317,4294,4330,4348,4317,4345,4334,51,40,379184,"2,465,139.95",655474
,20160907,4345,4334,4364,4458,4357,4416,4409,82,75,867724,"5,739,649.73",646836
,20160908,4416,4409,4432,4432,4378,4412,4402,3,-7,511720,"3,378,974.39",630388
,20160909,4412,4402,4404,4405,4341,4351,4372,-51,-30,603648,"3,959,037.14",619888
,20160912,4351,4372,4338,4348,4220,4248,4285,-124,-87,790160,"5,078,790.18",603798
,20160913,4248,4285,4240,4312,4222,4280,4265,-5,-20,660334,"4,224,830.11",586594
,20160914,4280,4265,4265,4273,4210,4265,4246,0,-19,627282,"3,995,952.64",592368
,20160919,4265,4246,4227,4308,4218,4284,4269,38,23,373100,"2,389,681.48",602938
,20160920,4284,4269,4300,4316,4280,4302,4301,33,32,408950,"2,638,392.26",599840
,20160921,4302,4301,4297,4352,4271,4345,4308,44,7,664526,"4,294,410.85",643102
,20160922,4345,4308,4400,4430,4352,4385,4397,77,89,959772,"6,330,730.90",609332
,20160923,4385,4397,4421,4444,4379,4394,4413,-3,16,668518,"4,426,004.95",624024
,20160926,4394,4413,4402,4402,4319,4342,4360,-71,-53,591404,"3,867,999.28",599586
,20160927,4342,4360,4333,4365,4313,4335,4339,-25,-21,508916,"3,312,281.99",588286
,20160928,4335,4339,4315,4317,4250,4258,4277,-81,-62,747270,"4,795,088.35",572476
,20160929,4258,4277,4268,4310,4232,4269,4272,-8,-5,534762,"3,427,353.38",546284
,20160930,4269,4272,4251,4293,4249,4266,4270,-6,-2,466044,"2,985,212.37",524172
,20161010,4266,4270,3952,4001,3952,3981,3976,-289,-294,483216,"2,882,203.63",508154
,20161011,3981,3976,3974,4024,3967,4015,3989,39,13,568006,"3,399,220.38",540440
,20161012,4015,3989,3979,3999,3971,3987,3983,-2,-6,501496,"2,996,770.20",549134
,20161013,3987,3983,3975,4007,3967,3992,3986,9,3,510614,"3,053,240.82",547748
,20161014,3992,3986,3982,3996,3972,3981,3984,-5,-2,380420,"2,273,525.29",547756
,20161017,3981,3984,3976,4005,3966,3986,3984,2,0,521934,"3,119,153.18",567816
,20161018,3986,3984,3987,4042,3981,4033,4009,49,25,559570,"3,365,039.33",602206
,20161019,4033,4009,4031,4045,4013,4024,4027,15,18,424582,"2,564,981.83",563310
,20161020,4024,4027,4051,4063,4029,4044,4045,17,18,480334,"2,915,139.62",565408
,20161021,4044,4045,4043,4053,3983,4000,4009,-45,-36,527866,"3,174,966.92",553626
,20161024,4000,4009,4001,4035,3996,4030,4011,21,2,384910,"2,316,219.17",565480
,20161025,4030,4011,4052,4081,4024,4058,4051,47,40,695734,"4,228,365.74",601990
,20161026,4058,4051,4063,4100,4046,4080,4072,29,21,612998,"3,744,449.11",593440
,20161027,4080,4072,4063,4076,4046,4059,4059,-13,-13,410780,"2,501,181.69",572906
,20161028,4059,4059,4071,4076,4049,4057,4061,-2,2,352260,"2,145,983.92",549220
,20161031,4057,4061,4056,4093,4051,4080,4073,19,12,613624,"3,749,381.71",512058
,20161101,4080,4073,4078,4113,4072,4102,4087,29,14,402530,"2,468,263.44",509494
,20161102,4102,4087,4155,4196,4141,4193,4165,106,78,642228,"4,012,708.34",509430
,20161103,4193,4165,4208,4228,4168,4171,4203,6,38,542588,"3,421,268.62",449696
,20161104,4171,4203,4132,4169,4106,4111,4133,-92,-70,554180,"3,436,104.68",403004
,20161107,4111,4133,4137,4157,4098,4116,4128,-17,-5,398204,"2,465,839.10",387068
,20161108,4116,4128,4110,4145,4060,4144,4115,16,-13,425578,"2,626,998.43",388050
,20161109,4144,4115,4121,4305,4117,4264,4207,149,92,1413512,"8,920,359.37",369290
,20161110,4264,4207,4251,4274,4190,4273,4243,66,36,748222,"4,762,129.59",344092
,20161111,4273,4243,4261,4319,4221,4313,4268,70,25,770218,"4,932,048.50",345710
,20161114,4313,4268,4287,4333,4011,4014,4156,-254,-112,914730,"5,703,056.93",260784
,20161115,4014,4156,4046,4046,3976,4016,4007,-140,-149,411538,"2,473,989.36",245542
,20161116,4016,4007,4005,4050,3999,4034,4026,27,19,179824,"1,086,139.88",232158
,20161117,4034,4026,4023,4036,4013,4017,4024,-9,-2,101782,"614,413.15",225766
,20161118,4017,4024,4025,4031,3959,3981,3995,-43,-29,135168,"810,109.80",212662
,20161121,3981,3995,3985,4012,3960,4010,3986,15,-9,95468,"570,883.01",203694
,20161122,4010,3986,4008,4058,3992,4040,4022,54,36,97558,"588,595.60",189030
,20161123,4040,4022,4039,4051,4017,4036,4034,14,12,74370,"450,085.50",177682
,20161124,4036,4034,4025,4028,3962,4004,3998,-30,-36,106100,"636,418.36",164934
,20161125,4004,3998,4000,4027,3971,3997,4001,-1,3,82918,"497,710.94",148972
,20161128,3997,4001,4007,4099,4000,4079,4056,78,55,75930,"462,005.72",134564
,20161129,4079,4056,4059,4085,4036,4046,4061,-10,5,54402,"331,458.79",123386
,20161130,4046,4061,4039,4050,4010,4023,4029,-38,-32,49896,"301,610.29",108704
,20161201,4023,4029,4022,4043,3963,4018,4004,-11,-25,20120,"120,843.15",99284
,20161202,4018,4004,4000,4032,3986,4009,4011,5,7,9992,"60,128.90",95452
,20161205,4009,4011,3997,4075,3985,4030,4037,19,26,10072,"61,001.63",91340
,20161206,4030,4037,4033,4060,4022,4028,4041,-9,4,7280,"44,129.94",88792
,20161207,4028,4041,4038,4052,4028,4035,4037,-6,-4,8516,"51,571.97",83768
,20161208,4035,4037,4043,4140,4043,4112,4115,75,78,12900,"79,628.09",79224
,20161209,4112,4115,4106,4127,4066,4080,4086,-35,-29,8352,"51,196.40",77956
,20161212,4080,4086,4083,4122,4069,4098,4094,12,8,6172,"37,902.98",76408
,20161213,4098,4094,4098,4144,4062,4120,4118,26,24,3020,"18,657.73",77096
,20161214,4120,4118,4142,4145,4072,4072,4111,-46,-7,3816,"23,536.67",77120
,20161215,4072,4111,4110,4140,4073,4081,4101,-30,-10,4704,"28,940.07",80420
ag1701,20160118,3368,3368,3355,3389,3355,3389,3372,21,4,4,20.23,2
,20160119,3389,3372,3388,3390,3388,3390,3389,18,17,8,40.67,10
,20160120,3390,3389,3406,3406,3390,3390,3396,1,7,6,30.56,12
,20160121,3390,3396,,,,3396,3396,0,0,0,0.00,12
,20160122,3396,3396,,,,3396,3396,0,0,0,0.00,12
,20160125,3396,3396,,,,3396,3396,0,0,0,0.00,12
,20160126,3396,3396,,,,3396,3396,0,0,0,0.00,12
,20160127,3396,3396,,,,3396,3396,0,0,0,0.00,12
,20160128,3396,3396,,,,3390,3390,-6,-6,0,0.00,12
,20160129,3390,3390,,,,3373,3373,-17,-17,0,0.00,12
,20160201,3373,3373,,,,3373,3373,0,0,0,0.00,12
,20160202,3373,3373,,,,3411,3411,38,38,0,0.00,12
,20160203,3411,3411,,,,3408,3408,-3,-3,0,0.00,12
,20160204,3408,3408,3454,3454,3454,3454,3454,46,46,4,20.72,14
,20160205,3454,3454,3516,3524,3489,3489,3509,35,55,6,31.59,16
,20160215,3489,3509,3546,3546,3546,3546,3546,37,37,2,10.64,14
,20160216,3546,3546,3543,3543,3527,3543,3537,-3,-9,6,31.84,16
,20160217,3543,3537,3541,3560,3541,3560,3550,23,13,4,21.30,16
,20160218,3560,3550,,,,3550,3550,0,0,0,0.00,16
,20160219,3550,3550,,,,3555,3555,5,5,0,0.00,16
,20160222,3555,3555,3584,3584,3530,3530,3556,-25,1,12,64.02,22
,20160223,3530,3556,3564,3564,3527,3557,3551,1,-5,8,42.62,22
,20160224,3557,3551,,,,3551,3551,0,0,0,0.00,22
,20160225,3551,3551,3540,3579,3531,3531,3570,-20,19,306,"1,638.81",42
,20160226,3531,3570,3504,3515,3504,3515,3509,-55,-61,10,52.64,46
,20160229,3515,3509,3471,3471,3422,3431,3456,-78,-53,20,103.69,48
,20160301,3431,3456,,,,3452,3452,-4,-4,0,0.00,48
,20160302,3452,3452,3450,3451,3430,3431,3440,-21,-12,12,61.92,54
,20160303,3431,3440,3438,3438,3438,3438,3438,-2,-2,4,20.63,56
,20160304,3438,3438,3466,3500,3444,3500,3480,62,42,20,104.40,60
,20160307,3500,3480,3517,3611,3508,3569,3568,89,88,38,203.43,70
,20160308,3569,3568,3636,3636,3539,3541,3581,-27,13,14,75.22,66
,20160309,3541,3581,3453,3594,3453,3492,3530,-89,-51,48,254.23,72
,20160310,3492,3530,3514,3528,3490,3492,3501,-38,-29,16,84.04,82
,20160311,3492,3501,3536,3536,3536,3536,3536,35,35,2,10.61,80
,20160314,3536,3536,3541,3542,3519,3522,3529,-14,-7,16,84.72,78
,20160315,3522,3529,3475,3475,3475,3475,3475,-54,-54,2,10.43,78
,20160316,3475,3475,3487,3501,3487,3501,3495,26,20,6,31.46,80
,20160317,3501,3495,3550,3550,3531,3535,3541,40,46,24,127.49,80
,20160318,3535,3541,3554,3620,3554,3620,3600,79,59,10,54.01,80
,20160321,3620,3600,3577,3589,3562,3589,3581,-11,-19,12,64.47,80
,20160322,3589,3581,,,,3604,3604,23,23,0,0.00,80
,20160323,3604,3604,3604,3604,3580,3580,3594,-24,-10,22,118.61,94
,20160324,3580,3594,3538,3543,3512,3512,3521,-82,-73,28,147.92,104
,20160325,3512,3521,,,,3516,3516,-5,-5,0,0.00,104
,20160328,3516,3516,3516,3520,3508,3515,3514,-1,-2,8,42.18,102
,20160329,3515,3514,3505,3505,3496,3496,3500,-18,-14,4,21.00,104
,20160330,3496,3500,3517,3524,3517,3524,3520,24,20,12,63.37,116
,20160331,3524,3520,3515,3515,3515,3515,3515,-5,-5,16,84.36,128
,20160401,3515,3515,3508,3508,3508,3508,3508,-7,-7,6,31.57,134
,20160405,3508,3508,3472,3472,3472,3472,3472,-36,-36,4,20.83,134
,20160406,3472,3472,3475,3482,3466,3466,3472,-6,0,10,52.09,136
,20160407,3466,3472,3472,3472,3472,3472,3472,0,0,2,10.42,136
,20160408,3472,3472,3483,3485,3483,3485,3484,13,12,4,20.90,134
,20160411,3485,3484,3487,3520,3483,3520,3504,36,20,10,52.57,136
,20160412,3520,3504,3558,3558,3517,3517,3537,13,33,4,21.23,136
,20160413,3517,3537,3594,3594,3565,3567,3576,30,39,10,53.64,136
,20160414,3567,3576,3599,3618,3582,3604,3600,28,24,42,226.84,128
,20160415,3604,3600,3600,3600,3555,3590,3587,-10,-13,82,441.21,132
,20160418,3590,3587,3618,3626,3567,3592,3601,5,14,18,97.23,128
,20160419,3592,3601,3601,3772,3601,3750,3686,149,85,78,431.31,170
,20160420,3750,3686,3778,3852,3766,3778,3798,92,112,110,626.78,180
,20160421,3778,3798,3834,3926,3778,3886,3857,88,59,146,844.90,190
,20160422,3886,3857,3978,3978,3786,3808,3860,-49,3,166,961.16,202
,20160425,3808,3860,3862,3862,3639,3796,3784,-64,-76,40,227.05,208
,20160426,3796,3784,3790,3834,3776,3786,3803,2,19,112,638.96,254
,20160427,3786,3803,3815,3880,3781,3880,3836,77,33,162,932.25,300
,20160428,3880,3836,3890,3890,3826,3867,3857,31,21,86,497.64,308
,20160429,3867,3857,3860,3978,3848,3950,3937,93,80,192,"1,134.06",338
,20160503,3950,3937,3947,3952,3932,3944,3944,7,7,18,106.49,338
,20160504,3944,3944,3930,3933,3871,3871,3899,-73,-45,256,"1,497.42",412
,20160505,3871,3899,3897,3916,3873,3897,3899,-2,0,14,81.88,418
,20160506,3897,3899,3877,3877,3830,3840,3848,-59,-51,30,173.18,408
,20160509,3840,3848,3865,3876,3850,3853,3864,5,16,34,197.11,396
,20160510,3853,3864,3799,3805,3747,3768,3772,-96,-92,64,362.17,390
,20160511,3768,3772,3787,3836,3768,3821,3816,49,44,116,664.09,456
,20160512,3821,3816,3845,3873,3802,3835,3848,19,32,40,230.93,454
,20160513,3835,3848,3833,3856,3764,3797,3798,-51,-50,254,"1,447.37",456
,20160516,3797,3798,3720,3845,3690,3841,3790,43,-8,32,181.95,458
,20160517,3841,3790,3861,3861,3830,3830,3833,40,43,120,690.09,556
,20160518,3830,3833,3827,3838,3810,3810,3828,-23,-5,32,183.75,538
,20160519,3810,3828,3818,3818,3724,3724,3754,-104,-74,44,247.79,550
,20160520,3724,3754,3686,3708,3676,3702,3689,-52,-65,56,309.93,544
,20160523,3702,3689,3726,3728,3660,3672,3701,-17,12,62,344.28,560
,20160524,3672,3701,3660,3680,3646,3651,3664,-50,-37,130,714.62,522
,20160525,3651,3664,3652,3678,3650,3651,3661,-13,-3,44,241.65,538
,20160526,3651,3661,3661,3681,3655,3681,3667,20,6,22,121.03,536
,20160527,3681,3667,3700,3705,3627,3650,3645,-17,-22,196,"1,071.92",556
,20160530,3650,3645,3652,3658,3577,3577,3614,-68,-31,68,368.71,578
,20160531,3577,3614,3598,3625,3590,3608,3607,-6,-7,146,790.02,592
,20160601,3608,3607,3608,3613,3596,3613,3606,6,-1,178,962.96,608
,20160602,3613,3606,3602,3614,3587,3614,3606,8,0,60,324.60,640
,20160603,3614,3606,3602,3616,3598,3616,3608,10,2,24,129.89,632
,20160606,3616,3608,3688,3698,3668,3687,3683,79,75,116,640.97,622
,20160607,3687,3683,3710,3710,3686,3686,3697,3,14,28,155.30,616
,20160608,3686,3697,3687,3723,3687,3723,3702,26,5,20,111.08,606
,20160613,3723,3702,3848,3889,3838,3889,3844,187,142,46,265.26,602
,20160614,3889,3844,3886,3886,3831,3869,3869,25,25,28,162.54,594
,20160615,3869,3869,3875,3899,3848,3884,3877,15,8,66,383.89,598
,20160616,3884,3877,3879,3966,3879,3950,3930,73,53,284,"1,674.35",588
,20160617,3950,3930,3958,3958,3838,3856,3892,-74,-38,116,677.22,558
,20160620,3856,3892,3865,3882,3836,3860,3859,-32,-33,86,497.90,558
,20160621,3860,3859,3862,3876,3862,3862,3870,3,11,34,197.41,568
,20160622,3862,3870,3835,3845,3805,3819,3831,-51,-39,88,505.70,558
,20160623,3819,3831,3831,3840,3825,3840,3833,9,2,26,149.51,560
,20160624,3840,3833,3833,3950,3833,3924,3896,91,63,172,"1,005.32",596
,20160627,3924,3896,3957,3963,3917,3937,3934,41,38,144,849.86,600
,20160628,3937,3934,3944,3946,3901,3922,3929,-12,-5,130,766.29,590
,20160629,3922,3929,3931,4068,3931,4068,3979,139,50,112,668.63,608
,20160630,4068,3979,4099,4099,4043,4084,4068,105,89,86,524.84,606
,20160701,4084,4068,4086,4299,4065,4253,4186,185,118,202,"1,268.45",638
,20160704,4253,4186,4245,4437,4242,4437,4325,251,139,318,"2,063.31",622
,20160705,4437,4325,4526,4595,4342,4462,4503,137,178,1146,"7,741.57",818
,20160706,4462,4503,4402,4590,4291,4528,4419,25,-84,1050,"6,961.17",852
,20160707,4528,4419,4502,4518,4442,4463,4485,44,66,596,"4,010.30",794
,20160708,4463,4485,4422,4432,4338,4350,4381,-135,-104,396,"2,602.88",686
,20160711,4350,4381,4345,4598,4341,4519,4508,138,127,940,"6,356.86",732
,20160712,4519,4508,4501,4557,4474,4529,4516,21,8,876,"5,934.50",748
,20160713,4529,4516,4529,4549,4412,4528,4505,12,-11,584,"3,947.16",758
,20160714,4528,4505,4514,4558,4473,4497,4517,-8,12,250,"1,693.94",768
,20160715,4497,4517,4459,4529,4448,4477,4475,-40,-42,206,"1,382.80",764
,20160718,4477,4475,4481,4481,4403,4412,4447,-63,-28,264,"1,761.10",742
,20160719,4412,4447,4399,4431,4396,4404,4415,-43,-32,252,"1,669.04",824
,20160720,4404,4415,4403,4425,4374,4374,4404,-41,-11,224,"1,479.74",826
,20160721,4374,4404,4309,4334,4257,4295,4305,-109,-99,478,"3,086.99",880
,20160722,4295,4305,4282,4411,4271,4351,4357,46,52,442,"2,889.32",880
,20160725,4351,4357,4346,4358,4302,4308,4334,-49,-23,82,533.18,856
,20160726,4308,4334,4301,4369,4284,4356,4323,22,-11,124,804.14,850
,20160727,4356,4323,4349,4354,4336,4336,4347,13,24,72,469.57,852
,20160728,4336,4347,4388,4520,4388,4513,4455,166,108,478,"3,194.39",886
,20160729,4513,4455,4485,4492,4450,4469,4472,14,17,58,389.13,850
,20160801,4469,4472,4505,4566,4471,4536,4508,64,36,700,"4,734.41",850
,20160802,4536,4508,4548,4554,4510,4537,4533,29,25,210,"1,428.16",820
,20160803,4537,4533,4591,4597,4557,4581,4581,48,48,296,"2,034.35",786
,20160804,4581,4581,4569,4569,4457,4457,4489,-124,-92,692,"4,659.75",850
,20160805,4457,4489,4514,4515,4490,4507,4506,18,17,206,"1,392.44",774
,20160808,4507,4506,4410,4427,4351,4356,4383,-150,-123,384,"2,524.97",836
,20160809,4356,4383,4371,4391,4357,4357,4376,-26,-7,282,"1,851.29",746
,20160810,4357,4376,4347,4483,4347,4472,4404,96,28,602,"3,977.45",820
,20160811,4472,4404,4500,4504,4415,4427,4467,23,63,424,"2,841.19",860
,20160812,4427,4467,4442,4469,4421,4434,4440,-33,-27,218,"1,451.95",866
,20160815,4434,4440,4465,4465,4368,4391,4411,-49,-29,586,"3,877.34",952
,20160816,4391,4411,4380,4466,4380,4427,4412,16,1,210,"1,390.00",902
,20160817,4427,4412,4476,4476,4364,4369,4394,-43,-18,234,"1,542.53",930
,20160818,4369,4394,4371,4432,4300,4404,4381,10,-13,364,"2,392.43",966
,20160819,4404,4381,4388,4404,4366,4384,4384,3,3,142,933.84,970
,20160822,4384,4384,4315,4349,4222,4230,4277,-154,-107,634,"4,067.81",1172
,20160823,4230,4277,4232,4256,4225,4250,4240,-27,-37,312,"1,984.50",1112
,20160824,4250,4240,4251,4251,4222,4227,4233,-13,-7,152,965.24,1048
,20160825,4227,4233,4207,4207,4139,4160,4161,-73,-72,682,"4,257.55",1128
,20160826,4160,4161,4153,4172,4148,4164,4160,3,-1,100,624.13,1124
,20160829,4164,4160,4222,4256,4125,4147,4191,-13,31,410,"2,577.55",1124
,20160830,4147,4191,4159,4200,4157,4180,4185,-11,-6,296,"1,858.56",1110
,20160831,4180,4185,4192,4199,4156,4187,4175,2,-10,276,"1,728.79",1112
,20160901,4187,4175,4176,4199,4172,4188,4186,13,11,230,"1,444.30",1104
,20160902,4188,4186,4182,4251,4178,4222,4225,36,39,492,"3,118.39",1118
,20160905,4222,4225,4310,4340,4283,4334,4314,109,89,956,"6,187.42",1144
,20160906,4334,4314,4335,4363,4335,4362,4347,48,33,232,"1,512.78",1080
,20160907,4362,4347,4373,4500,4370,4447,4425,100,78,730,"4,845.43",1068
,20160908,4447,4425,4447,4447,4396,4427,4418,2,-7,452,"2,995.50",1160
,20160909,4427,4418,4406,4421,4359,4364,4386,-54,-32,414,"2,724.02",1110
,20160912,4364,4386,4354,4363,4241,4267,4294,-119,-92,468,"3,014.62",1056
,20160913,4267,4294,4266,4327,4248,4295,4286,1,-8,458,"2,945.08",1148
,20160914,4295,4286,4278,4294,4238,4286,4266,0,-20,242,"1,548.91",1128
,20160919,4286,4266,4370,4400,4237,4304,4296,38,30,234,"1,508.08",1092
,20160920,4304,4296,4326,4329,4286,4323,4316,27,20,310,"2,007.37",1048
,20160921,4323,4316,4308,4364,4285,4351,4319,35,3,306,"1,982.79",1048
,20160922,4351,4319,4386,4440,4368,4400,4413,81,94,634,"4,197.67",1080
,20160923,4400,4413,4442,4455,4394,4413,4433,0,20,814,"5,413.80",1098
,20160926,4413,4433,4417,4417,4342,4358,4371,-75,-62,344,"2,255.81",1120
,20160927,4358,4371,4360,4379,4332,4357,4356,-14,-15,234,"1,529.23",1104
,20160928,4357,4356,4327,4327,4270,4273,4289,-83,-67,602,"3,873.56",1048
,20160929,4273,4289,4290,4327,4254,4280,4287,-9,-2,550,"3,537.24",1202
,20160930,4280,4287,4284,4307,4267,4288,4289,1,2,318,"2,045.95",1196
,20161010,4288,4289,4001,4016,3950,3997,3993,-292,-296,924,"5,534.38",1390
,20161011,3997,3993,3993,4040,3992,4029,4004,36,11,810,"4,865.36",1468
,20161012,4029,4004,4029,4029,3992,4006,4001,2,-3,682,"4,093.94",1410
,20161013,4006,4001,3997,4024,3990,4006,4008,5,7,550,"3,306.97",1308
,20161014,4006,4008,4010,4015,3993,4000,4000,-8,-8,218,"1,308.30",1338
,20161017,4000,4000,3997,4022,3987,4003,4001,3,1,402,"2,412.81",1316
,20161018,4003,4001,4008,4056,3997,4046,4031,45,30,396,"2,394.86",1332
,20161019,4046,4031,4039,4061,4033,4043,4043,12,12,484,"2,935.76",1358
,20161020,4043,4043,4060,4073,4046,4062,4061,19,18,616,"3,752.73",1386
,20161021,4062,4061,4060,4066,3999,4012,4021,-49,-40,1870,"11,281.09",1636
,20161024,4012,4021,4018,4051,4013,4043,4025,22,4,448,"2,705.20",1620
,20161025,4043,4025,4056,4096,4042,4071,4063,46,38,940,"5,728.89",1610
,20161026,4071,4063,4071,4115,4067,4097,4088,34,25,816,"5,004.21",1616
,20161027,4097,4088,4081,4091,4061,4077,4076,-11,-12,700,"4,280.22",1608
,20161028,4077,4076,4096,4096,4066,4073,4081,-3,5,838,"5,130.69",1592
,20161031,4073,4081,4078,4110,4068,4097,4100,16,19,2940,"18,081.41",2526
,20161101,4097,4100,4092,4133,4057,4122,4113,22,13,1168,"7,207.13",2908
,20161102,4122,4113,4152,4219,4152,4211,4186,98,73,1766,"11,088.81",2910
,20161103,4211,4186,4251,4251,3950,4193,4227,7,41,2282,"14,470.08",2942
,20161104,4193,4227,4176,4183,4125,4125,4151,-102,-76,1000,"6,227.71",2892
,20161107,4125,4151,4145,4173,4123,4138,4145,-13,-6,830,"5,160.57",3028
,20161108,4138,4145,4132,4169,4103,4169,4140,24,-5,562,"3,490.28",3064
,20161109,4169,4140,4146,4326,4139,4293,4242,153,102,4718,"30,021.14",3730
,20161110,4293,4242,4276,4300,4222,4295,4272,53,30,7314,"46,878.47",5784
,20161111,4295,4272,4287,4348,4251,4339,4295,67,23,6802,"43,830.11",8084
,20161114,4339,4295,4339,4365,4037,4044,4125,-251,-170,6790,"42,015.05",8722
,20161115,4044,4125,4037,4065,4001,4042,4034,-83,-91,2058,"12,455.17",8608
,20161116,4042,4034,4025,4070,4022,4058,4048,24,14,1980,"12,025.29",8572
,20161117,4058,4048,4059,4060,4039,4039,4047,-9,-1,1132,"6,873.48",8726
,20161118,4039,4047,4044,4055,3981,4006,4017,-41,-30,1766,"10,641.15",8758
,20161121,4006,4017,4009,4033,3990,4030,4014,13,-3,2438,"14,679.38",9122
,20161122,4030,4014,4027,4085,4018,4069,4056,55,42,2830,"17,218.68",9738
,20161123,4069,4056,4058,4145,4050,4059,4061,3,5,2316,"14,111.26",10058
,20161124,4059,4061,4049,4072,3985,4029,4024,-32,-37,3328,"20,090.75",11024
,20161125,4029,4024,4024,4059,3998,4014,4029,-10,5,2676,"16,174.81",11984
,20161128,4014,4029,4030,4129,4029,4111,4099,82,70,4314,"26,527.84",13604
,20161129,4111,4099,4097,4123,4069,4089,4096,-10,-3,9752,"59,924.92",20040
,20161130,4089,4096,4062,4082,4041,4050,4058,-46,-38,3912,"23,817.33",20096
,20161201,4050,4058,4061,4074,3991,4041,4033,-17,-25,1788,"10,817.36",20082
,20161202,4041,4033,4022,4064,4020,4046,4052,13,19,2604,"15,828.99",20098
,20161205,4046,4052,4046,4110,4020,4065,4064,13,12,1986,"12,107.05",20368
,20161206,4065,4064,4063,4092,4050,4066,4075,2,11,7006,"42,834.47",20010
,20161207,4066,4075,4066,4083,4058,4063,4066,-12,-9,1366,"8,333.03",20082
,20161208,4063,4066,4076,4169,4074,4145,4143,79,77,2974,"18,482.73",19804
,20161209,4145,4143,4137,4156,4094,4126,4121,-17,-22,1756,"10,856.21",20108
,20161212,4126,4121,4110,4149,4108,4133,4126,12,5,2472,"15,301.90",20680
,20161213,4133,4126,4134,4179,4116,4160,4155,34,29,3248,"20,245.70",21132
,20161214,4160,4155,4161,4183,4110,4148,4147,-7,-8,2850,"17,730.12",21336
,20161215,4148,4147,4152,4181,4000,4114,4132,-33,-15,5328,"33,023.07",22014
,20161216,4114,4132,4038,4038,3984,3993,4005,-139,-127,2414,"14,504.90",22008
,20161219,3993,4005,3993,4021,3993,4011,4011,6,6,2552,"15,355.40",21934
,20161220,4011,4011,3999,4001,3805,3894,3969,-117,-42,3944,"23,485.02",22352
,20161221,3894,3969,3852,3952,3839,3937,3899,-32,-70,1938,"11,335.89",22316
,20161222,3937,3899,3932,3938,3869,3886,3901,-13,2,992,"5,806.15",22354
,20161223,3886,3901,3876,3933,3869,3890,3904,-11,3,1510,"8,844.47",22524
,20161226,3890,3904,3903,3914,3873,3901,3888,-3,-16,2180,"12,714.70",22670
,20161227,3901,3888,3886,3945,3883,3945,3913,57,25,1254,"7,360.53",22730
,20161228,3945,3913,3948,3965,3921,3945,3949,32,36,2500,"14,809.00",23610
,20161229,3945,3949,3939,3994,3933,3977,3980,28,31,1838,"10,973.61",23838
,20161230,3977,3980,3968,4026,3902,3902,3994,-78,14,5776,"34,606.90",23716
ag1702,20160216,3546,3546,3557,3595,3557,3595,3566,49,20,8,42.80,6
,20160217,3595,3566,3583,3583,3583,3583,3583,17,17,2,10.75,8
,20160218,3583,3583,3603,3603,3544,3593,3589,10,6,10,53.84,12
,20160219,3593,3589,3553,3600,3552,3585,3585,-4,-4,26,139.82,22
,20160222,3585,3585,3560,3560,3507,3544,3545,-41,-40,194,"1,031.87",168
,20160223,3544,3545,3530,3541,3530,3541,3534,-4,-11,6,31.81,170
,20160224,3541,3534,3544,3552,3536,3552,3551,18,17,158,841.75,168
,20160225,3552,3551,3555,3578,3555,3578,3566,27,15,4,21.40,172
,20160226,3578,3566,3516,3531,3508,3508,3516,-58,-50,10,52.75,166
,20160229,3508,3516,3502,3502,3437,3437,3479,-79,-37,18,93.96,158
,20160301,3437,3479,3439,3466,3439,3466,3453,-13,-26,12,62.17,162
,20160302,3466,3453,3425,3425,3425,3425,3425,-28,-28,2,10.28,162
,20160303,3425,3425,,,,3425,3425,0,0,0,0.00,162
,20160304,3425,3425,,,,3425,3425,0,0,0,0.00,162
,20160307,3425,3425,3534,3630,3530,3588,3573,163,148,28,150.07,170
,20160308,3588,3573,3591,3624,3558,3577,3590,4,17,28,150.80,182
,20160309,3577,3590,3561,3561,3500,3510,3521,-80,-69,30,158.48,184
,20160310,3510,3521,3520,3535,3503,3503,3509,-18,-12,26,136.87,184
,20160311,3503,3509,3496,3581,3496,3534,3522,25,13,16,84.53,180
,20160314,3534,3522,3549,3549,3547,3547,3547,25,25,12,63.86,188
,20160315,3547,3547,3533,3533,3520,3520,3527,-27,-20,8,42.32,190
,20160316,3520,3527,3515,3518,3491,3518,3511,-9,-16,28,147.47,194
,20160317,3518,3511,3574,3574,3543,3543,3558,32,47,8,42.70,192
,20160318,3543,3558,3569,3676,3569,3647,3620,89,62,78,423.63,190
,20160321,3647,3620,3596,3602,3590,3599,3597,-21,-23,10,53.96,196
,20160322,3599,3597,3600,3640,3600,3640,3616,43,19,10,54.25,196
,20160323,3640,3616,3617,3617,3600,3600,3601,-16,-15,18,97.25,194
,20160324,3600,3601,3545,3545,3508,3530,3530,-71,-71,10,52.95,196
,20160325,3530,3530,3547,3547,3528,3528,3534,-2,4,6,31.81,198
,20160328,3528,3534,3531,3531,3510,3528,3523,-6,-11,10,52.85,200
,20160329,3528,3523,,,,3509,3509,-14,-14,0,0.00,200
,20160330,3509,3509,,,,3509,3509,0,0,0,0.00,200
,20160331,3509,3509,,,,3504,3504,-5,-5,0,0.00,200
,20160401,3504,3504,3540,3540,3519,3519,3524,15,20,8,42.29,196
,20160405,3519,3524,3474,3488,3474,3488,3482,-36,-42,16,83.58,204
,20160406,3488,3482,3492,3547,3460,3460,3471,-22,-11,94,489.50,278
,20160407,3460,3471,,,,3471,3471,0,0,0,0.00,278
,20160408,3471,3471,3500,3500,3500,3500,3500,29,29,6,31.50,272
,20160411,3500,3500,3498,3525,3491,3516,3519,16,19,40,211.17,248
,20160412,3516,3519,3566,3566,3556,3556,3561,37,42,4,21.37,246
,20160413,3556,3561,3585,3598,3585,3598,3589,37,28,14,75.38,236
,20160414,3598,3589,3604,3604,3598,3598,3600,9,11,6,32.40,236
,20160415,3598,3600,3602,3610,3592,3610,3601,10,1,6,32.41,238
,20160418,3610,3601,3600,3654,3600,3600,3609,-1,8,22,119.10,236
,20160419,3600,3609,3619,3650,3596,3645,3625,36,16,16,87.00,234
,20160420,3645,3625,3782,3818,3769,3769,3792,144,167,46,261.68,230
,20160421,3769,3792,,,,3792,3792,0,0,0,0.00,230
,20160422,3792,3792,3970,4009,3824,3824,3921,32,129,36,211.74,228
,20160425,3824,3921,3813,3813,3813,3813,3813,-108,-108,2,11.44,226
,20160426,3813,3813,3820,3820,3820,3820,3820,7,7,4,22.92,226
,20160427,3820,3820,3819,3885,3764,3885,3838,65,18,26,149.70,230
,20160428,3885,3838,3849,3849,3838,3838,3843,0,5,4,23.06,230
,20160429,3838,3843,3933,3977,3933,3974,3952,131,109,14,83.01,226
,20160503,3974,3952,3957,3957,3957,3957,3957,5,5,2,11.87,224
,20160504,3957,3957,3929,3930,3903,3903,3917,-54,-40,12,70.52,226
,20160505,3903,3917,,,,3917,3917,0,0,0,0.00,226
,20160506,3917,3917,3869,3869,3836,3836,3858,-81,-59,6,34.72,228
,20160509,3836,3858,3892,3920,3860,3882,3884,24,26,26,151.48,234
,20160510,3882,3884,3807,3807,3780,3780,3790,-104,-94,8,45.48,240
,20160511,3780,3790,3835,3835,3835,3835,3835,45,45,2,11.51,240
,20160512,3835,3835,3862,3873,3848,3850,3856,15,21,10,57.84,244
,20160513,3850,3856,3847,3847,3793,3846,3805,-10,-51,154,878.98,348
,20160516,3846,3805,3808,3874,3802,3874,3813,69,8,16,91.52,346
,20160517,3874,3813,,,,3813,3813,0,0,0,0.00,346
,20160518,3813,3813,3839,3839,3839,3839,3839,26,26,6,34.55,346
,20160519,3839,3839,3843,3843,3838,3838,3839,-1,0,8,46.07,346
,20160520,3838,3839,3697,3728,3697,3728,3706,-111,-133,50,278.02,348
,20160523,3728,3706,3742,3764,3663,3663,3726,-43,20,18,100.62,348
,20160524,3663,3726,3683,3683,3683,3683,3683,-43,-43,2,11.05,348
,20160525,3683,3683,3673,3673,3659,3659,3668,-24,-15,16,88.05,336
,20160526,3659,3668,3672,3672,3672,3672,3672,4,4,4,22.03,336
,20160527,3672,3672,3712,3712,3647,3647,3687,-25,15,14,77.45,336
,20160530,3647,3687,3668,3675,3613,3613,3647,-74,-40,34,186.01,328
,20160531,3613,3647,3627,3627,3627,3627,3627,-20,-20,8,43.52,328
,20160601,3627,3627,3629,3629,3629,3629,3629,2,2,20,108.87,328
,20160602,3629,3629,3624,3638,3618,3638,3625,9,-4,12,65.26,334
,20160603,3638,3625,,,,3625,3625,0,0,0,0.00,334
,20160606,3625,3625,3695,3707,3695,3699,3700,74,75,6,33.30,328
,20160607,3699,3700,,,,3700,3700,0,0,0,0.00,328
,20160608,3700,3700,3747,3758,3742,3744,3748,44,48,10,56.23,326
,20160613,3744,3748,3861,3918,3860,3918,3879,170,131,6,34.92,328
,20160614,3918,3879,3884,3884,3884,3884,3884,5,5,2,11.65,326
,20160615,3884,3884,3927,3927,3927,3927,3927,43,43,2,11.78,326
,20160616,3927,3927,3957,3957,3957,3957,3957,30,30,2,11.87,326
,20160617,3957,3957,3869,3869,3869,3869,3869,-88,-88,2,11.61,324
,20160620,3869,3869,3886,3886,3839,3878,3872,9,3,70,406.61,332
,20160621,3878,3872,3888,3888,3888,3888,3888,16,16,4,23.33,328
,20160622,3888,3888,3860,3860,3836,3836,3852,-52,-36,6,34.67,328
,20160623,3836,3852,3849,3849,3849,3849,3849,-3,-3,2,11.55,328
,20160624,3849,3849,3860,3870,3860,3870,3862,21,13,8,46.35,326
,20160627,3870,3862,3936,3936,3936,3936,3936,74,74,2,11.81,324
,20160628,3936,3936,,,,3936,3936,0,0,0,0.00,324
,20160629,3936,3936,3999,4093,3999,4093,4041,157,105,14,84.88,312
,20160630,4093,4041,4124,4124,4124,4124,4124,83,83,2,12.37,314
,20160701,4124,4124,4116,4291,4102,4291,4142,167,18,104,646.17,326
,20160704,4291,4142,,,,4280,4280,138,138,0,0.00,326
,20160705,4280,4280,4536,4536,4415,4492,4525,212,245,212,"1,439.22",212
,20160706,4492,4525,4451,4616,4426,4595,4512,70,-13,68,460.25,216
,20160707,4595,4512,4569,4569,4464,4517,4502,5,-10,26,175.60,218
,20160708,4517,4502,4462,4462,4380,4380,4433,-122,-69,12,79.80,218
,20160711,4380,4433,4433,4591,4405,4569,4476,136,43,40,268.58,220
,20160712,4569,4476,4510,4516,4504,4510,4510,34,34,16,108.24,222
,20160713,4510,4510,4541,4545,4433,4540,4518,30,8,58,393.14,202
,20160714,4540,4518,4541,4576,4509,4509,4538,-9,20,16,108.92,198
,20160715,4509,4538,,,,4538,4538,0,0,0,0.00,198
,20160718,4538,4538,4473,4479,4434,4434,4457,-104,-81,18,120.35,198
,20160719,4434,4457,4436,4442,4436,4442,4439,-15,-18,10,66.59,192
,20160720,4442,4439,,,,4439,4439,0,0,0,0.00,192
,20160721,4439,4439,4300,4305,4300,4305,4301,-134,-138,12,77.42,188
,20160722,4305,4301,,,,4301,4301,0,0,0,0.00,188
,20160725,4301,4301,,,,4301,4301,0,0,0,0.00,188
,20160726,4301,4301,,,,4301,4301,0,0,0,0.00,188
,20160727,4301,4301,4360,4362,4360,4362,4361,61,60,4,26.17,184
,20160728,4362,4361,4436,4528,4435,4528,4466,167,105,6,40.20,186
,20160729,4528,4466,4516,4516,4496,4496,4509,30,43,6,40.58,186
,20160801,4496,4509,4498,4603,4491,4542,4537,33,28,12,81.68,186
,20160802,4542,4537,4554,4563,4554,4563,4557,26,20,6,41.01,184
,20160803,4563,4557,,,,4557,4557,0,0,0,0.00,184
,20160804,4557,4557,4565,4565,4535,4550,4558,-7,1,18,123.07,184
,20160805,4550,4558,4527,4528,4516,4528,4520,-30,-38,28,189.86,190
,20160808,4528,4520,4400,4400,4400,4400,4400,-120,-120,4,26.40,186
,20160809,4400,4400,,,,4400,4400,0,0,0,0.00,186
,20160810,4400,4400,,,,4400,4400,0,0,0,0.00,186
,20160811,4400,4400,4429,4448,4429,4447,4440,47,40,310,"2,065.04",482
,20160812,4447,4440,4456,4483,4391,4466,4455,26,15,84,561.35,502
,20160815,4466,4455,4464,4474,4362,4401,4444,-54,-11,118,786.68,552
,20160816,4401,4444,4398,4414,4396,4414,4399,-30,-45,44,290.37,530
,20160817,4414,4399,4385,4385,4385,4385,4385,-14,-14,2,13.16,532
,20160818,4385,4385,4395,4440,4395,4440,4417,55,32,4,26.51,530
,20160819,4440,4417,4410,4410,4398,4398,4404,-19,-13,4,26.42,530
,20160822,4398,4404,4344,4348,4344,4348,4345,-56,-59,8,52.14,538
,20160823,4348,4345,4255,4255,4255,4255,4255,-90,-90,12,76.59,550
,20160824,4255,4255,4232,4232,4232,4232,4232,-23,-23,2,12.70,552
,20160825,4232,4232,4194,4203,4174,4174,4189,-58,-43,40,251.38,582
,20160826,4174,4189,,,,4189,4189,0,0,0,0.00,582
,20160829,4189,4189,4152,4152,4152,4152,4152,-37,-37,2,12.46,584
,20160830,4152,4152,,,,4152,4152,0,0,0,0.00,584
,20160831,4152,4152,4184,4204,4184,4196,4199,44,47,38,239.39,596
,20160901,4196,4199,4197,4197,4197,4197,4197,-2,-2,6,37.77,590
,20160902,4197,4197,4240,4258,4219,4219,4238,22,41,12,76.30,586
,20160905,4219,4238,4300,4342,4300,4342,4326,104,88,12,77.88,582
,20160906,4342,4326,4344,4369,4344,4354,4357,28,31,16,104.59,582
,20160907,4354,4357,4456,4469,4454,4469,4456,112,99,16,106.96,580
,20160908,4469,4456,4454,4454,4425,4435,4442,-21,-14,16,106.61,586
,20160909,4435,4442,,,,4442,4442,0,0,0,0.00,586
,20160912,4442,4442,4265,4267,4265,4267,4266,-175,-176,14,89.59,572
,20160913,4267,4266,4268,4330,4268,4311,4308,45,42,10,64.63,572
,20160914,4311,4308,,,,4308,4308,0,0,0,0.00,572
,20160919,4308,4308,4265,4323,4265,4323,4287,15,-21,6,38.58,568
,20160920,4323,4287,4330,4345,4328,4328,4331,41,44,18,116.95,558
,20160921,4328,4331,4308,4381,4308,4381,4341,50,10,12,78.14,562
,20160922,4381,4341,4408,4465,4408,4418,4439,77,98,86,572.74,570
,20160923,4418,4439,4449,4473,4417,4417,4451,-22,12,74,494.11,528
,20160926,4417,4451,4414,4418,4364,4364,4411,-87,-40,264,"1,746.80",574
,20160927,4364,4411,4375,4388,4360,4360,4379,-51,-32,26,170.80,552
,20160928,4360,4379,4292,4292,4287,4287,4289,-92,-90,4,25.74,550
,20160929,4287,4289,,,,4289,4289,0,0,0,0.00,550
,20160930,4289,4289,4289,4289,4289,4289,4289,0,0,8,51.47,544
,20161010,4289,4289,3998,4022,3998,4010,4010,-279,-279,26,156.42,544
,20161011,4010,4010,4010,4018,4008,4016,4013,6,3,20,120.39,552
,20161012,4016,4013,,,,4013,4013,0,0,0,0.00,552
,20161013,4013,4013,4009,4021,4009,4021,4015,8,2,4,24.09,548
,20161014,4021,4015,4014,4014,4012,4014,4013,-1,-2,6,36.12,546
,20161017,4014,4013,4015,4032,3999,4013,4016,0,3,32,192.81,528
,20161018,4013,4016,4029,4077,4029,4077,4048,61,32,8,48.58,534
,20161019,4077,4048,4053,4067,4044,4044,4054,-4,6,22,133.79,538
,20161020,4044,4054,4071,4081,4071,4076,4075,22,21,12,73.37,538
,20161021,4076,4075,4068,4068,4018,4035,4036,-40,-39,28,169.55,536
,20161024,4035,4036,,,,4036,4036,0,0,0,0.00,536
,20161025,4036,4036,4093,4105,4083,4085,4092,49,56,96,589.28,518
,20161026,4085,4092,4088,4124,4088,4124,4095,32,3,30,184.31,504
,20161027,4124,4095,,,,4095,4095,0,0,0,0.00,504
,20161028,4095,4095,4089,4095,4084,4095,4087,0,-8,32,196.19,494
,20161031,4095,4087,4093,4122,4093,4120,4118,33,31,248,"1,532.03",638
,20161101,4120,4118,4110,4139,4110,4134,4126,16,8,130,804.64,754
,20161102,4134,4126,4191,4216,4188,4216,4199,90,73,146,919.66,824
,20161103,4216,4199,4253,4263,4213,4215,4240,16,41,256,"1,628.17",1052
,20161104,4215,4240,4164,4200,4160,4172,4175,-68,-65,652,"4,083.51",1504
,20161107,4172,4175,4188,4191,4127,4157,4174,-18,-1,312,"1,953.87",1596
,20161108,4157,4174,4157,4175,4142,4159,4159,-15,-15,80,499.19,1624
,20161109,4159,4159,4171,4342,4167,4307,4224,148,65,400,"2,534.63",1814
,20161110,4307,4224,4295,4318,4259,4317,4294,93,70,74,476.72,1852
,20161111,4317,4294,4316,4352,4277,4352,4325,58,31,288,"1,868.74",1872
,20161114,4352,4325,4349,4412,4065,4065,4139,-260,-186,410,"2,545.97",1868
,20161115,4065,4139,4068,4085,4020,4062,4055,-77,-84,416,"2,530.92",1806
,20161116,4062,4055,4060,4095,4016,4088,4068,33,13,120,732.26,1818
,20161117,4088,4068,4112,4112,4062,4062,4070,-6,2,48,293.04,1808
,20161118,4062,4070,4063,4105,4015,4026,4056,-44,-14,104,632.78,1820
,20161121,4026,4056,4029,4050,4012,4050,4043,-6,-13,68,412.40,1820
,20161122,4050,4043,4038,4098,4038,4090,4084,47,41,66,404.33,1846
,20161123,4090,4084,4090,4098,4070,4082,4086,-2,2,58,355.49,1844
,20161124,4082,4086,4067,4073,4012,4040,4041,-46,-45,294,"1,782.23",1678
,20161125,4040,4041,4059,4080,4027,4036,4065,-5,24,184,"1,122.19",1772
,20161128,4036,4065,4050,4151,4050,4133,4131,68,66,290,"1,797.18",1850
,20161129,4133,4131,4127,4140,4059,4109,4117,-22,-14,124,765.89,1840
,20161130,4109,4117,4092,4105,4074,4083,4085,-34,-32,96,588.26,1892
,20161201,4083,4085,4088,4088,4035,4041,4044,-44,-41,314,"1,904.93",1926
,20161202,4041,4044,4046,4086,3970,4051,4067,7,23,178,"1,086.15",1908
,20161205,4051,4067,4051,4128,4051,4086,4091,19,24,262,"1,607.79",1918
,20161206,4086,4091,4104,4119,4085,4092,4103,1,12,260,"1,600.49",1974
,20161207,4092,4103,4095,4108,4088,4088,4095,-15,-8,30,184.28,1974
,20161208,4088,4095,4102,4205,4102,4171,4177,76,82,588,"3,684.39",2056
,20161209,4171,4177,4164,4181,4127,4155,4150,-22,-27,290,"1,805.31",2102
,20161212,4155,4150,4141,4179,4138,4151,4149,1,-1,198,"1,232.29",2170
,20161213,4151,4149,4151,4200,4142,4180,4176,31,27,486,"3,044.98",2128
,20161214,4180,4176,4206,4206,4160,4185,4178,9,2,472,"2,958.52",2218
,20161215,4185,4178,4173,4200,4134,4137,4158,-41,-20,198,"1,235.09",2240
,20161216,4137,4158,4046,4046,4013,4023,4023,-135,-135,318,"1,919.34",2156
,20161219,4023,4023,4025,4045,4022,4031,4029,8,6,176,"1,063.85",2138
,20161220,4031,4029,4018,4024,3925,3925,4006,-104,-23,268,"1,610.56",2114
,20161221,3925,4006,3888,3962,3863,3949,3908,-57,-98,152,891.16,2116
,20161222,3949,3908,3950,3956,3890,3900,3917,-8,9,126,740.32,2056
,20161223,3900,3917,3906,3940,3901,3917,3910,0,-7,94,551.41,2030
,20161226,3917,3910,3900,3909,3883,3899,3902,-11,-8,194,"1,135.50",1916
,20161227,3899,3902,3913,3966,3904,3959,3932,57,30,168,991.01,1928
,20161228,3959,3932,3972,3979,3958,3961,3968,29,36,178,"1,059.58",2002
,20161229,3961,3968,3955,4009,3951,3997,3996,29,28,314,"1,882.53",2144
,20161230,3997,3996,3998,4048,3984,4027,4029,31,33,106,640.62,2166
ag1703,20160316,3527,3527,3466,3533,3466,3533,3492,6,-35,8,41.91,6
,20160317,3533,3492,3496,3496,3496,3496,3496,4,4,2,10.49,6
,20160318,3496,3496,3647,3647,3641,3641,3644,145,148,4,21.86,8
,20160321,3641,3644,,,,3621,3621,-23,-23,0,0.00,8
,20160322,3621,3621,,,,3640,3640,19,19,0,0.00,8
,20160323,3640,3640,3609,3609,3609,3609,3609,-31,-31,2,10.83,10
,20160324,3609,3609,3577,3577,3547,3547,3561,-62,-48,22,117.53,18
,20160325,3547,3561,,,,3565,3565,4,4,0,0.00,18
,20160328,3565,3565,,,,3554,3554,-11,-11,0,0.00,18
,20160329,3554,3554,3571,3571,3530,3532,3544,-22,-10,6,31.90,20
,20160330,3532,3544,3560,3560,3528,3528,3544,-16,0,4,21.26,20
,20160331,3528,3544,,,,3538,3538,-6,-6,0,0.00,20
,20160401,3538,3538,,,,3558,3558,20,20,0,0.00,20
,20160405,3558,3558,,,,3516,3516,-42,-42,0,0.00,20
,20160406,3516,3516,3523,3526,3489,3489,3495,-27,-21,22,115.35,42
,20160407,3489,3495,,,,3495,3495,0,0,0,0.00,42
,20160408,3495,3495,3501,3501,3501,3501,3501,6,6,2,10.50,40
,20160411,3501,3501,3529,3536,3529,3536,3533,35,32,6,31.80,36
,20160412,3536,3533,3578,3578,3551,3551,3564,18,31,4,21.39,40
,20160413,3551,3564,3587,3606,3522,3594,3581,30,17,50,268.64,50
,20160414,3594,3581,3620,3631,3618,3619,3620,38,39,20,108.60,40
,20160415,3619,3620,3620,3620,3620,3620,3620,0,0,4,21.72,44
,20160418,3620,3620,3631,3634,3630,3630,3631,10,11,20,108.95,38
,20160419,3630,3631,3656,3700,3656,3700,3678,69,47,4,22.07,40
,20160420,3700,3678,3793,3894,3775,3775,3822,97,144,68,389.85,92
,20160421,3775,3822,3838,3968,3810,3968,3868,146,46,64,371.33,114
,20160422,3968,3868,3988,3988,3784,3839,3902,-29,34,18,105.38,114
,20160425,3839,3902,3800,3808,3775,3808,3787,-94,-115,56,318.19,112
,20160426,3808,3787,3810,3846,3810,3846,3833,59,46,22,126.49,110
,20160427,3846,3833,3849,3880,3838,3880,3861,47,28,10,57.92,108
,20160428,3880,3861,3870,3890,3870,3890,3877,29,16,42,244.26,128
,20160429,3890,3877,3895,3999,3895,3964,3945,87,68,22,130.21,128
,20160503,3964,3945,3955,3956,3955,3956,3955,11,10,10,59.34,136
,20160504,3956,3955,3958,3959,3907,3907,3952,-48,-3,18,106.72,138
,20160505,3907,3952,3903,3940,3883,3920,3912,-32,-40,88,516.42,164
,20160506,3920,3912,3920,3920,3850,3863,3879,-49,-33,28,162.95,160
,20160509,3863,3879,3870,3870,3860,3870,3865,-9,-14,24,139.15,142
,20160510,3870,3865,3826,3826,3785,3800,3807,-65,-58,62,354.09,122
,20160511,3800,3807,3799,3853,3798,3853,3826,46,19,24,137.76,120
,20160512,3853,3826,3878,3910,3857,3857,3875,31,49,166,964.88,148
,20160513,3857,3875,3840,3840,3800,3834,3811,-41,-64,68,388.80,168
,20160516,3834,3811,3819,3866,3815,3866,3833,55,22,30,172.50,158
,20160517,3866,3833,3865,3865,3865,3865,3865,32,32,2,11.60,156
,20160518,3865,3865,,,,3865,3865,0,0,0,0.00,156
,20160519,3865,3865,3850,3850,3765,3765,3800,-100,-65,38,216.65,184
,20160520,3765,3800,3718,3741,3708,3741,3722,-59,-78,18,100.52,178
,20160523,3741,3722,3723,3723,3687,3687,3712,-35,-10,20,111.38,172
,20160524,3687,3712,3703,3704,3685,3696,3695,-16,-17,14,77.60,176
,20160525,3696,3695,,,,3695,3695,0,0,0,0.00,176
,20160526,3695,3695,3689,3708,3689,3708,3698,13,3,4,22.19,176
,20160527,3708,3698,3692,3700,3661,3672,3681,-26,-17,16,88.34,180
,20160530,3672,3681,3685,3685,3611,3620,3629,-61,-52,16,87.11,186
,20160531,3620,3629,3622,3648,3622,3648,3635,19,6,4,21.81,188
,20160601,3648,3635,3637,3647,3637,3647,3645,12,10,12,65.61,182
,20160602,3647,3645,3640,3640,3640,3640,3640,-5,-5,4,21.84,178
,20160603,3640,3640,3683,3683,3683,3683,3683,43,43,2,11.05,176
,20160606,3683,3683,,,,3683,3683,0,0,0,0.00,176
,20160607,3683,3683,,,,3683,3683,0,0,0,0.00,176
,20160608,3683,3683,3710,3742,3710,3742,3731,59,48,6,33.58,178
,20160613,3742,3731,3846,3885,3844,3885,3862,154,131,88,509.81,172
,20160614,3885,3862,3896,3896,3880,3880,3890,18,28,8,46.68,166
,20160615,3880,3890,,,,3890,3890,0,0,0,0.00,166
,20160616,3890,3890,3915,3983,3913,3983,3940,93,50,38,224.63,164
,20160617,3983,3940,3877,3877,3877,3877,3877,-63,-63,2,11.63,162
,20160620,3877,3877,3882,3883,3882,3883,3882,6,5,8,46.59,154
,20160621,3883,3882,,,,3885,3885,3,3,0,0.00,154
,20160622,3885,3885,3875,3875,3863,3863,3869,-22,-16,4,23.21,150
,20160623,3863,3869,3865,3876,3865,3876,3867,7,-2,10,58.01,152
,20160624,3876,3867,3900,3900,3886,3886,3895,19,28,6,35.06,154
,20160627,3886,3895,3988,3988,3937,3937,3962,42,67,4,23.78,152
,20160628,3937,3962,,,,3962,3962,0,0,0,0.00,152
,20160629,3962,3962,,,,4064,4064,102,102,0,0.00,152
,20160630,4064,4064,4126,4126,4093,4095,4110,31,46,20,123.31,152
,20160701,4095,4110,4126,4245,4125,4245,4177,135,67,36,225.60,160
,20160704,4245,4177,4298,4427,4298,4427,4358,250,181,34,222.30,162
,20160705,4427,4358,4615,4615,4380,4427,4503,69,145,30,202.64,160
,20160706,4427,4503,4525,4525,4525,4525,4525,22,22,2,13.58,160
,20160707,4525,4525,4523,4525,4498,4498,4519,-27,-6,10,67.79,156
,20160708,4498,4519,4368,4400,4368,4400,4384,-119,-135,4,26.30,156
,20160711,4400,4384,4415,4591,4415,4591,4464,207,80,36,241.09,156
,20160712,4591,4464,,,,4464,4464,0,0,0,0.00,156
,20160713,4464,4464,4495,4578,4495,4564,4525,100,61,10,67.88,156
,20160714,4564,4525,4566,4581,4545,4545,4569,20,44,14,95.95,154
,20160715,4545,4569,4515,4515,4515,4515,4515,-54,-54,6,40.64,154
,20160718,4515,4515,4442,4458,4442,4458,4446,-57,-69,8,53.36,156
,20160719,4458,4446,4388,4456,4388,4456,4434,10,-12,28,186.24,138
,20160720,4456,4434,4439,4439,4439,4439,4439,5,5,2,13.32,138
,20160721,4439,4439,4311,4330,4311,4330,4320,-109,-119,8,51.85,130
,20160722,4330,4320,4317,4317,4317,4317,4317,-3,-3,2,12.95,130
,20160725,4317,4317,,,,4317,4317,0,0,0,0.00,130
,20160726,4317,4317,4317,4387,4317,4377,4368,60,51,38,249.02,136
,20160727,4377,4368,4381,4381,4363,4364,4371,-4,3,12,78.68,130
,20160728,4364,4371,4515,4515,4515,4515,4515,144,144,2,13.55,130
,20160729,4515,4515,4515,4515,4507,4507,4509,-8,-6,8,54.11,130
,20160801,4507,4509,4590,4590,4590,4590,4590,81,81,4,27.54,126
,20160802,4590,4590,,,,4590,4590,0,0,0,0.00,126
,20160803,4590,4590,4596,4605,4596,4605,4598,15,8,8,55.18,124
,20160804,4605,4598,4538,4538,4511,4511,4524,-87,-74,8,54.29,124
,20160805,4511,4524,4540,4540,4499,4525,4525,1,1,16,108.61,126
,20160808,4525,4525,4471,4471,4394,4394,4447,-131,-78,8,53.37,126
,20160809,4394,4447,4385,4385,4385,4385,4385,-62,-62,20,131.55,108
,20160810,4385,4385,4438,4494,4438,4454,4457,69,72,18,120.36,108
,20160811,4454,4457,,,,4457,4457,0,0,0,0.00,108
,20160812,4457,4457,4489,4489,4489,4489,4489,32,32,4,26.93,108
,20160815,4489,4489,4418,4426,4418,4426,4423,-63,-66,6,39.81,102
,20160816,4426,4423,,,,4423,4423,0,0,0,0.00,102
,20160817,4423,4423,,,,4423,4423,0,0,0,0.00,102
,20160818,4423,4423,4405,4438,4340,4438,4375,15,-48,50,328.20,118
,20160819,4438,4375,4401,4402,4391,4391,4398,16,23,6,39.58,116
,20160822,4391,4398,4363,4363,4363,4363,4363,-35,-35,4,26.18,116
,20160823,4363,4363,,,,4363,4363,0,0,0,0.00,116
,20160824,4363,4363,,,,4339,4339,-24,-24,0,0.00,116
,20160825,4339,4339,,,,4197,4197,-142,-142,0,0.00,116
,20160826,4197,4197,,,,4197,4197,0,0,0,0.00,116
,20160829,4197,4197,,,,4197,4197,0,0,0,0.00,116
,20160830,4197,4197,4197,4226,4197,4226,4211,29,14,4,25.27,118
,20160831,4226,4211,,,,4211,4211,0,0,0,0.00,118
,20160901,4211,4211,4269,4269,4200,4200,4234,-11,23,4,25.41,116
,20160902,4200,4234,4260,4266,4260,4266,4263,32,29,4,25.58,116
,20160905,4266,4263,4283,4365,4283,4362,4336,99,73,10,65.04,118
,20160906,4362,4336,4361,4365,4361,4365,4363,29,27,4,26.18,114
,20160907,4365,4363,4428,4464,4428,4464,4440,101,77,6,39.96,112
,20160908,4464,4440,,,,4440,4440,0,0,0,0.00,112
,20160909,4440,4440,4428,4428,4409,4409,4414,-31,-26,16,105.94,116
,20160912,4409,4414,,,,4239,4239,-175,-175,0,0.00,116
,20160913,4239,4239,4273,4337,4260,4331,4299,92,60,20,128.98,114
,20160914,4331,4299,4312,4312,4262,4262,4287,-37,-12,4,25.72,116
,20160919,4262,4287,4268,4268,4268,4268,4268,-19,-19,2,12.80,114
,20160920,4268,4268,4353,4353,4348,4348,4350,80,82,4,26.10,118
,20160921,4348,4350,4322,4380,4322,4380,4333,30,-17,10,65.00,112
,20160922,4380,4333,4422,4474,4422,4474,4448,141,115,4,26.69,112
,20160923,4474,4448,4456,4475,4456,4470,4467,22,19,6,40.20,106
,20160926,4470,4467,4468,4468,4468,4468,4468,1,1,2,13.40,108
,20160927,4468,4468,,,,4468,4468,0,0,0,0.00,108
,20160928,4468,4468,,,,4376,4376,-92,-92,0,0.00,108
,20160929,4376,4376,4271,4345,4271,4345,4308,-31,-68,4,25.85,110
,20160930,4345,4308,4315,4315,4315,4315,4315,7,7,2,12.95,110
,20161010,4315,4315,4004,4020,4004,4020,4007,-295,-308,12,72.14,108
,20161011,4020,4007,4045,4045,4045,4045,4045,38,38,4,24.27,112
,20161012,4045,4045,4023,4023,4023,4023,4023,-22,-22,8,48.28,112
,20161013,4023,4023,4016,4063,4016,4063,4032,40,9,8,48.39,116
,20161014,4063,4032,,,,4032,4032,0,0,0,0.00,116
,20161017,4032,4032,,,,4032,4032,0,0,0,0.00,116
,20161018,4032,4032,4043,4086,4030,4086,4045,54,13,24,145.64,128
,20161019,4086,4045,4172,4172,4052,4068,4096,23,51,108,663.58,120
,20161020,4068,4096,4090,4090,4090,4090,4090,-6,-6,10,61.35,120
,20161021,4090,4090,4058,4058,4058,4058,4058,-32,-32,2,12.17,118
,20161024,4058,4058,,,,4058,4058,0,0,0,0.00,118
,20161025,4058,4058,4101,4125,4096,4125,4098,67,40,36,221.31,138
,20161026,4125,4098,4117,4132,4117,4132,4124,34,26,12,74.24,140
,20161027,4132,4124,,,,4124,4124,0,0,0,0.00,140
,20161028,4124,4124,,,,4124,4124,0,0,0,0.00,140
,20161031,4124,4124,4134,4134,4134,4134,4134,10,10,6,37.21,140
,20161101,4134,4134,4141,4156,4137,4156,4145,22,11,40,248.72,160
,20161102,4156,4145,4200,4228,4200,4228,4212,83,67,42,265.37,182
,20161103,4228,4212,4259,4259,4232,4232,4250,20,38,6,38.25,176
,20161104,4232,4250,4165,4165,4165,4165,4165,-85,-85,4,24.99,176
,20161107,4165,4165,,,,4165,4165,0,0,0,0.00,176
,20161108,4165,4165,4177,4182,4177,4180,4179,15,14,8,50.15,172
,20161109,4180,4179,4188,4353,4177,4338,4239,159,60,268,"1,704.14",320
,20161110,4338,4239,4317,4338,4296,4332,4323,93,84,130,843.05,354
,20161111,4332,4323,4360,4376,4266,4354,4314,31,-9,376,"2,433.34",358
,20161114,4354,4314,4404,4404,4078,4091,4110,-223,-204,88,542.60,338
,20161115,4091,4110,4100,4104,4066,4066,4086,-44,-24,34,208.41,336
,20161116,4066,4086,4100,4106,4100,4106,4103,20,17,4,24.62,338
,20161117,4106,4103,4099,4099,4084,4084,4095,-19,-8,12,73.72,342
,20161118,4084,4095,4050,4050,4050,4050,4050,-45,-45,2,12.15,342
,20161121,4050,4050,4044,4060,4044,4060,4057,10,7,16,97.39,354
,20161122,4060,4057,4078,4106,4072,4101,4094,44,37,32,196.52,356
,20161123,4101,4094,4103,4138,4095,4097,4104,3,10,28,172.38,352
,20161124,4097,4104,4094,4095,4050,4078,4076,-26,-28,154,941.56,442
,20161125,4078,4076,4070,4099,4070,4072,4081,-4,5,58,355.08,486
,20161128,4072,4081,4089,4200,4089,4170,4164,89,83,30,187.42,502
,20161129,4170,4164,4169,4169,4080,4145,4137,-19,-27,44,273.09,492
,20161130,4145,4137,4097,4137,4095,4126,4102,-11,-35,92,566.09,424
,20161201,4126,4102,4105,4105,4055,4055,4068,-47,-34,18,109.85,406
,20161202,4055,4068,4074,4107,4074,4100,4083,32,15,14,85.76,406
,20161205,4100,4083,4122,4122,4122,4122,4122,39,39,2,12.37,406
,20161206,4122,4122,4121,4140,4107,4140,4119,18,-3,142,877.55,402
,20161207,4140,4119,4128,4128,4128,4128,4128,9,9,2,12.38,400
,20161208,4128,4128,4132,4206,4132,4199,4186,71,58,28,175.81,404
,20161209,4199,4186,4183,4197,4164,4169,4174,-17,-12,58,363.21,408
,20161212,4169,4174,4199,4199,4175,4175,4191,1,17,6,37.72,404
,20161213,4175,4191,4177,4215,4177,4204,4188,13,-3,12,75.40,408
,20161214,4204,4188,4235,4237,4186,4192,4192,4,4,84,528.28,398
,20161215,4192,4192,4204,4228,4151,4165,4190,-27,-2,148,930.23,402
,20161216,4165,4190,4046,4053,4045,4050,4046,-140,-144,38,230.64,390
,20161219,4050,4046,4050,4092,4050,4061,4068,15,22,32,195.28,388
,20161220,4061,4068,4045,4046,3999,3999,4025,-69,-43,20,120.76,390
,20161221,3999,4025,3971,3971,3971,3971,3971,-54,-54,2,11.91,388
,20161222,3971,3971,,,,3930,3930,-41,-41,0,0.00,388
,20161223,3930,3930,3928,3939,3918,3939,3930,9,0,48,283.00,410
,20161226,3939,3930,3949,3953,3902,3907,3925,-23,-5,52,306.18,404
,20161227,3907,3925,3928,3979,3928,3979,3943,54,18,18,106.48,410
,20161228,3979,3943,3982,4002,3977,4002,3988,59,45,16,95.73,408
,20161229,4002,3988,3978,4055,3978,4033,4027,45,39,172,"1,039.14",562
,20161230,4033,4027,4013,4060,4013,4041,4032,14,5,48,290.30,550
ag1704,20160418,3620,3620,,,,3620,3620,0,0,0,0.00,0
,20160419,3620,3620,,,,3632,3632,12,12,0,0.00,0
,20160420,3632,3632,3892,3892,3833,3833,3863,201,231,8,46.36,8
,20160421,3833,3863,4008,4008,3976,3976,3992,113,129,4,23.95,12
,20160422,3976,3992,3843,3848,3843,3848,3845,-144,-147,4,23.07,14
,20160425,3848,3845,3811,3837,3811,3825,3824,-20,-21,12,68.84,18
,20160426,3825,3824,3846,3846,3838,3838,3842,14,18,4,23.05,18
,20160427,3838,3842,3848,3848,3848,3848,3848,6,6,6,34.63,14
,20160428,3848,3848,3881,3899,3872,3888,3883,40,35,12,69.91,22
,20160429,3888,3883,3999,3999,3999,3999,3999,116,116,2,12.00,22
,20160503,3999,3999,3978,3978,3978,3978,3978,-21,-21,2,11.93,22
,20160504,3978,3978,3909,3909,3909,3909,3909,-69,-69,2,11.73,24
,20160505,3909,3909,,,,3909,3909,0,0,0,0.00,24
,20160506,3909,3909,3906,3906,3906,3906,3906,-3,-3,2,11.72,24
,20160509,3906,3906,3915,3915,3908,3908,3911,2,5,4,23.47,26
,20160510,3908,3911,3845,3850,3777,3832,3823,-79,-88,32,183.54,44
,20160511,3832,3823,3859,3903,3859,3899,3879,76,56,12,69.83,42
,20160512,3899,3879,,,,3879,3879,0,0,0,0.00,42
,20160513,3879,3879,3832,3856,3832,3856,3844,-23,-35,6,34.60,40
,20160516,3856,3844,3889,3889,3889,3889,3889,45,45,2,11.67,40
,20160517,3889,3889,3917,3917,3917,3917,3917,28,28,2,11.75,40
,20160518,3917,3917,3887,3888,3865,3871,3879,-46,-38,10,58.19,46
,20160519,3871,3879,3870,3870,3821,3821,3840,-58,-39,8,46.09,52
,20160520,3821,3840,3751,3754,3733,3740,3747,-100,-93,24,134.91,60
,20160523,3740,3747,3748,3754,3704,3704,3740,-43,-7,20,112.22,66
,20160524,3704,3740,3711,3711,3681,3681,3693,-59,-47,6,33.24,68
,20160525,3681,3693,3690,3690,3690,3690,3690,-3,-3,2,11.07,68
,20160526,3690,3690,3740,3740,3740,3740,3740,50,50,10,56.10,78
,20160527,3740,3740,3744,3744,3735,3735,3738,-5,-2,6,33.64,80
,20160530,3735,3738,3679,3711,3628,3628,3675,-110,-63,24,132.31,84
,20160531,3628,3675,,,,3675,3675,0,0,0,0.00,84
,20160601,3675,3675,,,,3675,3675,0,0,0,0.00,84
,20160602,3675,3675,3664,3664,3664,3664,3664,-11,-11,10,54.96,94
,20160603,3664,3664,3657,3657,3657,3657,3657,-7,-7,4,21.94,90
,20160606,3657,3657,,,,3657,3657,0,0,0,0.00,90
,20160607,3657,3657,3720,3743,3720,3743,3731,86,74,4,22.39,88
,20160608,3743,3731,,,,3731,3731,0,0,0,0.00,88
,20160613,3731,3731,3895,3895,3895,3895,3895,164,164,2,11.69,90
,20160614,3895,3895,3919,3919,3906,3906,3908,11,13,10,58.63,86
,20160615,3906,3908,3913,3913,3913,3913,3913,5,5,4,23.48,82
,20160616,3913,3913,3939,3939,3939,3939,3939,26,26,2,11.82,82
,20160617,3939,3939,4008,4008,3962,3966,3983,27,44,18,107.55,82
,20160620,3966,3983,3927,3927,3916,3916,3917,-67,-66,14,82.27,90
,20160621,3916,3917,3925,3939,3911,3911,3927,-6,10,10,58.91,90
,20160622,3911,3927,3898,3898,3880,3880,3892,-47,-35,6,35.03,88
,20160623,3880,3892,3883,3883,3883,3883,3883,-9,-9,2,11.65,86
,20160624,3883,3883,,,,3883,3883,0,0,0,0.00,86
,20160627,3883,3883,3932,3979,3932,3979,3950,96,67,16,94.82,80
,20160628,3979,3950,3963,3963,3963,3963,3963,13,13,4,23.78,76
,20160629,3963,3963,,,,3963,3963,0,0,0,0.00,76
,20160630,3963,3963,4121,4121,4121,4121,4121,158,158,2,12.36,76
,20160701,4121,4121,4300,4300,4300,4300,4300,179,179,2,12.90,78
,20160704,4300,4300,4287,4558,4287,4558,4544,258,244,236,"1,608.60",190
,20160705,4558,4544,4745,4745,4341,4489,4563,-55,19,222,"1,519.49",136
,20160706,4489,4563,4465,4599,4421,4569,4533,6,-30,46,312.80,132
,20160707,4569,4533,4532,4552,4496,4496,4526,-37,-7,28,190.13,120
,20160708,4496,4526,4440,4440,4394,4410,4399,-116,-127,1112,"7,339.19",1158
,20160711,4410,4399,4440,4609,4440,4609,4471,210,72,24,160.99,1160
,20160712,4609,4471,4531,4531,4529,4529,4529,58,58,8,54.35,1164
,20160713,4529,4529,,,,4529,4529,0,0,0,0.00,1164
,20160714,4529,4529,4590,4590,4570,4570,4580,41,51,10,68.71,1174
,20160715,4570,4580,4508,4530,4508,4522,4519,-58,-61,16,108.46,1184
,20160718,4522,4519,4541,4541,4541,4541,4541,22,22,2,13.62,1184
,20160719,4541,4541,4458,4465,4448,4453,4456,-88,-85,14,93.59,1184
,20160720,4453,4456,4440,4448,4438,4438,4441,-18,-15,8,53.30,1180
,20160721,4438,4441,4328,4338,4316,4325,4327,-116,-114,14,90.87,1186
,20160722,4325,4327,4440,4440,4393,4406,4431,79,104,26,172.84,1204
,20160725,4406,4431,,,,4431,4431,0,0,0,0.00,1204
,20160726,4431,4431,4350,4403,4350,4403,4369,-28,-62,8,52.43,1202
,20160727,4403,4369,4404,4404,4404,4404,4404,35,35,2,13.21,1200
,20160728,4404,4404,4479,4519,4479,4519,4489,115,85,10,67.34,1198
,20160729,4519,4489,4535,4535,4535,4535,4535,46,46,2,13.61,1200
,20160801,4535,4535,4610,4610,4602,4602,4607,67,72,6,41.47,1194
,20160802,4602,4607,,,,4607,4607,0,0,0,0.00,1194
,20160803,4607,4607,4650,4650,4640,4640,4648,33,41,12,83.67,1182
,20160804,4640,4648,,,,4573,4573,-75,-75,0,0.00,1182
,20160805,4573,4573,4551,4551,4548,4548,4548,-25,-25,16,109.17,1194
,20160808,4548,4548,4456,4456,4405,4420,4431,-128,-117,12,79.77,1186
,20160809,4420,4431,4379,4445,4379,4409,4416,-22,-15,32,212.00,1178
,20160810,4409,4416,4400,4530,4400,4530,4464,114,48,22,147.32,1180
,20160811,4530,4464,4528,4528,4473,4511,4504,47,40,6,40.54,1180
,20160812,4511,4504,4501,4505,4477,4477,4499,-27,-5,12,80.99,1178
,20160815,4477,4499,,,,4499,4499,0,0,0,0.00,1178
,20160816,4499,4499,4435,4435,4435,4435,4435,-64,-64,4,26.61,1178
,20160817,4435,4435,4442,4442,4442,4442,4442,7,7,2,13.33,1180
,20160818,4442,4442,,,,4442,4442,0,0,0,0.00,1180
,20160819,4442,4442,4444,4444,4408,4423,4418,-19,-24,174,"1,153.30",1244
,20160822,4423,4418,4374,4384,4284,4284,4367,-134,-51,188,"1,231.65",1138
,20160823,4284,4367,4271,4298,4271,4298,4277,-69,-90,8,51.33,1132
,20160824,4298,4277,4296,4306,4277,4279,4290,2,13,34,218.83,1110
,20160825,4279,4290,4218,4218,4202,4202,4208,-88,-82,10,63.13,1108
,20160826,4202,4208,4220,4220,4220,4220,4220,12,12,2,12.66,1110
,20160829,4220,4220,,,,4220,4220,0,0,0,0.00,1110
,20160830,4220,4220,,,,4220,4220,0,0,0,0.00,1110
,20160831,4220,4220,4236,4240,4230,4240,4236,20,16,18,114.38,1100
,20160901,4240,4236,4223,4241,4223,4231,4229,-5,-7,14,88.82,1086
,20160902,4231,4229,4236,4306,4230,4306,4242,77,13,38,241.84,1066
,20160905,4306,4242,4341,4359,4341,4355,4351,113,109,18,117.50,1062
,20160906,4355,4351,4388,4391,4386,4391,4388,40,37,36,236.99,1042
,20160907,4391,4388,4444,4497,4444,4497,4479,109,91,6,40.31,1038
,20160908,4497,4479,,,,4479,4479,0,0,0,0.00,1038
,20160909,4479,4479,4431,4435,4431,4434,4433,-45,-46,16,106.41,1028
,20160912,4434,4433,4406,4406,4393,4393,4397,-40,-36,38,250.64,990
,20160913,4393,4397,4352,4352,4352,4352,4352,-45,-45,4,26.11,990
,20160914,4352,4352,,,,4352,4352,0,0,0,0.00,990
,20160919,4352,4352,,,,4332,4332,-20,-20,0,0.00,990
,20160920,4332,4332,4368,4368,4368,4368,4368,36,36,12,78.62,986
,20160921,4368,4368,4345,4345,4345,4345,4345,-23,-23,26,169.46,968
,20160922,4345,4345,4470,4470,4470,4470,4470,125,125,2,13.41,968
,20160923,4470,4470,4499,4499,4484,4492,4493,22,23,26,175.23,962
,20160926,4492,4493,4447,4447,4447,4447,4447,-46,-46,6,40.02,958
,20160927,4447,4447,,,,4447,4447,0,0,0,0.00,958
,20160928,4447,4447,4352,4352,4327,4327,4339,-120,-108,8,52.07,954
,20160929,4327,4339,4328,4372,4297,4332,4322,-7,-17,28,181.55,958
,20160930,4332,4322,4332,4332,4332,4332,4332,10,10,4,25.99,958
,20161010,4332,4332,4060,4060,4030,4045,4052,-287,-280,32,194.54,946
,20161011,4045,4052,4050,4053,4047,4053,4051,1,-1,26,158.02,946
,20161012,4053,4051,,,,4051,4051,0,0,0,0.00,946
,20161013,4051,4051,4066,4066,4066,4066,4066,15,15,2,12.20,948
,20161014,4066,4066,,,,4058,4058,-8,-8,0,0.00,948
,20161017,4058,4058,4058,4058,4046,4055,4054,-3,-4,10,60.82,948
,20161018,4055,4054,4047,4095,4046,4095,4061,41,7,10,60.92,946
,20161019,4095,4061,,,,4061,4061,0,0,0,0.00,946
,20161020,4061,4061,4113,4113,4110,4110,4112,49,51,22,135.72,966
,20161021,4110,4112,4111,4111,4111,4111,4111,-1,-1,2,12.33,966
,20161024,4111,4111,4064,4064,4064,4064,4064,-47,-47,2,12.19,966
,20161025,4064,4064,4130,4130,4122,4122,4126,58,62,4,24.76,966
,20161026,4122,4126,4145,4145,4145,4145,4145,19,19,2,12.44,966
,20161027,4145,4145,4116,4116,4116,4116,4116,-29,-29,2,12.35,966
,20161028,4116,4116,4136,4138,4136,4138,4137,22,21,10,62.06,958
,20161031,4138,4137,4137,4153,4137,4151,4147,14,10,12,74.65,960
,20161101,4151,4147,4145,4173,4145,4173,4168,26,21,24,150.07,974
,20161102,4173,4168,4242,4242,4242,4242,4242,74,74,2,12.73,976
,20161103,4242,4242,4271,4310,4271,4286,4283,44,41,12,77.11,974
,20161104,4286,4283,4212,4212,4208,4208,4209,-75,-74,14,88.40,980
,20161107,4208,4209,4216,4216,4191,4191,4199,-18,-10,6,37.79,978
,20161108,4191,4199,4191,4212,4177,4212,4200,13,1,208,"1,310.41",972
,20161109,4212,4200,4214,4360,4214,4345,4296,145,96,166,"1,069.93",1008
,20161110,4345,4296,4345,4356,4334,4346,4345,50,49,46,299.87,970
,20161111,4346,4345,4379,4379,4340,4369,4356,24,11,154,"1,006.38",974
,20161114,4369,4356,4411,4411,4096,4110,4182,-246,-174,54,338.78,956
,20161115,4110,4182,4117,4117,4065,4112,4100,-70,-82,20,123.02,952
,20161116,4112,4100,4097,4135,4097,4114,4115,14,15,6,37.04,948
,20161117,4114,4115,4111,4111,4110,4110,4110,-5,-5,12,73.99,948
,20161118,4110,4110,,,,4110,4110,0,0,0,0.00,948
,20161121,4110,4110,,,,4110,4110,0,0,0,0.00,948
,20161122,4110,4110,4091,4119,4090,4119,4097,9,-13,32,196.68,956
,20161123,4119,4097,,,,4097,4097,0,0,0,0.00,956
,20161124,4097,4097,,,,4097,4097,0,0,0,0.00,956
,20161125,4097,4097,4086,4098,4086,4098,4088,1,-9,10,61.33,962
,20161128,4098,4088,4101,4144,4101,4144,4111,56,23,8,49.34,956
,20161129,4144,4111,,,,4111,4111,0,0,0,0.00,956
,20161130,4111,4111,4123,4148,4119,4148,4137,37,26,10,62.06,960
,20161201,4148,4137,4132,4132,4120,4120,4129,-17,-8,8,49.55,968
,20161202,4120,4129,4103,4109,4100,4109,4102,-20,-27,14,86.16,970
,20161205,4109,4102,4090,4178,4090,4137,4137,35,35,32,198.62,966
,20161206,4137,4137,4131,4161,4131,4161,4138,24,1,26,161.40,946
,20161207,4161,4138,,,,4138,4138,0,0,0,0.00,946
,20161208,4138,4138,4204,4230,4204,4228,4223,90,85,26,164.73,934
,20161209,4228,4223,4200,4203,4190,4203,4198,-20,-25,12,75.57,932
,20161212,4203,4198,4220,4220,4189,4189,4210,-9,12,22,138.93,926
,20161213,4189,4210,4198,4234,4198,4234,4217,24,7,36,227.73,890
,20161214,4234,4217,4218,4243,4218,4243,4223,26,6,10,63.35,884
,20161215,4243,4223,4200,4208,4164,4208,4193,-15,-30,8,50.32,884
,20161216,4208,4193,4081,4084,4079,4082,4081,-111,-112,10,61.22,884
,20161219,4082,4081,,,,4081,4081,0,0,0,0.00,884
,20161220,4081,4081,4064,4064,4039,4039,4051,-42,-30,4,24.31,888
,20161221,4039,4051,4018,4018,4018,4018,4018,-33,-33,2,12.05,888
,20161222,4018,4018,3955,3955,3951,3952,3952,-66,-66,22,130.42,876
,20161223,3952,3952,3940,3966,3940,3958,3954,6,2,70,415.25,896
,20161226,3958,3954,3936,3936,3936,3936,3936,-18,-18,2,11.81,898
,20161227,3936,3936,3961,3992,3958,3992,3979,56,43,30,179.07,872
,20161228,3992,3979,4026,4031,4013,4015,4023,36,44,22,132.78,876
,20161229,4015,4023,4002,4060,4000,4060,4037,37,14,88,532.91,832
,20161230,4060,4037,4039,4080,4036,4073,4067,36,30,110,671.21,790
ag1705,20160517,3889,3889,3887,3918,3841,3917,3882,28,-7,48,279.57,28
,20160518,3917,3882,3904,3904,3855,3863,3874,-19,-8,6,34.87,30
,20160519,3863,3874,3816,3816,3776,3776,3796,-98,-78,4,22.78,34
,20160520,3776,3796,3753,3760,3716,3750,3747,-46,-49,30,168.63,38
,20160523,3750,3747,3760,3770,3734,3734,3749,-13,2,18,101.24,46
,20160524,3734,3749,3708,3743,3698,3698,3718,-51,-31,36,200.80,50
,20160525,3698,3718,3710,3710,3696,3704,3705,-14,-13,12,66.69,58
,20160526,3704,3705,3715,3742,3710,3742,3725,37,20,8,44.70,64
,20160527,3742,3725,3716,3762,3694,3708,3713,-17,-12,28,155.98,70
,20160530,3708,3713,3704,3709,3635,3642,3668,-71,-45,16,88.04,78
,20160531,3642,3668,3682,3684,3673,3683,3682,15,14,54,298.31,126
,20160601,3683,3682,3675,3690,3660,3677,3675,-5,-7,54,297.71,126
,20160602,3677,3675,3675,3680,3663,3675,3670,0,-5,34,187.21,126
,20160603,3675,3670,3680,3691,3668,3689,3684,19,14,80,442.12,186
,20160606,3689,3684,3746,3754,3710,3750,3740,66,56,110,617.13,150
,20160607,3750,3740,3760,3760,3756,3756,3757,16,17,18,101.46,150
,20160608,3756,3757,3758,3793,3758,3793,3779,36,22,16,90.71,138
,20160613,3793,3779,3888,3920,3854,3919,3893,140,114,38,221.93,134
,20160614,3919,3893,3919,3940,3913,3919,3927,26,34,60,353.48,150
,20160615,3919,3927,3931,3939,3931,3939,3935,12,8,4,23.61,150
,20160616,3939,3935,3946,4029,3932,4010,3986,75,51,68,406.64,148
,20160617,4010,3986,4188,4188,3904,3917,3963,-69,-23,132,784.73,176
,20160620,3917,3963,3939,3939,3894,3930,3909,-33,-54,42,246.30,156
,20160621,3930,3909,3930,3965,3930,3955,3951,46,42,20,118.56,158
,20160622,3955,3951,3904,3911,3870,3870,3899,-81,-52,66,386.09,154
,20160623,3870,3899,3898,3900,3898,3900,3898,1,-1,6,35.09,154
,20160624,3900,3898,3872,4000,3872,3990,3954,92,56,66,391.47,140
,20160627,3990,3954,4023,4023,3981,4001,4005,47,51,70,420.59,128
,20160628,4001,4005,3981,3981,3975,3975,3978,-30,-27,4,23.87,128
,20160629,3975,3978,3998,4159,3998,4159,4075,181,97,16,97.82,126
,20160630,4159,4075,4117,4155,4117,4119,4130,44,55,6,37.17,128
,20160701,4119,4130,,,,4130,4130,0,0,0,0.00,128
,20160704,4130,4130,4377,4377,4377,4377,4377,247,247,8,52.52,130
,20160705,4377,4377,4658,4658,4410,4462,4545,85,168,80,545.43,130
,20160706,4462,4545,4489,4631,4442,4631,4518,86,-27,14,94.88,128
,20160707,4631,4518,4532,4577,4531,4540,4556,22,38,34,232.40,124
,20160708,4540,4556,4480,4480,4392,4466,4460,-90,-96,16,107.05,126
,20160711,4466,4460,4472,4599,4453,4582,4576,122,116,46,315.76,122
,20160712,4582,4576,4587,4609,4587,4598,4600,22,24,10,69.00,126
,20160713,4598,4600,4540,4573,4489,4573,4517,-27,-83,10,67.76,128
,20160714,4573,4517,4604,4604,4604,4604,4604,87,87,2,13.81,130
,20160715,4604,4604,4539,4539,4474,4538,4512,-66,-92,10,67.69,132
,20160718,4538,4512,,,,4512,4512,0,0,0,0.00,132
,20160719,4512,4512,4483,4502,4458,4458,4483,-54,-29,12,80.70,128
,20160720,4458,4483,4460,4469,4460,4465,4463,-18,-20,8,53.56,124
,20160721,4465,4463,4333,4384,4333,4349,4338,-114,-125,106,689.86,108
,20160722,4349,4338,4349,4514,4349,4466,4486,128,148,32,215.37,100
,20160725,4466,4486,,,,4486,4486,0,0,0,0.00,100
,20160726,4486,4486,4358,4358,4358,4358,4358,-128,-128,2,13.07,100
,20160727,4358,4358,4425,4447,4404,4404,4421,46,63,10,66.32,100
,20160728,4404,4421,4503,4562,4503,4562,4532,141,111,4,27.20,98
,20160729,4562,4532,,,,4532,4532,0,0,0,0.00,98
,20160801,4532,4532,4537,4630,4537,4630,4566,98,34,12,82.19,90
,20160802,4630,4566,4583,4583,4583,4583,4583,17,17,2,13.75,90
,20160803,4583,4583,4583,4677,4583,4677,4653,94,70,14,97.72,98
,20160804,4677,4653,4599,4599,4550,4550,4562,-103,-91,8,54.75,106
,20160805,4550,4562,,,,4562,4562,0,0,0,0.00,106
,20160808,4562,4562,4486,4486,4486,4486,4486,-76,-76,16,107.66,90
,20160809,4486,4486,4430,4430,4430,4430,4430,-56,-56,2,13.29,90
,20160810,4430,4430,4447,4535,4447,4535,4491,105,61,4,26.95,86
,20160811,4535,4491,4506,4506,4506,4506,4506,15,15,4,27.04,82
,20160812,4506,4506,,,,4506,4506,0,0,0,0.00,82
,20160815,4506,4506,4456,4460,4416,4460,4444,-46,-62,6,40.00,88
,20160816,4460,4444,4450,4462,4449,4462,4453,18,9,6,40.08,86
,20160817,4462,4453,,,,4453,4453,0,0,0,0.00,86
,20160818,4453,4453,,,,4453,4453,0,0,0,0.00,86
,20160819,4453,4453,4459,4459,4433,4450,4447,-3,-6,16,106.75,86
,20160822,4450,4447,4394,4406,4298,4298,4387,-149,-60,26,171.13,102
,20160823,4298,4387,4308,4315,4308,4315,4311,-72,-76,4,25.87,102
,20160824,4315,4311,4312,4545,4294,4303,4349,-8,38,42,274.03,114
,20160825,4303,4349,4333,4333,4219,4226,4242,-123,-107,22,140.00,114
,20160826,4226,4242,4216,4224,4216,4224,4220,-18,-22,4,25.32,112
,20160829,4224,4220,4211,4286,4211,4216,4232,-4,12,12,76.18,108
,20160830,4216,4232,4243,4243,4243,4243,4243,11,11,2,12.73,108
,20160831,4243,4243,4250,4255,4232,4249,4246,6,3,12,76.44,100
,20160901,4249,4246,4245,4259,4243,4249,4249,3,3,16,102.00,98
,20160902,4249,4249,4302,4302,4302,4302,4302,53,53,2,12.91,98
,20160905,4302,4302,4353,4395,4343,4395,4366,93,64,12,78.60,92
,20160906,4395,4366,4404,4422,4404,4422,4410,56,44,6,39.69,86
,20160907,4422,4410,4539,4539,4505,4505,4516,95,106,12,81.29,86
,20160908,4505,4516,4464,4479,4464,4479,4471,-37,-45,4,26.83,90
,20160909,4479,4471,4458,4458,4457,4457,4457,-14,-14,4,26.75,88
,20160912,4457,4457,4424,4424,4308,4308,4366,-149,-91,12,78.59,98
,20160913,4308,4366,4299,4299,4299,4299,4299,-67,-67,2,12.90,96
,20160914,4299,4299,4336,4342,4336,4342,4338,43,39,6,39.04,90
,20160919,4342,4338,,,,4318,4318,-20,-20,0,0.00,90
,20160920,4318,4318,4371,4371,4371,4371,4371,53,53,2,13.11,90
,20160921,4371,4371,4363,4389,4363,4389,4375,18,4,24,157.51,84
,20160922,4389,4375,4474,4474,4455,4455,4464,80,89,38,254.45,86
,20160923,4455,4464,4497,4512,4471,4471,4502,7,38,30,202.61,70
,20160926,4471,4502,4422,4422,4412,4412,4417,-90,-85,4,26.50,74
,20160927,4412,4417,4409,4416,4384,4398,4402,-19,-15,12,79.24,72
,20160928,4398,4402,4382,4382,4342,4342,4355,-60,-47,30,196.00,84
,20160929,4342,4355,4345,4345,4322,4331,4330,-24,-25,8,51.96,88
,20160930,4331,4330,4351,4368,4351,4368,4359,38,29,6,39.24,86
,20161010,4368,4359,4066,4073,4032,4070,4059,-289,-300,24,146.16,92
,20161011,4070,4059,4075,4112,4062,4100,4077,41,18,54,330.26,132
,20161012,4100,4077,4061,4083,4058,4069,4068,-8,-9,40,244.13,146
,20161013,4069,4068,4061,4061,4061,4061,4061,-7,-7,2,12.18,146
,20161014,4061,4061,4069,4072,4058,4058,4065,-3,4,40,243.91,168
,20161017,4058,4065,4067,4072,4052,4068,4065,3,0,14,85.38,174
,20161018,4068,4065,4065,4107,4058,4104,4073,39,8,52,317.77,188
,20161019,4104,4073,4145,4145,4094,4094,4105,21,32,36,221.68,188
,20161020,4094,4105,4133,4133,4133,4133,4133,28,28,2,12.40,188
,20161021,4133,4133,4066,4125,4066,4068,4092,-65,-41,68,417.44,180
,20161024,4068,4092,,,,4092,4092,0,0,0,0.00,180
,20161025,4092,4092,,,,4092,4092,0,0,0,0.00,180
,20161026,4092,4092,4191,4191,4085,4160,4144,68,52,142,882.75,174
,20161027,4160,4144,,,,4144,4144,0,0,0,0.00,174
,20161028,4144,4144,4150,4150,4145,4145,4148,1,4,26,161.79,168
,20161031,4145,4148,4154,4182,4142,4176,4165,28,17,86,537.30,210
,20161101,4176,4165,4162,4191,4162,4191,4176,26,11,14,87.71,212
,20161102,4191,4176,4240,4276,4236,4276,4256,100,80,34,217.07,202
,20161103,4276,4256,4294,4309,4262,4266,4277,10,21,216,"1,385.86",248
,20161104,4266,4277,4212,4248,4202,4203,4211,-74,-66,90,568.60,230
,20161107,4203,4211,4236,4236,4196,4207,4212,-4,1,44,278.01,226
,20161108,4207,4212,4199,4232,4194,4232,4209,20,-3,52,328.35,220
,20161109,4232,4209,4227,4408,4222,4353,4305,144,96,232,"1,498.22",254
,20161110,4353,4305,4298,4370,4293,4369,4348,64,43,124,808.79,264
,20161111,4369,4348,4376,4431,4323,4396,4379,48,31,160,"1,051.02",282
,20161114,4396,4379,4440,4448,4116,4116,4259,-263,-120,448,"2,862.14",250
,20161115,4116,4259,4110,4135,4076,4107,4106,-152,-153,86,529.79,236
,20161116,4107,4106,4098,4141,4093,4138,4118,32,12,294,"1,816.37",326
,20161117,4138,4118,4133,4140,4117,4117,4128,-1,10,52,321.99,318
,20161118,4117,4128,4118,4133,4066,4087,4091,-41,-37,380,"2,331.92",530
,20161121,4087,4091,4088,4110,4062,4110,4086,19,-5,282,"1,728.64",374
,20161122,4110,4086,4119,4171,4098,4141,4130,55,44,226,"1,400.15",444
,20161123,4141,4130,4144,4159,4131,4148,4140,18,10,120,745.36,448
,20161124,4148,4140,4134,4146,4069,4106,4096,-34,-44,232,"1,425.65",386
,20161125,4106,4096,4109,4131,4073,4087,4104,-9,8,92,566.41,382
,20161128,4087,4104,4117,4212,4116,4200,4189,96,85,416,"2,613.99",536
,20161129,4200,4189,4188,4195,4159,4171,4175,-18,-14,390,"2,442.46",548
,20161130,4171,4175,4150,4173,4131,4142,4153,-33,-22,422,"2,629.11",692
,20161201,4142,4153,4153,4162,4090,4142,4132,-11,-21,576,"3,570.05",708
,20161202,4142,4132,4118,4155,4102,4128,4130,-4,-2,200,"1,239.18",772
,20161205,4128,4130,4119,4205,4110,4159,4153,29,23,598,"3,725.99",688
,20161206,4159,4153,4155,4187,4145,4154,4163,1,10,176,"1,099.22",692
,20161207,4154,4163,4169,4181,4154,4154,4163,-9,0,112,699.54,682
,20161208,4154,4163,4170,4275,4167,4247,4228,84,65,432,"2,740.15",658
,20161209,4247,4228,4228,4247,4185,4221,4224,-7,-4,272,"1,723.75",626
,20161212,4221,4224,4226,4250,4212,4224,4227,0,3,150,951.26,668
,20161213,4224,4227,4235,4288,4217,4261,4259,34,32,284,"1,814.67",728
,20161214,4261,4259,4258,4282,4213,4259,4240,0,-19,228,"1,450.38",748
,20161215,4259,4240,4248,4288,4193,4207,4244,-33,4,2700,"17,191.65",878
,20161216,4207,4244,4119,4123,4082,4099,4099,-145,-145,552,"3,394.10",788
,20161219,4099,4099,4095,4114,4089,4102,4105,3,6,158,973.10,816
,20161220,4102,4105,4088,4092,3983,3992,4053,-113,-52,652,"3,964.34",810
,20161221,3992,4053,3960,4046,3935,4024,3963,-29,-90,1024,"6,087.60",824
,20161222,4024,3963,4030,4030,3960,3971,3997,8,34,334,"2,002.65",794
,20161223,3971,3997,3967,4016,3952,3987,3987,-10,-10,96,574.16,788
,20161226,3987,3987,3987,3998,3939,3956,3970,-31,-17,114,679.02,792
,20161227,3956,3970,3968,4025,3960,4025,4001,55,31,76,456.12,786
,20161228,4025,4001,4054,4054,4004,4024,4025,23,24,188,"1,135.16",746
,20161229,4024,4025,4021,4080,4016,4073,4056,48,31,312,"1,898.23",734
,20161230,4073,4056,4073,4115,4057,4090,4089,34,33,470,"2,883.12",760
ag1706,20160616,3935,3935,3980,4028,3879,4014,3992,79,57,224,"1,341.40",102
,20160617,4014,3992,4012,4012,3911,3925,3959,-67,-33,396,"2,352.06",266
,20160620,3925,3959,3948,3961,3920,3940,3938,-19,-21,284,"1,677.59",292
,20160621,3940,3938,3936,3976,3936,3943,3957,5,19,256,"1,519.63",330
,20160622,3943,3957,3917,3923,3882,3904,3908,-53,-49,262,"1,536.07",376
,20160623,3904,3908,3908,3925,3893,3907,3912,-1,4,240,"1,408.42",446
,20160624,3907,3912,3913,4039,3913,3996,3974,84,62,938,"5,591.84",716
,20160627,3996,3974,4020,4052,3990,4016,4020,42,46,864,"5,210.33",988
,20160628,4016,4020,4028,4028,3979,3999,4004,-21,-16,612,"3,676.39",1022
,20160629,3999,4004,4017,4155,4010,4153,4070,149,66,792,"4,836.09",1218
,20160630,4153,4070,4153,4171,4115,4159,4145,89,75,754,"4,688.21",1310
,20160701,4159,4145,4165,4377,4151,4323,4268,178,123,2186,"13,997.48",1558
,20160704,4323,4268,4329,4524,4322,4524,4467,256,199,2170,"14,540.39",2300
,20160705,4524,4467,4600,4687,4411,4522,4570,55,103,8040,"55,117.78",2190
,20160706,4522,4570,4493,4666,4435,4611,4560,41,-10,6842,"46,802.61",2480
,20160707,4611,4560,4598,4600,4513,4558,4568,-2,8,3704,"25,380.50",2528
,20160708,4558,4568,4535,4535,4419,4430,4456,-138,-112,4220,"28,211.50",2558
,20160711,4430,4456,4428,4672,4400,4612,4578,156,122,6728,"46,202.75",2964
,20160712,4612,4578,4593,4632,4554,4616,4600,38,22,3668,"25,310.02",2990
,20160713,4616,4600,4616,4631,4495,4622,4573,22,-27,5454,"37,416.93",3416
,20160714,4622,4573,4622,4640,4556,4588,4596,15,23,3644,"25,126.86",3396
,20160715,4588,4596,4558,4586,4522,4564,4561,-32,-35,2670,"18,267.52",3676
,20160718,4564,4561,4564,4566,4485,4495,4523,-66,-38,3820,"25,921.64",4052
,20160719,4495,4523,4495,4517,4469,4488,4492,-35,-31,3502,"23,597.86",4496
,20160720,4488,4492,4488,4516,4458,4458,4486,-34,-6,2866,"19,285.59",4706
,20160721,4458,4486,4418,4421,4346,4380,4378,-106,-108,4352,"28,582.78",5216
,20160722,4380,4378,4379,4502,4360,4440,4460,62,82,4596,"30,748.38",5772
,20160725,4440,4460,4440,4450,4370,4400,4406,-60,-54,3034,"20,053.09",6238
,20160726,4400,4406,4397,4459,4375,4441,4428,35,22,3542,"23,530.61",6818
,20160727,4441,4428,4441,4458,4420,4436,4434,8,6,2322,"15,443.85",7316
,20160728,4436,4434,4446,4615,4446,4601,4554,167,120,4924,"33,637.57",7058
,20160729,4601,4554,4594,4596,4538,4548,4569,-6,15,2510,"17,203.53",7156
,20160801,4548,4569,4582,4663,4557,4639,4621,70,52,4158,"28,822.23",7714
,20160802,4639,4621,4639,4648,4600,4638,4622,17,1,2678,"18,567.11",7994
,20160803,4638,4622,4670,4692,4652,4672,4672,50,50,2714,"19,022.42",8434
,20160804,4672,4672,4665,4665,4549,4560,4590,-112,-82,4174,"28,744.13",8476
,20160805,4560,4590,4592,4613,4579,4605,4597,15,7,2106,"14,523.23",8588
,20160808,4605,4597,4528,4529,4441,4447,4477,-150,-120,4130,"27,738.83",8900
,20160809,4447,4477,4463,4488,4442,4452,4464,-25,-13,2404,"16,097.58",9122
,20160810,4452,4464,4443,4579,4435,4566,4520,102,56,3868,"26,225.95",9394
,20160811,4566,4520,4596,4602,4506,4535,4546,15,26,4588,"31,289.75",9170
,20160812,4535,4546,4561,4568,4511,4525,4533,-21,-13,2694,"18,318.87",9454
,20160815,4525,4533,4556,4560,4460,4479,4489,-54,-44,7240,"48,754.74",8910
,20160816,4479,4489,4471,4533,4466,4512,4496,23,7,3530,"23,808.21",9132
,20160817,4512,4496,4508,4511,4452,4462,4479,-34,-17,3714,"24,956.60",9584
,20160818,4462,4479,4462,4521,4406,4488,4485,9,6,5150,"34,650.82",10024
,20160819,4488,4485,4488,4495,4455,4467,4472,-18,-13,3254,"21,829.09",10492
,20160822,4467,4472,4426,4440,4302,4305,4361,-167,-111,10412,"68,124.32",13220
,20160823,4305,4361,4306,4342,4305,4338,4326,-23,-35,3152,"20,456.65",13494
,20160824,4338,4326,4347,4347,4305,4313,4320,-13,-6,3094,"20,049.64",13772
,20160825,4313,4320,4304,4304,4223,4249,4247,-71,-73,4906,"31,254.18",14222
,20160826,4249,4247,4238,4263,4230,4247,4248,0,1,3120,"19,882.24",14420
,20160829,4247,4248,4275,4339,4205,4233,4254,-15,6,8032,"51,260.33",15202
,20160830,4233,4254,4241,4300,4241,4260,4266,6,12,4000,"25,599.82",15614
,20160831,4260,4266,4262,4289,4243,4267,4266,1,0,3420,"21,889.23",15744
,20160901,4267,4266,4255,4288,4255,4270,4272,4,6,6648,"42,601.27",17484
,20160902,4270,4272,4255,4342,4255,4315,4307,43,35,5850,"37,802.54",17880
,20160905,4315,4307,4366,4428,4366,4412,4397,105,90,9172,"60,503.47",17662
,20160906,4412,4397,4418,4444,4415,4438,4429,41,32,4590,"30,497.94",17324
,20160907,4438,4429,4451,4554,4451,4507,4514,78,85,10812,"73,217.00",17772
,20160908,4507,4514,4516,4527,4477,4511,4503,-3,-11,5386,"36,384.96",18448
,20160909,4511,4503,4503,4503,4441,4455,4467,-48,-36,8232,"55,169.95",18422
,20160912,4455,4467,4436,4446,4320,4352,4367,-115,-100,11166,"73,155.99",19530
,20160913,4352,4367,4344,4411,4327,4380,4370,13,3,8250,"54,081.76",21194
,20160914,4380,4370,4351,4373,4313,4366,4346,-4,-24,6616,"43,138.61",21028
,20160919,4366,4346,4332,4408,4321,4380,4371,34,25,4490,"29,443.49",21208
,20160920,4380,4371,4399,4416,4382,4401,4401,30,30,4510,"29,773.52",21746
,20160921,4401,4401,4397,4449,4359,4444,4407,43,6,8774,"58,009.63",21858
,20160922,4444,4407,4481,4526,4450,4481,4495,74,88,13528,"91,226.10",22644
,20160923,4481,4495,4520,4540,4477,4494,4503,-1,8,9530,"64,382.27",24320
,20160926,4494,4503,4504,4504,4418,4445,4457,-58,-46,11030,"73,743.25",26380
,20160927,4445,4457,4439,4463,4413,4435,4434,-22,-23,6772,"45,045.29",26862
,20160928,4435,4434,4403,4414,4350,4364,4376,-70,-58,11554,"75,848.13",28022
,20160929,4364,4376,4364,4405,4334,4375,4374,-1,-2,8840,"58,007.95",28040
,20160930,4375,4374,4353,4389,4347,4364,4366,-10,-8,8442,"55,286.87",27632
,20161010,4364,4366,4060,4101,4052,4075,4075,-291,-291,24764,"151,401.65",37192
,20161011,4075,4075,4076,4120,4062,4112,4086,37,11,23926,"146,643.04",44492
,20161012,4112,4086,4082,4094,4068,4082,4080,-4,-6,17366,"106,288.07",45960
,20161013,4082,4080,4070,4103,4066,4086,4084,6,4,15496,"94,941.58",49602
,20161014,4086,4084,4076,4092,4069,4073,4078,-11,-6,23588,"144,300.78",56778
,20161017,4073,4078,4073,4097,4061,4081,4078,3,0,18986,"116,150.65",59794
,20161018,4081,4078,4078,4135,4077,4125,4104,47,26,18728,"115,310.18",61234
,20161019,4125,4104,4123,4140,4110,4120,4123,16,19,22904,"141,663.35",65556
,20161020,4120,4123,4142,4155,4126,4143,4144,20,21,21450,"133,353.99",70438
,20161021,4143,4144,4134,4151,4083,4100,4107,-44,-37,30188,"185,989.10",77910
,20161024,4100,4107,4101,4134,4097,4128,4111,21,4,25456,"157,000.85",84310
,20161025,4128,4111,4148,4180,4124,4152,4149,41,38,43674,"271,858.79",93798
,20161026,4152,4149,4165,4199,4143,4181,4173,32,24,70696,"442,598.57",111614
,20161027,4181,4173,4161,4175,4146,4160,4157,-13,-16,60132,"375,030.21",137934
,20161028,4160,4157,4170,4177,4150,4166,4165,9,8,52966,"330,974.75",160246
,20161031,4166,4165,4165,4207,4155,4187,4186,22,21,96434,"605,586.94",194872
,20161101,4187,4186,4185,4224,4181,4210,4199,24,13,74300,"468,063.84",218316
,20161102,4210,4199,4259,4306,4248,4303,4276,104,77,105566,"677,181.77",225616
,20161103,4303,4276,4318,4333,4274,4275,4306,-1,30,120968,"781,377.99",213506
,20161104,4275,4306,4220,4276,4216,4218,4235,-88,-71,151816,"964,487.97",217806
,20161107,4218,4235,4242,4260,4206,4226,4233,-9,-2,114554,"727,496.73",225676
,20161108,4226,4233,4220,4259,4190,4257,4229,24,-4,129340,"820,469.12",255802
,20161109,4257,4229,4237,4419,4232,4384,4326,155,97,501866,"3,256,647.71",303064
,20161110,4384,4326,4384,4403,4308,4403,4367,77,41,349812,"2,291,837.72",389490
,20161111,4403,4367,4391,4465,4352,4452,4403,85,36,540772,"3,571,689.71",531670
,20161114,4452,4403,4425,4479,4138,4138,4295,-265,-108,853470,"5,499,092.04",435976
,20161115,4138,4295,4141,4164,4093,4140,4126,-155,-169,500754,"3,099,894.58",421952
,20161116,4140,4126,4130,4180,4120,4158,4150,32,24,395132,"2,460,070.93",438130
,20161117,4158,4150,4148,4161,4135,4139,4148,-11,-2,331908,"2,065,308.90",454692
,20161118,4139,4148,4148,4158,4080,4101,4118,-47,-30,516058,"3,188,125.06",492548
,20161121,4101,4118,4102,4133,4073,4131,4104,13,-14,535686,"3,298,380.16",512028
,20161122,4131,4104,4125,4186,4110,4166,4147,62,43,620846,"3,862,021.98",589436
,20161123,4166,4147,4166,4177,4143,4159,4158,12,11,480092,"2,994,730.66",605060
,20161124,4159,4158,4148,4153,4081,4129,4121,-29,-37,908362,"5,615,895.33",643450
,20161125,4129,4121,4125,4158,4093,4119,4127,-2,6,665974,"4,123,508.09",668112
,20161128,4119,4127,4133,4237,4125,4211,4183,84,56,944576,"5,926,952.93",718130
,20161129,4211,4183,4195,4220,4167,4179,4194,-4,11,708916,"4,460,494.37",694584
,20161130,4179,4194,4159,4188,4133,4155,4160,-39,-34,712904,"4,449,313.65",695622
,20161201,4155,4160,4155,4176,4090,4147,4141,-13,-19,906362,"5,629,955.83",724380
,20161202,4147,4141,4121,4165,4116,4144,4138,3,-3,588310,"3,652,062.93",732220
,20161205,4144,4138,4128,4214,4116,4165,4167,27,29,980844,"6,131,001.02",750078
,20161206,4165,4167,4167,4202,4156,4172,4178,5,11,690058,"4,324,827.35",768054
,20161207,4172,4178,4181,4192,4163,4169,4176,-9,-2,517866,"3,243,922.19",768516
,20161208,4169,4176,4182,4290,4180,4250,4243,74,67,1332558,"8,482,671.55",834208
,20161209,4250,4243,4245,4266,4208,4238,4237,-5,-6,776850,"4,937,833.75",805230
,20161212,4238,4237,4228,4265,4221,4244,4240,7,3,737376,"4,690,670.91",864670
,20161213,4244,4240,4246,4298,4231,4275,4270,35,30,869156,"5,567,640.63",875882
,20161214,4275,4270,4276,4300,4222,4273,4261,3,-9,908220,"5,806,020.71",876070
,20161215,4273,4261,4275,4298,4200,4231,4252,-30,-9,972096,"6,200,797.05",828720
,20161216,4231,4252,4136,4148,4096,4112,4118,-140,-134,908346,"5,611,229.52",770624
,20161219,4112,4118,4112,4135,4104,4116,4120,-2,2,507136,"3,134,194.95",758880
,20161220,4116,4120,4110,4115,3997,4003,4074,-117,-46,780436,"4,770,163.17",760922
,20161221,4003,4074,3960,4059,3943,4041,3995,-33,-79,827464,"4,959,755.80",728162
,20161222,4041,3995,4035,4047,3972,3990,4013,-5,18,514436,"3,097,353.20",736258
,20161223,3990,4013,3980,4038,3972,3995,4008,-18,-5,635390,"3,820,136.22",727314
,20161226,3995,4008,3999,4017,3950,3979,3990,-29,-18,486620,"2,913,141.33",716582
,20161227,3979,3990,3978,4045,3975,4039,4012,49,22,374334,"2,252,881.13",740776
,20161228,4039,4012,4042,4065,4019,4042,4043,30,31,573016,"3,475,460.00",737970
,20161229,4042,4043,4035,4102,4030,4087,4068,44,25,572730,"3,495,435.86",729452
,20161230,4087,4068,4076,4136,4069,4113,4102,45,34,595792,"3,666,795.54",708376
ag1707,20160718,4561,4561,4635,4635,4510,4510,4562,-51,1,266,"1,820.45",18
,20160719,4510,4562,,,,4513,4513,-49,-49,0,0.00,18
,20160720,4513,4513,,,,4486,4486,-27,-27,0,0.00,18
,20160721,4486,4486,4413,4415,4377,4381,4399,-105,-87,10,66.00,22
,20160722,4381,4399,4383,4515,4383,4486,4481,87,82,18,120.99,38
,20160725,4486,4481,,,,4428,4428,-53,-53,0,0.00,38
,20160726,4428,4428,,,,4428,4428,0,0,0,0.00,38
,20160727,4428,4428,4429,4453,4429,4436,4435,8,7,20,133.06,46
,20160728,4436,4435,4465,4640,4465,4609,4578,174,143,26,178.57,46
,20160729,4609,4578,4602,4602,4570,4570,4587,-8,9,22,151.37,50
,20160801,4570,4587,4602,4602,4602,4602,4602,15,15,2,13.81,50
,20160802,4602,4602,,,,4602,4602,0,0,0,0.00,50
,20160803,4602,4602,4709,4709,4681,4681,4695,79,93,4,28.17,48
,20160804,4681,4695,4619,4619,4580,4580,4599,-115,-96,4,27.60,44
,20160805,4580,4599,,,,4599,4599,0,0,0,0.00,44
,20160808,4599,4599,4558,4558,4478,4478,4506,-121,-93,10,67.60,44
,20160809,4478,4506,4499,4499,4479,4479,4486,-27,-20,10,67.30,40
,20160810,4479,4486,4510,4515,4485,4515,4504,29,18,12,81.08,40
,20160811,4515,4504,4542,4542,4542,4542,4542,38,38,2,13.63,38
,20160812,4542,4542,,,,4542,4542,0,0,0,0.00,38
,20160815,4542,4542,,,,4503,4503,-39,-39,0,0.00,38
,20160816,4503,4503,,,,4503,4503,0,0,0,0.00,38
,20160817,4503,4503,,,,4503,4503,0,0,0,0.00,38
,20160818,4503,4503,,,,4503,4503,0,0,0,0.00,38
,20160819,4503,4503,4521,4521,4473,4474,4490,-29,-13,20,134.73,58
,20160822,4474,4490,4415,4460,4336,4336,4418,-154,-72,36,238.59,72
,20160823,4336,4418,4353,4353,4337,4350,4349,-68,-69,72,469.77,112
,20160824,4350,4349,4340,4340,4340,4340,4340,-9,-9,4,26.04,116
,20160825,4340,4340,4306,4306,4259,4271,4272,-69,-68,42,269.15,116
,20160826,4271,4272,4262,4262,4262,4262,4262,-10,-10,6,38.36,122
,20160829,4262,4262,4292,4304,4292,4304,4298,42,36,4,25.79,122
,20160830,4304,4298,4276,4299,4276,4299,4295,1,-3,18,115.97,118
,20160831,4299,4295,4279,4279,4279,4279,4279,-16,-16,2,12.84,118
,20160901,4279,4279,,,,4279,4279,0,0,0,0.00,118
,20160902,4279,4279,4298,4298,4296,4298,4297,19,18,18,116.03,134
,20160905,4298,4297,4435,4435,4430,4430,4432,133,135,4,26.60,134
,20160906,4430,4432,4440,4450,4440,4450,4442,18,10,26,173.27,156
,20160907,4450,4442,4522,4560,4522,4541,4541,99,99,8,54.50,154
,20160908,4541,4541,,,,4541,4541,0,0,0,0.00,154
,20160909,4541,4541,4488,4488,4488,4488,4488,-53,-53,2,13.46,152
,20160912,4488,4488,,,,4388,4388,-100,-100,0,0.00,152
,20160913,4388,4388,,,,4388,4388,0,0,0,0.00,152
,20160914,4388,4388,4397,4397,4397,4397,4397,9,9,2,13.19,152
,20160919,4397,4397,,,,4423,4423,26,26,0,0.00,152
,20160920,4423,4423,,,,4423,4423,0,0,0,0.00,152
,20160921,4423,4423,4394,4426,4388,4410,4398,-13,-25,90,593.74,82
,20160922,4410,4398,,,,4398,4398,0,0,0,0.00,82
,20160923,4398,4398,4544,4546,4509,4509,4536,111,138,34,231.38,74
,20160926,4509,4536,,,,4536,4536,0,0,0,0.00,74
,20160927,4536,4536,4468,4468,4440,4440,4454,-96,-82,4,26.72,74
,20160928,4440,4454,,,,4380,4380,-74,-74,0,0.00,74
,20160929,4380,4380,,,,4380,4380,0,0,0,0.00,74
,20160930,4380,4380,,,,4372,4372,-8,-8,0,0.00,74
,20161010,4372,4372,4106,4106,4067,4076,4082,-296,-290,28,171.45,72
,20161011,4076,4082,4086,4086,4086,4086,4086,4,4,2,12.26,72
,20161012,4086,4086,4097,4097,4097,4097,4097,11,11,2,12.29,70
,20161013,4097,4097,4097,4105,4097,4105,4102,8,5,6,36.92,72
,20161014,4105,4102,4100,4106,4081,4081,4095,-21,-7,18,110.57,72
,20161017,4081,4095,4084,4088,4080,4088,4084,-7,-11,8,49.01,70
,20161018,4088,4084,4099,4145,4087,4145,4091,61,7,74,454.19,122
,20161019,4145,4091,4135,4144,4098,4144,4134,53,43,26,161.23,126
,20161020,4144,4134,,,,4134,4134,0,0,0,0.00,126
,20161021,4134,4134,4113,4113,4113,4113,4113,-21,-21,36,222.10,140
,20161024,4113,4113,,,,4113,4113,0,0,0,0.00,140
,20161025,4113,4113,,,,4113,4113,0,0,0,0.00,140
,20161026,4113,4113,,,,4153,4153,40,40,0,0.00,140
,20161027,4153,4153,,,,4153,4153,0,0,0,0.00,140
,20161028,4153,4153,,,,4153,4153,0,0,0,0.00,140
,20161031,4153,4153,4181,4204,4181,4204,4202,51,49,84,529.49,190
,20161101,4204,4202,,,,4202,4202,0,0,0,0.00,190
,20161102,4202,4202,4280,4283,4261,4283,4274,81,72,6,38.47,188
,20161103,4283,4274,,,,4274,4274,0,0,0,0.00,188
,20161104,4274,4274,4245,4276,4241,4276,4256,2,-18,10,63.84,184
,20161107,4276,4256,,,,4256,4256,0,0,0,0.00,184
,20161108,4256,4256,4234,4234,4234,4234,4234,-22,-22,2,12.70,186
,20161109,4234,4234,4277,4396,4277,4396,4321,162,87,84,544.49,186
,20161110,4396,4321,4379,4402,4347,4402,4375,81,54,10,65.63,184
,20161111,4402,4375,4414,4434,4389,4395,4410,20,35,10,66.16,182
,20161114,4395,4410,4438,4450,4150,4155,4298,-255,-112,8,51.58,184
,20161115,4155,4298,4157,4157,4149,4149,4154,-149,-144,16,99.70,174
,20161116,4149,4154,4146,4146,4146,4146,4146,-8,-8,18,111.94,192
,20161117,4146,4146,,,,4146,4146,0,0,0,0.00,192
,20161118,4146,4146,4150,4150,4109,4109,4123,-37,-23,26,160.81,192
,20161121,4109,4123,4120,4141,4098,4141,4118,18,-5,14,86.48,198
,20161122,4141,4118,4129,4134,4129,4134,4130,16,12,6,37.18,204
,20161123,4134,4130,4177,4177,4167,4167,4172,37,42,8,50.06,212
,20161124,4167,4172,4154,4168,4152,4152,4155,-20,-17,20,124.67,232
,20161125,4152,4155,4156,4156,4132,4132,4137,-23,-18,16,99.31,248
,20161128,4132,4137,4150,4250,4112,4233,4193,96,56,48,301.95,278
,20161129,4233,4193,4202,4210,4189,4201,4204,8,11,18,113.53,274
,20161130,4201,4204,4178,4232,4163,4177,4185,-27,-19,50,313.88,278
,20161201,4177,4185,4178,4180,4114,4131,4161,-54,-24,42,262.20,274
,20161202,4131,4161,,,,4161,4161,0,0,0,0.00,274
,20161205,4161,4161,4200,4213,4152,4213,4184,52,23,18,112.98,264
,20161206,4213,4184,4178,4204,4177,4188,4191,4,7,70,440.06,240
,20161207,4188,4191,4192,4239,4172,4194,4195,3,4,56,352.46,236
,20161208,4194,4195,4199,4288,4199,4287,4274,92,79,14,89.77,236
,20161209,4287,4274,4265,4268,4235,4235,4256,-39,-18,18,114.92,238
,20161212,4235,4256,,,,4256,4256,0,0,0,0.00,238
,20161213,4256,4256,4278,4317,4259,4259,4280,3,24,8,51.36,238
,20161214,4259,4280,4288,4288,4285,4285,4286,5,6,4,25.72,242
,20161215,4285,4286,4278,4278,4278,4278,4278,-8,-8,2,12.83,244
,20161216,4278,4278,4132,4150,4128,4150,4138,-128,-140,30,186.24,244
,20161219,4150,4138,4136,4136,4136,4136,4136,-2,-2,6,37.22,238
,20161220,4136,4136,,,,4119,4119,-17,-17,0,0.00,238
,20161221,4119,4119,3980,4021,3934,4008,3980,-111,-139,36,214.93,208
,20161222,4008,3980,,,,3980,3980,0,0,0,0.00,208
,20161223,3980,3980,,,,4000,4000,20,20,0,0.00,208
,20161226,4000,4000,,,,4000,4000,0,0,0,0.00,208
,20161227,4000,4000,4028,4028,4028,4028,4028,28,28,6,36.25,210
,20161228,4028,4028,4068,4068,4068,4068,4068,40,40,2,12.20,210
,20161229,4068,4068,4067,4113,4067,4110,4092,42,24,16,98.21,212
,20161230,4110,4092,4138,4138,4127,4127,4132,35,40,4,24.80,210
ag1708,20160816,4503,4503,4554,4554,4500,4531,4528,28,25,6,40.76,4
,20160817,4531,4528,,,,4528,4528,0,0,0,0.00,4
,20160818,4528,4528,4490,4572,4490,4519,4527,-9,-1,8,54.33,8
,20160819,4519,4527,4530,4530,4508,4515,4519,-12,-8,8,54.23,14
,20160822,4515,4519,4470,4470,4360,4368,4393,-151,-126,132,869.90,122
,20160823,4368,4393,4366,4377,4366,4377,4369,-16,-24,6,39.33,122
,20160824,4377,4369,4386,4386,4318,4348,4351,-21,-18,14,91.38,126
,20160825,4348,4351,4293,4304,4269,4269,4287,-82,-64,16,102.91,130
,20160826,4269,4287,4280,4295,4280,4282,4286,-5,-1,10,64.30,130
,20160829,4282,4286,4307,4416,4257,4257,4328,-29,42,32,207.76,140
,20160830,4257,4328,4308,4345,4308,4345,4317,17,-11,8,51.81,134
,20160831,4345,4317,4301,4301,4298,4300,4299,-17,-18,6,38.70,130
,20160901,4300,4299,4305,4319,4305,4319,4310,20,11,6,38.79,132
,20160902,4319,4310,4312,4312,4312,4312,4312,2,2,2,12.94,130
,20160905,4312,4312,4420,4449,4408,4449,4423,137,111,18,119.43,126
,20160906,4449,4423,4447,4447,4447,4447,4447,24,24,2,13.34,128
,20160907,4447,4447,4499,4561,4499,4560,4533,113,86,18,122.41,134
,20160908,4560,4533,4543,4543,4534,4534,4537,1,4,6,40.83,140
,20160909,4534,4537,,,,4534,4534,-3,-3,0,0.00,140
,20160912,4534,4534,4410,4463,4360,4379,4394,-155,-140,32,210.93,136
,20160913,4379,4394,4379,4444,4372,4433,4393,39,-1,30,197.72,134
,20160914,4433,4393,4391,4391,4360,4390,4378,-3,-15,16,105.08,128
,20160919,4390,4378,4375,4403,4362,4403,4380,25,2,6,39.42,130
,20160920,4403,4380,4435,4440,4417,4417,4430,37,50,46,305.73,114
,20160921,4417,4430,4423,4463,4404,4463,4414,33,-16,84,556.19,76
,20160922,4463,4414,4507,4549,4500,4535,4523,121,109,34,230.67,80
,20160923,4535,4523,4540,4554,4540,4545,4548,22,25,26,177.38,74
,20160926,4545,4548,4509,4523,4463,4463,4486,-85,-62,14,94.21,66
,20160927,4463,4486,4528,4528,4481,4482,4493,-4,7,8,53.92,66
,20160928,4482,4493,4426,4426,4390,4392,4401,-101,-92,22,145.24,62
,20160929,4392,4401,4387,4387,4336,4359,4360,-42,-41,6,39.25,66
,20160930,4359,4360,4400,4404,4390,4390,4397,30,37,16,105.53,70
,20161010,4390,4397,4123,4124,4089,4110,4104,-287,-293,26,160.07,68
,20161011,4110,4104,4102,4137,4100,4129,4111,25,7,26,160.33,86
,20161012,4129,4111,4106,4114,4094,4094,4105,-17,-6,16,98.52,98
,20161013,4094,4105,,,,4105,4105,0,0,0,0.00,98
,20161014,4105,4105,4103,4103,4103,4103,4103,-2,-2,4,24.62,102
,20161017,4103,4103,4099,4099,4092,4092,4095,-11,-8,4,24.57,104
,20161018,4092,4095,4100,4138,4092,4138,4113,43,18,96,592.28,112
,20161019,4138,4113,4144,4146,4142,4145,4144,32,31,14,87.03,114
,20161020,4145,4144,4157,4174,4157,4159,4165,15,21,34,212.42,138
,20161021,4159,4165,4172,4172,4113,4125,4136,-40,-29,50,310.25,160
,20161024,4125,4136,,,,4136,4136,0,0,0,0.00,160
,20161025,4136,4136,4136,4191,4135,4179,4163,43,27,168,"1,049.27",160
,20161026,4179,4163,4178,4222,4174,4202,4186,39,23,14,87.91,164
,20161027,4202,4186,,,,4186,4186,0,0,0,0.00,164
,20161028,4186,4186,,,,4186,4186,0,0,0,0.00,164
,20161031,4186,4186,4199,4220,4198,4220,4203,34,17,46,290.01,190
,20161101,4220,4203,4222,4222,4222,4222,4222,19,19,26,164.66,216
,20161102,4222,4222,4284,4313,4284,4313,4290,91,68,24,154.45,232
,20161103,4313,4290,4336,4343,4325,4336,4335,46,45,8,52.02,230
,20161104,4336,4335,4275,4295,4264,4276,4277,-59,-58,20,128.31,236
,20161107,4276,4277,,,,4277,4277,0,0,0,0.00,236
,20161108,4277,4277,4234,4260,4232,4260,4244,-17,-33,18,114.61,240
,20161109,4260,4244,4268,4446,4268,4409,4390,165,146,34,223.89,236
,20161110,4409,4390,4398,4426,4388,4414,4411,24,21,28,185.29,246
,20161111,4414,4411,4436,4459,4403,4442,4428,31,17,44,292.25,248
,20161114,4442,4428,4463,4477,4162,4162,4334,-266,-94,30,195.07,250
,20161115,4162,4334,4208,4208,4118,4162,4157,-172,-177,28,174.60,248
,20161116,4162,4157,4205,4206,4182,4182,4202,25,45,32,201.74,274
,20161117,4182,4202,4176,4176,4165,4165,4168,-37,-34,14,87.54,268
,20161118,4165,4168,4174,4175,4162,4162,4169,-6,1,10,62.55,268
,20161121,4162,4169,4149,4157,4116,4146,4136,-23,-33,32,198.57,290
,20161122,4146,4136,4153,4154,4153,4154,4153,18,17,6,37.38,296
,20161123,4154,4153,4191,4191,4167,4179,4179,26,26,16,100.31,300
,20161124,4179,4179,4120,4185,4116,4183,4176,4,-3,54,338.33,300
,20161125,4183,4176,4165,4189,4141,4154,4163,-22,-13,72,449.70,280
,20161128,4154,4163,4164,4266,4153,4246,4213,83,50,24,151.70,276
,20161129,4246,4213,4239,4242,4227,4227,4232,14,19,32,203.14,256
,20161130,4227,4232,4185,4199,4185,4195,4194,-37,-38,12,75.50,248
,20161201,4195,4194,4204,4204,4142,4156,4178,-38,-16,26,162.96,246
,20161202,4156,4178,4146,4190,4146,4190,4175,12,-3,6,37.58,250
,20161205,4190,4175,4199,4203,4196,4203,4198,28,23,10,62.97,246
,20161206,4203,4198,4212,4212,4212,4212,4212,14,14,2,12.64,244
,20161207,4212,4212,,,,4212,4212,0,0,0,0.00,244
,20161208,4212,4212,4306,4306,4277,4292,4291,80,79,6,38.63,242
,20161209,4292,4291,4254,4254,4254,4254,4254,-37,-37,8,51.05,234
,20161212,4254,4254,4261,4261,4261,4261,4261,7,7,4,25.57,234
,20161213,4261,4261,4324,4324,4296,4296,4297,35,36,86,554.39,272
,20161214,4296,4297,,,,4297,4297,0,0,0,0.00,272
,20161215,4297,4297,,,,4297,4297,0,0,0,0.00,272
,20161216,4297,4297,,,,4198,4198,-99,-99,0,0.00,272
,20161219,4198,4198,,,,4197,4197,-1,-1,0,0.00,272
,20161220,4197,4197,,,,4178,4178,-19,-19,0,0.00,272
,20161221,4178,4178,4000,4030,3984,4030,3997,-148,-181,44,263.84,244
,20161222,4030,3997,4088,4088,4020,4022,4076,25,79,118,721.49,200
,20161223,4022,4076,4036,4036,4036,4036,4036,-40,-40,2,12.11,200
,20161226,4036,4036,,,,4036,4036,0,0,0,0.00,200
,20161227,4036,4036,4018,4080,4005,4080,4016,44,-20,132,795.18,226
,20161228,4080,4016,,,,4016,4016,0,0,0,0.00,226
,20161229,4016,4016,4119,4119,4119,4119,4119,103,103,2,12.36,226
,20161230,4119,4119,4109,4170,4109,4160,4144,41,25,30,186.52,224
ag1709,20160920,4380,4380,,,,4392,4392,12,12,0,0.00,0
,20160921,4392,4392,4480,4480,4480,4480,4480,88,88,2,13.44,2
,20160922,4480,4480,4532,4545,4515,4545,4529,65,49,22,149.46,20
,20160923,4545,4529,4560,4570,4525,4527,4541,-2,12,26,177.11,30
,20160926,4527,4541,4524,4524,4463,4480,4500,-61,-41,36,243.03,40
,20160927,4480,4500,4486,4540,4461,4461,4494,-39,-6,32,215.72,40
,20160928,4461,4494,4444,4445,4369,4380,4393,-114,-101,64,421.80,76
,20160929,4380,4393,4384,4426,4366,4417,4394,24,1,130,856.91,166
,20160930,4417,4394,,,,4394,4394,0,0,0,0.00,166
,20161010,4394,4394,4119,4142,4100,4120,4122,-274,-272,134,828.70,218
,20161011,4120,4122,4124,4172,4124,4168,4147,46,25,16,99.53,228
,20161012,4168,4147,4133,4184,4117,4117,4130,-30,-17,36,223.04,238
,20161013,4117,4130,,,,4130,4130,0,0,0,0.00,238
,20161014,4130,4130,,,,4130,4130,0,0,0,0.00,238
,20161017,4130,4130,4106,4114,4102,4112,4110,-18,-20,62,382.24,292
,20161018,4112,4110,4113,4151,4112,4151,4121,41,11,18,111.29,304
,20161019,4151,4121,4160,4168,4160,4161,4161,40,40,12,74.91,304
,20161020,4161,4161,4174,4188,4160,4183,4178,22,17,22,137.88,314
,20161021,4183,4178,4183,4216,4121,4132,4155,-46,-23,34,211.93,326
,20161024,4132,4155,4153,4164,4147,4164,4152,9,-3,10,62.29,328
,20161025,4164,4152,4180,4199,4176,4176,4185,24,33,16,100.46,326
,20161026,4176,4185,4196,4203,4190,4203,4193,18,8,22,138.39,332
,20161027,4203,4193,4192,4192,4192,4192,4192,-1,-1,2,12.58,334
,20161028,4192,4192,4208,4208,4208,4208,4208,16,16,2,12.62,334
,20161031,4208,4208,4216,4247,4207,4223,4222,15,14,18,114.02,334
,20161101,4223,4222,4205,4260,4205,4246,4223,24,1,158,"1,000.99",362
,20161102,4246,4223,4310,4326,4289,4323,4301,100,78,56,361.33,348
,20161103,4323,4301,4365,4365,4333,4333,4348,32,47,40,260.91,352
,20161104,4333,4348,4275,4314,4220,4277,4274,-71,-74,54,346.21,350
,20161107,4277,4274,4290,4296,4251,4254,4275,-20,1,36,230.87,354
,20161108,4254,4275,4254,4288,4250,4288,4269,13,-6,30,192.11,348
,20161109,4288,4269,4297,4450,4297,4432,4375,163,106,84,551.37,360
,20161110,4432,4375,4460,4460,4380,4428,4415,53,40,18,119.23,366
,20161111,4428,4415,4452,4477,4432,4437,4449,22,34,24,160.20,370
,20161114,4437,4449,4478,4528,4182,4183,4381,-266,-68,100,657.16,400
,20161115,4183,4381,4195,4238,4160,4167,4182,-214,-199,56,351.35,418
,20161116,4167,4182,4199,4208,4189,4208,4200,26,18,10,63.01,412
,20161117,4208,4200,4200,4206,4188,4190,4194,-10,-6,20,125.82,408
,20161118,4190,4194,4210,4211,4140,4145,4174,-49,-20,42,263.02,410
,20161121,4145,4174,4169,4201,4140,4176,4164,2,-10,52,324.82,414
,20161122,4176,4164,4183,4209,4171,4209,4187,45,23,28,175.88,412
,20161123,4209,4187,4214,4219,4201,4209,4208,22,21,22,138.89,416
,20161124,4209,4208,4191,4239,4140,4198,4182,-10,-26,44,276.06,426
,20161125,4198,4182,4180,4213,4165,4172,4183,-10,1,42,263.57,430
,20161128,4172,4183,4187,4288,4187,4273,4243,90,60,88,560.19,458
,20161129,4273,4243,4260,4288,4244,4246,4260,3,17,40,255.61,468
,20161130,4246,4260,4226,4231,4210,4215,4217,-45,-43,14,88.56,468
,20161201,4215,4217,4253,4253,4157,4196,4195,-21,-22,44,276.88,470
,20161202,4196,4195,4186,4228,4186,4202,4201,7,6,32,201.65,462
,20161205,4202,4201,4192,4270,4192,4218,4256,17,55,30,191.55,476
,20161206,4218,4256,4240,4254,4235,4240,4246,-16,-10,50,318.47,462
,20161207,4240,4246,4246,4246,4224,4224,4231,-22,-15,44,279.28,438
,20161208,4224,4231,4290,4336,4247,4286,4284,55,53,20,128.53,446
,20161209,4286,4284,4293,4293,4272,4272,4279,-12,-5,14,89.87,432
,20161212,4272,4279,4311,4311,4286,4298,4299,19,20,8,51.60,430
,20161213,4298,4299,4296,4366,4296,4325,4311,26,12,40,258.67,434
,20161214,4325,4311,4329,4329,4312,4312,4320,1,9,4,25.92,432
,20161215,4312,4320,4317,4360,4246,4281,4303,-39,-17,34,219.50,444
,20161216,4281,4303,4173,4214,4161,4186,4180,-117,-123,46,288.44,470
,20161219,4186,4180,4180,4221,4151,4194,4183,14,3,48,301.24,470
,20161220,4194,4183,4150,4167,4055,4055,4123,-128,-60,104,643.30,538
,20161221,4055,4123,4049,4144,3995,4115,4046,-8,-77,88,534.11,558
,20161222,4115,4046,4137,4137,4050,4050,4098,4,52,40,245.91,566
,20161223,4050,4098,4072,4072,4069,4070,4069,-28,-29,14,85.47,560
,20161226,4070,4069,4085,4085,4021,4021,4054,-48,-15,24,145.97,560
,20161227,4021,4054,4053,4100,4045,4100,4066,46,12,18,109.79,564
,20161228,4100,4066,4103,4103,4103,4103,4103,37,37,2,12.31,562
,20161229,4103,4103,4068,4147,4068,4147,4117,44,14,18,111.18,556
,20161230,4147,4117,4143,4184,4143,4184,4168,67,51,12,75.02,548
ag1710,20161018,4110,4110,,,,4110,4110,0,0,0,0.00,0
,20161019,4110,4110,,,,4110,4110,0,0,0,0.00,0
,20161020,4110,4110,4205,4205,4200,4200,4202,90,92,8,50.43,8
,20161021,4200,4202,4218,4218,4148,4148,4169,-54,-33,22,137.61,30
,20161024,4148,4169,4178,4178,4168,4168,4171,-1,2,6,37.54,36
,20161025,4168,4171,4203,4203,4203,4203,4203,32,32,2,12.61,38
,20161026,4203,4203,4240,4280,4226,4231,4244,28,41,8,50.93,42
,20161027,4231,4244,,,,4244,4244,0,0,0,0.00,42
,20161028,4244,4244,4221,4221,4221,4221,4221,-23,-23,2,12.66,42
,20161031,4221,4221,4232,4232,4223,4223,4229,2,8,8,50.76,50
,20161101,4223,4229,4254,4254,4254,4254,4254,25,25,4,25.52,50
,20161102,4254,4254,4334,4350,4318,4350,4329,96,75,10,64.94,52
,20161103,4350,4329,4370,4425,4370,4374,4386,45,57,16,105.29,54
,20161104,4374,4386,4299,4303,4285,4285,4294,-101,-92,14,90.18,62
,20161107,4285,4294,4299,4299,4282,4282,4290,-12,-4,4,25.74,62
,20161108,4282,4290,4278,4298,4271,4289,4284,-1,-6,40,257.08,86
,20161109,4289,4284,4302,4450,4302,4444,4376,160,92,28,183.79,102
,20161110,4444,4376,4430,4430,4368,4410,4408,34,32,28,185.15,106
,20161111,4410,4408,4430,4494,4426,4448,4440,40,32,32,213.16,108
,20161114,4448,4440,4378,4378,4205,4205,4259,-235,-181,20,127.77,114
,20161115,4205,4259,4221,4221,4160,4208,4188,-51,-71,18,113.08,112
,20161116,4208,4188,4219,4234,4219,4234,4226,46,38,4,25.36,116
,20161117,4234,4226,4215,4215,4215,4215,4215,-11,-11,2,12.65,114
,20161118,4215,4215,4178,4178,4150,4162,4163,-53,-52,10,62.45,114
,20161121,4162,4163,4158,4188,4150,4188,4168,25,5,20,125.06,122
,20161122,4188,4168,4197,4231,4188,4231,4203,63,35,8,50.44,126
,20161123,4231,4203,4225,4225,4221,4221,4223,18,20,4,25.34,128
,20161124,4221,4223,4203,4220,4149,4220,4190,-3,-33,30,188.57,132
,20161125,4220,4190,4215,4215,4174,4174,4194,-16,4,4,25.17,136
,20161128,4174,4194,4206,4329,4204,4290,4285,96,91,32,205.72,150
,20161129,4290,4285,4275,4280,4240,4240,4272,-45,-13,28,179.45,138
,20161130,4240,4272,4224,4224,4213,4213,4218,-59,-54,10,63.28,134
,20161201,4213,4218,4190,4192,4187,4192,4190,-26,-28,10,62.85,136
,20161202,4192,4190,4247,4247,4197,4226,4222,36,32,20,126.69,136
,20161205,4226,4222,4206,4266,4201,4266,4211,44,-11,14,88.45,136
,20161206,4266,4211,4248,4258,4229,4244,4238,33,27,50,317.86,124
,20161207,4244,4238,4253,4253,4238,4238,4245,0,7,8,50.95,120
,20161208,4238,4245,4251,4380,4251,4324,4309,79,64,12,77.58,120
,20161209,4324,4309,,,,4309,4309,0,0,0,0.00,120
,20161212,4309,4309,4308,4308,4308,4308,4308,-1,-1,2,12.92,118
,20161213,4308,4308,4308,4308,4308,4308,4308,0,0,2,12.92,120
,20161214,4308,4308,4300,4331,4300,4331,4323,23,15,12,77.83,124
,20161215,4331,4323,,,,4323,4323,0,0,0,0.00,124
,20161216,4323,4323,,,,4241,4241,-82,-82,0,0.00,124
,20161219,4241,4241,4190,4205,4186,4199,4190,-42,-51,66,414.83,162
,20161220,4199,4190,4158,4170,4158,4170,4164,-20,-26,4,24.98,162
,20161221,4170,4164,4052,4121,4026,4121,4068,-43,-96,14,85.43,164
,20161222,4121,4068,4078,4078,4078,4078,4078,10,10,2,12.23,164
,20161223,4078,4078,,,,4078,4078,0,0,0,0.00,164
,20161226,4078,4078,,,,4078,4078,0,0,0,0.00,164
,20161227,4078,4078,,,,4078,4078,0,0,0,0.00,164
,20161228,4078,4078,4102,4114,4102,4114,4108,36,30,4,24.65,164
,20161229,4114,4108,,,,4140,4140,32,32,0,0.00,164
,20161230,4140,4140,,,,4144,4144,4,4,0,0.00,164
ag1711,20161116,4188,4188,4216,4216,4215,4215,4215,27,27,4,25.29,4
,20161117,4215,4215,,,,4215,4215,0,0,0,0.00,4
,20161118,4215,4215,4209,4209,4188,4189,4197,-26,-18,12,75.55,14
,20161121,4189,4197,4218,4218,4195,4195,4207,-2,10,10,63.11,20
,20161122,4195,4207,4195,4259,4195,4259,4232,52,25,12,76.19,20
,20161123,4259,4232,,,,4232,4232,0,0,0,0.00,20
,20161124,4232,4232,4169,4240,4169,4229,4207,-3,-25,14,88.35,18
,20161125,4229,4207,,,,4207,4207,0,0,0,0.00,18
,20161128,4207,4207,4245,4361,4245,4282,4296,75,89,6,38.66,18
,20161129,4282,4296,4285,4285,4285,4285,4285,-11,-11,2,12.86,20
,20161130,4285,4285,4272,4272,4272,4272,4272,-13,-13,2,12.82,22
,20161201,4272,4272,4197,4218,4196,4218,4202,-54,-70,8,50.42,28
,20161202,4218,4202,,,,4202,4202,0,0,0,0.00,28
,20161205,4202,4202,,,,4202,4202,0,0,0,0.00,28
,20161206,4202,4202,,,,4202,4202,0,0,0,0.00,28
,20161207,4202,4202,4272,4272,4272,4272,4272,70,70,2,12.82,26
,20161208,4272,4272,4371,4390,4327,4360,4367,88,95,18,117.91,38
,20161209,4360,4367,,,,4367,4367,0,0,0,0.00,38
,20161212,4367,4367,4336,4336,4335,4335,4335,-32,-32,16,104.05,36
,20161213,4335,4335,4371,4410,4348,4410,4371,75,36,18,118.03,30
,20161214,4410,4371,4342,4386,4342,4345,4357,-26,-14,6,39.22,30
,20161215,4345,4357,,,,4357,4357,0,0,0,0.00,30
,20161216,4357,4357,4226,4226,4200,4220,4213,-137,-144,14,88.48,42
,20161219,4220,4213,4223,4223,4218,4218,4221,5,8,8,50.66,46
,20161220,4218,4221,4191,4191,4172,4172,4183,-49,-38,8,50.20,46
,20161221,4172,4183,4076,4150,4055,4149,4110,-34,-73,12,73.98,52
,20161222,4149,4110,,,,4110,4110,0,0,0,0.00,52
,20161223,4110,4110,4134,4134,4134,4134,4134,24,24,2,12.40,50
,20161226,4134,4134,4100,4115,4100,4104,4109,-30,-25,14,86.30,54
,20161227,4104,4109,4083,4142,4083,4129,4119,20,10,10,61.79,56
,20161228,4129,4119,4139,4139,4139,4139,4139,20,20,2,12.42,54
,20161229,4139,4139,4186,4186,4186,4186,4186,47,47,10,62.79,56
,20161230,4186,4186,,,,4186,4186,0,0,0,0.00,56
ag1712,20161216,4357,4357,4248,4248,4222,4231,4232,-126,-125,100,634.85,60
,20161219,4231,4232,4232,4256,4225,4240,4244,8,12,184,"1,171.49",182
,20161220,4240,4244,4233,4239,4128,4138,4181,-106,-63,696,"4,365.66",670
,20161221,4138,4181,4066,4182,4066,4161,4113,-20,-68,594,"3,665.26",838
,20161222,4161,4113,4147,4255,4101,4115,4140,2,27,420,"2,608.22",1006
,20161223,4115,4140,4099,4154,4095,4117,4128,-23,-12,1084,"6,712.73",1340
,20161226,4117,4128,4123,4137,4076,4102,4108,-26,-20,1044,"6,433.55",1532
,20161227,4102,4108,4098,4159,4097,4158,4118,50,10,594,"3,669.82",1772
,20161228,4158,4118,4163,4179,4139,4164,4162,46,44,758,"4,733.28",1906
,20161229,4164,4162,4158,4217,4151,4211,4188,49,26,964,"6,057.04",2006
,20161230,4211,4188,4211,4260,4191,4242,4214,54,26,2576,"16,285.43",3208
al1601,20160104,11200,11120,11110,11150,10985,11030,11045,-90,-75,5090,"28,116.00",31960
,20160105,11030,11045,10980,11110,10980,11090,11055,45,10,5330,"29,474.20",30640
,20160106,11090,11055,11045,11060,11000,11040,11035,-15,-20,2880,"15,894.10",30220
,20160107,11040,11035,11025,11045,10980,11000,11005,-35,-30,6670,"36,716.10",29430
,20160108,11000,11005,11000,11065,10950,11050,11035,45,30,3140,"17,329.08",29360
,20160111,11050,11035,11070,11080,11020,11030,11055,-5,20,7170,"39,634.53",26350
,20160112,11030,11055,11000,11060,10850,10850,11010,-205,-45,7850,"43,221.58",24790
,20160113,10850,11010,10855,10940,10815,10870,10845,-140,-165,2810,"15,243.28",23150
,20160114,10870,10845,10870,10900,10760,10760,10815,-85,-30,3800,"20,553.08",19940
,20160115,10760,10815,10760,10780,10690,10690,10720,-125,-95,8270,"44,327.60",14920
al1602,20160104,10910,10885,10875,10940,10705,10750,10780,-135,-105,76104,"410,240.74",116718
,20160105,10750,10780,10680,10885,10680,10860,10770,80,-10,65470,"352,641.62",111814
,20160106,10860,10770,10820,10840,10745,10810,10800,40,30,37172,"200,750.43",111526
,20160107,10810,10800,10780,10850,10720,10770,10775,-30,-25,43292,"233,325.67",107874
,20160108,10770,10775,10750,10870,10705,10850,10805,75,30,31328,"169,259.00",102862
,20160111,10850,10805,10855,10980,10835,10915,10905,110,100,31402,"171,291.30",95402
,20160112,10915,10905,10925,10955,10660,10670,10825,-235,-80,33978,"183,981.14",94200
,20160113,10670,10825,10670,10760,10605,10705,10670,-120,-155,29856,"159,318.72",88426
,20160114,10705,10670,10690,10850,10650,10755,10760,85,90,23782,"128,000.51",80260
,20160115,10755,10760,10775,10795,10680,10685,10745,-75,-15,27288,"146,652.36",73582
,20160118,10685,10745,10670,10800,10660,10740,10745,-5,0,20062,"107,826.76",65810
,20160119,10740,10745,10745,10785,10700,10780,10740,35,-5,15088,"81,025.77",62240
,20160120,10780,10740,10775,10780,10620,10650,10670,-90,-70,17904,"95,551.94",56274
,20160121,10650,10670,10650,10670,10605,10650,10645,-20,-25,8518,"45,350.73",54912
,20160122,10650,10645,10670,10835,10655,10830,10750,185,105,17560,"94,427.41",48084
,20160125,10830,10750,10870,10970,10680,10720,10775,-30,25,16392,"88,323.85",41376
,20160126,10720,10775,10725,10745,10690,10710,10725,-65,-50,6120,"32,821.08",38062
,20160127,10710,10725,10770,10810,10715,10740,10760,15,35,6054,"32,577.15",35852
,20160128,10740,10760,10755,10820,10720,10725,10760,-35,0,6646,"35,760.46",32706
,20160129,10725,10760,10725,10760,10670,10720,10700,-40,-60,4106,"21,970.05",31190
,20160201,10720,10700,10695,10750,10530,10570,10610,-130,-90,4260,"22,606.08",29080
,20160202,10570,10610,10560,10620,10545,10570,10575,-40,-35,3480,"18,405.90",28260
,20160203,10570,10575,10600,10630,10525,10590,10565,15,-10,4230,"22,350.60",29030
,20160204,10590,10565,10625,10750,10620,10750,10685,185,120,3780,"20,196.43",28930
,20160205,10750,10685,10725,10770,10680,10695,10700,10,15,2310,"12,360.28",28460
,20160215,10695,10700,10450,10785,10450,10780,10690,80,-10,6710,"35,878.10",24490
al1603,20160104,10820,10810,10850,10850,10605,10630,10680,-180,-130,218568,"1,167,177.41",252556
,20160105,10630,10680,10600,10780,10565,10770,10665,90,-15,262764,"1,401,551.37",245448
,20160106,10770,10665,10720,10745,10640,10685,10690,20,25,203524,"1,088,100.84",244508
,20160107,10685,10690,10665,10725,10610,10675,10665,-15,-25,233816,"1,247,147.32",247252
,20160108,10675,10665,10660,10765,10590,10745,10690,80,25,293130,"1,567,343.02",253098
,20160111,10745,10690,10745,10890,10740,10815,10815,125,125,354386,"1,916,489.89",249752
,20160112,10815,10815,10805,10860,10565,10580,10735,-235,-80,455630,"2,445,608.00",270492
,20160113,10580,10735,10605,10660,10500,10595,10575,-140,-160,425636,"2,251,469.44",280248
,20160114,10595,10575,10565,10770,10555,10700,10660,125,85,279564,"1,490,386.54",264572
,20160115,10700,10660,10695,10750,10645,10650,10700,-10,40,194338,"1,039,995.86",261244
,20160118,10650,10700,10630,10795,10625,10725,10715,25,15,179042,"959,658.09",239268
,20160119,10725,10715,10715,10815,10700,10810,10745,95,30,154372,"829,712.71",229454
,20160120,10810,10745,10810,10820,10650,10690,10710,-55,-35,176180,"943,727.80",221784
,20160121,10690,10710,10685,10695,10615,10655,10655,-55,-55,121300,"646,522.69",223790
,20160122,10655,10655,10675,10815,10650,10815,10735,160,80,198820,"1,067,245.77",227416
,20160125,10815,10735,10835,10950,10680,10710,10785,-25,50,191878,"1,035,168.37",211656
,20160126,10710,10785,10725,10750,10685,10725,10720,-60,-65,84460,"452,807.50",203108
,20160127,10725,10720,10750,10835,10720,10785,10775,65,55,111832,"602,539.82",187974
,20160128,10785,10775,10790,10850,10735,10745,10800,-30,25,145400,"785,430.43",169980
,20160129,10745,10800,10750,10790,10690,10725,10735,-75,-65,83596,"448,779.35",159002
,20160201,10725,10735,10715,10800,10565,10620,10665,-115,-70,102854,"548,615.08",145084
,20160202,10620,10665,10625,10670,10590,10630,10630,-35,-35,44378,"235,888.13",139712
,20160203,10630,10630,10650,10705,10585,10675,10635,45,5,44244,"235,339.18",128554
,20160204,10675,10635,10695,10860,10650,10840,10745,205,110,57550,"309,308.41",117434
,20160205,10840,10745,10850,10850,10705,10740,10770,-5,25,29440,"158,540.10",111094
,20160215,10740,10770,10740,10835,10660,10820,10755,50,-15,17188,"92,431.82",107112
,20160216,10820,10755,10820,11005,10770,10985,10915,230,160,37538,"204,942.65",100008
,20160217,10985,10915,10985,11080,10850,10920,10970,5,55,34280,"188,075.20",90748
,20160218,10920,10970,10950,10990,10890,10925,10925,-45,-45,15330,"83,758.60",86652
,20160219,10925,10925,10925,11020,10885,10995,10970,70,45,18824,"103,295.73",85442
,20160222,10995,10970,11035,11200,10995,11145,11115,175,145,33692,"187,327.24",78640
,20160223,11145,11115,11145,11220,11095,11150,11140,35,25,21100,"117,540.46",73590
,20160224,11150,11140,11135,11140,11030,11085,11100,-55,-40,22108,"122,713.49",66700
,20160225,11085,11100,11070,11250,11070,11165,11190,65,90,25588,"143,176.65",62926
,20160226,11165,11190,11185,11270,11105,11205,11205,15,15,15228,"85,325.87",62690
,20160229,11205,11205,11105,11320,11105,11225,11240,20,35,12774,"71,804.06",58550
,20160301,11225,11240,11260,11260,11040,11130,11180,-110,-60,9260,"51,782.95",55010
,20160302,11130,11180,11175,11225,11075,11215,11155,35,-25,5250,"29,282.23",53640
,20160303,11215,11155,11215,11240,11180,11240,11205,85,50,4230,"23,707.23",52960
,20160304,11240,11205,11265,11350,11220,11330,11300,125,95,6320,"35,721.30",51380
,20160307,11330,11300,11280,11435,11215,11325,11315,25,15,8370,"47,358.00",49840
,20160308,11325,11315,11380,11415,11295,11380,11345,65,30,4510,"25,587.95",49860
,20160309,11380,11345,11320,11485,10980,11210,11215,-135,-130,9940,"55,740.75",49600
,20160310,11210,11215,11220,11295,11150,11200,11200,-15,-15,6130,"34,328.68",51160
,20160311,11200,11200,11160,11255,11150,11250,11230,50,30,2960,"16,621.75",50250
,20160314,11250,11230,11240,11305,11215,11225,11250,-5,20,3430,"19,300.25",50220
,20160315,11225,11250,11200,11265,11170,11220,11230,-30,-20,7000,"39,321.98",47500
al1604,20160104,10800,10780,10765,10785,10560,10595,10635,-185,-145,60026,"319,210.29",116200
,20160105,10595,10635,10550,10725,10400,10710,10615,75,-20,46666,"247,782.42",113172
,20160106,10710,10615,10650,10685,10585,10625,10630,10,15,34466,"183,257.01",117522
,20160107,10625,10630,10605,10680,10565,10625,10610,-5,-20,50068,"265,732.14",119068
,20160108,10625,10610,10605,10715,10530,10700,10645,90,35,73974,"393,796.83",124578
,20160111,10700,10645,10690,10815,10690,10755,10755,110,110,102390,"550,783.00",128242
,20160112,10755,10755,10725,10815,10535,10545,10700,-210,-55,126610,"677,432.86",135782
,20160113,10545,10700,10565,10620,10470,10575,10540,-125,-160,96994,"511,296.77",138738
,20160114,10575,10540,10535,10730,10525,10690,10635,150,95,79970,"425,294.25",137190
,20160115,10690,10635,10720,10730,10635,10645,10680,10,45,54306,"290,124.90",140720
,20160118,10645,10680,10610,10780,10610,10725,10710,45,30,63296,"339,090.70",144832
,20160119,10725,10710,10720,10815,10700,10805,10755,95,45,69054,"371,386.12",157712
,20160120,10805,10755,10795,10820,10670,10715,10720,-40,-35,50494,"270,759.32",158728
,20160121,10715,10720,10680,10720,10630,10675,10675,-45,-45,40166,"214,415.00",165134
,20160122,10675,10675,10670,10810,10670,10790,10735,115,60,69062,"370,834.97",173436
,20160125,10790,10735,10840,10905,10680,10710,10770,-25,35,68656,"369,731.64",178268
,20160126,10710,10770,10685,10745,10680,10710,10715,-60,-55,41904,"224,502.54",181892
,20160127,10710,10715,10740,10840,10710,10800,10775,85,60,68884,"371,204.24",193048
,20160128,10800,10775,10815,10870,10745,10760,10815,-15,40,86776,"469,290.86",207472
,20160129,10760,10815,10760,10810,10715,10755,10760,-60,-55,53342,"286,989.08",213990
,20160201,10755,10760,10760,10830,10590,10645,10690,-115,-70,116952,"625,131.11",230270
,20160202,10645,10690,10640,10705,10620,10675,10665,-15,-25,64828,"345,702.53",230296
,20160203,10675,10665,10700,10745,10635,10710,10680,45,15,105984,"566,158.76",219654
,20160204,10710,10680,10710,10930,10705,10900,10805,220,125,157238,"849,696.40",219032
,20160205,10900,10805,10890,10900,10785,10800,10835,-5,30,114566,"620,691.51",211336
,20160215,10800,10835,10750,10880,10715,10875,10815,40,-20,76200,"412,145.58",221772
,20160216,10875,10815,10880,11070,10830,11045,10970,230,155,282232,"1,548,494.19",257796
,20160217,11045,10970,11050,11120,10930,10980,11035,10,65,230950,"1,274,271.56",245582
,20160218,10980,11035,10990,11055,10945,10965,10985,-70,-50,122812,"674,792.38",247736
,20160219,10965,10985,10970,11085,10925,11060,11015,75,30,139926,"770,673.54",247286
,20160222,11060,11015,11090,11275,11055,11210,11165,195,150,220932,"1,233,551.86",250208
,20160223,11210,11165,11240,11285,11155,11225,11210,60,45,161226,"904,050.32",235416
,20160224,11225,11210,11205,11210,11085,11150,11145,-60,-65,140616,"783,765.08",221226
,20160225,11150,11145,11130,11325,11130,11230,11245,85,100,190750,"1,072,761.82",217282
,20160226,11230,11245,11290,11340,11170,11265,11265,20,20,218430,"1,230,308.66",209664
,20160229,11265,11265,11275,11400,11255,11265,11310,0,45,214978,"1,216,237.18",174414
,20160301,11265,11310,11300,11345,11020,11185,11210,-125,-100,151130,"847,246.08",145790
,20160302,11185,11210,11210,11285,11100,11270,11195,60,-15,91990,"514,968.82",133064
,20160303,11270,11195,11240,11305,11220,11295,11270,100,75,42518,"239,626.67",128276
,20160304,11295,11270,11290,11415,11270,11370,11340,100,70,59282,"336,272.51",120166
,20160307,11370,11340,11345,11550,11295,11385,11405,45,65,79778,"455,017.59",105788
,20160308,11385,11405,11415,11515,11340,11475,11420,70,15,41386,"236,372.98",99894
,20160309,11475,11420,11475,11475,10975,11295,11250,-125,-170,42840,"240,982.24",91940
,20160310,11295,11250,11295,11345,11205,11250,11265,0,15,18710,"105,405.17",86424
,20160311,11250,11265,11235,11310,11185,11300,11265,35,0,16398,"92,384.26",81590
,20160314,11300,11265,11290,11395,11260,11275,11305,10,40,26236,"148,323.04",74634
,20160315,11275,11305,11265,11300,11215,11265,11270,-40,-35,19362,"109,120.59",70912
,20160316,11265,11270,11230,11265,11180,11240,11240,-30,-30,16290,"91,562.75",68460
,20160317,11240,11240,11225,11335,11205,11325,11290,85,50,15284,"86,306.83",61218
,20160318,11325,11290,11320,11475,11310,11425,11410,135,120,19926,"113,713.18",57656
,20160321,11425,11410,11400,11545,11370,11450,11455,40,45,24798,"142,083.94",52548
,20160322,11450,11455,11460,11510,11435,11475,11480,20,25,17260,"99,096.39",49418
,20160323,11475,11480,11455,11500,11430,11470,11470,-10,-10,11258,"64,589.77",45960
,20160324,11470,11470,11470,11615,11430,11510,11525,40,55,18828,"108,518.87",45432
,20160325,11510,11525,11495,11690,11495,11660,11625,135,100,18848,"109,570.56",46170
,20160328,11660,11625,11690,11800,11650,11700,11735,75,110,15970,"93,726.10",43292
,20160329,11700,11735,11710,11840,11670,11720,11775,-15,40,11626,"68,470.44",39064
,20160330,11720,11775,11725,11750,11650,11700,11700,-75,-75,9310,"54,481.79",38538
,20160331,11700,11700,11680,11780,11680,11715,11715,15,15,10602,"62,115.40",35500
,20160401,11715,11715,11750,11880,11750,11855,11835,140,120,8000,"47,347.83",33250
,20160405,11855,11835,11875,11910,11840,11850,11875,15,40,7170,"42,572.50",33010
,20160406,11850,11875,11840,11860,11710,11730,11805,-145,-70,9650,"56,968.88",32740
,20160407,11730,11805,11715,11775,11700,11740,11730,-65,-75,8790,"51,562.70",32700
,20160408,11740,11730,11680,11700,11535,11660,11655,-70,-75,7200,"41,959.90",32660
,20160411,11660,11655,11705,11795,11700,11775,11760,120,105,6280,"36,932.85",33660
,20160412,11775,11760,11785,11790,11750,11765,11770,5,10,6410,"37,726.80",35300
,20160413,11765,11770,11800,12000,11800,11915,11915,145,145,3850,"22,940.85",33920
,20160414,11915,11915,12010,12020,11845,11865,11870,-50,-45,6750,"40,074.50",30220
,20160415,11865,11870,11800,11985,11800,11880,11860,10,-10,7700,"45,673.53",26160
al1605,20160104,10785,10785,10745,10760,10550,10570,10615,-215,-170,31980,"169,764.12",99606
,20160105,10570,10615,10635,10700,10495,10700,10590,85,-25,36990,"195,896.33",103064
,20160106,10700,10590,10670,10670,10565,10600,10610,10,20,18498,"98,152.13",104574
,20160107,10600,10610,10585,10660,10540,10600,10595,-10,-15,25562,"135,436.95",105540
,20160108,10600,10595,10570,10695,10505,10680,10610,85,15,32042,"169,986.94",105462
,20160111,10680,10610,10680,10780,10670,10725,10730,115,120,47430,"254,577.11",104222
,20160112,10725,10730,10720,10795,10515,10525,10675,-205,-55,57052,"304,579.37",112548
,20160113,10525,10675,10555,10600,10460,10550,10525,-125,-150,52216,"274,872.47",121222
,20160114,10550,10525,10505,10705,10505,10665,10615,140,90,41528,"220,438.98",118520
,20160115,10665,10615,10645,10720,10630,10635,10675,20,60,27054,"144,452.97",121622
,20160118,10635,10675,10630,10780,10610,10730,10710,55,35,27502,"147,312.08",121606
,20160119,10730,10710,10710,10825,10705,10810,10770,100,60,33718,"181,615.48",124174
,20160120,10810,10770,10805,10815,10700,10735,10740,-35,-30,25042,"134,525.25",123246
,20160121,10735,10740,10710,10740,10650,10690,10695,-50,-45,18176,"97,222.45",125380
,20160122,10690,10695,10700,10810,10695,10785,10750,90,55,31018,"166,761.36",128878
,20160125,10785,10750,10860,10935,10685,10715,10765,-35,15,39510,"212,680.78",132948
,20160126,10715,10765,10715,10745,10690,10715,10715,-50,-50,22086,"118,348.75",132408
,20160127,10715,10715,10750,10840,10715,10820,10780,105,65,41620,"224,404.45",138676
,20160128,10820,10780,10815,10880,10760,10770,10830,-10,50,50358,"272,742.59",149644
,20160129,10770,10830,10760,10820,10735,10775,10770,-55,-60,26674,"143,672.16",152440
,20160201,10775,10770,10800,10850,10615,10660,10710,-110,-60,46010,"246,412.78",155874
,20160202,10660,10710,10665,10735,10650,10710,10690,0,-20,22856,"122,204.93",155214
,20160203,10710,10690,10720,10770,10670,10740,10715,50,25,32026,"171,621.97",155504
,20160204,10740,10715,10740,10965,10735,10940,10835,225,120,50594,"274,213.02",150362
,20160205,10940,10835,10940,10940,10830,10860,10875,25,40,39128,"212,774.95",142658
,20160215,10860,10875,10855,10925,10760,10920,10860,45,-15,31184,"169,352.23",146764
,20160216,10920,10860,10950,11110,10875,11070,11005,210,145,103062,"567,309.72",164974
,20160217,11070,11005,11065,11150,10980,11030,11070,25,65,95066,"526,310.42",171428
,20160218,11030,11070,11030,11095,10990,11010,11025,-60,-45,51274,"282,744.32",174374
,20160219,11010,11025,11000,11125,10970,11105,11060,80,35,71612,"396,108.49",178994
,20160222,11105,11060,11125,11330,11105,11255,11215,195,155,108118,"606,388.42",188100
,20160223,11255,11215,11275,11350,11200,11260,11260,45,45,100560,"566,384.48",196804
,20160224,11260,11260,11260,11260,11130,11180,11190,-80,-70,86254,"482,671.44",201282
,20160225,11180,11190,11180,11370,11180,11280,11290,90,100,113034,"638,170.25",206674
,20160226,11280,11290,11330,11375,11215,11290,11300,0,10,111354,"629,350.77",216438
,20160229,11290,11300,11310,11420,11290,11300,11350,0,50,150710,"855,620.41",225128
,20160301,11300,11350,11360,11375,11120,11225,11245,-125,-105,170132,"956,959.31",236644
,20160302,11225,11245,11260,11340,11155,11325,11255,80,10,181264,"1,020,271.66",251728
,20160303,11325,11255,11305,11370,11280,11365,11330,110,75,126498,"716,666.89",250702
,20160304,11365,11330,11365,11485,11330,11435,11410,105,80,227818,"1,299,825.33",249040
,20160307,11435,11410,11430,11645,11365,11455,11475,45,65,353800,"2,030,560.30",258844
,20160308,11455,11475,11475,11595,11410,11535,11500,60,25,324148,"1,864,410.57",251428
,20160309,11535,11500,11535,11545,11055,11370,11335,-130,-165,296444,"1,680,828.45",241844
,20160310,11370,11335,11355,11415,11265,11315,11335,-20,0,168332,"954,179.63",235698
,20160311,11315,11335,11300,11375,11245,11375,11315,40,-20,145504,"823,341.39",230998
,20160314,11375,11315,11335,11455,11320,11335,11375,20,60,141928,"807,484.02",232508
,20160315,11335,11375,11310,11355,11270,11300,11315,-75,-60,125840,"712,045.24",231462
,20160316,11300,11315,11245,11305,11200,11275,11265,-40,-50,110250,"621,140.30",229948
,20160317,11275,11265,11230,11365,11230,11340,11305,75,40,94516,"534,462.03",223070
,20160318,11340,11305,11325,11500,11320,11455,11435,150,130,158696,"907,586.07",224098
,20160321,11455,11435,11425,11580,11400,11485,11485,50,50,154720,"888,728.38",223520
,20160322,11485,11485,11530,11550,11470,11515,11515,30,30,94936,"546,732.14",224414
,20160323,11515,11515,11495,11545,11460,11500,11505,-15,-10,95008,"546,753.85",210446
,20160324,11500,11505,11495,11640,11465,11525,11540,20,35,241820,"1,395,682.86",190994
,20160325,11525,11540,11520,11715,11510,11700,11640,160,100,174076,"1,013,335.49",211914
,20160328,11700,11640,11720,11830,11680,11740,11760,100,120,164850,"969,343.95",211640
,20160329,11740,11760,11750,11880,11700,11755,11810,-5,50,183126,"1,081,467.89",211004
,20160330,11755,11810,11775,11780,11690,11740,11735,-70,-75,107466,"630,626.69",199590
,20160331,11740,11735,11720,11810,11700,11775,11755,40,20,115298,"677,857.63",182842
,20160401,11775,11755,11770,11920,11770,11890,11850,135,95,106450,"630,934.20",167150
,20160405,11890,11850,11890,11990,11855,11870,11900,20,50,62150,"369,936.89",159788
,20160406,11870,11900,11825,11920,11740,11765,11835,-135,-65,65850,"389,751.30",140262
,20160407,11765,11835,11745,11805,11725,11760,11755,-75,-80,55458,"325,976.30",121064
,20160408,11760,11755,11740,11740,11525,11640,11645,-115,-110,47628,"277,412.78",107774
,20160411,11640,11645,11665,11810,11665,11785,11760,140,115,29822,"175,386.43",100352
,20160412,11785,11760,11785,11810,11760,11780,11785,20,25,16888,"99,523.07",93204
,20160413,11780,11785,11815,12045,11815,11930,11950,145,165,43066,"257,373.21",85452
,20160414,11930,11950,11955,12035,11890,11925,11960,-25,10,29572,"176,913.99",78030
,20160415,11925,11960,11980,12045,11885,11930,11925,-30,-35,16584,"98,904.18",73676
,20160418,11930,11925,11920,11980,11800,11940,11925,15,0,15700,"93,620.16",70406
,20160419,11940,11925,11960,12025,11940,12020,11985,95,60,20892,"125,206.90",62284
,20160420,12020,11985,12020,12100,12015,12070,12055,85,70,22958,"138,429.18",56246
,20160421,12070,12055,12105,12500,12105,12400,12305,345,250,37012,"227,757.85",54924
,20160422,12400,12305,12425,12795,12240,12785,12525,480,220,43952,"275,331.98",50602
,20160425,12785,12525,12815,13025,12680,12830,12850,305,325,23976,"154,062.68",47304
,20160426,12830,12850,12860,12915,12715,12775,12800,-75,-50,15860,"101,526.24",45594
,20160427,12775,12800,12775,12930,12745,12800,12815,0,15,14200,"90,993.70",42474
,20160428,12800,12815,12810,12895,12470,12480,12620,-335,-195,18798,"118,647.20",41846
,20160429,12480,12620,12545,12820,12470,12740,12615,120,-5,7788,"49,137.48",38870
,20160503,12740,12615,12705,12830,12700,12810,12770,195,155,6730,"42,974.40",39580
,20160504,12810,12770,12740,12780,12575,12575,12615,-195,-155,8480,"53,506.85",40540
,20160505,12575,12615,12600,12630,12520,12555,12585,-60,-30,7970,"50,159.03",40500
,20160506,12555,12585,12610,12620,12320,12440,12410,-145,-175,5580,"34,626.38",38620
,20160509,12440,12410,12430,12545,12115,12165,12330,-245,-80,5950,"36,688.35",35930
,20160510,12165,12330,12110,12120,11900,11970,11995,-360,-335,4410,"26,454.40",34770
,20160511,11970,11995,11965,12135,11925,12125,12020,130,25,6040,"36,313.33",33520
,20160512,12125,12020,12000,12250,12000,12200,12150,180,130,2000,"12,152.33",33050
,20160513,12200,12150,12155,12220,11950,12185,12130,35,-20,5030,"30,517.70",31150
,20160516,12185,12130,12200,12420,12165,12365,12320,235,190,6130,"37,774.85",27170
al1606,20160104,10775,10765,10765,10765,10550,10570,10610,-195,-155,10074,"53,464.96",52536
,20160105,10570,10610,10525,10690,10495,10685,10590,75,-20,11688,"61,916.62",55042
,20160106,10685,10590,10650,10660,10565,10595,10605,5,15,5776,"30,629.49",56346
,20160107,10595,10605,10575,10650,10540,10590,10590,-15,-15,5396,"28,575.61",57620
,20160108,10590,10590,10590,10690,10505,10675,10615,85,25,8242,"43,751.17",58624
,20160111,10675,10615,10685,10770,10665,10740,10730,125,115,11192,"60,052.18",60916
,20160112,10740,10730,10710,10785,10520,10520,10670,-210,-60,12414,"66,250.66",63556
,20160113,10520,10670,10550,10605,10470,10555,10525,-115,-145,15424,"81,197.46",65488
,20160114,10555,10525,10540,10705,10520,10665,10620,140,95,9146,"48,575.94",65668
,20160115,10665,10620,10665,10730,10635,10650,10685,30,65,8608,"45,997.85",66060
,20160118,10650,10685,10610,10775,10605,10740,10730,55,45,9070,"48,660.67",65544
,20160119,10740,10730,10740,10830,10710,10830,10785,100,55,14294,"77,116.13",66394
,20160120,10830,10785,10820,10835,10720,10755,10755,-30,-30,8910,"47,931.95",68952
,20160121,10755,10755,10770,10770,10670,10710,10710,-45,-45,7530,"40,339.46",71320
,20160122,10710,10710,10720,10820,10705,10800,10750,90,40,9610,"51,655.89",72146
,20160125,10800,10750,10860,10905,10700,10725,10775,-25,25,10626,"57,262.27",74876
,20160126,10725,10775,10730,10755,10705,10725,10730,-50,-45,5920,"31,767.65",75958
,20160127,10725,10730,10750,10845,10730,10830,10790,100,60,8272,"44,646.09",77482
,20160128,10830,10790,10835,10890,10775,10795,10835,5,45,14896,"80,725.99",79938
,20160129,10795,10835,10790,10835,10750,10790,10775,-45,-60,10832,"58,376.86",82380
,20160201,10790,10775,10815,10860,10640,10690,10720,-85,-55,14964,"80,218.86",84526
,20160202,10690,10720,10680,10755,10675,10740,10720,20,0,6484,"34,761.68",85764
,20160203,10740,10720,10740,10790,10715,10770,10745,50,25,9786,"52,584.42",85464
,20160204,10770,10745,10770,10975,10770,10965,10870,220,125,19730,"107,265.08",83502
,20160205,10965,10870,10965,11020,10855,10890,10900,20,30,11316,"61,693.80",84180
,20160215,10890,10900,10890,10955,10795,10945,10895,45,-5,13846,"75,454.43",89894
,20160216,10945,10895,10945,11135,10915,11100,11025,205,130,34784,"191,805.22",96788
,20160217,11100,11025,11100,11180,11020,11060,11105,35,80,35126,"195,102.38",101562
,20160218,11060,11105,11060,11125,11025,11035,11055,-70,-50,14626,"80,863.41",103224
,20160219,11035,11055,11020,11155,11010,11135,11095,80,40,29862,"165,728.70",107400
,20160222,11135,11095,11135,11365,11135,11295,11270,200,175,38808,"218,754.20",118076
,20160223,11295,11270,11300,11400,11245,11310,11300,40,30,29708,"167,857.12",125050
,20160224,11310,11300,11275,11280,11170,11230,11230,-70,-70,31278,"175,684.96",132166
,20160225,11230,11230,11230,11400,11215,11320,11335,90,105,34550,"195,831.13",139478
,20160226,11320,11335,11370,11400,11255,11310,11335,-25,0,37396,"211,992.52",146858
,20160229,11310,11335,11320,11445,11320,11325,11390,-10,55,49186,"280,221.03",145062
,20160301,11325,11390,11345,11415,11190,11270,11285,-120,-105,43806,"247,238.36",144334
,20160302,11270,11285,11310,11375,11200,11360,11305,75,20,32574,"184,129.15",148892
,20160303,11360,11305,11345,11410,11325,11400,11370,95,65,26390,"150,053.13",152970
,20160304,11400,11370,11405,11530,11380,11490,11460,120,90,47328,"271,273.27",153122
,20160307,11490,11460,11480,11685,11420,11490,11525,30,65,85976,"495,543.36",164608
,20160308,11490,11525,11550,11640,11460,11590,11550,65,25,85686,"494,875.57",170396
,20160309,11590,11550,11575,11590,11140,11430,11395,-120,-155,86728,"494,289.14",170830
,20160310,11430,11395,11410,11465,11325,11370,11390,-25,-5,46874,"267,009.23",171188
,20160311,11370,11390,11360,11420,11300,11420,11365,30,-25,46264,"262,896.15",170310
,20160314,11420,11365,11370,11500,11370,11395,11430,30,65,50100,"286,347.49",174498
,20160315,11395,11430,11390,11395,11320,11345,11355,-85,-75,42020,"238,669.21",175904
,20160316,11345,11355,11270,11340,11220,11295,11295,-60,-60,45612,"257,656.79",182262
,20160317,11295,11295,11270,11380,11260,11360,11330,65,35,39052,"221,308.72",182232
,20160318,11360,11330,11360,11515,11350,11480,11445,150,115,62970,"360,408.03",184898
,20160321,11480,11445,11470,11595,11415,11510,11505,65,60,74480,"428,627.85",182852
,20160322,11510,11505,11530,11570,11485,11530,11525,25,20,51330,"295,900.71",183106
,20160323,11530,11525,11490,11560,11480,11510,11525,-15,0,45312,"261,156.28",183200
,20160324,11510,11525,11510,11630,11475,11525,11535,0,10,106850,"616,503.32",180362
,20160325,11525,11535,11495,11680,11490,11680,11615,145,80,75884,"440,829.65",193044
,20160328,11680,11615,11680,11785,11650,11715,11725,100,110,71996,"422,088.24",201752
,20160329,11715,11725,11730,11840,11625,11715,11770,-10,45,84034,"494,601.30",205874
,20160330,11715,11770,11720,11745,11660,11705,11705,-65,-65,63162,"369,686.71",205598
,20160331,11705,11705,11700,11780,11675,11750,11735,45,30,88830,"521,244.72",223770
,20160401,11750,11735,11765,11900,11750,11865,11830,130,95,104802,"620,099.71",242438
,20160405,11865,11830,11870,11940,11830,11850,11875,20,45,83516,"495,955.43",245412
,20160406,11850,11875,11825,11910,11750,11765,11830,-110,-45,149362,"883,610.66",251514
,20160407,11765,11830,11765,11815,11745,11780,11770,-50,-60,121118,"713,066.62",256784
,20160408,11780,11770,11750,11755,11520,11635,11665,-135,-105,162978,"950,584.71",260446
,20160411,11635,11665,11670,11820,11665,11775,11755,110,90,143912,"846,086.57",272308
,20160412,11775,11755,11750,11820,11750,11785,11790,30,35,87924,"518,352.63",277386
,20160413,11785,11790,11835,12075,11825,11945,11960,155,170,274114,"1,639,557.67",281384
,20160414,11945,11960,12000,12070,11915,11960,11995,0,35,168504,"1,010,801.43",281402
,20160415,11960,11995,11995,12020,11925,11960,11960,-35,-35,131570,"786,993.85",278472
,20160418,11960,11960,11950,12010,11830,11955,11950,-5,-10,140130,"837,397.69",276302
,20160419,11955,11950,12000,12045,11955,12035,11995,85,45,126866,"761,194.99",268162
,20160420,12035,11995,12055,12120,12025,12075,12065,80,70,149904,"904,634.99",249360
,20160421,12075,12065,12115,12540,12115,12400,12315,335,250,339418,"2,090,310.74",247488
,20160422,12400,12315,12450,12805,12260,12805,12575,490,260,548556,"3,449,341.90",271754
,20160425,12805,12575,12850,13075,12700,12885,12900,310,325,525606,"3,390,946.48",255694
,20160426,12885,12900,12900,12955,12740,12790,12840,-110,-60,258076,"1,656,954.47",252650
,20160427,12790,12840,12810,12980,12765,12820,12850,-20,10,225278,"1,447,487.09",236148
,20160428,12820,12850,12865,12940,12445,12485,12650,-365,-200,482322,"3,051,757.02",181802
,20160429,12485,12650,12555,12730,12480,12705,12620,55,-30,188466,"1,189,449.96",161704
,20160503,12705,12620,12670,12840,12665,12805,12760,185,140,79498,"507,378.67",157504
,20160504,12805,12760,12770,12785,12490,12520,12610,-240,-150,84000,"529,730.17",142436
,20160505,12520,12610,12535,12600,12450,12500,12535,-110,-75,62422,"391,328.44",137576
,20160506,12500,12535,12495,12575,12255,12390,12380,-145,-155,68242,"422,525.75",129742
,20160509,12390,12380,12390,12525,12055,12090,12240,-290,-140,78212,"478,844.12",118812
,20160510,12090,12240,12095,12150,11835,11945,11960,-295,-280,64224,"384,103.59",106938
,20160511,11945,11960,11940,12150,11910,12135,12010,175,50,35674,"214,284.07",101744
,20160512,12135,12010,12145,12265,12050,12180,12155,170,145,34394,"209,115.36",95872
,20160513,12180,12155,12135,12180,11900,12130,12070,-25,-85,52780,"318,649.40",95436
,20160516,12130,12070,12130,12335,12070,12290,12215,220,145,32864,"200,726.45",89472
,20160517,12290,12215,12280,12495,12265,12495,12415,280,200,27134,"168,472.27",84190
,20160518,12495,12415,12455,12530,12340,12360,12440,-55,25,25124,"156,274.31",80476
,20160519,12360,12440,12370,12465,12305,12390,12395,-50,-45,20976,"130,043.79",75394
,20160520,12390,12395,12390,12515,12340,12510,12440,115,45,14708,"91,484.48",71348
,20160523,12510,12440,12535,12625,12325,12380,12445,-60,5,25396,"158,061.56",69010
,20160524,12380,12445,12390,12435,12060,12365,12370,-80,-75,22208,"137,411.70",64404
,20160525,12365,12370,12410,12470,12110,12155,12225,-215,-145,33860,"207,035.06",63996
,20160526,12155,12225,12170,12320,12025,12315,12150,90,-75,20854,"126,736.13",61236
,20160527,12315,12150,12325,12475,12205,12410,12345,260,195,29552,"182,418.68",59746
,20160530,12410,12345,12410,12540,12350,12505,12470,160,125,17230,"107,471.55",56780
,20160531,12505,12470,12515,12595,12470,12500,12545,30,75,14506,"91,011.87",53042
,20160601,12500,12545,12530,12530,12350,12360,12445,-185,-100,7882,"49,049.16",51790
,20160602,12360,12445,12360,12510,12345,12480,12445,35,0,5230,"32,547.53",50490
,20160603,12480,12445,12435,12470,12320,12370,12365,-75,-80,7840,"48,476.15",46410
,20160606,12370,12365,12420,12435,12240,12240,12335,-125,-30,8760,"54,045.78",39640
,20160607,12240,12335,12260,12290,12115,12140,12175,-195,-160,10340,"62,950.75",32450
,20160608,12140,12175,12120,12255,12080,12255,12195,80,20,5830,"35,551.13",27910
,20160613,12255,12195,12255,12265,12195,12195,12215,0,20,5060,"30,916.13",23320
,20160614,12195,12215,12190,12300,12130,12185,12195,-30,-20,6450,"39,330.30",19100
,20160615,12185,12195,12350,12350,12080,12130,12230,-65,35,7150,"43,735.80",13580
al1607,20160104,10785,10770,10725,10750,10560,10570,10610,-200,-160,2992,"15,872.63",18032
,20160105,10570,10610,10540,10695,10510,10685,10605,75,-5,2990,"15,859.07",19304
,20160106,10685,10605,10675,10675,10570,10595,10600,-10,-5,1182,"6,265.82",19788
,20160107,10595,10600,10575,10625,10550,10595,10585,-5,-15,1104,"5,845.21",19922
,20160108,10595,10585,10605,10695,10520,10675,10605,90,20,1332,"7,064.20",20340
,20160111,10675,10605,10710,10770,10680,10735,10745,130,140,2276,"12,232.97",21846
,20160112,10735,10745,10730,10800,10530,10540,10690,-205,-55,3002,"16,052.56",22506
,20160113,10540,10690,10595,10610,10480,10570,10535,-120,-155,2008,"10,577.79",23504
,20160114,10570,10535,10570,10730,10530,10670,10610,135,75,622,"3,300.04",23550
,20160115,10670,10610,10655,10735,10645,10650,10685,40,75,586,"3,131.93",23366
,20160118,10650,10685,10655,10780,10645,10745,10740,60,55,932,"5,006.40",22956
,20160119,10745,10740,10745,10845,10730,10835,10810,95,70,3774,"20,401.19",22192
,20160120,10835,10810,10825,10830,10730,10770,10760,-40,-50,1476,"7,943.25",22486
,20160121,10770,10760,10750,10775,10695,10725,10715,-35,-45,1886,"10,107.82",23188
,20160122,10725,10715,10740,10835,10720,10820,10780,105,65,918,"4,949.04",23316
,20160125,10820,10780,10865,10955,10715,10735,10790,-45,10,2202,"11,880.60",24074
,20160126,10735,10790,10735,10755,10725,10740,10740,-50,-50,3776,"20,285.26",24556
,20160127,10740,10740,10755,10855,10740,10825,10780,85,40,1912,"10,308.64",24860
,20160128,10825,10780,10830,10900,10780,10800,10855,20,75,2808,"15,242.68",25366
,20160129,10800,10855,10775,10830,10760,10805,10770,-50,-85,2654,"14,295.40",26948
,20160201,10805,10770,10820,10860,10660,10720,10725,-50,-45,1076,"5,771.74",26992
,20160202,10720,10725,10705,10765,10695,10760,10735,35,10,1954,"10,492.87",26732
,20160203,10760,10735,10770,10810,10735,10790,10775,55,40,3098,"16,692.51",26630
,20160204,10790,10775,10795,11000,10795,11000,10890,225,115,4014,"21,859.71",26736
,20160205,11000,10890,10920,10965,10875,10915,10925,25,35,2774,"15,155.72",26752
,20160215,10915,10925,10880,10985,10835,10970,10920,45,-5,2916,"15,925.58",28040
,20160216,10970,10920,10970,11160,10950,11125,11055,205,135,8436,"46,646.95",29086
,20160217,11125,11055,11125,11200,11050,11090,11145,35,90,8490,"47,329.53",31034
,20160218,11090,11145,11090,11155,11050,11060,11080,-85,-65,4588,"25,426.34",32144
,20160219,11060,11080,11060,11180,11035,11165,11130,85,50,9498,"52,876.14",33888
,20160222,11165,11130,11165,11395,11165,11345,11275,215,145,19574,"110,396.29",36084
,20160223,11345,11275,11345,11425,11285,11340,11340,65,65,11868,"67,298.02",38034
,20160224,11340,11340,11340,11340,11210,11270,11275,-70,-65,11282,"63,617.60",41730
,20160225,11270,11275,11270,11440,11260,11350,11370,75,95,8018,"45,593.70",41672
,20160226,11350,11370,11380,11430,11290,11355,11370,-15,0,7284,"41,417.22",42178
,20160229,11355,11370,11375,11475,11360,11370,11425,0,55,22508,"128,582.05",46228
,20160301,11370,11425,11395,11445,11225,11305,11325,-120,-100,12682,"71,834.13",49118
,20160302,11305,11325,11315,11410,11240,11390,11345,65,20,14598,"82,814.86",52914
,20160303,11390,11345,11390,11485,11365,11445,11410,100,65,6890,"39,320.75",53058
,20160304,11445,11410,11440,11565,11420,11535,11495,125,85,22858,"131,385.62",58696
,20160307,11535,11495,11535,11710,11460,11545,11565,50,70,23790,"137,600.22",63240
,20160308,11545,11565,11545,11680,11515,11645,11600,80,35,21710,"125,931.06",66914
,20160309,11645,11600,11645,11645,11205,11470,11450,-130,-150,21188,"121,324.59",71560
,20160310,11470,11450,11470,11505,11370,11405,11430,-45,-20,13612,"77,808.41",73540
,20160311,11405,11430,11395,11460,11355,11460,11415,30,-15,11488,"65,586.19",76312
,20160314,11460,11415,11420,11535,11410,11440,11475,25,60,13238,"75,965.50",79748
,20160315,11440,11475,11440,11440,11360,11380,11390,-95,-85,11156,"63,552.58",81268
,20160316,11380,11390,11360,11370,11290,11320,11325,-70,-65,15882,"89,939.93",84478
,20160317,11320,11325,11295,11400,11285,11380,11360,55,35,14964,"85,009.88",88592
,20160318,11380,11360,11380,11530,11365,11475,11460,115,100,16290,"93,376.06",90894
,20160321,11475,11460,11465,11600,11420,11520,11500,60,40,20794,"119,597.92",97746
,20160322,11520,11500,11520,11570,11485,11540,11525,40,25,20720,"119,412.05",100904
,20160323,11540,11525,11525,11570,11480,11520,11540,-5,15,18158,"104,789.83",102540
,20160324,11520,11540,11525,11620,11480,11520,11545,-20,5,45348,"261,827.44",116532
,20160325,11520,11545,11500,11660,11485,11640,11605,95,60,27826,"161,515.09",123508
,20160328,11640,11605,11640,11745,11625,11690,11690,85,85,30136,"176,162.61",129260
,20160329,11690,11690,11705,11810,11630,11675,11745,-15,55,30324,"178,082.89",131390
,20160330,11675,11745,11675,11710,11630,11680,11670,-65,-75,20312,"118,556.16",134230
,20160331,11680,11670,11680,11750,11655,11720,11710,50,40,19244,"112,688.07",133632
,20160401,11720,11710,11720,11870,11720,11820,11815,110,105,22360,"132,096.31",136228
,20160405,11820,11815,11880,11905,11800,11810,11840,-5,25,21626,"128,062.50",140568
,20160406,11810,11840,11790,11885,11740,11760,11815,-80,-25,31266,"184,781.15",147296
,20160407,11760,11815,11760,11805,11735,11770,11765,-45,-50,27082,"159,365.04",148964
,20160408,11770,11765,11755,11755,11555,11630,11655,-135,-110,37772,"220,158.74",154252
,20160411,11630,11655,11670,11800,11660,11755,11735,100,80,34788,"204,190.21",155946
,20160412,11755,11735,11745,11800,11740,11770,11770,35,35,29870,"175,847.37",161930
,20160413,11770,11770,11795,12055,11795,11940,11945,170,175,88504,"528,636.23",170870
,20160414,11940,11945,11980,12060,11910,11960,11975,15,30,71566,"428,573.25",177110
,20160415,11960,11975,11995,12015,11930,11960,11965,-15,-10,44238,"264,665.72",182694
,20160418,11960,11965,11960,12000,11835,11960,11950,-5,-15,53856,"321,796.83",186968
,20160419,11960,11950,11995,12035,11955,12025,11995,75,45,46720,"280,266.59",187992
,20160420,12025,11995,12045,12095,12015,12060,12055,65,60,71292,"429,876.74",189454
,20160421,12060,12055,12100,12490,12095,12395,12280,340,225,161482,"991,734.24",204912
,20160422,12395,12280,12450,12770,12240,12760,12535,480,255,294684,"1,847,555.76",232438
,20160425,12760,12535,12830,13035,12625,12830,12860,295,325,353218,"2,271,769.58",232640
,20160426,12830,12860,12865,12895,12695,12755,12785,-105,-75,155478,"994,184.65",243684
,20160427,12755,12785,12750,12950,12725,12790,12820,5,35,165232,"1,059,265.85",269178
,20160428,12790,12820,12830,12915,12430,12480,12630,-340,-190,373434,"2,359,154.48",279362
,20160429,12480,12630,12560,12710,12470,12680,12605,50,-25,159098,"1,002,999.60",284564
,20160503,12680,12605,12660,12820,12660,12755,12735,150,130,111152,"707,996.50",285618
,20160504,12755,12735,12715,12740,12455,12475,12570,-260,-165,207928,"1,307,138.19",283696
,20160505,12475,12570,12505,12570,12400,12455,12495,-115,-75,161326,"1,008,103.87",280228
,20160506,12455,12495,12490,12535,12200,12340,12340,-155,-155,274898,"1,696,749.74",270046
,20160509,12340,12340,12315,12490,11980,12055,12215,-285,-125,254028,"1,551,490.70",264462
,20160510,12055,12215,12080,12080,11770,11910,11905,-305,-310,240472,"1,431,760.56",249230
,20160511,11910,11905,11875,12130,11875,12120,12000,215,95,189674,"1,138,233.10",252526
,20160512,12120,12000,12145,12245,12050,12170,12145,170,145,190054,"1,154,261.76",253558
,20160513,12170,12145,12080,12165,11855,12070,12015,-75,-130,252344,"1,516,400.89",256480
,20160516,12070,12015,12070,12290,12015,12225,12160,210,145,211712,"1,287,518.96",270528
,20160517,12225,12160,12220,12440,12195,12435,12360,275,200,219754,"1,358,260.69",278820
,20160518,12435,12360,12365,12460,12260,12270,12360,-90,0,191306,"1,182,297.26",273490
,20160519,12270,12360,12305,12400,12220,12325,12330,-35,-30,181804,"1,121,079.29",266412
,20160520,12325,12330,12285,12445,12265,12435,12360,105,30,154288,"953,764.83",266834
,20160523,12435,12360,12485,12560,12225,12275,12370,-85,10,229128,"1,417,327.46",258762
,20160524,12275,12370,12310,12350,12135,12270,12285,-100,-85,171758,"1,055,298.53",253582
,20160525,12270,12285,12355,12380,11995,12065,12145,-220,-140,302810,"1,839,207.24",233592
,20160526,12065,12145,12095,12195,11900,12185,12040,40,-105,292252,"1,759,689.68",218172
,20160527,12185,12040,12210,12265,12005,12220,12145,180,105,271156,"1,646,971.82",211172
,20160530,12220,12145,12200,12345,12170,12295,12255,150,110,180440,"1,106,057.01",210776
,20160531,12295,12255,12325,12370,12225,12260,12305,5,50,148640,"914,656.58",197334
,20160601,12260,12305,12290,12300,12065,12090,12180,-215,-125,138866,"845,994.92",179966
,20160602,12090,12180,12125,12315,12060,12305,12210,125,30,150508,"919,209.28",168862
,20160603,12305,12210,12240,12280,12030,12095,12135,-115,-75,101520,"616,023.99",164718
,20160606,12095,12135,12195,12195,11930,11955,12065,-180,-70,84798,"511,685.54",165186
,20160607,11955,12065,11990,12025,11815,11850,11900,-215,-165,78346,"466,283.15",154294
,20160608,11850,11900,11850,12045,11780,12025,11905,125,5,58136,"346,176.08",139494
,20160613,12025,11905,12005,12125,11910,11990,11995,85,90,30016,"180,075.23",138534
,20160614,11990,11995,12020,12180,11930,12000,12055,5,60,44700,"269,433.13",131582
,20160615,12000,12055,12010,12040,11925,12035,11990,-20,-65,24216,"145,188.11",128100
,20160616,12035,11990,12065,12135,12045,12065,12080,75,90,22494,"135,864.96",125206
,20160617,12065,12080,12030,12155,11995,12135,12095,55,15,19682,"119,049.19",119602
,20160620,12135,12095,12120,12295,12080,12265,12185,170,90,29706,"180,992.78",111144
,20160621,12265,12185,12300,12420,12255,12410,12345,225,160,36462,"225,087.54",102404
,20160622,12410,12345,12435,12630,12380,12570,12535,225,190,48222,"302,308.95",89688
,20160623,12570,12535,12570,12620,12490,12550,12550,15,15,29042,"182,295.65",82882
,20160624,12550,12550,12560,12620,12380,12405,12515,-145,-35,31552,"197,472.61",76638
,20160627,12405,12515,12420,12670,12375,12565,12545,50,30,26914,"168,841.99",67888
,20160628,12565,12545,12545,12600,12495,12555,12550,10,5,19342,"121,415.89",61668
,20160629,12555,12550,12605,12625,12515,12560,12555,10,5,16642,"104,501.66",56508
,20160630,12560,12555,12560,12735,12505,12720,12635,165,80,20116,"127,096.47",48928
,20160701,12720,12635,12660,12950,12640,12950,12865,315,230,11878,"76,429.39",46800
,20160704,12950,12865,12990,13180,12880,12880,13005,15,140,10660,"69,336.83",43600
,20160705,12880,13005,12855,12915,12655,12790,12750,-215,-255,8060,"51,401.83",39410
,20160706,12790,12750,12840,12945,12690,12885,12840,135,90,7240,"46,488.48",38220
,20160707,12885,12840,12810,13020,12810,12930,12960,90,120,7840,"50,810.45",34930
,20160708,12930,12960,12920,13015,12850,13015,12935,55,-25,6900,"44,635.05",31370
,20160711,13015,12935,13005,13115,13000,13060,13075,125,140,6720,"43,932.38",29470
,20160712,13060,13075,13085,13105,12910,12955,13020,-120,-55,5380,"35,028.85",25730
,20160713,12955,13020,13000,13055,12960,12960,13025,-60,5,9560,"62,262.40",17020
,20160714,12960,13025,13020,13030,12960,13015,12980,-10,-45,6470,"42,005.70",11100
,20160715,13015,12980,12980,13020,12900,12955,12955,-25,-25,5140,"33,298.18",7360
al1608,20160104,10790,10775,10620,10640,10575,10605,10600,-170,-175,674,"3,573.74",6438
,20160105,10605,10600,10515,10665,10515,10660,10595,60,-5,524,"2,776.32",6464
,20160106,10660,10595,10615,10640,10580,10605,10600,10,5,316,"1,674.97",6696
,20160107,10605,10600,10580,10620,10565,10615,10590,15,-10,342,"1,811.40",6886
,20160108,10615,10590,10610,10695,10530,10680,10605,90,15,602,"3,193.02",7126
,20160111,10680,10605,10730,10770,10670,10750,10750,145,145,880,"4,730.25",7572
,20160112,10750,10750,10750,10800,10550,10570,10690,-180,-60,1178,"6,298.89",8118
,20160113,10570,10690,10570,10595,10490,10580,10540,-110,-150,2220,"11,704.12",9362
,20160114,10580,10540,10570,10730,10540,10680,10640,140,100,326,"1,734.67",9454
,20160115,10680,10640,10675,10730,10670,10670,10700,30,60,546,"2,922.26",9460
,20160118,10670,10700,10650,10775,10650,10740,10710,40,10,238,"1,274.68",9484
,20160119,10740,10710,10745,10865,10720,10840,10820,130,110,3504,"18,956.86",10214
,20160120,10840,10820,10810,10815,10740,10780,10770,-40,-50,594,"3,198.88",10260
,20160121,10780,10770,10760,10780,10710,10730,10730,-40,-40,238,"1,277.23",10204
,20160122,10730,10730,10735,10850,10735,10815,10790,85,60,464,"2,503.81",9902
,20160125,10815,10790,10915,10940,10745,10750,10775,-40,-15,2370,"12,770.60",10392
,20160126,10750,10775,10750,10765,10735,10750,10750,-25,-25,2182,"11,733.41",12012
,20160127,10750,10750,10760,10860,10750,10825,10785,75,35,1212,"6,537.92",12980
,20160128,10825,10785,10845,10905,10800,10805,10865,20,80,2048,"11,126.33",13678
,20160129,10805,10865,10825,10845,10765,10815,10795,-50,-70,892,"4,815.56",13768
,20160201,10815,10795,10845,10860,10680,10720,10710,-75,-85,438,"2,346.14",13670
,20160202,10720,10710,10720,10780,10720,10770,10750,60,40,2712,"14,578.03",15428
,20160203,10770,10750,10795,10830,10755,10805,10800,55,50,3726,"20,122.28",17326
,20160204,10805,10800,10840,11030,10825,11030,10925,230,125,4676,"25,547.46",19042
,20160205,11030,10925,10955,10985,10910,10960,10950,35,25,884,"4,841.30",19280
,20160215,10960,10950,10895,11010,10885,11010,10955,60,5,250,"1,369.64",19300
,20160216,11010,10955,10995,11180,10985,11145,11100,190,145,1044,"5,794.98",19550
,20160217,11145,11100,11135,11215,11080,11125,11180,25,80,2852,"15,945.09",19902
,20160218,11125,11180,11110,11185,11065,11080,11105,-100,-75,2996,"16,640.26",20190
,20160219,11080,11105,11060,11195,11060,11180,11140,75,35,4344,"24,202.19",20204
,20160222,11180,11140,11210,11405,11190,11375,11355,235,215,12624,"71,681.53",15512
,20160223,11375,11355,11405,11445,11315,11365,11370,10,15,1016,"5,777.30",15602
,20160224,11365,11370,11340,11345,11245,11300,11305,-70,-65,4262,"24,099.84",16852
,20160225,11300,11305,11310,11470,11310,11375,11410,70,105,1726,"9,848.67",16732
,20160226,11375,11410,11425,11450,11320,11390,11415,-20,5,2182,"12,455.48",16270
,20160229,11390,11415,11425,11500,11390,11395,11450,-20,35,2648,"15,165.47",16282
,20160301,11395,11450,11455,11455,11270,11345,11340,-105,-110,5234,"29,678.63",17392
,20160302,11345,11340,11370,11445,11280,11440,11370,100,30,1572,"8,940.29",17618
,20160303,11440,11370,11430,11480,11405,11480,11435,110,65,1478,"8,452.92",17030
,20160304,11480,11435,11490,11600,11455,11575,11550,140,115,2194,"12,672.46",16944
,20160307,11575,11550,11525,11725,11500,11595,11610,45,60,3384,"19,644.47",16692
,20160308,11595,11610,11635,11720,11565,11680,11635,70,25,2166,"12,604.83",16906
,20160309,11680,11635,11675,11675,11180,11495,11490,-140,-145,3976,"22,845.97",17602
,20160310,11495,11490,11470,11550,11420,11460,11465,-30,-25,2850,"16,341.60",18774
,20160311,11460,11465,11440,11495,11400,11475,11440,10,-25,1208,"6,912.12",19060
,20160314,11475,11440,11480,11560,11460,11460,11505,20,65,2072,"11,920.68",19200
,20160315,11460,11505,11410,11450,11400,11410,11420,-95,-85,3044,"17,387.94",20514
,20160316,11410,11420,11355,11395,11330,11345,11350,-75,-70,3252,"18,461.32",21536
,20160317,11345,11350,11325,11415,11310,11400,11375,50,25,2682,"15,255.40",22052
,20160318,11400,11375,11405,11545,11400,11475,11495,100,120,5884,"33,829.89",23610
,20160321,11475,11495,11470,11610,11435,11540,11530,45,35,5044,"29,081.66",24134
,20160322,11540,11530,11525,11575,11500,11555,11540,25,10,10598,"61,168.13",25856
,20160323,11555,11540,11520,11590,11505,11540,11565,0,25,8538,"49,375.23",28214
,20160324,11540,11565,11525,11620,11490,11520,11570,-45,5,15876,"91,854.92",32372
,20160325,11520,11570,11510,11645,11510,11630,11595,60,25,14666,"85,041.80",39540
,20160328,11630,11595,11630,11720,11615,11675,11675,80,80,12054,"70,386.06",42704
,20160329,11675,11675,11700,11800,11620,11655,11730,-20,55,11158,"65,466.47",45490
,20160330,11655,11730,11680,11690,11605,11665,11655,-65,-75,4548,"26,504.26",45440
,20160331,11665,11655,11685,11735,11655,11700,11700,45,45,4256,"24,899.36",46146
,20160401,11700,11700,11720,11845,11715,11805,11795,105,95,7472,"44,078.88",46876
,20160405,11805,11795,11855,11885,11780,11810,11835,15,40,9542,"56,464.95",48124
,20160406,11810,11835,11815,11875,11740,11750,11825,-85,-10,23806,"140,791.58",61040
,20160407,11750,11825,11760,11800,11735,11775,11765,-50,-60,10102,"59,433.46",61846
,20160408,11775,11765,11895,11895,11555,11630,11650,-135,-115,13072,"76,162.82",62304
,20160411,11630,11650,11655,11790,11645,11755,11740,105,90,10612,"62,292.85",63528
,20160412,11755,11740,11755,11790,11745,11770,11765,30,25,9114,"53,620.27",64440
,20160413,11770,11765,11815,12030,11810,11940,11925,175,160,21080,"125,693.17",64808
,20160414,11940,11925,11970,12050,11900,11945,11975,20,50,14684,"87,923.07",66998
,20160415,11945,11975,11985,12005,11930,11965,11960,-10,-15,13996,"83,728.47",68742
,20160418,11965,11960,11955,11990,11835,11950,11940,-10,-20,17480,"104,397.08",74520
,20160419,11950,11940,11965,12020,11955,12010,11990,70,50,14822,"88,875.26",77242
,20160420,12010,11990,12010,12080,12000,12045,12040,55,50,21552,"129,783.77",83242
,20160421,12045,12040,12075,12440,12075,12350,12235,310,195,50196,"307,157.23",93828
,20160422,12350,12235,12400,12690,12205,12685,12470,450,235,80410,"501,459.51",108674
,20160425,12685,12470,12710,12965,12520,12740,12800,270,330,89776,"574,624.68",107078
,20160426,12740,12800,12750,12825,12610,12670,12700,-130,-100,35900,"227,985.47",106612
,20160427,12670,12700,12670,12860,12650,12705,12740,5,40,28644,"182,509.22",110364
,20160428,12705,12740,12775,12830,12375,12435,12550,-305,-190,72382,"454,274.72",109994
,20160429,12435,12550,12500,12650,12415,12625,12555,75,5,42558,"267,233.59",120130
,20160503,12625,12555,12620,12760,12615,12685,12680,130,125,33100,"209,900.07",123754
,20160504,12685,12680,12645,12670,12410,12430,12510,-250,-170,48440,"303,074.22",130192
,20160505,12430,12510,12450,12510,12045,12400,12430,-110,-80,29336,"182,348.75",130076
,20160506,12400,12430,12390,12470,12150,12295,12270,-135,-160,65490,"401,876.26",124798
,20160509,12295,12270,12280,12430,11925,11995,12155,-275,-115,66566,"404,665.54",125150
,20160510,11995,12155,11990,12010,11715,11840,11845,-315,-310,68060,"403,118.67",120576
,20160511,11840,11845,11820,12100,11820,12085,11955,240,110,51968,"310,735.20",123022
,20160512,12085,11955,12100,12210,12020,12140,12110,185,155,48198,"291,864.40",125740
,20160513,12140,12110,12060,12120,11830,12005,11975,-105,-135,75238,"450,581.07",124718
,20160516,12005,11975,11995,12200,11955,12160,12095,185,120,62922,"380,641.53",129600
,20160517,12160,12095,12150,12355,12135,12355,12285,260,190,68174,"418,764.88",133292
,20160518,12355,12285,12300,12370,12175,12185,12270,-100,-15,59298,"363,866.21",139056
,20160519,12185,12270,12190,12315,12135,12245,12245,-25,-25,46428,"284,297.78",142112
,20160520,12245,12245,12195,12360,12180,12355,12275,110,30,53474,"328,312.59",148586
,20160523,12355,12275,12390,12470,12125,12165,12275,-110,0,71334,"437,867.56",151938
,20160524,12165,12275,12200,12280,12060,12175,12195,-100,-80,60928,"371,585.99",155446
,20160525,12175,12195,12250,12300,11920,11975,12055,-220,-140,126952,"765,351.41",150768
,20160526,11975,12055,12015,12115,11825,12095,11960,40,-95,124260,"743,355.82",160626
,20160527,12095,11960,12105,12150,11900,12090,12030,130,70,119026,"716,000.63",175010
,20160530,12090,12030,12050,12195,12040,12145,12120,115,90,63004,"381,918.27",174816
,20160531,12145,12120,12165,12200,12055,12095,12135,-25,15,70780,"429,495.70",178354
,20160601,12095,12135,12110,12130,11885,11915,11985,-220,-150,107220,"642,739.27",191050
,20160602,11915,11985,11930,12165,11875,12145,12065,160,80,178172,"1,074,826.26",191924
,20160603,12145,12065,12100,12130,11850,11905,11960,-160,-105,234004,"1,399,596.54",214978
,20160606,11905,11960,11990,12000,11720,11780,11865,-180,-95,309120,"1,833,962.89",245704
,20160607,11780,11865,11805,11840,11610,11655,11715,-210,-150,298698,"1,749,861.86",265440
,20160608,11655,11715,11640,11895,11590,11870,11755,155,40,241406,"1,418,953.88",242234
,20160613,11870,11755,11805,11960,11740,11850,11830,95,75,136040,"804,740.69",230756
,20160614,11850,11830,11890,12030,11780,11855,11910,25,80,255184,"1,519,657.04",206970
,20160615,11855,11910,11850,11880,11765,11870,11825,-40,-85,118516,"700,884.71",208330
,20160616,11870,11825,11920,11970,11875,11915,11910,90,85,148418,"884,185.09",205754
,20160617,11915,11910,11870,11990,11830,11985,11920,75,10,128992,"768,975.30",201532
,20160620,11985,11920,11965,12125,11910,12100,12020,180,100,192464,"1,156,744.25",203438
,20160621,12100,12020,12165,12215,12095,12205,12150,185,130,217738,"1,323,149.77",201490
,20160622,12205,12150,12180,12360,12165,12345,12280,195,130,238118,"1,462,410.92",195192
,20160623,12345,12280,12370,12385,12250,12335,12315,55,35,154820,"953,371.01",195992
,20160624,12335,12315,12350,12405,12140,12170,12280,-145,-35,192334,"1,181,030.44",186774
,20160627,12170,12280,12155,12460,12130,12375,12310,95,30,170286,"1,048,262.25",181716
,20160628,12375,12310,12340,12480,12305,12385,12375,75,65,116112,"718,490.60",179588
,20160629,12385,12375,12425,12475,12340,12365,12400,-10,25,131212,"813,623.67",169034
,20160630,12365,12400,12360,12575,12320,12530,12460,130,60,170332,"1,061,168.95",164724
,20160701,12530,12460,12550,12770,12500,12760,12650,300,190,147724,"934,647.81",155210
,20160704,12760,12650,12780,12985,12655,12685,12805,35,155,125810,"805,777.26",139152
,20160705,12685,12805,12690,12730,12425,12610,12545,-195,-260,91682,"575,133.70",127770
,20160706,12610,12545,12610,12690,12455,12650,12585,105,40,67526,"424,985.54",122280
,20160707,12650,12585,12520,12795,12520,12645,12700,60,115,61826,"392,720.18",117102
,20160708,12645,12700,12665,12790,12580,12750,12685,50,-15,51508,"326,750.95",115456
,20160711,12750,12685,12805,12870,12755,12830,12810,145,125,36392,"233,125.93",112900
,20160712,12830,12810,12800,12855,12660,12720,12750,-90,-60,42610,"271,732.75",109378
,20160713,12720,12750,12765,12890,12705,12830,12815,80,65,48666,"311,872.82",103088
,20160714,12830,12815,12825,12885,12750,12865,12820,50,5,24918,"159,724.43",97676
,20160715,12865,12820,12865,12895,12805,12860,12845,40,25,21814,"140,114.03",95342
,20160718,12860,12845,12870,12925,12650,12650,12770,-195,-75,26620,"170,017.42",88340
,20160719,12650,12770,12625,12675,12350,12400,12525,-370,-245,35962,"225,262.20",80478
,20160720,12400,12525,12355,12470,12320,12430,12405,-95,-120,30832,"191,269.22",74124
,20160721,12430,12405,12385,12530,12325,12525,12460,120,55,18446,"114,948.79",73650
,20160722,12525,12460,12515,12565,12300,12310,12425,-150,-35,21372,"132,779.29",69152
,20160725,12310,12425,12355,12395,12245,12340,12330,-85,-95,24792,"152,900.69",62498
,20160726,12340,12330,12340,12365,12285,12290,12315,-40,-15,12304,"75,789.45",59332
,20160727,12290,12315,12290,12315,12205,12250,12260,-65,-55,17770,"108,941.98",54248
,20160728,12250,12260,12250,12500,12225,12475,12385,215,125,20432,"126,532.45",46106
,20160729,12475,12385,12500,12540,12345,12400,12440,15,55,9662,"60,113.67",42010
,20160801,12400,12440,12440,12510,12435,12490,12475,50,35,6440,"40,180.75",39320
,20160802,12490,12475,12460,12500,12370,12475,12430,0,-45,5240,"32,577.33",37670
,20160803,12475,12430,12500,12500,12305,12320,12390,-110,-40,5440,"33,705.33",35990
,20160804,12320,12390,12370,12410,12325,12355,12350,-35,-40,4630,"28,598.85",34130
,20160805,12355,12350,12325,12500,12305,12500,12420,150,70,5090,"31,609.73",32330
,20160808,12500,12420,12495,12605,12480,12605,12545,185,125,7390,"46,370.80",30750
,20160809,12605,12545,12570,12615,12535,12540,12565,-5,20,5020,"31,543.33",28050
,20160810,12540,12565,12570,12650,12530,12640,12605,75,40,7880,"49,670.23",24650
,20160811,12640,12605,12500,12645,12500,12620,12620,15,15,6390,"40,327.40",19630
,20160812,12620,12620,12605,12615,12560,12615,12590,-5,-30,8010,"50,426.78",12680
,20160815,12615,12590,12605,12765,12565,12615,12640,25,50,12050,"76,175.40",2990
al1609,20160104,10800,10785,10760,10760,10585,10585,10610,-200,-175,134,711.19,4922
,20160105,10585,10610,10490,10660,10490,10660,10645,50,35,510,"2,714.74",5224
,20160106,10660,10645,10625,10625,10555,10600,10590,-45,-55,92,487.31,5218
,20160107,10600,10590,10600,10615,10565,10615,10580,25,-10,94,497.35,5220
,20160108,10615,10580,10590,10695,10530,10695,10620,115,40,288,"1,529.75",5298
,20160111,10695,10620,10700,10765,10700,10755,10720,135,100,66,353.86,5292
,20160112,10755,10720,10710,10760,10550,10550,10650,-170,-70,438,"2,333.17",5552
,20160113,10550,10650,10560,10570,10500,10545,10535,-105,-115,142,748.32,5562
,20160114,10545,10535,10570,10735,10570,10685,10660,150,125,60,319.90,5596
,20160115,10685,10660,10695,10740,10660,10680,10685,20,25,72,384.83,5606
,20160118,10680,10685,10700,10750,10700,10740,10715,55,30,54,289.36,5594
,20160119,10740,10715,10750,10870,10735,10870,10835,155,120,598,"3,240.06",5862
,20160120,10870,10835,10825,10840,10780,10795,10805,-40,-30,34,183.72,5850
,20160121,10795,10805,10805,10805,10725,10725,10765,-80,-40,246,"1,324.66",5822
,20160122,10725,10765,10765,10855,10765,10825,10800,60,35,120,648.27,5752
,20160125,10825,10800,10850,10850,10770,10770,10805,-30,5,80,432.38,5758
,20160126,10770,10805,10785,10785,10750,10760,10765,-45,-40,82,441.55,5794
,20160127,10760,10765,10750,10820,10750,10800,10800,35,35,74,399.63,5750
,20160128,10800,10800,10910,10930,10795,10815,10860,15,60,176,955.76,5642
,20160129,10815,10860,10835,10845,10790,10830,10810,-30,-50,46,248.73,5646
,20160201,10830,10810,10865,10865,10720,10720,10795,-90,-15,12,64.80,5648
,20160202,10720,10795,10740,10790,10740,10790,10775,-5,-20,168,905.25,5562
,20160203,10790,10775,10805,10850,10770,10830,10810,55,35,364,"1,968.02",5452
,20160204,10830,10810,10870,10990,10870,10990,10895,180,85,126,686.65,5458
,20160205,10990,10895,10940,10990,10935,10960,10955,65,60,22,120.56,5454
,20160215,10960,10955,10955,11035,10940,11035,10975,80,20,68,373.23,5472
,20160216,11035,10975,11155,11170,11020,11155,11100,180,125,220,"1,221.36",5596
,20160217,11155,11100,11130,11235,11100,11115,11180,15,80,298,"1,665.92",5624
,20160218,11115,11180,11170,11175,11075,11080,11095,-100,-85,670,"3,717.46",5820
,20160219,11080,11095,11095,11210,11095,11205,11190,110,95,654,"3,659.23",6172
,20160222,11205,11190,11215,11430,11205,11395,11355,205,165,1312,"7,452.02",6334
,20160223,11395,11355,11430,11430,11355,11385,11375,30,20,300,"1,706.88",6172
,20160224,11385,11375,11360,11360,11275,11305,11300,-70,-75,500,"2,825.60",6440
,20160225,11305,11300,11395,11500,11395,11400,11455,100,155,80,458.24,6442
,20160226,11400,11455,11410,11480,11345,11420,11445,-35,-10,174,995.73,6444
,20160229,11420,11445,11420,11525,11410,11410,11475,-35,30,218,"1,251.13",6462
,20160301,11410,11475,11455,11465,11290,11370,11370,-105,-105,1352,"7,687.75",6784
,20160302,11370,11370,11410,11490,11295,11470,11430,100,60,352,"2,012.53",6866
,20160303,11470,11430,11480,11510,11445,11510,11480,80,50,302,"1,734.16",6998
,20160304,11510,11480,11500,11625,11500,11620,11575,140,95,384,"2,223.10",6928
,20160307,11620,11575,11550,11745,11525,11625,11640,50,65,802,"4,669.32",7170
,20160308,11625,11640,11765,11765,11600,11710,11670,70,30,1128,"6,582.20",7582
,20160309,11710,11670,11655,11655,11315,11520,11520,-150,-150,1346,"7,753.33",8056
,20160310,11520,11520,11500,11575,11465,11505,11505,-15,-15,762,"4,383.99",8530
,20160311,11505,11505,11470,11535,11425,11520,11470,15,-35,1464,"8,399.52",8812
,20160314,11520,11470,11490,11585,11400,11480,11530,10,60,364,"2,099.36",8838
,20160315,11480,11530,11425,11480,11425,11435,11455,-95,-75,780,"4,467.45",9000
,20160316,11435,11455,11395,11435,11365,11370,11380,-85,-75,1526,"8,685.36",9750
,20160317,11370,11380,11350,11455,11340,11425,11410,45,30,1036,"5,912.58",10092
,20160318,11425,11410,11435,11555,11425,11505,11520,95,110,2468,"14,216.49",10262
,20160321,11505,11520,11510,11635,11460,11570,11535,50,15,1958,"11,297.28",10338
,20160322,11570,11535,11550,11590,11525,11575,11555,40,20,1880,"10,864.16",10574
,20160323,11575,11555,11530,11620,11520,11550,11585,-5,30,2512,"14,553.61",11194
,20160324,11550,11585,11545,11635,11500,11525,11585,-60,0,3580,"20,737.48",11518
,20160325,11525,11585,11540,11645,11525,11635,11580,50,-5,3692,"21,379.96",12778
,20160328,11635,11580,11650,11715,11605,11680,11670,100,90,8952,"52,241.43",17044
,20160329,11680,11670,11690,11790,11605,11660,11725,-10,55,8244,"48,334.87",19874
,20160330,11660,11725,11685,11685,11600,11660,11650,-65,-75,4802,"27,973.21",20958
,20160331,11660,11650,11650,11730,11650,11695,11685,45,35,4770,"27,876.34",22664
,20160401,11695,11685,11725,11840,11710,11795,11780,110,95,4240,"24,977.69",23502
,20160405,11795,11780,11810,11875,11765,11795,11810,15,30,2038,"12,039.09",24086
,20160406,11795,11810,11750,11865,11735,11750,11810,-60,0,7306,"43,152.67",25336
,20160407,11750,11810,11755,11790,11735,11770,11755,-40,-55,5442,"31,998.37",27152
,20160408,11770,11755,11735,11735,11560,11630,11645,-125,-110,6002,"34,948.48",27948
,20160411,11630,11645,11650,11780,11650,11760,11740,115,95,4610,"27,063.55",28534
,20160412,11760,11740,11750,11785,11750,11765,11765,25,25,3124,"18,379.18",29444
,20160413,11765,11765,11815,12005,11815,11925,11915,160,150,11524,"68,669.07",30994
,20160414,11925,11915,11970,12045,11890,11950,11980,35,65,5604,"33,571.46",32320
,20160415,11950,11980,11985,12005,11930,11960,11970,-20,-10,7450,"44,589.01",33790
,20160418,11960,11970,11930,11985,11835,11950,11950,-20,-20,6562,"39,220.57",35614
,20160419,11950,11950,11970,12010,11950,12000,11985,50,35,9904,"59,367.06",38938
,20160420,12000,11985,12045,12070,11995,12045,12030,60,45,10950,"65,878.33",41904
,20160421,12045,12030,12050,12410,12050,12300,12210,270,180,26954,"164,562.42",51688
,20160422,12300,12210,12350,12620,12155,12620,12440,410,230,30660,"190,752.29",59542
,20160425,12620,12440,12770,12880,12445,12650,12700,210,260,32800,"208,352.08",62632
,20160426,12650,12700,12690,12715,12535,12590,12620,-110,-80,13196,"83,299.20",63362
,20160427,12590,12620,12580,12760,12560,12620,12655,0,35,15304,"96,872.45",67148
,20160428,12620,12655,12670,12745,12330,12390,12480,-265,-175,35166,"219,500.84",68746
,20160429,12390,12480,12440,12595,12360,12565,12485,85,5,15962,"99,667.62",70546
,20160503,12565,12485,12580,12700,12555,12620,12625,135,140,16530,"104,383.20",75820
,20160504,12620,12625,12510,12605,12350,12360,12450,-265,-175,14372,"89,494.38",76516
,20160505,12360,12450,12375,12450,12300,12340,12370,-110,-80,13014,"80,518.87",76358
,20160506,12340,12370,12320,12490,12100,12230,12205,-140,-165,23498,"143,443.81",74630
,20160509,12230,12205,12220,12375,11880,11950,12095,-255,-110,15760,"95,320.22",74704
,20160510,11950,12095,11950,11955,11680,11820,11815,-275,-280,30116,"177,917.32",72988
,20160511,11820,11815,11805,12070,11805,12050,11940,235,125,19674,"117,498.69",74928
,20160512,12050,11940,12050,12180,11990,12100,12080,160,140,14806,"89,432.59",75950
,20160513,12100,12080,12020,12090,11815,11980,11945,-100,-135,25136,"150,167.94",75692
,20160516,11980,11945,11980,12150,11920,12110,12055,165,110,19520,"117,677.14",76462
,20160517,12110,12055,12080,12320,12080,12285,12225,230,170,25006,"152,853.86",79808
,20160518,12285,12225,12255,12300,12120,12135,12210,-90,-15,19032,"116,233.32",81108
,20160519,12135,12210,12140,12250,12075,12190,12175,-20,-35,14012,"85,332.90",80900
,20160520,12190,12175,12160,12330,12120,12290,12210,115,35,14020,"85,619.23",82668
,20160523,12290,12210,12330,12405,12060,12115,12200,-95,-10,18952,"115,634.82",84434
,20160524,12115,12200,12115,12180,12010,12105,12125,-95,-75,15076,"91,426.10",85358
,20160525,12105,12125,12155,12225,11875,11890,12005,-235,-120,35126,"210,912.42",87482
,20160526,11890,12005,11955,12055,11755,12040,11930,35,-75,43368,"258,701.24",93296
,20160527,12040,11930,12060,12095,11840,12000,11970,70,40,40212,"240,708.78",101834
,20160530,12000,11970,12005,12090,11955,12035,12030,65,60,26588,"159,951.56",105740
,20160531,12035,12030,12035,12070,11945,12000,12025,-30,-5,30904,"185,850.40",109974
,20160601,12000,12025,12025,12025,11775,11780,11875,-245,-150,35588,"211,325.87",114836
,20160602,11780,11875,11795,12060,11765,12040,11960,165,85,42782,"255,849.90",112354
,20160603,12040,11960,12050,12050,11775,11800,11860,-160,-100,46726,"277,131.09",118994
,20160606,11800,11860,11900,11905,11630,11670,11755,-190,-105,54946,"323,030.72",125000
,20160607,11670,11755,11765,11765,11530,11590,11625,-165,-130,54750,"318,338.54",122892
,20160608,11590,11625,11585,11820,11545,11780,11690,155,65,51696,"302,246.53",115332
,20160613,11780,11690,11775,11880,11660,11750,11740,60,50,39096,"229,515.95",117118
,20160614,11750,11740,11790,11940,11715,11780,11825,40,85,63608,"376,156.52",114934
,20160615,11780,11825,11785,11795,11685,11775,11730,-50,-95,41124,"241,243.03",112192
,20160616,11775,11730,11810,11870,11790,11815,11820,85,90,43418,"256,671.15",112930
,20160617,11815,11820,11780,11895,11750,11880,11825,60,5,41668,"246,433.03",108752
,20160620,11880,11825,11870,12000,11800,11980,11905,155,80,54148,"322,341.90",108380
,20160621,11980,11905,12015,12060,11970,12055,12010,150,105,53526,"321,499.35",112694
,20160622,12055,12010,12010,12160,12010,12100,12100,90,90,68594,"415,129.28",120228
,20160623,12100,12100,12135,12180,12065,12140,12120,40,20,38238,"231,810.16",122134
,20160624,12140,12120,12155,12205,11970,11990,12085,-130,-35,77248,"466,808.07",126662
,20160627,11990,12085,12000,12300,11965,12225,12160,140,75,68518,"416,659.78",121848
,20160628,12225,12160,12225,12305,12150,12230,12215,70,55,51962,"317,458.98",130192
,20160629,12230,12215,12285,12305,12180,12225,12240,10,25,68964,"422,163.91",136296
,20160630,12225,12240,12230,12380,12170,12335,12300,95,60,93304,"573,913.64",154000
,20160701,12335,12300,12360,12605,12320,12590,12480,290,180,153556,"958,440.70",167108
,20160704,12590,12480,12600,12785,12505,12535,12640,55,160,265260,"1,676,517.84",192366
,20160705,12535,12640,12530,12590,12270,12480,12400,-160,-240,243116,"1,507,897.85",184638
,20160706,12480,12400,12480,12550,12310,12480,12435,80,35,268018,"1,666,780.47",190086
,20160707,12480,12435,12410,12630,12390,12460,12535,25,100,279126,"1,749,565.32",196612
,20160708,12460,12535,12450,12615,12420,12565,12500,30,-35,190794,"1,192,649.70",207458
,20160711,12565,12500,12605,12665,12555,12650,12615,150,115,182850,"1,153,702.67",219986
,20160712,12650,12615,12640,12660,12465,12500,12565,-115,-50,186242,"1,170,164.78",217100
,20160713,12500,12565,12555,12725,12515,12655,12625,90,60,257226,"1,623,893.09",221860
,20160714,12655,12625,12645,12705,12570,12700,12640,75,15,148452,"938,498.45",215568
,20160715,12700,12640,12720,12735,12625,12685,12670,45,30,121236,"768,203.50",215694
,20160718,12685,12670,12725,12745,12500,12515,12600,-155,-70,142020,"895,023.46",206718
,20160719,12515,12600,12505,12520,12205,12280,12385,-320,-215,211724,"1,311,282.09",201854
,20160720,12280,12385,12275,12370,12215,12330,12315,-55,-70,149712,"921,919.95",187574
,20160721,12330,12315,12300,12405,12215,12390,12335,75,20,152210,"938,808.51",183340
,20160722,12390,12335,12365,12430,12150,12160,12290,-175,-45,151792,"932,940.57",185732
,20160725,12160,12290,12190,12240,12070,12190,12165,-100,-125,144064,"876,488.31",182574
,20160726,12190,12165,12175,12210,12115,12120,12150,-45,-15,86604,"526,299.65",181170
,20160727,12120,12150,12115,12160,12020,12070,12090,-80,-60,141782,"857,375.93",178604
,20160728,12070,12090,12095,12345,12040,12345,12205,255,115,153174,"934,943.17",160690
,20160729,12345,12205,12360,12390,12180,12260,12280,55,75,110912,"681,048.29",150804
,20160801,12260,12280,12290,12360,12240,12325,12310,45,30,81400,"501,178.20",139518
,20160802,12325,12310,12340,12350,12180,12315,12265,5,-45,71234,"436,842.91",132704
,20160803,12315,12265,12340,12350,12125,12180,12230,-85,-35,44554,"272,556.54",128088
,20160804,12180,12230,12200,12235,12135,12180,12175,-50,-55,36702,"223,442.22",122518
,20160805,12180,12175,12200,12340,12110,12335,12240,160,65,42370,"259,319.93",116422
,20160808,12335,12240,12350,12520,12305,12510,12425,270,185,54424,"338,125.57",109788
,20160809,12510,12425,12510,12510,12395,12430,12440,5,15,32290,"200,918.38",105592
,20160810,12430,12440,12430,12580,12405,12545,12490,105,50,25400,"158,676.83",104774
,20160811,12545,12490,12575,12600,12465,12500,12505,10,15,16836,"105,288.01",101280
,20160812,12500,12505,12525,12525,12410,12470,12465,-35,-40,14966,"93,279.68",98156
,20160815,12470,12465,12425,12500,12350,12430,12440,-35,-25,27994,"174,139.96",94976
,20160816,12430,12440,12445,12570,12445,12510,12505,70,65,23656,"147,926.28",90900
,20160817,12510,12505,12510,12560,12495,12550,12530,45,25,16968,"106,308.48",85246
,20160818,12550,12530,12555,12800,12540,12745,12670,215,140,25906,"164,167.18",84176
,20160819,12745,12670,12750,12815,12680,12740,12735,70,65,23952,"152,546.14",75796
,20160822,12740,12735,12695,12700,12440,12470,12560,-265,-175,21136,"132,756.03",68466
,20160823,12470,12560,12470,12545,12395,12535,12480,-25,-80,12200,"76,156.18",65538
,20160824,12535,12480,12530,12585,12500,12535,12535,55,55,11774,"73,814.51",61254
,20160825,12535,12535,12535,12535,12400,12450,12445,-85,-90,15548,"96,751.14",54994
,20160826,12450,12445,12425,12565,12415,12505,12480,60,35,11738,"73,263.43",51528
,20160829,12505,12480,12505,12570,12450,12515,12530,35,50,16360,"102,520.68",47410
,20160830,12515,12530,12515,12550,12460,12485,12500,-45,-30,9348,"58,442.09",43816
,20160831,12485,12500,12465,12545,12410,12430,12485,-70,-15,12276,"76,645.57",40122
,20160901,12430,12485,12405,12440,12370,12410,12405,-75,-80,8642,"53,612.44",36300
,20160902,12410,12405,12385,12545,12385,12530,12505,125,100,5550,"34,703.30",34760
,20160905,12530,12505,12530,12545,12285,12315,12395,-190,-110,7560,"46,868.98",31570
,20160906,12315,12395,12305,12370,12250,12350,12285,-45,-110,5280,"32,442.03",28310
,20160907,12350,12285,12375,12480,12330,12455,12405,170,120,4460,"27,670.35",25910
,20160908,12455,12405,12450,12500,12410,12500,12445,95,40,2660,"16,554.38",24030
,20160909,12500,12445,12515,12585,12515,12560,12555,115,110,6010,"37,729.15",19420
,20160912,12560,12555,12530,12570,12470,12540,12530,-15,-25,6070,"38,039.28",15900
,20160913,12540,12530,12570,12605,12555,12600,12585,70,55,4670,"29,388.05",13280
,20160914,12600,12585,12575,12605,12460,12500,12565,-85,-20,5900,"37,073.70",8180
,20160919,12500,12565,12535,12535,12400,12400,12470,-165,-95,5200,"32,423.80",4110
al1610,20160104,10800,10805,10665,10705,10590,10590,10610,-215,-195,34,180.41,5704
,20160105,10590,10610,10505,10665,10505,10660,10585,50,-25,84,444.59,5724
,20160106,10660,10585,10625,10625,10570,10570,10590,-15,5,28,148.31,5718
,20160107,10570,10590,10570,10615,10550,10615,10595,25,5,30,159.00,5722
,20160108,10615,10595,10575,10750,10575,10685,10690,90,95,74,395.60,5700
,20160111,10685,10690,10715,10760,10665,10760,10730,70,40,94,504.49,5680
,20160112,10760,10730,10700,10750,10670,10670,10720,-60,-10,94,503.97,5678
,20160113,10670,10720,10525,10575,10500,10575,10515,-145,-205,66,347.06,5694
,20160114,10575,10515,10570,10660,10570,10660,10600,145,85,6,31.80,5696
,20160115,10660,10600,10695,10700,10590,10680,10680,80,80,80,427.30,5700
,20160118,10680,10680,10690,10880,10690,10745,10750,65,70,26,139.76,5676
,20160119,10745,10750,10765,10880,10765,10865,10825,115,75,126,682.15,5690
,20160120,10865,10825,10830,10830,10770,10780,10780,-45,-45,166,895.13,5700
,20160121,10780,10780,10760,10760,10725,10735,10735,-45,-45,66,354.28,5716
,20160122,10735,10735,10785,10825,10785,10825,10800,90,65,72,388.89,5748
,20160125,10825,10800,10850,10850,10785,10785,10825,-15,25,38,205.76,5748
,20160126,10785,10825,10785,10795,10740,10740,10750,-85,-75,24,129.06,5758
,20160127,10740,10750,10755,10860,10755,10860,10805,110,55,4,21.62,5754
,20160128,10860,10805,10885,10910,10835,10835,10895,30,90,208,"1,133.08",5794
,20160129,10835,10895,10880,10880,10820,10840,10860,-55,-35,10,54.30,5790
,20160201,10840,10860,10760,10760,10760,10760,10760,-100,-100,2,10.76,5790
,20160202,10760,10760,10780,10830,10760,10810,10795,50,35,102,550.75,5750
,20160203,10810,10795,10850,10870,10800,10870,10850,75,55,566,"3,071.18",5832
,20160204,10870,10850,10895,11055,10895,11055,10970,205,120,68,372.99,5838
,20160205,11055,10970,11005,11005,10985,10985,10985,15,15,10,54.95,5836
,20160215,10985,10985,11000,11040,11000,11035,11025,50,40,10,55.14,5840
,20160216,11035,11025,11025,11230,11025,11170,11150,145,125,262,"1,460.82",5944
,20160217,11170,11150,11185,11255,11140,11155,11210,5,60,1292,"7,244.30",6478
,20160218,11155,11210,11120,11150,11070,11085,11095,-125,-115,1578,"8,755.92",7648
,20160219,11085,11095,11145,11215,11145,11215,11180,120,85,432,"2,415.38",7696
,20160222,11215,11180,11240,11440,11220,11415,11385,235,205,1946,"11,078.48",7154
,20160223,11415,11385,11425,11455,11390,11425,11435,40,50,1164,"6,657.28",6448
,20160224,11425,11435,11405,11405,11345,11345,11385,-90,-50,40,227.71,6438
,20160225,11345,11385,11360,11530,11360,11455,11485,70,100,124,712.12,6372
,20160226,11455,11485,11455,11505,11380,11485,11460,0,-25,246,"1,409.98",6268
,20160229,11485,11460,11540,11550,11430,11430,11490,-30,30,208,"1,195.47",6218
,20160301,11430,11490,11440,11440,11300,11390,11395,-100,-95,128,729.50,6206
,20160302,11390,11395,11425,11520,11315,11520,11430,125,35,166,948.85,6256
,20160303,11520,11430,11515,11530,11490,11525,11505,95,75,194,"1,116.36",6202
,20160304,11525,11505,11530,11665,11530,11665,11605,160,100,568,"3,297.07",6124
,20160307,11665,11605,11575,11770,11575,11670,11680,65,75,150,876.16,6156
,20160308,11670,11680,11755,11795,11635,11750,11690,70,10,272,"1,590.16",6258
,20160309,11750,11690,11700,11700,11340,11550,11495,-140,-195,196,"1,126.84",6262
,20160310,11550,11495,11560,11635,11495,11525,11535,30,40,104,600.01,6200
,20160311,11525,11535,11485,11560,11475,11560,11520,25,-15,120,691.47,6152
,20160314,11560,11520,11540,11580,11505,11505,11530,-15,10,714,"4,116.65",6154
,20160315,11505,11530,11475,11500,11430,11450,11470,-80,-60,310,"1,777.97",6150
,20160316,11450,11470,11420,11420,11380,11380,11395,-90,-75,296,"1,686.90",6102
,20160317,11380,11395,11350,11455,11345,11455,11435,60,40,342,"1,956.00",6150
,20160318,11455,11435,11500,11565,11500,11540,11545,105,110,414,"2,390.63",6004
,20160321,11540,11545,11520,11635,11505,11580,11610,35,65,346,"2,008.97",5834
,20160322,11580,11610,11550,11625,11545,11580,11590,-30,-20,482,"2,793.86",5940
,20160323,11580,11590,11565,11620,11550,11590,11605,0,15,614,"3,563.46",6362
,20160324,11590,11605,11570,11645,11520,11530,11610,-75,5,552,"3,205.38",6450
,20160325,11530,11610,11535,11655,11535,11655,11630,45,20,632,"3,675.58",6456
,20160328,11655,11630,11670,11715,11630,11670,11675,40,45,2300,"13,428.77",6868
,20160329,11670,11675,11700,11780,11610,11660,11725,-15,50,1516,"8,888.78",7612
,20160330,11660,11725,11670,11685,11610,11665,11655,-60,-70,668,"3,894.06",7988
,20160331,11665,11655,11655,11730,11655,11700,11685,45,30,770,"4,500.35",8416
,20160401,11700,11685,11710,11835,11710,11805,11770,120,85,1478,"8,701.29",8666
,20160405,11805,11770,11820,11860,11770,11800,11820,30,50,702,"4,149.68",9064
,20160406,11800,11820,11780,11855,11740,11740,11815,-80,-5,1768,"10,446.72",9150
,20160407,11740,11815,11775,11795,11740,11785,11775,-30,-40,802,"4,722.36",9566
,20160408,11785,11775,11725,11725,11575,11645,11645,-130,-130,3254,"18,952.13",11536
,20160411,11645,11645,11690,11780,11690,11775,11745,130,100,1430,"8,400.41",11958
,20160412,11775,11745,11760,11790,11755,11790,11775,45,30,1466,"8,631.22",12350
,20160413,11790,11775,11845,12010,11835,11940,11920,165,145,5834,"34,776.60",12302
,20160414,11940,11920,12000,12040,11900,11950,11990,30,70,2604,"15,617.36",12264
,20160415,11950,11990,12000,12005,11930,11965,11965,-25,-25,1520,"9,094.16",12388
,20160418,11965,11965,11940,11980,11860,11940,11945,-25,-20,1102,"6,584.38",12654
,20160419,11940,11945,11970,12000,11950,12000,11985,55,40,1160,"6,951.51",13074
,20160420,12000,11985,12010,12055,11990,12030,12030,45,45,5896,"35,469.09",16510
,20160421,12030,12030,12090,12360,12065,12290,12195,260,165,8698,"53,041.04",19876
,20160422,12290,12195,12350,12560,12125,12560,12400,365,205,8052,"49,926.75",21350
,20160425,12560,12400,12605,12785,12380,12615,12615,215,215,10776,"67,994.49",22404
,20160426,12615,12615,12585,12660,12460,12515,12545,-100,-70,3112,"19,525.59",23020
,20160427,12515,12545,12515,12685,12505,12580,12580,35,35,2566,"16,141.17",23750
,20160428,12580,12580,12625,12680,12310,12375,12420,-205,-160,8358,"51,904.66",25692
,20160429,12375,12420,12440,12570,12330,12535,12440,115,20,6594,"41,021.43",25390
,20160503,12535,12440,12560,12665,12525,12590,12585,150,145,1804,"11,353.52",25726
,20160504,12590,12585,12555,12555,12325,12325,12435,-260,-150,3526,"21,928.20",26716
,20160505,12325,12435,12360,12415,12270,12300,12345,-135,-90,2474,"15,270.96",26832
,20160506,12300,12345,12310,12380,12085,12205,12190,-140,-155,5908,"36,021.34",26556
,20160509,12205,12190,12215,12345,11865,11935,12025,-255,-165,2624,"15,780.28",26782
,20160510,11935,12025,11930,11930,11675,11830,11810,-195,-215,4254,"25,121.04",27188
,20160511,11830,11810,11780,12075,11780,12065,11950,255,140,4504,"26,922.22",28602
,20160512,12065,11950,12085,12180,11990,12085,12075,135,125,2948,"17,800.07",28950
,20160513,12085,12075,12015,12080,11810,11985,11940,-90,-135,4492,"26,818.30",28926
,20160516,11985,11940,11945,12120,11915,12095,12050,155,110,4228,"25,481.80",29726
,20160517,12095,12050,12180,12255,12005,12255,12190,205,140,7096,"43,256.54",30256
,20160518,12255,12190,12230,12265,12095,12120,12175,-70,-15,4238,"25,802.42",29502
,20160519,12120,12175,11965,12205,11965,12130,12145,-45,-30,3050,"18,523.46",29490
,20160520,12130,12145,12115,12255,12090,12255,12175,110,30,3302,"20,108.87",29798
,20160523,12255,12175,12295,12360,12030,12070,12175,-105,0,5194,"31,627.67",30296
,20160524,12070,12175,12035,12130,11980,12075,12085,-100,-90,3702,"22,370.78",30646
,20160525,12075,12085,12110,12180,11865,11905,11980,-180,-105,9620,"57,641.90",32458
,20160526,11905,11980,11920,12030,11775,12010,11910,30,-70,10108,"60,203.42",33732
,20160527,12010,11910,12050,12055,11815,11985,11930,75,20,12996,"77,551.94",36838
,20160530,11985,11930,11960,12035,11920,11980,11985,50,55,7328,"43,930.52",37796
,20160531,11980,11985,11975,12000,11880,11925,11960,-60,-25,6480,"38,755.05",39102
,20160601,11925,11960,11955,11955,11730,11745,11825,-215,-135,9432,"55,788.90",39514
,20160602,11745,11825,11745,12000,11725,11985,11920,160,95,12248,"73,024.91",40404
,20160603,11985,11920,11985,11985,11735,11760,11810,-160,-110,12926,"76,356.54",40886
,20160606,11760,11810,11835,11850,11600,11635,11715,-175,-95,17168,"100,598.15",43378
,20160607,11635,11715,11695,11710,11510,11600,11590,-115,-125,17670,"102,410.37",45112
,20160608,11600,11590,11580,11785,11540,11755,11675,165,85,17968,"104,931.42",45186
,20160613,11755,11675,11730,11805,11630,11730,11715,55,40,12442,"72,901.73",45380
,20160614,11730,11715,11730,11890,11690,11745,11790,30,75,20442,"120,552.97",45662
,20160615,11745,11790,11740,11760,11655,11755,11700,-35,-90,8998,"52,651.81",46816
,20160616,11755,11700,11775,11830,11755,11785,11785,85,85,14078,"82,988.57",47702
,20160617,11785,11785,11745,11855,11725,11815,11790,30,5,12382,"73,015.83",48508
,20160620,11815,11790,11815,11915,11750,11900,11850,110,60,16800,"99,542.58",50404
,20160621,11900,11850,11925,11950,11890,11945,11920,95,70,15890,"94,732.57",53010
,20160622,11945,11920,11925,12040,11910,12030,11985,110,65,29616,"177,490.11",61674
,20160623,12030,11985,12050,12050,11950,12020,12000,35,15,13762,"82,601.37",65892
,20160624,12020,12000,12000,12075,11860,11875,11955,-125,-45,30972,"185,177.83",71158
,20160627,11875,11955,11885,12170,11860,12125,12045,170,90,22072,"132,978.55",68884
,20160628,12125,12045,12075,12180,12025,12115,12090,70,45,15248,"92,210.18",69934
,20160629,12115,12090,12140,12175,12060,12110,12120,20,30,21398,"129,716.61",71846
,20160630,12110,12120,12115,12220,12060,12200,12170,80,50,27190,"165,456.62",74386
,20160701,12200,12170,12200,12425,12160,12425,12315,255,145,41914,"258,101.36",80564
,20160704,12425,12315,12440,12575,12350,12385,12470,70,155,55836,"348,240.27",86146
,20160705,12385,12470,12415,12430,12135,12360,12275,-110,-195,43852,"269,157.98",83482
,20160706,12360,12275,12365,12415,12190,12335,12315,60,40,39178,"241,251.07",85506
,20160707,12335,12315,12270,12470,12245,12295,12375,-20,60,41272,"255,458.52",90344
,20160708,12295,12375,12270,12445,12250,12395,12340,20,-35,29566,"182,452.32",92506
,20160711,12395,12340,12450,12520,12385,12470,12435,130,95,31160,"193,770.34",100470
,20160712,12470,12435,12460,12470,12305,12355,12390,-80,-45,30028,"186,073.33",103662
,20160713,12355,12390,12405,12565,12345,12490,12470,100,80,57984,"361,630.95",113476
,20160714,12490,12470,12470,12535,12415,12525,12475,55,5,30662,"191,328.42",112628
,20160715,12525,12475,12545,12575,12470,12525,12525,50,50,34948,"218,869.70",113894
,20160718,12525,12525,12560,12590,12370,12415,12460,-110,-65,44616,"277,967.59",117150
,20160719,12415,12460,12360,12415,12115,12240,12295,-220,-165,65072,"400,047.32",131950
,20160720,12240,12295,12210,12330,12165,12280,12260,-15,-35,54284,"332,860.92",122460
,20160721,12280,12260,12200,12345,12145,12300,12255,40,-5,50810,"311,349.45",125018
,20160722,12300,12255,12295,12335,12070,12090,12200,-165,-55,50842,"310,197.00",128608
,20160725,12090,12200,12125,12155,12000,12120,12080,-80,-120,49008,"296,061.97",133372
,20160726,12120,12080,12095,12115,12040,12045,12075,-35,-5,35474,"214,180.44",134666
,20160727,12045,12075,12040,12095,11950,12010,12020,-65,-55,53122,"319,347.95",136834
,20160728,12010,12020,12030,12230,11965,12210,12120,190,100,71872,"435,619.49",141696
,20160729,12210,12120,12230,12260,12075,12160,12170,40,50,58652,"357,012.49",145106
,20160801,12160,12170,12190,12270,12145,12235,12215,65,45,62530,"382,041.82",149648
,20160802,12235,12215,12235,12245,12100,12205,12175,-10,-40,79720,"485,378.11",158440
,20160803,12205,12175,12240,12260,12010,12050,12120,-125,-55,108294,"656,426.89",180308
,20160804,12050,12120,12100,12135,12030,12065,12065,-55,-55,100416,"605,963.44",183016
,20160805,12065,12065,12065,12235,12000,12220,12125,155,60,136198,"825,798.12",178134
,20160808,12220,12125,12235,12395,12190,12385,12310,260,185,171128,"1,053,424.68",195008
,20160809,12385,12310,12380,12400,12270,12310,12330,0,20,128862,"794,750.42",199820
,20160810,12310,12330,12310,12480,12295,12465,12385,135,55,123252,"763,432.74",211156
,20160811,12465,12385,12485,12495,12355,12390,12405,5,20,103748,"643,527.95",202964
,20160812,12390,12405,12395,12395,12300,12350,12345,-55,-60,75136,"463,907.95",202034
,20160815,12350,12345,12270,12380,12225,12295,12310,-50,-35,119434,"735,234.88",198428
,20160816,12295,12310,12335,12470,12310,12430,12395,120,85,115670,"717,096.35",211308
,20160817,12430,12395,12465,12465,12385,12450,12430,55,35,106126,"659,715.22",202854
,20160818,12450,12430,12455,12795,12435,12780,12595,350,165,235560,"1,483,573.62",252598
,20160819,12780,12595,12780,12780,12605,12685,12675,90,80,168504,"1,068,115.80",244700
,20160822,12685,12675,12600,12625,12360,12375,12495,-300,-180,195852,"1,223,915.00",206244
,20160823,12375,12495,12380,12450,12230,12440,12385,-55,-110,95362,"590,716.89",196388
,20160824,12440,12385,12425,12495,12385,12420,12435,35,50,71036,"441,797.22",190990
,20160825,12420,12435,12440,12440,12280,12340,12335,-95,-100,114524,"706,564.10",184048
,20160826,12340,12335,12300,12450,12295,12370,12365,35,30,111038,"686,704.23",174710
,20160829,12370,12365,12330,12450,12310,12345,12390,-20,25,102356,"634,234.92",171010
,20160830,12345,12390,12360,12410,12300,12320,12340,-70,-50,72000,"444,253.24",165894
,20160831,12320,12340,12310,12375,12205,12215,12300,-125,-40,111132,"683,620.15",160826
,20160901,12215,12300,12195,12255,12150,12230,12210,-70,-90,84856,"518,228.70",154718
,20160902,12230,12210,12200,12355,12170,12345,12280,135,70,77584,"476,538.88",141732
,20160905,12345,12280,12310,12350,12035,12075,12185,-205,-95,83772,"510,570.62",133268
,20160906,12075,12185,12025,12165,12000,12145,12060,-40,-125,49544,"298,853.90",128710
,20160907,12145,12060,12125,12200,12095,12170,12155,110,95,43858,"266,642.40",120538
,20160908,12170,12155,12200,12220,12100,12200,12160,45,5,35122,"213,570.18",115814
,20160909,12200,12160,12200,12295,12175,12280,12245,120,85,35584,"217,904.74",109688
,20160912,12280,12245,12260,12270,12160,12220,12210,-25,-35,35554,"217,122.72",106294
,20160913,12220,12210,12220,12300,12205,12250,12255,40,45,29246,"179,229.94",98586
,20160914,12250,12255,12210,12270,12125,12175,12195,-80,-60,38546,"235,082.58",96266
,20160919,12175,12195,12175,12245,12155,12200,12200,5,5,20450,"124,764.98",94974
,20160920,12200,12200,12200,12355,12200,12290,12290,90,90,29000,"178,223.41",86862
,20160921,12290,12290,12285,12425,12255,12360,12355,70,65,29484,"182,155.04",77338
,20160922,12360,12355,12360,12600,12360,12555,12510,200,155,31766,"198,760.27",68600
,20160923,12555,12510,12595,12780,12595,12745,12670,235,160,25396,"160,925.14",63060
,20160926,12745,12670,12745,12760,12570,12680,12680,10,10,24758,"157,014.51",55660
,20160927,12680,12680,12695,12780,12630,12715,12715,35,35,16472,"104,734.75",54298
,20160928,12715,12715,12715,12780,12595,12680,12665,-35,-50,14638,"92,699.24",51376
,20160929,12680,12665,12685,12945,12680,12845,12805,180,140,15538,"99,506.51",46740
,20160930,12845,12805,12845,12955,12765,12860,12845,55,40,10520,"67,588.08",43046
,20161010,12860,12845,12860,13305,12860,13265,13115,420,270,15136,"99,292.14",33970
,20161011,13265,13115,13290,13315,13205,13300,13260,185,145,12920,"85,688.50",25850
,20161012,13300,13260,13245,13375,13215,13325,13265,65,5,11490,"76,226.03",18870
,20161013,13325,13265,13385,13540,13375,13440,13475,175,210,7570,"51,021.20",14730
,20161014,13440,13475,13450,13550,13450,13510,13490,35,15,7500,"50,593.95",8560
,20161017,13510,13490,13455,13495,13220,13320,13395,-170,-95,5560,"37,245.93",3580
al1611,20160104,10850,10810,10720,10720,10600,10600,10645,-210,-165,20,106.47,2704
,20160105,10600,10645,10560,10660,10560,10660,10610,15,-35,930,"4,933.95",3462
,20160106,10660,10610,10580,10610,10360,10585,10490,-25,-120,90,472.16,3460
,20160107,10585,10490,10580,10630,10570,10630,10585,140,95,10,52.94,3460
,20160108,10630,10585,10740,10740,10660,10680,10680,95,95,254,"1,356.88",3684
,20160111,10680,10680,10715,10755,10705,10750,10720,70,40,48,257.37,3684
,20160112,10750,10720,10735,10745,10500,10500,10685,-220,-35,76,406.03,3718
,20160113,10500,10685,10580,10610,10410,10545,10535,-140,-150,164,864.09,3724
,20160114,10545,10535,10540,10685,10540,10635,10640,100,105,32,170.30,3728
,20160115,10635,10640,10700,10700,10670,10690,10685,50,45,72,384.70,3728
,20160118,10690,10685,10610,10760,10610,10740,10715,55,30,40,214.35,3728
,20160119,10740,10715,10745,10870,10745,10870,10840,155,125,714,"3,870.50",4238
,20160120,10870,10840,10840,10840,10790,10790,10795,-50,-45,124,669.36,4148
,20160121,10790,10795,,,,10795,10795,0,0,0,0.00,4148
,20160122,10795,10795,10865,10865,10815,10815,10835,20,40,16,86.72,4146
,20160125,10815,10835,10820,10820,10780,10790,10790,-45,-45,50,269.79,4144
,20160126,10790,10790,10780,10780,10735,10735,10745,-55,-45,20,107.49,4152
,20160127,10735,10745,10775,10860,10775,10860,10835,115,90,14,75.86,4146
,20160128,10860,10835,10855,10925,10840,10840,10910,5,75,212,"1,156.55",4148
,20160129,10840,10910,10875,10875,10815,10850,10850,-60,-60,12,65.11,4138
,20160201,10850,10850,10845,10860,10760,10760,10780,-90,-70,36,194.09,4150
,20160202,10760,10780,10810,10830,10800,10830,10820,50,40,938,"5,075.18",4152
,20160203,10830,10820,10840,10890,10825,10890,10850,70,30,322,"1,747.64",4110
,20160204,10890,10850,10930,11095,10930,11085,11005,235,155,66,363.25,4086
,20160205,11085,11005,11005,11005,11005,11005,11005,0,0,10,55.03,4086
,20160215,11005,11005,11030,11075,11000,11055,11050,50,45,38,210.01,4096
,20160216,11055,11050,11070,11250,11050,11180,11170,130,120,186,"1,039.15",4076
,20160217,11180,11170,11200,11270,11160,11160,11200,-10,30,186,"1,041.62",4088
,20160218,11160,11200,11170,11170,11095,11115,11135,-85,-65,20,111.36,4084
,20160219,11115,11135,11170,11225,11170,11220,11200,85,65,442,"2,475.91",3896
,20160222,11220,11200,11265,11450,11265,11435,11430,235,230,156,891.91,3924
,20160223,11435,11430,11455,11465,11455,11465,11455,35,25,6,34.38,3920
,20160224,11465,11455,11385,11480,11330,11375,11440,-80,-15,80,457.72,3902
,20160225,11375,11440,11455,11545,11425,11470,11470,30,30,10,57.37,3900
,20160226,11470,11470,11495,11520,11390,11495,11435,25,-35,192,"1,098.03",4002
,20160229,11495,11435,11525,11570,11480,11480,11550,45,115,48,277.28,3984
,20160301,11480,11550,11440,11455,11365,11450,11445,-100,-105,294,"1,682.76",4048
,20160302,11450,11445,11450,11510,11385,11510,11430,65,-15,32,182.93,4034
,20160303,11510,11430,11520,11590,11520,11555,11545,125,115,176,"1,016.33",4042
,20160304,11555,11545,11635,11635,11635,11635,11635,90,90,120,698.10,3942
,20160307,11635,11635,11635,11810,11595,11720,11700,85,65,18,105.33,3944
,20160308,11720,11700,11710,11740,11710,11740,11720,40,20,6,35.16,3944
,20160309,11740,11720,11680,11680,11335,11570,11575,-150,-145,34,196.85,3944
,20160310,11570,11575,11550,11550,11550,11550,11550,-25,-25,2,11.55,3942
,20160311,11550,11550,11515,11565,11500,11565,11525,15,-25,6,34.58,3938
,20160314,11565,11525,11565,11590,11520,11520,11565,-5,40,1440,"8,329.03",3772
,20160315,11520,11565,11470,11480,11470,11480,11475,-85,-90,4,22.95,3772
,20160316,11480,11475,11425,11425,11390,11390,11395,-85,-80,54,307.79,3732
,20160317,11390,11395,11470,11505,11470,11505,11470,110,75,26,149.15,3732
,20160318,11505,11470,11535,11565,11535,11560,11560,90,90,112,647.55,3706
,20160321,11560,11560,11520,11630,11520,11600,11620,40,60,332,"1,929.49",3510
,20160322,11600,11620,11655,11655,11580,11605,11620,-15,0,350,"2,033.78",3540
,20160323,11605,11620,11640,11640,11640,11640,11640,20,20,6,34.92,3540
,20160324,11640,11640,11620,11645,11550,11550,11630,-90,-10,38,220.99,3538
,20160325,11550,11630,11555,11665,11555,11665,11655,35,25,442,"2,576.28",3704
,20160328,11665,11655,11670,11710,11640,11665,11675,10,20,1170,"6,831.45",3574
,20160329,11665,11675,11735,11770,11615,11645,11715,-30,40,540,"3,163.25",3884
,20160330,11645,11715,11675,11775,11615,11680,11690,-35,-25,248,"1,449.77",3868
,20160331,11680,11690,11705,11730,11675,11700,11705,10,15,288,"1,685.67",3922
,20160401,11700,11705,11715,11820,11715,11810,11780,105,75,660,"3,887.44",4240
,20160405,11810,11780,11760,11845,11760,11790,11815,10,35,190,"1,122.68",4300
,20160406,11790,11815,11810,11850,11745,11745,11815,-70,0,522,"3,084.20",4592
,20160407,11745,11815,11755,11800,11740,11800,11770,-15,-45,84,494.35,4602
,20160408,11800,11770,11725,11725,11610,11630,11655,-140,-115,716,"4,173.51",4738
,20160411,11630,11655,11740,11780,11735,11765,11755,110,100,262,"1,540.05",4876
,20160412,11765,11755,11790,11790,11780,11785,11780,30,25,118,695.16,4914
,20160413,11785,11780,11845,11970,11845,11925,11910,145,130,890,"5,300.75",5270
,20160414,11925,11910,12020,12020,11890,11945,11945,35,35,826,"4,933.63",4966
,20160415,11945,11945,11985,11985,11930,11960,11950,15,5,500,"2,988.65",4864
,20160418,11960,11950,11940,11965,11915,11940,11945,-10,-5,498,"2,974.74",5056
,20160419,11940,11945,11965,11990,11945,11965,11975,20,30,226,"1,353.65",5114
,20160420,11965,11975,12000,12030,11990,12030,12010,55,35,2586,"15,531.45",6690
,20160421,12030,12010,12040,12330,12040,12290,12145,280,135,4530,"27,514.51",7872
,20160422,12290,12145,12340,12475,12100,12450,12350,305,205,2742,"16,937.32",9248
,20160425,12450,12350,12560,12735,12385,12580,12560,230,210,3664,"23,018.53",9478
,20160426,12580,12560,12500,12575,12465,12475,12505,-85,-55,1526,"9,541.94",10068
,20160427,12475,12505,12505,12640,12485,12530,12555,25,50,1046,"6,568.02",10556
,20160428,12530,12555,12590,12600,12300,12370,12395,-185,-160,3150,"19,528.59",11426
,20160429,12370,12395,12370,12540,12335,12530,12450,135,55,804,"5,006.52",11638
,20160503,12530,12450,12555,12615,12525,12550,12595,100,145,956,"6,020.61",12196
,20160504,12550,12595,12545,12545,12315,12315,12430,-280,-165,1204,"7,483.75",12818
,20160505,12315,12430,12390,12425,12300,12300,12310,-130,-120,766,"4,716.57",13218
,20160506,12300,12310,12320,12320,12080,12180,12150,-130,-160,1298,"7,888.15",13356
,20160509,12180,12150,12240,12280,11870,11915,11995,-235,-155,968,"5,806.28",13714
,20160510,11915,11995,11895,11895,11700,11830,11815,-165,-180,1496,"8,839.99",13974
,20160511,11830,11815,11880,12060,11840,12035,11940,220,125,1504,"8,982.35",14490
,20160512,12035,11940,12030,12165,12000,12100,12100,160,160,554,"3,352.55",14654
,20160513,12100,12100,12090,12090,11835,11970,11960,-130,-140,1218,"7,285.93",14662
,20160516,11970,11960,11935,12115,11925,12100,12040,140,80,772,"4,647.80",14804
,20160517,12100,12040,12100,12240,12095,12240,12190,200,150,2716,"16,554.40",15430
,20160518,12240,12190,12190,12240,12090,12095,12135,-95,-55,790,"4,793.44",15782
,20160519,12095,12135,11905,12185,11905,12125,12120,-10,-15,1126,"6,823.98",15854
,20160520,12125,12120,12085,12230,12080,12230,12165,110,45,1364,"8,297.68",16558
,20160523,12230,12165,12335,12345,12020,12035,12155,-130,-10,598,"3,635.34",16728
,20160524,12035,12155,12050,12110,11990,12040,12065,-115,-90,912,"5,503.77",17032
,20160525,12040,12065,12140,12140,11865,11900,11955,-165,-110,1170,"6,996.28",16884
,20160526,11900,11955,11940,12005,11775,11990,11920,35,-35,1306,"7,783.91",17258
,20160527,11990,11920,12000,12010,11800,11965,11940,45,20,3706,"22,126.41",19626
,20160530,11965,11940,11950,12005,11900,11965,11975,25,35,1396,"8,360.86",20238
,20160531,11965,11975,11965,11980,11875,11905,11935,-70,-40,1180,"7,042.31",20462
,20160601,11905,11935,11930,11930,11715,11730,11775,-205,-160,2668,"15,711.91",21210
,20160602,11730,11775,11750,11980,11720,11965,11910,190,135,3112,"18,535.03",22366
,20160603,11965,11910,11910,11950,11730,11750,11785,-160,-125,1910,"11,255.37",22540
,20160606,11750,11785,11835,11835,11595,11625,11700,-160,-85,2010,"11,760.55",23062
,20160607,11625,11700,11675,11695,11510,11590,11585,-110,-115,3666,"21,240.26",23910
,20160608,11590,11585,11600,11780,11555,11750,11670,165,85,2934,"17,119.96",23560
,20160613,11750,11670,11750,11780,11630,11735,11705,65,35,1004,"5,876.42",23782
,20160614,11735,11705,11775,11880,11700,11740,11785,35,80,2692,"15,864.23",24216
,20160615,11740,11785,11725,11760,11645,11745,11705,-40,-80,3444,"20,163.22",26022
,20160616,11745,11705,11800,11830,11755,11785,11785,80,80,5088,"29,986.03",27412
,20160617,11785,11785,11750,11845,11735,11805,11780,20,-5,4866,"28,671.34",28472
,20160620,11805,11780,11825,11890,11735,11875,11815,95,35,4376,"25,859.76",29230
,20160621,11875,11815,11890,11915,11855,11885,11880,70,65,4896,"29,093.02",30322
,20160622,11885,11880,11880,11970,11855,11960,11925,80,45,9710,"57,907.76",34470
,20160623,11960,11925,11970,11980,11905,11950,11945,25,20,2896,"17,301.30",35064
,20160624,11950,11945,11950,12015,11805,11820,11915,-125,-30,4940,"29,431.84",35554
,20160627,11820,11915,11820,12105,11820,12060,12010,145,95,6802,"40,850.80",34086
,20160628,12060,12010,12000,12105,11975,12030,12025,20,15,5396,"32,444.05",33952
,20160629,12030,12025,12095,12110,12010,12035,12050,10,25,5804,"34,983.16",35862
,20160630,12035,12050,12065,12140,12000,12130,12095,80,45,6972,"42,163.18",37400
,20160701,12130,12095,12130,12295,12070,12295,12200,200,105,18814,"114,794.29",41790
,20160704,12295,12200,12290,12415,12230,12265,12325,65,125,27500,"169,531.34",43998
,20160705,12265,12325,12265,12300,12035,12255,12165,-70,-160,18376,"111,781.82",42880
,20160706,12255,12165,12295,12310,12110,12235,12230,70,65,17638,"107,861.08",43598
,20160707,12235,12230,12165,12360,12135,12190,12260,-40,30,14644,"89,769.91",45922
,20160708,12190,12260,12185,12315,12155,12270,12225,10,-35,11058,"67,613.67",46038
,20160711,12270,12225,12325,12350,12255,12315,12295,90,70,11260,"69,228.14",49262
,20160712,12315,12295,12310,12325,12175,12220,12250,-75,-45,6120,"37,491.58",49092
,20160713,12220,12250,12280,12430,12250,12370,12340,120,90,14632,"90,312.72",49566
,20160714,12370,12340,12350,12400,12280,12395,12340,55,0,6286,"38,799.63",48866
,20160715,12395,12340,12415,12430,12345,12390,12395,50,55,8576,"53,149.99",49522
,20160718,12390,12395,12430,12445,12260,12310,12330,-85,-65,9542,"58,842.71",50624
,20160719,12310,12330,12285,12290,12080,12180,12220,-150,-110,16156,"98,748.50",51586
,20160720,12180,12220,12165,12290,12125,12235,12220,15,0,15894,"97,136.97",54026
,20160721,12235,12220,12120,12265,12085,12240,12185,20,-35,13316,"81,157.19",53016
,20160722,12240,12185,12200,12270,12025,12035,12150,-150,-35,11820,"71,823.27",54432
,20160725,12035,12150,12045,12110,11945,12075,12040,-75,-110,10368,"62,427.53",55264
,20160726,12075,12040,12040,12075,11995,12010,12030,-30,-10,8480,"51,025.87",57162
,20160727,12010,12030,12000,12045,11920,11950,11975,-80,-55,20416,"122,280.31",60870
,20160728,11950,11975,11970,12160,11900,12160,12060,185,85,18926,"114,138.42",60040
,20160729,12160,12060,12165,12200,12020,12090,12105,30,45,12720,"76,988.36",60736
,20160801,12090,12105,12120,12200,12085,12180,12165,75,60,17242,"104,893.59",64620
,20160802,12180,12165,12175,12185,12055,12135,12120,-30,-45,13900,"84,265.70",66150
,20160803,12135,12120,12185,12190,11960,11995,12060,-125,-60,15490,"93,426.70",69818
,20160804,11995,12060,12015,12070,11980,12010,12015,-50,-45,15736,"94,548.67",71080
,20160805,12010,12015,11970,12160,11950,12135,12075,120,60,22088,"133,373.99",73010
,20160808,12135,12075,12135,12290,12110,12280,12225,205,150,30914,"188,993.56",78906
,20160809,12280,12225,12260,12295,12180,12210,12240,-15,15,22464,"137,515.08",83352
,20160810,12210,12240,12195,12365,12195,12355,12290,115,50,27750,"170,582.60",92796
,20160811,12355,12290,12370,12385,12260,12300,12310,10,20,22340,"137,507.66",95576
,20160812,12300,12310,12300,12300,12205,12250,12250,-60,-60,12214,"74,838.78",95600
,20160815,12250,12250,12240,12275,12150,12205,12215,-45,-35,24806,"151,551.74",98314
,20160816,12205,12215,12220,12370,12210,12340,12295,125,80,31964,"196,564.15",106958
,20160817,12340,12295,12370,12385,12295,12345,12340,50,45,29564,"182,423.35",113506
,20160818,12345,12340,12355,12630,12345,12620,12485,280,145,70036,"437,246.32",132658
,20160819,12620,12485,12655,12655,12485,12560,12550,75,65,48526,"304,554.61",132826
,20160822,12560,12550,12500,12505,12200,12300,12390,-250,-160,61678,"382,226.64",131676
,20160823,12300,12390,12300,12365,12220,12350,12305,-40,-85,26046,"160,305.43",130148
,20160824,12350,12305,12335,12400,12305,12350,12350,45,45,27174,"167,840.15",129506
,20160825,12350,12350,12345,12350,12215,12260,12260,-90,-90,48310,"296,199.80",131172
,20160826,12260,12260,12210,12365,12210,12295,12290,35,30,45900,"282,166.84",136112
,20160829,12295,12290,12305,12375,12230,12270,12315,-20,25,40638,"250,285.29",140834
,20160830,12270,12315,12290,12325,12200,12210,12240,-105,-75,50596,"309,670.31",144418
,20160831,12210,12240,12215,12260,12110,12130,12190,-110,-50,72092,"439,433.11",153048
,20160901,12130,12190,12095,12155,12055,12110,12110,-80,-80,83166,"503,672.41",160242
,20160902,12110,12110,12075,12245,12070,12205,12180,95,70,107270,"653,458.94",164336
,20160905,12205,12180,12210,12220,11885,11965,12040,-215,-140,221590,"1,334,446.99",224970
,20160906,11965,12040,11935,12030,11850,11995,11925,-45,-115,172430,"1,028,237.17",242198
,20160907,11995,11925,11965,12050,11940,12010,12010,85,85,124304,"746,451.90",235340
,20160908,12010,12010,12025,12055,11915,11990,11985,-20,-25,114328,"685,175.89",237304
,20160909,11990,11985,11960,12100,11960,12050,12035,65,50,97082,"584,297.07",230914
,20160912,12050,12035,12030,12045,11910,11960,11975,-75,-60,113940,"682,238.84",233992
,20160913,11960,11975,11955,12070,11955,12025,12025,50,50,101988,"613,234.73",215834
,20160914,12025,12025,12025,12035,11835,11875,11925,-150,-100,149656,"892,496.49",226064
,20160919,11875,11925,11925,11975,11875,11915,11915,-10,-10,76484,"455,702.91",227986
,20160920,11915,11915,11915,12115,11910,12065,12035,150,120,132564,"797,886.62",211084
,20160921,12065,12035,12050,12190,12035,12145,12115,110,80,134810,"816,807.06",201986
,20160922,12145,12115,12175,12355,12120,12310,12250,195,135,151512,"928,336.22",193246
,20160923,12310,12250,12375,12530,12335,12495,12430,245,180,186206,"1,157,518.41",183554
,20160926,12495,12430,12495,12510,12320,12420,12415,-10,-15,161124,"1,000,259.07",168408
,20160927,12420,12415,12440,12555,12370,12495,12480,80,65,149292,"931,794.49",171774
,20160928,12495,12480,12515,12520,12355,12445,12430,-35,-50,115466,"717,849.38",163228
,20160929,12445,12430,12440,12690,12440,12590,12560,160,130,149908,"941,619.43",153602
,20160930,12590,12560,12580,12620,12455,12465,12520,-95,-40,94502,"591,628.74",140562
,20161010,12465,12520,12490,12910,12490,12865,12745,345,225,117772,"750,791.62",146942
,20161011,12865,12745,12870,12990,12835,12950,12910,205,165,97846,"631,715.74",139144
,20161012,12950,12910,12900,12935,12765,12890,12870,-20,-40,78892,"507,672.25",133158
,20161013,12890,12870,12945,13070,12905,13010,12995,140,125,60428,"392,634.52",130614
,20161014,13010,12995,13020,13190,12975,13100,13100,105,105,53550,"350,753.79",126208
,20161017,13100,13100,13100,13110,12930,12980,12990,-120,-110,49822,"323,659.40",118274
,20161018,12980,12990,12900,13025,12890,13010,12960,20,-30,31434,"203,713.40",108500
,20161019,13010,12960,12985,13050,12830,12865,12935,-95,-25,34316,"221,965.72",101238
,20161020,12865,12935,12865,12940,12840,12855,12875,-80,-60,23088,"148,672.67",96594
,20161021,12855,12875,12805,12960,12735,12895,12890,20,15,26784,"172,679.29",88024
,20161024,12895,12890,12895,13225,12840,13215,13065,325,175,29934,"195,570.90",82800
,20161025,13215,13065,13215,13585,13180,13585,13405,520,340,32776,"219,682.03",73514
,20161026,13585,13405,13650,14280,13645,13935,13990,530,585,65338,"457,155.38",58556
,20161027,13935,13990,13985,14045,13750,13910,13875,-80,-115,34476,"239,247.90",55488
,20161028,13910,13875,13910,14385,13910,14265,14195,390,320,28942,"205,487.03",49640
,20161031,14265,14195,14290,14750,14280,14525,14525,330,330,28302,"205,605.00",43534
,20161101,14525,14525,14590,14685,14410,14540,14555,15,30,9954,"72,441.09",38660
,20161102,14540,14555,14520,14545,13970,13970,14240,-585,-315,10950,"77,980.85",33160
,20161103,13970,14240,13900,14065,13790,14015,13895,-225,-345,9020,"62,679.03",30980
,20161104,14015,13895,14090,14145,13700,13725,13880,-170,-15,8310,"57,691.78",28590
,20161107,13725,13880,13690,14100,13650,13960,13935,80,55,5450,"37,983.23",26660
,20161108,13960,13935,13985,14115,13855,14090,14030,155,95,5350,"37,542.83",25000
,20161109,14090,14030,14065,14435,14065,14330,14320,300,290,7090,"50,767.80",21040
,20161110,14330,14320,14440,14890,14420,14890,14790,570,470,3720,"27,510.03",17890
,20161111,14890,14790,15200,15300,13805,15235,15155,445,365,3510,"26,603.80",14910
,20161114,15235,15155,15480,15985,15000,15180,15385,25,230,6140,"47,232.88",9200
,20161115,15180,15385,15170,15240,14840,14985,15110,-400,-275,4220,"31,885.68",5180
al1612,20160104,10790,10835,10685,10685,10685,10685,10685,-150,-150,2,10.69,50
,20160105,10685,10685,10635,10635,10595,10600,10620,-85,-65,26,138.10,70
,20160106,10600,10620,10660,10660,10555,10630,10620,10,0,60,318.75,110
,20160107,10630,10620,10560,10560,10560,10560,10560,-60,-60,2,10.56,110
,20160108,10560,10560,,,,10560,10560,0,0,0,0.00,110
,20160111,10560,10560,10625,10760,10625,10760,10690,200,130,4,21.39,110
,20160112,10760,10690,10690,10750,10480,10480,10615,-210,-75,22,116.81,114
,20160113,10480,10615,10550,10565,10530,10565,10555,-50,-60,16,84.47,116
,20160114,10565,10555,,,,10660,10660,105,105,0,0.00,116
,20160115,10660,10660,,,,10660,10660,0,0,0,0.00,116
,20160118,10660,10660,10750,10750,10750,10750,10750,90,90,6,32.25,122
,20160119,10750,10750,10865,10870,10865,10870,10865,120,115,4,21.74,124
,20160120,10870,10865,10800,10800,10800,10800,10800,-65,-65,4,21.60,126
,20160121,10800,10800,,,,10800,10800,0,0,0,0.00,126
,20160122,10800,10800,10825,10825,10825,10825,10825,25,25,2,10.83,128
,20160125,10825,10825,,,,10825,10825,0,0,0,0.00,128
,20160126,10825,10825,,,,10825,10825,0,0,0,0.00,128
,20160127,10825,10825,10830,10830,10830,10830,10830,5,5,22,119.13,148
,20160128,10830,10830,10905,10920,10870,10920,10915,90,85,90,491.27,228
,20160129,10920,10915,10875,10875,10830,10830,10865,-85,-50,16,86.96,228
,20160201,10830,10865,10780,10780,10765,10765,10770,-100,-95,6,32.32,226
,20160202,10765,10770,10815,10840,10800,10840,10810,70,40,166,897.26,368
,20160203,10840,10810,10835,10905,10835,10905,10870,95,60,48,260.91,374
,20160204,10905,10870,10920,11085,10920,11070,11035,200,165,86,474.61,362
,20160205,11070,11035,11055,11055,11030,11030,11040,-5,5,4,22.09,364
,20160215,11030,11040,11065,11085,11025,11070,11055,30,15,12,66.36,366
,20160216,11070,11055,11050,11255,11050,11190,11160,135,105,232,"1,294.69",440
,20160217,11190,11160,11210,11280,11160,11160,11235,0,75,62,348.39,452
,20160218,11160,11235,11165,11245,11105,11125,11130,-110,-105,80,445.24,422
,20160219,11125,11130,11200,11205,11200,11205,11200,75,70,22,123.21,408
,20160222,11205,11200,11395,11455,11395,11440,11450,240,250,86,492.41,476
,20160223,11440,11450,11465,11475,11435,11435,11465,-15,15,34,194.91,470
,20160224,11435,11465,11365,11485,11360,11390,11400,-75,-65,62,353.46,472
,20160225,11390,11400,11470,11555,11470,11485,11495,85,95,32,183.95,492
,20160226,11485,11495,11510,11540,11425,11510,11470,15,-25,122,699.95,500
,20160229,11510,11470,11550,11590,11490,11490,11550,20,80,52,300.34,522
,20160301,11490,11550,11470,11470,11355,11460,11430,-90,-120,16,91.45,522
,20160302,11460,11430,11515,11565,11410,11565,11505,135,75,120,690.33,546
,20160303,11565,11505,11560,11585,11525,11550,11555,45,50,370,"2,138.26",690
,20160304,11550,11555,11695,11695,11655,11690,11665,135,110,18,105.00,686
,20160307,11690,11665,11645,11900,11640,11700,11855,35,190,110,652.26,688
,20160308,11700,11855,11820,11830,11730,11770,11785,-85,-70,20,117.88,688
,20160309,11770,11785,11620,11620,11565,11565,11610,-220,-175,20,116.15,690
,20160310,11565,11610,,,,11610,11610,0,0,0,0.00,690
,20160311,11610,11610,11535,11585,11475,11585,11535,-25,-75,10,57.68,692
,20160314,11585,11535,11590,11605,11585,11585,11595,50,60,14,81.17,698
,20160315,11585,11595,11530,11530,11470,11470,11505,-125,-90,22,126.60,694
,20160316,11470,11505,11410,11410,11410,11410,11410,-95,-95,8,45.64,690
,20160317,11410,11410,11505,11505,11505,11505,11505,95,95,2,11.51,690
,20160318,11505,11505,11540,11680,11540,11580,11585,75,80,42,243.35,694
,20160321,11580,11585,11550,11670,11545,11625,11640,40,55,94,547.17,768
,20160322,11625,11640,11660,11660,11585,11585,11645,-55,5,110,640.66,838
,20160323,11585,11645,11605,11635,11605,11620,11620,-25,-25,26,151.07,838
,20160324,11620,11620,11665,11670,11555,11555,11645,-65,25,28,163.04,836
,20160325,11555,11645,11570,11695,11570,11660,11660,15,15,46,268.21,846
,20160328,11660,11660,11715,11725,11640,11675,11690,15,30,378,"2,209.80",950
,20160329,11675,11690,11725,11770,11640,11640,11725,-50,35,442,"2,592.09",1158
,20160330,11640,11725,11680,11680,11680,11680,11680,-45,-45,4,23.36,1156
,20160331,11680,11680,11680,11720,11680,11700,11700,20,20,150,877.72,1232
,20160401,11700,11700,11755,11810,11740,11800,11780,100,80,596,"3,510.90",1584
,20160405,11800,11780,11775,11835,11750,11785,11815,5,35,240,"1,418.38",1758
,20160406,11785,11815,11815,11845,11745,11745,11820,-70,5,122,721.05,1844
,20160407,11745,11820,11785,11795,11760,11760,11775,-60,-45,84,494.73,1828
,20160408,11760,11775,11705,11705,11600,11625,11640,-150,-135,1180,"6,869.76",2500
,20160411,11625,11640,11700,11780,11700,11775,11765,135,125,470,"2,765.31",2730
,20160412,11775,11765,11780,11780,11780,11780,11780,15,15,22,129.58,2736
,20160413,11780,11780,11850,11960,11850,11930,11905,150,125,952,"5,666.87",3156
,20160414,11930,11905,11990,12005,11890,11940,11965,35,60,80,478.64,3186
,20160415,11940,11965,11930,11970,11930,11945,11945,-20,-20,14,83.64,3178
,20160418,11945,11945,11920,11970,11885,11955,11945,10,0,178,"1,063.45",3172
,20160419,11955,11945,11970,12000,11955,11975,11975,30,30,170,"1,017.92",3270
,20160420,11975,11975,12000,12030,11990,12030,12010,55,35,1160,"6,967.31",4042
,20160421,12030,12010,12055,12350,12045,12285,12150,275,140,2132,"12,955.45",4866
,20160422,12285,12150,12335,12450,12100,12450,12340,300,190,1556,"9,601.99",5740
,20160425,12450,12340,12530,12780,12365,12555,12565,215,225,2984,"18,751.34",6758
,20160426,12555,12565,12405,12590,12405,12465,12500,-100,-65,784,"4,900.06",6794
,20160427,12465,12500,12460,12600,12450,12500,12545,0,45,540,"3,387.27",6884
,20160428,12500,12545,12535,12580,12275,12370,12375,-175,-170,1492,"9,234.83",7244
,20160429,12370,12375,12350,12535,12320,12525,12450,150,75,1170,"7,285.64",7848
,20160503,12525,12450,12535,12615,12525,12540,12560,90,110,396,"2,487.71",7886
,20160504,12540,12560,12550,12550,12360,12365,12440,-195,-120,542,"3,371.83",8128
,20160505,12365,12440,12335,12385,12285,12295,12310,-145,-130,674,"4,148.51",8466
,20160506,12295,12310,12285,12295,12080,12175,12155,-135,-155,1078,"6,553.85",8310
,20160509,12175,12155,12245,12315,11875,11920,11995,-235,-160,970,"5,817.85",8576
,20160510,11920,11995,11900,11910,11715,11840,11810,-155,-185,752,"4,441.77",8728
,20160511,11840,11810,11890,12080,11845,12080,11940,270,130,538,"3,212.65",8992
,20160512,12080,11940,12035,12165,12015,12110,12090,170,150,304,"1,837.93",8926
,20160513,12110,12090,12065,12065,11850,11985,11940,-105,-150,928,"5,541.69",9028
,20160516,11985,11940,12020,12125,11930,12105,12005,165,65,1238,"7,433.73",8730
,20160517,12105,12005,12105,12240,12105,12215,12180,210,175,1310,"7,981.10",8786
,20160518,12215,12180,12180,12240,12080,12080,12175,-100,-5,318,"1,936.40",8820
,20160519,12080,12175,11890,12175,11890,12105,12110,-70,-65,894,"5,413.81",8992
,20160520,12105,12110,12080,12230,12070,12230,12160,120,50,1418,"8,623.92",9702
,20160523,12230,12160,12345,12345,12000,12050,12125,-110,-35,436,"2,644.27",9870
,20160524,12050,12125,11965,12105,11965,12075,12050,-50,-75,138,831.57,9904
,20160525,12075,12050,12140,12140,11880,11880,11990,-170,-60,1884,"11,295.51",10176
,20160526,11880,11990,11910,12045,11790,12010,11910,20,-80,714,"4,252.18",10460
,20160527,12010,11910,12010,12010,11815,11980,11940,70,30,1976,"11,799.63",11906
,20160530,11980,11940,11950,12005,11905,11970,11975,30,35,1054,"6,313.26",12308
,20160531,11970,11975,11975,12000,11885,11905,11950,-70,-25,742,"4,433.89",12394
,20160601,11905,11950,11925,11925,11730,11740,11785,-210,-165,598,"3,523.82",12552
,20160602,11740,11785,11800,11995,11795,11980,11925,195,140,1542,"9,195.17",13456
,20160603,11980,11925,11895,11955,11730,11760,11770,-165,-155,2148,"12,646.20",14122
,20160606,11760,11770,11820,11820,11605,11620,11700,-150,-70,2492,"14,581.65",14754
,20160607,11620,11700,11650,11700,11520,11610,11580,-90,-120,2064,"11,952.92",15934
,20160608,11610,11580,11635,11765,11570,11750,11665,170,85,1842,"10,745.78",15908
,20160613,11750,11665,11765,11790,11645,11720,11705,55,40,596,"3,488.12",16040
,20160614,11720,11705,11780,11875,11695,11725,11785,20,80,734,"4,325.53",16156
,20160615,11725,11785,11750,11750,11655,11720,11710,-65,-75,534,"3,126.62",16116
,20160616,11720,11710,11805,11820,11750,11800,11775,90,65,1758,"10,353.82",15984
,20160617,11800,11775,11750,11835,11730,11805,11775,30,0,1880,"11,069.91",16490
,20160620,11805,11775,11785,11890,11750,11875,11835,100,60,1334,"7,894.06",16918
,20160621,11875,11835,11900,11910,11850,11895,11880,60,45,2308,"13,709.92",17700
,20160622,11895,11880,11870,11955,11850,11955,11915,75,35,7008,"41,755.52",20902
,20160623,11955,11915,12025,12025,11895,11925,11925,10,10,1986,"11,843.38",21290
,20160624,11925,11925,11950,11990,11785,11800,11915,-125,-10,1452,"8,652.61",21482
,20160627,11800,11915,11840,12050,11840,12005,11970,90,55,3582,"21,442.48",22388
,20160628,12005,11970,11960,12060,11930,12010,11990,40,20,4910,"29,445.46",22770
,20160629,12010,11990,12060,12060,11980,12005,12010,15,20,4362,"26,194.00",24616
,20160630,12005,12010,12005,12085,11960,12080,12040,70,30,4776,"28,757.02",25436
,20160701,12080,12040,12100,12200,12020,12200,12120,160,80,9882,"59,885.74",27142
,20160704,12200,12120,12200,12325,11800,12195,12240,75,120,17736,"108,566.70",34802
,20160705,12195,12240,12210,12225,11950,12175,12105,-65,-135,9786,"59,233.70",35436
,20160706,12175,12105,12215,12245,12055,12175,12160,70,55,7802,"47,440.18",35642
,20160707,12175,12160,12110,12280,12080,12090,12180,-70,20,6890,"41,966.18",36968
,20160708,12090,12180,12115,12220,12040,12185,12145,5,-35,4640,"28,186.21",36906
,20160711,12185,12145,12240,12240,12160,12210,12195,65,50,5882,"35,871.29",37760
,20160712,12210,12195,12205,12230,12095,12160,12160,-35,-35,3636,"22,109.56",38110
,20160713,12160,12160,12190,12330,12160,12255,12245,95,85,11488,"70,347.70",39500
,20160714,12255,12245,12250,12300,12200,12290,12255,45,10,5192,"31,814.01",39284
,20160715,12290,12255,12305,12335,12250,12290,12290,35,35,6596,"40,541.29",39624
,20160718,12290,12290,12330,12350,12180,12215,12235,-75,-55,8468,"51,804.38",39934
,20160719,12215,12235,12210,12220,12060,12160,12160,-75,-75,13004,"79,085.12",40714
,20160720,12160,12160,12135,12265,12110,12205,12205,45,45,10340,"63,101.99",41562
,20160721,12205,12205,12140,12225,12055,12210,12175,5,-30,10232,"62,310.17",41028
,20160722,12210,12175,12195,12240,12010,12020,12135,-155,-40,8384,"50,880.19",42838
,20160725,12020,12135,12060,12100,11955,12065,12035,-70,-100,7478,"45,006.36",44302
,20160726,12065,12035,12040,12065,11980,11995,12010,-40,-25,4336,"26,042.44",44304
,20160727,11995,12010,11980,12015,11905,11920,11955,-90,-55,10776,"64,423.34",45680
,20160728,11920,11955,11940,12115,11880,12100,12010,145,55,11824,"71,017.76",43738
,20160729,12100,12010,12145,12180,11980,12055,12050,45,40,6600,"39,776.15",43394
,20160801,12055,12050,12065,12160,12050,12150,12120,100,70,7690,"46,618.02",43010
,20160802,12150,12120,12150,12150,12020,12095,12085,-25,-35,5760,"34,810.70",43436
,20160803,12095,12085,12145,12145,11915,11965,12020,-120,-65,7802,"46,897.93",46650
,20160804,11965,12020,12000,12020,11945,11975,11985,-45,-35,9488,"56,866.76",48936
,20160805,11975,11985,11945,12115,11935,12080,12035,95,50,12518,"75,352.79",49162
,20160808,12080,12035,12095,12240,12065,12210,12165,175,130,18838,"114,619.32",48578
,20160809,12210,12165,12205,12230,12105,12150,12175,-15,10,9156,"55,744.56",48134
,20160810,12150,12175,12145,12300,12140,12255,12210,80,35,10876,"66,423.28",50726
,20160811,12255,12210,12280,12295,12185,12200,12230,-10,20,7228,"44,201.11",51642
,20160812,12200,12230,12200,12220,12130,12185,12175,-45,-55,3596,"21,899.51",51448
,20160815,12185,12175,12185,12215,12090,12130,12150,-45,-25,7370,"44,781.94",50952
,20160816,12130,12150,12125,12295,12125,12270,12235,120,85,14846,"90,836.36",55802
,20160817,12270,12235,12275,12300,12225,12275,12265,40,30,9622,"59,014.56",57184
,20160818,12275,12265,12300,12650,12270,12510,12390,245,125,35692,"221,140.87",71182
,20160819,12510,12390,12485,12525,12395,12475,12450,85,60,21836,"135,969.90",72898
,20160822,12475,12450,12410,12410,12215,12225,12315,-225,-135,21132,"130,148.82",73738
,20160823,12225,12315,12240,12295,12165,12290,12245,-25,-70,6982,"42,754.61",73786
,20160824,12290,12245,12270,12340,12245,12285,12285,40,40,8536,"52,446.02",75652
,20160825,12285,12285,12285,12285,12170,12205,12210,-80,-75,20680,"126,257.48",80894
,20160826,12205,12210,12185,12295,12170,12230,12235,20,25,18862,"115,400.91",81530
,20160829,12230,12235,12240,12295,12185,12210,12245,-25,10,19622,"120,157.75",83032
,20160830,12210,12245,12210,12255,12135,12155,12170,-90,-75,15800,"96,163.36",85880
,20160831,12155,12170,12155,12180,12050,12050,12115,-120,-55,16686,"101,091.05",88318
,20160901,12050,12115,12045,12095,12000,12060,12050,-55,-65,18464,"111,261.48",89190
,20160902,12060,12050,12040,12170,12015,12110,12105,60,55,26406,"159,825.90",85030
,20160905,12110,12105,12110,12145,11830,11885,11990,-220,-115,46576,"279,238.13",93406
,20160906,11885,11990,11880,11960,11795,11935,11855,-55,-135,36168,"214,455.19",97834
,20160907,11935,11855,11890,11975,11865,11905,11920,50,65,24440,"145,700.99",99108
,20160908,11905,11920,11925,11950,11820,11860,11875,-60,-45,25572,"151,842.17",104956
,20160909,11860,11875,11860,11965,11800,11920,11900,45,25,19794,"117,818.99",105726
,20160912,11920,11900,11900,11910,11790,11840,11845,-60,-55,30758,"182,197.75",104494
,20160913,11840,11845,11840,11910,11815,11880,11870,35,25,27604,"163,885.03",108556
,20160914,11880,11870,11880,11885,11685,11720,11770,-150,-100,36892,"217,167.13",116144
,20160919,11720,11770,11770,11790,11700,11745,11745,-25,-25,20562,"120,752.85",119608
,20160920,11745,11745,11745,11945,11740,11905,11870,160,125,48198,"286,128.47",122382
,20160921,11905,11870,11895,12015,11875,11965,11950,95,80,46474,"277,796.97",126136
,20160922,11965,11950,12000,12145,11950,12120,12070,170,120,54356,"328,093.96",133306
,20160923,12120,12070,12160,12300,12130,12285,12220,215,150,81888,"500,375.42",144640
,20160926,12285,12220,12295,12295,12100,12190,12180,-30,-40,68044,"414,550.56",149092
,20160927,12190,12180,12200,12320,12135,12280,12245,100,65,76186,"466,454.16",159852
,20160928,12280,12245,12285,12305,12140,12260,12230,15,-15,61994,"379,247.91",169682
,20160929,12260,12230,12270,12455,12260,12350,12360,120,130,111738,"690,626.90",172330
,20160930,12350,12360,12370,12385,12245,12270,12295,-90,-65,54748,"336,658.82",172868
,20161010,12270,12295,12305,12605,12290,12580,12480,285,185,95090,"593,584.94",179652
,20161011,12580,12480,12600,12725,12575,12710,12650,230,170,130360,"824,703.10",196636
,20161012,12710,12650,12685,12710,12540,12665,12635,15,-15,170886,"1,079,862.53",204136
,20161013,12665,12635,12695,12815,12660,12765,12750,130,115,164466,"1,048,528.32",225132
,20161014,12765,12750,12765,12960,12725,12865,12860,115,110,192156,"1,235,751.53",244610
,20161017,12865,12860,12875,12895,12655,12720,12740,-140,-120,188756,"1,202,803.82",239878
,20161018,12720,12740,12660,12790,12625,12785,12700,45,-40,126208,"801,723.50",244694
,20161019,12785,12700,12735,12815,12560,12590,12680,-110,-20,189492,"1,201,776.03",236698
,20161020,12590,12680,12560,12670,12555,12575,12610,-105,-70,127564,"804,386.57",237874
,20161021,12575,12610,12545,12695,12465,12630,12605,20,-5,143252,"903,133.90",230600
,20161024,12630,12605,12625,12945,12580,12930,12790,325,185,200718,"1,283,984.75",227772
,20161025,12930,12790,12920,13300,12900,13300,13090,510,300,196192,"1,284,441.12",224526
,20161026,13300,13090,13390,13995,13350,13620,13700,530,610,543864,"3,726,239.61",207904
,20161027,13620,13700,13660,13715,13390,13530,13540,-170,-160,309382,"2,095,147.32",214614
,20161028,13530,13540,13585,13960,13540,13860,13795,320,255,332560,"2,294,532.92",214640
,20161031,13860,13795,13885,14285,13830,14100,14060,305,265,359262,"2,525,992.25",204846
,20161101,14100,14060,14145,14255,13970,14115,14120,55,60,224166,"1,583,081.36",188092
,20161102,14115,14120,14100,14115,13555,13555,13840,-565,-280,192448,"1,331,993.48",161690
,20161103,13555,13840,13520,13720,13430,13665,13545,-175,-295,150376,"1,018,694.78",140858
,20161104,13665,13545,13715,13790,13375,13425,13605,-120,60,101548,"691,015.69",133246
,20161107,13425,13605,13430,13795,13350,13565,13595,-40,-10,99246,"674,645.94",121690
,20161108,13565,13595,13575,13750,13505,13610,13615,15,20,70160,"477,717.08",120614
,20161109,13610,13615,13620,14045,13555,13830,13835,215,220,102728,"710,730.44",115684
,20161110,13830,13835,13870,14385,13870,14385,14205,550,370,79614,"565,484.41",106212
,20161111,14385,14205,14460,14670,14060,14460,14425,255,220,74532,"537,564.15",104566
,20161114,14460,14425,14470,15215,14165,14750,14680,325,255,127718,"937,523.49",92896
,20161115,14750,14680,14755,14850,14165,14190,14565,-490,-115,83136,"605,514.00",83384
,20161116,14190,14565,14240,14305,13870,13980,14085,-585,-480,45470,"320,286.74",79556
,20161117,13980,14085,13960,13985,13640,13785,13775,-300,-310,37548,"258,646.54",74266
,20161118,13785,13775,13765,14020,13740,14015,13895,240,120,30336,"210,834.49",70374
,20161121,14015,13895,14090,14535,13850,14490,14210,595,315,30730,"218,373.24",64958
,20161122,14490,14210,14525,14705,14415,14600,14555,390,345,30720,"223,630.17",61172
,20161123,14600,14555,14605,14780,14440,14445,14595,-110,40,24250,"176,973.85",59002
,20161124,14445,14595,14420,14720,14130,14405,14470,-190,-125,38396,"277,801.01",54596
,20161125,14405,14470,14465,14465,14190,14295,14315,-175,-155,22388,"160,265.51",54812
,20161128,14295,14315,14285,14520,14250,14400,14370,85,55,14770,"106,125.64",52320
,20161129,14400,14370,14400,14415,13985,13990,14115,-380,-255,18576,"131,131.03",47282
,20161130,13990,14115,13990,14010,13505,13680,13790,-435,-325,12718,"87,698.13",42108
,20161201,13680,13790,13805,14005,13755,13935,13870,145,80,10368,"71,920.25",41930
,20161202,13935,13870,13900,14045,13770,13925,13930,55,60,5520,"38,449.33",39360
,20161205,13925,13930,13930,14010,13810,13840,13870,-90,-60,3560,"24,696.78",37450
,20161206,13840,13870,13845,13935,13640,13730,13765,-140,-105,7680,"52,870.33",34070
,20161207,13730,13765,13690,13700,13300,13450,13515,-315,-250,9480,"64,062.13",29280
,20161208,13450,13515,13500,13535,13280,13370,13370,-145,-145,7030,"47,007.00",25910
,20161209,13370,13370,13415,13480,13300,13445,13395,75,25,4070,"27,259.55",23150
,20161212,13445,13395,13455,13600,13455,13490,13555,95,160,5000,"33,898.60",18820
,20161213,13490,13555,13450,13490,13315,13385,13390,-170,-165,4590,"30,738.20",15320
,20161214,13385,13390,13200,13200,12970,12970,13055,-420,-335,4020,"26,250.00",12380
,20161215,12970,13055,12450,12960,12450,12945,12805,-110,-250,5330,"34,135.53",9840
al1701,20160118,10660,10660,10535,10785,10535,10755,10690,95,30,18,96.23,10
,20160119,10755,10690,,,,10690,10690,0,0,0,0.00,10
,20160120,10690,10690,10800,10800,10800,10800,10800,110,110,2,10.80,10
,20160121,10800,10800,10760,10760,10750,10750,10755,-50,-45,4,21.51,14
,20160122,10750,10755,,,,10760,10760,5,5,0,0.00,14
,20160125,10760,10760,,,,10760,10760,0,0,0,0.00,14
,20160126,10760,10760,,,,10765,10765,5,5,0,0.00,14
,20160127,10765,10765,10840,10840,10840,10840,10840,75,75,2,10.84,14
,20160128,10840,10840,,,,10925,10925,85,85,0,0.00,14
,20160129,10925,10925,,,,10875,10875,-50,-50,0,0.00,14
,20160201,10875,10875,10755,10755,10755,10755,10755,-120,-120,2,10.76,16
,20160202,10755,10755,10840,10840,10840,10840,10840,85,85,2,10.84,18
,20160203,10840,10840,10825,10905,10805,10905,10835,65,-5,22,119.20,16
,20160204,10905,10835,10955,11055,10955,11000,11005,165,170,10,55.05,24
,20160205,11000,11005,,,,11010,11010,5,5,0,0.00,24
,20160215,11010,11010,,,,11010,11010,0,0,0,0.00,24
,20160216,11010,11010,11110,11285,11000,11180,11180,170,170,104,581.54,104
,20160217,11180,11180,11240,11265,11215,11230,11240,50,60,30,168.64,110
,20160218,11230,11240,11190,11190,11120,11120,11155,-120,-85,8,44.62,110
,20160219,11120,11155,,,,11155,11155,0,0,0,0.00,110
,20160222,11155,11155,11280,11455,11280,11450,11425,295,270,56,319.99,148
,20160223,11450,11425,11485,11500,11470,11470,11475,45,50,20,114.79,154
,20160224,11470,11475,11395,11395,11395,11395,11395,-80,-80,2,11.40,156
,20160225,11395,11395,11460,11500,11460,11500,11480,105,85,4,22.96,156
,20160226,11500,11480,11500,11500,11500,11500,11500,20,20,2,11.50,154
,20160229,11500,11500,11600,11600,11555,11560,11590,60,90,38,220.24,160
,20160301,11560,11590,11485,11485,11445,11460,11460,-130,-130,6,34.39,166
,20160302,11460,11460,11490,11595,11445,11555,11510,95,50,28,161.18,178
,20160303,11555,11510,11575,11600,11555,11595,11565,85,55,228,"1,318.96",272
,20160304,11595,11565,11610,11710,11610,11710,11680,145,115,10,58.42,278
,20160307,11710,11680,11655,11895,11655,11735,11815,55,135,154,910.05,316
,20160308,11735,11815,11815,11860,11730,11730,11800,-85,-15,50,295.07,346
,20160309,11730,11800,11735,11735,11460,11630,11595,-170,-205,80,463.82,346
,20160310,11630,11595,11610,11615,11610,11615,11610,20,15,4,23.23,346
,20160311,11615,11610,11575,11715,11525,11615,11600,5,-10,36,208.81,350
,20160314,11615,11600,11535,11655,11535,11570,11610,-30,10,26,150.96,356
,20160315,11570,11610,,,,11610,11610,0,0,0,0.00,356
,20160316,11610,11610,11435,11470,11430,11460,11450,-150,-160,46,263.41,350
,20160317,11460,11450,11495,11555,11475,11500,11515,50,65,16,92.14,356
,20160318,11500,11515,11580,11610,11550,11610,11585,95,70,14,81.13,360
,20160321,11610,11585,11665,11690,11665,11690,11670,105,85,16,93.37,358
,20160322,11690,11670,11635,11670,11600,11635,11625,-35,-45,88,511.64,358
,20160323,11635,11625,11610,11665,11605,11665,11640,40,15,12,69.87,350
,20160324,11665,11640,11605,11665,11570,11570,11610,-70,-30,66,383.22,354
,20160325,11570,11610,11585,11715,11585,11690,11680,80,70,20,116.82,366
,20160328,11690,11680,11690,11740,11675,11685,11710,5,30,182,"1,065.88",466
,20160329,11685,11710,11720,11765,11665,11665,11745,-45,35,272,"1,597.39",560
,20160330,11665,11745,11650,11695,11625,11665,11665,-80,-80,36,210.04,568
,20160331,11665,11665,11660,11735,11660,11700,11695,35,30,112,655.15,562
,20160401,11700,11695,11725,11795,11725,11795,11770,100,75,366,"2,153.92",666
,20160405,11795,11770,11830,11830,11820,11820,11820,50,50,122,721.09,712
,20160406,11820,11820,11770,11840,11725,11730,11815,-90,-5,68,401.78,724
,20160407,11730,11815,11755,11780,11715,11765,11740,-50,-75,100,587.01,722
,20160408,11765,11740,11660,11670,11625,11625,11655,-115,-85,84,489.58,724
,20160411,11625,11655,11705,11770,11690,11770,11725,115,70,162,950.02,766
,20160412,11770,11725,11800,11800,11770,11790,11785,65,60,32,188.62,792
,20160413,11790,11785,11860,11960,11845,11920,11895,135,110,270,"1,606.24",934
,20160414,11920,11895,12005,12020,11865,11945,11990,50,95,124,743.46,966
,20160415,11945,11990,11985,11985,11950,11955,11955,-35,-35,126,753.33,1062
,20160418,11955,11955,11920,11970,11890,11945,11935,-10,-20,142,847.72,1050
,20160419,11945,11935,11980,12000,11950,11990,11970,55,35,42,251.43,1060
,20160420,11990,11970,12000,12040,11995,12035,12015,65,45,172,"1,033.32",1060
,20160421,12035,12015,12035,12420,12035,12275,12190,260,175,186,"1,133.93",1102
,20160422,12275,12190,12280,12500,12065,12415,12330,225,140,582,"3,588.31",1140
,20160425,12415,12330,12505,12770,12340,12540,12515,210,185,904,"5,656.84",1108
,20160426,12540,12515,12480,12575,12405,12440,12485,-75,-30,254,"1,585.67",1138
,20160427,12440,12485,12445,12585,12425,12500,12490,15,5,176,"1,099.56",1116
,20160428,12500,12490,12535,12560,12270,12355,12360,-135,-130,546,"3,374.42",1250
,20160429,12355,12360,12350,12570,12265,12520,12485,160,125,396,"2,472.38",1382
,20160503,12520,12485,12640,12640,12515,12540,12565,55,80,48,301.60,1366
,20160504,12540,12565,12515,12515,12315,12340,12445,-225,-120,638,"3,970.20",1850
,20160505,12340,12445,12290,12400,12280,12280,12315,-165,-130,114,702.08,1864
,20160506,12280,12315,12360,12360,12070,12180,12205,-135,-110,332,"2,026.84",1944
,20160509,12180,12205,12225,12300,11890,11955,11965,-250,-240,390,"2,333.57",2092
,20160510,11955,11965,11925,11930,11730,11850,11840,-115,-125,450,"2,664.68",2070
,20160511,11850,11840,11880,12020,11870,12020,11935,180,95,116,692.23,1980
,20160512,12020,11935,12040,12175,12040,12150,12080,215,145,58,350.44,1972
,20160513,12150,12080,12025,12025,11835,11965,11920,-115,-160,74,441.14,1962
,20160516,11965,11920,12010,12140,11960,12110,12045,190,125,288,"1,734.99",1964
,20160517,12110,12045,12125,12220,12125,12220,12185,175,140,88,536.15,1968
,20160518,12220,12185,12190,12270,12020,12100,12160,-85,-25,162,985.34,1980
,20160519,12100,12160,12065,12170,12065,12100,12130,-60,-30,216,"1,310.17",1972
,20160520,12100,12130,12100,12215,12075,12215,12145,85,15,60,364.42,1956
,20160523,12215,12145,12290,12290,11995,12095,12120,-50,-25,88,533.48,1942
,20160524,12095,12120,12075,12125,11810,12035,12055,-85,-65,78,470.34,1930
,20160525,12035,12055,12140,12155,11900,11905,12065,-150,10,92,555.10,1964
,20160526,11905,12065,11970,12020,11835,12020,11900,-45,-165,172,"1,023.70",1974
,20160527,12020,11900,12020,12020,11800,11980,11875,80,-25,298,"1,769.38",2016
,20160530,11980,11875,11930,12000,11930,11980,11975,105,100,22,131.75,2014
,20160531,11980,11975,12020,12020,11855,11855,11955,-120,-20,80,478.27,2046
,20160601,11855,11955,11935,11935,11730,11735,11780,-220,-175,164,966.08,2096
,20160602,11735,11780,11755,12000,11755,11980,11900,200,120,126,749.96,2118
,20160603,11980,11900,11960,11960,11755,11755,11805,-145,-95,166,980.19,2156
,20160606,11755,11805,11810,11825,11640,11640,11750,-165,-55,236,"1,386.94",2234
,20160607,11640,11750,11680,11705,11520,11590,11610,-160,-140,98,569.05,2248
,20160608,11590,11610,11630,11780,11595,11780,11695,170,85,90,526.42,2244
,20160613,11780,11695,11725,11780,11660,11750,11720,55,25,142,832.16,2270
,20160614,11750,11720,11805,11885,11580,11805,11805,85,85,142,838.38,2276
,20160615,11805,11805,11750,11750,11695,11740,11720,-65,-85,272,"1,594.16",2300
,20160616,11740,11720,11800,11820,11780,11790,11795,70,75,220,"1,297.77",2270
,20160617,11790,11795,11780,11835,11780,11825,11810,30,15,388,"2,291.57",2300
,20160620,11825,11810,11815,11900,11770,11890,11840,80,30,334,"1,977.46",2422
,20160621,11890,11840,11900,11915,11860,11880,11895,40,55,610,"3,628.01",2512
,20160622,11880,11895,11885,11960,11860,11960,11910,65,15,1520,"9,054.00",2746
,20160623,11960,11910,11960,11960,11895,11930,11930,20,20,704,"4,200.01",3168
,20160624,11930,11930,11950,11995,11800,11800,11895,-130,-35,300,"1,784.38",3222
,20160627,11800,11895,11895,12035,11850,11990,11970,95,75,548,"3,279.89",3354
,20160628,11990,11970,11960,12055,11915,11990,11980,20,10,826,"4,949.70",3526
,20160629,11990,11980,12015,12025,11970,11995,11990,15,10,1398,"8,383.30",4198
,20160630,11995,11990,12015,12065,11980,12060,12020,70,30,2960,"17,796.80",6348
,20160701,12060,12020,12105,12180,12000,12150,12100,130,80,5504,"33,303.30",9672
,20160704,12150,12100,12180,12290,12010,12165,12205,65,105,4328,"26,411.64",11658
,20160705,12165,12205,12190,12200,11950,12135,12075,-70,-130,2986,"18,032.30",12268
,20160706,12135,12075,12145,12220,12040,12135,12135,60,60,1850,"11,225.63",12248
,20160707,12135,12135,11930,12245,11930,12110,12130,-25,-5,3678,"22,310.22",13560
,20160708,12110,12130,12080,12170,12030,12155,12080,25,-50,1400,"8,459.36",13676
,20160711,12155,12080,12185,12245,12100,12165,12140,85,60,2918,"17,717.29",15424
,20160712,12165,12140,12145,12175,12060,12110,12115,-30,-25,1346,"8,154.23",15812
,20160713,12110,12115,12170,12300,12125,12210,12195,95,80,4152,"25,326.41",17422
,20160714,12210,12195,12210,12345,12165,12255,12205,60,10,3352,"20,463.33",18478
,20160715,12255,12205,12255,12275,12180,12255,12235,50,30,2930,"17,931.05",18854
,20160718,12255,12235,12280,12290,12140,12170,12215,-65,-20,2500,"15,271.48",20134
,20160719,12170,12215,12170,12180,12050,12130,12125,-85,-90,4426,"26,836.32",21612
,20160720,12130,12125,12125,12245,12105,12175,12185,50,60,2570,"15,660.22",21640
,20160721,12175,12185,12050,12200,12050,12175,12160,-10,-25,4620,"28,093.54",20632
,20160722,12175,12160,12180,12195,12010,12010,12085,-150,-75,3574,"21,598.23",21044
,20160725,12010,12085,12075,12100,11960,12070,12045,-15,-40,3112,"18,743.15",21684
,20160726,12070,12045,12035,12075,11970,11995,12020,-50,-25,1302,"7,825.50",21846
,20160727,11995,12020,11995,12020,11905,11910,11945,-110,-75,2572,"15,364.41",22748
,20160728,11910,11945,11950,12095,11880,12095,12025,150,80,3522,"21,181.44",22622
,20160729,12095,12025,12085,12120,11950,12030,12020,5,-5,2740,"16,470.25",22966
,20160801,12030,12020,12045,12130,12010,12120,12090,100,70,4522,"27,345.65",23468
,20160802,12120,12090,12105,12120,11955,12080,12070,-10,-20,2192,"13,233.81",23870
,20160803,12080,12070,12110,12120,11915,11935,12005,-135,-65,2530,"15,190.85",24554
,20160804,11935,12005,12000,12010,11935,11990,11985,-15,-20,5066,"30,362.78",26884
,20160805,11990,11985,11965,12095,11930,12070,12030,85,45,4248,"25,554.97",27804
,20160808,12070,12030,12085,12175,12050,12175,12130,145,100,6468,"39,244.38",28176
,20160809,12175,12130,12180,12180,12060,12100,12120,-30,-10,3072,"18,622.07",28646
,20160810,12100,12120,12115,12210,12095,12205,12165,85,45,3368,"20,487.77",28902
,20160811,12205,12165,12210,12220,12120,12145,12160,-20,-5,2892,"17,586.29",29334
,20160812,12145,12160,12145,12165,12070,12150,12125,-10,-35,1798,"10,903.28",29814
,20160815,12150,12125,12130,12150,12030,12090,12110,-35,-15,2722,"16,486.43",29928
,20160816,12090,12110,12125,12240,12110,12205,12190,95,80,9164,"55,875.19",34154
,20160817,12205,12190,12220,12240,12160,12205,12200,15,10,6994,"42,678.12",32348
,20160818,12205,12200,12230,12400,12155,12400,12310,200,110,19662,"121,032.73",35306
,20160819,12400,12310,12415,12445,12305,12390,12360,80,50,10596,"65,496.43",36100
,20160822,12390,12360,12350,12350,12155,12155,12250,-205,-110,10356,"63,436.89",36980
,20160823,12155,12250,12155,12255,12105,12225,12200,-25,-50,3164,"19,307.28",36706
,20160824,12225,12200,12240,12285,12175,12225,12230,25,30,3538,"21,639.99",37054
,20160825,12225,12230,12230,12230,12120,12155,12165,-75,-65,4614,"28,068.17",37350
,20160826,12155,12165,12140,12250,12120,12175,12190,10,25,5796,"35,336.71",37158
,20160829,12175,12190,12170,12250,12135,12160,12195,-30,5,7960,"48,553.28",37800
,20160830,12160,12195,12160,12205,12075,12095,12120,-100,-75,5376,"32,584.59",39212
,20160831,12095,12120,12095,12115,12010,12015,12050,-105,-70,7904,"47,632.91",41600
,20160901,12015,12050,11970,12040,11955,12010,11995,-40,-55,7448,"44,684.67",41756
,20160902,12010,11995,11990,12115,11970,12060,12065,65,70,13684,"82,563.40",42052
,20160905,12060,12065,12050,12070,11790,11840,11945,-225,-120,22630,"135,186.22",46132
,20160906,11840,11945,11835,11925,11755,11900,11815,-45,-130,17912,"105,829.60",47076
,20160907,11900,11815,11895,11925,11820,11855,11875,40,60,9048,"53,727.31",47854
,20160908,11855,11875,11860,11890,11760,11795,11810,-80,-65,10898,"64,366.87",49458
,20160909,11795,11810,11795,11950,11795,11845,11835,35,25,10812,"63,996.38",50280
,20160912,11845,11835,11830,11840,11725,11775,11775,-60,-60,13604,"80,108.77",51064
,20160913,11775,11775,11775,11830,11760,11810,11795,35,20,17338,"102,278.87",51800
,20160914,11810,11795,11810,11815,11610,11645,11685,-150,-110,20044,"117,132.11",57636
,20160919,11645,11685,11755,11755,11610,11630,11645,-55,-40,15044,"87,610.68",62214
,20160920,11630,11645,11630,11850,11630,11830,11775,185,130,17856,"105,155.10",63528
,20160921,11830,11775,11830,11910,11750,11860,11855,85,80,22178,"131,491.79",59574
,20160922,11860,11855,11860,12020,11845,11980,11945,125,90,18580,"110,976.32",60880
,20160923,11980,11945,12025,12150,12005,12110,12075,165,130,32936,"198,925.07",69112
,20160926,12110,12075,12110,12145,11940,12025,12010,-50,-65,38332,"230,208.60",78486
,20160927,12025,12010,12010,12140,11945,12105,12055,95,45,37224,"224,410.73",90462
,20160928,12105,12055,12105,12120,11970,12105,12070,50,15,25930,"156,505.83",90828
,20160929,12105,12070,12115,12240,12105,12160,12170,90,100,45546,"277,247.68",101406
,20160930,12160,12170,12150,12185,12065,12080,12110,-90,-60,20796,"125,948.74",104192
,20161010,12080,12110,12130,12375,12125,12335,12265,225,155,43514,"266,954.56",113632
,20161011,12335,12265,12345,12515,12340,12500,12440,235,175,45938,"285,843.32",121814
,20161012,12500,12440,12440,12510,12355,12480,12450,40,10,54972,"342,236.34",115894
,20161013,12480,12450,12505,12605,12470,12560,12550,110,100,51124,"320,814.95",113472
,20161014,12560,12550,12550,12750,12525,12675,12655,125,105,55756,"352,925.58",123860
,20161017,12675,12655,12665,12695,12450,12515,12545,-140,-110,61212,"383,998.71",129514
,20161018,12515,12545,12465,12610,12420,12600,12510,55,-35,45308,"283,411.81",134888
,20161019,12600,12510,12545,12635,12365,12370,12485,-140,-25,74382,"464,421.12",141884
,20161020,12370,12485,12360,12450,12345,12360,12395,-125,-90,42028,"260,560.55",143312
,20161021,12360,12395,12330,12490,12265,12425,12405,30,10,51966,"322,399.96",146550
,20161024,12425,12405,12405,12710,12390,12710,12580,305,175,70528,"443,683.57",149954
,20161025,12710,12580,12705,13080,12680,13080,12875,500,295,118886,"765,496.13",151534
,20161026,13080,12875,13145,13735,13105,13330,13450,455,575,242844,"1,633,323.35",136770
,20161027,13330,13450,13350,13390,13100,13230,13235,-220,-215,138308,"915,577.12",148716
,20161028,13230,13235,13300,13610,13175,13510,13460,275,225,170166,"1,145,618.12",154786
,20161031,13510,13460,13525,13865,13485,13725,13690,265,230,214552,"1,469,118.80",167662
,20161101,13725,13690,13790,13885,13610,13740,13755,50,65,192270,"1,322,527.37",178184
,20161102,13740,13755,13740,13750,13200,13200,13445,-555,-310,294782,"1,982,024.33",187476
,20161103,13200,13445,13230,13475,13180,13410,13305,-35,-140,260894,"1,735,985.25",192384
,20161104,13410,13305,13490,13540,13185,13245,13385,-60,80,287006,"1,921,358.40",203836
,20161107,13245,13385,13285,13580,13215,13340,13395,-45,10,338492,"2,267,766.93",204920
,20161108,13340,13395,13340,13520,13270,13355,13375,-40,-20,302074,"2,020,373.10",211964
,20161109,13355,13375,13345,13695,13300,13490,13520,115,145,468358,"3,167,076.24",216636
,20161110,13490,13520,13560,14060,13550,14060,13880,540,360,536290,"3,722,666.46",241474
,20161111,14060,13880,14165,14255,13925,14105,14090,225,210,442056,"3,114,770.04",228928
,20161114,14105,14090,14210,14850,13610,14330,14220,240,130,793962,"5,645,580.05",222388
,20161115,14330,14220,14280,14445,13725,13800,14145,-420,-75,597190,"4,224,269.06",218096
,20161116,13800,14145,13805,13930,13485,13600,13720,-545,-425,431322,"2,959,742.75",217268
,20161117,13600,13720,13565,13615,13275,13430,13445,-290,-275,359502,"2,416,829.79",212194
,20161118,13430,13445,13400,13665,13385,13635,13545,190,100,360164,"2,439,286.85",201068
,20161121,13635,13545,13655,14140,13480,14090,13800,545,255,409674,"2,827,311.15",203440
,20161122,14090,13800,14120,14315,14020,14210,14150,410,350,374006,"2,646,277.11",191742
,20161123,14210,14150,14190,14370,14050,14100,14210,-50,60,352842,"2,507,573.83",193646
,20161124,14100,14210,14110,14350,13820,14075,14135,-135,-75,560262,"3,960,865.68",193644
,20161125,14075,14135,14075,14120,13850,13960,13990,-175,-145,348334,"2,436,635.10",184852
,20161128,13960,13990,13940,14185,13880,14085,14020,95,30,352976,"2,474,842.59",168458
,20161129,14085,14020,14035,14065,13530,13570,13725,-450,-295,374286,"2,569,374.76",160500
,20161130,13570,13725,13560,13615,13075,13270,13375,-455,-350,316108,"2,114,694.48",158568
,20161201,13270,13375,13295,13630,13290,13520,13470,145,95,223204,"1,503,691.39",150198
,20161202,13520,13470,13465,13670,13350,13510,13485,40,15,133814,"902,451.51",145566
,20161205,13510,13485,13500,13610,13370,13405,13475,-80,-10,93932,"633,053.53",141522
,20161206,13405,13475,13435,13530,13250,13340,13400,-135,-75,70654,"473,439.77",133948
,20161207,13340,13400,13295,13340,13075,13225,13205,-175,-195,66052,"436,146.07",126742
,20161208,13225,13205,13255,13350,13090,13210,13205,5,0,49934,"329,752.57",117494
,20161209,13210,13205,13245,13410,13120,13350,13295,145,90,44216,"293,950.39",109408
,20161212,13350,13295,13350,13565,13300,13430,13465,135,170,34668,"233,469.73",102880
,20161213,13430,13465,13390,13425,13240,13250,13340,-215,-125,23268,"155,245.48",99750
,20161214,13250,13340,13285,13325,12975,12990,13085,-350,-255,38022,"248,764.74",92422
,20161215,12990,13085,13150,13150,12810,12955,12890,-130,-195,33974,"219,029.51",88814
,20161216,12955,12890,12895,13045,12845,12880,12945,-10,55,21772,"140,969.36",88194
,20161219,12880,12945,12850,12885,12610,12610,12710,-335,-235,33864,"215,209.39",81656
,20161220,12610,12710,12610,12695,12520,12655,12625,-55,-85,21306,"134,537.62",79032
,20161221,12655,12625,12680,12920,12670,12905,12790,280,165,22372,"143,119.25",75844
,20161222,12905,12790,12880,12960,12800,12835,12875,45,85,19308,"124,323.29",74094
,20161223,12835,12875,12825,12945,12645,12700,12790,-175,-85,19728,"126,207.90",71516
,20161226,12700,12790,12710,12815,12495,12645,12585,-145,-205,22120,"139,207.42",65594
,20161227,12645,12585,12670,12785,12570,12760,12700,175,115,17694,"112,375.18",62358
,20161228,12760,12700,12760,12910,12605,12625,12755,-75,55,11794,"75,225.37",61934
,20161229,12625,12755,12585,12695,12530,12675,12610,-80,-145,14672,"92,530.36",57750
,20161230,12675,12610,12620,12850,12595,12800,12765,190,155,16610,"106,053.41",51214
al1702,20160216,11010,11010,11150,11150,11150,11150,11150,140,140,4,22.30,4
,20160217,11150,11150,,,,11150,11150,0,0,0,0.00,4
,20160218,11150,11150,11160,11160,11160,11160,11160,10,10,2,11.16,6
,20160219,11160,11160,,,,11160,11160,0,0,0,0.00,6
,20160222,11160,11160,,,,11430,11430,270,270,0,0.00,6
,20160223,11430,11430,11495,11505,11495,11500,11500,70,70,6,34.50,8
,20160224,11500,11500,11400,11400,11400,11400,11400,-100,-100,2,11.40,10
,20160225,11400,11400,11645,11645,11645,11645,11645,245,245,40,232.90,50
,20160226,11645,11645,11555,11595,11540,11595,11565,-50,-80,26,150.37,58
,20160229,11595,11565,11625,11625,11615,11615,11620,50,55,10,58.12,56
,20160301,11615,11620,11485,11485,11485,11485,11485,-135,-135,2,11.49,58
,20160302,11485,11485,11540,11540,11540,11540,11540,55,55,8,46.16,60
,20160303,11540,11540,11620,11645,11585,11605,11590,65,50,76,440.58,124
,20160304,11605,11590,11640,11700,11630,11670,11670,80,80,14,81.71,134
,20160307,11670,11670,11685,11865,11685,11755,11785,85,115,32,188.58,156
,20160308,11755,11785,11845,11875,11725,11830,11810,45,25,96,567.02,154
,20160309,11830,11810,11760,11825,11555,11645,11645,-165,-165,16,93.18,146
,20160310,11645,11645,,,,11660,11660,15,15,0,0.00,146
,20160311,11660,11660,,,,11660,11660,0,0,0,0.00,146
,20160314,11660,11660,11590,11660,11585,11600,11615,-60,-45,36,209.08,150
,20160315,11600,11615,11575,11575,11575,11575,11575,-40,-40,4,23.15,150
,20160316,11575,11575,11480,11480,11465,11465,11470,-110,-105,4,22.95,148
,20160317,11465,11470,11460,11560,11460,11510,11505,40,35,28,161.13,170
,20160318,11510,11505,11620,11720,11620,11630,11655,125,150,32,186.50,186
,20160321,11630,11655,11585,11680,11585,11680,11620,25,-35,20,116.20,180
,20160322,11680,11620,11695,11780,11620,11620,11685,0,65,46,268.76,202
,20160323,11620,11685,,,,11685,11685,0,0,0,0.00,202
,20160324,11685,11685,11655,11700,11640,11640,11670,-45,-15,8,46.69,206
,20160325,11640,11670,11595,11680,11595,11680,11630,10,-40,30,174.52,208
,20160328,11680,11630,11705,11725,11700,11725,11710,95,80,10,58.57,212
,20160329,11725,11710,11760,11770,11660,11660,11730,-50,20,130,762.70,288
,20160330,11660,11730,11670,11670,11665,11665,11665,-65,-65,12,70.01,294
,20160331,11665,11665,11700,11715,11700,11715,11700,50,35,26,152.15,306
,20160401,11715,11700,11750,11790,11750,11790,11765,90,65,284,"1,671.18",444
,20160405,11790,11765,11780,11780,11780,11780,11780,15,15,2,11.78,444
,20160406,11780,11780,11815,11840,11770,11770,11830,-10,50,48,284.01,480
,20160407,11770,11830,11785,11785,11785,11785,11785,-45,-45,2,11.79,480
,20160408,11785,11785,11640,11655,11635,11650,11635,-135,-150,30,174.59,478
,20160411,11650,11635,,,,11665,11665,30,30,0,0.00,478
,20160412,11665,11665,11785,11805,11760,11805,11790,140,125,26,153.27,488
,20160413,11805,11790,11860,11950,11850,11920,11900,130,110,108,642.65,548
,20160414,11920,11900,12000,12000,11895,11910,11930,10,30,12,71.59,556
,20160415,11910,11930,11990,11990,11940,11945,11955,15,25,14,83.69,560
,20160418,11945,11955,11920,11970,11900,11925,11920,-30,-35,54,321.97,558
,20160419,11925,11920,11970,11970,11950,11950,11950,30,30,44,262.98,556
,20160420,11950,11950,12000,12035,12000,12035,12025,85,75,52,312.70,574
,20160421,12035,12025,12055,12270,12040,12270,12160,245,135,324,"1,970.64",798
,20160422,12270,12160,12340,12420,12195,12380,12330,220,170,284,"1,750.88",976
,20160425,12380,12330,12520,12790,12325,12515,12495,185,165,214,"1,337.27",1018
,20160426,12515,12495,12450,12525,12360,12440,12490,-55,-5,232,"1,449.13",1022
,20160427,12440,12490,12440,12570,12420,12495,12515,5,25,164,"1,026.63",1084
,20160428,12495,12515,12495,12500,12270,12345,12345,-170,-170,340,"2,099.01",1110
,20160429,12345,12345,12345,12530,12330,12510,12455,165,110,254,"1,582.04",1190
,20160503,12510,12455,12575,12595,12510,12545,12545,90,90,74,464.26,1204
,20160504,12545,12545,12515,12515,12310,12310,12420,-235,-125,142,882.11,1244
,20160505,12310,12420,12325,12350,12260,12305,12310,-115,-110,40,246.26,1254
,20160506,12305,12310,12350,12350,12065,12190,12175,-120,-135,76,462.66,1254
,20160509,12190,12175,12195,12265,11885,11955,12020,-220,-155,118,709.31,1298
,20160510,11955,12020,11920,11930,11720,11840,11800,-180,-220,170,"1,003.17",1248
,20160511,11840,11800,11865,11940,11865,11940,11935,140,135,38,226.79,1216
,20160512,11940,11935,12100,12155,12035,12135,12045,200,110,200,"1,204.78",1242
,20160513,12135,12045,12080,12080,11910,11975,12020,-70,-25,70,420.80,1244
,20160516,11975,12020,12105,12150,12095,12095,12110,75,90,18,109.02,1256
,20160517,12095,12110,12145,12235,12145,12185,12180,75,70,18,109.65,1260
,20160518,12185,12180,12215,12220,12090,12090,12200,-90,20,86,524.73,1292
,20160519,12090,12200,11865,12165,11860,12090,12115,-110,-85,140,848.14,1322
,20160520,12090,12115,12045,12185,12045,12185,12110,70,-5,28,169.60,1316
,20160523,12185,12110,12290,12290,12010,12010,12130,-100,20,58,351.90,1332
,20160524,12010,12130,12105,12105,12030,12030,12060,-100,-70,28,168.89,1322
,20160525,12030,12060,12115,12120,11910,11910,12045,-150,-15,156,939.79,1302
,20160526,11910,12045,11975,12045,11815,12025,11900,-20,-145,128,761.60,1288
,20160527,12025,11900,11985,11985,11830,11950,11885,50,-15,114,677.64,1318
,20160530,11950,11885,11980,12000,11960,11980,11975,95,90,180,"1,077.97",1280
,20160531,11980,11975,11985,12075,11890,11910,11970,-65,-5,154,921.94,1268
,20160601,11910,11970,11875,11875,11750,11760,11795,-210,-175,346,"2,041.08",1348
,20160602,11760,11795,11770,11955,11770,11930,11850,135,55,64,379.26,1368
,20160603,11930,11850,11885,11915,11760,11765,11825,-85,-25,46,272.00,1374
,20160606,11765,11825,11780,11815,11665,11685,11740,-140,-85,60,352.33,1398
,20160607,11685,11740,11705,11705,11560,11580,11590,-160,-150,32,185.47,1426
,20160608,11580,11590,11650,11800,11650,11800,11700,210,110,62,362.79,1428
,20160613,11800,11700,11725,11725,11705,11705,11715,5,15,8,46.86,1436
,20160614,11705,11715,11885,11895,11725,11765,11775,50,60,32,188.46,1444
,20160615,11765,11775,11730,11830,11475,11750,11710,-25,-65,14,82.00,1446
,20160616,11750,11710,11850,11850,11785,11795,11790,85,80,92,542.46,1468
,20160617,11795,11790,11810,11845,11805,11820,11805,30,15,26,153.53,1480
,20160620,11820,11805,11815,11875,11815,11875,11820,70,15,22,130.03,1496
,20160621,11875,11820,11890,11920,11885,11900,11905,80,85,164,976.45,1522
,20160622,11900,11905,11900,11940,11865,11940,11915,35,10,618,"3,682.67",1746
,20160623,11940,11915,11950,11960,11900,11930,11920,15,5,782,"4,662.40",1884
,20160624,11930,11920,11955,11955,11800,11800,11865,-120,-55,758,"4,496.90",2102
,20160627,11800,11865,11910,12020,11870,12000,11930,135,65,240,"1,431.75",2226
,20160628,12000,11930,11930,12050,11920,11990,11965,60,35,440,"2,632.67",2404
,20160629,11990,11965,12020,12020,11945,11980,11975,15,10,154,922.31,2432
,20160630,11980,11975,11970,12040,11970,12040,12015,65,40,230,"1,381.79",2590
,20160701,12040,12015,12055,12150,12010,12100,12075,85,60,998,"6,025.65",3206
,20160704,12100,12075,12135,12250,12095,12165,12165,90,90,1728,"10,513.52",3910
,20160705,12165,12165,12170,12195,11990,12100,12085,-65,-80,818,"4,943.31",4014
,20160706,12100,12085,12175,12200,12070,12130,12135,45,50,350,"2,124.40",4082
,20160707,12130,12135,12105,12230,12060,12090,12120,-45,-15,1812,"10,981.17",5140
,20160708,12090,12120,12090,12145,12040,12145,12105,25,-15,262,"1,585.86",5266
,20160711,12145,12105,12195,12230,12075,12140,12115,35,10,576,"3,489.47",5600
,20160712,12140,12115,12160,12160,12030,12075,12075,-40,-40,286,"1,727.32",5660
,20160713,12075,12075,12115,12265,12105,12180,12175,105,100,1626,"9,900.31",6052
,20160714,12180,12175,12200,12220,12140,12215,12165,40,-10,646,"3,930.67",6324
,20160715,12215,12165,12215,12245,12170,12220,12210,55,45,1008,"6,155.91",6814
,20160718,12220,12210,12250,12255,12115,12135,12155,-75,-55,1416,"8,607.96",7322
,20160719,12135,12155,12120,12155,12030,12120,12095,-35,-60,1356,"8,203.59",8072
,20160720,12120,12095,12095,12240,12095,12160,12175,65,80,842,"5,127.11",8378
,20160721,12160,12175,12120,12215,12050,12180,12155,5,-20,982,"5,968.86",8816
,20160722,12180,12155,12180,12200,12020,12020,12105,-135,-50,1202,"7,278.01",9430
,20160725,12020,12105,12045,12115,11970,12075,12040,-30,-65,1262,"7,600.33",9564
,20160726,12075,12040,12045,12115,11985,12015,12040,-25,0,418,"2,517.12",9636
,20160727,12015,12040,11970,12045,11910,11925,11955,-115,-85,830,"4,961.50",9592
,20160728,11925,11955,11910,12100,11890,12090,12020,135,65,1486,"8,933.35",9168
,20160729,12090,12020,12110,12110,11940,12010,12005,-10,-15,702,"4,214.33",9132
,20160801,12010,12005,12045,12115,12045,12110,12090,105,85,742,"4,486.05",9226
,20160802,12110,12090,12045,12110,11980,12100,12080,10,-10,924,"5,581.24",9476
,20160803,12100,12080,12115,12115,11930,11930,12025,-150,-55,762,"4,582.23",9860
,20160804,11930,12025,11965,12015,11960,11990,11985,-35,-40,422,"2,528.90",10016
,20160805,11990,11985,11950,12090,11940,12075,12055,90,70,830,"5,002.85",10250
,20160808,12075,12055,12065,12160,12065,12160,12120,105,65,4066,"24,647.98",11986
,20160809,12160,12120,12160,12165,12050,12075,12095,-45,-25,974,"5,891.73",12154
,20160810,12075,12095,12100,12170,12080,12160,12130,65,35,1652,"10,020.83",12412
,20160811,12160,12130,12170,12175,12080,12100,12120,-30,-10,1016,"6,157.83",12686
,20160812,12100,12120,12115,12125,12065,12110,12095,-10,-25,714,"4,318.87",12562
,20160815,12110,12095,12085,12105,12015,12075,12075,-20,-20,910,"5,495.36",12682
,20160816,12075,12075,12120,12205,12070,12200,12165,125,90,2768,"16,841.81",14048
,20160817,12200,12165,12185,12215,12150,12185,12180,20,15,4738,"28,856.08",15360
,20160818,12185,12180,12205,12350,12205,12350,12270,170,90,9088,"55,776.21",21256
,20160819,12350,12270,12375,12375,12255,12335,12310,65,40,3640,"22,408.98",22566
,20160822,12335,12310,12270,12270,12150,12170,12195,-140,-115,2932,"17,885.07",23234
,20160823,12170,12195,12125,12225,12120,12210,12175,15,-20,1006,"6,125.52",23298
,20160824,12210,12175,12250,12250,12155,12195,12205,20,30,2156,"13,158.89",23820
,20160825,12195,12205,12200,12200,12070,12130,12140,-75,-65,914,"5,548.87",24000
,20160826,12130,12140,12140,12215,12120,12170,12175,30,35,1098,"6,686.23",24078
,20160829,12170,12175,12120,12225,12120,12150,12175,-25,0,2550,"15,523.48",25774
,20160830,12150,12175,12130,12200,12050,12075,12110,-100,-65,1598,"9,676.06",26634
,20160831,12075,12110,12040,12080,11985,11985,12015,-125,-95,2642,"15,876.59",27386
,20160901,11985,12015,11985,12025,11930,12000,11980,-15,-35,4278,"25,630.56",28894
,20160902,12000,11980,11950,12090,11950,12020,12030,40,50,4390,"26,411.70",29984
,20160905,12020,12030,12040,12065,11770,11855,11905,-175,-125,8054,"47,952.14",32876
,20160906,11855,11905,11835,11905,11735,11895,11790,-10,-115,4216,"24,859.63",34012
,20160907,11895,11790,11880,11915,11805,11835,11850,45,60,3328,"19,721.33",34422
,20160908,11835,11850,11845,11875,11735,11780,11785,-70,-65,3168,"18,672.39",34946
,20160909,11780,11785,11780,11860,11775,11820,11805,35,20,2840,"16,769.87",35190
,20160912,11820,11805,11790,11810,11700,11755,11755,-50,-50,6118,"35,972.34",35432
,20160913,11755,11755,11755,11800,11730,11775,11770,20,15,3894,"22,920.97",34644
,20160914,11775,11770,11760,11795,11585,11620,11660,-150,-110,7466,"43,526.85",36622
,20160919,11620,11660,11690,11690,11580,11600,11615,-60,-45,5358,"31,124.38",38192
,20160920,11600,11615,11615,11815,11610,11785,11740,170,125,8102,"47,562.26",39440
,20160921,11785,11740,11770,11860,11755,11815,11825,75,85,8250,"48,779.04",41558
,20160922,11815,11825,11835,11950,11800,11915,11890,90,65,9268,"55,118.20",42796
,20160923,11915,11890,11945,12060,11920,12050,11990,160,100,15680,"94,019.49",48342
,20160926,12050,11990,12035,12050,11860,11930,11935,-60,-55,8524,"50,872.97",51004
,20160927,11930,11935,11930,12025,11865,11990,11960,55,25,12428,"74,334.28",54392
,20160928,11990,11960,11995,12025,11885,12020,11980,60,20,11498,"68,890.39",55268
,20160929,12020,11980,12045,12110,12005,12010,12055,30,75,17914,"107,998.15",58222
,20160930,12010,12055,12010,12050,11950,11960,11990,-95,-65,6744,"40,431.42",59720
,20161010,11960,11990,12005,12200,11925,12170,12115,180,125,21060,"127,621.37",64934
,20161011,12170,12115,12150,12355,12140,12350,12285,235,170,22228,"136,584.65",72392
,20161012,12350,12285,12340,12365,12225,12330,12315,45,30,25262,"155,561.27",72758
,20161013,12330,12315,12350,12445,12335,12430,12400,115,85,18850,"116,894.70",76714
,20161014,12430,12400,12430,12605,12385,12550,12535,150,135,20930,"131,191.67",83620
,20161017,12550,12535,12550,12555,12300,12380,12375,-155,-160,22984,"142,230.64",91006
,20161018,12380,12375,12320,12470,12290,12470,12385,95,10,14242,"88,199.46",93610
,20161019,12470,12385,12440,12500,12220,12225,12335,-160,-50,30748,"189,658.10",100770
,20161020,12225,12335,12225,12285,12200,12235,12250,-100,-85,16664,"102,082.82",102932
,20161021,12235,12250,12230,12330,12140,12280,12245,30,-5,20560,"125,906.52",102910
,20161024,12280,12245,12250,12530,12230,12520,12435,275,190,28570,"177,662.35",108146
,20161025,12520,12435,12520,12930,12495,12930,12710,495,275,67918,"431,714.59",112074
,20161026,12930,12710,12930,13215,12880,13090,13155,380,445,69920,"460,049.46",114808
,20161027,13090,13155,13110,13150,12885,12980,13015,-175,-140,45608,"296,843.92",120012
,20161028,12980,13015,13050,13335,12995,13265,13220,250,205,58764,"388,444.55",126578
,20161031,13265,13220,13315,13540,13245,13420,13400,200,180,76188,"510,606.59",143686
,20161101,13420,13400,13475,13580,13325,13460,13455,60,55,56222,"378,316.28",155162
,20161102,13460,13455,13480,13480,12955,13020,13180,-435,-275,94284,"621,355.99",156596
,20161103,13020,13180,13035,13280,13005,13220,13125,40,-55,72542,"476,155.93",154818
,20161104,13220,13125,13290,13345,13070,13110,13200,-15,75,64806,"427,765.35",155562
,20161107,13110,13200,13195,13380,13095,13160,13250,-40,50,90774,"601,506.60",166298
,20161108,13160,13250,13185,13330,13110,13180,13205,-70,-45,67536,"446,060.23",169262
,20161109,13180,13205,13180,13420,13135,13275,13305,70,100,102740,"683,650.62",174974
,20161110,13275,13305,13355,13835,13335,13785,13625,480,320,154092,"1,049,955.95",188872
,20161111,13785,13625,13860,13975,13690,13855,13830,230,205,153472,"1,061,275.27",188196
,20161114,13855,13830,13915,14600,13360,14010,13940,180,110,221294,"1,542,632.06",186658
,20161115,14010,13940,13930,14100,13495,13550,13850,-390,-90,146060,"1,011,631.10",189542
,20161116,13550,13850,13550,13680,13250,13380,13470,-470,-380,136572,"919,954.83",187910
,20161117,13380,13470,13345,13395,13100,13270,13250,-200,-220,92338,"611,800.94",178652
,20161118,13270,13250,13220,13455,13205,13430,13345,180,95,73410,"489,905.51",181114
,20161121,13430,13345,13435,13860,13300,13820,13585,475,240,110948,"753,874.30",186242
,20161122,13820,13585,13845,14115,13785,13935,13900,350,315,107838,"749,609.43",194690
,20161123,13935,13900,13925,14070,13810,13860,13945,-40,45,104710,"730,110.41",203394
,20161124,13860,13945,13885,14090,13620,13900,13920,-45,-25,234918,"1,635,225.95",219524
,20161125,13900,13920,13900,13945,13715,13825,13825,-95,-95,163316,"1,129,292.53",220422
,20161128,13825,13825,13795,14030,13725,13975,13900,150,75,187198,"1,301,447.21",227380
,20161129,13975,13900,13925,13980,13380,13420,13630,-480,-270,237194,"1,616,597.33",229220
,20161130,13420,13630,13400,13520,12970,13145,13255,-485,-375,225884,"1,497,288.94",235782
,20161201,13145,13255,13200,13480,13180,13355,13350,100,95,212596,"1,419,295.28",232956
,20161202,13355,13350,13290,13530,13195,13325,13340,-25,-10,244004,"1,627,745.81",242520
,20161205,13325,13340,13290,13415,13165,13185,13275,-155,-65,285818,"1,897,779.98",271380
,20161206,13185,13275,13210,13375,13100,13165,13225,-110,-50,295638,"1,955,186.71",283794
,20161207,13165,13225,13150,13175,12920,13120,13055,-105,-170,376068,"2,455,394.49",287240
,20161208,13120,13055,13160,13325,12960,13110,13110,55,55,364188,"2,388,026.35",289490
,20161209,13110,13110,13140,13395,13015,13320,13220,210,110,412274,"2,725,264.54",276480
,20161212,13320,13220,13335,13595,13250,13445,13450,225,230,356510,"2,397,642.23",260944
,20161213,13445,13450,13400,13450,13280,13300,13360,-150,-90,225086,"1,503,821.68",258702
,20161214,13300,13360,13345,13360,13010,13040,13125,-320,-235,320318,"2,102,689.18",271064
,20161215,13040,13125,13095,13100,12820,13005,12930,-120,-195,363828,"2,352,395.69",291456
,20161216,13005,12930,12915,13075,12880,12915,12980,-15,50,232046,"1,506,100.51",297952
,20161219,12915,12980,12865,12920,12620,12630,12740,-350,-240,277128,"1,765,831.48",304270
,20161220,12630,12740,12630,12715,12530,12665,12635,-75,-105,243730,"1,540,182.23",296030
,20161221,12665,12635,12705,12890,12670,12880,12775,245,140,232076,"1,482,884.58",272976
,20161222,12880,12775,12875,12925,12770,12800,12855,25,80,212028,"1,362,865.88",251370
,20161223,12800,12855,12800,12930,12635,12700,12770,-155,-85,237702,"1,518,080.85",255262
,20161226,12700,12770,12700,12820,12450,12640,12600,-130,-170,249754,"1,574,055.75",246292
,20161227,12640,12600,12630,12815,12565,12790,12710,190,110,181280,"1,152,316.83",238486
,20161228,12790,12710,12790,12950,12635,12650,12805,-60,95,223894,"1,433,897.79",234496
,20161229,12650,12805,12580,12740,12550,12720,12645,-85,-160,185226,"1,171,198.47",224934
,20161230,12720,12645,12630,12875,12605,12795,12755,150,110,214938,"1,371,302.36",200226
al1703,20160316,11575,11575,,,,11575,11575,0,0,0,0.00,0
,20160317,11575,11575,,,,11575,11575,0,0,0,0.00,0
,20160318,11575,11575,11725,11845,11615,11615,11710,40,135,20,117.12,4
,20160321,11615,11710,11465,11725,11465,11650,11605,-60,-105,18,104.46,10
,20160322,11650,11605,11645,11645,11645,11645,11645,40,40,2,11.65,8
,20160323,11645,11645,,,,11660,11660,15,15,0,0.00,8
,20160324,11660,11660,11740,11740,11620,11620,11670,-40,10,14,81.72,14
,20160325,11620,11670,11605,11690,11605,11690,11645,20,-25,6,34.94,14
,20160328,11690,11645,11715,11730,11700,11730,11705,85,60,34,199.01,44
,20160329,11730,11705,11755,11765,11660,11660,11730,-45,25,184,"1,079.36",112
,20160330,11660,11730,11670,11730,11670,11730,11685,0,-45,8,46.74,104
,20160331,11730,11685,11695,11700,11695,11700,11695,15,10,4,23.40,108
,20160401,11700,11695,11715,11785,11715,11785,11760,90,65,110,646.90,128
,20160405,11785,11760,11775,11775,11775,11775,11775,15,15,2,11.78,130
,20160406,11775,11775,11815,11840,11755,11755,11775,-20,0,16,94.24,132
,20160407,11755,11775,11855,11855,11760,11760,11795,-15,20,6,35.39,132
,20160408,11760,11795,11665,11695,11620,11630,11645,-165,-150,44,256.25,150
,20160411,11630,11645,11630,11630,11630,11630,11630,-15,-15,2,11.63,150
,20160412,11630,11630,11770,11810,11770,11775,11800,145,170,28,165.26,156
,20160413,11775,11800,11865,11960,11845,11900,11905,100,105,232,"1,381.41",300
,20160414,11900,11905,11955,12000,11940,11940,11945,35,40,32,191.19,306
,20160415,11940,11945,11980,11980,11950,11955,11955,10,10,30,179.33,326
,20160418,11955,11955,11920,11980,11920,11960,11935,5,-20,16,95.50,328
,20160419,11960,11935,11975,11995,11975,11995,11990,60,55,8,47.96,336
,20160420,11995,11990,12030,12045,12015,12020,12020,30,30,84,504.88,412
,20160421,12020,12020,12305,12310,12125,12240,12180,220,160,400,"2,436.55",702
,20160422,12240,12180,11965,12405,11965,12370,12290,190,110,504,"3,098.11",1056
,20160425,12370,12290,12575,12680,12255,12495,12465,205,175,282,"1,757.80",1202
,20160426,12495,12465,12435,12510,12350,12470,12465,5,0,108,673.33,1240
,20160427,12470,12465,12490,12545,12440,12440,12520,-25,55,56,350.64,1218
,20160428,12440,12520,12510,12520,12265,12335,12355,-185,-165,264,"1,630.92",1230
,20160429,12335,12355,12335,12535,12330,12535,12390,180,35,408,"2,528.37",1260
,20160503,12535,12390,12535,12575,12535,12575,12540,185,150,12,75.25,1270
,20160504,12575,12540,12440,12440,12310,12310,12335,-230,-205,26,160.36,1272
,20160505,12310,12335,12315,12400,12295,12340,12330,5,-5,54,332.96,1264
,20160506,12340,12330,12240,12240,12050,12135,12090,-195,-240,200,"1,209.19",1258
,20160509,12135,12090,12215,12225,11885,11940,12025,-150,-65,160,962.26,1250
,20160510,11940,12025,11935,11955,11740,11875,11835,-150,-190,168,994.54,1196
,20160511,11875,11835,11895,12075,11875,12075,11945,240,110,32,191.17,1194
,20160512,12075,11945,12070,12155,12045,12155,12080,210,135,258,"1,558.45",1122
,20160513,12155,12080,11980,11980,11920,11970,11960,-110,-120,178,"1,064.71",1086
,20160516,11970,11960,12010,12105,11975,12105,12045,145,85,24,144.55,1076
,20160517,12105,12045,12115,12220,12115,12180,12150,135,105,34,206.61,1062
,20160518,12180,12150,12185,12265,12080,12080,12135,-70,-15,50,303.46,1066
,20160519,12080,12135,12070,12160,12070,12105,12120,-30,-15,64,387.93,1082
,20160520,12105,12120,12135,12165,12135,12165,12160,45,40,12,72.96,1092
,20160523,12165,12160,12295,12295,12000,12010,12115,-150,-45,42,254.48,1092
,20160524,12010,12115,12005,12095,12005,12035,12045,-80,-70,8,48.20,1092
,20160525,12035,12045,12130,12130,11900,11900,12010,-145,-35,112,672.65,1112
,20160526,11900,12010,12015,12025,11820,12025,11935,15,-75,26,155.18,1112
,20160527,12025,11935,12040,12040,11830,11950,11925,15,-10,56,333.90,1122
,20160530,11950,11925,11940,11990,11940,11980,11975,55,50,160,958.26,1204
,20160531,11980,11975,12000,12025,11810,11810,11980,-165,5,92,551.21,1232
,20160601,11810,11980,11880,11920,11765,11770,11815,-210,-165,136,803.57,1220
,20160602,11770,11815,11800,12065,11800,12065,11885,250,70,10,59.43,1216
,20160603,12065,11885,11915,12005,11785,11785,11815,-100,-70,42,248.17,1230
,20160606,11785,11815,11810,11820,11675,11675,11740,-140,-75,88,516.58,1234
,20160607,11675,11740,11695,11745,11575,11635,11650,-105,-90,152,885.57,1286
,20160608,11635,11650,11695,11810,11600,11785,11710,135,60,208,"1,218.24",1134
,20160613,11785,11710,11740,11820,11695,11780,11745,70,35,30,176.22,1126
,20160614,11780,11745,11850,11900,11695,11750,11760,5,15,114,670.53,1126
,20160615,11750,11760,11715,11770,11715,11770,11740,10,-20,62,364.04,1098
,20160616,11770,11740,11755,11855,11755,11810,11800,70,60,78,460.34,1076
,20160617,11810,11800,11790,11875,11790,11830,11825,30,25,10,59.14,1076
,20160620,11830,11825,11835,11900,11810,11870,11840,45,15,70,414.50,1072
,20160621,11870,11840,11905,11925,11880,11900,11920,60,80,98,584.11,1054
,20160622,11900,11920,11890,11960,11855,11960,11930,40,10,758,"4,521.53",1378
,20160623,11960,11930,11940,11955,11910,11945,11930,15,0,238,"1,419.82",1404
,20160624,11945,11930,11965,11965,11765,11765,11855,-165,-75,284,"1,684.00",1216
,20160627,11765,11855,11910,12030,11905,11995,11915,140,60,172,"1,024.84",1308
,20160628,11995,11915,11980,12025,11965,12025,11975,110,60,32,191.68,1324
,20160629,12025,11975,12020,12020,11925,11995,11990,20,15,178,"1,067.32",1380
,20160630,11995,11990,12010,12055,12005,12035,12020,45,30,228,"1,370.71",1516
,20160701,12035,12020,12020,12155,12020,12110,12095,90,75,584,"3,532.79",1784
,20160704,12110,12095,12130,12245,12100,12140,12200,45,105,1458,"8,894.14",2948
,20160705,12140,12200,12155,12155,11990,12135,12070,-65,-130,582,"3,512.77",3312
,20160706,12135,12070,12175,12225,12000,12125,12135,55,65,118,716.22,3264
,20160707,12125,12135,12085,12190,12060,12065,12115,-70,-20,1122,"6,798.20",3926
,20160708,12065,12115,12030,12080,12030,12075,12070,-40,-45,24,144.86,3922
,20160711,12075,12070,12130,12170,12100,12135,12110,65,40,596,"3,609.99",4166
,20160712,12135,12110,12130,12130,11770,12075,12075,-35,-35,502,"3,031.55",4432
,20160713,12075,12075,12120,12240,12070,12185,12145,110,70,1014,"6,158.63",4758
,20160714,12185,12145,12130,12240,12130,12220,12170,75,25,632,"3,845.75",5072
,20160715,12220,12170,12255,12255,12150,12210,12220,40,50,246,"1,503.37",5220
,20160718,12210,12220,12230,12230,12120,12130,12135,-90,-85,194,"1,177.52",5280
,20160719,12130,12135,12090,12185,12025,12120,12110,-15,-25,1398,"8,466.55",6154
,20160720,12120,12110,12100,12240,12100,12170,12175,60,65,930,"5,663.11",6580
,20160721,12170,12175,12055,12200,12055,12175,12155,0,-20,536,"3,258.16",6912
,20160722,12175,12155,12185,12195,12025,12025,12100,-130,-55,1256,"7,601.72",7726
,20160725,12025,12100,12200,12200,11970,12075,12065,-25,-35,730,"4,404.59",7988
,20160726,12075,12065,12035,12145,12000,12010,12035,-55,-30,336,"2,021.94",8042
,20160727,12010,12035,11965,12040,11920,11930,11950,-105,-85,804,"4,803.95",7780
,20160728,11930,11950,11920,12105,11905,12075,12020,125,70,470,"2,824.81",7818
,20160729,12075,12020,12080,12080,11925,11985,12015,-35,-5,688,"4,133.39",7828
,20160801,11985,12015,12040,12135,12040,12135,12100,120,85,594,"3,594.59",7918
,20160802,12135,12100,12100,12135,12000,12100,12065,0,-35,344,"2,075.41",7990
,20160803,12100,12065,12120,12120,11930,11930,11990,-135,-75,558,"3,345.42",8212
,20160804,11930,11990,11975,11995,11965,11995,11985,5,-5,342,"2,049.73",8274
,20160805,11995,11985,11980,12090,11935,12085,12005,100,20,166,996.82,8296
,20160808,12085,12005,12080,12160,12080,12155,12130,150,125,2092,"12,689.41",8626
,20160809,12155,12130,12290,12290,11995,12075,12090,-55,-40,970,"5,863.97",8628
,20160810,12075,12090,11955,12165,11955,12155,12120,65,30,2014,"12,207.24",8816
,20160811,12155,12120,12155,12175,12065,12100,12110,-20,-10,316,"1,913.84",8818
,20160812,12100,12110,12050,12115,12030,12110,12080,0,-30,566,"3,419.36",9156
,20160815,12110,12080,12060,12095,11680,12050,12055,-30,-25,652,"3,930.06",9430
,20160816,12050,12055,12060,12190,12040,12165,12145,110,90,2080,"12,631.33",10192
,20160817,12165,12145,12185,12200,12135,12185,12160,40,15,2482,"15,096.26",11226
,20160818,12185,12160,12160,12340,12160,12320,12260,160,100,2830,"17,350.41",13028
,20160819,12320,12260,12345,12345,12235,12315,12300,55,40,1848,"11,366.82",14012
,20160822,12315,12300,12250,12280,12130,12160,12190,-140,-110,1636,"9,972.91",14232
,20160823,12160,12190,12115,12200,12105,12180,12175,-10,-15,436,"2,654.48",14218
,20160824,12180,12175,12195,12265,12145,12190,12195,15,20,904,"5,513.82",14556
,20160825,12190,12195,12150,12160,12080,12130,12120,-65,-75,1588,"9,624.46",15408
,20160826,12130,12120,12145,12205,12090,12150,12160,30,40,1010,"6,142.24",15970
,20160829,12150,12160,12155,12205,12110,12140,12165,-20,5,624,"3,796.54",16256
,20160830,12140,12165,12115,12140,12040,12065,12075,-100,-90,946,"5,713.50",16846
,20160831,12065,12075,12015,12070,11980,11980,12005,-95,-70,1860,"11,165.96",17974
,20160901,11980,12005,11990,12015,11925,11995,11970,-10,-35,2146,"12,845.10",19030
,20160902,11995,11970,11980,12090,11980,12015,12035,45,65,1096,"6,595.91",19242
,20160905,12015,12035,11995,12025,11780,11845,11915,-190,-120,5594,"33,328.31",20758
,20160906,11845,11915,11825,11890,11740,11870,11785,-45,-130,2028,"11,951.88",21750
,20160907,11870,11785,11825,11910,11805,11825,11840,40,55,1228,"7,270.99",22212
,20160908,11825,11840,11840,11840,11740,11780,11775,-60,-65,1312,"7,727.00",22808
,20160909,11780,11775,11800,11890,11760,11820,11805,45,30,2798,"16,518.61",22064
,20160912,11820,11805,11770,11800,11695,11750,11750,-55,-55,3036,"17,838.22",22270
,20160913,11750,11750,11770,11800,11735,11765,11770,15,20,1758,"10,349.67",22290
,20160914,11765,11770,11760,11770,11585,11615,11655,-155,-115,2620,"15,270.37",23430
,20160919,11615,11655,11665,11670,11575,11590,11605,-65,-50,3242,"18,816.18",24658
,20160920,11590,11605,11605,11800,11605,11780,11740,175,135,6574,"38,592.85",26578
,20160921,11780,11740,11785,11850,11750,11815,11820,75,80,4952,"29,271.81",27830
,20160922,11815,11820,11820,11930,11785,11865,11875,45,55,6700,"39,788.63",30428
,20160923,11865,11875,11925,12035,11890,12025,11970,150,95,12380,"74,113.78",33920
,20160926,12025,11970,12005,12010,11835,11915,11885,-55,-85,7356,"43,730.67",36520
,20160927,11915,11885,11920,11980,11840,11955,11925,70,40,8378,"49,972.06",38144
,20160928,11955,11925,11965,11985,11855,11985,11945,60,20,6094,"36,397.96",37806
,20160929,11985,11945,11990,12055,11945,12005,12005,60,60,10256,"61,582.64",40108
,20160930,12005,12005,11960,11990,11905,11920,11935,-85,-70,4232,"25,264.07",41164
,20161010,11920,11935,11950,12100,11950,12070,12050,135,115,8146,"49,094.71",42040
,20161011,12070,12050,12070,12260,12070,12260,12190,210,140,6634,"40,449.83",43690
,20161012,12260,12190,12235,12275,12135,12240,12215,50,25,11358,"69,392.44",46334
,20161013,12240,12215,12280,12360,12235,12335,12315,120,100,11180,"68,844.23",48364
,20161014,12335,12315,12330,12550,12305,12465,12460,150,145,9348,"58,247.70",48880
,20161017,12465,12460,12465,12480,12230,12300,12310,-160,-150,9122,"56,158.12",49628
,20161018,12300,12310,12240,12405,12230,12405,12325,95,15,3620,"22,313.16",49622
,20161019,12405,12325,12360,12435,12155,12170,12250,-155,-75,12154,"74,447.72",53586
,20161020,12170,12250,12180,12215,12135,12170,12180,-80,-70,7554,"46,015.97",54896
,20161021,12170,12180,12165,12260,12085,12220,12185,40,5,9790,"59,658.45",55840
,20161024,12220,12185,12210,12425,12190,12400,12340,215,155,8838,"54,545.69",54920
,20161025,12400,12340,12420,12830,12400,12830,12620,490,280,28046,"177,012.95",52182
,20161026,12830,12620,12845,13120,12800,12935,13030,315,410,28290,"184,358.26",50656
,20161027,12935,13030,12970,13000,12765,12840,12870,-190,-160,18194,"117,122.90",52654
,20161028,12840,12870,12915,13170,12840,13115,13045,245,175,17346,"113,162.78",55060
,20161031,13115,13045,13115,13350,13085,13245,13215,200,170,30494,"201,531.84",60486
,20161101,13245,13215,13340,13400,13155,13300,13275,85,60,22508,"149,423.48",65678
,20161102,13300,13275,13270,13325,12865,12930,13090,-345,-185,39524,"258,686.29",71192
,20161103,12930,13090,12935,13175,12885,13115,13030,25,-60,27612,"179,904.29",72798
,20161104,13115,13030,13165,13245,13010,13045,13110,15,80,26424,"173,250.35",75082
,20161107,13045,13110,13050,13275,13035,13100,13170,-10,60,33310,"219,356.28",75978
,20161108,13100,13170,13110,13250,13045,13110,13135,-60,-35,17142,"112,583.64",78528
,20161109,13110,13135,13105,13270,13065,13170,13205,35,70,40176,"265,266.88",81264
,20161110,13170,13205,13225,13730,13225,13680,13490,475,285,52872,"356,711.83",90348
,20161111,13680,13490,13730,13805,13040,13730,13685,240,195,45320,"310,200.20",90286
,20161114,13730,13685,13585,14385,13275,13820,13790,135,105,68280,"470,891.38",90818
,20161115,13820,13790,13760,13900,13350,13380,13675,-410,-115,35662,"243,872.03",91524
,20161116,13380,13675,13380,13535,13165,13280,13350,-395,-325,31916,"213,059.15",93710
,20161117,13280,13350,13270,13300,13035,13175,13160,-175,-190,27558,"181,359.06",94194
,20161118,13175,13160,13145,13355,13115,13340,13255,180,95,24236,"160,662.65",93652
,20161121,13340,13255,13345,13695,13215,13670,13485,415,230,29738,"200,518.29",94544
,20161122,13670,13485,13670,13875,13650,13795,13770,310,285,33750,"232,374.82",99248
,20161123,13795,13770,13785,13900,13675,13720,13785,-50,15,29826,"205,628.15",98330
,20161124,13720,13785,13725,13955,13535,13815,13785,30,0,67674,"466,495.48",106478
,20161125,13815,13785,13815,13850,13665,13770,13765,-15,-20,45484,"313,120.35",106520
,20161128,13770,13765,13730,14005,13675,13970,13880,205,115,65518,"454,800.28",106540
,20161129,13970,13880,13905,13960,13420,13425,13650,-455,-230,73230,"499,919.68",114606
,20161130,13425,13650,13420,13560,13030,13175,13295,-475,-355,57528,"382,444.73",119808
,20161201,13175,13295,13245,13480,13220,13355,13365,60,70,54638,"365,209.04",125714
,20161202,13355,13365,13315,13535,13210,13305,13355,-60,-10,58858,"393,148.62",126646
,20161205,13305,13355,13300,13400,13185,13205,13275,-150,-80,56876,"377,605.97",132556
,20161206,13205,13275,13205,13385,13140,13195,13245,-80,-30,54928,"363,877.63",136908
,20161207,13195,13245,13175,13230,12985,13200,13095,-45,-150,86368,"565,609.01",143136
,20161208,13200,13095,13215,13335,13005,13155,13165,60,70,81446,"536,265.62",142084
,20161209,13155,13165,13175,13420,13075,13340,13270,175,105,96192,"638,443.91",143332
,20161212,13340,13270,13350,13615,13280,13475,13480,205,210,97490,"657,257.83",138614
,20161213,13475,13480,13440,13495,13335,13355,13410,-125,-70,61502,"412,408.84",144372
,20161214,13355,13410,13410,13420,13080,13100,13190,-310,-220,92792,"612,094.28",156172
,20161215,13100,13190,13135,13150,12910,13075,13015,-115,-175,102664,"668,099.07",165454
,20161216,13075,13015,13005,13135,12955,12985,13055,-30,40,74082,"483,590.55",172240
,20161219,12985,13055,12945,12990,12705,12715,12820,-340,-235,88082,"564,611.87",178222
,20161220,12715,12820,12700,12790,12620,12745,12710,-75,-110,78686,"500,207.54",180594
,20161221,12745,12710,12760,12920,12735,12895,12835,185,125,76568,"491,408.04",175058
,20161222,12895,12835,12900,12945,12800,12805,12880,-30,45,70576,"454,544.48",177204
,20161223,12805,12880,12840,12950,12700,12770,12810,-110,-70,70066,"448,787.32",180902
,20161226,12770,12810,12770,12880,12520,12705,12650,-105,-160,105842,"669,710.07",186686
,20161227,12705,12650,12700,12860,12620,12840,12765,190,115,73082,"466,507.45",191036
,20161228,12840,12765,12835,13015,12705,12730,12860,-35,95,98106,"631,055.93",200232
,20161229,12730,12860,12680,12795,12625,12775,12710,-85,-150,97670,"620,848.51",213184
,20161230,12775,12710,12710,12915,12665,12840,12815,130,105,126648,"811,613.72",212692
al1704,20160418,11955,11955,,,,11955,11955,0,0,0,0.00,0
,20160419,11955,11955,12030,12030,12030,12030,12030,75,75,2,12.03,2
,20160420,12030,12030,12055,12065,12020,12065,12040,35,10,18,108.39,6
,20160421,12065,12040,12230,12350,12170,12170,12250,130,210,60,367.52,48
,20160422,12170,12250,11985,12325,11975,12275,12155,25,-95,42,255.33,58
,20160425,12275,12155,12540,12540,12295,12365,12450,210,295,14,87.17,52
,20160426,12365,12450,12470,12520,12370,12370,12465,-80,15,8,49.87,52
,20160427,12370,12465,12450,12585,12355,12585,12440,120,-25,24,149.28,66
,20160428,12585,12440,12405,12405,12280,12350,12330,-90,-110,50,308.35,78
,20160429,12350,12330,12375,12480,12350,12480,12415,150,85,14,86.94,86
,20160503,12480,12415,12565,12565,12520,12520,12540,105,125,6,37.63,84
,20160504,12520,12540,12330,12330,12330,12330,12330,-210,-210,2,12.33,86
,20160505,12330,12330,,,,12330,12330,0,0,0,0.00,86
,20160506,12330,12330,12255,12255,12080,12230,12165,-100,-165,32,194.70,106
,20160509,12230,12165,12165,12165,11940,11940,12050,-225,-115,14,84.37,114
,20160510,11940,12050,11800,11880,11740,11880,11805,-170,-245,18,106.27,118
,20160511,11880,11805,11950,12120,11945,12120,11975,315,170,68,407.28,154
,20160512,12120,11975,12110,12165,12065,12165,12125,190,150,24,145.52,152
,20160513,12165,12125,11835,11835,11835,11835,11835,-290,-290,4,23.67,148
,20160516,11835,11835,11880,12165,11880,12165,12025,330,190,120,721.71,116
,20160517,12165,12025,12230,12230,12230,12230,12230,205,205,10,61.15,116
,20160518,12230,12230,12210,12210,12210,12210,12210,-20,-20,8,48.84,124
,20160519,12210,12210,12070,12070,12070,12070,12070,-140,-140,4,24.14,120
,20160520,12070,12070,12075,12075,12075,12075,12075,5,5,2,12.08,122
,20160523,12075,12075,12210,12210,12020,12030,12100,-45,25,42,254.19,144
,20160524,12030,12100,12040,12040,12040,12040,12040,-60,-60,2,12.04,144
,20160525,12040,12040,12140,12155,11930,11945,12085,-95,45,62,374.75,162
,20160526,11945,12085,12015,12015,11920,12000,11975,-85,-110,6,35.94,164
,20160527,12000,11975,11880,11925,11830,11925,11865,-50,-110,22,130.56,168
,20160530,11925,11865,11940,12000,11940,12000,11975,135,110,48,287.42,170
,20160531,12000,11975,11990,12025,11895,11980,11945,5,-30,84,501.84,186
,20160601,11980,11945,11870,11870,11765,11765,11805,-180,-140,34,200.77,200
,20160602,11765,11805,11805,11945,11805,11925,11850,120,45,20,118.51,196
,20160603,11925,11850,11945,11960,11775,11780,11825,-70,-25,44,260.23,182
,20160606,11780,11825,11815,11815,11665,11700,11725,-125,-100,98,574.59,186
,20160607,11700,11725,11745,11755,11610,11645,11705,-80,-20,50,292.65,186
,20160608,11645,11705,11720,11810,11720,11810,11740,105,35,20,117.44,196
,20160613,11810,11740,11715,11820,11715,11820,11740,80,0,22,129.17,194
,20160614,11820,11740,11850,11900,11760,11760,11835,20,95,6,35.51,192
,20160615,11760,11835,11790,11790,11790,11790,11790,-45,-45,10,58.95,192
,20160616,11790,11790,11805,11835,11785,11785,11815,-5,25,22,130.01,192
,20160617,11785,11815,11770,11830,11770,11830,11820,15,5,38,224.65,222
,20160620,11830,11820,11880,11890,11820,11890,11875,70,55,16,95.01,220
,20160621,11890,11875,11920,11945,11905,11905,11920,30,45,12,71.54,220
,20160622,11905,11920,11900,11990,11880,11930,11925,10,5,38,226.66,224
,20160623,11930,11925,11950,11980,11930,11930,11950,5,25,440,"2,629.52",616
,20160624,11930,11950,11980,11980,11805,11805,11905,-145,-45,166,988.39,652
,20160627,11805,11905,11860,12015,11850,11975,11910,70,5,42,250.21,650
,20160628,11975,11910,11980,12135,11980,12025,12000,115,90,188,"1,128.10",784
,20160629,12025,12000,12070,12070,11995,11995,12010,-5,10,66,396.42,760
,20160630,11995,12010,12035,12065,12035,12065,12045,55,35,34,204.81,792
,20160701,12065,12045,12025,12165,11985,12115,12085,70,40,318,"1,921.73",1028
,20160704,12115,12085,12145,12200,12130,12190,12155,105,70,106,644.37,1066
,20160705,12190,12155,12195,12195,12025,12150,12090,-5,-65,66,399.03,1050
,20160706,12150,12090,12230,12235,12110,12150,12140,60,50,42,254.95,1048
,20160707,12150,12140,12110,12175,12085,12085,12130,-55,-10,106,642.90,1074
,20160708,12085,12130,12055,12170,12055,12170,12110,40,-20,4,24.23,1074
,20160711,12170,12110,12145,12235,12115,12150,12150,40,40,122,741.35,1146
,20160712,12150,12150,12145,12145,12105,12110,12125,-40,-25,56,339.56,1148
,20160713,12110,12125,12100,12245,12100,12215,12185,90,60,70,426.63,1158
,20160714,12215,12185,12165,12210,12165,12210,12180,25,-5,78,475.11,1180
,20160715,12210,12180,12210,12250,12210,12220,12235,40,55,68,416.04,1236
,20160718,12220,12235,,,,12235,12235,0,0,0,0.00,1236
,20160719,12235,12235,12105,12160,12040,12120,12100,-115,-135,62,375.25,1250
,20160720,12120,12100,12165,12270,12145,12200,12205,100,105,62,378.36,1254
,20160721,12200,12205,12130,12185,12130,12175,12150,-30,-55,16,97.24,1258
,20160722,12175,12150,12150,12205,12100,12100,12105,-50,-45,444,"2,687.39",1678
,20160725,12100,12105,11980,12045,11980,12045,12020,-60,-85,6,36.07,1678
,20160726,12045,12020,12135,12135,12040,12040,12100,20,80,6,36.31,1678
,20160727,12040,12100,11975,12015,11935,11940,11955,-160,-145,108,645.71,1638
,20160728,11940,11955,11940,12325,11940,12085,12110,130,155,46,278.56,1664
,20160729,12085,12110,12075,12100,12000,12035,12065,-75,-45,50,301.71,1700
,20160801,12035,12065,12095,12105,12085,12085,12090,20,25,8,48.37,1704
,20160802,12085,12090,12055,12105,12015,12100,12085,10,-5,34,205.51,1724
,20160803,12100,12085,12125,12125,11980,11980,12010,-105,-75,182,"1,092.93",1818
,20160804,11980,12010,11980,12010,11980,12010,12000,0,-10,80,480.14,1820
,20160805,12010,12000,11960,12045,11950,12045,11965,45,-35,42,251.33,1820
,20160808,12045,11965,12125,12165,12110,12165,12145,200,180,114,692.30,1804
,20160809,12165,12145,12105,12120,12090,12100,12100,-45,-45,44,266.25,1816
,20160810,12100,12100,12100,12180,12100,12170,12150,70,50,24,145.83,1812
,20160811,12170,12150,12155,12155,12095,12095,12100,-55,-50,58,350.93,1818
,20160812,12095,12100,12095,12125,12060,12095,12090,-5,-10,134,810.08,1820
,20160815,12095,12090,12085,12095,12030,12075,12065,-15,-25,88,530.90,1820
,20160816,12075,12065,12115,12200,12065,12200,12155,135,90,382,"2,322.24",1838
,20160817,12200,12155,12160,12185,12150,12185,12175,30,20,292,"1,778.03",1840
,20160818,12185,12175,12265,12330,12205,12330,12265,155,90,488,"2,992.97",1946
,20160819,12330,12265,12345,12500,12270,12300,12350,35,85,450,"2,779.57",2038
,20160822,12300,12350,12225,12235,12130,12140,12170,-210,-180,180,"1,095.55",2126
,20160823,12140,12170,12100,12205,12100,12180,12150,10,-20,236,"1,433.76",2182
,20160824,12180,12150,12205,12240,12170,12170,12215,20,65,24,146.62,2184
,20160825,12170,12215,12145,12150,12105,12135,12125,-80,-90,66,400.28,2192
,20160826,12135,12125,12120,12210,12120,12150,12170,25,45,88,535.62,2190
,20160829,12150,12170,12165,12210,12125,12130,12165,-40,-5,38,231.14,2196
,20160830,12130,12165,12100,12150,12040,12065,12080,-100,-85,262,"1,582.66",2346
,20160831,12065,12080,11995,12070,11980,11980,11995,-100,-85,188,"1,127.89",2470
,20160901,11980,11995,11975,12005,11940,11975,11960,-20,-35,194,"1,160.16",2590
,20160902,11975,11960,11950,12065,11950,12010,12010,50,50,74,444.53,2594
,20160905,12010,12010,11985,12015,11780,11855,11905,-155,-105,672,"4,000.33",2984
,20160906,11855,11905,11810,11860,11745,11855,11780,-50,-125,614,"3,617.35",3354
,20160907,11855,11780,11880,11895,11800,11830,11840,50,60,118,698.68,3388
,20160908,11830,11840,11840,11840,11750,11770,11780,-70,-60,326,"1,920.82",3646
,20160909,11770,11780,11820,11830,11780,11820,11805,40,25,974,"5,750.77",4318
,20160912,11820,11805,11770,11785,11705,11760,11750,-45,-55,522,"3,067.52",4708
,20160913,11760,11750,11770,11790,11735,11775,11770,25,20,312,"1,836.77",4762
,20160914,11775,11770,11710,11790,11595,11610,11635,-160,-135,2052,"11,937.71",6314
,20160919,11610,11635,11610,11640,11580,11585,11600,-50,-35,816,"4,734.13",6694
,20160920,11585,11600,11640,11795,11635,11780,11765,180,165,1284,"7,554.88",7422
,20160921,11780,11765,11770,11850,11765,11820,11825,55,60,1586,"9,378.56",8602
,20160922,11820,11825,11810,11935,11795,11875,11890,50,65,3572,"21,242.57",11294
,20160923,11875,11890,11915,12035,11905,12035,11975,145,85,3570,"21,381.33",12576
,20160926,12035,11975,11990,12010,11840,11910,11900,-65,-75,2378,"14,153.54",14536
,20160927,11910,11900,11895,11980,11860,11940,11940,40,40,2434,"14,531.18",14890
,20160928,11940,11940,11930,11975,11855,11975,11935,35,-5,2036,"12,150.02",15294
,20160929,11975,11935,11980,12040,11935,11935,11995,0,60,3566,"21,387.57",16840
,20160930,11935,11995,11955,11975,11880,11920,11925,-75,-70,1746,"10,413.44",17298
,20161010,11920,11925,11935,12055,11935,12020,11995,95,70,3566,"21,389.92",16938
,20161011,12020,11995,12050,12225,12050,12200,12145,205,150,2308,"14,018.38",17390
,20161012,12200,12145,12180,12245,12085,12210,12185,65,40,2876,"17,528.57",17882
,20161013,12210,12185,12255,12325,12200,12300,12260,115,75,2360,"14,471.03",18960
,20161014,12300,12260,12285,12480,12265,12430,12420,170,160,1802,"11,193.31",19348
,20161017,12430,12420,12445,12445,12200,12280,12275,-140,-145,1828,"11,220.68",19644
,20161018,12280,12275,12200,12380,12200,12375,12290,100,15,1824,"11,208.70",20192
,20161019,12375,12290,12340,12445,12135,12145,12230,-145,-60,4332,"26,496.21",22054
,20161020,12145,12230,12160,12195,12115,12140,12160,-90,-70,4408,"26,801.30",24738
,20161021,12140,12160,12100,12240,12080,12195,12165,35,5,2888,"17,572.42",25046
,20161024,12195,12165,12210,12380,12210,12375,12310,210,145,3446,"21,218.71",24498
,20161025,12375,12310,12390,12800,12360,12770,12550,460,240,8716,"54,693.23",26070
,20161026,12770,12550,12755,13050,12755,12870,12965,320,415,10142,"65,763.12",26686
,20161027,12870,12965,12950,12950,12705,12820,12810,-145,-155,8068,"51,682.32",29992
,20161028,12820,12810,12875,13090,12795,13040,12960,230,150,6798,"44,060.02",31264
,20161031,13040,12960,13045,13250,13000,13150,13120,190,160,10568,"69,335.91",33732
,20161101,13150,13120,13230,13300,13065,13225,13180,105,60,5644,"37,201.15",34644
,20161102,13225,13180,13200,13225,12820,12910,13035,-270,-145,14324,"93,374.15",35258
,20161103,12910,13035,12910,13120,12875,13085,12985,50,-50,12488,"81,096.82",36434
,20161104,13085,12985,13150,13195,12980,13020,13060,35,75,10378,"67,792.69",36786
,20161107,13020,13060,13045,13225,13010,13080,13135,20,75,11212,"73,643.69",37220
,20161108,13080,13135,13065,13200,13020,13085,13100,-50,-35,6404,"41,957.73",37820
,20161109,13085,13100,13065,13220,13045,13125,13155,25,55,14400,"94,716.83",38354
,20161110,13125,13155,13225,13680,13195,13630,13425,475,270,16960,"113,865.89",39682
,20161111,13630,13425,13800,13800,13500,13700,13645,275,220,16524,"112,737.78",41576
,20161114,13700,13645,13705,14330,13225,13735,13745,90,100,22874,"157,233.34",43496
,20161115,13735,13745,13655,13825,13275,13325,13635,-420,-110,23998,"163,629.07",43902
,20161116,13325,13635,13385,13470,13120,13245,13295,-390,-340,13194,"87,716.49",44740
,20161117,13245,13295,13200,13260,13020,13145,13130,-150,-165,9726,"63,856.60",46276
,20161118,13145,13130,13120,13310,13100,13300,13215,170,85,9322,"61,617.51",45514
,20161121,13300,13215,13330,13630,13200,13580,13430,365,215,13000,"87,321.40",45060
,20161122,13580,13430,13610,13875,13580,13730,13690,300,260,8972,"61,429.52",44648
,20161123,13730,13690,13725,13820,13620,13675,13730,-15,40,6132,"42,100.30",44270
,20161124,13675,13730,13680,13915,13490,13805,13765,75,35,14202,"97,762.74",47014
,20161125,13805,13765,13770,13850,13705,13775,13775,10,10,15840,"109,115.85",50550
,20161128,13775,13775,13775,14040,13680,13990,13910,215,135,19400,"134,951.80",50976
,20161129,13990,13910,13990,13990,13450,13475,13700,-435,-210,19368,"132,681.35",54138
,20161130,13475,13700,13475,13595,13090,13215,13295,-485,-405,14696,"97,700.18",55484
,20161201,13215,13295,13225,13510,13225,13415,13405,120,110,14010,"93,919.49",55828
,20161202,13415,13405,13395,13575,13250,13335,13415,-70,10,13782,"92,444.99",52950
,20161205,13335,13415,13335,13425,13235,13240,13310,-175,-105,10518,"70,013.43",53334
,20161206,13240,13310,13245,13440,13205,13250,13285,-60,-25,11250,"74,749.09",52672
,20161207,13250,13285,13230,13300,13060,13275,13165,-10,-120,25558,"168,274.77",52776
,20161208,13275,13165,13335,13400,13080,13220,13240,55,75,18934,"125,373.03",51312
,20161209,13220,13240,13230,13470,13150,13385,13350,145,110,18048,"120,481.97",49332
,20161212,13385,13350,13385,13650,13330,13515,13530,165,180,19486,"131,854.42",51448
,20161213,13515,13530,13445,13535,13390,13400,13450,-130,-80,15316,"103,027.00",53064
,20161214,13400,13450,13415,13465,13145,13180,13240,-270,-210,18612,"123,254.73",54302
,20161215,13180,13240,13195,13215,12995,13150,13065,-90,-175,18836,"123,093.15",55472
,20161216,13150,13065,13115,13210,13035,13050,13130,-15,65,11090,"72,824.75",55960
,20161219,13050,13130,13000,13060,12790,12790,12890,-340,-240,17096,"110,211.33",58748
,20161220,12790,12890,12790,12860,12700,12835,12780,-55,-110,21942,"140,215.41",62056
,20161221,12835,12780,12865,12960,12800,12935,12895,155,115,20856,"134,473.88",64360
,20161222,12935,12895,12905,12995,12850,12875,12915,-20,20,21882,"141,328.68",68530
,20161223,12875,12915,12895,12995,12750,12820,12870,-95,-45,21608,"139,083.39",71430
,20161226,12820,12870,12820,12940,12585,12755,12715,-115,-155,17218,"109,480.52",73200
,20161227,12755,12715,12755,12920,12680,12900,12830,185,115,13250,"85,027.40",75656
,20161228,12900,12830,12900,13070,12775,12790,12920,-40,90,19008,"122,803.76",77930
,20161229,12790,12920,12605,12865,12605,12840,12780,-80,-140,14464,"92,436.82",78734
,20161230,12840,12780,12800,12965,12730,12900,12875,120,95,25084,"161,502.44",78096
al1705,20160517,12025,12025,,,,12025,12025,0,0,0,0.00,0
,20160518,12025,12025,12195,12340,12080,12245,12200,220,175,18,109.84,14
,20160519,12245,12200,,,,12180,12180,-20,-20,0,0.00,14
,20160520,12180,12180,,,,12180,12180,0,0,0,0.00,14
,20160523,12180,12180,12120,12170,12010,12010,12095,-170,-85,164,992.03,126
,20160524,12010,12095,12025,12075,12025,12070,12045,-25,-50,18,108.45,126
,20160525,12070,12045,12140,12145,11940,11940,12075,-105,30,72,434.77,144
,20160526,11940,12075,11960,11960,11905,11905,11930,-170,-145,4,23.87,146
,20160527,11905,11930,11850,11960,11820,11915,11885,-15,-45,208,"1,236.17",340
,20160530,11915,11885,11990,12010,11950,12010,11980,125,95,70,419.43,378
,20160531,12010,11980,12085,12090,11905,11930,11975,-50,-5,108,646.88,422
,20160601,11930,11975,11860,11860,11775,11775,11795,-200,-180,172,"1,014.66",550
,20160602,11775,11795,11845,11955,11845,11935,11920,140,125,10,59.61,550
,20160603,11935,11920,11925,11935,11770,11810,11860,-110,-60,102,605.11,564
,20160606,11810,11860,11800,11880,11615,11705,11765,-155,-95,178,"1,047.10",640
,20160607,11705,11765,11740,11790,11555,11660,11695,-105,-70,154,900.88,684
,20160608,11660,11695,11710,11830,11640,11810,11715,115,20,192,"1,125.08",626
,20160613,11810,11715,11725,11855,11725,11855,11740,140,25,72,422.71,638
,20160614,11855,11740,11840,11890,11780,11780,11850,40,110,28,165.95,626
,20160615,11780,11850,11755,11805,11685,11805,11770,-45,-80,14,82.42,626
,20160616,11805,11770,11825,11845,11825,11835,11835,65,65,6,35.51,624
,20160617,11835,11835,11785,11850,11785,11845,11825,10,-10,6,35.48,624
,20160620,11845,11825,11890,11940,11885,11940,11900,115,75,12,71.43,624
,20160621,11940,11900,11945,11970,11930,11930,11940,30,40,14,83.59,622
,20160622,11930,11940,11905,11975,11905,11960,11955,20,15,54,322.80,656
,20160623,11960,11955,11985,11990,11960,11960,11975,5,20,10,59.90,658
,20160624,11960,11975,11980,11980,11870,11870,11935,-105,-40,26,155.16,670
,20160627,11870,11935,11930,12040,11885,12010,11960,75,25,40,239.24,678
,20160628,12010,11960,12015,12060,11970,12045,12025,85,65,20,120.27,678
,20160629,12045,12025,12080,12080,12000,12035,12010,10,-15,88,528.58,694
,20160630,12035,12010,12040,12090,12035,12080,12065,70,55,126,760.27,752
,20160701,12080,12065,12055,12160,12055,12130,12110,65,45,72,436.07,788
,20160704,12130,12110,12195,12260,12140,12195,12185,85,75,314,"1,913.05",1010
,20160705,12195,12185,12125,12170,12020,12165,12110,-20,-75,110,666.11,1022
,20160706,12165,12110,12230,12265,12065,12150,12190,40,80,150,914.51,1026
,20160707,12150,12190,12140,12240,12100,12100,12150,-90,-40,58,352.45,1054
,20160708,12100,12150,12105,12200,12065,12200,12115,50,-35,34,205.99,1052
,20160711,12200,12115,12145,12195,12130,12180,12145,65,30,174,"1,056.82",1144
,20160712,12180,12145,12150,12225,12095,12110,12140,-35,-5,92,558.64,1132
,20160713,12110,12140,12185,12290,12170,12210,12205,70,65,160,976.66,1130
,20160714,12210,12205,12180,12235,12170,12220,12200,15,-5,48,292.91,1138
,20160715,12220,12200,12220,12285,12195,12225,12225,25,25,88,538.09,1172
,20160718,12225,12225,12210,12210,12120,12190,12180,-35,-45,14,85.27,1172
,20160719,12190,12180,12115,12180,12030,12135,12115,-45,-65,92,557.45,1190
,20160720,12135,12115,12165,12255,12165,12210,12215,95,100,114,696.40,1202
,20160721,12210,12215,12075,12210,12065,12210,12140,-5,-75,16,97.14,1202
,20160722,12210,12140,12225,12225,12060,12060,12125,-80,-15,302,"1,831.28",1290
,20160725,12060,12125,12000,12145,12000,12145,12065,20,-60,12,72.40,1286
,20160726,12145,12065,12105,12105,12040,12050,12065,-15,0,22,132.72,1286
,20160727,12050,12065,12000,12030,11920,11950,11980,-115,-85,164,982.37,1252
,20160728,11950,11980,12025,12155,12025,12115,12105,135,125,50,302.74,1260
,20160729,12115,12105,12165,12165,12000,12035,12035,-70,-70,100,601.88,1276
,20160801,12035,12035,12050,12150,12050,12150,12100,115,65,34,205.78,1274
,20160802,12150,12100,12085,12115,12050,12115,12095,15,-5,40,241.99,1278
,20160803,12115,12095,12150,12150,12000,12000,12025,-95,-70,148,890.05,1314
,20160804,12000,12025,11980,12025,11980,12025,12015,0,-10,74,444.62,1324
,20160805,12025,12015,11895,12120,11895,12120,12030,105,15,82,493.39,1368
,20160808,12120,12030,12120,12185,12120,12185,12165,155,135,790,"4,806.93",2066
,20160809,12185,12165,12225,12225,12095,12115,12125,-50,-40,352,"2,134.52",2286
,20160810,12115,12125,12095,12180,12095,12180,12155,55,30,368,"2,237.19",2582
,20160811,12180,12155,12160,12160,12100,12135,12115,-20,-40,308,"1,866.39",2836
,20160812,12135,12115,12090,12135,12040,12095,12095,-20,-20,82,495.90,2864
,20160815,12095,12095,12065,12080,12065,12080,12070,-15,-25,20,120.72,2860
,20160816,12080,12070,12075,12195,12075,12195,12140,125,70,184,"1,116.91",2926
,20160817,12195,12140,11990,12245,11990,12200,12185,60,45,102,621.56,2966
,20160818,12200,12185,12270,12310,12200,12310,12260,125,75,560,"3,433.46",3366
,20160819,12310,12260,12310,12325,12250,12300,12285,40,25,170,"1,044.52",3472
,20160822,12300,12285,12225,12230,12135,12140,12170,-145,-115,294,"1,789.25",3502
,20160823,12140,12170,12150,12205,12130,12190,12185,20,15,198,"1,206.53",3498
,20160824,12190,12185,12230,12260,12175,12190,12215,5,30,118,720.72,3562
,20160825,12190,12215,12160,12170,11900,12155,12100,-60,-115,102,617.33,3574
,20160826,12155,12100,12130,12225,12110,12165,12180,65,80,162,986.60,3586
,20160829,12165,12180,12170,12210,12130,12135,12160,-45,-20,50,304.03,3594
,20160830,12135,12160,12110,12150,12045,12045,12100,-115,-60,70,423.56,3586
,20160831,12045,12100,12000,12080,11990,11995,12000,-105,-100,134,804.15,3586
,20160901,11995,12000,11960,12020,11945,11980,11965,-20,-35,168,"1,005.23",3582
,20160902,11980,11965,11960,12080,11940,12010,12025,45,60,108,649.53,3578
,20160905,12010,12025,11995,12020,11800,11800,11910,-225,-115,500,"2,977.57",3736
,20160906,11800,11910,11815,11935,11765,11890,11820,-20,-90,426,"2,517.94",3942
,20160907,11890,11820,11905,11910,11835,11845,11855,25,35,160,948.71,4016
,20160908,11845,11855,11855,11855,11770,11775,11790,-80,-65,164,966.96,4060
,20160909,11775,11790,11790,11845,11790,11830,11830,40,40,1548,"9,158.16",5316
,20160912,11830,11830,11800,11815,11710,11750,11750,-80,-80,532,"3,126.69",5652
,20160913,11750,11750,11785,11810,11745,11795,11790,45,40,978,"5,766.07",6286
,20160914,11795,11790,11780,11780,11600,11630,11670,-160,-120,800,"4,669.42",6796
,20160919,11630,11670,11600,11675,11585,11585,11605,-85,-65,302,"1,752.79",6852
,20160920,11585,11605,11645,11805,11630,11785,11775,180,170,1280,"7,538.29",7540
,20160921,11785,11775,11770,11865,11765,11825,11840,50,65,1800,"10,660.47",8796
,20160922,11825,11840,11820,11950,11810,11945,11900,105,60,1900,"11,306.69",9970
,20160923,11945,11900,11960,12040,11930,12040,12005,140,105,3444,"20,673.34",12456
,20160926,12040,12005,12020,12020,11850,11910,11915,-95,-90,2640,"15,728.08",14424
,20160927,11910,11915,11905,11985,11855,11955,11940,40,25,1690,"10,090.65",15320
,20160928,11955,11940,11955,11990,11860,11990,11955,50,15,1938,"11,584.94",16300
,20160929,11990,11955,12000,12045,11950,11950,12010,-5,55,3586,"21,538.29",18602
,20160930,11950,12010,11960,11970,11900,11925,11915,-85,-95,1330,"7,925.06",19140
,20161010,11925,11915,11950,12045,11930,12005,12000,90,85,4560,"27,369.90",20366
,20161011,12005,12000,12025,12185,12025,12185,12125,185,125,5080,"30,801.27",22508
,20161012,12185,12125,12170,12225,12075,12180,12150,55,25,2270,"13,793.07",23422
,20161013,12180,12150,12240,12285,12160,12270,12245,120,95,3920,"24,004.02",25510
,20161014,12270,12245,12250,12455,12235,12410,12400,165,155,6420,"39,817.34",29560
,20161017,12410,12400,12405,12435,12185,12245,12250,-155,-150,6642,"40,690.62",33096
,20161018,12245,12250,12205,12365,12185,12365,12265,115,15,6680,"40,979.48",36312
,20161019,12365,12265,12330,12395,12125,12140,12240,-125,-25,8334,"51,019.25",41550
,20161020,12140,12240,12140,12190,12110,12135,12150,-105,-90,3612,"21,943.70",43770
,20161021,12135,12150,12090,12230,12075,12175,12150,25,0,5470,"33,233.57",46200
,20161024,12175,12150,12180,12370,12180,12370,12300,220,150,6416,"39,467.41",47152
,20161025,12370,12300,12390,12790,12335,12745,12545,445,245,7174,"45,011.15",48140
,20161026,12745,12545,12775,13045,12705,12880,12960,335,415,9238,"59,871.66",50538
,20161027,12880,12960,12885,12950,12690,12790,12790,-170,-170,7514,"48,053.24",52440
,20161028,12790,12790,12825,13050,12770,13020,12945,230,155,7572,"49,016.92",52340
,20161031,13020,12945,13020,13195,12965,13110,13100,165,155,8308,"54,418.77",52658
,20161101,13110,13100,13300,13300,13025,13190,13155,90,55,4778,"31,432.96",53634
,20161102,13190,13155,13155,13185,12785,12880,13035,-275,-120,11750,"76,580.64",54624
,20161103,12880,13035,12885,13095,12855,13060,12955,25,-80,9794,"63,450.68",54438
,20161104,13060,12955,13070,13165,12965,13005,13050,50,95,8268,"53,957.85",56318
,20161107,13005,13050,13020,13195,13000,13065,13115,15,65,9634,"63,175.51",57588
,20161108,13065,13115,13050,13180,13000,13075,13080,-40,-35,5276,"34,517.25",59384
,20161109,13075,13080,13080,13200,13035,13100,13140,20,60,11812,"77,608.54",60608
,20161110,13100,13140,13155,13665,12700,13635,13410,495,270,15650,"104,939.63",61962
,20161111,13635,13410,13655,13745,13510,13695,13630,285,220,14656,"99,890.43",63020
,20161114,13695,13630,13670,14300,13280,13735,13705,105,75,19862,"136,140.69",61114
,20161115,13735,13705,13700,13800,13250,13305,13580,-400,-125,13480,"91,540.02",63156
,20161116,13305,13580,13360,13435,13120,13220,13270,-360,-310,11312,"75,058.81",65972
,20161117,13220,13270,13225,13245,13020,13135,13125,-135,-145,10004,"65,657.27",67738
,20161118,13135,13125,13105,13300,13095,13300,13215,175,90,8144,"53,820.97",66482
,20161121,13300,13215,13295,13625,13195,13585,13425,370,210,11524,"77,378.72",65732
,20161122,13585,13425,13595,13780,13560,13730,13675,305,250,11580,"79,195.78",65182
,20161123,13730,13675,13700,13800,13605,13665,13715,-10,40,11582,"79,446.16",66318
,20161124,13665,13715,13670,13930,13490,13790,13755,75,40,23730,"163,221.87",69838
,20161125,13790,13755,13785,13860,13740,13805,13795,50,40,20336,"140,317.39",68824
,20161128,13805,13795,13850,14085,13700,14030,13955,235,160,25850,"180,427.75",67872
,20161129,14030,13955,14050,14050,13505,13505,13750,-450,-205,23156,"159,232.79",66242
,20161130,13505,13750,13495,13630,13080,13255,13360,-495,-390,15954,"106,593.42",65734
,20161201,13255,13360,13375,13730,13255,13435,13445,75,85,14926,"100,342.40",65886
,20161202,13435,13445,13380,13610,13290,13385,13445,-60,0,13130,"88,288.44",65568
,20161205,13385,13445,13355,13470,13290,13295,13350,-150,-95,14450,"96,455.93",68566
,20161206,13295,13350,13295,13495,13270,13325,13370,-25,20,20952,"140,090.80",70316
,20161207,13325,13370,13345,13385,13125,13360,13260,-10,-110,39488,"261,832.30",72820
,20161208,13360,13260,13385,13460,13150,13275,13330,15,70,35450,"236,338.59",67232
,20161209,13275,13330,13290,13535,13205,13440,13390,110,60,23934,"160,274.38",59340
,20161212,13440,13390,13465,13690,13385,13570,13560,180,170,18438,"125,033.12",58566
,20161213,13570,13560,13545,13590,13400,13465,13510,-95,-50,10706,"72,321.21",58842
,20161214,13465,13510,13520,13520,13215,13240,13310,-270,-200,15286,"101,752.47",62128
,20161215,13240,13310,13245,13285,13050,13220,13150,-90,-160,19992,"131,469.78",63702
,20161216,13220,13150,13145,13265,13110,13115,13190,-35,40,13126,"86,598.61",65154
,20161219,13115,13190,13060,13125,12865,12865,12960,-325,-230,14750,"95,602.23",67654
,20161220,12865,12960,12805,12950,12725,12895,12860,-65,-100,15032,"96,670.35",66908
,20161221,12895,12860,12900,13030,12875,12980,12960,120,100,14086,"91,279.54",67198
,20161222,12980,12960,12980,13050,12900,12930,12970,-30,10,11272,"73,121.84",66950
,20161223,12930,12970,12930,13045,12530,12870,12925,-100,-45,13316,"86,067.26",67828
,20161226,12870,12925,12870,13010,12645,12830,12785,-95,-140,9824,"62,808.64",68194
,20161227,12830,12785,12830,12985,12755,12960,12895,175,110,7642,"49,273.01",68342
,20161228,12960,12895,12965,13130,12845,12865,12985,-30,90,15698,"101,934.63",70934
,20161229,12865,12985,12805,12935,12765,12905,12845,-80,-140,12400,"79,644.91",71512
,20161230,12905,12845,12855,13030,12800,12960,12940,115,95,22406,"144,969.27",72198
al1706,20160616,11770,11770,11810,11810,11810,11810,11810,40,40,2,11.81,2
,20160617,11810,11810,11960,11960,11835,11835,11855,25,45,18,106.72,16
,20160620,11835,11855,,,,11855,11855,0,0,0,0.00,16
,20160621,11855,11855,11935,11935,11935,11935,11935,80,80,8,47.74,24
,20160622,11935,11935,11940,11940,11920,11920,11925,-15,-10,6,35.78,28
,20160623,11920,11925,12030,12030,11870,11990,11940,65,15,50,298.62,34
,20160624,11990,11940,11945,11945,11880,11880,11910,-60,-30,4,23.83,38
,20160627,11880,11910,11995,12020,11930,12020,11980,110,70,6,35.95,40
,20160628,12020,11980,,,,11980,11980,0,0,0,0.00,40
,20160629,11980,11980,,,,11980,11980,0,0,0,0.00,40
,20160630,11980,11980,,,,12010,12010,30,30,0,0.00,40
,20160701,12010,12010,12010,12160,12010,12110,12105,100,95,196,"1,186.63",106
,20160704,12110,12105,12480,12480,12155,12265,12250,160,145,78,477.80,124
,20160705,12265,12250,12160,12180,12030,12145,12115,-105,-135,174,"1,054.37",164
,20160706,12145,12115,12200,12210,12195,12210,12205,95,90,48,292.93,190
,20160707,12210,12205,12120,12190,12115,12155,12160,-50,-45,76,462.17,234
,20160708,12155,12160,12110,12155,12110,12145,12120,-15,-40,34,206.11,250
,20160711,12145,12120,12170,12170,12115,12170,12140,50,20,36,218.55,276
,20160712,12170,12140,12135,12155,12040,12145,12115,5,-25,48,290.84,324
,20160713,12145,12115,12195,12300,12160,12265,12200,150,85,68,414.84,362
,20160714,12265,12200,12200,12235,12200,12235,12215,35,15,6,36.65,360
,20160715,12235,12215,12240,12240,12230,12230,12235,15,20,4,24.47,360
,20160718,12230,12235,12275,12275,12160,12185,12235,-50,0,16,97.90,374
,20160719,12185,12235,12155,12225,12050,12085,12125,-150,-110,14,84.89,386
,20160720,12085,12125,12170,12220,12170,12215,12200,90,75,28,170.84,378
,20160721,12215,12200,12195,12195,12195,12195,12195,-5,-5,2,12.20,376
,20160722,12195,12195,12205,12215,12065,12065,12200,-130,5,26,158.63,394
,20160725,12065,12200,12030,12145,12000,12110,12075,-90,-125,22,132.87,400
,20160726,12110,12075,12050,12050,12050,12050,12050,-25,-25,4,24.10,404
,20160727,12050,12050,12025,12030,11930,11995,11995,-55,-55,24,143.95,402
,20160728,11995,11995,12035,12145,12035,12095,12070,100,75,32,193.20,410
,20160729,12095,12070,12110,12110,12025,12025,12075,-45,5,26,156.99,418
,20160801,12025,12075,12100,12190,12100,12135,12140,60,65,18,109.26,422
,20160802,12135,12140,12050,12140,12050,12140,12090,0,-50,8,48.37,430
,20160803,12140,12090,12125,12125,12015,12015,12100,-75,10,14,84.71,422
,20160804,12015,12100,12000,12000,12000,12000,12000,-100,-100,10,60.00,432
,20160805,12000,12000,12040,12090,12040,12060,12050,60,50,18,108.48,444
,20160808,12060,12050,12110,12180,12105,12175,12160,125,110,88,535.11,512
,20160809,12175,12160,12190,12190,12005,12115,12120,-45,-40,444,"2,690.71",628
,20160810,12115,12120,12150,12195,12145,12190,12160,70,40,808,"4,913.36",1370
,20160811,12190,12160,12240,12240,12110,12125,12140,-35,-20,122,740.83,1378
,20160812,12125,12140,12105,12135,12080,12100,12100,-40,-40,88,532.50,1408
,20160815,12100,12100,12115,12115,12095,12095,12105,-5,5,4,24.21,1404
,20160816,12095,12105,12130,12210,12090,12210,12150,105,45,74,449.64,1406
,20160817,12210,12150,12030,12220,12030,12180,12140,30,-10,18,109.27,1404
,20160818,12180,12140,12280,12325,12235,12325,12275,185,135,68,417.48,1414
,20160819,12325,12275,12350,12350,12275,12295,12310,20,35,22,135.43,1410
,20160822,12295,12310,12230,12230,12155,12160,12190,-150,-120,40,243.81,1398
,20160823,12160,12190,12145,12170,12145,12170,12160,-20,-30,8,48.66,1398
,20160824,12170,12160,12260,12260,12200,12200,12210,40,50,24,146.58,1400
,20160825,12200,12210,12185,12185,12150,12165,12175,-45,-35,90,547.97,1480
,20160826,12165,12175,12150,12210,12025,12170,12105,-5,-70,88,532.73,1442
,20160829,12170,12105,12185,12200,12120,12120,12140,15,35,14,84.99,1442
,20160830,12120,12140,12165,12165,12075,12080,12095,-60,-45,76,459.72,1440
,20160831,12080,12095,12030,12055,12000,12000,12025,-95,-70,22,132.28,1446
,20160901,12000,12025,12020,12020,11960,11960,11980,-65,-45,38,227.67,1454
,20160902,11960,11980,11970,12145,11970,12030,12045,50,65,70,421.74,1440
,20160905,12030,12045,12010,12015,11815,11815,11965,-230,-80,68,406.89,1462
,20160906,11815,11965,11820,11985,11800,11925,11850,-40,-115,72,426.69,1504
,20160907,11925,11850,11905,11940,11850,11855,11870,5,20,100,593.59,1540
,20160908,11855,11870,11790,11830,11790,11795,11800,-75,-70,18,106.22,1544
,20160909,11795,11800,11830,11850,11795,11845,11830,45,30,238,"1,408.01",1654
,20160912,11845,11830,11785,11845,11735,11765,11755,-65,-75,106,623.06,1740
,20160913,11765,11755,11785,11810,11765,11805,11790,50,35,66,389.18,1760
,20160914,11805,11790,11735,11745,11610,11640,11685,-150,-105,170,993.57,1864
,20160919,11640,11685,11670,11670,11610,11615,11620,-70,-65,122,708.98,1910
,20160920,11615,11620,11710,11825,11710,11795,11790,175,170,30,176.87,1908
,20160921,11795,11790,11850,11870,11830,11840,11855,50,65,440,"2,608.17",2084
,20160922,11840,11855,11855,11935,11835,11900,11910,45,55,170,"1,012.56",2104
,20160923,11900,11910,11965,12040,11925,11990,12025,80,115,106,637.39,2108
,20160926,11990,12025,12030,12030,11865,11920,11880,-105,-145,240,"1,426.07",2232
,20160927,11920,11880,11900,11985,11895,11945,11955,65,75,1106,"6,611.49",3114
,20160928,11945,11955,11890,11990,11890,11985,11960,30,5,188,"1,124.36",3182
,20160929,11985,11960,12000,12035,11960,11960,12015,0,55,2050,"12,318.28",4862
,20160930,11960,12015,11950,11960,11900,11950,11930,-65,-85,200,"1,193.48",4974
,20161010,11950,11930,12000,12020,11935,11985,11970,55,40,532,"3,184.90",5200
,20161011,11985,11970,11995,12245,11995,12130,12105,160,135,2112,"12,787.09",6712
,20161012,12130,12105,12125,12180,12065,12145,12125,40,20,168,"1,018.60",6700
,20161013,12145,12125,12180,12260,12180,12250,12220,125,95,532,"3,251.13",6924
,20161014,12250,12220,12345,12435,12330,12415,12410,195,190,946,"5,870.60",7620
,20161017,12415,12410,12385,12425,12185,12195,12260,-215,-150,1022,"6,266.32",8130
,20161018,12195,12260,12205,12360,12160,12360,12240,100,-20,218,"1,334.40",8050
,20161019,12360,12240,12330,12375,12125,12125,12255,-115,15,382,"2,341.23",8152
,20161020,12125,12255,12120,12165,12090,12155,12145,-100,-110,346,"2,101.29",8422
,20161021,12155,12145,12085,12220,12085,12170,12145,25,0,490,"2,975.98",8688
,20161024,12170,12145,12255,12360,12220,12355,12305,210,160,564,"3,471.40",8950
,20161025,12355,12305,12395,12780,12350,12735,12680,430,375,904,"5,731.62",9418
,20161026,12735,12680,12990,13185,12800,12840,13025,160,345,6512,"42,415.23",11148
,20161027,12840,13025,12840,12905,12675,12785,12820,-240,-205,4432,"28,417.14",13704
,20161028,12785,12820,12790,13040,12765,13005,12965,185,145,5862,"38,012.73",15944
,20161031,13005,12965,13010,13170,12960,13105,13065,140,100,4506,"29,444.08",18252
,20161101,13105,13065,13220,13230,13030,13175,13130,110,65,1498,"9,837.23",18808
,20161102,13175,13130,13135,13165,12805,12850,13040,-280,-90,4818,"31,414.18",20398
,20161103,12850,13040,12880,13085,12860,13050,12935,10,-105,2334,"15,098.05",21334
,20161104,13050,12935,13095,13140,12955,12985,13065,50,130,2064,"13,483.31",22122
,20161107,12985,13065,13000,13195,13000,13080,13110,15,45,2968,"19,456.48",23464
,20161108,13080,13110,13075,13160,13000,13065,13070,-45,-40,1476,"9,649.05",23980
,20161109,13065,13070,13065,13190,13055,13090,13115,20,45,2114,"13,863.39",24800
,20161110,13090,13115,13135,13635,13100,13635,13445,520,330,2226,"14,966.51",25080
,20161111,13635,13445,13630,13725,13450,13660,13625,215,180,1316,"8,965.56",25190
,20161114,13660,13625,13760,14290,13210,13795,13640,170,15,4248,"28,977.43",24614
,20161115,13795,13640,13690,13805,13285,13285,13645,-355,5,1332,"9,089.73",24810
,20161116,13285,13645,13350,13410,13130,13225,13265,-420,-380,1096,"7,269.88",24940
,20161117,13225,13265,13205,13225,13015,13150,13125,-115,-140,1628,"10,687.12",25518
,20161118,13150,13125,13100,13300,13100,13280,13210,155,85,548,"3,619.63",25446
,20161121,13280,13210,13310,13610,13200,13570,13430,360,220,2268,"15,230.87",25340
,20161122,13570,13430,13605,13780,13570,13695,13685,265,255,1178,"8,060.55",25442
,20161123,13695,13685,13730,13795,13630,13655,13715,-30,30,892,"6,117.47",25570
,20161124,13655,13715,13685,13940,13500,13815,13745,100,30,3250,"22,340.39",26500
,20161125,13815,13745,13775,13910,13770,13850,13835,105,90,6974,"48,243.17",25452
,20161128,13850,13835,13845,14130,13750,14085,13995,250,160,3128,"21,889.47",25136
,20161129,14085,13995,14050,14090,13540,13570,13810,-425,-185,5038,"34,792.55",25360
,20161130,13570,13810,13535,13685,13175,13300,13370,-510,-440,1478,"9,883.67",25282
,20161201,13300,13370,13400,13680,13390,13470,13510,100,140,1382,"9,336.61",25292
,20161202,13470,13510,13460,13665,13355,13435,13470,-75,-40,1778,"11,975.93",24700
,20161205,13435,13470,13390,13505,13320,13345,13380,-125,-90,2376,"15,898.63",24650
,20161206,13345,13380,13410,13535,13340,13370,13410,-10,30,1230,"8,248.33",24432
,20161207,13370,13410,13345,13450,13195,13415,13330,5,-80,5170,"34,466.37",22526
,20161208,13415,13330,13475,13530,13215,13345,13400,15,70,906,"6,070.58",22204
,20161209,13345,13400,13435,13580,13295,13520,13485,120,85,992,"6,690.71",21910
,20161212,13520,13485,13550,13715,13460,13630,13645,145,160,2340,"15,967.62",22342
,20161213,13630,13645,13595,13690,13500,13510,13545,-135,-100,1826,"12,368.42",22064
,20161214,13510,13545,13590,13590,13290,13315,13345,-230,-200,988,"6,593.04",21994
,20161215,13315,13345,13265,13350,13115,13285,13195,-60,-150,2134,"14,083.46",22808
,20161216,13285,13195,13225,13340,13190,13205,13265,10,70,2060,"13,664.18",22902
,20161219,13205,13265,13180,13205,12955,12960,13025,-305,-240,1646,"10,721.69",23484
,20161220,12960,13025,13010,13010,12865,12970,12945,-55,-80,2996,"19,395.77",23182
,20161221,12970,12945,13005,13070,12960,13030,13030,85,85,4600,"29,974.82",23652
,20161222,13030,13030,13050,13095,12965,12985,13035,-45,5,1946,"12,683.54",23830
,20161223,12985,13035,13010,13100,12885,12945,13010,-90,-25,2268,"14,755.69",24712
,20161226,12945,13010,12945,13330,12675,12900,12835,-110,-175,1404,"9,013.25",24876
,20161227,12900,12835,12935,13040,12830,13025,12965,190,130,982,"6,366.64",24962
,20161228,13025,12965,13045,13190,12915,12950,13020,-15,55,2124,"13,832.45",25868
,20161229,12950,13020,12905,12970,12840,12970,12905,-50,-115,1042,"6,724.80",25824
,20161230,12970,12905,12925,13085,12875,13000,12995,95,90,1950,"12,673.19",26030
al1707,20160718,12235,12235,,,,12235,12235,0,0,0,0.00,0
,20160719,12235,12235,12170,12170,12120,12120,12130,-115,-105,10,60.66,10
,20160720,12120,12130,12170,12305,12170,12230,12230,100,100,14,85.64,6
,20160721,12230,12230,12230,12230,12190,12190,12210,-40,-20,6,36.63,12
,20160722,12190,12210,12465,12465,12110,12110,12205,-100,-5,44,268.58,46
,20160725,12110,12205,12155,12155,12150,12150,12150,-55,-55,4,24.31,50
,20160726,12150,12150,12160,12160,12055,12055,12090,-95,-60,12,72.55,60
,20160727,12055,12090,11985,11985,11985,11985,11985,-105,-105,4,23.97,64
,20160728,11985,11985,11985,12125,11985,12125,12075,140,90,48,289.92,92
,20160729,12125,12075,12100,12110,12020,12020,12065,-55,-10,44,265.52,118
,20160801,12020,12065,12100,12100,12100,12100,12100,35,35,16,96.80,118
,20160802,12100,12100,,,,12100,12100,0,0,0,0.00,118
,20160803,12100,12100,12105,12120,12000,12000,12070,-100,-30,60,362.17,116
,20160804,12000,12070,12000,12045,11950,12010,12000,-60,-70,52,312.07,128
,20160805,12010,12000,12045,12050,12040,12050,12045,50,45,22,132.50,150
,20160808,12050,12045,12130,12195,12130,12175,12165,130,120,28,170.33,162
,20160809,12175,12165,12130,12130,12130,12130,12130,-35,-35,14,84.91,150
,20160810,12130,12130,12140,12145,12140,12145,12140,15,10,6,36.43,154
,20160811,12145,12140,12130,12160,12105,12145,12115,5,-25,34,205.97,184
,20160812,12145,12115,12100,12100,12085,12085,12090,-30,-25,4,24.19,182
,20160815,12085,12090,12080,12100,12055,12100,12075,10,-15,16,96.64,182
,20160816,12100,12075,12225,12225,12085,12200,12175,125,100,98,596.61,222
,20160817,12200,12175,12180,12200,12175,12200,12190,25,15,34,207.24,228
,20160818,12200,12190,12255,12260,12245,12245,12250,55,60,14,85.77,220
,20160819,12245,12250,12325,12325,12200,12305,12275,55,25,68,417.41,220
,20160822,12305,12275,12210,12220,12085,12085,12180,-190,-95,26,158.37,224
,20160823,12085,12180,12140,12225,12140,12190,12200,10,20,46,280.71,232
,20160824,12190,12200,12245,12275,12200,12210,12205,10,5,90,549.36,294
,20160825,12210,12205,12185,12185,12080,12135,12150,-70,-55,50,303.78,274
,20160826,12135,12150,12140,12230,12140,12185,12175,35,25,44,267.86,288
,20160829,12185,12175,12180,12210,12150,12205,12185,30,10,16,97.50,290
,20160830,12205,12185,12130,12130,12130,12130,12130,-55,-55,12,72.78,298
,20160831,12130,12130,12035,12035,12035,12035,12035,-95,-95,2,12.04,300
,20160901,12035,12035,12010,12025,11995,11995,12015,-40,-20,26,156.20,322
,20160902,11995,12015,12030,12135,12030,12040,12065,25,50,50,301.64,318
,20160905,12040,12065,12020,12025,11830,11830,11910,-235,-155,56,333.53,342
,20160906,11830,11910,11830,11900,11795,11900,11825,-10,-85,22,130.13,344
,20160907,11900,11825,11905,11920,11865,11865,11900,40,75,20,119.00,342
,20160908,11865,11900,11800,11810,11800,11810,11805,-90,-95,8,47.23,342
,20160909,11810,11805,11835,11855,11810,11855,11835,50,30,70,414.36,338
,20160912,11855,11835,11810,11810,11745,11755,11750,-80,-85,72,423.14,392
,20160913,11755,11750,11765,11810,11730,11800,11770,50,20,58,341.46,402
,20160914,11800,11770,11770,11770,11640,11650,11680,-120,-90,234,"1,366.97",468
,20160919,11650,11680,11660,11660,11640,11640,11640,-40,-40,46,267.80,472
,20160920,11640,11640,11670,11830,11670,11830,11710,190,70,54,316.17,456
,20160921,11830,11710,11845,11900,11845,11845,11865,135,155,76,450.98,456
,20160922,11845,11865,11850,11965,11850,11940,11910,75,45,82,488.37,486
,20160923,11940,11910,11970,12055,11970,12025,11995,115,85,28,167.94,490
,20160926,12025,11995,12010,12020,11870,11900,11965,-95,-30,34,203.44,486
,20160927,11900,11965,11915,11975,11910,11965,11950,0,-15,62,370.50,494
,20160928,11965,11950,11925,11955,11885,11955,11940,5,-10,52,310.44,490
,20160929,11955,11940,11995,12000,11990,11990,11990,50,50,30,179.91,490
,20160930,11990,11990,11970,11970,11895,11895,11925,-95,-65,44,262.38,476
,20161010,11895,11925,11970,11990,11920,11960,11965,35,40,134,801.95,500
,20161011,11960,11965,12140,12140,12020,12130,12075,165,110,118,712.43,572
,20161012,12130,12075,12120,12170,12060,12120,12135,45,60,88,533.99,620
,20161013,12120,12135,12180,12240,12180,12240,12220,105,85,68,415.58,656
,20161014,12240,12220,12225,12440,12220,12395,12380,175,160,266,"1,646.77",804
,20161017,12395,12380,12385,12415,12180,12180,12285,-200,-95,54,331.74,830
,20161018,12180,12285,12200,12355,12165,12355,12260,70,-25,164,"1,005.41",850
,20161019,12355,12260,12360,12370,12135,12135,12240,-125,-20,132,807.86,928
,20161020,12135,12240,12135,12190,12080,12140,12145,-100,-95,90,546.59,984
,20161021,12140,12145,12205,12205,12205,12205,12205,60,60,10,61.03,984
,20161024,12205,12205,12250,12345,12220,12345,12290,140,85,174,"1,069.58",1010
,20161025,12345,12290,12360,12780,12350,12735,12550,445,260,164,"1,029.50",1014
,20161026,12735,12550,13015,13050,12840,12840,12920,290,370,428,"2,765.03",1264
,20161027,12840,12920,12875,12910,12670,12810,12820,-110,-100,354,"2,269.52",1462
,20161028,12810,12820,12770,13030,12725,12980,12975,160,155,826,"5,359.52",1894
,20161031,12980,12975,13080,13110,12950,13100,13060,125,85,2108,"13,767.44",3580
,20161101,13100,13060,13125,13195,13060,13155,13105,95,45,338,"2,215.14",3666
,20161102,13155,13105,13105,13130,12800,12855,13010,-250,-95,342,"2,224.73",3616
,20161103,12855,13010,12855,13050,12825,13010,12945,0,-65,324,"2,097.29",3582
,20161104,13010,12945,13120,13120,12940,12950,13015,5,70,252,"1,640.13",3644
,20161107,12950,13015,12985,13165,12985,13080,13065,65,50,354,"2,313.06",3662
,20161108,13080,13065,13050,13115,13000,13020,13050,-45,-15,262,"1,710.11",3748
,20161109,13020,13050,13095,13170,13000,13075,13095,25,45,422,"2,763.20",3706
,20161110,13075,13095,13185,13615,13185,13610,13490,515,395,428,"2,887.43",3828
,20161111,13610,13490,13605,13765,13525,13630,13635,140,145,826,"5,632.66",4152
,20161114,13630,13635,13720,14250,13210,13755,13660,120,25,1082,"7,391.88",4010
,20161115,13755,13660,13655,13745,13305,13305,13585,-355,-75,294,"1,997.38",3974
,20161116,13305,13585,13330,13355,13105,13220,13215,-365,-370,388,"2,564.09",4156
,20161117,13220,13215,13150,13195,13025,13135,13115,-80,-100,524,"3,436.15",4500
,20161118,13135,13115,13155,13300,13065,13280,13230,165,115,206,"1,362.77",4588
,20161121,13280,13230,13340,13590,13225,13575,13485,345,255,472,"3,182.65",4540
,20161122,13575,13485,13610,13750,13590,13690,13685,205,200,310,"2,121.73",4632
,20161123,13690,13685,13450,13800,13450,13665,13720,-20,35,518,"3,553.63",4528
,20161124,13665,13720,13675,13880,13530,13810,13745,90,25,432,"2,969.18",4632
,20161125,13810,13745,13805,13960,13800,13890,13880,145,135,2152,"14,935.56",4914
,20161128,13890,13880,13890,14180,13785,14155,14035,275,155,410,"2,877.82",4976
,20161129,14155,14035,14065,14200,13635,13635,13865,-400,-170,244,"1,691.88",4910
,20161130,13635,13865,13570,13720,13300,13325,13530,-540,-335,524,"3,545.59",4770
,20161201,13325,13530,13500,13695,13490,13525,13575,-5,45,284,"1,927.80",4710
,20161202,13525,13575,13520,13660,13415,13480,13520,-95,-55,568,"3,841.06",4490
,20161205,13480,13520,13435,13560,13395,13395,13460,-125,-60,168,"1,130.86",4552
,20161206,13395,13460,13480,13515,13400,13400,13480,-60,20,22,148.30,4556
,20161207,13400,13480,13415,13530,13310,13530,13405,50,-75,74,496.06,4574
,20161208,13530,13405,13550,13575,13320,13405,13505,0,100,16,108.05,4580
,20161209,13405,13505,13440,13625,13390,13615,13570,110,65,158,"1,072.13",4548
,20161212,13615,13570,13625,13745,13575,13685,13695,115,125,1212,"8,301.18",4806
,20161213,13685,13695,13585,13680,13575,13585,13600,-110,-95,216,"1,469.11",4870
,20161214,13585,13600,13610,13610,13390,13390,13460,-210,-140,140,942.42,4866
,20161215,13390,13460,13360,13400,13235,13390,13320,-70,-140,430,"2,863.82",5126
,20161216,13390,13320,13320,13415,13285,13285,13370,-35,50,300,"2,005.88",5250
,20161219,13285,13370,13255,13330,13065,13065,13110,-305,-260,476,"3,120.97",5474
,20161220,13065,13110,13095,13095,12960,12970,13020,-140,-90,166,"1,081.04",5478
,20161221,12970,13020,13155,13155,13080,13100,13110,80,90,384,"2,518.05",5506
,20161222,13100,13110,13120,13165,13035,13045,13115,-65,5,1024,"6,716.46",5992
,20161223,13045,13115,13010,13170,12900,13015,13075,-100,-40,808,"5,282.99",6452
,20161226,13015,13075,13025,13235,12800,12970,12905,-105,-170,424,"2,736.85",6580
,20161227,12970,12905,12995,13110,12950,13095,13045,190,140,584,"3,810.11",6758
,20161228,13095,13045,13115,13240,12985,13020,13080,-25,35,194,"1,268.77",6830
,20161229,13020,13080,12940,13040,12905,13030,12955,-50,-125,280,"1,814.09",6966
,20161230,13030,12955,12965,13150,12940,13070,13085,115,130,538,"3,520.15",7090
al1708,20160816,12075,12075,12110,12195,12110,12195,12185,120,110,64,389.95,54
,20160817,12195,12185,12195,12215,12195,12200,12200,15,15,32,195.27,58
,20160818,12200,12200,12230,12360,12230,12360,12290,160,90,108,663.79,88
,20160819,12360,12290,12360,12375,12280,12315,12305,25,15,22,135.41,94
,20160822,12315,12305,12270,12270,12035,12175,12195,-130,-110,86,524.50,128
,20160823,12175,12195,12180,12245,12160,12215,12220,20,25,40,244.48,144
,20160824,12215,12220,12260,12270,12215,12220,12235,0,15,118,721.99,148
,20160825,12220,12235,12220,12220,12155,12155,12175,-80,-60,130,791.47,236
,20160826,12155,12175,12235,12235,12185,12185,12200,10,25,132,805.47,196
,20160829,12185,12200,12170,12215,12165,12165,12185,-35,-15,28,170.63,198
,20160830,12165,12185,12120,12180,12110,12110,12140,-75,-45,42,254.94,208
,20160831,12110,12140,12040,12085,12020,12025,12050,-115,-90,54,325.36,228
,20160901,12025,12050,12035,12050,12010,12050,12025,0,-25,26,156.36,248
,20160902,12050,12025,12090,12105,12060,12060,12070,35,45,22,132.81,242
,20160905,12060,12070,12035,12035,11850,11865,11895,-205,-175,290,"1,725.29",414
,20160906,11865,11895,11800,11935,11795,11910,11850,15,-45,186,"1,102.40",460
,20160907,11910,11850,11930,11935,11860,11880,11900,30,50,154,916.63,480
,20160908,11880,11900,11880,11880,11800,11815,11835,-85,-65,114,674.60,520
,20160909,11815,11835,11815,11860,11815,11855,11845,20,10,1344,"7,961.46",1388
,20160912,11855,11845,11795,11835,11750,11805,11785,-40,-60,386,"2,275.04",1666
,20160913,11805,11785,11805,11830,11760,11825,11805,40,20,344,"2,030.94",1748
,20160914,11825,11805,11790,11815,11650,11650,11715,-155,-90,384,"2,250.04",1970
,20160919,11650,11715,11715,11730,11645,11645,11675,-70,-40,140,817.42,1980
,20160920,11645,11675,11695,11845,11695,11845,11795,170,120,66,389.26,1958
,20160921,11845,11795,11845,11900,11830,11845,11860,50,65,130,770.95,1946
,20160922,11845,11860,11860,11975,11765,11955,11910,95,50,200,"1,191.19",2038
,20160923,11955,11910,12025,12090,11875,12070,12020,160,110,118,709.24,2066
,20160926,12070,12020,12035,12035,11910,11935,11940,-85,-80,66,394.05,2048
,20160927,11935,11940,11905,12005,11905,11980,11960,40,20,118,705.83,2070
,20160928,11980,11960,11895,11955,11870,11955,11920,-5,-40,114,679.50,2058
,20160929,11955,11920,11985,12050,11960,11960,12005,40,85,202,"1,212.53",2158
,20160930,11960,12005,11965,11965,11875,11875,11900,-130,-105,298,"1,773.65",2332
,20161010,11875,11900,11955,11960,11885,11960,11935,60,35,222,"1,324.92",2462
,20161011,11960,11935,12005,12105,11970,12095,12055,160,120,282,"1,700.28",2486
,20161012,12095,12055,12095,12130,12055,12100,12090,45,35,178,"1,076.32",2482
,20161013,12100,12090,12145,12220,12130,12200,12155,110,65,126,765.89,2466
,20161014,12200,12155,12200,12495,12200,12395,12385,240,230,556,"3,444.08",2688
,20161017,12395,12385,12425,12425,12200,12240,12345,-145,-40,306,"1,888.86",2626
,20161018,12240,12345,12220,12345,12195,12345,12255,0,-90,128,784.53,2552
,20161019,12345,12255,12330,12370,12140,12140,12255,-115,0,304,"1,862.82",2520
,20161020,12140,12255,12140,12160,12110,12150,12135,-105,-120,42,254.86,2526
,20161021,12150,12135,12120,12200,12075,12170,12125,35,-10,48,291.06,2524
,20161024,12170,12125,12240,12350,12220,12350,12280,225,155,154,945.74,2532
,20161025,12350,12280,12365,12770,12350,12735,12505,455,225,364,"2,276.69",2586
,20161026,12735,12505,12995,12995,12860,12860,12900,355,395,54,348.38,2588
,20161027,12860,12900,12890,12890,12700,12780,12795,-120,-105,546,"3,493.07",3014
,20161028,12780,12795,12760,12995,12760,12950,12940,155,145,544,"3,520.94",3240
,20161031,12950,12940,13065,13130,12955,13080,13055,140,115,590,"3,852.70",3620
,20161101,13080,13055,13160,13200,13040,13130,13090,75,35,500,"3,273.09",3882
,20161102,13130,13090,13130,13130,12795,12860,12965,-230,-125,516,"3,345.94",4082
,20161103,12860,12965,12860,13005,12850,13000,12915,35,-50,518,"3,345.44",4062
,20161104,13000,12915,13090,13280,12915,12935,13025,20,110,224,"1,459.21",4136
,20161107,12935,13025,12950,13150,12950,13015,13035,-10,10,398,"2,594.78",4142
,20161108,13015,13035,13005,13170,12965,13010,13035,-25,0,318,"2,073.06",4132
,20161109,13010,13035,13080,13145,13050,13050,13060,15,25,336,"2,194.19",4340
,20161110,13050,13060,13050,13580,13050,13580,13405,520,345,296,"1,984.60",4316
,20161111,13580,13405,13590,13695,13380,13635,13600,230,195,458,"3,114.92",4328
,20161114,13635,13600,13735,14270,13250,13735,13685,135,85,514,"3,517.12",4366
,20161115,13735,13685,13640,13790,13280,13280,13630,-405,-55,328,"2,235.58",4394
,20161116,13280,13630,13305,13360,13135,13195,13235,-435,-395,222,"1,469.41",4386
,20161117,13195,13235,13180,13185,12980,13095,13090,-140,-145,350,"2,291.06",4610
,20161118,13095,13090,13155,13300,13095,13300,13210,210,120,254,"1,677.92",4690
,20161121,13300,13210,13340,13545,13205,13535,13370,325,160,262,"1,751.57",4724
,20161122,13535,13370,13630,13745,13570,13650,13655,280,285,42,286.77,4750
,20161123,13650,13655,13735,13795,13590,13680,13710,25,55,288,"1,974.56",4724
,20161124,13680,13710,13640,13895,13495,13810,13825,100,115,324,"2,240.04",4760
,20161125,13810,13825,13800,13970,13800,13935,13910,110,85,1886,"13,118.51",4832
,20161128,13935,13910,13995,14250,13860,14190,14125,280,215,530,"3,744.17",4890
,20161129,14190,14125,14145,14145,13680,13680,13885,-445,-240,304,"2,110.56",4870
,20161130,13680,13885,13700,13760,13350,13355,13460,-530,-425,508,"3,419.08",4840
,20161201,13355,13460,13590,13700,13515,13635,13585,175,125,342,"2,323.63",4788
,20161202,13635,13585,13500,13750,13500,13565,13565,-20,-20,102,691.85,4808
,20161205,13565,13565,13495,13605,13455,13455,13490,-110,-75,140,944.37,4870
,20161206,13455,13490,13525,13600,13470,13475,13530,-15,40,18,121.77,4862
,20161207,13475,13530,13495,13595,13375,13595,13450,65,-80,150,"1,008.88",4846
,20161208,13595,13450,13605,13680,13400,13480,13555,30,105,304,"2,060.69",4902
,20161209,13480,13555,13575,13700,13440,13660,13605,105,50,164,"1,115.63",4954
,20161212,13660,13605,13625,13815,13575,13710,13740,105,135,160,"1,099.40",4878
,20161213,13710,13740,13665,13730,13660,13675,13685,-65,-55,182,"1,245.65",4838
,20161214,13675,13685,13680,13680,13460,13475,13550,-210,-135,180,"1,219.50",4840
,20161215,13475,13550,13450,13530,13345,13485,13400,-65,-150,64,428.87,4846
,20161216,13485,13400,13395,13495,13380,13400,13445,0,45,356,"2,393.56",5048
,20161219,13400,13445,13325,13380,13150,13155,13240,-290,-205,776,"5,139.02",5344
,20161220,13155,13240,13080,13190,13005,13060,13105,-180,-135,154,"1,009.16",5420
,20161221,13060,13105,13145,13220,13130,13190,13190,85,85,432,"2,849.55",5408
,20161222,13190,13190,13190,13235,13105,13115,13185,-75,-5,670,"4,417.51",5494
,20161223,13115,13185,13085,13205,13030,13105,13145,-80,-40,356,"2,339.96",5688
,20161226,13105,13145,13140,13190,12855,13040,13005,-105,-140,236,"1,534.72",5778
,20161227,13040,13005,13070,13170,12970,13165,13120,160,115,84,551.19,5830
,20161228,13165,13120,13180,13300,13095,13105,13195,-15,75,50,329.94,5838
,20161229,13105,13195,13025,13110,12970,13110,13060,-85,-135,94,613.89,5866
,20161230,13110,13060,13060,13220,13010,13165,13150,105,90,262,"1,722.85",6006
al1709,20160920,11675,11675,11685,11835,11685,11835,11785,160,110,82,483.29,70
,20160921,11835,11785,11830,11920,11830,11905,11890,120,105,150,891.83,212
,20160922,11905,11890,11840,12050,11840,11940,11950,50,60,22,131.48,214
,20160923,11940,11950,11980,12070,11955,12070,12025,120,75,162,974.40,348
,20160926,12070,12025,12015,12015,11905,11935,11945,-90,-80,50,298.71,368
,20160927,11935,11945,11910,11995,11910,11975,11955,30,10,1278,"7,639.94",1526
,20160928,11975,11955,11865,11980,11860,11950,11945,-5,-10,160,955.67,1616
,20160929,11950,11945,11995,12045,11950,11950,12000,5,55,838,"5,029.60",2296
,20160930,11950,12000,11975,12020,11870,11905,11900,-95,-100,358,"2,130.61",2590
,20161010,11905,11900,12005,12005,11885,11950,11930,50,30,856,"5,107.34",3282
,20161011,11950,11930,11950,12070,11950,12060,12000,130,70,1370,"8,223.15",4434
,20161012,12060,12000,12045,12110,12025,12070,12065,70,65,292,"1,761.95",4504
,20161013,12070,12065,12130,12195,12060,12185,12140,120,75,356,"2,161.49",4632
,20161014,12185,12140,11955,12550,11955,12400,12340,260,200,804,"4,962.40",5024
,20161017,12400,12340,12375,12475,12200,12230,12310,-110,-30,878,"5,405.58",4880
,20161018,12230,12310,12200,12360,12195,12355,12280,45,-30,232,"1,424.99",4956
,20161019,12355,12280,12300,12370,12120,12120,12220,-160,-60,694,"4,241.35",5328
,20161020,12120,12220,12140,12180,12095,12130,12145,-90,-75,262,"1,591.06",5500
,20161021,12130,12145,12040,12215,12040,12165,12170,20,25,300,"1,825.81",5594
,20161024,12165,12170,12230,12360,12225,12355,12285,185,115,478,"2,936.62",5636
,20161025,12355,12285,12375,12765,12345,12750,12615,465,330,854,"5,388.60",5612
,20161026,12750,12615,12795,13115,12790,12830,12970,215,355,994,"6,447.42",5790
,20161027,12830,12970,12875,12905,12660,12770,12795,-200,-175,704,"4,504.70",6074
,20161028,12770,12795,12750,13000,12725,12970,12915,175,120,532,"3,436.06",6174
,20161031,12970,12915,13015,13135,12930,13075,13050,160,135,582,"3,797.56",6402
,20161101,13075,13050,13110,13210,13035,13115,13105,65,55,278,"1,821.96",6478
,20161102,13115,13105,13105,13115,12780,12830,12970,-275,-135,800,"5,189.30",6686
,20161103,12830,12970,12890,13015,12825,12985,12905,15,-65,950,"6,132.09",6724
,20161104,12985,12905,13015,13085,12895,12935,12965,30,60,1010,"6,549.61",7380
,20161107,12935,12965,12935,13125,12935,13050,13045,85,80,998,"6,511.44",7264
,20161108,13050,13045,13040,13100,12940,13000,13030,-45,-15,1270,"8,274.51",7444
,20161109,13000,13030,13035,13145,13000,13060,13065,30,35,1724,"11,265.74",7900
,20161110,13060,13065,13095,13585,13095,13560,13365,495,300,1622,"10,841.69",8316
,20161111,13560,13365,13555,13665,13365,13625,13555,260,190,978,"6,629.36",8382
,20161114,13625,13555,13780,14200,13115,13655,13650,100,95,1746,"11,919.44",8404
,20161115,13655,13650,13585,13760,13210,13210,13595,-440,-55,1168,"7,942.29",8530
,20161116,13210,13595,13280,13390,13085,13195,13230,-400,-365,394,"2,606.95",8610
,20161117,13195,13230,13060,13195,13000,13110,13100,-120,-130,808,"5,293.95",9020
,20161118,13110,13100,13065,13285,13065,13250,13215,150,115,290,"1,916.58",9104
,20161121,13250,13215,13490,13560,13185,13545,13400,330,185,918,"6,152.44",9128
,20161122,13545,13400,13630,13775,13505,13680,13645,280,245,306,"2,088.12",9134
,20161123,13680,13645,13680,13810,12840,13660,13545,15,-100,416,"2,818.26",9026
,20161124,13660,13545,13640,13875,13490,13805,13795,260,250,486,"3,352.27",8984
,20161125,13805,13795,13820,14000,13790,13990,13935,195,140,2930,"20,419.43",8682
,20161128,13990,13935,13990,14340,13865,14235,14145,300,210,1742,"12,323.59",8578
,20161129,14235,14145,14175,14255,13730,13730,13960,-415,-185,914,"6,381.21",8474
,20161130,13730,13960,13750,13780,13350,13435,13465,-525,-495,564,"3,798.39",8564
,20161201,13435,13465,13510,13720,13510,13615,13635,150,170,514,"3,504.67",8516
,20161202,13615,13635,13555,13800,13555,13600,13635,-35,0,156,"1,063.79",8502
,20161205,13600,13635,13555,13610,13490,13500,13540,-135,-95,166,"1,123.91",8548
,20161206,13500,13540,13555,13670,13490,13550,13560,10,20,64,433.97,8564
,20161207,13550,13560,13550,13670,13415,13670,13475,110,-85,330,"2,223.84",8704
,20161208,13670,13475,13665,13740,13440,13570,13620,95,145,388,"2,642.92",8532
,20161209,13570,13620,13645,13760,13435,13740,13695,120,75,262,"1,794.35",8582
,20161212,13740,13695,13735,13880,13665,13765,13795,70,100,354,"2,441.94",8568
,20161213,13765,13795,13715,13795,13715,13740,13760,-55,-35,1356,"9,331.47",8308
,20161214,13740,13760,13750,13750,13510,13545,13610,-215,-150,148,"1,007.49",8372
,20161215,13545,13610,13575,13575,13415,13555,13470,-55,-140,236,"1,589.70",8392
,20161216,13555,13470,13545,13575,13495,13495,13530,25,60,488,"3,302.14",8560
,20161219,13495,13530,13445,13460,13235,13235,13325,-295,-205,328,"2,186.02",8618
,20161220,13235,13325,13220,13295,13120,13205,13195,-120,-130,316,"2,084.85",8636
,20161221,13205,13195,13220,13315,13170,13260,13270,65,75,476,"3,158.33",8592
,20161222,13260,13270,13235,13320,13170,13195,13245,-75,-25,146,967.15,8618
,20161223,13195,13245,13130,13300,13115,13190,13235,-55,-10,412,"2,727.01",8634
,20161226,13190,13235,13230,13260,12925,13090,13045,-145,-190,280,"1,826.73",8634
,20161227,13090,13045,13100,13335,13035,13335,13200,290,155,106,699.64,8636
,20161228,13335,13200,13200,13380,12900,13145,13215,-55,15,288,"1,903.61",8606
,20161229,13145,13215,13105,13210,13000,13195,13125,-20,-90,212,"1,391.75",8614
,20161230,13195,13125,13125,13290,13085,13230,13230,105,105,640,"4,234.69",8760
al1710,20161018,12310,12310,12220,12335,12195,12335,12265,25,-45,54,331.16,30
,20161019,12335,12265,12455,12455,12165,12175,12235,-90,-30,40,244.71,54
,20161020,12175,12235,12150,12150,12150,12150,12150,-85,-85,2,12.15,56
,20161021,12150,12150,12125,12185,12125,12185,12160,35,10,12,72.97,60
,20161024,12185,12160,12235,12345,12215,12345,12285,185,125,122,749.64,160
,20161025,12345,12285,12425,12725,12370,12720,12550,435,265,106,665.27,238
,20161026,12720,12550,12565,13000,12565,12800,12870,250,320,136,875.24,304
,20161027,12800,12870,12860,12900,12680,12805,12805,-65,-65,344,"2,203.22",526
,20161028,12805,12805,12715,12995,12715,12980,12835,175,30,716,"4,596.26",930
,20161031,12980,12835,12980,13125,12950,13040,13035,205,200,468,"3,050.77",1160
,20161101,13040,13035,13050,13200,13050,13080,13085,45,50,196,"1,282.79",1262
,20161102,13080,13085,13085,13110,12770,12800,12955,-285,-130,530,"3,433.91",1526
,20161103,12800,12955,12885,12995,12830,12955,12895,0,-60,300,"1,934.94",1524
,20161104,12955,12895,13030,13060,12880,12900,12970,5,75,240,"1,556.75",1504
,20161107,12900,12970,12940,13100,12940,13040,13030,70,60,256,"1,668.26",1526
,20161108,13040,13030,12990,13090,12955,13070,13005,40,-25,132,858.49,1556
,20161109,13070,13005,13025,13150,13010,13045,13045,40,40,218,"1,422.09",1612
,20161110,13045,13045,13135,13565,13135,13565,13355,520,310,326,"2,177.17",1684
,20161111,13565,13355,13465,13665,13415,13600,13545,245,190,248,"1,680.04",1778
,20161114,13600,13545,13795,14200,13170,13690,13595,145,50,656,"4,460.47",1784
,20161115,13690,13595,13635,13710,13190,13235,13485,-360,-110,310,"2,090.44",1788
,20161116,13235,13485,13265,13355,13080,13160,13205,-325,-280,464,"3,064.53",1886
,20161117,13160,13205,13125,13145,12970,13100,13070,-105,-135,456,"2,980.60",2076
,20161118,13100,13070,13125,13290,13125,13290,13220,220,150,242,"1,599.76",2190
,20161121,13290,13220,13325,13555,13180,13555,13360,335,140,132,881.87,2206
,20161122,13555,13360,13565,13750,13565,13660,13660,300,300,204,"1,393.62",2230
,20161123,13660,13660,13685,13755,13485,13650,13660,-10,0,618,"4,221.41",2146
,20161124,13650,13660,13625,13870,13500,13815,13780,155,120,168,"1,157.60",2112
,20161125,13815,13780,13815,14005,13775,13985,13920,205,140,462,"3,215.74",2156
,20161128,13985,13920,14020,14340,13880,14310,14210,390,290,240,"1,705.54",2086
,20161129,14310,14210,14245,14245,13710,13710,14020,-500,-190,202,"1,416.19",2042
,20161130,13710,14020,13705,13725,13420,13475,13525,-545,-495,76,514.11,2024
,20161201,13475,13525,13560,13715,13550,13685,13595,160,70,142,965.25,2068
,20161202,13685,13595,13630,13805,13600,13600,13625,5,30,26,177.15,2048
,20161205,13600,13625,13575,13585,13530,13535,13555,-90,-70,28,189.78,2056
,20161206,13535,13555,13585,13670,13520,13550,13605,-5,50,26,176.93,2064
,20161207,13550,13605,13555,13710,13460,13690,13540,85,-65,86,582.38,2082
,20161208,13690,13540,13745,13815,13530,13580,13730,40,190,184,"1,263.20",2054
,20161209,13580,13730,13635,13805,13440,13805,13720,75,-10,176,"1,207.70",2058
,20161212,13805,13720,13740,13900,13720,13800,13805,80,85,88,607.48,2058
,20161213,13800,13805,13755,13820,13745,13805,13800,0,-5,94,648.64,2080
,20161214,13805,13800,13745,13800,13610,13615,13725,-185,-75,92,631.46,2062
,20161215,13615,13725,13590,13645,13490,13615,13545,-110,-180,112,758.79,2030
,20161216,13615,13545,13610,13650,13560,13580,13585,35,40,200,"1,358.95",2142
,20161219,13580,13585,13545,13555,13340,13340,13465,-245,-120,196,"1,319.58",2158
,20161220,13340,13465,13320,13380,13215,13270,13285,-195,-180,344,"2,285.22",2162
,20161221,13270,13285,13290,13395,13290,13345,13350,60,65,102,681.01,2164
,20161222,13345,13350,13345,13390,13255,13255,13320,-95,-30,60,399.71,2176
,20161223,13255,13320,13250,13370,13200,13270,13290,-50,-30,308,"2,046.75",2284
,20161226,13270,13290,13270,13300,13030,13160,13145,-130,-145,92,604.85,2298
,20161227,13160,13145,13205,13225,13120,13225,13185,80,40,30,197.83,2292
,20161228,13225,13185,13250,13430,13225,13230,13310,45,125,100,665.53,2308
,20161229,13230,13310,13170,13240,13170,13240,13210,-70,-100,36,237.80,2310
,20161230,13240,13210,13400,13400,13215,13290,13270,80,60,64,424.66,2316
al1711,20161116,13485,13485,13175,13565,13090,13090,13245,-395,-240,26,172.20,16
,20161117,13090,13245,13125,13180,13000,13000,13110,-245,-135,92,603.17,90
,20161118,13000,13110,13130,13295,13130,13295,13215,185,105,90,594.74,108
,20161121,13295,13215,13305,13505,13290,13500,13370,285,155,78,521.57,158
,20161122,13500,13370,13775,13775,13405,13640,13640,270,270,62,422.99,170
,20161123,13640,13640,13735,13765,13505,13640,13640,0,0,114,777.62,216
,20161124,13640,13640,13640,13875,13580,13815,13805,175,165,236,"1,629.23",296
,20161125,13815,13805,13800,14080,13795,14080,13895,275,90,320,"2,223.55",530
,20161128,14080,13895,13935,14380,13920,14320,14245,425,350,264,"1,880.85",552
,20161129,14320,14245,14285,14285,13765,13775,14020,-470,-225,144,"1,009.67",502
,20161130,13775,14020,13785,13850,13400,13450,13580,-570,-440,126,855.60,510
,20161201,13450,13580,13580,13770,13445,13670,13665,90,85,474,"3,239.22",596
,20161202,13670,13665,13635,13820,13610,13650,13695,-15,30,116,794.50,608
,20161205,13650,13695,13665,13665,13540,13550,13580,-145,-115,144,978.10,648
,20161206,13550,13580,13635,13655,13560,13560,13605,-20,25,32,217.75,648
,20161207,13560,13605,13595,13780,13470,13760,13620,155,15,226,"1,539.10",702
,20161208,13760,13620,13825,13875,13550,13645,13735,25,115,258,"1,771.89",658
,20161209,13645,13735,13690,13825,13625,13815,13785,80,50,158,"1,089.09",758
,20161212,13815,13785,13840,13930,13720,13820,13845,35,60,156,"1,080.10",754
,20161213,13820,13845,13820,13855,13785,13840,13830,-5,-15,148,"1,023.72",814
,20161214,13840,13830,13800,13830,13555,13715,13735,-115,-95,212,"1,456.42",768
,20161215,13715,13735,13635,13700,13565,13700,13615,-35,-120,64,435.69,784
,20161216,13700,13615,13620,13715,13615,13630,13655,15,40,156,"1,065.27",856
,20161219,13630,13655,13595,13600,13405,13405,13500,-250,-155,114,769.61,792
,20161220,13405,13500,13400,13450,13270,13270,13355,-230,-145,104,694.66,782
,20161221,13270,13355,13460,13460,13415,13415,13435,60,80,22,147.82,772
,20161222,13415,13435,13380,13455,13360,13375,13385,-60,-50,28,187.42,772
,20161223,13375,13385,13335,13450,13260,13310,13405,-75,20,284,"1,904.15",800
,20161226,13310,13405,13390,13390,13100,13230,13175,-175,-230,66,434.82,804
,20161227,13230,13175,13280,13335,13175,13335,13245,160,70,158,"1,046.70",820
,20161228,13335,13245,13325,13490,13245,13260,13340,15,95,102,680.56,818
,20161229,13260,13340,13200,13330,13180,13330,13255,-10,-85,18,119.33,826
,20161230,13330,13255,13310,13400,13215,13385,13335,130,80,40,266.72,832
al1712,20161216,13615,13615,13685,13705,13685,13700,13690,85,75,8,54.78,8
,20161219,13700,13690,13585,13585,13500,13500,13540,-190,-150,14,94.81,12
,20161220,13500,13540,13420,13455,13370,13425,13405,-115,-135,34,227.93,26
,20161221,13425,13405,13480,13510,13425,13510,13465,105,60,18,121.19,30
,20161222,13510,13465,13440,13495,13440,13445,13465,-20,0,18,121.20,24
,20161223,13445,13465,13480,13485,13360,13380,13450,-85,-15,362,"2,434.82",260
,20161226,13380,13450,13255,13485,13170,13300,13260,-150,-190,110,729.39,280
,20161227,13300,13260,13315,13405,13280,13405,13355,145,95,44,293.85,284
,20161228,13405,13355,13415,13555,13285,13305,13415,-50,60,70,469.69,300
,20161229,13305,13415,13260,13350,13260,13350,13320,-65,-95,46,306.44,316
,20161230,13350,13320,13375,13455,13290,13430,13380,110,60,104,695.96,372
au1601,20160104,222.8,222.1,223,223,223,223,223,.9,.9,6,133.80,300
,20160105,223,223,,,,225.05,225.05,2.05,2.05,0,0.00,300
,20160106,225.05,225.05,225.05,226.8,225.05,226.8,225.95,1.75,.9,30,677.94,300
,20160107,226.8,225.95,229.05,229.05,229.05,229.05,229.05,3.1,3.1,12,274.86,300
,20160108,229.05,229.05,233.9,233.9,233.9,233.9,233.9,4.85,4.85,12,280.68,288
,20160111,233.9,233.9,232.05,232.05,232.05,232.05,232.05,-1.85,-1.85,6,139.23,288
,20160112,232.05,232.05,234,234,234,234,234,1.95,1.95,12,280.80,276
,20160113,234,234,,,,234,234,0,0,0,0.00,276
,20160114,234,234,,,,234,234,0,0,0,0.00,276
,20160115,234,234,,,,234,234,0,0,0,0.00,276
au1602,20160104,223,223.05,223.25,225.25,223.25,224.9,224.85,1.85,1.8,18,404.76,262
,20160105,224.9,224.85,225.45,227.4,224.6,226.9,226.2,2.05,1.35,156,"3,529.22",216
,20160106,226.9,226.2,227,228.1,224.3,227.6,226.45,1.4,.25,56,"1,268.37",208
,20160107,227.6,226.45,228.8,233.75,226.7,233.25,230.85,6.8,4.4,190,"4,387.05",204
,20160108,233.25,230.85,234.3,235.3,232.6,234.2,234.2,3.35,3.35,138,"3,232.28",296
,20160111,234.2,234.2,233.35,234.85,232.8,234.85,233.8,.65,-.4,140,"3,273.76",278
,20160112,234.85,233.8,233.35,233.35,230.95,232.1,232.2,-1.7,-1.6,26,603.73,272
,20160113,232.1,232.2,230.65,230.7,228.5,230.05,230.15,-2.15,-2.05,70,"1,611.17",290
,20160114,230.05,230.15,229.15,232.2,227.4,232.2,229.9,2.05,-.25,82,"1,885.38",258
,20160115,232.2,229.9,231.05,231.4,229.6,230,230.1,.1,.2,30,690.36,254
,20160118,230,230.1,230.5,232.15,230,231.9,231.35,1.8,1.25,24,555.24,250
,20160119,231.9,231.35,231.75,231.75,230.9,231.35,231.15,0,-.2,28,647.27,258
,20160120,231.35,231.15,230.65,232.3,230.6,232.1,231.75,.95,.6,18,417.19,246
,20160121,232.1,231.75,234.85,234.85,232.35,233.9,234.1,2.15,2.35,58,"1,357.80",250
,20160122,233.9,234.1,233.55,233.65,232.25,232.25,233.25,-1.85,-.85,30,699.86,238
,20160125,232.25,233.25,233.3,233.95,233,233.95,233.4,.7,.15,46,"1,073.71",210
,20160126,233.95,233.4,235.05,235.05,234.2,234.2,234.6,.8,1.2,4,93.85,210
,20160127,234.2,234.6,237.85,238.4,237.1,237.55,237.7,2.95,3.1,24,570.58,200
,20160128,237.55,237.7,238.3,238.7,235.45,236.2,237.45,-1.5,-.25,92,"2,184.68",172
,20160129,236.2,237.45,236.5,238.1,235,235.1,235.85,-2.35,-1.6,46,"1,085.08",174
,20160201,235.1,235.85,,,,236.85,236.85,1,1,0,0.00,174
,20160202,236.85,236.85,242,243,239,239,241.3,2.15,4.45,18,434.40,168
,20160203,239,241.3,,,,241.3,241.3,0,0,0,0.00,168
,20160204,241.3,241.3,,,,241.3,241.3,0,0,0,0.00,168
,20160205,241.3,241.3,,,,241.3,241.3,0,0,0,0.00,168
,20160215,241.3,241.3,,,,241.3,241.3,0,0,0,0.00,168
au1603,20160104,226,226,,,,226,226,0,0,0,0.00,4
,20160105,226,226,,,,226,226,0,0,0,0.00,4
,20160106,226,226,,,,226.25,226.25,.25,.25,0,0.00,4
,20160107,226.25,226.25,232.85,236.65,232.85,236.65,233.9,10.4,7.65,8,187.12,8
,20160108,236.65,233.9,235.75,236.85,232.55,236.85,234.75,2.95,.85,18,422.59,8
,20160111,236.85,234.75,236.8,236.8,236.8,236.8,236.8,2.05,2.05,2,47.36,10
,20160112,236.8,236.8,231.9,234,231.9,234,232.95,-2.8,-3.85,4,93.18,8
,20160113,234,232.95,,,,232.95,232.95,0,0,0,0.00,8
,20160114,232.95,232.95,231.55,231.55,229.7,229.7,230.6,-3.25,-2.35,4,92.25,10
,20160115,229.7,230.6,228.85,228.85,228.85,228.85,228.85,-1.75,-1.75,2,45.77,8
,20160118,228.85,228.85,,,,230.7,230.7,1.85,1.85,0,0.00,8
,20160119,230.7,230.7,,,,230.5,230.5,-.2,-.2,0,0.00,8
,20160120,230.5,230.5,,,,231,231,.5,.5,0,0.00,8
,20160121,231,231,,,,233.4,233.4,2.4,2.4,0,0.00,8
,20160122,233.4,233.4,232.25,232.4,232.25,232.4,232.3,-1,-1.1,16,371.69,18
,20160125,232.4,232.3,233.3,233.35,233.3,233.35,233.3,1.05,1,6,139.99,14
,20160126,233.35,233.3,,,,233.3,233.3,0,0,0,0.00,14
,20160127,233.3,233.3,236.05,238.45,236.05,238.45,237.35,5.15,4.05,6,142.42,16
,20160128,238.45,237.35,236.9,238.15,236.9,238.15,237.5,.8,.15,4,95.01,18
,20160129,238.15,237.5,237.95,237.95,237.9,237.9,237.9,.4,.4,10,237.94,26
,20160201,237.9,237.9,238.05,239.6,237.7,237.7,239.1,-.2,1.2,58,"1,386.78",62
,20160202,237.7,239.1,,,,239.1,239.1,0,0,0,0.00,62
,20160203,239.1,239.1,240.9,240.9,240.05,240.05,240.05,.95,.95,42,"1,008.38",26
,20160204,240.05,240.05,,,,240.05,240.05,0,0,0,0.00,26
,20160205,240.05,240.05,245.35,245.35,244.3,244.3,244.8,4.25,4.75,4,97.93,26
,20160215,244.3,244.8,257.8,258.2,253.65,256.5,256.5,11.7,11.7,42,"1,077.48",36
,20160216,256.5,256.5,244.05,254.95,244.05,252.25,252.7,-4.25,-3.8,100,"2,527.29",34
,20160217,252.25,252.7,253.6,253.6,252,253.5,253.2,.8,.5,14,354.54,28
,20160218,253.5,253.2,252.45,254.5,252.45,254.5,253.65,1.3,.45,6,152.20,28
,20160219,254.5,253.65,254.9,257.6,254.9,256.5,256.4,2.85,2.75,36,923.14,28
,20160222,256.5,256.4,257.1,257.3,254.75,254.75,255.95,-1.65,-.45,32,819.11,30
,20160223,254.75,255.95,254.85,256.3,254.5,254.95,255.2,-1,-.75,16,408.34,28
,20160224,254.95,255.2,258.5,261.05,253.3,257.65,258.5,2.45,3.3,22,568.77,22
,20160225,257.65,258.5,260.95,262.2,259.4,262,260.6,3.5,2.1,46,"1,198.89",2
,20160226,262,260.6,,,,260.6,260.6,0,0,0,0.00,2
,20160229,260.6,260.6,253.6,257.95,251.3,257.95,255.05,-2.65,-5.55,8,204.07,0
,20160301,257.95,255.05,,,,255.05,255.05,0,0,0,0.00,0
,20160302,255.05,255.05,,,,255.05,255.05,0,0,0,0.00,0
,20160303,255.05,255.05,,,,255.05,255.05,0,0,0,0.00,0
,20160304,255.05,255.05,,,,255.05,255.05,0,0,0,0.00,0
,20160307,255.05,255.05,,,,255.05,255.05,0,0,0,0.00,0
,20160308,255.05,255.05,,,,255.05,255.05,0,0,0,0.00,0
,20160309,255.05,255.05,,,,255.05,255.05,0,0,0,0.00,0
,20160310,255.05,255.05,,,,255.05,255.05,0,0,0,0.00,0
,20160311,255.05,255.05,,,,255.05,255.05,0,0,0,0.00,0
,20160314,255.05,255.05,,,,255.05,255.05,0,0,0,0.00,0
,20160315,255.05,255.05,,,,255.05,255.05,0,0,0,0.00,0
au1604,20160104,225.05,225.05,225.6,226.8,225.6,226.15,226.65,1.1,1.6,42,952.03,128
,20160105,226.15,226.65,228.5,228.5,228.5,228.5,228.5,1.85,1.85,2,45.70,128
,20160106,228.5,228.5,228.15,229.3,228,229.3,228.3,.8,-.2,16,365.30,122
,20160107,229.3,228.3,229.3,235.1,229.15,235.1,230.85,6.8,2.55,204,"4,709.58",130
,20160108,235.1,230.85,,,,234.5,234.5,3.65,3.65,0,0.00,130
,20160111,234.5,234.5,234,235.95,234,235.45,235.1,.95,.6,6,141.08,132
,20160112,235.45,235.1,234.05,234.05,232.05,233.25,233.25,-1.85,-1.85,14,326.60,126
,20160113,233.25,233.25,231.15,231.15,231.1,231.1,231.1,-2.15,-2.15,10,231.14,116
,20160114,231.1,231.1,230.2,233.6,229.55,233.1,231.6,2,.5,68,"1,575.13",142
,20160115,233.1,231.6,232.15,232.15,230.35,230.35,231.8,-1.25,.2,92,"2,132.56",92
,20160118,230.35,231.8,232.15,232.15,232,232,232.1,.2,.3,6,139.26,92
,20160119,232,232.1,231.75,232.35,231.5,231.85,231.95,-.25,-.15,24,556.69,92
,20160120,231.85,231.95,,,,231.95,231.95,0,0,0,0.00,92
,20160121,231.95,231.95,234.45,234.6,234.45,234.6,234.45,2.65,2.5,8,187.59,90
,20160122,234.6,234.45,234.3,234.3,233.5,234.2,234.05,-.25,-.4,8,187.24,90
,20160125,234.2,234.05,234.2,234.3,234.15,234.15,234.25,.1,.2,14,327.95,82
,20160126,234.15,234.25,,,,234.25,234.25,0,0,0,0.00,82
,20160127,234.25,234.25,236.7,238.85,236.7,238.5,238,4.25,3.75,6,142.81,80
,20160128,238.5,238,238.65,238.65,237.3,237.3,238.15,-.7,.15,12,285.78,76
,20160129,237.3,238.15,,,,238.15,238.15,0,0,0,0.00,76
,20160201,238.15,238.15,237,237,237,237,237,-1.15,-1.15,4,94.80,72
,20160202,237,237,,,,237,237,0,0,0,0.00,72
,20160203,237,237,,,,237,237,0,0,0,0.00,72
,20160204,237,237,,,,242.5,242.5,5.5,5.5,0,0.00,72
,20160205,242.5,242.5,243.85,244.85,243.85,244.55,244.65,2.05,2.15,16,391.50,72
,20160215,244.55,244.65,261.4,261.4,255.4,255.4,256.8,10.75,12.15,26,667.71,80
,20160216,255.4,256.8,253.2,253.2,250.7,251.4,251.9,-5.4,-4.9,38,957.33,62
,20160217,251.4,251.9,254.3,255.2,254.3,255.2,254.75,3.3,2.85,4,101.90,66
,20160218,255.2,254.75,253.85,254.3,253.85,254.15,254.1,-.6,-.65,6,152.46,66
,20160219,254.15,254.1,253.55,257.15,253.55,257.15,255.35,3.05,1.25,8,204.28,70
,20160222,257.15,255.35,,,,255.35,255.35,0,0,0,0.00,70
,20160223,255.35,255.35,253.45,255.6,253.15,255.4,254.85,.05,-.5,16,407.82,70
,20160224,255.4,254.85,256.4,257.9,255.6,257.9,256.45,3.05,1.6,28,718.06,66
,20160225,257.9,256.45,262.5,262.5,258.4,260.3,259.95,3.85,3.5,16,415.94,64
,20160226,260.3,259.95,261.2,261.2,260.05,260.05,260.6,.1,.65,4,104.25,64
,20160229,260.05,260.6,257.6,258.4,257.3,258,257.8,-2.6,-2.8,16,412.52,68
,20160301,258,257.8,259.7,262,258.6,261.75,261.3,3.95,3.5,44,"1,149.77",62
,20160302,261.75,261.3,262.55,262.65,258.7,258.7,260.9,-2.6,-.4,40,"1,043.78",66
,20160303,258.7,260.9,261.05,261.05,261.05,261.05,261.05,.15,.15,8,208.84,64
,20160304,261.05,261.05,261.8,264.55,261.75,264.5,263.85,3.45,2.8,28,738.85,70
,20160307,264.5,263.85,264,266.8,263.05,265,265.5,1.15,1.65,40,"1,062.03",70
,20160308,265,265.5,266.25,267,265.05,265.4,266.05,-.1,.55,48,"1,277.13",92
,20160309,265.4,266.05,267.1,267.1,262,263.5,264.45,-2.55,-1.6,30,793.36,94
,20160310,263.5,264.45,263.1,264.3,260.7,261.05,262.5,-3.4,-1.95,48,"1,260.12",106
,20160311,261.05,262.5,260.8,268,260.8,266.4,264.2,3.9,1.7,72,"1,902.57",84
,20160314,266.4,264.2,264.1,265.15,261.8,263.1,262.9,-1.1,-1.3,38,999.18,68
,20160315,263.1,262.9,257.6,258.25,257.5,257.55,257.7,-5.35,-5.2,64,"1,649.33",100
,20160316,257.55,257.7,258.35,258.9,258.2,258.7,258.45,1,.75,34,878.82,92
,20160317,258.7,258.45,258.45,263.4,257.7,263.3,258.75,4.85,.3,62,"1,604.25",44
,20160318,263.3,258.75,263.8,263.8,263.35,263.6,263.55,4.85,4.8,6,158.15,44
,20160321,263.6,263.55,261.85,261.85,259.4,259.4,260.6,-4.15,-2.95,4,104.25,42
,20160322,259.4,260.6,260.15,260.15,259.6,259.6,259.85,-1,-.75,4,103.95,42
,20160323,259.6,259.85,262.9,262.9,260.6,260.6,261.7,.75,1.85,14,366.38,44
,20160324,260.6,261.7,,,,255.85,255.85,-5.85,-5.85,0,0.00,44
,20160325,255.85,255.85,255.8,255.8,255.8,255.8,255.8,-.05,-.05,2,51.16,42
,20160328,255.8,255.8,257.95,257.95,254.3,254.45,254.6,-1.35,-1.2,34,865.80,16
,20160329,254.45,254.6,257.25,257.25,255.05,257.2,256.1,2.6,1.5,8,204.91,20
,20160330,257.2,256.1,256.7,263.5,255.15,263.5,258.6,7.4,2.5,10,258.64,18
,20160331,263.5,258.6,256.95,261.95,245.65,245.65,252.6,-12.95,-6,16,404.16,14
,20160401,245.65,252.6,245.65,245.65,245.65,245.65,245.65,-6.95,-6.95,2,49.13,12
,20160405,245.65,245.65,254.2,254.2,254.2,254.2,254.2,8.55,8.55,6,152.52,6
,20160406,254.2,254.2,,,,254.2,254.2,0,0,0,0.00,6
,20160407,254.2,254.2,248.2,248.2,248.2,248.2,248.2,-6,-6,6,148.92,6
,20160408,248.2,248.2,,,,248.2,248.2,0,0,0,0.00,6
,20160411,248.2,248.2,257,257,257,257,257,8.8,8.8,6,154.20,6
,20160412,257,257,,,,257,257,0,0,0,0.00,6
,20160413,257,257,,,,257,257,0,0,0,0.00,6
,20160414,257,257,,,,257,257,0,0,0,0.00,6
,20160415,257,257,256,256,256,256,256,-1,-1,6,153.60,12
au1605,20160216,256.8,256.8,254.35,254.6,249.95,254.2,252.3,-2.6,-4.5,48,"1,211.09",14
,20160217,254.2,252.3,253.85,255.45,252.1,253.75,253.85,1.45,1.55,38,964.65,16
,20160218,253.75,253.85,254.15,255.1,253.45,254.45,254.5,.6,.65,88,"2,239.72",14
,20160219,254.45,254.5,253.45,258.45,253.2,257.1,256.55,2.6,2.05,1028,"26,374.62",42
,20160222,257.1,256.55,257.75,257.75,254.95,255.7,256.65,-.85,.1,94,"2,412.93",44
,20160223,255.7,256.65,254.5,257.25,253.8,255.55,255.25,-1.1,-1.4,110,"2,807.94",48
,20160224,255.55,255.25,255.8,258.05,255.8,257.6,257.15,2.35,1.9,80,"2,057.48",34
,20160225,257.6,257.15,259.8,264,259.2,260.85,260.4,3.7,3.25,686,"17,865.31",82
,20160226,260.85,260.4,260.3,262.15,258.6,261.4,260.55,1,.15,222,"5,784.53",58
,20160229,261.4,260.55,260.85,260.85,256.35,259.05,258.8,-1.5,-1.75,178,"4,607.46",74
,20160301,259.05,258.8,259.8,262.8,258.95,262.4,261.3,3.6,2.5,70,"1,829.28",50
,20160302,262.4,261.3,268.3,268.3,258.35,259.55,261.4,-1.75,.1,170,"4,444.19",60
,20160303,259.55,261.4,261,262.15,259.25,261.4,260.3,0,-1.1,156,"4,061.22",74
,20160304,261.4,260.3,262.5,265.6,261.1,264.7,264.05,4.4,3.75,280,"7,394.17",96
,20160307,264.7,264.05,265.3,268.35,262.8,265.35,265.4,1.3,1.35,320,"8,493.09",94
,20160308,265.35,265.4,267,267,265.6,266.2,266.2,.8,.8,228,"6,070.15",74
,20160309,266.2,266.2,267.25,267.35,261.55,263.3,264.4,-2.9,-1.8,116,"3,067.36",64
,20160310,263.3,264.4,263.85,264.25,260.6,262,262.35,-2.4,-2.05,222,"5,824.49",56
,20160311,262,262.35,260.3,267.9,260.3,265.15,265.45,2.8,3.1,266,"7,061.69",166
,20160314,265.15,265.45,265.3,265.5,261.85,261.85,263.55,-3.6,-1.9,116,"3,057.31",168
,20160315,261.85,263.55,261.65,261.65,256.7,257.05,258.35,-6.5,-5.2,524,"13,538.57",88
,20160316,257.05,258.35,257.6,258.8,257.4,258.4,257.9,.05,-.45,110,"2,837.16",90
,20160317,258.4,257.9,258.7,269.65,257.25,263.1,259.9,5.2,2,102,"2,651.18",80
,20160318,263.1,259.9,262.65,263.95,262,262.5,263.35,2.6,3.45,44,"1,158.89",76
,20160321,262.5,263.35,260.9,261.9,259,259,259.95,-4.35,-3.4,72,"1,871.97",82
,20160322,259,259.95,258.95,261,258.95,260.75,260,.8,.05,154,"4,004.08",134
,20160323,260.75,260,261.3,261.8,257.1,257.95,260.05,-2.05,.05,62,"1,612.42",130
,20160324,257.95,260.05,255.1,255.65,254.6,255,255.25,-5.05,-4.8,136,"3,471.95",162
,20160325,255,255.25,255.2,256.1,255.2,256,255.85,.75,.6,48,"1,228.29",160
,20160328,256,255.85,255.4,257.35,254,255.1,255.85,-.75,0,308,"7,881.29",154
,20160329,255.1,255.85,255.5,256.3,255.1,255.75,255.3,-.1,-.55,102,"2,604.27",78
,20160330,255.75,255.3,255.75,259.5,255.75,258,258.05,2.7,2.75,58,"1,496.95",84
,20160331,258,258.05,257.65,257.65,255.3,255.85,256.05,-2.2,-2,36,921.83,72
,20160401,255.85,256.05,256.95,256.95,256.1,256.45,256.55,.4,.5,16,410.53,70
,20160405,256.45,256.55,255.7,255.85,255.7,255.85,255.8,-.7,-.75,6,153.48,68
,20160406,255.85,255.8,256.7,256.85,256.1,256.15,256.45,.35,.65,64,"1,641.31",76
,20160407,256.15,256.45,255.7,256.3,255.7,256,256.05,-.45,-.4,12,307.30,66
,20160408,256,256.05,258.3,259.65,257.85,258.2,258.4,2.15,2.35,12,310.11,64
,20160411,258.2,258.4,258.25,260.65,258.25,260.35,259.65,1.95,1.25,10,259.65,72
,20160412,260.35,259.65,260.35,262.25,259.25,261.8,261.05,2.15,1.4,74,"1,932.02",78
,20160413,261.8,261.05,260.55,261.6,259.8,260.3,260.95,-.75,-.1,94,"2,452.95",32
,20160414,260.3,260.95,260.15,260.15,259.6,259.6,259.85,-1.35,-1.1,4,103.95,32
,20160415,259.6,259.85,257.2,257.3,256.35,256.35,256.85,-3.5,-3,8,205.50,34
,20160418,256.35,256.85,257.15,257.65,257.15,257.35,257.35,.5,.5,6,154.43,30
,20160419,257.35,257.35,257.6,257.9,255.1,255.95,256.95,-1.4,-.4,56,"1,439.09",24
,20160420,255.95,256.95,262.8,262.8,260,260.05,261.4,3.1,4.45,60,"1,568.40",38
,20160421,260.05,261.4,261.35,263.5,259.95,263.5,261.55,2.1,.15,46,"1,203.34",26
,20160422,263.5,261.55,261.4,262.2,259.8,259.8,260.9,-1.75,-.65,8,208.75,28
,20160425,259.8,260.9,257.45,259.45,256.3,259.4,258.55,-1.5,-2.35,12,310.28,26
,20160426,259.4,258.55,258.35,265.4,258.35,259.7,261.1,1.15,2.55,100,"2,611.21",78
,20160427,259.7,261.1,259.95,261.9,259.15,260.7,260.8,-.4,-.3,60,"1,564.97",62
,20160428,260.7,260.8,261.3,262.9,258.2,260.8,260,0,-.8,62,"1,612.23",26
,20160429,260.8,260,263.55,263.55,260.9,263.05,262.3,3.05,2.3,22,577.16,6
,20160503,263.05,262.3,,,,262.3,262.3,0,0,0,0.00,6
,20160504,262.3,262.3,,,,262.3,262.3,0,0,0,0.00,6
,20160505,262.3,262.3,262.3,262.3,262.3,262.3,262.3,0,0,6,157.38,0
,20160506,262.3,262.3,,,,262.3,262.3,0,0,0,0.00,0
,20160509,262.3,262.3,,,,262.3,262.3,0,0,0,0.00,0
,20160510,262.3,262.3,,,,262.3,262.3,0,0,0,0.00,0
,20160511,262.3,262.3,,,,262.3,262.3,0,0,0,0.00,0
,20160512,262.3,262.3,,,,262.3,262.3,0,0,0,0.00,0
,20160513,262.3,262.3,,,,262.3,262.3,0,0,0,0.00,0
,20160516,262.3,262.3,,,,262.3,262.3,0,0,0,0.00,0
au1606,20160104,226.05,226.3,226.7,228.5,226.2,228.2,227.3,1.9,1,115918,"2,635,229.81",271686
,20160105,228.2,227.3,229.05,230.85,228.45,230.3,229.7,3,2.4,262396,"6,027,416.78",285116
,20160106,230.3,229.7,230.5,231.75,229.05,231.4,230.25,1.7,.55,269668,"6,210,049.35",298044
,20160107,231.4,230.25,233.05,237.4,231.65,236.6,234.35,6.35,4.1,475962,"11,154,572.01",315870
,20160108,236.6,234.35,236.7,238.15,235.95,236.8,237.05,2.45,2.7,378540,"8,974,274.81",306860
,20160111,236.8,237.05,236.8,238.3,235,237.45,236.7,.4,-.35,353852,"8,377,384.64",312682
,20160112,237.45,236.7,236.6,236.95,233.95,234.6,235.25,-2.1,-1.45,295580,"6,953,639.63",287788
,20160113,234.6,235.25,232.85,233.25,232.05,232.25,232.55,-3,-2.7,237332,"5,519,804.51",279594
,20160114,232.25,232.55,232,234.8,231.35,234.05,233.15,1.5,.6,316336,"7,376,052.87",279494
,20160115,234.05,233.15,233.05,233.8,231.2,232.6,232.65,-.55,-.5,263662,"6,134,744.55",275630
,20160118,232.6,232.65,232.8,234.75,232.75,233.5,233.8,.85,1.15,334226,"7,814,746.33",278082
,20160119,233.5,233.8,233.55,234,232.5,233.2,233.25,-.6,-.55,148870,"3,473,134.50",275074
,20160120,233.2,233.25,232.5,234.1,232.35,233.8,233.2,.55,-.05,178390,"4,160,689.49",278754
,20160121,233.8,233.2,235.8,237.25,235,236.25,235.8,3.05,2.6,299478,"7,062,232.89",282528
,20160122,236.25,235.8,235.5,235.85,234.35,235.2,235.1,-.6,-.7,239830,"5,638,528.29",273946
,20160125,235.2,235.1,235.1,236.15,234.55,235.8,235.35,.7,.25,199426,"4,693,830.75",270582
,20160126,235.8,235.35,236.25,239.05,236,238.9,237.35,3.55,2,248890,"5,908,372.31",289828
,20160127,238.9,237.35,238.3,240.1,237.8,239.35,239,2,1.65,238910,"5,710,168.36",290040
,20160128,239.35,239,239.4,240.1,238.65,238.8,239.25,-.2,.25,201368,"4,817,997.76",288210
,20160129,238.8,239.25,239.1,239.75,237.8,238.3,238.5,-.95,-.75,232398,"5,543,845.75",285544
,20160201,238.3,238.5,238.4,240.1,237.5,239.9,238.8,1.4,.3,199550,"4,766,196.62",296222
,20160202,239.9,238.8,240.25,241.35,239.4,240.55,240.6,1.75,1.8,184274,"4,434,549.85",303304
,20160203,240.55,240.6,240.55,241.85,240.2,241.45,241.15,.85,.55,197552,"4,764,851.47",305490
,20160204,241.45,241.15,242,244.2,240.8,243.95,242.55,2.8,1.4,268622,"6,516,765.11",295142
,20160205,243.95,242.55,244.6,246.25,244.4,245.9,245.6,3.35,3.05,225544,"5,539,725.38",280014
,20160215,245.9,245.6,258.5,259.9,255.6,256.15,257.25,10.55,11.65,190718,"4,906,580.40",276240
,20160216,256.15,257.25,254.8,255.3,251.5,253.1,253.3,-4.15,-3.95,309996,"7,853,607.24",283638
,20160217,253.1,253.3,255.4,255.85,252.15,255.05,254.65,1.75,1.35,397254,"10,117,433.42",288710
,20160218,255.05,254.65,255,255.75,253.8,254.85,254.9,.2,.25,310824,"7,922,991.18",289972
,20160219,254.85,254.9,254.5,259.5,254.3,258,256.8,3.1,1.9,369542,"9,489,909.55",302822
,20160222,258,256.8,258.95,259.6,255.9,256.2,258.15,-.6,1.35,468326,"12,090,172.09",303564
,20160223,256.2,258.15,254.35,257,254.35,256.3,255.55,-1.85,-2.6,374288,"9,565,386.19",300378
,20160224,256.3,255.55,256.95,259.25,256.6,258.45,257.95,2.9,2.4,449322,"11,592,486.47",312306
,20160225,258.45,257.95,260.25,264.6,259.4,261.5,262.2,3.55,4.25,797662,"20,916,001.47",330980
,20160226,261.5,262.2,261.3,262.5,259.15,261.85,261.2,-.35,-1,608646,"15,898,002.76",331884
,20160229,261.85,261.2,261.65,261.7,256.25,259.4,258.9,-1.8,-2.3,756284,"19,581,576.04",329216
,20160301,259.4,258.9,260.1,263.65,259,263.05,261.2,4.15,2.3,552970,"14,446,311.48",351736
,20160302,263.05,261.2,263,263.9,259.1,259.85,260.9,-1.35,-.3,637386,"16,631,845.55",329022
,20160303,259.85,260.9,260.5,262.55,259.7,262.05,261.4,1.15,.5,520756,"13,614,881.56",338906
,20160304,262.05,261.4,262.7,265.95,261.6,265.6,264.05,4.2,2.65,627072,"16,559,485.94",351182
,20160307,265.6,264.05,265.95,268.7,263.25,265.65,266.25,1.6,2.2,896440,"23,868,530.31",335068
,20160308,265.65,266.25,267.25,267.8,265.2,266.7,266.7,.45,.45,535820,"14,292,728.15",342884
,20160309,266.7,266.7,267.65,267.95,263,264.05,265.65,-2.65,-1.05,513264,"13,636,404.50",332420
,20160310,264.05,265.65,263.95,264.35,261.1,261.9,262.75,-3.75,-2.9,530230,"13,933,538.04",319344
,20160311,261.9,262.75,261,268.85,260.15,265.75,265.25,3,2.5,868980,"23,051,189.94",326228
,20160314,265.75,265.25,265.3,265.9,262.1,262.5,264,-2.75,-1.25,544586,"14,378,951.37",318588
,20160315,262.5,264,263,263.75,257.05,257.85,260.05,-6.15,-3.95,586332,"15,250,325.63",318154
,20160316,257.85,260.05,259.15,259.55,257.35,259.45,258.25,-.6,-1.8,402560,"10,397,884.20",319314
,20160317,259.45,258.25,258.75,264.35,257.65,263.3,260.6,5.05,2.35,500638,"13,047,844.02",316900
,20160318,263.3,260.6,263.8,264.85,262.55,263.35,263.7,2.75,3.1,403442,"10,639,219.95",308886
,20160321,263.35,263.7,261.1,262.5,259.15,259.7,261,-4,-2.7,340072,"8,877,286.36",303776
,20160322,259.7,261,259.6,261.45,259.25,261.4,260.35,.4,-.65,263124,"6,850,782.55",305662
,20160323,261.4,260.35,262.4,262.95,258.15,258.35,260.75,-2,.4,331106,"8,634,874.40",304448
,20160324,258.35,260.75,256.35,256.85,255,255.1,255.85,-5.65,-4.9,380646,"9,739,556.35",294312
,20160325,255.1,255.85,256.3,256.75,255.65,256.1,256.15,.25,.3,164146,"4,205,035.75",293992
,20160328,256.1,256.15,255.95,256.65,254,255.05,255.05,-1.1,-1.1,147416,"3,760,369.55",297086
,20160329,255.05,255.05,255.75,256.6,255.25,255.75,255.8,.7,.75,185942,"4,756,957.80",290892
,20160330,255.75,255.8,256.15,259.8,255.85,258.6,257.95,2.8,2.15,378770,"9,771,062.68",285732
,20160331,258.6,257.95,258,258.1,255.35,256.15,256.6,-1.8,-1.35,269920,"6,926,683.14",279210
,20160401,256.15,256.6,257.5,257.8,256.1,257.2,256.85,.6,.25,232786,"5,979,371.69",272338
,20160405,257.2,256.85,255.05,256.35,254.2,256.05,255.65,-.8,-1.2,95420,"2,439,885.69",270088
,20160406,256.05,255.65,257.5,257.7,256.1,256.75,256.85,1.1,1.2,194794,"5,003,601.20",273552
,20160407,256.75,256.85,255.2,257.1,255,256.45,256.05,-.4,-.8,227246,"5,819,479.85",279408
,20160408,256.45,256.05,258.4,259.35,257.65,258,258.4,1.95,2.35,257602,"6,657,093.09",283298
,20160411,258,258.4,257.7,261.15,257.4,260.55,259.3,2.15,.9,245542,"6,367,604.45",287684
,20160412,260.55,259.3,260.95,262,260.4,261.8,261.25,2.5,1.95,189268,"4,945,138.15",291346
,20160413,261.8,261.25,262.05,262.65,260,260.4,261.45,-.85,.2,268234,"7,013,208.34",282358
,20160414,260.4,261.45,260.5,261.05,257,257.8,259,-3.65,-2.45,273610,"7,086,644.04",278694
,20160415,257.8,259,257.6,258.25,256.05,257.2,257.1,-1.8,-1.9,236076,"6,070,294.03",265642
,20160418,257.2,257.1,257.15,258.7,256.2,257.35,257.55,.25,.45,217164,"5,593,115.67",259854
,20160419,257.35,257.55,258.55,260,256.55,259.85,257.95,2.3,.4,239320,"6,173,920.64",260238
,20160420,259.85,257.95,261,262.5,259.65,260.65,261.15,2.7,3.2,325448,"8,499,737.11",258636
,20160421,260.65,261.15,261,264.15,260,264,261.85,2.85,.7,350660,"9,183,069.40",274058
,20160422,264,261.85,265.7,266.5,260,260.6,262.15,-1.25,.3,401306,"10,520,380.78",242932
,20160425,260.6,262.15,260.7,261.3,256.95,258.65,259.2,-3.5,-2.95,372910,"9,667,565.30",221956
,20160426,258.65,259.2,258.75,260,258,258.1,259.2,-1.1,0,172382,"4,468,171.86",208928
,20160427,258.1,259.2,258.55,261.45,258.25,261.3,260.3,2.1,1.1,253034,"6,587,509.90",193114
,20160428,261.3,260.3,261.9,262.75,259.3,262.25,261.1,1.95,.8,342874,"8,953,471.89",177568
,20160429,262.25,261.1,262.15,267.95,261.75,266.45,265,5.35,3.9,347256,"9,202,931.79",177698
,20160503,266.45,265,269.5,271.65,269.1,271.5,270.25,6.5,5.25,152216,"4,114,077.71",161770
,20160504,271.5,270.25,270.7,271.25,268.05,268.4,269.25,-1.85,-1,186568,"5,023,942.61",144530
,20160505,268.4,269.25,269.25,270.25,267.15,268.05,268.7,-1.2,-.55,147672,"3,968,567.36",130162
,20160506,268.05,268.7,269.2,269.85,265.55,268.35,267.8,-.35,-.9,111378,"2,982,795.68",115478
,20160509,268.35,267.8,270.9,270.9,267.5,267.9,269.2,.1,1.4,113192,"3,047,264.00",99592
,20160510,267.9,269.2,266.9,266.95,264.25,265.75,265.4,-3.45,-3.8,69624,"1,848,011.05",84894
,20160511,265.75,265.4,264.95,267.65,263.65,267.2,265.7,1.8,.3,48084,"1,277,684.31",78748
,20160512,267.2,265.7,267.4,268,266,266.3,266.95,.6,1.25,40030,"1,068,674.25",72346
,20160513,266.3,266.95,266.25,268.8,265.55,267.75,266.9,.8,-.05,52394,"1,398,634.98",64812
,20160516,267.75,266.9,265.95,269.95,265.3,269.5,267.95,2.6,1.05,40430,"1,083,505.99",59054
,20160517,269.5,267.95,270.45,271,266.85,267.8,268.4,-.15,.45,36372,"976,371.43",51370
,20160518,267.8,268.4,267.1,269.2,267.1,267.75,268.3,-.65,-.1,23614,"633,578.37",49168
,20160519,267.75,268.3,268.65,268.9,263.7,263.9,266.2,-4.4,-2.1,37442,"996,732.45",41442
,20160520,263.9,266.2,262.5,264.65,261.85,264.05,263.2,-2.15,-3,19546,"514,475.05",38508
,20160523,264.05,263.2,264.55,265.2,262.8,263.25,263.75,.05,.55,21136,"557,560.36",34588
,20160524,263.25,263.75,262.75,263.65,261.8,261.8,262.7,-1.95,-1.05,21908,"575,553.80",30344
,20160525,261.8,262.7,260.2,261.8,257.9,257.95,259.7,-4.75,-3,23334,"606,029.70",26034
,20160526,257.95,259.7,257.2,259.85,256.6,259,258.05,-.7,-1.65,20132,"519,595.24",25022
,20160527,259,258.05,259.8,259.8,255.7,257.9,257.85,-.15,-.2,17426,"449,389.11",20988
,20160530,257.9,257.85,257.45,257.55,253.85,254.6,255.2,-3.25,-2.65,19648,"501,513.12",15170
,20160531,254.6,255.2,255.05,258,254.85,256.95,256.4,1.75,1.2,12386,"317,608.82",8936
,20160601,256.95,256.4,256.95,258.5,256.6,257.65,257.6,1.25,1.2,1796,"46,273.07",7824
,20160602,257.65,257.6,258,258,256.05,257.9,257.05,.3,-.55,1338,"34,393.95",7170
,20160603,257.9,257.05,257.1,257.65,256.7,257.5,257,.45,-.05,984,"25,291.71",6522
,20160606,257.5,257,262.05,262.75,261,262.55,262.35,5.55,5.35,1326,"34,792.65",6030
,20160607,262.55,262.35,263.75,263.95,262.7,262.7,263.4,.35,1.05,918,"24,181.68",5184
,20160608,262.7,263.4,261.95,265,261.95,264.9,263.9,1.5,.5,1296,"34,204.02",4320
,20160613,264.9,263.9,270.8,273.5,270,271.05,271.85,7.15,7.95,204,"5,546.58",4140
,20160614,271.05,271.85,271,273.5,271,271.2,272,-.65,.15,642,"17,464.14",3582
,20160615,271.2,272,,,,272,272,0,0,0,0.00,3582
au1607,20160418,257.1,257.1,,,,257.1,257.1,0,0,0,0.00,0
,20160419,257.1,257.1,,,,257.1,257.1,0,0,0,0.00,0
,20160420,257.1,257.1,262.5,263.2,260.3,260.3,262.1,3.2,5,18,471.80,2
,20160421,260.3,262.1,,,,262.1,262.1,0,0,0,0.00,2
,20160422,262.1,262.1,263.15,263.15,263.15,263.15,263.15,1.05,1.05,2,52.63,4
,20160425,263.15,263.15,,,,263.15,263.15,0,0,0,0.00,4
,20160426,263.15,263.15,,,,263.15,263.15,0,0,0,0.00,4
,20160427,263.15,263.15,,,,263.15,263.15,0,0,0,0.00,4
,20160428,263.15,263.15,,,,263.15,263.15,0,0,0,0.00,4
,20160429,263.15,263.15,268.05,268.25,268.05,268.25,268.1,5.1,4.95,28,750.78,20
,20160503,268.25,268.1,270.85,272.7,270.45,272.7,271.45,4.6,3.35,10,271.49,20
,20160504,272.7,271.45,,,,271.45,271.45,0,0,0,0.00,20
,20160505,271.45,271.45,,,,271.45,271.45,0,0,0,0.00,20
,20160506,271.45,271.45,269.95,269.95,267.95,267.95,268.95,-3.5,-2.5,8,215.16,20
,20160509,267.95,268.95,256,273.05,256,269.5,268.95,.55,0,18,484.14,20
,20160510,269.5,268.95,,,,268.95,268.95,0,0,0,0.00,20
,20160511,268.95,268.95,,,,268.95,268.95,0,0,0,0.00,20
,20160512,268.95,268.95,267.05,269.55,267.05,269.55,268.7,.6,-.25,6,161.23,20
,20160513,269.55,268.7,,,,268.65,268.65,-.05,-.05,0,0.00,20
,20160516,268.65,268.65,,,,268.65,268.65,0,0,0,0.00,20
,20160517,268.65,268.65,272.7,272.7,271.6,271.6,272.15,2.95,3.5,4,108.86,20
,20160518,271.6,272.15,271.7,271.7,271.7,271.7,271.7,-.45,-.45,2,54.34,20
,20160519,271.7,271.7,,,,269.55,269.55,-2.15,-2.15,0,0.00,20
,20160520,269.55,269.55,266.25,266.7,265.25,265.25,266.05,-4.3,-3.5,30,798.21,38
,20160523,265.25,266.05,265.5,265.5,264.3,264.3,264.85,-1.75,-1.2,18,476.80,22
,20160524,264.3,264.85,,,,263.8,263.8,-1.05,-1.05,0,0.00,22
,20160525,263.8,263.8,,,,260.8,260.8,-3,-3,0,0.00,22
,20160526,260.8,260.8,257.6,258.9,257.6,258.9,258.35,-1.9,-2.45,6,155.03,20
,20160527,258.9,258.35,,,,258.15,258.15,-.2,-.2,0,0.00,20
,20160530,258.15,258.15,253.8,255.2,253.8,255.2,254.5,-2.95,-3.65,4,101.80,20
,20160531,255.2,254.5,,,,254.5,254.5,0,0,0,0.00,20
,20160601,254.5,254.5,257.35,258.6,257.35,258.6,257.45,4.1,2.95,18,463.48,16
,20160602,258.6,257.45,,,,257.45,257.45,0,0,0,0.00,16
,20160603,257.45,257.45,,,,257.45,257.45,0,0,0,0.00,16
,20160606,257.45,257.45,263.55,263.55,260.3,262.8,262.05,5.35,4.6,24,629.03,18
,20160607,262.8,262.05,263.2,263.9,263.2,263.9,263.65,1.85,1.6,6,158.20,16
,20160608,263.9,263.65,,,,263.65,263.65,0,0,0,0.00,16
,20160613,263.65,263.65,269.65,272.85,269.65,272.85,270.95,9.2,7.3,50,"1,354.94",18
,20160614,272.85,270.95,273.95,274.1,272.6,273.6,273.45,2.65,2.5,18,492.27,26
,20160615,273.6,273.45,274.35,275.2,273.75,275.2,274.6,1.75,1.15,8,219.70,26
,20160616,275.2,274.6,274.9,277.9,274.9,277.9,276,3.3,1.4,18,496.85,24
,20160617,277.9,276,274.75,274.75,272.25,273.25,273.1,-2.75,-2.9,8,218.50,24
,20160620,273.25,273.1,275.45,275.45,275.45,275.45,275.45,2.35,2.35,2,55.09,22
,20160621,275.45,275.45,275.05,275.05,274.8,274.8,274.95,-.65,-.5,16,439.98,8
,20160622,274.8,274.95,265,272.55,265,271.3,268.9,-3.65,-6.05,10,268.90,8
,20160623,271.3,268.9,268.95,270.3,268.95,270.3,269.6,1.4,.7,4,107.85,6
,20160624,270.3,269.6,278.9,278.9,278.9,278.9,278.9,9.3,9.3,4,111.56,6
,20160627,278.9,278.9,281.95,281.95,278.7,278.7,280.3,-.2,1.4,8,224.26,6
,20160628,278.7,280.3,,,,280.3,280.3,0,0,0,0.00,6
,20160629,280.3,280.3,283.95,283.95,283.95,283.95,283.95,3.65,3.65,4,113.58,6
,20160630,283.95,283.95,286.75,286.75,281,281,283.1,-2.95,-.85,12,339.73,4
,20160701,281,283.1,281,281,281,281,281,-2.1,-2.1,4,112.40,0
,20160704,281,281,,,,281,281,0,0,0,0.00,0
,20160705,281,281,,,,281,281,0,0,0,0.00,0
,20160706,281,281,,,,281,281,0,0,0,0.00,0
,20160707,281,281,,,,281,281,0,0,0,0.00,0
,20160708,281,281,,,,281,281,0,0,0,0.00,0
,20160711,281,281,,,,281,281,0,0,0,0.00,0
,20160712,281,281,,,,281,281,0,0,0,0.00,0
,20160713,281,281,,,,281,281,0,0,0,0.00,0
,20160714,281,281,,,,281,281,0,0,0,0.00,0
,20160715,281,281,,,,281,281,0,0,0,0.00,0
au1608,20160104,227.75,227.55,,,,227.55,227.55,0,0,0,0.00,46
,20160105,227.55,227.55,231.6,231.6,231.6,231.6,231.6,4.05,4.05,4,92.64,50
,20160106,231.6,231.6,231.5,231.5,231.5,231.5,231.5,-.1,-.1,2,46.30,48
,20160107,231.5,231.5,233.2,237.7,233.2,237.7,235.8,6.2,4.3,16,377.34,54
,20160108,237.7,235.8,237.45,237.45,237.45,237.45,237.45,1.65,1.65,8,189.96,46
,20160111,237.45,237.45,238.6,238.9,237.75,238,238.3,.55,.85,18,428.96,52
,20160112,238,238.3,,,,238.3,238.3,0,0,0,0.00,52
,20160113,238.3,238.3,234.4,234.5,234.05,234.05,234.25,-4.25,-4.05,10,234.28,52
,20160114,234.05,234.25,,,,234.25,234.25,0,0,0,0.00,52
,20160115,234.25,234.25,234,234,233.4,233.4,233.55,-.85,-.7,8,186.84,54
,20160118,233.4,233.55,,,,233.55,233.55,0,0,0,0.00,54
,20160119,233.55,233.55,235.55,235.55,234.9,234.9,235.15,1.35,1.6,6,141.10,52
,20160120,234.9,235.15,235.6,235.7,235.6,235.7,235.65,.55,.5,10,235.68,62
,20160121,235.7,235.65,238.7,238.7,236.75,236.75,237.4,1.1,1.75,32,759.82,62
,20160122,236.75,237.4,236.9,236.9,236.9,236.9,236.9,-.5,-.5,2,47.38,62
,20160125,236.9,236.9,237,237.65,237,237.65,237.2,.75,.3,6,142.33,60
,20160126,237.65,237.2,,,,237.2,237.2,0,0,0,0.00,60
,20160127,237.2,237.2,241.5,241.5,241.5,241.5,241.5,4.3,4.3,2,48.30,62
,20160128,241.5,241.5,241.1,241.1,240.25,240.3,240.45,-1.2,-1.05,14,336.66,62
,20160129,240.3,240.45,240.95,240.95,239.2,240.15,240.35,-.3,-.1,14,336.54,58
,20160201,240.15,240.35,239.55,241.25,239.55,241.25,240.1,.9,-.25,6,144.07,54
,20160202,241.25,240.1,,,,240.1,240.1,0,0,0,0.00,54
,20160203,240.1,240.1,,,,240.1,240.1,0,0,0,0.00,54
,20160204,240.1,240.1,,,,240.1,240.1,0,0,0,0.00,54
,20160205,240.1,240.1,245.5,246.75,245.5,246.25,246.15,6.15,6.05,8,196.95,56
,20160215,246.25,246.15,259.85,259.85,249.55,256.55,257.5,10.4,11.35,28,721.05,48
,20160216,256.55,257.5,255.55,255.6,252.55,252.55,254.25,-4.95,-3.25,24,610.30,54
,20160217,252.55,254.25,256.65,256.7,255.35,255.35,256.3,1.1,2.05,8,205.07,60
,20160218,255.35,256.3,255.15,256.35,255.15,255.45,255.7,-.85,-.6,8,204.59,60
,20160219,255.45,255.7,257.5,259.35,257.5,258.75,258.6,3.05,2.9,24,620.70,62
,20160222,258.75,258.6,258.6,259.9,255.75,255.75,257.75,-2.85,-.85,16,412.44,60
,20160223,255.75,257.75,255.9,257.15,255.5,257.15,256.05,-.6,-1.7,18,460.93,62
,20160224,257.15,256.05,258.05,259.1,257.9,259.1,258.5,3.05,2.45,10,258.52,56
,20160225,259.1,258.5,263.5,266.4,253.45,262.35,260.85,3.85,2.35,126,"3,287.23",78
,20160226,262.35,260.85,262.1,262.35,261.95,262.3,262.1,1.45,1.25,18,471.83,76
,20160229,262.3,262.1,,,,262.1,262.1,0,0,0,0.00,76
,20160301,262.1,262.1,261.65,261.7,261.65,261.7,261.65,-.4,-.45,10,261.66,76
,20160302,261.7,261.65,264.1,264.1,259.85,260.4,260.55,-1.25,-1.1,22,573.25,72
,20160303,260.4,260.55,263.7,263.7,261.95,261.95,262.8,1.4,2.25,4,105.13,74
,20160304,261.95,262.8,262.85,265.75,262.85,265.75,263.65,2.95,.85,14,369.17,74
,20160307,265.75,263.65,264.2,268.4,264.2,266.1,267.1,2.45,3.45,26,694.56,84
,20160308,266.1,267.1,267.4,267.9,266.65,267,267.5,-.1,.4,70,"1,872.58",118
,20160309,267,267.5,267.4,267.4,264.05,264.65,264.9,-2.85,-2.6,22,582.78,112
,20160310,264.65,264.9,264.4,264.4,262.25,262.6,263.35,-2.3,-1.55,14,368.71,108
,20160311,262.6,263.35,265.85,269.2,265.85,267.75,267.35,4.4,4,10,267.36,102
,20160314,267.75,267.35,265.4,265.4,265.35,265.35,265.35,-2,-2,4,106.15,104
,20160315,265.35,265.35,258,258.6,258,258.6,258,-6.75,-7.35,64,"1,651.46",54
,20160316,258.6,258,,,,258,258,0,0,0,0.00,54
,20160317,258,258,263.1,263.6,263.1,263.6,263.35,5.6,5.35,6,158.03,52
,20160318,263.6,263.35,264.1,264.1,264.1,264.1,264.1,.75,.75,2,52.82,52
,20160321,264.1,264.1,262.2,262.4,260.35,260.55,261.3,-3.55,-2.8,30,783.93,54
,20160322,260.55,261.3,260.65,260.65,260.6,260.6,260.6,-.7,-.7,20,521.29,46
,20160323,260.6,260.6,262.35,263,259.55,259.55,261.65,-1.05,1.05,46,"1,203.73",60
,20160324,259.55,261.65,256.55,256.55,256.45,256.55,256.5,-5.1,-5.15,8,205.20,62
,20160325,256.55,256.5,257,257,256.7,256.7,256.9,.2,.4,6,154.14,64
,20160328,256.7,256.9,257.35,257.35,255.5,256.2,256,-.7,-.9,30,768.03,70
,20160329,256.2,256,,,,256,256,0,0,0,0.00,70
,20160330,256,256,258.05,259.35,258,259.35,258.65,3.35,2.65,16,413.84,58
,20160331,259.35,258.65,259.35,266.3,257.5,257.5,258.95,-1.15,.3,30,776.97,72
,20160401,257.5,258.95,258.1,258.4,257.7,257.7,258.1,-1.25,-.85,10,258.12,72
,20160405,257.7,258.1,256.05,256.8,256.05,256.8,256.65,-1.3,-1.45,14,359.34,64
,20160406,256.8,256.65,257.9,257.95,257.75,257.75,257.85,1.1,1.2,12,309.44,64
,20160407,257.75,257.85,256.85,257,256.85,257,256.9,-.85,-.95,8,205.52,62
,20160408,257,256.9,258.9,258.9,258.4,258.55,258.65,1.65,1.75,64,"1,655.59",88
,20160411,258.55,258.65,258.5,261.7,258.5,261.2,259.7,2.55,1.05,40,"1,038.82",82
,20160412,261.2,259.7,261.55,262.2,261.4,262.2,261.8,2.5,2.1,18,471.27,80
,20160413,262.2,261.8,262.8,262.8,261,261.35,261.55,-.45,-.25,54,"1,412.43",70
,20160414,261.35,261.55,260.95,261.2,258.65,258.7,259.8,-2.85,-1.75,16,415.74,68
,20160415,258.7,259.8,257.65,257.65,257.65,257.65,257.65,-2.15,-2.15,2,51.53,66
,20160418,257.65,257.65,259.15,259.3,258.9,258.9,259.1,1.25,1.45,6,155.47,64
,20160419,258.9,259.1,,,,259.1,259.1,0,0,0,0.00,64
,20160420,259.1,259.1,262.9,262.9,261.2,261.4,261.8,2.3,2.7,26,680.70,66
,20160421,261.4,261.8,261.35,264.9,261.25,264.4,263.05,2.6,1.25,56,"1,473.19",52
,20160422,264.4,263.05,266.5,266.9,260.55,260.55,262.75,-2.5,-.3,42,"1,103.70",62
,20160425,260.55,262.75,260.35,260.4,258.4,259.45,259.35,-3.3,-3.4,24,622.47,66
,20160426,259.45,259.35,259.5,260.2,259.45,259.45,259.7,.1,.35,14,363.60,68
,20160427,259.45,259.7,261.05,261.85,260.35,261.45,261.3,1.75,1.6,12,313.59,68
,20160428,261.45,261.3,261.85,263.25,260.85,263.25,262.35,1.95,1.05,16,419.83,74
,20160429,263.25,262.35,262.7,268.1,262.7,266.3,265.5,3.95,3.15,64,"1,699.42",94
,20160503,266.3,265.5,270.7,272.35,270.3,272.35,271.5,6.85,6,84,"2,280.65",138
,20160504,272.35,271.5,271.8,271.8,268.9,269.2,270.1,-2.3,-1.4,32,864.41,132
,20160505,269.2,270.1,270.55,270.7,269,270,269.7,-.1,-.4,24,647.28,146
,20160506,270,269.7,269.8,269.85,266.6,268.45,268.7,-1.25,-1,80,"2,149.85",128
,20160509,268.45,268.7,270.65,271.9,268.55,268.55,269.65,-.15,.95,66,"1,779.86",130
,20160510,268.55,269.65,266.95,266.95,265.95,266.15,266.3,-3.5,-3.35,50,"1,331.60",118
,20160511,266.15,266.3,266.15,266.9,264.95,266.9,265.65,.6,-.65,16,425.09,112
,20160512,266.9,265.65,268.35,268.35,267.4,267.4,267.85,1.75,2.2,8,214.29,108
,20160513,267.4,267.85,267.7,268.5,267.7,267.7,267.9,-.15,.05,8,214.32,104
,20160516,267.7,267.9,266.9,270.2,266.9,269.95,268.85,2.05,.95,136,"3,656.89",126
,20160517,269.95,268.85,271.65,271.65,268.95,269.3,269.85,.45,1,52,"1,403.38",120
,20160518,269.3,269.85,269.3,269.3,268.95,268.95,269.15,-.9,-.7,6,161.51,122
,20160519,268.95,269.15,267.55,267.55,265.1,265.1,266.3,-4.05,-2.85,4,106.53,120
,20160520,265.1,266.3,263.1,265.6,262.9,264.65,263.75,-1.65,-2.55,46,"1,213.44",102
,20160523,264.65,263.75,265.55,265.55,263.75,263.75,264.65,0,.9,30,794.07,96
,20160524,263.75,264.65,263,263.6,263,263.6,263.2,-1.05,-1.45,6,157.92,92
,20160525,263.6,263.2,261.15,261.2,259.05,259.05,260.05,-4.15,-3.15,32,832.26,82
,20160526,259.05,260.05,259.6,259.6,259.15,259.45,259.4,-.6,-.65,8,207.54,80
,20160527,259.45,259.4,260.4,260.4,254.1,258.5,258.85,-.9,-.55,14,362.43,72
,20160530,258.5,258.85,257.55,257.65,254.45,255.55,255.4,-3.3,-3.45,36,919.50,76
,20160531,255.55,255.4,257.2,257.4,257.2,257.4,257.3,2,1.9,4,102.92,74
,20160601,257.4,257.3,257.8,260.4,257.8,258.55,259.2,1.25,1.9,28,725.80,72
,20160602,258.55,259.2,258.1,258.1,256.5,257.65,257.4,-1.55,-1.8,16,411.88,68
,20160603,257.65,257.4,257.65,257.9,257.4,257.9,257.8,.5,.4,16,412.49,78
,20160606,257.9,257.8,262.85,263.8,262.65,263.8,263.1,6,5.3,16,421.03,86
,20160607,263.8,263.1,263.9,264.5,263.75,263.75,264.1,.65,1,20,528.23,82
,20160608,263.75,264.1,263.55,265.5,263.55,265.35,265.3,1.25,1.2,78,"2,069.43",108
,20160613,265.35,265.3,270.9,273.45,270.8,272.95,271.65,7.65,6.35,38,"1,032.35",110
,20160614,272.95,271.65,272.9,273.15,272.2,272.35,272.85,.7,1.2,90,"2,455.87",80
,20160615,272.35,272.85,273.6,274,273.6,274,273.7,1.15,.85,6,164.24,82
,20160616,274,273.7,273.95,280.3,273.75,280.3,276.85,6.6,3.15,52,"1,439.75",78
,20160617,280.3,276.85,278.85,279.35,271.8,272.55,274.65,-4.3,-2.2,32,878.89,68
,20160620,272.55,274.65,274.15,274.15,272.45,272.6,272.55,-2.05,-2.1,398,"10,847.84",138
,20160621,272.6,272.55,273,273.85,272.15,272.15,273.3,-.4,.75,30,819.97,124
,20160622,272.15,273.3,270.2,270.85,268.85,269.35,269.9,-3.95,-3.4,48,"1,295.69",118
,20160623,269.35,269.9,268.35,269.95,268.35,269.35,269.05,-.55,-.85,36,968.68,108
,20160624,269.35,269.05,267.9,282.5,267.9,280.5,279.6,11.45,10.55,128,"3,579.49",156
,20160627,280.5,279.6,283.4,284.6,279.95,283.7,283.35,4.1,3.75,128,"3,627.43",178
,20160628,283.7,283.35,285,285.95,282.5,282.95,283.55,-.4,.2,74,"2,098.50",132
,20160629,282.95,283.55,281.8,284.05,281.35,283.6,282.6,.05,-.95,68,"1,921.88",152
,20160630,283.6,282.6,283.25,283.8,282.35,282.35,282.7,-.25,.1,28,791.66,162
,20160701,282.35,282.7,283.1,286.75,282.8,286.5,285.05,3.8,2.35,110,"3,135.81",94
,20160704,286.5,285.05,287.1,291.75,285.6,291,290.2,5.95,5.15,32,928.67,78
,20160705,291,290.2,291.45,291.7,288.85,289.8,290.95,-.4,.75,36,"1,047.59",66
,20160706,289.8,290.95,290.15,295.95,289.35,295.95,290.7,5,-.25,322,"9,360.77",170
,20160707,295.95,290.7,295.65,297,294.1,294.1,295.3,3.4,4.6,26,767.83,166
,20160708,294.1,295.3,292.75,293.55,291.2,293.55,292.15,-1.75,-3.15,150,"4,382.46",82
,20160711,293.55,292.15,290.95,294.55,290.65,293.45,292.55,1.3,.4,730,"21,356.43",144
,20160712,293.45,292.55,291.75,293.25,291.2,292.8,292.4,.25,-.15,134,"3,918.62",132
,20160713,292.8,292.4,290.75,290.75,286.7,289.15,289.95,-3.25,-2.45,246,"7,133.32",108
,20160714,289.15,289.95,290.45,290.55,288.05,288.05,289.9,-1.9,-.05,22,637.82,118
,20160715,288.05,289.9,285.3,288.2,285.3,286.95,286.65,-2.95,-3.25,30,859.99,116
,20160718,286.95,286.65,287.5,288.3,286.5,287.95,287.35,1.3,.7,76,"2,184.02",78
,20160719,287.95,287.35,287.85,287.85,287.3,287.75,287.5,.4,.15,18,517.56,62
,20160720,287.75,287.5,288.45,288.45,287.6,287.6,287.85,.1,.35,8,230.29,58
,20160721,287.6,287.85,284.75,284.75,283.15,283.6,283.6,-4.25,-4.25,16,453.81,54
,20160722,283.6,283.6,,,,283.6,283.6,0,0,0,0.00,54
,20160725,283.6,283.6,282.65,282.65,282.65,282.65,282.65,-.95,-.95,2,56.53,54
,20160726,282.65,282.65,284.25,284.4,284.25,284.4,284.3,1.75,1.65,24,682.42,44
,20160727,284.4,284.3,283.8,283.8,283.75,283.75,283.75,-.55,-.55,16,454.07,28
,20160728,283.75,283.75,285.5,287,284.35,287,285.05,3.25,1.3,28,798.15,4
,20160729,287,285.05,289.45,291.8,281.15,281.15,286,-3.9,.95,12,343.24,0
,20160801,281.15,286,,,,286,286,0,0,0,0.00,0
,20160802,286,286,,,,286,286,0,0,0,0.00,0
,20160803,286,286,,,,286,286,0,0,0,0.00,0
,20160804,286,286,,,,286,286,0,0,0,0.00,0
,20160805,286,286,,,,286,286,0,0,0,0.00,0
,20160808,286,286,281.2,281.2,281.2,281.2,281.2,-4.8,-4.8,12,337.44,12
,20160809,281.2,281.2,,,,282,282,.8,.8,0,0.00,12
,20160810,282,282,295.2,295.2,295.2,295.2,295.2,13.2,13.2,6,177.12,6
,20160811,295.2,295.2,305,305,290,290,297.5,-5.2,2.3,12,357.00,6
,20160812,290,297.5,,,,297.5,297.5,0,0,0,0.00,6
,20160815,297.5,297.5,,,,297.5,297.5,0,0,0,0.00,6
au1609,20160616,273.7,273.7,,,,273.7,273.7,0,0,0,0.00,0
,20160617,273.7,273.7,273.7,273.7,271.95,271.95,272.8,-1.75,-.9,20,545.65,2
,20160620,271.95,272.8,275.5,275.5,272.45,272.45,274.15,-.35,1.35,172,"4,715.68",28
,20160621,272.45,274.15,273.75,274.3,260.4,260.4,269.55,-13.75,-4.6,20,539.11,32
,20160622,260.4,269.55,270.3,271.35,267.75,268.3,269.5,-1.25,-.05,18,485.15,22
,20160623,268.3,269.5,269.5,269.65,268.15,269.65,268.85,.15,-.65,14,376.45,20
,20160624,269.65,268.85,268.9,282.25,267.9,280.3,278.55,11.45,9.7,158,"4,401.22",78
,20160627,280.3,278.55,283.05,285.1,278.9,283.7,282.9,5.15,4.35,50,"1,414.59",76
,20160628,283.7,282.9,284.75,284.85,281.95,281.95,283.75,-.95,.85,54,"1,532.27",72
,20160629,281.95,283.75,281.3,285.1,281.3,284.95,282.75,1.2,-1,46,"1,300.84",70
,20160630,284.95,282.75,285.15,285.15,282.1,282.15,283.05,-.6,.3,56,"1,585.16",78
,20160701,282.15,283.05,286,287.55,286,287.55,286.05,4.5,3,62,"1,773.51",60
,20160704,287.55,286.05,287.55,292.1,286.6,291.15,289.45,5.1,3.4,82,"2,373.63",60
,20160705,291.15,289.45,292.1,292.1,287.1,289.75,291.15,.3,1.7,116,"3,377.61",64
,20160706,289.75,291.15,289.85,296.85,288.55,295.9,293.05,4.75,1.9,38,"1,113.64",54
,20160707,295.9,293.05,294,296.8,294,294.65,295.05,1.6,2,38,"1,121.20",52
,20160708,294.65,295.05,292.5,293.55,290.2,291.85,291.75,-3.2,-3.3,88,"2,567.56",52
,20160711,291.85,291.75,291.7,296.55,289.6,294.65,293.4,2.9,1.65,184,"5,398.68",120
,20160712,294.65,293.4,293.05,293.85,291.25,292.5,292.4,-.9,-1,50,"1,462.23",100
,20160713,292.5,292.4,292.2,292.2,286.85,290.1,288.65,-2.3,-3.75,144,"4,157.09",106
,20160714,290.1,288.65,289.5,291.2,287.05,288.05,289.1,-.6,.45,76,"2,197.53",98
,20160715,288.05,289.1,288.05,288.05,284.1,287.6,285.8,-1.5,-3.3,68,"1,943.69",86
,20160718,287.6,285.8,286.65,287.4,286,287.4,286.65,1.6,.85,24,688.02,82
,20160719,287.4,286.65,287.95,288.5,287.35,287.35,287.85,.7,1.2,40,"1,151.54",82
,20160720,287.35,287.85,289.5,289.5,286.9,287.55,287.85,-.3,0,12,345.42,84
,20160721,287.55,287.85,283.6,284.45,282.2,283.25,283.2,-4.6,-4.65,60,"1,699.28",92
,20160722,283.25,283.2,284.2,286.1,282.95,284.55,284.7,1.35,1.5,20,569.47,90
,20160725,284.55,284.7,284.4,284.4,282.5,283.6,283.4,-1.1,-1.3,22,623.54,92
,20160726,283.6,283.4,282.5,284.95,282.5,284.3,284.35,.9,.95,28,796.24,80
,20160727,284.3,284.35,284.35,284.35,282.75,284.35,283.7,0,-.65,18,510.73,74
,20160728,284.35,283.7,285.1,288.2,284.95,288.2,286.85,4.5,3.15,76,"2,180.42",48
,20160729,288.2,286.85,,,,286.85,286.85,0,0,0,0.00,48
,20160801,286.85,286.85,289.4,289.4,288.05,288.05,288.4,1.2,1.55,10,288.40,50
,20160802,288.05,288.4,289.95,289.95,289.1,289.1,289.7,.7,1.3,8,231.79,48
,20160803,289.1,289.7,,,,289.7,289.7,0,0,0,0.00,48
,20160804,289.7,289.7,289.6,290.9,289.6,290.05,290.45,.35,.75,26,755.23,54
,20160805,290.05,290.45,291.95,292.2,291.95,292.1,292.05,1.65,1.6,16,467.33,38
,20160808,292.1,292.05,288.05,288.05,286.6,286.6,287.25,-5.45,-4.8,6,172.35,40
,20160809,286.6,287.25,287.35,287.35,285.75,286.25,286.35,-1,-.9,30,859.11,32
,20160810,286.25,286.35,288.65,289.4,286.85,288.1,288.25,1.75,1.9,8,230.60,32
,20160811,288.1,288.25,287.9,287.9,287.6,287.6,287.7,-.65,-.55,6,172.64,26
,20160812,287.6,287.7,288.1,288.35,286.85,287.3,287.5,-.4,-.2,24,690.03,24
,20160815,287.3,287.5,288.95,289.75,286.1,288.4,288.85,.9,1.35,60,"1,733.16",28
,20160816,288.4,288.85,286.9,286.9,286.9,286.9,286.9,-1.95,-1.95,2,57.38,28
,20160817,286.9,286.9,286.9,288.85,286.9,287.85,287.7,.95,.8,10,287.70,28
,20160818,287.85,287.7,287.05,287.05,287.05,287.05,287.05,-.65,-.65,2,57.41,28
,20160819,287.05,287.05,,,,287.05,287.05,0,0,0,0.00,28
,20160822,287.05,287.05,,,,287.05,287.05,0,0,0,0.00,28
,20160823,287.05,287.05,286.8,287.1,286.8,286.8,286.85,-.25,-.2,14,401.60,16
,20160824,286.8,286.85,281.85,289.05,280.95,286.95,285.65,.1,-1.2,56,"1,599.66",10
,20160825,286.95,285.65,,,,285.65,285.65,0,0,0,0.00,10
,20160826,285.65,285.65,285.6,285.6,284.8,285.55,285.15,-.1,-.5,8,228.15,6
,20160829,285.55,285.15,285.15,285.15,285.15,285.15,285.15,0,0,2,57.03,6
,20160830,285.15,285.15,279.1,290.5,279.1,284.65,283.8,-.5,-1.35,12,340.56,0
,20160831,284.65,283.8,,,,283.8,283.8,0,0,0,0.00,0
,20160901,283.8,283.8,,,,283.8,283.8,0,0,0,0.00,0
,20160902,283.8,283.8,,,,283.8,283.8,0,0,0,0.00,0
,20160905,283.8,283.8,,,,283.8,283.8,0,0,0,0.00,0
,20160906,283.8,283.8,,,,283.8,283.8,0,0,0,0.00,0
,20160907,283.8,283.8,296.3,296.3,288.7,292,293.3,8.2,9.5,24,703.98,0
,20160908,292,293.3,,,,293.3,293.3,0,0,0,0.00,0
,20160909,293.3,293.3,,,,293.3,293.3,0,0,0,0.00,0
,20160912,293.3,293.3,,,,293.3,293.3,0,0,0,0.00,0
,20160913,293.3,293.3,,,,293.3,293.3,0,0,0,0.00,0
,20160914,293.3,293.3,,,,293.3,293.3,0,0,0,0.00,0
,20160919,293.3,293.3,,,,293.3,293.3,0,0,0,0.00,0
au1610,20160104,228.8,228.8,227.75,229.9,227.75,229.9,228.15,1.1,-.65,10,228.18,66
,20160105,229.9,228.15,,,,229.35,229.35,1.2,1.2,0,0.00,66
,20160106,229.35,229.35,231.5,232.75,231,232.75,231.8,3.4,2.45,10,231.81,64
,20160107,232.75,231.8,234.7,238.55,234.7,238.55,235.95,6.75,4.15,6,141.59,62
,20160108,238.55,235.95,239,239,237.4,237.4,237.65,1.45,1.7,12,285.22,58
,20160111,237.4,237.65,236.9,239.15,236.9,239.15,238,1.5,.35,4,95.21,62
,20160112,239.15,238,,,,236,236,-2,-2,0,0.00,62
,20160113,236,236,,,,236,236,0,0,0,0.00,62
,20160114,236,236,235.35,235.35,235.35,235.35,235.35,-.65,-.65,2,47.07,62
,20160115,235.35,235.35,,,,235.35,235.35,0,0,0,0.00,62
,20160118,235.35,235.35,,,,235.35,235.35,0,0,0,0.00,62
,20160119,235.35,235.35,234.6,235.3,234.6,235.3,234.8,-.05,-.55,6,140.90,60
,20160120,235.3,234.8,,,,234.8,234.8,0,0,0,0.00,60
,20160121,234.8,234.8,,,,234.8,234.8,0,0,0,0.00,60
,20160122,234.8,234.8,236.95,236.95,236.35,236.35,236.6,1.55,1.8,10,236.62,58
,20160125,236.35,236.6,,,,236.6,236.6,0,0,0,0.00,58
,20160126,236.6,236.6,238.45,240.3,238.45,240.3,239.85,3.7,3.25,38,911.54,72
,20160127,240.3,239.85,241.3,241.3,241.3,241.3,241.3,1.45,1.45,2,48.26,70
,20160128,241.3,241.3,,,,241.3,241.3,0,0,0,0.00,70
,20160129,241.3,241.3,,,,241.3,241.3,0,0,0,0.00,70
,20160201,241.3,241.3,,,,241.3,241.3,0,0,0,0.00,70
,20160202,241.3,241.3,,,,241.3,241.3,0,0,0,0.00,70
,20160203,241.3,241.3,,,,241.3,241.3,0,0,0,0.00,70
,20160204,241.3,241.3,,,,241.3,241.3,0,0,0,0.00,70
,20160205,241.3,241.3,247.45,247.45,247.2,247.2,247.25,5.9,5.95,6,148.37,68
,20160215,247.2,247.25,258.7,258.7,258.7,258.7,258.7,11.45,11.45,2,51.74,68
,20160216,258.7,258.7,255.35,256.25,253.25,253.85,254.35,-4.85,-4.35,46,"1,170.02",76
,20160217,253.85,254.35,255.8,255.8,255.8,255.8,255.8,1.45,1.45,2,51.16,78
,20160218,255.8,255.8,255.6,256.15,255.6,256.15,255.85,.35,.05,4,102.35,80
,20160219,256.15,255.85,259.85,259.85,258.8,259.15,259.4,3.3,3.55,28,726.41,74
,20160222,259.15,259.4,260.65,260.65,258,258,259.3,-1.4,-.1,4,103.73,74
,20160223,258,259.3,258,258,256.05,256.05,256.75,-3.25,-2.55,6,154.06,74
,20160224,256.05,256.75,259.9,259.9,259.45,259.45,259.65,2.7,2.9,4,103.87,76
,20160225,259.45,259.65,261.8,264.5,261.2,261.75,262.75,2.1,3.1,36,945.91,92
,20160226,261.75,262.75,262.7,262.95,262.65,262.95,262.7,.2,-.05,10,262.74,84
,20160229,262.95,262.7,260.15,260.7,256.65,260.7,259.85,-2,-2.85,42,"1,091.54",88
,20160301,260.7,259.85,260.3,264.25,260.3,263.8,263.25,3.95,3.4,18,473.87,94
,20160302,263.8,263.25,263.9,263.9,263.9,263.9,263.9,.65,.65,4,105.56,90
,20160303,263.9,263.9,,,,263.9,263.9,0,0,0,0.00,90
,20160304,263.9,263.9,263.8,266.3,263.8,266.3,265.8,2.4,1.9,28,744.32,88
,20160307,266.3,265.8,266.3,269.2,265.95,265.95,267.55,.15,1.75,16,428.08,86
,20160308,265.95,267.55,268.05,268.2,267.3,267.3,267.65,-.25,.1,10,267.65,84
,20160309,267.3,267.65,268.4,268.4,264.2,264.25,265.9,-3.4,-1.75,26,691.35,84
,20160310,264.25,265.9,,,,265.9,265.9,0,0,0,0.00,84
,20160311,265.9,265.9,267.8,268.95,267.8,268.95,268.35,3.05,2.45,4,107.35,84
,20160314,268.95,268.35,,,,268.35,268.35,0,0,0,0.00,84
,20160315,268.35,268.35,263.2,263.2,258.7,259.7,259.85,-8.65,-8.5,30,779.58,84
,20160316,259.7,259.85,259.1,260.65,259.1,260.65,259.85,.8,0,16,415.79,84
,20160317,260.65,259.85,,,,259.85,259.85,0,0,0,0.00,84
,20160318,259.85,259.85,265.05,265.05,264.05,264.2,264.45,4.35,4.6,26,687.67,78
,20160321,264.2,264.45,262.2,262.5,260.45,260.45,261.95,-4,-2.5,14,366.77,84
,20160322,260.45,261.95,261.1,261.7,261.1,261.7,261.4,-.25,-.55,4,104.56,82
,20160323,261.7,261.4,263.05,263.05,262.15,262.15,262.6,.75,1.2,4,105.04,80
,20160324,262.15,262.6,256.5,257.8,256.3,257.8,256.9,-4.8,-5.7,26,667.99,80
,20160325,257.8,256.9,256.9,256.9,256.9,256.9,256.9,0,0,2,51.38,80
,20160328,256.9,256.9,255.5,256.2,255,256.2,255.55,-.7,-1.35,10,255.58,78
,20160329,256.2,255.55,256.6,256.6,256.6,256.6,256.6,1.05,1.05,4,102.64,76
,20160330,256.6,256.6,258.25,258.25,258.25,258.25,258.25,1.65,1.65,2,51.65,74
,20160331,258.25,258.25,258.35,258.35,258.35,258.35,258.35,.1,.1,2,51.67,72
,20160401,258.35,258.35,,,,258.35,258.35,0,0,0,0.00,72
,20160405,258.35,258.35,256.15,256.15,255.6,255.8,255.85,-2.55,-2.5,20,511.71,82
,20160406,255.8,255.85,,,,255.85,255.85,0,0,0,0.00,82
,20160407,255.85,255.85,257.8,257.8,257.4,257.4,257.7,1.55,1.85,24,618.54,98
,20160408,257.4,257.7,,,,257.7,257.7,0,0,0,0.00,98
,20160411,257.7,257.7,261.5,261.5,261.15,261.35,261.3,3.65,3.6,6,156.80,96
,20160412,261.35,261.3,261.6,263.15,261.6,263.15,262.25,1.85,.95,18,472.09,92
,20160413,263.15,262.25,262.85,262.85,262.85,262.85,262.85,.6,.6,2,52.57,92
,20160414,262.85,262.85,258.85,258.85,258.8,258.8,258.8,-4.05,-4.05,4,103.53,92
,20160415,258.8,258.8,258.7,258.7,258.55,258.55,258.6,-.25,-.2,8,206.90,88
,20160418,258.55,258.6,,,,258.6,258.6,0,0,0,0.00,88
,20160419,258.6,258.6,259.35,259.35,259.35,259.35,259.35,.75,.75,4,103.74,88
,20160420,259.35,259.35,262,263.35,262,262,262.25,2.65,2.9,16,419.66,90
,20160421,262,262.25,263,265.5,261.9,265.5,263.85,3.25,1.6,66,"1,741.41",76
,20160422,265.5,263.85,267.15,267.2,261.65,262.15,264.25,-1.7,.4,34,898.51,76
,20160425,262.15,264.25,259.5,259.55,259.5,259.55,259.5,-4.7,-4.75,8,207.62,74
,20160426,259.55,259.5,260.45,260.45,260.45,260.45,260.45,.95,.95,2,52.09,72
,20160427,260.45,260.45,260.25,262.8,260.25,262.8,261.8,2.35,1.35,24,628.42,68
,20160428,262.8,261.8,262.55,263.9,261.05,263.65,261.9,1.85,.1,52,"1,362.11",54
,20160429,263.65,261.9,263.85,269.8,263.85,267.65,266.3,5.75,4.4,56,"1,491.39",64
,20160503,267.65,266.3,272.5,272.5,270.1,270.8,271.15,4.5,4.85,26,705.10,68
,20160504,270.8,271.15,272.4,272.4,269.2,269.9,270.5,-1.25,-.65,32,865.60,62
,20160505,269.9,270.5,271.2,271.2,269.45,269.75,269.95,-.75,-.55,16,431.98,64
,20160506,269.75,269.95,270.95,270.95,268.3,269.25,269.55,-.7,-.4,36,970.53,62
,20160509,269.25,269.55,270.15,271.55,269.9,269.9,270.55,.35,1,18,487.06,62
,20160510,269.9,270.55,266.7,267.15,265.75,267.15,266.5,-3.4,-4.05,16,426.47,64
,20160511,267.15,266.5,265.1,268.9,265.1,268.45,267.85,1.95,1.35,26,696.44,68
,20160512,268.45,267.85,268.75,268.75,267.4,267.9,267.7,.05,-.15,32,856.79,64
,20160513,267.9,267.7,268.95,269.45,266.95,268.65,268.65,.95,.95,26,698.60,54
,20160516,268.65,268.65,267.55,270.35,267.55,270.35,269.4,1.7,.75,8,215.55,52
,20160517,270.35,269.4,270.35,271.9,268.7,269.45,270.75,.05,1.35,276,"7,473.31",90
,20160518,269.45,270.75,269.65,270.4,269.25,269.25,269.85,-1.5,-.9,10,269.87,88
,20160519,269.25,269.85,268.35,269.65,266.1,266.1,268,-3.75,-1.85,24,643.31,78
,20160520,266.1,268,263.5,265.6,263.15,265.15,264.05,-2.85,-3.95,34,897.89,72
,20160523,265.15,264.05,265.15,265.6,263.75,263.75,264.95,-.3,.9,20,529.91,78
,20160524,263.75,264.95,263.8,264.05,263,263.25,263.6,-1.7,-1.35,46,"1,212.64",76
,20160525,263.25,263.6,260.55,260.65,259.45,260.1,260.25,-3.5,-3.35,10,260.25,72
,20160526,260.1,260.25,258,259.65,258,259.65,258.8,-.6,-1.45,4,103.53,68
,20160527,259.65,258.8,257.8,259.05,256.5,258.85,258.05,.05,-.75,8,206.44,72
,20160530,258.85,258.05,258,258,254.55,254.8,256.35,-3.25,-1.7,16,410.18,78
,20160531,254.8,256.35,258.2,258.2,258.2,258.2,258.2,1.85,1.85,6,154.92,76
,20160601,258.2,258.2,259.65,259.65,259.3,259.3,259.4,1.1,1.2,6,155.66,76
,20160602,259.3,259.4,,,,259.4,259.4,0,0,0,0.00,76
,20160603,259.4,259.4,257.55,258.3,257.55,257.75,257.75,-1.65,-1.65,16,412.43,80
,20160606,257.75,257.75,263,263.25,262.75,263.25,263,5.5,5.25,6,157.80,78
,20160607,263.25,263,,,,263,263,0,0,0,0.00,78
,20160608,263,263,264.4,265.5,264.4,265.45,265.1,2.45,2.1,12,318.12,72
,20160613,265.45,265.1,271,273.5,271,273.5,272.25,8.4,7.15,4,108.90,70
,20160614,273.5,272.25,272.9,273.55,271.85,271.85,272.75,-.4,.5,20,545.50,62
,20160615,271.85,272.75,274.45,274.45,273.45,273.9,273.9,1.15,1.15,16,438.28,62
,20160616,273.9,273.9,274.05,279.85,274.05,278.85,278.4,4.95,4.5,88,"2,450.09",64
,20160617,278.85,278.4,279.15,279.7,271.55,272.2,275.05,-6.2,-3.35,48,"1,320.28",78
,20160620,272.2,275.05,274,274.95,272.9,273.05,274.05,-2,-1,48,"1,315.57",80
,20160621,273.05,274.05,272,273.6,271.65,273.15,272.5,-.9,-1.55,10,272.50,80
,20160622,273.15,272.5,270.45,270.45,268.4,268.75,268.9,-3.75,-3.6,46,"1,237.14",80
,20160623,268.75,268.9,269.25,269.7,268.5,269.7,268.9,.8,0,680,"18,286.71",120
,20160624,269.7,268.9,268.45,282.3,268,280.65,279.5,11.75,10.6,222,"6,205.12",112
,20160627,280.65,279.5,282.9,284.15,279.65,284.15,282.35,4.65,2.85,70,"1,976.57",118
,20160628,284.15,282.35,284.15,284.15,282.4,282.4,283.25,.05,.9,24,679.81,116
,20160629,282.4,283.25,282.25,283.65,281.5,283.15,282.4,-.1,-.85,20,564.85,110
,20160630,283.15,282.4,283.1,284.35,281.8,282.15,283.3,-.25,.9,66,"1,869.91",118
,20160701,282.15,283.3,283.15,287.55,282.15,286.8,284.6,3.5,1.3,120,"3,415.71",102
,20160704,286.8,284.6,288.2,291.85,287.3,291.7,290,7.1,5.4,22,638.07,100
,20160705,291.7,290,291.4,291.45,288.15,289.35,290.4,-.65,.4,42,"1,219.71",106
,20160706,289.35,290.4,290.8,296.3,289.6,296.3,293.6,5.9,3.2,92,"2,701.30",82
,20160707,296.3,293.6,295.45,296,294.4,294.5,295.35,.9,1.75,46,"1,358.75",100
,20160708,294.5,295.35,292.25,292.65,290.85,292.15,291.95,-3.2,-3.4,26,759.12,98
,20160711,292.15,291.95,291.8,296.2,291.8,294.7,294.1,2.75,2.15,36,"1,058.81",104
,20160712,294.7,294.1,291.65,293.4,291.55,293,292.2,-1.1,-1.9,84,"2,454.84",122
,20160713,293,292.2,290.95,290.95,286.95,289.9,289.05,-2.3,-3.15,92,"2,659.51",148
,20160714,289.9,289.05,290.2,290.65,287.55,288,289.5,-1.05,.45,92,"2,663.79",174
,20160715,288,289.5,285.6,287.45,285.6,287.45,287,-2.05,-2.5,68,"1,951.89",120
,20160718,287.45,287,287.25,288.2,286.4,287.25,287.3,.25,.3,28,804.55,112
,20160719,287.25,287.3,288.1,288.45,287.55,287.55,288.2,.25,.9,48,"1,383.52",110
,20160720,287.55,288.2,288.1,288.55,287.45,287.45,288.05,-.75,-.15,10,288.06,106
,20160721,287.45,288.05,283.9,284.25,283.5,283.5,283.8,-4.55,-4.25,22,624.39,100
,20160722,283.5,283.8,285.4,286.7,285.3,285.3,286,1.5,2.2,10,286.02,100
,20160725,285.3,286,285.05,285.25,283.45,284.2,284.2,-1.8,-1.8,32,909.55,114
,20160726,284.2,284.2,283.15,285.1,283.15,284.75,284.25,.55,.05,20,568.52,104
,20160727,284.75,284.25,283.9,284.15,283.7,283.85,283.9,-.4,-.35,12,340.72,106
,20160728,283.85,283.9,284.75,288.6,284.75,288.15,287.6,4.25,3.7,52,"1,495.55",96
,20160729,288.15,287.6,288.85,288.85,287.15,287.15,287.95,-.45,.35,12,345.57,94
,20160801,287.15,287.95,289.05,290.2,287.5,289.25,289.15,1.3,1.2,128,"3,701.36",98
,20160802,289.25,289.15,289.85,289.85,289.4,289.4,289.6,.25,.45,4,115.85,98
,20160803,289.4,289.6,291.8,291.8,291.5,291.5,291.65,1.9,2.05,10,291.69,90
,20160804,291.5,291.65,291.05,291.05,289.15,289.15,289.9,-2.5,-1.75,18,521.83,90
,20160805,289.15,289.9,291.2,292.5,291.2,292.3,291.7,2.4,1.8,18,525.07,84
,20160808,292.3,291.7,288.7,288.7,286,286,287.05,-5.7,-4.65,10,287.08,84
,20160809,286,287.05,287.3,287.35,287.3,287.35,287.3,.3,.25,4,114.93,80
,20160810,287.35,287.3,289.45,289.9,289.45,289.9,289.65,2.6,2.35,4,115.87,78
,20160811,289.9,289.65,288.8,288.8,287.35,287.75,287.75,-1.9,-1.9,94,"2,705.19",78
,20160812,287.75,287.75,288.5,290.1,287.5,287.6,289.35,-.15,1.6,102,"2,951.73",76
,20160815,287.6,289.35,289.5,289.7,286.25,286.75,288.25,-2.6,-1.1,18,518.85,78
,20160816,286.75,288.25,287.25,287.25,287.25,287.25,287.25,-1,-1,2,57.45,76
,20160817,287.25,287.25,287.25,288.05,286.3,286.55,287,-.7,-.25,30,861.00,74
,20160818,286.55,287,288.85,288.85,288.3,288.3,288.55,1.3,1.55,164,"4,732.63",98
,20160819,288.3,288.55,288.85,289.1,287.7,287.7,288.65,-.85,.1,28,808.27,98
,20160822,287.7,288.65,,,,288.65,288.65,0,0,0,0.00,98
,20160823,288.65,288.65,286.8,286.8,286.8,286.8,286.8,-1.85,-1.85,2,57.36,100
,20160824,286.8,286.8,,,,286.8,286.8,0,0,0,0.00,100
,20160825,286.8,286.8,284.6,285,284,284.35,284.55,-2.45,-2.25,10,284.59,102
,20160826,284.35,284.55,,,,284.55,284.55,0,0,0,0.00,102
,20160829,284.55,284.55,285.2,286.55,283.45,283.45,285.05,-1.1,.5,20,570.16,102
,20160830,283.45,285.05,,,,285.05,285.05,0,0,0,0.00,102
,20160831,285.05,285.05,282.85,282.85,282.85,282.85,282.85,-2.2,-2.2,4,113.14,98
,20160901,282.85,282.85,282.25,282.25,282.1,282.2,282.15,-.65,-.7,20,564.39,88
,20160902,282.2,282.15,282.25,283.35,282.25,282.3,282.85,.15,.7,28,792.08,98
,20160905,282.3,282.85,286,286,286,286,286,3.15,3.15,2,57.20,96
,20160906,286,286,286.35,286.35,286.35,286.35,286.35,.35,.35,2,57.27,96
,20160907,286.35,286.35,288.35,288.35,288.35,288.35,288.35,2,2,2,57.67,94
,20160908,288.35,288.35,289.25,289.5,289.25,289.5,289.3,1.15,.95,18,520.80,88
,20160909,289.5,289.3,288.4,289,288.4,289,288.6,-.3,-.7,16,461.76,86
,20160912,289,288.6,288.2,288.2,286.9,287.6,287.95,-1,-.65,16,460.74,88
,20160913,287.6,287.95,,,,287.95,287.95,0,0,0,0.00,88
,20160914,287.95,287.95,285.5,285.5,285.5,285.5,285.5,-2.45,-2.45,2,57.10,86
,20160919,285.5,285.5,284.4,284.7,283.75,283.95,284.1,-1.55,-1.4,14,397.74,84
,20160920,283.95,284.1,284,284.7,283.8,284.15,284.1,.05,0,16,454.60,82
,20160921,284.15,284.1,284.35,285.7,284.2,285.15,284.65,1.05,.55,16,455.49,84
,20160922,285.15,284.65,286.05,287.2,286,286,286.65,1.35,2,24,687.96,64
,20160923,286,286.65,287.85,287.85,287.85,287.85,287.85,1.2,1.2,2,57.57,62
,20160926,287.85,287.85,289.3,289.3,287.95,287.95,288.35,.1,.5,8,230.71,58
,20160927,287.95,288.35,287.9,288.6,287.9,288.6,288.2,.25,-.15,6,172.92,54
,20160928,288.6,288.2,287.15,289.4,287.05,289.4,287.85,1.2,-.35,18,518.17,48
,20160929,289.4,287.85,289.55,293.2,288.85,291.95,291.45,4.1,3.6,36,"1,049.30",40
,20160930,291.95,291.45,292.5,292.5,286.65,286.65,288.85,-4.8,-2.6,28,808.85,12
,20161010,286.65,288.85,,,,288.85,288.85,0,0,0,0.00,12
,20161011,288.85,288.85,278,278,278,278,278,-10.85,-10.85,6,166.80,6
,20161012,278,278,278,278,278,278,278,0,0,6,166.80,6
,20161013,278,278,264.15,268,264.15,268,266.05,-10,-11.95,12,319.29,6
,20161014,268,266.05,,,,266.05,266.05,0,0,0,0.00,6
,20161017,266.05,266.05,,,,266.05,266.05,0,0,0,0.00,6
au1611,20160816,288.25,288.25,,,,288.25,288.25,0,0,0,0.00,0
,20160817,288.25,288.25,,,,288.25,288.25,0,0,0,0.00,0
,20160818,288.25,288.25,286.45,288.05,286.45,288.05,287.25,-.2,-1,4,114.90,2
,20160819,288.05,287.25,289.7,289.7,287.55,287.55,288.35,.3,1.1,6,173.02,6
,20160822,287.55,288.35,288.1,288.95,288.1,288.95,288.5,.6,.15,4,115.41,6
,20160823,288.95,288.5,286.9,286.9,286.9,286.9,286.9,-1.6,-1.6,2,57.38,4
,20160824,286.9,286.9,,,,286.9,286.9,0,0,0,0.00,4
,20160825,286.9,286.9,,,,286.9,286.9,0,0,0,0.00,4
,20160826,286.9,286.9,,,,286.9,286.9,0,0,0,0.00,4
,20160829,286.9,286.9,,,,286.9,286.9,0,0,0,0.00,4
,20160830,286.9,286.9,,,,286.9,286.9,0,0,0,0.00,4
,20160831,286.9,286.9,,,,286.9,286.9,0,0,0,0.00,4
,20160901,286.9,286.9,282.6,282.6,282.6,282.6,282.6,-4.3,-4.3,4,113.04,8
,20160902,282.6,282.6,282.5,282.5,282.5,282.5,282.5,-.1,-.1,2,56.50,6
,20160905,282.5,282.5,284.1,284.1,284.1,284.1,284.1,1.6,1.6,4,113.64,6
,20160906,284.1,284.1,,,,284.1,284.1,0,0,0,0.00,6
,20160907,284.1,284.1,288.9,288.9,288.9,288.9,288.9,4.8,4.8,2,57.78,4
,20160908,288.9,288.9,,,,288.9,288.9,0,0,0,0.00,4
,20160909,288.9,288.9,,,,288.9,288.9,0,0,0,0.00,4
,20160912,288.9,288.9,,,,288.9,288.9,0,0,0,0.00,4
,20160913,288.9,288.9,286,286,286,286,286,-2.9,-2.9,2,57.20,6
,20160914,286,286,,,,286,286,0,0,0,0.00,6
,20160919,286,286,,,,286,286,0,0,0,0.00,6
,20160920,286,286,,,,286,286,0,0,0,0.00,6
,20160921,286,286,284.8,286,284.7,286,285,0,-1,26,741.10,18
,20160922,286,285,285.7,288.6,285.7,287.75,287.65,2.75,2.65,72,"2,071.24",30
,20160923,287.75,287.65,287.9,289.85,287.9,289.85,288.55,2.2,.9,6,173.13,28
,20160926,289.85,288.55,,,,288.55,288.55,0,0,0,0.00,28
,20160927,288.55,288.55,,,,288.35,288.35,-.2,-.2,0,0.00,28
,20160928,288.35,288.35,,,,288,288,-.35,-.35,0,0.00,28
,20160929,288,288,287.2,288.55,283.55,285.2,285.6,-2.8,-2.4,28,799.75,14
,20160930,285.2,285.6,,,,283.05,283.05,-2.55,-2.55,0,0.00,14
,20161010,283.05,283.05,271.8,274.1,271.8,274.1,272.25,-8.95,-10.8,10,272.27,10
,20161011,274.1,272.25,273.2,273.2,273.05,273.2,273.15,.95,.9,6,163.89,14
,20161012,273.2,273.15,273.7,274.25,272.8,273.55,273.6,.4,.45,18,492.56,18
,20161013,273.55,273.6,273.85,273.85,270.9,270.9,272.35,-2.7,-1.25,4,108.95,20
,20161014,270.9,272.35,274.3,274.3,273.3,273.3,273.8,.95,1.45,4,109.52,20
,20161017,273.3,273.8,274.6,274.6,274.6,274.6,274.6,.8,.8,4,109.84,24
,20161018,274.6,274.6,275.3,275.3,275.3,275.3,275.3,.7,.7,2,55.06,24
,20161019,275.3,275.3,,,,275.3,275.3,0,0,0,0.00,24
,20161020,275.3,275.3,282.3,282.3,277.2,277.2,279.1,1.9,3.8,14,390.76,18
,20161021,277.2,279.1,278.05,283.05,277.55,280.05,280.2,.95,1.1,42,"1,176.85",6
,20161024,280.05,280.2,282.5,282.5,278,278,278.75,-2.2,-1.45,12,334.50,12
,20161025,278,278.75,282.4,282.4,272.85,277.15,278.1,-1.6,-.65,12,333.76,18
,20161026,277.15,278.1,275.3,275.3,275.3,275.3,275.3,-2.8,-2.8,2,55.06,18
,20161027,275.3,275.3,273.2,285.2,272.9,272.9,277.95,-2.4,2.65,12,333.54,12
,20161028,272.9,277.95,278,278,274.2,274.2,276.1,-3.75,-1.85,8,220.88,12
,20161031,274.2,276.1,274.2,279,274.2,279,275.8,2.9,-.3,6,165.48,6
,20161101,279,275.8,,,,275.8,275.8,0,0,0,0.00,6
,20161102,275.8,275.8,,,,275.8,275.8,0,0,0,0.00,6
,20161103,275.8,275.8,,,,275.8,275.8,0,0,0,0.00,6
,20161104,275.8,275.8,,,,275.8,275.8,0,0,0,0.00,6
,20161107,275.8,275.8,,,,275.8,275.8,0,0,0,0.00,6
,20161108,275.8,275.8,,,,275.8,275.8,0,0,0,0.00,6
,20161109,275.8,275.8,279.85,279.85,279.85,279.85,279.85,4.05,4.05,6,167.91,0
,20161110,279.85,279.85,,,,279.85,279.85,0,0,0,0.00,0
,20161111,279.85,279.85,,,,279.85,279.85,0,0,0,0.00,0
,20161114,279.85,279.85,,,,279.85,279.85,0,0,0,0.00,0
,20161115,279.85,279.85,,,,279.85,279.85,0,0,0,0.00,0
au1612,20160104,228.8,228.85,229.35,231.05,229.1,230.8,230.2,1.95,1.35,380,"8,749.04",798
,20160105,230.8,230.2,231.3,233.2,231.3,232.8,232.25,2.6,2.05,638,"14,818.69",1012
,20160106,232.8,232.25,232.85,234.35,231.95,234.35,232.65,2.1,.4,246,"5,724.24",1166
,20160107,234.35,232.65,234.35,239.55,234.35,239.2,237.35,6.55,4.7,1050,"24,924.20",1570
,20160108,239.2,237.35,239.95,240.45,238.65,239.25,239.55,1.9,2.2,260,"6,228.89",1582
,20160111,239.25,239.55,238.5,240.45,238,240.2,239.45,.65,-.1,236,"5,651.74",1640
,20160112,240.2,239.45,239.2,239.2,236.4,236.9,237.3,-2.55,-2.15,888,"21,075.09",2232
,20160113,236.9,237.3,235.45,235.7,234.6,234.65,234.9,-2.65,-2.4,366,"8,598.65",2324
,20160114,234.65,234.9,234.3,237.1,233.8,236.45,235.9,1.55,1,406,"9,577.55",2358
,20160115,236.45,235.9,235.5,236.25,233.8,234.8,234.55,-1.1,-1.35,552,"12,947.84",2326
,20160118,234.8,234.55,235.15,237.1,235.15,235.8,236.1,1.25,1.55,592,"13,978.31",2670
,20160119,235.8,236.1,235.95,236.2,234.95,235.6,235.55,-.5,-.55,258,"6,078.43",2662
,20160120,235.6,235.55,235.55,236.5,235.1,236.25,235.95,.7,.4,290,"6,842.66",2758
,20160121,236.25,235.95,238.45,240,237.55,238.6,238.2,2.65,2.25,756,"18,008.93",2986
,20160122,238.6,238.2,237.8,238.3,236.85,237.55,237.65,-.65,-.55,556,"13,215.73",3234
,20160125,237.55,237.65,237.2,238.5,237,238.05,237.95,.4,.3,654,"15,562.01",3636
,20160126,238.05,237.95,238.4,241.25,238.4,241.1,240.1,3.15,2.15,1108,"26,606.84",4390
,20160127,241.1,240.1,240.7,242.25,240.2,241.8,241.7,1.7,1.6,1174,"28,378.53",4798
,20160128,241.8,241.7,241.8,242.85,241.1,241.3,241.95,-.4,.25,1342,"32,473.38",5506
,20160129,241.3,241.95,241.45,242.15,240.3,240.6,240.8,-1.35,-1.15,488,"11,753.09",5704
,20160201,240.6,240.8,240.7,242.45,239.9,242.45,241.3,1.65,.5,450,"10,860.00",5656
,20160202,242.45,241.3,244.2,244.2,242,242.9,243.2,1.6,1.9,1040,"25,294.27",6184
,20160203,242.9,243.2,243,244.2,242.85,243.95,243.75,.75,.55,700,"17,062.63",6480
,20160204,243.95,243.75,244.45,246.5,243.35,246.4,245.55,2.65,1.8,1226,"30,109.60",6974
,20160205,246.4,245.55,247.1,248.55,246.95,248.05,248.05,2.5,2.5,2056,"51,008.23",8282
,20160215,248.05,248.05,264.45,264.45,258.1,258.7,259.8,10.65,11.75,2668,"69,319.94",9002
,20160216,258.7,259.8,256.7,257.7,246.8,255.5,255.4,-4.3,-4.4,3586,"91,596.74",10180
,20160217,255.5,255.4,257.25,258.05,255,257.2,256.65,1.8,1.25,2680,"68,784.31",10436
,20160218,257.2,256.65,256.95,257.85,256.25,257.2,257.1,.55,.45,1336,"34,349.00",10500
,20160219,257.2,257.1,256.8,261.05,256.5,260.25,260.05,3.15,2.95,4576,"119,006.64",13556
,20160222,260.25,260.05,261.05,261.85,258.1,258.3,259.1,-1.75,-.95,5828,"151,019.39",15882
,20160223,258.3,259.1,257,259,256.75,258.3,258,-.8,-1.1,4384,"113,125.50",17728
,20160224,258.3,258,258.95,262.5,258.75,260.6,260.7,2.6,2.7,4110,"107,162.79",18582
,20160225,260.6,260.7,260.65,267.45,260.65,263.55,264.25,2.85,3.55,12156,"321,263.48",23288
,20160226,263.55,264.25,263.5,264.5,261.45,264.15,263.7,-.1,-.55,10070,"265,588.23",27114
,20160229,264.15,263.7,263.85,263.85,258.6,261.55,261.65,-2.15,-2.05,6616,"173,109.90",28102
,20160301,261.55,261.65,262.4,265.85,261.25,265.4,264.6,3.75,2.95,8112,"214,682.22",32722
,20160302,265.4,264.6,265.75,265.95,261.4,261.6,262.65,-3,-1.95,6880,"180,717.67",34640
,20160303,261.6,262.65,262,264.95,261.95,264,263.6,1.35,.95,4934,"130,084.48",36176
,20160304,264,263.6,264.65,267.6,263.6,267.25,266.6,3.65,3,10256,"273,434.07",36640
,20160307,267.25,266.6,267.55,270,265,267.4,267.55,.8,.95,10570,"282,840.17",39686
,20160308,267.4,267.55,269,269.55,266.9,268.5,268.65,.95,1.1,8908,"239,323.57",42596
,20160309,268.5,268.65,269.35,269.8,264.7,265.75,266.6,-2.9,-2.05,8738,"232,962.76",44452
,20160310,265.75,266.6,265.7,266.1,262.75,263.55,264.55,-3.05,-2.05,15624,"413,361.08",44946
,20160311,263.55,264.55,262.8,270.4,261.7,267.5,268.35,2.95,3.8,12150,"326,089.16",47092
,20160314,267.5,268.35,266.25,267.7,264,264.25,265.15,-4.1,-3.2,9416,"249,666.09",47776
,20160315,264.25,265.15,264.75,265.55,258.9,259.25,260.6,-5.9,-4.55,10416,"271,461.78",47810
,20160316,259.25,260.6,260.5,261.3,259.1,261.15,260.35,.55,-.25,8286,"215,736.80",48952
,20160317,261.15,260.35,260.55,266.4,259.35,264.95,263.6,4.6,3.25,9484,"250,026.19",51364
,20160318,264.95,263.6,266,266.5,264.25,265,265.3,1.4,1.7,9054,"240,213.77",51624
,20160321,265,265.3,263,264.15,260.95,261.25,262.6,-4.05,-2.7,7158,"187,974.07",52396
,20160322,261.25,262.6,261.05,264.6,260.9,263.15,262.25,.55,-.35,6022,"157,941.31",53670
,20160323,263.15,262.25,264.2,264.6,259.8,260,262.4,-2.25,.15,7152,"187,692.59",54372
,20160324,260,262.4,258,258.5,256.75,256.8,257.4,-5.6,-5,11862,"305,367.86",56024
,20160325,256.8,257.4,258.05,258.6,257.4,257.85,257.95,.45,.55,3068,"79,139.96",56482
,20160328,257.85,257.95,257.7,258.3,255.95,256.7,256.65,-1.25,-1.3,6588,"169,112.22",57102
,20160329,256.7,256.65,257.4,258.2,256.9,257.45,257.45,.8,.8,5808,"149,548.28",57062
,20160330,257.45,257.45,257.95,261.45,257.5,260.35,259.9,2.9,2.45,11628,"302,261.16",58788
,20160331,260.35,259.9,259.95,259.95,257.2,257.85,258.45,-2.05,-1.45,15804,"408,505.06",58802
,20160401,257.85,258.45,259.95,259.95,257.9,259,258.7,.55,.25,9404,"243,306.00",58612
,20160405,259,258.7,256.8,258.05,256.3,257.7,257.35,-1,-1.35,7666,"197,285.96",60774
,20160406,257.7,257.35,258.9,259.35,257.95,258.4,258.55,1.05,1.2,7646,"197,695.27",62434
,20160407,258.4,258.55,257.15,258.8,256.85,258.2,257.8,-.35,-.75,9024,"232,643.70",63262
,20160408,258.2,257.8,260,261.1,259.5,259.85,260.2,2.05,2.4,13430,"349,508.81",64742
,20160411,259.85,260.2,259.65,263,259.2,262.35,261.45,2.15,1.25,13834,"361,698.79",66578
,20160412,262.35,261.45,262.9,263.75,262.15,263.65,262.95,2.2,1.5,14486,"380,955.99",69452
,20160413,263.65,262.95,264.1,264.3,261.55,262,262.8,-.95,-.15,25724,"676,033.48",73758
,20160414,262,262.8,261.75,262.6,258.6,259.4,260,-3.4,-2.8,22788,"592,565.98",77196
,20160415,259.4,260,259.4,259.8,257.6,258.75,258.75,-1.25,-1.25,18716,"484,334.05",80144
,20160418,258.75,258.75,258.95,260.4,257.8,258.95,259.3,.2,.55,18266,"473,675.87",82274
,20160419,258.95,259.3,260.7,261.6,258.2,261.5,259.55,2.2,.25,23892,"620,218.33",85290
,20160420,261.5,259.55,262.5,264,261.1,262.1,262.65,2.55,3.1,33158,"870,903.47",88094
,20160421,262.1,262.65,262.7,266.05,261.5,265.8,263.8,3.15,1.15,50924,"1,343,414.28",94590
,20160422,265.8,263.8,267.95,268.45,261,262.15,263.8,-1.65,0,61342,"1,618,465.24",92664
,20160425,262.15,263.8,262.65,262.95,258.2,260.35,260.8,-3.45,-3,51474,"1,342,460.78",95706
,20160426,260.35,260.8,260.5,261.75,259.95,259.95,260.95,-.85,.15,35878,"936,267.80",102848
,20160427,259.95,260.95,260.15,263.3,260.15,263.25,262.4,2.3,1.45,58272,"1,529,319.20",115676
,20160428,263.25,262.4,263.65,265.2,261.2,264.5,263.3,2.1,.9,100298,"2,641,218.77",136864
,20160429,264.5,263.3,265.35,270.2,263.9,268.7,267.45,5.4,4.15,142898,"3,822,048.81",173052
,20160503,268.7,267.45,272,274,271.3,273.9,272.65,6.45,5.2,91622,"2,498,111.08",203292
,20160504,273.9,272.65,273.65,273.65,270.3,270.65,271.5,-2,-1.15,166064,"4,509,435.36",217452
,20160505,270.65,271.5,271.55,272.7,269.3,270.25,271.05,-1.25,-.45,168280,"4,561,399.70",223004
,20160506,270.25,271.05,271.75,272,267.65,270.75,269.95,-.3,-1.1,257778,"6,959,658.79",229060
,20160509,270.75,269.95,272.8,273.45,269.7,270.05,271.65,.1,1.7,364526,"9,902,580.94",244720
,20160510,270.05,271.65,268.75,268.95,266.2,267.6,267.3,-4.05,-4.35,269504,"7,204,337.26",232556
,20160511,267.6,267.3,267.25,269.45,265.35,268.9,267.4,1.6,.1,252092,"6,741,265.05",238998
,20160512,268.9,267.4,269.45,270,267.65,268.1,268.8,.7,1.4,195620,"5,258,376.06",240004
,20160513,268.1,268.8,268.25,270.7,267.3,270.1,268.8,1.3,0,309730,"8,326,464.23",251788
,20160516,270.1,268.8,267.9,272.4,267.8,272.05,270,3.25,1.2,297706,"8,039,316.67",281686
,20160517,272.05,270,272.7,273.15,269.2,270.1,270.85,.1,.85,278192,"7,535,151.20",270764
,20160518,270.1,270.85,269.65,271.55,269.5,270.2,270.55,-.65,-.3,236438,"6,397,720.44",276598
,20160519,270.2,270.55,269.95,271.2,265.9,265.95,268.55,-4.6,-2,362390,"9,733,290.39",279720
,20160520,265.95,268.55,264.1,266.85,264.1,266.1,265.4,-2.45,-3.15,229012,"6,078,881.33",285308
,20160523,266.1,265.4,266.8,267.45,264.75,265.45,265.75,.05,.35,237010,"6,299,080.57",296306
,20160524,265.45,265.75,264.55,265.75,263.3,263.6,264.5,-2.15,-1.25,244742,"6,474,442.80",302680
,20160525,263.6,264.5,262.8,263.6,259.5,259.7,261.4,-4.8,-3.1,318086,"8,316,276.53",311778
,20160526,259.7,261.4,259.2,261.75,258.35,260.7,259.95,-.7,-1.45,236722,"6,154,612.61",307562
,20160527,260.7,259.95,260.9,261.55,257.15,259.5,259.25,-.45,-.7,282392,"7,322,285.91",304944
,20160530,259.5,259.25,258.8,258.95,255.15,256.45,256.85,-2.8,-2.4,298804,"7,675,279.24",311692
,20160531,256.45,256.85,256.75,259,256.5,258.95,257.95,2.1,1.1,207452,"5,351,232.87",280976
,20160601,258.95,257.95,258.2,260.45,258.15,259.35,259.3,1.4,1.35,224472,"5,820,953.75",282330
,20160602,259.35,259.3,259.8,259.8,257.3,259.65,258.65,.35,-.65,206500,"5,341,236.44",285598
,20160603,259.65,258.65,259.5,259.5,257.9,258.65,258.5,0,-.15,148472,"3,838,347.01",283090
,20160606,258.65,258.5,263.25,264.75,262.95,264.4,263.8,5.9,5.3,298338,"7,870,456.32",269594
,20160607,264.4,263.8,264.9,265.5,263.9,264.85,264.85,1.05,1.05,183862,"4,869,977.80",266688
,20160608,264.85,264.85,264,266.7,263.8,266.55,265.15,1.7,.3,161948,"4,294,505.73",269490
,20160613,266.55,265.15,272,274.4,271.45,274.15,272.75,9,7.6,181804,"4,959,040.15",283924
,20160614,274.15,272.75,275,275.25,272.75,273.35,273.8,.6,1.05,210538,"5,765,260.07",279248
,20160615,273.35,273.8,274.5,275.8,273.8,275.2,274.85,1.4,1.05,253134,"6,958,644.47",297362
,20160616,275.2,274.85,274.4,280.4,273.65,279.95,276.9,5.1,2.05,363092,"10,055,249.87",324660
,20160617,279.95,276.9,279.95,281.15,272.1,273.2,276.5,-3.7,-.4,546056,"15,099,845.79",320060
,20160620,273.2,276.5,274.6,276.35,272.8,273.75,274.45,-2.75,-2.05,327082,"8,978,079.15",318602
,20160621,273.75,274.45,273.65,275.05,272.55,273.2,273.7,-1.25,-.75,252118,"6,901,059.83",317422
,20160622,273.2,273.7,271,271.6,268.8,269.6,270.4,-4.1,-3.3,275022,"7,436,749.42",314488
,20160623,269.6,270.4,269.1,271.2,269,269.75,269.9,-.65,-.5,240326,"6,486,505.33",311720
,20160624,269.75,269.9,268.4,283.35,268.2,282.25,276.25,12.35,6.35,997696,"27,564,212.58",351222
,20160627,282.25,276.25,283.5,285.2,280.35,284.65,282.8,8.4,6.55,580666,"16,423,856.53",336628
,20160628,284.65,282.8,285.1,285.65,282.8,283.35,284.15,.55,1.35,325764,"9,257,754.34",337380
,20160629,283.35,284.15,282.85,284.8,282.2,284.3,283.5,.15,-.65,300974,"8,533,600.05",339374
,20160630,284.3,283.5,284.5,285.5,282.7,283,283.9,-.5,.4,287436,"8,160,733.78",333492
,20160701,283,283.9,283.55,288.65,283.1,287.15,285.45,3.25,1.55,445956,"12,730,999.43",356164
,20160704,287.15,285.45,288.05,293.7,287.5,292.15,290.55,6.7,5.1,558068,"16,215,651.86",391306
,20160705,292.15,290.55,292.6,292.85,288.6,290.8,291.05,.25,.5,344286,"10,020,670.81",368924
,20160706,290.8,291.05,291.75,297.7,289.75,296.7,293.9,5.65,2.85,542390,"15,943,368.82",381340
,20160707,296.7,293.9,296.95,297.4,295.1,295.7,296.2,1.8,2.3,341338,"10,110,910.48",374042
,20160708,295.7,296.2,294.6,294.6,291.75,292.8,293.1,-3.4,-3.1,337310,"9,887,447.73",356062
,20160711,292.8,293.1,291.05,297,290.9,295,294.35,1.9,1.25,434348,"12,786,842.21",361060
,20160712,295,294.35,293,294.75,292.55,293.6,293.7,-.75,-.65,252080,"7,403,633.42",367662
,20160713,293.6,293.7,291.8,292.35,287.65,290.8,290,-2.9,-3.7,450672,"13,069,811.93",372344
,20160714,290.8,290,290.55,291.85,288.55,288.85,290.25,-1.15,.25,304580,"8,840,580.72",367140
,20160715,288.85,290.25,286.3,289.2,285.75,288.95,287.65,-1.3,-2.6,277810,"7,992,342.27",370190
,20160718,288.95,287.65,288.25,289.2,286.75,288.15,287.95,.5,.3,303768,"8,747,816.71",368142
,20160719,288.15,287.95,288.4,290.25,287.65,288.7,288.8,.75,.85,239612,"6,920,583.09",372068
,20160720,288.7,288.8,288.8,289.7,287.5,287.55,288.7,-1.25,-.1,219452,"6,336,655.56",373546
,20160721,287.55,288.7,284.85,285.6,283.5,284.6,284.5,-4.1,-4.2,263726,"7,503,069.98",362946
,20160722,284.6,284.5,284.9,288,284.15,286.3,286.35,1.8,1.85,284348,"8,142,458.87",359946
,20160725,286.3,286.35,286.2,286.5,284.05,284.8,285.3,-1.55,-1.05,194602,"5,552,171.18",358870
,20160726,284.8,285.3,284.7,286.25,283.65,285.2,285,-.1,-.3,197578,"5,631,306.55",358204
,20160727,285.2,285,285.5,285.95,284.3,285,285.15,0,.15,170012,"4,848,386.48",362740
,20160728,285,285.15,285.6,289.8,285.6,289.25,287.7,4.1,2.55,282092,"8,115,990.35",367096
,20160729,289.25,287.7,289.8,289.8,287.15,287.45,288.35,-.25,.65,218240,"6,293,263.74",359396
,20160801,287.45,288.35,290,290.7,287.9,289.65,289.6,1.3,1.25,263120,"7,620,650.58",364264
,20160802,289.65,289.6,289.95,291.4,289.65,291.15,290.4,1.55,.8,186350,"5,412,156.95",368132
,20160803,291.15,290.4,292.7,293.35,292.1,292.6,292.75,2.2,2.35,182442,"5,341,115.37",369418
,20160804,292.6,292.75,292.55,292.55,289.65,289.75,291.05,-3,-1.7,229126,"6,669,649.92",363464
,20160805,289.75,291.05,292.65,293.55,291.8,293.3,292.6,2.25,1.55,189834,"5,555,173.68",367134
,20160808,293.3,292.6,290,290.1,286.9,287.05,288.55,-5.55,-4.05,260816,"7,526,164.88",362960
,20160809,287.05,288.55,287.65,288.2,286.7,286.8,287.45,-1.75,-1.1,133298,"3,831,952.22",361456
,20160810,286.8,287.45,287.15,291.4,287,290.9,289.3,3.45,1.85,208638,"6,036,340.39",361804
,20160811,290.9,289.3,291.15,291.25,287.9,288.5,289.2,-.8,-.1,218884,"6,330,463.39",364760
,20160812,288.5,289.2,289.25,290.6,287,288.25,288.95,-.95,-.25,207452,"5,995,054.45",361684
,20160815,288.25,288.95,290.7,291.05,283.8,287.7,288.65,-1.25,-.3,276634,"7,985,353.80",354846
,20160816,287.7,288.65,287.2,289.6,287.05,289,288.3,.35,-.35,168358,"4,854,573.38",358256
,20160817,289,288.3,288.85,289.35,287.3,287.6,288.15,-.7,-.15,220036,"6,340,451.60",355932
,20160818,287.6,288.15,288.15,290.25,286.15,289.3,288.85,1.15,.7,202202,"5,840,628.22",357676
,20160819,289.3,288.85,289.3,289.9,288.45,289.3,289.1,.45,.25,159760,"4,619,316.70",357870
,20160822,289.3,289.1,287.3,289.5,286.3,286.7,287.7,-2.4,-1.4,230778,"6,640,152.51",363330
,20160823,286.7,287.7,287.35,287.65,286.8,287.25,287.25,-.45,-.45,105430,"3,028,568.30",358476
,20160824,287.25,287.25,288.15,288.45,287,287.4,287.5,.15,.25,134914,"3,878,878.09",358384
,20160825,287.4,287.5,286.65,286.65,284.3,284.75,285.2,-2.75,-2.3,192890,"5,501,450.43",361324
,20160826,284.75,285.2,283.75,285.15,283.15,284.8,284.2,-.4,-1,118746,"3,374,870.63",355384
,20160829,284.8,284.2,286.3,288.8,283.2,283.9,285.45,-.3,1.25,418364,"11,943,487.24",355204
,20160830,283.9,285.45,284.5,285.65,284.35,284.65,284.9,-.8,-.55,143950,"4,101,769.27",346096
,20160831,284.65,284.9,284.25,284.75,282.8,283.4,283.85,-1.5,-1.05,197694,"5,612,018.36",337940
,20160901,283.4,283.85,282.4,283.6,282.15,282.75,282.95,-1.1,-.9,166752,"4,718,363.56",327980
,20160902,282.75,282.95,282.1,284.05,282,283.15,283.35,.2,.4,214742,"6,084,921.79",320942
,20160905,283.15,283.35,285.85,287,284.85,286.65,285.85,3.3,2.5,227614,"6,507,371.88",321394
,20160906,286.65,285.85,286.75,287,286.4,286.95,286.7,1.1,.85,77624,"2,225,553.80",318452
,20160907,286.95,286.7,288.25,291.7,288.05,290.85,289.85,4.15,3.15,237860,"6,894,783.72",317164
,20160908,290.85,289.85,290.95,291,289.15,290.45,290,.6,.15,131246,"3,806,516.47",315700
,20160909,290.45,290,290,290.15,288.45,288.65,289.2,-1.35,-.8,179550,"5,193,191.67",317912
,20160912,288.65,289.2,288.6,289.2,286.6,287.5,287.9,-1.7,-1.3,183842,"5,293,078.15",320156
,20160913,287.5,287.9,286.65,288.1,285.85,287.45,286.9,-.45,-1,190612,"5,469,415.09",318016
,20160914,287.45,286.9,286.5,287.1,284.8,286,285.95,-.9,-.95,173902,"4,973,538.67",320806
,20160919,286,285.95,283.55,284.85,283.05,284.55,284.2,-1.4,-1.75,84438,"2,399,919.73",321814
,20160920,284.55,284.2,284.1,284.9,284.1,284.85,284.55,.65,.35,103348,"2,941,197.69",323364
,20160921,284.85,284.55,284.55,285.75,283.65,285.35,284.8,.8,.25,152780,"4,351,505.56",324646
,20160922,285.35,284.8,287,288.25,284.85,287.7,287.2,2.9,2.4,208376,"5,984,628.58",314404
,20160923,287.7,287.2,288.3,289.7,287.8,288.15,288.6,.95,1.4,169772,"4,900,207.93",310996
,20160926,288.15,288.6,288.7,288.9,287.5,288.1,288.3,-.5,-.3,126784,"3,655,662.96",306600
,20160927,288.1,288.3,288.65,289.3,287.6,287.7,288.5,-.6,.2,135572,"3,911,611.07",307978
,20160928,287.7,288.5,287.45,287.5,285.3,285.45,286.05,-3.05,-2.45,173412,"4,960,755.18",304024
,20160929,285.45,286.05,285.6,285.95,284.4,284.75,285.2,-1.3,-.85,133208,"3,799,748.69",298064
,20160930,284.75,285.2,283.9,285.55,283.9,285.3,284.75,.1,-.45,125074,"3,561,667.35",292310
,20161010,285.3,284.75,273.6,274.2,272.35,274,273.35,-10.75,-11.4,151026,"4,128,766.50",282202
,20161011,274,273.35,273.3,274.1,273.05,273.9,273.55,.55,.2,180290,"4,931,836.52",294926
,20161012,273.9,273.55,273.05,274.05,272.95,273.3,273.35,-.25,-.2,142370,"3,892,274.78",295548
,20161013,273.3,273.35,273.05,274.7,272.5,274.2,273.4,.85,.05,211380,"5,779,925.29",295356
,20161014,274.2,273.4,273.75,274.9,273.25,273.45,273.9,.05,.5,156426,"4,285,204.93",296788
,20161017,273.45,273.9,272.8,274.25,272.6,273.7,273.3,-.2,-.6,194610,"5,318,854.10",299380
,20161018,273.7,273.3,273.65,275.4,273.45,275.2,274.3,1.9,1,150702,"4,134,248.26",298968
,20161019,275.2,274.3,275.05,275.75,274.15,275.2,275.05,.9,.75,136832,"3,763,956.05",296264
,20161020,275.2,275.05,276.8,277.7,276.5,277.25,277.05,2.2,2,156082,"4,324,946.70",295204
,20161021,277.25,277.05,277.25,277.95,275.7,276.3,276.4,-.75,-.65,165012,"4,561,662.65",284304
,20161024,276.3,276.4,277.1,277.4,276.5,277.05,276.9,.65,.5,130816,"3,622,437.76",281088
,20161025,277.05,276.9,278.25,278.8,276.6,277.9,277.5,1,.6,170374,"4,728,681.60",278640
,20161026,277.9,277.5,278.15,279.9,277.9,279.2,279.05,1.7,1.55,186498,"5,204,831.54",259932
,20161027,279.2,279.05,278.6,279.1,277.4,278.25,278.1,-.8,-.95,154518,"4,297,623.38",241346
,20161028,278.25,278.1,279.1,279.45,277.95,278.5,278.45,.4,.35,146162,"4,070,553.55",226468
,20161031,278.5,278.45,277.45,281.35,277.45,279.65,279.35,1.2,.9,231556,"6,468,954.99",208032
,20161101,279.65,279.35,279.2,280.75,278.75,280.25,279.65,.9,.3,122000,"3,412,267.52",196426
,20161102,280.25,279.65,281.55,283.1,281.35,282.95,281.95,3.3,2.3,142370,"4,014,170.82",191694
,20161103,282.95,281.95,283.4,285,283,283.75,283.95,1.8,2,153342,"4,354,522.10",179110
,20161104,283.75,283.95,282.4,284.55,282.1,282.4,283.25,-1.55,-.7,135836,"3,848,221.51",165716
,20161107,282.4,283.25,284.05,284.75,281.6,281.85,283.05,-1.4,-.2,134896,"3,818,817.71",152006
,20161108,281.85,283.05,281.75,281.8,279.65,281.2,280.85,-1.85,-2.2,98046,"2,753,723.99",146142
,20161109,281.2,280.85,280.6,289.95,278.6,288.7,284.25,7.85,3.4,429826,"12,219,063.15",137458
,20161110,288.7,284.25,285.35,286.5,279.6,283,283.45,-1.25,-.8,231386,"6,559,371.68",119342
,20161111,283,283.45,281.95,283.1,275,278.55,279.55,-4.9,-3.9,172052,"4,810,137.41",111148
,20161114,278.55,279.55,276.75,278.6,265.55,269.75,271.9,-9.8,-7.65,148832,"4,047,095.89",93458
,20161115,269.75,271.9,271,272.95,269.3,272.5,271.3,.6,-.6,70400,"1,909,980.01",84416
,20161116,272.5,271.3,271.4,274.4,271.4,274.05,273.05,2.75,1.75,43040,"1,175,290.18",74472
,20161117,274.05,273.05,273.45,274.2,272.8,273.25,273.55,.2,.5,25162,"688,370.79",68542
,20161118,273.25,273.55,273.6,273.95,270,270.35,271.55,-3.2,-2,38362,"1,041,872.92",60516
,20161121,270.35,271.55,270.55,272.55,269.8,272.5,271.15,.95,-.4,27188,"737,326.24",55410
,20161122,272.5,271.15,272.65,273.85,271.8,273.25,273.1,2.1,1.95,28136,"768,530.79",45684
,20161123,273.25,273.1,273.15,273.85,272,273.45,273.1,.35,0,22556,"616,037.82",39774
,20161124,273.45,273.1,272.85,272.95,269.85,270.65,270.8,-2.45,-2.3,33976,"920,090.73",33836
,20161125,270.65,270.8,270.1,270.5,265.65,268.55,268.15,-2.25,-2.65,18860,"505,771.13",30636
,20161128,268.55,268.15,270,272.35,268.4,271.1,270.65,2.95,2.5,22940,"620,975.41",24580
,20161129,271.1,270.65,270.65,271.8,269.75,269.8,270.75,-.85,.1,15768,"426,922.52",20112
,20161130,269.8,270.75,268.7,269.8,262.2,268.2,268.6,-2.55,-2.15,17014,"456,998.47",12046
,20161201,268.2,268.6,267.4,268.4,264.75,266.3,266.3,-2.3,-2.3,6556,"174,606.08",9888
,20161202,266.3,266.3,264.65,266.2,263.95,265.6,265.5,-.7,-.8,2136,"56,716.53",8808
,20161205,265.6,265.5,265.1,267.45,264.05,265.7,266,.2,.5,1608,"42,776.64",7860
,20161206,265.7,266,265.15,266.75,264.55,265.15,265.15,-.85,-.85,2538,"67,297.77",6258
,20161207,265.15,265.15,265.2,265.5,264.2,264.95,264.8,-.2,-.35,1368,"36,228.48",5238
,20161208,264.95,264.8,265.85,267.65,265.8,266.8,266.7,2,1.9,1164,"31,044.00",4500
,20161209,266.8,266.7,266.8,267,265.65,266.45,266.1,-.25,-.6,888,"23,633.61",3858
,20161212,266.45,266.1,265.3,266.9,262.35,262.75,264.55,-3.35,-1.55,2862,"75,724.59",1776
,20161213,262.75,264.55,260.25,265,260,263.65,263.75,-.9,-.8,132,"3,481.95",1740
,20161214,263.65,263.75,264,264.5,264,264.5,264,.75,.25,126,"3,326.79",1734
,20161215,264.5,264,,,,264,264,0,0,0,0.00,1734
au1701,20161018,273.3,273.3,,,,273.3,273.3,0,0,0,0.00,0
,20161019,273.3,273.3,277.9,277.9,276.75,276.75,277.3,3.45,4,4,110.93,2
,20161020,276.75,277.3,280.4,280.95,278.3,278.3,279.7,1,2.4,58,"1,622.43",2
,20161021,278.3,279.7,,,,279.7,279.7,0,0,0,0.00,2
,20161024,279.7,279.7,280.3,280.3,277.65,278.7,278.8,-1,-.9,50,"1,394.18",4
,20161025,278.7,278.8,280.7,280.7,277.7,277.7,279.65,-1.1,.85,8,223.72,4
,20161026,277.7,279.65,281.5,282.35,279.9,281.05,281.3,1.4,1.65,22,618.88,6
,20161027,281.05,281.3,278.8,280.5,278.7,279.85,279.4,-1.45,-1.9,26,726.56,10
,20161028,279.85,279.4,280,281.65,279.55,279.55,280.4,.15,1,34,953.50,12
,20161031,279.55,280.4,281.1,282.75,281.05,281.15,281.9,.75,1.5,26,732.94,16
,20161101,281.15,281.9,280.65,283.4,280.5,283.4,281.65,1.5,-.25,54,"1,521.04",16
,20161102,283.4,281.65,283.5,285.55,283.5,285.55,284.15,3.9,2.5,14,397.85,18
,20161103,285.55,284.15,285.75,287.1,283.6,284,285.9,-.15,1.75,76,"2,173.03",38
,20161104,284,285.9,281.05,285.45,281.05,283.7,284.15,-2.2,-1.75,26,738.83,44
,20161107,283.7,284.15,286.65,286.65,282.95,282.95,284.4,-1.2,.25,42,"1,194.68",38
,20161108,282.95,284.4,282.6,283,280.3,283,281.55,-1.4,-2.85,46,"1,295.16",38
,20161109,283,281.55,281.05,295,280.9,289.05,290.2,7.5,8.65,1172,"34,015.63",678
,20161110,289.05,290.2,288.35,288.75,281.5,284.05,285.55,-6.15,-4.65,564,"16,107.13",520
,20161111,284.05,285.55,284.5,284.55,277.65,280.4,280.85,-5.15,-4.7,224,"6,291.41",538
,20161114,280.4,280.85,280.4,294.85,268.85,270.95,278.6,-9.9,-2.25,1006,"28,027.23",726
,20161115,270.95,278.6,272.1,275.95,270.85,274.55,273.9,-4.05,-4.7,244,"6,683.56",698
,20161116,274.55,273.9,273.3,276.15,273.3,275.65,274.3,1.75,.4,386,"10,588.88",494
,20161117,275.65,274.3,275.65,275.9,274.05,274.7,275.15,.4,.85,72,"1,981.20",456
,20161118,274.7,275.15,274.85,275,271.3,272.1,272.65,-3.05,-2.5,152,"4,144.28",438
,20161121,272.1,272.65,271.55,274.55,271.55,274.55,273.1,1.9,.45,106,"2,895.32",448
,20161122,274.55,273.1,274.65,276.65,274,276,275.65,2.9,2.55,372,"10,255.08",456
,20161123,276,275.65,275.35,276.1,274.05,274.95,275,-.7,-.65,128,"3,520.27",438
,20161124,274.95,275,270.25,275.05,270.25,272.7,272.85,-2.3,-2.15,134,"3,656.75",456
,20161125,272.7,272.85,271.7,272.45,267.4,269.6,270.45,-3.25,-2.4,136,"3,678.18",470
,20161128,269.6,270.45,270.85,274.7,270.45,272.8,272.15,2.35,1.7,250,"6,804.57",458
,20161129,272.8,272.15,272.3,273.6,271.15,272,272.5,-.15,.35,290,"7,903.79",538
,20161130,272,272.5,271,271.25,269.85,270.2,270.3,-2.3,-2.2,248,"6,704.63",642
,20161201,270.2,270.3,269.7,269.8,266.3,267.9,268.4,-2.4,-1.9,126,"3,382.27",644
,20161202,267.9,268.4,267.1,268.7,266.05,267.7,267.45,-.7,-.95,168,"4,493.56",726
,20161205,267.7,267.45,266.85,269.35,266,267.5,268,.05,.55,52,"1,393.77",718
,20161206,267.5,268,266.75,267.8,266.35,266.35,266.8,-1.65,-1.2,32,853.82,706
,20161207,266.35,266.8,266.3,266.7,265.85,266.4,266.2,-.4,-.6,102,"2,715.65",698
,20161208,266.4,266.2,268.5,270.1,267.4,268.25,268.5,2.05,2.3,92,"2,470.53",700
,20161209,268.25,268.5,268.5,268.5,266.45,267.75,267.5,-.75,-1,34,909.60,688
,20161212,267.75,267.5,266.5,267,265.65,266,266.25,-1.5,-1.25,132,"3,514.90",700
,20161213,266,266.25,266.15,267,265.75,266.25,266.55,0,.3,140,"3,732.32",728
,20161214,266.25,266.55,265,267.3,265,266.7,266.05,.15,-.5,170,"4,523.21",732
,20161215,266.7,266.05,266.85,267.45,263.75,264.6,265.3,-1.45,-.75,38,"1,008.31",738
,20161216,264.6,265.3,262.4,266.4,262.2,262.65,262.7,-2.65,-2.6,44,"1,155.93",716
,20161219,262.65,262.7,264.15,264.15,262.4,263.2,263.1,.5,.4,42,"1,105.19",716
,20161220,263.2,263.1,263.35,264,263.1,263.3,263.45,.2,.35,26,685.07,700
,20161221,263.3,263.45,260.1,262.45,260.1,261.8,260.85,-1.65,-2.6,26,678.30,706
,20161222,261.8,260.85,260.85,260.85,257.55,258.8,259.65,-2.05,-1.2,64,"1,661.87",680
,20161223,258.8,259.65,261.1,261.1,258.55,260.1,259.3,.45,-.35,66,"1,711.51",638
,20161226,260.1,259.3,260.35,260.45,258.95,260.4,259.95,1.1,.65,16,415.92,634
,20161227,260.4,259.95,260.7,261.65,259.95,260.6,260.65,.65,.7,22,573.49,628
,20161228,260.6,260.65,261.15,262.8,261.05,262.35,261.95,1.7,1.3,42,"1,100.27",628
,20161229,262.35,261.95,262.15,263.9,260.6,263.1,262.95,1.15,1,56,"1,472.75",614
,20161230,263.1,262.95,262.2,265.4,257,264.05,261.9,1.1,-1.05,622,"16,290.64",540
au1702,20160118,234.55,234.55,,,,234.55,234.55,0,0,0,0.00,0
,20160119,234.55,234.55,,,,234.05,234.05,-.5,-.5,0,0.00,0
,20160120,234.05,234.05,,,,234.05,234.05,0,0,0,0.00,0
,20160121,234.05,234.05,,,,234.05,234.05,0,0,0,0.00,0
,20160122,234.05,234.05,239.5,239.5,239.5,239.5,239.5,5.45,5.45,2,47.90,2
,20160125,239.5,239.5,239.5,240.45,237.05,240.45,239.2,.95,-.3,8,191.39,6
,20160126,240.45,239.2,239.2,239.2,239.2,239.2,239.2,0,0,2,47.84,6
,20160127,239.2,239.2,242.85,242.85,242.25,242.25,242.4,3.05,3.2,8,193.92,6
,20160128,242.25,242.4,240.9,243.55,240.6,243.55,241.8,1.15,-.6,10,241.80,8
,20160129,243.55,241.8,241.45,241.45,241.45,241.45,241.45,-.35,-.35,2,48.29,8
,20160201,241.45,241.45,243.7,243.7,243.7,243.7,243.7,2.25,2.25,6,146.22,8
,20160202,243.7,243.7,,,,243.7,243.7,0,0,0,0.00,8
,20160203,243.7,243.7,,,,243.7,243.7,0,0,0,0.00,8
,20160204,243.7,243.7,246.3,247.75,245.8,247,246.4,3.3,2.7,12,295.72,6
,20160205,247,246.4,249.85,249.95,247.6,248.5,248.8,2.1,2.4,18,447.91,6
,20160215,248.5,248.8,260.05,262.45,259.55,262.45,260.3,13.65,11.5,10,260.32,12
,20160216,262.45,260.3,,,,260.3,260.3,0,0,0,0.00,12
,20160217,260.3,260.3,257.15,257.75,257.15,257.75,257.35,-2.55,-2.95,6,154.41,14
,20160218,257.75,257.35,259.35,259.6,258,258.35,258.85,1,1.5,14,362.39,16
,20160219,258.35,258.85,262.8,262.8,262,262,262.4,3.15,3.55,4,104.96,16
,20160222,262,262.4,,,,262,262,-.4,-.4,0,0.00,16
,20160223,262,262,259.65,259.65,259.65,259.65,259.65,-2.35,-2.35,2,51.93,18
,20160224,259.65,259.65,,,,259.65,259.65,0,0,0,0.00,18
,20160225,259.65,259.65,266,266.2,263.4,264.45,264.85,4.8,5.2,22,582.74,22
,20160226,264.45,264.85,264.65,265.55,264,264,264.7,-.85,-.15,6,158.84,26
,20160229,264,264.7,262.4,262.4,262.4,262.4,262.4,-2.3,-2.3,2,52.48,26
,20160301,262.4,262.4,263.2,265.25,263.2,265.25,264.55,2.85,2.15,6,158.74,30
,20160302,265.25,264.55,262.9,262.9,262.45,262.45,262.6,-2.1,-1.95,8,210.08,34
,20160303,262.45,262.6,263.7,264,263.7,264,263.8,1.4,1.2,12,316.60,46
,20160304,264,263.8,267.2,268,264.85,268,266.9,4.2,3.1,26,693.95,58
,20160307,268,266.9,268.75,268.75,265.95,267.35,267.65,.45,.75,18,481.78,60
,20160308,267.35,267.65,269.5,269.9,268,269.9,269.2,2.25,1.55,14,376.89,66
,20160309,269.9,269.2,269.5,269.5,266.05,266.05,267.45,-3.15,-1.75,52,"1,390.94",74
,20160310,266.05,267.45,266.45,266.45,263.85,264.1,264.8,-3.35,-2.65,18,476.65,70
,20160311,264.1,264.8,262.25,269.05,261.05,269.05,266.95,4.25,2.15,60,"1,601.90",86
,20160314,269.05,266.95,267.05,267.05,264.4,264.9,265.4,-2.05,-1.55,22,583.88,90
,20160315,264.9,265.4,264.7,264.7,259.9,260,261.55,-5.4,-3.85,38,993.95,90
,20160316,260,261.55,260,260.15,260,260.15,260.05,-1.4,-1.5,8,208.06,86
,20160317,260.15,260.05,260.75,266.2,260.4,265.55,262.55,5.5,2.5,34,892.68,84
,20160318,265.55,262.55,266.8,266.8,266.15,266.45,266.45,3.9,3.9,8,213.17,86
,20160321,266.45,266.45,263.3,263.7,263.1,263.7,263.3,-2.75,-3.15,20,526.64,86
,20160322,263.7,263.3,262.3,263.2,262.3,263.2,262.75,-.1,-.55,4,105.10,88
,20160323,263.2,262.75,263.95,263.95,260.45,260.45,262.5,-2.3,-.25,8,210.01,88
,20160324,260.45,262.5,258.3,258.3,257.3,257.3,257.9,-5.2,-4.6,10,257.92,92
,20160325,257.3,257.9,258,258,258,258,258,.1,.1,2,51.60,90
,20160328,258,258,256.5,257.8,256.5,257.8,257.5,-.2,-.5,10,257.54,86
,20160329,257.8,257.5,,,,257.5,257.5,0,0,0,0.00,86
,20160330,257.5,257.5,260.95,260.95,260.25,260.25,260.5,2.75,3,6,156.30,86
,20160331,260.25,260.5,260.35,260.35,260.35,260.35,260.35,-.15,-.15,2,52.07,84
,20160401,260.35,260.35,260.35,260.35,258.5,259,259.1,-1.35,-1.25,12,310.96,88
,20160405,259,259.1,257.5,258.2,257.5,258.2,257.7,-.9,-1.4,8,206.18,90
,20160406,258.2,257.7,258.55,258.55,258.55,258.55,258.55,.85,.85,2,51.71,88
,20160407,258.55,258.55,,,,258.55,258.55,0,0,0,0.00,88
,20160408,258.55,258.55,260.4,261.05,260.15,260.3,260.55,1.75,2,36,938.09,86
,20160411,260.3,260.55,,,,260.8,260.8,.25,.25,0,0.00,86
,20160412,260.8,260.8,263.55,263.55,263.45,263.45,263.5,2.65,2.7,6,158.11,82
,20160413,263.45,263.5,264.15,264.15,263.5,263.7,263.75,.2,.25,6,158.27,80
,20160414,263.7,263.75,262.5,262.5,259.15,260.05,260.2,-3.7,-3.55,12,312.27,78
,20160415,260.05,260.2,260.35,260.35,258.65,258.9,259,-1.3,-1.2,18,466.26,82
,20160418,258.9,259,,,,259,259,0,0,0,0.00,82
,20160419,259,259,261.3,261.3,259.45,259.45,260.3,.45,1.3,6,156.20,84
,20160420,259.45,260.3,,,,263.4,263.4,3.1,3.1,0,0.00,84
,20160421,263.4,263.4,263.6,266.55,263.6,266.55,264.5,3.15,1.1,8,211.62,86
,20160422,266.55,264.5,268.25,268.25,263,263,265.15,-1.5,.65,38,"1,007.63",96
,20160425,263,265.15,262.3,262.3,262.3,262.3,262.3,-2.85,-2.85,2,52.46,98
,20160426,262.3,262.3,,,,262.3,262.3,0,0,0,0.00,98
,20160427,262.3,262.3,262.6,263.05,262.4,262.4,262.65,.1,.35,10,262.65,98
,20160428,262.4,262.65,262.1,264.9,262.1,264.9,264.4,2.25,1.75,14,370.22,98
,20160429,264.9,264.4,264.95,269.75,264.95,269.3,267.4,4.9,3,42,"1,123.11",110
,20160503,269.3,267.4,273,274.45,272.4,274.45,273.3,7.05,5.9,64,"1,749.32",122
,20160504,274.45,273.3,273,273,271.15,271.5,272.45,-1.8,-.85,200,"5,449.53",144
,20160505,271.5,272.45,272.4,272.65,258.8,271.1,264.65,-1.35,-7.8,588,"15,562.66",258
,20160506,271.1,264.65,272.05,272.3,268.6,270.45,270.9,5.8,6.25,136,"3,684.91",160
,20160509,270.45,270.9,272.9,272.9,270.45,270.45,271.8,-.45,.9,80,"2,174.66",130
,20160510,270.45,271.8,269.6,269.6,267.3,267.55,268.1,-4.25,-3.7,48,"1,287.00",106
,20160511,267.55,268.1,267,269.95,267,269.95,268.5,1.85,.4,6,161.12,104
,20160512,269.95,268.5,270.8,270.8,269.1,269.1,269.65,.6,1.15,10,269.69,106
,20160513,269.1,269.65,269.6,270.25,269.6,270.25,270,.6,.35,12,324.04,108
,20160516,270.25,270,271.55,272.5,271.45,272.5,271.9,2.5,1.9,22,598.19,114
,20160517,272.5,271.9,273.25,273.25,270.85,270.85,272.35,-1.05,.45,6,163.42,118
,20160518,270.85,272.35,271.8,271.8,270.9,270.9,271.2,-1.45,-1.15,6,162.73,118
,20160519,270.9,271.2,271.2,271.2,266.85,267,268.3,-4.2,-2.9,34,912.28,118
,20160520,267,268.3,265.5,267.15,265.1,267.05,266.1,-1.25,-2.2,14,372.55,112
,20160523,267.05,266.1,266.15,266.95,263.25,266.25,266,.15,-.1,12,319.22,108
,20160524,266.25,266,264.95,265.05,264.5,265.05,264.95,-.95,-1.05,24,635.88,106
,20160525,265.05,264.95,263.6,264.95,260.45,260.45,262.95,-4.5,-2,38,999.36,108
,20160526,260.45,262.95,259.6,261.85,259.6,261.85,260,-1.1,-2.95,14,364.04,110
,20160527,261.85,260,259.1,260.5,259.1,260.5,259.95,.5,-.05,6,155.99,114
,20160530,260.5,259.95,256.45,257.1,256.45,257.1,256.55,-2.85,-3.4,10,256.58,112
,20160531,257.1,256.55,259.6,259.75,259.6,259.75,259.6,3.2,3.05,12,311.57,122
,20160601,259.75,259.6,260.55,261.4,259.15,260.3,259.95,.7,.35,28,727.97,126
,20160602,260.3,259.95,259.85,260.25,258.95,260.25,259.8,.3,-.15,18,467.65,126
,20160603,260.25,259.8,261.65,261.65,259.95,259.95,260.5,.15,.7,6,156.31,130
,20160606,259.95,260.5,264.3,265.5,264.3,265.05,265,4.55,4.5,32,848.09,106
,20160607,265.05,265,265.55,265.9,265.5,265.9,265.7,.9,.7,12,318.89,110
,20160608,265.9,265.7,264.55,264.85,264.55,264.85,264.75,-.85,-.95,10,264.79,106
,20160613,264.85,264.75,271.4,274.75,271.4,274.65,272.9,9.9,8.15,58,"1,582.86",98
,20160614,274.65,272.9,274.85,274.85,273.3,273.75,274.2,.85,1.3,12,329.04,94
,20160615,273.75,274.2,275.55,275.75,275.3,275.35,275.4,1.15,1.2,16,440.68,94
,20160616,275.35,275.4,274.85,281.95,274.1,281.45,279.2,6.05,3.8,248,"6,924.62",216
,20160617,281.45,279.2,281.2,282.6,274.4,276.1,279,-3.1,-.2,100,"2,790.39",236
,20160620,276.1,279,276.2,277.15,274.4,274.95,275.5,-4.05,-3.5,30,826.52,254
,20160621,274.95,275.5,274.35,276.4,274,274.9,275.45,-.6,-.05,78,"2,148.78",228
,20160622,274.9,275.45,271.8,272.75,270.9,270.9,271.7,-4.55,-3.75,30,815.19,228
,20160623,270.9,271.7,270.65,272.2,270.65,272.2,271.2,.5,-.5,8,216.97,232
,20160624,272.2,271.2,271.05,284.75,270.65,282.65,278.7,11.45,7.5,196,"5,463.06",218
,20160627,282.65,278.7,285.15,286.25,280.05,285.6,284.75,6.9,6.05,80,"2,278.11",218
,20160628,285.6,284.75,285.6,286.15,284.35,284.5,285.05,-.25,.3,76,"2,166.40",218
,20160629,284.5,285.05,284.4,285.8,283.3,285.5,284.7,.45,-.35,54,"1,537.52",224
,20160630,285.5,284.7,285.2,285.8,283.9,284.2,284.85,-.5,.15,66,"1,880.27",232
,20160701,284.2,284.85,285.3,289.35,284.7,287.85,286.2,3,1.35,96,"2,747.89",212
,20160704,287.85,286.2,289.5,293.95,289.15,293.95,291.25,7.75,5.05,48,"1,398.03",208
,20160705,293.95,291.25,293.55,293.7,290,291.5,292.3,.25,1.05,64,"1,870.81",224
,20160706,291.5,292.3,297.1,298.8,297.1,297.65,297.8,5.35,5.5,34,"1,012.55",236
,20160707,297.65,297.8,297.8,297.95,296.9,297.6,297.5,-.2,-.3,38,"1,130.61",258
,20160708,297.6,297.5,295,295.1,293,293.8,294.5,-3.7,-3,30,883.55,248
,20160711,293.8,294.5,297.75,298.35,296.6,296.6,297.45,2.1,2.95,12,356.95,246
,20160712,296.6,297.45,294.8,295.45,294.8,295,295,-2.45,-2.45,14,413.02,254
,20160713,295,295,,,,295,295,0,0,0,0.00,254
,20160714,295,295,291.4,291.4,289.75,290.5,291,-4.5,-4,118,"3,433.83",252
,20160715,290.5,291,287.7,287.8,287.7,287.8,287.7,-3.2,-3.3,6,172.64,254
,20160718,287.8,287.7,289.3,290.25,288.2,289.55,289.5,1.85,1.8,48,"1,389.77",256
,20160719,289.55,289.5,290.25,290.35,290,290,290.15,.5,.65,12,348.19,250
,20160720,290,290.15,289.8,290.85,289.8,290.7,290.05,.55,-.1,34,986.24,226
,20160721,290.7,290.05,285.55,286.1,285.55,286.05,286,-4,-4.05,128,"3,660.95",154
,20160722,286.05,286,287.9,287.9,287.3,287.3,287.6,1.3,1.6,4,115.04,154
,20160725,287.3,287.6,287.35,287.35,287.35,287.35,287.35,-.25,-.25,2,57.47,152
,20160726,287.35,287.35,285.15,287.05,285.15,286.85,286.45,-.5,-.9,154,"4,412.07",160
,20160727,286.85,286.45,286.35,286.7,285.5,286.1,286.3,-.35,-.15,28,801.73,142
,20160728,286.1,286.3,288.5,290.7,287.85,290.7,288.5,4.4,2.2,12,346.25,144
,20160729,290.7,288.5,,,,288.5,288.5,0,0,0,0.00,144
,20160801,288.5,288.5,290.5,291.4,289.9,291.4,290.6,2.9,2.1,16,465.01,132
,20160802,291.4,290.6,290.8,292.1,290.8,292.1,291.35,1.5,.75,10,291.39,128
,20160803,292.1,291.35,293.85,294.35,293.85,294.35,294.1,3,2.75,16,470.62,130
,20160804,294.35,294.1,292.1,292.8,291.2,291.7,291.9,-2.4,-2.2,12,350.30,132
,20160805,291.7,291.9,293.9,295.15,293.25,295,293.95,3.1,2.05,64,"1,881.55",166
,20160808,295,293.95,291.6,291.6,288.5,288.5,289.9,-5.45,-4.05,44,"1,275.69",156
,20160809,288.5,289.9,288.4,288.4,288.4,288.4,288.4,-1.5,-1.5,10,288.40,152
,20160810,288.4,288.4,289.9,292.65,289.9,292.65,291.65,4.25,3.25,16,466.69,148
,20160811,292.65,291.65,291.1,291.1,289.9,290.2,290.3,-1.45,-1.35,8,232.24,154
,20160812,290.2,290.3,,,,290.3,290.3,0,0,0,0.00,154
,20160815,290.3,290.3,290.3,291.75,289.1,289.1,290.35,-1.2,.05,12,348.46,154
,20160816,289.1,290.35,289.65,289.65,289.65,289.65,289.65,-.7,-.7,2,57.93,154
,20160817,289.65,289.65,288.65,289.3,288.65,289.3,289.05,-.35,-.6,28,809.43,154
,20160818,289.3,289.05,289.4,291,289.4,291,290.2,1.95,1.15,8,232.17,154
,20160819,291,290.2,,,,290.2,290.2,0,0,0,0.00,154
,20160822,290.2,290.2,,,,290.2,290.2,0,0,0,0.00,154
,20160823,290.2,290.2,288.65,288.65,288.65,288.65,288.65,-1.55,-1.55,2,57.73,154
,20160824,288.65,288.65,,,,288.65,288.65,0,0,0,0.00,154
,20160825,288.65,288.65,285.55,286.15,283.1,286.15,285.25,-2.5,-3.4,28,798.72,154
,20160826,286.15,285.25,,,,285.25,285.25,0,0,0,0.00,154
,20160829,285.25,285.25,286.95,288.1,285.15,285.15,286.6,-.1,1.35,36,"1,031.85",156
,20160830,285.15,286.6,286.45,286.5,286,286.5,286.4,-.1,-.2,30,859.32,170
,20160831,286.5,286.4,286.5,286.5,284.35,284.35,285.35,-2.05,-1.05,14,399.49,170
,20160901,284.35,285.35,284.95,284.95,283.65,284.4,284.2,-.95,-1.15,14,397.94,168
,20160902,284.4,284.2,283.55,285.75,283.55,284.5,284.95,.3,.75,46,"1,310.95",178
,20160905,284.5,284.95,287.55,288,286.8,287.55,287.55,2.6,2.6,46,"1,322.83",176
,20160906,287.55,287.55,288.35,288.35,288.35,288.35,288.35,.8,.8,2,57.67,176
,20160907,288.35,288.35,290.7,292.65,290.4,292.2,291.5,3.85,3.15,18,524.70,186
,20160908,292.2,291.5,291.2,291.75,290.55,291.75,291.1,.25,-.4,14,407.55,186
,20160909,291.75,291.1,290.7,290.7,289.95,289.95,290,-1.15,-1.1,16,464.07,184
,20160912,289.95,290,288.35,289,288.35,289,288.65,-1,-1.35,18,519.65,176
,20160913,289,288.65,288.5,289.65,288.5,288.9,289.05,.25,.4,10,289.08,174
,20160914,288.9,289.05,286.2,287.55,286.2,287.55,287.15,-1.5,-1.9,18,516.92,172
,20160919,287.55,287.15,285.35,286.3,285.35,286.3,285.7,-.85,-1.45,6,171.44,174
,20160920,286.3,285.7,286.2,286.55,286.15,286.15,286.25,.45,.55,10,286.26,174
,20160921,286.15,286.25,286.2,287.25,286.05,287.25,286.4,1,.15,38,"1,088.41",174
,20160922,287.25,286.4,288.25,289.35,287.45,289,288.4,2.6,2,12,346.12,178
,20160923,289,288.4,289.8,290.45,289.6,289.6,290,1.2,1.6,26,754.12,168
,20160926,289.6,290,289.95,289.95,289.4,289.4,289.55,-.6,-.45,6,173.75,172
,20160927,289.4,289.55,290.65,290.65,289.35,289.65,290.2,.1,.65,16,464.36,168
,20160928,289.65,290.2,287.85,287.85,287.85,287.85,287.85,-2.35,-2.35,4,115.14,168
,20160929,287.85,287.85,287.3,287.9,286.9,287.9,287.3,.05,-.55,10,287.32,164
,20160930,287.9,287.3,287.45,287.75,287.45,287.75,287.6,.45,.3,4,115.04,166
,20161010,287.75,287.6,275.45,276.1,274,276,275.15,-11.6,-12.45,58,"1,596.03",160
,20161011,276,275.15,275.15,275.15,275.15,275.15,275.15,0,0,2,55.03,158
,20161012,275.15,275.15,274.85,275.25,274.85,275.25,275.2,.1,.05,32,880.72,188
,20161013,275.25,275.2,275.7,276.7,275.4,276,276.2,.8,1,22,607.66,204
,20161014,276,276.2,276.25,276.25,275.7,275.7,275.85,-.5,-.35,20,551.71,208
,20161017,275.7,275.85,274.65,275.95,274.65,275.95,275.3,.1,-.55,74,"2,037.32",222
,20161018,275.95,275.3,276.7,276.7,276.45,276.45,276.5,1.15,1.2,6,165.92,216
,20161019,276.45,276.5,276.8,277.6,276.8,277.35,277.05,.85,.55,66,"1,828.82",198
,20161020,277.35,277.05,279.15,279.6,279.15,279.6,279.3,2.55,2.25,12,335.17,202
,20161021,279.6,279.3,279.4,279.8,278,278,278.55,-1.3,-.75,34,947.12,194
,20161024,278,278.55,278.95,279.5,278.5,279.5,278.95,.95,.4,10,278.99,192
,20161025,279.5,278.95,279,280.35,279,279.75,279.5,.8,.55,14,391.36,194
,20161026,279.75,279.5,280,281.7,280,281.55,281.25,2.05,1.75,42,"1,181.33",168
,20161027,281.55,281.25,280.85,281.4,280,280.55,280.6,-.7,-.65,14,392.85,168
,20161028,280.55,280.6,280.65,280.75,280.25,280.4,280.45,-.2,-.15,38,"1,065.81",162
,20161031,280.4,280.45,280.8,282,280.8,282,281.4,1.55,.95,4,112.56,164
,20161101,282,281.4,281.6,282.8,281.1,282.8,282,1.4,.6,30,846.14,166
,20161102,282.8,282,284.05,285.05,283.85,285,284.4,3,2.4,44,"1,251.50",164
,20161103,285,284.4,286.75,287,286.05,286.05,286.45,1.65,2.05,24,687.55,160
,20161104,286.05,286.45,284.5,286.6,284.5,284.9,285.2,-1.55,-1.25,16,456.38,156
,20161107,284.9,285.2,286.75,286.75,283.65,283.75,284.5,-1.45,-.7,68,"1,934.73",156
,20161108,283.75,284.5,283.3,283.7,282,282.55,282.5,-1.95,-2,112,"3,164.51",176
,20161109,282.55,282.5,283.8,291.9,281.15,290.25,287.25,7.75,4.75,162,"4,654.02",190
,20161110,290.25,287.25,287.05,288.1,283.45,284.8,285.2,-2.45,-2.05,66,"1,882.33",168
,20161111,284.8,285.2,283.8,283.8,279.55,280.8,281.3,-4.4,-3.9,54,"1,519.06",178
,20161114,280.8,281.3,279.45,279.75,270.15,271.95,272.85,-9.35,-8.45,60,"1,637.30",186
,20161115,271.95,272.85,272.95,275.25,272.2,274.9,274,2.05,1.15,58,"1,589.20",220
,20161116,274.9,274,274.2,276.65,274.05,275.65,275.15,1.65,1.15,48,"1,320.93",216
,20161117,275.65,275.15,,,,275.15,275.15,0,0,0,0.00,216
,20161118,275.15,275.15,275.25,275.25,270.85,272.15,272,-3,-3.15,46,"1,251.37",214
,20161121,272.15,272,272.15,272.15,272.15,272.15,272.15,.15,.15,2,54.43,214
,20161122,272.15,272.15,273.95,275.6,273.95,275.6,274.6,3.45,2.45,8,219.70,212
,20161123,275.6,274.6,274.85,275.05,273.65,274.4,274.7,-.2,.1,18,494.53,212
,20161124,274.4,274.7,274.3,274.3,271.9,272,272.8,-2.7,-1.9,180,"4,910.56",246
,20161125,272,272.8,271.95,271.95,268.45,268.8,269.45,-4,-3.35,24,646.79,246
,20161128,268.8,269.45,270.75,273.5,270.2,272.5,272.25,3.05,2.8,38,"1,034.71",244
,20161129,272.5,272.25,272.55,272.9,271.8,271.8,272.4,-.45,.15,18,490.37,242
,20161130,271.8,272.4,269.55,271.25,269.55,270.75,270.4,-1.65,-2,86,"2,325.59",250
,20161201,270.75,270.4,269.5,269.85,266.35,268,268.25,-2.4,-2.15,270,"7,242.95",298
,20161202,268,268.25,267.5,268,265.4,267.85,267.3,-.4,-.95,104,"2,780.04",304
,20161205,267.85,267.3,266.9,268.9,266.9,267.8,267.9,.5,.6,46,"1,232.42",306
,20161206,267.8,267.9,267.1,267.35,266.65,267.3,267.1,-.6,-.8,26,694.58,306
,20161207,267.3,267.1,267.2,267.65,266.85,267.3,267.15,.2,.05,30,801.51,314
,20161208,267.3,267.15,269.95,269.95,268.6,269.15,269.25,2,2.1,92,"2,477.12",302
,20161209,269.15,269.25,268.7,268.9,267.85,268.6,268.55,-.65,-.7,30,805.66,296
,20161212,268.6,268.55,268.05,268.05,266.15,266.7,267.3,-1.85,-1.25,28,748.57,288
,20161213,266.7,267.3,267.5,267.85,267.45,267.85,267.5,.55,.2,10,267.54,290
,20161214,267.85,267.5,267.8,269,267.8,269,268.15,1.5,.65,78,"2,091.65",304
,20161215,269,268.15,268,268.9,264.25,266.05,266.8,-2.1,-1.35,42,"1,120.62",302
,20161216,266.05,266.8,264.35,264.85,263.25,264.1,264.35,-2.7,-2.45,74,"1,956.52",330
,20161219,264.1,264.35,263.95,265.05,263.95,265.05,264.2,.7,-.15,26,686.93,328
,20161220,265.05,264.2,265.45,265.55,264.45,264.45,265.05,.25,.85,36,954.29,320
,20161221,264.45,265.05,261.5,263.55,261.45,263.55,262.1,-1.5,-2.95,24,629.07,322
,20161222,263.55,262.1,,,,262.1,262.1,0,0,0,0.00,322
,20161223,262.1,262.1,261.25,262.25,261.25,262,261.65,-.1,-.45,26,680.30,328
,20161226,262,261.65,261.8,261.95,261.25,261.95,261.35,.3,-.3,34,888.62,320
,20161227,261.95,261.35,262.45,263.95,262.45,263.95,263.4,2.6,2.05,8,210.72,320
,20161228,263.95,263.4,264.45,264.9,263.85,264.4,264.4,1,1,54,"1,427.95",328
,20161229,264.4,264.4,263.55,266.1,263.55,264.65,265.1,.25,.7,42,"1,113.62",350
,20161230,264.65,265.1,264,267.5,262.3,265.35,264.95,.25,-.15,312,"8,266.50",498
au1703,20161216,266.8,266.8,,,,266.8,266.8,0,0,0,0.00,0
,20161219,266.8,266.8,269.15,269.15,269.15,269.15,269.15,2.35,2.35,2,53.83,2
,20161220,269.15,269.15,,,,270,270,.85,.85,0,0.00,2
,20161221,270,270,,,,267,267,-3,-3,0,0.00,2
,20161222,267,267,,,,265.75,265.75,-1.25,-1.25,0,0.00,2
,20161223,265.75,265.75,,,,265.75,265.75,0,0,0,0.00,2
,20161226,265.75,265.75,,,,265.45,265.45,-.3,-.3,0,0.00,2
,20161227,265.45,265.45,,,,267.5,267.5,2.05,2.05,0,0.00,2
,20161228,267.5,267.5,266.55,266.55,266.55,266.55,266.55,-.95,-.95,2,53.31,4
,20161229,266.55,266.55,267.05,267.05,266.95,266.95,267,.4,.45,4,106.80,2
,20161230,266.95,267,269.95,269.95,269.95,269.95,269.95,2.95,2.95,2,53.99,0
au1704,20160316,261.55,261.55,,,,261.55,261.55,0,0,0,0.00,0
,20160317,261.55,261.55,,,,261.55,261.55,0,0,0,0.00,0
,20160318,261.55,261.55,267.6,268.25,267.6,268.25,267.9,6.7,6.35,4,107.17,4
,20160321,268.25,267.9,,,,267.9,267.9,0,0,0,0.00,4
,20160322,267.9,267.9,,,,267.9,267.9,0,0,0,0.00,4
,20160323,267.9,267.9,,,,267.9,267.9,0,0,0,0.00,4
,20160324,267.9,267.9,260,260,260,260,260,-7.9,-7.9,2,52.00,6
,20160325,260,260,,,,260,260,0,0,0,0.00,6
,20160328,260,260,258.05,258.75,257.4,258.75,258.15,-1.25,-1.85,8,206.53,12
,20160329,258.75,258.15,258.05,258.05,258.05,258.05,258.05,-.1,-.1,2,51.61,12
,20160330,258.05,258.05,259,263.25,259,260.65,261.1,2.6,3.05,18,469.99,8
,20160331,260.65,261.1,260.85,260.85,259.85,260,260,-1.1,-1.1,26,676.11,28
,20160401,260,260,261,261.45,261,261,261,1,1,42,"1,096.29",70
,20160405,261,261,258.9,258.9,258.9,258.9,258.9,-2.1,-2.1,16,414.24,54
,20160406,258.9,258.9,,,,258.9,258.9,0,0,0,0.00,54
,20160407,258.9,258.9,260.45,260.45,258.55,259.35,259.55,.45,.65,10,259.55,56
,20160408,259.35,259.55,261.4,262,261.4,262,261.65,2.45,2.1,8,209.32,56
,20160411,262,261.65,263.35,263.35,263.35,263.35,263.35,1.7,1.7,2,52.67,56
,20160412,263.35,263.35,264.75,265.4,263.8,264.2,264.6,.85,1.25,24,635.07,52
,20160413,264.2,264.6,264.95,264.95,264.95,264.95,264.95,.35,.35,6,158.97,56
,20160414,264.95,264.95,260.8,260.8,260.8,260.8,260.8,-4.15,-4.15,4,104.32,56
,20160415,260.8,260.8,259.1,260.9,259.1,259.6,259.85,-1.2,-.95,6,155.92,56
,20160418,259.6,259.85,260.05,261.05,260.05,261.05,260.55,1.2,.7,4,104.22,58
,20160419,261.05,260.55,261.85,261.85,260.6,260.6,261.2,.05,.65,4,104.49,56
,20160420,260.6,261.2,263.65,263.75,263.65,263.75,263.7,2.55,2.5,4,105.48,56
,20160421,263.75,263.7,264.65,265.75,264.65,265.2,265.15,1.5,1.45,20,530.39,70
,20160422,265.2,265.15,270.25,270.25,265.8,265.8,268,.65,2.85,4,107.21,74
,20160425,265.8,268,263.75,263.75,260.55,261.7,261.6,-6.3,-6.4,36,941.80,84
,20160426,261.7,261.6,262.2,262.9,262.2,262.9,262.55,1.3,.95,4,105.02,84
,20160427,262.9,262.55,262.25,264.75,262.25,264,263.65,1.45,1.1,6,158.20,88
,20160428,264,263.65,265.2,265.2,263.2,265.2,264.35,1.55,.7,36,951.81,96
,20160429,265.2,264.35,264.6,272.6,264.6,269.35,269,5,4.65,36,968.44,102
,20160503,269.35,269,274.8,275.15,273.55,274.1,274,5.1,5,74,"2,027.71",86
,20160504,274.1,274,274.8,274.8,270.7,272.3,273.2,-1.7,-.8,26,710.39,82
,20160505,272.3,273.2,273,273,271.85,271.85,272.5,-1.35,-.7,8,218.00,80
,20160506,271.85,272.5,271.25,271.8,270.05,271.8,271.15,-.7,-1.35,24,650.79,88
,20160509,271.8,271.15,273.75,273.8,271.35,271.35,272.75,.2,1.6,28,763.81,94
,20160510,271.35,272.75,270,270,268,268.9,268.55,-3.85,-4.2,86,"2,309.95",158
,20160511,268.9,268.55,269,270.65,268.2,270.65,268.95,2.1,.4,52,"1,398.70",198
,20160512,270.65,268.95,,,,268.95,268.95,0,0,0,0.00,198
,20160513,268.95,268.95,270.95,272.5,270.95,272.5,271.7,3.55,2.75,70,"1,902.10",236
,20160516,272.5,271.7,270.65,274.45,270.5,274,272.05,2.3,.35,70,"1,904.47",236
,20160517,274,272.05,270.85,270.85,270.85,270.85,270.85,-1.2,-1.2,2,54.17,236
,20160518,270.85,270.85,,,,270.85,270.85,0,0,0,0.00,236
,20160519,270.85,270.85,269.05,269.7,268.8,268.8,268.9,-2.05,-1.95,22,591.59,236
,20160520,268.8,268.9,266.15,268.15,266.15,268.15,266.7,-.75,-2.2,72,"1,920.43",254
,20160523,268.15,266.7,269.75,269.75,266.75,267,268.4,.3,1.7,30,805.20,250
,20160524,267,268.4,266.5,267.55,266.4,266.4,266.6,-2,-1.8,150,"3,999.05",200
,20160525,266.4,266.6,265.75,265.75,262.95,262.95,264.2,-3.65,-2.4,14,369.90,204
,20160526,262.95,264.2,261.75,262.65,260.15,262.65,260.9,-1.55,-3.3,60,"1,565.52",220
,20160527,262.65,260.9,261.8,261.8,259.45,259.85,260.7,-1.05,-.2,28,729.98,200
,20160530,259.85,260.7,259.5,259.5,259.3,259.3,259.4,-1.4,-1.3,10,259.40,190
,20160531,259.3,259.4,259.5,260,259.5,260,259.65,.6,.25,6,155.80,194
,20160601,260,259.65,,,,259.65,259.65,0,0,0,0.00,194
,20160602,259.65,259.65,260.45,261.5,260.45,261.5,261.05,1.85,1.4,6,156.63,198
,20160603,261.5,261.05,260.95,260.95,260.4,260.4,260.65,-.65,-.4,4,104.27,196
,20160606,260.4,260.65,266,266.6,265.5,266.1,265.8,5.45,5.15,98,"2,605.19",192
,20160607,266.1,265.8,267.1,267.1,266.7,266.7,266.9,.9,1.1,6,160.16,190
,20160608,266.7,266.9,266.45,268.75,266.45,268.75,267.75,1.85,.85,24,642.70,186
,20160613,268.75,267.75,274.85,276,274.85,275.65,275.45,7.9,7.7,14,385.67,192
,20160614,275.65,275.45,275.05,276.1,275.05,275.05,275.7,-.4,.25,46,"1,268.44",198
,20160615,275.05,275.7,277.1,277.25,275.75,277.1,276.5,1.4,.8,22,608.35,208
,20160616,277.1,276.5,275.65,281.95,275.65,281.95,279.25,5.45,2.75,22,614.40,210
,20160617,281.95,279.25,276.2,276.2,274.5,274.5,275.6,-4.75,-3.65,14,385.87,206
,20160620,274.5,275.6,275.55,275.75,274.95,275.1,275.35,-.5,-.25,12,330.43,202
,20160621,275.1,275.35,274.75,275,274.75,275,274.85,-.35,-.5,4,109.95,202
,20160622,275,274.85,272.45,273,272.05,272.05,272.1,-2.8,-2.75,70,"1,904.87",150
,20160623,272.05,272.1,271.05,272.25,271.05,272.25,271.65,.15,-.45,4,108.66,152
,20160624,272.25,271.65,273.95,285.2,272.75,283.3,280.05,11.65,8.4,30,840.15,158
,20160627,283.3,280.05,285.8,286.65,282.6,286.65,285.1,6.6,5.05,28,798.29,156
,20160628,286.65,285.1,286.35,286.85,284.7,285.15,285.55,.05,.45,14,399.81,152
,20160629,285.15,285.55,285.65,286.05,284.5,285.05,285.25,-.5,-.3,12,342.33,158
,20160630,285.05,285.25,285.65,285.65,284.5,284.5,285.05,-.75,-.2,18,513.12,152
,20160701,284.5,285.05,286.5,290.3,286.5,289,288.6,3.95,3.55,46,"1,327.59",142
,20160704,289,288.6,294.35,294.35,294.35,294.35,294.35,5.75,5.75,14,412.09,142
,20160705,294.35,294.35,292,292,292,292,292,-2.35,-2.35,2,58.40,142
,20160706,292,292,297.3,297.3,297.3,297.3,297.3,5.3,5.3,4,118.92,140
,20160707,297.3,297.3,,,,297.3,297.3,0,0,0,0.00,140
,20160708,297.3,297.3,293.85,294.95,293.75,294.8,294.6,-2.5,-2.7,14,412.44,140
,20160711,294.8,294.6,292.9,295.9,292.9,294.75,294.3,.15,-.3,68,"2,001.45",140
,20160712,294.75,294.3,295.6,295.6,295.6,295.6,295.6,1.3,1.3,2,59.12,138
,20160713,295.6,295.6,290.2,292.05,290.2,292.05,291.1,-3.55,-4.5,4,116.45,138
,20160714,292.05,291.1,292.35,292.8,291.2,291.2,291.65,.1,.55,24,700.04,134
,20160715,291.2,291.65,,,,291.65,291.65,0,0,0,0.00,134
,20160718,291.65,291.65,,,,291.65,291.65,0,0,0,0.00,134
,20160719,291.65,291.65,290.9,290.9,290.3,290.3,290.6,-1.35,-1.05,4,116.24,132
,20160720,290.3,290.6,290.35,291,289.75,289.75,290.45,-.85,-.15,14,406.65,138
,20160721,289.75,290.45,285.45,286.1,285.45,286.1,285.8,-4.35,-4.65,6,171.48,134
,20160722,286.1,285.8,,,,285.8,285.8,0,0,0,0.00,134
,20160725,285.8,285.8,,,,285.8,285.8,0,0,0,0.00,134
,20160726,285.8,285.8,,,,285.8,285.8,0,0,0,0.00,134
,20160727,285.8,285.8,286.25,286.25,286.25,286.25,286.25,.45,.45,2,57.25,132
,20160728,286.25,286.25,,,,286.25,286.25,0,0,0,0.00,132
,20160729,286.25,286.25,290.95,291.2,290.95,291.2,291.05,4.95,4.8,14,407.53,130
,20160801,291.2,291.05,290.8,292.2,290.8,292,291.75,.95,.7,8,233.40,130
,20160802,292,291.75,292.6,292.85,291.7,292.85,292.3,1.1,.55,8,233.85,130
,20160803,292.85,292.3,294.25,296.4,294.2,295,294.75,2.7,2.45,20,589.59,120
,20160804,295,294.75,294.15,294.15,292.45,292.45,293.45,-2.3,-1.3,10,293.47,122
,20160805,292.45,293.45,293.95,295.4,293.95,294.35,294.5,.9,1.05,20,589.02,122
,20160808,294.35,294.5,290.45,291.3,288.9,289.1,290.3,-5.4,-4.2,36,"1,045.09",138
,20160809,289.1,290.3,290.3,290.3,289.95,289.95,290.1,-.35,-.2,4,116.05,138
,20160810,289.95,290.1,290.45,292.85,290.45,292.85,291.55,2.75,1.45,6,174.95,140
,20160811,292.85,291.55,290.7,290.7,290.7,290.7,290.7,-.85,-.85,2,58.14,138
,20160812,290.7,290.7,,,,290.7,290.7,0,0,0,0.00,138
,20160815,290.7,290.7,,,,290.7,290.7,0,0,0,0.00,138
,20160816,290.7,290.7,,,,290.7,290.7,0,0,0,0.00,138
,20160817,290.7,290.7,,,,290.7,290.7,0,0,0,0.00,138
,20160818,290.7,290.7,289.05,289.05,289.05,289.05,289.05,-1.65,-1.65,4,115.62,138
,20160819,289.05,289.05,291.1,291.1,291.1,291.1,291.1,2.05,2.05,2,58.22,138
,20160822,291.1,291.1,289.7,289.7,288.6,288.6,289.45,-2.5,-1.65,16,463.17,154
,20160823,288.6,289.45,,,,289.45,289.45,0,0,0,0.00,154
,20160824,289.45,289.45,,,,289.45,289.45,0,0,0,0.00,154
,20160825,289.45,289.45,286.9,286.9,286.9,286.9,286.9,-2.55,-2.55,8,229.52,150
,20160826,286.9,286.9,286.35,287.4,285.95,287.4,286.3,.5,-.6,12,343.60,148
,20160829,287.4,286.3,287.8,287.9,285.6,285.75,286.75,-.55,.45,8,229.41,150
,20160830,285.75,286.75,286.55,287.75,286.25,287.75,286.6,1,-.15,22,630.55,156
,20160831,287.75,286.6,285.5,285.5,285.5,285.5,285.5,-1.1,-1.1,2,57.10,156
,20160901,285.5,285.5,284.95,284.95,284.95,284.95,284.95,-.55,-.55,2,56.99,154
,20160902,284.95,284.95,,,,284.95,284.95,0,0,0,0.00,154
,20160905,284.95,284.95,,,,284.95,284.95,0,0,0,0.00,154
,20160906,284.95,284.95,,,,284.95,284.95,0,0,0,0.00,154
,20160907,284.95,284.95,290.45,293.45,290.45,293.45,291.05,8.5,6.1,14,407.48,146
,20160908,293.45,291.05,,,,291.05,291.05,0,0,0,0.00,146
,20160909,291.05,291.05,,,,291.05,291.05,0,0,0,0.00,146
,20160912,291.05,291.05,290.6,290.6,289.7,289.7,290.15,-1.35,-.9,4,116.06,146
,20160913,289.7,290.15,288.85,290.25,288.7,289.75,289.15,-.4,-1,24,694.06,142
,20160914,289.75,289.15,288.85,288.95,286.95,286.95,288.35,-2.2,-.8,18,519.11,134
,20160919,286.95,288.35,,,,288.35,288.35,0,0,0,0.00,134
,20160920,288.35,288.35,286.9,287.15,286.8,287.15,287,-1.2,-1.35,8,229.60,134
,20160921,287.15,287,286.3,287.75,286.15,287.75,286.5,.75,-.5,36,"1,031.44",110
,20160922,287.75,286.5,287.8,289.75,287.8,289.75,288.75,3.25,2.25,4,115.51,114
,20160923,289.75,288.75,290.4,290.6,290.4,290.4,290.4,1.65,1.65,18,522.76,100
,20160926,290.4,290.4,290.5,290.65,289.75,289.9,290.25,-.5,-.15,16,464.45,94
,20160927,289.9,290.25,,,,290.25,290.25,0,0,0,0.00,94
,20160928,290.25,290.25,,,,290.25,290.25,0,0,0,0.00,94
,20160929,290.25,290.25,287.4,287.75,287,287.75,287.4,-2.5,-2.85,10,287.44,96
,20160930,287.75,287.4,287.1,287.1,287.1,287.1,287.1,-.3,-.3,4,114.84,92
,20161010,287.1,287.1,275.8,275.85,275.25,275.75,275.45,-11.35,-11.65,24,661.16,102
,20161011,275.75,275.45,275.9,276.25,275.5,275.9,275.8,.45,.35,12,331.00,106
,20161012,275.9,275.8,275.5,275.5,275.5,275.5,275.5,-.3,-.3,4,110.20,106
,20161013,275.5,275.5,,,,275.5,275.5,0,0,0,0.00,106
,20161014,275.5,275.5,,,,275.5,275.5,0,0,0,0.00,106
,20161017,275.5,275.5,275.2,276.4,275.2,276.4,275.7,.9,.2,12,330.84,108
,20161018,276.4,275.7,,,,275.7,275.7,0,0,0,0.00,108
,20161019,275.7,275.7,,,,275.7,275.7,0,0,0,0.00,108
,20161020,275.7,275.7,278.8,279.4,278.8,279.4,279.1,3.7,3.4,4,111.64,104
,20161021,279.4,279.1,280,280,278.55,278.55,279.25,-.55,.15,4,111.71,104
,20161024,278.55,279.25,278.8,278.8,278.8,278.8,278.8,-.45,-.45,2,55.76,102
,20161025,278.8,278.8,279.1,279.1,279.1,279.1,279.1,.3,.3,4,111.64,100
,20161026,279.1,279.1,281.35,281.4,281.35,281.4,281.35,2.3,2.25,6,168.82,94
,20161027,281.4,281.35,280.2,280.2,280.2,280.2,280.2,-1.15,-1.15,2,56.04,94
,20161028,280.2,280.2,280.65,280.65,280.65,280.65,280.65,.45,.45,4,112.26,90
,20161031,280.65,280.65,282.05,282.25,282.05,282.25,282.1,1.6,1.45,12,338.54,102
,20161101,282.25,282.1,281.75,282.45,281.75,282.45,282,.35,-.1,18,507.61,90
,20161102,282.45,282,284.1,285,284,285,284.35,3,2.35,6,170.62,90
,20161103,285,284.35,286.05,286.65,285.9,286.65,286.15,2.3,1.8,22,629.61,100
,20161104,286.65,286.15,285.85,285.85,285,285,285.4,-1.15,-.75,4,114.17,102
,20161107,285,285.4,284.15,284.45,284.15,284.45,284.2,-.95,-1.2,10,284.21,94
,20161108,284.45,284.2,283.65,284.4,283.45,283.45,283.8,-.75,-.4,16,454.12,92
,20161109,283.45,283.8,283.05,292.4,281.9,289.2,290.15,5.4,6.35,118,"3,424.29",178
,20161110,289.2,290.15,288.6,288.6,284.15,285.95,285.45,-4.2,-4.7,18,513.83,182
,20161111,285.95,285.45,284.85,284.85,280.6,281.3,281.4,-4.15,-4.05,28,787.96,190
,20161114,281.3,281.4,280.5,280.5,270.95,272.9,273.1,-8.5,-8.3,158,"4,315.46",266
,20161115,272.9,273.1,273.55,276.75,273.55,275.75,274.85,2.65,1.75,40,"1,099.52",270
,20161116,275.75,274.85,275.75,277.25,275.45,277.25,276.05,2.4,1.2,16,441.72,264
,20161117,277.25,276.05,277,277,277,277,277,.95,.95,2,55.40,262
,20161118,277,277,275.3,275.3,273.2,273.2,273.75,-3.8,-3.25,24,657.04,268
,20161121,273.2,273.75,274.2,275.4,273.8,275.4,274.35,1.65,.6,14,384.09,264
,20161122,275.4,274.35,275.85,277,275.75,276.95,276.3,2.6,1.95,30,828.97,262
,20161123,276.95,276.3,276.3,276.3,276.3,276.3,276.3,0,0,2,55.26,260
,20161124,276.3,276.3,274.3,274.3,273.2,273.2,273.8,-3.1,-2.5,6,164.28,258
,20161125,273.2,273.8,273.2,273.55,269.05,269.9,272,-3.9,-1.8,30,816.10,262
,20161128,269.9,272,273.75,275.15,273.75,274.5,274.3,2.5,2.3,20,548.63,262
,20161129,274.5,274.3,,,,274.3,274.3,0,0,0,0.00,262
,20161130,274.3,274.3,272.5,272.5,268.45,271.7,271.25,-2.6,-3.05,12,325.55,262
,20161201,271.7,271.25,268.05,269.8,268.05,269.5,268.85,-1.75,-2.4,72,"1,935.83",238
,20161202,269.5,268.85,268.35,269.65,268.15,268.5,268.85,-.35,0,192,"5,162.50",316
,20161205,268.5,268.85,268.45,270.45,267.85,269.6,269.5,.75,.65,92,"2,479.40",352
,20161206,269.6,269.5,268.5,269.55,267.5,268.85,269.15,-.65,-.35,32,861.30,360
,20161207,268.85,269.15,267.95,267.95,267.65,267.65,267.65,-1.5,-1.5,16,428.30,360
,20161208,267.65,267.65,269.8,270.45,269.8,270,270,2.35,2.35,38,"1,026.16",366
,20161209,270,270,268,269.6,268,269.05,268.55,-.95,-1.45,14,376.02,362
,20161212,269.05,268.55,265.75,267.95,265.75,267.95,267.3,-.6,-1.25,14,374.25,364
,20161213,267.95,267.3,268.3,269.2,268.2,268.45,268.7,1.15,1.4,24,644.92,358
,20161214,268.45,268.7,267.75,268.6,267.7,268.5,268.35,-.2,-.35,46,"1,234.62",348
,20161215,268.5,268.35,268.4,269.6,264.7,266.4,267.65,-1.95,-.7,92,"2,462.45",334
,20161216,266.4,267.65,265,265.15,264.55,264.95,264.95,-2.7,-2.7,36,953.94,330
,20161219,264.95,264.95,264.65,266.15,264.6,266.15,264.9,1.2,-.05,28,741.75,328
,20161220,266.15,264.9,265.75,265.75,264.5,264.5,265.25,-.4,.35,30,795.81,324
,20161221,264.5,265.25,262.15,264.1,262.15,264.1,263.2,-1.15,-2.05,6,157.92,322
,20161222,264.1,263.2,263.2,263.25,262.1,262.1,262.6,-1.1,-.6,22,577.75,322
,20161223,262.1,262.6,261.95,263,261.95,262.9,262.3,.3,-.3,16,419.75,322
,20161226,262.9,262.3,262.95,263.8,262.5,263.2,263.05,.9,.75,30,789.26,322
,20161227,263.2,263.05,,,,263.05,263.05,0,0,0,0.00,322
,20161228,263.05,263.05,264.65,266.3,264.65,266.3,265.75,3.25,2.7,10,265.78,318
,20161229,266.3,265.75,267.5,267.75,267,267,267.3,1.25,1.55,26,695.05,316
,20161230,267,267.3,269.8,269.95,269.65,269.95,269.8,2.65,2.5,6,161.88,318
au1706,20160517,272.05,272.05,,,,272.05,272.05,0,0,0,0.00,0
,20160518,272.05,272.05,274.25,274.5,272.2,272.2,273.55,.15,1.5,26,711.35,8
,20160519,272.2,273.55,275,275,268.3,269.2,270.1,-4.35,-3.45,44,"1,188.57",20
,20160520,269.2,270.1,267,269.5,266.9,268.5,268,-1.6,-2.1,54,"1,447.33",44
,20160523,268.5,268,268.05,268.9,267.7,267.7,268.15,-.3,.15,22,590.03,52
,20160524,267.7,268.15,266.45,267.8,266.45,267.5,267.25,-.65,-.9,6,160.35,56
,20160525,267.5,267.25,265.7,265.75,262.1,262.1,264.05,-5.15,-3.2,44,"1,162.02",78
,20160526,262.1,264.05,261.85,263.6,260.8,262.7,262.15,-1.35,-1.9,16,419.45,84
,20160527,262.7,262.15,262.7,262.8,260,262,261.3,-.15,-.85,32,836.25,94
,20160530,262,261.3,260.8,261.25,257.9,259.7,259.1,-1.6,-2.2,64,"1,658.27",136
,20160531,259.7,259.1,259.05,261.5,258.95,261.2,260.05,2.1,.95,94,"2,444.69",156
,20160601,261.2,260.05,261.1,262.55,260.85,261.95,262.2,1.9,2.15,92,"2,412.32",200
,20160602,261.95,262.2,261,263,260.1,263,261,.8,-1.2,64,"1,670.62",204
,20160603,263,261,261,261,260.15,260.95,260.55,-.05,-.45,42,"1,094.47",222
,20160606,260.95,260.55,265.55,266.65,265.05,266.3,266,5.75,5.45,182,"4,841.62",350
,20160607,266.3,266,266.7,267.65,266.6,266.65,267.25,.65,1.25,126,"3,367.71",386
,20160608,266.65,267.25,265.85,268.7,265.85,268.6,267.55,1.35,.3,74,"1,980.08",400
,20160613,268.6,267.55,274.15,276.05,273.6,276.05,275.1,8.5,7.55,362,"9,960.01",582
,20160614,276.05,275.1,277.15,278.2,274.7,274.95,275.2,-.15,.1,342,"9,412.14",748
,20160615,274.95,275.2,276.75,277.3,275.75,276.9,276.6,1.7,1.4,360,"9,958.45",840
,20160616,276.9,276.6,275.65,282,275.6,281.7,278.95,5.1,2.35,1002,"27,953.03",1392
,20160617,281.7,278.95,282,282.9,274.05,274.7,278.05,-4.25,-.9,822,"22,858.41",1388
,20160620,274.7,278.05,278.25,278.3,274.75,275.7,276.2,-2.35,-1.85,296,"8,176.40",1414
,20160621,275.7,276.2,275.35,276.7,274.55,275,275.35,-1.2,-.85,238,"6,553.68",1424
,20160622,275,275.35,270.95,273.35,270.75,271.65,271.9,-3.7,-3.45,256,"6,961.40",1444
,20160623,271.65,271.9,271.55,272.85,271,271.95,271.65,.05,-.25,166,"4,509.94",1468
,20160624,271.95,271.65,270.45,285.2,270.45,284.1,281.5,12.45,9.85,1902,"53,550.57",2220
,20160627,284.1,281.5,284.15,286.65,282.15,286.35,284.85,4.85,3.35,1180,"33,615.26",2344
,20160628,286.35,284.85,286.95,287,284.6,285.2,285.65,.35,.8,328,"9,370.77",2320
,20160629,285.2,285.65,284.3,286.4,284,286,285,.35,-.65,378,"10,774.11",2278
,20160630,286,285,286,287,284.35,284.8,285.25,-.2,.25,724,"20,652.83",2346
,20160701,284.8,285.25,285.6,290.15,285.2,289.15,288.05,3.9,2.8,788,"22,701.06",2470
,20160704,289.15,288.05,289.35,295.5,289.35,293.75,292.65,5.7,4.6,1136,"33,250.57",2718
,20160705,293.75,292.65,293.85,294.55,290.6,292.2,292.65,-.45,0,674,"19,727.54",2728
,20160706,292.2,292.65,293.3,299.5,291.7,298.2,297.05,5.55,4.4,1544,"45,870.57",3112
,20160707,298.2,297.05,298.2,299.15,296.85,297.95,298.05,.9,1,888,"26,470.74",3294
,20160708,297.95,298.05,297.6,297.6,293.5,295.15,294.95,-2.9,-3.1,534,"15,751.94",3282
,20160711,295.15,294.95,294.05,299,292.35,296.7,296.9,1.75,1.95,906,"26,902.35",3454
,20160712,296.7,296.9,294.85,296.65,294.55,295.5,295.7,-1.4,-1.2,912,"26,968.44",3852
,20160713,295.5,295.7,295.3,295.3,289.7,292.5,291.75,-3.2,-3.95,1432,"41,783.77",4128
,20160714,292.5,291.75,292.5,293.6,290.4,290.65,291.85,-1.1,.1,504,"14,709.34",4150
,20160715,290.65,291.85,288.25,291,287.65,290.55,289.5,-1.3,-2.35,572,"16,560.60",4224
,20160718,290.55,289.5,290.45,290.8,288.55,289.9,289.65,.4,.15,460,"13,324.44",4210
,20160719,289.9,289.65,289.1,291.9,289.1,290.8,290.65,1.15,1,444,"12,906.79",4226
,20160720,290.8,290.65,290.8,291.4,289.05,289.05,290.35,-1.6,-.3,604,"17,538.38",4414
,20160721,289.05,290.35,287.9,287.9,285.3,286.7,286.3,-3.65,-4.05,1354,"38,767.79",4572
,20160722,286.7,286.3,286.8,289.8,286.3,288,288.15,1.7,1.85,442,"12,738.10",4586
,20160725,288,288.15,288,288,285.7,286.75,286.8,-1.4,-1.35,448,"12,848.75",4566
,20160726,286.75,286.8,286.75,288.1,285.6,286.75,286.9,-.05,.1,554,"15,896.92",4490
,20160727,286.75,286.9,287.15,287.75,286.35,287.15,287.1,.25,.2,816,"23,430.51",4656
,20160728,287.15,287.1,287.55,291.75,287.55,291.25,290.35,4.15,3.25,664,"19,280.35",4740
,20160729,291.25,290.35,291.6,291.6,289,289.4,290.1,-.95,-.25,484,"14,042.50",4792
,20160801,289.4,290.1,291.35,292.45,290,291.9,291.55,1.8,1.45,536,"15,627.32",4862
,20160802,291.9,291.55,291.9,293.3,291.7,293.05,292.4,1.5,.85,570,"16,667.49",4956
,20160803,293.05,292.4,296,296,294,294.45,294.7,2.05,2.3,430,"12,672.90",5058
,20160804,294.45,294.7,294.2,294.2,291.55,291.75,292.8,-2.95,-1.9,500,"14,641.92",5100
,20160805,291.75,292.8,294.1,295.45,293.8,295.3,294.6,2.5,1.8,674,"19,857.27",5208
,20160808,295.3,294.6,292,292,288.8,289.15,290.1,-5.45,-4.5,1676,"48,626.78",5804
,20160809,289.15,290.1,289.15,290,288.5,288.5,289.15,-1.6,-.95,1178,"34,062.34",6170
,20160810,288.5,289.15,288.65,293.15,288.65,292.8,291.25,3.65,2.1,1248,"36,352.33",6256
,20160811,292.8,291.25,293,293,289.9,290.3,290.7,-.95,-.55,1694,"49,248.86",6440
,20160812,290.3,290.7,290.85,292.45,289,290.2,290.7,-.5,0,1376,"40,003.94",6770
,20160815,290.2,290.7,292.65,292.85,284.2,289.6,289.95,-1.1,-.75,1610,"46,687.65",6886
,20160816,289.6,289.95,289.15,291.6,288.95,291.1,290.55,1.15,.6,5036,"146,340.65",8556
,20160817,291.1,290.55,291.1,291.1,289.3,289.65,290,-.9,-.55,3306,"95,883.75",9554
,20160818,289.65,290,289.75,292.3,288.1,291.4,291.5,1.4,1.5,3288,"95,851.26",10216
,20160819,291.4,291.5,291.35,292.1,290.25,291.35,291.35,-.15,-.15,3300,"96,146.63",11526
,20160822,291.35,291.35,288.8,291.45,288.4,288.95,289.35,-2.4,-2,2736,"79,170.77",12028
,20160823,288.95,289.35,289.25,289.7,289,289.5,289.35,.15,0,1364,"39,471.20",12560
,20160824,289.5,289.35,290.2,290.5,289.2,289.7,289.55,.35,.2,2508,"72,622.15",13794
,20160825,289.7,289.55,289.1,289.1,286.55,286.85,287.2,-2.7,-2.35,1852,"53,194.54",13874
,20160826,286.85,287.2,285.9,287.2,285.45,286.95,286.5,-.25,-.7,1388,"39,769.40",14192
,20160829,286.95,286.5,288.35,290.8,285.45,286,287.45,-.5,.95,4236,"121,772.68",14666
,20160830,286,287.45,286.45,287.65,286.45,286.8,287.05,-.65,-.4,1112,"31,923.80",14856
,20160831,286.8,287.05,286.45,286.95,285.15,285.55,286,-1.5,-1.05,2166,"61,953.26",15336
,20160901,285.55,286,284.6,285.65,284.5,284.65,285.05,-1.35,-.95,2980,"84,945.76",15480
,20160902,284.65,285.05,284.2,286.1,283.95,285.15,285.45,.1,.4,1802,"51,445.95",15756
,20160905,285.15,285.45,287.6,290.1,286.95,288.8,288.05,3.35,2.6,2726,"78,522.50",16294
,20160906,288.8,288.05,288.8,289.25,288.55,288.9,288.85,.85,.8,1766,"51,019.11",16918
,20160907,288.9,288.85,290.2,293.85,290.2,293.1,292.3,4.25,3.45,4862,"142,119.30",18402
,20160908,293.1,292.3,293.1,293.1,291.5,292.75,292.3,.45,0,1900,"55,545.88",18850
,20160909,292.75,292.3,292.55,292.55,290.65,291.1,291.4,-1.2,-.9,3884,"113,183.85",20478
,20160912,291.1,291.4,290.95,291.4,288.95,290.15,289.75,-1.25,-1.65,4358,"126,280.76",22290
,20160913,290.15,289.75,288.95,290.75,288.3,289.85,289.6,.1,-.15,2168,"62,786.32",22530
,20160914,289.85,289.6,289,289.5,287.2,288.4,288,-1.2,-1.6,3108,"89,513.19",22996
,20160919,288.4,288,286.35,287.05,285.5,286.7,286.45,-1.3,-1.55,1922,"55,063.21",23436
,20160920,286.7,286.45,286.4,287.2,286.4,287.2,286.85,.75,.4,1518,"43,548.01",23558
,20160921,287.2,286.85,286.85,288.3,286.1,287.35,287,.5,.15,5096,"146,264.13",25210
,20160922,287.35,287,289.45,290.2,286.85,289.8,289.3,2.8,2.3,5018,"145,195.24",25380
,20160923,289.8,289.3,290.35,291.7,289.95,290.45,290.45,1.15,1.15,4514,"131,130.42",24922
,20160926,290.45,290.45,290.9,291.05,289.85,290.35,290.4,-.1,-.05,3626,"105,305.35",26296
,20160927,290.35,290.4,290.8,291.65,289.95,290.2,290.9,-.2,.5,2712,"78,895.36",27014
,20160928,290.2,290.9,290.05,290.05,287.55,287.7,288.25,-3.2,-2.65,5068,"146,095.85",25946
,20160929,287.7,288.25,287.7,288.2,286.65,287.05,287.6,-1.2,-.65,4074,"117,170.11",26058
,20160930,287.05,287.6,286.5,287.8,286.15,287.5,286.95,-.1,-.65,3466,"99,463.51",25790
,20161010,287.5,286.95,275,276.4,274.7,276.2,275.6,-10.75,-11.35,8808,"242,789.46",28402
,20161011,276.2,275.6,275.5,276.45,275.4,276.25,275.85,.65,.25,9186,"253,439.75",32372
,20161012,276.25,275.85,275.35,276.45,275.2,275.45,275.65,-.4,-.2,8962,"247,050.66",35466
,20161013,275.45,275.65,275.35,276.9,274.75,276.55,275.75,.9,.1,6780,"186,981.39",36314
,20161014,276.55,275.75,276.15,277.1,275.65,275.75,276.15,0,.4,7096,"195,971.26",38868
,20161017,275.75,276.15,275.2,276.55,275,276.15,275.75,0,-.4,11458,"315,959.91",43204
,20161018,276.15,275.75,276,277.8,275.95,277.7,276.9,1.95,1.15,11098,"307,304.79",47572
,20161019,277.7,276.9,277.55,278.2,276.65,277.7,277.55,.8,.65,12006,"333,284.76",51292
,20161020,277.7,277.55,279.05,280.1,279.05,279.7,279.55,2.15,2,9314,"260,403.97",51710
,20161021,279.7,279.55,279.7,280.3,278.15,278.7,278.75,-.85,-.8,8866,"247,156.95",52778
,20161024,278.7,278.75,279.1,279.85,278.9,279.6,279.3,.85,.55,19834,"554,007.14",61398
,20161025,279.6,279.3,280.8,281.85,279.05,280.45,280,1.15,.7,21440,"600,422.09",66722
,20161026,280.45,280,280.9,282.35,280.45,281.6,281.7,1.6,1.7,43338,"1,220,947.52",76298
,20161027,281.6,281.7,281.05,281.5,279.85,280.7,280.35,-1,-1.35,34970,"980,517.95",90396
,20161028,280.7,280.35,281.25,281.4,280.45,280.85,280.95,.5,.6,33092,"929,877.45",101590
,20161031,280.85,280.95,280.1,283.75,279.9,282.1,282.05,1.15,1.1,47570,"1,341,834.88",114090
,20161101,282.1,282.05,281.85,283.6,281.65,283.1,282.65,1.05,.6,48358,"1,366,858.68",131152
,20161102,283.1,282.65,284.35,285.95,283.8,285.85,284.75,3.2,2.1,56654,"1,613,319.43",135696
,20161103,285.85,284.75,286.05,287.75,284.85,286.65,286.65,1.9,1.9,62574,"1,793,846.74",139998
,20161104,286.65,286.65,285.25,287.25,284.8,284.85,285.85,-1.8,-.8,64678,"1,848,975.16",139660
,20161107,284.85,285.85,286.85,287.3,284.25,284.45,285.65,-1.4,-.2,68358,"1,952,707.51",142796
,20161108,284.45,285.65,284.15,284.55,282.5,284.15,283.7,-1.5,-1.95,68224,"1,935,780.61",161280
,20161109,284.15,283.7,283.3,293,281.75,291.65,287.3,7.95,3.6,270780,"7,780,284.66",179558
,20161110,291.65,287.3,288,289.6,283.3,286.15,286.45,-1.15,-.85,217030,"6,217,735.92",199378
,20161111,286.15,286.45,285.05,286,279.25,281.75,282.4,-4.7,-4.05,248716,"7,024,610.77",217910
,20161114,281.75,282.4,280.9,282,269.8,272.95,275.2,-9.45,-7.2,360232,"9,914,513.11",228372
,20161115,272.95,275.2,273.95,276.45,272.8,275.95,274.5,.75,-.7,245686,"6,745,201.88",229724
,20161116,275.95,274.5,275.85,277.65,275,277.05,276.35,2.55,1.85,180050,"4,976,364.36",233816
,20161117,277.05,276.35,276.55,277.5,276.25,276.5,276.85,.15,.5,136938,"3,791,293.79",235730
,20161118,276.5,276.85,277,277.15,273.05,273.45,274.95,-3.4,-1.9,216120,"5,942,395.47",241806
,20161121,273.45,274.95,273.85,275.6,273,275.55,274.25,.6,-.7,189682,"5,202,074.83",248640
,20161122,275.55,274.25,275.6,276.95,274.5,276.25,276,2,1.75,179428,"4,952,520.12",253582
,20161123,276.25,276,276.2,276.95,275.05,276.6,276,.6,0,177860,"4,909,799.11",255416
,20161124,276.6,276,276,276,272.7,273.7,273.8,-2.3,-2.2,340644,"9,327,114.07",266746
,20161125,273.7,273.8,273.4,273.65,268.45,271.4,271.25,-2.4,-2.55,253516,"6,877,429.03",272100
,20161128,271.4,271.25,272.5,275.3,271.25,273.8,273.2,2.55,1.95,256832,"7,016,963.55",272312
,20161129,273.8,273.2,273.6,274.55,272.4,272.75,273.5,-.45,.3,204490,"5,593,173.84",275378
,20161130,272.75,273.5,271.5,272.3,270.55,271.05,271.3,-2.45,-2.2,200036,"5,427,586.05",278538
,20161201,271.05,271.3,270.15,270.9,266.6,269.25,269.05,-2.05,-2.25,318392,"8,566,597.02",296638
,20161202,269.25,269.05,267.95,269.4,266.6,268.85,268,-.2,-1.05,206838,"5,543,737.25",301358
,20161205,268.85,268,268.1,270.9,267.05,268.75,269.1,.75,1.1,289230,"7,784,438.76",302008
,20161206,268.75,269.1,268.3,269.5,267.1,268.15,268.25,-.95,-.85,234960,"6,303,009.08",315832
,20161207,268.15,268.25,268.6,268.65,267.45,267.7,268,-.55,-.25,170588,"4,572,323.51",326816
,20161208,267.7,268,268.6,270.95,268.35,269.75,269.75,1.75,1.75,244680,"6,600,334.66",329794
,20161209,269.75,269.75,269.35,270.2,268.3,269.5,269.3,-.25,-.45,177508,"4,781,128.06",331766
,20161212,269.5,269.3,268.35,269.35,267.2,267.95,268.25,-1.35,-1.05,203912,"5,470,542.09",344840
,20161213,267.95,268.25,267.7,269.35,267.25,268.2,268.4,-.05,.15,173102,"4,646,850.15",349590
,20161214,268.2,268.4,268.15,269.9,267.65,269.65,268.75,1.25,.35,247566,"6,653,676.55",366272
,20161215,269.65,268.75,269.6,270.6,264.8,266.95,267.9,-1.8,-.85,312470,"8,371,549.15",366840
,20161216,266.95,267.9,265,265.85,264.3,265.35,265.3,-2.55,-2.6,235872,"6,257,733.17",357144
,20161219,265.35,265.3,265.45,266.95,265.1,266.6,266.05,1.3,.75,172448,"4,588,087.19",356986
,20161220,266.6,266.05,266.45,266.9,264.55,265.25,266.15,-.8,.1,157024,"4,179,699.09",353076
,20161221,265.25,266.15,263.8,265.45,262.1,264.85,263.55,-1.3,-2.6,208540,"5,496,788.54",354770
,20161222,264.85,263.55,264.45,264.85,262.8,263.3,263.85,-.25,.3,119052,"3,141,313.96",360090
,20161223,263.3,263.85,262.8,264.3,262.45,263.55,263.55,-.3,-.3,155500,"4,098,482.27",366702
,20161226,263.55,263.55,263.75,265.1,263.3,264.75,264.05,1.2,.5,127840,"3,376,136.11",359872
,20161227,264.75,264.05,264.85,266.1,264.4,266.1,265.35,2.05,1.3,132016,"3,503,441.09",367772
,20161228,266.1,265.35,266.15,267.85,265.35,267.3,266.55,1.95,1.2,172420,"4,596,667.99",368704
,20161229,267.3,266.55,266.5,269.15,266,268.75,267.7,2.2,1.15,217154,"5,813,509.14",370722
,20161230,268.75,267.7,268.05,272.15,268,271.35,270.35,3.65,2.65,257682,"6,967,713.85",383078
au1708,20160718,289.5,289.5,,,,289.5,289.5,0,0,0,0.00,0
,20160719,289.5,289.5,,,,289.5,289.5,0,0,0,0.00,0
,20160720,289.5,289.5,289.5,289.5,289.5,289.5,289.5,0,0,2,57.90,2
,20160721,289.5,289.5,,,,289.5,289.5,0,0,0,0.00,2
,20160722,289.5,289.5,291.05,291.05,289.05,290.4,290.15,.9,.65,6,174.10,2
,20160725,290.4,290.15,,,,290.15,290.15,0,0,0,0.00,2
,20160726,290.15,290.15,289.25,289.85,287.7,287.7,288.95,-2.45,-1.2,160,"4,623.63",128
,20160727,287.7,288.95,289,289,288.55,288.55,288.7,-.4,-.25,64,"1,847.92",188
,20160728,288.55,288.7,289.75,293.6,289.15,293.6,290.4,4.9,1.7,10,290.42,190
,20160729,293.6,290.4,,,,290.4,290.4,0,0,0,0.00,190
,20160801,290.4,290.4,291.5,291.5,291.5,291.5,291.5,1.1,1.1,2,58.30,192
,20160802,291.5,291.5,,,,291.5,291.5,0,0,0,0.00,192
,20160803,291.5,291.5,,,,291.5,291.5,0,0,0,0.00,192
,20160804,291.5,291.5,,,,291.5,291.5,0,0,0,0.00,192
,20160805,291.5,291.5,297.25,297.25,296.8,296.8,296.95,5.3,5.45,6,178.18,198
,20160808,296.8,296.95,292.7,292.7,290.7,290.7,291.7,-6.25,-5.25,8,233.36,206
,20160809,290.7,291.7,291.35,291.35,291,291.2,291.1,-.5,-.6,18,524.01,216
,20160810,291.2,291.1,295.05,295.3,295.05,295.3,295.15,4.2,4.05,8,236.15,220
,20160811,295.3,295.15,294.15,294.8,294.15,294.8,294.35,-.35,-.8,6,176.62,226
,20160812,294.8,294.35,,,,294.35,294.35,0,0,0,0.00,226
,20160815,294.35,294.35,291.95,291.95,291.95,291.95,291.95,-2.4,-2.4,4,116.78,226
,20160816,291.95,291.95,,,,291.95,291.95,0,0,0,0.00,226
,20160817,291.95,291.95,291.7,291.7,290.75,290.75,291.05,-1.2,-.9,6,174.64,224
,20160818,290.75,291.05,291.5,293.8,291.5,293.65,293.1,2.6,2.05,26,762.18,202
,20160819,293.65,293.1,,,,293.1,293.1,0,0,0,0.00,202
,20160822,293.1,293.1,290.35,290.35,290.3,290.3,290.3,-2.8,-2.8,4,116.13,206
,20160823,290.3,290.3,,,,290.3,290.3,0,0,0,0.00,206
,20160824,290.3,290.3,291.5,291.5,290.75,290.75,291.25,.45,.95,6,174.75,212
,20160825,290.75,291.25,289.5,289.5,288.55,288.85,289,-2.4,-2.25,24,693.67,234
,20160826,288.85,289,287.75,289.6,287.75,289.25,289.15,.25,.15,16,462.67,242
,20160829,289.25,289.15,289.7,289.8,288,288,288.85,-1.15,-.3,12,346.66,248
,20160830,288,288.85,288.95,288.95,288.95,288.95,288.95,.1,.1,8,231.16,240
,20160831,288.95,288.95,287.9,287.9,287.75,287.75,287.75,-1.2,-1.2,14,402.91,240
,20160901,287.75,287.75,287.2,287.2,286.65,286.65,287.05,-1.1,-.7,8,229.65,240
,20160902,286.65,287.05,287.35,287.35,287.35,287.35,287.35,.3,.3,4,114.94,244
,20160905,287.35,287.35,289.4,290.4,289.4,290.4,290,3.05,2.65,18,522.07,234
,20160906,290.4,290,290.5,290.7,290,290,290.25,0,.25,12,348.34,232
,20160907,290,290.25,291.35,294.1,291.25,294.1,292.2,3.85,1.95,28,818.21,228
,20160908,294.1,292.2,,,,292.2,292.2,0,0,0,0.00,228
,20160909,292.2,292.2,292.4,292.4,292.4,292.4,292.4,.2,.2,2,58.48,228
,20160912,292.4,292.4,292.45,292.7,290.95,291.4,291.7,-1,-.7,58,"1,692.01",220
,20160913,291.4,291.7,292.1,292.1,292.1,292.1,292.1,.4,.4,2,58.42,220
,20160914,292.1,292.1,289.15,290,289.15,290,289.5,-2.1,-2.6,10,289.52,224
,20160919,290,289.5,288.05,289.8,288.05,289.8,288.9,.3,-.6,4,115.57,226
,20160920,289.8,288.9,288.75,289.55,288.45,289,288.85,.1,-.05,50,"1,444.39",258
,20160921,289,288.85,288.4,289.75,288.25,289.35,289.05,.5,.2,50,"1,445.27",252
,20160922,289.35,289.05,290.3,292.1,289.95,291.65,291,2.6,1.95,44,"1,280.60",248
,20160923,291.65,291,292,292.9,291.9,291.9,292.3,.9,1.3,28,818.57,240
,20160926,291.9,292.3,291.95,291.95,291.6,291.6,291.7,-.7,-.6,10,291.73,238
,20160927,291.6,291.7,292.75,292.75,292.05,292.05,292.4,.35,.7,4,116.96,236
,20160928,292.05,292.4,290.5,290.5,289.4,289.4,289.75,-3,-2.65,18,521.62,246
,20160929,289.4,289.75,289.75,289.95,289.1,289.1,289.55,-.65,-.2,8,231.67,244
,20160930,289.1,289.55,288.1,288.5,288.1,288.5,288.3,-1.05,-1.25,8,230.64,244
,20161010,288.5,288.3,285.75,285.75,277,277.2,277.95,-11.1,-10.35,30,833.90,268
,20161011,277.2,277.95,277.6,278,277.6,277.9,277.85,-.05,-.1,78,"2,167.36",328
,20161012,277.9,277.85,277.75,278,277.65,277.7,277.75,-.15,-.1,20,555.51,330
,20161013,277.7,277.75,277.35,278.75,276.75,278.35,277.65,.6,-.1,36,999.62,328
,20161014,278.35,277.65,277.35,277.35,277.35,277.35,277.35,-.3,-.3,2,55.47,328
,20161017,277.35,277.35,277.8,278.7,277.8,278.7,278.3,1.35,.95,12,333.96,336
,20161018,278.7,278.3,278.4,279.9,278.35,279.9,278.85,1.6,.55,6,167.33,338
,20161019,279.9,278.85,281.3,281.3,279.55,279.9,280.05,1.05,1.2,22,616.11,332
,20161020,279.9,280.05,281.65,281.9,281.5,281.8,281.7,1.75,1.65,14,394.40,334
,20161021,281.8,281.7,282.35,282.35,281.85,281.85,282.1,.15,.4,4,112.84,334
,20161024,281.85,282.1,281.55,281.55,281.55,281.55,281.55,-.55,-.55,2,56.31,334
,20161025,281.55,281.55,,,,281.55,281.55,0,0,0,0.00,334
,20161026,281.55,281.55,284,284.25,284,284.25,284.05,2.7,2.5,8,227.25,326
,20161027,284.25,284.05,282.45,282.85,282.45,282.85,282.6,-1.2,-1.45,10,282.62,328
,20161028,282.85,282.6,,,,282.6,282.6,0,0,0,0.00,328
,20161031,282.6,282.6,283.4,284.65,283.4,284.5,284.15,1.9,1.55,6,170.51,326
,20161101,284.5,284.15,284.35,286,284.2,285.3,284.75,1.15,.6,30,854.28,316
,20161102,285.3,284.75,287.3,288,286.75,288,287.2,3.25,2.45,26,746.76,308
,20161103,288,287.2,288.9,289.9,288.4,289.4,289.25,2.2,2.05,22,636.39,310
,20161104,289.4,289.25,288.1,289.7,288.1,288.3,289.1,-.95,-.15,22,636.05,318
,20161107,288.3,289.1,,,,289.1,289.1,0,0,0,0.00,318
,20161108,289.1,289.1,285.4,286,285.3,286,285.4,-3.1,-3.7,224,"6,393.68",344
,20161109,286,285.4,286.65,294.4,284.5,293.85,289.55,8.45,4.15,294,"8,513.04",432
,20161110,293.85,289.55,290.7,290.7,287.75,288.05,288.5,-1.5,-1.05,80,"2,308.16",456
,20161111,288.05,288.5,286.55,286.55,281.25,283.05,283.85,-5.45,-4.65,96,"2,724.97",456
,20161114,283.05,283.85,282.55,283.1,273.4,274.8,276.3,-9.05,-7.55,82,"2,265.66",452
,20161115,274.8,276.3,275.65,278,275.65,278,276.85,1.7,.55,40,"1,107.56",450
,20161116,278,276.85,277,278.95,277,278.4,278.5,1.55,1.65,66,"1,838.36",424
,20161117,278.4,278.5,278.25,278.65,278,278,278.25,-.5,-.25,54,"1,502.62",422
,20161118,278,278.25,277.55,277.55,274.8,274.8,277.3,-3.45,-.95,38,"1,053.80",416
,20161121,274.8,277.3,273.55,276.1,273.55,275.9,275.7,-1.4,-1.6,34,937.50,432
,20161122,275.9,275.7,276.5,277.8,276.5,277.8,277.6,2.1,1.9,42,"1,166.10",424
,20161123,277.8,277.6,276.9,277.75,276.9,277.75,277.1,.15,-.5,10,277.10,418
,20161124,277.75,277.1,275.4,275.4,273.95,274.9,275.2,-2.2,-1.9,94,"2,587.27",416
,20161125,274.9,275.2,274.1,274.35,269.8,270.3,271.2,-4.9,-4,56,"1,518.79",400
,20161128,270.3,271.2,272.2,276.25,272.2,274.35,274.15,3.15,2.95,38,"1,041.83",396
,20161129,274.35,274.15,274.6,274.75,273.9,273.9,274.55,-.25,.4,114,"3,130.16",294
,20161130,273.9,274.55,271.75,271.75,271.75,271.75,271.75,-2.8,-2.8,2,54.35,294
,20161201,271.75,271.75,269.9,270.5,267.7,270,269.2,-1.75,-2.55,40,"1,076.92",290
,20161202,270,269.2,268.6,269.65,268.6,269.65,269.4,.45,.2,28,754.44,266
,20161205,269.65,269.4,268.95,271.2,268.15,271.2,269.4,1.8,0,6,161.66,266
,20161206,271.2,269.4,269.65,270.75,268.75,269.85,269.4,.45,0,36,969.88,272
,20161207,269.85,269.4,,,,269.4,269.4,0,0,0,0.00,272
,20161208,269.4,269.4,270,271.25,269.75,270.8,270.85,1.4,1.45,38,"1,029.23",276
,20161209,270.8,270.85,270.85,270.85,270.55,270.55,270.75,-.3,-.1,8,216.61,276
,20161212,270.55,270.75,269.8,269.8,268.5,269.2,269.15,-1.55,-1.6,12,323.00,278
,20161213,269.2,269.15,269.1,269.85,269.05,269.65,269.35,.5,.2,14,377.13,272
,20161214,269.65,269.35,269.95,270.75,269.95,270.75,270.35,1.4,1,4,108.14,274
,20161215,270.75,270.35,271.4,271.4,267.25,268,268.6,-2.35,-1.75,42,"1,128.15",284
,20161216,268,268.6,266.75,266.75,266.25,266.4,266.4,-2.2,-2.2,40,"1,065.73",294
,20161219,266.4,266.4,266.65,267.25,266.3,267.1,266.85,.7,.45,40,"1,067.43",270
,20161220,267.1,266.85,267.15,267.55,265.9,265.9,267.05,-.95,.2,12,320.50,266
,20161221,265.9,267.05,262.85,265.6,262.75,265.6,263.7,-1.45,-3.35,198,"5,222.10",254
,20161222,265.6,263.7,263.75,263.75,263.75,263.75,263.75,.05,.05,8,211.00,254
,20161223,263.75,263.75,264.9,264.9,264.2,264.2,264.45,.45,.7,28,740.46,254
,20161226,264.2,264.45,264.6,264.95,264.2,264.85,264.65,.4,.2,56,"1,482.29",224
,20161227,264.85,264.65,265.5,266.25,265.5,266.25,265.85,1.6,1.2,28,744.49,208
,20161228,266.25,265.85,266.75,267.4,266.45,267.4,266.9,1.55,1.05,8,213.52,206
,20161229,267.4,266.9,267.5,268.95,266.95,268.95,267.85,2.05,.95,14,375.04,208
,20161230,268.95,267.85,268.95,272.75,268.95,271.3,271.4,3.45,3.55,36,977.08,208
au1710,20160920,288.9,288.9,,,,288.9,288.9,0,0,0,0.00,0
,20160921,288.9,288.9,,,,288.9,288.9,0,0,0,0.00,0
,20160922,288.9,288.9,,,,288.9,288.9,0,0,0,0.00,0
,20160923,288.9,288.9,,,,288.95,288.95,.05,.05,0,0.00,0
,20160926,288.95,288.95,,,,289.9,289.9,.95,.95,0,0.00,0
,20160927,289.9,289.9,,,,289.9,289.9,0,0,0,0.00,0
,20160928,289.9,289.9,,,,289.9,289.9,0,0,0,0.00,0
,20160929,289.9,289.9,289,289.7,289,289.7,289.35,-.2,-.55,4,115.74,0
,20160930,289.7,289.35,,,,288.1,288.1,-1.25,-1.25,0,0.00,0
,20161010,288.1,288.1,,,,277.75,277.75,-10.35,-10.35,0,0.00,0
,20161011,277.75,277.75,,,,277.75,277.75,0,0,0,0.00,0
,20161012,277.75,277.75,,,,277.75,277.75,0,0,0,0.00,0
,20161013,277.75,277.75,,,,277.75,277.75,0,0,0,0.00,0
,20161014,277.75,277.75,,,,277.75,277.75,0,0,0,0.00,0
,20161017,277.75,277.75,,,,277.75,277.75,0,0,0,0.00,0
,20161018,277.75,277.75,,,,277.75,277.75,0,0,0,0.00,0
,20161019,277.75,277.75,280.25,280.8,280.25,280.8,280.5,3.05,2.75,4,112.21,4
,20161020,280.8,280.5,,,,280.5,280.5,0,0,0,0.00,4
,20161021,280.5,280.5,282.4,282.55,281.9,282.35,282.25,1.85,1.75,18,508.08,6
,20161024,282.35,282.25,,,,282.25,282.25,0,0,0,0.00,6
,20161025,282.25,282.25,,,,282.25,282.25,0,0,0,0.00,6
,20161026,282.25,282.25,284.7,284.7,284.05,284.05,284.55,1.8,2.3,24,683.02,22
,20161027,284.05,284.55,,,,284.55,284.55,0,0,0,0.00,22
,20161028,284.55,284.55,283.4,283.8,283.4,283.8,283.55,-.75,-1,12,340.30,26
,20161031,283.8,283.55,284.7,285,284.7,285,284.8,1.45,1.25,6,170.89,22
,20161101,285,284.8,285.1,285.65,285.1,285.65,285.35,.85,.55,8,228.30,22
,20161102,285.65,285.35,288.1,288.1,287,287,287.5,1.65,2.15,8,230.03,28
,20161103,287,287.5,288.8,288.8,288.8,288.8,288.8,1.3,1.3,6,173.28,34
,20161104,288.8,288.8,288,288,288,288,288,-.8,-.8,2,57.60,36
,20161107,288,288,290,290,287.5,287.5,288.05,-.5,.05,20,576.14,48
,20161108,287.5,288.05,287.2,287.2,286.25,286.35,286.6,-1.7,-1.45,10,286.62,56
,20161109,286.35,286.6,286.6,296.45,286.35,296.45,291.65,9.85,5.05,16,466.69,64
,20161110,296.45,291.65,292,292,286.9,288.85,289.9,-2.8,-1.75,18,521.86,74
,20161111,288.85,289.9,289,289,282.9,284.75,286.1,-5.15,-3.8,52,"1,487.72",100
,20161114,284.75,286.1,284.4,284.6,274.7,275.6,279.8,-10.5,-6.3,66,"1,846.84",124
,20161115,275.6,279.8,276.7,278.55,276.7,278.55,277.4,-1.25,-2.4,20,554.81,118
,20161116,278.55,277.4,278.5,280.7,278.4,280.7,279.7,3.3,2.3,24,671.29,120
,20161117,280.7,279.7,279.75,279.75,279.75,279.75,279.75,.05,.05,2,55.95,120
,20161118,279.75,279.75,277.3,277.3,277.3,277.3,277.3,-2.45,-2.45,6,166.38,122
,20161121,277.3,277.3,277.85,277.85,277.7,277.7,277.75,.4,.45,4,111.11,122
,20161122,277.7,277.75,,,,277.75,277.75,0,0,0,0.00,122
,20161123,277.75,277.75,,,,277.75,277.75,0,0,0,0.00,122
,20161124,277.75,277.75,276.85,276.85,276,276,276.4,-1.75,-1.35,44,"1,216.20",108
,20161125,276,276.4,270.8,273.3,270.8,273.3,272.05,-3.1,-4.35,4,108.82,110
,20161128,273.3,272.05,277.45,277.45,277.45,277.45,277.45,5.4,5.4,4,110.98,114
,20161129,277.45,277.45,276.45,276.45,276.45,276.45,276.45,-1,-1,2,55.29,114
,20161130,276.45,276.45,274.9,274.9,274.15,274.15,274.4,-2.3,-2.05,6,164.65,110
,20161201,274.15,274.4,273.45,273.45,270.8,271.05,271.95,-3.35,-2.45,8,217.58,110
,20161202,271.05,271.95,270.5,270.5,270.5,270.5,270.5,-1.45,-1.45,2,54.10,110
,20161205,270.5,270.5,271.2,273.1,270.75,271.6,271.55,1.1,1.05,24,651.83,112
,20161206,271.6,271.55,270.9,270.9,270.25,270.8,270.6,-.75,-.95,24,649.49,114
,20161207,270.8,270.6,270.8,270.8,270.8,270.8,270.8,.2,.2,2,54.16,112
,20161208,270.8,270.8,272.45,273.05,272.45,272.5,272.65,1.7,1.85,6,163.60,106
,20161209,272.5,272.65,272.55,273,272.25,272.8,272.6,.15,-.05,40,"1,090.58",106
,20161212,272.8,272.6,,,,272.6,272.6,0,0,0,0.00,106
,20161213,272.6,272.6,,,,272.6,272.6,0,0,0,0.00,106
,20161214,272.6,272.6,271.3,272.95,271.3,272.95,271.9,.35,-.7,12,326.31,106
,20161215,272.95,271.9,272.65,274,269.05,270.95,271.85,-.95,-.05,32,869.94,110
,20161216,270.95,271.85,268.3,268.85,268.3,268.8,268.75,-3.05,-3.1,22,591.32,114
,20161219,268.8,268.75,270,270.25,269.7,270.25,270,1.5,1.25,14,378.02,112
,20161220,270.25,270,269.9,269.9,269.9,269.9,269.9,-.1,-.1,10,269.90,112
,20161221,269.9,269.9,266.2,266.65,266.2,266.65,266.25,-3.25,-3.65,12,319.54,118
,20161222,266.65,266.25,,,,266.25,266.25,0,0,0,0.00,118
,20161223,266.25,266.25,267.2,267.2,266.85,267.15,267.1,.9,.85,18,480.81,116
,20161226,267.15,267.1,266.9,267.25,266.8,267.25,266.95,.15,-.15,10,266.98,110
,20161227,267.25,266.95,268.85,269.1,268.75,269.1,268.95,2.15,2,18,484.19,112
,20161228,269.1,268.95,269.2,270.45,269.2,270.45,269.8,1.5,.85,8,215.86,106
,20161229,270.45,269.8,271.5,271.75,271.4,271.75,271.55,1.95,1.75,6,162.93,102
,20161230,271.75,271.55,274.55,274.55,273.75,274,273.95,2.45,2.4,18,493.19,106
au1712,20161116,277.4,277.4,278.4,280.55,278.4,279.3,279.85,1.9,2.45,36,"1,007.60",12
,20161117,279.3,279.85,279.8,280.2,279.8,280.2,280.05,.35,.2,10,280.09,16
,20161118,280.2,280.05,279.05,279.05,276.3,276.3,277.1,-3.75,-2.95,42,"1,163.97",40
,20161121,276.3,277.1,276.4,277.8,276.1,277.75,276.75,.65,-.35,20,553.53,44
,20161122,277.75,276.75,,,,277,277,.25,.25,0,0.00,44
,20161123,277,277,279,279.8,278.5,279.6,279.05,2.6,2.05,14,390.72,46
,20161124,279.6,279.05,276.1,276.65,275.65,276.65,275.9,-2.4,-3.15,30,827.81,62
,20161125,276.65,275.9,276.2,276.7,271.8,274.3,274,-1.6,-1.9,62,"1,699.02",98
,20161128,274.3,274,275.5,277.4,274.7,277.2,276.65,3.2,2.65,26,719.33,102
,20161129,277.2,276.65,276.55,276.9,275.2,276,276,-.65,-.65,34,938.45,106
,20161130,276,276,274,288.55,273.65,274,275.4,-2,-.6,44,"1,211.87",124
,20161201,274,275.4,273.8,273.8,270,271.9,271.5,-3.5,-3.9,82,"2,226.43",162
,20161202,271.9,271.5,271,272.45,270,271.8,271.2,.3,-.3,46,"1,247.74",192
,20161205,271.8,271.2,271.8,274,271,272.4,272.15,1.2,.95,60,"1,633.17",208
,20161206,272.4,272.15,271.8,272.6,270.7,271.2,271.55,-.95,-.6,90,"2,444.20",240
,20161207,271.2,271.55,271.2,271.7,270.65,271,271.05,-.55,-.5,30,813.26,244
,20161208,271,271.05,271.75,273.95,271.75,272.9,272.75,1.85,1.7,154,"4,200.97",290
,20161209,272.9,272.75,273,273.15,271.5,272.5,272.35,-.25,-.4,64,"1,743.13",304
,20161212,272.5,272.35,271.5,271.95,270.45,271,271.15,-1.35,-1.2,112,"3,036.94",358
,20161213,271,271.15,271.5,272,271.25,271.45,271.6,.3,.45,106,"2,879.02",402
,20161214,271.45,271.6,271.65,274.1,271.1,273.9,272.95,2.3,1.35,776,"21,182.70",1036
,20161215,273.9,272.95,273.4,276,270.85,271.65,272.8,-1.3,-.15,2448,"66,791.74",2342
,20161216,271.65,272.8,270,270.95,269.2,269.75,270.05,-3.05,-2.75,1486,"40,136.65",3232
,20161219,269.75,270.05,269.75,272.8,269,270.85,270.3,.8,.25,864,"23,357.63",3312
,20161220,270.85,270.3,270.6,270.8,268.9,269,269.8,-1.3,-.5,636,"17,160.02",3474
,20161221,269,269.8,267.8,269.45,266.2,268.75,267.35,-1.05,-2.45,1138,"30,428.68",3974
,20161222,268.75,267.35,268.6,268.8,266.1,267,267.6,-.35,.25,684,"18,306.87",4262
,20161223,267,267.6,266.65,268.05,263.4,267.5,267.45,-.1,-.15,816,"21,827.25",4624
,20161226,267.5,267.45,267.55,269,267.3,268.7,268.05,1.25,.6,850,"22,786.71",5040
,20161227,268.7,268.05,268.75,270,268.45,270,269.15,1.95,1.1,446,"12,005.62",5284
,20161228,270,269.15,270.55,271.8,269.55,271.45,270.5,2.3,1.35,1388,"37,546.22",6106
,20161229,271.45,270.5,270.7,273.05,270.2,272.55,271.4,2.05,.9,2770,"75,181.98",7548
,20161230,272.55,271.4,272.2,276.25,271.65,275.4,274.65,4,3.25,1512,"41,529.35",7960
bu1601,20160104,1700,1710,1702,1724,1606,1630,1636,-80,-74,12468,"20,397.87",20284
,20160105,1630,1636,1624,1650,1610,1638,1628,2,-8,5214,"8,491.50",17548
,20160106,1638,1628,1636,1642,1622,1636,1632,8,4,3518,"5,746.37",16334
,20160107,1636,1632,1620,1642,1606,1630,1620,-2,-12,2990,"4,845.44",14454
,20160108,1630,1620,1626,1648,1624,1640,1634,20,14,3642,"5,957.56",12032
,20160111,1640,1634,1630,1642,1630,1638,1638,4,4,2030,"3,325.38",10474
,20160112,1638,1638,1630,1668,1538,1546,1604,-92,-34,3072,"4,932.18",8606
,20160113,1546,1604,1506,1698,1506,1592,1558,-12,-46,1746,"2,720.56",7252
,20160114,1592,1558,1602,1602,1602,1602,1602,44,44,4,6.41,7248
,20160115,1602,1602,1600,1698,1600,1610,1644,8,42,258,424.43,7198
bu1602,20160104,1766,1766,1700,1700,1660,1660,1688,-106,-78,10,16.89,48
,20160105,1660,1688,1668,1668,1668,1668,1668,-20,-20,2,3.34,46
,20160106,1668,1668,1670,1682,1670,1680,1676,12,8,10,16.78,44
,20160107,1680,1676,1658,1678,1654,1678,1660,2,-16,16,26.58,34
,20160108,1678,1660,1704,1716,1670,1716,1696,56,36,56,95.02,38
,20160111,1716,1696,1710,1710,1710,1710,1710,14,14,2,3.42,38
,20160112,1710,1710,1680,1698,1624,1624,1680,-86,-30,20,33.63,38
,20160113,1624,1680,1660,1660,1598,1612,1642,-68,-38,34,55.85,44
,20160114,1612,1642,1630,1636,1630,1636,1632,-6,-10,4,6.53,40
,20160115,1636,1632,1698,1724,1632,1690,1698,58,66,36,61.19,34
,20160118,1690,1698,1666,1706,1666,1694,1676,-4,-22,12,20.13,34
,20160119,1694,1676,1764,1764,1710,1710,1724,34,48,14,24.15,32
,20160120,1710,1724,1788,1788,1724,1724,1754,0,30,8,14.04,32
,20160121,1724,1754,1750,1760,1750,1760,1752,6,-2,6,10.52,28
,20160122,1760,1752,,,,1752,1752,0,0,0,0.00,28
,20160125,1752,1752,1752,1752,1752,1752,1752,0,0,4,7.01,28
,20160126,1752,1752,,,,1752,1752,0,0,0,0.00,28
,20160127,1752,1752,,,,1752,1752,0,0,0,0.00,28
,20160128,1752,1752,1648,1750,1648,1654,1686,-98,-66,16,26.98,26
,20160129,1654,1686,1770,1770,1720,1720,1752,34,66,6,10.52,22
,20160201,1720,1752,,,,1752,1752,0,0,0,0.00,22
,20160202,1752,1752,1646,1666,1646,1646,1648,-106,-104,32,52.75,4
,20160203,1646,1648,1498,1598,1498,1550,1558,-98,-90,16,24.93,4
,20160204,1550,1558,,,,1558,1558,0,0,0,0.00,4
,20160205,1558,1558,,,,1558,1558,0,0,0,0.00,4
,20160215,1558,1558,,,,1558,1558,0,0,0,0.00,4
bu1603,20160104,1836,1832,1768,1768,1722,1722,1732,-110,-100,60,104.01,334
,20160105,1722,1732,1730,1734,1678,1718,1716,-14,-16,140,240.33,256
,20160106,1718,1716,1718,1720,1706,1718,1714,2,-2,12,20.58,246
,20160107,1718,1714,1702,1716,1702,1708,1706,-6,-8,54,92.17,220
,20160108,1708,1706,1698,1762,1692,1758,1728,52,22,56,96.86,196
,20160111,1758,1728,1752,1762,1730,1732,1736,4,8,106,184.15,114
,20160112,1732,1736,1732,1732,1646,1664,1688,-72,-48,50,84.43,122
,20160113,1664,1688,1636,1700,1636,1680,1676,-8,-12,44,73.80,124
,20160114,1680,1676,,,,1676,1676,0,0,0,0.00,124
,20160115,1676,1676,1716,1728,1680,1680,1706,4,30,30,51.24,110
,20160118,1680,1706,1652,1688,1652,1688,1678,-18,-28,26,43.67,106
,20160119,1688,1678,1706,1712,1694,1710,1706,32,28,16,27.32,106
,20160120,1710,1706,1710,1714,1710,1710,1710,4,4,16,27.37,114
,20160121,1710,1710,1698,1708,1698,1698,1698,-12,-12,24,40.78,110
,20160122,1698,1698,1728,1736,1712,1728,1730,30,32,72,124.60,124
,20160125,1728,1730,1702,1730,1702,1730,1714,0,-16,10,17.14,124
,20160126,1730,1714,1690,1712,1664,1712,1682,-2,-32,8,13.46,124
,20160127,1712,1682,1694,1694,1694,1694,1694,12,12,2,3.39,124
,20160128,1694,1694,1720,1732,1704,1704,1722,10,28,22,37.90,122
,20160129,1704,1722,1718,1722,1698,1698,1708,-24,-14,22,37.58,118
,20160201,1698,1708,,,,1708,1708,0,0,0,0.00,118
,20160202,1708,1708,,,,1700,1700,-8,-8,0,0.00,118
,20160203,1700,1700,1652,1704,1644,1644,1656,-56,-44,14,23.20,118
,20160204,1644,1656,1678,1678,1678,1678,1678,22,22,2,3.36,116
,20160205,1678,1678,1560,1652,1560,1652,1598,-26,-80,8,12.78,116
,20160215,1652,1598,,,,1598,1598,0,0,0,0.00,116
,20160216,1598,1598,1566,1650,1566,1626,1622,28,24,82,133.14,116
,20160217,1626,1622,,,,1608,1608,-14,-14,0,0.00,116
,20160218,1608,1608,1584,1678,1584,1640,1616,32,8,54,87.32,116
,20160219,1640,1616,,,,1616,1616,0,0,0,0.00,116
,20160222,1616,1616,1598,1628,1588,1604,1602,-12,-14,22,35.28,118
,20160223,1604,1602,1602,1622,1602,1614,1612,12,10,20,32.24,120
,20160224,1614,1612,1626,1636,1566,1586,1600,-26,-12,68,108.84,116
,20160225,1586,1600,1622,1648,1604,1606,1624,6,24,74,120.29,58
,20160226,1606,1624,1648,1674,1576,1650,1628,26,4,128,208.42,36
,20160229,1650,1628,1666,1666,1588,1588,1624,-40,-4,26,42.24,28
,20160301,1588,1624,1614,1648,1614,1648,1626,24,2,8,13.02,22
,20160302,1648,1626,,,,1626,1626,0,0,0,0.00,22
,20160303,1626,1626,,,,1630,1630,4,4,0,0.00,22
,20160304,1630,1630,1620,1726,1620,1632,1668,2,38,12,20.04,22
,20160307,1632,1668,1750,1750,1750,1750,1750,82,82,14,24.50,22
,20160308,1750,1750,,,,1750,1750,0,0,0,0.00,22
,20160309,1750,1750,1644,1854,1644,1712,1688,-38,-62,42,70.95,6
,20160310,1712,1688,1718,1718,1718,1718,1718,30,30,4,6.87,6
,20160311,1718,1718,1620,1620,1620,1620,1620,-98,-98,4,6.48,6
,20160314,1620,1620,,,,1620,1620,0,0,0,0.00,6
,20160315,1620,1620,,,,1620,1620,0,0,0,0.00,6
bu1604,20160104,1880,1852,,,,1752,1752,-100,-100,0,0.00,0
,20160105,1752,1752,1750,1762,1750,1762,1756,10,4,4,7.02,0
,20160106,1762,1756,,,,1756,1756,0,0,0,0.00,0
,20160107,1756,1756,,,,1748,1748,-8,-8,0,0.00,0
,20160108,1748,1748,,,,1748,1748,0,0,0,0.00,0
,20160111,1748,1748,1712,1712,1712,1712,1712,-36,-36,2,3.42,2
,20160112,1712,1712,,,,1664,1664,-48,-48,0,0.00,2
,20160113,1664,1664,1696,1740,1652,1652,1704,-12,40,20,34.08,4
,20160114,1652,1704,,,,1704,1704,0,0,0,0.00,4
,20160115,1704,1704,,,,1704,1704,0,0,0,0.00,4
,20160118,1704,1704,,,,1704,1704,0,0,0,0.00,4
,20160119,1704,1704,,,,1704,1704,0,0,0,0.00,4
,20160120,1704,1704,1710,1710,1710,1710,1710,6,6,2,3.42,4
,20160121,1710,1710,1708,1708,1708,1708,1708,-2,-2,2,3.42,4
,20160122,1708,1708,1738,1790,1700,1740,1742,32,34,60,104.60,6
,20160125,1740,1742,1754,1754,1710,1738,1738,-4,-4,10,17.38,4
,20160126,1738,1738,1686,1768,1686,1746,1746,8,8,18,31.45,16
,20160127,1746,1746,,,,1746,1746,0,0,0,0.00,16
,20160128,1746,1746,1726,1780,1694,1712,1720,-34,-26,10,17.22,12
,20160129,1712,1720,,,,1720,1720,0,0,0,0.00,12
,20160201,1720,1720,,,,1720,1720,0,0,0,0.00,12
,20160202,1720,1720,,,,1618,1618,-102,-102,0,0.00,12
,20160203,1618,1618,,,,1618,1618,0,0,0,0.00,12
,20160204,1618,1618,,,,1638,1638,20,20,0,0.00,12
,20160205,1638,1638,,,,1558,1558,-80,-80,0,0.00,12
,20160215,1558,1558,,,,1566,1566,8,8,0,0.00,12
,20160216,1566,1566,,,,1590,1590,24,24,0,0.00,12
,20160217,1590,1590,1676,1676,1648,1648,1666,58,76,6,10.00,10
,20160218,1648,1666,1618,1736,1610,1654,1654,-12,-12,58,95.99,10
,20160219,1654,1654,1688,1688,1668,1676,1672,22,18,24,40.17,16
,20160222,1676,1672,1688,1690,1660,1660,1674,-12,2,8,13.40,10
,20160223,1660,1674,,,,1674,1674,0,0,0,0.00,10
,20160224,1674,1674,,,,1674,1674,0,0,0,0.00,10
,20160225,1674,1674,,,,1700,1700,26,26,0,0.00,10
,20160226,1700,1700,,,,1700,1700,0,0,0,0.00,10
,20160229,1700,1700,,,,1700,1700,0,0,0,0.00,10
,20160301,1700,1700,1640,1706,1640,1658,1682,-42,-18,36,60.61,10
,20160302,1658,1682,,,,1726,1726,44,44,0,0.00,10
,20160303,1726,1726,,,,1730,1730,4,4,0,0.00,10
,20160304,1730,1730,1808,1808,1770,1770,1788,40,58,4,7.16,10
,20160307,1770,1788,1808,1894,1800,1894,1844,106,56,40,73.82,16
,20160308,1894,1844,1808,1908,1746,1806,1840,-38,-4,68,125.20,18
,20160309,1806,1840,1806,1806,1728,1802,1774,-38,-66,36,63.87,14
,20160310,1802,1774,1752,1836,1752,1784,1810,10,36,86,155.70,68
,20160311,1784,1810,1798,1814,1770,1786,1798,-24,-12,84,151.05,70
,20160314,1786,1798,1788,1818,1774,1774,1804,-24,6,26,46.92,82
,20160315,1774,1804,,,,1798,1798,-6,-6,0,0.00,82
,20160316,1798,1798,1804,1808,1712,1754,1732,-44,-66,168,291.20,92
,20160317,1754,1732,1754,1754,1754,1754,1754,22,22,2,3.51,92
,20160318,1754,1754,1794,1844,1758,1798,1794,44,40,44,79.02,90
,20160321,1798,1794,,,,1794,1794,0,0,0,0.00,90
,20160322,1794,1794,,,,1800,1800,6,6,0,0.00,90
,20160323,1800,1800,1806,1806,1804,1804,1804,4,4,6,10.83,90
,20160324,1804,1804,1696,1748,1696,1748,1706,-56,-98,10,17.08,90
,20160325,1748,1706,1748,1748,1676,1686,1702,-20,-4,6,10.22,90
,20160328,1686,1702,,,,1702,1702,0,0,0,0.00,90
,20160329,1702,1702,,,,1702,1702,0,0,0,0.00,90
,20160330,1702,1702,,,,1702,1702,0,0,0,0.00,90
,20160331,1702,1702,1638,1638,1638,1638,1638,-64,-64,2,3.28,88
,20160401,1638,1638,1732,1732,1646,1662,1682,24,44,10,16.82,84
,20160405,1662,1682,,,,1682,1682,0,0,0,0.00,84
,20160406,1682,1682,1684,1690,1606,1606,1666,-76,-16,8,13.34,82
,20160407,1606,1666,1658,1724,1628,1642,1670,-24,4,60,100.20,82
,20160408,1642,1670,1626,1640,1626,1638,1632,-32,-38,36,58.80,56
,20160411,1638,1632,1680,1680,1680,1680,1680,48,48,48,80.64,56
,20160412,1680,1680,,,,1680,1680,0,0,0,0.00,56
,20160413,1680,1680,,,,1680,1680,0,0,0,0.00,56
,20160414,1680,1680,,,,1680,1680,0,0,0,0.00,56
,20160415,1680,1680,,,,1680,1680,0,0,0,0.00,56
bu1605,20160104,1868,1874,1884,1884,1760,1780,1806,-94,-68,1156,"2,089.35",1346
,20160105,1780,1806,1792,1798,1760,1792,1778,-14,-28,676,"1,202.25",1264
,20160106,1792,1778,1806,1806,1766,1780,1782,2,4,416,742.05,1216
,20160107,1780,1782,1750,1880,1680,1738,1750,-44,-32,2348,"4,113.18",1336
,20160108,1738,1750,1746,1782,1740,1770,1764,20,14,1246,"2,199.27",1348
,20160111,1770,1764,1770,1790,1736,1746,1762,-18,-2,916,"1,615.30",1274
,20160112,1746,1762,1750,1758,1662,1678,1698,-84,-64,1654,"2,810.33",1350
,20160113,1678,1698,1702,1710,1668,1688,1692,-10,-6,1520,"2,574.06",1322
,20160114,1688,1692,1700,1706,1680,1696,1694,4,2,674,"1,142.47",1292
,20160115,1696,1694,1694,1720,1694,1694,1706,0,12,886,"1,512.94",1322
,20160118,1694,1706,1662,1728,1652,1706,1696,0,-10,2752,"4,668.34",1522
,20160119,1706,1696,1716,1744,1708,1732,1728,36,32,1732,"2,994.90",1364
,20160120,1732,1728,1744,1750,1702,1716,1720,-12,-8,2350,"4,042.18",1730
,20160121,1716,1720,1712,1730,1692,1694,1714,-26,-6,2492,"4,271.92",1438
,20160122,1694,1714,1700,1768,1694,1746,1728,32,14,2682,"4,638.08",1436
,20160125,1746,1728,1756,1758,1732,1738,1742,10,14,1394,"2,430.70",1362
,20160126,1738,1742,1732,1742,1666,1728,1726,-14,-16,1260,"2,175.22",1244
,20160127,1728,1726,1730,1756,1730,1742,1740,16,14,1236,"2,151.44",1252
,20160128,1742,1740,1748,1760,1732,1732,1748,-8,8,1078,"1,885.63",1294
,20160129,1732,1748,1738,1744,1676,1702,1722,-46,-26,2010,"3,462.26",1444
,20160201,1702,1722,1704,1720,1666,1666,1706,-56,-16,1768,"3,018.32",1576
,20160202,1666,1706,1670,1690,1666,1678,1680,-28,-26,738,"1,240.16",1598
,20160203,1678,1680,1678,1698,1654,1658,1674,-22,-6,3748,"6,278.51",2510
,20160204,1658,1674,1668,1692,1640,1662,1662,-12,-12,2448,"4,069.19",2146
,20160205,1662,1662,1658,1668,1594,1616,1640,-46,-22,860,"1,411.62",2084
,20160215,1616,1640,1582,1636,1582,1614,1622,-26,-18,506,821.23,1994
,20160216,1614,1622,1628,1662,1622,1646,1646,24,24,1176,"1,935.98",2064
,20160217,1646,1646,1642,1648,1616,1628,1634,-18,-12,1026,"1,678.31",2044
,20160218,1628,1634,1656,1662,1630,1652,1648,18,14,1432,"2,361.68",2038
,20160219,1652,1648,1656,1674,1646,1674,1662,26,14,1526,"2,537.82",1888
,20160222,1674,1662,1672,1720,1662,1696,1684,34,22,2480,"4,179.36",1932
,20160223,1696,1684,1710,1710,1672,1688,1690,4,6,1028,"1,737.62",2060
,20160224,1688,1690,1686,1696,1636,1648,1668,-42,-22,1632,"2,723.72",1778
,20160225,1648,1668,1642,1672,1630,1654,1654,-14,-14,1512,"2,500.93",1610
,20160226,1654,1654,1658,1726,1640,1710,1676,56,22,2626,"4,403.05",1746
,20160229,1710,1676,1738,1738,1696,1710,1716,34,40,3032,"5,204.74",1572
,20160301,1710,1716,1712,1816,1690,1756,1744,40,28,9754,"17,028.04",1524
,20160302,1756,1744,1770,1832,1740,1820,1782,76,38,3582,"6,386.00",1676
,20160303,1820,1782,1820,1858,1796,1798,1826,16,44,2978,"5,438.06",1982
,20160304,1798,1826,1816,1834,1778,1816,1806,-10,-20,3516,"6,355.06",2360
,20160307,1816,1806,1822,1914,1808,1914,1866,108,60,4036,"7,534.62",2446
,20160308,1914,1866,1938,1976,1754,1868,1894,2,28,10692,"20,265.41",4304
,20160309,1868,1894,1894,1894,1780,1788,1808,-106,-86,7574,"13,695.63",5716
,20160310,1788,1808,1810,1856,1766,1766,1812,-42,4,5934,"10,754.90",5694
,20160311,1766,1812,1768,1804,1768,1788,1784,-24,-28,1994,"3,559.93",5420
,20160314,1788,1784,1788,1818,1778,1782,1800,-2,16,2482,"4,471.10",5422
,20160315,1782,1800,1780,1804,1766,1772,1782,-28,-18,1958,"3,489.64",5266
,20160316,1772,1782,1766,1808,1766,1800,1792,18,10,1264,"2,266.50",5262
,20160317,1800,1792,1806,1844,1794,1828,1818,36,26,2042,"3,714.51",5402
,20160318,1828,1818,1834,1892,1834,1870,1862,52,44,5970,"11,125.14",5182
,20160321,1870,1862,1878,1904,1846,1858,1878,-4,16,3200,"6,015.00",3682
,20160322,1858,1878,1858,1894,1858,1866,1868,-12,-10,2822,"5,275.84",2818
,20160323,1866,1868,1846,1892,1830,1830,1860,-38,-8,1428,"2,656.14",2502
,20160324,1830,1860,1820,1834,1748,1748,1784,-112,-76,2094,"3,739.66",2366
,20160325,1748,1784,1742,1772,1732,1756,1748,-28,-36,1170,"2,046.26",2318
,20160328,1756,1748,1768,1790,1728,1732,1772,-16,24,686,"1,216.18",2254
,20160329,1732,1772,1742,1750,1708,1716,1728,-56,-44,508,878.54,2162
,20160330,1716,1728,1720,1780,1710,1734,1728,6,0,878,"1,517.32",2152
,20160331,1734,1728,1748,1766,1702,1718,1736,-10,8,1162,"2,018.12",2102
,20160401,1718,1736,1726,1738,1718,1728,1728,-8,-8,906,"1,565.72",2044
,20160405,1728,1728,1672,1680,1638,1660,1658,-68,-70,874,"1,449.82",2072
,20160406,1660,1658,1670,1684,1660,1676,1672,18,14,422,705.95,2064
,20160407,1676,1672,1678,1698,1674,1688,1686,16,14,810,"1,366.44",2084
,20160408,1688,1686,1666,1702,1666,1700,1686,14,0,566,954.50,2110
,20160411,1700,1686,1730,1774,1720,1740,1748,54,62,764,"1,336.64",2080
,20160412,1740,1748,1750,1760,1722,1746,1742,-2,-6,164,285.81,2066
,20160413,1746,1742,1748,1826,1742,1782,1790,40,48,246,440.64,2060
,20160414,1782,1790,1788,1802,1764,1776,1782,-14,-8,190,338.70,2068
,20160415,1776,1782,1820,1830,1782,1782,1794,0,12,218,391.36,2056
,20160418,1782,1794,1744,1774,1740,1758,1752,-36,-42,174,305.14,2052
,20160419,1758,1752,1778,1822,1766,1800,1796,48,44,408,732.78,2064
,20160420,1800,1796,1800,1852,1790,1842,1826,46,30,398,726.82,2016
,20160421,1842,1826,1816,1934,1816,1934,1888,108,62,476,899.03,2028
,20160422,1934,1888,1974,1982,1808,1870,1884,-18,-4,934,"1,760.16",2014
,20160425,1870,1884,1888,1980,1842,1884,1912,0,28,242,462.96,2018
,20160426,1884,1912,1884,1908,1840,1868,1882,-44,-30,110,207.24,2008
,20160427,1868,1882,1882,1924,1854,1874,1878,-8,-4,438,823.19,2210
,20160428,1874,1878,1846,1890,1802,1822,1862,-56,-16,74,137.79,2216
,20160429,1822,1862,1816,1878,1816,1836,1856,-26,-6,28,52.00,2204
,20160503,1836,1856,1830,1830,1764,1802,1786,-54,-70,34,60.76,2184
,20160504,1802,1786,1798,1798,1736,1750,1754,-36,-32,10,17.54,2182
,20160505,1750,1754,1838,1838,1744,1744,1784,-10,30,58,103.49,2158
,20160506,1744,1784,1752,1800,1688,1720,1742,-64,-42,110,191.69,2074
,20160509,1720,1742,1720,1750,1664,1680,1700,-62,-42,748,"1,272.92",1876
,20160510,1680,1700,1688,1702,1686,1702,1696,2,-4,28,47.54,1876
,20160511,1702,1696,1602,1788,1594,1788,1694,92,-2,86,145.84,1882
,20160512,1788,1694,1750,1750,1750,1750,1750,56,56,6,10.50,1876
,20160513,1750,1750,1780,1780,1780,1780,1780,30,30,100,178.00,1776
,20160516,1780,1780,1750,1750,1750,1750,1750,-30,-30,138,241.50,1776
bu1606,20160104,1894,1902,1918,1926,1802,1810,1842,-92,-60,721264,"1,329,654.35",202440
,20160105,1810,1842,1810,1828,1782,1816,1808,-26,-34,822890,"1,487,933.82",220356
,20160106,1816,1808,1812,1822,1786,1802,1804,-6,-4,659076,"1,190,124.66",236428
,20160107,1802,1804,1780,1798,1736,1760,1772,-44,-32,879632,"1,560,006.81",263264
,20160108,1760,1772,1762,1808,1760,1792,1788,20,16,956034,"1,710,237.47",246364
,20160111,1792,1788,1790,1804,1754,1762,1780,-26,-8,620582,"1,105,053.76",241318
,20160112,1762,1780,1766,1776,1676,1696,1722,-84,-58,1026268,"1,768,850.48",308052
,20160113,1696,1722,1708,1730,1682,1700,1704,-22,-18,1104896,"1,883,511.74",308000
,20160114,1700,1704,1704,1720,1684,1714,1706,10,2,987444,"1,684,624.59",316978
,20160115,1714,1706,1712,1738,1702,1706,1720,0,14,948896,"1,632,496.44",324124
,20160118,1706,1720,1678,1728,1654,1708,1690,-12,-30,1515676,"2,564,194.47",366898
,20160119,1708,1690,1722,1758,1714,1756,1734,66,44,1214208,"2,107,678.99",387650
,20160120,1756,1734,1762,1768,1704,1714,1732,-20,-2,1160222,"2,010,982.07",408748
,20160121,1714,1732,1714,1728,1690,1704,1710,-28,-22,1411848,"2,414,651.52",405922
,20160122,1704,1710,1708,1788,1700,1760,1742,50,32,1906248,"3,321,331.42",388350
,20160125,1760,1742,1772,1778,1742,1746,1754,4,12,1147564,"2,014,061.92",409772
,20160126,1746,1754,1736,1758,1732,1746,1744,-8,-10,833010,"1,453,958.08",390058
,20160127,1746,1744,1756,1774,1746,1764,1758,20,14,976774,"1,718,984.75",385046
,20160128,1764,1758,1760,1788,1754,1758,1772,0,14,1204266,"2,136,222.02",391314
,20160129,1758,1772,1766,1770,1710,1714,1738,-58,-34,1619634,"2,815,922.14",508092
,20160201,1714,1738,1712,1734,1682,1686,1712,-52,-26,1299156,"2,224,573.53",580216
,20160202,1686,1712,1680,1710,1676,1698,1692,-14,-20,940658,"1,592,800.99",557786
,20160203,1698,1692,1696,1704,1666,1684,1684,-8,-8,895204,"1,507,692.80",582598
,20160204,1684,1684,1686,1716,1668,1698,1694,14,10,1168040,"1,979,903.12",508320
,20160205,1698,1694,1690,1704,1638,1640,1670,-54,-24,924592,"1,545,386.71",533054
,20160215,1640,1670,1620,1664,1620,1632,1648,-38,-22,549984,"906,967.04",555758
,20160216,1632,1648,1650,1696,1642,1678,1672,30,24,1063032,"1,777,902.82",585878
,20160217,1678,1672,1672,1686,1648,1660,1668,-12,-4,982208,"1,639,568.31",605820
,20160218,1660,1668,1672,1706,1666,1694,1686,26,18,1248924,"2,107,350.00",596512
,20160219,1694,1686,1696,1720,1690,1716,1704,30,18,1228692,"2,095,310.69",569338
,20160222,1716,1704,1712,1758,1708,1738,1730,34,26,1546174,"2,677,789.44",569622
,20160223,1738,1730,1748,1754,1716,1732,1734,2,4,1031894,"1,790,579.43",562248
,20160224,1732,1734,1736,1740,1676,1688,1708,-46,-26,1264352,"2,161,000.18",603886
,20160225,1688,1708,1684,1718,1670,1694,1694,-14,-14,1494732,"2,534,882.54",589558
,20160226,1694,1694,1696,1774,1684,1760,1724,66,30,2275932,"3,925,215.08",697942
,20160229,1760,1724,1766,1784,1744,1752,1762,28,38,2492120,"4,392,745.16",700238
,20160301,1752,1762,1756,1808,1732,1798,1762,36,0,2528426,"4,458,900.25",690014
,20160302,1798,1762,1804,1864,1788,1842,1820,80,58,2740296,"4,988,938.75",782468
,20160303,1842,1820,1836,1878,1824,1832,1850,12,30,2703608,"5,003,245.84",829710
,20160304,1832,1850,1830,1876,1810,1844,1838,-6,-12,2899824,"5,333,988.03",831862
,20160307,1844,1838,1848,1948,1840,1948,1898,110,60,5260328,"9,986,886.47",875632
,20160308,1948,1898,1948,1996,1728,1860,1900,-38,2,5742748,"10,917,146.59",761660
,20160309,1860,1900,1878,1880,1786,1828,1814,-72,-86,3491494,"6,339,235.76",720340
,20160310,1828,1814,1838,1866,1774,1780,1824,-34,10,3683498,"6,719,381.48",822746
,20160311,1780,1824,1784,1824,1776,1800,1800,-24,-24,2204946,"3,971,908.58",832064
,20160314,1800,1800,1796,1848,1792,1806,1820,6,20,2197224,"4,001,078.28",819336
,20160315,1806,1820,1800,1822,1784,1796,1800,-24,-20,1843896,"3,322,579.62",813770
,20160316,1796,1800,1786,1834,1784,1828,1816,28,16,1936086,"3,519,300.18",761932
,20160317,1828,1816,1824,1876,1822,1868,1850,52,34,1437004,"2,659,343.46",751520
,20160318,1868,1850,1868,1932,1862,1902,1902,52,52,2095300,"3,988,937.70",744018
,20160321,1902,1902,1912,1928,1872,1892,1898,-10,-4,1918150,"3,643,325.82",736666
,20160322,1892,1898,1902,1922,1876,1886,1898,-12,0,1343074,"2,550,757.50",751144
,20160323,1886,1898,1882,1914,1844,1848,1882,-50,-16,1536662,"2,892,116.48",796094
,20160324,1848,1882,1850,1858,1768,1768,1810,-114,-72,2236036,"4,047,802.14",748450
,20160325,1768,1810,1758,1790,1750,1782,1770,-28,-40,1250722,"2,215,264.74",720846
,20160328,1782,1770,1788,1806,1750,1752,1788,-18,18,972924,"1,740,074.64",730762
,20160329,1752,1788,1752,1772,1726,1736,1750,-52,-38,1161106,"2,032,187.20",741762
,20160330,1736,1750,1730,1768,1724,1758,1748,8,-2,919076,"1,607,217.09",737692
,20160331,1758,1748,1766,1794,1730,1748,1760,0,12,1347656,"2,372,994.45",734214
,20160401,1748,1760,1760,1780,1750,1770,1762,10,2,937204,"1,652,943.19",658000
,20160405,1770,1762,1716,1730,1674,1698,1700,-64,-62,1000870,"1,701,705.08",621604
,20160406,1698,1700,1694,1722,1690,1714,1708,14,8,508408,"869,157.09",561794
,20160407,1714,1708,1712,1746,1710,1716,1726,8,18,411808,"711,010.22",549820
,20160408,1716,1726,1710,1746,1706,1744,1726,18,0,379174,"654,793.34",478700
,20160411,1744,1726,1766,1820,1760,1776,1782,50,56,581896,"1,037,037.49",403710
,20160412,1776,1782,1786,1806,1756,1788,1778,6,-4,271634,"483,460.96",368522
,20160413,1788,1778,1794,1876,1778,1822,1822,44,44,567290,"1,033,780.95",274198
,20160414,1822,1822,1824,1850,1812,1826,1828,4,6,240212,"439,393.64",266952
,20160415,1826,1828,1838,1850,1814,1820,1832,-8,4,157314,"288,368.55",253834
,20160418,1820,1832,1808,1822,1778,1810,1798,-22,-34,219506,"395,032.48",227242
,20160419,1810,1798,1814,1882,1812,1862,1852,64,54,278644,"516,056.89",220048
,20160420,1862,1852,1860,1924,1844,1898,1884,46,32,303052,"571,481.95",227738
,20160421,1898,1884,1896,1996,1862,1996,1934,112,50,297504,"575,814.38",237108
,20160422,1996,1934,2016,2050,1870,1920,1942,-14,8,337092,"654,798.14",205672
,20160425,1920,1942,1926,2024,1888,1926,1950,-16,8,233278,"455,278.02",187978
,20160426,1926,1950,1946,1960,1892,1926,1932,-24,-18,170820,"330,300.15",161256
,20160427,1926,1932,1926,1988,1900,1944,1946,12,14,168644,"328,186.28",145086
,20160428,1944,1946,1946,1958,1872,1900,1918,-46,-28,116394,"223,392.70",147116
,20160429,1900,1918,1914,1928,1896,1902,1912,-16,-6,94910,"181,488.38",149184
,20160503,1902,1912,1894,1894,1818,1844,1846,-68,-66,73816,"136,297.83",137268
,20160504,1844,1846,1830,1846,1810,1818,1826,-28,-20,45680,"83,423.24",127058
,20160505,1818,1826,1832,1842,1808,1822,1826,-4,0,34132,"62,383.06",122668
,20160506,1822,1826,1852,1860,1768,1780,1800,-46,-26,61604,"110,916.59",113902
,20160509,1780,1800,1784,1800,1738,1750,1768,-50,-32,51750,"91,526.91",104500
,20160510,1750,1768,1740,1770,1722,1768,1742,0,-26,48330,"84,253.20",92844
,20160511,1768,1742,1770,1802,1764,1784,1782,42,40,51172,"91,285.74",90176
,20160512,1784,1782,1786,1830,1770,1808,1800,26,18,36042,"64,882.22",89418
,20160513,1808,1800,1814,1838,1770,1782,1800,-18,0,38348,"69,090.57",84162
,20160516,1782,1800,1790,1834,1762,1830,1806,30,6,19694,"35,585.25",84416
,20160517,1830,1806,1836,1862,1828,1850,1848,44,42,24260,"44,862.60",84580
,20160518,1850,1848,1844,1870,1816,1836,1844,-12,-4,24062,"44,384.41",80142
,20160519,1836,1844,1838,1858,1782,1784,1818,-60,-26,24580,"44,689.57",76248
,20160520,1784,1818,1786,1822,1744,1798,1786,-20,-32,35468,"63,402.02",66722
,20160523,1798,1786,1794,1806,1686,1714,1726,-72,-60,35586,"61,448.58",60788
,20160524,1714,1726,1714,1738,1690,1694,1708,-32,-18,18618,"31,824.32",56976
,20160525,1694,1708,1762,1762,1704,1722,1720,14,12,13740,"23,652.87",56462
,20160526,1722,1720,1722,1744,1712,1734,1728,14,8,16202,"28,012.71",56630
,20160527,1734,1728,1734,1742,1700,1704,1714,-24,-14,17016,"29,191.65",50092
,20160530,1704,1714,1696,1724,1692,1712,1710,-2,-4,10722,"18,352.37",46130
,20160531,1712,1710,1714,1734,1704,1706,1720,-4,10,8984,"15,463.92",44408
,20160601,1706,1720,1704,1720,1680,1688,1702,-32,-18,8180,"13,923.92",41764
,20160602,1688,1702,1684,1716,1682,1710,1704,8,2,3126,"5,330.64",40972
,20160603,1710,1704,1702,1730,1700,1724,1712,20,8,3872,"6,635.67",39296
,20160606,1724,1712,1720,1776,1720,1766,1744,54,32,8104,"14,145.16",32636
,20160607,1766,1744,1778,1778,1750,1776,1764,32,20,2742,"4,839.30",31672
,20160608,1776,1764,1770,1780,1748,1748,1766,-16,2,3158,"5,580.81",30628
,20160613,1748,1766,1662,1810,1662,1772,1784,6,18,512,914.37,30146
,20160614,1772,1784,1780,1790,1702,1790,1752,6,-32,26,45.60,30142
,20160615,1790,1752,1824,1824,1732,1732,1804,-20,52,296,534.57,29904
bu1607,20160118,1720,1720,,,,1720,1720,0,0,0,0.00,0
,20160119,1720,1720,,,,1724,1724,4,4,0,0.00,0
,20160120,1724,1724,,,,1724,1724,0,0,0,0.00,0
,20160121,1724,1724,1770,1770,1710,1710,1740,-14,16,4,6.96,0
,20160122,1710,1740,,,,1740,1740,0,0,0,0.00,0
,20160125,1740,1740,,,,1752,1752,12,12,0,0.00,0
,20160126,1752,1752,,,,1742,1742,-10,-10,0,0.00,0
,20160127,1742,1742,,,,1756,1756,14,14,0,0.00,0
,20160128,1756,1756,,,,1756,1756,0,0,0,0.00,0
,20160129,1756,1756,,,,1756,1756,0,0,0,0.00,0
,20160201,1756,1756,,,,1730,1730,-26,-26,0,0.00,0
,20160202,1730,1730,,,,1710,1710,-20,-20,0,0.00,0
,20160203,1710,1710,1666,1776,1664,1678,1706,-32,-4,32,54.64,6
,20160204,1678,1706,,,,1706,1706,0,0,0,0.00,6
,20160205,1706,1706,1670,1670,1670,1670,1670,-36,-36,6,10.02,0
,20160215,1670,1670,,,,1670,1670,0,0,0,0.00,0
,20160216,1670,1670,1668,1722,1668,1722,1694,52,24,4,6.78,0
,20160217,1722,1694,,,,1694,1694,0,0,0,0.00,0
,20160218,1694,1694,,,,1712,1712,18,18,0,0.00,0
,20160219,1712,1712,,,,1712,1712,0,0,0,0.00,0
,20160222,1712,1712,,,,1740,1740,28,28,0,0.00,0
,20160223,1740,1740,,,,1740,1740,0,0,0,0.00,0
,20160224,1740,1740,,,,1740,1740,0,0,0,0.00,0
,20160225,1740,1740,,,,1726,1726,-14,-14,0,0.00,0
,20160226,1726,1726,1692,1828,1692,1828,1772,102,46,16,28.36,12
,20160229,1828,1772,1782,1804,1778,1778,1786,6,14,34,60.78,0
,20160301,1778,1786,1822,1838,1764,1804,1794,18,8,56,100.50,2
,20160302,1804,1794,1848,1898,1848,1876,1876,82,82,10,18.77,4
,20160303,1876,1876,1858,1858,1858,1858,1858,-18,-18,2,3.72,2
,20160304,1858,1858,,,,1858,1858,0,0,0,0.00,2
,20160307,1858,1858,1892,1962,1892,1918,1926,60,68,18,34.69,6
,20160308,1918,1926,1998,2038,1918,1918,1982,-8,56,24,47.61,6
,20160309,1918,1982,,,,1892,1892,-90,-90,0,0.00,6
,20160310,1892,1892,1922,1922,1810,1812,1856,-80,-36,18,33.42,4
,20160311,1812,1856,1798,1836,1798,1834,1824,-22,-32,8,14.60,2
,20160314,1834,1824,1870,1916,1826,1880,1878,56,54,44,82.70,6
,20160315,1880,1878,1822,1898,1804,1870,1860,-8,-18,82,152.63,22
,20160316,1870,1860,1854,1854,1854,1854,1854,-6,-6,2,3.71,20
,20160317,1854,1854,1838,1948,1838,1908,1910,54,56,40,76.41,28
,20160318,1908,1910,1934,1990,1930,1980,1942,70,32,30,58.26,14
,20160321,1980,1942,1990,1990,1948,1948,1968,6,26,4,7.88,12
,20160322,1948,1968,1970,1970,1942,1942,1956,-26,-12,8,15.65,12
,20160323,1942,1956,1930,1990,1926,1988,1966,32,10,28,55.09,20
,20160324,1988,1966,1912,1912,1848,1850,1884,-116,-82,30,56.56,32
,20160325,1850,1884,1842,1842,1842,1842,1842,-42,-42,2,3.68,30
,20160328,1842,1842,1838,1850,1838,1850,1844,8,2,4,7.38,30
,20160329,1850,1844,,,,1844,1844,0,0,0,0.00,30
,20160330,1844,1844,1804,1804,1802,1802,1802,-42,-42,4,7.21,34
,20160331,1802,1802,1832,1832,1786,1786,1808,-16,6,4,7.24,36
,20160401,1786,1808,1820,1820,1820,1820,1820,12,12,2,3.64,38
,20160405,1820,1820,1768,1768,1710,1756,1742,-64,-78,34,59.27,40
,20160406,1756,1742,,,,1742,1742,0,0,0,0.00,40
,20160407,1742,1742,,,,1742,1742,0,0,0,0.00,40
,20160408,1742,1742,1744,1744,1744,1744,1744,2,2,2,3.49,40
,20160411,1744,1744,1782,1830,1774,1826,1800,82,56,18,32.43,38
,20160412,1826,1800,1802,1806,1800,1800,1802,0,2,6,10.82,38
,20160413,1800,1802,1804,1890,1804,1850,1846,48,44,58,107.12,58
,20160414,1850,1846,1858,1862,1834,1854,1842,8,-4,34,62.64,58
,20160415,1854,1842,1864,1896,1840,1846,1862,4,20,78,145.26,56
,20160418,1846,1862,1810,1848,1810,1834,1838,-28,-24,26,47.79,58
,20160419,1834,1838,1856,1926,1856,1880,1898,42,60,28,53.15,62
,20160420,1880,1898,1920,1926,1848,1926,1902,28,4,22,41.86,62
,20160421,1926,1902,1898,2016,1898,2016,1966,114,64,46,90.50,54
,20160422,2016,1966,2142,2142,1924,1940,2000,-26,34,36,72.06,52
,20160425,1940,2000,1996,2046,1910,1928,1974,-72,-26,62,122.44,52
,20160426,1928,1974,1938,1960,1938,1956,1954,-18,-20,16,31.28,52
,20160427,1956,1954,1954,2030,1916,1986,1950,32,-4,324,632.02,60
,20160428,1986,1950,1986,1986,1910,1924,1948,-26,-2,40,77.93,42
,20160429,1924,1948,1942,1972,1938,1938,1956,-10,8,10,19.57,40
,20160503,1938,1956,1916,1916,1880,1880,1894,-76,-62,12,22.75,48
,20160504,1880,1894,,,,1894,1894,0,0,0,0.00,48
,20160505,1894,1894,1906,1906,1874,1874,1892,-20,-2,8,15.14,48
,20160506,1874,1892,1872,1874,1828,1874,1858,-18,-34,6,11.15,46
,20160509,1874,1858,1838,1838,1838,1838,1838,-20,-20,4,7.35,50
,20160510,1838,1838,,,,1838,1838,0,0,0,0.00,50
,20160511,1838,1838,1850,1866,1844,1866,1850,28,12,26,48.11,52
,20160512,1866,1850,1876,1904,1872,1890,1896,40,46,46,87.23,66
,20160513,1890,1896,1878,1878,1844,1844,1860,-52,-36,38,70.69,78
,20160516,1844,1860,1858,1902,1830,1902,1858,42,-2,34,63.19,66
,20160517,1902,1858,1864,1874,1864,1874,1868,16,10,4,7.48,66
,20160518,1874,1868,1942,1942,1836,1884,1900,16,32,112,212.90,98
,20160519,1884,1900,1886,1900,1858,1858,1880,-42,-20,48,90.28,100
,20160520,1858,1880,1828,1878,1808,1864,1850,-16,-30,76,140.70,102
,20160523,1864,1850,1860,1860,1742,1742,1788,-108,-62,30,53.69,106
,20160524,1742,1788,1786,1786,1786,1786,1786,-2,-2,2,3.57,104
,20160525,1786,1786,1782,1798,1762,1798,1786,12,0,40,71.46,124
,20160526,1798,1786,1796,1804,1770,1790,1788,4,2,60,107.32,110
,20160527,1790,1788,1798,1798,1758,1760,1770,-28,-18,30,53.15,126
,20160530,1760,1770,1766,1770,1766,1770,1768,0,-2,6,10.61,124
,20160531,1770,1768,1770,1784,1762,1782,1772,14,4,22,39.02,114
,20160601,1782,1772,1758,1758,1736,1738,1744,-34,-28,12,20.93,112
,20160602,1738,1744,1760,1772,1760,1772,1766,28,22,14,24.74,110
,20160603,1772,1766,1770,1776,1770,1770,1770,4,4,8,14.17,108
,20160606,1770,1770,1778,1814,1778,1806,1800,36,30,12,21.62,104
,20160607,1806,1800,1814,1834,1812,1818,1818,18,18,14,25.45,100
,20160608,1818,1818,1816,1840,1802,1818,1818,0,0,36,65.48,100
,20160613,1818,1818,1764,1820,1764,1810,1804,-8,-14,20,36.08,102
,20160614,1810,1804,1820,1852,1812,1812,1824,8,20,24,43.82,104
,20160615,1812,1824,1818,1822,1806,1822,1816,-2,-8,12,21.81,102
,20160616,1822,1816,1836,1836,1804,1812,1814,-4,-2,32,58.11,92
,20160617,1812,1814,1792,1798,1788,1798,1792,-16,-22,10,17.92,92
,20160620,1798,1792,1822,1876,1822,1876,1848,84,56,30,55.49,80
,20160621,1876,1848,,,,1850,1850,2,2,0,0.00,80
,20160622,1850,1850,1840,1890,1840,1888,1872,38,22,14,26.23,82
,20160623,1888,1872,1866,1916,1866,1896,1900,24,28,38,72.26,84
,20160624,1896,1900,,,,1870,1870,-30,-30,0,0.00,84
,20160627,1870,1870,1898,1904,1898,1904,1900,34,30,10,19.01,86
,20160628,1904,1900,1914,1916,1914,1914,1914,14,14,10,19.15,90
,20160629,1914,1914,1862,1946,1862,1946,1900,32,-14,56,106.43,102
,20160630,1946,1900,1948,2014,1916,2014,1962,114,62,82,161.04,92
,20160701,2014,1962,2014,2014,1930,1984,1966,22,4,18,35.40,88
,20160704,1984,1966,1978,1978,1964,1964,1972,-2,6,6,11.84,86
,20160705,1964,1972,1980,2024,1942,1942,1982,-30,10,14,27.76,88
,20160706,1942,1982,1896,1896,1862,1868,1866,-114,-116,18,33.61,82
,20160707,1868,1866,1814,1908,1814,1838,1852,-28,-14,24,44.47,76
,20160708,1838,1852,,,,1852,1852,0,0,0,0.00,76
,20160711,1852,1852,1788,1806,1788,1806,1794,-46,-58,6,10.76,76
,20160712,1806,1794,1880,1892,1814,1892,1858,98,64,14,26.02,76
,20160713,1892,1858,1894,1894,1890,1890,1892,32,34,32,60.58,58
,20160714,1890,1892,,,,1892,1892,0,0,0,0.00,58
,20160715,1892,1892,,,,1892,1892,0,0,0,0.00,58
bu1608,20160216,1670,1670,,,,1680,1680,10,10,0,0.00,0
,20160217,1680,1680,,,,1676,1676,-4,-4,0,0.00,0
,20160218,1676,1676,1764,1800,1756,1760,1774,84,98,20,35.48,8
,20160219,1760,1774,1702,1784,1702,1736,1748,-38,-26,86,150.42,32
,20160222,1736,1748,1740,1818,1740,1776,1786,28,38,72,128.59,14
,20160223,1776,1786,1836,1836,1758,1758,1786,-28,0,18,32.16,6
,20160224,1758,1786,,,,1758,1758,-28,-28,0,0.00,6
,20160225,1758,1758,,,,1754,1754,-4,-4,0,0.00,6
,20160226,1754,1754,,,,1818,1818,64,64,0,0.00,6
,20160229,1818,1818,1798,1844,1798,1826,1822,8,4,12,21.87,10
,20160301,1826,1822,1808,1858,1802,1858,1818,36,-4,12,21.82,4
,20160302,1858,1818,1860,1888,1800,1872,1854,54,36,16,29.68,4
,20160303,1872,1854,,,,1854,1854,0,0,0,0.00,4
,20160304,1854,1854,1848,1942,1844,1844,1864,-10,10,98,182.86,0
,20160307,1844,1864,1966,1974,1902,1974,1956,110,92,10,19.57,2
,20160308,1974,1956,2042,2054,1838,1962,1958,6,2,48,94.06,12
,20160309,1962,1958,1878,1886,1852,1874,1874,-84,-84,20,37.48,10
,20160310,1874,1874,,,,1874,1874,0,0,0,0.00,10
,20160311,1874,1874,,,,1874,1874,0,0,0,0.00,10
,20160314,1874,1874,,,,1874,1874,0,0,0,0.00,10
,20160315,1874,1874,,,,1874,1874,0,0,0,0.00,10
,20160316,1874,1874,,,,1874,1874,0,0,0,0.00,10
,20160317,1874,1874,,,,1908,1908,34,34,0,0.00,10
,20160318,1908,1908,,,,1960,1960,52,52,0,0.00,10
,20160321,1960,1960,1948,1994,1924,1994,1972,34,12,38,75.00,14
,20160322,1994,1972,2022,2022,2022,2022,2022,50,50,2,4.04,14
,20160323,2022,2022,2022,2032,2012,2012,2024,-10,2,174,352.31,80
,20160324,2012,2024,1988,1988,1902,1902,1932,-122,-92,606,"1,171.02",204
,20160325,1902,1932,1816,1916,1816,1884,1884,-48,-48,26,48.99,198
,20160328,1884,1884,1920,1920,1884,1884,1910,0,26,28,53.49,188
,20160329,1884,1910,1904,1904,1870,1870,1888,-40,-22,30,56.64,200
,20160330,1870,1888,1846,1896,1846,1896,1868,8,-20,12,22.42,202
,20160331,1896,1868,1896,1898,1804,1844,1854,-24,-14,42,77.91,198
,20160401,1844,1854,1866,1866,1830,1836,1840,-18,-14,180,331.25,190
,20160405,1836,1840,1732,1772,1732,1772,1752,-68,-88,16,28.06,192
,20160406,1772,1752,1764,1764,1762,1762,1762,10,10,4,7.05,192
,20160407,1762,1762,1778,1778,1778,1778,1778,16,16,2,3.56,192
,20160408,1778,1778,1738,1778,1738,1776,1764,-2,-14,48,84.72,200
,20160411,1776,1764,1820,1858,1812,1826,1836,62,72,46,84.53,200
,20160412,1826,1836,1860,1860,1830,1834,1850,-2,14,12,22.21,196
,20160413,1834,1850,1848,1944,1848,1918,1920,68,70,162,311.30,68
,20160414,1918,1920,1922,1922,1886,1886,1904,-34,-16,4,7.62,66
,20160415,1886,1904,1912,1912,1908,1908,1908,4,4,6,11.46,62
,20160418,1908,1908,1908,1908,1908,1908,1908,0,0,2,3.82,62
,20160419,1908,1908,1880,2014,1880,1956,1954,48,46,84,164.21,62
,20160420,1956,1954,1938,2050,1938,1968,1984,14,30,160,317.59,54
,20160421,1968,1984,2008,2080,2008,2070,2042,86,58,30,61.30,44
,20160422,2070,2042,2080,2086,1960,2068,2042,26,0,30,61.30,42
,20160425,2068,2042,2000,2114,1974,1974,2052,-68,10,18,36.94,34
,20160426,1974,2052,2078,2084,1964,2038,2042,-14,-10,28,57.20,32
,20160427,2038,2042,2076,2076,2058,2058,2068,16,26,8,16.55,32
,20160428,2058,2068,2010,2064,1996,1996,2006,-72,-62,1266,"2,541.36",38
,20160429,1996,2006,2000,2074,2000,2030,2036,24,30,36,73.30,44
,20160503,2030,2036,2002,2002,1940,1940,1972,-96,-64,24,47.37,52
,20160504,1940,1972,1960,1962,1940,1940,1952,-32,-20,26,50.80,58
,20160505,1940,1952,1960,1968,1922,1922,1940,-30,-12,476,923.63,116
,20160506,1922,1940,1952,1962,1920,1920,1944,-20,4,42,81.67,122
,20160509,1920,1944,1900,1900,1854,1856,1870,-88,-74,50,93.57,118
,20160510,1856,1870,1836,1858,1830,1858,1838,-12,-32,82,150.82,154
,20160511,1858,1838,1890,1906,1886,1906,1894,68,56,10,18.95,154
,20160512,1906,1894,1920,1936,1910,1936,1924,42,30,24,46.20,152
,20160513,1936,1924,1916,1932,1894,1898,1912,-26,-12,20,38.27,150
,20160516,1898,1912,1914,1928,1914,1928,1918,16,6,8,15.36,152
,20160517,1928,1918,1974,1980,1954,1960,1968,42,50,24,47.26,152
,20160518,1960,1968,1944,1958,1938,1938,1946,-30,-22,168,326.93,160
,20160519,1938,1946,1940,1960,1900,1900,1922,-46,-24,34,65.41,162
,20160520,1900,1922,1868,1920,1850,1894,1884,-28,-38,32,60.33,162
,20160523,1894,1884,1874,1874,1784,1784,1838,-100,-46,26,47.82,166
,20160524,1784,1838,1830,1830,1792,1792,1808,-46,-30,26,47.04,164
,20160525,1792,1808,1800,1836,1800,1822,1812,14,4,68,123.24,156
,20160526,1822,1812,1830,1868,1830,1832,1842,20,30,8,14.74,156
,20160527,1832,1842,1840,1840,1800,1810,1814,-32,-28,28,50.83,154
,20160530,1810,1814,1810,1810,1802,1810,1808,-4,-6,10,18.08,154
,20160531,1810,1808,1832,1838,1820,1832,1828,24,20,26,47.56,150
,20160601,1832,1828,1812,1812,1796,1796,1806,-32,-22,6,10.84,150
,20160602,1796,1806,1810,1814,1808,1808,1810,2,4,10,18.11,152
,20160603,1808,1810,1802,1824,1802,1824,1812,14,2,18,32.63,150
,20160606,1824,1812,1828,1860,1796,1860,1830,48,18,18,32.95,152
,20160607,1860,1830,1854,1854,1854,1854,1854,24,24,2,3.71,152
,20160608,1854,1854,1872,1872,1860,1862,1864,8,10,8,14.92,154
,20160613,1862,1864,1824,1922,1824,1878,1880,14,16,122,229.57,172
,20160614,1878,1880,1870,1916,1870,1898,1894,18,14,38,72.00,154
,20160615,1898,1894,1900,1900,1872,1872,1882,-22,-12,6,11.29,154
,20160616,1872,1882,1880,1890,1876,1876,1880,-6,-2,24,45.15,164
,20160617,1876,1880,1872,1880,1854,1854,1864,-26,-16,10,18.65,166
,20160620,1854,1864,1884,1934,1880,1934,1914,70,50,54,103.38,176
,20160621,1934,1914,1952,1952,1912,1922,1928,8,14,16,30.87,182
,20160622,1922,1928,1904,1950,1904,1946,1932,18,4,18,34.79,192
,20160623,1946,1932,1954,1972,1948,1968,1958,36,26,26,50.95,196
,20160624,1968,1958,1964,1968,1964,1968,1964,10,6,8,15.72,190
,20160627,1968,1964,1940,1986,1920,1986,1940,22,-24,50,97.01,202
,20160628,1986,1940,1972,1980,1960,1978,1972,38,32,60,118.32,184
,20160629,1978,1972,2028,2028,1984,2004,2006,32,34,678,"1,361.16",178
,20160630,2004,2006,2018,2060,2010,2038,2034,32,28,66,134.25,174
,20160701,2038,2034,2024,2034,2004,2034,2010,0,-24,34,68.38,174
,20160704,2034,2010,2044,2084,2044,2084,2070,74,60,8,16.57,174
,20160705,2084,2070,2072,2074,1966,1992,2012,-78,-58,32,64.39,174
,20160706,1992,2012,1980,1988,1910,1924,1934,-88,-78,22,42.57,160
,20160707,1924,1934,,,,1934,1934,0,0,0,0.00,160
,20160708,1934,1934,1894,1900,1860,1890,1880,-44,-54,14,26.33,160
,20160711,1890,1880,1912,1912,1912,1912,1912,32,32,2,3.82,160
,20160712,1912,1912,1928,1956,1916,1956,1936,44,24,12,23.24,160
,20160713,1956,1936,1972,2002,1972,2002,1986,66,50,8,15.90,160
,20160714,2002,1986,1968,2032,1968,2030,2016,44,30,430,867.25,164
,20160715,2030,2016,,,,2016,2016,0,0,0,0.00,164
,20160718,2016,2016,2000,2000,1920,1932,1944,-84,-72,28,54.45,160
,20160719,1932,1944,1912,1940,1884,1906,1928,-38,-16,98,188.97,166
,20160720,1906,1928,1928,1936,1918,1936,1924,8,-4,14,26.94,166
,20160721,1936,1924,1936,1976,1926,1968,1950,44,26,32,62.45,160
,20160722,1968,1950,1966,1966,1906,1912,1930,-38,-20,8,15.45,160
,20160725,1912,1930,1906,1916,1906,1912,1908,-18,-22,10,19.09,160
,20160726,1912,1908,1900,1942,1900,1940,1928,32,20,54,104.18,146
,20160727,1940,1928,1948,1950,1822,1822,1886,-106,-42,66,124.57,168
,20160728,1822,1886,1906,1936,1892,1932,1924,46,38,80,153.97,136
,20160729,1932,1924,1904,1904,1840,1840,1872,-84,-52,28,52.42,136
,20160801,1840,1872,1804,1850,1804,1848,1836,-24,-36,54,99.20,136
,20160802,1848,1836,,,,1836,1836,0,0,0,0.00,136
,20160803,1836,1836,,,,1836,1836,0,0,0,0.00,136
,20160804,1836,1836,1892,1892,1798,1846,1848,10,12,10,18.48,138
,20160805,1846,1848,1848,1852,1802,1840,1836,-8,-12,16,29.40,130
,20160808,1840,1836,1808,1808,1796,1796,1804,-40,-32,16,28.88,128
,20160809,1796,1804,1796,1824,1796,1824,1800,20,-4,14,25.20,118
,20160810,1824,1800,1752,1856,1736,1820,1788,20,-12,46,82.32,116
,20160811,1820,1788,1766,1766,1682,1760,1744,-28,-44,10,17.46,116
,20160812,1760,1744,,,,1744,1744,0,0,0,0.00,116
,20160815,1744,1744,,,,1744,1744,0,0,0,0.00,116
bu1609,20160104,1970,1980,1980,1988,1894,1894,1920,-86,-60,1170,"2,247.22",2022
,20160105,1894,1920,1890,1916,1872,1896,1892,-24,-28,1014,"1,920.29",2112
,20160106,1896,1892,1900,1906,1868,1886,1884,-6,-8,974,"1,836.30",2248
,20160107,1886,1884,1876,1882,1828,1842,1854,-42,-30,1128,"2,091.64",2348
,20160108,1842,1854,1848,1888,1832,1876,1868,22,14,924,"1,727.27",2338
,20160111,1876,1868,1874,1884,1838,1842,1858,-26,-10,1412,"2,623.64",2634
,20160112,1842,1858,1852,1862,1762,1780,1806,-78,-52,2200,"3,973.48",2782
,20160113,1780,1806,1790,1830,1776,1784,1798,-22,-8,1090,"1,960.63",2920
,20160114,1784,1798,1792,1808,1692,1796,1776,-2,-22,1726,"3,065.59",2770
,20160115,1796,1776,1796,1820,1786,1794,1804,18,28,1662,"2,998.66",2904
,20160118,1794,1804,1760,1806,1748,1786,1780,-18,-24,4012,"7,141.39",3284
,20160119,1786,1780,1800,1830,1786,1824,1804,44,24,6578,"11,872.63",6032
,20160120,1824,1804,1830,1830,1760,1764,1790,-40,-14,4136,"7,410.58",7384
,20160121,1764,1790,1760,1778,1734,1752,1760,-38,-30,4230,"7,449.91",7814
,20160122,1752,1760,1756,1812,1744,1794,1776,34,16,15064,"26,770.09",10084
,20160125,1794,1776,1802,1818,1774,1788,1788,12,12,7686,"13,744.66",12078
,20160126,1788,1788,1784,1794,1774,1786,1782,-2,-6,3258,"5,811.87",11604
,20160127,1786,1782,1798,1816,1772,1816,1802,34,20,4370,"7,881.19",12444
,20160128,1816,1802,1810,1848,1810,1822,1830,20,28,6616,"12,119.68",13180
,20160129,1822,1830,1826,1840,1772,1776,1812,-54,-18,16518,"29,950.25",19022
,20160201,1776,1812,1774,1784,1726,1726,1762,-86,-50,11734,"20,687.74",21920
,20160202,1726,1762,1726,1750,1720,1738,1734,-24,-28,12298,"21,345.55",26100
,20160203,1738,1734,1736,1744,1714,1726,1728,-8,-6,7350,"12,713.73",26882
,20160204,1726,1728,1732,1768,1728,1750,1750,22,22,15852,"27,749.96",29782
,20160205,1750,1750,1746,1764,1710,1710,1732,-40,-18,9662,"16,751.75",30232
,20160215,1710,1732,1706,1730,1692,1706,1716,-26,-16,7324,"12,569.34",30042
,20160216,1706,1716,1716,1758,1716,1748,1740,32,24,12196,"21,236.42",30372
,20160217,1748,1740,1738,1752,1722,1732,1738,-8,-2,7622,"13,248.70",31366
,20160218,1732,1738,1742,1768,1736,1756,1750,18,12,16154,"28,292.13",35386
,20160219,1756,1750,1758,1776,1750,1766,1764,16,14,14596,"25,748.94",37312
,20160222,1766,1764,1764,1800,1762,1784,1778,20,14,26784,"47,663.67",41938
,20160223,1784,1778,1800,1804,1770,1798,1790,20,12,23910,"42,813.70",42188
,20160224,1798,1790,1800,1808,1748,1752,1778,-38,-12,35970,"64,018.50",43908
,20160225,1752,1778,1756,1778,1740,1750,1758,-28,-20,31738,"55,841.32",45320
,20160226,1750,1758,1756,1840,1730,1826,1794,68,36,83410,"149,709.39",62742
,20160229,1826,1794,1830,1844,1800,1820,1822,26,28,81698,"148,889.76",58288
,20160301,1820,1822,1826,1866,1802,1862,1828,40,6,72062,"131,769.46",64854
,20160302,1862,1828,1868,1914,1848,1896,1880,68,52,92996,"175,009.47",77276
,20160303,1896,1880,1896,1932,1890,1892,1908,12,28,96018,"183,360.51",92084
,20160304,1892,1908,1886,1936,1870,1920,1902,12,-6,115692,"220,139.65",103524
,20160307,1920,1902,1930,2016,1912,2010,1968,108,66,245550,"483,315.47",124668
,20160308,2010,1968,2008,2030,1848,1936,1960,-32,-8,411562,"807,195.94",136838
,20160309,1936,1960,1956,1958,1842,1904,1880,-56,-80,294596,"554,191.38",138834
,20160310,1904,1880,1914,1948,1854,1862,1906,-18,26,257800,"491,479.68",151800
,20160311,1862,1906,1872,1908,1860,1888,1882,-18,-24,143780,"270,708.16",156646
,20160314,1888,1882,1890,1942,1880,1894,1914,12,32,176970,"338,875.00",159078
,20160315,1894,1914,1888,1902,1862,1872,1878,-42,-36,172714,"324,700.62",167956
,20160316,1872,1878,1862,1912,1854,1908,1894,30,16,186718,"353,660.20",170026
,20160317,1908,1894,1908,1956,1902,1950,1930,56,36,182702,"352,851.49",180556
,20160318,1950,1930,1942,2022,1942,1990,1994,60,64,298094,"594,418.38",183534
,20160321,1990,1994,2006,2052,1966,2010,2008,16,14,395500,"794,410.15",215772
,20160322,2010,2008,2028,2060,2012,2022,2034,14,26,456952,"930,101.09",250958
,20160323,2022,2034,2014,2062,1972,1980,2024,-54,-10,521272,"1,055,732.78",265754
,20160324,1980,2024,1984,1992,1902,1902,1952,-122,-72,754376,"1,473,558.13",280582
,20160325,1902,1952,1870,1926,1870,1916,1902,-36,-50,464062,"883,029.42",282118
,20160328,1916,1902,1922,1952,1890,1894,1928,-8,26,392320,"757,010.33",297382
,20160329,1894,1928,1898,1918,1872,1884,1896,-44,-32,403382,"764,913.65",321904
,20160330,1884,1896,1870,1910,1862,1896,1892,0,-4,409460,"775,042.28",354256
,20160331,1896,1892,1904,1932,1832,1850,1876,-42,-16,649672,"1,219,797.17",386922
,20160401,1850,1876,1864,1878,1838,1862,1860,-14,-16,578386,"1,076,399.37",416834
,20160405,1862,1860,1812,1816,1748,1780,1774,-80,-86,541802,"961,944.25",405384
,20160406,1780,1774,1780,1806,1778,1788,1792,14,18,406936,"729,349.20",428014
,20160407,1788,1792,1784,1828,1782,1808,1808,16,16,520164,"940,538.99",463882
,20160408,1808,1808,1796,1836,1778,1836,1808,28,0,918234,"1,660,723.16",494474
,20160411,1836,1808,1858,1916,1856,1882,1886,74,78,1755004,"3,312,034.35",518964
,20160412,1882,1886,1896,1924,1878,1912,1900,26,14,1457028,"2,770,205.33",582636
,20160413,1912,1900,1920,2012,1904,1942,1952,42,52,2814634,"5,496,909.39",677080
,20160414,1942,1952,1954,1996,1944,1964,1964,12,12,2114392,"4,155,265.00",702642
,20160415,1964,1964,1982,1994,1944,1958,1970,-6,6,1790988,"3,528,461.88",695790
,20160418,1958,1970,1936,1966,1906,1948,1936,-22,-34,2313410,"4,479,722.12",651944
,20160419,1948,1936,1960,2042,1946,2006,1998,70,62,3509740,"7,013,023.33",722328
,20160420,2006,1998,2012,2080,1986,2052,2034,54,36,4386232,"8,925,031.99",859642
,20160421,2052,2034,2044,2156,2014,2156,2088,122,54,4605280,"9,619,707.96",892258
,20160422,2156,2088,2150,2180,2014,2068,2096,-20,8,5332934,"11,180,014.20",833966
,20160425,2068,2096,2080,2184,2030,2080,2106,-16,10,5143508,"10,834,192.35",851316
,20160426,2080,2106,2090,2112,2038,2074,2082,-32,-24,3083122,"6,420,202.63",765266
,20160427,2074,2082,2096,2146,2042,2098,2098,16,16,4182762,"8,779,515.48",874560
,20160428,2098,2098,2106,2116,2024,2056,2074,-42,-24,3514638,"7,295,154.47",902406
,20160429,2056,2074,2074,2090,2048,2066,2072,-8,-2,2101698,"4,355,561.42",895958
,20160503,2066,2072,2030,2046,1972,1996,1998,-76,-74,1492678,"2,983,922.49",943200
,20160504,1996,1998,1978,1996,1962,1970,1976,-28,-22,1336884,"2,643,534.80",955516
,20160505,1970,1976,1986,1996,1958,1978,1980,2,4,1331200,"2,637,778.43",969338
,20160506,1978,1980,2004,2014,1912,1926,1956,-54,-24,1935576,"3,786,461.59",953252
,20160509,1926,1956,1922,1952,1872,1892,1912,-64,-44,1707024,"3,264,722.49",925410
,20160510,1892,1912,1870,1904,1852,1898,1880,-14,-32,1423906,"2,677,854.86",843742
,20160511,1898,1880,1902,1954,1898,1944,1930,64,50,1658412,"3,201,657.69",865578
,20160512,1944,1930,1944,1992,1922,1970,1956,40,26,1627936,"3,186,961.66",889534
,20160513,1970,1956,1978,1998,1918,1932,1954,-24,-2,2105406,"4,115,888.26",816534
,20160516,1932,1954,1940,1996,1912,1986,1962,32,8,1667746,"3,273,784.22",826202
,20160517,1986,1962,1994,2032,1988,2008,2010,46,48,1705364,"3,429,245.66",893662
,20160518,2008,2010,1996,2030,1968,1984,2000,-26,-10,1793446,"3,588,344.84",853260
,20160519,1984,2000,1982,2018,1932,1932,1982,-68,-18,1864300,"3,695,366.57",783242
,20160520,1932,1982,1920,1962,1896,1944,1932,-38,-50,1466336,"2,833,068.96",771988
,20160523,1944,1932,1938,1954,1818,1860,1880,-72,-52,1765104,"3,321,011.49",677140
,20160524,1860,1880,1848,1878,1824,1832,1848,-48,-32,1405162,"2,598,012.86",685886
,20160525,1832,1848,1850,1878,1842,1870,1860,22,12,1190562,"2,214,605.94",671968
,20160526,1870,1860,1872,1898,1860,1884,1878,24,18,1266334,"2,379,162.48",681192
,20160527,1884,1878,1896,1896,1832,1836,1854,-42,-24,1437378,"2,666,759.09",764626
,20160530,1836,1854,1828,1866,1822,1854,1846,0,-8,1042176,"1,925,000.90",752956
,20160531,1854,1846,1858,1890,1850,1860,1870,14,24,1087928,"2,035,167.77",734676
,20160601,1860,1870,1862,1874,1812,1828,1844,-42,-26,1342288,"2,476,907.94",819256
,20160602,1828,1844,1830,1868,1820,1856,1846,12,2,841390,"1,554,645.36",769240
,20160603,1856,1846,1850,1882,1840,1876,1860,30,14,765912,"1,425,432.26",745278
,20160606,1876,1860,1880,1914,1856,1914,1886,54,26,946152,"1,785,069.23",701370
,20160607,1914,1886,1924,1928,1894,1922,1912,36,26,888074,"1,699,279.26",691452
,20160608,1922,1912,1928,1932,1900,1912,1914,0,2,651898,"1,248,919.82",667696
,20160613,1912,1914,1876,1928,1866,1918,1906,4,-8,549430,"1,048,042.08",676732
,20160614,1918,1906,1914,1964,1910,1936,1938,30,32,1063158,"2,061,399.99",674708
,20160615,1936,1938,1936,1956,1900,1930,1924,-8,-14,871700,"1,678,269.09",664092
,20160616,1930,1924,1934,1940,1916,1922,1926,-2,2,749784,"1,444,962.33",654102
,20160617,1922,1926,1914,1926,1882,1924,1902,-2,-24,891420,"1,695,575.11",670912
,20160620,1924,1902,1932,1992,1922,1990,1964,88,62,1139642,"2,239,174.69",706354
,20160621,1990,1964,1998,2008,1964,1972,1986,8,22,865556,"1,719,159.53",673328
,20160622,1972,1986,1962,2026,1952,2026,1996,40,10,1025850,"2,047,902.34",757850
,20160623,2026,1996,2020,2040,2006,2018,2020,22,24,1046456,"2,115,438.87",765542
,20160624,2018,2020,2030,2046,1966,1970,2002,-50,-18,1441306,"2,888,329.68",671236
,20160627,1970,2002,1974,2030,1968,2028,1998,26,-4,952414,"1,904,067.02",697124
,20160628,2028,1998,2006,2036,1982,2022,2012,24,14,1157080,"2,329,046.89",743560
,20160629,2022,2012,2036,2072,2024,2060,2046,48,34,1727864,"3,537,555.43",785108
,20160630,2060,2046,2066,2116,2050,2082,2078,36,32,1459324,"3,034,377.30",743532
,20160701,2082,2078,2066,2088,2036,2040,2068,-38,-10,1054538,"2,182,020.58",708772
,20160704,2040,2068,2040,2154,2038,2136,2106,68,38,1881130,"3,965,373.51",734030
,20160705,2136,2106,2140,2152,2000,2032,2074,-74,-32,1702278,"3,533,340.91",693486
,20160706,2032,2074,2020,2044,1948,1952,1986,-122,-88,1570612,"3,120,539.80",675064
,20160707,1952,1986,1940,1988,1936,1952,1966,-34,-20,936470,"1,841,712.48",638988
,20160708,1952,1966,1960,1976,1902,1932,1936,-34,-30,1035238,"2,004,988.88",619876
,20160711,1932,1936,1936,1970,1920,1964,1944,28,8,785728,"1,528,440.99",617756
,20160712,1964,1944,1974,2024,1960,2024,1988,80,44,886348,"1,762,590.87",606514
,20160713,2024,1988,2038,2066,2000,2020,2034,32,46,1084318,"2,206,991.42",595462
,20160714,2020,2034,2026,2092,1996,2076,2052,42,18,1426486,"2,929,136.31",642740
,20160715,2076,2052,2082,2090,2044,2074,2064,22,12,903458,"1,864,943.16",635168
,20160718,2074,2064,2088,2092,1974,1982,2034,-82,-30,961494,"1,956,227.93",605264
,20160719,1982,2034,1970,2002,1952,1980,1978,-54,-56,672526,"1,331,491.14",599880
,20160720,1980,1978,1984,1992,1956,1990,1978,12,0,626018,"1,238,880.48",587790
,20160721,1990,1978,1982,2044,1968,2040,2010,62,32,862816,"1,735,245.83",584514
,20160722,2040,2010,2038,2044,1972,1978,2006,-32,-4,710992,"1,427,575.91",552528
,20160725,1978,2006,1984,1994,1938,1994,1970,-12,-36,691634,"1,363,868.42",525452
,20160726,1994,1970,1990,2014,1966,2004,1992,34,22,844882,"1,684,012.35",534450
,20160727,2004,1992,1994,2040,1972,1982,2010,-10,18,1051170,"2,113,928.03",494430
,20160728,1982,2010,1986,2004,1964,1976,1986,-34,-24,793662,"1,576,352.28",474396
,20160729,1976,1986,1980,1990,1868,1882,1936,-104,-50,1102928,"2,136,080.49",465660
,20160801,1882,1936,1882,1924,1878,1910,1904,-26,-32,616854,"1,175,541.52",445322
,20160802,1910,1904,1904,1910,1862,1886,1880,-18,-24,543788,"1,023,246.72",438420
,20160803,1886,1880,1894,1916,1876,1890,1894,10,14,455280,"863,109.38",408576
,20160804,1890,1894,1892,1912,1868,1876,1890,-18,-4,381552,"721,706.62",375348
,20160805,1876,1890,1876,1886,1842,1852,1864,-38,-26,255684,"476,693.48",358318
,20160808,1852,1864,1864,1884,1832,1866,1858,2,-6,226590,"421,233.22",323466
,20160809,1866,1858,1878,1880,1844,1856,1862,-2,4,125652,"233,972.07",298924
,20160810,1856,1862,1858,1872,1850,1860,1860,-2,-2,88024,"163,811.14",276894
,20160811,1860,1860,1864,1868,1830,1834,1844,-26,-16,86792,"160,133.98",272762
,20160812,1834,1844,1836,1860,1834,1856,1850,12,6,78314,"144,926.64",258094
,20160815,1856,1850,1856,1858,1842,1848,1850,-2,0,76498,"141,639.09",235556
,20160816,1848,1850,1850,1856,1824,1834,1834,-16,-16,77480,"142,184.36",230356
,20160817,1834,1834,1836,1840,1810,1818,1822,-16,-12,72432,"132,069.69",220596
,20160818,1818,1822,1818,1822,1772,1774,1792,-48,-30,90166,"161,740.94",203066
,20160819,1774,1792,1780,1784,1748,1776,1766,-16,-26,81338,"143,794.52",186336
,20160822,1776,1766,1778,1782,1748,1752,1764,-14,-2,58236,"102,771.81",166154
,20160823,1752,1764,1752,1760,1736,1736,1744,-28,-20,37284,"65,086.76",154350
,20160824,1736,1744,1742,1766,1730,1746,1748,2,4,39620,"69,307.13",140276
,20160825,1746,1748,1748,1756,1704,1726,1724,-22,-24,48294,"83,351.00",117980
,20160826,1726,1724,1728,1732,1716,1718,1724,-6,0,19836,"34,215.47",110872
,20160829,1718,1724,1724,1728,1708,1722,1720,-2,-4,24998,"43,024.75",99334
,20160830,1722,1720,1720,1722,1672,1680,1698,-40,-22,29058,"49,370.93",83514
,20160831,1680,1698,1678,1686,1646,1664,1662,-34,-36,40672,"67,664.32",58046
,20160901,1664,1662,1664,1696,1656,1686,1678,24,16,10886,"18,276.99",51330
,20160902,1686,1678,1680,1698,1680,1688,1688,10,10,5942,"10,041.78",47704
,20160905,1688,1688,1688,1704,1686,1704,1694,16,6,7534,"12,768.51",42912
,20160906,1704,1694,1704,1724,1696,1724,1710,30,16,6164,"10,548.97",38848
,20160907,1724,1710,1712,1726,1710,1712,1718,2,8,4474,"7,686.37",35918
,20160908,1712,1718,1718,1724,1692,1700,1700,-18,-18,6888,"11,710.23",31512
,20160909,1700,1700,1704,1706,1690,1692,1696,-8,-4,7448,"12,638.67",25420
,20160912,1692,1696,1692,1692,1594,1594,1612,-102,-84,15966,"25,760.72",15364
,20160913,1594,1612,1570,1596,1550,1586,1574,-26,-38,4832,"7,611.03",12830
,20160914,1586,1574,1586,1610,1580,1596,1592,22,18,2478,"3,945.44",11284
,20160919,1596,1592,1590,1610,1590,1600,1598,8,6,882,"1,409.73",10538
bu1610,20160418,1970,1970,1980,2022,1944,1988,1982,18,12,14,27.77,4
,20160419,1988,1982,1988,2052,1986,2052,2008,70,26,6,12.05,4
,20160420,2052,2008,2028,2108,2018,2090,2066,82,58,228,471.09,66
,20160421,2090,2066,2086,2188,2024,2188,2106,122,40,400,842.74,92
,20160422,2188,2106,2186,2186,2054,2078,2156,-28,50,334,720.42,120
,20160425,2078,2156,2072,2230,2072,2148,2168,-8,12,332,720.28,256
,20160426,2148,2168,2120,2162,2070,2130,2122,-38,-46,236,500.99,122
,20160427,2130,2122,2102,2158,2086,2134,2120,12,-2,90,190.91,116
,20160428,2134,2120,2114,2148,2044,2078,2106,-42,-14,302,636.29,104
,20160429,2078,2106,2108,2108,2086,2100,2094,-6,-12,136,284.90,104
,20160503,2100,2094,2050,2064,2010,2018,2026,-76,-68,56,113.54,92
,20160504,2018,2026,2018,2024,2018,2024,2020,-2,-6,6,12.12,90
,20160505,2024,2020,2012,2012,1998,2002,2004,-18,-16,6,12.02,90
,20160506,2002,2004,2018,2042,1998,1998,2028,-6,24,84,170.36,90
,20160509,1998,2028,,,,1982,1982,-46,-46,0,0.00,90
,20160510,1982,1982,1920,1942,1894,1918,1928,-64,-54,200,385.79,94
,20160511,1918,1928,1958,1984,1952,1964,1960,36,32,110,215.79,98
,20160512,1964,1960,1952,2014,1952,2006,1998,46,38,28,55.98,112
,20160513,2006,1998,2006,2006,1962,1968,1984,-30,-14,12,23.82,112
,20160516,1968,1984,1982,2024,1966,2012,1992,28,8,70,139.44,108
,20160517,2012,1992,2060,2062,2040,2040,2048,48,56,82,168.10,116
,20160518,2040,2048,2016,2026,2016,2018,2020,-30,-28,6,12.12,118
,20160519,2018,2020,2008,2042,1988,1988,2012,-32,-8,30,60.40,120
,20160520,1988,2012,1940,1988,1932,1988,1952,-24,-60,394,769.68,214
,20160523,1988,1952,1954,1962,1870,1888,1890,-64,-62,52,98.31,214
,20160524,1888,1890,,,,1858,1858,-32,-32,0,0.00,214
,20160525,1858,1858,1880,1898,1876,1876,1884,18,26,12,22.61,212
,20160526,1876,1884,1906,1906,1898,1898,1904,14,20,46,87.66,212
,20160527,1898,1904,1880,1884,1880,1880,1882,-24,-22,10,18.82,220
,20160530,1880,1882,1868,1888,1866,1866,1876,-16,-6,24,45.04,220
,20160531,1866,1876,1888,1900,1888,1894,1894,18,18,14,26.53,222
,20160601,1894,1894,1890,1898,1874,1874,1884,-20,-10,80,150.84,222
,20160602,1874,1884,1854,1888,1854,1872,1880,-12,-4,44,82.75,202
,20160603,1872,1880,1886,1886,1882,1882,1884,2,4,8,15.07,200
,20160606,1882,1884,1942,1942,1922,1938,1932,54,48,18,34.79,198
,20160607,1938,1932,1940,1940,1932,1932,1936,0,4,4,7.74,196
,20160608,1932,1936,,,,1936,1936,0,0,0,0.00,196
,20160613,1936,1936,1934,1934,1934,1934,1934,-2,-2,2,3.87,196
,20160614,1934,1934,1962,1974,1956,1974,1970,40,36,36,70.93,172
,20160615,1974,1970,1944,1944,1944,1944,1944,-26,-26,2,3.89,172
,20160616,1944,1944,1956,1956,1956,1956,1956,12,12,2,3.91,172
,20160617,1956,1956,,,,1956,1956,0,0,0,0.00,172
,20160620,1956,1956,2000,2014,2000,2014,2002,58,46,12,24.03,172
,20160621,2014,2002,,,,2002,2002,0,0,0,0.00,172
,20160622,2002,2002,1994,2030,1992,2030,2024,28,22,36,72.93,140
,20160623,2030,2024,2054,2054,2040,2040,2044,16,20,8,16.36,138
,20160624,2040,2044,2038,2046,1988,2004,2020,-40,-24,18,36.37,128
,20160627,2004,2020,2006,2028,2006,2028,2020,8,0,6,12.12,128
,20160628,2028,2020,2032,2032,2016,2016,2024,-4,4,4,8.10,126
,20160629,2016,2024,2090,2092,2052,2084,2068,60,44,36,74.47,130
,20160630,2084,2068,2106,2148,2076,2124,2106,56,38,48,101.10,132
,20160701,2124,2106,2110,2116,2088,2090,2104,-16,-2,100,210.58,182
,20160704,2090,2104,2090,2168,2090,2168,2132,64,28,126,268.71,280
,20160705,2168,2132,2138,2142,2042,2084,2102,-48,-30,152,319.68,236
,20160706,2084,2102,2034,2064,1974,1992,2000,-110,-102,336,672.02,252
,20160707,1992,2000,1992,2018,1986,1992,1994,-8,-6,278,554.67,246
,20160708,1992,1994,2004,2004,1944,1962,1974,-32,-20,32,63.23,246
,20160711,1962,1974,1978,1998,1966,1998,1980,24,6,8,15.84,242
,20160712,1998,1980,1998,2038,1998,2038,2016,58,36,14,28.24,240
,20160713,2038,2016,2082,2084,2042,2056,2060,40,44,166,342.20,298
,20160714,2056,2060,2062,2112,2038,2104,2084,44,24,126,262.60,252
,20160715,2104,2084,2104,2106,2072,2072,2082,-12,-2,76,158.36,268
,20160718,2072,2082,2112,2112,2010,2020,2028,-62,-54,768,"1,558.91",264
,20160719,2020,2028,2030,2032,1992,2004,2012,-24,-16,36,72.44,266
,20160720,2004,2012,1998,1998,1998,1998,1998,-14,-14,4,7.99,262
,20160721,1998,1998,2020,2072,2020,2072,2038,74,40,56,114.22,248
,20160722,2072,2038,2058,2058,2012,2012,2032,-26,-6,10,20.32,248
,20160725,2012,2032,2020,2020,1924,2018,2006,-14,-26,194,389.19,270
,20160726,2018,2006,2020,2026,1996,2018,2016,12,10,72,145.27,254
,20160727,2018,2016,2016,2064,2014,2024,2044,8,28,264,540.06,214
,20160728,2024,2044,2022,2022,2022,2022,2022,-22,-22,6,12.13,214
,20160729,2022,2022,2026,2026,1906,1906,1974,-116,-48,112,221.30,214
,20160801,1906,1974,1930,1954,1926,1954,1936,-20,-38,48,93.00,236
,20160802,1954,1936,1924,1932,1894,1910,1920,-26,-16,62,119.05,244
,20160803,1910,1920,1928,1938,1918,1924,1930,4,10,18,34.75,250
,20160804,1924,1930,1928,1948,1910,1910,1926,-20,-4,60,115.58,246
,20160805,1910,1926,1924,1924,1896,1898,1904,-28,-22,124,236.27,356
,20160808,1898,1904,1878,1964,1874,1922,1916,18,12,150,287.49,374
,20160809,1922,1916,1916,1924,1898,1904,1912,-12,-4,68,130.10,402
,20160810,1904,1912,1916,1920,1892,1908,1904,-4,-8,184,350.59,386
,20160811,1908,1904,1906,1906,1884,1892,1894,-12,-10,58,109.85,410
,20160812,1892,1894,1892,1910,1892,1904,1900,10,6,48,91.28,408
,20160815,1904,1900,1898,1914,1892,1904,1900,4,0,80,152.06,408
,20160816,1904,1900,1894,1894,1868,1868,1880,-32,-20,180,338.45,526
,20160817,1868,1880,1874,1882,1850,1858,1864,-22,-16,252,470.06,646
,20160818,1858,1864,1860,1862,1814,1814,1836,-50,-28,228,419.05,756
,20160819,1814,1836,1824,1826,1794,1810,1810,-26,-26,248,449.12,800
,20160822,1810,1810,1814,1820,1780,1780,1796,-30,-14,476,855.42,762
,20160823,1780,1796,1788,1796,1772,1784,1782,-12,-14,78,139.14,762
,20160824,1784,1782,1776,1798,1770,1790,1788,8,6,116,207.49,720
,20160825,1790,1788,1792,1794,1748,1754,1766,-34,-22,242,427.48,684
,20160826,1754,1766,1756,1802,1756,1764,1768,-2,2,132,233.61,718
,20160829,1764,1768,1770,1774,1758,1766,1766,-2,-2,100,176.66,730
,20160830,1766,1766,1764,1764,1724,1724,1750,-42,-16,188,329.36,888
,20160831,1724,1750,1726,1740,1694,1728,1714,-22,-36,300,514.77,994
,20160901,1728,1714,1720,1736,1716,1730,1726,16,12,80,138.17,1006
,20160902,1730,1726,1728,1738,1724,1726,1730,0,4,148,256.06,976
,20160905,1726,1730,1734,1736,1724,1736,1728,6,-2,84,145.30,976
,20160906,1736,1728,1732,1760,1728,1760,1742,32,14,126,219.70,954
,20160907,1760,1742,1764,1764,1746,1752,1752,10,10,108,189.22,946
,20160908,1752,1752,1758,1768,1730,1754,1746,2,-6,78,136.27,926
,20160909,1754,1746,1754,1768,1740,1740,1748,-6,2,214,374.48,1058
,20160912,1740,1748,1724,1730,1642,1644,1658,-104,-90,710,"1,177.81",1396
,20160913,1644,1658,1634,1642,1604,1620,1626,-38,-32,420,683.39,1602
,20160914,1620,1626,1620,1636,1616,1630,1624,4,-2,246,399.72,1536
,20160919,1630,1624,1632,1644,1624,1634,1632,10,8,60,97.97,1532
,20160920,1634,1632,1632,1646,1624,1634,1634,2,2,190,310.69,1438
,20160921,1634,1634,1628,1644,1610,1642,1630,8,-4,898,"1,465.10",1314
,20160922,1642,1630,1642,1650,1634,1638,1644,8,14,292,480.20,1156
,20160923,1638,1644,1646,1646,1612,1636,1620,-8,-24,554,898.21,1174
,20160926,1636,1620,1632,1634,1616,1628,1626,8,6,182,296.19,1062
,20160927,1628,1626,1614,1626,1608,1610,1614,-16,-12,90,145.39,1032
,20160928,1610,1614,1586,1610,1530,1546,1546,-68,-68,410,634.31,834
,20160929,1546,1546,1560,1622,1550,1598,1588,52,42,326,517.90,846
,20160930,1598,1588,1612,1618,1586,1616,1606,28,18,184,295.76,710
,20161010,1616,1606,1608,1634,1608,1634,1626,28,20,246,400.38,568
,20161011,1634,1626,1640,1652,1622,1622,1628,-4,2,48,78.18,526
,20161012,1622,1628,1558,1640,1530,1530,1556,-98,-72,722,"1,124.76",464
,20161013,1530,1556,1432,1432,1428,1430,1428,-126,-128,118,168.70,464
,20161014,1430,1428,1450,1500,1450,1500,1494,72,66,54,80.76,416
,20161017,1500,1494,1460,1470,1460,1470,1460,-24,-34,46,67.22,370
bu1611,20160517,1992,1992,2088,2088,2046,2046,2066,54,74,4,8.27,0
,20160518,2046,2066,,,,2036,2036,-30,-30,0,0.00,0
,20160519,2036,2036,2044,2044,1986,1986,2014,-50,-22,8,16.12,4
,20160520,1986,2014,,,,2014,2014,0,0,0,0.00,4
,20160523,2014,2014,,,,1950,1950,-64,-64,0,0.00,4
,20160524,1950,1950,1876,1902,1876,1902,1888,-48,-62,4,7.56,2
,20160525,1902,1888,,,,1914,1914,26,26,0,0.00,2
,20160526,1914,1914,,,,1934,1934,20,20,0,0.00,2
,20160527,1934,1934,,,,1910,1910,-24,-24,0,0.00,2
,20160530,1910,1910,1874,1942,1874,1896,1908,-14,-2,28,53.46,12
,20160531,1896,1908,1924,1924,1924,1924,1924,16,16,6,11.54,6
,20160601,1924,1924,1902,1902,1872,1872,1892,-52,-32,6,11.35,4
,20160602,1872,1892,,,,1892,1892,0,0,0,0.00,4
,20160603,1892,1892,,,,1892,1892,0,0,0,0.00,4
,20160606,1892,1892,,,,1940,1940,48,48,0,0.00,4
,20160607,1940,1940,,,,1940,1940,0,0,0,0.00,4
,20160608,1940,1940,,,,1940,1940,0,0,0,0.00,4
,20160613,1940,1940,,,,1940,1940,0,0,0,0.00,4
,20160614,1940,1940,,,,1940,1940,0,0,0,0.00,4
,20160615,1940,1940,,,,1940,1940,0,0,0,0.00,4
,20160616,1940,1940,,,,1940,1940,0,0,0,0.00,4
,20160617,1940,1940,,,,1940,1940,0,0,0,0.00,4
,20160620,1940,1940,,,,1984,1984,44,44,0,0.00,4
,20160621,1984,1984,,,,1984,1984,0,0,0,0.00,4
,20160622,1984,1984,,,,2006,2006,22,22,0,0.00,4
,20160623,2006,2006,,,,2026,2026,20,20,0,0.00,4
,20160624,2026,2026,2026,2080,2026,2080,2052,54,26,4,8.21,4
,20160627,2080,2052,,,,2052,2052,0,0,0,0.00,4
,20160628,2052,2052,,,,2052,2052,0,0,0,0.00,4
,20160629,2052,2052,,,,2096,2096,44,44,0,0.00,4
,20160630,2096,2096,,,,2096,2096,0,0,0,0.00,4
,20160701,2096,2096,,,,2096,2096,0,0,0,0.00,4
,20160704,2096,2096,2158,2220,2158,2220,2200,124,104,32,70.45,26
,20160705,2220,2200,2208,2208,2142,2142,2192,-58,-8,18,39.47,12
,20160706,2142,2192,,,,2084,2084,-108,-108,0,0.00,12
,20160707,2084,2084,2086,2096,2042,2048,2066,-36,-18,16,33.07,10
,20160708,2048,2066,2046,2046,2046,2046,2046,-20,-20,2,4.09,10
,20160711,2046,2046,,,,2046,2046,0,0,0,0.00,10
,20160712,2046,2046,2058,2072,2054,2054,2060,8,14,6,12.37,10
,20160713,2054,2060,,,,2106,2106,46,46,0,0.00,10
,20160714,2106,2106,2146,2146,2146,2146,2146,40,40,2,4.29,12
,20160715,2146,2146,2192,2192,2126,2126,2158,-20,12,4,8.64,14
,20160718,2126,2158,2126,2126,2110,2110,2118,-48,-40,4,8.47,16
,20160719,2110,2118,2050,2090,2024,2034,2058,-84,-60,20,41.18,24
,20160720,2034,2058,2052,2052,2026,2026,2042,-32,-16,6,12.25,22
,20160721,2026,2042,,,,2084,2084,42,42,0,0.00,22
,20160722,2084,2084,2084,2084,2084,2084,2084,0,0,2,4.17,22
,20160725,2084,2084,2046,2046,2046,2046,2046,-38,-38,2,4.09,24
,20160726,2046,2046,2048,2048,2004,2004,2032,-42,-14,8,16.26,28
,20160727,2004,2032,2012,2014,2012,2012,2012,-20,-20,20,40.25,42
,20160728,2012,2012,,,,2012,2012,0,0,0,0.00,42
,20160729,2012,2012,1996,1996,1964,1966,1970,-46,-42,10,19.72,34
,20160801,1966,1970,1950,1950,1950,1950,1950,-20,-20,2,3.90,32
,20160802,1950,1950,1940,1940,1940,1940,1940,-10,-10,2,3.88,30
,20160803,1940,1940,,,,1940,1940,0,0,0,0.00,30
,20160804,1940,1940,,,,1940,1940,0,0,0,0.00,30
,20160805,1940,1940,1978,1978,1952,1954,1958,14,18,10,19.60,30
,20160808,1954,1958,1980,1980,1926,1958,1956,0,-2,24,46.94,30
,20160809,1958,1956,1970,1984,1948,1948,1970,-8,14,18,35.46,26
,20160810,1948,1970,2000,2000,1958,1980,1972,10,2,18,35.53,26
,20160811,1980,1972,,,,1972,1972,0,0,0,0.00,26
,20160812,1972,1972,,,,1972,1972,0,0,0,0.00,26
,20160815,1972,1972,2002,2002,1984,1984,1992,12,20,40,79.74,26
,20160816,1984,1992,2020,2020,1996,1996,2000,4,8,16,32.02,26
,20160817,1996,2000,1990,2030,1934,1940,1968,-60,-32,72,141.82,62
,20160818,1940,1968,1940,1956,1940,1940,1940,-28,-28,44,85.39,94
,20160819,1940,1940,1910,1948,1908,1914,1920,-26,-20,12,23.05,96
,20160822,1914,1920,1922,1922,1846,1846,1872,-74,-48,16,29.95,90
,20160823,1846,1872,1848,1906,1846,1864,1886,-8,14,288,543.60,270
,20160824,1864,1886,1860,1860,1860,1860,1860,-26,-26,2,3.72,268
,20160825,1860,1860,1854,1854,1806,1816,1826,-44,-34,52,95.03,274
,20160826,1816,1826,,,,1826,1826,0,0,0,0.00,274
,20160829,1826,1826,1858,1858,1846,1846,1852,20,26,10,18.53,272
,20160830,1846,1852,1836,1838,1836,1838,1836,-14,-16,6,11.02,272
,20160831,1838,1836,1818,1826,1796,1806,1812,-30,-24,16,28.99,270
,20160901,1806,1812,1810,1842,1810,1842,1816,30,4,42,76.32,268
,20160902,1842,1816,1840,1850,1832,1846,1842,30,26,76,140.00,268
,20160905,1846,1842,1850,1850,1850,1850,1850,8,8,4,7.40,268
,20160906,1850,1850,1860,1870,1860,1868,1866,18,16,50,93.30,272
,20160907,1868,1866,1866,1870,1854,1870,1864,4,-2,28,52.22,266
,20160908,1870,1864,1874,1876,1836,1842,1846,-22,-18,38,70.18,288
,20160909,1842,1846,1864,1864,1848,1850,1850,4,4,118,218.53,394
,20160912,1850,1850,1848,1848,1756,1764,1774,-86,-76,360,639.01,276
,20160913,1764,1774,1778,1778,1748,1762,1762,-12,-12,66,116.30,284
,20160914,1762,1762,1756,1770,1754,1756,1760,-6,-2,94,165.60,278
,20160919,1756,1760,1770,1770,1770,1770,1770,10,10,4,7.08,282
,20160920,1770,1770,1776,1776,1776,1776,1776,6,6,4,7.10,282
,20160921,1776,1776,1778,1802,1762,1762,1786,-14,10,38,67.91,290
,20160922,1762,1786,1772,1798,1770,1770,1784,-16,-2,50,89.23,312
,20160923,1770,1784,1776,1782,1758,1758,1772,-26,-12,48,85.06,290
,20160926,1758,1772,1766,1776,1764,1766,1770,-6,-2,102,180.64,364
,20160927,1766,1770,1762,1766,1744,1744,1758,-26,-12,48,84.39,390
,20160928,1744,1758,1700,1700,1654,1658,1680,-100,-78,76,127.71,412
,20160929,1658,1680,,,,1680,1680,0,0,0,0.00,412
,20160930,1680,1680,,,,1700,1700,20,20,0,0.00,412
,20161010,1700,1700,1686,1700,1678,1696,1688,-4,-12,20,33.76,416
,20161011,1696,1688,1704,1750,1704,1708,1716,20,28,14,24.02,412
,20161012,1708,1716,1694,1696,1638,1674,1674,-42,-42,32,53.63,432
,20161013,1674,1674,1666,1688,1624,1674,1660,0,-14,128,212.61,456
,20161014,1674,1660,1678,1688,1650,1674,1676,14,16,84,140.85,446
,20161017,1674,1676,1684,1722,1684,1710,1706,34,30,36,61.44,450
,20161018,1710,1706,1688,1700,1684,1700,1694,-6,-12,24,40.68,434
,20161019,1700,1694,1728,1766,1698,1718,1718,24,24,72,123.75,424
,20161020,1718,1718,1766,1786,1720,1784,1772,66,54,316,559.99,480
,20161021,1784,1772,1776,1780,1760,1768,1766,-4,-6,278,491.34,458
,20161024,1768,1766,1782,1782,1782,1782,1782,16,16,6,10.69,452
,20161025,1782,1782,1796,1796,1750,1758,1768,-24,-14,6,10.61,450
,20161026,1758,1768,1738,1748,1684,1684,1718,-84,-50,80,137.56,452
,20161027,1684,1718,1714,1714,1682,1682,1702,-36,-16,6,10.22,446
,20161028,1682,1702,1754,1760,1754,1760,1756,58,54,68,119.46,512
,20161031,1760,1756,1748,1748,1708,1730,1728,-26,-28,62,107.25,566
,20161101,1730,1728,1740,1780,1740,1780,1774,52,46,54,95.86,596
,20161102,1780,1774,1832,1832,1784,1800,1808,26,34,24,43.43,592
,20161103,1800,1808,1742,1770,1742,1770,1766,-38,-42,46,81.31,592
,20161104,1770,1766,1754,1772,1704,1704,1734,-62,-32,16,27.74,582
,20161107,1704,1734,1750,1750,1716,1716,1732,-18,-2,38,65.89,578
,20161108,1716,1732,1750,1786,1734,1786,1756,54,24,6,10.54,578
,20161109,1786,1756,1778,1778,1712,1712,1738,-44,-18,10,17.40,576
,20161110,1712,1738,1632,1842,1632,1842,1738,104,0,116,201.78,566
,20161111,1842,1738,1842,1842,1842,1842,1842,104,104,2,3.68,566
,20161114,1842,1842,1842,1842,1842,1842,1842,0,0,4,7.37,562
,20161115,1842,1842,,,,1842,1842,0,0,0,0.00,562
bu1612,20160104,2004,2004,1990,1994,1928,1928,1942,-76,-62,168,326.43,256
,20160105,1928,1942,1928,1940,1906,1930,1926,-12,-16,76,146.44,274
,20160106,1930,1926,1932,1932,1908,1926,1918,0,-8,76,145.82,294
,20160107,1926,1918,1900,1916,1874,1886,1896,-32,-22,56,106.22,316
,20160108,1886,1896,1890,1928,1890,1928,1914,32,18,32,61.26,326
,20160111,1928,1914,1916,1944,1882,1884,1902,-30,-12,356,677.17,388
,20160112,1884,1902,1884,1886,1804,1804,1838,-98,-64,56,102.98,406
,20160113,1804,1838,1836,1852,1812,1820,1830,-18,-8,240,439.61,484
,20160114,1820,1830,1830,1848,1804,1828,1816,-2,-14,142,257.94,478
,20160115,1828,1816,1836,1844,1828,1828,1838,12,22,26,47.79,474
,20160118,1828,1838,1788,1848,1786,1840,1820,2,-18,420,764.76,464
,20160119,1840,1820,1854,1866,1834,1860,1854,40,34,100,185.52,498
,20160120,1860,1854,1866,1868,1814,1832,1846,-22,-8,94,173.54,524
,20160121,1832,1846,1828,1844,1818,1820,1826,-26,-20,72,131.56,548
,20160122,1820,1826,1818,1870,1788,1864,1836,38,10,260,477.86,582
,20160125,1864,1836,1922,1922,1848,1858,1858,22,22,168,312.43,590
,20160126,1858,1858,1850,1862,1848,1856,1854,-2,-4,28,51.95,596
,20160127,1856,1854,1856,1878,1856,1876,1872,22,18,108,202.22,578
,20160128,1876,1872,1880,1900,1878,1882,1888,10,16,102,192.69,584
,20160129,1882,1888,1890,1892,1842,1842,1866,-46,-22,126,235.22,628
,20160201,1842,1866,1838,1850,1806,1806,1830,-60,-36,426,780.36,706
,20160202,1806,1830,1810,1818,1800,1816,1810,-14,-20,88,159.32,726
,20160203,1816,1810,1806,1820,1790,1808,1808,-2,-2,270,488.59,760
,20160204,1808,1808,1818,1850,1814,1842,1830,34,22,162,296.60,742
,20160205,1842,1830,1848,1848,1806,1806,1812,-24,-18,110,199.42,758
,20160215,1806,1812,1784,1812,1784,1796,1802,-16,-10,176,317.34,828
,20160216,1796,1802,1802,1866,1802,1832,1832,30,30,400,733.28,1042
,20160217,1832,1832,1838,1874,1820,1826,1832,-6,0,174,318.93,1072
,20160218,1826,1832,1836,1860,1828,1846,1840,14,8,476,876.63,1146
,20160219,1846,1840,1846,1866,1838,1860,1852,20,12,210,388.97,1244
,20160222,1860,1852,1866,1962,1802,1860,1880,8,28,1548,"2,912.80",1048
,20160223,1860,1880,1858,1878,1846,1864,1860,-16,-20,902,"1,677.88",1142
,20160224,1864,1860,1860,1872,1832,1842,1854,-18,-6,576,"1,068.21",1180
,20160225,1842,1854,1840,1862,1828,1836,1844,-18,-10,480,885.21,1176
,20160226,1836,1844,1838,1902,1822,1900,1872,56,28,792,"1,483.62",902
,20160229,1900,1872,1914,1928,1880,1892,1904,20,32,458,872.26,1002
,20160301,1892,1904,1902,1952,1880,1936,1910,32,6,522,997.13,986
,20160302,1936,1910,1948,1986,1928,1978,1956,68,46,364,712.52,1036
,20160303,1978,1956,1978,2008,1970,1976,1988,20,32,688,"1,368.70",1258
,20160304,1976,1988,1966,2010,1956,1992,1982,4,-6,816,"1,617.83",1228
,20160307,1992,1982,2008,2100,1994,2090,2042,108,60,1648,"3,368.49",1250
,20160308,2090,2042,2148,2148,1918,2014,2036,-28,-6,2970,"6,051.40",1712
,20160309,2014,2036,2030,2030,1918,1980,1960,-56,-76,1436,"2,815.35",1854
,20160310,1980,1960,2002,2018,1950,1954,1982,-6,22,1596,"3,164.28",1992
,20160311,1954,1982,1964,1996,1952,1976,1974,-6,-8,486,959.40,1990
,20160314,1976,1974,1992,2026,1988,1998,2002,24,28,304,609.17,2008
,20160315,1998,2002,1984,1992,1960,1964,1972,-38,-30,328,647.20,2020
,20160316,1964,1972,1954,2000,1954,2000,1988,28,16,450,895.09,1926
,20160317,2000,1988,2000,2048,2000,2030,2022,42,34,910,"1,840.54",1822
,20160318,2030,2022,2044,2100,2042,2078,2080,56,58,726,"1,511.15",1698
,20160321,2078,2080,2082,2136,2056,2092,2096,12,16,1256,"2,634.56",1764
,20160322,2092,2096,2092,2148,2060,2108,2116,12,20,1104,"2,337.69",1802
,20160323,2108,2116,2110,2146,2080,2082,2124,-34,8,1886,"4,009.23",2394
,20160324,2082,2124,2072,2116,1996,1996,2044,-128,-80,1862,"3,809.12",2590
,20160325,1996,2044,1988,2034,1980,2022,2008,-22,-36,3396,"6,824.02",2800
,20160328,2022,2008,2034,2046,1982,1984,2024,-24,16,1886,"3,817.57",3072
,20160329,1984,2024,1988,2018,1960,1974,1988,-50,-36,1742,"3,465.29",3654
,20160330,1974,1988,1966,2002,1954,1986,1984,-2,-4,634,"1,257.96",3570
,20160331,1986,1984,1996,2020,1920,1936,1960,-48,-24,1324,"2,597.02",3508
,20160401,1936,1960,1936,1966,1928,1952,1952,-8,-8,2998,"5,855.48",3938
,20160405,1952,1952,1902,1934,1848,1888,1878,-64,-74,3580,"6,725.13",3808
,20160406,1888,1878,1870,1900,1870,1888,1894,10,16,2222,"4,208.69",4330
,20160407,1888,1894,1888,1920,1888,1900,1904,6,10,2978,"5,671.28",4882
,20160408,1900,1904,1890,1920,1872,1920,1904,16,0,2292,"4,364.64",5476
,20160411,1920,1904,1940,2018,1934,1954,1964,50,60,15202,"29,863.17",10478
,20160412,1954,1964,1960,1994,1956,1984,1976,20,12,5964,"11,795.57",11872
,20160413,1984,1976,1986,2080,1980,2016,2018,40,42,19858,"40,107.76",18420
,20160414,2016,2018,2024,2056,2010,2030,2030,12,12,8104,"16,466.14",19440
,20160415,2030,2030,2048,2062,2010,2018,2036,-12,6,10234,"20,852.27",19212
,20160418,2018,2036,2012,2034,1970,2014,2002,-22,-34,13280,"26,610.43",20260
,20160419,2014,2002,2016,2100,2014,2066,2058,64,56,16914,"34,824.14",21524
,20160420,2066,2058,2064,2138,2050,2110,2094,52,36,26584,"55,666.91",28370
,20160421,2110,2094,2108,2218,2020,2218,2134,124,40,35960,"76,779.36",36182
,20160422,2218,2134,2222,2230,2066,2140,2150,6,16,35336,"76,004.04",35670
,20160425,2140,2150,2154,2250,2100,2150,2166,0,16,35302,"76,483.22",39346
,20160426,2150,2166,2172,2176,2098,2134,2144,-32,-22,37260,"79,945.90",43038
,20160427,2134,2144,2152,2202,2102,2162,2154,18,10,32270,"69,536.10",48332
,20160428,2162,2154,2172,2174,2074,2106,2128,-48,-26,31586,"67,256.45",60432
,20160429,2106,2128,2126,2142,2100,2118,2120,-10,-8,22258,"47,228.70",65520
,20160503,2118,2120,2092,2098,2034,2050,2052,-70,-68,23840,"48,943.80",71688
,20160504,2050,2052,2042,2050,2018,2028,2032,-24,-20,16474,"33,498.80",74638
,20160505,2028,2032,2038,2052,2014,2026,2038,-6,6,13816,"28,168.92",75412
,20160506,2026,2038,2050,2068,1974,1984,2010,-54,-28,26130,"52,551.78",76426
,20160509,1984,2010,1974,2012,1920,1938,1964,-72,-46,44206,"86,843.61",76026
,20160510,1938,1964,1912,1950,1900,1948,1924,-16,-40,20030,"38,567.68",77732
,20160511,1948,1924,1948,2002,1948,1990,1978,66,54,19014,"37,618.23",77826
,20160512,1990,1978,2002,2044,1972,2022,2008,44,30,22034,"44,285.22",77594
,20160513,2022,2008,2026,2050,1968,1982,2002,-26,-6,27012,"54,130.52",76876
,20160516,1982,2002,1976,2046,1960,2042,2014,40,12,24360,"49,107.46",74820
,20160517,2042,2014,2048,2080,2040,2064,2062,50,48,26842,"55,387.12",76476
,20160518,2064,2062,2054,2084,2024,2042,2050,-20,-12,35084,"71,952.30",73876
,20160519,2042,2050,2036,2070,1988,1990,2030,-60,-20,34654,"70,384.56",73894
,20160520,1990,2030,1988,2012,1946,1994,1982,-36,-48,36514,"72,376.08",76616
,20160523,1994,1982,1988,2002,1866,1904,1924,-78,-58,41574,"80,069.26",80930
,20160524,1904,1924,1900,1926,1874,1878,1898,-46,-26,34860,"66,185.27",80232
,20160525,1878,1898,1908,1938,1894,1934,1916,36,18,38694,"74,213.14",81146
,20160526,1934,1916,1938,1960,1926,1958,1942,42,26,28150,"54,706.14",82178
,20160527,1958,1942,1962,1970,1908,1918,1926,-24,-16,40574,"78,203.97",82500
,20160530,1918,1926,1914,1952,1906,1940,1932,14,6,37280,"72,063.45",83230
,20160531,1940,1932,1942,1968,1932,1936,1950,4,18,25696,"50,157.11",81568
,20160601,1936,1950,1940,1952,1886,1904,1916,-46,-34,35496,"68,043.10",83016
,20160602,1904,1916,1898,1934,1894,1922,1918,6,2,29868,"57,332.22",85334
,20160603,1922,1918,1916,1958,1912,1952,1936,34,18,29068,"56,287.15",90064
,20160606,1952,1936,1962,1988,1932,1982,1964,46,28,45292,"88,962.80",97484
,20160607,1982,1964,1990,2010,1970,1994,1988,30,24,36282,"72,167.57",103412
,20160608,1994,1988,2000,2006,1976,1988,1992,0,4,30950,"61,698.20",107358
,20160613,1988,1992,1964,2016,1948,2004,1990,12,-2,33398,"66,501.97",108172
,20160614,2004,1990,1992,2054,1992,2026,2028,36,38,58446,"118,593.05",115712
,20160615,2026,2028,2022,2044,1980,2002,2004,-26,-24,59120,"118,502.06",120946
,20160616,2002,2004,2008,2012,1990,1996,2002,-8,-2,44730,"89,551.71",123342
,20160617,1996,2002,1996,2010,1966,2010,1988,8,-14,69798,"138,792.06",115534
,20160620,2010,1988,2018,2072,2010,2064,2044,76,56,76010,"155,453.58",130148
,20160621,2064,2044,2076,2088,2054,2060,2070,16,26,64238,"133,027.98",124410
,20160622,2060,2070,2050,2112,2040,2110,2082,40,12,52830,"110,034.70",129502
,20160623,2110,2082,2108,2120,2088,2096,2102,14,20,53864,"113,274.86",131412
,20160624,2096,2102,2112,2128,2048,2052,2084,-50,-18,100970,"210,511.70",138020
,20160627,2052,2084,2048,2112,2048,2110,2078,26,-6,69798,"145,176.08",150080
,20160628,2110,2078,2092,2118,2060,2102,2090,24,12,90290,"188,874.82",161600
,20160629,2102,2090,2114,2154,2102,2142,2130,52,40,129070,"274,923.65",167504
,20160630,2142,2130,2144,2236,2138,2200,2190,70,60,204220,"447,420.97",187086
,20160701,2200,2190,2184,2210,2150,2164,2184,-26,-6,181040,"395,405.37",178934
,20160704,2164,2184,2178,2288,2152,2264,2234,80,50,280080,"625,941.36",225398
,20160705,2264,2234,2274,2280,2110,2156,2192,-78,-42,326870,"716,959.19",219138
,20160706,2156,2192,2120,2172,2060,2064,2102,-128,-90,251274,"528,298.38",211022
,20160707,2064,2102,2060,2106,2052,2066,2080,-36,-22,161614,"336,287.62",211836
,20160708,2066,2080,2074,2092,2004,2024,2042,-56,-38,202486,"413,723.24",212210
,20160711,2024,2042,2038,2062,2018,2050,2038,8,-4,143372,"292,360.26",227514
,20160712,2050,2038,2066,2116,2050,2116,2078,78,40,167750,"348,831.00",236738
,20160713,2116,2078,2122,2152,2086,2106,2122,28,44,221100,"469,545.39",249952
,20160714,2106,2122,2102,2188,2082,2156,2140,34,18,331994,"710,756.76",305244
,20160715,2156,2140,2170,2172,2116,2142,2138,2,-2,204034,"436,352.20",322330
,20160718,2142,2138,2154,2156,2060,2062,2108,-76,-30,249028,"525,238.91",312962
,20160719,2062,2108,2052,2088,2032,2056,2060,-52,-48,169570,"349,576.29",316680
,20160720,2056,2060,2060,2078,2044,2070,2062,10,2,162828,"335,993.86",319824
,20160721,2070,2062,2050,2112,2044,2106,2082,44,20,232216,"483,480.26",324432
,20160722,2106,2082,2100,2108,2048,2052,2076,-30,-6,205552,"426,892.32",333032
,20160725,2052,2076,2052,2066,2004,2048,2038,-28,-38,250918,"511,413.79",346692
,20160726,2048,2038,2040,2064,2006,2018,2030,-20,-8,283844,"576,326.56",391048
,20160727,2018,2030,2010,2056,1990,2006,2016,-24,-14,385396,"777,667.85",405382
,20160728,2006,2016,2014,2028,1986,1996,2008,-20,-8,339692,"682,138.94",429000
,20160729,1996,2008,2000,2010,1918,1930,1970,-78,-38,405762,"799,372.50",452698
,20160801,1930,1970,1930,1974,1924,1966,1952,-4,-18,317318,"619,591.45",469076
,20160802,1966,1952,1954,1976,1934,1966,1952,14,0,375188,"732,849.10",502104
,20160803,1966,1952,1978,2004,1952,1960,1974,8,22,464428,"916,844.46",542312
,20160804,1960,1974,1970,1990,1946,1964,1966,-10,-8,727214,"1,429,709.44",602890
,20160805,1964,1966,1964,1984,1956,1964,1968,-2,2,673230,"1,325,693.31",631284
,20160808,1964,1968,1968,2012,1936,2004,1982,36,14,1067934,"2,117,585.06",662628
,20160809,2004,1982,2010,2020,1976,2002,2000,20,18,777870,"1,556,089.20",696022
,20160810,2002,2000,2004,2022,1984,1996,2006,-4,6,820452,"1,646,871.78",730560
,20160811,1996,2006,2004,2014,1972,1980,1990,-26,-16,893488,"1,779,034.84",817918
,20160812,1980,1990,1982,2030,1978,2030,2006,40,16,887836,"1,782,236.08",783262
,20160815,2030,2006,2022,2054,2008,2038,2030,32,24,934236,"1,897,300.07",838390
,20160816,2038,2030,2038,2054,2020,2020,2032,-10,2,894626,"1,818,802.70",895662
,20160817,2020,2032,2024,2044,2016,2022,2028,-10,-4,800096,"1,623,935.44",941798
,20160818,2022,2028,2028,2034,1986,1996,2012,-32,-16,1036706,"2,086,034.44",974528
,20160819,1996,2012,2002,2010,1954,1964,1980,-48,-32,1212006,"2,402,058.58",1070166
,20160822,1964,1980,1958,1974,1896,1896,1934,-84,-46,1181930,"2,287,654.21",1101950
,20160823,1896,1934,1896,1914,1884,1892,1898,-42,-36,857706,"1,628,677.26",1140322
,20160824,1892,1898,1894,1918,1888,1896,1902,-2,4,669334,"1,273,546.24",1145184
,20160825,1896,1902,1896,1908,1832,1854,1862,-48,-40,1250470,"2,328,796.01",1164012
,20160826,1854,1862,1856,1888,1850,1870,1866,8,4,803374,"1,500,307.02",1121248
,20160829,1870,1866,1872,1900,1864,1878,1882,12,16,829294,"1,560,825.59",1118902
,20160830,1878,1882,1878,1884,1852,1858,1868,-24,-14,672114,"1,256,078.37",1165796
,20160831,1858,1868,1860,1872,1824,1852,1846,-16,-22,977742,"1,805,336.06",1188736
,20160901,1852,1846,1850,1880,1844,1876,1862,30,16,758924,"1,414,480.30",1148044
,20160902,1876,1862,1870,1888,1858,1868,1874,6,12,756322,"1,417,585.44",1143120
,20160905,1868,1874,1874,1892,1862,1880,1876,6,2,811734,"1,524,116.47",1147110
,20160906,1880,1876,1886,1916,1874,1910,1896,34,20,814770,"1,545,562.93",1119244
,20160907,1910,1896,1900,1914,1894,1904,1904,8,8,684980,"1,304,398.48",1103526
,20160908,1904,1904,1904,1924,1878,1902,1896,-2,-8,854042,"1,619,873.90",1105352
,20160909,1902,1896,1900,1912,1894,1898,1902,2,6,584228,"1,112,281.06",1103552
,20160912,1898,1902,1894,1898,1814,1824,1850,-78,-52,1304586,"2,414,622.93",1184424
,20160913,1824,1850,1824,1838,1810,1824,1826,-26,-24,758430,"1,385,219.58",1193270
,20160914,1824,1826,1820,1836,1808,1818,1820,-8,-6,711978,"1,296,966.94",1196574
,20160919,1818,1820,1812,1846,1810,1840,1834,20,14,413636,"758,762.36",1167094
,20160920,1840,1834,1840,1854,1832,1840,1842,6,8,603340,"1,111,364.77",1182686
,20160921,1840,1842,1838,1858,1826,1830,1842,-12,0,745628,"1,374,280.24",1194688
,20160922,1830,1842,1826,1862,1818,1822,1838,-20,-4,1073962,"1,975,721.29",1256948
,20160923,1822,1838,1828,1838,1796,1830,1820,-8,-18,1092494,"1,989,013.33",1293324
,20160926,1830,1820,1832,1842,1812,1822,1830,2,10,717356,"1,312,877.60",1279178
,20160927,1822,1830,1824,1832,1796,1808,1812,-22,-18,863472,"1,566,081.61",1337214
,20160928,1808,1812,1802,1802,1702,1718,1744,-94,-68,2138790,"3,730,305.61",1280228
,20160929,1718,1744,1718,1756,1702,1734,1730,-10,-14,1328252,"2,299,345.76",1169824
,20160930,1734,1730,1740,1750,1718,1732,1734,2,4,656974,"1,139,830.86",1097890
,20161010,1732,1734,1752,1756,1724,1730,1734,-4,0,527332,"915,119.85",1117774
,20161011,1730,1734,1740,1794,1740,1770,1770,36,36,1318480,"2,334,479.76",1115182
,20161012,1770,1770,1764,1774,1726,1736,1750,-34,-20,826628,"1,447,613.57",1203980
,20161013,1736,1750,1738,1746,1716,1730,1730,-20,-20,928164,"1,605,962.19",1180382
,20161014,1730,1730,1730,1742,1704,1720,1724,-10,-6,1053922,"1,818,375.94",1253320
,20161017,1720,1724,1724,1786,1720,1776,1760,52,36,1475788,"2,598,265.14",1133460
,20161018,1776,1760,1780,1786,1752,1770,1764,10,4,791806,"1,397,424.66",1108172
,20161019,1770,1764,1770,1790,1756,1770,1772,6,8,1181716,"2,095,420.98",1065426
,20161020,1770,1772,1774,1852,1774,1836,1820,64,48,2028104,"3,691,374.87",982006
,20161021,1836,1820,1830,1834,1804,1830,1818,10,-2,916266,"1,666,690.30",969666
,20161024,1830,1818,1832,1844,1818,1832,1830,14,12,763610,"1,398,114.00",952194
,20161025,1832,1830,1830,1856,1790,1802,1820,-28,-10,1460518,"2,660,048.57",964746
,20161026,1802,1820,1802,1812,1730,1760,1762,-60,-58,1722100,"3,037,099.68",962076
,20161027,1760,1762,1758,1790,1752,1772,1770,10,8,1041730,"1,844,909.80",882518
,20161028,1772,1770,1772,1824,1772,1820,1802,50,32,1210710,"2,183,589.36",812336
,20161031,1820,1802,1816,1826,1772,1812,1800,10,-2,1270006,"2,286,049.98",753820
,20161101,1812,1800,1808,1846,1770,1828,1808,28,8,1256372,"2,273,956.84",695362
,20161102,1828,1808,1828,1890,1808,1818,1848,10,40,1568530,"2,900,320.74",666614
,20161103,1818,1848,1816,1826,1794,1814,1808,-34,-40,820072,"1,483,780.96",663712
,20161104,1814,1808,1814,1834,1750,1756,1786,-52,-22,1170262,"2,090,204.69",670200
,20161107,1756,1786,1750,1802,1748,1772,1774,-14,-12,896268,"1,591,566.73",659784
,20161108,1772,1774,1774,1838,1770,1818,1804,44,30,1106554,"1,997,434.07",618792
,20161109,1818,1804,1816,1844,1800,1820,1822,16,18,1033388,"1,884,655.26",551112
,20161110,1820,1822,1828,1906,1824,1892,1870,70,48,1213816,"2,269,906.32",488280
,20161111,1892,1870,1890,1940,1854,1912,1896,42,26,898996,"1,705,928.34",415822
,20161114,1912,1896,1902,1950,1782,1782,1850,-114,-46,738250,"1,366,029.28",336762
,20161115,1782,1850,1794,1812,1752,1798,1786,-52,-64,304630,"544,427.04",310320
,20161116,1798,1786,1808,1854,1802,1848,1832,62,46,247374,"453,336.79",285840
,20161117,1848,1832,1836,1882,1812,1868,1848,36,16,186922,"345,627.24",250152
,20161118,1868,1848,1874,1892,1842,1872,1866,24,18,130330,"243,289.07",227842
,20161121,1872,1866,1878,1940,1858,1926,1900,60,34,149598,"284,361.45",188794
,20161122,1926,1900,1950,2014,1916,2004,1980,104,80,175236,"347,032.97",167180
,20161123,2004,1980,1980,2080,1954,2048,2028,68,48,166336,"337,370.22",142316
,20161124,2048,2028,2020,2056,1984,1990,2014,-38,-14,116222,"234,292.59",130982
,20161125,1990,2014,1990,2036,1938,1960,1982,-54,-32,95782,"189,932.22",122708
,20161128,1960,1982,1966,2024,1938,2008,1980,26,-2,89210,"176,790.85",102852
,20161129,2008,1980,2010,2042,1972,1988,2008,8,28,64082,"128,804.37",84956
,20161130,1988,2008,1984,1984,1880,1916,1936,-92,-72,75256,"145,746.63",63038
,20161201,1916,1936,1982,2054,1968,2034,2012,98,76,41672,"83,882.27",54144
,20161202,2034,2012,2048,2054,1990,2030,2026,18,14,21024,"42,604.45",47380
,20161205,2030,2026,2022,2114,2010,2112,2074,86,48,19954,"41,391.76",40790
,20161206,2112,2074,2118,2146,2090,2108,2112,34,38,10568,"22,335.74",36720
,20161207,2108,2112,2110,2164,2080,2140,2130,28,18,12964,"27,614.18",31532
,20161208,2140,2130,2118,2166,2080,2094,2114,-36,-16,7790,"16,477.32",27188
,20161209,2094,2114,2102,2198,2094,2176,2148,62,34,9424,"20,246.60",24152
,20161212,2176,2148,2188,2278,2166,2256,2238,108,90,7432,"16,639.54",21640
,20161213,2256,2238,2250,2394,2084,2236,2212,-2,-26,4872,"10,779.02",23284
,20161214,2236,2212,2220,2260,2200,2212,2224,0,12,710,"1,579.23",22916
,20161215,2212,2224,2208,2228,2150,2228,2210,4,-14,502,"1,110.25",22910
bu1701,20160718,2138,2138,2116,2212,2106,2146,2144,8,6,34,72.94,24
,20160719,2146,2144,2148,2154,2070,2088,2112,-56,-32,138,291.66,18
,20160720,2088,2112,2054,2150,2054,2102,2082,-10,-30,818,"1,704.09",218
,20160721,2102,2082,2152,2152,2078,2122,2132,40,50,98,209.13,250
,20160722,2122,2132,2098,2150,2076,2080,2118,-52,-14,52,110.17,254
,20160725,2080,2118,2114,2118,2044,2056,2076,-62,-42,72,149.56,272
,20160726,2056,2076,2058,2106,2000,2090,2068,14,-8,540,"1,117.23",448
,20160727,2090,2068,2066,2084,2032,2044,2052,-24,-16,906,"1,859.15",468
,20160728,2044,2052,2044,2060,2004,2032,2038,-20,-14,452,921.56,434
,20160729,2032,2038,2038,2060,1916,1930,2014,-108,-24,4866,"9,804.37",1300
,20160801,1930,2014,1956,2000,1934,1986,1966,-28,-48,1740,"3,423.58",1426
,20160802,1986,1966,1974,1982,1930,1974,1958,8,-8,1398,"2,737.80",1422
,20160803,1974,1958,1988,2006,1960,1966,1980,8,22,1066,"2,111.48",1480
,20160804,1966,1980,1966,1998,1954,1976,1974,-4,-6,866,"1,711.08",1478
,20160805,1976,1974,1980,1992,1968,1984,1986,10,12,822,"1,632.67",1470
,20160808,1984,1986,1980,2034,1962,2020,2002,34,16,1356,"2,716.51",1412
,20160809,2020,2002,2030,2040,1996,2020,2024,18,22,916,"1,854.82",1410
,20160810,2020,2024,2016,2036,2000,2012,2020,-12,-4,688,"1,390.29",1382
,20160811,2012,2020,2010,2032,1996,2002,2012,-18,-8,1020,"2,052.58",1444
,20160812,2002,2012,2012,2048,2008,2048,2028,36,16,1092,"2,215.71",1526
,20160815,2048,2028,2042,2068,2030,2052,2048,24,20,1148,"2,352.03",1500
,20160816,2052,2048,2066,2126,2042,2056,2056,8,8,1138,"2,340.54",1772
,20160817,2056,2056,2048,2072,2030,2048,2048,-8,-8,1094,"2,241.80",2036
,20160818,2048,2048,2052,2062,2030,2030,2044,-18,-4,1936,"3,958.42",2118
,20160819,2030,2044,2044,2060,2012,2016,2032,-28,-12,2450,"4,981.56",2166
,20160822,2016,2032,2016,2026,1924,1960,1960,-72,-72,9044,"17,734.70",2544
,20160823,1960,1960,1950,1958,1932,1938,1946,-22,-14,1708,"3,326.42",3170
,20160824,1938,1946,1940,1954,1934,1936,1942,-10,-4,1508,"2,931.40",3478
,20160825,1936,1942,1942,1946,1872,1900,1898,-42,-44,2592,"4,923.41",3510
,20160826,1900,1898,1896,1926,1890,1904,1906,6,8,1828,"3,486.00",3212
,20160829,1904,1906,1914,1936,1906,1914,1918,8,12,3304,"6,339.69",3896
,20160830,1914,1918,1914,1924,1896,1898,1908,-20,-10,1478,"2,820.69",3912
,20160831,1898,1908,1900,1912,1870,1896,1886,-12,-22,2228,"4,204.71",3860
,20160901,1896,1886,1884,1920,1882,1912,1902,26,16,2384,"4,538.56",4198
,20160902,1912,1902,1908,1924,1900,1904,1912,2,10,2220,"4,246.14",4256
,20160905,1904,1912,1910,1922,1888,1920,1912,8,0,2008,"3,841.82",4394
,20160906,1920,1912,1928,1946,1912,1942,1930,30,18,2944,"5,682.61",4684
,20160907,1942,1930,1936,1950,1906,1932,1930,2,0,4154,"8,025.27",5888
,20160908,1932,1930,1926,1948,1910,1930,1920,0,-10,2968,"5,703.36",5452
,20160909,1930,1920,1918,1938,1910,1924,1926,4,6,3032,"5,844.29",6468
,20160912,1924,1926,1990,1990,1862,1864,1904,-62,-22,8180,"15,576.87",5134
,20160913,1864,1904,1870,1886,1852,1868,1870,-36,-34,3080,"5,763.42",5210
,20160914,1868,1870,1866,1874,1848,1854,1860,-16,-10,2282,"4,244.77",5588
,20160919,1854,1860,1854,1884,1852,1880,1872,20,12,4086,"7,649.42",6234
,20160920,1880,1872,1866,1888,1860,1880,1878,8,6,3464,"6,507.63",6268
,20160921,1880,1878,1876,1896,1868,1872,1880,-6,2,3666,"6,893.26",5340
,20160922,1872,1880,1872,1896,1862,1864,1878,-16,-2,3226,"6,058.87",5646
,20160923,1864,1878,1864,1880,1846,1868,1862,-10,-16,3674,"6,846.36",6166
,20160926,1868,1862,1874,1878,1848,1860,1866,-2,4,3762,"7,026.86",6646
,20160927,1860,1866,1866,1872,1836,1844,1850,-22,-16,4218,"7,803.60",6664
,20160928,1844,1850,1840,1840,1738,1742,1766,-108,-84,10820,"19,127.20",7306
,20160929,1742,1766,1742,1780,1736,1752,1760,-14,-6,10982,"19,348.49",9564
,20160930,1752,1760,1760,1770,1746,1764,1756,4,-4,3630,"6,378.98",8392
,20161010,1764,1756,1774,1776,1746,1756,1758,0,2,4594,"8,083.71",9516
,20161011,1756,1758,1774,1808,1764,1788,1788,30,30,10440,"18,683.94",12722
,20161012,1788,1788,1786,1790,1756,1766,1770,-22,-18,6686,"11,841.20",10996
,20161013,1766,1770,1764,1770,1742,1762,1756,-8,-14,7562,"13,289.48",10388
,20161014,1762,1756,1766,1770,1714,1750,1746,-6,-10,11330,"19,790.02",12690
,20161017,1750,1746,1758,1804,1746,1798,1782,52,36,13758,"24,538.66",17464
,20161018,1798,1782,1780,1798,1778,1794,1788,12,6,17316,"30,989.90",19534
,20161019,1794,1788,1792,1814,1788,1810,1802,22,14,18768,"33,847.24",21308
,20161020,1810,1802,1824,1892,1808,1870,1864,68,62,37358,"69,639.94",24068
,20161021,1870,1864,1866,1872,1758,1872,1848,8,-16,15968,"29,531.94",22408
,20161024,1872,1848,1870,1882,1858,1872,1866,24,18,12544,"23,432.06",23422
,20161025,1872,1866,1874,1888,1836,1840,1858,-26,-8,26528,"49,317.30",31228
,20161026,1840,1858,1836,1856,1774,1806,1806,-52,-52,26628,"48,091.64",33480
,20161027,1806,1806,1802,1826,1798,1804,1808,-2,2,17662,"31,954.14",34234
,20161028,1804,1808,1808,1842,1804,1836,1830,28,22,20584,"37,672.68",39150
,20161031,1836,1830,1832,1842,1794,1828,1814,-2,-16,31470,"57,119.70",51100
,20161101,1828,1814,1824,1860,1798,1844,1830,30,16,39620,"72,530.75",50446
,20161102,1844,1830,1846,1934,1836,1838,1880,8,50,68890,"129,642.13",47784
,20161103,1838,1880,1840,1848,1816,1832,1828,-48,-52,31804,"58,161.12",48654
,20161104,1832,1828,1826,1848,1776,1780,1806,-48,-22,46826,"84,599.45",48976
,20161107,1780,1806,1784,1824,1732,1804,1798,-2,-8,42104,"75,758.99",47660
,20161108,1804,1798,1800,1854,1800,1842,1828,44,30,49940,"91,296.73",50616
,20161109,1842,1828,1840,1886,1830,1858,1864,30,36,78306,"146,027.24",59218
,20161110,1858,1864,1866,1974,1866,1960,1924,96,60,124382,"239,428.51",86554
,20161111,1960,1924,1956,1998,1914,1976,1960,52,36,137892,"270,455.99",101608
,20161114,1976,1960,1966,2010,1842,1842,1904,-118,-56,123404,"235,144.12",80620
,20161115,1842,1904,1838,1864,1810,1856,1840,-48,-64,56692,"104,410.06",71208
,20161116,1856,1840,1866,1908,1864,1906,1886,66,46,38810,"73,261.60",70622
,20161117,1906,1886,1892,1934,1866,1926,1900,40,14,42284,"80,344.92",66048
,20161118,1926,1900,1940,1954,1900,1926,1918,26,18,29024,"55,707.86",66404
,20161121,1926,1918,1932,1988,1910,1980,1948,62,30,34414,"67,064.85",63310
,20161122,1980,1948,1988,2064,1976,2052,2034,104,86,62664,"127,582.88",69558
,20161123,2052,2034,2042,2130,2006,2094,2076,60,42,64800,"134,612.35",68018
,20161124,2094,2076,2080,2100,2030,2046,2066,-30,-10,47948,"99,112.48",70100
,20161125,2046,2066,2046,2088,1986,2020,2032,-46,-34,55982,"113,857.22",63668
,20161128,2020,2032,2038,2076,1996,2060,2030,28,-2,45094,"91,566.35",63706
,20161129,2060,2030,2070,2088,2012,2030,2054,0,24,42938,"88,227.20",62236
,20161130,2030,2054,2018,2026,1932,1978,1974,-76,-80,47186,"93,192.98",52226
,20161201,1978,1974,2012,2106,2012,2072,2058,98,84,45544,"93,775.41",51956
,20161202,2072,2058,2078,2100,2030,2068,2066,10,8,33110,"68,443.21",50798
,20161205,2068,2066,2050,2160,2048,2146,2118,80,52,41350,"87,590.31",52606
,20161206,2146,2118,2150,2178,2126,2144,2148,26,30,30696,"65,965.97",48756
,20161207,2144,2148,2140,2206,2130,2174,2170,26,22,32036,"69,559.93",49716
,20161208,2174,2170,2170,2196,2116,2132,2146,-38,-24,29940,"64,289.91",42336
,20161209,2132,2146,2136,2228,2132,2186,2180,40,34,36490,"79,614.71",42574
,20161212,2186,2180,2190,2302,2182,2276,2252,96,72,33778,"76,086.62",40670
,20161213,2276,2252,2276,2292,2236,2274,2266,22,14,23536,"53,341.21",39702
,20161214,2274,2266,2282,2304,2238,2260,2266,-6,0,24706,"56,019.32",36244
,20161215,2260,2266,2258,2266,2204,2254,2232,-12,-34,25948,"57,967.15",32196
,20161216,2254,2232,2254,2290,2226,2232,2258,0,26,17412,"39,317.53",29630
,20161219,2232,2258,2238,2352,2236,2328,2308,70,50,31794,"73,401.72",26496
,20161220,2328,2308,2322,2392,2310,2370,2350,62,42,34392,"80,867.74",26082
,20161221,2370,2350,2386,2412,2358,2374,2386,24,36,22444,"53,577.04",23712
,20161222,2374,2386,2362,2376,2330,2330,2358,-56,-28,14016,"33,052.61",22336
,20161223,2330,2358,2332,2336,2274,2304,2308,-54,-50,16512,"38,130.06",19008
,20161226,2304,2308,2304,2312,2232,2252,2270,-56,-38,13514,"30,686.64",16806
,20161227,2252,2270,2248,2410,2238,2406,2294,136,24,12632,"28,995.28",14540
,20161228,2406,2294,2406,2454,2390,2454,2422,160,128,9726,"23,559.96",14262
,20161229,2454,2422,2468,2546,2430,2524,2488,102,66,12914,"32,142.54",14074
,20161230,2524,2488,2516,2520,2466,2500,2494,12,6,5792,"14,455.05",13398
bu1702,20160816,2048,2048,,,,2048,2048,0,0,0,0.00,0
,20160817,2048,2048,,,,2048,2048,0,0,0,0.00,0
,20160818,2048,2048,,,,2048,2048,0,0,0,0.00,0
,20160819,2048,2048,2014,2062,2014,2062,2046,14,-2,12,24.56,8
,20160822,2062,2046,1980,2014,1968,2014,1986,-32,-60,6,11.92,6
,20160823,2014,1986,1952,2014,1952,2008,1984,22,-2,8,15.88,6
,20160824,2008,1984,1978,2010,1930,1930,1974,-54,-10,10,19.76,2
,20160825,1930,1974,1922,1922,1922,1922,1922,-52,-52,2,3.84,2
,20160826,1922,1922,,,,1922,1922,0,0,0,0.00,2
,20160829,1922,1922,,,,1922,1922,0,0,0,0.00,2
,20160830,1922,1922,,,,1922,1922,0,0,0,0.00,2
,20160831,1922,1922,,,,1922,1922,0,0,0,0.00,2
,20160901,1922,1922,,,,1922,1922,0,0,0,0.00,2
,20160902,1922,1922,,,,1922,1922,0,0,0,0.00,2
,20160905,1922,1922,1926,2002,1926,1956,1960,34,38,6,11.77,2
,20160906,1956,1960,,,,1960,1960,0,0,0,0.00,2
,20160907,1960,1960,1946,1946,1946,1946,1946,-14,-14,2,3.89,2
,20160908,1946,1946,,,,1946,1946,0,0,0,0.00,2
,20160909,1946,1946,2018,2018,1988,1988,2008,42,62,6,12.05,8
,20160912,1988,2008,,,,1984,1984,-24,-24,0,0.00,8
,20160913,1984,1984,,,,1984,1984,0,0,0,0.00,8
,20160914,1984,1984,,,,1984,1984,0,0,0,0.00,8
,20160919,1984,1984,1944,1944,1944,1944,1944,-40,-40,2,3.89,10
,20160920,1944,1944,1956,1956,1956,1956,1956,12,12,2,3.91,12
,20160921,1956,1956,1954,1968,1900,1900,1946,-56,-10,18,35.03,22
,20160922,1900,1946,1938,1966,1902,1966,1942,20,-4,8,15.54,18
,20160923,1966,1942,1938,1938,1908,1908,1922,-34,-20,4,7.69,18
,20160926,1908,1922,1942,1942,1942,1942,1942,20,20,6,11.65,24
,20160927,1942,1942,1860,1930,1860,1866,1890,-76,-52,10,18.90,24
,20160928,1866,1890,1850,1850,1776,1782,1812,-108,-78,8,14.50,26
,20160929,1782,1812,1830,1830,1818,1820,1820,8,8,10,18.21,22
,20160930,1820,1820,1848,1848,1848,1848,1848,28,28,2,3.70,22
,20161010,1848,1848,,,,1848,1848,0,0,0,0.00,22
,20161011,1848,1848,1848,1848,1848,1848,1848,0,0,2,3.70,24
,20161012,1848,1848,,,,1848,1848,0,0,0,0.00,24
,20161013,1848,1848,,,,1848,1848,0,0,0,0.00,24
,20161014,1848,1848,1858,1860,1858,1860,1858,12,10,4,7.44,24
,20161017,1860,1858,,,,1858,1858,0,0,0,0.00,24
,20161018,1858,1858,1868,1868,1868,1868,1868,10,10,2,3.74,24
,20161019,1868,1868,1908,1908,1908,1908,1908,40,40,2,3.82,24
,20161020,1908,1908,1912,1980,1890,1980,1934,72,26,54,104.50,32
,20161021,1980,1934,,,,1934,1934,0,0,0,0.00,32
,20161024,1934,1934,1960,1960,1926,1926,1930,-8,-4,26,50.18,34
,20161025,1926,1930,1956,1956,1936,1936,1940,6,10,10,19.40,44
,20161026,1936,1940,1822,1880,1822,1870,1852,-70,-88,12,22.24,48
,20161027,1870,1852,1872,1874,1872,1874,1872,22,20,4,7.49,52
,20161028,1874,1872,1882,1896,1872,1896,1884,24,12,10,18.84,50
,20161031,1896,1884,1896,1896,1896,1896,1896,12,12,2,3.79,50
,20161101,1896,1896,1876,1936,1850,1910,1900,14,4,142,269.91,120
,20161102,1910,1900,1920,1996,1904,1918,1936,18,36,82,158.91,132
,20161103,1918,1936,1900,1900,1868,1868,1884,-68,-52,14,26.39,132
,20161104,1868,1884,1898,1914,1820,1820,1878,-64,-6,30,56.36,128
,20161107,1820,1878,1900,1900,1900,1900,1900,22,22,2,3.80,128
,20161108,1900,1900,1912,1912,1894,1910,1902,10,2,8,15.22,128
,20161109,1910,1902,1906,1954,1906,1916,1936,14,34,34,65.82,146
,20161110,1916,1936,1936,2024,1926,2024,1980,88,44,58,114.94,146
,20161111,2024,1980,2020,2064,1974,2030,2032,50,52,254,516.52,238
,20161114,2030,2032,2064,2076,1910,1910,1950,-122,-82,254,495.66,296
,20161115,1910,1950,1908,1932,1862,1918,1902,-32,-48,52,98.92,294
,20161116,1918,1902,1926,1972,1926,1970,1948,68,46,26,50.66,294
,20161117,1970,1948,1966,1984,1940,1984,1968,36,20,22,43.30,296
,20161118,1984,1968,1970,1996,1946,1984,1972,16,4,60,118.34,296
,20161121,1984,1972,1994,2034,1974,2028,2006,56,34,254,509.69,376
,20161122,2028,2006,2070,2120,2052,2096,2076,90,70,124,257.53,324
,20161123,2096,2076,2076,2168,2076,2140,2118,64,42,200,423.82,214
,20161124,2140,2118,2122,2138,2098,2104,2122,-14,4,80,169.83,246
,20161125,2104,2122,2124,2124,2018,2084,2082,-38,-40,20,41.67,250
,20161128,2084,2082,2062,2086,2002,2086,2046,4,-36,44,90.06,238
,20161129,2086,2046,2106,2108,2070,2070,2092,24,46,8,16.75,234
,20161130,2070,2092,2066,2066,2000,2026,2032,-66,-60,66,134.19,244
,20161201,2026,2032,2074,2162,2074,2138,2112,106,80,162,342.37,258
,20161202,2138,2112,2130,2144,2086,2118,2102,6,-10,50,105.17,238
,20161205,2118,2102,2112,2210,2112,2192,2156,90,54,90,194.09,198
,20161206,2192,2156,2226,2260,2178,2200,2200,44,44,130,286.18,154
,20161207,2200,2200,2192,2234,2192,2216,2208,16,8,50,110.46,142
,20161208,2216,2208,2220,2224,2154,2190,2190,-18,-18,94,206.03,124
,20161209,2190,2190,2190,2260,2190,2260,2208,70,18,34,75.10,118
,20161212,2260,2208,2232,2360,2232,2314,2276,106,68,48,109.32,112
,20161213,2314,2276,2278,2322,2274,2274,2292,-2,16,14,32.10,108
,20161214,2274,2292,2330,2330,2286,2286,2308,-6,16,70,161.62,78
,20161215,2286,2308,2290,2290,2234,2280,2270,-28,-38,44,99.88,70
,20161216,2280,2270,2262,2354,2262,2284,2310,14,40,30,69.32,64
,20161219,2284,2310,2290,2384,2290,2354,2348,44,38,16,37.59,62
,20161220,2354,2348,2414,2414,2366,2400,2380,52,32,14,33.34,62
,20161221,2400,2380,2470,2470,2370,2408,2430,28,50,40,97.23,68
,20161222,2408,2430,2398,2398,2360,2396,2376,-34,-54,38,90.35,76
,20161223,2396,2376,2326,2400,2326,2340,2362,-36,-14,52,122.90,70
,20161226,2340,2362,2334,2334,2288,2308,2294,-54,-68,22,50.48,68
,20161227,2308,2294,2292,2420,2292,2420,2386,126,92,18,42.95,70
,20161228,2420,2386,2522,2552,2488,2552,2546,166,160,150,381.93,162
,20161229,2552,2546,2560,2594,2502,2562,2556,16,10,344,879.52,408
,20161230,2562,2556,2544,2550,2500,2540,2544,-16,-12,32,81.42,412
bu1703,20160104,2066,2066,,,,2048,2048,-18,-18,0,0.00,6
,20160105,2048,2048,,,,2048,2048,0,0,0,0.00,6
,20160106,2048,2048,1926,1926,1926,1926,1926,-122,-122,2,3.85,6
,20160107,1926,1926,1970,1970,1934,1958,1954,32,28,6,11.72,6
,20160108,1958,1954,,,,1954,1954,0,0,0,0.00,6
,20160111,1954,1954,,,,1940,1940,-14,-14,0,0.00,6
,20160112,1940,1940,,,,1930,1930,-10,-10,0,0.00,6
,20160113,1930,1930,1960,1960,1960,1960,1960,30,30,2,3.92,6
,20160114,1960,1960,,,,1944,1944,-16,-16,0,0.00,6
,20160115,1944,1944,1958,1980,1950,1980,1962,36,18,6,11.78,6
,20160118,1980,1962,1922,1990,1922,1966,1944,4,-18,10,19.44,10
,20160119,1966,1944,,,,1944,1944,0,0,0,0.00,10
,20160120,1944,1944,2038,2038,1938,1958,1978,14,34,6,11.87,14
,20160121,1958,1978,,,,1978,1978,0,0,0,0.00,14
,20160122,1978,1978,,,,1978,1978,0,0,0,0.00,14
,20160125,1978,1978,1982,1982,1972,1972,1976,-6,-2,4,7.91,12
,20160126,1972,1976,,,,1976,1976,0,0,0,0.00,12
,20160127,1976,1976,,,,1976,1976,0,0,0,0.00,12
,20160128,1976,1976,1968,1968,1968,1968,1968,-8,-8,2,3.94,12
,20160129,1968,1968,,,,1968,1968,0,0,0,0.00,12
,20160201,1968,1968,,,,1930,1930,-38,-38,0,0.00,12
,20160202,1930,1930,,,,1924,1924,-6,-6,0,0.00,12
,20160203,1924,1924,,,,1924,1924,0,0,0,0.00,12
,20160204,1924,1924,,,,1924,1924,0,0,0,0.00,12
,20160205,1924,1924,,,,1924,1924,0,0,0,0.00,12
,20160215,1924,1924,1924,1924,1924,1924,1924,0,0,4,7.70,12
,20160216,1924,1924,1918,1918,1918,1918,1918,-6,-6,2,3.84,14
,20160217,1918,1918,1956,1956,1956,1956,1956,38,38,2,3.91,12
,20160218,1956,1956,,,,1956,1956,0,0,0,0.00,12
,20160219,1956,1956,,,,1956,1956,0,0,0,0.00,12
,20160222,1956,1956,,,,1956,1956,0,0,0,0.00,12
,20160223,1956,1956,,,,1956,1956,0,0,0,0.00,12
,20160224,1956,1956,1902,1902,1902,1902,1902,-54,-54,4,7.61,10
,20160225,1902,1902,,,,1902,1902,0,0,0,0.00,10
,20160226,1902,1902,1934,1952,1934,1952,1940,50,38,6,11.65,12
,20160229,1952,1940,,,,1940,1940,0,0,0,0.00,12
,20160301,1940,1940,1978,1996,1922,1996,1964,56,24,50,98.20,16
,20160302,1996,1964,1992,2032,1992,2022,2014,58,50,6,12.09,16
,20160303,2022,2014,1994,1994,1994,1994,1994,-20,-20,2,3.99,16
,20160304,1994,1994,,,,1994,1994,0,0,0,0.00,16
,20160307,1994,1994,2048,2112,2030,2112,2074,118,80,20,41.51,16
,20160308,2112,2074,2206,2220,2024,2074,2140,0,66,18,38.52,18
,20160309,2074,2140,2078,2078,2078,2078,2078,-62,-62,2,4.16,20
,20160310,2078,2078,,,,2100,2100,22,22,0,0.00,20
,20160311,2100,2100,2002,2094,2002,2094,2048,-6,-52,4,8.19,20
,20160314,2094,2048,,,,2078,2078,30,30,0,0.00,20
,20160315,2078,2078,1970,2092,1970,2092,2032,14,-46,10,20.32,20
,20160316,2092,2032,,,,2032,2032,0,0,0,0.00,20
,20160317,2032,2032,,,,2078,2078,46,46,0,0.00,20
,20160318,2078,2078,,,,2138,2138,60,60,0,0.00,20
,20160321,2138,2138,,,,2156,2156,18,18,0,0.00,20
,20160322,2156,2156,2172,2172,2172,2172,2172,16,16,2,4.34,18
,20160323,2172,2172,,,,2182,2182,10,10,0,0.00,18
,20160324,2182,2182,,,,2100,2100,-82,-82,0,0.00,18
,20160325,2100,2100,2136,2136,2136,2136,2136,36,36,6,12.82,22
,20160328,2136,2136,,,,2136,2136,0,0,0,0.00,22
,20160329,2136,2136,2050,2136,2042,2136,2090,0,-46,8,16.73,22
,20160330,2136,2090,2098,2098,2098,2098,2098,8,8,2,4.20,22
,20160331,2098,2098,,,,2098,2098,0,0,0,0.00,22
,20160401,2098,2098,2122,2150,2094,2144,2120,46,22,46,97.55,30
,20160405,2144,2120,2030,2032,2022,2032,2026,-88,-94,8,16.22,28
,20160406,2032,2026,2032,2060,2004,2012,2030,-14,4,22,44.69,40
,20160407,2012,2030,2010,2048,1998,2016,2018,-14,-12,14,28.25,36
,20160408,2016,2018,1986,1986,1986,1986,1986,-32,-32,2,3.97,36
,20160411,1986,1986,2078,2104,2074,2104,2090,118,104,44,92.00,36
,20160412,2104,2090,2134,2134,2134,2134,2134,44,44,4,8.54,38
,20160413,2134,2134,2146,2188,2124,2188,2158,54,24,38,82.06,38
,20160414,2188,2158,2206,2208,2184,2184,2190,26,32,12,26.30,44
,20160415,2184,2190,2180,2180,2172,2172,2176,-18,-14,6,13.06,42
,20160418,2172,2176,2132,2180,2122,2180,2148,4,-28,14,30.08,38
,20160419,2180,2148,2256,2256,2208,2208,2212,60,64,18,39.84,40
,20160420,2208,2212,2230,2322,2230,2254,2254,42,42,10,22.54,42
,20160421,2254,2254,2304,2304,2298,2298,2298,44,44,10,23.00,46
,20160422,2298,2298,,,,2298,2298,0,0,0,0.00,46
,20160425,2298,2298,2332,2420,2286,2356,2366,58,68,22,52.09,54
,20160426,2356,2366,2288,2292,2226,2226,2258,-140,-108,12,27.10,58
,20160427,2226,2258,2294,2302,2240,2240,2270,-18,12,20,45.44,56
,20160428,2240,2270,2230,2230,2204,2204,2216,-66,-54,4,8.87,58
,20160429,2204,2216,2236,2278,2236,2276,2262,60,46,16,36.22,56
,20160503,2276,2262,2140,2180,2140,2180,2160,-82,-102,4,8.64,56
,20160504,2180,2160,2176,2210,2142,2162,2174,2,14,26,56.53,66
,20160505,2162,2174,,,,2172,2172,-2,-2,0,0.00,66
,20160506,2172,2172,2144,2144,2114,2124,2126,-48,-46,12,25.52,70
,20160509,2124,2126,2006,2034,2006,2028,2022,-98,-104,6,12.14,68
,20160510,2028,2022,,,,2032,2032,10,10,0,0.00,68
,20160511,2032,2032,,,,2080,2080,48,48,0,0.00,68
,20160512,2080,2080,,,,2100,2100,20,20,0,0.00,68
,20160513,2100,2100,,,,2100,2100,0,0,0,0.00,68
,20160516,2100,2100,,,,2100,2100,0,0,0,0.00,68
,20160517,2100,2100,,,,2158,2158,58,58,0,0.00,68
,20160518,2158,2158,2172,2236,2160,2160,2186,2,28,12,26.23,72
,20160519,2160,2186,2174,2174,2132,2132,2146,-54,-40,12,25.76,68
,20160520,2132,2146,,,,2146,2146,0,0,0,0.00,68
,20160523,2146,2146,2086,2086,2016,2016,2040,-130,-106,20,40.83,70
,20160524,2016,2040,1986,2046,1974,2008,1990,-32,-50,22,43.78,66
,20160525,2008,1990,,,,2020,2020,30,30,0,0.00,66
,20160526,2020,2020,,,,2020,2020,0,0,0,0.00,66
,20160527,2020,2020,2022,2048,2022,2048,2034,28,14,4,8.14,64
,20160530,2048,2034,2000,2000,2000,2000,2000,-34,-34,2,4.00,66
,20160531,2000,2000,2068,2068,1996,2032,2038,32,38,16,32.63,66
,20160601,2032,2038,2002,2036,2002,2036,2018,-2,-20,4,8.08,62
,20160602,2036,2018,2024,2024,2024,2024,2024,6,6,2,4.05,60
,20160603,2024,2024,,,,2026,2026,2,2,0,0.00,60
,20160606,2026,2026,2038,2118,2038,2078,2100,52,74,14,29.41,62
,20160607,2078,2100,2122,2122,2092,2092,2106,-8,6,8,16.85,68
,20160608,2092,2106,,,,2108,2108,2,2,0,0.00,68
,20160613,2108,2108,2082,2130,2082,2112,2114,4,6,28,59.20,58
,20160614,2112,2114,2128,2190,2128,2150,2168,36,54,60,130.12,100
,20160615,2150,2168,2166,2208,2138,2140,2174,-28,6,86,187.06,134
,20160616,2140,2174,2142,2142,2108,2110,2128,-64,-46,96,204.33,82
,20160617,2110,2128,2110,2110,2080,2094,2094,-34,-34,20,41.90,78
,20160620,2094,2094,2120,2148,2110,2138,2128,44,34,46,97.94,78
,20160621,2138,2128,2138,2174,2138,2158,2152,30,24,54,116.29,80
,20160622,2158,2152,,,,2180,2180,28,28,0,0.00,80
,20160623,2180,2180,2168,2218,2168,2204,2192,24,12,30,65.77,80
,20160624,2204,2192,2204,2210,2138,2168,2192,-24,0,74,162.24,108
,20160627,2168,2192,2188,2200,2170,2200,2184,8,-8,10,21.85,108
,20160628,2200,2184,2204,2210,2180,2210,2198,26,14,40,87.98,118
,20160629,2210,2198,2264,2292,2196,2242,2240,44,42,54,121.02,132
,20160630,2242,2240,2254,2288,2252,2286,2260,46,20,30,67.83,116
,20160701,2286,2260,2288,2346,2256,2292,2306,32,46,118,272.14,182
,20160704,2292,2306,2310,2390,2300,2354,2344,48,38,84,196.93,178
,20160705,2354,2344,2382,2396,2268,2278,2340,-66,-4,52,121.68,178
,20160706,2278,2340,2290,2296,2198,2216,2238,-124,-102,94,210.48,188
,20160707,2216,2238,2214,2258,2182,2210,2226,-28,-12,130,289.54,256
,20160708,2210,2226,2198,2208,2152,2174,2176,-52,-50,190,413.73,220
,20160711,2174,2176,2170,2196,2160,2194,2168,18,-8,62,134.52,222
,20160712,2194,2168,2212,2240,2192,2240,2216,72,48,10,22.17,222
,20160713,2240,2216,2244,2262,2212,2228,2242,12,26,94,210.88,240
,20160714,2228,2242,2246,2292,2224,2280,2270,38,28,90,204.32,196
,20160715,2280,2270,2264,2264,2246,2246,2254,-24,-16,6,13.53,200
,20160718,2246,2254,2262,2262,2188,2188,2214,-66,-40,42,93.00,184
,20160719,2188,2214,2186,2212,2162,2166,2182,-48,-32,34,74.25,194
,20160720,2166,2182,2190,2200,2186,2194,2192,12,10,34,74.58,196
,20160721,2194,2192,2196,2228,2196,2222,2216,30,24,18,39.91,202
,20160722,2222,2216,2220,2220,2178,2178,2206,-38,-10,34,75.04,204
,20160725,2178,2206,2164,2184,2138,2184,2170,-22,-36,18,39.07,212
,20160726,2184,2170,2170,2184,2132,2132,2160,-38,-10,198,427.87,380
,20160727,2132,2160,2108,2168,2108,2122,2132,-38,-28,32,68.27,372
,20160728,2122,2132,2122,2122,2098,2112,2108,-20,-24,10,21.09,364
,20160729,2112,2108,2126,2128,2024,2024,2070,-84,-38,178,368.62,336
,20160801,2024,2070,2046,2072,2028,2072,2052,2,-18,50,102.62,314
,20160802,2072,2052,2052,2076,2036,2076,2062,24,10,18,37.14,322
,20160803,2076,2062,2082,2090,2060,2060,2074,-2,12,38,78.82,316
,20160804,2060,2074,2068,2068,2058,2058,2062,-16,-12,4,8.25,314
,20160805,2058,2062,2066,2086,2066,2066,2070,4,8,32,66.25,298
,20160808,2066,2070,2052,2108,2052,2102,2084,32,14,20,41.69,288
,20160809,2102,2084,2114,2122,2074,2096,2102,12,18,26,54.69,274
,20160810,2096,2102,2120,2120,2118,2118,2118,16,16,18,38.14,268
,20160811,2118,2118,2132,2132,2114,2114,2122,-4,4,4,8.49,270
,20160812,2114,2122,2082,2136,2082,2120,2116,-2,-6,16,33.87,264
,20160815,2120,2116,2140,2140,2140,2140,2140,24,24,2,4.28,264
,20160816,2140,2140,2148,2160,2140,2146,2148,6,8,12,25.79,264
,20160817,2146,2148,2152,2152,2138,2140,2146,-8,-2,18,38.63,258
,20160818,2140,2146,2130,2142,2116,2120,2132,-26,-14,68,145.08,244
,20160819,2120,2132,2130,2144,2112,2112,2130,-20,-2,28,59.66,238
,20160822,2112,2130,2108,2118,2056,2056,2094,-74,-36,22,46.08,246
,20160823,2056,2094,2060,2066,2038,2040,2050,-54,-44,76,155.90,272
,20160824,2040,2050,2036,2058,2036,2056,2048,6,-2,14,28.69,270
,20160825,2056,2048,2032,2032,1984,1996,2004,-52,-44,32,64.18,274
,20160826,1996,2004,2010,2010,2010,2010,2010,6,6,6,12.06,268
,20160829,2010,2010,2010,2010,2010,2010,2010,0,0,6,12.06,266
,20160830,2010,2010,1998,2004,1980,1982,1992,-28,-18,44,87.67,290
,20160831,1982,1992,1984,1984,1944,1944,1962,-48,-30,36,70.68,304
,20160901,1944,1962,1972,1990,1970,1990,1978,28,16,28,55.40,292
,20160902,1990,1978,1986,1988,1986,1988,1986,10,8,4,7.95,290
,20160905,1988,1986,1978,2008,1978,2008,1994,22,8,40,79.78,286
,20160906,2008,1994,2006,2048,2004,2048,2016,54,22,34,68.58,286
,20160907,2048,2016,2034,2038,2030,2032,2034,16,18,10,20.34,288
,20160908,2032,2034,2020,2038,2020,2030,2030,-4,-4,46,93.44,288
,20160909,2030,2030,2034,2034,2024,2026,2028,-4,-2,6,12.17,288
,20160912,2026,2028,2024,2024,1962,1978,1996,-50,-32,54,107.80,282
,20160913,1978,1996,1974,1974,1962,1970,1964,-26,-32,14,27.51,276
,20160914,1970,1964,1886,1972,1886,1968,1956,4,-8,42,82.21,284
,20160919,1968,1956,1980,1980,1980,1980,1980,24,24,4,7.92,286
,20160920,1980,1980,1986,1986,1982,1982,1984,2,4,6,11.91,282
,20160921,1982,1984,1998,2062,1972,1972,2010,-12,26,92,184.96,288
,20160922,1972,2010,1986,2012,1952,1970,1986,-40,-24,96,190.83,292
,20160923,1970,1986,1974,1992,1950,1976,1970,-10,-16,88,173.45,312
,20160926,1976,1970,1974,1980,1966,1978,1978,8,8,34,67.26,310
,20160927,1978,1978,1962,1962,1950,1954,1952,-24,-26,30,58.59,316
,20160928,1954,1952,1922,1924,1844,1866,1870,-86,-82,146,273.03,368
,20160929,1866,1870,1870,1876,1828,1852,1850,-18,-20,100,185.13,360
,20160930,1852,1850,1874,1874,1860,1860,1868,10,18,112,209.24,346
,20161010,1860,1868,1866,1876,1866,1866,1866,-2,-2,30,56.04,340
,20161011,1866,1866,1884,1922,1880,1888,1902,22,36,194,369.22,376
,20161012,1888,1902,1884,1886,1872,1872,1880,-30,-22,26,48.92,394
,20161013,1872,1880,1870,1888,1864,1874,1872,-6,-8,100,187.21,416
,20161014,1874,1872,1880,1886,1854,1872,1868,0,-4,62,115.86,422
,20161017,1872,1868,1852,1922,1852,1910,1902,42,34,112,213.08,444
,20161018,1910,1902,1930,1934,1896,1902,1908,0,6,108,206.18,484
,20161019,1902,1908,1924,1932,1910,1932,1924,24,16,152,292.50,458
,20161020,1932,1924,1952,2002,1940,1980,1978,56,54,196,388.00,438
,20161021,1980,1978,1972,1984,1954,1970,1970,-8,-8,70,137.96,464
,20161024,1970,1970,1976,1998,1972,1982,1988,12,18,182,362.13,552
,20161025,1982,1988,1992,1992,1956,1956,1970,-32,-18,220,433.41,616
,20161026,1956,1970,1956,1968,1900,1920,1930,-50,-40,156,301.20,682
,20161027,1920,1930,1934,1934,1914,1918,1922,-12,-8,56,107.73,712
,20161028,1918,1922,1930,1950,1924,1944,1940,22,18,102,198.01,718
,20161031,1944,1940,1942,1942,1910,1938,1924,-2,-16,148,284.89,776
,20161101,1938,1924,1936,1962,1902,1958,1926,34,2,210,404.81,796
,20161102,1958,1926,1956,2038,1952,1960,1998,34,72,284,567.53,742
,20161103,1960,1998,1950,1962,1910,1932,1944,-66,-54,90,175.03,744
,20161104,1932,1944,1956,1964,1886,1906,1916,-38,-28,144,276.11,806
,20161107,1906,1916,1910,1936,1896,1930,1918,14,2,210,402.78,828
,20161108,1930,1918,1914,1952,1914,1944,1934,26,16,326,630.61,792
,20161109,1944,1934,1952,1988,1946,1974,1968,40,34,180,354.24,786
,20161110,1974,1968,1996,2080,1984,2080,2032,112,64,428,870.52,840
,20161111,2080,2032,2034,2116,2030,2096,2074,64,42,626,"1,299.37",996
,20161114,2096,2074,2084,2124,1948,1966,2012,-108,-62,746,"1,501.92",986
,20161115,1966,2012,1936,1982,1932,1972,1960,-40,-52,278,545.28,996
,20161116,1972,1960,2004,2018,1986,2016,2004,56,44,162,324.72,960
,20161117,2016,2004,1992,2040,1990,2034,2016,30,12,72,145.22,936
,20161118,2034,2016,2054,2054,2006,2036,2020,20,4,138,278.82,836
,20161121,2036,2020,2038,2098,2008,2084,2052,64,32,170,349.00,740
,20161122,2084,2052,2098,2174,2098,2172,2152,120,100,294,633.18,798
,20161123,2172,2152,2232,2236,2140,2200,2186,48,34,260,568.54,812
,20161124,2200,2186,2170,2202,2130,2170,2172,-16,-14,334,725.96,862
,20161125,2170,2172,2188,2198,2108,2118,2124,-54,-48,210,446.27,812
,20161128,2118,2124,2126,2178,2110,2178,2150,54,26,62,133.36,810
,20161129,2178,2150,2188,2208,2134,2156,2162,6,12,300,649.15,900
,20161130,2156,2162,2130,2148,2060,2086,2088,-76,-74,324,676.75,992
,20161201,2086,2088,2154,2210,2130,2188,2172,100,84,184,399.93,982
,20161202,2188,2172,2196,2216,2154,2166,2174,-6,2,268,582.68,1050
,20161205,2166,2174,2178,2274,2162,2258,2240,84,66,426,954.65,1022
,20161206,2258,2240,2270,2300,2250,2270,2270,30,30,296,671.92,986
,20161207,2270,2270,2262,2320,2254,2288,2280,18,10,230,524.84,978
,20161208,2288,2280,2296,2296,2230,2244,2254,-36,-26,128,288.75,986
,20161209,2244,2254,2260,2326,2260,2310,2292,56,38,74,169.63,982
,20161212,2310,2292,2296,2412,2294,2396,2368,104,76,430,"1,018.67",890
,20161213,2396,2368,2390,2398,2348,2390,2374,22,6,102,242.33,864
,20161214,2390,2374,2414,2416,2352,2372,2374,-2,0,158,375.25,870
,20161215,2372,2374,2352,2374,2314,2362,2340,-12,-34,170,398.00,842
,20161216,2362,2340,2344,2380,2344,2354,2358,14,18,32,75.51,840
,20161219,2354,2358,2360,2460,2354,2418,2416,60,58,254,613.72,832
,20161220,2418,2416,2420,2478,2384,2452,2434,36,18,330,803.30,810
,20161221,2452,2434,2462,2480,2450,2452,2462,18,28,148,364.62,800
,20161222,2452,2462,2420,2448,2416,2432,2434,-30,-28,180,438.28,764
,20161223,2432,2434,2398,2430,2392,2408,2408,-26,-26,212,510.76,770
,20161226,2408,2408,2388,2474,2332,2370,2376,-38,-32,188,446.83,770
,20161227,2370,2376,2366,2504,2366,2494,2468,118,92,296,730.98,988
,20161228,2494,2468,2528,2616,2514,2616,2598,148,130,750,"1,949.87",1286
,20161229,2616,2598,2624,2628,2530,2608,2570,10,-28,898,"2,309.46",1144
,20161230,2608,2570,2612,2632,2560,2600,2584,30,14,1020,"2,636.80",962
bu1704,20161018,1902,1902,,,,1902,1902,0,0,0,0.00,0
,20161019,1902,1902,,,,1902,1902,0,0,0,0.00,0
,20161020,1902,1902,,,,1944,1944,42,42,0,0.00,0
,20161021,1944,1944,,,,1944,1944,0,0,0,0.00,0
,20161024,1944,1944,,,,1976,1976,32,32,0,0.00,0
,20161025,1976,1976,,,,1976,1976,0,0,0,0.00,0
,20161026,1976,1976,,,,1976,1976,0,0,0,0.00,0
,20161027,1976,1976,1994,1994,1930,1930,1962,-46,-14,4,7.85,2
,20161028,1930,1962,2002,2002,2002,2002,2002,40,40,2,4.00,2
,20161031,2002,2002,,,,2002,2002,0,0,0,0.00,2
,20161101,2002,2002,,,,2002,2002,0,0,0,0.00,2
,20161102,2002,2002,,,,2002,2002,0,0,0,0.00,2
,20161103,2002,2002,,,,2002,2002,0,0,0,0.00,2
,20161104,2002,2002,,,,1974,1974,-28,-28,0,0.00,2
,20161107,1974,1974,,,,1974,1974,0,0,0,0.00,2
,20161108,1974,1974,,,,1974,1974,0,0,0,0.00,2
,20161109,1974,1974,,,,2008,2008,34,34,0,0.00,2
,20161110,2008,2008,,,,2074,2074,66,66,0,0.00,2
,20161111,2074,2074,2198,2198,2160,2160,2178,86,104,24,52.30,6
,20161114,2160,2178,2082,2082,2060,2060,2070,-118,-108,68,140.81,64
,20161115,2060,2070,2018,2096,2018,2028,2046,-42,-24,6,12.28,66
,20161116,2028,2046,2136,2136,2136,2136,2136,90,90,2,4.27,68
,20161117,2136,2136,2070,2144,2070,2114,2112,-22,-24,8,16.90,70
,20161118,2114,2112,,,,2112,2112,0,0,0,0.00,70
,20161121,2112,2112,2166,2170,2072,2170,2142,58,30,8,17.14,68
,20161122,2170,2142,2268,2268,2212,2212,2224,70,82,66,146.80,14
,20161123,2212,2224,2164,2320,2164,2298,2264,74,40,10,22.64,12
,20161124,2298,2264,,,,2264,2264,0,0,0,0.00,12
,20161125,2264,2264,2244,2274,2160,2212,2222,-52,-42,22,48.89,14
,20161128,2212,2222,2272,2272,2260,2260,2268,38,46,8,18.15,10
,20161129,2260,2268,2270,2272,2222,2222,2248,-46,-20,12,26.98,18
,20161130,2222,2248,2194,2194,2116,2140,2152,-108,-96,12,25.84,22
,20161201,2140,2152,2220,2244,2216,2244,2222,92,70,10,22.23,16
,20161202,2244,2222,2262,2266,2216,2252,2252,30,30,12,27.04,22
,20161205,2252,2252,2262,2348,2262,2348,2316,96,64,16,37.08,20
,20161206,2348,2316,2332,2332,2308,2308,2312,-8,-4,10,23.13,20
,20161207,2308,2312,2340,2354,2340,2354,2348,42,36,6,14.10,18
,20161208,2354,2348,2364,2364,2348,2348,2356,0,8,4,9.42,18
,20161209,2348,2356,2254,2334,2254,2286,2300,-70,-56,8,18.41,18
,20161212,2286,2300,2352,2460,2352,2446,2400,146,100,38,91.22,18
,20161213,2446,2400,2446,2464,2430,2430,2450,30,50,8,19.61,16
,20161214,2430,2450,2456,2480,2424,2432,2438,-18,-12,20,48.79,24
,20161215,2432,2438,2340,2428,2340,2396,2376,-42,-62,22,52.28,24
,20161216,2396,2376,2432,2432,2400,2410,2414,34,38,6,14.48,24
,20161219,2410,2414,2430,2540,2396,2514,2486,100,72,16,39.80,34
,20161220,2514,2486,2486,2568,2486,2568,2514,82,28,6,15.09,38
,20161221,2568,2514,2500,2500,2490,2500,2496,-14,-18,8,19.98,32
,20161222,2500,2496,2472,2488,2468,2468,2476,-28,-20,6,14.86,34
,20161223,2468,2476,2414,2502,2414,2460,2466,-16,-10,24,59.22,36
,20161226,2460,2466,2384,2422,2320,2422,2382,-44,-84,8,19.06,34
,20161227,2422,2382,2382,2548,2382,2546,2458,164,76,56,137.71,36
,20161228,2546,2458,2578,2630,2578,2630,2618,172,160,24,62.83,36
,20161229,2630,2618,2866,2866,2626,2680,2678,62,60,222,594.72,196
,20161230,2680,2678,2618,2618,2604,2604,2610,-74,-68,4,10.44,196
bu1705,20161116,2046,2046,2120,2164,2044,2138,2120,92,74,70,148.43,20
,20161117,2138,2120,2148,2170,2070,2154,2130,34,10,174,370.82,46
,20161118,2154,2130,2178,2180,2106,2110,2134,-20,4,54,115.26,42
,20161121,2110,2134,2138,2210,2088,2190,2150,56,16,234,503.52,56
,20161122,2190,2150,2228,2278,2198,2274,2266,124,116,842,"1,909.12",136
,20161123,2274,2266,2232,2362,2224,2296,2296,30,30,682,"1,566.64",236
,20161124,2296,2296,2318,2342,2264,2266,2300,-30,4,462,"1,063.25",304
,20161125,2266,2300,2254,2318,2218,2234,2262,-66,-38,534,"1,207.96",354
,20161128,2234,2262,2248,2312,2222,2298,2256,36,-6,978,"2,207.24",442
,20161129,2298,2256,2310,2330,2232,2254,2294,-2,38,2838,"6,511.92",740
,20161130,2254,2294,2230,2266,2140,2190,2200,-104,-94,1508,"3,318.43",638
,20161201,2190,2200,2282,2340,2230,2286,2288,86,88,2070,"4,739.24",804
,20161202,2286,2288,2314,2360,2252,2314,2318,26,30,2860,"6,630.37",1928
,20161205,2314,2318,2318,2436,2286,2378,2350,60,32,5206,"12,238.69",1972
,20161206,2378,2350,2404,2414,2354,2384,2378,34,28,2624,"6,245.05",2004
,20161207,2384,2378,2384,2438,2352,2398,2388,20,10,4460,"10,656.78",1506
,20161208,2398,2388,2398,2426,2336,2358,2378,-30,-10,1522,"3,621.93",1554
,20161209,2358,2378,2378,2462,2350,2422,2410,44,32,2808,"6,769.14",1624
,20161212,2422,2410,2444,2532,2410,2496,2488,86,78,4452,"11,076.72",1448
,20161213,2496,2488,2518,2518,2452,2488,2484,0,-4,1264,"3,141.46",1450
,20161214,2488,2484,2526,2530,2446,2472,2484,-12,0,1828,"4,542.60",1326
,20161215,2472,2484,2480,2480,2420,2470,2452,-14,-32,1488,"3,649.38",1146
,20161216,2470,2452,2462,2514,2422,2446,2472,-6,20,2634,"6,515.98",1056
,20161219,2446,2472,2442,2570,2442,2532,2518,60,46,2484,"6,254.82",988
,20161220,2532,2518,2530,2594,2504,2568,2550,50,32,4308,"10,993.33",1184
,20161221,2568,2550,2578,2604,2544,2560,2574,10,24,3330,"8,571.98",1796
,20161222,2560,2574,2558,2562,2510,2532,2536,-42,-38,11492,"29,161.84",7210
,20161223,2532,2536,2528,2554,2456,2498,2502,-38,-34,8576,"21,460.47",7538
,20161226,2498,2502,2490,2510,2412,2448,2458,-54,-44,6358,"15,635.51",8510
,20161227,2448,2458,2452,2630,2430,2630,2518,172,60,7006,"17,641.25",9086
,20161228,2630,2518,2650,2694,2622,2694,2666,176,148,8124,"21,660.48",8490
,20161229,2694,2666,2694,2900,2652,2720,2696,54,30,13564,"36,588.77",8570
,20161230,2720,2696,2722,2732,2660,2700,2692,4,-4,10204,"27,482.62",8390
bu1706,20160104,2162,2156,2124,2130,2090,2092,2106,-64,-50,56,118.00,86
,20160105,2092,2106,2088,2096,1984,1984,2072,-122,-34,30,62.21,92
,20160106,1984,2072,2076,2080,2062,2080,2074,8,2,24,49.79,92
,20160107,2080,2074,2022,2050,2022,2026,2036,-48,-38,34,69.24,86
,20160108,2026,2036,2046,2070,2046,2070,2062,34,26,16,33.02,88
,20160111,2070,2062,2074,2074,2032,2032,2048,-30,-14,82,168.01,68
,20160112,2032,2048,2046,2050,1980,1980,2020,-68,-28,38,76.83,76
,20160113,1980,2020,2002,2002,1972,1972,1980,-48,-40,10,19.80,78
,20160114,1972,1980,1986,2026,1976,1990,2006,10,26,294,589.99,88
,20160115,1990,2006,2010,2010,1914,2010,1998,4,-8,52,103.95,92
,20160118,2010,1998,2000,2004,1996,1996,1998,-2,0,12,23.99,92
,20160119,1996,1998,1982,2022,1982,2022,2008,24,10,20,40.18,84
,20160120,2022,2008,2034,2034,2008,2008,2022,0,14,12,24.27,96
,20160121,2008,2022,2010,2010,1982,1986,1998,-36,-24,50,99.97,96
,20160122,1986,1998,1994,2040,1994,2030,2028,32,30,20,40.56,92
,20160125,2030,2028,2022,2056,2020,2020,2032,-8,4,22,44.74,84
,20160126,2020,2032,2026,2044,2026,2034,2036,2,4,46,93.73,126
,20160127,2034,2036,2046,2080,2046,2062,2058,26,22,108,222.44,136
,20160128,2062,2058,2074,2074,2060,2060,2066,2,8,4,8.27,134
,20160129,2060,2066,2056,2056,2002,2018,2022,-48,-44,46,93.04,148
,20160201,2018,2022,2014,2014,1996,1996,2004,-26,-18,10,20.05,152
,20160202,1996,2004,1998,1998,1952,1952,1982,-52,-22,16,31.72,158
,20160203,1952,1982,1972,1976,1960,1964,1966,-18,-16,10,19.67,158
,20160204,1964,1966,1982,1982,1982,1982,1982,16,16,4,7.93,158
,20160205,1982,1982,1968,1968,1968,1968,1968,-14,-14,2,3.94,156
,20160215,1968,1968,1950,1956,1950,1956,1950,-12,-18,54,105.35,208
,20160216,1956,1950,1954,2010,1952,1998,1994,48,44,138,275.25,320
,20160217,1998,1994,1990,1994,1964,1968,1984,-26,-10,54,107.15,306
,20160218,1968,1984,1992,2008,1992,2006,2002,22,18,64,128.16,282
,20160219,2006,2002,2024,2024,1982,2006,1998,4,-4,224,447.98,186
,20160222,2006,1998,2000,2032,2000,2028,2014,30,16,58,116.88,162
,20160223,2028,2014,2032,2036,2014,2020,2026,6,12,44,89.16,166
,20160224,2020,2026,2014,2016,1978,1984,2000,-42,-26,42,84.06,174
,20160225,1984,2000,1972,2002,1972,1988,1984,-12,-16,46,91.31,154
,20160226,1988,1984,2010,2048,2010,2048,2020,64,36,34,68.74,150
,20160229,2048,2020,2052,2060,2038,2042,2048,22,28,32,65.57,144
,20160301,2042,2048,2026,2082,2020,2070,2046,22,-2,54,110.52,146
,20160302,2070,2046,2086,2128,2072,2120,2098,74,52,50,104.99,134
,20160303,2120,2098,2104,2212,2104,2132,2150,34,52,1010,"2,172.24",206
,20160304,2132,2150,2120,2148,2118,2136,2128,-14,-22,168,357.60,220
,20160307,2136,2128,2150,2254,2132,2242,2220,114,92,332,737.37,330
,20160308,2242,2220,2250,2296,2110,2174,2224,-46,4,412,916.85,462
,20160309,2174,2224,2124,2152,2090,2144,2120,-80,-104,108,229.04,490
,20160310,2144,2120,2150,2182,2070,2096,2140,-24,20,238,509.35,534
,20160311,2096,2140,2108,2126,2104,2116,2116,-24,-24,90,190.59,508
,20160314,2116,2116,2120,2188,2120,2136,2158,20,42,202,436.25,542
,20160315,2136,2158,2142,2152,2112,2114,2126,-44,-32,56,119.07,554
,20160316,2114,2126,2112,2146,2106,2144,2132,18,6,114,243.20,546
,20160317,2144,2132,2150,2200,2146,2186,2176,54,44,78,169.85,554
,20160318,2186,2176,2208,2262,2204,2246,2234,70,58,220,491.70,504
,20160321,2246,2234,2248,2286,2226,2254,2250,20,16,176,396.12,478
,20160322,2254,2250,2270,2294,2254,2256,2272,6,22,144,327.26,428
,20160323,2256,2272,2248,2290,2234,2250,2274,-22,2,152,345.93,448
,20160324,2250,2274,2246,2246,2150,2158,2194,-116,-80,222,487.23,464
,20160325,2158,2194,2144,2188,2144,2178,2158,-16,-36,100,215.94,446
,20160328,2178,2158,2198,2212,2162,2170,2188,12,30,164,358.92,440
,20160329,2170,2188,2166,2194,2152,2152,2172,-36,-16,54,117.37,448
,20160330,2152,2172,2168,2184,2156,2184,2166,12,-6,110,238.28,408
,20160331,2184,2166,2192,2208,2138,2162,2168,-4,2,200,433.71,436
,20160401,2162,2168,2142,2182,2142,2180,2170,12,2,162,351.62,446
,20160405,2180,2170,2118,2142,2084,2118,2108,-52,-62,142,299.54,500
,20160406,2118,2108,2122,2146,2086,2086,2120,-22,12,224,475.04,526
,20160407,2086,2120,2104,2142,2104,2124,2132,4,12,92,196.19,534
,20160408,2124,2132,2126,2164,2110,2164,2132,32,0,162,345.49,590
,20160411,2164,2132,2188,2248,2180,2188,2200,56,68,382,840.90,554
,20160412,2188,2200,2194,2226,2186,2220,2214,20,14,112,247.99,592
,20160413,2220,2214,2226,2314,2224,2244,2260,30,46,176,398.10,556
,20160414,2244,2260,2278,2280,2254,2268,2262,8,2,88,199.17,564
,20160415,2268,2262,2276,2296,2268,2270,2286,8,24,168,384.10,632
,20160418,2270,2286,2258,2276,2228,2274,2252,-12,-34,204,459.44,652
,20160419,2274,2252,2284,2370,2266,2316,2300,64,48,400,920.24,654
,20160420,2316,2300,2310,2382,2306,2344,2334,44,34,472,"1,102.47",738
,20160421,2344,2334,2342,2468,2314,2464,2400,130,66,1326,"3,184.42",1298
,20160422,2464,2400,2410,2458,2308,2350,2374,-50,-26,1116,"2,650.80",1200
,20160425,2350,2374,2358,2438,2266,2348,2366,-26,-8,442,"1,046.31",1174
,20160426,2348,2366,2348,2378,2302,2340,2348,-26,-18,422,991.37,1222
,20160427,2340,2348,2372,2400,2330,2378,2366,30,18,304,719.43,1186
,20160428,2378,2366,2380,2390,2290,2314,2336,-52,-30,698,"1,631.59",1396
,20160429,2314,2336,2314,2354,2314,2326,2328,-10,-8,282,656.75,1488
,20160503,2326,2328,2300,2300,2252,2262,2268,-66,-60,508,"1,152.37",1706
,20160504,2262,2268,2266,2266,2232,2242,2240,-26,-28,330,739.59,1820
,20160505,2242,2240,2254,2268,2232,2256,2254,16,14,632,"1,424.92",1810
,20160506,2256,2254,2284,2284,2206,2208,2222,-46,-32,720,"1,601.25",2070
,20160509,2208,2222,2182,2242,2176,2200,2204,-22,-18,754,"1,663.28",2190
,20160510,2200,2204,2186,2204,2156,2190,2176,-14,-28,1326,"2,887.35",2282
,20160511,2190,2176,2206,2242,2196,2222,2216,46,40,574,"1,272.86",2258
,20160512,2222,2216,2216,2260,2214,2242,2236,26,20,372,832.33,2164
,20160513,2242,2236,2276,2276,2200,2210,2224,-26,-12,196,436.19,2172
,20160516,2210,2224,2210,2272,2210,2266,2248,42,24,220,494.73,2186
,20160517,2266,2248,2294,2312,2270,2294,2296,46,48,516,"1,185.29",2110
,20160518,2294,2296,2288,2314,2262,2268,2286,-28,-10,392,896.56,2116
,20160519,2268,2286,2268,2302,2236,2238,2266,-48,-20,304,689.20,2080
,20160520,2238,2266,2214,2250,2196,2236,2230,-30,-36,328,731.86,2114
,20160523,2236,2230,2234,2244,2100,2132,2138,-98,-92,904,"1,933.52",2472
,20160524,2132,2138,2112,2172,2094,2100,2112,-38,-26,1064,"2,247.99",2414
,20160525,2100,2112,2120,2156,2112,2156,2130,44,18,392,835.18,2374
,20160526,2156,2130,2166,2194,2136,2160,2170,30,40,1688,"3,663.61",2360
,20160527,2160,2170,2142,2174,2118,2128,2138,-42,-32,310,662.88,2418
,20160530,2128,2138,2080,2146,2080,2146,2128,8,-10,272,579.16,2468
,20160531,2146,2128,2146,2164,2136,2138,2150,10,22,234,503.12,2482
,20160601,2138,2150,2148,2152,2102,2112,2118,-38,-32,132,279.76,2492
,20160602,2112,2118,2104,2142,2102,2130,2124,12,6,184,390.82,2422
,20160603,2130,2124,2120,2152,2118,2150,2132,26,8,126,268.75,2400
,20160606,2150,2132,2174,2200,2132,2182,2148,50,16,818,"1,758.66",2608
,20160607,2182,2148,2184,2210,2178,2196,2194,48,46,230,505.07,2562
,20160608,2196,2194,2218,2220,2192,2202,2210,8,16,588,"1,299.50",2344
,20160613,2202,2210,2186,2216,2166,2208,2192,-2,-18,178,390.36,2356
,20160614,2208,2192,2226,2252,2222,2236,2238,44,46,452,"1,012.33",2448
,20160615,2236,2238,2230,2250,2198,2210,2214,-28,-24,156,345.57,2478
,20160616,2210,2214,2218,2230,2204,2218,2220,4,6,222,493.02,2536
,20160617,2218,2220,2200,2214,2180,2204,2190,-16,-30,532,"1,165.54",2520
,20160620,2204,2190,2212,2266,2204,2260,2226,70,36,1092,"2,432.14",2974
,20160621,2260,2226,2268,2286,2254,2256,2268,30,42,506,"1,147.66",2794
,20160622,2256,2268,2258,2296,2246,2292,2272,24,4,816,"1,854.32",2780
,20160623,2292,2272,2290,2304,2280,2280,2290,8,18,250,572.93,2752
,20160624,2280,2290,2308,2318,2238,2238,2282,-52,-8,904,"2,063.11",2798
,20160627,2238,2282,2230,2306,2230,2304,2268,22,-14,296,671.57,2852
,20160628,2304,2268,2300,2300,2256,2296,2280,28,12,426,971.34,2986
,20160629,2296,2280,2310,2340,2296,2338,2316,58,36,354,820.14,3046
,20160630,2338,2316,2334,2420,2328,2390,2380,74,64,476,"1,133.72",3004
,20160701,2390,2380,2382,2420,2364,2364,2392,-16,12,706,"1,688.91",3282
,20160704,2364,2392,2364,2490,2364,2476,2446,84,54,584,"1,429.24",3390
,20160705,2476,2446,2490,2490,2366,2386,2406,-60,-40,794,"1,911.25",3454
,20160706,2386,2406,2360,2394,2264,2282,2312,-124,-94,1778,"4,113.34",3226
,20160707,2282,2312,2268,2326,2268,2270,2298,-42,-14,678,"1,558.26",3438
,20160708,2270,2298,2290,2300,2218,2234,2250,-64,-48,996,"2,241.25",3596
,20160711,2234,2250,2258,2266,2220,2266,2250,16,0,644,"1,449.25",3678
,20160712,2266,2250,2278,2320,2262,2320,2290,70,40,614,"1,407.25",3678
,20160713,2320,2290,2324,2358,2300,2310,2328,20,38,1054,"2,454.18",3622
,20160714,2310,2328,2322,2388,2296,2366,2338,38,10,1232,"2,880.95",3674
,20160715,2366,2338,2380,2380,2328,2354,2346,16,8,938,"2,200.64",3776
,20160718,2354,2346,2368,2368,2276,2278,2314,-68,-32,1156,"2,677.18",3904
,20160719,2278,2314,2280,2304,2246,2276,2276,-38,-38,1292,"2,941.59",4166
,20160720,2276,2276,2274,2300,2252,2292,2284,16,8,1104,"2,521.77",4374
,20160721,2292,2284,2280,2320,2264,2312,2300,28,16,1982,"4,559.09",4460
,20160722,2312,2300,2306,2306,2258,2264,2280,-36,-20,510,"1,163.80",4510
,20160725,2264,2280,2256,2276,2202,2262,2250,-18,-30,1474,"3,317.46",4220
,20160726,2262,2250,2242,2280,2228,2234,2248,-16,-2,860,"1,934.94",4476
,20160727,2234,2248,2222,2248,2190,2212,2212,-36,-36,4476,"9,903.61",5878
,20160728,2212,2212,2206,2226,2186,2188,2208,-24,-4,1926,"4,254.53",6300
,20160729,2188,2208,2200,2204,2112,2126,2156,-82,-52,2974,"6,413.10",6910
,20160801,2126,2156,2158,2158,2116,2150,2136,-6,-20,2174,"4,647.90",7318
,20160802,2150,2136,2134,2162,2128,2154,2140,18,4,2542,"5,440.66",7862
,20160803,2154,2140,2162,2186,2142,2148,2162,8,22,1864,"4,032.84",8218
,20160804,2148,2162,2158,2176,2140,2158,2154,-4,-8,1664,"3,587.21",8530
,20160805,2158,2154,2154,2174,2150,2162,2160,8,6,1372,"2,965.13",8856
,20160808,2162,2160,2162,2206,2140,2198,2180,38,20,4098,"8,934.37",9908
,20160809,2198,2180,2214,2220,2182,2202,2198,22,18,2198,"4,832.55",10130
,20160810,2202,2198,2212,2236,2202,2212,2222,14,24,2986,"6,636.69",10958
,20160811,2212,2222,2216,2226,2190,2220,2208,-2,-14,3518,"7,773.15",11754
,20160812,2220,2208,2220,2256,2212,2246,2236,38,28,4174,"9,335.25",11622
,20160815,2246,2236,2240,2244,2218,2222,2230,-14,-6,9084,"20,261.71",13496
,20160816,2222,2230,2224,2238,2218,2218,2226,-12,-4,2680,"5,971.00",13878
,20160817,2218,2226,2218,2236,2196,2206,2212,-20,-14,5984,"13,248.05",15684
,20160818,2206,2212,2210,2220,2162,2178,2192,-34,-20,5752,"12,613.64",17010
,20160819,2178,2192,2140,2196,2140,2170,2166,-22,-26,10648,"23,078.57",23604
,20160822,2170,2166,2166,2178,2112,2112,2138,-54,-28,5358,"11,464.35",24228
,20160823,2112,2138,2114,2140,2102,2102,2118,-36,-20,7918,"16,778.52",24924
,20160824,2102,2118,2104,2128,2094,2106,2112,-12,-6,9804,"20,711.29",28752
,20160825,2106,2112,2110,2118,2034,2050,2058,-62,-54,15036,"30,949.27",33146
,20160826,2050,2058,2054,2078,2044,2058,2062,0,4,6210,"12,813.32",34986
,20160829,2058,2062,2058,2090,2058,2060,2072,-2,10,10808,"22,415.72",40822
,20160830,2060,2072,2068,2068,2026,2032,2048,-40,-24,14118,"28,917.40",45666
,20160831,2032,2048,2032,2044,1994,2018,2012,-30,-36,17604,"35,448.49",46520
,20160901,2018,2012,2012,2046,2008,2038,2030,26,18,12164,"24,695.08",46904
,20160902,2038,2030,2036,2050,2030,2032,2038,2,8,14090,"28,730.74",46532
,20160905,2032,2038,2036,2056,2034,2050,2046,12,8,10532,"21,556.48",48286
,20160906,2050,2046,2060,2092,2048,2088,2070,42,24,8018,"16,608.25",48246
,20160907,2088,2070,2076,2086,2070,2080,2076,10,6,10832,"22,502.56",50512
,20160908,2080,2076,2078,2098,2064,2098,2084,22,8,16964,"35,370.48",51284
,20160909,2098,2084,2084,2106,2084,2088,2096,4,12,9646,"20,230.16",52888
,20160912,2088,2096,2084,2086,2016,2024,2044,-72,-52,18698,"38,251.57",53942
,20160913,2024,2044,2002,2044,2002,2026,2028,-18,-16,12328,"25,009.22",55474
,20160914,2026,2028,2024,2034,2008,2008,2018,-20,-10,13758,"27,770.36",58704
,20160919,2008,2018,2010,2050,2004,2050,2032,32,14,9802,"19,935.95",58364
,20160920,2050,2032,2044,2058,2038,2050,2050,18,18,12480,"25,585.51",59722
,20160921,2050,2050,2044,2068,2026,2036,2050,-14,0,20212,"41,450.73",63608
,20160922,2036,2050,2030,2068,2026,2026,2044,-24,-6,28640,"58,577.84",67438
,20160923,2026,2044,2034,2044,2012,2030,2028,-14,-16,19638,"39,853.06",71244
,20160926,2030,2028,2032,2034,2012,2020,2026,-8,-2,12684,"25,701.92",72332
,20160927,2020,2026,2026,2032,1990,2000,2008,-26,-18,24684,"49,582.87",79624
,20160928,2000,2008,1990,1998,1886,1890,1916,-118,-92,87822,"168,312.81",103852
,20160929,1890,1916,1900,1920,1858,1908,1892,-8,-24,110712,"209,536.67",118508
,20160930,1908,1892,1908,1930,1904,1922,1918,30,26,41746,"80,136.40",114646
,20161010,1922,1918,1930,1952,1924,1928,1934,10,16,33424,"64,697.56",112952
,20161011,1928,1934,1946,2020,1940,1988,1992,54,58,100030,"199,453.78",121008
,20161012,1988,1992,1990,1998,1960,1968,1978,-24,-14,43398,"85,924.51",124288
,20161013,1968,1978,1974,1982,1948,1954,1962,-24,-16,51208,"100,503.82",130646
,20161014,1954,1962,1956,1970,1938,1960,1956,-2,-6,50536,"98,882.65",137304
,20161017,1960,1956,1962,2030,1950,2028,1998,72,42,95510,"190,867.34",146670
,20161018,2028,1998,2036,2040,2002,2020,2016,22,18,60304,"121,573.96",149592
,20161019,2020,2016,2020,2048,2016,2042,2032,26,16,110574,"224,860.66",158452
,20161020,2042,2032,2048,2094,2042,2078,2074,46,42,149860,"311,007.54",165902
,20161021,2078,2074,2076,2082,2050,2078,2064,4,-10,85954,"177,423.62",158914
,20161024,2078,2064,2078,2104,2070,2096,2090,32,26,112756,"235,703.37",178348
,20161025,2096,2090,2100,2112,2064,2066,2082,-24,-8,161092,"335,610.73",195850
,20161026,2066,2082,2066,2074,2002,2030,2032,-52,-50,215488,"438,074.43",221516
,20161027,2030,2032,2030,2050,2018,2036,2034,4,2,164512,"334,752.07",244592
,20161028,2036,2034,2036,2064,2036,2060,2050,26,16,175550,"359,885.57",254888
,20161031,2060,2050,2060,2062,2022,2058,2046,8,-4,239574,"490,202.28",300352
,20161101,2058,2046,2052,2102,2034,2078,2068,32,22,342128,"707,816.64",366116
,20161102,2078,2068,2080,2140,2048,2056,2092,-12,24,490206,"1,025,698.30",403602
,20161103,2056,2092,2052,2066,2030,2048,2046,-44,-46,222450,"455,293.72",403374
,20161104,2048,2046,2052,2066,1986,2000,2024,-46,-22,397100,"803,920.05",391262
,20161107,2000,2024,1998,2050,1992,2032,2022,8,-2,299704,"606,453.45",408968
,20161108,2032,2022,2028,2080,2022,2060,2052,38,30,497432,"1,020,864.75",441970
,20161109,2060,2052,2060,2126,2052,2078,2088,26,36,921144,"1,924,679.31",505654
,20161110,2078,2088,2098,2208,2092,2194,2150,106,62,1408590,"3,030,314.79",595784
,20161111,2194,2150,2192,2264,2164,2248,2218,98,68,1511354,"3,353,887.11",732758
,20161114,2248,2218,2248,2296,2084,2084,2170,-134,-48,1710012,"3,712,856.61",663306
,20161115,2084,2170,2084,2128,2060,2120,2098,-50,-72,1090110,"2,288,324.98",730172
,20161116,2120,2098,2132,2188,2128,2188,2158,90,60,1240456,"2,678,201.54",797768
,20161117,2188,2158,2180,2198,2140,2182,2170,24,12,1053888,"2,288,812.11",801028
,20161118,2182,2170,2200,2204,2148,2168,2172,-2,2,967566,"2,102,867.56",810026
,20161121,2168,2172,2180,2256,2150,2246,2204,74,32,1310426,"2,889,500.54",839744
,20161122,2246,2204,2256,2336,2242,2326,2298,122,94,1430114,"3,288,843.27",845928
,20161123,2326,2298,2302,2396,2258,2348,2340,50,42,1652108,"3,866,692.72",884780
,20161124,2348,2340,2350,2368,2290,2312,2328,-28,-12,1486792,"3,464,126.08",883330
,20161125,2312,2328,2322,2362,2250,2288,2304,-40,-24,1393032,"3,212,001.52",872974
,20161128,2288,2304,2292,2358,2256,2342,2306,38,2,1441558,"3,327,055.20",953482
,20161129,2342,2306,2352,2378,2284,2304,2334,-2,28,1361690,"3,179,677.39",912064
,20161130,2304,2334,2280,2302,2178,2228,2240,-106,-94,1623202,"3,638,675.99",821776
,20161201,2228,2240,2278,2382,2276,2344,2328,104,88,2075150,"4,834,093.91",813716
,20161202,2344,2328,2360,2374,2292,2338,2336,10,8,1233134,"2,881,709.68",779650
,20161205,2338,2336,2328,2438,2318,2418,2382,82,46,1360676,"3,243,418.07",802468
,20161206,2418,2382,2430,2454,2390,2410,2420,28,38,1049410,"2,539,815.86",820884
,20161207,2410,2420,2408,2482,2394,2444,2434,24,14,1294240,"3,152,718.42",810716
,20161208,2444,2434,2444,2470,2374,2392,2418,-42,-16,886768,"2,144,626.49",777232
,20161209,2392,2418,2402,2506,2390,2466,2446,48,28,1604898,"3,926,816.41",812912
,20161212,2466,2446,2470,2576,2450,2544,2522,98,76,1138960,"2,873,692.52",804014
,20161213,2544,2522,2544,2558,2492,2538,2530,16,8,791020,"2,001,340.12",806858
,20161214,2538,2530,2554,2568,2486,2520,2524,-10,-6,894832,"2,259,708.83",828764
,20161215,2520,2524,2518,2518,2468,2510,2494,-14,-30,896400,"2,235,798.60",841752
,20161216,2510,2494,2502,2550,2478,2484,2512,-10,18,942928,"2,369,841.46",822244
,20161219,2484,2512,2490,2616,2484,2576,2556,64,44,1365748,"3,492,849.93",772312
,20161220,2576,2556,2580,2632,2534,2588,2584,32,28,1956368,"5,057,831.08",746892
,20161221,2588,2584,2600,2628,2564,2592,2592,8,8,1348748,"3,496,905.04",762640
,20161222,2592,2592,2592,2592,2510,2510,2554,-82,-38,1254588,"3,205,862.90",748856
,20161223,2510,2554,2500,2536,2458,2500,2496,-54,-58,1313346,"3,278,536.40",699552
,20161226,2500,2496,2490,2514,2416,2468,2466,-28,-30,1297160,"3,200,037.43",664340
,20161227,2468,2466,2468,2638,2446,2638,2520,172,54,1532322,"3,861,824.26",723478
,20161228,2638,2520,2650,2696,2632,2696,2672,176,152,1101560,"2,943,878.64",764588
,20161229,2696,2672,2718,2778,2670,2752,2720,80,48,1912888,"5,205,627.42",774820
,20161230,2752,2720,2752,2756,2696,2738,2722,18,2,1271218,"3,462,398.96",733132
bu1709,20160104,2202,2210,2204,2204,2140,2140,2158,-70,-52,12,25.90,48
,20160105,2140,2158,2148,2148,2148,2148,2148,-10,-10,2,4.30,48
,20160106,2148,2148,2148,2148,2096,2108,2120,-40,-28,20,42.41,48
,20160107,2108,2120,2092,2094,2052,2054,2066,-66,-54,36,74.41,46
,20160108,2054,2066,2076,2076,2058,2058,2070,-8,4,6,12.42,46
,20160111,2058,2070,2094,2100,2002,2056,2078,-14,8,26,54.03,42
,20160112,2056,2078,2014,2028,2006,2028,2018,-50,-60,34,68.61,40
,20160113,2028,2018,2012,2018,1982,2006,2000,-12,-18,28,56.03,46
,20160114,2006,2000,2010,2030,1970,2030,2018,30,18,36,72.67,44
,20160115,2030,2018,2032,2076,2024,2024,2044,6,26,16,32.70,44
,20160118,2024,2044,2042,2080,2040,2070,2062,26,18,34,70.17,42
,20160119,2070,2062,2080,2106,2080,2106,2090,44,28,18,37.65,40
,20160120,2106,2090,2108,2112,2080,2092,2102,2,12,14,29.43,40
,20160121,2092,2102,2084,2092,2058,2058,2070,-44,-32,20,41.43,44
,20160122,2058,2070,2064,2090,2064,2090,2080,20,10,10,20.80,42
,20160125,2090,2080,2098,2098,2098,2098,2098,18,18,2,4.20,40
,20160126,2098,2098,2072,2072,2072,2072,2072,-26,-26,2,4.14,42
,20160127,2072,2072,,,,2072,2072,0,0,0,0.00,42
,20160128,2072,2072,2108,2108,2086,2106,2102,34,30,10,21.02,36
,20160129,2106,2102,,,,2100,2100,-2,-2,0,0.00,36
,20160201,2100,2100,2064,2086,2060,2060,2066,-40,-34,10,20.67,36
,20160202,2060,2066,2040,2056,2034,2040,2042,-26,-24,20,40.87,26
,20160203,2040,2042,2024,2024,2024,2024,2024,-18,-18,8,16.19,20
,20160204,2024,2024,2056,2058,2056,2058,2056,34,32,8,16.46,20
,20160205,2058,2056,,,,2056,2056,0,0,0,0.00,20
,20160215,2056,2056,,,,2056,2056,0,0,0,0.00,20
,20160216,2056,2056,2046,2074,2046,2060,2060,4,4,6,12.36,24
,20160217,2060,2060,2060,2060,2038,2038,2048,-22,-12,6,12.29,22
,20160218,2038,2048,,,,2054,2054,6,6,0,0.00,22
,20160219,2054,2054,2088,2110,2060,2088,2082,34,28,32,66.66,24
,20160222,2088,2082,2078,2120,2078,2082,2098,0,16,50,104.92,24
,20160223,2082,2098,2090,2090,2054,2054,2058,-44,-40,58,119.44,70
,20160224,2054,2058,2054,2098,2006,2012,2044,-46,-14,52,106.33,86
,20160225,2012,2044,2032,2040,2008,2040,2020,-4,-24,36,72.75,78
,20160226,2040,2020,2022,2076,2022,2072,2050,52,30,60,123.09,52
,20160229,2072,2050,2082,2092,2070,2092,2076,42,26,12,24.92,48
,20160301,2092,2076,2054,2094,2054,2094,2062,18,-14,28,57.78,62
,20160302,2094,2062,2152,2152,2152,2152,2152,90,90,6,12.91,58
,20160303,2152,2152,,,,2152,2152,0,0,0,0.00,58
,20160304,2152,2152,2146,2166,2142,2166,2156,14,4,20,43.13,74
,20160307,2166,2156,2172,2266,2172,2240,2244,84,88,42,94.30,94
,20160308,2240,2244,2266,2328,2136,2216,2216,-28,-28,88,195.11,126
,20160309,2216,2216,2172,2172,2118,2168,2138,-48,-78,20,42.76,130
,20160310,2168,2138,2186,2186,2126,2126,2152,-12,14,32,68.89,150
,20160311,2126,2152,2206,2206,2130,2152,2156,0,4,10,21.57,154
,20160314,2152,2156,2166,2184,2166,2184,2172,28,16,6,13.04,150
,20160315,2184,2172,2138,2152,2138,2142,2142,-30,-30,16,34.30,158
,20160316,2142,2142,2142,2200,2142,2174,2164,32,22,8,17.32,158
,20160317,2174,2164,2214,2234,2202,2210,2212,46,48,14,30.99,158
,20160318,2210,2212,2226,2320,2224,2316,2268,104,56,160,363.03,138
,20160321,2316,2268,2316,2316,2316,2316,2316,48,48,2,4.63,138
,20160322,2316,2316,2316,2348,2300,2302,2330,-14,14,118,274.94,142
,20160323,2302,2330,2290,2330,2282,2314,2306,-16,-24,60,138.42,176
,20160324,2314,2306,2262,2276,2208,2220,2240,-86,-66,34,76.21,176
,20160325,2220,2240,2196,2226,2172,2200,2198,-40,-42,174,382.63,204
,20160328,2200,2198,2244,2252,2210,2210,2232,12,34,42,93.82,224
,20160329,2210,2232,2224,2224,2202,2202,2210,-30,-22,34,75.17,248
,20160330,2202,2210,2194,2204,2194,2204,2202,-6,-8,22,48.45,248
,20160331,2204,2202,2236,2278,2180,2188,2210,-14,8,112,247.70,288
,20160401,2188,2210,2222,2248,2212,2248,2228,38,18,32,71.32,290
,20160405,2248,2228,2158,2198,2150,2168,2170,-60,-58,54,117.19,270
,20160406,2168,2170,2168,2186,2168,2180,2174,10,4,40,86.98,246
,20160407,2180,2174,2180,2200,2178,2190,2190,16,16,52,113.94,212
,20160408,2190,2190,2186,2276,2168,2210,2210,20,20,100,221.11,240
,20160411,2210,2210,2324,2324,2260,2268,2272,58,62,154,350.03,194
,20160412,2268,2272,2292,2308,2266,2288,2284,16,12,92,210.28,190
,20160413,2288,2284,2290,2358,2290,2320,2330,36,46,202,470.73,194
,20160414,2320,2330,2320,2360,2320,2336,2338,6,8,58,135.61,194
,20160415,2336,2338,2358,2358,2340,2346,2350,8,12,26,61.11,182
,20160418,2346,2350,2324,2330,2272,2300,2300,-50,-50,522,"1,201.49",198
,20160419,2300,2300,2326,2388,2310,2366,2354,66,54,238,560.56,224
,20160420,2366,2354,2374,2436,2350,2400,2406,46,52,562,"1,352.71",342
,20160421,2400,2406,2410,2550,2352,2550,2476,144,70,224,554.85,352
,20160422,2550,2476,2570,2594,2410,2412,2466,-64,-10,586,"1,445.24",370
,20160425,2412,2466,2448,2498,2394,2460,2442,-6,-24,458,"1,118.50",374
,20160426,2460,2442,2472,2472,2402,2434,2436,-8,-6,118,287.60,384
,20160427,2434,2436,2480,2494,2426,2466,2466,30,30,196,483.54,404
,20160428,2466,2466,2462,2474,2404,2422,2448,-44,-18,168,411.49,402
,20160429,2422,2448,2438,2462,2430,2436,2436,-12,-12,62,151.11,410
,20160503,2436,2436,2402,2402,2366,2378,2376,-58,-60,52,123.58,416
,20160504,2378,2376,2392,2392,2340,2360,2354,-16,-22,164,386.18,422
,20160505,2360,2354,2378,2378,2348,2348,2360,-6,6,116,273.80,394
,20160506,2348,2360,2380,2384,2316,2316,2334,-44,-26,78,182.13,390
,20160509,2316,2334,2322,2346,2240,2274,2278,-60,-56,264,601.91,320
,20160510,2274,2278,2226,2276,2226,2270,2256,-8,-22,46,103.79,324
,20160511,2270,2256,2272,2320,2272,2316,2302,60,46,78,179.56,310
,20160512,2316,2302,2318,2346,2294,2346,2308,44,6,110,254.09,300
,20160513,2346,2308,2360,2366,2300,2320,2334,12,26,48,112.04,304
,20160516,2320,2334,2288,2362,2288,2362,2326,28,-8,82,190.80,304
,20160517,2362,2326,2396,2396,2356,2380,2376,54,50,44,104.63,306
,20160518,2380,2376,2380,2392,2344,2366,2374,-10,-2,18,42.76,304
,20160519,2366,2374,2366,2366,2320,2320,2338,-54,-36,42,98.24,314
,20160520,2320,2338,2296,2326,2272,2326,2310,-12,-28,36,83.22,308
,20160523,2326,2310,2306,2306,2198,2220,2242,-90,-68,60,134.58,290
,20160524,2220,2242,2246,2246,2188,2190,2202,-52,-40,158,348.09,310
,20160525,2190,2202,2226,2230,2204,2226,2216,24,14,46,101.98,310
,20160526,2226,2216,2240,2260,2230,2238,2242,22,26,48,107.69,314
,20160527,2238,2242,2240,2242,2196,2206,2210,-36,-32,38,83.99,312
,20160530,2206,2210,2202,2218,2190,2216,2204,6,-6,34,74.98,320
,20160531,2216,2204,2226,2234,2216,2224,2224,20,20,22,48.96,322
,20160601,2224,2224,2214,2214,2176,2176,2192,-48,-32,10,21.93,322
,20160602,2176,2192,2192,2204,2184,2190,2192,-2,0,38,83.37,344
,20160603,2190,2192,2180,2214,2180,2214,2202,22,10,64,140.96,364
,20160606,2214,2202,2214,2244,2200,2238,2216,36,14,72,159.58,356
,20160607,2238,2216,2238,2258,2236,2244,2246,28,30,62,139.30,358
,20160608,2244,2246,2314,2314,2246,2268,2264,22,18,54,122.34,358
,20160613,2268,2264,2248,2268,2242,2268,2254,4,-10,42,94.72,372
,20160614,2268,2254,2278,2312,2264,2278,2284,24,30,484,"1,106.31",454
,20160615,2278,2284,2290,2292,2248,2264,2264,-20,-20,32,72.48,454
,20160616,2264,2264,2266,2290,2260,2272,2274,8,10,64,145.58,466
,20160617,2272,2274,2262,2272,2228,2268,2256,-6,-18,70,157.95,484
,20160620,2268,2256,2286,2322,2278,2322,2300,66,44,68,156.43,480
,20160621,2322,2300,2314,2374,2310,2340,2334,40,34,76,177.44,450
,20160622,2340,2334,2328,2360,2328,2350,2346,16,12,26,61.01,462
,20160623,2350,2346,2360,2366,2356,2366,2360,20,14,18,42.49,460
,20160624,2366,2360,2328,2358,2308,2308,2332,-52,-28,46,107.33,460
,20160627,2308,2332,2322,2352,2312,2352,2324,20,-8,36,83.71,458
,20160628,2352,2324,2352,2364,2320,2350,2346,26,22,18,42.23,454
,20160629,2350,2346,2350,2398,2350,2390,2380,44,34,44,104.76,464
,20160630,2390,2380,2418,2504,2418,2464,2448,84,68,96,235.19,424
,20160701,2464,2448,2464,2486,2456,2468,2470,20,22,126,311.34,434
,20160704,2468,2470,2478,2570,2468,2570,2522,100,52,122,307.82,480
,20160705,2570,2522,2548,2552,2466,2498,2510,-24,-12,264,662.87,658
,20160706,2498,2510,2468,2488,2386,2386,2420,-124,-90,252,610.26,598
,20160707,2386,2420,2404,2474,2386,2386,2420,-34,0,116,280.80,608
,20160708,2386,2420,2406,2406,2332,2336,2360,-84,-60,52,122.75,628
,20160711,2336,2360,2356,2366,2334,2366,2352,6,-8,8,18.82,628
,20160712,2366,2352,2366,2414,2366,2414,2392,62,40,48,114.85,610
,20160713,2414,2392,2426,2470,2406,2426,2430,34,38,60,145.84,606
,20160714,2426,2430,2406,2480,2404,2466,2444,36,14,62,151.56,604
,20160715,2466,2444,2432,2472,2426,2428,2450,-16,6,166,406.86,670
,20160718,2428,2450,2428,2428,2362,2376,2402,-74,-48,164,394.04,620
,20160719,2376,2402,2372,2388,2350,2350,2370,-52,-32,38,90.12,626
,20160720,2350,2370,2382,2386,2366,2376,2378,6,8,34,80.89,620
,20160721,2376,2378,2366,2412,2366,2412,2398,34,20,68,163.15,618
,20160722,2412,2398,2388,2388,2366,2366,2372,-32,-26,52,123.39,632
,20160725,2366,2372,2376,2376,2326,2346,2346,-26,-26,76,178.42,644
,20160726,2346,2346,2350,2366,2328,2330,2346,-16,0,52,122.02,654
,20160727,2330,2346,2330,2346,2306,2306,2324,-40,-22,144,334.87,694
,20160728,2306,2324,2326,2328,2300,2304,2312,-20,-12,46,106.37,688
,20160729,2304,2312,2318,2318,2246,2246,2264,-66,-48,98,221.99,692
,20160801,2246,2264,2234,2266,2232,2266,2238,2,-26,78,174.69,656
,20160802,2266,2238,2242,2252,2238,2242,2244,4,6,44,98.80,664
,20160803,2242,2244,2266,2302,2258,2260,2274,16,30,50,113.71,656
,20160804,2260,2274,2270,2286,2246,2254,2258,-20,-16,46,103.91,654
,20160805,2254,2258,2264,2266,2264,2266,2264,8,6,8,18.12,646
,20160808,2266,2264,2264,2302,2246,2298,2276,34,12,36,82.00,646
,20160809,2298,2276,2286,2306,2286,2306,2298,30,22,38,87.36,636
,20160810,2306,2298,2326,2328,2306,2312,2318,14,20,42,97.37,636
,20160811,2312,2318,2308,2320,2286,2306,2306,-12,-12,92,212.16,640
,20160812,2306,2306,2308,2338,2308,2338,2324,32,18,52,120.90,634
,20160815,2338,2324,2330,2346,2308,2326,2334,2,10,78,182.18,638
,20160816,2326,2334,2332,2336,2318,2318,2324,-16,-10,24,55.78,640
,20160817,2318,2324,2346,2346,2302,2318,2316,-6,-8,32,74.12,650
,20160818,2318,2316,2314,2314,2286,2286,2300,-30,-16,42,96.62,672
,20160819,2286,2300,2294,2304,2272,2280,2284,-20,-16,50,114.30,706
,20160822,2280,2284,2284,2284,2242,2246,2262,-38,-22,46,104.05,740
,20160823,2246,2262,2252,2256,2202,2202,2210,-60,-52,322,711.68,818
,20160824,2202,2210,2218,2226,2204,2204,2214,-6,4,148,327.92,844
,20160825,2204,2214,2216,2216,2134,2154,2152,-60,-62,218,469.29,936
,20160826,2154,2152,2164,2168,2152,2168,2160,16,8,28,60.50,926
,20160829,2168,2160,2182,2196,2176,2180,2186,20,26,58,126.79,936
,20160830,2180,2186,2166,2180,2138,2138,2156,-48,-30,52,112.13,962
,20160831,2138,2156,2156,2156,2106,2132,2132,-24,-24,92,196.16,1024
,20160901,2132,2132,2144,2156,2144,2156,2146,24,14,16,34.35,1012
,20160902,2156,2146,2162,2162,2142,2156,2152,10,6,6,12.92,1012
,20160905,2156,2152,2160,2166,2152,2164,2160,12,8,14,30.24,1012
,20160906,2164,2160,2160,2188,2160,2188,2172,28,12,54,117.39,1002
,20160907,2188,2172,2178,2190,2178,2184,2186,12,14,44,96.19,998
,20160908,2184,2186,2190,2202,2172,2190,2190,4,4,40,87.68,1012
,20160909,2190,2190,2206,2206,2202,2202,2204,12,14,10,22.05,1006
,20160912,2202,2204,2186,2186,2130,2138,2158,-66,-46,64,138.14,1044
,20160913,2138,2158,2128,2148,2126,2142,2140,-16,-18,30,64.21,1054
,20160914,2142,2140,2130,2150,2126,2128,2138,-12,-2,32,68.44,1066
,20160919,2128,2138,2152,2164,2144,2162,2152,24,14,26,55.99,1072
,20160920,2162,2152,2166,2170,2154,2170,2162,18,10,40,86.56,1062
,20160921,2170,2162,2166,2180,2144,2144,2160,-18,-2,94,203.22,1076
,20160922,2144,2160,2150,2172,2140,2140,2154,-20,-6,100,215.43,1098
,20160923,2140,2154,2152,2152,2128,2140,2140,-14,-14,72,154.13,1128
,20160926,2140,2140,2132,2150,2128,2140,2142,0,2,48,102.84,1150
,20160927,2140,2142,2150,2150,2106,2106,2122,-36,-20,176,373.70,1172
,20160928,2106,2122,2100,2136,1996,2006,2026,-116,-96,556,"1,127.28",1400
,20160929,2006,2026,2002,2022,1980,2008,2002,-18,-24,598,"1,197.78",1444
,20160930,2008,2002,2012,2030,2006,2020,2018,18,16,214,431.90,1410
,20161010,2020,2018,2026,2036,2016,2018,2018,0,0,246,496.83,1434
,20161011,2018,2018,2038,2122,2026,2094,2100,76,82,900,"1,891.24",1442
,20161012,2094,2100,2088,2106,2070,2106,2078,6,-22,528,"1,098.22",1706
,20161013,2106,2078,2120,2120,2070,2070,2094,-8,16,674,"1,412.60",1866
,20161014,2070,2094,2078,2084,2054,2080,2070,-14,-24,296,612.78,1992
,20161017,2080,2070,2080,2130,2078,2120,2096,50,26,648,"1,358.87",1850
,20161018,2120,2096,2126,2126,2106,2120,2114,24,18,186,393.40,1916
,20161019,2120,2114,2122,2146,2116,2144,2130,30,16,254,541.47,1960
,20161020,2144,2130,2146,2188,2146,2176,2176,46,46,726,"1,580.55",2046
,20161021,2176,2176,2180,2180,2148,2166,2160,-10,-16,216,466.62,2038
,20161024,2166,2160,2180,2198,2172,2186,2188,26,28,410,897.34,2242
,20161025,2186,2188,2196,2206,2170,2182,2190,-6,2,1122,"2,457.72",2364
,20161026,2182,2190,2166,2188,2124,2132,2142,-58,-48,640,"1,371.94",2538
,20161027,2132,2142,2082,2166,2082,2150,2128,8,-14,690,"1,469.40",2636
,20161028,2150,2128,2160,2182,2158,2178,2172,50,44,788,"1,712.01",2746
,20161031,2178,2172,2180,2180,2146,2180,2164,8,-8,820,"1,775.41",2716
,20161101,2180,2164,2180,2218,2158,2194,2192,30,28,1070,"2,346.75",2826
,20161102,2194,2192,2210,2258,2128,2174,2214,-18,22,1598,"3,540.02",2822
,20161103,2174,2214,2170,2186,2154,2164,2172,-50,-42,990,"2,150.38",2996
,20161104,2164,2172,2140,2184,2118,2126,2140,-46,-32,2288,"4,900.36",3480
,20161107,2126,2140,2134,2176,2106,2162,2146,22,6,530,"1,137.95",3550
,20161108,2162,2146,2176,2206,2152,2206,2178,60,32,1356,"2,954.83",3904
,20161109,2206,2178,2212,2248,2170,2202,2212,24,34,2026,"4,484.35",3598
,20161110,2202,2212,2216,2330,2216,2318,2278,106,66,2106,"4,798.52",3786
,20161111,2318,2278,2328,2408,2292,2390,2366,112,88,2944,"6,970.52",4740
,20161114,2390,2366,2390,2440,2224,2226,2316,-140,-50,6490,"15,038.67",5520
,20161115,2226,2316,2248,2270,2200,2254,2238,-62,-78,3078,"6,893.85",5710
,20161116,2254,2238,2266,2320,2266,2320,2294,82,56,1548,"3,552.90",5662
,20161117,2320,2294,2314,2328,2276,2318,2302,24,8,2062,"4,747.70",5544
,20161118,2318,2302,2360,2360,2286,2302,2310,0,8,1768,"4,086.75",5660
,20161121,2302,2310,2314,2390,2284,2382,2332,72,22,2914,"6,795.84",5898
,20161122,2382,2332,2382,2466,2372,2442,2434,110,102,9568,"23,304.15",8384
,20161123,2442,2434,2430,2508,2376,2460,2458,26,24,5556,"13,662.28",9004
,20161124,2460,2458,2448,2476,2386,2418,2438,-40,-20,3396,"8,283.06",8954
,20161125,2418,2438,2428,2470,2360,2398,2408,-40,-30,5010,"12,072.80",9982
,20161128,2398,2408,2394,2456,2360,2446,2414,38,6,3670,"8,860.15",10300
,20161129,2446,2414,2450,2486,2320,2404,2424,-10,10,5532,"13,410.01",10308
,20161130,2404,2424,2400,2402,2284,2340,2344,-84,-80,6550,"15,356.47",10698
,20161201,2340,2344,2388,2480,2388,2440,2430,96,86,6158,"14,970.44",11168
,20161202,2440,2430,2448,2472,2402,2444,2436,14,6,4588,"11,181.71",11416
,20161205,2444,2436,2430,2546,2428,2534,2492,98,56,7616,"18,987.44",11644
,20161206,2534,2492,2538,2566,2502,2528,2534,36,42,5678,"14,388.55",11720
,20161207,2528,2534,2528,2612,2516,2570,2564,36,30,9490,"24,347.20",14224
,20161208,2570,2564,2570,2596,2506,2526,2542,-38,-22,5630,"14,322.34",14860
,20161209,2526,2542,2526,2640,2520,2598,2594,56,52,14288,"37,084.33",18174
,20161212,2598,2594,2608,2716,2592,2680,2674,86,80,13312,"35,605.88",19372
,20161213,2680,2674,2680,2694,2638,2678,2666,4,-8,7710,"20,569.89",20970
,20161214,2678,2666,2696,2708,2628,2662,2666,-4,0,6842,"18,241.19",21328
,20161215,2662,2666,2662,2662,2608,2644,2634,-22,-32,7314,"19,266.72",21340
,20161216,2644,2634,2644,2682,2618,2620,2652,-14,18,6482,"17,198.28",21734
,20161219,2620,2652,2620,2730,2620,2708,2690,56,38,10946,"29,456.02",20752
,20161220,2708,2690,2702,2742,2658,2680,2698,-10,8,21144,"57,049.91",21824
,20161221,2680,2698,2670,2726,2670,2702,2698,4,0,11888,"32,086.51",22656
,20161222,2702,2698,2698,2700,2618,2618,2662,-80,-36,8216,"21,882.50",22922
,20161223,2618,2662,2618,2648,2574,2606,2610,-56,-52,14040,"36,649.02",23408
,20161226,2606,2610,2582,2628,2530,2590,2578,-20,-32,12240,"31,576.30",22828
,20161227,2590,2578,2580,2758,2572,2756,2642,178,64,11686,"30,878.70",22278
,20161228,2756,2642,2758,2826,2752,2826,2794,184,152,12384,"34,621.14",23576
,20161229,2826,2794,2846,2878,2780,2846,2820,52,26,32212,"90,886.32",27560
,20161230,2846,2820,2846,2848,2786,2824,2810,4,-10,24474,"68,787.41",25026
bu1712,20160104,2226,2196,,,,2196,2196,0,0,0,0.00,4
,20160105,2196,2196,2170,2170,2170,2170,2170,-26,-26,2,4.34,4
,20160106,2170,2170,2190,2190,2072,2084,2098,-86,-72,52,109.20,34
,20160107,2084,2098,2082,2084,2050,2052,2058,-46,-40,46,94.71,42
,20160108,2052,2058,2044,2044,2044,2044,2044,-14,-14,2,4.09,42
,20160111,2044,2044,2066,2148,2054,2060,2092,16,48,92,192.55,36
,20160112,2060,2092,2050,2050,1988,1990,2018,-102,-74,50,100.99,34
,20160113,1990,2018,2006,2034,1972,2000,2000,-18,-18,68,136.08,44
,20160114,2000,2000,2002,2044,1992,2000,2008,0,8,60,120.52,48
,20160115,2000,2008,1992,2078,1992,2040,2044,32,36,54,110.42,30
,20160118,2040,2044,2012,2082,1972,2064,2042,20,-2,56,114.39,56
,20160119,2064,2042,2088,2088,2028,2076,2072,34,30,42,87.03,60
,20160120,2076,2072,2088,2092,2064,2074,2082,2,10,36,74.96,58
,20160121,2074,2082,2064,2070,2040,2052,2052,-30,-30,54,110.88,60
,20160122,2052,2052,2040,2080,2008,2066,2038,14,-14,28,57.11,54
,20160125,2066,2038,2050,2088,2050,2080,2070,42,32,20,41.41,56
,20160126,2080,2070,2070,2072,2062,2062,2066,-8,-4,12,24.81,54
,20160127,2062,2066,,,,2066,2066,0,0,0,0.00,54
,20160128,2066,2066,2096,2178,2070,2092,2104,26,38,28,58.95,52
,20160129,2092,2104,2096,2096,2052,2052,2074,-52,-30,4,8.30,56
,20160201,2052,2074,2050,2058,2042,2042,2050,-32,-24,18,36.90,56
,20160202,2042,2050,2022,2048,2022,2036,2036,-14,-14,14,28.52,52
,20160203,2036,2036,2032,2032,2032,2032,2032,-4,-4,2,4.06,50
,20160204,2032,2032,2046,2046,2046,2046,2046,14,14,2,4.09,48
,20160205,2046,2046,2014,2030,2012,2018,2018,-28,-28,10,20.18,50
,20160215,2018,2018,2012,2012,2012,2012,2012,-6,-6,2,4.02,50
,20160216,2012,2012,2050,2068,2026,2048,2048,36,36,18,36.89,54
,20160217,2048,2048,2042,2042,2042,2042,2042,-6,-6,2,4.08,54
,20160218,2042,2042,2062,2078,2062,2078,2070,36,28,4,8.28,54
,20160219,2078,2070,2078,2108,2076,2108,2086,38,16,10,20.88,62
,20160222,2108,2086,2100,2106,2080,2090,2092,4,6,34,71.14,76
,20160223,2090,2092,2094,2094,2074,2080,2086,-12,-6,24,50.08,82
,20160224,2080,2086,2078,2080,2056,2064,2070,-22,-16,142,294.18,196
,20160225,2064,2070,2050,2080,2050,2064,2066,-6,-4,52,107.52,200
,20160226,2064,2066,2098,2114,2062,2112,2090,46,24,122,255.20,144
,20160229,2112,2090,2122,2140,2102,2116,2114,26,24,60,126.94,122
,20160301,2116,2114,2118,2160,2106,2152,2128,38,14,34,72.35,118
,20160302,2152,2128,2152,2208,2146,2194,2174,66,46,64,139.24,114
,20160303,2194,2174,2196,2216,2188,2188,2196,14,22,28,61.52,118
,20160304,2188,2196,2182,2196,2182,2188,2192,-8,-4,18,39.47,132
,20160307,2188,2192,2208,2322,2192,2322,2284,130,92,98,223.86,164
,20160308,2322,2284,2336,2372,2182,2220,2282,-64,-2,124,283.16,190
,20160309,2220,2282,2196,2238,2144,2238,2180,-44,-102,110,240.00,248
,20160310,2238,2180,2242,2262,2160,2180,2204,0,24,296,652.69,370
,20160311,2180,2204,2202,2204,2190,2204,2198,0,-6,6,13.19,366
,20160314,2204,2198,2224,2252,2224,2242,2228,44,30,28,62.42,346
,20160315,2242,2228,2242,2242,2192,2192,2210,-36,-18,32,70.78,334
,20160316,2192,2210,2216,2232,2216,2230,2218,20,8,24,53.26,336
,20160317,2230,2218,2260,2272,2250,2272,2262,54,44,10,22.63,340
,20160318,2272,2262,2310,2352,2264,2338,2326,76,64,50,116.36,326
,20160321,2338,2326,2306,2368,2306,2368,2340,42,14,14,32.78,324
,20160322,2368,2340,2358,2366,2348,2358,2356,18,16,8,18.86,326
,20160323,2358,2356,2304,2398,2304,2352,2362,-4,6,52,122.88,348
,20160324,2352,2362,2330,2360,2264,2264,2306,-98,-56,346,798.26,462
,20160325,2264,2306,2284,2314,2252,2308,2292,2,-14,96,220.14,468
,20160328,2308,2292,2326,2334,2286,2286,2318,-6,26,108,250.51,404
,20160329,2286,2318,2270,2300,2268,2286,2284,-32,-34,44,100.51,422
,20160330,2286,2284,2286,2324,2286,2310,2304,26,20,30,69.15,416
,20160331,2310,2304,2346,2380,2250,2276,2318,-28,14,184,426.64,398
,20160401,2276,2318,2278,2336,2278,2328,2314,10,-4,62,143.57,398
,20160405,2328,2314,2260,2278,2204,2262,2232,-52,-82,186,415.18,288
,20160406,2262,2232,2254,2266,2254,2266,2260,34,28,4,9.04,286
,20160407,2266,2260,2252,2270,2252,2262,2262,2,2,10,22.63,284
,20160408,2262,2262,,,,2262,2262,0,0,0,0.00,284
,20160411,2262,2262,2318,2360,2312,2328,2340,66,78,154,360.63,268
,20160412,2328,2340,2340,2340,2340,2340,2340,0,0,52,121.68,268
,20160413,2340,2340,2364,2392,2356,2366,2376,26,36,182,432.66,346
,20160414,2366,2376,2392,2400,2350,2350,2382,-26,6,52,123.94,330
,20160415,2350,2382,2394,2396,2370,2370,2388,-12,6,28,66.89,346
,20160418,2370,2388,2330,2394,2298,2330,2318,-58,-70,402,932.01,376
,20160419,2330,2318,2368,2396,2348,2392,2386,74,68,132,315.06,392
,20160420,2392,2386,2398,2470,2384,2416,2426,30,40,90,218.50,418
,20160421,2416,2426,2446,2570,2406,2570,2508,144,82,200,501.79,386
,20160422,2570,2508,2552,2576,2450,2468,2484,-40,-24,170,422.32,356
,20160425,2468,2484,2464,2548,2452,2468,2480,-16,-4,208,516.16,366
,20160426,2468,2480,2494,2494,2452,2464,2478,-16,-2,68,168.58,368
,20160427,2464,2478,2452,2540,2452,2494,2494,16,16,88,219.61,360
,20160428,2494,2494,2518,2518,2462,2462,2506,-32,12,80,200.59,364
,20160429,2462,2506,2486,2488,2486,2488,2486,-18,-20,4,9.95,362
,20160503,2488,2486,,,,2462,2462,-24,-24,0,0.00,362
,20160504,2462,2462,2422,2444,2416,2420,2418,-42,-44,24,58.07,368
,20160505,2420,2418,2466,2466,2412,2412,2422,-6,4,50,121.14,386
,20160506,2412,2422,2430,2430,2366,2366,2382,-56,-40,32,76.27,386
,20160509,2366,2382,2380,2382,2318,2320,2338,-62,-44,28,65.48,382
,20160510,2320,2338,2342,2342,2300,2302,2304,-36,-34,36,82.97,378
,20160511,2302,2304,2328,2350,2328,2348,2340,44,36,32,74.91,394
,20160512,2348,2340,2348,2404,2348,2396,2388,56,48,68,162.48,392
,20160513,2396,2388,2416,2420,2372,2372,2400,-16,12,28,67.22,386
,20160516,2372,2400,2366,2416,2364,2410,2398,10,-2,32,76.75,396
,20160517,2410,2398,2442,2442,2420,2424,2428,26,30,16,38.86,396
,20160518,2424,2428,2416,2438,2394,2404,2416,-24,-12,32,77.35,402
,20160519,2404,2416,2404,2426,2364,2364,2394,-52,-22,78,186.75,386
,20160520,2364,2394,2346,2378,2342,2368,2364,-26,-30,30,70.96,386
,20160523,2368,2364,2360,2360,2228,2258,2296,-106,-68,80,183.82,370
,20160524,2258,2296,2254,2274,2236,2236,2256,-60,-40,88,198.59,382
,20160525,2236,2256,2256,2276,2236,2276,2256,20,0,170,383.58,390
,20160526,2276,2256,2288,2318,2258,2274,2280,18,24,94,214.38,404
,20160527,2274,2280,2260,2262,2224,2226,2244,-54,-36,60,134.64,410
,20160530,2226,2244,2228,2248,2208,2232,2222,-12,-22,54,120.05,418
,20160531,2232,2222,2254,2258,2230,2230,2248,8,26,18,40.49,428
,20160601,2230,2248,2244,2254,2202,2208,2230,-40,-18,24,53.54,438
,20160602,2208,2230,2216,2216,2196,2206,2210,-24,-20,122,269.70,422
,20160603,2206,2210,2204,2228,2192,2226,2206,16,-4,40,88.31,440
,20160606,2226,2206,2236,2272,2208,2260,2244,54,38,82,184.05,422
,20160607,2260,2244,2270,2274,2242,2262,2266,18,22,50,113.34,408
,20160608,2262,2266,2280,2288,2260,2272,2274,6,8,34,77.36,408
,20160613,2272,2274,2236,2286,2236,2270,2268,-4,-6,40,90.74,410
,20160614,2270,2268,2298,2318,2276,2300,2302,32,34,152,349.96,472
,20160615,2300,2302,2308,2308,2268,2300,2284,-2,-18,38,86.82,486
,20160616,2300,2284,2288,2298,2284,2296,2290,12,6,52,119.12,516
,20160617,2296,2290,2286,2296,2256,2296,2274,6,-16,58,131.92,544
,20160620,2296,2274,2318,2358,2296,2358,2332,84,58,128,298.52,614
,20160621,2358,2332,2358,2382,2344,2372,2366,40,34,190,449.88,706
,20160622,2372,2366,2360,2410,2356,2356,2378,-10,12,76,180.76,718
,20160623,2356,2378,2402,2410,2386,2390,2400,12,22,48,115.21,744
,20160624,2390,2400,2408,2434,2366,2384,2410,-16,10,136,327.80,760
,20160627,2384,2410,2394,2416,2380,2402,2394,-8,-16,50,119.72,756
,20160628,2402,2394,2418,2422,2384,2420,2406,26,12,62,149.24,756
,20160629,2420,2406,2428,2468,2420,2468,2440,62,34,122,297.70,736
,20160630,2468,2440,2452,2550,2452,2514,2506,74,66,112,280.69,736
,20160701,2514,2506,2522,2536,2500,2504,2518,-2,12,36,90.72,744
,20160704,2504,2518,2530,2598,2524,2598,2558,80,40,84,214.92,738
,20160705,2598,2558,2612,2612,2516,2528,2540,-30,-18,174,442.24,678
,20160706,2528,2540,2546,2570,2390,2450,2484,-90,-56,224,556.70,636
,20160707,2450,2484,2460,2494,2450,2468,2466,-16,-18,84,207.28,634
,20160708,2468,2466,2442,2452,2404,2408,2418,-58,-48,102,246.68,632
,20160711,2408,2418,2404,2420,2398,2420,2404,2,-14,30,72.15,634
,20160712,2420,2404,2458,2464,2436,2462,2452,58,48,26,63.79,640
,20160713,2462,2452,2474,2500,2472,2474,2488,22,36,56,139.35,672
,20160714,2474,2488,2462,2524,2460,2520,2504,32,16,76,190.34,662
,20160715,2520,2504,2518,2528,2500,2500,2516,-4,12,22,55.38,660
,20160718,2500,2516,2548,2548,2454,2454,2482,-62,-34,38,94.37,660
,20160719,2454,2482,2440,2450,2420,2424,2434,-58,-48,34,82.80,670
,20160720,2424,2434,2438,2450,2432,2450,2440,16,6,10,24.41,668
,20160721,2450,2440,2448,2462,2428,2462,2446,22,6,6,14.68,668
,20160722,2462,2446,2448,2448,2430,2430,2442,-16,-4,14,34.20,662
,20160725,2430,2442,2410,2456,2390,2422,2416,-20,-26,44,106.37,674
,20160726,2422,2416,2418,2458,2382,2410,2412,-6,-4,98,236.53,664
,20160727,2410,2412,2392,2458,2382,2388,2402,-24,-10,142,341.08,668
,20160728,2388,2402,2400,2410,2388,2396,2396,-6,-6,36,86.30,666
,20160729,2396,2396,2386,2426,2320,2320,2374,-76,-22,350,831.59,612
,20160801,2320,2374,2332,2338,2298,2328,2310,-46,-64,274,633.01,626
,20160802,2328,2310,2324,2324,2312,2316,2312,6,2,28,64.77,616
,20160803,2316,2312,2350,2350,2320,2324,2340,12,28,50,117.06,616
,20160804,2324,2340,2334,2342,2310,2314,2322,-26,-18,76,176.52,626
,20160805,2314,2322,2308,2344,2308,2328,2330,6,8,100,233.01,650
,20160808,2328,2330,2326,2360,2318,2360,2334,30,4,84,196.15,686
,20160809,2360,2334,2368,2370,2336,2352,2354,18,20,86,202.54,698
,20160810,2352,2354,2366,2378,2344,2352,2366,-2,12,36,85.18,724
,20160811,2352,2366,2342,2354,2342,2354,2344,-12,-22,18,42.22,720
,20160812,2354,2344,2364,2392,2360,2392,2372,48,28,26,61.70,734
,20160815,2392,2372,2378,2388,2366,2372,2378,0,6,16,38.07,738
,20160816,2372,2378,2370,2378,2362,2378,2370,0,-8,26,61.64,756
,20160817,2378,2370,2356,2358,2356,2358,2356,-12,-14,16,37.70,748
,20160818,2358,2356,2360,2368,2340,2346,2356,-10,0,78,183.82,756
,20160819,2346,2356,2348,2354,2330,2336,2342,-20,-14,30,70.26,758
,20160822,2336,2342,2336,2336,2308,2308,2324,-34,-18,14,32.54,760
,20160823,2308,2324,2348,2348,2280,2280,2296,-44,-28,76,174.63,750
,20160824,2280,2296,2296,2310,2280,2280,2286,-16,-10,66,150.99,730
,20160825,2280,2286,2294,2294,2220,2224,2246,-62,-40,70,157.25,714
,20160826,2224,2246,2238,2254,2224,2254,2240,8,-6,26,58.24,722
,20160829,2254,2240,2256,2278,2256,2256,2266,16,26,72,163.16,742
,20160830,2256,2266,2256,2266,2230,2230,2242,-36,-24,56,125.59,758
,20160831,2230,2242,2240,2240,2198,2220,2214,-22,-28,52,115.16,788
,20160901,2220,2214,2232,2242,2224,2234,2228,20,14,20,44.58,780
,20160902,2234,2228,2230,2234,2224,2224,2228,-4,0,16,35.68,776
,20160905,2224,2228,2230,2248,2230,2248,2236,20,8,8,17.90,776
,20160906,2248,2236,2234,2276,2234,2276,2260,40,24,24,54.26,778
,20160907,2276,2260,2274,2274,2250,2250,2260,-10,0,24,54.26,786
,20160908,2250,2260,2256,2272,2244,2270,2258,10,-2,82,185.28,800
,20160909,2270,2258,2270,2270,2270,2270,2270,12,12,2,4.54,802
,20160912,2270,2270,2250,2260,2190,2196,2218,-74,-52,100,221.94,808
,20160913,2196,2218,2190,2214,2190,2194,2202,-24,-16,66,145.42,826
,20160914,2194,2202,2212,2212,2190,2190,2198,-12,-4,46,101.16,834
,20160919,2190,2198,2212,2236,2212,2234,2230,36,32,120,267.65,832
,20160920,2234,2230,2238,2252,2234,2240,2240,10,10,204,457.10,878
,20160921,2240,2240,2244,2256,2220,2220,2238,-20,-2,154,344.82,874
,20160922,2220,2238,2228,2246,2220,2222,2228,-16,-10,100,222.96,884
,20160923,2222,2228,2238,2238,2202,2218,2216,-10,-12,98,217.17,898
,20160926,2218,2216,2218,2220,2208,2210,2214,-6,-2,110,243.64,868
,20160927,2210,2214,2210,2218,2190,2192,2204,-22,-10,146,321.92,932
,20160928,2192,2204,2182,2182,2082,2094,2128,-110,-76,360,766.40,960
,20160929,2094,2128,2094,2100,2056,2082,2080,-46,-48,388,807.08,866
,20160930,2082,2080,2090,2094,2050,2078,2078,-2,-2,64,133.04,872
,20161010,2078,2078,2088,2118,2068,2076,2082,-2,4,122,254.18,840
,20161011,2076,2082,2096,2156,2092,2132,2134,50,52,372,794.46,830
,20161012,2132,2134,2126,2140,2112,2114,2126,-20,-8,132,280.67,846
,20161013,2114,2126,2126,2136,2118,2126,2126,0,0,58,123.33,852
,20161014,2126,2126,2124,2134,2104,2112,2118,-14,-8,174,368.57,860
,20161017,2112,2118,2140,2178,2128,2178,2154,60,36,142,306.00,864
,20161018,2178,2154,2174,2174,2154,2170,2162,16,8,204,441.33,880
,20161019,2170,2162,2182,2188,2170,2188,2180,26,18,154,335.78,912
,20161020,2188,2180,2212,2238,2202,2234,2224,54,44,150,333.73,880
,20161021,2234,2224,2212,2228,2200,2216,2210,-8,-14,116,256.41,920
,20161024,2216,2210,2204,2238,2204,2228,2226,18,16,160,356.27,942
,20161025,2228,2226,2242,2242,2210,2218,2222,-8,-4,142,315.76,954
,20161026,2218,2222,2220,2222,2180,2198,2202,-24,-20,208,458.03,970
,20161027,2198,2202,2202,2230,2194,2210,2210,8,8,128,283.00,958
,20161028,2210,2210,2234,2242,2228,2242,2234,32,24,56,125.12,984
,20161031,2242,2234,2250,2250,2214,2244,2228,10,-6,126,280.81,988
,20161101,2244,2228,2220,2272,2218,2260,2248,32,20,108,242.95,990
,20161102,2260,2248,2270,2308,2234,2236,2256,-12,8,312,704.02,1064
,20161103,2236,2256,2230,2248,2212,2232,2230,-24,-26,148,330.26,1104
,20161104,2232,2230,2248,2260,2200,2200,2224,-30,-6,300,667.64,1134
,20161107,2200,2224,2200,2250,2200,2226,2220,2,-4,86,191.09,1140
,20161108,2226,2220,2236,2270,2232,2242,2258,22,38,116,262.04,1162
,20161109,2242,2258,2266,2306,2266,2270,2282,12,24,90,205.49,1156
,20161110,2270,2282,2306,2386,2302,2386,2328,104,46,200,465.79,1128
,20161111,2386,2328,2366,2458,2362,2452,2420,124,92,366,886.13,1098
,20161114,2452,2420,2472,2490,2280,2298,2356,-122,-64,678,"1,598.66",1110
,20161115,2298,2356,2298,2348,2286,2334,2320,-22,-36,242,561.80,1098
,20161116,2334,2320,2352,2400,2352,2394,2370,74,50,160,379.38,1106
,20161117,2394,2370,2380,2398,2364,2386,2380,16,10,72,171.38,1102
,20161118,2386,2380,2414,2420,2362,2370,2386,-10,6,480,"1,145.59",1342
,20161121,2370,2386,2382,2462,2360,2454,2406,68,20,294,707.62,1342
,20161122,2454,2406,2450,2524,2450,2496,2488,90,82,354,881.02,1278
,20161123,2496,2488,2494,2556,2470,2518,2524,30,36,494,"1,247.46",1312
,20161124,2518,2524,2518,2524,2460,2510,2506,-14,-18,216,541.51,1272
,20161125,2510,2506,2520,2538,2468,2482,2494,-24,-12,150,374.20,1288
,20161128,2482,2494,2476,2534,2470,2526,2492,32,-2,140,348.99,1264
,20161129,2526,2492,2546,2550,2486,2502,2518,10,26,148,372.76,1272
,20161130,2502,2518,2486,2490,2400,2442,2458,-76,-60,314,772.26,1274
,20161201,2442,2458,2460,2568,2460,2542,2534,84,76,306,775.72,1276
,20161202,2542,2534,2566,2566,2508,2528,2530,-6,-4,94,237.96,1268
,20161205,2528,2530,2532,2650,2532,2624,2598,94,68,232,603.14,1308
,20161206,2624,2598,2648,2660,2604,2630,2646,32,48,290,767.69,1356
,20161207,2630,2646,2624,2700,2618,2680,2674,34,28,400,"1,069.97",1548
,20161208,2680,2674,2694,2700,2620,2620,2660,-54,-14,178,473.75,1524
,20161209,2620,2660,2660,2750,2646,2734,2706,74,46,258,698.39,1550
,20161212,2734,2706,2732,2814,2700,2784,2752,78,46,228,627.83,1614
,20161213,2784,2752,2778,2794,2756,2786,2780,34,28,144,400.48,1606
,20161214,2786,2780,2800,2846,2754,2778,2776,-2,-4,310,860.95,1556
,20161215,2778,2776,2766,2766,2720,2742,2746,-34,-30,558,"1,532.58",1702
,20161216,2742,2746,2738,2760,2720,2722,2740,-24,-6,924,"2,532.52",2228
,20161219,2722,2740,2730,2820,2722,2780,2770,40,30,632,"1,751.68",2494
,20161220,2780,2770,2782,2834,2750,2768,2794,-2,24,736,"2,056.46",2672
,20161221,2768,2794,2760,2808,2760,2784,2784,-10,-10,232,646.18,2676
,20161222,2784,2784,2766,2774,2710,2710,2746,-74,-38,358,983.72,2640
,20161223,2710,2746,2706,2720,2666,2694,2692,-52,-54,616,"1,658.33",2748
,20161226,2694,2692,2692,2744,2662,2708,2688,16,-4,1908,"5,132.19",2502
,20161227,2708,2688,2714,2860,2686,2850,2750,162,62,742,"2,041.90",2368
,20161228,2850,2750,2880,2942,2848,2942,2922,192,172,1370,"4,004.68",2844
,20161229,2942,2922,2920,2954,2876,2942,2916,20,-6,1446,"4,216.78",2846
,20161230,2942,2916,2946,2948,2878,2906,2900,-10,-16,1372,"3,979.69",2980
bu1803,20160316,2210,2210,2110,2328,2108,2226,2248,16,38,18,40.48,0
,20160317,2226,2248,,,,2248,2248,0,0,0,0.00,0
,20160318,2248,2248,,,,2272,2272,24,24,0,0.00,0
,20160321,2272,2272,,,,2302,2302,30,30,0,0.00,0
,20160322,2302,2302,,,,2304,2304,2,2,0,0.00,0
,20160323,2304,2304,,,,2312,2312,8,8,0,0.00,0
,20160324,2312,2312,,,,2312,2312,0,0,0,0.00,0
,20160325,2312,2312,2224,2328,2224,2320,2294,8,-18,16,36.70,4
,20160328,2320,2294,,,,2320,2320,26,26,0,0.00,4
,20160329,2320,2320,,,,2320,2320,0,0,0,0.00,4
,20160330,2320,2320,2342,2342,2342,2342,2342,22,22,2,4.68,4
,20160331,2342,2342,2358,2358,2350,2350,2352,8,10,6,14.12,8
,20160401,2350,2352,2352,2390,2352,2390,2366,38,14,10,23.67,14
,20160405,2390,2366,2294,2318,2240,2318,2274,-48,-92,214,486.64,16
,20160406,2318,2274,,,,2274,2274,0,0,0,0.00,16
,20160407,2274,2274,,,,2274,2274,0,0,0,0.00,16
,20160408,2274,2274,,,,2274,2274,0,0,0,0.00,16
,20160411,2274,2274,2308,2380,2308,2380,2356,106,82,16,37.72,26
,20160412,2380,2356,2380,2380,2370,2370,2374,14,18,4,9.50,28
,20160413,2370,2374,2408,2464,2376,2392,2410,18,36,22,53.03,28
,20160414,2392,2410,2424,2448,2388,2388,2412,-22,2,12,28.96,32
,20160415,2388,2412,2432,2432,2432,2432,2432,20,20,2,4.86,32
,20160418,2432,2432,2356,2392,2356,2392,2362,-40,-70,26,61.46,24
,20160419,2392,2362,2458,2474,2410,2410,2430,48,68,12,29.17,22
,20160420,2410,2430,2424,2508,2420,2508,2468,78,38,16,39.50,28
,20160421,2508,2468,2468,2616,2468,2616,2552,148,84,18,45.95,30
,20160422,2616,2552,2524,2578,2524,2524,2532,-28,-20,14,35.47,26
,20160425,2524,2532,2512,2570,2510,2520,2528,-12,-4,14,35.40,20
,20160426,2520,2528,,,,2524,2524,-4,-4,0,0.00,20
,20160427,2524,2524,2526,2526,2518,2518,2522,-6,-2,4,10.09,20
,20160428,2518,2522,2540,2546,2540,2546,2542,24,20,4,10.17,24
,20160429,2546,2542,,,,2542,2542,0,0,0,0.00,24
,20160503,2542,2542,2498,2498,2498,2498,2498,-44,-44,2,5.00,24
,20160504,2498,2498,2506,2506,2454,2504,2480,6,-18,8,19.85,24
,20160505,2504,2480,,,,2480,2480,0,0,0,0.00,24
,20160506,2480,2480,2400,2438,2400,2438,2418,-42,-62,4,9.68,22
,20160509,2438,2418,2424,2448,2362,2378,2390,-40,-28,34,81.28,36
,20160510,2378,2390,2326,2380,2326,2330,2342,-60,-48,42,98.36,62
,20160511,2330,2342,2346,2380,2346,2378,2372,36,30,24,56.97,70
,20160512,2378,2372,2398,2418,2382,2390,2398,18,26,20,47.96,74
,20160513,2390,2398,2384,2426,2376,2396,2400,-2,2,12,28.81,68
,20160516,2396,2400,2394,2396,2394,2396,2394,-4,-6,8,19.16,60
,20160517,2396,2394,2444,2470,2442,2444,2448,50,54,10,24.49,68
,20160518,2444,2448,2442,2458,2400,2410,2432,-38,-16,20,48.66,64
,20160519,2410,2432,2428,2428,2428,2428,2428,-4,-4,2,4.86,62
,20160520,2428,2428,2372,2372,2370,2370,2370,-58,-58,4,9.48,60
,20160523,2370,2370,2370,2370,2226,2276,2292,-94,-78,22,50.46,60
,20160524,2276,2292,2252,2260,2196,2200,2206,-92,-86,84,185.40,130
,20160525,2200,2206,2248,2258,2222,2248,2240,42,34,50,112.06,134
,20160526,2248,2240,2294,2320,2194,2268,2254,28,14,254,572.76,196
,20160527,2268,2254,2276,2276,2214,2226,2240,-28,-14,94,210.67,224
,20160530,2226,2240,2200,2232,2160,2230,2200,-10,-40,88,193.72,262
,20160531,2230,2200,2248,2258,2248,2258,2252,58,52,4,9.01,266
,20160601,2258,2252,2232,2232,2208,2210,2216,-42,-36,24,53.21,264
,20160602,2210,2216,2192,2226,2192,2226,2212,10,-4,16,35.42,270
,20160603,2226,2212,2226,2226,2220,2220,2222,8,10,4,8.89,272
,20160606,2220,2222,2264,2334,2220,2270,2262,48,40,50,113.17,272
,20160607,2270,2262,2282,2368,2268,2268,2302,6,40,66,151.96,254
,20160608,2268,2302,2290,2302,2280,2290,2288,-12,-14,24,54.94,260
,20160613,2290,2288,2250,2304,2240,2304,2262,16,-26,38,86.00,250
,20160614,2304,2262,2308,2330,2294,2302,2314,40,52,56,129.64,258
,20160615,2302,2314,2322,2326,2292,2296,2304,-18,-10,14,32.28,252
,20160616,2296,2304,2304,2304,2294,2298,2298,-6,-6,18,41.38,252
,20160617,2298,2298,2296,2298,2268,2288,2282,-10,-16,32,73.08,258
,20160620,2288,2282,2304,2338,2304,2338,2324,56,42,20,46.50,260
,20160621,2338,2324,2362,2386,2360,2380,2372,56,48,64,151.86,266
,20160622,2380,2372,2372,2426,2372,2406,2400,34,28,42,100.87,268
,20160623,2406,2400,2420,2420,2418,2418,2418,18,18,4,9.68,264
,20160624,2418,2418,2442,2456,2400,2416,2442,-2,24,104,254.02,198
,20160627,2416,2442,2416,2442,2404,2442,2416,0,-26,32,77.32,194
,20160628,2442,2416,2420,2448,2416,2442,2434,26,18,32,77.91,186
,20160629,2442,2434,2458,2498,2448,2498,2470,64,36,68,167.97,176
,20160630,2498,2470,2486,2580,2486,2542,2552,72,82,114,290.95,106
,20160701,2542,2552,2544,2566,2540,2540,2548,-12,-4,12,30.58,102
,20160704,2540,2548,2552,2640,2552,2630,2610,82,62,28,73.10,110
,20160705,2630,2610,2632,2634,2562,2562,2584,-48,-26,26,67.19,110
,20160706,2562,2584,2566,2578,2480,2500,2534,-84,-50,30,76.03,96
,20160707,2500,2534,2502,2520,2502,2520,2510,-14,-24,10,25.10,96
,20160708,2520,2510,2480,2480,2452,2452,2458,-58,-52,14,34.42,90
,20160711,2452,2458,2464,2464,2452,2452,2458,-6,0,4,9.83,90
,20160712,2452,2458,2482,2536,2482,2536,2506,78,48,10,25.07,90
,20160713,2536,2506,2538,2540,2502,2510,2522,4,16,24,60.55,84
,20160714,2510,2522,2516,2560,2510,2560,2530,38,8,10,25.30,84
,20160715,2560,2530,2530,2550,2522,2522,2540,-8,10,24,61.00,84
,20160718,2522,2540,2508,2508,2502,2502,2504,-38,-36,4,10.02,86
,20160719,2502,2504,2468,2468,2468,2468,2468,-36,-36,2,4.94,86
,20160720,2468,2468,2486,2486,2486,2486,2486,18,18,2,4.97,86
,20160721,2486,2486,2482,2516,2482,2516,2498,30,12,8,19.99,88
,20160722,2516,2498,2490,2490,2490,2490,2490,-8,-8,2,4.98,90
,20160725,2490,2490,2462,2490,2452,2452,2474,-38,-16,14,34.65,84
,20160726,2452,2474,2488,2488,2460,2466,2470,-8,-4,8,19.77,84
,20160727,2466,2470,2456,2474,2454,2458,2460,-12,-10,8,19.68,86
,20160728,2458,2460,2464,2472,2454,2472,2464,12,4,16,39.43,92
,20160729,2472,2464,2450,2450,2384,2384,2414,-80,-50,20,48.30,86
,20160801,2384,2414,2392,2420,2370,2420,2392,6,-22,8,19.14,82
,20160802,2420,2392,2410,2410,2410,2410,2410,18,18,2,4.82,82
,20160803,2410,2410,2428,2428,2400,2400,2404,-10,-6,12,28.86,76
,20160804,2400,2404,2416,2416,2392,2392,2408,-12,4,8,19.27,70
,20160805,2392,2408,,,,2408,2408,0,0,0,0.00,70
,20160808,2408,2408,2420,2430,2420,2430,2424,22,16,4,9.70,70
,20160809,2430,2424,,,,2424,2424,0,0,0,0.00,70
,20160810,2424,2424,2446,2446,2444,2444,2444,20,20,6,14.67,72
,20160811,2444,2444,,,,2444,2444,0,0,0,0.00,72
,20160812,2444,2444,2448,2448,2444,2444,2446,0,2,4,9.78,72
,20160815,2444,2446,2462,2462,2444,2444,2452,-2,6,8,19.63,74
,20160816,2444,2452,2446,2446,2446,2446,2446,-6,-6,4,9.78,74
,20160817,2446,2446,2446,2446,2420,2420,2430,-26,-16,22,53.50,68
,20160818,2420,2430,2428,2428,2400,2400,2410,-30,-20,10,24.12,64
,20160819,2400,2410,2408,2408,2396,2396,2402,-14,-8,6,14.42,62
,20160822,2396,2402,2388,2390,2368,2368,2382,-34,-20,12,28.58,66
,20160823,2368,2382,2362,2362,2334,2334,2344,-48,-38,8,18.75,70
,20160824,2334,2344,2338,2350,2338,2350,2342,6,-2,6,14.05,66
,20160825,2350,2342,2348,2348,2296,2300,2312,-42,-30,10,23.12,62
,20160826,2300,2312,2312,2324,2312,2324,2318,12,6,4,9.27,60
,20160829,2324,2318,2332,2332,2332,2332,2332,14,14,2,4.66,60
,20160830,2332,2332,2322,2330,2310,2310,2322,-22,-10,8,18.58,62
,20160831,2310,2322,2306,2306,2294,2294,2298,-28,-24,18,41.36,60
,20160901,2294,2298,,,,2306,2306,8,8,0,0.00,60
,20160902,2306,2306,2316,2316,2316,2316,2316,10,10,2,4.63,60
,20160905,2316,2316,2316,2316,2316,2316,2316,0,0,2,4.63,62
,20160906,2316,2316,2362,2362,2346,2346,2352,30,36,6,14.12,62
,20160907,2346,2352,2328,2328,2326,2326,2326,-26,-26,6,13.96,64
,20160908,2326,2326,2328,2328,2318,2322,2322,-4,-4,10,23.22,70
,20160909,2322,2322,2326,2326,2326,2326,2326,4,4,2,4.65,72
,20160912,2326,2326,2312,2316,2264,2280,2286,-46,-40,40,91.50,78
,20160913,2280,2286,2258,2276,2258,2276,2270,-10,-16,8,18.17,78
,20160914,2276,2270,,,,2270,2270,0,0,0,0.00,78
,20160919,2270,2270,2272,2286,2272,2286,2278,16,8,4,9.12,76
,20160920,2286,2278,2302,2302,2302,2302,2302,24,24,2,4.60,78
,20160921,2302,2302,,,,2302,2302,0,0,0,0.00,78
,20160922,2302,2302,2296,2296,2296,2296,2296,-6,-6,2,4.59,80
,20160923,2296,2296,2286,2296,2286,2296,2290,0,-6,4,9.16,84
,20160926,2296,2290,2284,2284,2278,2284,2282,-6,-8,6,13.69,84
,20160927,2284,2282,2264,2272,2264,2272,2268,-10,-14,4,9.07,86
,20160928,2272,2268,2254,2254,2170,2178,2186,-90,-82,24,52.50,84
,20160929,2178,2186,2190,2190,2152,2172,2172,-14,-14,18,39.10,82
,20160930,2172,2172,2182,2182,2152,2152,2172,-20,0,10,21.74,82
,20161010,2152,2172,2176,2176,2176,2176,2176,4,4,2,4.35,80
,20161011,2176,2176,2208,2246,2208,2224,2232,48,56,12,26.80,82
,20161012,2224,2232,2230,2230,2216,2216,2220,-16,-12,10,22.21,80
,20161013,2216,2220,2220,2220,2220,2220,2220,0,0,2,4.44,82
,20161014,2220,2220,,,,2210,2210,-10,-10,0,0.00,82
,20161017,2210,2210,2234,2234,2234,2234,2234,24,24,8,17.87,90
,20161018,2234,2234,2266,2266,2242,2242,2254,8,20,6,13.52,88
,20161019,2242,2254,2254,2260,2250,2250,2254,-4,0,10,22.54,84
,20161020,2250,2254,2276,2320,2272,2302,2300,48,46,26,59.80,80
,20161021,2302,2300,2296,2306,2296,2306,2300,6,0,4,9.20,78
,20161024,2306,2300,2314,2324,2314,2322,2320,22,20,12,27.84,72
,20161025,2322,2320,2310,2322,2310,2322,2318,2,-2,8,18.55,70
,20161026,2322,2318,2282,2292,2280,2290,2286,-28,-32,24,54.90,72
,20161027,2290,2286,,,,2292,2292,6,6,0,0.00,72
,20161028,2292,2292,2316,2320,2316,2316,2316,24,24,8,18.54,64
,20161031,2316,2316,2306,2324,2298,2324,2314,8,-2,14,32.40,64
,20161101,2324,2314,2308,2346,2308,2346,2324,32,10,12,27.90,62
,20161102,2346,2324,2376,2386,2332,2332,2358,8,34,10,23.60,60
,20161103,2332,2358,,,,2326,2326,-32,-32,0,0.00,60
,20161104,2326,2326,2310,2316,2290,2290,2302,-36,-24,22,50.65,64
,20161107,2290,2302,2312,2314,2310,2310,2310,8,8,8,18.49,66
,20161108,2310,2310,2346,2356,2330,2346,2344,36,34,10,23.44,64
,20161109,2346,2344,2400,2400,2370,2370,2388,26,44,6,14.33,62
,20161110,2370,2388,2426,2492,2420,2420,2442,32,54,58,141.69,62
,20161111,2420,2442,2490,2548,2452,2548,2488,106,46,388,965.95,56
,20161114,2548,2488,2532,2576,2382,2382,2508,-106,20,32,80.31,54
,20161115,2382,2508,2402,2434,2384,2418,2408,-90,-100,20,48.18,60
,20161116,2418,2408,2468,2492,2468,2478,2476,70,68,12,29.73,58
,20161117,2478,2476,2474,2546,2474,2500,2504,24,28,14,35.07,62
,20161118,2500,2504,2514,2514,2474,2474,2492,-30,-12,12,29.92,64
,20161121,2474,2492,2474,2570,2474,2570,2512,78,20,6,15.08,62
,20161122,2570,2512,2586,2598,2586,2586,2590,74,78,10,25.92,56
,20161123,2586,2590,2600,2628,2600,2620,2610,30,20,22,57.45,70
,20161124,2620,2610,2616,2616,2572,2590,2586,-20,-24,20,51.75,58
,20161125,2590,2586,2572,2608,2552,2552,2578,-34,-8,16,41.27,56
,20161128,2552,2578,2562,2644,2558,2644,2580,66,2,14,36.14,50
,20161129,2644,2580,2618,2620,2618,2620,2618,40,38,4,10.48,46
,20161130,2620,2618,2552,2552,2482,2510,2520,-108,-98,14,35.30,48
,20161201,2510,2520,2640,2650,2616,2650,2634,130,114,10,26.36,44
,20161202,2650,2634,2626,2626,2614,2614,2622,-20,-12,8,20.98,46
,20161205,2614,2622,2634,2708,2634,2708,2670,86,48,4,10.68,44
,20161206,2708,2670,2740,2740,2684,2724,2716,54,46,8,21.73,44
,20161207,2724,2716,2714,2768,2714,2768,2748,52,32,18,49.47,46
,20161208,2768,2748,,,,2748,2748,0,0,0,0.00,46
,20161209,2748,2748,2782,2818,2782,2802,2804,54,56,10,28.05,44
,20161212,2802,2804,2880,2906,2874,2906,2888,102,84,8,23.11,44
,20161213,2906,2888,2894,2894,2868,2868,2882,-20,-6,6,17.30,46
,20161214,2868,2882,2888,2888,2888,2888,2888,6,6,4,11.55,48
,20161215,2888,2888,2848,2884,2822,2838,2848,-50,-40,12,34.19,44
,20161216,2838,2848,2826,2864,2826,2826,2838,-22,-10,20,56.80,48
,20161219,2826,2838,2830,2900,2830,2900,2868,62,30,8,22.96,46
,20161220,2900,2868,2884,2884,2832,2832,2864,-36,-4,14,40.12,54
,20161221,2832,2864,2888,2888,2856,2856,2868,-8,4,10,28.68,58
,20161222,2856,2868,,,,2868,2868,0,0,0,0.00,58
,20161223,2868,2868,2756,2798,2742,2772,2768,-96,-100,28,77.53,66
,20161226,2772,2768,2766,2770,2702,2770,2740,2,-28,38,104.15,56
,20161227,2770,2740,2752,2904,2752,2904,2806,164,66,32,89.83,52
,20161228,2904,2806,2924,2996,2924,2996,2978,190,172,44,131.06,70
,20161229,2996,2978,2904,2984,2904,2984,2954,6,-24,22,65.00,66
,20161230,2984,2954,2974,2978,2948,2952,2962,-2,8,30,88.91,54
bu1806,20160616,2304,2304,2320,2350,2290,2306,2306,2,2,40,92.30,32
,20160617,2306,2306,2288,2320,2270,2290,2284,-16,-22,24,54.84,48
,20160620,2290,2284,2296,2376,2296,2376,2332,92,48,36,83.96,60
,20160621,2376,2332,2372,2408,2362,2392,2386,60,54,58,138.48,82
,20160622,2392,2386,2382,2432,2382,2432,2406,46,20,56,134.75,102
,20160623,2432,2406,2430,2452,2422,2444,2436,38,30,46,112.07,112
,20160624,2444,2436,2444,2478,2430,2430,2460,-6,24,58,142.73,134
,20160627,2430,2460,2470,2480,2454,2472,2470,12,10,16,39.54,132
,20160628,2472,2470,2498,2502,2404,2458,2470,-12,0,60,148.27,140
,20160629,2458,2470,2502,2550,2490,2512,2510,42,40,58,145.69,154
,20160630,2512,2510,2534,2598,2520,2586,2556,76,46,100,255.68,176
,20160701,2586,2556,2600,2614,2564,2588,2594,32,38,38,98.60,186
,20160704,2588,2594,2620,2696,2616,2680,2660,86,66,72,191.64,168
,20160705,2680,2660,2670,2696,2606,2620,2636,-40,-24,42,110.77,176
,20160706,2620,2636,2582,2648,2532,2566,2594,-70,-42,46,119.40,166
,20160707,2566,2594,2580,2598,2540,2594,2584,0,-10,32,82.70,162
,20160708,2594,2584,2594,2594,2542,2542,2562,-42,-22,20,51.26,152
,20160711,2542,2562,2532,2550,2532,2546,2544,-16,-18,26,66.18,146
,20160712,2546,2544,2572,2596,2558,2596,2576,52,32,38,97.94,152
,20160713,2596,2576,2648,2648,2600,2618,2612,42,36,20,52.27,158
,20160714,2618,2612,2620,2652,2550,2648,2622,36,10,106,278.10,186
,20160715,2648,2622,2632,2632,2578,2620,2606,-2,-16,70,182.52,172
,20160718,2620,2606,2610,2616,2562,2562,2584,-44,-22,50,129.28,160
,20160719,2562,2584,2548,2604,2544,2550,2564,-34,-20,24,61.55,160
,20160720,2550,2564,,,,2564,2564,0,0,0,0.00,160
,20160721,2564,2564,2572,2596,2572,2586,2584,22,20,22,56.86,170
,20160722,2586,2584,2602,2618,2560,2574,2584,-10,0,42,108.58,168
,20160725,2574,2584,2562,2568,2530,2554,2552,-30,-32,40,102.09,162
,20160726,2554,2552,2544,2580,2536,2536,2558,-16,6,28,71.68,174
,20160727,2536,2558,2538,2550,2522,2522,2536,-36,-22,6,15.22,176
,20160728,2522,2536,2578,2578,2542,2556,2554,20,18,14,35.77,178
,20160729,2556,2554,2560,2570,2478,2478,2512,-76,-42,74,185.96,116
,20160801,2478,2512,2470,2494,2462,2486,2478,-26,-34,22,54.55,108
,20160802,2486,2478,2488,2488,2476,2488,2484,10,6,16,39.74,112
,20160803,2488,2484,2508,2516,2472,2490,2496,6,12,50,124.82,120
,20160804,2490,2496,2484,2498,2476,2476,2482,-20,-14,24,59.58,104
,20160805,2476,2482,2490,2490,2472,2488,2480,6,-2,14,34.73,110
,20160808,2488,2480,2480,2510,2480,2510,2492,30,12,10,24.93,110
,20160809,2510,2492,,,,2500,2500,8,8,0,0.00,110
,20160810,2500,2500,2510,2524,2510,2524,2516,24,16,4,10.07,108
,20160811,2524,2516,2492,2496,2492,2496,2494,-20,-22,8,19.96,104
,20160812,2496,2494,2510,2516,2510,2516,2512,22,18,6,15.08,108
,20160815,2516,2512,2506,2526,2506,2518,2514,6,2,12,30.18,108
,20160816,2518,2514,2510,2510,2500,2500,2506,-14,-8,10,25.06,104
,20160817,2500,2506,2500,2500,2488,2488,2494,-18,-12,8,19.96,104
,20160818,2488,2494,2494,2494,2464,2472,2476,-22,-18,12,29.73,100
,20160819,2472,2476,2472,2474,2456,2470,2468,-6,-8,24,59.25,96
,20160822,2470,2468,2480,2480,2438,2456,2456,-12,-12,18,44.23,100
,20160823,2456,2456,2450,2450,2418,2418,2428,-38,-28,12,29.15,104
,20160824,2418,2428,2434,2434,2412,2412,2420,-16,-8,16,38.74,104
,20160825,2412,2420,2412,2430,2356,2374,2386,-46,-34,50,119.34,110
,20160826,2374,2386,2372,2390,2372,2386,2380,0,-6,18,42.85,114
,20160829,2386,2380,2414,2428,2400,2402,2412,22,32,18,43.44,106
,20160830,2402,2412,2404,2404,2358,2358,2364,-54,-48,68,160.77,154
,20160831,2358,2364,2338,2356,2330,2356,2338,-8,-26,40,93.56,170
,20160901,2356,2338,2362,2378,2340,2360,2362,22,24,36,85.04,182
,20160902,2360,2362,2374,2374,2332,2336,2350,-26,-12,52,122.30,206
,20160905,2336,2350,2344,2356,2336,2336,2342,-14,-8,28,65.59,218
,20160906,2336,2342,2358,2376,2348,2374,2366,32,24,54,127.86,254
,20160907,2374,2366,2344,2362,2340,2340,2354,-26,-12,30,70.64,272
,20160908,2340,2354,2354,2360,2334,2354,2350,0,-4,66,155.20,312
,20160909,2354,2350,2348,2348,2344,2344,2344,-6,-6,6,14.07,316
,20160912,2344,2344,2314,2350,2288,2290,2312,-54,-32,84,194.22,320
,20160913,2290,2312,2310,2322,2274,2296,2302,-16,-10,78,179.61,344
,20160914,2296,2302,2286,2316,2286,2296,2302,-6,0,36,82.88,346
,20160919,2296,2302,2320,2330,2316,2330,2326,28,24,30,69.80,356
,20160920,2330,2326,2320,2348,2320,2330,2330,4,4,30,69.95,382
,20160921,2330,2330,2330,2346,2330,2334,2336,4,6,12,28.03,390
,20160922,2334,2336,2342,2344,2312,2312,2338,-24,2,26,60.79,392
,20160923,2312,2338,2330,2330,2302,2322,2314,-16,-24,56,129.60,412
,20160926,2322,2314,2322,2328,2314,2328,2322,14,8,18,41.80,418
,20160927,2328,2322,2318,2324,2306,2310,2310,-12,-12,42,97.09,408
,20160928,2310,2310,2292,2304,2202,2216,2252,-94,-58,186,418.90,358
,20160929,2216,2252,2224,2230,2192,2208,2214,-44,-38,186,412.06,244
,20160930,2208,2214,2220,2226,2206,2206,2216,-8,2,34,75.37,236
,20161010,2206,2216,2228,2228,2220,2222,2224,6,8,10,22.24,234
,20161011,2222,2224,2230,2290,2230,2264,2266,40,42,110,249.26,292
,20161012,2264,2266,2258,2268,2230,2244,2252,-22,-14,40,90.10,294
,20161013,2244,2252,2250,2260,2232,2240,2246,-12,-6,88,197.82,314
,20161014,2240,2246,2252,2256,2238,2246,2248,0,2,20,44.97,320
,20161017,2246,2248,2256,2288,2256,2288,2276,40,28,134,305.17,406
,20161018,2288,2276,2290,2300,2278,2300,2284,24,8,54,123.36,442
,20161019,2300,2284,2310,2310,2298,2310,2304,26,20,124,285.74,498
,20161020,2310,2304,2314,2350,2314,2340,2334,36,30,128,298.97,594
,20161021,2340,2334,2340,2350,2328,2350,2336,16,2,150,350.64,626
,20161024,2350,2336,2346,2374,2346,2364,2360,28,24,134,316.47,646
,20161025,2364,2360,2364,2376,2350,2360,2360,0,0,134,316.36,668
,20161026,2360,2360,2350,2356,2324,2336,2334,-24,-26,122,284.92,652
,20161027,2336,2334,2350,2358,2328,2346,2342,12,8,82,192.15,664
,20161028,2346,2342,2358,2372,2352,2372,2366,30,24,70,165.76,714
,20161031,2372,2366,2352,2376,2352,2376,2358,10,-8,46,108.52,728
,20161101,2376,2358,2358,2400,2358,2394,2380,36,22,126,299.91,778
,20161102,2394,2380,2432,2438,2366,2366,2394,-14,14,66,158.13,784
,20161103,2366,2394,2360,2378,2356,2378,2364,-16,-30,12,28.38,786
,20161104,2378,2364,2380,2380,2330,2342,2356,-22,-8,86,202.70,810
,20161107,2342,2356,2340,2376,2340,2376,2354,20,-2,68,160.16,858
,20161108,2376,2354,2362,2404,2362,2398,2380,44,26,106,252.48,936
,20161109,2398,2380,2408,2446,2392,2418,2418,38,38,92,222.48,988
,20161110,2418,2418,2440,2538,2440,2538,2482,120,64,130,322.67,1012
,20161111,2538,2482,2512,2628,2508,2586,2568,104,86,200,513.99,1066
,20161114,2586,2568,2620,2626,2412,2452,2498,-116,-70,330,824.66,1050
,20161115,2452,2498,2460,2500,2432,2490,2476,-8,-22,178,440.76,1066
,20161116,2490,2476,2524,2538,2508,2538,2520,62,44,114,287.40,1026
,20161117,2538,2520,2522,2554,2496,2552,2534,32,14,118,299.08,1042
,20161118,2552,2534,2550,2550,2508,2516,2526,-18,-8,38,96.04,1040
,20161121,2516,2526,2512,2598,2506,2598,2556,72,30,74,189.28,1066
,20161122,2598,2556,2604,2660,2604,2634,2638,78,82,262,691.25,1172
,20161123,2634,2638,2626,2668,2610,2648,2642,10,4,158,417.65,1156
,20161124,2648,2642,2630,2650,2600,2626,2628,-16,-14,110,289.14,1154
,20161125,2626,2628,2652,2660,2600,2624,2622,-4,-6,154,404.01,1108
,20161128,2624,2622,2610,2666,2602,2666,2626,44,4,100,262.74,1088
,20161129,2666,2626,2680,2700,2630,2642,2664,16,38,106,282.50,1086
,20161130,2642,2664,2626,2640,2550,2580,2582,-84,-82,172,444.39,1132
,20161201,2580,2582,2620,2732,2620,2690,2682,108,100,148,397.05,1118
,20161202,2690,2682,2700,2702,2652,2680,2678,-2,-4,54,144.67,1120
,20161205,2680,2678,2696,2796,2680,2776,2756,98,78,178,490.70,1078
,20161206,2776,2756,2808,2848,2752,2792,2802,36,46,84,235.48,1076
,20161207,2792,2802,2776,2850,2772,2830,2814,28,12,152,427.83,1120
,20161208,2830,2814,2840,2840,2758,2806,2798,-8,-16,48,134.36,1114
,20161209,2806,2798,2818,2896,2818,2876,2850,78,52,130,370.73,1094
,20161212,2876,2850,2866,2968,2862,2942,2936,92,86,100,293.61,1094
,20161213,2942,2936,2940,2944,2920,2944,2932,8,-4,58,170.14,1100
,20161214,2944,2932,2968,2978,2892,2920,2918,-12,-14,122,356.07,1138
,20161215,2920,2918,2900,2918,2862,2886,2890,-32,-28,138,398.86,1076
,20161216,2886,2890,2898,2918,2868,2868,2890,-22,0,74,213.93,1068
,20161219,2868,2890,2906,2944,2862,2914,2902,24,12,278,807.01,1052
,20161220,2914,2902,2914,2932,2872,2880,2902,-22,0,336,975.59,1082
,20161221,2880,2902,2890,2916,2864,2884,2886,-18,-16,48,138.62,1088
,20161222,2884,2886,2880,2880,2810,2810,2856,-76,-30,52,148.52,1058
,20161223,2810,2856,2802,2838,2778,2800,2804,-56,-52,78,218.78,1050
,20161226,2800,2804,2802,2810,2760,2768,2774,-36,-30,54,149.89,1058
,20161227,2768,2774,2788,2968,2768,2968,2852,194,78,176,502.04,1118
,20161228,2968,2852,2934,3044,2934,3038,2996,186,144,230,689.19,1124
,20161229,3038,2996,3020,3020,2974,3014,2994,18,-2,122,365.34,1116
,20161230,3014,2994,3012,3022,2980,3004,2990,10,-4,94,281.13,1128
bu1809,20160920,2326,2326,2364,2380,2352,2374,2364,48,38,108,255.38,84
,20160921,2374,2364,2402,2402,2366,2366,2376,2,12,30,71.28,76
,20160922,2366,2376,2364,2388,2362,2370,2372,-6,-4,60,142.40,102
,20160923,2370,2372,2380,2380,2360,2372,2368,0,-4,78,184.82,124
,20160926,2372,2368,2374,2382,2366,2374,2372,6,4,114,270.60,146
,20160927,2374,2372,2396,2398,2356,2362,2370,-10,-2,34,80.58,150
,20160928,2362,2370,2360,2360,2232,2248,2280,-122,-90,244,556.38,212
,20160929,2248,2280,2254,2270,2208,2252,2250,-28,-30,214,481.74,204
,20160930,2252,2250,2258,2278,2252,2262,2264,12,14,82,185.72,202
,20161010,2262,2264,2300,2300,2268,2278,2278,14,14,44,100.27,200
,20161011,2278,2278,2292,2360,2292,2310,2324,32,46,112,260.32,218
,20161012,2310,2324,2312,2312,2288,2290,2300,-34,-24,52,119.60,232
,20161013,2290,2300,2300,2310,2288,2300,2298,0,-2,240,551.56,394
,20161014,2300,2298,2344,2344,2284,2300,2300,2,2,74,170.26,406
,20161017,2300,2300,2312,2360,2308,2354,2334,54,34,154,359.73,458
,20161018,2354,2334,2346,2370,2332,2370,2348,36,14,70,164.38,480
,20161019,2370,2348,2378,2390,2368,2384,2382,36,34,162,385.98,542
,20161020,2384,2382,2380,2444,2380,2436,2424,54,42,134,325.01,564
,20161021,2436,2424,2432,2432,2402,2426,2416,2,-8,128,309.41,594
,20161024,2426,2416,2420,2442,2416,2440,2430,24,14,100,243.18,640
,20161025,2440,2430,2448,2454,2422,2434,2436,4,6,80,194.95,640
,20161026,2434,2436,2426,2436,2392,2392,2408,-44,-28,148,356.43,666
,20161027,2392,2408,2422,2446,2410,2430,2426,22,18,182,441.58,684
,20161028,2430,2426,2440,2460,2434,2448,2450,22,24,118,289.18,728
,20161031,2448,2450,2466,2468,2422,2450,2444,0,-6,248,606.22,872
,20161101,2450,2444,2440,2476,2440,2468,2454,24,10,218,535.30,928
,20161102,2468,2454,2498,2522,2442,2446,2482,-8,28,282,700.10,982
,20161103,2446,2482,2436,2466,2436,2454,2450,-28,-32,164,402.09,1038
,20161104,2454,2450,2462,2470,2402,2412,2420,-38,-30,232,561.78,930
,20161107,2412,2420,2414,2456,2408,2442,2432,22,12,70,170.34,926
,20161108,2442,2432,2448,2490,2448,2482,2468,50,36,92,227.08,932
,20161109,2482,2468,2496,2512,2468,2500,2500,32,32,262,655.39,980
,20161110,2500,2500,2528,2612,2502,2604,2564,104,64,286,733.77,1028
,20161111,2604,2564,2590,2688,2582,2664,2640,100,76,348,919.18,1164
,20161114,2664,2640,2688,2708,2502,2510,2574,-130,-66,458,"1,179.25",1142
,20161115,2510,2574,2536,2608,2526,2576,2568,2,-6,288,739.89,1152
,20161116,2576,2568,2606,2642,2594,2634,2612,66,44,82,214.25,1180
,20161117,2634,2612,2610,2642,2602,2630,2626,18,14,58,152.31,1182
,20161118,2630,2626,2654,2654,2592,2614,2610,-12,-16,104,271.58,1178
,20161121,2614,2610,2604,2690,2588,2690,2676,80,66,496,"1,327.34",1248
,20161122,2690,2676,2700,2766,2692,2746,2734,70,58,366,"1,001.12",1348
,20161123,2746,2734,2736,2818,2718,2742,2738,8,4,310,849.00,1344
,20161124,2742,2738,2724,2756,2702,2736,2736,-2,-2,232,634.78,1382
,20161125,2736,2736,2750,2770,2712,2732,2734,-4,-2,178,486.98,1340
,20161128,2732,2734,2724,2796,2712,2774,2750,40,16,224,616.08,1348
,20161129,2774,2750,2822,2822,2746,2748,2772,-2,22,150,415.92,1330
,20161130,2748,2772,2730,2742,2662,2704,2696,-68,-76,196,528.51,1294
,20161201,2704,2696,2736,2824,2736,2804,2790,108,94,198,552.69,1290
,20161202,2804,2790,2802,2816,2760,2788,2788,-2,-2,160,446.18,1294
,20161205,2788,2788,2798,2908,2788,2892,2858,104,70,460,"1,314.99",1422
,20161206,2892,2858,2892,2924,2864,2902,2892,44,34,232,671.00,1434
,20161207,2902,2892,2888,2982,2886,2942,2930,50,38,232,680.20,1408
,20161208,2942,2930,2942,2952,2902,2930,2930,0,0,98,287.25,1414
,20161209,2930,2930,2946,3012,2924,3000,2976,70,46,276,821.43,1432
,20161212,3000,2976,2994,3092,2978,3060,3050,84,74,170,518.66,1450
,20161213,3060,3050,3052,3076,3044,3064,3056,14,6,184,562.54,1462
,20161214,3064,3056,3082,3082,3032,3066,3052,10,-4,226,689.92,1426
,20161215,3066,3052,3048,3060,3014,3032,3030,-20,-22,250,757.68,1346
,20161216,3032,3030,3024,3048,3008,3012,3022,-18,-8,268,810.20,1312
,20161219,3012,3022,2964,3050,2964,3022,3004,0,-18,400,"1,202.06",1188
,20161220,3022,3004,3008,3020,2966,2966,2988,-38,-16,318,950.40,1078
,20161221,2966,2988,2990,3000,2956,2966,2974,-22,-14,136,404.72,1026
,20161222,2966,2974,2964,2974,2908,2908,2948,-66,-26,244,719.51,1038
,20161223,2908,2948,2906,2948,2870,2902,2906,-46,-42,268,778.93,1070
,20161226,2902,2906,2888,2930,2840,2862,2872,-44,-34,290,833.32,1090
,20161227,2862,2872,2872,3040,2872,3040,2950,168,78,282,832.41,1126
,20161228,3040,2950,2978,3128,2978,3128,3078,178,128,362,"1,114.69",1252
,20161229,3128,3078,3108,3108,3064,3106,3080,28,2,200,616.36,1230
,20161230,3106,3080,3082,3084,3050,3068,3064,-12,-16,90,275.85,1224
bu1812,20161216,3030,3030,2972,3122,2972,3064,3066,34,36,348,"1,067.03",128
,20161219,3064,3066,3066,3098,3012,3080,3060,14,-6,302,924.18,192
,20161220,3080,3060,3030,3076,2990,3010,3036,-50,-24,104,315.90,192
,20161221,3010,3036,3040,3040,3002,3020,3020,-16,-16,102,308.14,170
,20161222,3020,3020,2994,3004,2970,2970,2990,-50,-30,56,167.50,188
,20161223,2970,2990,2960,2976,2902,2918,2930,-72,-60,110,322.48,218
,20161226,2918,2930,2924,2958,2834,2886,2894,-44,-36,324,937.84,250
,20161227,2886,2894,2922,3026,2886,3026,2950,132,56,476,"1,404.27",316
,20161228,3026,2950,3032,3148,3008,3148,3094,198,144,536,"1,659.39",484
,20161229,3148,3094,3132,3144,3042,3122,3104,28,10,466,"1,447.38",444
,20161230,3122,3104,3112,3130,3082,3108,3102,4,-2,120,372.25,424
cu1601,20160104,36710,36740,36610,36720,36120,36240,36270,-500,-470,14746,"267,439.79",50400
,20160105,36240,36270,36200,36720,35580,36720,36330,450,60,15110,"274,508.40",47010
,20160106,36720,36330,36700,36720,36310,36450,36450,120,120,16260,"296,414.85",44060
,20160107,36450,36450,36270,36700,36160,36250,36380,-200,-70,22020,"400,559.80",41680
,20160108,36250,36380,36010,36350,35550,36000,35940,-380,-440,21570,"387,636.15",37670
,20160111,36000,35940,35890,36030,35010,35010,35510,-930,-430,23140,"410,937.05",32930
,20160112,35010,35510,35010,35330,34800,34800,35060,-710,-450,16020,"280,878.45",29330
,20160113,34800,35060,34890,35050,34740,34830,34870,-230,-190,11760,"205,087.15",23190
,20160114,34830,34870,34040,34940,34040,34830,34730,-40,-140,6730,"116,869.10",20020
,20160115,34830,34730,34850,35100,34510,34720,34900,-10,170,5050,"88,137.35",18010
cu1602,20160104,36650,36610,36540,36680,35930,36100,36160,-510,-450,234824,"4,245,876.44",175346
,20160105,36100,36160,36070,36630,35940,36590,36200,430,40,232312,"4,205,108.48",162834
,20160106,36590,36200,36540,36610,36220,36310,36390,110,190,169528,"3,084,801.03",150840
,20160107,36310,36390,36220,36630,36010,36200,36300,-190,-90,152250,"2,763,951.42",139516
,20160108,36200,36300,35950,36200,35370,35800,35810,-500,-490,220442,"3,947,399.42",123568
,20160111,35800,35810,35720,35920,34910,34940,35450,-870,-360,135708,"2,406,058.99",120162
,20160112,34940,35450,35060,35320,34760,34780,35030,-670,-420,107556,"1,884,251.17",111036
,20160113,34780,35030,34950,35170,34780,34850,34930,-180,-100,88020,"1,537,369.64",100978
,20160114,34850,34930,34850,35060,34420,34960,34810,30,-120,74048,"1,288,958.19",98508
,20160115,34960,34810,34880,35330,34790,34810,35040,0,230,55384,"970,574.98",94858
,20160118,34810,35040,34540,35170,34500,34940,34890,-100,-150,72550,"1,265,683.94",89456
,20160119,34940,34890,34920,35500,34800,35300,35130,410,240,52402,"920,552.08",84250
,20160120,35300,35130,35320,35410,34950,35020,35110,-110,-20,43170,"757,966.29",82640
,20160121,35020,35110,34960,35210,34810,34820,35000,-290,-110,42950,"751,629.85",77964
,20160122,34820,35000,34930,35340,34880,35180,35170,180,170,32786,"576,565.19",70648
,20160125,35180,35170,35320,35330,34910,35000,35020,-170,-150,30334,"531,250.58",66882
,20160126,35000,35020,35000,35140,34840,35030,34990,10,-30,29034,"508,027.54",60720
,20160127,35030,34990,35320,35700,35220,35700,35480,710,490,38482,"682,857.81",53632
,20160128,35700,35480,35560,35820,35470,35470,35610,-10,130,22540,"401,336.26",49230
,20160129,35470,35610,35500,35650,35390,35540,35500,-70,-110,24786,"439,975.38",42156
,20160201,35540,35500,35540,35680,35220,35280,35390,-220,-110,18806,"332,825.03",36380
,20160202,35280,35390,35320,35500,35220,35430,35410,40,20,14820,"262,451.15",32760
,20160203,35430,35410,35550,35550,35210,35420,35330,10,-80,14470,"255,665.20",27390
,20160204,35420,35330,35400,36230,35400,36180,35920,850,590,8860,"159,160.10",23760
,20160205,36180,35920,36110,36570,35900,36080,36030,160,110,3270,"58,914.00",22260
,20160215,36080,36030,35560,35570,33820,35500,35420,-530,-610,4660,"82,539.60",22120
cu1603,20160104,36560,36520,36480,36570,35820,35970,36050,-550,-470,224740,"4,051,416.28",294626
,20160105,35970,36050,36000,36550,35820,36510,36120,460,70,411016,"7,424,146.55",291660
,20160106,36510,36120,36410,36530,36140,36240,36320,120,200,476828,"8,659,701.97",299874
,20160107,36240,36320,36140,36580,35910,36090,36240,-230,-80,646922,"11,724,014.92",305238
,20160108,36090,36240,35810,36090,35230,35680,35690,-560,-550,974450,"17,391,621.10",318464
,20160111,35680,35690,35630,35790,34760,34770,35320,-920,-370,647856,"11,442,992.63",356500
,20160112,34770,35320,34900,35140,34610,34630,34890,-690,-430,668706,"11,666,305.11",354662
,20160113,34630,34890,34740,35070,34660,34810,34830,-80,-60,611038,"10,644,091.18",351896
,20160114,34810,34830,34760,35030,34350,34930,34750,100,-80,713142,"12,391,800.75",333742
,20160115,34930,34750,34840,35330,34730,34800,35010,50,260,598056,"10,471,870.31",317570
,20160118,34800,35010,34480,35200,34450,34990,34870,-20,-140,672146,"11,719,066.38",315402
,20160119,34990,34870,34970,35600,34840,35360,35170,490,300,636590,"11,197,483.76",307608
,20160120,35360,35170,35400,35470,34970,35080,35210,-90,40,495406,"8,723,787.45",305510
,20160121,35080,35210,35000,35280,34810,34850,35030,-360,-180,556644,"9,749,936.64",310518
,20160122,34850,35030,35000,35410,34910,35190,35170,160,140,549800,"9,668,922.32",294652
,20160125,35190,35170,35350,35400,34920,35020,35140,-150,-30,406458,"7,142,629.40",294056
,20160126,35020,35140,35050,35190,34840,35100,35010,-40,-130,414594,"7,259,363.48",278786
,20160127,35100,35010,35480,35840,35280,35780,35540,770,530,551904,"9,809,654.57",265050
,20160128,35780,35540,35670,35980,35570,35600,35740,60,200,418618,"7,481,046.14",247240
,20160129,35600,35740,35640,35800,35470,35680,35630,-60,-110,447376,"7,971,754.73",224774
,20160201,35680,35630,35630,35820,35350,35450,35600,-180,-30,316184,"5,628,749.19",211646
,20160202,35450,35600,35510,35710,35380,35640,35550,40,-50,219372,"3,900,281.38",206848
,20160203,35640,35550,35750,35800,35380,35650,35550,100,0,249588,"4,437,478.76",200044
,20160204,35650,35550,35650,36440,35640,36330,36020,780,470,259658,"4,677,544.29",187024
,20160205,36330,36020,36250,36530,36120,36350,36320,330,300,184432,"3,349,343.60",174498
,20160215,36350,36320,35530,35820,35530,35660,35670,-660,-650,98178,"1,751,031.31",165196
,20160216,35660,35670,35600,35900,35540,35680,35700,10,30,90290,"1,611,989.47",153568
,20160217,35680,35700,35710,35800,35400,35410,35550,-290,-150,66708,"1,185,990.80",147106
,20160218,35410,35550,35530,35720,35490,35650,35600,100,50,37654,"670,361.15",142192
,20160219,35650,35600,35650,35920,35440,35810,35640,210,40,52924,"943,295.78",135646
,20160222,35810,35640,35750,36240,35600,36220,35980,580,340,48922,"880,165.43",129774
,20160223,36220,35980,36270,36400,36000,36080,36140,100,160,42536,"768,825.08",123360
,20160224,36080,36140,36130,36140,35620,35710,35860,-430,-280,40136,"719,662.20",119120
,20160225,35710,35860,35710,36150,35590,35820,35950,-40,90,47396,"852,103.35",108852
,20160226,35820,35950,35900,35960,35500,35730,35710,-220,-240,44366,"792,196.42",100754
,20160229,35730,35710,36000,36440,35570,35750,35910,40,200,54814,"984,416.39",84088
,20160301,35750,35910,35980,35980,35500,35900,35720,-10,-190,31588,"564,251.05",77330
,20160302,35900,35720,35940,36650,35830,36650,36270,930,550,37200,"674,632.55",65870
,20160303,36650,36270,36550,36800,36500,36700,36650,430,380,25470,"466,854.60",61020
,20160304,36700,36650,36820,37630,36700,37550,37210,900,560,25890,"481,738.35",54690
,20160307,37550,37210,37540,38690,37330,37820,37810,610,600,22820,"431,518.50",51960
,20160308,37820,37810,38020,38200,37200,37430,37470,-380,-340,24020,"450,070.85",48050
,20160309,37430,37470,37500,37500,36640,37010,36860,-460,-610,23760,"437,978.00",45550
,20160310,37010,36860,37070,37300,36970,37000,37050,140,190,15810,"292,906.75",41920
,20160311,37000,37050,36710,37390,36710,37390,37110,340,60,15410,"285,972.15",35430
,20160314,37390,37110,37380,37730,37130,37370,37450,260,340,10620,"198,898.10",31170
,20160315,37370,37450,36620,37250,36620,36980,36940,-470,-510,8050,"148,706.00",29790
cu1604,20160104,36450,36440,36280,36500,35760,35880,35990,-560,-450,49552,"891,912.73",113434
,20160105,35880,35990,35910,36450,35750,36430,36040,440,50,62922,"1,133,990.72",115092
,20160106,36430,36040,36320,36450,36090,36160,36250,120,210,76070,"1,379,128.60",109870
,20160107,36160,36250,36060,36500,35870,36030,36160,-220,-90,84798,"1,533,460.04",113390
,20160108,36030,36160,35800,36010,35160,35610,35610,-550,-550,145080,"2,583,592.54",125796
,20160111,35610,35610,35540,35710,34680,34720,35210,-890,-400,93916,"1,653,488.91",137654
,20160112,34720,35210,34860,35060,34550,34570,34810,-640,-400,90558,"1,576,233.14",142758
,20160113,34570,34810,34630,35000,34600,34740,34770,-70,-40,106582,"1,852,969.47",139728
,20160114,34740,34770,34700,34970,34300,34870,34700,100,-70,131476,"2,281,120.13",147214
,20160115,34870,34700,34790,35270,34700,34760,34970,60,270,114292,"1,998,526.48",153188
,20160118,34760,34970,34420,35170,34410,34940,34860,-30,-110,166764,"2,906,917.01",148932
,20160119,34940,34860,34910,35560,34810,35330,35170,470,310,135076,"2,375,356.68",145560
,20160120,35330,35170,35370,35440,34950,35060,35170,-110,0,102922,"1,809,891.83",153760
,20160121,35060,35170,34980,35240,34800,34840,34990,-330,-180,105654,"1,848,933.13",160848
,20160122,34840,34990,34950,35380,34890,35210,35170,220,180,125938,"2,214,756.07",166984
,20160125,35210,35170,35380,35420,34960,35060,35150,-110,-20,102992,"1,810,389.94",179178
,20160126,35060,35150,35000,35240,34900,35140,35070,-10,-80,121576,"2,131,967.33",186770
,20160127,35140,35070,35490,35900,35300,35840,35580,770,510,208722,"3,713,569.97",201536
,20160128,35840,35580,35690,36060,35640,35650,35800,70,220,149574,"2,677,698.36",223966
,20160129,35650,35800,35680,35870,35570,35730,35720,-70,-80,196416,"3,507,992.78",250514
,20160201,35730,35720,35690,35900,35440,35540,35660,-180,-60,137634,"2,454,339.98",248036
,20160202,35540,35660,35590,35820,35460,35760,35650,100,-10,105406,"1,879,386.23",255098
,20160203,35760,35650,35880,35910,35500,35810,35690,160,40,167454,"2,988,589.78",255800
,20160204,35810,35690,35830,36570,35780,36500,36210,810,520,218918,"3,964,421.61",246020
,20160205,36500,36210,36400,36680,36250,36510,36440,300,230,144804,"2,638,834.24",241936
,20160215,36510,36440,35800,35940,35510,35750,35770,-690,-670,190342,"3,405,178.02",232728
,20160216,35750,35770,35670,36010,35650,35750,35790,-20,20,274046,"4,905,377.57",251394
,20160217,35750,35790,35760,35910,35470,35480,35650,-310,-140,343700,"6,126,979.51",251098
,20160218,35480,35650,35590,35820,35550,35700,35690,50,40,251418,"4,487,273.09",254242
,20160219,35700,35690,35700,36030,35510,35920,35750,230,60,379600,"6,786,381.53",270716
,20160222,35920,35750,35780,36380,35700,36350,36050,600,300,398280,"7,179,651.30",268738
,20160223,36350,36050,36450,36560,36090,36200,36330,150,280,313264,"5,690,562.79",259186
,20160224,36200,36330,36280,36280,35700,35810,35990,-520,-340,332556,"5,985,639.24",260900
,20160225,35810,35990,35780,36290,35680,35920,36010,-70,20,408926,"7,363,421.61",245666
,20160226,35920,36010,36020,36060,35550,35840,35790,-170,-220,399770,"7,155,003.30",226834
,20160229,35840,35790,36190,36570,35660,35840,36090,50,300,693032,"12,508,297.76",199640
,20160301,35840,36090,36050,36110,35530,35960,35870,-130,-220,420474,"7,541,394.48",182716
,20160302,35960,35870,36110,36830,35970,36820,36310,950,440,349666,"6,349,463.59",174522
,20160303,36820,36310,36710,37010,36680,36840,36840,530,530,220462,"4,061,642.87",157700
,20160304,36840,36840,36990,37830,36880,37790,37360,950,520,187288,"3,499,356.43",148780
,20160307,37790,37360,37700,39000,37510,37960,38030,600,670,219208,"4,168,668.08",135894
,20160308,37960,38030,38130,38470,37360,37630,37850,-400,-180,150826,"2,854,874.58",128332
,20160309,37630,37850,37630,37810,36740,37170,37080,-680,-770,122816,"2,277,614.84",123594
,20160310,37170,37080,37260,37530,37140,37180,37270,100,190,69518,"1,295,796.52",124686
,20160311,37180,37270,37290,37590,36920,37580,37250,310,-20,66932,"1,246,767.66",123784
,20160314,37580,37250,37470,37960,37360,37570,37660,320,410,64118,"1,207,369.18",122932
,20160315,37570,37660,37550,37560,37010,37130,37190,-530,-470,60012,"1,116,131.82",119770
,20160316,37130,37190,37070,37470,36980,37390,37230,200,40,50670,"943,426.14",116884
,20160317,37390,37230,37330,37810,37240,37780,37620,550,390,46796,"880,444.67",114914
,20160318,37780,37620,37730,38530,37710,38240,38190,620,570,75160,"1,435,536.03",115414
,20160321,38240,38190,38180,38640,37800,38050,38060,-140,-130,60780,"1,156,859.07",110824
,20160322,38050,38060,38070,38280,37940,38030,38080,-30,20,47440,"903,260.85",108344
,20160323,38030,38080,38030,38260,37930,38030,38110,-50,30,46436,"885,064.56",104124
,20160324,38030,38110,37970,37970,37350,37540,37510,-570,-600,68334,"1,281,874.83",97114
,20160325,37540,37510,37450,37720,37310,37680,37580,170,70,28250,"530,831.01",94934
,20160328,37680,37580,37690,37770,37430,37490,37630,-90,50,26448,"497,700.00",92180
,20160329,37490,37630,37490,37940,37420,37500,37620,-130,-10,42996,"808,924.22",86270
,20160330,37500,37620,37510,37570,36930,37010,37270,-610,-350,56092,"1,045,523.53",74712
,20160331,37010,37270,37000,37260,36710,36850,36840,-420,-430,39384,"725,588.22",64258
,20160401,36850,36840,36840,37120,36740,37120,36980,280,140,16998,"314,296.33",60960
,20160405,37120,36980,36680,36840,36550,36720,36680,-260,-300,18330,"336,210.05",58380
,20160406,36720,36680,36560,36760,36560,36710,36690,30,10,17970,"329,734.85",55470
,20160407,36710,36690,36580,36830,36580,36640,36710,-50,20,21690,"398,185.50",52560
,20160408,36640,36710,36370,36370,35680,35760,35870,-950,-840,34330,"615,771.85",45090
,20160411,35760,35870,35720,36060,35720,35800,35890,-70,20,19810,"355,571.70",39340
,20160412,35800,35890,35830,35970,35640,35960,35810,70,-80,19900,"356,404.90",34110
,20160413,35960,35810,36000,37090,36000,36800,36710,990,900,20450,"375,413.65",27690
,20160414,36800,36710,36850,36920,36610,36630,36690,-80,-20,12760,"234,127.35",22870
,20160415,36630,36690,36820,36900,36560,36700,36780,10,90,5700,"104,827.20",21770
cu1605,20160104,36400,36390,36260,36420,35700,35820,35960,-570,-430,26852,"482,861.22",88744
,20160105,35820,35960,35810,36390,35700,36380,35960,420,0,41040,"738,033.17",89062
,20160106,36380,35960,36210,36370,36010,36110,36180,150,220,41218,"745,657.73",91310
,20160107,36110,36180,35980,36430,35790,35940,36110,-240,-70,51110,"922,869.10",96686
,20160108,35940,36110,35750,35940,35090,35530,35560,-580,-550,70758,"1,258,094.59",100160
,20160111,35530,35560,35460,35650,34610,34690,35160,-870,-400,52166,"917,187.33",103880
,20160112,34690,35160,34740,34990,34490,34530,34750,-630,-410,39372,"684,281.23",103906
,20160113,34530,34750,34600,34930,34530,34680,34710,-70,-40,53190,"923,224.95",106646
,20160114,34680,34710,34650,34920,34270,34830,34670,120,-40,51046,"884,997.31",105606
,20160115,34830,34670,34710,35220,34670,34740,34930,70,260,40956,"715,428.42",104312
,20160118,34740,34930,34440,35130,34380,34900,34800,-30,-130,59888,"1,042,139.58",104970
,20160119,34900,34800,34910,35530,34780,35330,35140,530,340,47716,"838,487.16",107678
,20160120,35330,35140,35350,35410,34920,35020,35150,-120,10,42040,"738,893.63",112096
,20160121,35020,35150,34960,35190,34780,34790,34970,-360,-180,47062,"822,898.64",114548
,20160122,34790,34970,34870,35340,34860,35170,35150,200,180,52352,"920,268.55",112758
,20160125,35170,35150,35330,35400,34990,35070,35160,-80,10,42726,"751,133.86",114080
,20160126,35070,35160,35130,35230,34920,35140,35080,-20,-80,56556,"992,199.35",121616
,20160127,35140,35080,35500,35900,35320,35870,35610,790,530,81454,"1,450,378.00",130456
,20160128,35870,35610,35760,36080,35680,35700,35830,90,220,60800,"1,089,408.78",135992
,20160129,35700,35830,35730,35900,35650,35780,35780,-50,-50,77762,"1,391,210.67",146294
,20160201,35780,35780,35700,35940,35520,35600,35730,-180,-50,51886,"927,060.39",148448
,20160202,35600,35730,35640,35880,35550,35840,35730,110,0,36210,"647,006.40",150614
,20160203,35840,35730,35890,35980,35600,35920,35800,190,70,61654,"1,103,762.60",151870
,20160204,35920,35800,35940,36680,35890,36600,36330,800,530,71660,"1,301,868.96",152614
,20160205,36600,36330,36570,36780,36340,36570,36530,240,200,48280,"882,011.51",150570
,20160215,36570,36530,35600,36020,35600,35860,35860,-670,-670,58462,"1,048,284.52",151994
,20160216,35860,35860,35780,36080,35740,35820,35880,-40,20,67592,"1,212,832.18",163512
,20160217,35820,35880,35840,36000,35540,35540,35730,-340,-150,83062,"1,484,210.14",164652
,20160218,35540,35730,35650,35880,35620,35780,35750,50,20,51960,"928,921.91",167750
,20160219,35780,35750,35780,36080,35590,35990,35810,240,60,85002,"1,522,375.57",171820
,20160222,35990,35810,35840,36480,35780,36480,36170,670,360,124494,"2,251,997.07",194914
,20160223,36480,36170,36600,36660,36200,36300,36420,130,250,95206,"1,734,028.73",201072
,20160224,36300,36420,36400,36400,35830,35890,36080,-530,-340,134166,"2,420,787.55",208012
,20160225,35890,36080,35870,36380,35760,36000,36100,-80,20,167464,"3,023,560.72",227906
,20160226,36000,36100,36100,36150,35590,35890,35850,-210,-250,184246,"3,302,876.14",229778
,20160229,35890,35850,36250,36680,35680,35880,36140,30,290,428862,"7,751,499.02",259370
,20160301,35880,36140,36080,36160,35550,36010,35890,-130,-250,354354,"6,360,371.89",276038
,20160302,36010,35890,36160,36960,36020,36940,36430,1050,540,529086,"9,639,197.94",325702
,20160303,36940,36430,36830,37150,36800,37000,36970,570,540,490662,"9,069,916.23",310200
,20160304,37000,36970,37110,38010,37020,37950,37520,980,550,712994,"13,378,913.76",311400
,20160307,37950,37520,37910,39400,37640,38090,38210,570,690,1078126,"20,597,889.38",276290
,20160308,38090,38210,38250,38620,37460,37750,38000,-460,-210,910538,"17,303,109.98",261796
,20160309,37750,38000,37920,37920,36800,37320,37190,-680,-810,852456,"15,852,400.98",257800
,20160310,37320,37190,37440,37670,37250,37300,37420,110,230,521714,"9,762,421.60",258828
,20160311,37300,37420,37350,37740,37040,37710,37370,290,-50,506820,"9,471,117.80",276460
,20160314,37710,37370,37540,38150,37490,37750,37770,380,400,527542,"9,963,622.15",276344
,20160315,37750,37770,37700,37710,37130,37250,37350,-520,-420,484084,"9,041,759.33",280502
,20160316,37250,37350,37200,37620,37080,37570,37360,220,10,448986,"8,387,591.16",279816
,20160317,37570,37360,37450,37970,37370,37940,37720,580,360,467704,"8,821,979.17",286684
,20160318,37940,37720,37870,38690,37830,38380,38280,660,560,800538,"15,322,833.70",300858
,20160321,38380,38280,38300,38440,37930,38160,38190,-120,-90,493144,"9,417,466.94",298568
,20160322,38160,38190,38180,38430,38060,38150,38250,-40,60,418080,"7,995,796.74",295066
,20160323,38150,38250,38200,38420,38040,38160,38230,-90,-20,341424,"6,527,585.21",282902
,20160324,38160,38230,38110,38120,37430,37630,37650,-600,-580,532272,"10,020,985.75",229948
,20160325,37630,37650,37490,37800,37400,37750,37620,100,-30,212472,"3,996,887.04",223332
,20160328,37750,37620,37750,37870,37500,37510,37720,-110,100,171106,"3,227,354.64",216036
,20160329,37510,37720,37600,38040,37470,37570,37710,-150,-10,293616,"5,536,583.92",201452
,20160330,37570,37710,37580,37640,36920,37040,37320,-670,-390,376980,"7,035,172.82",191042
,20160331,37040,37320,37050,37320,36710,36900,36960,-420,-360,256912,"4,747,935.50",176256
,20160401,36900,36960,36830,37170,36780,37160,37030,200,70,177780,"3,291,910.50",164608
,20160405,37160,37030,36720,36850,36540,36780,36710,-250,-320,69078,"1,268,239.35",156264
,20160406,36780,36710,36660,36820,36570,36770,36720,60,10,63750,"1,170,687.79",150244
,20160407,36770,36720,36650,36880,36590,36670,36740,-50,20,65064,"1,195,480.67",148206
,20160408,36670,36740,36450,36450,35650,35810,35920,-930,-820,116638,"2,095,134.05",146984
,20160411,35810,35920,35790,36160,35770,35870,35960,-50,40,84234,"1,514,615.16",143472
,20160412,35870,35960,35850,36080,35660,36020,35910,60,-50,75290,"1,352,146.54",138682
,20160413,36020,35910,36100,37280,36050,36830,36690,920,780,123164,"2,259,890.99",131906
,20160414,36830,36690,36860,37100,36710,36810,36890,120,200,53510,"987,157.82",130582
,20160415,36810,36890,36870,37070,36700,36750,36920,-140,30,41490,"766,062.77",127968
,20160418,36750,36920,36620,37000,36540,36570,36770,-350,-150,63636,"1,169,974.02",122266
,20160419,36570,36770,36570,37100,36570,36870,36860,100,90,54094,"996,958.30",115224
,20160420,36870,36860,36960,37650,36890,37280,37320,420,460,75464,"1,408,493.85",107994
,20160421,37280,37320,37400,38090,37280,37990,37680,670,360,74908,"1,411,342.51",98706
,20160422,37990,37680,38220,38430,37360,37890,37820,210,140,72300,"1,367,315.85",94336
,20160425,37890,37820,38080,38870,37780,38000,38130,180,310,69046,"1,316,434.18",88674
,20160426,38000,38130,38020,38070,37420,37650,37690,-480,-440,41280,"778,118.48",83168
,20160427,37650,37690,37590,37800,37430,37550,37590,-140,-100,32744,"615,499.00",76728
,20160428,37550,37590,37560,37630,36950,37180,37160,-410,-430,42992,"798,971.54",70654
,20160429,37180,37160,37250,37630,37080,37590,37430,430,270,26494,"495,864.78",65096
,20160503,37590,37430,37550,37800,37310,37730,37470,300,40,20066,"376,030.43",61520
,20160504,37730,37470,37700,37700,37060,37100,37140,-370,-330,27960,"519,312.20",55380
,20160505,37100,37140,37090,37250,36760,36760,36880,-380,-260,29210,"538,756.50",49140
,20160506,36760,36880,36700,36800,36300,36510,36470,-370,-410,24240,"442,059.95",44460
,20160509,36510,36470,36430,36770,35720,35760,36030,-710,-440,33310,"600,191.60",40420
,20160510,35760,36030,35840,35940,35610,35850,35790,-180,-240,25350,"453,739.55",34690
,20160511,35850,35790,35860,35900,35610,35820,35780,30,-10,22480,"402,274.45",30850
,20160512,35820,35780,35810,36270,35700,36090,35960,310,180,15250,"274,247.70",26830
,20160513,36090,35960,36160,36250,35100,35300,35310,-660,-650,12460,"220,016.85",21630
,20160516,35300,35310,35300,36460,35000,35510,35270,200,-40,3940,"69,499.25",20810
cu1606,20160104,36300,36320,36280,36370,35660,35770,35910,-550,-410,3132,"56,238.82",24324
,20160105,35770,35910,35780,36320,35650,36320,35880,410,-30,3640,"65,317.64",24968
,20160106,36320,35880,36240,36300,35960,36080,36140,200,260,5428,"98,088.01",25234
,20160107,36080,36140,35950,36380,35740,35890,36020,-250,-120,7832,"141,059.17",26788
,20160108,35890,36020,35690,35850,35050,35460,35490,-560,-530,11898,"211,172.94",28054
,20160111,35460,35490,35460,35580,34540,34670,35050,-820,-440,8192,"143,584.67",29416
,20160112,34670,35050,34690,34920,34430,34500,34680,-550,-370,7854,"136,225.54",31006
,20160113,34500,34680,34510,34850,34480,34700,34660,20,-20,11062,"191,756.73",35956
,20160114,34700,34660,34700,34880,34250,34770,34600,110,-60,10758,"186,165.69",38766
,20160115,34770,34600,34710,35200,34640,34720,34890,120,290,8296,"144,762.04",40424
,20160118,34720,34890,34500,35100,34360,34910,34800,20,-90,9240,"160,816.84",42486
,20160119,34910,34800,34890,35500,34770,35260,35160,460,360,7836,"137,766.44",41364
,20160120,35260,35160,35340,35370,34880,35010,35090,-150,-70,5802,"101,811.67",41780
,20160121,35010,35090,34950,35180,34750,34790,34930,-300,-160,7460,"130,323.66",42700
,20160122,34790,34930,34930,35300,34860,35160,35140,230,210,6810,"119,657.35",43076
,20160125,35160,35140,35290,35390,34980,35050,35170,-90,30,6268,"110,225.50",43424
,20160126,35050,35170,35120,35240,34900,35120,35100,-50,-70,7854,"137,847.75",43572
,20160127,35120,35100,35550,35940,35340,35900,35660,800,560,23678,"422,205.21",50400
,20160128,35900,35660,35830,36110,35700,35700,35880,40,220,11426,"204,991.07",50788
,20160129,35700,35880,35750,35950,35700,35820,35810,-60,-70,18406,"329,636.09",51010
,20160201,35820,35810,35800,36000,35600,35670,35760,-140,-50,14574,"260,649.28",53150
,20160202,35670,35760,35750,35950,35630,35910,35810,150,50,11334,"202,947.73",53924
,20160203,35910,35810,36030,36050,35700,35990,35890,180,80,13776,"247,252.75",53738
,20160204,35990,35890,36000,36780,35990,36670,36430,780,540,21126,"384,891.36",56956
,20160205,36670,36430,36610,36900,36420,36600,36590,170,160,15028,"274,979.58",57290
,20160215,36600,36590,35940,36070,35720,35910,35910,-680,-680,20742,"372,455.98",53552
,20160216,35910,35910,35810,36120,35790,35840,35960,-70,50,31786,"571,576.21",64322
,20160217,35840,35960,35890,36070,35590,35620,35780,-340,-180,26520,"474,534.87",69464
,20160218,35620,35780,35780,35900,35660,35810,35790,30,10,15286,"273,578.91",72856
,20160219,35810,35790,35790,36110,35640,36010,35870,220,80,18122,"325,072.44",76052
,20160222,36010,35870,35970,36540,35810,36510,36240,640,370,19900,"360,634.91",78448
,20160223,36510,36240,36550,36700,36250,36340,36450,100,210,22726,"414,187.50",86298
,20160224,36340,36450,36400,36410,35880,35950,36090,-500,-360,32978,"595,211.87",93904
,20160225,35950,36090,35930,36420,35800,36060,36150,-30,60,35328,"638,691.03",101022
,20160226,36060,36150,36170,36200,35620,35950,35880,-200,-270,52020,"933,299.32",111120
,20160229,35950,35880,36340,36730,35730,35880,36180,0,300,114766,"2,076,594.93",119624
,20160301,35880,36180,36080,36180,35600,36070,35930,-110,-250,69454,"1,247,916.24",127768
,20160302,36070,35930,36210,37000,36060,36970,36510,1040,580,85064,"1,552,854.28",140402
,20160303,36970,36510,36850,37250,36850,37070,37080,560,570,110440,"2,047,767.81",140272
,20160304,37070,37080,37160,38090,37120,38040,37650,960,570,144680,"2,723,748.60",138978
,20160307,38040,37650,38000,39500,37730,38170,38270,520,620,187712,"3,592,329.23",144084
,20160308,38170,38270,38360,38680,37550,37830,38050,-440,-220,211842,"4,031,280.54",146260
,20160309,37830,38050,38030,38030,36870,37430,37280,-620,-770,176748,"3,294,641.14",149412
,20160310,37430,37280,37500,37760,37340,37390,37500,110,220,106146,"1,990,424.31",153960
,20160311,37390,37500,37460,37820,37120,37800,37450,300,-50,106244,"1,989,826.42",158096
,20160314,37800,37450,37630,38250,37590,37840,37880,390,430,119506,"2,263,755.57",169960
,20160315,37840,37880,37820,37820,37210,37360,37440,-520,-440,130790,"2,448,450.93",176458
,20160316,37360,37440,37330,37700,37180,37660,37450,220,10,111238,"2,083,261.27",183988
,20160317,37660,37450,37520,38060,37470,38010,37840,560,390,118392,"2,240,189.99",189948
,20160318,38010,37840,37970,38770,37930,38460,38380,620,540,217304,"4,170,880.90",198238
,20160321,38460,38380,38360,38520,38000,38220,38270,-160,-110,157268,"3,009,390.51",201140
,20160322,38220,38270,38280,38500,38150,38230,38320,-40,50,119592,"2,291,602.92",203490
,20160323,38230,38320,38270,38510,38120,38230,38320,-90,0,117322,"2,248,170.53",205578
,20160324,38230,38320,38170,38180,37510,37710,37720,-610,-600,259834,"4,900,954.80",219882
,20160325,37710,37720,37560,37870,37470,37830,37690,110,-30,97426,"1,836,228.39",220314
,20160328,37830,37690,37840,37930,37560,37570,37790,-120,100,91148,"1,722,346.06",229602
,20160329,37570,37790,37660,38090,37490,37590,37750,-200,-40,185848,"3,508,547.87",254388
,20160330,37590,37750,37660,37660,36850,36990,37260,-760,-490,357590,"6,663,386.87",311466
,20160331,36990,37260,37040,37290,36640,36860,36890,-400,-370,335052,"6,181,077.40",335806
,20160401,36860,36890,36780,37150,36730,37120,37000,230,110,323898,"5,993,696.10",329404
,20160405,37120,37000,36660,36850,36500,36730,36700,-270,-300,204600,"3,754,829.34",314184
,20160406,36730,36700,36600,36810,36550,36730,36710,30,10,237194,"4,353,814.27",319632
,20160407,36730,36710,36560,36880,36560,36650,36730,-60,20,260044,"4,776,010.83",329786
,20160408,36650,36730,36400,36400,35610,35760,35870,-970,-860,506212,"9,081,310.64",349294
,20160411,35760,35870,35760,36150,35730,35830,35920,-40,50,442994,"7,956,333.90",340792
,20160412,35830,35920,35800,36060,35600,35980,35880,60,-40,384698,"6,902,715.14",322328
,20160413,35980,35880,36110,37360,36040,36830,36700,950,820,786206,"14,429,162.70",286356
,20160414,36830,36700,36930,37150,36780,36850,36960,150,260,366646,"6,776,069.13",294134
,20160415,36850,36960,37030,37130,36740,36780,36990,-180,30,357608,"6,613,996.40",295658
,20160418,36780,36990,36690,37080,36560,36610,36820,-380,-170,421168,"7,754,588.12",293264
,20160419,36610,36820,36770,37170,36730,36940,36910,120,90,430730,"7,950,925.71",286746
,20160420,36940,36910,37010,37740,36950,37360,37400,450,490,669188,"12,514,338.07",268236
,20160421,37360,37400,37520,38220,37350,38100,37750,700,350,595434,"11,240,944.66",242330
,20160422,38100,37750,38400,38570,37460,37970,37950,220,200,560744,"10,640,593.55",201826
,20160425,37970,37950,38110,39010,37880,38120,38320,170,370,539090,"10,330,071.05",196302
,20160426,38120,38320,38150,38180,37490,37700,37830,-620,-490,353214,"6,682,631.74",177638
,20160427,37700,37830,37650,37920,37490,37630,37710,-200,-120,245034,"4,620,293.41",168264
,20160428,37630,37710,37690,37710,37000,37250,37260,-460,-450,326618,"6,086,000.31",171264
,20160429,37250,37260,37250,37750,37160,37620,37460,360,200,230256,"4,312,935.42",156058
,20160503,37620,37460,37710,37920,37380,37830,37620,370,160,127078,"2,390,711.37",152838
,20160504,37830,37620,37630,37730,37140,37200,37330,-420,-290,136042,"2,539,715.55",150458
,20160505,37200,37330,37190,37300,36810,36820,37030,-510,-300,112602,"2,085,285.32",146874
,20160506,36820,37030,36770,36890,36310,36600,36560,-430,-470,112630,"2,058,909.59",141584
,20160509,36600,36560,36510,36920,35800,35850,36230,-710,-330,132510,"2,401,018.01",141714
,20160510,35850,36230,35830,36060,35670,35920,35860,-310,-370,86222,"1,546,314.98",138118
,20160511,35920,35860,35920,36060,35690,35950,35910,90,50,66252,"1,189,619.33",138562
,20160512,35950,35910,36090,36450,35800,36200,36120,290,210,65560,"1,184,310.20",135652
,20160513,36200,36120,36170,36320,35000,35460,35480,-660,-640,100116,"1,776,114.95",139504
,20160516,35460,35480,35350,35700,35100,35570,35410,90,-70,57118,"1,011,348.00",134692
,20160517,35570,35410,35530,35890,35470,35850,35710,440,300,51904,"926,919.75",126260
,20160518,35850,35710,35700,35890,35280,35370,35540,-340,-170,74284,"1,320,247.61",120042
,20160519,35370,35540,35240,35600,35090,35170,35320,-370,-220,64244,"1,134,734.68",110940
,20160520,35170,35320,35190,35400,34830,35310,35240,-10,-80,55578,"979,287.84",105004
,20160523,35310,35240,35410,35530,34870,35170,35110,-70,-130,59558,"1,045,687.14",101364
,20160524,35170,35110,35170,35330,35010,35190,35190,80,80,53282,"937,503.24",93016
,20160525,35190,35190,35420,35650,35280,35460,35500,270,310,50850,"902,728.95",89644
,20160526,35460,35500,35680,36030,35600,36000,35830,500,330,42394,"759,496.76",85376
,20160527,36000,35830,36030,36150,35580,35870,35810,40,-20,37704,"675,105.71",79562
,20160530,35870,35810,35930,36020,35620,35660,35700,-150,-110,33494,"597,909.24",70472
,20160531,35660,35700,35700,35930,35630,35770,35770,70,70,29436,"526,545.32",64542
,20160601,35770,35770,35770,35820,35200,35230,35370,-540,-400,31242,"552,632.66",57880
,20160602,35230,35370,35210,35440,35120,35340,35320,-30,-50,19390,"342,449.70",53790
,20160603,35340,35320,35340,35810,35240,35790,35510,470,190,17390,"308,833.50",50930
,20160606,35790,35510,36180,36300,35860,36300,36160,790,650,23930,"432,705.25",45710
,20160607,36300,36160,36240,36300,35900,35940,35990,-220,-170,25720,"462,950.10",41240
,20160608,35940,35990,35510,35540,35280,35450,35470,-540,-520,23200,"411,517.00",34150
,20160613,35450,35470,35030,35630,35030,35470,35460,0,-10,16340,"289,780.00",27850
,20160614,35470,35460,35450,35600,35300,35320,35460,-140,0,11660,"206,748.90",20940
,20160615,35320,35460,35260,35460,35160,35430,35370,-30,-90,7550,"133,551.80",16950
cu1607,20160104,36190,36280,36200,36230,35670,35740,35830,-540,-450,266,"4,766.51",10624
,20160105,35740,35830,35900,36220,35640,36180,35870,350,40,878,"15,749.85",11076
,20160106,36180,35870,36100,36250,35930,36080,36070,210,200,700,"12,626.12",10982
,20160107,36080,36070,35910,36300,35740,35850,36090,-220,20,794,"14,330.80",11262
,20160108,35850,36090,35720,35740,35060,35460,35510,-630,-580,2554,"45,349.12",12364
,20160111,35460,35510,35540,35550,34610,34620,34950,-890,-560,1538,"26,878.56",12912
,20160112,34620,34950,34620,34910,34410,34410,34600,-540,-350,1008,"17,438.77",13450
,20160113,34410,34600,34520,34800,34430,34600,34630,0,30,1730,"29,957.12",13700
,20160114,34600,34630,34610,34800,34220,34760,34580,130,-50,1008,"17,428.43",13852
,20160115,34760,34580,34820,35110,34630,34660,34920,80,340,752,"13,132.42",13910
,20160118,34660,34920,34280,35080,34280,34830,34710,-90,-210,2214,"38,429.19",14628
,20160119,34830,34710,34730,35470,34730,35270,35030,560,320,1480,"25,922.64",15104
,20160120,35270,35030,35300,35350,34880,34970,35110,-60,80,1450,"25,455.77",15486
,20160121,34970,35110,34930,35090,34740,34740,34870,-370,-240,974,"16,983.54",15396
,20160122,34740,34870,34850,35300,34830,35110,35090,240,220,656,"11,510.70",15424
,20160125,35110,35090,35270,35380,35000,35110,35170,20,80,1634,"28,737.64",16022
,20160126,35110,35170,35030,35220,34910,35140,35060,-30,-110,1988,"34,858.61",16368
,20160127,35140,35060,35480,35980,35350,35920,35640,860,580,6392,"113,911.43",19402
,20160128,35920,35640,35790,36090,35710,35750,35850,110,210,3826,"68,597.41",21156
,20160129,35750,35850,35750,35990,35720,35880,35870,30,20,4866,"87,293.40",22928
,20160201,35880,35870,35800,36030,35650,35730,35770,-140,-100,3134,"56,062.53",23494
,20160202,35730,35770,35780,35990,35700,35970,35880,200,110,2178,"39,073.49",23204
,20160203,35970,35880,36080,36110,35750,36050,35970,170,90,4640,"83,460.05",24234
,20160204,36050,35970,36100,36870,36060,36790,36480,820,510,4826,"88,033.82",23664
,20160205,36790,36480,36660,36910,36460,36740,36640,260,160,3944,"72,266.30",24534
,20160215,36740,36640,36000,36090,35800,35970,35960,-670,-680,5302,"95,340.84",25684
,20160216,35970,35960,35860,36160,35820,35860,35980,-100,20,10024,"180,346.38",30902
,20160217,35860,35980,35880,36130,35630,35670,35820,-310,-160,10072,"180,421.98",32254
,20160218,35670,35820,35700,35920,35700,35850,35840,30,20,6022,"107,937.87",32442
,20160219,35850,35840,35830,36140,35670,36040,35910,200,70,4896,"87,915.30",32780
,20160222,36040,35910,35970,36570,35860,36570,36270,660,360,8120,"147,294.44",32490
,20160223,36570,36270,36620,36770,36310,36340,36500,70,230,5040,"92,004.62",33384
,20160224,36340,36500,36380,36440,35940,36010,36130,-490,-370,8090,"146,179.53",32492
,20160225,36010,36130,36010,36450,35860,36060,36160,-70,30,11710,"211,759.72",33176
,20160226,36060,36160,36120,36220,35660,36000,35900,-160,-260,17766,"318,959.28",38994
,20160229,36000,35900,36270,36760,35770,35980,36210,80,310,24658,"446,494.67",41660
,20160301,35980,36210,36090,36230,35640,36100,35960,-110,-250,14392,"258,826.15",42582
,20160302,36100,35960,36280,37180,36100,37050,36580,1090,620,25994,"475,517.34",47828
,20160303,37050,36580,37000,37320,36950,37190,37170,610,590,40394,"750,800.55",53386
,20160304,37190,37170,37320,38200,37190,38120,37750,950,580,64338,"1,214,635.21",56848
,20160307,38120,37750,38100,39320,37810,38240,38360,490,610,44200,"847,759.02",56364
,20160308,38240,38360,38420,38760,37620,37880,38110,-480,-250,38484,"733,435.75",57376
,20160309,37880,38110,37920,38070,36940,37510,37350,-600,-760,39914,"745,449.68",58432
,20160310,37510,37350,37620,37830,37410,37500,37580,150,230,19016,"357,375.79",59880
,20160311,37500,37580,37500,37890,37230,37880,37550,300,-30,27468,"515,827.19",63478
,20160314,37880,37550,37730,38320,37660,37870,37940,320,390,25112,"476,398.15",66086
,20160315,37870,37940,37850,37890,37310,37480,37510,-460,-430,20140,"377,749.26",68234
,20160316,37480,37510,37380,37780,37270,37720,37530,210,20,20438,"383,572.13",71198
,20160317,37720,37530,37640,38140,37560,38080,37930,550,400,23840,"452,234.02",74118
,20160318,38080,37930,38080,38820,38010,38550,38440,620,510,47640,"915,813.26",80018
,20160321,38550,38440,38440,38580,38070,38290,38320,-150,-120,29018,"556,073.88",80094
,20160322,38290,38320,38340,38550,38200,38290,38360,-30,40,19504,"374,174.22",81010
,20160323,38290,38360,38330,38550,38180,38280,38370,-80,10,25052,"480,716.10",84918
,20160324,38280,38370,38240,38240,37560,37760,37760,-610,-610,44274,"836,073.41",87014
,20160325,37760,37760,37640,37910,37530,37840,37750,80,-10,20204,"381,446.69",91336
,20160328,37840,37750,37850,37960,37590,37620,37800,-130,50,17866,"337,704.82",95514
,20160329,37620,37800,37650,38110,37500,37570,37730,-230,-70,35146,"663,189.30",100544
,20160330,37570,37730,37580,37640,36830,36990,37220,-740,-510,69380,"1,291,463.97",110568
,20160331,36990,37220,37060,37260,36620,36860,36840,-360,-380,56874,"1,047,871.45",121762
,20160401,36860,36840,36830,37140,36740,37120,37010,280,170,50474,"934,054.62",122642
,20160405,37120,37010,36740,36850,36500,36740,36710,-270,-300,36066,"661,994.16",123184
,20160406,36740,36710,36640,36800,36560,36720,36700,10,-10,34744,"637,597.56",125618
,20160407,36720,36700,36550,36850,36550,36650,36710,-50,10,39816,"730,900.46",129712
,20160408,36650,36710,36350,36400,35600,35760,35880,-950,-830,84048,"1,508,051.28",140078
,20160411,35760,35880,35740,36130,35710,35820,35900,-60,20,82266,"1,477,011.86",150086
,20160412,35820,35900,35780,36040,35600,36000,35870,100,-30,80400,"1,442,232.08",151490
,20160413,36000,35870,36070,37370,36030,36850,36750,980,880,218062,"4,007,175.39",157262
,20160414,36850,36750,36900,37140,36770,36840,36940,90,190,97722,"1,805,303.04",158718
,20160415,36840,36940,36990,37120,36730,36780,36970,-160,30,89678,"1,657,854.86",160484
,20160418,36780,36970,36700,37050,36560,36610,36790,-360,-180,113508,"2,088,408.04",162416
,20160419,36610,36790,36780,37160,36720,36900,36900,110,110,130168,"2,401,997.24",172646
,20160420,36900,36900,36970,37720,36930,37350,37390,450,490,220026,"4,113,717.31",176148
,20160421,37350,37390,37500,38260,37350,38120,37800,730,410,259166,"4,899,253.32",191774
,20160422,38120,37800,38410,38600,37490,37980,37960,180,160,275352,"5,227,357.76",194714
,20160425,37980,37960,38160,39040,37930,38170,38360,210,400,308976,"5,927,143.91",200872
,20160426,38170,38360,38200,38230,37530,37710,37850,-650,-510,232600,"4,403,096.04",201384
,20160427,37710,37850,37710,37950,37510,37630,37720,-220,-130,188230,"3,550,441.35",223068
,20160428,37630,37720,37600,37720,37010,37280,37280,-440,-440,261212,"4,869,454.93",256418
,20160429,37280,37280,37290,37800,37180,37660,37520,380,240,214126,"4,017,947.34",265734
,20160503,37660,37520,37780,37970,37420,37910,37680,390,160,199440,"3,757,523.04",273536
,20160504,37910,37680,37680,37780,37140,37230,37350,-450,-330,325310,"6,076,710.26",297920
,20160505,37230,37350,37220,37340,36820,36840,37060,-510,-290,380366,"7,050,028.03",315360
,20160506,36840,37060,36810,36920,36330,36620,36580,-440,-480,371676,"6,798,931.54",308860
,20160509,36620,36580,36540,36970,35780,35840,36270,-740,-310,574206,"10,415,843.60",339126
,20160510,35840,36270,35780,36080,35670,35950,35870,-320,-400,384000,"6,888,832.64",324560
,20160511,35950,35870,35880,36080,35690,35960,35920,90,50,328504,"5,901,056.84",334466
,20160512,35960,35920,36080,36520,35820,36240,36150,320,230,456792,"8,258,641.75",320998
,20160513,36240,36150,36240,36380,35030,35480,35560,-670,-590,644522,"11,460,301.45",330664
,20160516,35480,35560,35390,35770,35120,35610,35440,50,-120,384188,"6,809,437.70",328590
,20160517,35610,35440,35500,35960,35500,35900,35770,460,330,332574,"5,949,208.54",316784
,20160518,35900,35770,35700,35940,35290,35380,35590,-390,-180,469084,"8,349,195.26",320878
,20160519,35380,35590,35210,35640,35110,35200,35360,-390,-230,402516,"7,118,207.28",307112
,20160520,35200,35360,35160,35440,34820,35320,35200,-40,-160,391992,"6,900,529.96",300324
,20160523,35320,35200,35480,35570,34880,35170,35150,-30,-50,433462,"7,620,131.34",292744
,20160524,35170,35150,35200,35370,35030,35190,35210,40,60,304944,"5,368,979.09",277556
,20160525,35190,35210,35460,35700,35280,35490,35500,280,290,350164,"6,215,706.91",259468
,20160526,35490,35500,35750,36080,35640,36060,35840,560,340,302290,"5,417,337.11",248398
,20160527,36060,35840,36090,36210,35620,35910,35880,70,40,305036,"5,473,672.92",232554
,20160530,35910,35880,36040,36090,35650,35700,35790,-180,-90,220828,"3,952,757.68",216442
,20160531,35700,35790,35810,36000,35650,35780,35810,-10,20,155694,"2,787,810.77",198248
,20160601,35780,35810,35800,35880,35170,35230,35520,-580,-290,178840,"3,176,535.34",185484
,20160602,35230,35520,35240,35470,35100,35320,35310,-200,-210,106042,"1,872,343.88",175232
,20160603,35320,35310,35300,35790,35220,35740,35470,430,160,96162,"1,705,767.39",164746
,20160606,35740,35470,36150,36300,35700,36270,36100,800,630,96362,"1,739,668.76",150168
,20160607,36270,36100,36160,36300,35830,35890,36040,-210,-60,68236,"1,229,619.94",146974
,20160608,35890,36040,35360,35450,35170,35360,35340,-680,-700,91672,"1,620,187.58",149338
,20160613,35360,35340,35030,35600,34960,35300,35340,-40,0,71470,"1,263,034.48",142522
,20160614,35300,35340,35290,35590,35170,35200,35380,-140,40,61380,"1,085,914.77",138724
,20160615,35200,35380,35160,35440,35080,35410,35260,30,-120,54330,"957,980.34",134112
,20160616,35410,35260,35990,36060,35390,35440,35710,180,450,59234,"1,057,667.13",126368
,20160617,35440,35710,35280,35640,35200,35610,35420,-100,-290,49574,"877,984.27",121248
,20160620,35610,35420,35530,35670,35350,35490,35530,70,110,42604,"756,874.25",115508
,20160621,35490,35530,35610,35900,35510,35570,35690,40,160,46376,"827,771.03",107640
,20160622,35570,35690,35610,36250,35550,36230,35900,540,210,53028,"951,854.13",103846
,20160623,36230,35900,36200,36380,36050,36300,36170,400,270,40148,"726,128.00",98494
,20160624,36300,36170,36550,36720,35860,35950,36200,-220,30,72124,"1,305,573.61",93450
,20160627,35950,36200,36080,36690,36010,36660,36370,460,170,45098,"820,325.94",89434
,20160628,36660,36370,36480,37200,36410,37140,36830,770,460,54336,"1,000,734.43",79266
,20160629,37140,36830,37270,37410,36940,37120,37110,290,280,42214,"783,428.15",69980
,20160630,37120,37110,37150,37630,37010,37530,37430,420,320,34996,"655,056.88",61536
,20160701,37530,37430,37540,37560,37050,37270,37360,-160,-70,20156,"376,547.70",56320
,20160704,37270,37360,37200,38360,37200,38260,38030,900,670,27280,"518,799.00",51730
,20160705,38260,38030,38340,38340,37410,37700,37620,-330,-410,22350,"420,500.45",46380
,20160706,37700,37620,37680,37680,37000,37360,37320,-260,-300,18060,"337,044.15",44960
,20160707,37360,37320,36770,37200,36770,36860,37050,-460,-270,18280,"338,641.45",42720
,20160708,36860,37050,36970,37030,36500,36620,36590,-430,-460,15640,"286,198.65",39100
,20160711,36620,36590,36620,37070,36550,37020,36820,430,230,16970,"312,494.45",34200
,20160712,37020,36820,37150,37150,36900,37120,37010,300,190,13780,"255,055.35",28630
,20160713,37120,37010,37100,39200,36890,38530,38370,1520,1360,17560,"336,948.50",19840
,20160714,38530,38370,38720,38800,38110,38360,38310,-10,-60,6390,"122,429.60",17110
,20160715,38360,38310,37530,38420,37530,38420,38220,110,-90,2760,"52,752.95",15950
cu1608,20160104,36150,36270,36150,36150,35600,35670,35790,-600,-480,118,"2,111.67",4488
,20160105,35670,35790,35400,36230,35400,36100,35880,310,90,556,"9,977.07",4876
,20160106,36100,35880,36100,36180,35920,36030,35980,150,100,252,"4,534.20",4776
,20160107,36030,35980,36050,36050,35740,35740,35910,-240,-70,60,"1,077.30",4780
,20160108,35740,35910,35680,35710,35040,35400,35560,-510,-350,882,"15,684.85",5328
,20160111,35400,35560,35490,35520,34670,34670,34960,-890,-600,894,"15,631.08",5444
,20160112,34670,34960,34590,34910,34460,34460,34670,-500,-290,568,"9,848.60",5492
,20160113,34460,34670,34580,34800,34500,34600,34610,-70,-60,292,"5,054.45",5510
,20160114,34600,34610,34640,34790,34200,34740,34670,130,60,462,"8,009.15",5662
,20160115,34740,34670,34830,35030,34610,34610,34980,-60,310,356,"6,227.02",5768
,20160118,34610,34980,34160,35060,33510,34850,34750,-130,-230,316,"5,490.96",5838
,20160119,34850,34750,34800,35440,34740,35270,35030,520,280,104,"1,821.68",5872
,20160120,35270,35030,35260,35290,34860,35020,35050,-10,20,150,"2,628.83",5928
,20160121,35020,35050,34800,35100,34730,34740,34790,-310,-260,138,"2,400.72",6022
,20160122,34740,34790,34920,35240,34830,35100,35100,310,310,44,772.35,6018
,20160125,35100,35100,35200,35330,35030,35110,35110,10,10,214,"3,757.46",6132
,20160126,35110,35110,35150,35210,34950,35200,35150,90,40,410,"7,207.42",6198
,20160127,35200,35150,35500,36350,35350,35860,35670,710,520,2372,"42,305.56",6916
,20160128,35860,35670,35870,36090,35730,35730,35850,60,180,196,"3,513.45",6912
,20160129,35730,35850,35850,36000,35770,35890,35820,40,-30,2260,"40,485.79",8306
,20160201,35890,35820,35930,36000,35500,35740,35780,-80,-40,3000,"53,676.28",10630
,20160202,35740,35780,35720,36010,35720,35990,35880,210,100,1120,"20,094.39",11226
,20160203,35990,35880,36140,36140,35800,36110,36020,230,140,1282,"23,091.68",11498
,20160204,36110,36020,36090,36910,36090,36820,36580,800,560,1412,"25,830.61",11958
,20160205,36820,36580,36730,37000,36520,36730,36640,150,60,1184,"21,692.98",11692
,20160215,36730,36640,36030,36100,35870,36020,35980,-620,-660,1124,"20,225.20",11722
,20160216,36020,35980,35920,36190,35850,35890,35990,-90,10,880,"15,839.63",12012
,20160217,35890,35990,35910,36140,35640,35660,35820,-330,-170,1988,"35,605.91",12656
,20160218,35660,35820,35690,35950,35690,35860,35850,40,30,1114,"19,970.95",13232
,20160219,35860,35850,35810,36150,35700,36070,35850,220,0,1178,"21,116.79",13332
,20160222,36070,35850,36020,36590,35920,36590,36320,740,470,560,"10,171.63",13342
,20160223,36590,36320,36720,36790,35700,36400,36540,80,220,1412,"25,800.79",13542
,20160224,36400,36540,36420,36450,35940,36030,36160,-510,-380,848,"15,335.15",13814
,20160225,36030,36160,36050,36470,35910,36110,36200,-50,40,932,"16,870.16",13878
,20160226,36110,36200,36230,36240,35660,36000,35910,-200,-290,2220,"39,870.48",14692
,20160229,36000,35910,36330,36810,35800,36000,36320,90,410,3300,"59,938.42",15516
,20160301,36000,36320,36120,36250,35680,36150,35990,-170,-330,3600,"64,788.21",16806
,20160302,36150,35990,36250,37100,36130,37090,36670,1100,680,3802,"69,718.64",16300
,20160303,37090,36670,37000,37350,36990,37260,37210,590,540,7614,"141,670.48",18166
,20160304,37260,37210,37390,38200,37250,38200,37830,990,620,11856,"224,312.06",18904
,20160307,38200,37830,38200,39400,37860,38250,38430,420,600,5534,"106,342.91",19048
,20160308,38250,38430,38490,38800,37660,37920,38160,-510,-270,5126,"97,815.67",18888
,20160309,37920,38160,38040,38080,37000,37490,37380,-670,-780,5514,"103,060.21",19978
,20160310,37490,37380,37660,37860,37470,37520,37630,140,250,4040,"76,029.25",19734
,20160311,37520,37630,37520,37930,37280,37920,37670,290,40,3390,"63,850.81",21304
,20160314,37920,37670,37690,38350,37690,37950,38040,280,370,4388,"83,467.82",22378
,20160315,37950,38040,37880,37910,37360,37450,37570,-590,-470,2850,"53,550.18",23018
,20160316,37450,37570,37460,37820,37320,37800,37620,230,50,4188,"78,793.38",23870
,20160317,37800,37620,37610,38190,37600,38130,38020,510,400,4968,"94,448.03",25996
,20160318,38130,38020,38800,38840,38070,38590,38480,570,460,6100,"117,386.12",27844
,20160321,38590,38480,38460,38610,38100,38350,38360,-130,-120,5068,"97,229.00",29434
,20160322,38350,38360,38370,38580,38250,38330,38380,-30,20,3890,"74,667.38",30046
,20160323,38330,38380,38360,38590,38230,38350,38420,-30,40,3604,"69,233.82",30458
,20160324,38350,38420,38270,38270,37600,37750,37760,-670,-660,11756,"221,974.37",34454
,20160325,37750,37760,37660,37920,37580,37880,37800,120,40,5458,"103,159.93",37104
,20160328,37880,37800,37910,37980,37610,37650,37850,-150,50,6612,"125,163.16",39268
,20160329,37650,37850,37680,38120,37500,37590,37780,-260,-70,13758,"259,955.95",41444
,20160330,37590,37780,37620,37640,36840,36990,37240,-790,-540,17336,"322,839.28",43370
,20160331,36990,37240,37000,37250,36620,36880,36820,-360,-420,9002,"165,731.05",44328
,20160401,36880,36820,36820,37140,36730,37090,37030,270,210,9148,"169,377.17",43654
,20160405,37090,37030,36490,36920,36490,36750,36700,-280,-330,8502,"156,011.71",44516
,20160406,36750,36700,36580,36780,36570,36680,36700,-20,0,9744,"178,813.93",46958
,20160407,36680,36700,36500,36840,36500,36640,36710,-60,10,6534,"119,959.54",47730
,20160408,36640,36710,36300,36370,35600,35740,35860,-970,-850,19024,"341,189.13",51768
,20160411,35740,35860,35800,36120,35710,35820,35890,-40,30,18530,"332,593.10",56590
,20160412,35820,35890,35820,36010,35610,35980,35840,90,-50,19324,"346,345.06",61732
,20160413,35980,35840,36080,37360,36010,36820,36740,980,900,42036,"772,336.65",67954
,20160414,36820,36740,36870,37120,36740,36820,36910,80,170,18264,"337,085.37",71048
,20160415,36820,36910,36950,37090,36700,36750,36950,-160,40,14952,"276,294.20",73534
,20160418,36750,36950,36700,37020,36550,36600,36760,-350,-190,26366,"484,609.91",80972
,20160419,36600,36760,36690,37110,36690,36860,36850,100,90,29330,"540,459.96",88764
,20160420,36860,36850,36940,37690,36890,37360,37380,510,530,47396,"885,835.64",90428
,20160421,37360,37380,37530,38300,37320,38130,37810,750,430,69194,"1,308,425.92",98660
,20160422,38130,37810,38390,38600,37470,37960,37960,150,150,57816,"1,097,628.66",98544
,20160425,37960,37960,38180,39010,37910,38160,38380,200,420,74356,"1,427,148.67",95850
,20160426,38160,38380,38180,38220,37540,37730,37850,-650,-530,57290,"1,084,224.59",99278
,20160427,37730,37850,37680,37950,37520,37640,37720,-210,-130,35586,"671,198.77",102700
,20160428,37640,37720,37640,37730,37030,37290,37300,-430,-420,47916,"893,676.80",104978
,20160429,37290,37300,37350,37810,37210,37690,37560,390,260,45244,"849,813.96",110884
,20160503,37690,37560,37820,38030,37460,37940,37690,380,130,37712,"710,765.71",116292
,20160504,37940,37690,37690,37820,37170,37260,37390,-430,-300,53570,"1,001,551.08",121066
,20160505,37260,37390,37270,37350,36850,36880,37070,-510,-320,60932,"1,129,643.80",125438
,20160506,36880,37070,36840,36950,36360,36630,36610,-440,-460,58042,"1,062,473.64",125434
,20160509,36630,36610,36530,37000,35830,35900,36270,-710,-340,113548,"2,059,474.05",141654
,20160510,35900,36270,35800,36120,35710,35980,35900,-290,-370,79644,"1,429,830.90",146310
,20160511,35980,35900,35910,36120,35710,36020,35950,120,50,83716,"1,504,932.34",155676
,20160512,36020,35950,36120,36540,35860,36300,36210,350,260,115288,"2,087,513.47",162070
,20160513,36300,36210,36250,36420,35080,35540,35590,-670,-620,197864,"3,521,880.78",179744
,20160516,35540,35590,35440,35810,35170,35650,35500,60,-90,112504,"1,997,019.75",181538
,20160517,35650,35500,35600,35980,35560,35920,35820,420,320,111302,"1,993,749.90",186208
,20160518,35920,35820,35750,35970,35320,35400,35620,-420,-200,160858,"2,865,449.97",197056
,20160519,35400,35620,35270,35650,35090,35200,35350,-420,-270,165134,"2,919,154.84",209470
,20160520,35200,35350,35150,35440,34810,35330,35190,-20,-160,162794,"2,865,148.55",228204
,20160523,35330,35190,35480,35560,34880,35160,35150,-30,-40,192646,"3,386,542.92",237954
,20160524,35160,35150,35180,35340,35010,35150,35190,0,40,144702,"2,546,620.46",247044
,20160525,35150,35190,35450,35680,35270,35490,35490,300,300,196900,"3,494,265.83",250004
,20160526,35490,35490,35770,36080,35630,36050,35830,560,340,185346,"3,321,089.48",258550
,20160527,36050,35830,36090,36210,35610,35840,35860,10,30,229682,"4,119,314.11",280154
,20160530,35840,35860,35990,36060,35630,35710,35770,-150,-90,172624,"3,087,921.89",302688
,20160531,35710,35770,35780,35990,35640,35750,35800,-20,30,173512,"3,106,256.52",321466
,20160601,35750,35800,35810,35890,35120,35190,35480,-610,-320,323974,"5,747,723.38",360438
,20160602,35190,35480,35180,35460,35070,35280,35280,-200,-200,273418,"4,823,512.21",362532
,20160603,35280,35280,35250,35760,35170,35720,35420,440,140,296102,"5,245,037.77",351546
,20160606,35720,35420,36110,36300,35800,36260,36080,840,660,318566,"5,747,001.72",346128
,20160607,36260,36080,36150,36300,35800,35840,36040,-240,-40,267268,"4,816,799.08",335334
,20160608,35840,36040,35340,35390,35100,35230,35270,-810,-770,331978,"5,855,407.63",356466
,20160613,35230,35270,34880,35540,34850,35250,35280,-20,10,272286,"4,803,542.88",322280
,20160614,35250,35280,35200,35540,35080,35110,35320,-170,40,286756,"5,065,182.30",323586
,20160615,35110,35320,35100,35370,34980,35320,35170,0,-150,257364,"4,526,934.39",309524
,20160616,35320,35170,35890,36000,35330,35410,35690,240,520,313520,"5,594,972.60",284714
,20160617,35410,35690,35210,35600,35160,35560,35330,-130,-360,259350,"4,582,510.14",268414
,20160620,35560,35330,35410,35630,35320,35460,35470,130,140,226642,"4,020,304.09",264384
,20160621,35460,35470,35610,35880,35480,35570,35680,100,210,252478,"4,504,778.90",255898
,20160622,35570,35680,35650,36270,35530,36260,35890,580,210,345406,"6,198,994.42",252888
,20160623,36260,35890,36280,36390,36060,36270,36200,380,310,251632,"4,555,478.97",249130
,20160624,36270,36200,36550,36760,35850,35970,36280,-230,80,472024,"8,563,079.23",218592
,20160627,35970,36280,36120,36730,36020,36720,36400,440,120,337584,"6,144,405.79",204394
,20160628,36720,36400,36520,37250,36430,37190,36820,790,420,344604,"6,345,466.34",191484
,20160629,37190,36820,37310,37480,36980,37150,37220,330,400,238522,"4,439,813.50",185242
,20160630,37150,37220,37180,37640,37040,37500,37400,280,180,229304,"4,289,027.56",167500
,20160701,37500,37400,37420,37590,37110,37270,37340,-130,-60,151864,"2,835,735.38",152066
,20160704,37270,37340,37260,38440,37200,38330,37960,990,620,208424,"3,956,878.09",144296
,20160705,38330,37960,38400,38470,37400,37720,37810,-240,-150,130734,"2,471,989.51",136086
,20160706,37720,37810,37740,37780,36930,37380,37330,-430,-480,110452,"2,061,796.50",128838
,20160707,37380,37330,36850,37240,36800,36900,37020,-430,-310,90294,"1,671,642.04",121952
,20160708,36900,37020,36920,37050,36460,36630,36650,-390,-370,80666,"1,478,276.09",113632
,20160711,36630,36650,36760,37100,36540,37000,36790,350,140,51438,"946,432.11",109276
,20160712,37000,36790,37110,37220,36880,37150,37030,360,240,42022,"778,217.46",107662
,20160713,37150,37030,37450,39110,37220,38530,38340,1500,1310,120638,"2,312,952.74",113786
,20160714,38530,38340,38540,38750,38140,38530,38390,190,50,66074,"1,268,564.52",112156
,20160715,38530,38390,38480,38600,38180,38430,38350,40,-40,56746,"1,088,189.57",109514
,20160718,38430,38350,38620,38840,37750,37800,38070,-550,-280,72396,"1,378,175.52",102708
,20160719,37800,38070,37740,38480,37740,38220,38210,150,140,58108,"1,110,205.73",97720
,20160720,38220,38210,38280,38700,38060,38240,38320,30,110,56644,"1,085,448.42",92988
,20160721,38240,38320,38020,38600,37850,38580,38400,260,80,54176,"1,040,409.71",86810
,20160722,38580,38400,38520,38740,38120,38130,38350,-270,-50,44138,"846,352.20",81318
,20160725,38130,38350,38290,38570,37780,38130,38100,-220,-250,48812,"929,983.05",79984
,20160726,38130,38100,38130,38220,37600,37760,37740,-340,-360,44046,"831,257.77",74470
,20160727,37760,37740,37710,38020,37600,37710,37820,-30,80,37652,"712,157.15",70252
,20160728,37710,37820,37670,37820,37400,37750,37680,-70,-140,43306,"815,971.69",65232
,20160729,37750,37680,37800,37990,37410,37490,37730,-190,50,29826,"562,740.90",59814
,20160801,37490,37730,37580,38160,37410,38120,37870,390,140,23734,"449,445.45",53240
,20160802,38120,37870,37950,38000,37560,37840,37760,-30,-110,17060,"322,125.50",50990
,20160803,37840,37760,37990,38230,37580,37680,37780,-80,20,19170,"362,168.45",49260
,20160804,37680,37780,37650,37750,37330,37570,37540,-210,-240,21090,"395,926.85",45650
,20160805,37570,37540,37300,37670,37210,37500,37470,-40,-70,19810,"371,193.75",41440
,20160808,37500,37470,37400,37520,37280,37440,37440,-30,-30,20570,"385,133.85",39220
,20160809,37440,37440,37470,37550,37100,37150,37280,-290,-160,23250,"433,458.00",33770
,20160810,37150,37280,37110,37330,37100,37300,37240,20,-40,17970,"334,601.50",28610
,20160811,37300,37240,37500,37560,37310,37360,37360,120,120,13230,"247,159.60",22900
,20160812,37360,37360,37400,37480,37320,37410,37380,50,20,8620,"161,119.80",19250
,20160815,37410,37380,36280,37220,36280,37000,37040,-380,-340,5870,"108,728.05",18110
cu1609,20160104,36160,36220,36170,36170,35600,35600,35740,-620,-480,162,"2,895.42",2950
,20160105,35600,35740,35520,36170,35520,36170,35920,430,180,242,"4,346.59",2980
,20160106,36170,35920,36130,36160,35900,36020,35990,100,70,108,"1,943.60",2914
,20160107,36020,35990,35940,36130,35670,35860,35890,-130,-100,90,"1,615.34",2880
,20160108,35860,35890,35660,35670,35030,35440,35500,-450,-390,654,"11,611.01",3132
,20160111,35440,35500,35490,35530,34550,34550,34960,-950,-540,720,"12,587.44",3644
,20160112,34550,34960,34590,34910,34410,34410,34640,-550,-320,562,"9,736.13",3908
,20160113,34410,34640,34540,34800,34470,34570,34590,-70,-50,310,"5,362.38",4072
,20160114,34570,34590,34560,34770,34190,34730,34530,140,-60,654,"11,293.76",4130
,20160115,34730,34530,34800,35080,34600,34610,34870,80,340,158,"2,755.40",4124
,20160118,34610,34870,34320,35040,34320,34820,34740,-50,-130,382,"6,637.07",4180
,20160119,34820,34740,34770,35450,34770,35330,35130,590,390,198,"3,478.40",4166
,20160120,35330,35130,35270,35280,34850,34930,35020,-200,-110,102,"1,786.49",4196
,20160121,34930,35020,34850,35120,34740,34750,34770,-270,-250,1872,"32,552.43",5752
,20160122,34750,34770,34840,35290,34840,35100,35080,330,310,78,"1,368.50",5774
,20160125,35100,35080,35310,35310,34980,35110,35100,30,20,234,"4,107.04",5768
,20160126,35110,35100,35000,35250,34990,35240,35090,140,-10,172,"3,017.92",5748
,20160127,35240,35090,35460,35960,35410,35850,35670,760,580,552,"9,845.00",5798
,20160128,35850,35670,35860,36170,35760,35760,35850,90,180,534,"9,574.40",6142
,20160129,35760,35850,35820,36240,35740,35860,35910,10,60,510,"9,158.52",5928
,20160201,35860,35910,36000,36000,35720,35750,35890,-160,-20,312,"5,599.27",5916
,20160202,35750,35890,35730,36040,35730,36040,35980,150,90,426,"7,665.83",5742
,20160203,36040,35980,36040,36190,35850,36170,35970,190,-10,1194,"21,477.96",6388
,20160204,36170,35970,36150,36960,36150,36850,36670,880,700,762,"13,974.80",6374
,20160205,36850,36670,36810,37040,36580,36790,36720,120,50,440,"8,080.34",6190
,20160215,36790,36720,36180,36180,35900,36060,36020,-660,-700,582,"10,483.00",6144
,20160216,36060,36020,35900,36220,35900,35910,35990,-110,-30,494,"8,891.78",6292
,20160217,35910,35990,35650,36150,35650,35720,35860,-270,-130,652,"11,692.24",6370
,20160218,35720,35860,35810,35950,35800,35870,35880,10,20,242,"4,341.80",6424
,20160219,35870,35880,35990,36200,35750,36110,35920,230,40,684,"12,286.73",6654
,20160222,36110,35920,36000,36600,35920,36600,36420,680,500,948,"17,265.97",6770
,20160223,36600,36420,36680,36820,36380,36450,36620,30,200,658,"12,048.87",6932
,20160224,36450,36620,36490,36500,36010,36080,36230,-540,-390,276,"5,000.72",6914
,20160225,36080,36230,36010,36500,35960,36150,36260,-80,30,188,"3,408.64",6918
,20160226,36150,36260,36280,36280,35760,36070,35980,-190,-280,1026,"18,460.95",7440
,20160229,36070,35980,36340,36830,35850,36020,36360,40,380,838,"15,237.08",7590
,20160301,36020,36360,36060,36230,35710,36190,35980,-170,-380,596,"10,723.05",7598
,20160302,36190,35980,36230,37130,36150,37130,36660,1150,680,1048,"19,214.89",7408
,20160303,37130,36660,36840,37380,36840,37260,37240,600,580,870,"16,203.45",7512
,20160304,37260,37240,37270,38270,37270,38270,37820,1030,580,1376,"26,020.96",7470
,20160307,38270,37820,38120,39450,37900,38340,38450,520,630,1262,"24,265.62",7422
,20160308,38340,38450,38570,38870,37730,38000,38250,-450,-200,2310,"44,179.22",8394
,20160309,38000,38250,38120,38150,37050,37540,37430,-710,-820,1486,"27,814.71",8566
,20160310,37540,37430,37710,37920,37510,37580,37660,150,230,958,"18,043.31",8732
,20160311,37580,37660,37620,37990,37320,37980,37630,320,-30,1042,"19,607.50",8818
,20160314,37980,37630,37870,38420,37750,38000,38040,370,410,902,"17,156.36",8926
,20160315,38000,38040,37940,37940,37410,37520,37590,-520,-450,582,"10,938.80",8956
,20160316,37520,37590,37490,37850,37370,37800,37620,210,30,780,"14,672.51",8962
,20160317,37800,37620,37760,38260,37650,38200,38080,580,460,1026,"19,535.74",9382
,20160318,38200,38080,38220,38890,38100,38600,38580,520,500,1868,"36,042.24",9906
,20160321,38600,38580,38520,38610,38150,38320,38400,-260,-180,1160,"22,275.48",10130
,20160322,38320,38400,38420,38600,38300,38390,38450,-10,50,1130,"21,728.28",10626
,20160323,38390,38450,38380,38630,38250,38380,38480,-70,30,620,"11,931.79",10702
,20160324,38380,38480,38210,38210,37640,37770,37790,-710,-690,1850,"34,963.05",11458
,20160325,37770,37790,37750,37950,37600,37880,37840,90,50,904,"17,104.92",11654
,20160328,37880,37840,37950,37990,37640,37660,37940,-180,100,1932,"36,652.43",11896
,20160329,37660,37940,37710,38120,37510,37580,37740,-360,-200,2758,"52,056.87",11760
,20160330,37580,37740,37650,37650,36830,37010,37210,-730,-530,6086,"113,241.48",13364
,20160331,37010,37210,37100,37250,36620,37000,36790,-210,-420,4296,"79,037.10",14988
,20160401,37000,36790,36850,37130,36740,37130,37010,340,220,4304,"79,659.32",15334
,20160405,37130,37010,36560,36860,36530,36800,36710,-210,-300,3512,"64,466.07",15468
,20160406,36800,36710,36800,36800,36580,36720,36700,10,-10,3022,"55,456.92",16438
,20160407,36720,36700,36550,36810,36550,36630,36690,-70,-10,4940,"90,643.83",18004
,20160408,36630,36690,36390,36390,35600,35740,35860,-950,-830,9688,"173,715.26",21498
,20160411,35740,35860,35750,36100,35720,35820,35900,-40,40,6536,"117,341.83",23042
,20160412,35820,35900,35970,36010,35610,35970,35850,70,-50,6522,"116,925.68",24608
,20160413,35970,35850,36070,37360,36020,36870,36740,1020,890,17380,"319,284.34",24844
,20160414,36870,36740,36870,37110,36730,36840,36910,100,170,7890,"145,637.89",25402
,20160415,36840,36910,36950,37090,36700,36720,36940,-190,30,7132,"131,730.92",25870
,20160418,36720,36940,36710,37000,36560,36580,36770,-360,-170,9692,"178,231.26",27848
,20160419,36580,36770,36710,37100,36670,36870,36870,100,100,11336,"208,996.10",29974
,20160420,36870,36870,36960,37700,36900,37350,37350,480,480,22150,"413,723.43",31254
,20160421,37350,37350,37510,38360,37300,38180,37920,830,570,50032,"948,672.88",48102
,20160422,38180,37920,38310,38650,37470,37970,37960,50,40,36290,"688,850.20",44964
,20160425,37970,37960,38100,39010,37920,38130,38340,170,380,48412,"928,280.87",45028
,20160426,38130,38340,38160,38220,37570,37740,37860,-600,-480,26296,"497,913.66",48980
,20160427,37740,37860,37750,37960,37540,37660,37740,-200,-120,20424,"385,410.70",54366
,20160428,37660,37740,37720,37740,37050,37300,37320,-440,-420,20966,"391,327.49",56730
,20160429,37300,37320,37360,37820,37230,37720,37550,400,230,17214,"323,242.76",56380
,20160503,37720,37550,37810,38000,37500,37940,37740,390,190,15526,"293,031.02",58954
,20160504,37940,37740,37760,37960,37190,37270,37390,-470,-350,21742,"406,544.40",62480
,20160505,37270,37390,37270,37370,36900,36900,37100,-490,-290,25048,"464,716.75",66092
,20160506,36900,37100,36960,36980,36330,36660,36630,-440,-470,26202,"479,982.45",65624
,20160509,36660,36630,36580,37030,35870,35910,36330,-720,-300,39000,"708,523.25",71460
,20160510,35910,36330,35830,36160,35740,36010,35950,-320,-380,28932,"520,168.05",69888
,20160511,36010,35950,35980,36160,35740,36070,35970,120,20,22168,"398,787.40",71744
,20160512,36070,35970,36220,36580,35900,36360,36270,390,300,29786,"540,296.23",71870
,20160513,36360,36270,36290,36470,35000,35570,35610,-700,-660,44492,"792,296.28",74032
,20160516,35570,35610,35450,35860,35220,35720,35550,110,-60,31866,"566,521.16",77512
,20160517,35720,35550,35700,36020,35640,35980,35860,430,310,29744,"533,426.94",80082
,20160518,35980,35860,35760,36000,35360,35430,35650,-430,-210,38500,"686,391.64",84786
,20160519,35430,35650,35300,35660,35110,35210,35360,-440,-290,44752,"791,365.48",89706
,20160520,35210,35360,35190,35460,34840,35370,35230,10,-130,41068,"723,423.90",95802
,20160523,35370,35230,35500,35590,34900,35190,35150,-40,-80,54178,"952,409.35",100880
,20160524,35190,35150,35180,35360,35040,35190,35210,40,60,30788,"542,156.56",104430
,20160525,35190,35210,35490,35680,35280,35500,35500,290,290,43372,"769,952.77",106816
,20160526,35500,35500,35710,36080,35620,36050,35840,550,340,51234,"918,202.10",113688
,20160527,36050,35840,36060,36210,35630,35890,35870,50,30,53560,"960,799.80",115594
,20160530,35890,35870,36010,36050,35640,35720,35770,-150,-100,49864,"891,893.77",121846
,20160531,35720,35770,35760,36010,35650,35820,35820,50,50,44696,"800,523.58",129570
,20160601,35820,35820,35840,35910,35140,35210,35480,-610,-340,79666,"1,413,458.78",148222
,20160602,35210,35480,35200,35470,35080,35280,35300,-200,-180,66820,"1,179,449.03",155466
,20160603,35280,35300,35220,35740,35180,35700,35400,400,100,71462,"1,265,150.75",159212
,20160606,35700,35400,36070,36280,35800,36270,36070,870,670,77406,"1,396,344.67",159304
,20160607,36270,36070,36180,36290,35800,35850,36020,-220,-50,63370,"1,141,430.19",164114
,20160608,35850,36020,35310,35390,35110,35250,35280,-770,-740,93838,"1,655,429.04",166888
,20160613,35250,35280,34890,35520,34850,35240,35260,-40,-20,93706,"1,652,375.98",162596
,20160614,35240,35260,35210,35520,35060,35100,35310,-160,50,101238,"1,787,839.25",166008
,20160615,35100,35310,35100,35340,34960,35290,35150,-20,-160,86404,"1,518,773.01",170032
,20160616,35290,35150,35890,35950,35310,35370,35660,220,510,96926,"1,728,226.35",172178
,20160617,35370,35660,35200,35570,35140,35550,35310,-110,-350,97750,"1,726,235.41",178204
,20160620,35550,35310,35430,35600,35280,35440,35450,130,140,86138,"1,526,827.37",180844
,20160621,35440,35450,35580,35850,35450,35530,35640,80,190,104040,"1,854,327.08",184842
,20160622,35530,35640,35600,36250,35500,36210,35860,570,220,137860,"2,472,042.23",191576
,20160623,36210,35860,36260,36360,36040,36260,36180,400,320,115314,"2,086,197.63",196122
,20160624,36260,36180,36550,36750,35700,35940,36230,-240,50,272494,"4,936,567.54",207946
,20160627,35940,36230,36070,36730,35980,36720,36380,490,150,203636,"3,705,151.27",218894
,20160628,36720,36380,36500,37280,36460,37200,36870,820,490,263022,"4,849,816.10",242292
,20160629,37200,36870,37300,37500,37010,37220,37260,350,390,215762,"4,019,763.28",249728
,20160630,37220,37260,37250,37690,37080,37530,37470,270,210,261792,"4,905,279.05",248882
,20160701,37530,37470,37440,37630,37140,37300,37380,-170,-90,320148,"5,983,568.93",250822
,20160704,37300,37380,37290,38510,37220,38410,38040,1030,660,682034,"12,973,536.34",293484
,20160705,38410,38040,38440,38540,37470,37790,37880,-250,-160,492320,"9,326,411.37",281800
,20160706,37790,37880,37760,37850,36950,37380,37390,-500,-490,485598,"9,078,454.47",262294
,20160707,37380,37390,36880,37290,36820,36910,37050,-480,-340,371704,"6,886,756.95",253368
,20160708,36910,37050,36960,37100,36450,36620,36680,-430,-370,381592,"6,999,410.46",259412
,20160711,36620,36680,36800,37130,36540,37020,36800,340,120,302506,"5,566,118.64",260408
,20160712,37020,36800,37140,37260,36900,37180,37060,380,260,253784,"4,703,214.74",263540
,20160713,37180,37060,37500,39210,37260,38580,38350,1520,1290,876672,"16,810,849.85",295230
,20160714,38580,38350,38660,38820,38190,38640,38470,290,120,448580,"8,629,223.54",306792
,20160715,38640,38470,38530,38710,38230,38500,38420,30,-50,361670,"6,949,252.54",309744
,20160718,38500,38420,38700,38930,37800,37850,38230,-570,-190,497462,"9,511,271.38",298892
,20160719,37850,38230,37790,38550,37790,38300,38240,70,10,415374,"7,943,951.25",283666
,20160720,38300,38240,38380,38800,38110,38280,38460,40,220,463442,"8,912,122.22",276684
,20160721,38280,38460,38020,38690,37870,38650,38400,190,-60,351616,"6,752,490.70",270376
,20160722,38650,38400,38570,38840,38160,38180,38460,-220,60,336090,"6,464,443.74",260900
,20160725,38180,38460,38350,38650,37830,38160,38180,-300,-280,420530,"8,029,151.15",249108
,20160726,38160,38180,38170,38250,37600,37810,37810,-370,-370,322706,"6,102,369.14",236284
,20160727,37810,37810,37770,38090,37620,37740,37890,-70,80,308300,"5,840,782.06",225788
,20160728,37740,37890,37700,37890,37430,37820,37700,-70,-190,307786,"5,803,111.48",207992
,20160729,37820,37700,37880,38060,37430,37470,37810,-230,110,297570,"5,625,667.96",189826
,20160801,37470,37810,37580,38250,37460,38170,37880,360,70,313708,"5,942,498.02",175052
,20160802,38170,37880,38030,38090,37590,37940,37850,60,-30,186076,"3,522,364.94",163298
,20160803,37940,37850,38040,38350,37610,37730,37950,-120,100,142930,"2,712,711.38",157456
,20160804,37730,37950,37660,37820,37380,37570,37590,-380,-360,119230,"2,240,946.26",149410
,20160805,37570,37590,37310,37710,37230,37550,37480,-40,-110,85252,"1,598,001.86",142164
,20160808,37550,37480,37450,37590,37300,37470,37450,-10,-30,72512,"1,357,871.35",137400
,20160809,37470,37450,37460,37670,37140,37180,37380,-270,-70,69620,"1,301,242.51",136112
,20160810,37180,37380,37090,37450,37060,37430,37290,50,-90,56464,"1,052,876.02",136276
,20160811,37430,37290,37700,37710,37380,37470,37500,180,210,53376,"1,000,997.82",135180
,20160812,37470,37500,37470,37600,37390,37500,37480,0,-20,38888,"728,828.94",132438
,20160815,37500,37480,37300,37300,36920,36980,37150,-500,-330,62596,"1,162,762.26",129336
,20160816,36980,37150,36980,37220,36980,37160,37080,10,-70,50124,"929,504.01",121874
,20160817,37160,37080,37230,37310,37110,37160,37200,80,120,35362,"657,788.78",116932
,20160818,37160,37200,37100,37340,37030,37310,37170,110,-30,31732,"589,878.16",114660
,20160819,37310,37170,37410,37410,37170,37330,37230,160,60,28198,"524,919.06",110554
,20160822,37330,37230,37260,37320,37050,37070,37180,-160,-50,36986,"687,676.05",105858
,20160823,37070,37180,37010,37150,36900,37090,37080,-90,-100,30698,"569,149.28",97978
,20160824,37090,37080,36990,37000,36630,36640,36770,-440,-310,51102,"939,745.84",86824
,20160825,36640,36770,36540,36620,36040,36330,36310,-440,-460,52290,"949,383.81",76078
,20160826,36330,36310,36270,36490,36160,36430,36340,120,30,31290,"568,648.85",68362
,20160829,36430,36340,36350,36590,36210,36420,36370,80,30,28626,"520,616.23",59946
,20160830,36420,36370,36370,36500,36240,36250,36390,-120,20,27350,"497,695.15",52942
,20160831,36250,36390,36220,36350,36120,36320,36270,-70,-120,25428,"461,263.34",43610
,20160901,36320,36270,36300,36600,36180,36500,36420,230,150,18180,"331,070.80",40150
,20160902,36500,36420,36430,36640,36350,36600,36500,180,80,15410,"281,285.90",38580
,20160905,36600,36500,36610,37400,36440,36500,36540,0,40,14690,"268,444.70",35310
,20160906,36500,36540,36480,36570,36370,36530,36500,-10,-40,17950,"327,660.85",31630
,20160907,36530,36500,36480,36780,36430,36700,36670,200,170,18390,"337,267.10",26990
,20160908,36700,36670,36700,36750,36530,36550,36620,-120,-50,16170,"296,103.30",23410
,20160909,36550,36620,36550,36680,36470,36610,36610,-10,-10,13320,"243,868.40",20300
,20160912,36610,36610,36550,36580,36190,36200,36340,-410,-270,24230,"440,281.40",14080
,20160913,36200,36340,36290,36590,36290,36590,36520,250,180,10290,"187,938.60",10980
,20160914,36590,36520,36680,36780,36480,36770,36660,250,140,6160,"112,917.60",7380
,20160919,36770,36660,36950,37150,36950,37150,37070,490,410,2010,"37,263.40",6190
cu1610,20160104,36150,36220,36090,36090,35560,35610,35710,-610,-510,104,"1,857.36",3590
,20160105,35610,35710,35690,36170,35570,36170,35840,460,130,160,"2,867.98",3604
,20160106,36170,35840,36160,36180,35870,35990,36010,150,170,136,"2,449.25",3612
,20160107,35990,36010,35950,36080,35690,35760,35940,-250,-70,684,"12,293.37",3978
,20160108,35760,35940,35630,35710,35060,35410,35400,-530,-540,356,"6,302.84",4054
,20160111,35410,35400,35460,35500,34600,34610,34990,-790,-410,522,"9,134.59",4394
,20160112,34610,34990,34610,34790,34380,34380,34600,-610,-390,238,"4,117.40",4414
,20160113,34380,34600,34550,34940,34380,34610,34580,10,-20,192,"3,320.09",4400
,20160114,34610,34580,34550,34720,34200,34710,34440,130,-140,206,"3,548.29",4398
,20160115,34710,34440,34680,35010,34570,34570,34840,130,400,230,"4,006.68",4448
,20160118,34570,34840,34370,34900,34370,34760,34720,-80,-120,108,"1,875.16",4454
,20160119,34760,34720,34850,35400,34750,35200,34990,480,270,74,"1,294.95",4462
,20160120,35200,34990,35260,35260,34920,34920,35020,-70,30,90,"1,576.10",4462
,20160121,34920,35020,34870,35090,34710,34760,34810,-260,-210,114,"1,984.46",4476
,20160122,34760,34810,34850,35210,34850,35090,35070,280,260,56,981.97,4510
,20160125,35090,35070,35240,35250,35050,35150,35130,80,60,112,"1,967.32",4538
,20160126,35150,35130,35120,35270,34980,35220,35120,90,-10,148,"2,599.08",4554
,20160127,35220,35120,35440,35970,35430,35870,35710,750,590,194,"3,464.78",4538
,20160128,35870,35710,35790,35940,35780,35780,35870,70,160,74,"1,327.43",4524
,20160129,35780,35870,35830,36010,35720,35880,35830,10,-40,176,"3,153.41",4544
,20160201,35880,35830,35880,36010,35700,35700,35880,-130,50,138,"2,475.72",4550
,20160202,35700,35880,35760,36070,35760,36060,35950,180,70,238,"4,278.40",4480
,20160203,36060,35950,36040,36200,35830,36150,36020,200,70,208,"3,746.84",4452
,20160204,36150,36020,36190,36970,36190,36900,36650,880,630,856,"15,687.42",4432
,20160205,36900,36650,36860,36970,36610,36840,36740,190,90,196,"3,601.01",4450
,20160215,36840,36740,36140,36220,35980,36120,36100,-620,-640,200,"3,610.68",4500
,20160216,36120,36100,35990,36280,35960,35960,36050,-140,-50,160,"2,884.11",4516
,20160217,35960,36050,35950,36180,35760,35760,35880,-290,-170,194,"3,480.46",4520
,20160218,35760,35880,35820,36000,35820,35950,35910,70,30,82,"1,472.47",4516
,20160219,35950,35910,36010,36210,35760,36180,36020,270,110,274,"4,934.93",4538
,20160222,36180,36020,36090,36660,35930,36660,36380,640,360,126,"2,291.94",4532
,20160223,36660,36380,36780,36880,36430,36480,36640,100,260,370,"6,780.04",4506
,20160224,36480,36640,36570,36570,36070,36100,36330,-540,-310,244,"4,432.92",4516
,20160225,36100,36330,35980,36550,35980,36100,36310,-230,-20,240,"4,357.25",4512
,20160226,36100,36310,36120,36150,35780,36150,36000,-160,-310,644,"11,592.17",4726
,20160229,36150,36000,36380,36850,35880,35940,36430,-60,430,400,"7,287.46",4706
,20160301,35940,36430,36110,36340,35750,36210,36000,-220,-430,708,"12,745.39",4818
,20160302,36210,36000,36300,37160,36200,37160,36730,1160,730,380,"6,978.91",4792
,20160303,37160,36730,37100,37390,37070,37340,37280,610,550,554,"10,327.60",4858
,20160304,37340,37280,37470,38270,37330,38270,37740,990,460,742,"14,002.89",4934
,20160307,38270,37740,38100,39300,37950,38350,38500,610,760,618,"11,898.81",4930
,20160308,38350,38500,38650,39010,37890,38050,38360,-450,-140,336,"6,444.77",4972
,20160309,38050,38360,38140,38140,37150,37590,37450,-770,-910,748,"14,007.28",5074
,20160310,37590,37450,37850,37970,37570,37630,37730,180,280,226,"4,263.89",5064
,20160311,37630,37730,37650,38020,37390,38020,37690,290,-40,350,"6,596.99",5052
,20160314,38020,37690,37900,38420,37900,38040,38130,350,440,146,"2,783.94",5038
,20160315,38040,38130,37890,37890,37450,37550,37640,-580,-490,196,"3,688.97",5090
,20160316,37550,37640,37550,37900,37550,37900,37710,260,70,54,"1,018.27",5094
,20160317,37900,37710,37770,38270,37770,38220,38100,510,390,188,"3,582.02",5106
,20160318,38220,38100,38200,38910,38170,38590,38600,490,500,364,"7,026.16",5096
,20160321,38590,38600,38630,38660,38200,38430,38390,-170,-210,402,"7,717.68",5154
,20160322,38430,38390,38430,38680,38360,38400,38510,10,120,220,"4,236.62",5214
,20160323,38400,38510,38420,38650,38360,38430,38520,-80,10,58,"1,117.30",5214
,20160324,38430,38520,38180,38180,37690,37820,37820,-700,-700,480,"9,078.59",5344
,20160325,37820,37820,37720,37960,37650,37960,37880,140,60,210,"3,978.01",5434
,20160328,37960,37880,38000,38070,37700,37700,37970,-180,90,394,"7,481.07",5434
,20160329,37700,37970,37730,38150,37530,37580,37790,-390,-180,810,"15,308.29",5638
,20160330,37580,37790,37650,37650,36840,37010,37280,-780,-510,2442,"45,529.59",6920
,20160331,37010,37280,37090,37250,36650,36860,36810,-420,-470,920,"16,934.32",7222
,20160401,36860,36810,36850,37150,36770,37140,37050,330,240,1032,"19,120.79",7544
,20160405,37140,37050,36800,36850,36580,36750,36720,-300,-330,504,"9,255.28",7714
,20160406,36750,36720,36620,36810,36620,36710,36710,-10,-10,590,"10,829.68",7682
,20160407,36710,36710,36890,38470,36590,36640,36710,-70,0,828,"15,199.33",7800
,20160408,36640,36710,36340,36340,35640,35760,35910,-950,-800,2012,"36,134.02",8410
,20160411,35760,35910,35850,36110,35750,35800,35910,-110,0,1370,"24,598.61",8912
,20160412,35800,35910,35860,36020,35650,36000,35850,90,-60,856,"15,346.43",9026
,20160413,36000,35850,36100,37350,36040,36850,36750,1000,900,2172,"39,912.96",9074
,20160414,36850,36750,37510,37520,36770,36830,36920,80,170,1490,"27,509.78",9502
,20160415,36830,36920,36950,37080,36740,36740,36940,-180,20,1104,"20,395.48",9732
,20160418,36740,36940,36650,36990,36550,36590,36760,-350,-180,908,"16,690.58",10172
,20160419,36590,36760,36720,37070,36720,36890,36920,130,160,1550,"28,616.09",10580
,20160420,36890,36920,37000,37680,36900,37400,37390,480,470,2532,"47,335.74",10642
,20160421,37400,37390,37430,38400,37360,38230,37970,840,580,3642,"69,146.31",11026
,20160422,38230,37970,38480,38650,37500,37960,37960,-10,-10,2408,"45,713.50",10830
,20160425,37960,37960,38180,39000,37970,38170,38320,210,360,2364,"45,305.85",11050
,20160426,38170,38320,38220,38220,37600,37780,37900,-540,-420,1428,"27,061.95",11100
,20160427,37780,37900,37780,37970,37580,37690,37780,-210,-120,694,"13,110.59",11150
,20160428,37690,37780,37670,37760,37100,37330,37300,-450,-480,2304,"42,970.28",11802
,20160429,37330,37300,37400,37870,37270,37740,37620,440,320,1614,"30,364.52",12136
,20160503,37740,37620,37880,38040,37530,38030,37800,410,180,1598,"30,206.92",12354
,20160504,38030,37800,37760,37880,37220,37270,37440,-530,-360,2346,"43,918.21",12748
,20160505,37270,37440,37290,37400,36930,36930,37100,-510,-340,3216,"59,663.89",12830
,20160506,36930,37100,36950,36990,36430,36700,36640,-400,-460,3996,"73,220.54",13684
,20160509,36700,36640,36630,37050,35900,35930,36350,-710,-290,4894,"88,960.09",14816
,20160510,35930,36350,35950,36180,35780,36040,35970,-310,-380,4148,"74,610.98",15502
,20160511,36040,35970,36020,36180,35790,36100,36030,130,60,3570,"64,315.41",15884
,20160512,36100,36030,36180,36620,35900,36410,36350,380,320,4688,"85,204.87",15850
,20160513,36410,36350,36360,36520,35210,35640,35650,-710,-700,8116,"144,685.21",17504
,20160516,35640,35650,35520,35900,35280,35790,35630,140,-20,4728,"84,230.03",17718
,20160517,35790,35630,35740,36070,35730,36020,35930,390,300,6298,"113,163.21",18266
,20160518,36020,35930,35810,36030,35400,35490,35690,-440,-240,10022,"178,853.81",19522
,20160519,35490,35690,35300,35680,35150,35270,35420,-420,-270,9408,"166,619.06",20292
,20160520,35270,35420,35200,35480,34860,35390,35270,-30,-150,9724,"171,515.36",21272
,20160523,35390,35270,35550,35620,34950,35190,35170,-80,-100,12292,"216,202.27",23546
,20160524,35190,35170,35220,35390,35080,35200,35250,30,80,5314,"93,671.20",24108
,20160525,35200,35250,35540,35690,35310,35520,35520,270,270,9664,"171,665.33",24770
,20160526,35520,35520,35790,36080,35640,36080,35850,560,330,9658,"173,137.58",26806
,20160527,36080,35850,36140,36220,35650,35890,35910,40,60,7586,"136,208.97",27140
,20160530,35890,35910,35970,36020,35660,35760,35800,-150,-110,8916,"159,598.04",28234
,20160531,35760,35800,35830,36030,35680,35850,35860,50,60,7774,"139,411.79",30112
,20160601,35850,35860,35870,35940,35170,35240,35450,-620,-410,12708,"225,277.43",32122
,20160602,35240,35450,35240,35490,35120,35320,35310,-130,-140,17090,"301,769.17",34346
,20160603,35320,35310,35300,35720,35180,35700,35460,390,150,13954,"247,470.99",35644
,20160606,35700,35460,36050,36320,35810,36250,36100,790,640,23030,"415,712.08",36616
,20160607,36250,36100,36190,36290,35810,35840,36040,-260,-60,11916,"214,763.02",37774
,20160608,35840,36040,35450,35450,35140,35250,35290,-790,-750,20850,"367,997.71",42278
,20160613,35250,35290,34990,35520,34840,35240,35250,-50,-40,17268,"304,424.46",43936
,20160614,35240,35250,35210,35500,35070,35090,35310,-160,60,16310,"288,024.81",46168
,20160615,35090,35310,35070,35320,34970,35300,35140,-10,-170,21574,"379,065.20",49040
,20160616,35300,35140,35830,35950,35310,35370,35630,230,490,18176,"323,853.02",50262
,20160617,35370,35630,35190,35550,35150,35540,35310,-90,-320,23298,"411,418.62",52308
,20160620,35540,35310,35450,35590,35280,35450,35450,140,140,16040,"284,361.90",53854
,20160621,35450,35450,35580,35820,35450,35530,35640,80,190,23256,"414,437.62",55352
,20160622,35530,35640,35540,36200,35500,36200,35860,560,220,27944,"501,070.42",59848
,20160623,36200,35860,36250,36340,36030,36240,36150,380,290,21954,"396,922.82",61588
,20160624,36240,36150,36580,36720,35820,35920,36190,-230,40,55024,"995,820.62",63748
,20160627,35920,36190,36040,36710,35970,36700,36390,510,200,39076,"710,998.83",69180
,20160628,36700,36390,36470,37250,36430,37130,36880,740,490,58600,"1,080,717.23",81226
,20160629,37130,36880,37290,37480,37010,37210,37220,330,340,44104,"820,904.69",84688
,20160630,37210,37220,37250,37700,37070,37550,37480,330,260,60958,"1,142,402.48",93630
,20160701,37550,37480,37450,37630,37130,37280,37370,-200,-110,58010,"1,083,956.13",95042
,20160704,37280,37370,37210,38520,37210,38430,38090,1060,720,131188,"2,498,787.81",105032
,20160705,38430,38090,38430,38530,37500,37790,37910,-300,-180,92414,"1,751,735.58",104516
,20160706,37790,37910,37800,37850,36980,37430,37410,-480,-500,78092,"1,460,732.32",102898
,20160707,37430,37410,36940,37300,36810,36950,37070,-460,-340,67390,"1,249,248.61",101386
,20160708,36950,37070,36960,37110,36460,36620,36660,-450,-410,81090,"1,486,655.09",107108
,20160711,36620,36660,36800,37130,36550,37020,36820,360,160,65800,"1,211,619.66",111066
,20160712,37020,36820,37120,37260,36920,37180,37080,360,260,59388,"1,101,145.79",114062
,20160713,37180,37080,37520,39210,37280,38620,38390,1540,1310,228744,"4,391,602.89",126354
,20160714,38620,38390,38710,38810,38200,38670,38470,280,80,110770,"2,131,154.40",130270
,20160715,38670,38470,38520,38700,38250,38480,38430,10,-40,96970,"1,863,712.26",131834
,20160718,38480,38430,38720,38920,37820,37840,38210,-590,-220,133652,"2,553,947.36",137208
,20160719,37840,38210,37830,38570,37800,38330,38290,120,80,142278,"2,724,599.61",145762
,20160720,38330,38290,38420,38830,38140,38410,38460,120,170,168214,"3,235,453.65",158190
,20160721,38410,38460,38130,38730,37930,38680,38470,220,10,142002,"2,731,787.28",170636
,20160722,38680,38470,38600,38900,38220,38220,38500,-250,30,139052,"2,677,339.87",169610
,20160725,38220,38500,38400,38690,37860,38210,38210,-290,-290,173264,"3,310,387.38",170600
,20160726,38210,38210,38220,38280,37650,37850,37850,-360,-360,130380,"2,467,975.15",173340
,20160727,37850,37850,37810,38130,37680,37800,37930,-50,80,142368,"2,700,290.82",179278
,20160728,37800,37930,37750,37950,37510,37890,37770,-40,-160,151922,"2,869,713.99",188276
,20160729,37890,37770,37960,38150,37490,37520,37870,-250,100,192998,"3,654,886.29",199022
,20160801,37520,37870,37690,38330,37500,38280,37980,410,110,265488,"5,041,934.13",223192
,20160802,38280,37980,38140,38160,37680,38020,37940,40,-40,245842,"4,664,209.65",225696
,20160803,38020,37940,38120,38450,37680,37790,38050,-150,110,341054,"6,488,696.03",234238
,20160804,37790,38050,37710,37910,37430,37620,37650,-430,-400,350780,"6,604,678.46",234164
,20160805,37620,37650,37300,37770,37280,37620,37540,-30,-110,307212,"5,766,627.45",225438
,20160808,37620,37540,37510,37680,37370,37540,37510,0,-30,257108,"4,823,206.43",231414
,20160809,37540,37510,37560,37760,37180,37220,37470,-290,-40,290706,"5,447,044.33",250054
,20160810,37220,37470,37160,37530,37100,37470,37350,0,-120,236298,"4,413,976.53",245182
,20160811,37470,37350,37790,37800,37450,37530,37600,180,250,248324,"4,669,403.49",238242
,20160812,37530,37600,37550,37690,37450,37560,37570,-40,-30,175934,"3,305,449.86",236262
,20160815,37560,37570,37230,37350,37000,37070,37210,-500,-360,244612,"4,551,307.30",241304
,20160816,37070,37210,37070,37290,37020,37220,37160,10,-50,212270,"3,944,723.88",238790
,20160817,37220,37160,37330,37390,37180,37220,37280,60,120,177690,"3,312,636.28",230482
,20160818,37220,37280,37180,37400,37090,37370,37230,90,-50,180484,"3,360,291.63",238920
,20160819,37370,37230,37480,37490,37230,37390,37330,160,100,159022,"2,968,264.98",234600
,20160822,37390,37330,37290,37390,37080,37140,37250,-190,-80,176644,"3,290,115.05",236770
,20160823,37140,37250,37020,37180,36910,37120,37090,-130,-160,146416,"2,715,675.17",236976
,20160824,37120,37090,36970,37040,36640,36650,36830,-440,-260,248346,"4,574,464.44",255570
,20160825,36650,36830,36530,36640,36050,36370,36330,-460,-500,308008,"5,596,276.48",232444
,20160826,36370,36330,36290,36530,36180,36430,36350,100,20,167726,"3,048,993.58",226274
,20160829,36430,36350,36380,36620,36210,36420,36370,70,20,184566,"3,357,208.01",216386
,20160830,36420,36370,36350,36520,36240,36260,36390,-110,20,119618,"2,176,756.65",210696
,20160831,36260,36390,36250,36390,36140,36270,36280,-120,-110,142170,"2,579,126.88",196118
,20160901,36270,36280,36260,36670,36230,36530,36450,250,170,139762,"2,547,484.08",179154
,20160902,36530,36450,36450,36690,36350,36640,36500,190,50,124228,"2,267,691.11",164622
,20160905,36640,36500,36650,36650,36440,36500,36540,0,40,78198,"1,429,056.19",154276
,20160906,36500,36540,36480,36610,36380,36550,36510,10,-30,58616,"1,070,113.47",147104
,20160907,36550,36510,36560,36850,36460,36730,36650,220,140,71790,"1,315,905.37",134922
,20160908,36730,36650,36770,36820,36520,36560,36650,-90,0,50582,"926,950.35",128598
,20160909,36560,36650,36560,36710,36460,36630,36620,-20,-30,43172,"790,570.37",122840
,20160912,36630,36620,36530,36620,36170,36180,36330,-440,-290,75770,"1,376,688.33",119484
,20160913,36180,36330,36250,36620,36250,36620,36510,290,180,53038,"968,299.55",109830
,20160914,36620,36510,36670,36800,36480,36720,36660,210,150,48344,"886,269.61",103844
,20160919,36720,36660,37100,37200,36930,37200,37090,540,430,50154,"930,115.50",92896
,20160920,37200,37090,37230,37300,37140,37240,37200,150,110,35520,"660,824.60",88852
,20160921,37240,37200,37300,37460,37160,37320,37280,120,80,36090,"672,819.23",82822
,20160922,37320,37280,37360,37630,37230,37600,37500,320,220,47464,"890,039.28",76062
,20160923,37600,37500,37710,37840,37620,37820,37710,320,210,38270,"721,629.01",67350
,20160926,37820,37710,37800,37840,37660,37720,37720,10,10,31398,"592,309.50",60468
,20160927,37720,37720,37700,37790,37480,37650,37580,-70,-140,39740,"746,794.85",52212
,20160928,37650,37580,37590,37590,37260,37490,37440,-90,-140,32958,"617,038.09",46330
,20160929,37490,37440,37530,37910,37520,37690,37800,250,360,25268,"477,646.19",41412
,20160930,37690,37800,37660,37870,37570,37760,37670,-40,-130,16516,"311,094.84",36046
,20161010,37760,37670,37600,37670,37500,37660,37540,-10,-130,21186,"397,760.51",29900
,20161011,37660,37540,37710,38150,37710,38150,37980,610,440,24030,"456,376.55",25520
,20161012,38150,37980,38020,38020,37780,37920,37920,-60,-60,18320,"347,419.40",19770
,20161013,37920,37920,38000,38080,37630,37710,37850,-210,-70,14100,"266,870.95",14930
,20161014,37710,37850,37310,37550,37250,37490,37480,-360,-370,13450,"252,053.50",8080
,20161017,37490,37480,37800,37800,37300,37300,37330,-180,-150,3260,"60,862.15",7360
cu1611,20160104,36100,36160,36150,36200,35560,35560,35680,-600,-480,80,"1,427.41",2938
,20160105,35560,35680,35750,36050,35560,36020,35860,340,180,182,"3,264.12",2998
,20160106,36020,35860,36050,36080,35860,36020,35960,160,100,36,647.43,2988
,20160107,36020,35960,35910,36130,35620,35710,35870,-250,-90,140,"2,511.41",2962
,20160108,35710,35870,35600,35700,34980,35410,35350,-460,-520,190,"3,359.09",3012
,20160111,35410,35350,35440,35440,34600,34600,34910,-750,-440,326,"5,691.10",3228
,20160112,34600,34910,34580,34720,34380,34380,34590,-530,-320,312,"5,397.33",3260
,20160113,34380,34590,34520,34730,34430,34530,34550,-60,-40,106,"1,831.61",3220
,20160114,34530,34550,34550,34680,34170,34680,34420,130,-130,166,"2,857.21",3268
,20160115,34680,34420,34810,35020,34540,34540,34860,120,440,266,"4,637.39",3272
,20160118,34540,34860,34370,35020,34370,34700,34710,-160,-150,126,"2,187.14",3320
,20160119,34700,34710,34800,35320,34730,35210,35090,500,380,58,"1,017.78",3292
,20160120,35210,35090,35190,35230,34910,34990,35030,-100,-60,86,"1,506.60",3296
,20160121,34990,35030,34840,35080,34700,34730,34770,-300,-260,86,"1,495.28",3338
,20160122,34730,34770,34870,35240,34790,35160,35020,390,250,98,"1,715.99",3334
,20160125,35160,35020,35200,35330,35000,35100,35110,80,90,80,"1,404.79",3312
,20160126,35100,35110,35100,35260,34990,35260,35130,150,20,60,"1,054.13",3282
,20160127,35260,35130,35450,35900,35450,35900,35790,770,660,184,"3,292.81",3212
,20160128,35900,35790,35850,36010,35830,35830,35900,40,110,46,825.85,3206
,20160129,35830,35900,35880,36000,35740,35870,35860,-30,-40,88,"1,578.05",3218
,20160201,35870,35860,35830,35840,35650,35650,35780,-210,-80,66,"1,180.83",3196
,20160202,35650,35780,35740,36100,35740,36100,35920,320,140,74,"1,329.37",3184
,20160203,36100,35920,36080,36190,35870,36170,36030,250,110,112,"2,018.22",3206
,20160204,36170,36030,36120,36960,36120,36960,36650,930,620,218,"3,995.05",3160
,20160205,36960,36650,36900,36960,36670,36890,36750,240,100,80,"1,470.25",3140
,20160215,36890,36750,36100,36210,36000,36150,36100,-600,-650,136,"2,455.46",3208
,20160216,36150,36100,35980,36290,35940,36000,36070,-100,-30,166,"2,994.33",3240
,20160217,36000,36070,35940,36160,35780,35840,35890,-230,-180,90,"1,615.40",3268
,20160218,35840,35890,36000,36000,35860,35920,35920,30,30,52,933.93,3276
,20160219,35920,35920,35980,36210,35790,36210,36100,290,180,96,"1,733.21",3268
,20160222,36210,36100,36000,36690,35950,36630,36530,530,430,230,"4,201.25",3254
,20160223,36630,36530,36810,36840,36460,36530,36670,0,140,176,"3,227.59",3264
,20160224,36530,36670,36520,36520,36050,36080,36290,-590,-380,106,"1,923.84",3250
,20160225,36080,36290,35990,36560,35990,36230,36400,-60,110,100,"1,820.16",3252
,20160226,36230,36400,36290,36290,35840,36200,36080,-200,-320,278,"5,016.20",3264
,20160229,36200,36080,36410,36860,35900,36090,36400,10,320,414,"7,535.24",3262
,20160301,36090,36400,36140,36290,35820,36100,36120,-300,-280,144,"2,600.71",3270
,20160302,36100,36120,36280,37140,36190,37140,36790,1020,670,282,"5,188.69",3378
,20160303,37140,36790,37120,37410,37110,37350,37300,560,510,340,"6,342.42",3378
,20160304,37350,37300,37430,38280,37360,38280,37860,980,560,228,"4,316.18",3368
,20160307,38280,37860,38220,39270,38030,38410,38490,550,630,254,"4,888.37",3340
,20160308,38410,38490,38640,38900,37870,38090,38160,-400,-330,180,"3,434.53",3378
,20160309,38090,38160,38120,38120,37190,37650,37530,-510,-630,304,"5,705.07",3440
,20160310,37650,37530,37890,37940,37610,37610,37800,80,270,68,"1,285.31",3448
,20160311,37610,37800,37450,38010,37450,38010,37700,210,-100,176,"3,318.32",3422
,20160314,38010,37700,37980,38410,37850,38070,38230,370,530,234,"4,473.92",3370
,20160315,38070,38230,37990,37990,37520,37650,37650,-580,-580,98,"1,845.29",3406
,20160316,37650,37650,37790,37940,37580,37890,37780,240,130,66,"1,246.82",3404
,20160317,37890,37780,37810,38230,37800,38230,38100,450,320,40,762.03,3392
,20160318,38230,38100,38410,38950,38410,38660,38660,560,560,410,"7,927.12",3394
,20160321,38660,38660,38650,38650,38370,38420,38500,-240,-160,90,"1,732.94",3434
,20160322,38420,38500,38600,38640,38410,38440,38510,-60,10,114,"2,195.41",3438
,20160323,38440,38510,38440,38600,38440,38530,38510,20,0,40,770.20,3456
,20160324,38530,38510,38290,38290,37730,37790,37920,-720,-590,156,"2,957.85",3478
,20160325,37790,37920,37770,37990,37770,37960,37920,40,0,72,"1,365.15",3470
,20160328,37960,37920,37970,38070,37710,37720,37980,-200,60,220,"4,177.84",3430
,20160329,37720,37980,37790,38120,37650,37650,37840,-330,-140,88,"1,665.03",3468
,20160330,37650,37840,37650,37650,36910,36990,37230,-850,-610,496,"9,234.62",3486
,20160331,36990,37230,36940,37230,36700,36860,36850,-370,-380,334,"6,154.69",3442
,20160401,36860,36850,36820,37130,36800,37110,37030,260,180,128,"2,370.02",3460
,20160405,37110,37030,36650,36880,36640,36740,36700,-290,-330,136,"2,495.60",3498
,20160406,36740,36700,36720,36820,36640,36700,36700,0,0,130,"2,385.52",3528
,20160407,36700,36700,36620,36820,36620,36640,36730,-60,30,74,"1,359.33",3540
,20160408,36640,36730,36260,36260,35680,35790,35940,-940,-790,554,"9,956.38",3656
,20160411,35790,35940,35900,36080,35820,35820,35930,-120,-10,408,"7,330.94",3814
,20160412,35820,35930,35870,36270,35740,35900,35910,-30,-20,346,"6,213.75",3856
,20160413,35900,35910,36200,37380,36150,36890,36660,980,750,222,"4,069.58",3888
,20160414,36890,36660,36950,37140,36780,36820,36930,160,270,356,"6,574.49",4018
,20160415,36820,36930,37490,37490,36810,36810,36970,-120,40,182,"3,364.58",4112
,20160418,36810,36970,36710,37000,36620,36630,36760,-340,-210,184,"3,382.24",4166
,20160419,36630,36760,36790,37080,36730,36880,36960,120,200,158,"2,919.99",4212
,20160420,36880,36960,37030,37710,36950,37380,37370,420,410,318,"5,943.10",4242
,20160421,37380,37370,37450,38370,37450,38230,37870,860,500,682,"12,915.73",4232
,20160422,38230,37870,38550,38680,37570,38040,38000,170,130,380,"7,221.09",4214
,20160425,38040,38000,38220,39050,37960,38200,38350,200,350,598,"11,468.15",4280
,20160426,38200,38350,38250,38250,37650,37840,37910,-510,-440,446,"8,455.27",4364
,20160427,37840,37910,37750,37960,37620,37730,37750,-180,-160,360,"6,796.10",4442
,20160428,37730,37750,37640,37640,37200,37350,37350,-400,-400,434,"8,105.12",4684
,20160429,37350,37350,37450,37870,37300,37780,37650,430,300,150,"2,823.83",4668
,20160503,37780,37650,37870,38060,37580,37970,37840,320,190,170,"3,216.92",4686
,20160504,37970,37840,37830,37900,37260,37320,37500,-520,-340,218,"4,087.64",4722
,20160505,37320,37500,37330,37410,36970,36970,37120,-530,-380,396,"7,349.89",4860
,20160506,36970,37120,36970,36970,36460,36730,36720,-390,-400,620,"11,385.67",5004
,20160509,36730,36720,36710,37080,35950,36000,36280,-720,-440,926,"16,801.26",5268
,20160510,36000,36280,35950,36190,35830,36120,36070,-160,-210,432,"7,793.12",5494
,20160511,36120,36070,36090,36200,35860,36140,36050,70,-20,338,"6,093.87",5686
,20160512,36140,36050,36230,36690,35990,36470,36260,420,210,774,"14,036.17",5776
,20160513,36470,36260,36410,36530,35270,35650,35750,-610,-510,752,"13,445.42",5900
,20160516,35650,35750,35740,35950,35430,35870,35690,120,-60,220,"3,926.85",5966
,20160517,35870,35690,35900,36100,35880,36060,35970,370,280,586,"10,539.60",6132
,20160518,36060,35970,35800,36020,35470,35570,35710,-400,-260,724,"12,929.52",6450
,20160519,35570,35710,35320,35730,35180,35290,35390,-420,-320,1084,"19,185.19",6864
,20160520,35290,35390,35340,35490,34900,35430,35260,40,-130,990,"17,455.55",6962
,20160523,35430,35260,35500,35660,34980,35240,35220,-20,-40,440,"7,749.38",7144
,20160524,35240,35220,35240,35380,35130,35250,35250,30,30,654,"11,526.77",7632
,20160525,35250,35250,35460,35700,35400,35550,35580,300,330,486,"8,647.32",7820
,20160526,35550,35580,35740,36130,35710,36130,35940,550,360,482,"8,662.92",7912
,20160527,36130,35940,36220,36240,35680,35940,35860,0,-80,786,"14,096.00",8000
,20160530,35940,35860,36000,36000,35680,35760,35800,-100,-60,1118,"20,017.33",8220
,20160531,35760,35800,35800,36050,35700,35920,35840,120,40,1296,"23,229.74",8400
,20160601,35920,35840,35890,35940,35200,35250,35620,-590,-220,2506,"44,632.88",8806
,20160602,35250,35620,35230,35500,35150,35330,35320,-290,-300,2744,"48,468.58",9532
,20160603,35330,35320,35260,35720,35200,35680,35410,360,90,3660,"64,802.77",11116
,20160606,35680,35410,36050,36330,35800,36140,36120,730,710,6664,"120,383.22",11624
,20160607,36140,36120,36140,36300,35810,35850,36020,-270,-100,2670,"48,098.80",12078
,20160608,35850,36020,35320,35420,35160,35280,35310,-740,-710,3884,"68,576.14",13314
,20160613,35280,35310,34900,35520,34890,35210,35240,-100,-70,2012,"35,455.26",13700
,20160614,35210,35240,35230,35500,35080,35080,35320,-160,80,2168,"38,289.43",14246
,20160615,35080,35320,35150,35330,35000,35280,35130,-40,-190,3452,"60,645.51",15412
,20160616,35280,35130,35930,35950,35310,35390,35660,260,530,3356,"59,845.75",15332
,20160617,35390,35660,35180,35550,35130,35530,35390,-130,-270,4578,"81,018.39",16006
,20160620,35530,35390,35450,35590,35270,35440,35470,50,80,3042,"53,962.13",16514
,20160621,35440,35470,35640,35810,35450,35550,35650,80,180,4586,"81,746.73",17324
,20160622,35550,35650,35560,36250,35480,36250,35840,600,190,7412,"132,826.20",19158
,20160623,36250,35840,36250,36330,36020,36230,36150,390,310,4612,"83,381.55",20192
,20160624,36230,36150,36520,36700,35750,35910,36180,-240,30,11952,"216,227.30",21790
,20160627,35910,36180,35970,36690,35970,36660,36350,480,170,9604,"174,577.62",24178
,20160628,36660,36350,36490,37240,36430,37190,36910,840,560,13096,"241,743.75",26718
,20160629,37190,36910,37290,37480,37010,37190,37230,280,320,6898,"128,426.15",28180
,20160630,37190,37230,37230,37690,37070,37550,37500,320,270,11478,"215,228.90",30350
,20160701,37550,37500,37540,37620,37140,37270,37360,-230,-140,8452,"157,924.49",31564
,20160704,37270,37360,37240,38520,36230,38400,38070,1040,710,35036,"667,042.05",38498
,20160705,38400,38070,38400,38550,37510,37780,37860,-290,-210,23746,"449,619.61",41044
,20160706,37780,37860,37790,37860,37010,37440,37420,-420,-440,17584,"329,004.28",41154
,20160707,37440,37420,37020,37300,36870,36950,37090,-470,-330,22356,"414,614.24",41136
,20160708,36950,37090,37000,37120,36480,36630,36640,-460,-450,22394,"410,267.73",41148
,20160711,36630,36640,36740,37140,36590,37050,36840,410,200,14304,"263,545.17",43156
,20160712,37050,36840,37150,37270,36930,37180,37080,340,240,18472,"342,554.51",42326
,20160713,37180,37080,37550,39200,37300,38620,38490,1540,1410,51842,"997,769.58",49496
,20160714,38620,38490,38660,38820,38210,38640,38480,150,-10,28350,"545,566.68",54184
,20160715,38640,38480,38580,38700,38270,38490,38430,10,-50,13996,"268,989.80",54354
,20160718,38490,38430,38670,38920,37850,37890,38140,-540,-290,28762,"548,632.57",53676
,20160719,37890,38140,37920,38590,37850,38340,38310,200,170,29648,"567,988.49",54256
,20160720,38340,38310,38430,38840,38180,38400,38480,90,170,30688,"590,508.98",59494
,20160721,38400,38480,38180,38760,38010,38720,38490,240,10,24930,"479,781.12",61988
,20160722,38720,38490,38620,38900,38260,38290,38500,-200,10,24482,"471,324.09",62270
,20160725,38290,38500,38440,38700,37910,38240,38250,-260,-250,29684,"567,726.64",63702
,20160726,38240,38250,38230,38300,37700,37880,37900,-370,-350,27410,"519,527.90",64734
,20160727,37880,37900,37800,38160,37730,37830,37950,-70,50,26254,"498,282.95",68306
,20160728,37830,37950,37820,37980,37580,37940,37820,-10,-130,27596,"521,952.19",69218
,20160729,37940,37820,37990,38200,37550,37570,37930,-250,110,29294,"555,590.25",70380
,20160801,37570,37930,37770,38380,37600,38330,38050,400,120,45700,"869,461.85",75126
,20160802,38330,38050,38160,38220,37760,38070,38010,20,-40,40684,"773,231.49",77732
,20160803,38070,38010,38150,38500,37750,37860,38120,-150,110,51480,"981,328.29",79704
,20160804,37860,38120,38000,38000,37520,37690,37730,-430,-390,44338,"836,571.88",79846
,20160805,37690,37730,37370,37810,37360,37660,37600,-70,-130,38278,"719,664.23",79074
,20160808,37660,37600,37570,37720,37420,37600,37580,0,-20,36062,"677,732.04",76922
,20160809,37600,37580,37600,37800,37260,37290,37510,-290,-70,36378,"682,436.32",80488
,20160810,37290,37510,37220,37590,37170,37530,37420,20,-90,35150,"657,796.91",83018
,20160811,37530,37420,37870,37870,37520,37600,37650,180,230,42294,"796,373.54",83132
,20160812,37600,37650,37580,37740,37520,37640,37620,-10,-30,26080,"490,659.23",84542
,20160815,37640,37620,37320,37420,37070,37130,37280,-490,-340,42388,"790,194.18",86984
,20160816,37130,37280,37120,37350,37090,37270,37230,-10,-50,41810,"778,424.51",91734
,20160817,37270,37230,37400,37450,37250,37300,37350,70,120,35970,"671,751.29",94136
,20160818,37300,37350,37260,37450,37180,37440,37300,90,-50,41062,"765,813.02",95704
,20160819,37440,37300,37540,37540,37290,37430,37380,130,80,35606,"665,643.87",98814
,20160822,37430,37380,37370,37460,37150,37160,37300,-220,-80,44634,"832,439.52",105116
,20160823,37160,37300,37040,37240,36980,37170,37150,-130,-150,43768,"813,051.83",109280
,20160824,37170,37150,37020,37090,36690,36690,36880,-460,-270,82120,"1,514,416.38",124248
,20160825,36690,36880,36610,36680,36120,36420,36380,-460,-500,104042,"1,892,687.32",134594
,20160826,36420,36380,36310,36560,36210,36450,36380,70,0,66086,"1,202,378.51",146872
,20160829,36450,36380,36380,36650,36230,36430,36400,50,20,73208,"1,332,533.10",151526
,20160830,36430,36400,36350,36530,36250,36260,36390,-140,-10,62880,"1,144,325.32",160918
,20160831,36260,36390,36230,36410,36160,36300,36310,-90,-80,79946,"1,451,435.07",172474
,20160901,36300,36310,36300,36670,36260,36560,36480,250,170,112462,"2,051,567.48",183818
,20160902,36560,36480,36490,36690,36400,36670,36530,190,50,139928,"2,555,881.17",197610
,20160905,36670,36530,36640,36660,36440,36510,36550,-20,20,147262,"2,691,283.20",210070
,20160906,36510,36550,36460,36620,36390,36570,36520,20,-30,136530,"2,493,357.37",215374
,20160907,36570,36520,36600,36870,36460,36750,36660,230,140,205396,"3,765,757.00",219446
,20160908,36750,36660,36750,36850,36530,36570,36660,-90,0,176616,"3,238,005.10",219166
,20160909,36570,36660,36560,36730,36460,36620,36620,-40,-40,149500,"2,737,818.77",215504
,20160912,36620,36620,36560,36630,36130,36170,36360,-450,-260,256900,"4,670,843.22",243058
,20160913,36170,36360,36250,36620,36250,36600,36480,240,120,192602,"3,513,080.37",216048
,20160914,36600,36480,36630,36800,36470,36730,36640,250,160,189584,"3,473,879.20",199982
,20160919,36730,36640,37100,37240,36930,37230,37110,590,470,158336,"2,938,067.58",187816
,20160920,37230,37110,37260,37350,37160,37280,37240,170,130,129424,"2,410,286.25",180818
,20160921,37280,37240,37300,37500,37190,37300,37330,60,90,172558,"3,220,949.40",178240
,20160922,37300,37330,37310,37680,37240,37650,37490,320,160,202334,"3,792,883.68",172190
,20160923,37650,37490,37770,37900,37650,37860,37770,370,280,172102,"3,250,396.98",168930
,20160926,37860,37770,37820,37900,37690,37760,37770,-10,0,132548,"2,503,738.41",161124
,20160927,37760,37770,37750,37830,37470,37680,37640,-90,-130,178872,"3,366,653.15",157098
,20160928,37680,37640,37560,37580,37250,37500,37430,-140,-210,149364,"2,795,759.23",144808
,20160929,37500,37430,37580,37960,37520,37660,37750,230,320,150794,"2,846,325.36",138420
,20160930,37660,37750,37650,37870,37540,37720,37690,-30,-60,106890,"2,014,706.81",125222
,20161010,37720,37690,37610,37670,37440,37670,37550,-20,-140,59716,"1,121,279.83",120404
,20161011,37670,37550,37630,38170,37630,38140,37980,590,430,96600,"1,834,482.90",120474
,20161012,38140,37980,38070,38070,37740,37940,37900,-40,-80,61508,"1,165,674.31",115150
,20161013,37940,37900,37960,38120,37580,37670,37840,-230,-60,63864,"1,208,523.49",112228
,20161014,37670,37840,37220,37460,37150,37410,37330,-430,-510,76700,"1,431,971.02",108956
,20161017,37410,37330,37220,37410,37180,37340,37280,10,-50,49958,"931,399.01",102218
,20161018,37340,37280,37260,37410,37210,37410,37300,130,20,38820,"724,052.11",98852
,20161019,37410,37300,37300,37410,37180,37210,37260,-90,-40,44972,"837,987.10",94992
,20161020,37210,37260,37210,37440,36990,37310,37270,50,10,45358,"845,254.34",87266
,20161021,37310,37270,37230,37270,35660,37200,37150,-70,-120,36966,"686,666.97",85124
,20161024,37200,37150,37100,37440,37100,37360,37320,210,170,37910,"707,535.57",81722
,20161025,37360,37320,37330,38180,37290,38040,37860,720,540,76492,"1,447,994.14",76734
,20161026,38040,37860,38160,38250,37740,37780,37920,-80,60,41800,"792,688.87",71952
,20161027,37780,37920,37810,37970,37750,37850,37830,-70,-90,27734,"524,666.98",68216
,20161028,37850,37830,38060,38330,37940,38270,38190,440,360,31952,"610,224.17",61608
,20161031,38270,38190,38400,38610,38290,38410,38420,220,230,33152,"636,946.41",53252
,20161101,38410,38420,38500,38870,38410,38770,38680,350,260,20072,"388,266.14",48580
,20161102,38770,38680,38760,39120,38590,38610,38740,-70,60,21080,"408,391.00",44290
,20161103,38610,38740,38610,38970,38610,38970,38810,230,70,13500,"262,029.80",41190
,20161104,38970,38810,38860,39310,38860,39100,39130,290,320,15900,"311,133.80",37400
,20161107,39100,39130,39190,40560,38740,40330,39880,1200,750,22990,"458,460.50",32190
,20161108,40330,39880,40020,40670,40020,40500,40360,620,480,18780,"379,033.30",27400
,20161109,40500,40360,40410,42000,40410,41640,41470,1280,1110,18700,"387,768.20",23810
,20161110,41640,41470,41450,43950,41450,43950,43460,2480,1990,3720,"80,837.85",22110
,20161111,43950,43460,45460,47000,44700,47000,45390,3540,1930,19570,"444,193.10",14190
,20161114,47000,45390,47990,48090,44500,45620,45770,230,380,12040,"275,538.10",6390
,20161115,45620,45770,45000,46060,43230,43280,45360,-2490,-410,3240,"73,487.65",5020
cu1612,20160104,36170,36200,36160,36160,35600,35600,35680,-600,-520,92,"1,641.50",906
,20160105,35600,35680,35730,36070,35540,36070,35710,390,30,68,"1,214.28",938
,20160106,36070,35710,36050,36100,35810,35950,35960,240,250,68,"1,222.93",948
,20160107,35950,35960,35940,36110,35660,35810,35900,-150,-60,68,"1,220.64",972
,20160108,35810,35900,35560,35640,34970,35420,35270,-480,-630,234,"4,127.19",1044
,20160111,35420,35270,35390,35450,34500,34500,34890,-770,-380,388,"6,769.99",1200
,20160112,34500,34890,35920,35920,34300,34310,34520,-580,-370,276,"4,765.01",1304
,20160113,34310,34520,34380,34640,34380,34510,34500,-10,-20,402,"6,934.91",1562
,20160114,34510,34500,34550,34750,34100,34600,34420,100,-80,1864,"32,083.62",2394
,20160115,34600,34420,34830,34930,34540,34540,34760,120,340,356,"6,187.59",2574
,20160118,34540,34760,34300,34950,34300,34700,34620,-60,-140,138,"2,389.12",2664
,20160119,34700,34620,34800,35350,34730,35270,35050,650,430,70,"1,226.78",2670
,20160120,35270,35050,35150,35210,34870,34950,35090,-100,40,80,"1,403.92",2678
,20160121,34950,35090,35380,35380,34700,34710,34790,-380,-300,66,"1,148.26",2722
,20160122,34710,34790,34800,35180,34790,35130,35060,340,270,72,"1,262.42",2750
,20160125,35130,35060,35190,35220,35010,35080,35090,20,30,530,"9,299.28",2990
,20160126,35080,35090,35120,35150,35010,35140,35100,50,10,28,491.45,2982
,20160127,35140,35100,35470,35900,35400,35900,35740,800,640,156,"2,788.37",3030
,20160128,35900,35740,35850,36060,35780,35780,35890,40,150,128,"2,297.26",3016
,20160129,35780,35890,35830,35950,35740,35920,35850,30,-40,162,"2,904.53",3022
,20160201,35920,35850,36000,36000,35680,35710,35790,-140,-60,48,859.05,3026
,20160202,35710,35790,35720,35990,35700,35990,35880,200,90,126,"2,260.98",3012
,20160203,35990,35880,36060,36210,35870,36190,36050,310,170,104,"1,875.08",3028
,20160204,36190,36050,36300,36970,36290,36960,36730,910,680,140,"2,571.69",3004
,20160205,36960,36730,36930,36990,36320,36320,36690,-410,-40,148,"2,715.16",3106
,20160215,36320,36690,36140,36210,36010,36170,36130,-520,-560,152,"2,746.24",3142
,20160216,36170,36130,36020,36280,35960,36030,36020,-100,-110,272,"4,898.98",3146
,20160217,36030,36020,35950,36180,35770,35810,35890,-210,-130,94,"1,686.83",3176
,20160218,35810,35890,35920,36010,35880,35960,35950,70,60,70,"1,258.46",3182
,20160219,35960,35950,35980,36210,35780,36210,36030,260,80,62,"1,117.06",3192
,20160222,36210,36030,36370,36670,36310,36660,36560,630,530,66,"1,206.50",3192
,20160223,36660,36560,36800,36830,36460,36530,36550,-30,-10,146,"2,668.81",3194
,20160224,36530,36550,36520,36540,36100,36160,36280,-390,-270,136,"2,467.29",3198
,20160225,36160,36280,36060,36500,36060,36240,36310,-40,30,94,"1,706.96",3184
,20160226,36240,36310,36250,36250,35870,36220,36050,-90,-260,148,"2,667.78",3164
,20160229,36220,36050,36450,36880,35980,35980,36350,-70,300,138,"2,508.66",3158
,20160301,35980,36350,36150,36340,35800,36290,36060,-60,-290,410,"7,393.24",3122
,20160302,36290,36060,36290,37160,36210,37160,36690,1100,630,210,"3,852.90",3194
,20160303,37160,36690,37140,37430,37140,37350,37330,660,640,344,"6,421.37",3250
,20160304,37350,37330,37500,38310,37380,38300,37680,970,350,526,"9,910.38",3386
,20160307,38300,37680,38160,39390,38050,38500,38520,820,840,598,"11,519.39",3478
,20160308,38500,38520,38630,38970,37830,38100,38180,-420,-340,280,"5,346.59",3534
,20160309,38100,38180,37810,37830,37090,37700,37550,-480,-630,514,"9,652.14",3550
,20160310,37700,37550,37810,37890,37630,37700,37790,150,240,202,"3,817.11",3584
,20160311,37700,37790,37590,38090,37500,38080,37860,290,70,244,"4,619.84",3524
,20160314,38080,37860,38020,38470,37910,38150,38250,290,390,214,"4,093.19",3600
,20160315,38150,38250,38010,38020,37510,37570,37680,-680,-570,176,"3,316.39",3616
,20160316,37570,37680,37660,37930,37500,37930,37720,250,40,232,"4,376.54",3674
,20160317,37930,37720,37950,38300,37940,38270,38150,550,430,104,"1,984.06",3714
,20160318,38270,38150,38270,38990,38270,38800,38630,650,480,390,"7,534.79",3816
,20160321,38800,38630,38730,38730,38090,38450,38520,-180,-110,252,"4,854.44",3718
,20160322,38450,38520,38450,38710,38410,38450,38540,-70,20,564,"10,869.64",3818
,20160323,38450,38540,38520,38720,38500,38520,38600,-20,60,74,"1,428.48",3798
,20160324,38520,38600,38190,38190,37720,37920,38030,-680,-570,296,"5,629.89",3756
,20160325,37920,38030,37770,38020,37770,38020,37910,-10,-120,68,"1,289.11",3774
,20160328,38020,37910,38070,38100,37810,37810,38010,-100,100,112,"2,128.95",3784
,20160329,37810,38010,37820,38080,37570,37630,37860,-380,-150,120,"2,271.61",3816
,20160330,37630,37860,37610,37610,36920,37030,37320,-830,-540,540,"10,078.33",3826
,20160331,37030,37320,37070,37260,36710,36840,36820,-480,-500,282,"5,192.88",3788
,20160401,36840,36820,36860,37150,36770,37150,36960,330,140,190,"3,511.61",3828
,20160405,37150,36960,36150,36860,35010,36780,36620,-180,-340,102,"1,867.73",3830
,20160406,36780,36620,36790,36790,36700,36760,36740,140,120,86,"1,580.05",3812
,20160407,36760,36740,36650,36840,36650,36680,36770,-60,30,450,"8,274.62",3640
,20160408,36680,36770,36260,36260,35700,35790,35860,-980,-910,712,"12,769.58",3692
,20160411,35790,35860,35900,36110,35790,35890,35980,30,120,222,"3,994.00",3742
,20160412,35890,35980,35960,36070,35760,36040,35920,60,-60,172,"3,089.93",3774
,20160413,36040,35920,36190,37380,36190,36880,36880,960,960,328,"6,048.96",3766
,20160414,36880,36880,37020,37200,36840,36870,37030,-10,150,166,"3,073.88",3706
,20160415,36870,37030,37100,37110,36830,36840,37040,-190,10,164,"3,037.77",3708
,20160418,36840,37040,36730,37040,36600,36600,36810,-440,-230,92,"1,693.39",3666
,20160419,36600,36810,36760,37130,36760,36850,36950,40,140,270,"4,989.41",3616
,20160420,36850,36950,37040,37740,36970,37400,37440,450,490,270,"5,054.51",3610
,20160421,37400,37440,37490,38450,37380,38320,38050,880,610,594,"11,302.71",3828
,20160422,38320,38050,38560,38780,37630,38050,38170,0,120,610,"11,644.46",3802
,20160425,38050,38170,38210,39050,37960,38210,38450,40,280,834,"16,035.32",3832
,20160426,38210,38450,38220,38220,37650,37900,37920,-550,-530,278,"5,271.08",3842
,20160427,37900,37920,37870,37970,37650,37710,37790,-210,-130,138,"2,607.78",3838
,20160428,37710,37790,37830,37830,37230,37390,37420,-400,-370,228,"4,266.07",3874
,20160429,37390,37420,37390,37940,37390,37840,37780,420,360,138,"2,606.91",3930
,20160503,37840,37780,37930,38120,37670,38050,37910,270,130,626,"11,866.17",4222
,20160504,38050,37910,37920,37930,37300,37410,37570,-500,-340,556,"10,446.77",4306
,20160505,37410,37570,37300,37470,37020,37070,37190,-500,-380,338,"6,285.35",4396
,20160506,37070,37190,36790,37100,36540,36750,36720,-440,-470,584,"10,724.51",4502
,20160509,36750,36720,36700,37100,35990,36050,36350,-670,-370,608,"11,052.27",4668
,20160510,36050,36350,36100,36270,35870,36100,36120,-250,-230,516,"9,319.29",4758
,20160511,36100,36120,36120,36250,35900,36210,36140,90,20,394,"7,120.03",4814
,20160512,36210,36140,36330,36720,36050,36470,36370,330,230,574,"10,439.32",4934
,20160513,36470,36370,36410,36620,35190,35750,35670,-620,-700,928,"16,553.50",5188
,20160516,35750,35670,35770,36000,35400,35880,35700,210,30,388,"6,926.56",5154
,20160517,35880,35700,35910,36160,35890,36160,36040,460,340,594,"10,703.96",5002
,20160518,36160,36040,35980,36110,35520,35600,35790,-440,-250,588,"10,523.11",5174
,20160519,35600,35790,35450,35700,35260,35370,35450,-420,-340,412,"7,304.33",5330
,20160520,35370,35450,35280,36000,34990,35500,35330,50,-120,1414,"24,979.82",5770
,20160523,35500,35330,35600,35660,35020,35260,35300,-70,-30,342,"6,036.66",5888
,20160524,35260,35300,35250,35420,35250,35300,35350,0,50,124,"2,192.09",5918
,20160525,35300,35350,35540,35750,35400,35590,35590,240,240,256,"4,555.78",5978
,20160526,35590,35590,35810,36150,35770,36110,35960,520,370,486,"8,739.34",5922
,20160527,36110,35960,36220,36260,35720,35960,36030,0,70,390,"7,027.70",5944
,20160530,35960,36030,36060,36060,35700,35790,35820,-240,-210,272,"4,871.68",5962
,20160531,35790,35820,35870,36020,35730,35930,35920,110,100,836,"15,017.91",5930
,20160601,35930,35920,35880,35930,35230,35230,35510,-690,-410,344,"6,109.05",6078
,20160602,35230,35510,35250,35540,35240,35380,35350,-130,-160,362,"6,399.73",6224
,20160603,35380,35350,35250,35750,35250,35750,35410,400,60,328,"5,808.02",6292
,20160606,35750,35410,36160,36270,35840,36230,36090,820,680,218,"3,934.81",6192
,20160607,36230,36090,36230,36320,35850,35850,36000,-240,-90,260,"4,681.00",6224
,20160608,35850,36000,35410,35430,35180,35300,35330,-700,-670,1528,"26,997.79",6982
,20160613,35300,35330,34660,35540,34660,35310,35340,-20,10,632,"11,168.08",7288
,20160614,35310,35340,35290,35510,35120,35130,35310,-210,-30,674,"11,900.55",7608
,20160615,35130,35310,35120,35350,35010,35320,35190,10,-120,482,"8,481.91",7790
,20160616,35320,35190,35600,35950,35320,35400,35660,210,470,528,"9,414.32",7828
,20160617,35400,35660,35300,35550,35200,35550,35360,-110,-300,792,"14,002.70",8072
,20160620,35550,35360,35440,35610,35350,35450,35490,90,130,138,"2,449.23",8088
,20160621,35450,35490,35570,35820,35480,35490,35670,0,180,650,"11,593.40",8230
,20160622,35490,35670,35530,36190,35520,36190,35830,520,160,2608,"46,727.59",9100
,20160623,36190,35830,36180,36310,36020,36220,36180,390,350,1658,"29,993.98",9554
,20160624,36220,36180,36520,36700,35800,35890,36180,-290,0,3128,"56,600.75",10094
,20160627,35890,36180,35970,36690,35970,36660,36310,480,130,2172,"39,442.64",10464
,20160628,36660,36310,36550,37230,36440,37200,36850,890,540,2400,"44,227.87",10478
,20160629,37200,36850,37330,37490,37030,37180,37250,330,400,1624,"30,251.78",10616
,20160630,37180,37250,37240,37720,37080,37550,37500,300,250,1870,"35,065.63",10922
,20160701,37550,37500,37500,37650,37160,37300,37340,-200,-160,3898,"72,785.93",11106
,20160704,37300,37340,37240,38550,37230,38490,38140,1150,800,6862,"130,860.39",12322
,20160705,38490,38140,38400,38560,37550,37850,37930,-290,-210,4500,"85,354.83",12716
,20160706,37850,37930,37840,37890,37020,37460,37440,-470,-490,4282,"80,166.39",13170
,20160707,37460,37440,37000,37310,36900,37000,37080,-440,-360,9090,"168,560.38",16264
,20160708,37000,37080,37060,37160,36520,36680,36800,-400,-280,3654,"67,250.36",16228
,20160711,36680,36800,36840,37120,36630,37110,36840,310,40,3088,"56,889.49",16420
,20160712,37110,36840,37170,37280,36930,37180,37100,340,260,5710,"105,938.56",15818
,20160713,37180,37100,37460,39210,37280,38610,38380,1510,1280,9584,"183,926.84",16594
,20160714,38610,38380,38650,38830,38240,38700,38480,320,100,4130,"79,461.66",17142
,20160715,38700,38480,38560,38710,38290,38510,38440,30,-40,5640,"108,426.84",18956
,20160718,38510,38440,38660,38940,37880,37880,38180,-560,-260,8358,"159,589.87",20282
,20160719,37880,38180,37880,38600,37880,38360,38330,180,150,8418,"161,361.77",20120
,20160720,38360,38330,38440,38870,38200,38410,38530,80,200,10766,"207,426.83",21916
,20160721,38410,38530,38110,38780,37920,38740,38540,210,10,9670,"186,371.88",23672
,20160722,38740,38540,38670,38920,38290,38300,38510,-240,-30,9494,"182,844.64",23658
,20160725,38300,38510,38480,38720,37940,38270,38250,-240,-260,10146,"194,083.09",24254
,20160726,38270,38250,38290,38330,37730,37940,37920,-310,-330,7468,"141,622.65",25244
,20160727,37940,37920,37880,38210,37780,37880,38010,-40,90,7858,"149,372.00",26426
,20160728,37880,38010,37870,38050,37600,37980,37870,-30,-140,9056,"171,497.57",26994
,20160729,37980,37870,38010,38250,37610,37660,37970,-210,100,12974,"246,360.98",28398
,20160801,37660,37970,37780,38430,37650,38370,38100,400,130,12704,"242,067.84",29986
,20160802,38370,38100,38250,38270,37800,38120,38040,20,-60,10162,"193,296.83",31014
,20160803,38120,38040,38220,38550,37820,37920,38140,-120,100,12678,"241,816.85",31122
,20160804,37920,38140,37880,38010,37570,37740,37790,-400,-350,13326,"251,805.26",31598
,20160805,37740,37790,37400,37850,37400,37710,37640,-80,-150,12322,"231,933.13",30964
,20160808,37710,37640,37600,37750,37470,37650,37620,10,-20,11870,"223,300.66",31648
,20160809,37650,37620,37660,37850,37300,37330,37580,-290,-40,11768,"221,153.98",33066
,20160810,37330,37580,37240,37620,37220,37560,37460,-20,-120,10050,"188,243.58",33130
,20160811,37560,37460,37900,37900,37580,37620,37720,160,260,11110,"209,583.72",33060
,20160812,37620,37720,37620,37780,37570,37700,37680,-20,-40,6476,"122,011.61",33950
,20160815,37700,37680,37350,37470,37140,37200,37340,-480,-340,15174,"283,347.36",35502
,20160816,37200,37340,37210,37420,37160,37360,37300,20,-40,11446,"213,503.33",35970
,20160817,37360,37300,37500,37510,37310,37370,37400,70,100,9694,"181,323.31",35404
,20160818,37370,37400,37250,37500,37230,37500,37370,100,-30,9774,"182,641.38",35750
,20160819,37500,37370,37600,37610,37350,37500,37450,130,80,7490,"140,283.38",36672
,20160822,37500,37450,37440,37510,37210,37250,37360,-200,-90,8860,"165,534.30",38262
,20160823,37250,37360,37120,37300,37060,37210,37210,-150,-150,8824,"164,182.09",39442
,20160824,37210,37210,37050,37150,36750,36760,36940,-450,-270,20460,"377,969.04",43406
,20160825,36760,36940,36690,36730,36160,36460,36430,-480,-510,33598,"612,112.67",50520
,20160826,36460,36430,36380,36590,36260,36500,36450,70,20,19552,"356,375.66",55140
,20160829,36500,36450,36450,36680,36270,36480,36440,30,-10,16180,"294,832.65",58112
,20160830,36480,36440,36450,36560,36290,36290,36460,-150,20,17926,"326,794.66",62854
,20160831,36290,36460,36300,36440,36210,36340,36340,-120,-120,15872,"288,451.24",66362
,20160901,36340,36340,36300,36690,36300,36600,36510,260,170,20082,"366,658.17",71978
,20160902,36600,36510,36500,36710,36430,36680,36560,170,50,24810,"453,598.72",74938
,20160905,36680,36560,36580,36660,36480,36540,36580,-20,20,26404,"482,936.60",78794
,20160906,36540,36580,36470,36650,36410,36610,36550,30,-30,20130,"367,931.84",81690
,20160907,36610,36550,36620,36890,36480,36790,36700,240,150,33012,"605,929.82",85168
,20160908,36790,36700,36760,36880,36400,36600,36700,-100,0,30434,"558,497.62",88936
,20160909,36600,36700,36570,36750,36500,36670,36650,-30,-50,26008,"476,643.99",90586
,20160912,36670,36650,36580,36670,36160,36170,36350,-480,-300,52336,"951,414.48",98334
,20160913,36170,36350,36270,36630,36270,36600,36490,250,140,40648,"741,824.01",99586
,20160914,36600,36490,36620,36800,36490,36700,36660,210,170,45052,"825,873.93",105026
,20160919,36700,36660,37060,37250,36960,37250,37100,590,440,44642,"828,304.40",110424
,20160920,37250,37100,37260,37350,37190,37300,37250,200,150,40914,"762,155.49",113830
,20160921,37300,37250,37350,37500,37200,37340,37330,90,80,60794,"1,134,965.21",116754
,20160922,37340,37330,37300,37700,37250,37690,37520,360,190,90642,"1,700,886.98",132402
,20160923,37690,37520,37790,37930,37680,37900,37790,380,270,81960,"1,548,994.59",140580
,20160926,37900,37790,37840,37930,37720,37780,37810,-10,20,63180,"1,194,433.17",147528
,20160927,37780,37810,37780,37860,37500,37700,37660,-110,-150,92460,"1,741,469.21",159708
,20160928,37700,37660,37550,37610,37270,37520,37450,-140,-210,80366,"1,504,958.95",160920
,20160929,37520,37450,37600,37960,37530,37650,37780,200,330,106982,"2,020,909.54",165492
,20160930,37650,37780,37680,37880,37560,37710,37690,-70,-90,82256,"1,550,198.10",174124
,20161010,37710,37690,37660,37670,37430,37650,37550,-40,-140,69828,"1,311,263.50",174958
,20161011,37650,37550,37670,38180,37660,38160,38000,610,450,197110,"3,745,498.64",201536
,20161012,38160,38000,38060,38080,37760,37950,37920,-50,-80,160384,"3,041,237.74",202450
,20161013,37950,37920,37990,38150,37580,37630,37860,-290,-60,197824,"3,745,758.03",205370
,20161014,37630,37860,37210,37460,37110,37370,37300,-490,-560,226982,"4,233,535.28",195040
,20161017,37370,37300,37210,37400,37160,37320,37260,20,-40,183592,"3,420,846.27",202110
,20161018,37320,37260,37250,37410,37200,37400,37290,140,30,108748,"2,028,035.16",195810
,20161019,37400,37290,37310,37410,37150,37190,37270,-100,-20,168580,"3,141,521.19",197272
,20161020,37190,37270,37200,37440,36970,37310,37240,40,-30,198066,"3,688,889.57",193992
,20161021,37310,37240,37240,37270,37000,37180,37130,-60,-110,147892,"2,746,234.38",191816
,20161024,37180,37130,37110,37430,37100,37350,37270,220,140,147972,"2,758,157.04",191262
,20161025,37350,37270,37300,38170,37250,38010,37780,740,510,354232,"6,693,003.43",184244
,20161026,38010,37780,38110,38250,37700,37760,37930,-20,150,228692,"4,337,196.00",165254
,20161027,37760,37930,37790,37960,37720,37820,37820,-110,-110,139948,"2,647,030.43",160052
,20161028,37820,37820,38020,38340,37950,38270,38130,450,310,183386,"3,497,064.50",153130
,20161031,38270,38130,38390,38630,38280,38390,38420,260,290,175810,"3,377,928.50",141922
,20161101,38390,38420,38490,38860,38380,38720,38620,300,200,149270,"2,883,096.11",135544
,20161102,38720,38620,38730,39140,38530,38570,38800,-50,180,140636,"2,728,694.92",122318
,20161103,38570,38800,38700,38980,38590,38970,38760,170,-40,56516,"1,095,545.58",121044
,20161104,38970,38760,39110,39330,38980,39090,39140,330,380,79984,"1,565,518.76",117856
,20161107,39090,39140,39190,40540,39110,40320,39830,1180,690,129400,"2,577,601.83",116418
,20161108,40320,39830,40190,40660,40020,40410,40330,580,500,107926,"2,176,377.90",111008
,20161109,40410,40330,40310,41980,40300,41570,41380,1240,1050,134448,"2,781,915.26",102896
,20161110,41570,41380,42170,43860,42170,43860,42970,2480,1590,62374,"1,340,158.57",96910
,20161111,43860,42970,44920,46810,44460,46720,45280,3750,2310,136124,"3,081,960.85",83940
,20161114,46720,45280,47150,47990,43650,45540,45730,260,450,128760,"2,944,352.02",79248
,20161115,45540,45730,45400,46090,43100,43750,45000,-1980,-730,68474,"1,540,771.27",74756
,20161116,43750,45000,43750,44630,43600,44580,44190,-420,-810,53458,"1,181,343.99",70492
,20161117,44580,44190,44270,44400,43420,43650,43810,-540,-380,40558,"888,426.51",67228
,20161118,43650,43810,43750,44550,43730,44150,44040,340,230,34694,"764,066.48",63400
,20161121,44150,44040,44320,45340,43600,45130,44590,1090,550,46090,"1,027,779.45",59864
,20161122,45130,44590,45130,46250,44710,46140,45690,1550,1100,43836,"1,001,470.64",56382
,20161123,46140,45690,45940,46030,45350,45750,45720,60,30,38366,"877,129.85",52576
,20161124,45750,45720,45450,48460,45420,48130,47560,2410,1840,34708,"825,440.78",49600
,20161125,48130,47560,47870,48870,47500,48060,48030,500,470,37786,"907,557.37",47414
,20161128,48060,48030,47970,49430,47720,49150,48670,1120,640,39344,"957,475.72",43604
,20161129,49150,48670,49150,49150,46480,46640,47520,-2030,-1150,43236,"1,027,322.74",37412
,20161130,46640,47520,46770,47060,45000,45700,46060,-1820,-1460,33758,"777,518.56",32508
,20161201,45700,46060,46160,47320,46100,46920,46850,860,790,15858,"371,508.51",29230
,20161202,46920,46850,46730,46940,46010,46410,46290,-440,-560,16590,"384,014.40",26880
,20161205,46410,46290,46150,47310,46020,47070,46890,780,600,19130,"448,598.10",24330
,20161206,47070,46890,47440,48000,47230,47370,47510,480,620,17870,"424,567.75",22270
,20161207,47370,47510,47330,48110,47190,48010,47590,500,80,18660,"444,104.90",21290
,20161208,48010,47590,47800,48020,46640,46950,46980,-640,-610,20690,"486,025.70",21670
,20161209,46950,46980,47200,47350,46300,47180,46840,200,-140,16430,"384,829.45",19010
,20161212,47180,46840,47150,47870,46880,46950,47420,110,580,15580,"369,431.75",16600
,20161213,46950,47420,46790,46950,46400,46640,46580,-780,-840,16210,"377,586.30",10960
,20161214,46640,46580,47590,47590,46000,46260,46180,-320,-400,6530,"150,779.15",8630
,20161215,46260,46180,46200,47230,46000,46450,46500,270,320,3780,"87,887.10",7470
cu1701,20160118,34760,34760,34670,34990,34470,34800,34820,40,60,30,522.34,24
,20160119,34800,34820,34880,35280,34880,35280,35030,460,210,16,280.26,38
,20160120,35280,35030,35170,35170,34900,34900,34980,-130,-50,50,874.67,64
,20160121,34900,34980,35000,35020,34750,34750,34920,-230,-60,40,698.54,92
,20160122,34750,34920,35110,35110,35060,35060,35070,140,150,6,105.23,96
,20160125,35060,35070,35030,35120,35030,35100,35060,30,-10,218,"3,822.38",212
,20160126,35100,35060,35080,35220,35080,35220,35110,160,50,40,702.20,240
,20160127,35220,35110,35460,35910,35450,35910,35800,800,690,658,"11,780.46",782
,20160128,35910,35800,35910,35960,35800,35800,35870,0,70,356,"6,386.38",1072
,20160129,35800,35870,35880,35920,35690,35920,35810,50,-60,1048,"18,766.66",1908
,20160201,35920,35810,35930,35940,35700,35700,35790,-110,-20,236,"4,223.82",2068
,20160202,35700,35790,35730,36020,35670,36020,35860,230,70,358,"6,419.93",2298
,20160203,36020,35860,36110,36200,35800,36160,36020,300,160,108,"1,945.37",2328
,20160204,36160,36020,36620,36990,36240,36950,36750,930,730,142,"2,609.53",2360
,20160205,36950,36750,36900,36900,36690,36810,36770,60,20,28,514.78,2356
,20160215,36810,36770,36240,36240,36000,36150,36110,-620,-660,142,"2,563.99",2380
,20160216,36150,36110,35990,36270,35980,35980,36130,-130,20,164,"2,962.93",2450
,20160217,35980,36130,36050,36160,35770,35820,35900,-310,-230,142,"2,549.19",2488
,20160218,35820,35900,35860,36050,35780,35780,35920,-120,20,54,969.92,2524
,20160219,35780,35920,36060,36230,35800,36200,36120,280,200,50,903.12,2552
,20160222,36200,36120,36000,36680,36000,36660,36510,540,390,148,"2,702.41",2630
,20160223,36660,36510,36790,36880,36450,36550,36740,40,230,76,"1,396.39",2666
,20160224,36550,36740,36550,36550,36100,36190,36270,-550,-470,52,943.15,2668
,20160225,36190,36270,36150,36490,36100,36320,36260,50,-10,86,"1,559.25",2670
,20160226,36320,36260,35970,36230,35840,36230,36070,-30,-190,152,"2,741.81",2680
,20160229,36230,36070,36430,37080,36010,36120,36580,50,510,250,"4,573.16",2726
,20160301,36120,36580,36110,36370,35850,36320,36090,-260,-490,190,"3,428.81",2750
,20160302,36320,36090,36400,37250,36240,37250,36720,1160,630,524,"9,620.95",2934
,20160303,37250,36720,37150,37460,37140,37380,37320,660,600,360,"6,719.22",2994
,20160304,37380,37320,37470,38390,37460,38310,37910,990,590,216,"4,095.35",3016
,20160307,38310,37910,39070,39440,38110,38510,38550,600,640,404,"7,787.14",3014
,20160308,38510,38550,38700,38960,37860,38150,38330,-400,-220,234,"4,485.47",2968
,20160309,38150,38330,38290,38290,37230,37740,37730,-590,-600,392,"7,395.77",3068
,20160310,37740,37730,37860,38050,37740,37750,37900,20,170,106,"2,008.92",3080
,20160311,37750,37900,37820,38130,37560,38130,37950,230,50,166,"3,150.55",2982
,20160314,38130,37950,38000,38450,37910,38180,38240,230,290,272,"5,201.51",2938
,20160315,38180,38240,37960,38060,37600,37720,37730,-520,-510,70,"1,320.63",2954
,20160316,37720,37730,37720,37990,37550,37960,37780,230,50,46,869.07,2950
,20160317,37960,37780,37900,38320,37900,38310,38240,530,460,120,"2,294.65",2952
,20160318,38310,38240,38490,38980,38000,38800,38570,560,330,552,"10,647.72",2870
,20160321,38800,38570,38700,38700,38390,38560,38620,-10,50,258,"4,982.80",2766
,20160322,38560,38620,38660,38690,38470,38480,38590,-140,-30,46,887.76,2780
,20160323,38480,38590,38570,38750,38440,38480,38580,-110,-10,30,578.81,2772
,20160324,38480,38580,38230,38240,37800,37900,37970,-680,-610,156,"2,962.43",2814
,20160325,37900,37970,37780,38080,37780,38080,37970,110,0,58,"1,101.35",2806
,20160328,38080,37970,38070,38100,37810,37810,38060,-160,90,114,"2,169.85",2818
,20160329,37810,38060,37830,38240,37660,37680,37950,-380,-110,698,"13,247.34",3118
,20160330,37680,37950,37710,37710,36900,37160,37290,-790,-660,410,"7,645.90",3156
,20160331,37160,37290,37000,37200,36740,36830,36930,-460,-360,148,"2,733.25",3176
,20160401,36830,36930,36900,37150,36790,37100,37030,170,100,100,"1,851.65",3200
,20160405,37100,37030,36740,36910,36580,36790,36720,-240,-310,48,881.38,3200
,20160406,36790,36720,36660,36840,36660,36800,36760,80,40,290,"5,330.99",3182
,20160407,36800,36760,36670,36890,36670,36750,36810,-10,50,110,"2,024.77",3182
,20160408,36750,36810,36380,36380,35720,35810,35910,-1000,-900,962,"17,277.49",3380
,20160411,35810,35910,35890,36160,35820,35830,35950,-80,40,354,"6,363.66",3444
,20160412,35830,35950,36010,36100,35730,36020,35920,70,-30,702,"12,608.87",3722
,20160413,36020,35920,37000,38040,36120,36930,36920,1010,1000,852,"15,731.44",3760
,20160414,36930,36920,36580,37250,36580,36940,37070,20,150,378,"7,007.59",3804
,20160415,36940,37070,37120,37210,36820,36850,37020,-220,-50,144,"2,665.98",3762
,20160418,36850,37020,36750,37090,36680,36680,36870,-340,-150,394,"7,264.29",3846
,20160419,36680,36870,36790,37130,36750,36870,36900,0,30,792,"14,614.69",3968
,20160420,36870,36900,37070,37800,36990,37480,37430,580,530,1074,"20,103.94",4026
,20160421,37480,37430,37790,38450,37400,38280,37980,850,550,1536,"29,176.21",4012
,20160422,38280,37980,38680,38730,37610,38010,38160,30,180,866,"16,525.04",3944
,20160425,38010,38160,38270,39090,38000,38300,38410,140,250,762,"14,635.22",3898
,20160426,38300,38410,37830,38250,37690,37940,37960,-470,-450,338,"6,415.66",3890
,20160427,37940,37960,37720,38230,37720,37800,37890,-160,-70,342,"6,480.57",3922
,20160428,37800,37890,37780,37780,37240,37480,37450,-410,-440,448,"8,389.93",4002
,20160429,37480,37450,37460,37950,37450,37950,37720,500,270,644,"12,146.10",4076
,20160503,37950,37720,37950,38160,37700,38100,37900,380,180,346,"6,556.72",4096
,20160504,38100,37900,37990,37990,37360,37370,37510,-530,-390,526,"9,866.73",4168
,20160505,37370,37510,37320,37460,37050,37060,37230,-450,-280,498,"9,271.53",4118
,20160506,37060,37230,37070,37070,36540,36810,36770,-420,-460,270,"4,964.44",4190
,20160509,36810,36770,36820,37150,36030,36030,36410,-740,-360,448,"8,157.73",4330
,20160510,36030,36410,36130,36250,35900,36200,36090,-210,-320,294,"5,305.65",4324
,20160511,36200,36090,36240,36310,35950,36270,36190,180,100,480,"8,687.59",4410
,20160512,36270,36190,36310,36740,36100,36570,36400,380,210,260,"4,733.04",4422
,20160513,36570,36400,36610,36680,35340,35830,35800,-570,-600,868,"15,539.51",4528
,20160516,35830,35800,35650,36060,35440,35910,35760,110,-40,176,"3,147.63",4568
,20160517,35910,35760,36080,36230,35970,36160,36140,400,380,274,"4,951.78",4564
,20160518,36160,36140,36090,36210,35600,35660,35850,-480,-290,426,"7,637.20",4622
,20160519,35660,35850,35590,35820,35310,35400,35480,-450,-370,626,"11,105.63",4664
,20160520,35400,35480,35420,35590,35010,35520,35340,40,-140,436,"7,705.59",4724
,20160523,35520,35340,35710,35710,35050,35360,35240,20,-100,522,"9,198.37",4640
,20160524,35360,35240,35270,35460,35270,35330,35350,90,110,144,"2,545.91",4646
,20160525,35330,35350,35550,35800,35430,35630,35640,280,290,358,"6,380.40",4676
,20160526,35630,35640,35860,36180,35770,36160,35930,520,290,242,"4,348.56",4724
,20160527,36160,35930,36290,36290,35750,36000,35980,70,50,328,"5,901.78",4768
,20160530,36000,35980,36000,36000,35760,35760,35860,-220,-120,92,"1,649.82",4808
,20160531,35760,35860,35760,36080,35760,35940,35890,80,30,152,"2,728.21",4786
,20160601,35940,35890,35770,36010,35340,35350,35540,-540,-350,276,"4,904.74",4850
,20160602,35350,35540,35330,35550,35250,35370,35400,-170,-140,226,"4,000.48",4914
,20160603,35370,35400,35320,35710,35280,35710,35410,310,10,370,"6,550.99",5022
,20160606,35710,35410,35860,36490,35820,36290,36160,880,750,532,"9,619.09",4996
,20160607,36290,36160,36280,36350,35880,35940,36100,-220,-60,220,"3,971.97",5026
,20160608,35940,36100,35610,35610,35240,35350,35390,-750,-710,1298,"22,971.60",4886
,20160613,35350,35390,35520,35600,34900,35350,35290,-40,-100,436,"7,694.77",4968
,20160614,35350,35290,35280,35550,35180,35210,35350,-80,60,386,"6,824.30",5038
,20160615,35210,35350,35180,35390,35070,35350,35200,0,-150,556,"9,788.10",5062
,20160616,35350,35200,36000,36000,35330,35450,35700,250,500,364,"6,499.16",5008
,20160617,35450,35700,35210,35630,35210,35630,35370,-70,-330,304,"5,376.51",5068
,20160620,35630,35370,35470,35680,35370,35510,35540,140,170,390,"6,930.80",5118
,20160621,35510,35540,35630,35850,35520,35520,35700,-20,160,442,"7,890.18",5164
,20160622,35520,35700,35590,36200,35560,36200,35910,500,210,708,"12,714.68",5268
,20160623,36200,35910,36240,36360,36030,36240,36160,330,250,388,"7,015.53",5252
,20160624,36240,36160,36540,36760,35800,35960,36220,-200,60,980,"17,749.40",5214
,20160627,35960,36220,35980,36660,35980,36660,36380,440,160,804,"14,625.68",5370
,20160628,36660,36380,36460,37260,36460,37160,36870,780,490,626,"11,541.55",5370
,20160629,37160,36870,37300,37510,37040,37170,37280,300,410,720,"13,420.92",5372
,20160630,37170,37280,37170,37700,37120,37580,37470,300,190,644,"12,067.30",5316
,20160701,37580,37470,37540,37560,37200,37300,37400,-170,-70,700,"13,090.57",5430
,20160704,37300,37400,37330,38570,37290,38500,38170,1100,770,1644,"31,382.30",5502
,20160705,38500,38170,38530,38590,37560,37860,37900,-310,-270,1600,"30,326.02",5752
,20160706,37860,37900,37800,37890,37020,37450,37380,-450,-520,1098,"20,522.58",5800
,20160707,37450,37380,37250,37330,36910,36940,37090,-440,-290,992,"18,399.21",5838
,20160708,36940,37090,37090,37150,36570,36720,36740,-370,-350,1056,"19,400.70",5790
,20160711,36720,36740,37000,37180,36650,37150,36870,410,130,674,"12,426.54",5918
,20160712,37150,36870,37220,37310,36960,37230,37140,360,270,1082,"20,093.89",6270
,20160713,37230,37140,37480,39250,37340,38660,38500,1520,1360,4060,"78,164.78",6578
,20160714,38660,38500,38700,38870,38260,38700,38530,200,30,1268,"24,431.98",6532
,20160715,38700,38530,38800,38800,38310,38550,38480,20,-50,800,"15,392.10",6566
,20160718,38550,38480,38790,38960,37890,37950,38290,-530,-190,1276,"24,435.08",6724
,20160719,37950,38290,37880,38610,37880,38390,38300,100,10,1902,"36,424.02",6790
,20160720,38390,38300,38480,38890,38250,38380,38510,80,210,2180,"41,981.49",7282
,20160721,38380,38510,38120,38780,38100,38750,38540,240,30,3126,"60,239.46",7456
,20160722,38750,38540,38610,38940,38310,38310,38500,-230,-40,2634,"50,716.73",7412
,20160725,38310,38500,38500,38750,37960,38310,38260,-190,-240,1522,"29,123.02",7394
,20160726,38310,38260,38380,38380,37780,37980,38000,-280,-260,1690,"32,116.09",7472
,20160727,37980,38000,37950,38230,37820,37890,38040,-110,40,1300,"24,732.14",7724
,20160728,37890,38040,37910,38070,37670,38030,37900,-10,-140,1868,"35,400.29",7672
,20160729,38030,37900,38080,38300,37640,37690,37990,-210,90,2364,"44,915.33",8128
,20160801,37690,37990,37890,38460,37690,38400,38180,410,190,2744,"52,390.60",8438
,20160802,38400,38180,38290,38310,37870,38190,38100,10,-80,3536,"67,376.27",9240
,20160803,38190,38100,38300,38590,37850,37960,38210,-140,110,2544,"48,608.33",9548
,20160804,37960,38210,37940,38050,37620,37780,37820,-430,-390,2562,"48,450.80",9494
,20160805,37780,37820,37510,37890,37300,37740,37670,-80,-150,3216,"60,586.69",9532
,20160808,37740,37670,37630,37800,37530,37700,37680,30,10,2904,"54,713.05",9906
,20160809,37700,37680,37690,37880,37200,37340,37560,-340,-120,2852,"53,571.40",10390
,20160810,37340,37560,37300,37680,37300,37650,37510,90,-50,2848,"53,419.31",10548
,20160811,37650,37510,37950,37950,37640,37680,37770,170,260,1838,"34,711.95",10620
,20160812,37680,37770,37710,37830,37620,37750,37730,-20,-40,1136,"21,431.27",10898
,20160815,37750,37730,37500,37530,37180,37270,37380,-460,-350,2940,"54,955.83",11788
,20160816,37270,37380,37340,37490,37210,37420,37370,40,-10,3418,"63,869.41",11934
,20160817,37420,37370,37460,37570,37370,37430,37480,60,110,2390,"44,789.03",11922
,20160818,37430,37480,37410,37580,37310,37580,37440,100,-40,2430,"45,498.56",12404
,20160819,37580,37440,37690,37690,37420,37550,37520,110,80,1756,"32,945.93",12480
,20160822,37550,37520,37400,37560,37260,37270,37420,-250,-100,2674,"50,035.66",12896
,20160823,37270,37420,37200,37350,37110,37270,37260,-150,-160,2950,"54,970.19",12944
,20160824,37270,37260,37170,37210,36800,36810,36960,-450,-300,4254,"78,621.07",14352
,20160825,36810,36960,36710,36800,36230,36510,36500,-450,-460,8212,"149,887.36",17060
,20160826,36510,36500,36410,36650,36310,36540,36490,40,-10,4990,"91,054.94",18066
,20160829,36540,36490,36520,36730,36340,36540,36480,50,-10,3240,"59,109.47",18516
,20160830,36540,36480,36470,36600,36350,36370,36480,-110,0,4364,"79,602.51",19692
,20160831,36370,36480,36710,36710,36260,36390,36400,-90,-80,4260,"77,540.96",20430
,20160901,36390,36400,36390,36750,36380,36630,36580,230,180,5064,"92,633.80",21416
,20160902,36630,36580,36560,36740,36460,36740,36600,160,20,7864,"143,921.58",21108
,20160905,36740,36600,36730,36730,36520,36570,36610,-30,10,7598,"139,096.26",21438
,20160906,36570,36610,36550,36670,36440,36620,36580,10,-30,7144,"130,675.09",21998
,20160907,36620,36580,36630,36930,36500,36810,36700,230,120,14630,"268,520.01",23780
,20160908,36810,36700,36850,36910,36610,36660,36750,-40,50,6774,"124,483.01",24486
,20160909,36660,36750,36640,36790,36550,36710,36700,-40,-50,6188,"113,558.47",25058
,20160912,36710,36700,36620,36690,36200,36220,36380,-480,-320,17272,"314,228.61",26400
,20160913,36220,36380,36340,36660,36330,36640,36520,260,140,11426,"208,695.76",26900
,20160914,36640,36520,36670,36830,36510,36750,36680,230,160,10716,"196,541.16",27154
,20160919,36750,36680,37200,37250,36980,37250,37140,570,460,12066,"224,105.66",29534
,20160920,37250,37140,37300,37380,37210,37310,37270,170,130,12642,"235,606.91",32208
,20160921,37310,37270,37330,37510,37220,37360,37340,90,70,18852,"352,013.56",38646
,20160922,37360,37340,37320,37730,37260,37720,37550,380,210,28566,"536,420.75",47058
,20160923,37720,37550,37810,37970,37700,37920,37830,370,280,26606,"503,335.71",53280
,20160926,37920,37830,37900,37960,37750,37820,37830,-10,0,22014,"416,424.10",56030
,20160927,37820,37830,37760,37880,37520,37720,37680,-110,-150,29976,"564,810.59",61756
,20160928,37720,37680,37600,37630,37310,37540,37480,-140,-200,21444,"401,937.11",64898
,20160929,37540,37480,37620,37960,37530,37680,37790,200,310,29622,"559,742.46",67018
,20160930,37680,37790,37630,37890,37570,37700,37700,-90,-90,26582,"501,119.40",71922
,20161010,37700,37700,37600,37670,37440,37650,37550,-50,-150,20946,"393,357.34",75584
,20161011,37650,37550,37700,38180,37680,38160,38010,610,460,47434,"901,503.59",84812
,20161012,38160,38010,38090,38090,37770,37960,37940,-50,-70,38188,"724,554.21",90510
,20161013,37960,37940,38000,38160,37600,37630,37860,-310,-80,47986,"908,555.90",95702
,20161014,37630,37860,37200,37450,37140,37390,37310,-470,-550,56760,"1,059,075.96",96998
,20161017,37390,37310,37240,37400,37190,37310,37280,0,-30,59192,"1,103,434.81",101346
,20161018,37310,37280,37290,37440,37200,37410,37310,130,30,42460,"792,233.37",103504
,20161019,37410,37310,37320,37440,37170,37220,37300,-90,-10,65330,"1,218,439.09",103274
,20161020,37220,37300,37190,37470,37000,37350,37270,50,-30,74142,"1,381,872.09",112468
,20161021,37350,37270,37230,37290,37030,37180,37150,-90,-120,59228,"1,100,415.99",115244
,20161024,37180,37150,37150,37440,37120,37350,37300,200,150,67962,"1,267,540.38",121320
,20161025,37350,37300,37350,38150,37270,37990,37800,690,500,190842,"3,607,185.06",139380
,20161026,37990,37800,38070,38200,37670,37770,37880,-30,80,151732,"2,874,262.81",133432
,20161027,37770,37880,37830,37940,37720,37820,37810,-60,-70,85460,"1,615,835.55",137074
,20161028,37820,37810,38010,38350,37940,38270,38140,460,330,137900,"2,629,790.32",145712
,20161031,38270,38140,38430,38640,38270,38410,38430,270,290,144230,"2,771,790.32",157678
,20161101,38410,38430,38500,38890,38390,38740,38660,310,230,149396,"2,888,238.25",175362
,20161102,38740,38660,38780,39180,38540,38580,38820,-80,160,281808,"5,470,657.21",175478
,20161103,38580,38820,38730,39020,38620,38990,38800,170,-20,153686,"2,981,839.19",192668
,20161104,38990,38800,39100,39390,39000,39130,39190,330,390,268470,"5,261,233.71",201496
,20161107,39130,39190,39230,40770,39150,40380,39880,1190,690,505096,"10,072,867.04",240376
,20161108,40380,39880,40180,40730,40070,40450,40370,570,490,422864,"8,537,280.08",251404
,20161109,40450,40370,40400,42030,40340,41600,41430,1230,1060,825362,"17,098,598.39",258136
,20161110,41600,41430,42320,43910,42230,43910,42970,2480,1540,515896,"11,086,018.13",253884
,20161111,43910,42970,45000,46830,44430,46700,45330,3730,2360,988810,"22,413,013.46",262712
,20161114,46700,45330,47200,48040,43700,45520,45630,190,300,1319384,"30,104,876.05",249310
,20161115,45520,45630,45500,46160,43060,43670,44940,-1960,-690,827514,"18,594,540.32",242572
,20161116,43670,44940,43670,44650,43560,44580,44170,-360,-770,534122,"11,796,616.24",248372
,20161117,44580,44170,44270,44410,43400,43670,43890,-500,-280,371964,"8,163,666.75",231320
,20161118,43670,43890,43830,44580,43720,44210,44180,320,290,412470,"9,113,112.98",228852
,20161121,44210,44180,44430,45410,43610,45120,44500,940,320,536360,"11,934,293.27",238170
,20161122,45120,44500,45190,46320,44710,46210,45610,1710,1110,405740,"9,253,245.36",228864
,20161123,46210,45610,45900,46120,45400,45760,45760,150,150,315082,"7,209,432.31",221660
,20161124,45760,45760,45560,48500,45460,48210,47310,2450,1550,622346,"14,724,144.41",198930
,20161125,48210,47310,47930,48900,47400,48100,48260,790,950,474172,"11,442,288.47",185342
,20161128,48100,48260,48020,49660,47760,49380,48600,1120,340,424094,"10,307,414.86",178930
,20161129,49380,48600,49130,49240,46490,46610,47890,-1990,-710,405738,"9,716,321.70",138700
,20161130,46610,47890,46880,47180,45030,45980,46160,-1910,-1730,367218,"8,475,458.76",119400
,20161201,45980,46160,46260,47430,46040,46920,46850,760,690,195272,"4,575,075.33",112096
,20161202,46920,46850,46790,47080,46000,46500,46500,-350,-350,94036,"2,186,645.71",105390
,20161205,46500,46500,46380,47450,46100,47170,46770,670,270,75782,"1,772,403.75",103650
,20161206,47170,46770,47310,48300,47230,47500,47770,730,1000,69286,"1,654,970.17",99378
,20161207,47500,47770,47330,48300,47190,48150,47740,380,-30,54092,"1,291,402.85",98606
,20161208,48150,47740,48040,48290,46730,47070,47270,-670,-470,55520,"1,312,485.31",92824
,20161209,47070,47270,47130,47600,46380,47290,46970,20,-300,50542,"1,187,068.82",92162
,20161212,47290,46970,47300,48100,47010,47080,47590,110,620,47550,"1,131,660.35",90884
,20161213,47080,47590,46990,47120,46520,46780,46760,-810,-830,50806,"1,187,923.93",85406
,20161214,46780,46760,47070,47560,45900,46400,46380,-360,-380,39232,"909,926.95",82638
,20161215,46400,46380,46630,46980,46050,46680,46630,300,250,31072,"724,565.19",77656
,20161216,46680,46630,46390,47000,46110,46300,46570,-330,-60,32960,"767,548.93",75068
,20161219,46300,46570,46160,46450,45500,45510,45880,-1060,-690,39718,"911,279.11",72650
,20161220,45510,45880,45480,45490,44320,44780,44860,-1100,-1020,46494,"1,042,861.49",69824
,20161221,44780,44860,44800,45300,44720,45190,45110,330,250,27642,"623,521.78",64778
,20161222,45190,45110,45090,45190,44330,44400,44690,-710,-420,26652,"595,539.04",64080
,20161223,44400,44690,44370,45120,44080,44960,44750,270,60,27570,"616,942.76",58822
,20161226,44960,44750,44830,44980,43360,44040,43950,-710,-800,28902,"635,175.41",56134
,20161227,44040,43950,44040,44680,43840,44580,44310,630,360,17960,"397,929.67",53722
,20161228,44580,44310,44580,45750,44490,45440,45430,1130,1120,24614,"559,185.25",49752
,20161229,45440,45430,45220,45660,44950,45600,45320,170,-110,20934,"474,369.25",47076
,20161230,45600,45320,45360,45880,44830,45200,45210,-120,-110,16460,"372,101.17",44240
cu1702,20160216,36110,36110,36090,36200,35990,36000,36110,-110,0,24,433.32,18
,20160217,36000,36110,36160,36160,35700,35790,35840,-320,-270,70,"1,254.57",68
,20160218,35790,35840,35910,36000,35850,36000,35930,160,90,20,359.34,74
,20160219,36000,35930,35950,36200,35850,36160,36090,230,160,32,577.44,76
,20160222,36160,36090,36370,36620,36370,36560,36450,470,360,42,765.56,90
,20160223,36560,36450,36980,36980,36540,36540,36640,90,190,94,"1,722.43",144
,20160224,36540,36640,36550,36600,36160,36160,36320,-480,-320,174,"3,159.93",222
,20160225,36160,36320,36600,36650,36420,36420,36510,100,190,24,438.12,226
,20160226,36420,36510,36330,36330,35750,36180,36080,-330,-430,34,613.40,230
,20160229,36180,36080,36870,36870,35980,36070,36210,-10,130,76,"1,376.25",252
,20160301,36070,36210,36140,36370,35840,36250,36170,40,-40,198,"3,581.62",278
,20160302,36250,36170,36430,37200,36380,37200,36900,1030,730,164,"3,026.53",366
,20160303,37200,36900,37200,37440,37130,37430,37360,530,460,94,"1,756.20",378
,20160304,37430,37360,37470,38390,37430,38390,37900,1030,540,292,"5,534.25",440
,20160307,38390,37900,38340,39050,38080,38630,38680,730,780,70,"1,353.85",454
,20160308,38630,38680,38780,39020,37930,38240,38310,-440,-370,204,"3,908.41",484
,20160309,38240,38310,37980,37980,37230,37770,37620,-540,-690,86,"1,617.98",478
,20160310,37770,37620,37880,37910,37760,37760,37860,140,240,66,"1,249.43",524
,20160311,37760,37860,37510,38150,37510,38150,37870,290,10,176,"3,332.70",470
,20160314,38150,37870,38150,38520,38000,38290,38350,420,480,38,728.66,454
,20160315,38290,38350,38020,38020,37600,37650,37780,-700,-570,22,415.58,458
,20160316,37650,37780,37730,38000,37730,37930,37820,150,40,30,567.38,462
,20160317,37930,37820,37890,38360,37890,38360,38280,540,460,116,"2,220.31",446
,20160318,38360,38280,38500,38960,37900,38700,38720,420,440,266,"5,150.65",446
,20160321,38700,38720,38690,38740,38510,38600,38600,-120,-120,46,887.86,446
,20160322,38600,38600,38680,38720,38490,38570,38590,-30,-10,24,463.08,438
,20160323,38570,38590,38440,38790,38440,38550,38670,-40,80,94,"1,817.91",460
,20160324,38550,38670,38370,38370,37850,37960,37970,-710,-700,156,"2,962.12",446
,20160325,37960,37970,37850,38070,37840,38020,37970,50,0,30,569.69,454
,20160328,38020,37970,38060,38130,37800,37800,38090,-170,120,108,"2,057.37",522
,20160329,37800,38090,38090,38240,37680,37680,37940,-410,-150,180,"3,415.24",592
,20160330,37680,37940,37690,37740,36940,37200,37330,-740,-610,140,"2,613.31",640
,20160331,37200,37330,36760,36910,36720,36910,36860,-420,-470,68,"1,253.50",656
,20160401,36910,36860,36900,37170,36540,37130,36990,270,130,34,628.93,658
,20160405,37130,36990,36750,36830,36650,36830,36770,-160,-220,10,183.86,658
,20160406,36830,36770,36770,36850,36720,36800,36760,30,-10,100,"1,838.15",676
,20160407,36800,36760,36760,36940,36690,36810,36830,50,70,36,662.95,690
,20160408,36810,36830,36280,36280,35760,35770,35830,-1060,-1000,408,"7,310.30",940
,20160411,35770,35830,35900,36140,35850,35910,36010,80,180,190,"3,420.97",972
,20160412,35910,36010,36000,36100,35800,36100,35950,90,-60,140,"2,516.93",1032
,20160413,36100,35950,36200,37470,36180,36930,36890,980,940,232,"4,279.55",1030
,20160414,36930,36890,37170,37170,36910,36950,37090,60,200,220,"4,079.92",1038
,20160415,36950,37090,37070,37140,36950,36950,37030,-140,-60,36,666.67,1016
,20160418,36950,37030,36830,37130,36750,36750,36930,-280,-100,36,664.78,1024
,20160419,36750,36930,37080,37130,36850,36880,36980,-50,50,58,"1,072.58",1008
,20160420,36880,36980,37450,37680,37210,37240,37390,260,410,48,897.47,1014
,20160421,37240,37390,37500,38490,37440,38350,38090,960,700,382,"7,276.41",1000
,20160422,38350,38090,38550,38750,37840,38190,38220,100,130,210,"4,014.03",966
,20160425,38190,38220,38200,39030,38080,38300,38280,80,60,600,"11,484.46",1290
,20160426,38300,38280,38340,38340,37750,38030,37990,-250,-290,138,"2,621.33",1284
,20160427,38030,37990,37960,38090,37720,37800,37930,-190,-60,112,"2,124.61",1288
,20160428,37800,37930,37580,37580,37350,37460,37460,-470,-470,74,"1,386.04",1310
,20160429,37460,37460,37470,37970,37470,37950,37640,490,180,162,"3,049.43",1370
,20160503,37950,37640,38000,38170,37740,38070,37860,430,220,62,"1,173.92",1366
,20160504,38070,37860,38020,38020,37360,37530,37590,-330,-270,88,"1,654.23",1388
,20160505,37530,37590,37290,37300,37080,37120,37190,-470,-400,146,"2,715.47",1436
,20160506,37120,37190,37080,37080,36580,36860,36780,-330,-410,78,"1,434.43",1442
,20160509,36860,36780,36710,36710,36050,36050,36310,-730,-470,134,"2,433.01",1528
,20160510,36050,36310,36050,36310,35910,36250,36190,-60,-120,148,"2,678.74",1536
,20160511,36250,36190,36190,36370,35980,36290,36170,100,-20,234,"4,233.03",1636
,20160512,36290,36170,36320,36800,36150,36640,36590,470,420,166,"3,037.57",1660
,20160513,36640,36590,36610,36670,35450,35810,35850,-780,-740,306,"5,485.57",1778
,20160516,35810,35850,35840,36050,35500,35950,35790,100,-60,60,"1,073.94",1778
,20160517,35950,35790,36040,36250,36000,36200,36110,410,320,52,938.91,1768
,20160518,36200,36110,35890,36140,35680,35690,35850,-420,-260,300,"5,378.75",1852
,20160519,35690,35850,35500,35870,35310,35500,35680,-350,-170,416,"7,422.02",1940
,20160520,35500,35680,35450,35610,35140,35560,35430,-120,-250,224,"3,968.18",1996
,20160523,35560,35430,35730,35730,35200,35240,35340,-190,-90,248,"4,382.92",2070
,20160524,35240,35340,35270,35490,35270,35480,35400,140,60,24,424.91,2062
,20160525,35480,35400,35550,35830,35490,35730,35660,330,260,198,"3,530.98",2140
,20160526,35730,35660,35870,36170,35830,36170,35960,510,300,78,"1,402.65",2170
,20160527,36170,35960,36150,36150,35780,36020,36000,60,40,298,"5,364.40",2342
,20160530,36020,36000,35960,36000,35720,35810,35870,-190,-130,82,"1,470.89",2342
,20160531,35810,35870,35880,36020,35770,35950,35940,80,70,110,"1,977.03",2372
,20160601,35950,35940,35900,36000,35280,35340,35490,-600,-450,172,"3,052.79",2462
,20160602,35340,35490,35390,35570,35340,35370,35420,-120,-70,106,"1,877.33",2474
,20160603,35370,35420,35320,35690,35290,35690,35410,270,-10,202,"3,577.27",2612
,20160606,35690,35410,36160,36310,35890,36200,36090,790,680,160,"2,887.27",2618
,20160607,36200,36090,36260,36330,35900,35950,36040,-140,-50,284,"5,118.66",2704
,20160608,35950,36040,35430,35450,35240,35380,35400,-660,-640,240,"4,248.39",2764
,20160613,35380,35400,35100,35560,35100,35370,35400,-30,0,222,"3,930.45",2790
,20160614,35370,35400,35410,35530,35170,35170,35380,-230,-20,490,"8,668.52",2534
,20160615,35170,35380,35240,35390,35060,35340,35190,-40,-190,374,"6,582.32",2586
,20160616,35340,35190,35900,35900,35430,35490,35630,300,440,176,"3,135.98",2674
,20160617,35490,35630,35240,35620,35240,35620,35420,-10,-210,108,"1,912.78",2706
,20160620,35620,35420,35510,35610,35450,35510,35490,90,70,38,674.47,2714
,20160621,35510,35490,35790,35790,35540,35540,35650,50,160,44,784.34,2750
,20160622,35540,35650,35590,36200,35590,36200,35990,550,340,286,"5,146.65",2892
,20160623,36200,35990,36290,36290,36020,36240,36170,250,180,190,"3,436.26",2892
,20160624,36240,36170,36380,36730,35890,35950,36310,-220,140,162,"2,941.20",2900
,20160627,35950,36310,36000,36670,36000,36650,36400,340,90,144,"2,621.21",2924
,20160628,36650,36400,36600,37250,36470,37150,36810,750,410,174,"3,202.89",2926
,20160629,37150,36810,37410,37430,37060,37210,37270,400,460,362,"6,746.14",2720
,20160630,37210,37270,37400,37720,37280,37620,37560,350,290,146,"2,742.39",2750
,20160701,37620,37560,37420,37490,37240,37370,37360,-190,-200,72,"1,345.26",2744
,20160704,37370,37360,37470,38520,37470,38360,38190,1000,830,222,"4,239.10",2730
,20160705,38360,38190,38500,38500,37660,37700,38010,-490,-180,86,"1,634.80",2736
,20160706,37700,38010,37680,37720,37040,37350,37430,-660,-580,80,"1,497.38",2746
,20160707,37350,37430,36910,37310,36890,36940,37150,-490,-280,396,"7,357.23",2834
,20160708,36940,37150,37060,37150,36610,36700,36720,-450,-430,152,"2,791.02",2868
,20160711,36700,36720,36910,37170,36870,37170,37100,450,380,162,"3,005.72",2988
,20160712,37170,37100,37270,37270,36990,37240,37140,140,40,144,"2,674.59",2912
,20160713,37240,37140,37490,39220,37390,38690,38520,1550,1380,378,"7,280.34",2880
,20160714,38690,38520,38570,38880,38380,38700,38530,180,10,240,"4,624.13",2934
,20160715,38700,38530,38660,38660,38360,38550,38430,20,-100,60,"1,152.99",2928
,20160718,38550,38430,38880,38930,37950,37950,38180,-480,-250,342,"6,530.03",3016
,20160719,37950,38180,37920,38600,37920,38420,38310,240,130,126,"2,413.76",3022
,20160720,38420,38310,38570,38870,38250,38460,38550,150,240,126,"2,428.92",3034
,20160721,38460,38550,38200,38760,38150,38750,38530,200,-20,252,"4,855.35",3008
,20160722,38750,38530,38790,38900,38350,38350,38520,-180,-10,136,"2,619.49",2954
,20160725,38350,38520,38530,38550,37990,38290,38220,-230,-300,136,"2,599.32",3012
,20160726,38290,38220,38350,38350,37830,37990,37950,-230,-270,228,"4,326.64",3174
,20160727,37990,37950,37960,38220,37830,37900,37990,-50,40,194,"3,685.41",3292
,20160728,37900,37990,37890,38030,37650,38000,37910,10,-80,174,"3,298.26",3392
,20160729,38000,37910,38150,38310,37740,37780,38090,-130,180,316,"6,019.55",3556
,20160801,37780,38090,37930,38470,37710,38420,38190,330,100,680,"12,985.90",3476
,20160802,38420,38190,38300,38310,37870,38210,38090,20,-100,500,"9,524.51",3724
,20160803,38210,38090,38300,38630,37900,37990,38160,-100,70,310,"5,915.65",3838
,20160804,37990,38160,37830,38060,37690,37830,37830,-330,-330,228,"4,313.19",3844
,20160805,37830,37830,37500,37870,37500,37810,37680,-20,-150,286,"5,388.41",3772
,20160808,37810,37680,37730,37880,37580,37780,37800,100,120,238,"4,498.92",3746
,20160809,37780,37800,37780,37780,37390,37390,37580,-410,-220,94,"1,766.37",3748
,20160810,37390,37580,37350,37700,37350,37700,37540,120,-40,144,"2,703.32",3814
,20160811,37700,37540,37900,37950,37690,37750,37820,210,280,116,"2,194.05",3836
,20160812,37750,37820,37740,37850,37690,37760,37760,-60,-60,44,830.72,3852
,20160815,37760,37760,37530,37530,37320,37340,37430,-420,-330,134,"2,508.10",3934
,20160816,37340,37430,37350,37500,37330,37450,37440,20,10,240,"4,493.09",3864
,20160817,37450,37440,37590,37590,37410,37480,37500,40,60,156,"2,925.77",3896
,20160818,37480,37500,37480,37620,37410,37620,37540,120,40,294,"5,519.34",3736
,20160819,37620,37540,37660,37700,37490,37650,37560,110,20,162,"3,042.74",3710
,20160822,37650,37560,37530,37650,37330,37330,37470,-230,-90,428,"8,019.25",3690
,20160823,37330,37470,37260,37450,37260,37300,37330,-170,-140,222,"4,143.78",3682
,20160824,37300,37330,37240,37280,36850,36870,37020,-460,-310,778,"14,404.05",3786
,20160825,36870,37020,36800,36800,36310,36580,36530,-440,-490,766,"13,992.61",4078
,20160826,36580,36530,36500,36680,36360,36600,36550,70,20,436,"7,968.08",4256
,20160829,36600,36550,36540,36750,36380,36570,36570,20,20,320,"5,852.65",4438
,20160830,36570,36570,36510,36610,36400,36420,36530,-150,-40,406,"7,417.44",4664
,20160831,36420,36530,36490,36550,36340,36460,36460,-70,-70,462,"8,423.69",4818
,20160901,36460,36460,36460,36800,36460,36720,36620,260,160,276,"5,054.45",4988
,20160902,36720,36620,36630,36790,36510,36760,36660,140,40,1084,"19,874.07",5324
,20160905,36760,36660,36760,36760,36570,36630,36660,-30,0,626,"11,477.30",5492
,20160906,36630,36660,36540,36710,36520,36680,36640,20,-20,562,"10,297.59",5746
,20160907,36680,36640,36670,37000,36530,36870,36850,230,210,1944,"35,819.21",6480
,20160908,36870,36850,36880,36960,36510,36700,36790,-150,-60,1430,"26,309.71",6664
,20160909,36700,36790,36710,36840,36630,36760,36770,-30,-20,648,"11,914.92",7040
,20160912,36760,36770,36670,36700,36270,36280,36390,-490,-380,3336,"60,702.42",7554
,20160913,36280,36390,36390,36700,36390,36660,36590,270,200,1506,"27,556.74",7818
,20160914,36660,36590,36660,36840,36560,36740,36730,150,140,1724,"31,667.45",8122
,20160919,36740,36730,37160,37280,37010,37280,37170,550,440,1088,"20,223.54",7994
,20160920,37280,37170,37380,37400,37250,37340,37310,170,140,940,"17,536.43",8336
,20160921,37340,37310,37350,37530,37260,37390,37400,80,90,1088,"20,347.50",8516
,20160922,37390,37400,37330,37780,37300,37770,37680,370,280,10540,"198,593.13",15968
,20160923,37770,37680,37900,38000,37770,37950,37870,270,190,2738,"51,845.36",16204
,20160926,37950,37870,37950,37980,37790,37860,37870,-10,0,1024,"19,391.07",16168
,20160927,37860,37870,37840,37930,37590,37780,37710,-90,-160,3748,"70,681.04",16536
,20160928,37780,37710,37650,37660,37350,37570,37520,-140,-190,1334,"25,031.79",16418
,20160929,37570,37520,37690,37980,37590,37720,37840,200,320,2962,"56,046.20",16192
,20160930,37720,37840,37710,37920,37620,37790,37720,-50,-120,2120,"39,988.81",16368
,20161010,37790,37720,37690,37710,37500,37690,37610,-30,-110,3738,"70,293.74",16936
,20161011,37690,37610,37750,38210,37740,38210,38050,600,440,7824,"148,870.13",18140
,20161012,38210,38050,38210,38210,37800,37970,37960,-80,-90,4566,"86,679.10",18982
,20161013,37970,37960,38050,38350,37640,37670,37910,-290,-50,7564,"143,385.17",19450
,20161014,37670,37910,37390,37480,37170,37420,37350,-490,-560,8294,"154,911.15",20898
,20161017,37420,37350,37360,37420,37200,37350,37310,0,-40,6966,"129,951.12",22908
,20161018,37350,37310,37280,37450,37250,37400,37350,90,40,6064,"113,263.75",23990
,20161019,37400,37350,37330,37460,37200,37220,37310,-130,-40,10460,"195,146.77",25824
,20161020,37220,37310,37240,37490,37040,37370,37330,60,20,14400,"268,833.90",27676
,20161021,37370,37330,37280,37310,37060,37200,37180,-130,-150,12562,"233,557.43",30052
,20161024,37200,37180,37170,37450,37140,37380,37320,200,140,12866,"240,124.24",34978
,20161025,37380,37320,37330,38120,37300,37940,37760,620,440,46236,"873,081.76",50356
,20161026,37940,37760,38020,38160,37640,37750,37830,-10,70,41124,"777,950.20",56478
,20161027,37750,37830,37800,37920,37710,37790,37780,-40,-50,17736,"335,117.54",58108
,20161028,37790,37780,37960,38340,37930,38270,38130,490,350,38688,"737,755.07",68026
,20161031,38270,38130,38430,38630,38280,38400,38430,270,300,38530,"740,509.68",74726
,20161101,38400,38430,38530,38900,38390,38770,38650,340,220,47066,"909,723.29",85474
,20161102,38770,38650,38750,39180,38560,38620,38800,-30,150,67106,"1,301,880.76",95102
,20161103,38620,38800,38780,39000,38640,38990,38820,190,20,33302,"646,397.55",99836
,20161104,38990,38820,39140,39440,39010,39130,39200,310,380,72690,"1,424,853.34",102504
,20161107,39130,39200,39270,40610,39160,40420,39920,1220,720,99756,"1,991,380.93",110006
,20161108,40420,39920,40290,40740,40090,40450,40410,530,490,89588,"1,810,372.52",116114
,20161109,40450,40410,40440,42030,40360,41600,41410,1190,1000,165868,"3,434,889.11",123206
,20161110,41600,41410,42290,43890,42200,43890,42960,2480,1550,101848,"2,188,045.58",123692
,20161111,43890,42960,44900,46820,44440,46740,45280,3780,2320,224836,"5,090,657.43",131874
,20161114,46740,45280,47200,47990,43600,45460,45780,180,500,238918,"5,469,335.99",135530
,20161115,45460,45780,45460,46090,43030,43640,44870,-2140,-910,155358,"3,485,470.80",139074
,20161116,43640,44870,43670,44610,43510,44570,44130,-300,-740,110154,"2,430,892.25",141296
,20161117,44570,44130,44310,44390,43430,43690,43870,-440,-260,78748,"1,727,573.54",140734
,20161118,43690,43870,43870,44560,43750,44260,44130,390,260,92606,"2,043,374.58",146850
,20161121,44260,44130,44440,45430,43650,45210,44590,1080,460,127490,"2,842,571.07",160950
,20161122,45210,44590,45310,46400,44810,46310,45770,1720,1180,135392,"3,098,774.13",177586
,20161123,46310,45770,46000,46190,45500,45850,45850,80,80,107592,"2,466,882.35",181896
,20161124,45850,45850,45670,48600,45540,48320,47480,2470,1630,263216,"6,249,447.97",195644
,20161125,48320,47480,48050,48990,47580,48180,48340,700,860,195684,"4,729,684.01",195206
,20161128,48180,48340,48120,49840,47850,49580,48820,1240,480,271522,"6,628,142.41",229802
,20161129,49580,48820,49300,49400,46590,46750,47950,-2070,-870,353894,"8,485,413.21",218234
,20161130,46750,47950,47030,47240,45110,46100,46220,-1850,-1730,505638,"11,686,428.04",228600
,20161201,46100,46220,46390,47570,46140,47060,46990,840,770,464488,"10,915,000.07",235960
,20161202,47060,46990,46930,47180,46150,46630,46650,-360,-340,330356,"7,705,765.57",230370
,20161205,46630,46650,46420,47630,46200,47360,46910,710,260,364274,"8,545,006.09",251632
,20161206,47360,46910,47420,48480,47400,47690,47950,780,1040,365538,"8,765,205.44",254760
,20161207,47690,47950,47460,48500,47330,48350,47930,400,-20,358714,"8,597,298.70",281024
,20161208,48350,47930,48260,48470,46910,47210,47530,-720,-400,385546,"9,163,284.77",259338
,20161209,47210,47530,47360,47770,46480,47390,47100,-140,-430,373262,"8,791,529.83",245848
,20161212,47390,47100,47530,48270,47150,47230,47700,130,600,332482,"7,930,254.41",244348
,20161213,47230,47700,47060,47300,46620,46920,46930,-780,-770,292322,"6,859,857.46",235676
,20161214,46920,46930,47270,47300,46000,46490,46540,-440,-390,288536,"6,715,300.18",228348
,20161215,46490,46540,46780,47130,46140,46790,46680,250,140,269802,"6,297,338.73",223872
,20161216,46790,46680,46400,47160,46220,46460,46640,-220,-40,233462,"5,445,016.33",216844
,20161219,46460,46640,46180,46590,45580,45630,46090,-1010,-550,244460,"5,633,978.53",215100
,20161220,45630,46090,45580,45580,44480,44890,44970,-1200,-1120,297386,"6,687,677.63",203366
,20161221,44890,44970,44950,45420,44800,45330,45140,360,170,158184,"3,570,905.82",199436
,20161222,45330,45140,45180,45330,44370,44430,44810,-710,-330,171752,"3,848,363.72",204652
,20161223,44430,44810,44410,45200,44130,45070,44800,260,-10,236000,"5,287,231.46",199536
,20161226,45070,44800,44900,45100,43370,44070,44210,-730,-590,249022,"5,505,323.05",181694
,20161227,44070,44210,44050,44770,43880,44600,44340,390,130,137474,"3,047,944.44",167124
,20161228,44600,44340,44540,45980,44540,45540,45430,1200,1090,173772,"3,947,271.70",153064
,20161229,45540,45430,45320,45820,45020,45680,45430,250,0,109594,"2,489,797.72",139816
,20161230,45680,45430,45490,45630,44930,45360,45300,-70,-130,79578,"1,802,778.17",130252
cu1703,20160316,37780,37780,37890,38000,37700,38000,37970,220,190,96,"1,822.71",90
,20160317,38000,37970,38170,38390,38160,38330,38230,360,260,46,879.50,112
,20160318,38330,38230,38570,39090,38480,38980,38770,750,540,36,697.96,118
,20160321,38980,38770,38500,38920,38440,38920,38700,150,-70,24,464.46,118
,20160322,38920,38700,38750,38810,38510,38510,38640,-190,-60,56,"1,082.01",148
,20160323,38510,38640,38720,38830,38540,38590,38610,-50,-30,116,"2,239.48",242
,20160324,38590,38610,38050,38050,37830,37960,37930,-650,-680,186,"3,527.77",330
,20160325,37960,37930,37820,38520,37820,38080,38040,150,110,62,"1,179.26",340
,20160328,38080,38040,38140,38170,37930,37930,38050,-110,10,54,"1,027.57",354
,20160329,37930,38050,37920,38260,37670,37670,37920,-380,-130,158,"2,995.70",478
,20160330,37670,37920,37260,37570,36530,37090,37080,-830,-840,258,"4,783.59",542
,20160331,37090,37080,37040,37090,36630,36920,36790,-160,-290,92,"1,692.46",554
,20160401,36920,36790,37220,37240,36930,37100,37140,310,350,124,"2,302.73",556
,20160405,37100,37140,,,,37140,37140,0,0,0,0.00,556
,20160406,37140,37140,36830,36900,36780,36780,36810,-360,-330,40,736.23,566
,20160407,36780,36810,36690,36690,36690,36690,36690,-120,-120,2,36.69,566
,20160408,36690,36690,36500,36500,35740,35840,35930,-850,-760,636,"11,428.69",874
,20160411,35840,35930,35830,36430,35830,35950,36020,20,90,144,"2,593.76",878
,20160412,35950,36020,36050,36100,35750,36100,35980,80,-40,144,"2,590.58",954
,20160413,36100,35980,36170,37500,36170,37000,36850,1020,870,190,"3,501.42",1002
,20160414,37000,36850,37100,37230,36950,36980,37140,130,290,984,"18,275.71",1592
,20160415,36980,37140,37250,37250,36870,36870,37070,-270,-70,146,"2,706.41",1556
,20160418,36870,37070,36810,37120,36710,36710,36860,-360,-210,178,"3,281.10",1602
,20160419,36710,36860,36870,37180,36870,36870,37040,10,180,174,"3,222.97",1614
,20160420,36870,37040,37130,37790,37060,37380,37430,340,390,366,"6,851.05",1586
,20160421,37380,37430,37600,38500,37450,38380,38160,950,730,458,"8,740.21",1746
,20160422,38380,38160,38700,38810,37880,38140,38290,-20,130,486,"9,304.49",1642
,20160425,38140,38290,38230,39140,38070,38250,38590,-40,300,242,"4,669.71",1646
,20160426,38250,38590,37910,38290,37770,37940,37990,-650,-600,136,"2,583.39",1650
,20160427,37940,37990,38000,38120,37720,37810,37880,-180,-110,314,"5,947.94",1704
,20160428,37810,37880,37800,37800,37300,37410,37480,-470,-400,78,"1,461.91",1706
,20160429,37410,37480,37570,37950,37520,37950,37810,470,330,64,"1,210.00",1720
,20160503,37950,37810,38030,38050,37760,38030,37870,220,60,66,"1,249.91",1710
,20160504,38030,37870,38040,38040,37460,37460,37600,-410,-270,136,"2,557.43",1814
,20160505,37460,37600,37470,37490,37170,37210,37240,-390,-360,98,"1,825.19",1806
,20160506,37210,37240,37150,37150,36640,36870,36920,-370,-320,138,"2,547.92",1844
,20160509,36870,36920,36930,37240,35940,36080,36390,-840,-530,154,"2,802.44",1868
,20160510,36080,36390,36040,36310,36030,36220,36220,-170,-170,164,"2,970.11",1886
,20160511,36220,36220,36230,36320,36030,36310,36230,90,10,276,"5,000.54",2058
,20160512,36310,36230,36400,36800,36200,36670,36440,440,210,74,"1,348.49",2034
,20160513,36670,36440,36660,36670,35420,35840,35870,-600,-570,304,"5,452.81",2008
,20160516,35840,35870,35880,36080,35560,36000,35840,130,-30,134,"2,401.64",2020
,20160517,36000,35840,36100,36300,36050,36270,36100,430,260,76,"1,371.95",2014
,20160518,36270,36100,36060,36290,35750,35760,35970,-340,-130,78,"1,403.05",2034
,20160519,35760,35970,35500,35950,35410,35570,35570,-400,-400,478,"8,502.12",2020
,20160520,35570,35570,35470,35630,35240,35580,35400,10,-170,520,"9,204.53",2122
,20160523,35580,35400,35590,35590,35200,35330,35340,-70,-60,214,"3,781.42",2258
,20160524,35330,35340,35480,35490,35400,35470,35470,130,130,24,425.68,2262
,20160525,35470,35470,35630,35850,35530,35770,35710,300,240,82,"1,464.48",2256
,20160526,35770,35710,36000,36190,35840,36190,36030,480,320,78,"1,405.20",2250
,20160527,36190,36030,36230,36310,35840,36060,36060,30,30,38,685.23,2250
,20160530,36060,36060,36020,36020,35810,35820,35990,-240,-70,264,"4,751.18",2336
,20160531,35820,35990,35900,36100,35870,36010,35980,20,-10,34,611.74,2322
,20160601,36010,35980,35830,35980,35500,35500,35590,-480,-390,194,"3,452.33",2336
,20160602,35500,35590,35270,35540,35270,35420,35430,-170,-160,88,"1,558.93",2298
,20160603,35420,35430,35400,35770,35370,35770,35560,340,130,160,"2,845.57",2308
,20160606,35770,35560,36100,36300,35950,36270,36190,710,630,52,941.08,2308
,20160607,36270,36190,36270,36300,35940,36010,36150,-180,-40,78,"1,410.10",2286
,20160608,36010,36150,35390,35500,35250,35430,35460,-720,-690,804,"14,257.16",2852
,20160613,35430,35460,35200,35650,35200,35440,35440,-20,-20,104,"1,842.89",2894
,20160614,35440,35440,35500,35520,35220,35220,35390,-220,-50,76,"1,344.83",2928
,20160615,35220,35390,35150,35450,35150,35410,35300,20,-90,54,953.24,2940
,20160616,35410,35300,35980,35990,35470,35470,35700,170,400,140,"2,499.23",2946
,20160617,35470,35700,35360,35670,35280,35670,35560,-30,-140,68,"1,209.33",2942
,20160620,35670,35560,35510,35680,35440,35550,35600,-10,40,30,534.07,2952
,20160621,35550,35600,35850,35900,35570,35570,35730,-30,130,108,"1,929.94",2978
,20160622,35570,35730,35760,36200,35750,36200,36010,470,280,368,"6,627.52",3100
,20160623,36200,36010,36320,36320,36080,36290,36170,280,160,132,"2,387.56",3040
,20160624,36290,36170,36430,36750,35850,35970,36050,-200,-120,546,"9,842.24",2958
,20160627,35970,36050,36240,36710,36170,36710,36400,660,350,180,"3,276.67",3036
,20160628,36710,36400,36660,37290,36510,37150,37020,750,620,124,"2,295.26",3070
,20160629,37150,37020,37300,37430,37080,37260,37240,240,220,192,"3,575.39",3034
,20160630,37260,37240,37250,37730,37250,37580,37520,340,280,138,"2,589.02",3052
,20160701,37580,37520,37600,37600,37230,37380,37420,-140,-100,100,"1,871.40",3030
,20160704,37380,37420,37450,38590,37450,38230,38190,810,770,164,"3,132.32",3052
,20160705,38230,38190,38550,38550,37600,37900,38200,-290,10,500,"9,551.11",2982
,20160706,37900,38200,37860,37890,37240,37620,37450,-580,-750,192,"3,596.02",2968
,20160707,37620,37450,37300,37350,36940,37000,37100,-450,-350,242,"4,489.54",2980
,20160708,37000,37100,37100,37180,36600,36710,36850,-390,-250,456,"8,403.85",3140
,20160711,36710,36850,36930,37180,36670,37180,36880,330,30,20,368.86,3142
,20160712,37180,36880,37200,37300,37050,37230,37150,350,270,154,"2,860.84",3190
,20160713,37230,37150,37500,39330,37450,38670,38550,1520,1400,496,"9,562.68",3128
,20160714,38670,38550,38650,38910,38360,38640,38570,90,20,200,"3,857.07",3154
,20160715,38640,38570,38530,38600,38360,38490,38440,-80,-130,130,"2,498.83",3188
,20160718,38490,38440,38720,38720,37940,37960,38150,-480,-290,208,"3,967.87",3264
,20160719,37960,38150,38030,38630,38030,38380,38420,230,270,156,"2,997.26",3264
,20160720,38380,38420,38590,38940,38330,38540,38550,120,130,252,"4,857.81",3394
,20160721,38540,38550,38250,38780,38250,38780,38710,230,160,598,"11,574.87",3114
,20160722,38780,38710,38800,38920,38400,38410,38610,-300,-100,248,"4,788.20",3026
,20160725,38410,38610,38540,38660,37980,38280,38280,-330,-330,170,"3,254.01",3074
,20160726,38280,38280,38210,38210,37850,38000,37970,-280,-310,174,"3,303.44",3184
,20160727,38000,37970,38180,38200,37870,37900,38020,-70,50,66,"1,254.98",3206
,20160728,37900,38020,38010,38080,37730,38000,37900,-20,-120,106,"2,008.92",3248
,20160729,38000,37900,38200,38310,37700,37700,38120,-200,220,400,"7,625.29",3330
,20160801,37700,38120,37880,38500,37770,38500,38120,380,0,472,"8,996.38",3298
,20160802,38500,38120,38200,38400,37880,38280,38130,160,10,568,"10,830.47",3498
,20160803,38280,38130,38250,38620,37980,38080,38290,-50,160,228,"4,365.76",3548
,20160804,38080,38290,37900,38010,37730,37850,37810,-440,-480,100,"1,890.69",3568
,20160805,37850,37810,37600,37900,37540,37820,37690,10,-120,466,"8,782.33",3634
,20160808,37820,37690,37720,37860,37620,37830,37720,140,30,80,"1,508.85",3650
,20160809,37830,37720,37800,37810,37440,37440,37590,-280,-130,80,"1,503.65",3672
,20160810,37440,37590,37590,37700,37550,37690,37610,100,20,112,"2,106.56",3736
,20160811,37690,37610,37900,37960,37730,37780,37780,170,170,178,"3,362.79",3816
,20160812,37780,37780,37720,37840,37720,37800,37790,20,10,112,"2,116.65",3766
,20160815,37800,37790,37600,37600,37300,37300,37470,-490,-320,208,"3,897.62",3890
,20160816,37300,37470,37300,37540,37300,37520,37420,50,-50,96,"1,796.28",3906
,20160817,37520,37420,37600,37630,37440,37540,37570,120,150,146,"2,743.08",3972
,20160818,37540,37570,37510,37640,37460,37640,37560,70,-10,90,"1,690.36",3972
,20160819,37640,37560,37710,37710,37530,37640,37610,80,50,108,"2,031.34",3898
,20160822,37640,37610,37550,37670,37380,37380,37540,-230,-70,186,"3,491.85",3942
,20160823,37380,37540,37300,37450,37300,37370,37400,-170,-140,286,"5,349.00",3788
,20160824,37370,37400,37200,37210,36910,36940,37050,-460,-350,226,"4,186.71",3906
,20160825,36940,37050,36820,36840,36330,36650,36600,-400,-450,424,"7,760.14",3928
,20160826,36650,36600,36550,36740,36460,36710,36620,110,20,832,"15,235.22",4350
,20160829,36710,36620,36620,36850,36470,36620,36630,0,10,474,"8,682.72",4510
,20160830,36620,36630,36560,36690,36470,36470,36580,-160,-50,356,"6,512.25",4572
,20160831,36470,36580,36450,36600,36440,36500,36540,-80,-40,462,"8,441.35",4730
,20160901,36500,36540,38730,38730,36500,36750,36750,210,210,478,"8,784.67",4830
,20160902,36750,36750,36700,36840,36630,36840,36740,90,-10,862,"15,837.39",4854
,20160905,36840,36740,36840,36840,36600,36700,36710,-40,-30,846,"15,532.41",5234
,20160906,36700,36710,36560,36770,36560,36750,36690,40,-20,334,"6,127.34",5398
,20160907,36750,36690,36720,37130,36580,36930,36970,240,280,2238,"41,378.11",6256
,20160908,36930,36970,36930,37020,36720,36750,36870,-220,-100,838,"15,450.80",6718
,20160909,36750,36870,36780,36880,36690,36830,36840,-40,-30,1044,"19,230.65",7388
,20160912,36830,36840,36760,36780,36330,36350,36440,-490,-400,1818,"33,131.63",7756
,20160913,36350,36440,36460,36750,36440,36710,36590,270,150,516,"9,441.35",7728
,20160914,36710,36590,37160,37160,36460,36770,36780,180,190,560,"10,298.58",7838
,20160919,36770,36780,37210,37300,37050,37300,37200,520,420,644,"11,980.17",7718
,20160920,37300,37200,37370,37450,37290,37350,37330,150,130,234,"4,368.14",7702
,20160921,37350,37330,37330,37580,37300,37400,37390,70,60,124,"2,318.79",7690
,20160922,37400,37390,37380,37790,37360,37730,37670,340,280,1172,"22,079.98",7404
,20160923,37730,37670,37900,38080,37800,37990,37880,320,210,740,"14,017.25",7486
,20160926,37990,37880,37870,38000,37860,37870,37900,-10,20,316,"5,988.69",7586
,20160927,37870,37900,37830,37950,37630,37800,37760,-100,-140,650,"12,272.82",7800
,20160928,37800,37760,37760,37760,37420,37600,37570,-160,-190,268,"5,034.86",7862
,20160929,37600,37570,37750,38030,37640,37700,37870,130,300,404,"7,651.52",7856
,20160930,37700,37870,37760,37900,37650,37790,37750,-80,-120,842,"15,896.39",8300
,20161010,37790,37750,37690,37730,37540,37720,37600,-30,-150,1338,"25,159.61",8314
,20161011,37720,37600,37760,38230,37760,38220,38080,620,480,2444,"46,544.00",9372
,20161012,38220,38080,38120,38120,37840,38000,38000,-80,-80,914,"17,368.89",9828
,20161013,38000,38000,38080,38200,37670,37720,37900,-280,-100,1090,"20,658.23",10078
,20161014,37720,37900,37300,37530,37210,37420,37360,-480,-540,1644,"30,716.99",10566
,20161017,37420,37360,37320,37460,37230,37380,37360,20,0,1726,"32,245.54",11238
,20161018,37380,37360,37330,37480,37280,37430,37390,70,30,990,"18,512.66",11572
,20161019,37430,37390,37380,37480,37240,37240,37330,-150,-60,1176,"21,955.04",11684
,20161020,37240,37330,37290,37510,37060,37400,37320,70,-10,1268,"23,666.39",11820
,20161021,37400,37320,37270,37330,37100,37230,37220,-90,-100,1846,"34,356.14",12172
,20161024,37230,37220,37200,37480,37170,37370,37360,150,140,2526,"47,187.72",12448
,20161025,37370,37360,37330,38120,37290,38000,37850,640,490,9436,"178,606.30",14340
,20161026,38000,37850,38030,38130,37650,37750,37900,-100,50,7500,"142,159.05",16760
,20161027,37750,37900,37790,37930,37720,37800,37790,-100,-110,3202,"60,509.59",17728
,20161028,37800,37790,37930,38330,37930,38290,38120,500,330,7870,"150,040.54",19808
,20161031,38290,38120,38410,38650,38310,38430,38450,310,330,8470,"162,836.10",21184
,20161101,38430,38450,38500,38900,38420,38770,38700,320,250,9492,"183,716.34",24578
,20161102,38770,38700,38780,39180,38600,38620,38790,-80,90,13002,"252,228.23",27580
,20161103,38620,38790,38730,39020,38650,39020,38830,230,40,6006,"116,624.57",28134
,20161104,39020,38830,39140,39400,39030,39160,39200,330,370,12726,"249,477.10",29218
,20161107,39160,39200,39260,40620,39180,40370,39970,1170,770,26418,"528,000.32",31930
,20161108,40370,39970,40270,40770,40130,40480,40420,510,450,24038,"485,870.08",32784
,20161109,40480,40420,40510,42030,40380,41580,41460,1160,1040,42558,"882,284.15",33350
,20161110,41580,41460,42180,43940,42180,43940,43080,2480,1620,29742,"640,773.60",34058
,20161111,43940,43080,44960,46880,44410,46780,45310,3700,2230,67946,"1,539,461.44",37826
,20161114,46780,45310,47200,48020,43730,45420,45800,110,490,86558,"1,982,312.06",43080
,20161115,45420,45800,45320,46060,43070,43660,44850,-2140,-950,47092,"1,056,206.23",44942
,20161116,43660,44850,43650,44590,43550,44530,44110,-320,-740,33676,"742,769.56",46142
,20161117,44530,44110,44280,44390,43460,43690,43890,-420,-220,24296,"533,268.31",48150
,20161118,43690,43890,43780,44550,43210,44250,44120,360,230,27792,"613,123.24",51048
,20161121,44250,44120,44400,45450,43680,45250,44630,1130,510,40394,"901,417.07",54958
,20161122,45250,44630,45270,46480,44880,46350,45830,1720,1200,42808,"980,975.10",58534
,20161123,46350,45830,46000,46220,45560,45910,45890,80,60,38598,"885,754.10",62146
,20161124,45910,45890,45780,48640,45580,48320,47560,2430,1670,81818,"1,945,893.76",70702
,20161125,48320,47560,47940,49030,47610,48200,48330,640,770,73708,"1,781,458.67",77708
,20161128,48200,48330,48140,49940,47890,49680,48880,1350,550,95056,"2,323,385.87",93744
,20161129,49680,48880,49400,49510,46640,46890,48040,-1990,-840,111216,"2,671,770.33",101052
,20161130,46890,48040,47100,47360,45150,46160,46340,-1880,-1700,115566,"2,677,936.46",103110
,20161201,46160,46340,46500,47640,46200,47130,47060,790,720,81206,"1,911,004.11",107078
,20161202,47130,47060,47040,47250,46210,46690,46670,-370,-390,61380,"1,432,477.07",108244
,20161205,46690,46670,46550,47680,46300,47450,47030,780,360,66540,"1,564,752.09",112918
,20161206,47450,47030,47540,48560,47490,47760,48010,730,980,68050,"1,633,749.32",114954
,20161207,47760,48010,47590,48580,47450,48460,48010,450,0,69116,"1,659,472.10",120598
,20161208,48460,48010,48380,48540,47000,47290,47640,-720,-370,91484,"2,179,590.90",118198
,20161209,47290,47640,47490,47850,46580,47510,47210,-130,-430,83478,"1,970,659.16",122334
,20161212,47510,47210,47690,48380,47250,47380,47810,170,600,81532,"1,949,120.22",123418
,20161213,47380,47810,47150,47410,46740,47010,47030,-800,-780,77356,"1,819,211.13",126272
,20161214,47010,47030,47350,47410,46140,46610,46670,-420,-360,86152,"2,010,474.38",129462
,20161215,46610,46670,46860,47230,46290,46920,46780,250,110,93966,"2,197,911.57",133480
,20161216,46920,46780,46480,47300,46350,46570,46770,-210,-10,92482,"2,162,827.06",133580
,20161219,46570,46770,46280,46700,45700,45720,46200,-1050,-570,88668,"2,048,240.74",134350
,20161220,45720,46200,45650,45680,44560,45020,45070,-1180,-1130,120832,"2,723,280.19",138598
,20161221,45020,45070,45110,45560,44920,45430,45270,360,200,84196,"1,905,944.33",145540
,20161222,45430,45270,45290,45440,44480,44520,44900,-750,-370,92470,"2,076,056.16",149836
,20161223,44520,44900,44520,45300,44230,45250,44910,350,10,117286,"2,633,841.00",153444
,20161226,45250,44910,45000,45210,43490,44160,44280,-750,-630,170606,"3,778,065.81",170352
,20161227,44160,44280,44120,44850,43960,44720,44440,440,160,131318,"2,918,490.93",169470
,20161228,44720,44440,44640,46020,44640,45620,45530,1180,1090,208248,"4,741,319.67",179558
,20161229,45620,45530,45450,45970,45160,45810,45570,280,40,213126,"4,856,867.69",192142
,20161230,45810,45570,45650,45760,45070,45500,45430,-70,-140,199464,"4,531,762.57",187358
cu1704,20160418,37070,37070,36930,36930,36700,36700,36880,-370,-190,44,811.55,44
,20160419,36700,36880,37140,37140,36870,37090,36950,210,70,98,"1,810.89",78
,20160420,37090,36950,37630,37700,37290,37290,37560,340,610,38,713.82,92
,20160421,37290,37560,37530,38540,37500,38350,38200,790,640,304,"5,806.69",224
,20160422,38350,38200,38820,38820,37920,38110,38210,-90,10,274,"5,235.55",228
,20160425,38110,38210,38510,39020,37940,38400,38450,190,240,148,"2,845.98",236
,20160426,38400,38450,38140,38350,37800,37910,38060,-540,-390,122,"2,322.00",286
,20160427,37910,38060,37990,38120,37780,37870,37960,-190,-100,24,455.57,284
,20160428,37870,37960,37730,37730,37300,37410,37470,-550,-490,58,"1,086.86",286
,20160429,37410,37470,37490,38020,37490,37990,37930,520,460,88,"1,669.00",280
,20160503,37990,37930,37980,38300,37850,38130,38070,200,140,26,495.00,284
,20160504,38130,38070,38050,38050,37460,37500,37580,-570,-490,100,"1,879.32",322
,20160505,37500,37580,37400,37610,37180,37220,37280,-360,-300,122,"2,274.60",324
,20160506,37220,37280,37220,37220,36680,36920,36850,-360,-430,160,"2,948.23",408
,20160509,36920,36850,36840,37150,36110,36110,36390,-740,-460,188,"3,420.82",420
,20160510,36110,36390,35830,36390,35830,36300,36290,-90,-100,122,"2,214.20",508
,20160511,36300,36290,36300,36400,36050,36390,36300,100,10,234,"4,247.21",664
,20160512,36390,36300,36400,36880,36210,36680,36490,380,190,98,"1,788.39",704
,20160513,36680,36490,36680,36770,35270,35960,35900,-530,-590,420,"7,539.74",822
,20160516,35960,35900,35790,36210,35650,36040,35960,140,60,158,"2,841.52",890
,20160517,36040,35960,36620,36620,36100,36130,36160,170,200,70,"1,265.66",928
,20160518,36130,36160,36080,36220,35750,35830,35900,-330,-260,142,"2,549.47",904
,20160519,35830,35900,35520,35980,35440,35520,35670,-380,-230,310,"5,529.00",808
,20160520,35520,35670,35490,35720,35200,35720,35450,50,-220,190,"3,367.90",828
,20160523,35720,35450,35660,35660,35190,35400,35330,-50,-120,122,"2,155.60",850
,20160524,35400,35330,35510,35560,35410,35430,35520,100,190,60,"1,065.66",854
,20160525,35430,35520,35690,35770,35570,35770,35690,250,170,72,"1,284.97",880
,20160526,35770,35690,35690,36180,35690,36180,36040,490,350,70,"1,261.56",890
,20160527,36180,36040,36250,36300,35880,36110,36090,70,50,88,"1,588.13",928
,20160530,36110,36090,36060,36060,35850,35900,35940,-190,-150,36,647.02,930
,20160531,35900,35940,35970,35970,35920,35920,35950,-20,10,14,251.71,930
,20160601,35920,35950,35950,36080,35400,35460,35650,-490,-300,70,"1,247.98",930
,20160602,35460,35650,35350,35600,35350,35450,35490,-200,-160,154,"2,733.16",926
,20160603,35450,35490,35400,35780,35330,35770,35480,280,-10,100,"1,774.44",978
,20160606,35770,35480,36060,36370,35920,36310,36150,830,670,40,723.14,970
,20160607,36310,36150,36240,36380,35990,36010,36110,-140,-40,220,"3,972.48",978
,20160608,36010,36110,35450,35550,35300,35450,35470,-660,-640,616,"10,927.12",1300
,20160613,35450,35470,35230,35670,35230,35460,35480,-10,10,62,"1,100.06",1304
,20160614,35460,35480,35420,35630,35240,35240,35470,-240,-10,186,"3,298.99",1304
,20160615,35240,35470,35330,35450,35200,35420,35350,-50,-120,278,"4,914.84",1390
,20160616,35420,35350,35990,36010,35420,35420,35730,70,380,72,"1,286.60",1382
,20160617,35420,35730,35370,35660,35330,35660,35460,-70,-270,36,638.43,1372
,20160620,35660,35460,35610,35650,35420,35550,35540,90,80,28,497.63,1374
,20160621,35550,35540,35670,35900,35600,35620,35750,80,210,72,"1,287.06",1380
,20160622,35620,35750,35850,36250,35850,36250,35950,500,200,98,"1,761.68",1428
,20160623,36250,35950,36430,36430,36090,36230,36210,280,260,28,507.01,1422
,20160624,36230,36210,36490,36620,35880,36040,36250,-170,40,72,"1,305.02",1432
,20160627,36040,36250,36120,36730,36120,36730,36420,480,170,56,"1,019.96",1432
,20160628,36730,36420,36620,37270,36530,37220,36900,800,480,400,"7,381.72",1652
,20160629,37220,36900,37410,37510,37260,37260,37380,360,480,46,859.83,1640
,20160630,37260,37380,37270,37790,37270,37680,37520,300,140,102,"1,913.78",1612
,20160701,37680,37520,37590,37590,37220,37380,37430,-140,-90,96,"1,796.93",1610
,20160704,37380,37430,37970,38570,37900,38500,38270,1070,840,294,"5,625.90",1588
,20160705,38500,38270,38520,38590,37650,37810,38110,-460,-160,140,"2,668.14",1586
,20160706,37810,38110,37850,37880,37180,37450,37510,-660,-600,86,"1,613.14",1572
,20160707,37450,37510,37060,37370,36970,37010,37220,-500,-290,96,"1,786.94",1580
,20160708,37010,37220,37150,37150,36600,36670,36730,-550,-490,118,"2,167.15",1580
,20160711,36670,36730,36810,37260,36810,37100,36960,370,230,274,"5,064.66",1614
,20160712,37100,36960,37240,37250,37130,37130,37170,170,210,98,"1,821.61",1610
,20160713,37130,37170,37550,39220,37550,38640,38360,1470,1190,274,"5,256.03",1608
,20160714,38640,38360,38660,38910,38290,38450,38580,90,220,172,"3,318.51",1654
,20160715,38450,38580,38650,38720,38360,38480,38470,-100,-110,120,"2,308.50",1616
,20160718,38480,38470,38670,38770,37970,37970,38150,-500,-320,138,"2,632.80",1590
,20160719,37970,38150,38550,38600,38210,38390,38430,240,280,62,"1,191.40",1572
,20160720,38390,38430,38710,38880,38400,38560,38600,130,170,74,"1,428.35",1594
,20160721,38560,38600,38270,38780,38270,38760,38730,160,130,338,"6,546.23",1450
,20160722,38760,38730,38790,38890,38390,38390,38650,-340,-80,150,"2,899.39",1390
,20160725,38390,38650,38700,38750,38010,38270,38300,-380,-350,48,919.26,1396
,20160726,38270,38300,37870,38060,37870,37970,38000,-330,-300,100,"1,900.09",1422
,20160727,37970,38000,38180,38290,37850,37950,37990,-50,-10,32,607.89,1450
,20160728,37950,37990,37940,38070,37790,38040,37900,50,-90,132,"2,501.66",1468
,20160729,38040,37900,38160,38270,37800,37800,38010,-100,110,318,"6,043.65",1564
,20160801,37800,38010,38360,38460,37820,38460,38250,450,240,154,"2,945.87",1564
,20160802,38460,38250,38250,38310,37990,38280,38160,30,-90,214,"4,083.49",1676
,20160803,38280,38160,38480,38630,37990,38040,38210,-120,50,196,"3,745.29",1792
,20160804,38040,38210,37870,38050,37780,37890,37900,-320,-310,36,682.31,1786
,20160805,37890,37900,37700,37950,37630,37870,37830,-30,-70,168,"3,177.92",1822
,20160808,37870,37830,37760,37880,37620,37800,37760,-30,-70,66,"1,246.31",1818
,20160809,37800,37760,37900,37900,37470,37470,37610,-290,-150,134,"2,520.32",1868
,20160810,37470,37610,37520,37780,37520,37780,37640,170,30,266,"5,006.55",2058
,20160811,37780,37640,37920,37920,37770,37780,37810,140,170,22,415.97,2056
,20160812,37780,37810,37830,37860,37830,37860,37840,50,30,6,113.54,2060
,20160815,37860,37840,37500,37610,37480,37520,37540,-320,-300,62,"1,164.04",2092
,20160816,37520,37540,37460,37570,37430,37540,37490,0,-50,26,487.39,2098
,20160817,37540,37490,37560,37680,37550,37570,37590,80,100,26,488.72,2092
,20160818,37570,37590,37510,37700,37510,37670,37600,80,10,42,789.75,2080
,20160819,37670,37600,37740,37740,37600,37680,37640,80,40,36,677.54,2076
,20160822,37680,37640,37710,37710,37550,37550,37590,-90,-50,40,751.95,2050
,20160823,37550,37590,37380,37500,37380,37420,37440,-170,-150,192,"3,594.49",2034
,20160824,37420,37440,37260,37260,36990,36990,37090,-450,-350,130,"2,411.45",2050
,20160825,36990,37090,36930,36950,36510,36750,36610,-340,-480,306,"5,601.65",1940
,20160826,36750,36610,36650,36800,36560,36800,36680,190,70,64,"1,173.98",1938
,20160829,36800,36680,36800,36800,36550,36700,36650,20,-30,140,"2,566.15",1910
,20160830,36700,36650,36630,36770,36530,36540,36690,-110,40,534,"9,798.89",1830
,20160831,36540,36690,36540,36630,36500,36580,36560,-110,-130,218,"3,985.90",1926
,20160901,36580,36560,36610,36900,36610,36850,36750,290,190,264,"4,851.16",2024
,20160902,36850,36750,36780,36850,36740,36820,36820,70,70,214,"3,939.85",1876
,20160905,36820,36820,36830,36850,36730,36770,36800,-50,-20,60,"1,104.05",1896
,20160906,36770,36800,36650,36790,36650,36770,36730,-30,-70,50,918.27,1898
,20160907,36770,36730,36850,37140,36680,37010,36950,280,220,92,"1,700.02",1918
,20160908,37010,36950,37080,37110,36830,36880,37030,-70,80,178,"3,296.42",1922
,20160909,36880,37030,36770,36930,36770,36900,36900,-130,-130,28,516.60,1928
,20160912,36900,36900,36800,36800,36400,36410,36500,-490,-400,106,"1,934.61",1938
,20160913,36410,36500,36570,36790,36540,36770,36700,270,200,220,"4,038.00",1974
,20160914,36770,36700,36900,36900,36670,36840,36830,140,130,306,"5,636.32",2072
,20160919,36840,36830,37210,37300,37210,37290,37250,460,420,102,"1,899.97",2110
,20160920,37290,37250,37400,37450,37330,37340,37420,90,170,168,"3,143.48",2190
,20160921,37340,37420,37350,37580,37350,37460,37460,40,40,260,"4,870.91",2196
,20160922,37460,37460,37480,37810,37380,37770,37700,310,240,300,"5,656.46",2128
,20160923,37770,37700,37930,38050,37830,38000,37930,300,230,124,"2,351.71",2080
,20160926,38000,37930,37870,38020,37870,37920,37950,-10,20,34,645.17,2074
,20160927,37920,37950,37640,37850,37640,37820,37710,-130,-240,34,641.07,2068
,20160928,37820,37710,37560,37650,37550,37610,37620,-100,-90,60,"1,128.77",2070
,20160929,37610,37620,37850,38090,37700,37700,37970,80,350,126,"2,392.25",2122
,20160930,37700,37970,37860,37860,37690,37810,37770,-160,-200,354,"6,686.69",2114
,20161010,37810,37770,37720,37720,37270,37620,37580,-150,-190,282,"5,299.93",2094
,20161011,37620,37580,37810,38150,37770,38090,37970,510,390,202,"3,835.00",2118
,20161012,38090,37970,38000,38100,37890,38040,38030,70,60,92,"1,749.46",2110
,20161013,38040,38030,38140,38190,37710,37710,37930,-320,-100,114,"2,162.50",2122
,20161014,37710,37930,37300,37520,37280,37490,37360,-440,-570,104,"1,943.14",2124
,20161017,37490,37360,37480,37660,37250,37400,37390,40,30,146,"2,729.73",2130
,20161018,37400,37390,37340,37520,37340,37520,37410,130,20,28,523.74,2128
,20161019,37520,37410,37440,37470,37290,37290,37390,-120,-20,62,"1,159.31",2138
,20161020,37290,37390,37190,37540,37120,37400,37370,10,-20,46,859.57,2134
,20161021,37400,37370,37250,37300,37120,37250,37280,-120,-90,196,"3,653.97",2292
,20161024,37250,37280,37240,37480,37240,37440,37370,160,90,116,"2,167.77",2332
,20161025,37440,37370,37370,38120,37370,38100,37880,730,510,768,"14,549.10",2744
,20161026,38100,37880,38070,38150,37680,37770,37880,-110,0,1006,"19,057.75",3288
,20161027,37770,37880,37790,37920,37750,37850,37830,-30,-50,622,"11,767.60",3472
,20161028,37850,37830,37990,38340,37970,38290,38210,460,380,934,"17,844.49",3670
,20161031,38290,38210,38400,38630,38370,38460,38450,250,240,450,"8,652.14",3738
,20161101,38460,38450,38560,38910,38490,38790,38680,340,230,400,"7,737.36",3814
,20161102,38790,38680,38800,39180,38620,38640,38750,-40,70,2058,"39,883.11",4602
,20161103,38640,38750,38770,39010,38690,39000,38850,250,100,744,"14,453.69",4574
,20161104,39000,38850,39100,39410,39070,39200,39240,350,390,5288,"103,774.83",6690
,20161107,39200,39240,39300,40630,39230,40410,39870,1170,630,9010,"179,621.33",6886
,20161108,40410,39870,40250,40750,40140,40500,40400,630,530,3060,"61,813.24",6428
,20161109,40500,40400,40460,42020,40390,41610,41530,1210,1130,5352,"111,147.37",6790
,20161110,41610,41530,42250,44020,42250,44020,43340,2490,1810,7972,"172,782.00",9098
,20161111,44020,43340,44980,47240,41500,46720,45290,3380,1950,15728,"356,175.44",8804
,20161114,46720,45290,47150,48000,43710,45410,45820,120,530,18172,"416,359.09",9188
,20161115,45410,45820,45080,46070,43080,43700,44810,-2120,-1010,10520,"235,736.23",9724
,20161116,43700,44810,43600,44600,43600,44550,44150,-260,-660,7760,"171,309.29",10818
,20161117,44550,44150,44230,44390,43500,43690,43900,-460,-250,5044,"110,720.48",11090
,20161118,43690,43900,43890,44560,43800,44290,44140,390,240,5270,"116,319.76",12046
,20161121,44290,44140,44520,45450,43700,45290,44630,1150,490,6434,"143,595.95",12494
,20161122,45290,44630,45380,46490,44910,46400,45910,1770,1280,8186,"187,925.44",14380
,20161123,46400,45910,46000,46240,45600,46000,45940,90,30,7998,"183,730.03",15886
,20161124,46000,45940,45740,48690,45570,48380,47790,2440,1850,18910,"451,894.28",20474
,20161125,48380,47790,48050,49040,47690,48250,48300,460,510,16826,"406,349.80",23364
,20161128,48250,48300,48150,50010,47940,49730,48990,1430,690,16186,"396,534.68",25286
,20161129,49730,48990,49540,49600,46820,47030,48150,-1960,-840,20902,"503,264.79",25590
,20161130,47030,48150,47290,47450,45260,46200,46330,-1950,-1820,21320,"493,924.58",26026
,20161201,46200,46330,46390,47680,46280,47180,47080,850,750,13894,"327,133.97",26234
,20161202,47180,47080,47040,47290,46270,46730,46690,-350,-390,18498,"431,880.82",27928
,20161205,46730,46690,46650,47740,46360,47450,47070,760,380,11644,"274,049.78",28728
,20161206,47450,47070,47510,48620,47510,47830,48060,760,990,12234,"294,014.75",30206
,20161207,47830,48060,47720,48630,47530,48470,48120,410,60,11888,"286,055.53",31018
,20161208,48470,48120,48400,48580,47060,47360,47640,-760,-480,13296,"316,745.92",31876
,20161209,47360,47640,47580,47900,46670,47660,47250,20,-390,10098,"238,599.91",32362
,20161212,47660,47250,47690,48470,47350,47470,47970,220,720,11910,"285,671.25",32704
,20161213,47470,47970,47360,47530,46870,47190,47160,-780,-810,10482,"247,206.27",33000
,20161214,47190,47160,47490,47520,46270,46730,46740,-430,-420,10826,"253,057.23",33166
,20161215,46730,46740,47010,47350,46400,47070,46940,330,200,9064,"212,738.90",33392
,20161216,47070,46940,46850,47410,46490,46700,46960,-240,20,11362,"266,783.57",34244
,20161219,46700,46960,46280,46800,45810,45820,46260,-1140,-700,18942,"438,166.03",36220
,20161220,45820,46260,45790,45790,44680,45140,45180,-1120,-1080,21636,"488,788.44",41598
,20161221,45140,45180,45250,45690,45080,45550,45410,370,230,16726,"379,832.63",46874
,20161222,45550,45410,45490,45570,44610,44650,45080,-760,-330,17814,"401,530.68",51936
,20161223,44650,45080,44700,45400,44360,45380,44990,300,-90,24844,"558,912.86",57208
,20161226,45380,44990,45150,45330,43620,44290,44380,-700,-610,27118,"601,805.80",61334
,20161227,44290,44380,44380,44960,44110,44830,44620,450,240,31154,"695,147.80",66556
,20161228,44830,44620,44790,46120,44780,45700,45660,1080,1040,22198,"506,791.51",67400
,20161229,45700,45660,45490,46090,45270,45950,45680,290,20,19908,"454,787.22",67996
,20161230,45950,45680,45810,45880,45200,45630,45570,-50,-110,20916,"476,668.96",67548
cu1705,20160517,35960,35960,36170,36590,36120,36320,36230,360,270,100,"1,811.68",80
,20160518,36320,36230,35950,36290,35790,35860,35970,-370,-260,262,"4,712.09",218
,20160519,35860,35970,35640,35890,35450,35600,35690,-370,-280,238,"4,247.60",306
,20160520,35600,35690,35550,35780,35200,35630,35480,-60,-210,102,"1,809.65",320
,20160523,35630,35480,35800,35800,35300,35460,35420,-20,-60,150,"2,657.09",388
,20160524,35460,35420,35390,35580,35390,35450,35500,30,80,20,355.08,394
,20160525,35450,35500,35740,35790,35690,35720,35710,220,210,30,535.77,394
,20160526,35720,35710,36080,36250,36080,36250,36180,540,470,6,108.56,392
,20160527,36250,36180,35960,36150,35960,36150,36050,-30,-130,8,144.22,392
,20160530,36150,36050,35950,36120,35870,35920,35980,-130,-70,42,755.70,404
,20160531,35920,35980,36000,36120,35980,36080,36040,100,60,22,396.46,404
,20160601,36080,36040,36010,36010,35600,35620,35710,-420,-330,20,357.15,408
,20160602,35620,35710,35370,35650,35370,35490,35450,-220,-260,264,"4,680.44",608
,20160603,35490,35450,35500,35790,35440,35780,35580,330,130,52,925.17,606
,20160606,35780,35580,36070,36350,35850,36350,36210,770,630,98,"1,774.62",660
,20160607,36350,36210,36270,36390,35950,36060,36200,-150,-10,126,"2,280.93",700
,20160608,36060,36200,35560,35570,35330,35460,35480,-740,-720,212,"3,761.14",748
,20160613,35460,35480,35080,35630,35080,35500,35480,20,0,96,"1,703.08",782
,20160614,35500,35480,35450,35790,35290,35290,35570,-190,90,288,"5,122.63",828
,20160615,35290,35570,35370,35510,35180,35460,35390,-110,-180,174,"3,079.53",866
,20160616,35460,35390,36020,36070,35500,35540,35780,150,390,184,"3,291.86",866
,20160617,35540,35780,35350,35670,35350,35670,35540,-110,-240,48,852.96,870
,20160620,35670,35540,35610,35750,35450,35630,35620,90,80,98,"1,745.52",896
,20160621,35630,35620,35680,35950,35660,35680,35860,60,240,244,"4,375.95",928
,20160622,35680,35860,35730,36130,35730,36130,35950,270,90,154,"2,768.81",980
,20160623,36130,35950,36370,36370,36170,36310,36250,360,300,30,543.76,972
,20160624,36310,36250,36520,36790,35880,35980,36280,-270,30,274,"4,970.93",928
,20160627,35980,36280,36090,36750,36090,36750,36360,470,80,192,"3,490.74",946
,20160628,36750,36360,36640,37330,36530,37250,37000,890,640,376,"6,957.67",1090
,20160629,37250,37000,37430,37520,37120,37270,37330,270,330,198,"3,695.97",1112
,20160630,37270,37330,37300,37810,37200,37660,37550,330,220,120,"2,253.17",1138
,20160701,37660,37550,37640,37660,37280,37400,37480,-150,-70,202,"3,785.52",1182
,20160704,37400,37480,37550,38630,37550,38530,38290,1050,810,496,"9,498.34",1378
,20160705,38530,38290,38630,38630,37630,37860,38020,-430,-270,646,"12,282.32",1584
,20160706,37860,38020,37860,37930,37120,37450,37510,-570,-510,182,"3,414.27",1566
,20160707,37450,37510,37130,37500,37040,37050,37260,-460,-250,288,"5,366.78",1648
,20160708,37050,37260,37120,37200,36570,36810,36760,-450,-500,240,"4,411.20",1606
,20160711,36810,36760,36980,37250,36730,37250,37090,490,330,574,"10,645.37",1422
,20160712,37250,37090,37390,37400,37100,37290,37260,200,170,256,"4,769.78",1430
,20160713,37290,37260,37620,39300,37470,38670,38370,1410,1110,624,"11,974.27",1310
,20160714,38670,38370,38790,38850,38390,38770,38590,400,220,188,"3,627.54",1284
,20160715,38770,38590,38650,38700,38380,38600,38570,10,-20,64,"1,234.30",1290
,20160718,38600,38570,38780,39010,37980,37980,38230,-590,-340,174,"3,326.77",1292
,20160719,37980,38230,38020,38670,38020,38350,38400,120,170,180,"3,456.15",1266
,20160720,38350,38400,38500,38950,38390,38580,38650,180,250,136,"2,628.55",1282
,20160721,38580,38650,38230,38800,38230,38790,38610,140,-40,132,"2,548.64",1290
,20160722,38790,38610,38710,39010,38400,38400,38650,-210,40,98,"1,893.91",1332
,20160725,38400,38650,38620,38760,38090,38330,38410,-320,-240,98,"1,882.47",1342
,20160726,38330,38410,38220,38270,37820,38030,38010,-380,-400,84,"1,596.60",1324
,20160727,38030,38010,38060,38440,37900,37980,38080,-30,70,114,"2,171.05",1334
,20160728,37980,38080,38030,38130,37780,38060,37960,-20,-120,280,"5,314.45",1488
,20160729,38060,37960,38220,38350,37780,37780,38140,-180,180,448,"8,543.44",1754
,20160801,37780,38140,37970,38510,37830,38470,38260,330,120,116,"2,219.08",1768
,20160802,38470,38260,38380,38390,37930,38300,38230,40,-30,178,"3,402.81",1834
,20160803,38300,38230,38410,38730,38010,38080,38270,-150,40,296,"5,664.54",1906
,20160804,38080,38270,38040,38160,37710,37930,37930,-340,-340,370,"7,017.38",1966
,20160805,37930,37930,37630,38020,37630,37910,37840,-20,-90,546,"10,332.85",2068
,20160808,37910,37840,37830,37910,37640,37840,37780,0,-60,570,"10,769.92",1984
,20160809,37840,37780,37840,37980,37500,37500,37690,-280,-90,482,"9,084.46",2086
,20160810,37500,37690,37450,37800,37450,37800,37660,110,-30,132,"2,485.87",2122
,20160811,37800,37660,37990,38030,37790,37860,37910,200,250,78,"1,478.78",2106
,20160812,37860,37910,37840,37910,37820,37910,37860,0,-50,28,530.12,2118
,20160815,37910,37860,37650,37690,37350,37440,37540,-420,-320,216,"4,054.95",2208
,20160816,37440,37540,37410,37610,37410,37580,37490,40,-50,112,"2,099.51",2220
,20160817,37580,37490,37630,37720,37590,37610,37660,120,170,104,"1,958.54",2224
,20160818,37610,37660,37610,37750,37520,37750,37610,90,-50,106,"1,993.50",2220
,20160819,37750,37610,37790,37830,37640,37800,37700,190,90,96,"1,810.01",2238
,20160822,37800,37700,37690,37780,37520,37520,37640,-180,-60,92,"1,731.88",2244
,20160823,37520,37640,37450,37580,37430,37480,37500,-160,-140,158,"2,962.95",2224
,20160824,37480,37500,37430,37440,37060,37060,37200,-440,-300,268,"4,985.98",2254
,20160825,37060,37200,37000,37030,36530,36810,36810,-390,-390,602,"11,080.14",2326
,20160826,36810,36810,36640,36880,36610,36800,36750,-10,-60,238,"4,374.01",2192
,20160829,36800,36750,36750,36980,36600,36740,36750,-10,0,622,"11,429.40",1936
,20160830,36740,36750,36800,36860,36600,36600,36780,-150,30,436,"8,018.38",1828
,20160831,36600,36780,36560,36680,36520,36640,36620,-140,-160,86,"1,574.73",1838
,20160901,36640,36620,36690,36970,36660,36910,36790,290,170,322,"5,923.22",1830
,20160902,36910,36790,36830,37020,36710,37020,36890,230,100,108,"1,992.52",1846
,20160905,37020,36890,36900,36970,36790,36830,36870,-60,-20,642,"11,838.32",1972
,20160906,36830,36870,36840,36890,36730,36860,36800,-10,-70,148,"2,723.24",2022
,20160907,36860,36800,36900,37180,36730,37050,36950,250,150,204,"3,769.32",2068
,20160908,37050,36950,37100,37140,36840,36950,36990,0,40,56,"1,035.75",2068
,20160909,36950,36990,36900,37020,36790,36920,36910,-70,-80,244,"4,504.21",2058
,20160912,36920,36910,36850,36850,36430,36440,36580,-470,-330,234,"4,280.80",2086
,20160913,36440,36580,36600,36830,36600,36800,36750,220,170,124,"2,278.75",2092
,20160914,36800,36750,36980,36980,36670,36840,36860,90,110,204,"3,759.85",2134
,20160919,36840,36860,37250,37380,37120,37380,37290,520,430,312,"5,817.78",2152
,20160920,37380,37290,37430,37490,37360,37430,37430,140,140,114,"2,133.60",2138
,20160921,37430,37430,37460,37600,37360,37480,37460,50,30,126,"2,360.41",2162
,20160922,37480,37460,37500,37850,37370,37820,37680,360,220,436,"8,214.99",2148
,20160923,37820,37680,37980,38100,37850,38010,37930,330,250,388,"7,358.81",2262
,20160926,38010,37930,37910,38010,37890,37930,37950,0,20,138,"2,618.61",2254
,20160927,37930,37950,37910,38000,37680,37870,37850,-80,-100,390,"7,381.08",2328
,20160928,37870,37850,37730,37730,37500,37650,37610,-200,-240,282,"5,304.06",2288
,20160929,37650,37610,37740,38060,37740,37750,37930,140,320,204,"3,869.33",2318
,20160930,37750,37930,37740,37980,37720,37770,37820,-160,-110,192,"3,631.18",2342
,20161010,37770,37820,37660,37750,37390,37730,37620,-90,-200,254,"4,778.50",2312
,20161011,37730,37620,37800,38260,37780,38260,38070,640,450,450,"8,566.70",2548
,20161012,38260,38070,38040,38130,37890,38060,38040,-10,-30,178,"3,386.34",2594
,20161013,38060,38040,38170,38270,37700,37750,37910,-290,-130,396,"7,507.50",2582
,20161014,37750,37910,37510,37560,37270,37490,37420,-420,-490,326,"6,101.02",2648
,20161017,37490,37420,37380,37570,37310,37440,37390,20,-30,502,"9,385.55",2760
,20161018,37440,37390,37390,37560,37340,37530,37440,140,50,226,"4,231.44",2898
,20161019,37530,37440,37480,37520,37320,37320,37410,-120,-30,354,"6,623.09",2890
,20161020,37320,37410,37220,37540,37120,37430,37410,20,0,414,"7,745.04",2966
,20161021,37430,37410,37390,37390,37140,37300,37290,-110,-120,296,"5,519.05",3104
,20161024,37300,37290,37240,37550,37240,37470,37440,180,150,370,"6,926.69",3254
,20161025,37470,37440,37430,38180,37430,37900,37820,460,380,1226,"23,185.16",3484
,20161026,37900,37820,38190,38220,37710,37750,37900,-70,80,988,"18,724.52",3616
,20161027,37750,37900,37830,37960,37770,37830,37850,-70,-50,494,"9,349.76",3712
,20161028,37830,37850,38060,38380,37980,38320,38190,470,340,702,"13,406.10",3716
,20161031,38320,38190,38480,38690,38350,38580,38510,390,320,1032,"19,872.05",3918
,20161101,38580,38510,38810,38950,38500,38810,38750,300,240,1108,"21,470.36",4178
,20161102,38810,38750,38870,39250,38640,38680,38850,-70,100,1508,"29,300.20",3922
,20161103,38680,38850,39200,39200,38700,39050,38870,200,20,562,"10,922.75",3934
,20161104,39050,38870,39190,39440,39100,39240,39270,370,400,1360,"26,703.97",4170
,20161107,39240,39270,39350,40650,39280,40460,40060,1190,790,2728,"54,645.76",5162
,20161108,40460,40060,40400,40850,40180,40500,40490,440,430,2854,"57,786.25",5882
,20161109,40500,40490,40490,42060,40430,41600,41520,1110,1030,4904,"101,828.68",6408
,20161110,41600,41520,42220,44010,42220,44010,43200,2490,1680,3888,"83,998.62",6814
,20161111,44010,43200,45010,46880,44490,46750,45290,3550,2090,7760,"175,737.75",6778
,20161114,46750,45290,47090,48000,43640,45460,45780,170,490,13874,"317,637.26",6826
,20161115,45460,45780,45390,46100,43070,43700,44750,-2080,-1030,6054,"135,462.94",6520
,20161116,43700,44750,43880,44710,43570,44590,44180,-160,-570,3650,"80,643.56",6858
,20161117,44590,44180,44320,44450,43500,43740,43950,-440,-230,2742,"60,256.90",7068
,20161118,43740,43950,43970,44600,43720,44320,44220,370,270,1770,"39,135.10",7082
,20161121,44320,44220,44550,45500,43730,45380,44990,1160,770,8530,"191,883.32",10404
,20161122,45380,44990,45470,46580,44950,46490,45870,1500,880,7700,"176,608.37",12234
,20161123,46490,45870,46200,46320,45180,46050,46010,180,140,4844,"111,440.28",12916
,20161124,46050,46010,45920,48760,45680,48250,47660,2240,1650,10418,"248,283.80",12152
,20161125,48250,47660,47920,49100,47730,48330,48390,670,730,8194,"198,256.57",13008
,20161128,48330,48390,48250,50180,48000,49920,49180,1530,790,13206,"324,790.53",16768
,20161129,49920,49180,49700,49740,46950,47160,48370,-2020,-810,14318,"346,350.69",17994
,20161130,47160,48370,47370,47590,45390,46300,46420,-2070,-1950,14840,"344,471.20",18046
,20161201,46300,46420,46870,47780,46350,47300,47140,880,720,13758,"324,303.50",17218
,20161202,47300,47140,47300,47370,46290,46790,46780,-350,-360,10078,"235,758.81",16032
,20161205,46790,46780,46460,47830,46380,47550,47180,770,400,7800,"184,014.53",16082
,20161206,47550,47180,47650,48760,47640,47920,48220,740,1040,8614,"207,700.76",16476
,20161207,47920,48220,47730,48690,47630,48540,48230,320,10,7936,"191,378.87",17172
,20161208,48540,48230,48510,48650,47120,47440,47730,-790,-500,8170,"194,993.45",17786
,20161209,47440,47730,47490,47960,46720,47670,47330,-60,-400,9442,"223,454.20",18750
,20161212,47670,47330,47670,48570,47400,47580,48090,250,760,11836,"284,634.71",18002
,20161213,47580,48090,47470,47700,47000,47310,47330,-780,-760,12230,"289,480.09",20862
,20161214,47310,47330,47640,47650,46400,46900,46920,-430,-410,8694,"203,988.99",21796
,20161215,46900,46920,47040,47490,46520,47200,47030,280,110,8024,"188,711.79",21382
,20161216,47200,47030,46790,47540,46530,46810,47050,-220,20,8742,"205,668.77",20200
,20161219,46810,47050,46680,46900,45840,45920,46370,-1130,-680,8970,"207,978.59",20554
,20161220,45920,46370,45720,45840,44800,45260,45320,-1110,-1050,10728,"243,109.99",20932
,20161221,45260,45320,45260,45830,45200,45690,45560,370,240,6686,"152,310.95",21154
,20161222,45690,45560,45600,45710,44760,44830,45150,-730,-410,7492,"169,155.08",21362
,20161223,44830,45150,44800,45530,44500,45440,45130,290,-20,11220,"253,190.25",22240
,20161226,45440,45130,45080,45450,43770,44490,44500,-640,-630,13762,"306,266.36",24060
,20161227,44490,44500,44490,45100,44270,44990,44770,490,270,14014,"313,706.53",26328
,20161228,44990,44770,44990,46260,44920,45900,45800,1130,1030,13976,"320,076.77",27234
,20161229,45900,45800,45670,46210,45420,46090,45830,290,30,11840,"271,326.16",27760
,20161230,46090,45830,45890,46020,45360,45810,45720,-20,-110,8762,"200,323.69",28192
cu1706,20160616,35390,35390,35850,36310,35500,35590,35680,200,290,74,"1,320.31",58
,20160617,35590,35680,35420,35690,35410,35610,35510,-70,-170,36,639.30,70
,20160620,35610,35510,35660,35840,35600,35610,35700,100,190,20,357.07,82
,20160621,35610,35700,35760,35980,35690,35690,35810,-10,110,42,752.03,86
,20160622,35690,35810,35990,36240,35900,36240,36000,430,190,30,540.00,94
,20160623,36240,36000,36400,36400,36110,36350,36270,350,270,70,"1,269.48",100
,20160624,36350,36270,36550,36650,35830,36030,36310,-240,40,72,"1,307.42",124
,20160627,36030,36310,36100,36720,36100,36700,36470,390,160,62,"1,130.61",132
,20160628,36700,36470,36930,37360,36390,37290,37030,820,560,88,"1,629.55",140
,20160629,37290,37030,37240,37420,37240,37420,37330,390,300,4,74.66,142
,20160630,37420,37330,37430,37880,37430,37640,37760,310,430,28,528.73,142
,20160701,37640,37760,37370,37370,37370,37370,37370,-390,-390,2,37.37,142
,20160704,37370,37370,37320,38600,37320,38580,38410,1210,1040,262,"5,032.22",252
,20160705,38580,38410,38520,38520,37560,37660,38000,-750,-410,346,"6,574.17",426
,20160706,37660,38000,37770,37770,37010,37500,37500,-500,-500,62,"1,162.80",452
,20160707,37500,37500,37140,37440,37090,37100,37230,-400,-270,148,"2,755.57",554
,20160708,37100,37230,37080,37080,36680,36770,36800,-460,-430,108,"1,987.73",576
,20160711,36770,36800,36960,37530,36880,37300,37190,500,390,274,"5,096.14",536
,20160712,37300,37190,37360,37420,37150,37300,37230,110,40,88,"1,638.28",510
,20160713,37300,37230,37890,39400,37500,38700,38600,1470,1370,1676,"32,353.49",1462
,20160714,38700,38600,38670,39070,38400,38560,38580,-40,-20,122,"2,353.69",1454
,20160715,38560,38580,38610,38740,38190,38630,38520,50,-60,108,"2,080.34",1472
,20160718,38630,38520,38790,38950,37940,38020,38300,-500,-220,78,"1,493.89",1466
,20160719,38020,38300,38160,38650,37960,38510,38420,210,120,138,"2,651.46",1472
,20160720,38510,38420,38510,38910,38350,38600,38630,180,210,100,"1,931.86",1492
,20160721,38600,38630,38230,39030,38080,38760,38490,130,-140,78,"1,501.25",1484
,20160722,38760,38490,38920,38920,38250,38470,38680,-20,190,120,"2,320.82",1498
,20160725,38470,38680,38690,38690,38170,38360,38290,-320,-390,64,"1,225.56",1496
,20160726,38360,38290,38070,38070,37830,38060,37950,-230,-340,62,"1,176.54",1476
,20160727,38060,37950,38000,38300,37950,37950,38120,0,170,38,724.44,1484
,20160728,37950,38120,38110,38110,37790,38060,37990,-60,-130,206,"3,913.47",1570
,20160729,38060,37990,38200,38380,37820,37820,38210,-170,220,788,"15,055.83",1420
,20160801,37820,38210,38040,38580,37890,38580,38290,370,80,76,"1,455.31",1390
,20160802,38580,38290,38380,38390,38000,38310,38250,20,-40,116,"2,218.99",1466
,20160803,38310,38250,38420,38670,38080,38100,38310,-150,60,166,"3,180.53",1538
,20160804,38100,38310,38000,38090,37790,37810,37950,-500,-360,68,"1,290.41",1574
,20160805,37810,37950,37740,38090,37650,37950,37870,0,-80,540,"10,225.81",1742
,20160808,37950,37870,37870,37960,37740,37890,37810,20,-60,42,794.04,1740
,20160809,37890,37810,38010,38060,37510,37510,37710,-300,-100,512,"9,654.94",2000
,20160810,37510,37710,37600,37850,37600,37850,37690,140,-20,250,"4,712.21",2000
,20160811,37850,37690,38050,38120,37850,37890,37950,200,260,254,"4,820.84",2008
,20160812,37890,37950,38070,38080,37900,37920,37990,-30,40,20,379.96,2014
,20160815,37920,37990,37690,37710,37380,37510,37610,-480,-380,168,"3,159.91",2122
,20160816,37510,37610,37470,37670,37440,37600,37530,-10,-80,122,"2,289.37",2106
,20160817,37600,37530,37630,37720,37630,37660,37670,130,140,30,565.19,2114
,20160818,37660,37670,37660,37800,37660,37800,37690,130,20,32,603.14,2106
,20160819,37800,37690,37830,37850,37730,37850,37760,160,70,52,981.80,2098
,20160822,37850,37760,37500,37750,37500,37550,37620,-210,-140,106,"1,994.21",2100
,20160823,37550,37620,37470,37610,37470,37520,37530,-100,-90,114,"2,139.71",2054
,20160824,37520,37530,37450,37480,37120,37150,37250,-380,-280,230,"4,284.81",2036
,20160825,37150,37250,37060,37060,36650,36820,36870,-430,-380,270,"4,978.66",2124
,20160826,36820,36870,36800,36950,36710,36950,36810,80,-60,40,736.29,2134
,20160829,36950,36810,36820,37010,36760,36790,36800,-20,-10,94,"1,729.72",2088
,20160830,36790,36800,36840,36880,36690,36690,36810,-110,10,344,"6,331.89",1822
,20160831,36690,36810,36730,36770,36530,36710,36690,-100,-120,34,623.80,1826
,20160901,36710,36690,36800,37030,36730,36990,36850,300,160,210,"3,869.27",1660
,20160902,36990,36850,36880,37090,36790,37090,36990,240,140,200,"3,699.10",1684
,20160905,37090,36990,36930,36990,36850,36960,36930,-30,-60,278,"5,134.53",1614
,20160906,36960,36930,36790,37000,36790,37000,36900,70,-30,142,"2,620.49",1618
,20160907,37000,36900,36890,37220,36800,37130,36940,230,40,450,"8,313.59",1690
,20160908,37130,36940,37170,37170,36930,36960,37000,20,60,112,"2,072.13",1662
,20160909,36960,37000,36920,37040,36900,37000,36970,0,-30,158,"2,921.11",1702
,20160912,37000,36970,36930,36930,36510,36520,36650,-450,-320,106,"1,942.81",1686
,20160913,36520,36650,36720,36910,36720,36860,36820,210,170,184,"3,387.98",1754
,20160914,36860,36820,36980,37010,36740,36930,36920,110,100,262,"4,837.77",1816
,20160919,36930,36920,37250,37400,37190,37400,37310,480,390,96,"1,791.01",1792
,20160920,37400,37310,37450,37550,37420,37440,37450,130,140,38,711.71,1772
,20160921,37440,37450,37500,37660,37410,37560,37500,110,50,86,"1,612.57",1746
,20160922,37560,37500,37500,37900,37470,37900,37740,400,240,120,"2,264.70",1706
,20160923,37900,37740,38080,38150,37920,38030,37980,290,240,212,"4,026.09",1660
,20160926,38030,37980,38020,38050,37950,37970,37990,-10,10,44,835.82,1650
,20160927,37970,37990,37790,37860,37750,37860,37780,-130,-210,42,793.56,1648
,20160928,37860,37780,37500,37720,37500,37700,37680,-80,-100,186,"3,504.57",1538
,20160929,37700,37680,37770,38110,37690,37800,37920,120,240,474,"8,989.36",1334
,20160930,37800,37920,37860,38030,37760,37770,37790,-150,-130,220,"4,157.90",1250
,20161010,37770,37790,37790,37790,37590,37760,37630,-30,-160,66,"1,241.83",1226
,20161011,37760,37630,37830,38310,37800,38310,38100,680,470,346,"6,592.51",1344
,20161012,38310,38100,38120,38120,38000,38070,38070,-30,-30,40,761.43,1360
,20161013,38070,38070,38190,38190,37760,37760,38020,-310,-50,84,"1,596.92",1378
,20161014,37760,38020,37360,37580,37350,37500,37490,-520,-530,134,"2,511.89",1398
,20161017,37500,37490,37430,37510,37360,37490,37450,0,-40,124,"2,322.15",1414
,20161018,37490,37450,37420,37550,37350,37540,37420,90,-30,64,"1,197.62",1430
,20161019,37540,37420,37880,37880,37350,37350,37470,-70,50,50,936.86,1426
,20161020,37350,37470,37230,37580,37160,37480,37310,10,-160,76,"1,418.05",1410
,20161021,37480,37310,37380,37380,37250,37340,37340,30,30,106,"1,979.49",1480
,20161024,37340,37340,37270,37560,37270,37520,37480,180,140,72,"1,349.58",1528
,20161025,37520,37480,37550,38180,37490,38050,37920,570,440,264,"5,005.84",1560
,20161026,38050,37920,38240,38240,37740,37810,37970,-110,50,302,"5,734.07",1592
,20161027,37810,37970,37870,37970,37800,37860,37860,-110,-110,88,"1,666.21",1574
,20161028,37860,37860,38050,38390,38030,38360,38200,500,340,176,"3,362.05",1624
,20161031,38360,38200,38350,38730,38350,38480,38550,280,350,240,"4,627.00",1682
,20161101,38480,38550,38800,38940,38610,38890,38790,340,240,224,"4,345.23",1698
,20161102,38890,38790,38970,39230,38630,38720,38880,-70,90,270,"5,249.88",1658
,20161103,38720,38880,38800,39070,38740,39070,38910,190,30,166,"3,229.84",1554
,20161104,39070,38910,39330,39440,39130,39270,39280,360,370,288,"5,656.61",1620
,20161107,39270,39280,39350,40690,39320,40520,40120,1240,840,772,"15,487.23",1854
,20161108,40520,40120,40340,40810,40320,40640,40540,520,420,364,"7,378.39",1952
,20161109,40640,40540,40530,42050,40530,41700,41630,1160,1090,1236,"25,727.68",2124
,20161110,41700,41630,42540,44120,42350,44120,43430,2490,1800,1672,"36,313.69",2624
,20161111,44120,43430,45190,47010,44500,46740,45570,3310,2140,1770,"40,331.40",2688
,20161114,46740,45570,47270,48300,43800,45500,46390,-70,820,5342,"123,909.09",3726
,20161115,45500,46390,45440,46000,43600,43600,44770,-2790,-1620,1506,"33,715.07",3712
,20161116,43600,44770,43600,44600,43540,44510,44040,-260,-730,1482,"32,637.23",3544
,20161117,44510,44040,44300,44370,43530,43720,43930,-320,-110,498,"10,938.73",3582
,20161118,43720,43930,43910,44600,43880,44310,44210,380,280,258,"5,704.35",3556
,20161121,44310,44210,44480,45440,43770,45380,44890,1170,680,1094,"24,555.32",3332
,20161122,45380,44890,45460,46620,45000,46430,45790,1540,900,710,"16,255.89",3296
,20161123,46430,45790,46000,46350,45670,46060,46020,270,230,828,"19,054.05",3516
,20161124,46060,46020,45800,48780,45750,48470,47650,2450,1630,1086,"25,874.51",3794
,20161125,48470,47650,48130,49100,47760,48300,48390,650,740,876,"21,198.78",3580
,20161128,48300,48390,48350,50190,47980,49880,49370,1490,980,938,"23,156.81",3650
,20161129,49880,49370,49690,49780,47000,47210,48070,-2160,-1300,1408,"33,846.13",3940
,20161130,47210,48070,47440,47570,45550,46350,46440,-1720,-1630,696,"16,163.22",3844
,20161201,46350,46440,46710,47780,46500,47390,47310,950,870,1092,"25,834.91",4180
,20161202,47390,47310,46910,47500,46190,46840,46820,-470,-490,460,"10,770.74",4162
,20161205,46840,46820,46570,47840,46380,47650,47040,830,220,716,"16,843.69",4260
,20161206,47650,47040,47640,48900,47630,48100,48350,1060,1310,1462,"35,350.16",4758
,20161207,48100,48350,47810,48710,47640,48630,48420,280,70,1038,"25,132.56",4830
,20161208,48630,48420,48610,48710,47290,47520,47790,-900,-630,814,"19,454.25",4910
,20161209,47520,47790,47800,48030,46860,47800,47440,10,-350,390,"9,252.52",4906
,20161212,47800,47440,47930,48640,47550,47690,48320,250,880,604,"14,593.81",5044
,20161213,47690,48320,47240,47790,47170,47460,47460,-860,-860,366,"8,685.55",5032
,20161214,47460,47460,47460,48320,46510,46990,47020,-470,-440,570,"13,402.11",4984
,20161215,46990,47020,47030,47550,46680,47290,47080,270,60,204,"4,802.30",4982
,20161216,47290,47080,46910,47980,46750,46820,47130,-260,50,278,"6,551.80",4998
,20161219,46820,47130,46800,46900,46000,46000,46480,-1130,-650,394,"9,157.15",5046
,20161220,46000,46480,45900,45960,44930,45390,45680,-1090,-800,2300,"52,541.52",5866
,20161221,45390,45680,45540,45930,45370,45810,45620,130,-60,1486,"33,897.55",5984
,20161222,45810,45620,45700,45770,44900,44920,45140,-700,-480,624,"14,085.99",6250
,20161223,44920,45140,44960,45660,44660,45600,45420,460,280,960,"21,802.14",6678
,20161226,45600,45420,45120,45480,43930,44630,44510,-790,-910,1500,"33,388.61",7126
,20161227,44630,44510,44760,45250,44450,45100,44910,590,400,1376,"30,900.24",7590
,20161228,45100,44910,45000,46410,44920,46060,46150,1150,1240,1648,"38,028.27",7866
,20161229,46060,46150,45880,46380,45610,46270,45980,120,-170,790,"18,164.48",7964
,20161230,46270,45980,46010,46130,45510,45930,45880,-50,-100,1022,"23,447.86",8006
cu1707,20160718,38520,38520,38600,38700,37890,38040,38180,-480,-340,48,916.50,22
,20160719,38040,38180,38650,38650,38310,38480,38550,300,370,56,"1,079.48",64
,20160720,38480,38550,38540,39030,38460,38850,38610,300,60,94,"1,814.91",114
,20160721,38850,38610,38260,39020,38250,38790,38650,180,40,80,"1,546.35",88
,20160722,38790,38650,38760,38810,38450,38450,38650,-200,0,22,425.17,92
,20160725,38450,38650,38880,38880,38110,38380,38430,-270,-220,38,730.35,98
,20160726,38380,38430,38070,38120,37950,38060,38010,-370,-420,34,646.27,112
,20160727,38060,38010,38250,38260,38000,38010,38180,0,170,110,"2,100.29",188
,20160728,38010,38180,37870,38240,37850,38110,38000,-70,-180,90,"1,710.18",198
,20160729,38110,38000,38300,38370,37810,37810,38060,-190,60,164,"3,121.73",238
,20160801,37810,38060,37920,38490,37910,38490,38280,430,220,124,"2,373.43",304
,20160802,38490,38280,38310,38360,38000,38360,38190,80,-90,448,"8,555.24",658
,20160803,38360,38190,38440,38720,38050,38170,38370,-20,180,270,"5,180.48",858
,20160804,38170,38370,38080,38180,37800,37880,38010,-490,-360,70,"1,330.66",904
,20160805,37880,38010,37770,38030,37630,37960,37870,-50,-140,84,"1,590.74",918
,20160808,37960,37870,37850,38170,37720,37920,37900,50,30,44,833.92,932
,20160809,37920,37900,37980,37980,37510,37580,37720,-320,-180,170,"3,206.57",1052
,20160810,37580,37720,37780,37840,37640,37840,37710,120,-10,32,603.40,1068
,20160811,37840,37710,38050,38100,37840,37900,37920,190,210,80,"1,517.16",1124
,20160812,37900,37920,37900,38170,37900,37970,37960,50,40,20,379.60,1128
,20160815,37970,37960,37710,37720,37420,37650,37630,-310,-330,130,"2,446.35",1240
,20160816,37650,37630,37650,37660,37650,37660,37650,30,20,6,112.97,1242
,20160817,37660,37650,37700,37770,37700,37710,37730,60,80,32,603.70,1256
,20160818,37710,37730,37510,37840,37510,37840,37700,110,-30,26,490.11,1270
,20160819,37840,37700,37900,37900,37760,37860,37850,160,150,16,302.86,1260
,20160822,37860,37850,37770,37770,37610,37640,37670,-210,-180,22,414.46,1262
,20160823,37640,37670,37510,37600,37500,37530,37540,-140,-130,36,675.87,1266
,20160824,37530,37540,37500,37500,37100,37150,37290,-390,-250,78,"1,454.35",1296
,20160825,37150,37290,37000,37060,36620,36850,36780,-440,-510,98,"1,802.46",1272
,20160826,36850,36780,36810,36920,36740,36920,36850,140,70,42,773.87,1266
,20160829,36920,36850,36830,37070,36750,36820,36830,-30,-20,108,"1,989.25",1216
,20160830,36820,36830,36800,36940,36800,36860,36860,30,30,130,"2,396.48",1134
,20160831,36860,36860,36720,36790,36690,36690,36730,-170,-130,32,587.82,1134
,20160901,36690,36730,36760,37060,36760,37040,36960,310,230,18,332.68,1132
,20160902,37040,36960,37020,37110,37020,37110,37060,150,100,24,444.78,1124
,20160905,37110,37060,37000,37050,36880,37000,36990,-60,-70,130,"2,404.42",1078
,20160906,37000,36990,36880,37000,36880,37000,36940,10,-50,160,"2,955.92",1086
,20160907,37000,36940,36980,37250,36870,37150,36960,210,20,428,"7,910.81",816
,20160908,37150,36960,37220,37220,36970,36970,37070,10,110,112,"2,076.25",814
,20160909,36970,37070,37000,37080,37000,37020,37030,-50,-40,154,"2,851.75",814
,20160912,37020,37030,36940,36970,36590,36620,36750,-410,-280,176,"3,234.33",878
,20160913,36620,36750,36780,36950,36760,36820,36860,70,110,168,"3,096.71",868
,20160914,36820,36860,37000,37050,36830,36940,36970,80,110,104,"1,922.85",878
,20160919,36940,36970,37300,37450,37300,37450,37370,480,400,32,598.03,862
,20160920,37450,37370,37500,37590,37440,37490,37470,120,100,26,487.20,858
,20160921,37490,37470,37560,37650,37470,37520,37540,50,70,38,713.28,842
,20160922,37520,37540,37500,37920,37500,37920,37800,380,260,44,831.63,854
,20160923,37920,37800,38080,38150,37920,38110,38040,310,240,38,722.76,852
,20160926,38110,38040,38080,38080,37980,37980,38020,-60,-20,10,190.14,856
,20160927,37980,38020,37980,38000,37750,37880,37850,-140,-170,62,"1,173.40",852
,20160928,37880,37850,37660,37760,37550,37730,37690,-120,-160,32,603.11,860
,20160929,37730,37690,37880,38070,37800,38000,37960,310,270,64,"1,214.80",862
,20160930,38000,37960,37940,38400,37820,37850,37940,-110,-20,84,"1,593.66",870
,20161010,37850,37940,37620,37690,37620,37690,37650,-250,-290,6,112.96,872
,20161011,37690,37650,38190,38290,38100,38290,38170,640,520,22,419.97,872
,20161012,38290,38170,38170,38170,38100,38120,38140,-50,-30,24,457.71,890
,20161013,38120,38140,38130,38130,37900,37900,38070,-240,-70,112,"2,132.23",940
,20161014,37900,38070,37430,37580,37430,37540,37540,-530,-530,30,563.21,960
,20161017,37540,37540,37440,37540,37420,37520,37500,-20,-40,20,375.00,968
,20161018,37520,37500,37430,37580,37400,37570,37470,70,-30,34,637.15,970
,20161019,37570,37470,37440,37460,37440,37440,37440,-30,-30,10,187.23,970
,20161020,37440,37440,37260,37600,37260,37600,37560,160,120,104,"1,953.20",968
,20161021,37600,37560,37400,37410,37260,37370,37350,-190,-210,124,"2,316.03",1008
,20161024,37370,37350,37360,37600,37360,37500,37480,150,130,62,"1,162.06",1018
,20161025,37500,37480,37540,38160,37540,38000,37850,520,370,164,"3,104.50",1086
,20161026,38000,37850,38000,38110,37770,37840,37950,-10,100,136,"2,580.95",1132
,20161027,37840,37950,37930,37970,37870,37900,37900,-50,-50,56,"1,061.20",1132
,20161028,37900,37900,38070,38310,38050,38310,38170,410,270,12,229.05,1126
,20161031,38310,38170,38420,38700,38420,38560,38560,390,390,52,"1,002.56",1124
,20161101,38560,38560,38590,38960,38590,38880,38750,320,190,36,697.54,1116
,20161102,38880,38750,38950,39180,38710,38730,38960,-20,210,36,701.30,1112
,20161103,38730,38960,38850,39050,38850,39050,38970,90,10,26,506.63,1104
,20161104,39050,38970,39450,39480,39140,39200,39320,230,350,80,"1,572.98",1114
,20161107,39200,39320,39400,40640,39400,40500,40230,1180,910,240,"4,828.59",1188
,20161108,40500,40230,40360,40800,40180,40690,40600,460,370,148,"3,004.52",1236
,20161109,40690,40600,40570,42000,40570,41810,41440,1210,840,224,"4,641.95",1192
,20161110,41810,41440,42550,43920,42420,43920,43050,2480,1610,280,"6,028.10",1178
,20161111,43920,43050,44540,46810,44540,46810,45270,3760,2220,420,"9,508.71",1300
,20161114,46810,45270,47180,47980,44030,45640,45950,370,680,328,"7,536.62",1310
,20161115,45640,45950,45120,45960,43190,43500,44390,-2450,-1560,378,"8,391.03",1240
,20161116,43500,44390,43660,44580,43660,44450,44070,60,-320,218,"4,804.05",1246
,20161117,44450,44070,44300,44330,43690,43820,44020,-250,-50,112,"2,465.22",1242
,20161118,43820,44020,43980,44630,43890,44380,44250,360,230,132,"2,920.55",1244
,20161121,44380,44250,44460,45450,43800,45320,44560,1070,310,208,"4,634.74",1294
,20161122,45320,44560,45450,46580,45040,46550,45760,1990,1200,292,"6,682.32",1260
,20161123,46550,45760,46550,46550,45740,46170,46070,410,310,80,"1,843.01",1274
,20161124,46170,46070,45980,48830,44510,48550,47820,2480,1750,218,"5,213.06",1212
,20161125,48550,47820,48510,49080,47860,48390,48510,570,690,226,"5,482.67",1142
,20161128,48390,48510,48500,50080,48100,50030,49290,1520,780,214,"5,274.96",1182
,20161129,50030,49290,49680,49680,47120,47380,47940,-1910,-1350,758,"18,171.26",1380
,20161130,47380,47940,47020,47610,45890,46300,46820,-1640,-1120,102,"2,388.31",1380
,20161201,46300,46820,46850,47840,46750,47530,47190,710,370,142,"3,350.80",1426
,20161202,47530,47190,47350,47350,46600,46960,46890,-230,-300,62,"1,453.84",1442
,20161205,46960,46890,46810,47880,46660,47850,47530,960,640,146,"3,470.18",1432
,20161206,47850,47530,48120,49050,48100,48280,48550,750,1020,574,"13,935.92",1536
,20161207,48280,48550,48100,48910,48100,48860,48660,310,110,220,"5,353.56",1552
,20161208,48860,48660,48690,48930,47600,47730,47890,-930,-770,156,"3,735.77",1554
,20161209,47730,47890,48010,48210,47120,47950,47650,60,-240,58,"1,382.03",1558
,20161212,47950,47650,48080,48840,47970,47970,48610,320,960,88,"2,139.10",1606
,20161213,47970,48610,47680,47950,47330,47580,47610,-1030,-1000,196,"4,666.65",1562
,20161214,47580,47610,47780,47800,46700,47140,47120,-470,-490,44,"1,036.78",1574
,20161215,47140,47120,47260,47630,47190,47630,47550,510,430,60,"1,426.69",1598
,20161216,47630,47550,46890,47520,46890,47040,47360,-510,-190,54,"1,278.77",1598
,20161219,47040,47360,46730,46980,46390,46390,46670,-970,-690,56,"1,306.80",1598
,20161220,46390,46670,46020,46020,45040,45550,45570,-1120,-1100,330,"7,520.38",1698
,20161221,45550,45570,45700,46050,45550,45990,45790,420,220,24,549.52,1696
,20161222,45990,45790,45700,45750,45130,45140,45410,-650,-380,136,"3,088.25",1692
,20161223,45140,45410,45010,45790,44920,45600,45460,190,50,60,"1,363.89",1672
,20161226,45600,45460,45510,45550,44140,44870,44720,-590,-740,440,"9,840.21",1848
,20161227,44870,44720,44900,45420,44640,45310,45220,590,500,420,"9,496.46",1954
,20161228,45310,45220,45290,46630,45270,46190,46200,970,980,320,"7,392.77",2098
,20161229,46190,46200,46010,46540,45930,46500,46180,300,-20,142,"3,278.99",2154
,20161230,46500,46180,46360,46360,45730,46130,46070,-50,-110,202,"4,653.44",2242
cu1708,20160816,37630,37630,37740,37740,37570,37570,37630,-60,0,26,489.22,26
,20160817,37570,37630,37780,37830,37710,37760,37760,130,130,132,"2,492.19",158
,20160818,37760,37760,37600,37800,37600,37800,37760,40,0,24,453.12,170
,20160819,37800,37760,37810,37810,37810,37810,37810,50,50,2,37.81,172
,20160822,37810,37810,37730,37810,37650,37650,37730,-160,-80,16,301.87,170
,20160823,37650,37730,37490,37710,37490,37570,37610,-160,-120,44,827.52,176
,20160824,37570,37610,37450,37450,37170,37170,37260,-440,-350,56,"1,043.53",182
,20160825,37170,37260,37130,37130,36740,36850,36970,-410,-290,54,998.35,208
,20160826,36850,36970,36980,36980,36660,36900,36860,-70,-110,88,"1,621.87",226
,20160829,36900,36860,36790,36910,36790,36870,36860,10,0,94,"1,732.51",264
,20160830,36870,36860,36950,36950,36730,36730,36860,-130,0,126,"2,322.70",350
,20160831,36730,36860,36800,36840,36700,36800,36780,-60,-80,94,"1,728.91",364
,20160901,36800,36780,36930,37060,36890,37050,36920,270,140,96,"1,772.38",442
,20160902,37050,36920,36930,37130,36930,37130,37030,210,110,54,"1,000.01",422
,20160905,37130,37030,37030,37290,36930,37030,37070,0,40,280,"5,189.95",520
,20160906,37030,37070,36930,37030,36930,37030,36980,-40,-90,70,"1,294.46",550
,20160907,37030,36980,36940,37290,36940,37290,37060,310,80,58,"1,074.78",568
,20160908,37290,37060,37160,37160,37000,37000,37060,-60,0,10,185.34,562
,20160909,37000,37060,37060,37060,37060,37060,37060,0,0,12,222.36,564
,20160912,37060,37060,36830,36830,36650,36670,36740,-390,-320,120,"2,204.65",622
,20160913,36670,36740,36810,37000,36760,36890,36920,150,180,28,516.90,618
,20160914,36890,36920,37150,37150,36870,36980,36970,60,50,14,258.82,626
,20160919,36980,36970,37300,37550,37170,37450,37360,480,390,160,"2,989.58",646
,20160920,37450,37360,37500,37540,37480,37490,37490,130,130,30,562.41,634
,20160921,37490,37490,37600,37750,37500,37580,37540,90,50,54,"1,013.69",634
,20160922,37580,37540,37520,37920,37520,37910,37770,370,230,34,642.11,648
,20160923,37910,37770,38050,38180,37990,38140,38050,370,280,38,723.01,632
,20160926,38140,38050,38000,38000,38000,38000,38000,-50,-50,2,38.00,632
,20160927,38000,38000,37800,37800,37800,37800,37800,-200,-200,12,226.80,640
,20160928,37800,37800,37700,37790,37570,37780,37740,-20,-60,46,868.07,648
,20160929,37780,37740,37900,38140,37900,37990,38040,250,300,24,456.51,642
,20160930,37990,38040,37890,37960,37840,37860,37850,-180,-190,194,"3,671.89",768
,20161010,37860,37850,37790,37790,37610,37720,37730,-130,-120,22,415.09,770
,20161011,37720,37730,38200,38330,38130,38330,38190,600,460,24,458.29,780
,20161012,38330,38190,38160,38160,38000,38140,38100,-50,-90,18,342.91,790
,20161013,38140,38100,38260,38280,37800,38010,38080,-90,-20,98,"1,866.17",846
,20161014,38010,38080,37600,37600,37310,37560,37510,-520,-570,102,"1,913.03",860
,20161017,37560,37510,37470,37580,37430,37520,37500,10,-10,60,"1,125.20",886
,20161018,37520,37500,37490,37540,37420,37540,37460,40,-40,28,524.47,896
,20161019,37540,37460,37450,37500,37450,37450,37460,-10,0,20,374.63,912
,20161020,37450,37460,37300,37630,37300,37550,37520,90,60,16,300.19,910
,20161021,37550,37520,37300,37360,37300,37340,37330,-180,-190,16,298.70,910
,20161024,37340,37330,37390,37610,37390,37590,37490,260,160,84,"1,574.90",908
,20161025,37590,37490,37600,38310,37590,38050,37900,560,410,100,"1,895.08",904
,20161026,38050,37900,38200,38200,37810,38070,38020,170,120,98,"1,863.30",934
,20161027,38070,38020,38000,38000,37880,37910,37930,-110,-90,16,303.51,934
,20161028,37910,37930,38110,38340,38110,38340,38210,410,280,36,687.82,932
,20161031,38340,38210,38500,38720,38500,38500,38580,290,370,86,"1,659.12",884
,20161101,38500,38580,38800,39000,38740,38980,38840,400,260,34,660.41,878
,20161102,38980,38840,38970,39180,38740,38740,38950,-100,110,58,"1,129.55",878
,20161103,38740,38950,38910,39100,38910,39100,38990,150,40,22,428.98,874
,20161104,39100,38990,39270,39460,39060,39250,39320,260,330,50,983.14,884
,20161107,39250,39320,39430,40750,39420,40450,40020,1130,700,112,"2,241.43",900
,20161108,40450,40020,40410,40870,40300,40800,40600,780,580,142,"2,883.27",922
,20161109,40800,40600,40580,42240,40580,41730,41590,1130,990,166,"3,452.43",890
,20161110,41730,41590,42570,44080,42440,44080,43200,2490,1610,96,"2,073.88",892
,20161111,44080,43200,44080,46900,44080,46900,45260,3700,2060,292,"6,609.25",924
,20161114,46900,45260,47040,47970,43780,45390,45590,130,330,382,"8,708.84",1002
,20161115,45390,45590,45170,46190,43280,43530,44300,-2060,-1290,248,"5,493.43",988
,20161116,43530,44300,43690,44720,43690,44550,44110,250,-190,168,"3,705.88",960
,20161117,44550,44110,44290,44350,43540,43850,44020,-260,-90,90,"1,981.17",1002
,20161118,43850,44020,44010,44650,44010,44160,44290,140,270,194,"4,296.69",972
,20161121,44160,44290,44480,45510,43800,45280,44910,990,620,350,"7,859.63",1002
,20161122,45280,44910,45460,46610,45230,46320,45690,1410,780,140,"3,198.51",1036
,20161123,46320,45690,46200,46330,45820,46200,46100,510,410,86,"1,982.65",1030
,20161124,46200,46100,45920,48850,45920,48500,47980,2400,1880,86,"2,063.36",1028
,20161125,48500,47980,48760,49190,47860,48370,48560,390,580,110,"2,671.17",1020
,20161128,48370,48560,49130,50230,48300,50210,49420,1650,860,180,"4,448.24",1082
,20161129,50210,49420,50150,50150,47260,47620,48870,-1800,-550,258,"6,305.45",1034
,20161130,47620,48870,47450,47450,45810,46390,46840,-2480,-2030,82,"1,920.80",1026
,20161201,46390,46840,46770,47940,46770,47560,47520,720,680,196,"4,657.59",1056
,20161202,47560,47520,47430,47430,46650,46970,47000,-550,-520,122,"2,867.04",1058
,20161205,46970,47000,46860,48120,46760,47950,47410,950,410,158,"3,746.05",1034
,20161206,47950,47410,48040,49330,48040,48480,48670,1070,1260,292,"7,107.26",1066
,20161207,48480,48670,48420,49050,48310,49000,48780,330,110,142,"3,463.62",1016
,20161208,49000,48780,48870,48880,47720,47950,48140,-830,-640,648,"15,598.43",1482
,20161209,47950,48140,48200,48480,47360,48010,47810,-130,-330,84,"2,008.02",1472
,20161212,48010,47810,48110,49090,47970,48260,48690,450,880,100,"2,434.60",1456
,20161213,48260,48690,47790,48080,47530,47710,47790,-980,-900,130,"3,106.80",1446
,20161214,47710,47790,47900,47910,46810,47340,47320,-450,-470,56,"1,324.97",1448
,20161215,47340,47320,47100,47810,47100,47650,47480,330,160,44,"1,044.56",1436
,20161216,47650,47480,47100,47710,47060,47290,47430,-190,-50,48,"1,138.36",1438
,20161219,47290,47430,47150,47150,46360,46360,46680,-1070,-750,66,"1,540.61",1450
,20161220,46360,46680,45990,46070,45240,45690,45690,-990,-990,156,"3,564.43",1474
,20161221,45690,45690,45800,46200,45800,45990,45940,300,250,40,918.82,1468
,20161222,45990,45940,46090,46090,45270,45270,45480,-670,-460,56,"1,273.56",1502
,20161223,45270,45480,45250,45900,45000,45870,45450,390,-30,74,"1,681.81",1510
,20161226,45870,45450,45660,45660,44470,45000,44930,-450,-520,214,"4,808.52",1510
,20161227,45000,44930,44970,45640,44970,45470,45360,540,430,118,"2,676.30",1566
,20161228,45470,45360,45510,46790,45480,46370,46220,1010,860,150,"3,467.17",1674
,20161229,46370,46220,46280,46740,46120,46690,46340,470,120,120,"2,780.46",1708
,20161230,46690,46340,46450,46500,46130,46300,46230,-40,-110,246,"5,687.05",1688
cu1709,20160920,37360,37360,37560,37640,37560,37580,37590,220,230,24,451.08,18
,20160921,37580,37590,37690,37700,37550,37620,37620,30,30,10,188.11,20
,20160922,37620,37620,37680,37970,37680,37960,37890,340,270,26,492.57,42
,20160923,37960,37890,38250,38270,37780,38100,38030,210,140,46,874.71,52
,20160926,38100,38030,38140,38170,38000,38130,38070,100,40,28,532.99,68
,20160927,38130,38070,37940,37950,37830,37830,37920,-240,-150,12,227.55,66
,20160928,37830,37920,37810,37900,37700,37840,37860,-80,-60,466,"8,823.10",456
,20160929,37840,37860,38040,38200,37910,38080,38120,220,260,196,"3,736.05",480
,20160930,38080,38120,37900,38110,37870,37930,37930,-190,-190,144,"2,731.33",458
,20161010,37930,37930,37730,37810,37680,37750,37750,-180,-180,72,"1,359.35",494
,20161011,37750,37750,38010,38390,38010,38390,38230,640,480,106,"2,026.40",528
,20161012,38390,38230,38170,38350,37870,38180,38180,-50,-50,86,"1,642.06",532
,20161013,38180,38180,38290,38370,37840,37840,38070,-340,-110,100,"1,903.68",544
,20161014,37840,38070,37570,37640,37390,37630,37540,-440,-530,156,"2,928.45",614
,20161017,37630,37540,37480,37620,37480,37550,37540,10,0,58,"1,088.72",634
,20161018,37550,37540,37550,37680,37500,37680,37550,140,10,58,"1,089.05",652
,20161019,37680,37550,37610,37610,37460,37470,37530,-80,-20,30,562.95,652
,20161020,37470,37530,37410,37710,37280,37620,37540,90,10,96,"1,802.37",636
,20161021,37620,37540,37490,37510,37150,37410,37280,-130,-260,374,"6,972.34",740
,20161024,37410,37280,37400,37720,37400,37630,37560,350,280,258,"4,846.05",704
,20161025,37630,37560,37730,38200,37660,38160,37880,600,320,154,"2,917.50",744
,20161026,38160,37880,38080,38360,37800,37880,37990,0,110,118,"2,241.64",750
,20161027,37880,37990,37990,38000,37910,37960,37950,-30,-40,36,683.18,762
,20161028,37960,37950,38160,38490,38110,38400,38300,450,350,216,"4,137.08",800
,20161031,38400,38300,38500,38670,38490,38640,38570,340,270,200,"3,857.72",862
,20161101,38640,38570,38640,39030,38640,39000,38870,430,300,98,"1,904.69",894
,20161102,39000,38870,38850,39240,38710,38820,38930,-50,60,122,"2,374.94",914
,20161103,38820,38930,38920,39150,38860,39150,39040,220,110,34,663.79,920
,20161104,39150,39040,39590,39590,39190,39280,39390,240,350,194,"3,821.00",936
,20161107,39280,39390,39370,40980,39370,40600,40250,1210,860,224,"4,508.55",966
,20161108,40600,40250,40500,40860,40360,40740,40620,490,370,146,"2,965.94",942
,20161109,40740,40620,40650,43040,40650,42130,41630,1510,1010,376,"7,827.57",952
,20161110,42130,41630,42590,44120,42500,44120,43270,2490,1640,342,"7,399.89",988
,20161111,44120,43270,45690,47060,44690,46920,45240,3650,1970,522,"11,809.99",1060
,20161114,46920,45240,47290,47950,44090,45740,45810,500,570,1104,"25,292.57",1310
,20161115,45740,45810,45630,46170,43300,43980,45150,-1830,-660,660,"14,901.24",1460
,20161116,43980,45150,43780,44710,43700,44710,44250,-440,-900,292,"6,461.31",1530
,20161117,44710,44250,44400,44490,43800,43940,44010,-310,-240,204,"4,489.81",1576
,20161118,43940,44010,44080,44740,43980,44480,44430,470,420,282,"6,265.46",1592
,20161121,44480,44430,44580,45590,43860,45290,44660,860,230,354,"7,906.52",1530
,20161122,45290,44660,45520,46770,45230,46660,46000,2000,1340,462,"10,627.34",1462
,20161123,46660,46000,46060,46430,45830,46300,46240,300,240,184,"4,254.45",1514
,20161124,46300,46240,45810,48990,45810,48490,47940,2250,1700,306,"7,334.83",1494
,20161125,48490,47940,48800,49290,48100,48600,48690,660,750,222,"5,404.81",1498
,20161128,48600,48690,48690,50260,48190,50260,49550,1570,860,180,"4,460.01",1500
,20161129,50260,49550,49790,49960,47350,47660,48510,-1890,-1040,152,"3,687.46",1518
,20161130,47660,48510,47510,47740,45870,46800,46970,-1710,-1540,444,"10,427.34",1528
,20161201,46800,46970,47120,48380,47090,47730,47950,760,980,530,"12,706.80",1776
,20161202,47730,47950,47560,47770,46860,47200,47200,-750,-750,210,"4,956.90",1790
,20161205,47200,47200,47800,48300,46810,48110,47750,910,550,332,"7,926.74",1876
,20161206,48110,47750,48060,49850,48060,48720,49070,970,1320,1140,"27,971.50",2362
,20161207,48720,49070,48720,49150,48510,49070,48850,0,-220,324,"7,914.33",2486
,20161208,49070,48850,49100,49190,47840,48130,48320,-720,-530,314,"7,587.22",2496
,20161209,48130,48320,50500,50500,47180,48230,48080,-90,-240,132,"3,173.85",2474
,20161212,48230,48080,48400,49480,48220,48300,49150,220,1070,792,"19,466.09",2852
,20161213,48300,49150,48210,48210,47590,47980,47920,-1170,-1230,680,"16,295.75",2578
,20161214,47980,47920,48070,48100,47050,47560,47480,-360,-440,308,"7,313.19",2614
,20161215,47560,47480,47260,48000,47260,47720,47550,240,70,192,"4,565.65",2652
,20161216,47720,47550,47210,47810,47140,47270,47460,-280,-90,204,"4,841.36",2630
,20161219,47270,47460,47210,47350,46500,46500,46920,-960,-540,136,"3,191.15",2608
,20161220,46500,46920,46360,46360,45280,45840,45830,-1080,-1090,256,"5,867.18",2514
,20161221,45840,45830,45840,46340,45840,46340,46210,510,380,32,739.40,2518
,20161222,46340,46210,46200,46230,45430,45430,45930,-780,-280,86,"1,975.41",2544
,20161223,45430,45930,45370,46090,45070,45910,45560,-20,-370,104,"2,369.33",2598
,20161226,45910,45560,45890,45900,44520,45220,45100,-340,-460,270,"6,089.07",2608
,20161227,45220,45100,45400,45840,45000,45680,45540,580,440,110,"2,505.15",2632
,20161228,45680,45540,45690,46900,45660,46480,46440,940,900,230,"5,341.72",2722
,20161229,46480,46440,46560,46920,46160,46880,46500,440,60,138,"3,208.78",2756
,20161230,46880,46500,46660,46680,46240,46410,46380,-90,-120,98,"2,273.03",2760
cu1710,20161018,37540,37540,37540,37560,37540,37560,37550,20,10,6,112.66,6
,20161019,37560,37550,37600,37600,37500,37500,37550,-50,0,8,150.21,12
,20161020,37500,37550,37420,37700,37310,37660,37490,110,-60,26,487.43,24
,20161021,37660,37490,37580,37580,37450,37450,37490,-40,0,24,449.89,36
,20161024,37450,37490,37540,37720,37490,37720,37630,230,140,46,865.54,50
,20161025,37720,37630,37700,38190,37650,38180,37910,550,280,44,834.10,46
,20161026,38180,37910,38000,38020,37650,37910,37950,0,40,184,"3,491.79",150
,20161027,37910,37950,38020,38020,37960,37980,37990,30,40,12,227.97,156
,20161028,37980,37990,38260,38420,38250,38400,38330,410,340,34,651.63,174
,20161031,38400,38330,38400,38850,38400,38850,38600,520,270,90,"1,737.20",212
,20161101,38850,38600,38690,39070,38670,39070,38860,470,260,88,"1,710.00",230
,20161102,39070,38860,39000,39260,38820,38850,38990,-10,130,64,"1,247.70",264
,20161103,38850,38990,38980,39190,38920,39160,39060,170,70,76,"1,484.55",300
,20161104,39160,39060,39320,39730,39280,39450,39460,390,400,104,"2,052.12",306
,20161107,39450,39460,39370,40790,39370,40550,40090,1090,630,186,"3,728.83",342
,20161108,40550,40090,40550,40800,40400,40710,40610,620,520,170,"3,452.09",410
,20161109,40710,40610,40670,42250,40670,41830,41590,1220,980,148,"3,078.11",408
,20161110,41830,41590,42620,44080,42460,44080,43310,2490,1720,148,"3,205.53",460
,20161111,44080,43310,45770,47190,44670,47040,45320,3730,2010,416,"9,427.11",476
,20161114,47040,45320,47220,48030,43900,45680,46570,360,1250,958,"22,310.45",530
,20161115,45680,46570,45430,46140,43780,43790,45250,-2780,-1320,296,"6,698.23",564
,20161116,43790,45250,43850,44680,43780,44500,44240,-750,-1010,152,"3,362.54",570
,20161117,44500,44240,44380,44380,43710,43910,43990,-330,-250,134,"2,947.61",590
,20161118,43910,43990,44190,44720,44090,44500,44390,510,400,92,"2,042.06",580
,20161121,44500,44390,44550,45530,44120,45450,45110,1060,720,166,"3,744.52",586
,20161122,45450,45110,45470,46700,45360,46630,46080,1520,970,210,"4,839.28",606
,20161123,46630,46080,46080,46490,45950,46240,46270,160,190,304,"7,033.66",584
,20161124,46240,46270,46090,49040,45970,48670,48050,2400,1780,192,"4,613.22",552
,20161125,48670,48050,48880,49430,48210,48600,48830,550,780,192,"4,688.26",602
,20161128,48600,48830,48430,50230,48340,50020,49270,1190,440,98,"2,414.44",624
,20161129,50020,49270,49810,49810,47510,47600,48510,-1670,-760,218,"5,288.33",624
,20161130,47600,48510,47750,47800,45890,46420,47040,-2090,-1470,166,"3,904.62",602
,20161201,46420,47040,47390,48440,47290,47780,47790,740,750,136,"3,250.02",592
,20161202,47780,47790,47630,47860,46860,47280,47280,-510,-510,122,"2,884.60",618
,20161205,47280,47280,46960,48390,46960,48320,48000,1040,720,490,"11,760.46",916
,20161206,48320,48000,48590,49950,48590,48920,49120,920,1120,372,"9,136.33",1002
,20161207,48920,49120,48900,49250,48700,49240,49010,120,-110,190,"4,656.15",1002
,20161208,49240,49010,48900,49040,48200,48260,48460,-750,-550,430,"10,420.30",1166
,20161209,48260,48460,48600,48600,47640,48420,48030,-40,-430,50,"1,200.97",1158
,20161212,48420,48030,48310,49610,48270,48830,49210,800,1180,444,"10,925.71",1232
,20161213,48830,49210,48060,48280,47210,48200,47900,-1010,-1310,222,"5,317.54",1224
,20161214,48200,47900,48400,48400,47220,47600,47570,-300,-330,96,"2,283.62",1222
,20161215,47600,47570,47360,48060,47350,47830,47710,260,140,136,"3,244.29",1238
,20161216,47830,47710,47420,48090,47200,47620,47660,-90,-50,216,"5,147.54",1284
,20161219,47620,47660,47060,47360,46630,46630,46890,-1030,-770,102,"2,391.84",1314
,20161220,46630,46890,46380,46490,45490,46000,46020,-890,-870,230,"5,292.49",1276
,20161221,46000,46020,46210,46570,46090,46390,46320,370,300,40,926.53,1278
,20161222,46390,46320,46360,46400,45500,45610,45930,-710,-390,74,"1,699.58",1282
,20161223,45610,45930,45440,46260,45300,46110,45710,180,-220,110,"2,514.59",1280
,20161226,46110,45710,45990,46190,44750,45500,45600,-210,-110,110,"2,508.03",1308
,20161227,45500,45600,45570,45970,45180,45860,45640,260,40,114,"2,601.50",1316
,20161228,45860,45640,45870,47160,45840,46680,46700,1040,1060,228,"5,323.99",1338
,20161229,46680,46700,46490,47070,46390,47070,46620,370,-80,110,"2,564.34",1340
,20161230,47070,46620,46860,46870,46310,46700,46590,80,-30,60,"1,397.95",1342
cu1711,20161116,45250,45250,44170,45010,44080,45010,44460,-240,-790,14,311.26,10
,20161117,45010,44460,44430,44430,43610,44060,44010,-400,-450,62,"1,364.44",44
,20161118,44060,44010,44180,44800,44090,44160,44320,150,310,62,"1,374.06",44
,20161121,44160,44320,45100,45710,45100,45710,45460,1390,1140,14,318.24,50
,20161122,45710,45460,46100,46750,45250,46590,46180,1130,720,140,"3,233.03",124
,20161123,46590,46180,46220,46620,45570,46340,46360,160,180,172,"3,987.30",180
,20161124,46340,46360,46300,49120,46300,48630,48480,2270,2120,32,775.68,182
,20161125,48630,48480,49200,49250,48080,48600,48380,120,-100,102,"2,467.75",212
,20161128,48600,48380,48430,50190,48430,50140,49290,1760,910,124,"3,056.37",304
,20161129,50140,49290,49720,49900,47570,47960,48610,-1330,-680,272,"6,611.67",426
,20161130,47960,48610,47740,47740,46200,46680,47360,-1930,-1250,300,"7,105.38",472
,20161201,46680,47360,47190,48020,47120,48020,47870,660,510,74,"1,771.21",506
,20161202,48020,47870,47700,47840,46900,47240,47270,-630,-600,130,"3,072.83",520
,20161205,47240,47270,47510,49790,47120,48430,48290,1160,1020,514,"12,412.67",824
,20161206,48430,48290,48540,50360,48510,49020,49540,730,1250,2466,"61,091.02",1942
,20161207,49020,49540,49020,49370,48810,49370,49120,-170,-420,550,"13,509.15",2126
,20161208,49370,49120,49140,49140,48200,48520,48600,-600,-520,76,"1,846.95",2144
,20161209,48520,48600,48040,48560,47870,48560,48210,-40,-390,30,723.18,2140
,20161212,48560,48210,48690,49540,48630,49130,49230,920,1020,148,"3,643.20",2244
,20161213,49130,49230,48440,48440,47760,48200,48080,-1030,-1150,58,"1,394.43",2238
,20161214,48200,48080,48080,48080,47240,47740,47630,-340,-450,36,857.42,2252
,20161215,47740,47630,47550,48050,47400,47930,47660,300,30,146,"3,479.75",2312
,20161216,47930,47660,47410,48150,47280,47560,47810,-100,150,650,"15,538.43",2656
,20161219,47560,47810,47350,47470,46800,46800,47090,-1010,-720,98,"2,307.79",2622
,20161220,46800,47090,46460,46460,45620,46100,46040,-990,-1050,238,"5,478.77",2656
,20161221,46100,46040,46320,46650,46080,46460,46470,420,430,282,"6,552.55",2822
,20161222,46460,46470,46420,46590,45700,45740,46220,-730,-250,256,"5,917.36",2810
,20161223,45740,46220,45560,46370,45240,46230,45670,10,-550,206,"4,704.03",2750
,20161226,46230,45670,46230,46230,44920,45500,45540,-170,-130,84,"1,912.87",2754
,20161227,45500,45540,45640,46070,45350,46070,45770,530,230,114,"2,609.14",2756
,20161228,46070,45770,45950,47300,45950,46860,46640,1090,870,346,"8,070.24",2924
,20161229,46860,46640,46510,47300,46510,47260,47040,620,400,286,"6,728.14",3120
,20161230,47260,47040,46910,47000,46440,46830,46800,-210,-240,94,"2,199.80",3116
cu1712,20161216,47660,47660,47850,48050,47850,47870,47950,210,290,8,191.82,6
,20161219,47870,47950,47720,47720,46830,47500,47060,-450,-890,56,"1,317.85",22
,20161220,47500,47060,46170,46780,45890,46250,46400,-810,-660,784,"18,192.44",514
,20161221,46250,46400,46520,46780,46520,46700,46660,300,260,120,"2,799.81",560
,20161222,46700,46660,46620,46690,45820,45940,46410,-720,-250,214,"4,966.14",646
,20161223,45940,46410,45940,46550,45550,46350,46140,-60,-270,488,"11,259.93",918
,20161226,46350,46140,46180,46390,45000,45820,45730,-320,-410,1286,"29,405.44",1872
,20161227,45820,45730,45770,46190,45590,46190,45930,460,200,1076,"24,713.32",2278
,20161228,46190,45930,46150,47450,46150,47070,47100,1140,1170,974,"22,937.87",2882
,20161229,47070,47100,46890,47500,46380,47500,47140,400,40,2120,"49,973.38",4084
,20161230,47500,47140,47130,47280,46720,47170,47010,30,-130,176,"4,137.36",4082
fu1603,20160104,2340,2340,,,,2340,2340,0,0,0,0.00,0
,20160105,2340,2340,,,,2340,2340,0,0,0,0.00,0
,20160106,2340,2340,,,,2340,2340,0,0,0,0.00,0
,20160107,2340,2340,,,,2340,2340,0,0,0,0.00,0
,20160108,2340,2340,,,,2340,2340,0,0,0,0.00,0
,20160111,2340,2340,,,,2340,2340,0,0,0,0.00,0
,20160112,2340,2340,,,,2340,2340,0,0,0,0.00,0
,20160113,2340,2340,,,,2340,2340,0,0,0,0.00,0
,20160114,2340,2340,,,,2340,2340,0,0,0,0.00,0
,20160115,2340,2340,,,,2340,2340,0,0,0,0.00,0
,20160118,2340,2340,,,,2340,2340,0,0,0,0.00,0
,20160119,2340,2340,,,,2340,2340,0,0,0,0.00,0
,20160120,2340,2340,,,,2340,2340,0,0,0,0.00,0
,20160121,2340,2340,,,,2340,2340,0,0,0,0.00,0
,20160122,2340,2340,,,,2340,2340,0,0,0,0.00,0
,20160125,2340,2340,,,,2340,2340,0,0,0,0.00,0
,20160126,2340,2340,,,,2340,2340,0,0,0,0.00,0
,20160127,2340,2340,,,,2340,2340,0,0,0,0.00,0
,20160128,2340,2340,,,,2340,2340,0,0,0,0.00,0
,20160129,2340,2340,,,,2340,2340,0,0,0,0.00,0
,20160201,2340,2340,,,,2340,2340,0,0,0,0.00,0
,20160202,2340,2340,,,,2340,2340,0,0,0,0.00,0
,20160203,2340,2340,,,,2340,2340,0,0,0,0.00,0
,20160204,2340,2340,,,,2340,2340,0,0,0,0.00,0
,20160205,2340,2340,,,,2340,2340,0,0,0,0.00,0
,20160215,2340,2340,,,,2340,2340,0,0,0,0.00,0
,20160216,2340,2340,,,,2340,2340,0,0,0,0.00,0
,20160217,2340,2340,,,,2340,2340,0,0,0,0.00,0
,20160218,2340,2340,,,,2340,2340,0,0,0,0.00,0
,20160219,2340,2340,,,,2340,2340,0,0,0,0.00,0
,20160222,2340,2340,2225,2230,2225,2230,2227,-110,-113,4,44.55,0
,20160223,2230,2227,,,,2227,2227,0,0,0,0.00,0
,20160224,2227,2227,,,,2227,2227,0,0,0,0.00,0
,20160225,2227,2227,,,,2227,2227,0,0,0,0.00,0
,20160226,2227,2227,,,,2227,2227,0,0,0,0.00,0
,20160229,2227,2227,,,,2227,2227,0,0,0,0.00,0
fu1604,20160104,2553,2530,2576,2581,2572,2572,2576,42,46,8,103.06,12
,20160105,2572,2576,2454,2571,2454,2571,2512,-5,-64,4,50.25,12
,20160106,2571,2512,2470,2589,2470,2584,2547,72,35,6,76.43,12
,20160107,2584,2547,2506,2568,2422,2559,2545,12,-2,24,305.42,16
,20160108,2559,2545,2452,2452,2452,2452,2452,-93,-93,4,49.04,20
,20160111,2452,2452,2411,2574,2411,2565,2543,113,91,22,279.80,18
,20160112,2565,2543,2505,2583,2505,2564,2558,21,15,14,179.08,14
,20160113,2564,2558,2504,2504,2504,2504,2504,-54,-54,2,25.04,12
,20160114,2504,2504,2434,2568,2434,2568,2532,64,28,8,101.28,10
,20160115,2568,2532,2483,2483,2483,2483,2483,-49,-49,2,24.83,12
,20160118,2483,2483,2416,2602,2416,2466,2499,-17,16,8,99.99,12
,20160119,2466,2499,,,,2499,2499,0,0,0,0.00,12
,20160120,2499,2499,2417,2599,2417,2594,2559,95,60,20,255.94,16
,20160121,2594,2559,2564,2590,2491,2512,2539,-47,-20,8,101.57,10
,20160122,2512,2539,2503,2503,2503,2503,2503,-36,-36,2,25.03,12
,20160125,2503,2503,2452,2603,2452,2600,2551,97,48,10,127.58,14
,20160126,2600,2551,2472,2665,2472,2560,2564,9,13,8,102.57,10
,20160127,2560,2564,2510,2665,2510,2550,2556,-14,-8,14,178.96,10
,20160128,2550,2556,2491,2599,2491,2545,2543,-11,-13,28,356.11,10
,20160129,2545,2543,2589,2599,2534,2599,2571,56,28,14,179.99,12
,20160201,2599,2571,2530,2605,2530,2587,2574,16,3,6,77.22,12
,20160202,2587,2574,2531,2605,2531,2580,2574,6,0,8,102.97,12
,20160203,2580,2574,2564,2564,2564,2564,2564,-10,-10,2,25.64,12
,20160204,2564,2564,,,,2564,2564,0,0,0,0.00,12
,20160205,2564,2564,2608,2608,2561,2561,2597,-3,33,34,441.64,6
,20160215,2561,2597,2470,2599,2470,2599,2534,2,-63,8,101.38,10
,20160216,2599,2534,,,,2597,2597,63,63,0,0.00,10
,20160217,2597,2597,2520,2520,2520,2520,2520,-77,-77,2,25.20,10
,20160218,2520,2520,,,,2596,2596,76,76,0,0.00,10
,20160219,2596,2596,2500,2500,2500,2500,2500,-96,-96,2,25.00,12
,20160222,2500,2500,,,,2379,2379,-121,-121,0,0.00,12
,20160223,2379,2379,,,,2497,2497,118,118,0,0.00,12
,20160224,2497,2497,,,,2497,2497,0,0,0,0.00,12
,20160225,2497,2497,,,,2497,2497,0,0,0,0.00,12
,20160226,2497,2497,,,,2497,2497,0,0,0,0.00,12
,20160229,2497,2497,2599,2599,2598,2598,2598,101,101,10,129.94,6
,20160301,2598,2598,2600,2720,2596,2597,2628,-1,30,8,105.13,2
,20160302,2597,2628,2498,2498,2498,2498,2498,-130,-130,2,24.98,0
,20160303,2498,2498,,,,2498,2498,0,0,0,0.00,0
,20160304,2498,2498,,,,2498,2498,0,0,0,0.00,0
,20160307,2498,2498,,,,2498,2498,0,0,0,0.00,0
,20160308,2498,2498,,,,2498,2498,0,0,0,0.00,0
,20160309,2498,2498,,,,2498,2498,0,0,0,0.00,0
,20160310,2498,2498,,,,2498,2498,0,0,0,0.00,0
,20160311,2498,2498,,,,2498,2498,0,0,0,0.00,0
,20160314,2498,2498,,,,2498,2498,0,0,0,0.00,0
,20160315,2498,2498,,,,2498,2498,0,0,0,0.00,0
,20160316,2498,2498,,,,2498,2498,0,0,0,0.00,0
,20160317,2498,2498,,,,2498,2498,0,0,0,0.00,0
,20160318,2498,2498,,,,2498,2498,0,0,0,0.00,0
,20160321,2498,2498,,,,2498,2498,0,0,0,0.00,0
,20160322,2498,2498,,,,2498,2498,0,0,0,0.00,0
,20160323,2498,2498,,,,2498,2498,0,0,0,0.00,0
,20160324,2498,2498,,,,2498,2498,0,0,0,0.00,0
,20160325,2498,2498,,,,2498,2498,0,0,0,0.00,0
,20160328,2498,2498,,,,2498,2498,0,0,0,0.00,0
,20160329,2498,2498,,,,2498,2498,0,0,0,0.00,0
,20160330,2498,2498,,,,2498,2498,0,0,0,0.00,0
,20160331,2498,2498,,,,2498,2498,0,0,0,0.00,0
fu1605,20160104,2550,2550,,,,2550,2550,0,0,0,0.00,4
,20160105,2550,2550,,,,2550,2550,0,0,0,0.00,4
,20160106,2550,2550,,,,2550,2550,0,0,0,0.00,4
,20160107,2550,2550,,,,2550,2550,0,0,0,0.00,4
,20160108,2550,2550,2677,2677,2677,2677,2677,127,127,2,26.77,6
,20160111,2677,2677,2544,2544,2543,2543,2543,-134,-134,4,50.87,2
,20160112,2543,2543,,,,2543,2543,0,0,0,0.00,2
,20160113,2543,2543,,,,2543,2543,0,0,0,0.00,2
,20160114,2543,2543,,,,2543,2543,0,0,0,0.00,2
,20160115,2543,2543,,,,2543,2543,0,0,0,0.00,2
,20160118,2543,2543,,,,2543,2543,0,0,0,0.00,2
,20160119,2543,2543,,,,2543,2543,0,0,0,0.00,2
,20160120,2543,2543,,,,2543,2543,0,0,0,0.00,2
,20160121,2543,2543,,,,2543,2543,0,0,0,0.00,2
,20160122,2543,2543,,,,2543,2543,0,0,0,0.00,2
,20160125,2543,2543,,,,2543,2543,0,0,0,0.00,2
,20160126,2543,2543,,,,2543,2543,0,0,0,0.00,2
,20160127,2543,2543,,,,2543,2543,0,0,0,0.00,2
,20160128,2543,2543,,,,2543,2543,0,0,0,0.00,2
,20160129,2543,2543,2440,2440,2440,2440,2440,-103,-103,4,48.80,6
,20160201,2440,2440,2387,2562,2387,2562,2474,122,34,4,49.49,6
,20160202,2562,2474,2495,2495,2495,2495,2495,21,21,2,24.95,4
,20160203,2495,2495,2495,2495,2495,2495,2495,0,0,2,24.95,4
,20160204,2495,2495,2430,2604,2430,2495,2509,0,14,6,75.29,6
,20160205,2495,2509,2495,2495,2495,2495,2495,-14,-14,2,24.95,4
,20160215,2495,2495,2495,2495,2495,2495,2495,0,0,2,24.95,6
,20160216,2495,2495,2440,2440,2440,2440,2440,-55,-55,2,24.40,4
,20160217,2440,2440,,,,2367,2367,-73,-73,0,0.00,4
,20160218,2367,2367,,,,2485,2485,118,118,0,0.00,4
,20160219,2485,2485,,,,2485,2485,0,0,0,0.00,4
,20160222,2485,2485,,,,2485,2485,0,0,0,0.00,4
,20160223,2485,2485,,,,2485,2485,0,0,0,0.00,4
,20160224,2485,2485,,,,2485,2485,0,0,0,0.00,4
,20160225,2485,2485,2594,2594,2368,2368,2481,-117,-4,4,49.62,4
,20160226,2368,2481,2374,2374,2374,2374,2374,-107,-107,2,23.74,4
,20160229,2374,2374,2366,2366,2366,2366,2366,-8,-8,4,47.32,8
,20160301,2366,2366,2249,2249,2249,2249,2249,-117,-117,2,22.49,6
,20160302,2249,2249,,,,2361,2361,112,112,0,0.00,6
,20160303,2361,2361,2244,2244,2244,2244,2244,-117,-117,2,22.44,4
,20160304,2244,2244,2247,2247,2247,2247,2247,3,3,2,22.47,4
,20160307,2247,2247,2151,2151,2151,2151,2151,-96,-96,2,21.51,4
,20160308,2151,2151,2117,2117,2117,2117,2117,-34,-34,2,21.17,6
,20160309,2117,2117,,,,2117,2117,0,0,0,0.00,6
,20160310,2117,2117,,,,2117,2117,0,0,0,0.00,6
,20160311,2117,2117,2013,2013,2013,2013,2013,-104,-104,2,20.13,6
,20160314,2013,2013,,,,2113,2113,100,100,0,0.00,6
,20160315,2113,2113,,,,2218,2218,105,105,0,0.00,6
,20160316,2218,2218,2110,2110,2110,2110,2110,-108,-108,2,21.10,6
,20160317,2110,2110,,,,2215,2215,105,105,0,0.00,6
,20160318,2215,2215,2110,2110,2110,2110,2110,-105,-105,2,21.10,6
,20160321,2110,2110,,,,2110,2110,0,0,0,0.00,6
,20160322,2110,2110,2215,2215,2215,2215,2215,105,105,2,22.15,4
,20160323,2215,2215,2059,2059,2059,2059,2059,-156,-156,2,20.59,4
,20160324,2059,2059,,,,2161,2161,102,102,0,0.00,4
,20160325,2161,2161,,,,2269,2269,108,108,0,0.00,4
,20160328,2269,2269,2160,2201,2160,2201,2180,-68,-89,4,43.61,6
,20160329,2201,2180,,,,2289,2289,109,109,0,0.00,6
,20160330,2289,2289,2180,2403,2180,2403,2263,114,-26,34,384.87,22
,20160331,2403,2263,2265,2374,2265,2369,2350,106,87,52,611.10,16
,20160401,2369,2350,2425,2437,2334,2424,2395,74,45,30,359.28,18
,20160405,2424,2395,2512,2512,2444,2444,2461,49,66,8,98.46,16
,20160406,2444,2461,,,,2461,2461,0,0,0,0.00,16
,20160407,2461,2461,,,,2461,2461,0,0,0,0.00,16
,20160408,2461,2461,2430,2430,2430,2430,2430,-31,-31,2,24.30,14
,20160411,2430,2430,,,,2430,2430,0,0,0,0.00,14
,20160412,2430,2430,2430,2430,2430,2430,2430,0,0,2,24.30,14
,20160413,2430,2430,2311,2547,2311,2355,2364,-75,-66,36,425.60,8
,20160414,2355,2364,2356,2356,2355,2355,2355,-9,-9,4,47.11,4
,20160415,2355,2355,2395,2471,2395,2471,2433,116,78,4,48.66,2
,20160418,2471,2433,2311,2548,2311,2453,2434,20,1,58,706.02,8
,20160419,2453,2434,2327,2331,2327,2331,2329,-103,-105,6,69.89,4
,20160420,2331,2329,2238,2445,2216,2355,2356,26,27,16,188.51,6
,20160421,2355,2356,2473,2473,2401,2473,2449,117,93,12,146.94,4
,20160422,2473,2449,2354,2354,2328,2328,2341,-121,-108,4,46.82,0
,20160425,2328,2341,2223,2458,2223,2306,2355,-35,14,58,683.21,0
,20160426,2306,2355,,,,2355,2355,0,0,0,0.00,0
,20160427,2355,2355,,,,2355,2355,0,0,0,0.00,0
,20160428,2355,2355,,,,2355,2355,0,0,0,0.00,0
,20160429,2355,2355,,,,2355,2355,0,0,0,0.00,0
fu1606,20160104,2413,2413,,,,2457,2457,44,44,0,0.00,0
,20160105,2457,2457,,,,2396,2396,-61,-61,0,0.00,0
,20160106,2396,2396,,,,2430,2430,34,34,0,0.00,0
,20160107,2430,2430,,,,2428,2428,-2,-2,0,0.00,0
,20160108,2428,2428,,,,2428,2428,0,0,0,0.00,0
,20160111,2428,2428,,,,2306,2306,-122,-122,0,0.00,0
,20160112,2306,2306,,,,2319,2319,13,13,0,0.00,0
,20160113,2319,2319,,,,2270,2270,-49,-49,0,0.00,0
,20160114,2270,2270,,,,2295,2295,25,25,0,0.00,0
,20160115,2295,2295,,,,2250,2250,-45,-45,0,0.00,0
,20160118,2250,2250,,,,2265,2265,15,15,0,0.00,0
,20160119,2265,2265,,,,2265,2265,0,0,0,0.00,0
,20160120,2265,2265,,,,2319,2319,54,54,0,0.00,0
,20160121,2319,2319,,,,2301,2301,-18,-18,0,0.00,0
,20160122,2301,2301,,,,2268,2268,-33,-33,0,0.00,0
,20160125,2268,2268,,,,2312,2312,44,44,0,0.00,0
,20160126,2312,2312,,,,2324,2324,12,12,0,0.00,0
,20160127,2324,2324,,,,2317,2317,-7,-7,0,0.00,0
,20160128,2317,2317,,,,2305,2305,-12,-12,0,0.00,0
,20160129,2305,2305,,,,2211,2211,-94,-94,0,0.00,0
,20160201,2211,2211,,,,2321,2321,110,110,0,0.00,0
,20160202,2321,2321,,,,2340,2340,19,19,0,0.00,0
,20160203,2340,2340,,,,2340,2340,0,0,0,0.00,0
,20160204,2340,2340,,,,2353,2353,13,13,0,0.00,0
,20160205,2353,2353,,,,2339,2339,-14,-14,0,0.00,0
,20160215,2339,2339,,,,2339,2339,0,0,0,0.00,0
,20160216,2339,2339,,,,2287,2287,-52,-52,0,0.00,0
,20160217,2287,2287,,,,2219,2219,-68,-68,0,0.00,0
,20160218,2219,2219,,,,2329,2329,110,110,0,0.00,0
,20160219,2329,2329,,,,2242,2242,-87,-87,0,0.00,0
,20160222,2242,2242,,,,2354,2354,112,112,0,0.00,0
,20160223,2354,2354,2301,2301,2301,2301,2301,-53,-53,2,23.01,2
,20160224,2301,2301,2280,2280,2280,2280,2280,-21,-21,2,22.80,0
,20160225,2280,2280,,,,2276,2276,-4,-4,0,0.00,0
,20160226,2276,2276,,,,2177,2177,-99,-99,0,0.00,0
,20160229,2177,2177,,,,2285,2285,108,108,0,0.00,0
,20160301,2285,2285,,,,2172,2172,-113,-113,0,0.00,0
,20160302,2172,2172,,,,2064,2064,-108,-108,0,0.00,0
,20160303,2064,2064,,,,2167,2167,103,103,0,0.00,0
,20160304,2167,2167,,,,2275,2275,108,108,0,0.00,0
,20160307,2275,2275,,,,2177,2177,-98,-98,0,0.00,0
,20160308,2177,2177,,,,2285,2285,108,108,0,0.00,0
,20160309,2285,2285,,,,2285,2285,0,0,0,0.00,0
,20160310,2285,2285,,,,2285,2285,0,0,0,0.00,0
,20160311,2285,2285,,,,2172,2172,-113,-113,0,0.00,0
,20160314,2172,2172,,,,2280,2280,108,108,0,0.00,0
,20160315,2280,2280,,,,2280,2280,0,0,0,0.00,0
,20160316,2280,2280,,,,2168,2168,-112,-112,0,0.00,0
,20160317,2168,2168,,,,2276,2276,108,108,0,0.00,0
,20160318,2276,2276,,,,2168,2168,-108,-108,0,0.00,0
,20160321,2168,2168,,,,2276,2276,108,108,0,0.00,0
,20160322,2276,2276,,,,2389,2389,113,113,0,0.00,0
,20160323,2389,2389,,,,2269,2269,-120,-120,0,0.00,0
,20160324,2269,2269,,,,2269,2269,0,0,0,0.00,0
,20160325,2269,2269,2160,2160,2160,2160,2160,-109,-109,2,21.60,2
,20160328,2160,2160,,,,2268,2268,108,108,0,0.00,2
,20160329,2268,2268,,,,2268,2268,0,0,0,0.00,2
,20160330,2268,2268,,,,2243,2243,-25,-25,0,0.00,2
,20160331,2243,2243,,,,2329,2329,86,86,0,0.00,2
,20160401,2329,2329,,,,2373,2373,44,44,0,0.00,2
,20160405,2373,2373,2256,2256,2256,2256,2256,-117,-117,2,22.56,4
,20160406,2256,2256,,,,2256,2256,0,0,0,0.00,4
,20160407,2256,2256,,,,2256,2256,0,0,0,0.00,4
,20160408,2256,2256,,,,2227,2227,-29,-29,0,0.00,4
,20160411,2227,2227,,,,2227,2227,0,0,0,0.00,4
,20160412,2227,2227,,,,2227,2227,0,0,0,0.00,4
,20160413,2227,2227,,,,2166,2166,-61,-61,0,0.00,4
,20160414,2166,2166,2065,2065,2065,2065,2065,-101,-101,2,20.65,2
,20160415,2065,2065,,,,2133,2133,68,68,0,0.00,2
,20160418,2133,2133,,,,2134,2134,1,1,0,0.00,2
,20160419,2134,2134,,,,2042,2042,-92,-92,0,0.00,2
,20160420,2042,2042,,,,2144,2144,102,102,0,0.00,2
,20160421,2144,2144,,,,2228,2228,84,84,0,0.00,2
,20160422,2228,2228,,,,2129,2129,-99,-99,0,0.00,2
,20160425,2129,2129,,,,2142,2142,13,13,0,0.00,2
,20160426,2142,2142,,,,2142,2142,0,0,0,0.00,2
,20160427,2142,2142,,,,2142,2142,0,0,0,0.00,2
,20160428,2142,2142,,,,2142,2142,0,0,0,0.00,2
,20160429,2142,2142,2040,2040,2040,2040,2040,-102,-102,2,20.40,0
,20160503,2040,2040,,,,2040,2040,0,0,0,0.00,0
,20160504,2040,2040,,,,2040,2040,0,0,0,0.00,0
,20160505,2040,2040,,,,2040,2040,0,0,0,0.00,0
,20160506,2040,2040,,,,2040,2040,0,0,0,0.00,0
,20160509,2040,2040,,,,2040,2040,0,0,0,0.00,0
,20160510,2040,2040,,,,2040,2040,0,0,0,0.00,0
,20160511,2040,2040,,,,2040,2040,0,0,0,0.00,0
,20160512,2040,2040,,,,2040,2040,0,0,0,0.00,0
,20160513,2040,2040,,,,2040,2040,0,0,0,0.00,0
,20160516,2040,2040,,,,2040,2040,0,0,0,0.00,0
,20160517,2040,2040,,,,2040,2040,0,0,0,0.00,0
,20160518,2040,2040,,,,2040,2040,0,0,0,0.00,0
,20160519,2040,2040,,,,2040,2040,0,0,0,0.00,0
,20160520,2040,2040,,,,2040,2040,0,0,0,0.00,0
,20160523,2040,2040,,,,2040,2040,0,0,0,0.00,0
,20160524,2040,2040,,,,2040,2040,0,0,0,0.00,0
,20160525,2040,2040,,,,2040,2040,0,0,0,0.00,0
,20160526,2040,2040,,,,2040,2040,0,0,0,0.00,0
,20160527,2040,2040,,,,2040,2040,0,0,0,0.00,0
,20160530,2040,2040,,,,2040,2040,0,0,0,0.00,0
,20160531,2040,2040,,,,2040,2040,0,0,0,0.00,0
fu1607,20160104,2414,2414,,,,2414,2414,0,0,0,0.00,2
,20160105,2414,2414,,,,2354,2354,-60,-60,0,0.00,2
,20160106,2354,2354,,,,2387,2387,33,33,0,0.00,2
,20160107,2387,2387,,,,2385,2385,-2,-2,0,0.00,2
,20160108,2385,2385,,,,2503,2503,118,118,0,0.00,2
,20160111,2503,2503,,,,2378,2378,-125,-125,0,0.00,2
,20160112,2378,2378,,,,2392,2392,14,14,0,0.00,2
,20160113,2392,2392,,,,2341,2341,-51,-51,0,0.00,2
,20160114,2341,2341,,,,2367,2367,26,26,0,0.00,2
,20160115,2367,2367,,,,2321,2321,-46,-46,0,0.00,2
,20160118,2321,2321,,,,2336,2336,15,15,0,0.00,2
,20160119,2336,2336,,,,2336,2336,0,0,0,0.00,2
,20160120,2336,2336,,,,2392,2392,56,56,0,0.00,2
,20160121,2392,2392,,,,2373,2373,-19,-19,0,0.00,2
,20160122,2373,2373,,,,2339,2339,-34,-34,0,0.00,2
,20160125,2339,2339,,,,2384,2384,45,45,0,0.00,2
,20160126,2384,2384,,,,2396,2396,12,12,0,0.00,2
,20160127,2396,2396,,,,2389,2389,-7,-7,0,0.00,2
,20160128,2389,2389,,,,2377,2377,-12,-12,0,0.00,2
,20160129,2377,2377,,,,2280,2280,-97,-97,0,0.00,2
,20160201,2280,2280,,,,2394,2394,114,114,0,0.00,2
,20160202,2394,2394,,,,2414,2414,20,20,0,0.00,2
,20160203,2414,2414,,,,2414,2414,0,0,0,0.00,2
,20160204,2414,2414,,,,2428,2428,14,14,0,0.00,2
,20160205,2428,2428,,,,2428,2428,0,0,0,0.00,2
,20160215,2428,2428,,,,2428,2428,0,0,0,0.00,2
,20160216,2428,2428,,,,2374,2374,-54,-54,0,0.00,2
,20160217,2374,2374,,,,2303,2303,-71,-71,0,0.00,2
,20160218,2303,2303,,,,2303,2303,0,0,0,0.00,2
,20160219,2303,2303,,,,2418,2418,115,115,0,0.00,2
,20160222,2418,2418,,,,2301,2301,-117,-117,0,0.00,2
,20160223,2301,2301,,,,2416,2416,115,115,0,0.00,2
,20160224,2416,2416,,,,2393,2393,-23,-23,0,0.00,2
,20160225,2393,2393,,,,2389,2389,-4,-4,0,0.00,2
,20160226,2389,2389,,,,2285,2285,-104,-104,0,0.00,2
,20160229,2285,2285,,,,2277,2277,-8,-8,0,0.00,2
,20160301,2277,2277,,,,2164,2164,-113,-113,0,0.00,2
,20160302,2164,2164,,,,2272,2272,108,108,0,0.00,2
,20160303,2272,2272,2159,2159,2159,2159,2159,-113,-113,6,64.77,8
,20160304,2159,2159,,,,2266,2266,107,107,0,0.00,8
,20160307,2266,2266,,,,2169,2169,-97,-97,0,0.00,8
,20160308,2169,2169,,,,2277,2277,108,108,0,0.00,8
,20160309,2277,2277,,,,2277,2277,0,0,0,0.00,8
,20160310,2277,2277,,,,2277,2277,0,0,0,0.00,8
,20160311,2277,2277,2281,2281,2281,2281,2281,4,4,2,22.81,6
,20160314,2281,2281,,,,2281,2281,0,0,0,0.00,6
,20160315,2281,2281,2170,2170,2170,2170,2170,-111,-111,2,21.70,4
,20160316,2170,2170,,,,2278,2278,108,108,0,0.00,4
,20160317,2278,2278,2169,2169,2169,2169,2169,-109,-109,2,21.69,6
,20160318,2169,2169,,,,2277,2277,108,108,0,0.00,6
,20160321,2277,2277,,,,2277,2277,0,0,0,0.00,6
,20160322,2277,2277,2166,2166,2166,2166,2166,-111,-111,2,21.66,4
,20160323,2166,2166,,,,2274,2274,108,108,0,0.00,4
,20160324,2274,2274,,,,2274,2274,0,0,0,0.00,4
,20160325,2274,2274,,,,2164,2164,-110,-110,0,0.00,4
,20160328,2164,2164,,,,2272,2272,108,108,0,0.00,4
,20160329,2272,2272,,,,2272,2272,0,0,0,0.00,4
,20160330,2272,2272,,,,2247,2247,-25,-25,0,0.00,4
,20160331,2247,2247,,,,2333,2333,86,86,0,0.00,4
,20160401,2333,2333,,,,2377,2377,44,44,0,0.00,4
,20160405,2377,2377,,,,2259,2259,-118,-118,0,0.00,4
,20160406,2259,2259,,,,2259,2259,0,0,0,0.00,4
,20160407,2259,2259,,,,2259,2259,0,0,0,0.00,4
,20160408,2259,2259,,,,2230,2230,-29,-29,0,0.00,4
,20160411,2230,2230,,,,2230,2230,0,0,0,0.00,4
,20160412,2230,2230,,,,2230,2230,0,0,0,0.00,4
,20160413,2230,2230,,,,2169,2169,-61,-61,0,0.00,4
,20160414,2169,2169,,,,2277,2277,108,108,0,0.00,4
,20160415,2277,2277,,,,2352,2352,75,75,0,0.00,4
,20160418,2352,2352,,,,2353,2353,1,1,0,0.00,4
,20160419,2353,2353,2240,2240,2240,2240,2240,-113,-113,2,22.40,2
,20160420,2240,2240,,,,2266,2266,26,26,0,0.00,2
,20160421,2266,2266,,,,2355,2355,89,89,0,0.00,2
,20160422,2355,2355,,,,2251,2251,-104,-104,0,0.00,2
,20160425,2251,2251,,,,2265,2265,14,14,0,0.00,2
,20160426,2265,2265,,,,2265,2265,0,0,0,0.00,2
,20160427,2265,2265,,,,2265,2265,0,0,0,0.00,2
,20160428,2265,2265,,,,2265,2265,0,0,0,0.00,2
,20160429,2265,2265,,,,2157,2157,-108,-108,0,0.00,2
,20160503,2157,2157,,,,2157,2157,0,0,0,0.00,2
,20160504,2157,2157,,,,2157,2157,0,0,0,0.00,2
,20160505,2157,2157,,,,2157,2157,0,0,0,0.00,2
,20160506,2157,2157,,,,2264,2264,107,107,0,0.00,2
,20160509,2264,2264,,,,2264,2264,0,0,0,0.00,2
,20160510,2264,2264,,,,2264,2264,0,0,0,0.00,2
,20160511,2264,2264,,,,2264,2264,0,0,0,0.00,2
,20160512,2264,2264,,,,2264,2264,0,0,0,0.00,2
,20160513,2264,2264,,,,2264,2264,0,0,0,0.00,2
,20160516,2264,2264,,,,2264,2264,0,0,0,0.00,2
,20160517,2264,2264,,,,2264,2264,0,0,0,0.00,2
,20160518,2264,2264,,,,2264,2264,0,0,0,0.00,2
,20160519,2264,2264,,,,2264,2264,0,0,0,0.00,2
,20160520,2264,2264,,,,2264,2264,0,0,0,0.00,2
,20160523,2264,2264,,,,2264,2264,0,0,0,0.00,2
,20160524,2264,2264,,,,2264,2264,0,0,0,0.00,2
,20160525,2264,2264,,,,2264,2264,0,0,0,0.00,2
,20160526,2264,2264,,,,2264,2264,0,0,0,0.00,2
,20160527,2264,2264,,,,2264,2264,0,0,0,0.00,2
,20160530,2264,2264,,,,2264,2264,0,0,0,0.00,2
,20160531,2264,2264,,,,2264,2264,0,0,0,0.00,2
,20160601,2264,2264,,,,2264,2264,0,0,0,0.00,2
,20160602,2264,2264,,,,2264,2264,0,0,0,0.00,2
,20160603,2264,2264,,,,2264,2264,0,0,0,0.00,2
,20160606,2264,2264,,,,2264,2264,0,0,0,0.00,2
,20160607,2264,2264,,,,2264,2264,0,0,0,0.00,2
,20160608,2264,2264,,,,2264,2264,0,0,0,0.00,2
,20160613,2264,2264,,,,2264,2264,0,0,0,0.00,2
,20160614,2264,2264,,,,2264,2264,0,0,0,0.00,2
,20160615,2264,2264,,,,2264,2264,0,0,0,0.00,2
,20160616,2264,2264,,,,2264,2264,0,0,0,0.00,2
,20160617,2264,2264,,,,2264,2264,0,0,0,0.00,2
,20160620,2264,2264,,,,2264,2264,0,0,0,0.00,2
,20160621,2264,2264,,,,2264,2264,0,0,0,0.00,2
,20160622,2264,2264,,,,2264,2264,0,0,0,0.00,2
,20160623,2264,2264,,,,2377,2377,113,113,0,0.00,2
,20160624,2377,2377,,,,2377,2377,0,0,0,0.00,2
,20160627,2377,2377,2495,2495,2495,2495,2495,118,118,2,24.95,0
,20160628,2495,2495,,,,2495,2495,0,0,0,0.00,0
,20160629,2495,2495,,,,2495,2495,0,0,0,0.00,0
,20160630,2495,2495,,,,2495,2495,0,0,0,0.00,0
fu1608,20160104,2499,2499,2600,2600,2405,2520,2508,21,9,6,75.25,0
,20160105,2520,2508,,,,2508,2508,0,0,0,0.00,0
,20160106,2508,2508,,,,2508,2508,0,0,0,0.00,0
,20160107,2508,2508,,,,2508,2508,0,0,0,0.00,0
,20160108,2508,2508,,,,2632,2632,124,124,0,0.00,0
,20160111,2632,2632,,,,2500,2500,-132,-132,0,0.00,0
,20160112,2500,2500,,,,2500,2500,0,0,0,0.00,0
,20160113,2500,2500,,,,2500,2500,0,0,0,0.00,0
,20160114,2500,2500,,,,2500,2500,0,0,0,0.00,0
,20160115,2500,2500,,,,2500,2500,0,0,0,0.00,0
,20160118,2500,2500,,,,2500,2500,0,0,0,0.00,0
,20160119,2500,2500,2600,2625,2600,2625,2612,125,112,4,52.25,4
,20160120,2625,2612,,,,2612,2612,0,0,0,0.00,4
,20160121,2612,2612,,,,2612,2612,0,0,0,0.00,4
,20160122,2612,2612,,,,2612,2612,0,0,0,0.00,4
,20160125,2612,2612,,,,2612,2612,0,0,0,0.00,4
,20160126,2612,2612,2481,2481,2481,2481,2481,-131,-131,2,24.81,2
,20160127,2481,2481,,,,2481,2481,0,0,0,0.00,2
,20160128,2481,2481,,,,2481,2481,0,0,0,0.00,2
,20160129,2481,2481,,,,2481,2481,0,0,0,0.00,2
,20160201,2481,2481,,,,2481,2481,0,0,0,0.00,2
,20160202,2481,2481,2605,2605,2605,2605,2605,124,124,2,26.05,4
,20160203,2605,2605,,,,2605,2605,0,0,0,0.00,4
,20160204,2605,2605,,,,2605,2605,0,0,0,0.00,4
,20160205,2605,2605,,,,2605,2605,0,0,0,0.00,4
,20160215,2605,2605,,,,2605,2605,0,0,0,0.00,4
,20160216,2605,2605,,,,2605,2605,0,0,0,0.00,4
,20160217,2605,2605,,,,2605,2605,0,0,0,0.00,4
,20160218,2605,2605,,,,2605,2605,0,0,0,0.00,4
,20160219,2605,2605,,,,2605,2605,0,0,0,0.00,4
,20160222,2605,2605,,,,2605,2605,0,0,0,0.00,4
,20160223,2605,2605,,,,2605,2605,0,0,0,0.00,4
,20160224,2605,2605,,,,2605,2605,0,0,0,0.00,4
,20160225,2605,2605,,,,2605,2605,0,0,0,0.00,4
,20160226,2605,2605,,,,2492,2492,-113,-113,0,0.00,4
,20160229,2492,2492,,,,2483,2483,-9,-9,0,0.00,4
,20160301,2483,2483,,,,2360,2360,-123,-123,0,0.00,4
,20160302,2360,2360,,,,2243,2243,-117,-117,0,0.00,4
,20160303,2243,2243,2355,2355,2355,2355,2355,112,112,6,70.65,10
,20160304,2355,2355,2444,2444,2444,2444,2444,89,89,2,24.44,8
,20160307,2444,2444,2355,2355,2355,2355,2355,-89,-89,2,23.55,8
,20160308,2355,2355,,,,2317,2317,-38,-38,0,0.00,8
,20160309,2317,2317,2205,2432,2205,2432,2356,115,39,6,70.69,8
,20160310,2432,2356,2309,2309,2309,2309,2309,-47,-47,2,23.09,6
,20160311,2309,2309,,,,2313,2313,4,4,0,0.00,6
,20160314,2313,2313,2313,2313,2313,2313,2313,0,0,2,23.13,4
,20160315,2313,2313,,,,2200,2200,-113,-113,0,0.00,4
,20160316,2200,2200,,,,2310,2310,110,110,0,0.00,4
,20160317,2310,2310,,,,2199,2199,-111,-111,0,0.00,4
,20160318,2199,2199,,,,2308,2308,109,109,0,0.00,4
,20160321,2308,2308,,,,2308,2308,0,0,0,0.00,4
,20160322,2308,2308,,,,2195,2195,-113,-113,0,0.00,4
,20160323,2195,2195,,,,2304,2304,109,109,0,0.00,4
,20160324,2304,2304,,,,2304,2304,0,0,0,0.00,4
,20160325,2304,2304,,,,2193,2193,-111,-111,0,0.00,4
,20160328,2193,2193,,,,2302,2302,109,109,0,0.00,4
,20160329,2302,2302,,,,2302,2302,0,0,0,0.00,4
,20160330,2302,2302,,,,2276,2276,-26,-26,0,0.00,4
,20160331,2276,2276,,,,2363,2363,87,87,0,0.00,4
,20160401,2363,2363,,,,2408,2408,45,45,0,0.00,4
,20160405,2408,2408,,,,2289,2289,-119,-119,0,0.00,4
,20160406,2289,2289,,,,2289,2289,0,0,0,0.00,4
,20160407,2289,2289,,,,2289,2289,0,0,0,0.00,4
,20160408,2289,2289,,,,2260,2260,-29,-29,0,0.00,4
,20160411,2260,2260,,,,2260,2260,0,0,0,0.00,4
,20160412,2260,2260,,,,2260,2260,0,0,0,0.00,4
,20160413,2260,2260,,,,2199,2199,-61,-61,0,0.00,4
,20160414,2199,2199,,,,2308,2308,109,109,0,0.00,4
,20160415,2308,2308,,,,2384,2384,76,76,0,0.00,4
,20160418,2384,2384,,,,2385,2385,1,1,0,0.00,4
,20160419,2385,2385,,,,2270,2270,-115,-115,0,0.00,4
,20160420,2270,2270,,,,2296,2296,26,26,0,0.00,4
,20160421,2296,2296,,,,2386,2386,90,90,0,0.00,4
,20160422,2386,2386,,,,2280,2280,-106,-106,0,0.00,4
,20160425,2280,2280,,,,2294,2294,14,14,0,0.00,4
,20160426,2294,2294,,,,2294,2294,0,0,0,0.00,4
,20160427,2294,2294,,,,2294,2294,0,0,0,0.00,4
,20160428,2294,2294,,,,2294,2294,0,0,0,0.00,4
,20160429,2294,2294,,,,2184,2184,-110,-110,0,0.00,4
,20160503,2184,2184,,,,2184,2184,0,0,0,0.00,4
,20160504,2184,2184,,,,2184,2184,0,0,0,0.00,4
,20160505,2184,2184,2080,2293,2080,2293,2269,109,85,18,204.24,16
,20160506,2293,2269,2450,2450,2355,2390,2389,121,120,80,955.77,10
,20160509,2390,2389,,,,2389,2389,0,0,0,0.00,10
,20160510,2389,2389,2339,2339,2339,2339,2339,-50,-50,2,23.39,8
,20160511,2339,2339,,,,2339,2339,0,0,0,0.00,8
,20160512,2339,2339,,,,2339,2339,0,0,0,0.00,8
,20160513,2339,2339,,,,2340,2340,1,1,0,0.00,8
,20160516,2340,2340,,,,2343,2343,3,3,0,0.00,8
,20160517,2343,2343,2230,2410,2230,2410,2326,67,-17,6,69.80,6
,20160518,2410,2326,2322,2322,2322,2322,2322,-4,-4,2,23.22,4
,20160519,2322,2322,,,,2322,2322,0,0,0,0.00,4
,20160520,2322,2322,,,,2322,2322,0,0,0,0.00,4
,20160523,2322,2322,,,,2350,2350,28,28,0,0.00,4
,20160524,2350,2350,,,,2350,2350,0,0,0,0.00,4
,20160525,2350,2350,,,,2350,2350,0,0,0,0.00,4
,20160526,2350,2350,,,,2350,2350,0,0,0,0.00,4
,20160527,2350,2350,,,,2350,2350,0,0,0,0.00,4
,20160530,2350,2350,,,,2350,2350,0,0,0,0.00,4
,20160531,2350,2350,,,,2350,2350,0,0,0,0.00,4
,20160601,2350,2350,,,,2350,2350,0,0,0,0.00,4
,20160602,2350,2350,,,,2350,2350,0,0,0,0.00,4
,20160603,2350,2350,,,,2350,2350,0,0,0,0.00,4
,20160606,2350,2350,,,,2350,2350,0,0,0,0.00,4
,20160607,2350,2350,,,,2350,2350,0,0,0,0.00,4
,20160608,2350,2350,,,,2352,2352,2,2,0,0.00,4
,20160613,2352,2352,,,,2356,2356,4,4,0,0.00,4
,20160614,2356,2356,,,,2356,2356,0,0,0,0.00,4
,20160615,2356,2356,,,,2356,2356,0,0,0,0.00,4
,20160616,2356,2356,,,,2361,2361,5,5,0,0.00,4
,20160617,2361,2361,,,,2361,2361,0,0,0,0.00,4
,20160620,2361,2361,,,,2361,2361,0,0,0,0.00,4
,20160621,2361,2361,,,,2361,2361,0,0,0,0.00,4
,20160622,2361,2361,,,,2361,2361,0,0,0,0.00,4
,20160623,2361,2361,,,,2361,2361,0,0,0,0.00,4
,20160624,2361,2361,,,,2361,2361,0,0,0,0.00,4
,20160627,2361,2361,,,,2478,2478,117,117,0,0.00,4
,20160628,2478,2478,2564,2564,2564,2564,2564,86,86,2,25.64,4
,20160629,2564,2564,2439,2532,2439,2532,2499,-32,-65,8,99.98,6
,20160630,2532,2499,,,,2516,2516,17,17,0,0.00,6
,20160701,2516,2516,,,,2516,2516,0,0,0,0.00,6
,20160704,2516,2516,,,,2516,2516,0,0,0,0.00,6
,20160705,2516,2516,2390,2390,2390,2390,2390,-126,-126,2,23.90,4
,20160706,2390,2390,,,,2390,2390,0,0,0,0.00,4
,20160707,2390,2390,,,,2390,2390,0,0,0,0.00,4
,20160708,2390,2390,2390,2390,2390,2390,2390,0,0,2,23.90,2
,20160711,2390,2390,,,,2390,2390,0,0,0,0.00,2
,20160712,2390,2390,,,,2390,2390,0,0,0,0.00,2
,20160713,2390,2390,,,,2390,2390,0,0,0,0.00,2
,20160714,2390,2390,,,,2390,2390,0,0,0,0.00,2
,20160715,2390,2390,,,,2390,2390,0,0,0,0.00,2
,20160718,2390,2390,,,,2390,2390,0,0,0,0.00,2
,20160719,2390,2390,,,,2390,2390,0,0,0,0.00,2
,20160720,2390,2390,,,,2390,2390,0,0,0,0.00,2
,20160721,2390,2390,,,,2390,2390,0,0,0,0.00,2
,20160722,2390,2390,,,,2390,2390,0,0,0,0.00,2
,20160725,2390,2390,2270,2270,2270,2270,2270,-120,-120,2,22.70,0
,20160726,2270,2270,,,,2270,2270,0,0,0,0.00,0
,20160727,2270,2270,,,,2270,2270,0,0,0,0.00,0
,20160728,2270,2270,,,,2270,2270,0,0,0,0.00,0
,20160729,2270,2270,,,,2270,2270,0,0,0,0.00,0
fu1609,20160104,2536,2536,,,,2536,2536,0,0,0,0.00,2
,20160105,2536,2536,,,,2473,2473,-63,-63,0,0.00,2
,20160106,2473,2473,,,,2508,2508,35,35,0,0.00,2
,20160107,2508,2508,,,,2508,2508,0,0,0,0.00,2
,20160108,2508,2508,,,,2632,2632,124,124,0,0.00,2
,20160111,2632,2632,,,,2632,2632,0,0,0,0.00,2
,20160112,2632,2632,,,,2632,2632,0,0,0,0.00,2
,20160113,2632,2632,2746,2746,2500,2500,2582,-132,-50,6,77.46,0
,20160114,2500,2582,,,,2610,2610,28,28,0,0.00,0
,20160115,2610,2610,,,,2559,2559,-51,-51,0,0.00,0
,20160118,2559,2559,,,,2576,2576,17,17,0,0.00,0
,20160119,2576,2576,,,,2691,2691,115,115,0,0.00,0
,20160120,2691,2691,,,,2756,2756,65,65,0,0.00,0
,20160121,2756,2756,,,,2734,2734,-22,-22,0,0.00,0
,20160122,2734,2734,,,,2695,2695,-39,-39,0,0.00,0
,20160125,2695,2695,,,,2747,2747,52,52,0,0.00,0
,20160126,2747,2747,,,,2609,2609,-138,-138,0,0.00,0
,20160127,2609,2609,,,,2601,2601,-8,-8,0,0.00,0
,20160128,2601,2601,,,,2588,2588,-13,-13,0,0.00,0
,20160129,2588,2588,,,,2588,2588,0,0,0,0.00,0
,20160201,2588,2588,,,,2624,2624,36,36,0,0.00,0
,20160202,2624,2624,,,,2755,2755,131,131,0,0.00,0
,20160203,2755,2755,,,,2755,2755,0,0,0,0.00,0
,20160204,2755,2755,,,,2771,2771,16,16,0,0.00,0
,20160205,2771,2771,,,,2755,2755,-16,-16,0,0.00,0
,20160215,2755,2755,,,,2755,2755,0,0,0,0.00,0
,20160216,2755,2755,,,,2694,2694,-61,-61,0,0.00,0
,20160217,2694,2694,,,,2614,2614,-80,-80,0,0.00,0
,20160218,2614,2614,,,,2614,2614,0,0,0,0.00,0
,20160219,2614,2614,,,,2517,2517,-97,-97,0,0.00,0
,20160222,2517,2517,,,,2395,2395,-122,-122,0,0.00,0
,20160223,2395,2395,,,,2341,2341,-54,-54,0,0.00,0
,20160224,2341,2341,,,,2458,2458,117,117,0,0.00,0
,20160225,2458,2458,,,,2454,2454,-4,-4,0,0.00,0
,20160226,2454,2454,,,,2348,2348,-106,-106,0,0.00,0
,20160229,2348,2348,,,,2340,2340,-8,-8,0,0.00,0
,20160301,2340,2340,,,,2224,2224,-116,-116,0,0.00,0
,20160302,2224,2224,,,,2335,2335,111,111,0,0.00,0
,20160303,2335,2335,,,,2451,2451,116,116,0,0.00,0
,20160304,2451,2451,,,,2543,2543,92,92,0,0.00,0
,20160307,2543,2543,,,,2543,2543,0,0,0,0.00,0
,20160308,2543,2543,,,,2543,2543,0,0,0,0.00,0
,20160309,2543,2543,,,,2586,2586,43,43,0,0.00,0
,20160310,2586,2586,,,,2534,2534,-52,-52,0,0.00,0
,20160311,2534,2534,,,,2538,2538,4,4,0,0.00,0
,20160314,2538,2538,,,,2538,2538,0,0,0,0.00,0
,20160315,2538,2538,,,,2538,2538,0,0,0,0.00,0
,20160316,2538,2538,,,,2538,2538,0,0,0,0.00,0
,20160317,2538,2538,,,,2538,2538,0,0,0,0.00,0
,20160318,2538,2538,,,,2538,2538,0,0,0,0.00,0
,20160321,2538,2538,,,,2538,2538,0,0,0,0.00,0
,20160322,2538,2538,,,,2538,2538,0,0,0,0.00,0
,20160323,2538,2538,,,,2538,2538,0,0,0,0.00,0
,20160324,2538,2538,,,,2538,2538,0,0,0,0.00,0
,20160325,2538,2538,,,,2538,2538,0,0,0,0.00,0
,20160328,2538,2538,,,,2538,2538,0,0,0,0.00,0
,20160329,2538,2538,,,,2538,2538,0,0,0,0.00,0
,20160330,2538,2538,,,,2510,2510,-28,-28,0,0.00,0
,20160331,2510,2510,,,,2606,2606,96,96,0,0.00,0
,20160401,2606,2606,,,,2656,2656,50,50,0,0.00,0
,20160405,2656,2656,,,,2525,2525,-131,-131,0,0.00,0
,20160406,2525,2525,,,,2525,2525,0,0,0,0.00,0
,20160407,2525,2525,2651,2651,2425,2425,2538,-100,13,4,50.76,2
,20160408,2425,2538,,,,2538,2538,0,0,0,0.00,2
,20160411,2538,2538,,,,2538,2538,0,0,0,0.00,2
,20160412,2538,2538,,,,2538,2538,0,0,0,0.00,2
,20160413,2538,2538,,,,2538,2538,0,0,0,0.00,2
,20160414,2538,2538,,,,2419,2419,-119,-119,0,0.00,2
,20160415,2419,2419,,,,2419,2419,0,0,0,0.00,2
,20160418,2419,2419,,,,2420,2420,1,1,0,0.00,2
,20160419,2420,2420,,,,2303,2303,-117,-117,0,0.00,2
,20160420,2303,2303,,,,2330,2330,27,27,0,0.00,2
,20160421,2330,2330,,,,2421,2421,91,91,0,0.00,2
,20160422,2421,2421,,,,2314,2314,-107,-107,0,0.00,2
,20160425,2314,2314,,,,2328,2328,14,14,0,0.00,2
,20160426,2328,2328,,,,2328,2328,0,0,0,0.00,2
,20160427,2328,2328,,,,2328,2328,0,0,0,0.00,2
,20160428,2328,2328,,,,2328,2328,0,0,0,0.00,2
,20160429,2328,2328,,,,2217,2217,-111,-111,0,0.00,2
,20160503,2217,2217,,,,2217,2217,0,0,0,0.00,2
,20160504,2217,2217,,,,2217,2217,0,0,0,0.00,2
,20160505,2217,2217,,,,2303,2303,86,86,0,0.00,2
,20160506,2303,2303,,,,2303,2303,0,0,0,0.00,2
,20160509,2303,2303,2191,2191,2191,2191,2191,-112,-112,2,21.91,4
,20160510,2191,2191,2300,2300,2300,2300,2300,109,109,4,46.00,2
,20160511,2300,2300,2190,2203,2190,2203,2196,-97,-104,4,43.93,6
,20160512,2203,2196,,,,2305,2305,109,109,0,0.00,6
,20160513,2305,2305,2420,2420,2420,2420,2420,115,115,6,72.60,2
,20160516,2420,2420,,,,2420,2420,0,0,0,0.00,2
,20160517,2420,2420,,,,2420,2420,0,0,0,0.00,2
,20160518,2420,2420,2392,2392,2392,2392,2392,-28,-28,2,23.92,2
,20160519,2392,2392,2275,2391,2275,2391,2333,-1,-59,4,46.66,0
,20160520,2391,2333,,,,2360,2360,27,27,0,0.00,0
,20160523,2360,2360,,,,2360,2360,0,0,0,0.00,0
,20160524,2360,2360,,,,2360,2360,0,0,0,0.00,0
,20160525,2360,2360,,,,2360,2360,0,0,0,0.00,0
,20160526,2360,2360,,,,2360,2360,0,0,0,0.00,0
,20160527,2360,2360,,,,2360,2360,0,0,0,0.00,0
,20160530,2360,2360,,,,2360,2360,0,0,0,0.00,0
,20160531,2360,2360,,,,2360,2360,0,0,0,0.00,0
,20160601,2360,2360,,,,2360,2360,0,0,0,0.00,0
,20160602,2360,2360,,,,2360,2360,0,0,0,0.00,0
,20160603,2360,2360,,,,2360,2360,0,0,0,0.00,0
,20160606,2360,2360,,,,2360,2360,0,0,0,0.00,0
,20160607,2360,2360,,,,2360,2360,0,0,0,0.00,0
,20160608,2360,2360,,,,2360,2360,0,0,0,0.00,0
,20160613,2360,2360,,,,2360,2360,0,0,0,0.00,0
,20160614,2360,2360,,,,2360,2360,0,0,0,0.00,0
,20160615,2360,2360,,,,2360,2360,0,0,0,0.00,0
,20160616,2360,2360,,,,2360,2360,0,0,0,0.00,0
,20160617,2360,2360,,,,2360,2360,0,0,0,0.00,0
,20160620,2360,2360,,,,2360,2360,0,0,0,0.00,0
,20160621,2360,2360,,,,2360,2360,0,0,0,0.00,0
,20160622,2360,2360,,,,2360,2360,0,0,0,0.00,0
,20160623,2360,2360,,,,2360,2360,0,0,0,0.00,0
,20160624,2360,2360,,,,2360,2360,0,0,0,0.00,0
,20160627,2360,2360,,,,2360,2360,0,0,0,0.00,0
,20160628,2360,2360,2478,2478,2242,2470,2390,110,30,8,95.63,2
,20160629,2470,2390,,,,2329,2329,-61,-61,0,0.00,2
,20160630,2329,2329,2298,2298,2298,2298,2298,-31,-31,2,22.98,0
,20160701,2298,2298,,,,2298,2298,0,0,0,0.00,0
,20160704,2298,2298,,,,2298,2298,0,0,0,0.00,0
,20160705,2298,2298,,,,2183,2183,-115,-115,0,0.00,0
,20160706,2183,2183,,,,2183,2183,0,0,0,0.00,0
,20160707,2183,2183,,,,2183,2183,0,0,0,0.00,0
,20160708,2183,2183,,,,2183,2183,0,0,0,0.00,0
,20160711,2183,2183,,,,2183,2183,0,0,0,0.00,0
,20160712,2183,2183,,,,2183,2183,0,0,0,0.00,0
,20160713,2183,2183,,,,2183,2183,0,0,0,0.00,0
,20160714,2183,2183,,,,2183,2183,0,0,0,0.00,0
,20160715,2183,2183,,,,2183,2183,0,0,0,0.00,0
,20160718,2183,2183,,,,2183,2183,0,0,0,0.00,0
,20160719,2183,2183,,,,2183,2183,0,0,0,0.00,0
,20160720,2183,2183,,,,2183,2183,0,0,0,0.00,0
,20160721,2183,2183,,,,2183,2183,0,0,0,0.00,0
,20160722,2183,2183,,,,2183,2183,0,0,0,0.00,0
,20160725,2183,2183,,,,2073,2073,-110,-110,0,0.00,0
,20160726,2073,2073,,,,2073,2073,0,0,0,0.00,0
,20160727,2073,2073,,,,2073,2073,0,0,0,0.00,0
,20160728,2073,2073,,,,2073,2073,0,0,0,0.00,0
,20160729,2073,2073,,,,2073,2073,0,0,0,0.00,0
,20160801,2073,2073,,,,2073,2073,0,0,0,0.00,0
,20160802,2073,2073,,,,2073,2073,0,0,0,0.00,0
,20160803,2073,2073,,,,2073,2073,0,0,0,0.00,0
,20160804,2073,2073,,,,2073,2073,0,0,0,0.00,0
,20160805,2073,2073,,,,2073,2073,0,0,0,0.00,0
,20160808,2073,2073,,,,2073,2073,0,0,0,0.00,0
,20160809,2073,2073,,,,2073,2073,0,0,0,0.00,0
,20160810,2073,2073,,,,2073,2073,0,0,0,0.00,0
,20160811,2073,2073,,,,2073,2073,0,0,0,0.00,0
,20160812,2073,2073,,,,2073,2073,0,0,0,0.00,0
,20160815,2073,2073,,,,2073,2073,0,0,0,0.00,0
,20160816,2073,2073,,,,2073,2073,0,0,0,0.00,0
,20160817,2073,2073,,,,2073,2073,0,0,0,0.00,0
,20160818,2073,2073,,,,2073,2073,0,0,0,0.00,0
,20160819,2073,2073,,,,2073,2073,0,0,0,0.00,0
,20160822,2073,2073,,,,2073,2073,0,0,0,0.00,0
,20160823,2073,2073,,,,2073,2073,0,0,0,0.00,0
,20160824,2073,2073,,,,2073,2073,0,0,0,0.00,0
,20160825,2073,2073,,,,2073,2073,0,0,0,0.00,0
,20160826,2073,2073,,,,2073,2073,0,0,0,0.00,0
,20160829,2073,2073,,,,2073,2073,0,0,0,0.00,0
,20160830,2073,2073,,,,2073,2073,0,0,0,0.00,0
,20160831,2073,2073,,,,2073,2073,0,0,0,0.00,0
fu1610,20160104,2472,2472,,,,2472,2472,0,0,0,0.00,0
,20160105,2472,2472,,,,2472,2472,0,0,0,0.00,0
,20160106,2472,2472,,,,2472,2472,0,0,0,0.00,0
,20160107,2472,2472,,,,2472,2472,0,0,0,0.00,0
,20160108,2472,2472,,,,2472,2472,0,0,0,0.00,0
,20160111,2472,2472,,,,2472,2472,0,0,0,0.00,0
,20160112,2472,2472,,,,2472,2472,0,0,0,0.00,0
,20160113,2472,2472,,,,2472,2472,0,0,0,0.00,0
,20160114,2472,2472,,,,2472,2472,0,0,0,0.00,0
,20160115,2472,2472,,,,2472,2472,0,0,0,0.00,0
,20160118,2472,2472,,,,2472,2472,0,0,0,0.00,0
,20160119,2472,2472,,,,2472,2472,0,0,0,0.00,0
,20160120,2472,2472,,,,2472,2472,0,0,0,0.00,0
,20160121,2472,2472,,,,2472,2472,0,0,0,0.00,0
,20160122,2472,2472,,,,2472,2472,0,0,0,0.00,0
,20160125,2472,2472,,,,2472,2472,0,0,0,0.00,0
,20160126,2472,2472,,,,2472,2472,0,0,0,0.00,0
,20160127,2472,2472,,,,2472,2472,0,0,0,0.00,0
,20160128,2472,2472,,,,2472,2472,0,0,0,0.00,0
,20160129,2472,2472,,,,2472,2472,0,0,0,0.00,0
,20160201,2472,2472,,,,2472,2472,0,0,0,0.00,0
,20160202,2472,2472,,,,2472,2472,0,0,0,0.00,0
,20160203,2472,2472,,,,2472,2472,0,0,0,0.00,0
,20160204,2472,2472,,,,2472,2472,0,0,0,0.00,0
,20160205,2472,2472,,,,2472,2472,0,0,0,0.00,0
,20160215,2472,2472,,,,2472,2472,0,0,0,0.00,0
,20160216,2472,2472,,,,2472,2472,0,0,0,0.00,0
,20160217,2472,2472,,,,2472,2472,0,0,0,0.00,0
,20160218,2472,2472,,,,2472,2472,0,0,0,0.00,0
,20160219,2472,2472,,,,2472,2472,0,0,0,0.00,0
,20160222,2472,2472,,,,2472,2472,0,0,0,0.00,0
,20160223,2472,2472,,,,2472,2472,0,0,0,0.00,0
,20160224,2472,2472,,,,2472,2472,0,0,0,0.00,0
,20160225,2472,2472,,,,2472,2472,0,0,0,0.00,0
,20160226,2472,2472,,,,2472,2472,0,0,0,0.00,0
,20160229,2472,2472,,,,2472,2472,0,0,0,0.00,0
,20160301,2472,2472,,,,2472,2472,0,0,0,0.00,0
,20160302,2472,2472,,,,2472,2472,0,0,0,0.00,0
,20160303,2472,2472,,,,2472,2472,0,0,0,0.00,0
,20160304,2472,2472,,,,2472,2472,0,0,0,0.00,0
,20160307,2472,2472,,,,2472,2472,0,0,0,0.00,0
,20160308,2472,2472,,,,2472,2472,0,0,0,0.00,0
,20160309,2472,2472,,,,2472,2472,0,0,0,0.00,0
,20160310,2472,2472,,,,2472,2472,0,0,0,0.00,0
,20160311,2472,2472,,,,2472,2472,0,0,0,0.00,0
,20160314,2472,2472,,,,2472,2472,0,0,0,0.00,0
,20160315,2472,2472,,,,2472,2472,0,0,0,0.00,0
,20160316,2472,2472,,,,2472,2472,0,0,0,0.00,0
,20160317,2472,2472,,,,2472,2472,0,0,0,0.00,0
,20160318,2472,2472,,,,2472,2472,0,0,0,0.00,0
,20160321,2472,2472,,,,2472,2472,0,0,0,0.00,0
,20160322,2472,2472,,,,2472,2472,0,0,0,0.00,0
,20160323,2472,2472,,,,2472,2472,0,0,0,0.00,0
,20160324,2472,2472,,,,2472,2472,0,0,0,0.00,0
,20160325,2472,2472,,,,2472,2472,0,0,0,0.00,0
,20160328,2472,2472,,,,2472,2472,0,0,0,0.00,0
,20160329,2472,2472,,,,2472,2472,0,0,0,0.00,0
,20160330,2472,2472,,,,2472,2472,0,0,0,0.00,0
,20160331,2472,2472,,,,2472,2472,0,0,0,0.00,0
,20160401,2472,2472,,,,2472,2472,0,0,0,0.00,0
,20160405,2472,2472,,,,2472,2472,0,0,0,0.00,0
,20160406,2472,2472,,,,2472,2472,0,0,0,0.00,0
,20160407,2472,2472,,,,2484,2484,12,12,0,0.00,0
,20160408,2484,2484,,,,2484,2484,0,0,0,0.00,0
,20160411,2484,2484,,,,2484,2484,0,0,0,0.00,0
,20160412,2484,2484,,,,2484,2484,0,0,0,0.00,0
,20160413,2484,2484,,,,2484,2484,0,0,0,0.00,0
,20160414,2484,2484,,,,2484,2484,0,0,0,0.00,0
,20160415,2484,2484,,,,2484,2484,0,0,0,0.00,0
,20160418,2484,2484,,,,2484,2484,0,0,0,0.00,0
,20160419,2484,2484,,,,2484,2484,0,0,0,0.00,0
,20160420,2484,2484,,,,2484,2484,0,0,0,0.00,0
,20160421,2484,2484,,,,2484,2484,0,0,0,0.00,0
,20160422,2484,2484,,,,2484,2484,0,0,0,0.00,0
,20160425,2484,2484,,,,2484,2484,0,0,0,0.00,0
,20160426,2484,2484,,,,2484,2484,0,0,0,0.00,0
,20160427,2484,2484,,,,2484,2484,0,0,0,0.00,0
,20160428,2484,2484,,,,2484,2484,0,0,0,0.00,0
,20160429,2484,2484,,,,2484,2484,0,0,0,0.00,0
,20160503,2484,2484,,,,2484,2484,0,0,0,0.00,0
,20160504,2484,2484,,,,2484,2484,0,0,0,0.00,0
,20160505,2484,2484,,,,2484,2484,0,0,0,0.00,0
,20160506,2484,2484,,,,2484,2484,0,0,0,0.00,0
,20160509,2484,2484,,,,2484,2484,0,0,0,0.00,0
,20160510,2484,2484,,,,2484,2484,0,0,0,0.00,0
,20160511,2484,2484,,,,2484,2484,0,0,0,0.00,0
,20160512,2484,2484,,,,2484,2484,0,0,0,0.00,0
,20160513,2484,2484,,,,2484,2484,0,0,0,0.00,0
,20160516,2484,2484,,,,2484,2484,0,0,0,0.00,0
,20160517,2484,2484,,,,2484,2484,0,0,0,0.00,0
,20160518,2484,2484,,,,2455,2455,-29,-29,0,0.00,0
,20160519,2455,2455,,,,2455,2455,0,0,0,0.00,0
,20160520,2455,2455,,,,2455,2455,0,0,0,0.00,0
,20160523,2455,2455,,,,2455,2455,0,0,0,0.00,0
,20160524,2455,2455,,,,2455,2455,0,0,0,0.00,0
,20160525,2455,2455,,,,2455,2455,0,0,0,0.00,0
,20160526,2455,2455,,,,2455,2455,0,0,0,0.00,0
,20160527,2455,2455,,,,2455,2455,0,0,0,0.00,0
,20160530,2455,2455,,,,2455,2455,0,0,0,0.00,0
,20160531,2455,2455,,,,2455,2455,0,0,0,0.00,0
,20160601,2455,2455,,,,2455,2455,0,0,0,0.00,0
,20160602,2455,2455,,,,2455,2455,0,0,0,0.00,0
,20160603,2455,2455,,,,2455,2455,0,0,0,0.00,0
,20160606,2455,2455,,,,2455,2455,0,0,0,0.00,0
,20160607,2455,2455,,,,2455,2455,0,0,0,0.00,0
,20160608,2455,2455,,,,2455,2455,0,0,0,0.00,0
,20160613,2455,2455,,,,2455,2455,0,0,0,0.00,0
,20160614,2455,2455,,,,2455,2455,0,0,0,0.00,0
,20160615,2455,2455,,,,2455,2455,0,0,0,0.00,0
,20160616,2455,2455,,,,2455,2455,0,0,0,0.00,0
,20160617,2455,2455,,,,2455,2455,0,0,0,0.00,0
,20160620,2455,2455,,,,2455,2455,0,0,0,0.00,0
,20160621,2455,2455,,,,2455,2455,0,0,0,0.00,0
,20160622,2455,2455,,,,2455,2455,0,0,0,0.00,0
,20160623,2455,2455,,,,2455,2455,0,0,0,0.00,0
,20160624,2455,2455,,,,2455,2455,0,0,0,0.00,0
,20160627,2455,2455,,,,2455,2455,0,0,0,0.00,0
,20160628,2455,2455,,,,2455,2455,0,0,0,0.00,0
,20160629,2455,2455,,,,2455,2455,0,0,0,0.00,0
,20160630,2455,2455,,,,2455,2455,0,0,0,0.00,0
,20160701,2455,2455,,,,2455,2455,0,0,0,0.00,0
,20160704,2455,2455,,,,2455,2455,0,0,0,0.00,0
,20160705,2455,2455,,,,2455,2455,0,0,0,0.00,0
,20160706,2455,2455,,,,2455,2455,0,0,0,0.00,0
,20160707,2455,2455,,,,2455,2455,0,0,0,0.00,0
,20160708,2455,2455,,,,2455,2455,0,0,0,0.00,0
,20160711,2455,2455,,,,2455,2455,0,0,0,0.00,0
,20160712,2455,2455,,,,2455,2455,0,0,0,0.00,0
,20160713,2455,2455,,,,2455,2455,0,0,0,0.00,0
,20160714,2455,2455,,,,2455,2455,0,0,0,0.00,0
,20160715,2455,2455,,,,2455,2455,0,0,0,0.00,0
,20160718,2455,2455,,,,2455,2455,0,0,0,0.00,0
,20160719,2455,2455,,,,2455,2455,0,0,0,0.00,0
,20160720,2455,2455,,,,2455,2455,0,0,0,0.00,0
,20160721,2455,2455,,,,2455,2455,0,0,0,0.00,0
,20160722,2455,2455,,,,2455,2455,0,0,0,0.00,0
,20160725,2455,2455,,,,2455,2455,0,0,0,0.00,0
,20160726,2455,2455,,,,2455,2455,0,0,0,0.00,0
,20160727,2455,2455,,,,2455,2455,0,0,0,0.00,0
,20160728,2455,2455,,,,2455,2455,0,0,0,0.00,0
,20160729,2455,2455,,,,2455,2455,0,0,0,0.00,0
,20160801,2455,2455,,,,2455,2455,0,0,0,0.00,0
,20160802,2455,2455,,,,2455,2455,0,0,0,0.00,0
,20160803,2455,2455,,,,2455,2455,0,0,0,0.00,0
,20160804,2455,2455,,,,2455,2455,0,0,0,0.00,0
,20160805,2455,2455,,,,2455,2455,0,0,0,0.00,0
,20160808,2455,2455,,,,2455,2455,0,0,0,0.00,0
,20160809,2455,2455,,,,2455,2455,0,0,0,0.00,0
,20160810,2455,2455,,,,2455,2455,0,0,0,0.00,0
,20160811,2455,2455,,,,2455,2455,0,0,0,0.00,0
,20160812,2455,2455,,,,2455,2455,0,0,0,0.00,0
,20160815,2455,2455,,,,2455,2455,0,0,0,0.00,0
,20160816,2455,2455,,,,2455,2455,0,0,0,0.00,0
,20160817,2455,2455,,,,2455,2455,0,0,0,0.00,0
,20160818,2455,2455,,,,2455,2455,0,0,0,0.00,0
,20160819,2455,2455,,,,2455,2455,0,0,0,0.00,0
,20160822,2455,2455,,,,2455,2455,0,0,0,0.00,0
,20160823,2455,2455,,,,2455,2455,0,0,0,0.00,0
,20160824,2455,2455,,,,2455,2455,0,0,0,0.00,0
,20160825,2455,2455,,,,2455,2455,0,0,0,0.00,0
,20160826,2455,2455,,,,2455,2455,0,0,0,0.00,0
,20160829,2455,2455,,,,2455,2455,0,0,0,0.00,0
,20160830,2455,2455,,,,2455,2455,0,0,0,0.00,0
,20160831,2455,2455,,,,2455,2455,0,0,0,0.00,0
,20160901,2455,2455,,,,2455,2455,0,0,0,0.00,0
,20160902,2455,2455,,,,2455,2455,0,0,0,0.00,0
,20160905,2455,2455,,,,2455,2455,0,0,0,0.00,0
,20160906,2455,2455,,,,2455,2455,0,0,0,0.00,0
,20160907,2455,2455,,,,2455,2455,0,0,0,0.00,0
,20160908,2455,2455,,,,2455,2455,0,0,0,0.00,0
,20160909,2455,2455,,,,2455,2455,0,0,0,0.00,0
,20160912,2455,2455,,,,2455,2455,0,0,0,0.00,0
,20160913,2455,2455,,,,2455,2455,0,0,0,0.00,0
,20160914,2455,2455,,,,2455,2455,0,0,0,0.00,0
,20160919,2455,2455,,,,2455,2455,0,0,0,0.00,0
,20160920,2455,2455,,,,2455,2455,0,0,0,0.00,0
,20160921,2455,2455,,,,2455,2455,0,0,0,0.00,0
,20160922,2455,2455,,,,2455,2455,0,0,0,0.00,0
,20160923,2455,2455,,,,2455,2455,0,0,0,0.00,0
,20160926,2455,2455,,,,2455,2455,0,0,0,0.00,0
,20160927,2455,2455,,,,2455,2455,0,0,0,0.00,0
,20160928,2455,2455,,,,2455,2455,0,0,0,0.00,0
,20160929,2455,2455,,,,2455,2455,0,0,0,0.00,0
,20160930,2455,2455,,,,2455,2455,0,0,0,0.00,0
fu1611,20160104,2472,2472,,,,2472,2472,0,0,0,0.00,0
,20160105,2472,2472,,,,2472,2472,0,0,0,0.00,0
,20160106,2472,2472,,,,2472,2472,0,0,0,0.00,0
,20160107,2472,2472,,,,2472,2472,0,0,0,0.00,0
,20160108,2472,2472,,,,2472,2472,0,0,0,0.00,0
,20160111,2472,2472,,,,2472,2472,0,0,0,0.00,0
,20160112,2472,2472,,,,2472,2472,0,0,0,0.00,0
,20160113,2472,2472,,,,2472,2472,0,0,0,0.00,0
,20160114,2472,2472,,,,2472,2472,0,0,0,0.00,0
,20160115,2472,2472,,,,2472,2472,0,0,0,0.00,0
,20160118,2472,2472,,,,2472,2472,0,0,0,0.00,0
,20160119,2472,2472,,,,2472,2472,0,0,0,0.00,0
,20160120,2472,2472,,,,2472,2472,0,0,0,0.00,0
,20160121,2472,2472,,,,2472,2472,0,0,0,0.00,0
,20160122,2472,2472,,,,2472,2472,0,0,0,0.00,0
,20160125,2472,2472,,,,2472,2472,0,0,0,0.00,0
,20160126,2472,2472,,,,2472,2472,0,0,0,0.00,0
,20160127,2472,2472,,,,2472,2472,0,0,0,0.00,0
,20160128,2472,2472,,,,2472,2472,0,0,0,0.00,0
,20160129,2472,2472,,,,2472,2472,0,0,0,0.00,0
,20160201,2472,2472,,,,2472,2472,0,0,0,0.00,0
,20160202,2472,2472,,,,2472,2472,0,0,0,0.00,0
,20160203,2472,2472,,,,2472,2472,0,0,0,0.00,0
,20160204,2472,2472,,,,2472,2472,0,0,0,0.00,0
,20160205,2472,2472,,,,2472,2472,0,0,0,0.00,0
,20160215,2472,2472,,,,2472,2472,0,0,0,0.00,0
,20160216,2472,2472,,,,2472,2472,0,0,0,0.00,0
,20160217,2472,2472,,,,2472,2472,0,0,0,0.00,0
,20160218,2472,2472,,,,2472,2472,0,0,0,0.00,0
,20160219,2472,2472,,,,2472,2472,0,0,0,0.00,0
,20160222,2472,2472,,,,2472,2472,0,0,0,0.00,0
,20160223,2472,2472,,,,2472,2472,0,0,0,0.00,0
,20160224,2472,2472,,,,2472,2472,0,0,0,0.00,0
,20160225,2472,2472,,,,2472,2472,0,0,0,0.00,0
,20160226,2472,2472,,,,2472,2472,0,0,0,0.00,0
,20160229,2472,2472,,,,2472,2472,0,0,0,0.00,0
,20160301,2472,2472,,,,2472,2472,0,0,0,0.00,0
,20160302,2472,2472,,,,2472,2472,0,0,0,0.00,0
,20160303,2472,2472,,,,2472,2472,0,0,0,0.00,0
,20160304,2472,2472,,,,2472,2472,0,0,0,0.00,0
,20160307,2472,2472,,,,2472,2472,0,0,0,0.00,0
,20160308,2472,2472,,,,2472,2472,0,0,0,0.00,0
,20160309,2472,2472,,,,2472,2472,0,0,0,0.00,0
,20160310,2472,2472,,,,2472,2472,0,0,0,0.00,0
,20160311,2472,2472,,,,2472,2472,0,0,0,0.00,0
,20160314,2472,2472,,,,2472,2472,0,0,0,0.00,0
,20160315,2472,2472,,,,2472,2472,0,0,0,0.00,0
,20160316,2472,2472,,,,2472,2472,0,0,0,0.00,0
,20160317,2472,2472,,,,2472,2472,0,0,0,0.00,0
,20160318,2472,2472,,,,2472,2472,0,0,0,0.00,0
,20160321,2472,2472,,,,2472,2472,0,0,0,0.00,0
,20160322,2472,2472,,,,2472,2472,0,0,0,0.00,0
,20160323,2472,2472,,,,2472,2472,0,0,0,0.00,0
,20160324,2472,2472,,,,2472,2472,0,0,0,0.00,0
,20160325,2472,2472,,,,2472,2472,0,0,0,0.00,0
,20160328,2472,2472,,,,2472,2472,0,0,0,0.00,0
,20160329,2472,2472,,,,2472,2472,0,0,0,0.00,0
,20160330,2472,2472,,,,2472,2472,0,0,0,0.00,0
,20160331,2472,2472,,,,2472,2472,0,0,0,0.00,0
,20160401,2472,2472,,,,2472,2472,0,0,0,0.00,0
,20160405,2472,2472,,,,2472,2472,0,0,0,0.00,0
,20160406,2472,2472,,,,2472,2472,0,0,0,0.00,0
,20160407,2472,2472,,,,2484,2484,12,12,0,0.00,0
,20160408,2484,2484,,,,2484,2484,0,0,0,0.00,0
,20160411,2484,2484,,,,2484,2484,0,0,0,0.00,0
,20160412,2484,2484,,,,2484,2484,0,0,0,0.00,0
,20160413,2484,2484,,,,2484,2484,0,0,0,0.00,0
,20160414,2484,2484,,,,2484,2484,0,0,0,0.00,0
,20160415,2484,2484,,,,2484,2484,0,0,0,0.00,0
,20160418,2484,2484,,,,2484,2484,0,0,0,0.00,0
,20160419,2484,2484,,,,2484,2484,0,0,0,0.00,0
,20160420,2484,2484,,,,2484,2484,0,0,0,0.00,0
,20160421,2484,2484,,,,2484,2484,0,0,0,0.00,0
,20160422,2484,2484,,,,2484,2484,0,0,0,0.00,0
,20160425,2484,2484,,,,2484,2484,0,0,0,0.00,0
,20160426,2484,2484,,,,2484,2484,0,0,0,0.00,0
,20160427,2484,2484,,,,2484,2484,0,0,0,0.00,0
,20160428,2484,2484,,,,2484,2484,0,0,0,0.00,0
,20160429,2484,2484,,,,2484,2484,0,0,0,0.00,0
,20160503,2484,2484,,,,2484,2484,0,0,0,0.00,0
,20160504,2484,2484,,,,2484,2484,0,0,0,0.00,0
,20160505,2484,2484,,,,2484,2484,0,0,0,0.00,0
,20160506,2484,2484,,,,2484,2484,0,0,0,0.00,0
,20160509,2484,2484,,,,2484,2484,0,0,0,0.00,0
,20160510,2484,2484,,,,2484,2484,0,0,0,0.00,0
,20160511,2484,2484,,,,2484,2484,0,0,0,0.00,0
,20160512,2484,2484,,,,2484,2484,0,0,0,0.00,0
,20160513,2484,2484,,,,2484,2484,0,0,0,0.00,0
,20160516,2484,2484,,,,2484,2484,0,0,0,0.00,0
,20160517,2484,2484,,,,2484,2484,0,0,0,0.00,0
,20160518,2484,2484,,,,2455,2455,-29,-29,0,0.00,0
,20160519,2455,2455,,,,2455,2455,0,0,0,0.00,0
,20160520,2455,2455,,,,2455,2455,0,0,0,0.00,0
,20160523,2455,2455,,,,2455,2455,0,0,0,0.00,0
,20160524,2455,2455,,,,2455,2455,0,0,0,0.00,0
,20160525,2455,2455,,,,2455,2455,0,0,0,0.00,0
,20160526,2455,2455,,,,2455,2455,0,0,0,0.00,0
,20160527,2455,2455,,,,2455,2455,0,0,0,0.00,0
,20160530,2455,2455,,,,2455,2455,0,0,0,0.00,0
,20160531,2455,2455,,,,2455,2455,0,0,0,0.00,0
,20160601,2455,2455,,,,2455,2455,0,0,0,0.00,0
,20160602,2455,2455,,,,2455,2455,0,0,0,0.00,0
,20160603,2455,2455,,,,2455,2455,0,0,0,0.00,0
,20160606,2455,2455,,,,2455,2455,0,0,0,0.00,0
,20160607,2455,2455,,,,2455,2455,0,0,0,0.00,0
,20160608,2455,2455,,,,2455,2455,0,0,0,0.00,0
,20160613,2455,2455,,,,2455,2455,0,0,0,0.00,0
,20160614,2455,2455,,,,2455,2455,0,0,0,0.00,0
,20160615,2455,2455,,,,2455,2455,0,0,0,0.00,0
,20160616,2455,2455,,,,2455,2455,0,0,0,0.00,0
,20160617,2455,2455,,,,2455,2455,0,0,0,0.00,0
,20160620,2455,2455,,,,2455,2455,0,0,0,0.00,0
,20160621,2455,2455,,,,2455,2455,0,0,0,0.00,0
,20160622,2455,2455,,,,2455,2455,0,0,0,0.00,0
,20160623,2455,2455,,,,2455,2455,0,0,0,0.00,0
,20160624,2455,2455,,,,2455,2455,0,0,0,0.00,0
,20160627,2455,2455,,,,2455,2455,0,0,0,0.00,0
,20160628,2455,2455,,,,2455,2455,0,0,0,0.00,0
,20160629,2455,2455,,,,2455,2455,0,0,0,0.00,0
,20160630,2455,2455,,,,2455,2455,0,0,0,0.00,0
,20160701,2455,2455,2635,2635,2550,2550,2592,95,137,32,414.80,0
,20160704,2550,2592,,,,2592,2592,0,0,0,0.00,0
,20160705,2592,2592,,,,2592,2592,0,0,0,0.00,0
,20160706,2592,2592,,,,2592,2592,0,0,0,0.00,0
,20160707,2592,2592,,,,2592,2592,0,0,0,0.00,0
,20160708,2592,2592,,,,2592,2592,0,0,0,0.00,0
,20160711,2592,2592,,,,2592,2592,0,0,0,0.00,0
,20160712,2592,2592,,,,2592,2592,0,0,0,0.00,0
,20160713,2592,2592,,,,2592,2592,0,0,0,0.00,0
,20160714,2592,2592,,,,2592,2592,0,0,0,0.00,0
,20160715,2592,2592,,,,2592,2592,0,0,0,0.00,0
,20160718,2592,2592,,,,2592,2592,0,0,0,0.00,0
,20160719,2592,2592,,,,2592,2592,0,0,0,0.00,0
,20160720,2592,2592,,,,2592,2592,0,0,0,0.00,0
,20160721,2592,2592,,,,2592,2592,0,0,0,0.00,0
,20160722,2592,2592,,,,2592,2592,0,0,0,0.00,0
,20160725,2592,2592,,,,2592,2592,0,0,0,0.00,0
,20160726,2592,2592,,,,2592,2592,0,0,0,0.00,0
,20160727,2592,2592,,,,2592,2592,0,0,0,0.00,0
,20160728,2592,2592,,,,2592,2592,0,0,0,0.00,0
,20160729,2592,2592,,,,2592,2592,0,0,0,0.00,0
,20160801,2592,2592,,,,2592,2592,0,0,0,0.00,0
,20160802,2592,2592,,,,2592,2592,0,0,0,0.00,0
,20160803,2592,2592,,,,2592,2592,0,0,0,0.00,0
,20160804,2592,2592,,,,2592,2592,0,0,0,0.00,0
,20160805,2592,2592,,,,2592,2592,0,0,0,0.00,0
,20160808,2592,2592,,,,2592,2592,0,0,0,0.00,0
,20160809,2592,2592,,,,2592,2592,0,0,0,0.00,0
,20160810,2592,2592,,,,2592,2592,0,0,0,0.00,0
,20160811,2592,2592,,,,2592,2592,0,0,0,0.00,0
,20160812,2592,2592,,,,2592,2592,0,0,0,0.00,0
,20160815,2592,2592,,,,2592,2592,0,0,0,0.00,0
,20160816,2592,2592,,,,2592,2592,0,0,0,0.00,0
,20160817,2592,2592,,,,2592,2592,0,0,0,0.00,0
,20160818,2592,2592,,,,2592,2592,0,0,0,0.00,0
,20160819,2592,2592,,,,2592,2592,0,0,0,0.00,0
,20160822,2592,2592,,,,2592,2592,0,0,0,0.00,0
,20160823,2592,2592,,,,2592,2592,0,0,0,0.00,0
,20160824,2592,2592,,,,2592,2592,0,0,0,0.00,0
,20160825,2592,2592,,,,2592,2592,0,0,0,0.00,0
,20160826,2592,2592,,,,2592,2592,0,0,0,0.00,0
,20160829,2592,2592,,,,2592,2592,0,0,0,0.00,0
,20160830,2592,2592,,,,2592,2592,0,0,0,0.00,0
,20160831,2592,2592,,,,2592,2592,0,0,0,0.00,0
,20160901,2592,2592,,,,2592,2592,0,0,0,0.00,0
,20160902,2592,2592,,,,2592,2592,0,0,0,0.00,0
,20160905,2592,2592,,,,2592,2592,0,0,0,0.00,0
,20160906,2592,2592,,,,2592,2592,0,0,0,0.00,0
,20160907,2592,2592,,,,2592,2592,0,0,0,0.00,0
,20160908,2592,2592,,,,2592,2592,0,0,0,0.00,0
,20160909,2592,2592,,,,2592,2592,0,0,0,0.00,0
,20160912,2592,2592,,,,2592,2592,0,0,0,0.00,0
,20160913,2592,2592,,,,2592,2592,0,0,0,0.00,0
,20160914,2592,2592,,,,2592,2592,0,0,0,0.00,0
,20160919,2592,2592,,,,2592,2592,0,0,0,0.00,0
,20160920,2592,2592,,,,2592,2592,0,0,0,0.00,0
,20160921,2592,2592,,,,2592,2592,0,0,0,0.00,0
,20160922,2592,2592,,,,2592,2592,0,0,0,0.00,0
,20160923,2592,2592,,,,2592,2592,0,0,0,0.00,0
,20160926,2592,2592,,,,2592,2592,0,0,0,0.00,0
,20160927,2592,2592,,,,2592,2592,0,0,0,0.00,0
,20160928,2592,2592,,,,2592,2592,0,0,0,0.00,0
,20160929,2592,2592,,,,2592,2592,0,0,0,0.00,0
,20160930,2592,2592,,,,2592,2592,0,0,0,0.00,0
,20161010,2592,2592,,,,2592,2592,0,0,0,0.00,0
,20161011,2592,2592,,,,2592,2592,0,0,0,0.00,0
,20161012,2592,2592,,,,2592,2592,0,0,0,0.00,0
,20161013,2592,2592,,,,2592,2592,0,0,0,0.00,0
,20161014,2592,2592,,,,2592,2592,0,0,0,0.00,0
,20161017,2592,2592,,,,2592,2592,0,0,0,0.00,0
,20161018,2592,2592,,,,2592,2592,0,0,0,0.00,0
,20161019,2592,2592,,,,2592,2592,0,0,0,0.00,0
,20161020,2592,2592,,,,2592,2592,0,0,0,0.00,0
,20161021,2592,2592,,,,2592,2592,0,0,0,0.00,0
,20161024,2592,2592,,,,2592,2592,0,0,0,0.00,0
,20161025,2592,2592,,,,2592,2592,0,0,0,0.00,0
,20161026,2592,2592,,,,2592,2592,0,0,0,0.00,0
,20161027,2592,2592,,,,2592,2592,0,0,0,0.00,0
,20161028,2592,2592,,,,2592,2592,0,0,0,0.00,0
,20161031,2592,2592,,,,2592,2592,0,0,0,0.00,0
fu1612,20160104,2393,2393,,,,2401,2401,8,8,0,0.00,2
,20160105,2401,2401,,,,2341,2341,-60,-60,0,0.00,2
,20160106,2341,2341,,,,2374,2374,33,33,0,0.00,2
,20160107,2374,2374,,,,2372,2372,-2,-2,0,0.00,2
,20160108,2372,2372,,,,2372,2372,0,0,0,0.00,2
,20160111,2372,2372,,,,2253,2253,-119,-119,0,0.00,2
,20160112,2253,2253,,,,2266,2266,13,13,0,0.00,2
,20160113,2266,2266,,,,2222,2222,-44,-44,0,0.00,2
,20160114,2222,2222,,,,2246,2246,24,24,0,0.00,2
,20160115,2246,2246,,,,2202,2202,-44,-44,0,0.00,2
,20160118,2202,2202,,,,2216,2216,14,14,0,0.00,2
,20160119,2216,2216,,,,2315,2315,99,99,0,0.00,2
,20160120,2315,2315,,,,2370,2370,55,55,0,0.00,2
,20160121,2370,2370,,,,2351,2351,-19,-19,0,0.00,2
,20160122,2351,2351,,,,2317,2317,-34,-34,0,0.00,2
,20160125,2317,2317,,,,2361,2361,44,44,0,0.00,2
,20160126,2361,2361,,,,2242,2242,-119,-119,0,0.00,2
,20160127,2242,2242,,,,2235,2235,-7,-7,0,0.00,2
,20160128,2235,2235,,,,2224,2224,-11,-11,0,0.00,2
,20160129,2224,2224,,,,2335,2335,111,111,0,0.00,2
,20160201,2335,2335,,,,2368,2368,33,33,0,0.00,2
,20160202,2368,2368,,,,2486,2486,118,118,0,0.00,2
,20160203,2486,2486,,,,2486,2486,0,0,0,0.00,2
,20160204,2486,2486,,,,2500,2500,14,14,0,0.00,2
,20160205,2500,2500,,,,2500,2500,0,0,0,0.00,2
,20160215,2500,2500,,,,2500,2500,0,0,0,0.00,2
,20160216,2500,2500,,,,2444,2444,-56,-56,0,0.00,2
,20160217,2444,2444,,,,2371,2371,-73,-73,0,0.00,2
,20160218,2371,2371,,,,2371,2371,0,0,0,0.00,2
,20160219,2371,2371,,,,2283,2283,-88,-88,0,0.00,2
,20160222,2283,2283,,,,2397,2397,114,114,0,0.00,2
,20160223,2397,2397,,,,2343,2343,-54,-54,0,0.00,2
,20160224,2343,2343,,,,2321,2321,-22,-22,0,0.00,2
,20160225,2321,2321,,,,2317,2317,-4,-4,0,0.00,2
,20160226,2317,2317,,,,2432,2432,115,115,0,0.00,2
,20160229,2432,2432,,,,2423,2423,-9,-9,0,0.00,2
,20160301,2423,2423,,,,2303,2303,-120,-120,0,0.00,2
,20160302,2303,2303,,,,2189,2189,-114,-114,0,0.00,2
,20160303,2189,2189,,,,2298,2298,109,109,0,0.00,2
,20160304,2298,2298,,,,2384,2384,86,86,0,0.00,2
,20160307,2384,2384,,,,2297,2297,-87,-87,0,0.00,2
,20160308,2297,2297,,,,2260,2260,-37,-37,0,0.00,2
,20160309,2260,2260,,,,2298,2298,38,38,0,0.00,2
,20160310,2298,2298,,,,2252,2252,-46,-46,0,0.00,2
,20160311,2252,2252,,,,2364,2364,112,112,0,0.00,2
,20160314,2364,2364,,,,2364,2364,0,0,0,0.00,2
,20160315,2364,2364,,,,2248,2248,-116,-116,0,0.00,2
,20160316,2248,2248,,,,2360,2360,112,112,0,0.00,2
,20160317,2360,2360,,,,2478,2478,118,118,0,0.00,2
,20160318,2478,2478,,,,2360,2360,-118,-118,0,0.00,2
,20160321,2360,2360,,,,2360,2360,0,0,0,0.00,2
,20160322,2360,2360,,,,2244,2244,-116,-116,0,0.00,2
,20160323,2244,2244,,,,2356,2356,112,112,0,0.00,2
,20160324,2356,2356,,,,2356,2356,0,0,0,0.00,2
,20160325,2356,2356,,,,2242,2242,-114,-114,0,0.00,2
,20160328,2242,2242,,,,2354,2354,112,112,0,0.00,2
,20160329,2354,2354,,,,2354,2354,0,0,0,0.00,2
,20160330,2354,2354,,,,2328,2328,-26,-26,0,0.00,2
,20160331,2328,2328,,,,2417,2417,89,89,0,0.00,2
,20160401,2417,2417,,,,2463,2463,46,46,0,0.00,2
,20160405,2463,2463,,,,2341,2341,-122,-122,0,0.00,2
,20160406,2341,2341,,,,2341,2341,0,0,0,0.00,2
,20160407,2341,2341,,,,2353,2353,12,12,0,0.00,2
,20160408,2353,2353,,,,2323,2323,-30,-30,0,0.00,2
,20160411,2323,2323,,,,2323,2323,0,0,0,0.00,2
,20160412,2323,2323,,,,2323,2323,0,0,0,0.00,2
,20160413,2323,2323,,,,2260,2260,-63,-63,0,0.00,2
,20160414,2260,2260,,,,2154,2154,-106,-106,0,0.00,2
,20160415,2154,2154,,,,2261,2261,107,107,0,0.00,2
,20160418,2261,2261,2147,2147,2147,2147,2147,-114,-114,4,42.94,4
,20160419,2147,2147,,,,2254,2254,107,107,0,0.00,4
,20160420,2254,2254,,,,2366,2366,112,112,0,0.00,4
,20160421,2366,2366,,,,2484,2484,118,118,0,0.00,4
,20160422,2484,2484,,,,2484,2484,0,0,0,0.00,4
,20160425,2484,2484,,,,2499,2499,15,15,0,0.00,4
,20160426,2499,2499,,,,2499,2499,0,0,0,0.00,4
,20160427,2499,2499,,,,2499,2499,0,0,0,0.00,4
,20160428,2499,2499,,,,2499,2499,0,0,0,0.00,4
,20160429,2499,2499,,,,2380,2380,-119,-119,0,0.00,4
,20160503,2380,2380,,,,2380,2380,0,0,0,0.00,4
,20160504,2380,2380,,,,2380,2380,0,0,0,0.00,4
,20160505,2380,2380,,,,2472,2472,92,92,0,0.00,4
,20160506,2472,2472,,,,2595,2595,123,123,0,0.00,4
,20160509,2595,2595,,,,2468,2468,-127,-127,0,0.00,4
,20160510,2468,2468,,,,2590,2590,122,122,0,0.00,4
,20160511,2590,2590,2460,2460,2460,2460,2460,-130,-130,2,24.60,4
,20160512,2460,2460,2583,2583,2583,2583,2583,123,123,2,25.83,4
,20160513,2583,2583,,,,2711,2711,128,128,0,0.00,4
,20160516,2711,2711,,,,2711,2711,0,0,0,0.00,4
,20160517,2711,2711,2750,2750,2575,2575,2662,-136,-49,4,53.25,6
,20160518,2575,2662,2528,2528,2528,2528,2528,-134,-134,4,50.56,4
,20160519,2528,2528,,,,2465,2465,-63,-63,0,0.00,4
,20160520,2465,2465,2346,2346,2346,2346,2346,-119,-119,2,23.46,2
,20160523,2346,2346,,,,2346,2346,0,0,0,0.00,2
,20160524,2346,2346,,,,2346,2346,0,0,0,0.00,2
,20160525,2346,2346,,,,2346,2346,0,0,0,0.00,2
,20160526,2346,2346,,,,2346,2346,0,0,0,0.00,2
,20160527,2346,2346,,,,2346,2346,0,0,0,0.00,2
,20160530,2346,2346,,,,2346,2346,0,0,0,0.00,2
,20160531,2346,2346,,,,2346,2346,0,0,0,0.00,2
,20160601,2346,2346,,,,2346,2346,0,0,0,0.00,2
,20160602,2346,2346,,,,2346,2346,0,0,0,0.00,2
,20160603,2346,2346,,,,2346,2346,0,0,0,0.00,2
,20160606,2346,2346,,,,2346,2346,0,0,0,0.00,2
,20160607,2346,2346,,,,2346,2346,0,0,0,0.00,2
,20160608,2346,2346,,,,2346,2346,0,0,0,0.00,2
,20160613,2346,2346,,,,2346,2346,0,0,0,0.00,2
,20160614,2346,2346,,,,2346,2346,0,0,0,0.00,2
,20160615,2346,2346,,,,2346,2346,0,0,0,0.00,2
,20160616,2346,2346,,,,2346,2346,0,0,0,0.00,2
,20160617,2346,2346,,,,2346,2346,0,0,0,0.00,2
,20160620,2346,2346,,,,2346,2346,0,0,0,0.00,2
,20160621,2346,2346,,,,2346,2346,0,0,0,0.00,2
,20160622,2346,2346,,,,2346,2346,0,0,0,0.00,2
,20160623,2346,2346,,,,2346,2346,0,0,0,0.00,2
,20160624,2346,2346,,,,2346,2346,0,0,0,0.00,2
,20160627,2346,2346,,,,2462,2462,116,116,0,0.00,2
,20160628,2462,2462,,,,2494,2494,32,32,0,0.00,2
,20160629,2494,2494,,,,2431,2431,-63,-63,0,0.00,2
,20160630,2431,2431,,,,2398,2398,-33,-33,0,0.00,2
,20160701,2398,2398,,,,2517,2517,119,119,0,0.00,2
,20160704,2517,2517,2640,2640,2640,2640,2640,123,123,2,26.40,2
,20160705,2640,2640,,,,2508,2508,-132,-132,0,0.00,2
,20160706,2508,2508,,,,2508,2508,0,0,0,0.00,2
,20160707,2508,2508,,,,2508,2508,0,0,0,0.00,2
,20160708,2508,2508,,,,2508,2508,0,0,0,0.00,2
,20160711,2508,2508,,,,2508,2508,0,0,0,0.00,2
,20160712,2508,2508,,,,2508,2508,0,0,0,0.00,2
,20160713,2508,2508,,,,2508,2508,0,0,0,0.00,2
,20160714,2508,2508,2390,2390,2390,2390,2390,-118,-118,2,23.90,2
,20160715,2390,2390,,,,2390,2390,0,0,0,0.00,2
,20160718,2390,2390,,,,2390,2390,0,0,0,0.00,2
,20160719,2390,2390,,,,2390,2390,0,0,0,0.00,2
,20160720,2390,2390,,,,2390,2390,0,0,0,0.00,2
,20160721,2390,2390,,,,2390,2390,0,0,0,0.00,2
,20160722,2390,2390,,,,2390,2390,0,0,0,0.00,2
,20160725,2390,2390,,,,2270,2270,-120,-120,0,0.00,2
,20160726,2270,2270,,,,2270,2270,0,0,0,0.00,2
,20160727,2270,2270,,,,2270,2270,0,0,0,0.00,2
,20160728,2270,2270,,,,2270,2270,0,0,0,0.00,2
,20160729,2270,2270,,,,2270,2270,0,0,0,0.00,2
,20160801,2270,2270,,,,2270,2270,0,0,0,0.00,2
,20160802,2270,2270,2165,2204,2165,2204,2184,-66,-86,4,43.69,4
,20160803,2204,2184,2099,2099,2099,2099,2099,-85,-85,2,20.99,2
,20160804,2099,2099,,,,2203,2203,104,104,0,0.00,2
,20160805,2203,2203,,,,2313,2313,110,110,0,0.00,2
,20160808,2313,2313,,,,2313,2313,0,0,0,0.00,2
,20160809,2313,2313,,,,2313,2313,0,0,0,0.00,2
,20160810,2313,2313,,,,2313,2313,0,0,0,0.00,2
,20160811,2313,2313,,,,2313,2313,0,0,0,0.00,2
,20160812,2313,2313,,,,2313,2313,0,0,0,0.00,2
,20160815,2313,2313,,,,2313,2313,0,0,0,0.00,2
,20160816,2313,2313,2204,2204,2204,2204,2204,-109,-109,2,22.04,4
,20160817,2204,2204,2115,2115,2115,2115,2115,-89,-89,2,21.15,4
,20160818,2115,2115,,,,2220,2220,105,105,0,0.00,4
,20160819,2220,2220,2250,2250,2250,2250,2250,30,30,2,22.50,2
,20160822,2250,2250,,,,2250,2250,0,0,0,0.00,2
,20160823,2250,2250,,,,2250,2250,0,0,0,0.00,2
,20160824,2250,2250,,,,2250,2250,0,0,0,0.00,2
,20160825,2250,2250,,,,2250,2250,0,0,0,0.00,2
,20160826,2250,2250,,,,2250,2250,0,0,0,0.00,2
,20160829,2250,2250,,,,2250,2250,0,0,0,0.00,2
,20160830,2250,2250,,,,2250,2250,0,0,0,0.00,2
,20160831,2250,2250,,,,2250,2250,0,0,0,0.00,2
,20160901,2250,2250,,,,2250,2250,0,0,0,0.00,2
,20160902,2250,2250,,,,2250,2250,0,0,0,0.00,2
,20160905,2250,2250,,,,2250,2250,0,0,0,0.00,2
,20160906,2250,2250,,,,2250,2250,0,0,0,0.00,2
,20160907,2250,2250,2146,2146,2146,2146,2146,-104,-104,2,21.46,4
,20160908,2146,2146,,,,2253,2253,107,107,0,0.00,4
,20160909,2253,2253,,,,2365,2365,112,112,0,0.00,4
,20160912,2365,2365,,,,2483,2483,118,118,0,0.00,4
,20160913,2483,2483,2607,2607,2557,2557,2582,74,99,4,51.64,2
,20160914,2557,2582,,,,2582,2582,0,0,0,0.00,2
,20160919,2582,2582,,,,2582,2582,0,0,0,0.00,2
,20160920,2582,2582,,,,2582,2582,0,0,0,0.00,2
,20160921,2582,2582,2466,2711,2466,2524,2598,-58,16,10,129.92,2
,20160922,2524,2598,2537,2537,2537,2537,2537,-61,-61,2,25.37,2
,20160923,2537,2537,2416,2550,2416,2550,2483,13,-54,4,49.66,4
,20160926,2550,2483,2505,2505,2505,2505,2505,22,22,2,25.05,2
,20160927,2505,2505,2452,2630,2452,2630,2544,125,39,6,76.32,4
,20160928,2630,2544,2357,2746,2357,2551,2634,7,90,20,263.41,2
,20160929,2551,2634,2516,2516,2516,2516,2516,-118,-118,2,25.16,2
,20160930,2516,2516,,,,2610,2610,94,94,0,0.00,2
,20161010,2610,2610,2431,2431,2431,2431,2431,-179,-179,2,24.31,2
,20161011,2431,2431,2315,2315,2315,2315,2315,-116,-116,2,23.15,2
,20161012,2315,2315,,,,2430,2430,115,115,0,0.00,2
,20161013,2430,2430,,,,2430,2430,0,0,0,0.00,2
,20161014,2430,2430,,,,2430,2430,0,0,0,0.00,2
,20161017,2430,2430,2310,2310,2310,2310,2310,-120,-120,2,23.10,2
,20161018,2310,2310,,,,2425,2425,115,115,0,0.00,2
,20161019,2425,2425,,,,2425,2425,0,0,0,0.00,2
,20161020,2425,2425,,,,2425,2425,0,0,0,0.00,2
,20161021,2425,2425,,,,2425,2425,0,0,0,0.00,2
,20161024,2425,2425,2355,2546,2355,2546,2450,121,25,4,49.01,2
,20161025,2546,2450,2646,2646,2646,2646,2646,196,196,2,26.46,0
,20161026,2646,2646,,,,2646,2646,0,0,0,0.00,0
,20161027,2646,2646,,,,2646,2646,0,0,0,0.00,0
,20161028,2646,2646,,,,2646,2646,0,0,0,0.00,0
,20161031,2646,2646,,,,2646,2646,0,0,0,0.00,0
,20161101,2646,2646,,,,2646,2646,0,0,0,0.00,0
,20161102,2646,2646,,,,2646,2646,0,0,0,0.00,0
,20161103,2646,2646,,,,2646,2646,0,0,0,0.00,0
,20161104,2646,2646,,,,2646,2646,0,0,0,0.00,0
,20161107,2646,2646,,,,2646,2646,0,0,0,0.00,0
,20161108,2646,2646,,,,2646,2646,0,0,0,0.00,0
,20161109,2646,2646,,,,2646,2646,0,0,0,0.00,0
,20161110,2646,2646,,,,2646,2646,0,0,0,0.00,0
,20161111,2646,2646,,,,2646,2646,0,0,0,0.00,0
,20161114,2646,2646,,,,2646,2646,0,0,0,0.00,0
,20161115,2646,2646,,,,2646,2646,0,0,0,0.00,0
,20161116,2646,2646,,,,2646,2646,0,0,0,0.00,0
,20161117,2646,2646,,,,2646,2646,0,0,0,0.00,0
,20161118,2646,2646,,,,2646,2646,0,0,0,0.00,0
,20161121,2646,2646,,,,2646,2646,0,0,0,0.00,0
,20161122,2646,2646,,,,2646,2646,0,0,0,0.00,0
,20161123,2646,2646,,,,2646,2646,0,0,0,0.00,0
,20161124,2646,2646,,,,2646,2646,0,0,0,0.00,0
,20161125,2646,2646,,,,2646,2646,0,0,0,0.00,0
,20161128,2646,2646,,,,2646,2646,0,0,0,0.00,0
,20161129,2646,2646,,,,2646,2646,0,0,0,0.00,0
,20161130,2646,2646,,,,2646,2646,0,0,0,0.00,0
fu1702,20160201,2335,2335,,,,2368,2368,33,33,0,0.00,0
,20160202,2368,2368,,,,2486,2486,118,118,0,0.00,0
,20160203,2486,2486,,,,2486,2486,0,0,0,0.00,0
,20160204,2486,2486,,,,2486,2486,0,0,0,0.00,0
,20160205,2486,2486,,,,2486,2486,0,0,0,0.00,0
,20160215,2486,2486,,,,2486,2486,0,0,0,0.00,0
,20160216,2486,2486,,,,2486,2486,0,0,0,0.00,0
,20160217,2486,2486,,,,2486,2486,0,0,0,0.00,0
,20160218,2486,2486,,,,2486,2486,0,0,0,0.00,0
,20160219,2486,2486,,,,2486,2486,0,0,0,0.00,0
,20160222,2486,2486,,,,2486,2486,0,0,0,0.00,0
,20160223,2486,2486,,,,2486,2486,0,0,0,0.00,0
,20160224,2486,2486,,,,2486,2486,0,0,0,0.00,0
,20160225,2486,2486,,,,2486,2486,0,0,0,0.00,0
,20160226,2486,2486,2734,2734,2237,2456,2529,-30,43,10,126.45,2
,20160229,2456,2529,,,,2529,2529,0,0,0,0.00,2
,20160301,2529,2529,,,,2529,2529,0,0,0,0.00,2
,20160302,2529,2529,2405,2405,2405,2405,2405,-124,-124,2,24.05,0
,20160303,2405,2405,,,,2525,2525,120,120,0,0.00,0
,20160304,2525,2525,,,,2525,2525,0,0,0,0.00,0
,20160307,2525,2525,,,,2525,2525,0,0,0,0.00,0
,20160308,2525,2525,,,,2525,2525,0,0,0,0.00,0
,20160309,2525,2525,,,,2525,2525,0,0,0,0.00,0
,20160310,2525,2525,,,,2525,2525,0,0,0,0.00,0
,20160311,2525,2525,,,,2525,2525,0,0,0,0.00,0
,20160314,2525,2525,,,,2525,2525,0,0,0,0.00,0
,20160315,2525,2525,,,,2525,2525,0,0,0,0.00,0
,20160316,2525,2525,,,,2525,2525,0,0,0,0.00,0
,20160317,2525,2525,,,,2525,2525,0,0,0,0.00,0
,20160318,2525,2525,,,,2525,2525,0,0,0,0.00,0
,20160321,2525,2525,,,,2525,2525,0,0,0,0.00,0
,20160322,2525,2525,,,,2401,2401,-124,-124,0,0.00,0
,20160323,2401,2401,,,,2280,2280,-121,-121,0,0.00,0
,20160324,2280,2280,,,,2280,2280,0,0,0,0.00,0
,20160325,2280,2280,,,,2170,2170,-110,-110,0,0.00,0
,20160328,2170,2170,,,,2278,2278,108,108,0,0.00,0
,20160329,2278,2278,,,,2278,2278,0,0,0,0.00,0
,20160330,2278,2278,,,,2253,2253,-25,-25,0,0.00,0
,20160331,2253,2253,,,,2365,2365,112,112,0,0.00,0
,20160401,2365,2365,,,,2410,2410,45,45,0,0.00,0
,20160405,2410,2410,,,,2291,2291,-119,-119,0,0.00,0
,20160406,2291,2291,,,,2291,2291,0,0,0,0.00,0
,20160407,2291,2291,,,,2302,2302,11,11,0,0.00,0
,20160408,2302,2302,,,,2273,2273,-29,-29,0,0.00,0
,20160411,2273,2273,,,,2273,2273,0,0,0,0.00,0
,20160412,2273,2273,,,,2273,2273,0,0,0,0.00,0
,20160413,2273,2273,,,,2211,2211,-62,-62,0,0.00,0
,20160414,2211,2211,2320,2320,2320,2320,2320,109,109,10,116.00,10
,20160415,2320,2320,,,,2436,2436,116,116,0,0.00,10
,20160418,2436,2436,2556,2556,2556,2556,2556,120,120,10,127.80,0
,20160419,2556,2556,,,,2556,2556,0,0,0,0.00,0
,20160420,2556,2556,,,,2586,2586,30,30,0,0.00,0
,20160421,2586,2586,,,,2688,2688,102,102,0,0.00,0
,20160422,2688,2688,,,,2569,2569,-119,-119,0,0.00,0
,20160425,2569,2569,,,,2585,2585,16,16,0,0.00,0
,20160426,2585,2585,,,,2585,2585,0,0,0,0.00,0
,20160427,2585,2585,2714,2714,2714,2714,2714,129,129,2,27.14,2
,20160428,2714,2714,2666,2666,2666,2666,2666,-48,-48,2,26.66,4
,20160429,2666,2666,2626,2626,2587,2587,2607,-79,-59,8,104.30,4
,20160503,2587,2607,,,,2607,2607,0,0,0,0.00,4
,20160504,2607,2607,,,,2607,2607,0,0,0,0.00,4
,20160505,2607,2607,2572,2572,2563,2563,2567,-44,-40,8,102.69,4
,20160506,2563,2567,,,,2567,2567,0,0,0,0.00,4
,20160509,2567,2567,,,,2567,2567,0,0,0,0.00,4
,20160510,2567,2567,,,,2567,2567,0,0,0,0.00,4
,20160511,2567,2567,,,,2559,2559,-8,-8,0,0.00,4
,20160512,2559,2559,,,,2558,2558,-1,-1,0,0.00,4
,20160513,2558,2558,,,,2558,2558,0,0,0,0.00,4
,20160516,2558,2558,,,,2558,2558,0,0,0,0.00,4
,20160517,2558,2558,,,,2558,2558,0,0,0,0.00,4
,20160518,2558,2558,2562,2562,2560,2560,2561,2,3,6,76.83,6
,20160519,2560,2561,,,,2561,2561,0,0,0,0.00,6
,20160520,2561,2561,,,,2561,2561,0,0,0,0.00,6
,20160523,2561,2561,,,,2561,2561,0,0,0,0.00,6
,20160524,2561,2561,2533,2533,2433,2433,2483,-128,-78,4,49.66,6
,20160525,2433,2483,2360,2607,2360,2601,2565,118,82,22,282.19,18
,20160526,2601,2565,2630,2630,2576,2579,2595,14,30,6,77.85,14
,20160527,2579,2595,2576,2576,2471,2575,2549,-20,-46,8,101.97,10
,20160530,2575,2549,2553,2599,2553,2596,2579,47,30,8,103.18,8
,20160531,2596,2579,,,,2579,2579,0,0,0,0.00,8
,20160601,2579,2579,2567,2567,2567,2567,2567,-12,-12,2,25.67,10
,20160602,2567,2567,2439,2599,2439,2567,2551,0,-16,8,102.04,10
,20160603,2567,2551,2599,2599,2598,2598,2598,47,47,6,77.96,14
,20160606,2598,2598,2584,2620,2584,2594,2597,-4,-1,20,259.72,12
,20160607,2594,2597,,,,2597,2597,0,0,0,0.00,12
,20160608,2597,2597,2615,2615,2615,2615,2615,18,18,2,26.15,12
,20160613,2615,2615,,,,2615,2615,0,0,0,0.00,12
,20160614,2615,2615,,,,2615,2615,0,0,0,0.00,12
,20160615,2615,2615,,,,2615,2615,0,0,0,0.00,12
,20160616,2615,2615,,,,2615,2615,0,0,0,0.00,12
,20160617,2615,2615,2486,2486,2486,2486,2486,-129,-129,2,24.86,12
,20160620,2486,2486,2594,2598,2593,2593,2594,107,108,14,181.61,16
,20160621,2593,2594,,,,2594,2594,0,0,0,0.00,16
,20160622,2594,2594,,,,2594,2594,0,0,0,0.00,16
,20160623,2594,2594,,,,2594,2594,0,0,0,0.00,16
,20160624,2594,2594,,,,2594,2594,0,0,0,0.00,16
,20160627,2594,2594,,,,2594,2594,0,0,0,0.00,16
,20160628,2594,2594,2615,2624,2598,2598,2613,4,19,10,130.65,12
,20160629,2598,2613,,,,2613,2613,0,0,0,0.00,12
,20160630,2613,2613,,,,2613,2613,0,0,0,0.00,12
,20160701,2613,2613,2644,2644,2603,2631,2632,18,19,18,236.88,12
,20160704,2631,2632,2649,2711,2649,2652,2670,20,38,6,80.12,14
,20160705,2652,2670,2660,2675,2660,2673,2669,3,-1,10,133.47,12
,20160706,2673,2669,,,,2669,2669,0,0,0,0.00,12
,20160707,2669,2669,,,,2669,2669,0,0,0,0.00,12
,20160708,2669,2669,,,,2669,2669,0,0,0,0.00,12
,20160711,2669,2669,,,,2669,2669,0,0,0,0.00,12
,20160712,2669,2669,2694,2694,2566,2653,2667,-16,-2,26,346.76,10
,20160713,2653,2667,2688,2688,2688,2688,2688,21,21,2,26.88,12
,20160714,2688,2688,,,,2688,2688,0,0,0,0.00,12
,20160715,2688,2688,,,,2688,2688,0,0,0,0.00,12
,20160718,2688,2688,2654,2654,2554,2554,2604,-134,-84,4,52.08,10
,20160719,2554,2604,,,,2626,2626,22,22,0,0.00,10
,20160720,2626,2626,2496,2496,2496,2496,2496,-130,-130,2,24.96,12
,20160721,2496,2496,2433,2620,2433,2620,2526,124,30,4,50.53,10
,20160722,2620,2526,,,,2617,2617,91,91,0,0.00,10
,20160725,2617,2617,,,,2617,2617,0,0,0,0.00,10
,20160726,2617,2617,,,,2617,2617,0,0,0,0.00,10
,20160727,2617,2617,,,,2620,2620,3,3,0,0.00,10
,20160728,2620,2620,,,,2620,2620,0,0,0,0.00,10
,20160729,2620,2620,2528,2608,2528,2608,2568,-12,-52,4,51.36,10
,20160801,2608,2568,,,,2620,2620,52,52,0,0.00,10
,20160802,2620,2620,,,,2621,2621,1,1,0,0.00,10
,20160803,2621,2621,,,,2621,2621,0,0,0,0.00,10
,20160804,2621,2621,,,,2621,2621,0,0,0,0.00,10
,20160805,2621,2621,2642,2642,2642,2642,2642,21,21,2,26.42,10
,20160808,2642,2642,,,,2640,2640,-2,-2,0,0.00,10
,20160809,2640,2640,,,,2640,2640,0,0,0,0.00,10
,20160810,2640,2640,2536,2536,2536,2536,2536,-104,-104,2,25.36,10
,20160811,2536,2536,,,,2625,2625,89,89,0,0.00,10
,20160812,2625,2625,,,,2626,2626,1,1,0,0.00,10
,20160815,2626,2626,2650,2650,2650,2650,2650,24,24,2,26.50,10
,20160816,2650,2650,,,,2650,2650,0,0,0,0.00,10
,20160817,2650,2650,,,,2650,2650,0,0,0,0.00,10
,20160818,2650,2650,2551,2645,2551,2645,2613,-5,-37,6,78.41,6
,20160819,2645,2613,,,,2637,2637,24,24,0,0.00,6
,20160822,2637,2637,,,,2637,2637,0,0,0,0.00,6
,20160823,2637,2637,,,,2637,2637,0,0,0,0.00,6
,20160824,2637,2637,,,,2637,2637,0,0,0,0.00,6
,20160825,2637,2637,,,,2637,2637,0,0,0,0.00,6
,20160826,2637,2637,,,,2637,2637,0,0,0,0.00,6
,20160829,2637,2637,,,,2637,2637,0,0,0,0.00,6
,20160830,2637,2637,,,,2637,2637,0,0,0,0.00,6
,20160831,2637,2637,,,,2637,2637,0,0,0,0.00,6
,20160901,2637,2637,2631,2631,2631,2631,2631,-6,-6,2,26.31,4
,20160902,2631,2631,2551,2551,2551,2551,2551,-80,-80,2,25.51,4
,20160905,2551,2551,,,,2619,2619,68,68,0,0.00,4
,20160906,2619,2619,2749,2749,2749,2749,2749,130,130,2,27.49,6
,20160907,2749,2749,2622,2678,2622,2676,2661,-73,-88,20,266.16,16
,20160908,2676,2661,2582,2669,2579,2669,2633,8,-28,10,131.68,10
,20160909,2669,2633,2709,2759,2689,2704,2719,71,86,42,571.07,14
,20160912,2704,2719,2685,2697,2584,2590,2630,-129,-89,40,526.13,18
,20160913,2590,2630,2607,2685,2605,2685,2650,55,20,24,318.05,14
,20160914,2685,2650,,,,2665,2665,15,15,0,0.00,14
,20160919,2665,2665,,,,2665,2665,0,0,0,0.00,14
,20160920,2665,2665,2711,2711,2681,2681,2696,16,31,4,53.92,14
,20160921,2681,2696,,,,2696,2696,0,0,0,0.00,14
,20160922,2696,2696,,,,2696,2696,0,0,0,0.00,14
,20160923,2696,2696,2591,2662,2591,2662,2626,-34,-70,4,52.53,14
,20160926,2662,2626,,,,2682,2682,56,56,0,0.00,14
,20160927,2682,2682,2682,2682,2682,2682,2682,0,0,2,26.82,12
,20160928,2682,2682,2680,2680,2605,2660,2657,-22,-25,12,159.43,6
,20160929,2660,2657,,,,2657,2657,0,0,0,0.00,6
,20160930,2657,2657,2620,2620,2620,2620,2620,-37,-37,2,26.20,4
,20161010,2620,2620,,,,2670,2670,50,50,0,0.00,4
,20161011,2670,2670,,,,2674,2674,4,4,0,0.00,4
,20161012,2674,2674,,,,2674,2674,0,0,0,0.00,4
,20161013,2674,2674,,,,2674,2674,0,0,0,0.00,4
,20161014,2674,2674,,,,2674,2674,0,0,0,0.00,4
,20161017,2674,2674,,,,2674,2674,0,0,0,0.00,4
,20161018,2674,2674,,,,2674,2674,0,0,0,0.00,4
,20161019,2674,2674,,,,2674,2674,0,0,0,0.00,4
,20161020,2674,2674,,,,2674,2674,0,0,0,0.00,4
,20161021,2674,2674,,,,2674,2674,0,0,0,0.00,4
,20161024,2674,2674,,,,2674,2674,0,0,0,0.00,4
,20161025,2674,2674,2728,2728,2728,2728,2728,54,54,2,27.28,4
,20161026,2728,2728,,,,2728,2728,0,0,0,0.00,4
,20161027,2728,2728,,,,2728,2728,0,0,0,0.00,4
,20161028,2728,2728,,,,2728,2728,0,0,0,0.00,4
,20161031,2728,2728,,,,2728,2728,0,0,0,0.00,4
,20161101,2728,2728,,,,2728,2728,0,0,0,0.00,4
,20161102,2728,2728,,,,2728,2728,0,0,0,0.00,4
,20161103,2728,2728,,,,2728,2728,0,0,0,0.00,4
,20161104,2728,2728,,,,2728,2728,0,0,0,0.00,4
,20161107,2728,2728,,,,2728,2728,0,0,0,0.00,4
,20161108,2728,2728,,,,2728,2728,0,0,0,0.00,4
,20161109,2728,2728,2699,2860,2699,2803,2787,75,59,6,83.62,4
,20161110,2803,2787,2813,2926,2813,2924,2901,137,114,10,145.09,14
,20161111,2924,2901,2835,2910,2835,2910,2879,9,-22,16,230.34,6
,20161114,2910,2879,,,,2900,2900,21,21,0,0.00,6
,20161115,2900,2900,2918,2918,2918,2918,2918,18,18,2,29.18,4
,20161116,2918,2918,,,,2918,2918,0,0,0,0.00,4
,20161117,2918,2918,,,,2923,2923,5,5,0,0.00,4
,20161118,2923,2923,2830,2830,2830,2830,2830,-93,-93,2,28.30,4
,20161121,2830,2830,,,,2830,2830,0,0,0,0.00,4
,20161122,2830,2830,,,,2830,2830,0,0,0,0.00,4
,20161123,2830,2830,,,,2830,2830,0,0,0,0.00,4
,20161124,2830,2830,,,,2830,2830,0,0,0,0.00,4
,20161125,2830,2830,,,,2830,2830,0,0,0,0.00,4
,20161128,2830,2830,,,,2830,2830,0,0,0,0.00,4
,20161129,2830,2830,,,,2830,2830,0,0,0,0.00,4
,20161130,2830,2830,,,,2830,2830,0,0,0,0.00,4
,20161201,2830,2830,,,,2971,2971,141,141,0,0.00,4
,20161202,2971,2971,,,,3119,3119,148,148,0,0.00,4
,20161205,3119,3119,3144,3144,3144,3144,3144,25,25,2,31.44,2
,20161206,3144,3144,,,,3144,3144,0,0,0,0.00,2
,20161207,3144,3144,,,,3301,3301,157,157,0,0.00,2
,20161208,3301,3301,,,,3466,3466,165,165,0,0.00,2
,20161209,3466,3466,,,,3639,3639,173,173,0,0.00,2
,20161212,3639,3639,,,,3820,3820,181,181,0,0.00,2
,20161213,3820,3820,3630,3630,3630,3630,3630,-190,-190,2,36.30,2
,20161214,3630,3630,,,,3811,3811,181,181,0,0.00,2
,20161215,3811,3811,4001,4001,4001,4001,4001,190,190,2,40.01,0
,20161216,4001,4001,,,,4001,4001,0,0,0,0.00,0
,20161219,4001,4001,,,,4001,4001,0,0,0,0.00,0
,20161220,4001,4001,,,,4001,4001,0,0,0,0.00,0
,20161221,4001,4001,,,,4001,4001,0,0,0,0.00,0
,20161222,4001,4001,,,,4001,4001,0,0,0,0.00,0
,20161223,4001,4001,,,,4001,4001,0,0,0,0.00,0
,20161226,4001,4001,,,,4001,4001,0,0,0,0.00,0
,20161227,4001,4001,,,,4001,4001,0,0,0,0.00,0
,20161228,4001,4001,,,,4001,4001,0,0,0,0.00,0
,20161229,4001,4001,,,,4001,4001,0,0,0,0.00,0
,20161230,4001,4001,,,,4001,4001,0,0,0,0.00,0
fu1703,20160301,2529,2529,,,,2529,2529,0,0,0,0.00,0
,20160302,2529,2529,,,,2529,2529,0,0,0,0.00,0
,20160303,2529,2529,,,,2529,2529,0,0,0,0.00,0
,20160304,2529,2529,,,,2529,2529,0,0,0,0.00,0
,20160307,2529,2529,,,,2529,2529,0,0,0,0.00,0
,20160308,2529,2529,,,,2529,2529,0,0,0,0.00,0
,20160309,2529,2529,,,,2529,2529,0,0,0,0.00,0
,20160310,2529,2529,,,,2529,2529,0,0,0,0.00,0
,20160311,2529,2529,,,,2529,2529,0,0,0,0.00,0
,20160314,2529,2529,,,,2529,2529,0,0,0,0.00,0
,20160315,2529,2529,,,,2529,2529,0,0,0,0.00,0
,20160316,2529,2529,,,,2529,2529,0,0,0,0.00,0
,20160317,2529,2529,,,,2529,2529,0,0,0,0.00,0
,20160318,2529,2529,,,,2529,2529,0,0,0,0.00,0
,20160321,2529,2529,,,,2529,2529,0,0,0,0.00,0
,20160322,2529,2529,2781,2781,2366,2366,2573,-163,44,4,51.47,2
,20160323,2366,2573,,,,2444,2444,-129,-129,0,0.00,2
,20160324,2444,2444,,,,2444,2444,0,0,0,0.00,2
,20160325,2444,2444,,,,2326,2326,-118,-118,0,0.00,2
,20160328,2326,2326,,,,2235,2235,-91,-91,0,0.00,2
,20160329,2235,2235,,,,2346,2346,111,111,0,0.00,2
,20160330,2346,2346,,,,2320,2320,-26,-26,0,0.00,2
,20160331,2320,2320,,,,2409,2409,89,89,0,0.00,2
,20160401,2409,2409,,,,2455,2455,46,46,0,0.00,2
,20160405,2455,2455,,,,2333,2333,-122,-122,0,0.00,2
,20160406,2333,2333,,,,2333,2333,0,0,0,0.00,2
,20160407,2333,2333,,,,2345,2345,12,12,0,0.00,2
,20160408,2345,2345,,,,2315,2315,-30,-30,0,0.00,2
,20160411,2315,2315,,,,2315,2315,0,0,0,0.00,2
,20160412,2315,2315,,,,2315,2315,0,0,0,0.00,2
,20160413,2315,2315,,,,2252,2252,-63,-63,0,0.00,2
,20160414,2252,2252,,,,2363,2363,111,111,0,0.00,2
,20160415,2363,2363,,,,2441,2441,78,78,0,0.00,2
,20160418,2441,2441,,,,2561,2561,120,120,0,0.00,2
,20160419,2561,2561,,,,2438,2438,-123,-123,0,0.00,2
,20160420,2438,2438,,,,2438,2438,0,0,0,0.00,2
,20160421,2438,2438,,,,2534,2534,96,96,0,0.00,2
,20160422,2534,2534,,,,2422,2422,-112,-112,0,0.00,2
,20160425,2422,2422,,,,2437,2437,15,15,0,0.00,2
,20160426,2437,2437,,,,2437,2437,0,0,0,0.00,2
,20160427,2437,2437,,,,2437,2437,0,0,0,0.00,2
,20160428,2437,2437,,,,2393,2393,-44,-44,0,0.00,2
,20160429,2393,2393,,,,2340,2340,-53,-53,0,0.00,2
,20160503,2340,2340,,,,2340,2340,0,0,0,0.00,2
,20160504,2340,2340,,,,2340,2340,0,0,0,0.00,2
,20160505,2340,2340,,,,2304,2304,-36,-36,0,0.00,2
,20160506,2304,2304,,,,2419,2419,115,115,0,0.00,2
,20160509,2419,2419,,,,2301,2301,-118,-118,0,0.00,2
,20160510,2301,2301,,,,2415,2415,114,114,0,0.00,2
,20160511,2415,2415,,,,2294,2294,-121,-121,0,0.00,2
,20160512,2294,2294,,,,2408,2408,114,114,0,0.00,2
,20160513,2408,2408,,,,2528,2528,120,120,0,0.00,2
,20160516,2528,2528,,,,2528,2528,0,0,0,0.00,2
,20160517,2528,2528,,,,2528,2528,0,0,0,0.00,2
,20160518,2528,2528,,,,2528,2528,0,0,0,0.00,2
,20160519,2528,2528,,,,2528,2528,0,0,0,0.00,2
,20160520,2528,2528,,,,2528,2528,0,0,0,0.00,2
,20160523,2528,2528,,,,2528,2528,0,0,0,0.00,2
,20160524,2528,2528,,,,2451,2451,-77,-77,0,0.00,2
,20160525,2451,2451,,,,2451,2451,0,0,0,0.00,2
,20160526,2451,2451,,,,2479,2479,28,28,0,0.00,2
,20160527,2479,2479,,,,2435,2435,-44,-44,0,0.00,2
,20160530,2435,2435,,,,2464,2464,29,29,0,0.00,2
,20160531,2464,2464,,,,2464,2464,0,0,0,0.00,2
,20160601,2464,2464,2341,2341,2341,2341,2341,-123,-123,2,23.41,2
,20160602,2341,2341,,,,2326,2326,-15,-15,0,0.00,2
,20160603,2326,2326,,,,2369,2369,43,43,0,0.00,2
,20160606,2369,2369,,,,2368,2368,-1,-1,0,0.00,2
,20160607,2368,2368,,,,2368,2368,0,0,0,0.00,2
,20160608,2368,2368,,,,2384,2384,16,16,0,0.00,2
,20160613,2384,2384,,,,2384,2384,0,0,0,0.00,2
,20160614,2384,2384,,,,2384,2384,0,0,0,0.00,2
,20160615,2384,2384,,,,2384,2384,0,0,0,0.00,2
,20160616,2384,2384,,,,2384,2384,0,0,0,0.00,2
,20160617,2384,2384,,,,2266,2266,-118,-118,0,0.00,2
,20160620,2266,2266,,,,2364,2364,98,98,0,0.00,2
,20160621,2364,2364,,,,2364,2364,0,0,0,0.00,2
,20160622,2364,2364,,,,2364,2364,0,0,0,0.00,2
,20160623,2364,2364,,,,2364,2364,0,0,0,0.00,2
,20160624,2364,2364,,,,2364,2364,0,0,0,0.00,2
,20160627,2364,2364,,,,2481,2481,117,117,0,0.00,2
,20160628,2481,2481,,,,2499,2499,18,18,0,0.00,2
,20160629,2499,2499,,,,2436,2436,-63,-63,0,0.00,2
,20160630,2436,2436,,,,2403,2403,-33,-33,0,0.00,2
,20160701,2403,2403,,,,2420,2420,17,17,0,0.00,2
,20160704,2420,2420,,,,2420,2420,0,0,0,0.00,2
,20160705,2420,2420,2541,2541,2541,2541,2541,121,121,2,25.41,0
,20160706,2541,2541,,,,2541,2541,0,0,0,0.00,0
,20160707,2541,2541,,,,2541,2541,0,0,0,0.00,0
,20160708,2541,2541,,,,2541,2541,0,0,0,0.00,0
,20160711,2541,2541,,,,2541,2541,0,0,0,0.00,0
,20160712,2541,2541,,,,2541,2541,0,0,0,0.00,0
,20160713,2541,2541,,,,2541,2541,0,0,0,0.00,0
,20160714,2541,2541,,,,2541,2541,0,0,0,0.00,0
,20160715,2541,2541,,,,2541,2541,0,0,0,0.00,0
,20160718,2541,2541,,,,2541,2541,0,0,0,0.00,0
,20160719,2541,2541,,,,2541,2541,0,0,0,0.00,0
,20160720,2541,2541,,,,2541,2541,0,0,0,0.00,0
,20160721,2541,2541,,,,2541,2541,0,0,0,0.00,0
,20160722,2541,2541,,,,2541,2541,0,0,0,0.00,0
,20160725,2541,2541,,,,2413,2413,-128,-128,0,0.00,0
,20160726,2413,2413,,,,2413,2413,0,0,0,0.00,0
,20160727,2413,2413,,,,2413,2413,0,0,0,0.00,0
,20160728,2413,2413,,,,2413,2413,0,0,0,0.00,0
,20160729,2413,2413,,,,2365,2365,-48,-48,0,0.00,0
,20160801,2365,2365,,,,2365,2365,0,0,0,0.00,0
,20160802,2365,2365,,,,2483,2483,118,118,0,0.00,0
,20160803,2483,2483,,,,2386,2386,-97,-97,0,0.00,0
,20160804,2386,2386,,,,2386,2386,0,0,0,0.00,0
,20160805,2386,2386,2276,2276,2276,2276,2276,-110,-110,2,22.76,2
,20160808,2276,2276,2201,2201,2201,2201,2201,-75,-75,2,22.01,0
,20160809,2201,2201,,,,2311,2311,110,110,0,0.00,0
,20160810,2311,2311,,,,2219,2219,-92,-92,0,0.00,0
,20160811,2219,2219,,,,2219,2219,0,0,0,0.00,0
,20160812,2219,2219,,,,2329,2329,110,110,0,0.00,0
,20160815,2329,2329,,,,2445,2445,116,116,0,0.00,0
,20160816,2445,2445,,,,2329,2329,-116,-116,0,0.00,0
,20160817,2329,2329,,,,2234,2234,-95,-95,0,0.00,0
,20160818,2234,2234,,,,2203,2203,-31,-31,0,0.00,0
,20160819,2203,2203,,,,2313,2313,110,110,0,0.00,0
,20160822,2313,2313,,,,2428,2428,115,115,0,0.00,0
,20160823,2428,2428,,,,2428,2428,0,0,0,0.00,0
,20160824,2428,2428,,,,2428,2428,0,0,0,0.00,0
,20160825,2428,2428,,,,2428,2428,0,0,0,0.00,0
,20160826,2428,2428,2310,2310,2310,2310,2310,-118,-118,2,23.10,2
,20160829,2310,2310,,,,2310,2310,0,0,0,0.00,2
,20160830,2310,2310,,,,2425,2425,115,115,0,0.00,2
,20160831,2425,2425,,,,2425,2425,0,0,0,0.00,2
,20160901,2425,2425,,,,2419,2419,-6,-6,0,0.00,2
,20160902,2419,2419,,,,2345,2345,-74,-74,0,0.00,2
,20160905,2345,2345,,,,2462,2462,117,117,0,0.00,2
,20160906,2462,2462,2344,2344,2344,2344,2344,-118,-118,2,23.44,0
,20160907,2344,2344,,,,2461,2461,117,117,0,0.00,0
,20160908,2461,2461,,,,2435,2435,-26,-26,0,0.00,0
,20160909,2435,2435,,,,2514,2514,79,79,0,0.00,0
,20160912,2514,2514,,,,2432,2432,-82,-82,0,0.00,0
,20160913,2432,2432,,,,2450,2450,18,18,0,0.00,0
,20160914,2450,2450,2330,2330,2330,2330,2330,-120,-120,2,23.30,2
,20160919,2330,2330,,,,2446,2446,116,116,0,0.00,2
,20160920,2446,2446,2336,2336,2336,2336,2336,-110,-110,2,23.36,0
,20160921,2336,2336,,,,2452,2452,116,116,0,0.00,0
,20160922,2452,2452,,,,2394,2394,-58,-58,0,0.00,0
,20160923,2394,2394,,,,2332,2332,-62,-62,0,0.00,0
,20160926,2332,2332,,,,2352,2352,20,20,0,0.00,0
,20160927,2352,2352,,,,2352,2352,0,0,0,0.00,0
,20160928,2352,2352,,,,2469,2469,117,117,0,0.00,0
,20160929,2469,2469,,,,2358,2358,-111,-111,0,0.00,0
,20160930,2358,2358,,,,2325,2325,-33,-33,0,0.00,0
,20161010,2325,2325,,,,2165,2165,-160,-160,0,0.00,0
,20161011,2165,2165,,,,2273,2273,108,108,0,0.00,0
,20161012,2273,2273,,,,2386,2386,113,113,0,0.00,0
,20161013,2386,2386,,,,2386,2386,0,0,0,0.00,0
,20161014,2386,2386,,,,2386,2386,0,0,0,0.00,0
,20161017,2386,2386,,,,2268,2268,-118,-118,0,0.00,0
,20161018,2268,2268,,,,2381,2381,113,113,0,0.00,0
,20161019,2381,2381,,,,2381,2381,0,0,0,0.00,0
,20161020,2381,2381,,,,2381,2381,0,0,0,0.00,0
,20161021,2381,2381,,,,2381,2381,0,0,0,0.00,0
,20161024,2381,2381,,,,2406,2406,25,25,0,0.00,0
,20161025,2406,2406,,,,2454,2454,48,48,0,0.00,0
,20161026,2454,2454,,,,2454,2454,0,0,0,0.00,0
,20161027,2454,2454,,,,2454,2454,0,0,0,0.00,0
,20161028,2454,2454,,,,2454,2454,0,0,0,0.00,0
,20161031,2454,2454,,,,2454,2454,0,0,0,0.00,0
,20161101,2454,2454,,,,2576,2576,122,122,0,0.00,0
,20161102,2576,2576,,,,2576,2576,0,0,0,0.00,0
,20161103,2576,2576,,,,2576,2576,0,0,0,0.00,0
,20161104,2576,2576,,,,2576,2576,0,0,0,0.00,0
,20161107,2576,2576,,,,2576,2576,0,0,0,0.00,0
,20161108,2576,2576,,,,2576,2576,0,0,0,0.00,0
,20161109,2576,2576,,,,2632,2632,56,56,0,0.00,0
,20161110,2632,2632,,,,2740,2740,108,108,0,0.00,0
,20161111,2740,2740,,,,2719,2719,-21,-21,0,0.00,0
,20161114,2719,2719,,,,2719,2719,0,0,0,0.00,0
,20161115,2719,2719,,,,2735,2735,16,16,0,0.00,0
,20161116,2735,2735,,,,2735,2735,0,0,0,0.00,0
,20161117,2735,2735,,,,2735,2735,0,0,0,0.00,0
,20161118,2735,2735,,,,2647,2647,-88,-88,0,0.00,0
,20161121,2647,2647,,,,2647,2647,0,0,0,0.00,0
,20161122,2647,2647,,,,2647,2647,0,0,0,0.00,0
,20161123,2647,2647,,,,2779,2779,132,132,0,0.00,0
,20161124,2779,2779,,,,2779,2779,0,0,0,0.00,0
,20161125,2779,2779,,,,2779,2779,0,0,0,0.00,0
,20161128,2779,2779,,,,2779,2779,0,0,0,0.00,0
,20161129,2779,2779,,,,2917,2917,138,138,0,0.00,0
,20161130,2917,2917,,,,2917,2917,0,0,0,0.00,0
,20161201,2917,2917,,,,2917,2917,0,0,0,0.00,0
,20161202,2917,2917,,,,3062,3062,145,145,0,0.00,0
,20161205,3062,3062,,,,3215,3215,153,153,0,0.00,0
,20161206,3215,3215,,,,3215,3215,0,0,0,0.00,0
,20161207,3215,3215,,,,3215,3215,0,0,0,0.00,0
,20161208,3215,3215,,,,3375,3375,160,160,0,0.00,0
,20161209,3375,3375,,,,3543,3543,168,168,0,0.00,0
,20161212,3543,3543,,,,3543,3543,0,0,0,0.00,0
,20161213,3543,3543,,,,3720,3720,177,177,0,0.00,0
,20161214,3720,3720,,,,3906,3906,186,186,0,0.00,0
,20161215,3906,3906,,,,4100,4100,194,194,0,0.00,0
,20161216,4100,4100,,,,4100,4100,0,0,0,0.00,0
,20161219,4100,4100,,,,4100,4100,0,0,0,0.00,0
,20161220,4100,4100,,,,4100,4100,0,0,0,0.00,0
,20161221,4100,4100,,,,4100,4100,0,0,0,0.00,0
,20161222,4100,4100,,,,4100,4100,0,0,0,0.00,0
,20161223,4100,4100,,,,4100,4100,0,0,0,0.00,0
,20161226,4100,4100,,,,4100,4100,0,0,0,0.00,0
,20161227,4100,4100,,,,4100,4100,0,0,0,0.00,0
,20161228,4100,4100,,,,4100,4100,0,0,0,0.00,0
,20161229,4100,4100,,,,4100,4100,0,0,0,0.00,0
,20161230,4100,4100,,,,4100,4100,0,0,0,0.00,0
fu1704,20160401,2409,2409,,,,2455,2455,46,46,0,0.00,0
,20160405,2455,2455,,,,2455,2455,0,0,0,0.00,0
,20160406,2455,2455,,,,2455,2455,0,0,0,0.00,0
,20160407,2455,2455,,,,2467,2467,12,12,0,0.00,0
,20160408,2467,2467,,,,2467,2467,0,0,0,0.00,0
,20160411,2467,2467,,,,2467,2467,0,0,0,0.00,0
,20160412,2467,2467,,,,2467,2467,0,0,0,0.00,0
,20160413,2467,2467,,,,2467,2467,0,0,0,0.00,0
,20160414,2467,2467,,,,2467,2467,0,0,0,0.00,0
,20160415,2467,2467,,,,2467,2467,0,0,0,0.00,0
,20160418,2467,2467,,,,2467,2467,0,0,0,0.00,0
,20160419,2467,2467,,,,2467,2467,0,0,0,0.00,0
,20160420,2467,2467,,,,2467,2467,0,0,0,0.00,0
,20160421,2467,2467,,,,2467,2467,0,0,0,0.00,0
,20160422,2467,2467,,,,2467,2467,0,0,0,0.00,0
,20160425,2467,2467,,,,2467,2467,0,0,0,0.00,0
,20160426,2467,2467,,,,2467,2467,0,0,0,0.00,0
,20160427,2467,2467,,,,2467,2467,0,0,0,0.00,0
,20160428,2467,2467,,,,2467,2467,0,0,0,0.00,0
,20160429,2467,2467,,,,2467,2467,0,0,0,0.00,0
,20160503,2467,2467,,,,2467,2467,0,0,0,0.00,0
,20160504,2467,2467,,,,2467,2467,0,0,0,0.00,0
,20160505,2467,2467,,,,2429,2429,-38,-38,0,0.00,0
,20160506,2429,2429,,,,2429,2429,0,0,0,0.00,0
,20160509,2429,2429,,,,2310,2310,-119,-119,0,0.00,0
,20160510,2310,2310,,,,2424,2424,114,114,0,0.00,0
,20160511,2424,2424,,,,2424,2424,0,0,0,0.00,0
,20160512,2424,2424,,,,2424,2424,0,0,0,0.00,0
,20160513,2424,2424,,,,2424,2424,0,0,0,0.00,0
,20160516,2424,2424,,,,2424,2424,0,0,0,0.00,0
,20160517,2424,2424,,,,2424,2424,0,0,0,0.00,0
,20160518,2424,2424,,,,2424,2424,0,0,0,0.00,0
,20160519,2424,2424,,,,2424,2424,0,0,0,0.00,0
,20160520,2424,2424,,,,2424,2424,0,0,0,0.00,0
,20160523,2424,2424,,,,2424,2424,0,0,0,0.00,0
,20160524,2424,2424,,,,2424,2424,0,0,0,0.00,0
,20160525,2424,2424,,,,2424,2424,0,0,0,0.00,0
,20160526,2424,2424,,,,2424,2424,0,0,0,0.00,0
,20160527,2424,2424,,,,2424,2424,0,0,0,0.00,0
,20160530,2424,2424,,,,2424,2424,0,0,0,0.00,0
,20160531,2424,2424,,,,2424,2424,0,0,0,0.00,0
,20160601,2424,2424,,,,2424,2424,0,0,0,0.00,0
,20160602,2424,2424,,,,2424,2424,0,0,0,0.00,0
,20160603,2424,2424,2666,2666,2666,2666,2666,242,242,6,79.98,6
,20160606,2666,2666,2535,2797,2533,2664,2731,-2,65,28,382.35,22
,20160607,2664,2731,2608,2645,2608,2621,2616,-110,-115,44,575.70,14
,20160608,2621,2616,2585,2641,2585,2613,2620,-3,4,8,104.80,14
,20160613,2613,2620,2500,2749,2500,2632,2638,12,18,16,211.07,14
,20160614,2632,2638,2587,2617,2587,2617,2607,-21,-31,6,78.21,12
,20160615,2617,2607,2568,2595,2568,2595,2581,-12,-26,4,51.63,12
,20160616,2595,2581,2459,2612,2459,2592,2576,11,-5,10,128.81,10
,20160617,2592,2576,,,,2594,2594,18,18,0,0.00,10
,20160620,2594,2594,2611,2617,2611,2617,2614,23,20,14,182.98,16
,20160621,2617,2614,,,,2614,2614,0,0,0,0.00,16
,20160622,2614,2614,2511,2637,2511,2626,2598,12,-16,8,103.93,14
,20160623,2626,2598,2526,2526,2526,2526,2526,-72,-72,2,25.26,14
,20160624,2526,2526,2522,2652,2522,2619,2624,93,98,24,314.91,8
,20160627,2619,2624,2512,2747,2512,2629,2602,5,-22,10,130.12,10
,20160628,2629,2602,2555,2555,2555,2555,2555,-47,-47,2,25.55,10
,20160629,2555,2555,,,,2612,2612,57,57,0,0.00,10
,20160630,2612,2612,2559,2647,2559,2624,2624,12,12,12,157.46,10
,20160701,2624,2624,2583,2643,2501,2613,2596,-11,-28,10,129.82,10
,20160704,2613,2596,2651,2651,2651,2651,2651,55,55,4,53.02,12
,20160705,2651,2651,2538,2696,2538,2644,2613,-7,-38,10,130.68,14
,20160706,2644,2613,2645,2645,2558,2645,2623,32,10,8,104.92,12
,20160707,2645,2623,2656,2656,2656,2656,2656,33,33,2,26.56,12
,20160708,2656,2656,2583,2638,2583,2638,2619,-18,-37,6,78.58,12
,20160711,2638,2619,,,,2626,2626,7,7,0,0.00,12
,20160712,2626,2626,2556,2556,2556,2556,2556,-70,-70,2,25.56,12
,20160713,2556,2556,2660,2660,2551,2629,2624,73,68,12,157.45,10
,20160714,2629,2624,,,,2624,2624,0,0,0,0.00,10
,20160715,2624,2624,,,,2624,2624,0,0,0,0.00,10
,20160718,2624,2624,2571,2571,2571,2571,2571,-53,-53,2,25.71,10
,20160719,2571,2571,2611,2633,2611,2633,2625,62,54,6,78.77,8
,20160720,2633,2625,2497,2497,2497,2497,2497,-128,-128,2,24.97,8
,20160721,2497,2497,2433,2621,2433,2621,2527,124,30,4,50.54,8
,20160722,2621,2527,2402,2633,2402,2633,2517,106,-10,4,50.35,10
,20160725,2633,2517,2620,2640,2464,2597,2578,80,61,12,154.68,8
,20160726,2597,2578,2634,2634,2634,2634,2634,56,56,4,52.68,12
,20160727,2634,2634,,,,2634,2634,0,0,0,0.00,12
,20160728,2634,2634,2645,2645,2630,2630,2637,-4,3,4,52.75,12
,20160729,2630,2637,,,,2637,2637,0,0,0,0.00,12
,20160801,2637,2637,2630,2630,2630,2630,2630,-7,-7,4,52.60,8
,20160802,2630,2630,,,,2630,2630,0,0,0,0.00,8
,20160803,2630,2630,2530,2634,2530,2634,2599,4,-31,6,77.98,12
,20160804,2634,2599,2536,2699,2471,2649,2601,50,2,14,182.10,14
,20160805,2649,2601,,,,2632,2632,31,31,0,0.00,14
,20160808,2632,2632,2627,2627,2627,2627,2627,-5,-5,2,26.27,12
,20160809,2627,2627,,,,2627,2627,0,0,0,0.00,12
,20160810,2627,2627,2626,2626,2626,2626,2626,-1,-1,2,26.26,12
,20160811,2626,2626,,,,2630,2630,4,4,0,0.00,12
,20160812,2630,2630,,,,2632,2632,2,2,0,0.00,12
,20160815,2632,2632,,,,2632,2632,0,0,0,0.00,12
,20160816,2632,2632,,,,2632,2632,0,0,0,0.00,12
,20160817,2632,2632,,,,2634,2634,2,2,0,0.00,12
,20160818,2634,2634,,,,2634,2634,0,0,0,0.00,12
,20160819,2634,2634,,,,2634,2634,0,0,0,0.00,12
,20160822,2634,2634,,,,2634,2634,0,0,0,0.00,12
,20160823,2634,2634,2633,2633,2504,2504,2568,-130,-66,4,51.37,10
,20160824,2504,2568,2527,2696,2527,2604,2623,36,55,10,131.17,10
,20160825,2604,2623,2538,2546,2538,2546,2542,-77,-81,4,50.84,10
,20160826,2546,2542,,,,2610,2610,68,68,0,0.00,10
,20160829,2610,2610,2526,2526,2526,2526,2526,-84,-84,2,25.26,10
,20160830,2526,2526,2489,2553,2489,2553,2521,27,-5,4,50.42,10
,20160831,2553,2521,2461,2551,2461,2551,2506,30,-15,4,50.12,10
,20160901,2551,2506,2631,2631,2621,2622,2624,116,118,8,104.97,8
,20160902,2622,2624,,,,2625,2625,1,1,0,0.00,8
,20160905,2625,2625,,,,2627,2627,2,2,0,0.00,8
,20160906,2627,2627,,,,2627,2627,0,0,0,0.00,8
,20160907,2627,2627,2631,2631,2631,2631,2631,4,4,2,26.31,6
,20160908,2631,2631,2661,2661,2661,2661,2661,30,30,2,26.61,8
,20160909,2661,2661,2566,2566,2566,2566,2566,-95,-95,2,25.66,8
,20160912,2566,2566,2637,2637,2637,2637,2637,71,71,2,26.37,6
,20160913,2637,2637,2640,2640,2640,2640,2640,3,3,2,26.40,6
,20160914,2640,2640,2556,2556,2556,2556,2556,-84,-84,2,25.56,6
,20160919,2556,2556,2680,2680,2680,2680,2680,124,124,2,26.80,8
,20160920,2680,2680,,,,2680,2680,0,0,0,0.00,8
,20160921,2680,2680,,,,2680,2680,0,0,0,0.00,8
,20160922,2680,2680,,,,2680,2680,0,0,0,0.00,8
,20160923,2680,2680,2586,2586,2586,2586,2586,-94,-94,2,25.86,8
,20160926,2586,2586,,,,2664,2664,78,78,0,0.00,8
,20160927,2664,2664,,,,2666,2666,2,2,0,0.00,8
,20160928,2666,2666,2661,2661,2661,2661,2661,-5,-5,2,26.61,6
,20160929,2661,2661,2675,2675,2675,2675,2675,14,14,2,26.75,8
,20160930,2675,2675,,,,2675,2675,0,0,0,0.00,8
,20161010,2675,2675,,,,2675,2675,0,0,0,0.00,8
,20161011,2675,2675,,,,2675,2675,0,0,0,0.00,8
,20161012,2675,2675,,,,2675,2675,0,0,0,0.00,8
,20161013,2675,2675,,,,2675,2675,0,0,0,0.00,8
,20161014,2675,2675,,,,2675,2675,0,0,0,0.00,8
,20161017,2675,2675,,,,2675,2675,0,0,0,0.00,8
,20161018,2675,2675,,,,2675,2675,0,0,0,0.00,8
,20161019,2675,2675,,,,2675,2675,0,0,0,0.00,8
,20161020,2675,2675,,,,2675,2675,0,0,0,0.00,8
,20161021,2675,2675,,,,2675,2675,0,0,0,0.00,8
,20161024,2675,2675,2718,2718,2718,2718,2718,43,43,2,27.18,8
,20161025,2718,2718,2667,2667,2667,2667,2667,-51,-51,2,26.67,6
,20161026,2667,2667,,,,2667,2667,0,0,0,0.00,6
,20161027,2667,2667,,,,2667,2667,0,0,0,0.00,6
,20161028,2667,2667,,,,2667,2667,0,0,0,0.00,6
,20161031,2667,2667,,,,2667,2667,0,0,0,0.00,6
,20161101,2667,2667,2606,2800,2606,2779,2778,112,111,30,416.75,12
,20161102,2779,2778,2776,2819,2776,2817,2795,39,17,14,195.65,12
,20161103,2817,2795,2788,2825,2788,2825,2810,30,15,6,84.30,14
,20161104,2825,2810,,,,2818,2818,8,8,0,0.00,14
,20161107,2818,2818,2818,2818,2783,2794,2792,-24,-26,12,167.54,6
,20161108,2794,2792,2692,2760,2692,2760,2726,-32,-66,4,54.52,6
,20161109,2760,2726,,,,2747,2747,21,21,0,0.00,6
,20161110,2747,2747,2760,2880,2760,2880,2826,133,79,34,480.46,16
,20161111,2880,2826,2929,2929,2841,2927,2897,101,71,16,231.77,16
,20161114,2927,2897,2850,2928,2850,2860,2879,-37,-18,6,86.38,14
,20161115,2860,2879,2752,3020,2752,2969,2937,90,58,44,646.15,22
,20161116,2969,2937,2947,3075,2947,3035,3006,98,69,58,871.75,20
,20161117,3035,3006,3044,3044,2994,2998,3019,-8,13,12,181.19,20
,20161118,2998,3019,3000,3000,3000,3000,3000,-19,-19,2,30.00,20
,20161121,3000,3000,2967,3018,2967,3017,3000,17,0,6,90.02,18
,20161122,3017,3000,3008,3052,3005,3036,3022,36,22,30,453.38,20
,20161123,3036,3022,3034,3034,3033,3033,3033,11,11,4,60.67,16
,20161124,3033,3033,3041,3041,3035,3035,3038,2,5,8,121.52,14
,20161125,3035,3038,3043,3189,3043,3166,3125,128,87,30,468.84,26
,20161128,3166,3125,3166,3281,3166,3280,3248,155,123,22,357.38,28
,20161129,3280,3248,3271,3400,3269,3269,3323,21,75,20,332.37,24
,20161130,3269,3323,3215,3320,3215,3320,3267,-3,-56,4,65.35,24
,20161201,3320,3267,3350,3430,3295,3425,3406,158,139,52,885.74,30
,20161202,3425,3406,3548,3576,3425,3576,3547,170,141,30,532.18,34
,20161205,3576,3547,3816,3829,3618,3727,3750,180,203,186,"3,488.36",60
,20161206,3727,3750,3726,3853,3711,3818,3784,68,34,64,"1,210.95",72
,20161207,3818,3784,3970,3973,3858,3973,3942,189,158,96,"1,892.57",82
,20161208,3973,3942,3969,4139,3965,4124,4099,182,157,170,"3,484.71",166
,20161209,4124,4099,4212,4245,4098,4209,4193,110,94,196,"4,109.56",222
,20161212,4209,4193,4251,4402,4245,4400,4358,207,165,182,"3,966.16",316
,20161213,4400,4358,4510,4575,4213,4575,4510,217,152,302,"6,810.89",358
,20161214,4575,4510,4588,4627,4381,4502,4521,-8,11,418,"9,450.52",310
,20161215,4502,4521,4484,4515,4294,4294,4373,-227,-148,160,"3,498.49",278
,20161216,4294,4373,4200,4200,4023,4081,4099,-292,-274,280,"5,738.67",296
,20161219,4081,4099,4093,4264,4074,4133,4161,34,62,238,"4,952.35",296
,20161220,4133,4161,4035,4140,4035,4082,4080,-79,-81,114,"2,325.88",262
,20161221,4082,4080,4173,4194,4114,4140,4163,60,83,84,"1,748.46",248
,20161222,4140,4163,4100,4120,4003,4003,4059,-160,-104,100,"2,029.97",204
,20161223,4003,4059,4030,4191,4030,4104,4089,45,30,126,"2,576.18",220
,20161226,4104,4089,4149,4200,4098,4179,4139,90,50,120,"2,483.47",188
,20161227,4179,4139,4162,4250,4162,4212,4211,73,72,82,"1,726.58",174
,20161228,4212,4211,4321,4421,4312,4421,4370,210,159,152,"3,321.62",186
,20161229,4421,4370,4493,4493,4384,4472,4441,102,71,124,"2,753.65",178
,20161230,4472,4441,4472,4520,4472,4487,4496,46,55,78,"1,753.67",174
fu1705,20160503,2467,2467,,,,2467,2467,0,0,0,0.00,0
,20160504,2467,2467,,,,2467,2467,0,0,0,0.00,0
,20160505,2467,2467,,,,2467,2467,0,0,0,0.00,0
,20160506,2467,2467,,,,2467,2467,0,0,0,0.00,0
,20160509,2467,2467,,,,2467,2467,0,0,0,0.00,0
,20160510,2467,2467,,,,2467,2467,0,0,0,0.00,0
,20160511,2467,2467,,,,2467,2467,0,0,0,0.00,0
,20160512,2467,2467,,,,2467,2467,0,0,0,0.00,0
,20160513,2467,2467,,,,2467,2467,0,0,0,0.00,0
,20160516,2467,2467,,,,2467,2467,0,0,0,0.00,0
,20160517,2467,2467,,,,2467,2467,0,0,0,0.00,0
,20160518,2467,2467,,,,2467,2467,0,0,0,0.00,0
,20160519,2467,2467,,,,2467,2467,0,0,0,0.00,0
,20160520,2467,2467,,,,2467,2467,0,0,0,0.00,0
,20160523,2467,2467,,,,2467,2467,0,0,0,0.00,0
,20160524,2467,2467,,,,2467,2467,0,0,0,0.00,0
,20160525,2467,2467,,,,2467,2467,0,0,0,0.00,0
,20160526,2467,2467,,,,2467,2467,0,0,0,0.00,0
,20160527,2467,2467,,,,2467,2467,0,0,0,0.00,0
,20160530,2467,2467,,,,2467,2467,0,0,0,0.00,0
,20160531,2467,2467,,,,2467,2467,0,0,0,0.00,0
,20160601,2467,2467,,,,2467,2467,0,0,0,0.00,0
,20160602,2467,2467,,,,2467,2467,0,0,0,0.00,0
,20160603,2467,2467,,,,2467,2467,0,0,0,0.00,0
,20160606,2467,2467,,,,2467,2467,0,0,0,0.00,0
,20160607,2467,2467,,,,2467,2467,0,0,0,0.00,0
,20160608,2467,2467,,,,2470,2470,3,3,0,0.00,0
,20160613,2470,2470,,,,2470,2470,0,0,0,0.00,0
,20160614,2470,2470,,,,2470,2470,0,0,0,0.00,0
,20160615,2470,2470,,,,2470,2470,0,0,0,0.00,0
,20160616,2470,2470,,,,2470,2470,0,0,0,0.00,0
,20160617,2470,2470,,,,2470,2470,0,0,0,0.00,0
,20160620,2470,2470,,,,2470,2470,0,0,0,0.00,0
,20160621,2470,2470,,,,2470,2470,0,0,0,0.00,0
,20160622,2470,2470,,,,2470,2470,0,0,0,0.00,0
,20160623,2470,2470,,,,2470,2470,0,0,0,0.00,0
,20160624,2470,2470,,,,2470,2470,0,0,0,0.00,0
,20160627,2470,2470,,,,2470,2470,0,0,0,0.00,0
,20160628,2470,2470,,,,2470,2470,0,0,0,0.00,0
,20160629,2470,2470,,,,2470,2470,0,0,0,0.00,0
,20160630,2470,2470,,,,2481,2481,11,11,0,0.00,0
,20160701,2481,2481,2650,2650,2565,2578,2603,97,122,64,833.18,2
,20160704,2578,2603,,,,2603,2603,0,0,0,0.00,2
,20160705,2603,2603,2733,2733,2472,2639,2605,36,2,12,156.31,4
,20160706,2639,2605,,,,2605,2605,0,0,0,0.00,4
,20160707,2605,2605,,,,2605,2605,0,0,0,0.00,4
,20160708,2605,2605,,,,2605,2605,0,0,0,0.00,4
,20160711,2605,2605,,,,2605,2605,0,0,0,0.00,4
,20160712,2605,2605,,,,2605,2605,0,0,0,0.00,4
,20160713,2605,2605,2564,2639,2564,2638,2619,33,14,8,104.78,8
,20160714,2638,2619,2651,2651,2640,2640,2644,21,25,6,79.33,4
,20160715,2640,2644,,,,2644,2644,0,0,0,0.00,4
,20160718,2644,2644,,,,2644,2644,0,0,0,0.00,4
,20160719,2644,2644,,,,2644,2644,0,0,0,0.00,4
,20160720,2644,2644,,,,2644,2644,0,0,0,0.00,4
,20160721,2644,2644,,,,2639,2639,-5,-5,0,0.00,4
,20160722,2639,2639,2635,2635,2617,2617,2626,-22,-13,4,52.52,4
,20160725,2617,2626,,,,2626,2626,0,0,0,0.00,4
,20160726,2626,2626,,,,2626,2626,0,0,0,0.00,4
,20160727,2626,2626,,,,2626,2626,0,0,0,0.00,4
,20160728,2626,2626,,,,2626,2626,0,0,0,0.00,4
,20160729,2626,2626,,,,2626,2626,0,0,0,0.00,4
,20160801,2626,2626,2630,2630,2630,2630,2630,4,4,2,26.30,6
,20160802,2630,2630,,,,2630,2630,0,0,0,0.00,6
,20160803,2630,2630,,,,2630,2630,0,0,0,0.00,6
,20160804,2630,2630,,,,2630,2630,0,0,0,0.00,6
,20160805,2630,2630,,,,2630,2630,0,0,0,0.00,6
,20160808,2630,2630,,,,2630,2630,0,0,0,0.00,6
,20160809,2630,2630,2502,2502,2502,2502,2502,-128,-128,2,25.02,6
,20160810,2502,2502,2627,2627,2627,2627,2627,125,125,4,52.54,4
,20160811,2627,2627,,,,2627,2627,0,0,0,0.00,4
,20160812,2627,2627,,,,2627,2627,0,0,0,0.00,4
,20160815,2627,2627,,,,2627,2627,0,0,0,0.00,4
,20160816,2627,2627,,,,2627,2627,0,0,0,0.00,4
,20160817,2627,2627,,,,2627,2627,0,0,0,0.00,4
,20160818,2627,2627,,,,2627,2627,0,0,0,0.00,4
,20160819,2627,2627,,,,2627,2627,0,0,0,0.00,4
,20160822,2627,2627,,,,2627,2627,0,0,0,0.00,4
,20160823,2627,2627,,,,2627,2627,0,0,0,0.00,4
,20160824,2627,2627,,,,2627,2627,0,0,0,0.00,4
,20160825,2627,2627,,,,2627,2627,0,0,0,0.00,4
,20160826,2627,2627,,,,2627,2627,0,0,0,0.00,4
,20160829,2627,2627,,,,2627,2627,0,0,0,0.00,4
,20160830,2627,2627,,,,2627,2627,0,0,0,0.00,4
,20160831,2627,2627,,,,2627,2627,0,0,0,0.00,4
,20160901,2627,2627,2607,2607,2607,2607,2607,-20,-20,2,26.07,2
,20160902,2607,2607,,,,2609,2609,2,2,0,0.00,2
,20160905,2609,2609,,,,2611,2611,2,2,0,0.00,2
,20160906,2611,2611,,,,2613,2613,2,2,0,0.00,2
,20160907,2613,2613,,,,2613,2613,0,0,0,0.00,2
,20160908,2613,2613,2743,2743,2743,2743,2743,130,130,2,27.43,4
,20160909,2743,2743,2606,2606,2606,2606,2606,-137,-137,2,26.06,4
,20160912,2606,2606,2527,2527,2527,2527,2527,-79,-79,2,25.27,4
,20160913,2527,2527,,,,2527,2527,0,0,0,0.00,4
,20160914,2527,2527,,,,2527,2527,0,0,0,0.00,4
,20160919,2527,2527,2404,2404,2404,2404,2404,-123,-123,2,24.04,4
,20160920,2404,2404,,,,2295,2295,-109,-109,0,0.00,4
,20160921,2295,2295,,,,2409,2409,114,114,0,0.00,4
,20160922,2409,2409,,,,2529,2529,120,120,0,0.00,4
,20160923,2529,2529,,,,2440,2440,-89,-89,0,0.00,4
,20160926,2440,2440,,,,2461,2461,21,21,0,0.00,4
,20160927,2461,2461,,,,2461,2461,0,0,0,0.00,4
,20160928,2461,2461,,,,2584,2584,123,123,0,0.00,4
,20160929,2584,2584,,,,2584,2584,0,0,0,0.00,4
,20160930,2584,2584,2406,2406,2406,2406,2406,-178,-178,2,24.06,4
,20161010,2406,2406,,,,2240,2240,-166,-166,0,0.00,4
,20161011,2240,2240,,,,2352,2352,112,112,0,0.00,4
,20161012,2352,2352,,,,2469,2469,117,117,0,0.00,4
,20161013,2469,2469,2350,2350,2350,2350,2350,-119,-119,2,23.50,4
,20161014,2350,2350,,,,2467,2467,117,117,0,0.00,4
,20161017,2467,2467,,,,2345,2345,-122,-122,0,0.00,4
,20161018,2345,2345,,,,2462,2462,117,117,0,0.00,4
,20161019,2462,2462,,,,2462,2462,0,0,0,0.00,4
,20161020,2462,2462,,,,2462,2462,0,0,0,0.00,4
,20161021,2462,2462,,,,2585,2585,123,123,0,0.00,4
,20161024,2585,2585,,,,2626,2626,41,41,0,0.00,4
,20161025,2626,2626,,,,2626,2626,0,0,0,0.00,4
,20161026,2626,2626,,,,2626,2626,0,0,0,0.00,4
,20161027,2626,2626,2500,2500,2500,2500,2500,-126,-126,2,25.00,4
,20161028,2500,2500,,,,2625,2625,125,125,0,0.00,4
,20161031,2625,2625,,,,2625,2625,0,0,0,0.00,4
,20161101,2625,2625,,,,2734,2734,109,109,0,0.00,4
,20161102,2734,2734,,,,2734,2734,0,0,0,0.00,4
,20161103,2734,2734,,,,2734,2734,0,0,0,0.00,4
,20161104,2734,2734,,,,2734,2734,0,0,0,0.00,4
,20161107,2734,2734,2610,2610,2610,2610,2610,-124,-124,2,26.10,4
,20161108,2610,2610,,,,2548,2548,-62,-62,0,0.00,4
,20161109,2548,2548,2598,2598,2598,2598,2598,50,50,2,25.98,4
,20161110,2598,2598,,,,2727,2727,129,129,0,0.00,4
,20161111,2727,2727,,,,2795,2795,68,68,0,0.00,4
,20161114,2795,2795,,,,2777,2777,-18,-18,0,0.00,4
,20161115,2777,2777,,,,2832,2832,55,55,0,0.00,4
,20161116,2832,2832,2701,2701,2701,2701,2701,-131,-131,2,27.01,4
,20161117,2701,2701,,,,2713,2713,12,12,0,0.00,4
,20161118,2713,2713,,,,2695,2695,-18,-18,0,0.00,4
,20161121,2695,2695,,,,2695,2695,0,0,0,0.00,4
,20161122,2695,2695,,,,2715,2715,20,20,0,0.00,4
,20161123,2715,2715,2603,2781,2603,2781,2673,66,-42,8,106.95,6
,20161124,2781,2673,,,,2806,2806,133,133,0,0.00,6
,20161125,2806,2806,2946,2946,2946,2946,2946,140,140,4,58.92,6
,20161128,2946,2946,,,,3093,3093,147,147,0,0.00,6
,20161129,3093,3093,3247,3247,2967,3247,3177,154,84,8,127.08,4
,20161130,3247,3177,3383,3383,3383,3383,3383,206,206,2,33.83,4
,20161201,3383,3383,3225,3548,3225,3516,3427,133,44,14,239.94,4
,20161202,3516,3427,3257,3257,3257,3257,3257,-170,-170,2,32.57,6
,20161205,3257,3257,,,,3419,3419,162,162,0,0.00,6
,20161206,3419,3419,3350,3350,3350,3350,3350,-69,-69,2,33.50,4
,20161207,3350,3350,,,,3517,3517,167,167,0,0.00,4
,20161208,3517,3517,3350,3350,3350,3350,3350,-167,-167,2,33.50,4
,20161209,3350,3350,,,,3517,3517,167,167,0,0.00,4
,20161212,3517,3517,,,,3692,3692,175,175,0,0.00,4
,20161213,3692,3692,,,,3876,3876,184,184,0,0.00,4
,20161214,3876,3876,,,,3886,3886,10,10,0,0.00,4
,20161215,3886,3886,,,,3758,3758,-128,-128,0,0.00,4
,20161216,3758,3758,,,,3570,3570,-188,-188,0,0.00,4
,20161219,3570,3570,,,,3748,3748,178,178,0,0.00,4
,20161220,3748,3748,,,,3675,3675,-73,-73,0,0.00,4
,20161221,3675,3675,,,,3749,3749,74,74,0,0.00,4
,20161222,3749,3749,,,,3656,3656,-93,-93,0,0.00,4
,20161223,3656,3656,,,,3683,3683,27,27,0,0.00,4
,20161226,3683,3683,,,,3728,3728,45,45,0,0.00,4
,20161227,3728,3728,,,,3793,3793,65,65,0,0.00,4
,20161228,3793,3793,,,,3936,3936,143,143,0,0.00,4
,20161229,3936,3936,,,,4000,4000,64,64,0,0.00,4
,20161230,4000,4000,,,,4050,4050,50,50,0,0.00,4
fu1706,20160601,2467,2467,,,,2467,2467,0,0,0,0.00,0
,20160602,2467,2467,,,,2467,2467,0,0,0,0.00,0
,20160603,2467,2467,,,,2467,2467,0,0,0,0.00,0
,20160606,2467,2467,,,,2467,2467,0,0,0,0.00,0
,20160607,2467,2467,,,,2467,2467,0,0,0,0.00,0
,20160608,2467,2467,,,,2467,2467,0,0,0,0.00,0
,20160613,2467,2467,,,,2467,2467,0,0,0,0.00,0
,20160614,2467,2467,,,,2467,2467,0,0,0,0.00,0
,20160615,2467,2467,,,,2467,2467,0,0,0,0.00,0
,20160616,2467,2467,,,,2467,2467,0,0,0,0.00,0
,20160617,2467,2467,,,,2467,2467,0,0,0,0.00,0
,20160620,2467,2467,,,,2467,2467,0,0,0,0.00,0
,20160621,2467,2467,,,,2467,2467,0,0,0,0.00,0
,20160622,2467,2467,,,,2467,2467,0,0,0,0.00,0
,20160623,2467,2467,,,,2467,2467,0,0,0,0.00,0
,20160624,2467,2467,,,,2467,2467,0,0,0,0.00,0
,20160627,2467,2467,,,,2467,2467,0,0,0,0.00,0
,20160628,2467,2467,,,,2467,2467,0,0,0,0.00,0
,20160629,2467,2467,,,,2467,2467,0,0,0,0.00,0
,20160630,2467,2467,,,,2478,2478,11,11,0,0.00,0
,20160701,2478,2478,,,,2478,2478,0,0,0,0.00,0
,20160704,2478,2478,,,,2478,2478,0,0,0,0.00,0
,20160705,2478,2478,,,,2478,2478,0,0,0,0.00,0
,20160706,2478,2478,,,,2478,2478,0,0,0,0.00,0
,20160707,2478,2478,,,,2478,2478,0,0,0,0.00,0
,20160708,2478,2478,,,,2478,2478,0,0,0,0.00,0
,20160711,2478,2478,,,,2478,2478,0,0,0,0.00,0
,20160712,2478,2478,,,,2478,2478,0,0,0,0.00,0
,20160713,2478,2478,,,,2478,2478,0,0,0,0.00,0
,20160714,2478,2478,,,,2478,2478,0,0,0,0.00,0
,20160715,2478,2478,,,,2478,2478,0,0,0,0.00,0
,20160718,2478,2478,,,,2478,2478,0,0,0,0.00,0
,20160719,2478,2478,,,,2478,2478,0,0,0,0.00,0
,20160720,2478,2478,,,,2478,2478,0,0,0,0.00,0
,20160721,2478,2478,,,,2478,2478,0,0,0,0.00,0
,20160722,2478,2478,,,,2478,2478,0,0,0,0.00,0
,20160725,2478,2478,,,,2478,2478,0,0,0,0.00,0
,20160726,2478,2478,,,,2478,2478,0,0,0,0.00,0
,20160727,2478,2478,,,,2478,2478,0,0,0,0.00,0
,20160728,2478,2478,,,,2478,2478,0,0,0,0.00,0
,20160729,2478,2478,,,,2478,2478,0,0,0,0.00,0
,20160801,2478,2478,,,,2478,2478,0,0,0,0.00,0
,20160802,2478,2478,,,,2478,2478,0,0,0,0.00,0
,20160803,2478,2478,,,,2478,2478,0,0,0,0.00,0
,20160804,2478,2478,,,,2478,2478,0,0,0,0.00,0
,20160805,2478,2478,,,,2478,2478,0,0,0,0.00,0
,20160808,2478,2478,,,,2478,2478,0,0,0,0.00,0
,20160809,2478,2478,,,,2478,2478,0,0,0,0.00,0
,20160810,2478,2478,,,,2478,2478,0,0,0,0.00,0
,20160811,2478,2478,,,,2478,2478,0,0,0,0.00,0
,20160812,2478,2478,,,,2478,2478,0,0,0,0.00,0
,20160815,2478,2478,,,,2478,2478,0,0,0,0.00,0
,20160816,2478,2478,,,,2478,2478,0,0,0,0.00,0
,20160817,2478,2478,,,,2478,2478,0,0,0,0.00,0
,20160818,2478,2478,,,,2478,2478,0,0,0,0.00,0
,20160819,2478,2478,,,,2478,2478,0,0,0,0.00,0
,20160822,2478,2478,,,,2478,2478,0,0,0,0.00,0
,20160823,2478,2478,,,,2478,2478,0,0,0,0.00,0
,20160824,2478,2478,,,,2478,2478,0,0,0,0.00,0
,20160825,2478,2478,,,,2478,2478,0,0,0,0.00,0
,20160826,2478,2478,,,,2478,2478,0,0,0,0.00,0
,20160829,2478,2478,,,,2478,2478,0,0,0,0.00,0
,20160830,2478,2478,,,,2478,2478,0,0,0,0.00,0
,20160831,2478,2478,,,,2478,2478,0,0,0,0.00,0
,20160901,2478,2478,,,,2478,2478,0,0,0,0.00,0
,20160902,2478,2478,,,,2478,2478,0,0,0,0.00,0
,20160905,2478,2478,,,,2478,2478,0,0,0,0.00,0
,20160906,2478,2478,,,,2478,2478,0,0,0,0.00,0
,20160907,2478,2478,,,,2478,2478,0,0,0,0.00,0
,20160908,2478,2478,,,,2478,2478,0,0,0,0.00,0
,20160909,2478,2478,,,,2478,2478,0,0,0,0.00,0
,20160912,2478,2478,,,,2478,2478,0,0,0,0.00,0
,20160913,2478,2478,,,,2478,2478,0,0,0,0.00,0
,20160914,2478,2478,,,,2478,2478,0,0,0,0.00,0
,20160919,2478,2478,,,,2478,2478,0,0,0,0.00,0
,20160920,2478,2478,,,,2478,2478,0,0,0,0.00,0
,20160921,2478,2478,,,,2478,2478,0,0,0,0.00,0
,20160922,2478,2478,,,,2478,2478,0,0,0,0.00,0
,20160923,2478,2478,,,,2478,2478,0,0,0,0.00,0
,20160926,2478,2478,,,,2499,2499,21,21,0,0.00,0
,20160927,2499,2499,,,,2499,2499,0,0,0,0.00,0
,20160928,2499,2499,,,,2499,2499,0,0,0,0.00,0
,20160929,2499,2499,,,,2512,2512,13,13,0,0.00,0
,20160930,2512,2512,,,,2512,2512,0,0,0,0.00,0
,20161010,2512,2512,,,,2512,2512,0,0,0,0.00,0
,20161011,2512,2512,,,,2512,2512,0,0,0,0.00,0
,20161012,2512,2512,,,,2512,2512,0,0,0,0.00,0
,20161013,2512,2512,,,,2512,2512,0,0,0,0.00,0
,20161014,2512,2512,,,,2512,2512,0,0,0,0.00,0
,20161017,2512,2512,,,,2512,2512,0,0,0,0.00,0
,20161018,2512,2512,,,,2512,2512,0,0,0,0.00,0
,20161019,2512,2512,,,,2512,2512,0,0,0,0.00,0
,20161020,2512,2512,,,,2512,2512,0,0,0,0.00,0
,20161021,2512,2512,,,,2512,2512,0,0,0,0.00,0
,20161024,2512,2512,,,,2512,2512,0,0,0,0.00,0
,20161025,2512,2512,,,,2512,2512,0,0,0,0.00,0
,20161026,2512,2512,,,,2512,2512,0,0,0,0.00,0
,20161027,2512,2512,,,,2512,2512,0,0,0,0.00,0
,20161028,2512,2512,2758,2758,2758,2758,2758,246,246,2,27.58,2
,20161031,2758,2758,,,,2758,2758,0,0,0,0.00,2
,20161101,2758,2758,2680,2895,2633,2723,2765,-35,7,10,138.26,2
,20161102,2723,2765,,,,2765,2765,0,0,0,0.00,2
,20161103,2765,2765,,,,2765,2765,0,0,0,0.00,2
,20161104,2765,2765,,,,2765,2765,0,0,0,0.00,2
,20161107,2765,2765,,,,2765,2765,0,0,0,0.00,2
,20161108,2765,2765,,,,2765,2765,0,0,0,0.00,2
,20161109,2765,2765,,,,2765,2765,0,0,0,0.00,2
,20161110,2765,2765,,,,2844,2844,79,79,0,0.00,2
,20161111,2844,2844,2986,2986,2986,2986,2986,142,142,2,29.86,2
,20161114,2986,2986,3135,3135,2836,2836,2985,-150,-1,4,59.71,2
,20161115,2836,2985,,,,2985,2985,0,0,0,0.00,2
,20161116,2985,2985,,,,2846,2846,-139,-139,0,0.00,2
,20161117,2846,2846,2750,2750,2750,2750,2750,-96,-96,2,27.50,2
,20161118,2750,2750,,,,2732,2732,-18,-18,0,0.00,2
,20161121,2732,2732,,,,2732,2732,0,0,0,0.00,2
,20161122,2732,2732,,,,2752,2752,20,20,0,0.00,2
,20161123,2752,2752,,,,2710,2710,-42,-42,0,0.00,2
,20161124,2710,2710,,,,2714,2714,4,4,0,0.00,2
,20161125,2714,2714,2661,2661,2661,2661,2661,-53,-53,2,26.61,2
,20161128,2661,2661,2680,2680,2680,2680,2680,19,19,2,26.80,2
,20161129,2680,2680,,,,2814,2814,134,134,0,0.00,2
,20161130,2814,2814,2750,2750,2750,2750,2750,-64,-64,2,27.50,2
,20161201,2750,2750,,,,2786,2786,36,36,0,0.00,2
,20161202,2786,2786,,,,2925,2925,139,139,0,0.00,2
,20161205,2925,2925,,,,3071,3071,146,146,0,0.00,2
,20161206,3071,3071,,,,3224,3224,153,153,0,0.00,2
,20161207,3224,3224,3063,3063,3063,3063,3063,-161,-161,2,30.63,2
,20161208,3063,3063,,,,3216,3216,153,153,0,0.00,2
,20161209,3216,3216,,,,3376,3376,160,160,0,0.00,2
,20161212,3376,3376,,,,3544,3544,168,168,0,0.00,2
,20161213,3544,3544,,,,3721,3721,177,177,0,0.00,2
,20161214,3721,3721,,,,3907,3907,186,186,0,0.00,2
,20161215,3907,3907,3711,3711,3711,3711,3711,-196,-196,2,37.11,0
,20161216,3711,3711,,,,3525,3525,-186,-186,0,0.00,0
,20161219,3525,3525,,,,3701,3701,176,176,0,0.00,0
,20161220,3701,3701,,,,3629,3629,-72,-72,0,0.00,0
,20161221,3629,3629,,,,3702,3702,73,73,0,0.00,0
,20161222,3702,3702,,,,3610,3610,-92,-92,0,0.00,0
,20161223,3610,3610,,,,3636,3636,26,26,0,0.00,0
,20161226,3636,3636,,,,3680,3680,44,44,0,0.00,0
,20161227,3680,3680,,,,3744,3744,64,64,0,0.00,0
,20161228,3744,3744,,,,3885,3885,141,141,0,0.00,0
,20161229,3885,3885,,,,3948,3948,63,63,0,0.00,0
,20161230,3948,3948,,,,3997,3997,49,49,0,0.00,0
fu1707,20160701,2478,2478,,,,2478,2478,0,0,0,0.00,0
,20160704,2478,2478,,,,2478,2478,0,0,0,0.00,0
,20160705,2478,2478,,,,2478,2478,0,0,0,0.00,0
,20160706,2478,2478,,,,2478,2478,0,0,0,0.00,0
,20160707,2478,2478,,,,2478,2478,0,0,0,0.00,0
,20160708,2478,2478,,,,2478,2478,0,0,0,0.00,0
,20160711,2478,2478,,,,2478,2478,0,0,0,0.00,0
,20160712,2478,2478,,,,2478,2478,0,0,0,0.00,0
,20160713,2478,2478,,,,2478,2478,0,0,0,0.00,0
,20160714,2478,2478,,,,2478,2478,0,0,0,0.00,0
,20160715,2478,2478,,,,2478,2478,0,0,0,0.00,0
,20160718,2478,2478,,,,2478,2478,0,0,0,0.00,0
,20160719,2478,2478,,,,2478,2478,0,0,0,0.00,0
,20160720,2478,2478,,,,2478,2478,0,0,0,0.00,0
,20160721,2478,2478,,,,2478,2478,0,0,0,0.00,0
,20160722,2478,2478,,,,2478,2478,0,0,0,0.00,0
,20160725,2478,2478,,,,2478,2478,0,0,0,0.00,0
,20160726,2478,2478,,,,2478,2478,0,0,0,0.00,0
,20160727,2478,2478,,,,2478,2478,0,0,0,0.00,0
,20160728,2478,2478,,,,2478,2478,0,0,0,0.00,0
,20160729,2478,2478,,,,2478,2478,0,0,0,0.00,0
,20160801,2478,2478,,,,2478,2478,0,0,0,0.00,0
,20160802,2478,2478,,,,2478,2478,0,0,0,0.00,0
,20160803,2478,2478,,,,2478,2478,0,0,0,0.00,0
,20160804,2478,2478,,,,2478,2478,0,0,0,0.00,0
,20160805,2478,2478,,,,2478,2478,0,0,0,0.00,0
,20160808,2478,2478,,,,2478,2478,0,0,0,0.00,0
,20160809,2478,2478,,,,2478,2478,0,0,0,0.00,0
,20160810,2478,2478,,,,2478,2478,0,0,0,0.00,0
,20160811,2478,2478,,,,2478,2478,0,0,0,0.00,0
,20160812,2478,2478,,,,2478,2478,0,0,0,0.00,0
,20160815,2478,2478,,,,2478,2478,0,0,0,0.00,0
,20160816,2478,2478,,,,2478,2478,0,0,0,0.00,0
,20160817,2478,2478,,,,2478,2478,0,0,0,0.00,0
,20160818,2478,2478,,,,2478,2478,0,0,0,0.00,0
,20160819,2478,2478,,,,2478,2478,0,0,0,0.00,0
,20160822,2478,2478,,,,2478,2478,0,0,0,0.00,0
,20160823,2478,2478,,,,2478,2478,0,0,0,0.00,0
,20160824,2478,2478,,,,2478,2478,0,0,0,0.00,0
,20160825,2478,2478,,,,2478,2478,0,0,0,0.00,0
,20160826,2478,2478,,,,2478,2478,0,0,0,0.00,0
,20160829,2478,2478,,,,2478,2478,0,0,0,0.00,0
,20160830,2478,2478,,,,2478,2478,0,0,0,0.00,0
,20160831,2478,2478,,,,2478,2478,0,0,0,0.00,0
,20160901,2478,2478,,,,2478,2478,0,0,0,0.00,0
,20160902,2478,2478,,,,2478,2478,0,0,0,0.00,0
,20160905,2478,2478,,,,2478,2478,0,0,0,0.00,0
,20160906,2478,2478,,,,2478,2478,0,0,0,0.00,0
,20160907,2478,2478,,,,2478,2478,0,0,0,0.00,0
,20160908,2478,2478,,,,2478,2478,0,0,0,0.00,0
,20160909,2478,2478,,,,2478,2478,0,0,0,0.00,0
,20160912,2478,2478,,,,2478,2478,0,0,0,0.00,0
,20160913,2478,2478,,,,2478,2478,0,0,0,0.00,0
,20160914,2478,2478,,,,2478,2478,0,0,0,0.00,0
,20160919,2478,2478,,,,2478,2478,0,0,0,0.00,0
,20160920,2478,2478,,,,2478,2478,0,0,0,0.00,0
,20160921,2478,2478,,,,2478,2478,0,0,0,0.00,0
,20160922,2478,2478,,,,2478,2478,0,0,0,0.00,0
,20160923,2478,2478,,,,2478,2478,0,0,0,0.00,0
,20160926,2478,2478,,,,2499,2499,21,21,0,0.00,0
,20160927,2499,2499,,,,2499,2499,0,0,0,0.00,0
,20160928,2499,2499,,,,2499,2499,0,0,0,0.00,0
,20160929,2499,2499,,,,2512,2512,13,13,0,0.00,0
,20160930,2512,2512,,,,2512,2512,0,0,0,0.00,0
,20161010,2512,2512,,,,2512,2512,0,0,0,0.00,0
,20161011,2512,2512,,,,2392,2392,-120,-120,0,0.00,0
,20161012,2392,2392,,,,2392,2392,0,0,0,0.00,0
,20161013,2392,2392,,,,2276,2276,-116,-116,0,0.00,0
,20161014,2276,2276,,,,2276,2276,0,0,0,0.00,0
,20161017,2276,2276,,,,2163,2163,-113,-113,0,0.00,0
,20161018,2163,2163,,,,2379,2379,216,216,0,0.00,0
,20161019,2379,2379,,,,2379,2379,0,0,0,0.00,0
,20161020,2379,2379,,,,2379,2379,0,0,0,0.00,0
,20161021,2379,2379,,,,2379,2379,0,0,0,0.00,0
,20161024,2379,2379,,,,2417,2417,38,38,0,0.00,0
,20161025,2417,2417,,,,2371,2371,-46,-46,0,0.00,0
,20161026,2371,2371,,,,2371,2371,0,0,0,0.00,0
,20161027,2371,2371,,,,2257,2257,-114,-114,0,0.00,0
,20161028,2257,2257,,,,2478,2478,221,221,0,0.00,0
,20161031,2478,2478,,,,2478,2478,0,0,0,0.00,0
,20161101,2478,2478,,,,2484,2484,6,6,0,0.00,0
,20161102,2484,2484,,,,2499,2499,15,15,0,0.00,0
,20161103,2499,2499,,,,2512,2512,13,13,0,0.00,0
,20161104,2512,2512,,,,2512,2512,0,0,0,0.00,0
,20161107,2512,2512,,,,2398,2398,-114,-114,0,0.00,0
,20161108,2398,2398,,,,2341,2341,-57,-57,0,0.00,0
,20161109,2341,2341,,,,2386,2386,45,45,0,0.00,0
,20161110,2386,2386,,,,2624,2624,238,238,0,0.00,0
,20161111,2624,2624,,,,2755,2755,131,131,0,0.00,0
,20161114,2755,2755,,,,2755,2755,0,0,0,0.00,0
,20161115,2755,2755,,,,2755,2755,0,0,0,0.00,0
,20161116,2755,2755,,,,2627,2627,-128,-128,0,0.00,0
,20161117,2627,2627,,,,2538,2538,-89,-89,0,0.00,0
,20161118,2538,2538,,,,2522,2522,-16,-16,0,0.00,0
,20161121,2522,2522,,,,2522,2522,0,0,0,0.00,0
,20161122,2522,2522,,,,2540,2540,18,18,0,0.00,0
,20161123,2540,2540,,,,2501,2501,-39,-39,0,0.00,0
,20161124,2501,2501,,,,2505,2505,4,4,0,0.00,0
,20161125,2505,2505,,,,2456,2456,-49,-49,0,0.00,0
,20161128,2456,2456,,,,2473,2473,17,17,0,0.00,0
,20161129,2473,2473,,,,2720,2720,247,247,0,0.00,0
,20161130,2720,2720,,,,2658,2658,-62,-62,0,0.00,0
,20161201,2658,2658,,,,2693,2693,35,35,0,0.00,0
,20161202,2693,2693,,,,2962,2962,269,269,0,0.00,0
,20161205,2962,2962,,,,3132,3132,170,170,0,0.00,0
,20161206,3132,3132,,,,3068,3068,-64,-64,0,0.00,0
,20161207,3068,3068,,,,2914,2914,-154,-154,0,0.00,0
,20161208,2914,2914,,,,3205,3205,291,291,0,0.00,0
,20161209,3205,3205,,,,3278,3278,73,73,0,0.00,0
,20161212,3278,3278,,,,3605,3605,327,327,0,0.00,0
,20161213,3605,3605,,,,3731,3731,126,126,0,0.00,0
,20161214,3731,3731,,,,3740,3740,9,9,0,0.00,0
,20161215,3740,3740,,,,3552,3552,-188,-188,0,0.00,0
,20161216,3552,3552,,,,3329,3329,-223,-223,0,0.00,0
,20161219,3329,3329,,,,3661,3661,332,332,0,0.00,0
,20161220,3661,3661,,,,3590,3590,-71,-71,0,0.00,0
,20161221,3590,3590,,,,3663,3663,73,73,0,0.00,0
,20161222,3663,3663,,,,3572,3572,-91,-91,0,0.00,0
,20161223,3572,3572,,,,3598,3598,26,26,0,0.00,0
,20161226,3598,3598,,,,3642,3642,44,44,0,0.00,0
,20161227,3642,3642,,,,3705,3705,63,63,0,0.00,0
,20161228,3705,3705,,,,3845,3845,140,140,0,0.00,0
,20161229,3845,3845,,,,3907,3907,62,62,0,0.00,0
,20161230,3907,3907,,,,3955,3955,48,48,0,0.00,0
fu1708,20160801,2478,2478,,,,2478,2478,0,0,0,0.00,0
,20160802,2478,2478,,,,2478,2478,0,0,0,0.00,0
,20160803,2478,2478,,,,2478,2478,0,0,0,0.00,0
,20160804,2478,2478,,,,2478,2478,0,0,0,0.00,0
,20160805,2478,2478,,,,2478,2478,0,0,0,0.00,0
,20160808,2478,2478,,,,2478,2478,0,0,0,0.00,0
,20160809,2478,2478,,,,2478,2478,0,0,0,0.00,0
,20160810,2478,2478,,,,2478,2478,0,0,0,0.00,0
,20160811,2478,2478,,,,2478,2478,0,0,0,0.00,0
,20160812,2478,2478,,,,2478,2478,0,0,0,0.00,0
,20160815,2478,2478,,,,2478,2478,0,0,0,0.00,0
,20160816,2478,2478,,,,2478,2478,0,0,0,0.00,0
,20160817,2478,2478,,,,2478,2478,0,0,0,0.00,0
,20160818,2478,2478,,,,2478,2478,0,0,0,0.00,0
,20160819,2478,2478,,,,2478,2478,0,0,0,0.00,0
,20160822,2478,2478,,,,2478,2478,0,0,0,0.00,0
,20160823,2478,2478,,,,2478,2478,0,0,0,0.00,0
,20160824,2478,2478,,,,2478,2478,0,0,0,0.00,0
,20160825,2478,2478,,,,2478,2478,0,0,0,0.00,0
,20160826,2478,2478,,,,2478,2478,0,0,0,0.00,0
,20160829,2478,2478,,,,2478,2478,0,0,0,0.00,0
,20160830,2478,2478,,,,2478,2478,0,0,0,0.00,0
,20160831,2478,2478,,,,2478,2478,0,0,0,0.00,0
,20160901,2478,2478,,,,2478,2478,0,0,0,0.00,0
,20160902,2478,2478,,,,2478,2478,0,0,0,0.00,0
,20160905,2478,2478,,,,2478,2478,0,0,0,0.00,0
,20160906,2478,2478,,,,2478,2478,0,0,0,0.00,0
,20160907,2478,2478,,,,2478,2478,0,0,0,0.00,0
,20160908,2478,2478,,,,2478,2478,0,0,0,0.00,0
,20160909,2478,2478,,,,2478,2478,0,0,0,0.00,0
,20160912,2478,2478,,,,2478,2478,0,0,0,0.00,0
,20160913,2478,2478,,,,2478,2478,0,0,0,0.00,0
,20160914,2478,2478,,,,2478,2478,0,0,0,0.00,0
,20160919,2478,2478,,,,2478,2478,0,0,0,0.00,0
,20160920,2478,2478,,,,2478,2478,0,0,0,0.00,0
,20160921,2478,2478,,,,2478,2478,0,0,0,0.00,0
,20160922,2478,2478,,,,2478,2478,0,0,0,0.00,0
,20160923,2478,2478,,,,2478,2478,0,0,0,0.00,0
,20160926,2478,2478,,,,2499,2499,21,21,0,0.00,0
,20160927,2499,2499,,,,2499,2499,0,0,0,0.00,0
,20160928,2499,2499,,,,2499,2499,0,0,0,0.00,0
,20160929,2499,2499,,,,2512,2512,13,13,0,0.00,0
,20160930,2512,2512,,,,2512,2512,0,0,0,0.00,0
,20161010,2512,2512,,,,2512,2512,0,0,0,0.00,0
,20161011,2512,2512,,,,2512,2512,0,0,0,0.00,0
,20161012,2512,2512,,,,2512,2512,0,0,0,0.00,0
,20161013,2512,2512,,,,2512,2512,0,0,0,0.00,0
,20161014,2512,2512,,,,2512,2512,0,0,0,0.00,0
,20161017,2512,2512,,,,2512,2512,0,0,0,0.00,0
,20161018,2512,2512,,,,2512,2512,0,0,0,0.00,0
,20161019,2512,2512,,,,2512,2512,0,0,0,0.00,0
,20161020,2512,2512,,,,2512,2512,0,0,0,0.00,0
,20161021,2512,2512,,,,2512,2512,0,0,0,0.00,0
,20161024,2512,2512,,,,2512,2512,0,0,0,0.00,0
,20161025,2512,2512,,,,2512,2512,0,0,0,0.00,0
,20161026,2512,2512,,,,2512,2512,0,0,0,0.00,0
,20161027,2512,2512,,,,2512,2512,0,0,0,0.00,0
,20161028,2512,2512,,,,2512,2512,0,0,0,0.00,0
,20161031,2512,2512,,,,2512,2512,0,0,0,0.00,0
,20161101,2512,2512,,,,2518,2518,6,6,0,0.00,0
,20161102,2518,2518,,,,2533,2533,15,15,0,0.00,0
,20161103,2533,2533,,,,2546,2546,13,13,0,0.00,0
,20161104,2546,2546,,,,2546,2546,0,0,0,0.00,0
,20161107,2546,2546,,,,2430,2430,-116,-116,0,0.00,0
,20161108,2430,2430,,,,2372,2372,-58,-58,0,0.00,0
,20161109,2372,2372,,,,2418,2418,46,46,0,0.00,0
,20161110,2418,2418,,,,2487,2487,69,69,0,0.00,0
,20161111,2487,2487,,,,2611,2611,124,124,0,0.00,0
,20161114,2611,2611,,,,2610,2610,-1,-1,0,0.00,0
,20161115,2610,2610,,,,2662,2662,52,52,0,0.00,0
,20161116,2662,2662,,,,2538,2538,-124,-124,0,0.00,0
,20161117,2538,2538,,,,2452,2452,-86,-86,0,0.00,0
,20161118,2452,2452,,,,2436,2436,-16,-16,0,0.00,0
,20161121,2436,2436,2216,2216,2216,2216,2216,-220,-220,2,22.16,2
,20161122,2216,2216,,,,2326,2326,110,110,0,0.00,2
,20161123,2326,2326,,,,2442,2442,116,116,0,0.00,2
,20161124,2442,2442,,,,2564,2564,122,122,0,0.00,2
,20161125,2564,2564,,,,2692,2692,128,128,0,0.00,2
,20161128,2692,2692,,,,2826,2826,134,134,0,0.00,2
,20161129,2826,2826,,,,2967,2967,141,141,0,0.00,2
,20161130,2967,2967,,,,2899,2899,-68,-68,0,0.00,2
,20161201,2899,2899,,,,3043,3043,144,144,0,0.00,2
,20161202,3043,3043,,,,3195,3195,152,152,0,0.00,2
,20161205,3195,3195,,,,3354,3354,159,159,0,0.00,2
,20161206,3354,3354,,,,3286,3286,-68,-68,0,0.00,2
,20161207,3286,3286,,,,3450,3450,164,164,0,0.00,2
,20161208,3450,3450,,,,3622,3622,172,172,0,0.00,2
,20161209,3622,3622,,,,3803,3803,181,181,0,0.00,2
,20161212,3803,3803,,,,3993,3993,190,190,0,0.00,2
,20161213,3993,3993,,,,4192,4192,199,199,0,0.00,2
,20161214,4192,4192,4401,4401,3984,3984,4192,-208,0,4,83.85,2
,20161215,3984,4192,3983,3983,3983,3983,3983,-209,-209,2,39.83,0
,20161216,3983,3983,,,,3783,3783,-200,-200,0,0.00,0
,20161219,3783,3783,,,,3840,3840,57,57,0,0.00,0
,20161220,3840,3840,,,,3765,3765,-75,-75,0,0.00,0
,20161221,3765,3765,,,,3841,3841,76,76,0,0.00,0
,20161222,3841,3841,,,,3745,3745,-96,-96,0,0.00,0
,20161223,3745,3745,,,,3772,3772,27,27,0,0.00,0
,20161226,3772,3772,,,,3818,3818,46,46,0,0.00,0
,20161227,3818,3818,,,,3884,3884,66,66,0,0.00,0
,20161228,3884,3884,,,,4031,4031,147,147,0,0.00,0
,20161229,4031,4031,,,,4096,4096,65,65,0,0.00,0
,20161230,4096,4096,,,,4147,4147,51,51,0,0.00,0
fu1709,20160901,2478,2478,,,,2478,2478,0,0,0,0.00,0
,20160902,2478,2478,,,,2478,2478,0,0,0,0.00,0
,20160905,2478,2478,,,,2478,2478,0,0,0,0.00,0
,20160906,2478,2478,,,,2478,2478,0,0,0,0.00,0
,20160907,2478,2478,,,,2478,2478,0,0,0,0.00,0
,20160908,2478,2478,,,,2478,2478,0,0,0,0.00,0
,20160909,2478,2478,,,,2478,2478,0,0,0,0.00,0
,20160912,2478,2478,,,,2478,2478,0,0,0,0.00,0
,20160913,2478,2478,,,,2478,2478,0,0,0,0.00,0
,20160914,2478,2478,,,,2478,2478,0,0,0,0.00,0
,20160919,2478,2478,,,,2478,2478,0,0,0,0.00,0
,20160920,2478,2478,,,,2478,2478,0,0,0,0.00,0
,20160921,2478,2478,,,,2478,2478,0,0,0,0.00,0
,20160922,2478,2478,,,,2478,2478,0,0,0,0.00,0
,20160923,2478,2478,,,,2478,2478,0,0,0,0.00,0
,20160926,2478,2478,,,,2499,2499,21,21,0,0.00,0
,20160927,2499,2499,,,,2499,2499,0,0,0,0.00,0
,20160928,2499,2499,,,,2499,2499,0,0,0,0.00,0
,20160929,2499,2499,,,,2512,2512,13,13,0,0.00,0
,20160930,2512,2512,,,,2512,2512,0,0,0,0.00,0
,20161010,2512,2512,,,,2512,2512,0,0,0,0.00,0
,20161011,2512,2512,,,,2512,2512,0,0,0,0.00,0
,20161012,2512,2512,,,,2512,2512,0,0,0,0.00,0
,20161013,2512,2512,,,,2512,2512,0,0,0,0.00,0
,20161014,2512,2512,,,,2512,2512,0,0,0,0.00,0
,20161017,2512,2512,,,,2512,2512,0,0,0,0.00,0
,20161018,2512,2512,,,,2512,2512,0,0,0,0.00,0
,20161019,2512,2512,,,,2512,2512,0,0,0,0.00,0
,20161020,2512,2512,,,,2512,2512,0,0,0,0.00,0
,20161021,2512,2512,,,,2512,2512,0,0,0,0.00,0
,20161024,2512,2512,,,,2512,2512,0,0,0,0.00,0
,20161025,2512,2512,,,,2512,2512,0,0,0,0.00,0
,20161026,2512,2512,,,,2512,2512,0,0,0,0.00,0
,20161027,2512,2512,,,,2512,2512,0,0,0,0.00,0
,20161028,2512,2512,,,,2512,2512,0,0,0,0.00,0
,20161031,2512,2512,,,,2512,2512,0,0,0,0.00,0
,20161101,2512,2512,,,,2518,2518,6,6,0,0.00,0
,20161102,2518,2518,,,,2533,2533,15,15,0,0.00,0
,20161103,2533,2533,,,,2546,2546,13,13,0,0.00,0
,20161104,2546,2546,,,,2546,2546,0,0,0,0.00,0
,20161107,2546,2546,,,,2430,2430,-116,-116,0,0.00,0
,20161108,2430,2430,,,,2372,2372,-58,-58,0,0.00,0
,20161109,2372,2372,,,,2609,2609,237,237,0,0.00,0
,20161110,2609,2609,,,,2684,2684,75,75,0,0.00,0
,20161111,2684,2684,,,,2684,2684,0,0,0,0.00,0
,20161114,2684,2684,,,,2683,2683,-1,-1,0,0.00,0
,20161115,2683,2683,,,,2737,2737,54,54,0,0.00,0
,20161116,2737,2737,,,,2610,2610,-127,-127,0,0.00,0
,20161117,2610,2610,,,,2521,2521,-89,-89,0,0.00,0
,20161118,2521,2521,,,,2505,2505,-16,-16,0,0.00,0
,20161121,2505,2505,,,,2278,2278,-227,-227,0,0.00,0
,20161122,2278,2278,,,,2505,2505,227,227,0,0.00,0
,20161123,2505,2505,,,,2466,2466,-39,-39,0,0.00,0
,20161124,2466,2466,,,,2470,2470,4,4,0,0.00,0
,20161125,2470,2470,,,,2421,2421,-49,-49,0,0.00,0
,20161128,2421,2421,,,,2438,2438,17,17,0,0.00,0
,20161129,2438,2438,,,,2681,2681,243,243,0,0.00,0
,20161130,2681,2681,,,,2620,2620,-61,-61,0,0.00,0
,20161201,2620,2620,,,,2882,2882,262,262,0,0.00,0
,20161202,2882,2882,,,,2739,2739,-143,-143,0,0.00,0
,20161205,2739,2739,,,,2896,2896,157,157,0,0.00,0
,20161206,2896,2896,,,,2837,2837,-59,-59,0,0.00,0
,20161207,2837,2837,,,,2695,2695,-142,-142,0,0.00,0
,20161208,2695,2695,,,,2964,2964,269,269,0,0.00,0
,20161209,2964,2964,,,,3032,3032,68,68,0,0.00,0
,20161212,3032,3032,,,,3335,3335,303,303,0,0.00,0
,20161213,3335,3335,,,,3668,3668,333,333,0,0.00,0
,20161214,3668,3668,,,,3668,3668,0,0,0,0.00,0
,20161215,3668,3668,,,,3485,3485,-183,-183,0,0.00,0
,20161216,3485,3485,,,,3266,3266,-219,-219,0,0.00,0
,20161219,3266,3266,,,,3592,3592,326,326,0,0.00,0
,20161220,3592,3592,,,,3522,3522,-70,-70,0,0.00,0
,20161221,3522,3522,,,,3593,3593,71,71,0,0.00,0
,20161222,3593,3593,,,,3504,3504,-89,-89,0,0.00,0
,20161223,3504,3504,,,,3530,3530,26,26,0,0.00,0
,20161226,3530,3530,,,,3573,3573,43,43,0,0.00,0
,20161227,3573,3573,,,,3635,3635,62,62,0,0.00,0
,20161228,3635,3635,,,,3772,3772,137,137,0,0.00,0
,20161229,3772,3772,,,,3833,3833,61,61,0,0.00,0
,20161230,3833,3833,,,,3880,3880,47,47,0,0.00,0
fu1710,20161010,2512,2512,,,,2512,2512,0,0,0,0.00,0
,20161011,2512,2512,,,,2512,2512,0,0,0,0.00,0
,20161012,2512,2512,,,,2512,2512,0,0,0,0.00,0
,20161013,2512,2512,,,,2512,2512,0,0,0,0.00,0
,20161014,2512,2512,,,,2512,2512,0,0,0,0.00,0
,20161017,2512,2512,,,,2512,2512,0,0,0,0.00,0
,20161018,2512,2512,,,,2512,2512,0,0,0,0.00,0
,20161019,2512,2512,,,,2512,2512,0,0,0,0.00,0
,20161020,2512,2512,,,,2512,2512,0,0,0,0.00,0
,20161021,2512,2512,,,,2512,2512,0,0,0,0.00,0
,20161024,2512,2512,,,,2512,2512,0,0,0,0.00,0
,20161025,2512,2512,,,,2512,2512,0,0,0,0.00,0
,20161026,2512,2512,,,,2512,2512,0,0,0,0.00,0
,20161027,2512,2512,,,,2512,2512,0,0,0,0.00,0
,20161028,2512,2512,,,,2512,2512,0,0,0,0.00,0
,20161031,2512,2512,,,,2512,2512,0,0,0,0.00,0
,20161101,2512,2512,,,,2518,2518,6,6,0,0.00,0
,20161102,2518,2518,,,,2533,2533,15,15,0,0.00,0
,20161103,2533,2533,,,,2546,2546,13,13,0,0.00,0
,20161104,2546,2546,,,,2546,2546,0,0,0,0.00,0
,20161107,2546,2546,,,,2430,2430,-116,-116,0,0.00,0
,20161108,2430,2430,,,,2372,2372,-58,-58,0,0.00,0
,20161109,2372,2372,,,,2609,2609,237,237,0,0.00,0
,20161110,2609,2609,,,,2684,2684,75,75,0,0.00,0
,20161111,2684,2684,,,,2818,2818,134,134,0,0.00,0
,20161114,2818,2818,,,,2818,2818,0,0,0,0.00,0
,20161115,2818,2818,,,,2818,2818,0,0,0,0.00,0
,20161116,2818,2818,,,,2818,2818,0,0,0,0.00,0
,20161117,2818,2818,,,,2818,2818,0,0,0,0.00,0
,20161118,2818,2818,,,,2818,2818,0,0,0,0.00,0
,20161121,2818,2818,,,,2818,2818,0,0,0,0.00,0
,20161122,2818,2818,,,,2839,2839,21,21,0,0.00,0
,20161123,2839,2839,,,,2839,2839,0,0,0,0.00,0
,20161124,2839,2839,,,,2839,2839,0,0,0,0.00,0
,20161125,2839,2839,,,,2839,2839,0,0,0,0.00,0
,20161128,2839,2839,,,,2859,2859,20,20,0,0.00,0
,20161129,2859,2859,,,,2936,2936,77,77,0,0.00,0
,20161130,2936,2936,,,,2869,2869,-67,-67,0,0.00,0
,20161201,2869,2869,,,,2906,2906,37,37,0,0.00,0
,20161202,2906,2906,,,,2761,2761,-145,-145,0,0.00,0
,20161205,2761,2761,,,,2919,2919,158,158,0,0.00,0
,20161206,2919,2919,,,,2860,2860,-59,-59,0,0.00,0
,20161207,2860,2860,,,,2717,2717,-143,-143,0,0.00,0
,20161208,2717,2717,,,,2988,2988,271,271,0,0.00,0
,20161209,2988,2988,,,,3056,3056,68,68,0,0.00,0
,20161212,3056,3056,,,,3361,3361,305,305,0,0.00,0
,20161213,3361,3361,,,,3697,3697,336,336,0,0.00,0
,20161214,3697,3697,,,,3697,3697,0,0,0,0.00,0
,20161215,3697,3697,,,,3512,3512,-185,-185,0,0.00,0
,20161216,3512,3512,,,,3291,3291,-221,-221,0,0.00,0
,20161219,3291,3291,,,,3620,3620,329,329,0,0.00,0
,20161220,3620,3620,,,,3549,3549,-71,-71,0,0.00,0
,20161221,3549,3549,,,,3621,3621,72,72,0,0.00,0
,20161222,3621,3621,,,,3531,3531,-90,-90,0,0.00,0
,20161223,3531,3531,,,,3557,3557,26,26,0,0.00,0
,20161226,3557,3557,,,,3600,3600,43,43,0,0.00,0
,20161227,3600,3600,,,,3662,3662,62,62,0,0.00,0
,20161228,3662,3662,,,,3800,3800,138,138,0,0.00,0
,20161229,3800,3800,,,,3862,3862,62,62,0,0.00,0
,20161230,3862,3862,,,,3910,3910,48,48,0,0.00,0
fu1711,20161101,2512,2512,,,,2518,2518,6,6,0,0.00,0
,20161102,2518,2518,,,,2533,2533,15,15,0,0.00,0
,20161103,2533,2533,,,,2546,2546,13,13,0,0.00,0
,20161104,2546,2546,,,,2546,2546,0,0,0,0.00,0
,20161107,2546,2546,,,,2430,2430,-116,-116,0,0.00,0
,20161108,2430,2430,,,,2372,2372,-58,-58,0,0.00,0
,20161109,2372,2372,,,,2609,2609,237,237,0,0.00,0
,20161110,2609,2609,,,,2684,2684,75,75,0,0.00,0
,20161111,2684,2684,,,,2818,2818,134,134,0,0.00,0
,20161114,2818,2818,,,,2818,2818,0,0,0,0.00,0
,20161115,2818,2818,,,,2818,2818,0,0,0,0.00,0
,20161116,2818,2818,,,,2818,2818,0,0,0,0.00,0
,20161117,2818,2818,,,,2818,2818,0,0,0,0.00,0
,20161118,2818,2818,3099,3099,2762,2762,2932,-56,114,8,117.30,4
,20161121,2762,2932,,,,2785,2785,-147,-147,0,0.00,4
,20161122,2785,2785,,,,2805,2805,20,20,0,0.00,4
,20161123,2805,2805,,,,2762,2762,-43,-43,0,0.00,4
,20161124,2762,2762,,,,2766,2766,4,4,0,0.00,4
,20161125,2766,2766,,,,2711,2711,-55,-55,0,0.00,4
,20161128,2711,2711,,,,2730,2730,19,19,0,0.00,4
,20161129,2730,2730,,,,2804,2804,74,74,0,0.00,4
,20161130,2804,2804,,,,2740,2740,-64,-64,0,0.00,4
,20161201,2740,2740,,,,2776,2776,36,36,0,0.00,4
,20161202,2776,2776,,,,2914,2914,138,138,0,0.00,4
,20161205,2914,2914,,,,3059,3059,145,145,0,0.00,4
,20161206,3059,3059,,,,3211,3211,152,152,0,0.00,4
,20161207,3211,3211,,,,3050,3050,-161,-161,0,0.00,4
,20161208,3050,3050,3171,3171,3171,3171,3171,121,121,2,31.71,4
,20161209,3171,3171,,,,3329,3329,158,158,0,0.00,4
,20161212,3329,3329,,,,3495,3495,166,166,0,0.00,4
,20161213,3495,3495,3636,3636,3323,3323,3479,-172,-16,4,69.59,6
,20161214,3323,3479,,,,3652,3652,173,173,0,0.00,6
,20161215,3652,3652,3710,3710,3710,3710,3710,58,58,2,37.10,6
,20161216,3710,3710,3895,3895,3895,3895,3895,185,185,2,38.95,6
,20161219,3895,3895,,,,3895,3895,0,0,0,0.00,6
,20161220,3895,3895,,,,3819,3819,-76,-76,0,0.00,6
,20161221,3819,3819,,,,3819,3819,0,0,0,0.00,6
,20161222,3819,3819,,,,3819,3819,0,0,0,0.00,6
,20161223,3819,3819,,,,3819,3819,0,0,0,0.00,6
,20161226,3819,3819,,,,3819,3819,0,0,0,0.00,6
,20161227,3819,3819,,,,3819,3819,0,0,0,0.00,6
,20161228,3819,3819,4009,4009,4009,4009,4009,190,190,2,40.09,6
,20161229,4009,4009,,,,4009,4009,0,0,0,0.00,6
,20161230,4009,4009,,,,4009,4009,0,0,0,0.00,6
fu1712,20161201,2740,2740,,,,2776,2776,36,36,0,0.00,0
,20161202,2776,2776,,,,2638,2638,-138,-138,0,0.00,0
,20161205,2638,2638,,,,2901,2901,263,263,0,0.00,0
,20161206,2901,2901,,,,2842,2842,-59,-59,0,0.00,0
,20161207,2842,2842,,,,2700,2700,-142,-142,0,0.00,0
,20161208,2700,2700,,,,2970,2970,270,270,0,0.00,0
,20161209,2970,2970,,,,3038,3038,68,68,0,0.00,0
,20161212,3038,3038,,,,3341,3341,303,303,0,0.00,0
,20161213,3341,3341,,,,3675,3675,334,334,0,0.00,0
,20161214,3675,3675,,,,3675,3675,0,0,0,0.00,0
,20161215,3675,3675,,,,3733,3733,58,58,0,0.00,0
,20161216,3733,3733,,,,3919,3919,186,186,0,0.00,0
,20161219,3919,3919,,,,3919,3919,0,0,0,0.00,0
,20161220,3919,3919,,,,3919,3919,0,0,0,0.00,0
,20161221,3919,3919,,,,3919,3919,0,0,0,0.00,0
,20161222,3919,3919,,,,3919,3919,0,0,0,0.00,0
,20161223,3919,3919,,,,3919,3919,0,0,0,0.00,0
,20161226,3919,3919,,,,3919,3919,0,0,0,0.00,0
,20161227,3919,3919,,,,3919,3919,0,0,0,0.00,0
,20161228,3919,3919,,,,4113,4113,194,194,0,0.00,0
,20161229,4113,4113,,,,4113,4113,0,0,0,0.00,0
,20161230,4113,4113,,,,4164,4164,51,51,0,0.00,0
hc1601,20160104,2060,2044,2060,2060,2048,2048,2049,4,5,66,135.24,960
,20160105,2048,2049,,,,2049,2049,0,0,0,0.00,960
,20160106,2049,2049,,,,2049,2049,0,0,0,0.00,960
,20160107,2049,2049,,,,2049,2049,0,0,0,0.00,960
,20160108,2049,2049,,,,2049,2049,0,0,0,0.00,960
,20160111,2049,2049,1999,1999,1999,1999,1999,-50,-50,600,"1,199.40",960
,20160112,1999,1999,,,,1999,1999,0,0,0,0.00,960
,20160113,1999,1999,,,,1999,1999,0,0,0,0.00,960
,20160114,1999,1999,,,,1999,1999,0,0,0,0.00,960
,20160115,1999,1999,,,,1999,1999,0,0,0,0.00,960
hc1602,20160104,1988,1988,,,,1992,1992,4,4,0,0.00,0
,20160105,1992,1992,,,,1992,1992,0,0,0,0.00,0
,20160106,1992,1992,,,,1992,1992,0,0,0,0.00,0
,20160107,1992,1992,,,,1992,1992,0,0,0,0.00,0
,20160108,1992,1992,,,,1992,1992,0,0,0,0.00,0
,20160111,1992,1992,,,,1943,1943,-49,-49,0,0.00,0
,20160112,1943,1943,,,,1943,1943,0,0,0,0.00,0
,20160113,1943,1943,,,,1943,1943,0,0,0,0.00,0
,20160114,1943,1943,,,,1943,1943,0,0,0,0.00,0
,20160115,1943,1943,,,,1943,1943,0,0,0,0.00,0
,20160118,1943,1943,,,,1943,1943,0,0,0,0.00,0
,20160119,1943,1943,,,,1943,1943,0,0,0,0.00,0
,20160120,1943,1943,,,,1943,1943,0,0,0,0.00,0
,20160121,1943,1943,,,,1943,1943,0,0,0,0.00,0
,20160122,1943,1943,,,,1943,1943,0,0,0,0.00,0
,20160125,1943,1943,,,,1943,1943,0,0,0,0.00,0
,20160126,1943,1943,,,,1943,1943,0,0,0,0.00,0
,20160127,1943,1943,,,,1943,1943,0,0,0,0.00,0
,20160128,1943,1943,,,,1943,1943,0,0,0,0.00,0
,20160129,1943,1943,,,,1943,1943,0,0,0,0.00,0
,20160201,1943,1943,,,,1943,1943,0,0,0,0.00,0
,20160202,1943,1943,,,,1943,1943,0,0,0,0.00,0
,20160203,1943,1943,,,,1943,1943,0,0,0,0.00,0
,20160204,1943,1943,,,,1943,1943,0,0,0,0.00,0
,20160205,1943,1943,,,,1943,1943,0,0,0,0.00,0
,20160215,1943,1943,,,,1943,1943,0,0,0,0.00,0
hc1603,20160104,1975,1975,,,,1975,1975,0,0,0,0.00,0
,20160105,1975,1975,,,,1975,1975,0,0,0,0.00,0
,20160106,1975,1975,,,,1975,1975,0,0,0,0.00,0
,20160107,1975,1975,,,,1975,1975,0,0,0,0.00,0
,20160108,1975,1975,,,,1975,1975,0,0,0,0.00,0
,20160111,1975,1975,1900,2036,1881,1881,1939,-94,-36,6,11.63,0
,20160112,1881,1939,,,,1939,1939,0,0,0,0.00,0
,20160113,1939,1939,,,,1939,1939,0,0,0,0.00,0
,20160114,1939,1939,,,,1939,1939,0,0,0,0.00,0
,20160115,1939,1939,,,,1939,1939,0,0,0,0.00,0
,20160118,1939,1939,,,,1939,1939,0,0,0,0.00,0
,20160119,1939,1939,,,,1939,1939,0,0,0,0.00,0
,20160120,1939,1939,,,,1939,1939,0,0,0,0.00,0
,20160121,1939,1939,,,,1939,1939,0,0,0,0.00,0
,20160122,1939,1939,,,,1939,1939,0,0,0,0.00,0
,20160125,1939,1939,,,,1939,1939,0,0,0,0.00,0
,20160126,1939,1939,,,,1939,1939,0,0,0,0.00,0
,20160127,1939,1939,,,,1939,1939,0,0,0,0.00,0
,20160128,1939,1939,1850,1936,1850,1936,1882,-3,-57,14,26.35,0
,20160129,1936,1882,,,,1882,1882,0,0,0,0.00,0
,20160201,1882,1882,,,,1882,1882,0,0,0,0.00,0
,20160202,1882,1882,,,,1882,1882,0,0,0,0.00,0
,20160203,1882,1882,,,,1882,1882,0,0,0,0.00,0
,20160204,1882,1882,,,,1882,1882,0,0,0,0.00,0
,20160205,1882,1882,,,,1882,1882,0,0,0,0.00,0
,20160215,1882,1882,,,,1882,1882,0,0,0,0.00,0
,20160216,1882,1882,,,,1882,1882,0,0,0,0.00,0
,20160217,1882,1882,,,,1882,1882,0,0,0,0.00,0
,20160218,1882,1882,,,,1882,1882,0,0,0,0.00,0
,20160219,1882,1882,,,,1882,1882,0,0,0,0.00,0
,20160222,1882,1882,,,,1882,1882,0,0,0,0.00,0
,20160223,1882,1882,,,,1882,1882,0,0,0,0.00,0
,20160224,1882,1882,,,,1882,1882,0,0,0,0.00,0
,20160225,1882,1882,,,,1882,1882,0,0,0,0.00,0
,20160226,1882,1882,,,,1882,1882,0,0,0,0.00,0
,20160229,1882,1882,1882,1976,1882,1976,1929,94,47,4,7.72,0
,20160301,1976,1929,,,,1929,1929,0,0,0,0.00,0
,20160302,1929,1929,,,,1929,1929,0,0,0,0.00,0
,20160303,1929,1929,,,,1929,1929,0,0,0,0.00,0
,20160304,1929,1929,,,,1929,1929,0,0,0,0.00,0
,20160307,1929,1929,,,,1929,1929,0,0,0,0.00,0
,20160308,1929,1929,,,,1929,1929,0,0,0,0.00,0
,20160309,1929,1929,,,,1929,1929,0,0,0,0.00,0
,20160310,1929,1929,,,,1929,1929,0,0,0,0.00,0
,20160311,1929,1929,,,,1929,1929,0,0,0,0.00,0
,20160314,1929,1929,,,,1929,1929,0,0,0,0.00,0
,20160315,1929,1929,,,,1929,1929,0,0,0,0.00,0
hc1604,20160104,1973,1973,,,,1977,1977,4,4,0,0.00,0
,20160105,1977,1977,,,,1977,1977,0,0,0,0.00,0
,20160106,1977,1977,,,,1977,1977,0,0,0,0.00,0
,20160107,1977,1977,,,,1977,1977,0,0,0,0.00,0
,20160108,1977,1977,,,,1977,1977,0,0,0,0.00,0
,20160111,1977,1977,,,,1940,1940,-37,-37,0,0.00,0
,20160112,1940,1940,,,,1940,1940,0,0,0,0.00,0
,20160113,1940,1940,,,,1940,1940,0,0,0,0.00,0
,20160114,1940,1940,,,,1940,1940,0,0,0,0.00,0
,20160115,1940,1940,,,,1940,1940,0,0,0,0.00,0
,20160118,1940,1940,,,,1940,1940,0,0,0,0.00,0
,20160119,1940,1940,,,,1940,1940,0,0,0,0.00,0
,20160120,1940,1940,,,,1940,1940,0,0,0,0.00,0
,20160121,1940,1940,,,,1940,1940,0,0,0,0.00,0
,20160122,1940,1940,2008,2008,2008,2008,2008,68,68,2,4.02,2
,20160125,2008,2008,,,,2008,2008,0,0,0,0.00,2
,20160126,2008,2008,1908,2006,1908,2006,1957,-2,-51,4,7.83,2
,20160127,2006,1957,2027,2027,1905,1950,1960,-7,3,6,11.76,2
,20160128,1950,1960,,,,1902,1902,-58,-58,0,0.00,2
,20160129,1902,1902,1852,1905,1852,1905,1878,3,-24,4,7.51,0
,20160201,1905,1878,,,,1878,1878,0,0,0,0.00,0
,20160202,1878,1878,,,,1878,1878,0,0,0,0.00,0
,20160203,1878,1878,,,,1878,1878,0,0,0,0.00,0
,20160204,1878,1878,,,,1878,1878,0,0,0,0.00,0
,20160205,1878,1878,,,,1878,1878,0,0,0,0.00,0
,20160215,1878,1878,,,,1878,1878,0,0,0,0.00,0
,20160216,1878,1878,,,,1878,1878,0,0,0,0.00,0
,20160217,1878,1878,,,,1878,1878,0,0,0,0.00,0
,20160218,1878,1878,,,,1878,1878,0,0,0,0.00,0
,20160219,1878,1878,,,,1878,1878,0,0,0,0.00,0
,20160222,1878,1878,,,,1878,1878,0,0,0,0.00,0
,20160223,1878,1878,,,,1878,1878,0,0,0,0.00,0
,20160224,1878,1878,,,,1878,1878,0,0,0,0.00,0
,20160225,1878,1878,,,,1971,1971,93,93,0,0.00,0
,20160226,1971,1971,,,,1971,1971,0,0,0,0.00,0
,20160229,1971,1971,,,,2020,2020,49,49,0,0.00,0
,20160301,2020,2020,,,,2020,2020,0,0,0,0.00,0
,20160302,2020,2020,,,,2020,2020,0,0,0,0.00,0
,20160303,2020,2020,,,,2020,2020,0,0,0,0.00,0
,20160304,2020,2020,,,,2020,2020,0,0,0,0.00,0
,20160307,2020,2020,,,,2020,2020,0,0,0,0.00,0
,20160308,2020,2020,,,,2020,2020,0,0,0,0.00,0
,20160309,2020,2020,2020,2121,2020,2120,2063,100,43,24,49.53,14
,20160310,2120,2063,2157,2160,2157,2160,2158,97,95,4,8.63,12
,20160311,2160,2158,2160,2160,2160,2160,2160,2,2,12,25.92,0
,20160314,2160,2160,,,,2160,2160,0,0,0,0.00,0
,20160315,2160,2160,,,,2160,2160,0,0,0,0.00,0
,20160316,2160,2160,,,,2160,2160,0,0,0,0.00,0
,20160317,2160,2160,,,,2160,2160,0,0,0,0.00,0
,20160318,2160,2160,,,,2160,2160,0,0,0,0.00,0
,20160321,2160,2160,,,,2160,2160,0,0,0,0.00,0
,20160322,2160,2160,,,,2160,2160,0,0,0,0.00,0
,20160323,2160,2160,,,,2160,2160,0,0,0,0.00,0
,20160324,2160,2160,,,,2160,2160,0,0,0,0.00,0
,20160325,2160,2160,2150,2268,2148,2268,2208,108,48,18,39.75,6
,20160328,2268,2208,2384,2384,2384,2384,2384,176,176,8,19.07,0
,20160329,2384,2384,,,,2384,2384,0,0,0,0.00,0
,20160330,2384,2384,,,,2384,2384,0,0,0,0.00,0
,20160331,2384,2384,,,,2384,2384,0,0,0,0.00,0
,20160401,2384,2384,,,,2384,2384,0,0,0,0.00,0
,20160405,2384,2384,,,,2384,2384,0,0,0,0.00,0
,20160406,2384,2384,,,,2384,2384,0,0,0,0.00,0
,20160407,2384,2384,,,,2384,2384,0,0,0,0.00,0
,20160408,2384,2384,,,,2384,2384,0,0,0,0.00,0
,20160411,2384,2384,,,,2384,2384,0,0,0,0.00,0
,20160412,2384,2384,,,,2384,2384,0,0,0,0.00,0
,20160413,2384,2384,,,,2384,2384,0,0,0,0.00,0
,20160414,2384,2384,,,,2384,2384,0,0,0,0.00,0
,20160415,2384,2384,,,,2384,2384,0,0,0,0.00,0
hc1605,20160104,1949,1949,1980,2000,1924,1929,1949,-20,0,51510,"100,435.14",96892
,20160105,1929,1949,1931,1959,1913,1958,1938,9,-11,80708,"156,489.43",101900
,20160106,1958,1938,1958,1960,1930,1935,1942,-3,4,72220,"140,305.51",106728
,20160107,1935,1942,1924,1945,1902,1924,1926,-18,-16,69686,"134,225.82",103416
,20160108,1924,1926,1910,1920,1876,1881,1896,-45,-30,92350,"175,109.40",102436
,20160111,1881,1896,1880,1889,1865,1877,1878,-19,-18,71196,"133,724.93",105040
,20160112,1877,1878,1874,1881,1854,1857,1865,-21,-13,61630,"114,971.85",112408
,20160113,1857,1865,1857,1874,1850,1857,1859,-8,-6,52738,"98,057.85",113248
,20160114,1857,1859,1856,1887,1852,1881,1868,22,9,74838,"139,811.63",125728
,20160115,1881,1868,1880,1911,1875,1898,1899,30,31,101724,"193,259.21",127776
,20160118,1898,1899,1896,1948,1889,1937,1926,38,27,133370,"256,953.83",131710
,20160119,1937,1926,1942,1955,1933,1949,1942,23,16,78206,"151,917.40",139254
,20160120,1949,1942,1950,1952,1921,1929,1934,-13,-8,80174,"155,120.22",140470
,20160121,1929,1934,1932,1936,1916,1923,1925,-11,-9,58738,"113,078.17",145614
,20160122,1923,1925,1923,1960,1922,1934,1941,9,16,93130,"180,794.79",154792
,20160125,1934,1941,1938,1957,1930,1938,1945,-3,4,74648,"145,232.00",157732
,20160126,1938,1945,1941,1947,1931,1945,1938,0,-7,49296,"95,571.02",158764
,20160127,1945,1938,1949,1966,1935,1945,1948,7,10,77464,"150,905.31",172696
,20160128,1945,1948,1946,1946,1895,1898,1920,-50,-28,140860,"270,586.68",183174
,20160129,1898,1920,1895,1919,1890,1909,1907,-11,-13,85502,"163,114.53",180062
,20160201,1909,1907,1911,1945,1910,1924,1929,17,22,90538,"174,688.60",186670
,20160202,1924,1929,1927,1934,1912,1918,1920,-11,-9,71984,"138,230.25",189932
,20160203,1918,1920,1919,1935,1911,1923,1922,3,2,73464,"141,202.52",194138
,20160204,1923,1922,1924,1965,1922,1964,1942,42,20,82444,"160,152.50",196248
,20160205,1964,1942,1963,1972,1927,1944,1946,2,4,52174,"101,579.31",195606
,20160215,1944,1946,1946,1971,1932,1956,1958,10,12,39426,"77,224.87",202266
,20160216,1956,1958,1955,1986,1955,1969,1969,11,11,69362,"136,589.14",212284
,20160217,1969,1969,1965,1975,1955,1961,1964,-8,-5,53598,"105,291.69",212702
,20160218,1961,1964,1964,1978,1957,1975,1968,11,4,53038,"104,400.54",215850
,20160219,1975,1968,1976,1999,1970,1992,1984,24,16,83832,"166,376.77",217452
,20160222,1992,1984,1992,2083,1990,2083,2036,99,52,181082,"368,824.69",218462
,20160223,2083,2036,2080,2100,2047,2058,2072,22,36,188830,"391,374.49",220036
,20160224,2058,2072,2058,2064,2039,2063,2052,-9,-20,110660,"227,102.93",225550
,20160225,2063,2052,2063,2082,2045,2053,2065,1,13,124932,"258,060.58",223186
,20160226,2053,2065,2060,2069,2029,2059,2045,-6,-20,121614,"248,797.78",221482
,20160229,2059,2045,2056,2089,2044,2089,2065,44,20,156600,"323,492.60",224294
,20160301,2089,2065,2090,2127,2078,2109,2097,44,32,158854,"333,154.20",228190
,20160302,2109,2097,2114,2123,2087,2110,2106,13,9,135396,"285,255.69",230744
,20160303,2110,2106,2110,2140,2110,2127,2126,21,20,165558,"351,994.49",199484
,20160304,2127,2126,2122,2175,2119,2174,2149,48,23,216552,"465,475.80",199580
,20160307,2174,2149,2172,2256,2172,2256,2213,107,64,108544,"240,273.96",186520
,20160308,2256,2213,2390,2390,2249,2390,2344,177,131,314062,"736,274.33",144152
,20160309,2390,2344,2370,2377,2171,2218,2240,-126,-104,438188,"981,748.19",144356
,20160310,2218,2240,2230,2352,2220,2269,2288,29,48,456430,"1,044,351.23",163828
,20160311,2269,2288,2268,2290,2230,2235,2256,-53,-32,205586,"463,984.73",151078
,20160314,2235,2256,2190,2308,2184,2200,2241,-56,-15,233100,"522,491.41",146250
,20160315,2200,2241,2195,2218,2145,2160,2183,-81,-58,255194,"557,179.48",160750
,20160316,2160,2183,2156,2185,2150,2181,2169,-2,-14,155088,"336,484.65",163578
,20160317,2181,2169,2190,2268,2183,2263,2232,94,63,255534,"570,489.39",144962
,20160318,2263,2232,2263,2343,2263,2322,2309,90,77,307508,"710,099.66",140490
,20160321,2322,2309,2325,2410,2304,2359,2348,50,39,333186,"782,394.99",146484
,20160322,2359,2348,2369,2385,2348,2357,2364,9,16,174724,"413,193.24",145286
,20160323,2357,2364,2355,2428,2340,2401,2393,37,29,242140,"579,458.64",144338
,20160324,2401,2393,2403,2411,2308,2327,2354,-66,-39,315896,"743,685.85",134336
,20160325,2327,2354,2323,2410,2321,2410,2363,56,9,239726,"566,665.16",132500
,20160328,2410,2363,2412,2440,2342,2346,2405,-17,42,283614,"682,102.77",122912
,20160329,2346,2405,2359,2392,2352,2376,2370,-29,-35,244942,"580,594.37",119930
,20160330,2376,2370,2370,2386,2331,2343,2352,-27,-18,226506,"532,910.27",116374
,20160331,2343,2352,2348,2389,2338,2389,2359,37,7,176470,"416,374.46",114976
,20160401,2389,2359,2385,2493,2385,2483,2433,124,74,296916,"722,477.27",125028
,20160405,2483,2433,2500,2540,2452,2530,2503,97,70,234958,"588,252.24",137476
,20160406,2530,2503,2530,2558,2496,2505,2520,2,17,291954,"735,945.28",129538
,20160407,2505,2520,2506,2560,2498,2546,2521,26,1,214626,"541,213.28",138700
,20160408,2546,2521,2532,2587,2530,2574,2566,53,45,366056,"939,445.66",156506
,20160411,2574,2566,2581,2714,2580,2681,2641,115,75,357690,"944,834.52",123258
,20160412,2681,2641,2680,2720,2660,2719,2686,78,45,218380,"586,629.81",103970
,20160413,2719,2686,2716,2724,2634,2662,2674,-24,-12,270218,"722,760.65",53020
,20160414,2662,2674,2657,2695,2642,2659,2673,-15,-1,75970,"203,130.65",43110
,20160415,2659,2673,2662,2675,2625,2627,2648,-46,-25,51222,"135,657.62",38316
,20160418,2627,2648,2628,2762,2613,2749,2689,101,41,53774,"144,627.48",36588
,20160419,2749,2689,2765,2850,2755,2850,2818,161,129,43666,"123,092.64",34596
,20160420,2850,2818,2940,3071,2883,3071,2996,253,178,79242,"237,453.16",31896
,20160421,3071,2996,3119,3245,3051,3238,3175,242,179,70818,"224,871.82",25140
,20160422,3238,3175,3231,3231,3077,3097,3126,-78,-49,45872,"143,413.14",20130
,20160425,3097,3126,3128,3195,3063,3096,3122,-30,-4,20214,"63,119.89",18890
,20160426,3096,3122,3085,3097,2934,2934,3021,-188,-101,15940,"48,165.30",15418
,20160427,2934,3021,2950,2950,2840,2888,2889,-133,-132,13418,"38,775.66",13222
,20160428,2888,2889,2893,2977,2848,2952,2923,63,34,9294,"27,167.40",12144
,20160429,2952,2923,2970,3098,2952,3098,3027,175,104,3188,"9,651.94",11468
,20160503,3098,3027,3024,3024,2920,2920,2964,-107,-63,728,"2,158.04",10980
,20160504,2920,2964,2900,2900,2842,2842,2881,-122,-83,720,"2,074.62",10320
,20160505,2842,2881,2850,2850,2800,2810,2811,-71,-70,1200,"3,373.92",9660
,20160506,2810,2811,2785,2810,2785,2810,2798,-1,-13,180,503.70,9480
,20160509,2810,2798,2646,2680,2630,2630,2639,-168,-159,420,"1,108.62",9180
,20160510,2630,2639,2500,2550,2500,2550,2503,-89,-136,840,"2,103.18",8640
,20160511,2550,2503,2650,2650,2650,2650,2650,147,147,60,159.00,8580
,20160512,2650,2650,,,,2630,2630,-20,-20,0,0.00,8580
,20160513,2630,2630,,,,2630,2630,0,0,0,0.00,8580
,20160516,2630,2630,,,,2630,2630,0,0,0,0.00,8580
hc1606,20160104,1919,1919,,,,1919,1919,0,0,0,0.00,0
,20160105,1919,1919,,,,1909,1909,-10,-10,0,0.00,0
,20160106,1909,1909,,,,1909,1909,0,0,0,0.00,0
,20160107,1909,1909,,,,1893,1893,-16,-16,0,0.00,0
,20160108,1893,1893,,,,1863,1863,-30,-30,0,0.00,0
,20160111,1863,1863,,,,1845,1845,-18,-18,0,0.00,0
,20160112,1845,1845,,,,1832,1832,-13,-13,0,0.00,0
,20160113,1832,1832,,,,1826,1826,-6,-6,0,0.00,0
,20160114,1826,1826,,,,1835,1835,9,9,0,0.00,0
,20160115,1835,1835,,,,1866,1866,31,31,0,0.00,0
,20160118,1866,1866,1959,1959,1916,1916,1937,50,71,4,7.75,0
,20160119,1916,1937,,,,1953,1953,16,16,0,0.00,0
,20160120,1953,1953,,,,1953,1953,0,0,0,0.00,0
,20160121,1953,1953,,,,1944,1944,-9,-9,0,0.00,0
,20160122,1944,1944,,,,1960,1960,16,16,0,0.00,0
,20160125,1960,1960,,,,1964,1964,4,4,0,0.00,0
,20160126,1964,1964,,,,1957,1957,-7,-7,0,0.00,0
,20160127,1957,1957,,,,1967,1967,10,10,0,0.00,0
,20160128,1967,1967,,,,1939,1939,-28,-28,0,0.00,0
,20160129,1939,1939,,,,1926,1926,-13,-13,0,0.00,0
,20160201,1926,1926,,,,1948,1948,22,22,0,0.00,0
,20160202,1948,1948,,,,1939,1939,-9,-9,0,0.00,0
,20160203,1939,1939,,,,1941,1941,2,2,0,0.00,0
,20160204,1941,1941,,,,1961,1961,20,20,0,0.00,0
,20160205,1961,1961,,,,1965,1965,4,4,0,0.00,0
,20160215,1965,1965,,,,1977,1977,12,12,0,0.00,0
,20160216,1977,1977,,,,1977,1977,0,0,0,0.00,0
,20160217,1977,1977,,,,1972,1972,-5,-5,0,0.00,0
,20160218,1972,1972,2039,2039,1941,1973,1984,1,12,6,11.91,0
,20160219,1973,1984,,,,1984,1984,0,0,0,0.00,0
,20160222,1984,1984,,,,2036,2036,52,52,0,0.00,0
,20160223,2036,2036,,,,2036,2036,0,0,0,0.00,0
,20160224,2036,2036,,,,2036,2036,0,0,0,0.00,0
,20160225,2036,2036,,,,2036,2036,0,0,0,0.00,0
,20160226,2036,2036,,,,2036,2036,0,0,0,0.00,0
,20160229,2036,2036,,,,2036,2036,0,0,0,0.00,0
,20160301,2036,2036,,,,2067,2067,31,31,0,0.00,0
,20160302,2067,2067,,,,2076,2076,9,9,0,0.00,0
,20160303,2076,2076,,,,2095,2095,19,19,0,0.00,0
,20160304,2095,2095,,,,2118,2118,23,23,0,0.00,0
,20160307,2118,2118,2223,2223,2223,2223,2223,105,105,2,4.45,2
,20160308,2223,2223,2334,2334,2210,2294,2301,71,78,10,23.01,2
,20160309,2294,2301,,,,2199,2199,-102,-102,0,0.00,2
,20160310,2199,2199,,,,2246,2246,47,47,0,0.00,2
,20160311,2246,2246,,,,2215,2215,-31,-31,0,0.00,2
,20160314,2215,2215,2136,2236,2136,2236,2185,21,-30,52,113.65,2
,20160315,2236,2185,,,,2128,2128,-57,-57,0,0.00,2
,20160316,2128,2128,2079,2089,2079,2089,2084,-39,-44,4,8.34,2
,20160317,2089,2084,2188,2188,2144,2188,2162,104,78,14,30.28,10
,20160318,2188,2162,2160,2260,2160,2260,2193,98,31,6,13.16,10
,20160321,2260,2193,,,,2230,2230,37,37,0,0.00,10
,20160322,2230,2230,,,,2245,2245,15,15,0,0.00,10
,20160323,2245,2245,2251,2357,2251,2273,2320,28,75,16,37.13,6
,20160324,2273,2320,2262,2411,2262,2299,2319,-21,-1,20,46.39,6
,20160325,2299,2319,2380,2380,2370,2370,2370,51,51,22,52.16,24
,20160328,2370,2370,,,,2412,2412,42,42,0,0.00,24
,20160329,2412,2412,,,,2408,2408,-4,-4,0,0.00,24
,20160330,2408,2408,2287,2320,2287,2320,2308,-88,-100,6,13.85,22
,20160331,2320,2308,2358,2358,2358,2358,2358,50,50,2,4.72,22
,20160401,2358,2358,2426,2443,2372,2443,2434,85,76,20,48.68,10
,20160405,2443,2434,,,,2434,2434,0,0,0,0.00,10
,20160406,2434,2434,,,,2451,2451,17,17,0,0.00,10
,20160407,2451,2451,,,,2451,2451,0,0,0,0.00,10
,20160408,2451,2451,,,,2451,2451,0,0,0,0.00,10
,20160411,2451,2451,2443,2443,2443,2443,2443,-8,-8,8,19.54,10
,20160412,2443,2443,,,,2484,2484,41,41,0,0.00,10
,20160413,2484,2484,,,,2473,2473,-11,-11,0,0.00,10
,20160414,2473,2473,,,,2472,2472,-1,-1,0,0.00,10
,20160415,2472,2472,,,,2449,2449,-23,-23,0,0.00,10
,20160418,2449,2449,,,,2487,2487,38,38,0,0.00,10
,20160419,2487,2487,,,,2636,2636,149,149,0,0.00,10
,20160420,2636,2636,,,,2794,2794,158,158,0,0.00,10
,20160421,2794,2794,2960,2961,2866,2866,2937,72,143,8,23.50,8
,20160422,2866,2937,2842,2900,2782,2850,2827,-87,-110,26,73.51,18
,20160425,2850,2827,2994,2996,2786,2860,2935,33,108,28,82.20,12
,20160426,2860,2935,2819,2995,2817,2817,2847,-118,-88,12,34.17,16
,20160427,2817,2847,2785,2885,2785,2860,2847,13,0,8,22.78,14
,20160428,2860,2847,2681,2883,2681,2872,2804,25,-43,26,72.92,20
,20160429,2872,2804,2916,2916,2906,2906,2912,102,108,6,17.48,20
,20160503,2906,2912,,,,2912,2912,0,0,0,0.00,20
,20160504,2912,2912,2740,2741,2737,2737,2738,-175,-174,34,93.11,28
,20160505,2737,2738,2740,2760,2693,2693,2721,-45,-17,8,21.77,26
,20160506,2693,2721,2774,2775,2774,2775,2774,54,53,6,16.65,26
,20160509,2775,2774,2613,2613,2613,2613,2613,-161,-161,2,5.23,26
,20160510,2613,2613,2458,2749,2458,2588,2613,-25,0,176,459.93,36
,20160511,2588,2613,2700,2700,2527,2600,2616,-13,3,22,57.56,26
,20160512,2600,2616,2520,2520,2500,2500,2510,-116,-106,4,10.04,26
,20160513,2500,2510,2400,2400,2400,2400,2400,-110,-110,2,4.80,24
,20160516,2400,2400,2400,2500,2400,2500,2450,100,50,4,9.80,24
,20160517,2500,2450,2520,2520,2520,2520,2520,70,70,2,5.04,22
,20160518,2520,2520,2500,2667,2500,2667,2583,147,63,4,10.33,22
,20160519,2667,2583,,,,2582,2582,-1,-1,0,0.00,22
,20160520,2582,2582,2462,2635,2462,2496,2533,-86,-49,10,25.33,20
,20160523,2496,2533,,,,2533,2533,0,0,0,0.00,20
,20160524,2533,2533,,,,2533,2533,0,0,0,0.00,20
,20160525,2533,2533,2388,2388,2388,2388,2388,-145,-145,2,4.78,20
,20160526,2388,2388,,,,2410,2410,22,22,0,0.00,20
,20160527,2410,2410,,,,2410,2410,0,0,0,0.00,20
,20160530,2410,2410,2554,2554,2551,2551,2553,141,143,22,56.18,0
,20160531,2551,2553,,,,2553,2553,0,0,0,0.00,0
,20160601,2553,2553,,,,2553,2553,0,0,0,0.00,0
,20160602,2553,2553,,,,2553,2553,0,0,0,0.00,0
,20160603,2553,2553,,,,2553,2553,0,0,0,0.00,0
,20160606,2553,2553,,,,2553,2553,0,0,0,0.00,0
,20160607,2553,2553,,,,2553,2553,0,0,0,0.00,0
,20160608,2553,2553,,,,2553,2553,0,0,0,0.00,0
,20160613,2553,2553,,,,2553,2553,0,0,0,0.00,0
,20160614,2553,2553,,,,2553,2553,0,0,0,0.00,0
,20160615,2553,2553,,,,2553,2553,0,0,0,0.00,0
hc1607,20160104,1957,1957,,,,1957,1957,0,0,0,0.00,0
,20160105,1957,1957,,,,1946,1946,-11,-11,0,0.00,0
,20160106,1946,1946,,,,1946,1946,0,0,0,0.00,0
,20160107,1946,1946,,,,1930,1930,-16,-16,0,0.00,0
,20160108,1930,1930,,,,1930,1930,0,0,0,0.00,0
,20160111,1930,1930,,,,1911,1911,-19,-19,0,0.00,0
,20160112,1911,1911,,,,1898,1898,-13,-13,0,0.00,0
,20160113,1898,1898,,,,1892,1892,-6,-6,0,0.00,0
,20160114,1892,1892,,,,1901,1901,9,9,0,0.00,0
,20160115,1901,1901,,,,1933,1933,32,32,0,0.00,0
,20160118,1933,1933,,,,2007,2007,74,74,0,0.00,0
,20160119,2007,2007,,,,2024,2024,17,17,0,0.00,0
,20160120,2024,2024,2098,2099,1985,1985,2040,-39,16,38,77.53,18
,20160121,1985,2040,,,,2040,2040,0,0,0,0.00,18
,20160122,2040,2040,,,,2036,2036,-4,-4,0,0.00,18
,20160125,2036,2036,,,,2000,2000,-36,-36,0,0.00,18
,20160126,2000,2000,,,,2000,2000,0,0,0,0.00,18
,20160127,2000,2000,,,,2000,2000,0,0,0,0.00,18
,20160128,2000,2000,,,,2000,2000,0,0,0,0.00,18
,20160129,2000,2000,,,,1997,1997,-3,-3,0,0.00,18
,20160201,1997,1997,,,,1997,1997,0,0,0,0.00,18
,20160202,1997,1997,,,,1997,1997,0,0,0,0.00,18
,20160203,1997,1997,,,,1997,1997,0,0,0,0.00,18
,20160204,1997,1997,,,,1997,1997,0,0,0,0.00,18
,20160205,1997,1997,,,,1997,1997,0,0,0,0.00,18
,20160215,1997,1997,,,,1997,1997,0,0,0,0.00,18
,20160216,1997,1997,,,,1997,1997,0,0,0,0.00,18
,20160217,1997,1997,,,,1997,1997,0,0,0,0.00,18
,20160218,1997,1997,,,,1997,1997,0,0,0,0.00,18
,20160219,1997,1997,1982,1999,1982,1999,1995,2,-2,14,27.93,4
,20160222,1999,1995,2001,2030,2001,2030,2015,35,20,8,16.12,0
,20160223,2030,2015,,,,2015,2015,0,0,0,0.00,0
,20160224,2015,2015,,,,2015,2015,0,0,0,0.00,0
,20160225,2015,2015,,,,2015,2015,0,0,0,0.00,0
,20160226,2015,2015,,,,1996,1996,-19,-19,0,0.00,0
,20160229,1996,1996,,,,2016,2016,20,20,0,0.00,0
,20160301,2016,2016,,,,2047,2047,31,31,0,0.00,0
,20160302,2047,2047,,,,2056,2056,9,9,0,0.00,0
,20160303,2056,2056,,,,2075,2075,19,19,0,0.00,0
,20160304,2075,2075,,,,2097,2097,22,22,0,0.00,0
,20160307,2097,2097,,,,2200,2200,103,103,0,0.00,0
,20160308,2200,2200,,,,2277,2277,77,77,0,0.00,0
,20160309,2277,2277,,,,2176,2176,-101,-101,0,0.00,0
,20160310,2176,2176,,,,2222,2222,46,46,0,0.00,0
,20160311,2222,2222,,,,2191,2191,-31,-31,0,0.00,0
,20160314,2191,2191,,,,2161,2161,-30,-30,0,0.00,0
,20160315,2161,2161,,,,2105,2105,-56,-56,0,0.00,0
,20160316,2105,2105,,,,2061,2061,-44,-44,0,0.00,0
,20160317,2061,2061,,,,2138,2138,77,77,0,0.00,0
,20160318,2138,2138,,,,2168,2168,30,30,0,0.00,0
,20160321,2168,2168,,,,2204,2204,36,36,0,0.00,0
,20160322,2204,2204,,,,2219,2219,15,15,0,0.00,0
,20160323,2219,2219,,,,2293,2293,74,74,0,0.00,0
,20160324,2293,2293,,,,2292,2292,-1,-1,0,0.00,0
,20160325,2292,2292,,,,2343,2343,51,51,0,0.00,0
,20160328,2343,2343,,,,2384,2384,41,41,0,0.00,0
,20160329,2384,2384,,,,2349,2349,-35,-35,0,0.00,0
,20160330,2349,2349,,,,2252,2252,-97,-97,0,0.00,0
,20160331,2252,2252,,,,2300,2300,48,48,0,0.00,0
,20160401,2300,2300,,,,2374,2374,74,74,0,0.00,0
,20160405,2374,2374,,,,2442,2442,68,68,0,0.00,0
,20160406,2442,2442,,,,2459,2459,17,17,0,0.00,0
,20160407,2459,2459,,,,2460,2460,1,1,0,0.00,0
,20160408,2460,2460,,,,2504,2504,44,44,0,0.00,0
,20160411,2504,2504,,,,2495,2495,-9,-9,0,0.00,0
,20160412,2495,2495,,,,2537,2537,42,42,0,0.00,0
,20160413,2537,2537,2669,2669,2669,2669,2669,132,132,2,5.34,2
,20160414,2669,2669,,,,2651,2651,-18,-18,0,0.00,2
,20160415,2651,2651,,,,2626,2626,-25,-25,0,0.00,2
,20160418,2626,2626,,,,2626,2626,0,0,0,0.00,2
,20160419,2626,2626,2768,2768,2768,2768,2768,142,142,2,5.54,2
,20160420,2768,2768,,,,2934,2934,166,166,0,0.00,2
,20160421,2934,2934,3033,3033,3033,3033,3033,99,99,2,6.07,4
,20160422,3033,3033,3066,3066,3046,3046,3056,13,23,4,12.22,6
,20160425,3046,3056,2881,2881,2881,2881,2881,-175,-175,2,5.76,6
,20160426,2881,2881,,,,2794,2794,-87,-87,0,0.00,6
,20160427,2794,2794,,,,2794,2794,0,0,0,0.00,6
,20160428,2794,2794,2627,2773,2627,2773,2700,-21,-94,4,10.80,4
,20160429,2773,2700,,,,2804,2804,104,104,0,0.00,4
,20160503,2804,2804,,,,2745,2745,-59,-59,0,0.00,4
,20160504,2745,2745,,,,2581,2581,-164,-164,0,0.00,4
,20160505,2581,2581,,,,2581,2581,0,0,0,0.00,4
,20160506,2581,2581,,,,2581,2581,0,0,0,0.00,4
,20160509,2581,2581,,,,2431,2431,-150,-150,0,0.00,4
,20160510,2431,2431,,,,2431,2431,0,0,0,0.00,4
,20160511,2431,2431,,,,2431,2431,0,0,0,0.00,4
,20160512,2431,2431,,,,2431,2431,0,0,0,0.00,4
,20160513,2431,2431,,,,2324,2324,-107,-107,0,0.00,4
,20160516,2324,2324,,,,2372,2372,48,48,0,0.00,4
,20160517,2372,2372,2471,2471,2471,2471,2471,99,99,4,9.88,8
,20160518,2471,2471,2545,2545,2352,2352,2448,-119,-23,4,9.79,10
,20160519,2352,2448,,,,2407,2407,-41,-41,0,0.00,10
,20160520,2407,2407,,,,2407,2407,0,0,0,0.00,10
,20160523,2407,2407,,,,2407,2407,0,0,0,0.00,10
,20160524,2407,2407,,,,2407,2407,0,0,0,0.00,10
,20160525,2407,2407,,,,2269,2269,-138,-138,0,0.00,10
,20160526,2269,2269,,,,2269,2269,0,0,0,0.00,10
,20160527,2269,2269,,,,2269,2269,0,0,0,0.00,10
,20160530,2269,2269,,,,2404,2404,135,135,0,0.00,10
,20160531,2404,2404,,,,2404,2404,0,0,0,0.00,10
,20160601,2404,2404,,,,2404,2404,0,0,0,0.00,10
,20160602,2404,2404,,,,2404,2404,0,0,0,0.00,10
,20160603,2404,2404,,,,2404,2404,0,0,0,0.00,10
,20160606,2404,2404,,,,2404,2404,0,0,0,0.00,10
,20160607,2404,2404,,,,2404,2404,0,0,0,0.00,10
,20160608,2404,2404,,,,2404,2404,0,0,0,0.00,10
,20160613,2404,2404,,,,2404,2404,0,0,0,0.00,10
,20160614,2404,2404,,,,2404,2404,0,0,0,0.00,10
,20160615,2404,2404,2339,2339,2339,2339,2339,-65,-65,2,4.68,8
,20160616,2339,2339,,,,2339,2339,0,0,0,0.00,8
,20160617,2339,2339,,,,2339,2339,0,0,0,0.00,8
,20160620,2339,2339,,,,2339,2339,0,0,0,0.00,8
,20160621,2339,2339,,,,2339,2339,0,0,0,0.00,8
,20160622,2339,2339,,,,2339,2339,0,0,0,0.00,8
,20160623,2339,2339,,,,2375,2375,36,36,0,0.00,8
,20160624,2375,2375,,,,2375,2375,0,0,0,0.00,8
,20160627,2375,2375,2514,2514,2358,2435,2435,60,60,14,34.09,2
,20160628,2435,2435,,,,2435,2435,0,0,0,0.00,2
,20160629,2435,2435,2391,2391,2391,2391,2391,-44,-44,2,4.78,2
,20160630,2391,2391,2532,2532,2532,2532,2532,141,141,2,5.06,0
,20160701,2532,2532,,,,2532,2532,0,0,0,0.00,0
,20160704,2532,2532,,,,2532,2532,0,0,0,0.00,0
,20160705,2532,2532,,,,2532,2532,0,0,0,0.00,0
,20160706,2532,2532,,,,2532,2532,0,0,0,0.00,0
,20160707,2532,2532,,,,2532,2532,0,0,0,0.00,0
,20160708,2532,2532,,,,2532,2532,0,0,0,0.00,0
,20160711,2532,2532,,,,2532,2532,0,0,0,0.00,0
,20160712,2532,2532,,,,2532,2532,0,0,0,0.00,0
,20160713,2532,2532,,,,2532,2532,0,0,0,0.00,0
,20160714,2532,2532,,,,2532,2532,0,0,0,0.00,0
,20160715,2532,2532,,,,2532,2532,0,0,0,0.00,0
hc1608,20160104,1934,1934,,,,1934,1934,0,0,0,0.00,0
,20160105,1934,1934,,,,1924,1924,-10,-10,0,0.00,0
,20160106,1924,1924,,,,1924,1924,0,0,0,0.00,0
,20160107,1924,1924,2015,2018,2015,2018,2016,94,92,10,20.17,10
,20160108,2018,2016,1915,1988,1915,1916,1922,-100,-94,36,69.23,0
,20160111,1916,1922,,,,1904,1904,-18,-18,0,0.00,0
,20160112,1904,1904,,,,1891,1891,-13,-13,0,0.00,0
,20160113,1891,1891,,,,1885,1885,-6,-6,0,0.00,0
,20160114,1885,1885,,,,1894,1894,9,9,0,0.00,0
,20160115,1894,1894,,,,1926,1926,32,32,0,0.00,0
,20160118,1926,1926,,,,1999,1999,73,73,0,0.00,0
,20160119,1999,1999,,,,2016,2016,17,17,0,0.00,0
,20160120,2016,2016,,,,1988,1988,-28,-28,0,0.00,0
,20160121,1988,1988,,,,1978,1978,-10,-10,0,0.00,0
,20160122,1978,1978,,,,1994,1994,16,16,0,0.00,0
,20160125,1994,1994,,,,1998,1998,4,4,0,0.00,0
,20160126,1998,1998,,,,1991,1991,-7,-7,0,0.00,0
,20160127,1991,1991,2017,2017,2017,2017,2017,26,26,2,4.03,2
,20160128,2017,2017,,,,1989,1989,-28,-28,0,0.00,2
,20160129,1989,1989,,,,1970,1970,-19,-19,0,0.00,2
,20160201,1970,1970,1994,2026,1987,2000,2002,30,32,16,32.03,10
,20160202,2000,2002,,,,1980,1980,-22,-22,0,0.00,10
,20160203,1980,1980,1985,1987,1985,1987,1985,7,5,12,23.82,10
,20160204,1987,1985,,,,1985,1985,0,0,0,0.00,10
,20160205,1985,1985,,,,1985,1985,0,0,0,0.00,10
,20160215,1985,1985,,,,1985,1985,0,0,0,0.00,10
,20160216,1985,1985,2080,2080,2080,2080,2080,95,95,2,4.16,10
,20160217,2080,2080,,,,2038,2038,-42,-42,0,0.00,10
,20160218,2038,2038,,,,2038,2038,0,0,0,0.00,10
,20160219,2038,2038,2053,2069,2053,2069,2059,31,21,10,20.59,12
,20160222,2069,2059,,,,2080,2080,21,21,0,0.00,12
,20160223,2080,2080,2060,2143,2033,2053,2093,-27,13,16,33.50,10
,20160224,2053,2093,,,,2093,2093,0,0,0,0.00,10
,20160225,2093,2093,,,,2093,2093,0,0,0,0.00,10
,20160226,2093,2093,,,,2093,2093,0,0,0,0.00,10
,20160229,2093,2093,,,,2093,2093,0,0,0,0.00,10
,20160301,2093,2093,2150,2171,2140,2171,2156,78,63,18,38.81,8
,20160302,2171,2156,2212,2212,2110,2210,2188,54,32,14,30.64,6
,20160303,2210,2188,,,,2208,2208,20,20,0,0.00,6
,20160304,2208,2208,,,,2232,2232,24,24,0,0.00,6
,20160307,2232,2232,,,,2342,2342,110,110,0,0.00,6
,20160308,2342,2342,,,,2342,2342,0,0,0,0.00,6
,20160309,2342,2342,,,,2238,2238,-104,-104,0,0.00,6
,20160310,2238,2238,,,,2238,2238,0,0,0,0.00,6
,20160311,2238,2238,,,,2238,2238,0,0,0,0.00,6
,20160314,2238,2238,,,,2208,2208,-30,-30,0,0.00,6
,20160315,2208,2208,2105,2130,2105,2130,2115,-78,-93,10,21.15,2
,20160316,2130,2115,,,,2115,2115,0,0,0,0.00,2
,20160317,2115,2115,2220,2220,2220,2220,2220,105,105,2,4.44,0
,20160318,2220,2220,,,,2252,2252,32,32,0,0.00,0
,20160321,2252,2252,,,,2290,2290,38,38,0,0.00,0
,20160322,2290,2290,,,,2306,2306,16,16,0,0.00,0
,20160323,2306,2306,,,,2383,2383,77,77,0,0.00,0
,20160324,2383,2383,,,,2382,2382,-1,-1,0,0.00,0
,20160325,2382,2382,,,,2435,2435,53,53,0,0.00,0
,20160328,2435,2435,2318,2318,2318,2318,2318,-117,-117,4,9.27,4
,20160329,2318,2318,,,,2318,2318,0,0,0,0.00,4
,20160330,2318,2318,,,,2222,2222,-96,-96,0,0.00,4
,20160331,2222,2222,,,,2270,2270,48,48,0,0.00,4
,20160401,2270,2270,,,,2343,2343,73,73,0,0.00,4
,20160405,2343,2343,,,,2411,2411,68,68,0,0.00,4
,20160406,2411,2411,,,,2428,2428,17,17,0,0.00,4
,20160407,2428,2428,,,,2429,2429,1,1,0,0.00,4
,20160408,2429,2429,,,,2429,2429,0,0,0,0.00,4
,20160411,2429,2429,,,,2421,2421,-8,-8,0,0.00,4
,20160412,2421,2421,,,,2462,2462,41,41,0,0.00,4
,20160413,2462,2462,2482,2482,2482,2482,2482,20,20,4,9.93,2
,20160414,2482,2482,2531,2531,2531,2531,2531,49,49,2,5.06,0
,20160415,2531,2531,,,,2531,2531,0,0,0,0.00,0
,20160418,2531,2531,2574,2605,2574,2605,2603,74,72,76,197.89,76
,20160419,2605,2603,,,,2743,2743,140,140,0,0.00,76
,20160420,2743,2743,,,,2907,2907,164,164,0,0.00,76
,20160421,2907,2907,2900,3080,2892,2982,2946,75,39,192,565.75,24
,20160422,2982,2946,2901,2968,2890,2890,2924,-56,-22,8,23.40,24
,20160425,2890,2924,,,,2924,2924,0,0,0,0.00,24
,20160426,2924,2924,2873,2873,2850,2850,2861,-74,-63,4,11.45,24
,20160427,2850,2861,,,,2861,2861,0,0,0,0.00,24
,20160428,2861,2861,,,,2861,2861,0,0,0,0.00,24
,20160429,2861,2861,,,,2861,2861,0,0,0,0.00,24
,20160503,2861,2861,,,,2801,2801,-60,-60,0,0.00,24
,20160504,2801,2801,,,,2634,2634,-167,-167,0,0.00,24
,20160505,2634,2634,2543,2543,2543,2543,2543,-91,-91,2,5.09,24
,20160506,2543,2543,2520,2520,2520,2520,2520,-23,-23,12,30.24,12
,20160509,2520,2520,2520,2521,2500,2510,2514,-10,-6,42,105.62,12
,20160510,2510,2514,2660,2660,2364,2371,2405,-143,-109,24,57.72,28
,20160511,2371,2405,,,,2405,2405,0,0,0,0.00,28
,20160512,2405,2405,,,,2405,2405,0,0,0,0.00,28
,20160513,2405,2405,,,,2299,2299,-106,-106,0,0.00,28
,20160516,2299,2299,,,,2312,2312,13,13,0,0.00,28
,20160517,2312,2312,,,,2408,2408,96,96,0,0.00,28
,20160518,2408,2408,,,,2408,2408,0,0,0,0.00,28
,20160519,2408,2408,,,,2352,2352,-56,-56,0,0.00,28
,20160520,2352,2352,,,,2352,2352,0,0,0,0.00,28
,20160523,2352,2352,,,,2352,2352,0,0,0,0.00,28
,20160524,2352,2352,,,,2352,2352,0,0,0,0.00,28
,20160525,2352,2352,,,,2217,2217,-135,-135,0,0.00,28
,20160526,2217,2217,,,,2217,2217,0,0,0,0.00,28
,20160527,2217,2217,,,,2217,2217,0,0,0,0.00,28
,20160530,2217,2217,,,,2349,2349,132,132,0,0.00,28
,20160531,2349,2349,,,,2349,2349,0,0,0,0.00,28
,20160601,2349,2349,2249,2249,2249,2249,2249,-100,-100,4,9.00,26
,20160602,2249,2249,,,,2249,2249,0,0,0,0.00,26
,20160603,2249,2249,,,,2249,2249,0,0,0,0.00,26
,20160606,2249,2249,,,,2289,2289,40,40,0,0.00,26
,20160607,2289,2289,,,,2312,2312,23,23,0,0.00,26
,20160608,2312,2312,,,,2332,2332,20,20,0,0.00,26
,20160613,2332,2332,,,,2352,2352,20,20,0,0.00,26
,20160614,2352,2352,,,,2352,2352,0,0,0,0.00,26
,20160615,2352,2352,,,,2352,2352,0,0,0,0.00,26
,20160616,2352,2352,,,,2352,2352,0,0,0,0.00,26
,20160617,2352,2352,,,,2352,2352,0,0,0,0.00,26
,20160620,2352,2352,2283,2491,2281,2319,2371,-33,19,30,71.14,20
,20160621,2319,2371,,,,2371,2371,0,0,0,0.00,20
,20160622,2371,2371,2353,2353,2352,2352,2352,-19,-19,4,9.41,16
,20160623,2352,2352,,,,2353,2353,1,1,0,0.00,16
,20160624,2353,2353,,,,2353,2353,0,0,0,0.00,16
,20160627,2353,2353,2361,2469,2361,2469,2415,116,62,4,9.66,16
,20160628,2469,2415,2508,2508,2508,2508,2508,93,93,16,40.13,0
,20160629,2508,2508,,,,2508,2508,0,0,0,0.00,0
,20160630,2508,2508,,,,2508,2508,0,0,0,0.00,0
,20160701,2508,2508,,,,2508,2508,0,0,0,0.00,0
,20160704,2508,2508,2658,2658,2511,2552,2600,44,92,62,161.23,18
,20160705,2552,2600,2566,2566,2566,2566,2566,-34,-34,2,5.13,16
,20160706,2566,2566,2600,2600,2600,2600,2600,34,34,16,41.60,4
,20160707,2600,2600,,,,2600,2600,0,0,0,0.00,4
,20160708,2600,2600,,,,2600,2600,0,0,0,0.00,4
,20160711,2600,2600,,,,2600,2600,0,0,0,0.00,4
,20160712,2600,2600,2746,2746,2746,2746,2746,146,146,4,10.98,0
,20160713,2746,2746,,,,2746,2746,0,0,0,0.00,0
,20160714,2746,2746,,,,2746,2746,0,0,0,0.00,0
,20160715,2746,2746,,,,2746,2746,0,0,0,0.00,0
,20160718,2746,2746,,,,2746,2746,0,0,0,0.00,0
,20160719,2746,2746,,,,2746,2746,0,0,0,0.00,0
,20160720,2746,2746,2583,2583,2583,2583,2583,-163,-163,2,5.17,2
,20160721,2583,2583,2589,2589,2589,2589,2589,6,6,2,5.18,0
,20160722,2589,2589,,,,2589,2589,0,0,0,0.00,0
,20160725,2589,2589,,,,2589,2589,0,0,0,0.00,0
,20160726,2589,2589,,,,2589,2589,0,0,0,0.00,0
,20160727,2589,2589,,,,2589,2589,0,0,0,0.00,0
,20160728,2589,2589,,,,2589,2589,0,0,0,0.00,0
,20160729,2589,2589,,,,2589,2589,0,0,0,0.00,0
,20160801,2589,2589,,,,2589,2589,0,0,0,0.00,0
,20160802,2589,2589,,,,2589,2589,0,0,0,0.00,0
,20160803,2589,2589,,,,2589,2589,0,0,0,0.00,0
,20160804,2589,2589,,,,2589,2589,0,0,0,0.00,0
,20160805,2589,2589,,,,2589,2589,0,0,0,0.00,0
,20160808,2589,2589,,,,2589,2589,0,0,0,0.00,0
,20160809,2589,2589,,,,2589,2589,0,0,0,0.00,0
,20160810,2589,2589,,,,2589,2589,0,0,0,0.00,0
,20160811,2589,2589,,,,2589,2589,0,0,0,0.00,0
,20160812,2589,2589,,,,2589,2589,0,0,0,0.00,0
,20160815,2589,2589,,,,2589,2589,0,0,0,0.00,0
hc1609,20160104,1914,1914,,,,1914,1914,0,0,0,0.00,0
,20160105,1914,1914,,,,1904,1904,-10,-10,0,0.00,0
,20160106,1904,1904,1920,1983,1891,1970,1932,66,28,24,46.38,0
,20160107,1970,1932,,,,1932,1932,0,0,0,0.00,0
,20160108,1932,1932,,,,1932,1932,0,0,0,0.00,0
,20160111,1932,1932,,,,1932,1932,0,0,0,0.00,0
,20160112,1932,1932,,,,1919,1919,-13,-13,0,0.00,0
,20160113,1919,1919,,,,1913,1913,-6,-6,0,0.00,0
,20160114,1913,1913,,,,1913,1913,0,0,0,0.00,0
,20160115,1913,1913,,,,1913,1913,0,0,0,0.00,0
,20160118,1913,1913,,,,1986,1986,73,73,0,0.00,0
,20160119,1986,1986,,,,2003,2003,17,17,0,0.00,0
,20160120,2003,2003,,,,1988,1988,-15,-15,0,0.00,0
,20160121,1988,1988,,,,1978,1978,-10,-10,0,0.00,0
,20160122,1978,1978,,,,1978,1978,0,0,0,0.00,0
,20160125,1978,1978,,,,1982,1982,4,4,0,0.00,0
,20160126,1982,1982,,,,1975,1975,-7,-7,0,0.00,0
,20160127,1975,1975,,,,2000,2000,25,25,0,0.00,0
,20160128,2000,2000,,,,1972,1972,-28,-28,0,0.00,0
,20160129,1972,1972,,,,1959,1959,-13,-13,0,0.00,0
,20160201,1959,1959,,,,1990,1990,31,31,0,0.00,0
,20160202,1990,1990,,,,1981,1981,-9,-9,0,0.00,0
,20160203,1981,1981,,,,1981,1981,0,0,0,0.00,0
,20160204,1981,1981,,,,2002,2002,21,21,0,0.00,0
,20160205,2002,2002,2011,2011,1890,1920,1945,-82,-57,60,116.71,4
,20160215,1920,1945,,,,1945,1945,0,0,0,0.00,4
,20160216,1945,1945,,,,1945,1945,0,0,0,0.00,4
,20160217,1945,1945,,,,1945,1945,0,0,0,0.00,4
,20160218,1945,1945,,,,1945,1945,0,0,0,0.00,4
,20160219,1945,1945,,,,1945,1945,0,0,0,0.00,4
,20160222,1945,1945,,,,1964,1964,19,19,0,0.00,4
,20160223,1964,1964,2062,2062,2002,2046,2043,82,79,8,16.34,2
,20160224,2046,2043,,,,2043,2043,0,0,0,0.00,2
,20160225,2043,2043,,,,2043,2043,0,0,0,0.00,2
,20160226,2043,2043,2049,2050,2049,2050,2049,7,6,4,8.20,0
,20160229,2050,2049,,,,2049,2049,0,0,0,0.00,0
,20160301,2049,2049,,,,2110,2110,61,61,0,0.00,0
,20160302,2110,2110,,,,2110,2110,0,0,0,0.00,0
,20160303,2110,2110,,,,2130,2130,20,20,0,0.00,0
,20160304,2130,2130,,,,2153,2153,23,23,0,0.00,0
,20160307,2153,2153,,,,2259,2259,106,106,0,0.00,0
,20160308,2259,2259,2371,2371,2310,2371,2331,112,72,466,"1,086.62",424
,20160309,2371,2331,2400,2400,2161,2220,2208,-111,-123,148,326.87,354
,20160310,2220,2208,2184,2318,2184,2318,2251,110,43,12,27.01,354
,20160311,2318,2251,2180,2300,2180,2300,2226,49,-25,18,40.07,346
,20160314,2300,2226,2247,2297,2171,2232,2246,6,20,186,417.76,346
,20160315,2232,2246,2232,2269,2133,2133,2140,-113,-106,396,847.60,244
,20160316,2133,2140,2136,2230,2136,2142,2152,2,12,14,30.13,236
,20160317,2142,2152,,,,2192,2192,40,40,0,0.00,236
,20160318,2192,2192,2250,2301,2181,2280,2245,88,53,92,206.56,234
,20160321,2280,2245,2357,2357,2230,2345,2328,100,83,18,41.91,236
,20160322,2345,2328,2393,2393,2266,2340,2305,12,-23,22,50.72,236
,20160323,2340,2305,2297,2381,2291,2381,2356,76,51,34,80.11,238
,20160324,2381,2356,2381,2381,2291,2292,2344,-64,-12,32,75.02,232
,20160325,2292,2344,2348,2379,2271,2370,2349,26,5,38,89.27,238
,20160328,2370,2349,2368,2398,2340,2340,2362,-9,13,64,151.22,240
,20160329,2340,2362,2312,2345,2312,2345,2328,-17,-34,4,9.31,242
,20160330,2345,2328,2308,2313,2240,2305,2287,-23,-41,50,114.38,240
,20160331,2305,2287,2326,2345,2271,2345,2309,58,22,12,27.71,240
,20160401,2345,2309,2337,2425,2337,2410,2409,101,100,54,130.11,272
,20160405,2410,2409,2508,2508,2334,2345,2403,-64,-6,178,427.81,226
,20160406,2345,2403,2362,2440,2349,2386,2382,-17,-21,58,138.20,208
,20160407,2386,2382,,,,2383,2383,1,1,0,0.00,208
,20160408,2383,2383,2361,2420,2336,2407,2383,24,0,58,138.22,198
,20160411,2407,2383,2473,2524,2375,2523,2463,140,80,148,364.65,186
,20160412,2523,2463,2535,2583,2492,2546,2519,83,56,94,236.85,180
,20160413,2546,2519,2372,2648,2367,2532,2540,13,21,1180,"2,997.62",326
,20160414,2532,2540,2567,2567,2457,2477,2524,-63,-16,56,141.38,324
,20160415,2477,2524,2489,2505,2450,2469,2463,-55,-61,34,83.77,330
,20160418,2469,2463,2462,2596,2462,2548,2552,85,89,358,913.95,324
,20160419,2548,2552,2548,2705,2548,2705,2665,153,113,404,"1,076.91",318
,20160420,2705,2665,2725,2824,2661,2824,2752,159,87,710,"1,954.31",320
,20160421,2824,2752,2830,2917,2819,2917,2872,165,120,1118,"3,211.57",258
,20160422,2917,2872,3089,3094,2841,2867,2934,-5,62,458,"1,344.06",198
,20160425,2867,2934,2800,3011,2800,2886,2927,-48,-7,218,638.29,204
,20160426,2886,2927,2846,2889,2760,2766,2829,-161,-98,146,413.16,182
,20160427,2766,2829,2739,2778,2660,2668,2725,-161,-104,214,583.30,164
,20160428,2668,2725,2688,2754,2664,2752,2725,27,0,324,883.20,146
,20160429,2752,2725,2797,2834,2759,2810,2805,85,80,200,561.08,188
,20160503,2810,2805,2758,2758,2645,2653,2672,-152,-133,178,475.65,186
,20160504,2653,2672,2607,2640,2562,2582,2608,-90,-64,194,505.99,148
,20160505,2582,2608,2560,2631,2510,2542,2563,-66,-45,68,174.30,134
,20160506,2542,2563,2512,2551,2486,2541,2511,-22,-52,136,341.61,168
,20160509,2541,2511,2570,2570,2360,2360,2431,-151,-80,210,510.59,160
,20160510,2360,2431,2338,2376,2280,2341,2325,-90,-106,102,237.15,150
,20160511,2341,2325,2341,2386,2324,2372,2363,47,38,132,312.02,138
,20160512,2372,2363,2333,2373,2290,2290,2338,-73,-25,108,252.54,138
,20160513,2290,2338,2290,2296,2228,2254,2255,-84,-83,94,212.06,168
,20160516,2254,2255,2275,2351,2261,2312,2300,57,45,344,791.32,192
,20160517,2312,2300,2330,2372,2290,2361,2335,61,35,60,140.15,196
,20160518,2361,2335,2358,2374,2284,2288,2336,-47,1,114,266.37,196
,20160519,2288,2336,2314,2462,2218,2286,2310,-50,-26,542,"1,252.39",262
,20160520,2286,2310,2254,2329,2254,2324,2303,14,-7,104,239.58,270
,20160523,2324,2303,2305,2305,2164,2173,2183,-130,-120,420,917.08,258
,20160524,2173,2183,2180,2220,2156,2203,2187,20,4,206,450.61,240
,20160525,2203,2187,2221,2237,2169,2169,2209,-18,22,162,357.93,210
,20160526,2169,2209,2174,2219,2154,2219,2189,10,-20,166,363.40,232
,20160527,2219,2189,2238,2320,2215,2320,2261,131,72,338,764.27,340
,20160530,2320,2261,2356,2366,2185,2290,2277,29,16,590,"1,343.78",344
,20160531,2290,2277,2293,2318,2285,2285,2302,8,25,56,128.96,340
,20160601,2285,2302,2265,2265,2202,2244,2234,-58,-68,208,464.83,328
,20160602,2244,2234,2230,2272,2212,2234,2234,0,0,122,272.57,342
,20160603,2234,2234,2213,2273,2213,2259,2250,25,16,88,198.01,368
,20160606,2259,2250,2289,2359,2251,2325,2289,75,39,204,467.00,344
,20160607,2325,2289,2347,2374,2330,2332,2351,43,62,108,254.00,358
,20160608,2332,2351,2357,2376,2313,2359,2336,8,-15,126,294.37,360
,20160613,2359,2336,2378,2436,2376,2419,2407,83,71,170,409.22,298
,20160614,2419,2407,2403,2417,2334,2335,2378,-72,-29,206,490.06,288
,20160615,2335,2378,2319,2326,2281,2322,2309,-56,-69,24,55.42,288
,20160616,2322,2309,2335,2358,2300,2317,2316,8,7,202,467.91,288
,20160617,2317,2316,2245,2326,2245,2318,2296,2,-20,108,248.02,266
,20160620,2318,2296,2297,2351,2297,2308,2336,12,40,268,626.21,272
,20160621,2308,2336,2305,2361,2305,2336,2338,0,2,62,144.97,296
,20160622,2336,2338,2357,2397,2345,2361,2368,23,30,204,483.22,268
,20160623,2361,2368,2362,2401,2362,2379,2380,11,12,32,76.18,268
,20160624,2379,2380,2403,2417,2346,2364,2375,-16,-5,78,185.25,260
,20160627,2364,2375,2396,2516,2379,2516,2460,141,85,288,708.71,282
,20160628,2516,2460,2472,2536,2462,2508,2515,48,55,200,503.00,264
,20160629,2508,2515,2500,2519,2478,2482,2498,-33,-17,32,79.94,266
,20160630,2482,2498,2455,2584,2454,2568,2541,70,43,136,345.66,252
,20160701,2568,2541,2615,2620,2542,2542,2567,1,26,180,462.07,160
,20160704,2542,2567,2587,2721,2587,2603,2641,36,74,370,977.26,184
,20160705,2603,2641,2638,2663,2491,2590,2557,-51,-84,612,"1,565.27",142
,20160706,2590,2557,2599,2619,2530,2564,2572,7,15,176,452.71,164
,20160707,2564,2572,2550,2685,2550,2664,2622,92,50,228,597.99,154
,20160708,2664,2622,2625,2648,2579,2579,2619,-43,-3,434,"1,136.87",148
,20160711,2579,2619,2661,2661,2614,2632,2640,13,21,12,31.68,148
,20160712,2632,2640,2632,2702,2632,2690,2675,50,35,870,"2,327.88",224
,20160713,2690,2675,2688,2742,2667,2672,2694,-3,19,16,43.11,226
,20160714,2672,2694,2668,2668,2612,2654,2644,-40,-50,48,126.93,200
,20160715,2654,2644,2655,2694,2641,2645,2661,1,17,108,287.39,154
,20160718,2645,2661,2643,2643,2502,2502,2560,-159,-101,46,117.76,142
,20160719,2502,2560,2505,2508,2432,2432,2487,-128,-73,94,233.87,100
,20160720,2432,2487,2490,2490,2439,2446,2468,-41,-19,68,167.86,102
,20160721,2446,2468,2351,2596,2339,2588,2498,120,30,382,954.40,118
,20160722,2588,2498,2550,2585,2476,2476,2518,-22,20,14,35.26,120
,20160725,2476,2518,2515,2594,2459,2519,2526,1,8,28,70.75,124
,20160726,2519,2526,2545,2564,2509,2560,2555,34,29,92,235.07,120
,20160727,2560,2555,2579,2647,2518,2518,2601,-37,46,136,353.85,100
,20160728,2518,2601,2618,2635,2601,2632,2612,31,11,142,371.04,98
,20160729,2632,2612,2598,2642,2567,2570,2603,-42,-9,110,286.34,108
,20160801,2570,2603,2694,2728,2657,2728,2709,125,106,30,81.29,94
,20160802,2728,2709,2751,2751,2696,2696,2722,-13,13,14,38.11,92
,20160803,2696,2722,,,,2722,2722,0,0,0,0.00,92
,20160804,2722,2722,2649,2729,2631,2659,2655,-63,-67,40,106.22,90
,20160805,2659,2655,2685,2756,2660,2753,2708,98,53,16,43.33,86
,20160808,2753,2708,,,,2708,2708,0,0,0,0.00,86
,20160809,2708,2708,2849,2849,2723,2723,2759,15,51,34,93.81,100
,20160810,2723,2759,2777,2790,2752,2752,2783,-7,24,32,89.09,88
,20160811,2752,2783,2831,2831,2831,2831,2831,48,48,2,5.66,86
,20160812,2831,2831,2766,2808,2752,2780,2788,-51,-43,32,89.22,88
,20160815,2780,2788,2780,2802,2713,2741,2769,-47,-19,34,94.15,82
,20160816,2741,2769,2871,2935,2827,2882,2897,113,128,1018,"2,949.77",94
,20160817,2882,2897,,,,2890,2890,-7,-7,0,0.00,94
,20160818,2890,2890,2815,2831,2814,2831,2818,-59,-72,10,28.18,92
,20160819,2831,2818,2822,2822,2743,2764,2759,-54,-59,98,270.41,98
,20160822,2764,2759,2798,2799,2798,2799,2798,40,39,8,22.39,96
,20160823,2799,2798,2911,2911,2911,2911,2911,113,113,4,11.64,100
,20160824,2911,2911,,,,2911,2911,0,0,0,0.00,100
,20160825,2911,2911,2838,2838,2809,2809,2823,-102,-88,4,11.29,98
,20160826,2809,2823,,,,2823,2823,0,0,0,0.00,98
,20160829,2823,2823,2806,2806,2806,2806,2806,-17,-17,4,11.22,98
,20160830,2806,2806,2800,2846,2740,2760,2777,-46,-29,26,72.21,80
,20160831,2760,2777,2760,2780,2760,2780,2776,3,-1,20,55.52,60
,20160901,2780,2776,,,,2776,2776,0,0,0,0.00,60
,20160902,2776,2776,,,,2776,2776,0,0,0,0.00,60
,20160905,2776,2776,,,,2776,2776,0,0,0,0.00,60
,20160906,2776,2776,,,,2776,2776,0,0,0,0.00,60
,20160907,2776,2776,,,,2776,2776,0,0,0,0.00,60
,20160908,2776,2776,2700,2700,2700,2700,2700,-76,-76,60,162.00,60
,20160909,2700,2700,,,,2700,2700,0,0,0,0.00,60
,20160912,2700,2700,,,,2700,2700,0,0,0,0.00,60
,20160913,2700,2700,,,,2700,2700,0,0,0,0.00,60
,20160914,2700,2700,,,,2700,2700,0,0,0,0.00,60
,20160919,2700,2700,,,,2700,2700,0,0,0,0.00,60
hc1610,20160104,1932,1942,1949,1979,1933,1937,1956,-5,14,1072,"2,097.78",1184
,20160105,1937,1956,1936,1965,1930,1965,1956,9,0,342,669.14,1402
,20160106,1965,1956,1955,1965,1944,1950,1949,-6,-7,56,109.19,1402
,20160107,1950,1949,1933,1949,1915,1922,1926,-27,-23,572,"1,101.98",1418
,20160108,1922,1926,1909,1909,1888,1900,1899,-26,-27,934,"1,774.29",2170
,20160111,1900,1899,1901,1902,1871,1878,1895,-21,-4,1926,"3,650.04",3440
,20160112,1878,1895,1873,1878,1850,1852,1861,-43,-34,410,763.38,3494
,20160113,1852,1861,1863,1869,1850,1861,1855,0,-6,262,486.26,3670
,20160114,1861,1855,1859,1885,1851,1880,1864,25,9,588,"1,096.31",4002
,20160115,1880,1864,1877,1905,1876,1898,1901,34,37,550,"1,045.57",4410
,20160118,1898,1901,1893,1942,1891,1939,1927,38,26,2492,"4,804.57",5302
,20160119,1939,1927,1949,1966,1937,1950,1949,23,22,1240,"2,417.40",5332
,20160120,1950,1949,1953,1966,1923,1928,1940,-21,-9,1168,"2,266.85",5640
,20160121,1928,1940,1925,1934,1920,1922,1927,-18,-13,262,505.04,5824
,20160122,1922,1927,1924,1960,1924,1935,1940,8,13,584,"1,133.22",6034
,20160125,1935,1940,1935,1954,1935,1943,1945,3,5,180,350.16,6158
,20160126,1943,1945,1935,1945,1928,1938,1937,-7,-8,112,216.96,6210
,20160127,1938,1937,1943,1952,1929,1937,1936,0,-1,324,627.48,6348
,20160128,1937,1936,1931,1937,1890,1890,1919,-46,-17,208,399.25,6344
,20160129,1890,1919,1898,1907,1881,1900,1894,-19,-25,760,"1,439.71",6394
,20160201,1900,1894,1903,1920,1902,1905,1908,11,14,1542,"2,942.36",6288
,20160202,1905,1908,1908,1913,1895,1905,1902,-3,-6,242,460.50,6274
,20160203,1905,1902,1919,1922,1898,1906,1909,4,7,352,672.22,6254
,20160204,1906,1909,1909,1949,1909,1949,1927,40,18,454,874.99,6270
,20160205,1949,1927,1947,1960,1924,1938,1944,11,17,518,"1,007.38",6284
,20160215,1938,1944,1944,1962,1938,1950,1952,6,8,664,"1,296.45",6350
,20160216,1950,1952,1957,1973,1949,1963,1958,11,6,1304,"2,554.27",7076
,20160217,1963,1958,1956,1967,1950,1958,1960,0,2,736,"1,443.01",7592
,20160218,1958,1960,1958,1970,1954,1965,1961,5,1,628,"1,231.55",7932
,20160219,1965,1961,1970,1984,1964,1982,1973,21,12,1084,"2,139.23",8030
,20160222,1982,1973,1993,2067,1979,2063,2032,90,59,3000,"6,097.38",7930
,20160223,2063,2032,2063,2070,2028,2035,2047,3,15,2252,"4,609.89",7896
,20160224,2035,2047,2030,2047,2027,2043,2037,-4,-10,1948,"3,969.97",8598
,20160225,2043,2037,2053,2062,2029,2035,2048,-2,11,2650,"5,428.48",8248
,20160226,2035,2048,2034,2040,2004,2027,2019,-21,-29,1424,"2,875.88",8300
,20160229,2027,2019,2024,2060,2020,2058,2039,39,20,1312,"2,675.94",8104
,20160301,2058,2039,2062,2098,2053,2081,2071,42,32,2314,"4,792.67",8336
,20160302,2081,2071,2091,2106,2067,2090,2088,19,17,5246,"10,957.22",11032
,20160303,2090,2088,2144,2144,2086,2100,2099,12,11,4024,"8,448.69",11158
,20160304,2100,2099,2110,2150,2091,2144,2120,45,21,11856,"25,136.68",11580
,20160307,2144,2120,2141,2226,2141,2226,2186,106,66,6176,"13,502.99",12248
,20160308,2226,2186,2360,2360,2205,2360,2315,174,129,30664,"71,013.84",16536
,20160309,2360,2315,2340,2340,2199,2199,2223,-116,-92,29164,"64,842.15",19454
,20160310,2199,2223,2199,2308,2194,2228,2251,5,28,27302,"61,474.06",18600
,20160311,2228,2251,2213,2224,2168,2170,2200,-81,-51,15692,"34,522.44",21876
,20160314,2170,2200,2161,2227,2128,2134,2167,-66,-33,20504,"44,436.52",23596
,20160315,2134,2167,2132,2150,2104,2115,2126,-52,-41,15652,"33,279.82",26466
,20160316,2115,2126,2112,2138,2109,2136,2128,10,2,8372,"17,818.53",28114
,20160317,2136,2128,2135,2207,2135,2204,2181,76,53,23470,"51,191.31",31180
,20160318,2204,2181,2213,2286,2204,2254,2248,73,67,45176,"101,589.67",36118
,20160321,2254,2248,2272,2333,2135,2285,2277,37,29,32290,"73,532.30",37000
,20160322,2285,2277,2270,2310,2270,2290,2292,13,15,16162,"37,055.18",38752
,20160323,2290,2292,2288,2354,2266,2324,2325,32,33,30646,"71,264.67",40748
,20160324,2324,2325,2325,2335,2236,2249,2274,-76,-51,37508,"85,309.37",41182
,20160325,2249,2274,2254,2330,2235,2306,2267,32,-7,35052,"79,468.65",42338
,20160328,2306,2267,2305,2338,2241,2249,2298,-18,31,42642,"98,030.38",47892
,20160329,2249,2298,2244,2283,2240,2271,2263,-27,-35,33340,"75,468.98",52258
,20160330,2271,2263,2273,2278,2180,2230,2237,-33,-26,43028,"96,262.33",50220
,20160331,2230,2237,2232,2262,2229,2258,2242,21,5,32682,"73,298.49",52504
,20160401,2258,2242,2258,2335,2256,2329,2297,87,55,61966,"142,353.01",48808
,20160405,2329,2297,2315,2350,2285,2341,2327,44,30,60650,"141,145.67",50900
,20160406,2341,2327,2342,2385,2321,2332,2349,5,22,92314,"216,859.02",52450
,20160407,2332,2349,2323,2365,2321,2348,2340,-1,-9,52422,"122,702.91",54818
,20160408,2348,2340,2350,2368,2333,2361,2354,21,14,87786,"206,709.69",66426
,20160411,2361,2354,2366,2495,2366,2467,2437,113,83,164884,"401,986.47",79118
,20160412,2467,2437,2467,2560,2465,2556,2501,119,64,250566,"626,695.76",105366
,20160413,2556,2501,2550,2640,2524,2558,2567,57,66,530680,"1,362,460.88",128586
,20160414,2558,2567,2558,2567,2491,2508,2536,-59,-31,357796,"907,416.76",118634
,20160415,2508,2536,2514,2518,2471,2478,2493,-58,-43,348210,"868,137.09",117090
,20160418,2478,2493,2476,2611,2459,2581,2547,88,54,426286,"1,085,986.00",132994
,20160419,2581,2547,2601,2699,2585,2699,2663,152,116,651134,"1,734,060.73",194160
,20160420,2699,2663,2720,2858,2716,2833,2792,170,129,1079532,"3,014,851.20",168910
,20160421,2833,2792,2830,2959,2803,2954,2892,162,100,1228096,"3,551,901.32",146848
,20160422,2954,2892,2940,2941,2796,2817,2855,-75,-37,875484,"2,499,641.07",125618
,20160425,2817,2855,2800,2969,2780,2831,2857,-24,2,538120,"1,537,580.96",115960
,20160426,2831,2857,2831,2831,2685,2685,2760,-172,-97,452874,"1,250,282.62",130494
,20160427,2685,2760,2700,2709,2594,2632,2650,-128,-110,612324,"1,622,927.35",141004
,20160428,2632,2650,2633,2699,2600,2692,2658,42,8,513652,"1,365,293.90",137404
,20160429,2692,2658,2696,2765,2691,2731,2737,73,79,456480,"1,249,479.87",140666
,20160503,2731,2737,2714,2714,2572,2574,2601,-163,-136,338830,"881,485.79",156046
,20160504,2574,2601,2562,2578,2501,2524,2540,-77,-61,394220,"1,001,704.55",173856
,20160505,2524,2540,2535,2560,2450,2458,2506,-82,-34,342334,"857,988.80",172300
,20160506,2458,2506,2455,2496,2412,2493,2456,-13,-50,316368,"777,013.12",164704
,20160509,2493,2456,2500,2517,2308,2308,2405,-148,-51,378212,"909,817.51",157642
,20160510,2308,2405,2253,2325,2235,2303,2274,-102,-131,401014,"912,086.47",155928
,20160511,2303,2274,2310,2337,2267,2304,2307,30,33,344588,"795,041.57",162940
,20160512,2304,2307,2315,2317,2236,2236,2287,-71,-20,241932,"553,471.20",173602
,20160513,2236,2287,2220,2239,2155,2195,2198,-92,-89,342292,"752,381.76",189070
,20160516,2195,2198,2199,2280,2171,2245,2235,47,37,408336,"912,694.83",195776
,20160517,2245,2235,2245,2316,2225,2312,2267,77,32,304972,"691,651.76",199732
,20160518,2312,2267,2312,2322,2205,2244,2273,-23,6,402000,"914,030.21",189400
,20160519,2244,2273,2242,2262,2209,2231,2231,-42,-42,251872,"562,161.21",192920
,20160520,2231,2231,2226,2265,2204,2255,2242,24,11,241494,"541,464.66",205386
,20160523,2255,2242,2255,2270,2107,2123,2162,-119,-80,340820,"737,070.25",215838
,20160524,2123,2162,2123,2167,2100,2153,2129,-9,-33,260288,"554,268.03",222486
,20160525,2153,2129,2164,2174,2099,2105,2136,-24,7,239486,"511,571.82",229280
,20160526,2105,2136,2101,2155,2092,2153,2132,17,-4,263222,"561,202.12",241200
,20160527,2153,2132,2160,2259,2141,2259,2201,127,69,610384,"1,343,896.23",297014
,20160530,2259,2201,2264,2283,2107,2230,2224,29,23,695362,"1,547,169.46",317230
,20160531,2230,2224,2241,2255,2196,2201,2229,-23,5,329512,"734,757.12",316684
,20160601,2201,2229,2200,2200,2146,2167,2168,-62,-61,408586,"886,207.88",322430
,20160602,2167,2168,2159,2195,2150,2153,2171,-15,3,375976,"816,263.36",341994
,20160603,2153,2171,2150,2201,2148,2176,2176,5,5,272958,"594,160.72",338130
,20160606,2176,2176,2183,2275,2170,2256,2222,80,46,404826,"899,559.29",326652
,20160607,2256,2222,2271,2305,2241,2284,2277,62,55,304636,"693,958.39",318094
,20160608,2284,2277,2272,2325,2238,2300,2290,23,13,398328,"912,278.33",321760
,20160613,2300,2290,2295,2379,2285,2336,2345,46,55,273100,"640,647.83",304466
,20160614,2336,2345,2336,2358,2255,2256,2306,-89,-39,343294,"791,911.14",291258
,20160615,2256,2306,2240,2285,2227,2251,2257,-55,-49,265168,"598,670.86",294214
,20160616,2251,2257,2263,2316,2250,2252,2273,-5,16,315552,"717,451.04",287968
,20160617,2252,2273,2242,2265,2197,2261,2232,-12,-41,306464,"684,313.11",288224
,20160620,2261,2232,2256,2282,2226,2237,2253,5,21,242624,"546,698.30",289106
,20160621,2237,2253,2238,2298,2221,2260,2264,7,11,280246,"634,631.88",279162
,20160622,2260,2264,2255,2322,2250,2314,2296,50,32,305954,"702,739.18",270942
,20160623,2314,2296,2308,2330,2294,2307,2312,11,16,194788,"450,445.19",266972
,20160624,2307,2312,2319,2347,2262,2297,2310,-15,-2,301382,"696,262.23",270152
,20160627,2297,2310,2301,2448,2291,2448,2382,138,72,393408,"937,485.33",290168
,20160628,2448,2382,2460,2469,2405,2443,2441,61,59,248790,"607,400.65",273100
,20160629,2443,2441,2449,2465,2400,2409,2429,-32,-12,259648,"630,691.11",273428
,20160630,2409,2429,2400,2510,2400,2502,2467,73,38,333834,"823,862.22",278650
,20160701,2502,2467,2504,2539,2460,2509,2500,42,33,255002,"637,748.60",277342
,20160704,2509,2500,2501,2610,2501,2566,2562,66,62,366328,"938,748.87",268228
,20160705,2566,2562,2590,2596,2435,2530,2519,-32,-43,362556,"913,401.15",246572
,20160706,2530,2519,2528,2556,2452,2518,2504,-1,-15,331648,"830,697.16",237664
,20160707,2518,2504,2503,2634,2492,2557,2572,53,68,610320,"1,569,814.51",261338
,20160708,2557,2572,2560,2597,2510,2594,2557,22,-15,429176,"1,097,629.20",248820
,20160711,2594,2557,2635,2649,2515,2589,2580,32,23,320672,"827,399.96",248352
,20160712,2589,2580,2595,2712,2574,2699,2648,119,68,382354,"1,012,595.43",258168
,20160713,2699,2648,2701,2745,2656,2664,2699,16,51,318646,"860,082.25",243354
,20160714,2664,2699,2668,2689,2612,2659,2648,-40,-51,272784,"722,561.53",235254
,20160715,2659,2648,2659,2700,2622,2661,2655,13,7,262976,"698,302.40",234062
,20160718,2661,2655,2668,2672,2495,2495,2566,-160,-89,369384,"947,920.79",237720
,20160719,2495,2566,2471,2490,2396,2430,2449,-136,-117,340920,"835,180.92",228862
,20160720,2430,2449,2431,2486,2427,2463,2452,14,3,255380,"626,273.96",225398
,20160721,2463,2452,2457,2599,2434,2572,2524,120,72,495956,"1,252,188.92",214594
,20160722,2572,2524,2580,2580,2485,2495,2530,-29,6,366642,"927,849.96",216572
,20160725,2495,2530,2491,2586,2469,2557,2538,27,8,449156,"1,140,173.68",224154
,20160726,2557,2538,2548,2606,2526,2604,2559,66,21,348164,"891,285.59",247618
,20160727,2604,2559,2607,2670,2576,2623,2623,64,64,595522,"1,562,086.04",256994
,20160728,2623,2623,2631,2684,2615,2674,2655,51,32,465800,"1,236,733.92",256152
,20160729,2674,2655,2670,2681,2575,2599,2630,-56,-25,331492,"872,048.67",248260
,20160801,2599,2630,2605,2719,2572,2700,2665,70,35,416658,"1,110,686.63",258744
,20160802,2700,2665,2708,2708,2665,2689,2686,24,21,266464,"715,846.68",256042
,20160803,2689,2686,2690,2700,2644,2673,2669,-13,-17,274098,"731,711.53",258462
,20160804,2673,2669,2670,2686,2590,2626,2635,-43,-34,352206,"928,102.64",248502
,20160805,2626,2635,2626,2718,2622,2710,2683,75,48,285414,"765,807.67",248914
,20160808,2710,2683,2710,2800,2690,2787,2756,104,73,367034,"1,011,832.60",247228
,20160809,2787,2756,2779,2809,2714,2752,2763,-4,7,273772,"756,650.20",236108
,20160810,2752,2763,2749,2799,2727,2754,2754,-9,-9,238268,"656,235.49",232806
,20160811,2754,2754,2759,2772,2701,2760,2738,6,-16,274784,"752,485.04",224866
,20160812,2760,2738,2758,2765,2723,2747,2748,9,10,172990,"475,498.62",223284
,20160815,2747,2748,2730,2755,2677,2733,2719,-15,-29,273986,"745,130.37",204708
,20160816,2733,2719,2730,2865,2730,2817,2808,98,89,307434,"863,330.67",227822
,20160817,2817,2808,2825,2854,2787,2790,2819,-18,11,235952,"665,212.51",239192
,20160818,2790,2819,2782,2830,2763,2793,2793,-26,-26,254254,"710,196.26",231804
,20160819,2793,2793,2804,2805,2741,2786,2772,-7,-21,228966,"634,874.69",221538
,20160822,2786,2772,2795,2813,2769,2776,2786,4,14,215720,"601,106.11",221486
,20160823,2776,2786,2790,2863,2762,2839,2825,53,39,290494,"820,828.59",248302
,20160824,2839,2825,2843,2848,2817,2825,2831,0,6,138664,"392,669.74",237146
,20160825,2825,2831,2840,2889,2752,2823,2813,-8,-18,271562,"764,039.55",212880
,20160826,2823,2813,2808,2845,2784,2784,2811,-29,-2,167108,"469,828.50",198730
,20160829,2784,2811,2788,2837,2735,2830,2797,19,-14,293080,"819,821.63",192616
,20160830,2830,2797,2830,2848,2778,2780,2816,-17,19,196924,"554,685.29",180330
,20160831,2780,2816,2780,2825,2725,2734,2784,-82,-32,203890,"567,693.87",171044
,20160901,2734,2784,2722,2754,2700,2741,2726,-43,-58,172998,"471,712.67",151892
,20160902,2741,2726,2740,2809,2730,2753,2769,27,43,132818,"367,881.06",138210
,20160905,2753,2769,2763,2788,2738,2749,2760,-20,-9,88878,"245,324.46",119070
,20160906,2749,2760,2749,2766,2714,2730,2735,-30,-25,52246,"142,920.96",112542
,20160907,2730,2735,2730,2738,2686,2693,2707,-42,-28,63244,"171,244.79",106206
,20160908,2693,2707,2699,2729,2684,2718,2709,11,2,47006,"127,362.12",94864
,20160909,2718,2709,2726,2732,2684,2723,2706,14,-3,43896,"118,807.38",85986
,20160912,2723,2706,2700,2718,2680,2682,2697,-24,-9,50372,"135,896.24",72714
,20160913,2682,2697,2689,2708,2669,2682,2687,-15,-10,28198,"75,777.82",62760
,20160914,2682,2687,2685,2708,2678,2689,2693,2,6,19558,"52,669.88",53926
,20160919,2689,2693,2680,2698,2645,2679,2685,-14,-8,17024,"45,715.22",48202
,20160920,2679,2685,2677,2687,2644,2682,2669,-3,-16,18894,"50,433.59",39612
,20160921,2682,2669,2677,2690,2667,2682,2676,13,7,13532,"36,222.11",33314
,20160922,2682,2676,2680,2718,2675,2689,2699,13,23,15124,"40,821.45",27496
,20160923,2689,2699,2708,2722,2692,2720,2711,21,12,5672,"15,382.34",25782
,20160926,2720,2711,2729,2746,2722,2734,2734,23,23,6960,"19,035.43",23928
,20160927,2734,2734,2733,2739,2707,2717,2718,-17,-16,6364,"17,299.34",20116
,20160928,2717,2718,2714,2732,2710,2717,2720,-1,2,3992,"10,860.39",17524
,20160929,2717,2720,2724,2778,2718,2731,2741,11,21,6336,"17,370.59",14432
,20160930,2731,2741,2739,2755,2716,2753,2729,12,-12,5268,"14,381.21",10266
,20161010,2753,2729,2800,2800,2731,2779,2766,50,37,1926,"5,327.65",8520
,20161011,2779,2766,2820,2850,2820,2850,2831,84,65,2520,"7,135.80",6180
,20161012,2850,2831,2850,2881,2850,2880,2869,49,38,1740,"4,992.90",4740
,20161013,2880,2869,2850,2875,2850,2850,2870,-19,1,900,"2,583.00",4620
,20161014,2850,2870,2845,2845,2830,2843,2840,-27,-30,240,681.78,4560
,20161017,2843,2840,,,,2840,2840,0,0,0,0.00,4560
hc1611,20160104,1911,1911,,,,1911,1911,0,0,0,0.00,0
,20160105,1911,1911,,,,1911,1911,0,0,0,0.00,0
,20160106,1911,1911,,,,1911,1911,0,0,0,0.00,0
,20160107,1911,1911,,,,1888,1888,-23,-23,0,0.00,0
,20160108,1888,1888,,,,1862,1862,-26,-26,0,0.00,0
,20160111,1862,1862,,,,1858,1858,-4,-4,0,0.00,0
,20160112,1858,1858,,,,1825,1825,-33,-33,0,0.00,0
,20160113,1825,1825,,,,1825,1825,0,0,0,0.00,0
,20160114,1825,1825,,,,1834,1834,9,9,0,0.00,0
,20160115,1834,1834,,,,1870,1870,36,36,0,0.00,0
,20160118,1870,1870,,,,1896,1896,26,26,0,0.00,0
,20160119,1896,1896,,,,1918,1918,22,22,0,0.00,0
,20160120,1918,1918,,,,1918,1918,0,0,0,0.00,0
,20160121,1918,1918,1870,1870,1870,1870,1870,-48,-48,4,7.48,4
,20160122,1870,1870,,,,1906,1906,36,36,0,0.00,4
,20160125,1906,1906,,,,1906,1906,0,0,0,0.00,4
,20160126,1906,1906,,,,1906,1906,0,0,0,0.00,4
,20160127,1906,1906,,,,1906,1906,0,0,0,0.00,4
,20160128,1906,1906,,,,1906,1906,0,0,0,0.00,4
,20160129,1906,1906,,,,1906,1906,0,0,0,0.00,4
,20160201,1906,1906,,,,1906,1906,0,0,0,0.00,4
,20160202,1906,1906,,,,1906,1906,0,0,0,0.00,4
,20160203,1906,1906,,,,1906,1906,0,0,0,0.00,4
,20160204,1906,1906,1990,1990,1990,1990,1990,84,84,4,7.96,0
,20160205,1990,1990,,,,2008,2008,18,18,0,0.00,0
,20160215,2008,2008,,,,2016,2016,8,8,0,0.00,0
,20160216,2016,2016,,,,2016,2016,0,0,0,0.00,0
,20160217,2016,2016,,,,2018,2018,2,2,0,0.00,0
,20160218,2018,2018,,,,2018,2018,0,0,0,0.00,0
,20160219,2018,2018,,,,2018,2018,0,0,0,0.00,0
,20160222,2018,2018,,,,2078,2078,60,60,0,0.00,0
,20160223,2078,2078,,,,2078,2078,0,0,0,0.00,0
,20160224,2078,2078,,,,2078,2078,0,0,0,0.00,0
,20160225,2078,2078,,,,2078,2078,0,0,0,0.00,0
,20160226,2078,2078,,,,2049,2049,-29,-29,0,0.00,0
,20160229,2049,2049,,,,2049,2049,0,0,0,0.00,0
,20160301,2049,2049,2020,2118,2020,2080,2060,31,11,14,28.85,0
,20160302,2080,2060,,,,2060,2060,0,0,0,0.00,0
,20160303,2060,2060,,,,2071,2071,11,11,0,0.00,0
,20160304,2071,2071,,,,2091,2091,20,20,0,0.00,0
,20160307,2091,2091,,,,2156,2156,65,65,0,0.00,0
,20160308,2156,2156,,,,2263,2263,107,107,0,0.00,0
,20160309,2263,2263,,,,2173,2173,-90,-90,0,0.00,0
,20160310,2173,2173,,,,2200,2200,27,27,0,0.00,0
,20160311,2200,2200,,,,2150,2150,-50,-50,0,0.00,0
,20160314,2150,2150,,,,2117,2117,-33,-33,0,0.00,0
,20160315,2117,2117,,,,2077,2077,-40,-40,0,0.00,0
,20160316,2077,2077,,,,2079,2079,2,2,0,0.00,0
,20160317,2079,2079,,,,2130,2130,51,51,0,0.00,0
,20160318,2130,2130,,,,2196,2196,66,66,0,0.00,0
,20160321,2196,2196,,,,2224,2224,28,28,0,0.00,0
,20160322,2224,2224,,,,2239,2239,15,15,0,0.00,0
,20160323,2239,2239,,,,2271,2271,32,32,0,0.00,0
,20160324,2271,2271,,,,2221,2221,-50,-50,0,0.00,0
,20160325,2221,2221,,,,2214,2214,-7,-7,0,0.00,0
,20160328,2214,2214,,,,2245,2245,31,31,0,0.00,0
,20160329,2245,2245,,,,2211,2211,-34,-34,0,0.00,0
,20160330,2211,2211,,,,2185,2185,-26,-26,0,0.00,0
,20160331,2185,2185,,,,2190,2190,5,5,0,0.00,0
,20160401,2190,2190,,,,2243,2243,53,53,0,0.00,0
,20160405,2243,2243,,,,2272,2272,29,29,0,0.00,0
,20160406,2272,2272,,,,2293,2293,21,21,0,0.00,0
,20160407,2293,2293,,,,2284,2284,-9,-9,0,0.00,0
,20160408,2284,2284,,,,2298,2298,14,14,0,0.00,0
,20160411,2298,2298,2350,2355,2341,2355,2349,57,51,30,70.49,0
,20160412,2355,2349,2370,2488,2370,2488,2426,139,77,12,29.12,0
,20160413,2488,2426,2431,2570,2431,2570,2507,144,81,8,20.06,2
,20160414,2570,2507,,,,2507,2507,0,0,0,0.00,2
,20160415,2507,2507,,,,2507,2507,0,0,0,0.00,2
,20160418,2507,2507,,,,2507,2507,0,0,0,0.00,2
,20160419,2507,2507,,,,2621,2621,114,114,0,0.00,2
,20160420,2621,2621,,,,2748,2748,127,127,0,0.00,2
,20160421,2748,2748,2840,2840,2840,2840,2840,92,92,2,5.68,0
,20160422,2840,2840,,,,2840,2840,0,0,0,0.00,0
,20160425,2840,2840,,,,2840,2840,0,0,0,0.00,0
,20160426,2840,2840,,,,2744,2744,-96,-96,0,0.00,0
,20160427,2744,2744,,,,2635,2635,-109,-109,0,0.00,0
,20160428,2635,2635,,,,2635,2635,0,0,0,0.00,0
,20160429,2635,2635,,,,2646,2646,11,11,0,0.00,0
,20160503,2646,2646,,,,2515,2515,-131,-131,0,0.00,0
,20160504,2515,2515,,,,2515,2515,0,0,0,0.00,0
,20160505,2515,2515,,,,2515,2515,0,0,0,0.00,0
,20160506,2515,2515,,,,2515,2515,0,0,0,0.00,0
,20160509,2515,2515,,,,2463,2463,-52,-52,0,0.00,0
,20160510,2463,2463,,,,2329,2329,-134,-134,0,0.00,0
,20160511,2329,2329,,,,2329,2329,0,0,0,0.00,0
,20160512,2329,2329,2267,2267,2189,2189,2199,-140,-130,46,101.16,46
,20160513,2189,2199,2151,2330,2151,2186,2247,-13,48,62,139.33,14
,20160516,2186,2247,2211,2211,2211,2211,2211,-36,-36,10,22.11,4
,20160517,2211,2211,,,,2243,2243,32,32,0,0.00,4
,20160518,2243,2243,,,,2243,2243,0,0,0,0.00,4
,20160519,2243,2243,,,,2202,2202,-41,-41,0,0.00,4
,20160520,2202,2202,,,,2202,2202,0,0,0,0.00,4
,20160523,2202,2202,,,,2124,2124,-78,-78,0,0.00,4
,20160524,2124,2124,,,,2092,2092,-32,-32,0,0.00,4
,20160525,2092,2092,,,,2099,2099,7,7,0,0.00,4
,20160526,2099,2099,,,,2095,2095,-4,-4,0,0.00,4
,20160527,2095,2095,,,,2163,2163,68,68,0,0.00,4
,20160530,2163,2163,,,,2186,2186,23,23,0,0.00,4
,20160531,2186,2186,,,,2186,2186,0,0,0,0.00,4
,20160601,2186,2186,,,,2186,2186,0,0,0,0.00,4
,20160602,2186,2186,2227,2227,2227,2227,2227,41,41,2,4.45,6
,20160603,2227,2227,2175,2175,2175,2175,2175,-52,-52,2,4.35,4
,20160606,2175,2175,2235,2250,2235,2250,2242,75,67,4,8.97,4
,20160607,2250,2242,2349,2349,2253,2253,2301,11,59,4,9.20,4
,20160608,2253,2301,,,,2301,2301,0,0,0,0.00,4
,20160613,2301,2301,2265,2265,2265,2265,2265,-36,-36,2,4.53,4
,20160614,2265,2265,,,,2265,2265,0,0,0,0.00,4
,20160615,2265,2265,,,,2265,2265,0,0,0,0.00,4
,20160616,2265,2265,,,,2265,2265,0,0,0,0.00,4
,20160617,2265,2265,,,,2265,2265,0,0,0,0.00,4
,20160620,2265,2265,,,,2265,2265,0,0,0,0.00,4
,20160621,2265,2265,,,,2265,2265,0,0,0,0.00,4
,20160622,2265,2265,,,,2265,2265,0,0,0,0.00,4
,20160623,2265,2265,,,,2303,2303,38,38,0,0.00,4
,20160624,2303,2303,,,,2301,2301,-2,-2,0,0.00,4
,20160627,2301,2301,2350,2350,2350,2350,2350,49,49,2,4.70,2
,20160628,2350,2350,,,,2408,2408,58,58,0,0.00,2
,20160629,2408,2408,2453,2453,2343,2343,2398,-65,-10,4,9.59,2
,20160630,2343,2398,,,,2436,2436,38,38,0,0.00,2
,20160701,2436,2436,,,,2469,2469,33,33,0,0.00,2
,20160704,2469,2469,,,,2530,2530,61,61,0,0.00,2
,20160705,2530,2530,,,,2530,2530,0,0,0,0.00,2
,20160706,2530,2530,,,,2506,2506,-24,-24,0,0.00,2
,20160707,2506,2506,2511,2511,2511,2511,2511,5,5,2,5.02,2
,20160708,2511,2511,,,,2496,2496,-15,-15,0,0.00,2
,20160711,2496,2496,,,,2518,2518,22,22,0,0.00,2
,20160712,2518,2518,,,,2584,2584,66,66,0,0.00,2
,20160713,2584,2584,2688,2688,2688,2688,2688,104,104,2,5.38,0
,20160714,2688,2688,,,,2638,2638,-50,-50,0,0.00,0
,20160715,2638,2638,,,,2638,2638,0,0,0,0.00,0
,20160718,2638,2638,,,,2549,2549,-89,-89,0,0.00,0
,20160719,2549,2549,,,,2433,2433,-116,-116,0,0.00,0
,20160720,2433,2433,,,,2433,2433,0,0,0,0.00,0
,20160721,2433,2433,,,,2505,2505,72,72,0,0.00,0
,20160722,2505,2505,2587,2587,2587,2587,2587,82,82,2,5.17,2
,20160725,2587,2587,,,,2587,2587,0,0,0,0.00,2
,20160726,2587,2587,,,,2587,2587,0,0,0,0.00,2
,20160727,2587,2587,2576,2576,2576,2576,2576,-11,-11,2,5.15,0
,20160728,2576,2576,,,,2576,2576,0,0,0,0.00,0
,20160729,2576,2576,,,,2576,2576,0,0,0,0.00,0
,20160801,2576,2576,,,,2576,2576,0,0,0,0.00,0
,20160802,2576,2576,,,,2576,2576,0,0,0,0.00,0
,20160803,2576,2576,,,,2576,2576,0,0,0,0.00,0
,20160804,2576,2576,,,,2576,2576,0,0,0,0.00,0
,20160805,2576,2576,,,,2623,2623,47,47,0,0.00,0
,20160808,2623,2623,,,,2695,2695,72,72,0,0.00,0
,20160809,2695,2695,,,,2695,2695,0,0,0,0.00,0
,20160810,2695,2695,2745,2755,2745,2755,2750,60,55,4,11.00,0
,20160811,2755,2750,,,,2750,2750,0,0,0,0.00,0
,20160812,2750,2750,,,,2750,2750,0,0,0,0.00,0
,20160815,2750,2750,,,,2750,2750,0,0,0,0.00,0
,20160816,2750,2750,,,,2750,2750,0,0,0,0.00,0
,20160817,2750,2750,,,,2750,2750,0,0,0,0.00,0
,20160818,2750,2750,,,,2750,2750,0,0,0,0.00,0
,20160819,2750,2750,,,,2750,2750,0,0,0,0.00,0
,20160822,2750,2750,,,,2750,2750,0,0,0,0.00,0
,20160823,2750,2750,,,,2771,2771,21,21,0,0.00,0
,20160824,2771,2771,,,,2771,2771,0,0,0,0.00,0
,20160825,2771,2771,,,,2771,2771,0,0,0,0.00,0
,20160826,2771,2771,,,,2771,2771,0,0,0,0.00,0
,20160829,2771,2771,,,,2771,2771,0,0,0,0.00,0
,20160830,2771,2771,,,,2771,2771,0,0,0,0.00,0
,20160831,2771,2771,,,,2739,2739,-32,-32,0,0.00,0
,20160901,2739,2739,,,,2739,2739,0,0,0,0.00,0
,20160902,2739,2739,,,,2739,2739,0,0,0,0.00,0
,20160905,2739,2739,2822,2822,2724,2724,2766,-15,27,10,27.66,0
,20160906,2724,2766,2653,2777,2625,2700,2688,-66,-78,8,21.51,0
,20160907,2700,2688,,,,2661,2661,-27,-27,0,0.00,0
,20160908,2661,2661,,,,2661,2661,0,0,0,0.00,0
,20160909,2661,2661,,,,2661,2661,0,0,0,0.00,0
,20160912,2661,2661,,,,2661,2661,0,0,0,0.00,0
,20160913,2661,2661,,,,2651,2651,-10,-10,0,0.00,0
,20160914,2651,2651,,,,2651,2651,0,0,0,0.00,0
,20160919,2651,2651,,,,2643,2643,-8,-8,0,0.00,0
,20160920,2643,2643,2667,2667,2495,2495,2581,-148,-62,4,10.32,2
,20160921,2495,2581,,,,2581,2581,0,0,0,0.00,2
,20160922,2581,2581,,,,2581,2581,0,0,0,0.00,2
,20160923,2581,2581,,,,2593,2593,12,12,0,0.00,2
,20160926,2593,2593,,,,2615,2615,22,22,0,0.00,2
,20160927,2615,2615,,,,2615,2615,0,0,0,0.00,2
,20160928,2615,2615,,,,2615,2615,0,0,0,0.00,2
,20160929,2615,2615,,,,2615,2615,0,0,0,0.00,2
,20160930,2615,2615,,,,2604,2604,-11,-11,0,0.00,2
,20161010,2604,2604,,,,2604,2604,0,0,0,0.00,2
,20161011,2604,2604,2749,2759,2625,2695,2716,91,112,32,86.94,2
,20161012,2695,2716,2732,2750,2717,2739,2734,23,18,8,21.88,2
,20161013,2739,2734,2751,2751,2751,2751,2751,17,17,2,5.50,0
,20161014,2751,2751,,,,2751,2751,0,0,0,0.00,0
,20161017,2751,2751,,,,2751,2751,0,0,0,0.00,0
,20161018,2751,2751,,,,2751,2751,0,0,0,0.00,0
,20161019,2751,2751,,,,2751,2751,0,0,0,0.00,0
,20161020,2751,2751,,,,2751,2751,0,0,0,0.00,0
,20161021,2751,2751,,,,2751,2751,0,0,0,0.00,0
,20161024,2751,2751,,,,2751,2751,0,0,0,0.00,0
,20161025,2751,2751,,,,2751,2751,0,0,0,0.00,0
,20161026,2751,2751,,,,2751,2751,0,0,0,0.00,0
,20161027,2751,2751,,,,2751,2751,0,0,0,0.00,0
,20161028,2751,2751,2916,2916,2797,2797,2871,46,120,14,40.20,2
,20161031,2797,2871,3042,3042,3042,3042,3042,171,171,2,6.08,0
,20161101,3042,3042,,,,3042,3042,0,0,0,0.00,0
,20161102,3042,3042,,,,3042,3042,0,0,0,0.00,0
,20161103,3042,3042,,,,3042,3042,0,0,0,0.00,0
,20161104,3042,3042,,,,3042,3042,0,0,0,0.00,0
,20161107,3042,3042,,,,3042,3042,0,0,0,0.00,0
,20161108,3042,3042,,,,3042,3042,0,0,0,0.00,0
,20161109,3042,3042,,,,3042,3042,0,0,0,0.00,0
,20161110,3042,3042,,,,3042,3042,0,0,0,0.00,0
,20161111,3042,3042,,,,3042,3042,0,0,0,0.00,0
,20161114,3042,3042,,,,3042,3042,0,0,0,0.00,0
,20161115,3042,3042,,,,3042,3042,0,0,0,0.00,0
hc1612,20160104,1899,1899,,,,1899,1899,0,0,0,0.00,0
,20160105,1899,1899,,,,1899,1899,0,0,0,0.00,0
,20160106,1899,1899,,,,1899,1899,0,0,0,0.00,0
,20160107,1899,1899,,,,1877,1877,-22,-22,0,0.00,0
,20160108,1877,1877,,,,1877,1877,0,0,0,0.00,0
,20160111,1877,1877,,,,1873,1873,-4,-4,0,0.00,0
,20160112,1873,1873,,,,1873,1873,0,0,0,0.00,0
,20160113,1873,1873,1940,1943,1940,1943,1942,70,69,8,15.54,8
,20160114,1943,1942,,,,1942,1942,0,0,0,0.00,8
,20160115,1942,1942,,,,1942,1942,0,0,0,0.00,8
,20160118,1942,1942,,,,1969,1969,27,27,0,0.00,8
,20160119,1969,1969,,,,1969,1969,0,0,0,0.00,8
,20160120,1969,1969,,,,1969,1969,0,0,0,0.00,8
,20160121,1969,1969,,,,1919,1919,-50,-50,0,0.00,8
,20160122,1919,1919,,,,1944,1944,25,25,0,0.00,8
,20160125,1944,1944,,,,1949,1949,5,5,0,0.00,8
,20160126,1949,1949,,,,1949,1949,0,0,0,0.00,8
,20160127,1949,1949,,,,1949,1949,0,0,0,0.00,8
,20160128,1949,1949,,,,1932,1932,-17,-17,0,0.00,8
,20160129,1932,1932,,,,1932,1932,0,0,0,0.00,8
,20160201,1932,1932,,,,1932,1932,0,0,0,0.00,8
,20160202,1932,1932,,,,1932,1932,0,0,0,0.00,8
,20160203,1932,1932,,,,1932,1932,0,0,0,0.00,8
,20160204,1932,1932,,,,2017,2017,85,85,0,0.00,8
,20160205,2017,2017,,,,2035,2035,18,18,0,0.00,8
,20160215,2035,2035,,,,2028,2028,-7,-7,0,0.00,8
,20160216,2028,2028,,,,2028,2028,0,0,0,0.00,8
,20160217,2028,2028,,,,2028,2028,0,0,0,0.00,8
,20160218,2028,2028,,,,2028,2028,0,0,0,0.00,8
,20160219,2028,2028,,,,2028,2028,0,0,0,0.00,8
,20160222,2028,2028,,,,2089,2089,61,61,0,0.00,8
,20160223,2089,2089,,,,2089,2089,0,0,0,0.00,8
,20160224,2089,2089,,,,2089,2089,0,0,0,0.00,8
,20160225,2089,2089,,,,2089,2089,0,0,0,0.00,8
,20160226,2089,2089,,,,2089,2089,0,0,0,0.00,8
,20160229,2089,2089,,,,2089,2089,0,0,0,0.00,8
,20160301,2089,2089,,,,2101,2101,12,12,0,0.00,8
,20160302,2101,2101,,,,2101,2101,0,0,0,0.00,8
,20160303,2101,2101,,,,2101,2101,0,0,0,0.00,8
,20160304,2101,2101,2181,2181,2181,2181,2181,80,80,2,4.36,10
,20160307,2181,2181,,,,2249,2249,68,68,0,0.00,10
,20160308,2249,2249,2265,2294,2265,2294,2284,45,35,6,13.71,8
,20160309,2294,2284,2221,2221,2221,2221,2221,-63,-63,2,4.44,8
,20160310,2221,2221,,,,2249,2249,28,28,0,0.00,8
,20160311,2249,2249,2136,2290,2136,2290,2203,41,-46,6,13.22,8
,20160314,2290,2203,,,,2203,2203,0,0,0,0.00,8
,20160315,2203,2203,2141,2215,2093,2153,2151,-50,-52,12,25.82,4
,20160316,2153,2151,2102,2102,2102,2102,2102,-49,-49,24,50.45,20
,20160317,2102,2102,2182,2182,2178,2178,2178,76,76,22,47.93,2
,20160318,2178,2178,,,,2245,2245,67,67,0,0.00,2
,20160321,2245,2245,2311,2311,2311,2311,2311,66,66,2,4.62,0
,20160322,2311,2311,,,,2326,2326,15,15,0,0.00,0
,20160323,2326,2326,2237,2237,2237,2237,2237,-89,-89,2,4.47,2
,20160324,2237,2237,2308,2308,2308,2308,2308,71,71,2,4.62,2
,20160325,2308,2308,,,,2308,2308,0,0,0,0.00,2
,20160328,2308,2308,,,,2300,2300,-8,-8,0,0.00,2
,20160329,2300,2300,,,,2300,2300,0,0,0,0.00,2
,20160330,2300,2300,,,,2273,2273,-27,-27,0,0.00,2
,20160331,2273,2273,,,,2273,2273,0,0,0,0.00,2
,20160401,2273,2273,,,,2329,2329,56,56,0,0.00,2
,20160405,2329,2329,,,,2320,2320,-9,-9,0,0.00,2
,20160406,2320,2320,,,,2320,2320,0,0,0,0.00,2
,20160407,2320,2320,,,,2320,2320,0,0,0,0.00,2
,20160408,2320,2320,,,,2320,2320,0,0,0,0.00,2
,20160411,2320,2320,,,,2372,2372,52,52,0,0.00,2
,20160412,2372,2372,2361,2496,2361,2434,2430,62,58,6,14.58,2
,20160413,2434,2430,,,,2430,2430,0,0,0,0.00,2
,20160414,2430,2430,,,,2430,2430,0,0,0,0.00,2
,20160415,2430,2430,,,,2430,2430,0,0,0,0.00,2
,20160418,2430,2430,,,,2434,2434,4,4,0,0.00,2
,20160419,2434,2434,,,,2544,2544,110,110,0,0.00,2
,20160420,2544,2544,,,,2667,2667,123,123,0,0.00,2
,20160421,2667,2667,,,,2756,2756,89,89,0,0.00,2
,20160422,2756,2756,,,,2756,2756,0,0,0,0.00,2
,20160425,2756,2756,,,,2756,2756,0,0,0,0.00,2
,20160426,2756,2756,,,,2663,2663,-93,-93,0,0.00,2
,20160427,2663,2663,,,,2663,2663,0,0,0,0.00,2
,20160428,2663,2663,2611,2688,2611,2688,2649,25,-14,8,21.20,4
,20160429,2688,2649,,,,2649,2649,0,0,0,0.00,4
,20160503,2649,2649,2560,2613,2500,2500,2557,-149,-92,6,15.35,4
,20160504,2500,2557,,,,2530,2530,-27,-27,0,0.00,4
,20160505,2530,2530,,,,2530,2530,0,0,0,0.00,4
,20160506,2530,2530,2530,2542,2404,2413,2476,-117,-54,84,208.04,14
,20160509,2413,2476,2446,2472,2332,2332,2385,-144,-91,16,38.17,14
,20160510,2332,2385,2284,2284,2283,2283,2283,-102,-102,8,18.27,6
,20160511,2283,2283,,,,2283,2283,0,0,0,0.00,6
,20160512,2283,2283,2349,2349,2267,2267,2308,-16,25,4,9.23,6
,20160513,2267,2308,,,,2358,2358,50,50,0,0.00,6
,20160516,2358,2358,,,,2320,2320,-38,-38,0,0.00,6
,20160517,2320,2320,,,,2354,2354,34,34,0,0.00,6
,20160518,2354,2354,,,,2360,2360,6,6,0,0.00,6
,20160519,2360,2360,,,,2317,2317,-43,-43,0,0.00,6
,20160520,2317,2317,,,,2317,2317,0,0,0,0.00,6
,20160523,2317,2317,,,,2234,2234,-83,-83,0,0.00,6
,20160524,2234,2234,,,,2200,2200,-34,-34,0,0.00,6
,20160525,2200,2200,,,,2207,2207,7,7,0,0.00,6
,20160526,2207,2207,,,,2207,2207,0,0,0,0.00,6
,20160527,2207,2207,2320,2320,2200,2250,2267,43,60,8,18.14,6
,20160530,2250,2267,,,,2267,2267,0,0,0,0.00,6
,20160531,2267,2267,,,,2267,2267,0,0,0,0.00,6
,20160601,2267,2267,,,,2205,2205,-62,-62,0,0.00,6
,20160602,2205,2205,,,,2205,2205,0,0,0,0.00,6
,20160603,2205,2205,,,,2201,2201,-4,-4,0,0.00,6
,20160606,2201,2201,,,,2201,2201,0,0,0,0.00,6
,20160607,2201,2201,,,,2201,2201,0,0,0,0.00,6
,20160608,2201,2201,2304,2304,2304,2304,2304,103,103,2,4.61,4
,20160613,2304,2304,,,,2304,2304,0,0,0,0.00,4
,20160614,2304,2304,,,,2304,2304,0,0,0,0.00,4
,20160615,2304,2304,,,,2304,2304,0,0,0,0.00,4
,20160616,2304,2304,,,,2304,2304,0,0,0,0.00,4
,20160617,2304,2304,,,,2304,2304,0,0,0,0.00,4
,20160620,2304,2304,,,,2304,2304,0,0,0,0.00,4
,20160621,2304,2304,,,,2304,2304,0,0,0,0.00,4
,20160622,2304,2304,,,,2304,2304,0,0,0,0.00,4
,20160623,2304,2304,,,,2304,2304,0,0,0,0.00,4
,20160624,2304,2304,,,,2302,2302,-2,-2,0,0.00,4
,20160627,2302,2302,,,,2351,2351,49,49,0,0.00,4
,20160628,2351,2351,2351,2351,2351,2351,2351,0,0,4,9.40,4
,20160629,2351,2351,,,,2351,2351,0,0,0,0.00,4
,20160630,2351,2351,,,,2398,2398,47,47,0,0.00,4
,20160701,2398,2398,,,,2400,2400,2,2,0,0.00,4
,20160704,2400,2400,,,,2460,2460,60,60,0,0.00,4
,20160705,2460,2460,,,,2460,2460,0,0,0,0.00,4
,20160706,2460,2460,,,,2460,2460,0,0,0,0.00,4
,20160707,2460,2460,,,,2464,2464,4,4,0,0.00,4
,20160708,2464,2464,2464,2551,2464,2551,2501,87,37,30,75.04,6
,20160711,2551,2501,2488,2488,2488,2488,2488,-13,-13,2,4.98,4
,20160712,2488,2488,,,,2553,2553,65,65,0,0.00,4
,20160713,2553,2553,,,,2553,2553,0,0,0,0.00,4
,20160714,2553,2553,,,,2553,2553,0,0,0,0.00,4
,20160715,2553,2553,,,,2553,2553,0,0,0,0.00,4
,20160718,2553,2553,,,,2467,2467,-86,-86,0,0.00,4
,20160719,2467,2467,,,,2467,2467,0,0,0,0.00,4
,20160720,2467,2467,,,,2467,2467,0,0,0,0.00,4
,20160721,2467,2467,2528,2528,2520,2520,2524,53,57,4,10.10,4
,20160722,2520,2524,,,,2524,2524,0,0,0,0.00,4
,20160725,2524,2524,,,,2524,2524,0,0,0,0.00,4
,20160726,2524,2524,,,,2524,2524,0,0,0,0.00,4
,20160727,2524,2524,,,,2524,2524,0,0,0,0.00,4
,20160728,2524,2524,,,,2554,2554,30,30,0,0.00,4
,20160729,2554,2554,,,,2554,2554,0,0,0,0.00,4
,20160801,2554,2554,,,,2588,2588,34,34,0,0.00,4
,20160802,2588,2588,,,,2600,2600,12,12,0,0.00,4
,20160803,2600,2600,,,,2600,2600,0,0,0,0.00,4
,20160804,2600,2600,,,,2600,2600,0,0,0,0.00,4
,20160805,2600,2600,2587,2587,2587,2587,2587,-13,-13,2,5.17,4
,20160808,2587,2587,2741,2741,2741,2741,2741,154,154,2,5.48,2
,20160809,2741,2741,2791,2791,2685,2685,2755,-56,14,6,16.53,4
,20160810,2685,2755,,,,2755,2755,0,0,0,0.00,4
,20160811,2755,2755,2721,2745,2679,2697,2710,-58,-45,8,21.68,4
,20160812,2697,2710,,,,2710,2710,0,0,0,0.00,4
,20160815,2710,2710,,,,2710,2710,0,0,0,0.00,4
,20160816,2710,2710,,,,2710,2710,0,0,0,0.00,4
,20160817,2710,2710,2702,2744,2702,2744,2731,34,21,8,21.85,4
,20160818,2744,2731,,,,2731,2731,0,0,0,0.00,4
,20160819,2731,2731,,,,2731,2731,0,0,0,0.00,4
,20160822,2731,2731,,,,2731,2731,0,0,0,0.00,4
,20160823,2731,2731,,,,2760,2760,29,29,0,0.00,4
,20160824,2760,2760,,,,2780,2780,20,20,0,0.00,4
,20160825,2780,2780,,,,2780,2780,0,0,0,0.00,4
,20160826,2780,2780,2766,2832,2712,2712,2742,-68,-38,18,49.36,14
,20160829,2712,2742,2742,2785,2683,2710,2750,-32,8,26,71.52,4
,20160830,2710,2750,2751,2781,2698,2766,2749,16,-1,8,21.99,2
,20160831,2766,2749,,,,2718,2718,-31,-31,0,0.00,2
,20160901,2718,2718,,,,2718,2718,0,0,0,0.00,2
,20160902,2718,2718,,,,2718,2718,0,0,0,0.00,2
,20160905,2718,2718,,,,2718,2718,0,0,0,0.00,2
,20160906,2718,2718,,,,2718,2718,0,0,0,0.00,2
,20160907,2718,2718,,,,2690,2690,-28,-28,0,0.00,2
,20160908,2690,2690,,,,2692,2692,2,2,0,0.00,2
,20160909,2692,2692,2692,2692,2582,2637,2637,-55,-55,14,36.92,4
,20160912,2637,2637,2614,2614,2614,2614,2614,-23,-23,2,5.23,2
,20160913,2614,2614,,,,2605,2605,-9,-9,0,0.00,2
,20160914,2605,2605,2537,2537,2508,2508,2522,-97,-83,12,30.27,12
,20160919,2508,2522,2547,2548,2547,2548,2547,26,25,8,20.38,12
,20160920,2548,2547,2499,2499,2499,2499,2499,-48,-48,2,5.00,14
,20160921,2499,2499,,,,2505,2505,6,6,0,0.00,14
,20160922,2505,2505,,,,2532,2532,27,27,0,0.00,14
,20160923,2532,2532,,,,2555,2555,23,23,0,0.00,14
,20160926,2555,2555,,,,2580,2580,25,25,0,0.00,14
,20160927,2580,2580,,,,2580,2580,0,0,0,0.00,14
,20160928,2580,2580,2640,2640,2640,2640,2640,60,60,12,31.68,2
,20160929,2640,2640,,,,2629,2629,-11,-11,0,0.00,2
,20160930,2629,2629,,,,2610,2610,-19,-19,0,0.00,2
,20161010,2610,2610,,,,2609,2609,-1,-1,0,0.00,2
,20161011,2609,2609,,,,2621,2621,12,12,0,0.00,2
,20161012,2621,2621,2745,2745,2742,2742,2744,121,123,6,16.46,0
,20161013,2742,2744,,,,2744,2744,0,0,0,0.00,0
,20161014,2744,2744,2675,2675,2675,2675,2675,-69,-69,20,53.50,20
,20161017,2675,2675,,,,2706,2706,31,31,0,0.00,20
,20161018,2706,2706,,,,2706,2706,0,0,0,0.00,20
,20161019,2706,2706,,,,2735,2735,29,29,0,0.00,20
,20161020,2735,2735,,,,2771,2771,36,36,0,0.00,20
,20161021,2771,2771,,,,2771,2771,0,0,0,0.00,20
,20161024,2771,2771,,,,2771,2771,0,0,0,0.00,20
,20161025,2771,2771,,,,2850,2850,79,79,0,0.00,20
,20161026,2850,2850,2850,2850,2845,2845,2847,-5,-3,4,11.39,20
,20161027,2845,2847,,,,2847,2847,0,0,0,0.00,20
,20161028,2847,2847,2959,2959,2959,2959,2959,112,112,2,5.92,20
,20161031,2959,2959,2965,2965,2965,2965,2965,6,6,2,5.93,20
,20161101,2965,2965,,,,2999,2999,34,34,0,0.00,20
,20161102,2999,2999,,,,3020,3020,21,21,0,0.00,20
,20161103,3020,3020,,,,3060,3060,40,40,0,0.00,20
,20161104,3060,3060,,,,3060,3060,0,0,0,0.00,20
,20161107,3060,3060,3243,3243,3243,3243,3243,183,183,2,6.49,22
,20161108,3243,3243,3328,3328,3324,3324,3324,81,81,18,59.85,22
,20161109,3324,3324,,,,3342,3342,18,18,0,0.00,22
,20161110,3342,3342,,,,3342,3342,0,0,0,0.00,22
,20161111,3342,3342,,,,3450,3450,108,108,0,0.00,22
,20161114,3450,3450,3370,3370,3370,3370,3370,-80,-80,20,67.40,2
,20161115,3370,3370,,,,3370,3370,0,0,0,0.00,2
,20161116,3370,3370,3167,3167,3167,3167,3167,-203,-203,2,6.33,2
,20161117,3167,3167,,,,3167,3167,0,0,0,0.00,2
,20161118,3167,3167,,,,3167,3167,0,0,0,0.00,2
,20161121,3167,3167,,,,3167,3167,0,0,0,0.00,2
,20161122,3167,3167,,,,3167,3167,0,0,0,0.00,2
,20161123,3167,3167,3356,3357,3310,3357,3353,190,186,28,93.90,24
,20161124,3357,3353,3440,3441,3440,3441,3440,88,87,10,34.40,20
,20161125,3441,3440,3679,3679,3679,3679,3679,239,239,2,7.36,20
,20161128,3679,3679,,,,3679,3679,0,0,0,0.00,20
,20161129,3679,3679,3510,3510,3510,3510,3510,-169,-169,2,7.02,20
,20161130,3510,3510,3341,3755,3268,3400,3475,-110,-35,42,145.98,0
,20161201,3400,3475,,,,3475,3475,0,0,0,0.00,0
,20161202,3475,3475,,,,3475,3475,0,0,0,0.00,0
,20161205,3475,3475,,,,3475,3475,0,0,0,0.00,0
,20161206,3475,3475,,,,3475,3475,0,0,0,0.00,0
,20161207,3475,3475,,,,3475,3475,0,0,0,0.00,0
,20161208,3475,3475,,,,3475,3475,0,0,0,0.00,0
,20161209,3475,3475,,,,3475,3475,0,0,0,0.00,0
,20161212,3475,3475,,,,3475,3475,0,0,0,0.00,0
,20161213,3475,3475,,,,3475,3475,0,0,0,0.00,0
,20161214,3475,3475,,,,3475,3475,0,0,0,0.00,0
,20161215,3475,3475,,,,3475,3475,0,0,0,0.00,0
hc1701,20160118,1942,1942,1900,1930,1900,1930,1928,-12,-14,40,77.14,38
,20160119,1930,1928,,,,1934,1934,6,6,0,0.00,38
,20160120,1934,1934,,,,1934,1934,0,0,0,0.00,38
,20160121,1934,1934,,,,1934,1934,0,0,0,0.00,38
,20160122,1934,1934,,,,1934,1934,0,0,0,0.00,38
,20160125,1934,1934,,,,1934,1934,0,0,0,0.00,38
,20160126,1934,1934,,,,1934,1934,0,0,0,0.00,38
,20160127,1934,1934,1979,1979,1914,1958,1953,24,19,18,35.17,42
,20160128,1958,1953,1932,1932,1900,1900,1915,-53,-38,24,45.97,48
,20160129,1900,1915,1947,1947,1922,1922,1934,7,19,12,23.22,48
,20160201,1922,1934,1880,1919,1880,1919,1906,-15,-28,6,11.44,50
,20160202,1919,1906,,,,1906,1906,0,0,0,0.00,50
,20160203,1906,1906,1900,1948,1900,1948,1939,42,33,14,27.15,54
,20160204,1948,1939,,,,1940,1940,1,1,0,0.00,54
,20160205,1940,1940,,,,1957,1957,17,17,0,0.00,54
,20160215,1957,1957,,,,1957,1957,0,0,0,0.00,54
,20160216,1957,1957,,,,1957,1957,0,0,0,0.00,54
,20160217,1957,1957,1947,1986,1939,1965,1959,8,2,10,19.59,54
,20160218,1965,1959,1958,1958,1958,1958,1958,-1,-1,2,3.92,54
,20160219,1958,1958,1975,1977,1975,1977,1976,19,18,4,7.90,54
,20160222,1977,1976,1995,2060,1980,2055,2018,79,42,30,60.56,72
,20160223,2055,2018,2099,2099,2029,2031,2048,13,30,58,118.80,112
,20160224,2031,2048,,,,2048,2048,0,0,0,0.00,112
,20160225,2048,2048,2078,2078,2047,2047,2051,-1,3,40,82.04,140
,20160226,2047,2051,2000,2010,2000,2010,2004,-41,-47,14,28.06,142
,20160229,2010,2004,2042,2042,2042,2042,2042,38,38,4,8.17,142
,20160301,2042,2042,2089,2089,2089,2089,2089,47,47,2,4.18,142
,20160302,2089,2089,2069,2088,2035,2035,2066,-54,-23,16,33.06,142
,20160303,2035,2066,2087,2095,2087,2095,2092,29,26,6,12.55,142
,20160304,2095,2092,2086,2146,2086,2146,2109,54,17,120,253.16,178
,20160307,2146,2109,2142,2185,2142,2185,2161,76,52,18,38.91,182
,20160308,2185,2161,2248,2269,2196,2269,2261,108,100,92,208.02,180
,20160309,2269,2261,2264,2264,2101,2178,2123,-83,-138,530,"1,125.20",512
,20160310,2178,2123,2228,2229,2151,2199,2209,76,86,1076,"2,376.95",734
,20160311,2199,2209,2197,2209,2152,2152,2192,-57,-17,3250,"7,124.23",3420
,20160314,2152,2192,2140,2206,2139,2146,2160,-46,-32,74,159.86,3428
,20160315,2146,2160,2068,2138,2068,2110,2124,-50,-36,1332,"2,829.35",4512
,20160316,2110,2124,2127,2145,2109,2120,2123,-4,-1,58,123.14,4518
,20160317,2120,2123,2154,2213,2132,2185,2175,62,52,128,278.49,4516
,20160318,2185,2175,2204,2268,2204,2251,2228,76,53,86,191.69,4518
,20160321,2251,2228,2244,2300,2207,2262,2268,34,40,42,95.27,4524
,20160322,2262,2268,2279,2306,2268,2270,2288,2,20,86,196.80,4574
,20160323,2270,2288,2281,2324,2281,2300,2311,12,23,396,915.17,4782
,20160324,2300,2311,2320,2332,2211,2211,2275,-100,-36,946,"2,152.24",5262
,20160325,2211,2275,2236,2259,2221,2259,2245,-16,-30,206,462.64,5292
,20160328,2259,2245,2271,2291,2200,2200,2263,-45,18,1446,"3,273.35",5392
,20160329,2200,2263,2220,2247,2195,2218,2218,-45,-45,872,"1,934.86",5332
,20160330,2218,2218,2219,2220,2155,2180,2187,-38,-31,814,"1,780.84",5390
,20160331,2180,2187,2188,2209,2170,2190,2189,3,2,534,"1,169.27",5522
,20160401,2190,2189,2201,2244,2190,2232,2214,43,25,996,"2,205.84",5550
,20160405,2232,2214,2222,2260,2202,2246,2233,32,19,514,"1,147.87",5540
,20160406,2246,2233,2224,2285,2223,2251,2257,18,24,1444,"3,259.95",5512
,20160407,2251,2257,2245,2283,2240,2270,2259,13,2,1654,"3,737.36",6358
,20160408,2270,2259,2259,2278,2255,2277,2269,18,10,556,"1,262.06",6368
,20160411,2277,2269,2280,2383,2280,2360,2336,91,67,3402,"7,949.78",7274
,20160412,2360,2336,2350,2441,2343,2434,2391,98,55,3630,"8,679.48",7838
,20160413,2434,2391,2440,2531,2423,2483,2469,92,78,4970,"12,275.17",8082
,20160414,2483,2469,2475,2490,2410,2421,2451,-48,-18,3564,"8,738.33",8288
,20160415,2421,2451,2431,2457,2388,2405,2414,-46,-37,17082,"41,248.82",10442
,20160418,2405,2414,2396,2541,2387,2509,2473,95,59,4302,"10,639.65",10690
,20160419,2509,2473,2526,2621,2513,2621,2591,148,118,6844,"17,738.22",11330
,20160420,2621,2591,2680,2755,2640,2745,2693,154,102,13694,"36,890.23",12954
,20160421,2745,2693,2740,2854,2711,2854,2786,161,93,10624,"29,603.85",11662
,20160422,2854,2786,2840,2840,2688,2732,2745,-54,-41,7738,"21,247.10",11540
,20160425,2732,2745,2704,2873,2691,2738,2759,-7,14,5684,"15,686.44",11260
,20160426,2738,2759,2729,2729,2610,2622,2647,-137,-112,10090,"26,717.66",13776
,20160427,2622,2647,2610,2643,2525,2584,2577,-63,-70,5210,"13,426.67",14306
,20160428,2584,2577,2588,2635,2544,2630,2594,53,17,4462,"11,578.44",15076
,20160429,2630,2594,2595,2690,2595,2665,2663,71,69,4396,"11,708.40",15434
,20160503,2665,2663,2650,2650,2505,2514,2538,-149,-125,7910,"20,083.47",17108
,20160504,2514,2538,2510,2513,2430,2453,2480,-85,-58,5202,"12,904.84",17404
,20160505,2453,2480,2468,2485,2377,2379,2437,-101,-43,5344,"13,024.39",17742
,20160506,2379,2437,2383,2419,2347,2417,2385,-20,-52,5442,"12,982.06",18148
,20160509,2417,2385,2421,2439,2241,2241,2307,-144,-78,14084,"32,492.13",18986
,20160510,2241,2307,2201,2292,2180,2252,2226,-55,-81,18702,"41,648.34",19686
,20160511,2252,2226,2269,2283,2219,2262,2262,36,36,9310,"21,064.63",20220
,20160512,2262,2262,2265,2271,2205,2205,2247,-57,-15,4906,"11,025.85",19990
,20160513,2205,2247,2212,2212,2124,2165,2168,-82,-79,9638,"20,902.61",21444
,20160516,2165,2168,2161,2234,2118,2205,2198,37,30,9738,"21,413.74",21760
,20160517,2205,2198,2207,2258,2184,2251,2216,53,18,11498,"25,486.88",22172
,20160518,2251,2216,2251,2269,2170,2197,2226,-19,10,8472,"18,861.16",20734
,20160519,2197,2226,2181,2214,2162,2184,2187,-42,-39,4156,"9,092.40",20936
,20160520,2184,2187,2174,2223,2160,2217,2199,30,12,4148,"9,124.67",20652
,20160523,2217,2199,2215,2222,2067,2092,2107,-107,-92,10354,"21,819.27",22524
,20160524,2092,2107,2099,2119,2065,2110,2094,3,-13,6342,"13,281.60",23448
,20160525,2110,2094,2123,2129,2060,2063,2096,-31,2,5218,"10,937.19",24222
,20160526,2063,2096,2065,2120,2052,2119,2097,23,1,6834,"14,334.16",23572
,20160527,2119,2097,2130,2222,2100,2222,2178,125,81,17536,"38,201.32",24410
,20160530,2222,2178,2223,2239,2082,2191,2177,13,-1,15432,"33,596.55",23560
,20160531,2191,2177,2188,2216,2147,2150,2178,-27,1,10132,"22,076.10",25972
,20160601,2150,2178,2165,2165,2103,2120,2125,-58,-53,7886,"16,764.76",27322
,20160602,2120,2125,2112,2160,2108,2121,2135,-4,10,11960,"25,539.37",28868
,20160603,2121,2135,2118,2168,2118,2142,2141,7,6,9054,"19,393.24",29890
,20160606,2142,2141,2163,2266,2121,2220,2187,79,46,9510,"20,802.64",29422
,20160607,2220,2187,2230,2268,2217,2242,2235,55,48,9390,"20,993.05",28486
,20160608,2242,2235,2250,2279,2203,2254,2247,19,12,12840,"28,862.22",29508
,20160613,2254,2247,2264,2323,2170,2293,2294,46,47,15422,"35,389.75",27460
,20160614,2293,2294,2305,2307,2207,2218,2258,-76,-36,15702,"35,461.86",27212
,20160615,2218,2258,2209,2248,2194,2212,2220,-46,-38,8526,"18,933.03",28314
,20160616,2212,2220,2224,2264,2210,2212,2228,-8,8,8594,"19,155.12",28818
,20160617,2212,2228,2201,2218,2132,2215,2187,-13,-41,9670,"21,153.60",28638
,20160620,2215,2187,2212,2234,2190,2190,2207,3,20,8020,"17,705.24",29752
,20160621,2190,2207,2192,2248,2180,2215,2217,8,10,7880,"17,471.04",30034
,20160622,2215,2217,2202,2280,2202,2255,2244,38,27,11590,"26,012.66",29950
,20160623,2255,2244,2255,2270,2239,2249,2256,5,12,7638,"17,232.78",29096
,20160624,2249,2256,2245,2284,2212,2241,2254,-15,-2,8556,"19,290.12",29100
,20160627,2241,2254,2246,2376,2244,2363,2328,109,74,24022,"55,927.71",26416
,20160628,2363,2328,2361,2379,2318,2356,2350,28,22,13176,"30,973.60",27114
,20160629,2356,2350,2357,2375,2328,2344,2349,-6,-1,10744,"25,238.02",27758
,20160630,2344,2349,2344,2484,2335,2434,2397,85,48,19000,"45,546.19",27314
,20160701,2434,2397,2434,2466,2396,2442,2434,45,37,14940,"36,373.51",26896
,20160704,2442,2434,2442,2538,2441,2515,2500,81,66,19214,"48,043.68",26444
,20160705,2515,2500,2529,2552,2402,2495,2484,-5,-16,21270,"52,847.14",27158
,20160706,2495,2484,2495,2519,2416,2466,2464,-18,-20,20882,"51,454.40",26928
,20160707,2466,2464,2464,2559,2440,2484,2508,20,44,23160,"58,101.87",21902
,20160708,2484,2508,2500,2522,2448,2522,2486,14,-22,16464,"40,932.55",22906
,20160711,2522,2486,2529,2562,2455,2510,2504,24,18,12022,"30,105.73",23490
,20160712,2510,2504,2525,2619,2503,2608,2571,104,67,16692,"42,918.27",25580
,20160713,2608,2571,2609,2640,2576,2581,2606,10,35,13088,"34,118.36",25494
,20160714,2581,2606,2590,2607,2552,2592,2580,-14,-26,14264,"36,811.32",26810
,20160715,2592,2580,2585,2625,2560,2595,2588,15,8,14112,"36,532.23",25638
,20160718,2595,2588,2605,2610,2432,2432,2500,-156,-88,18778,"46,959.58",25936
,20160719,2432,2500,2406,2440,2340,2378,2403,-122,-97,26704,"64,185.12",27920
,20160720,2378,2403,2388,2424,2376,2405,2398,2,-5,10768,"25,832.23",28248
,20160721,2405,2398,2396,2535,2378,2495,2463,97,65,24688,"60,810.06",26110
,20160722,2495,2463,2523,2523,2418,2427,2454,-36,-9,17628,"43,260.67",26452
,20160725,2427,2454,2404,2500,2403,2479,2463,25,9,24556,"60,499.04",29330
,20160726,2479,2463,2480,2512,2446,2511,2479,48,16,17944,"44,483.42",30088
,20160727,2511,2479,2515,2585,2504,2563,2542,84,63,36438,"92,654.30",32264
,20160728,2563,2542,2566,2617,2549,2612,2589,70,47,26722,"69,198.18",33514
,20160729,2612,2589,2614,2614,2525,2544,2566,-45,-23,24886,"63,881.41",34414
,20160801,2544,2566,2546,2650,2520,2632,2605,66,39,27466,"71,567.57",35240
,20160802,2632,2605,2637,2645,2574,2626,2620,21,15,18868,"49,441.42",36280
,20160803,2626,2620,2625,2634,2581,2605,2604,-15,-16,20456,"53,286.46",35134
,20160804,2605,2604,2611,2614,2508,2552,2562,-52,-42,27968,"71,663.15",36882
,20160805,2552,2562,2549,2641,2548,2639,2611,77,49,23136,"60,419.58",36618
,20160808,2639,2611,2640,2730,2630,2715,2681,104,70,52408,"140,551.48",48470
,20160809,2715,2681,2711,2729,2643,2682,2686,1,5,39046,"104,878.07",50326
,20160810,2682,2686,2682,2721,2658,2684,2687,-2,1,35664,"95,838.11",55088
,20160811,2684,2687,2680,2695,2622,2675,2662,-12,-25,55458,"147,636.22",58006
,20160812,2675,2662,2671,2689,2646,2662,2665,0,3,18180,"48,460.90",58480
,20160815,2662,2665,2645,2653,2581,2623,2618,-42,-47,54648,"143,071.08",68696
,20160816,2623,2618,2629,2750,2618,2721,2696,103,78,72300,"194,931.30",78214
,20160817,2721,2696,2757,2763,2692,2692,2731,-4,35,48428,"132,266.64",85480
,20160818,2692,2731,2691,2750,2674,2723,2714,-8,-17,54772,"148,653.93",86212
,20160819,2723,2714,2733,2753,2678,2740,2720,26,6,59630,"162,228.24",93282
,20160822,2740,2720,2744,2792,2737,2743,2764,23,44,82762,"228,799.20",105132
,20160823,2743,2764,2766,2814,2728,2800,2787,36,23,90546,"252,390.04",120250
,20160824,2800,2787,2800,2830,2786,2799,2806,12,19,70168,"196,944.10",129082
,20160825,2799,2806,2806,2836,2700,2783,2770,-23,-36,157492,"436,267.88",138852
,20160826,2783,2770,2760,2785,2724,2730,2758,-40,-12,93384,"257,614.62",143146
,20160829,2730,2758,2720,2729,2650,2717,2705,-41,-53,124806,"337,715.75",155604
,20160830,2717,2705,2720,2744,2664,2666,2702,-39,-3,116418,"314,584.13",162348
,20160831,2666,2702,2657,2691,2617,2618,2659,-84,-43,119018,"316,544.73",175906
,20160901,2618,2659,2620,2652,2595,2633,2626,-26,-33,134564,"353,484.13",191024
,20160902,2633,2626,2639,2697,2620,2652,2662,26,36,153236,"408,059.03",199096
,20160905,2652,2662,2660,2709,2657,2668,2685,6,23,190432,"511,312.46",222250
,20160906,2668,2685,2670,2695,2630,2643,2659,-42,-26,221312,"588,608.51",238444
,20160907,2643,2659,2643,2652,2552,2560,2590,-99,-69,321932,"834,044.34",257910
,20160908,2560,2590,2563,2612,2558,2587,2584,-3,-6,251606,"650,209.51",288830
,20160909,2587,2584,2583,2609,2560,2595,2585,11,1,258526,"668,375.92",304386
,20160912,2595,2585,2599,2610,2528,2542,2557,-43,-28,275138,"703,743.46",321698
,20160913,2542,2557,2540,2582,2521,2534,2548,-23,-9,256114,"652,642.11",340716
,20160914,2534,2548,2545,2570,2520,2552,2548,4,0,225038,"573,618.95",351370
,20160919,2552,2548,2500,2557,2495,2540,2536,-8,-12,183252,"464,814.39",360354
,20160920,2540,2536,2543,2566,2517,2548,2544,12,8,281340,"715,966.26",362586
,20160921,2548,2544,2548,2561,2518,2530,2536,-14,-8,279452,"708,911.40",377130
,20160922,2530,2536,2530,2602,2526,2567,2569,31,33,344996,"886,583.25",359680
,20160923,2567,2569,2579,2606,2565,2604,2590,35,21,262538,"680,172.79",354666
,20160926,2604,2590,2610,2645,2600,2619,2618,29,28,223820,"586,119.47",345648
,20160927,2619,2618,2623,2623,2545,2570,2575,-48,-43,236220,"608,283.69",335698
,20160928,2570,2575,2568,2588,2552,2585,2573,10,-2,176884,"455,185.58",320682
,20160929,2585,2573,2585,2638,2563,2565,2608,-8,35,287658,"750,295.42",291008
,20160930,2565,2608,2578,2581,2532,2541,2551,-67,-57,200178,"510,757.50",286978
,20161010,2541,2551,2571,2579,2510,2568,2543,17,-8,168742,"429,207.74",292552
,20161011,2568,2543,2577,2675,2570,2675,2630,132,87,387132,"1,018,523.32",288628
,20161012,2675,2630,2674,2725,2659,2711,2694,81,64,407320,"1,097,591.36",317250
,20161013,2711,2694,2715,2725,2668,2696,2691,2,-3,273250,"735,519.55",311192
,20161014,2696,2691,2690,2742,2684,2718,2716,27,25,312846,"849,933.62",333524
,20161017,2718,2716,2711,2751,2700,2738,2727,22,11,290120,"791,211.02",327518
,20161018,2738,2727,2740,2744,2695,2729,2716,2,-11,236576,"642,674.07",312950
,20161019,2729,2716,2729,2828,2729,2756,2780,40,64,486084,"1,351,647.37",334938
,20161020,2756,2780,2744,2817,2741,2806,2786,26,6,273316,"761,515.39",352278
,20161021,2806,2786,2817,2850,2750,2791,2782,5,-4,267808,"745,111.53",334396
,20161024,2791,2782,2791,2811,2752,2806,2780,24,-2,228558,"635,424.57",337210
,20161025,2806,2780,2810,2904,2806,2884,2864,104,84,431268,"1,235,301.51",352306
,20161026,2884,2864,2895,2915,2828,2854,2865,-10,1,329622,"944,556.07",325828
,20161027,2854,2865,2858,2891,2818,2849,2856,-16,-9,259682,"741,765.02",325682
,20161028,2849,2856,2853,2919,2841,2909,2883,53,27,262618,"757,181.75",335516
,20161031,2909,2883,2911,2990,2880,2969,2930,86,47,413880,"1,212,914.93",340672
,20161101,2969,2930,2970,3079,2933,3035,3012,105,82,502962,"1,515,002.45",351658
,20161102,3035,3012,3048,3126,3045,3064,3083,52,71,632204,"1,949,179.68",360150
,20161103,3064,3083,3076,3122,3052,3119,3091,36,8,450992,"1,394,089.50",375202
,20161104,3119,3091,3129,3156,3099,3125,3129,34,38,507628,"1,588,475.44",344172
,20161107,3125,3129,3148,3316,3091,3284,3207,155,78,677430,"2,173,189.60",336204
,20161108,3284,3207,3290,3314,3165,3220,3245,13,38,469296,"1,522,881.12",298290
,20161109,3220,3245,3251,3413,3208,3387,3326,142,81,568466,"1,891,272.23",300634
,20161110,3387,3326,3380,3515,3301,3346,3390,20,64,723924,"2,454,152.05",255214
,20161111,3346,3390,3346,3496,3322,3480,3402,90,12,477708,"1,625,497.04",246744
,20161114,3480,3402,3480,3596,3290,3350,3423,-52,21,590554,"2,021,968.45",213856
,20161115,3350,3423,3350,3405,3217,3217,3324,-206,-99,355662,"1,182,310.23",216874
,20161116,3217,3324,3200,3229,3100,3205,3176,-119,-148,456442,"1,449,776.16",206714
,20161117,3205,3176,3209,3236,3136,3218,3185,42,9,358728,"1,142,786.27",208280
,20161118,3218,3185,3222,3253,3150,3179,3189,-6,4,366340,"1,168,292.99",208320
,20161121,3179,3189,3181,3207,3079,3151,3153,-38,-36,351248,"1,107,552.85",199726
,20161122,3151,3153,3151,3342,3151,3342,3265,189,112,408406,"1,333,457.59",196576
,20161123,3342,3265,3353,3453,3343,3424,3394,159,129,484316,"1,643,852.14",191002
,20161124,3424,3394,3415,3489,3336,3399,3416,5,22,453070,"1,547,962.67",175162
,20161125,3399,3416,3395,3606,3371,3551,3499,135,83,450090,"1,575,142.89",167352
,20161128,3551,3499,3550,3689,3491,3620,3566,121,67,406308,"1,449,298.16",149244
,20161129,3620,3566,3597,3649,3411,3413,3544,-153,-22,367302,"1,301,746.47",122968
,20161130,3413,3544,3423,3435,3295,3295,3358,-249,-186,234434,"787,273.10",111526
,20161201,3295,3358,3306,3593,3306,3578,3481,220,123,425200,"1,480,497.78",113874
,20161202,3578,3481,3578,3599,3473,3554,3536,73,55,248974,"880,602.92",88548
,20161205,3554,3536,3596,3640,3491,3608,3559,72,23,123124,"438,238.88",72738
,20161206,3608,3559,3634,3679,3596,3654,3646,95,87,52908,"192,943.97",68184
,20161207,3654,3646,3650,3850,3645,3778,3760,132,114,60242,"226,525.17",59814
,20161208,3778,3760,3778,3807,3692,3793,3753,33,-7,37990,"142,586.70",53928
,20161209,3793,3753,3772,3810,3657,3763,3722,10,-31,39386,"146,597.77",46958
,20161212,3763,3722,3778,3931,3740,3838,3855,116,133,31374,"120,959.67",44962
,20161213,3838,3855,3838,3898,3815,3881,3861,26,6,18252,"70,477.01",42114
,20161214,3881,3861,3882,3894,3780,3812,3826,-49,-35,26014,"99,549.75",39364
,20161215,3812,3826,3820,3881,3780,3867,3823,41,-3,22256,"85,103.11",36836
,20161216,3867,3823,3894,3894,3805,3807,3851,-16,28,19084,"73,500.25",36174
,20161219,3807,3851,3802,3826,3730,3730,3781,-121,-70,15052,"56,918.38",35048
,20161220,3730,3781,3729,3765,3709,3748,3731,-33,-50,17764,"66,284.28",31736
,20161221,3748,3731,3760,3777,3705,3749,3742,18,11,11576,"43,319.23",29412
,20161222,3749,3742,3748,3750,3634,3634,3693,-108,-49,16354,"60,398.14",23050
,20161223,3634,3693,3634,3664,3551,3571,3609,-122,-84,12066,"43,548.34",18510
,20161226,3571,3609,3561,3615,3438,3518,3535,-91,-74,10082,"35,641.09",15320
,20161227,3518,3535,3525,3609,3487,3584,3533,49,-2,5774,"20,400.63",14754
,20161228,3584,3533,3584,3661,3567,3625,3620,92,87,4914,"17,791.05",13574
,20161229,3625,3620,3621,3635,3570,3594,3598,-26,-22,4732,"17,029.99",12508
,20161230,3594,3598,3592,3652,3550,3550,3604,-48,6,3448,"12,426.91",10398
hc1702,20160216,1957,1957,,,,1957,1957,0,0,0,0.00,0
,20160217,1957,1957,,,,1957,1957,0,0,0,0.00,0
,20160218,1957,1957,,,,1957,1957,0,0,0,0.00,0
,20160219,1957,1957,,,,1957,1957,0,0,0,0.00,0
,20160222,1957,1957,,,,1999,1999,42,42,0,0.00,0
,20160223,1999,1999,,,,2001,2001,2,2,0,0.00,0
,20160224,2001,2001,,,,2001,2001,0,0,0,0.00,0
,20160225,2001,2001,,,,2001,2001,0,0,0,0.00,0
,20160226,2001,2001,,,,2001,2001,0,0,0,0.00,0
,20160229,2001,2001,,,,2001,2001,0,0,0,0.00,0
,20160301,2001,2001,,,,2022,2022,21,21,0,0.00,0
,20160302,2022,2022,,,,2040,2040,18,18,0,0.00,0
,20160303,2040,2040,,,,2066,2066,26,26,0,0.00,0
,20160304,2066,2066,,,,2083,2083,17,17,0,0.00,0
,20160307,2083,2083,,,,2135,2135,52,52,0,0.00,0
,20160308,2135,2135,,,,2233,2233,98,98,0,0.00,0
,20160309,2233,2233,,,,2096,2096,-137,-137,0,0.00,0
,20160310,2096,2096,,,,2180,2180,84,84,0,0.00,0
,20160311,2180,2180,,,,2163,2163,-17,-17,0,0.00,0
,20160314,2163,2163,,,,2131,2131,-32,-32,0,0.00,0
,20160315,2131,2131,,,,2095,2095,-36,-36,0,0.00,0
,20160316,2095,2095,,,,2094,2094,-1,-1,0,0.00,0
,20160317,2094,2094,,,,2145,2145,51,51,0,0.00,0
,20160318,2145,2145,,,,2198,2198,53,53,0,0.00,0
,20160321,2198,2198,,,,2237,2237,39,39,0,0.00,0
,20160322,2237,2237,,,,2257,2257,20,20,0,0.00,0
,20160323,2257,2257,,,,2279,2279,22,22,0,0.00,0
,20160324,2279,2279,,,,2243,2243,-36,-36,0,0.00,0
,20160325,2243,2243,,,,2214,2214,-29,-29,0,0.00,0
,20160328,2214,2214,,,,2232,2232,18,18,0,0.00,0
,20160329,2232,2232,,,,2188,2188,-44,-44,0,0.00,0
,20160330,2188,2188,,,,2158,2158,-30,-30,0,0.00,0
,20160331,2158,2158,,,,2160,2160,2,2,0,0.00,0
,20160401,2160,2160,,,,2185,2185,25,25,0,0.00,0
,20160405,2185,2185,,,,2203,2203,18,18,0,0.00,0
,20160406,2203,2203,,,,2227,2227,24,24,0,0.00,0
,20160407,2227,2227,,,,2229,2229,2,2,0,0.00,0
,20160408,2229,2229,,,,2239,2239,10,10,0,0.00,0
,20160411,2239,2239,,,,2305,2305,66,66,0,0.00,0
,20160412,2305,2305,,,,2359,2359,54,54,0,0.00,0
,20160413,2359,2359,,,,2380,2380,21,21,0,0.00,0
,20160414,2380,2380,,,,2380,2380,0,0,0,0.00,0
,20160415,2380,2380,,,,2380,2380,0,0,0,0.00,0
,20160418,2380,2380,,,,2440,2440,60,60,0,0.00,0
,20160419,2440,2440,2602,2602,2491,2491,2546,51,106,4,10.19,0
,20160420,2491,2546,,,,2647,2647,101,101,0,0.00,0
,20160421,2647,2647,,,,2738,2738,91,91,0,0.00,0
,20160422,2738,2738,2882,2882,2882,2882,2882,144,144,2,5.76,2
,20160425,2882,2882,,,,2882,2882,0,0,0,0.00,2
,20160426,2882,2882,,,,2765,2765,-117,-117,0,0.00,2
,20160427,2765,2765,,,,2691,2691,-74,-74,0,0.00,2
,20160428,2691,2691,,,,2691,2691,0,0,0,0.00,2
,20160429,2691,2691,,,,2691,2691,0,0,0,0.00,2
,20160503,2691,2691,,,,2691,2691,0,0,0,0.00,2
,20160504,2691,2691,,,,2630,2630,-61,-61,0,0.00,2
,20160505,2630,2630,,,,2584,2584,-46,-46,0,0.00,2
,20160506,2584,2584,,,,2584,2584,0,0,0,0.00,2
,20160509,2584,2584,,,,2428,2428,-156,-156,0,0.00,2
,20160510,2428,2428,,,,2343,2343,-85,-85,0,0.00,2
,20160511,2343,2343,,,,2343,2343,0,0,0,0.00,2
,20160512,2343,2343,,,,2327,2327,-16,-16,0,0.00,2
,20160513,2327,2327,,,,2245,2245,-82,-82,0,0.00,2
,20160516,2245,2245,,,,2277,2277,32,32,0,0.00,2
,20160517,2277,2277,,,,2296,2296,19,19,0,0.00,2
,20160518,2296,2296,,,,2296,2296,0,0,0,0.00,2
,20160519,2296,2296,,,,2256,2256,-40,-40,0,0.00,2
,20160520,2256,2256,,,,2256,2256,0,0,0,0.00,2
,20160523,2256,2256,,,,2161,2161,-95,-95,0,0.00,2
,20160524,2161,2161,,,,2147,2147,-14,-14,0,0.00,2
,20160525,2147,2147,,,,2149,2149,2,2,0,0.00,2
,20160526,2149,2149,,,,2150,2150,1,1,0,0.00,2
,20160527,2150,2150,2150,2150,2150,2150,2150,0,0,2,4.30,2
,20160530,2150,2150,2188,2188,2188,2188,2188,38,38,2,4.38,0
,20160531,2188,2188,,,,2188,2188,0,0,0,0.00,0
,20160601,2188,2188,,,,2188,2188,0,0,0,0.00,0
,20160602,2188,2188,,,,2188,2188,0,0,0,0.00,0
,20160603,2188,2188,,,,2188,2188,0,0,0,0.00,0
,20160606,2188,2188,,,,2235,2235,47,47,0,0.00,0
,20160607,2235,2235,,,,2235,2235,0,0,0,0.00,0
,20160608,2235,2235,,,,2247,2247,12,12,0,0.00,0
,20160613,2247,2247,,,,2294,2294,47,47,0,0.00,0
,20160614,2294,2294,,,,2294,2294,0,0,0,0.00,0
,20160615,2294,2294,,,,2294,2294,0,0,0,0.00,0
,20160616,2294,2294,,,,2294,2294,0,0,0,0.00,0
,20160617,2294,2294,2190,2260,2190,2190,2190,-104,-104,202,442.52,200
,20160620,2190,2190,,,,2190,2190,0,0,0,0.00,200
,20160621,2190,2190,,,,2200,2200,10,10,0,0.00,200
,20160622,2200,2200,,,,2240,2240,40,40,0,0.00,200
,20160623,2240,2240,,,,2240,2240,0,0,0,0.00,200
,20160624,2240,2240,,,,2240,2240,0,0,0,0.00,200
,20160627,2240,2240,,,,2313,2313,73,73,0,0.00,200
,20160628,2313,2313,2324,2435,2324,2435,2390,122,77,18,43.03,206
,20160629,2435,2390,2412,2412,2412,2412,2412,22,22,8,19.30,214
,20160630,2412,2412,2490,2500,2419,2419,2485,7,73,214,531.89,0
,20160701,2419,2485,,,,2485,2485,0,0,0,0.00,0
,20160704,2485,2485,,,,2485,2485,0,0,0,0.00,0
,20160705,2485,2485,,,,2485,2485,0,0,0,0.00,0
,20160706,2485,2485,2460,2460,2410,2410,2435,-75,-50,4,9.74,0
,20160707,2410,2435,,,,2479,2479,44,44,0,0.00,0
,20160708,2479,2479,,,,2457,2457,-22,-22,0,0.00,0
,20160711,2457,2457,,,,2475,2475,18,18,0,0.00,0
,20160712,2475,2475,,,,2541,2541,66,66,0,0.00,0
,20160713,2541,2541,,,,2552,2552,11,11,0,0.00,0
,20160714,2552,2552,,,,2560,2560,8,8,0,0.00,0
,20160715,2560,2560,,,,2570,2570,10,10,0,0.00,0
,20160718,2570,2570,,,,2483,2483,-87,-87,0,0.00,0
,20160719,2483,2483,,,,2483,2483,0,0,0,0.00,0
,20160720,2483,2483,,,,2478,2478,-5,-5,0,0.00,0
,20160721,2478,2478,,,,2480,2480,2,2,0,0.00,0
,20160722,2480,2480,,,,2480,2480,0,0,0,0.00,0
,20160725,2480,2480,,,,2480,2480,0,0,0,0.00,0
,20160726,2480,2480,,,,2496,2496,16,16,0,0.00,0
,20160727,2496,2496,,,,2560,2560,64,64,0,0.00,0
,20160728,2560,2560,,,,2571,2571,11,11,0,0.00,0
,20160729,2571,2571,,,,2571,2571,0,0,0,0.00,0
,20160801,2571,2571,,,,2610,2610,39,39,0,0.00,0
,20160802,2610,2610,,,,2610,2610,0,0,0,0.00,0
,20160803,2610,2610,,,,2610,2610,0,0,0,0.00,0
,20160804,2610,2610,,,,2610,2610,0,0,0,0.00,0
,20160805,2610,2610,,,,2610,2610,0,0,0,0.00,0
,20160808,2610,2610,,,,2680,2680,70,70,0,0.00,0
,20160809,2680,2680,,,,2680,2680,0,0,0,0.00,0
,20160810,2680,2680,,,,2680,2680,0,0,0,0.00,0
,20160811,2680,2680,,,,2680,2680,0,0,0,0.00,0
,20160812,2680,2680,,,,2680,2680,0,0,0,0.00,0
,20160815,2680,2680,,,,2632,2632,-48,-48,0,0.00,0
,20160816,2632,2632,,,,2710,2710,78,78,0,0.00,0
,20160817,2710,2710,2654,2777,2654,2777,2731,67,21,38,103.80,4
,20160818,2777,2731,,,,2731,2731,0,0,0,0.00,4
,20160819,2731,2731,,,,2731,2731,0,0,0,0.00,4
,20160822,2731,2731,2786,2786,2786,2786,2786,55,55,12,33.43,12
,20160823,2786,2786,2780,2821,2780,2821,2802,35,16,12,33.62,0
,20160824,2821,2802,,,,2802,2802,0,0,0,0.00,0
,20160825,2802,2802,,,,2802,2802,0,0,0,0.00,0
,20160826,2802,2802,,,,2802,2802,0,0,0,0.00,0
,20160829,2802,2802,,,,2802,2802,0,0,0,0.00,0
,20160830,2802,2802,,,,2799,2799,-3,-3,0,0.00,0
,20160831,2799,2799,,,,2755,2755,-44,-44,0,0.00,0
,20160901,2755,2755,,,,2721,2721,-34,-34,0,0.00,0
,20160902,2721,2721,,,,2721,2721,0,0,0,0.00,0
,20160905,2721,2721,,,,2721,2721,0,0,0,0.00,0
,20160906,2721,2721,,,,2695,2695,-26,-26,0,0.00,0
,20160907,2695,2695,,,,2625,2625,-70,-70,0,0.00,0
,20160908,2625,2625,,,,2625,2625,0,0,0,0.00,0
,20160909,2625,2625,,,,2625,2625,0,0,0,0.00,0
,20160912,2625,2625,,,,2625,2625,0,0,0,0.00,0
,20160913,2625,2625,,,,2616,2616,-9,-9,0,0.00,0
,20160914,2616,2616,,,,2616,2616,0,0,0,0.00,0
,20160919,2616,2616,,,,2604,2604,-12,-12,0,0.00,0
,20160920,2604,2604,,,,2604,2604,0,0,0,0.00,0
,20160921,2604,2604,,,,2604,2604,0,0,0,0.00,0
,20160922,2604,2604,,,,2604,2604,0,0,0,0.00,0
,20160923,2604,2604,,,,2604,2604,0,0,0,0.00,0
,20160926,2604,2604,2684,2684,2628,2628,2654,24,50,8,21.23,0
,20160927,2628,2654,,,,2654,2654,0,0,0,0.00,0
,20160928,2654,2654,,,,2647,2647,-7,-7,0,0.00,0
,20160929,2647,2647,,,,2647,2647,0,0,0,0.00,0
,20160930,2647,2647,,,,2589,2589,-58,-58,0,0.00,0
,20161010,2589,2589,,,,2589,2589,0,0,0,0.00,0
,20161011,2589,2589,,,,2678,2678,89,89,0,0.00,0
,20161012,2678,2678,,,,2678,2678,0,0,0,0.00,0
,20161013,2678,2678,,,,2678,2678,0,0,0,0.00,0
,20161014,2678,2678,,,,2678,2678,0,0,0,0.00,0
,20161017,2678,2678,,,,2689,2689,11,11,0,0.00,0
,20161018,2689,2689,,,,2689,2689,0,0,0,0.00,0
,20161019,2689,2689,,,,2711,2711,22,22,0,0.00,0
,20161020,2711,2711,2848,2848,2848,2848,2848,137,137,2,5.70,2
,20161021,2848,2848,,,,2848,2848,0,0,0,0.00,2
,20161024,2848,2848,,,,2848,2848,0,0,0,0.00,2
,20161025,2848,2848,,,,2848,2848,0,0,0,0.00,2
,20161026,2848,2848,,,,2848,2848,0,0,0,0.00,2
,20161027,2848,2848,,,,2848,2848,0,0,0,0.00,2
,20161028,2848,2848,,,,2848,2848,0,0,0,0.00,2
,20161031,2848,2848,,,,2895,2895,47,47,0,0.00,2
,20161101,2895,2895,,,,2976,2976,81,81,0,0.00,2
,20161102,2976,2976,,,,3046,3046,70,70,0,0.00,2
,20161103,3046,3046,,,,3046,3046,0,0,0,0.00,2
,20161104,3046,3046,2981,2981,2981,2981,2981,-65,-65,2,5.96,2
,20161107,2981,2981,3158,3158,3158,3158,3158,177,177,2,6.32,2
,20161108,3158,3158,,,,3195,3195,37,37,0,0.00,2
,20161109,3195,3195,3200,3200,3146,3146,3173,-49,-22,4,12.69,0
,20161110,3146,3173,,,,3173,3173,0,0,0,0.00,0
,20161111,3173,3173,3361,3362,3232,3362,3318,189,145,6,19.91,2
,20161114,3362,3318,3516,3516,3341,3341,3428,23,110,4,13.71,4
,20161115,3341,3428,,,,3329,3329,-99,-99,0,0.00,4
,20161116,3329,3329,3130,3130,3130,3130,3130,-199,-199,2,6.26,2
,20161117,3130,3130,,,,3139,3139,9,9,0,0.00,2
,20161118,3139,3139,,,,3139,3139,0,0,0,0.00,2
,20161121,3139,3139,2984,3168,2984,3168,3076,29,-63,4,12.30,0
,20161122,3168,3076,,,,3185,3185,109,109,0,0.00,0
,20161123,3185,3185,3332,3376,3219,3219,3298,34,113,48,158.35,2
,20161124,3219,3298,,,,3298,3298,0,0,0,0.00,2
,20161125,3298,3298,3528,3528,3528,3528,3528,230,230,10,35.28,12
,20161128,3528,3528,,,,3530,3530,2,2,0,0.00,12
,20161129,3530,3530,3485,3662,3295,3295,3489,-235,-41,8,27.92,14
,20161130,3295,3489,,,,3306,3306,-183,-183,0,0.00,14
,20161201,3306,3306,3192,3536,3192,3536,3391,230,85,24,81.40,2
,20161202,3536,3391,3500,3500,3455,3455,3477,64,86,12,41.73,2
,20161205,3455,3477,,,,3499,3499,22,22,0,0.00,2
,20161206,3499,3499,,,,3585,3585,86,86,0,0.00,2
,20161207,3585,3585,,,,3697,3697,112,112,0,0.00,2
,20161208,3697,3697,,,,3690,3690,-7,-7,0,0.00,2
,20161209,3690,3690,,,,3690,3690,0,0,0,0.00,2
,20161212,3690,3690,,,,3690,3690,0,0,0,0.00,2
,20161213,3690,3690,,,,3696,3696,6,6,0,0.00,2
,20161214,3696,3696,,,,3696,3696,0,0,0,0.00,2
,20161215,3696,3696,,,,3693,3693,-3,-3,0,0.00,2
,20161216,3693,3693,3434,3903,3434,3750,3787,57,94,36,136.35,2
,20161219,3750,3787,,,,3718,3718,-69,-69,0,0.00,2
,20161220,3718,3718,3458,3698,3458,3461,3530,-257,-188,20,70.62,10
,20161221,3461,3530,,,,3540,3540,10,10,0,0.00,10
,20161222,3540,3540,,,,3540,3540,0,0,0,0.00,10
,20161223,3540,3540,,,,3540,3540,0,0,0,0.00,10
,20161226,3540,3540,,,,3540,3540,0,0,0,0.00,10
,20161227,3540,3540,,,,3540,3540,0,0,0,0.00,10
,20161228,3540,3540,,,,3540,3540,0,0,0,0.00,10
,20161229,3540,3540,,,,3540,3540,0,0,0,0.00,10
,20161230,3540,3540,,,,3540,3540,0,0,0,0.00,10
hc1703,20160316,2095,2095,,,,2094,2094,-1,-1,0,0.00,0
,20160317,2094,2094,,,,2145,2145,51,51,0,0.00,0
,20160318,2145,2145,,,,2198,2198,53,53,0,0.00,0
,20160321,2198,2198,,,,2237,2237,39,39,0,0.00,0
,20160322,2237,2237,,,,2257,2257,20,20,0,0.00,0
,20160323,2257,2257,,,,2279,2279,22,22,0,0.00,0
,20160324,2279,2279,,,,2243,2243,-36,-36,0,0.00,0
,20160325,2243,2243,,,,2214,2214,-29,-29,0,0.00,0
,20160328,2214,2214,,,,2232,2232,18,18,0,0.00,0
,20160329,2232,2232,2165,2165,2164,2165,2164,-67,-68,78,168.83,78
,20160330,2165,2164,2270,2270,2176,2176,2256,12,92,48,108.30,40
,20160331,2176,2256,2156,2191,2156,2191,2174,-65,-82,8,17.40,38
,20160401,2191,2174,2231,2231,2231,2231,2231,57,57,2,4.46,38
,20160405,2231,2231,2237,2237,2214,2214,2225,-17,-6,4,8.90,38
,20160406,2214,2225,2268,2278,2255,2255,2265,30,40,8,18.12,46
,20160407,2255,2265,,,,2265,2265,0,0,0,0.00,46
,20160408,2265,2265,,,,2265,2265,0,0,0,0.00,46
,20160411,2265,2265,,,,2323,2323,58,58,0,0.00,46
,20160412,2323,2323,2424,2462,2398,2462,2402,139,79,52,124.93,4
,20160413,2462,2402,,,,2427,2427,25,25,0,0.00,4
,20160414,2427,2427,,,,2427,2427,0,0,0,0.00,4
,20160415,2427,2427,,,,2427,2427,0,0,0,0.00,4
,20160418,2427,2427,,,,2467,2467,40,40,0,0.00,4
,20160419,2467,2467,2615,2615,2615,2615,2615,148,148,4,10.46,2
,20160420,2615,2615,,,,2632,2632,17,17,0,0.00,2
,20160421,2632,2632,,,,2723,2723,91,91,0,0.00,2
,20160422,2723,2723,2660,2660,2660,2660,2660,-63,-63,2,5.32,4
,20160425,2660,2660,,,,2660,2660,0,0,0,0.00,4
,20160426,2660,2660,,,,2660,2660,0,0,0,0.00,4
,20160427,2660,2660,2631,2631,2631,2631,2631,-29,-29,2,5.26,4
,20160428,2631,2631,,,,2631,2631,0,0,0,0.00,4
,20160429,2631,2631,,,,2631,2631,0,0,0,0.00,4
,20160503,2631,2631,,,,2631,2631,0,0,0,0.00,4
,20160504,2631,2631,2478,2478,2478,2478,2478,-153,-153,2,4.96,2
,20160505,2478,2478,,,,2478,2478,0,0,0,0.00,2
,20160506,2478,2478,,,,2478,2478,0,0,0,0.00,2
,20160509,2478,2478,,,,2396,2396,-82,-82,0,0.00,2
,20160510,2396,2396,,,,2312,2312,-84,-84,0,0.00,2
,20160511,2312,2312,,,,2312,2312,0,0,0,0.00,2
,20160512,2312,2312,,,,2312,2312,0,0,0,0.00,2
,20160513,2312,2312,,,,2231,2231,-81,-81,0,0.00,2
,20160516,2231,2231,,,,2262,2262,31,31,0,0.00,2
,20160517,2262,2262,,,,2281,2281,19,19,0,0.00,2
,20160518,2281,2281,,,,2281,2281,0,0,0,0.00,2
,20160519,2281,2281,,,,2241,2241,-40,-40,0,0.00,2
,20160520,2241,2241,,,,2241,2241,0,0,0,0.00,2
,20160523,2241,2241,,,,2147,2147,-94,-94,0,0.00,2
,20160524,2147,2147,,,,2133,2133,-14,-14,0,0.00,2
,20160525,2133,2133,,,,2135,2135,2,2,0,0.00,2
,20160526,2135,2135,,,,2136,2136,1,1,0,0.00,2
,20160527,2136,2136,,,,2136,2136,0,0,0,0.00,2
,20160530,2136,2136,,,,2173,2173,37,37,0,0.00,2
,20160531,2173,2173,,,,2173,2173,0,0,0,0.00,2
,20160601,2173,2173,,,,2173,2173,0,0,0,0.00,2
,20160602,2173,2173,,,,2173,2173,0,0,0,0.00,2
,20160603,2173,2173,,,,2173,2173,0,0,0,0.00,2
,20160606,2173,2173,,,,2220,2220,47,47,0,0.00,2
,20160607,2220,2220,,,,2220,2220,0,0,0,0.00,2
,20160608,2220,2220,2191,2353,2191,2353,2272,133,52,4,9.09,2
,20160613,2353,2272,,,,2320,2320,48,48,0,0.00,2
,20160614,2320,2320,,,,2320,2320,0,0,0,0.00,2
,20160615,2320,2320,,,,2320,2320,0,0,0,0.00,2
,20160616,2320,2320,,,,2320,2320,0,0,0,0.00,2
,20160617,2320,2320,,,,2320,2320,0,0,0,0.00,2
,20160620,2320,2320,,,,2320,2320,0,0,0,0.00,2
,20160621,2320,2320,,,,2320,2320,0,0,0,0.00,2
,20160622,2320,2320,,,,2320,2320,0,0,0,0.00,2
,20160623,2320,2320,,,,2320,2320,0,0,0,0.00,2
,20160624,2320,2320,,,,2318,2318,-2,-2,0,0.00,2
,20160627,2318,2318,,,,2394,2394,76,76,0,0.00,2
,20160628,2394,2394,,,,2474,2474,80,80,0,0.00,2
,20160629,2474,2474,,,,2474,2474,0,0,0,0.00,2
,20160630,2474,2474,,,,2474,2474,0,0,0,0.00,2
,20160701,2474,2474,,,,2474,2474,0,0,0,0.00,2
,20160704,2474,2474,,,,2541,2541,67,67,0,0.00,2
,20160705,2541,2541,,,,2541,2541,0,0,0,0.00,2
,20160706,2541,2541,,,,2541,2541,0,0,0,0.00,2
,20160707,2541,2541,,,,2541,2541,0,0,0,0.00,2
,20160708,2541,2541,,,,2541,2541,0,0,0,0.00,2
,20160711,2541,2541,,,,2541,2541,0,0,0,0.00,2
,20160712,2541,2541,,,,2609,2609,68,68,0,0.00,2
,20160713,2609,2609,,,,2609,2609,0,0,0,0.00,2
,20160714,2609,2609,,,,2609,2609,0,0,0,0.00,2
,20160715,2609,2609,,,,2609,2609,0,0,0,0.00,2
,20160718,2609,2609,,,,2521,2521,-88,-88,0,0.00,2
,20160719,2521,2521,,,,2423,2423,-98,-98,0,0.00,2
,20160720,2423,2423,,,,2423,2423,0,0,0,0.00,2
,20160721,2423,2423,,,,2488,2488,65,65,0,0.00,2
,20160722,2488,2488,,,,2488,2488,0,0,0,0.00,2
,20160725,2488,2488,,,,2488,2488,0,0,0,0.00,2
,20160726,2488,2488,,,,2504,2504,16,16,0,0.00,2
,20160727,2504,2504,,,,2568,2568,64,64,0,0.00,2
,20160728,2568,2568,,,,2616,2616,48,48,0,0.00,2
,20160729,2616,2616,,,,2616,2616,0,0,0,0.00,2
,20160801,2616,2616,,,,2616,2616,0,0,0,0.00,2
,20160802,2616,2616,,,,2616,2616,0,0,0,0.00,2
,20160803,2616,2616,,,,2616,2616,0,0,0,0.00,2
,20160804,2616,2616,2616,2616,2616,2616,2616,0,0,2,5.23,2
,20160805,2616,2616,,,,2666,2666,50,50,0,0.00,2
,20160808,2666,2666,,,,2676,2676,10,10,0,0.00,2
,20160809,2676,2676,,,,2676,2676,0,0,0,0.00,2
,20160810,2676,2676,,,,2676,2676,0,0,0,0.00,2
,20160811,2676,2676,,,,2676,2676,0,0,0,0.00,2
,20160812,2676,2676,,,,2676,2676,0,0,0,0.00,2
,20160815,2676,2676,,,,2676,2676,0,0,0,0.00,2
,20160816,2676,2676,,,,2686,2686,10,10,0,0.00,2
,20160817,2686,2686,2760,2760,2760,2760,2760,74,74,2,5.52,2
,20160818,2760,2760,2780,2780,2688,2688,2734,-72,-26,8,21.87,2
,20160819,2688,2734,,,,2734,2734,0,0,0,0.00,2
,20160822,2734,2734,,,,2734,2734,0,0,0,0.00,2
,20160823,2734,2734,,,,2752,2752,18,18,0,0.00,2
,20160824,2752,2752,,,,2761,2761,9,9,0,0.00,2
,20160825,2761,2761,,,,2761,2761,0,0,0,0.00,2
,20160826,2761,2761,,,,2761,2761,0,0,0,0.00,2
,20160829,2761,2761,,,,2761,2761,0,0,0,0.00,2
,20160830,2761,2761,,,,2758,2758,-3,-3,0,0.00,2
,20160831,2758,2758,,,,2714,2714,-44,-44,0,0.00,2
,20160901,2714,2714,,,,2681,2681,-33,-33,0,0.00,2
,20160902,2681,2681,,,,2681,2681,0,0,0,0.00,2
,20160905,2681,2681,,,,2681,2681,0,0,0,0.00,2
,20160906,2681,2681,,,,2681,2681,0,0,0,0.00,2
,20160907,2681,2681,,,,2612,2612,-69,-69,0,0.00,2
,20160908,2612,2612,,,,2612,2612,0,0,0,0.00,2
,20160909,2612,2612,,,,2612,2612,0,0,0,0.00,2
,20160912,2612,2612,,,,2580,2580,-32,-32,0,0.00,2
,20160913,2580,2580,,,,2577,2577,-3,-3,0,0.00,2
,20160914,2577,2577,,,,2577,2577,0,0,0,0.00,2
,20160919,2577,2577,,,,2577,2577,0,0,0,0.00,2
,20160920,2577,2577,,,,2577,2577,0,0,0,0.00,2
,20160921,2577,2577,,,,2567,2567,-10,-10,0,0.00,2
,20160922,2567,2567,,,,2567,2567,0,0,0,0.00,2
,20160923,2567,2567,,,,2567,2567,0,0,0,0.00,2
,20160926,2567,2567,,,,2570,2570,3,3,0,0.00,2
,20160927,2570,2570,,,,2570,2570,0,0,0,0.00,2
,20160928,2570,2570,,,,2570,2570,0,0,0,0.00,2
,20160929,2570,2570,,,,2570,2570,0,0,0,0.00,2
,20160930,2570,2570,,,,2570,2570,0,0,0,0.00,2
,20161010,2570,2570,,,,2570,2570,0,0,0,0.00,2
,20161011,2570,2570,,,,2570,2570,0,0,0,0.00,2
,20161012,2570,2570,2680,2680,2680,2680,2680,110,110,2,5.36,0
,20161013,2680,2680,2622,2762,2622,2762,2692,82,12,4,10.77,2
,20161014,2762,2692,,,,2692,2692,0,0,0,0.00,2
,20161017,2692,2692,,,,2692,2692,0,0,0,0.00,2
,20161018,2692,2692,,,,2692,2692,0,0,0,0.00,2
,20161019,2692,2692,,,,2711,2711,19,19,0,0.00,2
,20161020,2711,2711,,,,2848,2848,137,137,0,0.00,2
,20161021,2848,2848,,,,2848,2848,0,0,0,0.00,2
,20161024,2848,2848,,,,2848,2848,0,0,0,0.00,2
,20161025,2848,2848,,,,2848,2848,0,0,0,0.00,2
,20161026,2848,2848,,,,2848,2848,0,0,0,0.00,2
,20161027,2848,2848,,,,2848,2848,0,0,0,0.00,2
,20161028,2848,2848,,,,2848,2848,0,0,0,0.00,2
,20161031,2848,2848,,,,2895,2895,47,47,0,0.00,2
,20161101,2895,2895,,,,2976,2976,81,81,0,0.00,2
,20161102,2976,2976,,,,2976,2976,0,0,0,0.00,2
,20161103,2976,2976,,,,2983,2983,7,7,0,0.00,2
,20161104,2983,2983,,,,2919,2919,-64,-64,0,0.00,2
,20161107,2919,2919,3092,3092,3092,3092,3092,173,173,2,6.18,2
,20161108,3092,3092,,,,3092,3092,0,0,0,0.00,2
,20161109,3092,3092,3277,3277,3277,3277,3277,185,185,12,39.32,14
,20161110,3277,3277,,,,3340,3340,63,63,0,0.00,14
,20161111,3340,3340,3250,3250,3250,3250,3250,-90,-90,4,13.00,14
,20161114,3250,3250,,,,3250,3250,0,0,0,0.00,14
,20161115,3250,3250,,,,3156,3156,-94,-94,0,0.00,14
,20161116,3156,3156,,,,2967,2967,-189,-189,0,0.00,14
,20161117,2967,2967,,,,2976,2976,9,9,0,0.00,14
,20161118,2976,2976,,,,2976,2976,0,0,0,0.00,14
,20161121,2976,2976,,,,2976,2976,0,0,0,0.00,14
,20161122,2976,2976,3104,3104,3104,3104,3104,128,128,6,18.62,8
,20161123,3104,3104,3267,3290,3260,3260,3270,156,166,36,117.75,24
,20161124,3260,3270,,,,3270,3270,0,0,0,0.00,24
,20161125,3270,3270,3478,3479,3478,3479,3478,209,208,4,13.91,22
,20161128,3479,3478,3576,3576,3439,3570,3532,92,54,12,42.39,22
,20161129,3570,3532,,,,3438,3438,-94,-94,0,0.00,22
,20161130,3438,3438,3314,3368,3285,3285,3316,-153,-122,22,72.95,0
,20161201,3285,3316,,,,3401,3401,85,85,0,0.00,0
,20161202,3401,3401,,,,3487,3487,86,86,0,0.00,0
,20161205,3487,3487,,,,3510,3510,23,23,0,0.00,0
,20161206,3510,3510,,,,3596,3596,86,86,0,0.00,0
,20161207,3596,3596,3539,3539,3539,3539,3539,-57,-57,4,14.16,4
,20161208,3539,3539,3785,3785,3785,3785,3785,246,246,4,15.14,0
,20161209,3785,3785,,,,3785,3785,0,0,0,0.00,0
,20161212,3785,3785,,,,3785,3785,0,0,0,0.00,0
,20161213,3785,3785,,,,3785,3785,0,0,0,0.00,0
,20161214,3785,3785,,,,3785,3785,0,0,0,0.00,0
,20161215,3785,3785,,,,3785,3785,0,0,0,0.00,0
,20161216,3785,3785,,,,3881,3881,96,96,0,0.00,0
,20161219,3881,3881,,,,3810,3810,-71,-71,0,0.00,0
,20161220,3810,3810,,,,3618,3618,-192,-192,0,0.00,0
,20161221,3618,3618,,,,3618,3618,0,0,0,0.00,0
,20161222,3618,3618,,,,3570,3570,-48,-48,0,0.00,0
,20161223,3570,3570,,,,3488,3488,-82,-82,0,0.00,0
,20161226,3488,3488,,,,3416,3416,-72,-72,0,0.00,0
,20161227,3416,3416,,,,3416,3416,0,0,0,0.00,0
,20161228,3416,3416,,,,3416,3416,0,0,0,0.00,0
,20161229,3416,3416,,,,3416,3416,0,0,0,0.00,0
,20161230,3416,3416,,,,3416,3416,0,0,0,0.00,0
hc1704,20160418,2427,2427,,,,2446,2446,19,19,0,0.00,0
,20160419,2446,2446,2446,2666,2446,2665,2567,219,121,28,71.88,6
,20160420,2665,2567,2666,2666,2666,2666,2666,99,99,2,5.33,4
,20160421,2666,2666,,,,2758,2758,92,92,0,0.00,4
,20160422,2758,2758,,,,2758,2758,0,0,0,0.00,4
,20160425,2758,2758,,,,2758,2758,0,0,0,0.00,4
,20160426,2758,2758,,,,2646,2646,-112,-112,0,0.00,4
,20160427,2646,2646,,,,2646,2646,0,0,0,0.00,4
,20160428,2646,2646,,,,2646,2646,0,0,0,0.00,4
,20160429,2646,2646,,,,2646,2646,0,0,0,0.00,4
,20160503,2646,2646,,,,2522,2522,-124,-124,0,0.00,4
,20160504,2522,2522,,,,2522,2522,0,0,0,0.00,4
,20160505,2522,2522,,,,2478,2478,-44,-44,0,0.00,4
,20160506,2478,2478,,,,2478,2478,0,0,0,0.00,4
,20160509,2478,2478,2329,2361,2329,2361,2345,-117,-133,4,9.38,6
,20160510,2361,2345,,,,2345,2345,0,0,0,0.00,6
,20160511,2345,2345,,,,2345,2345,0,0,0,0.00,6
,20160512,2345,2345,2290,2290,2290,2290,2290,-55,-55,2,4.58,8
,20160513,2290,2290,,,,2275,2275,-15,-15,0,0.00,8
,20160516,2275,2275,,,,2275,2275,0,0,0,0.00,8
,20160517,2275,2275,,,,2275,2275,0,0,0,0.00,8
,20160518,2275,2275,,,,2275,2275,0,0,0,0.00,8
,20160519,2275,2275,,,,2235,2235,-40,-40,0,0.00,8
,20160520,2235,2235,,,,2238,2238,3,3,0,0.00,8
,20160523,2238,2238,,,,2144,2144,-94,-94,0,0.00,8
,20160524,2144,2144,,,,2131,2131,-13,-13,0,0.00,8
,20160525,2131,2131,,,,2133,2133,2,2,0,0.00,8
,20160526,2133,2133,,,,2134,2134,1,1,0,0.00,8
,20160527,2134,2134,2262,2262,2262,2262,2262,128,128,4,9.05,8
,20160530,2262,2262,2228,2229,2228,2229,2228,-33,-34,4,8.91,8
,20160531,2229,2228,,,,2228,2228,0,0,0,0.00,8
,20160601,2228,2228,,,,2228,2228,0,0,0,0.00,8
,20160602,2228,2228,,,,2228,2228,0,0,0,0.00,8
,20160603,2228,2228,,,,2235,2235,7,7,0,0.00,8
,20160606,2235,2235,,,,2235,2235,0,0,0,0.00,8
,20160607,2235,2235,,,,2235,2235,0,0,0,0.00,8
,20160608,2235,2235,,,,2287,2287,52,52,0,0.00,8
,20160613,2287,2287,,,,2335,2335,48,48,0,0.00,8
,20160614,2335,2335,,,,2335,2335,0,0,0,0.00,8
,20160615,2335,2335,,,,2335,2335,0,0,0,0.00,8
,20160616,2335,2335,,,,2344,2344,9,9,0,0.00,8
,20160617,2344,2344,,,,2344,2344,0,0,0,0.00,8
,20160620,2344,2344,,,,2344,2344,0,0,0,0.00,8
,20160621,2344,2344,,,,2354,2354,10,10,0,0.00,8
,20160622,2354,2354,,,,2354,2354,0,0,0,0.00,8
,20160623,2354,2354,,,,2349,2349,-5,-5,0,0.00,8
,20160624,2349,2349,,,,2347,2347,-2,-2,0,0.00,8
,20160627,2347,2347,2366,2366,2366,2366,2366,19,19,4,9.46,4
,20160628,2366,2366,,,,2445,2445,79,79,0,0.00,4
,20160629,2445,2445,,,,2445,2445,0,0,0,0.00,4
,20160630,2445,2445,,,,2445,2445,0,0,0,0.00,4
,20160701,2445,2445,,,,2483,2483,38,38,0,0.00,4
,20160704,2483,2483,,,,2550,2550,67,67,0,0.00,4
,20160705,2550,2550,,,,2550,2550,0,0,0,0.00,4
,20160706,2550,2550,,,,2550,2550,0,0,0,0.00,4
,20160707,2550,2550,,,,2550,2550,0,0,0,0.00,4
,20160708,2550,2550,,,,2550,2550,0,0,0,0.00,4
,20160711,2550,2550,,,,2550,2550,0,0,0,0.00,4
,20160712,2550,2550,,,,2618,2618,68,68,0,0.00,4
,20160713,2618,2618,,,,2618,2618,0,0,0,0.00,4
,20160714,2618,2618,,,,2618,2618,0,0,0,0.00,4
,20160715,2618,2618,,,,2618,2618,0,0,0,0.00,4
,20160718,2618,2618,,,,2529,2529,-89,-89,0,0.00,4
,20160719,2529,2529,,,,2431,2431,-98,-98,0,0.00,4
,20160720,2431,2431,,,,2431,2431,0,0,0,0.00,4
,20160721,2431,2431,,,,2497,2497,66,66,0,0.00,4
,20160722,2497,2497,,,,2497,2497,0,0,0,0.00,4
,20160725,2497,2497,,,,2497,2497,0,0,0,0.00,4
,20160726,2497,2497,,,,2513,2513,16,16,0,0.00,4
,20160727,2513,2513,,,,2577,2577,64,64,0,0.00,4
,20160728,2577,2577,,,,2625,2625,48,48,0,0.00,4
,20160729,2625,2625,,,,2616,2616,-9,-9,0,0.00,4
,20160801,2616,2616,2724,2724,2627,2659,2677,43,61,16,42.83,4
,20160802,2659,2677,,,,2677,2677,0,0,0,0.00,4
,20160803,2677,2677,,,,2677,2677,0,0,0,0.00,4
,20160804,2677,2677,2620,2620,2620,2620,2620,-57,-57,2,5.24,4
,20160805,2620,2620,,,,2670,2670,50,50,0,0.00,4
,20160808,2670,2670,,,,2742,2742,72,72,0,0.00,4
,20160809,2742,2742,,,,2742,2742,0,0,0,0.00,4
,20160810,2742,2742,,,,2742,2742,0,0,0,0.00,4
,20160811,2742,2742,,,,2742,2742,0,0,0,0.00,4
,20160812,2742,2742,,,,2742,2742,0,0,0,0.00,4
,20160815,2742,2742,,,,2742,2742,0,0,0,0.00,4
,20160816,2742,2742,,,,2742,2742,0,0,0,0.00,4
,20160817,2742,2742,,,,2742,2742,0,0,0,0.00,4
,20160818,2742,2742,,,,2742,2742,0,0,0,0.00,4
,20160819,2742,2742,,,,2742,2742,0,0,0,0.00,4
,20160822,2742,2742,,,,2742,2742,0,0,0,0.00,4
,20160823,2742,2742,,,,2742,2742,0,0,0,0.00,4
,20160824,2742,2742,,,,2764,2764,22,22,0,0.00,4
,20160825,2764,2764,,,,2764,2764,0,0,0,0.00,4
,20160826,2764,2764,,,,2764,2764,0,0,0,0.00,4
,20160829,2764,2764,,,,2764,2764,0,0,0,0.00,4
,20160830,2764,2764,,,,2761,2761,-3,-3,0,0.00,4
,20160831,2761,2761,,,,2717,2717,-44,-44,0,0.00,4
,20160901,2717,2717,,,,2684,2684,-33,-33,0,0.00,4
,20160902,2684,2684,,,,2684,2684,0,0,0,0.00,4
,20160905,2684,2684,,,,2684,2684,0,0,0,0.00,4
,20160906,2684,2684,,,,2684,2684,0,0,0,0.00,4
,20160907,2684,2684,,,,2615,2615,-69,-69,0,0.00,4
,20160908,2615,2615,,,,2615,2615,0,0,0,0.00,4
,20160909,2615,2615,,,,2615,2615,0,0,0,0.00,4
,20160912,2615,2615,2608,2618,2536,2559,2565,-56,-50,62,159.08,4
,20160913,2559,2565,2559,2559,2559,2559,2559,-6,-6,2,5.12,4
,20160914,2559,2559,,,,2559,2559,0,0,0,0.00,4
,20160919,2559,2559,,,,2547,2547,-12,-12,0,0.00,4
,20160920,2547,2547,,,,2547,2547,0,0,0,0.00,4
,20160921,2547,2547,,,,2547,2547,0,0,0,0.00,4
,20160922,2547,2547,2584,2584,2572,2572,2578,25,31,4,10.31,4
,20160923,2572,2578,2596,2596,2596,2596,2596,18,18,2,5.19,4
,20160926,2596,2596,,,,2596,2596,0,0,0,0.00,4
,20160927,2596,2596,,,,2596,2596,0,0,0,0.00,4
,20160928,2596,2596,,,,2596,2596,0,0,0,0.00,4
,20160929,2596,2596,,,,2596,2596,0,0,0,0.00,4
,20160930,2596,2596,,,,2539,2539,-57,-57,0,0.00,4
,20161010,2539,2539,,,,2539,2539,0,0,0,0.00,4
,20161011,2539,2539,2639,2639,2639,2639,2639,100,100,2,5.28,4
,20161012,2639,2639,,,,2751,2751,112,112,0,0.00,4
,20161013,2751,2751,,,,2718,2718,-33,-33,0,0.00,4
,20161014,2718,2718,,,,2718,2718,0,0,0,0.00,4
,20161017,2718,2718,,,,2718,2718,0,0,0,0.00,4
,20161018,2718,2718,,,,2718,2718,0,0,0,0.00,4
,20161019,2718,2718,,,,2718,2718,0,0,0,0.00,4
,20161020,2718,2718,,,,2718,2718,0,0,0,0.00,4
,20161021,2718,2718,,,,2714,2714,-4,-4,0,0.00,4
,20161024,2714,2714,,,,2731,2731,17,17,0,0.00,4
,20161025,2731,2731,,,,2813,2813,82,82,0,0.00,4
,20161026,2813,2813,2825,2825,2825,2825,2825,12,12,2,5.65,4
,20161027,2825,2825,,,,2825,2825,0,0,0,0.00,4
,20161028,2825,2825,,,,2825,2825,0,0,0,0.00,4
,20161031,2825,2825,2839,2839,2839,2839,2839,14,14,2,5.68,4
,20161101,2839,2839,,,,2839,2839,0,0,0,0.00,4
,20161102,2839,2839,3004,3004,3004,3004,3004,165,165,2,6.01,4
,20161103,3004,3004,3000,3000,3000,3000,3000,-4,-4,2,6.00,2
,20161104,3000,3000,,,,2935,2935,-65,-65,0,0.00,2
,20161107,2935,2935,,,,3108,3108,173,173,0,0.00,2
,20161108,3108,3108,,,,3108,3108,0,0,0,0.00,2
,20161109,3108,3108,,,,3293,3293,185,185,0,0.00,2
,20161110,3293,3293,,,,3356,3356,63,63,0,0.00,2
,20161111,3356,3356,,,,3265,3265,-91,-91,0,0.00,2
,20161114,3265,3265,3188,3324,3188,3324,3256,59,-9,4,13.02,2
,20161115,3324,3256,,,,3162,3162,-94,-94,0,0.00,2
,20161116,3162,3162,,,,2972,2972,-190,-190,0,0.00,2
,20161117,2972,2972,,,,2981,2981,9,9,0,0.00,2
,20161118,2981,2981,,,,2984,2984,3,3,0,0.00,2
,20161121,2984,2984,,,,2924,2924,-60,-60,0,0.00,2
,20161122,2924,2924,,,,3049,3049,125,125,0,0.00,2
,20161123,3049,3049,,,,3212,3212,163,163,0,0.00,2
,20161124,3212,3212,3404,3404,3379,3379,3391,167,179,4,13.57,2
,20161125,3379,3391,,,,3607,3607,216,216,0,0.00,2
,20161128,3607,3607,,,,3607,3607,0,0,0,0.00,2
,20161129,3607,3607,,,,3565,3565,-42,-42,0,0.00,2
,20161130,3565,3565,,,,3438,3438,-127,-127,0,0.00,2
,20161201,3438,3438,,,,3527,3527,89,89,0,0.00,2
,20161202,3527,3527,,,,3616,3616,89,89,0,0.00,2
,20161205,3616,3616,,,,3639,3639,23,23,0,0.00,2
,20161206,3639,3639,,,,3728,3728,89,89,0,0.00,2
,20161207,3728,3728,,,,3668,3668,-60,-60,0,0.00,2
,20161208,3668,3668,3797,3797,3797,3797,3797,129,129,4,15.19,2
,20161209,3797,3797,,,,3765,3765,-32,-32,0,0.00,2
,20161212,3765,3765,,,,3899,3899,134,134,0,0.00,2
,20161213,3899,3899,,,,3905,3905,6,6,0,0.00,2
,20161214,3905,3905,3842,3842,3842,3842,3842,-63,-63,2,7.68,2
,20161215,3842,3842,,,,3839,3839,-3,-3,0,0.00,2
,20161216,3839,3839,3841,3841,3721,3721,3767,-118,-72,6,22.60,2
,20161219,3721,3767,3622,3753,3622,3654,3680,-113,-87,10,36.81,0
,20161220,3654,3680,,,,3494,3494,-186,-186,0,0.00,0
,20161221,3494,3494,,,,3504,3504,10,10,0,0.00,0
,20161222,3504,3504,,,,3458,3458,-46,-46,0,0.00,0
,20161223,3458,3458,,,,3458,3458,0,0,0,0.00,0
,20161226,3458,3458,,,,3387,3387,-71,-71,0,0.00,0
,20161227,3387,3387,,,,3387,3387,0,0,0,0.00,0
,20161228,3387,3387,,,,3387,3387,0,0,0,0.00,0
,20161229,3387,3387,,,,3367,3367,-20,-20,0,0.00,0
,20161230,3367,3367,,,,3372,3372,5,5,0,0.00,0
hc1705,20160517,2275,2275,2200,2246,2200,2245,2223,-30,-52,42,93.40,28
,20160518,2245,2223,2260,2260,2182,2182,2208,-41,-15,40,88.36,60
,20160519,2182,2208,2181,2213,2164,2188,2178,-20,-30,40,87.14,74
,20160520,2188,2178,,,,2182,2182,4,4,0,0.00,74
,20160523,2182,2182,2200,2200,2058,2099,2084,-83,-98,302,629.45,254
,20160524,2099,2084,2162,2162,2075,2101,2096,17,12,96,201.22,306
,20160525,2101,2096,2098,2111,2062,2066,2089,-30,-7,144,300.87,374
,20160526,2066,2089,2085,2110,2085,2109,2100,20,11,62,130.24,406
,20160527,2109,2100,2116,2225,2100,2200,2156,100,56,212,457.19,410
,20160530,2200,2156,2196,2216,2096,2185,2163,29,7,72,155.74,408
,20160531,2185,2163,2202,2203,2161,2161,2182,-2,19,76,165.87,404
,20160601,2161,2182,2161,2161,2121,2131,2139,-51,-43,108,231.02,436
,20160602,2131,2139,2139,2164,2132,2132,2149,-7,10,534,"1,147.66",766
,20160603,2132,2149,2132,2170,2126,2163,2154,14,5,324,698.16,788
,20160606,2163,2154,2180,2219,2151,2219,2182,65,28,146,318.71,816
,20160607,2219,2182,2222,2263,2222,2235,2235,53,53,92,205.69,816
,20160608,2235,2235,2217,2260,2217,2260,2238,25,3,454,"1,016.36",798
,20160613,2260,2238,2268,2302,2243,2290,2278,52,40,100,227.82,802
,20160614,2290,2278,2345,2345,2218,2230,2254,-48,-24,656,"1,479.11",646
,20160615,2230,2254,2225,2242,2202,2217,2221,-37,-33,44,97.74,658
,20160616,2217,2221,2232,2246,2222,2222,2236,1,15,26,58.15,654
,20160617,2222,2236,2206,2215,2181,2192,2193,-44,-43,80,175.51,702
,20160620,2192,2193,2205,2233,2198,2205,2213,12,20,38,84.10,706
,20160621,2205,2213,2184,2241,2184,2211,2213,-2,0,74,163.77,732
,20160622,2211,2213,2226,2267,2215,2249,2244,36,31,44,98.75,736
,20160623,2249,2244,2259,2267,2239,2241,2253,-3,9,72,162.27,762
,20160624,2241,2253,2259,2269,2220,2243,2245,-10,-8,90,202.11,804
,20160627,2243,2245,2248,2352,2248,2352,2300,107,55,150,345.09,778
,20160628,2352,2300,2340,2368,2316,2362,2344,62,44,162,379.76,788
,20160629,2362,2344,2345,2380,2330,2355,2354,11,10,110,259.00,806
,20160630,2355,2354,2359,2428,2349,2425,2394,71,40,240,574.58,872
,20160701,2425,2394,2421,2461,2400,2419,2428,25,34,90,218.58,872
,20160704,2419,2428,2466,2515,2419,2506,2483,78,55,412,"1,023.39",818
,20160705,2506,2483,2523,2530,2423,2490,2478,7,-5,248,614.57,832
,20160706,2490,2478,2490,2492,2425,2449,2444,-29,-34,128,312.94,870
,20160707,2449,2444,2418,2540,2418,2479,2488,35,44,176,438.04,840
,20160708,2479,2488,2491,2505,2450,2505,2464,17,-24,218,537.16,890
,20160711,2505,2464,2471,2533,2454,2486,2490,22,26,118,293.83,902
,20160712,2486,2490,2518,2590,2501,2588,2552,98,62,288,735.08,878
,20160713,2588,2552,2555,2620,2555,2579,2570,27,18,258,663.30,760
,20160714,2579,2570,2589,2594,2550,2580,2571,10,1,98,251.99,740
,20160715,2580,2571,2596,2606,2556,2574,2582,3,11,36,92.95,740
,20160718,2574,2582,2577,2577,2427,2427,2491,-155,-91,228,567.99,872
,20160719,2427,2491,2436,2436,2343,2389,2391,-102,-100,314,751.03,946
,20160720,2389,2391,2405,2406,2369,2380,2381,-11,-10,328,781.24,1132
,20160721,2380,2381,2398,2492,2388,2467,2436,86,55,188,458.04,1032
,20160722,2467,2436,2470,2471,2401,2410,2434,-26,-2,178,433.31,1036
,20160725,2410,2434,2422,2490,2392,2455,2422,21,-12,216,523.31,1050
,20160726,2455,2422,2457,2485,2426,2482,2449,60,27,178,436.03,1092
,20160727,2482,2449,2480,2548,2476,2516,2514,67,65,416,"1,046.03",1022
,20160728,2516,2514,2530,2585,2530,2573,2563,59,49,234,599.80,1034
,20160729,2573,2563,2573,2580,2506,2511,2544,-52,-19,168,427.43,1016
,20160801,2511,2544,2523,2617,2497,2606,2583,62,39,272,702.75,990
,20160802,2606,2583,2600,2601,2569,2595,2582,12,-1,390,"1,007.18",914
,20160803,2595,2582,2582,2587,2555,2576,2574,-6,-8,176,453.10,882
,20160804,2576,2574,2547,2579,2497,2530,2521,-44,-53,298,751.53,996
,20160805,2530,2521,2542,2602,2542,2602,2590,81,69,238,616.48,930
,20160808,2602,2590,2596,2680,2596,2678,2642,88,52,220,581.27,934
,20160809,2678,2642,2670,2684,2618,2644,2656,2,14,184,488.79,858
,20160810,2644,2656,2648,2680,2629,2653,2646,-3,-10,152,402.26,822
,20160811,2653,2646,2638,2656,2606,2639,2637,-7,-9,172,453.65,842
,20160812,2639,2637,2643,2650,2619,2640,2632,3,-5,96,252.69,858
,20160815,2640,2632,2620,2621,2562,2596,2593,-36,-39,224,580.97,936
,20160816,2596,2593,2598,2706,2591,2686,2656,93,63,340,903.25,1034
,20160817,2686,2656,2684,2715,2658,2660,2687,4,31,346,929.77,1034
,20160818,2660,2687,2662,2705,2640,2678,2678,-9,-9,276,739.13,1036
,20160819,2678,2678,2672,2718,2650,2716,2695,38,17,576,"1,552.59",1082
,20160822,2716,2695,2718,2758,2704,2717,2738,22,43,1432,"3,920.89",1676
,20160823,2717,2738,2665,2790,2665,2782,2742,44,4,1534,"4,207.75",2058
,20160824,2782,2742,2780,2829,2771,2795,2798,53,56,4280,"11,979.05",4534
,20160825,2795,2798,2798,2834,2684,2773,2776,-25,-22,3148,"8,741.28",5142
,20160826,2773,2776,2769,2773,2716,2719,2748,-57,-28,1612,"4,430.61",5452
,20160829,2719,2748,2681,2721,2650,2694,2691,-54,-57,3344,"9,001.85",6786
,20160830,2694,2691,2695,2714,2639,2643,2675,-48,-16,1936,"5,180.72",7076
,20160831,2643,2675,2639,2666,2592,2592,2632,-83,-43,2762,"7,269.82",7402
,20160901,2592,2632,2566,2623,2566,2619,2595,-13,-37,2978,"7,728.46",8008
,20160902,2619,2595,2616,2675,2598,2622,2635,27,40,6690,"17,632.50",10642
,20160905,2622,2635,2600,2687,2600,2647,2658,12,23,3918,"10,414.07",11760
,20160906,2647,2658,2631,2675,2610,2616,2642,-42,-16,6722,"17,763.51",13520
,20160907,2616,2642,2610,2629,2535,2536,2563,-106,-79,7788,"19,965.90",16482
,20160908,2536,2563,2521,2584,2521,2557,2559,-6,-4,5936,"15,194.65",17730
,20160909,2557,2559,2560,2581,2537,2572,2556,13,-3,8582,"21,936.61",21004
,20160912,2572,2556,2567,2590,2501,2510,2528,-46,-28,10214,"25,824.78",23230
,20160913,2510,2528,2535,2545,2486,2504,2519,-24,-9,5896,"14,854.32",24208
,20160914,2504,2519,2504,2529,2489,2516,2513,-3,-6,4846,"12,182.40",24460
,20160919,2516,2513,2500,2530,2460,2516,2511,3,-2,7538,"18,931.01",26862
,20160920,2516,2511,2516,2545,2505,2526,2526,15,15,12836,"32,425.12",30226
,20160921,2526,2526,2534,2539,2498,2508,2513,-18,-13,12232,"30,749.98",33416
,20160922,2508,2513,2508,2583,2504,2545,2551,32,38,13490,"34,416.25",32972
,20160923,2545,2551,2545,2577,2544,2577,2565,26,14,10782,"27,665.85",33826
,20160926,2577,2565,2580,2618,2569,2580,2586,15,21,12482,"32,288.05",33080
,20160927,2580,2586,2580,2585,2521,2542,2542,-44,-44,16224,"41,253.68",37206
,20160928,2542,2542,2542,2560,2528,2556,2545,14,3,7816,"19,893.22",37292
,20160929,2556,2545,2556,2603,2539,2539,2578,-6,33,12980,"33,473.95",37146
,20160930,2539,2578,2539,2554,2509,2521,2524,-57,-54,11864,"29,947.43",40558
,20161010,2521,2524,2510,2560,2479,2535,2517,11,-7,15576,"39,214.78",45782
,20161011,2535,2517,2530,2605,2530,2604,2583,87,66,27340,"70,636.41",48218
,20161012,2604,2583,2602,2642,2593,2634,2620,51,37,22188,"58,132.82",49124
,20161013,2634,2620,2634,2652,2613,2626,2627,6,7,23668,"62,195.36",50324
,20161014,2626,2627,2617,2689,2615,2665,2651,38,24,21658,"57,421.63",56628
,20161017,2665,2651,2665,2701,2649,2688,2674,37,23,43190,"115,496.65",67782
,20161018,2688,2674,2680,2688,2645,2676,2665,2,-9,23836,"63,538.15",72434
,20161019,2676,2665,2682,2765,2681,2698,2716,33,51,40530,"110,091.84",75830
,20161020,2698,2716,2690,2750,2689,2742,2727,26,11,23826,"64,985.15",75658
,20161021,2742,2727,2745,2756,2695,2733,2718,6,-9,23304,"63,358.32",76654
,20161024,2733,2718,2733,2753,2692,2747,2722,29,4,21328,"58,063.02",77094
,20161025,2747,2722,2747,2845,2747,2824,2806,102,84,35540,"99,727.69",73776
,20161026,2824,2806,2823,2850,2773,2796,2805,-10,-1,32302,"90,614.85",71570
,20161027,2796,2805,2796,2822,2756,2782,2790,-23,-15,27226,"75,968.83",70816
,20161028,2782,2790,2790,2850,2778,2838,2817,48,27,31830,"89,691.67",66634
,20161031,2838,2817,2841,2915,2821,2905,2869,88,52,70874,"203,373.53",71554
,20161101,2905,2869,2900,2983,2867,2961,2931,92,62,62346,"182,786.80",65644
,20161102,2961,2931,2973,3024,2957,2967,2990,36,59,70612,"211,151.99",68598
,20161103,2967,2990,2975,2995,2956,2988,2976,-2,-14,50726,"150,998.22",72864
,20161104,2988,2976,2993,3021,2966,2990,2998,14,22,58954,"176,801.78",71926
,20161107,2990,2998,2998,3177,2967,3145,3075,147,77,82910,"254,970.73",73122
,20161108,3145,3075,3142,3177,3040,3083,3113,8,38,57512,"179,058.79",65618
,20161109,3083,3113,3075,3282,3070,3270,3206,157,93,78220,"250,848.19",68564
,20161110,3270,3206,3265,3385,3225,3268,3293,62,87,82322,"271,094.38",74412
,20161111,3268,3293,3286,3405,3255,3394,3336,101,43,66102,"220,547.63",77886
,20161114,3394,3336,3400,3506,3222,3258,3342,-78,6,94594,"316,214.65",76646
,20161115,3258,3342,3268,3319,3141,3141,3241,-201,-101,51612,"167,325.03",80498
,20161116,3141,3241,3097,3147,3033,3128,3102,-113,-139,85814,"266,255.98",89978
,20161117,3128,3102,3119,3158,3059,3130,3102,28,0,42704,"132,504.65",91784
,20161118,3130,3102,3130,3161,3066,3090,3101,-12,-1,42418,"131,568.25",92020
,20161121,3090,3101,3108,3115,2996,3051,3061,-50,-40,54110,"165,682.26",90746
,20161122,3051,3061,3046,3244,3046,3244,3173,183,112,88440,"280,672.08",99616
,20161123,3244,3173,3245,3365,3230,3343,3301,170,128,95162,"314,159.50",109590
,20161124,3343,3301,3331,3438,3259,3355,3368,54,67,126988,"427,709.85",124450
,20161125,3355,3368,3365,3594,3336,3533,3480,165,112,180640,"628,750.29",147234
,20161128,3533,3480,3549,3630,3480,3608,3559,128,79,195448,"695,744.16",146280
,20161129,3608,3559,3596,3615,3355,3358,3492,-201,-67,208844,"729,357.17",148826
,20161130,3358,3492,3362,3374,3247,3247,3307,-245,-185,150820,"498,826.78",152200
,20161201,3247,3307,3260,3550,3248,3513,3419,206,112,430722,"1,472,949.85",170160
,20161202,3513,3419,3525,3558,3385,3494,3473,75,54,657320,"2,283,452.93",208186
,20161205,3494,3473,3488,3625,3436,3583,3532,110,59,784556,"2,771,794.37",262754
,20161206,3583,3532,3600,3674,3570,3642,3632,110,100,732954,"2,662,593.19",309866
,20161207,3642,3632,3640,3850,3636,3751,3750,119,118,855854,"3,209,854.23",365838
,20161208,3751,3750,3752,3799,3654,3760,3730,10,-20,834850,"3,114,188.21",362772
,20161209,3760,3730,3770,3795,3591,3740,3695,10,-35,905754,"3,347,245.78",364004
,20161212,3740,3695,3755,3898,3696,3770,3797,75,102,637124,"2,419,708.42",343524
,20161213,3770,3797,3778,3837,3744,3822,3798,25,1,358662,"1,362,323.27",340284
,20161214,3822,3798,3835,3835,3676,3722,3747,-76,-51,402062,"1,506,541.04",345432
,20161215,3722,3747,3725,3805,3655,3787,3733,40,-14,390816,"1,458,985.56",351358
,20161216,3787,3733,3767,3770,3676,3676,3733,-57,0,297762,"1,111,799.24",351338
,20161219,3676,3733,3666,3695,3551,3556,3633,-177,-100,379326,"1,378,409.36",340602
,20161220,3556,3633,3549,3600,3511,3574,3555,-59,-78,309776,"1,101,537.73",332926
,20161221,3574,3555,3583,3623,3512,3588,3578,33,23,325224,"1,163,865.16",355950
,20161222,3588,3578,3590,3595,3410,3415,3505,-163,-73,355852,"1,247,316.70",351524
,20161223,3415,3505,3405,3464,3353,3385,3406,-120,-99,340162,"1,158,617.70",345736
,20161226,3385,3406,3385,3415,3220,3299,3307,-107,-99,416016,"1,376,165.74",333464
,20161227,3299,3307,3302,3400,3261,3391,3328,84,21,322420,"1,073,285.18",333126
,20161228,3391,3328,3398,3479,3361,3405,3424,77,96,349140,"1,195,562.50",334692
,20161229,3405,3424,3407,3424,3320,3352,3370,-72,-54,324334,"1,093,193.89",342594
,20161230,3352,3370,3351,3392,3283,3305,3329,-65,-41,274602,"914,153.69",354172
hc1706,20160616,2221,2221,,,,2221,2221,0,0,0,0.00,0
,20160617,2221,2221,,,,2221,2221,0,0,0,0.00,0
,20160620,2221,2221,,,,2221,2221,0,0,0,0.00,0
,20160621,2221,2221,,,,2221,2221,0,0,0,0.00,0
,20160622,2221,2221,,,,2221,2221,0,0,0,0.00,0
,20160623,2221,2221,,,,2228,2228,7,7,0,0.00,0
,20160624,2228,2228,,,,2220,2220,-8,-8,0,0.00,0
,20160627,2220,2220,,,,2274,2274,54,54,0,0.00,0
,20160628,2274,2274,,,,2300,2300,26,26,0,0.00,0
,20160629,2300,2300,,,,2307,2307,7,7,0,0.00,0
,20160630,2307,2307,,,,2340,2340,33,33,0,0.00,0
,20160701,2340,2340,,,,2401,2401,61,61,0,0.00,0
,20160704,2401,2401,,,,2479,2479,78,78,0,0.00,0
,20160705,2479,2479,,,,2479,2479,0,0,0,0.00,0
,20160706,2479,2479,,,,2479,2479,0,0,0,0.00,0
,20160707,2479,2479,,,,2479,2479,0,0,0,0.00,0
,20160708,2479,2479,,,,2479,2479,0,0,0,0.00,0
,20160711,2479,2479,,,,2479,2479,0,0,0,0.00,0
,20160712,2479,2479,,,,2550,2550,71,71,0,0.00,0
,20160713,2550,2550,,,,2550,2550,0,0,0,0.00,0
,20160714,2550,2550,,,,2551,2551,1,1,0,0.00,0
,20160715,2551,2551,,,,2552,2552,1,1,0,0.00,0
,20160718,2552,2552,,,,2552,2552,0,0,0,0.00,0
,20160719,2552,2552,,,,2552,2552,0,0,0,0.00,0
,20160720,2552,2552,,,,2539,2539,-13,-13,0,0.00,0
,20160721,2539,2539,,,,2539,2539,0,0,0,0.00,0
,20160722,2539,2539,,,,2539,2539,0,0,0,0.00,0
,20160725,2539,2539,,,,2539,2539,0,0,0,0.00,0
,20160726,2539,2539,,,,2539,2539,0,0,0,0.00,0
,20160727,2539,2539,,,,2539,2539,0,0,0,0.00,0
,20160728,2539,2539,,,,2570,2570,31,31,0,0.00,0
,20160729,2570,2570,,,,2570,2570,0,0,0,0.00,0
,20160801,2570,2570,,,,2570,2570,0,0,0,0.00,0
,20160802,2570,2570,,,,2570,2570,0,0,0,0.00,0
,20160803,2570,2570,,,,2570,2570,0,0,0,0.00,0
,20160804,2570,2570,,,,2570,2570,0,0,0,0.00,0
,20160805,2570,2570,,,,2570,2570,0,0,0,0.00,0
,20160808,2570,2570,,,,2588,2588,18,18,0,0.00,0
,20160809,2588,2588,,,,2620,2620,32,32,0,0.00,0
,20160810,2620,2620,,,,2620,2620,0,0,0,0.00,0
,20160811,2620,2620,,,,2620,2620,0,0,0,0.00,0
,20160812,2620,2620,,,,2620,2620,0,0,0,0.00,0
,20160815,2620,2620,,,,2620,2620,0,0,0,0.00,0
,20160816,2620,2620,2709,2709,2709,2709,2709,89,89,10,27.09,10
,20160817,2709,2709,,,,2709,2709,0,0,0,0.00,10
,20160818,2709,2709,2699,2699,2699,2699,2699,-10,-10,2,5.40,10
,20160819,2699,2699,2699,2699,2682,2687,2687,-12,-12,8,21.50,10
,20160822,2687,2687,,,,2708,2708,21,21,0,0.00,10
,20160823,2708,2708,,,,2712,2712,4,4,0,0.00,10
,20160824,2712,2712,,,,2765,2765,53,53,0,0.00,10
,20160825,2765,2765,,,,2765,2765,0,0,0,0.00,10
,20160826,2765,2765,,,,2765,2765,0,0,0,0.00,10
,20160829,2765,2765,2749,2749,2749,2749,2749,-16,-16,2,5.50,10
,20160830,2749,2749,,,,2710,2710,-39,-39,0,0.00,10
,20160831,2710,2710,2671,2671,2671,2671,2671,-39,-39,2,5.34,8
,20160901,2671,2671,,,,2660,2660,-11,-11,0,0.00,8
,20160902,2660,2660,2636,2636,2636,2636,2636,-24,-24,4,10.54,8
,20160905,2636,2636,,,,2636,2636,0,0,0,0.00,8
,20160906,2636,2636,,,,2636,2636,0,0,0,0.00,8
,20160907,2636,2636,,,,2557,2557,-79,-79,0,0.00,8
,20160908,2557,2557,2603,2603,2528,2528,2565,-29,8,4,10.26,8
,20160909,2528,2565,,,,2565,2565,0,0,0,0.00,8
,20160912,2565,2565,,,,2547,2547,-18,-18,0,0.00,8
,20160913,2547,2547,,,,2547,2547,0,0,0,0.00,8
,20160914,2547,2547,,,,2547,2547,0,0,0,0.00,8
,20160919,2547,2547,,,,2547,2547,0,0,0,0.00,8
,20160920,2547,2547,,,,2547,2547,0,0,0,0.00,8
,20160921,2547,2547,,,,2547,2547,0,0,0,0.00,8
,20160922,2547,2547,,,,2547,2547,0,0,0,0.00,8
,20160923,2547,2547,,,,2547,2547,0,0,0,0.00,8
,20160926,2547,2547,,,,2559,2559,12,12,0,0.00,8
,20160927,2559,2559,,,,2559,2559,0,0,0,0.00,8
,20160928,2559,2559,,,,2559,2559,0,0,0,0.00,8
,20160929,2559,2559,,,,2559,2559,0,0,0,0.00,8
,20160930,2559,2559,2551,2551,2551,2551,2551,-8,-8,8,20.41,4
,20161010,2551,2551,,,,2551,2551,0,0,0,0.00,4
,20161011,2551,2551,,,,2618,2618,67,67,0,0.00,4
,20161012,2618,2618,,,,2655,2655,37,37,0,0.00,4
,20161013,2655,2655,,,,2655,2655,0,0,0,0.00,4
,20161014,2655,2655,,,,2655,2655,0,0,0,0.00,4
,20161017,2655,2655,,,,2659,2659,4,4,0,0.00,4
,20161018,2659,2659,,,,2659,2659,0,0,0,0.00,4
,20161019,2659,2659,,,,2659,2659,0,0,0,0.00,4
,20161020,2659,2659,,,,2670,2670,11,11,0,0.00,4
,20161021,2670,2670,,,,2661,2661,-9,-9,0,0.00,4
,20161024,2661,2661,,,,2665,2665,4,4,0,0.00,4
,20161025,2665,2665,,,,2747,2747,82,82,0,0.00,4
,20161026,2747,2747,2878,2878,2772,2772,2845,25,98,202,574.81,10
,20161027,2772,2845,,,,2806,2806,-39,-39,0,0.00,10
,20161028,2806,2806,,,,2806,2806,0,0,0,0.00,10
,20161031,2806,2806,,,,2860,2860,54,54,0,0.00,10
,20161101,2860,2860,2897,2897,2897,2897,2897,37,37,2,5.79,10
,20161102,2897,2897,,,,2897,2897,0,0,0,0.00,10
,20161103,2897,2897,,,,2951,2951,54,54,0,0.00,10
,20161104,2951,2951,,,,2951,2951,0,0,0,0.00,10
,20161107,2951,2951,,,,3027,3027,76,76,0,0.00,10
,20161108,3027,3027,,,,3027,3027,0,0,0,0.00,10
,20161109,3027,3027,,,,3118,3118,91,91,0,0.00,10
,20161110,3118,3118,,,,3202,3202,84,84,0,0.00,10
,20161111,3202,3202,,,,3244,3244,42,42,0,0.00,10
,20161114,3244,3244,,,,3250,3250,6,6,0,0.00,10
,20161115,3250,3250,,,,3152,3152,-98,-98,0,0.00,10
,20161116,3152,3152,,,,3017,3017,-135,-135,0,0.00,10
,20161117,3017,3017,,,,3017,3017,0,0,0,0.00,10
,20161118,3017,3017,,,,3050,3050,33,33,0,0.00,10
,20161121,3050,3050,,,,3050,3050,0,0,0,0.00,10
,20161122,3050,3050,,,,3162,3162,112,112,0,0.00,10
,20161123,3162,3162,,,,3289,3289,127,127,0,0.00,10
,20161124,3289,3289,,,,3289,3289,0,0,0,0.00,10
,20161125,3289,3289,,,,3399,3399,110,110,0,0.00,10
,20161128,3399,3399,3548,3548,3471,3471,3509,72,110,4,14.04,10
,20161129,3471,3509,3562,3562,3562,3562,3562,53,53,2,7.12,8
,20161130,3562,3562,,,,3373,3373,-189,-189,0,0.00,8
,20161201,3373,3373,,,,3450,3450,77,77,0,0.00,8
,20161202,3450,3450,3468,3468,3411,3429,3438,-21,-12,168,577.67,58
,20161205,3429,3438,3491,3610,3491,3610,3548,172,110,8,28.38,52
,20161206,3610,3548,3666,3667,3606,3606,3663,58,115,46,168.52,16
,20161207,3606,3663,,,,3663,3663,0,0,0,0.00,16
,20161208,3663,3663,3775,3775,3694,3694,3734,31,71,4,14.94,14
,20161209,3694,3734,3734,3780,3687,3692,3719,-42,-15,22,81.84,14
,20161212,3692,3719,3978,3978,3756,3801,3815,82,96,246,938.72,252
,20161213,3801,3815,3820,3821,3800,3801,3809,-14,-6,36,137.14,242
,20161214,3801,3809,3760,3818,3735,3735,3793,-74,-16,24,91.05,240
,20161215,3735,3793,3700,3782,3700,3782,3759,-11,-34,36,135.35,238
,20161216,3782,3759,,,,3759,3759,0,0,0,0.00,238
,20161219,3759,3759,3690,3690,3616,3616,3668,-143,-91,74,271.46,180
,20161220,3616,3668,,,,3668,3668,0,0,0,0.00,180
,20161221,3668,3668,3623,3623,3623,3623,3623,-45,-45,2,7.25,180
,20161222,3623,3623,3577,3577,3504,3504,3540,-119,-83,4,14.16,182
,20161223,3504,3540,3416,3416,3398,3398,3404,-142,-136,6,20.42,180
,20161226,3398,3404,3310,3341,3310,3341,3325,-63,-79,4,13.30,182
,20161227,3341,3325,3350,3395,3350,3395,3393,70,68,62,210.40,120
,20161228,3395,3393,3421,3448,3370,3383,3422,-10,29,108,369.67,64
,20161229,3383,3422,,,,3380,3380,-42,-42,0,0.00,64
,20161230,3380,3380,,,,3380,3380,0,0,0,0.00,64
hc1707,20160718,2552,2552,,,,2552,2552,0,0,0,0.00,0
,20160719,2552,2552,2330,2330,2329,2329,2329,-223,-223,104,242.22,104
,20160720,2329,2329,2431,2432,2431,2432,2431,103,102,104,252.92,0
,20160721,2432,2431,,,,2487,2487,56,56,0,0.00,0
,20160722,2487,2487,,,,2487,2487,0,0,0,0.00,0
,20160725,2487,2487,,,,2487,2487,0,0,0,0.00,0
,20160726,2487,2487,,,,2487,2487,0,0,0,0.00,0
,20160727,2487,2487,,,,2553,2553,66,66,0,0.00,0
,20160728,2553,2553,,,,2553,2553,0,0,0,0.00,0
,20160729,2553,2553,,,,2553,2553,0,0,0,0.00,0
,20160801,2553,2553,,,,2592,2592,39,39,0,0.00,0
,20160802,2592,2592,,,,2592,2592,0,0,0,0.00,0
,20160803,2592,2592,,,,2592,2592,0,0,0,0.00,0
,20160804,2592,2592,,,,2592,2592,0,0,0,0.00,0
,20160805,2592,2592,,,,2592,2592,0,0,0,0.00,0
,20160808,2592,2592,,,,2644,2644,52,52,0,0.00,0
,20160809,2644,2644,,,,2644,2644,0,0,0,0.00,0
,20160810,2644,2644,,,,2644,2644,0,0,0,0.00,0
,20160811,2644,2644,,,,2644,2644,0,0,0,0.00,0
,20160812,2644,2644,,,,2644,2644,0,0,0,0.00,0
,20160815,2644,2644,,,,2644,2644,0,0,0,0.00,0
,20160816,2644,2644,,,,2733,2733,89,89,0,0.00,0
,20160817,2733,2733,,,,2733,2733,0,0,0,0.00,0
,20160818,2733,2733,,,,2733,2733,0,0,0,0.00,0
,20160819,2733,2733,,,,2733,2733,0,0,0,0.00,0
,20160822,2733,2733,,,,2733,2733,0,0,0,0.00,0
,20160823,2733,2733,,,,2733,2733,0,0,0,0.00,0
,20160824,2733,2733,,,,2765,2765,32,32,0,0.00,0
,20160825,2765,2765,2645,2797,2645,2797,2701,32,-64,12,32.41,0
,20160826,2797,2701,,,,2701,2701,0,0,0,0.00,0
,20160829,2701,2701,,,,2701,2701,0,0,0,0.00,0
,20160830,2701,2701,,,,2701,2701,0,0,0,0.00,0
,20160831,2701,2701,,,,2662,2662,-39,-39,0,0.00,0
,20160901,2662,2662,,,,2662,2662,0,0,0,0.00,0
,20160902,2662,2662,,,,2662,2662,0,0,0,0.00,0
,20160905,2662,2662,,,,2662,2662,0,0,0,0.00,0
,20160906,2662,2662,,,,2662,2662,0,0,0,0.00,0
,20160907,2662,2662,,,,2583,2583,-79,-79,0,0.00,0
,20160908,2583,2583,,,,2583,2583,0,0,0,0.00,0
,20160909,2583,2583,,,,2583,2583,0,0,0,0.00,0
,20160912,2583,2583,,,,2583,2583,0,0,0,0.00,0
,20160913,2583,2583,,,,2583,2583,0,0,0,0.00,0
,20160914,2583,2583,,,,2583,2583,0,0,0,0.00,0
,20160919,2583,2583,,,,2581,2581,-2,-2,0,0.00,0
,20160920,2581,2581,,,,2581,2581,0,0,0,0.00,0
,20160921,2581,2581,,,,2581,2581,0,0,0,0.00,0
,20160922,2581,2581,,,,2581,2581,0,0,0,0.00,0
,20160923,2581,2581,,,,2581,2581,0,0,0,0.00,0
,20160926,2581,2581,,,,2581,2581,0,0,0,0.00,0
,20160927,2581,2581,,,,2581,2581,0,0,0,0.00,0
,20160928,2581,2581,,,,2581,2581,0,0,0,0.00,0
,20160929,2581,2581,,,,2581,2581,0,0,0,0.00,0
,20160930,2581,2581,,,,2572,2572,-9,-9,0,0.00,0
,20161010,2572,2572,,,,2572,2572,0,0,0,0.00,0
,20161011,2572,2572,,,,2640,2640,68,68,0,0.00,0
,20161012,2640,2640,,,,2677,2677,37,37,0,0.00,0
,20161013,2677,2677,,,,2677,2677,0,0,0,0.00,0
,20161014,2677,2677,,,,2677,2677,0,0,0,0.00,0
,20161017,2677,2677,,,,2677,2677,0,0,0,0.00,0
,20161018,2677,2677,,,,2677,2677,0,0,0,0.00,0
,20161019,2677,2677,,,,2728,2728,51,51,0,0.00,0
,20161020,2728,2728,,,,2739,2739,11,11,0,0.00,0
,20161021,2739,2739,,,,2739,2739,0,0,0,0.00,0
,20161024,2739,2739,,,,2739,2739,0,0,0,0.00,0
,20161025,2739,2739,,,,2823,2823,84,84,0,0.00,0
,20161026,2823,2823,2822,2822,2822,2822,2822,-1,-1,2,5.64,2
,20161027,2822,2822,,,,2822,2822,0,0,0,0.00,2
,20161028,2822,2822,,,,2822,2822,0,0,0,0.00,2
,20161031,2822,2822,2835,2835,2835,2835,2835,13,13,2,5.67,0
,20161101,2835,2835,,,,2871,2871,36,36,0,0.00,0
,20161102,2871,2871,,,,2929,2929,58,58,0,0.00,0
,20161103,2929,2929,,,,2916,2916,-13,-13,0,0.00,0
,20161104,2916,2916,,,,2938,2938,22,22,0,0.00,0
,20161107,2938,2938,,,,3013,3013,75,75,0,0.00,0
,20161108,3013,3013,,,,3013,3013,0,0,0,0.00,0
,20161109,3013,3013,,,,3103,3103,90,90,0,0.00,0
,20161110,3103,3103,,,,3187,3187,84,84,0,0.00,0
,20161111,3187,3187,,,,3229,3229,42,42,0,0.00,0
,20161114,3229,3229,,,,3235,3235,6,6,0,0.00,0
,20161115,3235,3235,,,,3138,3138,-97,-97,0,0.00,0
,20161116,3138,3138,,,,3004,3004,-134,-134,0,0.00,0
,20161117,3004,3004,3004,3139,3004,3122,3078,118,74,8,24.63,4
,20161118,3122,3078,,,,3077,3077,-1,-1,0,0.00,4
,20161121,3077,3077,,,,3038,3038,-39,-39,0,0.00,4
,20161122,3038,3038,,,,3149,3149,111,111,0,0.00,4
,20161123,3149,3149,,,,3276,3276,127,127,0,0.00,4
,20161124,3276,3276,,,,3342,3342,66,66,0,0.00,4
,20161125,3342,3342,,,,3453,3453,111,111,0,0.00,4
,20161128,3453,3453,,,,3565,3565,112,112,0,0.00,4
,20161129,3565,3565,,,,3618,3618,53,53,0,0.00,4
,20161130,3618,3618,3365,3365,3365,3365,3365,-253,-253,4,13.46,4
,20161201,3365,3365,3522,3522,3522,3522,3522,157,157,4,14.09,0
,20161202,3522,3522,,,,3510,3510,-12,-12,0,0.00,0
,20161205,3510,3510,,,,3622,3622,112,112,0,0.00,0
,20161206,3622,3622,,,,3739,3739,117,117,0,0.00,0
,20161207,3739,3739,,,,3860,3860,121,121,0,0.00,0
,20161208,3860,3860,,,,3935,3935,75,75,0,0.00,0
,20161209,3935,3935,,,,3920,3920,-15,-15,0,0.00,0
,20161212,3920,3920,,,,4022,4022,102,102,0,0.00,0
,20161213,4022,4022,,,,4016,4016,-6,-6,0,0.00,0
,20161214,4016,4016,3734,3734,3734,3734,3734,-282,-282,4,14.94,4
,20161215,3734,3734,,,,3701,3701,-33,-33,0,0.00,4
,20161216,3701,3701,,,,3701,3701,0,0,0,0.00,4
,20161219,3701,3701,,,,3611,3611,-90,-90,0,0.00,4
,20161220,3611,3611,,,,3534,3534,-77,-77,0,0.00,4
,20161221,3534,3534,,,,3490,3490,-44,-44,0,0.00,4
,20161222,3490,3490,,,,3410,3410,-80,-80,0,0.00,4
,20161223,3410,3410,,,,3278,3278,-132,-132,0,0.00,4
,20161226,3278,3278,,,,3202,3202,-76,-76,0,0.00,4
,20161227,3202,3202,,,,3268,3268,66,66,0,0.00,4
,20161228,3268,3268,,,,3296,3296,28,28,0,0.00,4
,20161229,3296,3296,,,,3244,3244,-52,-52,0,0.00,4
,20161230,3244,3244,,,,3204,3204,-40,-40,0,0.00,4
hc1708,20160816,2644,2644,,,,2645,2645,1,1,0,0.00,0
,20160817,2645,2645,,,,2645,2645,0,0,0,0.00,0
,20160818,2645,2645,,,,2645,2645,0,0,0,0.00,0
,20160819,2645,2645,,,,2675,2675,30,30,0,0.00,0
,20160822,2675,2675,,,,2707,2707,32,32,0,0.00,0
,20160823,2707,2707,,,,2707,2707,0,0,0,0.00,0
,20160824,2707,2707,2830,2830,2830,2830,2830,123,123,4,11.32,4
,20160825,2830,2830,2785,2785,2785,2785,2785,-45,-45,4,11.14,0
,20160826,2785,2785,,,,2785,2785,0,0,0,0.00,0
,20160829,2785,2785,,,,2785,2785,0,0,0,0.00,0
,20160830,2785,2785,,,,2785,2785,0,0,0,0.00,0
,20160831,2785,2785,,,,2744,2744,-41,-41,0,0.00,0
,20160901,2744,2744,,,,2705,2705,-39,-39,0,0.00,0
,20160902,2705,2705,,,,2705,2705,0,0,0,0.00,0
,20160905,2705,2705,,,,2705,2705,0,0,0,0.00,0
,20160906,2705,2705,,,,2705,2705,0,0,0,0.00,0
,20160907,2705,2705,,,,2624,2624,-81,-81,0,0.00,0
,20160908,2624,2624,,,,2624,2624,0,0,0,0.00,0
,20160909,2624,2624,,,,2624,2624,0,0,0,0.00,0
,20160912,2624,2624,,,,2624,2624,0,0,0,0.00,0
,20160913,2624,2624,,,,2624,2624,0,0,0,0.00,0
,20160914,2624,2624,,,,2618,2618,-6,-6,0,0.00,0
,20160919,2618,2618,,,,2616,2616,-2,-2,0,0.00,0
,20160920,2616,2616,,,,2616,2616,0,0,0,0.00,0
,20160921,2616,2616,,,,2616,2616,0,0,0,0.00,0
,20160922,2616,2616,,,,2616,2616,0,0,0,0.00,0
,20160923,2616,2616,,,,2616,2616,0,0,0,0.00,0
,20160926,2616,2616,,,,2616,2616,0,0,0,0.00,0
,20160927,2616,2616,,,,2616,2616,0,0,0,0.00,0
,20160928,2616,2616,,,,2616,2616,0,0,0,0.00,0
,20160929,2616,2616,,,,2616,2616,0,0,0,0.00,0
,20160930,2616,2616,,,,2607,2607,-9,-9,0,0.00,0
,20161010,2607,2607,,,,2607,2607,0,0,0,0.00,0
,20161011,2607,2607,,,,2607,2607,0,0,0,0.00,0
,20161012,2607,2607,,,,2644,2644,37,37,0,0.00,0
,20161013,2644,2644,,,,2644,2644,0,0,0,0.00,0
,20161014,2644,2644,,,,2668,2668,24,24,0,0.00,0
,20161017,2668,2668,,,,2691,2691,23,23,0,0.00,0
,20161018,2691,2691,,,,2691,2691,0,0,0,0.00,0
,20161019,2691,2691,,,,2742,2742,51,51,0,0.00,0
,20161020,2742,2742,,,,2742,2742,0,0,0,0.00,0
,20161021,2742,2742,,,,2742,2742,0,0,0,0.00,0
,20161024,2742,2742,,,,2742,2742,0,0,0,0.00,0
,20161025,2742,2742,,,,2826,2826,84,84,0,0.00,0
,20161026,2826,2826,2821,2821,2821,2821,2821,-5,-5,2,5.64,2
,20161027,2821,2821,,,,2821,2821,0,0,0,0.00,2
,20161028,2821,2821,,,,2821,2821,0,0,0,0.00,2
,20161031,2821,2821,,,,2833,2833,12,12,0,0.00,2
,20161101,2833,2833,,,,2924,2924,91,91,0,0.00,2
,20161102,2924,2924,,,,2932,2932,8,8,0,0.00,2
,20161103,2932,2932,,,,2918,2918,-14,-14,0,0.00,2
,20161104,2918,2918,,,,2944,2944,26,26,0,0.00,2
,20161107,2944,2944,3081,3081,3081,3081,3081,137,137,2,6.16,4
,20161108,3081,3081,3111,3111,3111,3111,3111,30,30,2,6.22,2
,20161109,3111,3111,,,,3204,3204,93,93,0,0.00,2
,20161110,3204,3204,,,,3204,3204,0,0,0,0.00,2
,20161111,3204,3204,,,,3246,3246,42,42,0,0.00,2
,20161114,3246,3246,,,,3246,3246,0,0,0,0.00,2
,20161115,3246,3246,,,,3148,3148,-98,-98,0,0.00,2
,20161116,3148,3148,,,,3013,3013,-135,-135,0,0.00,2
,20161117,3013,3013,,,,3087,3087,74,74,0,0.00,2
,20161118,3087,3087,,,,3087,3087,0,0,0,0.00,2
,20161121,3087,3087,,,,3087,3087,0,0,0,0.00,2
,20161122,3087,3087,,,,3200,3200,113,113,0,0.00,2
,20161123,3200,3200,,,,3329,3329,129,129,0,0.00,2
,20161124,3329,3329,,,,3329,3329,0,0,0,0.00,2
,20161125,3329,3329,,,,3440,3440,111,111,0,0.00,2
,20161128,3440,3440,,,,3551,3551,111,111,0,0.00,2
,20161129,3551,3551,,,,3551,3551,0,0,0,0.00,2
,20161130,3551,3551,,,,3302,3302,-249,-249,0,0.00,2
,20161201,3302,3302,,,,3456,3456,154,154,0,0.00,2
,20161202,3456,3456,,,,3444,3444,-12,-12,0,0.00,2
,20161205,3444,3444,,,,3554,3554,110,110,0,0.00,2
,20161206,3554,3554,,,,3554,3554,0,0,0,0.00,2
,20161207,3554,3554,,,,3669,3669,115,115,0,0.00,2
,20161208,3669,3669,,,,3740,3740,71,71,0,0.00,2
,20161209,3740,3740,,,,3725,3725,-15,-15,0,0.00,2
,20161212,3725,3725,,,,3822,3822,97,97,0,0.00,2
,20161213,3822,3822,,,,3822,3822,0,0,0,0.00,2
,20161214,3822,3822,,,,3822,3822,0,0,0,0.00,2
,20161215,3822,3822,,,,3822,3822,0,0,0,0.00,2
,20161216,3822,3822,,,,3822,3822,0,0,0,0.00,2
,20161219,3822,3822,,,,3729,3729,-93,-93,0,0.00,2
,20161220,3729,3729,,,,3729,3729,0,0,0,0.00,2
,20161221,3729,3729,,,,3729,3729,0,0,0,0.00,2
,20161222,3729,3729,,,,3644,3644,-85,-85,0,0.00,2
,20161223,3644,3644,,,,3504,3504,-140,-140,0,0.00,2
,20161226,3504,3504,,,,3423,3423,-81,-81,0,0.00,2
,20161227,3423,3423,,,,3423,3423,0,0,0,0.00,2
,20161228,3423,3423,,,,3423,3423,0,0,0,0.00,2
,20161229,3423,3423,,,,3423,3423,0,0,0,0.00,2
,20161230,3423,3423,,,,3423,3423,0,0,0,0.00,2
hc1709,20160920,2616,2616,,,,2586,2586,-30,-30,0,0.00,0
,20160921,2586,2586,2486,2575,2481,2505,2523,-81,-63,20,50.47,0
,20160922,2505,2523,,,,2523,2523,0,0,0,0.00,0
,20160923,2523,2523,,,,2540,2540,17,17,0,0.00,0
,20160926,2540,2540,,,,2561,2561,21,21,0,0.00,0
,20160927,2561,2561,,,,2561,2561,0,0,0,0.00,0
,20160928,2561,2561,,,,2561,2561,0,0,0,0.00,0
,20160929,2561,2561,,,,2561,2561,0,0,0,0.00,0
,20160930,2561,2561,2566,2566,2552,2552,2559,-9,-2,4,10.24,4
,20161010,2552,2559,,,,2559,2559,0,0,0,0.00,4
,20161011,2559,2559,,,,2570,2570,11,11,0,0.00,4
,20161012,2570,2570,,,,2601,2601,31,31,0,0.00,4
,20161013,2601,2601,,,,2609,2609,8,8,0,0.00,4
,20161014,2609,2609,,,,2647,2647,38,38,0,0.00,4
,20161017,2647,2647,,,,2661,2661,14,14,0,0.00,4
,20161018,2661,2661,2661,2661,2661,2661,2661,0,0,2,5.32,2
,20161019,2661,2661,2714,2714,2714,2714,2714,53,53,2,5.43,2
,20161020,2714,2714,,,,2714,2714,0,0,0,0.00,2
,20161021,2714,2714,,,,2714,2714,0,0,0,0.00,2
,20161024,2714,2714,,,,2714,2714,0,0,0,0.00,2
,20161025,2714,2714,,,,2797,2797,83,83,0,0.00,2
,20161026,2797,2797,,,,2797,2797,0,0,0,0.00,2
,20161027,2797,2797,2688,2799,2688,2799,2761,2,-36,6,16.57,0
,20161028,2799,2761,,,,2788,2788,27,27,0,0.00,0
,20161031,2788,2788,,,,2800,2800,12,12,0,0.00,0
,20161101,2800,2800,,,,2836,2836,36,36,0,0.00,0
,20161102,2836,2836,2836,2836,2836,2836,2836,0,0,2,5.67,2
,20161103,2836,2836,,,,2823,2823,-13,-13,0,0.00,2
,20161104,2823,2823,,,,2844,2844,21,21,0,0.00,2
,20161107,2844,2844,,,,2976,2976,132,132,0,0.00,2
,20161108,2976,2976,,,,2976,2976,0,0,0,0.00,2
,20161109,2976,2976,,,,3065,3065,89,89,0,0.00,2
,20161110,3065,3065,3121,3238,3121,3149,3180,84,115,30,95.42,6
,20161111,3149,3180,,,,3221,3221,41,41,0,0.00,6
,20161114,3221,3221,,,,3221,3221,0,0,0,0.00,6
,20161115,3221,3221,,,,3124,3124,-97,-97,0,0.00,6
,20161116,3124,3124,,,,3124,3124,0,0,0,0.00,6
,20161117,3124,3124,,,,3124,3124,0,0,0,0.00,6
,20161118,3124,3124,,,,3124,3124,0,0,0,0.00,6
,20161121,3124,3124,,,,3124,3124,0,0,0,0.00,6
,20161122,3124,3124,3170,3184,3170,3184,3177,60,53,4,12.71,8
,20161123,3184,3177,3328,3328,3238,3238,3286,61,109,8,26.29,8
,20161124,3238,3286,3378,3378,3378,3378,3378,92,92,2,6.76,10
,20161125,3378,3378,,,,3491,3491,113,113,0,0.00,10
,20161128,3491,3491,,,,3504,3504,13,13,0,0.00,10
,20161129,3504,3504,,,,3486,3486,-18,-18,0,0.00,10
,20161130,3486,3486,3262,3262,3262,3262,3262,-224,-224,2,6.52,8
,20161201,3262,3262,,,,3414,3414,152,152,0,0.00,8
,20161202,3414,3414,,,,3402,3402,-12,-12,0,0.00,8
,20161205,3402,3402,,,,3510,3510,108,108,0,0.00,8
,20161206,3510,3510,3588,3588,3588,3588,3588,78,78,4,14.35,4
,20161207,3588,3588,,,,3705,3705,117,117,0,0.00,4
,20161208,3705,3705,,,,3777,3777,72,72,0,0.00,4
,20161209,3777,3777,,,,3762,3762,-15,-15,0,0.00,4
,20161212,3762,3762,,,,3762,3762,0,0,0,0.00,4
,20161213,3762,3762,3636,3798,3636,3798,3716,36,-46,8,29.73,4
,20161214,3798,3716,3798,3798,3798,3798,3798,82,82,2,7.60,6
,20161215,3798,3798,3713,3713,3713,3713,3713,-85,-85,2,7.43,4
,20161216,3713,3713,,,,3713,3713,0,0,0,0.00,4
,20161219,3713,3713,,,,3623,3623,-90,-90,0,0.00,4
,20161220,3623,3623,3623,3660,3623,3660,3641,37,18,8,29.13,10
,20161221,3660,3641,3539,3539,3539,3539,3539,-102,-102,4,14.16,6
,20161222,3539,3539,,,,3458,3458,-81,-81,0,0.00,6
,20161223,3458,3458,,,,3458,3458,0,0,0,0.00,6
,20161226,3458,3458,3333,3357,3333,3356,3352,-102,-106,10,33.52,2
,20161227,3356,3352,3364,3364,3215,3348,3300,-4,-52,20,66.01,10
,20161228,3348,3300,3312,3350,3312,3350,3331,50,31,4,13.32,10
,20161229,3350,3331,,,,3279,3279,-52,-52,0,0.00,10
,20161230,3279,3279,3295,3308,3260,3260,3292,-19,13,8,26.34,8
hc1710,20161018,2661,2661,2661,2688,2632,2643,2644,-18,-17,74,195.70,52
,20161019,2643,2644,2660,2700,2660,2667,2682,23,38,78,209.24,94
,20161020,2667,2682,2681,2714,2681,2689,2695,7,13,30,80.85,104
,20161021,2689,2695,2691,2720,2661,2676,2690,-19,-5,50,134.53,114
,20161024,2676,2690,2684,2701,2663,2701,2684,11,-6,74,198.67,154
,20161025,2701,2684,2725,2769,2719,2765,2753,81,69,88,242.30,162
,20161026,2765,2753,2782,2782,2729,2740,2742,-13,-11,80,219.40,170
,20161027,2740,2742,2748,2787,2726,2745,2748,3,6,170,467.25,250
,20161028,2745,2748,2760,2815,2735,2810,2785,62,37,162,451.25,316
,20161031,2810,2785,2781,2860,2781,2851,2808,66,23,96,269.62,336
,20161101,2851,2808,2869,2900,2818,2895,2876,87,68,198,569.58,380
,20161102,2895,2876,2916,2935,2864,2912,2913,36,37,248,722.63,388
,20161103,2912,2913,2910,2924,2893,2912,2909,-1,-4,144,418.97,410
,20161104,2912,2909,2957,2957,2910,2936,2935,27,26,258,757.27,444
,20161107,2936,2935,2920,3078,2900,3050,2994,115,59,1502,"4,497.73",1160
,20161108,3050,2994,3091,3091,2995,3011,3034,17,40,918,"2,786.12",1638
,20161109,3011,3034,3043,3200,3043,3178,3148,144,114,866,"2,726.69",1862
,20161110,3178,3148,3199,3319,3161,3216,3206,68,58,554,"1,776.13",1716
,20161111,3216,3206,3171,3368,3171,3366,3296,160,90,848,"2,795.40",1806
,20161114,3366,3296,3335,3444,3160,3213,3244,-83,-52,2034,"6,598.87",1788
,20161115,3213,3244,3198,3260,3049,3055,3111,-189,-133,1188,"3,696.44",1774
,20161116,3055,3111,3056,3088,2999,3072,3049,-39,-62,944,"2,878.33",1532
,20161117,3072,3049,3092,3092,3005,3065,3033,16,-16,198,600.69,1504
,20161118,3065,3033,3075,3075,3002,3016,3030,-17,-3,100,303.07,1492
,20161121,3016,3030,3033,3033,2954,2998,3000,-32,-30,476,"1,428.28",1556
,20161122,2998,3000,3019,3180,3019,3180,3117,180,117,692,"2,157.22",1532
,20161123,3180,3117,3179,3343,3179,3275,3248,158,131,428,"1,390.49",1304
,20161124,3275,3248,3242,3382,3199,3318,3338,70,90,962,"3,211.59",1556
,20161125,3318,3338,3318,3538,3303,3494,3417,156,79,386,"1,319.14",1568
,20161128,3494,3417,3497,3610,3444,3582,3544,165,127,1204,"4,267.33",1824
,20161129,3582,3544,3548,3583,3307,3339,3467,-205,-77,610,"2,115.00",1848
,20161130,3339,3467,3339,3339,3224,3224,3271,-243,-196,476,"1,557.30",2054
,20161201,3224,3271,3234,3501,3234,3458,3355,187,84,916,"3,073.37",2012
,20161202,3458,3355,3484,3500,3323,3433,3411,78,56,768,"2,620.30",2058
,20161205,3433,3411,3412,3550,3380,3545,3470,134,59,1212,"4,206.51",2128
,20161206,3545,3470,3544,3611,3525,3558,3573,88,103,884,"3,158.59",2342
,20161207,3558,3573,3500,3778,3500,3701,3673,128,100,2272,"8,346.60",2620
,20161208,3701,3673,3710,3739,3601,3693,3680,20,7,836,"3,076.82",2448
,20161209,3693,3680,3709,3709,3536,3675,3621,-5,-59,636,"2,303.55",2408
,20161212,3675,3621,3675,3820,3636,3709,3761,88,140,1110,"4,175.50",2150
,20161213,3709,3761,3716,3754,3678,3737,3716,-24,-45,642,"2,385.74",2238
,20161214,3737,3716,3738,3738,3601,3632,3673,-84,-43,680,"2,497.74",2374
,20161215,3632,3673,3633,3720,3584,3706,3661,33,-12,698,"2,555.41",2428
,20161216,3706,3661,3676,3684,3602,3610,3654,-51,-7,378,"1,381.28",2508
,20161219,3610,3654,3578,3608,3497,3497,3566,-157,-88,850,"3,031.42",2824
,20161220,3497,3566,3492,3528,3449,3489,3490,-77,-76,866,"3,022.56",2750
,20161221,3489,3490,3518,3549,3450,3516,3511,26,21,640,"2,247.62",2784
,20161222,3516,3511,3519,3519,3347,3347,3437,-164,-74,1160,"3,987.56",2794
,20161223,3347,3437,3343,3393,3278,3308,3322,-129,-115,894,"2,970.74",3040
,20161226,3308,3322,3308,3340,3149,3225,3226,-97,-96,1692,"5,459.61",3532
,20161227,3225,3226,3242,3331,3196,3327,3273,101,47,1660,"5,433.61",3560
,20161228,3327,3273,3327,3390,3297,3321,3349,48,76,1640,"5,493.99",3248
,20161229,3321,3349,3318,3349,3246,3256,3287,-93,-62,1272,"4,181.34",3328
,20161230,3256,3287,3225,3308,3205,3215,3245,-72,-42,1674,"5,433.70",3766
hc1711,20161116,3111,3111,,,,3111,3111,0,0,0,0.00,0
,20161117,3111,3111,,,,3111,3111,0,0,0,0.00,0
,20161118,3111,3111,,,,3111,3111,0,0,0,0.00,0
,20161121,3111,3111,,,,3111,3111,0,0,0,0.00,0
,20161122,3111,3111,,,,3120,3120,9,9,0,0.00,0
,20161123,3120,3120,,,,3182,3182,62,62,0,0.00,0
,20161124,3182,3182,,,,3250,3250,68,68,0,0.00,0
,20161125,3250,3250,,,,3400,3400,150,150,0,0.00,0
,20161128,3400,3400,,,,3526,3526,126,126,0,0.00,0
,20161129,3526,3526,,,,3449,3449,-77,-77,0,0.00,0
,20161130,3449,3449,,,,3449,3449,0,0,0,0.00,0
,20161201,3449,3449,,,,3449,3449,0,0,0,0.00,0
,20161202,3449,3449,,,,3507,3507,58,58,0,0.00,0
,20161205,3507,3507,,,,3507,3507,0,0,0,0.00,0
,20161206,3507,3507,,,,3507,3507,0,0,0,0.00,0
,20161207,3507,3507,,,,3507,3507,0,0,0,0.00,0
,20161208,3507,3507,,,,3507,3507,0,0,0,0.00,0
,20161209,3507,3507,,,,3451,3451,-56,-56,0,0.00,0
,20161212,3451,3451,,,,3585,3585,134,134,0,0.00,0
,20161213,3585,3585,,,,3542,3542,-43,-43,0,0.00,0
,20161214,3542,3542,,,,3501,3501,-41,-41,0,0.00,0
,20161215,3501,3501,,,,3489,3489,-12,-12,0,0.00,0
,20161216,3489,3489,,,,3482,3482,-7,-7,0,0.00,0
,20161219,3482,3482,,,,3398,3398,-84,-84,0,0.00,0
,20161220,3398,3398,,,,3325,3325,-73,-73,0,0.00,0
,20161221,3325,3325,,,,3345,3345,20,20,0,0.00,0
,20161222,3345,3345,,,,3275,3275,-70,-70,0,0.00,0
,20161223,3275,3275,,,,3166,3166,-109,-109,0,0.00,0
,20161226,3166,3166,,,,3075,3075,-91,-91,0,0.00,0
,20161227,3075,3075,,,,3120,3120,45,45,0,0.00,0
,20161228,3120,3120,,,,3193,3193,73,73,0,0.00,0
,20161229,3193,3193,,,,3193,3193,0,0,0,0.00,0
,20161230,3193,3193,,,,3193,3193,0,0,0,0.00,0
hc1712,20161216,3489,3489,,,,3540,3540,51,51,0,0.00,0
,20161219,3540,3540,,,,3540,3540,0,0,0,0.00,0
,20161220,3540,3540,,,,3540,3540,0,0,0,0.00,0
,20161221,3540,3540,,,,3562,3562,22,22,0,0.00,0
,20161222,3562,3562,,,,3487,3487,-75,-75,0,0.00,0
,20161223,3487,3487,,,,3487,3487,0,0,0,0.00,0
,20161226,3487,3487,,,,3487,3487,0,0,0,0.00,0
,20161227,3487,3487,,,,3487,3487,0,0,0,0.00,0
,20161228,3487,3487,,,,3487,3487,0,0,0,0.00,0
,20161229,3487,3487,,,,3422,3422,-65,-65,0,0.00,0
,20161230,3422,3422,,,,3379,3379,-43,-43,0,0.00,0
ni1601,20160104,69100,69000,69490,69520,67200,67790,68440,-1210,-560,5566,"38,094.64",100812
,20160105,67790,68440,67780,68300,67170,68300,67790,-140,-650,11424,"77,444.51",96684
,20160106,68300,67790,68310,68310,67160,67650,67580,-140,-210,5652,"38,196.35",93828
,20160107,67650,67580,67730,68200,66040,66470,67250,-1110,-330,9144,"61,498.57",87348
,20160108,66470,67250,66310,67300,65550,66630,66820,-620,-430,6300,"42,098.05",85440
,20160111,66630,66820,66920,67300,65250,65250,66540,-1570,-280,5676,"37,769.06",82296
,20160112,65250,66540,65900,66180,64300,64510,65040,-2030,-1500,8472,"55,108.18",79800
,20160113,64510,65040,64500,65150,64500,64950,64900,-90,-140,1884,"12,227.45",78360
,20160114,64950,64900,64950,66500,64820,65760,65630,860,730,2760,"18,115.87",76464
,20160115,65760,65630,66490,69550,66400,66900,67340,1270,1710,4512,"30,388.25",76260
ni1602,20160104,69230,69300,67710,68760,67690,67690,68020,-1610,-1280,60,408.15,1054
,20160105,67690,68020,67800,68400,67540,68400,67950,380,-70,50,339.79,1050
,20160106,68400,67950,68450,68600,67360,67690,67920,-260,-30,220,"1,494.37",1032
,20160107,67690,67920,67860,68220,66580,66580,67380,-1340,-540,216,"1,455.50",958
,20160108,66580,67380,66740,67440,65780,67060,66860,-320,-520,162,"1,083.23",988
,20160111,67060,66860,67110,67620,65740,66670,66040,-190,-820,324,"2,139.83",1124
,20160112,66670,66040,66120,66700,64770,64850,65510,-1190,-530,2428,"15,908.20",1400
,20160113,64850,65510,65000,65440,64850,64850,65150,-660,-360,114,742.82,1360
,20160114,64850,65150,65340,66800,65150,66420,66060,1270,910,102,673.84,1348
,20160115,66420,66060,66380,68000,66330,66750,67270,690,1210,300,"2,018.36",1320
,20160118,66750,67270,65810,68400,65810,68100,67480,830,210,542,"3,657.52",1122
,20160119,68100,67480,68110,70330,67730,69100,68280,1620,800,340,"2,321.69",974
,20160120,69100,68280,68800,69280,67800,68250,68760,-30,480,114,783.94,942
,20160121,68250,68760,68400,68600,67850,68270,68180,-490,-580,28,190.92,928
,20160122,68270,68180,68410,69500,68110,69210,69010,1030,830,74,510.69,914
,20160125,69210,69010,70260,70260,68190,68310,68750,-700,-260,102,701.31,826
,20160126,68310,68750,68250,68400,67830,68060,68110,-690,-640,138,940.05,742
,20160127,68060,68110,68750,69360,68750,69360,69040,1250,930,18,124.28,732
,20160128,69360,69040,68500,68790,68420,68600,68560,-440,-480,24,164.56,710
,20160129,68600,68560,68400,68840,68270,68600,68540,40,-20,96,658.01,660
,20160201,68600,68540,68800,68800,68000,68000,68350,-540,-190,48,328.08,660
,20160202,68000,68350,,,,68350,68350,0,0,0,0.00,660
,20160203,68350,68350,68000,68000,67790,67790,67840,-560,-510,48,325.64,648
,20160204,67790,67840,68800,68800,68300,68300,68670,460,830,48,329.64,612
,20160205,68300,68670,68000,68000,67700,67780,67820,-890,-850,48,325.54,564
,20160215,67780,67820,62400,62400,62400,62400,62400,-5420,-5420,60,374.40,504
ni1603,20160104,69630,69620,69120,69120,68000,68220,68230,-1400,-1390,132,900.75,2060
,20160105,68220,68230,68630,68990,67980,68780,68340,550,110,80,546.72,2068
,20160106,68780,68340,69090,69090,67750,67990,68270,-350,-70,236,"1,611.33",2096
,20160107,67990,68270,68260,68750,66760,66760,67830,-1510,-440,144,976.84,2102
,20160108,66760,67830,66820,67730,66110,67430,66900,-400,-930,236,"1,578.88",2130
,20160111,67430,66900,67800,68000,66130,66350,66740,-550,-160,240,"1,601.76",2178
,20160112,66350,66740,66810,66960,65330,65500,65830,-1240,-910,92,605.67,2170
,20160113,65500,65830,65770,65800,65320,65550,65630,-280,-200,54,354.44,2186
,20160114,65550,65630,65890,67230,65460,66830,66420,1200,790,526,"3,493.86",2114
,20160115,66830,66420,66810,68500,66730,67150,67760,730,1340,300,"2,032.96",2122
,20160118,67150,67760,67040,68800,66900,68550,68030,790,270,580,"3,946.28",2236
,20160119,68550,68030,68550,69370,68180,69330,68660,1300,630,128,878.97,2238
,20160120,69330,68660,69210,69380,68200,68620,68560,-40,-100,446,"3,057.92",2490
,20160121,68620,68560,68650,69300,68340,68550,68660,-10,100,384,"2,636.80",2552
,20160122,68550,68660,68550,69900,68550,69370,69430,710,770,628,"4,360.45",2686
,20160125,69370,69430,69680,69720,68660,68660,69200,-770,-230,44,304.52,2698
,20160126,68660,69200,68380,68640,68100,68250,68370,-950,-830,114,779.42,2706
,20160127,68250,68370,69000,69800,68810,69770,69340,1400,970,120,832.19,2700
,20160128,69770,69340,69300,69300,68880,69110,69050,-230,-290,102,704.39,2710
,20160129,69110,69050,69300,69300,68700,68800,68930,-250,-120,64,441.19,2700
,20160201,68800,68930,69000,69880,67880,68130,68940,-800,10,160,"1,103.11",2680
,20160202,68130,68940,68510,68510,68010,68450,68270,-490,-670,60,409.67,2670
,20160203,68450,68270,68180,68270,67350,68270,67850,0,-420,64,434.25,2670
,20160204,68270,67850,68700,68880,68120,68620,68550,770,700,152,"1,041.96",2660
,20160205,68620,68550,68750,68900,67750,68020,68030,-530,-520,48,326.58,2628
,20160215,68020,68030,63880,65860,63880,65770,65390,-2260,-2640,132,863.16,2650
,20160216,65770,65390,65600,66220,65540,65940,65870,550,480,202,"1,330.58",2678
,20160217,65940,65870,65950,66000,65490,65780,65660,-90,-210,418,"2,744.82",2408
,20160218,65780,65660,65780,66400,65780,66030,66140,370,480,148,978.97,2314
,20160219,66030,66140,66140,66600,66000,66430,66450,290,310,1088,"7,230.81",2676
,20160222,66430,66450,66330,68120,66330,68100,67650,1650,1200,262,"1,772.60",2650
,20160223,68100,67650,68400,68700,67990,68250,68180,600,530,78,531.82,2686
,20160224,68250,68180,67960,68060,67430,67800,67740,-380,-440,208,"1,409.02",2688
,20160225,67800,67740,67380,68240,66750,66750,67780,-990,40,208,"1,409.92",2674
,20160226,66750,67780,66790,67100,66030,66920,66790,-860,-990,278,"1,856.81",2566
,20160229,66920,66790,66680,67450,64410,67080,65950,290,-840,710,"4,682.80",2592
,20160301,67080,65950,66600,67330,66130,67100,66670,1150,720,264,"1,760.30",2736
,20160302,67100,66670,67800,68320,67600,68320,67880,1650,1210,120,814.62,2784
,20160303,68320,67880,68500,68500,68070,68070,68360,190,480,156,"1,066.46",2892
,20160304,68070,68360,69800,70880,69800,70880,69950,2520,1590,84,587.62,2832
,20160307,70880,69950,71000,72500,71000,72500,71820,2550,1870,48,344.76,2832
,20160308,72500,71820,72500,72500,72000,72000,72120,180,300,48,346.20,2844
,20160309,72000,72120,,,,69180,69180,-2940,-2940,0,0.00,2844
,20160310,69180,69180,68000,68250,68000,68250,68160,-930,-1020,36,245.40,2844
,20160311,68250,68160,,,,68160,68160,0,0,0,0.00,2844
,20160314,68160,68160,,,,68160,68160,0,0,0,0.00,2844
,20160315,68160,68160,68180,68180,68000,68000,68090,-160,-70,36,245.14,2832
ni1604,20160104,69970,69820,69960,69960,69010,69010,69630,-810,-190,12,83.56,80
,20160105,69010,69630,69040,69040,68670,68740,68780,-890,-850,26,178.83,88
,20160106,68740,68780,68790,68790,68410,68730,68620,-50,-160,38,260.76,92
,20160107,68730,68620,,,,67390,67390,-1230,-1230,0,0.00,92
,20160108,67390,67390,67080,67980,67080,67980,67490,590,100,12,80.99,88
,20160111,67980,67490,,,,67490,67490,0,0,0,0.00,88
,20160112,67490,67490,,,,67490,67490,0,0,0,0.00,88
,20160113,67490,67490,66160,66160,66160,66160,66160,-1330,-1330,2,13.23,88
,20160114,66160,66160,66270,67410,65710,67180,66050,1020,-110,270,"1,783.59",132
,20160115,67180,66050,68660,68660,67270,67600,67540,1550,1490,90,607.91,176
,20160118,67600,67540,67360,68060,67360,67620,67720,80,180,30,203.18,150
,20160119,67620,67720,68950,70050,68510,69780,69530,2060,1810,102,709.22,126
,20160120,69780,69530,69810,69810,68950,68950,69070,-580,-460,14,96.70,112
,20160121,68950,69070,,,,69170,69170,100,100,0,0.00,112
,20160122,69170,69170,69220,70110,69220,69990,69550,820,380,26,180.85,116
,20160125,69990,69550,70170,70170,69320,69330,69600,-220,50,6,41.76,114
,20160126,69330,69600,,,,69600,69600,0,0,0,0.00,114
,20160127,69600,69600,69360,70070,69220,70070,69460,470,-140,20,138.92,110
,20160128,70070,69460,69790,69790,69440,69440,69610,-20,150,4,27.85,112
,20160129,69440,69610,69370,69840,69350,69350,69530,-260,-80,18,125.16,108
,20160201,69350,69530,69420,69420,69420,69420,69420,-110,-110,4,27.77,104
,20160202,69420,69420,68550,68790,68430,68430,68560,-990,-860,20,137.12,114
,20160203,68430,68560,68520,68720,67800,68720,68310,160,-250,298,"2,035.92",282
,20160204,68720,68310,,,,69010,69010,700,700,0,0.00,282
,20160205,69010,69010,69450,69490,68740,68740,69060,-270,50,22,151.94,272
,20160215,68740,69060,64460,66320,64380,66230,65560,-2830,-3500,188,"1,232.65",320
,20160216,66230,65560,66320,66910,66080,66360,66420,800,860,172,"1,142.46",400
,20160217,66360,66420,66200,66580,65940,66200,66140,-220,-280,72,476.21,400
,20160218,66200,66140,66520,66620,66500,66560,66560,420,420,46,306.22,396
,20160219,66560,66560,66530,67730,66440,66870,66650,310,90,142,946.52,402
,20160222,66870,66650,66960,68030,66760,67840,67290,1190,640,32,215.35,420
,20160223,67840,67290,68840,69110,68330,68490,68590,1200,1300,68,466.42,414
,20160224,68490,68590,68240,68400,67880,67880,68220,-710,-370,46,313.85,398
,20160225,67880,68220,67940,68450,67340,67470,68090,-750,-130,64,435.83,388
,20160226,67470,68090,67470,67580,67150,67150,67340,-940,-750,24,161.63,402
,20160229,67150,67340,67390,67390,66490,66490,66830,-850,-510,28,187.13,412
,20160301,66490,66830,66590,67570,66370,67570,66970,740,140,74,495.61,420
,20160302,67570,66970,68200,68210,67960,68030,68090,1060,1120,22,149.82,424
,20160303,68030,68090,68800,68850,68270,68680,68730,590,640,40,274.95,410
,20160304,68680,68730,69440,71800,69440,70810,70800,2080,2070,28,198.25,410
,20160307,70810,70800,71400,73420,71260,72140,72830,1340,2030,368,"2,680.46",406
,20160308,72140,72830,74200,74560,69440,71600,72910,-1230,80,88,641.63,380
,20160309,71600,72910,69700,69960,68530,68950,69020,-3960,-3890,76,524.59,372
,20160310,68950,69020,70010,70010,68580,68800,69070,-220,50,44,303.94,380
,20160311,68800,69070,68620,69220,68620,69000,69000,-70,-70,26,179.40,362
,20160314,69000,69000,69030,69560,68670,69380,69050,380,50,48,331.48,362
,20160315,69380,69050,68320,68320,67380,67980,67720,-1070,-1330,106,717.83,358
,20160316,67980,67720,67570,67700,67550,67680,67600,-40,-120,62,419.16,358
,20160317,67680,67600,67680,68430,67370,67930,67990,330,390,92,625.53,354
,20160318,67930,67990,68100,70790,68100,69700,69550,1710,1560,102,709.46,370
,20160321,69700,69550,69030,69230,67430,67430,68410,-2120,-1140,30,205.25,376
,20160322,67430,68410,68220,68730,66810,68080,67970,-330,-440,70,475.81,374
,20160323,68080,67970,67830,69000,67830,69000,68430,1030,460,16,109.50,374
,20160324,69000,68430,67870,68000,67610,68000,67850,-430,-580,10,67.86,374
,20160325,68000,67850,,,,67850,67850,0,0,0,0.00,374
,20160328,67850,67850,68000,68000,67290,67290,67550,-560,-300,16,108.09,374
,20160329,67290,67550,67680,68020,67590,67700,67810,150,260,140,949.46,366
,20160330,67700,67810,66800,69180,65860,66900,67550,-910,-260,136,918.81,364
,20160331,66900,67550,67330,67330,65560,66000,66100,-1550,-1450,64,423.05,372
,20160401,66000,66100,,,,66100,66100,0,0,0,0.00,372
,20160405,66100,66100,,,,66100,66100,0,0,0,0.00,372
,20160406,66100,66100,,,,66100,66100,0,0,0,0.00,372
,20160407,66100,66100,,,,66100,66100,0,0,0,0.00,372
,20160408,66100,66100,66000,66000,66000,66000,66000,-100,-100,12,79.20,372
,20160411,66000,66000,67350,67350,67350,67350,67350,1350,1350,12,80.82,384
,20160412,67350,67350,67380,67380,67380,67380,67380,30,30,12,80.86,384
,20160413,67380,67380,69480,69480,69480,69480,69480,2100,2100,12,83.38,384
,20160414,69480,69480,,,,69480,69480,0,0,0,0.00,384
,20160415,69480,69480,70000,70000,70000,70000,70000,520,520,12,84.00,372
ni1605,20160104,70630,70360,70810,70960,68560,68930,69370,-1430,-990,577174,"4,004,125.89",428358
,20160105,68930,69370,69200,69610,68500,69510,69070,140,-300,765810,"5,290,123.14",424542
,20160106,69510,69070,69380,69750,68360,68820,68940,-250,-130,773858,"5,335,213.40",437426
,20160107,68820,68940,69000,69410,67340,67480,68550,-1460,-390,911372,"6,248,358.28",484406
,20160108,67480,68550,67460,68550,66510,67920,67710,-630,-840,1222618,"8,279,023.56",459614
,20160111,67920,67710,67910,68660,66780,67000,67710,-710,0,986604,"6,680,535.00",475302
,20160112,67000,67710,67280,67630,65820,65950,66680,-1760,-1030,1033860,"6,893,897.82",497478
,20160113,65950,66680,66010,66680,65940,66220,66260,-460,-420,814236,"5,395,538.13",504624
,20160114,66220,66260,66220,68070,66050,67360,66910,1100,650,924800,"6,188,208.85",473274
,20160115,67360,66910,67370,69350,67260,68190,68320,1280,1410,1061426,"7,252,072.72",441794
,20160118,68190,68320,67820,69620,67700,69320,68760,1000,440,1076330,"7,401,742.12",449514
,20160119,69320,68760,69310,70300,68720,70130,69480,1370,720,977974,"6,795,142.92",440862
,20160120,70130,69480,70010,70290,68850,69470,69590,-10,110,925226,"6,438,990.43",437800
,20160121,69470,69590,69450,70000,68910,69250,69450,-340,-140,1032314,"7,169,698.01",427960
,20160122,69250,69450,69350,70780,69260,70160,70030,710,580,1091160,"7,641,964.76",432032
,20160125,70160,70030,70770,70930,69130,69360,69990,-670,-40,754402,"5,280,375.86",426650
,20160126,69360,69990,69400,69560,68750,69130,69150,-860,-840,744666,"5,149,821.50",429578
,20160127,69130,69150,69350,70590,69350,70520,69950,1370,800,820568,"5,740,604.13",443768
,20160128,70520,69950,70440,70570,69550,69730,70070,-220,120,683710,"4,791,289.97",442112
,20160129,69730,70070,69600,70220,69300,69590,69730,-480,-340,727910,"5,076,057.87",438022
,20160201,69590,69730,69420,70200,68500,68950,69470,-780,-260,779094,"5,412,491.89",460126
,20160202,68950,69470,68820,69240,68560,69010,68910,-460,-560,580890,"4,003,462.88",441838
,20160203,69010,68910,69050,69150,67960,68880,68600,-30,-310,640464,"4,393,920.28",436748
,20160204,68880,68600,68780,69780,68720,69340,69210,740,610,583156,"4,036,485.03",421032
,20160205,69340,69210,69360,69750,68500,68740,69130,-470,-80,494356,"3,417,775.49",407420
,20160215,68740,69130,64950,66600,64280,66320,65910,-2810,-3220,399620,"2,634,207.16",429914
,20160216,66320,65910,66010,67080,66010,66660,66590,750,680,600702,"4,000,134.58",446270
,20160217,66660,66590,66860,66890,66060,66400,66500,-190,-90,557778,"3,709,451.13",438520
,20160218,66400,66500,66600,67180,66430,66680,66740,180,240,459810,"3,068,777.50",433320
,20160219,66680,66740,66790,67350,66600,67120,66950,380,210,570678,"3,820,756.00",434012
,20160222,67120,66950,67150,69050,67010,68730,67970,1780,1020,740480,"5,033,206.41",444796
,20160223,68730,67970,69060,69560,68510,68700,69020,730,1050,590896,"4,078,828.01",424384
,20160224,68700,69020,69100,69120,68140,68550,68530,-470,-490,520200,"3,565,390.29",427820
,20160225,68550,68530,68350,68990,67560,67810,68350,-720,-180,657020,"4,490,835.09",451180
,20160226,67810,68350,67960,67990,66370,67290,67280,-1060,-1070,668722,"4,499,669.38",439272
,20160229,67290,67280,67500,68300,66550,67020,67410,-260,130,802790,"5,411,839.52",447552
,20160301,67020,67410,67220,67910,66690,67800,67220,390,-190,703738,"4,730,551.96",446398
,20160302,67800,67220,68000,69040,67830,68950,68410,1730,1190,783972,"5,363,861.06",431708
,20160303,68950,68410,69210,69540,68600,69400,69120,990,710,688900,"4,761,976.83",420924
,20160304,69400,69120,69550,72390,69320,71350,70730,2230,1610,1203738,"8,514,637.61",456092
,20160307,71350,70730,71340,74450,71200,73310,73010,2580,2280,1495566,"10,919,677.86",486106
,20160308,73310,73010,73860,75840,70060,71670,73070,-1340,60,1825344,"13,338,727.22",441868
,20160309,71670,73070,71900,71980,68680,69280,69690,-3790,-3380,1182210,"8,239,245.06",392578
,20160310,69280,69690,69600,70510,68750,68930,69670,-760,-20,1229092,"8,563,560.46",410358
,20160311,68930,69670,69100,69960,68510,69450,69290,-220,-380,816682,"5,658,964.54",399338
,20160314,69450,69290,69260,70370,68900,69310,69520,20,230,743622,"5,169,911.49",403324
,20160315,69310,69520,69030,69230,67730,68330,68350,-1190,-1170,750548,"5,130,158.78",394890
,20160316,68330,68350,67880,68350,67570,68100,67990,-250,-360,624272,"4,244,907.09",415204
,20160317,68100,67990,67640,68990,67590,68540,68360,550,370,690320,"4,719,105.40",422824
,20160318,68540,68360,68500,70440,68410,69860,69680,1500,1320,1136578,"7,920,657.81",422862
,20160321,69860,69680,69750,70060,67780,68090,68730,-1590,-950,840560,"5,777,856.96",439046
,20160322,68090,68730,68200,69350,68170,68450,68710,-280,-20,821964,"5,648,271.49",434656
,20160323,68450,68710,68300,69500,68050,68260,68690,-450,-20,674642,"4,634,512.82",435104
,20160324,68260,68690,68360,68610,67600,68130,68130,-560,-560,686116,"4,675,155.32",412414
,20160325,68130,68130,67980,68640,67850,68470,68320,340,190,461376,"3,152,214.69",393696
,20160328,68470,68320,68380,68950,67990,68120,68560,-200,240,436500,"2,993,040.54",387790
,20160329,68120,68560,68180,68810,67800,68290,68300,-270,-260,409056,"2,793,867.71",371538
,20160330,68290,68300,68240,68380,66350,66740,67190,-1560,-1110,643814,"4,326,176.65",393148
,20160331,66740,67190,66600,67390,66100,66250,66700,-940,-490,551754,"3,680,594.02",387192
,20160401,66250,66700,66070,66830,66010,66340,66450,-360,-250,472770,"3,141,636.17",368288
,20160405,66340,66450,66060,66230,65140,65690,65680,-760,-770,255854,"1,680,679.15",362046
,20160406,65690,65680,65530,66850,65530,66710,66460,1030,780,410908,"2,731,041.54",336676
,20160407,66710,66460,66710,67340,66610,67050,67010,590,550,340576,"2,282,495.75",311830
,20160408,67050,67010,66950,66950,65600,66520,66200,-490,-810,365724,"2,421,402.50",289182
,20160411,66520,66200,66660,67690,66640,67290,67250,1090,1050,316658,"2,129,659.80",260904
,20160412,67290,67250,67500,67830,67000,67800,67430,550,180,171238,"1,154,806.96",238242
,20160413,67800,67430,67800,70560,67610,69050,68980,1620,1550,271354,"1,871,868.82",182880
,20160414,69050,68980,69500,69980,68900,69300,69510,320,530,108428,"753,780.20",166160
,20160415,69300,69510,69420,70000,68690,68890,69500,-620,-10,78358,"544,661.67",150948
,20160418,68890,69500,68880,69990,68170,69300,69080,-200,-420,62466,"431,515.45",141720
,20160419,69300,69080,69600,70650,68740,69560,69940,480,860,74238,"519,283.73",128542
,20160420,69560,69940,69670,71320,69670,70420,70570,480,630,74430,"525,267.04",119664
,20160421,70420,70570,70980,72900,70300,72270,71570,1700,1000,72928,"522,002.85",114394
,20160422,72270,71570,73360,73550,69010,70270,70820,-1300,-750,46212,"327,299.21",110000
,20160425,70270,70820,70550,72180,69410,70540,70670,-280,-150,34754,"245,607.00",106634
,20160426,70540,70670,70540,70650,69260,69880,70150,-790,-520,31034,"217,709.61",102274
,20160427,69880,70150,70020,70940,69820,70450,70380,300,230,20284,"142,769.87",97196
,20160428,70450,70380,71170,71170,69880,70690,70520,310,140,30962,"218,354.02",91232
,20160429,70690,70520,70690,71900,70500,71030,70990,510,470,18198,"129,191.73",89076
,20160503,71030,70990,71620,74500,71170,74400,72830,3410,1840,12252,"89,242.79",87072
,20160504,74400,72830,74400,74710,72370,73150,73480,320,650,6720,"49,381.76",86088
,20160505,73150,73480,73140,73320,71600,71800,72220,-1680,-1260,3636,"26,259.53",83988
,20160506,71800,72220,71930,71930,68840,68910,69480,-3310,-2740,8688,"60,371.36",81972
,20160509,68910,69480,69010,70390,67180,67950,68280,-1530,-1200,3612,"24,666.17",81744
,20160510,67950,68280,67220,67970,66620,67900,67730,-380,-550,5508,"37,308.20",82104
,20160511,67900,67730,67830,68170,67700,68140,67950,410,220,1044,"7,094.28",81672
,20160512,68140,67950,67900,69000,67860,68700,68540,750,590,1416,"9,705.67",81708
,20160513,68700,68540,67180,68010,66400,67000,66910,-1540,-1630,240,"1,606.04",81888
,20160516,67000,66910,66510,68300,66400,67180,67300,270,390,5232,"35,216.30",79824
ni1606,20160104,70940,70990,71220,71220,68750,68990,69500,-2000,-1490,124,861.84,168
,20160105,68990,69500,69230,69780,68410,69780,69250,280,-250,162,"1,121.93",186
,20160106,69780,69250,69350,70240,68850,70240,69770,990,520,36,251.20,208
,20160107,70240,69770,69250,69520,67650,67930,68590,-1840,-1180,100,685.99,240
,20160108,67930,68590,67800,68900,67000,68370,67660,-220,-930,110,744.32,236
,20160111,68370,67660,68730,68730,67020,67860,68150,200,490,36,245.34,242
,20160112,67860,68150,67870,67870,65900,66650,66650,-1500,-1500,30,199.97,258
,20160113,66650,66650,66440,67080,65670,65670,66510,-980,-140,118,784.89,288
,20160114,65670,66510,66460,68900,66370,68310,66750,1800,240,140,934.60,270
,20160115,68310,66750,67720,69580,67720,68300,68540,1550,1790,196,"1,343.44",302
,20160118,68300,68540,68300,70100,67940,69620,68820,1080,280,186,"1,280.06",268
,20160119,69620,68820,69800,70470,68800,70060,69730,1240,910,390,"2,719.64",292
,20160120,70060,69730,70160,70530,69230,69750,69910,20,180,216,"1,510.25",274
,20160121,69750,69910,69480,70130,69370,69620,69880,-290,-30,78,545.10,270
,20160122,69620,69880,69740,70820,69550,70820,70110,940,230,38,266.43,272
,20160125,70820,70110,70780,70780,70010,70080,70410,-30,300,24,169.00,262
,20160126,70080,70410,69750,69750,69190,69460,69480,-950,-930,18,125.06,252
,20160127,69460,69480,69750,70920,69750,70920,70050,1440,570,64,448.38,232
,20160128,70920,70050,70660,70660,69860,69920,70020,-130,-30,294,"2,058.84",446
,20160129,69920,70020,70030,70030,69590,69590,69980,-430,-40,34,237.94,440
,20160201,69590,69980,69270,69270,68690,68880,68910,-1100,-1070,60,413.52,432
,20160202,68880,68910,69000,69240,68900,69240,69030,330,120,50,345.18,404
,20160203,69240,69030,69210,69210,68900,68900,69050,-130,20,8,55.24,408
,20160204,68900,69050,68960,69720,68960,69480,69350,430,300,20,138.70,408
,20160205,69480,69350,69730,69900,69660,69800,69760,450,410,30,209.31,396
,20160215,69800,69760,66390,67380,65630,66460,66220,-3300,-3540,116,768.27,422
,20160216,66460,66220,69940,69940,66350,66600,66860,380,640,150,"1,002.98",426
,20160217,66600,66860,66920,66920,66660,66770,66760,-90,-100,52,347.16,428
,20160218,66770,66760,66970,67200,66770,67050,67120,290,360,72,483.27,456
,20160219,67050,67120,67210,67640,66850,67360,67400,240,280,108,728.01,456
,20160222,67360,67400,67330,69140,67330,69140,68040,1740,640,304,"2,068.54",408
,20160223,69140,68040,69380,69600,68280,69000,69120,960,1080,104,718.90,402
,20160224,69000,69120,69050,69050,68460,68890,68820,-230,-300,18,123.88,402
,20160225,68890,68820,69070,69140,67800,67800,68750,-1020,-70,78,536.26,412
,20160226,67800,68750,68150,68150,67210,67650,67620,-1100,-1130,52,351.67,436
,20160229,67650,67620,68360,68420,67000,67700,67650,80,30,576,"3,896.80",496
,20160301,67700,67650,67320,67970,67240,67970,67460,320,-190,84,566.71,550
,20160302,67970,67460,68100,69180,68100,69180,68400,1720,940,178,"1,217.55",590
,20160303,69180,68400,69440,69700,69000,69310,69400,910,1000,308,"2,137.76",438
,20160304,69310,69400,69660,72160,69620,71230,70940,1830,1540,346,"2,454.63",448
,20160307,71230,70940,71700,74270,71550,72590,73460,1650,2520,474,"3,482.01",438
,20160308,72590,73460,74760,76060,71550,72000,74190,-1460,730,292,"2,166.61",470
,20160309,72000,74190,71590,71590,69730,69730,70300,-4460,-3890,654,"4,597.72",464
,20160310,69730,70300,70000,70720,69100,69100,70100,-1200,-200,170,"1,191.84",424
,20160311,69100,70100,69290,70100,68950,69610,69530,-490,-570,28,194.69,420
,20160314,69610,69530,69480,70080,69480,69480,69690,-50,160,52,362.41,416
,20160315,69480,69690,69380,69380,68060,68780,68390,-910,-1300,300,"2,051.97",458
,20160316,68780,68390,68270,68530,67950,68530,68250,140,-140,128,873.61,500
,20160317,68530,68250,68530,69240,68320,68860,68740,610,490,116,797.44,490
,20160318,68860,68740,68860,71160,68840,70200,70090,1460,1350,254,"1,780.45",496
,20160321,70200,70090,70050,70050,68200,68450,69060,-1640,-1030,264,"1,823.31",458
,20160322,68450,69060,68700,69350,68560,68700,68900,-360,-160,216,"1,488.27",492
,20160323,68700,68900,68350,69550,68310,68420,69170,-480,270,156,"1,079.15",416
,20160324,68420,69170,68420,68620,68000,68130,68370,-1040,-800,152,"1,039.30",442
,20160325,68130,68370,68440,68800,68390,68490,68570,120,200,422,"2,894.02",718
,20160328,68490,68570,68740,69190,67630,67630,68710,-940,140,150,"1,030.70",724
,20160329,67630,68710,68330,68990,68190,68550,68530,-160,-180,52,356.36,714
,20160330,68550,68530,68000,68240,66640,66940,67230,-1590,-1300,792,"5,325.07",568
,20160331,66940,67230,66970,67600,66170,66450,66920,-780,-310,348,"2,328.94",612
,20160401,66450,66920,66540,67150,66430,66720,66710,-200,-210,360,"2,401.84",808
,20160405,66720,66710,66440,66440,65500,66260,65950,-450,-760,158,"1,042.06",890
,20160406,66260,65950,66590,67030,66540,67000,66920,1050,970,502,"3,359.78",1242
,20160407,67000,66920,67210,67640,67000,67160,67290,240,370,448,"3,014.63",1058
,20160408,67160,67290,66820,67590,66030,66850,66420,-440,-870,812,"5,393.40",1104
,20160411,66850,66420,67250,68200,67090,67540,67620,1120,1200,360,"2,434.63",1012
,20160412,67540,67620,68110,68110,67440,67480,67640,-140,20,70,473.52,972
,20160413,67480,67640,68450,70390,68220,69220,69410,1580,1770,1026,"7,122.29",830
,20160414,69220,69410,69640,70250,69360,69530,69790,120,380,426,"2,973.07",998
,20160415,69530,69790,69920,70540,69460,69460,69930,-330,140,450,"3,146.94",1006
,20160418,69460,69930,69460,70660,68830,70300,69390,370,-540,364,"2,526.07",1068
,20160419,70300,69390,71080,71220,69570,70060,70590,670,1200,268,"1,891.87",1090
,20160420,70060,70590,71000,71880,69800,70470,71130,-120,540,772,"5,491.78",1088
,20160421,70470,71130,71350,73050,71250,72600,72350,1470,1220,902,"6,526.08",1046
,20160422,72600,72350,73950,73950,69760,70840,71370,-1510,-980,596,"4,253.79",1038
,20160425,70840,71370,71060,72690,69690,70600,71090,-770,-280,986,"7,009.59",1210
,20160426,70600,71090,72100,72100,69800,70580,70720,-510,-370,246,"1,739.78",1134
,20160427,70580,70720,70930,71360,70360,70860,70780,140,60,446,"3,157.00",1154
,20160428,70860,70780,71170,71760,70600,71650,71090,870,310,846,"6,014.73",914
,20160429,71650,71090,71330,72280,71050,72280,71560,1190,470,150,"1,073.44",920
,20160503,72280,71560,71900,74810,71760,74810,73750,3250,2190,410,"3,024.05",1080
,20160504,74810,73750,75100,75100,72760,73230,73820,-520,70,100,738.24,1072
,20160505,73230,73820,73440,73520,71880,71880,72820,-1940,-1000,124,902.97,1062
,20160506,71880,72820,70940,70940,69170,69660,69590,-3160,-3230,146,"1,016.02",1034
,20160509,69660,69590,69320,70870,67490,67800,68710,-1790,-880,328,"2,253.76",1030
,20160510,67800,68710,67520,68210,67250,68210,67730,-500,-980,74,501.21,1034
,20160511,68210,67730,68450,68450,68030,68360,68220,630,490,46,313.81,1026
,20160512,68360,68220,68150,69180,68100,69180,68460,960,240,52,356.03,1026
,20160513,69180,68460,68840,69200,66710,66830,67940,-1630,-520,48,326.12,1018
,20160516,66830,67940,66930,67800,66930,67580,67510,-360,-430,48,324.09,1018
,20160517,67580,67510,68240,68350,67510,68350,67980,840,470,178,"1,210.14",1024
,20160518,68350,67980,68020,68560,67360,67500,67910,-480,-70,148,"1,005.21",1028
,20160519,67500,67910,67090,67760,67090,67110,67310,-800,-600,32,215.42,1024
,20160520,67110,67310,66900,67490,66830,67490,67030,180,-280,66,442.44,1052
,20160523,67490,67030,67370,67370,65810,66270,66040,-760,-990,486,"3,209.77",1360
,20160524,66270,66040,65460,66300,65460,66000,65950,-40,-90,256,"1,688.49",1380
,20160525,66000,65950,66000,66300,65990,65990,66180,40,230,54,357.39,1358
,20160526,65990,66180,65990,66300,65880,66300,66030,120,-150,94,620.74,1418
,20160527,66300,66030,66380,66500,65410,66500,65980,470,-50,40,263.95,1416
,20160530,66500,65980,66350,66350,65750,65990,65900,10,-80,60,395.45,1418
,20160531,65990,65900,65450,67300,65450,67000,66770,1100,870,158,"1,055.01",1416
,20160601,67000,66770,66210,66210,65690,66010,65980,-760,-790,48,316.70,1416
,20160602,66010,65980,65170,66700,65170,66600,66330,620,350,240,"1,591.99",1404
,20160603,66600,66330,67640,67650,65810,65860,66700,-470,370,60,400.20,1392
,20160606,65860,66700,67010,67740,67010,67740,67300,1040,600,60,403.81,1392
,20160607,67740,67300,68400,68400,67400,67400,67810,100,510,96,650.98,1392
,20160608,67400,67810,68000,68000,66490,67210,67030,-600,-780,132,884.83,1368
,20160613,67210,67030,68990,69000,68990,69000,68990,1970,1960,420,"2,897.99",1368
,20160614,69000,68990,69200,69300,69200,69300,69280,310,290,240,"1,662.72",1428
,20160615,69300,69280,70000,70000,70000,70000,70000,720,720,264,"1,848.00",1464
ni1607,20160104,71600,71600,,,,70100,70100,-1500,-1500,0,0.00,30
,20160105,70100,70100,,,,69850,69850,-250,-250,0,0.00,30
,20160106,69850,69850,68520,68520,68520,68520,68520,-1330,-1330,2,13.70,32
,20160107,68520,68520,69110,69110,68530,68530,68910,10,390,6,41.35,34
,20160108,68530,68910,68880,68880,68880,68880,68880,-30,-30,2,13.78,34
,20160111,68880,68880,,,,69370,69370,490,490,0,0.00,34
,20160112,69370,69370,67250,67250,67000,67000,67150,-2370,-2220,6,40.29,40
,20160113,67000,67150,67050,67050,67050,67050,67050,-100,-100,2,13.41,40
,20160114,67050,67050,,,,67290,67290,240,240,0,0.00,40
,20160115,67290,67290,69010,69010,69010,69010,69010,1720,1720,2,13.80,40
,20160118,69010,69010,69350,69350,68210,69240,68840,230,-170,24,165.24,46
,20160119,69240,68840,70200,70200,70200,70200,70200,1360,1360,2,14.04,44
,20160120,70200,70200,69590,69590,69590,69590,69590,-610,-610,2,13.92,44
,20160121,69590,69590,,,,69560,69560,-30,-30,0,0.00,44
,20160122,69560,69560,,,,69790,69790,230,230,0,0.00,44
,20160125,69790,69790,69790,70700,69780,70700,70010,910,220,8,56.01,36
,20160126,70700,70010,70610,70670,68800,69760,69860,-250,-150,56,391.22,54
,20160127,69760,69860,70770,71270,70770,71270,71120,1410,1260,20,142.24,68
,20160128,71270,71120,71080,71080,71080,71080,71080,-40,-40,6,42.65,62
,20160129,71080,71080,70540,70540,69650,70230,70070,-850,-1010,18,126.13,48
,20160201,70230,70070,70370,70370,70370,70370,70370,300,300,2,14.07,46
,20160202,70370,70370,,,,70490,70490,120,120,0,0.00,46
,20160203,70490,70490,,,,70510,70510,20,20,0,0.00,46
,20160204,70510,70510,,,,70810,70810,300,300,0,0.00,46
,20160205,70810,70810,,,,71230,71230,420,420,0,0.00,46
,20160215,71230,71230,,,,67620,67620,-3610,-3610,0,0.00,46
,20160216,67620,67620,,,,68270,68270,650,650,0,0.00,46
,20160217,68270,68270,67190,67190,67190,67190,67190,-1080,-1080,2,13.44,44
,20160218,67190,67190,,,,67550,67550,360,360,0,0.00,44
,20160219,67550,67550,,,,67840,67840,290,290,0,0.00,44
,20160222,67840,67840,,,,68480,68480,640,640,0,0.00,44
,20160223,68480,68480,,,,69570,69570,1090,1090,0,0.00,44
,20160224,69570,69570,69680,69680,69510,69510,69510,-60,-60,42,291.98,86
,20160225,69510,69510,68500,68500,68500,68500,68500,-1010,-1010,2,13.70,86
,20160226,68500,68500,68660,68730,68660,68730,68690,230,190,4,27.48,82
,20160229,68730,68690,68440,68440,67890,68160,68120,-530,-570,14,95.38,82
,20160301,68160,68120,,,,67930,67930,-190,-190,0,0.00,82
,20160302,67930,67930,,,,68870,68870,940,940,0,0.00,82
,20160303,68870,68870,,,,69880,69880,1010,1010,0,0.00,82
,20160304,69880,69880,70400,70970,70110,70110,70490,230,610,6,42.30,84
,20160307,70110,70490,73750,74650,73410,74050,73910,3560,3420,78,576.55,88
,20160308,74050,73910,75220,75220,70500,71970,72390,-1940,-1520,38,275.10,106
,20160309,71970,72390,,,,68590,68590,-3800,-3800,0,0.00,106
,20160310,68590,68590,,,,68400,68400,-190,-190,0,0.00,106
,20160311,68400,68400,69990,69990,69640,69640,69810,1240,1410,4,27.93,106
,20160314,69640,69810,,,,69970,69970,160,160,0,0.00,106
,20160315,69970,69970,,,,68670,68670,-1300,-1300,0,0.00,106
,20160316,68670,68670,,,,68530,68530,-140,-140,0,0.00,106
,20160317,68530,68530,69340,69340,68930,68930,69170,400,640,6,41.50,102
,20160318,68930,69170,70720,70720,70720,70720,70720,1550,1550,2,14.14,102
,20160321,70720,70720,69100,69100,69100,69100,69100,-1620,-1620,2,13.82,104
,20160322,69100,69100,69350,69760,69350,69760,69550,660,450,4,27.82,104
,20160323,69760,69550,,,,69820,69820,270,270,0,0.00,104
,20160324,69820,69820,,,,69010,69010,-810,-810,0,0.00,104
,20160325,69010,69010,,,,69220,69220,210,210,0,0.00,104
,20160328,69220,69220,68660,68660,68660,68660,68660,-560,-560,20,137.32,124
,20160329,68660,68660,68660,68660,68660,68660,68660,0,0,6,41.20,118
,20160330,68660,68660,,,,67360,67360,-1300,-1300,0,0.00,118
,20160331,67360,67360,66610,66610,66610,66610,66610,-750,-750,28,186.51,138
,20160401,66610,66610,67280,67280,66910,66910,67090,300,480,16,107.36,134
,20160405,66910,67090,,,,66320,66320,-770,-770,0,0.00,134
,20160406,66320,66320,66660,67100,66600,66760,66750,440,430,10,66.76,130
,20160407,66760,66750,,,,67110,67110,360,360,0,0.00,130
,20160408,67110,67110,66520,66900,66520,66900,66710,-210,-400,4,26.68,130
,20160411,66900,66710,67460,67870,67460,67830,67750,1120,1040,8,54.21,124
,20160412,67830,67750,67860,67860,67530,67530,67720,-220,-30,10,67.72,124
,20160413,67530,67720,68850,70630,68310,70280,70100,2560,2380,164,"1,149.66",182
,20160414,70280,70100,70660,70660,69830,69980,70090,-120,-10,34,238.34,190
,20160415,69980,70090,69900,70800,69490,69560,70040,-530,-50,324,"2,269.45",208
,20160418,69560,70040,69630,70670,68940,70670,69540,630,-500,64,445.11,210
,20160419,70670,69540,70880,71770,67430,69980,70740,440,1200,54,382.03,216
,20160420,69980,70740,71030,71870,70140,71030,71470,290,730,24,171.53,226
,20160421,71030,71470,71730,73800,71530,73280,73060,1810,1590,320,"2,338.04",438
,20160422,73280,73060,73830,74070,70800,71230,72440,-1830,-620,86,623.07,444
,20160425,71230,72440,71640,72260,70400,71420,71130,-1020,-1310,194,"1,380.08",310
,20160426,71420,71130,71230,71230,70190,70670,70680,-460,-450,18,127.22,308
,20160427,70670,70680,70930,71660,70840,70840,71140,160,460,96,682.99,280
,20160428,70840,71140,71720,72010,70970,71430,71540,290,400,48,343.42,270
,20160429,71430,71540,71640,72130,71470,72130,71640,590,100,172,"1,232.24",254
,20160503,72130,71640,72130,75420,72130,75420,73250,3780,1610,52,380.95,240
,20160504,75420,73250,74590,75570,73720,74060,74540,810,1290,52,387.61,238
,20160505,74060,74540,74230,74230,72310,72800,73000,-1740,-1540,194,"1,416.24",262
,20160506,72800,73000,72830,72830,69330,69900,71400,-3100,-1600,108,771.13,210
,20160509,69900,71400,70240,71400,68590,68740,70050,-2660,-1350,70,490.36,234
,20160510,68740,70050,67650,68180,67500,68180,67800,-1870,-2250,12,81.36,234
,20160511,68180,67800,69020,69030,68910,68930,68980,1130,1180,42,289.72,248
,20160512,68930,68980,,,,68980,68980,0,0,0,0.00,248
,20160513,68980,68980,70060,70060,67190,67770,68480,-1210,-500,30,205.44,264
,20160516,67770,68480,67410,68560,67400,68000,68180,-480,-300,118,804.55,258
,20160517,68000,68180,68870,68870,68160,68640,68440,460,260,34,232.70,254
,20160518,68640,68440,69020,69210,67850,67850,68660,-590,220,64,439.47,242
,20160519,67850,68660,67720,67940,67720,67940,67840,-720,-820,18,122.11,242
,20160520,67940,67840,67550,67630,67550,67630,67570,-210,-270,10,67.57,244
,20160523,67630,67570,67540,67540,66040,66840,66670,-730,-900,216,"1,440.26",322
,20160524,66840,66670,66290,66660,65330,66220,66360,-450,-310,108,716.78,338
,20160525,66220,66360,66330,67050,65990,66340,66740,-20,380,192,"1,281.56",344
,20160526,66340,66740,66800,66890,66200,66310,66640,-430,-100,66,439.85,318
,20160527,66310,66640,66060,66930,65930,66810,66270,170,-370,54,357.89,332
,20160530,66810,66270,66750,66750,66140,66570,66330,300,60,26,172.47,330
,20160531,66570,66330,66730,67600,66730,67600,66940,1270,610,26,174.06,342
,20160601,67600,66940,67270,67270,66220,66220,66580,-720,-360,44,292.96,364
,20160602,66220,66580,66140,67130,66140,66870,66730,290,150,48,320.33,356
,20160603,66870,66730,66870,66950,66750,66750,66900,20,170,176,"1,177.44",342
,20160606,66750,66900,67150,68160,67030,68150,67810,1250,910,60,406.91,336
,20160607,68150,67810,68450,68450,67900,67950,67950,140,140,114,774.68,384
,20160608,67950,67950,67760,68470,67760,68150,68220,200,270,232,"1,582.91",490
,20160613,68150,68220,69320,69320,69320,69320,69320,1100,1100,2,13.86,490
,20160614,69320,69320,69630,69750,69390,69610,69590,290,270,86,598.53,480
,20160615,69610,69590,69560,70470,69540,70470,69810,880,220,80,558.52,490
,20160616,70470,69810,71040,71040,69670,69670,70340,-140,530,24,168.82,486
,20160617,69670,70340,69540,70420,69440,70420,69830,80,-510,52,363.16,460
,20160620,70420,69830,70850,71980,70850,71870,71770,2040,1940,102,732.09,490
,20160621,71870,71770,72040,72800,70910,72000,71990,230,220,134,964.71,532
,20160622,72000,71990,71450,72100,70950,71920,71460,-70,-530,132,943.40,580
,20160623,71920,71460,72000,72230,70900,71190,71270,-270,-190,1194,"8,510.11",1476
,20160624,71190,71270,71500,71630,69570,69900,70000,-1370,-1270,1272,"8,905.24",2606
,20160627,69900,70000,69840,70890,69840,70850,70200,850,200,694,"4,872.10",2904
,20160628,70850,70200,70720,72160,70350,71810,71330,1610,1130,666,"4,751.14",3196
,20160629,71810,71330,71850,73150,71850,72620,72260,1290,930,1116,"8,064.62",3248
,20160630,72620,72260,72860,74200,72700,74200,73280,1940,1020,80,586.30,3240
,20160701,74200,73280,72930,72930,72930,72930,72930,-350,-350,24,175.03,3240
,20160704,72930,72930,77290,77290,77290,77290,77290,4360,4360,12,92.75,3240
,20160705,77290,77290,81050,81050,76800,80000,78390,2710,1100,2964,"23,235.83",3264
,20160706,80000,78390,,,,78390,78390,0,0,0,0.00,3264
,20160707,78390,78390,79000,79200,78330,78330,78930,-60,540,48,378.88,3264
,20160708,78330,78930,,,,78930,78930,0,0,0,0.00,3264
,20160711,78930,78930,76800,76800,76800,76800,76800,-2130,-2130,24,184.32,3264
,20160712,76800,76800,,,,76800,76800,0,0,0,0.00,3264
,20160713,76800,76800,81390,81390,81390,81390,81390,4590,4590,12,97.67,3252
,20160714,81390,81390,79300,79300,79300,79300,79300,-2090,-2090,408,"3,235.44",3252
,20160715,79300,79300,,,,79300,79300,0,0,0,0.00,3252
ni1608,20160104,71060,71060,69830,69830,69790,69790,69810,-1270,-1250,6,41.89,66
,20160105,69790,69810,,,,69810,69810,0,0,0,0.00,66
,20160106,69810,69810,,,,68480,68480,-1330,-1330,0,0.00,66
,20160107,68480,68480,,,,68860,68860,380,380,0,0.00,66
,20160108,68860,68860,,,,68830,68830,-30,-30,0,0.00,66
,20160111,68830,68830,,,,69320,69320,490,490,0,0.00,66
,20160112,69320,69320,,,,67100,67100,-2220,-2220,0,0.00,66
,20160113,67100,67100,,,,67000,67000,-100,-100,0,0.00,66
,20160114,67000,67000,,,,67240,67240,240,240,0,0.00,66
,20160115,67240,67240,69760,69760,69250,69250,69590,2010,2350,16,111.35,74
,20160118,69250,69590,70110,70710,69070,69070,69960,-520,370,6,41.98,78
,20160119,69070,69960,,,,71340,71340,1380,1380,0,0.00,78
,20160120,71340,71340,,,,70720,70720,-620,-620,0,0.00,78
,20160121,70720,70720,70660,70660,69570,70290,70110,-430,-610,90,631.07,96
,20160122,70290,70110,,,,70340,70340,230,230,0,0.00,96
,20160125,70340,70340,70410,70540,69290,70150,70140,-190,-200,16,112.22,92
,20160126,70150,70140,,,,69990,69990,-150,-150,0,0.00,92
,20160127,69990,69990,70480,71260,70110,71260,70820,1270,830,16,113.32,94
,20160128,71260,70820,71300,71300,71300,71300,71300,480,480,2,14.26,92
,20160129,71300,71300,70600,70620,70600,70620,70610,-680,-690,4,28.24,90
,20160201,70620,70610,68980,70040,68980,68980,69400,-1630,-1210,10,69.40,88
,20160202,68980,69400,68700,68700,68700,68700,68700,-700,-700,4,27.48,88
,20160203,68700,68700,69340,69340,69340,69340,69340,640,640,2,13.87,90
,20160204,69340,69340,70080,70080,70080,70080,70080,740,740,2,14.02,90
,20160205,70080,70080,,,,70500,70500,420,420,0,0.00,90
,20160215,70500,70500,66500,66990,66500,66990,66820,-3510,-3680,6,40.10,88
,20160216,66990,66820,67180,67950,66680,67950,67330,1130,510,14,94.26,96
,20160217,67950,67330,,,,66260,66260,-1070,-1070,0,0.00,96
,20160218,66260,66260,66880,67680,66880,67620,67290,1360,1030,8,53.84,96
,20160219,67620,67290,,,,67570,67570,280,280,0,0.00,96
,20160222,67570,67570,69200,69460,69200,69460,69330,1890,1760,20,138.66,92
,20160223,69460,69330,,,,70430,70430,1100,1100,0,0.00,92
,20160224,70430,70430,69790,69790,69790,69790,69790,-640,-640,2,13.96,92
,20160225,69790,69790,,,,68770,68770,-1020,-1020,0,0.00,92
,20160226,68770,68770,,,,68960,68960,190,190,0,0.00,92
,20160229,68960,68960,68500,68500,68500,68500,68500,-460,-460,2,13.70,94
,20160301,68500,68500,,,,68310,68310,-190,-190,0,0.00,94
,20160302,68310,68310,69320,69450,69320,69450,69400,1140,1090,6,41.64,92
,20160303,69450,69400,,,,70420,70420,1020,1020,0,0.00,92
,20160304,70420,70420,71390,72480,71390,71880,72180,1460,1760,30,216.55,102
,20160307,71880,72180,72260,74470,72260,74130,73860,1950,1680,18,132.96,112
,20160308,74130,73860,75650,75650,71740,72540,73670,-1320,-190,28,206.28,114
,20160309,72540,73670,72100,72100,69270,69570,70250,-4100,-3420,42,295.08,110
,20160310,69570,70250,70280,70280,70280,70280,70280,30,30,2,14.06,110
,20160311,70280,70280,69290,69830,69290,69830,69690,-450,-590,8,55.76,108
,20160314,69830,69690,70660,70820,70030,70300,70370,610,680,22,154.81,114
,20160315,70300,70370,,,,69060,69060,-1310,-1310,0,0.00,114
,20160316,69060,69060,68930,68930,68770,68830,68870,-230,-190,12,82.64,122
,20160317,68830,68870,,,,69510,69510,640,640,0,0.00,122
,20160318,69510,69510,70460,71490,69630,71490,70300,1980,790,8,56.24,128
,20160321,71490,70300,,,,68680,68680,-1620,-1620,0,0.00,128
,20160322,68680,68680,69790,69790,69790,69790,69790,1110,1110,2,13.96,128
,20160323,69790,69790,69760,70400,68640,69690,69370,-100,-420,26,180.38,130
,20160324,69690,69370,69390,69390,69390,69390,69390,20,20,2,13.88,130
,20160325,69390,69390,,,,69600,69600,210,210,0,0.00,130
,20160328,69600,69600,68970,68970,68970,68970,68970,-630,-630,40,275.88,170
,20160329,68970,68970,68580,69150,68580,69100,69050,130,80,20,138.11,154
,20160330,69100,69050,,,,67740,67740,-1310,-1310,0,0.00,154
,20160331,67740,67740,67210,67210,67130,67130,67170,-610,-570,6,40.30,160
,20160401,67130,67170,,,,67660,67660,490,490,0,0.00,160
,20160405,67660,67660,,,,66890,66890,-770,-770,0,0.00,160
,20160406,66890,66890,66960,67680,66850,67530,67380,640,490,474,"3,194.12",170
,20160407,67530,67380,67880,68010,67850,67860,67900,480,520,24,162.96,172
,20160408,67860,67900,67180,67360,66980,67090,67170,-810,-730,56,376.21,178
,20160411,67090,67170,67520,68600,67400,68290,68170,1120,1000,58,395.41,174
,20160412,68290,68170,68460,68630,68230,68230,68610,60,440,84,576.38,246
,20160413,68230,68610,69300,71360,69300,70600,69560,1990,950,48,333.91,250
,20160414,70600,69560,70500,71030,69510,70110,70390,550,830,64,450.50,246
,20160415,70110,70390,71110,71110,70190,70190,70820,-200,430,8,56.66,240
,20160418,70190,70820,69380,70840,69380,70800,70510,-20,-310,26,183.35,244
,20160419,70800,70510,71510,71770,70080,70080,71590,-430,1080,90,644.33,180
,20160420,70080,71590,71400,72450,70960,70960,71850,-630,260,124,891.01,260
,20160421,70960,71850,72060,73940,72000,73550,72740,1700,890,304,"2,211.42",202
,20160422,73550,72740,74060,74420,71000,71260,71700,-1480,-1040,300,"2,151.28",438
,20160425,71260,71700,71760,72950,71130,71730,71810,30,110,398,"2,858.40",180
,20160426,71730,71810,71510,71750,70790,70790,71610,-1020,-200,110,787.80,204
,20160427,70790,71610,71500,71930,71010,71390,71550,-220,-60,56,400.72,186
,20160428,71390,71550,71770,72290,71290,71290,71870,-260,320,8,57.50,190
,20160429,71290,71870,71860,72960,71860,72960,72380,1090,510,90,651.49,230
,20160503,72960,72380,72740,74040,72500,74040,73440,1660,1060,84,616.90,202
,20160504,74040,73440,75430,75430,73580,74190,74280,750,840,376,"2,793.22",306
,20160505,74190,74280,73990,74160,73040,73350,73660,-930,-620,34,250.47,282
,20160506,73350,73660,71510,71510,69820,70720,70590,-2940,-3070,36,254.16,282
,20160509,70720,70590,70950,71560,69100,69140,70960,-1450,370,164,"1,163.78",282
,20160510,69140,70960,69170,69170,68410,69120,68980,-1840,-1980,10,68.99,284
,20160511,69120,68980,69190,69340,68780,69210,69160,230,180,70,484.13,280
,20160512,69210,69160,69560,69750,69560,69750,69670,590,510,16,111.48,276
,20160513,69750,69670,69600,69970,67480,68140,69140,-1530,-530,52,359.56,250
,20160516,68140,69140,68100,68600,68100,68330,68340,-810,-800,18,123.02,254
,20160517,68330,68340,68950,68950,68950,68950,68950,610,610,2,13.79,252
,20160518,68950,68950,69270,69270,69110,69200,69190,250,240,6,41.52,250
,20160519,69200,69190,,,,68360,68360,-830,-830,0,0.00,250
,20160520,68360,68360,67750,68320,67750,68320,68180,-40,-180,14,95.46,256
,20160523,68320,68180,68060,68060,66660,66950,67070,-1230,-1110,50,335.37,272
,20160524,66950,67070,66710,66760,66700,66740,66740,-330,-330,24,160.18,278
,20160525,66740,66740,66590,67410,66590,66770,67100,30,360,52,348.95,278
,20160526,66770,67100,67000,67000,66540,66800,66700,-300,-400,74,493.61,290
,20160527,66800,66700,,,,66330,66330,-370,-370,0,0.00,290
,20160530,66330,66330,67190,67190,67190,67190,67190,860,860,2,13.44,290
,20160531,67190,67190,67210,68160,67210,67850,67590,660,400,30,202.79,292
,20160601,67850,67590,67820,67820,67530,67530,67660,-60,70,10,67.66,290
,20160602,67530,67660,66940,67600,66710,67250,67370,-410,-290,94,633.33,334
,20160603,67250,67370,67220,67710,67100,67360,67370,-10,0,132,889.34,326
,20160606,67360,67370,67770,68700,67470,68490,68190,1120,820,60,409.16,308
,20160607,68490,68190,68890,69000,68210,68440,68720,250,530,64,439.86,318
,20160608,68440,68720,,,,68720,68720,0,0,0,0.00,318
,20160613,68720,68720,69470,70270,69470,70090,69870,1370,1150,58,405.29,312
,20160614,70090,69870,69980,70000,69900,70000,69980,130,110,130,909.80,282
,20160615,70000,69980,70100,70690,69920,70670,70370,690,390,74,520.81,280
,20160616,70670,70370,70630,70720,69920,69970,70380,-400,10,24,168.91,270
,20160617,69970,70380,69630,70780,69630,70780,70180,400,-200,48,336.88,254
,20160620,70780,70180,70900,72250,70830,72100,71820,1920,1640,64,459.71,240
,20160621,72100,71820,72070,73040,72050,72100,72490,280,670,86,623.44,224
,20160622,72100,72490,71560,72250,71370,72020,71750,-470,-740,10,71.75,224
,20160623,72020,71750,72270,72400,71500,71740,71820,-10,70,240,"1,723.80",242
,20160624,71740,71820,71880,72000,70040,70270,71050,-1550,-770,180,"1,279.00",310
,20160627,70270,71050,70310,71690,70310,71470,70680,420,-370,152,"1,074.48",352
,20160628,71470,70680,71380,71950,70670,71950,71040,1270,360,80,568.37,388
,20160629,71950,71040,72190,73260,72190,72950,72940,1910,1900,40,291.76,374
,20160630,72950,72940,73430,74600,73200,74490,74290,1550,1350,166,"1,233.30",362
,20160701,74490,74290,73530,75350,73240,75010,74260,720,-30,68,505.03,348
,20160704,75010,74260,75200,78710,75200,78610,78310,4350,4050,632,"4,949.59",434
,20160705,78610,78310,82520,82550,76840,80100,79980,1790,1670,150,"1,199.83",426
,20160706,80100,79980,80010,81250,76000,78230,77600,-1750,-2380,278,"2,157.43",404
,20160707,78230,77600,76530,80210,76530,77950,78840,350,1240,154,"1,214.15",370
,20160708,77950,78840,76810,76810,75490,76050,76450,-2790,-2390,28,214.08,384
,20160711,76050,76450,77030,79130,76260,78800,77120,2350,670,462,"3,563.29",390
,20160712,78800,77120,79190,79510,78550,79300,78980,2180,1860,102,805.63,386
,20160713,79300,78980,80880,82850,79790,80280,81560,1300,2580,156,"1,272.41",392
,20160714,80280,81560,80880,81370,79010,81170,80810,-390,-750,48,387.90,384
,20160715,81170,80810,80900,81040,80100,80390,80640,-420,-170,62,500.02,406
,20160718,80390,80640,81300,81300,79210,80410,80390,-230,-250,68,546.67,400
,20160719,80410,80390,80610,82990,80260,81720,81130,1330,740,612,"4,965.60",464
,20160720,81720,81130,81160,81800,81160,81800,81260,670,130,20,162.54,448
,20160721,81800,81260,81260,82100,80160,81830,81290,570,30,168,"1,365.70",464
,20160722,81830,81290,82310,83600,81100,81420,83200,130,1910,1218,"10,133.84",450
,20160725,81420,83200,79500,79970,79500,79970,79510,-3230,-3690,50,397.59,448
,20160726,79970,79510,79900,79900,78520,78650,79430,-860,-80,46,365.42,432
,20160727,78650,79430,80150,80150,78890,79170,79620,-260,190,64,509.61,436
,20160728,79170,79620,79450,80350,79450,80350,79870,730,250,100,798.78,424
,20160729,80350,79870,80500,84280,79310,84280,80870,4410,1000,312,"2,523.25",432
,20160801,84280,80870,80280,82000,80280,82000,81450,1130,580,60,488.70,444
,20160802,82000,81450,81500,82800,81500,82800,82180,1350,730,132,"1,084.80",552
,20160803,82800,82180,83000,83570,81870,81870,82880,-310,700,276,"2,287.64",648
,20160804,81870,82880,82300,82300,80150,80150,81640,-2730,-1240,48,391.91,648
,20160805,80150,81640,,,,81640,81640,0,0,0,0.00,648
,20160808,81640,81640,82280,82280,82200,82200,82240,560,600,24,197.38,648
,20160809,82200,82240,81800,81800,81780,81780,81790,-460,-450,24,196.30,636
,20160810,81780,81790,81710,83380,81710,83380,82090,1590,300,60,492.58,624
,20160811,83380,82090,,,,82090,82090,0,0,0,0.00,624
,20160812,82090,82090,81000,81000,81000,81000,81000,-1090,-1090,12,97.20,636
,20160815,81000,81000,79050,79050,79050,79050,79050,-1950,-1950,12,94.86,648
ni1609,20160104,71610,71570,71920,71920,69960,70180,70560,-1390,-1010,658,"4,643.41",1986
,20160105,70180,70560,70320,70810,69640,70730,70330,170,-230,224,"1,575.44",2034
,20160106,70730,70330,70860,70860,69610,70180,70080,-150,-250,370,"2,593.17",2002
,20160107,70180,70080,70000,70380,68540,68540,69490,-1540,-590,392,"2,724.29",2128
,20160108,68540,69490,68760,69680,67720,69240,68670,-250,-820,638,"4,381.43",2124
,20160111,69240,68670,70000,70000,68000,68000,68920,-670,250,400,"2,757.09",2192
,20160112,68000,68920,67500,68760,67100,67100,67770,-1820,-1150,550,"3,727.86",2272
,20160113,67100,67770,67350,67800,67130,67220,67450,-550,-320,440,"2,967.96",2232
,20160114,67220,67450,66800,69150,66790,68540,68020,1090,570,930,"6,326.64",2142
,20160115,68540,68020,68880,70290,68430,69140,69300,1120,1280,2246,"15,566.58",3046
,20160118,69140,69300,68880,70670,68880,70450,69720,1150,420,2004,"13,972.55",3250
,20160119,70450,69720,70590,71300,69830,71290,70400,1570,680,1594,"11,222.05",3572
,20160120,71290,70400,71100,71310,69880,70330,70710,-70,310,1948,"13,775.20",3398
,20160121,70330,70710,70630,71000,70000,70270,70500,-440,-210,840,"5,922.57",3364
,20160122,70270,70500,70380,71760,70370,71120,71240,620,740,1080,"7,694.66",3386
,20160125,71120,71240,71550,71570,70200,70310,71030,-930,-210,928,"6,592.08",3512
,20160126,70310,71030,70430,70520,69110,70160,70190,-870,-840,1298,"9,111.83",3810
,20160127,70160,70190,70730,71600,70440,71600,71020,1410,830,1706,"12,116.20",3938
,20160128,71600,71020,71510,71590,70610,70780,71030,-240,10,1154,"8,196.91",4036
,20160129,70780,71030,70700,71250,70390,70520,70810,-510,-220,1048,"7,421.63",4148
,20160201,70520,70810,70480,71240,69600,70010,70530,-800,-280,944,"6,658.88",4210
,20160202,70010,70530,69880,70250,69660,70040,69970,-490,-560,1166,"8,158.71",4134
,20160203,70040,69970,70070,70090,69080,69990,69620,20,-350,796,"5,542.08",4118
,20160204,69990,69620,69920,70750,69850,70400,70420,780,800,1666,"11,732.26",4534
,20160205,70400,70420,70350,70720,69500,69700,69980,-720,-440,2596,"18,166.89",5242
,20160215,69700,69980,64450,67420,64450,67100,66680,-2880,-3300,5030,"33,540.37",7544
,20160216,67100,66680,67020,68000,66900,67650,67460,970,780,4934,"33,285.01",8894
,20160217,67650,67460,67680,67790,67020,67300,67370,-160,-90,4762,"32,083.28",10612
,20160218,67300,67370,67300,68100,67300,67600,67650,230,280,3104,"21,001.13",10924
,20160219,67600,67650,67500,68280,67500,68090,67870,440,220,3464,"23,511.35",11082
,20160222,68090,67870,68190,69960,68010,69720,69020,1850,1150,4528,"31,256.57",11916
,20160223,69720,69020,69990,70550,69540,69660,70060,640,1040,6934,"48,583.60",13840
,20160224,69660,70060,70010,70010,69150,69570,69520,-490,-540,4238,"29,466.71",14444
,20160225,69570,69520,69290,69960,68440,68820,69320,-700,-200,6210,"43,047.77",14222
,20160226,68820,69320,69010,69010,67400,68300,68120,-1020,-1200,6952,"47,362.01",14136
,20160229,68300,68120,68440,69240,67500,68060,68340,-60,220,6006,"41,047.19",14458
,20160301,68060,68340,68350,68900,67760,68660,68280,320,-60,5190,"35,438.25",15250
,20160302,68660,68280,68990,70080,68810,69900,69540,1620,1260,9966,"69,303.68",16376
,20160303,69900,69540,70030,70510,69610,70300,70170,760,630,15856,"111,262.85",20076
,20160304,70300,70170,70510,72680,70310,72300,71570,2130,1400,71288,"510,234.11",44726
,20160307,72300,71570,72300,74930,72180,74200,73880,2630,2310,99760,"737,034.41",71180
,20160308,74200,73880,74600,76530,71100,72600,73780,-1280,-100,104752,"772,923.07",72516
,20160309,72600,73780,72910,72920,69350,70270,70500,-3510,-3280,79656,"561,607.95",73890
,20160310,70270,70500,70500,71460,69820,70070,70680,-430,180,62418,"441,189.21",77628
,20160311,70070,70680,70350,71060,69630,70560,70430,-120,-250,46894,"330,283.38",82810
,20160314,70560,70430,70500,71390,70080,70340,70590,-90,160,37652,"265,786.72",84574
,20160315,70340,70590,70300,70330,68900,69410,69460,-1180,-1130,49748,"345,578.28",89898
,20160316,69410,69460,69000,69210,68460,68940,68920,-520,-540,81024,"558,475.13",114138
,20160317,68940,68920,68500,69900,68400,69580,69330,660,410,60942,"422,571.07",121828
,20160318,69580,69330,69590,71500,69470,71010,70590,1680,1260,125890,"888,758.83",148964
,20160321,71010,70590,70940,71180,68800,69210,69730,-1380,-860,131954,"920,175.40",154230
,20160322,69210,69730,69370,70500,69300,69610,69860,-120,130,133346,"931,640.88",170032
,20160323,69610,69860,69490,70630,69220,69550,69920,-310,60,125180,"875,260.20",179060
,20160324,69550,69920,69620,69620,68750,69150,69230,-770,-690,131788,"912,395.98",183642
,20160325,69150,69230,69000,69780,69000,69500,69370,270,140,98532,"683,537.55",195812
,20160328,69500,69370,69520,70000,68950,69050,69560,-320,190,121838,"847,580.29",211914
,20160329,69050,69560,69080,69820,68810,69290,69320,-270,-240,116620,"808,442.08",213260
,20160330,69290,69320,69320,69400,67340,67640,68190,-1680,-1130,209666,"1,429,885.90",241772
,20160331,67640,68190,67650,68300,67110,67260,67620,-930,-570,181812,"1,229,425.36",275506
,20160401,67260,67620,67120,67800,67020,67380,67450,-240,-170,191300,"1,290,388.69",298734
,20160405,67380,67450,67020,67230,66300,66700,66750,-750,-700,123504,"824,415.70",311056
,20160406,66700,66750,66660,67820,66640,67740,67480,990,730,198478,"1,339,410.86",305846
,20160407,67740,67480,67680,68290,67620,68000,68010,520,530,210910,"1,434,601.03",329984
,20160408,68000,68010,67910,67940,66600,67430,67190,-580,-820,265832,"1,786,130.87",348830
,20160411,67430,67190,67600,68720,67530,68230,68260,1040,1070,416704,"2,844,584.28",371030
,20160412,68230,68260,68510,69040,68000,69000,68480,740,220,498870,"3,416,664.66",413000
,20160413,69000,68480,69070,71940,68760,70260,70340,1780,1860,1311228,"9,223,244.38",473382
,20160414,70260,70340,70800,71400,70260,70710,70880,370,540,762510,"5,405,161.93",490702
,20160415,70710,70880,70880,71460,70060,70240,70890,-640,10,745346,"5,284,073.64",508514
,20160418,70240,70890,70330,71470,69530,70840,70440,-50,-450,788530,"5,554,516.30",521640
,20160419,70840,70440,71300,72170,70040,71010,71380,570,940,1046740,"7,471,877.38",554886
,20160420,71010,71380,71340,72830,71060,71880,71990,500,610,1317728,"9,487,032.38",555618
,20160421,71880,71990,72300,74400,71720,73850,73050,1860,1060,1506998,"11,009,152.62",600716
,20160422,73850,73050,75010,75110,70470,71810,72240,-1240,-810,1459122,"10,541,837.11",557696
,20160425,71810,72240,72000,73720,70820,72050,72160,-190,-80,1250414,"9,023,929.81",561076
,20160426,72050,72160,71910,72220,70670,71350,71640,-810,-520,822540,"5,892,821.20",562176
,20160427,71350,71640,71500,72450,71260,71910,71860,270,220,823176,"5,915,687.63",564824
,20160428,71910,71860,72100,72710,71370,72170,72010,310,150,1041496,"7,500,451.22",570620
,20160429,72170,72010,72140,73400,71910,73340,72500,1330,490,954570,"6,921,030.03",593836
,20160503,73340,72500,73290,76200,72700,75940,74150,3440,1650,862968,"6,399,040.55",653182
,20160504,75940,74150,75690,76390,73720,74360,74850,210,700,1429034,"10,696,936.16",626004
,20160505,74360,74850,74540,74930,73120,73420,74020,-1430,-830,970200,"7,182,337.94",613536
,20160506,73420,74020,73460,73590,69900,70700,71410,-3320,-2610,1412010,"10,084,083.79",578524
,20160509,70700,71410,70790,72080,68920,69030,70500,-2380,-910,1291174,"9,103,257.99",604630
,20160510,69030,70500,68920,69480,68150,69210,68920,-1290,-1580,946058,"6,521,071.87",597736
,20160511,69210,68920,69050,69700,69010,69400,69360,480,440,773980,"5,368,547.42",605872
,20160512,69400,69360,69710,70610,69120,70130,69850,770,490,962488,"6,723,363.82",596240
,20160513,70130,69850,70000,70360,67750,68250,68710,-1600,-1140,1122286,"7,711,435.70",591130
,20160516,68250,68710,68080,69130,67900,68850,68670,140,-40,677276,"4,651,045.06",591198
,20160517,68850,68670,68880,69640,68660,69410,69220,740,550,688620,"4,766,935.92",594566
,20160518,69410,69220,69090,69880,68430,68600,69240,-620,20,806500,"5,584,255.73",619082
,20160519,68600,69240,68580,69180,68200,68430,68650,-810,-590,609878,"4,187,167.75",622594
,20160520,68430,68650,68190,68830,67770,68520,68370,-130,-280,559474,"3,825,509.61",628154
,20160523,68520,68370,68530,68780,66720,67180,67540,-1190,-830,828052,"5,593,114.71",643032
,20160524,67180,67540,66890,67420,66430,67020,66990,-520,-550,553818,"3,710,372.11",652548
,20160525,67020,66990,67190,67820,66730,66820,67210,-170,220,633888,"4,260,663.35",654140
,20160526,66820,67210,67080,67710,66830,67230,67170,20,-40,668844,"4,493,212.71",668578
,20160527,67230,67170,67280,67800,66350,67390,66990,220,-180,824508,"5,523,536.99",661686
,20160530,67390,66990,67390,67680,66750,67360,67250,370,260,544958,"3,665,115.87",660418
,20160531,67360,67250,67400,68390,67200,68090,67820,840,570,653542,"4,432,888.55",667272
,20160601,68090,67820,68160,68280,66950,67150,67650,-670,-170,524336,"3,547,142.15",681582
,20160602,67150,67650,66990,68000,66750,67430,67460,-220,-190,507290,"3,422,487.94",654718
,20160603,67430,67460,67320,67850,67310,67550,67600,90,140,480244,"3,246,617.19",671238
,20160606,67550,67600,68100,69260,67660,68990,68420,1390,820,615780,"4,213,473.99",652222
,20160607,68990,68420,69120,69500,68480,68780,68970,360,550,443264,"3,057,335.48",632672
,20160608,68780,68970,68500,69300,68320,68890,68740,-80,-230,408292,"2,806,733.08",607992
,20160613,68890,68740,69600,70870,69510,70300,70270,1560,1530,350280,"2,461,550.30",601348
,20160614,70300,70270,70430,70700,70000,70420,70360,150,90,389368,"2,739,848.88",588166
,20160615,70420,70360,70220,71300,70090,71240,70740,880,380,568748,"4,023,507.04",598626
,20160616,71240,70740,71880,71980,70170,70420,71080,-320,340,497828,"3,538,976.93",568340
,20160617,70420,71080,70250,71450,69900,71450,70520,370,-560,486166,"3,428,691.98",557408
,20160620,71450,70520,71600,72870,71090,72520,72030,2000,1510,617698,"4,449,837.21",541624
,20160621,72520,72030,72800,73400,72000,72390,72650,360,620,494708,"3,594,454.60",515490
,20160622,72390,72650,72450,72880,71570,72760,72200,110,-450,478340,"3,453,969.48",507188
,20160623,72760,72200,72750,72980,71680,72050,72240,-150,40,428734,"3,097,338.64",497116
,20160624,72050,72240,72180,72500,70010,70470,71270,-1770,-970,673326,"4,799,020.93",476088
,20160627,70470,71270,70610,71850,70520,71650,71230,380,-40,535002,"3,810,877.64",479126
,20160628,71650,71230,71580,72860,71030,72580,71830,1350,600,526784,"3,784,198.89",477966
,20160629,72580,71830,72730,73950,72650,73450,73250,1620,1420,710344,"5,203,569.68",459692
,20160630,73450,73250,73600,75350,73380,74890,74330,1640,1080,733846,"5,454,856.36",474668
,20160701,74890,74330,74730,75980,73600,75560,74760,1230,430,845836,"6,323,959.70",493470
,20160704,75560,74760,75700,79240,75500,79240,77950,4480,3190,1016926,"7,927,900.04",552196
,20160705,79240,77950,80950,83490,77200,80600,80080,2650,2130,1844850,"14,774,896.84",537240
,20160706,80600,80080,80660,82140,75970,78060,78480,-2020,-1600,2027096,"15,909,707.99",507050
,20160707,78060,78480,77410,80900,76680,77270,78750,-1210,270,1631036,"12,844,471.71",491106
,20160708,77270,78750,77480,78400,75120,76840,76870,-1910,-1880,1333552,"10,251,890.37",463450
,20160711,76840,76870,77510,79880,76900,79300,78200,2430,1330,1193678,"9,335,110.06",471884
,20160712,79300,78200,79450,81400,78820,81160,79740,2960,1540,1095460,"8,736,171.94",496362
,20160713,81160,79740,81400,83570,79900,80430,81830,690,2090,1638146,"13,405,176.92",485588
,20160714,80430,81830,80800,82000,79700,81770,80950,-60,-880,1085930,"8,790,918.00",486054
,20160715,81770,80950,81590,82180,80100,81200,81080,250,130,977862,"7,929,160.48",479964
,20160718,81200,81080,81610,82000,79530,80840,80860,-240,-220,1178810,"9,532,558.13",468188
,20160719,80840,80860,81000,83750,80340,81880,82180,1020,1320,1637088,"13,454,432.62",481030
,20160720,81880,82180,81750,82360,80680,81550,81580,-630,-600,1102102,"8,991,872.02",456666
,20160721,81550,81580,81080,82780,80510,82250,81840,670,260,1038416,"8,498,608.47",461090
,20160722,82250,81840,82880,84080,81150,81220,82670,-620,830,1274224,"10,534,147.68",442624
,20160725,81220,82670,81600,81890,79770,80520,80650,-2150,-2020,1000232,"8,067,102.25",414574
,20160726,80520,80650,80700,80880,78650,79390,79750,-1260,-900,860320,"6,861,292.89",382886
,20160727,79390,79750,79310,80690,79120,79650,79920,-100,170,768382,"6,141,676.14",351508
,20160728,79650,79920,79920,81500,79580,81390,80580,1470,660,784462,"6,321,216.21",343934
,20160729,81390,80580,81500,82000,80280,80330,81260,-250,680,716288,"5,820,946.51",315740
,20160801,80330,81260,80680,82580,79940,82430,81260,1170,0,684284,"5,561,171.50",304298
,20160802,82430,81260,82200,83450,81620,83390,82290,2130,1030,561092,"4,617,537.71",288158
,20160803,83390,82290,83380,83900,81770,82240,82560,-50,270,543284,"4,485,774.81",237110
,20160804,82240,82560,82300,82850,80050,80550,81550,-2010,-1010,338100,"2,757,245.53",199208
,20160805,80550,81550,80150,81500,80050,81290,80950,-260,-600,194472,"1,574,353.17",183654
,20160808,81290,80950,81040,83130,80500,82660,81860,1710,910,169610,"1,388,558.84",172616
,20160809,82660,81860,82700,83030,81600,82120,82370,260,510,104536,"861,133.25",161906
,20160810,82120,82370,81850,82960,81450,82540,82230,170,-140,90556,"744,675.03",157184
,20160811,82540,82230,82710,83500,81490,81720,82520,-510,290,90316,"745,296.40",150092
,20160812,81720,82520,81760,82250,81020,81500,81630,-1020,-890,66348,"541,631.02",140608
,20160815,81500,81630,80750,80900,79000,79300,79920,-2330,-1710,83348,"666,198.29",130754
,20160816,79300,79920,79620,80410,79480,79880,79980,-40,60,45788,"366,255.40",118888
,20160817,79880,79980,79710,80020,79040,79540,79600,-440,-380,32206,"256,381.80",114132
,20160818,79540,79600,79580,80170,78650,79780,79580,180,-20,36812,"292,984.50",109834
,20160819,79780,79580,79920,80100,79310,79890,79760,310,180,25468,"203,155.76",105572
,20160822,79890,79760,79560,80460,78950,79000,79730,-760,-30,24434,"194,815.10",102640
,20160823,79000,79730,79000,79900,78800,79390,79510,-340,-220,20100,"159,821.43",99482
,20160824,79390,79510,78720,79960,78720,79370,79510,-140,0,22174,"176,306.76",95186
,20160825,79370,79510,79380,79650,76020,77030,77260,-2480,-2250,41088,"317,478.50",85652
,20160826,77030,77260,76660,77260,76410,76950,76950,-310,-310,21404,"164,722.52",79644
,20160829,76950,76950,76950,77790,76500,77020,77120,70,170,13208,"101,860.63",77356
,20160830,77020,77120,77010,77440,76500,76750,77160,-370,40,14984,"115,631.50",72886
,20160831,76750,77160,76570,77150,76300,76300,76910,-860,-250,11030,"84,838.70",67200
,20160901,76300,76910,76620,77610,76620,77560,77090,650,180,6900,"53,195.44",64068
,20160902,77560,77090,77170,78960,77070,78270,78000,1180,910,3168,"24,712.48",62832
,20160905,78270,78000,78540,79140,78540,78680,78850,680,850,4344,"34,254.64",61488
,20160906,78680,78850,78870,79500,78050,79490,78950,640,100,3624,"28,614.50",60408
,20160907,79490,78950,79310,79650,78910,79380,79300,430,350,4260,"33,784.79",59076
,20160908,79380,79300,79770,79890,79160,79510,79590,210,290,3204,"25,500.98",60360
,20160909,79510,79590,79850,80000,79680,79850,79800,260,210,3960,"31,602.56",59568
,20160912,79850,79800,79900,79900,77070,77150,78330,-2650,-1470,2064,"16,168.06",59148
,20160913,77150,78330,78150,78180,77610,77900,77820,-430,-510,1836,"14,288.14",59076
,20160914,77900,77820,77200,79400,76810,76810,77130,-1010,-690,2496,"19,251.74",57912
,20160919,76810,77130,76810,77750,76810,77600,77550,470,420,2832,"21,964.84",58224
ni1610,20160104,72300,72300,,,,71280,71280,-1020,-1020,0,0.00,86
,20160105,71280,71280,,,,71040,71040,-240,-240,0,0.00,86
,20160106,71040,71040,,,,70790,70790,-250,-250,0,0.00,86
,20160107,70790,70790,,,,70200,70200,-590,-590,0,0.00,86
,20160108,70200,70200,,,,69370,69370,-830,-830,0,0.00,86
,20160111,69370,69370,,,,69620,69620,250,250,0,0.00,86
,20160112,69620,69620,,,,68460,68460,-1160,-1160,0,0.00,86
,20160113,68460,68460,,,,68140,68140,-320,-320,0,0.00,86
,20160114,68140,68140,67830,69550,67830,69550,68420,1410,280,12,82.11,90
,20160115,69550,68420,70060,70060,70060,70060,70060,1640,1640,4,28.02,94
,20160118,70060,70060,,,,70480,70480,420,420,0,0.00,94
,20160119,70480,70480,70000,70000,70000,70000,70000,-480,-480,2,14.00,92
,20160120,70000,70000,,,,70310,70310,310,310,0,0.00,92
,20160121,70310,70310,,,,70100,70100,-210,-210,0,0.00,92
,20160122,70100,70100,,,,70840,70840,740,740,0,0.00,92
,20160125,70840,70840,70840,71170,70840,71170,71000,330,160,4,28.40,92
,20160126,71170,71000,,,,70160,70160,-840,-840,0,0.00,92
,20160127,70160,70160,70160,71810,70160,71620,71190,1460,1030,6,42.72,94
,20160128,71620,71190,,,,71200,71200,10,10,0,0.00,94
,20160129,71200,71200,,,,70980,70980,-220,-220,0,0.00,94
,20160201,70980,70980,,,,70700,70700,-280,-280,0,0.00,94
,20160202,70700,70700,,,,70140,70140,-560,-560,0,0.00,94
,20160203,70140,70140,69950,69950,69950,69950,69950,-190,-190,2,13.99,96
,20160204,69950,69950,,,,70750,70750,800,800,0,0.00,96
,20160205,70750,70750,,,,70300,70300,-450,-450,0,0.00,96
,20160215,70300,70300,,,,66980,66980,-3320,-3320,0,0.00,96
,20160216,66980,66980,,,,67760,67760,780,780,0,0.00,96
,20160217,67760,67760,,,,67670,67670,-90,-90,0,0.00,96
,20160218,67670,67670,,,,67950,67950,280,280,0,0.00,96
,20160219,67950,67950,,,,68170,68170,220,220,0,0.00,96
,20160222,68170,68170,,,,69330,69330,1160,1160,0,0.00,96
,20160223,69330,69330,,,,70380,70380,1050,1050,0,0.00,96
,20160224,70380,70380,,,,69840,69840,-540,-540,0,0.00,96
,20160225,69840,69840,,,,69630,69630,-210,-210,0,0.00,96
,20160226,69630,69630,,,,68430,68430,-1200,-1200,0,0.00,96
,20160229,68430,68430,,,,68650,68650,220,220,0,0.00,96
,20160301,68650,68650,,,,68590,68590,-60,-60,0,0.00,96
,20160302,68590,68590,,,,69850,69850,1260,1260,0,0.00,96
,20160303,69850,69850,,,,70480,70480,630,630,0,0.00,96
,20160304,70480,70480,71220,71240,71220,71240,71220,760,740,36,256.42,132
,20160307,71240,71220,,,,73510,73510,2290,2290,0,0.00,132
,20160308,73510,73510,75760,75760,75760,75760,75760,2250,2250,2,15.15,134
,20160309,75760,75760,,,,71210,71210,-4550,-4550,0,0.00,134
,20160310,71210,71210,71040,71040,70540,70540,70870,-670,-340,6,42.52,128
,20160311,70540,70870,70510,70930,70510,70920,70790,50,-80,12,84.95,124
,20160314,70920,70790,,,,70950,70950,160,160,0,0.00,124
,20160315,70950,70950,,,,70490,70490,-460,-460,0,0.00,124
,20160316,70490,70490,69340,69340,69120,69120,69160,-1370,-1330,10,69.16,134
,20160317,69120,69160,,,,69580,69580,420,420,0,0.00,134
,20160318,69580,69580,70240,71940,70240,71520,70730,1940,1150,14,99.02,134
,20160321,71520,70730,70700,70700,70700,70700,70700,-30,-30,2,14.14,136
,20160322,70700,70700,,,,70830,70830,130,130,0,0.00,136
,20160323,70830,70830,,,,70890,70890,60,60,0,0.00,136
,20160324,70890,70890,69380,70280,69230,69420,69630,-1470,-1260,44,306.39,142
,20160325,69420,69630,,,,69770,69770,140,140,0,0.00,142
,20160328,69770,69770,69690,70460,69410,69410,69520,-360,-250,52,361.55,180
,20160329,69410,69520,,,,69280,69280,-240,-240,0,0.00,180
,20160330,69280,69280,68660,68660,68330,68330,68490,-950,-790,4,27.40,180
,20160331,68330,68490,67310,67890,67310,67890,67600,-600,-890,8,54.08,184
,20160401,67890,67600,,,,67430,67430,-170,-170,0,0.00,184
,20160405,67430,67430,,,,66730,66730,-700,-700,0,0.00,184
,20160406,66730,66730,,,,67460,67460,730,730,0,0.00,184
,20160407,67460,67460,67870,68600,67870,68510,68280,1050,820,14,95.60,184
,20160408,68510,68280,67710,67710,67180,67400,67350,-880,-930,48,323.31,146
,20160411,67400,67350,67880,69330,67880,68470,68590,1120,1240,42,288.10,152
,20160412,68470,68590,68790,69320,68370,69320,68640,730,50,76,521.69,184
,20160413,69320,68640,69890,71440,69880,70560,70620,1920,1980,162,"1,144.12",196
,20160414,70560,70620,,,,70620,70620,0,0,0,0.00,196
,20160415,70620,70620,71670,71670,71210,71210,71440,590,820,4,28.58,200
,20160418,71210,71440,,,,71440,71440,0,0,0,0.00,200
,20160419,71440,71440,71930,71930,70910,70910,71150,-530,-290,66,469.59,240
,20160420,70910,71150,71850,72900,71080,72040,72290,890,1140,78,563.90,210
,20160421,72040,72290,72750,74590,72360,74590,73370,2300,1080,68,498.98,206
,20160422,74590,73370,73820,73820,70800,71730,72720,-1640,-650,44,319.99,226
,20160425,71730,72720,72480,73470,71290,72640,72280,-80,-440,22,159.02,228
,20160426,72640,72280,72100,72100,71920,71920,72040,-360,-240,6,43.22,228
,20160427,71920,72040,72300,72420,71530,72000,72060,-40,20,116,835.91,244
,20160428,72000,72060,72670,72670,72090,72090,72370,30,310,8,57.90,236
,20160429,72090,72370,72400,73650,72400,73290,73030,920,660,110,803.38,264
,20160503,73290,73030,73340,75210,73340,75210,73770,2180,740,62,457.41,276
,20160504,75210,73770,76550,76550,74280,74970,75420,1200,1650,120,905.13,338
,20160505,74970,75420,74640,75170,74300,74300,74820,-1120,-600,48,359.15,364
,20160506,74300,74820,72780,73480,70380,71000,71600,-3820,-3220,182,"1,303.20",310
,20160509,71000,71600,71410,72770,68990,69760,70080,-1840,-1520,80,560.69,268
,20160510,69760,70080,69280,69730,68460,69730,69060,-350,-1020,54,372.95,270
,20160511,69730,69060,70000,70000,69750,69750,69870,690,810,12,83.84,276
,20160512,69750,69870,69680,70890,69680,70890,70820,1020,950,78,552.43,342
,20160513,70890,70820,70090,70090,68500,68670,69370,-2150,-1450,64,444.00,320
,20160516,68670,69370,69250,69250,69200,69200,69210,-170,-160,6,41.53,314
,20160517,69200,69210,70220,70220,69650,69900,69900,690,690,18,125.83,316
,20160518,69900,69900,70090,71010,69240,69730,69880,-170,-20,72,503.18,316
,20160519,69730,69880,69220,69220,68600,68600,68910,-1280,-970,4,27.56,316
,20160520,68600,68910,68390,69070,68390,68730,68800,-180,-110,8,55.04,318
,20160523,68730,68800,68160,68160,67540,67720,67770,-1080,-1030,20,135.56,324
,20160524,67720,67770,67360,68010,67150,67480,67430,-290,-340,12,80.92,322
,20160525,67480,67430,67910,67950,67100,67540,67820,110,390,56,379.81,370
,20160526,67540,67820,67660,67880,67330,67330,67670,-490,-150,16,108.28,368
,20160527,67330,67670,67430,68120,66930,68120,67810,450,140,34,230.56,378
,20160530,68120,67810,67850,67850,67220,67220,67470,-590,-340,10,67.47,380
,20160531,67220,67470,68010,68690,67730,68500,68080,1030,610,50,340.41,386
,20160601,68500,68080,67450,67450,67450,67450,67450,-630,-630,4,26.98,390
,20160602,67450,67450,67760,68470,67540,67860,68010,410,560,14,95.22,390
,20160603,67860,68010,67930,68180,67800,67850,67940,-160,-70,16,108.72,396
,20160606,67850,67940,68500,69080,68500,69080,69030,1140,1090,62,427.99,336
,20160607,69080,69030,69710,69710,69050,69120,69180,90,150,42,290.57,348
,20160608,69120,69180,69450,69640,69240,69240,69480,60,300,120,833.77,346
,20160613,69240,69480,67010,70950,67010,70950,70530,1470,1050,200,"1,410.61",348
,20160614,70950,70530,69930,70760,69930,70590,70300,60,-230,38,267.15,334
,20160615,70590,70300,70950,71530,70650,71530,70800,1230,500,436,"3,087.19",446
,20160616,71530,70800,72120,74500,70980,70980,72570,180,1770,382,"2,772.49",394
,20160617,70980,72570,70590,74810,70280,70780,71350,-1790,-1220,46,328.22,388
,20160620,70780,71350,71380,73020,71380,72900,72510,1550,1160,54,391.61,380
,20160621,72900,72510,72870,73170,72590,72590,72930,80,420,64,466.79,372
,20160622,72590,72930,72600,72800,72600,72800,72700,-130,-230,4,29.08,372
,20160623,72800,72700,72850,72850,72200,72380,72430,-320,-270,14,101.41,376
,20160624,72380,72430,72710,72710,70110,70950,70760,-1480,-1670,88,622.74,374
,20160627,70950,70760,71030,71030,71030,71030,71030,270,270,2,14.21,372
,20160628,71030,71030,71930,72340,71920,72340,72130,1310,1100,28,201.98,362
,20160629,72340,72130,73930,73930,72930,73260,73540,1130,1410,24,176.52,360
,20160630,73260,73540,74730,75830,74730,74860,74990,1320,1450,24,179.98,368
,20160701,74860,74990,74480,75830,74020,75830,74720,840,-270,20,149.45,364
,20160704,75830,74720,79200,79200,78940,79190,79060,4470,4340,12,94.88,370
,20160705,79190,79060,83660,83660,77480,80380,80970,1320,1910,318,"2,574.97",392
,20160706,80380,80970,77320,82130,76990,78950,79030,-2020,-1940,228,"1,801.91",398
,20160707,78950,79030,78500,81430,77210,78200,79320,-830,290,134,"1,063.01",410
,20160708,78200,79320,78350,78550,76540,76540,77610,-2780,-1710,78,605.41,412
,20160711,76540,77610,77940,79590,77640,79590,78270,1980,660,26,203.51,404
,20160712,79590,78270,80760,80760,79780,80500,80120,2230,1850,10,80.13,406
,20160713,80500,80120,82050,83080,80220,80220,82460,100,2340,38,313.35,420
,20160714,80220,82460,81230,82980,80250,82980,81670,520,-790,208,"1,698.80",422
,20160715,82980,81670,82160,82260,80740,81440,81750,-230,80,110,899.29,406
,20160718,81440,81750,82140,82860,80110,81450,81550,-300,-200,200,"1,631.05",436
,20160719,81450,81550,82000,83990,81510,82400,82260,850,710,286,"2,352.79",490
,20160720,82400,82260,,,,82260,82260,0,0,0,0.00,490
,20160721,82260,82260,81870,82610,81340,82460,82320,200,60,34,279.90,484
,20160722,82460,82320,83900,84240,81660,81660,83280,-660,960,104,866.19,476
,20160725,81660,83280,82660,82660,80520,80530,81840,-2750,-1440,146,"1,194.97",418
,20160726,80530,81840,80530,81380,79060,79730,80550,-2110,-1290,164,"1,321.08",416
,20160727,79730,80550,79950,80900,79510,79710,80410,-840,-140,78,627.27,394
,20160728,79710,80410,80020,81750,80020,81750,81430,1340,1020,88,716.59,358
,20160729,81750,81430,81840,82180,80610,80850,81650,-580,220,98,800.23,360
,20160801,80850,81650,80760,82920,80760,82450,81390,800,-260,66,537.19,354
,20160802,82450,81390,82500,83510,82010,83500,82410,2110,1020,78,642.82,374
,20160803,83500,82410,83770,84000,82240,82280,82860,-130,450,206,"1,707.06",404
,20160804,82280,82860,82560,83350,80600,81860,81930,-1000,-930,224,"1,835.37",338
,20160805,81860,81930,81200,81560,80920,81530,81240,-400,-690,78,633.68,328
,20160808,81530,81240,81380,83230,81210,83030,82440,1790,1200,48,395.72,330
,20160809,83030,82440,83380,83470,81930,82250,82510,-190,70,246,"2,029.93",358
,20160810,82250,82510,82430,83080,81950,82500,82600,-10,90,48,396.49,350
,20160811,82500,82600,83200,84570,82110,82460,83270,-140,670,242,"2,015.35",336
,20160812,82460,83270,82030,82590,81500,81500,82030,-1770,-1240,48,393.77,328
,20160815,81500,82030,81000,81450,79320,79640,80850,-2390,-1180,280,"2,263.86",366
,20160816,79640,80850,80200,80630,80190,80630,80250,-220,-600,46,369.17,362
,20160817,80630,80250,80130,80390,80130,80150,80200,-100,-50,20,160.42,362
,20160818,80150,80200,79710,80540,79100,79950,80090,-250,-110,68,544.67,360
,20160819,79950,80090,79950,80530,79950,80300,80190,210,100,28,224.54,366
,20160822,80300,80190,80110,80820,79440,79440,80490,-750,300,58,466.86,368
,20160823,79440,80490,79550,80200,79410,79830,79990,-660,-500,74,591.93,396
,20160824,79830,79990,80090,80210,79650,79680,79830,-310,-160,86,686.58,416
,20160825,79680,79830,79860,79920,76310,77210,77440,-2620,-2390,172,"1,332.03",466
,20160826,77210,77440,77680,77680,76990,77280,77300,-160,-140,64,494.73,466
,20160829,77280,77300,77030,77730,77030,77460,77320,160,20,66,510.36,482
,20160830,77460,77320,77390,77620,76860,76870,77290,-450,-30,86,664.70,504
,20160831,76870,77290,77060,77390,77030,77030,77240,-260,-50,92,710.63,500
,20160901,77030,77240,77260,77850,77180,77620,77450,380,210,78,604.14,488
,20160902,77620,77450,78610,78800,78210,78540,78620,1090,1170,116,912.01,454
,20160905,78540,78620,79300,79300,78790,79080,78970,460,350,68,537.01,462
,20160906,79080,78970,78890,79740,78890,79620,79280,650,310,50,396.44,466
,20160907,79620,79280,79380,79820,79210,79810,79500,530,220,76,604.25,466
,20160908,79810,79500,80100,80110,79530,79700,79950,200,450,76,607.66,468
,20160909,79700,79950,79940,80200,79860,80150,80050,200,100,44,352.22,472
,20160912,80150,80050,80120,80120,77920,77920,78900,-2130,-1150,74,583.93,514
,20160913,77920,78900,78400,78400,78190,78190,78290,-710,-610,4,31.32,514
,20160914,78190,78290,78000,78000,78000,78000,78000,-290,-290,2,15.60,514
,20160919,78000,78000,77640,78000,77640,78000,77920,0,-80,12,93.51,514
,20160920,78000,77920,78290,79400,78290,79400,79080,1480,1160,36,284.70,498
,20160921,79400,79080,79260,80100,79000,79240,79340,160,260,150,"1,190.11",482
,20160922,79240,79340,79840,81110,75750,81110,79850,1770,510,84,670.78,436
,20160923,81110,79850,81140,81300,80520,81260,80790,1410,940,64,517.06,400
,20160926,81260,80790,81540,81540,80240,80300,80680,-490,-110,42,338.86,380
,20160927,80300,80680,79800,80830,79200,80830,79640,150,-1040,32,254.87,368
,20160928,80830,79640,82010,82010,80480,80610,80820,970,1180,28,226.31,356
,20160929,80610,80820,80490,82500,80150,82000,81140,1180,320,200,"1,622.98",336
,20160930,82000,81140,79040,81980,77650,81980,81030,840,-110,150,"1,215.53",444
,20161010,81980,81030,79600,80350,79600,80350,79940,-680,-1090,48,383.72,420
,20161011,80350,79940,82500,82500,82500,82500,82500,2560,2560,48,396.00,372
,20161012,82500,82500,,,,82500,82500,0,0,0,0.00,372
,20161013,82500,82500,81000,81100,80600,80600,80720,-1900,-1780,84,678.12,372
,20161014,80600,80720,81600,81600,80200,80200,81360,-520,640,72,585.84,336
,20161017,80200,81360,,,,81360,81360,0,0,0,0.00,336
ni1611,20160104,71860,71860,71390,71390,71390,71390,71390,-470,-470,2,14.28,136
,20160105,71390,71390,,,,71390,71390,0,0,0,0.00,136
,20160106,71390,71390,,,,71140,71140,-250,-250,0,0.00,136
,20160107,71140,71140,,,,70540,70540,-600,-600,0,0.00,136
,20160108,70540,70540,,,,69710,69710,-830,-830,0,0.00,136
,20160111,69710,69710,,,,69710,69710,0,0,0,0.00,136
,20160112,69710,69710,,,,68550,68550,-1160,-1160,0,0.00,136
,20160113,68550,68550,68100,68100,68100,68100,68100,-450,-450,2,13.62,136
,20160114,68100,68100,,,,68380,68380,280,280,0,0.00,136
,20160115,68380,68380,,,,70010,70010,1630,1630,0,0.00,136
,20160118,70010,70010,,,,70430,70430,420,420,0,0.00,136
,20160119,70430,70430,71710,72130,71710,72130,71920,1700,1490,4,28.77,134
,20160120,72130,71920,72240,72240,70170,70170,71200,-1750,-720,20,142.41,136
,20160121,70170,71200,,,,70990,70990,-210,-210,0,0.00,136
,20160122,70990,70990,,,,71740,71740,750,750,0,0.00,136
,20160125,71740,71740,,,,71900,71900,160,160,0,0.00,136
,20160126,71900,71900,,,,71050,71050,-850,-850,0,0.00,136
,20160127,71050,71050,,,,72090,72090,1040,1040,0,0.00,136
,20160128,72090,72090,,,,72100,72100,10,10,0,0.00,136
,20160129,72100,72100,71940,71940,71940,71940,71940,-160,-160,4,28.78,132
,20160201,71940,71940,,,,71660,71660,-280,-280,0,0.00,132
,20160202,71660,71660,,,,71090,71090,-570,-570,0,0.00,132
,20160203,71090,71090,,,,70890,70890,-200,-200,0,0.00,132
,20160204,70890,70890,,,,71700,71700,810,810,0,0.00,132
,20160205,71700,71700,,,,71250,71250,-450,-450,0,0.00,132
,20160215,71250,71250,,,,67890,67890,-3360,-3360,0,0.00,132
,20160216,67890,67890,,,,68680,68680,790,790,0,0.00,132
,20160217,68680,68680,,,,68590,68590,-90,-90,0,0.00,132
,20160218,68590,68590,,,,68880,68880,290,290,0,0.00,132
,20160219,68880,68880,,,,69100,69100,220,220,0,0.00,132
,20160222,69100,69100,,,,70280,70280,1180,1180,0,0.00,132
,20160223,70280,70280,,,,71340,71340,1060,1060,0,0.00,132
,20160224,71340,71340,,,,70800,70800,-540,-540,0,0.00,132
,20160225,70800,70800,,,,70590,70590,-210,-210,0,0.00,132
,20160226,70590,70590,,,,69370,69370,-1220,-1220,0,0.00,132
,20160229,69370,69370,,,,69590,69590,220,220,0,0.00,132
,20160301,69590,69590,,,,69530,69530,-60,-60,0,0.00,132
,20160302,69530,69530,,,,69530,69530,0,0,0,0.00,132
,20160303,69530,69530,,,,70160,70160,630,630,0,0.00,132
,20160304,70160,70160,71730,72660,71730,72660,72510,2500,2350,14,101.52,142
,20160307,72660,72510,74410,74750,74200,74750,74270,2240,1760,36,267.39,166
,20160308,74750,74270,75720,75720,72010,72730,73820,-1540,-450,14,103.35,164
,20160309,72730,73820,,,,70540,70540,-3280,-3280,0,0.00,164
,20160310,70540,70540,,,,70200,70200,-340,-340,0,0.00,164
,20160311,70200,70200,,,,70120,70120,-80,-80,0,0.00,164
,20160314,70120,70120,,,,70270,70270,150,150,0,0.00,164
,20160315,70270,70270,,,,69150,69150,-1120,-1120,0,0.00,164
,20160316,69150,69150,,,,67840,67840,-1310,-1310,0,0.00,164
,20160317,67840,67840,,,,68250,68250,410,410,0,0.00,164
,20160318,68250,68250,71110,71650,71090,71650,71230,3400,2980,12,85.49,170
,20160321,71650,71230,,,,71230,71230,0,0,0,0.00,170
,20160322,71230,71230,,,,71360,71360,130,130,0,0.00,170
,20160323,71360,71360,,,,71360,71360,0,0,0,0.00,170
,20160324,71360,71360,,,,70090,70090,-1270,-1270,0,0.00,170
,20160325,70090,70090,,,,70230,70230,140,140,0,0.00,170
,20160328,70230,70230,,,,69980,69980,-250,-250,0,0.00,170
,20160329,69980,69980,69980,70420,69080,70400,69820,420,-160,12,83.79,166
,20160330,70400,69820,,,,69020,69020,-800,-800,0,0.00,166
,20160331,69020,69020,,,,68120,68120,-900,-900,0,0.00,166
,20160401,68120,68120,,,,67950,67950,-170,-170,0,0.00,166
,20160405,67950,67950,,,,67240,67240,-710,-710,0,0.00,166
,20160406,67240,67240,67330,67420,67330,67420,67370,180,130,4,26.95,170
,20160407,67420,67370,68190,68190,68190,68190,68190,820,820,2,13.64,170
,20160408,68190,68190,,,,67260,67260,-930,-930,0,0.00,170
,20160411,67260,67260,,,,68500,68500,1240,1240,0,0.00,170
,20160412,68500,68500,68140,68520,68140,68520,68260,20,-240,12,81.92,168
,20160413,68520,68260,69480,71440,69480,71440,70460,3180,2200,4,28.18,166
,20160414,71440,70460,71520,71570,71520,71570,71550,1110,1090,6,42.93,164
,20160415,71570,71550,72170,72170,70370,70370,71500,-1180,-50,10,71.50,164
,20160418,70370,71500,,,,71500,71500,0,0,0,0.00,164
,20160419,71500,71500,,,,71500,71500,0,0,0,0.00,164
,20160420,71500,71500,72100,72100,71540,71540,71960,40,460,8,57.57,160
,20160421,71540,71960,73300,73300,73300,73300,73300,1340,1340,2,14.66,158
,20160422,73300,73300,71880,71980,71870,71980,71910,-1320,-1390,6,43.15,160
,20160425,71980,71910,71890,72180,71890,72180,71960,270,50,8,57.57,166
,20160426,72180,71960,,,,71960,71960,0,0,0,0.00,166
,20160427,71960,71960,72050,72200,72050,72200,72080,240,120,8,57.67,158
,20160428,72200,72080,73150,73150,73150,73150,73150,1070,1070,2,14.63,158
,20160429,73150,73150,73590,74140,72860,72860,73290,-290,140,16,117.27,160
,20160503,72860,73290,74100,77350,74100,76430,76450,3140,3160,28,214.07,164
,20160504,76430,76450,76100,76750,74890,75260,75830,-1190,-620,16,121.33,164
,20160505,75260,75830,,,,75830,75830,0,0,0,0.00,164
,20160506,75830,75830,71360,71380,71360,71380,71370,-4450,-4460,4,28.55,164
,20160509,71380,71370,,,,69860,69860,-1510,-1510,0,0.00,164
,20160510,69860,69860,,,,69860,69860,0,0,0,0.00,164
,20160511,69860,69860,,,,69860,69860,0,0,0,0.00,164
,20160512,69860,69860,70550,70800,70000,70800,70350,940,490,24,168.85,164
,20160513,70800,70350,69360,69360,68250,68930,68840,-1420,-1510,6,41.31,162
,20160516,68930,68840,,,,68680,68680,-160,-160,0,0.00,162
,20160517,68680,68680,69900,69900,68600,68600,69570,-80,890,8,55.66,160
,20160518,68600,69570,70330,70330,70330,70330,70330,760,760,2,14.07,160
,20160519,70330,70330,69040,69040,69040,69040,69040,-1290,-1290,2,13.81,158
,20160520,69040,69040,,,,69040,69040,0,0,0,0.00,158
,20160523,69040,69040,68040,68040,67490,67490,67760,-1550,-1280,4,27.11,162
,20160524,67490,67760,,,,67420,67420,-340,-340,0,0.00,162
,20160525,67420,67420,67420,67420,67420,67420,67420,0,0,4,26.97,158
,20160526,67420,67420,,,,67270,67270,-150,-150,0,0.00,158
,20160527,67270,67270,,,,67410,67410,140,140,0,0.00,158
,20160530,67410,67410,,,,67410,67410,0,0,0,0.00,158
,20160531,67410,67410,68990,68990,68990,68990,68990,1580,1580,4,27.60,160
,20160601,68990,68990,68710,68710,67020,67020,67860,-1970,-1130,4,27.15,160
,20160602,67020,67860,67670,67670,67670,67670,67670,-190,-190,2,13.53,158
,20160603,67670,67670,68080,68080,68080,68080,68080,410,410,2,13.62,158
,20160606,68080,68080,,,,68080,68080,0,0,0,0.00,158
,20160607,68080,68080,69740,70190,69010,69010,69460,930,1380,14,97.25,160
,20160608,69010,69460,,,,69460,69460,0,0,0,0.00,160
,20160613,69460,69460,70720,70720,70720,70720,70720,1260,1260,2,14.14,160
,20160614,70720,70720,70930,71440,70540,70540,70890,-180,170,32,226.87,172
,20160615,70540,70890,,,,70890,70890,0,0,0,0.00,172
,20160616,70890,70890,72120,72120,72120,72120,72120,1230,1230,2,14.42,174
,20160617,72120,72120,71210,71210,70340,71100,70870,-1020,-1250,12,85.04,172
,20160620,71100,70870,71710,73060,71710,73060,72380,2190,1510,4,28.95,174
,20160621,73060,72380,,,,72380,72380,0,0,0,0.00,174
,20160622,72380,72380,71940,72690,71940,72580,72360,200,-20,28,202.63,172
,20160623,72580,72360,72680,72680,72430,72440,72530,80,170,14,101.55,174
,20160624,72440,72530,71150,71150,71150,71150,71150,-1380,-1380,8,56.92,174
,20160627,71150,71150,71320,72320,71320,72290,72070,1140,920,56,403.63,216
,20160628,72290,72070,72370,73470,72330,73470,72530,1400,460,20,145.07,216
,20160629,73470,72530,,,,72530,72530,0,0,0,0.00,216
,20160630,72530,72530,75640,75640,75640,75640,75640,3110,3110,4,30.26,218
,20160701,75640,75640,75410,76520,75340,76400,75730,760,90,12,90.88,214
,20160704,76400,75730,77000,80270,76790,80270,78010,4540,2280,52,405.66,210
,20160705,80270,78010,81990,82690,81370,81370,82360,3360,4350,24,197.67,200
,20160706,81370,82360,81320,81320,77410,78850,78110,-3510,-4250,34,265.59,218
,20160707,78850,78110,78490,81150,78110,78150,79560,40,1450,60,477.36,242
,20160708,78150,79560,79170,79170,76000,77190,78590,-2370,-970,324,"2,546.32",272
,20160711,77190,78590,78240,80390,78000,80390,78620,1800,30,22,172.98,258
,20160712,80390,78620,80780,81120,80230,81120,80730,2500,2110,16,129.17,250
,20160713,81120,80730,82000,84690,81960,81960,82800,1230,2070,16,132.48,252
,20160714,81960,82800,82230,82230,80960,82010,81840,-790,-960,16,130.95,254
,20160715,82010,81840,,,,81840,81840,0,0,0,0.00,254
,20160718,81840,81840,,,,81840,81840,0,0,0,0.00,254
,20160719,81840,81840,82210,82210,82210,82210,82210,370,370,6,49.33,248
,20160720,82210,82210,82010,82290,82010,82290,82190,80,-20,6,49.32,246
,20160721,82290,82190,81760,83630,81360,83230,82760,1040,570,28,231.74,232
,20160722,83230,82760,83830,85370,82450,82450,83530,-310,770,30,250.59,220
,20160725,82450,83530,82380,82380,82380,82380,82380,-1150,-1150,2,16.48,220
,20160726,82380,82380,80750,80750,80750,80750,80750,-1630,-1630,2,16.15,222
,20160727,80750,80750,81030,81050,81010,81010,81020,260,270,14,113.43,212
,20160728,81010,81020,,,,81020,81020,0,0,0,0.00,212
,20160729,81020,81020,81420,81420,81330,81330,81390,310,370,6,48.83,206
,20160801,81330,81390,,,,81390,81390,0,0,0,0.00,206
,20160802,81390,81390,83220,84330,83220,83770,83720,2380,2330,14,117.21,212
,20160803,83770,83720,84420,84420,84110,84110,84270,390,550,8,67.42,220
,20160804,84110,84270,82970,82970,81580,81580,82270,-2690,-2000,16,131.64,218
,20160805,81580,82270,82330,82330,81840,81840,82030,-430,-240,6,49.22,218
,20160808,81840,82030,,,,82030,82030,0,0,0,0.00,218
,20160809,82030,82030,,,,82030,82030,0,0,0,0.00,218
,20160810,82030,82030,,,,82030,82030,0,0,0,0.00,218
,20160811,82030,82030,82890,83200,81990,83080,82660,1050,630,212,"1,752.52",258
,20160812,83080,82660,82590,83090,82230,82230,82760,-430,100,46,380.70,224
,20160815,82230,82760,81710,81710,80700,80880,81020,-1880,-1740,38,307.90,238
,20160816,80880,81020,81340,81340,80910,80910,81060,-110,40,12,97.28,238
,20160817,80910,81060,80360,80920,80360,80500,80510,-560,-550,12,96.62,240
,20160818,80500,80510,80230,80360,79530,79960,80120,-550,-390,14,112.17,246
,20160819,79960,80120,80710,80850,80300,80340,80650,220,530,36,290.36,244
,20160822,80340,80650,,,,80650,80650,0,0,0,0.00,244
,20160823,80650,80650,80430,80500,80430,80500,80440,-150,-210,8,64.36,236
,20160824,80500,80440,,,,80440,80440,0,0,0,0.00,236
,20160825,80440,80440,77400,77950,76800,77950,77380,-2490,-3060,6,46.43,238
,20160826,77950,77380,,,,77380,77380,0,0,0,0.00,238
,20160829,77380,77380,,,,77380,77380,0,0,0,0.00,238
,20160830,77380,77380,78310,78310,77140,77470,77730,90,350,106,823.98,276
,20160831,77470,77730,77560,77710,77560,77690,77610,-40,-120,32,248.37,270
,20160901,77690,77610,78090,78400,78090,78200,78230,590,620,16,125.17,274
,20160902,78200,78230,79010,79010,79010,79010,79010,780,780,2,15.80,276
,20160905,79010,79010,79820,79820,79170,79420,79450,410,440,32,254.24,298
,20160906,79420,79450,79520,80150,79520,80150,80010,700,560,82,656.09,342
,20160907,80150,80010,80910,80910,79190,80260,80130,250,120,56,448.74,348
,20160908,80260,80130,80470,80490,80020,80460,80210,330,80,18,144.38,352
,20160909,80460,80210,80190,80530,80190,80340,80370,130,160,92,739.47,336
,20160912,80340,80370,80300,80300,78700,78700,79080,-1670,-1290,12,94.90,330
,20160913,78700,79080,,,,78790,78790,-290,-290,0,0.00,330
,20160914,78790,78790,77590,77590,77580,77580,77580,-1210,-1210,4,31.03,334
,20160919,77580,77580,78100,78200,78100,78160,78150,580,570,44,343.90,292
,20160920,78160,78150,78730,79660,78680,78680,78950,530,800,8,63.16,294
,20160921,78680,78950,79590,79590,79400,79540,79480,590,530,14,111.28,292
,20160922,79540,79480,79930,81830,79930,80630,80610,1150,1130,52,419.19,280
,20160923,80630,80610,81280,82020,81050,81050,81450,440,840,6,48.87,278
,20160926,81050,81450,81470,81890,80380,80380,81210,-1070,-240,178,"1,445.63",284
,20160927,80380,81210,80940,81200,79900,81200,80590,-10,-620,18,145.06,274
,20160928,81200,80590,81200,81530,81190,81530,81230,940,640,48,389.93,270
,20160929,81530,81230,81230,82340,80800,80800,81420,-430,190,36,293.12,254
,20160930,80800,81420,80260,80590,80230,80430,80330,-990,-1090,54,433.82,254
,20161010,80430,80330,,,,80580,80580,250,250,0,0.00,254
,20161011,80580,80580,81860,81920,81860,81920,81870,1340,1290,10,81.87,254
,20161012,81920,81870,81450,81450,81200,81200,81360,-670,-510,6,48.82,252
,20161013,81200,81360,81160,81160,81160,81160,81160,-200,-200,4,32.46,252
,20161014,81160,81160,,,,81160,81160,0,0,0,0.00,252
,20161017,81160,81160,81140,81600,81010,81600,81220,440,60,14,113.71,252
,20161018,81600,81220,,,,81220,81220,0,0,0,0.00,252
,20161019,81220,81220,80000,80000,79950,79960,79980,-1260,-1240,20,159.96,256
,20161020,79960,79980,79930,79930,79930,79930,79930,-50,-50,2,15.99,256
,20161021,79930,79930,79500,79520,79000,79290,79330,-640,-600,190,"1,507.45",406
,20161024,79290,79330,78960,80260,78960,79660,79720,330,390,192,"1,530.75",366
,20161025,79660,79720,81480,81480,81480,81480,81480,1760,1760,2,16.30,366
,20161026,81480,81480,81600,81600,80570,80570,81220,-910,-260,178,"1,445.72",486
,20161027,80570,81220,80930,80930,80800,80800,80860,-420,-360,4,32.35,486
,20161028,80800,80860,80980,82350,80960,81500,81390,640,530,154,"1,253.55",450
,20161031,81500,81390,80170,83500,80170,83500,82000,2110,610,292,"2,394.68",636
,20161101,83500,82000,,,,82000,82000,0,0,0,0.00,636
,20161102,82000,82000,,,,82000,82000,0,0,0,0.00,636
,20161103,82000,82000,,,,82000,82000,0,0,0,0.00,636
,20161104,82000,82000,,,,82000,82000,0,0,0,0.00,636
,20161107,82000,82000,86600,86920,86600,86920,86760,4920,4760,24,208.22,624
,20161108,86920,86760,,,,87000,87000,240,240,0,0.00,624
,20161109,87000,87000,90000,90000,88500,88500,88750,1500,1750,72,639.00,684
,20161110,88500,88750,94070,94070,94070,94070,94070,5320,5320,12,112.88,684
,20161111,94070,94070,95600,95600,95600,95600,95600,1530,1530,84,803.04,684
,20161114,95600,95600,91000,91000,90000,90000,90750,-5600,-4850,48,435.60,696
,20161115,90000,90750,90500,92980,90500,92900,92510,2150,1760,72,666.10,756
ni1612,20160104,72760,72740,,,,72740,72740,0,0,0,0.00,20
,20160105,72740,72740,,,,72740,72740,0,0,0,0.00,20
,20160106,72740,72740,,,,72740,72740,0,0,0,0.00,20
,20160107,72740,72740,,,,72740,72740,0,0,0,0.00,20
,20160108,72740,72740,,,,72740,72740,0,0,0,0.00,20
,20160111,72740,72740,,,,73010,73010,270,270,0,0.00,20
,20160112,73010,73010,,,,71800,71800,-1210,-1210,0,0.00,20
,20160113,71800,71800,,,,71800,71800,0,0,0,0.00,20
,20160114,71800,71800,,,,72100,72100,300,300,0,0.00,20
,20160115,72100,72100,,,,73820,73820,1720,1720,0,0.00,20
,20160118,73820,73820,,,,74270,74270,450,450,0,0.00,20
,20160119,74270,74270,,,,75840,75840,1570,1570,0,0.00,20
,20160120,75840,75840,,,,75080,75080,-760,-760,0,0.00,20
,20160121,75080,75080,,,,74860,74860,-220,-220,0,0.00,20
,20160122,74860,74860,,,,75650,75650,790,790,0,0.00,20
,20160125,75650,75650,,,,75650,75650,0,0,0,0.00,20
,20160126,75650,75650,,,,75650,75650,0,0,0,0.00,20
,20160127,75650,75650,,,,76760,76760,1110,1110,0,0.00,20
,20160128,76760,76760,,,,76770,76770,10,10,0,0.00,20
,20160129,76770,76770,72160,72960,72160,72160,72560,-4610,-4210,16,116.10,28
,20160201,72160,72560,71880,71880,71740,71740,71800,-820,-760,22,157.98,14
,20160202,71740,71800,,,,71230,71230,-570,-570,0,0.00,14
,20160203,71230,71230,,,,71030,71030,-200,-200,0,0.00,14
,20160204,71030,71030,,,,71840,71840,810,810,0,0.00,14
,20160205,71840,71840,,,,71390,71390,-450,-450,0,0.00,14
,20160215,71390,71390,,,,68020,68020,-3370,-3370,0,0.00,14
,20160216,68020,68020,67770,67770,67770,67770,67770,-250,-250,2,13.55,16
,20160217,67770,67770,,,,67680,67680,-90,-90,0,0.00,16
,20160218,67680,67680,,,,67960,67960,280,280,0,0.00,16
,20160219,67960,67960,68750,68750,68750,68750,68750,790,790,2,13.75,16
,20160222,68750,68750,,,,69920,69920,1170,1170,0,0.00,16
,20160223,69920,69920,,,,70970,70970,1050,1050,0,0.00,16
,20160224,70970,70970,,,,70970,70970,0,0,0,0.00,16
,20160225,70970,70970,71500,71500,70260,70260,70670,-710,-300,6,42.40,22
,20160226,70260,70670,,,,69450,69450,-1220,-1220,0,0.00,22
,20160229,69450,69450,,,,69670,69670,220,220,0,0.00,22
,20160301,69670,69670,,,,69670,69670,0,0,0,0.00,22
,20160302,69670,69670,,,,70950,70950,1280,1280,0,0.00,22
,20160303,70950,70950,,,,71590,71590,640,640,0,0.00,22
,20160304,71590,71590,72330,72330,72330,72330,72330,740,740,8,57.86,22
,20160307,72330,72330,73480,75300,73480,75300,74390,2970,2060,4,29.76,22
,20160308,75300,74390,,,,73940,73940,-450,-450,0,0.00,22
,20160309,73940,73940,,,,70650,70650,-3290,-3290,0,0.00,22
,20160310,70650,70650,,,,70310,70310,-340,-340,0,0.00,22
,20160311,70310,70310,,,,70230,70230,-80,-80,0,0.00,22
,20160314,70230,70230,,,,70380,70380,150,150,0,0.00,22
,20160315,70380,70380,70560,70560,70560,70560,70560,180,180,10,70.56,32
,20160316,70560,70560,70060,70260,70060,70120,70090,-440,-470,18,126.17,44
,20160317,70120,70090,70330,70820,70330,70820,70740,730,650,38,268.82,82
,20160318,70820,70740,71210,71710,71210,71710,71460,970,720,4,28.58,86
,20160321,71710,71460,,,,71420,71420,-40,-40,0,0.00,86
,20160322,71420,71420,70700,71360,70700,71170,71100,-250,-320,8,56.88,92
,20160323,71170,71100,,,,71160,71160,60,60,0,0.00,92
,20160324,71160,71160,,,,69890,69890,-1270,-1270,0,0.00,92
,20160325,69890,69890,,,,70030,70030,140,140,0,0.00,92
,20160328,70030,70030,69840,71060,69840,71060,70450,1030,420,4,28.18,94
,20160329,71060,70450,,,,70290,70290,-160,-160,0,0.00,94
,20160330,70290,70290,,,,69490,69490,-800,-800,0,0.00,94
,20160331,69490,69490,69320,69320,69040,69100,69120,-390,-370,8,55.30,100
,20160401,69100,69120,,,,68940,68940,-180,-180,0,0.00,100
,20160405,68940,68940,,,,68220,68220,-720,-720,0,0.00,100
,20160406,68220,68220,68220,68220,68220,68220,68220,0,0,2,13.64,102
,20160407,68220,68220,69140,69280,69140,69280,69240,1060,1020,8,55.40,104
,20160408,69280,69240,68380,68490,67430,68120,67680,-1120,-1560,140,947.61,64
,20160411,68120,67680,69050,69500,69050,69500,69200,1820,1520,6,41.52,60
,20160412,69500,69200,69640,69830,68950,69230,69530,30,330,44,305.96,68
,20160413,69230,69530,70030,72000,69960,72000,70410,2470,880,34,239.43,54
,20160414,72000,70410,,,,70410,70410,0,0,0,0.00,54
,20160415,70410,70410,72010,72300,72010,72200,72210,1790,1800,12,86.66,54
,20160418,72200,72210,,,,72210,72210,0,0,0,0.00,54
,20160419,72210,72210,72520,72820,72510,72560,72570,350,360,12,87.09,62
,20160420,72560,72570,73220,73220,73220,73220,73220,650,650,4,29.29,58
,20160421,73220,73220,73290,74660,73290,74660,74390,1440,1170,12,89.28,70
,20160422,74660,74390,73790,73790,71950,72600,72380,-1790,-2010,22,159.25,70
,20160425,72600,72380,72880,72880,72190,72190,72530,-190,150,4,29.01,66
,20160426,72190,72530,72950,72950,72220,72220,72910,-310,380,42,306.24,108
,20160427,72220,72910,72850,72850,72850,72850,72850,-60,-60,2,14.57,110
,20160428,72850,72850,73250,73270,72480,72480,73230,-370,380,132,966.67,230
,20160429,72480,73230,73020,73290,73020,73290,73260,60,30,124,908.53,114
,20160503,73290,73260,73590,75920,73590,75920,74250,2660,990,24,178.22,138
,20160504,75920,74250,76880,76880,74780,75360,75230,1110,980,56,421.34,146
,20160505,75360,75230,75990,75990,74600,74920,75210,-310,-20,458,"3,444.73",160
,20160506,74920,75210,73750,73750,71200,71200,72610,-4010,-2600,18,130.71,158
,20160509,71200,72610,71740,72320,70000,70300,70610,-2310,-2000,32,225.97,158
,20160510,70300,70610,,,,70610,70610,0,0,0,0.00,158
,20160511,70610,70610,70220,70490,70220,70390,70360,-220,-250,6,42.22,162
,20160512,70390,70360,,,,70360,70360,0,0,0,0.00,162
,20160513,70360,70360,70830,70830,69140,69140,69890,-1220,-470,18,125.80,164
,20160516,69140,69890,69140,69140,69140,69140,69140,-750,-750,2,13.83,164
,20160517,69140,69140,,,,70040,70040,900,900,0,0.00,164
,20160518,70040,70040,69860,69860,69860,69860,69860,-180,-180,2,13.97,164
,20160519,69860,69860,,,,69860,69860,0,0,0,0.00,164
,20160520,69860,69860,,,,69860,69860,0,0,0,0.00,164
,20160523,69860,69860,67880,68320,67880,68230,68140,-1630,-1720,6,40.89,164
,20160524,68230,68140,67590,68220,67430,68220,67680,80,-460,10,67.68,162
,20160525,68220,67680,68330,68330,68330,68330,68330,650,650,2,13.67,162
,20160526,68330,68330,68490,68540,67920,68350,68320,20,-10,34,232.31,178
,20160527,68350,68320,,,,68320,68320,0,0,0,0.00,178
,20160530,68320,68320,68350,68450,67790,67970,68040,-350,-280,40,272.19,182
,20160531,67970,68040,68590,68590,68470,68480,68510,440,470,12,82.22,176
,20160601,68480,68510,69030,69030,67800,67800,68620,-710,110,12,82.35,174
,20160602,67800,68620,67940,68760,67820,68330,68180,-290,-440,14,95.46,178
,20160603,68330,68180,68360,68800,68360,68610,68530,430,350,8,54.83,180
,20160606,68610,68530,69720,69720,69620,69620,69680,1090,1150,6,41.81,174
,20160607,69620,69680,70250,70250,70250,70250,70250,570,570,2,14.05,174
,20160608,70250,70250,69460,70840,69460,70840,70440,590,190,10,70.44,178
,20160613,70840,70440,,,,70440,70440,0,0,0,0.00,178
,20160614,70440,70440,71030,71030,71030,71030,71030,590,590,6,42.62,172
,20160615,71030,71030,,,,71030,71030,0,0,0,0.00,172
,20160616,71030,71030,72800,72800,71680,71680,72250,650,1220,46,332.38,164
,20160617,71680,72250,71640,71780,71640,71650,71710,-600,-540,22,157.78,172
,20160620,71650,71710,72480,73850,72360,73250,73300,1540,1590,32,234.59,164
,20160621,73250,73300,73590,74060,73590,73620,73750,320,450,6,44.25,164
,20160622,73620,73750,72790,73460,72780,73460,73180,-290,-570,16,117.10,154
,20160623,73460,73180,74030,74030,72790,73060,73650,-120,470,118,869.16,152
,20160624,73060,73650,73050,73050,71500,71700,71790,-1950,-1860,12,86.16,156
,20160627,71700,71790,71810,72000,71800,72000,71980,210,190,92,662.24,226
,20160628,72000,71980,72590,72590,72590,72590,72590,610,610,82,595.24,170
,20160629,72590,72590,73800,73800,73570,73730,73660,1140,1070,8,58.93,172
,20160630,73730,73660,74910,76150,74790,76150,75340,2490,1680,26,195.91,170
,20160701,76150,75340,75850,77300,74350,77300,75780,1960,440,42,318.31,174
,20160704,77300,75780,78680,80320,78680,80310,79680,4530,3900,126,"1,004.02",218
,20160705,80310,79680,81820,83870,78400,79330,81960,-350,2280,46,377.06,210
,20160706,79330,81960,82790,83260,77330,78890,80110,-3070,-1850,284,"2,275.21",312
,20160707,78890,80110,78550,79220,77790,78980,78540,-1130,-1570,242,"1,900.70",386
,20160708,78980,78540,79090,80130,77620,78330,78520,-210,-20,664,"5,214.05",384
,20160711,78330,78520,79360,80850,78440,80590,80260,2070,1740,416,"3,339.06",458
,20160712,80590,80260,81070,81830,80530,81830,80710,1570,450,238,"1,921.03",348
,20160713,81830,80710,82480,84400,81530,81530,82510,820,1800,104,858.16,324
,20160714,81530,82510,80980,83550,80980,83010,81750,500,-760,22,179.86,312
,20160715,83010,81750,82010,82750,81240,81870,81950,120,200,24,196.69,308
,20160718,81870,81950,83040,83200,81340,82990,82340,1040,390,18,148.22,302
,20160719,82990,82340,81760,84500,81760,84410,83010,2070,670,42,348.65,290
,20160720,84410,83010,83020,83150,81210,83150,82700,140,-310,18,148.88,288
,20160721,83150,82700,82220,83450,81590,83310,82890,610,190,62,513.98,278
,20160722,83310,82890,84800,84800,83240,83240,84340,350,1450,20,168.68,260
,20160725,83240,84340,82260,82920,80990,81500,82230,-2840,-2110,54,444.07,244
,20160726,81500,82230,80220,81370,80150,80150,80520,-2080,-1710,40,322.09,240
,20160727,80150,80520,80320,81270,80310,80670,81000,150,480,22,178.21,224
,20160728,80670,81000,81340,82470,81330,82470,81900,1470,900,26,212.95,230
,20160729,82470,81900,81810,81810,81810,81810,81810,-90,-90,4,32.72,232
,20160801,81810,81810,81590,82090,81590,82090,81920,280,110,6,49.15,230
,20160802,82090,81920,83600,84450,83230,84210,83460,2290,1540,182,"1,518.99",372
,20160803,84210,83460,84700,84960,83500,83650,84040,190,580,40,336.19,376
,20160804,83650,84040,82600,83500,81360,81710,82460,-2330,-1580,164,"1,352.48",316
,20160805,81710,82460,81640,82520,81640,81970,82010,-490,-450,16,131.22,312
,20160808,81970,82010,83220,84150,83220,84150,83560,2140,1550,32,267.42,314
,20160809,84150,83560,83530,83530,83000,83240,83220,-320,-340,68,565.92,316
,20160810,83240,83220,,,,83630,83630,410,410,0,0.00,316
,20160811,83630,83630,84000,84490,82220,83300,83050,-330,-580,130,"1,079.76",310
,20160812,83300,83050,82900,83190,82770,82770,82910,-280,-140,14,116.08,312
,20160815,82770,82910,80670,80930,80640,80880,80760,-2030,-2150,32,258.45,304
,20160816,80880,80760,81350,81350,80940,80940,81030,180,270,14,113.44,306
,20160817,80940,81030,80450,80890,80170,80840,80550,-190,-480,14,112.77,310
,20160818,80840,80550,,,,80550,80550,0,0,0,0.00,310
,20160819,80550,80550,80990,81060,80820,80820,80960,270,410,16,129.55,310
,20160822,80820,80960,80870,81070,79970,79970,80790,-990,-170,20,161.59,314
,20160823,79970,80790,,,,80790,80790,0,0,0,0.00,314
,20160824,80790,80790,80790,80880,80440,80440,80710,-350,-80,22,177.57,316
,20160825,80440,80710,80170,80170,77330,78050,77860,-2660,-2850,296,"2,304.83",326
,20160826,78050,77860,77920,78300,77810,78070,78080,210,220,14,109.31,322
,20160829,78070,78080,78080,78420,78080,78420,78250,340,170,52,406.93,342
,20160830,78420,78250,78000,78350,78000,78350,78290,100,40,38,297.52,318
,20160831,78350,78290,78150,78150,77900,77900,77950,-390,-340,12,93.55,314
,20160901,77900,77950,77930,78750,77930,78550,78330,600,380,18,141.00,310
,20160902,78550,78330,78180,79700,78180,79280,79240,950,910,50,396.25,304
,20160905,79280,79240,79760,80180,79700,79820,79920,580,680,242,"1,934.23",424
,20160906,79820,79920,79820,80530,79000,80530,79880,610,-40,52,415.41,454
,20160907,80530,79880,80610,80610,80100,80370,80410,490,530,44,353.84,470
,20160908,80370,80410,80860,80860,80240,80600,80650,190,240,100,806.51,466
,20160909,80600,80650,80870,80870,80590,80680,80700,30,50,26,209.83,468
,20160912,80680,80700,79120,79470,78680,78680,79120,-2020,-1580,82,648.82,474
,20160913,78680,79120,78450,79150,78450,79150,78930,30,-190,60,473.59,486
,20160914,79150,78930,77870,78280,77870,78160,78100,-770,-830,6,46.86,486
,20160919,78160,78100,78500,78870,78460,78550,78600,450,500,28,220.09,478
,20160920,78550,78600,79070,79070,78950,78950,79040,350,440,10,79.04,474
,20160921,78950,79040,,,,79040,79040,0,0,0,0.00,474
,20160922,79040,79040,80930,80930,80930,80930,80930,1890,1890,8,64.74,466
,20160923,80930,80930,81250,81740,81250,81490,81430,560,500,48,390.90,466
,20160926,81490,81430,81950,82140,81300,81300,81610,-130,180,16,130.58,460
,20160927,81300,81610,81340,82180,81340,82180,81810,570,200,6,49.09,464
,20160928,82180,81810,82120,82120,81330,81600,81620,-210,-190,58,473.44,462
,20160929,81600,81620,81710,83090,81620,81620,82310,0,690,144,"1,185.34",526
,20160930,81620,82310,81170,81170,80650,80910,80790,-1400,-1520,142,"1,147.33",540
,20161010,80910,80790,81090,81090,81000,81000,81060,210,270,6,48.64,540
,20161011,81000,81060,81050,82490,81050,82490,81800,1430,740,30,245.42,542
,20161012,82490,81800,81950,82000,81410,82000,81660,200,-140,44,359.32,548
,20161013,82000,81660,82280,82550,81870,81870,82250,210,590,48,394.81,520
,20161014,81870,82250,81420,81420,81420,81420,81420,-830,-830,4,32.57,518
,20161017,81420,81420,81540,82000,81220,81400,81540,-20,120,240,"1,957.02",508
,20161018,81400,81540,80890,81000,80700,80980,80910,-560,-630,76,614.92,488
,20161019,80980,80910,81650,81650,81050,81050,81400,140,490,8,65.12,484
,20161020,81050,81400,80050,80590,80050,80440,80330,-960,-1070,12,96.40,476
,20161021,80440,80330,79470,79470,79470,79470,79470,-860,-860,6,47.68,470
,20161024,79470,79470,79550,80280,79550,80280,79940,810,470,8,63.95,466
,20161025,80280,79940,80750,81630,80750,81430,81270,1490,1330,6,48.76,468
,20161026,81430,81270,81580,81580,79800,80450,80560,-820,-710,28,225.59,468
,20161027,80450,80560,82220,82220,80170,80490,81130,-70,570,72,584.16,478
,20161028,80490,81130,81960,82140,81500,82140,81950,1010,820,1024,"8,392.10",548
,20161031,82140,81950,82010,82510,81500,82510,82080,560,130,486,"3,989.26",890
,20161101,82510,82080,83610,83610,82610,83140,82770,1060,690,78,645.62,884
,20161102,83140,82770,81770,81770,81770,81770,81770,-1000,-1000,12,98.12,896
,20161103,81770,81770,82240,83310,82240,83270,82540,1500,770,28,231.12,884
,20161104,83270,82540,83160,83200,82880,82880,83020,340,480,34,282.27,870
,20161107,82880,83020,83790,87150,83790,87150,86420,4130,3400,28,241.98,870
,20161108,87150,86420,87360,89300,86560,87750,87660,1330,1240,96,841.56,872
,20161109,87750,87660,89210,90870,89000,90140,89830,2480,2170,102,916.28,862
,20161110,90140,89830,92010,95210,92010,95210,95090,5380,5260,68,646.66,920
,20161111,95210,95090,94310,97220,93050,95710,94240,620,-850,60,565.47,918
,20161114,95710,94240,97110,97110,88580,91380,90840,-2860,-3400,130,"1,180.93",940
,20161115,91380,90840,90890,91320,90700,90880,91010,40,170,254,"2,311.71",944
,20161116,90880,91010,,,,91320,91320,310,310,0,0.00,944
,20161117,91320,91320,91560,91560,91050,91400,91390,80,70,60,548.36,942
,20161118,91400,91390,91450,91450,90130,90130,90540,-1260,-850,22,199.20,936
,20161121,90130,90540,90430,91000,88110,90770,88460,230,-2080,208,"1,840.05",1008
,20161122,90770,88460,91090,93450,91090,92700,92760,4240,4300,100,927.66,1012
,20161123,92700,92760,92700,92700,92000,92000,92280,-760,-480,64,590.62,972
,20161124,92000,92280,92210,95970,91660,93800,93440,1520,1160,68,635.39,986
,20161125,93800,93440,95000,95000,92540,94360,93720,920,280,182,"1,705.84",954
,20161128,94360,93720,92370,98590,92370,97000,96370,3280,2650,358,"3,450.13",984
,20161129,97000,96370,95500,96000,91120,92800,95150,-3570,-1220,88,837.32,1036
,20161130,92800,95150,92800,92800,91580,91580,91900,-3570,-3250,16,147.04,1044
,20161201,91580,91900,90000,90000,90000,90000,90000,-1900,-1900,48,432.00,1008
,20161202,90000,90000,90000,90200,89900,89900,89940,-100,-60,168,"1,511.04",996
,20161205,89900,89940,93790,93790,93150,93150,93200,3210,3260,132,"1,230.35",1128
,20161206,93150,93200,93050,93200,92800,93200,93060,0,-140,216,"2,010.30",1320
,20161207,93200,93060,94000,94700,91600,94700,93510,1640,450,612,"5,723.10",1848
,20161208,94700,93510,,,,93510,93510,0,0,0,0.00,1848
,20161209,93510,93510,92000,93500,92000,93300,93000,-210,-510,96,892.80,1944
,20161212,93300,93000,94000,94000,91350,92500,93480,-500,480,168,"1,570.62",2076
,20161213,92500,93480,93000,93300,93000,93300,93160,-180,-320,360,"3,354.00",2436
,20161214,93300,93160,94800,94800,93400,93400,93700,240,540,864,"8,095.68",2748
,20161215,93400,93700,93000,95000,92500,93900,93650,200,-50,564,"5,282.28",3084
ni1701,20160118,73820,73820,71040,72920,71040,72920,71450,-900,-2370,12,85.74,12
,20160119,72920,71450,72780,72800,71600,72420,72210,970,760,52,375.53,22
,20160120,72420,72210,71370,71870,71120,71120,71450,-1090,-760,6,42.87,24
,20160121,71120,71450,72110,72730,71030,71600,71810,150,360,24,172.35,32
,20160122,71600,71810,72740,74460,71770,72330,73210,520,1400,84,615.03,90
,20160125,72330,73210,,,,73210,73210,0,0,0,0.00,90
,20160126,73210,73210,71750,71800,71270,71500,71550,-1710,-1660,58,415.03,102
,20160127,71500,71550,72180,73370,71400,72800,72120,1250,570,86,620.31,148
,20160128,72800,72120,72800,72800,72600,72600,72680,480,560,8,58.15,150
,20160129,72600,72680,72010,72170,71620,71980,71930,-700,-750,40,287.75,172
,20160201,71980,71930,72040,72100,71020,71270,71580,-660,-350,38,272.04,184
,20160202,71270,71580,71090,71420,71070,71070,71170,-510,-410,16,113.88,180
,20160203,71070,71170,71220,71220,70450,71130,70880,-40,-290,46,326.07,182
,20160204,71130,70880,71010,71950,71010,71950,71590,1070,710,64,458.24,200
,20160205,71950,71590,71680,71930,70700,70840,71020,-750,-570,52,369.31,208
,20160215,70840,71020,68260,69030,67910,68380,68280,-2640,-2740,118,805.76,264
,20160216,68380,68280,69490,69490,68210,68690,68470,410,190,216,"1,479.10",412
,20160217,68690,68470,68560,68810,68210,68550,68440,80,-30,66,451.74,436
,20160218,68550,68440,68550,68960,68550,68600,68710,160,270,38,261.10,420
,20160219,68600,68710,68710,69420,68710,69390,69140,680,430,18,124.46,422
,20160222,69390,69140,69270,71180,69150,70800,70300,1660,1160,90,632.75,456
,20160223,70800,70300,71110,72090,70600,70740,71510,440,1210,190,"1,358.86",572
,20160224,70740,71510,71130,71150,70220,70830,70750,-680,-760,96,679.26,608
,20160225,70830,70750,70520,71540,69700,70070,70530,-680,-220,270,"1,904.37",750
,20160226,70070,70530,70110,70200,68880,69750,69570,-780,-960,240,"1,669.76",856
,20160229,69750,69570,69540,70350,68940,69140,69670,-430,100,132,919.74,868
,20160301,69140,69670,69390,70030,69000,70030,69220,360,-450,102,706.14,882
,20160302,70030,69220,70190,71210,70010,71130,70610,1910,1390,182,"1,285.15",910
,20160303,71130,70610,71460,71470,70780,71400,71270,790,660,186,"1,325.77",954
,20160304,71400,71270,71610,73660,71370,73400,72620,2130,1350,514,"3,732.79",1182
,20160307,73400,72620,73270,76100,73270,75260,75020,2640,2400,596,"4,471.58",1462
,20160308,75260,75020,75750,77920,70620,74000,75270,-1020,250,650,"4,892.70",1666
,20160309,74000,75270,73850,73850,70750,71390,71660,-3880,-3610,572,"4,099.06",1846
,20160310,71390,71660,72040,72540,70840,70840,71670,-820,10,308,"2,207.48",1880
,20160311,70840,71670,71300,72350,70850,71640,71520,-30,-150,220,"1,573.52",1850
,20160314,71640,71520,71890,72400,71350,71450,71830,-70,310,212,"1,522.91",1918
,20160315,71450,71830,71250,71390,70070,70570,70570,-1260,-1260,286,"2,018.43",1864
,20160316,70570,70570,70050,70290,69760,70240,70110,-330,-460,372,"2,608.16",2022
,20160317,70240,70110,69810,71080,69810,70820,70520,710,410,388,"2,736.26",2268
,20160318,70820,70520,71100,72620,70800,72330,71990,1810,1470,794,"5,716.15",2622
,20160321,72330,71990,72270,72300,70020,70400,70820,-1590,-1170,966,"6,842.01",2820
,20160322,70400,70820,71040,71500,70650,70790,71040,-30,220,824,"5,854.09",2968
,20160323,70790,71040,70770,71870,70500,70730,71200,-310,160,1004,"7,148.66",3352
,20160324,70730,71200,70730,70900,70080,70400,70420,-800,-780,760,"5,352.37",3462
,20160325,70400,70420,70300,70850,70290,70750,70590,330,170,776,"5,478.34",3736
,20160328,70750,70590,70900,71210,70230,70240,70780,-350,190,458,"3,241.76",3824
,20160329,70240,70780,70400,71060,70100,70480,70520,-300,-260,534,"3,765.77",3890
,20160330,70480,70520,70470,70470,68700,68870,69350,-1650,-1170,1022,"7,088.57",4302
,20160331,68870,69350,68870,69580,68350,68440,68850,-910,-500,748,"5,150.42",4582
,20160401,68440,68850,68530,69090,68320,68580,68670,-270,-180,1450,"9,958.59",4868
,20160405,68580,68670,68500,68520,67540,67850,67970,-820,-700,1258,"8,550.63",5112
,20160406,67850,67970,68240,68960,68060,68900,68610,930,640,806,"5,530.27",5226
,20160407,68900,68610,68860,69420,68860,69160,69160,550,550,722,"4,993.41",5158
,20160408,69160,69160,68960,68960,67700,68540,68330,-620,-830,778,"5,316.36",5408
,20160411,68540,68330,68910,69800,68860,69420,69380,1090,1050,1206,"8,367.32",5762
,20160412,69420,69380,69800,70100,69030,70100,69600,720,220,812,"5,652.18",5936
,20160413,70100,69600,70520,73100,69890,71690,71330,2090,1730,2442,"17,420.04",6338
,20160414,71690,71330,72230,72550,71450,71910,71930,580,600,1838,"13,221.82",6328
,20160415,71910,71930,72000,72300,71080,71290,71990,-640,60,5198,"37,425.00",8360
,20160418,71290,71990,71340,72390,70500,71800,71680,-190,-310,3374,"24,186.03",8878
,20160419,71800,71680,72370,72980,70630,71910,72470,230,790,11340,"82,187.62",13134
,20160420,71910,72470,72700,73580,71910,72710,73000,240,530,14766,"107,804.18",18920
,20160421,72710,73000,73500,74990,72610,74620,74180,1620,1180,28382,"210,542.02",32988
,20160422,74620,74180,75060,75450,71460,72790,73840,-1390,-340,22318,"164,809.55",37284
,20160425,72790,73840,73660,74600,71880,72980,72990,-860,-850,9742,"71,111.33",38378
,20160426,72980,72990,73100,73100,71610,72250,72490,-740,-500,10136,"73,484.78",41316
,20160427,72250,72490,72340,73310,72130,72850,72820,360,330,10932,"79,608.96",43160
,20160428,72850,72820,72920,73410,72260,73040,73010,220,190,18228,"133,083.86",50050
,20160429,73040,73010,73040,74020,72750,73960,73440,950,430,32124,"235,935.89",68722
,20160503,73960,73440,74000,76940,73370,76730,74690,3290,1250,12408,"92,677.70",68818
,20160504,76730,74690,76420,77090,74580,75130,75590,440,900,21882,"165,420.17",70490
,20160505,75130,75590,75590,75750,73970,74320,74900,-1270,-690,13300,"99,627.02",70328
,20160506,74320,74900,74590,74590,70820,71740,72370,-3160,-2530,20154,"145,854.92",70054
,20160509,71740,72370,71740,72990,69910,70030,71250,-2340,-1120,16146,"115,050.98",70676
,20160510,70030,71250,69980,70450,69160,70160,69930,-1090,-1320,9630,"67,351.13",71032
,20160511,70160,69930,69990,70700,69990,70300,70410,370,480,11108,"78,213.33",71414
,20160512,70300,70410,70680,71580,70120,71050,70800,640,390,13494,"95,546.08",71162
,20160513,71050,70800,70870,71340,68700,69170,69780,-1630,-1020,16694,"116,502.99",71330
,20160516,69170,69780,69160,70070,68960,69910,69630,130,-150,8168,"56,876.60",71850
,20160517,69910,69630,69910,70630,69650,70340,70240,710,610,9400,"66,033.42",72090
,20160518,70340,70240,70180,70860,69450,69720,70220,-520,-20,10674,"74,962.09",72714
,20160519,69720,70220,69600,70230,69220,69360,69640,-860,-580,13794,"96,072.52",72822
,20160520,69360,69640,69080,69830,68620,69450,69320,-190,-320,8406,"58,277.62",73350
,20160523,69450,69320,69460,69770,67700,68200,68500,-1120,-820,12680,"86,864.97",74014
,20160524,68200,68500,68160,68420,67470,68010,68000,-490,-500,8068,"54,868.00",74474
,20160525,68010,68000,68220,68880,67700,67870,68080,-130,80,25640,"174,562.56",74890
,20160526,67870,68080,68170,68700,67880,68250,68220,170,140,8928,"60,911.34",75970
,20160527,68250,68220,68260,68820,67460,68300,68020,80,-200,15106,"102,759.91",75796
,20160530,68300,68020,68300,68670,67800,68480,68210,460,190,14614,"99,682.84",78308
,20160531,68480,68210,68480,69450,68340,69120,68890,910,680,16700,"115,050.15",78846
,20160601,69120,68890,69140,69250,67930,68210,68660,-680,-230,15614,"107,219.03",78086
,20160602,68210,68660,68160,69190,67810,68540,68540,-120,-120,15884,"108,879.27",81560
,20160603,68540,68540,68360,68930,68260,68660,68680,120,140,12116,"83,222.96",82828
,20160606,68660,68680,69240,70350,68630,70150,69430,1470,750,28750,"199,619.61",87756
,20160607,70150,69430,70180,70640,69670,69890,70120,460,690,16628,"116,605.08",92018
,20160608,69890,70120,69590,70430,69450,70090,69890,-30,-230,15188,"106,150.40",92652
,20160613,70090,69890,71000,72000,70430,71410,71330,1520,1440,20916,"149,214.19",92262
,20160614,71410,71330,71690,71880,71180,71570,71510,240,180,17554,"125,542.41",92694
,20160615,71570,71510,71480,72460,71200,72330,71890,820,380,21674,"155,825.08",94514
,20160616,72330,71890,73980,73980,71340,71520,72260,-370,370,28422,"205,383.62",95012
,20160617,71520,72260,71460,72620,71170,72580,71640,320,-620,34298,"245,716.11",96188
,20160620,72580,71640,72740,74150,72320,73780,73320,2140,1680,38428,"281,784.55",104634
,20160621,73780,73320,73930,74690,73220,73650,73900,330,580,39182,"289,582.38",107928
,20160622,73650,73900,73650,74110,72800,74050,73490,150,-410,25722,"189,049.24",109760
,20160623,74050,73490,74070,74250,72900,73280,73490,-210,0,20742,"152,448.53",110388
,20160624,73280,73490,73500,73780,71330,71820,72350,-1670,-1140,49168,"355,776.44",117432
,20160627,71820,72350,71840,73230,71840,73010,72560,660,210,43668,"316,877.43",126064
,20160628,73010,72560,72880,74220,72400,73900,73240,1340,680,52184,"382,213.71",134398
,20160629,73900,73240,74020,75400,74020,74710,74590,1470,1350,75700,"564,705.80",146304
,20160630,74710,74590,75000,76860,74780,76300,75810,1710,1220,103740,"786,516.16",167516
,20160701,76300,75810,76260,77320,75090,76870,76190,1060,380,131100,"998,872.26",180998
,20160704,76870,76190,77100,80760,76960,80760,79390,4570,3200,140668,"1,116,773.49",195868
,20160705,80760,79390,82020,84870,78540,81950,81340,2560,1950,220276,"1,791,896.02",193748
,20160706,81950,81340,82100,83500,77000,79320,79690,-2020,-1650,301210,"2,400,361.18",179088
,20160707,79320,79690,78540,82200,77880,78740,80090,-950,400,232994,"1,866,189.27",183820
,20160708,78740,80090,79110,79850,76520,78270,78200,-1820,-1890,223196,"1,745,501.59",182226
,20160711,78270,78200,79690,81380,78400,80750,79730,2550,1530,214258,"1,708,283.78",205706
,20160712,80750,79730,80880,82890,80340,82720,81240,2990,1510,186446,"1,514,832.39",216730
,20160713,82720,81240,82980,85000,81530,82020,83310,780,2070,305316,"2,543,805.65",224430
,20160714,82020,83310,82450,83570,81250,83280,82500,-30,-810,209384,"1,727,575.86",233296
,20160715,83280,82500,83090,83770,81700,82780,82640,280,140,195564,"1,616,238.19",255368
,20160718,82780,82640,83320,83590,81070,82510,82470,-130,-170,251578,"2,074,966.68",259618
,20160719,82510,82470,82510,85450,81890,83430,83760,960,1290,353792,"2,963,623.19",276850
,20160720,83430,83760,83400,83940,82230,83030,83100,-730,-660,227242,"1,888,593.78",276890
,20160721,83030,83100,82500,84290,81930,83690,83290,590,190,241366,"2,010,573.82",289244
,20160722,83690,83290,84470,85500,82490,82570,84040,-720,750,321826,"2,704,667.40",286718
,20160725,82570,84040,83000,83230,81010,81960,81980,-2080,-2060,273040,"2,238,643.27",285724
,20160726,81960,81980,82200,82330,80100,80840,81210,-1140,-770,241106,"1,958,259.34",289350
,20160727,80840,81210,80790,82180,80640,81120,81440,-90,230,232368,"1,892,448.51",298626
,20160728,81120,81440,81490,83000,81150,82950,82130,1510,690,302888,"2,487,806.03",338786
,20160729,82950,82130,83100,83520,81730,81790,82730,-340,600,273882,"2,266,040.66",346484
,20160801,81790,82730,82100,84090,81410,83930,82930,1200,200,349706,"2,900,381.63",387724
,20160802,83930,82930,83760,85200,83210,85180,84010,2250,1080,477874,"4,014,981.43",481616
,20160803,85180,84010,85290,85700,83450,83880,84260,-130,250,698722,"5,887,553.73",508116
,20160804,83880,84260,84010,84500,81590,82100,83040,-2160,-1220,796350,"6,613,342.72",478976
,20160805,82100,83040,81600,83200,81590,82970,82550,-70,-490,692210,"5,714,757.56",514468
,20160808,82970,82550,82700,84890,82110,84430,83700,1880,1150,773628,"6,475,729.22",566194
,20160809,84430,83700,84400,84790,83300,83790,84070,90,370,709644,"5,966,337.41",568570
,20160810,83790,84070,83450,84700,83100,84190,83900,120,-170,747168,"6,268,803.46",574810
,20160811,84190,83900,84500,85250,83090,83330,84150,-570,250,971948,"8,179,790.88",587090
,20160812,83330,84150,83300,83900,82600,83100,83270,-1050,-880,749318,"6,239,611.05",596208
,20160815,83100,83270,82080,82500,80520,80850,81430,-2420,-1840,983504,"8,008,983.03",610604
,20160816,80850,81430,81310,82050,81120,81490,81580,60,150,611550,"4,989,147.80",604464
,20160817,81490,81580,81380,81700,80660,81170,81210,-410,-370,684610,"5,559,948.41",613314
,20160818,81170,81210,81050,81770,80260,81440,81080,230,-130,733912,"5,951,095.84",609926
,20160819,81440,81080,81530,81740,80900,81540,81400,460,320,498222,"4,055,550.48",614896
,20160822,81540,81400,81400,82140,80500,80590,81380,-810,-20,602994,"4,907,747.83",621676
,20160823,80590,81380,80520,81480,80360,81110,81090,-270,-290,412270,"3,343,231.57",604530
,20160824,81110,81090,81270,81580,80670,80980,81130,-110,40,425210,"3,449,848.35",609466
,20160825,80980,81130,81120,81320,77550,78450,79090,-2680,-2040,1062506,"8,404,081.74",611110
,20160826,78450,79090,77900,78790,77850,78310,78450,-780,-640,466932,"3,663,159.37",600286
,20160829,78310,78450,78310,79280,77990,78570,78600,120,150,604124,"4,748,527.03",576564
,20160830,78570,78600,78610,78970,78000,78150,78560,-450,-40,356702,"2,802,326.62",588174
,20160831,78150,78560,77980,78710,77890,78060,78380,-500,-180,434898,"3,408,968.07",586950
,20160901,78060,78380,78000,79200,77980,78810,78700,430,320,531406,"4,182,679.44",576764
,20160902,78810,78700,78530,80480,78380,79820,79470,1120,770,731232,"5,811,786.01",556138
,20160905,79820,79470,80020,80840,80020,80230,80400,760,930,565786,"4,549,172.98",563528
,20160906,80230,80400,80370,81120,79500,81040,80380,640,-20,553620,"4,450,026.96",552206
,20160907,81040,80380,80910,81300,80360,80920,80840,540,460,533470,"4,312,757.08",537074
,20160908,80920,80840,81150,81420,80580,80980,80980,140,140,447436,"3,623,737.16",541706
,20160909,80980,80980,81400,81550,80850,81320,81220,340,240,426516,"3,464,445.84",536068
,20160912,81320,81220,81400,81460,78500,78710,80090,-2510,-1130,619392,"4,960,784.15",525288
,20160913,78710,80090,78820,79750,78680,79310,79200,-780,-890,416320,"3,297,564.15",517318
,20160914,79310,79200,79190,79500,78020,78280,78540,-920,-660,486080,"3,818,153.95",514876
,20160919,78280,78540,77990,79360,77960,78960,78920,420,380,256726,"2,026,204.99",512880
,20160920,78960,78920,79100,80700,79030,80610,79990,1690,1070,541658,"4,332,892.92",507280
,20160921,80610,79990,80690,80980,80110,80510,80530,520,540,398448,"3,208,794.86",496404
,20160922,80510,80530,80850,82560,80520,81700,81520,1170,990,652968,"5,323,239.71",492808
,20160923,81700,81520,82260,82650,81800,82620,82180,1100,660,446672,"3,671,014.17",499040
,20160926,82620,82180,82660,82850,81400,81480,82210,-700,30,541690,"4,453,341.31",509732
,20160927,81480,82210,81550,82730,80200,82700,81390,490,-820,713616,"5,808,663.45",530618
,20160928,82700,81390,82880,82980,81510,82090,82090,700,700,725532,"5,956,160.21",509676
,20160929,82090,82090,81920,83610,81570,81860,82630,-230,540,683474,"5,648,100.01",493246
,20160930,81860,82630,81800,81990,80430,81380,81310,-1250,-1320,525812,"4,275,809.33",464428
,20161010,81380,81310,80720,81860,80200,81660,81090,350,-220,284498,"2,307,229.16",465102
,20161011,81660,81090,81470,82970,81470,82840,82370,1750,1280,560184,"4,614,435.56",490950
,20161012,82840,82370,82490,83140,81890,82350,82440,-20,70,513218,"4,231,298.38",484610
,20161013,82350,82440,82760,83050,80900,81340,82160,-1100,-280,626050,"5,144,098.25",492972
,20161014,81340,82160,81090,82240,80720,81590,81550,-570,-610,502782,"4,100,495.02",486616
,20161017,81590,81550,81700,82540,81420,81820,82040,270,490,653362,"5,360,685.74",497082
,20161018,81820,82040,81950,82010,80850,81680,81450,-360,-590,443098,"3,609,152.11",498742
,20161019,81680,81450,81700,82350,80410,80700,81540,-750,90,637110,"5,195,310.64",513786
,20161020,80700,81540,80650,81290,79780,80750,80720,-790,-820,509984,"4,117,074.14",507158
,20161021,80750,80720,80400,80620,79360,79410,79970,-1310,-750,515654,"4,124,114.68",538548
,20161024,79410,79970,79280,80700,79080,80410,79820,440,-150,463548,"3,700,238.88",518322
,20161025,80410,79820,80200,81960,80200,81470,81170,1650,1350,583810,"4,739,052.22",512946
,20161026,81470,81170,81700,82300,80590,81050,81430,-120,260,539952,"4,397,303.56",511784
,20161027,81050,81430,80950,81900,80450,80980,81240,-450,-190,507290,"4,121,264.23",508394
,20161028,80980,81240,81600,82690,81400,82570,82190,1330,950,616094,"5,063,679.20",509508
,20161031,82570,82190,82650,84030,82100,83950,82810,1760,620,618874,"5,125,140.53",544172
,20161101,83950,82810,83910,84340,82900,83560,83600,750,790,581778,"4,864,020.97",521976
,20161102,83560,83600,83410,84460,81800,82310,83220,-1290,-380,676190,"5,627,635.52",499476
,20161103,82310,83220,82700,83470,82200,83280,82860,60,-360,375696,"3,113,372.13",498794
,20161104,83280,82860,83500,84100,82800,82920,83430,60,570,543200,"4,531,997.11",492920
,20161107,82920,83430,82980,88430,82650,87830,85890,4400,2460,1057918,"9,086,926.73",530624
,20161108,87830,85890,87930,90860,87050,89890,88870,4000,2980,1097124,"9,751,173.96",511204
,20161109,89890,88870,89450,91670,88550,90840,90190,1970,1320,1119850,"10,100,449.78",506656
,20161110,90840,90190,92000,95600,91500,95600,93550,5410,3360,1038744,"9,717,808.68",509140
,20161111,95600,93550,95800,97230,93000,96140,94730,2590,1180,1102576,"10,444,732.98",484362
,20161114,96140,94730,96100,99800,89040,91680,93030,-3050,-1700,1518068,"14,123,068.56",399120
,20161115,91680,93030,91340,94170,89490,90680,91570,-2350,-1460,870318,"7,970,055.81",403730
,20161116,90680,91570,90890,92800,90600,92530,91600,960,30,683878,"6,264,936.04",400152
,20161117,92530,91600,91830,92250,90870,91240,91550,-360,-50,582126,"5,329,637.03",377758
,20161118,91240,91550,91490,91850,89800,90720,90900,-830,-650,497672,"4,524,024.35",366414
,20161121,90720,90900,90720,91800,88010,91330,90170,430,-730,650826,"5,868,778.87",356944
,20161122,91330,90170,91600,94480,90770,93340,92660,3170,2490,656142,"6,080,249.14",342202
,20161123,93340,92660,93110,93370,92020,92970,92860,310,200,395870,"3,676,188.70",335988
,20161124,92970,92860,92780,96660,92350,94550,94690,1690,1830,824562,"7,808,456.48",313886
,20161125,94550,94690,94690,96250,93720,95200,95190,510,500,525570,"5,003,060.86",288094
,20161128,95200,95190,94990,97770,94120,97610,95930,2420,740,514246,"4,933,529.11",274106
,20161129,97610,95930,96850,97480,92720,93210,95360,-2720,-570,504692,"4,813,054.92",240038
,20161130,93210,95360,93350,93700,88800,89870,91200,-5490,-4160,443196,"4,042,314.83",212630
,20161201,89870,91200,90300,92500,89990,91470,91210,270,10,226646,"2,067,431.28",190352
,20161202,91470,91210,91400,91870,90000,90840,91030,-370,-180,103870,"945,595.21",179016
,20161205,90840,91030,90700,94490,90550,93760,93090,2730,2060,132302,"1,231,707.08",158738
,20161206,93760,93090,94570,95050,93000,93680,94090,590,1000,55642,"523,562.67",148778
,20161207,93680,94090,93810,95390,93180,95060,94500,970,410,62782,"593,318.52",137524
,20161208,95060,94500,95390,95560,92670,93440,94040,-1060,-460,43542,"409,502.83",128106
,20161209,93440,94040,93530,94000,91280,93490,92740,-550,-1300,48906,"453,569.46",116862
,20161212,93490,92740,93740,95950,92600,92760,94660,20,1920,58588,"554,619.75",103502
,20161213,92760,94660,92270,94290,92270,94200,93530,-460,-1130,30998,"289,950.20",97634
,20161214,94200,93530,94460,94950,91940,94490,94120,960,590,42638,"401,343.63",92046
,20161215,94490,94120,93830,95350,92920,94400,94210,280,90,32988,"310,784.12",83422
,20161216,94400,94210,93770,94770,93030,93570,93920,-640,-290,18062,"169,654.28",80132
,20161219,93570,93920,93030,93690,91800,91810,92770,-2110,-1150,15508,"143,880.71",75186
,20161220,91810,92770,91590,91590,89250,90970,90890,-1800,-1880,17982,"163,452.16",72292
,20161221,90970,90890,92350,92350,90520,90910,91070,20,180,16756,"152,603.92",69386
,20161222,90910,91070,90830,91110,88050,88410,89560,-2660,-1510,13214,"118,357.02",68272
,20161223,88410,89560,88210,89580,87920,88530,88820,-1030,-740,12744,"113,202.49",62918
,20161226,88530,88820,88250,88670,82600,82850,84340,-5970,-4480,33188,"279,910.93",56490
,20161227,82850,84340,82620,84150,82330,83850,83290,-490,-1050,12672,"105,552.83",53000
,20161228,83850,83290,84560,85630,83670,84100,84720,810,1430,6660,"56,424.66",51666
,20161229,84100,84720,84100,84810,83250,84700,84250,-20,-470,7012,"59,076.77",50634
,20161230,84700,84250,84000,84570,83250,84320,84000,70,-250,9364,"78,666.69",49550
ni1702,20160216,68280,68280,,,,68280,68280,0,0,0,0.00,0
,20160217,68280,68280,70480,70480,67700,67700,68620,-580,340,6,41.18,4
,20160218,67700,68620,,,,68620,68620,0,0,0,0.00,4
,20160219,68620,68620,,,,68620,68620,0,0,0,0.00,4
,20160222,68620,68620,,,,69770,69770,1150,1150,0,0.00,4
,20160223,69770,69770,,,,70970,70970,1200,1200,0,0.00,4
,20160224,70970,70970,,,,70220,70220,-750,-750,0,0.00,4
,20160225,70220,70220,,,,70000,70000,-220,-220,0,0.00,4
,20160226,70000,70000,68270,69070,68270,69070,68630,-930,-1370,10,68.63,12
,20160229,69070,68630,,,,68630,68630,0,0,0,0.00,12
,20160301,68630,68630,69920,69920,69920,69920,69920,1290,1290,2,13.98,12
,20160302,69920,69920,70800,70800,70800,70800,70800,880,880,2,14.16,12
,20160303,70800,70800,,,,71460,71460,660,660,0,0.00,12
,20160304,71460,71460,,,,72810,72810,1350,1350,0,0.00,12
,20160307,72810,72810,76000,76000,74460,74460,75230,1650,2420,4,30.09,12
,20160308,74460,75230,77820,77820,72170,74420,74800,-810,-430,6,44.88,14
,20160309,74420,74800,70340,72530,70340,72530,71430,-2270,-3370,4,28.57,14
,20160310,72530,71430,,,,71430,71430,0,0,0,0.00,14
,20160311,71430,71430,,,,71280,71280,-150,-150,0,0.00,14
,20160314,71280,71280,70790,71540,70790,71540,71160,260,-120,4,28.47,14
,20160315,71540,71160,70300,71820,70300,70370,70830,-790,-330,6,42.50,16
,20160316,70370,70830,70050,70050,70050,70050,70050,-780,-780,2,14.01,16
,20160317,70050,70050,,,,70050,70050,0,0,0,0.00,16
,20160318,70050,70050,72080,72080,71510,71510,71790,1460,1740,4,28.72,18
,20160321,71510,71790,71700,71700,71000,71000,71310,-790,-480,10,71.31,26
,20160322,71000,71310,71420,71520,71420,71520,71480,210,170,6,42.89,24
,20160323,71520,71480,71400,71400,71400,71400,71400,-80,-80,2,14.28,22
,20160324,71400,71400,70690,70690,70690,70690,70690,-710,-710,2,14.14,22
,20160325,70690,70690,,,,70860,70860,170,170,0,0.00,22
,20160328,70860,70860,70860,71320,70860,71320,71090,460,230,4,28.44,22
,20160329,71320,71090,,,,70820,70820,-270,-270,0,0.00,22
,20160330,70820,70820,,,,69650,69650,-1170,-1170,0,0.00,22
,20160331,69650,69650,69820,69820,68970,69520,69430,-130,-220,6,41.66,24
,20160401,69520,69430,,,,69250,69250,-180,-180,0,0.00,24
,20160405,69250,69250,,,,68540,68540,-710,-710,0,0.00,24
,20160406,68540,68540,,,,69180,69180,640,640,0,0.00,24
,20160407,69180,69180,,,,69730,69730,550,550,0,0.00,24
,20160408,69730,69730,69090,69090,68610,68610,68930,-1120,-800,6,41.36,30
,20160411,68610,68930,,,,69990,69990,1060,1060,0,0.00,30
,20160412,69990,69990,,,,70220,70220,230,230,0,0.00,30
,20160413,70220,70220,,,,70220,70220,0,0,0,0.00,30
,20160414,70220,70220,71840,71840,71840,71840,71840,1620,1620,2,14.37,30
,20160415,71840,71840,72680,72690,72290,72290,72540,450,700,8,58.04,32
,20160418,72290,72540,,,,72540,72540,0,0,0,0.00,32
,20160419,72540,72540,73210,73500,71660,71660,72800,-880,260,36,262.10,48
,20160420,71660,72800,73050,73750,73050,73750,73400,950,600,8,58.72,52
,20160421,73750,73400,,,,74580,74580,1180,1180,0,0.00,52
,20160422,74580,74580,75550,75560,73320,73320,74430,-1260,-150,8,59.55,52
,20160425,73320,74430,73000,73000,72440,72440,72620,-1990,-1810,6,43.58,54
,20160426,72440,72620,72600,72600,71860,71860,72410,-760,-210,8,57.93,50
,20160427,71860,72410,72420,73590,72250,72250,72670,-160,260,8,58.14,48
,20160428,72250,72670,,,,72670,72670,0,0,0,0.00,48
,20160429,72670,72670,73720,73720,73720,73720,73720,1050,1050,6,44.23,54
,20160503,73720,73720,74060,75080,74060,75080,74820,1360,1100,14,104.75,46
,20160504,75080,74820,75920,75920,75000,75000,75460,180,640,4,30.18,48
,20160505,75000,75460,,,,75460,75460,0,0,0,0.00,48
,20160506,75460,75460,73000,73000,71910,71910,72450,-3550,-3010,4,28.98,46
,20160509,71910,72450,72400,72400,71000,71000,72120,-1450,-330,10,72.12,42
,20160510,71000,72120,,,,72120,72120,0,0,0,0.00,42
,20160511,72120,72120,,,,72120,72120,0,0,0,0.00,42
,20160512,72120,72120,,,,72120,72120,0,0,0,0.00,42
,20160513,72120,72120,70190,70600,69020,70600,70030,-1520,-2090,10,70.04,50
,20160516,70600,70030,,,,69880,69880,-150,-150,0,0.00,50
,20160517,69880,69880,,,,70500,70500,620,620,0,0.00,50
,20160518,70500,70500,,,,70500,70500,0,0,0,0.00,50
,20160519,70500,70500,,,,69920,69920,-580,-580,0,0.00,50
,20160520,69920,69920,,,,69920,69920,0,0,0,0.00,50
,20160523,69920,69920,,,,69090,69090,-830,-830,0,0.00,50
,20160524,69090,69090,,,,68590,68590,-500,-500,0,0.00,50
,20160525,68590,68590,,,,68670,68670,80,80,0,0.00,50
,20160526,68670,68670,68850,68850,68850,68850,68850,180,180,2,13.77,48
,20160527,68850,68850,,,,68650,68650,-200,-200,0,0.00,48
,20160530,68650,68650,68890,69040,68610,68610,68840,-40,190,12,82.61,52
,20160531,68610,68840,69810,69810,69810,69810,69810,970,970,2,13.96,54
,20160601,69810,69810,,,,69810,69810,0,0,0,0.00,54
,20160602,69810,69810,,,,69810,69810,0,0,0,0.00,54
,20160603,69810,69810,68070,69320,68060,68990,68700,-820,-1110,202,"1,387.86",52
,20160606,68990,68700,69230,70160,69230,70160,69550,1460,850,6,41.73,52
,20160607,70160,69550,70550,70550,70000,70040,70190,490,640,6,42.12,50
,20160608,70040,70190,69910,69910,69910,69910,69910,-280,-280,2,13.98,50
,20160613,69910,69910,72590,72590,72590,72590,72590,2680,2680,4,29.04,54
,20160614,72590,72590,,,,72590,72590,0,0,0,0.00,54
,20160615,72590,72590,71970,72450,71970,72450,72090,-140,-500,8,57.68,54
,20160616,72450,72090,,,,72090,72090,0,0,0,0.00,54
,20160617,72090,72090,,,,72090,72090,0,0,0,0.00,54
,20160620,72090,72090,72080,73180,72080,73180,72680,1090,590,28,203.50,66
,20160621,73180,72680,73900,74710,73900,74710,74300,2030,1620,4,29.72,64
,20160622,74710,74300,73700,73860,73700,73860,73790,-440,-510,10,73.79,54
,20160623,73860,73790,,,,73790,73790,0,0,0,0.00,54
,20160624,73790,73790,73700,73700,72090,73510,73040,-280,-750,10,73.04,60
,20160627,73510,73040,72360,73000,72360,73000,72760,-40,-280,10,72.77,62
,20160628,73000,72760,73080,73080,73080,73080,73080,320,320,2,14.62,60
,20160629,73080,73080,75000,75000,75000,75000,75000,1920,1920,2,15.00,60
,20160630,75000,75000,75660,76250,75140,76250,75850,1250,850,14,106.20,70
,20160701,76250,75850,75660,77660,75660,77500,76790,1650,940,12,92.16,76
,20160704,77500,76790,80000,81360,80000,81360,80750,4570,3960,10,80.75,76
,20160705,81360,80750,81490,81490,79660,80100,80410,-650,-340,6,48.25,76
,20160706,80100,80410,79160,80540,77870,79340,78870,-1070,-1540,14,110.42,74
,20160707,79340,78870,79090,82720,77870,79500,79690,630,820,70,557.87,88
,20160708,79500,79690,79720,79780,78560,78580,79430,-1110,-260,42,333.62,84
,20160711,78580,79430,79210,82010,79210,80520,80290,1090,860,28,224.82,92
,20160712,80520,80290,81550,82410,81270,82410,82090,2120,1800,20,164.20,88
,20160713,82410,82090,83410,83410,83140,83140,83350,1050,1260,10,83.36,96
,20160714,83140,83350,83200,83200,83200,83200,83200,-150,-150,2,16.64,94
,20160715,83200,83200,,,,83200,83200,0,0,0,0.00,94
,20160718,83200,83200,83030,83030,83030,83030,83030,-170,-170,2,16.61,94
,20160719,83030,83030,84000,84000,84000,84000,84000,970,970,2,16.80,94
,20160720,84000,84000,83900,83900,82720,82720,83630,-1280,-370,16,133.82,88
,20160721,82720,83630,82850,83930,82360,83930,82740,300,-890,14,115.84,82
,20160722,83930,82740,85180,85440,84060,84140,84610,1400,1870,24,203.07,62
,20160725,84140,84610,81940,81940,81940,81940,81940,-2670,-2670,2,16.39,64
,20160726,81940,81940,82450,82450,81180,81590,81530,-350,-410,12,97.84,64
,20160727,81590,81530,81540,82860,81430,81430,82130,-100,600,20,164.28,54
,20160728,81430,82130,81820,82010,81820,82000,81940,-130,-190,6,49.17,56
,20160729,82000,81940,82330,82330,82050,82050,82190,110,250,4,32.88,54
,20160801,82050,82190,,,,82190,82190,0,0,0,0.00,54
,20160802,82190,82190,83930,84990,83930,84990,84450,2800,2260,36,304.03,72
,20160803,84990,84450,85540,85540,84010,84010,85090,-440,640,16,136.14,62
,20160804,84010,85090,84080,84430,82870,84430,83760,-660,-1330,8,67.01,66
,20160805,84430,83760,82380,82730,82380,82730,82490,-1030,-1270,8,65.99,62
,20160808,82730,82490,,,,82490,82490,0,0,0,0.00,62
,20160809,82490,82490,84040,84040,84040,84040,84040,1550,1550,2,16.81,62
,20160810,84040,84040,83880,85070,83710,85070,84430,1030,390,18,151.99,64
,20160811,85070,84430,84990,85260,84990,85210,85070,780,640,12,102.09,66
,20160812,85210,85070,83690,83690,83190,83190,83520,-1880,-1550,6,50.11,68
,20160815,83190,83520,83490,83490,81360,81380,82620,-2140,-900,24,198.30,74
,20160816,81380,82620,81860,81980,81690,81980,81840,-640,-780,6,49.11,74
,20160817,81980,81840,80630,81600,80630,81500,81480,-340,-360,210,"1,711.10",68
,20160818,81500,81480,82070,82070,81020,81020,81320,-460,-160,12,97.59,60
,20160819,81020,81320,,,,81470,81470,150,150,0,0.00,60
,20160822,81470,81470,80190,80190,80190,80190,80190,-1280,-1280,10,80.19,68
,20160823,80190,80190,80940,81560,80940,81560,81140,1370,950,44,357.05,62
,20160824,81560,81140,81330,81330,81320,81320,81320,180,180,10,81.32,58
,20160825,81320,81320,78330,79060,78330,78640,78670,-2680,-2650,6,47.21,56
,20160826,78640,78670,,,,78670,78670,0,0,0,0.00,56
,20160829,78670,78670,78590,79440,78590,79440,79100,770,430,10,79.10,62
,20160830,79440,79100,79120,79120,79120,79120,79120,20,20,2,15.82,60
,20160831,79120,79120,78540,78950,78540,78950,78740,-170,-380,4,31.50,62
,20160901,78950,78740,78560,78560,78560,78560,78560,-180,-180,2,15.71,60
,20160902,78560,78560,80400,80400,80400,80400,80400,1840,1840,2,16.08,58
,20160905,80400,80400,,,,80400,80400,0,0,0,0.00,58
,20160906,80400,80400,,,,80400,80400,0,0,0,0.00,58
,20160907,80400,80400,,,,80400,80400,0,0,0,0.00,58
,20160908,80400,80400,80620,81860,80620,81860,81240,1460,840,8,64.99,58
,20160909,81860,81240,,,,81240,81240,0,0,0,0.00,58
,20160912,81240,81240,,,,79760,79760,-1480,-1480,0,0.00,58
,20160913,79760,79760,79000,79000,79000,79000,79000,-760,-760,4,31.60,62
,20160914,79000,79000,79490,79490,79340,79340,79390,340,390,6,47.63,60
,20160919,79340,79390,,,,79390,79390,0,0,0,0.00,60
,20160920,79390,79390,79980,79980,79980,79980,79980,590,590,4,31.99,60
,20160921,79980,79980,76900,80990,76900,80580,79270,600,-710,10,79.27,60
,20160922,80580,79270,81100,82630,81100,82390,81730,3120,2460,112,915.44,154
,20160923,82390,81730,82600,82600,82600,82600,82600,870,870,2,16.52,152
,20160926,82600,82600,82810,82810,82710,82710,82760,110,160,4,33.10,152
,20160927,82710,82760,81830,82420,80940,82420,81740,-340,-1020,12,98.09,152
,20160928,82420,81740,82630,82630,82440,82440,82500,700,760,6,49.50,150
,20160929,82440,82500,83730,83730,82220,82220,83160,-280,660,20,166.33,150
,20160930,82220,83160,,,,81830,81830,-1330,-1330,0,0.00,150
,20161010,81830,81830,,,,81830,81830,0,0,0,0.00,150
,20161011,81830,81830,82790,82790,82790,82790,82790,960,960,2,16.56,150
,20161012,82790,82790,82880,84020,77830,83350,82870,560,80,116,961.36,68
,20161013,83350,82870,82810,82810,81330,82170,81650,-700,-1220,628,"5,127.68",662
,20161014,82170,81650,81580,82570,81110,81900,81870,250,220,124,"1,015.30",580
,20161017,81900,81870,82580,82580,82090,82090,82410,220,540,6,49.45,580
,20161018,82090,82410,82300,82300,81800,81800,81870,-610,-540,64,523.99,518
,20161019,81800,81870,82320,82320,80750,81170,81180,-700,-690,98,795.59,478
,20161020,81170,81180,81000,81370,80780,81140,81030,-40,-150,134,"1,085.80",420
,20161021,81140,81030,80050,80400,79880,79880,80090,-1150,-940,88,704.86,422
,20161024,79880,80090,79640,80940,79640,80780,80500,690,410,24,193.22,406
,20161025,80780,80500,81430,82030,81430,81900,81920,1400,1420,14,114.69,406
,20161026,81900,81920,81900,82240,80840,81320,81120,-600,-800,134,"1,087.13",384
,20161027,81320,81120,81990,81990,81270,81270,81530,150,410,12,97.85,378
,20161028,81270,81530,82490,82590,82330,82330,82470,800,940,30,247.43,374
,20161031,82330,82470,82640,84230,82390,84230,82960,1760,490,20,165.94,382
,20161101,84230,82960,83760,83990,83740,83990,83830,1030,870,6,50.30,378
,20161102,83990,83830,84210,84210,82440,82490,83160,-1340,-670,18,149.70,378
,20161103,82490,83160,82910,83540,82530,83540,83190,380,30,12,99.83,384
,20161104,83540,83190,83800,83810,83180,83180,83620,-10,430,16,133.80,382
,20161107,83180,83620,83180,87850,82740,87850,85920,4230,2300,86,738.91,350
,20161108,87850,85920,88210,90320,88210,90270,89440,4350,3520,96,858.62,346
,20161109,90270,89440,89800,91430,89360,91330,90700,1890,1260,128,"1,161.03",352
,20161110,91330,90700,91960,95770,91960,95390,93710,4690,3010,154,"1,443.22",320
,20161111,95390,93710,93590,96630,93590,96630,94670,2920,960,104,984.57,336
,20161114,96630,94670,95890,96260,90270,91020,92010,-3650,-2660,236,"2,171.49",280
,20161115,91020,92010,91800,93830,90490,90490,92840,-1520,830,186,"1,727.01",276
,20161116,90490,92840,91340,91780,91290,91290,91480,-1550,-1360,48,439.11,272
,20161117,91290,91480,93000,93000,90540,91110,91830,-370,350,14,128.57,276
,20161118,91110,91830,90960,90960,90960,90960,90960,-870,-870,2,18.19,274
,20161121,90960,90960,86000,92150,86000,91950,90380,990,-580,116,"1,048.49",274
,20161122,91950,90380,92310,93900,91820,93360,93120,2980,2740,54,502.89,268
,20161123,93360,93120,93080,93080,93080,93080,93080,-40,-40,14,130.31,262
,20161124,93080,93080,94900,97590,94500,95630,96230,2550,3150,230,"2,213.41",236
,20161125,95630,96230,95340,96000,94520,95270,95190,-960,-1040,296,"2,817.65",214
,20161128,95270,95190,94950,97920,94320,97920,96570,2730,1380,196,"1,892.86",164
,20161129,97920,96570,96870,98050,92840,93400,96620,-3170,50,478,"4,618.53",204
,20161130,93400,96620,93640,94290,89850,90520,92600,-6100,-4020,194,"1,796.59",214
,20161201,90520,92600,91360,92350,90520,92350,91740,-250,-860,1024,"9,394.19",328
,20161202,92350,91740,92100,92100,90660,90950,91270,-790,-470,44,401.62,304
,20161205,90950,91270,91790,94780,91260,94470,93150,3200,1880,56,521.65,298
,20161206,94470,93150,99630,99640,93870,93870,95450,720,2300,106,"1,011.85",264
,20161207,93870,95450,93850,95150,93850,95100,95040,-350,-410,52,494.26,214
,20161208,95100,95040,95520,95820,92920,94000,93940,-1040,-1100,28,263.04,204
,20161209,94000,93940,94210,94360,92100,94200,93060,260,-880,54,502.53,196
,20161212,94200,93060,94340,96110,93520,94890,95170,1830,2110,152,"1,446.64",164
,20161213,94890,95170,93410,95620,93230,94360,94240,-810,-930,184,"1,734.10",126
,20161214,94360,94240,94530,94680,94200,94200,94410,-40,170,8,75.53,126
,20161215,94200,94410,94440,94770,94440,94730,94640,320,230,46,435.36,122
,20161216,94730,94640,94270,95040,93740,93840,94380,-800,-260,48,453.06,124
,20161219,93840,94380,93950,93950,91750,92300,92470,-2080,-1910,68,628.85,132
,20161220,92300,92470,91620,92190,90160,90820,90870,-1650,-1600,42,381.67,122
,20161221,90820,90870,91440,92250,91290,92250,91670,1380,800,20,183.35,118
,20161222,92250,91670,89600,89650,89000,89540,89380,-2130,-2290,40,357.52,124
,20161223,89540,89380,88850,90140,88610,89150,89540,-230,160,86,770.10,156
,20161226,89150,89540,88780,89000,83270,83370,86700,-6170,-2840,202,"1,751.49",164
,20161227,83370,86700,83170,84550,82820,84510,83710,-2190,-2990,154,"1,289.20",152
,20161228,84510,83710,84400,86320,84400,84750,85320,1040,1610,36,307.17,152
,20161229,84750,85320,85130,85130,85130,85130,85130,-190,-190,6,51.08,146
,20161230,85130,85130,85130,85130,84240,84460,84360,-670,-770,40,337.45,120
ni1703,20160316,70830,70830,,,,70050,70050,-780,-780,0,0.00,0
,20160317,70050,70050,,,,70050,70050,0,0,0,0.00,0
,20160318,70050,70050,,,,70050,70050,0,0,0,0.00,0
,20160321,70050,70050,71700,71760,71500,71500,71660,1450,1610,8,57.33,6
,20160322,71500,71660,,,,71660,71660,0,0,0,0.00,6
,20160323,71660,71660,,,,71660,71660,0,0,0,0.00,6
,20160324,71660,71660,,,,70940,70940,-720,-720,0,0.00,6
,20160325,70940,70940,71420,71420,71420,71420,71420,480,480,6,42.85,12
,20160328,71420,71420,,,,71650,71650,230,230,0,0.00,12
,20160329,71650,71650,71290,71290,71290,71290,71290,-360,-360,4,28.52,12
,20160330,71290,71290,,,,70110,70110,-1180,-1180,0,0.00,12
,20160331,70110,70110,,,,69890,69890,-220,-220,0,0.00,12
,20160401,69890,69890,,,,69710,69710,-180,-180,0,0.00,12
,20160405,69710,69710,69650,69650,67520,67520,68580,-2190,-1130,4,27.43,12
,20160406,67520,68580,69680,69680,69680,69680,69680,1100,1100,2,13.94,14
,20160407,69680,69680,,,,70230,70230,550,550,0,0.00,14
,20160408,70230,70230,,,,69420,69420,-810,-810,0,0.00,14
,20160411,69420,69420,69970,70410,69970,70410,70190,990,770,4,28.08,14
,20160412,70410,70190,70110,70810,70110,70810,70250,620,60,10,70.25,24
,20160413,70810,70250,71210,73220,71210,73070,72500,2820,2250,6,43.50,26
,20160414,73070,72500,72550,72550,72550,72550,72550,50,50,2,14.51,28
,20160415,72550,72550,72760,72990,71810,72470,72490,-80,-60,22,159.49,40
,20160418,72470,72490,,,,72490,72490,0,0,0,0.00,40
,20160419,72490,72490,73620,73620,71760,72100,72150,-390,-340,14,101.01,42
,20160420,72100,72150,73160,74190,72700,73640,73300,1490,1150,22,161.27,44
,20160421,73640,73300,74320,75260,74320,75260,74790,1960,1490,4,29.92,44
,20160422,75260,74790,75900,75900,72890,73320,73630,-1470,-1160,16,117.81,52
,20160425,73320,73630,73710,73710,73710,73710,73710,80,80,2,14.74,50
,20160426,73710,73710,,,,73710,73710,0,0,0,0.00,50
,20160427,73710,73710,73910,73910,73910,73910,73910,200,200,2,14.78,50
,20160428,73910,73910,,,,73910,73910,0,0,0,0.00,50
,20160429,73910,73910,74600,74600,74500,74500,74550,590,640,4,29.82,50
,20160503,74500,74550,,,,75660,75660,1110,1110,0,0.00,50
,20160504,75660,75660,,,,75660,75660,0,0,0,0.00,50
,20160505,75660,75660,,,,75660,75660,0,0,0,0.00,50
,20160506,75660,75660,72300,72300,72300,72300,72300,-3360,-3360,2,14.46,48
,20160509,72300,72300,71000,71000,71000,71000,71000,-1300,-1300,2,14.20,50
,20160510,71000,71000,,,,71000,71000,0,0,0,0.00,50
,20160511,71000,71000,71230,71230,71230,71230,71230,230,230,2,14.25,48
,20160512,71230,71230,,,,71230,71230,0,0,0,0.00,48
,20160513,71230,71230,,,,71230,71230,0,0,0,0.00,48
,20160516,71230,71230,,,,71080,71080,-150,-150,0,0.00,48
,20160517,71080,71080,71060,71310,70640,71310,71050,230,-30,22,156.33,64
,20160518,71310,71050,,,,71050,71050,0,0,0,0.00,64
,20160519,71050,71050,,,,70470,70470,-580,-580,0,0.00,64
,20160520,70470,70470,,,,70470,70470,0,0,0,0.00,64
,20160523,70470,70470,69350,69550,69070,69550,69360,-920,-1110,18,124.86,68
,20160524,69550,69360,68860,68860,68860,68860,68860,-500,-500,4,27.54,72
,20160525,68860,68860,68670,69190,68670,69190,68910,330,50,12,82.69,70
,20160526,69190,68910,,,,69090,69090,180,180,0,0.00,70
,20160527,69090,69090,,,,68890,68890,-200,-200,0,0.00,70
,20160530,68890,68890,69120,69120,69120,69120,69120,230,230,2,13.82,68
,20160531,69120,69120,69890,69890,69890,69890,69890,770,770,4,27.96,68
,20160601,69890,69890,,,,69890,69890,0,0,0,0.00,68
,20160602,69890,69890,,,,69890,69890,0,0,0,0.00,68
,20160603,69890,69890,,,,69890,69890,0,0,0,0.00,68
,20160606,69890,69890,68580,69880,68570,69880,69220,-10,-670,192,"1,329.12",68
,20160607,69880,69220,70240,70240,70240,70240,70240,1020,1020,2,14.05,66
,20160608,70240,70240,,,,70240,70240,0,0,0,0.00,66
,20160613,70240,70240,,,,70240,70240,0,0,0,0.00,66
,20160614,70240,70240,,,,70240,70240,0,0,0,0.00,66
,20160615,70240,70240,,,,69760,69760,-480,-480,0,0.00,66
,20160616,69760,69760,73400,73400,72850,72850,73120,3090,3360,4,29.25,66
,20160617,72850,73120,71950,72700,71950,72700,72450,-420,-670,6,43.47,62
,20160620,72700,72450,73750,73770,73750,73770,73760,1320,1310,4,29.50,60
,20160621,73770,73760,74160,74160,74160,74160,74160,400,400,2,14.83,60
,20160622,74160,74160,,,,74160,74160,0,0,0,0.00,60
,20160623,74160,74160,74160,74160,74160,74160,74160,0,0,2,14.83,58
,20160624,74160,74160,72490,73060,70810,73060,72620,-1100,-1540,22,159.77,62
,20160627,73060,72620,72670,73200,72620,73170,72910,550,290,14,102.07,58
,20160628,73170,72910,73350,73350,73350,73350,73350,440,440,2,14.67,58
,20160629,73350,73350,,,,73350,73350,0,0,0,0.00,58
,20160630,73350,73350,,,,74180,74180,830,830,0,0.00,58
,20160701,74180,74180,75620,77080,75620,77080,76710,2900,2530,8,61.37,66
,20160704,77080,76710,80940,81310,80790,80820,80970,4110,4260,18,145.76,72
,20160705,80820,80970,83820,83820,79350,80600,81640,-370,670,16,130.64,70
,20160706,80600,81640,82510,82510,80800,80860,81050,-780,-590,14,113.47,68
,20160707,80860,81050,80240,82130,80240,82130,81500,1080,450,10,81.50,74
,20160708,82130,81500,80230,80230,78830,78830,79750,-2670,-1750,12,95.70,62
,20160711,78830,79750,79540,81030,79540,81030,80130,1280,380,10,80.14,62
,20160712,81030,80130,,,,81930,81930,1800,1800,0,0.00,62
,20160713,81930,81930,84000,84000,83780,83780,83890,1850,1960,12,100.67,68
,20160714,83780,83890,82700,83300,82700,83300,82940,-590,-950,20,165.90,54
,20160715,83300,82940,,,,82940,82940,0,0,0,0.00,54
,20160718,82940,82940,,,,82940,82940,0,0,0,0.00,54
,20160719,82940,82940,84660,85840,84660,85840,85530,2900,2590,40,342.15,60
,20160720,85840,85530,83660,83730,83660,83730,83680,-1800,-1850,6,50.21,56
,20160721,83730,83680,,,,83680,83680,0,0,0,0.00,56
,20160722,83680,83680,,,,83680,83680,0,0,0,0.00,56
,20160725,83680,83680,,,,83680,83680,0,0,0,0.00,56
,20160726,83680,83680,82100,82500,82040,82040,82330,-1640,-1350,16,131.74,52
,20160727,82040,82330,82340,82340,82080,82080,82140,-250,-190,8,65.72,50
,20160728,82080,82140,82770,83510,82140,83510,83000,1370,860,10,83.01,52
,20160729,83510,83000,83010,83010,83010,83010,83010,10,10,4,33.20,48
,20160801,83010,83010,83950,83950,83950,83950,83950,940,940,2,16.79,48
,20160802,83950,83950,84750,85200,84750,85200,85040,1250,1090,68,578.33,108
,20160803,85200,85040,85610,85810,84340,84340,85150,-700,110,14,119.21,112
,20160804,84340,85150,83000,83100,82600,82600,82970,-2550,-2180,70,580.85,60
,20160805,82600,82970,,,,82970,82970,0,0,0,0.00,60
,20160808,82970,82970,,,,84130,84130,1160,1160,0,0.00,60
,20160809,84130,84130,,,,84130,84130,0,0,0,0.00,60
,20160810,84130,84130,,,,84130,84130,0,0,0,0.00,60
,20160811,84130,84130,,,,84130,84130,0,0,0,0.00,60
,20160812,84130,84130,,,,84130,84130,0,0,0,0.00,60
,20160815,84130,84130,82830,82990,81680,81680,82660,-2450,-1470,24,198.39,64
,20160816,81680,82660,,,,82660,82660,0,0,0,0.00,64
,20160817,82660,82660,,,,82660,82660,0,0,0,0.00,64
,20160818,82660,82660,81880,81880,81880,81880,81880,-780,-780,2,16.38,64
,20160819,81880,81880,82060,82060,82060,82060,82060,180,180,2,16.41,64
,20160822,82060,82060,,,,82060,82060,0,0,0,0.00,64
,20160823,82060,82060,81940,81940,81940,81940,81940,-120,-120,4,32.78,62
,20160824,81940,81940,,,,81940,81940,0,0,0,0.00,62
,20160825,81940,81940,,,,79270,79270,-2670,-2670,0,0.00,62
,20160826,79270,79270,,,,79270,79270,0,0,0,0.00,62
,20160829,79270,79270,,,,79270,79270,0,0,0,0.00,62
,20160830,79270,79270,,,,79270,79270,0,0,0,0.00,62
,20160831,79270,79270,,,,79270,79270,0,0,0,0.00,62
,20160901,79270,79270,,,,79270,79270,0,0,0,0.00,62
,20160902,79270,79270,,,,79270,79270,0,0,0,0.00,62
,20160905,79270,79270,,,,79270,79270,0,0,0,0.00,62
,20160906,79270,79270,,,,79250,79250,-20,-20,0,0.00,62
,20160907,79250,79250,,,,79700,79700,450,450,0,0.00,62
,20160908,79700,79700,,,,80530,80530,830,830,0,0.00,62
,20160909,80530,80530,,,,80530,80530,0,0,0,0.00,62
,20160912,80530,80530,,,,80530,80530,0,0,0,0.00,62
,20160913,80530,80530,,,,80530,80530,0,0,0,0.00,62
,20160914,80530,80530,79140,79140,79140,79140,79140,-1390,-1390,10,79.14,58
,20160919,79140,79140,79680,80130,79640,79640,79840,500,700,10,79.84,64
,20160920,79640,79840,,,,80910,80910,1070,1070,0,0.00,64
,20160921,80910,80910,,,,80910,80910,0,0,0,0.00,64
,20160922,80910,80910,81980,81980,81980,81980,81980,1070,1070,2,16.40,62
,20160923,81980,81980,,,,81980,81980,0,0,0,0.00,62
,20160926,81980,81980,,,,81980,81980,0,0,0,0.00,62
,20160927,81980,81980,,,,81980,81980,0,0,0,0.00,62
,20160928,81980,81980,,,,81980,81980,0,0,0,0.00,62
,20160929,81980,81980,,,,81980,81980,0,0,0,0.00,62
,20160930,81980,81980,,,,80670,80670,-1310,-1310,0,0.00,62
,20161010,80670,80670,,,,80670,80670,0,0,0,0.00,62
,20161011,80670,80670,82300,83570,82300,83560,83110,2890,2440,14,116.36,66
,20161012,83560,83110,,,,83110,83110,0,0,0,0.00,66
,20161013,83110,83110,,,,82810,82810,-300,-300,0,0.00,66
,20161014,82810,82810,82390,82390,82090,82090,82240,-720,-570,20,164.48,66
,20161017,82090,82240,83980,83980,82600,82910,83220,670,980,36,299.61,70
,20161018,82910,83220,82700,82700,82490,82490,82590,-730,-630,4,33.04,66
,20161019,82490,82590,82660,82660,82660,82660,82660,70,70,8,66.13,66
,20161020,82660,82660,82660,84020,80790,81280,81880,-1380,-780,152,"1,244.70",76
,20161021,81280,81880,81210,81260,80500,80500,81040,-1380,-840,38,307.96,98
,20161024,80500,81040,,,,81040,81040,0,0,0,0.00,98
,20161025,81040,81040,83270,83270,82450,82450,82860,1410,1820,4,33.14,98
,20161026,82450,82860,82040,82040,82040,82040,82040,-820,-820,6,49.22,104
,20161027,82040,82040,81750,82640,81750,82640,82190,600,150,4,32.88,104
,20161028,82640,82190,83480,83480,82890,83040,83120,850,930,24,199.51,92
,20161031,83040,83120,83350,83780,82850,83040,83230,-80,110,30,249.71,88
,20161101,83040,83230,,,,83840,83840,610,610,0,0.00,88
,20161102,83840,83840,85200,85200,83210,83380,83970,-460,130,30,251.92,76
,20161103,83380,83970,83780,83780,83780,83780,83780,-190,-190,4,33.51,76
,20161104,83780,83780,84530,84530,84530,84530,84530,750,750,2,16.91,76
,20161107,84530,84530,88300,88300,88300,88300,88300,3770,3770,2,17.66,76
,20161108,88300,88300,89720,89720,89720,89720,89720,1420,1420,2,17.94,76
,20161109,89720,89720,90900,92210,90780,92210,91290,2490,1570,6,54.78,78
,20161110,92210,91290,94490,95930,94490,95930,95210,4640,3920,4,38.08,80
,20161111,95930,95210,95120,95850,94190,95610,95190,400,-20,20,190.40,80
,20161114,95610,95190,100100,100100,90710,92700,92690,-2490,-2500,30,278.08,88
,20161115,92700,92690,92020,94500,91690,94500,92930,1810,240,46,427.48,88
,20161116,94500,92930,91950,91950,91950,91950,91950,-980,-980,2,18.39,86
,20161117,91950,91950,92810,92830,92360,92360,92790,410,840,46,426.87,118
,20161118,92360,92790,91390,91390,91390,91390,91390,-1400,-1400,2,18.28,118
,20161121,91390,91390,91120,91770,91100,91500,91340,110,-50,84,767.26,88
,20161122,91500,91340,92480,94510,92480,94100,93800,2760,2460,70,656.65,100
,20161123,94100,93800,94050,94050,93420,93430,93530,-370,-270,24,224.48,82
,20161124,93430,93530,95510,97990,94970,95700,95610,2170,2080,54,516.32,100
,20161125,95700,95610,95520,95940,95520,95900,95780,290,170,22,210.72,86
,20161128,95900,95780,96060,96060,96060,96060,96060,280,280,2,19.21,86
,20161129,96060,96060,96770,97070,94420,94420,96640,-1640,580,296,"2,860.72",288
,20161130,94420,96640,94550,94710,90160,90160,92660,-6480,-3980,130,"1,204.65",294
,20161201,90160,92660,91620,92740,91620,92740,91930,80,-730,20,183.88,296
,20161202,92740,91930,,,,91930,91930,0,0,0,0.00,296
,20161205,91930,91930,,,,94530,94530,2600,2600,0,0.00,296
,20161206,94530,94530,96080,96080,95950,95950,95970,1420,1440,10,95.98,288
,20161207,95950,95970,95850,95850,95120,95120,95480,-850,-490,4,38.19,288
,20161208,95120,95480,96430,96440,94770,94770,95640,-710,160,22,210.42,288
,20161209,94770,95640,92700,95280,92250,94610,93800,-1030,-1840,132,"1,238.20",304
,20161212,94610,93800,94960,96690,94960,96690,96070,2890,2270,18,172.94,300
,20161213,96690,96070,94830,95280,94800,95280,94880,-790,-1190,18,170.78,294
,20161214,95280,94880,,,,95330,95330,450,450,0,0.00,294
,20161215,95330,95330,95080,95700,94810,94830,95270,-500,-60,14,133.38,294
,20161216,94830,95270,94910,95450,94910,95310,95050,40,-220,18,171.11,288
,20161219,95310,95050,94920,94920,94400,94400,94740,-650,-310,6,56.85,286
,20161220,94400,94740,92350,92350,92350,92350,92350,-2390,-2390,4,36.94,286
,20161221,92350,92350,92120,92730,91920,92200,92220,-150,-130,234,"2,158.06",200
,20161222,92200,92220,92100,92100,91360,91360,91630,-860,-590,22,201.60,206
,20161223,91360,91630,89790,90490,89650,89650,89860,-1980,-1770,30,269.61,210
,20161226,89650,89860,84000,84200,83570,83570,84010,-6290,-5850,34,285.64,212
,20161227,83570,84010,84200,84810,84130,84370,84370,360,360,30,253.11,210
,20161228,84370,84370,85010,86930,84740,85930,86090,1560,1720,92,792.11,212
,20161229,85930,86090,85310,85620,84560,85480,85020,-610,-1070,214,"1,819.62",212
,20161230,85480,85020,,,,85020,85020,0,0,0,0.00,212
ni1704,20160418,72490,72490,,,,72180,72180,-310,-310,0,0.00,0
,20160419,72180,72180,,,,71840,71840,-340,-340,0,0.00,0
,20160420,71840,71840,,,,72980,72980,1140,1140,0,0.00,0
,20160421,72980,72980,,,,74460,74460,1480,1480,0,0.00,0
,20160422,74460,74460,75430,75430,71290,73170,73700,-1290,-760,14,103.18,4
,20160425,73170,73700,74370,74370,74370,74370,74370,670,670,2,14.87,2
,20160426,74370,74370,,,,74370,74370,0,0,0,0.00,2
,20160427,74370,74370,,,,74370,74370,0,0,0,0.00,2
,20160428,74370,74370,74370,74370,74370,74370,74370,0,0,6,44.62,8
,20160429,74370,74370,74630,74640,74630,74640,74630,270,260,12,89.56,18
,20160503,74640,74630,75940,75940,75940,75940,75940,1310,1310,2,15.19,18
,20160504,75940,75940,,,,75940,75940,0,0,0,0.00,18
,20160505,75940,75940,,,,75940,75940,0,0,0,0.00,18
,20160506,75940,75940,,,,75940,75940,0,0,0,0.00,18
,20160509,75940,75940,,,,74570,74570,-1370,-1370,0,0.00,18
,20160510,74570,74570,,,,71550,71550,-3020,-3020,0,0.00,18
,20160511,71550,71550,,,,71550,71550,0,0,0,0.00,18
,20160512,71550,71550,,,,71550,71550,0,0,0,0.00,18
,20160513,71550,71550,,,,71550,71550,0,0,0,0.00,18
,20160516,71550,71550,,,,71390,71390,-160,-160,0,0.00,18
,20160517,71390,71390,,,,71360,71360,-30,-30,0,0.00,18
,20160518,71360,71360,,,,71360,71360,0,0,0,0.00,18
,20160519,71360,71360,,,,70900,70900,-460,-460,0,0.00,18
,20160520,70900,70900,,,,70900,70900,0,0,0,0.00,18
,20160523,70900,70900,,,,69790,69790,-1110,-1110,0,0.00,18
,20160524,69790,69790,,,,69500,69500,-290,-290,0,0.00,18
,20160525,69500,69500,68160,68160,68160,68160,68160,-1340,-1340,2,13.63,18
,20160526,68160,68160,,,,68330,68330,170,170,0,0.00,18
,20160527,68330,68330,,,,68130,68130,-200,-200,0,0.00,18
,20160530,68130,68130,,,,68130,68130,0,0,0,0.00,18
,20160531,68130,68130,,,,68130,68130,0,0,0,0.00,18
,20160601,68130,68130,,,,68130,68130,0,0,0,0.00,18
,20160602,68130,68130,,,,68010,68010,-120,-120,0,0.00,18
,20160603,68010,68010,69670,69670,69670,69670,69670,1660,1660,2,13.93,18
,20160606,69670,69670,,,,69670,69670,0,0,0,0.00,18
,20160607,69670,69670,71760,71760,70140,70140,70950,470,1280,4,28.38,20
,20160608,70140,70950,,,,70950,70950,0,0,0,0.00,20
,20160613,70950,70950,,,,70950,70950,0,0,0,0.00,20
,20160614,70950,70950,,,,70950,70950,0,0,0,0.00,20
,20160615,70950,70950,,,,70950,70950,0,0,0,0.00,20
,20160616,70950,70950,,,,70950,70950,0,0,0,0.00,20
,20160617,70950,70950,,,,70290,70290,-660,-660,0,0.00,20
,20160620,70290,70290,,,,71560,71560,1270,1270,0,0.00,20
,20160621,71560,71560,,,,71940,71940,380,380,0,0.00,20
,20160622,71940,71940,,,,71440,71440,-500,-500,0,0.00,20
,20160623,71440,71440,,,,71440,71440,0,0,0,0.00,20
,20160624,71440,71440,74180,75250,73060,73190,74110,1750,2670,138,"1,022.78",22
,20160627,73190,74110,72990,72990,72990,72990,72990,-1120,-1120,4,29.20,22
,20160628,72990,72990,73530,73530,73530,73530,73530,540,540,2,14.71,22
,20160629,73530,73530,75970,75970,75970,75970,75970,2440,2440,4,30.39,22
,20160630,75970,75970,76980,76980,76980,76980,76980,1010,1010,8,61.58,14
,20160701,76980,76980,,,,76980,76980,0,0,0,0.00,14
,20160704,76980,76980,,,,81260,81260,4280,4280,0,0.00,14
,20160705,81260,81260,,,,81930,81930,670,670,0,0.00,14
,20160706,81930,81930,80190,80190,78420,79950,79230,-1980,-2700,12,95.08,22
,20160707,79950,79230,79870,82770,79870,82770,81310,3540,2080,6,48.79,22
,20160708,82770,81310,,,,79560,79560,-1750,-1750,0,0.00,22
,20160711,79560,79560,,,,79560,79560,0,0,0,0.00,22
,20160712,79560,79560,,,,81350,81350,1790,1790,0,0.00,22
,20160713,81350,81350,,,,83290,83290,1940,1940,0,0.00,22
,20160714,83290,83290,83560,83560,83550,83550,83550,260,260,8,66.84,22
,20160715,83550,83550,,,,83550,83550,0,0,0,0.00,22
,20160718,83550,83550,,,,83550,83550,0,0,0,0.00,22
,20160719,83550,83550,,,,83550,83550,0,0,0,0.00,22
,20160720,83550,83550,,,,83550,83550,0,0,0,0.00,22
,20160721,83550,83550,,,,83550,83550,0,0,0,0.00,22
,20160722,83550,83550,,,,83550,83550,0,0,0,0.00,22
,20160725,83550,83550,,,,83550,83550,0,0,0,0.00,22
,20160726,83550,83550,,,,82200,82200,-1350,-1350,0,0.00,22
,20160727,82200,82200,82490,82490,82490,82490,82490,290,290,2,16.50,22
,20160728,82490,82490,,,,82490,82490,0,0,0,0.00,22
,20160729,82490,82490,82900,82900,82900,82900,82900,410,410,4,33.16,18
,20160801,82900,82900,,,,82900,82900,0,0,0,0.00,18
,20160802,82900,82900,85150,85150,83840,85000,84610,2100,1710,28,236.93,22
,20160803,85000,84610,,,,84610,84610,0,0,0,0.00,22
,20160804,84610,84610,,,,84610,84610,0,0,0,0.00,22
,20160805,84610,84610,,,,84610,84610,0,0,0,0.00,22
,20160808,84610,84610,,,,84610,84610,0,0,0,0.00,22
,20160809,84610,84610,,,,84610,84610,0,0,0,0.00,22
,20160810,84610,84610,,,,84610,84610,0,0,0,0.00,22
,20160811,84610,84610,,,,84610,84610,0,0,0,0.00,22
,20160812,84610,84610,,,,84610,84610,0,0,0,0.00,22
,20160815,84610,84610,,,,83130,83130,-1480,-1480,0,0.00,22
,20160816,83130,83130,,,,83130,83130,0,0,0,0.00,22
,20160817,83130,83130,,,,83130,83130,0,0,0,0.00,22
,20160818,83130,83130,,,,83130,83130,0,0,0,0.00,22
,20160819,83130,83130,,,,83130,83130,0,0,0,0.00,22
,20160822,83130,83130,,,,83130,83130,0,0,0,0.00,22
,20160823,83130,83130,,,,83130,83130,0,0,0,0.00,22
,20160824,83130,83130,,,,83130,83130,0,0,0,0.00,22
,20160825,83130,83130,,,,80420,80420,-2710,-2710,0,0.00,22
,20160826,80420,80420,,,,80420,80420,0,0,0,0.00,22
,20160829,80420,80420,,,,80420,80420,0,0,0,0.00,22
,20160830,80420,80420,,,,80420,80420,0,0,0,0.00,22
,20160831,80420,80420,,,,80420,80420,0,0,0,0.00,22
,20160901,80420,80420,,,,80420,80420,0,0,0,0.00,22
,20160902,80420,80420,,,,80420,80420,0,0,0,0.00,22
,20160905,80420,80420,80820,81510,80820,81510,81070,1090,650,130,"1,054.03",26
,20160906,81510,81070,,,,81070,81070,0,0,0,0.00,26
,20160907,81070,81070,,,,81070,81070,0,0,0,0.00,26
,20160908,81070,81070,82110,82180,81190,81850,81750,780,680,30,245.25,36
,20160909,81850,81750,,,,81750,81750,0,0,0,0.00,36
,20160912,81750,81750,,,,80610,80610,-1140,-1140,0,0.00,36
,20160913,80610,80610,,,,80610,80610,0,0,0,0.00,36
,20160914,80610,80610,,,,80610,80610,0,0,0,0.00,36
,20160919,80610,80610,,,,81320,81320,710,710,0,0.00,36
,20160920,81320,81320,,,,81320,81320,0,0,0,0.00,36
,20160921,81320,81320,,,,81320,81320,0,0,0,0.00,36
,20160922,81320,81320,82090,82090,82090,82090,82090,770,770,4,32.84,32
,20160923,82090,82090,82570,82570,82570,82570,82570,480,480,2,16.51,32
,20160926,82570,82570,,,,82570,82570,0,0,0,0.00,32
,20160927,82570,82570,,,,82570,82570,0,0,0,0.00,32
,20160928,82570,82570,,,,82570,82570,0,0,0,0.00,32
,20160929,82570,82570,,,,82570,82570,0,0,0,0.00,32
,20160930,82570,82570,,,,81250,81250,-1320,-1320,0,0.00,32
,20161010,81250,81250,,,,81250,81250,0,0,0,0.00,32
,20161011,81250,81250,83350,83470,83350,83470,83430,2220,2180,6,50.06,36
,20161012,83470,83430,,,,83430,83430,0,0,0,0.00,36
,20161013,83430,83430,,,,83430,83430,0,0,0,0.00,36
,20161014,83430,83430,,,,83430,83430,0,0,0,0.00,36
,20161017,83430,83430,,,,83430,83430,0,0,0,0.00,36
,20161018,83430,83430,82750,82750,82180,82350,82500,-1080,-930,8,66.01,40
,20161019,82350,82500,,,,82450,82450,-50,-50,0,0.00,40
,20161020,82450,82450,,,,82450,82450,0,0,0,0.00,40
,20161021,82450,82450,,,,81520,81520,-930,-930,0,0.00,40
,20161024,81520,81520,81490,81490,81490,81490,81490,-30,-30,4,32.60,36
,20161025,81490,81490,,,,81760,81760,270,270,0,0.00,36
,20161026,81760,81760,81630,81790,81630,81790,81670,30,-90,18,147.02,36
,20161027,81790,81670,82360,82360,82360,82360,82360,690,690,2,16.47,36
,20161028,82360,82360,83180,83180,83180,83180,83180,820,820,40,332.72,70
,20161031,83180,83180,,,,83180,83180,0,0,0,0.00,70
,20161101,83180,83180,85000,85000,83630,84390,84340,1210,1160,80,674.77,78
,20161102,84390,84340,,,,84200,84200,-140,-140,0,0.00,78
,20161103,84200,84200,,,,84200,84200,0,0,0,0.00,78
,20161104,84200,84200,,,,84200,84200,0,0,0,0.00,78
,20161107,84200,84200,85310,89250,85310,88930,88200,4730,4000,24,211.68,78
,20161108,88930,88200,88540,88540,88540,88540,88540,340,340,2,17.71,78
,20161109,88540,88540,90710,91860,90710,91860,91120,3320,2580,22,200.48,74
,20161110,91860,91120,96550,96550,96550,96550,96550,5430,5430,2,19.31,76
,20161111,96550,96550,96920,97950,95150,97580,97140,1030,590,32,310.88,90
,20161114,97580,97140,91310,95000,91310,91520,92350,-5620,-4790,52,480.26,102
,20161115,91520,92350,92780,93890,91430,93890,93290,1540,940,18,167.92,98
,20161116,93890,93290,93230,94360,93230,93910,93920,620,630,46,432.04,96
,20161117,93910,93920,93240,93240,93240,93240,93240,-680,-680,2,18.65,96
,20161118,93240,93240,93260,93260,92660,92660,92960,-580,-280,4,37.18,96
,20161121,92660,92960,,,,92960,92960,0,0,0,0.00,96
,20161122,92960,92960,92580,95750,92580,94690,94340,1730,1380,6,56.60,98
,20161123,94690,94340,94270,94520,94130,94130,94300,-210,-40,6,56.58,98
,20161124,94130,94300,95200,98210,94050,96610,95690,2310,1390,54,516.76,96
,20161125,96610,95690,,,,95690,95690,0,0,0,0.00,96
,20161128,95690,95690,,,,97770,97770,2080,2080,0,0.00,96
,20161129,97770,97770,98160,98600,94340,94340,96580,-3430,-1190,12,115.90,94
,20161130,94340,96580,93320,93320,93320,93320,93320,-3260,-3260,4,37.33,98
,20161201,93320,93320,91460,91460,91460,91460,91460,-1860,-1860,2,18.29,98
,20161202,91460,91460,,,,91460,91460,0,0,0,0.00,98
,20161205,91460,91460,95070,95810,94710,95300,95130,3840,3670,42,399.55,94
,20161206,95300,95130,,,,95130,95130,0,0,0,0.00,94
,20161207,95130,95130,,,,95410,95410,280,280,0,0.00,94
,20161208,95410,95410,,,,95410,95410,0,0,0,0.00,94
,20161209,95410,95410,95320,95380,94690,95020,95060,-390,-350,28,266.18,92
,20161212,95020,95060,101710,101710,95900,96910,97170,1850,2110,40,388.70,94
,20161213,96910,97170,95000,96170,94700,95510,95120,-1660,-2050,30,285.36,88
,20161214,95510,95120,96310,96310,94010,94010,95340,-1110,220,10,95.35,90
,20161215,94010,95340,95560,96890,95460,96630,96130,1290,790,8,76.91,92
,20161216,96630,96130,,,,95800,95800,-330,-330,0,0.00,92
,20161219,95800,95800,94660,94660,93600,94250,94030,-1550,-1770,124,"1,165.99",104
,20161220,94250,94030,92380,92380,91890,92210,92160,-1820,-1870,18,165.90,96
,20161221,92210,92160,92700,92700,92700,92700,92700,540,540,2,18.54,96
,20161222,92700,92700,92310,92310,91700,91700,92000,-1000,-700,4,36.80,98
,20161223,91700,92000,,,,90760,90760,-1240,-1240,0,0.00,98
,20161226,90760,90760,87850,87850,85920,85920,86880,-4840,-3880,12,104.26,98
,20161227,85920,86880,84590,84830,84330,84630,84490,-2250,-2390,32,270.40,104
,20161228,84630,84490,,,,84810,84810,320,320,0,0.00,104
,20161229,84810,84810,85690,85690,85690,85690,85690,880,880,2,17.14,104
,20161230,85690,85690,85060,85060,85060,85060,85060,-630,-630,8,68.05,104
ni1705,20160517,71390,71390,71610,72600,69300,71650,71290,260,-100,208,"1,483.02",76
,20160518,71650,71290,71060,71960,70510,70750,71110,-540,-180,88,625.81,100
,20160519,70750,71110,70320,71280,70320,70650,70880,-460,-230,124,878.97,150
,20160520,70650,70880,70010,70850,70010,70560,70570,-320,-310,166,"1,171.62",206
,20160523,70560,70570,70560,70570,69000,69350,69560,-1220,-1010,302,"2,100.98",334
,20160524,69350,69560,69110,69550,68740,69220,69240,-340,-320,268,"1,855.89",420
,20160525,69220,69240,69470,69940,69000,69000,69360,-240,120,202,"1,401.18",500
,20160526,69000,69360,69200,69750,69060,69460,69350,100,-10,122,846.18,516
,20160527,69460,69350,69920,69920,68530,69550,69170,200,-180,74,511.90,522
,20160530,69550,69170,69500,69810,68760,69250,69370,80,200,78,541.16,520
,20160531,69250,69370,69580,70670,69580,70200,70270,830,900,214,"1,503.79",632
,20160601,70200,70270,70450,70450,69160,69210,69620,-1060,-650,328,"2,283.56",826
,20160602,69210,69620,69220,70000,69020,69650,69510,30,-110,90,625.63,810
,20160603,69650,69510,69720,69970,69610,69840,69770,330,260,90,628.00,834
,20160606,69840,69770,70700,71390,69990,71310,71040,1540,1270,302,"2,145.65",982
,20160607,71310,71040,71530,71620,70890,70990,71140,-50,100,314,"2,234.07",1110
,20160608,70990,71140,70800,71350,70530,71100,70820,-40,-320,110,779.04,1124
,20160613,71100,70820,71800,73000,71800,72510,72450,1690,1630,150,"1,086.87",1132
,20160614,72510,72450,72640,72910,72460,72720,72630,270,180,194,"1,409.10",1212
,20160615,72720,72630,72460,73500,72440,73440,73030,810,400,158,"1,153.92",1238
,20160616,73440,73030,74700,74700,72530,72540,73310,-490,280,278,"2,038.11",1330
,20160617,72540,73310,72580,73830,72130,73830,72690,520,-620,232,"1,686.47",1296
,20160620,73830,72690,73710,75120,73570,74770,74520,2080,1830,486,"3,621.94",1528
,20160621,74770,74520,74950,75680,74410,74680,75030,160,510,400,"3,001.32",1690
,20160622,74680,75030,74630,75140,73910,75140,74500,110,-530,250,"1,862.68",1764
,20160623,75140,74500,75090,75250,74000,74300,74470,-200,-30,278,"2,070.42",1836
,20160624,74300,74470,74470,74710,72310,72810,73190,-1660,-1280,688,"5,035.53",2192
,20160627,72810,73190,73050,74190,73050,74000,73600,810,410,506,"3,724.17",2408
,20160628,74000,73600,73870,75300,73500,75130,74240,1530,640,532,"3,949.92",2570
,20160629,75130,74240,75400,76380,75210,75930,75700,1690,1460,1318,"9,978.30",3218
,20160630,75930,75700,76250,77920,75960,77740,77170,2040,1470,1818,"14,031.25",4298
,20160701,77740,77170,77250,78550,76300,78360,77350,1190,180,1654,"12,795.24",4718
,20160704,78360,77350,78410,81990,78150,81990,80660,4640,3310,1516,"12,228.74",5014
,20160705,81990,80660,84380,86030,79930,83340,82930,2680,2270,2224,"18,444.93",5394
,20160706,83340,82930,83690,84680,78410,80750,81000,-2180,-1930,2354,"19,068.69",5716
,20160707,80750,81000,80080,83370,79350,80080,81500,-920,500,2150,"17,524.58",6174
,20160708,80080,81500,80300,81100,77900,79570,79440,-1930,-2060,1738,"13,807.03",6548
,20160711,79570,79440,80600,82540,79840,82090,80880,2650,1440,1834,"14,833.72",6742
,20160712,82090,80880,82340,84230,81740,84100,82610,3220,1730,1518,"12,541.23",7038
,20160713,84100,82610,84100,86320,83000,83230,84840,620,2230,2596,"22,025.82",7330
,20160714,83230,84840,83000,84900,82640,84740,83830,-100,-1010,1202,"10,076.59",7510
,20160715,84740,83830,84400,85140,83180,84150,83990,320,160,1082,"9,087.88",7694
,20160718,84150,83990,84690,85000,82440,83890,83710,-100,-280,2000,"16,743.31",7536
,20160719,83890,83710,83960,86610,83300,84840,85300,1130,1590,2174,"18,545.84",7720
,20160720,84840,85300,84730,85360,83700,84410,84440,-890,-860,1952,"16,483.59",8140
,20160721,84410,84440,83930,85650,83430,85070,84690,630,250,1534,"12,991.47",8146
,20160722,85070,84690,85830,86950,83900,83910,85460,-780,770,1940,"16,579.77",8316
,20160725,83910,85460,84310,84560,82440,83260,83300,-2200,-2160,2084,"17,359.84",8288
,20160726,83260,83300,83500,83660,81520,82310,82800,-990,-500,4350,"36,021.47",9842
,20160727,82310,82800,82250,83500,82000,82200,82700,-600,-100,2738,"22,644.66",10466
,20160728,82200,82700,82700,84390,82570,84390,83550,1690,850,2332,"19,483.93",10748
,20160729,84390,83550,84580,84760,82980,83030,83860,-520,310,4098,"34,368.01",12652
,20160801,83030,83860,83300,85290,82640,85130,83740,1270,-120,2614,"21,891.80",13026
,20160802,85130,83740,85130,86490,84470,86490,85140,2750,1400,1680,"14,304.53",13232
,20160803,86490,85140,86560,86920,84780,85240,85670,100,530,2088,"17,888.78",13442
,20160804,85240,85670,85460,85880,82970,83530,84430,-2140,-1240,2440,"20,601.33",13756
,20160805,83530,84430,83150,84460,83030,84300,83900,-130,-530,1522,"12,769.67",13884
,20160808,84300,83900,84010,86180,83540,85840,85180,1940,1280,1618,"13,783.73",14206
,20160809,85840,85180,85580,86040,84600,85050,85490,-130,310,2576,"22,023.37",14894
,20160810,85050,85490,84720,85990,84500,85570,85190,80,-300,1526,"13,001.49",14988
,20160811,85570,85190,85990,86500,84100,84760,85310,-430,120,1808,"15,425.37",14996
,20160812,84760,85310,84570,85200,84000,84510,84640,-800,-670,1628,"13,779.59",15394
,20160815,84510,84640,83990,83990,81900,82300,82850,-2340,-1790,3412,"28,268.60",16040
,20160816,82300,82850,82420,83400,82420,82960,83020,110,170,1302,"10,810.13",16286
,20160817,82960,83020,82770,83080,82100,82460,82660,-560,-360,1526,"12,615.12",16492
,20160818,82460,82660,82460,83190,81720,82820,82690,160,30,2204,"18,226.43",17154
,20160819,82820,82690,83020,83090,82350,82860,82760,170,70,3148,"26,054.18",17952
,20160822,82860,82760,82720,83500,81930,82030,82640,-730,-120,2752,"22,744.25",18752
,20160823,82030,82640,82030,82870,81770,82530,82500,-110,-140,1870,"15,427.57",18614
,20160824,82530,82500,82650,82950,82220,82290,82530,-210,30,992,"8,187.50",18598
,20160825,82290,82530,82450,82600,79000,79710,80220,-2820,-2310,6768,"54,297.22",18948
,20160826,79710,80220,79150,80110,79150,79600,79760,-620,-460,3952,"31,521.96",19818
,20160829,79600,79760,79600,80580,79330,79890,79940,130,180,2874,"22,975.28",20292
,20160830,79890,79940,79850,80170,79330,79460,79850,-480,-90,2832,"22,614.81",20526
,20160831,79460,79850,79210,79940,79190,79360,79610,-490,-240,5466,"43,517.55",20526
,20160901,79360,79610,79340,80390,79330,80090,79900,480,290,6756,"53,986.24",21722
,20160902,80090,79900,79890,81670,79580,81050,80580,1150,680,11562,"93,170.65",24560
,20160905,81050,80580,80600,82080,80600,81500,81640,920,1060,11038,"90,115.68",24832
,20160906,81500,81640,81570,82330,80700,82280,81620,640,-20,5882,"48,009.10",25244
,20160907,82280,81620,82280,82520,81630,82180,82050,560,430,5142,"42,195.13",25360
,20160908,82180,82050,82250,82660,81650,82260,82240,210,190,6316,"51,946.36",25894
,20160909,82260,82240,82560,82800,82140,82560,82500,320,260,4686,"38,663.24",25958
,20160912,82560,82500,82740,82780,79760,80080,81150,-2420,-1350,8260,"67,032.40",25510
,20160913,80080,81150,80330,80980,79940,80640,80430,-510,-720,5846,"47,021.16",25676
,20160914,80640,80430,80470,80770,79300,79600,79800,-830,-630,4944,"39,455.43",25768
,20160919,79600,79800,79270,80660,79230,80170,80200,370,400,5722,"45,891.96",25816
,20160920,80170,80200,80280,81970,80280,81830,81170,1630,970,7048,"57,209.95",26468
,20160921,81830,81170,81990,82350,81470,81890,81830,720,660,5612,"45,927.20",27372
,20160922,81890,81830,82300,83880,81600,82910,82830,1080,1000,9000,"74,548.22",27666
,20160923,82910,82830,83610,83990,83180,83960,83510,1130,680,6078,"50,758.01",28488
,20160926,83960,83510,83880,84180,82760,82780,83490,-730,-20,8088,"67,530.61",27690
,20160927,82780,83490,82780,84080,81510,83990,82860,500,-630,10836,"89,787.40",26740
,20160928,83990,82860,84100,84290,82800,83490,83450,630,590,7524,"62,790.81",26450
,20160929,83490,83450,83260,84890,82860,83150,83970,-300,520,9530,"80,027.32",26166
,20160930,83150,83970,83770,83770,81720,82710,82570,-1260,-1400,7406,"61,157.71",25074
,20161010,82710,82570,82020,83240,81500,82900,82390,330,-180,6638,"54,695.39",25794
,20161011,82900,82390,82790,84380,82790,84230,83660,1840,1270,14174,"118,582.90",29206
,20161012,84230,83660,83800,84460,83300,83740,83860,80,200,11122,"93,278.30",30554
,20161013,83740,83860,84320,84320,82240,82670,83740,-1190,-120,24892,"208,465.06",33558
,20161014,82670,83740,82660,83570,82000,82990,82890,-750,-850,15734,"130,428.48",35570
,20161017,82990,82890,83040,83880,82800,83250,83410,360,520,28400,"236,910.08",44948
,20161018,83250,83410,83540,83540,82310,83160,82940,-250,-470,25718,"213,325.87",50052
,20161019,83160,82940,83160,83780,81900,82200,82940,-740,0,23416,"194,234.21",52670
,20161020,82200,82940,82350,82690,81270,82140,82230,-800,-710,23964,"197,061.67",55148
,20161021,82140,82230,81920,82060,80760,80920,81360,-1310,-870,28566,"232,421.39",61646
,20161024,80920,81360,80840,82100,80500,81800,81220,440,-140,24404,"198,220.78",68348
,20161025,81800,81220,81800,83250,81610,82760,82490,1540,1270,37648,"310,579.23",76190
,20161026,82760,82490,83000,83690,81910,82350,82710,-140,220,43234,"357,606.73",78112
,20161027,82350,82710,82350,83190,81760,82250,82510,-460,-200,30258,"249,674.99",81656
,20161028,82250,82510,82960,83960,82730,83870,83480,1360,970,35860,"299,387.87",84388
,20161031,83870,83480,83920,85320,83480,85220,84150,1740,670,48956,"411,980.20",92286
,20161101,85220,84150,85250,85600,84200,84870,84910,720,760,46260,"392,821.47",93706
,20161102,84870,84910,84830,85750,83080,83600,84460,-1310,-450,54624,"461,372.39",92106
,20161103,83600,84460,84000,84740,83530,84590,84140,130,-320,41506,"349,251.43",98402
,20161104,84590,84140,84900,85430,84100,84270,84720,130,580,58756,"497,783.61",101508
,20161107,84270,84720,84420,89800,83880,89280,87530,4560,2810,164318,"1,438,385.44",146262
,20161108,89280,87530,89490,92250,88520,91140,90210,3610,2680,153554,"1,385,246.56",158304
,20161109,91140,90210,90980,93000,89960,92260,91500,2050,1290,163512,"1,496,140.50",157600
,20161110,92260,91500,93080,96990,92940,96990,94950,5490,3450,165504,"1,571,556.96",166406
,20161111,96990,94950,96990,98620,94400,97620,96250,2670,1300,178638,"1,719,523.90",180762
,20161114,97620,96250,97510,101360,90470,93100,94510,-3150,-1740,301568,"2,850,390.89",189058
,20161115,93100,94510,93100,95600,90850,92100,93020,-2410,-1490,191262,"1,779,269.81",199776
,20161116,92100,93020,92440,94300,92000,94010,93070,990,50,156522,"1,456,902.72",210582
,20161117,94010,93070,93500,93740,92390,92690,93030,-380,-40,164852,"1,533,727.73",228144
,20161118,92690,93030,93050,93360,91370,92260,92390,-770,-640,140520,"1,298,316.77",243376
,20161121,92260,92390,92320,93360,89500,92820,91820,430,-570,227680,"2,090,773.76",265792
,20161122,92820,91820,93100,95980,92310,94830,94190,3010,2370,239044,"2,251,593.87",273036
,20161123,94830,94190,94300,94850,93600,94400,94340,210,150,152414,"1,437,922.63",281776
,20161124,94400,94340,94180,98300,93820,96120,96340,1780,2000,346902,"3,342,065.22",320136
,20161125,96120,96340,96340,97860,95250,96700,96710,360,370,279996,"2,708,022.76",334476
,20161128,96700,96710,96550,99300,95600,99220,97590,2510,880,321352,"3,136,222.64",370144
,20161129,99220,97590,98500,99130,94100,94520,96810,-3070,-780,438106,"4,241,352.60",378098
,20161130,94520,96810,95010,95110,90150,91300,92440,-5510,-4370,488862,"4,519,377.27",384376
,20161201,91300,92440,91890,94100,91530,92980,92810,540,370,489010,"4,538,881.66",399788
,20161202,92980,92810,92960,93450,91500,92430,92570,-380,-240,410014,"3,795,592.08",412270
,20161205,92430,92570,92500,96170,92160,95440,94830,2870,2260,755494,"7,164,820.84",460848
,20161206,95440,94830,96200,96800,94620,95300,95680,470,850,482512,"4,616,767.48",449058
,20161207,95300,95680,95350,97170,94820,96790,96210,1110,530,605210,"5,823,253.13",483402
,20161208,96790,96210,96660,97280,94360,95110,95700,-1100,-510,578928,"5,540,529.69",485072
,20161209,95110,95700,95350,95700,92870,95150,94380,-550,-1320,578832,"5,463,159.54",500744
,20161212,95150,94380,95150,97800,94260,94460,96130,80,1750,740996,"7,123,276.99",496320
,20161213,94460,96130,94650,96060,94230,95960,95290,-170,-840,456780,"4,353,100.07",508200
,20161214,95960,95290,96230,96750,93500,96260,95690,970,400,801636,"7,671,245.35",540190
,20161215,96260,95690,96390,97200,94620,96130,95930,440,240,763680,"7,326,398.12",531784
,20161216,96130,95930,95200,96560,94720,95280,95660,-650,-270,551742,"5,278,494.31",532768
,20161219,95280,95660,94500,95420,93350,93390,94610,-2270,-1050,525428,"4,971,481.58",534284
,20161220,93390,94610,93000,93120,90830,92510,92410,-2100,-2200,601532,"5,559,303.40",542136
,20161221,92510,92410,92510,93400,92150,92660,92730,250,320,381176,"3,534,936.05",540978
,20161222,92660,92730,92490,92790,89750,90120,91420,-2610,-1310,493564,"4,512,385.21",556726
,20161223,90120,91420,89800,91360,89620,90150,90530,-1270,-890,459026,"4,156,015.81",550220
,20161226,90150,90530,89940,90420,84190,84190,86750,-6340,-3780,922890,"8,006,804.75",546922
,20161227,84190,86750,84320,85850,83860,85550,84760,-1200,-1990,485794,"4,117,682.98",527964
,20161228,85550,84760,85500,87350,85250,85820,86360,1060,1600,564542,"4,875,726.67",538380
,20161229,85820,86360,85850,86530,84820,86350,85890,-10,-470,467428,"4,014,756.20",532506
,20161230,86350,85890,85850,86350,84920,85560,85760,-330,-130,394134,"3,380,288.38",534940
ni1706,20160616,73030,73030,,,,73030,73030,0,0,0,0.00,0
,20160617,73030,73030,,,,73030,73030,0,0,0,0.00,0
,20160620,73030,73030,,,,73030,73030,0,0,0,0.00,0
,20160621,73030,73030,74920,74920,74920,74920,74920,1890,1890,4,29.97,4
,20160622,74920,74920,75260,75260,75260,75260,75260,340,340,4,30.10,8
,20160623,75260,75260,,,,74600,74600,-660,-660,0,0.00,8
,20160624,74600,74600,73440,73570,73440,73570,73500,-1030,-1100,4,29.40,10
,20160627,73570,73500,,,,73500,73500,0,0,0,0.00,10
,20160628,73500,73500,,,,73500,73500,0,0,0,0.00,10
,20160629,73500,73500,,,,73500,73500,0,0,0,0.00,10
,20160630,73500,73500,77010,77880,77010,77880,77180,4380,3680,10,77.18,18
,20160701,77880,77180,,,,77180,77180,0,0,0,0.00,18
,20160704,77180,77180,,,,80480,80480,3300,3300,0,0.00,18
,20160705,80480,80480,85010,85010,83430,83430,84480,2950,4000,6,50.69,22
,20160706,83430,84480,,,,82510,82510,-1970,-1970,0,0.00,22
,20160707,82510,82510,80590,80590,80080,80080,80330,-2430,-2180,4,32.13,26
,20160708,80080,80330,79500,79500,79050,79050,79270,-1280,-1060,4,31.71,30
,20160711,79050,79270,80500,81230,80500,81230,80930,1960,1660,6,48.56,26
,20160712,81230,80930,82560,82560,82560,82560,82560,1630,1630,4,33.02,30
,20160713,82560,82560,,,,82560,82560,0,0,0,0.00,30
,20160714,82560,82560,,,,81570,81570,-990,-990,0,0.00,30
,20160715,81570,81570,84010,84200,83700,84200,84090,2630,2520,14,117.73,34
,20160718,84200,84090,84630,84950,84630,84760,84750,670,660,18,152.56,40
,20160719,84760,84750,,,,84750,84750,0,0,0,0.00,40
,20160720,84750,84750,84960,84960,84950,84950,84950,200,200,4,33.98,40
,20160721,84950,84950,,,,85250,85250,300,300,0,0.00,40
,20160722,85250,85250,85990,85990,85990,85990,85990,740,740,2,17.20,40
,20160725,85990,85990,83810,83810,83810,83810,83810,-2180,-2180,2,16.76,40
,20160726,83810,83810,,,,83810,83810,0,0,0,0.00,40
,20160727,83810,83810,83860,83860,83860,83860,83860,50,50,10,83.86,40
,20160728,83860,83860,83730,83730,83730,83730,83730,-130,-130,2,16.75,38
,20160729,83730,83730,83730,83730,83730,83730,83730,0,0,4,33.49,38
,20160801,83730,83730,85600,85600,85600,85600,85600,1870,1870,2,17.12,38
,20160802,85600,85600,,,,85600,85600,0,0,0,0.00,38
,20160803,85600,85600,85760,85760,85760,85760,85760,160,160,2,17.15,38
,20160804,85760,85760,84500,84950,83770,83770,84280,-1990,-1480,10,84.28,42
,20160805,83770,84280,,,,84280,84280,0,0,0,0.00,42
,20160808,84280,84280,,,,84280,84280,0,0,0,0.00,42
,20160809,84280,84280,86190,86190,86190,86190,86190,1910,1910,4,34.48,42
,20160810,86190,86190,,,,86190,86190,0,0,0,0.00,42
,20160811,86190,86190,,,,86190,86190,0,0,0,0.00,42
,20160812,86190,86190,85250,85250,85250,85250,85250,-940,-940,2,17.05,40
,20160815,85250,85250,,,,83440,83440,-1810,-1810,0,0.00,40
,20160816,83440,83440,,,,83440,83440,0,0,0,0.00,40
,20160817,83440,83440,,,,83440,83440,0,0,0,0.00,40
,20160818,83440,83440,,,,83440,83440,0,0,0,0.00,40
,20160819,83440,83440,,,,83440,83440,0,0,0,0.00,40
,20160822,83440,83440,,,,83440,83440,0,0,0,0.00,40
,20160823,83440,83440,,,,83440,83440,0,0,0,0.00,40
,20160824,83440,83440,,,,83440,83440,0,0,0,0.00,40
,20160825,83440,83440,,,,81110,81110,-2330,-2330,0,0.00,40
,20160826,81110,81110,80250,80790,80250,80790,80520,-320,-590,4,32.21,38
,20160829,80790,80520,,,,80520,80520,0,0,0,0.00,38
,20160830,80520,80520,,,,80520,80520,0,0,0,0.00,38
,20160831,80520,80520,80160,80160,80160,80160,80160,-360,-360,10,80.16,38
,20160901,80160,80160,,,,80160,80160,0,0,0,0.00,38
,20160902,80160,80160,81140,81140,81140,81140,81140,980,980,8,64.91,46
,20160905,81140,81140,,,,81140,81140,0,0,0,0.00,46
,20160906,81140,81140,,,,81140,81140,0,0,0,0.00,46
,20160907,81140,81140,,,,81140,81140,0,0,0,0.00,46
,20160908,81140,81140,,,,81140,81140,0,0,0,0.00,46
,20160909,81140,81140,,,,81140,81140,0,0,0,0.00,46
,20160912,81140,81140,,,,81140,81140,0,0,0,0.00,46
,20160913,81140,81140,,,,81140,81140,0,0,0,0.00,46
,20160914,81140,81140,,,,81140,81140,0,0,0,0.00,46
,20160919,81140,81140,,,,81540,81540,400,400,0,0.00,46
,20160920,81540,81540,,,,81540,81540,0,0,0,0.00,46
,20160921,81540,81540,,,,81540,81540,0,0,0,0.00,46
,20160922,81540,81540,84020,84020,83270,83380,83570,1840,2030,12,100.28,48
,20160923,83380,83570,84130,84130,84130,84130,84130,560,560,10,84.13,54
,20160926,84130,84130,84000,84000,83460,83470,83830,-660,-300,14,117.37,48
,20160927,83470,83830,,,,83830,83830,0,0,0,0.00,48
,20160928,83830,83830,,,,83830,83830,0,0,0,0.00,48
,20160929,83830,83830,,,,83830,83830,0,0,0,0.00,48
,20160930,83830,83830,,,,82440,82440,-1390,-1390,0,0.00,48
,20161010,82440,82440,,,,82440,82440,0,0,0,0.00,48
,20161011,82440,82440,,,,83710,83710,1270,1270,0,0.00,48
,20161012,83710,83710,,,,83710,83710,0,0,0,0.00,48
,20161013,83710,83710,,,,83710,83710,0,0,0,0.00,48
,20161014,83710,83710,,,,83710,83710,0,0,0,0.00,48
,20161017,83710,83710,,,,83710,83710,0,0,0,0.00,48
,20161018,83710,83710,,,,83710,83710,0,0,0,0.00,48
,20161019,83710,83710,,,,83710,83710,0,0,0,0.00,48
,20161020,83710,83710,81810,82570,81810,82570,82190,-1140,-1520,4,32.88,50
,20161021,82570,82190,,,,82190,82190,0,0,0,0.00,50
,20161024,82190,82190,,,,82190,82190,0,0,0,0.00,50
,20161025,82190,82190,,,,82200,82200,10,10,0,0.00,50
,20161026,82200,82200,83180,83180,83180,83180,83180,980,980,20,166.36,70
,20161027,83180,83180,,,,83180,83180,0,0,0,0.00,70
,20161028,83180,83180,,,,83180,83180,0,0,0,0.00,70
,20161031,83180,83180,,,,84510,84510,1330,1330,0,0.00,70
,20161101,84510,84510,85040,85040,85040,85040,85040,530,530,2,17.01,72
,20161102,85040,85040,85330,85330,85330,85330,85330,290,290,2,17.07,72
,20161103,85330,85330,85260,85380,83940,84230,84700,-1100,-630,14,118.59,72
,20161104,84230,84700,85260,85260,85260,85260,85260,560,560,2,17.05,70
,20161107,85260,85260,85360,85360,85360,85360,85360,100,100,2,17.07,68
,20161108,85360,85360,89500,90480,89500,90420,90180,5060,4820,100,901.88,108
,20161109,90420,90180,91070,91960,91070,91960,91390,1780,1210,16,146.24,120
,20161110,91960,91390,94610,94880,93400,94770,94590,3380,3200,100,945.99,154
,20161111,94770,94590,96860,96860,95200,96220,96040,1630,1450,62,595.49,160
,20161114,96220,96040,97190,97190,91930,94120,93660,-1920,-2380,60,562.01,178
,20161115,94120,93660,93630,94670,92590,93830,93700,170,40,102,955.76,244
,20161116,93830,93700,94130,94130,93580,93580,93850,-120,150,4,37.54,244
,20161117,93580,93850,93550,94510,93020,93400,93820,-450,-30,76,713.09,272
,20161118,93400,93820,93580,94360,92470,92470,93590,-1350,-230,90,842.35,294
,20161121,92470,93590,90600,93800,90600,93330,93220,-260,-370,318,"2,964.67",562
,20161122,93330,93220,93150,95920,93150,95200,94360,1980,1140,272,"2,566.74",698
,20161123,95200,94360,94980,95350,94440,94820,94870,460,510,172,"1,631.84",578
,20161124,94820,94870,95340,98650,95340,97500,96820,2630,1950,724,"7,010.47",366
,20161125,97500,96820,96740,97900,95550,96990,97370,170,550,230,"2,239.67",212
,20161128,96990,97370,97000,99390,96140,99390,97560,2020,190,68,663.44,202
,20161129,99390,97560,98900,98900,94950,95700,96310,-1860,-1250,166,"1,598.85",150
,20161130,95700,96310,94610,94610,92890,92890,94250,-3420,-2060,20,188.51,148
,20161201,92890,94250,93200,93860,92790,93860,93720,-390,-530,26,243.69,166
,20161202,93860,93720,,,,93440,93440,-280,-280,0,0.00,166
,20161205,93440,93440,96060,96060,95110,95110,95580,1670,2140,12,114.70,162
,20161206,95110,95580,96900,97090,95630,95950,95930,370,350,50,479.69,160
,20161207,95950,95930,,,,96580,96580,650,650,0,0.00,160
,20161208,96580,96580,,,,96120,96120,-460,-460,0,0.00,160
,20161209,96120,96120,94470,94960,94050,94630,94310,-1490,-1810,18,169.77,160
,20161212,94630,94310,95520,97450,95520,97400,96820,3090,2510,262,"2,536.75",168
,20161213,97400,96820,95090,95890,95090,95890,95280,-930,-1540,48,457.37,166
,20161214,95890,95280,97190,97200,95410,95410,96410,130,1130,28,269.97,166
,20161215,95410,96410,96040,97520,96000,96000,96600,-410,190,30,289.81,170
,20161216,96000,96600,95750,96380,95750,96230,96090,-370,-510,8,76.87,174
,20161219,96230,96090,94650,94650,94460,94460,94580,-1630,-1510,6,56.75,176
,20161220,94460,94580,93610,93610,92390,92390,93020,-2190,-1560,8,74.42,172
,20161221,92390,93020,92690,94110,92690,94110,93440,1090,420,14,130.82,178
,20161222,94110,93440,92720,92760,90860,90860,92010,-2580,-1430,8,73.61,176
,20161223,90860,92010,89960,91510,89960,91410,90480,-600,-1530,32,289.54,182
,20161226,91410,90480,89400,89400,86160,86160,89000,-4320,-1480,20,178.01,174
,20161227,86160,89000,84960,85900,84930,85900,85290,-3100,-3710,16,136.46,174
,20161228,85900,85290,86460,86770,85990,86180,86540,890,1250,272,"2,354.15",432
,20161229,86180,86540,85720,86660,85720,86660,86280,120,-260,8,69.03,432
,20161230,86660,86280,85910,85910,85680,85680,85720,-600,-560,10,85.73,422
ni1707,20160718,84090,84090,,,,84090,84090,0,0,0,0.00,0
,20160719,84090,84090,,,,84090,84090,0,0,0,0.00,0
,20160720,84090,84090,,,,84090,84090,0,0,0,0.00,0
,20160721,84090,84090,,,,84090,84090,0,0,0,0.00,0
,20160722,84090,84090,,,,84090,84090,0,0,0,0.00,0
,20160725,84090,84090,,,,84090,84090,0,0,0,0.00,0
,20160726,84090,84090,,,,84090,84090,0,0,0,0.00,0
,20160727,84090,84090,,,,84090,84090,0,0,0,0.00,0
,20160728,84090,84090,,,,84090,84090,0,0,0,0.00,0
,20160729,84090,84090,,,,84090,84090,0,0,0,0.00,0
,20160801,84090,84090,83450,84600,83450,84600,84020,510,-70,4,33.61,4
,20160802,84600,84020,85190,85190,85190,85190,85190,1170,1170,2,17.04,4
,20160803,85190,85190,,,,85190,85190,0,0,0,0.00,4
,20160804,85190,85190,,,,85190,85190,0,0,0,0.00,4
,20160805,85190,85190,,,,85190,85190,0,0,0,0.00,4
,20160808,85190,85190,,,,85190,85190,0,0,0,0.00,4
,20160809,85190,85190,,,,85190,85190,0,0,0,0.00,4
,20160810,85190,85190,,,,85190,85190,0,0,0,0.00,4
,20160811,85190,85190,,,,85190,85190,0,0,0,0.00,4
,20160812,85190,85190,,,,85190,85190,0,0,0,0.00,4
,20160815,85190,85190,,,,83380,83380,-1810,-1810,0,0.00,4
,20160816,83380,83380,,,,83380,83380,0,0,0,0.00,4
,20160817,83380,83380,,,,83380,83380,0,0,0,0.00,4
,20160818,83380,83380,,,,83380,83380,0,0,0,0.00,4
,20160819,83380,83380,,,,83380,83380,0,0,0,0.00,4
,20160822,83380,83380,83360,83360,83360,83360,83360,-20,-20,2,16.67,6
,20160823,83360,83360,,,,83360,83360,0,0,0,0.00,6
,20160824,83360,83360,,,,83360,83360,0,0,0,0.00,6
,20160825,83360,83360,,,,81030,81030,-2330,-2330,0,0.00,6
,20160826,81030,81030,,,,81030,81030,0,0,0,0.00,6
,20160829,81030,81030,,,,81030,81030,0,0,0,0.00,6
,20160830,81030,81030,,,,81030,81030,0,0,0,0.00,6
,20160831,81030,81030,,,,81030,81030,0,0,0,0.00,6
,20160901,81030,81030,,,,81030,81030,0,0,0,0.00,6
,20160902,81030,81030,,,,81030,81030,0,0,0,0.00,6
,20160905,81030,81030,,,,81030,81030,0,0,0,0.00,6
,20160906,81030,81030,,,,81030,81030,0,0,0,0.00,6
,20160907,81030,81030,,,,81870,81870,840,840,0,0.00,6
,20160908,81870,81870,,,,81870,81870,0,0,0,0.00,6
,20160909,81870,81870,,,,81870,81870,0,0,0,0.00,6
,20160912,81870,81870,,,,81870,81870,0,0,0,0.00,6
,20160913,81870,81870,,,,81870,81870,0,0,0,0.00,6
,20160914,81870,81870,,,,81870,81870,0,0,0,0.00,6
,20160919,81870,81870,,,,82280,82280,410,410,0,0.00,6
,20160920,82280,82280,,,,82280,82280,0,0,0,0.00,6
,20160921,82280,82280,,,,82280,82280,0,0,0,0.00,6
,20160922,82280,82280,83620,83630,81900,81900,82760,-380,480,112,926.97,6
,20160923,81900,82760,,,,82760,82760,0,0,0,0.00,6
,20160926,82760,82760,,,,82760,82760,0,0,0,0.00,6
,20160927,82760,82760,,,,82760,82760,0,0,0,0.00,6
,20160928,82760,82760,,,,82760,82760,0,0,0,0.00,6
,20160929,82760,82760,,,,82760,82760,0,0,0,0.00,6
,20160930,82760,82760,,,,81380,81380,-1380,-1380,0,0.00,6
,20161010,81380,81380,,,,81380,81380,0,0,0,0.00,6
,20161011,81380,81380,,,,82630,82630,1250,1250,0,0.00,6
,20161012,82630,82630,,,,82630,82630,0,0,0,0.00,6
,20161013,82630,82630,,,,82630,82630,0,0,0,0.00,6
,20161014,82630,82630,82740,83720,82740,83610,83220,980,590,8,66.58,8
,20161017,83610,83220,,,,83220,83220,0,0,0,0.00,8
,20161018,83220,83220,83240,83240,83240,83240,83240,20,20,4,33.30,12
,20161019,83240,83240,,,,83240,83240,0,0,0,0.00,12
,20161020,83240,83240,82780,82780,82780,82780,82780,-460,-460,2,16.56,14
,20161021,82780,82780,,,,81780,81780,-1000,-1000,0,0.00,14
,20161024,81780,81780,,,,81780,81780,0,0,0,0.00,14
,20161025,81780,81780,,,,81780,81780,0,0,0,0.00,14
,20161026,81780,81780,82960,82960,82790,82790,82900,1010,1120,6,49.74,18
,20161027,82790,82900,,,,82900,82900,0,0,0,0.00,18
,20161028,82900,82900,84460,84460,83970,83970,84210,1070,1310,4,33.69,20
,20161031,83970,84210,84760,85990,84760,84790,85320,580,1110,18,153.58,20
,20161101,84790,85320,85580,85880,85350,85550,85590,230,270,10,85.59,20
,20161102,85550,85590,,,,84750,84750,-840,-840,0,0.00,20
,20161103,84750,84750,,,,84750,84750,0,0,0,0.00,20
,20161104,84750,84750,,,,84750,84750,0,0,0,0.00,20
,20161107,84750,84750,89820,89830,89820,89830,89820,5080,5070,16,143.72,32
,20161108,89830,89820,88970,91800,88970,91800,90100,1980,280,10,90.10,32
,20161109,91800,90100,,,,91920,91920,1820,1820,0,0.00,32
,20161110,91920,91920,,,,95140,95140,3220,3220,0,0.00,32
,20161111,95140,95140,,,,97370,97370,2230,2230,0,0.00,32
,20161114,97370,97370,98250,98250,91530,93010,93210,-4360,-4160,16,149.14,40
,20161115,93010,93210,93510,93510,93510,93510,93510,300,300,2,18.70,38
,20161116,93510,93510,93290,93290,93290,93290,93290,-220,-220,2,18.66,36
,20161117,93290,93290,,,,93290,93290,0,0,0,0.00,36
,20161118,93290,93290,,,,93290,93290,0,0,0,0.00,36
,20161121,93290,93290,92180,92180,92180,92180,92180,-1110,-1110,4,36.87,36
,20161122,92180,92180,,,,94370,94370,2190,2190,0,0.00,36
,20161123,94370,94370,,,,94370,94370,0,0,0,0.00,36
,20161124,94370,94370,,,,95600,95600,1230,1230,0,0.00,36
,20161125,95600,95600,,,,96430,96430,830,830,0,0.00,36
,20161128,96430,96430,96660,96660,96660,96660,96660,230,230,2,19.33,36
,20161129,96660,96660,,,,95970,95970,-690,-690,0,0.00,36
,20161130,95970,95970,,,,92540,92540,-3430,-3430,0,0.00,36
,20161201,92540,92540,90570,93690,90570,93690,92550,1150,10,6,55.53,38
,20161202,93690,92550,,,,92550,92550,0,0,0,0.00,38
,20161205,92550,92550,,,,95130,95130,2580,2580,0,0.00,38
,20161206,95130,95130,,,,95130,95130,0,0,0,0.00,38
,20161207,95130,95130,,,,96410,96410,1280,1280,0,0.00,38
,20161208,96410,96410,,,,96130,96130,-280,-280,0,0.00,38
,20161209,96130,96130,,,,96130,96130,0,0,0,0.00,38
,20161212,96130,96130,,,,96080,96080,-50,-50,0,0.00,38
,20161213,96080,96080,,,,96080,96080,0,0,0,0.00,38
,20161214,96080,96080,,,,96140,96140,60,60,0,0.00,38
,20161215,96140,96140,,,,96140,96140,0,0,0,0.00,38
,20161216,96140,96140,,,,96140,96140,0,0,0,0.00,38
,20161219,96140,96140,,,,95360,95360,-780,-780,0,0.00,38
,20161220,95360,95360,,,,93800,93800,-1560,-1560,0,0.00,38
,20161221,93800,93800,,,,93800,93800,0,0,0,0.00,38
,20161222,93800,93800,,,,91170,91170,-2630,-2630,0,0.00,38
,20161223,91170,91170,,,,91170,91170,0,0,0,0.00,38
,20161226,91170,91170,,,,89680,89680,-1490,-1490,0,0.00,38
,20161227,89680,89680,,,,86790,86790,-2890,-2890,0,0.00,38
,20161228,86790,86790,,,,86790,86790,0,0,0,0.00,38
,20161229,86790,86790,,,,86790,86790,0,0,0,0.00,38
,20161230,86790,86790,,,,86790,86790,0,0,0,0.00,38
ni1708,20160816,83380,83380,,,,83380,83380,0,0,0,0.00,0
,20160817,83380,83380,,,,83380,83380,0,0,0,0.00,0
,20160818,83380,83380,,,,83380,83380,0,0,0,0.00,0
,20160819,83380,83380,,,,83380,83380,0,0,0,0.00,0
,20160822,83380,83380,,,,83380,83380,0,0,0,0.00,0
,20160823,83380,83380,,,,83380,83380,0,0,0,0.00,0
,20160824,83380,83380,,,,83380,83380,0,0,0,0.00,0
,20160825,83380,83380,81060,81060,81060,81060,81060,-2320,-2320,2,16.21,2
,20160826,81060,81060,80650,80650,80650,80650,80650,-410,-410,2,16.13,4
,20160829,80650,80650,,,,80650,80650,0,0,0,0.00,4
,20160830,80650,80650,,,,80650,80650,0,0,0,0.00,4
,20160831,80650,80650,,,,80650,80650,0,0,0,0.00,4
,20160901,80650,80650,,,,80650,80650,0,0,0,0.00,4
,20160902,80650,80650,80500,81420,80500,81420,80960,770,310,4,32.38,6
,20160905,81420,80960,,,,80960,80960,0,0,0,0.00,6
,20160906,80960,80960,,,,80960,80960,0,0,0,0.00,6
,20160907,80960,80960,,,,82060,82060,1100,1100,0,0.00,6
,20160908,82060,82060,,,,82060,82060,0,0,0,0.00,6
,20160909,82060,82060,,,,82060,82060,0,0,0,0.00,6
,20160912,82060,82060,81000,81000,80980,80980,80990,-1080,-1070,4,32.40,8
,20160913,80980,80990,,,,80990,80990,0,0,0,0.00,8
,20160914,80990,80990,,,,80990,80990,0,0,0,0.00,8
,20160919,80990,80990,,,,81390,81390,400,400,0,0.00,8
,20160920,81390,81390,,,,81390,81390,0,0,0,0.00,8
,20160921,81390,81390,,,,81390,81390,0,0,0,0.00,8
,20160922,81390,81390,,,,81860,81860,470,470,0,0.00,8
,20160923,81860,81860,,,,82400,82400,540,540,0,0.00,8
,20160926,82400,82400,,,,82400,82400,0,0,0,0.00,8
,20160927,82400,82400,,,,81770,81770,-630,-630,0,0.00,8
,20160928,81770,81770,,,,82350,82350,580,580,0,0.00,8
,20160929,82350,82350,82440,86150,82440,83460,84120,1110,1770,10,84.13,12
,20160930,83460,84120,,,,82720,82720,-1400,-1400,0,0.00,12
,20161010,82720,82720,,,,82720,82720,0,0,0,0.00,12
,20161011,82720,82720,84910,84910,84460,84460,84880,1740,2160,38,322.57,48
,20161012,84460,84880,,,,84880,84880,0,0,0,0.00,48
,20161013,84880,84880,84830,84830,84830,84830,84830,-50,-50,12,101.80,60
,20161014,84830,84830,,,,84830,84830,0,0,0,0.00,60
,20161017,84830,84830,,,,84830,84830,0,0,0,0.00,60
,20161018,84830,84830,83890,83890,83890,83890,83890,-940,-940,6,50.33,66
,20161019,83890,83890,82960,82960,82960,82960,82960,-930,-930,2,16.59,68
,20161020,82960,82960,83120,83250,83120,83250,83180,290,220,4,33.27,70
,20161021,83250,83180,,,,82970,82970,-210,-210,0,0.00,70
,20161024,82970,82970,83200,83320,82610,83320,83040,350,70,6,49.83,72
,20161025,83320,83040,,,,83040,83040,0,0,0,0.00,72
,20161026,83040,83040,83680,83680,83680,83680,83680,640,640,2,16.74,70
,20161027,83680,83680,,,,83680,83680,0,0,0,0.00,70
,20161028,83680,83680,,,,83680,83680,0,0,0,0.00,70
,20161031,83680,83680,,,,83680,83680,0,0,0,0.00,70
,20161101,83680,83680,85830,85830,85830,85830,85830,2150,2150,6,51.50,64
,20161102,85830,85830,,,,85820,85820,-10,-10,0,0.00,64
,20161103,85820,85820,,,,85820,85820,0,0,0,0.00,64
,20161104,85820,85820,,,,85820,85820,0,0,0,0.00,64
,20161107,85820,85820,90000,90000,90000,90000,90000,4180,4180,2,18.00,64
,20161108,90000,90000,90320,90320,90320,90320,90320,320,320,2,18.06,62
,20161109,90320,90320,,,,90320,90320,0,0,0,0.00,62
,20161110,90320,90320,93900,95310,93900,95080,94180,4760,3860,38,357.89,66
,20161111,95080,94180,95770,99220,95770,99220,97490,5040,3310,8,78.00,70
,20161114,99220,97490,92500,94440,92500,94440,93470,-3050,-4020,16,149.55,78
,20161115,94440,93470,96020,96020,95070,95070,95540,1600,2070,8,76.44,74
,20161116,95070,95540,,,,95540,95540,0,0,0,0.00,74
,20161117,95540,95540,94250,94250,94250,94250,94250,-1290,-1290,4,37.70,78
,20161118,94250,94250,92130,92130,92130,92130,92130,-2120,-2120,4,36.85,78
,20161121,92130,92130,91770,95120,91770,93650,94010,1520,1880,40,376.07,86
,20161122,93650,94010,95480,95480,95370,95370,95450,1360,1440,10,95.46,96
,20161123,95370,95450,94670,95130,94600,94890,94670,-560,-780,24,227.22,90
,20161124,94890,94670,98070,98070,98070,98070,98070,3400,3400,6,58.84,96
,20161125,98070,98070,97640,97970,97430,97970,97590,-100,-480,12,117.12,90
,20161128,97970,97590,97470,99050,96890,99050,97340,1460,-250,12,116.82,90
,20161129,99050,97340,99220,99220,95230,96060,96830,-1280,-510,6,58.10,90
,20161130,96060,96830,93820,94040,93820,94040,93930,-2790,-2900,4,37.57,90
,20161201,94040,93930,94040,94040,93260,93260,93650,-670,-280,16,149.84,90
,20161202,93260,93650,92910,92910,92910,92910,92910,-740,-740,2,18.58,92
,20161205,92910,92910,93350,97570,93350,96330,96790,3420,3880,14,135.51,100
,20161206,96330,96790,97490,97490,97490,97490,97490,700,700,2,19.50,100
,20161207,97490,97490,96770,96770,96770,96770,96770,-720,-720,4,38.71,104
,20161208,96770,96770,,,,96770,96770,0,0,0,0.00,104
,20161209,96770,96770,,,,96770,96770,0,0,0,0.00,104
,20161212,96770,96770,,,,99340,99340,2570,2570,0,0.00,104
,20161213,99340,99340,,,,97970,97970,-1370,-1370,0,0.00,104
,20161214,97970,97970,,,,97970,97970,0,0,0,0.00,104
,20161215,97970,97970,,,,97970,97970,0,0,0,0.00,104
,20161216,97970,97970,97150,97150,97150,97150,97150,-820,-820,2,19.43,102
,20161219,97150,97150,,,,95880,95880,-1270,-1270,0,0.00,102
,20161220,95880,95880,,,,94850,94850,-1030,-1030,0,0.00,102
,20161221,94850,94850,,,,94850,94850,0,0,0,0.00,102
,20161222,94850,94850,,,,92110,92110,-2740,-2740,0,0.00,102
,20161223,92110,92110,,,,92110,92110,0,0,0,0.00,102
,20161226,92110,92110,,,,90600,90600,-1510,-1510,0,0.00,102
,20161227,90600,90600,85480,85480,85480,85480,85480,-5120,-5120,4,34.19,106
,20161228,85480,85480,,,,86000,86000,520,520,0,0.00,106
,20161229,86000,86000,,,,86000,86000,0,0,0,0.00,106
,20161230,86000,86000,85980,85980,85980,85980,85980,-20,-20,6,51.59,100
ni1709,20160920,81390,81390,82600,82950,82600,82940,82810,1550,1420,8,66.25,8
,20160921,82940,82810,,,,82810,82810,0,0,0,0.00,8
,20160922,82810,82810,83120,85070,83120,84490,84350,1680,1540,50,421.76,40
,20160923,84490,84350,84950,85170,84190,85170,84880,820,530,80,679.05,58
,20160926,85170,84880,84970,85410,83700,84250,84690,-630,-190,140,"1,185.69",70
,20160927,84250,84690,84320,85350,82910,85350,84290,660,-400,90,758.62,84
,20160928,85350,84290,84520,85330,84230,84890,84760,600,470,76,644.24,100
,20160929,84890,84760,84680,86300,84460,84460,85170,-300,410,130,"1,107.23",118
,20160930,84460,85170,84570,85640,83370,84030,84030,-1140,-1140,98,823.56,150
,20161010,84030,84030,83740,84570,83210,84480,84160,450,130,124,"1,043.69",160
,20161011,84480,84160,84550,85700,84550,85700,85250,1540,1090,84,716.18,186
,20161012,85700,85250,85260,85800,84630,85070,85300,-180,50,132,"1,126.01",210
,20161013,85070,85300,85410,85620,83610,84000,84770,-1300,-530,224,"1,898.93",248
,20161014,84000,84770,83940,84820,83400,84500,84040,-270,-730,108,907.67,252
,20161017,84500,84040,84340,85200,84340,84640,84830,600,790,126,"1,068.97",296
,20161018,84640,84830,84760,84760,83790,84570,84270,-260,-560,118,994.47,340
,20161019,84570,84270,84710,85000,83370,83730,84050,-540,-220,144,"1,210.32",384
,20161020,83730,84050,83440,84000,82690,83590,83470,-460,-580,240,"2,003.31",404
,20161021,83590,83470,83180,83330,82230,82250,82800,-1220,-670,546,"4,520.98",574
,20161024,82250,82800,82160,83400,81950,83300,82610,500,-190,244,"2,015.69",600
,20161025,83300,82610,83220,84620,83220,84300,83850,1690,1240,340,"2,850.96",614
,20161026,84300,83850,84430,85000,83350,83680,84230,-170,380,470,"3,959.20",756
,20161027,83680,84230,83800,84500,83200,83850,83900,-380,-330,530,"4,447.21",878
,20161028,83850,83900,84080,85300,84070,85180,84820,1280,920,322,"2,731.48",958
,20161031,85180,84820,85180,86600,84900,86570,85270,1750,450,760,"6,480.83",1444
,20161101,86570,85270,86660,87000,85620,86340,86440,1070,1170,508,"4,391.40",1500
,20161102,86340,86440,86340,87000,84700,84880,85260,-1560,-1180,974,"8,305.03",1364
,20161103,84880,85260,85280,86000,85000,85880,85500,620,240,108,923.51,1378
,20161104,85880,85500,86370,86680,85500,85600,86010,100,510,552,"4,747.85",1422
,20161107,85600,86010,85620,91170,85500,90700,89030,4690,3020,1210,"10,773.32",1752
,20161108,90700,89030,91090,93610,89900,92900,91590,3870,2560,1074,"9,837.05",2012
,20161109,92900,91590,92510,94300,91130,93490,93190,1900,1600,860,"8,015.11",2224
,20161110,93490,93190,94650,98780,94200,98780,97150,5590,3960,1352,"13,134.96",2616
,20161111,98780,97150,98420,100070,95600,99050,97750,1900,600,1672,"16,343.96",2880
,20161114,99050,97750,98990,102500,92010,94510,95550,-3240,-2200,2400,"22,933.39",3084
,20161115,94510,95550,94850,97000,92340,93500,94990,-2050,-560,2520,"23,939.87",3906
,20161116,93500,94990,93600,95690,93560,95510,94920,520,-70,1086,"10,309.34",4490
,20161117,95510,94920,94510,95260,93800,94130,94490,-790,-430,2172,"20,524.21",4920
,20161118,94130,94490,94990,94990,92810,93710,93640,-780,-850,554,"5,187.76",4834
,20161121,93710,93640,93820,94770,91210,94200,93580,560,-60,1616,"15,122.55",5326
,20161122,94200,93580,94650,97470,93890,96330,95940,2750,2360,3178,"30,489.76",6198
,20161123,96330,95940,95810,96440,95250,95900,95770,-40,-170,2338,"22,393.03",6608
,20161124,95900,95770,95340,99980,95340,97700,97930,1930,2160,1722,"16,863.68",7102
,20161125,97700,97930,97770,99300,96750,98200,98210,270,280,1996,"19,603.43",7556
,20161128,98200,98210,97920,100840,97100,100510,99180,2300,970,2620,"25,985.71",8166
,20161129,100510,99180,100000,101600,95790,96170,98120,-3010,-1060,5812,"57,030.34",10262
,20161130,96170,98120,96580,96580,91700,92760,94080,-5360,-4040,4344,"40,868.44",11322
,20161201,92760,94080,94010,95500,93050,94590,94240,510,160,2480,"23,373.57",11648
,20161202,94590,94240,94550,94940,92890,93900,93990,-340,-250,1406,"13,215.76",11732
,20161205,93900,93990,93900,97500,93750,96780,95890,2790,1900,3636,"34,868.19",12642
,20161206,96780,95890,97510,98120,96000,96620,97230,730,1340,4434,"43,112.67",14618
,20161207,96620,97230,96620,98480,96220,98100,97450,870,220,2844,"27,716.89",14950
,20161208,98100,97450,98060,98500,95430,96260,96810,-1190,-640,3496,"33,848.17",16260
,20161209,96260,96810,96260,96990,94200,96400,95810,-410,-1000,2794,"26,770.95",17034
,20161212,96400,95810,96400,99200,95700,95890,98050,80,2240,13300,"130,418.67",22150
,20161213,95890,98050,95900,97360,95650,97350,96480,-700,-1570,3318,"32,012.98",23676
,20161214,97350,96480,97420,98070,95000,97720,97210,1240,730,4846,"47,111.04",24722
,20161215,97720,97210,97720,98390,95840,97450,97360,240,150,7882,"76,743.62",25554
,20161216,97450,97360,96870,97890,96050,96590,96950,-770,-410,3312,"32,112.83",25580
,20161219,96590,96950,96190,96670,94700,94780,95860,-2170,-1090,2466,"23,641.08",25904
,20161220,94780,95860,94550,94550,92250,93960,93680,-1900,-2180,6546,"61,325.80",27656
,20161221,93960,93680,93960,94680,93500,93960,94030,280,350,2838,"26,688.38",27642
,20161222,93960,94030,93880,94070,91090,91400,92490,-2630,-1540,4158,"38,457.89",27184
,20161223,91400,92490,91330,92650,91010,91550,91820,-940,-670,2010,"18,457.06",27154
,20161226,91550,91820,91010,91750,85390,85600,87770,-6220,-4050,9236,"81,065.03",27810
,20161227,85600,87770,85550,87220,85190,86920,86270,-850,-1500,4138,"35,699.70",28260
,20161228,86920,86270,86720,88810,86680,87250,87710,980,1440,4440,"38,946.12",28396
,20161229,87250,87710,87390,87960,86320,87770,87310,60,-400,3296,"28,778.22",28498
,20161230,87770,87310,87300,87800,86330,86920,87120,-390,-190,7356,"64,086.87",29524
ni1710,20161018,84830,84830,84380,84380,84200,84200,84290,-630,-540,4,33.72,2
,20161019,84200,84290,,,,84290,84290,0,0,0,0.00,2
,20161020,84290,84290,84320,85410,84320,85410,85040,1120,750,6,51.03,8
,20161021,85410,85040,,,,84350,84350,-690,-690,0,0.00,8
,20161024,84350,84350,,,,84350,84350,0,0,0,0.00,8
,20161025,84350,84350,85600,85600,85220,85220,85470,870,1120,6,51.28,12
,20161026,85220,85470,,,,85470,85470,0,0,0,0.00,12
,20161027,85470,85470,,,,85080,85080,-390,-390,0,0.00,12
,20161028,85080,85080,,,,85080,85080,0,0,0,0.00,12
,20161031,85080,85080,86150,86900,86010,86900,86290,1820,1210,18,155.32,18
,20161101,86900,86290,87340,87340,87340,87340,87340,1050,1050,4,34.94,18
,20161102,87340,87340,,,,86850,86850,-490,-490,0,0.00,18
,20161103,86850,86850,86440,86570,84690,86570,85900,-280,-950,6,51.54,22
,20161104,86570,85900,,,,85900,85900,0,0,0,0.00,22
,20161107,85900,85900,88000,91050,88000,90930,89030,5030,3130,26,231.48,32
,20161108,90930,89030,90970,92740,90570,91060,91280,2030,2250,20,182.57,36
,20161109,91060,91280,,,,92260,92260,980,980,0,0.00,36
,20161110,92260,92260,97000,97780,97000,97780,97390,5520,5130,4,38.96,40
,20161111,97780,97390,98040,100490,96440,100050,98200,2660,810,32,314.26,64
,20161114,100050,98200,99150,102990,93300,95340,95510,-2860,-2690,30,286.56,72
,20161115,95340,95510,93000,93000,93000,93000,93000,-2510,-2510,2,18.60,70
,20161116,93000,93000,,,,93000,93000,0,0,0,0.00,70
,20161117,93000,93000,94670,94670,94080,94080,94370,1080,1370,4,37.75,74
,20161118,94080,94370,94830,94830,93500,93500,94110,-870,-260,12,112.94,76
,20161121,93500,94110,94120,94120,93990,93990,94050,-120,-60,4,37.62,76
,20161122,93990,94050,96280,96600,96280,96600,96440,2550,2390,4,38.58,78
,20161123,96600,96440,,,,96440,96440,0,0,0,0.00,78
,20161124,96440,96440,97500,98220,97500,98220,97680,1780,1240,8,78.14,84
,20161125,98220,97680,98930,98930,98930,98930,98930,1250,1250,4,39.57,88
,20161128,98930,98930,100750,100750,100750,100750,100750,1820,1820,2,20.15,88
,20161129,100750,100750,99150,101560,97400,97400,98710,-3350,-2040,14,138.20,84
,20161130,97400,98710,96640,96640,92860,92860,95440,-5850,-3270,10,95.45,80
,20161201,92860,95440,,,,95440,95440,0,0,0,0.00,80
,20161202,95440,95440,94690,94690,94690,94690,94690,-750,-750,2,18.94,78
,20161205,94690,94690,,,,94690,94690,0,0,0,0.00,78
,20161206,94690,94690,96240,96240,96240,96240,96240,1550,1550,4,38.50,78
,20161207,96240,96240,,,,96240,96240,0,0,0,0.00,78
,20161208,96240,96240,97000,97000,97000,97000,97000,760,760,2,19.40,78
,20161209,97000,97000,96500,96500,95360,95360,96040,-1640,-960,6,57.62,76
,20161212,95360,96040,97600,98940,97600,98940,98380,2900,2340,6,59.03,74
,20161213,98940,98380,,,,98380,98380,0,0,0,0.00,74
,20161214,98380,98380,,,,98380,98380,0,0,0,0.00,74
,20161215,98380,98380,,,,98380,98380,0,0,0,0.00,74
,20161216,98380,98380,,,,98380,98380,0,0,0,0.00,74
,20161219,98380,98380,,,,98380,98380,0,0,0,0.00,74
,20161220,98380,98380,,,,98380,98380,0,0,0,0.00,74
,20161221,98380,98380,,,,98380,98380,0,0,0,0.00,74
,20161222,98380,98380,93900,93900,93900,93900,93900,-4480,-4480,2,18.78,72
,20161223,93900,93900,,,,93900,93900,0,0,0,0.00,72
,20161226,93900,93900,88000,88000,87320,87320,87580,-6580,-6320,8,70.06,72
,20161227,87320,87580,86300,87380,85940,87380,86430,-200,-1150,26,224.74,74
,20161228,87380,86430,,,,86430,86430,0,0,0,0.00,74
,20161229,86430,86430,,,,86430,86430,0,0,0,0.00,74
,20161230,86430,86430,,,,86430,86430,0,0,0,0.00,74
ni1711,20161116,93000,93000,,,,92940,92940,-60,-60,0,0.00,0
,20161117,92940,92940,,,,92940,92940,0,0,0,0.00,0
,20161118,92940,92940,94480,94480,93800,93800,94140,860,1200,4,37.66,2
,20161121,93800,94140,93000,93000,93000,93000,93000,-1140,-1140,2,18.60,4
,20161122,93000,93000,,,,95360,95360,2360,2360,0,0.00,4
,20161123,95360,95360,,,,95360,95360,0,0,0,0.00,4
,20161124,95360,95360,99750,99750,99750,99750,99750,4390,4390,2,19.95,6
,20161125,99750,99750,97630,97630,97630,97630,97630,-2120,-2120,2,19.53,6
,20161128,97630,97630,,,,99420,99420,1790,1790,0,0.00,6
,20161129,99420,99420,,,,97400,97400,-2020,-2020,0,0.00,6
,20161130,97400,97400,96690,96690,96690,96690,96690,-710,-710,2,19.34,8
,20161201,96690,96690,,,,96690,96690,0,0,0,0.00,8
,20161202,96690,96690,,,,96690,96690,0,0,0,0.00,8
,20161205,96690,96690,,,,96690,96690,0,0,0,0.00,8
,20161206,96690,96690,,,,96690,96690,0,0,0,0.00,8
,20161207,96690,96690,,,,96690,96690,0,0,0,0.00,8
,20161208,96690,96690,,,,96690,96690,0,0,0,0.00,8
,20161209,96690,96690,,,,96690,96690,0,0,0,0.00,8
,20161212,96690,96690,97600,97600,97600,97600,97600,910,910,2,19.52,10
,20161213,97600,97600,,,,97600,97600,0,0,0,0.00,10
,20161214,97600,97600,,,,97600,97600,0,0,0,0.00,10
,20161215,97600,97600,,,,97600,97600,0,0,0,0.00,10
,20161216,97600,97600,,,,97600,97600,0,0,0,0.00,10
,20161219,97600,97600,,,,97600,97600,0,0,0,0.00,10
,20161220,97600,97600,,,,95380,95380,-2220,-2220,0,0.00,10
,20161221,95380,95380,,,,95380,95380,0,0,0,0.00,10
,20161222,95380,95380,,,,91030,91030,-4350,-4350,0,0.00,10
,20161223,91030,91030,,,,91030,91030,0,0,0,0.00,10
,20161226,91030,91030,,,,84900,84900,-6130,-6130,0,0.00,10
,20161227,84900,84900,87930,87930,87930,87930,87930,3030,3030,4,35.17,14
,20161228,87930,87930,90480,90480,89100,89100,89790,1170,1860,4,35.92,14
,20161229,89100,89790,88500,88800,87250,88710,88060,-1080,-1730,36,317.03,14
,20161230,88710,88060,88290,88290,88290,88290,88290,230,230,4,35.32,16
ni1712,20161216,97600,97600,,,,97600,97600,0,0,0,0.00,0
,20161219,97600,97600,,,,97600,97600,0,0,0,0.00,0
,20161220,97600,97600,94910,94910,94910,94910,94910,-2690,-2690,2,18.98,2
,20161221,94910,94910,94860,95350,94860,95350,95100,440,190,4,38.04,6
,20161222,95350,95100,,,,95100,95100,0,0,0,0.00,6
,20161223,95100,95100,,,,95100,95100,0,0,0,0.00,6
,20161226,95100,95100,89640,89640,88440,88440,89040,-6660,-6060,40,356.16,46
,20161227,88440,89040,87080,87590,87080,87590,87330,-1450,-1710,4,34.93,46
,20161228,87590,87330,,,,87330,87330,0,0,0,0.00,46
,20161229,87330,87330,87700,89560,87700,88780,88320,1450,990,18,158.98,46
,20161230,88780,88320,90100,90100,88880,88880,89280,560,960,6,53.57,48
pb1601,20160104,13250,13205,13215,13220,13110,13110,13170,-95,-35,570,"3,753.60",2630
,20160105,13110,13170,13195,13280,13150,13280,13235,110,65,560,"3,706.70",2100
,20160106,13280,13235,13190,13200,13150,13200,13175,-35,-60,240,"1,581.35",1880
,20160107,13200,13175,13100,13105,12950,12960,13045,-215,-130,180,"1,174.18",1700
,20160108,12960,13045,12855,12980,12850,12930,12900,-115,-145,520,"3,354.18",1180
,20160111,12930,12900,12850,12880,12820,12830,12845,-70,-55,220,"1,413.28",980
,20160112,12830,12845,12695,12695,12630,12630,12650,-215,-195,260,"1,644.55",720
,20160113,12630,12650,12750,12750,12730,12730,12745,80,95,100,637.35,620
,20160114,12730,12745,12740,12900,12740,12900,12875,155,130,100,643.85,520
,20160115,12900,12875,12900,12900,12900,12900,12900,25,25,70,451.50,450
pb1602,20160104,13170,13145,13130,13335,13080,13145,13185,0,40,9506,"62,689.01",16534
,20160105,13145,13185,13130,13300,13115,13300,13210,115,25,6486,"42,853.90",15822
,20160106,13300,13210,13255,13270,13120,13220,13170,10,-40,4112,"27,086.29",14834
,20160107,13220,13170,13165,13195,12765,12865,13075,-305,-95,4704,"30,763.70",13624
,20160108,12865,13075,12730,13030,12715,12960,12875,-115,-200,5176,"33,322.71",12460
,20160111,12960,12875,12880,12980,12750,12765,12830,-110,-45,3496,"22,429.52",10936
,20160112,12765,12830,12635,12750,12605,12615,12665,-215,-165,3442,"21,798.44",9302
,20160113,12615,12665,12665,12800,12610,12750,12750,85,85,3692,"23,540.87",8614
,20160114,12750,12750,12740,13050,12705,13050,12850,300,100,1464,"9,407.94",8224
,20160115,13050,12850,12940,13015,12665,12670,12855,-180,5,1512,"9,721.21",7782
,20160118,12670,12855,12670,12990,12630,12990,12870,135,15,980,"6,307.03",7340
,20160119,12990,12870,12980,13100,12880,13095,12975,225,105,1106,"7,177.30",6644
,20160120,13095,12975,13095,13120,12910,13000,12985,25,10,816,"5,299.47",6224
,20160121,13000,12985,13015,13015,12865,12900,12950,-85,-35,1294,"8,379.51",5960
,20160122,12900,12950,12940,13050,12860,12960,12965,10,15,608,"3,942.84",5746
,20160125,12960,12965,13015,13090,13000,13075,13050,110,85,768,"5,011.42",5432
,20160126,13075,13050,13110,13300,13110,13290,13235,240,185,636,"4,208.78",4994
,20160127,13290,13235,13375,13730,13365,13700,13640,465,405,980,"6,685.23",4862
,20160128,13700,13640,13670,13720,13650,13700,13695,60,55,520,"3,561.27",4756
,20160129,13700,13695,13700,14235,13700,14225,13965,530,270,1188,"8,296.20",4700
,20160201,14225,13965,14300,14520,14300,14520,14500,555,535,1120,"8,121.58",4610
,20160202,14520,14500,14505,15515,14325,14395,15235,-105,735,2000,"15,236.50",4560
,20160203,14395,15235,14625,14990,14625,14625,14635,-610,-600,310,"2,269.10",4520
,20160204,14625,14635,14490,15500,14490,15500,14845,865,210,370,"2,747.10",4520
,20160205,15500,14845,15100,15100,14050,14400,14800,-445,-45,170,"1,258.00",4440
,20160215,14400,14800,14485,14485,14000,14000,14385,-800,-415,100,719.40,4360
pb1603,20160104,13075,13065,13150,13235,13035,13050,13105,-15,40,2908,"19,059.38",9860
,20160105,13050,13105,13035,13220,13025,13220,13120,115,15,7088,"46,509.09",11892
,20160106,13220,13120,13165,13200,13050,13140,13115,20,-5,8998,"59,012.44",12506
,20160107,13140,13115,13130,13170,12810,12845,13035,-270,-80,6956,"45,348.64",12144
,20160108,12845,13035,12760,12950,12715,12915,12835,-120,-200,10842,"69,585.60",12006
,20160111,12915,12835,12880,12945,12730,12740,12810,-95,-25,6702,"42,927.67",12224
,20160112,12740,12810,12685,12735,12520,12555,12635,-255,-175,8866,"56,016.74",12904
,20160113,12555,12635,12580,12735,12560,12715,12670,80,35,8480,"53,732.40",13564
,20160114,12715,12670,12700,12875,12655,12835,12780,165,110,9312,"59,516.41",13712
,20160115,12835,12780,12815,12925,12575,12585,12755,-195,-25,12156,"77,536.65",13382
,20160118,12585,12755,12545,12900,12535,12890,12770,135,15,12434,"79,399.53",14094
,20160119,12890,12770,12880,13020,12790,12995,12905,225,135,9888,"63,817.15",15188
,20160120,12995,12905,13010,13055,12805,12870,12925,-35,20,8354,"53,994.10",14306
,20160121,12870,12925,12885,12910,12750,12775,12830,-150,-95,7214,"46,280.19",13912
,20160122,12775,12830,12795,12890,12725,12795,12810,-35,-20,10364,"66,382.85",13834
,20160125,12795,12810,12855,12895,12780,12810,12825,0,15,5586,"35,829.36",13404
,20160126,12810,12825,12790,12980,12785,12920,12895,95,70,7744,"49,942.44",13876
,20160127,12920,12895,13015,13250,12985,13215,13115,320,220,10974,"71,976.24",14810
,20160128,13215,13115,13240,13265,13105,13145,13180,30,65,6728,"44,337.57",14830
,20160129,13145,13180,13200,13695,13155,13475,13375,295,195,21334,"142,673.69",17226
,20160201,13475,13375,13525,13770,13520,13650,13655,275,280,21510,"146,860.14",17350
,20160202,13650,13655,13665,13735,13615,13680,13670,25,15,15300,"104,591.75",19120
,20160203,13680,13670,13705,13825,13600,13775,13735,105,65,14192,"97,473.32",20580
,20160204,13775,13735,13750,14115,13720,14045,13910,310,175,12776,"88,876.18",20542
,20160205,14045,13910,14055,14055,13605,13815,13855,-95,-55,7412,"51,354.04",19610
,20160215,13815,13855,13975,14125,13810,13875,13935,20,80,4306,"30,005.64",19680
,20160216,13875,13935,13840,13880,13690,13695,13775,-240,-160,4654,"32,057.35",18984
,20160217,13695,13775,13630,13785,13565,13610,13655,-165,-120,5696,"38,898.61",17450
,20160218,13610,13655,13590,13700,13525,13620,13600,-35,-55,3556,"24,186.17",16204
,20160219,13620,13600,13540,13960,13540,13940,13745,340,145,3686,"25,340.84",14974
,20160222,13940,13745,13880,14160,13825,14150,14040,405,295,3772,"26,488.80",13668
,20160223,14150,14040,14210,14210,13780,13830,13945,-210,-95,2850,"19,873.64",13238
,20160224,13830,13945,13810,13860,13770,13795,13790,-150,-155,1432,"9,875.83",12374
,20160225,13795,13790,13760,13935,13760,13780,13835,-10,45,2072,"14,335.01",11414
,20160226,13780,13835,13680,13940,13680,13875,13800,40,-35,2012,"13,885.86",10116
,20160229,13875,13800,13955,14000,13690,13825,13860,25,60,2714,"18,813.12",9090
,20160301,13825,13860,13920,13920,13630,13750,13710,-110,-150,1330,"9,118.33",8720
,20160302,13750,13710,13805,13920,13800,13800,13840,90,130,1190,"8,237.58",8630
,20160303,13800,13840,13840,13990,13840,13925,13930,85,90,1350,"9,403.90",8150
,20160304,13925,13930,13985,14050,13900,13990,13960,60,30,1700,"11,868.95",7270
,20160307,13990,13960,13970,14060,13890,13970,13970,10,10,920,"6,427.05",7020
,20160308,13970,13970,14000,14150,13750,13755,13925,-215,-45,2020,"14,069.20",6300
,20160309,13755,13925,13800,13800,13560,13685,13695,-240,-230,1810,"12,397.05",5850
,20160310,13685,13695,13700,13730,13630,13720,13670,25,-25,410,"2,803.15",5610
,20160311,13720,13670,13700,13800,13700,13790,13740,120,70,510,"3,504.80",5710
,20160314,13790,13740,13800,13800,13650,13650,13735,-90,-5,210,"1,442.40",5670
,20160315,13650,13735,13790,13790,13505,13680,13540,-55,-195,450,"3,046.75",5780
pb1604,20160104,12970,12965,13005,13145,12930,12955,12965,-10,0,428,"2,774.78",4536
,20160105,12955,12965,12930,13135,12915,13130,13015,165,50,1038,"6,755.57",4902
,20160106,13130,13015,13085,13135,13000,13110,13070,95,55,906,"5,921.77",5274
,20160107,13110,13070,13110,13110,12795,12795,13005,-275,-65,712,"4,630.76",5662
,20160108,12795,13005,12700,12905,12690,12905,12775,-100,-230,924,"5,903.55",5520
,20160111,12905,12775,12800,12880,12730,12730,12760,-45,-15,1306,"8,334.33",6390
,20160112,12730,12760,12690,12700,12520,12520,12585,-240,-175,786,"4,946.14",6760
,20160113,12520,12585,12580,12675,12580,12655,12630,70,45,1278,"8,072.37",7600
,20160114,12655,12630,12670,12820,12610,12760,12740,130,110,1100,"7,009.15",8228
,20160115,12760,12740,12770,12845,12560,12560,12720,-180,-20,1776,"11,297.76",9212
,20160118,12560,12720,12415,12805,12415,12805,12730,85,10,1842,"11,728.68",10096
,20160119,12805,12730,12740,12935,12705,12910,12810,180,80,1602,"10,263.84",10846
,20160120,12910,12810,12930,12970,12720,12790,12805,-20,-5,656,"4,201.02",11082
,20160121,12790,12805,12785,12810,12695,12700,12750,-105,-55,718,"4,577.45",11196
,20160122,12700,12750,12735,12830,12670,12715,12750,-35,0,1646,"10,495.79",11476
,20160125,12715,12750,12715,12815,12700,12745,12745,-5,-5,1228,"7,826.46",11922
,20160126,12745,12745,12745,12845,12730,12800,12800,55,55,1910,"12,226.83",12118
,20160127,12800,12800,12845,13045,12845,13045,12950,245,150,3868,"25,050.71",12680
,20160128,13045,12950,13050,13085,12965,12985,13030,35,80,2402,"15,653.75",12800
,20160129,12985,13030,13050,13260,13000,13245,13145,215,115,4898,"32,200.06",14044
,20160201,13245,13145,13300,13510,13235,13330,13370,185,225,5474,"36,594.10",14396
,20160202,13330,13370,13345,13415,13325,13380,13370,10,0,3692,"24,688.70",14616
,20160203,13380,13370,13415,13570,13380,13525,13475,155,105,5098,"34,355.71",15290
,20160204,13525,13475,13450,13870,13450,13825,13695,350,220,8894,"60,922.95",16724
,20160205,13825,13695,13795,13800,13400,13600,13655,-95,-40,5226,"35,680.90",17436
,20160215,13600,13655,13915,13915,13585,13745,13755,90,100,5820,"40,036.70",18364
,20160216,13745,13755,13670,13785,13580,13590,13675,-165,-80,9360,"64,006.99",20256
,20160217,13590,13675,13625,13685,13470,13510,13560,-165,-115,9774,"66,284.25",20548
,20160218,13510,13560,13545,13550,13370,13485,13460,-75,-100,12370,"83,259.00",20786
,20160219,13485,13460,13410,13700,13370,13655,13520,195,60,17210,"116,362.63",20630
,20160222,13655,13520,13595,13870,13565,13860,13710,340,190,15512,"106,360.68",22436
,20160223,13860,13710,13900,13930,13465,13590,13660,-120,-50,13966,"95,415.90",22742
,20160224,13590,13660,13620,13630,13490,13555,13555,-105,-105,8822,"59,792.38",22820
,20160225,13555,13555,13545,13760,13485,13520,13610,-35,55,13376,"91,056.76",22992
,20160226,13520,13610,13535,13660,13450,13610,13530,0,-80,13218,"89,442.52",21900
,20160229,13610,13530,13670,13835,13565,13650,13695,120,165,16522,"113,160.26",21462
,20160301,13650,13695,13740,13795,13500,13660,13635,-35,-60,8424,"57,435.47",19862
,20160302,13660,13635,13690,13800,13625,13740,13730,105,95,7518,"51,621.29",19942
,20160303,13740,13730,13725,13955,13725,13835,13830,105,100,8864,"61,295.45",19236
,20160304,13835,13830,13885,13950,13765,13890,13860,60,30,10946,"75,862.31",17870
,20160307,13890,13860,13870,14115,13765,13880,13915,20,55,10462,"72,800.85",16296
,20160308,13880,13915,13975,14260,13705,13730,13980,-185,65,11270,"78,803.06",12840
,20160309,13730,13980,13750,13820,13420,13570,13630,-410,-350,4646,"31,662.66",11336
,20160310,13570,13630,13665,13770,13585,13635,13660,5,30,2190,"14,963.00",10986
,20160311,13635,13660,13645,13780,13565,13765,13680,105,20,1648,"11,274.64",10766
,20160314,13765,13680,13740,13820,13650,13695,13730,15,50,1000,"6,865.11",10500
,20160315,13695,13730,13725,13740,13605,13605,13655,-125,-75,988,"6,747.69",10306
,20160316,13605,13655,13525,13650,13510,13570,13565,-85,-90,1362,"9,239.16",9686
,20160317,13570,13565,13515,13735,13505,13735,13615,170,50,940,"6,399.37",9296
,20160318,13735,13615,13720,13795,13665,13690,13730,75,115,1170,"8,033.44",8790
,20160321,13690,13730,13635,13780,13600,13670,13695,-60,-35,1018,"6,971.04",8178
,20160322,13670,13695,13680,13735,13635,13650,13670,-45,-25,764,"5,223.70",7876
,20160323,13650,13670,13625,13720,13605,13635,13645,-35,-25,1276,"8,707.95",7010
,20160324,13635,13645,13620,13665,13615,13620,13630,-25,-15,1256,"8,560.03",6732
,20160325,13620,13630,13600,13665,13580,13620,13620,-10,-10,1104,"7,519.42",6464
,20160328,13620,13620,13670,13685,13610,13640,13660,20,40,880,"6,011.07",6342
,20160329,13640,13660,13690,13725,13630,13645,13670,-15,10,1950,"13,328.33",5670
,20160330,13645,13670,13640,13680,13375,13375,13600,-295,-70,1598,"10,868.72",4512
,20160331,13375,13600,13325,13450,13255,13290,13330,-310,-270,1716,"11,439.09",3180
,20160401,13290,13330,13280,13420,13235,13420,13305,90,-25,810,"5,388.78",2430
,20160405,13420,13305,13375,13375,13290,13290,13315,-15,10,460,"3,062.98",2020
,20160406,13290,13315,13305,13305,13155,13165,13260,-150,-55,540,"3,581.50",1660
,20160407,13165,13260,13190,13300,13160,13295,13225,35,-35,770,"5,092.25",1310
,20160408,13295,13225,13095,13135,13070,13070,13095,-155,-130,510,"3,339.83",1050
,20160411,13070,13095,13070,13260,13070,13240,13245,145,150,290,"1,921.05",770
,20160412,13240,13245,13180,13180,12730,12730,13145,-515,-100,620,"4,075.55",600
,20160413,12730,13145,,,,13145,13145,0,0,0,0.00,600
,20160414,13145,13145,13670,13670,12655,13350,13175,205,30,290,"1,910.63",560
,20160415,13350,13175,13200,13200,13200,13200,13200,25,25,10,66.00,560
pb1605,20160104,12850,12860,13020,13020,12855,12860,12890,0,30,112,721.88,540
,20160105,12860,12890,12815,13045,12815,13020,12945,130,55,142,919.25,566
,20160106,13020,12945,12985,13045,12960,13000,12990,55,45,114,740.66,610
,20160107,13000,12990,13015,13025,12900,12900,12960,-90,-30,290,"1,879.39",736
,20160108,12900,12960,12660,12900,12660,12850,12740,-110,-220,116,739.10,756
,20160111,12850,12740,12755,12755,12660,12700,12695,-40,-45,56,355.52,774
,20160112,12700,12695,12660,12660,12450,12450,12570,-245,-125,188,"1,181.64",866
,20160113,12450,12570,12390,12635,12390,12620,12575,50,5,302,"1,899.02",910
,20160114,12620,12575,12610,12750,12550,12715,12670,140,95,302,"1,913.59",1020
,20160115,12715,12670,12700,12760,12530,12530,12645,-140,-25,426,"2,693.59",1210
,20160118,12530,12645,12495,12720,12495,12720,12635,75,-10,166,"1,048.90",1200
,20160119,12720,12635,12730,12855,12695,12855,12775,220,140,150,958.48,1220
,20160120,12855,12775,12800,12870,12670,12755,12760,-20,-15,458,"2,922.82",1466
,20160121,12755,12760,12755,12755,12635,12635,12720,-125,-40,292,"1,857.85",1592
,20160122,12635,12720,12620,12780,12620,12685,12750,-35,30,522,"3,327.99",2016
,20160125,12685,12750,12800,12800,12660,12660,12665,-90,-85,84,532.03,2002
,20160126,12660,12665,12680,12750,12675,12715,12705,50,40,462,"2,935.60",2220
,20160127,12715,12705,12795,12945,12770,12945,12860,240,155,848,"5,453.27",2706
,20160128,12945,12860,12980,12980,12855,12895,12925,35,65,586,"3,788.00",2906
,20160129,12895,12925,12935,13100,12920,13100,13010,175,85,1188,"7,728.72",3432
,20160201,13100,13010,13170,13360,13090,13160,13220,150,210,1038,"6,861.65",3892
,20160202,13160,13220,13170,13240,13125,13215,13185,-5,-35,1324,"8,729.33",4152
,20160203,13215,13185,13225,13395,13225,13360,13315,175,130,1832,"12,199.77",4690
,20160204,13360,13315,13405,13700,13345,13690,13540,375,225,1668,"11,292.45",4648
,20160205,13690,13540,13610,13640,13235,13405,13465,-135,-75,796,"5,360.37",4670
,20160215,13405,13465,13560,13650,13455,13600,13585,135,120,1148,"7,800.65",4980
,20160216,13600,13585,13540,13625,13450,13470,13545,-115,-40,1784,"12,085.20",5664
,20160217,13470,13545,13480,13530,13345,13400,13435,-145,-110,3226,"21,676.91",6316
,20160218,13400,13435,13380,13400,13250,13330,13330,-105,-105,1834,"12,224.55",6476
,20160219,13330,13330,13295,13530,13250,13495,13375,165,45,3190,"21,335.29",7448
,20160222,13495,13375,13515,13680,13410,13665,13550,290,175,2376,"16,103.24",7818
,20160223,13665,13550,13715,13725,13325,13425,13465,-125,-85,1994,"13,427.50",8172
,20160224,13425,13465,13425,13430,13320,13395,13385,-70,-80,2090,"13,989.62",8562
,20160225,13395,13385,13345,13550,13315,13355,13440,-30,55,2598,"17,459.86",9388
,20160226,13355,13440,13360,13425,13260,13405,13330,-35,-110,3656,"24,368.40",10888
,20160229,13405,13330,13430,13620,13390,13460,13485,130,155,4460,"30,076.17",12024
,20160301,13460,13485,13580,13595,13350,13505,13460,20,-25,4836,"32,555.15",12558
,20160302,13505,13460,13535,13630,13465,13600,13565,140,105,5482,"37,185.59",14012
,20160303,13600,13565,13600,13780,13560,13710,13665,145,100,8002,"54,687.50",15924
,20160304,13710,13665,13825,13850,13675,13790,13755,125,90,10296,"70,817.88",17282
,20160307,13790,13755,13790,14100,13700,13870,13865,115,110,11638,"80,682.31",17868
,20160308,13870,13865,14000,14275,13715,13755,13995,-110,130,20670,"144,687.18",18088
,20160309,13755,13995,13795,13860,13485,13570,13630,-425,-365,13082,"89,171.19",17804
,20160310,13570,13630,13635,13795,13600,13605,13675,-25,45,8284,"56,650.18",18300
,20160311,13605,13675,13630,13770,13520,13770,13655,95,-20,7014,"47,904.85",18830
,20160314,13770,13655,13750,13815,13605,13695,13740,40,85,7806,"53,643.20",19214
,20160315,13695,13740,13720,13745,13605,13615,13650,-125,-90,4968,"33,916.91",18792
,20160316,13615,13650,13530,13600,13465,13525,13530,-125,-120,9472,"64,084.61",18586
,20160317,13525,13530,13485,13710,13415,13685,13565,155,35,8458,"57,386.06",18364
,20160318,13685,13565,13685,13790,13620,13630,13715,65,150,12836,"88,038.86",18482
,20160321,13630,13715,13600,13740,13470,13595,13650,-120,-65,8784,"59,958.34",18070
,20160322,13595,13650,13605,13700,13595,13600,13635,-50,-15,6704,"45,718.43",18632
,20160323,13600,13635,13595,13710,13540,13570,13590,-65,-45,6854,"46,588.38",18642
,20160324,13570,13590,13545,13595,13465,13520,13525,-70,-65,8002,"54,128.49",18838
,20160325,13520,13525,13495,13575,13435,13540,13525,15,0,4546,"30,748.06",18764
,20160328,13540,13525,13550,13620,13525,13575,13575,50,50,4188,"28,426.18",19128
,20160329,13575,13575,13575,13650,13530,13550,13585,-25,10,4220,"28,668.44",18722
,20160330,13550,13585,13550,13575,13285,13295,13475,-290,-110,7590,"51,151.76",17432
,20160331,13295,13475,13305,13385,13110,13240,13275,-235,-200,9630,"63,927.66",16768
,20160401,13240,13275,13240,13375,13170,13370,13280,95,5,6380,"42,364.77",16310
,20160405,13370,13280,13300,13330,13200,13230,13265,-50,-15,2444,"16,210.09",15762
,20160406,13230,13265,13230,13270,13155,13170,13220,-95,-45,2642,"17,470.02",15320
,20160407,13170,13220,13160,13300,13115,13230,13235,10,15,3850,"25,477.43",14688
,20160408,13230,13235,13230,13230,13000,13025,13070,-210,-165,5162,"33,739.33",14426
,20160411,13025,13070,13025,13270,12935,13165,13115,95,45,4160,"27,289.06",13544
,20160412,13165,13115,13140,13140,13000,13070,13065,-45,-50,3704,"24,205.07",13170
,20160413,13070,13065,13145,13460,13100,13390,13290,325,225,5454,"36,248.71",12564
,20160414,13390,13290,13410,13520,13265,13395,13390,105,100,6484,"43,417.42",10606
,20160415,13395,13390,13455,13460,13270,13275,13335,-115,-55,1988,"13,255.08",10604
,20160418,13275,13335,13295,13500,13240,13245,13325,-90,-10,2450,"16,328.65",9746
,20160419,13245,13325,13370,13390,13245,13290,13320,-35,-5,2220,"14,787.64",8822
,20160420,13290,13320,13380,13520,13355,13475,13420,155,100,2670,"17,921.08",7680
,20160421,13475,13420,13530,13595,13415,13440,13520,20,100,2706,"18,293.06",7372
,20160422,13440,13520,13595,13610,13155,13355,13370,-165,-150,2512,"16,796.25",6702
,20160425,13355,13370,13410,13560,13125,13400,13390,30,20,1646,"11,022.47",5820
,20160426,13400,13390,13355,13355,12980,13010,13190,-380,-200,2164,"14,274.50",5490
,20160427,13010,13190,13060,13135,13025,13060,13080,-130,-110,842,"5,507.15",5066
,20160428,13060,13080,13055,13075,12980,13045,13035,-35,-45,416,"2,712.19",4802
,20160429,13045,13035,13075,13320,12510,12510,13090,-525,55,420,"2,749.01",4570
,20160503,12510,13090,13300,13300,13120,13220,13160,130,70,650,"4,277.13",4830
,20160504,13220,13160,13140,13160,12960,12960,13040,-200,-120,610,"3,977.20",4380
,20160505,12960,13040,13100,13100,12885,12885,13020,-155,-20,570,"3,711.35",3960
,20160506,12885,13020,12915,12915,12770,12850,12805,-170,-215,500,"3,201.80",3560
,20160509,12850,12805,12850,12930,12800,12930,12825,125,20,410,"2,629.30",3250
,20160510,12930,12825,12820,12920,12810,12810,12825,-15,0,280,"1,795.78",3410
,20160511,12810,12825,12875,13100,12875,13000,13040,175,215,60,391.33,3360
,20160512,13000,13040,,,,13035,13035,-5,-5,0,0.00,3360
,20160513,13035,13035,12995,12995,12995,12995,12995,-40,-40,200,"1,299.50",3160
,20160516,12995,12995,12820,12840,12790,12800,12810,-195,-185,150,960.83,3200
pb1606,20160104,12750,12750,,,,12780,12780,30,30,0,0.00,20
,20160105,12780,12780,12920,12920,12920,12920,12920,140,140,2,12.92,22
,20160106,12920,12920,12930,12950,12875,12935,12915,15,-5,14,90.42,28
,20160107,12935,12915,12930,12945,12925,12925,12930,10,15,8,51.73,34
,20160108,12925,12930,12550,12845,12550,12740,12705,-190,-225,10,63.53,36
,20160111,12740,12705,,,,12660,12660,-45,-45,0,0.00,36
,20160112,12660,12660,12610,12610,12610,12610,12610,-50,-50,2,12.61,36
,20160113,12610,12610,12600,12600,12600,12600,12600,-10,-10,2,12.60,36
,20160114,12600,12600,12660,12660,12650,12650,12655,50,55,4,25.31,34
,20160115,12650,12655,12650,12705,12535,12540,12575,-115,-80,18,113.19,46
,20160118,12540,12575,12475,12475,12475,12475,12475,-100,-100,12,74.85,34
,20160119,12475,12475,12675,12800,12670,12800,12715,325,240,6,38.15,38
,20160120,12800,12715,12680,12680,12585,12585,12655,-130,-60,84,531.67,118
,20160121,12585,12655,,,,12620,12620,-35,-35,0,0.00,118
,20160122,12620,12620,12615,12680,12610,12620,12640,0,20,66,417.23,140
,20160125,12620,12640,12685,12685,12620,12620,12660,-20,20,38,240.63,176
,20160126,12620,12660,12625,12700,12625,12695,12680,35,20,48,304.37,196
,20160127,12695,12680,12760,12885,12750,12885,12805,205,125,60,384.18,194
,20160128,12885,12805,,,,12870,12870,65,65,0,0.00,194
,20160129,12870,12870,12880,12980,12830,12950,12875,80,5,368,"2,369.91",534
,20160201,12950,12875,13095,13145,13015,13015,13105,140,230,110,720.83,626
,20160202,13015,13105,13035,13060,13035,13060,13055,-45,-50,46,300.36,624
,20160203,13060,13055,13185,13325,13105,13265,13255,210,200,52,344.65,628
,20160204,13265,13255,13300,13520,13300,13515,13470,260,215,126,848.75,602
,20160205,13515,13470,13495,13595,13220,13220,13490,-250,20,74,499.21,622
,20160215,13220,13490,13465,13545,13465,13490,13520,0,30,106,716.59,704
,20160216,13490,13520,13430,13430,13405,13405,13405,-115,-115,24,160.89,720
,20160217,13405,13405,13400,13435,13290,13290,13400,-115,-5,56,375.26,730
,20160218,13290,13400,13240,13250,13180,13235,13210,-165,-190,46,303.93,750
,20160219,13235,13210,13290,13595,13250,13400,13350,190,140,254,"1,696.03",854
,20160222,13400,13350,13400,13575,13320,13575,13410,225,60,160,"1,072.97",960
,20160223,13575,13410,13530,13600,13250,13315,13420,-95,10,94,630.74,930
,20160224,13315,13420,13360,13360,13280,13290,13305,-130,-115,76,505.76,946
,20160225,13290,13305,13245,13475,13230,13260,13370,-45,65,194,"1,297.23",1004
,20160226,13260,13370,13195,13275,13135,13260,13200,-110,-170,1078,"7,115.54",1660
,20160229,13260,13200,13325,13460,13275,13325,13340,125,140,1330,"8,874.26",2226
,20160301,13325,13340,13420,13485,13270,13405,13375,65,35,954,"6,381.05",2758
,20160302,13405,13375,13475,13530,13400,13515,13480,140,105,418,"2,817.53",2878
,20160303,13515,13480,13515,13660,13490,13630,13575,150,95,756,"5,131.45",2896
,20160304,13630,13575,13700,13795,13585,13795,13660,220,85,1320,"9,018.47",2862
,20160307,13795,13660,13705,14095,13545,13820,13780,160,120,1802,"12,417.00",3056
,20160308,13820,13780,13955,14200,13720,13740,13945,-40,165,2074,"14,463.16",3648
,20160309,13740,13945,13795,13795,13520,13560,13655,-385,-290,1560,"10,652.01",3758
,20160310,13560,13655,13700,13730,13600,13600,13635,-55,-20,612,"4,173.77",3906
,20160311,13600,13635,13635,13730,13545,13725,13665,90,30,876,"5,986.50",4262
,20160314,13725,13665,13750,13775,13620,13690,13715,25,50,1018,"6,981.59",4704
,20160315,13690,13715,13710,13710,13585,13615,13645,-100,-70,416,"2,838.97",4804
,20160316,13615,13645,13505,13580,13455,13480,13495,-165,-150,850,"5,736.41",5050
,20160317,13480,13495,13415,13650,13400,13645,13520,150,25,1138,"7,695.32",5414
,20160318,13645,13520,13675,13725,13600,13600,13670,80,150,1566,"10,704.66",5548
,20160321,13600,13670,13595,13680,13495,13580,13605,-90,-65,446,"3,034.47",5534
,20160322,13580,13605,13615,13660,13560,13570,13615,-35,10,508,"3,458.91",5622
,20160323,13570,13615,13535,13655,13510,13520,13555,-95,-60,522,"3,537.87",5726
,20160324,13520,13555,13480,13525,13425,13460,13480,-95,-75,890,"5,999.70",5972
,20160325,13460,13480,13415,13500,13400,13480,13465,0,-15,894,"6,020.86",6346
,20160328,13480,13465,13510,13540,13460,13505,13505,40,40,706,"4,767.78",6580
,20160329,13505,13505,13545,13575,13440,13480,13500,-25,-5,1240,"8,372.58",7200
,20160330,13480,13500,13455,13480,13215,13240,13400,-260,-100,1086,"7,277.32",7574
,20160331,13240,13400,13250,13305,13145,13205,13215,-195,-185,3156,"20,853.59",8402
,20160401,13205,13215,13195,13320,13120,13315,13250,100,35,2404,"15,932.49",8680
,20160405,13315,13250,13265,13290,13170,13180,13230,-70,-20,1666,"11,023.35",9032
,20160406,13180,13230,13165,13220,13115,13120,13180,-110,-50,1498,"9,872.80",9364
,20160407,13120,13180,13085,13280,13085,13205,13200,25,20,2886,"19,050.93",10072
,20160408,13205,13200,13155,13180,12970,13000,13050,-200,-150,4664,"30,438.51",10888
,20160411,13000,13050,13015,13235,12970,13120,13095,70,45,4288,"28,085.12",10676
,20160412,13120,13095,13080,13090,12980,13040,13030,-55,-65,3662,"23,860.21",11444
,20160413,13040,13030,13110,13430,13060,13290,13250,260,220,10884,"72,130.02",13108
,20160414,13290,13250,13230,13435,13230,13350,13330,100,80,9914,"66,086.58",13964
,20160415,13350,13330,13400,13420,13235,13255,13305,-75,-25,6960,"46,315.59",14610
,20160418,13255,13305,13240,13355,13200,13215,13280,-90,-25,7764,"51,555.88",15480
,20160419,13215,13280,13300,13385,13175,13255,13295,-25,15,9280,"61,693.37",16030
,20160420,13255,13295,13295,13505,13295,13450,13410,155,115,13162,"88,268.01",16300
,20160421,13450,13410,13550,13620,13405,13440,13515,30,105,18156,"122,700.44",18228
,20160422,13440,13515,13555,13650,13210,13365,13430,-150,-85,17476,"117,362.79",17602
,20160425,13365,13430,13430,13640,13180,13420,13450,-10,20,16202,"108,980.40",17442
,20160426,13420,13450,13350,13400,13030,13060,13220,-390,-230,11894,"78,624.77",17080
,20160427,13060,13220,13100,13215,13070,13105,13130,-115,-90,7104,"46,653.44",17248
,20160428,13105,13130,13160,13175,13020,13060,13090,-70,-40,8052,"52,706.29",17044
,20160429,13060,13090,13090,13245,13055,13230,13155,140,65,7602,"50,013.19",16474
,20160503,13230,13155,13245,13370,13180,13365,13250,210,95,6482,"42,952.61",15834
,20160504,13365,13250,13295,13360,13030,13060,13155,-190,-95,6156,"40,504.83",15290
,20160505,13060,13155,13160,13190,13010,13040,13090,-115,-65,4192,"27,446.41",15038
,20160506,13040,13090,13090,13090,12740,12875,12910,-215,-180,8110,"52,351.73",14128
,20160509,12875,12910,12900,13005,12840,12955,12890,45,-20,6014,"38,761.96",12380
,20160510,12955,12890,12995,13020,12815,12950,12915,60,25,5450,"35,196.63",10860
,20160511,12950,12915,12925,13115,12925,13100,13045,185,130,2700,"17,614.11",10684
,20160512,13100,13045,13150,13215,13005,13060,13115,15,70,3690,"24,204.69",9618
,20160513,13060,13115,13050,13100,12820,12820,12945,-295,-170,3916,"25,352.16",9000
,20160516,12820,12945,12880,12935,12755,12840,12860,-105,-85,1940,"12,477.94",9014
,20160517,12840,12860,12810,12990,12810,12965,12915,105,55,1250,"8,073.20",8702
,20160518,12965,12915,12885,12945,12805,12840,12855,-75,-60,1252,"8,049.43",8408
,20160519,12840,12855,12810,12980,12700,12845,12810,-10,-45,1606,"10,288.79",8168
,20160520,12845,12810,12650,12855,12650,12805,12765,-5,-45,1032,"6,588.70",7920
,20160523,12805,12765,12820,12890,12675,12715,12730,-50,-35,954,"6,073.98",7476
,20160524,12715,12730,12610,12730,12610,12640,12695,-90,-35,1628,"10,334.46",7034
,20160525,12640,12695,12725,12750,12650,12690,12685,-5,-10,1002,"6,355.92",6696
,20160526,12690,12685,12690,12780,12625,12745,12685,60,0,1936,"12,281.35",6306
,20160527,12745,12685,12870,12880,12695,12800,12765,115,80,710,"4,532.62",5874
,20160530,12800,12765,12785,12860,12780,12850,12820,85,55,1144,"7,334.42",5226
,20160531,12850,12820,12900,13280,12510,13280,12780,460,-40,2890,"18,470.92",4356
,20160601,13280,12780,12800,12820,12610,12610,12695,-170,-85,346,"2,196.69",4210
,20160602,12610,12695,12650,12800,12650,12800,12725,105,30,700,"4,454.43",4440
,20160603,12800,12725,12835,12835,12700,12730,12725,5,0,810,"5,155.13",4480
,20160606,12730,12725,12785,12800,12745,12745,12780,20,55,200,"1,278.13",4420
,20160607,12745,12780,12800,12870,12730,12750,12765,-30,-15,1220,"7,788.78",4330
,20160608,12750,12765,12740,12760,12720,12755,12745,-10,-20,220,"1,402.15",4130
,20160613,12755,12745,12780,12800,12780,12795,12785,50,40,80,511.53,4150
,20160614,12795,12785,12685,12750,12510,12670,12660,-115,-125,70,443.13,4140
,20160615,12670,12660,12710,12740,12710,12740,12725,80,65,110,699.88,4130
pb1607,20160104,12655,12655,,,,12685,12685,30,30,0,0.00,12
,20160105,12685,12685,,,,12820,12820,135,135,0,0.00,12
,20160106,12820,12820,12795,12795,12795,12795,12795,-25,-25,4,25.59,16
,20160107,12795,12795,12840,12840,12750,12750,12780,-45,-15,6,38.34,18
,20160108,12750,12780,,,,12555,12555,-225,-225,0,0.00,18
,20160111,12555,12555,12560,12560,12560,12560,12560,5,5,2,12.56,18
,20160112,12560,12560,,,,12510,12510,-50,-50,0,0.00,18
,20160113,12510,12510,,,,12510,12510,0,0,0,0.00,18
,20160114,12510,12510,12600,12600,12600,12600,12600,90,90,2,12.60,18
,20160115,12600,12600,12595,12675,12580,12580,12640,-20,40,32,202.30,30
,20160118,12580,12640,12480,12480,12480,12480,12480,-160,-160,2,12.48,30
,20160119,12480,12480,12685,12690,12685,12690,12685,210,205,8,50.75,34
,20160120,12690,12685,,,,12625,12625,-60,-60,0,0.00,34
,20160121,12625,12625,,,,12590,12590,-35,-35,0,0.00,34
,20160122,12590,12590,,,,12610,12610,20,20,0,0.00,34
,20160125,12610,12610,,,,12630,12630,20,20,0,0.00,34
,20160126,12630,12630,,,,12650,12650,20,20,0,0.00,34
,20160127,12650,12650,12720,12795,12700,12700,12710,50,60,20,127.13,26
,20160128,12700,12710,12825,12825,12755,12775,12785,65,75,6,38.36,28
,20160129,12775,12785,12825,12880,12730,12880,12795,95,10,10,63.99,38
,20160201,12880,12795,13030,13155,13030,13045,13095,250,300,12,78.57,36
,20160202,13045,13095,,,,13045,13045,-50,-50,0,0.00,36
,20160203,13045,13045,13130,13130,13130,13130,13130,85,85,2,13.13,36
,20160204,13130,13130,,,,13345,13345,215,215,0,0.00,36
,20160205,13345,13345,,,,13365,13365,20,20,0,0.00,36
,20160215,13365,13365,,,,13395,13395,30,30,0,0.00,36
,20160216,13395,13395,13360,13395,13360,13395,13370,0,-25,20,133.71,52
,20160217,13395,13370,13390,13395,13355,13355,13385,-15,15,76,508.76,122
,20160218,13355,13385,,,,13195,13195,-190,-190,0,0.00,122
,20160219,13195,13195,13250,13300,13250,13300,13255,105,60,12,79.55,132
,20160222,13300,13255,13295,13355,13265,13355,13300,100,45,8,53.21,136
,20160223,13355,13300,13470,13470,13145,13145,13305,-155,5,18,119.77,136
,20160224,13145,13305,13250,13250,13250,13250,13250,-55,-55,2,13.25,136
,20160225,13250,13250,13200,13200,13200,13200,13200,-50,-50,2,13.20,136
,20160226,13200,13200,13130,13130,13095,13100,13105,-100,-95,6,39.33,138
,20160229,13100,13105,13190,13190,13165,13165,13175,60,70,4,26.36,138
,20160301,13165,13175,13300,13330,13300,13330,13310,155,135,14,93.19,136
,20160302,13330,13310,,,,13310,13310,0,0,0,0.00,136
,20160303,13310,13310,13530,13530,13530,13530,13530,220,220,2,13.53,136
,20160304,13530,13530,,,,13615,13615,85,85,0,0.00,136
,20160307,13615,13615,13590,13775,13590,13775,13705,160,90,6,41.12,132
,20160308,13775,13705,14125,14125,13730,13800,14000,95,295,60,420.14,170
,20160309,13800,14000,13505,13505,13505,13505,13505,-495,-495,2,13.51,170
,20160310,13505,13505,,,,13550,13550,45,45,0,0.00,170
,20160311,13550,13550,,,,13580,13580,30,30,0,0.00,170
,20160314,13580,13580,,,,13630,13630,50,50,0,0.00,170
,20160315,13630,13630,,,,13560,13560,-70,-70,0,0.00,170
,20160316,13560,13560,13495,13495,13495,13495,13495,-65,-65,2,13.50,168
,20160317,13495,13495,13540,13570,13540,13570,13550,75,55,6,40.66,166
,20160318,13570,13550,13660,13680,13635,13635,13655,85,105,6,40.98,166
,20160321,13635,13655,,,,13590,13590,-65,-65,0,0.00,166
,20160322,13590,13590,,,,13590,13590,0,0,0,0.00,166
,20160323,13590,13590,13540,13540,13540,13540,13540,-50,-50,2,13.54,166
,20160324,13540,13540,13440,13465,13440,13465,13450,-75,-90,4,26.91,164
,20160325,13465,13450,,,,13450,13450,0,0,0,0.00,164
,20160328,13450,13450,,,,13490,13490,40,40,0,0.00,164
,20160329,13490,13490,13445,13445,13445,13445,13445,-45,-45,6,40.34,170
,20160330,13445,13445,13360,13360,13360,13360,13360,-85,-85,2,13.36,170
,20160331,13360,13360,13220,13250,13155,13155,13195,-205,-165,12,79.18,170
,20160401,13155,13195,,,,13230,13230,35,35,0,0.00,170
,20160405,13230,13230,13190,13190,13190,13190,13190,-40,-40,2,13.19,170
,20160406,13190,13190,13175,13175,13175,13175,13175,-15,-15,2,13.18,170
,20160407,13175,13175,13170,13230,13170,13225,13200,50,25,14,92.42,172
,20160408,13225,13200,13100,13100,12950,13005,13005,-195,-195,56,364.22,188
,20160411,13005,13005,13055,13170,13020,13100,13095,95,90,382,"2,501.22",360
,20160412,13100,13095,13010,13020,12990,13000,12995,-95,-100,118,766.84,378
,20160413,13000,12995,13065,13390,13065,13250,13215,255,220,940,"6,212.07",1062
,20160414,13250,13215,13280,13435,13245,13340,13340,125,125,868,"5,791.11",1654
,20160415,13340,13340,13355,13395,13225,13225,13300,-115,-40,490,"3,259.48",1778
,20160418,13225,13300,13225,13315,13185,13215,13265,-85,-35,162,"1,074.66",1822
,20160419,13215,13265,13310,13345,13170,13235,13260,-30,-5,700,"4,642.37",2086
,20160420,13235,13260,13300,13430,13275,13395,13365,135,105,2202,"14,716.12",3154
,20160421,13395,13365,13445,13565,13400,13450,13475,85,110,3994,"26,914.89",5278
,20160422,13450,13475,13600,13615,13215,13385,13460,-90,-15,3448,"23,208.97",6470
,20160425,13385,13460,13495,13615,13345,13450,13465,-10,5,4734,"31,878.74",8322
,20160426,13450,13465,13450,13450,13045,13105,13225,-360,-240,2526,"16,703.93",8384
,20160427,13105,13225,13195,13245,13120,13160,13175,-65,-50,1558,"10,263.40",8580
,20160428,13160,13175,13200,13200,13060,13080,13115,-95,-60,2090,"13,710.11",9160
,20160429,13080,13115,13120,13285,13105,13280,13190,165,75,2406,"15,872.89",10212
,20160503,13280,13190,13335,13405,13235,13405,13290,215,100,2862,"19,018.86",11338
,20160504,13405,13290,13370,13390,13095,13120,13190,-170,-100,3052,"20,130.03",12146
,20160505,13120,13190,13200,13210,13070,13080,13135,-110,-55,4316,"28,355.58",13406
,20160506,13080,13135,13070,13115,12845,12925,12930,-210,-205,8746,"56,548.55",15304
,20160509,12925,12930,12875,13040,12845,12970,12915,40,-15,9804,"63,319.21",17164
,20160510,12970,12915,12955,13050,12850,12970,12935,55,20,7614,"49,244.02",17482
,20160511,12970,12935,12970,13140,12970,13120,13065,185,130,7012,"45,806.66",18102
,20160512,13120,13065,13150,13245,12925,13090,13135,25,70,8262,"54,272.75",18426
,20160513,13090,13135,13035,13135,12850,12885,12960,-250,-175,9852,"63,841.71",17080
,20160516,12885,12960,12885,12965,12780,12880,12865,-80,-95,8528,"54,863.56",17534
,20160517,12880,12865,12845,13000,12830,12985,12925,120,60,7186,"46,449.41",17820
,20160518,12985,12925,12915,12960,12805,12860,12870,-65,-55,8020,"51,619.40",17490
,20160519,12860,12870,12815,12990,12700,12870,12835,0,-35,11854,"76,081.93",16522
,20160520,12870,12835,12835,12835,12675,12795,12755,-40,-80,9578,"61,090.82",16898
,20160523,12795,12755,12840,12870,12670,12690,12745,-65,-10,10808,"68,883.34",14644
,20160524,12690,12745,12625,12730,12590,12640,12655,-105,-90,8318,"52,648.89",13364
,20160525,12640,12655,12685,12760,12600,12650,12665,-5,10,6366,"40,313.77",14306
,20160526,12650,12665,12720,12750,12610,12715,12675,50,10,5996,"38,003.96",14858
,20160527,12715,12675,12740,12875,12690,12805,12770,130,95,6872,"43,882.62",14430
,20160530,12805,12770,12840,12880,12785,12850,12825,80,55,4640,"29,757.45",14134
,20160531,12850,12825,12830,12900,12730,12785,12795,-40,-30,4420,"28,285.26",14396
,20160601,12785,12795,12815,12850,12640,12670,12710,-125,-85,6812,"43,295.71",14764
,20160602,12670,12710,12650,12870,12650,12860,12790,150,80,8374,"53,568.74",12858
,20160603,12860,12790,12860,12860,12700,12770,12780,-20,-10,4618,"29,510.79",12818
,20160606,12770,12780,12800,12835,12770,12800,12800,20,20,5468,"35,004.02",13350
,20160607,12800,12800,12785,12875,12725,12750,12775,-50,-25,4260,"27,217.14",12508
,20160608,12750,12775,12745,12765,12710,12720,12725,-55,-50,5022,"31,963.67",11626
,20160613,12720,12725,12700,12865,12655,12865,12810,140,85,4386,"28,094.20",9918
,20160614,12865,12810,12860,12860,12715,12730,12765,-80,-45,3794,"24,219.21",8998
,20160615,12730,12765,12725,12795,12720,12750,12745,-15,-20,3916,"24,962.18",8732
,20160616,12750,12745,12825,12880,12670,12765,12750,20,5,3062,"19,523.44",7642
,20160617,12765,12750,12800,12840,12720,12805,12785,55,35,2536,"16,216.21",7142
,20160620,12805,12785,12800,12830,12645,12760,12770,-25,-15,1846,"11,786.88",6374
,20160621,12760,12770,12850,12850,12730,12805,12810,35,40,1706,"10,927.44",5816
,20160622,12805,12810,12805,12850,12750,12835,12805,25,-5,1320,"8,453.27",5326
,20160623,12835,12805,12855,12905,12755,12795,12805,-10,0,1192,"7,631.90",4816
,20160624,12795,12805,12860,12860,12685,12700,12790,-105,-15,730,"4,668.56",4574
,20160627,12700,12790,12695,12810,12695,12800,12785,10,-5,1568,"10,023.68",3638
,20160628,12800,12785,12755,12830,12730,12800,12790,15,5,2368,"15,144.61",3252
,20160629,12800,12790,12875,12950,12730,12840,12890,50,100,2104,"13,561.88",3570
,20160630,12840,12890,12935,13110,12865,13110,12950,220,60,1696,"10,981.74",4314
,20160701,13110,12950,13070,13175,13000,13175,13095,225,145,1634,"10,702.66",5240
,20160704,13175,13095,13310,13445,13290,13370,13355,275,260,1680,"11,218.35",6270
,20160705,13370,13355,13380,13380,13000,13030,13130,-325,-225,400,"2,626.65",6270
,20160706,13030,13130,13060,13060,12855,12900,12940,-230,-190,160,"1,035.40",6160
,20160707,12900,12940,12850,13025,12850,12880,12970,-60,30,210,"1,361.95",6110
,20160708,12880,12970,12865,12915,12845,12875,12865,-95,-105,100,643.40,6040
,20160711,12875,12865,12900,13000,12895,13000,12915,135,50,290,"1,872.75",5990
,20160712,13000,12915,12990,13060,12950,13045,13020,130,105,300,"1,953.03",6220
,20160713,13045,13020,13150,13200,13100,13100,13160,80,140,40,263.25,6240
,20160714,13100,13160,13100,13100,13050,13100,13080,-60,-80,210,"1,373.68",6270
,20160715,13100,13080,13150,13230,13150,13230,13190,150,110,430,"2,836.63",6470
pb1608,20160104,12490,12490,,,,12515,12515,25,25,0,0.00,28
,20160105,12515,12515,12745,12745,12745,12745,12745,230,230,2,12.75,26
,20160106,12745,12745,12775,12775,12730,12730,12740,-15,-5,8,50.98,24
,20160107,12730,12740,12685,12685,12685,12685,12685,-55,-55,6,38.06,28
,20160108,12685,12685,,,,12465,12465,-220,-220,0,0.00,28
,20160111,12465,12465,12435,12535,12435,12535,12495,70,30,8,49.98,30
,20160112,12535,12495,12450,12480,12450,12480,12465,-15,-30,8,49.86,30
,20160113,12480,12465,12475,12475,12450,12470,12465,5,0,6,37.40,30
,20160114,12470,12465,12470,12560,12470,12560,12510,95,45,8,50.04,32
,20160115,12560,12510,12530,12530,12405,12405,12465,-105,-45,4,24.94,34
,20160118,12405,12465,12555,12555,12555,12555,12555,90,90,2,12.56,34
,20160119,12555,12555,,,,12760,12760,205,205,0,0.00,34
,20160120,12760,12760,,,,12700,12700,-60,-60,0,0.00,34
,20160121,12700,12700,,,,12665,12665,-35,-35,0,0.00,34
,20160122,12665,12665,12425,12460,12425,12460,12445,-205,-220,6,37.34,34
,20160125,12460,12445,12500,12500,12485,12485,12490,40,45,4,24.99,34
,20160126,12485,12490,12575,12575,12575,12575,12575,85,85,2,12.58,34
,20160127,12575,12575,12755,12755,12685,12685,12725,110,150,8,50.90,30
,20160128,12685,12725,,,,12800,12800,75,75,0,0.00,30
,20160129,12800,12800,12810,12810,12705,12705,12730,-95,-70,8,50.93,34
,20160201,12705,12730,,,,13025,13025,295,295,0,0.00,34
,20160202,13025,13025,,,,12975,12975,-50,-50,0,0.00,34
,20160203,12975,12975,13165,13190,13165,13190,13170,215,195,6,39.52,32
,20160204,13190,13170,,,,13385,13385,215,215,0,0.00,32
,20160205,13385,13385,,,,13405,13405,20,20,0,0.00,32
,20160215,13405,13405,,,,13435,13435,30,30,0,0.00,32
,20160216,13435,13435,,,,13410,13410,-25,-25,0,0.00,32
,20160217,13410,13410,,,,13425,13425,15,15,0,0.00,32
,20160218,13425,13425,,,,13235,13235,-190,-190,0,0.00,32
,20160219,13235,13235,,,,13295,13295,60,60,0,0.00,32
,20160222,13295,13295,,,,13340,13340,45,45,0,0.00,32
,20160223,13340,13340,,,,13345,13345,5,5,0,0.00,32
,20160224,13345,13345,,,,13285,13285,-60,-60,0,0.00,32
,20160225,13285,13285,,,,13230,13230,-55,-55,0,0.00,32
,20160226,13230,13230,13035,13035,12975,12975,13005,-255,-225,4,26.01,34
,20160229,12975,13005,13200,13205,13090,13090,13160,85,155,12,78.99,36
,20160301,13090,13160,13185,13250,13120,13250,13180,90,20,10,65.92,34
,20160302,13250,13180,13345,13345,13305,13305,13325,125,145,4,26.65,34
,20160303,13305,13325,13235,13235,13235,13235,13235,-90,-90,2,13.24,34
,20160304,13235,13235,13465,13525,13395,13470,13465,235,230,12,80.80,28
,20160307,13470,13465,13520,13620,13520,13620,13550,155,85,6,40.66,24
,20160308,13620,13550,13895,13955,13755,13755,13895,205,345,14,97.29,28
,20160309,13755,13895,13650,13650,13535,13585,13575,-310,-320,8,54.31,30
,20160310,13585,13575,,,,13575,13575,0,0,0,0.00,30
,20160311,13575,13575,,,,13575,13575,0,0,0,0.00,30
,20160314,13575,13575,,,,13575,13575,0,0,0,0.00,30
,20160315,13575,13575,,,,13505,13505,-70,-70,0,0.00,30
,20160316,13505,13505,13445,13445,13445,13445,13445,-60,-60,2,13.45,28
,20160317,13445,13445,13515,13515,13500,13500,13505,55,60,6,40.52,28
,20160318,13500,13505,13620,13640,13620,13640,13630,135,125,10,68.17,32
,20160321,13640,13630,,,,13565,13565,-65,-65,0,0.00,32
,20160322,13565,13565,13560,13560,13560,13560,13560,-5,-5,4,27.12,34
,20160323,13560,13560,13570,13570,13570,13570,13570,10,10,2,13.57,34
,20160324,13570,13570,,,,13480,13480,-90,-90,0,0.00,34
,20160325,13480,13480,13450,13450,13365,13365,13405,-115,-75,4,26.82,32
,20160328,13365,13405,13460,13460,13460,13460,13460,55,55,4,26.92,34
,20160329,13460,13460,13430,13430,13405,13420,13420,-40,-40,8,53.68,40
,20160330,13420,13420,13320,13320,13300,13300,13310,-120,-110,4,26.62,44
,20160331,13300,13310,13195,13265,13125,13125,13200,-185,-110,34,224.40,52
,20160401,13125,13200,13145,13175,13145,13175,13165,-25,-35,6,39.50,52
,20160405,13175,13165,13210,13210,13185,13185,13195,20,30,4,26.40,52
,20160406,13185,13195,13155,13165,13155,13165,13160,-30,-35,4,26.32,52
,20160407,13165,13160,13210,13235,13210,13235,13220,75,60,16,105.79,66
,20160408,13235,13220,13095,13095,12995,12995,13055,-225,-165,46,300.30,94
,20160411,12995,13055,13045,13110,13035,13110,13060,55,5,12,78.37,100
,20160412,13110,13060,13015,13015,12965,13010,13000,-50,-60,28,182.07,120
,20160413,13010,13000,13265,13380,13215,13285,13285,285,285,20,132.85,134
,20160414,13285,13285,13335,13405,13260,13285,13310,0,25,12,79.88,134
,20160415,13285,13310,13340,13340,13260,13280,13290,-30,-20,14,93.06,144
,20160418,13280,13290,13240,13315,13210,13210,13255,-80,-35,22,145.81,162
,20160419,13210,13255,13315,13315,13185,13185,13250,-70,-5,14,92.76,170
,20160420,13185,13250,13320,13420,13270,13320,13370,70,120,108,722.14,178
,20160421,13320,13370,13435,13555,13380,13480,13470,110,100,152,"1,023.79",162
,20160422,13480,13470,13515,13515,13335,13390,13405,-80,-65,182,"1,220.11",242
,20160425,13390,13405,13420,13570,13305,13420,13460,15,55,304,"2,046.07",292
,20160426,13420,13460,13320,13320,13135,13135,13185,-325,-275,154,"1,015.61",326
,20160427,13135,13185,13215,13255,13190,13240,13215,55,30,326,"2,154.63",576
,20160428,13240,13215,13110,13170,13100,13155,13140,-60,-75,54,354.89,554
,20160429,13155,13140,13150,13255,13150,13240,13220,100,80,58,383.41,538
,20160503,13240,13220,13310,13400,13285,13400,13325,180,105,56,373.14,532
,20160504,13400,13325,13385,13385,13150,13160,13305,-165,-20,248,"1,650.04",584
,20160505,13160,13305,13200,13215,13130,13130,13180,-175,-125,92,606.42,632
,20160506,13130,13180,13105,13105,12900,12985,12965,-195,-215,676,"4,382.72",948
,20160509,12985,12965,12985,13045,12895,12995,12950,30,-15,478,"3,095.93",1072
,20160510,12995,12950,12965,13060,12900,13000,12985,50,35,608,"3,948.30",1474
,20160511,13000,12985,13010,13160,13010,13110,13085,125,100,414,"2,708.88",1596
,20160512,13110,13085,13165,13255,13065,13105,13150,20,65,774,"5,090.24",2024
,20160513,13105,13150,13095,13115,12860,12900,12940,-250,-210,1090,"7,052.43",2358
,20160516,12900,12940,12880,12930,12805,12880,12860,-60,-80,722,"4,643.35",2580
,20160517,12880,12860,12855,13030,12840,13020,12955,160,95,1524,"9,872.03",3374
,20160518,13020,12955,12940,12975,12840,12870,12895,-85,-60,812,"5,236.81",3608
,20160519,12870,12895,12835,12990,12755,12890,12825,-5,-70,1182,"7,581.50",3816
,20160520,12890,12825,12800,12825,12700,12800,12775,-25,-50,1352,"8,639.02",4138
,20160523,12800,12775,12835,12890,12705,12720,12765,-55,-10,2416,"15,420.18",4568
,20160524,12720,12765,12660,12740,12640,12650,12680,-115,-85,3820,"24,227.35",6310
,20160525,12650,12680,12685,12760,12650,12700,12690,20,10,1152,"7,310.03",6670
,20160526,12700,12690,12760,12765,12655,12750,12700,60,10,1586,"10,072.53",6920
,20160527,12750,12700,12780,12860,12715,12820,12785,120,85,1540,"9,848.24",6764
,20160530,12820,12785,12840,12885,12800,12845,12830,60,45,1302,"8,352.81",6560
,20160531,12845,12830,12870,12875,12770,12795,12810,-35,-20,1750,"11,209.15",6904
,20160601,12795,12810,12815,12820,12685,12700,12720,-110,-90,2668,"16,974.67",7952
,20160602,12700,12720,12685,12905,12685,12895,12825,175,105,4744,"30,426.39",8562
,20160603,12895,12825,12900,12915,12740,12810,12830,-15,5,2288,"14,680.60",9034
,20160606,12810,12830,12860,12875,12805,12830,12835,0,5,2846,"18,269.83",9628
,20160607,12830,12835,12835,12895,12755,12780,12815,-55,-20,2952,"18,921.00",9992
,20160608,12780,12815,12780,12800,12720,12740,12760,-75,-55,3084,"19,676.37",10446
,20160613,12740,12760,12705,12885,12670,12875,12815,115,55,2522,"16,160.40",10852
,20160614,12875,12815,12850,12890,12740,12755,12805,-60,-10,3732,"23,898.24",11868
,20160615,12755,12805,12745,12945,12730,12830,12790,25,-15,3582,"22,911.13",11800
,20160616,12830,12790,12875,12940,12700,12805,12800,15,10,5006,"32,044.97",12118
,20160617,12805,12800,12820,12935,12775,12870,12830,70,30,6164,"39,557.02",12986
,20160620,12870,12830,12840,12880,12685,12790,12795,-40,-35,5668,"36,263.44",13598
,20160621,12790,12795,12800,12885,12785,12830,12835,35,40,5068,"32,527.86",13618
,20160622,12830,12835,12800,12885,12755,12870,12825,35,-10,3800,"24,372.44",14212
,20160623,12870,12825,12870,12930,12780,12840,12845,15,20,5530,"35,529.87",14446
,20160624,12840,12845,12890,12895,12720,12730,12800,-115,-45,7360,"47,117.99",13966
,20160627,12730,12800,12760,12865,12740,12850,12815,50,15,5708,"36,586.34",14524
,20160628,12850,12815,12825,12915,12775,12900,12855,85,40,8258,"53,092.31",15894
,20160629,12900,12855,12930,13065,12785,12935,12930,80,75,15042,"97,256.40",15214
,20160630,12935,12930,12980,13275,12920,13175,13050,245,120,16118,"105,194.20",16968
,20160701,13175,13050,13210,13270,13085,13260,13185,210,135,12344,"81,406.52",16056
,20160704,13260,13185,13355,13585,13330,13440,13445,255,260,13166,"88,518.23",15986
,20160705,13440,13445,13455,13470,12950,13110,13200,-335,-245,13054,"86,157.42",14792
,20160706,13110,13200,13160,13220,12900,12970,13020,-230,-180,9414,"61,298.88",14640
,20160707,12970,13020,12875,13115,12850,12920,12985,-100,-35,5740,"37,272.90",14672
,20160708,12920,12985,12955,13000,12890,12965,12940,-20,-45,4378,"28,327.69",14000
,20160711,12965,12940,13040,13100,12885,13090,13000,150,60,3312,"21,530.11",13398
,20160712,13090,13000,13080,13160,13015,13115,13080,115,80,1980,"12,949.35",12968
,20160713,13115,13080,13215,13350,13095,13155,13225,75,145,3846,"25,437.64",13026
,20160714,13155,13225,13160,13210,13070,13185,13140,-40,-85,1546,"10,159.52",12948
,20160715,13185,13140,13195,13350,13190,13335,13275,195,135,2818,"18,704.72",12554
,20160718,13335,13275,13360,13390,13055,13130,13195,-145,-80,1322,"8,723.08",12410
,20160719,13130,13195,13170,13330,13080,13285,13220,90,25,1862,"12,309.72",11802
,20160720,13285,13220,13270,13325,13180,13220,13250,0,30,1414,"9,369.61",11358
,20160721,13220,13250,13095,13340,13075,13330,13245,80,-5,1740,"11,526.93",10886
,20160722,13330,13245,13350,13435,13290,13305,13365,60,120,2268,"15,159.15",9960
,20160725,13305,13365,13285,13580,13215,13530,13440,165,75,1544,"10,375.97",9692
,20160726,13530,13440,13530,13770,13435,13720,13595,280,155,1900,"12,916.99",9038
,20160727,13720,13595,13625,13775,13620,13695,13700,100,105,1530,"10,482.48",8512
,20160728,13695,13700,13690,13690,13475,13520,13585,-180,-115,878,"5,965.00",8040
,20160729,13520,13585,13520,13850,13045,13670,13630,85,45,866,"5,902.66",7612
,20160801,13670,13630,13755,14040,13755,14000,13895,370,265,692,"4,808.10",7410
,20160802,14000,13895,13955,14005,13810,13850,13945,-45,50,530,"3,696.45",7060
,20160803,13850,13945,13900,13900,13750,13780,13795,-165,-150,550,"3,794.55",6760
,20160804,13780,13795,13755,13850,13755,13775,13795,-20,0,310,"2,138.45",6640
,20160805,13775,13795,13720,13900,13720,13900,13795,105,0,430,"2,966.53",6530
,20160808,13900,13795,13870,13870,13755,13850,13810,55,15,1130,"7,803.50",6370
,20160809,13850,13810,13825,13825,13750,13750,13780,-60,-30,610,"4,203.05",6080
,20160810,13750,13780,13700,13790,13680,13700,13745,-80,-35,560,"3,849.70",6100
,20160811,13700,13745,13730,13800,13730,13800,13750,55,5,290,"1,993.93",5970
,20160812,13800,13750,13750,13780,13750,13775,13775,25,25,110,757.63,5860
,20160815,13775,13775,13765,13775,13450,13450,13660,-325,-115,360,"2,459.43",5880
pb1609,20160104,12665,12630,,,,12660,12660,30,30,0,0.00,50
,20160105,12660,12660,12720,12720,12700,12700,12710,40,50,4,25.42,52
,20160106,12700,12710,12720,12720,12710,12710,12715,0,5,4,25.43,48
,20160107,12710,12715,12705,12745,12635,12635,12675,-80,-40,12,76.07,46
,20160108,12635,12675,,,,12675,12675,0,0,0,0.00,46
,20160111,12675,12675,12455,12455,12455,12455,12455,-220,-220,2,12.46,48
,20160112,12455,12455,12425,12425,12350,12350,12400,-105,-55,6,37.20,50
,20160113,12350,12400,12395,12400,12395,12400,12395,0,-5,10,62.00,44
,20160114,12400,12395,12380,12475,12380,12475,12405,80,10,12,74.46,40
,20160115,12475,12405,12475,12515,12360,12370,12400,-35,-5,14,86.83,46
,20160118,12370,12400,12370,12490,12370,12490,12440,90,40,10,62.20,48
,20160119,12490,12440,12640,12640,12640,12640,12640,200,200,2,12.64,50
,20160120,12640,12640,12630,12630,12450,12450,12530,-190,-110,10,62.65,54
,20160121,12450,12530,12445,12445,12445,12445,12445,-85,-85,2,12.45,56
,20160122,12445,12445,12425,12515,12400,12515,12435,70,-10,16,99.51,44
,20160125,12515,12435,12515,12515,12515,12515,12515,80,80,4,25.03,48
,20160126,12515,12515,,,,12600,12600,85,85,0,0.00,48
,20160127,12600,12600,12705,12705,12580,12580,12635,-20,35,12,75.84,44
,20160128,12580,12635,12605,12770,12600,12690,12705,55,70,18,114.38,42
,20160129,12690,12705,12785,12800,12600,12785,12715,80,10,34,216.16,44
,20160201,12785,12715,12915,13000,12915,13000,12940,285,225,6,38.83,44
,20160202,13000,12940,12920,12925,12920,12925,12920,-15,-20,8,51.69,44
,20160203,12925,12920,13090,13090,13090,13090,13090,170,170,4,26.18,40
,20160204,13090,13090,,,,13300,13300,210,210,0,0.00,40
,20160205,13300,13300,13100,13125,13100,13125,13110,-175,-190,4,26.23,40
,20160215,13125,13110,13305,13305,13305,13305,13305,195,195,2,13.31,38
,20160216,13305,13305,,,,13280,13280,-25,-25,0,0.00,38
,20160217,13280,13280,,,,13295,13295,15,15,0,0.00,38
,20160218,13295,13295,13055,13055,13055,13055,13055,-240,-240,4,26.11,38
,20160219,13055,13055,13235,13235,13235,13235,13235,180,180,2,13.24,36
,20160222,13235,13235,,,,13280,13280,45,45,0,0.00,36
,20160223,13280,13280,13335,13335,12910,12910,13080,-370,-200,8,52.34,40
,20160224,12910,13080,13025,13025,13025,13025,13025,-55,-55,6,39.08,38
,20160225,13025,13025,13080,13080,13080,13080,13080,55,55,2,13.08,38
,20160226,13080,13080,12950,12950,12950,12950,12950,-130,-130,2,12.95,40
,20160229,12950,12950,13065,13065,13015,13030,13035,80,85,6,39.11,42
,20160301,13030,13035,13110,13140,13060,13060,13100,25,65,6,39.31,44
,20160302,13060,13100,,,,13240,13240,140,140,0,0.00,44
,20160303,13240,13240,,,,13150,13150,-90,-90,0,0.00,44
,20160304,13150,13150,13510,13510,13400,13450,13440,300,290,8,53.77,44
,20160307,13450,13440,13645,13660,13600,13600,13635,160,195,10,68.20,46
,20160308,13600,13635,13940,14000,13800,13815,13905,180,270,56,389.34,54
,20160309,13815,13905,13475,13610,13345,13610,13470,-295,-435,18,121.26,56
,20160310,13610,13470,13685,13700,13560,13560,13640,90,170,8,54.58,56
,20160311,13560,13640,13540,13575,13535,13575,13545,-65,-95,16,108.37,48
,20160314,13575,13545,,,,13595,13595,50,50,0,0.00,48
,20160315,13595,13595,,,,13525,13525,-70,-70,0,0.00,48
,20160316,13525,13525,13605,13605,13465,13465,13535,-60,10,4,27.07,46
,20160317,13465,13535,,,,13595,13595,60,60,0,0.00,46
,20160318,13595,13595,13665,13665,13665,13665,13665,70,70,2,13.67,48
,20160321,13665,13665,13500,13525,13500,13525,13520,-140,-145,12,81.13,56
,20160322,13525,13520,,,,13515,13515,-5,-5,0,0.00,56
,20160323,13515,13515,,,,13520,13520,5,5,0,0.00,56
,20160324,13520,13520,13330,13435,13330,13380,13380,-140,-140,6,40.15,58
,20160325,13380,13380,13365,13380,13365,13380,13370,0,-10,4,26.75,58
,20160328,13380,13370,13340,13515,13105,13365,13290,-5,-80,616,"4,094.71",72
,20160329,13365,13290,13400,13400,13400,13400,13400,110,110,2,13.40,72
,20160330,13400,13400,13355,13355,13340,13340,13345,-60,-55,4,26.70,70
,20160331,13340,13345,13085,13285,13085,13105,13155,-240,-190,46,302.61,86
,20160401,13105,13155,,,,13120,13120,-35,-35,0,0.00,86
,20160405,13120,13120,13210,13210,13160,13165,13170,45,50,10,65.86,88
,20160406,13165,13170,,,,13135,13135,-35,-35,0,0.00,88
,20160407,13135,13135,13200,13230,13040,13105,13155,-30,20,52,342.11,86
,20160408,13105,13155,13030,13030,13025,13025,13025,-130,-130,4,26.06,86
,20160411,13025,13025,13040,13180,13040,13060,13090,35,65,8,52.36,88
,20160412,13060,13090,13000,13290,12860,12995,13000,-95,-90,42,273.03,90
,20160413,12995,13000,12505,13420,12505,13250,13190,250,190,40,263.81,104
,20160414,13250,13190,13280,13330,13190,13265,13270,75,80,34,225.62,94
,20160415,13265,13270,13295,13295,13135,13230,13220,-40,-50,20,132.20,96
,20160418,13230,13220,13270,13365,13200,13200,13290,-20,70,18,119.63,100
,20160419,13200,13290,13445,13445,13040,13205,13245,-85,-45,38,251.75,100
,20160420,13205,13245,13345,13490,13255,13255,13335,10,90,130,866.98,128
,20160421,13255,13335,13400,13555,13365,13375,13465,40,130,196,"1,319.62",174
,20160422,13375,13465,13475,13580,13290,13305,13450,-160,-15,90,605.26,192
,20160425,13305,13450,13450,13590,13320,13435,13400,-15,-50,144,965.02,206
,20160426,13435,13400,13300,13345,13080,13130,13215,-270,-185,48,317.21,218
,20160427,13130,13215,13195,13335,13150,13245,13215,30,0,52,343.68,208
,20160428,13245,13215,13170,13170,13050,13130,13090,-85,-125,44,288.01,192
,20160429,13130,13090,13245,13280,13190,13220,13230,130,140,24,158.78,190
,20160503,13220,13230,13220,13380,13155,13380,13210,150,-20,10,66.07,192
,20160504,13380,13210,13220,13220,13220,13220,13220,10,10,2,13.22,190
,20160505,13220,13220,13160,13160,13160,13160,13160,-60,-60,2,13.16,190
,20160506,13160,13160,13080,13080,12825,13000,12945,-160,-215,104,673.40,186
,20160509,13000,12945,13015,13190,12860,12945,12980,0,35,202,"1,311.08",278
,20160510,12945,12980,12975,13085,12915,12980,13030,0,50,164,"1,068.64",220
,20160511,12980,13030,13090,13090,13090,13090,13090,60,60,2,13.09,220
,20160512,13090,13090,13160,13160,13040,13110,13095,20,5,58,379.80,222
,20160513,13110,13095,13100,13100,12870,12915,12935,-180,-160,90,582.09,204
,20160516,12915,12935,12910,12930,12790,12910,12860,-25,-75,50,321.60,208
,20160517,12910,12860,12980,12980,12980,12980,12980,120,120,8,51.92,206
,20160518,12980,12980,12915,12915,12895,12900,12905,-80,-75,24,154.91,204
,20160519,12900,12905,12810,13010,12810,13010,12940,105,35,22,142.37,190
,20160520,13010,12940,12815,12840,12610,12750,12730,-190,-210,244,"1,553.52",202
,20160523,12750,12730,12715,12825,12715,12750,12755,20,25,20,127.57,206
,20160524,12750,12755,12695,12745,12695,12745,12710,-10,-45,10,63.57,204
,20160525,12745,12710,12725,12750,12670,12735,12710,25,0,66,419.48,232
,20160526,12735,12710,12725,12775,12685,12775,12715,65,5,14,89.03,238
,20160527,12775,12715,12855,12855,12715,12825,12800,110,85,254,"1,626.01",390
,20160530,12825,12800,12850,12870,12830,12830,12840,30,40,168,"1,078.90",416
,20160531,12830,12840,12840,12890,12800,12830,12840,-10,0,32,205.44,410
,20160601,12830,12840,12845,12845,12710,12720,12785,-120,-55,190,"1,214.87",450
,20160602,12720,12785,12750,12955,12745,12920,12810,135,25,118,756.04,492
,20160603,12920,12810,12920,12925,12800,12810,12890,0,80,52,335.17,504
,20160606,12810,12890,12895,12895,12840,12885,12860,-5,-30,260,"1,671.85",664
,20160607,12885,12860,12900,12910,12780,12780,12845,-80,-15,224,"1,439.17",780
,20160608,12780,12845,12845,12845,12760,12770,12790,-75,-55,198,"1,266.54",900
,20160613,12770,12790,12775,12930,12770,12890,12870,100,80,110,707.95,932
,20160614,12890,12870,12890,12900,12775,12775,12830,-95,-40,470,"3,016.20",1218
,20160615,12775,12830,12775,12890,12775,12860,12800,30,-30,218,"1,395.69",1230
,20160616,12860,12800,12940,12975,12795,12850,12850,50,50,364,"2,339.04",1398
,20160617,12850,12850,12880,12910,12810,12880,12865,30,15,560,"3,602.69",1482
,20160620,12880,12865,12875,12875,12760,12800,12825,-65,-40,398,"2,552.49",1548
,20160621,12800,12825,12830,12895,12830,12860,12865,35,40,506,"3,255.08",1630
,20160622,12860,12865,12825,12915,12815,12915,12850,50,-15,188,"1,208.29",1700
,20160623,12915,12850,12930,12950,12820,12870,12860,20,10,668,"4,296.70",1894
,20160624,12870,12860,12915,12915,12755,12770,12820,-90,-40,2108,"13,512.73",2588
,20160627,12770,12820,12795,12905,12795,12895,12840,75,20,660,"4,237.76",2748
,20160628,12895,12840,12870,12950,12830,12935,12885,95,45,1550,"9,989.64",3382
,20160629,12935,12885,12955,13085,12830,12965,12950,80,65,3956,"25,622.13",5354
,20160630,12965,12950,12950,13310,12950,13210,13085,260,135,6676,"43,688.56",7068
,20160701,13210,13085,13255,13355,13160,13350,13265,265,180,6676,"44,280.25",9184
,20160704,13350,13265,13500,13660,13440,13535,13535,270,270,10262,"69,452.21",11302
,20160705,13535,13535,13550,13565,13125,13205,13280,-330,-255,11422,"75,856.28",12690
,20160706,13205,13280,13205,13300,12990,13065,13120,-215,-160,10352,"67,921.30",14940
,20160707,13065,13120,13025,13200,12945,13015,13080,-105,-40,10728,"70,176.58",16480
,20160708,13015,13080,13025,13085,12965,13040,13025,-40,-55,9428,"61,403.29",16624
,20160711,13040,13025,13095,13165,12975,13165,13070,140,45,10108,"66,075.26",17288
,20160712,13165,13070,13125,13225,13080,13190,13140,120,70,9352,"61,462.97",16924
,20160713,13190,13140,13290,13445,13175,13250,13300,110,160,17710,"117,813.83",17684
,20160714,13250,13300,13260,13300,13160,13270,13230,-30,-70,7476,"49,461.44",18442
,20160715,13270,13230,13285,13440,13260,13420,13350,190,120,13956,"93,180.70",19610
,20160718,13420,13350,13425,13465,13130,13210,13260,-140,-90,11472,"76,087.86",19290
,20160719,13210,13260,13255,13390,13140,13340,13275,80,15,11526,"76,528.94",19592
,20160720,13340,13275,13335,13395,13235,13320,13315,45,40,10012,"66,668.84",19884
,20160721,13320,13315,13195,13520,13140,13390,13285,75,-30,10750,"71,432.47",20050
,20160722,13390,13285,13400,13505,13360,13395,13430,110,145,11498,"77,235.58",20594
,20160725,13395,13430,13380,13665,13270,13635,13505,205,75,22756,"153,701.45",21414
,20160726,13635,13505,13615,13830,13470,13810,13650,305,145,30630,"209,119.56",23046
,20160727,13810,13650,13795,13860,13670,13755,13775,105,125,21238,"146,321.38",23922
,20160728,13755,13775,13710,13780,13545,13605,13690,-170,-85,18104,"123,930.40",23058
,20160729,13605,13690,13610,13800,13575,13775,13710,85,20,19752,"135,441.44",22124
,20160801,13775,13710,13800,14135,13745,14050,13905,340,195,18164,"126,320.35",23328
,20160802,14050,13905,14005,14065,13840,13900,13950,-5,45,14018,"97,805.37",22176
,20160803,13900,13950,13945,14030,13775,13805,13895,-145,-55,11472,"79,715.75",21452
,20160804,13805,13895,13835,13905,13775,13835,13825,-60,-70,5994,"41,438.94",21174
,20160805,13835,13825,13770,13950,13705,13945,13810,120,-15,8958,"61,874.34",21344
,20160808,13945,13810,13950,13950,13755,13900,13870,90,60,9542,"66,195.65",21014
,20160809,13900,13870,13860,13960,13710,13730,13825,-140,-45,7920,"54,762.77",20026
,20160810,13730,13825,13735,13850,13660,13765,13755,-60,-70,7034,"48,393.62",19574
,20160811,13765,13755,13850,13940,13705,13885,13835,130,80,8056,"55,734.47",19760
,20160812,13885,13835,13870,13920,13790,13805,13830,-30,-5,4744,"32,814.03",19872
,20160815,13805,13830,13745,13865,13460,13470,13620,-360,-210,11170,"76,084.84",16870
,20160816,13470,13620,13505,13680,13450,13530,13530,-90,-90,11268,"76,254.27",16260
,20160817,13530,13530,13655,13655,13485,13540,13550,10,20,6780,"45,949.28",15556
,20160818,13540,13550,13565,13840,13555,13840,13695,290,145,7252,"49,667.58",14564
,20160819,13840,13695,13855,14010,13785,13990,13890,295,195,5808,"40,351.00",13492
,20160822,13990,13890,13960,14065,13845,13890,13910,0,20,4078,"28,363.87",12596
,20160823,13890,13910,13850,13920,13830,13890,13885,-20,-25,2672,"18,555.41",11484
,20160824,13890,13885,13840,13980,13840,13930,13920,45,35,2012,"14,005.23",10686
,20160825,13930,13920,13940,14010,13825,13960,13895,40,-25,2980,"20,709.32",9278
,20160826,13960,13895,13930,14020,13840,13910,13920,15,25,1288,"8,965.41",9018
,20160829,13910,13920,13910,13995,13830,13850,13875,-70,-45,1200,"8,327.22",8428
,20160830,13850,13875,13805,13835,13700,13745,13810,-130,-65,2416,"16,684.58",7762
,20160831,13745,13810,13745,14000,13720,14000,13815,190,5,870,"6,010.84",7152
,20160901,14000,13815,13830,14365,13830,14365,14080,550,265,1042,"7,336.98",6660
,20160902,14365,14080,14405,14640,14405,14490,14545,410,465,590,"4,291.98",6490
,20160905,14490,14545,14485,14525,14225,14425,14395,-120,-150,650,"4,678.93",5980
,20160906,14425,14395,14515,14515,14340,14360,14370,-35,-25,630,"4,527.93",5650
,20160907,14360,14370,14225,14265,14190,14200,14220,-170,-150,480,"3,413.05",5310
,20160908,14200,14220,14130,14130,14100,14100,14115,-120,-105,310,"2,187.88",5250
,20160909,14100,14115,13965,14185,13860,14125,14085,10,-30,1120,"7,889.03",5370
,20160912,14125,14085,13855,13955,13560,13560,13875,-525,-210,580,"4,024.45",4220
,20160913,13560,13875,13920,14200,13920,14020,14000,145,125,350,"2,450.73",4290
,20160914,14020,14000,14005,14120,14005,14065,14045,65,45,980,"6,883.88",3470
,20160919,14065,14045,14155,14300,14155,14290,14250,245,205,60,427.63,3480
pb1610,20160104,12590,12590,,,,12620,12620,30,30,0,0.00,36
,20160105,12620,12620,,,,12665,12665,45,45,0,0.00,36
,20160106,12665,12665,12710,12720,12710,12720,12715,55,50,4,25.43,32
,20160107,12720,12715,12660,12660,12385,12555,12490,-160,-225,44,274.78,24
,20160108,12555,12490,,,,12270,12270,-220,-220,0,0.00,24
,20160111,12270,12270,12310,12385,12310,12385,12345,115,75,8,49.40,24
,20160112,12385,12345,12325,12325,12325,12325,12325,-20,-20,2,12.33,24
,20160113,12325,12325,,,,12320,12320,-5,-5,0,0.00,24
,20160114,12320,12320,,,,12330,12330,10,10,0,0.00,24
,20160115,12330,12330,12470,12470,12470,12470,12470,140,140,2,12.47,22
,20160118,12470,12470,12200,12365,12200,12365,12280,-105,-190,4,24.57,22
,20160119,12365,12280,12510,12510,12510,12510,12510,230,230,4,25.02,26
,20160120,12510,12510,12515,12555,12410,12410,12490,-100,-20,6,37.48,26
,20160121,12410,12490,,,,12405,12405,-85,-85,0,0.00,26
,20160122,12405,12405,12315,12480,12315,12480,12395,75,-10,8,49.60,24
,20160125,12480,12395,,,,12470,12470,75,75,0,0.00,24
,20160126,12470,12470,,,,12550,12550,80,80,0,0.00,24
,20160127,12550,12550,12500,12635,12500,12505,12550,-45,0,12,75.33,34
,20160128,12505,12550,,,,12620,12620,70,70,0,0.00,34
,20160129,12620,12620,,,,12625,12625,5,5,0,0.00,34
,20160201,12625,12625,12870,12985,12870,12985,12925,360,300,6,38.78,34
,20160202,12985,12925,,,,12905,12905,-20,-20,0,0.00,34
,20160203,12905,12905,13025,13065,13025,13065,13045,160,140,8,52.18,38
,20160204,13065,13045,13090,13285,13090,13285,13150,240,105,8,52.62,34
,20160205,13285,13150,13140,13140,13020,13020,13080,-130,-70,4,26.16,34
,20160215,13020,13080,13175,13300,13175,13220,13245,140,165,12,79.48,36
,20160216,13220,13245,13145,13145,13145,13145,13145,-100,-100,2,13.15,36
,20160217,13145,13145,,,,13160,13160,15,15,0,0.00,36
,20160218,13160,13160,13025,13025,12990,12990,12995,-170,-165,8,52.00,32
,20160219,12990,12995,13055,13055,13055,13055,13055,60,60,2,13.06,32
,20160222,13055,13055,13000,13000,13000,13000,13000,-55,-55,2,13.00,32
,20160223,13000,13000,,,,12805,12805,-195,-195,0,0.00,32
,20160224,12805,12805,12985,12985,12965,12965,12975,160,170,4,25.95,32
,20160225,12965,12975,13280,13280,12950,13045,13090,70,115,6,39.28,30
,20160226,13045,13090,,,,12955,12955,-135,-135,0,0.00,30
,20160229,12955,12955,13035,13105,12990,12990,13050,35,95,16,104.42,38
,20160301,12990,13050,,,,13115,13115,65,65,0,0.00,38
,20160302,13115,13115,13435,13435,13150,13150,13290,35,175,4,26.59,38
,20160303,13150,13290,,,,13200,13200,-90,-90,0,0.00,38
,20160304,13200,13200,13400,13400,13345,13345,13375,145,175,8,53.52,38
,20160307,13345,13375,13600,13620,13550,13615,13585,240,210,26,176.67,46
,20160308,13615,13585,,,,13850,13850,265,265,0,0.00,46
,20160309,13850,13850,13610,13610,13455,13455,13530,-395,-320,8,54.13,48
,20160310,13455,13530,13585,13585,13535,13535,13550,5,20,6,40.66,50
,20160311,13535,13550,13600,13615,13600,13615,13605,65,55,4,27.22,48
,20160314,13615,13605,13675,13675,13675,13675,13675,70,70,2,13.68,48
,20160315,13675,13675,,,,13665,13665,-10,-10,0,0.00,48
,20160316,13665,13665,13430,13430,13430,13430,13430,-235,-235,2,13.43,46
,20160317,13430,13430,,,,13485,13485,55,55,0,0.00,46
,20160318,13485,13485,13515,13640,13515,13605,13580,120,95,10,67.92,44
,20160321,13605,13580,,,,13435,13435,-145,-145,0,0.00,44
,20160322,13435,13435,,,,13430,13430,-5,-5,0,0.00,44
,20160323,13430,13430,,,,13435,13435,5,5,0,0.00,44
,20160324,13435,13435,13400,13400,13400,13400,13400,-35,-35,4,26.80,44
,20160325,13400,13400,,,,13390,13390,-10,-10,0,0.00,44
,20160328,13390,13390,,,,13310,13310,-80,-80,0,0.00,44
,20160329,13310,13310,13400,13400,13400,13400,13400,90,90,4,26.80,44
,20160330,13400,13400,,,,13345,13345,-55,-55,0,0.00,44
,20160331,13345,13345,13150,13215,13110,13110,13165,-235,-180,14,92.17,42
,20160401,13110,13165,13070,13200,13070,13200,13110,35,-55,6,39.34,42
,20160405,13200,13110,13005,13195,13005,13195,13175,85,65,22,144.96,60
,20160406,13195,13175,13120,13120,13120,13120,13120,-55,-55,2,13.12,62
,20160407,13120,13120,13115,13150,13115,13150,13135,30,15,6,39.42,66
,20160408,13150,13135,12830,13015,12830,13000,12970,-135,-165,10,64.86,68
,20160411,13000,12970,,,,13030,13030,60,60,0,0.00,68
,20160412,13030,13030,,,,12940,12940,-90,-90,0,0.00,68
,20160413,12940,12940,13255,13255,13255,13255,13255,315,315,4,26.51,68
,20160414,13255,13255,13260,13270,13260,13270,13265,15,10,6,39.80,70
,20160415,13270,13265,13175,13295,13175,13230,13210,-35,-55,12,79.26,70
,20160418,13230,13210,13230,13230,13205,13205,13215,-5,5,4,26.44,72
,20160419,13205,13215,13200,13200,13200,13200,13200,-15,-15,4,26.40,68
,20160420,13200,13200,13345,13370,13290,13290,13345,90,145,12,80.08,72
,20160421,13290,13345,13380,13490,13360,13490,13410,145,65,14,93.89,76
,20160422,13490,13410,13460,13460,13300,13300,13375,-110,-35,10,66.89,76
,20160425,13300,13375,13335,13335,13335,13335,13335,-40,-40,2,13.34,74
,20160426,13335,13335,13265,13385,13030,13095,13240,-240,-95,26,172.15,76
,20160427,13095,13240,13165,13220,13135,13220,13180,-20,-60,10,65.90,76
,20160428,13220,13180,,,,13055,13055,-125,-125,0,0.00,76
,20160429,13055,13055,,,,13195,13195,140,140,0,0.00,76
,20160503,13195,13195,13195,13195,13195,13195,13195,0,0,6,39.59,74
,20160504,13195,13195,13320,13320,13320,13320,13320,125,125,2,13.32,76
,20160505,13320,13320,13150,13150,13150,13150,13150,-170,-170,2,13.15,76
,20160506,13150,13150,13085,13085,13085,13085,13085,-65,-65,2,13.09,76
,20160509,13085,13085,,,,13120,13120,35,35,0,0.00,76
,20160510,13120,13120,,,,13100,13100,-20,-20,0,0.00,76
,20160511,13100,13100,,,,13160,13160,60,60,0,0.00,76
,20160512,13160,13160,13090,13090,13090,13090,13090,-70,-70,6,39.27,82
,20160513,13090,13090,13120,13120,13120,13120,13120,30,30,2,13.12,80
,20160516,13120,13120,,,,13045,13045,-75,-75,0,0.00,80
,20160517,13045,13045,13010,13010,12925,13010,12965,-35,-80,12,77.80,78
,20160518,13010,12965,12940,12985,12940,12985,12960,20,-5,4,25.93,80
,20160519,12985,12960,12875,12875,12820,12820,12835,-140,-125,6,38.52,76
,20160520,12820,12835,12770,12870,12770,12840,12835,5,0,86,552.01,116
,20160523,12840,12835,12705,12705,12705,12705,12705,-130,-130,2,12.71,114
,20160524,12705,12705,12705,12710,12660,12705,12700,0,-5,14,88.91,114
,20160525,12705,12700,12735,12760,12720,12740,12735,40,35,62,394.87,150
,20160526,12740,12735,12785,12785,12745,12745,12765,10,30,4,25.53,150
,20160527,12745,12765,12815,12815,12815,12815,12815,50,50,2,12.82,152
,20160530,12815,12815,12875,12875,12850,12850,12855,35,40,6,38.58,154
,20160531,12850,12855,12900,12900,12885,12885,12885,30,30,22,141.75,138
,20160601,12885,12885,12810,12810,12745,12755,12745,-130,-140,56,356.97,106
,20160602,12755,12745,12790,12945,12790,12945,12850,200,105,18,115.67,116
,20160603,12945,12850,12950,12950,12950,12950,12950,100,100,6,38.85,116
,20160606,12950,12950,,,,12920,12920,-30,-30,0,0.00,116
,20160607,12920,12920,12820,12825,12820,12825,12820,-95,-100,6,38.47,122
,20160608,12825,12820,12815,12815,12790,12800,12800,-20,-20,28,179.21,126
,20160613,12800,12800,12875,12885,12860,12885,12875,85,75,16,103.03,132
,20160614,12885,12875,12855,12855,12840,12840,12850,-35,-25,24,154.20,154
,20160615,12840,12850,12795,12895,12785,12880,12820,30,-30,60,384.68,180
,20160616,12880,12820,12865,12865,12805,12805,12840,-15,20,36,231.13,216
,20160617,12805,12840,12865,12905,12810,12905,12860,65,20,36,231.51,210
,20160620,12905,12860,12800,12800,12800,12800,12800,-60,-60,2,12.80,212
,20160621,12800,12800,12855,12885,12855,12885,12880,85,80,12,77.28,210
,20160622,12885,12880,,,,12890,12890,10,10,0,0.00,210
,20160623,12890,12890,12920,12920,12855,12855,12895,-35,5,14,90.29,210
,20160624,12855,12895,,,,12895,12895,0,0,0,0.00,210
,20160627,12895,12895,12835,12930,12835,12930,12875,35,-20,6,38.63,210
,20160628,12930,12875,12900,12900,12900,12900,12900,25,25,2,12.90,210
,20160629,12900,12900,13000,13125,12900,13010,12965,110,65,86,557.64,226
,20160630,13010,12965,13020,13325,13020,13285,13140,320,175,206,"1,353.43",292
,20160701,13285,13140,13190,13380,13190,13380,13300,240,160,370,"2,461.41",464
,20160704,13380,13300,13420,13700,13420,13590,13585,290,285,396,"2,690.11",534
,20160705,13590,13585,13565,13595,13195,13245,13330,-340,-255,280,"1,866.49",486
,20160706,13245,13330,13260,13300,13070,13235,13175,-95,-155,92,606.28,486
,20160707,13235,13175,13215,13230,13040,13050,13120,-125,-55,70,459.30,508
,20160708,13050,13120,13090,13090,13040,13040,13065,-80,-55,14,91.46,512
,20160711,13040,13065,13040,13245,13030,13205,13105,140,40,52,340.75,510
,20160712,13205,13105,13165,13240,13155,13240,13210,135,105,54,356.74,498
,20160713,13240,13210,13320,13480,13230,13270,13350,60,140,246,"1,642.28",580
,20160714,13270,13350,13300,13315,13220,13315,13290,-35,-60,60,398.82,578
,20160715,13315,13290,13390,13470,13360,13470,13415,180,125,228,"1,529.51",696
,20160718,13470,13415,13495,13495,13170,13260,13255,-155,-160,234,"1,550.96",758
,20160719,13260,13255,13280,13450,13260,13445,13290,190,35,212,"1,409.04",840
,20160720,13445,13290,13350,13460,13310,13355,13390,65,100,154,"1,031.39",826
,20160721,13355,13390,13215,13475,13200,13450,13355,60,-35,318,"2,123.61",922
,20160722,13450,13355,13475,13545,13445,13445,13495,90,140,400,"2,699.06",1198
,20160725,13445,13495,13415,13700,13350,13675,13570,180,75,730,"4,953.25",1450
,20160726,13675,13570,13650,13860,13510,13860,13695,290,125,1326,"9,081.88",1802
,20160727,13860,13695,13845,13900,13715,13800,13825,105,130,1590,"10,992.89",2114
,20160728,13800,13825,13785,13820,13610,13655,13740,-170,-85,1896,"13,029.14",2706
,20160729,13655,13740,13685,13850,13635,13825,13770,85,30,4856,"33,442.81",4804
,20160801,13825,13770,13845,14170,13790,14100,13985,330,215,3314,"23,175.07",5638
,20160802,14100,13985,14070,14120,13890,13940,13995,-45,10,3434,"24,037.74",5984
,20160803,13940,13995,13975,14080,13820,13850,13930,-145,-65,4074,"28,378.60",7074
,20160804,13850,13930,13870,13935,13815,13855,13865,-75,-65,2612,"18,111.96",7372
,20160805,13855,13865,13845,13975,13755,13965,13840,100,-25,3792,"26,248.53",8362
,20160808,13965,13840,13970,13985,13810,13940,13905,100,65,4084,"28,402.58",8870
,20160809,13940,13905,13920,14000,13750,13770,13865,-135,-40,3598,"24,949.61",9098
,20160810,13770,13865,13795,13890,13715,13830,13805,-35,-60,4904,"33,850.18",9450
,20160811,13830,13805,13890,13970,13755,13920,13875,115,70,5976,"41,469.78",9716
,20160812,13920,13875,13920,13925,13815,13840,13855,-35,-20,5098,"35,322.85",9616
,20160815,13840,13855,13855,13875,13520,13520,13705,-335,-150,7232,"49,572.55",11084
,20160816,13520,13705,13550,13690,13515,13565,13585,-140,-120,7822,"53,134.77",12576
,20160817,13565,13585,13565,13675,13540,13600,13600,15,15,6102,"41,508.37",13510
,20160818,13600,13600,13640,13885,13615,13885,13735,285,135,8576,"58,913.85",14184
,20160819,13885,13735,13875,14000,13825,13985,13905,250,170,9014,"62,685.85",15566
,20160822,13985,13905,14000,14035,13870,13900,13930,-5,25,6384,"44,472.13",16256
,20160823,13900,13930,13855,13960,13845,13915,13915,-15,-15,8014,"55,766.07",16956
,20160824,13915,13915,13930,13995,13895,13965,13960,50,45,9302,"64,943.62",17358
,20160825,13965,13960,13995,14070,13880,13970,13950,10,-10,13130,"91,592.57",18006
,20160826,13970,13950,13945,14050,13865,13960,13950,10,0,8812,"61,470.26",17396
,20160829,13960,13950,14000,14040,13855,13905,13925,-45,-25,8578,"59,745.22",17930
,20160830,13905,13925,13875,13900,13765,13810,13835,-115,-90,8748,"60,526.09",18132
,20160831,13810,13835,13845,13920,13805,13835,13870,0,35,10008,"69,419.22",18126
,20160901,13835,13870,13825,14420,13825,14420,14170,550,300,21586,"152,945.64",22620
,20160902,14420,14170,14460,14935,14370,14495,14600,325,430,41308,"301,601.31",24440
,20160905,14495,14600,14595,14610,14290,14520,14445,-80,-155,26136,"188,796.13",22950
,20160906,14520,14445,14575,14595,14400,14420,14480,-25,35,10358,"74,993.86",21064
,20160907,14420,14480,14385,14400,14200,14240,14265,-240,-215,10550,"75,273.06",19838
,20160908,14240,14265,14160,14385,14115,14135,14205,-130,-60,9514,"67,579.27",18798
,20160909,14135,14205,14140,14190,14045,14145,14125,-60,-80,7464,"52,725.75",18800
,20160912,14145,14125,14060,14190,13820,13835,13975,-290,-150,12850,"89,813.88",17786
,20160913,13835,13975,13865,14070,13865,14040,13995,65,20,7420,"51,934.59",15328
,20160914,14040,13995,14060,14110,13990,14070,14055,75,60,6568,"46,158.12",14662
,20160919,14070,14055,14320,14320,14110,14220,14185,165,130,4448,"31,551.48",14868
,20160920,14220,14185,14210,14460,14210,14420,14380,235,195,5260,"37,822.38",13184
,20160921,14420,14380,14445,14680,14440,14550,14575,170,195,3302,"24,065.64",12442
,20160922,14550,14575,14545,14575,14320,14520,14500,-55,-75,3532,"25,611.36",11778
,20160923,14520,14500,14520,14755,14405,14460,14515,-40,15,2908,"21,107.31",10658
,20160926,14460,14515,14360,14490,14330,14420,14390,-95,-125,4290,"30,868.39",9882
,20160927,14420,14390,14480,14870,14440,14735,14635,345,245,3446,"25,216.99",8930
,20160928,14735,14635,14700,14765,14585,14715,14680,80,45,3276,"24,049.34",9054
,20160929,14715,14680,14735,15145,14735,15115,14995,435,315,786,"5,894.33",8696
,20160930,15115,14995,15170,15525,15130,15485,15310,490,315,2116,"16,199.75",7030
,20161010,15485,15310,15450,15930,15450,15850,15790,540,480,2080,"16,426.33",5800
,20161011,15850,15790,15780,16000,15770,15955,15880,165,90,1430,"11,355.25",5390
,20161012,15955,15880,15755,15900,15655,15755,15790,-125,-90,870,"6,870.60",5120
,20161013,15755,15790,15300,15600,15300,15600,15535,-190,-255,700,"5,437.85",5030
,20161014,15600,15535,16115,16115,15430,15500,15635,-35,100,480,"3,752.95",5090
,20161017,15500,15635,15550,15560,15550,15560,15555,-75,-80,40,311.10,5070
pb1611,20160104,12330,12330,12410,12505,12410,12505,12455,175,125,4,24.92,36
,20160105,12505,12455,12650,12650,12430,12590,12565,135,110,8,50.26,40
,20160106,12590,12565,12625,12625,12480,12520,12520,-45,-45,12,75.15,36
,20160107,12520,12520,12825,12825,12755,12755,12775,235,255,6,38.34,36
,20160108,12755,12775,12300,12395,12300,12395,12345,-380,-430,4,24.70,38
,20160111,12395,12345,12340,12340,12340,12340,12340,-5,-5,2,12.34,38
,20160112,12340,12340,12300,12300,12170,12170,12255,-170,-85,8,49.03,40
,20160113,12170,12255,,,,12255,12255,0,0,0,0.00,40
,20160114,12255,12255,,,,12265,12265,10,10,0,0.00,40
,20160115,12265,12265,12380,12410,12235,12235,12345,-30,80,12,74.07,34
,20160118,12235,12345,12140,12360,12140,12360,12260,15,-85,6,36.79,36
,20160119,12360,12260,12480,12480,12460,12460,12460,200,200,10,62.32,44
,20160120,12460,12460,12395,12395,12395,12395,12395,-65,-65,2,12.40,46
,20160121,12395,12395,12335,12380,12335,12380,12355,-15,-40,4,24.72,48
,20160122,12380,12355,12285,12350,12285,12350,12315,-5,-40,4,24.64,50
,20160125,12350,12315,,,,12390,12390,75,75,0,0.00,50
,20160126,12390,12390,12395,12395,12395,12395,12395,5,5,2,12.40,50
,20160127,12395,12395,12465,12585,12465,12480,12525,85,130,10,62.63,54
,20160128,12480,12525,,,,12595,12595,70,70,0,0.00,54
,20160129,12595,12595,12655,12725,12645,12725,12710,130,115,22,139.83,58
,20160201,12725,12710,12855,12905,12855,12890,12875,180,165,8,51.51,60
,20160202,12890,12875,12820,12825,12820,12825,12820,-50,-55,10,64.11,64
,20160203,12825,12820,13000,13000,13000,13000,13000,180,180,4,26.00,60
,20160204,13000,13000,13000,13000,12995,13000,12995,0,-5,8,52.00,56
,20160205,13000,12995,13140,13140,12810,12810,12975,-185,-20,4,25.95,54
,20160215,12810,12975,13100,13100,13100,13100,13100,125,125,2,13.10,52
,20160216,13100,13100,13065,13065,13035,13035,13050,-65,-50,4,26.10,52
,20160217,13035,13050,12920,12920,12920,12920,12920,-130,-130,6,38.76,50
,20160218,12920,12920,12890,12915,12885,12915,12890,-5,-30,12,77.36,52
,20160219,12915,12890,12880,12990,12860,12990,12910,100,20,6,38.73,52
,20160222,12990,12910,13170,13175,13170,13175,13170,265,260,4,26.35,52
,20160223,13175,13170,13305,13305,13305,13305,13305,135,135,2,13.31,52
,20160224,13305,13305,12910,12910,12910,12910,12910,-395,-395,4,25.82,52
,20160225,12910,12910,,,,13025,13025,115,115,0,0.00,52
,20160226,13025,13025,,,,12895,12895,-130,-130,0,0.00,52
,20160229,12895,12895,,,,12905,12905,10,10,0,0.00,52
,20160301,12905,12905,,,,12970,12970,65,65,0,0.00,52
,20160302,12970,12970,13095,13095,13095,13095,13095,125,125,2,13.10,52
,20160303,13095,13095,,,,13005,13005,-90,-90,0,0.00,52
,20160304,13005,13005,13265,13265,13265,13265,13265,260,260,2,13.27,50
,20160307,13265,13265,13470,13470,13465,13465,13465,200,200,6,40.41,48
,20160308,13465,13465,,,,13730,13730,265,265,0,0.00,48
,20160309,13730,13730,13610,13610,13605,13605,13605,-125,-125,8,54.43,56
,20160310,13605,13605,,,,13605,13605,0,0,0,0.00,56
,20160311,13605,13605,,,,13660,13660,55,55,0,0.00,56
,20160314,13660,13660,,,,13730,13730,70,70,0,0.00,56
,20160315,13730,13730,,,,13660,13660,-70,-70,0,0.00,56
,20160316,13660,13660,,,,13615,13615,-45,-45,0,0.00,56
,20160317,13615,13615,13430,13430,13430,13430,13430,-185,-185,2,13.43,54
,20160318,13430,13430,13560,13560,13560,13560,13560,130,130,2,13.56,54
,20160321,13560,13560,,,,13415,13415,-145,-145,0,0.00,54
,20160322,13415,13415,,,,13410,13410,-5,-5,0,0.00,54
,20160323,13410,13410,,,,13415,13415,5,5,0,0.00,54
,20160324,13415,13415,,,,13380,13380,-35,-35,0,0.00,54
,20160325,13380,13380,,,,13370,13370,-10,-10,0,0.00,54
,20160328,13370,13370,13400,13400,13400,13400,13400,30,30,6,40.20,56
,20160329,13400,13400,,,,13490,13490,90,90,0,0.00,56
,20160330,13490,13490,,,,13435,13435,-55,-55,0,0.00,56
,20160331,13435,13435,13245,13245,13070,13070,13170,-365,-265,24,158.04,72
,20160401,13070,13170,,,,13115,13115,-55,-55,0,0.00,72
,20160405,13115,13115,,,,13180,13180,65,65,0,0.00,72
,20160406,13180,13180,,,,13120,13120,-60,-60,0,0.00,72
,20160407,13120,13120,13140,13140,13140,13140,13140,20,20,2,13.14,72
,20160408,13140,13140,12980,12980,12980,12980,12980,-160,-160,2,12.98,72
,20160411,12980,12980,,,,13040,13040,60,60,0,0.00,72
,20160412,13040,13040,12975,12975,12975,12975,12975,-65,-65,4,25.95,72
,20160413,12975,12975,13245,13245,13210,13210,13220,235,245,10,66.12,68
,20160414,13210,13220,13260,13265,13260,13265,13260,45,40,6,39.79,66
,20160415,13265,13260,13355,13355,13195,13195,13300,-65,40,12,79.81,68
,20160418,13195,13300,13305,13305,13250,13250,13275,-50,-25,4,26.56,70
,20160419,13250,13275,13250,13250,13250,13250,13250,-25,-25,2,13.25,70
,20160420,13250,13250,13385,13385,13280,13280,13305,30,55,16,106.48,68
,20160421,13280,13305,13365,13430,13365,13430,13405,125,100,6,40.23,66
,20160422,13430,13405,13220,13330,13220,13330,13275,-75,-130,4,26.55,68
,20160425,13330,13275,13365,13365,13365,13365,13365,90,90,2,13.37,68
,20160426,13365,13365,,,,13270,13270,-95,-95,0,0.00,68
,20160427,13270,13270,13135,13165,13125,13125,13150,-145,-120,16,105.20,72
,20160428,13125,13150,,,,13025,13025,-125,-125,0,0.00,72
,20160429,13025,13025,,,,13200,13200,175,175,0,0.00,72
,20160503,13200,13200,,,,13200,13200,0,0,0,0.00,72
,20160504,13200,13200,13335,13335,13335,13335,13335,135,135,2,13.34,70
,20160505,13335,13335,13210,13210,13130,13130,13155,-205,-180,6,39.47,70
,20160506,13130,13155,,,,13085,13085,-70,-70,0,0.00,70
,20160509,13085,13085,,,,13120,13120,35,35,0,0.00,70
,20160510,13120,13120,,,,13170,13170,50,50,0,0.00,70
,20160511,13170,13170,13090,13090,13090,13090,13090,-80,-80,2,13.09,72
,20160512,13090,13090,13260,13260,13090,13090,13140,0,50,10,65.72,76
,20160513,13090,13140,,,,13170,13170,30,30,0,0.00,76
,20160516,13170,13170,12950,12950,12950,12950,12950,-220,-220,4,25.90,76
,20160517,12950,12950,13060,13060,13060,13060,13060,110,110,6,39.18,74
,20160518,13060,13060,,,,13055,13055,-5,-5,0,0.00,74
,20160519,13055,13055,,,,13055,13055,0,0,0,0.00,74
,20160520,13055,13055,13055,13055,12900,12900,12975,-155,-80,4,25.96,72
,20160523,12900,12975,,,,12840,12840,-135,-135,0,0.00,72
,20160524,12840,12840,,,,12840,12840,0,0,0,0.00,72
,20160525,12840,12840,,,,12875,12875,35,35,0,0.00,72
,20160526,12875,12875,12785,12785,12755,12755,12770,-120,-105,4,25.54,70
,20160527,12755,12770,,,,12820,12820,50,50,0,0.00,70
,20160530,12820,12820,,,,12860,12860,40,40,0,0.00,70
,20160531,12860,12860,,,,12890,12890,30,30,0,0.00,70
,20160601,12890,12890,,,,12890,12890,0,0,0,0.00,70
,20160602,12890,12890,12810,12885,12810,12885,12845,-5,-45,4,25.70,72
,20160603,12885,12845,,,,12845,12845,0,0,0,0.00,72
,20160606,12845,12845,,,,12815,12815,-30,-30,0,0.00,72
,20160607,12815,12815,,,,12815,12815,0,0,0,0.00,72
,20160608,12815,12815,,,,12795,12795,-20,-20,0,0.00,72
,20160613,12795,12795,,,,12830,12830,35,35,0,0.00,72
,20160614,12830,12830,,,,12830,12830,0,0,0,0.00,72
,20160615,12830,12830,12885,12885,12885,12885,12885,55,55,4,25.77,72
,20160616,12885,12885,12860,12860,12835,12835,12840,-50,-45,8,51.37,68
,20160617,12835,12840,12880,12880,12865,12870,12870,30,30,14,90.09,58
,20160620,12870,12870,,,,12805,12805,-65,-65,0,0.00,58
,20160621,12805,12805,12930,12930,12905,12905,12915,100,110,4,25.84,58
,20160622,12905,12915,12905,12905,12905,12905,12905,-10,-10,2,12.91,56
,20160623,12905,12905,12905,12905,12905,12905,12905,0,0,2,12.91,58
,20160624,12905,12905,12925,12925,12925,12925,12925,20,20,2,12.93,56
,20160627,12925,12925,13070,13070,13070,13070,13070,145,145,2,13.07,56
,20160628,13070,13070,12965,12965,12950,12950,12950,-120,-120,10,64.77,66
,20160629,12950,12950,12950,12950,12950,12950,12950,0,0,12,77.70,76
,20160630,12950,12950,13125,13180,13125,13180,13135,230,185,34,223.30,104
,20160701,13180,13135,13180,13345,13180,13345,13250,210,115,28,185.51,104
,20160704,13345,13250,13590,13765,13540,13635,13620,385,370,18,122.61,98
,20160705,13635,13620,13580,13580,13205,13285,13350,-335,-270,38,253.68,104
,20160706,13285,13350,13320,13320,13205,13245,13245,-105,-105,10,66.23,110
,20160707,13245,13245,,,,13190,13190,-55,-55,0,0.00,110
,20160708,13190,13190,,,,13130,13130,-60,-60,0,0.00,110
,20160711,13130,13130,13245,13245,13230,13230,13235,100,105,4,26.48,110
,20160712,13230,13235,13230,13230,13230,13230,13230,-5,-5,2,13.23,110
,20160713,13230,13230,13385,13400,13285,13285,13365,55,135,8,53.47,112
,20160714,13285,13365,,,,13365,13365,0,0,0,0.00,112
,20160715,13365,13365,13430,13435,13390,13435,13405,70,40,10,67.04,112
,20160718,13435,13405,13445,13445,13280,13305,13360,-100,-45,12,80.17,116
,20160719,13305,13360,13340,13505,13335,13505,13395,145,35,26,174.17,122
,20160720,13505,13395,13400,13435,13400,13435,13405,40,10,34,227.93,140
,20160721,13435,13405,13470,13480,13430,13480,13465,75,60,16,107.72,130
,20160722,13480,13465,13590,13590,13500,13500,13545,35,80,4,27.09,128
,20160725,13500,13545,13430,13645,13430,13645,13570,100,25,6,40.72,122
,20160726,13645,13570,13715,13820,13625,13820,13695,250,125,8,54.79,122
,20160727,13820,13695,13895,13905,13785,13785,13820,90,125,36,248.85,120
,20160728,13785,13820,13845,13855,13700,13700,13750,-120,-70,54,371.34,96
,20160729,13700,13750,13710,13800,13710,13800,13770,50,20,10,68.85,100
,20160801,13800,13770,13875,14180,13875,14180,14025,410,255,40,280.54,116
,20160802,14180,14025,14080,14140,13950,13950,14060,-75,35,20,140.64,118
,20160803,13950,14060,14015,14095,13830,13860,13875,-200,-185,182,"1,262.76",268
,20160804,13860,13875,13860,13895,13850,13850,13865,-25,-10,14,97.08,276
,20160805,13850,13865,13815,13835,13815,13835,13820,-30,-45,14,96.76,276
,20160808,13835,13820,14075,14075,14075,14075,14075,255,255,2,14.08,276
,20160809,14075,14075,14025,14065,13955,13960,13980,-115,-95,26,181.75,284
,20160810,13960,13980,13860,13930,13795,13890,13845,-90,-135,76,526.24,302
,20160811,13890,13845,13920,13975,13875,13975,13920,130,75,22,153.16,310
,20160812,13975,13920,13925,13925,13785,13850,13835,-70,-85,850,"5,880.31",894
,20160815,13850,13835,13815,13880,13545,13545,13720,-290,-115,220,"1,509.41",952
,20160816,13545,13720,13620,13690,13585,13615,13645,-105,-75,82,559.52,968
,20160817,13615,13645,13590,13670,13580,13645,13625,0,-20,38,258.93,944
,20160818,13645,13625,13695,13880,13660,13880,13805,255,180,58,400.48,920
,20160819,13880,13805,13900,14000,13840,13995,13975,190,170,466,"3,256.50",1242
,20160822,13995,13975,14025,14025,13910,13910,13955,-65,-20,496,"3,461.76",1422
,20160823,13910,13955,13920,13970,13880,13920,13935,-35,-20,322,"2,243.75",1580
,20160824,13920,13935,13945,13995,13945,13980,13975,45,40,216,"1,509.52",1634
,20160825,13980,13975,14010,14065,13920,13995,13980,20,5,976,"6,822.56",1972
,20160826,13995,13980,13985,14050,13895,13980,13970,0,-10,1238,"8,650.40",2516
,20160829,13980,13970,14025,14050,13900,13935,13960,-35,-10,2146,"14,980.33",3118
,20160830,13935,13960,13925,13925,13800,13845,13875,-115,-85,1098,"7,617.71",3392
,20160831,13845,13875,13885,13960,13860,13900,13915,25,40,1660,"11,551.62",3948
,20160901,13900,13915,13910,14470,13905,14465,14205,550,290,7680,"54,556.17",7288
,20160902,14465,14205,14485,14770,14400,14515,14600,310,395,12828,"93,670.48",9576
,20160905,14515,14600,14590,14635,14310,14545,14480,-55,-120,10860,"78,642.41",11186
,20160906,14545,14480,14635,14635,14435,14460,14505,-20,25,7254,"52,610.48",12286
,20160907,14460,14505,14430,14435,14225,14265,14295,-240,-210,8520,"60,904.09",12412
,20160908,14265,14295,14210,14365,14160,14195,14235,-100,-60,8714,"62,042.26",12848
,20160909,14195,14235,14190,14230,14095,14195,14170,-40,-65,7012,"49,682.21",13866
,20160912,14195,14170,14145,14220,13820,13820,14030,-350,-140,11688,"82,009.81",13690
,20160913,13820,14030,13890,14080,13890,14040,14000,10,-30,8198,"57,390.66",13808
,20160914,14040,14000,14120,14120,14005,14070,14060,70,60,8490,"59,705.49",13912
,20160919,14070,14060,14220,14355,14125,14250,14220,190,160,6812,"48,439.56",15350
,20160920,14250,14220,14250,14495,14250,14475,14425,255,205,12976,"93,596.58",18718
,20160921,14475,14425,14525,14745,14510,14620,14630,195,205,18462,"135,060.14",21460
,20160922,14620,14630,14580,14610,14395,14550,14530,-80,-100,13160,"95,623.62",21366
,20160923,14550,14530,14580,14745,14320,14515,14550,-15,20,13636,"99,208.89",21696
,20160926,14515,14550,14450,14525,14335,14440,14405,-110,-145,12018,"86,561.39",21032
,20160927,14440,14405,14485,14890,14450,14750,14680,345,275,30532,"224,142.18",26284
,20160928,14750,14680,14750,14795,14605,14650,14680,-30,0,14234,"104,492.68",24356
,20160929,14650,14680,14750,15150,14735,15005,14960,325,280,24256,"181,488.26",24532
,20160930,15005,14960,15130,15460,15080,15445,15260,485,300,32486,"247,935.29",28074
,20161010,15445,15260,15330,15825,15310,15770,15615,510,355,16526,"129,056.58",30214
,20161011,15770,15615,15740,15915,15680,15880,15790,265,175,15414,"121,728.56",31002
,20161012,15880,15790,15760,15790,15580,15625,15665,-165,-125,13952,"109,303.38",29444
,20161013,15625,15665,15665,15780,15340,15375,15510,-290,-155,16860,"130,754.46",26348
,20161014,15375,15510,15325,15485,15270,15480,15385,-30,-125,10198,"78,467.65",24236
,20161017,15480,15385,15440,15645,15400,15510,15500,125,115,9584,"74,291.12",23154
,20161018,15510,15500,15435,15650,15420,15610,15530,110,30,5522,"42,891.07",21704
,20161019,15610,15530,15575,15615,15405,15445,15485,-85,-45,5734,"44,402.65",19804
,20161020,15445,15485,15445,15665,15370,15450,15515,-35,30,6660,"51,666.82",17494
,20161021,15450,15515,15440,15880,15440,15800,15720,285,205,4334,"34,068.80",16336
,20161024,15800,15720,15780,15920,15660,15795,15790,75,70,6242,"49,295.03",13424
,20161025,15795,15790,15810,16420,15810,16375,16250,585,460,7226,"58,711.91",10832
,20161026,16375,16250,16490,16630,16060,16230,16305,-20,55,5412,"44,125.31",9318
,20161027,16230,16305,16320,16585,16200,16250,16350,-55,45,3802,"31,090.14",7716
,20161028,16250,16350,16330,16470,16260,16410,16370,60,20,1828,"14,965.84",6568
,20161031,16410,16370,16405,16570,16300,16400,16430,30,60,1676,"13,769.38",5632
,20161101,16400,16430,16425,16860,16410,16600,16620,170,190,1902,"15,808.03",4860
,20161102,16600,16620,16615,16645,16310,16360,16545,-260,-75,720,"5,957.18",4450
,20161103,16360,16545,16350,16570,16350,16570,16440,25,-105,160,"1,315.30",4390
,20161104,16570,16440,16635,16865,16555,16620,16650,180,210,600,"4,995.75",4290
,20161107,16620,16650,16590,16975,16590,16910,16810,260,160,700,"5,884.35",4070
,20161108,16910,16810,16900,16900,16615,16665,16715,-145,-95,1030,"8,610.48",3380
,20161109,16665,16715,16710,16845,16640,16670,16715,-45,0,510,"4,262.75",3000
,20161110,16670,16715,16875,17375,16875,17320,17225,605,510,240,"2,067.13",2900
,20161111,17320,17225,17910,17910,17145,17185,17240,-40,15,540,"4,654.98",2460
,20161114,17185,17240,18270,18270,17500,17600,17600,360,360,430,"3,784.05",2250
,20161115,17600,17600,18200,18655,18200,18655,18425,1055,825,80,737.10,2170
pb1612,20160104,12445,12445,12540,12550,12540,12550,12540,105,95,10,62.71,6
,20160105,12550,12540,,,,12650,12650,110,110,0,0.00,6
,20160106,12650,12650,,,,12605,12605,-45,-45,0,0.00,6
,20160107,12605,12605,12555,12555,12395,12395,12510,-210,-95,8,50.05,10
,20160108,12395,12510,12320,12320,12320,12320,12320,-190,-190,2,12.32,12
,20160111,12320,12320,,,,12315,12315,-5,-5,0,0.00,12
,20160112,12315,12315,11850,12465,11850,12045,12140,-270,-175,16,97.15,16
,20160113,12045,12140,12275,12275,12275,12275,12275,135,135,2,12.28,16
,20160114,12275,12275,12300,12355,12260,12355,12305,80,30,10,61.53,16
,20160115,12355,12305,12460,12460,12460,12460,12460,155,155,2,12.46,16
,20160118,12460,12460,12400,12400,12400,12400,12400,-60,-60,4,24.80,18
,20160119,12400,12400,12445,12470,12390,12430,12425,30,25,34,211.27,40
,20160120,12430,12425,12425,12425,12400,12400,12410,-25,-15,6,37.24,42
,20160121,12400,12410,12365,12365,12255,12355,12325,-55,-85,6,36.98,42
,20160122,12355,12325,12250,12375,12250,12285,12320,-40,-5,16,98.58,44
,20160125,12285,12320,12340,12340,12250,12335,12290,15,-30,46,282.78,74
,20160126,12335,12290,12360,12365,12360,12365,12360,75,70,6,37.09,74
,20160127,12365,12360,12435,12555,12400,12500,12455,140,95,24,149.48,78
,20160128,12500,12455,12590,12590,12500,12565,12550,110,95,6,37.66,80
,20160129,12565,12550,12600,12705,12590,12705,12645,155,95,34,215.05,88
,20160201,12705,12645,12775,12850,12775,12840,12820,195,175,14,89.76,84
,20160202,12840,12820,12775,12775,12730,12730,12755,-90,-65,10,63.78,80
,20160203,12730,12755,12800,12960,12800,12960,12900,205,145,10,64.51,78
,20160204,12960,12900,13000,13230,13000,13230,13115,330,215,4,26.23,74
,20160205,13230,13115,13090,13140,12730,12730,13010,-385,-105,20,130.11,68
,20160215,12730,13010,13000,13035,13000,13035,13015,25,5,4,26.04,70
,20160216,13035,13015,12910,12910,12910,12910,12910,-105,-105,2,12.91,70
,20160217,12910,12910,12915,12915,12905,12905,12910,-5,0,4,25.82,70
,20160218,12905,12910,,,,12880,12880,-30,-30,0,0.00,70
,20160219,12880,12880,12840,13055,12840,13055,12925,175,45,18,116.36,76
,20160222,13055,12925,13080,13080,13080,13080,13080,155,155,2,13.08,74
,20160223,13080,13080,12810,12810,12810,12810,12810,-270,-270,8,51.24,72
,20160224,12810,12810,12870,12870,12870,12870,12870,60,60,2,12.87,72
,20160225,12870,12870,,,,12985,12985,115,115,0,0.00,72
,20160226,12985,12985,12790,12855,12790,12855,12820,-130,-165,4,25.65,72
,20160229,12855,12820,12840,12840,12840,12840,12840,20,20,2,12.84,72
,20160301,12840,12840,,,,12905,12905,65,65,0,0.00,72
,20160302,12905,12905,,,,13025,13025,120,120,0,0.00,72
,20160303,13025,13025,13210,13210,13135,13135,13175,110,150,6,39.53,76
,20160304,13135,13175,,,,13175,13175,0,0,0,0.00,76
,20160307,13175,13175,13485,13495,13425,13495,13465,320,290,10,67.33,78
,20160308,13495,13465,13645,13705,13645,13705,13665,240,200,6,41.01,80
,20160309,13705,13665,13560,13560,13560,13560,13560,-105,-105,4,27.12,82
,20160310,13560,13560,13560,13560,13550,13550,13555,-10,-5,6,40.67,88
,20160311,13550,13555,,,,13610,13610,55,55,0,0.00,88
,20160314,13610,13610,13555,13610,13555,13610,13590,0,-20,6,40.77,84
,20160315,13610,13590,13580,13580,13580,13580,13580,-10,-10,10,67.90,88
,20160316,13580,13580,13405,13405,13405,13405,13405,-175,-175,2,13.41,88
,20160317,13405,13405,13380,13485,13380,13485,13430,80,25,4,26.87,88
,20160318,13485,13430,13355,13555,13355,13555,13480,125,50,6,40.45,90
,20160321,13555,13480,,,,13335,13335,-145,-145,0,0.00,90
,20160322,13335,13335,13470,13470,13470,13470,13470,135,135,2,13.47,88
,20160323,13470,13470,,,,13475,13475,5,5,0,0.00,88
,20160324,13475,13475,13350,13350,13120,13310,13275,-165,-200,10,66.39,88
,20160325,13310,13275,,,,13265,13265,-10,-10,0,0.00,88
,20160328,13265,13265,,,,13290,13290,25,25,0,0.00,88
,20160329,13290,13290,,,,13375,13375,85,85,0,0.00,88
,20160330,13375,13375,,,,13320,13320,-55,-55,0,0.00,88
,20160331,13320,13320,13060,13130,12950,12950,13065,-370,-255,60,391.95,114
,20160401,12950,13065,12980,13130,12980,13130,13055,65,-10,6,39.18,116
,20160405,13130,13055,13065,13130,13065,13130,13105,75,50,6,39.33,114
,20160406,13130,13105,13050,13050,13050,13050,13050,-55,-55,6,39.15,120
,20160407,13050,13050,,,,13065,13065,15,15,0,0.00,120
,20160408,13065,13065,12950,12980,12920,12920,12945,-145,-120,12,77.68,128
,20160411,12920,12945,12925,13030,12925,13030,12975,85,30,4,25.96,126
,20160412,13030,12975,12960,12980,12945,12945,12955,-30,-20,12,77.76,134
,20160413,12945,12955,13140,13280,13115,13235,13175,280,220,22,144.95,134
,20160414,13235,13175,13235,13310,13195,13195,13250,20,75,12,79.51,142
,20160415,13195,13250,13220,13220,13220,13220,13220,-30,-30,6,39.66,142
,20160418,13220,13220,13250,13330,13250,13330,13280,110,60,8,53.13,150
,20160419,13330,13280,13165,13165,13165,13165,13165,-115,-115,2,13.17,150
,20160420,13165,13165,13355,13510,13230,13230,13305,65,140,72,478.98,168
,20160421,13230,13305,13335,13715,13295,13435,13395,130,90,36,241.20,176
,20160422,13435,13395,13325,13325,13070,13270,13230,-125,-165,8,52.94,176
,20160425,13270,13230,,,,13315,13315,85,85,0,0.00,176
,20160426,13315,13315,13315,13315,13110,13110,13180,-205,-135,10,65.92,184
,20160427,13110,13180,13140,13165,13140,13165,13145,-15,-35,10,65.75,188
,20160428,13165,13145,13115,13115,13110,13110,13110,-35,-35,4,26.23,186
,20160429,13110,13110,13155,13255,13155,13255,13180,145,70,8,52.73,188
,20160503,13255,13180,,,,13310,13310,130,130,0,0.00,188
,20160504,13310,13310,13305,13305,13195,13200,13225,-110,-85,12,79.36,194
,20160505,13200,13225,,,,13225,13225,0,0,0,0.00,194
,20160506,13225,13225,12970,12970,12970,12970,12970,-255,-255,4,25.94,192
,20160509,12970,12970,,,,13005,13005,35,35,0,0.00,192
,20160510,13005,13005,12950,12950,12950,12950,12950,-55,-55,2,12.95,192
,20160511,12950,12950,13050,13050,13050,13050,13050,100,100,4,26.10,194
,20160512,13050,13050,13245,13245,13175,13180,13195,130,145,8,52.79,196
,20160513,13180,13195,12955,12955,12955,12955,12955,-240,-240,2,12.96,196
,20160516,12955,12955,13030,13030,12905,12945,12960,-10,5,6,38.88,198
,20160517,12945,12960,,,,13070,13070,110,110,0,0.00,198
,20160518,13070,13070,,,,13070,13070,0,0,0,0.00,198
,20160519,13070,13070,12860,12860,12860,12860,12860,-210,-210,2,12.86,198
,20160520,12860,12860,12860,12915,12830,12900,12875,40,15,12,77.26,200
,20160523,12900,12875,12830,12830,12830,12830,12830,-45,-45,8,51.32,192
,20160524,12830,12830,12765,12765,12765,12765,12765,-65,-65,2,12.77,190
,20160525,12765,12765,12815,12835,12800,12800,12810,35,45,46,294.74,194
,20160526,12800,12810,12800,12840,12735,12800,12790,-10,-20,34,217.49,194
,20160527,12800,12790,12855,12915,12855,12915,12885,125,95,4,25.77,192
,20160530,12915,12885,,,,12925,12925,40,40,0,0.00,192
,20160531,12925,12925,12945,12945,12945,12945,12945,20,20,2,12.95,192
,20160601,12945,12945,,,,12895,12895,-50,-50,0,0.00,192
,20160602,12895,12895,,,,12850,12850,-45,-45,0,0.00,192
,20160603,12850,12850,,,,12950,12950,100,100,0,0.00,192
,20160606,12950,12950,12880,12945,12880,12945,12900,-5,-50,6,38.71,194
,20160607,12945,12900,,,,12900,12900,0,0,0,0.00,194
,20160608,12900,12900,,,,12880,12880,-20,-20,0,0.00,194
,20160613,12880,12880,12915,12950,12915,12950,12930,70,50,14,90.52,204
,20160614,12950,12930,12870,12870,12870,12870,12870,-60,-60,2,12.87,204
,20160615,12870,12870,12875,12905,12875,12895,12895,25,25,16,103.17,194
,20160616,12895,12895,12875,12875,12855,12855,12860,-40,-35,8,51.46,200
,20160617,12855,12860,12860,12895,12855,12895,12885,35,25,26,167.55,190
,20160620,12895,12885,12910,12910,12910,12910,12910,25,25,2,12.91,190
,20160621,12910,12910,12930,12930,12930,12930,12930,20,20,2,12.93,190
,20160622,12930,12930,,,,12930,12930,0,0,0,0.00,190
,20160623,12930,12930,12895,12895,12895,12895,12895,-35,-35,2,12.90,190
,20160624,12895,12895,,,,12910,12910,15,15,0,0.00,190
,20160627,12910,12910,12915,12930,12895,12930,12910,20,0,6,38.74,188
,20160628,12930,12910,12920,13035,12920,13030,13005,120,95,32,208.14,204
,20160629,13030,13005,13130,13130,13025,13025,13065,20,60,10,65.34,206
,20160630,13025,13065,13105,13385,13105,13385,13240,320,175,138,913.86,278
,20160701,13385,13240,13380,13395,13300,13380,13355,140,115,46,307.26,296
,20160704,13380,13355,13615,13645,13615,13645,13635,290,280,20,136.38,308
,20160705,13645,13635,13685,13685,13340,13340,13445,-295,-190,48,322.70,274
,20160706,13340,13445,13340,13340,13185,13220,13240,-225,-205,24,158.90,274
,20160707,13220,13240,13125,13140,13125,13140,13135,-100,-105,8,52.55,270
,20160708,13140,13135,,,,13135,13135,0,0,0,0.00,270
,20160711,13135,13135,13170,13170,13170,13170,13170,35,35,8,52.68,268
,20160712,13170,13170,13245,13290,13245,13290,13270,120,100,8,53.09,268
,20160713,13290,13270,13400,13520,13335,13335,13420,65,150,18,120.82,272
,20160714,13335,13420,13420,13425,13320,13340,13365,-80,-55,32,213.88,268
,20160715,13340,13365,13460,13550,13460,13550,13490,185,125,6,40.48,268
,20160718,13550,13490,13565,13565,13375,13375,13490,-115,0,8,53.96,272
,20160719,13375,13490,,,,13490,13490,0,0,0,0.00,272
,20160720,13490,13490,13405,13445,13405,13430,13425,-60,-65,8,53.72,268
,20160721,13430,13425,13380,13610,13380,13610,13505,185,80,28,189.08,278
,20160722,13610,13505,13535,13655,13535,13540,13565,35,60,14,94.97,274
,20160725,13540,13565,13460,13760,13460,13715,13670,150,105,42,287.08,260
,20160726,13715,13670,13655,13845,13655,13845,13745,175,75,16,109.99,246
,20160727,13845,13745,13895,13995,13895,13950,13960,205,215,26,181.52,242
,20160728,13950,13960,13790,13815,13790,13815,13800,-145,-160,4,27.61,238
,20160729,13815,13800,13835,13885,13830,13885,13850,85,50,6,41.55,234
,20160801,13885,13850,13950,14195,13950,14195,14005,345,155,12,84.04,230
,20160802,14195,14005,14200,14200,14035,14035,14150,30,145,8,56.61,234
,20160803,14035,14150,14120,14120,13885,13895,13980,-255,-170,12,83.90,228
,20160804,13895,13980,13915,13950,13885,13950,13915,-30,-65,6,41.75,222
,20160805,13950,13915,13860,13930,13860,13930,13895,15,-20,4,27.79,222
,20160808,13930,13895,14030,14030,13930,13945,13970,50,75,10,69.87,226
,20160809,13945,13970,14005,14005,13975,13975,13995,5,25,8,55.99,226
,20160810,13975,13995,13835,13835,13835,13835,13835,-160,-160,4,27.67,222
,20160811,13835,13835,13950,14000,13900,14000,13955,165,120,28,195.37,212
,20160812,14000,13955,13855,13880,13850,13860,13870,-95,-85,26,180.33,222
,20160815,13860,13870,,,,13755,13755,-115,-115,0,0.00,222
,20160816,13755,13755,13665,13700,13665,13680,13680,-75,-75,14,95.77,228
,20160817,13680,13680,13695,13695,13690,13690,13690,10,10,4,27.39,226
,20160818,13690,13690,13725,13870,13725,13870,13760,180,70,12,82.56,216
,20160819,13870,13760,14050,14050,14050,14050,14050,290,290,2,14.05,216
,20160822,14050,14050,,,,14050,14050,0,0,0,0.00,216
,20160823,14050,14050,13910,13960,13910,13945,13945,-105,-105,18,125.54,232
,20160824,13945,13945,14000,14030,13960,14030,14005,85,60,30,210.09,230
,20160825,14030,14005,13950,14005,13950,14005,13955,0,-50,18,125.61,232
,20160826,14005,13955,13895,13975,13895,13970,13925,15,-30,58,403.83,258
,20160829,13970,13925,14020,14020,13930,13930,14005,5,80,22,154.06,248
,20160830,13930,14005,13920,13920,13845,13845,13900,-160,-105,32,222.41,260
,20160831,13845,13900,13950,13970,13910,13910,13925,10,25,38,264.60,280
,20160901,13910,13925,13975,14465,13970,14430,14235,505,310,160,"1,138.93",278
,20160902,14430,14235,14530,14800,14440,14485,14635,250,400,730,"5,341.88",596
,20160905,14485,14635,14565,14620,14375,14540,14490,-95,-145,302,"2,188.60",756
,20160906,14540,14490,14715,14715,14450,14465,14515,-25,25,144,"1,045.29",830
,20160907,14465,14515,14400,14400,14250,14290,14285,-225,-230,434,"3,100.83",1126
,20160908,14290,14285,14215,14345,14175,14200,14260,-85,-25,492,"3,508.61",1210
,20160909,14200,14260,14185,14240,14120,14190,14210,-70,-50,282,"2,003.82",1204
,20160912,14190,14210,14200,14200,13870,13870,13965,-340,-245,376,"2,625.45",1228
,20160913,13870,13965,13930,14065,13920,13980,14030,15,65,208,"1,459.38",1242
,20160914,13980,14030,14065,14120,14025,14080,14090,50,60,240,"1,691.11",1244
,20160919,14080,14090,14200,14265,14145,14260,14235,170,145,324,"2,306.53",1304
,20160920,14260,14235,14345,14500,14345,14490,14440,255,205,478,"3,452.12",1600
,20160921,14490,14440,14550,14735,14550,14610,14615,170,175,1284,"9,385.85",2270
,20160922,14610,14615,14570,14620,14430,14560,14535,-55,-80,1186,"8,621.05",2828
,20160923,14560,14535,14565,14725,14450,14495,14585,-40,50,1278,"9,320.27",3128
,20160926,14495,14585,14475,14480,14280,14410,14395,-175,-190,1488,"10,711.31",4036
,20160927,14410,14395,14430,14820,14420,14700,14630,305,235,5346,"39,106.37",6618
,20160928,14700,14630,14700,14740,14580,14600,14630,-30,0,2432,"17,791.48",6972
,20160929,14600,14630,14705,15080,14700,14965,14930,335,300,6306,"47,075.39",9454
,20160930,14965,14930,15090,15425,15040,15420,15225,490,295,9660,"73,552.44",13052
,20161010,15420,15225,15300,15735,15290,15690,15540,465,315,6642,"51,614.33",15130
,20161011,15690,15540,15675,15820,15620,15770,15700,230,160,7894,"61,983.23",16962
,20161012,15770,15700,15680,15690,15480,15535,15565,-165,-135,8392,"65,311.49",17658
,20161013,15535,15565,15590,15655,15240,15255,15400,-310,-165,10476,"80,680.62",17918
,20161014,15255,15400,15260,15370,15170,15350,15265,-50,-135,9608,"73,352.06",18000
,20161017,15350,15265,15305,15500,15290,15430,15400,165,135,10254,"78,972.80",19198
,20161018,15430,15400,15395,15580,15335,15545,15450,145,50,9798,"75,707.32",20872
,20161019,15545,15450,15525,15525,15330,15360,15415,-90,-35,10490,"80,864.63",21950
,20161020,15360,15415,15390,15650,15290,15410,15470,-5,55,19750,"152,785.17",23070
,20161021,15410,15470,15455,15800,15430,15760,15655,290,185,25208,"197,366.75",27508
,20161024,15760,15655,15725,15875,15620,15755,15745,100,90,22420,"176,525.82",29310
,20161025,15755,15745,15830,16370,15800,16370,16170,625,425,28534,"230,752.25",33198
,20161026,16370,16170,16380,16620,16025,16230,16305,60,135,31504,"256,894.70",30286
,20161027,16230,16305,16305,16560,16175,16245,16380,-60,75,27774,"227,479.35",31348
,20161028,16245,16380,16320,16500,16250,16455,16360,75,-20,19882,"162,668.16",31244
,20161031,16455,16360,16440,16600,16295,16470,16470,110,110,25492,"209,948.62",30442
,20161101,16470,16470,16515,16955,16440,16590,16680,120,210,34432,"287,205.51",28846
,20161102,16590,16680,16595,16675,16240,16355,16520,-325,-160,23584,"194,807.30",25756
,20161103,16355,16520,16475,16680,16325,16640,16490,120,-30,11652,"96,089.74",25002
,20161104,16640,16490,16675,16765,16570,16680,16660,190,170,11994,"99,936.41",23310
,20161107,16680,16660,16700,17105,16605,16965,16825,305,165,17148,"144,285.83",22160
,20161108,16965,16825,16945,17055,16600,16650,16790,-175,-35,18098,"151,962.57",17452
,20161109,16650,16790,16670,16970,16515,16670,16715,-120,-75,10542,"88,110.17",15426
,20161110,16670,16715,16820,17380,16760,17315,17145,600,430,6344,"54,393.57",14798
,20161111,17315,17145,17385,17450,17020,17400,17220,255,75,7892,"67,968.11",14012
,20161114,17400,17220,17425,18250,16800,17660,17470,440,250,12990,"113,498.63",12486
,20161115,17660,17470,17690,18515,17630,17820,18015,350,545,6802,"61,272.02",11184
,20161116,17820,18015,17820,18680,17780,18330,18315,315,300,4118,"37,716.90",11080
,20161117,18330,18315,18320,18380,17500,17890,17965,-425,-350,3696,"33,205.37",11244
,20161118,17890,17965,17990,18080,17720,17885,17885,-80,-80,1454,"13,005.79",11010
,20161121,17885,17885,17875,18480,17780,18375,18180,490,295,2262,"20,564.18",11170
,20161122,18375,18180,18410,19270,18285,19270,18880,1090,700,4416,"41,692.97",10248
,20161123,19270,18880,19240,19635,19065,19460,19270,580,390,2128,"20,503.36",9510
,20161124,19460,19270,19435,20425,19300,20425,20005,1155,735,1850,"18,508.18",9040
,20161125,20425,20005,20355,21780,20350,20750,20990,745,985,2434,"25,548.06",7886
,20161128,20750,20990,20810,22455,20775,22335,21865,1345,875,2654,"29,018.48",6574
,20161129,22335,21865,22300,23200,21905,22030,22535,165,670,1964,"22,134.07",5282
,20161130,22030,22535,21710,22600,20955,21450,21655,-1085,-880,1206,"13,060.24",4970
,20161201,21450,21655,21000,21690,21000,21400,21295,-255,-360,1030,"10,968.55",5070
,20161202,21400,21295,21540,21540,20175,20480,20810,-815,-485,1260,"13,111.03",5490
,20161205,20480,20810,20480,20585,20180,20470,20440,-340,-370,540,"5,519.20",5400
,20161206,20470,20440,20750,20880,20600,20700,20725,260,285,460,"4,767.08",5490
,20161207,20700,20725,21240,21350,20850,21350,21010,625,285,490,"5,148.65",5550
,20161208,21350,21010,21400,21400,21155,21250,21265,240,255,180,"1,913.90",5520
,20161209,21250,21265,21100,21200,20950,21200,21030,-65,-235,800,"8,413.00",5340
,20161212,21200,21030,21050,21450,21050,21100,21280,70,250,360,"3,831.00",5210
,20161213,21100,21280,21230,21350,21000,21200,21180,-80,-100,280,"2,965.38",5050
,20161214,21200,21180,20890,21000,20770,20815,20835,-365,-345,180,"1,875.43",4880
,20161215,20815,20835,19555,22280,19555,21000,20965,165,130,780,"8,568.18",4870
pb1701,20160118,12460,12460,,,,12400,12400,-60,-60,0,0.00,0
,20160119,12400,12400,,,,12425,12425,25,25,0,0.00,0
,20160120,12425,12425,12185,12360,12185,12360,12270,-65,-155,4,24.55,4
,20160121,12360,12270,,,,12185,12185,-85,-85,0,0.00,4
,20160122,12185,12185,,,,12185,12185,0,0,0,0.00,4
,20160125,12185,12185,,,,12155,12155,-30,-30,0,0.00,4
,20160126,12155,12155,,,,12225,12225,70,70,0,0.00,4
,20160127,12225,12225,12310,12310,12310,12310,12310,85,85,2,12.31,4
,20160128,12310,12310,12560,12720,12120,12470,12460,160,150,82,510.96,12
,20160129,12470,12460,12470,12590,12470,12550,12555,90,95,40,251.16,28
,20160201,12550,12555,13045,13045,12895,12895,12970,340,415,4,25.94,26
,20160202,12895,12970,12880,12880,12750,12750,12800,-220,-170,8,51.21,30
,20160203,12750,12800,,,,12945,12945,145,145,0,0.00,30
,20160204,12945,12945,13000,13000,13000,13000,13000,55,55,18,117.00,28
,20160205,13000,13000,13060,13060,12785,12850,12815,-150,-185,22,141.02,28
,20160215,12850,12815,,,,12820,12820,5,5,0,0.00,28
,20160216,12820,12820,,,,12715,12715,-105,-105,0,0.00,28
,20160217,12715,12715,12850,12965,12835,12835,12915,120,200,12,77.51,28
,20160218,12835,12915,12805,12805,12805,12805,12805,-110,-110,2,12.81,28
,20160219,12805,12805,12895,12895,12870,12870,12880,65,75,4,25.77,30
,20160222,12870,12880,13075,13075,13055,13055,13065,175,185,4,26.13,30
,20160223,13055,13065,12840,12840,12840,12840,12840,-225,-225,4,25.68,34
,20160224,12840,12840,12790,12790,12790,12790,12790,-50,-50,2,12.79,36
,20160225,12790,12790,,,,12905,12905,115,115,0,0.00,36
,20160226,12905,12905,12775,12775,12775,12775,12775,-130,-130,2,12.78,38
,20160229,12775,12775,12875,12900,12875,12900,12885,125,110,4,25.78,36
,20160301,12900,12885,12885,12885,12775,12805,12825,-80,-60,18,115.45,40
,20160302,12805,12825,12955,13095,12955,13040,13005,215,180,10,65.04,40
,20160303,13040,13005,13115,13115,13015,13015,13065,10,60,4,26.13,38
,20160304,13015,13065,13175,13175,13165,13170,13170,105,105,6,39.51,36
,20160307,13170,13170,13340,13500,13300,13500,13405,330,235,38,254.71,40
,20160308,13500,13405,13680,13680,13680,13680,13680,275,275,2,13.68,40
,20160309,13680,13680,,,,13680,13680,0,0,0,0.00,40
,20160310,13680,13680,13295,13605,13295,13440,13390,-240,-290,10,66.95,42
,20160311,13440,13390,,,,13495,13495,105,105,0,0.00,42
,20160314,13495,13495,13505,13505,13505,13505,13505,10,10,4,27.01,44
,20160315,13505,13505,13420,13420,13420,13420,13420,-85,-85,2,13.42,44
,20160316,13420,13420,,,,13245,13245,-175,-175,0,0.00,44
,20160317,13245,13245,,,,13520,13520,275,275,0,0.00,44
,20160318,13520,13520,13630,13630,13630,13630,13630,110,110,2,13.63,44
,20160321,13630,13630,,,,13630,13630,0,0,0,0.00,44
,20160322,13630,13630,,,,13630,13630,0,0,0,0.00,44
,20160323,13630,13630,,,,13575,13575,-55,-55,0,0.00,44
,20160324,13575,13575,13350,13350,13350,13350,13350,-225,-225,2,13.35,42
,20160325,13350,13350,,,,13340,13340,-10,-10,0,0.00,42
,20160328,13340,13340,13345,13380,13345,13380,13360,40,20,4,26.73,44
,20160329,13380,13360,,,,13450,13450,90,90,0,0.00,44
,20160330,13450,13450,13310,13310,13310,13310,13310,-140,-140,2,13.31,42
,20160331,13310,13310,13095,13175,13095,13175,13140,-135,-170,6,39.42,42
,20160401,13175,13140,,,,13130,13130,-10,-10,0,0.00,42
,20160405,13130,13130,13110,13110,13110,13110,13110,-20,-20,2,13.11,42
,20160406,13110,13110,13085,13085,13080,13080,13080,-30,-30,4,26.17,42
,20160407,13080,13080,,,,13095,13095,15,15,0,0.00,42
,20160408,13095,13095,13020,13025,13020,13025,13020,-70,-75,8,52.09,42
,20160411,13025,13020,,,,13050,13050,30,30,0,0.00,42
,20160412,13050,13050,,,,13030,13030,-20,-20,0,0.00,42
,20160413,13030,13030,,,,13250,13250,220,220,0,0.00,42
,20160414,13250,13250,,,,13325,13325,75,75,0,0.00,42
,20160415,13325,13325,,,,13290,13290,-35,-35,0,0.00,42
,20160418,13290,13290,,,,13350,13350,60,60,0,0.00,42
,20160419,13350,13350,,,,13230,13230,-120,-120,0,0.00,42
,20160420,13230,13230,13355,13365,13245,13250,13290,20,60,38,252.53,54
,20160421,13250,13290,13350,13460,13350,13435,13410,145,120,14,93.90,52
,20160422,13435,13410,13485,13490,13350,13350,13445,-60,35,16,107.58,58
,20160425,13350,13445,13475,13475,13310,13370,13370,-75,-75,8,53.48,58
,20160426,13370,13370,13280,13280,13245,13245,13255,-125,-115,6,39.77,64
,20160427,13245,13255,,,,13220,13220,-35,-35,0,0.00,64
,20160428,13220,13220,13130,13145,13130,13145,13140,-75,-80,6,39.42,68
,20160429,13145,13140,,,,13210,13210,70,70,0,0.00,68
,20160503,13210,13210,,,,13210,13210,0,0,0,0.00,68
,20160504,13210,13210,13330,13360,13225,13225,13285,15,75,42,279.05,72
,20160505,13225,13285,,,,13105,13105,-180,-180,0,0.00,72
,20160506,13105,13105,13040,13040,12970,12970,13005,-135,-100,4,26.01,74
,20160509,12970,13005,,,,13040,13040,35,35,0,0.00,74
,20160510,13040,13040,13080,13080,13080,13080,13080,40,40,2,13.08,74
,20160511,13080,13080,,,,13180,13180,100,100,0,0.00,74
,20160512,13180,13180,13235,13270,13200,13270,13235,90,55,6,39.71,76
,20160513,13270,13235,12975,12975,12960,12975,12970,-260,-265,10,64.85,82
,20160516,12975,12970,12960,12960,12960,12960,12960,-10,-10,4,25.92,84
,20160517,12960,12960,,,,13070,13070,110,110,0,0.00,84
,20160518,13070,13070,,,,13065,13065,-5,-5,0,0.00,84
,20160519,13065,13065,12945,12945,12945,12945,12945,-120,-120,2,12.95,86
,20160520,12945,12945,,,,12960,12960,15,15,0,0.00,86
,20160523,12960,12960,,,,12910,12910,-50,-50,0,0.00,86
,20160524,12910,12910,,,,12840,12840,-70,-70,0,0.00,86
,20160525,12840,12840,12815,12815,12785,12810,12810,-30,-30,26,166.53,96
,20160526,12810,12810,12750,13080,12605,12875,12820,65,10,404,"2,589.98",126
,20160527,12875,12820,12865,12865,12865,12865,12865,45,45,2,12.87,124
,20160530,12865,12865,,,,12865,12865,0,0,0,0.00,124
,20160531,12865,12865,,,,12865,12865,0,0,0,0.00,124
,20160601,12865,12865,12885,12885,12885,12885,12885,20,20,4,25.77,124
,20160602,12885,12885,12945,12970,12945,12970,12950,85,65,8,51.81,116
,20160603,12970,12950,12990,12990,12990,12990,12990,40,40,6,38.97,112
,20160606,12990,12990,12880,12955,12875,12950,12890,-40,-100,52,335.21,84
,20160607,12950,12890,12905,12905,12905,12905,12905,15,15,2,12.91,84
,20160608,12905,12905,12910,12910,12910,12910,12910,5,5,2,12.91,82
,20160613,12910,12910,,,,12960,12960,50,50,0,0.00,82
,20160614,12960,12960,,,,12895,12895,-65,-65,0,0.00,82
,20160615,12895,12895,,,,12920,12920,25,25,0,0.00,82
,20160616,12920,12920,12960,12960,12960,12960,12960,40,40,2,12.96,84
,20160617,12960,12960,,,,12985,12985,25,25,0,0.00,84
,20160620,12985,12985,,,,13010,13010,25,25,0,0.00,84
,20160621,13010,13010,,,,13030,13030,20,20,0,0.00,84
,20160622,13030,13030,,,,13015,13015,-15,-15,0,0.00,84
,20160623,13015,13015,,,,12975,12975,-40,-40,0,0.00,84
,20160624,12975,12975,,,,12995,12995,20,20,0,0.00,84
,20160627,12995,12995,12945,12945,12945,12945,12945,-50,-50,2,12.95,82
,20160628,12945,12945,12995,12995,12995,12995,12995,50,50,2,13.00,80
,20160629,12995,12995,,,,13055,13055,60,60,0,0.00,80
,20160630,13055,13055,13190,13210,13190,13210,13195,155,140,12,79.19,74
,20160701,13210,13195,13385,13450,13385,13450,13400,255,205,26,174.22,72
,20160704,13450,13400,13595,13825,13595,13825,13650,425,250,10,68.27,72
,20160705,13825,13650,13710,13710,13360,13360,13575,-290,-75,6,40.73,70
,20160706,13360,13575,13200,13230,13200,13230,13215,-345,-360,4,26.43,70
,20160707,13230,13215,13150,13235,13140,13235,13170,20,-45,8,52.69,68
,20160708,13235,13170,,,,13110,13110,-60,-60,0,0.00,68
,20160711,13110,13110,13305,13305,13305,13305,13305,195,195,4,26.61,66
,20160712,13305,13305,13455,13455,13330,13330,13390,25,85,4,26.79,66
,20160713,13330,13390,,,,13390,13390,0,0,0,0.00,66
,20160714,13390,13390,,,,13335,13335,-55,-55,0,0.00,66
,20160715,13335,13335,,,,13335,13335,0,0,0,0.00,66
,20160718,13335,13335,,,,13335,13335,0,0,0,0.00,66
,20160719,13335,13335,13350,13415,13350,13415,13385,80,50,6,40.17,64
,20160720,13415,13385,,,,13320,13320,-65,-65,0,0.00,64
,20160721,13320,13320,13405,13405,13405,13405,13405,85,85,2,13.41,64
,20160722,13405,13405,,,,13465,13465,60,60,0,0.00,64
,20160725,13465,13465,,,,13565,13565,100,100,0,0.00,64
,20160726,13565,13565,13850,13920,13850,13920,13885,355,320,4,27.77,62
,20160727,13920,13885,14020,14020,14020,14020,14020,135,135,2,14.02,64
,20160728,14020,14020,13910,13910,13885,13885,13890,-135,-130,8,55.57,66
,20160729,13885,13890,13920,13920,13900,13915,13910,25,20,6,41.74,70
,20160801,13915,13910,14060,14270,14060,14270,14195,360,285,18,127.80,72
,20160802,14270,14195,14210,14210,14000,14000,14120,-195,-75,6,42.37,74
,20160803,14000,14120,14120,14120,13930,13930,14035,-190,-85,8,56.15,80
,20160804,13930,14035,13910,14045,13910,14045,13975,10,-60,4,27.96,80
,20160805,14045,13975,13900,13900,13900,13900,13900,-75,-75,2,13.90,82
,20160808,13900,13900,14035,14050,13960,13990,13995,90,95,16,112.00,92
,20160809,13990,13995,,,,14020,14020,25,25,0,0.00,92
,20160810,14020,14020,,,,13855,13855,-165,-165,0,0.00,92
,20160811,13855,13855,,,,13855,13855,0,0,0,0.00,92
,20160812,13855,13855,13910,13910,13855,13880,13880,25,25,28,194.36,100
,20160815,13880,13880,13900,13945,13755,13755,13855,-125,-25,12,83.15,98
,20160816,13755,13855,13805,13805,13705,13705,13785,-150,-70,24,165.47,114
,20160817,13705,13785,13680,13785,13680,13745,13715,-40,-70,12,82.30,110
,20160818,13745,13715,13905,13910,13900,13905,13905,190,190,14,97.34,102
,20160819,13905,13905,13985,14055,13910,14050,13995,145,90,128,895.85,164
,20160822,14050,13995,14010,14010,14010,14010,14010,15,15,4,28.02,164
,20160823,14010,14010,13885,13970,13885,13970,13955,-40,-55,20,139.57,170
,20160824,13970,13955,14015,14075,14005,14030,14025,75,70,32,224.46,162
,20160825,14030,14025,13920,14000,13920,14000,13975,-25,-50,8,55.90,158
,20160826,14000,13975,13960,14070,13935,14070,13975,95,0,42,293.54,160
,20160829,14070,13975,14015,14045,14005,14005,14025,30,50,12,84.16,160
,20160830,14005,14025,13930,13930,13915,13915,13920,-110,-105,8,55.70,156
,20160831,13915,13920,13955,13965,13955,13965,13960,45,40,12,83.76,150
,20160901,13965,13960,14165,14460,14105,14450,14355,490,395,28,201.01,170
,20160902,14450,14355,14530,14925,14435,14500,14680,145,325,194,"1,424.00",224
,20160905,14500,14680,14585,14650,14410,14550,14520,-130,-160,96,696.97,214
,20160906,14550,14520,14610,14620,14485,14490,14555,-30,35,20,145.56,210
,20160907,14490,14555,14310,14395,14280,14280,14300,-275,-255,96,686.41,246
,20160908,14280,14300,14250,14280,14200,14200,14245,-100,-55,24,170.97,246
,20160909,14200,14245,14180,14280,14150,14250,14245,5,0,98,698.02,232
,20160912,14250,14245,14165,14270,13915,13915,14075,-330,-170,108,760.07,238
,20160913,13915,14075,14000,14115,14000,14070,14060,-5,-15,92,646.90,244
,20160914,14070,14060,14080,14105,14080,14100,14090,40,30,34,239.56,236
,20160919,14100,14090,14210,14280,14210,14265,14255,175,165,56,399.22,240
,20160920,14265,14255,14400,14540,14375,14510,14465,255,210,218,"1,576.96",278
,20160921,14510,14465,14555,14750,14555,14675,14670,210,205,216,"1,584.87",360
,20160922,14675,14670,14575,14600,14460,14585,14530,-85,-140,112,813.77,380
,20160923,14585,14530,14620,14685,14475,14530,14605,0,75,96,701.21,424
,20160926,14530,14605,14435,14555,14365,14440,14440,-165,-165,146,"1,054.48",482
,20160927,14440,14440,14520,14810,14470,14700,14675,260,235,720,"5,283.01",794
,20160928,14700,14675,14665,14680,14595,14600,14625,-75,-50,276,"2,018.88",806
,20160929,14600,14625,14700,15020,14700,14995,14920,370,295,1820,"13,577.65",2028
,20160930,14995,14920,15085,15350,15040,15350,15185,430,265,910,"6,911.25",2410
,20161010,15350,15185,15400,15695,15170,15665,15535,480,350,2454,"19,065.33",3760
,20161011,15665,15535,15595,15760,15580,15735,15650,200,115,2570,"20,113.36",4590
,20161012,15735,15650,15680,15680,15440,15465,15520,-185,-130,2252,"17,477.37",5270
,20161013,15465,15520,15520,15580,15195,15205,15345,-315,-175,1444,"11,082.06",5210
,20161014,15205,15345,15170,15330,15115,15275,15240,-70,-105,1212,"9,236.82",5802
,20161017,15275,15240,15285,15445,15255,15385,15355,145,115,1394,"10,705.89",5836
,20161018,15385,15355,15340,15505,15285,15480,15400,125,45,1058,"8,148.85",5964
,20161019,15480,15400,15460,15460,15275,15275,15350,-125,-50,924,"7,093.76",5992
,20161020,15275,15350,15275,15510,15220,15300,15395,-50,45,1920,"14,780.57",6390
,20161021,15300,15395,15300,15885,15300,15685,15580,290,185,3352,"26,118.14",7810
,20161024,15685,15580,15795,15795,15535,15675,15665,95,85,3766,"29,505.25",9428
,20161025,15675,15665,15760,16290,15730,16290,16085,625,420,3720,"29,927.04",10874
,20161026,16290,16085,16255,16560,16105,16210,16300,125,215,6746,"54,992.33",11738
,20161027,16210,16300,16295,16525,16155,16200,16325,-100,25,5274,"43,051.28",12930
,20161028,16200,16325,16280,16475,16225,16445,16325,120,0,7236,"59,076.73",15448
,20161031,16445,16325,16410,16570,16275,16435,16435,110,110,6462,"53,114.61",16972
,20161101,16435,16435,16475,16885,16380,16575,16625,140,190,13546,"112,630.17",19264
,20161102,16575,16625,16605,16650,16260,16340,16480,-285,-145,9366,"77,183.38",20414
,20161103,16340,16480,16345,16650,16300,16625,16490,145,10,10712,"88,327.74",22368
,20161104,16625,16490,16650,16750,16555,16665,16655,175,165,13694,"114,039.56",22952
,20161107,16665,16655,16665,17100,16600,17000,16835,345,180,26372,"222,028.49",24968
,20161108,17000,16835,16935,17100,16635,16690,16835,-145,0,30278,"254,894.49",25886
,20161109,16690,16835,16675,17050,16550,16690,16795,-145,-40,32028,"268,962.82",26660
,20161110,16690,16795,16810,17465,16790,17400,17180,605,385,55348,"475,540.01",28296
,20161111,17400,17180,17400,17480,17060,17450,17280,270,100,34472,"297,857.45",27564
,20161114,17450,17280,17420,18295,16835,17675,17535,395,255,76006,"666,462.56",27992
,20161115,17675,17535,17650,18565,17615,17790,17985,255,450,68894,"619,620.21",27754
,20161116,17790,17985,17780,18660,17710,18320,18270,335,285,80594,"736,258.24",32052
,20161117,18320,18270,18295,18360,17400,17790,17935,-480,-335,58104,"521,186.19",29910
,20161118,17790,17935,17850,17975,17600,17835,17790,-100,-145,35142,"312,599.76",29192
,20161121,17835,17790,17860,18340,17665,18230,18020,440,230,60068,"541,333.28",31740
,20161122,18230,18020,18280,19100,18075,19095,18645,1075,625,68886,"642,193.65",36052
,20161123,19095,18645,19010,19355,18765,19170,19030,525,385,73616,"700,487.37",39858
,20161124,19170,19030,19120,20105,19020,19880,19610,850,580,106222,"1,041,588.59",40424
,20161125,19880,19610,19900,20475,19805,20180,20220,570,610,126682,"1,280,967.59",40664
,20161128,20180,20220,20470,21635,20295,21635,21025,1415,805,163666,"1,720,576.04",45442
,20161129,21635,21025,21730,22940,21555,21865,22230,840,1205,269264,"2,992,921.60",42872
,20161130,21865,22230,22080,22145,20670,20670,21270,-1560,-960,267962,"2,849,932.40",39866
,20161201,20670,21270,20600,21470,20450,21140,20895,-130,-375,206424,"2,156,852.86",38512
,20161202,21140,20895,21190,21315,20000,20300,20615,-595,-280,131956,"1,360,445.77",37020
,20161205,20300,20615,20200,20515,19670,20210,20140,-405,-475,141806,"1,428,095.78",38610
,20161206,20210,20140,20300,21300,20220,20350,20435,210,295,101560,"1,037,880.57",38042
,20161207,20350,20435,20440,21285,20255,21060,20920,625,485,142008,"1,485,553.12",37180
,20161208,21060,20920,21215,21695,20775,20965,21170,45,250,117542,"1,244,451.02",36538
,20161209,20965,21170,21145,21280,20410,20680,20780,-490,-390,85130,"884,543.59",34008
,20161212,20680,20780,20710,21190,20415,20660,20825,-120,45,74050,"771,058.71",31824
,20161213,20660,20825,20750,20985,20570,20725,20765,-100,-60,39290,"407,975.83",29194
,20161214,20725,20765,20810,20970,20505,20660,20665,-105,-100,29372,"303,541.44",26954
,20161215,20660,20665,20755,21025,20420,20695,20695,30,30,25438,"263,274.08",23490
,20161216,20695,20695,20610,20610,19820,19820,20175,-875,-520,20682,"208,667.26",18378
,20161219,19820,20175,19680,19725,18760,18760,19220,-1415,-955,15354,"147,570.15",18014
,20161220,18760,19220,18760,18760,17995,18265,18275,-955,-945,11966,"109,349.44",16816
,20161221,18265,18275,18410,18805,18270,18650,18540,375,265,6294,"58,355.07",15954
,20161222,18650,18540,18695,18695,18250,18255,18460,-285,-80,5014,"46,283.69",15008
,20161223,18255,18460,18195,18800,18050,18425,18475,-35,15,4258,"39,342.76",13832
,20161226,18425,18475,18165,18620,17300,17610,17810,-865,-665,5532,"49,274.39",12898
,20161227,17610,17810,17765,17855,17500,17855,17640,45,-170,6062,"53,480.41",12486
,20161228,17855,17640,17855,18275,17655,17700,17830,60,190,6500,"57,948.76",11958
,20161229,17700,17830,17855,17990,17570,17915,17705,85,-125,5976,"52,906.32",11344
,20161230,17915,17705,17890,17960,17005,17700,17720,-5,15,2148,"19,034.51",10270
pb1702,20160216,12820,12820,13400,13400,12975,12975,13145,155,325,12,78.88,10
,20160217,12975,13145,13055,13060,12830,12860,12950,-285,-195,22,142.50,22
,20160218,12860,12950,12845,12885,12705,12855,12810,-95,-140,28,179.37,32
,20160219,12855,12810,12900,13050,12900,13050,12975,240,165,4,25.95,32
,20160222,13050,12975,13070,13070,13040,13065,13060,90,85,8,52.24,30
,20160223,13065,13060,12890,12890,12890,12890,12890,-170,-170,2,12.89,30
,20160224,12890,12890,12865,12865,12830,12830,12845,-60,-45,4,25.70,32
,20160225,12830,12845,12920,12920,12835,12835,12890,-10,45,18,116.02,38
,20160226,12835,12890,12760,12760,12735,12740,12740,-150,-150,8,50.97,40
,20160229,12740,12740,12930,13070,12815,12815,12910,75,170,16,103.29,44
,20160301,12815,12910,12945,12945,12895,12895,12920,-15,10,4,25.84,46
,20160302,12895,12920,,,,13100,13100,180,180,0,0.00,46
,20160303,13100,13100,13060,13175,12990,13175,13085,75,-15,14,91.60,46
,20160304,13175,13085,13155,13195,13025,13170,13135,85,50,36,236.49,38
,20160307,13170,13135,13315,13445,13315,13445,13365,310,230,14,93.56,40
,20160308,13445,13365,,,,13450,13450,85,85,0,0.00,40
,20160309,13450,13450,13220,13220,13220,13220,13220,-230,-230,2,13.22,40
,20160310,13220,13220,13395,13510,13395,13510,13470,290,250,6,40.41,36
,20160311,13510,13470,,,,13470,13470,0,0,0,0.00,36
,20160314,13470,13470,,,,13470,13470,0,0,0,0.00,36
,20160315,13470,13470,,,,13470,13470,0,0,0,0.00,36
,20160316,13470,13470,13410,13410,13405,13405,13405,-65,-65,4,26.82,38
,20160317,13405,13405,13470,13485,13470,13485,13475,80,70,4,26.96,40
,20160318,13485,13475,13520,13575,13505,13575,13540,100,65,14,94.78,40
,20160321,13575,13540,13485,13485,13485,13485,13485,-55,-55,2,13.49,40
,20160322,13485,13485,13165,13450,13165,13450,13305,-35,-180,4,26.62,40
,20160323,13450,13305,,,,13305,13305,0,0,0,0.00,40
,20160324,13305,13305,13325,13325,13325,13325,13325,20,20,2,13.33,38
,20160325,13325,13325,13350,13350,13350,13350,13350,25,25,2,13.35,38
,20160328,13350,13350,,,,13370,13370,20,20,0,0.00,38
,20160329,13370,13370,,,,13460,13460,90,90,0,0.00,38
,20160330,13460,13460,13020,13020,13020,13020,13020,-440,-440,2,13.02,40
,20160331,13020,13020,13095,13125,13025,13085,13085,65,65,22,143.96,52
,20160401,13085,13085,13055,13165,13055,13130,13115,45,30,6,39.35,56
,20160405,13130,13115,,,,13095,13095,-20,-20,0,0.00,56
,20160406,13095,13095,13090,13090,13090,13090,13090,-5,-5,2,13.09,56
,20160407,13090,13090,,,,13090,13090,0,0,0,0.00,56
,20160408,13090,13090,13025,13025,12980,12980,13000,-110,-90,4,26.01,56
,20160411,12980,13000,13045,13085,13030,13030,13050,30,50,12,78.33,64
,20160412,13030,13050,13015,13015,12975,12975,12985,-75,-65,6,38.97,68
,20160413,12975,12985,13075,13305,13075,13230,13240,245,255,12,79.46,72
,20160414,13230,13240,13300,13300,13255,13255,13275,15,35,6,39.83,78
,20160415,13255,13275,13305,13305,13305,13305,13305,30,30,2,13.31,80
,20160418,13305,13305,13110,13110,13110,13110,13110,-195,-195,2,13.11,80
,20160419,13110,13110,13240,13325,13240,13260,13280,150,170,10,66.41,84
,20160420,13260,13280,13390,13390,13270,13270,13345,-10,65,50,333.73,104
,20160421,13270,13345,13410,13410,13390,13395,13395,50,50,6,40.20,108
,20160422,13395,13395,13480,13485,13190,13355,13395,-40,0,24,160.76,114
,20160425,13355,13395,13500,13500,13425,13425,13460,30,65,6,40.39,118
,20160426,13425,13460,13100,13100,13080,13080,13090,-380,-370,4,26.18,120
,20160427,13080,13090,13155,13185,13130,13185,13160,95,70,12,78.98,120
,20160428,13185,13160,13130,13130,13085,13085,13105,-75,-55,4,26.22,122
,20160429,13085,13105,13100,13205,13100,13205,13150,100,45,4,26.31,118
,20160503,13205,13150,13280,13340,13280,13330,13315,180,165,6,39.95,120
,20160504,13330,13315,13380,13380,13195,13195,13280,-120,-35,14,92.97,122
,20160505,13195,13280,13270,13270,13200,13200,13235,-80,-45,8,52.95,124
,20160506,13200,13235,13185,13185,12985,13000,13075,-235,-160,10,65.38,126
,20160509,13000,13075,,,,13075,13075,0,0,0,0.00,126
,20160510,13075,13075,,,,13075,13075,0,0,0,0.00,126
,20160511,13075,13075,13100,13110,13100,13110,13105,35,30,4,26.21,126
,20160512,13110,13105,13265,13265,13195,13195,13235,90,130,12,79.44,126
,20160513,13195,13235,13185,13185,12945,12945,13005,-290,-230,8,52.02,128
,20160516,12945,13005,,,,12990,12990,-15,-15,0,0.00,128
,20160517,12990,12990,13030,13100,13005,13005,13030,15,40,20,130.30,128
,20160518,13005,13030,12960,12960,12960,12960,12960,-70,-70,2,12.96,126
,20160519,12960,12960,12795,12795,12795,12795,12795,-165,-165,2,12.80,128
,20160520,12795,12795,,,,12810,12810,15,15,0,0.00,128
,20160523,12810,12810,12865,12875,12860,12875,12865,65,55,16,102.95,140
,20160524,12875,12865,,,,12795,12795,-70,-70,0,0.00,140
,20160525,12795,12795,12930,12930,12930,12930,12930,135,135,4,25.86,140
,20160526,12930,12930,12780,12900,12780,12800,12825,-130,-105,6,38.48,136
,20160527,12800,12825,,,,12870,12870,45,45,0,0.00,136
,20160530,12870,12870,,,,12910,12910,40,40,0,0.00,136
,20160531,12910,12910,,,,12925,12925,15,15,0,0.00,136
,20160601,12925,12925,,,,12945,12945,20,20,0,0.00,136
,20160602,12945,12945,,,,13010,13010,65,65,0,0.00,136
,20160603,13010,13010,,,,13010,13010,0,0,0,0.00,136
,20160606,13010,13010,,,,12910,12910,-100,-100,0,0.00,136
,20160607,12910,12910,12875,12925,12875,12925,12905,15,-5,6,38.72,134
,20160608,12925,12905,,,,12905,12905,0,0,0,0.00,134
,20160613,12905,12905,,,,12955,12955,50,50,0,0.00,134
,20160614,12955,12955,,,,12890,12890,-65,-65,0,0.00,134
,20160615,12890,12890,,,,12915,12915,25,25,0,0.00,134
,20160616,12915,12915,,,,12915,12915,0,0,0,0.00,134
,20160617,12915,12915,,,,12940,12940,25,25,0,0.00,134
,20160620,12940,12940,,,,12940,12940,0,0,0,0.00,134
,20160621,12940,12940,,,,12960,12960,20,20,0,0.00,134
,20160622,12960,12960,,,,12945,12945,-15,-15,0,0.00,134
,20160623,12945,12945,,,,12905,12905,-40,-40,0,0.00,134
,20160624,12905,12905,,,,12925,12925,20,20,0,0.00,134
,20160627,12925,12925,12965,13010,12965,13010,12990,85,65,6,38.98,128
,20160628,13010,12990,,,,13040,13040,50,50,0,0.00,128
,20160629,13040,13040,13155,13155,13040,13150,13125,110,85,12,78.77,126
,20160630,13150,13125,13180,13300,13180,13205,13230,80,105,20,132.32,120
,20160701,13205,13230,13370,13410,13350,13360,13370,130,140,8,53.49,120
,20160704,13360,13370,13630,13900,13630,13895,13810,525,440,16,110.49,124
,20160705,13895,13810,,,,13735,13735,-75,-75,0,0.00,124
,20160706,13735,13735,13400,13400,13235,13255,13280,-480,-455,14,92.98,136
,20160707,13255,13280,13250,13250,13250,13250,13250,-30,-30,2,13.25,134
,20160708,13250,13250,,,,13190,13190,-60,-60,0,0.00,134
,20160711,13190,13190,,,,13190,13190,0,0,0,0.00,134
,20160712,13190,13190,,,,13190,13190,0,0,0,0.00,134
,20160713,13190,13190,13450,13625,13350,13350,13460,160,270,10,67.30,130
,20160714,13350,13460,13355,13355,13355,13355,13355,-105,-105,2,13.36,128
,20160715,13355,13355,13515,13515,13515,13515,13515,160,160,2,13.52,128
,20160718,13515,13515,,,,13515,13515,0,0,0,0.00,128
,20160719,13515,13515,13550,13550,13550,13550,13550,35,35,2,13.55,126
,20160720,13550,13550,13500,13505,13500,13505,13500,-45,-50,6,40.51,122
,20160721,13505,13500,13565,13565,13555,13555,13560,55,60,6,40.69,116
,20160722,13555,13560,13600,13600,13600,13600,13600,40,40,2,13.60,114
,20160725,13600,13600,13555,13755,13505,13755,13640,155,40,8,54.57,112
,20160726,13755,13640,13775,13895,13775,13895,13825,255,185,18,124.46,110
,20160727,13895,13825,14015,14015,13990,14010,14000,185,175,10,70.02,114
,20160728,14010,14000,13930,13935,13825,13845,13860,-155,-140,32,221.81,118
,20160729,13845,13860,13850,13850,13850,13850,13850,-10,-10,2,13.85,116
,20160801,13850,13850,14100,14100,14100,14100,14100,250,250,2,14.10,114
,20160802,14100,14100,14095,14095,14035,14035,14065,-65,-35,4,28.13,112
,20160803,14035,14065,13970,13970,13970,13970,13970,-95,-95,2,13.97,114
,20160804,13970,13970,14005,14040,13975,14040,14000,70,30,10,70.01,114
,20160805,14040,14000,13945,13945,13945,13945,13945,-55,-55,2,13.95,116
,20160808,13945,13945,14090,14090,14070,14070,14080,125,135,4,28.16,116
,20160809,14070,14080,,,,14105,14105,25,25,0,0.00,116
,20160810,14105,14105,,,,13940,13940,-165,-165,0,0.00,116
,20160811,13940,13940,13965,13965,13965,13965,13965,25,25,4,27.93,114
,20160812,13965,13965,13960,13960,13920,13920,13935,-45,-30,12,83.62,118
,20160815,13920,13935,13940,13945,13770,13770,13910,-165,-25,24,166.92,106
,20160816,13770,13910,13735,13735,13735,13735,13735,-175,-175,2,13.74,108
,20160817,13735,13735,13770,13770,13770,13770,13770,35,35,2,13.77,110
,20160818,13770,13770,,,,13960,13960,190,190,0,0.00,110
,20160819,13960,13960,13965,14065,13965,14065,13995,105,35,16,111.97,102
,20160822,14065,13995,,,,14010,14010,15,15,0,0.00,102
,20160823,14010,14010,,,,13955,13955,-55,-55,0,0.00,102
,20160824,13955,13955,,,,14025,14025,70,70,0,0.00,102
,20160825,14025,14025,13935,14005,13935,14005,13970,-20,-55,4,27.94,102
,20160826,14005,13970,13970,13970,13870,13870,13920,-100,-50,4,27.84,102
,20160829,13870,13920,14025,14025,14025,14025,14025,105,105,2,14.03,100
,20160830,14025,14025,13940,13940,13900,13925,13920,-100,-105,8,55.69,94
,20160831,13925,13920,13980,13980,13975,13975,13975,55,55,10,69.89,96
,20160901,13975,13975,,,,14370,14370,395,395,0,0.00,96
,20160902,14370,14370,14910,14910,14905,14905,14905,535,535,8,59.63,90
,20160905,14905,14905,14585,14630,14440,14535,14555,-370,-350,30,218.34,86
,20160906,14535,14555,,,,14590,14590,35,35,0,0.00,86
,20160907,14590,14590,,,,14330,14330,-260,-260,0,0.00,86
,20160908,14330,14330,,,,14275,14275,-55,-55,0,0.00,86
,20160909,14275,14275,,,,14275,14275,0,0,0,0.00,86
,20160912,14275,14275,,,,14100,14100,-175,-175,0,0.00,86
,20160913,14100,14100,,,,14085,14085,-15,-15,0,0.00,86
,20160914,14085,14085,,,,14115,14115,30,30,0,0.00,86
,20160919,14115,14115,,,,14280,14280,165,165,0,0.00,86
,20160920,14280,14280,,,,14490,14490,210,210,0,0.00,86
,20160921,14490,14490,14600,14740,14600,14740,14675,250,185,10,73.39,84
,20160922,14740,14675,14560,14610,14455,14570,14525,-105,-150,102,740.99,126
,20160923,14570,14525,14700,14735,14520,14520,14645,-5,120,30,219.75,118
,20160926,14520,14645,,,,14480,14480,-165,-165,0,0.00,118
,20160927,14480,14480,14640,14800,14640,14800,14725,320,245,10,73.63,122
,20160928,14800,14725,14750,14750,14640,14640,14665,-85,-60,18,132.01,118
,20160929,14640,14665,14825,15010,14825,15010,14900,345,235,8,59.62,124
,20160930,15010,14900,15090,15200,15090,15200,15145,300,245,12,90.89,130
,20161010,15200,15145,15420,15575,15420,15575,15470,430,325,6,46.42,130
,20161011,15575,15470,15520,15700,15510,15700,15580,230,110,48,374.01,166
,20161012,15700,15580,15555,15555,15400,15420,15440,-160,-140,58,447.89,170
,20161013,15420,15440,15500,15500,15200,15200,15315,-240,-125,30,229.75,186
,20161014,15200,15315,15110,15195,15110,15150,15140,-165,-175,38,287.69,220
,20161017,15150,15140,15350,15355,15260,15355,15290,215,150,30,229.37,202
,20161018,15355,15290,15280,15475,15280,15475,15305,185,15,16,122.46,212
,20161019,15475,15305,15395,15395,15245,15280,15290,-25,-15,62,474.10,268
,20161020,15280,15290,15380,15470,15210,15410,15360,120,70,78,599.19,266
,20161021,15410,15360,15365,15645,15345,15645,15425,285,65,180,"1,388.39",302
,20161024,15645,15425,15550,15665,15520,15590,15545,165,120,262,"2,036.57",424
,20161025,15590,15545,15660,16165,15660,16165,16055,620,510,222,"1,782.65",566
,20161026,16165,16055,16390,16450,16050,16150,16170,95,115,312,"2,522.77",696
,20161027,16150,16170,16290,16430,16165,16285,16265,115,95,330,"2,684.21",774
,20161028,16285,16265,16270,16420,16210,16325,16285,60,20,836,"6,807.66",1140
,20161031,16325,16285,16445,16500,16295,16380,16380,95,95,560,"4,587.42",1322
,20161101,16380,16380,16420,16855,16385,16580,16660,200,280,816,"6,797.58",1506
,20161102,16580,16660,16580,16630,16275,16355,16490,-305,-170,1512,"12,469.76",2524
,20161103,16355,16490,16365,16625,16325,16625,16465,135,-25,988,"8,135.68",3130
,20161104,16625,16465,16610,16710,16560,16640,16645,175,180,690,"5,743.72",3532
,20161107,16640,16645,16600,17055,16600,17010,16840,365,195,1046,"8,807.66",3762
,20161108,17010,16840,16920,17080,16660,16740,16845,-100,5,3558,"29,972.80",5102
,20161109,16740,16845,16715,17050,16590,16705,16775,-140,-70,2682,"22,495.70",5936
,20161110,16705,16775,16900,17445,16845,17435,17215,660,440,1372,"11,811.85",5956
,20161111,17435,17215,17445,17495,17110,17440,17300,225,85,1796,"15,536.14",6858
,20161114,17440,17300,17365,18330,16940,17690,17615,390,315,4134,"36,418.93",8328
,20161115,17690,17615,17700,18595,17650,17880,18010,265,395,2712,"24,423.50",8860
,20161116,17880,18010,17800,18570,17725,18295,18265,285,255,1854,"16,933.85",9310
,20161117,18295,18265,18245,18330,17400,17765,17980,-500,-285,3590,"32,275.42",10680
,20161118,17765,17980,17860,17950,17590,17835,17755,-145,-225,1530,"13,584.34",11018
,20161121,17835,17755,17885,18320,17665,18210,18040,455,285,3830,"34,547.13",12040
,20161122,18210,18040,18220,19030,18055,18995,18620,955,580,8466,"78,836.48",14982
,20161123,18995,18620,18900,19105,18700,18980,18915,360,295,6818,"64,494.46",16910
,20161124,18980,18915,18855,19900,18855,19640,19475,725,560,12230,"119,116.54",16406
,20161125,19640,19475,19660,20200,19320,19800,19775,325,300,8524,"84,296.04",17344
,20161128,19800,19775,20200,21155,19830,21155,20625,1380,850,12514,"129,079.77",18426
,20161129,21155,20625,21165,22560,21165,21605,21875,980,1250,40122,"438,919.10",24550
,20161130,21605,21875,21995,21995,20340,20445,21070,-1430,-805,51284,"540,396.81",26596
,20161201,20445,21070,20400,21260,20225,20915,20705,-155,-365,51568,"533,894.45",30594
,20161202,20915,20705,21000,21105,19710,20070,20350,-635,-355,41734,"424,661.81",32040
,20161205,20070,20350,19980,20265,19420,19985,19880,-365,-470,47882,"475,986.97",33984
,20161206,19985,19880,20055,20495,19960,20095,20200,215,320,52418,"529,511.03",33832
,20161207,20095,20200,20155,21040,20015,20865,20700,665,500,83720,"866,587.24",39150
,20161208,20865,20700,20995,21460,20515,20775,20935,75,235,73786,"772,456.39",41774
,20161209,20775,20935,20910,21080,20210,20465,20570,-470,-365,68890,"708,580.72",43158
,20161212,20465,20570,20520,20960,20180,20440,20600,-130,30,79984,"823,889.08",42022
,20161213,20440,20600,20465,20820,20300,20545,20585,-55,-15,82576,"849,972.02",45014
,20161214,20545,20585,20785,20815,20315,20490,20485,-95,-100,81722,"837,090.22",45052
,20161215,20490,20485,20600,20950,20250,20745,20590,260,105,95834,"986,828.10",47536
,20161216,20745,20590,20400,20495,19830,19830,20175,-760,-415,101882,"1,027,972.84",45944
,20161219,19830,20175,19680,19755,18760,18760,19170,-1415,-1005,127320,"1,220,369.43",47190
,20161220,18760,19170,18590,18600,17665,18055,18020,-1115,-1150,192852,"1,737,630.88",45364
,20161221,18055,18020,18220,18665,18110,18405,18390,385,370,158664,"1,458,947.00",45686
,20161222,18405,18390,18380,18425,18010,18070,18180,-320,-210,123138,"1,119,487.71",45620
,20161223,18070,18180,17820,18560,17780,18260,18295,80,115,170122,"1,556,384.06",45196
,20161226,18260,18295,18155,18450,17070,17385,17820,-910,-475,168806,"1,504,291.82",42732
,20161227,17385,17820,17400,17705,17260,17655,17470,-165,-350,116832,"1,020,779.72",43752
,20161228,17655,17470,17700,18135,17505,17590,17785,120,315,134648,"1,197,431.51",42906
,20161229,17590,17785,17745,17930,17430,17775,17685,-10,-100,122276,"1,081,477.63",41884
,20161230,17775,17685,17690,17825,17310,17665,17555,-20,-130,116398,"1,021,878.66",41214
pb1703,20160316,13470,13470,,,,13405,13405,-65,-65,0,0.00,0
,20160317,13405,13405,,,,13475,13475,70,70,0,0.00,0
,20160318,13475,13475,,,,13540,13540,65,65,0,0.00,0
,20160321,13540,13540,,,,13485,13485,-55,-55,0,0.00,0
,20160322,13485,13485,,,,13305,13305,-180,-180,0,0.00,0
,20160323,13305,13305,,,,13310,13310,5,5,0,0.00,0
,20160324,13310,13310,,,,13330,13330,20,20,0,0.00,0
,20160325,13330,13330,,,,13355,13355,25,25,0,0.00,0
,20160328,13355,13355,13295,13295,13295,13295,13295,-60,-60,8,53.18,8
,20160329,13295,13295,13270,13270,13270,13270,13270,-25,-25,6,39.81,14
,20160330,13270,13270,13245,13310,13175,13175,13230,-95,-40,10,66.17,18
,20160331,13175,13230,,,,13295,13295,65,65,0,0.00,18
,20160401,13295,13295,13185,13185,13185,13185,13185,-110,-110,2,13.19,20
,20160405,13185,13185,13080,13080,13080,13080,13080,-105,-105,2,13.08,22
,20160406,13080,13080,12965,12965,12965,12965,12965,-115,-115,2,12.97,22
,20160407,12965,12965,13045,13085,13015,13055,13050,90,85,8,52.20,24
,20160408,13055,13050,,,,13050,13050,0,0,0,0.00,24
,20160411,13050,13050,13000,13035,13000,13035,13015,-15,-35,4,26.04,22
,20160412,13035,13015,12945,12945,12945,12945,12945,-70,-70,2,12.95,24
,20160413,12945,12945,13060,13260,13060,13260,13180,315,235,6,39.55,26
,20160414,13260,13180,,,,13215,13215,35,35,0,0.00,26
,20160415,13215,13215,13200,13200,13200,13200,13200,-15,-15,2,13.20,26
,20160418,13200,13200,13265,13265,13265,13265,13265,65,65,2,13.27,28
,20160419,13265,13265,13260,13260,13260,13260,13260,-5,-5,4,26.52,28
,20160420,13260,13260,13310,13340,13240,13240,13285,-20,25,20,132.88,44
,20160421,13240,13285,13345,13345,13345,13345,13345,60,60,2,13.35,44
,20160422,13345,13345,13420,13420,13280,13280,13325,-65,-20,12,79.96,42
,20160425,13280,13325,,,,13390,13390,65,65,0,0.00,42
,20160426,13390,13390,,,,13390,13390,0,0,0,0.00,42
,20160427,13390,13390,13095,13150,13095,13150,13115,-240,-275,6,39.36,48
,20160428,13150,13115,,,,13060,13060,-55,-55,0,0.00,48
,20160429,13060,13060,,,,13100,13100,40,40,0,0.00,48
,20160503,13100,13100,13250,13250,13250,13250,13250,150,150,2,13.25,48
,20160504,13250,13250,,,,13250,13250,0,0,0,0.00,48
,20160505,13250,13250,13215,13215,13150,13150,13185,-100,-65,10,65.94,50
,20160506,13150,13185,13050,13050,13000,13000,13030,-185,-155,10,65.16,52
,20160509,13000,13030,12990,12990,12990,12990,12990,-40,-40,2,12.99,50
,20160510,12990,12990,13065,13065,13065,13065,13065,75,75,2,13.07,50
,20160511,13065,13065,,,,13090,13090,25,25,0,0.00,50
,20160512,13090,13090,13205,13300,13200,13245,13240,155,150,22,145.66,50
,20160513,13245,13240,12990,13045,12990,13005,13020,-235,-220,8,52.08,44
,20160516,13005,13020,12880,13045,12880,13045,12980,25,-40,6,38.94,46
,20160517,13045,12980,12935,13030,12935,13030,12965,50,-15,6,38.90,46
,20160518,13030,12965,12975,12975,12975,12975,12975,10,10,4,25.95,48
,20160519,12975,12975,12825,12825,12825,12825,12825,-150,-150,2,12.83,48
,20160520,12825,12825,,,,12840,12840,15,15,0,0.00,48
,20160523,12840,12840,,,,12840,12840,0,0,0,0.00,48
,20160524,12840,12840,12735,12825,12735,12825,12765,-15,-75,6,38.30,50
,20160525,12825,12765,12875,12970,12875,12875,12920,110,155,44,284.25,78
,20160526,12875,12920,12815,12915,12815,12915,12865,-5,-55,4,25.73,80
,20160527,12915,12865,,,,12910,12910,45,45,0,0.00,80
,20160530,12910,12910,,,,12950,12950,40,40,0,0.00,80
,20160531,12950,12950,,,,12970,12970,20,20,0,0.00,80
,20160601,12970,12970,,,,12970,12970,0,0,0,0.00,80
,20160602,12970,12970,,,,13035,13035,65,65,0,0.00,80
,20160603,13035,13035,,,,13075,13075,40,40,0,0.00,80
,20160606,13075,13075,,,,12975,12975,-100,-100,0,0.00,80
,20160607,12975,12975,,,,12970,12970,-5,-5,0,0.00,80
,20160608,12970,12970,,,,12975,12975,5,5,0,0.00,80
,20160613,12975,12975,,,,13025,13025,50,50,0,0.00,80
,20160614,13025,13025,,,,13025,13025,0,0,0,0.00,80
,20160615,13025,13025,,,,13050,13050,25,25,0,0.00,80
,20160616,13050,13050,,,,13090,13090,40,40,0,0.00,80
,20160617,13090,13090,,,,13115,13115,25,25,0,0.00,80
,20160620,13115,13115,,,,13140,13140,25,25,0,0.00,80
,20160621,13140,13140,,,,13160,13160,20,20,0,0.00,80
,20160622,13160,13160,,,,13145,13145,-15,-15,0,0.00,80
,20160623,13145,13145,,,,13135,13135,-10,-10,0,0.00,80
,20160624,13135,13135,13060,13060,13060,13060,13060,-75,-75,2,13.06,80
,20160627,13060,13060,,,,13125,13125,65,65,0,0.00,80
,20160628,13125,13125,,,,13175,13175,50,50,0,0.00,80
,20160629,13175,13175,,,,13260,13260,85,85,0,0.00,80
,20160630,13260,13260,13210,13285,13205,13265,13240,5,-20,16,105.94,78
,20160701,13265,13240,13395,13435,13320,13320,13380,80,140,6,40.15,78
,20160704,13320,13380,13765,13905,13765,13770,13810,390,430,6,41.44,76
,20160705,13770,13810,13265,13585,13255,13585,13420,-225,-390,16,107.38,76
,20160706,13585,13420,13310,13315,13260,13295,13270,-125,-150,60,398.24,80
,20160707,13295,13270,13260,13340,13225,13340,13275,70,5,6,39.83,82
,20160708,13340,13275,,,,13215,13215,-60,-60,0,0.00,82
,20160711,13215,13215,13245,13245,13245,13245,13245,30,30,6,39.74,76
,20160712,13245,13245,,,,13330,13330,85,85,0,0.00,76
,20160713,13330,13330,,,,13600,13600,270,270,0,0.00,76
,20160714,13600,13600,,,,13600,13600,0,0,0,0.00,76
,20160715,13600,13600,,,,13760,13760,160,160,0,0.00,76
,20160718,13760,13760,,,,13760,13760,0,0,0,0.00,76
,20160719,13760,13760,,,,13795,13795,35,35,0,0.00,76
,20160720,13795,13795,,,,13795,13795,0,0,0,0.00,76
,20160721,13795,13795,13580,13580,13580,13580,13580,-215,-215,6,40.74,70
,20160722,13580,13580,13725,13725,13725,13725,13725,145,145,2,13.73,70
,20160725,13725,13725,,,,13825,13825,100,100,0,0.00,70
,20160726,13825,13825,13980,13980,13980,13980,13980,155,155,2,13.98,70
,20160727,13980,13980,,,,14155,14155,175,175,0,0.00,70
,20160728,14155,14155,,,,14155,14155,0,0,0,0.00,70
,20160729,14155,14155,14005,14005,14005,14005,14005,-150,-150,2,14.01,70
,20160801,14005,14005,14120,14280,14120,14280,14200,275,195,4,28.40,66
,20160802,14280,14200,,,,14160,14160,-40,-40,0,0.00,66
,20160803,14160,14160,,,,14160,14160,0,0,0,0.00,66
,20160804,14160,14160,,,,14160,14160,0,0,0,0.00,66
,20160805,14160,14160,,,,14100,14100,-60,-60,0,0.00,66
,20160808,14100,14100,14135,14135,14065,14065,14100,-35,0,6,42.31,66
,20160809,14065,14100,,,,14125,14125,25,25,0,0.00,66
,20160810,14125,14125,,,,13960,13960,-165,-165,0,0.00,66
,20160811,13960,13960,,,,13985,13985,25,25,0,0.00,66
,20160812,13985,13985,13965,13965,13955,13955,13960,-30,-25,4,27.92,64
,20160815,13955,13960,,,,13930,13930,-30,-30,0,0.00,64
,20160816,13930,13930,13765,13765,13765,13765,13765,-165,-165,2,13.77,64
,20160817,13765,13765,,,,13800,13800,35,35,0,0.00,64
,20160818,13800,13800,,,,13990,13990,190,190,0,0.00,64
,20160819,13990,13990,14040,14080,13980,14080,14005,90,15,34,238.14,68
,20160822,14080,14005,14035,14035,14035,14035,14035,30,30,2,14.04,66
,20160823,14035,14035,,,,13980,13980,-55,-55,0,0.00,66
,20160824,13980,13980,,,,14050,14050,70,70,0,0.00,66
,20160825,14050,14050,14115,14115,14075,14075,14095,25,45,4,28.19,64
,20160826,14075,14095,,,,14040,14040,-55,-55,0,0.00,64
,20160829,14040,14040,13975,13975,13975,13975,13975,-65,-65,2,13.98,66
,20160830,13975,13975,13970,13970,13970,13970,13970,-5,-5,2,13.97,66
,20160831,13970,13970,,,,14025,14025,55,55,0,0.00,66
,20160901,14025,14025,14500,14500,14500,14500,14500,475,475,2,14.50,66
,20160902,14500,14500,14560,14830,14505,14630,14670,130,170,14,102.72,76
,20160905,14630,14670,14620,14665,14465,14665,14565,-5,-105,10,72.84,70
,20160906,14665,14565,,,,14565,14565,0,0,0,0.00,70
,20160907,14565,14565,14385,14415,14380,14380,14390,-185,-175,10,71.95,68
,20160908,14380,14390,,,,14390,14390,0,0,0,0.00,68
,20160909,14390,14390,,,,14390,14390,0,0,0,0.00,68
,20160912,14390,14390,,,,14390,14390,0,0,0,0.00,68
,20160913,14390,14390,,,,14375,14375,-15,-15,0,0.00,68
,20160914,14375,14375,,,,14405,14405,30,30,0,0.00,68
,20160919,14405,14405,,,,14575,14575,170,170,0,0.00,68
,20160920,14575,14575,,,,14790,14790,215,215,0,0.00,68
,20160921,14790,14790,14700,14700,14700,14700,14700,-90,-90,2,14.70,66
,20160922,14700,14700,14640,14680,14535,14535,14600,-165,-100,48,350.46,70
,20160923,14535,14600,14700,14700,14525,14525,14610,-75,10,4,29.23,74
,20160926,14525,14610,,,,14610,14610,0,0,0,0.00,74
,20160927,14610,14610,14820,14820,14820,14820,14820,210,210,2,14.82,74
,20160928,14820,14820,14740,14740,14620,14660,14690,-160,-130,8,58.76,76
,20160929,14660,14690,14765,14880,14765,14880,14820,190,130,4,29.65,76
,20160930,14880,14820,15090,15120,15005,15115,15055,295,235,14,105.39,74
,20161010,15115,15055,15345,15470,15235,15470,15320,415,265,28,214.49,86
,20161011,15470,15320,15465,15550,15330,15535,15470,215,150,46,355.91,98
,20161012,15535,15470,15555,15555,15375,15460,15480,-10,10,14,108.37,92
,20161013,15460,15480,15410,15410,15315,15400,15355,-80,-125,52,399.24,102
,20161014,15400,15355,15225,15225,15225,15225,15225,-130,-130,2,15.23,104
,20161017,15225,15225,15260,15260,15260,15260,15260,35,35,8,61.04,96
,20161018,15260,15260,15220,15360,15220,15360,15290,100,30,4,30.58,94
,20161019,15360,15290,15305,15305,15220,15220,15280,-70,-10,22,168.11,102
,20161020,15220,15280,15380,15380,15380,15380,15380,100,100,6,46.14,100
,20161021,15380,15380,15400,15540,15380,15500,15455,120,75,14,108.21,100
,20161024,15500,15455,15500,15555,15500,15555,15520,100,65,20,155.23,108
,20161025,15555,15520,15865,16135,15865,16135,15990,615,470,26,207.90,116
,20161026,16135,15990,16205,16205,16025,16105,16095,115,105,30,241.50,124
,20161027,16105,16095,16260,16335,16185,16295,16265,200,170,10,81.35,120
,20161028,16295,16265,,,,16265,16265,0,0,0,0.00,120
,20161031,16265,16265,,,,16265,16265,0,0,0,0.00,120
,20161101,16265,16265,16385,16620,16340,16615,16440,350,175,44,361.73,132
,20161102,16615,16440,16500,16545,16260,16390,16370,-50,-70,376,"3,078.10",218
,20161103,16390,16370,16325,16455,16325,16450,16380,80,10,44,360.45,190
,20161104,16450,16380,16575,16650,16575,16600,16620,220,240,54,448.78,194
,20161107,16600,16620,16550,17025,16550,16945,16845,325,225,114,960.28,214
,20161108,16945,16845,17100,17100,16655,16790,16795,-55,-50,72,604.76,232
,20161109,16790,16795,16770,17000,16625,16690,16750,-105,-45,130,"1,088.84",284
,20161110,16690,16750,16865,17420,16710,17420,17285,670,535,312,"2,696.48",292
,20161111,17420,17285,17405,17735,17170,17515,17330,230,45,392,"3,397.26",448
,20161114,17515,17330,17485,18365,17030,17700,17755,370,425,366,"3,249.81",520
,20161115,17700,17755,17850,18590,17710,17745,18130,-10,375,218,"1,976.71",590
,20161116,17745,18130,17935,18560,17935,18175,18375,45,245,194,"1,782.58",630
,20161117,18175,18375,18315,18315,17455,17780,17920,-595,-455,694,"6,219.69",696
,20161118,17780,17920,17835,17955,17580,17855,17720,-65,-200,784,"6,947.48",1078
,20161121,17855,17720,17870,18325,17680,18210,18070,490,350,966,"8,728.14",1554
,20161122,18210,18070,18235,19000,18095,18905,18735,835,665,2152,"20,162.33",3270
,20161123,18905,18735,18855,19010,18680,18840,18885,105,150,2110,"19,927.00",4664
,20161124,18840,18885,18825,20005,18750,19500,19435,615,550,4620,"44,900.58",6690
,20161125,19500,19435,19445,20060,19150,19595,19620,160,185,1748,"17,150.37",7456
,20161128,19595,19620,20200,20990,19630,20990,20420,1370,800,1768,"18,053.33",7854
,20161129,20990,20420,21265,22295,21135,21455,21710,1035,1290,9986,"108,401.45",11808
,20161130,21455,21710,21760,21830,20190,20315,20995,-1395,-715,10400,"109,189.02",13398
,20161201,20315,20995,20495,21115,20150,20805,20615,-190,-380,6286,"64,804.75",14096
,20161202,20805,20615,20885,20885,19610,19940,20150,-675,-465,4522,"45,560.84",14744
,20161205,19940,20150,19810,20475,19330,19895,19780,-255,-370,6216,"61,490.30",15654
,20161206,19895,19780,19970,20340,19840,19950,20055,170,275,5286,"53,010.75",16158
,20161207,19950,20055,20095,20900,19865,20670,20530,615,475,8434,"86,581.12",16724
,20161208,20670,20530,20795,21230,20305,20540,20720,10,190,5082,"52,657.64",17014
,20161209,20540,20720,20675,20855,20000,20230,20330,-490,-390,4078,"41,459.37",17138
,20161212,20230,20330,20365,20765,20000,20200,20445,-130,115,5334,"54,534.04",17616
,20161213,20200,20445,20260,20600,20150,20280,20370,-165,-75,4374,"44,550.72",17978
,20161214,20280,20370,20500,20635,20130,20285,20305,-85,-65,3084,"31,315.66",18074
,20161215,20285,20305,20380,20780,20075,20735,20535,430,230,6250,"64,173.34",18786
,20161216,20735,20535,20490,20490,19795,19795,20115,-740,-420,5952,"59,867.20",19458
,20161219,19795,20115,19510,19680,18705,18705,19050,-1410,-1065,8512,"81,096.13",19828
,20161220,18705,19050,18475,18570,17410,17970,17825,-1080,-1225,18224,"162,457.22",18716
,20161221,17970,17825,18130,18595,18070,18335,18320,510,495,9548,"87,461.91",18292
,20161222,18335,18320,18315,18340,17850,17950,18055,-370,-265,8642,"78,020.71",19330
,20161223,17950,18055,17720,18425,17645,18110,18155,55,100,11348,"103,038.85",19624
,20161226,18110,18155,17995,18320,16935,17270,17530,-885,-625,16478,"144,455.83",18890
,20161227,17270,17530,17300,17590,17190,17545,17385,15,-145,13162,"114,439.65",19740
,20161228,17545,17385,17510,18070,17375,17510,17695,125,310,15392,"136,211.82",20790
,20161229,17510,17695,17650,18100,17365,17660,17605,-35,-90,11990,"105,547.60",20808
,20161230,17660,17605,17590,17675,16375,17565,17455,-40,-150,15434,"134,705.62",21296
pb1704,20160418,13200,13200,,,,13265,13265,65,65,0,0.00,0
,20160419,13265,13265,,,,13260,13260,-5,-5,0,0.00,0
,20160420,13260,13260,13375,13375,12975,13305,13240,45,-20,14,92.69,2
,20160421,13305,13240,,,,13295,13295,55,55,0,0.00,2
,20160422,13295,13295,,,,13275,13275,-20,-20,0,0.00,2
,20160425,13275,13275,,,,13340,13340,65,65,0,0.00,2
,20160426,13340,13340,13100,13100,13100,13100,13100,-240,-240,2,13.10,4
,20160427,13100,13100,13150,13150,13150,13150,13150,50,50,2,13.15,4
,20160428,13150,13150,,,,13095,13095,-55,-55,0,0.00,4
,20160429,13095,13095,,,,13140,13140,45,45,0,0.00,4
,20160503,13140,13140,,,,13290,13290,150,150,0,0.00,4
,20160504,13290,13290,13260,13260,13260,13260,13260,-30,-30,2,13.26,6
,20160505,13260,13260,13170,13245,13170,13245,13205,-15,-55,4,26.42,6
,20160506,13245,13205,,,,13050,13050,-155,-155,0,0.00,6
,20160509,13050,13050,,,,13005,13005,-45,-45,0,0.00,6
,20160510,13005,13005,12965,12965,12965,12965,12965,-40,-40,2,12.97,8
,20160511,12965,12965,13475,13475,13475,13475,13475,510,510,2,13.48,8
,20160512,13475,13475,13265,13520,13255,13295,13350,-180,-125,158,"1,054.97",90
,20160513,13295,13350,13170,13170,12815,13030,12850,-320,-500,110,706.96,40
,20160516,13030,12850,13020,13025,13020,13020,13020,170,170,10,65.11,42
,20160517,13020,13020,,,,13020,13020,0,0,0,0.00,42
,20160518,13020,13020,,,,13020,13020,0,0,0,0.00,42
,20160519,13020,13020,,,,13020,13020,0,0,0,0.00,42
,20160520,13020,13020,,,,13035,13035,15,15,0,0.00,42
,20160523,13035,13035,12935,12935,12840,12840,12880,-195,-155,6,38.65,44
,20160524,12840,12880,12725,13035,12725,12900,12905,20,25,74,477.62,74
,20160525,12900,12905,12945,12995,12920,12935,12965,30,60,38,246.39,94
,20160526,12935,12965,12865,12935,12865,12935,12895,-30,-70,10,64.48,92
,20160527,12935,12895,12980,13075,12980,13075,12995,180,100,10,65.00,94
,20160530,13075,12995,,,,12995,12995,0,0,0,0.00,94
,20160531,12995,12995,,,,13015,13015,20,20,0,0.00,94
,20160601,13015,13015,,,,13035,13035,20,20,0,0.00,94
,20160602,13035,13035,,,,13100,13100,65,65,0,0.00,94
,20160603,13100,13100,,,,13100,13100,0,0,0,0.00,94
,20160606,13100,13100,,,,13000,13000,-100,-100,0,0.00,94
,20160607,13000,13000,,,,12995,12995,-5,-5,0,0.00,94
,20160608,12995,12995,,,,13000,13000,5,5,0,0.00,94
,20160613,13000,13000,13045,13045,13045,13045,13045,45,45,6,39.14,96
,20160614,13045,13045,,,,12980,12980,-65,-65,0,0.00,96
,20160615,12980,12980,,,,12980,12980,0,0,0,0.00,96
,20160616,12980,12980,,,,12980,12980,0,0,0,0.00,96
,20160617,12980,12980,,,,12980,12980,0,0,0,0.00,96
,20160620,12980,12980,,,,12980,12980,0,0,0,0.00,96
,20160621,12980,12980,,,,13000,13000,20,20,0,0.00,96
,20160622,13000,13000,,,,12985,12985,-15,-15,0,0.00,96
,20160623,12985,12985,13060,13060,13060,13060,13060,75,75,8,52.24,104
,20160624,13060,13060,,,,12985,12985,-75,-75,0,0.00,104
,20160627,12985,12985,,,,12985,12985,0,0,0,0.00,104
,20160628,12985,12985,,,,12985,12985,0,0,0,0.00,104
,20160629,12985,12985,,,,13070,13070,85,85,0,0.00,104
,20160630,13070,13070,13230,13230,13230,13230,13230,160,160,4,26.46,104
,20160701,13230,13230,13505,13505,13505,13505,13505,275,275,2,13.51,106
,20160704,13505,13505,13740,13800,13740,13800,13770,295,265,4,27.54,110
,20160705,13800,13770,13570,13570,13435,13435,13500,-335,-270,4,27.01,114
,20160706,13435,13500,13390,13425,13195,13425,13310,-75,-190,106,705.65,102
,20160707,13425,13310,13360,13360,13210,13210,13270,-100,-40,20,132.70,98
,20160708,13210,13270,13250,13255,13250,13250,13250,-20,-20,12,79.51,102
,20160711,13250,13250,13280,13280,13280,13280,13280,30,30,2,13.28,104
,20160712,13280,13280,,,,13280,13280,0,0,0,0.00,104
,20160713,13280,13280,,,,13280,13280,0,0,0,0.00,104
,20160714,13280,13280,13500,13560,13500,13560,13530,280,250,4,27.06,104
,20160715,13560,13530,,,,13530,13530,0,0,0,0.00,104
,20160718,13530,13530,13670,13670,13670,13670,13670,140,140,8,54.68,106
,20160719,13670,13670,,,,13670,13670,0,0,0,0.00,106
,20160720,13670,13670,,,,13620,13620,-50,-50,0,0.00,106
,20160721,13620,13620,13535,13535,13535,13535,13535,-85,-85,2,13.54,104
,20160722,13535,13535,13530,13810,13530,13755,13735,220,200,12,82.41,96
,20160725,13755,13735,13625,13920,13620,13920,13695,185,-40,8,54.79,100
,20160726,13920,13695,14010,14010,14010,14010,14010,315,315,2,14.01,100
,20160727,14010,14010,,,,14190,14190,180,180,0,0.00,100
,20160728,14190,14190,13975,13975,13975,13975,13975,-215,-215,2,13.98,100
,20160729,13975,13975,,,,13825,13825,-150,-150,0,0.00,100
,20160801,13825,13825,14120,14260,14120,14260,14175,435,350,6,42.53,102
,20160802,14260,14175,,,,14135,14135,-40,-40,0,0.00,102
,20160803,14135,14135,14075,14075,14075,14075,14075,-60,-60,2,14.08,102
,20160804,14075,14075,14100,14100,14100,14100,14100,25,25,2,14.10,102
,20160805,14100,14100,14130,14130,14130,14130,14130,30,30,2,14.13,104
,20160808,14130,14130,14165,14165,14165,14165,14165,35,35,2,14.17,104
,20160809,14165,14165,14015,14015,14015,14015,14015,-150,-150,2,14.02,104
,20160810,14015,14015,,,,13850,13850,-165,-165,0,0.00,104
,20160811,13850,13850,13980,13980,13980,13980,13980,130,130,2,13.98,104
,20160812,13980,13980,,,,13955,13955,-25,-25,0,0.00,104
,20160815,13955,13955,13805,13805,13805,13805,13805,-150,-150,2,13.81,104
,20160816,13805,13805,,,,13640,13640,-165,-165,0,0.00,104
,20160817,13640,13640,,,,13670,13670,30,30,0,0.00,104
,20160818,13670,13670,13830,13945,13830,13945,13885,275,215,4,27.78,106
,20160819,13945,13885,14000,14015,14000,14010,14010,125,125,48,336.25,122
,20160822,14010,14010,,,,14040,14040,30,30,0,0.00,122
,20160823,14040,14040,,,,13985,13985,-55,-55,0,0.00,122
,20160824,13985,13985,,,,14055,14055,70,70,0,0.00,122
,20160825,14055,14055,,,,14100,14100,45,45,0,0.00,122
,20160826,14100,14100,14010,14010,14010,14010,14010,-90,-90,2,14.01,120
,20160829,14010,14010,,,,13945,13945,-65,-65,0,0.00,120
,20160830,13945,13945,,,,13940,13940,-5,-5,0,0.00,120
,20160831,13940,13940,,,,13995,13995,55,55,0,0.00,120
,20160901,13995,13995,14055,14425,14055,14420,14330,425,335,8,57.32,126
,20160902,14420,14330,14805,14900,14560,14560,14640,230,310,28,205.01,142
,20160905,14560,14640,14440,14680,14440,14680,14565,40,-75,8,58.27,142
,20160906,14680,14565,14565,14565,14565,14565,14565,0,0,4,29.13,140
,20160907,14565,14565,14415,14415,14370,14370,14390,-195,-175,8,57.57,140
,20160908,14370,14390,,,,14335,14335,-55,-55,0,0.00,140
,20160909,14335,14335,,,,14335,14335,0,0,0,0.00,140
,20160912,14335,14335,14270,14270,14015,14145,14125,-190,-210,20,141.26,146
,20160913,14145,14125,13985,14040,13985,14040,14020,-85,-105,20,140.25,136
,20160914,14040,14020,,,,14035,14035,15,15,0,0.00,136
,20160919,14035,14035,,,,14200,14200,165,165,0,0.00,136
,20160920,14200,14200,,,,14410,14410,210,210,0,0.00,136
,20160921,14410,14410,,,,14320,14320,-90,-90,0,0.00,136
,20160922,14320,14320,14635,14635,14490,14490,14615,170,295,26,190.06,118
,20160923,14490,14615,14735,14735,14735,14735,14735,120,120,2,14.74,116
,20160926,14735,14735,,,,14570,14570,-165,-165,0,0.00,116
,20160927,14570,14570,14680,14830,14575,14830,14645,260,75,14,102.55,122
,20160928,14830,14645,14700,14700,14590,14600,14610,-45,-35,12,87.67,128
,20160929,14600,14610,14890,14925,14890,14905,14905,295,295,6,44.72,130
,20160930,14905,14905,15120,15205,15020,15070,15075,165,170,64,482.44,164
,20161010,15070,15075,15325,15325,15325,15325,15325,250,250,12,91.95,176
,20161011,15325,15325,,,,15505,15505,180,180,0,0.00,176
,20161012,15505,15505,15445,15480,15380,15425,15440,-80,-65,42,324.31,196
,20161013,15425,15440,15390,15445,15215,15310,15365,-130,-75,24,184.44,184
,20161014,15310,15365,,,,15290,15290,-75,-75,0,0.00,184
,20161017,15290,15290,15235,15235,15235,15235,15235,-55,-55,10,76.18,194
,20161018,15235,15235,,,,15245,15245,10,10,0,0.00,194
,20161019,15245,15245,15215,15225,15135,15135,15195,-110,-50,12,91.19,196
,20161020,15135,15195,15335,15335,15335,15335,15335,140,140,2,15.34,198
,20161021,15335,15335,15505,15505,15440,15440,15445,105,110,26,200.84,216
,20161024,15440,15445,15470,15490,15470,15490,15480,45,35,4,30.96,214
,20161025,15490,15480,16095,16095,16000,16000,16045,520,565,4,32.10,214
,20161026,16000,16045,16280,16400,15950,15955,16155,-90,110,64,517.08,188
,20161027,15955,16155,16210,16235,16090,16110,16175,-45,20,18,145.62,196
,20161028,16110,16175,,,,16200,16200,25,25,0,0.00,196
,20161031,16200,16200,16350,16350,16340,16340,16345,140,145,4,32.69,196
,20161101,16340,16345,16290,16650,16290,16650,16485,305,140,160,"1,318.80",190
,20161102,16650,16485,16530,16565,16315,16340,16480,-145,-5,42,346.13,186
,20161103,16340,16480,16325,16365,16325,16340,16340,-140,-140,6,49.03,186
,20161104,16340,16340,16640,16665,16620,16665,16640,325,300,6,49.93,184
,20161107,16665,16640,16560,16880,16560,16880,16660,240,20,62,516.50,166
,20161108,16880,16660,16945,17120,16750,16795,16935,135,275,66,558.88,184
,20161109,16795,16935,17035,17090,16635,16725,16830,-210,-105,60,505.01,218
,20161110,16725,16830,16910,17500,16895,17500,17265,670,435,84,725.13,244
,20161111,17500,17265,17305,17775,17165,17510,17405,245,140,162,"1,409.85",268
,20161114,17510,17405,17510,18245,17065,17755,17600,350,195,124,"1,091.45",244
,20161115,17755,17600,16545,18300,16545,17835,17695,235,95,66,584.07,228
,20161116,17835,17695,17865,18550,17775,18275,18230,580,535,84,765.84,236
,20161117,18275,18230,18300,18480,17700,17900,17830,-330,-400,272,"2,425.28",328
,20161118,17900,17830,17920,17950,17535,17755,17720,-75,-110,162,"1,435.42",386
,20161121,17755,17720,17865,18310,17865,18100,18030,380,310,76,685.19,392
,20161122,18100,18030,18120,18900,18120,18800,18590,770,560,36,334.63,410
,20161123,18800,18590,18920,18980,18805,18970,18905,380,315,134,"1,266.77",514
,20161124,18970,18905,18760,19665,18715,19450,19080,545,175,730,"6,965.89",968
,20161125,19450,19080,19835,19835,19040,19475,19535,395,455,88,859.71,1014
,20161128,19475,19535,19990,20900,19845,20900,20590,1365,1055,182,"1,874.07",1074
,20161129,20900,20590,21115,22645,20735,21420,21505,830,915,1348,"14,495.80",1120
,20161130,21420,21505,21620,21695,20125,20330,20985,-1175,-520,5262,"55,218.28",4084
,20161201,20330,20985,20735,21095,20225,20720,20585,-265,-400,894,"9,201.99",4020
,20161202,20720,20585,20720,20960,19595,19895,20300,-690,-285,272,"2,760.81",4094
,20161205,19895,20300,19810,20120,19350,19960,19790,-340,-510,872,"8,630.52",4396
,20161206,19960,19790,20045,20360,19850,19920,20055,130,265,510,"5,114.96",4572
,20161207,19920,20055,20110,20790,19925,20605,20560,550,505,862,"8,861.43",4592
,20161208,20605,20560,20765,21155,20300,20415,20585,-145,25,1082,"11,137.77",5012
,20161209,20415,20585,20575,20735,20020,20305,20300,-280,-285,530,"5,379.56",5202
,20161212,20305,20300,20350,20660,20040,20195,20395,-105,95,744,"7,587.54",5500
,20161213,20195,20395,20225,20500,20145,20310,20275,-85,-120,274,"2,777.72",5614
,20161214,20310,20275,20355,20415,20175,20175,20315,-100,40,62,629.86,5596
,20161215,20175,20315,20175,20715,20155,20700,20605,385,290,528,"5,439.76",5598
,20161216,20700,20605,20420,20420,19850,19850,20085,-755,-520,372,"3,736.62",5638
,20161219,19850,20085,19670,19670,18675,18675,19130,-1410,-955,900,"8,609.85",5848
,20161220,18675,19130,18505,18505,17300,18075,17760,-1055,-1370,3326,"29,540.27",5786
,20161221,18075,17760,18190,18595,18075,18360,18300,600,540,974,"8,912.57",5842
,20161222,18360,18300,18295,18350,17855,17915,18015,-385,-285,418,"3,765.46",6046
,20161223,17915,18015,17640,18365,17630,18035,18045,20,30,466,"4,205.59",6116
,20161226,18035,18045,18265,18265,16930,17305,17295,-740,-750,1016,"8,787.71",5942
,20161227,17305,17295,17320,17540,17135,17535,17315,240,20,594,"5,142.86",5984
,20161228,17535,17315,17425,18020,17405,17525,17685,210,370,326,"2,883.32",6052
,20161229,17525,17685,17625,17860,17410,17665,17620,-20,-65,418,"3,683.41",6150
,20161230,17665,17620,17555,17635,17185,17450,17405,-170,-215,788,"6,858.47",6344
pb1705,20160517,13020,13020,,,,13005,13005,-15,-15,0,0.00,0
,20160518,13005,13005,,,,13015,13015,10,10,0,0.00,0
,20160519,13015,13015,,,,12860,12860,-155,-155,0,0.00,0
,20160520,12860,12860,,,,12875,12875,15,15,0,0.00,0
,20160523,12875,12875,,,,12720,12720,-155,-155,0,0.00,0
,20160524,12720,12720,,,,12745,12745,25,25,0,0.00,0
,20160525,12745,12745,12940,12955,12940,12955,12945,210,200,10,64.73,10
,20160526,12955,12945,,,,12945,12945,0,0,0,0.00,10
,20160527,12945,12945,,,,13045,13045,100,100,0,0.00,10
,20160530,13045,13045,12895,13110,12895,13110,13000,65,-45,4,26.01,10
,20160531,13110,13000,,,,13020,13020,20,20,0,0.00,10
,20160601,13020,13020,,,,13020,13020,0,0,0,0.00,10
,20160602,13020,13020,,,,13085,13085,65,65,0,0.00,10
,20160603,13085,13085,13100,13100,12995,12995,13045,-90,-40,4,26.10,12
,20160606,12995,13045,,,,12945,12945,-100,-100,0,0.00,12
,20160607,12945,12945,,,,12940,12940,-5,-5,0,0.00,12
,20160608,12940,12940,,,,12945,12945,5,5,0,0.00,12
,20160613,12945,12945,,,,12985,12985,40,40,0,0.00,12
,20160614,12985,12985,,,,12985,12985,0,0,0,0.00,12
,20160615,12985,12985,,,,13010,13010,25,25,0,0.00,12
,20160616,13010,13010,,,,13050,13050,40,40,0,0.00,12
,20160617,13050,13050,,,,13075,13075,25,25,0,0.00,12
,20160620,13075,13075,,,,13100,13100,25,25,0,0.00,12
,20160621,13100,13100,,,,13120,13120,20,20,0,0.00,12
,20160622,13120,13120,13100,13100,13100,13100,13100,-20,-20,4,26.20,14
,20160623,13100,13100,13150,13150,13150,13150,13150,50,50,2,13.15,14
,20160624,13150,13150,,,,13070,13070,-80,-80,0,0.00,14
,20160627,13070,13070,,,,13070,13070,0,0,0,0.00,14
,20160628,13070,13070,,,,13120,13120,50,50,0,0.00,14
,20160629,13120,13120,13275,13275,13275,13275,13275,155,155,2,13.28,14
,20160630,13275,13275,,,,13435,13435,160,160,0,0.00,14
,20160701,13435,13435,13505,13505,13505,13505,13505,70,70,2,13.51,16
,20160704,13505,13505,13780,13780,13780,13780,13780,275,275,2,13.78,18
,20160705,13780,13780,,,,13780,13780,0,0,0,0.00,18
,20160706,13780,13780,13400,13405,13355,13355,13380,-425,-400,10,66.92,24
,20160707,13355,13380,13270,13430,13260,13430,13320,50,-60,6,39.96,26
,20160708,13430,13320,13265,13285,13265,13280,13275,-40,-45,12,79.66,30
,20160711,13280,13275,13325,13325,13325,13325,13325,50,50,2,13.33,32
,20160712,13325,13325,,,,13325,13325,0,0,0,0.00,32
,20160713,13325,13325,,,,13595,13595,270,270,0,0.00,32
,20160714,13595,13595,,,,13595,13595,0,0,0,0.00,32
,20160715,13595,13595,,,,13595,13595,0,0,0,0.00,32
,20160718,13595,13595,,,,13735,13735,140,140,0,0.00,32
,20160719,13735,13735,,,,13735,13735,0,0,0,0.00,32
,20160720,13735,13735,,,,13685,13685,-50,-50,0,0.00,32
,20160721,13685,13685,,,,13595,13595,-90,-90,0,0.00,32
,20160722,13595,13595,13840,13840,13840,13840,13840,245,245,20,138.40,46
,20160725,13840,13840,13730,13980,13630,13980,13660,140,-180,26,177.64,32
,20160726,13980,13660,,,,13660,13660,0,0,0,0.00,32
,20160727,13660,13660,14130,14130,13885,14040,14025,380,365,16,112.21,40
,20160728,14040,14025,,,,13810,13810,-215,-215,0,0.00,40
,20160729,13810,13810,14030,14050,14030,14050,14035,240,225,6,42.11,40
,20160801,14050,14035,14145,14365,14145,14365,14175,330,140,20,141.78,42
,20160802,14365,14175,,,,14135,14135,-40,-40,0,0.00,42
,20160803,14135,14135,14280,14280,14125,14125,14215,-10,80,6,42.65,38
,20160804,14125,14215,14080,14205,14080,14105,14140,-110,-75,12,84.84,38
,20160805,14105,14140,,,,14170,14170,30,30,0,0.00,38
,20160808,14170,14170,,,,14205,14205,35,35,0,0.00,38
,20160809,14205,14205,,,,14050,14050,-155,-155,0,0.00,38
,20160810,14050,14050,,,,13885,13885,-165,-165,0,0.00,38
,20160811,13885,13885,,,,14015,14015,130,130,0,0.00,38
,20160812,14015,14015,14030,14030,14030,14030,14030,15,15,2,14.03,40
,20160815,14030,14030,14110,14110,14020,14020,14050,-10,20,6,42.15,40
,20160816,14020,14050,13820,13820,13820,13820,13820,-230,-230,6,41.46,46
,20160817,13820,13820,13785,13785,13785,13785,13785,-35,-35,2,13.79,44
,20160818,13785,13785,,,,13785,13785,0,0,0,0.00,44
,20160819,13785,13785,14070,14120,14070,14120,14100,335,315,6,42.31,44
,20160822,14120,14100,14130,14170,14100,14100,14125,0,25,10,70.64,48
,20160823,14100,14125,14125,14125,14125,14125,14125,0,0,2,14.13,50
,20160824,14125,14125,14190,14190,14190,14190,14190,65,65,4,28.38,48
,20160825,14190,14190,,,,14235,14235,45,45,0,0.00,48
,20160826,14235,14235,14170,14170,14170,14170,14170,-65,-65,2,14.17,48
,20160829,14170,14170,,,,14145,14145,-25,-25,0,0.00,48
,20160830,14145,14145,,,,14010,14010,-135,-135,0,0.00,48
,20160831,14010,14010,14015,14015,14015,14015,14015,5,5,2,14.02,48
,20160901,14015,14015,,,,14350,14350,335,335,0,0.00,48
,20160902,14350,14350,14920,14920,14620,14620,14830,270,480,10,74.17,46
,20160905,14620,14830,14690,14690,14465,14680,14575,-150,-255,38,277.02,60
,20160906,14680,14575,14575,14575,14575,14575,14575,0,0,2,14.58,58
,20160907,14575,14575,14405,14410,14405,14405,14405,-170,-170,8,57.63,58
,20160908,14405,14405,,,,14400,14400,-5,-5,0,0.00,58
,20160909,14400,14400,,,,14400,14400,0,0,0,0.00,58
,20160912,14400,14400,14020,14020,14020,14020,14020,-380,-380,2,14.02,58
,20160913,14020,14020,14055,14055,14055,14055,14055,35,35,6,42.17,58
,20160914,14055,14055,,,,14055,14055,0,0,0,0.00,58
,20160919,14055,14055,,,,14220,14220,165,165,0,0.00,58
,20160920,14220,14220,,,,14430,14430,210,210,0,0.00,58
,20160921,14430,14430,14710,14710,14700,14700,14700,270,270,8,58.81,50
,20160922,14700,14700,,,,15005,15005,305,305,0,0.00,50
,20160923,15005,15005,14755,14755,14615,14615,14685,-390,-320,6,44.06,52
,20160926,14615,14685,14625,14625,14415,14415,14545,-270,-140,16,116.39,54
,20160927,14415,14545,14795,14815,14795,14815,14800,270,255,20,148.04,74
,20160928,14815,14800,14725,14725,14635,14635,14655,-165,-145,12,87.95,68
,20160929,14635,14655,14995,14995,14995,14995,14995,340,340,8,59.98,76
,20160930,14995,14995,15105,15200,15105,15200,15120,205,125,14,105.85,86
,20161010,15200,15120,15160,15355,15160,15355,15255,235,135,4,30.52,86
,20161011,15355,15255,15470,15470,15360,15405,15385,150,130,30,230.83,90
,20161012,15405,15385,15415,15415,15300,15300,15375,-85,-10,48,369.07,86
,20161013,15300,15375,15380,15380,15055,15055,15210,-320,-165,30,228.18,98
,20161014,15055,15210,15070,15170,15070,15170,15120,-40,-90,4,30.24,98
,20161017,15170,15120,15160,15245,15155,15210,15195,90,75,36,273.60,122
,20161018,15210,15195,15160,15330,15160,15330,15210,135,15,44,334.65,140
,20161019,15330,15210,15160,15160,15155,15155,15155,-55,-55,6,45.47,142
,20161020,15155,15155,15230,15285,15230,15285,15260,130,105,10,76.31,138
,20161021,15285,15260,15315,15480,15225,15435,15375,175,115,34,261.44,138
,20161024,15435,15375,15400,15540,15400,15455,15475,80,100,22,170.24,136
,20161025,15455,15475,15585,16045,15585,16035,15925,560,450,46,366.32,168
,20161026,16035,15925,16290,16345,15905,16025,16075,100,150,118,948.45,206
,20161027,16025,16075,16100,16300,16030,16110,16175,35,100,68,550.10,210
,20161028,16110,16175,16075,16240,16075,16240,16200,65,25,32,259.21,212
,20161031,16240,16200,16330,16350,16245,16280,16300,80,100,26,211.93,220
,20161101,16280,16300,16300,16680,16300,16625,16450,325,150,94,773.26,230
,20161102,16625,16450,16555,16555,16160,16195,16400,-255,-50,130,"1,066.23",238
,20161103,16195,16400,16260,16385,16230,16385,16315,-15,-85,32,261.10,246
,20161104,16385,16315,16590,16690,16525,16690,16600,375,285,142,"1,178.73",238
,20161107,16690,16600,16560,17260,16555,17050,17090,450,490,176,"1,504.35",246
,20161108,17050,17090,16965,17220,16730,16785,16990,-305,-100,174,"1,478.42",232
,20161109,16785,16990,16870,17035,16620,16790,16795,-200,-195,64,537.58,244
,20161110,16790,16795,16950,17465,16950,17460,17290,665,495,90,778.10,240
,20161111,17460,17290,17370,17515,17160,17475,17345,185,55,110,953.98,180
,20161114,17475,17345,17625,18350,17005,17725,17805,380,460,214,"1,905.58",178
,20161115,17725,17805,17810,18650,17720,17845,18070,40,265,146,"1,319.13",208
,20161116,17845,18070,17800,18600,17800,18295,18165,225,95,140,"1,271.81",196
,20161117,18295,18165,18330,18330,17540,17865,17965,-300,-200,80,718.76,204
,20161118,17865,17965,17940,17940,17635,17635,17740,-330,-225,22,195.18,212
,20161121,17635,17740,17910,18250,17855,18250,17990,510,250,34,305.85,208
,20161122,18250,17990,18035,18890,18035,18875,18560,885,570,64,593.92,230
,20161123,18875,18560,18870,18985,18705,18890,18895,330,335,60,566.97,238
,20161124,18890,18895,18795,19405,18680,19350,19045,455,150,204,"1,942.76",318
,20161125,19350,19045,19555,19750,18985,19460,19335,415,290,224,"2,165.88",396
,20161128,19460,19335,20095,20685,19675,20685,20265,1350,930,98,993.08,404
,20161129,20685,20265,20835,22205,20805,21355,21420,1090,1155,682,"7,304.41",504
,20161130,21355,21420,21570,21585,20140,20210,20960,-1210,-460,1016,"10,649.31",680
,20161201,20210,20960,20350,21035,20205,20785,20590,-175,-370,496,"5,106.94",640
,20161202,20785,20590,20630,20630,19600,20050,20135,-540,-455,242,"2,436.42",682
,20161205,20050,20135,19710,20095,19265,19965,19660,-170,-475,582,"5,721.64",780
,20161206,19965,19660,20360,20360,19805,19880,20090,220,430,120,"1,205.44",788
,20161207,19880,20090,19360,20915,19360,20700,20625,610,535,286,"2,949.54",806
,20161208,20700,20625,20700,21230,20210,20405,20710,-220,85,216,"2,236.81",816
,20161209,20405,20710,20620,20900,19940,20100,20600,-610,-110,404,"4,162.19",846
,20161212,20100,20600,20350,20650,20075,20210,20360,-390,-240,382,"3,889.29",976
,20161213,20210,20360,20245,20570,20150,20365,20320,5,-40,146,"1,483.38",1040
,20161214,20365,20320,20330,20365,20145,20365,20215,45,-105,74,748.00,1054
,20161215,20365,20215,20285,20750,20140,20745,20605,530,390,262,"2,699.55",1130
,20161216,20745,20605,20835,20835,19935,19935,20180,-670,-425,284,"2,865.97",1170
,20161219,19935,20180,19695,19695,18765,18765,19040,-1415,-1140,342,"3,256.28",1314
,20161220,18765,19040,18500,18500,17390,18030,17750,-1010,-1290,1544,"13,705.44",1454
,20161221,18030,17750,18145,18595,18100,18340,18365,590,615,442,"4,059.35",1438
,20161222,18340,18365,18345,18370,17865,17935,18025,-430,-340,296,"2,668.19",1482
,20161223,17935,18025,17660,18505,17610,18025,18175,0,150,436,"3,962.96",1460
,20161226,18025,18175,18070,18215,16960,17305,17420,-870,-755,358,"3,118.98",1558
,20161227,17305,17420,17330,17565,17190,17565,17345,145,-75,110,954.18,1564
,20161228,17565,17345,17540,18045,17385,17610,17765,265,420,362,"3,215.58",1602
,20161229,17610,17765,17585,17910,17415,17645,17635,-120,-130,288,"2,539.99",1710
,20161230,17645,17635,18030,18030,17250,17470,17450,-165,-185,484,"4,224.02",1794
pb1706,20160616,13010,13010,,,,13050,13050,40,40,0,0.00,0
,20160617,13050,13050,,,,13075,13075,25,25,0,0.00,0
,20160620,13075,13075,,,,13100,13100,25,25,0,0.00,0
,20160621,13100,13100,,,,13120,13120,20,20,0,0.00,0
,20160622,13120,13120,,,,13100,13100,-20,-20,0,0.00,0
,20160623,13100,13100,,,,13150,13150,50,50,0,0.00,0
,20160624,13150,13150,,,,13070,13070,-80,-80,0,0.00,0
,20160627,13070,13070,13170,13170,13170,13170,13170,100,100,2,13.17,2
,20160628,13170,13170,13120,13195,13035,13035,13110,-135,-60,16,104.91,4
,20160629,13035,13110,13170,13230,13170,13230,13210,120,100,6,39.63,6
,20160630,13230,13210,,,,13370,13370,160,160,0,0.00,6
,20160701,13370,13370,,,,13435,13435,65,65,0,0.00,6
,20160704,13435,13435,13850,13880,13685,13845,13815,410,380,8,55.26,10
,20160705,13845,13815,13520,13520,13450,13450,13485,-365,-330,4,26.97,8
,20160706,13450,13485,13400,13400,13400,13400,13400,-85,-85,2,13.40,10
,20160707,13400,13400,13280,13440,13280,13440,13410,40,10,12,80.48,20
,20160708,13440,13410,13395,13395,13300,13300,13345,-110,-65,4,26.70,22
,20160711,13300,13345,,,,13395,13395,50,50,0,0.00,22
,20160712,13395,13395,,,,13480,13480,85,85,0,0.00,22
,20160713,13480,13480,13645,13645,13645,13645,13645,165,165,2,13.65,22
,20160714,13645,13645,,,,13645,13645,0,0,0,0.00,22
,20160715,13645,13645,,,,13645,13645,0,0,0,0.00,22
,20160718,13645,13645,13725,13725,13725,13725,13725,80,80,4,27.45,20
,20160719,13725,13725,,,,13760,13760,35,35,0,0.00,20
,20160720,13760,13760,13585,13585,13585,13585,13585,-175,-175,2,13.59,20
,20160721,13585,13585,,,,13500,13500,-85,-85,0,0.00,20
,20160722,13500,13500,,,,13740,13740,240,240,0,0.00,20
,20160725,13740,13740,13750,13750,13750,13750,13750,10,10,2,13.75,20
,20160726,13750,13750,13960,14080,13930,14080,13990,330,240,6,41.97,24
,20160727,14080,13990,14080,14145,14020,14020,14080,30,90,6,42.25,24
,20160728,14020,14080,,,,14080,14080,0,0,0,0.00,24
,20160729,14080,14080,,,,14080,14080,0,0,0,0.00,24
,20160801,14080,14080,14235,14235,14235,14235,14235,155,155,2,14.24,26
,20160802,14235,14235,,,,14235,14235,0,0,0,0.00,26
,20160803,14235,14235,14335,14335,14305,14305,14320,70,85,4,28.64,26
,20160804,14305,14320,14135,14255,14135,14170,14200,-150,-120,8,56.81,24
,20160805,14170,14200,14045,14100,14045,14100,14070,-100,-130,4,28.15,28
,20160808,14100,14070,14195,14195,14195,14195,14195,125,125,2,14.20,30
,20160809,14195,14195,14095,14095,14095,14095,14095,-100,-100,2,14.10,30
,20160810,14095,14095,14095,14095,14095,14095,14095,0,0,2,14.10,30
,20160811,14095,14095,,,,14095,14095,0,0,0,0.00,30
,20160812,14095,14095,,,,14095,14095,0,0,0,0.00,30
,20160815,14095,14095,13995,13995,13800,13800,13885,-295,-210,6,41.66,30
,20160816,13800,13885,,,,13655,13655,-230,-230,0,0.00,30
,20160817,13655,13655,13830,13830,13830,13830,13830,175,175,2,13.83,30
,20160818,13830,13830,14000,14000,14000,14000,14000,170,170,2,14.00,32
,20160819,14000,14000,14085,14085,14065,14065,14075,65,75,4,28.15,34
,20160822,14065,14075,,,,14100,14100,25,25,0,0.00,34
,20160823,14100,14100,14125,14125,14125,14125,14125,25,25,2,14.13,34
,20160824,14125,14125,14165,14165,14165,14165,14165,40,40,4,28.33,38
,20160825,14165,14165,,,,14210,14210,45,45,0,0.00,38
,20160826,14210,14210,,,,14145,14145,-65,-65,0,0.00,38
,20160829,14145,14145,,,,14075,14075,-70,-70,0,0.00,38
,20160830,14075,14075,,,,14065,14065,-10,-10,0,0.00,38
,20160831,14065,14065,,,,14070,14070,5,5,0,0.00,38
,20160901,14070,14070,,,,14405,14405,335,335,0,0.00,38
,20160902,14405,14405,14980,14980,14780,14780,14855,375,450,12,89.16,40
,20160905,14780,14855,14485,14510,14480,14510,14485,-345,-370,8,57.96,38
,20160906,14510,14485,14615,14690,14615,14690,14645,205,160,6,43.94,42
,20160907,14690,14645,,,,14475,14475,-170,-170,0,0.00,42
,20160908,14475,14475,,,,14420,14420,-55,-55,0,0.00,42
,20160909,14420,14420,14245,14245,14245,14245,14245,-175,-175,2,14.25,40
,20160912,14245,14245,,,,13865,13865,-380,-380,0,0.00,40
,20160913,13865,13865,,,,13895,13895,30,30,0,0.00,40
,20160914,13895,13895,,,,13925,13925,30,30,0,0.00,40
,20160919,13925,13925,,,,14090,14090,165,165,0,0.00,40
,20160920,14090,14090,,,,14300,14300,210,210,0,0.00,40
,20160921,14300,14300,,,,14570,14570,270,270,0,0.00,40
,20160922,14570,14570,14615,14615,14585,14585,14590,15,20,8,58.37,36
,20160923,14585,14590,,,,14275,14275,-315,-315,0,0.00,36
,20160926,14275,14275,,,,14140,14140,-135,-135,0,0.00,36
,20160927,14140,14140,14705,14705,14705,14705,14705,565,565,6,44.12,38
,20160928,14705,14705,14725,14725,14705,14705,14715,0,10,4,29.43,36
,20160929,14705,14715,14855,14945,14855,14865,14880,150,165,10,74.42,32
,20160930,14865,14880,15125,15125,15095,15095,15120,215,240,14,105.85,42
,20161010,15095,15120,,,,15255,15255,135,135,0,0.00,42
,20161011,15255,15255,15460,15460,15355,15355,15380,100,125,16,123.05,54
,20161012,15355,15380,15395,15395,15395,15395,15395,15,15,6,46.19,52
,20161013,15395,15395,,,,15080,15080,-315,-315,0,0.00,52
,20161014,15080,15080,,,,14990,14990,-90,-90,0,0.00,52
,20161017,14990,14990,15100,15120,15100,15120,15100,130,110,14,105.72,60
,20161018,15120,15100,,,,15100,15100,0,0,0,0.00,60
,20161019,15100,15100,,,,15100,15100,0,0,0,0.00,60
,20161020,15100,15100,,,,15100,15100,0,0,0,0.00,60
,20161021,15100,15100,,,,15305,15305,205,205,0,0.00,60
,20161024,15305,15305,,,,15305,15305,0,0,0,0.00,60
,20161025,15305,15305,15550,15550,15550,15550,15550,245,245,12,93.30,72
,20161026,15550,15550,16050,16125,16050,16100,16090,550,540,6,48.28,72
,20161027,16100,16090,16045,16100,16045,16100,16070,10,-20,4,32.15,74
,20161028,16100,16070,,,,16070,16070,0,0,0,0.00,74
,20161031,16070,16070,16355,16365,16255,16255,16350,185,280,36,294.30,102
,20161101,16255,16350,16390,16615,16380,16535,16455,185,105,46,378.47,118
,20161102,16535,16455,16395,16395,16200,16200,16385,-255,-70,50,409.67,146
,20161103,16200,16385,,,,16450,16450,65,65,0,0.00,146
,20161104,16450,16450,,,,16580,16580,130,130,0,0.00,146
,20161107,16580,16580,16520,16980,16520,16980,16695,400,115,38,317.24,148
,20161108,16980,16695,16910,17325,16740,16785,17205,90,510,258,"2,219.85",106
,20161109,16785,17205,16730,16755,16730,16755,16740,-450,-465,6,50.22,106
,20161110,16755,16740,17200,17405,17200,17405,17360,665,620,14,121.53,104
,20161111,17405,17360,17310,17490,17220,17280,17340,-80,-20,36,312.14,104
,20161114,17280,17340,17900,17900,17080,17835,17675,495,335,64,565.64,104
,20161115,17835,17675,17965,18445,17795,18020,18020,345,345,42,378.52,108
,20161116,18020,18020,18165,18300,18155,18155,18215,135,195,26,236.84,116
,20161117,18155,18215,18275,18275,17550,17805,17905,-410,-310,80,716.31,108
,20161118,17805,17905,17920,17920,17560,17810,17670,-95,-235,22,194.41,112
,20161121,17810,17670,17890,18175,17610,18175,17890,505,220,46,411.55,112
,20161122,18175,17890,18230,18800,18000,18800,18550,910,660,54,500.85,156
,20161123,18800,18550,18840,18910,18825,18825,18855,275,305,16,150.87,156
,20161124,18825,18855,18775,19300,18770,19280,19030,425,175,52,494.82,168
,20161125,19280,19030,19245,19580,19070,19495,19410,465,380,52,504.75,170
,20161128,19495,19410,20055,20765,19425,20765,20265,1355,855,80,810.71,164
,20161129,20765,20265,20600,21680,20600,21285,21295,1020,1030,140,"1,490.98",172
,20161130,21285,21295,21400,21400,20135,20375,20740,-920,-555,200,"2,074.14",198
,20161201,20375,20740,20470,20950,19810,20670,20480,-70,-260,58,594.01,188
,20161202,20670,20480,20500,20655,19815,19830,20390,-650,-90,72,734.12,204
,20161205,19830,20390,19645,20150,19320,19990,19610,-400,-780,186,"1,824.15",226
,20161206,19990,19610,20150,20235,19805,19910,20035,300,425,20,200.39,234
,20161207,19910,20035,20080,20630,20080,20425,20225,390,190,16,161.80,240
,20161208,20425,20225,21115,21115,20470,20470,20670,245,445,18,186.04,246
,20161209,20470,20670,20330,20330,20330,20330,20330,-340,-340,2,20.33,244
,20161212,20330,20330,20030,20690,20030,20380,20460,50,130,18,184.14,248
,20161213,20380,20460,20300,20550,20225,20245,20400,-215,-60,16,163.21,242
,20161214,20245,20400,20335,20375,20165,20375,20290,-25,-110,6,60.88,238
,20161215,20375,20290,20185,20695,20105,20665,20505,375,215,26,266.58,232
,20161216,20665,20505,20335,20335,19975,19975,20055,-530,-450,66,661.94,268
,20161219,19975,20055,19760,19760,18650,18650,19335,-1405,-720,176,"1,701.84",394
,20161220,18650,19335,18385,18390,17980,18065,18010,-1270,-1325,218,"1,963.60",410
,20161221,18065,18010,18190,18685,18160,18395,18400,385,390,192,"1,766.85",410
,20161222,18395,18400,18080,18100,17825,18000,17990,-400,-410,58,521.82,390
,20161223,18000,17990,17755,18455,17725,17940,17905,-50,-85,18,161.15,388
,20161226,17940,17905,18005,18005,17010,17255,17280,-650,-625,88,760.45,426
,20161227,17255,17280,17405,17560,17230,17560,17440,280,160,44,383.72,422
,20161228,17560,17440,17560,18000,17560,17740,17725,300,285,68,602.79,448
,20161229,17740,17725,17630,17800,17470,17680,17615,-45,-110,60,528.46,458
,20161230,17680,17615,17580,17580,17370,17370,17475,-245,-140,4,34.95,458
pb1707,20160718,13645,13645,13765,13765,13350,13350,13555,-295,-90,4,27.12,2
,20160719,13350,13555,,,,13590,13590,35,35,0,0.00,2
,20160720,13590,13590,,,,13415,13415,-175,-175,0,0.00,2
,20160721,13415,13415,,,,13330,13330,-85,-85,0,0.00,2
,20160722,13330,13330,13860,13860,13860,13860,13860,530,530,2,13.86,2
,20160725,13860,13860,,,,13870,13870,10,10,0,0.00,2
,20160726,13870,13870,,,,14110,14110,240,240,0,0.00,2
,20160727,14110,14110,,,,14200,14200,90,90,0,0.00,2
,20160728,14200,14200,,,,13980,13980,-220,-220,0,0.00,2
,20160729,13980,13980,,,,14205,14205,225,225,0,0.00,2
,20160801,14205,14205,14135,14200,14125,14200,14150,-5,-55,6,42.46,8
,20160802,14200,14150,,,,14110,14110,-40,-40,0,0.00,8
,20160803,14110,14110,14235,14240,14100,14100,14190,-10,80,6,42.58,8
,20160804,14100,14190,14120,14120,14120,14120,14120,-70,-70,2,14.12,10
,20160805,14120,14120,14070,14070,14070,14070,14070,-50,-50,4,28.14,10
,20160808,14070,14070,14205,14205,14205,14205,14205,135,135,2,14.21,12
,20160809,14205,14205,,,,14100,14100,-105,-105,0,0.00,12
,20160810,14100,14100,14000,14030,14000,14030,14015,-70,-85,4,28.03,14
,20160811,14030,14015,,,,14145,14145,130,130,0,0.00,14
,20160812,14145,14145,,,,14160,14160,15,15,0,0.00,14
,20160815,14160,14160,13955,13955,13845,13845,13890,-315,-270,6,41.67,14
,20160816,13845,13890,,,,13890,13890,0,0,0,0.00,14
,20160817,13890,13890,,,,14065,14065,175,175,0,0.00,14
,20160818,14065,14065,14050,14050,14050,14050,14050,-15,-15,4,28.10,18
,20160819,14050,14050,14200,14200,14200,14200,14200,150,150,2,14.20,20
,20160822,14200,14200,14160,14160,14160,14160,14160,-40,-40,2,14.16,22
,20160823,14160,14160,14135,14135,14135,14135,14135,-25,-25,2,14.14,20
,20160824,14135,14135,,,,14175,14175,40,40,0,0.00,20
,20160825,14175,14175,14220,14220,14145,14145,14180,-30,5,4,28.37,22
,20160826,14145,14180,,,,14180,14180,0,0,0,0.00,22
,20160829,14180,14180,,,,14110,14110,-70,-70,0,0.00,22
,20160830,14110,14110,,,,14110,14110,0,0,0,0.00,22
,20160831,14110,14110,,,,14115,14115,5,5,0,0.00,22
,20160901,14115,14115,14380,14380,14380,14380,14380,265,265,2,14.38,22
,20160902,14380,14380,14790,14955,14655,14655,14825,275,445,24,177.93,30
,20160905,14655,14825,14470,14470,14470,14470,14470,-355,-355,2,14.47,28
,20160906,14470,14470,,,,14625,14625,155,155,0,0.00,28
,20160907,14625,14625,14435,14515,14435,14475,14475,-150,-150,6,43.43,30
,20160908,14475,14475,,,,14475,14475,0,0,0,0.00,30
,20160909,14475,14475,14295,14295,14295,14295,14295,-180,-180,2,14.30,32
,20160912,14295,14295,,,,14295,14295,0,0,0,0.00,32
,20160913,14295,14295,14070,14070,14070,14070,14070,-225,-225,2,14.07,30
,20160914,14070,14070,,,,14070,14070,0,0,0,0.00,30
,20160919,14070,14070,14300,14300,14300,14300,14300,230,230,2,14.30,30
,20160920,14300,14300,14425,14425,14425,14425,14425,125,125,2,14.43,30
,20160921,14425,14425,14600,14600,14600,14600,14600,175,175,2,14.60,28
,20160922,14600,14600,14595,14870,14595,14870,14730,270,130,8,58.93,28
,20160923,14870,14730,14810,14810,14790,14790,14800,60,70,8,59.20,24
,20160926,14790,14800,,,,14800,14800,0,0,0,0.00,24
,20160927,14800,14800,,,,15390,15390,590,590,0,0.00,24
,20160928,15390,15390,14850,14850,14770,14770,14800,-620,-590,10,74.01,26
,20160929,14770,14800,14890,15090,14840,15090,14985,290,185,10,74.94,30
,20160930,15090,14985,15060,15140,15060,15130,15120,145,135,22,166.36,38
,20161010,15130,15120,,,,15255,15255,135,135,0,0.00,38
,20161011,15255,15255,15250,15250,15170,15170,15195,-85,-60,6,45.59,38
,20161012,15170,15195,15440,15440,15440,15440,15440,245,245,8,61.76,34
,20161013,15440,15440,15035,15035,15035,15035,15035,-405,-405,2,15.04,32
,20161014,15035,15035,15125,15125,15070,15070,15090,35,55,6,45.27,32
,20161017,15070,15090,15120,15120,15105,15105,15110,15,20,6,45.33,32
,20161018,15105,15110,,,,15200,15200,90,90,0,0.00,32
,20161019,15200,15200,,,,15145,15145,-55,-55,0,0.00,32
,20161020,15145,15145,15185,15185,15185,15185,15185,40,40,6,45.56,34
,20161021,15185,15185,15410,15410,15410,15410,15410,225,225,4,30.82,38
,20161024,15410,15410,,,,15510,15510,100,100,0,0.00,38
,20161025,15510,15510,,,,15850,15850,340,340,0,0.00,38
,20161026,15850,15850,15900,15900,15900,15900,15900,50,50,4,31.80,38
,20161027,15900,15900,16000,16000,15995,16000,15995,100,95,10,80.00,46
,20161028,16000,15995,,,,16050,16050,55,55,0,0.00,46
,20161031,16050,16050,16325,16335,16325,16335,16325,285,275,14,114.30,54
,20161101,16335,16325,16385,16560,16360,16560,16410,235,85,42,344.66,60
,20161102,16560,16410,16490,16490,16440,16445,16450,35,40,14,115.17,58
,20161103,16445,16450,,,,16450,16450,0,0,0,0.00,58
,20161104,16450,16450,,,,16450,16450,0,0,0,0.00,58
,20161107,16450,16450,16595,16735,16595,16735,16660,285,210,12,99.99,58
,20161108,16735,16660,17025,17235,17025,17235,17190,575,530,10,85.96,68
,20161109,17235,17190,16805,16805,16805,16805,16805,-385,-385,2,16.81,66
,20161110,16805,16805,17395,17475,17395,17475,17425,670,620,6,52.28,70
,20161111,17475,17425,17500,17655,17260,17435,17455,10,30,30,261.83,80
,20161114,17435,17455,17905,17905,17250,17600,17685,145,230,18,159.18,76
,20161115,17600,17685,,,,18030,18030,345,345,0,0.00,76
,20161116,18030,18030,18120,18415,17945,18415,18210,385,180,18,163.89,78
,20161117,18415,18210,18335,18470,17630,17630,18075,-580,-135,16,144.62,82
,20161118,17630,18075,17760,17760,17725,17725,17745,-350,-330,8,70.99,86
,20161121,17725,17745,17920,18130,17920,18130,18005,385,260,14,126.05,90
,20161122,18130,18005,18270,18875,18270,18875,18540,870,535,12,111.26,94
,20161123,18875,18540,18865,18900,18800,18900,18860,360,320,40,377.29,112
,20161124,18900,18860,18735,19245,18735,19120,19040,260,180,36,342.74,126
,20161125,19120,19040,19215,19455,18925,19200,19140,160,100,42,402.03,126
,20161128,19200,19140,19600,20475,19600,20475,20120,1335,980,20,201.23,130
,20161129,20475,20120,20765,21775,20765,21355,21355,1235,1235,52,555.29,144
,20161130,21355,21355,21525,21650,20475,20475,21050,-880,-305,38,400.03,136
,20161201,20475,21050,20430,20705,20085,20510,20380,-540,-670,82,835.77,154
,20161202,20510,20380,20120,20120,19625,19770,20075,-610,-305,40,401.56,144
,20161205,19770,20075,19620,19810,19430,19430,19645,-645,-430,46,451.89,150
,20161206,19430,19645,20190,20285,20115,20115,20195,470,550,12,121.18,148
,20161207,20115,20195,20480,20710,20480,20710,20555,515,360,6,61.67,144
,20161208,20710,20555,,,,20555,20555,0,0,0,0.00,144
,20161209,20555,20555,20655,20675,20055,20055,20395,-500,-160,12,122.38,144
,20161212,20055,20395,,,,20395,20395,0,0,0,0.00,144
,20161213,20395,20395,20200,20235,20200,20235,20210,-160,-185,18,181.91,152
,20161214,20235,20210,20395,20395,20380,20380,20385,170,175,4,40.78,148
,20161215,20380,20385,20135,20730,20125,20730,20400,345,15,12,122.42,148
,20161216,20730,20400,20365,20365,19935,19935,20170,-465,-230,24,242.05,148
,20161219,19935,20170,19815,19815,18755,18755,19235,-1415,-935,12,115.42,150
,20161220,18755,19235,18385,18385,17885,18015,18010,-1220,-1225,52,468.36,162
,20161221,18015,18010,18140,18505,18140,18405,18320,395,310,14,128.26,168
,20161222,18405,18320,18065,18065,18065,18065,18065,-255,-255,2,18.07,166
,20161223,18065,18065,17955,18490,17950,18300,18245,235,180,18,164.24,156
,20161226,18300,18245,18380,18380,17120,17120,17400,-1125,-845,28,243.63,166
,20161227,17120,17400,17470,17505,17470,17505,17485,105,85,4,34.98,164
,20161228,17505,17485,17445,17835,17445,17625,17680,140,195,46,406.69,174
,20161229,17625,17680,17560,17940,17350,17940,17585,260,-95,12,105.53,180
,20161230,17940,17585,17435,17450,17310,17450,17395,-135,-190,6,52.20,180
pb1708,20160816,13890,13890,,,,13890,13890,0,0,0,0.00,0
,20160817,13890,13890,,,,14065,14065,175,175,0,0.00,0
,20160818,14065,14065,,,,14065,14065,0,0,0,0.00,0
,20160819,14065,14065,,,,14215,14215,150,150,0,0.00,0
,20160822,14215,14215,,,,14170,14170,-45,-45,0,0.00,0
,20160823,14170,14170,,,,14140,14140,-30,-30,0,0.00,0
,20160824,14140,14140,14220,14220,14220,14220,14220,80,80,2,14.22,2
,20160825,14220,14220,,,,14225,14225,5,5,0,0.00,2
,20160826,14225,14225,,,,14225,14225,0,0,0,0.00,2
,20160829,14225,14225,14230,14230,14145,14145,14200,-80,-25,6,42.61,4
,20160830,14145,14200,14165,14165,14165,14165,14165,-35,-35,2,14.17,2
,20160831,14165,14165,,,,14165,14165,0,0,0,0.00,2
,20160901,14165,14165,14285,14360,14285,14360,14320,195,155,4,28.65,6
,20160902,14360,14320,14760,14890,14650,14650,14805,330,485,14,103.65,12
,20160905,14650,14805,14480,14480,14480,14480,14480,-325,-325,2,14.48,10
,20160906,14480,14480,14680,14680,14680,14680,14680,200,200,2,14.68,12
,20160907,14680,14680,,,,14680,14680,0,0,0,0.00,12
,20160908,14680,14680,,,,14680,14680,0,0,0,0.00,12
,20160909,14680,14680,14310,14310,14310,14310,14310,-370,-370,2,14.31,14
,20160912,14310,14310,14380,14380,14125,14180,14215,-130,-95,14,99.53,10
,20160913,14180,14215,14145,14145,14145,14145,14145,-70,-70,2,14.15,10
,20160914,14145,14145,,,,14145,14145,0,0,0,0.00,10
,20160919,14145,14145,14350,14350,14350,14350,14350,205,205,2,14.35,12
,20160920,14350,14350,14515,14580,14510,14580,14535,230,185,12,87.22,22
,20160921,14580,14535,,,,14535,14535,0,0,0,0.00,22
,20160922,14535,14535,,,,14535,14535,0,0,0,0.00,22
,20160923,14535,14535,14830,14940,14830,14940,14885,405,350,4,29.77,22
,20160926,14940,14885,14535,14535,14535,14535,14535,-350,-350,2,14.54,20
,20160927,14535,14535,14595,14770,14595,14770,14715,235,180,8,58.88,24
,20160928,14770,14715,,,,14715,14715,0,0,0,0.00,24
,20160929,14715,14715,,,,14755,14755,40,40,0,0.00,24
,20160930,14755,14755,15095,15095,15095,15095,15095,340,340,2,15.10,26
,20161010,15095,15095,,,,15095,15095,0,0,0,0.00,26
,20161011,15095,15095,,,,15200,15200,105,105,0,0.00,26
,20161012,15200,15200,,,,15200,15200,0,0,0,0.00,26
,20161013,15200,15200,15435,15435,15435,15435,15435,235,235,4,30.87,26
,20161014,15435,15435,15025,15195,15025,15195,15110,-240,-325,4,30.22,28
,20161017,15195,15110,,,,15110,15110,0,0,0,0.00,28
,20161018,15110,15110,,,,15180,15180,70,70,0,0.00,28
,20161019,15180,15180,,,,15180,15180,0,0,0,0.00,28
,20161020,15180,15180,15150,15150,15150,15150,15150,-30,-30,2,15.15,30
,20161021,15150,15150,,,,15150,15150,0,0,0,0.00,30
,20161024,15150,15150,15370,15370,15370,15370,15370,220,220,4,30.74,28
,20161025,15370,15370,15590,15760,15590,15760,15655,390,285,12,93.95,24
,20161026,15760,15655,16095,16095,16095,16095,16095,440,440,14,112.67,20
,20161027,16095,16095,,,,16095,16095,0,0,0,0.00,20
,20161028,16095,16095,,,,16120,16120,25,25,0,0.00,20
,20161031,16120,16120,16145,16145,16145,16145,16145,25,25,2,16.15,20
,20161101,16145,16145,16455,16630,16455,16630,16540,485,395,12,99.26,20
,20161102,16630,16540,,,,16580,16580,40,40,0,0.00,20
,20161103,16580,16580,,,,16580,16580,0,0,0,0.00,20
,20161104,16580,16580,16620,16620,16480,16480,16550,-100,-30,4,33.10,22
,20161107,16480,16550,16540,16920,16540,16915,16715,365,165,16,133.74,22
,20161108,16915,16715,16970,17115,16720,16800,16885,85,170,16,135.11,32
,20161109,16800,16885,16795,16955,16795,16900,16860,15,-25,14,118.05,28
,20161110,16900,16860,17460,17495,17425,17495,17455,635,595,16,139.64,38
,20161111,17495,17455,17460,17655,17365,17415,17455,-40,0,32,279.34,48
,20161114,17415,17455,18045,18290,17005,17550,17615,95,160,22,193.77,46
,20161115,17550,17615,17880,18350,17795,18350,18005,735,390,6,54.03,48
,20161116,18350,18005,18315,18315,18175,18315,18265,310,260,6,54.81,46
,20161117,18315,18265,17890,17890,17765,17765,17825,-500,-440,4,35.66,50
,20161118,17765,17825,17835,17835,17615,17615,17680,-210,-145,16,141.45,60
,20161121,17615,17680,17905,18215,17905,18215,18065,535,385,22,198.76,64
,20161122,18215,18065,18795,18795,18795,18795,18795,730,730,2,18.80,66
,20161123,18795,18795,18815,18930,18815,18920,18890,125,95,18,170.03,74
,20161124,18920,18890,18740,19315,18700,19055,18950,165,60,32,303.25,90
,20161125,19055,18950,19215,19480,19070,19070,19340,120,390,28,270.79,96
,20161128,19070,19340,20040,20670,19640,20615,20285,1275,945,24,243.46,92
,20161129,20615,20285,20970,21700,20970,21345,21450,1060,1165,84,901.04,108
,20161130,21345,21450,21505,21505,20180,20575,20930,-875,-520,32,334.90,108
,20161201,20575,20930,20400,21060,20300,21060,20665,130,-265,26,268.69,112
,20161202,21060,20665,20345,20345,19825,19825,20015,-840,-650,12,120.11,110
,20161205,19825,20015,19645,19940,19525,19940,19665,-75,-350,50,491.66,126
,20161206,19940,19665,20085,20285,20085,20285,20185,620,520,4,40.37,130
,20161207,20285,20185,19955,20660,19955,20660,20260,475,75,24,243.15,132
,20161208,20660,20260,20960,21180,20360,20580,20890,320,630,22,229.80,138
,20161209,20580,20890,20090,20185,20090,20185,20145,-705,-745,6,60.44,138
,20161212,20185,20145,19980,20530,19980,20530,20255,385,110,4,40.51,138
,20161213,20530,20255,20170,20395,20170,20205,20270,-50,15,20,202.71,138
,20161214,20205,20270,20530,20530,20180,20180,20290,-90,20,14,142.06,138
,20161215,20180,20290,20170,20675,20165,20665,20440,375,150,24,245.29,136
,20161216,20665,20440,20345,20375,19895,19915,20150,-525,-290,104,"1,047.83",124
,20161219,19915,20150,19855,19855,18735,18735,19240,-1415,-910,30,288.65,122
,20161220,18735,19240,18565,18565,17935,18090,18120,-1150,-1120,32,289.97,126
,20161221,18090,18120,18200,18475,18180,18475,18270,355,150,12,109.65,128
,20161222,18475,18270,18115,18115,17995,17995,18040,-275,-230,10,90.21,122
,20161223,17995,18040,17845,18485,17845,18220,18075,180,35,40,361.59,94
,20161226,18220,18075,18395,18395,16975,17355,17925,-720,-150,58,519.87,130
,20161227,17355,17925,17430,17535,17430,17535,17480,-390,-445,4,34.97,128
,20161228,17535,17480,17630,17630,17630,17630,17630,150,150,10,88.15,132
,20161229,17630,17630,17610,17795,17595,17775,17675,145,45,14,123.74,132
,20161230,17775,17675,,,,17675,17675,0,0,0,0.00,132
pb1709,20160920,14350,14350,,,,14535,14535,185,185,0,0.00,0
,20160921,14535,14535,,,,14710,14710,175,175,0,0.00,0
,20160922,14710,14710,,,,14840,14840,130,130,0,0.00,0
,20160923,14840,14840,,,,15195,15195,355,355,0,0.00,0
,20160926,15195,15195,,,,14835,14835,-360,-360,0,0.00,0
,20160927,14835,14835,14910,14910,14910,14910,14910,75,75,4,29.82,4
,20160928,14910,14910,,,,14335,14335,-575,-575,0,0.00,4
,20160929,14335,14335,14900,14905,14900,14905,14900,570,565,6,44.71,8
,20160930,14905,14900,15195,15195,15195,15195,15195,295,295,2,15.20,6
,20161010,15195,15195,15410,15410,15410,15410,15410,215,215,6,46.23,12
,20161011,15410,15410,,,,15410,15410,0,0,0,0.00,12
,20161012,15410,15410,15240,15260,15240,15260,15250,-150,-160,4,30.50,16
,20161013,15260,15250,15140,15140,15000,15035,15090,-215,-160,10,75.46,20
,20161014,15035,15090,,,,15090,15090,0,0,0,0.00,20
,20161017,15090,15090,,,,15090,15090,0,0,0,0.00,20
,20161018,15090,15090,15180,15250,15180,15250,15215,160,125,4,30.43,20
,20161019,15250,15215,,,,15160,15160,-55,-55,0,0.00,20
,20161020,15160,15160,14840,15250,14840,15250,15045,90,-115,4,30.09,22
,20161021,15250,15045,15180,15290,15050,15290,15170,245,125,12,91.05,22
,20161024,15290,15170,15230,15230,15230,15230,15230,60,60,2,15.23,22
,20161025,15230,15230,15260,15825,15260,15825,15370,595,140,16,122.97,16
,20161026,15825,15370,15965,15965,15735,15850,15850,480,480,14,110.96,16
,20161027,15850,15850,16005,16005,16005,16005,16005,155,155,4,32.01,20
,20161028,16005,16005,,,,16030,16030,25,25,0,0.00,20
,20161031,16030,16030,16020,16240,16020,16230,16130,200,100,28,225.86,22
,20161101,16230,16130,16220,16415,16205,16415,16255,285,125,12,97.54,26
,20161102,16415,16255,16275,16275,16265,16265,16270,10,15,6,48.82,32
,20161103,16265,16270,16110,16110,16110,16110,16110,-160,-160,2,16.11,30
,20161104,16110,16110,16505,16545,16490,16545,16515,435,405,10,82.59,34
,20161107,16545,16515,16545,17080,16545,16840,16820,325,305,64,538.38,56
,20161108,16840,16820,17115,17115,16675,16760,16740,-60,-80,64,535.70,86
,20161109,16760,16740,16725,16755,16725,16755,16740,15,0,4,33.48,86
,20161110,16755,16740,17400,17405,17400,17405,17400,665,660,10,87.01,86
,20161111,17405,17400,17535,17870,17345,17355,17545,-45,145,114,"1,000.30",112
,20161114,17355,17545,17340,18325,17095,17210,17995,-335,450,80,719.83,96
,20161115,17210,17995,17765,17960,17765,17960,17885,-35,-110,12,107.33,98
,20161116,17960,17885,18275,18410,18275,18410,18340,525,455,4,36.69,96
,20161117,18410,18340,,,,18340,18340,0,0,0,0.00,96
,20161118,18340,18340,17625,17625,17610,17610,17615,-730,-725,8,70.47,102
,20161121,17610,17615,17910,17970,17910,17970,17940,355,325,4,35.88,100
,20161122,17970,17940,18415,18880,18415,18745,18610,805,670,12,111.68,102
,20161123,18745,18610,18765,18825,18690,18825,18750,215,140,12,112.50,106
,20161124,18825,18750,18750,19135,18730,19135,18925,385,175,76,719.24,140
,20161125,19135,18925,19185,19440,19085,19160,19280,235,355,38,366.33,138
,20161128,19160,19280,20015,20625,19560,20605,20075,1325,795,92,923.53,144
,20161129,20605,20075,20870,21480,20870,21410,21335,1335,1260,262,"2,795.51",222
,20161130,21410,21335,21580,21640,20535,20570,20940,-765,-395,134,"1,403.02",222
,20161201,20570,20940,20410,20930,20335,20775,20690,-165,-250,36,372.42,220
,20161202,20775,20690,20775,20775,19600,19815,19920,-875,-770,28,278.93,218
,20161205,19815,19920,19735,20045,19345,20045,19655,125,-265,38,373.46,222
,20161206,20045,19655,20000,20270,19865,20055,20045,400,390,46,461.14,242
,20161207,20055,20045,20485,20790,20255,20750,20600,705,555,20,206.03,238
,20161208,20750,20600,21125,21125,20285,20490,20645,-110,45,14,144.52,240
,20161209,20490,20645,20750,20750,20105,20290,20430,-355,-215,10,102.17,240
,20161212,20290,20430,20360,20360,20360,20360,20360,-70,-70,2,20.36,240
,20161213,20360,20360,20345,20505,20080,20080,20270,-280,-90,26,263.55,228
,20161214,20080,20270,20765,20765,20185,20280,20435,10,165,60,613.18,240
,20161215,20280,20435,20220,20685,20220,20685,20500,250,65,44,451.11,224
,20161216,20685,20500,20370,20370,19955,19955,20135,-545,-365,30,302.06,232
,20161219,19955,20135,19865,19865,18725,18725,19300,-1410,-835,144,"1,389.75",170
,20161220,18725,19300,18565,18565,17945,18085,18075,-1215,-1225,134,"1,211.22",164
,20161221,18085,18075,18250,18755,18065,18620,18375,545,300,44,404.27,162
,20161222,18620,18375,18405,18405,18025,18025,18165,-350,-210,10,90.84,160
,20161223,18025,18165,18405,18465,18285,18310,18395,145,230,28,257.58,154
,20161226,18310,18395,17965,17965,17230,17230,17560,-1165,-835,22,193.18,150
,20161227,17230,17560,17520,17600,17435,17600,17525,40,-35,8,70.10,150
,20161228,17600,17525,17555,17885,17535,17800,17680,275,155,10,88.42,152
,20161229,17800,17680,17645,17775,17600,17710,17685,30,5,16,141.50,158
,20161230,17710,17685,17640,17705,17435,17590,17580,-95,-105,30,263.73,164
pb1710,20161018,15090,15090,,,,15215,15215,125,125,0,0.00,0
,20161019,15215,15215,15530,15530,15530,15530,15530,315,315,4,31.06,4
,20161020,15530,15530,15120,15350,15120,15350,15270,-180,-260,6,45.82,0
,20161021,15350,15270,15150,15655,15150,15655,15445,385,175,8,61.78,8
,20161024,15655,15445,15380,15380,15300,15300,15350,-145,-95,6,46.06,10
,20161025,15300,15350,15485,15695,15485,15695,15555,345,205,6,46.67,8
,20161026,15695,15555,15895,15915,15895,15915,15900,360,345,10,79.52,14
,20161027,15915,15900,16010,16010,16010,16010,16010,110,110,2,16.01,14
,20161028,16010,16010,,,,16035,16035,25,25,0,0.00,14
,20161031,16035,16035,16170,16500,15890,16195,16200,160,165,40,324.00,32
,20161101,16195,16200,16280,16370,16230,16370,16300,170,100,12,97.81,36
,20161102,16370,16300,16265,16265,16260,16265,16260,-35,-40,42,341.56,68
,20161103,16265,16260,16095,16195,16095,16195,16145,-65,-115,4,32.29,66
,20161104,16195,16145,16455,16605,16455,16585,16590,440,445,24,199.09,86
,20161107,16585,16590,16535,16755,16535,16755,16655,165,65,8,66.63,86
,20161108,16755,16655,16765,16795,16635,16635,16740,-20,85,10,83.70,86
,20161109,16635,16740,16835,17060,16775,16785,16925,45,185,20,169.26,86
,20161110,16785,16925,16935,17600,16935,17525,17540,600,615,76,666.63,96
,20161111,17525,17540,17555,17760,17340,17360,17410,-180,-130,94,818.46,92
,20161114,17360,17410,17385,18150,17265,17265,17910,-145,500,80,716.41,72
,20161115,17265,17910,17905,18345,17775,17895,17835,-15,-75,26,231.90,54
,20161116,17895,17835,18305,18335,18245,18245,18295,410,460,8,73.19,50
,20161117,18245,18295,,,,17980,17980,-315,-315,0,0.00,50
,20161118,17980,17980,17630,17630,17630,17630,17630,-350,-350,8,70.52,58
,20161121,17630,17630,17890,18030,17890,18030,17960,400,330,4,35.92,58
,20161122,18030,17960,18810,18925,18810,18925,18885,965,925,8,75.55,66
,20161123,18925,18885,18695,18965,18695,18895,18805,10,-80,12,112.84,70
,20161124,18895,18805,18710,19125,18710,19125,18895,320,90,68,642.49,136
,20161125,19125,18895,19210,19470,19000,19265,19300,370,405,56,540.50,154
,20161128,19265,19300,20110,20650,20110,20650,20505,1350,1205,22,225.56,152
,20161129,20650,20505,20965,21835,20965,21365,21350,860,845,144,"1,537.24",198
,20161130,21365,21350,21370,21455,20450,20450,20905,-900,-445,60,627.21,194
,20161201,20450,20905,20455,21000,20205,20775,20560,-130,-345,36,370.11,184
,20161202,20775,20560,20355,20355,19770,19770,20065,-790,-495,16,160.56,182
,20161205,19770,20065,19610,20045,19275,20045,19540,-20,-525,168,"1,641.65",80
,20161206,20045,19540,20035,20265,20035,20265,20150,725,610,4,40.30,80
,20161207,20265,20150,20040,20795,20040,20775,20595,625,445,8,82.39,88
,20161208,20775,20595,21035,21135,20285,20350,20695,-245,100,16,165.58,78
,20161209,20350,20695,,,,20550,20550,-145,-145,0,0.00,78
,20161212,20550,20550,,,,20505,20505,-45,-45,0,0.00,78
,20161213,20505,20505,20205,20380,20200,20345,20280,-160,-225,1810,"18,354.84",88
,20161214,20345,20280,20395,20670,20315,20315,20455,35,175,12,122.73,86
,20161215,20315,20455,20145,20680,20105,20660,20520,205,65,40,410.43,94
,20161216,20660,20520,20385,20400,19925,19925,20285,-595,-235,26,263.77,88
,20161219,19925,20285,19895,19895,18865,18865,19405,-1420,-880,60,582.15,96
,20161220,18865,19405,18565,18565,17675,18125,18015,-1280,-1390,112,"1,009.07",128
,20161221,18125,18015,18165,19150,18165,18380,18665,365,650,84,783.97,128
,20161222,18380,18665,18470,18470,18135,18135,18385,-530,-280,12,110.31,128
,20161223,18135,18385,18010,18450,18010,18370,18275,-15,-110,6,54.83,124
,20161226,18370,18275,18285,18375,17300,17300,17850,-975,-425,26,232.10,118
,20161227,17300,17850,17515,17605,17515,17600,17560,-250,-290,14,122.95,120
,20161228,17600,17560,17625,17625,17625,17625,17625,65,65,2,17.63,120
,20161229,17625,17625,,,,17630,17630,5,5,0,0.00,120
,20161230,17630,17630,17695,17695,17600,17640,17645,10,15,6,52.94,122
pb1711,20161116,17835,17835,,,,18295,18295,460,460,0,0.00,0
,20161117,18295,18295,,,,17855,17855,-440,-440,0,0.00,0
,20161118,17855,17855,,,,17505,17505,-350,-350,0,0.00,0
,20161121,17505,17505,,,,17505,17505,0,0,0,0.00,0
,20161122,17505,17505,18510,18920,18370,18750,18650,1245,1145,10,93.26,6
,20161123,18750,18650,18875,18875,18875,18875,18875,225,225,2,18.88,8
,20161124,18875,18875,18805,18805,18805,18805,18805,-70,-70,2,18.81,10
,20161125,18805,18805,18865,19200,18865,19010,19035,205,230,14,133.27,16
,20161128,19010,19035,20250,20365,20250,20365,20325,1330,1290,6,60.98,18
,20161129,20365,20325,21005,21905,20610,21255,21185,930,860,28,296.65,22
,20161130,21255,21185,21295,21295,20145,20360,20690,-825,-495,20,206.95,36
,20161201,20360,20690,20750,20950,19990,20920,20495,230,-195,12,122.98,36
,20161202,20920,20495,20745,20745,19720,19720,20045,-775,-450,8,80.19,34
,20161205,19720,20045,19650,20060,19215,20030,19535,-15,-510,28,273.55,32
,20161206,20030,19535,20145,20290,20145,20240,20230,705,695,12,121.41,36
,20161207,20240,20230,20200,20850,20200,20695,20760,465,530,54,560.58,62
,20161208,20695,20760,20910,21210,20345,20345,20905,-415,145,18,188.15,66
,20161209,20345,20905,20600,20600,20035,20250,20265,-655,-640,20,202.69,66
,20161212,20250,20265,20195,20550,20185,20185,20275,-80,10,8,81.12,66
,20161213,20185,20275,20110,20400,20100,20215,20205,-60,-70,1888,"19,076.92",48
,20161214,20215,20205,20445,20445,20100,20350,20290,145,85,22,223.22,50
,20161215,20350,20290,20260,20755,20205,20670,20535,380,245,38,390.19,64
,20161216,20670,20535,20315,20395,19995,19995,20235,-540,-300,24,242.87,58
,20161219,19995,20235,19600,19605,18815,18815,19160,-1420,-1075,38,364.11,68
,20161220,18815,19160,18535,18535,17815,18135,18005,-1025,-1155,24,216.09,74
,20161221,18135,18005,18320,18320,18320,18320,18320,315,315,2,18.32,74
,20161222,18320,18320,18450,18450,18450,18450,18450,130,130,2,18.45,74
,20161223,18450,18450,18385,18385,18385,18385,18385,-65,-65,2,18.39,76
,20161226,18385,18385,18125,18125,17415,17415,17815,-970,-570,16,142.53,84
,20161227,17415,17815,17540,17565,17460,17460,17530,-355,-285,8,70.13,82
,20161228,17460,17530,17600,18040,17600,17970,17815,440,285,12,106.89,80
,20161229,17970,17815,,,,17815,17815,0,0,0,0.00,80
,20161230,17815,17815,17520,17625,17520,17525,17560,-290,-255,10,87.82,84
pb1712,20161216,20535,20535,,,,20235,20235,-300,-300,0,0.00,0
,20161219,20235,20235,,,,18995,18995,-1240,-1240,0,0.00,0
,20161220,18995,18995,,,,17850,17850,-1145,-1145,0,0.00,0
,20161221,17850,17850,18220,18220,18220,18220,18220,370,370,2,18.22,2
,20161222,18220,18220,18160,18160,18160,18160,18160,-60,-60,2,18.16,4
,20161223,18160,18160,18405,18405,18405,18405,18405,245,245,2,18.41,6
,20161226,18405,18405,18410,18410,17275,17275,17765,-1130,-640,6,53.31,8
,20161227,17275,17765,17690,17695,17355,17695,17560,-70,-205,62,544.41,26
,20161228,17695,17560,17780,18020,17780,17940,17880,380,320,30,268.27,28
,20161229,17940,17880,17680,17795,17680,17795,17735,-85,-145,4,35.48,30
,20161230,17795,17735,17670,17730,17525,17525,17650,-210,-85,10,88.27,28
rb1601,20160104,1845,1841,1890,1910,1837,1837,1856,-4,15,12404,"23,030.63",76440
,20160105,1837,1856,1836,1846,1828,1845,1833,-11,-23,9360,"17,157.72",68520
,20160106,1845,1833,1840,1873,1840,1855,1855,22,22,12180,"22,601.16",58320
,20160107,1855,1855,1851,1854,1840,1848,1848,-7,-7,9240,"17,084.28",50760
,20160108,1848,1848,1842,1842,1819,1833,1829,-15,-19,13080,"23,935.02",38760
,20160111,1833,1829,1833,1836,1806,1814,1821,-15,-8,14760,"26,888.40",24660
,20160112,1814,1821,1823,1823,1729,1729,1775,-92,-46,21480,"38,127.42",9720
,20160113,1729,1775,1710,1721,1650,1691,1683,-84,-92,8100,"13,636.44",9360
,20160114,1691,1683,1679,1758,1679,1740,1739,57,56,1320,"2,296.68",8400
,20160115,1740,1739,1685,1774,1685,1705,1706,-34,-33,960,"1,638.12",8340
rb1602,20160104,1741,1747,1778,1778,1717,1730,1747,-17,0,5902,"10,312.32",29000
,20160105,1730,1747,1728,1747,1725,1747,1733,0,-14,5490,"9,517.10",26866
,20160106,1747,1733,1750,1752,1734,1744,1742,11,9,2858,"4,980.98",26414
,20160107,1744,1742,1738,1770,1738,1755,1762,13,20,5368,"9,459.25",25744
,20160108,1755,1762,1750,1755,1733,1738,1741,-24,-21,3038,"5,291.38",24426
,20160111,1738,1741,1741,1742,1728,1735,1735,-6,-6,1292,"2,242.26",23658
,20160112,1735,1735,1732,1739,1689,1696,1716,-39,-19,4250,"7,294.61",23122
,20160113,1696,1716,1690,1716,1682,1704,1695,-12,-21,10918,"18,509.13",24480
,20160114,1704,1695,1709,1738,1699,1733,1718,38,23,5796,"9,960.37",22028
,20160115,1733,1718,1737,1745,1730,1735,1736,17,18,2450,"4,255.59",21348
,20160118,1735,1736,1734,1797,1734,1793,1774,57,38,6076,"10,779.03",20478
,20160119,1793,1774,1849,1849,1794,1815,1804,41,30,5306,"9,573.20",17808
,20160120,1815,1804,1818,1822,1794,1796,1805,-8,1,8408,"15,181.40",13930
,20160121,1796,1805,1788,1810,1784,1790,1797,-15,-8,2324,"4,177.20",12730
,20160122,1790,1797,1794,1840,1788,1801,1803,4,6,2020,"3,643.40",11596
,20160125,1801,1803,1803,1812,1792,1804,1803,1,0,1888,"3,404.52",10746
,20160126,1804,1803,1795,1804,1793,1801,1800,-2,-3,1820,"3,276.95",9468
,20160127,1801,1800,1796,1807,1794,1799,1800,-1,0,1710,"3,079.09",8454
,20160128,1799,1800,1796,1797,1761,1766,1777,-34,-23,2092,"3,717.70",7654
,20160129,1766,1777,1760,1774,1746,1752,1763,-25,-14,3064,"5,403.86",5964
,20160201,1752,1763,1784,1830,1771,1775,1792,12,29,1164,"2,086.08",5520
,20160202,1775,1792,1777,1778,1740,1764,1766,-28,-26,1980,"3,498.00",5220
,20160203,1764,1766,1773,1773,1758,1760,1767,-6,1,600,"1,060.50",4680
,20160204,1760,1767,1765,1780,1761,1780,1771,13,4,240,425.16,4440
,20160205,1780,1771,1778,1778,1768,1768,1773,-3,2,240,425.52,4200
,20160215,1768,1773,1730,1750,1730,1750,1732,-23,-41,960,"1,663.20",3240
rb1603,20160104,1735,1742,1738,1777,1727,1729,1747,-13,5,3050,"5,328.57",21318
,20160105,1729,1747,1731,1745,1720,1745,1732,-2,-15,2188,"3,790.02",21106
,20160106,1745,1732,1748,1748,1730,1742,1737,10,5,2546,"4,423.51",21332
,20160107,1742,1737,1737,1752,1734,1739,1743,2,6,3804,"6,632.80",22296
,20160108,1739,1743,1739,1744,1716,1723,1727,-20,-16,4540,"7,840.75",23042
,20160111,1723,1727,1723,1731,1714,1716,1723,-11,-4,3232,"5,570.39",24178
,20160112,1716,1723,1721,1723,1683,1687,1702,-36,-21,3526,"6,002.20",25674
,20160113,1687,1702,1687,1699,1682,1692,1692,-10,-10,2964,"5,017.96",26322
,20160114,1692,1692,1698,1730,1693,1727,1714,35,22,3684,"6,315.38",25240
,20160115,1727,1714,1721,1737,1721,1733,1728,19,14,5136,"8,876.30",26254
,20160118,1733,1728,1733,1786,1729,1783,1763,55,35,5616,"9,906.58",24950
,20160119,1783,1763,1780,1805,1775,1804,1785,41,22,4380,"7,819.06",22712
,20160120,1804,1785,1807,1811,1786,1792,1797,7,12,2890,"5,193.87",21030
,20160121,1792,1797,1774,1799,1772,1788,1789,-9,-8,1612,"2,884.38",20614
,20160122,1788,1789,1787,1820,1787,1793,1803,4,14,1212,"2,185.62",20256
,20160125,1793,1803,1798,1806,1788,1794,1798,-9,-5,2480,"4,459.63",19494
,20160126,1794,1798,1797,1802,1785,1800,1797,2,-1,882,"1,585.03",19348
,20160127,1800,1797,1803,1818,1797,1807,1807,10,10,2050,"3,704.47",19692
,20160128,1807,1807,1809,1809,1766,1767,1789,-40,-18,1534,"2,745.19",19416
,20160129,1767,1789,1766,1789,1766,1774,1777,-15,-12,3284,"5,837.86",18364
,20160201,1774,1777,1778,1803,1778,1790,1792,13,15,1768,"3,168.34",17488
,20160202,1790,1792,1790,1796,1774,1776,1782,-16,-10,784,"1,397.28",17254
,20160203,1776,1782,1778,1786,1778,1784,1781,2,-1,1082,"1,927.54",16936
,20160204,1784,1781,1787,1808,1787,1804,1798,23,17,1512,"2,719.19",16386
,20160205,1804,1798,1812,1812,1785,1800,1794,2,-4,500,897.46,16392
,20160215,1800,1794,1798,1807,1788,1805,1797,11,3,1190,"2,139.36",15888
,20160216,1805,1797,1805,1807,1796,1799,1801,2,4,1106,"1,992.24",15630
,20160217,1799,1801,1796,1810,1796,1804,1804,3,3,828,"1,494.47",15544
,20160218,1804,1804,1800,1815,1800,1812,1811,8,7,1292,"2,340.05",14902
,20160219,1812,1811,1818,1830,1810,1830,1820,19,9,814,"1,482.26",14444
,20160222,1830,1820,1826,1893,1820,1893,1873,73,53,2312,"4,331.77",12930
,20160223,1893,1873,1890,1901,1860,1875,1883,2,10,2800,"5,274.29",10530
,20160224,1875,1883,1853,1886,1853,1875,1872,-8,-11,3158,"5,912.47",8322
,20160225,1875,1872,1884,1886,1864,1870,1874,-2,2,3016,"5,652.41",5986
,20160226,1870,1874,1882,1882,1830,1836,1844,-38,-30,1854,"3,420.15",4626
,20160229,1836,1844,1841,1852,1805,1835,1831,-9,-13,1324,"2,425.10",3840
,20160301,1835,1831,1889,1890,1810,1850,1833,19,2,4860,"8,911.08",3240
,20160302,1850,1833,1840,1868,1840,1868,1858,35,25,180,334.50,3180
,20160303,1868,1858,1850,1875,1809,1809,1844,-49,-14,180,332.04,3060
,20160304,1809,1844,1850,1869,1850,1869,1859,25,15,120,223.14,3060
,20160307,1869,1859,1868,1951,1868,1951,1884,92,25,360,678.24,3000
,20160308,1951,1884,1976,2034,1950,2034,1999,150,115,1320,"2,639.94",2820
,20160309,2034,1999,2050,2051,2001,2050,2010,51,11,1620,"3,256.44",1620
,20160310,2050,2010,,,,2010,2010,0,0,0,0.00,1620
,20160311,2010,2010,2008,2008,2008,2008,2008,-2,-2,60,120.48,1620
,20160314,2008,2008,,,,2008,2008,0,0,0,0.00,1620
,20160315,2008,2008,,,,2008,2008,0,0,0,0.00,1620
rb1604,20160104,1764,1769,1775,1780,1755,1755,1768,-14,-1,20,35.36,4106
,20160105,1755,1768,1762,1768,1736,1759,1759,-9,-9,70,123.16,4098
,20160106,1759,1759,1761,1769,1750,1756,1757,-3,-2,80,140.57,4084
,20160107,1756,1757,1757,1768,1750,1752,1758,-5,1,256,450.09,4068
,20160108,1752,1758,1750,1763,1719,1740,1743,-18,-15,560,976.10,4082
,20160111,1740,1743,1743,1751,1730,1737,1740,-6,-3,344,598.88,4072
,20160112,1737,1740,1741,1741,1724,1726,1730,-14,-10,488,844.70,4120
,20160113,1726,1730,1725,1730,1721,1723,1725,-7,-5,184,317.49,4096
,20160114,1723,1725,1726,1742,1714,1742,1723,17,-2,252,434.31,4004
,20160115,1742,1723,1735,1769,1735,1754,1750,31,27,418,731.74,4004
,20160118,1754,1750,1758,1813,1751,1808,1787,58,37,604,"1,079.56",4004
,20160119,1808,1787,1799,1816,1799,1816,1805,29,18,280,505.43,4112
,20160120,1816,1805,1811,1820,1796,1799,1800,-6,-5,438,788.67,4046
,20160121,1799,1800,1791,1805,1790,1792,1796,-8,-4,112,201.19,3994
,20160122,1792,1796,1791,1822,1787,1808,1801,12,5,1006,"1,811.91",4344
,20160125,1808,1801,1804,1831,1804,1815,1814,14,13,886,"1,608.00",4746
,20160126,1815,1814,1814,1826,1801,1817,1816,3,2,594,"1,079.15",5088
,20160127,1817,1816,1822,1849,1815,1840,1833,24,17,1456,"2,668.89",6004
,20160128,1840,1833,1840,1840,1800,1800,1829,-33,-4,1462,"2,674.73",6734
,20160129,1800,1829,1801,1812,1801,1810,1807,-19,-22,1242,"2,245.26",7134
,20160201,1810,1807,1824,1832,1815,1817,1826,10,19,882,"1,610.82",7050
,20160202,1817,1826,1807,1816,1801,1813,1806,-13,-20,434,784.23,7184
,20160203,1813,1806,1818,1826,1807,1824,1820,18,14,362,658.90,7416
,20160204,1824,1820,1829,1849,1829,1849,1840,29,20,280,515.38,7456
,20160205,1849,1840,1841,1841,1826,1833,1834,-7,-6,218,399.91,7542
,20160215,1833,1834,1838,1866,1820,1855,1846,21,12,610,"1,126.53",7534
,20160216,1855,1846,1858,1863,1853,1855,1858,9,12,728,"1,352.73",7452
,20160217,1855,1858,1853,1865,1850,1855,1857,-3,-1,266,494.19,7508
,20160218,1855,1857,1857,1863,1852,1861,1856,4,-1,246,456.67,7462
,20160219,1861,1856,1860,1881,1855,1879,1874,23,18,1106,"2,072.69",8150
,20160222,1879,1874,1875,1958,1874,1940,1924,66,50,2678,"5,154.72",7936
,20160223,1940,1924,1930,1936,1900,1907,1915,-17,-9,2512,"4,811.52",6694
,20160224,1907,1915,1907,1913,1895,1902,1902,-13,-13,1108,"2,108.34",6330
,20160225,1902,1902,1904,1921,1893,1893,1910,-9,8,598,"1,142.66",6168
,20160226,1893,1910,1905,1905,1870,1889,1885,-21,-25,356,671.22,6120
,20160229,1889,1885,1889,1926,1887,1926,1907,41,22,1086,"2,071.84",6516
,20160301,1926,1907,1944,1957,1901,1949,1935,42,28,1948,"3,770.66",6936
,20160302,1949,1935,1947,1970,1936,1960,1954,25,19,1714,"3,349.24",7080
,20160303,1960,1954,1953,1964,1929,1934,1945,-20,-9,574,"1,116.53",6950
,20160304,1934,1945,1935,1957,1924,1951,1942,6,-3,1298,"2,521.84",6900
,20160307,1951,1942,1971,2039,1951,2039,2013,97,71,802,"1,615.00",7068
,20160308,2039,2013,2174,2174,2050,2174,2142,161,129,2844,"6,094.50",6084
,20160309,2174,2142,2353,2353,2037,2199,2116,57,-26,1574,"3,331.91",5538
,20160310,2199,2116,2127,2199,2079,2126,2126,10,10,1908,"4,057.04",4866
,20160311,2126,2126,2110,2125,2064,2087,2103,-39,-23,700,"1,472.55",4584
,20160314,2087,2103,2093,2145,1997,2031,2048,-72,-55,1244,"2,548.67",4028
,20160315,2031,2048,2021,2059,2008,2010,2012,-38,-36,596,"1,199.65",3830
,20160316,2010,2012,2025,2045,2025,2038,2043,26,31,334,682.42,3806
,20160317,2038,2043,2084,2119,2059,2105,2086,62,43,488,"1,018.15",3740
,20160318,2105,2086,2136,2187,2123,2126,2139,40,53,308,659.03,3644
,20160321,2126,2139,2134,2209,2123,2178,2165,39,26,230,497.97,3570
,20160322,2178,2165,2126,2224,2126,2201,2203,36,38,236,520.14,3472
,20160323,2201,2203,2226,2296,2226,2262,2266,59,63,328,743.29,3322
,20160324,2262,2266,2272,2308,2229,2262,2261,-4,-5,512,"1,158.01",3288
,20160325,2262,2261,2290,2311,2272,2311,2295,50,34,508,"1,166.19",3080
,20160328,2311,2295,2343,2360,2290,2290,2328,-5,33,412,959.22,2998
,20160329,2290,2328,2311,2321,2281,2299,2300,-29,-28,316,726.84,3010
,20160330,2299,2300,2277,2309,2251,2268,2268,-32,-32,1126,"2,553.89",2840
,20160331,2268,2268,2280,2327,2233,2260,2275,-8,7,82,186.61,2820
,20160401,2260,2275,2250,2334,2250,2334,2292,59,17,120,275.04,2820
,20160405,2334,2292,2263,2350,2263,2350,2328,58,36,240,558.78,2640
,20160406,2350,2328,,,,2328,2328,0,0,0,0.00,2640
,20160407,2328,2328,2426,2430,2423,2426,2427,98,99,840,"2,038.74",1860
,20160408,2426,2427,,,,2426,2426,-1,-1,0,0.00,1860
,20160411,2426,2426,2456,2550,2440,2550,2482,124,56,180,446.76,1740
,20160412,2550,2482,2402,2530,2402,2530,2450,48,-32,180,441.06,1680
,20160413,2530,2450,2490,2490,2490,2490,2490,40,40,60,149.40,1620
,20160414,2490,2490,2460,2460,2400,2400,2415,-90,-75,240,579.60,1500
,20160415,2400,2415,2450,2450,2450,2450,2450,35,35,60,147.00,1440
rb1605,20160104,1784,1789,1821,1846,1773,1777,1797,-12,8,6700936,"12,044,095.91",3062134
,20160105,1777,1797,1779,1789,1761,1789,1778,-8,-19,6413148,"11,404,976.09",3171882
,20160106,1789,1778,1787,1790,1769,1775,1776,-3,-2,4603662,"8,180,671.02",3101762
,20160107,1775,1776,1770,1786,1766,1773,1776,-3,0,4652628,"8,264,383.37",3073988
,20160108,1773,1776,1769,1775,1747,1759,1761,-17,-15,6658038,"11,729,745.83",2885064
,20160111,1759,1761,1757,1772,1748,1758,1762,-3,1,5081394,"8,954,313.08",2834258
,20160112,1758,1762,1759,1765,1739,1741,1750,-21,-12,5333022,"9,332,904.46",2925678
,20160113,1741,1750,1741,1752,1735,1740,1743,-10,-7,3591540,"6,261,061.01",2791556
,20160114,1740,1743,1742,1759,1732,1758,1745,15,2,4110300,"7,173,864.03",2851872
,20160115,1758,1745,1758,1787,1754,1778,1774,33,29,6649864,"11,799,077.38",3152676
,20160118,1778,1774,1777,1832,1770,1827,1807,53,33,9156242,"16,553,162.27",3353516
,20160119,1827,1807,1825,1841,1817,1839,1827,32,20,6967734,"12,733,911.08",3331732
,20160120,1839,1827,1838,1842,1813,1818,1826,-9,-1,6237726,"11,393,979.89",3187010
,20160121,1818,1826,1815,1824,1805,1808,1813,-18,-13,5493208,"9,963,030.61",3248392
,20160122,1808,1813,1810,1856,1807,1823,1829,10,16,7687002,"14,065,786.06",3539188
,20160125,1823,1829,1828,1856,1823,1840,1841,11,12,7650122,"14,084,540.01",3646874
,20160126,1840,1841,1840,1848,1832,1845,1840,4,-1,4321346,"7,954,573.15",3622822
,20160127,1845,1840,1850,1871,1840,1863,1858,23,18,7017400,"13,040,162.51",3667088
,20160128,1863,1858,1861,1862,1810,1815,1841,-43,-17,7189268,"13,240,588.42",3326818
,20160129,1815,1841,1813,1827,1805,1814,1815,-27,-26,5938474,"10,781,813.58",3157788
,20160201,1814,1815,1816,1845,1815,1819,1831,4,16,5697330,"10,432,176.06",2911900
,20160202,1819,1831,1820,1824,1801,1815,1812,-16,-19,4090540,"7,412,689.54",2493290
,20160203,1815,1812,1820,1830,1807,1826,1819,14,7,3099622,"5,640,164.95",2307344
,20160204,1826,1819,1826,1855,1825,1851,1842,32,23,3515826,"6,477,921.69",2254350
,20160205,1851,1842,1853,1862,1826,1843,1842,1,0,2790060,"5,139,324.30",2088616
,20160215,1843,1842,1835,1880,1833,1872,1860,30,18,2680436,"4,987,712.16",2221548
,20160216,1872,1860,1872,1880,1861,1865,1871,5,11,2707824,"5,066,660.10",2279270
,20160217,1865,1871,1866,1876,1855,1861,1864,-10,-7,3197078,"5,961,372.43",2216192
,20160218,1861,1864,1864,1871,1855,1870,1861,6,-3,2833084,"5,275,085.57",2258336
,20160219,1870,1861,1872,1899,1864,1897,1881,36,20,4259322,"8,012,738.64",2307378
,20160222,1897,1881,1897,1968,1892,1962,1934,81,53,6568536,"12,705,853.02",2474776
,20160223,1962,1934,1957,1965,1921,1926,1941,-8,7,5118530,"9,935,112.85",2267538
,20160224,1926,1941,1922,1937,1916,1929,1926,-12,-15,3504668,"6,752,336.76",2243998
,20160225,1929,1926,1929,1961,1924,1928,1941,2,15,4325944,"8,399,887.52",2347758
,20160226,1928,1941,1932,1939,1898,1922,1916,-19,-25,4146132,"7,944,446.78",2272552
,20160229,1922,1916,1922,1973,1912,1969,1939,53,23,6078558,"11,786,353.87",2446476
,20160301,1969,1939,1975,2010,1961,1994,1982,55,43,6064250,"12,021,962.29",2456280
,20160302,1994,1982,1997,2009,1984,1993,1996,11,14,5582604,"11,147,541.94",2215504
,20160303,1993,1996,1990,1999,1967,1974,1983,-22,-13,4325658,"8,579,753.93",2049588
,20160304,1974,1983,1972,1997,1952,1987,1975,4,-8,4750600,"9,386,020.06",1843186
,20160307,1987,1975,1990,2073,1983,2073,2032,98,57,3279116,"6,663,923.91",1725824
,20160308,2073,2032,2194,2194,2077,2194,2147,162,115,6192598,"13,296,562.61",1593412
,20160309,2194,2147,2149,2163,2035,2104,2097,-43,-50,8678072,"18,201,360.13",1289634
,20160310,2104,2097,2112,2201,2107,2130,2147,33,50,11325298,"24,326,503.05",1511022
,20160311,2130,2147,2111,2133,2068,2085,2108,-62,-39,4663174,"9,833,447.52",1290812
,20160314,2085,2108,2058,2137,2034,2041,2087,-67,-21,5086806,"10,620,326.93",1209034
,20160315,2041,2087,2042,2063,2010,2022,2037,-65,-50,2972086,"6,054,879.69",1103782
,20160316,2022,2037,2012,2066,2012,2065,2045,28,8,2414432,"4,938,645.62",1182966
,20160317,2065,2045,2070,2135,2066,2134,2100,89,55,3378884,"7,098,886.58",1190256
,20160318,2134,2100,2135,2204,2135,2155,2172,55,72,4583820,"9,959,970.33",1138644
,20160321,2155,2172,2155,2244,2137,2192,2186,20,14,4232524,"9,252,958.87",1006140
,20160322,2192,2186,2198,2234,2190,2214,2215,28,29,2516072,"5,573,936.69",995244
,20160323,2214,2215,2213,2309,2205,2268,2264,53,49,3987608,"9,030,717.57",1039842
,20160324,2268,2264,2274,2288,2208,2225,2241,-39,-23,4923144,"11,034,135.20",1033990
,20160325,2225,2241,2221,2300,2217,2298,2260,57,19,3833882,"8,665,166.55",1134994
,20160328,2298,2260,2304,2348,2267,2276,2317,16,57,4378692,"10,149,416.79",982832
,20160329,2276,2317,2279,2313,2274,2290,2291,-27,-26,2485030,"5,695,467.63",906206
,20160330,2290,2291,2291,2296,2233,2256,2260,-35,-31,2193900,"4,960,394.60",751798
,20160331,2256,2260,2257,2287,2238,2260,2258,0,-2,1416578,"3,199,855.38",650948
,20160401,2260,2258,2266,2322,2266,2322,2287,64,29,972398,"2,224,681.23",568562
,20160405,2322,2287,2330,2359,2288,2351,2328,64,41,835324,"1,944,965.60",547212
,20160406,2351,2328,2351,2368,2325,2350,2345,22,17,774116,"1,815,884.44",504606
,20160407,2350,2345,2350,2376,2336,2357,2352,12,7,597030,"1,404,626.66",492406
,20160408,2357,2352,2360,2378,2348,2370,2364,18,12,479042,"1,132,591.56",494824
,20160411,2370,2364,2375,2493,2375,2482,2447,118,83,873374,"2,137,198.15",434800
,20160412,2482,2447,2490,2503,2455,2498,2479,51,32,643480,"1,595,389.52",362254
,20160413,2498,2479,2499,2537,2457,2466,2478,-13,-1,838978,"2,079,220.92",261896
,20160414,2466,2478,2460,2505,2457,2459,2481,-19,3,436084,"1,082,301.55",227530
,20160415,2459,2481,2460,2469,2421,2422,2442,-59,-39,282602,"690,154.73",197064
,20160418,2422,2442,2418,2516,2406,2488,2458,46,16,320998,"789,123.53",184898
,20160419,2488,2458,2493,2605,2493,2605,2551,147,93,268656,"685,553.71",185936
,20160420,2605,2551,2600,2704,2600,2704,2671,153,120,251048,"670,557.87",169466
,20160421,2704,2671,2730,2911,2717,2891,2838,220,167,383600,"1,088,919.80",138034
,20160422,2891,2838,2830,2869,2741,2750,2796,-88,-42,300990,"841,816.38",105306
,20160425,2750,2796,2740,2888,2740,2792,2802,-4,6,189236,"530,369.45",98158
,20160426,2792,2802,2761,2795,2672,2709,2747,-93,-55,103214,"283,617.04",81530
,20160427,2709,2747,2707,2729,2600,2635,2664,-112,-83,83170,"221,609.69",66496
,20160428,2635,2664,2650,2677,2586,2651,2630,-13,-34,69000,"181,506.18",51238
,20160429,2651,2630,2665,2787,2652,2787,2727,157,97,56456,"153,992.99",35490
,20160503,2787,2727,2829,2829,2716,2740,2760,13,33,12090,"33,376.68",29520
,20160504,2740,2760,2705,2729,2651,2655,2687,-105,-73,6900,"18,546.84",24000
,20160505,2655,2687,2650,2651,2530,2530,2600,-157,-87,8640,"22,466.46",18060
,20160506,2530,2600,2533,2566,2503,2556,2527,-44,-73,3780,"9,552.84",16260
,20160509,2556,2527,2547,2567,2406,2425,2458,-102,-69,5400,"13,273.26",12720
,20160510,2425,2458,2326,2545,2320,2545,2454,87,-4,6600,"16,196.64",7800
,20160511,2545,2454,2574,2601,2550,2601,2594,147,140,2160,"5,604.66",6000
,20160512,2601,2594,2700,2827,2428,2440,2737,-154,143,2880,"7,884.90",3900
,20160513,2440,2737,2572,2572,2572,2572,2572,-165,-165,120,308.64,3780
,20160516,2572,2572,,,,2340,2340,-232,-232,0,0.00,3780
rb1606,20160104,1771,1772,1781,1815,1759,1763,1781,-9,9,3422,"6,097.87",16188
,20160105,1763,1781,1763,1771,1748,1771,1762,-10,-19,2062,"3,635.23",16606
,20160106,1771,1762,1769,1774,1755,1764,1763,2,1,1136,"2,003.42",16302
,20160107,1764,1763,1756,1772,1756,1763,1765,0,2,1246,"2,199.64",16580
,20160108,1763,1765,1767,1767,1738,1749,1752,-16,-13,2142,"3,753.89",16826
,20160111,1749,1752,1750,1758,1742,1745,1750,-7,-2,1466,"2,565.61",17040
,20160112,1745,1750,1748,1750,1725,1725,1737,-25,-13,1658,"2,881.14",17398
,20160113,1725,1737,1724,1738,1722,1728,1729,-9,-8,788,"1,362.88",17544
,20160114,1728,1729,1729,1742,1719,1742,1728,13,-1,1076,"1,859.39",17710
,20160115,1742,1728,1743,1767,1738,1758,1757,30,29,1800,"3,162.61",17662
,20160118,1758,1757,1755,1819,1754,1809,1789,52,32,3062,"5,479.61",16938
,20160119,1809,1789,1805,1820,1800,1818,1807,29,18,1758,"3,178.26",16874
,20160120,1818,1807,1819,1832,1795,1803,1813,-4,6,2812,"5,100.90",16534
,20160121,1803,1813,1800,1808,1786,1786,1796,-27,-17,2748,"4,935.53",16646
,20160122,1786,1796,1792,1835,1788,1808,1818,12,22,5068,"9,216.53",16288
,20160125,1808,1818,1810,1833,1806,1823,1821,5,3,3432,"6,252.18",16204
,20160126,1823,1821,1820,1825,1812,1825,1817,4,-4,1552,"2,821.39",16124
,20160127,1825,1817,1826,1842,1819,1837,1832,20,15,2160,"3,958.44",16168
,20160128,1837,1832,1836,1836,1791,1795,1818,-37,-14,1304,"2,371.26",16096
,20160129,1795,1818,1795,1803,1785,1796,1795,-22,-23,1626,"2,919.99",16138
,20160201,1796,1795,1796,1819,1795,1800,1808,5,13,1620,"2,929.11",16022
,20160202,1800,1808,1800,1803,1785,1795,1793,-13,-15,1912,"3,428.51",16038
,20160203,1795,1793,1799,1806,1789,1801,1799,8,6,942,"1,694.95",15820
,20160204,1801,1799,1801,1829,1801,1825,1817,26,18,1328,"2,413.92",15684
,20160205,1825,1817,1824,1832,1802,1820,1816,3,-1,832,"1,511.22",15688
,20160215,1820,1816,1760,1860,1760,1841,1831,25,15,970,"1,776.83",15802
,20160216,1841,1831,1847,1850,1832,1834,1841,3,10,804,"1,480.31",15822
,20160217,1834,1841,1839,1845,1827,1829,1834,-12,-7,854,"1,566.51",15824
,20160218,1829,1834,1834,1839,1828,1838,1833,4,-1,798,"1,462.90",15840
,20160219,1838,1833,1841,1859,1836,1859,1846,26,13,2002,"3,696.73",15916
,20160222,1859,1846,1858,1925,1853,1924,1896,78,50,5042,"9,562.77",15462
,20160223,1924,1896,1911,1925,1890,1900,1910,4,14,2828,"5,402.15",15034
,20160224,1900,1910,1901,1907,1881,1891,1894,-19,-16,2376,"4,502.01",14648
,20160225,1891,1894,1893,1919,1851,1894,1903,0,9,2236,"4,256.09",14660
,20160226,1894,1903,1892,1895,1862,1882,1878,-21,-25,1298,"2,438.55",14638
,20160229,1882,1878,1879,1920,1873,1916,1896,38,18,2408,"4,565.89",14802
,20160301,1916,1896,1922,1944,1902,1934,1930,38,34,3800,"7,335.69",14226
,20160302,1934,1930,1938,1950,1911,1943,1939,13,9,3050,"5,914.26",13694
,20160303,1943,1939,1945,1972,1926,1933,1941,-6,2,2034,"3,949.26",13548
,20160304,1933,1941,1935,1957,1921,1948,1938,7,-3,2282,"4,424.49",13506
,20160307,1948,1938,1951,2034,1951,2033,2001,95,63,5104,"10,214.40",13532
,20160308,2033,2001,2101,2101,2038,2101,2089,100,88,11702,"24,455.23",10736
,20160309,2101,2089,2102,2158,1931,2061,2053,-28,-36,12494,"25,652.01",10556
,20160310,2061,2053,2053,2150,2053,2080,2107,27,54,9368,"19,743.76",10518
,20160311,2080,2107,2066,2082,2031,2040,2061,-67,-46,4018,"8,284.27",10486
,20160314,2040,2061,2015,2091,1995,1998,2035,-63,-26,5086,"10,351.65",10372
,20160315,1998,2035,1990,2015,1953,1975,1995,-60,-40,2890,"5,765.59",10260
,20160316,1975,1995,1981,2018,1978,2013,1995,18,0,1860,"3,711.45",10406
,20160317,2013,1995,2022,2082,2019,2076,2052,81,57,2922,"5,998.00",10522
,20160318,2076,2052,2082,2149,2079,2107,2111,55,59,6768,"14,293.64",10782
,20160321,2107,2111,2096,2175,2084,2130,2126,19,15,4932,"10,489.51",10714
,20160322,2130,2126,2125,2169,2122,2155,2152,29,26,2148,"4,623.15",10644
,20160323,2155,2152,2136,2225,2136,2193,2191,41,39,5134,"11,249.99",10576
,20160324,2193,2191,2183,2203,2127,2137,2158,-54,-33,4130,"8,915.00",10398
,20160325,2137,2158,2196,2214,2128,2214,2168,56,10,3780,"8,198.49",10822
,20160328,2214,2168,2177,2231,2164,2166,2206,-2,38,2876,"6,346.75",10776
,20160329,2166,2206,2165,2201,2165,2194,2181,-12,-25,2430,"5,301.58",10600
,20160330,2194,2181,2190,2192,2150,2167,2164,-14,-17,2764,"5,983.36",10226
,20160331,2167,2164,2174,2192,2153,2180,2170,16,6,1058,"2,296.86",10136
,20160401,2180,2170,2188,2225,2187,2222,2202,52,32,1594,"3,511.30",9776
,20160405,2222,2202,2227,2243,2192,2239,2219,37,17,1416,"3,142.51",9884
,20160406,2239,2219,2238,2245,2208,2222,2224,3,5,1658,"3,687.95",9784
,20160407,2222,2224,2218,2235,2210,2221,2222,-3,-2,1410,"3,133.11",9950
,20160408,2221,2222,2220,2230,2210,2221,2220,-1,-2,1790,"3,975.47",9954
,20160411,2221,2220,2229,2348,2219,2340,2303,120,83,4292,"9,887.46",8988
,20160412,2340,2303,2345,2383,2330,2382,2349,79,46,3182,"7,476.42",8520
,20160413,2382,2349,2396,2469,2380,2409,2413,60,64,5710,"13,779.26",7760
,20160414,2409,2413,2372,2446,2372,2393,2412,-20,-1,4026,"9,714.72",7126
,20160415,2393,2412,2397,2405,2366,2366,2384,-46,-28,1956,"4,664.97",6854
,20160418,2366,2384,2365,2455,2359,2435,2411,51,27,1978,"4,770.53",6580
,20160419,2435,2411,2450,2552,2445,2542,2486,131,75,2440,"6,066.71",6140
,20160420,2542,2486,2525,2635,2525,2635,2600,149,114,3556,"9,246.83",6436
,20160421,2635,2600,2679,2830,2629,2797,2747,197,147,5530,"15,196.05",6226
,20160422,2797,2747,2765,2795,2668,2687,2715,-60,-32,7686,"20,870.26",5698
,20160425,2687,2715,2691,2810,2660,2690,2723,-25,8,8040,"21,896.18",6362
,20160426,2690,2723,2654,2698,2571,2612,2649,-111,-74,5024,"13,313.09",6294
,20160427,2612,2649,2612,2647,2514,2562,2583,-87,-66,4468,"11,541.32",6098
,20160428,2562,2583,2580,2584,2516,2577,2561,-6,-22,4214,"10,792.25",5982
,20160429,2577,2561,2594,2658,2572,2654,2618,93,57,5360,"14,034.32",5704
,20160503,2654,2618,2631,2631,2531,2556,2562,-62,-56,3312,"8,485.71",5138
,20160504,2556,2562,2532,2571,2486,2521,2524,-41,-38,3072,"7,753.97",4754
,20160505,2521,2524,2525,2549,2372,2372,2460,-152,-64,4724,"11,623.51",4932
,20160506,2372,2460,2380,2418,2359,2412,2393,-48,-67,2634,"6,304.54",4864
,20160509,2412,2393,2439,2439,2249,2249,2325,-144,-68,3442,"8,003.50",4760
,20160510,2249,2325,2203,2235,2153,2207,2195,-118,-130,4126,"9,059.51",4318
,20160511,2207,2195,2209,2270,2206,2261,2234,66,39,4486,"10,024.06",4352
,20160512,2261,2234,2257,2336,2201,2205,2275,-29,41,5864,"13,344.91",4236
,20160513,2205,2275,2199,2208,2138,2138,2161,-137,-114,2422,"5,235.83",4240
,20160516,2138,2161,2104,2185,2077,2135,2150,-26,-11,2010,"4,322.47",4148
,20160517,2135,2150,2147,2169,2101,2160,2133,10,-17,1768,"3,772.86",4254
,20160518,2160,2133,2145,2173,2088,2101,2139,-32,6,2028,"4,339.05",4108
,20160519,2101,2139,2140,2140,2077,2108,2106,-31,-33,824,"1,735.48",4000
,20160520,2108,2106,2096,2129,2092,2114,2107,8,1,714,"1,504.52",3860
,20160523,2114,2107,2110,2110,1980,2015,2025,-92,-82,2696,"5,461.82",2682
,20160524,2015,2025,2023,2031,1995,2011,2011,-14,-14,362,728.11,2598
,20160525,2011,2011,2024,2041,1987,1993,2009,-18,-2,492,988.91,2438
,20160526,1993,2009,1973,2020,1973,2016,2004,7,-5,428,857.79,2262
,20160527,2016,2004,2039,2088,1981,2077,2022,73,18,566,"1,144.68",2294
,20160530,2077,2022,2069,2087,1918,1948,1970,-74,-52,1094,"2,155.21",2044
,20160531,1948,1970,1997,1997,1904,1930,1931,-40,-39,1844,"3,562.32",1680
,20160601,1930,1931,1917,1919,1880,1880,1904,-51,-27,480,914.10,1440
,20160602,1880,1904,1858,1898,1858,1898,1878,-6,-26,120,225.36,1320
,20160603,1898,1878,1920,1920,1900,1902,1904,24,26,300,571.32,1320
,20160606,1902,1904,1902,2005,1902,2005,1929,101,25,600,"1,157.52",1380
,20160607,2005,1929,2000,2000,2000,2000,2000,71,71,60,120.00,1380
,20160608,2000,2000,,,,2000,2000,0,0,0,0.00,1380
,20160613,2000,2000,2000,2000,2000,2000,2000,0,0,180,360.00,1380
,20160614,2000,2000,,,,2000,2000,0,0,0,0.00,1380
,20160615,2000,2000,,,,2000,2000,0,0,0,0.00,1380
rb1607,20160104,1786,1782,1828,1828,1774,1774,1777,-8,-5,232,412.30,6398
,20160105,1774,1777,1775,1780,1763,1778,1775,1,-2,54,95.89,6404
,20160106,1778,1775,1780,1780,1768,1770,1768,-5,-7,222,392.66,6406
,20160107,1770,1768,1775,1778,1770,1771,1774,3,6,58,102.90,6386
,20160108,1771,1774,1755,1769,1750,1758,1757,-16,-17,48,84.36,6376
,20160111,1758,1757,1757,1782,1750,1762,1763,5,6,84,148.11,6374
,20160112,1762,1763,1744,1750,1732,1733,1742,-30,-21,180,313.70,6426
,20160113,1733,1742,1731,1734,1722,1723,1729,-19,-13,812,"1,404.09",6968
,20160114,1723,1729,1730,1738,1718,1736,1728,7,-1,572,988.77,7304
,20160115,1736,1728,1739,1765,1735,1755,1751,27,23,214,374.89,7312
,20160118,1755,1751,1757,1809,1751,1800,1783,49,32,678,"1,209.41",7026
,20160119,1800,1783,1803,1818,1798,1818,1809,35,26,194,350.96,7024
,20160120,1818,1809,1807,1824,1795,1798,1805,-11,-4,342,617.38,7080
,20160121,1798,1805,1796,1805,1785,1794,1797,-11,-8,154,276.81,7076
,20160122,1794,1797,1798,1828,1798,1804,1815,7,18,150,272.28,7068
,20160125,1804,1815,1808,1831,1808,1818,1823,3,8,154,280.77,7094
,20160126,1818,1823,1817,1824,1817,1822,1818,-1,-5,162,294.61,7072
,20160127,1822,1818,1827,1840,1819,1835,1831,17,13,330,604.48,7142
,20160128,1835,1831,1828,1836,1800,1800,1816,-31,-15,442,802.77,6940
,20160129,1800,1816,1797,1805,1785,1793,1790,-23,-26,300,537.21,7130
,20160201,1793,1790,1805,1819,1796,1796,1811,6,21,166,300.77,7158
,20160202,1796,1811,1794,1802,1782,1790,1796,-21,-15,100,179.61,7116
,20160203,1790,1796,1802,1803,1782,1800,1792,4,-4,446,799.42,7302
,20160204,1800,1792,1807,1824,1802,1822,1810,30,18,252,456.28,7342
,20160205,1822,1810,1824,1824,1798,1812,1809,2,-1,256,463.24,7428
,20160215,1812,1809,1792,1846,1792,1835,1823,26,14,308,561.74,7438
,20160216,1835,1823,1839,1849,1831,1836,1838,13,15,344,632.28,7458
,20160217,1836,1838,1827,1841,1827,1834,1833,-4,-5,148,271.37,7458
,20160218,1834,1833,1832,1838,1829,1835,1832,2,-1,230,421.52,7468
,20160219,1835,1832,1837,1854,1834,1853,1843,21,11,498,917.86,7446
,20160222,1853,1843,1848,1918,1848,1911,1889,68,46,802,"1,515.56",7420
,20160223,1911,1889,1903,1915,1881,1892,1899,3,10,400,759.67,7490
,20160224,1892,1899,1883,1898,1882,1888,1888,-11,-11,202,381.42,7496
,20160225,1888,1888,1892,1913,1882,1882,1902,-6,14,302,574.63,7494
,20160226,1882,1902,1884,1884,1851,1869,1868,-33,-34,866,"1,618.25",7516
,20160229,1869,1868,1868,1896,1856,1896,1873,28,5,2436,"4,563.60",7510
,20160301,1896,1873,1900,1929,1890,1916,1906,43,33,992,"1,891.27",7504
,20160302,1916,1906,1922,1940,1914,1930,1927,24,21,1150,"2,216.65",7342
,20160303,1930,1927,1939,1949,1922,1923,1934,-4,7,1002,"1,938.50",7070
,20160304,1923,1934,1921,1943,1917,1936,1932,2,-2,714,"1,379.78",7080
,20160307,1936,1932,1941,2028,1937,2028,1993,96,61,1578,"3,146.45",7086
,20160308,2028,1993,2075,2152,2028,2152,2126,159,133,2566,"5,455.83",7042
,20160309,2152,2126,2128,2128,2019,2039,2050,-87,-76,3138,"6,435.51",7496
,20160310,2039,2050,2069,2148,2050,2064,2082,14,32,1720,"3,581.21",7298
,20160311,2064,2082,2046,2061,2015,2020,2044,-62,-38,694,"1,419.10",7452
,20160314,2020,2044,2000,2066,1995,1995,2023,-49,-21,1324,"2,679.51",7022
,20160315,1995,2023,1986,2008,1958,1958,1977,-65,-46,512,"1,012.53",7114
,20160316,1958,1977,1968,1997,1968,1995,1979,18,2,536,"1,061.06",7086
,20160317,1995,1979,1990,2054,1990,2052,2021,73,42,562,"1,136.08",7120
,20160318,2052,2021,2059,2110,2051,2072,2078,51,57,2224,"4,622.04",7022
,20160321,2072,2078,2070,2151,2054,2113,2095,35,17,1392,"2,916.56",6984
,20160322,2113,2095,2111,2152,2111,2125,2134,30,39,708,"1,511.51",6990
,20160323,2125,2134,2130,2200,2119,2164,2162,30,28,1068,"2,309.52",7040
,20160324,2164,2162,2161,2172,2085,2091,2118,-71,-44,1004,"2,126.63",7032
,20160325,2091,2118,2102,2149,2093,2149,2122,31,4,1318,"2,797.15",6952
,20160328,2149,2122,2160,2172,2100,2108,2153,-14,31,2048,"4,410.75",7058
,20160329,2108,2153,2119,2136,2104,2122,2121,-31,-32,844,"1,790.38",7182
,20160330,2122,2121,2122,2127,2083,2096,2095,-25,-26,594,"1,244.93",7092
,20160331,2096,2095,2103,2120,2089,2111,2103,16,8,496,"1,043.38",7038
,20160401,2111,2103,2119,2153,2119,2151,2141,48,38,992,"2,124.32",7018
,20160405,2151,2141,2160,2179,2136,2172,2158,31,17,1310,"2,827.13",7044
,20160406,2172,2158,2177,2180,2148,2158,2160,0,2,416,898.83,7064
,20160407,2158,2160,2170,2182,2156,2171,2168,11,8,250,542.09,7044
,20160408,2171,2168,2162,2182,2160,2176,2170,8,2,500,"1,085.14",6964
,20160411,2176,2170,2170,2279,2170,2267,2230,97,60,2872,"6,407.16",6548
,20160412,2267,2230,2270,2317,2258,2314,2282,84,52,1532,"3,496.43",6488
,20160413,2314,2282,2314,2410,2303,2334,2338,52,56,4880,"11,414.00",5834
,20160414,2334,2338,2323,2353,2305,2310,2325,-28,-13,1686,"3,921.26",5562
,20160415,2310,2325,2308,2322,2294,2294,2308,-31,-17,762,"1,759.24",5556
,20160418,2294,2308,2275,2388,2275,2371,2337,63,29,1428,"3,338.27",5318
,20160419,2371,2337,2387,2470,2383,2467,2424,130,87,1798,"4,359.15",4950
,20160420,2467,2424,2459,2569,2459,2569,2542,145,118,1208,"3,071.68",4870
,20160421,2569,2542,2606,2694,2568,2694,2650,152,108,2104,"5,575.78",5108
,20160422,2694,2650,2735,2735,2570,2604,2626,-46,-24,2250,"5,909.65",4870
,20160425,2604,2626,2592,2750,2574,2612,2654,-14,28,2548,"6,764.05",4882
,20160426,2612,2654,2601,2625,2517,2554,2574,-100,-80,1416,"3,644.96",4456
,20160427,2554,2574,2576,2578,2461,2499,2507,-75,-67,918,"2,302.01",4166
,20160428,2499,2507,2500,2530,2464,2530,2503,23,-4,656,"1,642.19",4114
,20160429,2530,2503,2539,2578,2529,2575,2559,72,56,760,"1,944.88",4066
,20160503,2575,2559,2557,2557,2431,2470,2470,-89,-89,822,"2,030.97",3976
,20160504,2470,2470,2435,2452,2366,2390,2413,-80,-57,558,"1,346.69",3876
,20160505,2390,2413,2400,2419,2308,2312,2363,-101,-50,1384,"3,271.19",3834
,20160506,2312,2363,2321,2344,2221,2335,2318,-28,-45,796,"1,845.20",3768
,20160509,2335,2318,2351,2390,2178,2178,2229,-140,-89,642,"1,431.32",3752
,20160510,2178,2229,2135,2215,2038,2153,2126,-76,-103,1442,"3,066.41",3696
,20160511,2153,2126,2165,2187,2130,2170,2168,44,42,1200,"2,601.69",3780
,20160512,2170,2168,2171,2220,2122,2122,2182,-46,14,2298,"5,014.84",3370
,20160513,2122,2182,2126,2129,2051,2055,2068,-127,-114,2048,"4,236.73",3962
,20160516,2055,2068,2042,2098,2031,2070,2073,2,5,890,"1,845.80",3922
,20160517,2070,2073,2068,2139,2058,2117,2087,44,14,998,"2,083.03",3946
,20160518,2117,2087,2127,2148,2051,2064,2107,-23,20,948,"1,997.84",3912
,20160519,2064,2107,2065,2090,2051,2071,2063,-36,-44,820,"1,692.33",3950
,20160520,2071,2063,2049,2095,2048,2081,2077,18,14,336,698.10,3946
,20160523,2081,2077,2070,2070,1952,1985,1975,-92,-102,1470,"2,903.28",3612
,20160524,1985,1975,2052,2052,1956,1996,1992,21,17,1052,"2,096.44",3382
,20160525,1996,1992,2008,2015,1961,1963,1986,-29,-6,278,552.28,3316
,20160526,1963,1986,1948,1999,1948,1995,1982,9,-4,178,352.84,3290
,20160527,1995,1982,2002,2083,1978,2068,2027,86,45,562,"1,139.52",3114
,20160530,2068,2027,2076,2078,1966,2018,2019,-9,-8,506,"1,021.62",2996
,20160531,2018,2019,2013,2034,1962,1962,2001,-57,-18,612,"1,224.79",3072
,20160601,1962,2001,1979,1980,1940,1951,1956,-50,-45,246,481.22,3012
,20160602,1951,1956,1938,1974,1935,1961,1959,5,3,350,685.89,3020
,20160603,1961,1959,1962,2000,1962,1989,1986,30,27,442,878.23,3032
,20160606,1989,1986,1982,2058,1982,2041,2027,55,41,290,588.00,3066
,20160607,2041,2027,2052,2078,2038,2064,2055,37,28,286,587.95,3092
,20160608,2064,2055,2050,2088,2030,2084,2059,29,4,296,609.51,3050
,20160613,2084,2059,2084,2156,2084,2128,2130,69,71,176,374.89,3050
,20160614,2128,2130,2133,2133,2066,2066,2102,-64,-28,710,"1,492.64",2740
,20160615,2066,2102,2060,2080,2052,2060,2063,-42,-39,590,"1,217.23",2394
,20160616,2060,2063,2057,2077,2055,2063,2066,0,3,438,904.97,2108
,20160617,2063,2066,2051,2064,2041,2055,2046,-11,-20,328,671.25,1874
,20160620,2055,2046,2080,2082,2058,2060,2063,14,17,98,202.24,1834
,20160621,2060,2063,2056,2099,2056,2081,2083,18,20,132,275.04,1752
,20160622,2081,2083,2064,2120,2064,2120,2110,37,27,702,"1,481.71",1780
,20160623,2120,2110,2127,2139,2072,2108,2111,-2,1,84,177.33,1764
,20160624,2108,2111,2114,2127,2090,2095,2099,-16,-12,380,797.64,1712
,20160627,2095,2099,2130,2200,2105,2200,2138,101,39,656,"1,402.82",1540
,20160628,2200,2138,2160,2184,2160,2166,2166,28,28,98,212.36,1462
,20160629,2166,2166,2130,2173,2118,2166,2151,0,-15,118,253.86,1394
,20160630,2166,2151,2137,2278,2119,2170,2208,19,57,434,958.39,1380
,20160701,2170,2208,,,,2208,2208,0,0,0,0.00,1380
,20160704,2208,2208,,,,2208,2208,0,0,0,0.00,1380
,20160705,2208,2208,2210,2210,2210,2210,2210,2,2,60,132.60,1320
,20160706,2210,2210,2210,2210,2181,2181,2202,-29,-8,240,528.66,1320
,20160707,2181,2202,,,,2202,2202,0,0,0,0.00,1320
,20160708,2202,2202,,,,2202,2202,0,0,0,0.00,1320
,20160711,2202,2202,2191,2191,2191,2191,2191,-11,-11,60,131.46,1260
,20160712,2191,2191,,,,2220,2220,29,29,0,0.00,1260
,20160713,2220,2220,2346,2346,2187,2187,2266,-33,46,120,271.98,1200
,20160714,2187,2266,,,,2266,2266,0,0,0,0.00,1200
,20160715,2266,2266,,,,2266,2266,0,0,0,0.00,1200
rb1608,20160104,1789,1793,1811,1811,1811,1811,1811,18,18,2,3.62,2900
,20160105,1811,1811,1788,1791,1767,1785,1782,-26,-29,34,60.61,2890
,20160106,1785,1782,1761,1770,1758,1770,1760,-12,-22,538,947.02,2792
,20160107,1770,1760,1763,1774,1763,1766,1768,6,8,174,307.75,2752
,20160108,1766,1768,1750,1769,1747,1760,1757,-8,-11,14,24.60,2750
,20160111,1760,1757,1753,1760,1753,1760,1754,3,-3,72,126.33,2726
,20160112,1760,1754,1745,1753,1737,1737,1740,-17,-14,288,501.21,2648
,20160113,1737,1740,1756,1759,1740,1740,1744,0,4,62,108.18,2640
,20160114,1740,1744,1741,1756,1737,1756,1744,12,0,84,146.53,2642
,20160115,1756,1744,1758,1780,1758,1780,1771,36,27,16,28.35,2638
,20160118,1780,1771,1776,1830,1776,1817,1808,46,37,102,184.46,2628
,20160119,1817,1808,1815,1825,1812,1823,1818,15,10,174,316.45,2626
,20160120,1823,1818,1821,1828,1802,1806,1814,-12,-4,50,90.72,2596
,20160121,1806,1814,1802,1810,1802,1803,1803,-11,-11,130,234.47,2572
,20160122,1803,1803,1811,1825,1809,1815,1817,12,14,56,101.76,2546
,20160125,1815,1817,1828,1828,1828,1828,1828,11,11,10,18.28,2536
,20160126,1828,1828,,,,1828,1828,0,0,0,0.00,2536
,20160127,1828,1828,1818,1838,1818,1838,1826,10,-2,6,10.96,2538
,20160128,1838,1826,1839,1840,1806,1806,1823,-20,-3,160,291.83,2658
,20160129,1806,1823,1813,1814,1800,1800,1804,-23,-19,18,32.48,2642
,20160201,1800,1804,,,,1804,1804,0,0,0,0.00,2642
,20160202,1804,1804,1815,1815,1797,1797,1806,-7,2,26,46.97,2640
,20160203,1797,1806,1805,1820,1803,1820,1811,14,5,8,14.49,2640
,20160204,1820,1811,1823,1835,1823,1835,1833,24,22,22,40.34,2640
,20160205,1835,1833,1839,1839,1822,1822,1835,-11,2,20,36.71,2640
,20160215,1822,1835,1837,1859,1837,1841,1846,6,11,326,601.86,2504
,20160216,1841,1846,1850,1856,1834,1838,1842,-8,-4,958,"1,765.38",2032
,20160217,1838,1842,1839,1844,1834,1838,1838,-4,-4,48,88.23,2012
,20160218,1838,1838,1839,1841,1833,1841,1839,3,1,50,91.97,2010
,20160219,1841,1839,1840,1857,1840,1855,1851,16,12,1202,"2,225.37",1608
,20160222,1855,1851,1926,1926,1850,1909,1873,58,22,1332,"2,495.65",2026
,20160223,1909,1873,1899,1907,1879,1882,1888,9,15,1082,"2,043.52",1980
,20160224,1882,1888,1889,1889,1869,1878,1879,-10,-9,976,"1,834.42",2218
,20160225,1878,1879,1868,1903,1868,1878,1890,-1,11,538,"1,017.00",2202
,20160226,1878,1890,1883,1883,1852,1873,1866,-17,-24,218,406.81,2210
,20160229,1873,1866,1874,1893,1865,1893,1881,27,15,372,699.76,2198
,20160301,1893,1881,1899,1928,1891,1918,1910,37,29,536,"1,024.06",2128
,20160302,1918,1910,1921,1947,1920,1943,1928,33,18,194,374.07,2086
,20160303,1943,1928,1948,1950,1920,1926,1934,-2,6,252,487.49,2128
,20160304,1926,1934,1919,1954,1919,1951,1941,17,7,246,477.50,2088
,20160307,1951,1941,1974,2038,1973,2038,2023,97,82,180,364.20,2070
,20160308,2038,2023,2178,2184,2016,2184,2146,161,123,3452,"7,409.68",2628
,20160309,2184,2146,2146,2146,2038,2038,2066,-108,-80,2134,"4,409.96",2448
,20160310,2038,2066,2028,2136,2028,2060,2086,-6,20,1076,"2,244.96",2426
,20160311,2060,2086,2047,2065,2001,2022,2036,-64,-50,888,"1,808.30",2446
,20160314,2022,2036,1997,2056,1983,1986,2016,-50,-20,902,"1,819.27",2616
,20160315,1986,2016,1983,1997,1953,1958,1965,-58,-51,710,"1,395.84",2994
,20160316,1958,1965,1962,1985,1962,1982,1973,17,8,336,663.17,3074
,20160317,1982,1973,1996,2046,1990,2046,2024,73,51,836,"1,692.20",3030
,20160318,2046,2024,2024,2124,2024,2091,2086,67,62,1648,"3,438.51",2548
,20160321,2091,2086,2067,2177,2059,2129,2110,43,24,594,"1,253.93",2390
,20160322,2129,2110,2129,2150,2107,2139,2128,29,18,288,613.09,2358
,20160323,2139,2128,2125,2199,2110,2153,2159,25,31,694,"1,498.35",2350
,20160324,2153,2159,2149,2166,2085,2088,2120,-71,-39,1196,"2,536.70",2406
,20160325,2088,2120,2106,2150,2101,2149,2123,29,3,436,926.03,2324
,20160328,2149,2123,2157,2185,2103,2112,2152,-11,29,486,"1,046.22",2286
,20160329,2112,2152,2120,2146,2105,2121,2123,-31,-29,314,666.67,2310
,20160330,2121,2123,2129,2132,2072,2089,2099,-34,-24,408,856.41,2272
,20160331,2089,2099,2099,2116,2095,2115,2104,16,5,894,"1,881.57",2002
,20160401,2115,2104,2129,2170,2119,2169,2146,65,42,374,802.60,2056
,20160405,2169,2146,2138,2178,2106,2176,2149,30,3,60,128.99,2072
,20160406,2176,2149,2176,2184,2150,2161,2164,12,15,186,402.57,2114
,20160407,2161,2164,2164,2190,2160,2190,2168,26,4,58,125.75,2094
,20160408,2190,2168,2169,2181,2161,2174,2170,6,2,100,217.02,2092
,20160411,2174,2170,2203,2299,2203,2270,2254,100,84,538,"1,212.91",2056
,20160412,2270,2254,2271,2326,2271,2324,2292,70,38,790,"1,811.36",1672
,20160413,2324,2292,2342,2420,2327,2336,2350,44,58,434,"1,020.28",1796
,20160414,2336,2350,2343,2363,2317,2338,2331,-12,-19,314,732.21,1796
,20160415,2338,2331,2323,2355,2300,2301,2319,-30,-12,290,672.68,1758
,20160418,2301,2319,2300,2409,2300,2382,2347,63,28,466,"1,093.80",1654
,20160419,2382,2347,2400,2486,2377,2483,2437,136,90,610,"1,486.78",1574
,20160420,2483,2437,2489,2583,2489,2583,2547,146,110,536,"1,365.47",1666
,20160421,2583,2547,2619,2699,2599,2699,2672,152,125,1068,"2,854.68",1504
,20160422,2699,2672,2699,2741,2585,2643,2650,-29,-22,2430,"6,440.18",1290
,20160425,2643,2650,2628,2776,2607,2638,2675,-12,25,706,"1,888.88",1242
,20160426,2638,2675,2621,2640,2530,2564,2593,-111,-82,180,466.84,1220
,20160427,2564,2593,2560,2590,2463,2507,2517,-86,-76,904,"2,275.66",1154
,20160428,2507,2517,2513,2540,2460,2536,2506,19,-11,378,947.48,1108
,20160429,2536,2506,2525,2589,2525,2588,2572,82,66,174,447.70,1114
,20160503,2588,2572,2536,2536,2449,2480,2483,-92,-89,336,834.37,1152
,20160504,2480,2483,2453,2462,2387,2401,2430,-82,-53,460,"1,117.95",950
,20160505,2401,2430,2419,2423,2330,2335,2387,-95,-43,912,"2,176.97",1108
,20160506,2335,2387,2354,2355,2301,2355,2340,-32,-47,306,716.14,1122
,20160509,2355,2340,2366,2366,2199,2199,2213,-141,-127,664,"1,469.97",1642
,20160510,2199,2213,2185,2188,2111,2160,2148,-53,-65,1130,"2,427.60",1480
,20160511,2160,2148,2181,2203,2140,2176,2180,28,32,532,"1,160.02",1296
,20160512,2176,2180,2179,2205,2113,2113,2168,-67,-12,984,"2,134.11",1342
,20160513,2113,2168,2110,2119,2048,2075,2080,-93,-88,1208,"2,512.64",1634
,20160516,2075,2080,2060,2120,2055,2105,2088,25,8,940,"1,963.58",1950
,20160517,2105,2088,2096,2155,2085,2154,2123,66,35,490,"1,040.35",2142
,20160518,2154,2123,2145,2168,2069,2089,2135,-34,12,504,"1,076.33",2158
,20160519,2089,2135,2085,2128,2067,2090,2084,-45,-51,426,887.94,2126
,20160520,2090,2084,2065,2120,2065,2111,2100,27,16,126,264.70,2120
,20160523,2111,2100,2094,2096,1974,2005,2003,-95,-97,1134,"2,271.42",2808
,20160524,2005,2003,1993,2016,1984,2011,2001,8,-2,440,880.62,2660
,20160525,2011,2001,2040,2040,1975,1983,1996,-18,-5,202,403.25,2646
,20160526,1983,1996,1970,2020,1970,1994,1998,-2,2,194,387.62,2564
,20160527,1994,1998,2029,2110,1992,2094,2031,96,33,260,528.23,2542
,20160530,2094,2031,2110,2110,1961,2037,2040,6,9,448,913.93,2496
,20160531,2037,2040,2053,2075,2021,2021,2043,-19,3,830,"1,695.92",2154
,20160601,2021,2043,2021,2024,1985,1999,2003,-44,-40,298,597.03,2230
,20160602,1999,2003,1988,2020,1988,2002,2007,-1,4,158,317.24,2168
,20160603,2002,2007,2007,2033,1999,2012,2018,5,11,728,"1,469.70",1634
,20160606,2012,2018,2021,2078,2021,2074,2044,56,26,658,"1,345.03",1134
,20160607,2074,2044,2098,2112,2072,2078,2088,34,44,290,605.52,1062
,20160608,2078,2088,2158,2158,2073,2123,2108,35,20,262,552.34,996
,20160613,2123,2108,2171,2233,2132,2193,2202,85,94,234,515.34,924
,20160614,2193,2202,2203,2203,2125,2125,2155,-77,-47,1010,"2,176.79",1280
,20160615,2125,2155,2116,2141,2102,2118,2124,-37,-31,268,569.28,1274
,20160616,2118,2124,2135,2158,2118,2124,2140,0,16,188,402.33,1274
,20160617,2124,2140,2115,2130,2086,2130,2099,-10,-41,136,285.58,1328
,20160620,2130,2099,2133,2138,2108,2119,2118,20,19,42,88.97,1328
,20160621,2119,2118,2122,2150,2119,2129,2133,11,15,550,"1,173.23",850
,20160622,2129,2133,2176,2176,2146,2161,2159,28,26,522,"1,127.42",620
,20160623,2161,2159,2190,2190,2168,2174,2175,15,16,164,356.81,622
,20160624,2174,2175,2185,2185,2110,2141,2149,-34,-26,178,382.54,664
,20160627,2141,2149,2136,2246,2136,2246,2191,97,42,478,"1,047.64",910
,20160628,2246,2191,2231,2237,2192,2235,2224,44,33,128,284.68,890
,20160629,2235,2224,2207,2222,2201,2222,2208,-2,-16,40,88.34,886
,20160630,2222,2208,2198,2292,2198,2266,2250,58,42,292,657.24,996
,20160701,2266,2250,2294,2294,2230,2280,2266,30,16,52,117.83,982
,20160704,2280,2266,2295,2362,2283,2350,2321,84,55,120,278.52,970
,20160705,2350,2321,2315,2333,2257,2324,2298,3,-23,108,248.18,928
,20160706,2324,2298,2358,2358,2247,2286,2292,-12,-6,236,541.06,878
,20160707,2286,2292,2292,2364,2276,2311,2319,19,27,92,213.40,872
,20160708,2311,2319,2331,2340,2313,2340,2325,21,6,118,274.35,872
,20160711,2340,2325,2396,2412,2284,2348,2355,23,30,84,197.84,882
,20160712,2348,2355,2367,2486,2347,2485,2461,130,106,120,295.37,840
,20160713,2485,2461,2460,2500,2444,2475,2470,14,9,38,93.89,816
,20160714,2475,2470,2465,2465,2415,2443,2444,-27,-26,32,78.24,798
,20160715,2443,2444,2409,2455,2409,2449,2427,5,-17,14,33.98,790
,20160718,2449,2427,2402,2409,2281,2281,2358,-146,-69,176,415.11,804
,20160719,2281,2358,2267,2299,2231,2265,2262,-93,-96,202,457.03,744
,20160720,2265,2262,2276,2314,2246,2314,2263,52,1,24,54.33,732
,20160721,2314,2263,2338,2398,2253,2397,2336,134,73,98,229.00,714
,20160722,2397,2336,2383,2383,2291,2291,2335,-45,-1,8,18.68,708
,20160725,2291,2335,2295,2355,2295,2323,2323,-12,-12,78,181.26,686
,20160726,2323,2323,2295,2334,2264,2319,2290,-4,-33,82,187.80,672
,20160727,2319,2290,2286,2387,2283,2290,2314,0,24,50,115.71,656
,20160728,2290,2314,2312,2350,2274,2345,2339,31,25,294,687.74,582
,20160729,2345,2339,2467,2467,2248,2447,2343,108,4,148,346.79,540
,20160801,2447,2343,,,,2343,2343,0,0,0,0.00,540
,20160802,2343,2343,,,,2343,2343,0,0,0,0.00,540
,20160803,2343,2343,,,,2380,2380,37,37,0,0.00,540
,20160804,2380,2380,2380,2380,2380,2380,2380,0,0,60,142.80,480
,20160805,2380,2380,2237,2522,2237,2418,2381,38,1,2040,"4,858.62",480
,20160808,2418,2381,,,,2381,2381,0,0,0,0.00,480
,20160809,2381,2381,,,,2381,2381,0,0,0,0.00,480
,20160810,2381,2381,,,,2420,2420,39,39,0,0.00,480
,20160811,2420,2420,,,,2420,2420,0,0,0,0.00,480
,20160812,2420,2420,2509,2509,2509,2509,2509,89,89,180,451.62,300
,20160815,2509,2509,,,,2509,2509,0,0,0,0.00,300
rb1609,20160104,1798,1803,1813,1853,1777,1791,1812,-12,9,1320,"2,392.57",8238
,20160105,1791,1812,1793,1799,1775,1794,1784,-18,-28,1510,"2,694.82",7872
,20160106,1794,1784,1792,1800,1776,1781,1785,-3,1,590,"1,053.20",7926
,20160107,1781,1785,1775,1792,1775,1778,1784,-7,-1,1390,"2,480.83",7978
,20160108,1778,1784,1775,1789,1756,1768,1774,-16,-10,5796,"10,282.78",9098
,20160111,1768,1774,1770,1778,1757,1765,1766,-9,-8,2030,"3,585.55",8850
,20160112,1765,1766,1765,1769,1746,1748,1758,-18,-8,3352,"5,893.08",8546
,20160113,1748,1758,1745,1763,1745,1752,1754,-6,-4,808,"1,417.78",8580
,20160114,1752,1754,1756,1770,1745,1769,1755,15,1,862,"1,513.51",8566
,20160115,1769,1755,1770,1792,1767,1782,1780,27,25,2204,"3,925.12",7976
,20160118,1782,1780,1771,1834,1771,1831,1812,51,32,2744,"4,973.99",7776
,20160119,1831,1812,1827,1847,1821,1846,1833,34,21,1944,"3,564.32",7690
,20160120,1846,1833,1842,1850,1818,1821,1832,-12,-1,1576,"2,888.36",7656
,20160121,1821,1832,1815,1828,1807,1812,1817,-20,-15,876,"1,591.91",7574
,20160122,1812,1817,1818,1850,1810,1822,1833,5,16,1750,"3,208.19",7460
,20160125,1822,1833,1829,1845,1822,1835,1837,2,4,2190,"4,024.04",7774
,20160126,1835,1837,1833,1842,1830,1841,1836,4,-1,1478,"2,714.52",7940
,20160127,1841,1836,1844,1855,1836,1853,1846,17,10,1770,"3,268.49",7952
,20160128,1853,1846,1853,1857,1814,1814,1843,-32,-3,2320,"4,278.04",8204
,20160129,1814,1843,1822,1831,1804,1815,1818,-28,-25,3074,"5,589.34",8792
,20160201,1815,1818,1815,1835,1814,1814,1826,-4,8,1298,"2,370.92",8814
,20160202,1814,1826,1818,1821,1803,1811,1811,-15,-15,1852,"3,354.82",8890
,20160203,1811,1811,1816,1827,1807,1821,1817,10,6,1214,"2,205.93",8860
,20160204,1821,1817,1821,1847,1819,1843,1836,26,19,1952,"3,584.79",8666
,20160205,1843,1836,1846,1847,1822,1833,1834,-3,-2,764,"1,401.41",8762
,20160215,1833,1834,1834,1867,1825,1854,1847,20,13,2110,"3,899.17",8984
,20160216,1854,1847,1863,1866,1850,1853,1858,6,11,1858,"3,453.57",9094
,20160217,1853,1858,1850,1865,1848,1849,1853,-9,-5,1864,"3,455.55",9626
,20160218,1849,1853,1852,1860,1833,1853,1848,0,-5,3042,"5,622.05",9978
,20160219,1853,1848,1856,1866,1848,1864,1857,16,9,1784,"3,313.37",9844
,20160222,1864,1857,1867,1920,1859,1910,1894,53,37,5670,"10,739.55",10162
,20160223,1910,1894,1906,1918,1801,1900,1901,6,7,7210,"13,712.27",9882
,20160224,1900,1901,1896,1910,1880,1890,1891,-11,-10,2144,"4,054.43",10100
,20160225,1890,1891,1892,1912,1883,1885,1900,-6,9,3600,"6,841.34",10076
,20160226,1885,1900,1892,1892,1860,1876,1874,-24,-26,3522,"6,602.03",9988
,20160229,1876,1874,1882,1909,1871,1909,1883,35,9,7180,"13,524.08",9882
,20160301,1909,1883,1903,1941,1901,1928,1917,45,34,8900,"17,066.16",10172
,20160302,1928,1917,1931,1973,1927,1956,1946,39,29,7500,"14,601.66",11368
,20160303,1956,1946,1951,1972,1942,1945,1954,-1,8,8106,"15,839.92",10802
,20160304,1945,1954,1946,1978,1931,1977,1957,23,3,6826,"13,360.98",10802
,20160307,1977,1957,1986,2054,1977,2054,2020,97,63,9656,"19,507.77",10428
,20160308,2054,2020,2098,2181,2050,2181,2129,161,109,25886,"55,124.16",13446
,20160309,2181,2129,2179,2179,2010,2058,2070,-71,-59,25684,"53,185.17",12390
,20160310,2058,2070,2070,2164,2062,2089,2104,19,34,28176,"59,310.45",13782
,20160311,2089,2104,2074,2094,2010,2028,2053,-76,-51,17372,"35,678.06",13486
,20160314,2028,2053,2050,2084,1992,1995,2032,-58,-21,15506,"31,513.33",13432
,20160315,1995,2032,2013,2013,1972,1979,1988,-53,-44,10448,"20,771.62",13922
,20160316,1979,1988,1972,2010,1972,2004,1993,16,5,7162,"14,278.70",13406
,20160317,2004,1993,2020,2069,2003,2049,2035,56,42,10222,"20,805.20",12770
,20160318,2049,2035,2065,2136,2062,2108,2105,73,70,12706,"26,757.20",13208
,20160321,2108,2105,2105,2209,2081,2163,2156,58,51,47866,"103,219.06",31460
,20160322,2163,2156,2163,2189,2129,2164,2172,8,16,18076,"39,276.03",25560
,20160323,2164,2172,2158,2226,2142,2182,2180,10,8,33148,"72,269.10",14506
,20160324,2182,2180,2180,2195,2102,2113,2140,-67,-40,24502,"52,451.68",14434
,20160325,2113,2140,2107,2175,2107,2175,2139,35,-1,25816,"55,234.74",14012
,20160328,2175,2139,2175,2207,2126,2126,2172,-13,33,14446,"31,377.16",13680
,20160329,2126,2172,2127,2165,2122,2156,2144,-16,-28,14374,"30,821.37",14920
,20160330,2156,2144,2155,2163,2092,2116,2119,-28,-25,17002,"36,031.75",14622
,20160331,2116,2119,2122,2140,2106,2137,2122,18,3,11488,"24,381.68",13990
,20160401,2137,2122,2156,2198,2125,2191,2168,69,46,20374,"44,186.60",14452
,20160405,2191,2168,2190,2202,2150,2192,2180,24,12,10878,"23,723.94",14182
,20160406,2192,2180,2193,2208,2166,2182,2186,2,6,13476,"29,465.67",14890
,20160407,2182,2186,2182,2214,2176,2195,2195,9,9,9218,"20,234.61",15740
,20160408,2195,2195,2194,2199,2182,2198,2190,3,-5,7774,"17,029.46",15566
,20160411,2198,2190,2204,2321,2204,2304,2261,114,71,32708,"73,966.49",23946
,20160412,2304,2261,2298,2356,2298,2349,2319,88,58,29724,"68,940.23",22288
,20160413,2349,2319,2352,2441,2340,2361,2372,42,53,32776,"77,752.31",22188
,20160414,2361,2372,2365,2385,2326,2332,2354,-40,-18,14636,"34,466.49",22318
,20160415,2332,2354,2374,2374,2312,2313,2331,-41,-23,12750,"29,725.22",22512
,20160418,2313,2331,2305,2420,2296,2396,2361,65,30,22078,"52,133.81",21470
,20160419,2396,2361,2409,2502,2401,2501,2456,140,95,36578,"89,871.04",23258
,20160420,2501,2456,2502,2603,2502,2603,2564,147,108,43332,"111,115.86",25750
,20160421,2603,2564,2565,2784,2565,2747,2709,183,145,109018,"295,420.34",26620
,20160422,2747,2709,2731,2740,2602,2649,2661,-60,-48,100344,"267,034.71",23536
,20160425,2649,2661,2654,2795,2613,2653,2686,-8,25,70328,"188,970.74",18274
,20160426,2653,2686,2641,2658,2533,2566,2605,-120,-81,41084,"107,055.71",16574
,20160427,2566,2605,2563,2596,2458,2517,2536,-88,-69,44966,"114,059.08",16076
,20160428,2517,2536,2519,2554,2474,2550,2515,14,-21,40746,"102,512.51",15728
,20160429,2550,2515,2557,2600,2541,2591,2578,76,63,27766,"71,592.58",15754
,20160503,2591,2578,2584,2584,2440,2473,2489,-105,-89,20758,"51,686.71",16490
,20160504,2473,2489,2465,2469,2388,2403,2429,-86,-60,18898,"45,913.54",15994
,20160505,2403,2429,2387,2428,2318,2329,2370,-100,-59,22646,"53,673.30",15368
,20160506,2329,2370,2330,2353,2295,2348,2326,-22,-44,28332,"65,901.91",15644
,20160509,2348,2326,2351,2367,2186,2186,2269,-140,-57,34890,"79,196.62",18120
,20160510,2186,2269,2158,2182,2101,2166,2144,-103,-125,30878,"66,214.80",15162
,20160511,2166,2144,2169,2195,2136,2164,2170,20,26,28740,"62,387.28",16386
,20160512,2164,2170,2165,2179,2091,2095,2148,-75,-22,22288,"47,880.00",16622
,20160513,2095,2148,2091,2100,2020,2050,2057,-98,-91,24456,"50,322.56",16558
,20160516,2050,2057,2042,2106,2030,2078,2075,21,18,28026,"58,171.35",20546
,20160517,2078,2075,2077,2137,2062,2134,2092,59,17,26802,"56,077.71",16492
,20160518,2134,2092,2133,2150,2052,2072,2111,-20,19,24346,"51,406.61",16108
,20160519,2072,2111,2086,2095,2044,2062,2067,-49,-44,21712,"44,888.62",16464
,20160520,2062,2067,2052,2098,2038,2082,2073,15,6,17376,"36,030.69",16800
,20160523,2082,2073,2082,2088,1948,1970,2009,-103,-64,19428,"39,048.94",16014
,20160524,1970,2009,1963,1985,1939,1980,1961,-29,-48,12680,"24,872.76",15920
,20160525,1980,1961,1985,1993,1933,1939,1966,-22,5,10712,"21,064.57",16190
,20160526,1939,1966,1945,1984,1933,1977,1966,11,0,20204,"39,726.27",16486
,20160527,1977,1966,1993,2068,1955,2058,2007,92,41,30984,"62,197.43",14556
,20160530,2058,2007,2065,2076,1921,2012,2016,5,9,20926,"42,197.71",14408
,20160531,2012,2016,2019,2050,1996,2001,2024,-15,8,15888,"32,171.01",14464
,20160601,2001,2024,1991,2009,1961,1975,1983,-49,-41,10334,"20,497.97",14752
,20160602,1975,1983,1972,2007,1964,1975,1980,-8,-3,10150,"20,105.24",14726
,20160603,1975,1980,1971,2018,1971,2000,1997,20,17,7712,"15,401.84",14164
,20160606,2000,1997,2007,2087,1993,2071,2041,74,44,19436,"39,678.29",16292
,20160607,2071,2041,2068,2163,2068,2087,2084,46,43,14878,"31,014.12",15260
,20160608,2087,2084,2080,2126,2050,2112,2095,28,11,23304,"48,829.33",14056
,20160613,2112,2095,2100,2200,2100,2182,2163,87,68,12842,"27,789.18",14682
,20160614,2182,2163,2180,2196,2089,2090,2148,-73,-15,17662,"37,953.42",13782
,20160615,2090,2148,2073,2119,2072,2085,2095,-63,-53,11164,"23,397.23",13788
,20160616,2085,2095,2099,2140,2089,2092,2107,-3,12,14110,"29,735.50",14138
,20160617,2092,2107,2087,2118,2042,2093,2072,-14,-35,10514,"21,792.56",12834
,20160620,2093,2072,2093,2168,2075,2085,2097,13,25,10140,"21,263.90",13726
,20160621,2085,2097,2086,2134,2073,2104,2107,7,10,7582,"15,979.90",13184
,20160622,2104,2107,2096,2156,2090,2155,2135,48,28,11520,"24,606.33",12166
,20160623,2155,2135,2160,2174,2143,2161,2162,26,27,7662,"16,567.27",12626
,20160624,2161,2162,2168,2183,2101,2136,2152,-26,-10,11450,"24,643.37",12668
,20160627,2136,2152,2146,2272,2135,2272,2217,120,65,18758,"41,597.39",14640
,20160628,2272,2217,2270,2279,2221,2246,2251,29,34,15784,"35,531.90",14100
,20160629,2246,2251,2259,2260,2209,2223,2234,-28,-17,10004,"22,353.38",14126
,20160630,2223,2234,2218,2316,2218,2297,2284,63,50,16466,"37,610.91",16524
,20160701,2297,2284,2303,2316,2256,2303,2292,19,8,19712,"45,184.47",16040
,20160704,2303,2292,2311,2399,2304,2375,2359,83,67,23126,"54,567.78",16816
,20160705,2375,2359,2378,2401,2269,2349,2338,-10,-21,12874,"30,107.16",16768
,20160706,2349,2338,2337,2379,2251,2326,2326,-12,-12,14716,"34,236.12",16648
,20160707,2326,2326,2326,2392,2300,2347,2350,21,24,15366,"36,115.90",16910
,20160708,2347,2350,2341,2387,2325,2382,2359,32,9,18318,"43,214.60",18796
,20160711,2382,2359,2399,2428,2324,2383,2372,24,13,16782,"39,822.28",16290
,20160712,2383,2372,2388,2504,2375,2498,2444,126,72,17446,"42,640.85",18092
,20160713,2498,2444,2498,2541,2470,2478,2498,34,54,15844,"39,580.90",16322
,20160714,2478,2498,2498,2498,2435,2478,2464,-20,-34,11534,"28,431.13",15992
,20160715,2478,2464,2481,2508,2438,2486,2469,22,5,11090,"27,386.50",15094
,20160718,2486,2469,2490,2499,2320,2320,2395,-149,-74,14600,"34,977.24",14870
,20160719,2320,2395,2346,2346,2251,2289,2282,-106,-113,19946,"45,528.02",12304
,20160720,2289,2282,2297,2332,2261,2270,2290,-12,8,12582,"28,815.15",11174
,20160721,2270,2290,2270,2421,2237,2389,2338,99,48,14670,"34,306.31",11828
,20160722,2389,2338,2382,2395,2290,2300,2342,-38,4,14244,"33,359.83",10924
,20160725,2300,2342,2315,2361,2275,2315,2324,-27,-18,10010,"23,263.53",11198
,20160726,2315,2324,2319,2358,2282,2348,2310,24,-14,8360,"19,316.29",10592
,20160727,2348,2310,2344,2419,2330,2371,2368,61,58,13582,"32,175.17",10704
,20160728,2371,2368,2380,2455,2377,2437,2418,69,50,10688,"25,852.43",11640
,20160729,2437,2418,2427,2444,2359,2378,2408,-40,-10,7708,"18,563.87",11008
,20160801,2378,2408,2378,2496,2353,2472,2447,64,39,8808,"21,557.97",9614
,20160802,2472,2447,2460,2484,2440,2475,2461,28,14,7028,"17,301.14",10126
,20160803,2475,2461,2484,2488,2445,2453,2460,-8,-1,5530,"13,605.87",10364
,20160804,2453,2460,2452,2461,2396,2437,2425,-23,-35,6814,"16,529.40",8370
,20160805,2437,2425,2437,2524,2428,2506,2491,81,66,6576,"16,383.48",8066
,20160808,2506,2491,2503,2577,2485,2570,2539,79,48,5214,"13,242.98",8312
,20160809,2570,2539,2565,2588,2517,2562,2555,23,16,4722,"12,068.58",7402
,20160810,2562,2555,2555,2606,2540,2559,2561,4,6,3156,"8,084.73",6832
,20160811,2559,2561,2545,2566,2514,2551,2547,-10,-14,4916,"12,521.86",7784
,20160812,2551,2547,2548,2565,2461,2551,2548,4,1,5742,"14,631.53",6448
,20160815,2551,2548,2533,2574,2492,2561,2545,13,-3,3988,"10,152.18",5374
,20160816,2561,2545,2560,2647,2558,2608,2605,63,60,4226,"11,010.95",5550
,20160817,2608,2605,2607,2626,2548,2553,2589,-52,-16,2104,"5,449.16",5266
,20160818,2553,2589,2550,2572,2517,2547,2544,-42,-45,2478,"6,305.58",4568
,20160819,2547,2544,2549,2549,2485,2515,2519,-29,-25,1274,"3,209.65",4382
,20160822,2515,2519,2519,2522,2462,2480,2487,-39,-32,1988,"4,945.67",4280
,20160823,2480,2487,2475,2515,2465,2512,2496,25,9,1054,"2,631.03",3966
,20160824,2512,2496,2502,2515,2495,2512,2502,16,6,886,"2,217.27",3456
,20160825,2512,2502,2519,2537,2466,2510,2503,8,1,792,"1,982.72",3200
,20160826,2510,2503,2508,2521,2476,2484,2501,-19,-2,848,"2,121.17",3034
,20160829,2484,2501,2478,2478,2442,2468,2459,-33,-42,388,954.40,2958
,20160830,2468,2459,2452,2484,2428,2444,2448,-15,-11,906,"2,218.69",2720
,20160831,2444,2448,2437,2452,2320,2325,2378,-123,-70,552,"1,313.16",2524
,20160901,2325,2378,2325,2415,2325,2415,2409,37,31,64,154.20,2520
,20160902,2415,2409,2407,2435,2407,2420,2416,11,7,420,"1,015.02",2340
,20160905,2420,2416,2383,2413,2383,2413,2398,-3,-18,120,287.76,2220
,20160906,2413,2398,2399,2399,2399,2399,2399,1,1,60,143.94,2280
,20160907,2399,2399,,,,2370,2370,-29,-29,0,0.00,2280
,20160908,2370,2370,,,,2365,2365,-5,-5,0,0.00,2280
,20160909,2365,2365,2301,2301,2301,2301,2301,-64,-64,60,138.06,2220
,20160912,2301,2301,2260,2260,2260,2260,2260,-41,-41,60,135.60,2220
,20160913,2260,2260,2212,2212,2200,2200,2204,-60,-56,180,396.72,2160
,20160914,2200,2204,2238,2238,2238,2238,2238,34,34,60,134.28,2160
,20160919,2238,2238,2275,2300,2275,2300,2287,62,49,360,823.50,2160
rb1610,20160104,1800,1803,1825,1865,1782,1791,1810,-12,7,197286,"357,161.60",354758
,20160105,1791,1810,1791,1801,1774,1796,1789,-14,-21,191812,"343,213.81",362332
,20160106,1796,1789,1794,1799,1775,1783,1783,-6,-6,191376,"341,315.35",377484
,20160107,1783,1783,1781,1794,1771,1781,1784,-2,1,153178,"273,349.94",377998
,20160108,1781,1784,1781,1782,1756,1769,1771,-15,-13,195328,"345,927.85",391144
,20160111,1769,1771,1766,1778,1759,1766,1769,-5,-2,189602,"335,564.60",402056
,20160112,1766,1769,1765,1770,1744,1748,1756,-21,-13,193420,"339,765.84",396168
,20160113,1748,1756,1747,1763,1744,1752,1754,-4,-2,115066,"201,875.72",405088
,20160114,1752,1754,1752,1772,1743,1771,1757,17,3,140414,"246,718.86",405742
,20160115,1771,1757,1770,1794,1768,1784,1783,27,26,218258,"389,318.27",422930
,20160118,1784,1783,1780,1836,1778,1835,1817,52,34,395096,"717,987.11",472534
,20160119,1835,1817,1834,1849,1825,1848,1835,31,18,239154,"438,913.69",511534
,20160120,1848,1835,1849,1854,1819,1821,1835,-14,0,304670,"559,250.29",548014
,20160121,1821,1835,1819,1828,1809,1812,1818,-23,-17,192136,"349,358.32",553282
,20160122,1812,1818,1815,1854,1808,1822,1830,4,12,336948,"616,852.67",602560
,20160125,1822,1830,1829,1846,1822,1836,1836,6,6,256674,"471,496.42",628732
,20160126,1836,1836,1835,1842,1828,1841,1835,5,-1,171660,"315,125.21",636856
,20160127,1841,1835,1844,1860,1835,1851,1848,16,13,332518,"614,760.39",680204
,20160128,1851,1848,1848,1860,1817,1818,1843,-30,-5,409184,"754,321.83",673718
,20160129,1818,1843,1817,1833,1809,1817,1820,-26,-23,280950,"511,406.32",685894
,20160201,1817,1820,1817,1839,1817,1821,1828,1,8,327060,"598,133.33",689800
,20160202,1821,1828,1820,1827,1806,1817,1815,-11,-13,323158,"586,707.77",686130
,20160203,1817,1815,1818,1829,1811,1825,1820,10,5,275122,"500,900.42",673948
,20160204,1825,1820,1825,1855,1824,1851,1843,31,23,408990,"754,101.68",652516
,20160205,1851,1843,1854,1858,1831,1843,1841,0,-2,247948,"456,586.48",676336
,20160215,1843,1841,1836,1883,1830,1871,1864,30,23,422842,"788,548.65",794134
,20160216,1871,1864,1872,1880,1861,1864,1869,0,5,402854,"753,328.69",867334
,20160217,1864,1869,1865,1875,1858,1860,1864,-9,-5,444426,"828,730.56",909262
,20160218,1860,1864,1864,1869,1856,1866,1861,2,-3,466846,"869,022.48",956304
,20160219,1866,1861,1869,1879,1860,1875,1870,14,9,774936,"1,449,569.68",1061580
,20160222,1875,1870,1878,1928,1872,1922,1904,52,34,1593014,"3,033,232.93",1184086
,20160223,1922,1904,1922,1927,1901,1910,1912,6,8,1128804,"2,158,848.18",1206448
,20160224,1910,1912,1910,1914,1890,1904,1900,-8,-12,958932,"1,822,789.44",1238694
,20160225,1904,1900,1904,1923,1890,1895,1907,-5,7,1118168,"2,133,303.87",1220136
,20160226,1895,1907,1897,1901,1866,1888,1881,-19,-26,1178244,"2,216,278.26",1213226
,20160229,1888,1881,1889,1922,1883,1921,1898,40,17,1542396,"2,928,950.59",1249424
,20160301,1921,1898,1930,1961,1920,1947,1939,49,41,2012248,"3,902,070.03",1298010
,20160302,1947,1939,1950,1987,1946,1976,1964,37,25,1886702,"3,707,247.19",1391358
,20160303,1976,1964,1978,1991,1955,1959,1972,-5,8,1848742,"3,646,274.40",1459396
,20160304,1959,1972,1960,1995,1952,1995,1974,23,2,2869432,"5,665,566.42",1512572
,20160307,1995,1974,1995,2072,1992,2072,2029,98,55,2502608,"5,080,017.29",1592680
,20160308,2072,2029,2191,2191,2058,2191,2138,162,109,4651236,"9,947,595.72",1443566
,20160309,2191,2138,2138,2149,2002,2058,2067,-80,-71,6715152,"13,886,671.68",1269322
,20160310,2058,2067,2063,2161,2063,2086,2104,19,37,8035450,"16,914,518.44",1509926
,20160311,2086,2104,2072,2090,2008,2025,2053,-79,-51,5421854,"11,133,600.53",1649222
,20160314,2025,2053,2000,2076,1985,1986,2024,-67,-29,7468574,"15,116,634.02",1876880
,20160315,1986,2024,1980,2006,1967,1972,1983,-52,-41,6206632,"12,309,045.52",1982310
,20160316,1972,1983,1969,2011,1968,2008,1993,25,10,5064118,"10,096,864.34",2125684
,20160317,2008,1993,2010,2086,2006,2078,2047,85,54,8370102,"17,138,702.35",2207256
,20160318,2078,2047,2082,2149,2073,2118,2119,71,72,12070078,"25,580,159.80",2411642
,20160321,2118,2119,2117,2210,2087,2147,2145,28,26,15519554,"33,298,983.31",2715948
,20160322,2147,2145,2153,2180,2144,2158,2161,13,16,10235742,"22,121,386.61",2637684
,20160323,2158,2161,2155,2240,2138,2193,2195,32,34,15313536,"33,621,097.71",2589898
,20160324,2193,2195,2198,2205,2106,2120,2144,-75,-51,17616140,"37,780,594.39",2456366
,20160325,2120,2144,2117,2185,2114,2184,2143,40,-1,13761106,"29,503,583.86",2597908
,20160328,2184,2143,2190,2219,2127,2132,2183,-11,40,15282150,"33,370,716.01",2704478
,20160329,2132,2183,2140,2172,2123,2159,2148,-24,-35,12704180,"27,294,065.02",2832060
,20160330,2159,2148,2163,2165,2091,2113,2119,-35,-29,15421990,"32,685,030.09",2982268
,20160331,2113,2119,2109,2140,2105,2136,2122,17,3,10882762,"23,101,561.76",2807376
,20160401,2136,2122,2140,2196,2136,2193,2167,71,45,11332698,"24,562,477.86",2849612
,20160405,2193,2167,2207,2209,2152,2194,2180,27,13,7784670,"16,973,642.24",3140770
,20160406,2194,2180,2194,2207,2162,2182,2184,2,4,9508160,"20,769,906.17",3437272
,20160407,2182,2184,2180,2212,2171,2191,2187,7,3,8191230,"17,914,373.65",3571450
,20160408,2191,2187,2188,2199,2178,2196,2189,9,2,7519084,"16,460,881.27",3548056
,20160411,2196,2189,2201,2315,2199,2293,2263,104,74,13939432,"31,546,565.71",4180004
,20160412,2293,2263,2302,2344,2287,2344,2312,81,49,12889096,"29,802,431.46",4273062
,20160413,2344,2312,2351,2435,2332,2353,2366,41,54,19138022,"45,289,124.34",4129856
,20160414,2353,2366,2355,2377,2315,2324,2350,-42,-16,11451662,"26,915,058.64",4028986
,20160415,2324,2350,2320,2340,2296,2300,2318,-50,-32,10863312,"25,182,332.68",3711280
,20160418,2300,2318,2287,2417,2287,2391,2353,73,35,11825572,"27,831,580.05",3715410
,20160419,2391,2353,2397,2494,2396,2494,2446,141,93,14327034,"35,049,836.06",3533946
,20160420,2494,2446,2501,2592,2501,2592,2561,146,115,15687854,"40,178,278.66",3329118
,20160421,2592,2561,2612,2787,2610,2750,2708,189,147,22361440,"60,562,982.85",2797426
,20160422,2750,2708,2735,2740,2591,2619,2652,-89,-56,21928680,"58,174,785.58",2671432
,20160425,2619,2652,2608,2781,2585,2643,2655,-9,3,19860714,"52,746,732.37",2778040
,20160426,2643,2655,2607,2650,2518,2554,2596,-101,-59,13828216,"35,910,943.33",2927298
,20160427,2554,2596,2550,2587,2451,2500,2519,-96,-77,14117966,"35,576,014.58",2892336
,20160428,2500,2519,2503,2548,2456,2539,2507,20,-12,12590112,"31,567,240.50",2901482
,20160429,2539,2507,2548,2590,2533,2580,2567,73,60,11065856,"28,410,070.26",2705042
,20160503,2580,2567,2545,2546,2432,2451,2470,-116,-97,6087006,"15,035,205.55",2702042
,20160504,2451,2470,2439,2448,2365,2381,2407,-89,-63,8158556,"19,640,103.22",2902036
,20160505,2381,2407,2373,2404,2299,2309,2356,-98,-51,8843630,"20,835,655.20",3010258
,20160506,2309,2356,2320,2339,2281,2336,2314,-20,-42,9851786,"22,799,719.75",3079210
,20160509,2336,2314,2343,2352,2175,2175,2257,-139,-57,8700040,"19,643,417.43",3311408
,20160510,2175,2257,2105,2165,2085,2147,2124,-110,-133,10220650,"21,716,047.64",2981232
,20160511,2147,2124,2155,2175,2118,2146,2152,22,28,9657606,"20,789,921.89",3045482
,20160512,2146,2152,2154,2159,2072,2074,2128,-78,-24,8472638,"18,034,333.17",3340930
,20160513,2074,2128,2064,2078,2000,2030,2037,-98,-91,10298962,"20,980,172.67",3500184
,20160516,2030,2037,2022,2086,2013,2052,2053,15,16,8318498,"17,080,318.81",3430758
,20160517,2052,2053,2058,2118,2042,2114,2076,61,23,8366662,"17,371,627.78",3195814
,20160518,2114,2076,2109,2134,2036,2055,2092,-21,16,10649982,"22,289,126.66",2961602
,20160519,2055,2092,2050,2073,2024,2043,2047,-49,-45,8679626,"17,769,940.06",3041332
,20160520,2043,2047,2030,2079,2016,2062,2054,15,7,7550934,"15,512,514.64",3092190
,20160523,2062,2054,2065,2069,1930,1947,1983,-107,-71,7824686,"15,519,207.71",2946832
,20160524,1947,1983,1945,1965,1917,1958,1941,-25,-42,6755808,"13,114,941.52",2962564
,20160525,1958,1941,1963,1973,1912,1916,1941,-25,0,6905020,"13,408,303.25",3045028
,20160526,1916,1941,1920,1958,1907,1953,1940,12,-1,7416702,"14,389,478.97",3043898
,20160527,1953,1940,1965,2048,1926,2033,1987,93,47,11215608,"22,291,275.41",2923206
,20160530,2033,1987,2033,2054,1894,1990,1994,3,7,10207570,"20,356,588.84",2854180
,20160531,1990,1994,1985,2028,1973,1978,1999,-16,5,7125598,"14,246,857.58",2941886
,20160601,1978,1999,1975,1985,1939,1955,1961,-44,-38,5423698,"10,638,925.40",2968202
,20160602,1955,1961,1940,1980,1938,1954,1959,-7,-2,4834340,"9,471,995.99",3035662
,20160603,1954,1959,1952,2003,1950,1988,1980,29,21,5065658,"10,030,773.94",2937758
,20160606,1988,1980,2009,2082,1982,2059,2031,79,51,7362346,"14,953,860.25",2941864
,20160607,2059,2031,2065,2103,2055,2077,2074,46,43,6342670,"13,160,085.70",2758772
,20160608,2077,2074,2076,2115,2038,2099,2080,25,6,7473444,"15,546,416.96",2478334
,20160613,2099,2080,2092,2189,2090,2170,2154,90,74,6223922,"13,408,933.97",2596912
,20160614,2170,2154,2170,2184,2071,2072,2125,-82,-29,8418904,"17,891,292.90",2447134
,20160615,2072,2125,2062,2101,2053,2067,2075,-58,-50,5505990,"11,428,336.72",2452108
,20160616,2067,2075,2082,2118,2068,2074,2086,-1,11,5954174,"12,423,894.66",2476248
,20160617,2074,2086,2069,2080,2028,2074,2054,-12,-32,5880856,"12,081,312.26",2375822
,20160620,2074,2054,2072,2099,2056,2062,2074,8,20,4848484,"10,059,863.74",2389908
,20160621,2062,2074,2053,2115,2048,2082,2085,8,11,5592902,"11,664,643.83",2480160
,20160622,2082,2085,2080,2143,2075,2143,2115,58,30,6999164,"14,809,429.54",2631158
,20160623,2143,2115,2148,2161,2131,2141,2145,26,30,5478706,"11,753,024.47",2686078
,20160624,2141,2145,2153,2168,2100,2126,2140,-19,-5,5838818,"12,495,949.66",2639884
,20160627,2126,2140,2125,2268,2124,2268,2210,128,70,7599160,"16,798,320.72",2806212
,20160628,2268,2210,2268,2288,2234,2265,2265,55,55,5887680,"13,338,703.60",2691696
,20160629,2265,2265,2264,2280,2226,2241,2250,-24,-15,5861356,"13,193,337.61",2608036
,20160630,2241,2250,2237,2345,2233,2337,2295,87,45,7704152,"17,683,897.19",2505608
,20160701,2337,2295,2341,2374,2309,2349,2344,54,49,7083518,"16,609,223.18",2313042
,20160704,2349,2344,2349,2468,2349,2424,2412,80,68,9112380,"21,982,611.70",2073208
,20160705,2424,2412,2430,2454,2311,2402,2385,-10,-27,7311714,"17,442,788.04",1971480
,20160706,2402,2385,2393,2429,2326,2378,2371,-7,-14,8042726,"19,075,690.61",1982898
,20160707,2378,2371,2370,2456,2349,2387,2401,16,30,8375194,"20,116,231.41",2077216
,20160708,2387,2401,2387,2447,2365,2445,2402,44,1,8376194,"20,123,866.03",2413392
,20160711,2445,2402,2464,2484,2361,2430,2422,28,20,7469210,"18,091,755.85",2276468
,20160712,2430,2422,2435,2563,2416,2558,2491,136,69,7774606,"19,371,538.27",2561784
,20160713,2558,2491,2540,2589,2512,2516,2550,25,59,6880472,"17,547,248.11",2494614
,20160714,2516,2550,2523,2542,2478,2524,2511,-26,-39,5581728,"14,020,854.22",2493862
,20160715,2524,2511,2515,2556,2479,2527,2513,16,2,6070020,"15,254,263.99",2463646
,20160718,2527,2513,2528,2535,2362,2362,2439,-151,-74,7009522,"17,102,673.15",2509524
,20160719,2362,2439,2354,2358,2264,2297,2315,-142,-124,7458256,"17,269,425.91",2326466
,20160720,2297,2315,2304,2336,2282,2310,2306,-5,-9,5487648,"12,658,784.92",2295432
,20160721,2310,2306,2309,2432,2278,2396,2353,90,47,7426584,"17,481,651.88",2261552
,20160722,2396,2353,2390,2399,2296,2310,2343,-43,-10,6666442,"15,623,130.27",2172398
,20160725,2310,2343,2311,2368,2279,2342,2331,-1,-12,7003380,"16,327,902.28",2116832
,20160726,2342,2331,2350,2379,2309,2379,2339,48,8,5557718,"12,999,536.00",2159444
,20160727,2379,2339,2377,2449,2367,2418,2405,79,66,7734528,"18,605,418.45",1903086
,20160728,2418,2405,2421,2503,2412,2480,2462,75,57,7475414,"18,410,021.97",1936284
,20160729,2480,2462,2475,2484,2396,2412,2444,-50,-18,5494102,"13,432,904.93",1891324
,20160801,2412,2444,2420,2521,2383,2495,2466,51,22,6510646,"16,061,576.89",1796142
,20160802,2495,2466,2500,2529,2478,2514,2500,48,34,4636956,"11,592,399.11",1857660
,20160803,2514,2500,2517,2522,2471,2497,2495,-3,-5,4146122,"10,345,101.78",1844192
,20160804,2497,2495,2495,2504,2417,2453,2461,-42,-34,5642740,"13,887,167.46",1922344
,20160805,2453,2461,2461,2555,2450,2538,2505,77,44,5161852,"12,934,653.97",1864868
,20160808,2538,2505,2538,2618,2516,2607,2570,102,65,4988876,"12,824,421.92",1968322
,20160809,2607,2570,2607,2628,2549,2589,2591,19,21,4572794,"11,851,168.77",1909702
,20160810,2589,2591,2580,2639,2561,2587,2586,-4,-5,4624264,"11,962,640.06",1905536
,20160811,2587,2586,2587,2602,2535,2594,2572,8,-14,4269190,"10,984,224.74",1963378
,20160812,2594,2572,2580,2590,2555,2577,2574,5,2,3689742,"9,499,582.27",1859538
,20160815,2577,2574,2561,2582,2505,2571,2551,-3,-23,4053394,"10,341,124.91",1783176
,20160816,2571,2551,2571,2687,2563,2648,2629,97,78,4320198,"11,359,710.65",1775446
,20160817,2648,2629,2640,2667,2585,2589,2629,-40,0,3099566,"8,149,464.70",1524614
,20160818,2589,2629,2581,2609,2552,2575,2580,-54,-49,2091794,"5,397,304.91",1356986
,20160819,2575,2580,2577,2586,2530,2553,2556,-27,-24,1409522,"3,603,451.03",1185748
,20160822,2553,2556,2560,2564,2521,2524,2540,-32,-16,1083452,"2,752,299.84",998034
,20160823,2524,2540,2525,2559,2508,2550,2538,10,-2,717280,"1,820,739.88",915470
,20160824,2550,2538,2551,2566,2540,2555,2551,17,13,412776,"1,053,116.33",802194
,20160825,2555,2551,2555,2580,2506,2554,2546,3,-5,695926,"1,772,487.84",633348
,20160826,2554,2546,2545,2567,2514,2518,2541,-28,-5,363852,"924,816.65",586088
,20160829,2518,2541,2513,2520,2481,2513,2502,-28,-39,407244,"1,018,942.79",521678
,20160830,2513,2502,2515,2520,2477,2477,2492,-25,-10,313592,"781,707.85",465536
,20160831,2477,2492,2473,2490,2417,2420,2461,-72,-31,314710,"774,504.51",407612
,20160901,2420,2461,2417,2450,2388,2442,2419,-19,-42,244550,"591,624.76",377828
,20160902,2442,2419,2432,2479,2427,2438,2454,19,35,222948,"547,321.30",345348
,20160905,2438,2454,2450,2461,2438,2442,2449,-12,-5,167714,"410,761.49",316038
,20160906,2442,2449,2442,2465,2422,2436,2435,-13,-14,124762,"303,891.89",299596
,20160907,2436,2435,2435,2440,2361,2370,2394,-65,-41,211276,"505,981.46",268380
,20160908,2370,2394,2368,2390,2363,2374,2375,-20,-19,107134,"254,523.32",246796
,20160909,2374,2375,2371,2374,2317,2334,2333,-41,-42,185036,"431,768.25",234146
,20160912,2334,2333,2333,2333,2243,2248,2290,-85,-43,155176,"355,492.66",207686
,20160913,2248,2290,2256,2264,2218,2226,2242,-64,-48,105440,"236,421.08",182802
,20160914,2226,2242,2229,2255,2225,2234,2239,-8,-3,84612,"189,496.73",160076
,20160919,2234,2239,2180,2234,2174,2228,2220,-11,-19,45520,"101,096.74",145824
,20160920,2228,2220,2222,2265,2222,2249,2241,29,21,61798,"138,499.81",132104
,20160921,2249,2241,2250,2258,2240,2254,2249,13,8,37302,"83,902.92",118620
,20160922,2254,2249,2255,2308,2226,2272,2276,23,27,70296,"160,030.58",103342
,20160923,2272,2276,2277,2290,2251,2286,2279,10,3,34634,"78,936.88",96912
,20160926,2286,2279,2293,2310,2277,2282,2293,3,14,45838,"105,115.87",82752
,20160927,2282,2293,2285,2288,2202,2215,2235,-78,-58,56952,"127,315.27",76248
,20160928,2215,2235,2216,2234,2212,2228,2222,-7,-13,31704,"70,447.91",64764
,20160929,2228,2222,2236,2250,2196,2208,2230,-14,8,37360,"83,325.73",49392
,20160930,2208,2230,2210,2218,2138,2163,2168,-67,-62,43410,"94,118.28",30054
,20161010,2163,2168,2197,2201,2153,2187,2169,19,1,6294,"13,656.72",25620
,20161011,2187,2169,2187,2219,2165,2211,2205,42,36,11820,"26,065.92",17280
,20161012,2211,2205,2220,2260,2213,2260,2237,55,32,11880,"26,587.08",9960
,20161013,2260,2237,2260,2270,2220,2225,2240,-12,3,2460,"5,512.50",8400
,20161014,2225,2240,2233,2273,2232,2273,2260,33,20,1620,"3,661.44",7500
,20161017,2273,2260,2289,2370,2270,2370,2322,110,62,2220,"5,155.38",6480
rb1611,20160104,1794,1796,1810,1835,1778,1784,1802,-12,6,514,926.31,4684
,20160105,1784,1802,1782,1790,1770,1785,1780,-17,-22,606,"1,078.95",4846
,20160106,1785,1780,1791,1791,1770,1779,1782,-1,2,400,712.86,4994
,20160107,1779,1782,1776,1805,1770,1777,1780,-5,-2,772,"1,374.75",5214
,20160108,1777,1780,1778,1778,1753,1763,1762,-17,-18,504,888.38,5092
,20160111,1763,1762,1765,1770,1756,1761,1762,-1,0,292,514.74,5126
,20160112,1761,1762,1756,1763,1735,1736,1747,-26,-15,692,"1,209.21",5222
,20160113,1736,1747,1742,1752,1740,1744,1745,-3,-2,254,443.23,5206
,20160114,1744,1745,1744,1762,1733,1762,1747,17,2,166,290.14,5214
,20160115,1762,1747,1763,1782,1762,1775,1776,28,29,194,344.63,5232
,20160118,1775,1776,1771,1824,1767,1824,1799,48,23,684,"1,230.98",5216
,20160119,1824,1799,1818,1839,1814,1838,1823,39,24,562,"1,024.98",5266
,20160120,1838,1823,1832,1845,1807,1812,1821,-11,-2,708,"1,289.69",5266
,20160121,1812,1821,1808,1818,1798,1798,1805,-23,-16,372,671.46,5356
,20160122,1798,1805,1798,1839,1798,1817,1817,12,12,214,388.98,5344
,20160125,1817,1817,1816,1836,1811,1829,1828,12,11,284,519.18,5388
,20160126,1829,1828,1819,1828,1818,1828,1823,0,-5,190,346.43,5426
,20160127,1828,1823,1827,1847,1823,1838,1835,15,12,190,348.65,5450
,20160128,1838,1835,1836,1847,1806,1806,1827,-29,-8,384,701.62,5474
,20160129,1806,1827,1806,1818,1799,1808,1806,-19,-21,188,339.60,5466
,20160201,1808,1806,1822,1825,1807,1810,1819,4,13,242,440.32,5466
,20160202,1810,1819,1812,1817,1800,1808,1808,-11,-11,338,611.42,5508
,20160203,1808,1808,1812,1820,1801,1820,1808,12,0,56,101.25,5522
,20160204,1820,1808,1816,1836,1813,1834,1826,26,18,542,989.71,5444
,20160205,1834,1826,1838,1838,1814,1825,1821,-1,-5,120,218.61,5416
,20160215,1825,1821,1822,1863,1822,1852,1842,31,21,240,442.17,5418
,20160216,1852,1842,1859,1864,1848,1851,1855,9,13,142,263.46,5418
,20160217,1851,1855,1847,1864,1844,1844,1849,-11,-6,202,373.55,5418
,20160218,1844,1849,1847,1854,1841,1849,1845,0,-4,128,236.17,5416
,20160219,1849,1845,1852,1860,1846,1860,1854,15,9,144,267.00,5416
,20160222,1860,1854,1858,1915,1858,1914,1896,60,42,472,895.20,5392
,20160223,1914,1896,1908,1911,1890,1899,1901,3,5,808,"1,536.08",5632
,20160224,1899,1901,1898,1904,1878,1891,1889,-10,-12,422,797.16,5722
,20160225,1891,1889,1893,1908,1878,1886,1901,-3,12,652,"1,239.50",5768
,20160226,1886,1901,1884,1887,1854,1872,1868,-29,-33,636,"1,188.43",5772
,20160229,1872,1868,1876,1898,1867,1898,1882,30,14,594,"1,118.08",5766
,20160301,1898,1882,1905,1934,1901,1928,1919,46,37,396,760.23,5772
,20160302,1928,1919,1933,1962,1926,1956,1948,37,29,868,"1,690.91",5684
,20160303,1956,1948,1962,1973,1945,1947,1960,-1,12,764,"1,497.65",5886
,20160304,1947,1960,1947,1975,1940,1975,1955,15,-5,740,"1,447.27",5878
,20160307,1975,1955,1985,2052,1979,2052,2035,97,80,838,"1,705.57",5816
,20160308,2052,2035,2153,2197,2037,2196,2141,161,106,3878,"8,306.38",5316
,20160309,2196,2141,2161,2162,2033,2037,2062,-104,-79,1398,"2,883.32",5350
,20160310,2037,2062,2052,2143,2052,2070,2096,8,34,2046,"4,288.48",6006
,20160311,2070,2096,2022,2067,1991,2003,2039,-93,-57,792,"1,615.01",6248
,20160314,2003,2039,1965,2046,1965,1973,2000,-66,-39,470,940.46,6178
,20160315,1973,2000,1971,1981,1948,1951,1961,-49,-39,1618,"3,173.10",6456
,20160316,1951,1961,1958,1984,1958,1982,1971,21,10,186,366.70,6458
,20160317,1982,1971,1987,2056,1987,2050,2022,79,51,624,"1,262.28",6618
,20160318,2050,2022,2049,2123,2049,2091,2083,69,61,798,"1,662.43",6498
,20160321,2091,2083,2087,2172,2060,2118,2102,35,19,862,"1,812.20",6488
,20160322,2118,2102,2119,2137,2109,2120,2124,18,22,376,798.71,6438
,20160323,2120,2124,2120,2193,2104,2145,2163,21,39,936,"2,024.80",6682
,20160324,2145,2163,2145,2150,2072,2082,2114,-81,-49,1098,"2,321.53",6434
,20160325,2082,2114,2099,2140,2084,2140,2103,26,-11,994,"2,090.81",6478
,20160328,2140,2103,2145,2169,2087,2087,2136,-16,33,938,"2,004.37",6368
,20160329,2087,2136,2100,2121,2088,2105,2103,-31,-33,676,"1,421.66",6440
,20160330,2105,2103,2114,2114,2046,2073,2075,-30,-28,278,576.89,6432
,20160331,2073,2075,2075,2095,2060,2087,2081,12,6,608,"1,265.40",6580
,20160401,2087,2081,2094,2146,2094,2146,2122,65,41,354,751.36,6610
,20160405,2146,2122,2133,2161,2105,2141,2118,19,-4,420,889.84,6514
,20160406,2141,2118,2143,2149,2106,2115,2127,-3,9,380,808.44,6536
,20160407,2115,2127,2121,2143,2113,2115,2127,-12,0,314,668.04,6488
,20160408,2115,2127,2120,2127,2112,2125,2121,-2,-6,176,373.32,6490
,20160411,2125,2121,2141,2220,2141,2204,2188,83,67,1768,"3,868.45",6098
,20160412,2204,2188,2213,2259,2210,2259,2222,71,34,862,"1,916.02",5628
,20160413,2259,2222,2265,2345,2251,2274,2282,52,60,1124,"2,565.61",5774
,20160414,2274,2282,2281,2294,2243,2249,2266,-33,-16,1344,"3,046.36",5408
,20160415,2249,2266,2249,2264,2208,2208,2244,-58,-22,202,453.45,5424
,20160418,2208,2244,2175,2339,2175,2319,2290,75,46,690,"1,580.79",5468
,20160419,2319,2290,2334,2420,2334,2420,2371,130,81,562,"1,332.71",5392
,20160420,2420,2371,2450,2513,2428,2513,2485,142,114,1938,"4,816.32",5924
,20160421,2513,2485,2549,2708,2547,2697,2641,212,156,1652,"4,363.72",5906
,20160422,2697,2641,2650,2683,2533,2540,2598,-101,-43,7082,"18,405.06",4520
,20160425,2540,2598,2541,2696,2510,2552,2587,-46,-11,2062,"5,334.50",4848
,20160426,2552,2587,2540,2582,2454,2477,2534,-110,-53,1020,"2,584.89",4546
,20160427,2477,2534,2489,2509,2386,2424,2438,-110,-96,592,"1,443.47",4576
,20160428,2424,2438,2449,2478,2391,2466,2440,28,2,1276,"3,113.78",4532
,20160429,2466,2440,2519,2519,2442,2518,2495,78,55,820,"2,046.17",4390
,20160503,2518,2495,2491,2491,2365,2381,2404,-114,-91,238,572.26,4386
,20160504,2381,2404,2364,2379,2308,2314,2341,-90,-63,144,337.23,4398
,20160505,2314,2341,2312,2323,2229,2242,2263,-99,-78,330,746.98,4558
,20160506,2242,2263,2250,2268,2219,2263,2248,0,-15,270,607.22,4562
,20160509,2263,2248,2268,2281,2113,2113,2163,-135,-85,1388,"3,002.63",4482
,20160510,2113,2163,2037,2098,2022,2077,2063,-86,-100,1158,"2,389.92",4326
,20160511,2077,2063,2092,2113,2059,2088,2089,25,26,670,"1,400.19",4320
,20160512,2088,2089,2088,2151,2028,2036,2088,-53,-1,1478,"3,087.44",4498
,20160513,2036,2088,2019,2042,1965,1993,1996,-95,-92,1246,"2,487.24",4528
,20160516,1993,1996,1982,2040,1982,2018,2027,22,31,1306,"2,647.32",4592
,20160517,2018,2027,2027,2078,2007,2069,2037,42,10,776,"1,581.21",4638
,20160518,2069,2037,2072,2106,2003,2024,2071,-13,34,1318,"2,729.90",4714
,20160519,2024,2071,2000,2035,1994,2008,2010,-63,-61,916,"1,841.93",4714
,20160520,2008,2010,1987,2037,1982,2027,2019,17,9,386,779.45,4604
,20160523,2027,2019,2033,2033,1897,1938,1937,-81,-82,634,"1,228.40",4688
,20160524,1938,1937,1916,1929,1886,1921,1905,-16,-32,334,636.44,4650
,20160525,1921,1905,1932,1932,1886,1888,1914,-17,9,260,497.82,4688
,20160526,1888,1914,1920,1923,1901,1917,1913,3,-1,560,"1,071.30",4914
,20160527,1917,1913,1928,2009,1901,2000,1961,87,48,612,"1,200.52",4884
,20160530,2000,1961,2003,2018,1875,1972,1962,11,1,1416,"2,778.45",4694
,20160531,1972,1962,1971,1997,1939,1948,1965,-14,3,406,798.19,4668
,20160601,1948,1965,1949,1954,1918,1929,1931,-36,-34,334,645.07,4706
,20160602,1929,1931,1926,1957,1924,1931,1934,0,3,388,750.68,4932
,20160603,1931,1934,1929,1967,1926,1956,1948,22,14,762,"1,484.96",5050
,20160606,1956,1948,1965,2033,1956,2017,1999,69,51,806,"1,611.80",4832
,20160607,2017,1999,2017,2055,2012,2037,2028,38,29,388,787.12,4820
,20160608,2037,2028,2037,2068,2001,2047,2035,19,7,410,834.67,4762
,20160613,2047,2035,2064,2132,2064,2117,2094,82,59,638,"1,336.41",4906
,20160614,2117,2094,2131,2131,2037,2037,2084,-57,-10,496,"1,034.10",4928
,20160615,2037,2084,2023,2057,2018,2026,2035,-58,-49,348,708.41,4962
,20160616,2026,2035,2048,2084,2030,2038,2046,3,11,912,"1,866.81",5174
,20160617,2038,2046,2021,2040,1995,2036,2014,-10,-32,416,838.24,5172
,20160620,2036,2014,2041,2052,2016,2027,2037,13,23,292,595.02,5122
,20160621,2027,2037,2019,2068,2019,2038,2056,1,19,654,"1,344.85",5140
,20160622,2038,2056,2054,2092,2051,2092,2076,36,20,436,905.28,5196
,20160623,2092,2076,2097,2109,2084,2098,2096,22,20,320,670.73,5116
,20160624,2098,2096,2087,2114,2053,2071,2086,-25,-10,358,746.89,5004
,20160627,2071,2086,2068,2211,2068,2211,2171,125,85,1064,"2,310.41",4866
,20160628,2211,2171,2214,2230,2185,2230,2210,59,39,418,924.13,4806
,20160629,2230,2210,2206,2228,2182,2197,2196,-13,-14,336,738.06,4660
,20160630,2197,2196,2198,2287,2194,2287,2240,91,44,414,927.64,4688
,20160701,2287,2240,2284,2333,2264,2290,2287,50,47,1202,"2,749.92",4610
,20160704,2290,2287,2310,2419,2310,2365,2365,78,78,762,"1,802.56",4724
,20160705,2365,2365,2369,2408,2279,2357,2336,-8,-29,634,"1,481.48",4560
,20160706,2357,2336,2352,2380,2286,2326,2318,-10,-18,642,"1,488.65",4476
,20160707,2326,2318,2309,2399,2307,2335,2344,17,26,704,"1,650.52",4604
,20160708,2335,2344,2339,2383,2322,2382,2355,38,11,404,951.61,4682
,20160711,2382,2355,2417,2417,2325,2375,2364,20,9,316,747.33,4608
,20160712,2375,2364,2375,2487,2368,2479,2433,115,69,424,"1,031.77",4618
,20160713,2479,2433,2483,2510,2438,2452,2488,19,55,1786,"4,444.31",3960
,20160714,2452,2488,2453,2463,2415,2445,2436,-43,-52,380,925.91,3802
,20160715,2445,2436,2451,2533,2411,2455,2454,19,18,436,"1,070.32",3802
,20160718,2455,2454,2434,2434,2306,2306,2374,-148,-80,604,"1,434.36",3860
,20160719,2306,2374,2296,2296,2205,2237,2265,-137,-109,1562,"3,538.25",3696
,20160720,2237,2265,2245,2264,2220,2249,2243,-16,-22,282,632.75,3710
,20160721,2249,2243,2241,2359,2221,2335,2289,92,46,602,"1,378.51",3716
,20160722,2335,2289,2328,2328,2242,2257,2284,-32,-5,188,429.54,3626
,20160725,2257,2284,2259,2300,2228,2279,2276,-5,-8,190,432.49,3590
,20160726,2279,2276,2292,2311,2256,2310,2281,34,5,208,474.64,3634
,20160727,2310,2281,2317,2385,2308,2347,2344,66,63,400,937.87,3568
,20160728,2347,2344,2375,2459,2294,2421,2398,77,54,506,"1,213.72",3572
,20160729,2421,2398,2411,2415,2346,2346,2385,-52,-13,198,472.30,3548
,20160801,2346,2385,2355,2467,2328,2454,2423,69,38,656,"1,589.78",3594
,20160802,2454,2423,2433,2468,2421,2458,2444,35,21,212,518.32,3584
,20160803,2458,2444,2456,2456,2418,2441,2434,-3,-10,92,223.98,3562
,20160804,2441,2434,2433,2433,2366,2390,2399,-44,-35,346,830.13,3570
,20160805,2390,2399,2395,2492,2392,2474,2449,75,50,164,401.77,3568
,20160808,2474,2449,2480,2542,2461,2542,2511,93,62,652,"1,637.60",3558
,20160809,2542,2511,2535,2546,2478,2511,2524,0,13,472,"1,191.50",3588
,20160810,2511,2524,2499,2540,2484,2503,2504,-21,-20,288,721.27,3486
,20160811,2503,2504,2486,2515,2462,2508,2494,4,-10,320,798.32,3392
,20160812,2508,2494,2487,2505,2480,2505,2492,11,-2,78,194.39,3388
,20160815,2505,2492,2485,2492,2437,2487,2469,-5,-23,402,992.67,3408
,20160816,2487,2469,2494,2595,2489,2574,2559,105,90,446,"1,141.69",3412
,20160817,2574,2559,2570,2579,2476,2519,2539,-40,-20,526,"1,335.86",3288
,20160818,2519,2539,2512,2534,2500,2508,2512,-31,-27,416,"1,045.39",3128
,20160819,2508,2512,2516,2518,2480,2514,2498,2,-14,750,"1,873.70",2810
,20160822,2514,2498,2505,2512,2483,2483,2493,-15,-5,532,"1,326.43",2752
,20160823,2483,2493,2464,2518,2463,2517,2492,24,-1,384,956.95,2748
,20160824,2517,2492,2504,2519,2500,2510,2506,18,14,220,551.48,2730
,20160825,2510,2506,2526,2534,2463,2505,2507,-1,1,610,"1,529.32",2646
,20160826,2505,2507,2510,2525,2481,2481,2507,-26,0,212,531.67,2670
,20160829,2481,2507,2462,2470,2440,2465,2456,-42,-51,154,378.28,2656
,20160830,2465,2456,2468,2468,2420,2420,2439,-36,-17,392,956.11,2776
,20160831,2420,2439,2423,2428,2363,2364,2405,-75,-34,230,553.24,2814
,20160901,2364,2405,2354,2368,2329,2361,2358,-44,-47,1672,"3,942.96",3404
,20160902,2361,2358,2373,2396,2350,2363,2378,5,20,908,"2,159.59",3842
,20160905,2363,2378,2378,2405,2376,2376,2388,-2,10,472,"1,127.31",3852
,20160906,2376,2388,2385,2386,2363,2371,2378,-17,-10,218,518.50,3830
,20160907,2371,2378,2368,2369,2294,2302,2331,-76,-47,306,713.32,3842
,20160908,2302,2331,2302,2331,2293,2319,2313,-12,-18,218,504.31,3848
,20160909,2319,2313,2311,2311,2265,2286,2275,-27,-38,940,"2,139.26",4420
,20160912,2286,2275,2286,2298,2203,2208,2248,-67,-27,1452,"3,265.21",5154
,20160913,2208,2248,2209,2223,2179,2180,2197,-68,-51,1230,"2,702.68",5072
,20160914,2180,2197,2183,2209,2180,2190,2196,-7,-1,770,"1,691.44",4958
,20160919,2190,2196,2162,2190,2150,2188,2178,-8,-18,458,997.95,5034
,20160920,2188,2178,2191,2222,2188,2209,2201,31,23,636,"1,399.95",5048
,20160921,2209,2201,2206,2227,2197,2215,2210,14,9,834,"1,843.60",4974
,20160922,2215,2210,2224,2270,2224,2230,2245,20,35,510,"1,145.28",4950
,20160923,2230,2245,2227,2257,2225,2248,2242,3,-3,540,"1,211.18",4960
,20160926,2248,2242,2252,2285,2252,2254,2266,12,24,502,"1,137.65",5036
,20160927,2254,2266,2256,2256,2172,2202,2212,-64,-54,1042,"2,305.80",5334
,20160928,2202,2212,2187,2211,2176,2207,2192,-5,-20,674,"1,477.95",5354
,20160929,2207,2192,2212,2239,2164,2200,2224,8,32,2090,"4,648.76",5288
,20160930,2200,2224,2200,2204,2159,2179,2177,-45,-47,1602,"3,488.44",5144
,20161010,2179,2177,2174,2191,2032,2186,2168,9,-9,808,"1,751.95",5018
,20161011,2186,2168,2193,2229,2191,2219,2212,51,44,1108,"2,451.10",4846
,20161012,2219,2212,2226,2266,2225,2266,2232,54,20,1434,"3,201.19",4172
,20161013,2266,2232,2266,2293,2266,2280,2277,48,45,1006,"2,291.15",3990
,20161014,2280,2277,2285,2340,2275,2330,2309,53,32,862,"1,990.73",3966
,20161017,2330,2309,2323,2376,2320,2372,2361,63,52,1132,"2,672.98",3774
,20161018,2372,2361,2370,2370,2359,2364,2364,3,3,726,"1,716.32",3646
,20161019,2364,2364,2377,2441,2377,2404,2412,40,48,682,"1,645.51",3682
,20161020,2404,2412,2357,2435,2356,2425,2404,13,-8,680,"1,635.16",3680
,20161021,2425,2404,2439,2440,2400,2410,2423,6,19,704,"1,706.06",3522
,20161024,2410,2423,2400,2425,2390,2425,2403,2,-20,536,"1,288.53",3216
,20161025,2425,2403,2430,2458,2417,2440,2444,37,41,948,"2,317.25",2738
,20161026,2440,2444,2464,2477,2399,2402,2425,-42,-19,524,"1,270.79",2508
,20161027,2402,2425,2399,2409,2365,2367,2391,-58,-34,472,"1,128.56",2332
,20161028,2367,2391,2390,2427,2383,2395,2398,4,7,408,978.41,2132
,20161031,2395,2398,2372,2510,2372,2441,2415,43,17,194,468.60,2100
,20161101,2441,2415,2430,2455,2425,2455,2432,40,17,600,"1,459.20",2100
,20161102,2455,2432,2500,2510,2466,2466,2486,34,54,420,"1,044.36",2280
,20161103,2466,2486,2486,2500,2486,2500,2493,14,7,120,299.16,2220
,20161104,2500,2493,2565,2579,2565,2579,2572,86,79,120,308.64,2100
,20161107,2579,2572,2620,2700,2620,2700,2665,128,93,540,"1,439.28",2340
,20161108,2700,2665,2650,2650,2650,2650,2650,-15,-15,60,159.00,2340
,20161109,2650,2650,2720,2760,2679,2760,2731,110,81,360,983.34,2640
,20161110,2760,2731,2796,2820,2619,2700,2724,-31,-7,420,"1,144.44",2760
,20161111,2700,2724,2731,2820,2731,2820,2790,96,66,180,502.26,2940
,20161114,2820,2790,2850,2850,2622,2622,2736,-168,-54,120,328.32,2940
,20161115,2622,2736,2633,2633,2596,2596,2614,-140,-122,240,627.48,2940
rb1612,20160104,1817,1816,1823,1840,1802,1802,1813,-14,-3,138,250.33,442
,20160105,1802,1813,1804,1809,1784,1801,1796,-12,-17,168,301.79,490
,20160106,1801,1796,1801,1809,1779,1787,1795,-9,-1,372,667.77,720
,20160107,1787,1795,1794,1802,1786,1789,1794,-6,-1,156,279.88,736
,20160108,1789,1794,1786,1789,1758,1778,1777,-16,-17,188,334.13,764
,20160111,1778,1777,1781,1783,1763,1777,1777,0,0,204,362.57,666
,20160112,1777,1777,1773,1776,1753,1753,1763,-24,-14,192,338.67,690
,20160113,1753,1763,1758,1767,1754,1756,1759,-7,-4,170,299.14,746
,20160114,1756,1759,1760,1775,1750,1775,1765,16,6,376,663.68,766
,20160115,1775,1765,1773,1794,1773,1777,1783,12,18,156,278.30,806
,20160118,1777,1783,1779,1830,1772,1828,1809,45,26,400,723.63,1010
,20160119,1828,1809,1833,1843,1823,1837,1832,28,23,100,183.22,1006
,20160120,1837,1832,1837,1855,1812,1815,1831,-17,-1,80,146.48,1018
,20160121,1815,1831,1810,1823,1800,1800,1812,-31,-19,290,525.50,1092
,20160122,1800,1812,1809,1843,1809,1818,1826,6,14,362,661.05,1022
,20160125,1818,1826,1829,1852,1820,1832,1836,6,10,58,106.49,1028
,20160126,1832,1836,1831,1838,1804,1833,1829,-3,-7,146,267.16,1040
,20160127,1833,1829,1836,1850,1834,1844,1845,15,16,142,262.07,1058
,20160128,1844,1845,1849,1857,1814,1814,1839,-31,-6,150,275.87,1026
,20160129,1814,1839,1814,1828,1806,1811,1815,-28,-24,92,167.04,1024
,20160201,1811,1815,1825,1834,1816,1816,1823,1,8,98,178.68,1002
,20160202,1816,1823,1812,1818,1805,1810,1815,-13,-8,86,156.16,1012
,20160203,1810,1815,1818,1820,1812,1820,1819,5,4,176,320.15,1128
,20160204,1820,1819,1826,1848,1826,1846,1843,27,24,126,232.31,1086
,20160205,1846,1843,1840,1840,1828,1837,1835,-6,-8,124,227.59,1088
,20160215,1837,1835,1836,1872,1836,1862,1855,27,20,44,81.62,1108
,20160216,1862,1855,1871,1873,1856,1857,1862,2,7,350,652.01,1066
,20160217,1857,1862,1857,1866,1849,1849,1856,-13,-6,114,211.65,1082
,20160218,1849,1856,1848,1848,1848,1848,1848,-8,-8,2,3.70,1084
,20160219,1848,1848,1861,1869,1853,1859,1860,11,12,72,133.98,1052
,20160222,1859,1860,1873,1920,1865,1917,1899,57,39,264,501.34,1002
,20160223,1917,1899,1910,1919,1900,1901,1909,2,10,292,557.45,1052
,20160224,1901,1909,1904,1907,1884,1894,1895,-15,-14,122,231.21,1080
,20160225,1894,1895,1909,1916,1876,1888,1904,-7,9,170,323.82,1064
,20160226,1888,1904,1895,1895,1866,1881,1873,-23,-31,52,97.43,1074
,20160229,1881,1873,1880,1903,1875,1896,1890,23,17,390,737.37,1084
,20160301,1896,1890,1909,1968,1908,1939,1924,49,34,442,850.60,1050
,20160302,1939,1924,1942,1976,1929,1966,1954,42,30,334,652.88,1018
,20160303,1966,1954,1970,1982,1951,1951,1968,-3,14,306,602.42,980
,20160304,1951,1968,1953,1983,1929,1975,1970,7,2,300,591.09,1030
,20160307,1975,1970,1988,2068,1988,2068,2046,98,76,112,229.25,1042
,20160308,2068,2046,2149,2209,2040,2199,2161,153,115,2226,"4,812.04",1520
,20160309,2199,2161,2093,2117,2052,2052,2072,-109,-89,1296,"2,685.84",1624
,20160310,2052,2072,2072,2145,2057,2079,2096,7,24,1282,"2,688.33",1922
,20160311,2079,2096,2062,2062,1991,2005,2027,-91,-69,892,"1,808.84",2050
,20160314,2005,2027,1986,2050,1960,1970,2002,-57,-25,516,"1,033.37",2054
,20160315,1970,2002,1969,1981,1954,1958,1965,-44,-37,298,585.78,1936
,20160316,1958,1965,1950,1985,1950,1983,1972,18,7,182,359.02,1912
,20160317,1983,1972,1997,2051,1990,2035,2018,63,46,216,435.92,1910
,20160318,2035,2018,2051,2110,2047,2110,2085,92,67,438,913.65,1874
,20160321,2110,2085,2087,2160,2056,2111,2098,26,13,632,"1,326.46",1882
,20160322,2111,2098,2111,2136,2099,2114,2120,16,22,158,335.04,1880
,20160323,2114,2120,2120,2180,2099,2147,2146,27,26,394,845.72,1908
,20160324,2147,2146,2141,2153,2069,2073,2098,-73,-48,706,"1,481.73",2012
,20160325,2073,2098,2086,2129,2084,2128,2101,30,3,164,344.62,2012
,20160328,2128,2101,2127,2159,2070,2070,2114,-31,13,740,"1,564.81",1992
,20160329,2070,2114,2084,2109,2065,2086,2087,-28,-27,392,818.16,2158
,20160330,2086,2087,2089,2089,2033,2049,2053,-38,-34,512,"1,051.60",2148
,20160331,2049,2053,2058,2155,2044,2067,2083,14,30,334,695.87,2222
,20160401,2067,2083,2071,2110,2057,2108,2089,25,6,558,"1,165.99",2296
,20160405,2108,2089,2069,2116,2069,2097,2090,8,1,372,777.77,2338
,20160406,2097,2090,2106,2109,2086,2098,2098,8,8,224,470.15,2282
,20160407,2098,2098,2100,2116,2093,2116,2106,18,8,136,286.46,2292
,20160408,2116,2106,2097,2110,2097,2110,2107,4,1,164,345.63,2336
,20160411,2110,2107,2121,2198,2121,2170,2166,63,59,720,"1,559.84",2262
,20160412,2170,2166,2180,2237,2174,2225,2196,59,30,636,"1,396.68",2260
,20160413,2225,2196,2238,2327,2064,2274,2263,78,67,982,"2,222.73",2336
,20160414,2274,2263,2269,2280,2227,2227,2256,-36,-7,744,"1,679.03",2190
,20160415,2227,2256,2220,2236,2211,2211,2226,-45,-30,308,685.79,2238
,20160418,2211,2226,2205,2320,2205,2297,2269,71,43,534,"1,212.07",2184
,20160419,2297,2269,2321,2405,2313,2405,2345,136,76,1136,"2,664.69",2424
,20160420,2405,2345,2411,2485,2411,2485,2469,140,124,1524,"3,763.80",2416
,20160421,2485,2469,2435,2684,2435,2668,2610,199,141,1642,"4,286.64",2678
,20160422,2668,2610,2588,2630,2500,2521,2559,-89,-51,1470,"3,762.00",2474
,20160425,2521,2559,2520,2670,2500,2537,2567,-22,8,1256,"3,224.46",2544
,20160426,2537,2567,2487,2541,2439,2465,2501,-102,-66,286,715.37,2520
,20160427,2465,2501,2480,2488,2363,2410,2404,-91,-97,764,"1,836.81",2670
,20160428,2410,2404,2421,2519,2333,2435,2412,31,8,1942,"4,685.77",3036
,20160429,2435,2412,2452,2494,2442,2487,2471,75,59,1864,"4,607.17",2536
,20160503,2487,2471,2432,2437,2348,2366,2386,-105,-85,452,"1,078.69",2410
,20160504,2366,2386,2331,2364,2259,2293,2302,-93,-84,836,"1,925.21",2396
,20160505,2293,2302,2299,2312,2208,2217,2266,-85,-36,544,"1,232.80",2512
,20160506,2217,2266,2226,2264,2196,2243,2237,-23,-29,404,904.04,2410
,20160509,2243,2237,2259,2259,2102,2102,2146,-135,-91,734,"1,575.67",2270
,20160510,2102,2146,2039,2102,1997,2078,2042,-68,-104,1726,"3,524.99",2510
,20160511,2078,2042,2103,2104,2056,2104,2087,62,45,272,567.73,2468
,20160512,2104,2087,2090,2103,2022,2033,2055,-54,-32,764,"1,570.36",2550
,20160513,2033,2055,2022,2035,1941,2001,1987,-54,-68,990,"1,967.73",2444
,20160516,2001,1987,1992,2036,1992,2016,2012,29,25,496,998.22,2448
,20160517,2016,2012,2013,2069,2008,2069,2025,57,13,310,627.81,2512
,20160518,2069,2025,2067,2089,2007,2020,2043,-5,18,356,727.63,2510
,20160519,2020,2043,2018,2032,1993,1998,2016,-45,-27,142,286.40,2498
,20160520,1998,2016,1996,2032,1993,2024,2013,8,-3,128,257.70,2500
,20160523,2024,2013,2015,2015,1892,1926,1932,-87,-81,386,746.07,2554
,20160524,1926,1932,1919,1963,1899,1919,1917,-13,-15,756,"1,449.30",2556
,20160525,1919,1917,1928,1934,1897,1901,1915,-16,-2,158,302.72,2556
,20160526,1901,1915,1901,1935,1901,1935,1920,20,5,312,599.19,2602
,20160527,1935,1920,1924,2006,1911,1999,1961,79,41,362,710.19,2550
,20160530,1999,1961,1999,2019,1903,1967,1960,6,-1,526,"1,031.31",2528
,20160531,1967,1960,1970,1991,1952,1956,1966,-4,6,204,401.21,2548
,20160601,1956,1966,1953,1966,1928,1938,1943,-28,-23,158,307.01,2556
,20160602,1938,1943,1934,1960,1932,1940,1942,-3,-1,214,415.69,2562
,20160603,1940,1942,1954,1988,1954,1970,1970,28,28,160,315.29,2536
,20160606,1970,1970,1998,2044,1969,2033,1998,63,28,406,811.54,2470
,20160607,2033,1998,2037,2069,2032,2041,2042,43,44,214,437.17,2462
,20160608,2041,2042,2036,2100,2020,2062,2077,20,35,1210,"2,513.45",2646
,20160613,2062,2077,2079,2129,2056,2122,2090,45,13,786,"1,643.07",2524
,20160614,2122,2090,2123,2124,2031,2043,2082,-47,-8,394,820.46,2568
,20160615,2043,2082,2031,2054,2021,2027,2038,-55,-44,204,415.79,2520
,20160616,2027,2038,2041,2065,2030,2030,2043,-8,5,958,"1,957.44",2994
,20160617,2030,2043,2027,2037,2003,2031,2018,-12,-25,230,464.34,2954
,20160620,2031,2018,2032,2051,2025,2032,2040,14,22,94,191.79,2974
,20160621,2032,2040,2027,2064,2024,2033,2047,-7,7,180,368.49,2954
,20160622,2033,2047,2045,2080,2045,2078,2066,31,19,182,376.08,2988
,20160623,2078,2066,2084,2100,2075,2078,2087,12,21,98,204.58,2992
,20160624,2078,2087,2097,2097,2055,2070,2076,-17,-11,134,278.20,3004
,20160627,2070,2076,2073,2200,2073,2200,2157,124,81,264,569.52,2980
,20160628,2200,2157,2193,2216,2175,2202,2200,45,43,444,976.87,2720
,20160629,2202,2200,2189,2227,2175,2189,2197,-11,-3,238,522.98,2728
,20160630,2189,2197,2193,2280,2192,2274,2234,77,37,262,585.44,2734
,20160701,2274,2234,2285,2302,2261,2263,2281,29,47,270,616.02,2764
,20160704,2263,2281,2277,2387,2277,2342,2333,61,52,1240,"2,893.62",2756
,20160705,2342,2333,2361,2364,2238,2327,2287,-6,-46,456,"1,043.15",2760
,20160706,2327,2287,2353,2353,2251,2288,2290,1,3,240,549.64,2718
,20160707,2288,2290,2275,2350,2268,2290,2322,0,32,1076,"2,499.16",2708
,20160708,2290,2322,2316,2343,2279,2341,2310,19,-12,256,591.40,2718
,20160711,2341,2310,2372,2374,2285,2328,2326,18,16,128,297.84,2708
,20160712,2328,2326,2418,2446,2237,2446,2354,120,28,320,753.43,2722
,20160713,2446,2354,2428,2460,2417,2418,2440,64,86,394,961.41,2634
,20160714,2418,2440,2421,2435,2399,2423,2406,-17,-34,308,741.13,2536
,20160715,2423,2406,2429,2453,2396,2428,2419,22,13,222,537.14,2522
,20160718,2428,2419,2394,2411,2273,2273,2333,-146,-86,212,494.77,2540
,20160719,2273,2333,2277,2284,2182,2243,2244,-90,-89,478,"1,072.64",2424
,20160720,2243,2244,2211,2244,2210,2226,2224,-18,-20,152,338.07,2404
,20160721,2226,2224,2201,2355,2201,2330,2264,106,40,202,457.44,2408
,20160722,2330,2264,2305,2305,2211,2232,2259,-32,-5,982,"2,218.58",2396
,20160725,2232,2259,2236,2291,2210,2256,2245,-3,-14,164,368.32,2394
,20160726,2256,2245,2310,2310,2233,2280,2274,35,29,238,541.27,2412
,20160727,2280,2274,2290,2360,2290,2337,2328,63,54,626,"1,457.44",2464
,20160728,2337,2328,2356,2419,2312,2397,2372,69,44,772,"1,831.30",2338
,20160729,2397,2372,2386,2394,2318,2331,2366,-41,-6,380,899.37,2284
,20160801,2331,2366,2412,2430,2306,2421,2371,55,5,1214,"2,878.88",2276
,20160802,2421,2371,2416,2432,2397,2429,2416,58,45,360,869.98,2270
,20160803,2429,2416,2424,2447,2389,2406,2409,-10,-7,226,544.66,2284
,20160804,2406,2409,2371,2415,2340,2364,2370,-45,-39,274,649.49,2294
,20160805,2364,2370,2376,2460,2364,2450,2426,80,56,404,980.38,2278
,20160808,2450,2426,2441,2513,2425,2497,2482,71,56,660,"1,638.35",2322
,20160809,2497,2482,2497,2506,2443,2470,2481,-12,-1,262,650.10,2326
,20160810,2470,2481,2483,2514,2449,2470,2477,-11,-4,296,733.34,2336
,20160811,2470,2477,2476,2480,2402,2471,2460,-6,-17,288,708.75,2344
,20160812,2471,2460,2465,2470,2444,2458,2459,-2,-1,138,339.36,2332
,20160815,2458,2459,2433,2446,2392,2438,2427,-21,-32,480,"1,165.32",2338
,20160816,2438,2427,2427,2557,2427,2530,2484,103,57,628,"1,560.04",2342
,20160817,2530,2484,2589,2589,2475,2489,2535,5,51,550,"1,394.57",2380
,20160818,2489,2535,2465,2519,2465,2499,2496,-36,-39,554,"1,382.90",2344
,20160819,2499,2496,2484,2516,2460,2507,2493,11,-3,366,912.47,2298
,20160822,2507,2493,2513,2537,2494,2495,2513,2,20,516,"1,296.87",2268
,20160823,2495,2513,2516,2550,2479,2547,2521,34,8,298,751.37,2242
,20160824,2547,2521,2545,2564,2532,2542,2547,21,26,184,468.65,2132
,20160825,2542,2547,2553,2563,2454,2510,2509,-37,-38,186,466.71,2026
,20160826,2510,2509,2524,2530,2475,2476,2505,-33,-4,154,385.89,2024
,20160829,2476,2505,2459,2460,2414,2443,2442,-62,-63,160,390.80,1942
,20160830,2443,2442,2451,2451,2399,2401,2416,-41,-26,218,526.75,1852
,20160831,2401,2416,2410,2419,2370,2370,2392,-46,-24,98,234.50,1836
,20160901,2370,2392,2341,2385,2341,2385,2356,-7,-36,974,"2,295.62",1830
,20160902,2385,2356,2370,2436,2369,2390,2398,34,42,414,992.84,1856
,20160905,2390,2398,2366,2430,2366,2408,2415,10,17,86,207.71,1876
,20160906,2408,2415,2416,2430,2393,2393,2403,-22,-12,240,576.91,1862
,20160907,2393,2403,2377,2377,2321,2323,2341,-80,-62,334,782.18,1944
,20160908,2323,2341,2322,2361,2317,2340,2334,-1,-7,1314,"3,067.69",2700
,20160909,2340,2334,2325,2342,2301,2342,2320,8,-14,724,"1,679.71",3134
,20160912,2342,2320,2329,2342,2265,2267,2290,-53,-30,1080,"2,474.27",3916
,20160913,2267,2290,2262,2285,2234,2247,2245,-43,-45,464,"1,042.09",3886
,20160914,2247,2245,2257,2266,2245,2247,2256,2,11,636,"1,434.83",4230
,20160919,2247,2256,2202,2251,2201,2243,2232,-13,-24,374,834.83,4320
,20160920,2243,2232,2245,2279,2245,2265,2257,33,25,476,"1,074.51",4430
,20160921,2265,2257,2265,2265,2246,2258,2257,1,0,200,451.58,4412
,20160922,2258,2257,2270,2315,2270,2287,2283,30,26,226,516.06,4456
,20160923,2287,2283,2289,2329,2279,2302,2301,19,18,1410,"3,245.44",4952
,20160926,2302,2301,2328,2354,2313,2328,2332,27,31,604,"1,408.86",5276
,20160927,2328,2332,2328,2328,2265,2280,2292,-52,-40,706,"1,618.62",5728
,20160928,2280,2292,2261,2317,2261,2291,2282,-1,-10,498,"1,136.49",5846
,20160929,2291,2282,2292,2335,2283,2285,2312,3,30,1482,"3,427.57",5964
,20160930,2285,2312,2290,2293,2257,2267,2271,-45,-41,602,"1,367.67",6162
,20161010,2267,2271,2282,2282,2227,2280,2247,9,-24,352,791.29,6168
,20161011,2280,2247,2290,2349,2285,2334,2321,87,74,1630,"3,784.57",7052
,20161012,2334,2321,2357,2368,2327,2366,2343,45,22,1166,"2,733.03",7002
,20161013,2366,2343,2372,2386,2352,2376,2367,33,24,1092,"2,585.25",7604
,20161014,2376,2367,2356,2439,2355,2421,2396,54,29,1118,"2,678.79",7650
,20161017,2421,2396,2418,2472,2415,2463,2445,67,49,478,"1,169.07",7582
,20161018,2463,2445,2453,2477,2406,2477,2448,32,3,906,"2,218.09",7662
,20161019,2477,2448,2483,2555,2483,2506,2525,58,77,2450,"6,187.22",7840
,20161020,2506,2525,2509,2550,2508,2542,2539,17,14,944,"2,397.17",7624
,20161021,2542,2539,2562,2562,2499,2541,2525,2,-14,1416,"3,576.69",7550
,20161024,2541,2525,2538,2556,2475,2556,2532,31,7,1288,"3,261.97",7084
,20161025,2556,2532,2560,2598,2545,2590,2574,58,42,1958,"5,041.54",5844
,20161026,2590,2574,2595,2605,2544,2553,2572,-21,-2,924,"2,376.56",5624
,20161027,2553,2572,2555,2576,2522,2549,2551,-23,-21,1036,"2,642.94",5630
,20161028,2549,2551,2560,2588,2556,2578,2567,27,16,658,"1,689.30",5426
,20161031,2578,2567,2594,2608,2559,2591,2582,24,15,386,996.83,5326
,20161101,2591,2582,2623,2634,2571,2622,2614,40,32,824,"2,154.52",4996
,20161102,2622,2614,2646,2672,2603,2626,2635,12,21,302,796.06,4924
,20161103,2626,2635,2627,2695,2615,2695,2655,60,20,540,"1,434.17",4928
,20161104,2695,2655,2720,2776,2699,2735,2731,80,76,408,"1,114.31",4938
,20161107,2735,2731,2767,2894,2737,2894,2837,163,106,370,"1,049.84",4890
,20161108,2894,2837,2899,2946,2822,2872,2908,35,71,1146,"3,333.10",4856
,20161109,2872,2908,2865,3064,2848,3030,2971,122,63,784,"2,329.47",4842
,20161110,3030,2971,3055,3135,2978,3048,3040,77,69,350,"1,064.32",4732
,20161111,3048,3040,3040,3163,3000,3129,3084,89,44,904,"2,788.66",4318
,20161114,3129,3084,3159,3235,2961,2986,3089,-98,5,732,"2,261.21",4094
,20161115,2986,3089,2967,3041,2903,2903,2972,-186,-117,220,653.97,4104
,20161116,2903,2972,2851,2915,2795,2880,2864,-92,-108,346,990.96,4216
,20161117,2880,2864,2871,2945,2828,2871,2884,7,20,198,571.04,4194
,20161118,2871,2884,2921,2921,2838,2857,2873,-27,-11,288,827.57,4194
,20161121,2857,2873,2846,2863,2799,2826,2831,-47,-42,390,"1,104.13",4178
,20161122,2826,2831,2786,2957,2786,2957,2916,126,85,578,"1,685.87",3812
,20161123,2957,2916,2959,3021,2937,3021,2970,105,54,378,"1,122.87",3594
,20161124,3021,2970,2992,3121,2923,3073,3062,103,92,968,"2,964.07",3328
,20161125,3073,3062,3062,3148,3062,3145,3119,83,57,1702,"5,310.06",3606
,20161128,3145,3119,3104,3284,3094,3237,3182,118,63,504,"1,603.78",3416
,20161129,3237,3182,3250,3254,3055,3174,3209,-8,27,426,"1,367.17",3380
,20161130,3174,3209,3099,3162,2985,3015,3044,-194,-165,254,773.31,3360
,20161201,3015,3044,3010,3100,3004,3100,3032,56,-12,2040,"6,186.24",2280
,20161202,3100,3032,3132,3132,2990,3039,3053,7,21,900,"2,748.12",1860
,20161205,3039,3053,3078,3129,3078,3126,3111,73,58,180,559.98,1860
,20161206,3126,3111,3159,3159,3112,3150,3140,39,29,180,565.26,1920
,20161207,3150,3140,3160,3273,3045,3273,3177,133,37,300,953.34,1860
,20161208,3273,3177,3177,3231,3175,3231,3194,54,17,180,574.98,1800
,20161209,3231,3194,3200,3200,3198,3198,3198,4,4,180,575.76,1800
,20161212,3198,3198,,,,3198,3198,0,0,0,0.00,1800
,20161213,3198,3198,,,,3198,3198,0,0,0,0.00,1800
,20161214,3198,3198,,,,3198,3198,0,0,0,0.00,1800
,20161215,3198,3198,3301,3301,3301,3301,3301,103,103,60,198.06,1800
rb1701,20160118,1783,1783,1820,1850,1785,1841,1821,58,38,5164,"9,404.77",3510
,20160119,1841,1821,1840,1854,1831,1854,1842,33,21,2712,"4,995.56",4634
,20160120,1854,1842,1853,1862,1828,1828,1840,-14,-2,1938,"3,567.19",5048
,20160121,1828,1840,1826,1836,1817,1818,1824,-22,-16,2016,"3,678.86",5598
,20160122,1818,1824,1817,1857,1815,1831,1837,7,13,3940,"7,239.52",6498
,20160125,1831,1837,1834,1853,1831,1847,1842,10,5,2612,"4,813.72",7364
,20160126,1847,1842,1843,1849,1836,1847,1842,5,0,1784,"3,287.90",7504
,20160127,1847,1842,1849,1863,1844,1858,1856,16,14,3082,"5,721.61",8892
,20160128,1858,1856,1857,1868,1825,1826,1847,-30,-9,3100,"5,728.24",9392
,20160129,1826,1847,1826,1844,1823,1830,1831,-17,-16,5820,"10,657.15",9484
,20160201,1830,1831,1831,1847,1820,1824,1834,-7,3,8034,"14,740.98",12598
,20160202,1824,1834,1818,1829,1811,1821,1820,-13,-14,2562,"4,664.49",13162
,20160203,1821,1820,1822,1837,1816,1830,1825,10,5,1692,"3,088.35",13104
,20160204,1830,1825,1831,1858,1830,1856,1846,31,21,2710,"5,004.26",12630
,20160205,1856,1846,1855,1861,1836,1851,1847,5,1,1932,"3,568.80",12650
,20160215,1851,1847,1847,1883,1838,1871,1869,24,22,8742,"16,346.08",18222
,20160216,1871,1869,1873,1880,1861,1863,1868,-6,-1,7730,"14,442.95",20438
,20160217,1863,1868,1865,1876,1858,1861,1864,-7,-4,5672,"10,576.11",20956
,20160218,1861,1864,1862,1869,1858,1868,1862,4,-2,7100,"13,222.00",21658
,20160219,1868,1862,1868,1879,1863,1878,1871,16,9,10906,"20,408.81",24564
,20160222,1878,1871,1875,1927,1873,1923,1904,52,33,18920,"36,037.00",28202
,20160223,1923,1904,1926,1927,1905,1910,1914,6,10,17388,"33,281.62",30234
,20160224,1910,1914,1915,1915,1890,1905,1902,-9,-12,8772,"16,690.86",30376
,20160225,1905,1902,1902,1925,1895,1899,1910,-3,8,7120,"13,605.08",31224
,20160226,1899,1910,1902,1905,1872,1893,1886,-17,-24,9398,"17,729.11",31994
,20160229,1893,1886,1898,1923,1886,1922,1901,36,15,17962,"34,148.37",32498
,20160301,1922,1901,1922,1962,1922,1953,1939,52,38,17910,"34,733.41",34886
,20160302,1953,1939,1950,1990,1949,1978,1966,39,27,25256,"49,664.45",38752
,20160303,1978,1966,1977,1993,1961,1963,1978,-3,12,20148,"39,868.61",40736
,20160304,1963,1978,1968,1998,1945,1998,1975,20,-3,27928,"55,157.94",44868
,20160307,1998,1975,1998,2073,1993,2073,2033,98,58,30034,"61,082.21",46608
,20160308,2073,2033,2180,2195,2047,2195,2151,162,118,117502,"252,813.52",76366
,20160309,2195,2151,2150,2150,2043,2045,2066,-106,-85,139878,"289,008.72",86564
,20160310,2045,2066,2052,2146,2052,2068,2082,2,16,196454,"409,078.01",110026
,20160311,2068,2082,2060,2060,1980,2003,2024,-79,-58,150556,"304,759.56",136938
,20160314,2003,2024,1981,2046,1963,1968,1997,-56,-27,144690,"289,046.02",147510
,20160315,1968,1997,1968,1985,1953,1957,1967,-40,-30,92696,"182,401.57",144972
,20160316,1957,1967,1960,1989,1955,1987,1975,20,8,66402,"131,169.58",145100
,20160317,1987,1975,1988,2057,1985,2047,2025,72,50,116448,"235,871.59",161404
,20160318,2047,2025,2049,2126,2045,2092,2090,67,65,241060,"503,989.01",162670
,20160321,2092,2090,2094,2180,2065,2105,2120,15,30,249158,"528,331.87",193040
,20160322,2105,2120,2106,2137,2101,2119,2119,-1,-1,143110,"303,320.96",193816
,20160323,2119,2119,2124,2183,2102,2145,2146,26,27,306576,"658,106.84",207162
,20160324,2145,2146,2143,2152,2052,2070,2097,-76,-49,269552,"565,319.59",211038
,20160325,2070,2097,2070,2125,2066,2123,2097,26,0,195066,"409,215.78",216220
,20160328,2123,2097,2125,2152,2058,2063,2111,-34,14,301834,"637,230.24",264536
,20160329,2063,2111,2066,2094,2048,2088,2071,-23,-40,165726,"343,237.42",275528
,20160330,2088,2071,2090,2093,2021,2038,2048,-33,-23,244338,"500,485.64",297182
,20160331,2038,2048,2038,2061,2033,2055,2045,7,-3,144718,"296,001.12",316920
,20160401,2055,2045,2046,2094,2046,2091,2075,46,30,217626,"451,580.15",347432
,20160405,2091,2075,2092,2099,2056,2076,2074,1,-1,113372,"235,207.24",345706
,20160406,2076,2074,2076,2098,2064,2080,2078,6,4,140994,"293,053.71",334306
,20160407,2080,2078,2080,2106,2074,2090,2085,12,7,87412,"182,288.84",335932
,20160408,2090,2085,2085,2098,2080,2094,2087,9,2,75264,"157,148.05",335054
,20160411,2094,2087,2095,2187,2094,2165,2155,78,68,335796,"723,787.92",391026
,20160412,2165,2155,2166,2219,2156,2218,2189,63,34,336772,"737,292.11",408664
,20160413,2218,2189,2220,2320,2210,2270,2266,81,77,585630,"1,327,378.71",395012
,20160414,2270,2266,2281,2282,2223,2231,2258,-35,-8,272504,"615,476.08",399212
,20160415,2231,2258,2231,2243,2210,2212,2225,-46,-33,212104,"472,004.97",395708
,20160418,2212,2225,2206,2328,2197,2303,2267,78,42,351904,"798,092.52",396774
,20160419,2303,2267,2305,2403,2305,2403,2362,136,95,650536,"1,536,574.58",294512
,20160420,2403,2362,2403,2503,2403,2503,2466,141,104,630394,"1,554,799.73",283846
,20160421,2503,2466,2507,2683,2501,2657,2603,191,137,1098226,"2,859,096.92",299458
,20160422,2657,2603,2635,2635,2503,2530,2562,-73,-41,838052,"2,147,476.63",302218
,20160425,2530,2562,2514,2683,2488,2538,2567,-24,5,630234,"1,618,110.40",324606
,20160426,2538,2567,2518,2545,2430,2460,2497,-107,-70,390490,"975,213.91",335026
,20160427,2460,2497,2468,2496,2361,2408,2432,-89,-65,439216,"1,068,289.48",340964
,20160428,2408,2432,2411,2451,2366,2443,2414,11,-18,259450,"626,424.78",351466
,20160429,2443,2414,2445,2496,2444,2485,2472,71,58,259844,"642,434.89",354288
,20160503,2485,2472,2456,2458,2342,2361,2380,-111,-92,217354,"517,411.89",389508
,20160504,2361,2380,2355,2360,2275,2289,2315,-91,-65,321638,"744,740.20",436114
,20160505,2289,2315,2295,2313,2211,2218,2260,-97,-55,276300,"624,465.91",444338
,20160506,2218,2260,2225,2253,2191,2250,2223,-10,-37,288624,"641,753.22",451204
,20160509,2250,2223,2251,2263,2089,2089,2162,-134,-61,465248,"1,006,142.42",481822
,20160510,2089,2162,2039,2104,2017,2078,2058,-84,-104,470548,"968,836.54",508660
,20160511,2078,2058,2091,2112,2059,2091,2090,33,32,364606,"762,287.18",522062
,20160512,2091,2090,2096,2102,2031,2034,2077,-56,-13,288718,"599,838.60",560232
,20160513,2034,2077,2036,2040,1957,1988,1995,-89,-82,472700,"943,434.52",608746
,20160516,1988,1995,1993,2036,1977,2008,2013,13,18,319042,"642,254.71",615784
,20160517,2008,2013,2013,2066,1997,2061,2024,48,11,302354,"612,245.29",616174
,20160518,2061,2024,2050,2076,1996,2011,2042,-13,18,374554,"764,905.94",627840
,20160519,2011,2042,2012,2028,1984,2004,2006,-38,-36,303556,"609,147.86",630074
,20160520,2004,2006,1995,2035,1980,2022,2013,16,7,227322,"457,785.61",632582
,20160523,2022,2013,2025,2029,1892,1918,1939,-95,-74,494230,"958,556.88",684664
,20160524,1918,1939,1919,1926,1890,1919,1905,-20,-34,334674,"637,815.11",689390
,20160525,1919,1905,1925,1935,1886,1891,1912,-14,7,276206,"528,170.73",695476
,20160526,1891,1912,1893,1923,1879,1918,1908,6,-4,282086,"538,261.46",691054
,20160527,1918,1908,1930,1999,1898,1988,1950,80,42,527538,"1,029,017.72",675120
,20160530,1988,1950,1981,2009,1878,1962,1957,12,7,474724,"929,266.40",684998
,20160531,1962,1957,1963,1991,1946,1953,1969,-4,12,289692,"570,526.87",713576
,20160601,1953,1969,1946,1962,1920,1936,1939,-33,-30,240184,"465,819.19",717144
,20160602,1936,1939,1926,1962,1921,1941,1944,2,5,251984,"490,053.20",754152
,20160603,1941,1944,1940,1985,1939,1975,1966,31,22,325064,"639,337.96",792658
,20160606,1975,1966,1981,2053,1968,2034,2010,68,44,442870,"890,570.93",758038
,20160607,2034,2010,2035,2070,2029,2046,2046,36,36,372794,"762,780.26",707580
,20160608,2046,2046,2042,2080,2013,2058,2050,12,4,377812,"774,794.34",697192
,20160613,2058,2050,2055,2129,2053,2110,2099,60,49,445930,"936,041.73",668092
,20160614,2110,2099,2110,2123,2035,2036,2079,-63,-20,424980,"883,647.70",653296
,20160615,2036,2079,2035,2059,2018,2026,2035,-53,-44,261014,"531,213.67",652554
,20160616,2026,2035,2040,2076,2028,2034,2044,-1,9,300170,"613,821.26",636370
,20160617,2034,2044,2030,2045,2003,2042,2022,-2,-22,335650,"678,941.31",643880
,20160620,2042,2022,2041,2061,2026,2032,2040,10,18,265808,"542,423.78",636172
,20160621,2032,2040,2028,2072,2021,2039,2047,-1,7,320106,"655,510.87",661670
,20160622,2039,2047,2037,2090,2031,2085,2068,38,21,355494,"735,445.45",625794
,20160623,2085,2068,2090,2104,2075,2083,2089,15,21,325104,"679,180.00",619480
,20160624,2083,2089,2091,2109,2049,2079,2084,-10,-5,354138,"738,042.22",600546
,20160627,2079,2084,2081,2209,2076,2207,2151,123,67,536472,"1,154,309.21",600352
,20160628,2207,2151,2205,2218,2170,2199,2198,48,47,432852,"951,732.90",583192
,20160629,2199,2198,2204,2220,2175,2196,2197,-2,-1,455748,"1,001,679.83",585408
,20160630,2196,2197,2195,2287,2190,2278,2249,81,52,640920,"1,441,462.92",606718
,20160701,2278,2249,2282,2316,2255,2285,2286,36,37,508742,"1,163,238.43",594056
,20160704,2285,2286,2285,2382,2283,2361,2344,75,58,826752,"1,938,502.18",599950
,20160705,2361,2344,2364,2393,2260,2352,2330,8,-14,872166,"2,032,783.19",559036
,20160706,2352,2330,2349,2371,2270,2315,2312,-15,-18,835970,"1,933,551.10",605432
,20160707,2315,2312,2300,2379,2290,2323,2335,11,23,808064,"1,887,620.23",620590
,20160708,2323,2335,2323,2365,2296,2362,2330,27,-5,845002,"1,969,079.75",661020
,20160711,2362,2330,2392,2398,2290,2348,2343,18,13,753228,"1,765,322.18",698938
,20160712,2348,2343,2353,2466,2340,2456,2406,113,63,987294,"2,376,017.11",813192
,20160713,2456,2406,2456,2489,2425,2434,2456,28,50,840008,"2,063,170.03",798668
,20160714,2434,2456,2433,2453,2407,2447,2431,-9,-25,598458,"1,454,987.71",809318
,20160715,2447,2431,2432,2473,2415,2448,2438,17,7,604926,"1,475,042.40",811612
,20160718,2448,2438,2452,2455,2291,2291,2366,-147,-72,793096,"1,876,782.40",810006
,20160719,2291,2366,2285,2294,2198,2229,2251,-137,-115,841804,"1,895,461.41",752334
,20160720,2229,2251,2237,2266,2219,2240,2239,-11,-12,549720,"1,231,182.96",769276
,20160721,2240,2239,2240,2361,2215,2327,2287,88,48,887578,"2,030,722.54",773186
,20160722,2327,2287,2320,2334,2240,2252,2282,-35,-5,848814,"1,937,261.46",781046
,20160725,2252,2282,2254,2306,2221,2275,2270,-7,-12,913314,"2,073,439.21",800380
,20160726,2275,2270,2279,2298,2246,2297,2273,27,3,688466,"1,565,319.85",822738
,20160727,2297,2273,2300,2381,2291,2372,2343,99,70,1284648,"3,010,619.17",883578
,20160728,2372,2343,2376,2445,2363,2434,2410,91,67,1370548,"3,303,169.27",919036
,20160729,2434,2410,2430,2437,2355,2371,2396,-39,-14,1029598,"2,467,372.38",922836
,20160801,2371,2396,2371,2464,2341,2445,2416,49,20,1368040,"3,306,508.68",931044
,20160802,2445,2416,2441,2477,2423,2456,2445,40,29,937336,"2,291,807.59",981314
,20160803,2456,2445,2461,2465,2413,2433,2435,-12,-10,1005416,"2,448,793.87",1008668
,20160804,2433,2435,2428,2440,2340,2387,2389,-48,-46,1604218,"3,832,552.16",1007826
,20160805,2387,2389,2387,2487,2376,2475,2439,86,50,1650210,"4,025,673.34",1048412
,20160808,2475,2439,2480,2543,2450,2536,2507,97,68,1613308,"4,045,164.57",1136242
,20160809,2536,2507,2537,2547,2471,2510,2514,3,7,1626070,"4,089,441.15",1080258
,20160810,2510,2514,2507,2546,2480,2507,2508,-7,-6,1860994,"4,668,203.10",1118268
,20160811,2507,2508,2510,2521,2453,2507,2493,-1,-15,2027240,"5,054,952.52",1196372
,20160812,2507,2493,2500,2507,2476,2488,2492,-5,-1,1526998,"3,805,672.66",1213926
,20160815,2488,2492,2455,2479,2400,2466,2454,-26,-38,2636020,"6,470,029.64",1326032
,20160816,2466,2454,2466,2598,2455,2571,2535,117,81,3580640,"9,077,407.93",1541280
,20160817,2571,2535,2570,2601,2529,2530,2571,-5,36,3885986,"9,992,815.88",1771500
,20160818,2530,2571,2531,2570,2516,2549,2542,-22,-29,4533600,"11,525,019.63",1978564
,20160819,2549,2542,2537,2575,2497,2567,2539,25,-3,5512548,"13,998,965.83",2144406
,20160822,2567,2539,2564,2602,2551,2553,2572,14,33,5207160,"13,397,024.31",2380650
,20160823,2553,2572,2549,2615,2537,2596,2585,24,13,5406822,"13,981,152.14",2576768
,20160824,2596,2585,2599,2620,2575,2589,2596,4,11,3940550,"10,231,663.01",2604334
,20160825,2589,2596,2600,2620,2487,2567,2563,-29,-33,7629108,"19,559,443.45",2710618
,20160826,2567,2563,2565,2573,2500,2502,2541,-61,-22,5510904,"14,003,583.97",2657676
,20160829,2502,2541,2492,2501,2447,2477,2476,-64,-65,5832962,"14,443,415.59",2660264
,20160830,2477,2476,2485,2491,2418,2422,2453,-54,-23,6071512,"14,897,485.98",2889822
,20160831,2422,2453,2430,2449,2389,2392,2422,-61,-31,5324052,"12,899,872.02",2838164
,20160901,2392,2422,2384,2412,2362,2402,2388,-20,-34,5234742,"12,503,476.50",2847492
,20160902,2402,2388,2400,2464,2388,2406,2426,18,38,7014078,"17,019,856.75",2747498
,20160905,2406,2426,2415,2463,2410,2436,2438,10,12,6002322,"14,636,543.35",2808008
,20160906,2436,2438,2436,2458,2412,2428,2430,-10,-8,5017696,"12,194,591.57",2902974
,20160907,2428,2430,2424,2427,2330,2334,2371,-96,-59,7433996,"17,628,721.79",3186378
,20160908,2334,2371,2334,2357,2321,2338,2338,-33,-33,4869812,"11,385,685.14",3209340
,20160909,2338,2338,2335,2346,2303,2343,2324,5,-14,5757430,"13,382,376.38",3175186
,20160912,2343,2324,2343,2357,2270,2277,2307,-47,-17,5823944,"13,440,371.44",3158204
,20160913,2277,2307,2276,2299,2247,2256,2272,-51,-35,4971790,"11,296,569.31",3229964
,20160914,2256,2272,2250,2276,2246,2250,2260,-22,-12,4277878,"9,668,061.28",3241868
,20160919,2250,2260,2200,2249,2190,2239,2235,-21,-25,3195102,"7,141,480.35",3369950
,20160920,2239,2235,2237,2285,2237,2264,2263,29,28,5189584,"11,747,621.62",3327228
,20160921,2264,2263,2264,2275,2242,2257,2259,-6,-4,4515108,"10,203,587.90",3355942
,20160922,2257,2259,2254,2330,2253,2280,2292,21,33,7508750,"17,211,681.91",3117042
,20160923,2280,2292,2285,2313,2280,2309,2298,17,6,4878596,"11,214,802.02",2999758
,20160926,2309,2298,2311,2353,2309,2316,2323,18,25,5032966,"11,696,106.44",2944970
,20160927,2316,2323,2319,2321,2252,2273,2282,-50,-41,5733910,"13,088,335.42",2995756
,20160928,2273,2282,2268,2288,2255,2285,2272,3,-10,4295198,"9,760,562.65",2983406
,20160929,2285,2272,2289,2332,2270,2273,2306,1,34,5653568,"13,038,567.84",2696638
,20160930,2273,2306,2270,2288,2248,2253,2264,-53,-42,3710948,"8,405,089.06",2570142
,20161010,2253,2264,2240,2274,2209,2270,2247,6,-17,3464986,"7,788,147.06",2628696
,20161011,2270,2247,2273,2340,2273,2339,2309,92,62,5548546,"12,816,948.50",2751772
,20161012,2339,2309,2340,2360,2311,2358,2335,49,26,4978656,"11,628,813.44",2776198
,20161013,2358,2335,2363,2368,2331,2354,2348,19,13,4501194,"10,572,710.05",2663540
,20161014,2354,2348,2353,2422,2344,2399,2378,51,30,5084094,"12,093,253.81",2680738
,20161017,2399,2378,2391,2451,2389,2431,2427,53,49,4848632,"11,767,732.16",2587868
,20161018,2431,2427,2430,2443,2402,2441,2421,14,-6,3898820,"9,442,858.96",2576244
,20161019,2441,2421,2451,2526,2424,2434,2472,13,51,7063346,"17,465,445.87",2469978
,20161020,2434,2472,2438,2495,2434,2486,2472,14,0,5109816,"12,635,552.23",2498386
,20161021,2486,2472,2492,2504,2433,2485,2465,13,-7,4545124,"11,204,931.51",2433466
,20161024,2485,2465,2480,2500,2430,2491,2469,26,4,4712738,"11,635,771.04",2444666
,20161025,2491,2469,2493,2587,2492,2569,2547,100,78,6094124,"15,527,332.38",2462038
,20161026,2569,2547,2572,2597,2513,2534,2546,-13,-1,5791228,"14,747,702.42",2356776
,20161027,2534,2546,2535,2570,2485,2512,2528,-34,-18,5433252,"13,739,742.14",2172556
,20161028,2512,2528,2520,2590,2510,2588,2545,60,17,4328268,"11,018,120.71",2211058
,20161031,2588,2545,2595,2613,2550,2600,2582,55,37,4884518,"12,612,272.96",2108310
,20161101,2600,2582,2600,2640,2563,2613,2607,31,25,5337216,"13,916,389.18",2111350
,20161102,2613,2607,2619,2665,2595,2610,2629,3,22,5090916,"13,388,931.40",2047804
,20161103,2610,2629,2615,2694,2608,2691,2646,62,17,4501852,"11,912,372.80",2288186
,20161104,2691,2646,2695,2767,2694,2716,2726,70,80,6349562,"17,309,325.78",2184014
,20161107,2716,2726,2736,2889,2712,2889,2799,163,73,6528734,"18,277,919.74",2122454
,20161108,2889,2799,2887,2933,2786,2836,2864,37,65,6907862,"19,788,496.08",1846738
,20161109,2836,2864,2827,3030,2815,3015,2943,151,79,5927072,"17,445,317.60",1856932
,20161110,3015,2943,3010,3119,2937,2987,3021,44,78,7075336,"21,380,379.36",1724324
,20161111,2987,3021,3000,3148,2960,3126,3043,105,22,4679740,"14,245,107.17",1711882
,20161114,3126,3043,3147,3220,2897,2945,3041,-98,-2,5886956,"17,906,479.26",1394948
,20161115,2945,3041,2950,2996,2858,2858,2930,-183,-111,2869130,"8,408,446.84",1442346
,20161116,2858,2930,2801,2839,2714,2816,2789,-114,-141,3909922,"10,906,765.32",1399424
,20161117,2816,2789,2819,2841,2738,2814,2785,25,-4,3171932,"8,834,915.64",1439176
,20161118,2814,2785,2824,2845,2750,2772,2783,-13,-2,2899398,"8,071,596.19",1396636
,20161121,2772,2783,2783,2790,2660,2714,2736,-69,-47,2988754,"8,178,411.48",1371636
,20161122,2714,2736,2726,2900,2708,2900,2826,164,90,3723944,"10,525,412.91",1300110
,20161123,2900,2826,2897,2966,2860,2954,2914,128,88,4070872,"11,866,449.73",1339794
,20161124,2954,2914,2950,3012,2882,2951,2948,37,34,3487584,"10,283,939.82",1132534
,20161125,2951,2948,2902,3154,2902,3154,3044,206,96,2816238,"8,573,089.61",1104502
,20161128,3154,3044,3155,3238,3082,3188,3162,144,118,2076172,"6,566,790.28",856984
,20161129,3188,3162,3180,3209,2987,2989,3126,-173,-36,1417776,"4,433,008.67",608088
,20161130,2989,3126,2994,3010,2907,2907,2959,-219,-167,785500,"2,324,356.99",457024
,20161201,2907,2959,2912,3135,2912,3103,3017,144,58,894252,"2,698,592.16",408854
,20161202,3103,3017,3105,3143,2980,3066,3063,49,46,577792,"1,770,043.05",323366
,20161205,3066,3063,3067,3149,3029,3127,3084,64,21,341610,"1,053,787.35",304842
,20161206,3127,3084,3125,3177,3111,3128,3138,44,54,253410,"795,347.22",260062
,20161207,3128,3138,3138,3295,3130,3265,3221,127,83,312078,"1,005,328.84",243956
,20161208,3265,3221,3277,3300,3170,3267,3238,46,17,232476,"752,905.54",211762
,20161209,3267,3238,3280,3286,3137,3225,3205,-13,-33,246122,"789,037.63",223580
,20161212,3225,3205,3243,3419,3218,3363,3335,158,130,227396,"758,389.04",186938
,20161213,3363,3335,3374,3419,3333,3419,3383,84,48,133136,"450,415.78",171208
,20161214,3419,3383,3414,3418,3291,3333,3360,-50,-23,148308,"498,413.19",146060
,20161215,3333,3360,3319,3368,3272,3349,3310,-11,-50,96054,"318,023.78",128518
,20161216,3349,3310,3333,3348,3251,3251,3309,-59,-1,58574,"193,871.43",115454
,20161219,3251,3309,3236,3262,3131,3132,3210,-177,-99,65320,"209,679.25",95340
,20161220,3132,3210,3103,3149,3075,3126,3113,-84,-97,60528,"188,443.07",81206
,20161221,3126,3113,3121,3190,3084,3158,3134,45,21,48546,"152,145.72",79768
,20161222,3158,3134,3164,3169,3102,3106,3140,-28,6,39720,"124,738.67",69406
,20161223,3106,3140,3100,3140,3066,3088,3099,-52,-41,35632,"110,426.03",58356
,20161226,3088,3099,3057,3118,2970,2984,3030,-115,-69,40510,"122,760.30",46444
,20161227,2984,3030,2995,3021,2919,3002,2977,-28,-53,35966,"107,092.00",33696
,20161228,3002,2977,3008,3030,2983,2989,3006,12,29,15096,"45,379.16",29392
,20161229,2989,3006,2985,3000,2935,2969,2966,-37,-40,12954,"38,433.41",24088
,20161230,2969,2966,2972,2982,2923,2923,2954,-43,-12,13708,"40,496.02",14402
rb1702,20160216,1869,1869,1874,1875,1850,1858,1865,-11,-4,178,332.12,154
,20160217,1858,1865,1857,1871,1847,1851,1852,-14,-13,896,"1,660.12",892
,20160218,1851,1852,1853,1855,1845,1850,1849,-2,-3,440,813.85,1238
,20160219,1850,1849,1853,1866,1852,1866,1857,17,8,416,772.75,1238
,20160222,1866,1857,1866,1924,1865,1913,1892,56,35,642,"1,215.26",1494
,20160223,1913,1892,1903,1921,1893,1901,1905,9,13,394,750.95,1636
,20160224,1901,1905,1895,1905,1885,1894,1896,-11,-9,286,542.26,1794
,20160225,1894,1896,1900,1913,1890,1891,1901,-5,5,264,501.98,1898
,20160226,1891,1901,1897,1897,1870,1885,1878,-16,-23,344,646.29,2022
,20160229,1885,1878,1882,1906,1881,1906,1891,28,13,364,688.51,2022
,20160301,1906,1891,1913,1947,1910,1938,1927,47,36,924,"1,780.77",2018
,20160302,1938,1927,1943,1981,1942,1971,1962,44,35,582,"1,142.06",2140
,20160303,1971,1962,1979,1983,1953,1956,1970,-6,8,412,812.05,2218
,20160304,1956,1970,1950,1987,1948,1978,1969,8,-1,776,"1,528.10",2344
,20160307,1978,1969,1994,2067,1988,2067,2030,98,61,460,934.26,2334
,20160308,2067,2030,2189,2192,2040,2192,2147,162,117,2722,"5,845.44",2828
,20160309,2192,2147,2092,2127,2039,2039,2063,-108,-84,2358,"4,865.04",3868
,20160310,2039,2063,2039,2133,2039,2061,2072,-2,9,4748,"9,839.94",5340
,20160311,2061,2072,2038,2044,1968,1987,2016,-85,-56,2534,"5,109.62",6570
,20160314,1987,2016,1970,2030,1952,1955,1978,-61,-38,2172,"4,296.90",7424
,20160315,1955,1978,1955,1969,1930,1943,1953,-35,-25,2128,"4,157.28",8156
,20160316,1943,1953,1939,1975,1939,1969,1960,16,7,1350,"2,646.50",8568
,20160317,1969,1960,1976,2037,1974,2029,1996,69,36,1608,"3,210.64",8648
,20160318,2029,1996,2035,2095,2031,2066,2061,70,65,5032,"10,371.36",7942
,20160321,2066,2061,2057,2145,2038,2090,2090,29,29,2824,"5,904.91",7772
,20160322,2090,2090,2145,2145,2060,2098,2101,8,11,1500,"3,152.95",7674
,20160323,2098,2101,2099,2166,2085,2125,2132,24,31,2968,"6,330.07",7900
,20160324,2125,2132,2120,2130,2045,2048,2081,-84,-51,3222,"6,707.90",7952
,20160325,2048,2081,2044,2107,2044,2107,2077,26,-4,1508,"3,132.85",7926
,20160328,2107,2077,2098,2128,2041,2045,2093,-32,16,1998,"4,182.56",8040
,20160329,2045,2093,2062,2073,2033,2068,2055,-25,-38,1206,"2,478.74",8022
,20160330,2068,2055,2065,2065,2002,2021,2028,-34,-27,1718,"3,485.66",8258
,20160331,2021,2028,2025,2044,2019,2036,2030,8,2,1374,"2,789.78",8358
,20160401,2036,2030,1976,2073,1976,2072,2054,42,24,1178,"2,420.16",8318
,20160405,2072,2054,2072,2074,2036,2058,2046,4,-8,1064,"2,177.41",8144
,20160406,2058,2046,2032,2073,2032,2063,2058,17,12,1018,"2,095.40",8250
,20160407,2063,2058,2057,2085,2055,2070,2066,12,8,1020,"2,107.51",8486
,20160408,2070,2066,2062,2075,2059,2074,2068,8,2,452,935.12,8484
,20160411,2074,2068,2080,2160,2078,2141,2130,73,62,1830,"3,899.36",8580
,20160412,2141,2130,2151,2185,2136,2185,2156,55,26,2610,"5,628.14",8234
,20160413,2185,2156,2190,2285,2177,2252,2241,96,85,6102,"13,675.82",8702
,20160414,2252,2241,2247,2261,2208,2213,2234,-28,-7,1632,"3,645.91",8774
,20160415,2213,2234,2215,2223,2194,2195,2208,-39,-26,1698,"3,749.38",8508
,20160418,2195,2208,2186,2307,2183,2280,2258,72,50,1788,"4,038.57",8520
,20160419,2280,2258,2263,2383,2263,2383,2337,125,79,3888,"9,088.60",8842
,20160420,2383,2337,2400,2477,2394,2477,2445,140,108,4014,"9,817.39",8814
,20160421,2477,2445,2487,2659,2482,2631,2586,186,141,4892,"12,652.59",8742
,20160422,2631,2586,2605,2612,2480,2504,2540,-82,-46,3684,"9,358.55",8448
,20160425,2504,2540,2518,2642,2476,2519,2558,-21,18,6770,"17,318.30",9184
,20160426,2519,2558,2491,2524,2420,2442,2474,-116,-84,3304,"8,174.96",9448
,20160427,2442,2474,2441,2475,2346,2397,2409,-77,-65,3310,"7,977.04",9424
,20160428,2397,2409,2405,2429,2351,2422,2390,13,-19,2636,"6,301.94",9100
,20160429,2422,2390,2426,2473,2422,2464,2454,74,64,2602,"6,387.60",8942
,20160503,2464,2454,2422,2425,2324,2348,2368,-106,-86,1424,"3,372.96",9224
,20160504,2348,2368,2315,2341,2260,2271,2296,-97,-72,1984,"4,556.11",9628
,20160505,2271,2296,2273,2297,2159,2201,2239,-95,-57,2126,"4,760.89",9650
,20160506,2201,2239,2219,2228,2175,2224,2209,-15,-30,2306,"5,094.21",9556
,20160509,2224,2209,2236,2241,2076,2076,2145,-133,-64,3120,"6,695.28",10184
,20160510,2076,2145,2052,2080,1981,2061,2033,-84,-112,4250,"8,643.76",10842
,20160511,2061,2033,2069,2088,2042,2070,2068,37,35,2792,"5,775.22",11340
,20160512,2070,2068,2079,2079,2013,2017,2057,-51,-11,1846,"3,798.59",11850
,20160513,2017,2057,2017,2021,1938,1967,1977,-90,-80,3454,"6,830.13",12640
,20160516,1967,1977,1888,2017,1888,1993,1997,16,20,2254,"4,501.33",12602
,20160517,1993,1997,1997,2044,1978,2040,2009,43,12,3494,"7,019.47",12968
,20160518,2040,2009,2036,2052,1976,1987,2025,-22,16,3416,"6,918.68",13196
,20160519,1987,2025,1984,2005,1959,1987,1988,-38,-37,2836,"5,638.05",13614
,20160520,1987,1988,1969,2011,1954,2001,1994,13,6,1780,"3,550.54",13594
,20160523,2001,1994,2004,2006,1874,1900,1912,-94,-82,7788,"14,891.45",14936
,20160524,1900,1912,1874,1908,1870,1898,1886,-14,-26,1610,"3,036.48",14902
,20160525,1898,1886,1906,1913,1868,1875,1893,-11,7,1850,"3,502.56",15224
,20160526,1875,1893,1875,1905,1853,1894,1889,1,-4,2266,"4,281.17",15286
,20160527,1894,1889,1899,1978,1879,1965,1928,76,39,4566,"8,805.36",15280
,20160530,1965,1928,1960,1986,1869,1941,1932,13,4,4538,"8,770.29",15090
,20160531,1941,1932,1934,1965,1923,1925,1941,-7,9,1810,"3,513.94",15158
,20160601,1925,1941,1925,1935,1891,1903,1912,-38,-29,2352,"4,497.98",15370
,20160602,1903,1912,1902,1933,1901,1912,1918,0,6,2042,"3,916.96",15498
,20160603,1912,1918,1918,1952,1918,1938,1939,20,21,1822,"3,533.61",15352
,20160606,1938,1939,1950,2010,1937,1993,1966,54,27,3678,"7,233.21",15368
,20160607,1993,1966,1997,2027,1987,2004,2003,38,37,2448,"4,905.03",15234
,20160608,2004,2003,2001,2035,1972,2020,2006,17,3,2658,"5,333.26",14934
,20160613,2020,2006,2013,2086,2013,2068,2052,62,46,3358,"6,891.16",14062
,20160614,2068,2052,2066,2080,2000,2000,2046,-52,-6,1814,"3,712.99",13772
,20160615,2000,2046,2000,2023,1988,1997,2001,-49,-45,1700,"3,402.25",13904
,20160616,1997,2001,2006,2044,2000,2005,2016,4,15,2174,"4,382.89",14138
,20160617,2005,2016,2002,2017,1976,2013,1994,-3,-22,2104,"4,195.98",14080
,20160620,2013,1994,2020,2033,2006,2012,2016,18,22,1892,"3,814.66",14224
,20160621,2012,2016,2010,2050,2003,2014,2025,-2,9,1928,"3,904.63",14390
,20160622,2014,2025,2016,2064,2014,2062,2044,37,19,2324,"4,752.32",14278
,20160623,2062,2044,2070,2079,2053,2056,2065,12,21,1914,"3,953.72",14230
,20160624,2056,2065,2066,2083,2020,2051,2055,-14,-10,3168,"6,512.48",14016
,20160627,2051,2055,2054,2178,2054,2176,2121,121,66,4444,"9,426.98",13924
,20160628,2176,2121,2167,2194,2145,2175,2175,54,54,3168,"6,893.37",14210
,20160629,2175,2175,2178,2198,2154,2169,2171,-6,-4,2266,"4,921.08",14058
,20160630,2169,2171,2173,2269,2080,2253,2224,82,53,3632,"8,081.00",14788
,20160701,2253,2224,2220,2293,2220,2267,2263,43,39,3392,"7,677.06",14740
,20160704,2267,2263,2247,2360,2247,2344,2328,81,65,4556,"10,610.27",15814
,20160705,2344,2328,2359,2387,2222,2326,2292,-2,-36,6840,"15,679.21",14912
,20160706,2326,2292,2301,2350,2240,2290,2280,-2,-12,3748,"8,545.62",14924
,20160707,2290,2280,2280,2355,2270,2296,2315,16,35,2822,"6,535.48",14844
,20160708,2296,2315,2300,2335,2270,2333,2298,18,-17,2210,"5,080.68",14618
,20160711,2333,2298,2340,2368,2269,2311,2304,13,6,3430,"7,905.67",14042
,20160712,2311,2304,2319,2440,2312,2429,2368,125,64,2998,"7,100.13",13410
,20160713,2429,2368,2429,2459,2401,2410,2433,42,65,2218,"5,397.26",13476
,20160714,2410,2433,2408,2429,2385,2416,2406,-17,-27,2792,"6,718.59",13304
,20160715,2416,2406,2407,2442,2387,2419,2410,13,4,3202,"7,718.62",12532
,20160718,2419,2410,2421,2421,2265,2265,2321,-145,-89,3612,"8,384.82",11952
,20160719,2265,2321,2259,2259,2160,2194,2223,-127,-98,6520,"14,495.24",11148
,20160720,2194,2223,2198,2231,2188,2208,2208,-15,-15,2840,"6,273.32",10286
,20160721,2208,2208,2197,2313,2182,2286,2248,78,40,2478,"5,572.70",10162
,20160722,2286,2248,2280,2289,2203,2215,2250,-33,2,3198,"7,197.69",9430
,20160725,2215,2250,2221,2268,2188,2241,2228,-9,-22,2890,"6,439.28",9438
,20160726,2241,2228,2244,2261,2205,2257,2239,29,11,1740,"3,896.99",9174
,20160727,2257,2239,2263,2343,2255,2337,2307,98,68,3364,"7,762.14",8210
,20160728,2337,2307,2340,2401,2327,2394,2367,87,60,1932,"4,573.78",8124
,20160729,2394,2367,2385,2391,2317,2333,2353,-34,-14,1900,"4,471.53",7908
,20160801,2333,2353,2334,2418,2302,2400,2362,47,9,1566,"3,700.35",7870
,20160802,2400,2362,2396,2432,2381,2418,2403,56,41,1670,"4,014.31",7682
,20160803,2418,2403,2404,2408,2375,2390,2389,-13,-14,806,"1,926.30",7602
,20160804,2390,2389,2392,2395,2304,2348,2352,-41,-37,1146,"2,695.79",7426
,20160805,2348,2352,2349,2436,2336,2430,2405,78,53,1478,"3,555.30",7522
,20160808,2430,2405,2427,2492,2407,2489,2459,84,54,1384,"3,403.27",7824
,20160809,2489,2459,2481,2497,2428,2462,2472,3,13,2350,"5,811.46",7300
,20160810,2462,2472,2458,2499,2440,2464,2465,-8,-7,1124,"2,770.80",7400
,20160811,2464,2465,2465,2472,2411,2455,2450,-10,-15,1776,"4,351.47",7720
,20160812,2455,2450,2457,2459,2433,2445,2445,-5,-5,444,"1,085.70",7702
,20160815,2445,2445,2430,2431,2370,2415,2402,-30,-43,1724,"4,142.01",8080
,20160816,2415,2402,2416,2526,2409,2498,2474,96,72,2588,"6,404.01",8474
,20160817,2498,2474,2498,2527,2462,2462,2501,-12,27,2262,"5,658.47",8464
,20160818,2462,2501,2468,2501,2450,2480,2475,-21,-26,1536,"3,802.60",8516
,20160819,2480,2475,2469,2508,2441,2505,2474,30,-1,1682,"4,162.32",8630
,20160822,2505,2474,2506,2539,2498,2501,2513,27,39,1728,"4,343.85",8650
,20160823,2501,2513,2500,2550,2480,2540,2522,27,9,1842,"4,646.86",8884
,20160824,2540,2522,2538,2562,2523,2537,2541,15,19,1626,"4,132.25",8788
,20160825,2537,2541,2551,2572,2450,2518,2526,-23,-15,3516,"8,883.41",8458
,20160826,2518,2526,2525,2529,2464,2464,2494,-62,-32,1320,"3,293.17",8488
,20160829,2464,2494,2460,2460,2410,2437,2437,-57,-57,1984,"4,836.32",8448
,20160830,2437,2437,2442,2446,2381,2382,2411,-55,-26,1124,"2,710.94",8444
,20160831,2382,2411,2393,2404,2350,2350,2384,-61,-27,896,"2,136.45",8396
,20160901,2350,2384,2345,2367,2320,2360,2343,-24,-41,1426,"3,342.20",8470
,20160902,2360,2343,2354,2418,2347,2365,2381,22,38,1400,"3,333.68",8554
,20160905,2365,2381,2353,2416,2345,2383,2392,2,11,1296,"3,101.22",8554
,20160906,2383,2392,2386,2410,2369,2383,2383,-9,-9,662,"1,577.64",8578
,20160907,2383,2383,2375,2379,2290,2291,2314,-92,-69,3012,"6,970.49",9792
,20160908,2291,2314,2292,2315,2284,2297,2299,-17,-15,972,"2,234.89",9832
,20160909,2297,2299,2318,2318,2266,2299,2285,0,-14,1086,"2,481.53",9728
,20160912,2299,2285,2298,2312,2235,2240,2263,-45,-22,4074,"9,222.56",9402
,20160913,2240,2263,2233,2259,2211,2229,2228,-34,-35,1622,"3,613.95",9500
,20160914,2229,2228,2222,2240,2216,2220,2228,-8,0,830,"1,849.69",9384
,20160919,2220,2228,2200,2222,2167,2219,2205,-9,-23,910,"2,007.26",9390
,20160920,2219,2205,2216,2256,2216,2241,2233,36,28,1462,"3,265.10",9400
,20160921,2241,2233,2239,2250,2223,2231,2235,-2,2,600,"1,341.47",9376
,20160922,2231,2235,2235,2308,2231,2261,2274,26,39,4256,"9,681.29",9334
,20160923,2261,2274,2263,2287,2262,2280,2273,6,-1,960,"2,183.03",9372
,20160926,2280,2273,2290,2321,2283,2287,2297,14,24,1180,"2,710.54",9350
,20160927,2287,2297,2289,2289,2233,2252,2256,-45,-41,854,"1,927.34",9338
,20160928,2252,2256,2250,2262,2235,2261,2248,5,-8,666,"1,497.39",9288
,20160929,2261,2248,2265,2303,2248,2252,2285,4,37,1504,"3,437.80",9344
,20160930,2252,2285,2252,2264,2224,2236,2240,-49,-45,2364,"5,296.77",9862
,20161010,2236,2240,2231,2249,2191,2245,2224,5,-16,1080,"2,402.50",9764
,20161011,2245,2224,2249,2303,2248,2299,2277,75,53,3094,"7,047.17",9748
,20161012,2299,2277,2309,2319,2277,2319,2298,42,21,1348,"3,099.04",9834
,20161013,2319,2298,2320,2327,2295,2313,2308,15,10,1252,"2,890.82",9802
,20161014,2313,2308,2313,2376,2306,2359,2336,51,28,1686,"3,938.60",9880
,20161017,2359,2336,2346,2399,2205,2381,2369,45,33,2070,"4,904.12",9822
,20161018,2381,2369,2376,2392,2353,2391,2374,22,5,1524,"3,618.38",9384
,20161019,2391,2374,2399,2464,2364,2377,2418,3,44,1858,"4,492.72",9436
,20161020,2377,2418,2385,2431,2385,2424,2419,6,1,2128,"5,149.73",9426
,20161021,2424,2419,2426,2438,2369,2416,2397,-3,-22,1444,"3,461.49",9318
,20161024,2416,2397,2413,2429,2368,2426,2400,29,3,1626,"3,902.44",9252
,20161025,2426,2400,2422,2518,2422,2512,2479,112,79,2392,"5,930.97",9356
,20161026,2512,2479,2502,2525,2455,2475,2486,-4,7,1460,"3,631.00",9280
,20161027,2475,2486,2475,2505,2381,2460,2469,-26,-17,1316,"3,250.18",9242
,20161028,2460,2469,2463,2534,2456,2533,2498,64,29,1582,"3,952.40",9238
,20161031,2533,2498,2539,2561,2499,2558,2531,60,33,2116,"5,357.13",8928
,20161101,2558,2531,2558,2591,2525,2568,2562,37,31,1946,"4,985.74",8802
,20161102,2568,2562,2561,2609,2547,2559,2584,-3,22,1670,"4,315.48",8778
,20161103,2559,2584,2560,2630,2550,2630,2581,46,-3,1262,"3,258.40",8730
,20161104,2630,2581,2626,2693,2626,2653,2654,72,73,2320,"6,157.30",8424
,20161107,2653,2654,2664,2813,2642,2811,2711,157,57,1932,"5,238.56",8418
,20161108,2811,2711,2811,2848,2715,2753,2785,42,74,2684,"7,477.59",8390
,20161109,2753,2785,2747,2950,2736,2935,2873,150,88,3616,"10,389.88",8444
,20161110,2935,2873,2922,3045,2871,2923,2952,50,79,3320,"9,802.09",8548
,20161111,2923,2952,2929,3059,2900,3044,2981,92,29,2988,"8,909.32",8446
,20161114,3044,2981,3065,3159,2802,2859,2961,-122,-20,3000,"8,883.72",8006
,20161115,2859,2961,2846,2910,2783,2783,2808,-178,-153,2924,"8,210.95",7070
,20161116,2783,2808,2849,2849,2651,2746,2736,-62,-72,3078,"8,421.45",6926
,20161117,2746,2736,2751,2765,2680,2745,2720,9,-16,1644,"4,472.85",6898
,20161118,2745,2720,2753,2778,2686,2706,2718,-14,-2,1904,"5,176.61",6910
,20161121,2706,2718,2715,2718,2600,2650,2663,-68,-55,1324,"3,527.05",6818
,20161122,2650,2663,2658,2822,2648,2822,2745,159,82,2004,"5,501.22",6922
,20161123,2822,2745,2805,2885,2791,2869,2837,124,92,2174,"6,169.25",6838
,20161124,2869,2837,2853,2947,2811,2885,2885,48,48,2392,"6,902.42",6456
,20161125,2885,2885,2861,3086,2860,3086,2989,201,104,2734,"8,173.32",6576
,20161128,3086,2989,3106,3179,3022,3149,3119,160,130,1854,"5,783.33",6614
,20161129,3149,3119,3130,3160,2931,2937,3024,-182,-95,3234,"9,782.54",5516
,20161130,2937,3024,2937,2952,2812,2812,2869,-212,-155,2238,"6,421.29",5592
,20161201,2812,2869,2848,3033,2830,3009,2915,140,46,2620,"7,639.75",5688
,20161202,3009,2915,3006,3035,2909,2989,2966,74,51,3698,"10,970.97",4570
,20161205,2989,2966,2987,3065,2950,3049,3006,83,40,1506,"4,527.04",4302
,20161206,3049,3006,3058,3115,3055,3087,3081,81,75,1280,"3,943.85",3802
,20161207,3087,3081,3100,3270,3091,3245,3210,164,129,1492,"4,789.41",3612
,20161208,3245,3210,3250,3283,3156,3242,3227,32,17,1196,"3,860.46",3630
,20161209,3242,3227,3250,3253,3124,3212,3193,-15,-34,1510,"4,822.48",3626
,20161212,3212,3193,3223,3388,3200,3321,3328,128,135,1712,"5,698.41",3752
,20161213,3321,3328,3343,3387,3310,3381,3353,53,25,402,"1,348.11",3738
,20161214,3381,3353,3366,3375,3250,3280,3319,-73,-34,532,"1,765.72",3718
,20161215,3280,3319,3267,3344,3229,3339,3279,20,-40,306,"1,003.65",3716
,20161216,3339,3279,3292,3309,3230,3230,3283,-49,4,416,"1,366.12",3758
,20161219,3230,3283,3201,3260,3125,3125,3172,-158,-111,1216,"3,858.33",3734
,20161220,3125,3172,3120,3134,3069,3108,3107,-64,-65,468,"1,454.14",3696
,20161221,3108,3107,3119,3142,3060,3118,3101,11,-6,252,781.59,3618
,20161222,3118,3101,3114,3133,3020,3031,3033,-70,-68,2610,"7,918.05",3562
,20161223,3031,3033,3000,3055,2980,3013,3018,-20,-15,428,"1,291.93",3542
,20161226,3013,3018,3022,3045,2875,2910,2938,-108,-80,570,"1,674.87",3492
,20161227,2910,2938,2936,3008,2900,3008,2939,70,1,694,"2,040.27",3394
,20161228,3008,2939,3049,3049,2963,2974,2996,35,57,756,"2,265.31",3352
,20161229,2974,2996,2913,2978,2879,2960,2921,-36,-75,262,765.39,3352
,20161230,2960,2921,2948,2948,2874,2892,2895,-29,-26,162,469.01,3322
rb1703,20160316,1953,1953,1960,1975,1938,1975,1961,22,8,184,360.95,146
,20160317,1975,1961,1978,2039,1976,2014,2020,53,59,706,"1,426.70",652
,20160318,2014,2020,2042,2102,2041,2070,2074,50,54,678,"1,406.55",1040
,20160321,2070,2074,2096,2167,2053,2096,2091,22,17,356,744.67,1064
,20160322,2096,2091,2101,2133,2096,2104,2108,13,17,266,560.75,1156
,20160323,2104,2108,2127,2169,2111,2135,2141,27,33,552,"1,182.20",1248
,20160324,2135,2141,2128,2134,2054,2059,2089,-82,-52,786,"1,642.47",1364
,20160325,2059,2089,2059,2106,2059,2106,2089,17,0,164,342.63,1402
,20160328,2106,2089,2116,2130,2051,2052,2097,-37,8,642,"1,346.59",1740
,20160329,2052,2097,2063,2079,2041,2078,2064,-19,-33,358,739.18,1778
,20160330,2078,2064,2062,2062,2016,2033,2028,-31,-36,272,551.77,1876
,20160331,2033,2028,2038,2046,2028,2043,2038,15,10,184,375.08,1944
,20160401,2043,2038,2054,2082,2053,2077,2069,39,31,944,"1,953.25",1982
,20160405,2077,2069,2079,2079,2050,2065,2064,-4,-5,240,495.36,2062
,20160406,2065,2064,2071,2081,2055,2061,2066,-3,2,350,723.41,2038
,20160407,2061,2066,2064,2095,2062,2082,2069,16,3,126,260.75,1980
,20160408,2082,2069,2069,2082,2069,2078,2075,9,6,36,74.71,1992
,20160411,2078,2075,2103,2173,2098,2145,2132,70,57,1334,"2,844.54",2114
,20160412,2145,2132,2157,2201,2145,2193,2166,61,34,520,"1,126.68",2230
,20160413,2193,2166,2208,2295,2190,2258,2241,92,75,1320,"2,958.34",2318
,20160414,2258,2241,2258,2260,2204,2211,2233,-30,-8,784,"1,751.23",2354
,20160415,2211,2233,2219,2223,2188,2193,2197,-40,-36,802,"1,762.40",2254
,20160418,2193,2197,2185,2302,2181,2277,2256,80,59,1108,"2,500.27",2272
,20160419,2277,2256,2290,2384,2290,2384,2326,128,70,1112,"2,587.08",2350
,20160420,2384,2326,2390,2465,2390,2465,2437,139,111,1600,"3,900.51",2358
,20160421,2465,2437,2495,2656,2476,2655,2575,218,138,2092,"5,387.11",2440
,20160422,2655,2575,2528,2606,2469,2505,2547,-70,-28,2552,"6,502.13",2500
,20160425,2505,2547,2506,2636,2468,2515,2527,-32,-20,740,"1,870.36",2436
,20160426,2515,2527,2511,2515,2416,2444,2473,-83,-54,562,"1,389.98",2400
,20160427,2444,2473,2440,2473,2348,2388,2395,-85,-78,1016,"2,433.42",2436
,20160428,2388,2395,2399,2423,2351,2420,2392,25,-3,436,"1,043.05",2454
,20160429,2420,2392,2431,2467,2421,2457,2452,65,60,458,"1,123.23",2478
,20160503,2457,2452,2418,2418,2322,2344,2352,-108,-100,754,"1,774.04",2608
,20160504,2344,2352,2323,2335,2262,2270,2302,-82,-50,710,"1,634.54",2740
,20160505,2270,2302,2280,2294,2210,2213,2243,-89,-59,646,"1,449.46",2800
,20160506,2213,2243,2220,2240,2187,2240,2221,-3,-22,616,"1,368.29",2770
,20160509,2240,2221,2245,2257,2087,2087,2159,-134,-62,852,"1,840.07",2946
,20160510,2087,2159,2054,2109,2023,2082,2063,-77,-96,666,"1,374.52",2856
,20160511,2082,2063,2100,2109,2065,2094,2094,31,31,892,"1,868.57",2914
,20160512,2094,2094,2091,2106,2050,2050,2085,-44,-9,884,"1,843.68",3264
,20160513,2050,2085,1977,2046,1962,1999,1997,-86,-88,904,"1,805.38",3490
,20160516,1999,1997,1980,2040,1980,2013,2015,16,18,536,"1,080.30",3512
,20160517,2013,2015,2016,2060,2004,2052,2023,37,8,690,"1,396.43",3640
,20160518,2052,2023,2060,2066,2001,2012,2039,-11,16,874,"1,782.56",3834
,20160519,2012,2039,2008,2026,1998,2015,2010,-24,-29,396,796.34,3948
,20160520,2015,2010,1995,2032,1991,2027,2018,17,8,574,"1,158.86",3928
,20160523,2027,2018,2016,2016,1896,1919,1929,-99,-89,798,"1,539.68",4132
,20160524,1919,1929,1920,1926,1895,1918,1912,-11,-17,358,684.61,4104
,20160525,1918,1912,1929,1933,1898,1905,1909,-7,-3,434,828.57,4244
,20160526,1905,1909,1907,1924,1895,1916,1907,7,-2,1216,"2,319.99",4788
,20160527,1916,1907,1917,1977,1893,1969,1932,62,25,1002,"1,936.48",4828
,20160530,1969,1932,1974,1983,1877,1945,1937,13,5,1108,"2,146.54",4626
,20160531,1945,1937,1952,1973,1906,1944,1956,7,19,154,301.32,4574
,20160601,1944,1956,1934,1945,1915,1924,1929,-32,-27,232,447.67,4700
,20160602,1924,1929,1916,1945,1915,1940,1933,11,4,306,591.64,4650
,20160603,1940,1933,1935,1968,1935,1960,1954,27,21,248,484.65,4574
,20160606,1960,1954,1973,2019,1945,2007,1979,53,25,554,"1,096.45",4670
,20160607,2007,1979,2011,2052,2007,2022,2024,43,45,368,745.07,4592
,20160608,2022,2024,2018,2061,2002,2033,2034,9,10,200,406.86,4590
,20160613,2033,2034,2061,2107,2040,2081,2068,47,34,552,"1,141.65",4432
,20160614,2081,2068,2087,2093,2035,2035,2062,-33,-6,188,387.76,4460
,20160615,2035,2062,2014,2044,1999,2016,2020,-46,-42,94,189.89,4438
,20160616,2016,2020,2034,2063,2015,2026,2031,6,11,176,357.51,4436
,20160617,2026,2031,2013,2030,1996,2030,2012,-1,-19,262,527.30,4520
,20160620,2030,2012,2037,2043,2021,2025,2029,13,17,68,137.99,4504
,20160621,2025,2029,2047,2052,2043,2044,2046,15,17,24,49.12,4500
,20160622,2044,2046,2036,2069,2036,2060,2060,14,14,236,486.22,4458
,20160623,2060,2060,2070,2090,2055,2067,2070,7,10,182,376.84,4402
,20160624,2067,2070,2075,2083,2033,2062,2064,-8,-6,164,338.64,4398
,20160627,2062,2064,2075,2184,2070,2177,2134,113,70,674,"1,438.57",4430
,20160628,2177,2134,2176,2199,2005,2175,2162,41,28,1014,"2,192.68",4372
,20160629,2175,2162,2184,2196,2159,2165,2172,3,10,132,286.73,4320
,20160630,2165,2172,2177,2262,2177,2254,2229,82,57,250,557.37,4314
,20160701,2254,2229,2262,2279,2225,2262,2258,33,29,282,636.99,4336
,20160704,2262,2258,2301,2336,2132,2326,2316,68,58,1732,"4,011.97",4266
,20160705,2326,2316,2325,2359,2223,2315,2300,-1,-16,720,"1,656.53",4266
,20160706,2315,2300,2327,2327,2236,2273,2277,-27,-23,260,592.24,4258
,20160707,2273,2277,2259,2331,2249,2261,2291,-16,14,1076,"2,465.29",4274
,20160708,2261,2291,2294,2313,2250,2310,2290,19,-1,324,742.12,4232
,20160711,2310,2290,2327,2341,2250,2300,2304,10,14,550,"1,267.33",4224
,20160712,2300,2304,2305,2405,2302,2397,2355,93,51,590,"1,389.62",4254
,20160713,2397,2355,2389,2427,2371,2383,2396,28,41,472,"1,131.24",4258
,20160714,2383,2396,2383,2392,2363,2391,2378,-5,-18,188,447.24,4268
,20160715,2391,2378,2411,2412,2375,2397,2392,19,14,362,866.00,4256
,20160718,2397,2392,2402,2403,2248,2248,2327,-144,-65,1244,"2,895.09",4240
,20160719,2248,2327,2244,2249,2187,2205,2215,-122,-112,710,"1,573.24",4036
,20160720,2205,2215,2195,2225,2185,2205,2201,-10,-14,192,422.77,4034
,20160721,2205,2201,2193,2304,2192,2280,2245,79,44,410,920.67,4048
,20160722,2280,2245,2286,2286,2205,2211,2245,-34,0,326,731.89,4078
,20160725,2211,2245,2217,2264,2195,2246,2229,1,-16,308,686.56,4110
,20160726,2246,2229,2250,2255,2215,2253,2238,24,9,172,384.94,4106
,20160727,2253,2238,2256,2320,2233,2308,2293,70,55,716,"1,641.81",4080
,20160728,2308,2293,2321,2371,2301,2363,2343,70,50,736,"1,724.52",4030
,20160729,2363,2343,2360,2360,2300,2306,2332,-37,-11,592,"1,380.58",4042
,20160801,2306,2332,2317,2395,2285,2388,2358,56,26,512,"1,207.31",3976
,20160802,2388,2358,2377,2401,2366,2390,2383,32,25,284,676.92,3984
,20160803,2390,2383,2394,2394,2356,2378,2374,-5,-9,350,831.13,3968
,20160804,2378,2374,2364,2376,2290,2328,2331,-46,-43,380,885.95,3944
,20160805,2328,2331,2329,2410,2322,2406,2379,75,48,512,"1,218.38",3952
,20160808,2406,2379,2397,2460,2385,2459,2436,80,57,608,"1,481.10",3954
,20160809,2459,2436,2452,2472,2400,2437,2437,1,1,496,"1,208.99",3960
,20160810,2437,2437,2443,2474,2420,2444,2444,7,7,488,"1,192.71",3964
,20160811,2444,2444,2433,2450,2397,2438,2425,-6,-19,296,718.00,3968
,20160812,2438,2425,2431,2438,2419,2431,2429,6,4,282,685.18,3984
,20160815,2431,2429,2400,2415,2364,2403,2393,-26,-36,458,"1,096.03",3972
,20160816,2403,2393,2398,2505,2395,2496,2458,103,65,822,"2,020.63",4014
,20160817,2496,2458,2492,2517,2460,2460,2494,2,36,372,927.82,3992
,20160818,2460,2494,2459,2494,2446,2480,2471,-14,-23,570,"1,408.66",4090
,20160819,2480,2471,2466,2505,2440,2505,2473,34,2,628,"1,553.39",4092
,20160822,2505,2473,2500,2530,2488,2495,2513,22,40,600,"1,507.95",4152
,20160823,2495,2513,2480,2550,2478,2545,2530,32,17,292,739.00,4190
,20160824,2545,2530,2541,2570,2532,2545,2548,15,18,422,"1,075.59",4208
,20160825,2545,2548,2550,2575,2451,2520,2510,-28,-38,904,"2,269.66",4188
,20160826,2520,2510,2520,2520,2469,2469,2500,-41,-10,394,985.11,4190
,20160829,2469,2500,2454,2454,2412,2432,2432,-68,-68,456,"1,109.38",4184
,20160830,2432,2432,2442,2443,2380,2381,2404,-51,-28,278,668.43,4178
,20160831,2381,2404,2390,2404,2350,2355,2376,-49,-28,282,670.29,4168
,20160901,2355,2376,2345,2367,2323,2364,2334,-12,-42,1128,"2,633.28",4166
,20160902,2364,2334,2357,2415,2348,2362,2380,28,46,378,899.85,4164
,20160905,2362,2380,2385,2416,2377,2392,2398,12,18,258,618.73,4162
,20160906,2392,2398,2389,2413,2376,2386,2390,-12,-8,124,296.43,4174
,20160907,2386,2390,2387,2387,2288,2288,2319,-102,-71,838,"1,943.76",4580
,20160908,2288,2319,2293,2314,2286,2299,2295,-20,-24,212,486.68,4600
,20160909,2299,2295,2293,2305,2275,2304,2289,9,-6,270,618.26,4634
,20160912,2304,2289,2283,2312,2242,2242,2272,-47,-17,312,709.04,4654
,20160913,2242,2272,2243,2266,2217,2228,2239,-44,-33,208,465.72,4664
,20160914,2228,2239,2233,2243,2217,2217,2225,-22,-14,376,836.73,4630
,20160919,2217,2225,2177,2224,2141,2218,2206,-7,-19,242,534.08,4634
,20160920,2218,2206,2222,2261,2221,2246,2232,40,26,486,"1,085.12",4636
,20160921,2246,2232,2248,2257,2230,2241,2236,9,4,174,389.12,4678
,20160922,2241,2236,2250,2315,2250,2278,2289,42,53,622,"1,424.11",4674
,20160923,2278,2289,2287,2303,2277,2294,2289,5,0,158,361.69,4652
,20160926,2294,2289,2301,2326,2288,2300,2309,11,20,140,323.28,4620
,20160927,2300,2309,2284,2284,2244,2256,2260,-53,-49,148,334.51,4642
,20160928,2256,2260,2244,2268,2243,2268,2253,8,-7,82,184.75,4632
,20160929,2268,2253,2273,2305,2257,2257,2285,4,32,238,543.96,4626
,20160930,2257,2285,2257,2280,2233,2244,2258,-41,-27,80,180.64,4614
,20161010,2244,2258,2257,2257,2203,2237,2223,-21,-35,152,337.95,4608
,20161011,2237,2223,2260,2307,2260,2307,2290,84,67,204,467.25,4598
,20161012,2307,2290,2312,2318,2285,2318,2301,28,11,340,782.42,4596
,20161013,2318,2301,2316,2331,2297,2314,2309,13,8,364,840.48,4586
,20161014,2314,2309,2315,2367,2287,2346,2330,37,21,394,918.19,4584
,20161017,2346,2330,2345,2388,2345,2381,2368,51,38,598,"1,416.66",4622
,20161018,2381,2368,2369,2380,2347,2374,2364,6,-4,166,392.48,4604
,20161019,2374,2364,2382,2438,2353,2360,2404,-4,40,912,"2,192.87",4592
,20161020,2360,2404,2379,2419,2374,2404,2402,0,-2,666,"1,600.00",4268
,20161021,2404,2402,2413,2414,2365,2399,2393,-3,-9,386,923.77,4246
,20161024,2399,2393,2405,2427,2378,2410,2390,17,-3,600,"1,434.01",3940
,20161025,2410,2390,2429,2514,2422,2512,2477,122,87,656,"1,625.00",3886
,20161026,2512,2477,2510,2525,2463,2485,2490,8,13,442,"1,100.75",3838
,20161027,2485,2490,2491,2510,2450,2474,2479,-16,-11,256,634.65,3810
,20161028,2474,2479,2487,2538,2475,2536,2510,57,31,246,617.60,3810
,20161031,2536,2510,2543,2580,2518,2579,2536,69,26,854,"2,166.39",3560
,20161101,2579,2536,2578,2598,2545,2596,2584,60,48,382,987.34,3558
,20161102,2596,2584,2589,2620,2569,2579,2607,-5,23,542,"1,413.08",3326
,20161103,2579,2607,2581,2646,2573,2646,2608,39,1,162,422.56,3300
,20161104,2646,2608,2656,2714,2641,2656,2665,48,57,246,655.80,3230
,20161107,2656,2665,2683,2824,2654,2817,2762,152,97,396,"1,093.91",3158
,20161108,2817,2762,2835,2846,2732,2764,2791,2,29,390,"1,088.77",3138
,20161109,2764,2791,2748,2956,2748,2953,2899,162,108,876,"2,539.57",3054
,20161110,2953,2899,2951,3054,2923,2964,2964,65,65,638,"1,891.24",2930
,20161111,2964,2964,2966,3115,2954,3091,3045,127,81,352,"1,071.90",2988
,20161114,3091,3045,3109,3227,2882,2893,2986,-152,-59,582,"1,737.91",2852
,20161115,2893,2986,2930,2975,2806,2813,2859,-173,-127,868,"2,481.71",2922
,20161116,2813,2859,2795,2869,2708,2815,2785,-44,-74,1202,"3,348.49",2532
,20161117,2815,2785,2846,2846,2751,2795,2787,10,2,122,340.06,2520
,20161118,2795,2787,2810,2810,2753,2762,2777,-25,-10,104,288.86,2470
,20161121,2762,2777,2765,2770,2685,2737,2731,-40,-46,132,360.54,2462
,20161122,2737,2731,2752,2894,2731,2894,2850,163,119,274,781.04,2454
,20161123,2894,2850,2885,2976,2880,2934,2926,84,76,462,"1,352.10",2432
,20161124,2934,2926,2922,3043,2881,2976,2940,50,14,522,"1,534.84",2460
,20161125,2976,2940,2976,3145,2948,3145,3079,205,139,342,"1,053.29",2554
,20161128,3145,3079,3179,3274,3114,3245,3217,166,138,668,"2,149.02",2702
,20161129,3245,3217,3244,3281,3030,3030,3164,-187,-53,396,"1,253.05",2674
,20161130,3030,3164,3011,3029,2942,2942,2985,-222,-179,242,722.45,2690
,20161201,2942,2985,2955,3150,2929,3123,3025,138,40,268,810.77,2746
,20161202,3123,3025,3164,3164,3003,3085,3087,60,62,370,"1,142.21",2742
,20161205,3085,3087,3061,3184,3032,3160,3104,73,17,164,509.21,2736
,20161206,3160,3104,3168,3206,3151,3170,3170,66,66,182,576.97,2726
,20161207,3170,3170,3176,3348,3176,3325,3280,155,110,172,564.20,2770
,20161208,3325,3280,3338,3354,3245,3326,3298,46,18,108,356.28,2740
,20161209,3326,3298,3319,3326,3199,3301,3254,3,-44,266,865.59,2700
,20161212,3301,3254,3326,3479,3260,3410,3412,156,158,874,"2,982.60",2758
,20161213,3410,3412,3419,3455,3383,3455,3421,43,9,126,431.12,2748
,20161214,3455,3421,3446,3446,3294,3350,3350,-71,-71,252,844.42,2766
,20161215,3350,3350,3320,3396,3276,3396,3333,46,-17,94,313.39,2772
,20161216,3396,3333,3345,3345,3329,3343,3335,10,2,62,206.83,2822
,20161219,3343,3335,3232,3248,3145,3145,3220,-190,-115,96,309.18,2822
,20161220,3145,3220,3130,3150,3072,3131,3118,-89,-102,160,498.89,2822
,20161221,3131,3118,3137,3155,3072,3145,3115,27,-3,140,436.12,2780
,20161222,3145,3115,3125,3125,3010,3034,3064,-81,-51,142,435.22,2824
,20161223,3034,3064,3000,3039,2984,2984,3010,-80,-54,158,475.72,2844
,20161226,2984,3010,2991,3062,2882,2923,2924,-87,-86,334,976.69,2918
,20161227,2923,2924,2950,3013,2900,2996,2941,72,17,298,876.50,2940
,20161228,2996,2941,3020,3039,2976,2976,3020,35,79,178,537.56,2940
,20161229,2976,3020,2930,2956,2926,2956,2937,-64,-83,92,270.29,3004
,20161230,2956,2937,2949,2950,2878,2878,2895,-59,-42,290,839.58,3002
rb1704,20160418,2197,2197,2201,2302,2200,2285,2282,88,85,304,693.94,250
,20160419,2285,2282,2315,2399,2299,2399,2338,117,56,1298,"3,035.68",880
,20160420,2399,2338,2407,2478,2399,2476,2443,138,105,530,"1,295.27",902
,20160421,2476,2443,2515,2589,2476,2589,2562,146,119,864,"2,214.39",1076
,20160422,2589,2562,2757,2757,2468,2524,2549,-38,-13,1030,"2,626.34",940
,20160425,2524,2549,2591,2625,2485,2512,2539,-37,-10,542,"1,376.16",1138
,20160426,2512,2539,2501,2536,2418,2434,2484,-105,-55,450,"1,118.21",1276
,20160427,2434,2484,2450,2483,2360,2386,2436,-98,-48,884,"2,153.69",1466
,20160428,2386,2436,2370,2433,2358,2428,2405,-8,-31,290,697.50,1542
,20160429,2428,2405,2434,2478,2434,2473,2457,68,52,360,884.55,1338
,20160503,2473,2457,2424,2424,2332,2363,2371,-94,-86,504,"1,195.13",1676
,20160504,2363,2371,2326,2348,2271,2285,2325,-86,-46,688,"1,599.81",2076
,20160505,2285,2325,2297,2309,2218,2218,2276,-107,-49,740,"1,684.28",2494
,20160506,2218,2276,2232,2256,2198,2256,2224,-20,-52,434,965.65,2594
,20160509,2256,2224,2271,2271,2090,2090,2133,-134,-91,764,"1,630.33",2818
,20160510,2090,2133,2076,2138,2041,2110,2080,-23,-53,1034,"2,151.43",2816
,20160511,2110,2080,2121,2137,2092,2120,2114,40,34,280,592.15,2784
,20160512,2120,2114,2122,2146,2065,2068,2110,-46,-4,614,"1,295.65",2832
,20160513,2068,2110,2062,2064,1994,2025,2027,-85,-83,678,"1,374.97",2976
,20160516,2025,2027,2030,2065,2024,2045,2041,18,14,770,"1,571.59",2894
,20160517,2045,2041,2043,2081,2011,2076,2037,35,-4,1020,"2,077.80",2754
,20160518,2076,2037,2074,2088,2025,2034,2067,-3,30,490,"1,012.99",2816
,20160519,2034,2067,2031,2052,2015,2027,2038,-40,-29,244,497.34,2804
,20160520,2027,2038,2006,2057,2006,2047,2035,9,-3,188,382.62,2746
,20160523,2047,2035,2035,2037,1912,1948,1941,-87,-94,1192,"2,314.58",2584
,20160524,1948,1941,1945,1954,1917,1943,1933,2,-8,582,"1,125.24",2562
,20160525,1943,1933,1952,1958,1926,1928,1937,-5,4,382,740.30,2560
,20160526,1928,1937,1937,1954,1924,1942,1936,5,-1,610,"1,181.46",2632
,20160527,1942,1936,1947,2016,1926,2006,1963,70,27,448,879.78,2672
,20160530,2006,1963,2007,2025,1888,1980,1966,17,3,610,"1,199.48",2652
,20160531,1980,1966,1988,2006,1962,1962,1981,-4,15,214,424.14,2668
,20160601,1962,1981,1967,1967,1929,1953,1954,-28,-27,178,347.98,2658
,20160602,1953,1954,1947,1976,1947,1956,1961,2,7,246,482.59,2640
,20160603,1956,1961,1975,1999,1968,1989,1987,28,26,108,214.66,2616
,20160606,1989,1987,2007,2055,1966,2048,2016,61,29,594,"1,197.61",2562
,20160607,2048,2016,2061,2083,2051,2065,2064,49,48,104,214.66,2548
,20160608,2065,2064,2056,2089,2037,2065,2062,1,-2,142,292.94,2542
,20160613,2065,2062,2085,2133,2075,2113,2100,51,38,146,306.66,2540
,20160614,2113,2100,2122,2122,2053,2053,2085,-47,-15,124,258.60,2612
,20160615,2053,2085,2050,2072,2036,2041,2053,-44,-32,124,254.61,2638
,20160616,2041,2053,2048,2131,2044,2044,2056,-9,3,88,180.96,2624
,20160617,2044,2056,2038,2063,2019,2063,2038,7,-18,122,248.75,2624
,20160620,2063,2038,2082,2082,2041,2051,2051,13,13,88,180.51,2614
,20160621,2051,2051,2050,2093,2045,2059,2073,8,22,154,319.37,2608
,20160622,2059,2073,2097,2105,2084,2097,2092,24,19,94,196.72,2590
,20160623,2097,2092,2106,2114,2092,2092,2101,0,9,44,92.48,2590
,20160624,2092,2101,2114,2114,2073,2090,2101,-11,0,106,222.72,2620
,20160627,2090,2101,2097,2201,2097,2200,2161,99,60,230,497.21,2568
,20160628,2200,2161,2205,2221,2162,2215,2200,54,39,156,343.24,2546
,20160629,2215,2200,2199,2229,2187,2205,2205,5,5,88,194.05,2510
,20160630,2205,2205,2218,2284,2207,2280,2263,75,58,404,914.48,2308
,20160701,2280,2263,2299,2309,2262,2284,2294,21,31,354,812.24,2304
,20160704,2284,2294,2296,2383,2296,2367,2369,73,75,970,"2,298.75",1918
,20160705,2367,2369,2371,2406,2258,2330,2338,-39,-31,316,739.08,1932
,20160706,2330,2338,2360,2371,2281,2315,2338,-23,0,224,523.89,1844
,20160707,2315,2338,2299,2359,2295,2295,2327,-43,-11,78,181.57,1844
,20160708,2295,2327,2326,2340,2281,2305,2311,-22,-16,130,300.46,1862
,20160711,2305,2311,2374,2374,2271,2322,2323,11,12,464,"1,078.27",1728
,20160712,2322,2323,2325,2430,2319,2425,2386,102,63,428,"1,021.38",1502
,20160713,2425,2386,2418,2450,2404,2415,2425,29,39,242,587.09,1406
,20160714,2415,2425,2416,2432,2401,2429,2415,4,-10,126,304.31,1382
,20160715,2429,2415,2427,2446,2414,2427,2424,12,9,168,407.39,1380
,20160718,2427,2424,2405,2413,2278,2278,2339,-146,-85,222,519.30,1318
,20160719,2278,2339,2279,2283,2210,2224,2254,-115,-85,212,478.06,1306
,20160720,2224,2254,2229,2249,2210,2228,2230,-26,-24,128,285.51,1320
,20160721,2228,2230,2208,2335,2208,2325,2264,95,34,188,425.71,1364
,20160722,2325,2264,2314,2314,2235,2235,2268,-29,4,60,136.12,1360
,20160725,2235,2268,2233,2289,2231,2251,2267,-17,-1,224,507.85,1358
,20160726,2251,2267,2245,2273,2243,2268,2262,1,-5,38,85.96,1360
,20160727,2268,2262,2276,2354,2276,2320,2322,58,60,82,190.43,1366
,20160728,2320,2322,2358,2410,2341,2397,2377,75,55,150,356.60,1354
,20160729,2397,2377,2381,2395,2335,2339,2380,-38,3,220,523.77,1340
,20160801,2339,2380,2350,2425,2320,2418,2401,38,21,212,509.15,1336
,20160802,2418,2401,2414,2429,2399,2429,2413,28,12,102,246.14,1316
,20160803,2429,2413,2428,2428,2381,2396,2405,-17,-8,92,221.29,1320
,20160804,2396,2405,2394,2403,2338,2368,2384,-37,-21,108,257.52,1332
,20160805,2368,2384,2362,2423,2362,2420,2406,36,22,166,399.44,1218
,20160808,2420,2406,2437,2491,2432,2491,2473,85,67,126,311.70,1196
,20160809,2491,2473,2489,2495,2449,2472,2475,-1,2,62,153.45,1190
,20160810,2472,2475,2467,2512,2467,2476,2485,1,10,64,159.09,1198
,20160811,2476,2485,2470,2482,2437,2475,2469,-10,-16,274,676.66,1300
,20160812,2475,2469,2469,2472,2469,2472,2471,3,2,42,103.82,1300
,20160815,2472,2471,2443,2443,2391,2415,2402,-56,-69,120,288.35,1366
,20160816,2415,2402,2433,2540,2428,2528,2472,126,70,114,281.92,1342
,20160817,2528,2472,2525,2538,2489,2490,2495,18,23,396,988.41,1116
,20160818,2490,2495,2490,2521,2488,2495,2495,0,0,338,843.33,1168
,20160819,2495,2495,2499,2536,2482,2529,2509,34,14,228,572.08,1124
,20160822,2529,2509,2534,2564,2533,2537,2546,28,37,110,280.12,1142
,20160823,2537,2546,2526,2590,2523,2582,2559,36,13,102,261.07,1114
,20160824,2582,2559,2583,2615,2581,2582,2590,23,31,118,305.72,1148
,20160825,2582,2590,2610,2617,2500,2522,2567,-68,-23,74,189.99,1108
,20160826,2522,2567,2558,2563,2513,2513,2539,-54,-28,74,187.90,1120
,20160829,2513,2539,2487,2491,2454,2461,2466,-78,-73,160,394.66,1202
,20160830,2461,2466,2483,2483,2412,2413,2441,-53,-25,192,468.80,1250
,20160831,2413,2441,2420,2427,2379,2379,2410,-62,-31,102,245.88,1250
,20160901,2379,2410,2374,2385,2353,2385,2368,-25,-42,246,582.72,1074
,20160902,2385,2368,2377,2441,2377,2441,2427,73,59,256,621.32,1216
,20160905,2441,2427,2407,2438,2407,2438,2431,11,4,162,393.83,1216
,20160906,2438,2431,2412,2427,2408,2412,2415,-19,-16,334,806.71,1286
,20160907,2412,2415,2405,2405,2329,2339,2330,-76,-85,460,"1,072.11",1020
,20160908,2339,2330,2325,2331,2325,2331,2328,1,-2,12,27.94,1014
,20160909,2331,2328,2328,2328,2299,2318,2314,-10,-14,16,37.02,1012
,20160912,2318,2314,2329,2330,2274,2279,2293,-35,-21,46,105.49,1026
,20160913,2279,2293,2275,2291,2246,2258,2261,-35,-32,48,108.56,1034
,20160914,2258,2261,2260,2263,2251,2259,2256,-2,-5,76,171.52,1034
,20160919,2259,2256,2224,2252,2224,2252,2234,-4,-22,6,13.40,1034
,20160920,2252,2234,2251,2299,2251,2273,2279,39,45,46,104.86,1048
,20160921,2273,2279,2272,2286,2265,2286,2270,7,-9,48,109.00,1052
,20160922,2286,2270,2296,2351,2296,2315,2333,45,63,202,471.44,1038
,20160923,2315,2333,2316,2338,2311,2320,2325,-13,-8,414,962.55,1026
,20160926,2320,2325,2334,2359,2322,2329,2332,4,7,112,261.26,998
,20160927,2329,2332,2314,2314,2270,2286,2293,-46,-39,50,114.67,974
,20160928,2286,2293,2273,2291,2272,2291,2278,-2,-15,6,13.67,972
,20160929,2291,2278,2311,2351,2295,2295,2319,17,41,24,55.66,970
,20160930,2295,2319,2299,2303,2260,2275,2279,-44,-40,24,54.71,966
,20161010,2275,2279,2257,2285,2251,2285,2264,6,-15,6,13.59,964
,20161011,2285,2264,2300,2338,2300,2338,2321,74,57,22,51.08,974
,20161012,2338,2321,2349,2349,2325,2344,2339,23,18,62,145.06,972
,20161013,2344,2339,2360,2363,2338,2355,2347,16,8,54,126.75,996
,20161014,2355,2347,2357,2404,2355,2404,2379,57,32,28,66.62,1002
,20161017,2404,2379,2392,2432,2392,2429,2416,50,37,24,58.01,1004
,20161018,2429,2416,2417,2417,2381,2412,2402,-4,-14,24,57.65,1004
,20161019,2412,2402,2435,2478,2382,2382,2438,-20,36,90,219.47,1014
,20161020,2382,2438,2421,2471,2421,2454,2441,16,3,122,297.90,1022
,20161021,2454,2441,2453,2453,2402,2431,2416,-10,-25,40,96.64,1002
,20161024,2431,2416,2417,2446,2413,2445,2426,29,10,34,82.52,990
,20161025,2445,2426,2480,2554,2465,2530,2519,104,93,110,277.16,998
,20161026,2530,2519,2557,2565,2503,2514,2526,-5,7,60,151.60,992
,20161027,2514,2526,2523,2541,2513,2521,2528,-5,2,46,116.29,972
,20161028,2521,2528,2518,2585,2518,2585,2563,57,35,102,261.44,986
,20161031,2585,2563,2586,2614,2555,2614,2587,51,24,82,212.18,982
,20161101,2614,2587,2603,2625,2584,2618,2607,31,20,90,234.65,982
,20161102,2618,2607,2618,2653,2586,2586,2620,-21,13,76,199.16,980
,20161103,2586,2620,2612,2646,2606,2634,2625,14,5,56,147.04,972
,20161104,2634,2625,2672,2700,2659,2661,2680,36,55,68,182.31,988
,20161107,2661,2680,2689,2835,2689,2818,2762,138,82,74,204.45,1004
,20161108,2818,2762,2858,2858,2748,2767,2800,5,38,144,403.32,1000
,20161109,2767,2800,2770,2950,2760,2927,2860,127,60,462,"1,321.56",938
,20161110,2927,2860,2935,3031,2904,2960,2972,100,112,270,802.53,946
,20161111,2960,2972,2972,3099,2952,3099,2996,127,24,180,539.31,966
,20161114,3099,2996,3139,3156,2920,2950,2984,-46,-12,512,"1,527.87",1004
,20161115,2950,2984,2927,2986,2804,2808,2893,-176,-91,178,515.10,1018
,20161116,2808,2893,2836,2836,2731,2830,2785,-63,-108,382,"1,063.88",1210
,20161117,2830,2785,2846,2856,2769,2827,2812,42,27,226,635.67,1218
,20161118,2827,2812,2835,2840,2779,2804,2805,-8,-7,112,314.24,1212
,20161121,2804,2805,2796,2798,2714,2775,2769,-30,-36,112,310.14,1250
,20161122,2775,2769,2776,2935,2750,2925,2839,156,70,274,778.09,1350
,20161123,2925,2839,2913,2984,2913,2969,2954,130,115,84,248.22,1304
,20161124,2969,2954,2949,3092,2927,3025,3024,71,70,174,526.33,1324
,20161125,3025,3024,3008,3235,3006,3235,3117,211,93,112,349.15,1344
,20161128,3235,3117,3250,3328,3169,3275,3258,158,141,486,"1,583.82",1402
,20161129,3275,3258,3265,3297,3083,3088,3120,-170,-138,744,"2,321.49",1368
,20161130,3088,3120,3036,3048,2903,2920,2998,-200,-122,1072,"3,214.17",1372
,20161201,2920,2998,3009,3187,2966,3159,3032,161,34,832,"2,523.36",1410
,20161202,3159,3032,3204,3204,3018,3112,3099,80,67,300,929.70,1442
,20161205,3112,3099,3106,3206,3055,3193,3136,94,37,378,"1,185.66",1558
,20161206,3193,3136,3206,3238,3169,3181,3203,45,67,244,781.61,1552
,20161207,3181,3203,3217,3388,3217,3374,3358,171,155,854,"2,868.00",1976
,20161208,3374,3358,3379,3395,3293,3374,3370,16,12,322,"1,085.35",1968
,20161209,3374,3370,3337,3362,3212,3319,3281,-51,-89,106,347.89,1970
,20161212,3319,3281,3344,3501,3307,3427,3436,146,155,230,790.32,2004
,20161213,3427,3436,3434,3483,3402,3458,3459,22,23,184,636.46,1938
,20161214,3458,3459,3450,3450,3320,3372,3404,-87,-55,136,462.99,1950
,20161215,3372,3404,3331,3418,3300,3411,3340,7,-64,64,213.81,1950
,20161216,3411,3340,3366,3376,3290,3290,3327,-50,-13,86,286.17,1914
,20161219,3290,3327,3270,3277,3179,3179,3226,-148,-101,408,"1,316.54",1852
,20161220,3179,3226,3162,3168,3109,3153,3128,-73,-98,304,951.20,1706
,20161221,3153,3128,3159,3178,3083,3157,3147,29,19,26,81.84,1714
,20161222,3157,3147,3120,3143,3019,3022,3084,-125,-63,416,"1,283.20",1950
,20161223,3022,3084,3007,3044,2966,2989,3011,-95,-73,404,"1,216.55",1816
,20161226,2989,3011,3008,3008,2882,2925,2921,-86,-90,780,"2,278.70",1702
,20161227,2925,2921,2935,3000,2894,2998,2940,77,19,322,946.88,1720
,20161228,2998,2940,2995,3079,2979,3009,3034,69,94,346,"1,049.79",1654
,20161229,3009,3034,2967,2989,2921,2989,2962,-45,-72,86,254.81,1650
,20161230,2989,2962,2942,2966,2754,2898,2895,-64,-67,434,"1,256.48",1644
rb1705,20160517,2041,2041,2008,2068,2005,2062,2023,21,-18,10490,"21,226.39",5866
,20160518,2062,2023,2064,2082,2010,2022,2048,-1,25,10558,"21,630.20",9290
,20160519,2022,2048,2022,2046,1998,2018,2026,-30,-22,11896,"24,111.82",13776
,20160520,2018,2026,2022,2042,2000,2035,2027,9,1,10204,"20,685.10",14648
,20160523,2035,2027,2037,2042,1905,1941,1942,-86,-85,36324,"70,541.28",26990
,20160524,1941,1942,1940,1947,1904,1938,1926,-4,-16,21696,"41,793.62",28888
,20160525,1938,1926,1938,1959,1913,1919,1936,-7,10,21110,"40,886.75",32856
,20160526,1919,1936,1923,1948,1912,1939,1935,3,-1,19790,"38,301.44",35880
,20160527,1939,1935,1939,2006,1920,1998,1961,63,26,35054,"68,772.70",41576
,20160530,1998,1961,1990,2015,1893,1971,1966,10,5,30672,"60,308.24",44240
,20160531,1971,1966,1971,2000,1962,1964,1979,-2,13,14376,"28,463.25",46850
,20160601,1964,1979,1965,1972,1935,1954,1952,-25,-27,13690,"26,733.16",46048
,20160602,1954,1952,1954,1976,1942,1958,1960,6,8,11566,"22,680.66",48166
,20160603,1958,1960,1958,1998,1958,1992,1983,32,23,17466,"34,650.20",51004
,20160606,1992,1983,1995,2069,1988,2052,2024,69,41,32772,"66,334.79",55558
,20160607,2052,2024,2053,2088,2045,2065,2063,41,39,17582,"36,282.40",56172
,20160608,2065,2063,2066,2092,2029,2066,2061,3,-2,26648,"54,944.94",61462
,20160613,2066,2061,2060,2131,2059,2113,2098,52,37,26042,"54,647.93",65182
,20160614,2113,2098,2118,2128,2049,2051,2087,-47,-11,27766,"57,957.32",67498
,20160615,2051,2087,2040,2070,2036,2042,2049,-45,-38,14198,"29,102.34",67772
,20160616,2042,2049,2050,2090,2042,2046,2056,-3,7,20256,"41,659.72",67622
,20160617,2046,2056,2043,2060,2023,2057,2039,1,-17,26702,"54,458.15",63394
,20160620,2057,2039,2058,2076,2048,2052,2058,13,19,16876,"34,740.85",66650
,20160621,2052,2058,2050,2087,2042,2059,2068,1,10,18470,"38,199.82",65998
,20160622,2059,2068,2058,2108,2055,2102,2089,34,21,26514,"55,408.56",71084
,20160623,2102,2089,2096,2115,2092,2094,2102,5,13,32604,"68,543.34",78954
,20160624,2094,2102,2104,2120,2072,2097,2099,-5,-3,33418,"70,168.47",74240
,20160627,2097,2099,2095,2217,2095,2215,2166,116,67,56714,"122,887.39",74060
,20160628,2215,2166,2208,2229,2178,2211,2207,45,41,46152,"101,871.61",77744
,20160629,2211,2207,2212,2237,2189,2209,2212,2,5,45138,"99,863.86",79148
,20160630,2209,2212,2206,2296,2205,2288,2256,76,44,55862,"126,057.33",76176
,20160701,2288,2256,2292,2319,2265,2295,2292,39,36,43652,"100,082.20",78908
,20160704,2295,2292,2295,2389,2295,2372,2352,80,60,70512,"165,848.53",80440
,20160705,2372,2352,2372,2405,2270,2358,2334,6,-18,69292,"161,787.42",79702
,20160706,2358,2334,2355,2375,2280,2318,2321,-16,-13,58464,"135,752.57",85228
,20160707,2318,2321,2308,2366,2295,2314,2328,-7,7,65050,"151,472.08",95740
,20160708,2314,2328,2338,2342,2289,2337,2317,9,-11,55706,"129,080.65",101226
,20160711,2337,2317,2345,2369,2272,2327,2320,10,3,52336,"121,431.51",101382
,20160712,2327,2320,2335,2440,2321,2427,2372,107,52,65408,"155,178.97",104734
,20160713,2427,2372,2425,2460,2404,2414,2428,42,56,58998,"143,302.77",109500
,20160714,2414,2428,2414,2438,2399,2434,2419,6,-9,55120,"133,339.10",117342
,20160715,2434,2419,2434,2459,2408,2429,2427,10,8,54418,"132,081.86",120154
,20160718,2429,2427,2429,2437,2281,2281,2354,-146,-73,85524,"201,373.90",134016
,20160719,2281,2354,2276,2282,2212,2222,2245,-132,-109,91410,"205,271.32",146180
,20160720,2222,2245,2221,2250,2209,2227,2227,-18,-18,61450,"136,864.40",146522
,20160721,2227,2227,2225,2331,2203,2300,2267,73,40,72580,"164,541.05",143726
,20160722,2300,2267,2300,2306,2229,2233,2265,-34,-2,57290,"129,772.25",146356
,20160725,2233,2265,2227,2285,2210,2258,2252,-7,-13,59030,"132,964.17",147240
,20160726,2258,2252,2258,2275,2234,2270,2255,18,3,47524,"107,191.32",150848
,20160727,2270,2255,2270,2352,2268,2341,2315,86,60,91972,"212,967.23",160364
,20160728,2341,2315,2340,2408,2338,2401,2379,86,64,97832,"232,760.49",163468
,20160729,2401,2379,2396,2405,2336,2347,2370,-32,-9,73132,"173,386.67",168320
,20160801,2347,2370,2336,2429,2317,2419,2389,49,19,98762,"236,030.91",165854
,20160802,2419,2389,2410,2439,2398,2424,2416,35,27,66714,"161,192.42",167098
,20160803,2424,2416,2415,2429,2381,2405,2405,-11,-11,47536,"114,350.22",166798
,20160804,2405,2405,2405,2411,2318,2361,2366,-44,-39,74854,"177,154.48",179094
,20160805,2361,2366,2362,2460,2353,2440,2409,74,43,76254,"183,700.23",169916
,20160808,2440,2409,2441,2500,2416,2494,2470,85,61,85794,"211,913.52",177872
,20160809,2494,2470,2495,2503,2440,2481,2484,11,14,89322,"221,889.53",188324
,20160810,2481,2484,2481,2510,2452,2478,2477,-6,-7,78090,"193,478.46",193866
,20160811,2478,2477,2486,2495,2431,2467,2461,-10,-16,78672,"193,684.65",200626
,20160812,2467,2461,2467,2475,2448,2461,2462,0,1,62426,"153,725.78",210770
,20160815,2461,2462,2440,2452,2382,2426,2418,-36,-44,104448,"252,634.64",225686
,20160816,2426,2418,2430,2540,2417,2519,2482,101,64,183620,"455,770.59",211504
,20160817,2519,2482,2520,2549,2487,2487,2526,5,44,137224,"346,669.44",219986
,20160818,2487,2526,2490,2533,2476,2512,2505,-14,-21,158614,"397,372.85",223794
,20160819,2512,2505,2505,2545,2477,2545,2511,40,6,143902,"361,343.63",229726
,20160822,2545,2511,2542,2580,2527,2533,2553,22,42,149840,"382,557.64",237382
,20160823,2533,2553,2532,2600,2515,2590,2570,37,17,149410,"384,070.94",255802
,20160824,2590,2570,2590,2630,2583,2602,2605,32,35,136032,"354,396.92",268824
,20160825,2602,2605,2615,2629,2497,2570,2570,-35,-35,246460,"633,599.79",291146
,20160826,2570,2570,2570,2580,2507,2508,2543,-62,-27,128112,"325,903.96",300866
,20160829,2508,2543,2500,2508,2451,2462,2472,-81,-71,180834,"447,148.77",308082
,20160830,2462,2472,2466,2475,2406,2410,2440,-62,-32,139928,"341,493.50",321442
,20160831,2410,2440,2410,2437,2372,2374,2405,-66,-35,147790,"355,496.20",331006
,20160901,2374,2405,2370,2396,2344,2389,2370,-16,-35,131044,"310,620.56",339570
,20160902,2389,2370,2387,2447,2372,2392,2412,22,42,177302,"427,660.05",344676
,20160905,2392,2412,2400,2446,2393,2419,2426,7,14,174538,"423,499.37",357550
,20160906,2419,2426,2420,2444,2398,2410,2415,-16,-11,144092,"348,085.27",376982
,20160907,2410,2415,2411,2413,2325,2329,2359,-86,-56,223576,"527,503.91",402790
,20160908,2329,2359,2329,2346,2317,2330,2331,-29,-28,148372,"345,903.83",418214
,20160909,2330,2331,2332,2333,2300,2330,2316,-1,-15,149966,"347,391.31",423058
,20160912,2330,2316,2330,2344,2271,2274,2297,-42,-19,168556,"387,283.68",435752
,20160913,2274,2297,2275,2293,2242,2251,2266,-46,-31,177566,"402,373.89",460954
,20160914,2251,2266,2249,2269,2242,2248,2254,-18,-12,130080,"293,222.80",466314
,20160919,2248,2254,2208,2262,2192,2256,2241,2,-13,154528,"346,298.29",491610
,20160920,2256,2241,2256,2297,2250,2278,2276,37,35,176602,"402,043.23",491740
,20160921,2278,2276,2280,2291,2263,2275,2276,-1,0,160530,"365,438.37",501342
,20160922,2275,2276,2271,2361,2270,2312,2323,36,47,338058,"785,515.13",518030
,20160923,2312,2323,2322,2340,2313,2333,2326,10,3,204532,"475,762.11",521314
,20160926,2333,2326,2331,2370,2330,2333,2343,7,17,196536,"460,593.41",528502
,20160927,2333,2343,2335,2339,2281,2299,2305,-44,-38,204474,"471,514.10",535064
,20160928,2299,2305,2293,2314,2280,2314,2297,9,-8,156878,"360,496.38",539746
,20160929,2314,2297,2315,2360,2303,2305,2335,8,38,203174,"474,532.45",533928
,20160930,2305,2335,2305,2323,2282,2284,2297,-51,-38,144080,"330,968.92",545710
,20161010,2284,2297,2285,2308,2244,2300,2276,3,-21,214626,"488,676.81",560882
,20161011,2300,2276,2300,2365,2300,2364,2337,88,61,305140,"713,344.47",597152
,20161012,2364,2337,2372,2375,2339,2373,2360,36,23,275872,"651,127.35",614858
,20161013,2373,2360,2379,2386,2357,2379,2369,19,9,290092,"687,363.79",651496
,20161014,2379,2369,2375,2438,2362,2413,2395,44,26,329586,"789,505.97",654288
,20161017,2413,2395,2410,2463,2406,2441,2440,46,45,433168,"1,057,055.54",699260
,20161018,2441,2440,2440,2446,2410,2437,2425,-3,-15,374598,"908,742.64",733248
,20161019,2437,2425,2441,2509,2413,2429,2462,4,37,610110,"1,502,235.30",767640
,20161020,2429,2462,2425,2478,2425,2469,2457,7,-5,347322,"853,656.26",783116
,20161021,2469,2457,2471,2483,2407,2453,2434,-4,-23,492352,"1,198,868.25",810024
,20161024,2453,2434,2450,2471,2413,2466,2441,32,7,427976,"1,044,870.02",829700
,20161025,2466,2441,2470,2577,2465,2557,2526,116,85,692334,"1,749,400.82",815636
,20161026,2557,2526,2563,2588,2513,2533,2544,7,18,712320,"1,812,687.07",819068
,20161027,2533,2544,2537,2560,2499,2525,2532,-19,-12,637502,"1,614,726.19",854302
,20161028,2525,2532,2525,2594,2519,2593,2557,61,25,704138,"1,800,842.29",869608
,20161031,2593,2557,2595,2630,2570,2629,2599,72,42,788490,"2,049,896.59",902466
,20161101,2629,2599,2630,2653,2592,2633,2628,34,29,856732,"2,251,612.27",866330
,20161102,2633,2628,2631,2670,2603,2618,2638,-10,10,815354,"2,150,949.05",846988
,20161103,2618,2638,2619,2672,2609,2671,2639,33,1,627666,"1,656,948.25",884728
,20161104,2671,2639,2675,2724,2672,2682,2693,43,54,925948,"2,493,890.45",849048
,20161107,2682,2693,2696,2854,2670,2838,2767,145,74,1176650,"3,256,534.47",915528
,20161108,2838,2767,2842,2878,2747,2789,2820,22,53,1149442,"3,241,528.39",907418
,20161109,2789,2820,2793,2989,2765,2989,2919,169,99,2069560,"6,042,000.43",894192
,20161110,2989,2919,2997,3094,2950,3005,3021,86,102,2405620,"7,269,183.82",886918
,20161111,3005,3021,3010,3158,2994,3143,3070,122,49,1438282,"4,416,875.48",941188
,20161114,3143,3070,3157,3234,2933,2979,3062,-91,-8,2198868,"6,735,081.26",856882
,20161115,2979,3062,2976,3035,2878,2878,2968,-184,-94,926108,"2,748,963.08",874342
,20161116,2878,2968,2839,2866,2749,2850,2824,-118,-144,1252410,"3,537,132.02",865114
,20161117,2850,2824,2848,2878,2780,2854,2825,30,1,1045916,"2,955,137.76",880334
,20161118,2854,2825,2860,2881,2780,2797,2817,-28,-8,1125852,"3,172,559.64",967860
,20161121,2797,2817,2802,2815,2696,2738,2757,-79,-60,1298414,"3,580,121.86",995722
,20161122,2738,2757,2747,2922,2740,2922,2849,165,92,1559814,"4,443,923.20",999844
,20161123,2922,2849,2930,3010,2903,2997,2958,148,109,1618752,"4,788,582.68",1021932
,20161124,2997,2958,2998,3102,2935,3021,3027,63,69,1939116,"5,871,325.36",1009108
,20161125,3021,3027,3016,3238,3001,3238,3141,211,114,2238222,"7,030,723.27",1218032
,20161128,3238,3141,3252,3378,3182,3332,3281,191,140,2733408,"8,970,199.52",1364960
,20161129,3332,3281,3306,3348,3060,3062,3226,-219,-55,3991114,"12,875,451.93",1433476
,20161130,3062,3226,3062,3085,3000,3000,3040,-226,-186,2136874,"6,498,129.98",1337564
,20161201,3000,3040,3000,3218,2965,3187,3087,147,47,5079566,"15,683,418.32",1610660
,20161202,3187,3087,3196,3229,3011,3126,3131,39,44,5315224,"16,644,954.00",1646860
,20161205,3126,3131,3124,3233,3060,3204,3147,73,16,4581570,"14,421,125.51",1742120
,20161206,3204,3147,3201,3262,3178,3217,3218,70,71,3570526,"11,490,270.92",1808054
,20161207,3217,3218,3223,3428,3216,3382,3337,164,119,4600540,"15,354,573.63",2081848
,20161208,3382,3337,3391,3418,3291,3394,3363,57,26,3988602,"13,414,374.53",2131430
,20161209,3394,3363,3402,3413,3213,3345,3325,-18,-38,5420202,"18,023,848.65",2147234
,20161212,3345,3325,3368,3557,3302,3444,3436,119,111,4000812,"13,748,300.29",2142098
,20161213,3444,3436,3456,3506,3413,3505,3466,69,30,3335092,"11,562,418.78",2325978
,20161214,3505,3466,3489,3497,3331,3375,3412,-91,-54,4341096,"14,812,565.78",2301362
,20161215,3375,3412,3368,3441,3304,3413,3368,1,-44,4079444,"13,741,322.56",2300790
,20161216,3413,3368,3380,3409,3292,3293,3363,-75,-5,3396454,"11,423,583.33",2313854
,20161219,3293,3363,3280,3309,3167,3171,3252,-192,-111,3659544,"11,904,231.09",2328378
,20161220,3171,3252,3161,3193,3118,3162,3157,-90,-95,3485732,"11,005,809.72",2178928
,20161221,3162,3157,3168,3205,3093,3169,3158,12,1,3572718,"11,282,833.28",2247440
,20161222,3169,3158,3173,3186,3024,3026,3110,-132,-48,3356712,"10,440,943.59",2355272
,20161223,3026,3110,3012,3068,2966,2984,3012,-126,-98,3764756,"11,342,166.69",2404368
,20161226,2984,3012,2971,3018,2846,2922,2927,-90,-85,4597294,"13,457,698.36",2499958
,20161227,2922,2927,2932,3007,2872,3006,2931,79,4,3606540,"10,570,948.86",2361982
,20161228,3006,2931,3010,3072,2966,2989,3015,58,84,4099296,"12,360,006.71",2398440
,20161229,2989,3015,2992,2995,2911,2952,2951,-63,-64,3948156,"11,651,289.18",2464282
,20161230,2952,2951,2948,2970,2866,2867,2911,-84,-40,2988602,"8,702,556.57",2442966
rb1706,20160616,2049,2049,2031,2055,2023,2040,2035,-9,-14,68,138.42,42
,20160617,2040,2035,2033,2045,2017,2031,2031,-4,-4,68,138.16,86
,20160620,2031,2031,2050,2058,2042,2049,2049,18,18,22,45.09,84
,20160621,2049,2049,2049,2073,2046,2046,2059,-3,10,36,74.13,102
,20160622,2046,2059,2061,2096,2061,2092,2083,33,24,42,87.52,114
,20160623,2092,2083,2092,2108,2087,2093,2095,10,12,50,104.77,134
,20160624,2093,2095,2108,2108,2082,2090,2094,-5,-1,44,92.15,136
,20160627,2090,2094,2100,2205,2095,2200,2150,106,56,134,288.21,156
,20160628,2200,2150,2223,2228,2176,2205,2198,55,48,374,822.23,274
,20160629,2205,2198,2193,2238,2183,2201,2213,3,15,420,929.59,568
,20160630,2201,2213,2210,2288,2210,2273,2231,60,18,192,428.42,486
,20160701,2273,2231,2301,2311,2274,2288,2290,57,59,38,87.02,482
,20160704,2288,2290,2290,2371,2290,2363,2332,73,42,128,298.60,490
,20160705,2363,2332,2380,2386,2274,2352,2322,20,-10,138,320.47,488
,20160706,2352,2322,2356,2362,2297,2302,2320,-20,-2,20,46.41,484
,20160707,2302,2320,2298,2385,2292,2333,2316,13,-4,98,226.98,510
,20160708,2333,2316,2314,2331,2288,2319,2313,3,-3,136,314.67,522
,20160711,2319,2313,2351,2351,2268,2316,2311,3,-2,330,762.86,696
,20160712,2316,2311,2331,2414,2322,2414,2378,103,67,264,628.00,680
,20160713,2414,2378,2407,2440,2394,2400,2411,22,33,166,400.36,668
,20160714,2400,2411,2420,2432,2392,2420,2410,9,-1,102,245.91,664
,20160715,2420,2410,2437,2442,2401,2417,2416,7,6,162,391.50,764
,20160718,2417,2416,2398,2400,2271,2271,2333,-145,-83,540,"1,260.15",816
,20160719,2271,2333,2270,2275,2193,2228,2238,-105,-95,180,402.96,898
,20160720,2228,2238,2218,2240,2204,2225,2221,-13,-17,182,404.25,918
,20160721,2225,2221,2250,2313,2200,2313,2240,92,19,206,461.63,932
,20160722,2313,2240,2289,2292,2193,2230,2258,-10,18,126,284.60,920
,20160725,2230,2258,2233,2271,2207,2255,2233,-3,-25,228,509.34,920
,20160726,2255,2233,2228,2264,2228,2260,2245,27,12,66,148.21,932
,20160727,2260,2245,2274,2335,2274,2330,2303,85,58,170,391.67,920
,20160728,2330,2303,2336,2388,2327,2376,2374,73,71,310,736.15,818
,20160729,2376,2374,2366,2384,2325,2325,2359,-49,-15,26,61.34,816
,20160801,2325,2359,2336,2416,2309,2416,2382,57,23,82,195.39,790
,20160802,2416,2382,2407,2419,2406,2408,2408,26,26,28,67.43,790
,20160803,2408,2408,2395,2404,2379,2392,2393,-16,-15,208,497.76,874
,20160804,2392,2393,2377,2396,2311,2344,2350,-49,-43,82,192.71,896
,20160805,2344,2350,2418,2426,2341,2415,2392,65,42,66,157.89,894
,20160808,2415,2392,2424,2484,2406,2478,2457,86,65,46,113.02,890
,20160809,2478,2457,2472,2488,2436,2472,2475,15,18,108,267.36,906
,20160810,2472,2475,2467,2498,2445,2458,2469,-17,-6,250,617.35,1016
,20160811,2458,2469,2465,2465,2428,2457,2444,-12,-25,54,132.00,1024
,20160812,2457,2444,2442,2460,2440,2460,2452,16,8,30,73.58,1034
,20160815,2460,2452,2406,2425,2382,2420,2402,-32,-50,312,749.62,1296
,20160816,2420,2402,2416,2523,2416,2513,2473,111,71,262,648.18,1224
,20160817,2513,2473,2507,2540,2486,2486,2510,13,37,594,"1,491.03",1488
,20160818,2486,2510,2487,2499,2459,2473,2485,-37,-25,518,"1,287.29",1566
,20160819,2473,2485,2473,2516,2460,2509,2492,24,7,128,319.03,1546
,20160822,2509,2492,2542,2543,2518,2518,2527,26,35,60,151.67,1556
,20160823,2518,2527,2501,2562,2501,2561,2534,34,7,34,86.19,1554
,20160824,2561,2534,2562,2590,2561,2579,2580,45,46,116,299.38,1550
,20160825,2579,2580,2601,2601,2514,2540,2565,-40,-15,104,266.84,1490
,20160826,2540,2565,2531,2544,2499,2507,2512,-58,-53,76,190.95,1484
,20160829,2507,2512,2447,2462,2409,2443,2441,-69,-71,134,327.14,1440
,20160830,2443,2441,2438,2442,2387,2387,2404,-54,-37,160,384.75,1464
,20160831,2387,2404,2396,2407,2352,2353,2369,-51,-35,748,"1,772.56",1424
,20160901,2353,2369,2348,2372,2319,2372,2348,3,-21,188,441.58,1474
,20160902,2372,2348,2359,2422,2359,2374,2384,26,36,370,882.35,1560
,20160905,2374,2384,2383,2425,2381,2405,2406,21,22,76,182.92,1552
,20160906,2405,2406,2398,2399,2387,2387,2392,-19,-14,20,47.84,1554
,20160907,2387,2392,2379,2382,2303,2303,2337,-89,-55,208,486.25,1622
,20160908,2303,2337,2324,2324,2305,2310,2314,-27,-23,26,60.19,1628
,20160909,2310,2314,2313,2313,2280,2310,2289,-4,-25,260,595.36,1786
,20160912,2310,2289,2315,2315,2258,2262,2291,-27,2,114,261.20,1820
,20160913,2262,2291,2259,2277,2230,2238,2254,-53,-37,130,293.14,1858
,20160914,2238,2254,2238,2255,2228,2243,2239,-11,-15,72,161.22,1904
,20160919,2243,2239,2229,2247,2222,2241,2231,2,-8,104,232.11,1934
,20160920,2241,2231,2256,2283,2253,2280,2265,49,34,48,108.77,1924
,20160921,2280,2265,2267,2275,2257,2265,2268,0,3,228,517.23,1982
,20160922,2265,2268,2271,2349,2271,2296,2305,28,37,206,474.85,2060
,20160923,2296,2305,2322,2322,2296,2321,2310,16,5,86,198.68,2064
,20160926,2321,2310,2323,2343,2313,2324,2333,14,23,308,718.65,2128
,20160927,2324,2333,2311,2314,2277,2277,2295,-56,-38,60,137.75,2150
,20160928,2277,2295,2276,2291,2276,2291,2284,-4,-11,16,36.55,2148
,20160929,2291,2284,2315,2343,2283,2292,2315,8,31,46,106.50,2130
,20160930,2292,2315,2304,2304,2275,2284,2282,-31,-33,38,86.72,2150
,20161010,2284,2282,2261,2285,2261,2285,2266,3,-16,18,40.80,2168
,20161011,2285,2266,2290,2350,2290,2350,2325,84,59,64,148.82,2132
,20161012,2350,2325,2348,2352,2327,2352,2342,27,17,46,107.75,2128
,20161013,2352,2342,2355,2372,2328,2348,2346,6,4,614,"1,440.63",2336
,20161014,2348,2346,2350,2409,2346,2409,2372,63,26,216,512.55,2322
,20161017,2409,2372,2395,2434,2390,2423,2415,51,43,134,323.65,2298
,20161018,2423,2415,2414,2425,2392,2425,2401,10,-14,174,417.86,2368
,20161019,2425,2401,2427,2488,2402,2425,2449,24,48,140,342.96,2372
,20161020,2425,2449,2429,2449,2425,2442,2436,-7,-13,16,38.98,2370
,20161021,2442,2436,2418,2424,2391,2424,2404,-12,-32,110,264.52,2364
,20161024,2424,2404,2415,2444,2394,2444,2423,40,19,80,193.86,2350
,20161025,2444,2423,2454,2543,2454,2536,2501,113,78,288,720.47,2342
,20161026,2536,2501,2536,2552,2483,2500,2500,-1,-1,978,"2,445.51",2310
,20161027,2500,2500,2512,2540,2486,2503,2528,3,28,598,"1,511.90",2262
,20161028,2503,2528,2506,2569,2506,2569,2530,41,2,644,"1,629.49",2244
,20161031,2569,2530,2582,2605,2548,2605,2573,75,43,184,473.53,2280
,20161101,2605,2573,2600,2625,2589,2617,2607,44,34,156,406.78,2268
,20161102,2617,2607,2625,2633,2583,2591,2604,-16,-3,80,208.33,2270
,20161103,2591,2604,2589,2643,2588,2642,2628,38,24,800,"2,102.72",2374
,20161104,2642,2628,2657,2694,2647,2658,2660,30,32,732,"1,947.38",2160
,20161107,2658,2660,2671,2819,2650,2819,2773,159,113,210,582.53,2108
,20161108,2819,2773,2820,2853,2738,2754,2812,-19,39,268,753.71,2122
,20161109,2754,2812,2737,2969,2737,2961,2864,149,52,316,905.32,2096
,20161110,2961,2864,2958,3035,2928,2976,2986,112,122,192,573.48,2120
,20161111,2976,2986,3000,3113,2973,3113,3023,127,37,290,876.89,2056
,20161114,3113,3023,3159,3203,2905,2947,3114,-76,91,646,"2,012.09",1666
,20161115,2947,3114,2944,2998,2927,2927,2946,-187,-168,300,883.86,1616
,20161116,2927,2946,2866,2866,2713,2799,2793,-147,-153,636,"1,776.79",1558
,20161117,2799,2793,2844,2844,2747,2811,2790,18,-3,96,267.93,1554
,20161118,2811,2790,2826,2826,2757,2788,2800,-2,10,70,196.01,1546
,20161121,2788,2800,2793,2793,2704,2727,2733,-73,-67,162,442.81,1566
,20161122,2727,2733,2740,2896,2733,2894,2805,161,72,526,"1,475.47",1552
,20161123,2894,2805,2917,2972,2884,2970,2929,165,124,610,"1,787.21",1574
,20161124,2970,2929,2957,3074,2908,2978,2962,49,33,426,"1,261.84",1556
,20161125,2978,2962,2969,3169,2969,3169,3067,207,105,136,417.19,1530
,20161128,3169,3067,3348,3348,3163,3298,3251,231,184,276,897.44,1526
,20161129,3298,3251,3288,3312,3082,3083,3182,-168,-69,312,992.97,1536
,20161130,3083,3182,3031,3049,2959,2959,2995,-223,-187,344,"1,030.29",1540
,20161201,2959,2995,2997,3182,2969,3147,3047,152,52,672,"2,048.15",1596
,20161202,3147,3047,3180,3188,3000,3054,3100,7,53,190,589.09,1586
,20161205,3054,3100,3070,3179,3038,3161,3081,61,-19,80,246.52,1578
,20161206,3161,3081,3169,3217,3144,3173,3178,92,97,208,661.06,1580
,20161207,3173,3178,3206,3389,3191,3338,3295,160,117,172,566.84,1570
,20161208,3338,3295,3361,3372,3272,3363,3317,68,22,94,311.87,1556
,20161209,3363,3317,3325,3342,3196,3324,3272,7,-45,124,405.79,1550
,20161212,3324,3272,3316,3491,3301,3417,3412,145,140,138,470.94,1554
,20161213,3417,3412,3422,3452,3421,3441,3438,29,26,488,"1,677.92",1528
,20161214,3441,3438,3463,3463,3326,3359,3381,-79,-57,164,554.55,1510
,20161215,3359,3381,3317,3400,3274,3356,3317,-25,-64,92,305.21,1486
,20161216,3356,3317,3351,3366,3281,3281,3336,-36,19,360,"1,201.10",1538
,20161219,3281,3336,3244,3265,3187,3187,3225,-149,-111,256,825.62,1576
,20161220,3187,3225,3150,3170,3105,3143,3143,-82,-82,260,817.30,1462
,20161221,3143,3143,3149,3175,3062,3155,3118,12,-25,206,642.46,1502
,20161222,3155,3118,3129,3144,3035,3035,3067,-83,-51,136,417.15,1442
,20161223,3035,3067,2997,3010,2935,2951,2967,-116,-100,268,795.17,1438
,20161226,2951,2967,2968,2987,2827,2861,2905,-106,-62,110,319.56,1438
,20161227,2861,2905,2901,2971,2864,2967,2911,62,6,126,366.82,1422
,20161228,2967,2911,2986,3022,2932,2949,2982,38,71,148,441.48,1414
,20161229,2949,2982,2937,2944,2899,2938,2919,-44,-63,150,437.94,1424
,20161230,2938,2919,2918,2920,2839,2839,2888,-80,-31,102,294.60,1450
rb1707,20160718,2416,2416,2360,2360,2230,2242,2293,-174,-123,56,128.45,40
,20160719,2242,2293,2260,2266,2196,2216,2240,-77,-53,92,206.08,74
,20160720,2216,2240,2217,2246,2205,2227,2226,-13,-14,50,111.32,110
,20160721,2227,2226,2230,2316,2230,2316,2263,90,37,30,67.90,116
,20160722,2316,2263,2285,2290,2235,2235,2269,-28,6,124,281.44,212
,20160725,2235,2269,2235,2266,2210,2248,2249,-21,-20,224,503.80,412
,20160726,2248,2249,2254,2256,2230,2255,2250,6,1,48,108.01,424
,20160727,2255,2250,2300,2338,2289,2316,2309,66,59,38,87.77,406
,20160728,2316,2309,2338,2399,2338,2383,2373,74,64,52,123.41,408
,20160729,2383,2373,2353,2353,2333,2336,2337,-37,-36,32,74.80,426
,20160801,2336,2337,2337,2410,2323,2410,2387,73,50,60,143.25,428
,20160802,2410,2387,2412,2413,2394,2413,2406,26,19,18,43.31,430
,20160803,2413,2406,2400,2400,2387,2387,2397,-19,-9,24,57.55,434
,20160804,2387,2397,2373,2373,2331,2331,2360,-66,-37,58,136.88,444
,20160805,2331,2360,2365,2437,2365,2420,2399,60,39,62,148.78,448
,20160808,2420,2399,2428,2483,2428,2481,2457,82,58,112,275.24,454
,20160809,2481,2457,2480,2487,2425,2467,2464,10,7,26,64.06,454
,20160810,2467,2464,2467,2491,2447,2447,2480,-17,16,58,143.86,464
,20160811,2447,2480,2448,2471,2422,2453,2444,-27,-36,56,136.87,480
,20160812,2453,2444,2442,2460,2433,2460,2447,16,3,76,186.04,500
,20160815,2460,2447,2432,2441,2378,2422,2416,-25,-31,136,328.71,580
,20160816,2422,2416,2425,2530,2421,2502,2475,86,59,256,633.69,644
,20160817,2502,2475,2516,2526,2480,2480,2513,5,38,84,211.12,682
,20160818,2480,2513,2479,2505,2462,2468,2479,-45,-34,80,198.40,694
,20160819,2468,2479,2479,2507,2459,2507,2484,28,5,14,34.79,694
,20160822,2507,2484,2520,2541,2507,2510,2517,26,33,64,161.10,688
,20160823,2510,2517,2495,2564,2495,2564,2534,47,17,92,233.15,724
,20160824,2564,2534,2558,2601,2550,2550,2582,16,48,238,614.57,668
,20160825,2550,2582,2576,2603,2502,2544,2537,-38,-45,130,329.82,696
,20160826,2544,2537,2531,2544,2486,2486,2511,-51,-26,96,241.10,708
,20160829,2486,2511,2470,2499,2432,2443,2458,-68,-53,86,211.46,726
,20160830,2443,2458,2449,2449,2391,2391,2406,-67,-52,224,538.96,680
,20160831,2391,2406,2405,2411,2358,2358,2379,-48,-27,140,333.15,712
,20160901,2358,2379,2356,2370,2326,2369,2344,-10,-35,76,178.17,744
,20160902,2369,2344,2380,2420,2358,2358,2393,14,49,124,296.77,788
,20160905,2358,2393,2380,2422,2380,2396,2403,3,10,168,403.71,778
,20160906,2396,2403,2391,2423,2383,2383,2392,-20,-11,76,181.79,802
,20160907,2383,2392,2388,2394,2303,2312,2348,-80,-44,178,418.05,856
,20160908,2312,2348,2296,2329,2296,2313,2313,-35,-35,38,87.93,858
,20160909,2313,2313,2316,2328,2290,2319,2303,6,-10,144,331.67,892
,20160912,2319,2303,2322,2347,2265,2265,2294,-38,-9,114,261.55,910
,20160913,2265,2294,2265,2282,2238,2238,2258,-56,-36,64,144.52,920
,20160914,2238,2258,2252,2258,2236,2236,2241,-22,-17,22,49.32,914
,20160919,2236,2241,2237,2244,2230,2244,2236,3,-5,26,58.14,914
,20160920,2244,2236,2254,2284,2254,2271,2268,35,32,62,140.64,922
,20160921,2271,2268,2263,2288,2260,2274,2277,6,9,106,241.45,1010
,20160922,2274,2277,2279,2351,2279,2325,2325,48,48,232,539.41,1090
,20160923,2325,2325,2317,2334,2317,2325,2323,0,-2,22,51.12,1086
,20160926,2325,2323,2342,2366,2331,2340,2344,17,21,50,117.21,1072
,20160927,2340,2344,2332,2336,2296,2300,2326,-44,-18,50,116.34,1114
,20160928,2300,2326,2293,2322,2293,2316,2308,-10,-18,22,50.78,1126
,20160929,2316,2308,2301,2353,2301,2310,2329,2,21,586,"1,365.28",1294
,20160930,2310,2329,2318,2318,2294,2294,2302,-35,-27,14,32.24,1290
,20161010,2294,2302,2267,2298,2267,2298,2284,-4,-18,10,22.85,1290
,20161011,2298,2284,2313,2353,2313,2353,2333,69,49,96,223.98,1302
,20161012,2353,2333,2357,2365,2334,2349,2347,16,14,258,605.73,1394
,20161013,2349,2347,2365,2365,2364,2364,2364,17,17,4,9.46,1390
,20161014,2364,2364,2385,2408,2385,2408,2391,44,27,32,76.52,1374
,20161017,2408,2391,2405,2450,2396,2428,2425,37,34,216,523.97,1344
,20161018,2428,2425,2430,2433,2406,2429,2414,4,-11,170,410.38,1476
,20161019,2429,2414,2448,2490,2428,2428,2469,14,55,96,237.05,1476
,20161020,2428,2469,2429,2474,2429,2454,2451,-15,-18,38,93.16,1486
,20161021,2454,2451,2436,2462,2406,2436,2429,-15,-22,26,63.18,1490
,20161024,2436,2429,2409,2442,2408,2442,2426,13,-3,14,33.97,1482
,20161025,2442,2426,2448,2548,2448,2543,2506,117,80,242,606.49,1330
,20161026,2543,2506,2533,2561,2499,2513,2515,7,9,38,95.60,1308
,20161027,2513,2515,2513,2513,2483,2508,2505,-7,-10,14,35.07,1302
,20161028,2508,2505,2517,2540,2517,2540,2528,35,23,40,101.13,1296
,20161031,2540,2528,2592,2610,2557,2605,2591,77,63,26,67.39,1300
,20161101,2605,2591,2620,2625,2596,2614,2599,23,8,564,"1,466.31",1058
,20161102,2614,2599,2611,2626,2580,2583,2606,-16,7,30,78.19,1054
,20161103,2583,2606,2582,2628,2582,2627,2620,21,14,292,765.26,1150
,20161104,2627,2620,2665,2689,2630,2656,2683,36,63,152,407.86,1040
,20161107,2656,2683,2678,2843,2678,2806,2800,123,117,94,263.28,1042
,20161108,2806,2800,2833,2843,2727,2770,2815,-30,15,222,625.05,1050
,20161109,2770,2815,2752,2949,2724,2939,2888,124,73,266,768.35,1100
,20161110,2939,2888,2938,3059,2938,2990,2985,102,97,44,131.38,1102
,20161111,2990,2985,2999,3102,2939,3095,3028,110,43,110,333.12,1094
,20161114,3095,3028,3118,3202,2901,2901,2991,-127,-37,216,646.22,1092
,20161115,2901,2991,2929,2983,2811,2811,2904,-180,-87,174,505.41,1100
,20161116,2811,2904,2797,2827,2729,2789,2769,-115,-135,456,"1,262.99",1104
,20161117,2789,2769,2821,2821,2725,2785,2760,16,-9,280,773.00,1128
,20161118,2785,2760,2814,2814,2740,2770,2771,10,11,88,243.93,1120
,20161121,2770,2771,2768,2768,2681,2739,2731,-32,-40,264,721.17,1196
,20161122,2739,2731,2738,2894,2731,2894,2838,163,107,162,459.85,1112
,20161123,2894,2838,2887,2982,2887,2934,2933,96,95,190,557.45,1158
,20161124,2934,2933,2963,3060,2923,3015,3010,82,77,330,993.31,1148
,20161125,3015,3010,3001,3220,3001,3207,3134,197,124,46,144.18,1130
,20161128,3207,3134,3188,3301,3112,3294,3186,160,52,262,834.94,1096
,20161129,3294,3186,3274,3285,3019,3019,3109,-167,-77,218,677.86,1084
,20161130,3019,3109,2992,3017,2891,2891,2940,-218,-169,172,505.81,1154
,20161201,2891,2940,2936,3144,2895,3125,2981,185,41,378,"1,126.92",1162
,20161202,3125,2981,3135,3144,2955,3040,3046,59,65,202,615.33,1154
,20161205,3040,3046,3023,3158,3015,3140,3079,94,33,198,609.77,1158
,20161206,3140,3079,3134,3190,3134,3145,3151,66,72,66,208.02,1154
,20161207,3145,3151,3183,3350,3178,3325,3260,174,109,150,489.03,1158
,20161208,3325,3260,3323,3345,3245,3318,3309,58,49,86,284.59,1170
,20161209,3318,3309,3337,3337,3190,3296,3234,-13,-75,96,310.51,1154
,20161212,3296,3234,3339,3458,3339,3385,3414,151,180,140,477.98,1186
,20161213,3385,3414,3395,3421,3388,3410,3403,-4,-11,48,163.38,1194
,20161214,3410,3403,3389,3410,3277,3325,3285,-78,-118,644,"2,115.73",1178
,20161215,3325,3285,3275,3365,3250,3349,3294,64,9,42,138.38,1174
,20161216,3349,3294,3312,3312,3238,3238,3274,-56,-20,24,78.60,1178
,20161219,3238,3274,3219,3229,3110,3110,3183,-164,-91,176,560.25,1164
,20161220,3110,3183,3106,3106,3077,3103,3092,-80,-91,46,142.24,1156
,20161221,3103,3092,3131,3131,3041,3090,3078,-2,-14,82,252.47,1152
,20161222,3090,3078,3080,3084,2977,2977,3028,-101,-50,84,254.43,1172
,20161223,2977,3028,2954,2997,2916,2941,2956,-87,-72,52,153.74,1178
,20161226,2941,2956,2937,2961,2802,2849,2847,-107,-109,152,432.89,1124
,20161227,2849,2847,2871,2955,2845,2955,2899,108,52,218,632.06,1214
,20161228,2955,2899,3001,3049,2925,2986,2973,87,74,164,487.67,1248
,20161229,2986,2973,2920,2964,2895,2920,2915,-53,-58,26,75.81,1254
,20161230,2920,2915,2909,2909,2845,2865,2869,-50,-46,46,132.01,1262
rb1708,20160816,2416,2416,2420,2502,2420,2502,2465,86,49,6,14.79,6
,20160817,2502,2465,2490,2523,2488,2488,2503,23,38,18,45.07,18
,20160818,2488,2503,2480,2507,2480,2507,2498,4,-5,10,24.98,22
,20160819,2507,2498,2489,2517,2468,2517,2491,19,-7,44,109.64,32
,20160822,2517,2491,2523,2550,2499,2525,2528,34,37,66,166.87,60
,20160823,2525,2528,2525,2582,2494,2567,2543,39,15,30,76.31,70
,20160824,2567,2543,2576,2599,2563,2563,2583,20,40,18,46.50,74
,20160825,2563,2583,2598,2610,2501,2552,2557,-31,-26,46,117.63,72
,20160826,2552,2557,2556,2556,2530,2530,2545,-27,-12,12,30.54,70
,20160829,2530,2545,2478,2487,2452,2452,2468,-93,-77,56,138.26,92
,20160830,2452,2468,2454,2454,2418,2418,2438,-50,-30,16,39.02,100
,20160831,2418,2438,2413,2424,2370,2370,2394,-68,-44,40,95.79,118
,20160901,2370,2394,2369,2390,2346,2390,2361,-4,-33,56,132.23,130
,20160902,2390,2361,2368,2429,2368,2404,2398,43,37,26,62.36,136
,20160905,2404,2398,2399,2437,2399,2421,2426,23,28,24,58.23,136
,20160906,2421,2426,,,,2410,2410,-16,-16,0,0.00,136
,20160907,2410,2410,2388,2394,2321,2326,2358,-84,-52,62,146.20,152
,20160908,2326,2358,2336,2338,2312,2336,2328,-22,-30,44,102.45,160
,20160909,2336,2328,2317,2317,2317,2317,2317,-11,-11,2,4.63,158
,20160912,2317,2317,2338,2338,2271,2280,2295,-37,-22,84,192.81,230
,20160913,2280,2295,2277,2299,2260,2260,2281,-35,-14,36,82.12,244
,20160914,2260,2281,2258,2277,2258,2268,2269,-13,-12,30,68.08,244
,20160919,2268,2269,2264,2278,2263,2278,2265,9,-4,16,36.25,254
,20160920,2278,2265,2279,2311,2276,2300,2291,35,26,94,215.40,284
,20160921,2300,2291,2293,2300,2281,2300,2288,9,-3,48,109.83,288
,20160922,2300,2288,2300,2371,2300,2342,2353,54,65,50,117.65,256
,20160923,2342,2353,2340,2357,2338,2338,2343,-15,-10,14,32.81,256
,20160926,2338,2343,2357,2383,2357,2362,2363,19,20,24,56.73,254
,20160927,2362,2363,2349,2358,2300,2315,2313,-48,-50,50,115.69,234
,20160928,2315,2313,2283,2314,2283,2312,2294,-1,-19,54,123.92,218
,20160929,2312,2294,2344,2364,2340,2340,2350,46,56,78,183.31,214
,20160930,2340,2350,2301,2308,2300,2305,2304,-45,-46,50,115.20,254
,20161010,2305,2304,2293,2318,2291,2318,2305,14,1,10,23.06,248
,20161011,2318,2305,2327,2368,2327,2368,2344,63,39,68,159.42,210
,20161012,2368,2344,2372,2372,2355,2355,2368,11,24,10,23.69,212
,20161013,2355,2368,2383,2383,2362,2362,2373,-6,5,16,37.98,212
,20161014,2362,2373,2376,2408,2376,2408,2392,35,19,18,43.07,208
,20161017,2408,2392,2411,2455,2406,2450,2429,58,37,82,199.23,168
,20161018,2450,2429,2433,2438,2419,2436,2428,7,-1,20,48.57,164
,20161019,2436,2428,2470,2480,2430,2430,2465,2,37,54,133.11,152
,20161020,2430,2465,2470,2470,2436,2461,2454,-4,-11,24,58.90,154
,20161021,2461,2454,2479,2490,2440,2444,2461,-10,7,26,63.99,160
,20161024,2444,2461,2431,2455,2406,2455,2437,-6,-24,32,78.00,164
,20161025,2455,2437,2474,2536,2466,2531,2491,94,54,46,114.60,162
,20161026,2531,2491,2562,2571,2522,2522,2549,31,58,10,25.49,158
,20161027,2522,2549,2522,2522,2505,2521,2517,-28,-32,16,40.27,152
,20161028,2521,2517,2527,2580,2527,2580,2561,63,44,12,30.73,152
,20161031,2580,2561,2573,2620,2550,2620,2590,59,29,66,170.94,194
,20161101,2620,2590,2637,2637,2570,2620,2612,30,22,50,130.62,180
,20161102,2620,2612,2634,2650,2598,2622,2631,10,19,112,294.71,174
,20161103,2622,2631,2610,2636,2610,2626,2625,-5,-6,46,120.78,176
,20161104,2626,2625,2666,2674,2657,2658,2665,33,40,30,79.97,188
,20161107,2658,2665,2662,2824,2662,2800,2756,135,91,36,99.22,184
,20161108,2800,2756,2829,2841,2745,2776,2788,20,32,164,457.32,210
,20161109,2776,2788,2754,2955,2754,2932,2848,144,60,114,324.78,178
,20161110,2932,2848,2938,3018,2925,2972,2983,124,135,66,196.88,188
,20161111,2972,2983,2983,3075,2975,3057,3030,74,47,38,115.18,188
,20161114,3057,3030,3126,3185,2873,2922,3047,-108,17,242,737.43,188
,20161115,2922,3047,2965,2994,2864,2864,2929,-183,-118,68,199.23,170
,20161116,2864,2929,2821,2839,2746,2828,2814,-101,-115,48,135.10,160
,20161117,2828,2814,2849,2849,2787,2810,2813,-4,-1,16,45.01,162
,20161118,2810,2813,2770,2770,2760,2760,2766,-53,-47,6,16.60,160
,20161121,2760,2766,2753,2765,2721,2730,2747,-36,-19,24,65.94,172
,20161122,2730,2747,2754,2911,2744,2910,2875,163,128,90,258.83,166
,20161123,2910,2875,2935,2979,2917,2929,2936,54,61,30,88.10,170
,20161124,2929,2936,2935,3056,2930,3019,3009,83,73,76,228.73,158
,20161125,3019,3009,2995,3214,2995,3214,3148,205,139,24,75.57,160
,20161128,3214,3148,3196,3319,3185,3288,3255,140,107,36,117.18,158
,20161129,3288,3255,3239,3272,3040,3040,3163,-215,-92,24,75.93,156
,20161130,3040,3163,3049,3049,2941,2979,2973,-184,-190,28,83.26,166
,20161201,2979,2973,2978,3130,2955,3130,3012,157,39,30,90.38,166
,20161202,3130,3012,3130,3203,2970,2999,3086,-13,74,94,290.13,162
,20161205,2999,3086,3169,3169,3169,3169,3169,83,83,2,6.34,164
,20161206,3169,3169,3173,3180,3127,3152,3145,-17,-24,418,"1,314.71",164
,20161207,3152,3145,3196,3360,3196,3360,3327,215,182,48,159.70,154
,20161208,3360,3327,3342,3342,3255,3300,3278,-27,-49,18,59.01,158
,20161209,3300,3278,3198,3280,3198,3265,3238,-13,-40,18,58.29,162
,20161212,3265,3238,3302,3449,3267,3423,3377,185,139,82,276.93,178
,20161213,3423,3377,3400,3438,3383,3426,3412,49,35,38,129.66,174
,20161214,3426,3412,3340,3392,3267,3311,3324,-101,-88,44,146.26,174
,20161215,3311,3324,3255,3353,3211,3340,3290,16,-34,30,98.72,174
,20161216,3340,3290,3257,3257,3257,3257,3257,-33,-33,2,6.51,174
,20161219,3257,3257,3256,3256,3083,3083,3198,-174,-59,50,159.94,192
,20161220,3083,3198,3094,3158,3094,3097,3115,-101,-83,42,130.87,180
,20161221,3097,3115,3152,3178,3103,3133,3137,18,22,16,50.20,178
,20161222,3133,3137,3129,3129,3026,3026,3067,-111,-70,8,24.54,174
,20161223,3026,3067,2966,2976,2942,2976,2968,-91,-99,16,47.49,172
,20161226,2976,2968,2937,2982,2816,2881,2870,-87,-98,16,45.92,170
,20161227,2881,2870,2895,2962,2854,2957,2923,87,53,26,76.02,184
,20161228,2957,2923,2956,2995,2933,2952,2965,29,42,24,71.17,180
,20161229,2952,2965,2894,2900,2859,2859,2889,-106,-76,30,86.68,178
,20161230,2859,2889,2915,2930,2841,2841,2867,-48,-22,50,143.40,180
rb1709,20160920,2265,2265,2267,2313,2267,2298,2293,33,28,60,137.58,38
,20160921,2298,2293,2291,2306,2285,2290,2294,-3,1,66,151.43,78
,20160922,2290,2294,2301,2380,2301,2337,2334,43,40,90,210.10,120
,20160923,2337,2334,2364,2375,2335,2350,2346,16,12,94,220.54,156
,20160926,2350,2346,2365,2385,2358,2368,2368,22,22,128,303.15,142
,20160927,2368,2368,2356,2356,2306,2325,2330,-43,-38,106,247.06,156
,20160928,2325,2330,2314,2338,2309,2338,2326,8,-4,34,79.09,166
,20160929,2338,2326,2341,2384,2327,2327,2361,1,35,126,297.61,170
,20160930,2327,2361,2330,2350,2301,2312,2317,-49,-44,118,273.50,204
,20161010,2312,2317,2282,2345,2259,2323,2297,6,-20,226,519.14,268
,20161011,2323,2297,2330,2377,2311,2366,2357,69,60,272,641.25,392
,20161012,2366,2357,2385,2385,2354,2376,2369,19,12,340,805.79,484
,20161013,2376,2369,2373,2395,2366,2380,2375,11,6,226,536.87,534
,20161014,2380,2375,2377,2433,2353,2427,2391,52,16,214,511.77,538
,20161017,2427,2391,2443,2467,2412,2456,2444,65,53,400,977.83,662
,20161018,2456,2444,2439,2447,2420,2439,2432,-5,-12,336,817.49,742
,20161019,2439,2432,2453,2506,2430,2437,2469,5,37,428,"1,056.84",882
,20161020,2437,2469,2440,2479,2440,2472,2466,3,-3,446,"1,100.02",1002
,20161021,2472,2466,2473,2476,2414,2441,2430,-25,-36,680,"1,652.48",1248
,20161024,2441,2430,2444,2462,2416,2459,2443,29,13,382,933.37,1382
,20161025,2459,2443,2467,2557,2464,2548,2516,105,73,648,"1,630.79",1394
,20161026,2548,2516,2545,2574,2506,2520,2538,4,22,590,"1,497.94",1302
,20161027,2520,2538,2522,2542,2510,2530,2526,-8,-12,660,"1,667.17",1320
,20161028,2530,2526,2534,2603,2531,2603,2561,77,35,760,"1,946.88",1600
,20161031,2603,2561,2604,2630,2571,2627,2598,66,37,904,"2,349.16",1476
,20161101,2627,2598,2628,2645,2595,2640,2635,42,37,920,"2,424.46",1930
,20161102,2640,2635,2631,2650,2596,2604,2634,-31,-1,794,"2,091.61",1750
,20161103,2604,2634,2604,2650,2598,2650,2627,16,-7,748,"1,965.13",1950
,20161104,2650,2627,2658,2684,2637,2662,2663,35,36,990,"2,636.60",1922
,20161107,2662,2663,2636,2822,2636,2815,2753,152,90,1198,"3,298.61",1958
,20161108,2815,2753,2815,2850,2743,2781,2807,28,54,694,"1,948.39",1930
,20161109,2781,2807,2762,2975,2756,2964,2899,157,92,726,"2,104.86",2042
,20161110,2964,2899,2966,3072,2945,2989,3008,90,109,1402,"4,218.34",2102
,20161111,2989,3008,2958,3140,2935,3130,3048,122,40,1400,"4,267.39",2066
,20161114,3130,3048,3144,3222,2960,2992,3056,-56,8,2730,"8,345.31",1684
,20161115,2992,3056,2976,3043,2872,2872,2949,-184,-107,738,"2,176.51",1668
,20161116,2872,2949,2850,2880,2772,2846,2817,-103,-132,1408,"3,967.13",1816
,20161117,2846,2817,2871,2872,2791,2848,2819,31,2,722,"2,035.86",1854
,20161118,2848,2819,2873,2879,2787,2802,2824,-17,5,412,"1,163.77",1918
,20161121,2802,2824,2800,2805,2720,2751,2760,-73,-64,650,"1,794.23",2034
,20161122,2751,2760,2760,2925,2759,2925,2860,165,100,894,"2,557.54",1982
,20161123,2925,2860,2930,3021,2920,3000,2966,140,106,664,"1,969.43",2050
,20161124,3000,2966,2960,3101,2938,3040,3032,74,66,988,"2,995.91",1984
,20161125,3040,3032,3017,3244,3017,3244,3164,212,132,870,"2,752.68",2104
,20161128,3244,3164,3250,3350,3171,3325,3274,161,110,3506,"11,481.47",2656
,20161129,3325,3274,3300,3333,3062,3062,3215,-212,-59,1180,"3,794.40",2576
,20161130,3062,3215,3061,3072,2989,2989,3035,-226,-180,1126,"3,417.42",2556
,20161201,2989,3035,2966,3184,2906,3161,3037,126,2,3474,"10,552.49",2682
,20161202,3161,3037,3198,3202,3000,3098,3083,61,46,2050,"6,320.60",2836
,20161205,3098,3083,3085,3204,3035,3172,3120,89,37,1064,"3,319.71",2822
,20161206,3172,3120,3194,3232,3163,3192,3193,72,73,1156,"3,691.56",2826
,20161207,3192,3193,3196,3388,3191,3352,3312,159,119,810,"2,683.44",2772
,20161208,3352,3312,3351,3385,3266,3355,3311,43,-1,876,"2,901.07",2640
,20161209,3355,3311,3340,3352,3200,3303,3267,-8,-44,884,"2,888.46",2724
,20161212,3303,3267,3330,3490,3280,3387,3394,120,127,1542,"5,234.07",2950
,20161213,3387,3394,3404,3440,3368,3440,3409,46,15,486,"1,657.20",2924
,20161214,3440,3409,3426,3430,3280,3325,3342,-84,-67,1102,"3,683.07",2964
,20161215,3325,3342,3317,3380,3254,3353,3322,11,-20,684,"2,272.32",3042
,20161216,3353,3322,3326,3351,3250,3261,3310,-61,-12,630,"2,085.76",2924
,20161219,3261,3310,3289,3289,3149,3149,3216,-161,-94,738,"2,374.05",2952
,20161220,3149,3216,3114,3151,3088,3121,3122,-95,-94,676,"2,110.68",2888
,20161221,3121,3122,3144,3158,3061,3136,3118,14,-4,730,"2,276.64",2826
,20161222,3136,3118,3128,3131,2988,2998,3073,-120,-45,504,"1,548.92",2832
,20161223,2998,3073,2991,3024,2936,2938,2977,-135,-96,1126,"3,352.26",2722
,20161226,2938,2977,2950,2980,2828,2905,2902,-72,-75,684,"1,985.38",2766
,20161227,2905,2902,2914,2962,2863,2960,2898,58,-4,1778,"5,154.07",3394
,20161228,2960,2898,2970,3030,2931,2947,2976,49,78,1076,"3,202.62",3652
,20161229,2947,2976,2923,2954,2886,2926,2914,-50,-62,1912,"5,572.82",3024
,20161230,2926,2914,2910,2933,2849,2853,2887,-61,-27,984,"2,840.89",3110
rb1710,20161018,2444,2444,2435,2440,2398,2430,2420,-14,-24,8852,"21,428.68",5446
,20161019,2430,2420,2440,2497,2406,2423,2449,3,29,15166,"37,143.95",11842
,20161020,2423,2449,2425,2457,2424,2447,2441,-2,-8,10394,"25,381.86",14932
,20161021,2447,2441,2448,2457,2384,2423,2412,-18,-29,12606,"30,416.23",18472
,20161024,2423,2412,2423,2433,2388,2430,2412,18,0,13246,"31,949.56",22842
,20161025,2430,2412,2432,2539,2432,2528,2495,116,83,19964,"49,817.26",27576
,20161026,2528,2495,2534,2561,2493,2510,2521,15,26,25220,"63,595.09",31238
,20161027,2510,2521,2511,2537,2503,2522,2521,1,0,27458,"69,247.61",41210
,20161028,2522,2521,2526,2593,2515,2588,2554,67,33,16306,"41,650.32",41738
,20161031,2588,2554,2590,2625,2566,2624,2589,70,35,32336,"83,733.36",46812
,20161101,2624,2589,2624,2638,2587,2609,2620,20,31,24670,"64,649.84",46402
,20161102,2609,2620,2608,2643,2581,2595,2616,-25,-4,27920,"73,063.05",50354
,20161103,2595,2616,2613,2645,2587,2640,2614,24,-2,23244,"60,769.80",50812
,20161104,2640,2614,2640,2678,2630,2640,2653,26,39,50042,"132,783.52",47100
,20161107,2640,2653,2652,2812,2629,2791,2719,138,66,51128,"139,034.63",53050
,20161108,2791,2719,2789,2824,2712,2744,2778,25,59,39994,"111,136.01",54504
,20161109,2744,2778,2744,2944,2724,2938,2885,160,107,62390,"180,052.76",59276
,20161110,2938,2885,2956,3052,2906,2968,2977,83,92,87678,"261,018.22",53428
,20161111,2968,2977,2982,3114,2965,3101,3038,124,61,79544,"241,699.51",55824
,20161114,3101,3038,3100,3196,2941,2982,3068,-56,30,119374,"366,300.86",48938
,20161115,2982,3068,2994,3038,2883,2883,2967,-185,-101,45174,"134,033.63",49244
,20161116,2883,2967,2845,2863,2749,2841,2819,-126,-148,68916,"194,336.52",50568
,20161117,2841,2819,2844,2866,2785,2844,2822,25,3,58704,"165,694.93",51162
,20161118,2844,2822,2848,2870,2773,2784,2813,-38,-9,68766,"193,445.79",56826
,20161121,2784,2813,2796,2803,2698,2742,2753,-71,-60,61126,"168,287.44",61516
,20161122,2742,2753,2749,2918,2742,2918,2856,165,103,83738,"239,219.10",65034
,20161123,2918,2856,2922,3003,2900,2984,2950,128,94,95544,"281,941.73",68172
,20161124,2984,2950,2989,3090,2924,3018,3020,68,70,116672,"352,464.20",64998
,20161125,3018,3020,3015,3231,2991,3231,3126,211,106,110574,"345,736.32",70602
,20161128,3231,3126,3228,3338,3170,3308,3267,182,141,125130,"408,830.48",68556
,20161129,3308,3267,3281,3317,3047,3050,3207,-217,-60,132706,"425,634.56",66706
,20161130,3050,3207,3050,3070,2982,2982,3026,-225,-181,77438,"234,341.13",66454
,20161201,2982,3026,2981,3191,2953,3159,3076,133,50,180836,"556,322.39",74084
,20161202,3159,3076,3174,3198,2984,3087,3099,11,23,172918,"535,981.58",89558
,20161205,3087,3099,3090,3193,3020,3168,3110,69,11,145488,"452,604.55",91338
,20161206,3168,3110,3170,3228,3149,3183,3184,73,74,102636,"326,807.44",93172
,20161207,3183,3184,3183,3385,3182,3343,3303,159,119,145702,"481,299.43",103786
,20161208,3343,3303,3345,3378,3256,3352,3324,49,21,127048,"422,396.00",104080
,20161209,3352,3324,3354,3367,3182,3298,3277,-26,-47,170246,"558,061.16",113512
,20161212,3298,3277,3315,3488,3260,3380,3390,103,113,178822,"606,221.16",127062
,20161213,3380,3390,3384,3437,3357,3435,3402,45,12,105070,"357,491.89",133408
,20161214,3435,3402,3430,3430,3267,3309,3345,-93,-57,157550,"527,144.77",137406
,20161215,3309,3345,3309,3378,3240,3349,3304,4,-41,174636,"577,164.76",141180
,20161216,3349,3304,3320,3342,3230,3234,3300,-70,-4,139978,"461,999.80",139778
,20161219,3234,3300,3222,3242,3116,3120,3197,-180,-103,147944,"473,003.37",142430
,20161220,3120,3197,3115,3137,3071,3111,3108,-86,-89,160744,"499,666.73",139236
,20161221,3111,3108,3110,3148,3041,3117,3106,9,-2,148642,"461,718.59",136404
,20161222,3117,3106,3115,3123,2977,2977,3057,-129,-49,166616,"509,354.02",153152
,20161223,2977,3057,2973,3015,2923,2943,2964,-114,-93,179444,"531,895.05",157764
,20161226,2943,2964,2934,2970,2818,2887,2882,-77,-82,260306,"750,391.24",175036
,20161227,2887,2882,2893,2961,2848,2960,2896,78,14,185552,"537,503.50",170298
,20161228,2960,2896,2960,3021,2924,2937,2967,41,71,224642,"666,676.65",179894
,20161229,2937,2967,2947,2947,2866,2909,2903,-58,-64,229358,"665,929.70",191774
,20161230,2909,2903,2905,2925,2831,2831,2870,-72,-33,169188,"485,602.43",197362
rb1711,20161116,2967,2967,2905,2907,2746,2797,2826,-170,-141,58,163.96,32
,20161117,2797,2826,2845,2845,2778,2814,2825,-12,-1,292,824.93,90
,20161118,2814,2825,2854,2854,2772,2780,2794,-45,-31,120,335.31,158
,20161121,2780,2794,2777,2777,2699,2742,2747,-52,-47,72,197.81,170
,20161122,2742,2747,2753,2911,2743,2900,2871,153,124,174,499.59,216
,20161123,2900,2871,2914,2981,2909,2974,2934,103,63,50,146.70,240
,20161124,2974,2934,2935,3070,2916,3044,3017,110,83,62,187.09,228
,20161125,3044,3017,3033,3228,3033,3228,3176,211,159,14,44.48,228
,20161128,3228,3176,3220,3317,3173,3300,3235,124,59,444,"1,436.45",550
,20161129,3300,3235,3292,3451,3081,3088,3213,-147,-22,470,"1,510.19",332
,20161130,3088,3213,3045,3045,2988,2988,3006,-225,-207,114,342.73,330
,20161201,2988,3006,2955,3159,2912,3135,3029,129,23,102,309.06,330
,20161202,3135,3029,3161,3165,2976,3028,3095,-1,66,44,136.18,334
,20161205,3028,3095,3028,3140,3028,3140,3106,45,11,36,111.83,338
,20161206,3140,3106,3149,3190,3141,3141,3174,35,68,38,120.61,344
,20161207,3141,3174,3234,3331,3234,3328,3285,154,111,56,183.96,352
,20161208,3328,3285,3332,3335,3239,3325,3294,40,9,38,125.20,354
,20161209,3325,3294,3335,3335,3173,3270,3241,-24,-53,50,162.05,342
,20161212,3270,3241,3315,3457,3273,3373,3351,132,110,176,589.84,418
,20161213,3373,3351,3407,3407,3367,3388,3377,37,26,102,344.54,476
,20161214,3388,3377,3393,3403,3293,3327,3309,-50,-68,198,655.30,634
,20161215,3327,3309,3270,3300,3249,3300,3262,-9,-47,46,150.08,672
,20161216,3300,3262,3310,3322,3230,3230,3272,-32,10,68,222.54,716
,20161219,3230,3272,3198,3216,3163,3166,3186,-106,-86,250,796.51,830
,20161220,3166,3186,3110,3118,3077,3077,3094,-109,-92,360,"1,113.86",1080
,20161221,3077,3094,3134,3139,3037,3091,3106,-3,12,240,745.57,1138
,20161222,3091,3106,3107,3122,2980,2980,3039,-126,-67,380,"1,155.13",1258
,20161223,2980,3039,2964,3001,2927,2934,2961,-105,-78,114,337.65,1282
,20161226,2934,2961,2930,2952,2796,2800,2846,-161,-115,582,"1,656.88",1066
,20161227,2800,2846,2880,2910,2835,2903,2877,57,31,42,120.86,1058
,20161228,2903,2877,2938,3033,2905,2937,2958,60,81,100,295.89,1048
,20161229,2937,2958,2874,2904,2856,2904,2888,-54,-70,54,155.96,1064
,20161230,2904,2888,2885,2897,2822,2828,2859,-60,-29,58,165.83,1074
rb1712,20161216,3262,3262,3256,3256,3256,3256,3256,-6,-6,2,6.51,2
,20161219,3256,3256,3213,3224,3112,3112,3172,-144,-84,10,31.73,8
,20161220,3112,3172,3077,3117,3068,3117,3088,-55,-84,34,105.00,32
,20161221,3117,3088,3138,3138,3070,3108,3089,20,1,18,55.62,46
,20161222,3108,3089,3104,3104,2989,2989,3046,-100,-43,48,146.21,86
,20161223,2989,3046,2984,2985,2952,2952,2971,-94,-75,80,237.71,108
,20161226,2952,2971,2896,2896,2829,2867,2842,-104,-129,40,113.70,134
,20161227,2867,2842,2898,2922,2848,2922,2895,80,53,50,144.77,176
,20161228,2922,2895,2948,3005,2948,2985,2972,90,77,12,35.66,176
,20161229,2985,2972,2880,2911,2871,2879,2894,-93,-78,24,69.46,186
,20161230,2879,2894,2895,2895,2844,2848,2855,-46,-39,42,119.94,210
ru1601,20160104,11410,11510,11445,11475,11200,11235,11335,-275,-175,3692,"41,852.68",18344
,20160105,11235,11335,11235,11245,10820,10930,10980,-405,-355,4168,"45,771.23",16772
,20160106,10930,10980,10910,10965,10320,10320,10545,-660,-435,7842,"82,698.80",12610
,20160107,10320,10545,10225,10255,9800,9880,9895,-665,-650,7354,"72,800.13",9968
,20160108,9880,9895,9920,9920,9750,9820,9850,-75,-45,3072,"30,263.48",8412
,20160111,9820,9850,9775,9890,9470,9470,9620,-380,-230,6514,"62,690.22",8060
,20160112,9470,9620,9550,9550,9255,9300,9400,-320,-220,1782,"16,756.76",7436
,20160113,9300,9400,9410,9580,9410,9560,9525,160,125,990,"9,430.88",7110
,20160114,9560,9525,9585,9650,9430,9600,9540,75,15,864,"8,242.60",6912
,20160115,9600,9540,9540,9750,9445,9465,9565,-75,25,624,"5,969.78",6884
ru1603,20160104,10705,10695,10695,10695,10180,10180,10375,-515,-320,188,"1,950.77",328
,20160105,10180,10375,10225,10295,10140,10185,10205,-190,-170,224,"2,286.32",214
,20160106,10185,10205,10185,10185,10050,10050,10090,-155,-115,70,706.45,230
,20160107,10050,10090,10010,10010,9875,9955,9955,-135,-135,114,"1,134.99",282
,20160108,9955,9955,9850,10095,9805,9995,9960,40,5,208,"2,072.52",356
,20160111,9995,9960,10000,10000,9590,9590,9770,-370,-190,254,"2,482.47",414
,20160112,9590,9770,9680,9690,9520,9540,9600,-230,-170,234,"2,247.08",436
,20160113,9540,9600,9650,9800,9650,9735,9730,135,130,316,"3,075.86",406
,20160114,9735,9730,9735,9800,9610,9775,9740,45,10,164,"1,597.56",442
,20160115,9775,9740,9780,9870,9645,9680,9770,-60,30,248,"2,423.31",422
,20160118,9680,9770,9640,9985,9640,9985,9895,215,125,126,"1,246.83",424
,20160119,9985,9895,10020,10200,9910,10185,10085,290,190,176,"1,775.60",524
,20160120,10185,10085,10195,10220,10060,10150,10130,65,45,300,"3,039.33",494
,20160121,10150,10130,10125,10180,10040,10055,10115,-75,-15,72,728.31,474
,20160122,10055,10115,10150,10250,10150,10250,10220,135,105,406,"4,149.86",654
,20160125,10250,10220,10245,10370,9970,10150,10195,-70,-25,366,"3,732.35",764
,20160126,10150,10195,10145,10155,10065,10075,10120,-120,-75,382,"3,866.33",524
,20160127,10075,10120,10105,10280,10105,10280,10205,160,85,238,"2,429.74",602
,20160128,10280,10205,10245,10270,10085,10085,10130,-120,-75,234,"2,370.61",556
,20160129,10085,10130,10100,10190,10065,10115,10105,-15,-25,164,"1,657.66",614
,20160201,10115,10105,10160,10200,10080,10115,10155,10,50,168,"1,706.36",652
,20160202,10115,10155,10075,10150,10000,10065,10070,-90,-85,140,"1,410.11",688
,20160203,10065,10070,10080,10110,9900,9930,10005,-140,-65,80,800.46,696
,20160204,9930,10005,10055,10290,9700,10020,10165,15,160,276,"2,806.81",684
,20160205,10020,10165,10150,10150,9975,9975,10055,-190,-110,94,945.55,684
,20160215,9975,10055,10000,10395,10000,10290,10260,235,205,192,"1,970.17",732
,20160216,10290,10260,10480,10480,10280,10360,10320,100,60,32,330.29,748
,20160217,10360,10320,10335,10395,10000,10000,10240,-320,-80,56,573.67,768
,20160218,10000,10240,10270,10415,10110,10110,10315,-130,75,100,"1,031.60",790
,20160219,10110,10315,10285,10400,10235,10400,10280,85,-35,382,"3,927.49",818
,20160222,10400,10280,10430,10590,10400,10445,10495,165,215,242,"2,540.09",896
,20160223,10445,10495,10465,10560,10360,10360,10480,-135,-15,362,"3,793.99",1046
,20160224,10360,10480,10450,10475,10305,10305,10430,-175,-50,178,"1,856.61",1062
,20160225,10305,10430,10430,10575,10240,10240,10475,-190,45,170,"1,781.02",1138
,20160226,10240,10475,10350,10350,10045,10100,10210,-375,-265,612,"6,249.49",1180
,20160229,10100,10210,10150,10240,10065,10065,10135,-145,-75,218,"2,209.85",1136
,20160301,10065,10135,10070,10210,10040,10100,10085,-35,-50,74,746.54,1110
,20160302,10100,10085,10250,10445,10250,10375,10350,290,265,94,973.22,1182
,20160303,10375,10350,10510,10525,10260,10420,10465,70,115,310,"3,244.67",1354
,20160304,10420,10465,10480,11090,10480,11085,10915,620,450,506,"5,524.94",1646
,20160307,11085,10915,11065,11565,11065,11565,11445,650,530,664,"7,600.98",1576
,20160308,11565,11445,11475,11760,11205,11205,11420,-240,-25,576,"6,578.72",1682
,20160309,11205,11420,11295,11305,10925,10945,11130,-475,-290,64,712.37,1686
,20160310,10945,11130,10825,11190,10770,10770,10990,-360,-140,66,725.36,1688
,20160311,10770,10990,10895,11230,10815,10815,10910,-175,-80,38,414.72,1702
,20160314,10815,10910,10805,11300,10805,11200,11245,290,335,30,337.38,1724
,20160315,11200,11245,10950,10950,10610,10610,10925,-635,-320,28,305.92,1732
ru1604,20160104,10645,10680,10250,10280,10145,10200,10215,-480,-465,42,429.15,170
,20160105,10200,10215,10200,10200,10170,10170,10180,-45,-35,16,162.88,174
,20160106,10170,10180,10115,10150,10100,10150,10105,-30,-75,56,566.14,194
,20160107,10150,10105,10045,10365,9960,10070,10065,-35,-40,28,281.94,196
,20160108,10070,10065,9990,10120,9990,10080,10050,15,-15,8,80.42,200
,20160111,10080,10050,10070,10135,9645,9685,9925,-365,-125,70,694.82,196
,20160112,9685,9925,9730,9730,9600,9725,9675,-200,-250,20,193.50,202
,20160113,9725,9675,9755,9880,9705,9795,9760,120,85,110,"1,073.79",204
,20160114,9795,9760,9835,9860,9650,9815,9795,55,35,128,"1,253.79",198
,20160115,9815,9795,9870,9870,9705,9725,9790,-70,-5,352,"3,447.81",286
,20160118,9725,9790,9800,10110,9780,10075,9950,285,160,130,"1,293.72",352
,20160119,10075,9950,10050,10300,10000,10300,10150,350,200,198,"2,010.02",492
,20160120,10300,10150,10270,10275,10060,10250,10155,100,5,406,"4,123.72",606
,20160121,10250,10155,10200,10200,10035,10140,10170,-15,15,52,528.98,648
,20160122,10140,10170,10140,10320,10140,10300,10280,130,110,254,"2,611.85",866
,20160125,10300,10280,10275,10435,10100,10205,10245,-75,-35,190,"1,947.48",922
,20160126,10205,10245,10185,10185,10100,10100,10130,-145,-115,196,"1,986.20",752
,20160127,10100,10130,10175,10315,10175,10315,10240,185,110,176,"1,802.95",846
,20160128,10315,10240,10290,10320,10100,10100,10150,-140,-90,208,"2,111.32",712
,20160129,10100,10150,10160,10160,10065,10125,10105,-25,-45,78,788.32,694
,20160201,10125,10105,10215,10250,10095,10130,10175,25,70,106,"1,079.01",670
,20160202,10130,10175,10095,10200,9995,10120,10075,-55,-100,110,"1,108.40",660
,20160203,10120,10075,10130,10130,10030,10030,10070,-45,-5,80,805.69,640
,20160204,10030,10070,10090,10325,10090,10325,10255,255,185,158,"1,620.51",684
,20160205,10325,10255,10300,10300,10100,10100,10175,-155,-80,80,814.33,712
,20160215,10100,10175,10200,10375,10200,10375,10275,200,100,58,596.10,760
,20160216,10375,10275,10450,10450,10430,10430,10435,155,160,16,166.96,764
,20160217,10430,10435,10445,10445,10430,10430,10430,-5,-5,12,125.19,774
,20160218,10430,10430,10405,10480,10365,10400,10415,-30,-15,68,708.43,746
,20160219,10400,10415,10400,10500,10400,10485,10455,70,40,84,878.37,818
,20160222,10485,10455,10520,10700,10430,10660,10595,205,140,34,360.25,832
,20160223,10660,10595,10560,10560,10535,10535,10545,-60,-50,38,400.72,794
,20160224,10535,10545,10505,10585,10470,10490,10510,-55,-35,14,147.15,804
,20160225,10490,10510,10485,10735,10455,10455,10525,-55,15,16,168.47,790
,20160226,10455,10525,10430,10430,10300,10300,10385,-225,-140,12,124.64,778
,20160229,10300,10385,10300,10405,10160,10160,10285,-225,-100,130,"1,337.44",796
,20160301,10160,10285,10190,10385,10075,10265,10200,-20,-85,892,"9,099.26",814
,20160302,10265,10200,10305,10560,10300,10560,10395,360,195,38,395.16,828
,20160303,10560,10395,10520,10685,10520,10580,10580,185,185,28,296.34,830
,20160304,10580,10580,10850,11145,10850,10970,10985,390,405,26,285.68,842
,20160307,10970,10985,11355,11640,11355,11640,11565,655,580,126,"1,457.37",778
,20160308,11640,11565,11645,11645,11350,11350,11495,-215,-70,4,45.99,776
,20160309,11350,11495,11320,11320,11035,11220,11210,-275,-285,14,156.94,770
,20160310,11220,11210,11395,11400,11150,11150,11310,-60,100,30,339.33,790
,20160311,11150,11310,11220,11330,11085,11330,11280,20,-30,536,"6,047.01",818
,20160314,11330,11280,11420,11420,11320,11320,11370,40,90,22,250.24,818
,20160315,11320,11370,11225,11225,10860,11065,11045,-305,-325,44,486.18,804
,20160316,11065,11045,11045,11045,10800,10800,10940,-245,-105,16,175.06,812
,20160317,10800,10940,11200,11490,11170,11435,11350,495,410,88,998.97,832
,20160318,11435,11350,11465,11680,11465,11500,11545,150,195,6,69.29,834
,20160321,11500,11545,11545,11575,11260,11285,11440,-260,-105,92,"1,052.76",866
,20160322,11285,11440,11310,11310,11190,11190,11260,-250,-180,6,67.56,866
,20160323,11190,11260,11190,11190,11040,11105,11085,-155,-175,14,155.21,870
,20160324,11105,11085,11085,11085,10905,10905,10970,-180,-115,52,570.47,918
,20160325,10905,10970,11080,11175,11075,11105,11105,135,135,50,555.30,900
,20160328,11105,11105,11210,11300,10960,10960,11190,-145,85,60,671.45,910
,20160329,10960,11190,11115,11145,10770,10770,11070,-420,-120,70,774.91,890
,20160330,10770,11070,10900,10920,10765,10805,10840,-265,-230,38,412.05,900
,20160331,10805,10840,10910,10910,10670,10700,10775,-140,-65,40,431.04,900
,20160401,10700,10775,,,,10910,10910,135,135,0,0.00,900
,20160405,10910,10910,11090,11090,10970,10970,11065,60,155,16,177.06,900
,20160406,10970,11065,11170,11185,11005,11090,11120,25,55,26,289.16,894
,20160407,11090,11120,11090,11090,11035,11035,11070,-85,-50,12,132.85,904
,20160408,11035,11070,11010,11070,11010,11070,11040,0,-30,4,44.16,904
,20160411,11070,11040,11620,11620,11620,11620,11620,580,580,2,23.24,904
,20160412,11620,11620,10920,12315,10920,12050,11655,430,35,16,186.55,910
,20160413,12050,11655,12280,12350,11005,11005,11990,-650,335,32,383.77,910
,20160414,11005,11990,12050,12050,11500,11500,11775,-490,-215,4,47.10,910
,20160415,11500,11775,12140,12140,11500,11660,11780,-115,5,18,212.08,918
ru1605,20160104,10540,10605,10585,10605,10100,10160,10250,-445,-355,682378,"6,996,484.91",266912
,20160105,10160,10250,10220,10235,10100,10190,10175,-60,-75,634596,"6,459,503.89",276548
,20160106,10190,10175,10150,10225,10050,10070,10130,-105,-45,664940,"6,735,910.67",290438
,20160107,10070,10130,10030,10150,9960,10080,10065,-50,-65,784090,"7,892,352.96",278630
,20160108,10080,10065,10030,10195,9980,10090,10090,25,25,688222,"6,944,459.99",272002
,20160111,10090,10090,10050,10150,9700,9700,9935,-390,-155,787438,"7,825,702.12",306270
,20160112,9700,9935,9705,9780,9590,9640,9695,-295,-240,663010,"6,427,883.01",303438
,20160113,9640,9695,9730,9905,9715,9850,9825,155,130,771850,"7,585,617.65",284602
,20160114,9850,9825,9845,9930,9690,9885,9830,60,5,701512,"6,898,409.75",285068
,20160115,9885,9830,9860,9960,9765,9795,9875,-35,45,672864,"6,644,681.30",283598
,20160118,9795,9875,9725,10195,9720,10150,9995,275,120,894570,"8,943,421.70",253384
,20160119,10150,9995,10145,10400,10050,10345,10215,350,220,813596,"8,311,106.58",243816
,20160120,10345,10215,10345,10385,10160,10265,10280,50,65,673990,"6,928,617.71",242066
,20160121,10265,10280,10190,10300,10165,10200,10230,-80,-50,691006,"7,070,827.24",246394
,20160122,10200,10230,10235,10450,10190,10385,10330,155,100,747726,"7,727,218.41",243982
,20160125,10385,10330,10435,10500,10260,10320,10350,-10,20,583260,"6,039,235.39",247392
,20160126,10320,10350,10300,10325,10120,10155,10230,-195,-120,554126,"5,669,149.41",248810
,20160127,10155,10230,10200,10415,10190,10400,10315,170,85,573732,"5,918,903.65",247304
,20160128,10400,10315,10400,10415,10160,10190,10290,-125,-25,515740,"5,308,169.41",243814
,20160129,10190,10290,10200,10320,10130,10210,10220,-80,-70,590514,"6,035,822.36",232154
,20160201,10210,10220,10210,10340,10150,10190,10255,-30,35,554042,"5,681,716.60",232246
,20160202,10190,10255,10215,10235,10060,10200,10160,-55,-95,565680,"5,749,377.01",231944
,20160203,10200,10160,10200,10220,10060,10155,10130,-5,-30,469956,"4,762,312.61",229982
,20160204,10155,10130,10150,10385,10140,10335,10285,205,155,520782,"5,358,379.31",223344
,20160205,10335,10285,10300,10320,10140,10195,10235,-90,-50,342124,"3,502,923.75",203414
,20160215,10195,10235,10100,10540,10055,10530,10330,295,95,528802,"5,463,726.10",242930
,20160216,10530,10330,10525,10660,10465,10535,10555,205,225,565878,"5,975,587.09",259092
,20160217,10535,10555,10530,10575,10415,10450,10490,-105,-65,427986,"4,490,339.83",257018
,20160218,10450,10490,10480,10600,10435,10470,10495,-20,5,467492,"4,908,110.83",260910
,20160219,10470,10495,10480,10635,10390,10615,10510,120,15,591054,"6,212,708.80",276358
,20160222,10615,10510,10600,10840,10560,10705,10700,195,190,628840,"6,729,992.27",284206
,20160223,10705,10700,10750,10820,10570,10645,10670,-55,-30,526924,"5,622,340.51",275448
,20160224,10645,10670,10660,10695,10520,10585,10610,-85,-60,532834,"5,654,782.06",268474
,20160225,10585,10610,10550,10800,10520,10540,10665,-70,55,717396,"7,653,706.31",273616
,20160226,10540,10665,10550,10585,10230,10360,10415,-305,-250,779100,"8,114,493.01",265372
,20160229,10360,10415,10410,10475,10220,10280,10335,-135,-80,728186,"7,527,475.31",264920
,20160301,10280,10335,10310,10405,10205,10355,10305,20,-30,671824,"6,924,657.19",265836
,20160302,10355,10305,10400,10660,10365,10560,10510,255,205,794450,"8,352,101.14",261114
,20160303,10560,10510,10580,10760,10555,10675,10670,165,160,714790,"7,627,131.96",257378
,20160304,10675,10670,10710,11310,10695,11310,11070,640,400,1046478,"11,585,729.24",256406
,20160307,11310,11070,11425,12065,11400,11705,11665,635,595,1230652,"14,355,862.22",227974
,20160308,11705,11665,11730,11970,11360,11610,11660,-55,-5,1228004,"14,322,520.75",214570
,20160309,11610,11660,11580,11610,11115,11350,11350,-310,-310,752776,"8,545,418.53",203896
,20160310,11350,11350,11365,11585,11135,11185,11375,-165,25,802798,"9,133,831.07",203716
,20160311,11185,11375,11165,11435,11125,11345,11295,-30,-80,642000,"7,252,823.17",195802
,20160314,11345,11295,11375,11630,11270,11270,11465,-25,170,606240,"6,950,686.91",191684
,20160315,11270,11465,11270,11320,11015,11085,11135,-380,-330,577988,"6,437,012.13",193882
,20160316,11085,11135,11080,11280,11055,11270,11195,135,60,487330,"5,456,028.22",182104
,20160317,11270,11195,11280,11625,11255,11460,11425,265,230,556090,"6,354,933.03",183000
,20160318,11460,11425,11480,11790,11390,11420,11595,-5,170,652562,"7,566,609.71",162560
,20160321,11420,11595,11460,11695,11315,11495,11505,-100,-90,376744,"4,334,449.52",146358
,20160322,11495,11505,11545,11615,11380,11400,11500,-105,-5,200058,"2,300,946.06",142952
,20160323,11400,11500,11435,11525,11200,11205,11375,-295,-125,186214,"2,118,508.87",131586
,20160324,11205,11375,11200,11270,11100,11125,11185,-250,-190,160144,"1,791,290.72",119314
,20160325,11125,11185,11105,11320,11100,11315,11235,130,50,85116,"956,515.20",116250
,20160328,11315,11235,11330,11500,11155,11165,11340,-70,105,107986,"1,224,699.11",109608
,20160329,11165,11340,11165,11270,10865,10905,11100,-435,-240,124548,"1,383,041.53",111096
,20160330,10905,11100,10950,11035,10850,10975,10950,-125,-150,97742,"1,070,662.79",109944
,20160331,10975,10950,10995,11085,10755,10985,10910,35,-40,120940,"1,319,890.41",90010
,20160401,10985,10910,10980,11150,10950,11045,11025,135,115,74150,"817,525.30",85092
,20160405,11045,11025,11000,11290,10900,11290,11145,265,120,65754,"733,136.66",82818
,20160406,11290,11145,11285,11335,11125,11205,11235,60,90,55134,"619,636.96",78380
,20160407,11205,11235,11170,11315,11135,11195,11235,-40,0,40330,"453,145.41",75500
,20160408,11195,11235,11190,11285,11045,11280,11145,45,-90,54534,"607,796.69",65976
,20160411,11280,11145,11330,11810,11330,11785,11630,640,485,86724,"1,008,605.39",60040
,20160412,11785,11630,11830,12020,11685,12020,11805,390,175,55336,"653,270.50",57802
,20160413,12020,11805,12065,12510,11965,12110,12230,305,425,81894,"1,001,664.01",50832
,20160414,12110,12230,12085,12280,12055,12140,12145,-90,-85,45734,"555,640.43",49446
,20160415,12140,12145,12140,12310,11900,11930,12145,-215,0,46272,"562,199.81",46884
,20160418,11930,12145,11875,12280,11855,12090,12080,-55,-65,45328,"547,676.45",44334
,20160419,12090,12080,12140,12450,12055,12310,12260,230,180,44990,"551,785.06",42668
,20160420,12310,12260,12320,12860,12220,12720,12495,460,235,37184,"464,710.79",39842
,20160421,12720,12495,12730,13240,12530,13030,12845,535,350,36338,"466,855.39",37274
,20160422,13030,12845,12955,13125,12300,12485,12605,-360,-240,29868,"376,620.13",34500
,20160425,12485,12605,12530,13010,12400,12565,12670,-40,65,11842,"150,069.48",34142
,20160426,12565,12670,12610,12735,12425,12590,12600,-80,-70,12682,"159,828.07",32534
,20160427,12590,12600,12600,12780,12305,12480,12580,-120,-20,11994,"150,895.53",31174
,20160428,12480,12580,12495,12575,12150,12250,12340,-330,-240,11182,"138,039.26",30150
,20160429,12250,12340,12395,12425,12210,12290,12305,-50,-35,9318,"114,697.91",29024
,20160503,12290,12305,11890,12580,11890,12530,12315,225,10,2398,"29,540.74",28762
,20160504,12530,12315,12520,12550,12170,12220,12320,-95,5,1966,"24,227.59",28400
,20160505,12220,12320,12265,12330,11910,11915,12090,-405,-230,1568,"18,962.71",27882
,20160506,11915,12090,12065,12065,11630,11795,11800,-295,-290,2226,"26,268.12",27148
,20160509,11795,11800,11810,11990,11245,11325,11530,-475,-270,3324,"38,330.62",26490
,20160510,11325,11530,11260,11495,11210,11455,11385,-75,-145,1592,"18,130.69",26000
,20160511,11455,11385,11460,11580,11280,11390,11450,5,65,1176,"13,467.87",25496
,20160512,11390,11450,12135,12135,11215,11550,11365,100,-85,222,"2,523.04",25410
,20160513,11550,11365,11230,11340,10750,10850,10975,-515,-390,304,"3,337.81",25196
,20160516,10850,10975,10750,10920,10680,10845,10830,-130,-145,216,"2,340.23",25180
ru1606,20160104,10595,10665,10535,10535,10195,10200,10275,-465,-390,36,370.01,1076
,20160105,10200,10275,10280,10425,10135,10425,10325,150,50,24,247.87,1088
,20160106,10425,10325,10245,10305,10005,10130,10185,-195,-140,150,"1,527.76",1080
,20160107,10130,10185,10060,10165,10020,10130,10095,-55,-90,56,565.49,1064
,20160108,10130,10095,10070,10200,10065,10130,10145,35,50,22,223.21,1070
,20160111,10130,10145,10150,10180,9825,9830,9965,-315,-180,150,"1,494.99",1102
,20160112,9830,9965,9815,9840,9705,9770,9780,-195,-185,58,567.39,1080
,20160113,9770,9780,9850,9950,9830,9930,9875,150,95,18,177.81,1074
,20160114,9930,9875,9900,9945,9870,9945,9890,70,15,16,158.29,1068
,20160115,9945,9890,9960,9975,9815,9815,9935,-75,45,74,735.31,1072
,20160118,9815,9935,9990,10205,9990,10170,10130,235,195,144,"1,458.83",1038
,20160119,10170,10130,10315,10375,10315,10375,10345,245,215,4,41.38,1036
,20160120,10375,10345,10410,10410,10310,10390,10370,45,25,64,663.74,1032
,20160121,10390,10370,10300,10345,10240,10240,10300,-130,-70,172,"1,771.94",1026
,20160122,10240,10300,10290,10410,10290,10395,10360,95,60,12,124.35,1028
,20160125,10395,10360,,,,10360,10360,0,0,0,0.00,1028
,20160126,10360,10360,10335,10335,10200,10200,10280,-160,-80,404,"4,154.25",1030
,20160127,10200,10280,10415,10465,10355,10465,10410,185,130,20,208.28,1026
,20160128,10465,10410,10460,10460,10260,10260,10330,-150,-80,46,475.24,1032
,20160129,10260,10330,10395,10395,10275,10275,10320,-55,-10,16,165.19,1028
,20160201,10275,10320,10220,10375,10195,10375,10285,55,-35,12,123.47,1030
,20160202,10375,10285,10230,10230,10155,10215,10205,-70,-80,12,122.50,1028
,20160203,10215,10205,10215,10280,10155,10180,10210,-25,5,20,204.27,1034
,20160204,10180,10210,10215,10430,10215,10380,10320,170,110,34,350.89,1042
,20160205,10380,10320,10305,10370,10300,10300,10320,-20,0,34,350.92,1026
,20160215,10300,10320,10275,10555,10275,10555,10380,235,60,24,249.22,1026
,20160216,10555,10380,10605,10670,10575,10630,10640,250,260,60,638.41,1044
,20160217,10630,10640,10585,10615,10535,10535,10600,-105,-40,24,254.48,1028
,20160218,10535,10600,10000,10660,10000,10525,10535,-75,-65,56,590.10,1040
,20160219,10525,10535,10535,10630,10455,10580,10505,45,-30,1292,"13,574.44",382
,20160222,10580,10505,10590,10750,10550,10710,10670,205,165,90,960.47,348
,20160223,10710,10670,10715,10720,10600,10650,10650,-20,-20,112,"1,192.91",312
,20160224,10650,10650,10675,10675,10550,10630,10590,-20,-60,10,105.91,314
,20160225,10630,10590,10600,10760,10550,10550,10630,-40,40,18,191.36,312
,20160226,10550,10630,10660,10660,10390,10390,10495,-240,-135,36,377.83,310
,20160229,10390,10495,10450,10505,10275,10330,10355,-165,-140,60,621.55,314
,20160301,10330,10355,10335,10395,10275,10390,10345,35,-10,90,931.08,326
,20160302,10390,10345,10460,10705,10425,10625,10535,280,190,80,842.91,308
,20160303,10625,10535,10640,10780,10640,10730,10720,195,185,42,450.34,312
,20160304,10730,10720,10740,11360,10730,11340,11035,620,315,1018,"11,234.85",350
,20160307,11340,11035,11540,11695,11535,11690,11635,655,600,292,"3,397.63",310
,20160308,11690,11635,11860,12000,11400,11610,11765,-25,130,170,"2,000.61",252
,20160309,11610,11765,11510,11525,11100,11380,11325,-385,-440,62,702.20,258
,20160310,11380,11325,11460,11620,11205,11285,11450,-40,125,202,"2,313.50",328
,20160311,11285,11450,11195,11485,11195,11340,11375,-110,-75,84,955.89,346
,20160314,11340,11375,11450,11685,11320,11320,11520,-55,145,186,"2,143.64",356
,20160315,11320,11520,11285,11285,11055,11185,11220,-335,-300,384,"4,309.41",306
,20160316,11185,11220,11185,11325,11180,11275,11265,55,45,80,901.25,308
,20160317,11275,11265,11365,11610,11340,11515,11465,250,200,170,"1,949.69",348
,20160318,11515,11465,11490,11835,11490,11560,11660,95,195,70,816.34,372
,20160321,11560,11660,11480,11795,11450,11595,11605,-65,-55,194,"2,252.06",454
,20160322,11595,11605,11645,11690,11485,11485,11590,-120,-15,246,"2,852.14",504
,20160323,11485,11590,11370,11620,11070,11290,11395,-300,-195,276,"3,145.25",494
,20160324,11290,11395,11260,11385,11165,11225,11250,-170,-145,116,"1,305.39",496
,20160325,11225,11250,11305,11380,11300,11320,11340,70,90,70,794.03,506
,20160328,11320,11340,11440,11535,11255,11255,11440,-85,100,100,"1,144.40",488
,20160329,11255,11440,11290,11340,10975,10975,11245,-465,-195,452,"5,084.53",546
,20160330,10975,11245,11065,11120,10935,11080,11025,-165,-220,390,"4,300.21",508
,20160331,11080,11025,11110,11180,10825,11045,11020,20,-5,330,"3,637.54",394
,20160401,11045,11020,11135,11180,11095,11160,11140,140,120,52,579.39,394
,20160405,11160,11140,11240,11400,11130,11400,11290,260,150,92,"1,038.72",396
,20160406,11400,11290,11370,11450,11260,11260,11325,-30,35,114,"1,291.35",392
,20160407,11260,11325,11295,11425,11285,11395,11345,70,20,62,703.50,384
,20160408,11395,11345,11250,11320,11130,11320,11255,-25,-90,80,900.45,370
,20160411,11320,11255,11435,11920,11415,11890,11725,635,470,236,"2,768.09",318
,20160412,11890,11725,11895,12100,11845,12100,11910,375,185,206,"2,454.27",272
,20160413,12100,11910,12110,12620,12085,12300,12365,390,455,134,"1,657.32",230
,20160414,12300,12365,12285,12400,12210,12255,12290,-110,-75,82,"1,008.15",254
,20160415,12255,12290,12385,12405,12185,12185,12340,-105,50,36,444.35,236
,20160418,12185,12340,12045,12340,12010,12340,12230,0,-110,104,"1,271.93",218
,20160419,12340,12230,12290,12530,12160,12285,12390,55,160,72,892.19,176
,20160420,12285,12390,12945,12945,12195,12535,12550,145,160,72,903.76,174
,20160421,12535,12550,12720,13160,12720,13160,13005,610,455,68,884.64,150
,20160422,13160,13005,12685,12920,12595,12660,12765,-345,-240,66,842.68,132
,20160425,12660,12765,12705,13070,12500,12795,12725,30,-40,40,509.08,112
,20160426,12795,12725,12795,12805,12465,12465,12715,-260,-10,30,381.45,134
,20160427,12465,12715,12840,13035,12395,12515,12725,-200,10,306,"3,895.22",152
,20160428,12515,12725,12660,12660,12285,12375,12500,-350,-225,46,575.06,164
,20160429,12375,12500,12490,12625,12430,12625,12485,125,-15,76,948.97,160
,20160503,12625,12485,12295,12560,12295,12560,12415,75,-70,56,695.24,154
,20160504,12560,12415,12725,12730,12375,12400,12530,-15,115,48,601.50,146
,20160505,12400,12530,12420,12420,12070,12170,12200,-360,-330,50,610.01,146
,20160506,12170,12200,12000,12000,11875,12000,11930,-200,-270,66,787.56,148
,20160509,12000,11930,12005,12050,11355,11470,11490,-460,-440,122,"1,401.88",182
,20160510,11470,11490,11475,11595,11415,11460,11530,-30,40,54,622.83,152
,20160511,11460,11530,11690,11690,11450,11450,11520,-80,-10,102,"1,175.34",208
,20160512,11450,11520,11595,11665,11520,11560,11545,40,25,74,854.66,174
,20160513,11560,11545,11355,11355,10850,10925,11020,-620,-525,92,"1,014.00",174
,20160516,10925,11020,10885,11000,10845,10920,10970,-100,-50,74,811.80,156
,20160517,10920,10970,10995,11080,10930,10940,10965,-30,-5,36,394.77,140
,20160518,10940,10965,10940,11155,10780,10780,10975,-185,10,84,922.28,132
,20160519,10780,10975,11075,11075,10510,10510,10740,-465,-235,82,880.97,146
,20160520,10510,10740,10525,10615,10445,10550,10520,-190,-220,260,"2,736.25",166
,20160523,10550,10520,10420,10420,9935,10035,10175,-485,-345,124,"1,261.98",166
,20160524,10035,10175,9975,10095,9970,10035,10045,-140,-130,78,783.64,182
,20160525,10035,10045,10150,10150,9880,9910,10070,-135,25,122,"1,228.93",200
,20160526,9910,10070,9945,10260,9945,10260,10135,190,65,118,"1,196.41",244
,20160527,10260,10135,10250,10280,10035,10280,10135,145,0,94,952.74,298
,20160530,10280,10135,10190,10265,10100,10175,10150,40,15,58,588.77,310
,20160531,10175,10150,10305,10335,10000,10000,10230,-150,80,86,879.82,320
,20160601,10000,10230,10045,10125,9905,9930,9990,-300,-240,78,779.41,342
,20160602,9930,9990,9870,10120,9870,10100,10025,110,35,212,"2,125.93",474
,20160603,10100,10025,10120,10210,10065,10200,10160,175,135,52,528.39,492
,20160606,10200,10160,10155,10370,10125,10370,10245,210,85,150,"1,537.01",510
,20160607,10370,10245,10320,10395,10180,10220,10295,-25,50,142,"1,462.16",516
,20160608,10220,10295,10050,10180,10020,10125,10120,-170,-175,44,445.46,530
,20160613,10125,10120,10000,10300,9990,10280,10170,160,50,78,793.32,582
,20160614,10280,10170,10280,10300,10080,10080,10260,-90,90,14,143.66,590
,20160615,10080,10260,10050,10050,10020,10020,10035,-240,-225,62,622.30,616
ru1607,20160104,10620,10635,10620,10620,10240,10260,10400,-375,-235,292,"3,037.52",1084
,20160105,10260,10400,10275,10330,10245,10270,10265,-130,-135,32,328.51,1082
,20160106,10270,10265,10320,10320,10155,10170,10280,-95,15,44,452.41,1098
,20160107,10170,10280,10195,10220,10150,10220,10195,-60,-85,40,407.91,1102
,20160108,10220,10195,10120,10415,10120,10180,10190,-15,-5,86,876.63,1086
,20160111,10180,10190,10185,10185,9800,9800,10060,-390,-130,80,805.09,1092
,20160112,9800,10060,9895,9990,9745,9750,9850,-310,-210,98,965.58,1082
,20160113,9750,9850,9930,9985,9905,9960,9940,110,90,50,497.11,1104
,20160114,9960,9940,9940,10005,9845,9960,9905,20,-35,52,515.08,1088
,20160115,9960,9905,10015,10065,9930,9930,10015,25,110,66,661.00,1088
,20160118,9930,10015,9965,10280,9965,10200,10195,185,180,66,672.96,1082
,20160119,10200,10195,10220,10500,10190,10500,10255,305,60,70,718.16,1070
,20160120,10500,10255,10400,10400,10325,10400,10370,145,115,10,103.73,1070
,20160121,10400,10370,10370,10400,10240,10315,10315,-55,-55,50,515.89,1090
,20160122,10315,10315,10435,10500,10325,10460,10465,145,150,42,439.58,1072
,20160125,10460,10465,10615,10615,10395,10395,10505,-70,40,8,84.04,1072
,20160126,10395,10505,10410,10415,10260,10260,10360,-245,-145,6,62.17,1074
,20160127,10260,10360,10465,10465,10410,10430,10435,70,75,18,187.83,1072
,20160128,10430,10435,10440,10440,10440,10440,10440,5,5,12,125.28,1072
,20160129,10440,10440,10355,10400,10300,10330,10360,-110,-80,26,269.36,1072
,20160201,10330,10360,10345,10410,10345,10345,10375,-15,15,32,332.06,1078
,20160202,10345,10375,,,,10295,10295,-80,-80,0,0.00,1078
,20160203,10295,10295,10295,10295,10235,10235,10265,-60,-30,4,41.06,1080
,20160204,10235,10265,10465,10465,10465,10465,10465,200,200,28,293.02,1080
,20160205,10465,10465,10400,10400,10290,10290,10345,-175,-120,158,"1,635.05",1080
,20160215,10290,10345,10195,10600,10195,10600,10525,255,180,144,"1,515.97",1100
,20160216,10600,10525,10640,10695,10610,10630,10645,105,120,16,170.35,1100
,20160217,10630,10645,10615,10615,10570,10570,10580,-75,-65,8,84.66,1106
,20160218,10570,10580,10665,10665,10565,10565,10650,-15,70,22,234.37,1088
,20160219,10565,10650,10600,10655,10535,10655,10595,5,-55,1098,"11,636.65",408
,20160222,10655,10595,10630,10865,10630,10770,10775,175,180,106,"1,142.44",338
,20160223,10770,10775,10645,10875,10645,10735,10710,-40,-65,16,171.42,344
,20160224,10735,10710,10700,10700,10640,10640,10665,-70,-45,22,234.68,344
,20160225,10640,10665,10720,10780,10700,10780,10730,115,65,16,171.69,336
,20160226,10780,10730,10645,10645,10420,10500,10475,-230,-255,26,272.47,336
,20160229,10500,10475,10590,10590,10380,10400,10405,-75,-70,84,874.23,356
,20160301,10400,10405,10400,10495,10380,10495,10410,90,5,52,541.49,364
,20160302,10495,10410,10570,10730,10500,10620,10615,210,205,118,"1,252.68",386
,20160303,10620,10615,10745,10850,10715,10845,10755,230,140,34,365.74,368
,20160304,10845,10755,10850,11395,10850,11335,11085,580,330,100,"1,108.50",454
,20160307,11335,11085,11555,11750,11545,11750,11695,665,610,236,"2,760.94",394
,20160308,11750,11695,11780,12055,11410,11625,11680,-70,-15,122,"1,425.04",390
,20160309,11625,11680,11575,11580,11150,11460,11385,-220,-295,52,592.17,366
,20160310,11460,11385,11530,11660,11340,11340,11545,-45,160,112,"1,293.07",464
,20160311,11340,11545,11570,11590,11355,11555,11485,10,-60,68,781.30,504
,20160314,11555,11485,11540,11650,11410,11410,11595,-75,110,56,649.54,534
,20160315,11410,11595,11190,11290,11120,11280,11205,-315,-390,122,"1,367.04",466
,20160316,11280,11205,11180,11390,11180,11345,11285,140,80,82,925.66,498
,20160317,11345,11285,11450,11700,11415,11615,11550,330,265,82,947.36,530
,20160318,11615,11550,11695,11925,11640,11685,11830,135,280,172,"2,035.59",608
,20160321,11685,11830,11630,11825,11630,11630,11660,-200,-170,242,"2,822.72",766
,20160322,11630,11660,11700,11745,11560,11560,11690,-100,30,80,935.27,780
,20160323,11560,11690,11500,11695,11390,11390,11490,-300,-200,90,"1,034.26",724
,20160324,11390,11490,11345,11515,11250,11355,11340,-135,-150,74,839.16,718
,20160325,11355,11340,11405,11490,11370,11445,11445,105,105,246,"2,816.07",562
,20160328,11445,11445,11555,11615,11365,11365,11570,-80,125,30,347.18,554
,20160329,11365,11570,11400,11410,10950,11155,11305,-415,-265,68,769.06,506
,20160330,11155,11305,11235,11235,11085,11225,11140,-80,-165,68,757.82,514
,20160331,11225,11140,11245,11275,11010,11220,11100,80,-40,54,599.46,508
,20160401,11220,11100,11170,11700,11170,11700,11235,600,135,36,404.49,530
,20160405,11700,11235,11320,11435,11295,11430,11350,195,115,46,522.26,510
,20160406,11430,11350,11490,11510,11015,11435,11415,85,65,58,662.22,498
,20160407,11435,11415,11405,11450,11405,11450,11445,35,30,22,251.80,492
,20160408,11450,11445,11450,11500,11300,11500,11390,55,-55,28,318.97,502
,20160411,11500,11390,11845,12030,11845,12030,11890,640,500,36,428.06,486
,20160412,12030,11890,12045,12350,11940,12350,12095,460,205,60,725.82,508
,20160413,12350,12095,12190,12675,12190,12315,12480,220,385,154,"1,921.94",464
,20160414,12315,12480,12345,12455,12295,12350,12365,-130,-115,88,"1,088.30",432
,20160415,12350,12365,12485,12485,12210,12210,12385,-155,20,70,867.07,374
,20160418,12210,12385,12335,12450,12270,12345,12390,-40,5,120,"1,487.31",368
,20160419,12345,12390,12445,12640,12445,12535,12550,145,160,54,677.77,340
,20160420,12535,12550,12660,12980,12660,12980,12800,430,250,40,512.09,338
,20160421,12980,12800,12910,13320,12820,13300,13090,500,290,48,628.34,338
,20160422,13300,13090,13160,13160,12595,12730,12865,-360,-225,128,"1,646.91",350
,20160425,12730,12865,12890,13000,12580,12775,12765,-90,-100,42,536.20,322
,20160426,12775,12765,12945,12945,12810,12865,12900,100,135,32,412.82,322
,20160427,12865,12900,12990,12990,12915,12915,12920,15,20,26,335.94,324
,20160428,12915,12920,12795,12795,12300,12450,12650,-470,-270,66,835.10,350
,20160429,12450,12650,12505,12615,12505,12520,12515,-130,-135,24,300.37,332
,20160503,12520,12515,12400,12795,12400,12770,12555,255,40,70,878.98,342
,20160504,12770,12555,12640,12670,12485,12485,12620,-70,65,32,403.95,330
,20160505,12485,12620,12280,12280,12170,12170,12255,-450,-365,56,686.30,344
,20160506,12170,12255,12060,12060,12025,12030,12025,-225,-230,42,505.13,312
,20160509,12030,12025,12060,12100,11665,11665,11815,-360,-210,60,709.12,330
,20160510,11665,11815,11545,11615,11540,11615,11600,-200,-215,28,324.93,304
,20160511,11615,11600,11735,11825,11500,11640,11635,40,35,50,581.77,302
,20160512,11640,11635,11640,11640,11550,11550,11555,-85,-80,28,323.58,300
,20160513,11550,11555,11495,11495,10920,11105,11065,-450,-490,100,"1,106.92",312
,20160516,11105,11065,10980,11245,10980,11045,11145,-20,80,54,602.01,288
,20160517,11045,11145,11050,11160,11050,11160,11055,15,-90,42,464.32,286
,20160518,11160,11055,11095,11240,11005,11005,11120,-50,65,124,"1,379.37",264
,20160519,11005,11120,10985,10985,10685,10685,10845,-435,-275,46,499.00,260
,20160520,10685,10845,10665,10745,10665,10745,10720,-100,-125,34,364.60,252
,20160523,10745,10720,10190,10350,10075,10075,10190,-645,-530,66,672.59,280
,20160524,10075,10190,10135,10205,10135,10205,10175,15,-15,46,468.08,254
,20160525,10205,10175,10225,10365,10195,10240,10235,65,60,72,737.06,310
,20160526,10240,10235,10190,10375,10175,10360,10280,125,45,96,986.97,252
,20160527,10360,10280,10165,10325,10145,10325,10155,45,-125,38,386.06,240
,20160530,10325,10155,10350,10395,10300,10300,10310,145,155,28,288.77,232
,20160531,10300,10310,10385,10385,10380,10380,10380,70,70,26,269.89,254
,20160601,10380,10380,10085,10085,10050,10070,10070,-310,-310,38,382.80,246
,20160602,10070,10070,10120,10205,10120,10205,10160,135,90,72,731.62,220
,20160603,10205,10160,10270,10335,10225,10335,10320,175,160,26,268.36,210
,20160606,10335,10320,10350,10535,10270,10480,10415,160,95,304,"3,167.51",334
,20160607,10480,10415,10470,10535,10310,10340,10490,-75,75,702,"7,365.85",174
,20160608,10340,10490,10340,10340,10135,10240,10275,-250,-215,10,102.79,176
,20160613,10240,10275,10240,10350,10240,10350,10330,75,55,46,475.20,178
,20160614,10350,10330,10350,10350,10150,10150,10265,-180,-65,56,574.88,162
,20160615,10150,10265,10175,10200,10135,10200,10175,-65,-90,22,223.89,154
,20160616,10200,10175,10350,10350,10350,10350,10350,175,175,10,103.50,164
,20160617,10350,10350,10300,10680,10160,10645,10410,295,60,214,"2,228.12",274
,20160620,10645,10410,10675,10800,10675,10725,10750,315,340,90,967.51,264
,20160621,10725,10750,10840,10840,10545,10610,10680,-140,-70,38,405.91,262
,20160622,10610,10680,10590,10880,10590,10880,10730,200,50,80,858.67,316
,20160623,10880,10730,10830,10850,10785,10795,10815,65,85,52,562.41,314
,20160624,10795,10815,11100,11100,10485,10720,10820,-95,5,70,757.52,314
,20160627,10720,10820,10675,11110,10675,11100,10990,280,170,42,461.62,330
,20160628,11100,10990,11020,11155,10900,11055,10985,65,-5,82,901.04,340
,20160629,11055,10985,11165,11240,10990,11000,11100,15,115,88,976.92,344
,20160630,11000,11100,11050,11270,11050,11160,11185,60,85,118,"1,320.09",416
,20160701,11160,11185,11120,11390,11120,11250,11205,65,20,66,739.62,448
,20160704,11250,11205,11535,11875,11535,11870,11755,665,550,74,869.89,504
,20160705,11870,11755,11800,11800,11420,11645,11545,-110,-210,26,300.19,520
,20160706,11645,11545,11595,11625,10915,10915,11115,-630,-430,60,666.97,540
,20160707,10915,11115,10815,11140,10745,10960,11025,-155,-90,92,"1,014.61",602
,20160708,10960,11025,10620,10625,10430,10480,10525,-545,-500,30,315.82,626
,20160711,10480,10525,10700,10700,10620,10640,10650,115,125,6,63.92,630
,20160712,10640,10650,10680,10835,10010,10795,10605,145,-45,24,254.58,628
,20160713,10795,10605,,,,10605,10605,0,0,0,0.00,628
,20160714,10605,10605,,,,10605,10605,0,0,0,0.00,628
,20160715,10605,10605,,,,10605,10605,0,0,0,0.00,628
ru1608,20160104,10590,10615,10530,10530,10190,10250,10315,-365,-300,216,"2,228.49",1132
,20160105,10250,10315,10260,10305,10195,10270,10215,-45,-100,76,776.50,1134
,20160106,10270,10215,10295,10295,10180,10215,10245,0,30,50,512.45,1136
,20160107,10215,10245,10175,10295,10150,10220,10240,-25,-5,502,"5,142.72",1148
,20160108,10220,10240,10210,10290,10110,10160,10155,-80,-85,464,"4,712.35",1372
,20160111,10160,10155,10195,10195,9970,9970,10065,-185,-90,56,563.77,1370
,20160112,9970,10065,9915,9915,9700,9725,9830,-340,-235,182,"1,789.22",1260
,20160113,9725,9830,9850,9915,9850,9900,9905,70,75,46,455.66,1232
,20160114,9900,9905,9900,10030,9870,10030,9940,125,35,116,"1,153.61",1210
,20160115,10030,9940,9980,9980,9935,9950,9950,10,10,46,457.86,1210
,20160118,9950,9950,9950,10290,9950,10180,10245,230,295,80,819.60,1206
,20160119,10180,10245,10185,10450,10185,10395,10260,150,15,18,184.70,1202
,20160120,10395,10260,10305,10415,10305,10415,10320,155,60,12,123.89,1196
,20160121,10415,10320,10300,10345,10250,10300,10305,-20,-15,84,865.92,1196
,20160122,10300,10305,10500,10500,10445,10485,10495,180,190,100,"1,049.64",1104
,20160125,10485,10495,,,,10495,10495,0,0,0,0.00,1104
,20160126,10495,10495,10405,10405,10280,10280,10370,-215,-125,8,82.97,1100
,20160127,10280,10370,10540,10540,10540,10540,10540,170,170,2,21.08,1098
,20160128,10540,10540,10370,10380,10370,10380,10375,-160,-165,4,41.50,1098
,20160129,10380,10375,10365,10365,10365,10365,10365,-10,-10,4,41.46,1098
,20160201,10365,10365,10410,10420,10410,10420,10415,55,50,4,41.66,1098
,20160202,10420,10415,10280,10280,10270,10270,10275,-145,-140,4,41.10,1098
,20160203,10270,10275,10250,10250,10250,10250,10250,-25,-25,2,20.50,1098
,20160204,10250,10250,10455,10460,10450,10460,10455,210,205,8,83.65,1094
,20160205,10460,10455,10450,10450,10350,10360,10350,-95,-105,104,"1,076.62",1096
,20160215,10360,10350,10255,10630,10255,10630,10545,280,195,38,400.73,1104
,20160216,10630,10545,10700,10700,10700,10700,10700,155,155,6,64.20,1098
,20160217,10700,10700,,,,10700,10700,0,0,0,0.00,1098
,20160218,10700,10700,10645,10645,10645,10645,10645,-55,-55,2,21.29,1098
,20160219,10645,10645,10650,10730,10625,10730,10685,85,40,344,"3,675.75",1116
,20160222,10730,10685,10695,10885,10695,10815,10825,130,140,42,454.69,1118
,20160223,10815,10825,10815,10890,10785,10785,10815,-40,-10,44,476.05,1122
,20160224,10785,10815,10765,10795,10700,10700,10770,-115,-45,10,107.70,1122
,20160225,10700,10770,10755,10870,10680,10680,10755,-90,-15,16,172.14,1118
,20160226,10680,10755,10680,10680,10510,10580,10580,-175,-175,38,402.22,1110
,20160229,10580,10580,10580,10600,10420,10450,10525,-130,-55,1800,"18,945.52",584
,20160301,10450,10525,10505,10550,10445,10545,10475,20,-50,58,607.81,580
,20160302,10545,10475,10690,10830,10640,10815,10745,340,270,94,"1,010.21",584
,20160303,10815,10745,10830,10970,10770,10910,10865,165,120,32,347.76,566
,20160304,10910,10865,10965,11515,10965,11515,11375,650,510,152,"1,729.06",574
,20160307,11515,11375,11700,12175,11700,11925,11880,550,505,190,"2,258.11",526
,20160308,11925,11880,12075,12100,11570,11575,11945,-305,65,100,"1,194.73",470
,20160309,11575,11945,11630,11630,11380,11560,11485,-385,-460,40,459.46,446
,20160310,11560,11485,11585,11745,11360,11365,11595,-120,110,98,"1,136.54",506
,20160311,11365,11595,11355,11610,11355,11610,11550,15,-45,26,300.35,504
,20160314,11610,11550,11580,11810,11485,11485,11680,-65,130,68,794.54,522
,20160315,11485,11680,11465,11465,11185,11310,11300,-370,-380,102,"1,152.95",448
,20160316,11310,11300,11370,11370,11315,11315,11340,15,40,4,45.37,446
,20160317,11315,11340,11510,11785,11510,11710,11610,370,270,88,"1,022.04",470
,20160318,11710,11610,11765,11820,11720,11720,11750,110,140,14,164.56,470
,20160321,11720,11750,11630,11890,11630,11755,11795,5,45,150,"1,769.70",542
,20160322,11755,11795,11815,11870,11755,11785,11850,-10,55,64,758.68,538
,20160323,11785,11850,11765,11765,11550,11550,11645,-300,-205,18,209.65,528
,20160324,11550,11645,11390,11525,11390,11525,11490,-120,-155,72,827.57,532
,20160325,11525,11490,11450,11575,11450,11545,11515,55,25,144,"1,658.65",472
,20160328,11545,11515,11760,11790,11685,11685,11700,170,185,24,280.81,476
,20160329,11685,11700,11540,11635,11220,11285,11475,-415,-225,66,757.63,438
,20160330,11285,11475,11270,11355,11265,11355,11300,-120,-175,46,519.83,446
,20160331,11355,11300,11285,11380,11070,11105,11180,-195,-120,40,447.33,446
,20160401,11105,11180,11325,11355,11280,11300,11330,120,150,22,249.32,454
,20160405,11300,11330,11420,11620,11420,11620,11465,290,135,16,183.44,454
,20160406,11620,11465,11650,11650,11500,11510,11590,45,125,38,440.57,470
,20160407,11510,11590,11530,11725,11530,11580,11580,-10,-10,30,347.45,476
,20160408,11580,11580,11485,11555,11335,11555,11435,-25,-145,58,663.32,454
,20160411,11555,11435,11705,12120,11705,12060,11960,625,525,88,"1,052.56",436
,20160412,12060,11960,12105,12200,12105,12200,12130,240,170,30,363.92,430
,20160413,12200,12130,12830,12845,12575,12685,12775,555,645,48,613.24,404
,20160414,12685,12775,12590,12615,12450,12540,12555,-235,-220,62,778.62,436
,20160415,12540,12555,12005,12585,12005,12370,12435,-185,-120,44,547.24,416
,20160418,12370,12435,12315,12540,12230,12510,12420,75,-15,54,670.86,420
,20160419,12510,12420,12670,12740,12490,12490,12670,70,250,74,937.59,412
,20160420,12490,12670,12645,13040,12645,12905,12925,235,255,426,"5,506.80",474
,20160421,12905,12925,13115,13640,13115,13410,13390,485,465,62,830.37,476
,20160422,13410,13390,13310,13310,12800,12900,12955,-490,-435,140,"1,814.03",462
,20160425,12900,12955,12900,13230,12855,12855,12945,-100,-10,70,906.41,456
,20160426,12855,12945,13010,13080,12925,12960,13000,15,55,96,"1,248.32",502
,20160427,12960,13000,13030,13135,12900,12940,12975,-60,-25,70,908.39,494
,20160428,12940,12975,12705,12705,12705,12705,12705,-270,-270,30,381.15,496
,20160429,12705,12705,12645,12685,12645,12685,12670,-20,-35,30,380.22,478
,20160503,12685,12670,12555,12730,12510,12720,12665,50,-5,68,861.42,506
,20160504,12720,12665,12820,12820,12645,12705,12715,40,50,62,788.50,512
,20160505,12705,12715,12705,12710,12300,12375,12365,-340,-350,68,840.87,516
,20160506,12375,12365,12200,12275,12200,12275,12210,-90,-155,30,366.30,512
,20160509,12275,12210,12100,12100,11635,11635,11785,-575,-425,80,943.18,518
,20160510,11635,11785,11595,11825,11595,11790,11770,5,-15,38,447.33,492
,20160511,11790,11770,11830,11890,11785,11785,11810,15,40,38,448.90,490
,20160512,11785,11810,11645,11960,11560,11900,11670,90,-140,60,700.33,492
,20160513,11900,11670,11560,11560,11155,11155,11255,-515,-415,34,382.80,492
,20160516,11155,11255,11290,11295,11175,11225,11225,-30,-30,130,"1,459.43",506
,20160517,11225,11225,11200,11285,11175,11280,11220,55,-5,48,538.56,512
,20160518,11280,11220,11265,11295,11200,11285,11275,65,55,28,315.79,506
,20160519,11285,11275,10985,11095,10900,10900,11050,-375,-225,48,530.44,506
,20160520,10900,11050,10770,10820,10770,10775,10775,-275,-275,32,344.94,480
,20160523,10775,10775,10460,10470,10130,10130,10395,-645,-380,326,"3,389.38",642
,20160524,10130,10395,10205,10255,10205,10255,10220,-140,-175,106,"1,083.52",648
,20160525,10255,10220,10215,10335,10115,10190,10265,-30,45,90,923.91,690
,20160526,10190,10265,10225,10350,10225,10300,10310,35,45,52,536.26,660
,20160527,10300,10310,10355,10540,10240,10460,10335,150,25,88,909.66,688
,20160530,10460,10335,10420,10490,10295,10490,10405,155,70,66,686.88,690
,20160531,10490,10405,10500,10500,10360,10360,10405,-45,0,50,520.39,686
,20160601,10360,10405,10340,10340,10150,10150,10200,-255,-205,192,"1,958.94",648
,20160602,10150,10200,10275,10310,10275,10310,10280,110,80,40,411.25,684
,20160603,10310,10280,10400,10470,10335,10420,10390,140,110,36,374.13,686
,20160606,10420,10390,10465,10620,10390,10620,10465,230,75,72,753.70,692
,20160607,10620,10465,10575,10605,10475,10475,10530,10,65,60,631.87,678
,20160608,10475,10530,10475,10475,10255,10365,10370,-165,-160,56,580.92,680
,20160613,10365,10370,10430,10535,10345,10535,10475,165,105,58,607.72,702
,20160614,10535,10475,10470,10605,10330,10330,10430,-145,-45,160,"1,669.05",686
,20160615,10330,10430,10315,10315,10250,10255,10275,-175,-155,20,205.57,686
,20160616,10255,10275,10435,10470,10360,10410,10385,135,110,116,"1,204.83",662
,20160617,10410,10385,10425,10825,10285,10825,10710,440,325,134,"1,435.19",656
,20160620,10825,10710,10785,10890,10785,10890,10825,180,115,22,238.17,648
,20160621,10890,10825,10945,10945,10715,10735,10825,-90,0,22,238.19,644
,20160622,10735,10825,,,,10825,10825,0,0,0,0.00,644
,20160623,10825,10825,11015,11025,10815,10920,10930,95,105,46,502.86,650
,20160624,10920,10930,10970,11030,10750,10825,10915,-105,-15,36,392.99,648
,20160627,10825,10915,11050,11230,11050,11210,11140,295,225,22,245.14,646
,20160628,11210,11140,11140,11265,11000,11265,11175,125,35,44,491.84,638
,20160629,11265,11175,,,,11175,11175,0,0,0,0.00,638
,20160630,11175,11175,11315,11355,11295,11355,11320,180,145,28,317.09,634
,20160701,11355,11320,11270,11505,11270,11350,11370,30,50,56,636.96,640
,20160704,11350,11370,11510,12000,11445,11900,11765,530,395,132,"1,553.51",636
,20160705,11900,11765,12050,12085,11590,11730,11835,-35,70,54,639.19,624
,20160706,11730,11835,11805,11805,11120,11185,11390,-650,-445,160,"1,822.60",600
,20160707,11185,11390,11025,11205,10875,10875,11125,-515,-265,102,"1,134.80",596
,20160708,10875,11125,10800,10870,10720,10720,10825,-405,-300,82,887.69,588
,20160711,10720,10825,10690,10860,10535,10860,10660,35,-165,52,554.50,588
,20160712,10860,10660,10870,11000,10730,10900,10875,240,215,60,652.55,546
,20160713,10900,10875,11070,11390,10910,10955,11180,80,305,188,"2,102.35",518
,20160714,10955,11180,11115,11115,10985,11035,11020,-145,-160,20,220.42,512
,20160715,11035,11020,11355,11355,11150,11220,11235,200,215,122,"1,371.26",488
,20160718,11220,11235,11045,11190,11000,11005,11080,-230,-155,98,"1,085.87",466
,20160719,11005,11080,10925,11240,10925,11210,11100,130,20,90,999.19,422
,20160720,11210,11100,11245,11400,11205,11400,11335,300,235,62,702.90,412
,20160721,11400,11335,11650,11650,11260,11550,11400,215,65,166,"1,892.61",376
,20160722,11550,11400,11550,11550,11260,11260,11435,-140,35,52,594.74,360
,20160725,11260,11435,11295,11335,10965,11000,11145,-435,-290,28,312.12,360
,20160726,11000,11145,11050,11170,10740,11010,10930,-135,-215,126,"1,377.61",320
,20160727,11010,10930,11010,11165,11010,11015,11100,85,170,32,355.30,304
,20160728,11015,11100,11100,11225,11080,11105,11110,5,10,14,155.58,304
,20160729,11105,11110,11175,11175,10635,10655,10925,-455,-185,34,371.49,302
,20160801,10655,10925,10800,10865,10730,10850,10810,-75,-115,58,627.01,302
,20160802,10850,10810,10685,10685,10685,10685,10685,-125,-125,2,21.37,302
,20160803,10685,10685,10810,10810,10740,10740,10770,55,85,54,581.64,304
,20160804,10740,10770,10710,10710,10425,10425,10640,-345,-130,24,255.42,314
,20160805,10425,10640,10450,10690,10450,10475,10550,-165,-90,44,464.28,342
,20160808,10475,10550,10580,10595,10475,10575,10530,25,-20,40,421.28,348
,20160809,10575,10530,10285,10285,10280,10280,10280,-250,-250,8,82.25,350
,20160810,10280,10280,10280,10315,10155,10275,10265,-5,-15,56,575.08,362
,20160811,10275,10265,10300,10420,10300,10420,10385,155,120,10,103.86,362
,20160812,10420,10385,10500,10560,10460,10540,10540,155,155,132,"1,391.30",446
,20160815,10540,10540,,,,10540,10540,0,0,0,0.00,446
ru1609,20160104,10400,10440,10420,10470,10040,10085,10165,-355,-275,69622,"707,796.81",88858
,20160105,10085,10165,10110,10150,10025,10110,10095,-55,-70,55818,"563,747.21",93060
,20160106,10110,10095,10095,10170,10025,10085,10100,-10,5,78136,"789,200.66",95302
,20160107,10085,10100,10030,10195,10010,10105,10105,5,5,93660,"946,698.17",92988
,20160108,10105,10105,10065,10185,10025,10100,10105,-5,0,75046,"758,561.02",94118
,20160111,10100,10105,10115,10180,9860,9870,10060,-235,-45,98460,"990,962.91",88244
,20160112,9870,10060,9855,9915,9705,9725,9820,-335,-240,60202,"591,223.13",87616
,20160113,9725,9820,9885,9985,9815,9980,9915,160,95,62868,"623,631.44",86466
,20160114,9980,9915,9950,10030,9835,9990,9945,75,30,52936,"526,474.92",86508
,20160115,9990,9945,9975,10080,9905,9925,9995,-20,50,55594,"555,847.47",86314
,20160118,9925,9995,9850,10200,9805,10150,10065,155,70,83234,"837,876.01",84974
,20160119,10150,10065,10140,10390,10080,10360,10220,295,155,76288,"779,913.79",86234
,20160120,10360,10220,10385,10395,10215,10275,10300,55,80,62298,"641,890.48",86048
,20160121,10275,10300,10220,10295,10180,10220,10225,-80,-75,67362,"689,096.90",89816
,20160122,10220,10225,10265,10440,10205,10405,10355,180,130,76894,"796,321.46",88634
,20160125,10405,10355,10430,10520,10285,10345,10385,-10,30,55448,"575,939.13",90558
,20160126,10345,10385,10300,10350,10210,10235,10265,-150,-120,54126,"555,740.91",95234
,20160127,10235,10265,10280,10405,10260,10385,10345,120,80,60748,"628,460.01",98498
,20160128,10385,10345,10380,10415,10215,10225,10315,-120,-30,53820,"555,230.90",101458
,20160129,10225,10315,10220,10350,10180,10260,10250,-55,-65,62734,"643,307.68",103122
,20160201,10260,10250,10260,10360,10185,10245,10285,-5,35,63654,"654,802.69",101624
,20160202,10245,10285,10280,10280,10140,10265,10215,-20,-70,52740,"538,943.63",101122
,20160203,10265,10215,10275,10295,10160,10205,10210,-10,-5,44206,"451,484.38",102200
,20160204,10205,10210,10225,10390,10205,10370,10315,160,105,59902,"618,081.16",96392
,20160205,10370,10315,10330,10345,10205,10265,10280,-50,-35,32720,"336,459.52",96704
,20160215,10265,10280,10200,10565,10150,10560,10380,280,100,61290,"636,361.19",101982
,20160216,10560,10380,10560,10685,10525,10585,10595,205,215,77746,"823,815.35",103422
,20160217,10585,10595,10565,10595,10460,10500,10525,-95,-70,49370,"519,801.99",102668
,20160218,10500,10525,10525,10665,10520,10565,10575,40,50,61828,"654,039.44",109816
,20160219,10565,10575,10565,10770,10485,10760,10625,185,50,91546,"972,918.78",117036
,20160222,10760,10625,10750,11020,10700,10880,10865,255,240,107090,"1,164,021.12",121624
,20160223,10880,10865,10945,10975,10760,10840,10855,-25,-10,78028,"847,041.62",120210
,20160224,10840,10855,10840,10865,10705,10760,10790,-95,-65,82194,"887,011.01",122714
,20160225,10760,10790,10740,10975,10705,10720,10850,-70,60,109750,"1,191,006.29",122946
,20160226,10720,10850,10735,10760,10420,10525,10610,-325,-240,123466,"1,310,415.18",119236
,20160229,10525,10610,10585,10670,10465,10540,10565,-70,-45,135734,"1,434,080.67",127288
,20160301,10540,10565,10565,10660,10475,10625,10570,60,5,124490,"1,316,094.49",135724
,20160302,10625,10570,10645,10910,10615,10830,10785,260,215,190424,"2,053,920.92",148788
,20160303,10830,10785,10860,11060,10830,10965,10955,180,170,208782,"2,287,952.61",159300
,20160304,10965,10955,11020,11610,10985,11610,11365,655,410,327102,"3,718,906.91",173412
,20160307,11610,11365,11745,12385,11700,11935,11935,570,570,411346,"4,909,693.89",163282
,20160308,11935,11935,11930,12185,11575,11815,11870,-120,-65,406608,"4,827,095.14",160444
,20160309,11815,11870,11800,11815,11305,11590,11555,-280,-315,272170,"3,145,895.49",158108
,20160310,11590,11555,11560,11870,11380,11415,11640,-140,85,294302,"3,425,793.35",166118
,20160311,11415,11640,11415,11720,11355,11625,11565,-15,-75,262700,"3,039,023.68",172022
,20160314,11625,11565,11600,11935,11510,11545,11755,-20,190,311168,"3,658,259.17",183366
,20160315,11545,11755,11520,11580,11230,11350,11395,-405,-360,331752,"3,780,416.78",172950
,20160316,11350,11395,11340,11565,11325,11550,11465,155,70,289252,"3,316,348.94",188762
,20160317,11550,11465,11585,11935,11555,11775,11725,310,260,426434,"5,001,761.36",207486
,20160318,11775,11725,11795,12110,11690,11700,11890,-25,165,674960,"8,028,502.63",221796
,20160321,11700,11890,11790,12050,11640,11845,11845,-45,-45,801300,"9,495,108.23",247508
,20160322,11845,11845,11900,11995,11755,11775,11865,-70,20,679382,"8,063,153.68",264848
,20160323,11775,11865,11800,11930,11550,11550,11760,-315,-105,696086,"8,187,220.90",273482
,20160324,11550,11760,11550,11660,11420,11505,11550,-255,-210,791522,"9,143,425.07",255304
,20160325,11505,11550,11490,11720,11460,11710,11625,160,75,565170,"6,572,688.26",262008
,20160328,11710,11625,11745,11935,11530,11540,11755,-85,130,734200,"8,630,671.28",262698
,20160329,11540,11755,11550,11680,11265,11310,11510,-445,-245,800266,"9,214,100.72",301262
,20160330,11310,11510,11335,11455,11250,11370,11360,-140,-150,717530,"8,152,978.49",303062
,20160331,11370,11360,11385,11495,11135,11370,11310,10,-50,788474,"8,918,283.73",305582
,20160401,11370,11310,11400,11565,11350,11440,11420,130,110,706596,"8,071,522.43",292184
,20160405,11440,11420,11405,11725,11310,11720,11570,300,150,649868,"7,519,086.30",315080
,20160406,11720,11570,11700,11765,11535,11615,11660,45,90,754984,"8,804,546.28",303120
,20160407,11615,11660,11550,11740,11540,11590,11650,-70,-10,606462,"7,066,262.22",310728
,20160408,11590,11650,11540,11660,11430,11650,11530,0,-120,771198,"8,894,664.91",306492
,20160411,11650,11530,11710,12220,11710,12220,12025,690,495,1113094,"13,387,900.25",340710
,20160412,12220,12025,12310,12430,12110,12425,12225,400,200,885342,"10,827,174.70",350038
,20160413,12425,12225,12500,12950,12380,12525,12645,300,420,1265352,"16,005,604.92",326980
,20160414,12525,12645,12480,12710,12470,12550,12575,-95,-70,804540,"10,117,737.76",327084
,20160415,12550,12575,12580,12740,12310,12350,12555,-225,-20,904940,"11,364,810.10",318930
,20160418,12350,12555,12320,12715,12260,12510,12515,-45,-40,892652,"11,174,671.61",328412
,20160419,12510,12515,12570,12870,12470,12740,12675,225,160,1080744,"13,701,912.06",320594
,20160420,12740,12675,12710,13295,12640,13170,12945,495,270,1621426,"20,996,350.06",318552
,20160421,13170,12945,13130,13670,12950,13445,13305,500,360,1390618,"18,504,359.67",315282
,20160422,13445,13305,13305,13480,12710,12930,13040,-375,-265,1254392,"16,359,043.98",284542
,20160425,12930,13040,12960,13450,12825,13055,13095,15,55,996268,"13,050,067.32",285208
,20160426,13055,13095,13065,13180,12865,13015,13040,-80,-55,844072,"11,008,562.02",284280
,20160427,13015,13040,13055,13245,12745,12945,13000,-95,-40,989580,"12,869,439.63",288514
,20160428,12945,13000,13000,13030,12585,12710,12800,-290,-200,896656,"11,480,947.03",275158
,20160429,12710,12800,12730,12905,12665,12755,12770,-45,-30,687952,"8,788,447.07",279086
,20160503,12755,12770,12600,13045,12550,13000,12820,230,50,637296,"8,171,332.02",308900
,20160504,13000,12820,12960,13035,12620,12725,12825,-95,5,735482,"9,435,983.80",296778
,20160505,12725,12825,12745,12825,12360,12360,12550,-465,-275,805118,"10,104,833.77",317444
,20160506,12360,12550,12435,12465,12150,12260,12290,-290,-260,796520,"9,789,517.73",304092
,20160509,12260,12290,12290,12420,11685,11785,12010,-505,-280,1046986,"12,579,012.10",299256
,20160510,11785,12010,11750,11960,11665,11895,11845,-115,-165,801594,"9,496,247.66",284028
,20160511,11895,11845,11905,12035,11735,11875,11895,30,50,759224,"9,032,054.68",297138
,20160512,11875,11895,11905,12015,11655,11800,11840,-95,-55,899328,"10,649,795.28",305370
,20160513,11800,11840,11795,11820,11150,11245,11420,-595,-420,1018986,"11,641,498.66",296730
,20160516,11245,11420,11215,11370,11110,11240,11265,-180,-155,697416,"7,859,584.18",303948
,20160517,11240,11265,11265,11390,11230,11355,11310,90,45,590762,"6,684,327.45",305712
,20160518,11355,11310,11320,11480,11035,11100,11265,-210,-45,884950,"9,971,340.77",321574
,20160519,11100,11265,11100,11180,10810,10845,11015,-420,-250,802596,"8,844,429.36",329682
,20160520,10845,11015,10795,10955,10755,10860,10865,-155,-150,641670,"6,972,936.16",335980
,20160523,10860,10865,10875,10920,10210,10295,10500,-570,-365,890038,"9,346,084.72",332734
,20160524,10295,10500,10320,10395,10220,10330,10330,-170,-170,540920,"5,588,172.21",336116
,20160525,10330,10330,10440,10455,10170,10255,10320,-75,-10,622680,"6,428,953.54",339098
,20160526,10255,10320,10320,10615,10270,10600,10420,280,100,702878,"7,325,436.31",334844
,20160527,10600,10420,10600,10685,10325,10535,10485,115,65,833422,"8,740,014.52",327808
,20160530,10535,10485,10510,10625,10390,10555,10515,70,30,653852,"6,877,913.60",326664
,20160531,10555,10515,10595,10700,10440,10455,10575,-60,60,707822,"7,487,209.78",343300
,20160601,10455,10575,10420,10460,10200,10245,10330,-330,-245,662828,"6,848,715.53",369598
,20160602,10245,10330,10240,10470,10145,10445,10350,115,20,622626,"6,445,660.05",354914
,20160603,10445,10350,10415,10575,10400,10515,10485,165,135,604786,"6,342,584.79",339398
,20160606,10515,10485,10595,10735,10470,10705,10600,220,115,644022,"6,827,962.08",340908
,20160607,10705,10600,10710,10750,10515,10560,10625,-40,25,536642,"5,702,050.15",352070
,20160608,10560,10625,10550,10575,10300,10455,10450,-170,-175,618652,"6,467,091.67",347888
,20160613,10455,10450,10355,10660,10275,10535,10545,85,95,538800,"5,681,660.32",356074
,20160614,10535,10545,10500,10700,10350,10355,10515,-190,-30,718564,"7,558,534.25",365648
,20160615,10355,10515,10355,10465,10315,10410,10400,-105,-115,562794,"5,853,095.61",373474
,20160616,10410,10400,10460,10595,10425,10500,10495,100,95,623540,"6,544,918.85",374620
,20160617,10500,10495,10490,10945,10320,10935,10600,440,105,1034276,"10,966,579.42",375522
,20160620,10935,10600,10945,11025,10860,10975,10940,375,340,733772,"8,027,922.68",367198
,20160621,10975,10940,10985,11085,10765,10835,10920,-105,-20,690966,"7,548,491.21",361464
,20160622,10835,10920,10805,11160,10800,11150,10960,230,40,661248,"7,247,606.75",374652
,20160623,11150,10960,11165,11195,10960,11035,11065,75,105,613858,"6,793,451.54",360996
,20160624,11035,11065,11100,11145,10775,10845,10960,-220,-105,880730,"9,654,346.36",348208
,20160627,10845,10960,10860,11355,10850,11270,11115,310,155,791246,"8,795,953.16",349972
,20160628,11270,11115,11210,11405,11110,11310,11265,195,150,766214,"8,632,356.72",352990
,20160629,11310,11265,11360,11425,11160,11250,11290,-15,25,716572,"8,090,239.43",351222
,20160630,11250,11290,11230,11520,11210,11425,11385,135,95,786070,"8,951,777.02",346216
,20160701,11425,11385,11410,11620,11305,11450,11460,65,75,770478,"8,832,316.26",338002
,20160704,11450,11460,11445,12135,11435,12075,11885,615,425,960566,"11,417,197.97",324720
,20160705,12075,11885,12100,12210,11590,11840,11885,-45,0,873444,"10,384,381.83",313060
,20160706,11840,11885,11800,11955,11170,11170,11450,-715,-435,897476,"10,280,066.66",313506
,20160707,11170,11450,11060,11380,10975,10985,11185,-465,-265,755692,"8,455,100.10",317452
,20160708,10985,11185,11010,11135,10540,10680,10825,-505,-360,763910,"8,271,806.56",317434
,20160711,10680,10825,10780,10960,10615,10880,10800,55,-25,584888,"6,317,778.52",312642
,20160712,10880,10800,10930,11100,10810,11000,10945,200,145,707402,"7,745,530.27",311054
,20160713,11000,10945,11065,11495,10965,11140,11210,195,265,988942,"11,088,983.49",299402
,20160714,11140,11210,11190,11250,10875,11210,11080,0,-130,785032,"8,699,692.24",292106
,20160715,11210,11080,11450,11550,11240,11405,11390,325,310,917242,"10,449,062.47",280216
,20160718,11405,11390,11465,11475,11100,11185,11265,-205,-125,661324,"7,451,697.77",277252
,20160719,11185,11265,11130,11385,11030,11355,11220,90,-45,755998,"8,483,497.51",280530
,20160720,11355,11220,11360,11660,11310,11445,11470,225,250,920826,"10,565,147.87",274732
,20160721,11445,11470,11435,11715,11320,11630,11575,160,105,761156,"8,813,849.74",278802
,20160722,11630,11575,11600,11695,11395,11420,11545,-155,-30,603388,"6,967,233.67",267640
,20160725,11420,11545,11430,11490,11055,11175,11220,-370,-325,690816,"7,754,015.83",263414
,20160726,11175,11220,11120,11185,10955,11145,11075,-75,-145,590852,"6,544,070.77",255776
,20160727,11145,11075,11140,11340,11105,11180,11205,105,130,545148,"6,111,068.35",240094
,20160728,11180,11205,11250,11320,11070,11255,11210,50,5,559444,"6,273,530.12",228912
,20160729,11255,11210,11270,11310,10800,10845,11055,-365,-155,602076,"6,658,704.15",218736
,20160801,10845,11055,10875,11060,10815,10985,10930,-70,-125,397280,"4,343,647.40",199616
,20160802,10985,10930,10950,10995,10835,10930,10900,0,-30,265048,"2,890,112.39",187836
,20160803,10930,10900,10980,11070,10860,10870,10965,-30,65,189020,"2,073,212.44",169842
,20160804,10870,10965,10880,10905,10545,10650,10725,-315,-240,158642,"1,701,441.90",160934
,20160805,10650,10725,10685,10755,10555,10625,10660,-100,-65,128760,"1,372,717.86",150000
,20160808,10625,10660,10665,10715,10555,10605,10645,-55,-15,114902,"1,223,458.36",137834
,20160809,10605,10645,10610,10650,10230,10390,10460,-255,-185,116684,"1,220,969.11",129610
,20160810,10390,10460,10385,10485,10325,10485,10410,25,-50,72040,"749,998.60",122032
,20160811,10485,10410,10515,10625,10445,10600,10540,190,130,64946,"684,599.04",115492
,20160812,10600,10540,10615,10730,10580,10730,10650,190,110,54596,"581,598.60",108454
,20160815,10730,10650,10730,10750,10550,10690,10675,40,25,50274,"536,701.05",101286
,20160816,10690,10675,10700,10740,10605,10660,10670,-15,-5,39668,"423,390.37",95692
,20160817,10660,10670,10645,10750,10620,10665,10680,-5,10,32960,"352,089.96",91210
,20160818,10665,10680,10645,10685,10570,10620,10615,-60,-65,27316,"289,988.37",86934
,20160819,10620,10615,10635,10730,10605,10660,10675,45,60,21370,"228,144.21",82822
,20160822,10660,10675,10600,10650,10445,10455,10530,-220,-145,23632,"248,923.76",77104
,20160823,10455,10530,10450,10510,10400,10415,10460,-115,-70,14626,"153,054.76",72698
,20160824,10415,10460,10425,10500,10410,10430,10450,-30,-10,11340,"118,545.39",68382
,20160825,10430,10450,10425,10475,10190,10255,10300,-195,-150,23858,"245,798.80",60762
,20160826,10255,10300,10280,10285,10210,10230,10245,-70,-55,12166,"124,684.76",58126
,20160829,10230,10245,10245,10255,10150,10205,10200,-40,-45,12952,"132,145.23",52804
,20160830,10205,10200,10215,10225,10040,10055,10150,-145,-50,19284,"195,771.36",42194
,20160831,10055,10150,10020,10125,9950,9975,10000,-175,-150,20314,"203,192.56",35484
,20160901,9975,10000,9995,10275,9985,10235,10115,235,115,9862,"99,755.64",32294
,20160902,10235,10115,10270,10400,10245,10320,10325,205,210,4210,"43,477.51",30466
,20160905,10320,10325,10335,10500,10335,10480,10450,155,125,4556,"47,610.72",28280
,20160906,10480,10450,10480,10480,10330,10425,10395,-25,-55,3632,"37,771.62",26654
,20160907,10425,10395,10385,10425,10330,10410,10380,15,-15,3024,"31,398.33",25168
,20160908,10410,10380,10415,10465,10350,10465,10400,85,20,6452,"67,114.52",22086
,20160909,10465,10400,10455,10460,10370,10400,10405,0,5,5014,"52,171.26",18844
,20160912,10400,10405,10395,10395,10000,10105,10175,-300,-230,7746,"78,824.86",14470
,20160913,10105,10175,9860,10210,9860,10190,10165,15,-10,790,"8,030.69",14368
,20160914,10190,10165,10230,10350,10220,10320,10280,155,115,896,"9,215.32",13970
,20160919,10320,10280,10320,10650,10320,10595,10530,315,250,1866,"19,651.11",13026
ru1610,20160104,10420,10465,10320,10320,10075,10140,10175,-325,-290,30,305.38,1110
,20160105,10140,10175,10145,10190,10100,10180,10145,5,-30,12,121.75,1110
,20160106,10180,10145,10215,10215,10215,10215,10215,70,70,2,20.43,1112
,20160107,10215,10215,10260,10260,10260,10260,10260,45,45,2,20.52,1114
,20160108,10260,10260,10220,10220,10220,10220,10220,-40,-40,2,20.44,1114
,20160111,10220,10220,10170,10230,10000,10000,10085,-220,-135,40,403.52,1106
,20160112,10000,10085,9915,9915,9820,9820,9845,-265,-240,24,236.38,1108
,20160113,9820,9845,9880,9995,9880,9960,9965,115,120,20,199.33,1106
,20160114,9960,9965,9990,10070,9990,10020,10015,55,50,8,80.15,1108
,20160115,10020,10015,10095,10095,10000,10000,10050,-15,35,6,60.32,1106
,20160118,10000,10050,9965,10200,9965,10200,10140,150,90,26,263.70,1106
,20160119,10200,10140,10160,10425,10160,10425,10265,285,125,12,123.18,1104
,20160120,10425,10265,10450,10640,10250,10330,10420,65,155,24,250.09,1102
,20160121,10330,10420,10280,10280,10240,10260,10255,-160,-165,8,82.06,1102
,20160122,10260,10255,10430,10430,10430,10430,10430,175,175,4,41.72,1100
,20160125,10430,10430,10530,10530,10380,10380,10445,-50,15,6,62.68,1100
,20160126,10380,10445,,,,10445,10445,0,0,0,0.00,1100
,20160127,10445,10445,,,,10525,10525,80,80,0,0.00,1100
,20160128,10525,10525,10425,10440,10300,10300,10365,-225,-160,10,103.68,1100
,20160129,10300,10365,10365,10365,10260,10295,10295,-70,-70,8,82.39,1096
,20160201,10295,10295,,,,10295,10295,0,0,0,0.00,1096
,20160202,10295,10295,,,,10225,10225,-70,-70,0,0.00,1096
,20160203,10225,10225,10275,10300,10270,10270,10295,45,70,52,535.34,1092
,20160204,10270,10295,10215,10430,10215,10430,10380,135,85,130,"1,349.76",1102
,20160205,10430,10380,10380,10380,10320,10320,10345,-60,-35,120,"1,241.52",1084
,20160215,10320,10345,10635,10635,10635,10635,10635,290,290,14,148.89,1098
,20160216,10635,10635,10710,10710,10595,10595,10605,-40,-30,26,275.79,1100
,20160217,10595,10605,10635,10660,10515,10515,10600,-90,-5,10,106.00,1100
,20160218,10515,10600,,,,10600,10600,0,0,0,0.00,1100
,20160219,10600,10600,10700,10730,10700,10720,10715,120,115,24,257.24,1088
,20160222,10720,10715,10765,11015,10750,10940,10790,225,75,84,906.54,1084
,20160223,10940,10790,10850,10885,10850,10885,10860,95,70,14,152.04,1084
,20160224,10885,10860,10875,10885,10800,10800,10840,-60,-20,44,477.06,1082
,20160225,10800,10840,10800,11000,10800,10870,10980,30,140,264,"2,899.49",1210
,20160226,10870,10980,10850,10850,10650,10650,10705,-330,-275,58,621.12,1206
,20160229,10650,10705,10620,10655,10550,10560,10630,-145,-75,26,276.43,1224
,20160301,10560,10630,10625,10660,10570,10580,10600,-50,-30,52,551.39,1222
,20160302,10580,10600,10795,10955,10755,10955,10860,355,260,40,434.56,1232
,20160303,10955,10860,11010,11060,11010,11040,11040,180,180,28,309.21,1212
,20160304,11040,11040,11325,11700,11280,11700,11530,660,490,530,"6,111.93",1470
,20160307,11700,11530,11775,12220,11755,11925,11925,395,395,174,"2,075.02",1428
,20160308,11925,11925,11980,12220,11800,11840,11970,-85,45,140,"1,675.95",1416
,20160309,11840,11970,11520,11695,11420,11675,11510,-295,-460,282,"3,245.83",1358
,20160310,11675,11510,11700,11900,11445,11445,11760,-65,250,86,"1,011.46",1364
,20160311,11445,11760,11440,11750,11440,11750,11700,-10,-60,26,304.25,1362
,20160314,11750,11700,11715,11935,11715,11790,11860,90,160,46,545.69,1368
,20160315,11790,11860,11470,11530,11375,11375,11435,-485,-425,98,"1,120.85",1356
,20160316,11375,11435,11430,11540,11410,11530,11460,95,25,1150,"13,183.44",766
,20160317,11530,11460,11540,11850,11540,11730,11675,270,215,130,"1,517.92",724
,20160318,11730,11675,11835,12075,11790,11850,11940,175,265,168,"2,006.44",796
,20160321,11850,11940,11765,12000,11700,11875,11875,-65,-65,560,"6,650.02",774
,20160322,11875,11875,11875,11970,11780,11780,11865,-95,-10,136,"1,614.20",770
,20160323,11780,11865,11840,11930,11645,11645,11825,-220,-40,152,"1,797.62",734
,20160324,11645,11825,11465,11655,11465,11520,11560,-305,-265,218,"2,520.93",798
,20160325,11520,11560,11665,11760,11640,11760,11700,200,140,814,"9,527.35",534
,20160328,11760,11700,11850,11900,11690,11690,11840,-10,140,94,"1,112.97",498
,20160329,11690,11840,11725,11725,11415,11415,11635,-425,-205,68,791.28,466
,20160330,11415,11635,11475,11550,11360,11435,11455,-200,-180,70,802.04,476
,20160331,11435,11455,11435,11545,11255,11370,11385,-85,-70,188,"2,141.10",446
,20160401,11370,11385,11485,11540,11440,11485,11490,100,105,46,528.76,452
,20160405,11485,11490,11610,11820,11515,11820,11640,330,150,32,372.53,446
,20160406,11820,11640,11770,11825,11625,11695,11720,55,80,110,"1,289.62",444
,20160407,11695,11720,11700,11800,11700,11740,11725,20,5,42,492.65,412
,20160408,11740,11725,11580,11655,11565,11655,11610,-70,-115,56,650.20,426
,20160411,11655,11610,11915,12305,11900,12305,12165,695,555,68,827.51,422
,20160412,12305,12165,12290,12305,12215,12305,12285,140,120,50,614.35,440
,20160413,12305,12285,12510,12940,12510,12560,12710,275,425,300,"3,813.99",464
,20160414,12560,12710,12595,12875,12560,12600,12665,-110,-45,1240,"15,708.25",354
,20160415,12600,12665,12695,12750,12475,12490,12630,-175,-35,160,"2,021.56",302
,20160418,12490,12630,12395,12770,12385,12690,12630,60,0,198,"2,501.37",312
,20160419,12690,12630,12785,12895,12620,12620,12820,-10,190,192,"2,461.56",308
,20160420,12620,12820,12730,13280,12730,13280,13050,460,230,374,"4,880.90",284
,20160421,13280,13050,13110,13630,13110,13550,13350,500,300,286,"3,818.73",266
,20160422,13550,13350,13355,13435,12850,12960,13080,-390,-270,618,"8,086.33",266
,20160425,12960,13080,13050,13465,12905,13090,13205,10,125,476,"6,286.40",264
,20160426,13090,13205,13150,13155,13005,13005,13105,-200,-100,94,"1,232.24",220
,20160427,13005,13105,13130,13265,12830,12915,13040,-190,-65,178,"2,321.37",196
,20160428,12915,13040,13065,13065,12740,12775,12855,-265,-185,104,"1,337.25",238
,20160429,12775,12855,12820,12910,12800,12825,12875,-30,20,94,"1,210.71",180
,20160503,12825,12875,12790,13060,12790,13030,12825,155,-50,266,"3,412.04",218
,20160504,13030,12825,13045,13050,12750,12800,12850,-25,25,70,899.76,194
,20160505,12800,12850,12800,12800,12450,12450,12620,-400,-230,160,"2,019.84",226
,20160506,12450,12620,12440,12440,12230,12310,12330,-310,-290,72,887.88,196
,20160509,12310,12330,12385,12405,11750,11750,12105,-580,-225,100,"1,210.91",196
,20160510,11750,12105,11875,12025,11805,12005,11930,-100,-175,78,930.59,186
,20160511,12005,11930,11960,12055,11910,11915,11935,-15,5,30,358.09,194
,20160512,11915,11935,11930,11985,11810,11985,11900,50,-35,100,"1,190.24",208
,20160513,11985,11900,11845,11855,11285,11365,11505,-535,-395,86,989.80,206
,20160516,11365,11505,11210,11440,11180,11355,11365,-150,-140,64,727.59,202
,20160517,11355,11365,11320,11350,11320,11350,11345,-15,-20,24,272.34,208
,20160518,11350,11345,11355,11515,11140,11145,11330,-200,-15,70,793.43,194
,20160519,11145,11330,11020,11135,10850,10945,11035,-385,-295,56,618.15,192
,20160520,10945,11035,10840,11020,10840,10940,10955,-95,-80,1220,"13,369.35",1158
,20160523,10940,10955,10960,10960,10295,10400,10690,-555,-265,174,"1,860.84",1176
,20160524,10400,10690,10445,10470,10415,10415,10440,-275,-250,28,292.45,1166
,20160525,10415,10440,10485,10505,10265,10300,10445,-140,5,56,585.04,1170
,20160526,10300,10445,10525,10525,10525,10525,10525,80,80,22,231.55,1172
,20160527,10525,10525,10655,10655,10435,10655,10550,130,25,76,802.02,1214
,20160530,10655,10550,10675,10675,10500,10630,10580,80,30,58,613.69,1190
,20160531,10630,10580,10755,10770,10610,10645,10650,65,70,42,447.44,1190
,20160601,10645,10650,10365,10435,10365,10435,10425,-215,-225,28,291.94,1190
,20160602,10435,10425,10360,10530,10250,10495,10405,70,-20,62,645.18,1240
,20160603,10495,10405,10525,10695,10520,10530,10610,125,205,166,"1,761.66",1224
,20160606,10530,10610,10650,10800,10595,10800,10670,190,60,64,683.07,1218
,20160607,10800,10670,10820,10820,10625,10645,10720,-25,50,74,793.52,1198
,20160608,10645,10720,10645,10645,10460,10590,10510,-130,-210,16,168.19,1198
,20160613,10590,10510,10480,10720,10480,10630,10660,120,150,1072,"11,430.96",252
,20160614,10630,10660,10665,10755,10480,10480,10625,-180,-35,406,"4,314.35",330
,20160615,10480,10625,10455,10530,10430,10510,10480,-115,-145,50,524.10,320
,20160616,10510,10480,10590,10650,10535,10535,10580,55,100,102,"1,079.17",272
,20160617,10535,10580,10580,11010,10410,11005,10645,425,65,146,"1,554.29",280
,20160620,11005,10645,10950,11095,10950,11050,11020,405,375,48,529.09,276
,20160621,11050,11020,11095,11140,10860,10875,11015,-145,-5,82,903.24,294
,20160622,10875,11015,11095,11195,11095,11195,11145,180,130,22,245.22,288
,20160623,11195,11145,11295,11295,11080,11120,11260,-25,115,1098,"12,365.76",1216
,20160624,11120,11260,11285,11285,10880,10945,11135,-315,-125,170,"1,893.65",1220
,20160627,10945,11135,10995,11440,10995,11350,11290,215,155,60,677.65,1218
,20160628,11350,11290,11370,11505,11215,11410,11355,120,65,128,"1,453.63",1218
,20160629,11410,11355,11465,11465,11270,11320,11360,-35,5,30,340.86,1216
,20160630,11320,11360,11400,11590,11335,11530,11495,170,135,162,"1,862.92",1234
,20160701,11530,11495,11430,11700,11430,11560,11540,65,45,190,"2,192.93",1232
,20160704,11560,11540,11605,12230,11570,12155,12050,615,510,280,"3,374.89",1226
,20160705,12155,12050,12275,12325,11760,12000,12050,-50,0,92,"1,108.62",1244
,20160706,12000,12050,11810,11810,11325,11330,11545,-720,-505,142,"1,639.40",1228
,20160707,11330,11545,11175,11470,11100,11125,11175,-420,-370,82,916.55,1256
,20160708,11125,11175,11160,11160,10700,10750,10990,-425,-185,140,"1,538.68",1278
,20160711,10750,10990,10860,11050,10750,10965,10895,-25,-95,86,937.21,1274
,20160712,10965,10895,11085,11205,10935,11125,11070,230,175,48,531.55,1274
,20160713,11125,11070,11165,11610,11105,11200,11325,130,255,262,"2,968.03",1226
,20160714,11200,11325,11275,11370,11000,11300,11185,-25,-140,140,"1,566.59",1250
,20160715,11300,11185,11510,11600,11435,11470,11510,285,325,106,"1,220.07",1206
,20160718,11470,11510,11490,11490,11220,11265,11320,-245,-190,58,656.65,1214
,20160719,11265,11320,11230,11400,11200,11400,11240,80,-80,50,562.07,1214
,20160720,11400,11240,11450,11755,11450,11575,11505,335,265,740,"8,514.91",1180
,20160721,11575,11505,11515,11780,11460,11765,11555,260,50,102,"1,178.96",1180
,20160722,11765,11555,11800,11815,11545,11545,11655,-10,100,60,699.48,1170
,20160725,11545,11655,11545,11550,11200,11270,11330,-385,-325,130,"1,473.46",1226
,20160726,11270,11330,11235,11245,11050,11210,11150,-120,-180,420,"4,683.27",1284
,20160727,11210,11150,11225,11380,11225,11240,11285,90,135,36,406.35,1274
,20160728,11240,11285,11310,11405,11245,11345,11310,60,25,1060,"11,993.72",750
,20160729,11345,11310,11315,11340,10895,10895,11130,-415,-180,136,"1,514.17",650
,20160801,10895,11130,10985,11165,10980,11115,11050,-15,-80,378,"4,178.34",708
,20160802,11115,11050,11055,11100,10970,11030,11030,-20,-20,132,"1,456.45",708
,20160803,11030,11030,11040,11185,10750,10995,11060,-35,30,190,"2,101.48",630
,20160804,10995,11060,11000,11000,10710,10775,10880,-285,-180,64,696.59,640
,20160805,10775,10880,10795,10825,10700,10805,10755,-75,-125,76,817.69,620
,20160808,10805,10755,10760,10835,10695,10815,10780,60,25,202,"2,177.63",650
,20160809,10815,10780,10795,10795,10385,10495,10680,-285,-100,538,"5,747.18",680
,20160810,10495,10680,10515,10605,10495,10605,10550,-75,-130,16,168.80,680
,20160811,10605,10550,10635,10710,10600,10695,10660,145,110,68,724.96,660
,20160812,10695,10660,10755,10855,10705,10815,10795,155,135,652,"7,038.38",600
,20160815,10815,10795,10800,10880,10655,10850,10790,55,-5,68,733.79,594
,20160816,10850,10790,10835,10885,10745,10805,10805,15,15,150,"1,621.47",552
,20160817,10805,10805,10805,10860,10750,10810,10830,5,25,700,"7,582.14",1142
,20160818,10810,10830,10840,10845,10710,10745,10785,-85,-45,188,"2,028.02",1114
,20160819,10745,10785,10795,10855,10790,10790,10815,5,30,146,"1,579.14",1092
,20160822,10790,10815,10770,10770,10520,10555,10640,-260,-175,728,"7,748.35",582
,20160823,10555,10640,10580,10610,10510,10510,10555,-130,-85,100,"1,055.59",532
,20160824,10510,10555,10515,10595,10490,10500,10525,-55,-30,14,147.35,534
,20160825,10500,10525,10535,10545,10290,10290,10350,-235,-175,146,"1,511.12",502
,20160826,10290,10350,10285,10325,10285,10325,10300,-25,-50,10,103.04,498
,20160829,10325,10300,10290,10325,10200,10305,10270,5,-30,58,595.86,482
,20160830,10305,10270,10325,10325,10140,10140,10270,-130,0,84,862.91,482
,20160831,10140,10270,10160,10210,9970,10085,10130,-185,-140,196,"1,985.51",546
,20160901,10085,10130,10145,10340,10115,10340,10185,210,55,126,"1,283.77",540
,20160902,10340,10185,10295,10465,10280,10390,10395,205,210,112,"1,164.25",548
,20160905,10390,10395,10500,10570,10475,10510,10530,115,135,38,400.32,540
,20160906,10510,10530,10510,10510,10475,10475,10480,-55,-50,16,167.72,538
,20160907,10475,10480,10495,10495,10495,10495,10495,15,15,4,41.98,538
,20160908,10495,10495,10510,10575,10510,10575,10520,80,25,10,105.23,540
,20160909,10575,10520,10520,10570,10475,10475,10525,-45,5,16,168.46,538
,20160912,10475,10525,10465,10465,10160,10180,10250,-345,-275,114,"1,168.83",560
,20160913,10180,10250,10245,10300,10205,10260,10265,10,15,34,349.10,562
,20160914,10260,10265,10340,10420,10320,10380,10395,115,130,50,519.83,560
,20160919,10380,10395,10440,10735,10440,10690,10640,295,245,102,"1,085.45",562
,20160920,10690,10640,10660,10855,10660,10835,10800,195,160,44,475.33,562
,20160921,10835,10800,10940,10940,10840,10940,10900,140,100,152,"1,657.16",562
,20160922,10940,10900,10910,11345,10910,11285,11105,385,205,100,"1,110.68",562
,20160923,11285,11105,11260,11350,11135,11350,11225,245,120,118,"1,324.67",484
,20160926,11350,11225,11015,11295,11015,11270,11170,45,-55,38,424.62,482
,20160927,11270,11170,11060,11100,10910,11090,11015,-80,-155,56,616.84,468
,20160928,11090,11015,11005,11275,10995,11240,11100,225,85,126,"1,399.13",468
,20160929,11240,11100,11235,11450,11225,11260,11350,160,250,74,840.21,470
,20160930,11260,11350,11260,11260,11050,11050,11250,-300,-100,120,"1,350.04",470
,20161010,11050,11250,11450,11595,11450,11575,11520,325,270,16,184.37,466
,20161011,11575,11520,11905,11980,11635,11975,11900,455,380,90,"1,071.23",460
,20161012,11975,11900,11850,11960,11810,11870,11865,-30,-35,182,"2,160.03",312
,20161013,11870,11865,11800,11845,11730,11730,11760,-135,-105,42,494.06,328
,20161014,11730,11760,12120,12125,12120,12120,12120,360,360,28,339.41,336
,20161017,12120,12120,12120,12120,12000,12000,12095,-120,-25,60,725.72,290
ru1611,20160104,10430,10460,10310,10340,10110,10160,10195,-300,-265,208,"2,121.24",1348
,20160105,10160,10195,10210,10210,10060,10200,10180,5,-15,132,"1,343.98",1412
,20160106,10200,10180,10150,10205,10105,10180,10170,0,-10,126,"1,281.68",1402
,20160107,10180,10170,10145,10250,10070,10160,10145,-10,-25,122,"1,237.85",1400
,20160108,10160,10145,10110,10225,10070,10175,10135,30,-10,74,750.28,1394
,20160111,10175,10135,10215,10240,9965,9965,10140,-170,5,194,"1,967.72",1374
,20160112,9965,10140,9905,9990,9795,9830,9895,-310,-245,130,"1,286.59",1404
,20160113,9830,9895,9980,10055,9935,10040,10000,145,105,202,"2,020.18",1402
,20160114,10040,10000,10005,10065,9890,10065,9990,65,-10,62,619.63,1374
,20160115,10065,9990,10015,10145,9955,9955,10005,-35,15,294,"2,941.93",1390
,20160118,9955,10005,9890,10230,9890,10200,10075,195,70,144,"1,451.11",1376
,20160119,10200,10075,10225,10440,10140,10410,10300,335,225,316,"3,256.35",1382
,20160120,10410,10300,10405,10435,10280,10345,10355,45,55,250,"2,589.22",1358
,20160121,10345,10355,10285,10335,10220,10235,10270,-120,-85,108,"1,109.46",1360
,20160122,10235,10270,10430,10435,10375,10395,10415,125,145,34,354.21,1348
,20160125,10395,10415,10520,10520,10335,10380,10375,-35,-40,110,"1,141.61",1386
,20160126,10380,10375,10315,10375,10255,10255,10335,-120,-40,48,496.11,1368
,20160127,10255,10335,10365,10430,10355,10385,10385,50,50,38,394.68,1354
,20160128,10385,10385,10445,10445,10255,10255,10330,-130,-55,72,744.05,1364
,20160129,10255,10330,10370,10370,10220,10340,10305,10,-25,64,659.71,1382
,20160201,10340,10305,10345,10380,10250,10250,10330,-55,25,70,723.36,1372
,20160202,10250,10330,10250,10315,10205,10315,10255,-15,-75,26,266.73,1372
,20160203,10315,10255,10255,10320,10255,10320,10280,65,25,12,123.39,1376
,20160204,10320,10280,10195,10420,10190,10420,10355,140,75,156,"1,616.09",1350
,20160205,10420,10355,10400,10400,10295,10350,10340,-5,-15,164,"1,696.05",1384
,20160215,10350,10340,10275,10565,10275,10565,10380,225,40,90,934.37,1358
,20160216,10565,10380,10560,10695,10560,10600,10650,220,270,124,"1,320.68",1336
,20160217,10600,10650,10560,10620,10500,10525,10575,-125,-75,74,782.60,1342
,20160218,10525,10575,10585,10735,10585,10605,10670,30,95,80,853.77,1348
,20160219,10605,10670,10610,10800,10600,10800,10730,130,60,70,751.33,1348
,20160222,10800,10730,10775,11000,10740,10955,10925,225,195,120,"1,311.47",1374
,20160223,10955,10925,10995,11005,10870,10900,10915,-25,-10,128,"1,397.75",1398
,20160224,10900,10915,10910,10940,10800,10835,10845,-80,-70,64,694.36,1394
,20160225,10835,10845,10930,11050,10815,10830,10970,-15,125,126,"1,382.42",1442
,20160226,10830,10970,10850,10850,10600,10660,10715,-310,-255,116,"1,243.42",1452
,20160229,10660,10715,10720,10720,10515,10585,10650,-130,-65,62,660.60,1462
,20160301,10585,10650,10675,10750,10650,10750,10675,100,25,66,704.85,1460
,20160302,10750,10675,10770,11020,10760,10925,10895,250,220,56,610.26,1458
,20160303,10925,10895,11095,11200,11015,11045,11070,150,175,70,774.93,1418
,20160304,11045,11070,11125,11730,11110,11730,11500,660,430,522,"6,004.66",1632
,20160307,11730,11500,11830,12190,11785,12000,11985,500,485,404,"4,842.87",1604
,20160308,12000,11985,12250,12275,11655,11905,11840,-80,-145,264,"3,126.44",1612
,20160309,11905,11840,11825,11825,11345,11645,11595,-195,-245,182,"2,110.89",1630
,20160310,11645,11595,11765,11835,11485,11485,11745,-110,150,132,"1,550.77",1682
,20160311,11485,11745,11580,11780,11570,11755,11695,10,-50,46,537.98,1688
,20160314,11755,11695,11795,11940,11645,11645,11855,-50,160,146,"1,731.04",1680
,20160315,11645,11855,11640,11645,11300,11475,11480,-380,-375,94,"1,079.19",1646
,20160316,11475,11480,11515,12120,11375,11520,11465,40,-15,1244,"14,262.84",1248
,20160317,11520,11465,11580,11800,11580,11800,11750,335,285,144,"1,692.57",1174
,20160318,11800,11750,11710,12080,11710,11835,11945,85,195,154,"1,839.86",1204
,20160321,11835,11945,11800,12085,11695,11950,11940,5,-5,196,"2,340.65",1236
,20160322,11950,11940,12000,12025,11840,11860,11905,-80,-35,126,"1,500.08",1258
,20160323,11860,11905,11810,11960,11630,11630,11830,-275,-75,228,"2,698.23",1252
,20160324,11630,11830,11560,11715,11510,11570,11605,-260,-225,138,"1,601.67",1276
,20160325,11570,11605,11640,11800,11610,11800,11745,195,140,702,"8,247.03",1222
,20160328,11800,11745,11900,12060,11675,11720,11925,-25,180,210,"2,505.19",1232
,20160329,11720,11925,11760,11790,11445,11455,11700,-470,-225,202,"2,363.98",1236
,20160330,11455,11700,11505,11575,11420,11550,11495,-150,-205,130,"1,494.81",1236
,20160331,11550,11495,11595,11630,11285,11470,11415,-25,-80,210,"2,397.70",1224
,20160401,11470,11415,11515,11620,11505,11585,11555,170,140,92,"1,063.45",1196
,20160405,11585,11555,11625,11820,11560,11790,11710,235,155,128,"1,499.39",1194
,20160406,11790,11710,11830,11880,11700,11700,11785,-10,75,92,"1,084.22",1174
,20160407,11700,11785,11690,11845,11690,11760,11800,-25,15,120,"1,416.09",1162
,20160408,11760,11800,11680,11750,11590,11750,11670,-50,-130,62,723.82,1166
,20160411,11750,11670,11920,12345,11920,12310,12210,640,540,202,"2,466.45",1120
,20160412,12310,12210,12330,12450,12270,12435,12345,225,135,62,765.39,1132
,20160413,12435,12345,12550,13085,12475,12630,12885,285,540,516,"6,649.45",1148
,20160414,12630,12885,12685,12830,12630,12650,12700,-235,-185,188,"2,388.45",1154
,20160415,12650,12700,12725,12825,12440,12465,12695,-235,-5,348,"4,419.46",1108
,20160418,12465,12695,12375,12785,12375,12710,12655,15,-40,316,"3,999.47",1252
,20160419,12710,12655,12760,12945,12630,12875,12810,220,155,170,"2,178.48",1248
,20160420,12875,12810,12885,13380,12780,13300,13120,490,310,194,"2,545.31",1250
,20160421,13300,13120,13250,13750,13150,13615,13360,495,240,316,"4,222.52",1150
,20160422,13615,13360,13600,13600,12860,13025,13080,-335,-280,406,"5,310.75",1138
,20160425,13025,13080,13250,13550,12940,13100,13160,20,80,110,"1,447.82",1092
,20160426,13100,13160,13175,13285,12990,13110,13140,-50,-20,80,"1,051.56",1114
,20160427,13110,13140,13235,13260,12890,13060,13100,-80,-40,98,"1,283.80",1112
,20160428,13060,13100,12870,12990,12740,12865,12920,-235,-180,164,"2,119.07",1178
,20160429,12865,12920,12860,12975,12830,12900,12885,-20,-35,202,"2,603.70",1160
,20160503,12900,12885,12760,13160,12760,13125,12975,240,90,242,"3,140.97",1256
,20160504,13125,12975,13125,13140,12800,12865,12965,-110,-10,164,"2,126.34",1320
,20160505,12865,12965,12935,12945,12545,12550,12680,-415,-285,160,"2,029.28",1382
,20160506,12550,12680,12560,12580,12350,12410,12415,-270,-265,156,"1,937.48",1350
,20160509,12410,12415,12490,12540,11825,11925,12065,-490,-350,230,"2,775.83",1374
,20160510,11925,12065,11900,12090,11830,12020,11960,-45,-105,176,"2,105.43",1344
,20160511,12020,11960,12050,12160,11890,12020,12035,60,75,192,"2,311.58",1414
,20160512,12020,12035,12020,12100,11850,12030,11935,-5,-100,158,"1,885.84",1372
,20160513,12030,11935,11935,11935,11285,11425,11520,-510,-415,260,"2,995.47",1392
,20160516,11425,11520,11260,11495,11260,11355,11390,-165,-130,116,"1,321.80",1366
,20160517,11355,11390,11430,11510,11390,11510,11435,120,45,88,"1,006.60",1392
,20160518,11510,11435,11475,11595,11220,11250,11290,-185,-145,1208,"13,638.80",2370
,20160519,11250,11290,11185,11305,10995,10995,11185,-295,-105,582,"6,511.11",2392
,20160520,10995,11185,10950,11095,10950,11050,11000,-135,-185,208,"2,288.44",2420
,20160523,11050,11000,11050,11050,10370,10485,10645,-515,-355,256,"2,726.03",2482
,20160524,10485,10645,10440,10525,10400,10495,10485,-150,-160,70,734.00,2482
,20160525,10495,10485,10495,10610,10360,10400,10470,-85,-15,322,"3,372.57",2502
,20160526,10400,10470,10475,10770,10475,10770,10605,300,135,102,"1,081.73",2502
,20160527,10770,10605,10750,10800,10530,10700,10655,95,50,154,"1,641.31",2524
,20160530,10700,10655,10715,10755,10600,10720,10670,65,15,84,896.35,2514
,20160531,10720,10670,10780,10850,10650,10650,10750,-20,80,122,"1,311.94",2538
,20160601,10650,10750,10640,10640,10400,10405,10495,-345,-255,126,"1,322.83",2570
,20160602,10405,10495,10350,10630,10350,10630,10525,135,30,154,"1,620.97",2600
,20160603,10630,10525,10620,10750,10580,10715,10675,190,150,120,"1,281.26",2592
,20160606,10715,10675,10720,10970,10670,10920,10845,245,170,322,"3,492.56",2758
,20160607,10920,10845,10930,10940,10730,10765,10830,-80,-15,242,"2,621.00",2820
,20160608,10765,10830,10745,10745,10475,10645,10650,-185,-180,426,"4,538.38",2816
,20160613,10645,10650,10500,10840,10500,10750,10750,100,100,1938,"20,835.34",2386
,20160614,10750,10750,10735,10890,10560,10560,10690,-190,-60,1266,"13,538.14",3218
,20160615,10560,10690,10505,10655,10465,10630,10595,-60,-95,1802,"19,098.93",4458
,20160616,10630,10595,10710,10780,10635,10680,10700,85,105,960,"10,273.70",5008
,20160617,10680,10700,10700,11105,10515,11090,10745,390,45,1530,"16,439.96",5598
,20160620,11090,10745,11095,11215,11050,11185,11145,440,400,3246,"36,190.34",7518
,20160621,11185,11145,11155,11270,10970,11020,11095,-125,-50,1114,"12,360.30",7566
,20160622,11020,11095,11020,11335,10995,11335,11160,240,65,376,"4,196.58",7526
,20160623,11335,11160,11400,11500,11155,11225,11290,65,130,862,"9,733.05",7790
,20160624,11225,11290,11310,11330,10985,11055,11185,-235,-105,988,"11,051.47",7620
,20160627,11055,11185,11060,11530,11060,11465,11295,280,110,758,"8,565.06",7668
,20160628,11465,11295,11380,11600,11305,11485,11465,190,170,1060,"12,156.85",8056
,20160629,11485,11465,11565,11605,11350,11425,11505,-40,40,1476,"16,986.52",8058
,20160630,11425,11505,11425,11700,11405,11610,11620,105,115,2416,"28,078.29",8744
,20160701,11610,11620,11585,11800,11505,11640,11660,20,40,2096,"24,440.97",9546
,20160704,11640,11660,11675,12330,11675,12320,11990,660,330,2416,"28,978.82",10488
,20160705,12320,11990,12335,12405,11800,12020,12130,30,140,2568,"31,160.76",11338
,20160706,12020,12130,12010,12135,11400,11400,11610,-730,-520,1868,"21,696.58",11844
,20160707,11400,11610,11225,12650,11120,11195,11420,-415,-190,1874,"21,403.27",12202
,20160708,11195,11420,11260,11315,10735,10845,10990,-575,-430,2326,"25,573.63",11986
,20160711,10845,10990,10945,11150,10810,11055,11015,65,25,1038,"11,436.78",12002
,20160712,11055,11015,11070,11270,11000,11170,11120,155,105,2206,"24,537.39",12418
,20160713,11170,11120,11240,11650,11150,11295,11385,175,265,2138,"24,347.09",12484
,20160714,11295,11385,11350,11420,11055,11400,11220,15,-165,3318,"37,239.10",12318
,20160715,11400,11220,11510,11700,11440,11580,11560,360,340,1858,"21,482.64",12214
,20160718,11580,11560,11620,11640,11280,11355,11430,-205,-130,1998,"22,845.25",12828
,20160719,11355,11430,11310,11560,11210,11540,11415,110,-15,1908,"21,786.74",13152
,20160720,11540,11415,11530,11850,11495,11620,11685,205,270,4856,"56,753.57",12808
,20160721,11620,11685,11595,11895,11520,11800,11790,115,105,2162,"25,494.10",12820
,20160722,11800,11790,11785,11870,11565,11600,11710,-190,-80,1696,"19,863.05",13128
,20160725,11600,11710,11595,11655,11200,11250,11320,-460,-390,3488,"39,487.18",14586
,20160726,11250,11320,11220,11285,10955,11135,11100,-185,-220,5668,"62,940.50",16640
,20160727,11135,11100,11050,11340,11050,11210,11215,110,115,2742,"30,752.37",16380
,20160728,11210,11215,11210,11345,11165,11270,11250,55,35,2704,"30,431.25",16410
,20160729,11270,11250,11300,11325,10865,10905,11085,-345,-165,2494,"27,653.11",16792
,20160801,10905,11085,10905,11195,10900,11135,11060,50,-25,2796,"30,927.12",17552
,20160802,11135,11060,11005,11175,11000,11075,11055,15,-5,3536,"39,096.10",18104
,20160803,11075,11055,11150,11250,11040,11045,11140,-10,85,2390,"26,626.28",18204
,20160804,11045,11140,11050,11095,10735,10850,10905,-290,-235,3566,"38,902.32",19008
,20160805,10850,10905,10845,10960,10755,10845,10870,-60,-35,4376,"47,581.28",19022
,20160808,10845,10870,10855,10910,10765,10830,10850,-40,-20,6478,"70,315.65",19700
,20160809,10830,10850,10840,10855,10410,10590,10665,-260,-185,8820,"94,081.05",21572
,20160810,10590,10665,10600,10675,10535,10670,10605,5,-60,5912,"62,707.40",21280
,20160811,10670,10605,10685,10800,10625,10735,10720,130,115,6526,"69,985.77",20052
,20160812,10735,10720,10675,10925,10675,10925,10825,205,105,5822,"63,041.21",20938
,20160815,10925,10825,10890,10945,10745,10905,10880,80,55,7160,"77,907.05",22008
,20160816,10905,10880,10890,10940,10820,10870,10875,-10,-5,5988,"65,148.67",22766
,20160817,10870,10875,10915,10945,10830,10860,10880,-15,5,4804,"52,283.23",23288
,20160818,10860,10880,10880,10885,10785,10815,10815,-65,-65,3544,"38,341.41",23738
,20160819,10815,10815,10830,10920,10810,10855,10865,40,50,4120,"44,781.43",23498
,20160822,10855,10865,10815,10850,10640,10660,10735,-205,-130,5032,"54,031.07",23968
,20160823,10660,10735,10610,11375,10590,10590,10670,-145,-65,4030,"43,010.41",25094
,20160824,10590,10670,10600,10670,10600,10615,10625,-55,-45,1960,"20,828.22",24844
,20160825,10615,10625,10635,10645,10325,10420,10425,-205,-200,6450,"67,265.56",24586
,20160826,10420,10425,10420,10440,10350,10365,10385,-60,-40,4572,"47,486.25",24770
,20160829,10365,10385,10400,10425,10300,10395,10375,10,-10,3726,"38,674.20",25558
,20160830,10395,10375,10405,10420,10215,10235,10340,-140,-35,8016,"82,924.37",28324
,20160831,10235,10340,10230,10270,10150,10170,10190,-170,-150,5830,"59,431.68",28104
,20160901,10170,10190,10250,10470,10210,10445,10330,255,140,10394,"107,377.24",28818
,20160902,10445,10330,10480,10605,10410,10530,10525,200,195,5028,"52,942.72",28390
,20160905,10530,10525,10545,10700,10520,10645,10645,120,120,5016,"53,408.28",28030
,20160906,10645,10645,10650,10710,10515,10625,10590,-20,-55,3538,"37,481.49",28570
,20160907,10625,10590,10595,10640,10530,10625,10595,35,5,5110,"54,152.61",29232
,20160908,10625,10595,10625,10690,10575,10680,10625,85,30,5168,"54,921.87",30278
,20160909,10680,10625,10680,10705,10600,10625,10650,0,25,4684,"49,888.18",31386
,20160912,10625,10650,10615,10630,10310,10350,10465,-300,-185,8062,"84,402.83",31246
,20160913,10350,10465,10365,10445,10345,10425,10400,-40,-65,3112,"32,366.13",31402
,20160914,10425,10400,10450,10540,10430,10525,10490,125,90,3190,"33,463.33",30858
,20160919,10525,10490,10560,10870,10450,10845,10740,355,250,6194,"66,536.68",31902
,20160920,10845,10740,10850,11070,10835,11065,10975,325,235,6260,"68,726.65",31106
,20160921,11065,10975,11130,11130,10990,11085,11050,110,75,4492,"49,659.05",30270
,20160922,11085,11050,11050,11555,11035,11385,11360,335,310,11624,"132,076.22",29096
,20160923,11385,11360,11400,11495,11300,11475,11390,115,30,4992,"56,880.68",27714
,20160926,11475,11390,11380,11525,11330,11430,11405,40,15,5088,"58,052.81",27210
,20160927,11430,11405,11345,11380,11095,11230,11200,-175,-205,7130,"79,887.26",25882
,20160928,11230,11200,11325,11450,11170,11395,11350,195,150,7284,"82,682.19",25564
,20160929,11395,11350,11375,11650,11250,11290,11430,-60,80,7932,"90,698.01",24402
,20160930,11290,11430,11300,11320,11165,11245,11240,-185,-190,6154,"69,176.17",23434
,20161010,11245,11240,11600,11840,11455,11800,11670,560,430,6872,"80,201.09",22372
,20161011,11800,11670,11785,12150,11780,12150,12025,480,355,5598,"67,330.70",21948
,20161012,12150,12025,12050,12100,11910,12035,12010,10,-15,3708,"44,538.23",21402
,20161013,12035,12010,12000,12090,11830,11890,11925,-120,-85,3942,"47,019.22",20866
,20161014,11890,11925,11820,12310,11815,12230,12165,305,240,5994,"72,931.47",20492
,20161017,12230,12165,12250,12330,12100,12170,12200,5,35,3260,"39,774.53",20228
,20161018,12170,12200,12170,12180,12000,12170,12085,-30,-115,2708,"32,732.24",20006
,20161019,12170,12085,12130,12160,11495,11580,11800,-505,-285,5876,"69,346.13",20064
,20161020,11580,11800,11625,11720,11585,11605,11655,-195,-145,3284,"38,278.43",19430
,20161021,11605,11655,11605,11655,11400,11565,11485,-90,-170,4474,"51,389.39",18546
,20161024,11565,11485,11630,11840,11585,11785,11725,300,240,3236,"37,948.67",17888
,20161025,11785,11725,11805,12105,11780,11825,11960,100,235,3764,"45,021.73",17458
,20161026,11825,11960,11870,11920,11530,11870,11720,-90,-240,4006,"46,956.99",16920
,20161027,11870,11720,11870,12085,11750,12010,11935,290,215,4106,"49,014.40",16306
,20161028,12010,11935,12010,12275,11950,12040,12075,105,140,3628,"43,819.24",15860
,20161031,12040,12075,12040,12145,11870,11980,12010,-95,-65,4422,"53,118.20",14728
,20161101,11980,12010,11960,12170,11850,11955,11990,-55,-20,2338,"28,037.15",14008
,20161102,11955,11990,11920,12065,11750,11800,11860,-190,-130,2364,"28,040.03",13310
,20161103,11800,11860,11810,11835,11705,11830,11795,-30,-65,730,"8,612.76",13214
,20161104,11830,11795,11840,12080,11800,11835,11930,40,135,1196,"14,271.61",12872
,20161107,11835,11930,11820,12580,11810,12295,12200,365,270,1666,"20,326.25",12068
,20161108,12295,12200,12300,12900,12200,12890,12630,690,430,1764,"22,285.13",11694
,20161109,12890,12630,12930,13130,12800,12950,12965,320,335,1694,"21,966.38",11112
,20161110,12950,12965,13050,13495,12800,13400,13135,435,170,1154,"15,158.19",10622
,20161111,13400,13135,13920,13920,12515,13750,13535,615,400,352,"4,764.34",10466
,20161114,13750,13535,14000,14100,12780,13300,13230,-235,-305,626,"8,284.49",10234
,20161115,13300,13230,13300,14000,13265,13600,13590,370,360,502,"6,824.55",10194
ru1701,20160118,10005,10005,10200,11010,10200,10965,10735,960,730,2668,"28,643.50",1432
,20160119,10965,10735,10945,11290,10930,11270,11090,535,355,3912,"43,400.81",2624
,20160120,11270,11090,11305,11310,11105,11185,11205,95,115,1832,"20,527.58",2932
,20160121,11185,11205,11115,11205,11105,11120,11150,-85,-55,1546,"17,241.69",3044
,20160122,11120,11150,11160,11345,11125,11310,11285,160,135,1360,"15,349.54",3170
,20160125,11310,11285,11370,11405,11225,11285,11295,0,10,1142,"12,899.07",3306
,20160126,11285,11295,11225,11265,11185,11185,11215,-110,-80,1762,"19,763.37",4014
,20160127,11185,11215,11265,11405,11235,11400,11335,185,120,1986,"22,517.52",4492
,20160128,11400,11335,11380,11415,11190,11220,11330,-115,-5,2250,"25,493.62",5052
,20160129,11220,11330,11225,11325,11170,11260,11220,-70,-110,2112,"23,697.69",6002
,20160201,11260,11220,11290,11350,11200,11280,11280,60,60,962,"10,856.01",6054
,20160202,11280,11280,11270,11285,11160,11280,11220,0,-60,1082,"12,143.86",6174
,20160203,11280,11220,11280,11280,11170,11245,11215,25,-5,600,"6,731.89",6138
,20160204,11245,11215,11255,11475,11240,11460,11365,245,150,1672,"19,009.32",6452
,20160205,11460,11365,11415,11445,11335,11365,11390,0,25,646,"7,359.86",6526
,20160215,11365,11390,11320,11645,11255,11645,11470,255,80,1376,"15,783.21",6796
,20160216,11645,11470,11640,11725,11545,11600,11640,130,170,3642,"42,396.76",7120
,20160217,11600,11640,11585,11605,11475,11500,11535,-140,-105,1100,"12,689.57",7234
,20160218,11500,11535,11500,11665,11500,11590,11595,55,60,1152,"13,359.01",7480
,20160219,11590,11595,11590,11795,11540,11795,11650,200,55,1712,"19,952.39",7808
,20160222,11795,11650,11755,12005,11715,11895,11880,245,230,2710,"32,202.91",8026
,20160223,11895,11880,11915,11975,11800,11870,11855,-10,-25,1510,"17,907.05",8462
,20160224,11870,11855,11855,11900,11760,11805,11830,-50,-25,1374,"16,258.07",8496
,20160225,11805,11830,11815,12050,11780,11860,11955,30,125,2788,"33,342.19",8936
,20160226,11860,11955,11860,11900,11645,11690,11775,-265,-180,2428,"28,593.06",9446
,20160229,11690,11775,11755,11780,11570,11620,11655,-155,-120,6196,"72,241.42",11406
,20160301,11620,11655,11660,11770,11580,11735,11660,80,5,5938,"69,254.38",14258
,20160302,11735,11660,11760,12025,11725,11970,11905,310,245,5656,"67,344.02",15862
,20160303,11970,11905,12000,12185,11920,12105,12060,200,155,7946,"95,859.74",18122
,20160304,12105,12060,12150,12780,12130,12780,12560,720,500,10818,"135,883.30",19878
,20160307,12780,12560,12870,13635,12870,13110,13145,550,585,15104,"198,583.82",20464
,20160308,13110,13145,13130,13380,12790,12975,13060,-170,-85,13868,"181,117.61",20930
,20160309,12975,13060,13000,13000,12445,12815,12690,-245,-370,8800,"111,703.12",21278
,20160310,12815,12690,12805,13090,12600,12660,12840,-30,150,10236,"131,455.55",20872
,20160311,12660,12840,12690,12900,12560,12795,12745,-45,-95,7510,"95,728.70",22470
,20160314,12795,12745,12800,13095,12700,12700,12935,-45,190,7538,"97,518.89",23992
,20160315,12700,12935,12680,12755,12430,12535,12575,-400,-360,5716,"71,898.52",24304
,20160316,12535,12575,12510,12735,12495,12735,12615,160,40,6100,"76,972.84",25768
,20160317,12735,12615,12785,13080,12740,12920,12905,305,290,9834,"126,910.75",26056
,20160318,12920,12905,12975,13295,12930,12950,13105,45,200,14536,"190,563.73",26430
,20160321,12950,13105,12950,13320,12885,13195,13150,90,45,12450,"163,760.52",27862
,20160322,13195,13150,13230,13310,13065,13080,13200,-70,50,10836,"143,082.56",28572
,20160323,13080,13200,13100,13260,12885,12890,13110,-310,-90,13244,"173,652.53",28892
,20160324,12890,13110,12885,13030,12750,12900,12885,-210,-225,16502,"212,638.78",28124
,20160325,12900,12885,12900,13100,12860,13090,13015,205,130,12432,"161,858.78",28484
,20160328,13090,13015,13120,13300,12965,12970,13160,-45,145,18436,"242,630.58",29270
,20160329,12970,13160,13000,13140,12730,12770,12955,-390,-205,22530,"291,904.98",28960
,20160330,12770,12955,12795,12895,12675,12770,12780,-185,-175,19036,"243,372.89",28948
,20160331,12770,12780,12790,12890,12395,12645,12625,-135,-155,29798,"376,259.14",35356
,20160401,12645,12625,12680,12790,12620,12685,12690,60,65,17786,"225,769.15",35864
,20160405,12685,12690,12635,12940,12555,12920,12825,230,135,18678,"239,551.29",39720
,20160406,12920,12825,12950,13000,12765,12855,12900,30,75,21498,"277,409.06",41624
,20160407,12855,12900,12795,12985,12795,12855,12910,-45,10,14804,"191,169.92",42768
,20160408,12855,12910,12805,12875,12650,12870,12750,-40,-160,24598,"313,629.99",45500
,20160411,12870,12750,12890,13510,12890,13450,13270,700,520,42324,"561,797.99",49686
,20160412,13450,13270,12760,13650,12755,13640,13435,370,165,32614,"438,271.49",52626
,20160413,13640,13435,13645,14100,13580,13645,13810,210,375,65272,"901,730.78",54068
,20160414,13645,13810,13660,13850,13620,13685,13720,-125,-90,30432,"417,591.02",56574
,20160415,13685,13720,13700,13860,13440,13500,13700,-220,-20,41614,"570,272.37",58210
,20160418,13500,13700,13410,13830,13375,13620,13650,-80,-50,41082,"560,869.71",58142
,20160419,13620,13650,13700,13985,13610,13865,13795,215,145,49858,"687,872.87",57708
,20160420,13865,13795,13870,14435,13760,14305,14115,510,320,105876,"1,494,559.55",61626
,20160421,14305,14115,14370,14830,14000,14605,14440,490,325,108938,"1,573,335.71",61740
,20160422,14605,14440,14505,14625,13850,14070,14195,-370,-245,108310,"1,537,698.81",62366
,20160425,14070,14195,14135,14600,13960,14215,14225,20,30,87838,"1,249,722.99",58954
,20160426,14215,14225,14240,14330,14025,14190,14200,-35,-25,70104,"995,501.01",60038
,20160427,14190,14200,14205,14435,13905,14120,14185,-80,-15,74628,"1,058,894.21",62422
,20160428,14120,14185,14190,14200,13800,13935,14005,-250,-180,55944,"783,540.19",61598
,20160429,13935,14005,13980,14225,13955,14060,14085,55,80,62630,"882,251.94",64012
,20160503,14060,14085,13945,14395,13840,14370,14120,285,35,47424,"669,667.25",67050
,20160504,14370,14120,14315,14390,13990,14110,14190,-10,70,63080,"895,325.81",67056
,20160505,14110,14190,14135,14220,13750,13750,13930,-440,-260,67298,"937,675.50",68176
,20160506,13750,13930,13805,13865,13505,13620,13665,-310,-265,68584,"937,495.47",65736
,20160509,13620,13665,13625,13780,13045,13120,13395,-545,-270,86112,"1,153,742.24",64728
,20160510,13120,13395,13110,13325,13030,13270,13195,-125,-200,56258,"742,351.69",63840
,20160511,13270,13195,13270,13405,13090,13205,13245,10,50,49506,"655,743.57",64072
,20160512,13205,13245,13250,13320,13000,13120,13160,-125,-85,57138,"752,105.55",64876
,20160513,13120,13160,13115,13145,12430,12505,12720,-655,-440,81464,"1,036,489.05",64436
,20160516,12505,12720,12450,12650,12355,12515,12535,-205,-185,38980,"488,806.82",65104
,20160517,12515,12535,12520,12735,12520,12705,12630,170,95,45010,"568,548.39",65100
,20160518,12705,12630,12675,12770,12330,12385,12570,-245,-60,67498,"848,545.19",69112
,20160519,12385,12570,12360,12460,12085,12120,12290,-450,-280,60656,"745,643.87",71956
,20160520,12120,12290,12080,12270,12025,12165,12160,-125,-130,49430,"601,222.18",73448
,20160523,12165,12160,12190,12255,11440,11615,11795,-545,-365,78852,"930,124.94",73960
,20160524,11615,11795,11605,11740,11520,11700,11665,-95,-130,54736,"638,565.19",74890
,20160525,11700,11665,11770,11845,11550,11600,11700,-65,35,63658,"744,918.92",74528
,20160526,11600,11700,11700,12050,11640,12040,11835,340,135,66500,"787,103.24",76336
,20160527,12040,11835,12055,12175,11765,12020,11955,185,120,74490,"890,739.99",75844
,20160530,12020,11955,12015,12105,11825,12020,11970,65,15,65200,"780,668.23",76640
,20160531,12020,11970,12050,12155,11890,11905,12020,-65,50,58192,"699,670.70",76874
,20160601,11905,12020,11850,11905,11630,11680,11765,-340,-255,49944,"587,806.37",77052
,20160602,11680,11765,11670,11950,11585,11930,11820,165,55,48690,"575,623.50",77448
,20160603,11930,11820,11910,12090,11860,12050,11995,230,175,53900,"646,592.37",77422
,20160606,12050,11995,12110,12245,11980,12220,12120,225,125,58944,"714,577.07",76396
,20160607,12220,12120,12220,12265,11960,12035,12120,-85,0,54880,"665,177.55",79268
,20160608,12035,12120,12010,12030,11765,11880,11895,-240,-225,59000,"702,018.95",78746
,20160613,11880,11895,11800,12145,11690,12040,11995,145,100,53236,"638,824.32",78054
,20160614,12040,11995,11995,12200,11830,11830,12010,-165,15,71686,"860,995.28",78698
,20160615,11830,12010,11805,11950,11790,11910,11865,-100,-145,60498,"718,072.43",81082
,20160616,11910,11865,11985,12060,11880,11930,11970,65,105,67202,"804,411.04",85330
,20160617,11930,11970,11910,12395,11795,12380,12060,410,90,109706,"1,323,577.94",89474
,20160620,12380,12060,12425,12515,12310,12445,12415,385,355,85034,"1,056,076.17",95352
,20160621,12445,12415,12455,12525,12225,12310,12385,-105,-30,85464,"1,058,528.70",96210
,20160622,12310,12385,12250,12615,12250,12615,12420,230,35,79728,"990,290.67",100026
,20160623,12615,12420,12620,12680,12430,12515,12550,95,130,78612,"986,836.03",103492
,20160624,12515,12550,12600,12630,12250,12340,12430,-210,-120,130518,"1,622,568.47",102726
,20160627,12340,12430,12330,12845,12330,12770,12595,340,165,112028,"1,411,473.29",107694
,20160628,12770,12595,12700,12995,12600,12895,12790,300,195,120242,"1,537,915.71",114684
,20160629,12895,12790,12965,13205,12870,13000,13020,210,230,170274,"2,217,482.46",121336
,20160630,13000,13020,13000,13430,12915,13390,13225,370,205,177086,"2,341,996.81",129154
,20160701,13390,13225,13385,13385,13045,13175,13235,-50,10,179816,"2,379,980.82",128796
,20160704,13175,13235,13220,13980,13170,13865,13700,630,465,234070,"3,207,857.68",136954
,20160705,13865,13700,13890,13965,13270,13520,13560,-180,-140,229298,"3,109,313.42",136614
,20160706,13520,13560,13485,13695,12745,12745,13080,-815,-480,253354,"3,313,980.34",132610
,20160707,12745,13080,12700,13080,12600,12630,12850,-450,-230,203646,"2,617,685.45",132572
,20160708,12630,12850,12670,12840,12200,12410,12530,-440,-320,222288,"2,785,336.04",130370
,20160711,12410,12530,12500,12780,12380,12715,12605,185,75,179310,"2,260,266.42",136122
,20160712,12715,12605,12755,12990,12675,12875,12820,270,215,231550,"2,968,832.35",146084
,20160713,12875,12820,12980,13400,12810,13000,13095,180,275,324782,"4,254,402.47",153188
,20160714,13000,13095,13070,13145,12600,13060,12905,-35,-190,318776,"4,114,121.61",154474
,20160715,13060,12905,13225,13385,12930,13150,13130,245,225,356124,"4,677,410.58",157270
,20160718,13150,13130,13245,13245,12805,12930,13010,-200,-120,238538,"3,104,280.33",159470
,20160719,12930,13010,12870,13150,12760,13110,12980,100,-30,279328,"3,625,783.34",161326
,20160720,13110,12980,13100,13340,13025,13095,13155,115,175,297768,"3,917,623.47",166404
,20160721,13095,13155,13080,13375,12970,13295,13230,140,75,261346,"3,458,562.33",169414
,20160722,13295,13230,13275,13375,13060,13075,13210,-155,-20,210520,"2,781,293.81",166402
,20160725,13075,13210,13085,13165,12575,12655,12800,-555,-410,292046,"3,739,407.97",171344
,20160726,12655,12800,12625,12675,12355,12505,12485,-295,-315,243260,"3,038,162.60",176050
,20160727,12505,12485,12485,12745,12470,12645,12605,160,120,228280,"2,877,566.83",176892
,20160728,12645,12605,12650,12800,12590,12690,12710,85,105,265722,"3,378,035.45",179298
,20160729,12690,12710,12715,12765,12150,12200,12450,-510,-260,325322,"4,050,503.20",192626
,20160801,12200,12450,12255,12655,12205,12600,12440,150,-10,314142,"3,909,302.28",192590
,20160802,12600,12440,12575,12735,12505,12675,12605,235,165,393426,"4,959,332.45",193264
,20160803,12675,12605,12700,12930,12620,12665,12755,60,150,568464,"7,252,071.63",209868
,20160804,12665,12755,12700,12770,12355,12535,12565,-220,-190,608516,"7,648,400.05",222284
,20160805,12535,12565,12510,12800,12475,12700,12635,135,70,576574,"7,287,591.24",225940
,20160808,12700,12635,12695,13010,12635,12810,12840,175,205,689138,"8,851,816.63",239214
,20160809,12810,12840,12840,12955,12300,12615,12720,-225,-120,717286,"9,125,413.43",245268
,20160810,12615,12720,12595,12720,12515,12660,12630,-60,-90,547046,"6,911,390.49",245510
,20160811,12660,12630,12710,12780,12565,12690,12675,60,45,545318,"6,911,921.20",248120
,20160812,12690,12675,12680,13075,12680,13035,12875,360,200,753024,"9,698,397.02",279360
,20160815,13035,12875,12985,13190,12845,13140,13055,265,180,692068,"9,035,317.56",294510
,20160816,13140,13055,13135,13240,13000,13100,13110,45,55,661448,"8,672,812.02",287476
,20160817,13100,13110,13100,13270,13045,13065,13135,-45,25,629406,"8,267,345.43",294438
,20160818,13065,13135,13090,13115,12850,12975,12975,-160,-160,584956,"7,592,678.03",280570
,20160819,12975,12975,13010,13190,12975,13085,13080,110,105,608632,"7,961,795.87",285942
,20160822,13085,13080,13065,13090,12620,12630,12850,-450,-230,640404,"8,230,557.83",281276
,20160823,12630,12850,12600,12730,12525,12530,12645,-320,-205,420084,"5,313,708.25",282052
,20160824,12530,12645,12535,12705,12525,12615,12625,-30,-20,384478,"4,854,144.47",285276
,20160825,12615,12625,12640,12670,12190,12315,12390,-310,-235,618014,"7,658,483.54",280986
,20160826,12315,12390,12330,12380,12245,12300,12305,-90,-85,391206,"4,814,891.08",281468
,20160829,12300,12305,12345,12415,12110,12355,12305,50,0,486948,"5,993,406.73",279014
,20160830,12355,12305,12345,12495,12240,12260,12380,-45,75,494962,"6,128,661.53",278858
,20160831,12260,12380,12270,12315,12010,12055,12180,-325,-200,562984,"6,858,126.77",293260
,20160901,12055,12180,12020,12400,12020,12375,12205,195,25,533510,"6,512,807.95",272404
,20160902,12375,12205,12375,12530,12335,12390,12415,185,210,477010,"5,924,071.76",257852
,20160905,12390,12415,12435,12650,12390,12570,12545,155,130,409020,"5,131,406.17",258616
,20160906,12570,12545,12595,12600,12435,12580,12515,35,-30,364774,"4,565,800.27",259420
,20160907,12580,12515,12525,12700,12450,12645,12565,130,50,540234,"6,789,504.46",254508
,20160908,12645,12565,12665,12815,12570,12775,12695,210,130,480908,"6,105,297.34",263746
,20160909,12775,12695,12750,12860,12710,12775,12780,80,85,439644,"5,618,967.83",265510
,20160912,12775,12780,12745,12760,12320,12360,12510,-420,-270,565118,"7,071,125.56",246834
,20160913,12360,12510,12390,12495,12350,12440,12425,-70,-85,349844,"4,346,820.71",240430
,20160914,12440,12425,12490,12595,12385,12530,12500,105,75,416298,"5,204,604.76",231532
,20160919,12530,12500,12605,13025,12405,13010,12810,510,310,531074,"6,803,887.59",269762
,20160920,13010,12810,13020,13250,13000,13225,13135,415,325,539172,"7,084,289.16",287762
,20160921,13225,13135,13280,13305,13115,13225,13195,90,60,433294,"5,719,092.51",283812
,20160922,13225,13195,13240,13680,13150,13475,13445,280,250,809414,"10,884,054.06",298522
,20160923,13475,13445,13510,13590,13350,13550,13475,105,30,513792,"6,924,953.67",304864
,20160926,13550,13475,13535,13600,13305,13450,13430,-25,-45,493918,"6,634,239.94",295208
,20160927,13450,13430,13380,13400,13100,13295,13240,-135,-190,559048,"7,404,212.93",286318
,20160928,13295,13240,13245,13540,13185,13460,13405,220,165,660858,"8,859,658.04",299738
,20160929,13460,13405,13440,13800,13275,13325,13525,-80,120,761750,"10,305,967.28",275630
,20160930,13325,13525,13325,13370,13170,13255,13265,-270,-260,409922,"5,437,891.65",255360
,20161010,13255,13265,13600,13925,13475,13835,13725,570,460,503364,"6,910,080.05",283638
,20161011,13835,13725,13865,14245,13850,14205,14125,480,400,672820,"9,506,809.51",298952
,20161012,14205,14125,14100,14300,14060,14165,14150,40,25,497472,"7,039,506.28",300826
,20161013,14165,14150,14105,14255,13920,14025,14070,-125,-80,622646,"8,761,415.02",292422
,20161014,14025,14070,13980,14520,13945,14385,14305,315,235,678166,"9,701,934.85",315978
,20161017,14385,14305,14405,14535,14235,14300,14365,-5,60,596490,"8,571,482.64",310860
,20161018,14300,14365,14300,14375,14125,14340,14250,-25,-115,552662,"7,877,125.47",303908
,20161019,14340,14250,14330,14360,13605,13760,13965,-490,-285,785038,"10,966,444.20",273668
,20161020,13760,13965,13765,13900,13720,13795,13800,-170,-165,514844,"7,106,389.37",271978
,20161021,13795,13800,13790,13825,13450,13660,13615,-140,-185,549628,"7,484,171.89",258288
,20161024,13660,13615,13700,14020,13665,13905,13850,290,235,535214,"7,414,833.59",261294
,20161025,13905,13850,13925,14310,13905,13985,14125,135,275,642340,"9,073,225.26",259938
,20161026,13985,14125,14015,14070,13580,14020,13830,-105,-295,717604,"9,925,497.14",257720
,20161027,14020,13830,13980,14255,13800,14155,14065,325,235,852286,"11,990,708.90",262008
,20161028,14155,14065,14190,14425,14050,14155,14190,90,125,754884,"10,714,460.00",248932
,20161031,14155,14190,14175,14345,13955,14225,14170,35,-20,668728,"9,477,137.19",249238
,20161101,14225,14170,14210,14380,14015,14100,14190,-70,20,568710,"8,071,289.81",249062
,20161102,14100,14190,14120,14230,13715,13785,13965,-405,-225,605094,"8,450,998.02",247090
,20161103,13785,13965,13800,13925,13650,13865,13795,-100,-170,401104,"5,533,537.00",245046
,20161104,13865,13795,13890,14175,13670,13760,13940,-35,145,596990,"8,323,613.59",233186
,20161107,13760,13940,13790,14770,13740,14505,14260,565,320,797342,"11,370,138.28",235510
,20161108,14505,14260,14480,15115,14380,15115,14805,855,545,843170,"12,483,416.49",247566
,20161109,15115,14805,15135,15700,15085,15290,15325,485,520,709964,"10,882,644.91",237780
,20161110,15290,15325,15430,16020,14875,15920,15535,595,210,813140,"12,632,305.66",242334
,20161111,15920,15535,16100,16465,15610,16390,16035,855,500,544784,"8,736,838.11",229624
,20161114,16390,16035,16265,16945,15070,15335,15770,-700,-265,689904,"10,881,903.21",185918
,20161115,15335,15770,15500,15985,15165,15620,15605,-150,-165,580922,"9,065,655.75",182500
,20161116,15620,15605,15715,16540,15675,16540,16140,935,535,539372,"8,707,725.61",207042
,20161117,16540,16140,16540,16665,16250,16505,16480,365,340,465778,"7,676,999.54",196684
,20161118,16505,16480,16470,16515,15890,16185,16165,-295,-315,394386,"6,376,119.81",182506
,20161121,16185,16165,16180,17130,16055,17130,16605,965,440,308838,"5,129,307.83",194324
,20161122,17130,16605,17300,17940,17300,17575,17570,970,965,463926,"8,151,971.16",179900
,20161123,17575,17570,17205,17780,17115,17570,17535,0,-35,330722,"5,800,122.23",169226
,20161124,17570,17535,17520,18400,17490,17775,18040,240,505,502786,"9,071,210.42",164118
,20161125,17775,18040,17710,18150,17490,17865,17845,-175,-195,290974,"5,193,448.43",149928
,20161128,17865,17845,17735,18915,17605,18770,18115,925,270,289728,"5,248,681.50",135262
,20161129,18770,18115,18650,18790,17995,18170,18500,55,385,175670,"3,250,687.41",105496
,20161130,18170,18500,18260,18285,17205,17205,17645,-1295,-855,147972,"2,611,224.70",84828
,20161201,17205,17645,17475,17820,17220,17515,17545,-130,-100,104602,"1,835,508.36",74750
,20161202,17515,17545,17605,17725,16855,17425,17300,-120,-245,71960,"1,245,073.91",68956
,20161205,17425,17300,17480,18100,17285,17990,17705,690,405,51916,"919,305.47",64918
,20161206,17990,17705,18135,18240,17805,17960,18050,255,345,30412,"549,060.41",61882
,20161207,17960,18050,17970,18405,17830,18395,18125,345,75,27966,"507,014.38",59612
,20161208,18395,18125,18405,18850,17935,18030,18350,-95,225,26396,"484,439.02",55088
,20161209,18030,18350,18160,18605,17640,18480,18040,130,-310,26696,"481,716.18",51270
,20161212,18480,18040,18605,19300,18345,18780,18910,740,870,25610,"484,350.55",47238
,20161213,18780,18910,18880,19490,18665,19490,18990,580,80,17068,"324,127.49",45122
,20161214,19490,18990,19810,19990,19200,19710,19550,720,560,15908,"311,042.43",43164
,20161215,19710,19550,19995,19995,19080,19390,19445,-160,-105,18148,"352,894.82",40048
,20161216,19390,19445,19395,19600,19005,19110,19345,-335,-100,11542,"223,325.17",36896
,20161219,19110,19345,19110,19320,18910,18950,19110,-395,-235,8766,"167,538.28",34708
,20161220,18950,19110,18885,18895,18165,18515,18480,-595,-630,14478,"267,583.04",32604
,20161221,18515,18480,18575,18850,18450,18785,18640,305,160,6616,"123,351.21",30982
,20161222,18785,18640,18735,18830,17950,18010,18435,-630,-205,8642,"159,339.54",29048
,20161223,18010,18435,17995,18250,17805,18110,18050,-325,-385,6774,"122,299.10",27068
,20161226,18110,18050,18145,18195,16860,17110,17380,-940,-670,9936,"172,700.46",24766
,20161227,17110,17380,17030,17420,16700,17390,17030,10,-350,6796,"115,740.55",22254
,20161228,17390,17030,17430,17755,17145,17145,17395,115,365,5714,"99,405.88",20732
,20161229,17145,17395,17145,17810,17030,17740,17430,345,35,4404,"76,775.35",20088
,20161230,17740,17430,17885,17900,17390,17745,17645,315,215,5482,"96,749.21",18382
ru1703,20160316,12575,12575,12400,12600,12400,12555,12525,-20,-50,8,100.23,6
,20160317,12555,12525,12820,12845,12700,12845,12785,320,260,6,76.73,8
,20160318,12845,12785,13100,13295,12980,13110,13110,325,325,24,314.66,12
,20160321,13110,13110,13015,13320,13015,13215,13210,105,100,16,211.38,14
,20160322,13215,13210,13275,13300,13210,13210,13260,0,50,18,238.76,18
,20160323,13210,13260,13160,13270,13005,13005,13170,-255,-90,14,184.43,24
,20160324,13005,13170,12980,12980,12820,12900,12890,-270,-280,8,103.15,24
,20160325,12900,12890,13120,13120,13120,13120,13120,230,230,4,52.48,26
,20160328,13120,13120,13200,13300,12920,12920,13140,-200,20,12,157.68,38
,20160329,12920,13140,13095,13095,12865,12865,12990,-275,-150,12,155.93,36
,20160330,12865,12990,12755,12755,12755,12755,12755,-235,-235,2,25.51,38
,20160331,12755,12755,12715,12720,12500,12720,12630,-35,-125,66,833.85,74
,20160401,12720,12630,12835,12835,12725,12725,12760,95,130,18,229.68,80
,20160405,12725,12760,12910,13000,12770,12950,12870,190,110,48,617.83,80
,20160406,12950,12870,12970,13000,12970,12985,12985,115,115,44,571.35,94
,20160407,12985,12985,13015,13020,12995,13020,13005,35,20,20,260.13,96
,20160408,13020,13005,12780,12880,12780,12880,12830,-125,-175,48,615.97,122
,20160411,12880,12830,13080,13505,13080,13440,13345,610,515,52,694.11,90
,20160412,13440,13345,13395,13555,13395,13555,13470,210,125,44,592.89,106
,20160413,13555,13470,13655,14225,13655,13815,13950,345,480,86,"1,199.94",120
,20160414,13815,13950,13805,13935,13780,13780,13870,-170,-80,52,721.37,112
,20160415,13780,13870,13935,14045,13880,13880,13900,10,30,26,361.43,108
,20160418,13880,13900,13510,13925,13510,13780,13755,-120,-145,36,495.19,134
,20160419,13780,13755,14080,14085,13725,13835,14015,80,260,36,504.67,120
,20160420,13835,14015,13995,14435,13955,14330,14230,315,215,498,"7,086.86",158
,20160421,14330,14230,14255,14775,14160,14750,14425,520,195,58,836.72,160
,20160422,14750,14425,14595,14600,14020,14210,14295,-215,-130,66,943.74,166
,20160425,14210,14295,14570,14570,14245,14270,14265,-25,-30,36,513.70,148
,20160426,14270,14265,14305,14440,14245,14270,14350,5,85,48,688.82,142
,20160427,14270,14350,14390,14440,14020,14165,14330,-185,-20,54,774.00,132
,20160428,14165,14330,14030,14230,13900,13905,14095,-425,-235,52,733.05,148
,20160429,13905,14095,14065,14295,14065,14115,14145,20,50,108,"1,527.94",168
,20160503,14115,14145,14065,14305,14065,14300,14180,155,35,64,907.83,194
,20160504,14300,14180,14395,14400,14100,14100,14240,-80,60,50,712.02,188
,20160505,14100,14240,14000,14040,13860,13960,13940,-280,-300,46,641.27,184
,20160506,13960,13940,13820,13820,13615,13785,13745,-155,-195,146,"2,007.04",230
,20160509,13785,13745,13795,13795,13200,13250,13370,-495,-375,136,"1,818.90",278
,20160510,13250,13370,13295,13395,13200,13395,13215,25,-155,136,"1,797.77",380
,20160511,13395,13215,13375,13375,13250,13250,13330,35,115,38,506.72,376
,20160512,13250,13330,13285,13435,13185,13330,13255,0,-75,48,636.47,378
,20160513,13330,13255,13050,13050,12545,12680,12725,-575,-530,54,687.18,406
,20160516,12680,12725,12495,12805,12495,12775,12760,50,35,34,433.94,388
,20160517,12775,12760,12700,12790,12700,12790,12760,30,0,44,561.55,402
,20160518,12790,12760,12855,12865,12450,12450,12760,-310,0,60,765.76,394
,20160519,12450,12760,12465,12570,12240,12240,12480,-520,-280,62,773.80,394
,20160520,12240,12480,12300,12300,12255,12255,12275,-225,-205,32,392.82,388
,20160523,12255,12275,12360,12360,11535,11610,11855,-665,-420,56,663.93,384
,20160524,11610,11855,11870,11870,11735,11810,11775,-45,-80,60,706.64,394
,20160525,11810,11775,11910,11915,11680,11710,11780,-65,5,60,706.80,406
,20160526,11710,11780,11775,12080,11775,12055,11965,275,185,46,550.58,374
,20160527,12055,11965,12170,12190,11935,12110,12055,145,90,50,602.89,370
,20160530,12110,12055,12080,12205,11950,12095,12045,40,-10,42,505.93,372
,20160531,12095,12045,12240,12240,12060,12085,12095,40,50,36,435.53,390
,20160601,12085,12095,11975,11975,11810,11815,11855,-280,-240,226,"2,680.12",400
,20160602,11815,11855,11965,11995,11945,11995,11985,140,130,48,575.39,400
,20160603,11995,11985,12100,12125,11995,12010,12055,25,70,80,964.73,392
,20160606,12010,12055,12100,12265,12100,12265,12225,210,170,28,342.37,386
,20160607,12265,12225,12305,12305,12080,12080,12215,-145,-10,84,"1,026.45",398
,20160608,12080,12215,12110,12110,11900,11940,11955,-275,-260,60,717.41,408
,20160613,11940,11955,11905,12150,11905,12125,12070,170,115,92,"1,110.53",438
,20160614,12125,12070,12135,12160,12065,12080,12105,10,35,56,677.88,436
,20160615,12080,12105,11890,11930,11890,11930,11905,-175,-200,18,214.34,442
,20160616,11930,11905,11930,12030,11930,11930,11955,25,50,26,310.93,450
,20160617,11930,11955,11955,12290,11955,12290,12185,335,230,56,682.45,440
,20160620,12290,12185,12370,12490,12370,12490,12440,305,255,24,298.59,438
,20160621,12490,12440,12510,12535,12310,12310,12415,-130,-25,46,571.12,446
,20160622,12310,12415,12345,12650,12345,12650,12590,235,175,46,579.22,462
,20160623,12650,12590,12650,12730,12545,12650,12620,60,30,896,"11,311.60",1126
,20160624,12650,12620,12680,12680,12450,12480,12570,-140,-50,320,"4,023.57",1384
,20160627,12480,12570,12595,12940,12545,12935,12765,365,195,66,842.80,1336
,20160628,12935,12765,12905,13055,12900,13055,13000,290,235,76,988.36,1344
,20160629,13055,13000,13105,13250,13105,13110,13175,110,175,38,500.78,1332
,20160630,13110,13175,13310,13530,13310,13500,13445,325,270,124,"1,667.33",1326
,20160701,13500,13445,13425,13495,13290,13390,13440,-55,-5,52,699.08,1332
,20160704,13390,13440,13870,14135,13810,14135,13980,695,540,16,223.73,1336
,20160705,14135,13980,14150,14150,13500,13645,13880,-335,-100,28,388.65,1342
,20160706,13645,13880,13370,13370,13045,13045,13115,-835,-765,30,393.48,1348
,20160707,13045,13115,13100,13100,13100,13100,13100,-15,-15,2,26.20,1346
,20160708,13100,13100,12800,12800,12430,12500,12590,-600,-510,52,654.78,1332
,20160711,12500,12590,12775,12775,12730,12730,12750,140,160,16,204.07,1326
,20160712,12730,12750,13050,13050,13015,13015,13025,265,275,12,156.35,1320
,20160713,13015,13025,13065,13445,12980,13150,13185,125,160,28,369.31,1314
,20160714,13150,13185,13270,13270,12825,13120,13030,-65,-155,18,234.59,1318
,20160715,13120,13030,13350,13350,13350,13350,13350,320,320,2,26.70,1318
,20160718,13350,13350,13160,13300,13050,13190,13175,-160,-175,8,105.40,1318
,20160719,13190,13175,12970,13280,12970,13165,13135,-10,-40,6,78.83,1316
,20160720,13165,13135,13355,13355,13355,13355,13355,220,220,42,560.91,1354
,20160721,13355,13355,13150,13340,13150,13340,13230,-15,-125,6,79.39,1356
,20160722,13340,13230,13400,13400,13400,13400,13400,170,170,2,26.80,1356
,20160725,13400,13400,13150,13150,12705,12800,12815,-600,-585,64,820.21,1368
,20160726,12800,12815,12800,12805,12605,12605,12700,-210,-115,54,686.05,1374
,20160727,12605,12700,12760,12875,12760,12770,12805,70,105,10,128.07,1372
,20160728,12770,12805,12890,12890,12890,12890,12890,85,85,2,25.78,1372
,20160729,12890,12890,12555,12555,12330,12350,12405,-540,-485,24,297.74,1374
,20160801,12350,12405,12410,12735,12410,12735,12465,330,60,26,324.17,1372
,20160802,12735,12465,12790,12830,12675,12680,12720,215,255,24,305.32,1372
,20160803,12680,12720,12850,13020,12850,12880,12940,160,220,12,155.30,1368
,20160804,12880,12940,12710,12855,12580,12580,12705,-360,-235,20,254.18,1366
,20160805,12580,12705,,,,12785,12785,80,80,0,0.00,1366
,20160808,12785,12785,13135,13135,13135,13135,13135,350,350,2,26.27,1368
,20160809,13135,13135,13075,13100,12550,12750,12825,-385,-310,72,923.51,1414
,20160810,12750,12825,12750,12835,12750,12820,12815,-5,-10,50,640.89,1382
,20160811,12820,12815,12910,12920,12755,12845,12850,30,35,34,436.93,1378
,20160812,12845,12850,12945,13150,12945,13150,13030,300,180,16,208.55,1376
,20160815,13150,13030,13135,13235,13025,13140,13185,110,155,1296,"17,092.02",656
,20160816,13140,13185,13175,13320,13085,13120,13155,-65,-30,74,973.57,672
,20160817,13120,13155,13160,13255,13160,13255,13185,100,30,14,184.64,668
,20160818,13255,13185,13045,13045,12985,12985,13020,-200,-165,10,130.22,668
,20160819,12985,13020,13155,13210,13105,13130,13135,110,115,28,367.78,660
,20160822,13130,13135,13030,13030,12690,12700,12870,-435,-265,60,772.39,658
,20160823,12700,12870,12685,12780,12605,12605,12715,-265,-155,68,864.87,650
,20160824,12605,12715,12680,12755,12680,12700,12715,-15,0,52,661.42,646
,20160825,12700,12715,12745,12745,12305,12405,12495,-310,-220,44,549.86,644
,20160826,12405,12495,12400,12400,12365,12400,12390,-95,-105,8,99.12,646
,20160829,12400,12390,12445,12470,12375,12430,12430,40,40,8,99.44,648
,20160830,12430,12430,12475,12475,12330,12340,12365,-90,-65,8,98.95,646
,20160831,12340,12365,12350,12350,12105,12155,12190,-210,-175,20,243.89,650
,20160901,12155,12190,12155,12435,12155,12435,12265,245,75,16,196.24,640
,20160902,12435,12265,12445,12465,12445,12465,12455,200,190,4,49.82,640
,20160905,12465,12455,,,,12455,12455,0,0,0,0.00,640
,20160906,12455,12455,12540,12570,12540,12570,12550,115,95,6,75.30,636
,20160907,12570,12550,12610,12645,12550,12600,12595,50,45,12,151.19,630
,20160908,12600,12595,12780,12865,12720,12865,12780,270,185,12,153.40,626
,20160909,12865,12780,12850,12940,12785,12840,12880,60,100,16,206.09,616
,20160912,12840,12880,12740,12740,12370,12460,12455,-420,-425,40,498.27,610
,20160913,12460,12455,12460,12560,12460,12500,12500,45,45,10,125.02,610
,20160914,12500,12500,12555,12610,12510,12610,12555,110,55,12,150.66,610
,20160919,12610,12555,12710,12980,12160,12980,12725,425,170,16,203.65,606
,20160920,12980,12725,13115,13270,13115,13270,13165,545,440,42,553.03,596
,20160921,13270,13165,13280,13325,13255,13270,13270,105,105,20,265.49,594
,20160922,13270,13270,13320,13700,13275,13650,13475,380,205,70,943.46,610
,20160923,13650,13475,13570,13635,13460,13520,13565,45,90,46,624.15,610
,20160926,13520,13565,13680,13680,13450,13500,13525,-65,-40,10,135.28,610
,20160927,13500,13525,13385,13385,13275,13275,13350,-250,-175,14,186.95,616
,20160928,13275,13350,13510,13590,13470,13480,13510,130,160,30,405.30,616
,20160929,13480,13510,13480,13810,13350,13350,13675,-160,165,38,519.67,604
,20160930,13350,13675,13415,13415,13285,13310,13325,-365,-350,18,239.92,592
,20161010,13310,13325,13575,13945,13575,13890,13800,565,475,196,"2,705.59",588
,20161011,13890,13800,14150,14255,14115,14255,14205,455,405,34,483.05,590
,20161012,14255,14205,14165,14225,14135,14195,14180,-10,-25,36,510.59,596
,20161013,14195,14180,14070,14155,14005,14030,14035,-150,-145,46,645.72,572
,20161014,14030,14035,14030,14555,14030,14555,14215,520,180,42,597.13,558
,20161017,14555,14215,14440,14505,14325,14325,14455,110,240,48,693.93,552
,20161018,14325,14455,14340,14470,14210,14450,14365,-5,-90,92,"1,321.79",566
,20161019,14450,14365,14425,14425,13670,13820,13950,-545,-415,42,586.07,570
,20161020,13820,13950,13910,13985,13875,13920,13935,-30,-15,86,"1,198.55",574
,20161021,13920,13935,13880,14765,13605,13745,13715,-190,-220,80,"1,097.27",550
,20161024,13745,13715,13905,14165,13870,14085,13980,370,265,52,727.19,542
,20161025,14085,13980,14255,14380,14185,14260,14260,280,280,46,656.03,540
,20161026,14260,14260,14155,14155,13695,13890,13950,-370,-310,52,725.40,546
,20161027,13890,13950,14120,14360,13975,14270,14185,320,235,44,624.20,534
,20161028,14270,14185,14425,14545,14235,14360,14395,175,210,34,489.58,536
,20161031,14360,14395,14260,14430,14200,14330,14315,-65,-80,28,400.84,540
,20161101,14330,14315,14380,14380,14285,14285,14305,-30,-10,118,"1,688.43",544
,20161102,14285,14305,14320,14380,13965,13965,14270,-340,-35,136,"1,941.21",542
,20161103,13965,14270,13985,14150,13835,14015,13960,-255,-310,48,670.18,528
,20161104,14015,13960,14095,14285,14095,14100,14220,140,260,48,682.58,514
,20161107,14100,14220,14200,14855,14200,14675,14575,455,355,62,903.84,520
,20161108,14675,14575,14625,15445,14610,15400,15195,825,620,1174,"17,839.00",1416
,20161109,15400,15195,15415,15700,15405,15500,15505,305,310,48,744.39,1390
,20161110,15500,15505,15880,16345,15300,16200,15780,695,275,242,"3,819.22",1338
,20161111,16200,15780,16340,16725,15960,16630,16455,850,675,310,"5,102.50",1340
,20161114,16630,16455,16610,17085,15465,15605,15935,-850,-520,170,"2,709.78",1328
,20161115,15605,15935,15750,16215,15605,15845,15940,-90,5,140,"2,232.28",1304
,20161116,15845,15940,16045,16895,15990,16895,16275,955,335,1240,"20,184.03",388
,20161117,16895,16275,16705,16895,16500,16780,16715,505,440,180,"3,008.96",384
,20161118,16780,16715,16545,16550,16165,16290,16325,-425,-390,50,816.30,384
,20161121,16290,16325,16525,17300,16525,17300,17040,975,715,6,102.25,388
,20161122,17300,17040,17600,18245,17600,17775,17920,735,880,108,"1,935.89",376
,20161123,17775,17920,17535,17915,17505,17875,17705,-45,-215,32,566.57,368
,20161124,17875,17705,18510,18685,18050,18050,18455,345,750,118,"2,178.03",308
,20161125,18050,18455,18220,18220,17890,18045,18075,-410,-380,38,686.96,288
,20161128,18045,18075,18150,19065,17985,19060,18310,985,235,170,"3,113.19",380
,20161129,19060,18310,18995,19025,18350,18580,18825,270,515,70,"1,318.09",344
,20161130,18580,18825,18350,18350,17505,17580,18005,-1245,-820,90,"1,620.56",284
,20161201,17580,18005,17770,18140,17695,18050,17955,45,-50,30,538.72,300
,20161202,18050,17955,17680,17710,17100,17670,17470,-285,-485,36,629.06,286
,20161205,17670,17470,17960,18385,17945,18330,18125,860,655,22,398.80,298
,20161206,18330,18125,18385,18425,18215,18240,18325,115,200,36,659.75,274
,20161207,18240,18325,18355,18615,18245,18615,18415,290,90,108,"1,988.94",268
,20161208,18615,18415,18390,18420,18295,18295,18365,-120,-50,8,146.95,264
,20161209,18295,18365,18095,18845,18020,18840,18320,475,-45,12,219.85,260
,20161212,18840,18320,18875,19600,18645,19270,19075,950,755,24,457.81,252
,20161213,19270,19075,19080,19130,18910,19100,19035,25,-40,20,380.73,254
,20161214,19100,19035,,,,19825,19825,790,790,0,0.00,254
,20161215,19825,19825,19895,19895,18440,19670,19395,-155,-430,14,271.56,252
,20161216,19670,19395,19590,19590,19310,19310,19490,-85,95,6,116.96,252
,20161219,19310,19490,19510,19510,19510,19510,19510,20,20,10,195.10,242
,20161220,19510,19510,19055,19055,18645,18900,18705,-610,-805,274,"5,125.91",240
,20161221,18900,18705,18930,19135,18795,19135,18940,430,235,22,416.68,244
,20161222,19135,18940,18880,18880,18390,18390,18555,-550,-385,6,111.34,246
,20161223,18390,18555,18420,18420,18315,18315,18365,-240,-190,4,73.47,244
,20161226,18315,18365,18265,18460,17090,17410,17770,-955,-595,54,959.59,246
,20161227,17410,17770,17005,17595,17005,17595,17405,-175,-365,20,348.10,246
,20161228,17595,17405,17870,17870,17465,17500,17610,95,205,136,"2,395.12",208
,20161229,17500,17610,17580,18080,17565,18000,17795,390,185,86,"1,530.50",156
,20161230,18000,17795,18100,18190,18045,18045,18095,250,300,8,144.76,154
ru1704,20160418,13900,13900,13975,14000,13975,14000,13985,100,85,4,55.95,4
,20160419,14000,13985,14000,14045,13905,13905,13980,-80,-5,6,83.90,4
,20160420,13905,13980,14540,14705,14400,14400,14515,420,535,10,145.16,14
,20160421,14400,14515,14400,14840,14395,14840,14505,325,-10,16,232.12,26
,20160422,14840,14505,14245,14450,14140,14140,14280,-365,-225,12,171.38,28
,20160425,14140,14280,14425,14425,14425,14425,14425,145,145,2,28.85,28
,20160426,14425,14425,14315,14360,14315,14360,14335,-65,-90,4,57.35,26
,20160427,14360,14335,14200,14200,14200,14200,14200,-135,-135,2,28.40,28
,20160428,14200,14200,14020,14145,14000,14145,14055,-55,-145,6,84.33,32
,20160429,14145,14055,14445,14445,14285,14285,14365,230,310,4,57.46,32
,20160503,14285,14365,14195,14195,14195,14195,14195,-170,-170,2,28.39,34
,20160504,14195,14195,14495,14495,14200,14260,14285,65,90,12,171.46,32
,20160505,14260,14285,14120,14120,13900,13900,14055,-385,-230,8,112.47,38
,20160506,13900,14055,14020,14020,13685,13775,13820,-280,-235,42,580.63,60
,20160509,13775,13820,13820,13820,13300,13385,13510,-435,-310,14,189.18,68
,20160510,13385,13510,,,,13510,13510,0,0,0,0.00,68
,20160511,13510,13510,,,,13510,13510,0,0,0,0.00,68
,20160512,13510,13510,13330,13495,13330,13495,13445,-15,-65,8,107.56,68
,20160513,13495,13445,13215,13215,12765,12765,12980,-680,-465,8,103.87,68
,20160516,12765,12980,12710,12710,12710,12710,12710,-270,-270,2,25.42,68
,20160517,12710,12710,12780,12855,12760,12760,12770,50,60,32,408.72,90
,20160518,12760,12770,12810,13020,12335,12635,12885,-135,115,50,644.32,94
,20160519,12635,12885,12510,12785,12280,12375,12530,-510,-355,44,551.50,92
,20160520,12375,12530,12475,12475,12380,12380,12460,-150,-70,32,398.76,72
,20160523,12380,12460,12200,12200,11710,11710,11905,-750,-555,38,452.53,98
,20160524,11710,11905,11880,11890,11830,11860,11875,-45,-30,32,380.11,100
,20160525,11860,11875,11950,12030,11800,11800,11950,-75,75,54,645.32,104
,20160526,11800,11950,11890,11980,11885,11980,11900,30,-50,38,452.22,88
,20160527,11980,11900,12190,12190,11925,12030,11975,130,75,34,407.26,112
,20160530,12030,11975,12140,12140,11975,12120,12085,145,110,34,411.05,100
,20160531,12120,12085,12150,12195,12145,12195,12185,110,100,28,341.27,96
,20160601,12195,12185,11860,11860,11850,11855,11855,-330,-330,28,331.94,84
,20160602,11855,11855,11760,12020,11760,12020,11910,165,55,54,643.18,104
,20160603,12020,11910,11990,12310,11990,12085,12080,175,170,64,773.15,102
,20160606,12085,12080,12135,12180,12085,12180,12160,100,80,36,437.85,102
,20160607,12180,12160,12210,12265,12115,12115,12240,-45,80,48,587.69,90
,20160608,12115,12240,12005,12070,11995,12010,12020,-230,-220,8,96.16,90
,20160613,12010,12020,12195,12195,12135,12180,12180,160,160,38,462.92,116
,20160614,12180,12180,12200,12200,12025,12025,12080,-155,-100,36,434.89,108
,20160615,12025,12080,11995,11995,11995,11995,11995,-85,-85,4,47.98,110
,20160616,11995,11995,12070,12070,12000,12020,12025,25,30,12,144.30,108
,20160617,12020,12025,12035,12400,12035,12400,12220,375,195,18,219.97,108
,20160620,12400,12220,12460,12510,12460,12510,12485,290,265,12,149.84,104
,20160621,12510,12485,12535,12605,12365,12365,12470,-120,-15,40,498.92,116
,20160622,12365,12470,12385,12600,12385,12600,12540,130,70,16,200.68,122
,20160623,12600,12540,12750,12750,12600,12635,12620,95,80,36,454.45,124
,20160624,12635,12620,12680,12680,12400,12440,12565,-180,-55,20,251.39,122
,20160627,12440,12565,12515,13045,12515,13000,12965,435,400,1042,"13,514.11",1092
,20160628,13000,12965,13010,13185,12850,13125,13065,160,100,156,"2,038.42",1090
,20160629,13125,13065,13345,13440,13130,13300,13305,235,240,44,585.42,1092
,20160630,13300,13305,13235,13320,13235,13320,13240,15,-65,18,238.40,1090
,20160701,13320,13240,13345,13660,13345,13425,13460,185,220,18,242.29,1088
,20160704,13425,13460,13495,13995,13495,13845,13810,385,350,16,221.00,1090
,20160705,13845,13810,14045,14080,13600,13755,13900,-55,90,32,444.88,1092
,20160706,13755,13900,13535,13535,13065,13095,13125,-805,-775,166,"2,179.55",1096
,20160707,13095,13125,12930,13260,12885,12885,13085,-240,-40,72,942.30,1094
,20160708,12885,13085,12990,13030,12480,12600,12705,-485,-380,70,889.45,1090
,20160711,12600,12705,12675,13000,12675,12950,12830,245,125,22,282.34,1090
,20160712,12950,12830,13050,13140,13005,13075,13075,245,245,14,183.05,1090
,20160713,13075,13075,13150,13730,13090,13200,13295,125,220,34,452.16,1090
,20160714,13200,13295,13270,13270,12980,13055,13150,-240,-145,16,210.44,1088
,20160715,13055,13150,13440,13440,13260,13260,13320,110,170,6,79.94,1088
,20160718,13260,13320,13110,13290,13110,13215,13180,-105,-140,8,105.45,1090
,20160719,13215,13180,,,,13200,13200,20,20,0,0.00,1090
,20160720,13200,13200,13370,13445,13280,13350,13355,150,155,18,240.45,1084
,20160721,13350,13355,13400,13620,13340,13620,13420,265,65,32,429.54,1084
,20160722,13620,13420,13590,13590,13350,13350,13510,-70,90,32,432.41,1074
,20160725,13350,13510,13395,13395,12950,12950,13145,-560,-365,18,236.67,1080
,20160726,12950,13145,12830,12850,12780,12780,12815,-365,-330,8,102.52,1080
,20160727,12780,12815,12795,12860,12795,12860,12825,45,10,4,51.31,1080
,20160728,12860,12825,12995,13000,12995,13000,12995,175,170,4,51.99,1082
,20160729,13000,12995,12925,12990,12450,12450,12665,-545,-330,44,557.40,1082
,20160801,12450,12665,12715,12945,12620,12945,12850,280,185,140,"1,799.33",1078
,20160802,12945,12850,12870,12880,12840,12875,12860,25,10,22,283.02,1076
,20160803,12875,12860,13005,13005,12895,12930,12930,70,70,24,310.36,1080
,20160804,12930,12930,13000,13000,12675,12785,12820,-145,-110,52,666.66,1078
,20160805,12785,12820,12800,12980,12755,12975,12830,155,10,76,975.30,1080
,20160808,12975,12830,12995,13200,12975,13100,13090,270,260,18,235.69,1078
,20160809,13100,13090,12685,12920,12680,12920,12785,-170,-305,16,204.59,1082
,20160810,12920,12785,12900,12965,12850,12920,12905,135,120,40,516.24,1082
,20160811,12920,12905,12940,12950,12880,12950,12920,45,15,6,77.54,1080
,20160812,12950,12920,13285,13285,13285,13285,13285,365,365,2,26.57,1080
,20160815,13285,13285,13245,13360,13200,13240,13290,-45,5,1280,"17,015.86",292
,20160816,13240,13290,13205,13305,13200,13225,13275,-65,-15,176,"2,337.07",278
,20160817,13225,13275,13255,13255,13240,13240,13245,-35,-30,6,79.47,276
,20160818,13240,13245,,,,13245,13245,0,0,0,0.00,276
,20160819,13245,13245,13200,13260,13150,13200,13185,-45,-60,38,501.20,274
,20160822,13200,13185,13120,13120,12800,12800,12985,-385,-200,48,623.42,264
,20160823,12800,12985,12770,12815,12715,12730,12775,-255,-210,56,715.52,252
,20160824,12730,12775,12760,12800,12760,12800,12780,25,5,16,204.51,254
,20160825,12800,12780,12340,12465,12340,12425,12380,-355,-400,50,619.10,248
,20160826,12425,12380,12490,12490,12440,12440,12445,60,65,12,149.38,248
,20160829,12440,12445,12445,12445,12395,12395,12405,-50,-40,8,99.26,244
,20160830,12395,12405,,,,12405,12405,0,0,0,0.00,244
,20160831,12405,12405,12200,12200,12200,12200,12200,-205,-205,2,24.40,242
,20160901,12200,12200,12280,12475,12225,12475,12360,275,160,8,98.91,238
,20160902,12475,12360,12485,12600,12485,12600,12500,240,140,28,350.05,236
,20160905,12600,12500,12640,12710,12640,12710,12680,210,180,6,76.08,236
,20160906,12710,12680,,,,12680,12680,0,0,0,0.00,236
,20160907,12680,12680,12680,12680,12610,12610,12645,-70,-35,6,75.88,236
,20160908,12610,12645,12820,12820,12800,12820,12810,175,165,14,179.35,236
,20160909,12820,12810,12900,12900,12900,12900,12900,90,90,2,25.80,236
,20160912,12900,12900,12775,12875,12480,12505,12685,-395,-215,46,583.70,236
,20160913,12505,12685,12555,12560,12475,12560,12535,-125,-150,8,100.29,236
,20160914,12560,12535,,,,12605,12605,70,70,0,0.00,236
,20160919,12605,12605,12810,13045,12810,13040,12955,435,350,10,129.57,238
,20160920,13040,12955,13095,13220,13095,13220,13155,265,200,6,78.94,238
,20160921,13220,13155,13280,13290,13280,13290,13285,135,130,4,53.14,238
,20160922,13290,13285,13335,13710,13335,13710,13480,425,195,6,80.89,238
,20160923,13710,13480,13525,13640,13525,13620,13595,140,115,6,81.57,238
,20160926,13620,13595,,,,13595,13595,0,0,0,0.00,238
,20160927,13595,13595,13420,13420,13420,13420,13420,-175,-175,2,26.84,240
,20160928,13420,13420,13590,13590,13525,13590,13565,170,145,6,81.41,240
,20160929,13590,13565,13700,13780,13400,13400,13625,-165,60,10,136.29,238
,20160930,13400,13625,13420,13420,13415,13415,13415,-210,-210,4,53.67,238
,20161010,13415,13415,13675,13965,13675,13965,13770,550,355,14,192.79,238
,20161011,13965,13770,,,,14165,14165,395,395,0,0.00,238
,20161012,14165,14165,14205,14390,14170,14390,14255,225,90,6,85.53,240
,20161013,14390,14255,14190,14190,14080,14130,14115,-125,-140,34,479.94,248
,20161014,14130,14115,14110,14480,14110,14480,14250,365,135,18,256.50,242
,20161017,14480,14250,14555,14555,14420,14420,14530,170,280,24,348.75,248
,20161018,14420,14530,14365,14550,14300,14550,14440,20,-90,96,"1,386.48",276
,20161019,14550,14440,13920,13965,13920,13965,13925,-475,-515,102,"1,420.61",372
,20161020,13965,13925,13995,14100,13965,14100,14015,175,90,38,532.71,372
,20161021,14100,14015,13760,13930,13760,13925,13840,-90,-175,20,276.86,372
,20161024,13925,13840,13990,14235,13990,14165,14170,325,330,26,368.44,356
,20161025,14165,14170,14460,14460,14460,14460,14460,290,290,2,28.92,356
,20161026,14460,14460,14175,14465,13870,14320,14065,-140,-395,20,281.38,352
,20161027,14320,14065,14265,14450,14190,14450,14300,385,235,10,143.00,350
,20161028,14450,14300,14505,14505,14410,14410,14440,110,140,10,144.41,344
,20161031,14410,14440,14445,14585,14445,14505,14475,65,35,12,173.75,342
,20161101,14505,14475,14605,14605,14510,14510,14555,35,80,6,87.33,338
,20161102,14510,14555,14250,14280,14100,14100,14165,-455,-390,16,226.70,330
,20161103,14100,14165,14100,14100,14090,14090,14095,-75,-70,8,112.78,322
,20161104,14090,14095,14290,14290,14290,14290,14290,195,195,2,28.58,320
,20161107,14290,14290,14110,14605,14100,14540,14150,250,-140,72,"1,019.06",256
,20161108,14540,14150,14675,14915,14675,14880,14835,730,685,66,979.21,258
,20161109,14880,14835,15720,15720,15530,15530,15670,695,835,24,376.12,248
,20161110,15530,15670,16570,16570,15690,16280,16160,610,490,94,"1,519.24",232
,20161111,16280,16160,16160,16805,16095,16780,16240,620,80,62,"1,007.10",210
,20161114,16780,16240,17050,17130,15590,15590,16305,-650,65,62,"1,011.17",206
,20161115,15590,16305,15875,16020,15725,16020,15855,-285,-450,18,285.42,206
,20161116,16020,15855,16580,16805,16580,16805,16755,950,900,28,469.18,216
,20161117,16805,16755,16785,16900,16780,16900,16835,145,80,26,437.82,236
,20161118,16900,16835,16570,16570,16320,16530,16370,-305,-465,18,294.68,238
,20161121,16530,16370,16520,17350,16460,17350,16960,980,590,22,373.15,242
,20161122,17350,16960,17850,18290,17820,17960,18020,1000,1060,24,432.53,236
,20161123,17960,18020,17640,17950,17640,17950,17825,-70,-195,10,178.25,232
,20161124,17950,17825,18335,18650,18335,18600,18510,775,685,12,222.16,230
,20161125,18600,18510,18330,18535,18005,18005,18330,-505,-180,8,146.66,228
,20161128,18005,18330,18250,19160,18055,19055,18450,725,120,64,"1,180.92",250
,20161129,19055,18450,19150,19150,18750,18750,19010,300,560,8,152.11,248
,20161130,18750,19010,18605,18605,17935,18155,18285,-855,-725,34,621.72,232
,20161201,18155,18285,17895,18230,17740,18230,17950,-55,-335,8,143.60,230
,20161202,18230,17950,18065,18265,17630,17680,17940,-270,-10,28,502.35,228
,20161205,17680,17940,18345,18345,18345,18345,18345,405,405,2,36.69,228
,20161206,18345,18345,18690,18690,18290,18290,18595,-55,250,360,"6,695.18",228
,20161207,18290,18595,18645,18645,18645,18645,18645,50,50,6,111.87,222
,20161208,18645,18645,19030,19090,18425,18510,18600,-135,-45,22,409.26,206
,20161209,18510,18600,18260,19065,18165,19040,18380,440,-220,50,919.16,206
,20161212,19040,18380,19565,19665,19150,19245,19450,865,1070,60,"1,167.12",208
,20161213,19245,19450,18975,19865,18975,19865,19340,415,-110,64,"1,238.06",200
,20161214,19865,19340,20120,20120,19755,19755,19930,415,590,6,119.58,198
,20161215,19755,19930,20105,20105,19910,19910,19975,-20,45,6,119.85,198
,20161216,19910,19975,19710,20015,19710,19810,19850,-165,-125,12,238.20,190
,20161219,19810,19850,19520,19650,19315,19475,19500,-375,-350,26,507.00,188
,20161220,19475,19500,19305,19315,18770,18950,19020,-550,-480,44,837.02,180
,20161221,18950,19020,19040,19075,19040,19075,19045,55,25,8,152.39,174
,20161222,19075,19045,18710,18710,18560,18560,18635,-485,-410,4,74.54,174
,20161223,18560,18635,18595,18595,18595,18595,18595,-40,-40,8,148.76,166
,20161226,18595,18595,,,,17630,17630,-965,-965,0,0.00,166
,20161227,17630,17630,17300,17300,17300,17300,17300,-330,-330,2,34.60,164
,20161228,17300,17300,17780,17780,17665,17665,17725,365,425,100,"1,772.95",158
,20161229,17665,17725,17740,18225,17740,18190,17985,465,260,14,251.80,156
,20161230,18190,17985,18070,18070,17995,17995,18030,10,45,4,72.13,152
ru1705,20160517,12710,12710,12710,12960,12525,12950,12810,240,100,536,"6,868.28",306
,20160518,12950,12810,12865,12970,12530,12560,12805,-250,-5,1048,"13,422.52",646
,20160519,12560,12805,12505,12640,12305,12310,12505,-495,-300,654,"8,181.41",830
,20160520,12310,12505,12275,12445,12230,12355,12340,-150,-165,730,"9,011.21",1090
,20160523,12355,12340,12390,12390,11635,11800,11940,-540,-400,1140,"13,614.15",1278
,20160524,11800,11940,11770,11905,11710,11870,11850,-70,-90,580,"6,874.16",1356
,20160525,11870,11850,11985,12025,11735,11780,11860,-70,10,712,"8,447.14",1492
,20160526,11780,11860,11830,12210,11815,12200,12015,340,155,576,"6,921.17",1584
,20160527,12200,12015,12300,12325,11950,12185,12155,170,140,1498,"18,215.53",1846
,20160530,12185,12155,12280,12280,12015,12210,12140,55,-15,1532,"18,602.29",2160
,20160531,12210,12140,12230,12330,12055,12085,12210,-55,70,1454,"17,753.56",2678
,20160601,12085,12210,12085,12085,11770,11800,11890,-410,-320,1428,"16,979.63",3182
,20160602,11800,11890,11830,12025,11730,11975,11925,85,35,1926,"22,969.78",3794
,20160603,11975,11925,11970,12090,11910,12075,12015,150,90,3316,"39,855.79",5054
,20160606,12075,12015,12185,12310,12005,12305,12190,290,175,2906,"35,427.32",5832
,20160607,12305,12190,12305,12340,12080,12120,12200,-70,10,2200,"26,841.25",6372
,20160608,12120,12200,12145,12145,11865,11960,11980,-240,-220,2380,"28,514.29",6560
,20160613,11960,11980,11885,12145,11800,12055,12050,75,70,2732,"32,922.41",7526
,20160614,12055,12050,12000,12190,11850,11855,12000,-195,-50,2718,"32,620.18",8424
,20160615,11855,12000,11835,11940,11825,11915,11885,-85,-115,2214,"26,321.71",9046
,20160616,11915,11885,11980,12065,11910,11940,11985,55,100,2660,"31,884.58",9712
,20160617,11940,11985,11920,12410,11800,12410,12070,425,85,4012,"48,435.57",10236
,20160620,12410,12070,12405,12535,12335,12535,12455,465,385,6556,"81,670.90",12318
,20160621,12535,12455,12530,12625,12340,12415,12490,-40,35,5682,"70,989.15",12766
,20160622,12415,12490,12350,12700,12350,12700,12530,210,40,2740,"34,345.24",13104
,20160623,12700,12530,12700,12765,12545,12620,12635,90,105,3614,"45,680.62",13600
,20160624,12620,12635,12700,12745,12400,12465,12560,-170,-75,4954,"62,240.63",14074
,20160627,12465,12560,12450,12990,12450,12930,12740,370,180,5016,"63,914.69",14900
,20160628,12930,12740,12865,13215,12775,13110,12980,370,240,7524,"97,697.97",15934
,20160629,13110,12980,13160,13395,13075,13185,13215,205,235,7780,"102,843.99",16880
,20160630,13185,13215,13215,13625,13115,13575,13435,360,220,8724,"117,247.49",17656
,20160701,13575,13435,13555,13565,13250,13380,13420,-55,-15,7100,"95,298.16",18100
,20160704,13380,13420,13370,14130,13370,14005,13850,585,430,10694,"148,161.67",18972
,20160705,14005,13850,14050,14095,13150,13665,13695,-185,-155,11534,"157,993.50",20042
,20160706,13665,13695,13550,13800,12870,12870,13145,-825,-550,12954,"170,339.86",20330
,20160707,12870,13145,12775,13215,12740,12780,13020,-365,-125,10540,"137,266.66",20390
,20160708,12780,13020,12790,12975,12370,12625,12665,-395,-355,14834,"187,894.80",22160
,20160711,12625,12665,12720,12940,12560,12890,12760,225,95,11578,"147,752.72",23254
,20160712,12890,12760,12915,13175,12855,13050,13005,290,245,11966,"155,661.51",24710
,20160713,13050,13005,13115,13595,13015,13205,13295,200,290,19628,"261,050.25",25410
,20160714,13205,13295,13285,13350,12830,13275,13115,-20,-180,19674,"258,114.66",25500
,20160715,13275,13115,13395,13680,13175,13360,13335,245,220,17548,"234,043.58",25760
,20160718,13360,13335,13400,13445,13040,13165,13200,-170,-135,12752,"168,357.63",26886
,20160719,13165,13200,13105,13355,12990,13330,13210,130,10,16494,"217,919.24",26774
,20160720,13330,13210,13315,13540,13260,13305,13370,95,160,18516,"247,636.91",27224
,20160721,13305,13370,13280,13560,13185,13495,13425,125,55,12764,"171,359.07",27214
,20160722,13495,13425,13495,13550,13265,13270,13400,-155,-25,12998,"174,219.29",27432
,20160725,13270,13400,13285,13350,12765,12840,12985,-560,-415,14890,"193,353.73",27624
,20160726,12840,12985,12800,12870,12550,12685,12670,-300,-315,15770,"199,822.41",29258
,20160727,12685,12670,12685,12930,12665,12845,12795,175,125,12610,"161,366.24",29848
,20160728,12845,12795,12880,12975,12790,12870,12895,75,100,12056,"155,500.71",29826
,20160729,12870,12895,12910,12945,12415,12435,12635,-460,-260,18088,"228,627.31",32918
,20160801,12435,12635,12500,12855,12440,12795,12655,160,20,16464,"208,374.28",33408
,20160802,12795,12655,12765,12940,12730,12875,12815,220,160,17558,"225,023.28",34682
,20160803,12875,12815,12940,13130,12860,12895,12975,80,160,25560,"331,724.30",36876
,20160804,12895,12975,12905,12990,12600,12755,12805,-220,-170,20098,"257,407.82",38204
,20160805,12755,12805,12720,13030,12710,12950,12885,145,80,21300,"274,533.69",38382
,20160808,12950,12885,12925,13220,12865,13030,13070,145,185,28398,"371,300.61",39086
,20160809,13030,13070,13095,13165,12600,12870,12930,-200,-140,28176,"364,336.21",42200
,20160810,12870,12930,12870,12950,12760,12895,12870,-35,-60,22534,"290,056.75",42950
,20160811,12895,12870,12950,13005,12815,12910,12900,40,30,20860,"269,184.67",42736
,20160812,12910,12900,12910,13285,12905,13245,13090,345,190,28432,"372,283.43",41634
,20160815,13245,13090,13200,13375,13050,13325,13255,235,165,32428,"429,835.73",41784
,20160816,13325,13255,13325,13430,13215,13305,13315,50,60,25136,"334,789.97",41858
,20160817,13305,13315,13315,13450,13245,13270,13330,-45,15,26610,"354,812.75",42838
,20160818,13270,13330,13270,13315,13050,13150,13175,-180,-155,26734,"352,254.58",43718
,20160819,13150,13175,13185,13340,13130,13220,13230,45,55,27132,"359,060.34",44082
,20160822,13220,13230,13215,13230,12830,12840,13010,-390,-220,40234,"523,617.26",45704
,20160823,12840,13010,12810,12945,12750,12765,12860,-245,-150,25298,"325,427.32",47754
,20160824,12765,12860,12760,12910,12750,12845,12835,-15,-25,22256,"285,684.29",49206
,20160825,12845,12835,12845,12885,12400,12535,12585,-300,-250,47770,"601,200.40",50070
,20160826,12535,12585,12550,12590,12460,12515,12520,-70,-65,25934,"324,729.95",50252
,20160829,12515,12520,12560,12610,12330,12540,12490,20,-30,31404,"392,350.28",50594
,20160830,12540,12490,12540,12680,12425,12455,12570,-35,80,29960,"376,625.30",51162
,20160831,12455,12570,12450,12505,12220,12255,12360,-315,-210,40804,"504,379.86",53666
,20160901,12255,12360,12255,12575,12235,12550,12405,190,45,41504,"514,871.03",53752
,20160902,12550,12405,12535,12695,12510,12570,12595,165,190,33004,"415,790.84",51654
,20160905,12570,12595,12605,12815,12575,12755,12720,160,125,30852,"392,502.60",52038
,20160906,12755,12720,12780,12785,12630,12760,12705,40,-15,27694,"351,893.69",53004
,20160907,12760,12705,12695,12885,12650,12840,12755,135,50,38702,"493,695.29",54008
,20160908,12840,12755,12840,12990,12760,12955,12885,200,130,36194,"466,465.11",54520
,20160909,12955,12885,12955,13040,12905,12950,12960,65,75,33150,"429,701.37",55022
,20160912,12950,12960,12930,12940,12545,12570,12700,-390,-260,48038,"610,317.79",57768
,20160913,12570,12700,12605,12695,12560,12645,12630,-55,-70,27630,"348,982.52",56770
,20160914,12645,12630,12685,12775,12590,12720,12695,90,65,32934,"418,165.47",56558
,20160919,12720,12695,12775,13190,12605,13180,12970,485,275,46950,"608,941.85",58122
,20160920,13180,12970,13180,13400,13165,13380,13310,410,340,47174,"627,914.86",60596
,20160921,13380,13310,13405,13450,13255,13370,13340,60,30,37692,"502,922.40",59986
,20160922,13370,13340,13370,13850,13320,13665,13615,325,275,80296,"1,093,614.71",61830
,20160923,13665,13615,13680,13780,13540,13755,13670,140,55,43656,"596,848.42",62892
,20160926,13755,13670,13725,13790,13515,13650,13630,-20,-40,54980,"749,493.88",62938
,20160927,13650,13630,13650,13650,13315,13515,13450,-115,-180,64218,"863,928.23",63758
,20160928,13515,13450,13480,13755,13400,13670,13625,220,175,75588,"1,029,951.18",66276
,20160929,13670,13625,13650,13980,13465,13500,13730,-125,105,79578,"1,092,728.58",62152
,20160930,13500,13730,13500,13545,13345,13470,13445,-260,-285,38282,"514,869.52",60216
,20161010,13470,13445,13760,14085,13660,14010,13900,565,455,59514,"827,374.37",59900
,20161011,14010,13900,14015,14440,14015,14410,14310,510,410,80974,"1,158,897.36",65524
,20161012,14410,14310,14335,14480,14260,14365,14345,55,35,60256,"864,614.74",67902
,20161013,14365,14345,14320,14445,14130,14225,14275,-120,-70,75392,"1,076,522.07",70294
,20161014,14225,14275,14170,14700,14145,14590,14505,315,230,80084,"1,161,672.31",73396
,20161017,14590,14505,14645,14730,14460,14535,14575,30,70,76304,"1,112,150.81",78498
,20161018,14535,14575,14540,14690,14370,14660,14525,85,-50,77768,"1,129,612.80",86178
,20161019,14660,14525,14620,14645,13940,14100,14280,-425,-245,122286,"1,746,503.12",87472
,20161020,14100,14280,14105,14235,14060,14125,14145,-155,-135,84002,"1,188,333.98",92234
,20161021,14125,14145,14105,14140,13780,14000,13940,-145,-205,91492,"1,275,722.59",95690
,20161024,14000,13940,14055,14350,14005,14250,14190,310,250,87864,"1,247,128.61",100654
,20161025,14250,14190,14260,14640,14250,14315,14460,125,270,109334,"1,581,152.78",101654
,20161026,14315,14460,14320,14415,13950,14400,14185,-60,-275,137312,"1,947,813.40",109118
,20161027,14400,14185,14365,14650,14180,14535,14445,350,260,156182,"2,256,176.74",114190
,20161028,14535,14445,14585,14820,14435,14560,14600,115,155,179520,"2,620,999.62",127566
,20161031,14560,14600,14560,14715,14370,14615,14565,15,-35,152698,"2,224,290.66",126244
,20161101,14615,14565,14580,14760,14415,14520,14590,-45,25,140186,"2,045,453.33",131536
,20161102,14520,14590,14515,14640,14125,14195,14370,-395,-220,139030,"1,998,132.26",133128
,20161103,14195,14370,14220,14310,14040,14260,14190,-110,-180,89240,"1,266,617.53",132602
,20161104,14260,14190,14280,14550,14070,14155,14330,-35,140,136856,"1,961,696.49",130670
,20161107,14155,14330,14170,15160,14130,14930,14670,600,340,215546,"3,162,372.30",139314
,20161108,14930,14670,14900,15550,14800,15550,15240,880,570,259570,"3,956,267.29",157598
,20161109,15550,15240,15550,16110,15520,15695,15740,455,500,284556,"4,479,695.88",157590
,20161110,15695,15740,15860,16475,15310,16365,15960,625,220,358336,"5,719,139.89",168710
,20161111,16365,15960,16490,16915,16030,16830,16475,870,515,211296,"3,481,128.93",165044
,20161114,16830,16475,16780,17375,15485,15755,16180,-720,-295,299060,"4,839,525.12",145752
,20161115,15755,16180,15960,16435,15605,16060,16050,-120,-130,251618,"4,039,719.64",166820
,20161116,16060,16050,16200,17010,16115,17010,16600,960,550,241538,"4,009,635.01",187144
,20161117,17010,16600,17000,17180,16750,17010,16975,410,375,211484,"3,590,259.84",193794
,20161118,17010,16975,17010,17015,16365,16695,16650,-280,-325,201142,"3,350,014.60",192650
,20161121,16695,16650,16720,17645,16535,17645,17155,995,505,185836,"3,188,177.11",208626
,20161122,17645,17155,17855,18450,17820,18065,18075,910,920,304346,"5,501,997.26",211732
,20161123,18065,18075,17665,18265,17650,18085,18020,10,-55,250598,"4,516,631.40",213962
,20161124,18085,18020,18045,18935,17980,18270,18555,250,535,469008,"8,702,571.32",230564
,20161125,18270,18555,18285,18680,17965,18420,18355,-135,-200,378250,"6,944,208.03",238004
,20161128,18420,18355,18250,19615,18170,19390,18775,1035,420,626036,"11,756,076.72",278848
,20161129,19390,18775,19260,19495,18555,18740,19115,-35,340,588320,"11,247,872.45",279142
,20161130,18740,19115,18785,18860,17775,17775,18215,-1340,-900,566424,"10,319,196.58",256552
,20161201,17775,18215,18090,18440,17745,18085,18135,-130,-80,660444,"11,978,560.16",262498
,20161202,18085,18135,18155,18325,17360,18015,17850,-120,-285,641480,"11,451,590.17",258762
,20161205,18015,17850,18020,18725,17870,18590,18305,740,455,543740,"9,954,482.35",270090
,20161206,18590,18305,18700,18870,18410,18565,18640,260,335,407034,"7,587,499.33",268740
,20161207,18565,18640,18545,19050,18420,19030,18735,390,95,468948,"8,786,947.66",279524
,20161208,19030,18735,19050,19500,18505,18630,18935,-105,200,584688,"11,072,046.15",276116
,20161209,18630,18935,18720,19210,18200,19085,18665,150,-270,636886,"11,889,129.94",278412
,20161212,19085,18665,19285,19965,18930,19345,19455,680,790,566406,"11,021,729.94",265890
,20161213,19345,19455,19360,20115,19250,20110,19610,655,155,534588,"10,484,376.06",289704
,20161214,20110,19610,20500,20580,19780,20310,20155,700,545,589534,"11,883,586.48",285876
,20161215,20310,20155,20480,20520,19715,20015,20055,-140,-100,645756,"12,951,240.41",271632
,20161216,20015,20055,19900,20300,19600,19700,19945,-355,-110,469050,"9,357,332.67",270992
,20161219,19700,19945,19645,19930,19500,19520,19715,-425,-230,416462,"8,212,089.61",267496
,20161220,19520,19715,19400,19470,18705,19090,19095,-625,-620,592814,"11,320,758.52",262730
,20161221,19090,19095,19190,19450,19000,19360,19230,265,135,434458,"8,356,250.20",262526
,20161222,19360,19230,19300,19425,18485,18540,19035,-690,-195,482270,"9,182,206.55",268276
,20161223,18540,19035,18530,18830,18350,18665,18615,-370,-420,465860,"8,673,267.16",256046
,20161226,18665,18615,18665,18755,17360,17660,18000,-955,-615,548646,"9,876,761.48",255752
,20161227,17660,18000,17660,17965,17200,17930,17590,-70,-410,506572,"8,912,723.00",242772
,20161228,17930,17590,18010,18345,17675,17705,17975,115,385,491830,"8,840,864.83",241916
,20161229,17705,17975,17785,18385,17515,18315,17985,340,10,494982,"8,904,657.58",242236
,20161230,18315,17985,18250,18450,17905,18350,18170,365,185,412746,"7,500,032.69",234266
ru1706,20160616,11885,11885,12800,12800,11945,11945,12370,60,485,4,49.49,4
,20160617,11945,12370,,,,12370,12370,0,0,0,0.00,4
,20160620,12370,12370,,,,12370,12370,0,0,0,0.00,4
,20160621,12370,12370,,,,12370,12370,0,0,0,0.00,4
,20160622,12370,12370,,,,12370,12370,0,0,0,0.00,4
,20160623,12370,12370,12775,12810,12575,12605,12685,235,315,10,126.85,6
,20160624,12605,12685,12480,12480,12480,12480,12480,-205,-205,2,24.96,6
,20160627,12480,12480,12800,12800,12800,12800,12800,320,320,2,25.60,6
,20160628,12800,12800,13160,13220,13160,13190,13195,390,395,14,184.78,18
,20160629,13190,13195,13310,13345,13105,13345,13245,150,50,20,264.96,28
,20160630,13345,13245,13200,13570,13135,13570,13275,325,30,30,398.36,36
,20160701,13570,13275,13450,13450,13450,13450,13450,175,175,4,53.80,38
,20160704,13450,13450,13985,14100,13985,14100,14045,650,595,8,112.37,40
,20160705,14100,14045,13875,13875,13500,13600,13655,-445,-390,6,81.95,40
,20160706,13600,13655,13650,13650,12860,12860,13110,-795,-545,38,498.34,46
,20160707,12860,13110,12860,13150,12830,12900,12965,-210,-145,38,492.79,48
,20160708,12900,12965,12975,12975,12480,12750,12715,-215,-250,746,"9,487.86",752
,20160711,12750,12715,12705,12935,12705,12840,12775,125,60,282,"3,603.75",1012
,20160712,12840,12775,13260,13260,13145,13180,13180,405,405,36,474.49,1010
,20160713,13180,13180,13165,13520,13165,13250,13310,70,130,48,639.07,1022
,20160714,13250,13310,13400,13400,13200,13210,13270,-100,-40,6,79.62,1020
,20160715,13210,13270,13500,13530,13480,13530,13495,260,225,14,188.94,1024
,20160718,13530,13495,13430,13430,13135,13190,13275,-305,-220,36,478.06,1028
,20160719,13190,13275,13240,13380,13080,13220,13180,-55,-95,14,184.58,1032
,20160720,13220,13180,13505,13505,13505,13505,13505,325,325,4,54.02,1030
,20160721,13505,13505,,,,13505,13505,0,0,0,0.00,1030
,20160722,13505,13505,13655,13655,13655,13655,13655,150,150,2,27.31,1030
,20160725,13655,13655,13440,13440,12900,12900,13145,-755,-510,80,"1,051.76",1058
,20160726,12900,13145,12805,13040,12780,12780,12850,-365,-295,78,"1,002.59",1062
,20160727,12780,12850,12850,12985,12850,12870,12930,20,80,22,284.52,1054
,20160728,12870,12930,13030,13050,13000,13000,13010,70,80,48,624.62,1076
,20160729,13000,13010,12940,12970,12510,12550,12670,-460,-340,28,354.82,1086
,20160801,12550,12670,12625,12985,12610,12985,12725,315,55,10,127.29,1082
,20160802,12985,12725,13045,13045,13045,13045,13045,320,320,2,26.09,1082
,20160803,13045,13045,13270,13270,12995,13020,13160,-25,115,12,157.92,1084
,20160804,13020,13160,12905,13055,12905,12960,12975,-200,-185,12,155.72,1086
,20160805,12960,12975,12860,13105,12860,13065,12990,90,15,10,129.93,1086
,20160808,13065,12990,13270,13320,13150,13150,13265,160,275,12,159.19,1082
,20160809,13150,13265,13200,13200,12795,12920,12885,-345,-380,12,154.62,1080
,20160810,12920,12885,13015,13080,12975,13080,13015,195,130,12,156.18,1088
,20160811,13080,13015,13090,13120,13030,13030,13075,15,60,56,732.43,1076
,20160812,13030,13075,13270,13270,13270,13270,13270,195,195,8,106.16,1076
,20160815,13270,13270,13295,13400,13235,13300,13335,30,65,1256,"16,750.42",212
,20160816,13300,13335,13360,13400,13270,13300,13330,-35,-5,20,266.66,218
,20160817,13300,13330,13450,13450,13400,13400,13425,70,95,4,53.70,216
,20160818,13400,13425,13130,13195,13130,13150,13155,-275,-270,20,263.14,210
,20160819,13150,13155,13280,13280,13280,13280,13280,125,125,2,26.56,208
,20160822,13280,13280,13160,13160,13160,13160,13160,-120,-120,4,52.64,208
,20160823,13160,13160,12870,12935,12805,12805,12880,-355,-280,12,154.56,210
,20160824,12805,12880,12845,12935,12845,12920,12880,40,0,14,180.33,210
,20160825,12920,12880,12820,12820,12500,12620,12650,-260,-230,12,151.80,212
,20160826,12620,12650,12585,12585,12530,12530,12555,-120,-95,8,100.46,210
,20160829,12530,12555,12400,12605,12400,12605,12450,50,-105,8,99.61,212
,20160830,12605,12450,12660,12660,12485,12485,12520,35,70,10,125.20,210
,20160831,12485,12520,12280,12280,12280,12280,12280,-240,-240,2,24.56,212
,20160901,12280,12280,12410,12520,12325,12520,12400,240,120,52,645.00,210
,20160902,12520,12400,12590,12600,12555,12555,12580,155,180,8,100.67,214
,20160905,12555,12580,,,,12580,12580,0,0,0,0.00,214
,20160906,12580,12580,12715,12725,12685,12685,12710,105,130,18,228.78,216
,20160907,12685,12710,12800,12800,12800,12800,12800,90,90,2,25.60,218
,20160908,12800,12800,,,,12900,12900,100,100,0,0.00,218
,20160909,12900,12900,12945,13020,12945,12980,12980,80,80,6,77.89,218
,20160912,12980,12980,12920,12920,12600,12600,12685,-380,-295,14,177.63,214
,20160913,12600,12685,12660,12660,12660,12660,12660,-25,-25,2,25.32,212
,20160914,12660,12660,12760,12760,12720,12720,12750,60,90,10,127.52,208
,20160919,12720,12750,13140,13140,13140,13140,13140,390,390,4,52.56,212
,20160920,13140,13140,13290,13440,13265,13440,13330,300,190,6,79.99,214
,20160921,13440,13330,13375,13375,13310,13365,13340,35,10,16,213.46,204
,20160922,13365,13340,13410,13840,13410,13730,13640,390,300,14,191.02,206
,20160923,13730,13640,13605,13605,13575,13575,13590,-65,-50,4,54.36,204
,20160926,13575,13590,,,,13590,13590,0,0,0,0.00,204
,20160927,13590,13590,13645,13645,13520,13520,13590,-70,0,42,570.84,200
,20160928,13520,13590,13680,13680,13625,13625,13650,35,60,4,54.61,200
,20160929,13625,13650,13880,13895,13515,13530,13750,-120,100,12,165.04,196
,20160930,13530,13750,13530,13530,13380,13485,13470,-265,-280,12,161.69,194
,20161010,13485,13470,13850,14005,13675,14005,13840,535,370,30,415.23,190
,20161011,14005,13840,14235,14395,14235,14395,14335,555,495,20,286.73,184
,20161012,14395,14335,14360,14360,14360,14360,14360,25,25,2,28.72,182
,20161013,14360,14360,14200,14200,14200,14200,14200,-160,-160,4,56.80,180
,20161014,14200,14200,14570,14680,14535,14670,14620,470,420,12,175.46,178
,20161017,14670,14620,14590,14590,14485,14550,14550,-70,-70,14,203.74,178
,20161018,14550,14550,14395,14395,14395,14395,14395,-155,-155,4,57.58,176
,20161019,14395,14395,14500,14500,14075,14075,14225,-320,-170,64,910.41,158
,20161020,14075,14225,14145,14160,14145,14160,14150,-65,-75,12,169.82,160
,20161021,14160,14150,13860,13860,13860,13860,13860,-290,-290,2,27.72,160
,20161024,13860,13860,14115,14380,14100,14325,14205,465,345,10,142.06,160
,20161025,14325,14205,14490,14550,14460,14460,14495,255,290,16,231.99,158
,20161026,14460,14495,14370,14485,14050,14485,14265,-10,-230,56,798.99,152
,20161027,14485,14265,14350,14575,14350,14575,14430,310,165,8,115.46,146
,20161028,14575,14430,14755,14800,14550,14640,14700,210,270,14,205.81,148
,20161031,14640,14700,14435,14695,14435,14645,14540,-55,-160,20,290.87,140
,20161101,14645,14540,14665,14785,14565,14600,14620,60,80,36,526.45,140
,20161102,14600,14620,14450,14450,14275,14275,14380,-345,-240,8,115.04,144
,20161103,14275,14380,,,,14330,14330,-50,-50,0,0.00,144
,20161104,14330,14330,14485,14485,14485,14485,14485,155,155,8,115.88,140
,20161107,14485,14485,14500,15070,14500,14945,14875,460,390,18,267.79,142
,20161108,14945,14875,14965,15750,14880,15715,15595,840,720,558,"8,704.52",520
,20161109,15715,15595,15575,16120,15575,15795,15855,200,260,838,"13,287.61",1058
,20161110,15795,15855,16100,16100,15665,15850,15855,-5,0,44,697.83,1048
,20161111,15850,15855,16300,16805,16215,16805,16490,950,635,62,"1,022.56",1046
,20161114,16805,16490,16855,17150,15650,15990,16200,-500,-290,204,"3,305.70",1056
,20161115,15990,16200,16035,16150,15890,16135,16020,-65,-180,16,256.34,1058
,20161116,16135,16020,16380,16980,16345,16980,16710,960,690,1260,"21,059.68",326
,20161117,16980,16710,16980,17200,16755,17120,17020,410,310,326,"5,548.92",426
,20161118,17120,17020,17000,17000,16450,16580,16950,-440,-70,288,"4,882.42",238
,20161121,16580,16950,16580,17955,16580,17950,17595,1000,645,80,"1,407.67",292
,20161122,17950,17595,18000,18355,17950,18000,18095,405,500,166,"3,004.02",244
,20161123,18000,18095,17795,18215,17795,18215,18130,120,35,16,290.14,234
,20161124,18215,18130,18085,18880,18085,18460,18550,330,420,174,"3,228.44",250
,20161125,18460,18550,18360,18570,18080,18200,18395,-350,-155,54,993.36,230
,20161128,18200,18395,18345,19495,18250,19465,18790,1070,395,56,"1,052.35",232
,20161129,19465,18790,19465,19490,18750,18965,19205,175,415,158,"3,034.78",244
,20161130,18965,19205,18660,18940,17860,17860,18500,-1345,-705,204,"3,774.08",240
,20161201,17860,18500,18070,18350,18050,18050,18195,-450,-305,24,436.79,240
,20161202,18050,18195,18050,18385,17630,17980,18035,-215,-160,222,"4,004.49",260
,20161205,17980,18035,19295,19295,18010,18560,18565,525,530,62,"1,151.21",246
,20161206,18560,18565,18890,18890,18545,18585,18620,20,55,52,968.35,238
,20161207,18585,18620,18530,18985,18530,18985,18780,365,160,66,"1,239.49",232
,20161208,18985,18780,19335,19455,18635,18675,19300,-105,520,62,"1,196.79",234
,20161209,18675,19300,18720,19170,18410,19170,18690,-130,-610,30,560.76,234
,20161212,19170,18690,19480,19980,19280,19435,19675,745,985,60,"1,180.61",234
,20161213,19435,19675,19500,20125,19420,20125,19690,450,15,180,"3,544.99",232
,20161214,20125,19690,20435,20470,20055,20395,20300,705,610,58,"1,177.44",242
,20161215,20395,20300,20440,20440,19900,20010,20085,-290,-215,244,"4,901.57",232
,20161216,20010,20085,19885,20245,19715,19715,20080,-370,-5,26,522.19,236
,20161219,19715,20080,19620,19845,19620,19845,19775,-235,-305,12,237.34,234
,20161220,19845,19775,19425,19425,18980,19295,19270,-480,-505,44,847.96,244
,20161221,19295,19270,19330,19330,19320,19320,19325,50,55,4,77.30,246
,20161222,19320,19325,19425,19435,18600,18600,19270,-725,-55,18,346.92,240
,20161223,18600,19270,18530,18770,18530,18605,18700,-665,-570,32,598.42,238
,20161226,18605,18700,18725,18730,17520,17685,17975,-1015,-725,116,"2,085.53",254
,20161227,17685,17975,17485,17860,17485,17860,17705,-115,-270,20,354.16,256
,20161228,17860,17705,17950,17950,17930,17930,17935,225,230,10,179.38,256
,20161229,17930,17935,17625,18330,17625,18330,18005,395,70,78,"1,404.68",246
,20161230,18330,18005,18080,18165,18030,18165,18095,160,90,12,217.18,242
ru1707,20160718,13495,13495,13480,13480,13175,13400,13330,-95,-165,8,106.67,8
,20160719,13400,13330,13245,13430,12975,13400,13230,70,-100,18,238.20,18
,20160720,13400,13230,13590,13700,13360,13515,13565,285,335,22,298.43,20
,20160721,13515,13565,13490,13490,13490,13490,13490,-75,-75,2,26.98,20
,20160722,13490,13490,13615,13630,13500,13500,13565,10,75,26,352.79,28
,20160725,13500,13565,13100,13100,13040,13080,13070,-485,-495,6,78.44,28
,20160726,13080,13070,13070,13070,12680,12960,12850,-110,-220,12,154.21,34
,20160727,12960,12850,13050,13100,13050,13100,13075,250,225,4,52.30,34
,20160728,13100,13075,,,,13075,13075,0,0,0,0.00,34
,20160729,13075,13075,12805,12805,12805,12805,12805,-270,-270,2,25.61,34
,20160801,12805,12805,12800,12800,12800,12800,12800,-5,-5,2,25.60,36
,20160802,12800,12800,,,,12800,12800,0,0,0,0.00,36
,20160803,12800,12800,,,,12800,12800,0,0,0,0.00,36
,20160804,12800,12800,,,,12800,12800,0,0,0,0.00,36
,20160805,12800,12800,,,,12815,12815,15,15,0,0.00,36
,20160808,12815,12815,13250,13305,13100,13305,13240,490,425,12,158.92,32
,20160809,13305,13240,13265,13265,12880,13110,13025,-130,-215,10,130.27,34
,20160810,13110,13025,,,,13025,13025,0,0,0,0.00,34
,20160811,13025,13025,,,,13025,13025,0,0,0,0.00,34
,20160812,13025,13025,13290,13360,13290,13360,13325,335,300,4,53.30,32
,20160815,13360,13325,13300,13465,13300,13360,13395,35,70,26,348.27,34
,20160816,13360,13395,13515,13515,13355,13410,13395,15,0,18,241.11,32
,20160817,13410,13395,,,,13395,13395,0,0,0,0.00,32
,20160818,13395,13395,,,,13395,13395,0,0,0,0.00,32
,20160819,13395,13395,13250,13270,13250,13270,13255,-125,-140,18,238.63,46
,20160822,13270,13255,13220,13220,12990,13070,13110,-185,-145,36,472.07,38
,20160823,13070,13110,12875,12875,12875,12875,12875,-235,-235,2,25.75,40
,20160824,12875,12875,12850,12885,12850,12885,12865,10,-10,8,102.94,40
,20160825,12885,12865,12630,12630,12630,12630,12630,-235,-235,2,25.26,38
,20160826,12630,12630,,,,12630,12630,0,0,0,0.00,38
,20160829,12630,12630,12480,12480,12480,12480,12480,-150,-150,2,24.96,38
,20160830,12480,12480,12580,12755,12580,12755,12680,275,200,6,76.08,38
,20160831,12755,12680,12480,12480,12470,12470,12475,-210,-205,6,74.86,42
,20160901,12470,12475,,,,12475,12475,0,0,0,0.00,42
,20160902,12475,12475,12680,12680,12680,12680,12680,205,205,2,25.36,40
,20160905,12680,12680,,,,12680,12680,0,0,0,0.00,40
,20160906,12680,12680,,,,12680,12680,0,0,0,0.00,40
,20160907,12680,12680,,,,12680,12680,0,0,0,0.00,40
,20160908,12680,12680,13000,13000,13000,13000,13000,320,320,2,26.00,38
,20160909,13000,13000,,,,13000,13000,0,0,0,0.00,38
,20160912,13000,13000,,,,12730,12730,-270,-270,0,0.00,38
,20160913,12730,12730,,,,12730,12730,0,0,0,0.00,38
,20160914,12730,12730,,,,12730,12730,0,0,0,0.00,38
,20160919,12730,12730,,,,13115,13115,385,385,0,0.00,38
,20160920,13115,13115,13330,13490,13330,13375,13395,260,280,6,80.39,40
,20160921,13375,13395,13400,13405,13400,13405,13400,10,5,6,80.42,44
,20160922,13405,13400,13530,13665,13530,13665,13600,265,200,6,81.60,44
,20160923,13665,13600,13665,13665,13665,13665,13665,65,65,2,27.33,44
,20160926,13665,13665,,,,13665,13665,0,0,0,0.00,44
,20160927,13665,13665,13640,13685,13440,13550,13585,-115,-80,26,353.29,48
,20160928,13550,13585,13700,13700,13700,13700,13700,115,115,2,27.40,48
,20160929,13700,13700,,,,13700,13700,0,0,0,0.00,48
,20160930,13700,13700,,,,13425,13425,-275,-275,0,0.00,48
,20161010,13425,13425,,,,13790,13790,365,365,0,0.00,48
,20161011,13790,13790,14150,14400,14150,14380,14330,590,540,20,286.62,56
,20161012,14380,14330,14360,14435,14335,14435,14385,105,55,16,230.23,54
,20161013,14435,14385,14250,14250,14155,14155,14200,-230,-185,4,56.81,54
,20161014,14155,14200,14495,14680,14495,14670,14580,470,380,28,408.28,68
,20161017,14670,14580,14590,14590,14590,14590,14590,10,10,2,29.18,70
,20161018,14590,14590,14365,14660,14365,14660,14580,70,-10,8,116.65,72
,20161019,14660,14580,14580,14580,14045,14045,14315,-535,-265,14,200.45,76
,20161020,14045,14315,14175,14175,14170,14170,14170,-145,-145,10,141.74,74
,20161021,14170,14170,14150,14160,13960,14045,14025,-125,-145,18,252.49,88
,20161024,14045,14025,14085,14330,14085,14330,14160,305,135,36,509.83,94
,20161025,14330,14160,,,,14160,14160,0,0,0,0.00,94
,20161026,14160,14160,14425,14425,14410,14410,14415,250,255,6,86.49,100
,20161027,14410,14415,14660,14670,14410,14410,14580,-5,165,6,87.48,98
,20161028,14410,14580,14710,14710,14630,14685,14670,105,90,12,176.07,100
,20161031,14685,14670,14510,14580,14510,14580,14545,-90,-125,4,58.18,102
,20161101,14580,14545,14645,14740,14645,14740,14690,195,145,4,58.77,106
,20161102,14740,14690,14285,14285,14285,14285,14285,-405,-405,2,28.57,108
,20161103,14285,14285,14250,14250,14250,14250,14250,-35,-35,2,28.50,108
,20161104,14250,14250,,,,14250,14250,0,0,0,0.00,108
,20161107,14250,14250,14660,15080,14660,15080,14870,830,620,4,59.48,106
,20161108,15080,14870,15505,15730,15340,15730,15570,860,700,22,342.57,114
,20161109,15730,15570,15920,16000,15700,15780,15860,210,290,40,634.53,120
,20161110,15780,15860,16000,16460,15900,16440,16225,580,365,18,292.10,130
,20161111,16440,16225,16420,17105,16420,16975,16910,750,685,20,338.28,136
,20161114,16975,16910,15895,16405,15895,15895,16140,-1015,-770,38,613.33,146
,20161115,15895,16140,16370,16370,16200,16205,16255,65,115,6,97.55,146
,20161116,16205,16255,16755,17230,16755,17230,17090,975,835,24,410.17,146
,20161117,17230,17090,17140,17250,16985,17250,17055,160,-35,24,409.41,128
,20161118,17250,17055,16670,16730,16670,16730,16700,-325,-355,4,66.80,128
,20161121,16730,16700,,,,17700,17700,1000,1000,0,0.00,128
,20161122,17700,17700,18145,18420,18145,18320,18300,620,600,8,146.41,126
,20161123,18320,18300,18245,18245,18230,18230,18240,-70,-60,6,109.44,124
,20161124,18230,18240,18805,18840,18750,18760,18770,520,530,16,300.37,116
,20161125,18760,18770,18420,18550,18225,18330,18400,-440,-370,38,699.29,104
,20161128,18330,18400,18540,19490,18540,19260,18955,860,555,8,151.66,106
,20161129,19260,18955,19475,19475,18945,18945,19205,-10,250,8,153.64,106
,20161130,18945,19205,18210,18525,17920,18095,18155,-1110,-1050,30,544.72,100
,20161201,18095,18155,,,,18155,18155,0,0,0,0.00,100
,20161202,18155,18155,17990,18120,17620,17620,17910,-535,-245,6,107.46,104
,20161205,17620,17910,18520,18665,18390,18665,18485,755,575,108,"1,996.78",128
,20161206,18665,18485,18820,18820,18680,18680,18750,195,265,4,75.00,128
,20161207,18680,18750,18900,18900,18900,18900,18900,150,150,4,75.60,126
,20161208,18900,18900,19460,19460,18695,18725,18970,-175,70,14,265.61,120
,20161209,18725,18970,18255,19210,18255,19210,18675,240,-295,6,112.05,122
,20161212,19210,18675,19975,19975,19365,19365,19740,690,1065,20,394.85,124
,20161213,19365,19740,19460,20160,19460,20160,19660,420,-80,12,235.93,124
,20161214,20160,19660,20310,20310,20150,20150,20210,490,550,8,161.69,126
,20161215,20150,20210,20150,20370,20150,20155,20220,-55,10,10,202.20,128
,20161216,20155,20220,19990,20180,19985,20005,20030,-215,-190,10,200.30,124
,20161219,20005,20030,19640,19880,19640,19835,19800,-195,-230,8,158.43,120
,20161220,19835,19800,19470,19470,19065,19065,19225,-735,-575,6,115.37,118
,20161221,19065,19225,19330,19330,19330,19330,19330,105,105,2,38.66,116
,20161222,19330,19330,19430,19430,18925,18925,19145,-405,-185,6,114.87,112
,20161223,18925,19145,,,,19030,19030,-115,-115,0,0.00,112
,20161226,19030,19030,18055,18055,17790,17795,17895,-1235,-1135,14,250.59,116
,20161227,17795,17895,17840,17840,17840,17840,17840,-55,-55,2,35.68,114
,20161228,17840,17840,17840,17840,17840,17840,17840,0,0,2,35.68,114
,20161229,17840,17840,18120,18330,18120,18280,18260,440,420,8,146.10,114
,20161230,18280,18260,,,,18260,18260,0,0,0,0.00,114
ru1708,20160816,13395,13395,,,,13395,13395,0,0,0,0.00,0
,20160817,13395,13395,13475,13475,13410,13410,13440,15,45,4,53.77,4
,20160818,13410,13440,,,,13440,13440,0,0,0,0.00,4
,20160819,13440,13440,13380,13380,13280,13280,13330,-160,-110,4,53.32,6
,20160822,13280,13330,,,,13330,13330,0,0,0,0.00,6
,20160823,13330,13330,13090,13090,12765,13020,12930,-310,-400,10,129.33,12
,20160824,13020,12930,13030,13065,13030,13065,13045,135,115,4,52.19,12
,20160825,13065,13045,12795,12795,12600,12675,12725,-370,-320,18,229.08,24
,20160826,12675,12725,12655,12655,12655,12655,12655,-70,-70,2,25.31,22
,20160829,12655,12655,12700,12700,12700,12700,12700,45,45,2,25.40,20
,20160830,12700,12700,,,,12700,12700,0,0,0,0.00,20
,20160831,12700,12700,,,,12545,12545,-155,-155,0,0.00,20
,20160901,12545,12545,12500,12500,12500,12500,12500,-45,-45,2,25.00,22
,20160902,12500,12500,12725,12755,12725,12755,12740,255,240,4,50.96,24
,20160905,12755,12740,12760,12760,12760,12760,12760,20,20,2,25.52,26
,20160906,12760,12760,,,,12760,12760,0,0,0,0.00,26
,20160907,12760,12760,12940,12940,12940,12940,12940,180,180,2,25.88,26
,20160908,12940,12940,13030,13030,13030,13030,13030,90,90,2,26.06,26
,20160909,13030,13030,12990,12990,12990,12990,12990,-40,-40,6,77.94,26
,20160912,12990,12990,12850,12850,12735,12735,12785,-255,-205,8,102.29,22
,20160913,12735,12785,,,,12785,12785,0,0,0,0.00,22
,20160914,12785,12785,12880,12880,12835,12835,12865,50,80,6,77.19,20
,20160919,12835,12865,12945,13200,12945,13200,13075,335,210,16,209.27,30
,20160920,13200,13075,13370,13370,13350,13350,13360,275,285,6,80.18,34
,20160921,13350,13360,13390,13410,13320,13320,13375,-40,15,8,107.02,34
,20160922,13320,13375,13485,13615,13485,13590,13560,215,185,8,108.50,34
,20160923,13590,13560,13650,13650,13650,13650,13650,90,90,4,54.60,32
,20160926,13650,13650,13700,13700,13695,13700,13695,50,45,6,82.19,26
,20160927,13700,13695,,,,13695,13695,0,0,0,0.00,26
,20160928,13695,13695,,,,13695,13695,0,0,0,0.00,26
,20160929,13695,13695,13650,13650,13600,13640,13630,-55,-65,14,190.82,24
,20160930,13640,13630,,,,13355,13355,-275,-275,0,0.00,24
,20161010,13355,13355,,,,13720,13720,365,365,0,0.00,24
,20161011,13720,13720,,,,14255,14255,535,535,0,0.00,24
,20161012,14255,14255,,,,14255,14255,0,0,0,0.00,24
,20161013,14255,14255,,,,14255,14255,0,0,0,0.00,24
,20161014,14255,14255,14685,14685,14685,14685,14685,430,430,4,58.74,28
,20161017,14685,14685,14670,14670,14670,14670,14670,-15,-15,2,29.34,28
,20161018,14670,14670,14635,14635,14635,14635,14635,-35,-35,2,29.27,28
,20161019,14635,14635,14400,14400,14215,14215,14305,-420,-330,4,57.23,28
,20161020,14215,14305,,,,14305,14305,0,0,0,0.00,28
,20161021,14305,14305,,,,14305,14305,0,0,0,0.00,28
,20161024,14305,14305,14235,14270,14200,14270,14225,-35,-80,12,170.73,34
,20161025,14270,14225,14650,14650,14635,14635,14640,410,415,4,58.57,38
,20161026,14635,14640,14470,14510,14200,14200,14410,-440,-230,16,230.61,40
,20161027,14200,14410,14465,14630,14465,14630,14515,220,105,14,203.27,40
,20161028,14630,14515,14955,14965,14690,14725,14830,210,315,32,474.64,46
,20161031,14725,14830,14635,14685,14595,14685,14630,-145,-200,8,117.06,42
,20161101,14685,14630,14850,14850,14810,14810,14835,180,205,6,89.02,46
,20161102,14810,14835,14785,14785,14460,14460,14620,-375,-215,4,58.49,46
,20161103,14460,14620,,,,14500,14500,-120,-120,0,0.00,46
,20161104,14500,14500,14280,14320,14280,14320,14300,-180,-200,4,57.20,48
,20161107,14320,14300,14585,15130,14585,15110,14980,810,680,12,179.79,42
,20161108,15110,14980,,,,15540,15540,560,560,0,0.00,42
,20161109,15540,15540,15940,16080,15895,15910,15950,370,410,24,382.86,44
,20161110,15910,15950,15990,15990,15990,15990,15990,40,40,2,31.98,44
,20161111,15990,15990,16420,16450,16420,16450,16430,460,440,8,131.44,40
,20161114,16450,16430,17250,17350,15900,15945,16430,-485,0,28,460.09,40
,20161115,15945,16430,16125,16125,16125,16125,16125,-305,-305,2,32.25,40
,20161116,16125,16125,16750,17050,16750,17050,16880,925,755,6,101.30,38
,20161117,17050,16880,,,,17040,17040,160,160,0,0.00,38
,20161118,17040,17040,17075,17075,16900,16900,16985,-140,-55,4,67.95,40
,20161121,16900,16985,,,,17630,17630,645,645,0,0.00,40
,20161122,17630,17630,18150,18340,18150,18340,18235,710,605,8,145.91,38
,20161123,18340,18235,18400,18400,18300,18300,18350,65,115,4,73.40,40
,20161124,18300,18350,18945,18945,18790,18790,18850,440,500,32,603.31,46
,20161125,18790,18850,18560,18595,18435,18595,18520,-255,-330,18,333.44,50
,20161128,18595,18520,18880,19350,18420,19350,18880,830,360,8,151.05,50
,20161129,19350,18880,19560,19675,19225,19225,19520,345,640,20,390.44,52
,20161130,19225,19520,18600,18670,18480,18500,18540,-1020,-980,14,259.62,52
,20161201,18500,18540,18505,18665,18220,18550,18450,10,-90,12,221.44,52
,20161202,18550,18450,,,,18450,18450,0,0,0,0.00,52
,20161205,18450,18450,19045,19155,18890,18890,19010,440,560,8,152.11,54
,20161206,18890,19010,19200,19200,19005,19020,19075,10,65,6,114.45,56
,20161207,19020,19075,,,,19075,19075,0,0,0,0.00,56
,20161208,19075,19075,19545,19545,18915,18915,19235,-160,160,8,153.88,58
,20161209,18915,19235,19195,19195,19195,19195,19195,-40,-40,2,38.39,60
,20161212,19195,19195,19500,20080,19500,19950,19870,755,675,8,158.96,54
,20161213,19950,19870,19775,20215,19775,20215,19920,345,50,6,119.53,54
,20161214,20215,19920,20635,20635,20635,20635,20635,715,715,2,41.27,56
,20161215,20635,20635,,,,20635,20635,0,0,0,0.00,56
,20161216,20635,20635,20490,20490,20490,20490,20490,-145,-145,2,40.98,58
,20161219,20490,20490,20070,20070,20070,20070,20070,-420,-420,2,40.14,58
,20161220,20070,20070,19480,19480,19480,19480,19480,-590,-590,2,38.96,58
,20161221,19480,19480,19680,19680,19680,19680,19680,200,200,2,39.36,58
,20161222,19680,19680,19130,19130,19130,19130,19130,-550,-550,2,38.26,58
,20161223,19130,19130,,,,19130,19130,0,0,0,0.00,58
,20161226,19130,19130,17980,17980,17955,17955,17960,-1175,-1170,10,179.60,66
,20161227,17955,17960,17895,18130,17865,18130,17940,170,-20,12,215.32,62
,20161228,18130,17940,18415,18415,18410,18410,18410,470,470,4,73.65,60
,20161229,18410,18410,18215,18640,18215,18495,18470,85,60,8,147.78,60
,20161230,18495,18470,18220,18555,18220,18555,18385,85,-85,4,73.55,60
ru1709,20160920,13075,13075,13085,13420,13085,13400,13330,325,255,1608,"21,439.26",1004
,20160921,13400,13330,13460,13460,13300,13420,13385,90,55,2744,"36,735.56",2826
,20160922,13420,13385,13435,13940,13390,13750,13755,365,370,3694,"50,822.41",4954
,20160923,13750,13755,13820,13850,13630,13825,13735,70,-20,1588,"21,818.16",5552
,20160926,13825,13735,13825,13865,13610,13725,13685,-10,-50,3154,"43,172.17",7150
,20160927,13725,13685,13645,13695,13420,13600,13505,-85,-180,3468,"46,845.75",8040
,20160928,13600,13505,13580,13835,13480,13740,13725,235,220,3144,"43,157.05",8260
,20160929,13740,13725,13740,14085,13590,13625,13805,-100,80,3876,"53,522.05",9580
,20160930,13625,13805,13615,13655,13470,13585,13560,-220,-245,1142,"15,488.57",9620
,20161010,13585,13560,13810,14185,13750,14105,13995,545,435,2652,"37,124.95",10482
,20161011,14105,13995,14145,14535,14135,14535,14420,540,425,2410,"34,752.32",10868
,20161012,14535,14420,14490,14560,14335,14470,14440,50,20,1930,"27,871.43",11370
,20161013,14470,14440,14470,14540,14250,14330,14385,-110,-55,1520,"21,868.96",11402
,20161014,14330,14385,14330,14800,14260,14700,14640,315,255,3016,"44,166.98",12206
,20161017,14700,14640,14740,14820,14575,14695,14705,55,65,4128,"60,719.67",13582
,20161018,14695,14705,14700,14795,14530,14790,14645,85,-60,2390,"35,011.72",14140
,20161019,14790,14645,14750,14790,14105,14275,14485,-370,-160,4496,"65,138.96",14012
,20161020,14275,14485,14280,14390,14240,14300,14315,-185,-170,2954,"42,295.11",14454
,20161021,14300,14315,14295,14310,13995,14185,14120,-130,-195,3070,"43,350.68",15068
,20161024,14185,14120,14260,14530,14225,14450,14385,330,265,3148,"45,296.92",15746
,20161025,14450,14385,14450,14810,14445,14500,14650,115,265,4604,"67,458.85",16026
,20161026,14500,14650,14500,14650,14240,14625,14450,-25,-200,8454,"122,160.76",17542
,20161027,14625,14450,14610,14850,14440,14780,14670,330,220,10606,"155,642.60",18048
,20161028,14780,14670,14810,15105,14720,14880,14890,210,220,12958,"192,992.26",19924
,20161031,14880,14890,14880,15000,14700,14925,14875,35,-15,11266,"167,608.48",20424
,20161101,14925,14875,14925,15065,14750,14825,14910,-50,35,12906,"192,430.26",21328
,20161102,14825,14910,14765,14925,14500,14540,14710,-370,-200,12660,"186,282.75",23916
,20161103,14540,14710,14550,14625,14400,14600,14535,-110,-175,7258,"105,495.19",23538
,20161104,14600,14535,14600,14870,14400,14450,14650,-85,115,9130,"133,780.60",23726
,20161107,14450,14650,14505,15430,14465,15200,14945,550,295,13412,"200,453.84",24280
,20161108,15200,14945,15180,15840,15065,15840,15515,895,570,17028,"264,257.39",26050
,20161109,15840,15515,15765,16350,15765,15960,16015,445,500,18916,"303,018.77",27080
,20161110,15960,16015,16005,16740,15605,16645,16215,630,200,23754,"385,269.82",28828
,20161111,16645,16215,16800,17185,16335,17155,16780,940,565,21110,"354,275.08",29552
,20161114,17155,16780,17150,17695,15815,16080,16515,-700,-265,34816,"575,127.51",29448
,20161115,16080,16515,16310,16730,15955,16370,16335,-145,-180,23802,"388,832.83",29266
,20161116,16370,16335,16425,17315,16425,17315,16855,980,520,24396,"411,289.51",30048
,20161117,17315,16855,17315,17480,17060,17330,17270,475,415,17630,"304,546.82",30408
,20161118,17330,17270,17345,17345,16730,17020,16975,-250,-295,20426,"346,809.61",30800
,20161121,17020,16975,17025,17990,16880,17990,17520,1015,545,22256,"390,032.59",31782
,20161122,17990,17520,18090,18750,18090,18355,18400,835,880,25712,"473,159.21",32528
,20161123,18355,18400,18085,18555,17910,18345,18325,-55,-75,20772,"380,659.13",33668
,20161124,18345,18325,18325,19170,18260,18435,18810,110,485,53580,"1,008,104.07",41202
,20161125,18435,18810,18440,18870,18255,18720,18585,-90,-225,44852,"833,742.71",42102
,20161128,18720,18585,18645,19885,18505,19740,19065,1155,480,45956,"876,360.00",43938
,20161129,19740,19065,19685,19875,18930,19060,19510,-5,445,47998,"936,558.46",47842
,20161130,19060,19510,19060,19195,18140,18190,18540,-1320,-970,49974,"926,614.15",51622
,20161201,18190,18540,18435,18880,18210,18520,18555,-20,15,51262,"951,339.94",53794
,20161202,18520,18555,18750,18750,17820,18485,18265,-70,-290,49382,"901,980.79",53966
,20161205,18485,18265,18470,19150,18345,19020,18760,755,495,41612,"780,708.52",54114
,20161206,19020,18760,19100,19295,18865,18985,19090,225,330,30046,"573,630.73",54076
,20161207,18985,19090,18975,19415,18860,19415,19150,325,60,38922,"745,397.02",55976
,20161208,19415,19150,19425,19850,18885,19040,19325,-110,175,58508,"1,130,698.69",56706
,20161209,19040,19325,19075,19595,18585,19500,19070,175,-255,60816,"1,159,972.42",58820
,20161212,19500,19070,19740,20395,19380,19820,19960,750,890,70048,"1,398,301.23",59850
,20161213,19820,19960,19855,20550,19700,20535,20040,575,80,51972,"1,041,737.52",60944
,20161214,20535,20040,20950,20965,20250,20745,20585,705,545,63368,"1,304,537.98",60174
,20161215,20745,20585,20900,20935,20195,20485,20535,-100,-50,75882,"1,558,325.06",60168
,20161216,20485,20535,20340,20700,20075,20170,20440,-365,-95,49084,"1,003,401.05",62000
,20161219,20170,20440,20075,20380,19860,19905,20145,-535,-295,56118,"1,130,652.89",57306
,20161220,19905,20145,19765,19845,19120,19530,19505,-615,-640,67246,"1,311,796.24",57442
,20161221,19530,19505,19605,19830,19400,19765,19620,260,115,40598,"796,592.31",57442
,20161222,19765,19620,19705,19875,18900,18930,19485,-690,-135,59410,"1,157,699.85",59708
,20161223,18930,19485,18925,19220,18740,19070,19015,-415,-470,47806,"909,219.27",60010
,20161226,19070,19015,19095,19170,17680,17995,18310,-1020,-705,71470,"1,308,939.65",56154
,20161227,17995,18310,17995,18300,17530,18225,17910,-85,-400,60882,"1,090,688.56",54706
,20161228,18225,17910,18305,18700,18065,18100,18355,190,445,56536,"1,037,737.71",55098
,20161229,18100,18355,18185,18760,17910,18705,18375,350,20,51248,"941,712.81",54798
,20161230,18705,18375,18685,18810,18280,18705,18545,330,170,45442,"842,758.21",53468
ru1710,20161018,14705,14705,14640,14640,14620,14620,14630,-85,-75,4,58.52,2
,20161019,14620,14630,14210,14260,14210,14260,14235,-370,-395,4,56.94,4
,20161020,14260,14235,14400,14400,14300,14300,14365,65,130,6,86.19,8
,20161021,14300,14365,14150,14150,14105,14105,14125,-260,-240,4,56.51,12
,20161024,14105,14125,14415,14415,14415,14415,14415,290,290,2,28.83,12
,20161025,14415,14415,14850,14850,14695,14695,14770,280,355,4,59.09,12
,20161026,14695,14770,14675,14675,14410,14410,14540,-360,-230,4,58.17,12
,20161027,14410,14540,14655,14865,14585,14720,14705,180,165,8,117.65,12
,20161028,14720,14705,14865,14865,14865,14865,14865,160,160,2,29.73,14
,20161031,14865,14865,,,,14865,14865,0,0,0,0.00,14
,20161101,14865,14865,,,,14865,14865,0,0,0,0.00,14
,20161102,14865,14865,14735,14775,14650,14650,14725,-215,-140,8,117.81,14
,20161103,14650,14725,14490,14695,14465,14465,14580,-260,-145,22,320.78,22
,20161104,14465,14580,14765,14765,14765,14765,14765,185,185,2,29.53,20
,20161107,14765,14765,15015,15320,15015,15225,15185,460,420,6,91.12,18
,20161108,15225,15185,15620,16095,15620,16050,15980,865,795,12,191.78,26
,20161109,16050,15980,16135,16135,15895,16055,15975,75,-5,10,159.75,24
,20161110,16055,15975,16255,16255,16255,16255,16255,280,280,2,32.51,22
,20161111,16255,16255,16625,17175,16625,17175,16670,920,415,58,966.86,24
,20161114,17175,16670,17205,17670,16095,16565,16945,-105,275,28,474.50,22
,20161115,16565,16945,,,,16760,16760,-185,-185,0,0.00,22
,20161116,16760,16760,17210,17580,17210,17580,17420,820,660,6,104.52,22
,20161117,17580,17420,16680,17200,16680,17140,17005,-280,-415,6,102.04,22
,20161118,17140,17005,17255,17275,16850,16920,17130,-85,125,28,479.77,32
,20161121,16920,17130,17175,18135,16995,18135,17470,1005,340,20,349.41,40
,20161122,18135,17470,18275,18275,18260,18260,18265,790,795,4,73.07,38
,20161123,18260,18265,18400,18430,18400,18430,18415,165,150,4,73.66,38
,20161124,18430,18415,18710,19020,18500,18500,18880,85,465,26,490.92,50
,20161125,18500,18880,18635,18735,18425,18630,18585,-250,-295,20,371.76,46
,20161128,18630,18585,18695,19700,18695,19700,19100,1115,515,26,496.67,56
,20161129,19700,19100,,,,19100,19100,0,0,0,0.00,56
,20161130,19100,19100,18205,18205,17760,18110,18030,-990,-1070,18,324.60,48
,20161201,18110,18030,,,,18030,18030,0,0,0,0.00,48
,20161202,18030,18030,17985,17985,17985,17985,17985,-45,-45,2,35.97,46
,20161205,17985,17985,19010,19015,18970,18970,18995,985,1010,6,113.99,44
,20161206,18970,18995,,,,18995,18995,0,0,0,0.00,44
,20161207,18995,18995,,,,18995,18995,0,0,0,0.00,44
,20161208,18995,18995,19620,19620,19620,19620,19620,625,625,2,39.24,44
,20161209,19620,19620,19620,19620,18810,19100,19095,-520,-525,12,229.16,40
,20161212,19100,19095,19495,20215,19495,19915,19775,820,680,58,"1,146.99",74
,20161213,19915,19775,19930,20495,19930,20495,20265,720,490,12,243.19,74
,20161214,20495,20265,,,,20310,20310,45,45,0,0.00,74
,20161215,20310,20310,20295,20505,20295,20505,20345,195,35,14,284.88,68
,20161216,20505,20345,20495,20515,20410,20410,20485,65,140,12,245.83,74
,20161219,20410,20485,20250,20250,20060,20060,20170,-425,-315,6,121.02,72
,20161220,20060,20170,19365,19710,19245,19710,19390,-460,-780,50,969.52,72
,20161221,19710,19390,,,,19715,19715,325,325,0,0.00,72
,20161222,19715,19715,19815,19815,18915,18970,19165,-745,-550,8,153.34,72
,20161223,18970,19165,19130,19130,19065,19065,19110,-100,-55,8,152.91,66
,20161226,19065,19110,18780,18780,17770,18235,18245,-875,-865,24,437.99,62
,20161227,18235,18245,17900,17900,17900,17900,17900,-345,-345,2,35.80,62
,20161228,17900,17900,18575,18600,18310,18310,18530,410,630,10,185.32,58
,20161229,18310,18530,18020,18515,18020,18515,18320,-15,-210,16,293.12,60
,20161230,18515,18320,18680,18680,18595,18595,18635,275,315,4,74.55,56
ru1711,20161116,16760,16760,16785,17570,16585,17570,17050,810,290,98,"1,671.36",66
,20161117,17570,17050,17300,17420,17215,17215,17295,165,245,46,795.76,90
,20161118,17215,17295,17215,17300,16920,17115,17045,-180,-250,126,"2,147.91",74
,20161121,17115,17045,17130,18065,17130,18050,17785,1005,740,282,"5,015.96",262
,20161122,18050,17785,18095,18755,18095,18235,18440,450,655,328,"6,048.83",286
,20161123,18235,18440,18290,18490,17715,18400,18260,-40,-180,206,"3,762.23",376
,20161124,18400,18260,18400,19125,18400,18400,18765,140,505,238,"4,466.35",432
,20161125,18400,18765,18585,18795,18320,18650,18590,-115,-175,40,743.74,420
,20161128,18650,18590,18685,19890,18600,19810,19265,1220,675,36,693.69,426
,20161129,19810,19265,19695,19850,19000,19150,19530,-115,265,158,"3,086.24",456
,20161130,19150,19530,19130,19130,18160,18160,18365,-1370,-1165,22,404.09,454
,20161201,18160,18365,18615,18790,18330,18595,18645,230,280,18,335.64,458
,20161202,18595,18645,18800,18800,17935,18050,18220,-595,-425,54,984.07,424
,20161205,18050,18220,18800,19100,18775,19050,18895,830,675,98,"1,851.94",500
,20161206,19050,18895,19065,19150,18985,18985,19070,90,175,12,228.86,502
,20161207,18985,19070,18950,19250,18950,19250,19015,180,-55,34,646.55,526
,20161208,19250,19015,19700,19755,19000,19105,19185,90,170,26,498.92,526
,20161209,19105,19185,18730,19180,18665,19180,18920,-5,-265,20,378.43,524
,20161212,19180,18920,19585,20240,19585,19985,20145,1065,1225,52,"1,047.74",554
,20161213,19985,20145,19800,20345,19800,20345,20190,200,45,58,"1,171.10",596
,20161214,20345,20190,20695,20855,20400,20710,20640,520,450,48,990.87,592
,20161215,20710,20640,20415,20720,20360,20485,20470,-155,-170,36,736.99,594
,20161216,20485,20470,20410,20460,20350,20445,20435,-25,-35,22,449.58,596
,20161219,20445,20435,20030,20280,19965,19965,20105,-470,-330,20,402.11,594
,20161220,19965,20105,19815,19815,19275,19375,19525,-730,-580,34,663.89,598
,20161221,19375,19525,19700,19835,19645,19835,19770,310,245,14,276.78,592
,20161222,19835,19770,19855,19855,19685,19685,19770,-85,0,4,79.08,590
,20161223,19685,19770,18865,19185,18785,19150,18995,-620,-775,26,493.97,588
,20161226,19150,18995,18755,18755,17895,18300,18330,-695,-665,470,"8,615.48",490
,20161227,18300,18330,18150,18435,17850,18415,17935,85,-395,68,"1,219.87",496
,20161228,18415,17935,18460,18615,18285,18285,18460,350,525,30,553.88,500
,20161229,18285,18460,18115,18735,18115,18735,18570,275,110,16,297.14,496
,20161230,18735,18570,18835,18840,18750,18750,18800,180,230,18,338.45,500
sn1601,20160104,92810,93000,94850,94850,90560,93000,93080,0,80,52,484.06,928
,20160105,93000,93080,93490,94280,93490,94280,93750,1200,670,24,225.01,908
,20160106,94280,93750,93000,93710,93000,93710,93560,-40,-190,44,411.70,876
,20160107,93710,93560,96790,96970,92870,96000,95800,2440,2240,156,"1,494.49",836
,20160108,96000,95800,92620,96000,92610,92610,94930,-3190,-870,100,949.37,768
,20160111,92610,94930,95810,95820,95810,95820,95810,890,880,16,153.30,764
,20160112,95820,95810,95510,99530,92120,96500,95680,690,-130,40,382.72,732
,20160113,96500,95680,,,,95500,95500,-180,-180,0,0.00,732
,20160114,95500,95500,95000,95000,93500,93500,93760,-2000,-1740,24,225.04,708
,20160115,93500,93760,94400,94400,94400,94400,94400,640,640,20,188.80,688
sn1602,20160104,92840,92840,,,,92920,92920,80,80,0,0.00,0
,20160105,92920,92920,,,,93590,93590,670,670,0,0.00,0
,20160106,93590,93590,,,,93400,93400,-190,-190,0,0.00,0
,20160107,93400,93400,,,,95630,95630,2230,2230,0,0.00,0
,20160108,95630,95630,,,,94760,94760,-870,-870,0,0.00,0
,20160111,94760,94760,,,,95640,95640,880,880,0,0.00,0
,20160112,95640,95640,,,,95510,95510,-130,-130,0,0.00,0
,20160113,95510,95510,,,,95510,95510,0,0,0,0.00,0
,20160114,95510,95510,,,,93770,93770,-1740,-1740,0,0.00,0
,20160115,93770,93770,,,,94410,94410,640,640,0,0.00,0
,20160118,94410,94410,,,,94410,94410,0,0,0,0.00,0
,20160119,94410,94410,,,,94410,94410,0,0,0,0.00,0
,20160120,94410,94410,,,,94410,94410,0,0,0,0.00,0
,20160121,94410,94410,,,,94410,94410,0,0,0,0.00,0
,20160122,94410,94410,,,,94410,94410,0,0,0,0.00,0
,20160125,94410,94410,,,,94410,94410,0,0,0,0.00,0
,20160126,94410,94410,,,,94410,94410,0,0,0,0.00,0
,20160127,94410,94410,,,,94410,94410,0,0,0,0.00,0
,20160128,94410,94410,,,,94410,94410,0,0,0,0.00,0
,20160129,94410,94410,,,,94410,94410,0,0,0,0.00,0
,20160201,94410,94410,,,,94410,94410,0,0,0,0.00,0
,20160202,94410,94410,,,,94410,94410,0,0,0,0.00,0
,20160203,94410,94410,,,,94410,94410,0,0,0,0.00,0
,20160204,94410,94410,,,,94410,94410,0,0,0,0.00,0
,20160205,94410,94410,,,,94410,94410,0,0,0,0.00,0
,20160215,94410,94410,,,,94410,94410,0,0,0,0.00,0
sn1603,20160104,90470,90470,,,,90550,90550,80,80,0,0.00,2
,20160105,90550,90550,,,,91200,91200,650,650,0,0.00,2
,20160106,91200,91200,,,,91020,91020,-180,-180,0,0.00,2
,20160107,91020,91020,,,,93190,93190,2170,2170,0,0.00,2
,20160108,93190,93190,,,,92350,92350,-840,-840,0,0.00,2
,20160111,92350,92350,,,,93200,93200,850,850,0,0.00,2
,20160112,93200,93200,,,,93070,93070,-130,-130,0,0.00,2
,20160113,93070,93070,90680,94960,90680,91840,92300,-1230,-770,12,110.76,6
,20160114,91840,92300,,,,90620,90620,-1680,-1680,0,0.00,6
,20160115,90620,90620,94230,94230,94230,94230,94230,3610,3610,4,37.69,2
,20160118,94230,94230,,,,94230,94230,0,0,0,0.00,2
,20160119,94230,94230,,,,94230,94230,0,0,0,0.00,2
,20160120,94230,94230,,,,94230,94230,0,0,0,0.00,2
,20160121,94230,94230,,,,94230,94230,0,0,0,0.00,2
,20160122,94230,94230,,,,94230,94230,0,0,0,0.00,2
,20160125,94230,94230,,,,94230,94230,0,0,0,0.00,2
,20160126,94230,94230,,,,94230,94230,0,0,0,0.00,2
,20160127,94230,94230,,,,94230,94230,0,0,0,0.00,2
,20160128,94230,94230,,,,94230,94230,0,0,0,0.00,2
,20160129,94230,94230,,,,94230,94230,0,0,0,0.00,2
,20160201,94230,94230,,,,94230,94230,0,0,0,0.00,2
,20160202,94230,94230,,,,94230,94230,0,0,0,0.00,2
,20160203,94230,94230,,,,94230,94230,0,0,0,0.00,2
,20160204,94230,94230,,,,94230,94230,0,0,0,0.00,2
,20160205,94230,94230,,,,94230,94230,0,0,0,0.00,2
,20160215,94230,94230,,,,94230,94230,0,0,0,0.00,2
,20160216,94230,94230,,,,94230,94230,0,0,0,0.00,2
,20160217,94230,94230,,,,94230,94230,0,0,0,0.00,2
,20160218,94230,94230,,,,94230,94230,0,0,0,0.00,2
,20160219,94230,94230,,,,94230,94230,0,0,0,0.00,2
,20160222,94230,94230,,,,97990,97990,3760,3760,0,0.00,2
,20160223,97990,97990,,,,97990,97990,0,0,0,0.00,2
,20160224,97990,97990,,,,97990,97990,0,0,0,0.00,2
,20160225,97990,97990,,,,97990,97990,0,0,0,0.00,2
,20160226,97990,97990,,,,101900,101900,3910,3910,0,0.00,2
,20160229,101900,101900,101900,101900,101900,101900,101900,0,0,2,20.38,0
,20160301,101900,101900,,,,101900,101900,0,0,0,0.00,0
,20160302,101900,101900,,,,101900,101900,0,0,0,0.00,0
,20160303,101900,101900,,,,101900,101900,0,0,0,0.00,0
,20160304,101900,101900,,,,105970,105970,4070,4070,0,0.00,0
,20160307,105970,105970,,,,105970,105970,0,0,0,0.00,0
,20160308,105970,105970,105970,110200,105970,110200,108080,4230,2110,120,"1,297.02",0
,20160309,110200,108080,,,,108080,108080,0,0,0,0.00,0
,20160310,108080,108080,,,,108080,108080,0,0,0,0.00,0
,20160311,108080,108080,,,,108080,108080,0,0,0,0.00,0
,20160314,108080,108080,,,,108080,108080,0,0,0,0.00,0
,20160315,108080,108080,,,,108080,108080,0,0,0,0.00,0
sn1604,20160104,91230,91230,,,,91310,91310,80,80,0,0.00,12
,20160105,91310,91310,,,,91970,91970,660,660,0,0.00,12
,20160106,91970,91970,,,,91790,91790,-180,-180,0,0.00,12
,20160107,91790,91790,,,,93980,93980,2190,2190,0,0.00,12
,20160108,93980,93980,,,,93130,93130,-850,-850,0,0.00,12
,20160111,93130,93130,,,,93990,93990,860,860,0,0.00,12
,20160112,93990,93990,,,,93860,93860,-130,-130,0,0.00,12
,20160113,93860,93860,90790,90790,90360,90370,90530,-3490,-3330,10,90.54,12
,20160114,90370,90530,93280,93280,93280,93280,93280,2750,2750,2,18.66,10
,20160115,93280,93280,,,,96990,96990,3710,3710,0,0.00,10
,20160118,96990,96990,,,,96990,96990,0,0,0,0.00,10
,20160119,96990,96990,,,,96990,96990,0,0,0,0.00,10
,20160120,96990,96990,,,,96990,96990,0,0,0,0.00,10
,20160121,96990,96990,,,,96990,96990,0,0,0,0.00,10
,20160122,96990,96990,,,,96990,96990,0,0,0,0.00,10
,20160125,96990,96990,,,,96990,96990,0,0,0,0.00,10
,20160126,96990,96990,,,,96990,96990,0,0,0,0.00,10
,20160127,96990,96990,,,,96990,96990,0,0,0,0.00,10
,20160128,96990,96990,,,,96990,96990,0,0,0,0.00,10
,20160129,96990,96990,,,,96990,96990,0,0,0,0.00,10
,20160201,96990,96990,,,,96990,96990,0,0,0,0.00,10
,20160202,96990,96990,,,,96990,96990,0,0,0,0.00,10
,20160203,96990,96990,,,,96990,96990,0,0,0,0.00,10
,20160204,96990,96990,,,,96990,96990,0,0,0,0.00,10
,20160205,96990,96990,,,,96990,96990,0,0,0,0.00,10
,20160215,96990,96990,97270,101000,97270,101000,99130,4010,2140,4,39.65,10
,20160216,101000,99130,,,,99130,99130,0,0,0,0.00,10
,20160217,99130,99130,,,,99130,99130,0,0,0,0.00,10
,20160218,99130,99130,,,,99130,99130,0,0,0,0.00,10
,20160219,99130,99130,,,,99130,99130,0,0,0,0.00,10
,20160222,99130,99130,100540,100540,100540,100540,100540,1410,1410,2,20.11,12
,20160223,100540,100540,,,,100540,100540,0,0,0,0.00,12
,20160224,100540,100540,,,,104560,104560,4020,4020,0,0.00,12
,20160225,104560,104560,,,,104560,104560,0,0,0,0.00,12
,20160226,104560,104560,107560,107560,107560,107560,107560,3000,3000,4,43.02,12
,20160229,107560,107560,,,,107560,107560,0,0,0,0.00,12
,20160301,107560,107560,,,,107560,107560,0,0,0,0.00,12
,20160302,107560,107560,,,,107560,107560,0,0,0,0.00,12
,20160303,107560,107560,,,,107560,107560,0,0,0,0.00,12
,20160304,107560,107560,,,,107560,107560,0,0,0,0.00,12
,20160307,107560,107560,,,,111860,111860,4300,4300,0,0.00,12
,20160308,111860,111860,114050,116330,112500,112500,114390,640,2530,30,343.18,12
,20160309,112500,114390,,,,114390,114390,0,0,0,0.00,12
,20160310,114390,114390,,,,114390,114390,0,0,0,0.00,12
,20160311,114390,114390,,,,114390,114390,0,0,0,0.00,12
,20160314,114390,114390,112660,112660,109820,109820,111240,-4570,-3150,20,222.48,12
,20160315,109820,111240,,,,111240,111240,0,0,0,0.00,12
,20160316,111240,111240,,,,111240,111240,0,0,0,0.00,12
,20160317,111240,111240,,,,111240,111240,0,0,0,0.00,12
,20160318,111240,111240,,,,111240,111240,0,0,0,0.00,12
,20160321,111240,111240,110400,110400,110400,110400,110400,-840,-840,4,44.16,8
,20160322,110400,110400,,,,110400,110400,0,0,0,0.00,8
,20160323,110400,110400,,,,110400,110400,0,0,0,0.00,8
,20160324,110400,110400,,,,110400,110400,0,0,0,0.00,8
,20160325,110400,110400,,,,110400,110400,0,0,0,0.00,8
,20160328,110400,110400,,,,110400,110400,0,0,0,0.00,8
,20160329,110400,110400,,,,110400,110400,0,0,0,0.00,8
,20160330,110400,110400,,,,110400,110400,0,0,0,0.00,8
,20160331,110400,110400,,,,110400,110400,0,0,0,0.00,8
,20160401,110400,110400,,,,110400,110400,0,0,0,0.00,8
,20160405,110400,110400,,,,110400,110400,0,0,0,0.00,8
,20160406,110400,110400,,,,110400,110400,0,0,0,0.00,8
,20160407,110400,110400,,,,110400,110400,0,0,0,0.00,8
,20160408,110400,110400,,,,110400,110400,0,0,0,0.00,8
,20160411,110400,110400,,,,110400,110400,0,0,0,0.00,8
,20160412,110400,110400,,,,110400,110400,0,0,0,0.00,8
,20160413,110400,110400,,,,110400,110400,0,0,0,0.00,8
,20160414,110400,110400,,,,110400,110400,0,0,0,0.00,8
,20160415,110400,110400,,,,110400,110400,0,0,0,0.00,8
sn1605,20160104,93370,93280,92680,93790,91430,91710,92360,-1570,-920,7628,"70,456.55",5476
,20160105,91710,92360,91640,93250,91280,93000,92400,640,40,12748,"117,796.29",5546
,20160106,93000,92400,92430,93150,92100,92720,92630,320,230,10368,"96,046.63",5670
,20160107,92720,92630,91880,93130,91590,91700,92240,-930,-390,12942,"119,389.66",5600
,20160108,91700,92240,91500,92880,90110,92630,91630,390,-610,15172,"139,034.73",6036
,20160111,92630,91630,92400,93690,92400,93000,93240,1370,1610,14282,"133,172.40",6638
,20160112,93000,93240,93100,94100,92000,92450,93130,-790,-110,15264,"142,159.89",6624
,20160113,92450,93130,92510,92960,91510,92600,92240,-530,-890,17358,"160,121.40",7348
,20160114,92600,92240,92560,93630,91790,93190,92560,950,320,13682,"126,650.41",6442
,20160115,93190,92560,93110,94460,92710,93090,93590,530,1030,13236,"123,875.75",6694
,20160118,93090,93590,92880,95500,92300,95060,94270,1470,680,17032,"160,574.42",6892
,20160119,95060,94270,95180,95360,94400,94790,94930,520,660,12976,"123,187.13",6880
,20160120,94790,94930,94950,94950,93500,93940,94090,-990,-840,11544,"108,619.24",5902
,20160121,93940,94090,94110,95680,94110,95240,95040,1150,950,20734,"197,068.25",6410
,20160122,95240,95040,95410,96400,95220,96150,95870,1110,830,15416,"147,806.15",6638
,20160125,96150,95870,96300,99700,96300,97730,97400,1860,1530,20878,"203,353.14",7512
,20160126,97730,97400,97650,97970,96800,97700,97390,300,-10,16062,"156,430.89",7890
,20160127,97700,97390,98050,100470,98050,100380,99650,2990,2260,33510,"333,936.33",9646
,20160128,100380,99650,100720,100990,100040,100260,100520,610,870,29174,"293,280.02",10584
,20160129,100260,100520,99600,99890,97690,98280,98790,-2240,-1730,39550,"390,740.90",8838
,20160201,98280,98790,100000,100280,97850,98440,99410,-350,620,39834,"396,000.95",8524
,20160202,98440,99410,98740,99190,98410,98970,98790,-440,-620,21844,"215,815.93",8142
,20160203,98970,98790,99220,99440,97940,98700,98610,-90,-180,19434,"191,641.63",7628
,20160204,98700,98610,98610,99990,98370,99790,99230,1180,620,16544,"164,182.45",7162
,20160205,99790,99230,100000,100450,98600,99430,99560,200,330,11934,"118,817.24",6146
,20160215,99430,99560,98000,100300,97030,99930,99650,370,90,6436,"64,135.89",6948
,20160216,99930,99650,99410,100180,99000,99190,99600,-460,-50,12660,"126,095.77",7630
,20160217,99190,99600,99250,99540,98190,98750,99140,-850,-460,10220,"101,328.91",7912
,20160218,98750,99140,99990,99990,98580,99340,99420,200,280,11414,"113,480.57",8182
,20160219,99340,99420,99430,100290,98910,100250,99580,830,160,13440,"133,842.01",9324
,20160222,100250,99580,100260,103500,99800,103290,101720,3710,2140,24958,"253,885.52",11912
,20160223,103290,101720,103700,105680,103410,105540,104840,3820,3120,51802,"543,130.41",17678
,20160224,105540,104840,105980,106300,104800,105160,105560,320,720,54618,"576,596.33",17834
,20160225,105160,105560,105540,106270,104860,105180,105600,-380,40,44526,"470,198.76",17282
,20160226,105180,105600,105490,105500,102260,103950,104260,-1650,-1340,48600,"506,714.16",14698
,20160229,103950,104260,104200,105380,102910,103640,104150,-620,-110,51306,"534,377.79",14542
,20160301,103640,104150,104010,104680,103190,104100,103860,-50,-290,31750,"329,771.72",14358
,20160302,104100,103860,104630,105020,103870,104710,104370,850,510,32300,"337,128.16",14214
,20160303,104710,104370,104800,108540,104700,108540,107190,4170,2820,74098,"794,266.74",20080
,20160304,108540,107190,109560,113940,108660,111600,110820,4410,3630,79394,"879,907.11",16778
,20160307,111600,110820,112800,114690,111810,112890,113330,2070,2510,82964,"940,259.39",16924
,20160308,112890,113330,113830,117600,111120,114540,114630,1210,1300,117778,"1,350,127.77",17350
,20160309,114540,114630,114000,114200,110040,110110,111250,-4520,-3380,76510,"851,202.06",16070
,20160310,110110,111250,110330,112650,108060,109000,109850,-2250,-1400,96310,"1,058,058.85",15506
,20160311,109000,109850,109300,111020,107610,109950,109390,100,-460,70792,"774,422.45",15700
,20160314,109950,109390,111000,111000,109250,109880,110300,490,910,52784,"582,254.99",15370
,20160315,109880,110300,109800,110560,108280,108720,109050,-1580,-1250,50468,"550,360.07",15650
,20160316,108720,109050,108050,109660,108000,109500,109050,450,0,41980,"457,807.99",15874
,20160317,109500,109050,109350,110470,109200,110000,109860,950,810,34100,"374,634.00",15436
,20160318,110000,109860,110300,113780,109800,112860,112060,3000,2200,61924,"693,967.85",16072
,20160321,112860,112060,112510,112980,108000,109400,110380,-2660,-1680,55704,"614,861.85",14648
,20160322,109400,110380,109860,110480,108900,108990,109710,-1390,-670,41924,"459,976.16",14984
,20160323,108990,109710,109200,110500,108300,109040,109440,-670,-270,45664,"499,783.91",14570
,20160324,109040,109440,109530,110690,109030,110270,110080,830,640,71278,"784,675.45",16238
,20160325,110270,110080,110680,112090,110390,112020,111370,1940,1290,57208,"637,150.49",17928
,20160328,112020,111370,111990,112880,108210,108600,111460,-2770,90,40490,"451,340.89",16618
,20160329,108600,111460,108600,109780,108000,108470,108930,-2990,-2530,41094,"447,656.37",16804
,20160330,108470,108930,108770,109280,105060,105090,106630,-3840,-2300,67674,"721,647.24",18888
,20160331,105090,106630,105210,105870,103010,103490,104530,-3140,-2100,69430,"725,820.41",19814
,20160401,103490,104530,102810,105620,102700,104830,104550,300,20,50800,"531,156.93",16994
,20160405,104830,104550,103320,105670,103300,105360,104790,810,240,18524,"194,114.40",16490
,20160406,105360,104790,104710,106150,104710,106040,105530,1250,740,27906,"294,501.60",15694
,20160407,106040,105530,106130,107400,105990,107080,106660,1550,1130,24902,"265,620.95",15938
,20160408,107080,106660,107110,107200,105170,106530,106120,-130,-540,30624,"324,997.49",15532
,20160411,106530,106120,106520,110480,106510,109060,108640,2940,2520,31106,"337,940.78",14150
,20160412,109060,108640,108960,109770,107230,108440,108510,-200,-130,22846,"247,918.48",14058
,20160413,108440,108510,108730,112560,108730,110660,110250,2150,1740,30058,"331,401.32",13528
,20160414,110660,110250,110810,113550,110100,112120,112400,1870,2150,35104,"394,601.35",13302
,20160415,112120,112400,113960,113960,110540,111570,111890,-830,-510,19584,"219,135.69",13428
,20160418,111570,111890,111580,111890,109660,110180,110670,-1710,-1220,20774,"229,919.39",13586
,20160419,110180,110670,110230,112000,110010,111470,111180,800,510,19212,"213,603.04",12880
,20160420,111470,111180,111610,112950,110490,111440,111700,260,520,19258,"215,125.57",12716
,20160421,111440,111700,112370,114600,110790,114400,112200,2700,500,20964,"235,221.94",12988
,20160422,114400,112200,115480,115960,110000,111460,112230,-740,30,19430,"218,080.79",12180
,20160425,111460,112230,111820,113410,108560,109520,111150,-2710,-1080,16102,"178,983.19",11708
,20160426,109520,111150,109170,110530,107560,108100,109140,-3050,-2010,9102,"99,341.94",11650
,20160427,108100,109140,108780,109430,107800,108300,108660,-840,-480,5110,"55,526.51",11132
,20160428,108300,108660,108690,108690,106600,106780,107510,-1880,-1150,4248,"45,671.85",10230
,20160429,106780,107510,107020,109340,106870,108120,108370,610,860,3898,"42,244.87",9670
,20160503,108120,108370,111220,111240,107480,110860,109300,2490,930,730,"7,979.02",9408
,20160504,110860,109300,110890,112200,108700,110240,110400,940,1100,856,"9,450.88",9044
,20160505,110240,110400,110070,112300,110070,111680,111010,1280,610,1000,"11,101.42",8724
,20160506,111680,111010,111920,112210,108420,109010,110330,-2000,-680,504,"5,561.13",8540
,20160509,109010,110330,109800,111440,108560,108800,109710,-1530,-620,360,"3,949.59",8448
,20160510,108800,109710,109340,109340,105280,107900,106710,-1810,-3000,620,"6,616.12",8260
,20160511,107900,106710,107910,109640,106600,108440,107480,1730,770,564,"6,062.04",7984
,20160512,108440,107480,112850,112850,102550,109100,108400,1620,920,204,"2,211.51",7988
,20160513,109100,108400,107000,108490,103000,107300,106550,-1100,-1850,360,"3,835.81",7984
,20160516,107300,106550,106000,107900,103080,107890,107300,1340,750,256,"2,747.08",7980
sn1606,20160104,93380,93380,,,,92460,92460,-920,-920,0,0.00,6
,20160105,92460,92460,91190,93840,91190,93840,92510,1380,50,12,111.01,6
,20160106,93840,92510,,,,92740,92740,230,230,0,0.00,6
,20160107,92740,92740,,,,92350,92350,-390,-390,0,0.00,6
,20160108,92350,92350,94440,94440,91280,92940,92860,590,510,44,408.62,6
,20160111,92940,92860,,,,94490,94490,1630,1630,0,0.00,6
,20160112,94490,94490,,,,94380,94380,-110,-110,0,0.00,6
,20160113,94380,94380,,,,93480,93480,-900,-900,0,0.00,6
,20160114,93480,93480,,,,93810,93810,330,330,0,0.00,6
,20160115,93810,93810,,,,94850,94850,1040,1040,0,0.00,6
,20160118,94850,94850,,,,95540,95540,690,690,0,0.00,6
,20160119,95540,95540,,,,96210,96210,670,670,0,0.00,6
,20160120,96210,96210,,,,95360,95360,-850,-850,0,0.00,6
,20160121,95360,95360,,,,96320,96320,960,960,0,0.00,6
,20160122,96320,96320,94370,98260,94370,98260,96310,1940,-10,4,38.53,6
,20160125,98260,96310,,,,97840,97840,1530,1530,0,0.00,6
,20160126,97840,97840,,,,97830,97830,-10,-10,0,0.00,6
,20160127,97830,97830,,,,100100,100100,2270,2270,0,0.00,6
,20160128,100100,100100,,,,100980,100980,880,880,0,0.00,6
,20160129,100980,100980,,,,99240,99240,-1740,-1740,0,0.00,6
,20160201,99240,99240,,,,99860,99860,620,620,0,0.00,6
,20160202,99860,99860,,,,99240,99240,-620,-620,0,0.00,6
,20160203,99240,99240,,,,99060,99060,-180,-180,0,0.00,6
,20160204,99060,99060,,,,99690,99690,630,630,0,0.00,6
,20160205,99690,99690,,,,100020,100020,330,330,0,0.00,6
,20160215,100020,100020,,,,100110,100110,90,90,0,0.00,6
,20160216,100110,100110,,,,100060,100060,-50,-50,0,0.00,6
,20160217,100060,100060,,,,99600,99600,-460,-460,0,0.00,6
,20160218,99600,99600,,,,99880,99880,280,280,0,0.00,6
,20160219,99880,99880,,,,100040,100040,160,160,0,0.00,6
,20160222,100040,100040,,,,102190,102190,2150,2150,0,0.00,6
,20160223,102190,102190,,,,105330,105330,3140,3140,0,0.00,6
,20160224,105330,105330,105740,107980,105740,107980,106500,2650,1170,6,63.90,4
,20160225,107980,106500,,,,106540,106540,40,40,0,0.00,4
,20160226,106540,106540,105320,105320,105320,105320,105320,-1220,-1220,2,21.06,4
,20160229,105320,105320,,,,105210,105210,-110,-110,0,0.00,4
,20160301,105210,105210,,,,104920,104920,-290,-290,0,0.00,4
,20160302,104920,104920,,,,105430,105430,510,510,0,0.00,4
,20160303,105430,105430,,,,108280,108280,2850,2850,0,0.00,4
,20160304,108280,108280,,,,111950,111950,3670,3670,0,0.00,4
,20160307,111950,111950,114700,115110,111610,113000,113600,1050,1650,8,90.88,4
,20160308,113000,113600,113800,113800,113800,113800,113800,200,200,2,22.76,4
,20160309,113800,113800,112420,112660,109320,112660,111070,-1140,-2730,8,88.86,4
,20160310,112660,111070,,,,109680,109680,-1390,-1390,0,0.00,4
,20160311,109680,109680,108600,110280,108600,109900,109760,220,80,8,87.81,8
,20160314,109900,109760,,,,109760,109760,0,0,0,0.00,8
,20160315,109760,109760,108640,110540,108640,110540,109330,780,-430,18,196.80,8
,20160316,110540,109330,106870,111080,106870,109050,108990,-280,-340,10,108.99,8
,20160317,109050,108990,,,,108990,108990,0,0,0,0.00,8
,20160318,108990,108990,,,,111180,111180,2190,2190,0,0.00,8
,20160321,111180,111180,110020,111190,110020,111190,110500,10,-680,8,88.41,8
,20160322,111190,110500,108500,111150,108500,111150,110250,650,-250,6,66.15,8
,20160323,111150,110250,110500,110500,110500,110500,110500,250,250,4,44.20,6
,20160324,110500,110500,,,,110500,110500,0,0,0,0.00,6
,20160325,110500,110500,112800,113560,109120,110110,111100,-390,600,28,311.09,8
,20160328,110110,111100,111100,111210,109800,109800,110700,-1300,-400,6,66.42,8
,20160329,109800,110700,,,,108190,108190,-2510,-2510,0,0.00,8
,20160330,108190,108190,106690,107000,104500,107000,106220,-1190,-1970,8,84.98,4
,20160331,107000,106220,,,,105200,105200,-1020,-1020,0,0.00,4
,20160401,105200,105200,,,,105200,105200,0,0,0,0.00,4
,20160405,105200,105200,106550,106550,102400,102400,104470,-2800,-730,4,41.79,4
,20160406,102400,104470,,,,104470,104470,0,0,0,0.00,4
,20160407,104470,104470,,,,104800,104800,330,330,0,0.00,4
,20160408,104800,104800,108490,108490,104310,108370,106030,3570,1230,10,106.03,10
,20160411,108370,106030,106800,110770,106800,110770,108850,4740,2820,6,65.31,6
,20160412,110770,108850,,,,108850,108850,0,0,0,0.00,6
,20160413,108850,108850,,,,110590,110590,1740,1740,0,0.00,6
,20160414,110590,110590,113750,114000,110810,113000,112810,2410,2220,34,383.57,4
,20160415,113000,112810,,,,112810,112810,0,0,0,0.00,4
,20160418,112810,112810,,,,111580,111580,-1230,-1230,0,0.00,4
,20160419,111580,111580,,,,111580,111580,0,0,0,0.00,4
,20160420,111580,111580,,,,112100,112100,520,520,0,0.00,4
,20160421,112100,112100,114000,116560,112510,112780,114460,680,2360,10,114.47,6
,20160422,112780,114460,,,,114500,114500,40,40,0,0.00,6
,20160425,114500,114500,,,,113400,113400,-1100,-1100,0,0.00,6
,20160426,113400,113400,111800,111800,111800,111800,111800,-1600,-1600,2,22.36,8
,20160427,111800,111800,111230,111600,109000,109000,110420,-2800,-1380,64,706.72,14
,20160428,109000,110420,105920,109990,105920,108010,108380,-2410,-2040,10,108.38,12
,20160429,108010,108380,106720,107230,106720,107230,106890,-1150,-1490,6,64.13,10
,20160503,107230,106890,,,,107800,107800,910,910,0,0.00,10
,20160504,107800,107800,,,,108800,108800,1000,1000,0,0.00,10
,20160505,108800,108800,,,,109400,109400,600,600,0,0.00,10
,20160506,109400,109400,,,,108730,108730,-670,-670,0,0.00,10
,20160509,108730,108730,,,,108110,108110,-620,-620,0,0.00,10
,20160510,108110,108110,108000,108000,108000,108000,108000,-110,-110,2,21.60,8
,20160511,108000,108000,,,,108780,108780,780,780,0,0.00,8
,20160512,108780,108780,107420,111740,107420,109980,109710,1200,930,6,65.83,8
,20160513,109980,109710,,,,107830,107830,-1880,-1880,0,0.00,8
,20160516,107830,107830,,,,108590,108590,760,760,0,0.00,8
,20160517,108590,108590,,,,108590,108590,0,0,0,0.00,8
,20160518,108590,108590,104390,108380,103700,106060,105650,-2530,-2940,16,169.04,8
,20160519,106060,105650,,,,105650,105650,0,0,0,0.00,8
,20160520,105650,105650,,,,105650,105650,0,0,0,0.00,8
,20160523,105650,105650,,,,105650,105650,0,0,0,0.00,8
,20160524,105650,105650,105950,105950,105950,105950,105950,300,300,2,21.19,6
,20160525,105950,105950,,,,105950,105950,0,0,0,0.00,6
,20160526,105950,105950,,,,105950,105950,0,0,0,0.00,6
,20160527,105950,105950,109100,109100,106010,106500,107700,550,1750,20,215.40,6
,20160530,106500,107700,104710,107000,104710,107000,105880,-700,-1820,10,105.88,6
,20160531,107000,105880,107500,107500,105590,105590,106540,-290,660,4,42.62,8
,20160601,105590,106540,,,,106540,106540,0,0,0,0.00,8
,20160602,106540,106540,,,,106540,106540,0,0,0,0.00,8
,20160603,106540,106540,107700,107700,107700,107700,107700,1160,1160,4,43.08,4
,20160606,107700,107700,,,,107700,107700,0,0,0,0.00,4
,20160607,107700,107700,,,,107700,107700,0,0,0,0.00,4
,20160608,107700,107700,,,,107700,107700,0,0,0,0.00,4
,20160613,107700,107700,,,,107700,107700,0,0,0,0.00,4
,20160614,107700,107700,,,,107700,107700,0,0,0,0.00,4
,20160615,107700,107700,,,,107700,107700,0,0,0,0.00,4
sn1607,20160104,94690,94690,,,,93760,93760,-930,-930,0,0.00,4
,20160105,93760,93760,,,,93810,93810,50,50,0,0.00,4
,20160106,93810,93810,,,,94050,94050,240,240,0,0.00,4
,20160107,94050,94050,,,,93660,93660,-390,-390,0,0.00,4
,20160108,93660,93660,,,,94180,94180,520,520,0,0.00,4
,20160111,94180,94180,,,,95830,95830,1650,1650,0,0.00,4
,20160112,95830,95830,,,,95720,95720,-110,-110,0,0.00,4
,20160113,95720,95720,,,,94810,94810,-910,-910,0,0.00,4
,20160114,94810,94810,,,,95140,95140,330,330,0,0.00,4
,20160115,95140,95140,,,,96190,96190,1050,1050,0,0.00,4
,20160118,96190,96190,,,,96890,96890,700,700,0,0.00,4
,20160119,96890,96890,,,,97570,97570,680,680,0,0.00,4
,20160120,97570,97570,,,,96700,96700,-870,-870,0,0.00,4
,20160121,96700,96700,,,,97680,97680,980,980,0,0.00,4
,20160122,97680,97680,,,,97670,97670,-10,-10,0,0.00,4
,20160125,97670,97670,,,,99220,99220,1550,1550,0,0.00,4
,20160126,99220,99220,,,,99210,99210,-10,-10,0,0.00,4
,20160127,99210,99210,,,,101510,101510,2300,2300,0,0.00,4
,20160128,101510,101510,,,,102400,102400,890,890,0,0.00,4
,20160129,102400,102400,,,,100640,100640,-1760,-1760,0,0.00,4
,20160201,100640,100640,,,,101270,101270,630,630,0,0.00,4
,20160202,101270,101270,,,,100640,100640,-630,-630,0,0.00,4
,20160203,100640,100640,,,,100450,100450,-190,-190,0,0.00,4
,20160204,100450,100450,,,,101090,101090,640,640,0,0.00,4
,20160205,101090,101090,,,,101420,101420,330,330,0,0.00,4
,20160215,101420,101420,,,,101510,101510,90,90,0,0.00,4
,20160216,101510,101510,,,,101460,101460,-50,-50,0,0.00,4
,20160217,101460,101460,,,,100990,100990,-470,-470,0,0.00,4
,20160218,100990,100990,,,,101270,101270,280,280,0,0.00,4
,20160219,101270,101270,,,,101430,101430,160,160,0,0.00,4
,20160222,101430,101430,,,,103610,103610,2180,2180,0,0.00,4
,20160223,103610,103610,,,,106790,106790,3180,3180,0,0.00,4
,20160224,106790,106790,,,,107970,107970,1180,1180,0,0.00,4
,20160225,107970,107970,,,,108010,108010,40,40,0,0.00,4
,20160226,108010,108010,105320,105320,103680,103680,104770,-4330,-3240,6,62.86,2
,20160229,103680,104770,,,,104660,104660,-110,-110,0,0.00,2
,20160301,104660,104660,106320,106320,104550,104550,105430,-110,770,4,42.17,2
,20160302,104550,105430,,,,105950,105950,520,520,0,0.00,2
,20160303,105950,105950,,,,108810,108810,2860,2860,0,0.00,2
,20160304,108810,108810,109140,113000,107150,112450,110590,3640,1780,18,199.07,4
,20160307,112450,110590,,,,112220,112220,1630,1630,0,0.00,4
,20160308,112220,112220,114210,114480,113000,114480,113890,2260,1670,6,68.34,0
,20160309,114480,113890,,,,111160,111160,-2730,-2730,0,0.00,0
,20160310,111160,111160,,,,111160,111160,0,0,0,0.00,0
,20160311,111160,111160,,,,111240,111240,80,80,0,0.00,0
,20160314,111240,111240,,,,112170,112170,930,930,0,0.00,0
,20160315,112170,112170,,,,111730,111730,-440,-440,0,0.00,0
,20160316,111730,111730,,,,111380,111380,-350,-350,0,0.00,0
,20160317,111380,111380,,,,112210,112210,830,830,0,0.00,0
,20160318,112210,112210,,,,114460,114460,2250,2250,0,0.00,0
,20160321,114460,114460,,,,113760,113760,-700,-700,0,0.00,0
,20160322,113760,113760,,,,113500,113500,-260,-260,0,0.00,0
,20160323,113500,113500,,,,113750,113750,250,250,0,0.00,0
,20160324,113750,113750,,,,114420,114420,670,670,0,0.00,0
,20160325,114420,114420,,,,112990,112990,-1430,-1430,0,0.00,0
,20160328,112990,112990,,,,112580,112580,-410,-410,0,0.00,0
,20160329,112580,112580,,,,110020,110020,-2560,-2560,0,0.00,0
,20160330,110020,110020,,,,108010,108010,-2010,-2010,0,0.00,0
,20160331,108010,108010,,,,105890,105890,-2120,-2120,0,0.00,0
,20160401,105890,105890,,,,105910,105910,20,20,0,0.00,0
,20160405,105910,105910,,,,105180,105180,-730,-730,0,0.00,0
,20160406,105180,105180,,,,105920,105920,740,740,0,0.00,0
,20160407,105920,105920,,,,107060,107060,1140,1140,0,0.00,0
,20160408,107060,107060,,,,108310,108310,1250,1250,0,0.00,0
,20160411,108310,108310,,,,111190,111190,2880,2880,0,0.00,0
,20160412,111190,111190,,,,111060,111060,-130,-130,0,0.00,0
,20160413,111060,111060,,,,112840,112840,1780,1780,0,0.00,0
,20160414,112840,112840,,,,115100,115100,2260,2260,0,0.00,0
,20160415,115100,115100,,,,114580,114580,-520,-520,0,0.00,0
,20160418,114580,114580,,,,113330,113330,-1250,-1250,0,0.00,0
,20160419,113330,113330,,,,113850,113850,520,520,0,0.00,0
,20160420,113850,113850,,,,114380,114380,530,530,0,0.00,0
,20160421,114380,114380,,,,116790,116790,2410,2410,0,0.00,0
,20160422,116790,116790,,,,116830,116830,40,40,0,0.00,0
,20160425,116830,116830,,,,115710,115710,-1120,-1120,0,0.00,0
,20160426,115710,115710,,,,114070,114070,-1640,-1640,0,0.00,0
,20160427,114070,114070,,,,112660,112660,-1410,-1410,0,0.00,0
,20160428,112660,112660,,,,110580,110580,-2080,-2080,0,0.00,0
,20160429,110580,110580,,,,110580,110580,0,0,0,0.00,0
,20160503,110580,110580,,,,111530,111530,950,950,0,0.00,0
,20160504,111530,111530,,,,112660,112660,1130,1130,0,0.00,0
,20160505,112660,112660,,,,113280,113280,620,620,0,0.00,0
,20160506,113280,113280,,,,112590,112590,-690,-690,0,0.00,0
,20160509,112590,112590,,,,111950,111950,-640,-640,0,0.00,0
,20160510,111950,111950,,,,111830,111830,-120,-120,0,0.00,0
,20160511,111830,111830,,,,112640,112640,810,810,0,0.00,0
,20160512,112640,112640,107880,111490,107880,110730,109730,-1910,-2910,90,987.60,0
,20160513,110730,109730,,,,107850,107850,-1880,-1880,0,0.00,0
,20160516,107850,107850,,,,108610,108610,760,760,0,0.00,0
,20160517,108610,108610,,,,108610,108610,0,0,0,0.00,0
,20160518,108610,108610,,,,105670,105670,-2940,-2940,0,0.00,0
,20160519,105670,105670,,,,105670,105670,0,0,0,0.00,0
,20160520,105670,105670,,,,105670,105670,0,0,0,0.00,0
,20160523,105670,105670,103860,107020,103860,107020,105440,1350,-230,4,42.18,2
,20160524,107020,105440,,,,105440,105440,0,0,0,0.00,2
,20160525,105440,105440,106460,106460,102950,102950,105990,-2490,550,22,233.19,20
,20160526,102950,105990,102110,106180,102110,104880,102750,-1110,-3240,22,226.06,20
,20160527,104880,102750,,,,104440,104440,1690,1690,0,0.00,20
,20160530,104440,104440,107000,107000,105120,105120,106060,680,1620,4,42.42,18
,20160531,105120,106060,105290,108500,105290,107500,107190,1440,1130,8,85.76,14
,20160601,107500,107190,105500,107980,105500,107980,107620,790,430,14,150.68,2
,20160602,107980,107620,103490,103490,103490,103490,103490,-4130,-4130,2,20.70,2
,20160603,103490,103490,,,,105030,105030,1540,1540,0,0.00,2
,20160606,105030,105030,108200,108200,108200,108200,108200,3170,3170,2,21.64,0
,20160607,108200,108200,,,,108200,108200,0,0,0,0.00,0
,20160608,108200,108200,,,,108200,108200,0,0,0,0.00,0
,20160613,108200,108200,,,,108200,108200,0,0,0,0.00,0
,20160614,108200,108200,,,,108200,108200,0,0,0,0.00,0
,20160615,108200,108200,,,,108200,108200,0,0,0,0.00,0
,20160616,108200,108200,,,,108200,108200,0,0,0,0.00,0
,20160617,108200,108200,,,,108200,108200,0,0,0,0.00,0
,20160620,108200,108200,,,,108200,108200,0,0,0,0.00,0
,20160621,108200,108200,,,,108200,108200,0,0,0,0.00,0
,20160622,108200,108200,,,,108510,108510,310,310,0,0.00,0
,20160623,108510,108510,,,,108510,108510,0,0,0,0.00,0
,20160624,108510,108510,,,,108510,108510,0,0,0,0.00,0
,20160627,108510,108510,,,,108510,108510,0,0,0,0.00,0
,20160628,108510,108510,,,,108510,108510,0,0,0,0.00,0
,20160629,108510,108510,,,,108510,108510,0,0,0,0.00,0
,20160630,108510,108510,,,,108510,108510,0,0,0,0.00,0
,20160701,108510,108510,,,,108510,108510,0,0,0,0.00,0
,20160704,108510,108510,,,,108510,108510,0,0,0,0.00,0
,20160705,108510,108510,,,,108510,108510,0,0,0,0.00,0
,20160706,108510,108510,,,,108510,108510,0,0,0,0.00,0
,20160707,108510,108510,,,,108510,108510,0,0,0,0.00,0
,20160708,108510,108510,,,,108510,108510,0,0,0,0.00,0
,20160711,108510,108510,,,,108510,108510,0,0,0,0.00,0
,20160712,108510,108510,,,,108510,108510,0,0,0,0.00,0
,20160713,108510,108510,,,,108510,108510,0,0,0,0.00,0
,20160714,108510,108510,,,,108510,108510,0,0,0,0.00,0
,20160715,108510,108510,,,,108510,108510,0,0,0,0.00,0
sn1608,20160104,93050,93050,,,,92130,92130,-920,-920,0,0.00,0
,20160105,92130,92130,,,,92180,92180,50,50,0,0.00,0
,20160106,92180,92180,,,,92410,92410,230,230,0,0.00,0
,20160107,92410,92410,,,,92030,92030,-380,-380,0,0.00,0
,20160108,92030,92030,,,,92540,92540,510,510,0,0.00,0
,20160111,92540,92540,,,,94170,94170,1630,1630,0,0.00,0
,20160112,94170,94170,,,,94060,94060,-110,-110,0,0.00,0
,20160113,94060,94060,,,,93160,93160,-900,-900,0,0.00,0
,20160114,93160,93160,,,,93490,93490,330,330,0,0.00,0
,20160115,93490,93490,,,,94530,94530,1040,1040,0,0.00,0
,20160118,94530,94530,,,,95220,95220,690,690,0,0.00,0
,20160119,95220,95220,,,,95890,95890,670,670,0,0.00,0
,20160120,95890,95890,,,,95040,95040,-850,-850,0,0.00,0
,20160121,95040,95040,,,,96000,96000,960,960,0,0.00,0
,20160122,96000,96000,,,,95990,95990,-10,-10,0,0.00,0
,20160125,95990,95990,,,,97520,97520,1530,1530,0,0.00,0
,20160126,97520,97520,,,,97510,97510,-10,-10,0,0.00,0
,20160127,97510,97510,,,,99770,99770,2260,2260,0,0.00,0
,20160128,99770,99770,,,,100640,100640,870,870,0,0.00,0
,20160129,100640,100640,,,,98910,98910,-1730,-1730,0,0.00,0
,20160201,98910,98910,,,,99530,99530,620,620,0,0.00,0
,20160202,99530,99530,,,,98910,98910,-620,-620,0,0.00,0
,20160203,98910,98910,,,,98730,98730,-180,-180,0,0.00,0
,20160204,98730,98730,,,,99360,99360,630,630,0,0.00,0
,20160205,99360,99360,,,,99690,99690,330,330,0,0.00,0
,20160215,99690,99690,,,,99780,99780,90,90,0,0.00,0
,20160216,99780,99780,,,,99730,99730,-50,-50,0,0.00,0
,20160217,99730,99730,,,,99270,99270,-460,-460,0,0.00,0
,20160218,99270,99270,,,,99550,99550,280,280,0,0.00,0
,20160219,99550,99550,,,,99710,99710,160,160,0,0.00,0
,20160222,99710,99710,,,,101850,101850,2140,2140,0,0.00,0
,20160223,101850,101850,,,,104980,104980,3130,3130,0,0.00,0
,20160224,104980,104980,,,,106140,106140,1160,1160,0,0.00,0
,20160225,106140,106140,,,,106180,106180,40,40,0,0.00,0
,20160226,106180,106180,,,,102990,102990,-3190,-3190,0,0.00,0
,20160229,102990,102990,,,,102880,102880,-110,-110,0,0.00,0
,20160301,102880,102880,,,,103640,103640,760,760,0,0.00,0
,20160302,103640,103640,,,,104150,104150,510,510,0,0.00,0
,20160303,104150,104150,,,,106960,106960,2810,2810,0,0.00,0
,20160304,106960,106960,,,,108710,108710,1750,1750,0,0.00,0
,20160307,108710,108710,,,,110310,110310,1600,1600,0,0.00,0
,20160308,110310,110310,,,,111950,111950,1640,1640,0,0.00,0
,20160309,111950,111950,,,,109270,109270,-2680,-2680,0,0.00,0
,20160310,109270,109270,,,,107900,107900,-1370,-1370,0,0.00,0
,20160311,107900,107900,,,,107980,107980,80,80,0,0.00,0
,20160314,107980,107980,,,,108880,108880,900,900,0,0.00,0
,20160315,108880,108880,,,,108450,108450,-430,-430,0,0.00,0
,20160316,108450,108450,,,,108110,108110,-340,-340,0,0.00,0
,20160317,108110,108110,,,,108910,108910,800,800,0,0.00,0
,20160318,108910,108910,,,,111090,111090,2180,2180,0,0.00,0
,20160321,111090,111090,,,,110410,110410,-680,-680,0,0.00,0
,20160322,110410,110410,,,,110160,110160,-250,-250,0,0.00,0
,20160323,110160,110160,,,,110400,110400,240,240,0,0.00,0
,20160324,110400,110400,,,,111050,111050,650,650,0,0.00,0
,20160325,111050,111050,,,,111650,111650,600,600,0,0.00,0
,20160328,111650,111650,,,,111250,111250,-400,-400,0,0.00,0
,20160329,111250,111250,,,,108720,108720,-2530,-2530,0,0.00,0
,20160330,108720,108720,,,,106740,106740,-1980,-1980,0,0.00,0
,20160331,106740,106740,,,,104640,104640,-2100,-2100,0,0.00,0
,20160401,104640,104640,,,,104660,104660,20,20,0,0.00,0
,20160405,104660,104660,,,,103930,103930,-730,-730,0,0.00,0
,20160406,103930,103930,,,,104660,104660,730,730,0,0.00,0
,20160407,104660,104660,,,,105780,105780,1120,1120,0,0.00,0
,20160408,105780,105780,,,,107020,107020,1240,1240,0,0.00,0
,20160411,107020,107020,,,,109860,109860,2840,2840,0,0.00,0
,20160412,109860,109860,,,,109730,109730,-130,-130,0,0.00,0
,20160413,109730,109730,,,,111490,111490,1760,1760,0,0.00,0
,20160414,111490,111490,,,,113730,113730,2240,2240,0,0.00,0
,20160415,113730,113730,,,,113210,113210,-520,-520,0,0.00,0
,20160418,113210,113210,,,,111980,111980,-1230,-1230,0,0.00,0
,20160419,111980,111980,,,,112490,112490,510,510,0,0.00,0
,20160420,112490,112490,,,,113020,113020,530,530,0,0.00,0
,20160421,113020,113020,115140,115140,115140,115140,115140,2120,2120,2,23.03,2
,20160422,115140,115140,,,,115180,115180,40,40,0,0.00,2
,20160425,115180,115180,,,,114070,114070,-1110,-1110,0,0.00,2
,20160426,114070,114070,,,,112460,112460,-1610,-1610,0,0.00,2
,20160427,112460,112460,,,,111070,111070,-1390,-1390,0,0.00,2
,20160428,111070,111070,,,,109020,109020,-2050,-2050,0,0.00,2
,20160429,109020,109020,107660,107660,107660,107660,107660,-1360,-1360,2,21.53,0
,20160503,107660,107660,111500,111500,109050,109050,110270,1390,2610,4,44.11,2
,20160504,109050,110270,,,,111380,111380,1110,1110,0,0.00,2
,20160505,111380,111380,,,,111400,111400,20,20,0,0.00,2
,20160506,111400,111400,,,,111400,111400,0,0,0,0.00,2
,20160509,111400,111400,109000,109000,109000,109000,109000,-2400,-2400,2,21.80,2
,20160510,109000,109000,,,,109000,109000,0,0,0,0.00,2
,20160511,109000,109000,108190,108190,108190,108190,108190,-810,-810,2,21.64,0
,20160512,108190,108190,,,,105390,105390,-2800,-2800,0,0.00,0
,20160513,105390,105390,,,,103590,103590,-1800,-1800,0,0.00,0
,20160516,103590,103590,,,,104320,104320,730,730,0,0.00,0
,20160517,104320,104320,,,,104320,104320,0,0,0,0.00,0
,20160518,104320,104320,,,,101490,101490,-2830,-2830,0,0.00,0
,20160519,101490,101490,,,,101490,101490,0,0,0,0.00,0
,20160520,101490,101490,,,,101490,101490,0,0,0,0.00,0
,20160523,101490,101490,,,,101260,101260,-230,-230,0,0.00,0
,20160524,101260,101260,,,,101540,101540,280,280,0,0.00,0
,20160525,101540,101540,,,,102070,102070,530,530,0,0.00,0
,20160526,102070,102070,,,,102930,102930,860,860,0,0.00,0
,20160527,102930,102930,,,,104630,104630,1700,1700,0,0.00,0
,20160530,104630,104630,,,,106250,106250,1620,1620,0,0.00,0
,20160531,106250,106250,,,,107380,107380,1130,1130,0,0.00,0
,20160601,107380,107380,110070,110070,106840,107320,108190,-60,810,72,779.00,14
,20160602,107320,108190,,,,108190,108190,0,0,0,0.00,14
,20160603,108190,108190,,,,108190,108190,0,0,0,0.00,14
,20160606,108190,108190,,,,108190,108190,0,0,0,0.00,14
,20160607,108190,108190,,,,108190,108190,0,0,0,0.00,14
,20160608,108190,108190,,,,108190,108190,0,0,0,0.00,14
,20160613,108190,108190,,,,108190,108190,0,0,0,0.00,14
,20160614,108190,108190,,,,108190,108190,0,0,0,0.00,14
,20160615,108190,108190,,,,109000,109000,810,810,0,0.00,14
,20160616,109000,109000,114450,114450,110750,110750,113150,1750,4150,1184,"13,397.54",276
,20160617,110750,113150,111290,111300,110590,111300,110990,-1850,-2160,224,"2,486.38",54
,20160620,111300,110990,111160,111160,111160,111160,111160,170,170,2,22.23,54
,20160621,111160,111160,,,,111160,111160,0,0,0,0.00,54
,20160622,111160,111160,108940,112290,108940,112290,110630,1130,-530,6,66.38,54
,20160623,112290,110630,,,,110630,110630,0,0,0,0.00,54
,20160624,110630,110630,,,,110630,110630,0,0,0,0.00,54
,20160627,110630,110630,110630,110630,110630,110630,110630,0,0,2,22.13,56
,20160628,110630,110630,,,,110850,110850,220,220,0,0.00,56
,20160629,110850,110850,,,,110850,110850,0,0,0,0.00,56
,20160630,110850,110850,,,,110850,110850,0,0,0,0.00,56
,20160701,110850,110850,,,,116390,116390,5540,5540,0,0.00,56
,20160704,116390,116390,,,,116390,116390,0,0,0,0.00,56
,20160705,116390,116390,120200,120200,120200,120200,120200,3810,3810,2,24.04,56
,20160706,120200,120200,,,,118000,118000,-2200,-2200,0,0.00,56
,20160707,118000,118000,,,,118000,118000,0,0,0,0.00,56
,20160708,118000,118000,,,,116200,116200,-1800,-1800,0,0.00,56
,20160711,116200,116200,,,,116500,116500,300,300,0,0.00,56
,20160712,116500,116500,,,,117500,117500,1000,1000,0,0.00,56
,20160713,117500,117500,,,,117500,117500,0,0,0,0.00,56
,20160714,117500,117500,,,,117500,117500,0,0,0,0.00,56
,20160715,117500,117500,,,,117500,117500,0,0,0,0.00,56
,20160718,117500,117500,,,,117500,117500,0,0,0,0.00,56
,20160719,117500,117500,,,,117500,117500,0,0,0,0.00,56
,20160720,117500,117500,117500,117500,117500,117500,117500,0,0,2,23.50,56
,20160721,117500,117500,,,,117500,117500,0,0,0,0.00,56
,20160722,117500,117500,117700,117700,117700,117700,117700,200,200,2,23.54,58
,20160725,117700,117700,,,,117700,117700,0,0,0,0.00,58
,20160726,117700,117700,,,,117700,117700,0,0,0,0.00,58
,20160727,117700,117700,,,,117700,117700,0,0,0,0.00,58
,20160728,117700,117700,,,,117700,117700,0,0,0,0.00,58
,20160729,117700,117700,116850,119000,116850,119000,117920,1300,220,4,47.17,60
,20160801,119000,117920,,,,117920,117920,0,0,0,0.00,60
,20160802,117920,117920,,,,117920,117920,0,0,0,0.00,60
,20160803,117920,117920,119990,119990,119990,119990,119990,2070,2070,4,48.00,56
,20160804,119990,119990,,,,119990,119990,0,0,0,0.00,56
,20160805,119990,119990,,,,119990,119990,0,0,0,0.00,56
,20160808,119990,119990,,,,119990,119990,0,0,0,0.00,56
,20160809,119990,119990,,,,119990,119990,0,0,0,0.00,56
,20160810,119990,119990,,,,119990,119990,0,0,0,0.00,56
,20160811,119990,119990,,,,119990,119990,0,0,0,0.00,56
,20160812,119990,119990,,,,119990,119990,0,0,0,0.00,56
,20160815,119990,119990,123500,123500,114400,121700,122140,1710,2150,48,586.28,40
sn1609,20160104,94650,94700,94800,94800,93000,93440,93800,-1260,-900,8,75.04,196
,20160105,93440,93800,92940,94650,92680,94650,93680,850,-120,32,299.78,194
,20160106,94650,93680,94060,94060,92720,93870,93540,190,-140,50,467.73,204
,20160107,93870,93540,93680,93680,92540,92830,93060,-710,-480,62,577.02,220
,20160108,92830,93060,93000,93300,91210,93300,92400,240,-660,46,425.08,242
,20160111,93300,92400,94330,94340,92730,93420,93840,1020,1440,76,713.21,276
,20160112,93420,93840,93420,94310,92200,92200,93120,-1640,-720,72,670.53,280
,20160113,92200,93120,92600,93000,91020,91090,91640,-2030,-1480,136,"1,246.31",262
,20160114,91090,91640,91570,93980,90820,93490,92180,1850,540,88,811.27,242
,20160115,93490,92180,92930,94610,92200,92200,93420,20,1240,46,429.76,234
,20160118,92200,93420,92920,95480,92920,95480,93830,2060,410,22,206.43,232
,20160119,95480,93830,94510,95410,94400,95410,94820,1580,990,36,341.35,226
,20160120,95410,94820,94920,94920,93700,93700,94540,-1120,-280,20,189.08,226
,20160121,93700,94540,94860,95900,94860,95900,95210,1360,670,18,171.39,230
,20160122,95900,95210,96030,96610,96000,96030,96250,820,1040,22,211.76,234
,20160125,96030,96250,97180,97400,96890,97150,97150,900,900,14,136.01,230
,20160126,97150,97150,,,,97150,97150,0,0,0,0.00,230
,20160127,97150,97150,98080,100200,98080,99860,99040,2710,1890,22,217.89,242
,20160128,99860,99040,100010,100180,99520,100100,99970,1060,930,32,319.93,250
,20160129,100100,99970,98560,99320,97800,98140,98520,-1830,-1450,58,571.45,236
,20160201,98140,98520,99640,99780,98830,98830,99290,310,770,16,158.88,236
,20160202,98830,99290,98290,98720,98290,98720,98520,-570,-770,10,98.53,238
,20160203,98720,98520,98830,99210,98000,98670,98530,150,10,18,177.36,240
,20160204,98670,98530,98890,99900,98890,99040,99180,510,650,10,99.18,238
,20160205,99040,99180,99680,99970,99500,99500,99700,320,520,20,199.40,238
,20160215,99500,99700,99100,99950,98280,99950,99620,250,-80,26,259.03,250
,20160216,99950,99620,99500,99810,99240,99240,99580,-380,-40,8,79.67,254
,20160217,99240,99580,99130,99130,99130,99130,99130,-450,-450,2,19.83,254
,20160218,99130,99130,99230,99230,99050,99050,99140,-80,10,4,39.66,252
,20160219,99050,99140,99280,99800,98820,99800,99150,660,10,54,535.45,220
,20160222,99800,99150,99620,102960,99530,102700,101180,3550,2030,74,748.75,220
,20160223,102700,101180,102920,105210,102690,104700,103970,3520,2790,202,"2,100.26",162
,20160224,104700,103970,105580,105580,103990,105210,104860,1240,890,48,503.37,168
,20160225,105210,104860,104700,105240,104680,104680,104930,-180,70,36,377.76,176
,20160226,104680,104930,104270,104890,103150,103760,103590,-1170,-1340,64,663.01,166
,20160229,103760,103590,104050,104690,102280,103140,103830,-450,240,60,623.03,176
,20160301,103140,103830,103220,103220,103180,103180,103190,-650,-640,6,61.92,178
,20160302,103180,103190,104290,104600,103680,104100,104060,910,870,14,145.69,180
,20160303,104100,104060,104520,108210,104520,108190,107040,4130,2980,108,"1,156.11",182
,20160304,108190,107040,109260,111320,108220,111020,110210,3980,3170,166,"1,829.64",196
,20160307,111020,110210,113000,114610,111640,113590,113370,3380,3160,306,"3,469.20",308
,20160308,113590,113370,113570,117900,112070,116170,116360,2800,2990,1030,"11,986.03",504
,20160309,116170,116360,115230,115800,111700,111990,112480,-4370,-3880,430,"4,836.75",536
,20160310,111990,112480,113430,113870,108510,109010,110560,-3470,-1920,904,"9,995.16",516
,20160311,109010,110560,109150,110660,107980,109270,109190,-1290,-1370,150,"1,637.89",532
,20160314,109270,109190,110240,111380,109230,110080,110290,890,1100,122,"1,345.65",538
,20160315,110080,110290,110000,110000,108380,108450,109230,-1840,-1060,98,"1,070.46",538
,20160316,108450,109230,108050,109570,108050,109570,109130,340,-100,210,"2,291.77",612
,20160317,109570,109130,109490,110720,109290,109940,110110,810,980,252,"2,774.92",732
,20160318,109940,110110,110230,113870,110030,113140,112490,3030,2380,552,"6,209.49",870
,20160321,113140,112490,113010,113110,108710,109450,110130,-3040,-2360,856,"9,427.52",810
,20160322,109450,110130,109630,110390,108950,109010,109510,-1120,-620,306,"3,351.01",800
,20160323,109010,109510,109560,110930,108220,109230,109710,-280,200,520,"5,705.43",884
,20160324,109230,109710,110230,110850,109320,109840,110170,130,460,696,"7,668.47",954
,20160325,109840,110170,111000,112150,110480,111950,111560,1780,1390,932,"10,397.78",1216
,20160328,111950,111560,111900,112870,108820,108900,111510,-2660,-50,760,"8,475.04",1196
,20160329,108900,111510,109580,109950,108730,108960,109270,-2550,-2240,766,"8,370.65",1300
,20160330,108960,109270,109730,109730,105620,106300,106980,-2970,-2290,1146,"12,260.22",1566
,20160331,106300,106980,106390,106560,103630,104060,104920,-2920,-2060,2056,"21,572.34",1694
,20160401,104060,104920,104200,106240,104000,106220,105300,1300,380,1968,"20,724.08",1888
,20160405,106220,105300,106000,107000,104180,106810,106010,1510,710,1688,"17,895.39",2374
,20160406,106810,106010,106120,107660,106030,107300,106940,1290,930,2796,"29,901.55",2674
,20160407,107300,106940,107480,108250,107230,107750,107790,810,850,2592,"27,940.72",2928
,20160408,107750,107790,108000,108000,106300,107500,107090,-290,-700,3814,"40,847.82",3290
,20160411,107500,107090,107610,111540,107610,110100,109410,3010,2320,5028,"55,012.64",3916
,20160412,110100,109410,110590,110990,108220,109360,109400,-50,-10,3916,"42,841.39",4246
,20160413,109360,109400,109800,113580,109620,111220,111250,1820,1850,5590,"62,191.65",4540
,20160414,111220,111250,111330,114110,111300,112590,113150,1340,1900,7494,"84,802.05",5188
,20160415,112590,113150,113520,113700,111610,111980,112630,-1170,-520,4606,"51,879.06",5342
,20160418,111980,112630,112210,112590,110300,111100,111590,-1530,-1040,5374,"59,971.58",5332
,20160419,111100,111590,111250,112750,111030,112750,112050,1160,460,6332,"70,952.92",6162
,20160420,112750,112050,112760,113370,111450,112250,112630,200,580,6356,"71,590.90",6404
,20160421,112250,112630,113250,115680,112060,115500,113710,2870,1080,10240,"116,445.60",7832
,20160422,115500,113710,115850,116280,108530,111950,112770,-1760,-940,10398,"117,266.84",6714
,20160425,111950,112770,112600,114500,110880,111320,112300,-1450,-470,9130,"102,531.55",7780
,20160426,111320,112300,111320,112080,109550,110000,110870,-2300,-1430,6890,"76,391.17",8462
,20160427,110000,110870,110000,111280,109430,110100,110390,-770,-480,8192,"90,436.32",8692
,20160428,110100,110390,110100,110140,108440,108800,108940,-1590,-1450,9694,"105,606.50",9176
,20160429,108800,108940,108860,110980,108520,110330,110190,1390,1250,12784,"140,879.65",9568
,20160503,110330,110190,110100,112410,109540,112400,111100,2210,910,9112,"101,235.52",9918
,20160504,112400,111100,112000,113510,111510,112040,112280,940,1180,19180,"215,360.55",10210
,20160505,112040,112280,112300,114380,111600,113480,113190,1200,910,30476,"344,985.64",12388
,20160506,113480,113190,113490,114490,110200,111360,112160,-1830,-1030,41310,"463,367.22",10866
,20160509,111360,112160,111200,113200,110030,110770,111590,-1390,-570,33068,"369,018.99",10624
,20160510,110770,111590,110500,110960,106630,108930,108780,-2660,-2810,38566,"419,527.91",10510
,20160511,108930,108780,108510,109960,107510,109550,108940,770,160,26656,"290,408.24",10458
,20160512,109550,108940,110000,111300,109470,110820,110510,1880,1570,25600,"282,911.92",10052
,20160513,110820,110510,110490,110650,107110,107500,108340,-3010,-2170,33972,"368,059.64",12194
,20160516,107500,108340,107200,108670,106690,107860,107840,-480,-500,22214,"239,574.83",11836
,20160517,107860,107840,107870,109000,106910,108220,108100,380,260,23502,"254,061.33",11586
,20160518,108220,108100,107900,108630,106540,106580,107740,-1520,-360,24366,"262,527.57",12468
,20160519,106580,107740,106120,107500,105730,106730,106670,-1010,-1070,22608,"241,168.37",12632
,20160520,106730,106670,106440,107390,105210,107150,106570,480,-100,15350,"163,588.36",12250
,20160523,107150,106570,108190,108190,105500,105930,106240,-640,-330,23870,"253,600.22",12360
,20160524,105930,106240,104860,106210,104230,105510,105220,-730,-1020,19434,"204,497.90",12114
,20160525,105510,105220,106000,106000,104600,104690,105050,-530,-170,15432,"162,120.29",12476
,20160526,104690,105050,104800,106600,104500,106500,105510,1450,460,18336,"193,473.47",12030
,20160527,106500,105510,106300,108380,105810,108310,106900,2800,1390,20132,"215,217.77",11134
,20160530,108310,106900,108500,108870,107350,108000,107960,1100,1060,13538,"146,167.16",10840
,20160531,108000,107960,107510,108980,107510,108650,108380,690,420,12918,"140,014.67",10220
,20160601,108650,108380,108960,108960,106100,106150,107560,-2230,-820,19062,"205,043.28",10396
,20160602,106150,107560,106210,108290,106200,108100,107450,540,-110,18218,"195,766.49",9736
,20160603,108100,107450,108100,108270,107030,107540,107700,90,250,12176,"131,139.28",9940
,20160606,107540,107700,108170,109790,108170,109300,108910,1600,1210,17152,"186,813.90",9944
,20160607,109300,108910,109290,109840,108920,109510,109290,600,380,11530,"126,012.50",9698
,20160608,109510,109290,109630,109690,108440,109270,109080,-20,-210,12394,"135,202.80",9606
,20160613,109270,109080,109860,112000,109830,111570,111100,2490,2020,10064,"111,817.94",11152
,20160614,111570,111100,112000,112070,110660,111890,111550,790,450,11692,"130,426.55",11636
,20160615,111890,111550,111640,112000,111020,111760,111550,210,0,10592,"118,155.86",12166
,20160616,111760,111550,112080,113270,111140,111440,112400,-110,850,16132,"181,336.99",11558
,20160617,111440,112400,111810,113170,111280,112800,112030,400,-370,11516,"129,015.74",12476
,20160620,112800,112030,113000,113500,111580,112300,112380,270,350,10244,"115,125.61",12552
,20160621,112300,112380,112320,112340,110660,110920,111570,-1460,-810,13082,"145,963.45",12162
,20160622,110920,111570,110850,111890,110100,111670,111280,100,-290,9574,"106,540.65",12360
,20160623,111670,111280,111680,112290,110600,111480,111360,200,80,9548,"106,332.70",11930
,20160624,111480,111360,111860,112890,110300,110600,111710,-760,350,18052,"201,668.37",11492
,20160627,110600,111710,111010,113120,110740,112880,112220,1170,510,14422,"161,847.99",12964
,20160628,112880,112220,111960,112800,111830,112600,112380,380,160,11936,"134,137.56",12496
,20160629,112600,112380,113100,113450,111010,111630,112360,-750,-20,20096,"225,803.54",12188
,20160630,111630,112360,112000,113080,111670,112770,112390,410,30,14328,"161,038.65",12436
,20160701,112770,112390,112690,118000,112050,118000,115310,5610,2920,34210,"394,494.51",18104
,20160704,118000,115310,119000,124000,117000,122770,120870,7460,5560,58638,"708,810.81",16964
,20160705,122770,120870,124380,125690,117810,120330,121460,-540,590,61288,"744,423.02",15818
,20160706,120330,121460,121280,121450,115800,117270,118070,-4190,-3390,45218,"533,891.31",14662
,20160707,117270,118070,116800,119500,116030,116920,118160,-1150,90,33606,"397,101.36",13898
,20160708,116920,118160,117880,117880,113840,114900,115710,-3260,-2450,24224,"280,303.80",12776
,20160711,114900,115710,115800,119250,114860,117570,117090,1860,1380,29320,"343,311.30",13176
,20160712,117570,117090,118080,120500,117370,119840,118990,2750,1900,29438,"350,303.67",14454
,20160713,119840,118990,120190,122000,118170,119070,119900,80,910,46426,"556,659.11",14916
,20160714,119070,119900,119440,119600,117510,118000,118310,-1900,-1590,24542,"290,378.25",14700
,20160715,118000,118310,118110,119840,118110,119730,118900,1420,590,27224,"323,718.79",15270
,20160718,119730,118900,120330,120880,117030,117030,118570,-1870,-330,25786,"305,748.59",15134
,20160719,117030,118570,117890,118180,116710,117350,117550,-1220,-1020,22642,"266,172.03",15238
,20160720,117350,117550,117350,118500,116800,118090,117760,540,210,23416,"275,766.10",15310
,20160721,118090,117760,117660,119490,117150,118800,118200,1040,440,21418,"253,169.87",15454
,20160722,118800,118200,118800,119800,117500,117960,118730,-240,530,23504,"279,078.52",14860
,20160725,117960,118730,118080,118490,116810,117530,117570,-1200,-1160,13780,"162,017.25",14346
,20160726,117530,117570,117620,118500,116890,118130,117850,560,280,16832,"198,377.51",14430
,20160727,118130,117850,118110,121900,117920,120900,120210,3050,2360,38912,"467,773.66",16556
,20160728,120900,120210,121000,121560,120280,121340,121010,1130,800,22488,"272,130.37",16528
,20160729,121340,121010,122310,122370,119220,120070,120530,-940,-480,17634,"212,542.78",15592
,20160801,120070,120530,120360,120400,118500,119760,119530,-770,-1000,16140,"192,923.68",14850
,20160802,119760,119530,119820,120830,118830,120540,119930,1010,400,13230,"158,679.90",14722
,20160803,120540,119930,120680,121180,119140,119470,119950,-460,20,13300,"159,538.06",14040
,20160804,119470,119950,119660,119730,117580,117730,118440,-2220,-1510,15616,"184,956.36",13472
,20160805,117730,118440,117450,120790,117450,120300,119400,1860,960,15730,"187,828.11",12912
,20160808,120300,119400,120340,122300,119500,122200,120790,2800,1390,15974,"192,961.54",13970
,20160809,122200,120790,121300,122600,120800,122440,121640,1650,850,11064,"134,589.65",14234
,20160810,122440,121640,122570,125500,122170,124650,124080,3010,2440,19078,"236,727.31",15190
,20160811,124650,124080,125000,125950,123330,123620,124630,-460,550,20646,"257,312.27",14460
,20160812,123620,124630,123180,124500,122800,124330,123730,-300,-900,12300,"152,200.01",13784
,20160815,124330,123730,123800,123980,121820,122270,122520,-1460,-1210,11544,"141,439.91",12160
,20160816,122270,122520,122320,124000,122270,123450,123310,930,790,9848,"121,441.92",12300
,20160817,123450,123310,123160,123960,122340,122480,123190,-830,-120,7600,"93,625.94",11708
,20160818,122480,123190,122920,122920,120730,121180,121820,-2010,-1370,11854,"144,414.62",10192
,20160819,121180,121820,121710,123050,121320,122000,122140,180,320,7898,"96,469.60",9600
,20160822,122000,122140,122340,122820,121630,121840,122300,-300,160,9078,"111,030.24",8792
,20160823,121840,122300,121940,122490,121120,121750,121740,-550,-560,5376,"65,451.07",8642
,20160824,121750,121740,121830,124490,121830,124120,123240,2380,1500,9562,"117,851.30",8546
,20160825,124120,123240,124610,124610,121480,122610,122820,-630,-420,8742,"107,376.32",7860
,20160826,122610,122820,122120,123470,122120,122910,122850,90,30,4088,"50,222.79",7510
,20160829,122910,122850,123420,123890,122780,123510,123480,660,630,2950,"36,428.71",7110
,20160830,123510,123480,122820,123750,122540,122690,123070,-790,-410,2814,"34,631.97",6726
,20160831,122690,123070,122920,123200,121600,123200,122340,130,-730,1712,"20,945.11",6160
,20160901,123200,122340,122700,123850,122240,123850,123220,1510,880,996,"12,273.32",6044
,20160902,123850,123220,123310,126980,123310,126210,125170,2990,1950,2072,"25,936.96",6368
,20160905,126210,125170,126230,127100,126030,126790,126750,1620,1580,448,"5,678.66",6320
,20160906,126790,126750,127000,127000,125010,126100,125820,-650,-930,672,"8,455.52",6268
,20160907,126100,125820,125740,126560,125550,126560,126050,740,230,196,"2,470.66",6192
,20160908,126560,126050,126880,126890,126030,126240,126230,190,180,316,"3,989.07",5924
,20160909,126240,126230,126590,126880,126300,126300,126600,70,370,240,"3,038.42",5744
,20160912,126300,126600,125210,125210,122050,122050,124270,-4550,-2330,976,"12,129.65",4972
,20160913,122050,124270,123590,123800,122500,122520,123080,-1750,-1190,568,"6,991.18",4704
,20160914,122520,123080,123350,123350,122200,122200,122520,-880,-560,56,686.13,4684
,20160919,122200,122520,124000,124000,124000,124000,124000,1480,1480,8,99.20,4684
sn1610,20160104,93670,93670,,,,93670,93670,0,0,0,0.00,32
,20160105,93670,93670,,,,93550,93550,-120,-120,0,0.00,32
,20160106,93550,93550,,,,93410,93410,-140,-140,0,0.00,32
,20160107,93410,93410,,,,93410,93410,0,0,0,0.00,32
,20160108,93410,93410,,,,93410,93410,0,0,0,0.00,32
,20160111,93410,93410,,,,94860,94860,1450,1450,0,0.00,32
,20160112,94860,94860,,,,94860,94860,0,0,0,0.00,32
,20160113,94860,94860,91060,92000,91060,92000,91510,-2860,-3350,18,164.73,32
,20160114,92000,91510,,,,91510,91510,0,0,0,0.00,32
,20160115,91510,91510,,,,91510,91510,0,0,0,0.00,32
,20160118,91510,91510,94770,94770,94770,94770,94770,3260,3260,2,18.95,30
,20160119,94770,94770,,,,94770,94770,0,0,0,0.00,30
,20160120,94770,94770,,,,94490,94490,-280,-280,0,0.00,30
,20160121,94490,94490,,,,94490,94490,0,0,0,0.00,30
,20160122,94490,94490,,,,95520,95520,1030,1030,0,0.00,30
,20160125,95520,95520,,,,96410,96410,890,890,0,0.00,30
,20160126,96410,96410,,,,96400,96400,-10,-10,0,0.00,30
,20160127,96400,96400,,,,98270,98270,1870,1870,0,0.00,30
,20160128,98270,98270,,,,99200,99200,930,930,0,0.00,30
,20160129,99200,99200,,,,97760,97760,-1440,-1440,0,0.00,30
,20160201,97760,97760,,,,98530,98530,770,770,0,0.00,30
,20160202,98530,98530,,,,97770,97770,-760,-760,0,0.00,30
,20160203,97770,97770,,,,97780,97780,10,10,0,0.00,30
,20160204,97780,97780,,,,98420,98420,640,640,0,0.00,30
,20160205,98420,98420,,,,98930,98930,510,510,0,0.00,30
,20160215,98930,98930,,,,98850,98850,-80,-80,0,0.00,30
,20160216,98850,98850,,,,98810,98810,-40,-40,0,0.00,30
,20160217,98810,98810,,,,98360,98360,-450,-450,0,0.00,30
,20160218,98360,98360,,,,98360,98360,0,0,0,0.00,30
,20160219,98360,98360,,,,98370,98370,10,10,0,0.00,30
,20160222,98370,98370,,,,100380,100380,2010,2010,0,0.00,30
,20160223,100380,100380,,,,104390,104390,4010,4010,0,0.00,30
,20160224,104390,104390,,,,104390,104390,0,0,0,0.00,30
,20160225,104390,104390,,,,104460,104460,70,70,0,0.00,30
,20160226,104460,104460,105250,105250,105250,105250,105250,790,790,2,21.05,30
,20160229,105250,105250,,,,105500,105500,250,250,0,0.00,30
,20160301,105500,105500,,,,104850,104850,-650,-650,0,0.00,30
,20160302,104850,104850,,,,105730,105730,880,880,0,0.00,30
,20160303,105730,105730,,,,108760,108760,3030,3030,0,0.00,30
,20160304,108760,108760,111270,111910,111270,111910,111590,3150,2830,4,44.64,26
,20160307,111910,111590,,,,111590,111590,0,0,0,0.00,26
,20160308,111590,111590,,,,111710,111710,120,120,0,0.00,26
,20160309,111710,111710,110700,112200,110700,112200,111450,490,-260,4,44.58,24
,20160310,112200,111450,,,,111450,111450,0,0,0,0.00,24
,20160311,111450,111450,,,,110070,110070,-1380,-1380,0,0.00,24
,20160314,110070,110070,,,,111180,111180,1110,1110,0,0.00,24
,20160315,111180,111180,,,,110110,110110,-1070,-1070,0,0.00,24
,20160316,110110,110110,,,,110010,110010,-100,-100,0,0.00,24
,20160317,110010,110010,,,,110010,110010,0,0,0,0.00,24
,20160318,110010,110010,113400,113400,113400,113400,113400,3390,3390,2,22.68,24
,20160321,113400,113400,111500,111500,111500,111500,111500,-1900,-1900,2,22.30,24
,20160322,111500,111500,,,,110870,110870,-630,-630,0,0.00,24
,20160323,110870,110870,,,,111080,111080,210,210,0,0.00,24
,20160324,111080,111080,,,,111550,111550,470,470,0,0.00,24
,20160325,111550,111550,112980,112980,110070,110070,111520,-1480,-30,4,44.61,24
,20160328,110070,111520,110900,110900,110900,110900,110900,-620,-620,2,22.18,24
,20160329,110900,110900,,,,110900,110900,0,0,0,0.00,24
,20160330,110900,110900,106870,106870,106870,106870,106870,-4030,-4030,2,21.37,24
,20160331,106870,106870,,,,106870,106870,0,0,0,0.00,24
,20160401,106870,106870,,,,107260,107260,390,390,0,0.00,24
,20160405,107260,107260,,,,107260,107260,0,0,0,0.00,24
,20160406,107260,107260,,,,107260,107260,0,0,0,0.00,24
,20160407,107260,107260,,,,107260,107260,0,0,0,0.00,24
,20160408,107260,107260,,,,107260,107260,0,0,0,0.00,24
,20160411,107260,107260,,,,108800,108800,1540,1540,0,0.00,24
,20160412,108800,108800,,,,108800,108800,0,0,0,0.00,24
,20160413,108800,108800,,,,109500,109500,700,700,0,0.00,24
,20160414,109500,109500,,,,110500,110500,1000,1000,0,0.00,24
,20160415,110500,110500,,,,110500,110500,0,0,0,0.00,24
,20160418,110500,110500,,,,110500,110500,0,0,0,0.00,24
,20160419,110500,110500,109500,112000,109500,112000,110750,1500,250,4,44.30,24
,20160420,112000,110750,,,,110750,110750,0,0,0,0.00,24
,20160421,110750,110750,,,,112500,112500,1750,1750,0,0.00,24
,20160422,112500,112500,,,,111570,111570,-930,-930,0,0.00,24
,20160425,111570,111570,,,,111100,111100,-470,-470,0,0.00,24
,20160426,111100,111100,112920,112920,109100,110740,111820,-360,720,102,"1,140.64",30
,20160427,110740,111820,108530,112330,108530,112330,110370,510,-1450,12,132.45,28
,20160428,112330,110370,,,,108920,108920,-1450,-1450,0,0.00,28
,20160429,108920,108920,110450,110450,110450,110450,110450,1530,1530,4,44.18,24
,20160503,110450,110450,,,,110500,110500,50,50,0,0.00,24
,20160504,110500,110500,,,,110500,110500,0,0,0,0.00,24
,20160505,110500,110500,,,,112200,112200,1700,1700,0,0.00,24
,20160506,112200,112200,,,,112000,112000,-200,-200,0,0.00,24
,20160509,112000,112000,,,,111430,111430,-570,-570,0,0.00,24
,20160510,111430,111430,,,,110250,110250,-1180,-1180,0,0.00,24
,20160511,110250,110250,,,,110410,110410,160,160,0,0.00,24
,20160512,110410,110410,,,,112000,112000,1590,1590,0,0.00,24
,20160513,112000,112000,,,,109800,109800,-2200,-2200,0,0.00,24
,20160516,109800,109800,,,,109300,109300,-500,-500,0,0.00,24
,20160517,109300,109300,,,,109560,109560,260,260,0,0.00,24
,20160518,109560,109560,,,,109190,109190,-370,-370,0,0.00,24
,20160519,109190,109190,,,,108100,108100,-1090,-1090,0,0.00,24
,20160520,108100,108100,,,,108000,108000,-100,-100,0,0.00,24
,20160523,108000,108000,,,,107660,107660,-340,-340,0,0.00,24
,20160524,107660,107660,,,,106630,106630,-1030,-1030,0,0.00,24
,20160525,106630,106630,,,,106460,106460,-170,-170,0,0.00,24
,20160526,106460,106460,,,,106930,106930,470,470,0,0.00,24
,20160527,106930,106930,,,,108340,108340,1410,1410,0,0.00,24
,20160530,108340,108340,,,,109420,109420,1080,1080,0,0.00,24
,20160531,109420,109420,,,,109850,109850,430,430,0,0.00,24
,20160601,109850,109850,,,,109020,109020,-830,-830,0,0.00,24
,20160602,109020,109020,,,,108910,108910,-110,-110,0,0.00,24
,20160603,108910,108910,,,,109160,109160,250,250,0,0.00,24
,20160606,109160,109160,,,,110390,110390,1230,1230,0,0.00,24
,20160607,110390,110390,,,,110770,110770,380,380,0,0.00,24
,20160608,110770,110770,,,,110560,110560,-210,-210,0,0.00,24
,20160613,110560,110560,,,,112610,112610,2050,2050,0,0.00,24
,20160614,112610,112610,,,,113060,113060,450,450,0,0.00,24
,20160615,113060,113060,,,,113060,113060,0,0,0,0.00,24
,20160616,113060,113060,,,,113920,113920,860,860,0,0.00,24
,20160617,113920,113920,,,,113540,113540,-380,-380,0,0.00,24
,20160620,113540,113540,,,,113540,113540,0,0,0,0.00,24
,20160621,113540,113540,,,,113540,113540,0,0,0,0.00,24
,20160622,113540,113540,,,,113240,113240,-300,-300,0,0.00,24
,20160623,113240,113240,,,,113320,113320,80,80,0,0.00,24
,20160624,113320,113320,,,,113680,113680,360,360,0,0.00,24
,20160627,113680,113680,,,,114200,114200,520,520,0,0.00,24
,20160628,114200,114200,,,,114360,114360,160,160,0,0.00,24
,20160629,114360,114360,,,,114360,114360,0,0,0,0.00,24
,20160630,114360,114360,,,,114390,114390,30,30,0,0.00,24
,20160701,114390,114390,113730,117720,113730,117720,115480,3330,1090,6,69.29,26
,20160704,117720,115480,119970,121000,119120,121000,120020,5520,4540,8,96.02,24
,20160705,121000,120020,120000,120000,120000,120000,120000,-20,-20,2,24.00,24
,20160706,120000,120000,120490,120500,119230,119230,120170,-770,170,16,192.28,26
,20160707,119230,120170,,,,120170,120170,0,0,0,0.00,26
,20160708,120170,120170,,,,117680,117680,-2490,-2490,0,0.00,26
,20160711,117680,117680,120350,120350,117010,117010,118680,-670,1000,4,47.47,24
,20160712,117010,118680,,,,120610,120610,1930,1930,0,0.00,24
,20160713,120610,120610,,,,120610,120610,0,0,0,0.00,24
,20160714,120610,120610,116300,118690,116300,118690,117530,-1920,-3080,6,70.52,24
,20160715,118690,117530,,,,117530,117530,0,0,0,0.00,24
,20160718,117530,117530,,,,117200,117200,-330,-330,0,0.00,24
,20160719,117200,117200,,,,116190,116190,-1010,-1010,0,0.00,24
,20160720,116190,116190,,,,116400,116400,210,210,0,0.00,24
,20160721,116400,116400,,,,117500,117500,1100,1100,0,0.00,24
,20160722,117500,117500,,,,117500,117500,0,0,0,0.00,24
,20160725,117500,117500,,,,116350,116350,-1150,-1150,0,0.00,24
,20160726,116350,116350,,,,116350,116350,0,0,0,0.00,24
,20160727,116350,116350,120490,121010,120490,121010,120750,4660,4400,4,48.30,24
,20160728,121010,120750,,,,120750,120750,0,0,0,0.00,24
,20160729,120750,120750,,,,120500,120500,-250,-250,0,0.00,24
,20160801,120500,120500,,,,119500,119500,-1000,-1000,0,0.00,24
,20160802,119500,119500,,,,119900,119900,400,400,0,0.00,24
,20160803,119900,119900,,,,119900,119900,0,0,0,0.00,24
,20160804,119900,119900,119820,119820,119820,119820,119820,-80,-80,4,47.93,28
,20160805,119820,119820,116000,119510,116000,119510,117960,-310,-1860,10,117.97,28
,20160808,119510,117960,,,,120470,120470,2510,2510,0,0.00,28
,20160809,120470,120470,,,,120730,120730,260,260,0,0.00,28
,20160810,120730,120730,123500,123500,123500,123500,123500,2770,2770,2,24.70,28
,20160811,123500,123500,,,,123500,123500,0,0,0,0.00,28
,20160812,123500,123500,,,,122610,122610,-890,-890,0,0.00,28
,20160815,122610,122610,120830,120830,120830,120830,120830,-1780,-1780,2,24.17,28
,20160816,120830,120830,124490,124490,121640,121640,123060,810,2230,4,49.23,28
,20160817,121640,123060,121340,124770,121340,124690,124130,1630,1070,14,173.78,32
,20160818,124690,124130,,,,123190,123190,-940,-940,0,0.00,32
,20160819,123190,123190,124210,124210,124210,124210,124210,1020,1020,4,49.68,34
,20160822,124210,124210,,,,123190,123190,-1020,-1020,0,0.00,34
,20160823,123190,123190,,,,123000,123000,-190,-190,0,0.00,34
,20160824,123000,123000,123500,125000,123500,125000,124240,2000,1240,8,99.40,28
,20160825,125000,124240,124010,124010,122690,122690,123200,-1550,-1040,50,616.02,24
,20160826,122690,123200,,,,123200,123200,0,0,0,0.00,24
,20160829,123200,123200,123500,123500,123500,123500,123500,300,300,12,148.20,12
,20160830,123500,123500,123500,123500,123500,123500,123500,0,0,2,24.70,12
,20160831,123500,123500,123000,123000,123000,123000,123000,-500,-500,6,73.80,6
,20160901,123000,123000,,,,123000,123000,0,0,0,0.00,6
,20160902,123000,123000,,,,123940,123940,940,940,0,0.00,6
,20160905,123940,123940,,,,124800,124800,860,860,0,0.00,6
,20160906,124800,124800,,,,124800,124800,0,0,0,0.00,6
,20160907,124800,124800,,,,125030,125030,230,230,0,0.00,6
,20160908,125030,125030,,,,125030,125030,0,0,0,0.00,6
,20160909,125030,125030,,,,125030,125030,0,0,0,0.00,6
,20160912,125030,125030,,,,124520,124520,-510,-510,0,0.00,6
,20160913,124520,124520,,,,124500,124500,-20,-20,0,0.00,6
,20160914,124500,124500,,,,123930,123930,-570,-570,0,0.00,6
,20160919,123930,123930,,,,125420,125420,1490,1490,0,0.00,6
,20160920,125420,125420,122010,122010,122010,122010,122010,-3410,-3410,2,24.40,4
,20160921,122010,122010,,,,122010,122010,0,0,0,0.00,4
,20160922,122010,122010,,,,123000,123000,990,990,0,0.00,4
,20160923,123000,123000,,,,123900,123900,900,900,0,0.00,4
,20160926,123900,123900,,,,123900,123900,0,0,0,0.00,4
,20160927,123900,123900,126000,127000,126000,127000,126200,3100,2300,12,151.44,8
,20160928,127000,126200,128000,128000,128000,128000,128000,1800,1800,2,25.60,8
,20160929,128000,128000,,,,128000,128000,0,0,0,0.00,8
,20160930,128000,128000,,,,128000,128000,0,0,0,0.00,8
,20161010,128000,128000,,,,128000,128000,0,0,0,0.00,8
,20161011,128000,128000,,,,128000,128000,0,0,0,0.00,8
,20161012,128000,128000,129000,129000,129000,129000,129000,1000,1000,8,103.20,0
,20161013,129000,129000,,,,129000,129000,0,0,0,0.00,0
,20161014,129000,129000,,,,129000,129000,0,0,0,0.00,0
,20161017,129000,129000,,,,129000,129000,0,0,0,0.00,0
sn1611,20160104,91370,91370,,,,90500,90500,-870,-870,0,0.00,0
,20160105,90500,90500,,,,90380,90380,-120,-120,0,0.00,0
,20160106,90380,90380,,,,90250,90250,-130,-130,0,0.00,0
,20160107,90250,90250,,,,89790,89790,-460,-460,0,0.00,0
,20160108,89790,89790,,,,89160,89160,-630,-630,0,0.00,0
,20160111,89160,89160,,,,90550,90550,1390,1390,0,0.00,0
,20160112,90550,90550,,,,89860,89860,-690,-690,0,0.00,0
,20160113,89860,89860,,,,86690,86690,-3170,-3170,0,0.00,0
,20160114,86690,86690,,,,90150,90150,3460,3460,0,0.00,0
,20160115,90150,90150,,,,91360,91360,1210,1210,0,0.00,0
,20160118,91360,91360,,,,94610,94610,3250,3250,0,0.00,0
,20160119,94610,94610,,,,95600,95600,990,990,0,0.00,0
,20160120,95600,95600,,,,95310,95310,-290,-290,0,0.00,0
,20160121,95310,95310,,,,95990,95990,680,680,0,0.00,0
,20160122,95990,95990,,,,97040,97040,1050,1050,0,0.00,0
,20160125,97040,97040,,,,97950,97950,910,910,0,0.00,0
,20160126,97950,97950,,,,97940,97940,-10,-10,0,0.00,0
,20160127,97940,97940,,,,99840,99840,1900,1900,0,0.00,0
,20160128,99840,99840,,,,100780,100780,940,940,0,0.00,0
,20160129,100780,100780,,,,99320,99320,-1460,-1460,0,0.00,0
,20160201,99320,99320,,,,100100,100100,780,780,0,0.00,0
,20160202,100100,100100,,,,99320,99320,-780,-780,0,0.00,0
,20160203,99320,99320,,,,99330,99330,10,10,0,0.00,0
,20160204,99330,99330,,,,99980,99980,650,650,0,0.00,0
,20160205,99980,99980,,,,100500,100500,520,520,0,0.00,0
,20160215,100500,100500,,,,100420,100420,-80,-80,0,0.00,0
,20160216,100420,100420,,,,100380,100380,-40,-40,0,0.00,0
,20160217,100380,100380,,,,99920,99920,-460,-460,0,0.00,0
,20160218,99920,99920,,,,99930,99930,10,10,0,0.00,0
,20160219,99930,99930,,,,99940,99940,10,10,0,0.00,0
,20160222,99940,99940,,,,101980,101980,2040,2040,0,0.00,0
,20160223,101980,101980,,,,104790,104790,2810,2810,0,0.00,0
,20160224,104790,104790,,,,105690,105690,900,900,0,0.00,0
,20160225,105690,105690,,,,105760,105760,70,70,0,0.00,0
,20160226,105760,105760,,,,106550,106550,790,790,0,0.00,0
,20160229,106550,106550,,,,106800,106800,250,250,0,0.00,0
,20160301,106800,106800,,,,106140,106140,-660,-660,0,0.00,0
,20160302,106140,106140,,,,107030,107030,890,890,0,0.00,0
,20160303,107030,107030,,,,110100,110100,3070,3070,0,0.00,0
,20160304,110100,110100,,,,112960,112960,2860,2860,0,0.00,0
,20160307,112960,112960,,,,116200,116200,3240,3240,0,0.00,0
,20160308,116200,116200,,,,119270,119270,3070,3070,0,0.00,0
,20160309,119270,119270,,,,114490,114490,-4780,-4780,0,0.00,0
,20160310,114490,114490,,,,112540,112540,-1950,-1950,0,0.00,0
,20160311,112540,112540,108030,110960,108030,110960,109490,-1580,-3050,4,43.80,0
,20160314,110960,109490,,,,110600,110600,1110,1110,0,0.00,0
,20160315,110600,110600,,,,109530,109530,-1070,-1070,0,0.00,0
,20160316,109530,109530,,,,109430,109430,-100,-100,0,0.00,0
,20160317,109430,109430,,,,110410,110410,980,980,0,0.00,0
,20160318,110410,110410,,,,113810,113810,3400,3400,0,0.00,0
,20160321,113810,113810,,,,111900,111900,-1910,-1910,0,0.00,0
,20160322,111900,111900,,,,111270,111270,-630,-630,0,0.00,0
,20160323,111270,111270,,,,111480,111480,210,210,0,0.00,0
,20160324,111480,111480,,,,111950,111950,470,470,0,0.00,0
,20160325,111950,111950,,,,111920,111920,-30,-30,0,0.00,0
,20160328,111920,111920,,,,111290,111290,-630,-630,0,0.00,0
,20160329,111290,111290,,,,109060,109060,-2230,-2230,0,0.00,0
,20160330,109060,109060,,,,105090,105090,-3970,-3970,0,0.00,0
,20160331,105090,105090,,,,103070,103070,-2020,-2020,0,0.00,0
,20160401,103070,103070,,,,103440,103440,370,370,0,0.00,0
,20160405,103440,103440,,,,104140,104140,700,700,0,0.00,0
,20160406,104140,104140,,,,105050,105050,910,910,0,0.00,0
,20160407,105050,105050,,,,105890,105890,840,840,0,0.00,0
,20160408,105890,105890,,,,105210,105210,-680,-680,0,0.00,0
,20160411,105210,105210,,,,107490,107490,2280,2280,0,0.00,0
,20160412,107490,107490,,,,107480,107480,-10,-10,0,0.00,0
,20160413,107480,107480,,,,109300,109300,1820,1820,0,0.00,0
,20160414,109300,109300,,,,111170,111170,1870,1870,0,0.00,0
,20160415,111170,111170,,,,110660,110660,-510,-510,0,0.00,0
,20160418,110660,110660,,,,109640,109640,-1020,-1020,0,0.00,0
,20160419,109640,109640,,,,109880,109880,240,240,0,0.00,0
,20160420,109880,109880,,,,110450,110450,570,570,0,0.00,0
,20160421,110450,110450,,,,111510,111510,1060,1060,0,0.00,0
,20160422,111510,111510,110150,114110,110150,114110,112130,2600,620,4,44.85,0
,20160425,114110,112130,,,,111660,111660,-470,-470,0,0.00,0
,20160426,111660,111660,,,,112390,112390,730,730,0,0.00,0
,20160427,112390,112390,,,,110940,110940,-1450,-1450,0,0.00,0
,20160428,110940,110940,108750,109810,108750,109800,109290,-1140,-1650,24,262.30,0
,20160429,109800,109290,,,,110820,110820,1530,1530,0,0.00,0
,20160503,110820,110820,,,,111730,111730,910,910,0,0.00,0
,20160504,111730,111730,,,,112920,112920,1190,1190,0,0.00,0
,20160505,112920,112920,,,,113840,113840,920,920,0,0.00,0
,20160506,113840,113840,,,,112810,112810,-1030,-1030,0,0.00,0
,20160509,112810,112810,,,,112240,112240,-570,-570,0,0.00,0
,20160510,112240,112240,,,,109410,109410,-2830,-2830,0,0.00,0
,20160511,109410,109410,,,,109570,109570,160,160,0,0.00,0
,20160512,109570,109570,,,,111150,111150,1580,1580,0,0.00,0
,20160513,111150,111150,,,,108960,108960,-2190,-2190,0,0.00,0
,20160516,108960,108960,,,,108460,108460,-500,-500,0,0.00,0
,20160517,108460,108460,,,,108720,108720,260,260,0,0.00,0
,20160518,108720,108720,,,,108360,108360,-360,-360,0,0.00,0
,20160519,108360,108360,,,,107280,107280,-1080,-1080,0,0.00,0
,20160520,107280,107280,,,,107180,107180,-100,-100,0,0.00,0
,20160523,107180,107180,103810,106960,103810,106960,105380,-220,-1800,4,42.15,2
,20160524,106960,105380,,,,104370,104370,-1010,-1010,0,0.00,2
,20160525,104370,104370,,,,104200,104200,-170,-170,0,0.00,2
,20160526,104200,104200,,,,104660,104660,460,460,0,0.00,2
,20160527,104660,104660,,,,106040,106040,1380,1380,0,0.00,2
,20160530,106040,106040,,,,107090,107090,1050,1050,0,0.00,2
,20160531,107090,107090,,,,107510,107510,420,420,0,0.00,2
,20160601,107510,107510,,,,106700,106700,-810,-810,0,0.00,2
,20160602,106700,106700,,,,106590,106590,-110,-110,0,0.00,2
,20160603,106590,106590,,,,106840,106840,250,250,0,0.00,2
,20160606,106840,106840,,,,108040,108040,1200,1200,0,0.00,2
,20160607,108040,108040,,,,108410,108410,370,370,0,0.00,2
,20160608,108410,108410,,,,108200,108200,-210,-210,0,0.00,2
,20160613,108200,108200,,,,110210,110210,2010,2010,0,0.00,2
,20160614,110210,110210,111410,111410,111410,111410,111410,1200,1200,2,22.28,0
,20160615,111410,111410,,,,111410,111410,0,0,0,0.00,0
,20160616,111410,111410,,,,112260,112260,850,850,0,0.00,0
,20160617,112260,112260,,,,111890,111890,-370,-370,0,0.00,0
,20160620,111890,111890,,,,112240,112240,350,350,0,0.00,0
,20160621,112240,112240,,,,111430,111430,-810,-810,0,0.00,0
,20160622,111430,111430,,,,111140,111140,-290,-290,0,0.00,0
,20160623,111140,111140,,,,111220,111220,80,80,0,0.00,0
,20160624,111220,111220,,,,111570,111570,350,350,0,0.00,0
,20160627,111570,111570,,,,112080,112080,510,510,0,0.00,0
,20160628,112080,112080,,,,112240,112240,160,160,0,0.00,0
,20160629,112240,112240,,,,112220,112220,-20,-20,0,0.00,0
,20160630,112220,112220,,,,112250,112250,30,30,0,0.00,0
,20160701,112250,112250,,,,113320,113320,1070,1070,0,0.00,0
,20160704,113320,113320,,,,117770,117770,4450,4450,0,0.00,0
,20160705,117770,117770,,,,118500,118500,730,730,0,0.00,0
,20160706,118500,118500,,,,118500,118500,0,0,0,0.00,0
,20160707,118500,118500,,,,118590,118590,90,90,0,0.00,0
,20160708,118590,118590,,,,116130,116130,-2460,-2460,0,0.00,0
,20160711,116130,116130,,,,117110,117110,980,980,0,0.00,0
,20160712,117110,117110,,,,119010,119010,1900,1900,0,0.00,0
,20160713,119010,119010,,,,119920,119920,910,910,0,0.00,0
,20160714,119920,119920,,,,116860,116860,-3060,-3060,0,0.00,0
,20160715,116860,116860,,,,117450,117450,590,590,0,0.00,0
,20160718,117450,117450,,,,117120,117120,-330,-330,0,0.00,0
,20160719,117120,117120,,,,116110,116110,-1010,-1010,0,0.00,0
,20160720,116110,116110,,,,116320,116320,210,210,0,0.00,0
,20160721,116320,116320,,,,116750,116750,430,430,0,0.00,0
,20160722,116750,116750,,,,117280,117280,530,530,0,0.00,0
,20160725,117280,117280,,,,116130,116130,-1150,-1150,0,0.00,0
,20160726,116130,116130,,,,116410,116410,280,280,0,0.00,0
,20160727,116410,116410,,,,120810,120810,4400,4400,0,0.00,0
,20160728,120810,120810,,,,121610,121610,800,800,0,0.00,0
,20160729,121610,121610,,,,121120,121120,-490,-490,0,0.00,0
,20160801,121120,121120,,,,120110,120110,-1010,-1010,0,0.00,0
,20160802,120110,120110,,,,120520,120520,410,410,0,0.00,0
,20160803,120520,120520,,,,120540,120540,20,20,0,0.00,0
,20160804,120540,120540,,,,120450,120450,-90,-90,0,0.00,0
,20160805,120450,120450,,,,118580,118580,-1870,-1870,0,0.00,0
,20160808,118580,118580,,,,119960,119960,1380,1380,0,0.00,0
,20160809,119960,119960,,,,120810,120810,850,850,0,0.00,0
,20160810,120810,120810,,,,123580,123580,2770,2770,0,0.00,0
,20160811,123580,123580,,,,124120,124120,540,540,0,0.00,0
,20160812,124120,124120,,,,123230,123230,-890,-890,0,0.00,0
,20160815,123230,123230,,,,121440,121440,-1790,-1790,0,0.00,0
,20160816,121440,121440,,,,123680,123680,2240,2240,0,0.00,0
,20160817,123680,123680,,,,124750,124750,1070,1070,0,0.00,0
,20160818,124750,124750,,,,123370,123370,-1380,-1380,0,0.00,0
,20160819,123370,123370,,,,124390,124390,1020,1020,0,0.00,0
,20160822,124390,124390,,,,124560,124560,170,170,0,0.00,0
,20160823,124560,124560,,,,123990,123990,-570,-570,0,0.00,0
,20160824,123990,123990,,,,125240,125240,1250,1250,0,0.00,0
,20160825,125240,125240,121000,121000,121000,121000,121000,-4240,-4240,2,24.20,2
,20160826,121000,121000,,,,121000,121000,0,0,0,0.00,2
,20160829,121000,121000,,,,121850,121850,850,850,0,0.00,2
,20160830,121850,121850,,,,121850,121850,0,0,0,0.00,2
,20160831,121850,121850,,,,121850,121850,0,0,0,0.00,2
,20160901,121850,121850,,,,122400,122400,550,550,0,0.00,2
,20160902,122400,122400,,,,124750,124750,2350,2350,0,0.00,2
,20160905,124750,124750,,,,125330,125330,580,580,0,0.00,2
,20160906,125330,125330,,,,125330,125330,0,0,0,0.00,2
,20160907,125330,125330,,,,125330,125330,0,0,0,0.00,2
,20160908,125330,125330,,,,125330,125330,0,0,0,0.00,2
,20160909,125330,125330,,,,125330,125330,0,0,0,0.00,2
,20160912,125330,125330,122720,122720,122720,122720,122720,-2610,-2610,2,24.54,0
,20160913,122720,122720,,,,121540,121540,-1180,-1180,0,0.00,0
,20160914,121540,121540,,,,120980,120980,-560,-560,0,0.00,0
,20160919,120980,120980,,,,122440,122440,1460,1460,0,0.00,0
,20160920,122440,122440,,,,119110,119110,-3330,-3330,0,0.00,0
,20160921,119110,119110,,,,119110,119110,0,0,0,0.00,0
,20160922,119110,119110,,,,119110,119110,0,0,0,0.00,0
,20160923,119110,119110,,,,119110,119110,0,0,0,0.00,0
,20160926,119110,119110,,,,119110,119110,0,0,0,0.00,0
,20160927,119110,119110,,,,121320,121320,2210,2210,0,0.00,0
,20160928,121320,121320,,,,123050,123050,1730,1730,0,0.00,0
,20160929,123050,123050,,,,123050,123050,0,0,0,0.00,0
,20160930,123050,123050,,,,123050,123050,0,0,0,0.00,0
,20161010,123050,123050,,,,123050,123050,0,0,0,0.00,0
,20161011,123050,123050,,,,123050,123050,0,0,0,0.00,0
,20161012,123050,123050,,,,124010,124010,960,960,0,0.00,0
,20161013,124010,124010,,,,124010,124010,0,0,0,0.00,0
,20161014,124010,124010,,,,124010,124010,0,0,0,0.00,0
,20161017,124010,124010,,,,124010,124010,0,0,0,0.00,0
,20161018,124010,124010,,,,124010,124010,0,0,0,0.00,0
,20161019,124010,124010,,,,124010,124010,0,0,0,0.00,0
,20161020,124010,124010,,,,124010,124010,0,0,0,0.00,0
,20161021,124010,124010,,,,124010,124010,0,0,0,0.00,0
,20161024,124010,124010,,,,124010,124010,0,0,0,0.00,0
,20161025,124010,124010,,,,124010,124010,0,0,0,0.00,0
,20161026,124010,124010,,,,124010,124010,0,0,0,0.00,0
,20161027,124010,124010,,,,124010,124010,0,0,0,0.00,0
,20161028,124010,124010,,,,124010,124010,0,0,0,0.00,0
,20161031,124010,124010,,,,124010,124010,0,0,0,0.00,0
,20161101,124010,124010,,,,124010,124010,0,0,0,0.00,0
,20161102,124010,124010,,,,124010,124010,0,0,0,0.00,0
,20161103,124010,124010,,,,124010,124010,0,0,0,0.00,0
,20161104,124010,124010,,,,124010,124010,0,0,0,0.00,0
,20161107,124010,124010,,,,124010,124010,0,0,0,0.00,0
,20161108,124010,124010,,,,130210,130210,6200,6200,0,0.00,0
,20161109,130210,130210,,,,130210,130210,0,0,0,0.00,0
,20161110,130210,130210,,,,130210,130210,0,0,0,0.00,0
,20161111,130210,130210,,,,130210,130210,0,0,0,0.00,0
,20161114,130210,130210,,,,130210,130210,0,0,0,0.00,0
,20161115,130210,130210,,,,130210,130210,0,0,0,0.00,0
sn1612,20160104,89830,89830,,,,88980,88980,-850,-850,0,0.00,0
,20160105,88980,88980,,,,88860,88860,-120,-120,0,0.00,0
,20160106,88860,88860,,,,88730,88730,-130,-130,0,0.00,0
,20160107,88730,88730,,,,88280,88280,-450,-450,0,0.00,0
,20160108,88280,88280,,,,90860,90860,2580,2580,0,0.00,0
,20160111,90860,90860,,,,90860,90860,0,0,0,0.00,0
,20160112,90860,90860,,,,90860,90860,0,0,0,0.00,0
,20160113,90860,90860,,,,90860,90860,0,0,0,0.00,0
,20160114,90860,90860,,,,90860,90860,0,0,0,0.00,0
,20160115,90860,90860,,,,90860,90860,0,0,0,0.00,0
,20160118,90860,90860,,,,94090,94090,3230,3230,0,0.00,0
,20160119,94090,94090,,,,95080,95080,990,990,0,0.00,0
,20160120,95080,95080,,,,95080,95080,0,0,0,0.00,0
,20160121,95080,95080,,,,95080,95080,0,0,0,0.00,0
,20160122,95080,95080,,,,95080,95080,0,0,0,0.00,0
,20160125,95080,95080,,,,95080,95080,0,0,0,0.00,0
,20160126,95080,95080,,,,95080,95080,0,0,0,0.00,0
,20160127,95080,95080,,,,96920,96920,1840,1840,0,0.00,0
,20160128,96920,96920,,,,96920,96920,0,0,0,0.00,0
,20160129,96920,96920,,,,96920,96920,0,0,0,0.00,0
,20160201,96920,96920,,,,96920,96920,0,0,0,0.00,0
,20160202,96920,96920,,,,96170,96170,-750,-750,0,0.00,0
,20160203,96170,96170,,,,96180,96180,10,10,0,0.00,0
,20160204,96180,96180,,,,96810,96810,630,630,0,0.00,0
,20160205,96810,96810,,,,97310,97310,500,500,0,0.00,0
,20160215,97310,97310,,,,97230,97230,-80,-80,0,0.00,0
,20160216,97230,97230,97530,102680,97530,100290,99720,3060,2490,10,99.72,2
,20160217,100290,99720,,,,99260,99260,-460,-460,0,0.00,2
,20160218,99260,99260,,,,99270,99270,10,10,0,0.00,2
,20160219,99270,99270,,,,99280,99280,10,10,0,0.00,2
,20160222,99280,99280,,,,101310,101310,2030,2030,0,0.00,2
,20160223,101310,101310,,,,101310,101310,0,0,0,0.00,2
,20160224,101310,101310,,,,102180,102180,870,870,0,0.00,2
,20160225,102180,102180,102210,106260,102210,106260,104230,4080,2050,4,41.69,4
,20160226,106260,104230,,,,105010,105010,780,780,0,0.00,4
,20160229,105010,105010,,,,105010,105010,0,0,0,0.00,4
,20160301,105010,105010,107390,107390,102010,103710,104170,-1300,-840,12,125.01,2
,20160302,103710,104170,,,,105050,105050,880,880,0,0.00,2
,20160303,105050,105050,,,,105050,105050,0,0,0,0.00,2
,20160304,105050,105050,,,,109250,109250,4200,4200,0,0.00,2
,20160307,109250,109250,,,,110510,110510,1260,1260,0,0.00,2
,20160308,110510,110510,,,,110860,110860,350,350,0,0.00,2
,20160309,110860,110860,,,,110600,110600,-260,-260,0,0.00,2
,20160310,110600,110600,,,,110600,110600,0,0,0,0.00,2
,20160311,110600,110600,,,,107600,107600,-3000,-3000,0,0.00,2
,20160314,107600,107600,,,,108690,108690,1090,1090,0,0.00,2
,20160315,108690,108690,,,,107640,107640,-1050,-1050,0,0.00,2
,20160316,107640,107640,107980,107980,107980,107980,107980,340,340,2,21.60,0
,20160317,107980,107980,,,,109000,109000,1020,1020,0,0.00,0
,20160318,109000,109000,,,,112350,112350,3350,3350,0,0.00,0
,20160321,112350,112350,,,,110460,110460,-1890,-1890,0,0.00,0
,20160322,110460,110460,,,,109830,109830,-630,-630,0,0.00,0
,20160323,109830,109830,,,,110040,110040,210,210,0,0.00,0
,20160324,110040,110040,113120,113120,110010,110010,111380,-30,1340,68,757.44,0
,20160325,110010,111380,,,,111380,111380,0,0,0,0.00,0
,20160328,111380,111380,,,,111380,111380,0,0,0,0.00,0
,20160329,111380,111380,,,,109150,109150,-2230,-2230,0,0.00,0
,20160330,109150,109150,,,,105180,105180,-3970,-3970,0,0.00,0
,20160331,105180,105180,,,,103150,103150,-2030,-2030,0,0.00,0
,20160401,103150,103150,,,,103150,103150,0,0,0,0.00,0
,20160405,103150,103150,,,,103850,103850,700,700,0,0.00,0
,20160406,103850,103850,,,,104760,104760,910,910,0,0.00,0
,20160407,104760,104760,,,,105590,105590,830,830,0,0.00,0
,20160408,105590,105590,,,,104910,104910,-680,-680,0,0.00,0
,20160411,104910,104910,,,,107180,107180,2270,2270,0,0.00,0
,20160412,107180,107180,,,,107170,107170,-10,-10,0,0.00,0
,20160413,107170,107170,,,,108980,108980,1810,1810,0,0.00,0
,20160414,108980,108980,,,,110850,110850,1870,1870,0,0.00,0
,20160415,110850,110850,,,,110340,110340,-510,-510,0,0.00,0
,20160418,110340,110340,,,,109320,109320,-1020,-1020,0,0.00,0
,20160419,109320,109320,,,,109560,109560,240,240,0,0.00,0
,20160420,109560,109560,,,,110130,110130,570,570,0,0.00,0
,20160421,110130,110130,,,,111190,111190,1060,1060,0,0.00,0
,20160422,111190,111190,,,,111800,111800,610,610,0,0.00,0
,20160425,111800,111800,,,,111330,111330,-470,-470,0,0.00,0
,20160426,111330,111330,,,,112050,112050,720,720,0,0.00,0
,20160427,112050,112050,112190,112210,111010,111010,111610,-1040,-440,12,133.93,0
,20160428,111010,111610,,,,109950,109950,-1660,-1660,0,0.00,0
,20160429,109950,109950,,,,111490,111490,1540,1540,0,0.00,0
,20160503,111490,111490,,,,112410,112410,920,920,0,0.00,0
,20160504,112410,112410,,,,113600,113600,1190,1190,0,0.00,0
,20160505,113600,113600,,,,114520,114520,920,920,0,0.00,0
,20160506,114520,114520,,,,113480,113480,-1040,-1040,0,0.00,0
,20160509,113480,113480,,,,112900,112900,-580,-580,0,0.00,0
,20160510,112900,112900,,,,110050,110050,-2850,-2850,0,0.00,0
,20160511,110050,110050,,,,110210,110210,160,160,0,0.00,0
,20160512,110210,110210,,,,111800,111800,1590,1590,0,0.00,0
,20160513,111800,111800,,,,109600,109600,-2200,-2200,0,0.00,0
,20160516,109600,109600,,,,109100,109100,-500,-500,0,0.00,0
,20160517,109100,109100,,,,109360,109360,260,260,0,0.00,0
,20160518,109360,109360,,,,108990,108990,-370,-370,0,0.00,0
,20160519,108990,108990,,,,107910,107910,-1080,-1080,0,0.00,0
,20160520,107910,107910,,,,107810,107810,-100,-100,0,0.00,0
,20160523,107810,107810,,,,106000,106000,-1810,-1810,0,0.00,0
,20160524,106000,106000,,,,104980,104980,-1020,-1020,0,0.00,0
,20160525,104980,104980,,,,104810,104810,-170,-170,0,0.00,0
,20160526,104810,104810,,,,105270,105270,460,460,0,0.00,0
,20160527,105270,105270,108520,109660,105500,109660,108420,4390,3150,38,412.02,20
,20160530,109660,108420,,,,109500,109500,1080,1080,0,0.00,20
,20160531,109500,109500,,,,109930,109930,430,430,0,0.00,20
,20160601,109930,109930,,,,108910,108910,-1020,-1020,0,0.00,20
,20160602,108910,108910,108000,108000,108000,108000,108000,-910,-910,18,194.40,20
,20160603,108000,108000,,,,108250,108250,250,250,0,0.00,20
,20160606,108250,108250,108660,108660,108660,108660,108660,410,410,2,21.73,22
,20160607,108660,108660,,,,109040,109040,380,380,0,0.00,22
,20160608,109040,109040,109060,109840,109060,109840,109190,800,150,24,262.06,20
,20160613,109840,109190,,,,111090,111090,1900,1900,0,0.00,20
,20160614,111090,111090,,,,111090,111090,0,0,0,0.00,20
,20160615,111090,111090,,,,111270,111270,180,180,0,0.00,20
,20160616,111270,111270,,,,111270,111270,0,0,0,0.00,20
,20160617,111270,111270,113480,113480,113380,113380,113470,2110,2200,20,226.94,18
,20160620,113380,113470,111600,111600,111600,111600,111600,-1870,-1870,14,156.24,4
,20160621,111600,111600,,,,110800,110800,-800,-800,0,0.00,4
,20160622,110800,110800,,,,110510,110510,-290,-290,0,0.00,4
,20160623,110510,110510,,,,110510,110510,0,0,0,0.00,4
,20160624,110510,110510,,,,110510,110510,0,0,0,0.00,4
,20160627,110510,110510,,,,111010,111010,500,500,0,0.00,4
,20160628,111010,111010,,,,111010,111010,0,0,0,0.00,4
,20160629,111010,111010,,,,110990,110990,-20,-20,0,0.00,4
,20160630,110990,110990,,,,111020,111020,30,30,0,0.00,4
,20160701,111020,111020,,,,112080,112080,1060,1060,0,0.00,4
,20160704,112080,112080,,,,116480,116480,4400,4400,0,0.00,4
,20160705,116480,116480,118390,118390,118390,118390,118390,1910,1910,2,23.68,2
,20160706,118390,118390,,,,118560,118560,170,170,0,0.00,2
,20160707,118560,118560,,,,118650,118650,90,90,0,0.00,2
,20160708,118650,118650,,,,116190,116190,-2460,-2460,0,0.00,2
,20160711,116190,116190,,,,117170,117170,980,980,0,0.00,2
,20160712,117170,117170,,,,119070,119070,1900,1900,0,0.00,2
,20160713,119070,119070,,,,119980,119980,910,910,0,0.00,2
,20160714,119980,119980,,,,116910,116910,-3070,-3070,0,0.00,2
,20160715,116910,116910,,,,117500,117500,590,590,0,0.00,2
,20160718,117500,117500,,,,117170,117170,-330,-330,0,0.00,2
,20160719,117170,117170,,,,116160,116160,-1010,-1010,0,0.00,2
,20160720,116160,116160,,,,116370,116370,210,210,0,0.00,2
,20160721,116370,116370,,,,116800,116800,430,430,0,0.00,2
,20160722,116800,116800,,,,117330,117330,530,530,0,0.00,2
,20160725,117330,117330,,,,116180,116180,-1150,-1150,0,0.00,2
,20160726,116180,116180,,,,116460,116460,280,280,0,0.00,2
,20160727,116460,116460,,,,120860,120860,4400,4400,0,0.00,2
,20160728,120860,120860,,,,121660,121660,800,800,0,0.00,2
,20160729,121660,121660,,,,121170,121170,-490,-490,0,0.00,2
,20160801,121170,121170,,,,120160,120160,-1010,-1010,0,0.00,2
,20160802,120160,120160,,,,120570,120570,410,410,0,0.00,2
,20160803,120570,120570,,,,120590,120590,20,20,0,0.00,2
,20160804,120590,120590,,,,120500,120500,-90,-90,0,0.00,2
,20160805,120500,120500,,,,118630,118630,-1870,-1870,0,0.00,2
,20160808,118630,118630,,,,120010,120010,1380,1380,0,0.00,2
,20160809,120010,120010,,,,120860,120860,850,850,0,0.00,2
,20160810,120860,120860,,,,123000,123000,2140,2140,0,0.00,2
,20160811,123000,123000,,,,123540,123540,540,540,0,0.00,2
,20160812,123540,123540,,,,122650,122650,-890,-890,0,0.00,2
,20160815,122650,122650,,,,120860,120860,-1790,-1790,0,0.00,2
,20160816,120860,120860,,,,123090,123090,2230,2230,0,0.00,2
,20160817,123090,123090,,,,124160,124160,1070,1070,0,0.00,2
,20160818,124160,124160,,,,122780,122780,-1380,-1380,0,0.00,2
,20160819,122780,122780,122000,122000,122000,122000,122000,-780,-780,2,24.40,2
,20160822,122000,122000,,,,122160,122160,160,160,0,0.00,2
,20160823,122160,122160,,,,121600,121600,-560,-560,0,0.00,2
,20160824,121600,121600,,,,122830,122830,1230,1230,0,0.00,2
,20160825,122830,122830,,,,118670,118670,-4160,-4160,0,0.00,2
,20160826,118670,118670,,,,118700,118700,30,30,0,0.00,2
,20160829,118700,118700,,,,118980,118980,280,280,0,0.00,2
,20160830,118980,118980,,,,118980,118980,0,0,0,0.00,2
,20160831,118980,118980,,,,118490,118490,-490,-490,0,0.00,2
,20160901,118490,118490,,,,119340,119340,850,850,0,0.00,2
,20160902,119340,119340,,,,121230,121230,1890,1890,0,0.00,2
,20160905,121230,121230,,,,122760,122760,1530,1530,0,0.00,2
,20160906,122760,122760,,,,121860,121860,-900,-900,0,0.00,2
,20160907,121860,121860,,,,122080,122080,220,220,0,0.00,2
,20160908,122080,122080,,,,122260,122260,180,180,0,0.00,2
,20160909,122260,122260,,,,122610,122610,350,350,0,0.00,2
,20160912,122610,122610,,,,120050,120050,-2560,-2560,0,0.00,2
,20160913,120050,120050,,,,118900,118900,-1150,-1150,0,0.00,2
,20160914,118900,118900,,,,118360,118360,-540,-540,0,0.00,2
,20160919,118360,118360,,,,119780,119780,1420,1420,0,0.00,2
,20160920,119780,119780,,,,116520,116520,-3260,-3260,0,0.00,2
,20160921,116520,116520,,,,116520,116520,0,0,0,0.00,2
,20160922,116520,116520,,,,116520,116520,0,0,0,0.00,2
,20160923,116520,116520,,,,116520,116520,0,0,0,0.00,2
,20160926,116520,116520,,,,122340,122340,5820,5820,0,0.00,2
,20160927,122340,122340,,,,124610,124610,2270,2270,0,0.00,2
,20160928,124610,124610,,,,126380,126380,1770,1770,0,0.00,2
,20160929,126380,126380,,,,126380,126380,0,0,0,0.00,2
,20160930,126380,126380,,,,126380,126380,0,0,0,0.00,2
,20161010,126380,126380,,,,126380,126380,0,0,0,0.00,2
,20161011,126380,126380,,,,126380,126380,0,0,0,0.00,2
,20161012,126380,126380,,,,127360,127360,980,980,0,0.00,2
,20161013,127360,127360,,,,127360,127360,0,0,0,0.00,2
,20161014,127360,127360,127500,127500,127500,127500,127500,140,140,2,25.50,0
,20161017,127500,127500,,,,127500,127500,0,0,0,0.00,0
,20161018,127500,127500,,,,127500,127500,0,0,0,0.00,0
,20161019,127500,127500,,,,127500,127500,0,0,0,0.00,0
,20161020,127500,127500,,,,127500,127500,0,0,0,0.00,0
,20161021,127500,127500,132590,133870,127560,133870,132470,6370,4970,48,635.89,32
,20161024,133870,132470,132000,132990,129000,132160,131120,-310,-1350,22,288.48,20
,20161025,132160,131120,130110,133270,130110,133270,132860,2150,1740,22,292.30,0
,20161026,133270,132860,,,,132860,132860,0,0,0,0.00,0
,20161027,132860,132860,,,,132860,132860,0,0,0,0.00,0
,20161028,132860,132860,,,,132860,132860,0,0,0,0.00,0
,20161031,132860,132860,,,,132860,132860,0,0,0,0.00,0
,20161101,132860,132860,,,,132860,132860,0,0,0,0.00,0
,20161102,132860,132860,,,,132860,132860,0,0,0,0.00,0
,20161103,132860,132860,,,,132860,132860,0,0,0,0.00,0
,20161104,132860,132860,,,,132860,132860,0,0,0,0.00,0
,20161107,132860,132860,,,,139500,139500,6640,6640,0,0.00,0
,20161108,139500,139500,,,,146470,146470,6970,6970,0,0.00,0
,20161109,146470,146470,,,,146470,146470,0,0,0,0.00,0
,20161110,146470,146470,,,,146470,146470,0,0,0,0.00,0
,20161111,146470,146470,,,,146470,146470,0,0,0,0.00,0
,20161114,146470,146470,,,,146470,146470,0,0,0,0.00,0
,20161115,146470,146470,,,,146470,146470,0,0,0,0.00,0
,20161116,146470,146470,,,,146470,146470,0,0,0,0.00,0
,20161117,146470,146470,,,,146470,146470,0,0,0,0.00,0
,20161118,146470,146470,,,,146470,146470,0,0,0,0.00,0
,20161121,146470,146470,,,,146470,146470,0,0,0,0.00,0
,20161122,146470,146470,155250,155250,142060,142060,148650,-4410,2180,4,59.46,0
,20161123,142060,148650,,,,148650,148650,0,0,0,0.00,0
,20161124,148650,148650,,,,148650,148650,0,0,0,0.00,0
,20161125,148650,148650,,,,148650,148650,0,0,0,0.00,0
,20161128,148650,148650,,,,148650,148650,0,0,0,0.00,0
,20161129,148650,148650,,,,148650,148650,0,0,0,0.00,0
,20161130,148650,148650,,,,148650,148650,0,0,0,0.00,0
,20161201,148650,148650,,,,148650,148650,0,0,0,0.00,0
,20161202,148650,148650,,,,148650,148650,0,0,0,0.00,0
,20161205,148650,148650,,,,148650,148650,0,0,0,0.00,0
,20161206,148650,148650,,,,148650,148650,0,0,0,0.00,0
,20161207,148650,148650,,,,148650,148650,0,0,0,0.00,0
,20161208,148650,148650,,,,148650,148650,0,0,0,0.00,0
,20161209,148650,148650,,,,148650,148650,0,0,0,0.00,0
,20161212,148650,148650,,,,148650,148650,0,0,0,0.00,0
,20161213,148650,148650,,,,148650,148650,0,0,0,0.00,0
,20161214,148650,148650,,,,148650,148650,0,0,0,0.00,0
,20161215,148650,148650,,,,148650,148650,0,0,0,0.00,0
sn1701,20160118,90860,90860,,,,94090,94090,3230,3230,0,0.00,0
,20160119,94090,94090,,,,95080,95080,990,990,0,0.00,0
,20160120,95080,95080,,,,95080,95080,0,0,0,0.00,0
,20160121,95080,95080,,,,95080,95080,0,0,0,0.00,0
,20160122,95080,95080,,,,95080,95080,0,0,0,0.00,0
,20160125,95080,95080,,,,95080,95080,0,0,0,0.00,0
,20160126,95080,95080,,,,95080,95080,0,0,0,0.00,0
,20160127,95080,95080,,,,98160,98160,3080,3080,0,0.00,0
,20160128,98160,98160,,,,98160,98160,0,0,0,0.00,0
,20160129,98160,98160,,,,98160,98160,0,0,0,0.00,0
,20160201,98160,98160,,,,98160,98160,0,0,0,0.00,0
,20160202,98160,98160,,,,98160,98160,0,0,0,0.00,0
,20160203,98160,98160,,,,98160,98160,0,0,0,0.00,0
,20160204,98160,98160,,,,98810,98810,650,650,0,0.00,0
,20160205,98810,98810,,,,99320,99320,510,510,0,0.00,0
,20160215,99320,99320,,,,99240,99240,-80,-80,0,0.00,0
,20160216,99240,99240,,,,99240,99240,0,0,0,0.00,0
,20160217,99240,99240,,,,99240,99240,0,0,0,0.00,0
,20160218,99240,99240,,,,99240,99240,0,0,0,0.00,0
,20160219,99240,99240,,,,99240,99240,0,0,0,0.00,0
,20160222,99240,99240,,,,99240,99240,0,0,0,0.00,0
,20160223,99240,99240,,,,99240,99240,0,0,0,0.00,0
,20160224,99240,99240,,,,101770,101770,2530,2530,0,0.00,0
,20160225,101770,101770,,,,103810,103810,2040,2040,0,0.00,0
,20160226,103810,103810,,,,103810,103810,0,0,0,0.00,0
,20160229,103810,103810,,,,103810,103810,0,0,0,0.00,0
,20160301,103810,103810,,,,103810,103810,0,0,0,0.00,0
,20160302,103810,103810,,,,103810,103810,0,0,0,0.00,0
,20160303,103810,103810,,,,106740,106740,2930,2930,0,0.00,0
,20160304,106740,106740,,,,111190,111190,4450,4450,0,0.00,0
,20160307,111190,111190,,,,111190,111190,0,0,0,0.00,0
,20160308,111190,111190,,,,113150,113150,1960,1960,0,0.00,0
,20160309,113150,113150,117190,117190,104500,104500,112960,-8650,-190,6,67.78,6
,20160310,104500,112960,,,,112490,112490,-470,-470,0,0.00,6
,20160311,112490,112490,,,,112490,112490,0,0,0,0.00,6
,20160314,112490,112490,,,,112490,112490,0,0,0,0.00,6
,20160315,112490,112490,,,,111400,111400,-1090,-1090,0,0.00,6
,20160316,111400,111400,111710,111710,109600,109600,110610,-1800,-790,6,66.37,6
,20160317,109600,110610,112190,112190,111000,111000,111590,390,980,4,44.64,6
,20160318,111000,111590,,,,112310,112310,720,720,0,0.00,6
,20160321,112310,112310,114990,114990,110000,110000,112490,-2310,180,4,45.00,8
,20160322,110000,112490,111980,112000,111980,112000,111990,-490,-500,4,44.80,12
,20160323,112000,111990,111990,111990,111990,111990,111990,0,0,2,22.40,14
,20160324,111990,111990,,,,111990,111990,0,0,0,0.00,14
,20160325,111990,111990,111510,113160,111510,112500,112390,510,400,6,67.43,14
,20160328,112500,112390,111360,111360,111350,111350,111350,-1040,-1040,4,44.54,14
,20160329,111350,111350,,,,111350,111350,0,0,0,0.00,14
,20160330,111350,111350,111390,111390,106890,106960,107730,-4390,-3620,20,215.47,12
,20160331,106960,107730,107310,107310,107310,107310,107310,-420,-420,2,21.46,12
,20160401,107310,107310,,,,107310,107310,0,0,0,0.00,12
,20160405,107310,107310,,,,108030,108030,720,720,0,0.00,12
,20160406,108030,108030,107090,107090,107090,107090,107090,-940,-940,2,21.42,12
,20160407,107090,107090,,,,107940,107940,850,850,0,0.00,12
,20160408,107940,107940,106660,106660,106660,106660,106660,-1280,-1280,2,21.33,12
,20160411,106660,106660,109730,109730,109730,109730,109730,3070,3070,2,21.95,14
,20160412,109730,109730,,,,109720,109720,-10,-10,0,0.00,14
,20160413,109720,109720,,,,111580,111580,1860,1860,0,0.00,14
,20160414,111580,111580,,,,111580,111580,0,0,0,0.00,14
,20160415,111580,111580,,,,111070,111070,-510,-510,0,0.00,14
,20160418,111070,111070,,,,110050,110050,-1020,-1020,0,0.00,14
,20160419,110050,110050,,,,110050,110050,0,0,0,0.00,14
,20160420,110050,110050,,,,111400,111400,1350,1350,0,0.00,14
,20160421,111400,111400,,,,112470,112470,1070,1070,0,0.00,14
,20160422,112470,112470,,,,113090,113090,620,620,0,0.00,14
,20160425,113090,113090,,,,112620,112620,-470,-470,0,0.00,14
,20160426,112620,112620,110210,110210,110210,110210,110210,-2410,-2410,2,22.04,12
,20160427,110210,110210,,,,109770,109770,-440,-440,0,0.00,12
,20160428,109770,109770,109710,110580,109710,110580,110210,810,440,8,88.17,16
,20160429,110580,110210,110580,110580,110580,110580,110580,370,370,2,22.12,14
,20160503,110580,110580,,,,110580,110580,0,0,0,0.00,14
,20160504,110580,110580,,,,110580,110580,0,0,0,0.00,14
,20160505,110580,110580,,,,112500,112500,1920,1920,0,0.00,14
,20160506,112500,112500,,,,111480,111480,-1020,-1020,0,0.00,14
,20160509,111480,111480,,,,110910,110910,-570,-570,0,0.00,14
,20160510,110910,110910,,,,108110,108110,-2800,-2800,0,0.00,14
,20160511,108110,108110,,,,108110,108110,0,0,0,0.00,14
,20160512,108110,108110,,,,108110,108110,0,0,0,0.00,14
,20160513,108110,108110,108910,108910,108020,108020,108460,-90,350,4,43.39,16
,20160516,108020,108460,,,,107960,107960,-500,-500,0,0.00,16
,20160517,107960,107960,,,,108220,108220,260,260,0,0.00,16
,20160518,108220,108220,,,,107860,107860,-360,-360,0,0.00,16
,20160519,107860,107860,,,,106790,106790,-1070,-1070,0,0.00,16
,20160520,106790,106790,107100,109740,107100,109740,108420,2950,1630,4,43.37,18
,20160523,109740,108420,107140,107450,105730,105730,106900,-2690,-1520,16,171.05,22
,20160524,105730,106900,107510,107510,107510,107510,107510,610,610,2,21.50,22
,20160525,107510,107510,105700,105700,105700,105700,105700,-1810,-1810,2,21.14,22
,20160526,105700,105700,,,,105700,105700,0,0,0,0.00,22
,20160527,105700,105700,,,,105700,105700,0,0,0,0.00,22
,20160530,105700,105700,,,,106750,106750,1050,1050,0,0.00,22
,20160531,106750,106750,,,,107170,107170,420,420,0,0.00,22
,20160601,107170,107170,111340,111340,108900,108900,109710,1730,2540,6,65.83,20
,20160602,108900,109710,107560,107560,107560,107560,107560,-2150,-2150,2,21.51,20
,20160603,107560,107560,,,,107560,107560,0,0,0,0.00,20
,20160606,107560,107560,,,,107560,107560,0,0,0,0.00,20
,20160607,107560,107560,,,,107930,107930,370,370,0,0.00,20
,20160608,107930,107930,108670,111110,108670,110150,109720,2220,1790,18,197.51,22
,20160613,110150,109720,,,,111750,111750,2030,2030,0,0.00,22
,20160614,111750,111750,112670,112670,112670,112670,112670,920,920,2,22.53,22
,20160615,112670,112670,,,,112670,112670,0,0,0,0.00,22
,20160616,112670,112670,113140,113140,113140,113140,113140,470,470,2,22.63,22
,20160617,113140,113140,113520,113520,110420,110420,111970,-2720,-1170,4,44.79,22
,20160620,110420,111970,,,,110120,110120,-1850,-1850,0,0.00,22
,20160621,110120,110120,113160,113160,113160,113160,113160,3040,3040,4,45.26,22
,20160622,113160,113160,,,,113160,113160,0,0,0,0.00,22
,20160623,113160,113160,,,,113240,113240,80,80,0,0.00,22
,20160624,113240,113240,,,,113600,113600,360,360,0,0.00,22
,20160627,113600,113600,111640,115340,111640,115340,113630,1740,30,6,68.18,24
,20160628,115340,113630,113190,113190,113190,113190,113190,-440,-440,2,22.64,22
,20160629,113190,113190,113310,113310,113310,113310,113310,120,120,2,22.66,24
,20160630,113310,113310,,,,113340,113340,30,30,0,0.00,24
,20160701,113340,113340,118340,118990,118340,118680,118710,5340,5370,16,189.94,34
,20160704,118680,118710,121070,123770,113790,122420,121150,3710,2440,148,"1,793.09",58
,20160705,122420,121150,124860,125030,119460,120850,122460,-300,1310,42,514.34,56
,20160706,120850,122460,122430,122430,116330,118340,118200,-4120,-4260,68,803.82,68
,20160707,118340,118200,119010,120990,117540,117680,119000,-520,800,54,642.64,96
,20160708,117680,119000,118210,119180,115930,116550,117040,-2450,-1960,92,"1,076.80",82
,20160711,116550,117040,117650,120890,115640,119360,118900,2320,1860,76,903.65,96
,20160712,119360,118900,119370,122520,119030,121570,120600,2670,1700,42,506.55,112
,20160713,121570,120600,121610,123170,120120,120420,121060,-180,460,88,"1,065.36",120
,20160714,120420,121060,120080,120080,119010,119480,119370,-1580,-1690,84,"1,002.72",138
,20160715,119480,119370,119890,121010,119420,120250,119940,880,570,88,"1,055.55",174
,20160718,120250,119940,121710,121740,118600,119200,119960,-740,20,80,959.74,168
,20160719,119200,119960,119060,119560,118350,118350,118870,-1610,-1090,26,309.07,174
,20160720,118350,118870,119300,119970,116360,119160,118740,290,-130,176,"2,089.85",220
,20160721,119160,118740,118460,120520,118460,120520,119530,1780,790,166,"1,984.31",212
,20160722,120520,119530,120850,121310,119350,120090,120210,560,680,76,913.66,228
,20160725,120090,120210,119850,119850,118420,118420,118930,-1790,-1280,44,523.33,218
,20160726,118420,118930,119710,119710,119300,119700,119520,770,590,10,119.52,218
,20160727,119700,119520,119860,122790,118550,121590,120930,2070,1410,170,"2,055.88",296
,20160728,121590,120930,121920,122580,121260,122450,121860,1520,930,208,"2,534.88",338
,20160729,122450,121860,122470,122470,120300,121180,121320,-680,-540,296,"3,591.23",316
,20160801,121180,121320,121420,121560,120000,121120,120830,-200,-490,190,"2,295.89",354
,20160802,121120,120830,121200,122210,120410,121900,121350,1070,520,164,"1,990.18",392
,20160803,121900,121350,121900,122140,120010,121280,121500,-70,150,190,"2,308.52",456
,20160804,121280,121500,120600,121300,119140,119700,120220,-1800,-1280,296,"3,558.73",538
,20160805,119700,120220,119070,121760,119070,121270,120970,1050,750,344,"4,161.46",548
,20160808,121270,120970,121720,123490,120920,123350,122180,2380,1210,768,"9,383.88",758
,20160809,123350,122180,122700,123480,122010,123320,122780,1140,600,536,"6,581.53",882
,20160810,123320,122780,123210,126000,123080,125700,124760,2920,1980,1108,"13,823.60",1308
,20160811,125700,124760,125930,126490,124210,124500,125490,-260,730,1680,"21,082.52",1662
,20160812,124500,125490,123890,125640,123590,125040,124850,-450,-640,1854,"23,147.75",2234
,20160815,125040,124850,124400,124630,122940,123210,123550,-1640,-1300,1408,"17,397.06",2284
,20160816,123210,123550,123950,124600,122740,124370,124220,820,670,1224,"15,204.72",2534
,20160817,124370,124220,124110,124690,123170,123500,124080,-720,-140,866,"10,745.98",2634
,20160818,123500,124080,123760,123970,122100,122570,122870,-1510,-1210,2432,"29,882.89",2740
,20160819,122570,122870,123000,123890,122520,123080,123140,210,270,1278,"15,738.48",2820
,20160822,123080,123140,122960,124500,122680,123160,123620,20,480,2994,"37,014.67",3632
,20160823,123160,123620,123730,123730,117660,122660,122790,-960,-830,2234,"27,432.18",3936
,20160824,122660,122790,123480,125610,123340,125410,124630,2620,1840,6088,"75,875.37",5750
,20160825,125410,124630,126000,126000,120560,123900,124070,-730,-560,9432,"117,025.11",5356
,20160826,123900,124070,124300,124590,123180,124200,124090,130,20,4728,"58,674.04",5742
,20160829,124200,124090,124550,125600,124140,125200,124870,1110,780,8246,"102,971.10",6536
,20160830,125200,124870,124980,125200,124360,124750,124740,-120,-130,7232,"90,218.82",7346
,20160831,124750,124740,124510,124780,123210,123750,124050,-990,-690,8324,"103,261.33",7902
,20160901,123750,124050,124070,125720,124020,125220,125110,1170,1060,13978,"174,889.31",10066
,20160902,125220,125110,125600,128400,125120,128200,126910,3090,1800,28432,"360,832.95",13398
,20160905,128200,126910,128010,129210,127910,128200,128440,1290,1530,17292,"222,099.83",14058
,20160906,128200,128440,128780,128820,126380,127520,127320,-920,-1120,16490,"209,954.41",13610
,20160907,127520,127320,127900,128060,126650,128050,127350,730,30,15564,"198,212.08",14830
,20160908,128050,127350,128280,128490,126470,127280,127470,-70,120,14396,"183,516.20",14458
,20160909,127280,127470,127530,127930,127000,127110,127390,-360,-80,10798,"137,557.98",13920
,20160912,127110,127390,126950,127100,122010,122470,124520,-4920,-2870,31128,"387,619.44",11380
,20160913,122470,124520,122800,123600,122240,122690,122950,-1830,-1570,16680,"205,084.52",11082
,20160914,122690,122950,123020,123540,121800,122750,122480,-200,-470,16640,"203,818.63",11440
,20160919,122750,122480,122550,125880,122550,123780,123980,1300,1500,11860,"147,051.20",10378
,20160920,123780,123980,124680,124960,124120,124530,124500,550,520,8984,"111,852.38",10814
,20160921,124530,124500,124640,125800,123840,124380,124490,-120,-10,14508,"180,611.82",11156
,20160922,124380,124490,123670,126780,123300,126220,125310,1730,820,19236,"241,052.82",10726
,20160923,126220,125310,126690,127500,125960,127060,126670,1750,1360,15974,"202,355.44",11940
,20160926,127060,126670,127300,128240,126300,127010,127220,340,550,15118,"192,337.91",11574
,20160927,127010,127220,127500,127980,125350,127330,126610,110,-610,15858,"200,783.73",10936
,20160928,127330,126610,127330,127740,126230,127500,126940,890,330,12554,"159,367.04",11712
,20160929,127500,126940,127680,129920,127350,128160,128530,1220,1590,23066,"296,487.40",12616
,20160930,128160,128530,127910,129170,127670,128700,128500,170,-30,11260,"144,700.05",12182
,20161010,128700,128500,128740,129740,126670,129370,128180,870,-320,12158,"155,846.45",12742
,20161011,129370,128180,128890,130200,128810,129890,129510,1710,1330,13380,"173,284.49",14622
,20161012,129890,129510,129500,129510,127750,129000,128640,-510,-870,15776,"202,952.46",13804
,20161013,129000,128640,129200,129580,127800,128100,128640,-540,0,11774,"151,466.47",14010
,20161014,128100,128640,127830,128400,126800,126900,127510,-1740,-1130,15718,"200,429.15",12778
,20161017,126900,127510,126980,128680,126910,128210,127870,700,360,13464,"172,177.62",12130
,20161018,128210,127870,128110,129370,127190,128740,128330,870,460,14032,"180,073.59",13378
,20161019,128740,128330,129160,129560,128500,128760,129000,430,670,12270,"158,286.45",13358
,20161020,128760,129000,129100,129930,128560,129570,129390,570,390,15344,"198,537.36",14540
,20161021,129570,129390,129160,132100,129120,131980,131010,2590,1620,37166,"486,927.62",20338
,20161024,131980,131010,131970,132480,131200,132350,131790,1340,780,18560,"244,618.08",20172
,20161025,132350,131790,132890,134640,132350,134190,133720,2400,1930,24972,"333,931.06",20534
,20161026,134190,133720,134190,135900,132640,133350,134120,-370,400,21938,"294,242.90",19196
,20161027,133350,134120,133960,134490,132270,133100,133560,-1020,-560,15958,"213,139.39",19130
,20161028,133100,133560,133390,135880,132750,135670,134360,2110,800,19928,"267,771.85",20470
,20161031,135670,134360,135490,136320,134100,135360,134840,1000,480,17586,"237,140.91",19038
,20161101,135360,134840,135990,138140,134550,137600,136210,2760,1370,27244,"371,103.25",19692
,20161102,137600,136210,137540,137980,135450,135680,136950,-530,740,20424,"279,718.11",18352
,20161103,135680,136950,135820,138130,135500,137970,136680,1020,-270,13188,"180,254.53",18790
,20161104,137970,136680,138300,143410,138240,142710,140390,6030,3710,42886,"602,100.25",21298
,20161107,142710,140390,141990,147400,140910,147400,144300,7010,3910,36322,"524,139.84",21304
,20161108,147400,144300,146900,154970,146680,150240,150520,5940,6220,61552,"926,492.24",19942
,20161109,150240,150520,150630,154180,146500,149890,150770,-630,250,59814,"901,831.78",20036
,20161110,149890,150770,150780,155520,149150,153700,153020,2930,2250,75396,"1,153,741.13",21372
,20161111,153700,153020,153800,154400,150250,152980,152160,-40,-860,41616,"633,252.78",20550
,20161114,152980,152160,152850,157310,143030,146410,148790,-5750,-3370,72138,"1,073,376.49",17042
,20161115,146410,148790,146010,152500,142500,143950,147590,-4840,-1200,48160,"710,829.71",16380
,20161116,143950,147590,143680,146110,142660,145030,144680,-2560,-2910,25136,"363,673.92",16684
,20161117,145030,144680,144230,144960,141140,141520,142500,-3160,-2180,24414,"347,921.34",16284
,20161118,141520,142500,142490,144650,139070,140380,142120,-2120,-380,28830,"409,738.66",16468
,20161121,140380,142120,141500,145070,138500,143390,141830,1270,-290,31542,"447,362.71",15630
,20161122,143390,141830,144000,149210,143180,147450,146290,5620,4460,30884,"451,813.28",15794
,20161123,147450,146290,147820,148380,145450,146970,147050,680,760,21410,"314,855.30",15662
,20161124,146970,147050,146900,151000,146000,146700,148170,-350,1120,43068,"638,174.09",15512
,20161125,146700,148170,147140,148320,143220,145820,146200,-2350,-1970,24014,"351,092.77",15362
,20161128,145820,146200,145160,149050,144210,149050,146880,2850,680,26528,"389,664.60",15336
,20161129,149050,146880,148060,149390,142270,142650,146160,-4230,-720,29468,"430,716.20",14376
,20161130,142650,146160,143520,143740,137350,140110,141170,-6050,-4990,28296,"399,458.19",14584
,20161201,140110,141170,142600,146760,141130,145740,143690,4570,2520,27626,"396,961.05",14244
,20161202,145740,143690,145000,145800,142200,143900,144210,210,520,18074,"260,661.87",13806
,20161205,143900,144210,143900,145690,143190,144160,144380,-50,170,18412,"265,839.64",13418
,20161206,144160,144380,144510,145500,143010,145000,144620,620,240,16538,"239,187.12",13200
,20161207,145000,144620,145060,146600,143660,146060,144850,1440,230,18714,"271,082.09",13958
,20161208,146060,144850,146210,147980,143990,144590,145790,-260,940,19464,"283,783.11",12876
,20161209,144590,145790,145500,146310,142280,144050,144120,-1740,-1670,14892,"214,631.64",13166
,20161212,144050,144120,144050,145550,143000,143280,144140,-840,20,12486,"179,985.38",13576
,20161213,143280,144140,143670,148840,142330,148090,146020,3950,1880,21248,"310,264.38",14058
,20161214,148090,146020,149500,149810,145880,148390,147890,2370,1870,18748,"277,278.05",13482
,20161215,148390,147890,148850,150900,146590,150720,149190,2830,1300,18394,"274,433.31",13914
,20161216,150720,149190,149220,150690,148620,148720,149760,-470,570,11304,"169,293.23",13242
,20161219,148720,149760,148150,149880,144180,144210,147080,-5550,-2680,14578,"214,414.24",10990
,20161220,144210,147080,143950,145150,142510,144150,143660,-2930,-3420,11690,"167,946.85",10672
,20161221,144150,143660,145000,145350,143800,144430,144490,770,830,5616,"81,147.78",10548
,20161222,144430,144490,144490,145170,143150,143150,143890,-1340,-600,8204,"118,050.59",10440
,20161223,143150,143890,143020,145790,142320,143790,144110,-100,220,9856,"142,043.65",10108
,20161226,143790,144110,144140,145110,137400,140520,141550,-3590,-2560,18122,"256,524.77",10248
,20161227,140520,141550,141490,144950,140030,144950,141590,3400,40,7808,"110,561.01",8972
,20161228,144950,141590,144470,146640,144060,146520,145460,4930,3870,7996,"116,315.40",7626
,20161229,146520,145460,145700,148980,144550,146940,146220,1480,760,5976,"87,382.99",6590
,20161230,146940,146220,146710,148200,145060,146080,146480,-140,260,2780,"40,721.47",5640
sn1702,20160216,99240,99240,,,,101780,101780,2540,2540,0,0.00,0
,20160217,101780,101780,,,,101320,101320,-460,-460,0,0.00,0
,20160218,101320,101320,,,,101320,101320,0,0,0,0.00,0
,20160219,101320,101320,,,,101320,101320,0,0,0,0.00,0
,20160222,101320,101320,,,,103390,103390,2070,2070,0,0.00,0
,20160223,103390,103390,,,,106240,106240,2850,2850,0,0.00,0
,20160224,106240,106240,,,,107150,107150,910,910,0,0.00,0
,20160225,107150,107150,,,,109300,109300,2150,2150,0,0.00,0
,20160226,109300,109300,,,,110120,110120,820,820,0,0.00,0
,20160229,110120,110120,,,,110380,110380,260,260,0,0.00,0
,20160301,110380,110380,,,,109500,109500,-880,-880,0,0.00,0
,20160302,109500,109500,,,,110420,110420,920,920,0,0.00,0
,20160303,110420,110420,,,,113580,113580,3160,3160,0,0.00,0
,20160304,113580,113580,,,,116530,116530,2950,2950,0,0.00,0
,20160307,116530,116530,,,,119870,119870,3340,3340,0,0.00,0
,20160308,119870,119870,,,,123040,123040,3170,3170,0,0.00,0
,20160309,123040,123040,,,,122830,122830,-210,-210,0,0.00,0
,20160310,122830,122830,,,,113000,113000,-9830,-9830,0,0.00,0
,20160311,113000,113000,,,,109940,109940,-3060,-3060,0,0.00,0
,20160314,109940,109940,,,,111050,111050,1110,1110,0,0.00,0
,20160315,111050,111050,,,,109980,109980,-1070,-1070,0,0.00,0
,20160316,109980,109980,,,,109200,109200,-780,-780,0,0.00,0
,20160317,109200,109200,,,,110170,110170,970,970,0,0.00,0
,20160318,110170,110170,,,,113560,113560,3390,3390,0,0.00,0
,20160321,113560,113560,,,,113560,113560,0,0,0,0.00,0
,20160322,113560,113560,,,,113050,113050,-510,-510,0,0.00,0
,20160323,113050,113050,,,,113050,113050,0,0,0,0.00,0
,20160324,113050,113050,,,,114430,114430,1380,1380,0,0.00,0
,20160325,114430,114430,,,,114830,114830,400,400,0,0.00,0
,20160328,114830,114830,,,,114830,114830,0,0,0,0.00,0
,20160329,114830,114830,,,,112530,112530,-2300,-2300,0,0.00,0
,20160330,112530,112530,,,,112500,112500,-30,-30,0,0.00,0
,20160331,112500,112500,,,,112500,112500,0,0,0,0.00,0
,20160401,112500,112500,,,,112910,112910,410,410,0,0.00,0
,20160405,112910,112910,,,,113670,113670,760,760,0,0.00,0
,20160406,113670,113670,,,,112680,112680,-990,-990,0,0.00,0
,20160407,112680,112680,,,,113580,113580,900,900,0,0.00,0
,20160408,113580,113580,,,,112230,112230,-1350,-1350,0,0.00,0
,20160411,112230,112230,,,,115460,115460,3230,3230,0,0.00,0
,20160412,115460,115460,,,,115450,115450,-10,-10,0,0.00,0
,20160413,115450,115450,,,,117400,117400,1950,1950,0,0.00,0
,20160414,117400,117400,,,,119410,119410,2010,2010,0,0.00,0
,20160415,119410,119410,,,,118860,118860,-550,-550,0,0.00,0
,20160418,118860,118860,,,,117760,117760,-1100,-1100,0,0.00,0
,20160419,117760,117760,,,,118020,118020,260,260,0,0.00,0
,20160420,118020,118020,,,,118630,118630,610,610,0,0.00,0
,20160421,118630,118630,,,,119770,119770,1140,1140,0,0.00,0
,20160422,119770,119770,,,,120430,120430,660,660,0,0.00,0
,20160425,120430,120430,,,,119930,119930,-500,-500,0,0.00,0
,20160426,119930,119930,,,,119930,119930,0,0,0,0.00,0
,20160427,119930,119930,,,,119450,119450,-480,-480,0,0.00,0
,20160428,119450,119450,,,,119930,119930,480,480,0,0.00,0
,20160429,119930,119930,,,,120330,120330,400,400,0,0.00,0
,20160503,120330,120330,,,,121320,121320,990,990,0,0.00,0
,20160504,121320,121320,,,,122610,122610,1290,1290,0,0.00,0
,20160505,122610,122610,,,,123610,123610,1000,1000,0,0.00,0
,20160506,123610,123610,,,,122490,122490,-1120,-1120,0,0.00,0
,20160509,122490,122490,,,,121870,121870,-620,-620,0,0.00,0
,20160510,121870,121870,,,,118800,118800,-3070,-3070,0,0.00,0
,20160511,118800,118800,,,,118980,118980,180,180,0,0.00,0
,20160512,118980,118980,,,,120690,120690,1710,1710,0,0.00,0
,20160513,120690,120690,,,,121080,121080,390,390,0,0.00,0
,20160516,121080,121080,,,,120530,120530,-550,-550,0,0.00,0
,20160517,120530,120530,,,,120820,120820,290,290,0,0.00,0
,20160518,120820,120820,,,,120420,120420,-400,-400,0,0.00,0
,20160519,120420,120420,,,,119220,119220,-1200,-1200,0,0.00,0
,20160520,119220,119220,,,,121030,121030,1810,1810,0,0.00,0
,20160523,121030,121030,,,,119340,119340,-1690,-1690,0,0.00,0
,20160524,119340,119340,,,,120020,120020,680,680,0,0.00,0
,20160525,120020,120020,,,,117990,117990,-2030,-2030,0,0.00,0
,20160526,117990,117990,,,,118510,118510,520,520,0,0.00,0
,20160527,118510,118510,,,,122060,122060,3550,3550,0,0.00,0
,20160530,122060,122060,,,,123270,123270,1210,1210,0,0.00,0
,20160531,123270,123270,,,,123750,123750,480,480,0,0.00,0
,20160601,123750,123750,,,,126680,126680,2930,2930,0,0.00,0
,20160602,126680,126680,,,,114010,114010,-12670,-12670,0,0.00,0
,20160603,114010,114010,,,,114270,114270,260,260,0,0.00,0
,20160606,114270,114270,,,,114700,114700,430,430,0,0.00,0
,20160607,114700,114700,,,,115100,115100,400,400,0,0.00,0
,20160608,115100,115100,,,,117010,117010,1910,1910,0,0.00,0
,20160613,117010,117010,,,,119180,119180,2170,2170,0,0.00,0
,20160614,119180,119180,,,,120160,120160,980,980,0,0.00,0
,20160615,120160,120160,,,,120160,120160,0,0,0,0.00,0
,20160616,120160,120160,,,,120660,120660,500,500,0,0.00,0
,20160617,120660,120660,,,,119410,119410,-1250,-1250,0,0.00,0
,20160620,119410,119410,,,,117440,117440,-1970,-1970,0,0.00,0
,20160621,117440,117440,,,,120680,120680,3240,3240,0,0.00,0
,20160622,120680,120680,,,,120360,120360,-320,-320,0,0.00,0
,20160623,120360,120360,,,,120450,120450,90,90,0,0.00,0
,20160624,120450,120450,,,,120830,120830,380,380,0,0.00,0
,20160627,120830,120830,,,,120860,120860,30,30,0,0.00,0
,20160628,120860,120860,,,,120390,120390,-470,-470,0,0.00,0
,20160629,120390,120390,,,,120510,120510,120,120,0,0.00,0
,20160630,120510,120510,,,,120540,120540,30,30,0,0.00,0
,20160701,120540,120540,,,,126250,126250,5710,5710,0,0.00,0
,20160704,126250,126250,,,,128850,128850,2600,2600,0,0.00,0
,20160705,128850,128850,,,,130240,130240,1390,1390,0,0.00,0
,20160706,130240,130240,,,,125710,125710,-4530,-4530,0,0.00,0
,20160707,125710,125710,,,,126560,126560,850,850,0,0.00,0
,20160708,126560,126560,,,,124470,124470,-2090,-2090,0,0.00,0
,20160711,124470,124470,,,,126440,126440,1970,1970,0,0.00,0
,20160712,126440,126440,,,,128250,128250,1810,1810,0,0.00,0
,20160713,128250,128250,,,,128740,128740,490,490,0,0.00,0
,20160714,128740,128740,,,,126940,126940,-1800,-1800,0,0.00,0
,20160715,126940,126940,,,,127550,127550,610,610,0,0.00,0
,20160718,127550,127550,,,,127570,127570,20,20,0,0.00,0
,20160719,127570,127570,,,,126410,126410,-1160,-1160,0,0.00,0
,20160720,126410,126410,,,,126270,126270,-140,-140,0,0.00,0
,20160721,126270,126270,,,,127110,127110,840,840,0,0.00,0
,20160722,127110,127110,,,,127840,127840,730,730,0,0.00,0
,20160725,127840,127840,,,,126480,126480,-1360,-1360,0,0.00,0
,20160726,126480,126480,,,,125000,125000,-1480,-1480,0,0.00,0
,20160727,125000,125000,,,,126470,126470,1470,1470,0,0.00,0
,20160728,126470,126470,,,,127450,127450,980,980,0,0.00,0
,20160729,127450,127450,,,,126890,126890,-560,-560,0,0.00,0
,20160801,126890,126890,,,,126380,126380,-510,-510,0,0.00,0
,20160802,126380,126380,,,,126920,126920,540,540,0,0.00,0
,20160803,126920,126920,,,,127070,127070,150,150,0,0.00,0
,20160804,127070,127070,,,,125730,125730,-1340,-1340,0,0.00,0
,20160805,125730,125730,,,,126510,126510,780,780,0,0.00,0
,20160808,126510,126510,,,,127780,127780,1270,1270,0,0.00,0
,20160809,127780,127780,,,,128410,128410,630,630,0,0.00,0
,20160810,128410,128410,,,,130480,130480,2070,2070,0,0.00,0
,20160811,130480,130480,,,,131240,131240,760,760,0,0.00,0
,20160812,131240,131240,,,,130570,130570,-670,-670,0,0.00,0
,20160815,130570,130570,,,,129210,129210,-1360,-1360,0,0.00,0
,20160816,129210,129210,,,,129910,129910,700,700,0,0.00,0
,20160817,129910,129910,,,,129770,129770,-140,-140,0,0.00,0
,20160818,129770,129770,,,,128500,128500,-1270,-1270,0,0.00,0
,20160819,128500,128500,,,,128790,128790,290,290,0,0.00,0
,20160822,128790,128790,,,,129300,129300,510,510,0,0.00,0
,20160823,129300,129300,,,,128430,128430,-870,-870,0,0.00,0
,20160824,128430,128430,,,,130350,130350,1920,1920,0,0.00,0
,20160825,130350,130350,,,,129760,129760,-590,-590,0,0.00,0
,20160826,129760,129760,,,,129790,129790,30,30,0,0.00,0
,20160829,129790,129790,,,,130610,130610,820,820,0,0.00,0
,20160830,130610,130610,,,,130480,130480,-130,-130,0,0.00,0
,20160831,130480,130480,,,,129760,129760,-720,-720,0,0.00,0
,20160901,129760,129760,,,,130870,130870,1110,1110,0,0.00,0
,20160902,130870,130870,,,,132750,132750,1880,1880,0,0.00,0
,20160905,132750,132750,,,,134350,134350,1600,1600,0,0.00,0
,20160906,134350,134350,,,,133180,133180,-1170,-1170,0,0.00,0
,20160907,133180,133180,125070,129980,125070,127760,127570,-5420,-5610,20,255.14,0
,20160908,127760,127570,,,,127570,127570,0,0,0,0.00,0
,20160909,127570,127570,,,,127490,127490,-80,-80,0,0.00,0
,20160912,127490,127490,,,,124620,124620,-2870,-2870,0,0.00,0
,20160913,124620,124620,,,,123050,123050,-1570,-1570,0,0.00,0
,20160914,123050,123050,,,,122580,122580,-470,-470,0,0.00,0
,20160919,122580,122580,,,,124090,124090,1510,1510,0,0.00,0
,20160920,124090,124090,,,,124610,124610,520,520,0,0.00,0
,20160921,124610,124610,,,,124600,124600,-10,-10,0,0.00,0
,20160922,124600,124600,,,,125420,125420,820,820,0,0.00,0
,20160923,125420,125420,,,,126780,126780,1360,1360,0,0.00,0
,20160926,126780,126780,,,,127330,127330,550,550,0,0.00,0
,20160927,127330,127330,,,,126720,126720,-610,-610,0,0.00,0
,20160928,126720,126720,,,,127050,127050,330,330,0,0.00,0
,20160929,127050,127050,,,,128650,128650,1600,1600,0,0.00,0
,20160930,128650,128650,,,,128620,128620,-30,-30,0,0.00,0
,20161010,128620,128620,,,,128300,128300,-320,-320,0,0.00,0
,20161011,128300,128300,,,,129630,129630,1330,1330,0,0.00,0
,20161012,129630,129630,,,,128760,128760,-870,-870,0,0.00,0
,20161013,128760,128760,,,,128760,128760,0,0,0,0.00,0
,20161014,128760,128760,,,,127630,127630,-1130,-1130,0,0.00,0
,20161017,127630,127630,,,,128000,128000,370,370,0,0.00,0
,20161018,128000,128000,,,,128460,128460,460,460,0,0.00,0
,20161019,128460,128460,,,,129130,129130,670,670,0,0.00,0
,20161020,129130,129130,,,,129520,129520,390,390,0,0.00,0
,20161021,129520,129520,,,,131140,131140,1620,1620,0,0.00,0
,20161024,131140,131140,129450,129450,129450,129450,129450,-1690,-1690,2,25.89,2
,20161025,129450,129450,,,,131340,131340,1890,1890,0,0.00,2
,20161026,131340,131340,,,,131730,131730,390,390,0,0.00,2
,20161027,131730,131730,,,,131180,131180,-550,-550,0,0.00,2
,20161028,131180,131180,,,,131970,131970,790,790,0,0.00,2
,20161031,131970,131970,,,,132440,132440,470,470,0,0.00,2
,20161101,132440,132440,,,,133790,133790,1350,1350,0,0.00,2
,20161102,133790,133790,139140,139140,134730,134730,136930,940,3140,8,109.55,4
,20161103,134730,136930,,,,137500,137500,570,570,0,0.00,4
,20161104,137500,137500,140950,140950,140950,140950,140950,3450,3450,2,28.19,2
,20161107,140950,140950,,,,144870,144870,3920,3920,0,0.00,2
,20161108,144870,144870,149170,152110,147820,147820,150920,2950,6050,26,392.39,4
,20161109,147820,150920,152250,155980,152250,152320,154050,1400,3130,42,647.05,6
,20161110,152320,154050,,,,156350,156350,2300,2300,0,0.00,6
,20161111,156350,156350,,,,155470,155470,-880,-880,0,0.00,6
,20161114,155470,155470,,,,152030,152030,-3440,-3440,0,0.00,6
,20161115,152030,152030,148320,150040,148320,150040,148890,-1990,-3140,6,89.34,4
,20161116,150040,148890,,,,145950,145950,-2940,-2940,0,0.00,4
,20161117,145950,145950,,,,143750,143750,-2200,-2200,0,0.00,4
,20161118,143750,143750,142420,144400,142420,144400,143410,650,-340,4,57.36,4
,20161121,144400,143410,141020,141020,141020,141020,141020,-2390,-2390,4,56.41,2
,20161122,141020,141020,145650,145830,145650,145830,145740,4810,4720,4,58.30,2
,20161123,145830,145740,,,,146500,146500,760,760,0,0.00,2
,20161124,146500,146500,,,,147620,147620,1120,1120,0,0.00,2
,20161125,147620,147620,,,,145660,145660,-1960,-1960,0,0.00,2
,20161128,145660,145660,,,,146340,146340,680,680,0,0.00,2
,20161129,146340,146340,143640,143640,143640,143640,143640,-2700,-2700,2,28.73,2
,20161130,143640,143640,,,,138730,138730,-4910,-4910,0,0.00,2
,20161201,138730,138730,144620,146430,141420,143860,144390,5130,5660,16,231.03,6
,20161202,143860,144390,144920,144920,144920,144920,144920,530,530,2,28.98,4
,20161205,144920,144920,,,,145090,145090,170,170,0,0.00,4
,20161206,145090,145090,,,,145340,145340,250,250,0,0.00,4
,20161207,145340,145340,145600,145600,144270,144270,144930,-1070,-410,4,57.97,0
,20161208,144270,144930,,,,145870,145870,940,940,0,0.00,0
,20161209,145870,145870,141060,141060,141060,141060,141060,-4810,-4810,2,28.21,2
,20161212,141060,141060,147260,147260,143100,143100,145190,2040,4130,12,174.23,2
,20161213,143100,145190,,,,147080,147080,1890,1890,0,0.00,2
,20161214,147080,147080,149370,149960,145340,149960,147580,2880,500,20,295.16,8
,20161215,149960,147580,,,,148880,148880,1300,1300,0,0.00,8
,20161216,148880,148880,152350,152350,150000,150000,151170,1120,2290,4,60.47,8
,20161219,150000,151170,,,,148460,148460,-2710,-2710,0,0.00,8
,20161220,148460,148460,,,,145010,145010,-3450,-3450,0,0.00,8
,20161221,145010,145010,142210,146470,142210,146470,144340,1460,-670,4,57.74,10
,20161222,146470,144340,144300,145780,141350,143800,144050,-540,-290,16,230.49,0
,20161223,143800,144050,,,,144270,144270,220,220,0,0.00,0
,20161226,144270,144270,144270,144270,139160,141990,142050,-2280,-2220,20,284.11,0
,20161227,141990,142050,,,,142090,142090,40,40,0,0.00,0
,20161228,142090,142090,147820,148890,143930,148890,147100,6800,5010,8,117.68,4
,20161229,148890,147100,,,,147870,147870,770,770,0,0.00,4
,20161230,147870,147870,,,,148130,148130,260,260,0,0.00,4
sn1703,20160316,109980,109980,,,,109200,109200,-780,-780,0,0.00,0
,20160317,109200,109200,,,,110170,110170,970,970,0,0.00,0
,20160318,110170,110170,,,,113560,113560,3390,3390,0,0.00,0
,20160321,113560,113560,,,,113560,113560,0,0,0,0.00,0
,20160322,113560,113560,,,,113050,113050,-510,-510,0,0.00,0
,20160323,113050,113050,,,,113050,113050,0,0,0,0.00,0
,20160324,113050,113050,,,,114430,114430,1380,1380,0,0.00,0
,20160325,114430,114430,,,,114830,114830,400,400,0,0.00,0
,20160328,114830,114830,,,,113770,113770,-1060,-1060,0,0.00,0
,20160329,113770,113770,,,,111490,111490,-2280,-2280,0,0.00,0
,20160330,111490,111490,,,,111490,111490,0,0,0,0.00,0
,20160331,111490,111490,,,,111490,111490,0,0,0,0.00,0
,20160401,111490,111490,,,,111890,111890,400,400,0,0.00,0
,20160405,111890,111890,,,,112650,112650,760,760,0,0.00,0
,20160406,112650,112650,,,,111660,111660,-990,-990,0,0.00,0
,20160407,111660,111660,,,,112550,112550,890,890,0,0.00,0
,20160408,112550,112550,,,,111210,111210,-1340,-1340,0,0.00,0
,20160411,111210,111210,,,,114410,114410,3200,3200,0,0.00,0
,20160412,114410,114410,,,,114400,114400,-10,-10,0,0.00,0
,20160413,114400,114400,,,,116330,116330,1930,1930,0,0.00,0
,20160414,116330,116330,,,,118320,118320,1990,1990,0,0.00,0
,20160415,118320,118320,,,,117780,117780,-540,-540,0,0.00,0
,20160418,117780,117780,,,,116690,116690,-1090,-1090,0,0.00,0
,20160419,116690,116690,116110,116110,113810,113810,114620,-2880,-2070,8,91.70,4
,20160420,113810,114620,,,,114620,114620,0,0,0,0.00,4
,20160421,114620,114620,,,,115720,115720,1100,1100,0,0.00,4
,20160422,115720,115720,112500,112500,112500,112500,112500,-3220,-3220,4,45.00,4
,20160425,112500,112500,,,,112500,112500,0,0,0,0.00,4
,20160426,112500,112500,111560,111560,111560,111560,111560,-940,-940,4,44.62,0
,20160427,111560,111560,,,,111120,111120,-440,-440,0,0.00,0
,20160428,111120,111120,,,,111560,111560,440,440,0,0.00,0
,20160429,111560,111560,,,,111930,111930,370,370,0,0.00,0
,20160503,111930,111930,,,,112850,112850,920,920,0,0.00,0
,20160504,112850,112850,,,,114050,114050,1200,1200,0,0.00,0
,20160505,114050,114050,,,,114980,114980,930,930,0,0.00,0
,20160506,114980,114980,,,,113940,113940,-1040,-1040,0,0.00,0
,20160509,113940,113940,,,,113360,113360,-580,-580,0,0.00,0
,20160510,113360,113360,,,,110500,110500,-2860,-2860,0,0.00,0
,20160511,110500,110500,,,,110660,110660,160,160,0,0.00,0
,20160512,110660,110660,,,,112250,112250,1590,1590,0,0.00,0
,20160513,112250,112250,,,,112610,112610,360,360,0,0.00,0
,20160516,112610,112610,,,,112090,112090,-520,-520,0,0.00,0
,20160517,112090,112090,,,,112360,112360,270,270,0,0.00,0
,20160518,112360,112360,,,,111980,111980,-380,-380,0,0.00,0
,20160519,111980,111980,,,,110870,110870,-1110,-1110,0,0.00,0
,20160520,110870,110870,,,,112560,112560,1690,1690,0,0.00,0
,20160523,112560,112560,,,,110980,110980,-1580,-1580,0,0.00,0
,20160524,110980,110980,,,,111610,111610,630,630,0,0.00,0
,20160525,111610,111610,,,,109730,109730,-1880,-1880,0,0.00,0
,20160526,109730,109730,,,,110210,110210,480,480,0,0.00,0
,20160527,110210,110210,,,,113510,113510,3300,3300,0,0.00,0
,20160530,113510,113510,,,,114640,114640,1130,1130,0,0.00,0
,20160531,114640,114640,,,,115090,115090,450,450,0,0.00,0
,20160601,115090,115090,,,,117820,117820,2730,2730,0,0.00,0
,20160602,117820,117820,,,,115510,115510,-2310,-2310,0,0.00,0
,20160603,115510,115510,,,,115780,115780,270,270,0,0.00,0
,20160606,115780,115780,,,,116210,116210,430,430,0,0.00,0
,20160607,116210,116210,,,,116610,116610,400,400,0,0.00,0
,20160608,116610,116610,,,,118550,118550,1940,1940,0,0.00,0
,20160613,118550,118550,,,,120750,120750,2200,2200,0,0.00,0
,20160614,120750,120750,,,,121740,121740,990,990,0,0.00,0
,20160615,121740,121740,,,,121740,121740,0,0,0,0.00,0
,20160616,121740,121740,,,,115650,115650,-6090,-6090,0,0.00,0
,20160617,115650,115650,,,,114450,114450,-1200,-1200,0,0.00,0
,20160620,114450,114450,,,,112560,112560,-1890,-1890,0,0.00,0
,20160621,112560,112560,,,,115660,115660,3100,3100,0,0.00,0
,20160622,115660,115660,,,,115360,115360,-300,-300,0,0.00,0
,20160623,115360,115360,,,,115440,115440,80,80,0,0.00,0
,20160624,115440,115440,,,,115800,115800,360,360,0,0.00,0
,20160627,115800,115800,,,,115830,115830,30,30,0,0.00,0
,20160628,115830,115830,,,,115380,115380,-450,-450,0,0.00,0
,20160629,115380,115380,,,,115500,115500,120,120,0,0.00,0
,20160630,115500,115500,,,,115530,115530,30,30,0,0.00,0
,20160701,115530,115530,,,,121000,121000,5470,5470,0,0.00,0
,20160704,121000,121000,,,,123490,123490,2490,2490,0,0.00,0
,20160705,123490,123490,,,,124820,124820,1330,1330,0,0.00,0
,20160706,124820,124820,,,,120480,120480,-4340,-4340,0,0.00,0
,20160707,120480,120480,,,,121300,121300,820,820,0,0.00,0
,20160708,121300,121300,,,,119300,119300,-2000,-2000,0,0.00,0
,20160711,119300,119300,,,,121190,121190,1890,1890,0,0.00,0
,20160712,121190,121190,,,,122930,122930,1740,1740,0,0.00,0
,20160713,122930,122930,,,,123400,123400,470,470,0,0.00,0
,20160714,123400,123400,,,,121670,121670,-1730,-1730,0,0.00,0
,20160715,121670,121670,,,,122250,122250,580,580,0,0.00,0
,20160718,122250,122250,,,,122270,122270,20,20,0,0.00,0
,20160719,122270,122270,,,,121160,121160,-1110,-1110,0,0.00,0
,20160720,121160,121160,,,,121020,121020,-140,-140,0,0.00,0
,20160721,121020,121020,,,,121830,121830,810,810,0,0.00,0
,20160722,121830,121830,,,,122530,122530,700,700,0,0.00,0
,20160725,122530,122530,121830,121830,120410,120410,121700,-2120,-830,22,267.74,20
,20160726,120410,121700,118010,118010,118010,118010,118010,-3690,-3690,20,236.02,0
,20160727,118010,118010,,,,119400,119400,1390,1390,0,0.00,0
,20160728,119400,119400,,,,120320,120320,920,920,0,0.00,0
,20160729,120320,120320,,,,119790,119790,-530,-530,0,0.00,0
,20160801,119790,119790,,,,119310,119310,-480,-480,0,0.00,0
,20160802,119310,119310,,,,119820,119820,510,510,0,0.00,0
,20160803,119820,119820,,,,119960,119960,140,140,0,0.00,0
,20160804,119960,119960,,,,118700,118700,-1260,-1260,0,0.00,0
,20160805,118700,118700,,,,119440,119440,740,740,0,0.00,0
,20160808,119440,119440,,,,120640,120640,1200,1200,0,0.00,0
,20160809,120640,120640,,,,121240,121240,600,600,0,0.00,0
,20160810,121240,121240,,,,123190,123190,1950,1950,0,0.00,0
,20160811,123190,123190,,,,123910,123910,720,720,0,0.00,0
,20160812,123910,123910,,,,123280,123280,-630,-630,0,0.00,0
,20160815,123280,123280,,,,122000,122000,-1280,-1280,0,0.00,0
,20160816,122000,122000,,,,122660,122660,660,660,0,0.00,0
,20160817,122660,122660,,,,122520,122520,-140,-140,0,0.00,0
,20160818,122520,122520,,,,121320,121320,-1200,-1200,0,0.00,0
,20160819,121320,121320,,,,121590,121590,270,270,0,0.00,0
,20160822,121590,121590,,,,122070,122070,480,480,0,0.00,0
,20160823,122070,122070,,,,121250,121250,-820,-820,0,0.00,0
,20160824,121250,121250,,,,123060,123060,1810,1810,0,0.00,0
,20160825,123060,123060,,,,122500,122500,-560,-560,0,0.00,0
,20160826,122500,122500,,,,122520,122520,20,20,0,0.00,0
,20160829,122520,122520,,,,123290,123290,770,770,0,0.00,0
,20160830,123290,123290,,,,123170,123170,-120,-120,0,0.00,0
,20160831,123170,123170,,,,122490,122490,-680,-680,0,0.00,0
,20160901,122490,122490,,,,123540,123540,1050,1050,0,0.00,0
,20160902,123540,123540,,,,125310,125310,1770,1770,0,0.00,0
,20160905,125310,125310,,,,126820,126820,1510,1510,0,0.00,0
,20160906,126820,126820,,,,125710,125710,-1110,-1110,0,0.00,0
,20160907,125710,125710,,,,120410,120410,-5300,-5300,0,0.00,0
,20160908,120410,120410,,,,120530,120530,120,120,0,0.00,0
,20160909,120530,120530,,,,120450,120450,-80,-80,0,0.00,0
,20160912,120450,120450,,,,117740,117740,-2710,-2710,0,0.00,0
,20160913,117740,117740,,,,116250,116250,-1490,-1490,0,0.00,0
,20160914,116250,116250,,,,115810,115810,-440,-440,0,0.00,0
,20160919,115810,115810,,,,117230,117230,1420,1420,0,0.00,0
,20160920,117230,117230,,,,117720,117720,490,490,0,0.00,0
,20160921,117720,117720,,,,117710,117710,-10,-10,0,0.00,0
,20160922,117710,117710,,,,118480,118480,770,770,0,0.00,0
,20160923,118480,118480,,,,119770,119770,1290,1290,0,0.00,0
,20160926,119770,119770,,,,120290,120290,520,520,0,0.00,0
,20160927,120290,120290,,,,126300,126300,6010,6010,0,0.00,0
,20160928,126300,126300,,,,126630,126630,330,330,0,0.00,0
,20160929,126630,126630,,,,128220,128220,1590,1590,0,0.00,0
,20160930,128220,128220,,,,128190,128190,-30,-30,0,0.00,0
,20161010,128190,128190,,,,127870,127870,-320,-320,0,0.00,0
,20161011,127870,127870,,,,129190,129190,1320,1320,0,0.00,0
,20161012,129190,129190,,,,128320,128320,-870,-870,0,0.00,0
,20161013,128320,128320,,,,128320,128320,0,0,0,0.00,0
,20161014,128320,128320,,,,127190,127190,-1130,-1130,0,0.00,0
,20161017,127190,127190,,,,127550,127550,360,360,0,0.00,0
,20161018,127550,127550,,,,128000,128000,450,450,0,0.00,0
,20161019,128000,128000,,,,128670,128670,670,670,0,0.00,0
,20161020,128670,128670,,,,129050,129050,380,380,0,0.00,0
,20161021,129050,129050,,,,130660,130660,1610,1610,0,0.00,0
,20161024,130660,130660,,,,128970,128970,-1690,-1690,0,0.00,0
,20161025,128970,128970,,,,130860,130860,1890,1890,0,0.00,0
,20161026,130860,130860,,,,131250,131250,390,390,0,0.00,0
,20161027,131250,131250,,,,130700,130700,-550,-550,0,0.00,0
,20161028,130700,130700,,,,131490,131490,790,790,0,0.00,0
,20161031,131490,131490,,,,131960,131960,470,470,0,0.00,0
,20161101,131960,131960,,,,133300,133300,1340,1340,0,0.00,0
,20161102,133300,133300,,,,133870,133870,570,570,0,0.00,0
,20161103,133870,133870,138550,138550,138550,138550,138550,4680,4680,2,27.71,2
,20161104,138550,138550,137660,141500,137660,141500,140390,2950,1840,8,112.32,2
,20161107,141500,140390,,,,144300,144300,3910,3910,0,0.00,2
,20161108,144300,144300,150880,151510,148850,148850,150050,4550,5750,20,300.11,2
,20161109,148850,150050,,,,153170,153170,3120,3120,0,0.00,2
,20161110,153170,153170,,,,155460,155460,2290,2290,0,0.00,2
,20161111,155460,155460,151250,151250,151250,151250,151250,-4210,-4210,4,60.50,4
,20161114,151250,151250,145890,145890,145890,145890,145890,-5360,-5360,2,29.18,4
,20161115,145890,145890,,,,142880,142880,-3010,-3010,0,0.00,4
,20161116,142880,142880,,,,140060,140060,-2820,-2820,0,0.00,4
,20161117,140060,140060,,,,137950,137950,-2110,-2110,0,0.00,4
,20161118,137950,137950,,,,137620,137620,-330,-330,0,0.00,4
,20161121,137620,137620,,,,135320,135320,-2300,-2300,0,0.00,4
,20161122,135320,135320,,,,139840,139840,4520,4520,0,0.00,4
,20161123,139840,139840,,,,140570,140570,730,730,0,0.00,4
,20161124,140570,140570,,,,141640,141640,1070,1070,0,0.00,4
,20161125,141640,141640,,,,139760,139760,-1880,-1880,0,0.00,4
,20161128,139760,139760,,,,140410,140410,650,650,0,0.00,4
,20161129,140410,140410,147690,149700,145300,148070,147320,7660,6910,18,265.18,4
,20161130,148070,147320,,,,142290,142290,-5030,-5030,0,0.00,4
,20161201,142290,142290,,,,148090,148090,5800,5800,0,0.00,4
,20161202,148090,148090,,,,148630,148630,540,540,0,0.00,4
,20161205,148630,148630,143350,145350,142700,144840,144060,-3790,-4570,8,115.25,4
,20161206,144840,144060,,,,144300,144300,240,240,0,0.00,4
,20161207,144300,144300,,,,143890,143890,-410,-410,0,0.00,4
,20161208,143890,143890,,,,144830,144830,940,940,0,0.00,4
,20161209,144830,144830,,,,140050,140050,-4780,-4780,0,0.00,4
,20161212,140050,140050,,,,144150,144150,4100,4100,0,0.00,4
,20161213,144150,144150,,,,146030,146030,1880,1880,0,0.00,4
,20161214,146030,146030,150060,151980,148290,149880,150650,3850,4620,22,331.43,20
,20161215,149880,150650,,,,151980,151980,1330,1330,0,0.00,20
,20161216,151980,151980,150370,150690,150370,150690,150590,-1290,-1390,8,120.47,20
,20161219,150690,150590,,,,147890,147890,-2700,-2700,0,0.00,20
,20161220,147890,147890,,,,144450,144450,-3440,-3440,0,0.00,20
,20161221,144450,144450,,,,143780,143780,-670,-670,0,0.00,20
,20161222,143780,143780,,,,143490,143490,-290,-290,0,0.00,20
,20161223,143490,143490,,,,143710,143710,220,220,0,0.00,20
,20161226,143710,143710,,,,141500,141500,-2210,-2210,0,0.00,20
,20161227,141500,141500,139610,139610,138000,138440,139050,-3060,-2450,10,139.05,22
,20161228,138440,139050,,,,143950,143950,4900,4900,0,0.00,22
,20161229,143950,143950,,,,144700,144700,750,750,0,0.00,22
,20161230,144700,144700,,,,144950,144950,250,250,0,0.00,22
sn1704,20160418,117780,117780,,,,116690,116690,-1090,-1090,0,0.00,0
,20160419,116690,116690,,,,114620,114620,-2070,-2070,0,0.00,0
,20160420,114620,114620,,,,115210,115210,590,590,0,0.00,0
,20160421,115210,115210,,,,116320,116320,1110,1110,0,0.00,0
,20160422,116320,116320,,,,113080,113080,-3240,-3240,0,0.00,0
,20160425,113080,113080,,,,112610,112610,-470,-470,0,0.00,0
,20160426,112610,112610,,,,111660,111660,-950,-950,0,0.00,0
,20160427,111660,111660,,,,111220,111220,-440,-440,0,0.00,0
,20160428,111220,111220,,,,111660,111660,440,440,0,0.00,0
,20160429,111660,111660,,,,112030,112030,370,370,0,0.00,0
,20160503,112030,112030,,,,112950,112950,920,920,0,0.00,0
,20160504,112950,112950,,,,114150,114150,1200,1200,0,0.00,0
,20160505,114150,114150,,,,115080,115080,930,930,0,0.00,0
,20160506,115080,115080,,,,114040,114040,-1040,-1040,0,0.00,0
,20160509,114040,114040,,,,113460,113460,-580,-580,0,0.00,0
,20160510,113460,113460,,,,110600,110600,-2860,-2860,0,0.00,0
,20160511,110600,110600,,,,110760,110760,160,160,0,0.00,0
,20160512,110760,110760,,,,112350,112350,1590,1590,0,0.00,0
,20160513,112350,112350,,,,112710,112710,360,360,0,0.00,0
,20160516,112710,112710,,,,112190,112190,-520,-520,0,0.00,0
,20160517,112190,112190,,,,112460,112460,270,270,0,0.00,0
,20160518,112460,112460,,,,112080,112080,-380,-380,0,0.00,0
,20160519,112080,112080,,,,110970,110970,-1110,-1110,0,0.00,0
,20160520,110970,110970,,,,112660,112660,1690,1690,0,0.00,0
,20160523,112660,112660,,,,111080,111080,-1580,-1580,0,0.00,0
,20160524,111080,111080,,,,111710,111710,630,630,0,0.00,0
,20160525,111710,111710,,,,109820,109820,-1890,-1890,0,0.00,0
,20160526,109820,109820,,,,110300,110300,480,480,0,0.00,0
,20160527,110300,110300,,,,113600,113600,3300,3300,0,0.00,0
,20160530,113600,113600,,,,114730,114730,1130,1130,0,0.00,0
,20160531,114730,114730,,,,115180,115180,450,450,0,0.00,0
,20160601,115180,115180,,,,117910,117910,2730,2730,0,0.00,0
,20160602,117910,117910,,,,115590,115590,-2320,-2320,0,0.00,0
,20160603,115590,115590,,,,115860,115860,270,270,0,0.00,0
,20160606,115860,115860,,,,116290,116290,430,430,0,0.00,0
,20160607,116290,116290,,,,116690,116690,400,400,0,0.00,0
,20160608,116690,116690,,,,118630,118630,1940,1940,0,0.00,0
,20160613,118630,118630,,,,120830,120830,2200,2200,0,0.00,0
,20160614,120830,120830,,,,121820,121820,990,990,0,0.00,0
,20160615,121820,121820,,,,121820,121820,0,0,0,0.00,0
,20160616,121820,121820,,,,122320,122320,500,500,0,0.00,0
,20160617,122320,122320,,,,121050,121050,-1270,-1270,0,0.00,0
,20160620,121050,121050,,,,119050,119050,-2000,-2000,0,0.00,0
,20160621,119050,119050,,,,122330,122330,3280,3280,0,0.00,0
,20160622,122330,122330,,,,122010,122010,-320,-320,0,0.00,0
,20160623,122010,122010,,,,122100,122100,90,90,0,0.00,0
,20160624,122100,122100,,,,122480,122480,380,380,0,0.00,0
,20160627,122480,122480,,,,122510,122510,30,30,0,0.00,0
,20160628,122510,122510,,,,122030,122030,-480,-480,0,0.00,0
,20160629,122030,122030,,,,122150,122150,120,120,0,0.00,0
,20160630,122150,122150,,,,122180,122180,30,30,0,0.00,0
,20160701,122180,122180,,,,127970,127970,5790,5790,0,0.00,0
,20160704,127970,127970,,,,130600,130600,2630,2630,0,0.00,0
,20160705,130600,130600,,,,124000,124000,-6600,-6600,0,0.00,0
,20160706,124000,124000,,,,121000,121000,-3000,-3000,0,0.00,0
,20160707,121000,121000,,,,121820,121820,820,820,0,0.00,0
,20160708,121820,121820,,,,119810,119810,-2010,-2010,0,0.00,0
,20160711,119810,119810,,,,121710,121710,1900,1900,0,0.00,0
,20160712,121710,121710,,,,123450,123450,1740,1740,0,0.00,0
,20160713,123450,123450,,,,123920,123920,470,470,0,0.00,0
,20160714,123920,123920,,,,122190,122190,-1730,-1730,0,0.00,0
,20160715,122190,122190,,,,122780,122780,590,590,0,0.00,0
,20160718,122780,122780,,,,122800,122800,20,20,0,0.00,0
,20160719,122800,122800,,,,121680,121680,-1120,-1120,0,0.00,0
,20160720,121680,121680,,,,121540,121540,-140,-140,0,0.00,0
,20160721,121540,121540,,,,122350,122350,810,810,0,0.00,0
,20160722,122350,122350,,,,123050,123050,700,700,0,0.00,0
,20160725,123050,123050,,,,122210,122210,-840,-840,0,0.00,0
,20160726,122210,122210,,,,118500,118500,-3710,-3710,0,0.00,0
,20160727,118500,118500,,,,119900,119900,1400,1400,0,0.00,0
,20160728,119900,119900,,,,120830,120830,930,930,0,0.00,0
,20160729,120830,120830,,,,120290,120290,-540,-540,0,0.00,0
,20160801,120290,120290,,,,119810,119810,-480,-480,0,0.00,0
,20160802,119810,119810,,,,120320,120320,510,510,0,0.00,0
,20160803,120320,120320,,,,120460,120460,140,140,0,0.00,0
,20160804,120460,120460,,,,119190,119190,-1270,-1270,0,0.00,0
,20160805,119190,119190,,,,119930,119930,740,740,0,0.00,0
,20160808,119930,119930,,,,121130,121130,1200,1200,0,0.00,0
,20160809,121130,121130,,,,121730,121730,600,600,0,0.00,0
,20160810,121730,121730,,,,123690,123690,1960,1960,0,0.00,0
,20160811,123690,123690,,,,124410,124410,720,720,0,0.00,0
,20160812,124410,124410,,,,123770,123770,-640,-640,0,0.00,0
,20160815,123770,123770,,,,122480,122480,-1290,-1290,0,0.00,0
,20160816,122480,122480,,,,123140,123140,660,660,0,0.00,0
,20160817,123140,123140,,,,123000,123000,-140,-140,0,0.00,0
,20160818,123000,123000,,,,121800,121800,-1200,-1200,0,0.00,0
,20160819,121800,121800,,,,122070,122070,270,270,0,0.00,0
,20160822,122070,122070,,,,122550,122550,480,480,0,0.00,0
,20160823,122550,122550,,,,121730,121730,-820,-820,0,0.00,0
,20160824,121730,121730,,,,123550,123550,1820,1820,0,0.00,0
,20160825,123550,123550,,,,122990,122990,-560,-560,0,0.00,0
,20160826,122990,122990,,,,123010,123010,20,20,0,0.00,0
,20160829,123010,123010,,,,123780,123780,770,770,0,0.00,0
,20160830,123780,123780,,,,123660,123660,-120,-120,0,0.00,0
,20160831,123660,123660,,,,122970,122970,-690,-690,0,0.00,0
,20160901,122970,122970,,,,124020,124020,1050,1050,0,0.00,0
,20160902,124020,124020,,,,125800,125800,1780,1780,0,0.00,0
,20160905,125800,125800,,,,127310,127310,1510,1510,0,0.00,0
,20160906,127310,127310,,,,126200,126200,-1110,-1110,0,0.00,0
,20160907,126200,126200,,,,120880,120880,-5320,-5320,0,0.00,0
,20160908,120880,120880,,,,121000,121000,120,120,0,0.00,0
,20160909,121000,121000,,,,120920,120920,-80,-80,0,0.00,0
,20160912,120920,120920,,,,118190,118190,-2730,-2730,0,0.00,0
,20160913,118190,118190,,,,116700,116700,-1490,-1490,0,0.00,0
,20160914,116700,116700,,,,116260,116260,-440,-440,0,0.00,0
,20160919,116260,116260,,,,117690,117690,1430,1430,0,0.00,0
,20160920,117690,117690,,,,118180,118180,490,490,0,0.00,0
,20160921,118180,118180,,,,118170,118170,-10,-10,0,0.00,0
,20160922,118170,118170,,,,118950,118950,780,780,0,0.00,0
,20160923,118950,118950,,,,120240,120240,1290,1290,0,0.00,0
,20160926,120240,120240,,,,120760,120760,520,520,0,0.00,0
,20160927,120760,120760,,,,120180,120180,-580,-580,0,0.00,0
,20160928,120180,120180,,,,120490,120490,310,310,0,0.00,0
,20160929,120490,120490,,,,122000,122000,1510,1510,0,0.00,0
,20160930,122000,122000,,,,121970,121970,-30,-30,0,0.00,0
,20161010,121970,121970,,,,121670,121670,-300,-300,0,0.00,0
,20161011,121670,121670,,,,122930,122930,1260,1260,0,0.00,0
,20161012,122930,122930,,,,122110,122110,-820,-820,0,0.00,0
,20161013,122110,122110,,,,122110,122110,0,0,0,0.00,0
,20161014,122110,122110,,,,121040,121040,-1070,-1070,0,0.00,0
,20161017,121040,121040,,,,121390,121390,350,350,0,0.00,0
,20161018,121390,121390,,,,121820,121820,430,430,0,0.00,0
,20161019,121820,121820,,,,122450,122450,630,630,0,0.00,0
,20161020,122450,122450,,,,122820,122820,370,370,0,0.00,0
,20161021,122820,122820,,,,124360,124360,1540,1540,0,0.00,0
,20161024,124360,124360,,,,122750,122750,-1610,-1610,0,0.00,0
,20161025,122750,122750,,,,124540,124540,1790,1790,0,0.00,0
,20161026,124540,124540,,,,124910,124910,370,370,0,0.00,0
,20161027,124910,124910,,,,124390,124390,-520,-520,0,0.00,0
,20161028,124390,124390,,,,125140,125140,750,750,0,0.00,0
,20161031,125140,125140,,,,125590,125590,450,450,0,0.00,0
,20161101,125590,125590,,,,126870,126870,1280,1280,0,0.00,0
,20161102,126870,126870,,,,133930,133930,7060,7060,0,0.00,0
,20161103,133930,133930,,,,138610,138610,4680,4680,0,0.00,0
,20161104,138610,138610,,,,140450,140450,1840,1840,0,0.00,0
,20161107,140450,140450,,,,145010,145010,4560,4560,0,0.00,0
,20161108,145010,145010,,,,150790,150790,5780,5780,0,0.00,0
,20161109,150790,150790,,,,153920,153920,3130,3130,0,0.00,0
,20161110,153920,153920,,,,156220,156220,2300,2300,0,0.00,0
,20161111,156220,156220,,,,151980,151980,-4240,-4240,0,0.00,0
,20161114,151980,151980,,,,146590,146590,-5390,-5390,0,0.00,0
,20161115,146590,146590,,,,143560,143560,-3030,-3030,0,0.00,0
,20161116,143560,143560,,,,140730,140730,-2830,-2830,0,0.00,0
,20161117,140730,140730,,,,138610,138610,-2120,-2120,0,0.00,0
,20161118,138610,138610,,,,138280,138280,-330,-330,0,0.00,0
,20161121,138280,138280,,,,135970,135970,-2310,-2310,0,0.00,0
,20161122,135970,135970,,,,140520,140520,4550,4550,0,0.00,0
,20161123,140520,140520,,,,141250,141250,730,730,0,0.00,0
,20161124,141250,141250,,,,142330,142330,1080,1080,0,0.00,0
,20161125,142330,142330,,,,140440,140440,-1890,-1890,0,0.00,0
,20161128,140440,140440,,,,141100,141100,660,660,0,0.00,0
,20161129,141100,141100,,,,148040,148040,6940,6940,0,0.00,0
,20161130,148040,148040,,,,142980,142980,-5060,-5060,0,0.00,0
,20161201,142980,142980,,,,148810,148810,5830,5830,0,0.00,0
,20161202,148810,148810,,,,149350,149350,540,540,0,0.00,0
,20161205,149350,149350,,,,144750,144750,-4600,-4600,0,0.00,0
,20161206,144750,144750,,,,144990,144990,240,240,0,0.00,0
,20161207,144990,144990,,,,144580,144580,-410,-410,0,0.00,0
,20161208,144580,144580,,,,145520,145520,940,940,0,0.00,0
,20161209,145520,145520,,,,140720,140720,-4800,-4800,0,0.00,0
,20161212,140720,140720,,,,144840,144840,4120,4120,0,0.00,0
,20161213,144840,144840,,,,146720,146720,1880,1880,0,0.00,0
,20161214,146720,146720,,,,151360,151360,4640,4640,0,0.00,0
,20161215,151360,151360,,,,152690,152690,1330,1330,0,0.00,0
,20161216,152690,152690,,,,151290,151290,-1400,-1400,0,0.00,0
,20161219,151290,151290,,,,148580,148580,-2710,-2710,0,0.00,0
,20161220,148580,148580,,,,145130,145130,-3450,-3450,0,0.00,0
,20161221,145130,145130,,,,144450,144450,-680,-680,0,0.00,0
,20161222,144450,144450,,,,144160,144160,-290,-290,0,0.00,0
,20161223,144160,144160,,,,144380,144380,220,220,0,0.00,0
,20161226,144380,144380,,,,142160,142160,-2220,-2220,0,0.00,0
,20161227,142160,142160,,,,139700,139700,-2460,-2460,0,0.00,0
,20161228,139700,139700,,,,144620,144620,4920,4920,0,0.00,0
,20161229,144620,144620,,,,145370,145370,750,750,0,0.00,0
,20161230,145370,145370,,,,145620,145620,250,250,0,0.00,0
sn1705,20160517,112190,112190,,,,112460,112460,270,270,0,0.00,0
,20160518,112460,112460,,,,110320,110320,-2140,-2140,0,0.00,0
,20160519,110320,110320,,,,109220,109220,-1100,-1100,0,0.00,0
,20160520,109220,109220,,,,110880,110880,1660,1660,0,0.00,0
,20160523,110880,110880,,,,109330,109330,-1550,-1550,0,0.00,0
,20160524,109330,109330,,,,109950,109950,620,620,0,0.00,0
,20160525,109950,109950,,,,108090,108090,-1860,-1860,0,0.00,0
,20160526,108090,108090,,,,108560,108560,470,470,0,0.00,0
,20160527,108560,108560,,,,111810,111810,3250,3250,0,0.00,0
,20160530,111810,111810,,,,112920,112920,1110,1110,0,0.00,0
,20160531,112920,112920,,,,113360,113360,440,440,0,0.00,0
,20160601,113360,113360,,,,116050,116050,2690,2690,0,0.00,0
,20160602,116050,116050,,,,113770,113770,-2280,-2280,0,0.00,0
,20160603,113770,113770,,,,114030,114030,260,260,0,0.00,0
,20160606,114030,114030,,,,114460,114460,430,430,0,0.00,0
,20160607,114460,114460,,,,114460,114460,0,0,0,0.00,0
,20160608,114460,114460,,,,116360,116360,1900,1900,0,0.00,0
,20160613,116360,116360,,,,118520,118520,2160,2160,0,0.00,0
,20160614,118520,118520,,,,119490,119490,970,970,0,0.00,0
,20160615,119490,119490,,,,119490,119490,0,0,0,0.00,0
,20160616,119490,119490,,,,119980,119980,490,490,0,0.00,0
,20160617,119980,119980,,,,118730,118730,-1250,-1250,0,0.00,0
,20160620,118730,118730,,,,116770,116770,-1960,-1960,0,0.00,0
,20160621,116770,116770,,,,119990,119990,3220,3220,0,0.00,0
,20160622,119990,119990,,,,119670,119670,-320,-320,0,0.00,0
,20160623,119670,119670,,,,119760,119760,90,90,0,0.00,0
,20160624,119760,119760,,,,120140,120140,380,380,0,0.00,0
,20160627,120140,120140,,,,120170,120170,30,30,0,0.00,0
,20160628,120170,120170,,,,119700,119700,-470,-470,0,0.00,0
,20160629,119700,119700,111460,114220,111460,114220,112840,-5480,-6860,4,45.14,4
,20160630,114220,112840,,,,112840,112840,0,0,0,0.00,4
,20160701,112840,112840,114300,118480,114300,118480,117900,5640,5060,30,353.70,18
,20160704,118480,117900,118520,123250,118520,123250,120090,5350,2190,6,72.06,18
,20160705,123250,120090,120250,122400,120240,121080,120900,990,810,18,217.63,16
,20160706,121080,120900,121990,121990,121990,121990,121990,1090,1090,2,24.40,18
,20160707,121990,121990,,,,121000,121000,-990,-990,0,0.00,18
,20160708,121000,121000,115370,115910,115370,115740,115690,-5260,-5310,8,92.55,16
,20160711,115740,115690,,,,118320,118320,2630,2630,0,0.00,16
,20160712,118320,118320,,,,120500,120500,2180,2180,0,0.00,16
,20160713,120500,120500,120370,122100,120180,120180,120380,-320,-120,26,313.01,40
,20160714,120180,120380,119480,119490,119480,119490,119480,-890,-900,4,47.79,42
,20160715,119490,119480,,,,119700,119700,220,220,0,0.00,42
,20160718,119700,119700,121090,121090,119100,119100,119890,-600,190,8,95.92,44
,20160719,119100,119890,,,,119880,119880,-10,-10,0,0.00,44
,20160720,119880,119880,118520,118520,118520,118520,118520,-1360,-1360,2,23.70,44
,20160721,118520,118520,120450,121280,119530,121280,120340,2760,1820,64,770.21,66
,20160722,121280,120340,121480,121700,121390,121700,121520,1360,1180,16,194.45,78
,20160725,121700,121520,120310,120310,120310,120310,120310,-1210,-1210,2,24.06,80
,20160726,120310,120310,120490,120490,120300,120300,120390,-10,80,4,48.16,80
,20160727,120300,120390,122000,123500,122000,123500,122750,3110,2360,4,49.10,76
,20160728,123500,122750,124200,124200,124200,124200,124200,1450,1450,2,24.84,74
,20160729,124200,124200,,,,123650,123650,-550,-550,0,0.00,74
,20160801,123650,123650,123650,123650,123200,123200,123420,-450,-230,4,49.37,70
,20160802,123200,123420,,,,123950,123950,530,530,0,0.00,70
,20160803,123950,123950,,,,124100,124100,150,150,0,0.00,70
,20160804,124100,124100,121950,121950,121950,121950,121950,-2150,-2150,2,24.39,68
,20160805,121950,121950,,,,122710,122710,760,760,0,0.00,68
,20160808,122710,122710,124090,126870,124090,126800,126150,4090,3440,8,100.93,76
,20160809,126800,126150,125170,125210,125170,125210,125180,-940,-970,6,75.11,76
,20160810,125210,125180,,,,126430,126430,1250,1250,0,0.00,76
,20160811,126430,126430,127370,127370,126520,126520,126930,90,500,6,76.16,76
,20160812,126520,126930,126140,126140,126140,126140,126140,-790,-790,8,100.91,70
,20160815,126140,126140,125540,125900,125020,125020,125600,-1120,-540,12,150.72,66
,20160816,125020,125600,125090,125560,125090,125500,125380,-100,-220,6,75.23,70
,20160817,125500,125380,125360,125360,125200,125200,125280,-180,-100,4,50.11,70
,20160818,125200,125280,125520,125520,125070,125070,125290,-210,10,4,50.12,70
,20160819,125070,125290,125540,125540,125500,125500,125520,210,230,8,100.42,78
,20160822,125500,125520,126050,126230,126050,126230,126170,710,650,6,75.70,78
,20160823,126230,126170,124850,124850,124850,124850,124850,-1320,-1320,2,24.97,78
,20160824,124850,124850,,,,125010,125010,160,160,0,0.00,78
,20160825,125010,125010,126060,126060,124030,124610,125030,-400,20,66,825.23,112
,20160826,124610,125030,,,,125030,125030,0,0,0,0.00,112
,20160829,125030,125030,126090,126130,125570,125570,125920,540,890,10,125.93,112
,20160830,125570,125920,125800,125800,125500,125560,125570,-360,-350,38,477.19,118
,20160831,125560,125570,125530,125530,124970,125080,125160,-490,-410,26,325.42,124
,20160901,125080,125160,125110,126230,125010,125910,125280,750,120,156,"1,954.39",206
,20160902,125910,125280,125710,128480,125590,126610,126620,1330,1340,60,759.74,214
,20160905,126610,126620,128310,128850,128240,128240,128470,1620,1850,8,102.78,216
,20160906,128240,128470,127140,127550,127140,127340,127390,-1130,-1080,8,101.91,216
,20160907,127340,127390,127340,127940,127340,127940,127490,550,100,8,101.99,210
,20160908,127940,127490,129340,129340,127630,127800,128170,310,680,12,153.81,210
,20160909,127800,128170,127640,127640,127230,127230,127430,-940,-740,4,50.97,210
,20160912,127230,127430,126290,126290,122880,123000,123950,-4430,-3480,174,"2,156.89",124
,20160913,123000,123950,123000,124410,123000,123610,123720,-340,-230,28,346.42,116
,20160914,123610,123720,123200,123200,122810,123000,123010,-720,-710,32,393.66,110
,20160919,123000,123010,126810,126810,124610,124880,125430,1870,2420,6,75.26,110
,20160920,124880,125430,125500,125500,124290,125490,125230,60,-200,14,175.33,108
,20160921,125490,125230,126300,126300,125150,125150,125730,-80,500,10,125.74,112
,20160922,125150,125730,122240,126990,122240,126990,125910,1260,180,32,402.93,112
,20160923,126990,125910,127100,128200,126520,128100,127350,2190,1440,34,433.01,122
,20160926,128100,127350,127820,127820,127650,127760,127740,410,390,10,127.74,118
,20160927,127760,127740,127920,128000,126420,128000,127160,260,-580,12,152.60,120
,20160928,128000,127160,127300,128440,127140,127650,127800,490,640,38,485.66,128
,20160929,127650,127800,128610,130460,127820,129000,129710,1200,1910,98,"1,271.21",156
,20160930,129000,129710,129180,129680,128830,129680,129220,-30,-490,32,413.51,142
,20161010,129680,129220,128960,128960,128960,128960,128960,-260,-260,2,25.79,144
,20161011,128960,128960,130100,130440,127940,130240,129890,1280,930,100,"1,298.94",194
,20161012,130240,129890,129730,129890,129000,129550,129520,-340,-370,58,751.23,166
,20161013,129550,129520,130010,130010,128740,128740,129290,-780,-230,12,155.15,160
,20161014,128740,129290,128310,128890,128110,128290,128280,-1000,-1010,18,230.92,160
,20161017,128290,128280,128130,129020,128130,129020,128560,740,280,8,102.85,156
,20161018,129020,128560,128620,130220,128620,130220,129390,1660,830,32,414.05,158
,20161019,130220,129390,129370,129440,129370,129440,129410,50,20,6,77.65,158
,20161020,129440,129410,129590,130380,129330,130010,129920,600,510,124,"1,611.10",224
,20161021,130010,129920,131160,132500,128520,132160,131440,2240,1520,106,"1,393.30",272
,20161024,132160,131440,134580,134580,131840,132360,132320,920,880,44,582.24,280
,20161025,132360,132320,132810,135310,132700,135310,134590,2990,2270,152,"2,045.87",280
,20161026,135310,134590,135310,136160,133160,133800,134020,-790,-570,164,"2,198.06",314
,20161027,133800,134020,134450,134590,133280,133750,134120,-270,100,160,"2,145.92",376
,20161028,133750,134120,133460,135990,132860,135990,134710,1870,590,98,"1,320.20",394
,20161031,135990,134710,136310,136380,134580,135150,135270,440,560,34,459.93,390
,20161101,135150,135270,136010,138300,135490,137800,137320,2530,2050,144,"1,977.53",406
,20161102,137800,137320,137590,138440,136050,136050,137480,-1270,160,228,"3,134.73",426
,20161103,136050,137480,137030,137770,136510,137770,136970,290,-510,44,602.71,424
,20161104,137770,136970,139030,143800,138810,143280,141310,6310,4340,482,"6,811.21",468
,20161107,143280,141310,140030,148370,140030,148370,144950,7060,3640,692,"10,030.72",488
,20161108,148370,144950,148930,152190,147740,151020,150540,6070,5590,836,"12,585.96",580
,20161109,151020,150540,151000,155550,148950,152160,153120,1620,2580,2632,"40,302.67",1656
,20161110,152160,153120,154270,157720,150870,156490,154900,3370,1780,1666,"25,807.94",1846
,20161111,156490,154900,155990,156770,152370,155290,154480,390,-420,778,"12,019.18",1878
,20161114,155290,154480,153400,159560,145210,147400,149820,-7080,-4660,2258,"33,830.85",1256
,20161115,147400,149820,147710,154010,144440,145730,148180,-4090,-1640,1316,"19,501.72",1198
,20161116,145730,148180,144500,147140,143800,146280,145940,-1900,-2240,954,"13,922.96",1136
,20161117,146280,145940,145990,146210,141920,142560,143330,-3380,-2610,1104,"15,824.62",1082
,20161118,142560,143330,143970,145360,140150,141490,143030,-1840,-300,1376,"19,682.29",1044
,20161121,141490,143030,142870,146730,140040,144970,143100,1940,70,1378,"19,719.24",1204
,20161122,144970,143100,146200,150430,145170,149540,147880,6440,4780,834,"12,333.47",1296
,20161123,149540,147880,149090,149770,147110,148670,148640,790,760,476,"7,075.72",1338
,20161124,148670,148640,148630,153400,148060,149040,150140,400,1500,1814,"27,236.61",1790
,20161125,149040,150140,149040,150720,145550,147910,148020,-2230,-2120,1016,"15,039.74",1880
,20161128,147910,148020,147150,150790,145960,150790,148850,2770,830,1252,"18,636.89",1820
,20161129,150790,148850,151840,151840,144330,145100,147910,-3750,-940,1400,"20,708.67",1886
,20161130,145100,147910,146950,146960,139290,141540,142610,-6370,-5300,1780,"25,386.04",1862
,20161201,141540,142610,143450,147960,143350,147520,145710,4910,3100,2058,"29,988.06",2040
,20161202,147520,145710,147410,147720,144300,146000,146030,290,320,1912,"27,921.82",1936
,20161205,146000,146030,145990,147390,144710,146080,146040,50,10,1640,"23,951.70",2032
,20161206,146080,146040,146650,147340,145030,146590,146570,550,530,1588,"23,275.93",2136
,20161207,146590,146570,146600,148760,145450,147890,146580,1320,10,1666,"24,421.60",2258
,20161208,147890,146580,148500,149520,145910,146650,147520,70,940,2446,"36,085.37",2238
,20161209,146650,147520,147630,148000,144300,145830,146000,-1690,-1520,1710,"24,966.14",2262
,20161212,145830,146000,146070,147200,145000,145370,146160,-630,160,2078,"30,372.59",2424
,20161213,145370,146160,145370,149800,144000,149200,147080,3040,920,2852,"41,948.75",2820
,20161214,149200,147080,150000,150610,146620,149190,148910,2110,1830,3448,"51,345.89",2872
,20161215,149190,148910,149190,151000,147320,151000,149900,2090,990,3638,"54,536.85",3686
,20161216,151000,149900,150980,150980,148830,149160,149830,-740,-70,2916,"43,691.27",3846
,20161219,149160,149830,148500,149930,144900,145120,147580,-4710,-2250,3776,"55,727.42",3806
,20161220,145120,147580,144940,145700,143050,144670,144370,-2910,-3210,3896,"56,248.73",3930
,20161221,144670,144370,144980,146750,144620,145610,145350,1240,980,2402,"34,914.70",4216
,20161222,145610,145350,146500,146500,144070,144100,144850,-1250,-500,3044,"44,092.59",4652
,20161223,144100,144850,144000,146430,143420,145100,145050,250,200,4182,"60,660.97",4990
,20161226,145100,145050,146500,146500,138410,141500,142130,-3550,-2920,11048,"157,036.22",6144
,20161227,141500,142130,141500,145710,140810,145000,142290,2870,160,6124,"87,141.05",6578
,20161228,145000,142290,144800,147550,144620,146980,146180,4690,3890,9556,"139,692.26",6736
,20161229,146980,146180,146680,148400,145430,147810,146810,1630,630,13184,"193,563.16",8600
,20161230,147810,146810,147700,148370,145800,146820,146890,10,80,12402,"182,180.79",8344
sn1706,20160616,119490,119490,,,,119980,119980,490,490,0,0.00,0
,20160617,119980,119980,,,,118730,118730,-1250,-1250,0,0.00,0
,20160620,118730,118730,,,,116770,116770,-1960,-1960,0,0.00,0
,20160621,116770,116770,,,,119990,119990,3220,3220,0,0.00,0
,20160622,119990,119990,,,,119670,119670,-320,-320,0,0.00,0
,20160623,119670,119670,,,,119760,119760,90,90,0,0.00,0
,20160624,119760,119760,,,,120140,120140,380,380,0,0.00,0
,20160627,120140,120140,,,,120170,120170,30,30,0,0.00,0
,20160628,120170,120170,,,,119700,119700,-470,-470,0,0.00,0
,20160629,119700,119700,,,,112840,112840,-6860,-6860,0,0.00,0
,20160630,112840,112840,,,,112870,112870,30,30,0,0.00,0
,20160701,112870,112870,117710,117710,111530,111530,114620,-1340,1750,4,45.85,0
,20160704,111530,114620,120340,120340,120340,120340,120340,5720,5720,4,48.14,4
,20160705,120340,120340,,,,121150,121150,810,810,0,0.00,4
,20160706,121150,121150,117200,117200,117200,117200,117200,-3950,-3950,4,46.88,0
,20160707,117200,117200,,,,118000,118000,800,800,0,0.00,0
,20160708,118000,118000,,,,112820,112820,-5180,-5180,0,0.00,0
,20160711,112820,112820,,,,114610,114610,1790,1790,0,0.00,0
,20160712,114610,114610,,,,116250,116250,1640,1640,0,0.00,0
,20160713,116250,116250,,,,116140,116140,-110,-110,0,0.00,0
,20160714,116140,116140,,,,115270,115270,-870,-870,0,0.00,0
,20160715,115270,115270,,,,115820,115820,550,550,0,0.00,0
,20160718,115820,115820,,,,116010,116010,190,190,0,0.00,0
,20160719,116010,116010,,,,114950,114950,-1060,-1060,0,0.00,0
,20160720,114950,114950,,,,113640,113640,-1310,-1310,0,0.00,0
,20160721,113640,113640,119320,119320,119320,119320,119320,5680,5680,2,23.86,2
,20160722,119320,119320,,,,120510,120510,1190,1190,0,0.00,2
,20160725,120510,120510,,,,120510,120510,0,0,0,0.00,2
,20160726,120510,120510,,,,120510,120510,0,0,0,0.00,2
,20160727,120510,120510,,,,121500,121500,990,990,0,0.00,2
,20160728,121500,121500,,,,121500,121500,0,0,0,0.00,2
,20160729,121500,121500,,,,120960,120960,-540,-540,0,0.00,2
,20160801,120960,120960,,,,120730,120730,-230,-230,0,0.00,2
,20160802,120730,120730,,,,121250,121250,520,520,0,0.00,2
,20160803,121250,121250,,,,121400,121400,150,150,0,0.00,2
,20160804,121400,121400,,,,119290,119290,-2110,-2110,0,0.00,2
,20160805,119290,119290,,,,120030,120030,740,740,0,0.00,2
,20160808,120030,120030,,,,123400,123400,3370,3370,0,0.00,2
,20160809,123400,123400,,,,122450,122450,-950,-950,0,0.00,2
,20160810,122450,122450,,,,123000,123000,550,550,0,0.00,2
,20160811,123000,123000,,,,123480,123480,480,480,0,0.00,2
,20160812,123480,123480,,,,122710,122710,-770,-770,0,0.00,2
,20160815,122710,122710,,,,122180,122180,-530,-530,0,0.00,2
,20160816,122180,122180,,,,121960,121960,-220,-220,0,0.00,2
,20160817,121960,121960,,,,124000,124000,2040,2040,0,0.00,2
,20160818,124000,124000,,,,124010,124010,10,10,0,0.00,2
,20160819,124010,124010,,,,124230,124230,220,220,0,0.00,2
,20160822,124230,124230,,,,124870,124870,640,640,0,0.00,2
,20160823,124870,124870,,,,123560,123560,-1310,-1310,0,0.00,2
,20160824,123560,123560,,,,125410,125410,1850,1850,0,0.00,2
,20160825,125410,125410,,,,125430,125430,20,20,0,0.00,2
,20160826,125430,125430,,,,125450,125450,20,20,0,0.00,2
,20160829,125450,125450,,,,126350,126350,900,900,0,0.00,2
,20160830,126350,126350,,,,126000,126000,-350,-350,0,0.00,2
,20160831,126000,126000,,,,125580,125580,-420,-420,0,0.00,2
,20160901,125580,125580,,,,125700,125700,120,120,0,0.00,2
,20160902,125700,125700,,,,127040,127040,1340,1340,0,0.00,2
,20160905,127040,127040,,,,128900,128900,1860,1860,0,0.00,2
,20160906,128900,128900,,,,127810,127810,-1090,-1090,0,0.00,2
,20160907,127810,127810,,,,127910,127910,100,100,0,0.00,2
,20160908,127910,127910,,,,128590,128590,680,680,0,0.00,2
,20160909,128590,128590,,,,127850,127850,-740,-740,0,0.00,2
,20160912,127850,127850,,,,124360,124360,-3490,-3490,0,0.00,2
,20160913,124360,124360,,,,124130,124130,-230,-230,0,0.00,2
,20160914,124130,124130,,,,123420,123420,-710,-710,0,0.00,2
,20160919,123420,123420,,,,125850,125850,2430,2430,0,0.00,2
,20160920,125850,125850,,,,125650,125650,-200,-200,0,0.00,2
,20160921,125650,125650,,,,126150,126150,500,500,0,0.00,2
,20160922,126150,126150,,,,126330,126330,180,180,0,0.00,2
,20160923,126330,126330,,,,127780,127780,1450,1450,0,0.00,2
,20160926,127780,127780,,,,128170,128170,390,390,0,0.00,2
,20160927,128170,128170,,,,128170,128170,0,0,0,0.00,2
,20160928,128170,128170,,,,128170,128170,0,0,0,0.00,2
,20160929,128170,128170,,,,130090,130090,1920,1920,0,0.00,2
,20160930,130090,130090,,,,129600,129600,-490,-490,0,0.00,2
,20161010,129600,129600,,,,129330,129330,-270,-270,0,0.00,2
,20161011,129330,129330,,,,130260,130260,930,930,0,0.00,2
,20161012,130260,130260,,,,130260,130260,0,0,0,0.00,2
,20161013,130260,130260,,,,130030,130030,-230,-230,0,0.00,2
,20161014,130030,130030,,,,130030,130030,0,0,0,0.00,2
,20161017,130030,130030,,,,130310,130310,280,280,0,0.00,2
,20161018,130310,130310,,,,131150,131150,840,840,0,0.00,2
,20161019,131150,131150,,,,131170,131170,20,20,0,0.00,2
,20161020,131170,131170,,,,131690,131690,520,520,0,0.00,2
,20161021,131690,131690,,,,133230,133230,1540,1540,0,0.00,2
,20161024,133230,133230,,,,134120,134120,890,890,0,0.00,2
,20161025,134120,134120,,,,136420,136420,2300,2300,0,0.00,2
,20161026,136420,136420,,,,135850,135850,-570,-570,0,0.00,2
,20161027,135850,135850,,,,135950,135950,100,100,0,0.00,2
,20161028,135950,135950,,,,136550,136550,600,600,0,0.00,2
,20161031,136550,136550,,,,137120,137120,570,570,0,0.00,2
,20161101,137120,137120,,,,139200,139200,2080,2080,0,0.00,2
,20161102,139200,139200,,,,139070,139070,-130,-130,0,0.00,2
,20161103,139070,139070,,,,138560,138560,-510,-510,0,0.00,2
,20161104,138560,138560,142500,142500,142500,142500,142500,3940,3940,2,28.50,2
,20161107,142500,142500,,,,146170,146170,3670,3670,0,0.00,2
,20161108,146170,146170,,,,151810,151810,5640,5640,0,0.00,2
,20161109,151810,151810,,,,154410,154410,2600,2600,0,0.00,2
,20161110,154410,154410,158610,158610,158610,158610,158610,4200,4200,2,31.72,4
,20161111,158610,158610,,,,158180,158180,-430,-430,0,0.00,4
,20161114,158180,158180,151530,151530,148680,148680,150100,-9500,-8080,4,60.04,4
,20161115,148680,150100,,,,148460,148460,-1640,-1640,0,0.00,4
,20161116,148460,148460,,,,146210,146210,-2250,-2250,0,0.00,4
,20161117,146210,146210,,,,143600,143600,-2610,-2610,0,0.00,4
,20161118,143600,143600,,,,143300,143300,-300,-300,0,0.00,4
,20161121,143300,143300,144350,148480,142910,148480,145140,5180,1840,12,174.18,4
,20161122,148480,145140,,,,149990,149990,4850,4850,0,0.00,4
,20161123,149990,149990,,,,150770,150770,780,780,0,0.00,4
,20161124,150770,150770,,,,152290,152290,1520,1520,0,0.00,4
,20161125,152290,152290,,,,150140,150140,-2150,-2150,0,0.00,4
,20161128,150140,150140,,,,150980,150980,840,840,0,0.00,4
,20161129,150980,150980,,,,150030,150030,-950,-950,0,0.00,4
,20161130,150030,150030,,,,144660,144660,-5370,-5370,0,0.00,4
,20161201,144660,144660,,,,147800,147800,3140,3140,0,0.00,4
,20161202,147800,147800,,,,148120,148120,320,320,0,0.00,4
,20161205,148120,148120,,,,148130,148130,10,10,0,0.00,4
,20161206,148130,148130,,,,148670,148670,540,540,0,0.00,4
,20161207,148670,148670,,,,148680,148680,10,10,0,0.00,4
,20161208,148680,148680,,,,149640,149640,960,960,0,0.00,4
,20161209,149640,149640,,,,148090,148090,-1550,-1550,0,0.00,4
,20161212,148090,148090,147000,147000,145200,145200,146100,-2890,-1990,4,58.44,4
,20161213,145200,146100,,,,147020,147020,920,920,0,0.00,4
,20161214,147020,147020,,,,148850,148850,1830,1830,0,0.00,4
,20161215,148850,148850,,,,149840,149840,990,990,0,0.00,4
,20161216,149840,149840,,,,149770,149770,-70,-70,0,0.00,4
,20161219,149770,149770,,,,147520,147520,-2250,-2250,0,0.00,4
,20161220,147520,147520,,,,144310,144310,-3210,-3210,0,0.00,4
,20161221,144310,144310,,,,145290,145290,980,980,0,0.00,4
,20161222,145290,145290,,,,144790,144790,-500,-500,0,0.00,4
,20161223,144790,144790,,,,144990,144990,200,200,0,0.00,4
,20161226,144990,144990,,,,142080,142080,-2910,-2910,0,0.00,4
,20161227,142080,142080,,,,142240,142240,160,160,0,0.00,4
,20161228,142240,142240,145000,145000,145000,145000,145000,2760,2760,2,29.00,4
,20161229,145000,145000,,,,145630,145630,630,630,0,0.00,4
,20161230,145630,145630,,,,145710,145710,80,80,0,0.00,4
sn1707,20160718,115820,115820,,,,116010,116010,190,190,0,0.00,0
,20160719,116010,116010,,,,114950,114950,-1060,-1060,0,0.00,0
,20160720,114950,114950,,,,113640,113640,-1310,-1310,0,0.00,0
,20160721,113640,113640,,,,119320,119320,5680,5680,0,0.00,0
,20160722,119320,119320,,,,120490,120490,1170,1170,0,0.00,0
,20160725,120490,120490,,,,119290,119290,-1200,-1200,0,0.00,0
,20160726,119290,119290,,,,119370,119370,80,80,0,0.00,0
,20160727,119370,119370,,,,121710,121710,2340,2340,0,0.00,0
,20160728,121710,121710,,,,123140,123140,1430,1430,0,0.00,0
,20160729,123140,123140,,,,122590,122590,-550,-550,0,0.00,0
,20160801,122590,122590,,,,122360,122360,-230,-230,0,0.00,0
,20160802,122360,122360,,,,122880,122880,520,520,0,0.00,0
,20160803,122880,122880,,,,123030,123030,150,150,0,0.00,0
,20160804,123030,123030,,,,120890,120890,-2140,-2140,0,0.00,0
,20160805,120890,120890,,,,121640,121640,750,750,0,0.00,0
,20160808,121640,121640,,,,125050,125050,3410,3410,0,0.00,0
,20160809,125050,125050,,,,124090,124090,-960,-960,0,0.00,0
,20160810,124090,124090,,,,126090,126090,2000,2000,0,0.00,0
,20160811,126090,126090,,,,126580,126580,490,490,0,0.00,0
,20160812,126580,126580,,,,125790,125790,-790,-790,0,0.00,0
,20160815,125790,125790,,,,125250,125250,-540,-540,0,0.00,0
,20160816,125250,125250,,,,125030,125030,-220,-220,0,0.00,0
,20160817,125030,125030,,,,124930,124930,-100,-100,0,0.00,0
,20160818,124930,124930,,,,124940,124940,10,10,0,0.00,0
,20160819,124940,124940,,,,125160,125160,220,220,0,0.00,0
,20160822,125160,125160,,,,125800,125800,640,640,0,0.00,0
,20160823,125800,125800,,,,124480,124480,-1320,-1320,0,0.00,0
,20160824,124480,124480,,,,126340,126340,1860,1860,0,0.00,0
,20160825,126340,126340,,,,126360,126360,20,20,0,0.00,0
,20160826,126360,126360,,,,126380,126380,20,20,0,0.00,0
,20160829,126380,126380,,,,127280,127280,900,900,0,0.00,0
,20160830,127280,127280,,,,126930,126930,-350,-350,0,0.00,0
,20160831,126930,126930,,,,126510,126510,-420,-420,0,0.00,0
,20160901,126510,126510,,,,126630,126630,120,120,0,0.00,0
,20160902,126630,126630,,,,127980,127980,1350,1350,0,0.00,0
,20160905,127980,127980,,,,129850,129850,1870,1870,0,0.00,0
,20160906,129850,129850,,,,128760,128760,-1090,-1090,0,0.00,0
,20160907,128760,128760,,,,128860,128860,100,100,0,0.00,0
,20160908,128860,128860,,,,129550,129550,690,690,0,0.00,0
,20160909,129550,129550,,,,128800,128800,-750,-750,0,0.00,0
,20160912,128800,128800,,,,125290,125290,-3510,-3510,0,0.00,0
,20160913,125290,125290,,,,125050,125050,-240,-240,0,0.00,0
,20160914,125050,125050,,,,124340,124340,-710,-710,0,0.00,0
,20160919,124340,124340,,,,126780,126780,2440,2440,0,0.00,0
,20160920,126780,126780,,,,126580,126580,-200,-200,0,0.00,0
,20160921,126580,126580,,,,127090,127090,510,510,0,0.00,0
,20160922,127090,127090,,,,127270,127270,180,180,0,0.00,0
,20160923,127270,127270,,,,128730,128730,1460,1460,0,0.00,0
,20160926,128730,128730,,,,129120,129120,390,390,0,0.00,0
,20160927,129120,129120,,,,128540,128540,-580,-580,0,0.00,0
,20160928,128540,128540,,,,129190,129190,650,650,0,0.00,0
,20160929,129190,129190,,,,131120,131120,1930,1930,0,0.00,0
,20160930,131120,131120,,,,130620,130620,-500,-500,0,0.00,0
,20161010,130620,130620,,,,130350,130350,-270,-270,0,0.00,0
,20161011,130350,130350,,,,131290,131290,940,940,0,0.00,0
,20161012,131290,131290,,,,130910,130910,-380,-380,0,0.00,0
,20161013,130910,130910,,,,130670,130670,-240,-240,0,0.00,0
,20161014,130670,130670,,,,129650,129650,-1020,-1020,0,0.00,0
,20161017,129650,129650,,,,129930,129930,280,280,0,0.00,0
,20161018,129930,129930,,,,130760,130760,830,830,0,0.00,0
,20161019,130760,130760,,,,130780,130780,20,20,0,0.00,0
,20161020,130780,130780,,,,131300,131300,520,520,0,0.00,0
,20161021,131300,131300,,,,132830,132830,1530,1530,0,0.00,0
,20161024,132830,132830,,,,133720,133720,890,890,0,0.00,0
,20161025,133720,133720,,,,136020,136020,2300,2300,0,0.00,0
,20161026,136020,136020,,,,135450,135450,-570,-570,0,0.00,0
,20161027,135450,135450,,,,135550,135550,100,100,0,0.00,0
,20161028,135550,135550,,,,136150,136150,600,600,0,0.00,0
,20161031,136150,136150,,,,136710,136710,560,560,0,0.00,0
,20161101,136710,136710,,,,138790,138790,2080,2080,0,0.00,0
,20161102,138790,138790,,,,138790,138790,0,0,0,0.00,0
,20161103,138790,138790,,,,138280,138280,-510,-510,0,0.00,0
,20161104,138280,138280,,,,142210,142210,3930,3930,0,0.00,0
,20161107,142210,142210,,,,145000,145000,2790,2790,0,0.00,0
,20161108,145000,145000,,,,150600,150600,5600,5600,0,0.00,0
,20161109,150600,150600,,,,153180,153180,2580,2580,0,0.00,0
,20161110,153180,153180,,,,157340,157340,4160,4160,0,0.00,0
,20161111,157340,157340,,,,156920,156920,-420,-420,0,0.00,0
,20161114,156920,156920,,,,148900,148900,-8020,-8020,0,0.00,0
,20161115,148900,148900,,,,147270,147270,-1630,-1630,0,0.00,0
,20161116,147270,147270,,,,145040,145040,-2230,-2230,0,0.00,0
,20161117,145040,145040,,,,142450,142450,-2590,-2590,0,0.00,0
,20161118,142450,142450,,,,142160,142160,-290,-290,0,0.00,0
,20161121,142160,142160,,,,143990,143990,1830,1830,0,0.00,0
,20161122,143990,143990,,,,148800,148800,4810,4810,0,0.00,0
,20161123,148800,148800,,,,149570,149570,770,770,0,0.00,0
,20161124,149570,149570,,,,151080,151080,1510,1510,0,0.00,0
,20161125,151080,151080,,,,148950,148950,-2130,-2130,0,0.00,0
,20161128,148950,148950,,,,149790,149790,840,840,0,0.00,0
,20161129,149790,149790,,,,148850,148850,-940,-940,0,0.00,0
,20161130,148850,148850,,,,143520,143520,-5330,-5330,0,0.00,0
,20161201,143520,143520,,,,146640,146640,3120,3120,0,0.00,0
,20161202,146640,146640,,,,146960,146960,320,320,0,0.00,0
,20161205,146960,146960,,,,146970,146970,10,10,0,0.00,0
,20161206,146970,146970,,,,147500,147500,530,530,0,0.00,0
,20161207,147500,147500,,,,147510,147510,10,10,0,0.00,0
,20161208,147510,147510,,,,148460,148460,950,950,0,0.00,0
,20161209,148460,148460,,,,146930,146930,-1530,-1530,0,0.00,0
,20161212,146930,146930,,,,144950,144950,-1980,-1980,0,0.00,0
,20161213,144950,144950,,,,145860,145860,910,910,0,0.00,0
,20161214,145860,145860,,,,147670,147670,1810,1810,0,0.00,0
,20161215,147670,147670,,,,148660,148660,990,990,0,0.00,0
,20161216,148660,148660,,,,148590,148590,-70,-70,0,0.00,0
,20161219,148590,148590,,,,146360,146360,-2230,-2230,0,0.00,0
,20161220,146360,146360,,,,143180,143180,-3180,-3180,0,0.00,0
,20161221,143180,143180,,,,144150,144150,970,970,0,0.00,0
,20161222,144150,144150,,,,143650,143650,-500,-500,0,0.00,0
,20161223,143650,143650,,,,143850,143850,200,200,0,0.00,0
,20161226,143850,143850,,,,140960,140960,-2890,-2890,0,0.00,0
,20161227,140960,140960,,,,141120,141120,160,160,0,0.00,0
,20161228,141120,141120,,,,143850,143850,2730,2730,0,0.00,0
,20161229,143850,143850,,,,144470,144470,620,620,0,0.00,0
,20161230,144470,144470,,,,144550,144550,80,80,0,0.00,0
sn1708,20160816,125250,125250,,,,125030,125030,-220,-220,0,0.00,0
,20160817,125030,125030,,,,124930,124930,-100,-100,0,0.00,0
,20160818,124930,124930,,,,124940,124940,10,10,0,0.00,0
,20160819,124940,124940,,,,125160,125160,220,220,0,0.00,0
,20160822,125160,125160,,,,125800,125800,640,640,0,0.00,0
,20160823,125800,125800,,,,124480,124480,-1320,-1320,0,0.00,0
,20160824,124480,124480,,,,126340,126340,1860,1860,0,0.00,0
,20160825,126340,126340,,,,126360,126360,20,20,0,0.00,0
,20160826,126360,126360,,,,126380,126380,20,20,0,0.00,0
,20160829,126380,126380,,,,127280,127280,900,900,0,0.00,0
,20160830,127280,127280,,,,126930,126930,-350,-350,0,0.00,0
,20160831,126930,126930,,,,126510,126510,-420,-420,0,0.00,0
,20160901,126510,126510,,,,126630,126630,120,120,0,0.00,0
,20160902,126630,126630,,,,127980,127980,1350,1350,0,0.00,0
,20160905,127980,127980,,,,129850,129850,1870,1870,0,0.00,0
,20160906,129850,129850,,,,128760,128760,-1090,-1090,0,0.00,0
,20160907,128760,128760,,,,128860,128860,100,100,0,0.00,0
,20160908,128860,128860,,,,129550,129550,690,690,0,0.00,0
,20160909,129550,129550,,,,128800,128800,-750,-750,0,0.00,0
,20160912,128800,128800,,,,125290,125290,-3510,-3510,0,0.00,0
,20160913,125290,125290,,,,125050,125050,-240,-240,0,0.00,0
,20160914,125050,125050,,,,124340,124340,-710,-710,0,0.00,0
,20160919,124340,124340,,,,126780,126780,2440,2440,0,0.00,0
,20160920,126780,126780,,,,126580,126580,-200,-200,0,0.00,0
,20160921,126580,126580,,,,127090,127090,510,510,0,0.00,0
,20160922,127090,127090,,,,127270,127270,180,180,0,0.00,0
,20160923,127270,127270,,,,128730,128730,1460,1460,0,0.00,0
,20160926,128730,128730,,,,129120,129120,390,390,0,0.00,0
,20160927,129120,129120,,,,128540,128540,-580,-580,0,0.00,0
,20160928,128540,128540,,,,129190,129190,650,650,0,0.00,0
,20160929,129190,129190,,,,131120,131120,1930,1930,0,0.00,0
,20160930,131120,131120,,,,130620,130620,-500,-500,0,0.00,0
,20161010,130620,130620,,,,130350,130350,-270,-270,0,0.00,0
,20161011,130350,130350,,,,131290,131290,940,940,0,0.00,0
,20161012,131290,131290,,,,130910,130910,-380,-380,0,0.00,0
,20161013,130910,130910,,,,130670,130670,-240,-240,0,0.00,0
,20161014,130670,130670,,,,129650,129650,-1020,-1020,0,0.00,0
,20161017,129650,129650,,,,129930,129930,280,280,0,0.00,0
,20161018,129930,129930,,,,130760,130760,830,830,0,0.00,0
,20161019,130760,130760,,,,130780,130780,20,20,0,0.00,0
,20161020,130780,130780,,,,131300,131300,520,520,0,0.00,0
,20161021,131300,131300,,,,132830,132830,1530,1530,0,0.00,0
,20161024,132830,132830,,,,133720,133720,890,890,0,0.00,0
,20161025,133720,133720,,,,136020,136020,2300,2300,0,0.00,0
,20161026,136020,136020,,,,135450,135450,-570,-570,0,0.00,0
,20161027,135450,135450,,,,135550,135550,100,100,0,0.00,0
,20161028,135550,135550,,,,136150,136150,600,600,0,0.00,0
,20161031,136150,136150,,,,136710,136710,560,560,0,0.00,0
,20161101,136710,136710,,,,138790,138790,2080,2080,0,0.00,0
,20161102,138790,138790,,,,138950,138950,160,160,0,0.00,0
,20161103,138950,138950,,,,138440,138440,-510,-510,0,0.00,0
,20161104,138440,138440,,,,142370,142370,3930,3930,0,0.00,0
,20161107,142370,142370,,,,144880,144880,2510,2510,0,0.00,0
,20161108,144880,144880,,,,150470,150470,5590,5590,0,0.00,0
,20161109,150470,150470,,,,153050,153050,2580,2580,0,0.00,0
,20161110,153050,153050,,,,157210,157210,4160,4160,0,0.00,0
,20161111,157210,157210,,,,156790,156790,-420,-420,0,0.00,0
,20161114,156790,156790,,,,148780,148780,-8010,-8010,0,0.00,0
,20161115,148780,148780,,,,147160,147160,-1620,-1620,0,0.00,0
,20161116,147160,147160,,,,144930,144930,-2230,-2230,0,0.00,0
,20161117,144930,144930,,,,142340,142340,-2590,-2590,0,0.00,0
,20161118,142340,142340,,,,142050,142050,-290,-290,0,0.00,0
,20161121,142050,142050,,,,143880,143880,1830,1830,0,0.00,0
,20161122,143880,143880,,,,148680,148680,4800,4800,0,0.00,0
,20161123,148680,148680,,,,149450,149450,770,770,0,0.00,0
,20161124,149450,149450,,,,150960,150960,1510,1510,0,0.00,0
,20161125,150960,150960,,,,148830,148830,-2130,-2130,0,0.00,0
,20161128,148830,148830,,,,149670,149670,840,840,0,0.00,0
,20161129,149670,149670,,,,148730,148730,-940,-940,0,0.00,0
,20161130,148730,148730,,,,143400,143400,-5330,-5330,0,0.00,0
,20161201,143400,143400,,,,146520,146520,3120,3120,0,0.00,0
,20161202,146520,146520,,,,146840,146840,320,320,0,0.00,0
,20161205,146840,146840,,,,146850,146850,10,10,0,0.00,0
,20161206,146850,146850,,,,147380,147380,530,530,0,0.00,0
,20161207,147380,147380,,,,147390,147390,10,10,0,0.00,0
,20161208,147390,147390,,,,148340,148340,950,950,0,0.00,0
,20161209,148340,148340,,,,146810,146810,-1530,-1530,0,0.00,0
,20161212,146810,146810,,,,144830,144830,-1980,-1980,0,0.00,0
,20161213,144830,144830,,,,145740,145740,910,910,0,0.00,0
,20161214,145740,145740,,,,147550,147550,1810,1810,0,0.00,0
,20161215,147550,147550,,,,148530,148530,980,980,0,0.00,0
,20161216,148530,148530,,,,148460,148460,-70,-70,0,0.00,0
,20161219,148460,148460,,,,146230,146230,-2230,-2230,0,0.00,0
,20161220,146230,146230,,,,143050,143050,-3180,-3180,0,0.00,0
,20161221,143050,143050,,,,144020,144020,970,970,0,0.00,0
,20161222,144020,144020,,,,143520,143520,-500,-500,0,0.00,0
,20161223,143520,143520,,,,143720,143720,200,200,0,0.00,0
,20161226,143720,143720,,,,140830,140830,-2890,-2890,0,0.00,0
,20161227,140830,140830,,,,140990,140990,160,160,0,0.00,0
,20161228,140990,140990,,,,143720,143720,2730,2730,0,0.00,0
,20161229,143720,143720,,,,144340,144340,620,620,0,0.00,0
,20161230,144340,144340,,,,144420,144420,80,80,0,0.00,0
sn1709,20160920,126780,126780,,,,126780,126780,0,0,0,0.00,0
,20160921,126780,126780,,,,127290,127290,510,510,0,0.00,0
,20160922,127290,127290,,,,127470,127470,180,180,0,0.00,0
,20160923,127470,127470,,,,128930,128930,1460,1460,0,0.00,0
,20160926,128930,128930,,,,129320,129320,390,390,0,0.00,0
,20160927,129320,129320,,,,128740,128740,-580,-580,0,0.00,0
,20160928,128740,128740,,,,129390,129390,650,650,0,0.00,0
,20160929,129390,129390,,,,131320,131320,1930,1930,0,0.00,0
,20160930,131320,131320,,,,130820,130820,-500,-500,0,0.00,0
,20161010,130820,130820,,,,130550,130550,-270,-270,0,0.00,0
,20161011,130550,130550,,,,131490,131490,940,940,0,0.00,0
,20161012,131490,131490,,,,131110,131110,-380,-380,0,0.00,0
,20161013,131110,131110,128910,131820,128910,131820,130360,710,-750,8,104.29,4
,20161014,131820,130360,,,,129350,129350,-1010,-1010,0,0.00,4
,20161017,129350,129350,,,,129350,129350,0,0,0,0.00,4
,20161018,129350,129350,,,,130180,130180,830,830,0,0.00,4
,20161019,130180,130180,,,,130200,130200,20,20,0,0.00,4
,20161020,130200,130200,,,,130720,130720,520,520,0,0.00,4
,20161021,130720,130720,131150,135590,131150,135590,133370,4870,2650,4,53.35,6
,20161024,135590,133370,,,,134270,134270,900,900,0,0.00,6
,20161025,134270,134270,,,,136580,136580,2310,2310,0,0.00,6
,20161026,136580,136580,,,,136000,136000,-580,-580,0,0.00,6
,20161027,136000,136000,,,,136100,136100,100,100,0,0.00,6
,20161028,136100,136100,,,,136700,136700,600,600,0,0.00,6
,20161031,136700,136700,,,,137270,137270,570,570,0,0.00,6
,20161101,137270,137270,,,,139350,139350,2080,2080,0,0.00,6
,20161102,139350,139350,,,,139520,139520,170,170,0,0.00,6
,20161103,139520,139520,,,,139010,139010,-510,-510,0,0.00,6
,20161104,139010,139010,142260,142260,139200,141350,141030,2340,2020,8,112.83,10
,20161107,141350,141030,145200,148080,145060,148080,146800,7050,5770,16,234.89,26
,20161108,148080,146800,153950,156720,150520,153360,152970,6560,6170,34,520.11,38
,20161109,153360,152970,156960,156960,151800,153030,154790,60,1820,16,247.66,36
,20161110,153030,154790,155890,157500,155580,157500,156610,2710,1820,28,438.53,34
,20161111,157500,156610,155290,155290,155180,155180,155210,-1430,-1400,6,93.13,34
,20161114,155180,155210,151000,151180,148110,150200,149650,-5010,-5560,18,269.38,36
,20161115,150200,149650,155420,155420,146170,146170,148050,-3480,-1600,14,207.28,46
,20161116,146170,148050,,,,148050,148050,0,0,0,0.00,46
,20161117,148050,148050,,,,145410,145410,-2640,-2640,0,0.00,46
,20161118,145410,145410,144870,144870,142490,142490,143680,-2920,-1730,12,172.42,40
,20161121,142490,143680,146880,146880,146880,146880,146880,3200,3200,2,29.38,40
,20161122,146880,146880,150140,150140,150140,150140,150140,3260,3260,2,30.03,40
,20161123,150140,150140,,,,150140,150140,0,0,0,0.00,40
,20161124,150140,150140,151450,154000,151450,154000,153150,3860,3010,6,91.89,46
,20161125,154000,153150,,,,150990,150990,-2160,-2160,0,0.00,46
,20161128,150990,150990,149910,150990,149910,150990,150400,0,-590,8,120.32,46
,20161129,150990,150400,,,,149450,149450,-950,-950,0,0.00,46
,20161130,149450,149450,,,,144100,144100,-5350,-5350,0,0.00,46
,20161201,144100,144100,146300,150820,146300,150820,148000,6720,3900,10,148.00,52
,20161202,150820,148000,147570,148010,147030,147320,147250,-680,-750,24,353.42,54
,20161205,147320,147250,,,,147250,147250,0,0,0,0.00,54
,20161206,147250,147250,148650,148650,148650,148650,148650,1400,1400,2,29.73,56
,20161207,148650,148650,,,,148660,148660,10,10,0,0.00,56
,20161208,148660,148660,150960,150960,150940,150960,150950,2300,2290,8,120.76,60
,20161209,150960,150950,148110,148120,148110,148120,148110,-2830,-2840,6,88.87,54
,20161212,148120,148110,147190,148310,147170,148150,147840,40,-270,40,591.40,56
,20161213,148150,147840,148820,151210,148820,150730,150240,2890,2400,8,120.20,50
,20161214,150730,150240,152330,152330,150300,150800,150590,560,350,24,361.43,70
,20161215,150800,150590,150590,151450,150590,151210,151030,620,440,68,"1,027.03",94
,20161216,151210,151030,151030,151030,151030,151030,151030,0,0,2,30.21,92
,20161219,151030,151030,147780,147930,147510,147510,147780,-3520,-3250,10,147.79,92
,20161220,147510,147780,144890,144890,144800,144800,144810,-2980,-2970,26,376.51,78
,20161221,144800,144810,145520,145720,145370,145600,145580,790,770,12,174.70,74
,20161222,145600,145580,145940,145980,144850,144850,145470,-730,-110,8,116.38,78
,20161223,144850,145470,144520,147190,144520,145500,145500,30,30,20,291.00,70
,20161226,145500,145500,146000,146230,140020,142970,142020,-2530,-3480,46,653.30,76
,20161227,142970,142020,143200,145150,142010,145150,143260,3130,1240,28,401.14,78
,20161228,145150,143260,146320,147960,145910,147960,146930,4700,3670,20,293.88,66
,20161229,147960,146930,147290,148000,147250,148000,147570,1070,640,20,295.15,64
,20161230,148000,147570,148560,148990,146970,147860,148060,290,490,30,444.20,74
sn1710,20161018,129350,129350,,,,130180,130180,830,830,0,0.00,0
,20161019,130180,130180,,,,130200,130200,20,20,0,0.00,0
,20161020,130200,130200,,,,130720,130720,520,520,0,0.00,0
,20161021,130720,130720,,,,133370,133370,2650,2650,0,0.00,0
,20161024,133370,133370,,,,134270,134270,900,900,0,0.00,0
,20161025,134270,134270,,,,136580,136580,2310,2310,0,0.00,0
,20161026,136580,136580,,,,136000,136000,-580,-580,0,0.00,0
,20161027,136000,136000,,,,136100,136100,100,100,0,0.00,0
,20161028,136100,136100,,,,136700,136700,600,600,0,0.00,0
,20161031,136700,136700,,,,137270,137270,570,570,0,0.00,0
,20161101,137270,137270,,,,139350,139350,2080,2080,0,0.00,0
,20161102,139350,139350,,,,139350,139350,0,0,0,0.00,0
,20161103,139350,139350,,,,138840,138840,-510,-510,0,0.00,0
,20161104,138840,138840,,,,140860,140860,2020,2020,0,0.00,0
,20161107,140860,140860,,,,146630,146630,5770,5770,0,0.00,0
,20161108,146630,146630,,,,152790,152790,6160,6160,0,0.00,0
,20161109,152790,152790,,,,154600,154600,1810,1810,0,0.00,0
,20161110,154600,154600,,,,156420,156420,1820,1820,0,0.00,0
,20161111,156420,156420,,,,155020,155020,-1400,-1400,0,0.00,0
,20161114,155020,155020,,,,149470,149470,-5550,-5550,0,0.00,0
,20161115,149470,149470,,,,147880,147880,-1590,-1590,0,0.00,0
,20161116,147880,147880,,,,145640,145640,-2240,-2240,0,0.00,0
,20161117,145640,145640,,,,143040,143040,-2600,-2600,0,0.00,0
,20161118,143040,143040,,,,141330,141330,-1710,-1710,0,0.00,0
,20161121,141330,141330,,,,144470,144470,3140,3140,0,0.00,0
,20161122,144470,144470,,,,147670,147670,3200,3200,0,0.00,0
,20161123,147670,147670,,,,148430,148430,760,760,0,0.00,0
,20161124,148430,148430,,,,151400,151400,2970,2970,0,0.00,0
,20161125,151400,151400,,,,149270,149270,-2130,-2130,0,0.00,0
,20161128,149270,149270,,,,148680,148680,-590,-590,0,0.00,0
,20161129,148680,148680,,,,147750,147750,-930,-930,0,0.00,0
,20161130,147750,147750,142560,146020,142560,146020,143500,-1730,-4250,10,143.51,8
,20161201,146020,143500,,,,147380,147380,3880,3880,0,0.00,8
,20161202,147380,147380,148860,148860,148850,148850,148850,1470,1470,6,89.31,8
,20161205,148850,148850,146430,146430,146430,146430,146430,-2420,-2420,4,58.57,4
,20161206,146430,146430,,,,147820,147820,1390,1390,0,0.00,4
,20161207,147820,147820,,,,147830,147830,10,10,0,0.00,4
,20161208,147830,147830,,,,150110,150110,2280,2280,0,0.00,4
,20161209,150110,150110,,,,147280,147280,-2830,-2830,0,0.00,4
,20161212,147280,147280,,,,147020,147020,-260,-260,0,0.00,4
,20161213,147020,147020,,,,149410,149410,2390,2390,0,0.00,4
,20161214,149410,149410,,,,149760,149760,350,350,0,0.00,4
,20161215,149760,149760,151130,151130,151130,151130,151130,1370,1370,4,60.45,4
,20161216,151130,151130,,,,151130,151130,0,0,0,0.00,4
,20161219,151130,151130,,,,147880,147880,-3250,-3250,0,0.00,4
,20161220,147880,147880,,,,144900,144900,-2980,-2980,0,0.00,4
,20161221,144900,144900,,,,145670,145670,770,770,0,0.00,4
,20161222,145670,145670,,,,145550,145550,-120,-120,0,0.00,4
,20161223,145550,145550,146370,146370,146370,146370,146370,820,820,4,58.55,4
,20161226,146370,146370,,,,142870,142870,-3500,-3500,0,0.00,4
,20161227,142870,142870,,,,144120,144120,1250,1250,0,0.00,4
,20161228,144120,144120,,,,147820,147820,3700,3700,0,0.00,4
,20161229,147820,147820,,,,148470,148470,650,650,0,0.00,4
,20161230,148470,148470,,,,148970,148970,500,500,0,0.00,4
sn1711,20161116,147880,147880,,,,145640,145640,-2240,-2240,0,0.00,0
,20161117,145640,145640,,,,143040,143040,-2600,-2600,0,0.00,0
,20161118,143040,143040,,,,141330,141330,-1710,-1710,0,0.00,0
,20161121,141330,141330,,,,144470,144470,3140,3140,0,0.00,0
,20161122,144470,144470,,,,147670,147670,3200,3200,0,0.00,0
,20161123,147670,147670,,,,148430,148430,760,760,0,0.00,0
,20161124,148430,148430,,,,151400,151400,2970,2970,0,0.00,0
,20161125,151400,151400,,,,149270,149270,-2130,-2130,0,0.00,0
,20161128,149270,149270,,,,148680,148680,-590,-590,0,0.00,0
,20161129,148680,148680,,,,147750,147750,-930,-930,0,0.00,0
,20161130,147750,147750,147260,147260,141010,141010,144130,-6740,-3620,4,57.65,2
,20161201,141010,144130,,,,148030,148030,3900,3900,0,0.00,2
,20161202,148030,148030,148870,148870,148870,148870,148870,840,840,2,29.77,4
,20161205,148870,148870,,,,148870,148870,0,0,0,0.00,4
,20161206,148870,148870,,,,150280,150280,1410,1410,0,0.00,4
,20161207,150280,150280,,,,150290,150290,10,10,0,0.00,4
,20161208,150290,150290,,,,152610,152610,2320,2320,0,0.00,4
,20161209,152610,152610,,,,149740,149740,-2870,-2870,0,0.00,4
,20161212,149740,149740,,,,149470,149470,-270,-270,0,0.00,4
,20161213,149470,149470,,,,151900,151900,2430,2430,0,0.00,4
,20161214,151900,151900,,,,152250,152250,350,350,0,0.00,4
,20161215,152250,152250,,,,153640,153640,1390,1390,0,0.00,4
,20161216,153640,153640,,,,153640,153640,0,0,0,0.00,4
,20161219,153640,153640,,,,150330,150330,-3310,-3310,0,0.00,4
,20161220,150330,150330,,,,150330,150330,0,0,0,0.00,4
,20161221,150330,150330,,,,151130,151130,800,800,0,0.00,4
,20161222,151130,151130,,,,151010,151010,-120,-120,0,0.00,4
,20161223,151010,151010,,,,151860,151860,850,850,0,0.00,4
,20161226,151860,151860,141220,141220,141220,141220,141220,-10640,-10640,2,28.24,2
,20161227,141220,141220,146550,146550,146550,146550,146550,5330,5330,2,29.31,2
,20161228,146550,146550,,,,150310,150310,3760,3760,0,0.00,2
,20161229,150310,150310,,,,150970,150970,660,660,0,0.00,2
,20161230,150970,150970,,,,151470,151470,500,500,0,0.00,2
sn1712,20161216,153640,153640,,,,153640,153640,0,0,0,0.00,0
,20161219,153640,153640,,,,150330,150330,-3310,-3310,0,0.00,0
,20161220,150330,150330,,,,147310,147310,-3020,-3020,0,0.00,0
,20161221,147310,147310,,,,148090,148090,780,780,0,0.00,0
,20161222,148090,148090,,,,147970,147970,-120,-120,0,0.00,0
,20161223,147970,147970,,,,148800,148800,830,830,0,0.00,0
,20161226,148800,148800,,,,138370,138370,-10430,-10430,0,0.00,0
,20161227,138370,138370,,,,143590,143590,5220,5220,0,0.00,0
,20161228,143590,143590,,,,147270,147270,3680,3680,0,0.00,0
,20161229,147270,147270,,,,147910,147910,640,640,0,0.00,0
,20161230,147910,147910,,,,148400,148400,490,490,0,0.00,0
wr1601,20160104,2124,2124,,,,2124,2124,0,0,0,0.00,0
,20160105,2124,2124,,,,2124,2124,0,0,0,0.00,0
,20160106,2124,2124,,,,2124,2124,0,0,0,0.00,0
,20160107,2124,2124,,,,2124,2124,0,0,0,0.00,0
,20160108,2124,2124,,,,2124,2124,0,0,0,0.00,0
,20160111,2124,2124,,,,2124,2124,0,0,0,0.00,0
,20160112,2124,2124,,,,2124,2124,0,0,0,0.00,0
,20160113,2124,2124,,,,2124,2124,0,0,0,0.00,0
,20160114,2124,2124,,,,2124,2124,0,0,0,0.00,0
,20160115,2124,2124,,,,2124,2124,0,0,0,0.00,0
wr1602,20160104,1830,1830,,,,1830,1830,0,0,0,0.00,0
,20160105,1830,1830,,,,1830,1830,0,0,0,0.00,0
,20160106,1830,1830,,,,1830,1830,0,0,0,0.00,0
,20160107,1830,1830,,,,1830,1830,0,0,0,0.00,0
,20160108,1830,1830,,,,1830,1830,0,0,0,0.00,0
,20160111,1830,1830,,,,1830,1830,0,0,0,0.00,0
,20160112,1830,1830,,,,1830,1830,0,0,0,0.00,0
,20160113,1830,1830,,,,1830,1830,0,0,0,0.00,0
,20160114,1830,1830,,,,1830,1830,0,0,0,0.00,0
,20160115,1830,1830,,,,1830,1830,0,0,0,0.00,0
,20160118,1830,1830,,,,1830,1830,0,0,0,0.00,0
,20160119,1830,1830,,,,1830,1830,0,0,0,0.00,0
,20160120,1830,1830,,,,1830,1830,0,0,0,0.00,0
,20160121,1830,1830,,,,1830,1830,0,0,0,0.00,0
,20160122,1830,1830,,,,1830,1830,0,0,0,0.00,0
,20160125,1830,1830,,,,1830,1830,0,0,0,0.00,0
,20160126,1830,1830,,,,1830,1830,0,0,0,0.00,0
,20160127,1830,1830,,,,1830,1830,0,0,0,0.00,0
,20160128,1830,1830,,,,1830,1830,0,0,0,0.00,0
,20160129,1830,1830,,,,1830,1830,0,0,0,0.00,0
,20160201,1830,1830,,,,1830,1830,0,0,0,0.00,0
,20160202,1830,1830,,,,1830,1830,0,0,0,0.00,0
,20160203,1830,1830,,,,1830,1830,0,0,0,0.00,0
,20160204,1830,1830,,,,1830,1830,0,0,0,0.00,0
,20160205,1830,1830,,,,1830,1830,0,0,0,0.00,0
,20160215,1830,1830,,,,1830,1830,0,0,0,0.00,0
wr1603,20160104,1985,1985,,,,1985,1985,0,0,0,0.00,0
,20160105,1985,1985,,,,1985,1985,0,0,0,0.00,0
,20160106,1985,1985,,,,1985,1985,0,0,0,0.00,0
,20160107,1985,1985,,,,1985,1985,0,0,0,0.00,0
,20160108,1985,1985,,,,1985,1985,0,0,0,0.00,0
,20160111,1985,1985,,,,1985,1985,0,0,0,0.00,0
,20160112,1985,1985,,,,1985,1985,0,0,0,0.00,0
,20160113,1985,1985,,,,1985,1985,0,0,0,0.00,0
,20160114,1985,1985,,,,1985,1985,0,0,0,0.00,0
,20160115,1985,1985,,,,1985,1985,0,0,0,0.00,0
,20160118,1985,1985,,,,1985,1985,0,0,0,0.00,0
,20160119,1985,1985,,,,1985,1985,0,0,0,0.00,0
,20160120,1985,1985,,,,1985,1985,0,0,0,0.00,0
,20160121,1985,1985,,,,1985,1985,0,0,0,0.00,0
,20160122,1985,1985,,,,1985,1985,0,0,0,0.00,0
,20160125,1985,1985,,,,1985,1985,0,0,0,0.00,0
,20160126,1985,1985,,,,1985,1985,0,0,0,0.00,0
,20160127,1985,1985,,,,1985,1985,0,0,0,0.00,0
,20160128,1985,1985,,,,1985,1985,0,0,0,0.00,0
,20160129,1985,1985,,,,1985,1985,0,0,0,0.00,0
,20160201,1985,1985,,,,1985,1985,0,0,0,0.00,0
,20160202,1985,1985,,,,1985,1985,0,0,0,0.00,0
,20160203,1985,1985,,,,1985,1985,0,0,0,0.00,0
,20160204,1985,1985,,,,1985,1985,0,0,0,0.00,0
,20160205,1985,1985,,,,1985,1985,0,0,0,0.00,0
,20160215,1985,1985,,,,1985,1985,0,0,0,0.00,0
,20160216,1985,1985,,,,1985,1985,0,0,0,0.00,0
,20160217,1985,1985,,,,1985,1985,0,0,0,0.00,0
,20160218,1985,1985,,,,1985,1985,0,0,0,0.00,0
,20160219,1985,1985,,,,1985,1985,0,0,0,0.00,0
,20160222,1985,1985,,,,1985,1985,0,0,0,0.00,0
,20160223,1985,1985,,,,1985,1985,0,0,0,0.00,0
,20160224,1985,1985,,,,1985,1985,0,0,0,0.00,0
,20160225,1985,1985,,,,1985,1985,0,0,0,0.00,0
,20160226,1985,1985,,,,1985,1985,0,0,0,0.00,0
,20160229,1985,1985,,,,1985,1985,0,0,0,0.00,0
,20160301,1985,1985,,,,1985,1985,0,0,0,0.00,0
,20160302,1985,1985,,,,1985,1985,0,0,0,0.00,0
,20160303,1985,1985,,,,1985,1985,0,0,0,0.00,0
,20160304,1985,1985,,,,1985,1985,0,0,0,0.00,0
,20160307,1985,1985,,,,1985,1985,0,0,0,0.00,0
,20160308,1985,1985,,,,1985,1985,0,0,0,0.00,0
,20160309,1985,1985,,,,1985,1985,0,0,0,0.00,0
,20160310,1985,1985,,,,1985,1985,0,0,0,0.00,0
,20160311,1985,1985,,,,1985,1985,0,0,0,0.00,0
,20160314,1985,1985,,,,1985,1985,0,0,0,0.00,0
,20160315,1985,1985,,,,1985,1985,0,0,0,0.00,0
wr1604,20160104,2016,2016,,,,2016,2016,0,0,0,0.00,0
,20160105,2016,2016,,,,2016,2016,0,0,0,0.00,0
,20160106,2016,2016,,,,2016,2016,0,0,0,0.00,0
,20160107,2016,2016,,,,2016,2016,0,0,0,0.00,0
,20160108,2016,2016,,,,2016,2016,0,0,0,0.00,0
,20160111,2016,2016,,,,2016,2016,0,0,0,0.00,0
,20160112,2016,2016,,,,2016,2016,0,0,0,0.00,0
,20160113,2016,2016,,,,2016,2016,0,0,0,0.00,0
,20160114,2016,2016,,,,2016,2016,0,0,0,0.00,0
,20160115,2016,2016,,,,2016,2016,0,0,0,0.00,0
,20160118,2016,2016,,,,2016,2016,0,0,0,0.00,0
,20160119,2016,2016,,,,2016,2016,0,0,0,0.00,0
,20160120,2016,2016,,,,2016,2016,0,0,0,0.00,0
,20160121,2016,2016,,,,2016,2016,0,0,0,0.00,0
,20160122,2016,2016,,,,2016,2016,0,0,0,0.00,0
,20160125,2016,2016,,,,2016,2016,0,0,0,0.00,0
,20160126,2016,2016,,,,2016,2016,0,0,0,0.00,0
,20160127,2016,2016,,,,2016,2016,0,0,0,0.00,0
,20160128,2016,2016,,,,2016,2016,0,0,0,0.00,0
,20160129,2016,2016,,,,2016,2016,0,0,0,0.00,0
,20160201,2016,2016,,,,2016,2016,0,0,0,0.00,0
,20160202,2016,2016,,,,2016,2016,0,0,0,0.00,0
,20160203,2016,2016,,,,2016,2016,0,0,0,0.00,0
,20160204,2016,2016,,,,2016,2016,0,0,0,0.00,0
,20160205,2016,2016,,,,2016,2016,0,0,0,0.00,0
,20160215,2016,2016,,,,2016,2016,0,0,0,0.00,0
,20160216,2016,2016,,,,2016,2016,0,0,0,0.00,0
,20160217,2016,2016,,,,2016,2016,0,0,0,0.00,0
,20160218,2016,2016,,,,2016,2016,0,0,0,0.00,0
,20160219,2016,2016,,,,2016,2016,0,0,0,0.00,0
,20160222,2016,2016,,,,2016,2016,0,0,0,0.00,0
,20160223,2016,2016,,,,2016,2016,0,0,0,0.00,0
,20160224,2016,2016,,,,2016,2016,0,0,0,0.00,0
,20160225,2016,2016,,,,2016,2016,0,0,0,0.00,0
,20160226,2016,2016,,,,2016,2016,0,0,0,0.00,0
,20160229,2016,2016,,,,2016,2016,0,0,0,0.00,0
,20160301,2016,2016,,,,2016,2016,0,0,0,0.00,0
,20160302,2016,2016,,,,2016,2016,0,0,0,0.00,0
,20160303,2016,2016,,,,2016,2016,0,0,0,0.00,0
,20160304,2016,2016,,,,2016,2016,0,0,0,0.00,0
,20160307,2016,2016,,,,2016,2016,0,0,0,0.00,0
,20160308,2016,2016,,,,2016,2016,0,0,0,0.00,0
,20160309,2016,2016,,,,2016,2016,0,0,0,0.00,0
,20160310,2016,2016,,,,2016,2016,0,0,0,0.00,0
,20160311,2016,2016,,,,2016,2016,0,0,0,0.00,0
,20160314,2016,2016,,,,2016,2016,0,0,0,0.00,0
,20160315,2016,2016,,,,2016,2016,0,0,0,0.00,0
,20160316,2016,2016,,,,2016,2016,0,0,0,0.00,0
,20160317,2016,2016,,,,2016,2016,0,0,0,0.00,0
,20160318,2016,2016,,,,2016,2016,0,0,0,0.00,0
,20160321,2016,2016,,,,2016,2016,0,0,0,0.00,0
,20160322,2016,2016,,,,2016,2016,0,0,0,0.00,0
,20160323,2016,2016,,,,2016,2016,0,0,0,0.00,0
,20160324,2016,2016,,,,2016,2016,0,0,0,0.00,0
,20160325,2016,2016,,,,2016,2016,0,0,0,0.00,0
,20160328,2016,2016,,,,2016,2016,0,0,0,0.00,0
,20160329,2016,2016,,,,2016,2016,0,0,0,0.00,0
,20160330,2016,2016,,,,2016,2016,0,0,0,0.00,0
,20160331,2016,2016,,,,2016,2016,0,0,0,0.00,0
,20160401,2016,2016,,,,2016,2016,0,0,0,0.00,0
,20160405,2016,2016,,,,2016,2016,0,0,0,0.00,0
,20160406,2016,2016,,,,2016,2016,0,0,0,0.00,0
,20160407,2016,2016,,,,2016,2016,0,0,0,0.00,0
,20160408,2016,2016,,,,2016,2016,0,0,0,0.00,0
,20160411,2016,2016,,,,2016,2016,0,0,0,0.00,0
,20160412,2016,2016,,,,2016,2016,0,0,0,0.00,0
,20160413,2016,2016,,,,2016,2016,0,0,0,0.00,0
,20160414,2016,2016,,,,2016,2016,0,0,0,0.00,0
,20160415,2016,2016,,,,2016,2016,0,0,0,0.00,0
wr1605,20160104,1911,1911,,,,1911,1911,0,0,0,0.00,0
,20160105,1911,1911,,,,1911,1911,0,0,0,0.00,0
,20160106,1911,1911,,,,1911,1911,0,0,0,0.00,0
,20160107,1911,1911,,,,1911,1911,0,0,0,0.00,0
,20160108,1911,1911,,,,1911,1911,0,0,0,0.00,0
,20160111,1911,1911,,,,1911,1911,0,0,0,0.00,0
,20160112,1911,1911,,,,1911,1911,0,0,0,0.00,0
,20160113,1911,1911,,,,1911,1911,0,0,0,0.00,0
,20160114,1911,1911,,,,1911,1911,0,0,0,0.00,0
,20160115,1911,1911,,,,1911,1911,0,0,0,0.00,0
,20160118,1911,1911,,,,1911,1911,0,0,0,0.00,0
,20160119,1911,1911,,,,1911,1911,0,0,0,0.00,0
,20160120,1911,1911,,,,1911,1911,0,0,0,0.00,0
,20160121,1911,1911,,,,1911,1911,0,0,0,0.00,0
,20160122,1911,1911,,,,1911,1911,0,0,0,0.00,0
,20160125,1911,1911,,,,1911,1911,0,0,0,0.00,0
,20160126,1911,1911,,,,1911,1911,0,0,0,0.00,0
,20160127,1911,1911,,,,1911,1911,0,0,0,0.00,0
,20160128,1911,1911,,,,1911,1911,0,0,0,0.00,0
,20160129,1911,1911,,,,1911,1911,0,0,0,0.00,0
,20160201,1911,1911,,,,1911,1911,0,0,0,0.00,0
,20160202,1911,1911,,,,1911,1911,0,0,0,0.00,0
,20160203,1911,1911,,,,1911,1911,0,0,0,0.00,0
,20160204,1911,1911,,,,1911,1911,0,0,0,0.00,0
,20160205,1911,1911,,,,1911,1911,0,0,0,0.00,0
,20160215,1911,1911,,,,1911,1911,0,0,0,0.00,0
,20160216,1911,1911,,,,1911,1911,0,0,0,0.00,0
,20160217,1911,1911,,,,1911,1911,0,0,0,0.00,0
,20160218,1911,1911,,,,1911,1911,0,0,0,0.00,0
,20160219,1911,1911,,,,1911,1911,0,0,0,0.00,0
,20160222,1911,1911,,,,1911,1911,0,0,0,0.00,0
,20160223,1911,1911,,,,1911,1911,0,0,0,0.00,0
,20160224,1911,1911,,,,1911,1911,0,0,0,0.00,0
,20160225,1911,1911,,,,1911,1911,0,0,0,0.00,0
,20160226,1911,1911,,,,1911,1911,0,0,0,0.00,0
,20160229,1911,1911,,,,1911,1911,0,0,0,0.00,0
,20160301,1911,1911,,,,1911,1911,0,0,0,0.00,0
,20160302,1911,1911,,,,1911,1911,0,0,0,0.00,0
,20160303,1911,1911,,,,1911,1911,0,0,0,0.00,0
,20160304,1911,1911,,,,1911,1911,0,0,0,0.00,0
,20160307,1911,1911,,,,1911,1911,0,0,0,0.00,0
,20160308,1911,1911,,,,1911,1911,0,0,0,0.00,0
,20160309,1911,1911,,,,1911,1911,0,0,0,0.00,0
,20160310,1911,1911,,,,1911,1911,0,0,0,0.00,0
,20160311,1911,1911,,,,1911,1911,0,0,0,0.00,0
,20160314,1911,1911,,,,1911,1911,0,0,0,0.00,0
,20160315,1911,1911,,,,1911,1911,0,0,0,0.00,0
,20160316,1911,1911,,,,1911,1911,0,0,0,0.00,0
,20160317,1911,1911,,,,1911,1911,0,0,0,0.00,0
,20160318,1911,1911,,,,1911,1911,0,0,0,0.00,0
,20160321,1911,1911,,,,1911,1911,0,0,0,0.00,0
,20160322,1911,1911,,,,1911,1911,0,0,0,0.00,0
,20160323,1911,1911,,,,1911,1911,0,0,0,0.00,0
,20160324,1911,1911,,,,1911,1911,0,0,0,0.00,0
,20160325,1911,1911,,,,1911,1911,0,0,0,0.00,0
,20160328,1911,1911,,,,1911,1911,0,0,0,0.00,0
,20160329,1911,1911,,,,1911,1911,0,0,0,0.00,0
,20160330,1911,1911,,,,1911,1911,0,0,0,0.00,0
,20160331,1911,1911,,,,1911,1911,0,0,0,0.00,0
,20160401,1911,1911,,,,1911,1911,0,0,0,0.00,0
,20160405,1911,1911,,,,1911,1911,0,0,0,0.00,0
,20160406,1911,1911,,,,1911,1911,0,0,0,0.00,0
,20160407,1911,1911,,,,1911,1911,0,0,0,0.00,0
,20160408,1911,1911,,,,1911,1911,0,0,0,0.00,0
,20160411,1911,1911,,,,1911,1911,0,0,0,0.00,0
,20160412,1911,1911,,,,1911,1911,0,0,0,0.00,0
,20160413,1911,1911,,,,1911,1911,0,0,0,0.00,0
,20160414,1911,1911,,,,1911,1911,0,0,0,0.00,0
,20160415,1911,1911,,,,1911,1911,0,0,0,0.00,0
,20160418,1911,1911,,,,1911,1911,0,0,0,0.00,0
,20160419,1911,1911,,,,1911,1911,0,0,0,0.00,0
,20160420,1911,1911,,,,1911,1911,0,0,0,0.00,0
,20160421,1911,1911,,,,1911,1911,0,0,0,0.00,0
,20160422,1911,1911,,,,1911,1911,0,0,0,0.00,0
,20160425,1911,1911,,,,1911,1911,0,0,0,0.00,0
,20160426,1911,1911,,,,1911,1911,0,0,0,0.00,0
,20160427,1911,1911,,,,1911,1911,0,0,0,0.00,0
,20160428,1911,1911,,,,1911,1911,0,0,0,0.00,0
,20160429,1911,1911,,,,1911,1911,0,0,0,0.00,0
,20160503,1911,1911,,,,1911,1911,0,0,0,0.00,0
,20160504,1911,1911,,,,1911,1911,0,0,0,0.00,0
,20160505,1911,1911,,,,1911,1911,0,0,0,0.00,0
,20160506,1911,1911,,,,1911,1911,0,0,0,0.00,0
,20160509,1911,1911,,,,1911,1911,0,0,0,0.00,0
,20160510,1911,1911,,,,1911,1911,0,0,0,0.00,0
,20160511,1911,1911,,,,1911,1911,0,0,0,0.00,0
,20160512,1911,1911,,,,1911,1911,0,0,0,0.00,0
,20160513,1911,1911,,,,1911,1911,0,0,0,0.00,0
,20160516,1911,1911,,,,1911,1911,0,0,0,0.00,0
wr1606,20160104,1911,1911,,,,1911,1911,0,0,0,0.00,0
,20160105,1911,1911,,,,1911,1911,0,0,0,0.00,0
,20160106,1911,1911,,,,1911,1911,0,0,0,0.00,0
,20160107,1911,1911,,,,1911,1911,0,0,0,0.00,0
,20160108,1911,1911,,,,1911,1911,0,0,0,0.00,0
,20160111,1911,1911,,,,1911,1911,0,0,0,0.00,0
,20160112,1911,1911,,,,1911,1911,0,0,0,0.00,0
,20160113,1911,1911,,,,1911,1911,0,0,0,0.00,0
,20160114,1911,1911,,,,1911,1911,0,0,0,0.00,0
,20160115,1911,1911,,,,1911,1911,0,0,0,0.00,0
,20160118,1911,1911,,,,1911,1911,0,0,0,0.00,0
,20160119,1911,1911,,,,1911,1911,0,0,0,0.00,0
,20160120,1911,1911,,,,1911,1911,0,0,0,0.00,0
,20160121,1911,1911,,,,1911,1911,0,0,0,0.00,0
,20160122,1911,1911,,,,1911,1911,0,0,0,0.00,0
,20160125,1911,1911,,,,1911,1911,0,0,0,0.00,0
,20160126,1911,1911,,,,1911,1911,0,0,0,0.00,0
,20160127,1911,1911,,,,1911,1911,0,0,0,0.00,0
,20160128,1911,1911,,,,1911,1911,0,0,0,0.00,0
,20160129,1911,1911,,,,1911,1911,0,0,0,0.00,0
,20160201,1911,1911,,,,1911,1911,0,0,0,0.00,0
,20160202,1911,1911,,,,1911,1911,0,0,0,0.00,0
,20160203,1911,1911,,,,1911,1911,0,0,0,0.00,0
,20160204,1911,1911,,,,1911,1911,0,0,0,0.00,0
,20160205,1911,1911,,,,1911,1911,0,0,0,0.00,0
,20160215,1911,1911,,,,1911,1911,0,0,0,0.00,0
,20160216,1911,1911,,,,1911,1911,0,0,0,0.00,0
,20160217,1911,1911,,,,1911,1911,0,0,0,0.00,0
,20160218,1911,1911,,,,1911,1911,0,0,0,0.00,0
,20160219,1911,1911,,,,1911,1911,0,0,0,0.00,0
,20160222,1911,1911,,,,1911,1911,0,0,0,0.00,0
,20160223,1911,1911,,,,1911,1911,0,0,0,0.00,0
,20160224,1911,1911,,,,1911,1911,0,0,0,0.00,0
,20160225,1911,1911,,,,1911,1911,0,0,0,0.00,0
,20160226,1911,1911,,,,1911,1911,0,0,0,0.00,0
,20160229,1911,1911,,,,1911,1911,0,0,0,0.00,0
,20160301,1911,1911,,,,1911,1911,0,0,0,0.00,0
,20160302,1911,1911,,,,1911,1911,0,0,0,0.00,0
,20160303,1911,1911,,,,1911,1911,0,0,0,0.00,0
,20160304,1911,1911,,,,1911,1911,0,0,0,0.00,0
,20160307,1911,1911,,,,1911,1911,0,0,0,0.00,0
,20160308,1911,1911,,,,1911,1911,0,0,0,0.00,0
,20160309,1911,1911,,,,1911,1911,0,0,0,0.00,0
,20160310,1911,1911,,,,1911,1911,0,0,0,0.00,0
,20160311,1911,1911,,,,1911,1911,0,0,0,0.00,0
,20160314,1911,1911,,,,1911,1911,0,0,0,0.00,0
,20160315,1911,1911,,,,1911,1911,0,0,0,0.00,0
,20160316,1911,1911,,,,1911,1911,0,0,0,0.00,0
,20160317,1911,1911,2095,2102,1792,2102,2022,191,111,8,16.18,4
,20160318,2102,2022,,,,2123,2123,101,101,0,0.00,4
,20160321,2123,2123,,,,2123,2123,0,0,0,0.00,4
,20160322,2123,2123,,,,2229,2229,106,106,0,0.00,4
,20160323,2229,2229,,,,2229,2229,0,0,0,0.00,4
,20160324,2229,2229,2340,2340,2340,2340,2340,111,111,4,9.36,0
,20160325,2340,2340,,,,2340,2340,0,0,0,0.00,0
,20160328,2340,2340,,,,2340,2340,0,0,0,0.00,0
,20160329,2340,2340,,,,2340,2340,0,0,0,0.00,0
,20160330,2340,2340,,,,2340,2340,0,0,0,0.00,0
,20160331,2340,2340,,,,2340,2340,0,0,0,0.00,0
,20160401,2340,2340,,,,2340,2340,0,0,0,0.00,0
,20160405,2340,2340,,,,2340,2340,0,0,0,0.00,0
,20160406,2340,2340,,,,2340,2340,0,0,0,0.00,0
,20160407,2340,2340,,,,2340,2340,0,0,0,0.00,0
,20160408,2340,2340,,,,2340,2340,0,0,0,0.00,0
,20160411,2340,2340,,,,2340,2340,0,0,0,0.00,0
,20160412,2340,2340,,,,2340,2340,0,0,0,0.00,0
,20160413,2340,2340,,,,2340,2340,0,0,0,0.00,0
,20160414,2340,2340,,,,2340,2340,0,0,0,0.00,0
,20160415,2340,2340,,,,2340,2340,0,0,0,0.00,0
,20160418,2340,2340,,,,2340,2340,0,0,0,0.00,0
,20160419,2340,2340,,,,2340,2340,0,0,0,0.00,0
,20160420,2340,2340,,,,2340,2340,0,0,0,0.00,0
,20160421,2340,2340,,,,2340,2340,0,0,0,0.00,0
,20160422,2340,2340,,,,2340,2340,0,0,0,0.00,0
,20160425,2340,2340,,,,2340,2340,0,0,0,0.00,0
,20160426,2340,2340,,,,2340,2340,0,0,0,0.00,0
,20160427,2340,2340,,,,2340,2340,0,0,0,0.00,0
,20160428,2340,2340,,,,2340,2340,0,0,0,0.00,0
,20160429,2340,2340,,,,2340,2340,0,0,0,0.00,0
,20160503,2340,2340,,,,2340,2340,0,0,0,0.00,0
,20160504,2340,2340,,,,2340,2340,0,0,0,0.00,0
,20160505,2340,2340,,,,2340,2340,0,0,0,0.00,0
,20160506,2340,2340,,,,2340,2340,0,0,0,0.00,0
,20160509,2340,2340,,,,2340,2340,0,0,0,0.00,0
,20160510,2340,2340,,,,2340,2340,0,0,0,0.00,0
,20160511,2340,2340,,,,2340,2340,0,0,0,0.00,0
,20160512,2340,2340,,,,2340,2340,0,0,0,0.00,0
,20160513,2340,2340,,,,2340,2340,0,0,0,0.00,0
,20160516,2340,2340,,,,2340,2340,0,0,0,0.00,0
,20160517,2340,2340,,,,2340,2340,0,0,0,0.00,0
,20160518,2340,2340,,,,2340,2340,0,0,0,0.00,0
,20160519,2340,2340,,,,2340,2340,0,0,0,0.00,0
,20160520,2340,2340,,,,2340,2340,0,0,0,0.00,0
,20160523,2340,2340,,,,2340,2340,0,0,0,0.00,0
,20160524,2340,2340,,,,2340,2340,0,0,0,0.00,0
,20160525,2340,2340,,,,2340,2340,0,0,0,0.00,0
,20160526,2340,2340,,,,2340,2340,0,0,0,0.00,0
,20160527,2340,2340,,,,2340,2340,0,0,0,0.00,0
,20160530,2340,2340,,,,2340,2340,0,0,0,0.00,0
,20160531,2340,2340,,,,2340,2340,0,0,0,0.00,0
,20160601,2340,2340,,,,2340,2340,0,0,0,0.00,0
,20160602,2340,2340,,,,2340,2340,0,0,0,0.00,0
,20160603,2340,2340,,,,2340,2340,0,0,0,0.00,0
,20160606,2340,2340,,,,2340,2340,0,0,0,0.00,0
,20160607,2340,2340,,,,2340,2340,0,0,0,0.00,0
,20160608,2340,2340,,,,2340,2340,0,0,0,0.00,0
,20160613,2340,2340,,,,2340,2340,0,0,0,0.00,0
,20160614,2340,2340,,,,2340,2340,0,0,0,0.00,0
,20160615,2340,2340,,,,2340,2340,0,0,0,0.00,0
wr1607,20160104,1911,1911,,,,1911,1911,0,0,0,0.00,0
,20160105,1911,1911,,,,1911,1911,0,0,0,0.00,0
,20160106,1911,1911,,,,1911,1911,0,0,0,0.00,0
,20160107,1911,1911,,,,1911,1911,0,0,0,0.00,0
,20160108,1911,1911,,,,1911,1911,0,0,0,0.00,0
,20160111,1911,1911,,,,1911,1911,0,0,0,0.00,0
,20160112,1911,1911,,,,1911,1911,0,0,0,0.00,0
,20160113,1911,1911,,,,1911,1911,0,0,0,0.00,0
,20160114,1911,1911,,,,1911,1911,0,0,0,0.00,0
,20160115,1911,1911,,,,1911,1911,0,0,0,0.00,0
,20160118,1911,1911,,,,1911,1911,0,0,0,0.00,0
,20160119,1911,1911,,,,1911,1911,0,0,0,0.00,0
,20160120,1911,1911,,,,1911,1911,0,0,0,0.00,0
,20160121,1911,1911,,,,1911,1911,0,0,0,0.00,0
,20160122,1911,1911,,,,1911,1911,0,0,0,0.00,0
,20160125,1911,1911,,,,1911,1911,0,0,0,0.00,0
,20160126,1911,1911,,,,1911,1911,0,0,0,0.00,0
,20160127,1911,1911,,,,1911,1911,0,0,0,0.00,0
,20160128,1911,1911,,,,1911,1911,0,0,0,0.00,0
,20160129,1911,1911,,,,1911,1911,0,0,0,0.00,0
,20160201,1911,1911,,,,1911,1911,0,0,0,0.00,0
,20160202,1911,1911,,,,1911,1911,0,0,0,0.00,0
,20160203,1911,1911,,,,1911,1911,0,0,0,0.00,0
,20160204,1911,1911,,,,1911,1911,0,0,0,0.00,0
,20160205,1911,1911,,,,1911,1911,0,0,0,0.00,0
,20160215,1911,1911,,,,1911,1911,0,0,0,0.00,0
,20160216,1911,1911,,,,1911,1911,0,0,0,0.00,0
,20160217,1911,1911,,,,1911,1911,0,0,0,0.00,0
,20160218,1911,1911,,,,1911,1911,0,0,0,0.00,0
,20160219,1911,1911,,,,1911,1911,0,0,0,0.00,0
,20160222,1911,1911,,,,1911,1911,0,0,0,0.00,0
,20160223,1911,1911,,,,1911,1911,0,0,0,0.00,0
,20160224,1911,1911,,,,1911,1911,0,0,0,0.00,0
,20160225,1911,1911,,,,1911,1911,0,0,0,0.00,0
,20160226,1911,1911,,,,1911,1911,0,0,0,0.00,0
,20160229,1911,1911,,,,1911,1911,0,0,0,0.00,0
,20160301,1911,1911,,,,1911,1911,0,0,0,0.00,0
,20160302,1911,1911,,,,1911,1911,0,0,0,0.00,0
,20160303,1911,1911,,,,1911,1911,0,0,0,0.00,0
,20160304,1911,1911,,,,1911,1911,0,0,0,0.00,0
,20160307,1911,1911,,,,1911,1911,0,0,0,0.00,0
,20160308,1911,1911,,,,1911,1911,0,0,0,0.00,0
,20160309,1911,1911,,,,1911,1911,0,0,0,0.00,0
,20160310,1911,1911,,,,1911,1911,0,0,0,0.00,0
,20160311,1911,1911,,,,1911,1911,0,0,0,0.00,0
,20160314,1911,1911,,,,1911,1911,0,0,0,0.00,0
,20160315,1911,1911,,,,1911,1911,0,0,0,0.00,0
,20160316,1911,1911,,,,1911,1911,0,0,0,0.00,0
,20160317,1911,1911,,,,2022,2022,111,111,0,0.00,0
,20160318,2022,2022,,,,2022,2022,0,0,0,0.00,0
,20160321,2022,2022,,,,2022,2022,0,0,0,0.00,0
,20160322,2022,2022,,,,2022,2022,0,0,0,0.00,0
,20160323,2022,2022,,,,2022,2022,0,0,0,0.00,0
,20160324,2022,2022,,,,2122,2122,100,100,0,0.00,0
,20160325,2122,2122,,,,2122,2122,0,0,0,0.00,0
,20160328,2122,2122,,,,2122,2122,0,0,0,0.00,0
,20160329,2122,2122,,,,2122,2122,0,0,0,0.00,0
,20160330,2122,2122,,,,2122,2122,0,0,0,0.00,0
,20160331,2122,2122,,,,2122,2122,0,0,0,0.00,0
,20160401,2122,2122,,,,2122,2122,0,0,0,0.00,0
,20160405,2122,2122,,,,2122,2122,0,0,0,0.00,0
,20160406,2122,2122,,,,2122,2122,0,0,0,0.00,0
,20160407,2122,2122,,,,2122,2122,0,0,0,0.00,0
,20160408,2122,2122,,,,2122,2122,0,0,0,0.00,0
,20160411,2122,2122,,,,2122,2122,0,0,0,0.00,0
,20160412,2122,2122,,,,2122,2122,0,0,0,0.00,0
,20160413,2122,2122,,,,2122,2122,0,0,0,0.00,0
,20160414,2122,2122,,,,2122,2122,0,0,0,0.00,0
,20160415,2122,2122,,,,2122,2122,0,0,0,0.00,0
,20160418,2122,2122,,,,2122,2122,0,0,0,0.00,0
,20160419,2122,2122,,,,2122,2122,0,0,0,0.00,0
,20160420,2122,2122,,,,2122,2122,0,0,0,0.00,0
,20160421,2122,2122,,,,2122,2122,0,0,0,0.00,0
,20160422,2122,2122,,,,2122,2122,0,0,0,0.00,0
,20160425,2122,2122,,,,2122,2122,0,0,0,0.00,0
,20160426,2122,2122,,,,2122,2122,0,0,0,0.00,0
,20160427,2122,2122,,,,2122,2122,0,0,0,0.00,0
,20160428,2122,2122,,,,2122,2122,0,0,0,0.00,0
,20160429,2122,2122,,,,2122,2122,0,0,0,0.00,0
,20160503,2122,2122,,,,2122,2122,0,0,0,0.00,0
,20160504,2122,2122,,,,2122,2122,0,0,0,0.00,0
,20160505,2122,2122,,,,2122,2122,0,0,0,0.00,0
,20160506,2122,2122,,,,2122,2122,0,0,0,0.00,0
,20160509,2122,2122,,,,2122,2122,0,0,0,0.00,0
,20160510,2122,2122,,,,2122,2122,0,0,0,0.00,0
,20160511,2122,2122,,,,2122,2122,0,0,0,0.00,0
,20160512,2122,2122,,,,2122,2122,0,0,0,0.00,0
,20160513,2122,2122,,,,2122,2122,0,0,0,0.00,0
,20160516,2122,2122,,,,2122,2122,0,0,0,0.00,0
,20160517,2122,2122,,,,2122,2122,0,0,0,0.00,0
,20160518,2122,2122,,,,2122,2122,0,0,0,0.00,0
,20160519,2122,2122,,,,2122,2122,0,0,0,0.00,0
,20160520,2122,2122,,,,2122,2122,0,0,0,0.00,0
,20160523,2122,2122,,,,2122,2122,0,0,0,0.00,0
,20160524,2122,2122,,,,2122,2122,0,0,0,0.00,0
,20160525,2122,2122,2122,2123,2122,2123,2122,1,0,4,8.49,0
,20160526,2123,2122,,,,2122,2122,0,0,0,0.00,0
,20160527,2122,2122,,,,2122,2122,0,0,0,0.00,0
,20160530,2122,2122,,,,2122,2122,0,0,0,0.00,0
,20160531,2122,2122,,,,2122,2122,0,0,0,0.00,0
,20160601,2122,2122,,,,2122,2122,0,0,0,0.00,0
,20160602,2122,2122,,,,2122,2122,0,0,0,0.00,0
,20160603,2122,2122,,,,2122,2122,0,0,0,0.00,0
,20160606,2122,2122,,,,2122,2122,0,0,0,0.00,0
,20160607,2122,2122,,,,2122,2122,0,0,0,0.00,0
,20160608,2122,2122,,,,2122,2122,0,0,0,0.00,0
,20160613,2122,2122,,,,2122,2122,0,0,0,0.00,0
,20160614,2122,2122,,,,2122,2122,0,0,0,0.00,0
,20160615,2122,2122,,,,2122,2122,0,0,0,0.00,0
,20160616,2122,2122,,,,2122,2122,0,0,0,0.00,0
,20160617,2122,2122,,,,2122,2122,0,0,0,0.00,0
,20160620,2122,2122,,,,2122,2122,0,0,0,0.00,0
,20160621,2122,2122,,,,2122,2122,0,0,0,0.00,0
,20160622,2122,2122,,,,2122,2122,0,0,0,0.00,0
,20160623,2122,2122,,,,2122,2122,0,0,0,0.00,0
,20160624,2122,2122,,,,2122,2122,0,0,0,0.00,0
,20160627,2122,2122,,,,2122,2122,0,0,0,0.00,0
,20160628,2122,2122,,,,2122,2122,0,0,0,0.00,0
,20160629,2122,2122,,,,2122,2122,0,0,0,0.00,0
,20160630,2122,2122,,,,2122,2122,0,0,0,0.00,0
,20160701,2122,2122,,,,2122,2122,0,0,0,0.00,0
,20160704,2122,2122,,,,2122,2122,0,0,0,0.00,0
,20160705,2122,2122,,,,2122,2122,0,0,0,0.00,0
,20160706,2122,2122,,,,2122,2122,0,0,0,0.00,0
,20160707,2122,2122,,,,2122,2122,0,0,0,0.00,0
,20160708,2122,2122,,,,2122,2122,0,0,0,0.00,0
,20160711,2122,2122,,,,2122,2122,0,0,0,0.00,0
,20160712,2122,2122,,,,2122,2122,0,0,0,0.00,0
,20160713,2122,2122,,,,2122,2122,0,0,0,0.00,0
,20160714,2122,2122,,,,2122,2122,0,0,0,0.00,0
,20160715,2122,2122,,,,2122,2122,0,0,0,0.00,0
wr1608,20160104,1911,1911,,,,1911,1911,0,0,0,0.00,0
,20160105,1911,1911,,,,1911,1911,0,0,0,0.00,0
,20160106,1911,1911,,,,1911,1911,0,0,0,0.00,0
,20160107,1911,1911,,,,1911,1911,0,0,0,0.00,0
,20160108,1911,1911,,,,1911,1911,0,0,0,0.00,0
,20160111,1911,1911,,,,1911,1911,0,0,0,0.00,0
,20160112,1911,1911,,,,1911,1911,0,0,0,0.00,0
,20160113,1911,1911,,,,1911,1911,0,0,0,0.00,0
,20160114,1911,1911,,,,1911,1911,0,0,0,0.00,0
,20160115,1911,1911,,,,1911,1911,0,0,0,0.00,0
,20160118,1911,1911,,,,1911,1911,0,0,0,0.00,0
,20160119,1911,1911,,,,1911,1911,0,0,0,0.00,0
,20160120,1911,1911,,,,1911,1911,0,0,0,0.00,0
,20160121,1911,1911,,,,1911,1911,0,0,0,0.00,0
,20160122,1911,1911,,,,1911,1911,0,0,0,0.00,0
,20160125,1911,1911,,,,1911,1911,0,0,0,0.00,0
,20160126,1911,1911,,,,1911,1911,0,0,0,0.00,0
,20160127,1911,1911,,,,1911,1911,0,0,0,0.00,0
,20160128,1911,1911,,,,1911,1911,0,0,0,0.00,0
,20160129,1911,1911,,,,1911,1911,0,0,0,0.00,0
,20160201,1911,1911,,,,1911,1911,0,0,0,0.00,0
,20160202,1911,1911,,,,1911,1911,0,0,0,0.00,0
,20160203,1911,1911,,,,1911,1911,0,0,0,0.00,0
,20160204,1911,1911,,,,1911,1911,0,0,0,0.00,0
,20160205,1911,1911,,,,1911,1911,0,0,0,0.00,0
,20160215,1911,1911,,,,1911,1911,0,0,0,0.00,0
,20160216,1911,1911,,,,1911,1911,0,0,0,0.00,0
,20160217,1911,1911,,,,1911,1911,0,0,0,0.00,0
,20160218,1911,1911,,,,1911,1911,0,0,0,0.00,0
,20160219,1911,1911,,,,1911,1911,0,0,0,0.00,0
,20160222,1911,1911,,,,1911,1911,0,0,0,0.00,0
,20160223,1911,1911,,,,1911,1911,0,0,0,0.00,0
,20160224,1911,1911,,,,1911,1911,0,0,0,0.00,0
,20160225,1911,1911,,,,1911,1911,0,0,0,0.00,0
,20160226,1911,1911,,,,1911,1911,0,0,0,0.00,0
,20160229,1911,1911,,,,1911,1911,0,0,0,0.00,0
,20160301,1911,1911,,,,1911,1911,0,0,0,0.00,0
,20160302,1911,1911,,,,1911,1911,0,0,0,0.00,0
,20160303,1911,1911,,,,1911,1911,0,0,0,0.00,0
,20160304,1911,1911,,,,1911,1911,0,0,0,0.00,0
,20160307,1911,1911,,,,1911,1911,0,0,0,0.00,0
,20160308,1911,1911,,,,1911,1911,0,0,0,0.00,0
,20160309,1911,1911,,,,1911,1911,0,0,0,0.00,0
,20160310,1911,1911,,,,1911,1911,0,0,0,0.00,0
,20160311,1911,1911,,,,1911,1911,0,0,0,0.00,0
,20160314,1911,1911,,,,1911,1911,0,0,0,0.00,0
,20160315,1911,1911,,,,1911,1911,0,0,0,0.00,0
,20160316,1911,1911,,,,1911,1911,0,0,0,0.00,0
,20160317,1911,1911,,,,2022,2022,111,111,0,0.00,0
,20160318,2022,2022,,,,2022,2022,0,0,0,0.00,0
,20160321,2022,2022,,,,2022,2022,0,0,0,0.00,0
,20160322,2022,2022,,,,2022,2022,0,0,0,0.00,0
,20160323,2022,2022,,,,2022,2022,0,0,0,0.00,0
,20160324,2022,2022,,,,2122,2122,100,100,0,0.00,0
,20160325,2122,2122,,,,2122,2122,0,0,0,0.00,0
,20160328,2122,2122,,,,2122,2122,0,0,0,0.00,0
,20160329,2122,2122,,,,2122,2122,0,0,0,0.00,0
,20160330,2122,2122,,,,2122,2122,0,0,0,0.00,0
,20160331,2122,2122,,,,2122,2122,0,0,0,0.00,0
,20160401,2122,2122,,,,2122,2122,0,0,0,0.00,0
,20160405,2122,2122,,,,2122,2122,0,0,0,0.00,0
,20160406,2122,2122,,,,2122,2122,0,0,0,0.00,0
,20160407,2122,2122,,,,2122,2122,0,0,0,0.00,0
,20160408,2122,2122,,,,2122,2122,0,0,0,0.00,0
,20160411,2122,2122,,,,2122,2122,0,0,0,0.00,0
,20160412,2122,2122,,,,2122,2122,0,0,0,0.00,0
,20160413,2122,2122,,,,2122,2122,0,0,0,0.00,0
,20160414,2122,2122,,,,2122,2122,0,0,0,0.00,0
,20160415,2122,2122,,,,2122,2122,0,0,0,0.00,0
,20160418,2122,2122,,,,2122,2122,0,0,0,0.00,0
,20160419,2122,2122,,,,2122,2122,0,0,0,0.00,0
,20160420,2122,2122,,,,2122,2122,0,0,0,0.00,0
,20160421,2122,2122,,,,2122,2122,0,0,0,0.00,0
,20160422,2122,2122,,,,2122,2122,0,0,0,0.00,0
,20160425,2122,2122,,,,2122,2122,0,0,0,0.00,0
,20160426,2122,2122,,,,2122,2122,0,0,0,0.00,0
,20160427,2122,2122,,,,2122,2122,0,0,0,0.00,0
,20160428,2122,2122,,,,2122,2122,0,0,0,0.00,0
,20160429,2122,2122,,,,2122,2122,0,0,0,0.00,0
,20160503,2122,2122,,,,2122,2122,0,0,0,0.00,0
,20160504,2122,2122,,,,2122,2122,0,0,0,0.00,0
,20160505,2122,2122,,,,2122,2122,0,0,0,0.00,0
,20160506,2122,2122,,,,2122,2122,0,0,0,0.00,0
,20160509,2122,2122,,,,2122,2122,0,0,0,0.00,0
,20160510,2122,2122,,,,2122,2122,0,0,0,0.00,0
,20160511,2122,2122,,,,2122,2122,0,0,0,0.00,0
,20160512,2122,2122,,,,2122,2122,0,0,0,0.00,0
,20160513,2122,2122,,,,2122,2122,0,0,0,0.00,0
,20160516,2122,2122,,,,2122,2122,0,0,0,0.00,0
,20160517,2122,2122,,,,2122,2122,0,0,0,0.00,0
,20160518,2122,2122,,,,2122,2122,0,0,0,0.00,0
,20160519,2122,2122,,,,2122,2122,0,0,0,0.00,0
,20160520,2122,2122,,,,2122,2122,0,0,0,0.00,0
,20160523,2122,2122,,,,2122,2122,0,0,0,0.00,0
,20160524,2122,2122,,,,2122,2122,0,0,0,0.00,0
,20160525,2122,2122,,,,2122,2122,0,0,0,0.00,0
,20160526,2122,2122,,,,2122,2122,0,0,0,0.00,0
,20160527,2122,2122,,,,2122,2122,0,0,0,0.00,0
,20160530,2122,2122,,,,2122,2122,0,0,0,0.00,0
,20160531,2122,2122,,,,2122,2122,0,0,0,0.00,0
,20160601,2122,2122,,,,2122,2122,0,0,0,0.00,0
,20160602,2122,2122,,,,2122,2122,0,0,0,0.00,0
,20160603,2122,2122,,,,2122,2122,0,0,0,0.00,0
,20160606,2122,2122,,,,2122,2122,0,0,0,0.00,0
,20160607,2122,2122,,,,2122,2122,0,0,0,0.00,0
,20160608,2122,2122,,,,2122,2122,0,0,0,0.00,0
,20160613,2122,2122,,,,2122,2122,0,0,0,0.00,0
,20160614,2122,2122,,,,2122,2122,0,0,0,0.00,0
,20160615,2122,2122,,,,2122,2122,0,0,0,0.00,0
,20160616,2122,2122,,,,2122,2122,0,0,0,0.00,0
,20160617,2122,2122,,,,2122,2122,0,0,0,0.00,0
,20160620,2122,2122,,,,2122,2122,0,0,0,0.00,0
,20160621,2122,2122,,,,2122,2122,0,0,0,0.00,0
,20160622,2122,2122,,,,2122,2122,0,0,0,0.00,0
,20160623,2122,2122,,,,2122,2122,0,0,0,0.00,0
,20160624,2122,2122,,,,2122,2122,0,0,0,0.00,0
,20160627,2122,2122,,,,2122,2122,0,0,0,0.00,0
,20160628,2122,2122,,,,2122,2122,0,0,0,0.00,0
,20160629,2122,2122,,,,2122,2122,0,0,0,0.00,0
,20160630,2122,2122,,,,2122,2122,0,0,0,0.00,0
,20160701,2122,2122,,,,2122,2122,0,0,0,0.00,0
,20160704,2122,2122,,,,2122,2122,0,0,0,0.00,0
,20160705,2122,2122,,,,2122,2122,0,0,0,0.00,0
,20160706,2122,2122,,,,2122,2122,0,0,0,0.00,0
,20160707,2122,2122,,,,2122,2122,0,0,0,0.00,0
,20160708,2122,2122,,,,2122,2122,0,0,0,0.00,0
,20160711,2122,2122,,,,2122,2122,0,0,0,0.00,0
,20160712,2122,2122,,,,2122,2122,0,0,0,0.00,0
,20160713,2122,2122,,,,2122,2122,0,0,0,0.00,0
,20160714,2122,2122,,,,2122,2122,0,0,0,0.00,0
,20160715,2122,2122,,,,2122,2122,0,0,0,0.00,0
,20160718,2122,2122,,,,2122,2122,0,0,0,0.00,0
,20160719,2122,2122,,,,2122,2122,0,0,0,0.00,0
,20160720,2122,2122,,,,2122,2122,0,0,0,0.00,0
,20160721,2122,2122,,,,2122,2122,0,0,0,0.00,0
,20160722,2122,2122,,,,2122,2122,0,0,0,0.00,0
,20160725,2122,2122,,,,2122,2122,0,0,0,0.00,0
,20160726,2122,2122,,,,2122,2122,0,0,0,0.00,0
,20160727,2122,2122,,,,2122,2122,0,0,0,0.00,0
,20160728,2122,2122,,,,2122,2122,0,0,0,0.00,0
,20160729,2122,2122,,,,2122,2122,0,0,0,0.00,0
,20160801,2122,2122,,,,2122,2122,0,0,0,0.00,0
,20160802,2122,2122,,,,2122,2122,0,0,0,0.00,0
,20160803,2122,2122,,,,2122,2122,0,0,0,0.00,0
,20160804,2122,2122,,,,2122,2122,0,0,0,0.00,0
,20160805,2122,2122,,,,2122,2122,0,0,0,0.00,0
,20160808,2122,2122,,,,2122,2122,0,0,0,0.00,0
,20160809,2122,2122,,,,2122,2122,0,0,0,0.00,0
,20160810,2122,2122,,,,2122,2122,0,0,0,0.00,0
,20160811,2122,2122,,,,2122,2122,0,0,0,0.00,0
,20160812,2122,2122,,,,2122,2122,0,0,0,0.00,0
,20160815,2122,2122,,,,2122,2122,0,0,0,0.00,0
wr1609,20160104,2011,2011,,,,2011,2011,0,0,0,0.00,0
,20160105,2011,2011,,,,2011,2011,0,0,0,0.00,0
,20160106,2011,2011,,,,2011,2011,0,0,0,0.00,0
,20160107,2011,2011,,,,2011,2011,0,0,0,0.00,0
,20160108,2011,2011,,,,2011,2011,0,0,0,0.00,0
,20160111,2011,2011,,,,2011,2011,0,0,0,0.00,0
,20160112,2011,2011,,,,2011,2011,0,0,0,0.00,0
,20160113,2011,2011,,,,2011,2011,0,0,0,0.00,0
,20160114,2011,2011,,,,2011,2011,0,0,0,0.00,0
,20160115,2011,2011,,,,2011,2011,0,0,0,0.00,0
,20160118,2011,2011,,,,2011,2011,0,0,0,0.00,0
,20160119,2011,2011,,,,2011,2011,0,0,0,0.00,0
,20160120,2011,2011,,,,2011,2011,0,0,0,0.00,0
,20160121,2011,2011,,,,2011,2011,0,0,0,0.00,0
,20160122,2011,2011,,,,2011,2011,0,0,0,0.00,0
,20160125,2011,2011,,,,2011,2011,0,0,0,0.00,0
,20160126,2011,2011,,,,2011,2011,0,0,0,0.00,0
,20160127,2011,2011,,,,2011,2011,0,0,0,0.00,0
,20160128,2011,2011,,,,2011,2011,0,0,0,0.00,0
,20160129,2011,2011,,,,2011,2011,0,0,0,0.00,0
,20160201,2011,2011,,,,2011,2011,0,0,0,0.00,0
,20160202,2011,2011,,,,2011,2011,0,0,0,0.00,0
,20160203,2011,2011,,,,2011,2011,0,0,0,0.00,0
,20160204,2011,2011,,,,2011,2011,0,0,0,0.00,0
,20160205,2011,2011,,,,2011,2011,0,0,0,0.00,0
,20160215,2011,2011,,,,2011,2011,0,0,0,0.00,0
,20160216,2011,2011,,,,2011,2011,0,0,0,0.00,0
,20160217,2011,2011,,,,2011,2011,0,0,0,0.00,0
,20160218,2011,2011,,,,2011,2011,0,0,0,0.00,0
,20160219,2011,2011,,,,2011,2011,0,0,0,0.00,0
,20160222,2011,2011,,,,2011,2011,0,0,0,0.00,0
,20160223,2011,2011,,,,2011,2011,0,0,0,0.00,0
,20160224,2011,2011,,,,2011,2011,0,0,0,0.00,0
,20160225,2011,2011,,,,2011,2011,0,0,0,0.00,0
,20160226,2011,2011,,,,2011,2011,0,0,0,0.00,0
,20160229,2011,2011,,,,2011,2011,0,0,0,0.00,0
,20160301,2011,2011,,,,2011,2011,0,0,0,0.00,0
,20160302,2011,2011,,,,2011,2011,0,0,0,0.00,0
,20160303,2011,2011,,,,2011,2011,0,0,0,0.00,0
,20160304,2011,2011,,,,2011,2011,0,0,0,0.00,0
,20160307,2011,2011,,,,2011,2011,0,0,0,0.00,0
,20160308,2011,2011,,,,2011,2011,0,0,0,0.00,0
,20160309,2011,2011,,,,2011,2011,0,0,0,0.00,0
,20160310,2011,2011,,,,2011,2011,0,0,0,0.00,0
,20160311,2011,2011,,,,2011,2011,0,0,0,0.00,0
,20160314,2011,2011,,,,2011,2011,0,0,0,0.00,0
,20160315,2011,2011,,,,2011,2011,0,0,0,0.00,0
,20160316,2011,2011,,,,2011,2011,0,0,0,0.00,0
,20160317,2011,2011,,,,2128,2128,117,117,0,0.00,0
,20160318,2128,2128,,,,2128,2128,0,0,0,0.00,0
,20160321,2128,2128,,,,2128,2128,0,0,0,0.00,0
,20160322,2128,2128,,,,2128,2128,0,0,0,0.00,0
,20160323,2128,2128,,,,2128,2128,0,0,0,0.00,0
,20160324,2128,2128,2128,2340,2128,2340,2264,212,136,6,13.59,0
,20160325,2340,2264,,,,2264,2264,0,0,0,0.00,0
,20160328,2264,2264,,,,2264,2264,0,0,0,0.00,0
,20160329,2264,2264,,,,2264,2264,0,0,0,0.00,0
,20160330,2264,2264,,,,2264,2264,0,0,0,0.00,0
,20160331,2264,2264,,,,2264,2264,0,0,0,0.00,0
,20160401,2264,2264,,,,2264,2264,0,0,0,0.00,0
,20160405,2264,2264,,,,2264,2264,0,0,0,0.00,0
,20160406,2264,2264,,,,2264,2264,0,0,0,0.00,0
,20160407,2264,2264,,,,2264,2264,0,0,0,0.00,0
,20160408,2264,2264,,,,2264,2264,0,0,0,0.00,0
,20160411,2264,2264,,,,2264,2264,0,0,0,0.00,0
,20160412,2264,2264,,,,2264,2264,0,0,0,0.00,0
,20160413,2264,2264,,,,2264,2264,0,0,0,0.00,0
,20160414,2264,2264,,,,2264,2264,0,0,0,0.00,0
,20160415,2264,2264,,,,2264,2264,0,0,0,0.00,0
,20160418,2264,2264,,,,2264,2264,0,0,0,0.00,0
,20160419,2264,2264,,,,2264,2264,0,0,0,0.00,0
,20160420,2264,2264,,,,2264,2264,0,0,0,0.00,0
,20160421,2264,2264,,,,2264,2264,0,0,0,0.00,0
,20160422,2264,2264,,,,2264,2264,0,0,0,0.00,0
,20160425,2264,2264,,,,2264,2264,0,0,0,0.00,0
,20160426,2264,2264,,,,2264,2264,0,0,0,0.00,0
,20160427,2264,2264,,,,2264,2264,0,0,0,0.00,0
,20160428,2264,2264,,,,2264,2264,0,0,0,0.00,0
,20160429,2264,2264,,,,2264,2264,0,0,0,0.00,0
,20160503,2264,2264,,,,2264,2264,0,0,0,0.00,0
,20160504,2264,2264,,,,2264,2264,0,0,0,0.00,0
,20160505,2264,2264,,,,2264,2264,0,0,0,0.00,0
,20160506,2264,2264,,,,2264,2264,0,0,0,0.00,0
,20160509,2264,2264,,,,2264,2264,0,0,0,0.00,0
,20160510,2264,2264,,,,2264,2264,0,0,0,0.00,0
,20160511,2264,2264,,,,2264,2264,0,0,0,0.00,0
,20160512,2264,2264,,,,2264,2264,0,0,0,0.00,0
,20160513,2264,2264,,,,2264,2264,0,0,0,0.00,0
,20160516,2264,2264,,,,2264,2264,0,0,0,0.00,0
,20160517,2264,2264,,,,2264,2264,0,0,0,0.00,0
,20160518,2264,2264,,,,2264,2264,0,0,0,0.00,0
,20160519,2264,2264,,,,2264,2264,0,0,0,0.00,0
,20160520,2264,2264,,,,2264,2264,0,0,0,0.00,0
,20160523,2264,2264,,,,2264,2264,0,0,0,0.00,0
,20160524,2264,2264,,,,2264,2264,0,0,0,0.00,0
,20160525,2264,2264,,,,2264,2264,0,0,0,0.00,0
,20160526,2264,2264,,,,2264,2264,0,0,0,0.00,0
,20160527,2264,2264,,,,2264,2264,0,0,0,0.00,0
,20160530,2264,2264,,,,2264,2264,0,0,0,0.00,0
,20160531,2264,2264,,,,2264,2264,0,0,0,0.00,0
,20160601,2264,2264,,,,2264,2264,0,0,0,0.00,0
,20160602,2264,2264,,,,2264,2264,0,0,0,0.00,0
,20160603,2264,2264,,,,2264,2264,0,0,0,0.00,0
,20160606,2264,2264,,,,2264,2264,0,0,0,0.00,0
,20160607,2264,2264,,,,2264,2264,0,0,0,0.00,0
,20160608,2264,2264,,,,2264,2264,0,0,0,0.00,0
,20160613,2264,2264,,,,2264,2264,0,0,0,0.00,0
,20160614,2264,2264,,,,2264,2264,0,0,0,0.00,0
,20160615,2264,2264,,,,2264,2264,0,0,0,0.00,0
,20160616,2264,2264,,,,2264,2264,0,0,0,0.00,0
,20160617,2264,2264,,,,2264,2264,0,0,0,0.00,0
,20160620,2264,2264,,,,2264,2264,0,0,0,0.00,0
,20160621,2264,2264,,,,2264,2264,0,0,0,0.00,0
,20160622,2264,2264,,,,2264,2264,0,0,0,0.00,0
,20160623,2264,2264,,,,2264,2264,0,0,0,0.00,0
,20160624,2264,2264,,,,2264,2264,0,0,0,0.00,0
,20160627,2264,2264,,,,2264,2264,0,0,0,0.00,0
,20160628,2264,2264,,,,2264,2264,0,0,0,0.00,0
,20160629,2264,2264,,,,2264,2264,0,0,0,0.00,0
,20160630,2264,2264,,,,2264,2264,0,0,0,0.00,0
,20160701,2264,2264,,,,2264,2264,0,0,0,0.00,0
,20160704,2264,2264,,,,2264,2264,0,0,0,0.00,0
,20160705,2264,2264,,,,2264,2264,0,0,0,0.00,0
,20160706,2264,2264,,,,2264,2264,0,0,0,0.00,0
,20160707,2264,2264,,,,2264,2264,0,0,0,0.00,0
,20160708,2264,2264,,,,2264,2264,0,0,0,0.00,0
,20160711,2264,2264,,,,2264,2264,0,0,0,0.00,0
,20160712,2264,2264,,,,2264,2264,0,0,0,0.00,0
,20160713,2264,2264,,,,2264,2264,0,0,0,0.00,0
,20160714,2264,2264,,,,2264,2264,0,0,0,0.00,0
,20160715,2264,2264,,,,2264,2264,0,0,0,0.00,0
,20160718,2264,2264,,,,2264,2264,0,0,0,0.00,0
,20160719,2264,2264,,,,2264,2264,0,0,0,0.00,0
,20160720,2264,2264,,,,2264,2264,0,0,0,0.00,0
,20160721,2264,2264,,,,2264,2264,0,0,0,0.00,0
,20160722,2264,2264,,,,2264,2264,0,0,0,0.00,0
,20160725,2264,2264,,,,2264,2264,0,0,0,0.00,0
,20160726,2264,2264,,,,2264,2264,0,0,0,0.00,0
,20160727,2264,2264,,,,2264,2264,0,0,0,0.00,0
,20160728,2264,2264,,,,2264,2264,0,0,0,0.00,0
,20160729,2264,2264,,,,2264,2264,0,0,0,0.00,0
,20160801,2264,2264,,,,2264,2264,0,0,0,0.00,0
,20160802,2264,2264,,,,2264,2264,0,0,0,0.00,0
,20160803,2264,2264,,,,2264,2264,0,0,0,0.00,0
,20160804,2264,2264,,,,2264,2264,0,0,0,0.00,0
,20160805,2264,2264,,,,2264,2264,0,0,0,0.00,0
,20160808,2264,2264,,,,2264,2264,0,0,0,0.00,0
,20160809,2264,2264,,,,2264,2264,0,0,0,0.00,0
,20160810,2264,2264,,,,2264,2264,0,0,0,0.00,0
,20160811,2264,2264,,,,2264,2264,0,0,0,0.00,0
,20160812,2264,2264,,,,2264,2264,0,0,0,0.00,0
,20160815,2264,2264,,,,2264,2264,0,0,0,0.00,0
,20160816,2264,2264,,,,2264,2264,0,0,0,0.00,0
,20160817,2264,2264,,,,2264,2264,0,0,0,0.00,0
,20160818,2264,2264,,,,2264,2264,0,0,0,0.00,0
,20160819,2264,2264,,,,2264,2264,0,0,0,0.00,0
,20160822,2264,2264,,,,2264,2264,0,0,0,0.00,0
,20160823,2264,2264,,,,2264,2264,0,0,0,0.00,0
,20160824,2264,2264,,,,2264,2264,0,0,0,0.00,0
,20160825,2264,2264,,,,2264,2264,0,0,0,0.00,0
,20160826,2264,2264,,,,2264,2264,0,0,0,0.00,0
,20160829,2264,2264,,,,2264,2264,0,0,0,0.00,0
,20160830,2264,2264,,,,2264,2264,0,0,0,0.00,0
,20160831,2264,2264,,,,2264,2264,0,0,0,0.00,0
,20160901,2264,2264,,,,2264,2264,0,0,0,0.00,0
,20160902,2264,2264,,,,2264,2264,0,0,0,0.00,0
,20160905,2264,2264,,,,2264,2264,0,0,0,0.00,0
,20160906,2264,2264,,,,2264,2264,0,0,0,0.00,0
,20160907,2264,2264,,,,2264,2264,0,0,0,0.00,0
,20160908,2264,2264,,,,2264,2264,0,0,0,0.00,0
,20160909,2264,2264,,,,2264,2264,0,0,0,0.00,0
,20160912,2264,2264,,,,2264,2264,0,0,0,0.00,0
,20160913,2264,2264,,,,2264,2264,0,0,0,0.00,0
,20160914,2264,2264,,,,2264,2264,0,0,0,0.00,0
,20160919,2264,2264,,,,2264,2264,0,0,0,0.00,0
wr1610,20160104,1881,1881,,,,1881,1881,0,0,0,0.00,0
,20160105,1881,1881,,,,1881,1881,0,0,0,0.00,0
,20160106,1881,1881,,,,1881,1881,0,0,0,0.00,0
,20160107,1881,1881,,,,1881,1881,0,0,0,0.00,0
,20160108,1881,1881,,,,1881,1881,0,0,0,0.00,0
,20160111,1881,1881,,,,1881,1881,0,0,0,0.00,0
,20160112,1881,1881,,,,1881,1881,0,0,0,0.00,0
,20160113,1881,1881,,,,1881,1881,0,0,0,0.00,0
,20160114,1881,1881,,,,1881,1881,0,0,0,0.00,0
,20160115,1881,1881,,,,1881,1881,0,0,0,0.00,0
,20160118,1881,1881,,,,1881,1881,0,0,0,0.00,0
,20160119,1881,1881,,,,1881,1881,0,0,0,0.00,0
,20160120,1881,1881,,,,1881,1881,0,0,0,0.00,0
,20160121,1881,1881,,,,1881,1881,0,0,0,0.00,0
,20160122,1881,1881,,,,1881,1881,0,0,0,0.00,0
,20160125,1881,1881,,,,1881,1881,0,0,0,0.00,0
,20160126,1881,1881,,,,1881,1881,0,0,0,0.00,0
,20160127,1881,1881,,,,1881,1881,0,0,0,0.00,0
,20160128,1881,1881,,,,1881,1881,0,0,0,0.00,0
,20160129,1881,1881,,,,1881,1881,0,0,0,0.00,0
,20160201,1881,1881,,,,1881,1881,0,0,0,0.00,0
,20160202,1881,1881,,,,1881,1881,0,0,0,0.00,0
,20160203,1881,1881,,,,1881,1881,0,0,0,0.00,0
,20160204,1881,1881,,,,1881,1881,0,0,0,0.00,0
,20160205,1881,1881,,,,1881,1881,0,0,0,0.00,0
,20160215,1881,1881,,,,1881,1881,0,0,0,0.00,0
,20160216,1881,1881,,,,1881,1881,0,0,0,0.00,0
,20160217,1881,1881,,,,1881,1881,0,0,0,0.00,0
,20160218,1881,1881,,,,1881,1881,0,0,0,0.00,0
,20160219,1881,1881,,,,1881,1881,0,0,0,0.00,0
,20160222,1881,1881,,,,1881,1881,0,0,0,0.00,0
,20160223,1881,1881,,,,1881,1881,0,0,0,0.00,0
,20160224,1881,1881,,,,1881,1881,0,0,0,0.00,0
,20160225,1881,1881,,,,1881,1881,0,0,0,0.00,0
,20160226,1881,1881,,,,1881,1881,0,0,0,0.00,0
,20160229,1881,1881,,,,1881,1881,0,0,0,0.00,0
,20160301,1881,1881,,,,1881,1881,0,0,0,0.00,0
,20160302,1881,1881,,,,1881,1881,0,0,0,0.00,0
,20160303,1881,1881,,,,1881,1881,0,0,0,0.00,0
,20160304,1881,1881,,,,1881,1881,0,0,0,0.00,0
,20160307,1881,1881,,,,1881,1881,0,0,0,0.00,0
,20160308,1881,1881,,,,1881,1881,0,0,0,0.00,0
,20160309,1881,1881,,,,1881,1881,0,0,0,0.00,0
,20160310,1881,1881,,,,1881,1881,0,0,0,0.00,0
,20160311,1881,1881,,,,1881,1881,0,0,0,0.00,0
,20160314,1881,1881,,,,1881,1881,0,0,0,0.00,0
,20160315,1881,1881,,,,1881,1881,0,0,0,0.00,0
,20160316,1881,1881,,,,1881,1881,0,0,0,0.00,0
,20160317,1881,1881,,,,1975,1975,94,94,0,0.00,0
,20160318,1975,1975,,,,1975,1975,0,0,0,0.00,0
,20160321,1975,1975,,,,1975,1975,0,0,0,0.00,0
,20160322,1975,1975,,,,1975,1975,0,0,0,0.00,0
,20160323,1975,1975,,,,1975,1975,0,0,0,0.00,0
,20160324,1975,1975,,,,2073,2073,98,98,0,0.00,0
,20160325,2073,2073,,,,2073,2073,0,0,0,0.00,0
,20160328,2073,2073,,,,2073,2073,0,0,0,0.00,0
,20160329,2073,2073,,,,2073,2073,0,0,0,0.00,0
,20160330,2073,2073,,,,2073,2073,0,0,0,0.00,0
,20160331,2073,2073,,,,2073,2073,0,0,0,0.00,0
,20160401,2073,2073,,,,2073,2073,0,0,0,0.00,0
,20160405,2073,2073,,,,2073,2073,0,0,0,0.00,0
,20160406,2073,2073,,,,2073,2073,0,0,0,0.00,0
,20160407,2073,2073,,,,2073,2073,0,0,0,0.00,0
,20160408,2073,2073,,,,2073,2073,0,0,0,0.00,0
,20160411,2073,2073,,,,2073,2073,0,0,0,0.00,0
,20160412,2073,2073,,,,2073,2073,0,0,0,0.00,0
,20160413,2073,2073,,,,2073,2073,0,0,0,0.00,0
,20160414,2073,2073,,,,2073,2073,0,0,0,0.00,0
,20160415,2073,2073,,,,2073,2073,0,0,0,0.00,0
,20160418,2073,2073,,,,2073,2073,0,0,0,0.00,0
,20160419,2073,2073,,,,2073,2073,0,0,0,0.00,0
,20160420,2073,2073,,,,2073,2073,0,0,0,0.00,0
,20160421,2073,2073,,,,2073,2073,0,0,0,0.00,0
,20160422,2073,2073,,,,2073,2073,0,0,0,0.00,0
,20160425,2073,2073,,,,2073,2073,0,0,0,0.00,0
,20160426,2073,2073,,,,2073,2073,0,0,0,0.00,0
,20160427,2073,2073,,,,2073,2073,0,0,0,0.00,0
,20160428,2073,2073,,,,2073,2073,0,0,0,0.00,0
,20160429,2073,2073,,,,2073,2073,0,0,0,0.00,0
,20160503,2073,2073,,,,2073,2073,0,0,0,0.00,0
,20160504,2073,2073,,,,2073,2073,0,0,0,0.00,0
,20160505,2073,2073,2073,2073,2073,2073,2073,0,0,2,4.15,2
,20160506,2073,2073,,,,2176,2176,103,103,0,0.00,2
,20160509,2176,2176,,,,2176,2176,0,0,0,0.00,2
,20160510,2176,2176,,,,2176,2176,0,0,0,0.00,2
,20160511,2176,2176,,,,2176,2176,0,0,0,0.00,2
,20160512,2176,2176,,,,2176,2176,0,0,0,0.00,2
,20160513,2176,2176,2283,2283,2283,2283,2283,107,107,2,4.57,0
,20160516,2283,2283,,,,2283,2283,0,0,0,0.00,0
,20160517,2283,2283,,,,2283,2283,0,0,0,0.00,0
,20160518,2283,2283,,,,2283,2283,0,0,0,0.00,0
,20160519,2283,2283,,,,2283,2283,0,0,0,0.00,0
,20160520,2283,2283,,,,2283,2283,0,0,0,0.00,0
,20160523,2283,2283,,,,2283,2283,0,0,0,0.00,0
,20160524,2283,2283,,,,2283,2283,0,0,0,0.00,0
,20160525,2283,2283,,,,2283,2283,0,0,0,0.00,0
,20160526,2283,2283,,,,2283,2283,0,0,0,0.00,0
,20160527,2283,2283,,,,2283,2283,0,0,0,0.00,0
,20160530,2283,2283,,,,2283,2283,0,0,0,0.00,0
,20160531,2283,2283,,,,2283,2283,0,0,0,0.00,0
,20160601,2283,2283,,,,2283,2283,0,0,0,0.00,0
,20160602,2283,2283,,,,2283,2283,0,0,0,0.00,0
,20160603,2283,2283,,,,2283,2283,0,0,0,0.00,0
,20160606,2283,2283,,,,2283,2283,0,0,0,0.00,0
,20160607,2283,2283,,,,2283,2283,0,0,0,0.00,0
,20160608,2283,2283,,,,2283,2283,0,0,0,0.00,0
,20160613,2283,2283,,,,2283,2283,0,0,0,0.00,0
,20160614,2283,2283,,,,2283,2283,0,0,0,0.00,0
,20160615,2283,2283,,,,2283,2283,0,0,0,0.00,0
,20160616,2283,2283,,,,2283,2283,0,0,0,0.00,0
,20160617,2283,2283,,,,2283,2283,0,0,0,0.00,0
,20160620,2283,2283,,,,2283,2283,0,0,0,0.00,0
,20160621,2283,2283,,,,2283,2283,0,0,0,0.00,0
,20160622,2283,2283,,,,2283,2283,0,0,0,0.00,0
,20160623,2283,2283,,,,2283,2283,0,0,0,0.00,0
,20160624,2283,2283,,,,2283,2283,0,0,0,0.00,0
,20160627,2283,2283,,,,2283,2283,0,0,0,0.00,0
,20160628,2283,2283,,,,2283,2283,0,0,0,0.00,0
,20160629,2283,2283,,,,2283,2283,0,0,0,0.00,0
,20160630,2283,2283,,,,2283,2283,0,0,0,0.00,0
,20160701,2283,2283,,,,2283,2283,0,0,0,0.00,0
,20160704,2283,2283,,,,2283,2283,0,0,0,0.00,0
,20160705,2283,2283,,,,2283,2283,0,0,0,0.00,0
,20160706,2283,2283,,,,2283,2283,0,0,0,0.00,0
,20160707,2283,2283,2169,2397,2169,2397,2207,114,-76,12,26.48,12
,20160708,2397,2207,,,,2317,2317,110,110,0,0.00,12
,20160711,2317,2317,,,,2317,2317,0,0,0,0.00,12
,20160712,2317,2317,,,,2432,2432,115,115,0,0.00,12
,20160713,2432,2432,2553,2553,2553,2553,2553,121,121,2,5.11,14
,20160714,2553,2553,,,,2553,2553,0,0,0,0.00,14
,20160715,2553,2553,,,,2553,2553,0,0,0,0.00,14
,20160718,2553,2553,,,,2553,2553,0,0,0,0.00,14
,20160719,2553,2553,,,,2553,2553,0,0,0,0.00,14
,20160720,2553,2553,2431,2431,2431,2431,2431,-122,-122,16,38.90,0
,20160721,2431,2431,,,,2431,2431,0,0,0,0.00,0
,20160722,2431,2431,,,,2431,2431,0,0,0,0.00,0
,20160725,2431,2431,,,,2431,2431,0,0,0,0.00,0
,20160726,2431,2431,,,,2431,2431,0,0,0,0.00,0
,20160727,2431,2431,,,,2431,2431,0,0,0,0.00,0
,20160728,2431,2431,,,,2431,2431,0,0,0,0.00,0
,20160729,2431,2431,,,,2431,2431,0,0,0,0.00,0
,20160801,2431,2431,,,,2431,2431,0,0,0,0.00,0
,20160802,2431,2431,,,,2431,2431,0,0,0,0.00,0
,20160803,2431,2431,,,,2431,2431,0,0,0,0.00,0
,20160804,2431,2431,,,,2431,2431,0,0,0,0.00,0
,20160805,2431,2431,,,,2431,2431,0,0,0,0.00,0
,20160808,2431,2431,,,,2431,2431,0,0,0,0.00,0
,20160809,2431,2431,,,,2431,2431,0,0,0,0.00,0
,20160810,2431,2431,,,,2431,2431,0,0,0,0.00,0
,20160811,2431,2431,,,,2431,2431,0,0,0,0.00,0
,20160812,2431,2431,,,,2431,2431,0,0,0,0.00,0
,20160815,2431,2431,,,,2431,2431,0,0,0,0.00,0
,20160816,2431,2431,,,,2431,2431,0,0,0,0.00,0
,20160817,2431,2431,,,,2431,2431,0,0,0,0.00,0
,20160818,2431,2431,,,,2431,2431,0,0,0,0.00,0
,20160819,2431,2431,,,,2431,2431,0,0,0,0.00,0
,20160822,2431,2431,,,,2431,2431,0,0,0,0.00,0
,20160823,2431,2431,,,,2431,2431,0,0,0,0.00,0
,20160824,2431,2431,,,,2431,2431,0,0,0,0.00,0
,20160825,2431,2431,,,,2431,2431,0,0,0,0.00,0
,20160826,2431,2431,,,,2431,2431,0,0,0,0.00,0
,20160829,2431,2431,,,,2431,2431,0,0,0,0.00,0
,20160830,2431,2431,,,,2431,2431,0,0,0,0.00,0
,20160831,2431,2431,,,,2431,2431,0,0,0,0.00,0
,20160901,2431,2431,,,,2431,2431,0,0,0,0.00,0
,20160902,2431,2431,,,,2431,2431,0,0,0,0.00,0
,20160905,2431,2431,,,,2431,2431,0,0,0,0.00,0
,20160906,2431,2431,,,,2431,2431,0,0,0,0.00,0
,20160907,2431,2431,,,,2431,2431,0,0,0,0.00,0
,20160908,2431,2431,,,,2431,2431,0,0,0,0.00,0
,20160909,2431,2431,,,,2431,2431,0,0,0,0.00,0
,20160912,2431,2431,,,,2431,2431,0,0,0,0.00,0
,20160913,2431,2431,,,,2431,2431,0,0,0,0.00,0
,20160914,2431,2431,,,,2431,2431,0,0,0,0.00,0
,20160919,2431,2431,,,,2431,2431,0,0,0,0.00,0
,20160920,2431,2431,,,,2431,2431,0,0,0,0.00,0
,20160921,2431,2431,,,,2431,2431,0,0,0,0.00,0
,20160922,2431,2431,,,,2431,2431,0,0,0,0.00,0
,20160923,2431,2431,,,,2431,2431,0,0,0,0.00,0
,20160926,2431,2431,,,,2431,2431,0,0,0,0.00,0
,20160927,2431,2431,,,,2431,2431,0,0,0,0.00,0
,20160928,2431,2431,,,,2431,2431,0,0,0,0.00,0
,20160929,2431,2431,,,,2431,2431,0,0,0,0.00,0
,20160930,2431,2431,,,,2431,2431,0,0,0,0.00,0
,20161010,2431,2431,,,,2431,2431,0,0,0,0.00,0
,20161011,2431,2431,,,,2431,2431,0,0,0,0.00,0
,20161012,2431,2431,,,,2431,2431,0,0,0,0.00,0
,20161013,2431,2431,,,,2431,2431,0,0,0,0.00,0
,20161014,2431,2431,,,,2431,2431,0,0,0,0.00,0
,20161017,2431,2431,,,,2431,2431,0,0,0,0.00,0
wr1611,20160104,1881,1881,,,,1881,1881,0,0,0,0.00,0
,20160105,1881,1881,,,,1881,1881,0,0,0,0.00,0
,20160106,1881,1881,,,,1881,1881,0,0,0,0.00,0
,20160107,1881,1881,,,,1881,1881,0,0,0,0.00,0
,20160108,1881,1881,,,,1881,1881,0,0,0,0.00,0
,20160111,1881,1881,,,,1881,1881,0,0,0,0.00,0
,20160112,1881,1881,,,,1881,1881,0,0,0,0.00,0
,20160113,1881,1881,,,,1881,1881,0,0,0,0.00,0
,20160114,1881,1881,,,,1881,1881,0,0,0,0.00,0
,20160115,1881,1881,,,,1881,1881,0,0,0,0.00,0
,20160118,1881,1881,,,,1881,1881,0,0,0,0.00,0
,20160119,1881,1881,,,,1881,1881,0,0,0,0.00,0
,20160120,1881,1881,,,,1881,1881,0,0,0,0.00,0
,20160121,1881,1881,,,,1881,1881,0,0,0,0.00,0
,20160122,1881,1881,,,,1881,1881,0,0,0,0.00,0
,20160125,1881,1881,,,,1881,1881,0,0,0,0.00,0
,20160126,1881,1881,,,,1881,1881,0,0,0,0.00,0
,20160127,1881,1881,,,,1881,1881,0,0,0,0.00,0
,20160128,1881,1881,,,,1881,1881,0,0,0,0.00,0
,20160129,1881,1881,,,,1881,1881,0,0,0,0.00,0
,20160201,1881,1881,,,,1881,1881,0,0,0,0.00,0
,20160202,1881,1881,,,,1881,1881,0,0,0,0.00,0
,20160203,1881,1881,,,,1881,1881,0,0,0,0.00,0
,20160204,1881,1881,,,,1881,1881,0,0,0,0.00,0
,20160205,1881,1881,,,,1881,1881,0,0,0,0.00,0
,20160215,1881,1881,,,,1881,1881,0,0,0,0.00,0
,20160216,1881,1881,,,,1881,1881,0,0,0,0.00,0
,20160217,1881,1881,,,,1881,1881,0,0,0,0.00,0
,20160218,1881,1881,,,,1881,1881,0,0,0,0.00,0
,20160219,1881,1881,,,,1881,1881,0,0,0,0.00,0
,20160222,1881,1881,,,,1881,1881,0,0,0,0.00,0
,20160223,1881,1881,,,,1881,1881,0,0,0,0.00,0
,20160224,1881,1881,,,,1881,1881,0,0,0,0.00,0
,20160225,1881,1881,,,,1881,1881,0,0,0,0.00,0
,20160226,1881,1881,,,,1881,1881,0,0,0,0.00,0
,20160229,1881,1881,,,,1881,1881,0,0,0,0.00,0
,20160301,1881,1881,,,,1881,1881,0,0,0,0.00,0
,20160302,1881,1881,,,,1881,1881,0,0,0,0.00,0
,20160303,1881,1881,,,,1881,1881,0,0,0,0.00,0
,20160304,1881,1881,,,,1881,1881,0,0,0,0.00,0
,20160307,1881,1881,,,,1881,1881,0,0,0,0.00,0
,20160308,1881,1881,,,,1881,1881,0,0,0,0.00,0
,20160309,1881,1881,,,,1881,1881,0,0,0,0.00,0
,20160310,1881,1881,,,,1881,1881,0,0,0,0.00,0
,20160311,1881,1881,,,,1881,1881,0,0,0,0.00,0
,20160314,1881,1881,,,,1881,1881,0,0,0,0.00,0
,20160315,1881,1881,,,,1881,1881,0,0,0,0.00,0
,20160316,1881,1881,,,,1881,1881,0,0,0,0.00,0
,20160317,1881,1881,,,,1990,1990,109,109,0,0.00,0
,20160318,1990,1990,,,,1990,1990,0,0,0,0.00,0
,20160321,1990,1990,,,,1990,1990,0,0,0,0.00,0
,20160322,1990,1990,,,,1990,1990,0,0,0,0.00,0
,20160323,1990,1990,,,,1990,1990,0,0,0,0.00,0
,20160324,1990,1990,,,,2117,2117,127,127,0,0.00,0
,20160325,2117,2117,,,,2117,2117,0,0,0,0.00,0
,20160328,2117,2117,,,,2117,2117,0,0,0,0.00,0
,20160329,2117,2117,,,,2117,2117,0,0,0,0.00,0
,20160330,2117,2117,,,,2117,2117,0,0,0,0.00,0
,20160331,2117,2117,,,,2117,2117,0,0,0,0.00,0
,20160401,2117,2117,,,,2117,2117,0,0,0,0.00,0
,20160405,2117,2117,,,,2117,2117,0,0,0,0.00,0
,20160406,2117,2117,,,,2117,2117,0,0,0,0.00,0
,20160407,2117,2117,,,,2117,2117,0,0,0,0.00,0
,20160408,2117,2117,,,,2117,2117,0,0,0,0.00,0
,20160411,2117,2117,,,,2117,2117,0,0,0,0.00,0
,20160412,2117,2117,,,,2117,2117,0,0,0,0.00,0
,20160413,2117,2117,,,,2117,2117,0,0,0,0.00,0
,20160414,2117,2117,,,,2117,2117,0,0,0,0.00,0
,20160415,2117,2117,,,,2117,2117,0,0,0,0.00,0
,20160418,2117,2117,,,,2117,2117,0,0,0,0.00,0
,20160419,2117,2117,,,,2117,2117,0,0,0,0.00,0
,20160420,2117,2117,,,,2117,2117,0,0,0,0.00,0
,20160421,2117,2117,,,,2117,2117,0,0,0,0.00,0
,20160422,2117,2117,,,,2117,2117,0,0,0,0.00,0
,20160425,2117,2117,,,,2117,2117,0,0,0,0.00,0
,20160426,2117,2117,,,,2117,2117,0,0,0,0.00,0
,20160427,2117,2117,,,,2117,2117,0,0,0,0.00,0
,20160428,2117,2117,,,,2117,2117,0,0,0,0.00,0
,20160429,2117,2117,,,,2117,2117,0,0,0,0.00,0
,20160503,2117,2117,,,,2117,2117,0,0,0,0.00,0
,20160504,2117,2117,,,,2117,2117,0,0,0,0.00,0
,20160505,2117,2117,,,,2117,2117,0,0,0,0.00,0
,20160506,2117,2117,,,,2117,2117,0,0,0,0.00,0
,20160509,2117,2117,,,,2117,2117,0,0,0,0.00,0
,20160510,2117,2117,,,,2117,2117,0,0,0,0.00,0
,20160511,2117,2117,,,,2117,2117,0,0,0,0.00,0
,20160512,2117,2117,,,,2117,2117,0,0,0,0.00,0
,20160513,2117,2117,,,,2221,2221,104,104,0,0.00,0
,20160516,2221,2221,,,,2221,2221,0,0,0,0.00,0
,20160517,2221,2221,,,,2221,2221,0,0,0,0.00,0
,20160518,2221,2221,,,,2221,2221,0,0,0,0.00,0
,20160519,2221,2221,,,,2221,2221,0,0,0,0.00,0
,20160520,2221,2221,,,,2221,2221,0,0,0,0.00,0
,20160523,2221,2221,,,,2221,2221,0,0,0,0.00,0
,20160524,2221,2221,,,,2221,2221,0,0,0,0.00,0
,20160525,2221,2221,,,,2221,2221,0,0,0,0.00,0
,20160526,2221,2221,,,,2221,2221,0,0,0,0.00,0
,20160527,2221,2221,,,,2221,2221,0,0,0,0.00,0
,20160530,2221,2221,,,,2221,2221,0,0,0,0.00,0
,20160531,2221,2221,,,,2221,2221,0,0,0,0.00,0
,20160601,2221,2221,,,,2221,2221,0,0,0,0.00,0
,20160602,2221,2221,,,,2221,2221,0,0,0,0.00,0
,20160603,2221,2221,,,,2221,2221,0,0,0,0.00,0
,20160606,2221,2221,,,,2221,2221,0,0,0,0.00,0
,20160607,2221,2221,,,,2221,2221,0,0,0,0.00,0
,20160608,2221,2221,,,,2221,2221,0,0,0,0.00,0
,20160613,2221,2221,,,,2221,2221,0,0,0,0.00,0
,20160614,2221,2221,,,,2221,2221,0,0,0,0.00,0
,20160615,2221,2221,,,,2221,2221,0,0,0,0.00,0
,20160616,2221,2221,,,,2221,2221,0,0,0,0.00,0
,20160617,2221,2221,,,,2221,2221,0,0,0,0.00,0
,20160620,2221,2221,,,,2221,2221,0,0,0,0.00,0
,20160621,2221,2221,,,,2221,2221,0,0,0,0.00,0
,20160622,2221,2221,,,,2221,2221,0,0,0,0.00,0
,20160623,2221,2221,,,,2221,2221,0,0,0,0.00,0
,20160624,2221,2221,,,,2221,2221,0,0,0,0.00,0
,20160627,2221,2221,,,,2221,2221,0,0,0,0.00,0
,20160628,2221,2221,,,,2221,2221,0,0,0,0.00,0
,20160629,2221,2221,,,,2221,2221,0,0,0,0.00,0
,20160630,2221,2221,,,,2221,2221,0,0,0,0.00,0
,20160701,2221,2221,,,,2221,2221,0,0,0,0.00,0
,20160704,2221,2221,,,,2221,2221,0,0,0,0.00,0
,20160705,2221,2221,,,,2221,2221,0,0,0,0.00,0
,20160706,2221,2221,,,,2221,2221,0,0,0,0.00,0
,20160707,2221,2221,,,,2147,2147,-74,-74,0,0.00,0
,20160708,2147,2147,,,,2147,2147,0,0,0,0.00,0
,20160711,2147,2147,,,,2147,2147,0,0,0,0.00,0
,20160712,2147,2147,,,,2147,2147,0,0,0,0.00,0
,20160713,2147,2147,,,,2253,2253,106,106,0,0.00,0
,20160714,2253,2253,,,,2253,2253,0,0,0,0.00,0
,20160715,2253,2253,,,,2253,2253,0,0,0,0.00,0
,20160718,2253,2253,,,,2253,2253,0,0,0,0.00,0
,20160719,2253,2253,,,,2253,2253,0,0,0,0.00,0
,20160720,2253,2253,,,,2145,2145,-108,-108,0,0.00,0
,20160721,2145,2145,,,,2145,2145,0,0,0,0.00,0
,20160722,2145,2145,,,,2145,2145,0,0,0,0.00,0
,20160725,2145,2145,,,,2145,2145,0,0,0,0.00,0
,20160726,2145,2145,,,,2145,2145,0,0,0,0.00,0
,20160727,2145,2145,,,,2145,2145,0,0,0,0.00,0
,20160728,2145,2145,,,,2145,2145,0,0,0,0.00,0
,20160729,2145,2145,,,,2145,2145,0,0,0,0.00,0
,20160801,2145,2145,,,,2145,2145,0,0,0,0.00,0
,20160802,2145,2145,,,,2145,2145,0,0,0,0.00,0
,20160803,2145,2145,,,,2145,2145,0,0,0,0.00,0
,20160804,2145,2145,,,,2145,2145,0,0,0,0.00,0
,20160805,2145,2145,,,,2145,2145,0,0,0,0.00,0
,20160808,2145,2145,,,,2145,2145,0,0,0,0.00,0
,20160809,2145,2145,,,,2145,2145,0,0,0,0.00,0
,20160810,2145,2145,,,,2145,2145,0,0,0,0.00,0
,20160811,2145,2145,,,,2145,2145,0,0,0,0.00,0
,20160812,2145,2145,,,,2145,2145,0,0,0,0.00,0
,20160815,2145,2145,,,,2145,2145,0,0,0,0.00,0
,20160816,2145,2145,,,,2145,2145,0,0,0,0.00,0
,20160817,2145,2145,,,,2145,2145,0,0,0,0.00,0
,20160818,2145,2145,,,,2145,2145,0,0,0,0.00,0
,20160819,2145,2145,,,,2145,2145,0,0,0,0.00,0
,20160822,2145,2145,,,,2145,2145,0,0,0,0.00,0
,20160823,2145,2145,,,,2145,2145,0,0,0,0.00,0
,20160824,2145,2145,,,,2145,2145,0,0,0,0.00,0
,20160825,2145,2145,,,,2145,2145,0,0,0,0.00,0
,20160826,2145,2145,,,,2145,2145,0,0,0,0.00,0
,20160829,2145,2145,,,,2145,2145,0,0,0,0.00,0
,20160830,2145,2145,,,,2145,2145,0,0,0,0.00,0
,20160831,2145,2145,,,,2145,2145,0,0,0,0.00,0
,20160901,2145,2145,,,,2145,2145,0,0,0,0.00,0
,20160902,2145,2145,,,,2145,2145,0,0,0,0.00,0
,20160905,2145,2145,,,,2145,2145,0,0,0,0.00,0
,20160906,2145,2145,,,,2145,2145,0,0,0,0.00,0
,20160907,2145,2145,,,,2145,2145,0,0,0,0.00,0
,20160908,2145,2145,,,,2145,2145,0,0,0,0.00,0
,20160909,2145,2145,,,,2145,2145,0,0,0,0.00,0
,20160912,2145,2145,,,,2145,2145,0,0,0,0.00,0
,20160913,2145,2145,,,,2145,2145,0,0,0,0.00,0
,20160914,2145,2145,,,,2145,2145,0,0,0,0.00,0
,20160919,2145,2145,,,,2145,2145,0,0,0,0.00,0
,20160920,2145,2145,,,,2145,2145,0,0,0,0.00,0
,20160921,2145,2145,,,,2145,2145,0,0,0,0.00,0
,20160922,2145,2145,,,,2145,2145,0,0,0,0.00,0
,20160923,2145,2145,,,,2145,2145,0,0,0,0.00,0
,20160926,2145,2145,,,,2145,2145,0,0,0,0.00,0
,20160927,2145,2145,,,,2145,2145,0,0,0,0.00,0
,20160928,2145,2145,,,,2145,2145,0,0,0,0.00,0
,20160929,2145,2145,,,,2145,2145,0,0,0,0.00,0
,20160930,2145,2145,1931,2340,1931,2340,2135,195,-10,4,8.54,0
,20161010,2340,2135,,,,2135,2135,0,0,0,0.00,0
,20161011,2135,2135,,,,2135,2135,0,0,0,0.00,0
,20161012,2135,2135,,,,2135,2135,0,0,0,0.00,0
,20161013,2135,2135,,,,2135,2135,0,0,0,0.00,0
,20161014,2135,2135,,,,2135,2135,0,0,0,0.00,0
,20161017,2135,2135,,,,2135,2135,0,0,0,0.00,0
,20161018,2135,2135,,,,2135,2135,0,0,0,0.00,0
,20161019,2135,2135,,,,2135,2135,0,0,0,0.00,0
,20161020,2135,2135,,,,2135,2135,0,0,0,0.00,0
,20161021,2135,2135,,,,2135,2135,0,0,0,0.00,0
,20161024,2135,2135,,,,2135,2135,0,0,0,0.00,0
,20161025,2135,2135,,,,2135,2135,0,0,0,0.00,0
,20161026,2135,2135,,,,2135,2135,0,0,0,0.00,0
,20161027,2135,2135,,,,2135,2135,0,0,0,0.00,0
,20161028,2135,2135,,,,2135,2135,0,0,0,0.00,0
,20161031,2135,2135,,,,2135,2135,0,0,0,0.00,0
,20161101,2135,2135,,,,2135,2135,0,0,0,0.00,0
,20161102,2135,2135,,,,2135,2135,0,0,0,0.00,0
,20161103,2135,2135,,,,2135,2135,0,0,0,0.00,0
,20161104,2135,2135,,,,2135,2135,0,0,0,0.00,0
,20161107,2135,2135,,,,2135,2135,0,0,0,0.00,0
,20161108,2135,2135,,,,2135,2135,0,0,0,0.00,0
,20161109,2135,2135,,,,2135,2135,0,0,0,0.00,0
,20161110,2135,2135,,,,2135,2135,0,0,0,0.00,0
,20161111,2135,2135,,,,2135,2135,0,0,0,0.00,0
,20161114,2135,2135,,,,2135,2135,0,0,0,0.00,0
,20161115,2135,2135,,,,2135,2135,0,0,0,0.00,0
wr1612,20160104,1881,1881,,,,1881,1881,0,0,0,0.00,0
,20160105,1881,1881,,,,1881,1881,0,0,0,0.00,0
,20160106,1881,1881,,,,1881,1881,0,0,0,0.00,0
,20160107,1881,1881,,,,1881,1881,0,0,0,0.00,0
,20160108,1881,1881,,,,1881,1881,0,0,0,0.00,0
,20160111,1881,1881,,,,1881,1881,0,0,0,0.00,0
,20160112,1881,1881,,,,1881,1881,0,0,0,0.00,0
,20160113,1881,1881,,,,1881,1881,0,0,0,0.00,0
,20160114,1881,1881,,,,1881,1881,0,0,0,0.00,0
,20160115,1881,1881,,,,1881,1881,0,0,0,0.00,0
,20160118,1881,1881,,,,1881,1881,0,0,0,0.00,0
,20160119,1881,1881,,,,1881,1881,0,0,0,0.00,0
,20160120,1881,1881,,,,1881,1881,0,0,0,0.00,0
,20160121,1881,1881,,,,1881,1881,0,0,0,0.00,0
,20160122,1881,1881,,,,1881,1881,0,0,0,0.00,0
,20160125,1881,1881,,,,1881,1881,0,0,0,0.00,0
,20160126,1881,1881,,,,1881,1881,0,0,0,0.00,0
,20160127,1881,1881,,,,1881,1881,0,0,0,0.00,0
,20160128,1881,1881,,,,1881,1881,0,0,0,0.00,0
,20160129,1881,1881,,,,1881,1881,0,0,0,0.00,0
,20160201,1881,1881,,,,1881,1881,0,0,0,0.00,0
,20160202,1881,1881,,,,1881,1881,0,0,0,0.00,0
,20160203,1881,1881,,,,1881,1881,0,0,0,0.00,0
,20160204,1881,1881,,,,1881,1881,0,0,0,0.00,0
,20160205,1881,1881,,,,1881,1881,0,0,0,0.00,0
,20160215,1881,1881,,,,1881,1881,0,0,0,0.00,0
,20160216,1881,1881,,,,1881,1881,0,0,0,0.00,0
,20160217,1881,1881,,,,1881,1881,0,0,0,0.00,0
,20160218,1881,1881,,,,1881,1881,0,0,0,0.00,0
,20160219,1881,1881,,,,1881,1881,0,0,0,0.00,0
,20160222,1881,1881,,,,1881,1881,0,0,0,0.00,0
,20160223,1881,1881,,,,1881,1881,0,0,0,0.00,0
,20160224,1881,1881,,,,1881,1881,0,0,0,0.00,0
,20160225,1881,1881,,,,1881,1881,0,0,0,0.00,0
,20160226,1881,1881,,,,1881,1881,0,0,0,0.00,0
,20160229,1881,1881,,,,1881,1881,0,0,0,0.00,0
,20160301,1881,1881,,,,1881,1881,0,0,0,0.00,0
,20160302,1881,1881,,,,1881,1881,0,0,0,0.00,0
,20160303,1881,1881,,,,1881,1881,0,0,0,0.00,0
,20160304,1881,1881,,,,1881,1881,0,0,0,0.00,0
,20160307,1881,1881,,,,1881,1881,0,0,0,0.00,0
,20160308,1881,1881,,,,1881,1881,0,0,0,0.00,0
,20160309,1881,1881,,,,1881,1881,0,0,0,0.00,0
,20160310,1881,1881,,,,1881,1881,0,0,0,0.00,0
,20160311,1881,1881,,,,1881,1881,0,0,0,0.00,0
,20160314,1881,1881,,,,1881,1881,0,0,0,0.00,0
,20160315,1881,1881,,,,1881,1881,0,0,0,0.00,0
,20160316,1881,1881,,,,1881,1881,0,0,0,0.00,0
,20160317,1881,1881,,,,1990,1990,109,109,0,0.00,0
,20160318,1990,1990,,,,1990,1990,0,0,0,0.00,0
,20160321,1990,1990,,,,1990,1990,0,0,0,0.00,0
,20160322,1990,1990,,,,1990,1990,0,0,0,0.00,0
,20160323,1990,1990,,,,1990,1990,0,0,0,0.00,0
,20160324,1990,1990,,,,2117,2117,127,127,0,0.00,0
,20160325,2117,2117,,,,2117,2117,0,0,0,0.00,0
,20160328,2117,2117,,,,2117,2117,0,0,0,0.00,0
,20160329,2117,2117,,,,2117,2117,0,0,0,0.00,0
,20160330,2117,2117,,,,2117,2117,0,0,0,0.00,0
,20160331,2117,2117,,,,2117,2117,0,0,0,0.00,0
,20160401,2117,2117,,,,2117,2117,0,0,0,0.00,0
,20160405,2117,2117,,,,2117,2117,0,0,0,0.00,0
,20160406,2117,2117,,,,2117,2117,0,0,0,0.00,0
,20160407,2117,2117,,,,2117,2117,0,0,0,0.00,0
,20160408,2117,2117,,,,2117,2117,0,0,0,0.00,0
,20160411,2117,2117,,,,2117,2117,0,0,0,0.00,0
,20160412,2117,2117,,,,2117,2117,0,0,0,0.00,0
,20160413,2117,2117,,,,2117,2117,0,0,0,0.00,0
,20160414,2117,2117,,,,2117,2117,0,0,0,0.00,0
,20160415,2117,2117,,,,2117,2117,0,0,0,0.00,0
,20160418,2117,2117,,,,2117,2117,0,0,0,0.00,0
,20160419,2117,2117,,,,2117,2117,0,0,0,0.00,0
,20160420,2117,2117,,,,2117,2117,0,0,0,0.00,0
,20160421,2117,2117,,,,2117,2117,0,0,0,0.00,0
,20160422,2117,2117,,,,2117,2117,0,0,0,0.00,0
,20160425,2117,2117,,,,2117,2117,0,0,0,0.00,0
,20160426,2117,2117,,,,2117,2117,0,0,0,0.00,0
,20160427,2117,2117,,,,2117,2117,0,0,0,0.00,0
,20160428,2117,2117,,,,2117,2117,0,0,0,0.00,0
,20160429,2117,2117,,,,2117,2117,0,0,0,0.00,0
,20160503,2117,2117,,,,2117,2117,0,0,0,0.00,0
,20160504,2117,2117,,,,2117,2117,0,0,0,0.00,0
,20160505,2117,2117,,,,2117,2117,0,0,0,0.00,0
,20160506,2117,2117,,,,2117,2117,0,0,0,0.00,0
,20160509,2117,2117,,,,2117,2117,0,0,0,0.00,0
,20160510,2117,2117,,,,2117,2117,0,0,0,0.00,0
,20160511,2117,2117,,,,2117,2117,0,0,0,0.00,0
,20160512,2117,2117,,,,2117,2117,0,0,0,0.00,0
,20160513,2117,2117,,,,2221,2221,104,104,0,0.00,0
,20160516,2221,2221,,,,2221,2221,0,0,0,0.00,0
,20160517,2221,2221,,,,2221,2221,0,0,0,0.00,0
,20160518,2221,2221,,,,2221,2221,0,0,0,0.00,0
,20160519,2221,2221,,,,2221,2221,0,0,0,0.00,0
,20160520,2221,2221,,,,2221,2221,0,0,0,0.00,0
,20160523,2221,2221,,,,2221,2221,0,0,0,0.00,0
,20160524,2221,2221,,,,2221,2221,0,0,0,0.00,0
,20160525,2221,2221,,,,2221,2221,0,0,0,0.00,0
,20160526,2221,2221,,,,2221,2221,0,0,0,0.00,0
,20160527,2221,2221,,,,2221,2221,0,0,0,0.00,0
,20160530,2221,2221,,,,2221,2221,0,0,0,0.00,0
,20160531,2221,2221,,,,2221,2221,0,0,0,0.00,0
,20160601,2221,2221,,,,2221,2221,0,0,0,0.00,0
,20160602,2221,2221,,,,2221,2221,0,0,0,0.00,0
,20160603,2221,2221,,,,2221,2221,0,0,0,0.00,0
,20160606,2221,2221,,,,2221,2221,0,0,0,0.00,0
,20160607,2221,2221,,,,2221,2221,0,0,0,0.00,0
,20160608,2221,2221,,,,2221,2221,0,0,0,0.00,0
,20160613,2221,2221,,,,2221,2221,0,0,0,0.00,0
,20160614,2221,2221,,,,2221,2221,0,0,0,0.00,0
,20160615,2221,2221,,,,2221,2221,0,0,0,0.00,0
,20160616,2221,2221,,,,2221,2221,0,0,0,0.00,0
,20160617,2221,2221,,,,2221,2221,0,0,0,0.00,0
,20160620,2221,2221,,,,2221,2221,0,0,0,0.00,0
,20160621,2221,2221,,,,2221,2221,0,0,0,0.00,0
,20160622,2221,2221,,,,2221,2221,0,0,0,0.00,0
,20160623,2221,2221,,,,2221,2221,0,0,0,0.00,0
,20160624,2221,2221,,,,2221,2221,0,0,0,0.00,0
,20160627,2221,2221,,,,2221,2221,0,0,0,0.00,0
,20160628,2221,2221,,,,2221,2221,0,0,0,0.00,0
,20160629,2221,2221,,,,2221,2221,0,0,0,0.00,0
,20160630,2221,2221,,,,2221,2221,0,0,0,0.00,0
,20160701,2221,2221,,,,2221,2221,0,0,0,0.00,0
,20160704,2221,2221,,,,2221,2221,0,0,0,0.00,0
,20160705,2221,2221,,,,2221,2221,0,0,0,0.00,0
,20160706,2221,2221,,,,2221,2221,0,0,0,0.00,0
,20160707,2221,2221,,,,2147,2147,-74,-74,0,0.00,0
,20160708,2147,2147,,,,2147,2147,0,0,0,0.00,0
,20160711,2147,2147,,,,2147,2147,0,0,0,0.00,0
,20160712,2147,2147,,,,2147,2147,0,0,0,0.00,0
,20160713,2147,2147,,,,2253,2253,106,106,0,0.00,0
,20160714,2253,2253,,,,2253,2253,0,0,0,0.00,0
,20160715,2253,2253,,,,2253,2253,0,0,0,0.00,0
,20160718,2253,2253,,,,2253,2253,0,0,0,0.00,0
,20160719,2253,2253,,,,2253,2253,0,0,0,0.00,0
,20160720,2253,2253,,,,2145,2145,-108,-108,0,0.00,0
,20160721,2145,2145,,,,2145,2145,0,0,0,0.00,0
,20160722,2145,2145,,,,2145,2145,0,0,0,0.00,0
,20160725,2145,2145,,,,2145,2145,0,0,0,0.00,0
,20160726,2145,2145,,,,2145,2145,0,0,0,0.00,0
,20160727,2145,2145,,,,2145,2145,0,0,0,0.00,0
,20160728,2145,2145,,,,2145,2145,0,0,0,0.00,0
,20160729,2145,2145,,,,2145,2145,0,0,0,0.00,0
,20160801,2145,2145,,,,2145,2145,0,0,0,0.00,0
,20160802,2145,2145,,,,2145,2145,0,0,0,0.00,0
,20160803,2145,2145,,,,2145,2145,0,0,0,0.00,0
,20160804,2145,2145,,,,2145,2145,0,0,0,0.00,0
,20160805,2145,2145,,,,2145,2145,0,0,0,0.00,0
,20160808,2145,2145,,,,2145,2145,0,0,0,0.00,0
,20160809,2145,2145,,,,2145,2145,0,0,0,0.00,0
,20160810,2145,2145,,,,2145,2145,0,0,0,0.00,0
,20160811,2145,2145,,,,2145,2145,0,0,0,0.00,0
,20160812,2145,2145,,,,2145,2145,0,0,0,0.00,0
,20160815,2145,2145,,,,2145,2145,0,0,0,0.00,0
,20160816,2145,2145,,,,2145,2145,0,0,0,0.00,0
,20160817,2145,2145,,,,2145,2145,0,0,0,0.00,0
,20160818,2145,2145,,,,2145,2145,0,0,0,0.00,0
,20160819,2145,2145,,,,2145,2145,0,0,0,0.00,0
,20160822,2145,2145,,,,2145,2145,0,0,0,0.00,0
,20160823,2145,2145,,,,2145,2145,0,0,0,0.00,0
,20160824,2145,2145,,,,2145,2145,0,0,0,0.00,0
,20160825,2145,2145,,,,2145,2145,0,0,0,0.00,0
,20160826,2145,2145,,,,2145,2145,0,0,0,0.00,0
,20160829,2145,2145,,,,2145,2145,0,0,0,0.00,0
,20160830,2145,2145,,,,2145,2145,0,0,0,0.00,0
,20160831,2145,2145,,,,2145,2145,0,0,0,0.00,0
,20160901,2145,2145,,,,2145,2145,0,0,0,0.00,0
,20160902,2145,2145,,,,2145,2145,0,0,0,0.00,0
,20160905,2145,2145,,,,2145,2145,0,0,0,0.00,0
,20160906,2145,2145,,,,2145,2145,0,0,0,0.00,0
,20160907,2145,2145,,,,2145,2145,0,0,0,0.00,0
,20160908,2145,2145,,,,2145,2145,0,0,0,0.00,0
,20160909,2145,2145,,,,2145,2145,0,0,0,0.00,0
,20160912,2145,2145,,,,2145,2145,0,0,0,0.00,0
,20160913,2145,2145,,,,2145,2145,0,0,0,0.00,0
,20160914,2145,2145,,,,2145,2145,0,0,0,0.00,0
,20160919,2145,2145,,,,2145,2145,0,0,0,0.00,0
,20160920,2145,2145,,,,2145,2145,0,0,0,0.00,0
,20160921,2145,2145,,,,2145,2145,0,0,0,0.00,0
,20160922,2145,2145,,,,2145,2145,0,0,0,0.00,0
,20160923,2145,2145,,,,2145,2145,0,0,0,0.00,0
,20160926,2145,2145,,,,2145,2145,0,0,0,0.00,0
,20160927,2145,2145,,,,2145,2145,0,0,0,0.00,0
,20160928,2145,2145,,,,2145,2145,0,0,0,0.00,0
,20160929,2145,2145,,,,2145,2145,0,0,0,0.00,0
,20160930,2145,2145,,,,2135,2135,-10,-10,0,0.00,0
,20161010,2135,2135,,,,2135,2135,0,0,0,0.00,0
,20161011,2135,2135,,,,2135,2135,0,0,0,0.00,0
,20161012,2135,2135,,,,2135,2135,0,0,0,0.00,0
,20161013,2135,2135,,,,2135,2135,0,0,0,0.00,0
,20161014,2135,2135,,,,2135,2135,0,0,0,0.00,0
,20161017,2135,2135,,,,2135,2135,0,0,0,0.00,0
,20161018,2135,2135,,,,2135,2135,0,0,0,0.00,0
,20161019,2135,2135,,,,2135,2135,0,0,0,0.00,0
,20161020,2135,2135,,,,2135,2135,0,0,0,0.00,0
,20161021,2135,2135,,,,2135,2135,0,0,0,0.00,0
,20161024,2135,2135,,,,2135,2135,0,0,0,0.00,0
,20161025,2135,2135,,,,2135,2135,0,0,0,0.00,0
,20161026,2135,2135,,,,2135,2135,0,0,0,0.00,0
,20161027,2135,2135,,,,2135,2135,0,0,0,0.00,0
,20161028,2135,2135,,,,2135,2135,0,0,0,0.00,0
,20161031,2135,2135,,,,2135,2135,0,0,0,0.00,0
,20161101,2135,2135,,,,2135,2135,0,0,0,0.00,0
,20161102,2135,2135,,,,2135,2135,0,0,0,0.00,0
,20161103,2135,2135,,,,2135,2135,0,0,0,0.00,0
,20161104,2135,2135,,,,2135,2135,0,0,0,0.00,0
,20161107,2135,2135,,,,2135,2135,0,0,0,0.00,0
,20161108,2135,2135,,,,2135,2135,0,0,0,0.00,0
,20161109,2135,2135,,,,2135,2135,0,0,0,0.00,0
,20161110,2135,2135,,,,2135,2135,0,0,0,0.00,0
,20161111,2135,2135,,,,2135,2135,0,0,0,0.00,0
,20161114,2135,2135,,,,2135,2135,0,0,0,0.00,0
,20161115,2135,2135,,,,2135,2135,0,0,0,0.00,0
,20161116,2135,2135,,,,2135,2135,0,0,0,0.00,0
,20161117,2135,2135,,,,2135,2135,0,0,0,0.00,0
,20161118,2135,2135,,,,2135,2135,0,0,0,0.00,0
,20161121,2135,2135,,,,2135,2135,0,0,0,0.00,0
,20161122,2135,2135,,,,2135,2135,0,0,0,0.00,0
,20161123,2135,2135,,,,2135,2135,0,0,0,0.00,0
,20161124,2135,2135,,,,2135,2135,0,0,0,0.00,0
,20161125,2135,2135,,,,2135,2135,0,0,0,0.00,0
,20161128,2135,2135,,,,2135,2135,0,0,0,0.00,0
,20161129,2135,2135,,,,2135,2135,0,0,0,0.00,0
,20161130,2135,2135,,,,2135,2135,0,0,0,0.00,0
,20161201,2135,2135,,,,2135,2135,0,0,0,0.00,0
,20161202,2135,2135,,,,2135,2135,0,0,0,0.00,0
,20161205,2135,2135,,,,2135,2135,0,0,0,0.00,0
,20161206,2135,2135,,,,2135,2135,0,0,0,0.00,0
,20161207,2135,2135,,,,2135,2135,0,0,0,0.00,0
,20161208,2135,2135,,,,2135,2135,0,0,0,0.00,0
,20161209,2135,2135,,,,2135,2135,0,0,0,0.00,0
,20161212,2135,2135,,,,2135,2135,0,0,0,0.00,0
,20161213,2135,2135,,,,2135,2135,0,0,0,0.00,0
,20161214,2135,2135,,,,2135,2135,0,0,0,0.00,0
,20161215,2135,2135,,,,2135,2135,0,0,0,0.00,0
wr1701,20160118,1881,1881,,,,1881,1881,0,0,0,0.00,0
,20160119,1881,1881,,,,1881,1881,0,0,0,0.00,0
,20160120,1881,1881,,,,1881,1881,0,0,0,0.00,0
,20160121,1881,1881,,,,1881,1881,0,0,0,0.00,0
,20160122,1881,1881,,,,1881,1881,0,0,0,0.00,0
,20160125,1881,1881,,,,1881,1881,0,0,0,0.00,0
,20160126,1881,1881,1888,1888,1888,1888,1888,7,7,2,3.78,2
,20160127,1888,1888,,,,1888,1888,0,0,0,0.00,2
,20160128,1888,1888,,,,1982,1982,94,94,0,0.00,2
,20160129,1982,1982,,,,1982,1982,0,0,0,0.00,2
,20160201,1982,1982,,,,1982,1982,0,0,0,0.00,2
,20160202,1982,1982,,,,1982,1982,0,0,0,0.00,2
,20160203,1982,1982,,,,1982,1982,0,0,0,0.00,2
,20160204,1982,1982,,,,1982,1982,0,0,0,0.00,2
,20160205,1982,1982,,,,1982,1982,0,0,0,0.00,2
,20160215,1982,1982,,,,1982,1982,0,0,0,0.00,2
,20160216,1982,1982,,,,1982,1982,0,0,0,0.00,2
,20160217,1982,1982,,,,1982,1982,0,0,0,0.00,2
,20160218,1982,1982,,,,1982,1982,0,0,0,0.00,2
,20160219,1982,1982,,,,1982,1982,0,0,0,0.00,2
,20160222,1982,1982,,,,1982,1982,0,0,0,0.00,2
,20160223,1982,1982,,,,1982,1982,0,0,0,0.00,2
,20160224,1982,1982,,,,1982,1982,0,0,0,0.00,2
,20160225,1982,1982,,,,1982,1982,0,0,0,0.00,2
,20160226,1982,1982,,,,1982,1982,0,0,0,0.00,2
,20160229,1982,1982,,,,1982,1982,0,0,0,0.00,2
,20160301,1982,1982,,,,1982,1982,0,0,0,0.00,2
,20160302,1982,1982,,,,1982,1982,0,0,0,0.00,2
,20160303,1982,1982,,,,1982,1982,0,0,0,0.00,2
,20160304,1982,1982,,,,1982,1982,0,0,0,0.00,2
,20160307,1982,1982,,,,1982,1982,0,0,0,0.00,2
,20160308,1982,1982,,,,1982,1982,0,0,0,0.00,2
,20160309,1982,1982,,,,1982,1982,0,0,0,0.00,2
,20160310,1982,1982,,,,2081,2081,99,99,0,0.00,2
,20160311,2081,2081,,,,2185,2185,104,104,0,0.00,2
,20160314,2185,2185,2290,2290,2290,2290,2290,105,105,2,4.58,0
,20160315,2290,2290,,,,2290,2290,0,0,0,0.00,0
,20160316,2290,2290,,,,2290,2290,0,0,0,0.00,0
,20160317,2290,2290,,,,2404,2404,114,114,0,0.00,0
,20160318,2404,2404,,,,2404,2404,0,0,0,0.00,0
,20160321,2404,2404,,,,2404,2404,0,0,0,0.00,0
,20160322,2404,2404,,,,2404,2404,0,0,0,0.00,0
,20160323,2404,2404,,,,2404,2404,0,0,0,0.00,0
,20160324,2404,2404,,,,2524,2524,120,120,0,0.00,0
,20160325,2524,2524,,,,2524,2524,0,0,0,0.00,0
,20160328,2524,2524,,,,2524,2524,0,0,0,0.00,0
,20160329,2524,2524,,,,2524,2524,0,0,0,0.00,0
,20160330,2524,2524,,,,2524,2524,0,0,0,0.00,0
,20160331,2524,2524,,,,2524,2524,0,0,0,0.00,0
,20160401,2524,2524,,,,2524,2524,0,0,0,0.00,0
,20160405,2524,2524,,,,2524,2524,0,0,0,0.00,0
,20160406,2524,2524,,,,2524,2524,0,0,0,0.00,0
,20160407,2524,2524,,,,2524,2524,0,0,0,0.00,0
,20160408,2524,2524,,,,2524,2524,0,0,0,0.00,0
,20160411,2524,2524,,,,2524,2524,0,0,0,0.00,0
,20160412,2524,2524,,,,2524,2524,0,0,0,0.00,0
,20160413,2524,2524,,,,2524,2524,0,0,0,0.00,0
,20160414,2524,2524,,,,2524,2524,0,0,0,0.00,0
,20160415,2524,2524,,,,2524,2524,0,0,0,0.00,0
,20160418,2524,2524,,,,2524,2524,0,0,0,0.00,0
,20160419,2524,2524,,,,2524,2524,0,0,0,0.00,0
,20160420,2524,2524,,,,2524,2524,0,0,0,0.00,0
,20160421,2524,2524,,,,2524,2524,0,0,0,0.00,0
,20160422,2524,2524,,,,2524,2524,0,0,0,0.00,0
,20160425,2524,2524,2524,2524,2524,2524,2524,0,0,4,10.10,4
,20160426,2524,2524,,,,2524,2524,0,0,0,0.00,4
,20160427,2524,2524,,,,2524,2524,0,0,0,0.00,4
,20160428,2524,2524,2649,2649,2649,2649,2649,125,125,4,10.60,0
,20160429,2649,2649,,,,2649,2649,0,0,0,0.00,0
,20160503,2649,2649,,,,2649,2649,0,0,0,0.00,0
,20160504,2649,2649,,,,2649,2649,0,0,0,0.00,0
,20160505,2649,2649,,,,2649,2649,0,0,0,0.00,0
,20160506,2649,2649,,,,2649,2649,0,0,0,0.00,0
,20160509,2649,2649,,,,2649,2649,0,0,0,0.00,0
,20160510,2649,2649,,,,2649,2649,0,0,0,0.00,0
,20160511,2649,2649,,,,2649,2649,0,0,0,0.00,0
,20160512,2649,2649,,,,2649,2649,0,0,0,0.00,0
,20160513,2649,2649,,,,2779,2779,130,130,0,0.00,0
,20160516,2779,2779,,,,2779,2779,0,0,0,0.00,0
,20160517,2779,2779,,,,2779,2779,0,0,0,0.00,0
,20160518,2779,2779,,,,2779,2779,0,0,0,0.00,0
,20160519,2779,2779,,,,2779,2779,0,0,0,0.00,0
,20160520,2779,2779,,,,2779,2779,0,0,0,0.00,0
,20160523,2779,2779,,,,2779,2779,0,0,0,0.00,0
,20160524,2779,2779,,,,2779,2779,0,0,0,0.00,0
,20160525,2779,2779,,,,2779,2779,0,0,0,0.00,0
,20160526,2779,2779,,,,2779,2779,0,0,0,0.00,0
,20160527,2779,2779,,,,2779,2779,0,0,0,0.00,0
,20160530,2779,2779,,,,2779,2779,0,0,0,0.00,0
,20160531,2779,2779,,,,2779,2779,0,0,0,0.00,0
,20160601,2779,2779,,,,2779,2779,0,0,0,0.00,0
,20160602,2779,2779,,,,2779,2779,0,0,0,0.00,0
,20160603,2779,2779,,,,2779,2779,0,0,0,0.00,0
,20160606,2779,2779,,,,2779,2779,0,0,0,0.00,0
,20160607,2779,2779,,,,2779,2779,0,0,0,0.00,0
,20160608,2779,2779,,,,2779,2779,0,0,0,0.00,0
,20160613,2779,2779,,,,2779,2779,0,0,0,0.00,0
,20160614,2779,2779,,,,2779,2779,0,0,0,0.00,0
,20160615,2779,2779,,,,2779,2779,0,0,0,0.00,0
,20160616,2779,2779,,,,2779,2779,0,0,0,0.00,0
,20160617,2779,2779,,,,2779,2779,0,0,0,0.00,0
,20160620,2779,2779,,,,2779,2779,0,0,0,0.00,0
,20160621,2779,2779,,,,2779,2779,0,0,0,0.00,0
,20160622,2779,2779,,,,2779,2779,0,0,0,0.00,0
,20160623,2779,2779,,,,2779,2779,0,0,0,0.00,0
,20160624,2779,2779,,,,2779,2779,0,0,0,0.00,0
,20160627,2779,2779,2640,2640,2640,2640,2640,-139,-139,2,5.28,2
,20160628,2640,2640,2508,2508,2508,2508,2508,-132,-132,4,10.03,4
,20160629,2508,2508,,,,2508,2508,0,0,0,0.00,4
,20160630,2508,2508,2382,2580,2382,2383,2448,-125,-60,6,14.69,0
,20160701,2383,2448,,,,2448,2448,0,0,0,0.00,0
,20160704,2448,2448,,,,2448,2448,0,0,0,0.00,0
,20160705,2448,2448,,,,2448,2448,0,0,0,0.00,0
,20160706,2448,2448,,,,2448,2448,0,0,0,0.00,0
,20160707,2448,2448,,,,2366,2366,-82,-82,0,0.00,0
,20160708,2366,2366,,,,2366,2366,0,0,0,0.00,0
,20160711,2366,2366,,,,2366,2366,0,0,0,0.00,0
,20160712,2366,2366,,,,2366,2366,0,0,0,0.00,0
,20160713,2366,2366,,,,2483,2483,117,117,0,0.00,0
,20160714,2483,2483,,,,2483,2483,0,0,0,0.00,0
,20160715,2483,2483,,,,2483,2483,0,0,0,0.00,0
,20160718,2483,2483,,,,2483,2483,0,0,0,0.00,0
,20160719,2483,2483,,,,2483,2483,0,0,0,0.00,0
,20160720,2483,2483,,,,2364,2364,-119,-119,0,0.00,0
,20160721,2364,2364,,,,2364,2364,0,0,0,0.00,0
,20160722,2364,2364,,,,2364,2364,0,0,0,0.00,0
,20160725,2364,2364,,,,2364,2364,0,0,0,0.00,0
,20160726,2364,2364,,,,2364,2364,0,0,0,0.00,0
,20160727,2364,2364,,,,2364,2364,0,0,0,0.00,0
,20160728,2364,2364,,,,2364,2364,0,0,0,0.00,0
,20160729,2364,2364,,,,2364,2364,0,0,0,0.00,0
,20160801,2364,2364,,,,2364,2364,0,0,0,0.00,0
,20160802,2364,2364,,,,2364,2364,0,0,0,0.00,0
,20160803,2364,2364,,,,2364,2364,0,0,0,0.00,0
,20160804,2364,2364,,,,2364,2364,0,0,0,0.00,0
,20160805,2364,2364,,,,2364,2364,0,0,0,0.00,0
,20160808,2364,2364,,,,2364,2364,0,0,0,0.00,0
,20160809,2364,2364,,,,2364,2364,0,0,0,0.00,0
,20160810,2364,2364,,,,2364,2364,0,0,0,0.00,0
,20160811,2364,2364,,,,2364,2364,0,0,0,0.00,0
,20160812,2364,2364,,,,2364,2364,0,0,0,0.00,0
,20160815,2364,2364,,,,2364,2364,0,0,0,0.00,0
,20160816,2364,2364,,,,2364,2364,0,0,0,0.00,0
,20160817,2364,2364,,,,2364,2364,0,0,0,0.00,0
,20160818,2364,2364,,,,2364,2364,0,0,0,0.00,0
,20160819,2364,2364,,,,2364,2364,0,0,0,0.00,0
,20160822,2364,2364,,,,2364,2364,0,0,0,0.00,0
,20160823,2364,2364,,,,2364,2364,0,0,0,0.00,0
,20160824,2364,2364,,,,2364,2364,0,0,0,0.00,0
,20160825,2364,2364,,,,2364,2364,0,0,0,0.00,0
,20160826,2364,2364,,,,2364,2364,0,0,0,0.00,0
,20160829,2364,2364,,,,2364,2364,0,0,0,0.00,0
,20160830,2364,2364,,,,2364,2364,0,0,0,0.00,0
,20160831,2364,2364,,,,2364,2364,0,0,0,0.00,0
,20160901,2364,2364,,,,2364,2364,0,0,0,0.00,0
,20160902,2364,2364,,,,2364,2364,0,0,0,0.00,0
,20160905,2364,2364,,,,2364,2364,0,0,0,0.00,0
,20160906,2364,2364,,,,2364,2364,0,0,0,0.00,0
,20160907,2364,2364,,,,2364,2364,0,0,0,0.00,0
,20160908,2364,2364,,,,2364,2364,0,0,0,0.00,0
,20160909,2364,2364,,,,2364,2364,0,0,0,0.00,0
,20160912,2364,2364,,,,2364,2364,0,0,0,0.00,0
,20160913,2364,2364,,,,2364,2364,0,0,0,0.00,0
,20160914,2364,2364,,,,2364,2364,0,0,0,0.00,0
,20160919,2364,2364,,,,2364,2364,0,0,0,0.00,0
,20160920,2364,2364,,,,2364,2364,0,0,0,0.00,0
,20160921,2364,2364,,,,2364,2364,0,0,0,0.00,0
,20160922,2364,2364,,,,2364,2364,0,0,0,0.00,0
,20160923,2364,2364,,,,2364,2364,0,0,0,0.00,0
,20160926,2364,2364,,,,2364,2364,0,0,0,0.00,0
,20160927,2364,2364,,,,2364,2364,0,0,0,0.00,0
,20160928,2364,2364,,,,2364,2364,0,0,0,0.00,0
,20160929,2364,2364,,,,2364,2364,0,0,0,0.00,0
,20160930,2364,2364,,,,2353,2353,-11,-11,0,0.00,0
,20161010,2353,2353,,,,2353,2353,0,0,0,0.00,0
,20161011,2353,2353,,,,2353,2353,0,0,0,0.00,0
,20161012,2353,2353,,,,2353,2353,0,0,0,0.00,0
,20161013,2353,2353,,,,2353,2353,0,0,0,0.00,0
,20161014,2353,2353,,,,2353,2353,0,0,0,0.00,0
,20161017,2353,2353,,,,2353,2353,0,0,0,0.00,0
,20161018,2353,2353,,,,2353,2353,0,0,0,0.00,0
,20161019,2353,2353,,,,2353,2353,0,0,0,0.00,0
,20161020,2353,2353,,,,2353,2353,0,0,0,0.00,0
,20161021,2353,2353,,,,2353,2353,0,0,0,0.00,0
,20161024,2353,2353,,,,2353,2353,0,0,0,0.00,0
,20161025,2353,2353,,,,2353,2353,0,0,0,0.00,0
,20161026,2353,2353,,,,2353,2353,0,0,0,0.00,0
,20161027,2353,2353,,,,2353,2353,0,0,0,0.00,0
,20161028,2353,2353,,,,2353,2353,0,0,0,0.00,0
,20161031,2353,2353,,,,2353,2353,0,0,0,0.00,0
,20161101,2353,2353,,,,2353,2353,0,0,0,0.00,0
,20161102,2353,2353,,,,2353,2353,0,0,0,0.00,0
,20161103,2353,2353,,,,2353,2353,0,0,0,0.00,0
,20161104,2353,2353,,,,2353,2353,0,0,0,0.00,0
,20161107,2353,2353,,,,2353,2353,0,0,0,0.00,0
,20161108,2353,2353,,,,2353,2353,0,0,0,0.00,0
,20161109,2353,2353,,,,2353,2353,0,0,0,0.00,0
,20161110,2353,2353,,,,2353,2353,0,0,0,0.00,0
,20161111,2353,2353,,,,2353,2353,0,0,0,0.00,0
,20161114,2353,2353,,,,2353,2353,0,0,0,0.00,0
,20161115,2353,2353,,,,2353,2353,0,0,0,0.00,0
,20161116,2353,2353,,,,2353,2353,0,0,0,0.00,0
,20161117,2353,2353,,,,2353,2353,0,0,0,0.00,0
,20161118,2353,2353,,,,2353,2353,0,0,0,0.00,0
,20161121,2353,2353,,,,2353,2353,0,0,0,0.00,0
,20161122,2353,2353,,,,2353,2353,0,0,0,0.00,0
,20161123,2353,2353,,,,2353,2353,0,0,0,0.00,0
,20161124,2353,2353,,,,2353,2353,0,0,0,0.00,0
,20161125,2353,2353,,,,2353,2353,0,0,0,0.00,0
,20161128,2353,2353,,,,2353,2353,0,0,0,0.00,0
,20161129,2353,2353,,,,2353,2353,0,0,0,0.00,0
,20161130,2353,2353,,,,2353,2353,0,0,0,0.00,0
,20161201,2353,2353,,,,2353,2353,0,0,0,0.00,0
,20161202,2353,2353,,,,2353,2353,0,0,0,0.00,0
,20161205,2353,2353,,,,2353,2353,0,0,0,0.00,0
,20161206,2353,2353,,,,2353,2353,0,0,0,0.00,0
,20161207,2353,2353,,,,2353,2353,0,0,0,0.00,0
,20161208,2353,2353,,,,2353,2353,0,0,0,0.00,0
,20161209,2353,2353,,,,2353,2353,0,0,0,0.00,0
,20161212,2353,2353,,,,2353,2353,0,0,0,0.00,0
,20161213,2353,2353,,,,2353,2353,0,0,0,0.00,0
,20161214,2353,2353,,,,2353,2353,0,0,0,0.00,0
,20161215,2353,2353,,,,2353,2353,0,0,0,0.00,0
,20161216,2353,2353,,,,2353,2353,0,0,0,0.00,0
,20161219,2353,2353,,,,2353,2353,0,0,0,0.00,0
,20161220,2353,2353,,,,2353,2353,0,0,0,0.00,0
,20161221,2353,2353,,,,2353,2353,0,0,0,0.00,0
,20161222,2353,2353,,,,2353,2353,0,0,0,0.00,0
,20161223,2353,2353,,,,2353,2353,0,0,0,0.00,0
,20161226,2353,2353,,,,2353,2353,0,0,0,0.00,0
,20161227,2353,2353,,,,2353,2353,0,0,0,0.00,0
,20161228,2353,2353,,,,2353,2353,0,0,0,0.00,0
,20161229,2353,2353,,,,2353,2353,0,0,0,0.00,0
,20161230,2353,2353,,,,2353,2353,0,0,0,0.00,0
wr1702,20160216,1982,1982,,,,1982,1982,0,0,0,0.00,0
,20160217,1982,1982,,,,1982,1982,0,0,0,0.00,0
,20160218,1982,1982,,,,1982,1982,0,0,0,0.00,0
,20160219,1982,1982,,,,1982,1982,0,0,0,0.00,0
,20160222,1982,1982,,,,1982,1982,0,0,0,0.00,0
,20160223,1982,1982,,,,1982,1982,0,0,0,0.00,0
,20160224,1982,1982,,,,1982,1982,0,0,0,0.00,0
,20160225,1982,1982,,,,1982,1982,0,0,0,0.00,0
,20160226,1982,1982,,,,1982,1982,0,0,0,0.00,0
,20160229,1982,1982,,,,1982,1982,0,0,0,0.00,0
,20160301,1982,1982,,,,1982,1982,0,0,0,0.00,0
,20160302,1982,1982,,,,1982,1982,0,0,0,0.00,0
,20160303,1982,1982,,,,1982,1982,0,0,0,0.00,0
,20160304,1982,1982,,,,1982,1982,0,0,0,0.00,0
,20160307,1982,1982,,,,1982,1982,0,0,0,0.00,0
,20160308,1982,1982,,,,1982,1982,0,0,0,0.00,0
,20160309,1982,1982,,,,1982,1982,0,0,0,0.00,0
,20160310,1982,1982,,,,1982,1982,0,0,0,0.00,0
,20160311,1982,1982,,,,1982,1982,0,0,0,0.00,0
,20160314,1982,1982,,,,2077,2077,95,95,0,0.00,0
,20160315,2077,2077,,,,2077,2077,0,0,0,0.00,0
,20160316,2077,2077,,,,2077,2077,0,0,0,0.00,0
,20160317,2077,2077,,,,2198,2198,121,121,0,0.00,0
,20160318,2198,2198,,,,2198,2198,0,0,0,0.00,0
,20160321,2198,2198,,,,2198,2198,0,0,0,0.00,0
,20160322,2198,2198,,,,2198,2198,0,0,0,0.00,0
,20160323,2198,2198,,,,2198,2198,0,0,0,0.00,0
,20160324,2198,2198,,,,2338,2338,140,140,0,0.00,0
,20160325,2338,2338,,,,2338,2338,0,0,0,0.00,0
,20160328,2338,2338,,,,2338,2338,0,0,0,0.00,0
,20160329,2338,2338,,,,2338,2338,0,0,0,0.00,0
,20160330,2338,2338,,,,2338,2338,0,0,0,0.00,0
,20160331,2338,2338,,,,2338,2338,0,0,0,0.00,0
,20160401,2338,2338,,,,2338,2338,0,0,0,0.00,0
,20160405,2338,2338,,,,2338,2338,0,0,0,0.00,0
,20160406,2338,2338,,,,2338,2338,0,0,0,0.00,0
,20160407,2338,2338,,,,2338,2338,0,0,0,0.00,0
,20160408,2338,2338,,,,2338,2338,0,0,0,0.00,0
,20160411,2338,2338,,,,2338,2338,0,0,0,0.00,0
,20160412,2338,2338,,,,2338,2338,0,0,0,0.00,0
,20160413,2338,2338,,,,2338,2338,0,0,0,0.00,0
,20160414,2338,2338,,,,2338,2338,0,0,0,0.00,0
,20160415,2338,2338,,,,2338,2338,0,0,0,0.00,0
,20160418,2338,2338,,,,2338,2338,0,0,0,0.00,0
,20160419,2338,2338,,,,2338,2338,0,0,0,0.00,0
,20160420,2338,2338,,,,2338,2338,0,0,0,0.00,0
,20160421,2338,2338,,,,2338,2338,0,0,0,0.00,0
,20160422,2338,2338,,,,2338,2338,0,0,0,0.00,0
,20160425,2338,2338,,,,2338,2338,0,0,0,0.00,0
,20160426,2338,2338,,,,2338,2338,0,0,0,0.00,0
,20160427,2338,2338,,,,2338,2338,0,0,0,0.00,0
,20160428,2338,2338,,,,2453,2453,115,115,0,0.00,0
,20160429,2453,2453,,,,2453,2453,0,0,0,0.00,0
,20160503,2453,2453,,,,2453,2453,0,0,0,0.00,0
,20160504,2453,2453,,,,2453,2453,0,0,0,0.00,0
,20160505,2453,2453,,,,2453,2453,0,0,0,0.00,0
,20160506,2453,2453,,,,2453,2453,0,0,0,0.00,0
,20160509,2453,2453,,,,2453,2453,0,0,0,0.00,0
,20160510,2453,2453,,,,2453,2453,0,0,0,0.00,0
,20160511,2453,2453,,,,2453,2453,0,0,0,0.00,0
,20160512,2453,2453,,,,2453,2453,0,0,0,0.00,0
,20160513,2453,2453,,,,2573,2573,120,120,0,0.00,0
,20160516,2573,2573,,,,2573,2573,0,0,0,0.00,0
,20160517,2573,2573,,,,2573,2573,0,0,0,0.00,0
,20160518,2573,2573,,,,2573,2573,0,0,0,0.00,0
,20160519,2573,2573,,,,2573,2573,0,0,0,0.00,0
,20160520,2573,2573,,,,2573,2573,0,0,0,0.00,0
,20160523,2573,2573,,,,2573,2573,0,0,0,0.00,0
,20160524,2573,2573,,,,2573,2573,0,0,0,0.00,0
,20160525,2573,2573,,,,2573,2573,0,0,0,0.00,0
,20160526,2573,2573,,,,2573,2573,0,0,0,0.00,0
,20160527,2573,2573,,,,2573,2573,0,0,0,0.00,0
,20160530,2573,2573,,,,2573,2573,0,0,0,0.00,0
,20160531,2573,2573,,,,2573,2573,0,0,0,0.00,0
,20160601,2573,2573,,,,2573,2573,0,0,0,0.00,0
,20160602,2573,2573,,,,2573,2573,0,0,0,0.00,0
,20160603,2573,2573,,,,2573,2573,0,0,0,0.00,0
,20160606,2573,2573,,,,2573,2573,0,0,0,0.00,0
,20160607,2573,2573,,,,2573,2573,0,0,0,0.00,0
,20160608,2573,2573,,,,2573,2573,0,0,0,0.00,0
,20160613,2573,2573,,,,2573,2573,0,0,0,0.00,0
,20160614,2573,2573,,,,2573,2573,0,0,0,0.00,0
,20160615,2573,2573,,,,2573,2573,0,0,0,0.00,0
,20160616,2573,2573,,,,2573,2573,0,0,0,0.00,0
,20160617,2573,2573,,,,2573,2573,0,0,0,0.00,0
,20160620,2573,2573,,,,2573,2573,0,0,0,0.00,0
,20160621,2573,2573,,,,2573,2573,0,0,0,0.00,0
,20160622,2573,2573,,,,2573,2573,0,0,0,0.00,0
,20160623,2573,2573,,,,2573,2573,0,0,0,0.00,0
,20160624,2573,2573,,,,2573,2573,0,0,0,0.00,0
,20160627,2573,2573,,,,2444,2444,-129,-129,0,0.00,0
,20160628,2444,2444,,,,2321,2321,-123,-123,0,0.00,0
,20160629,2321,2321,,,,2321,2321,0,0,0,0.00,0
,20160630,2321,2321,,,,2265,2265,-56,-56,0,0.00,0
,20160701,2265,2265,,,,2265,2265,0,0,0,0.00,0
,20160704,2265,2265,,,,2265,2265,0,0,0,0.00,0
,20160705,2265,2265,,,,2265,2265,0,0,0,0.00,0
,20160706,2265,2265,,,,2265,2265,0,0,0,0.00,0
,20160707,2265,2265,,,,2189,2189,-76,-76,0,0.00,0
,20160708,2189,2189,,,,2189,2189,0,0,0,0.00,0
,20160711,2189,2189,,,,2189,2189,0,0,0,0.00,0
,20160712,2189,2189,,,,2189,2189,0,0,0,0.00,0
,20160713,2189,2189,,,,2297,2297,108,108,0,0.00,0
,20160714,2297,2297,,,,2297,2297,0,0,0,0.00,0
,20160715,2297,2297,,,,2297,2297,0,0,0,0.00,0
,20160718,2297,2297,,,,2297,2297,0,0,0,0.00,0
,20160719,2297,2297,,,,2297,2297,0,0,0,0.00,0
,20160720,2297,2297,,,,2187,2187,-110,-110,0,0.00,0
,20160721,2187,2187,,,,2187,2187,0,0,0,0.00,0
,20160722,2187,2187,,,,2187,2187,0,0,0,0.00,0
,20160725,2187,2187,,,,2187,2187,0,0,0,0.00,0
,20160726,2187,2187,,,,2187,2187,0,0,0,0.00,0
,20160727,2187,2187,,,,2187,2187,0,0,0,0.00,0
,20160728,2187,2187,,,,2187,2187,0,0,0,0.00,0
,20160729,2187,2187,,,,2187,2187,0,0,0,0.00,0
,20160801,2187,2187,,,,2187,2187,0,0,0,0.00,0
,20160802,2187,2187,,,,2187,2187,0,0,0,0.00,0
,20160803,2187,2187,,,,2187,2187,0,0,0,0.00,0
,20160804,2187,2187,,,,2187,2187,0,0,0,0.00,0
,20160805,2187,2187,,,,2187,2187,0,0,0,0.00,0
,20160808,2187,2187,,,,2187,2187,0,0,0,0.00,0
,20160809,2187,2187,,,,2187,2187,0,0,0,0.00,0
,20160810,2187,2187,,,,2187,2187,0,0,0,0.00,0
,20160811,2187,2187,,,,2187,2187,0,0,0,0.00,0
,20160812,2187,2187,,,,2187,2187,0,0,0,0.00,0
,20160815,2187,2187,,,,2187,2187,0,0,0,0.00,0
,20160816,2187,2187,,,,2187,2187,0,0,0,0.00,0
,20160817,2187,2187,,,,2187,2187,0,0,0,0.00,0
,20160818,2187,2187,,,,2187,2187,0,0,0,0.00,0
,20160819,2187,2187,,,,2187,2187,0,0,0,0.00,0
,20160822,2187,2187,,,,2187,2187,0,0,0,0.00,0
,20160823,2187,2187,2186,2186,2186,2186,2186,-1,-1,4,8.74,4
,20160824,2186,2186,,,,2295,2295,109,109,0,0.00,4
,20160825,2295,2295,,,,2295,2295,0,0,0,0.00,4
,20160826,2295,2295,,,,2409,2409,114,114,0,0.00,4
,20160829,2409,2409,,,,2409,2409,0,0,0,0.00,4
,20160830,2409,2409,,,,2409,2409,0,0,0,0.00,4
,20160831,2409,2409,,,,2409,2409,0,0,0,0.00,4
,20160901,2409,2409,,,,2409,2409,0,0,0,0.00,4
,20160902,2409,2409,,,,2409,2409,0,0,0,0.00,4
,20160905,2409,2409,,,,2409,2409,0,0,0,0.00,4
,20160906,2409,2409,,,,2409,2409,0,0,0,0.00,4
,20160907,2409,2409,,,,2409,2409,0,0,0,0.00,4
,20160908,2409,2409,,,,2409,2409,0,0,0,0.00,4
,20160909,2409,2409,,,,2409,2409,0,0,0,0.00,4
,20160912,2409,2409,,,,2409,2409,0,0,0,0.00,4
,20160913,2409,2409,2399,2399,2399,2399,2399,-10,-10,2,4.80,4
,20160914,2399,2399,,,,2399,2399,0,0,0,0.00,4
,20160919,2399,2399,,,,2399,2399,0,0,0,0.00,4
,20160920,2399,2399,,,,2399,2399,0,0,0,0.00,4
,20160921,2399,2399,,,,2399,2399,0,0,0,0.00,4
,20160922,2399,2399,,,,2399,2399,0,0,0,0.00,4
,20160923,2399,2399,,,,2399,2399,0,0,0,0.00,4
,20160926,2399,2399,,,,2399,2399,0,0,0,0.00,4
,20160927,2399,2399,,,,2399,2399,0,0,0,0.00,4
,20160928,2399,2399,,,,2399,2399,0,0,0,0.00,4
,20160929,2399,2399,,,,2399,2399,0,0,0,0.00,4
,20160930,2399,2399,,,,2388,2388,-11,-11,0,0.00,4
,20161010,2388,2388,2555,2555,2555,2555,2555,167,167,2,5.11,4
,20161011,2555,2555,2427,2427,2427,2427,2427,-128,-128,4,9.71,2
,20161012,2427,2427,2305,2305,2305,2305,2305,-122,-122,2,4.61,0
,20161013,2305,2305,,,,2305,2305,0,0,0,0.00,0
,20161014,2305,2305,,,,2305,2305,0,0,0,0.00,0
,20161017,2305,2305,,,,2305,2305,0,0,0,0.00,0
,20161018,2305,2305,,,,2305,2305,0,0,0,0.00,0
,20161019,2305,2305,,,,2305,2305,0,0,0,0.00,0
,20161020,2305,2305,,,,2305,2305,0,0,0,0.00,0
,20161021,2305,2305,,,,2305,2305,0,0,0,0.00,0
,20161024,2305,2305,,,,2305,2305,0,0,0,0.00,0
,20161025,2305,2305,,,,2305,2305,0,0,0,0.00,0
,20161026,2305,2305,,,,2305,2305,0,0,0,0.00,0
,20161027,2305,2305,,,,2305,2305,0,0,0,0.00,0
,20161028,2305,2305,,,,2305,2305,0,0,0,0.00,0
,20161031,2305,2305,,,,2305,2305,0,0,0,0.00,0
,20161101,2305,2305,,,,2305,2305,0,0,0,0.00,0
,20161102,2305,2305,,,,2305,2305,0,0,0,0.00,0
,20161103,2305,2305,,,,2305,2305,0,0,0,0.00,0
,20161104,2305,2305,,,,2305,2305,0,0,0,0.00,0
,20161107,2305,2305,,,,2305,2305,0,0,0,0.00,0
,20161108,2305,2305,,,,2305,2305,0,0,0,0.00,0
,20161109,2305,2305,,,,2305,2305,0,0,0,0.00,0
,20161110,2305,2305,,,,2305,2305,0,0,0,0.00,0
,20161111,2305,2305,,,,2305,2305,0,0,0,0.00,0
,20161114,2305,2305,,,,2305,2305,0,0,0,0.00,0
,20161115,2305,2305,,,,2305,2305,0,0,0,0.00,0
,20161116,2305,2305,,,,2305,2305,0,0,0,0.00,0
,20161117,2305,2305,,,,2305,2305,0,0,0,0.00,0
,20161118,2305,2305,,,,2305,2305,0,0,0,0.00,0
,20161121,2305,2305,,,,2305,2305,0,0,0,0.00,0
,20161122,2305,2305,,,,2305,2305,0,0,0,0.00,0
,20161123,2305,2305,,,,2305,2305,0,0,0,0.00,0
,20161124,2305,2305,,,,2305,2305,0,0,0,0.00,0
,20161125,2305,2305,,,,2305,2305,0,0,0,0.00,0
,20161128,2305,2305,,,,2305,2305,0,0,0,0.00,0
,20161129,2305,2305,,,,2305,2305,0,0,0,0.00,0
,20161130,2305,2305,,,,2305,2305,0,0,0,0.00,0
,20161201,2305,2305,,,,2305,2305,0,0,0,0.00,0
,20161202,2305,2305,,,,2305,2305,0,0,0,0.00,0
,20161205,2305,2305,,,,2305,2305,0,0,0,0.00,0
,20161206,2305,2305,,,,2305,2305,0,0,0,0.00,0
,20161207,2305,2305,,,,2305,2305,0,0,0,0.00,0
,20161208,2305,2305,,,,2305,2305,0,0,0,0.00,0
,20161209,2305,2305,,,,2305,2305,0,0,0,0.00,0
,20161212,2305,2305,,,,2305,2305,0,0,0,0.00,0
,20161213,2305,2305,,,,2305,2305,0,0,0,0.00,0
,20161214,2305,2305,,,,2305,2305,0,0,0,0.00,0
,20161215,2305,2305,,,,2305,2305,0,0,0,0.00,0
,20161216,2305,2305,,,,2305,2305,0,0,0,0.00,0
,20161219,2305,2305,,,,2305,2305,0,0,0,0.00,0
,20161220,2305,2305,,,,2305,2305,0,0,0,0.00,0
,20161221,2305,2305,,,,2305,2305,0,0,0,0.00,0
,20161222,2305,2305,,,,2305,2305,0,0,0,0.00,0
,20161223,2305,2305,,,,2305,2305,0,0,0,0.00,0
,20161226,2305,2305,,,,2305,2305,0,0,0,0.00,0
,20161227,2305,2305,,,,2305,2305,0,0,0,0.00,0
,20161228,2305,2305,,,,2305,2305,0,0,0,0.00,0
,20161229,2305,2305,,,,2305,2305,0,0,0,0.00,0
,20161230,2305,2305,,,,2305,2305,0,0,0,0.00,0
wr1703,20160316,2077,2077,,,,2077,2077,0,0,0,0.00,0
,20160317,2077,2077,,,,2198,2198,121,121,0,0.00,0
,20160318,2198,2198,,,,2198,2198,0,0,0,0.00,0
,20160321,2198,2198,,,,2198,2198,0,0,0,0.00,0
,20160322,2198,2198,,,,2198,2198,0,0,0,0.00,0
,20160323,2198,2198,,,,2198,2198,0,0,0,0.00,0
,20160324,2198,2198,,,,2338,2338,140,140,0,0.00,0
,20160325,2338,2338,,,,2338,2338,0,0,0,0.00,0
,20160328,2338,2338,,,,2338,2338,0,0,0,0.00,0
,20160329,2338,2338,,,,2338,2338,0,0,0,0.00,0
,20160330,2338,2338,,,,2338,2338,0,0,0,0.00,0
,20160331,2338,2338,,,,2338,2338,0,0,0,0.00,0
,20160401,2338,2338,,,,2338,2338,0,0,0,0.00,0
,20160405,2338,2338,,,,2338,2338,0,0,0,0.00,0
,20160406,2338,2338,,,,2338,2338,0,0,0,0.00,0
,20160407,2338,2338,,,,2338,2338,0,0,0,0.00,0
,20160408,2338,2338,,,,2338,2338,0,0,0,0.00,0
,20160411,2338,2338,,,,2338,2338,0,0,0,0.00,0
,20160412,2338,2338,,,,2338,2338,0,0,0,0.00,0
,20160413,2338,2338,,,,2338,2338,0,0,0,0.00,0
,20160414,2338,2338,,,,2338,2338,0,0,0,0.00,0
,20160415,2338,2338,,,,2338,2338,0,0,0,0.00,0
,20160418,2338,2338,,,,2338,2338,0,0,0,0.00,0
,20160419,2338,2338,,,,2338,2338,0,0,0,0.00,0
,20160420,2338,2338,,,,2338,2338,0,0,0,0.00,0
,20160421,2338,2338,,,,2338,2338,0,0,0,0.00,0
,20160422,2338,2338,,,,2338,2338,0,0,0,0.00,0
,20160425,2338,2338,,,,2338,2338,0,0,0,0.00,0
,20160426,2338,2338,,,,2338,2338,0,0,0,0.00,0
,20160427,2338,2338,,,,2338,2338,0,0,0,0.00,0
,20160428,2338,2338,,,,2453,2453,115,115,0,0.00,0
,20160429,2453,2453,,,,2453,2453,0,0,0,0.00,0
,20160503,2453,2453,,,,2453,2453,0,0,0,0.00,0
,20160504,2453,2453,,,,2453,2453,0,0,0,0.00,0
,20160505,2453,2453,,,,2453,2453,0,0,0,0.00,0
,20160506,2453,2453,,,,2453,2453,0,0,0,0.00,0
,20160509,2453,2453,,,,2453,2453,0,0,0,0.00,0
,20160510,2453,2453,,,,2453,2453,0,0,0,0.00,0
,20160511,2453,2453,,,,2453,2453,0,0,0,0.00,0
,20160512,2453,2453,,,,2453,2453,0,0,0,0.00,0
,20160513,2453,2453,,,,2573,2573,120,120,0,0.00,0
,20160516,2573,2573,,,,2573,2573,0,0,0,0.00,0
,20160517,2573,2573,,,,2573,2573,0,0,0,0.00,0
,20160518,2573,2573,,,,2573,2573,0,0,0,0.00,0
,20160519,2573,2573,,,,2573,2573,0,0,0,0.00,0
,20160520,2573,2573,,,,2573,2573,0,0,0,0.00,0
,20160523,2573,2573,,,,2573,2573,0,0,0,0.00,0
,20160524,2573,2573,,,,2573,2573,0,0,0,0.00,0
,20160525,2573,2573,,,,2573,2573,0,0,0,0.00,0
,20160526,2573,2573,,,,2573,2573,0,0,0,0.00,0
,20160527,2573,2573,,,,2573,2573,0,0,0,0.00,0
,20160530,2573,2573,,,,2573,2573,0,0,0,0.00,0
,20160531,2573,2573,,,,2573,2573,0,0,0,0.00,0
,20160601,2573,2573,,,,2573,2573,0,0,0,0.00,0
,20160602,2573,2573,,,,2573,2573,0,0,0,0.00,0
,20160603,2573,2573,,,,2573,2573,0,0,0,0.00,0
,20160606,2573,2573,,,,2573,2573,0,0,0,0.00,0
,20160607,2573,2573,,,,2573,2573,0,0,0,0.00,0
,20160608,2573,2573,,,,2573,2573,0,0,0,0.00,0
,20160613,2573,2573,,,,2573,2573,0,0,0,0.00,0
,20160614,2573,2573,,,,2573,2573,0,0,0,0.00,0
,20160615,2573,2573,,,,2573,2573,0,0,0,0.00,0
,20160616,2573,2573,,,,2573,2573,0,0,0,0.00,0
,20160617,2573,2573,,,,2573,2573,0,0,0,0.00,0
,20160620,2573,2573,,,,2573,2573,0,0,0,0.00,0
,20160621,2573,2573,,,,2573,2573,0,0,0,0.00,0
,20160622,2573,2573,,,,2573,2573,0,0,0,0.00,0
,20160623,2573,2573,,,,2573,2573,0,0,0,0.00,0
,20160624,2573,2573,,,,2573,2573,0,0,0,0.00,0
,20160627,2573,2573,,,,2444,2444,-129,-129,0,0.00,0
,20160628,2444,2444,,,,2321,2321,-123,-123,0,0.00,0
,20160629,2321,2321,,,,2321,2321,0,0,0,0.00,0
,20160630,2321,2321,,,,2265,2265,-56,-56,0,0.00,0
,20160701,2265,2265,,,,2265,2265,0,0,0,0.00,0
,20160704,2265,2265,,,,2265,2265,0,0,0,0.00,0
,20160705,2265,2265,,,,2265,2265,0,0,0,0.00,0
,20160706,2265,2265,,,,2265,2265,0,0,0,0.00,0
,20160707,2265,2265,,,,2189,2189,-76,-76,0,0.00,0
,20160708,2189,2189,,,,2189,2189,0,0,0,0.00,0
,20160711,2189,2189,,,,2189,2189,0,0,0,0.00,0
,20160712,2189,2189,,,,2189,2189,0,0,0,0.00,0
,20160713,2189,2189,,,,2297,2297,108,108,0,0.00,0
,20160714,2297,2297,,,,2297,2297,0,0,0,0.00,0
,20160715,2297,2297,,,,2297,2297,0,0,0,0.00,0
,20160718,2297,2297,,,,2297,2297,0,0,0,0.00,0
,20160719,2297,2297,,,,2297,2297,0,0,0,0.00,0
,20160720,2297,2297,,,,2187,2187,-110,-110,0,0.00,0
,20160721,2187,2187,,,,2187,2187,0,0,0,0.00,0
,20160722,2187,2187,,,,2187,2187,0,0,0,0.00,0
,20160725,2187,2187,,,,2187,2187,0,0,0,0.00,0
,20160726,2187,2187,,,,2187,2187,0,0,0,0.00,0
,20160727,2187,2187,,,,2187,2187,0,0,0,0.00,0
,20160728,2187,2187,,,,2187,2187,0,0,0,0.00,0
,20160729,2187,2187,,,,2187,2187,0,0,0,0.00,0
,20160801,2187,2187,,,,2187,2187,0,0,0,0.00,0
,20160802,2187,2187,,,,2187,2187,0,0,0,0.00,0
,20160803,2187,2187,,,,2187,2187,0,0,0,0.00,0
,20160804,2187,2187,,,,2187,2187,0,0,0,0.00,0
,20160805,2187,2187,,,,2187,2187,0,0,0,0.00,0
,20160808,2187,2187,,,,2187,2187,0,0,0,0.00,0
,20160809,2187,2187,,,,2187,2187,0,0,0,0.00,0
,20160810,2187,2187,,,,2187,2187,0,0,0,0.00,0
,20160811,2187,2187,,,,2187,2187,0,0,0,0.00,0
,20160812,2187,2187,,,,2187,2187,0,0,0,0.00,0
,20160815,2187,2187,,,,2187,2187,0,0,0,0.00,0
,20160816,2187,2187,,,,2187,2187,0,0,0,0.00,0
,20160817,2187,2187,,,,2187,2187,0,0,0,0.00,0
,20160818,2187,2187,,,,2187,2187,0,0,0,0.00,0
,20160819,2187,2187,,,,2187,2187,0,0,0,0.00,0
,20160822,2187,2187,,,,2187,2187,0,0,0,0.00,0
,20160823,2187,2187,,,,2186,2186,-1,-1,0,0.00,0
,20160824,2186,2186,,,,2186,2186,0,0,0,0.00,0
,20160825,2186,2186,,,,2186,2186,0,0,0,0.00,0
,20160826,2186,2186,,,,2186,2186,0,0,0,0.00,0
,20160829,2186,2186,,,,2186,2186,0,0,0,0.00,0
,20160830,2186,2186,,,,2186,2186,0,0,0,0.00,0
,20160831,2186,2186,,,,2186,2186,0,0,0,0.00,0
,20160901,2186,2186,,,,2186,2186,0,0,0,0.00,0
,20160902,2186,2186,,,,2186,2186,0,0,0,0.00,0
,20160905,2186,2186,,,,2186,2186,0,0,0,0.00,0
,20160906,2186,2186,2322,2322,2322,2322,2322,136,136,2,4.64,2
,20160907,2322,2322,2438,2438,2438,2438,2438,116,116,2,4.88,0
,20160908,2438,2438,,,,2438,2438,0,0,0,0.00,0
,20160909,2438,2438,,,,2438,2438,0,0,0,0.00,0
,20160912,2438,2438,,,,2438,2438,0,0,0,0.00,0
,20160913,2438,2438,,,,2427,2427,-11,-11,0,0.00,0
,20160914,2427,2427,,,,2427,2427,0,0,0,0.00,0
,20160919,2427,2427,,,,2427,2427,0,0,0,0.00,0
,20160920,2427,2427,,,,2427,2427,0,0,0,0.00,0
,20160921,2427,2427,,,,2427,2427,0,0,0,0.00,0
,20160922,2427,2427,,,,2427,2427,0,0,0,0.00,0
,20160923,2427,2427,,,,2427,2427,0,0,0,0.00,0
,20160926,2427,2427,,,,2427,2427,0,0,0,0.00,0
,20160927,2427,2427,,,,2427,2427,0,0,0,0.00,0
,20160928,2427,2427,,,,2427,2427,0,0,0,0.00,0
,20160929,2427,2427,,,,2427,2427,0,0,0,0.00,0
,20160930,2427,2427,,,,2416,2416,-11,-11,0,0.00,0
,20161010,2416,2416,,,,2584,2584,168,168,0,0.00,0
,20161011,2584,2584,,,,2454,2454,-130,-130,0,0.00,0
,20161012,2454,2454,,,,2331,2331,-123,-123,0,0.00,0
,20161013,2331,2331,,,,2331,2331,0,0,0,0.00,0
,20161014,2331,2331,,,,2331,2331,0,0,0,0.00,0
,20161017,2331,2331,,,,2331,2331,0,0,0,0.00,0
,20161018,2331,2331,,,,2331,2331,0,0,0,0.00,0
,20161019,2331,2331,,,,2331,2331,0,0,0,0.00,0
,20161020,2331,2331,,,,2331,2331,0,0,0,0.00,0
,20161021,2331,2331,,,,2331,2331,0,0,0,0.00,0
,20161024,2331,2331,,,,2331,2331,0,0,0,0.00,0
,20161025,2331,2331,,,,2331,2331,0,0,0,0.00,0
,20161026,2331,2331,,,,2331,2331,0,0,0,0.00,0
,20161027,2331,2331,,,,2331,2331,0,0,0,0.00,0
,20161028,2331,2331,,,,2331,2331,0,0,0,0.00,0
,20161031,2331,2331,,,,2331,2331,0,0,0,0.00,0
,20161101,2331,2331,,,,2331,2331,0,0,0,0.00,0
,20161102,2331,2331,,,,2331,2331,0,0,0,0.00,0
,20161103,2331,2331,,,,2331,2331,0,0,0,0.00,0
,20161104,2331,2331,,,,2331,2331,0,0,0,0.00,0
,20161107,2331,2331,,,,2331,2331,0,0,0,0.00,0
,20161108,2331,2331,,,,2331,2331,0,0,0,0.00,0
,20161109,2331,2331,,,,2331,2331,0,0,0,0.00,0
,20161110,2331,2331,,,,2331,2331,0,0,0,0.00,0
,20161111,2331,2331,,,,2331,2331,0,0,0,0.00,0
,20161114,2331,2331,,,,2331,2331,0,0,0,0.00,0
,20161115,2331,2331,,,,2331,2331,0,0,0,0.00,0
,20161116,2331,2331,,,,2331,2331,0,0,0,0.00,0
,20161117,2331,2331,,,,2331,2331,0,0,0,0.00,0
,20161118,2331,2331,,,,2331,2331,0,0,0,0.00,0
,20161121,2331,2331,,,,2331,2331,0,0,0,0.00,0
,20161122,2331,2331,,,,2331,2331,0,0,0,0.00,0
,20161123,2331,2331,,,,2331,2331,0,0,0,0.00,0
,20161124,2331,2331,,,,2331,2331,0,0,0,0.00,0
,20161125,2331,2331,,,,2331,2331,0,0,0,0.00,0
,20161128,2331,2331,,,,2331,2331,0,0,0,0.00,0
,20161129,2331,2331,,,,2331,2331,0,0,0,0.00,0
,20161130,2331,2331,,,,2331,2331,0,0,0,0.00,0
,20161201,2331,2331,,,,2331,2331,0,0,0,0.00,0
,20161202,2331,2331,,,,2331,2331,0,0,0,0.00,0
,20161205,2331,2331,,,,2331,2331,0,0,0,0.00,0
,20161206,2331,2331,,,,2331,2331,0,0,0,0.00,0
,20161207,2331,2331,,,,2331,2331,0,0,0,0.00,0
,20161208,2331,2331,,,,2331,2331,0,0,0,0.00,0
,20161209,2331,2331,,,,2331,2331,0,0,0,0.00,0
,20161212,2331,2331,,,,2331,2331,0,0,0,0.00,0
,20161213,2331,2331,,,,2331,2331,0,0,0,0.00,0
,20161214,2331,2331,,,,2331,2331,0,0,0,0.00,0
,20161215,2331,2331,,,,2331,2331,0,0,0,0.00,0
,20161216,2331,2331,,,,2331,2331,0,0,0,0.00,0
,20161219,2331,2331,,,,2331,2331,0,0,0,0.00,0
,20161220,2331,2331,,,,2331,2331,0,0,0,0.00,0
,20161221,2331,2331,,,,2331,2331,0,0,0,0.00,0
,20161222,2331,2331,,,,2331,2331,0,0,0,0.00,0
,20161223,2331,2331,,,,2331,2331,0,0,0,0.00,0
,20161226,2331,2331,,,,2331,2331,0,0,0,0.00,0
,20161227,2331,2331,,,,2331,2331,0,0,0,0.00,0
,20161228,2331,2331,,,,2331,2331,0,0,0,0.00,0
,20161229,2331,2331,,,,2331,2331,0,0,0,0.00,0
,20161230,2331,2331,,,,2331,2331,0,0,0,0.00,0
wr1704,20160418,2338,2338,,,,2338,2338,0,0,0,0.00,0
,20160419,2338,2338,,,,2338,2338,0,0,0,0.00,0
,20160420,2338,2338,,,,2338,2338,0,0,0,0.00,0
,20160421,2338,2338,,,,2338,2338,0,0,0,0.00,0
,20160422,2338,2338,,,,2338,2338,0,0,0,0.00,0
,20160425,2338,2338,,,,2338,2338,0,0,0,0.00,0
,20160426,2338,2338,,,,2338,2338,0,0,0,0.00,0
,20160427,2338,2338,,,,2338,2338,0,0,0,0.00,0
,20160428,2338,2338,,,,2453,2453,115,115,0,0.00,0
,20160429,2453,2453,,,,2453,2453,0,0,0,0.00,0
,20160503,2453,2453,,,,2453,2453,0,0,0,0.00,0
,20160504,2453,2453,,,,2453,2453,0,0,0,0.00,0
,20160505,2453,2453,,,,2453,2453,0,0,0,0.00,0
,20160506,2453,2453,,,,2453,2453,0,0,0,0.00,0
,20160509,2453,2453,,,,2453,2453,0,0,0,0.00,0
,20160510,2453,2453,,,,2453,2453,0,0,0,0.00,0
,20160511,2453,2453,,,,2453,2453,0,0,0,0.00,0
,20160512,2453,2453,,,,2453,2453,0,0,0,0.00,0
,20160513,2453,2453,,,,2573,2573,120,120,0,0.00,0
,20160516,2573,2573,,,,2573,2573,0,0,0,0.00,0
,20160517,2573,2573,,,,2573,2573,0,0,0,0.00,0
,20160518,2573,2573,,,,2573,2573,0,0,0,0.00,0
,20160519,2573,2573,,,,2573,2573,0,0,0,0.00,0
,20160520,2573,2573,,,,2573,2573,0,0,0,0.00,0
,20160523,2573,2573,,,,2573,2573,0,0,0,0.00,0
,20160524,2573,2573,,,,2573,2573,0,0,0,0.00,0
,20160525,2573,2573,,,,2573,2573,0,0,0,0.00,0
,20160526,2573,2573,,,,2573,2573,0,0,0,0.00,0
,20160527,2573,2573,,,,2573,2573,0,0,0,0.00,0
,20160530,2573,2573,,,,2573,2573,0,0,0,0.00,0
,20160531,2573,2573,,,,2573,2573,0,0,0,0.00,0
,20160601,2573,2573,,,,2573,2573,0,0,0,0.00,0
,20160602,2573,2573,,,,2573,2573,0,0,0,0.00,0
,20160603,2573,2573,,,,2573,2573,0,0,0,0.00,0
,20160606,2573,2573,,,,2573,2573,0,0,0,0.00,0
,20160607,2573,2573,,,,2573,2573,0,0,0,0.00,0
,20160608,2573,2573,,,,2573,2573,0,0,0,0.00,0
,20160613,2573,2573,,,,2573,2573,0,0,0,0.00,0
,20160614,2573,2573,,,,2573,2573,0,0,0,0.00,0
,20160615,2573,2573,,,,2573,2573,0,0,0,0.00,0
,20160616,2573,2573,,,,2573,2573,0,0,0,0.00,0
,20160617,2573,2573,,,,2573,2573,0,0,0,0.00,0
,20160620,2573,2573,,,,2573,2573,0,0,0,0.00,0
,20160621,2573,2573,,,,2573,2573,0,0,0,0.00,0
,20160622,2573,2573,,,,2573,2573,0,0,0,0.00,0
,20160623,2573,2573,,,,2573,2573,0,0,0,0.00,0
,20160624,2573,2573,,,,2573,2573,0,0,0,0.00,0
,20160627,2573,2573,,,,2444,2444,-129,-129,0,0.00,0
,20160628,2444,2444,,,,2321,2321,-123,-123,0,0.00,0
,20160629,2321,2321,,,,2321,2321,0,0,0,0.00,0
,20160630,2321,2321,,,,2265,2265,-56,-56,0,0.00,0
,20160701,2265,2265,,,,2265,2265,0,0,0,0.00,0
,20160704,2265,2265,,,,2265,2265,0,0,0,0.00,0
,20160705,2265,2265,,,,2265,2265,0,0,0,0.00,0
,20160706,2265,2265,,,,2265,2265,0,0,0,0.00,0
,20160707,2265,2265,,,,2189,2189,-76,-76,0,0.00,0
,20160708,2189,2189,,,,2189,2189,0,0,0,0.00,0
,20160711,2189,2189,,,,2189,2189,0,0,0,0.00,0
,20160712,2189,2189,,,,2189,2189,0,0,0,0.00,0
,20160713,2189,2189,,,,2297,2297,108,108,0,0.00,0
,20160714,2297,2297,,,,2297,2297,0,0,0,0.00,0
,20160715,2297,2297,,,,2297,2297,0,0,0,0.00,0
,20160718,2297,2297,,,,2297,2297,0,0,0,0.00,0
,20160719,2297,2297,,,,2297,2297,0,0,0,0.00,0
,20160720,2297,2297,,,,2187,2187,-110,-110,0,0.00,0
,20160721,2187,2187,,,,2187,2187,0,0,0,0.00,0
,20160722,2187,2187,,,,2187,2187,0,0,0,0.00,0
,20160725,2187,2187,,,,2187,2187,0,0,0,0.00,0
,20160726,2187,2187,,,,2187,2187,0,0,0,0.00,0
,20160727,2187,2187,,,,2187,2187,0,0,0,0.00,0
,20160728,2187,2187,,,,2187,2187,0,0,0,0.00,0
,20160729,2187,2187,,,,2187,2187,0,0,0,0.00,0
,20160801,2187,2187,,,,2187,2187,0,0,0,0.00,0
,20160802,2187,2187,,,,2187,2187,0,0,0,0.00,0
,20160803,2187,2187,,,,2187,2187,0,0,0,0.00,0
,20160804,2187,2187,,,,2187,2187,0,0,0,0.00,0
,20160805,2187,2187,,,,2187,2187,0,0,0,0.00,0
,20160808,2187,2187,,,,2187,2187,0,0,0,0.00,0
,20160809,2187,2187,,,,2187,2187,0,0,0,0.00,0
,20160810,2187,2187,,,,2187,2187,0,0,0,0.00,0
,20160811,2187,2187,,,,2187,2187,0,0,0,0.00,0
,20160812,2187,2187,,,,2187,2187,0,0,0,0.00,0
,20160815,2187,2187,,,,2187,2187,0,0,0,0.00,0
,20160816,2187,2187,,,,2187,2187,0,0,0,0.00,0
,20160817,2187,2187,,,,2187,2187,0,0,0,0.00,0
,20160818,2187,2187,,,,2187,2187,0,0,0,0.00,0
,20160819,2187,2187,,,,2187,2187,0,0,0,0.00,0
,20160822,2187,2187,,,,2187,2187,0,0,0,0.00,0
,20160823,2187,2187,,,,2186,2186,-1,-1,0,0.00,0
,20160824,2186,2186,,,,2186,2186,0,0,0,0.00,0
,20160825,2186,2186,,,,2186,2186,0,0,0,0.00,0
,20160826,2186,2186,,,,2186,2186,0,0,0,0.00,0
,20160829,2186,2186,,,,2186,2186,0,0,0,0.00,0
,20160830,2186,2186,,,,2186,2186,0,0,0,0.00,0
,20160831,2186,2186,,,,2186,2186,0,0,0,0.00,0
,20160901,2186,2186,,,,2186,2186,0,0,0,0.00,0
,20160902,2186,2186,,,,2186,2186,0,0,0,0.00,0
,20160905,2186,2186,,,,2186,2186,0,0,0,0.00,0
,20160906,2186,2186,,,,2322,2322,136,136,0,0.00,0
,20160907,2322,2322,,,,2438,2438,116,116,0,0.00,0
,20160908,2438,2438,,,,2438,2438,0,0,0,0.00,0
,20160909,2438,2438,,,,2438,2438,0,0,0,0.00,0
,20160912,2438,2438,,,,2438,2438,0,0,0,0.00,0
,20160913,2438,2438,,,,2427,2427,-11,-11,0,0.00,0
,20160914,2427,2427,,,,2427,2427,0,0,0,0.00,0
,20160919,2427,2427,,,,2427,2427,0,0,0,0.00,0
,20160920,2427,2427,,,,2427,2427,0,0,0,0.00,0
,20160921,2427,2427,,,,2427,2427,0,0,0,0.00,0
,20160922,2427,2427,,,,2427,2427,0,0,0,0.00,0
,20160923,2427,2427,,,,2427,2427,0,0,0,0.00,0
,20160926,2427,2427,,,,2427,2427,0,0,0,0.00,0
,20160927,2427,2427,,,,2427,2427,0,0,0,0.00,0
,20160928,2427,2427,,,,2427,2427,0,0,0,0.00,0
,20160929,2427,2427,,,,2427,2427,0,0,0,0.00,0
,20160930,2427,2427,,,,2416,2416,-11,-11,0,0.00,0
,20161010,2416,2416,,,,2584,2584,168,168,0,0.00,0
,20161011,2584,2584,,,,2454,2454,-130,-130,0,0.00,0
,20161012,2454,2454,,,,2330,2330,-124,-124,0,0.00,0
,20161013,2330,2330,,,,2330,2330,0,0,0,0.00,0
,20161014,2330,2330,,,,2330,2330,0,0,0,0.00,0
,20161017,2330,2330,,,,2330,2330,0,0,0,0.00,0
,20161018,2330,2330,,,,2330,2330,0,0,0,0.00,0
,20161019,2330,2330,,,,2330,2330,0,0,0,0.00,0
,20161020,2330,2330,,,,2330,2330,0,0,0,0.00,0
,20161021,2330,2330,,,,2330,2330,0,0,0,0.00,0
,20161024,2330,2330,,,,2330,2330,0,0,0,0.00,0
,20161025,2330,2330,,,,2330,2330,0,0,0,0.00,0
,20161026,2330,2330,,,,2330,2330,0,0,0,0.00,0
,20161027,2330,2330,,,,2330,2330,0,0,0,0.00,0
,20161028,2330,2330,,,,2330,2330,0,0,0,0.00,0
,20161031,2330,2330,,,,2330,2330,0,0,0,0.00,0
,20161101,2330,2330,,,,2330,2330,0,0,0,0.00,0
,20161102,2330,2330,,,,2330,2330,0,0,0,0.00,0
,20161103,2330,2330,,,,2330,2330,0,0,0,0.00,0
,20161104,2330,2330,,,,2330,2330,0,0,0,0.00,0
,20161107,2330,2330,,,,2330,2330,0,0,0,0.00,0
,20161108,2330,2330,,,,2330,2330,0,0,0,0.00,0
,20161109,2330,2330,,,,2330,2330,0,0,0,0.00,0
,20161110,2330,2330,,,,2330,2330,0,0,0,0.00,0
,20161111,2330,2330,,,,2330,2330,0,0,0,0.00,0
,20161114,2330,2330,,,,2330,2330,0,0,0,0.00,0
,20161115,2330,2330,,,,2330,2330,0,0,0,0.00,0
,20161116,2330,2330,,,,2330,2330,0,0,0,0.00,0
,20161117,2330,2330,,,,2330,2330,0,0,0,0.00,0
,20161118,2330,2330,,,,2330,2330,0,0,0,0.00,0
,20161121,2330,2330,,,,2330,2330,0,0,0,0.00,0
,20161122,2330,2330,,,,2330,2330,0,0,0,0.00,0
,20161123,2330,2330,,,,2330,2330,0,0,0,0.00,0
,20161124,2330,2330,,,,2330,2330,0,0,0,0.00,0
,20161125,2330,2330,,,,2330,2330,0,0,0,0.00,0
,20161128,2330,2330,,,,2330,2330,0,0,0,0.00,0
,20161129,2330,2330,,,,2330,2330,0,0,0,0.00,0
,20161130,2330,2330,,,,2330,2330,0,0,0,0.00,0
,20161201,2330,2330,,,,2330,2330,0,0,0,0.00,0
,20161202,2330,2330,,,,2330,2330,0,0,0,0.00,0
,20161205,2330,2330,,,,2330,2330,0,0,0,0.00,0
,20161206,2330,2330,,,,2330,2330,0,0,0,0.00,0
,20161207,2330,2330,,,,2330,2330,0,0,0,0.00,0
,20161208,2330,2330,,,,2330,2330,0,0,0,0.00,0
,20161209,2330,2330,,,,2330,2330,0,0,0,0.00,0
,20161212,2330,2330,,,,2330,2330,0,0,0,0.00,0
,20161213,2330,2330,,,,2330,2330,0,0,0,0.00,0
,20161214,2330,2330,,,,2330,2330,0,0,0,0.00,0
,20161215,2330,2330,,,,2330,2330,0,0,0,0.00,0
,20161216,2330,2330,,,,2330,2330,0,0,0,0.00,0
,20161219,2330,2330,,,,2330,2330,0,0,0,0.00,0
,20161220,2330,2330,,,,2330,2330,0,0,0,0.00,0
,20161221,2330,2330,,,,2330,2330,0,0,0,0.00,0
,20161222,2330,2330,,,,2330,2330,0,0,0,0.00,0
,20161223,2330,2330,,,,2330,2330,0,0,0,0.00,0
,20161226,2330,2330,,,,2330,2330,0,0,0,0.00,0
,20161227,2330,2330,,,,2330,2330,0,0,0,0.00,0
,20161228,2330,2330,,,,2330,2330,0,0,0,0.00,0
,20161229,2330,2330,,,,2330,2330,0,0,0,0.00,0
,20161230,2330,2330,,,,2330,2330,0,0,0,0.00,0
wr1705,20160517,2573,2573,,,,2573,2573,0,0,0,0.00,0
,20160518,2573,2573,,,,2573,2573,0,0,0,0.00,0
,20160519,2573,2573,,,,2573,2573,0,0,0,0.00,0
,20160520,2573,2573,,,,2573,2573,0,0,0,0.00,0
,20160523,2573,2573,,,,2573,2573,0,0,0,0.00,0
,20160524,2573,2573,,,,2573,2573,0,0,0,0.00,0
,20160525,2573,2573,,,,2573,2573,0,0,0,0.00,0
,20160526,2573,2573,,,,2573,2573,0,0,0,0.00,0
,20160527,2573,2573,,,,2573,2573,0,0,0,0.00,0
,20160530,2573,2573,,,,2573,2573,0,0,0,0.00,0
,20160531,2573,2573,,,,2573,2573,0,0,0,0.00,0
,20160601,2573,2573,,,,2573,2573,0,0,0,0.00,0
,20160602,2573,2573,,,,2573,2573,0,0,0,0.00,0
,20160603,2573,2573,,,,2573,2573,0,0,0,0.00,0
,20160606,2573,2573,,,,2573,2573,0,0,0,0.00,0
,20160607,2573,2573,,,,2573,2573,0,0,0,0.00,0
,20160608,2573,2573,,,,2573,2573,0,0,0,0.00,0
,20160613,2573,2573,,,,2573,2573,0,0,0,0.00,0
,20160614,2573,2573,,,,2573,2573,0,0,0,0.00,0
,20160615,2573,2573,,,,2573,2573,0,0,0,0.00,0
,20160616,2573,2573,,,,2573,2573,0,0,0,0.00,0
,20160617,2573,2573,,,,2573,2573,0,0,0,0.00,0
,20160620,2573,2573,,,,2573,2573,0,0,0,0.00,0
,20160621,2573,2573,,,,2573,2573,0,0,0,0.00,0
,20160622,2573,2573,,,,2573,2573,0,0,0,0.00,0
,20160623,2573,2573,,,,2573,2573,0,0,0,0.00,0
,20160624,2573,2573,,,,2573,2573,0,0,0,0.00,0
,20160627,2573,2573,,,,2444,2444,-129,-129,0,0.00,0
,20160628,2444,2444,,,,2321,2321,-123,-123,0,0.00,0
,20160629,2321,2321,,,,2321,2321,0,0,0,0.00,0
,20160630,2321,2321,,,,2265,2265,-56,-56,0,0.00,0
,20160701,2265,2265,,,,2265,2265,0,0,0,0.00,0
,20160704,2265,2265,,,,2265,2265,0,0,0,0.00,0
,20160705,2265,2265,,,,2265,2265,0,0,0,0.00,0
,20160706,2265,2265,,,,2265,2265,0,0,0,0.00,0
,20160707,2265,2265,,,,2189,2189,-76,-76,0,0.00,0
,20160708,2189,2189,,,,2189,2189,0,0,0,0.00,0
,20160711,2189,2189,,,,2189,2189,0,0,0,0.00,0
,20160712,2189,2189,,,,2189,2189,0,0,0,0.00,0
,20160713,2189,2189,,,,2297,2297,108,108,0,0.00,0
,20160714,2297,2297,,,,2297,2297,0,0,0,0.00,0
,20160715,2297,2297,,,,2297,2297,0,0,0,0.00,0
,20160718,2297,2297,,,,2297,2297,0,0,0,0.00,0
,20160719,2297,2297,,,,2297,2297,0,0,0,0.00,0
,20160720,2297,2297,,,,2187,2187,-110,-110,0,0.00,0
,20160721,2187,2187,,,,2187,2187,0,0,0,0.00,0
,20160722,2187,2187,,,,2187,2187,0,0,0,0.00,0
,20160725,2187,2187,,,,2187,2187,0,0,0,0.00,0
,20160726,2187,2187,,,,2187,2187,0,0,0,0.00,0
,20160727,2187,2187,,,,2187,2187,0,0,0,0.00,0
,20160728,2187,2187,,,,2187,2187,0,0,0,0.00,0
,20160729,2187,2187,,,,2187,2187,0,0,0,0.00,0
,20160801,2187,2187,,,,2187,2187,0,0,0,0.00,0
,20160802,2187,2187,,,,2187,2187,0,0,0,0.00,0
,20160803,2187,2187,,,,2187,2187,0,0,0,0.00,0
,20160804,2187,2187,,,,2187,2187,0,0,0,0.00,0
,20160805,2187,2187,,,,2187,2187,0,0,0,0.00,0
,20160808,2187,2187,,,,2187,2187,0,0,0,0.00,0
,20160809,2187,2187,,,,2187,2187,0,0,0,0.00,0
,20160810,2187,2187,,,,2187,2187,0,0,0,0.00,0
,20160811,2187,2187,,,,2187,2187,0,0,0,0.00,0
,20160812,2187,2187,,,,2187,2187,0,0,0,0.00,0
,20160815,2187,2187,,,,2187,2187,0,0,0,0.00,0
,20160816,2187,2187,,,,2187,2187,0,0,0,0.00,0
,20160817,2187,2187,,,,2187,2187,0,0,0,0.00,0
,20160818,2187,2187,,,,2187,2187,0,0,0,0.00,0
,20160819,2187,2187,,,,2187,2187,0,0,0,0.00,0
,20160822,2187,2187,,,,2187,2187,0,0,0,0.00,0
,20160823,2187,2187,,,,2186,2186,-1,-1,0,0.00,0
,20160824,2186,2186,,,,2186,2186,0,0,0,0.00,0
,20160825,2186,2186,,,,2186,2186,0,0,0,0.00,0
,20160826,2186,2186,,,,2186,2186,0,0,0,0.00,0
,20160829,2186,2186,,,,2186,2186,0,0,0,0.00,0
,20160830,2186,2186,,,,2186,2186,0,0,0,0.00,0
,20160831,2186,2186,,,,2186,2186,0,0,0,0.00,0
,20160901,2186,2186,,,,2186,2186,0,0,0,0.00,0
,20160902,2186,2186,,,,2186,2186,0,0,0,0.00,0
,20160905,2186,2186,,,,2186,2186,0,0,0,0.00,0
,20160906,2186,2186,,,,2322,2322,136,136,0,0.00,0
,20160907,2322,2322,,,,2438,2438,116,116,0,0.00,0
,20160908,2438,2438,,,,2438,2438,0,0,0,0.00,0
,20160909,2438,2438,,,,2438,2438,0,0,0,0.00,0
,20160912,2438,2438,,,,2438,2438,0,0,0,0.00,0
,20160913,2438,2438,,,,2427,2427,-11,-11,0,0.00,0
,20160914,2427,2427,,,,2427,2427,0,0,0,0.00,0
,20160919,2427,2427,,,,2427,2427,0,0,0,0.00,0
,20160920,2427,2427,,,,2427,2427,0,0,0,0.00,0
,20160921,2427,2427,,,,2427,2427,0,0,0,0.00,0
,20160922,2427,2427,,,,2427,2427,0,0,0,0.00,0
,20160923,2427,2427,,,,2427,2427,0,0,0,0.00,0
,20160926,2427,2427,,,,2427,2427,0,0,0,0.00,0
,20160927,2427,2427,,,,2427,2427,0,0,0,0.00,0
,20160928,2427,2427,,,,2427,2427,0,0,0,0.00,0
,20160929,2427,2427,,,,2427,2427,0,0,0,0.00,0
,20160930,2427,2427,,,,2416,2416,-11,-11,0,0.00,0
,20161010,2416,2416,,,,2584,2584,168,168,0,0.00,0
,20161011,2584,2584,,,,2454,2454,-130,-130,0,0.00,0
,20161012,2454,2454,,,,2330,2330,-124,-124,0,0.00,0
,20161013,2330,2330,,,,2330,2330,0,0,0,0.00,0
,20161014,2330,2330,,,,2330,2330,0,0,0,0.00,0
,20161017,2330,2330,,,,2330,2330,0,0,0,0.00,0
,20161018,2330,2330,,,,2330,2330,0,0,0,0.00,0
,20161019,2330,2330,,,,2330,2330,0,0,0,0.00,0
,20161020,2330,2330,,,,2330,2330,0,0,0,0.00,0
,20161021,2330,2330,,,,2330,2330,0,0,0,0.00,0
,20161024,2330,2330,,,,2330,2330,0,0,0,0.00,0
,20161025,2330,2330,,,,2330,2330,0,0,0,0.00,0
,20161026,2330,2330,,,,2330,2330,0,0,0,0.00,0
,20161027,2330,2330,,,,2330,2330,0,0,0,0.00,0
,20161028,2330,2330,,,,2330,2330,0,0,0,0.00,0
,20161031,2330,2330,,,,2330,2330,0,0,0,0.00,0
,20161101,2330,2330,,,,2330,2330,0,0,0,0.00,0
,20161102,2330,2330,,,,2330,2330,0,0,0,0.00,0
,20161103,2330,2330,,,,2330,2330,0,0,0,0.00,0
,20161104,2330,2330,,,,2330,2330,0,0,0,0.00,0
,20161107,2330,2330,,,,2330,2330,0,0,0,0.00,0
,20161108,2330,2330,,,,2330,2330,0,0,0,0.00,0
,20161109,2330,2330,,,,2330,2330,0,0,0,0.00,0
,20161110,2330,2330,,,,2330,2330,0,0,0,0.00,0
,20161111,2330,2330,,,,2330,2330,0,0,0,0.00,0
,20161114,2330,2330,,,,2330,2330,0,0,0,0.00,0
,20161115,2330,2330,,,,2330,2330,0,0,0,0.00,0
,20161116,2330,2330,,,,2330,2330,0,0,0,0.00,0
,20161117,2330,2330,,,,2330,2330,0,0,0,0.00,0
,20161118,2330,2330,,,,2330,2330,0,0,0,0.00,0
,20161121,2330,2330,,,,2330,2330,0,0,0,0.00,0
,20161122,2330,2330,,,,2330,2330,0,0,0,0.00,0
,20161123,2330,2330,,,,2330,2330,0,0,0,0.00,0
,20161124,2330,2330,,,,2330,2330,0,0,0,0.00,0
,20161125,2330,2330,,,,2330,2330,0,0,0,0.00,0
,20161128,2330,2330,,,,2330,2330,0,0,0,0.00,0
,20161129,2330,2330,,,,2330,2330,0,0,0,0.00,0
,20161130,2330,2330,,,,2330,2330,0,0,0,0.00,0
,20161201,2330,2330,,,,2330,2330,0,0,0,0.00,0
,20161202,2330,2330,,,,2330,2330,0,0,0,0.00,0
,20161205,2330,2330,,,,2330,2330,0,0,0,0.00,0
,20161206,2330,2330,,,,2330,2330,0,0,0,0.00,0
,20161207,2330,2330,,,,2330,2330,0,0,0,0.00,0
,20161208,2330,2330,,,,2330,2330,0,0,0,0.00,0
,20161209,2330,2330,,,,2330,2330,0,0,0,0.00,0
,20161212,2330,2330,,,,2330,2330,0,0,0,0.00,0
,20161213,2330,2330,,,,2330,2330,0,0,0,0.00,0
,20161214,2330,2330,,,,2330,2330,0,0,0,0.00,0
,20161215,2330,2330,,,,2330,2330,0,0,0,0.00,0
,20161216,2330,2330,,,,2330,2330,0,0,0,0.00,0
,20161219,2330,2330,,,,2330,2330,0,0,0,0.00,0
,20161220,2330,2330,,,,2330,2330,0,0,0,0.00,0
,20161221,2330,2330,,,,2330,2330,0,0,0,0.00,0
,20161222,2330,2330,,,,2330,2330,0,0,0,0.00,0
,20161223,2330,2330,,,,2330,2330,0,0,0,0.00,0
,20161226,2330,2330,,,,2330,2330,0,0,0,0.00,0
,20161227,2330,2330,,,,2330,2330,0,0,0,0.00,0
,20161228,2330,2330,,,,2330,2330,0,0,0,0.00,0
,20161229,2330,2330,,,,2330,2330,0,0,0,0.00,0
,20161230,2330,2330,,,,2330,2330,0,0,0,0.00,0
wr1706,20160616,2573,2573,,,,2573,2573,0,0,0,0.00,0
,20160617,2573,2573,,,,2573,2573,0,0,0,0.00,0
,20160620,2573,2573,,,,2573,2573,0,0,0,0.00,0
,20160621,2573,2573,,,,2573,2573,0,0,0,0.00,0
,20160622,2573,2573,,,,2573,2573,0,0,0,0.00,0
,20160623,2573,2573,,,,2573,2573,0,0,0,0.00,0
,20160624,2573,2573,,,,2573,2573,0,0,0,0.00,0
,20160627,2573,2573,,,,2444,2444,-129,-129,0,0.00,0
,20160628,2444,2444,,,,2321,2321,-123,-123,0,0.00,0
,20160629,2321,2321,,,,2321,2321,0,0,0,0.00,0
,20160630,2321,2321,,,,2265,2265,-56,-56,0,0.00,0
,20160701,2265,2265,,,,2265,2265,0,0,0,0.00,0
,20160704,2265,2265,,,,2265,2265,0,0,0,0.00,0
,20160705,2265,2265,,,,2265,2265,0,0,0,0.00,0
,20160706,2265,2265,,,,2265,2265,0,0,0,0.00,0
,20160707,2265,2265,,,,2189,2189,-76,-76,0,0.00,0
,20160708,2189,2189,,,,2189,2189,0,0,0,0.00,0
,20160711,2189,2189,,,,2189,2189,0,0,0,0.00,0
,20160712,2189,2189,,,,2189,2189,0,0,0,0.00,0
,20160713,2189,2189,,,,2297,2297,108,108,0,0.00,0
,20160714,2297,2297,,,,2297,2297,0,0,0,0.00,0
,20160715,2297,2297,,,,2297,2297,0,0,0,0.00,0
,20160718,2297,2297,,,,2297,2297,0,0,0,0.00,0
,20160719,2297,2297,,,,2297,2297,0,0,0,0.00,0
,20160720,2297,2297,,,,2187,2187,-110,-110,0,0.00,0
,20160721,2187,2187,,,,2187,2187,0,0,0,0.00,0
,20160722,2187,2187,,,,2187,2187,0,0,0,0.00,0
,20160725,2187,2187,,,,2187,2187,0,0,0,0.00,0
,20160726,2187,2187,,,,2187,2187,0,0,0,0.00,0
,20160727,2187,2187,,,,2187,2187,0,0,0,0.00,0
,20160728,2187,2187,,,,2187,2187,0,0,0,0.00,0
,20160729,2187,2187,,,,2187,2187,0,0,0,0.00,0
,20160801,2187,2187,,,,2187,2187,0,0,0,0.00,0
,20160802,2187,2187,,,,2187,2187,0,0,0,0.00,0
,20160803,2187,2187,,,,2187,2187,0,0,0,0.00,0
,20160804,2187,2187,,,,2187,2187,0,0,0,0.00,0
,20160805,2187,2187,,,,2187,2187,0,0,0,0.00,0
,20160808,2187,2187,,,,2187,2187,0,0,0,0.00,0
,20160809,2187,2187,,,,2187,2187,0,0,0,0.00,0
,20160810,2187,2187,,,,2187,2187,0,0,0,0.00,0
,20160811,2187,2187,,,,2187,2187,0,0,0,0.00,0
,20160812,2187,2187,,,,2187,2187,0,0,0,0.00,0
,20160815,2187,2187,,,,2187,2187,0,0,0,0.00,0
,20160816,2187,2187,,,,2187,2187,0,0,0,0.00,0
,20160817,2187,2187,,,,2187,2187,0,0,0,0.00,0
,20160818,2187,2187,,,,2187,2187,0,0,0,0.00,0
,20160819,2187,2187,,,,2187,2187,0,0,0,0.00,0
,20160822,2187,2187,,,,2187,2187,0,0,0,0.00,0
,20160823,2187,2187,,,,2186,2186,-1,-1,0,0.00,0
,20160824,2186,2186,,,,2186,2186,0,0,0,0.00,0
,20160825,2186,2186,,,,2186,2186,0,0,0,0.00,0
,20160826,2186,2186,,,,2186,2186,0,0,0,0.00,0
,20160829,2186,2186,,,,2186,2186,0,0,0,0.00,0
,20160830,2186,2186,,,,2186,2186,0,0,0,0.00,0
,20160831,2186,2186,,,,2186,2186,0,0,0,0.00,0
,20160901,2186,2186,,,,2186,2186,0,0,0,0.00,0
,20160902,2186,2186,,,,2186,2186,0,0,0,0.00,0
,20160905,2186,2186,,,,2186,2186,0,0,0,0.00,0
,20160906,2186,2186,,,,2322,2322,136,136,0,0.00,0
,20160907,2322,2322,,,,2438,2438,116,116,0,0.00,0
,20160908,2438,2438,,,,2438,2438,0,0,0,0.00,0
,20160909,2438,2438,,,,2438,2438,0,0,0,0.00,0
,20160912,2438,2438,,,,2438,2438,0,0,0,0.00,0
,20160913,2438,2438,,,,2427,2427,-11,-11,0,0.00,0
,20160914,2427,2427,,,,2427,2427,0,0,0,0.00,0
,20160919,2427,2427,,,,2427,2427,0,0,0,0.00,0
,20160920,2427,2427,,,,2427,2427,0,0,0,0.00,0
,20160921,2427,2427,,,,2427,2427,0,0,0,0.00,0
,20160922,2427,2427,,,,2427,2427,0,0,0,0.00,0
,20160923,2427,2427,,,,2427,2427,0,0,0,0.00,0
,20160926,2427,2427,,,,2427,2427,0,0,0,0.00,0
,20160927,2427,2427,,,,2427,2427,0,0,0,0.00,0
,20160928,2427,2427,,,,2427,2427,0,0,0,0.00,0
,20160929,2427,2427,,,,2427,2427,0,0,0,0.00,0
,20160930,2427,2427,,,,2416,2416,-11,-11,0,0.00,0
,20161010,2416,2416,,,,2584,2584,168,168,0,0.00,0
,20161011,2584,2584,,,,2454,2454,-130,-130,0,0.00,0
,20161012,2454,2454,,,,2330,2330,-124,-124,0,0.00,0
,20161013,2330,2330,,,,2330,2330,0,0,0,0.00,0
,20161014,2330,2330,,,,2330,2330,0,0,0,0.00,0
,20161017,2330,2330,,,,2330,2330,0,0,0,0.00,0
,20161018,2330,2330,,,,2330,2330,0,0,0,0.00,0
,20161019,2330,2330,,,,2330,2330,0,0,0,0.00,0
,20161020,2330,2330,,,,2330,2330,0,0,0,0.00,0
,20161021,2330,2330,,,,2330,2330,0,0,0,0.00,0
,20161024,2330,2330,,,,2330,2330,0,0,0,0.00,0
,20161025,2330,2330,,,,2330,2330,0,0,0,0.00,0
,20161026,2330,2330,,,,2330,2330,0,0,0,0.00,0
,20161027,2330,2330,,,,2330,2330,0,0,0,0.00,0
,20161028,2330,2330,,,,2330,2330,0,0,0,0.00,0
,20161031,2330,2330,,,,2330,2330,0,0,0,0.00,0
,20161101,2330,2330,,,,2330,2330,0,0,0,0.00,0
,20161102,2330,2330,,,,2330,2330,0,0,0,0.00,0
,20161103,2330,2330,,,,2330,2330,0,0,0,0.00,0
,20161104,2330,2330,,,,2330,2330,0,0,0,0.00,0
,20161107,2330,2330,,,,2330,2330,0,0,0,0.00,0
,20161108,2330,2330,,,,2330,2330,0,0,0,0.00,0
,20161109,2330,2330,,,,2330,2330,0,0,0,0.00,0
,20161110,2330,2330,,,,2330,2330,0,0,0,0.00,0
,20161111,2330,2330,,,,2330,2330,0,0,0,0.00,0
,20161114,2330,2330,,,,2330,2330,0,0,0,0.00,0
,20161115,2330,2330,,,,2330,2330,0,0,0,0.00,0
,20161116,2330,2330,,,,2330,2330,0,0,0,0.00,0
,20161117,2330,2330,,,,2330,2330,0,0,0,0.00,0
,20161118,2330,2330,,,,2330,2330,0,0,0,0.00,0
,20161121,2330,2330,,,,2330,2330,0,0,0,0.00,0
,20161122,2330,2330,,,,2330,2330,0,0,0,0.00,0
,20161123,2330,2330,,,,2330,2330,0,0,0,0.00,0
,20161124,2330,2330,,,,2330,2330,0,0,0,0.00,0
,20161125,2330,2330,,,,2330,2330,0,0,0,0.00,0
,20161128,2330,2330,,,,2330,2330,0,0,0,0.00,0
,20161129,2330,2330,,,,2330,2330,0,0,0,0.00,0
,20161130,2330,2330,,,,2330,2330,0,0,0,0.00,0
,20161201,2330,2330,,,,2330,2330,0,0,0,0.00,0
,20161202,2330,2330,,,,2330,2330,0,0,0,0.00,0
,20161205,2330,2330,,,,2330,2330,0,0,0,0.00,0
,20161206,2330,2330,,,,2330,2330,0,0,0,0.00,0
,20161207,2330,2330,,,,2330,2330,0,0,0,0.00,0
,20161208,2330,2330,,,,2330,2330,0,0,0,0.00,0
,20161209,2330,2330,,,,2330,2330,0,0,0,0.00,0
,20161212,2330,2330,,,,2330,2330,0,0,0,0.00,0
,20161213,2330,2330,,,,2330,2330,0,0,0,0.00,0
,20161214,2330,2330,,,,2330,2330,0,0,0,0.00,0
,20161215,2330,2330,,,,2330,2330,0,0,0,0.00,0
,20161216,2330,2330,,,,2330,2330,0,0,0,0.00,0
,20161219,2330,2330,,,,2330,2330,0,0,0,0.00,0
,20161220,2330,2330,,,,2330,2330,0,0,0,0.00,0
,20161221,2330,2330,,,,2330,2330,0,0,0,0.00,0
,20161222,2330,2330,,,,2330,2330,0,0,0,0.00,0
,20161223,2330,2330,,,,2330,2330,0,0,0,0.00,0
,20161226,2330,2330,,,,2330,2330,0,0,0,0.00,0
,20161227,2330,2330,,,,2330,2330,0,0,0,0.00,0
,20161228,2330,2330,,,,2330,2330,0,0,0,0.00,0
,20161229,2330,2330,,,,2330,2330,0,0,0,0.00,0
,20161230,2330,2330,,,,2330,2330,0,0,0,0.00,0
wr1707,20160718,2297,2297,,,,2297,2297,0,0,0,0.00,0
,20160719,2297,2297,,,,2297,2297,0,0,0,0.00,0
,20160720,2297,2297,,,,2187,2187,-110,-110,0,0.00,0
,20160721,2187,2187,,,,2187,2187,0,0,0,0.00,0
,20160722,2187,2187,,,,2187,2187,0,0,0,0.00,0
,20160725,2187,2187,,,,2187,2187,0,0,0,0.00,0
,20160726,2187,2187,,,,2187,2187,0,0,0,0.00,0
,20160727,2187,2187,,,,2187,2187,0,0,0,0.00,0
,20160728,2187,2187,,,,2187,2187,0,0,0,0.00,0
,20160729,2187,2187,,,,2187,2187,0,0,0,0.00,0
,20160801,2187,2187,,,,2187,2187,0,0,0,0.00,0
,20160802,2187,2187,,,,2187,2187,0,0,0,0.00,0
,20160803,2187,2187,,,,2187,2187,0,0,0,0.00,0
,20160804,2187,2187,,,,2187,2187,0,0,0,0.00,0
,20160805,2187,2187,,,,2187,2187,0,0,0,0.00,0
,20160808,2187,2187,,,,2187,2187,0,0,0,0.00,0
,20160809,2187,2187,,,,2187,2187,0,0,0,0.00,0
,20160810,2187,2187,,,,2187,2187,0,0,0,0.00,0
,20160811,2187,2187,,,,2187,2187,0,0,0,0.00,0
,20160812,2187,2187,,,,2187,2187,0,0,0,0.00,0
,20160815,2187,2187,,,,2187,2187,0,0,0,0.00,0
,20160816,2187,2187,,,,2187,2187,0,0,0,0.00,0
,20160817,2187,2187,,,,2187,2187,0,0,0,0.00,0
,20160818,2187,2187,,,,2187,2187,0,0,0,0.00,0
,20160819,2187,2187,,,,2187,2187,0,0,0,0.00,0
,20160822,2187,2187,,,,2187,2187,0,0,0,0.00,0
,20160823,2187,2187,,,,2186,2186,-1,-1,0,0.00,0
,20160824,2186,2186,,,,2186,2186,0,0,0,0.00,0
,20160825,2186,2186,,,,2186,2186,0,0,0,0.00,0
,20160826,2186,2186,,,,2186,2186,0,0,0,0.00,0
,20160829,2186,2186,,,,2186,2186,0,0,0,0.00,0
,20160830,2186,2186,,,,2186,2186,0,0,0,0.00,0
,20160831,2186,2186,,,,2186,2186,0,0,0,0.00,0
,20160901,2186,2186,,,,2186,2186,0,0,0,0.00,0
,20160902,2186,2186,,,,2186,2186,0,0,0,0.00,0
,20160905,2186,2186,,,,2186,2186,0,0,0,0.00,0
,20160906,2186,2186,,,,2322,2322,136,136,0,0.00,0
,20160907,2322,2322,,,,2438,2438,116,116,0,0.00,0
,20160908,2438,2438,,,,2438,2438,0,0,0,0.00,0
,20160909,2438,2438,,,,2438,2438,0,0,0,0.00,0
,20160912,2438,2438,,,,2438,2438,0,0,0,0.00,0
,20160913,2438,2438,,,,2427,2427,-11,-11,0,0.00,0
,20160914,2427,2427,,,,2427,2427,0,0,0,0.00,0
,20160919,2427,2427,,,,2427,2427,0,0,0,0.00,0
,20160920,2427,2427,,,,2427,2427,0,0,0,0.00,0
,20160921,2427,2427,,,,2427,2427,0,0,0,0.00,0
,20160922,2427,2427,,,,2427,2427,0,0,0,0.00,0
,20160923,2427,2427,,,,2427,2427,0,0,0,0.00,0
,20160926,2427,2427,,,,2427,2427,0,0,0,0.00,0
,20160927,2427,2427,,,,2427,2427,0,0,0,0.00,0
,20160928,2427,2427,,,,2427,2427,0,0,0,0.00,0
,20160929,2427,2427,,,,2427,2427,0,0,0,0.00,0
,20160930,2427,2427,,,,2416,2416,-11,-11,0,0.00,0
,20161010,2416,2416,,,,2584,2584,168,168,0,0.00,0
,20161011,2584,2584,,,,2454,2454,-130,-130,0,0.00,0
,20161012,2454,2454,,,,2330,2330,-124,-124,0,0.00,0
,20161013,2330,2330,,,,2330,2330,0,0,0,0.00,0
,20161014,2330,2330,,,,2330,2330,0,0,0,0.00,0
,20161017,2330,2330,,,,2330,2330,0,0,0,0.00,0
,20161018,2330,2330,,,,2330,2330,0,0,0,0.00,0
,20161019,2330,2330,,,,2330,2330,0,0,0,0.00,0
,20161020,2330,2330,,,,2330,2330,0,0,0,0.00,0
,20161021,2330,2330,,,,2330,2330,0,0,0,0.00,0
,20161024,2330,2330,,,,2330,2330,0,0,0,0.00,0
,20161025,2330,2330,,,,2330,2330,0,0,0,0.00,0
,20161026,2330,2330,,,,2330,2330,0,0,0,0.00,0
,20161027,2330,2330,,,,2330,2330,0,0,0,0.00,0
,20161028,2330,2330,,,,2330,2330,0,0,0,0.00,0
,20161031,2330,2330,,,,2330,2330,0,0,0,0.00,0
,20161101,2330,2330,,,,2330,2330,0,0,0,0.00,0
,20161102,2330,2330,,,,2330,2330,0,0,0,0.00,0
,20161103,2330,2330,,,,2330,2330,0,0,0,0.00,0
,20161104,2330,2330,,,,2330,2330,0,0,0,0.00,0
,20161107,2330,2330,,,,2330,2330,0,0,0,0.00,0
,20161108,2330,2330,,,,2330,2330,0,0,0,0.00,0
,20161109,2330,2330,,,,2330,2330,0,0,0,0.00,0
,20161110,2330,2330,,,,2330,2330,0,0,0,0.00,0
,20161111,2330,2330,,,,2330,2330,0,0,0,0.00,0
,20161114,2330,2330,,,,2330,2330,0,0,0,0.00,0
,20161115,2330,2330,,,,2330,2330,0,0,0,0.00,0
,20161116,2330,2330,,,,2330,2330,0,0,0,0.00,0
,20161117,2330,2330,,,,2330,2330,0,0,0,0.00,0
,20161118,2330,2330,,,,2330,2330,0,0,0,0.00,0
,20161121,2330,2330,,,,2330,2330,0,0,0,0.00,0
,20161122,2330,2330,,,,2330,2330,0,0,0,0.00,0
,20161123,2330,2330,,,,2330,2330,0,0,0,0.00,0
,20161124,2330,2330,,,,2330,2330,0,0,0,0.00,0
,20161125,2330,2330,,,,2330,2330,0,0,0,0.00,0
,20161128,2330,2330,,,,2330,2330,0,0,0,0.00,0
,20161129,2330,2330,,,,2330,2330,0,0,0,0.00,0
,20161130,2330,2330,,,,2330,2330,0,0,0,0.00,0
,20161201,2330,2330,,,,2330,2330,0,0,0,0.00,0
,20161202,2330,2330,,,,2330,2330,0,0,0,0.00,0
,20161205,2330,2330,,,,2330,2330,0,0,0,0.00,0
,20161206,2330,2330,,,,2330,2330,0,0,0,0.00,0
,20161207,2330,2330,,,,2330,2330,0,0,0,0.00,0
,20161208,2330,2330,,,,2330,2330,0,0,0,0.00,0
,20161209,2330,2330,,,,2330,2330,0,0,0,0.00,0
,20161212,2330,2330,,,,2330,2330,0,0,0,0.00,0
,20161213,2330,2330,,,,2330,2330,0,0,0,0.00,0
,20161214,2330,2330,,,,2330,2330,0,0,0,0.00,0
,20161215,2330,2330,,,,2330,2330,0,0,0,0.00,0
,20161216,2330,2330,,,,2330,2330,0,0,0,0.00,0
,20161219,2330,2330,,,,2330,2330,0,0,0,0.00,0
,20161220,2330,2330,,,,2330,2330,0,0,0,0.00,0
,20161221,2330,2330,,,,2330,2330,0,0,0,0.00,0
,20161222,2330,2330,,,,2330,2330,0,0,0,0.00,0
,20161223,2330,2330,,,,2330,2330,0,0,0,0.00,0
,20161226,2330,2330,,,,2330,2330,0,0,0,0.00,0
,20161227,2330,2330,,,,2330,2330,0,0,0,0.00,0
,20161228,2330,2330,,,,2330,2330,0,0,0,0.00,0
,20161229,2330,2330,,,,2330,2330,0,0,0,0.00,0
,20161230,2330,2330,,,,2330,2330,0,0,0,0.00,0
wr1708,20160816,2187,2187,,,,2187,2187,0,0,0,0.00,0
,20160817,2187,2187,,,,2187,2187,0,0,0,0.00,0
,20160818,2187,2187,,,,2187,2187,0,0,0,0.00,0
,20160819,2187,2187,,,,2187,2187,0,0,0,0.00,0
,20160822,2187,2187,,,,2187,2187,0,0,0,0.00,0
,20160823,2187,2187,,,,2186,2186,-1,-1,0,0.00,0
,20160824,2186,2186,,,,2186,2186,0,0,0,0.00,0
,20160825,2186,2186,,,,2186,2186,0,0,0,0.00,0
,20160826,2186,2186,,,,2186,2186,0,0,0,0.00,0
,20160829,2186,2186,,,,2186,2186,0,0,0,0.00,0
,20160830,2186,2186,,,,2186,2186,0,0,0,0.00,0
,20160831,2186,2186,,,,2186,2186,0,0,0,0.00,0
,20160901,2186,2186,,,,2186,2186,0,0,0,0.00,0
,20160902,2186,2186,,,,2186,2186,0,0,0,0.00,0
,20160905,2186,2186,,,,2186,2186,0,0,0,0.00,0
,20160906,2186,2186,,,,2322,2322,136,136,0,0.00,0
,20160907,2322,2322,,,,2438,2438,116,116,0,0.00,0
,20160908,2438,2438,,,,2438,2438,0,0,0,0.00,0
,20160909,2438,2438,,,,2438,2438,0,0,0,0.00,0
,20160912,2438,2438,,,,2438,2438,0,0,0,0.00,0
,20160913,2438,2438,,,,2427,2427,-11,-11,0,0.00,0
,20160914,2427,2427,,,,2427,2427,0,0,0,0.00,0
,20160919,2427,2427,,,,2427,2427,0,0,0,0.00,0
,20160920,2427,2427,,,,2427,2427,0,0,0,0.00,0
,20160921,2427,2427,,,,2427,2427,0,0,0,0.00,0
,20160922,2427,2427,,,,2427,2427,0,0,0,0.00,0
,20160923,2427,2427,,,,2427,2427,0,0,0,0.00,0
,20160926,2427,2427,,,,2427,2427,0,0,0,0.00,0
,20160927,2427,2427,,,,2427,2427,0,0,0,0.00,0
,20160928,2427,2427,,,,2427,2427,0,0,0,0.00,0
,20160929,2427,2427,,,,2427,2427,0,0,0,0.00,0
,20160930,2427,2427,,,,2416,2416,-11,-11,0,0.00,0
,20161010,2416,2416,,,,2584,2584,168,168,0,0.00,0
,20161011,2584,2584,,,,2454,2454,-130,-130,0,0.00,0
,20161012,2454,2454,,,,2330,2330,-124,-124,0,0.00,0
,20161013,2330,2330,,,,2330,2330,0,0,0,0.00,0
,20161014,2330,2330,,,,2330,2330,0,0,0,0.00,0
,20161017,2330,2330,,,,2330,2330,0,0,0,0.00,0
,20161018,2330,2330,,,,2330,2330,0,0,0,0.00,0
,20161019,2330,2330,,,,2330,2330,0,0,0,0.00,0
,20161020,2330,2330,,,,2330,2330,0,0,0,0.00,0
,20161021,2330,2330,,,,2330,2330,0,0,0,0.00,0
,20161024,2330,2330,,,,2330,2330,0,0,0,0.00,0
,20161025,2330,2330,,,,2330,2330,0,0,0,0.00,0
,20161026,2330,2330,,,,2330,2330,0,0,0,0.00,0
,20161027,2330,2330,,,,2330,2330,0,0,0,0.00,0
,20161028,2330,2330,,,,2330,2330,0,0,0,0.00,0
,20161031,2330,2330,,,,2330,2330,0,0,0,0.00,0
,20161101,2330,2330,,,,2330,2330,0,0,0,0.00,0
,20161102,2330,2330,,,,2330,2330,0,0,0,0.00,0
,20161103,2330,2330,,,,2330,2330,0,0,0,0.00,0
,20161104,2330,2330,,,,2330,2330,0,0,0,0.00,0
,20161107,2330,2330,,,,2330,2330,0,0,0,0.00,0
,20161108,2330,2330,,,,2330,2330,0,0,0,0.00,0
,20161109,2330,2330,,,,2330,2330,0,0,0,0.00,0
,20161110,2330,2330,,,,2330,2330,0,0,0,0.00,0
,20161111,2330,2330,,,,2330,2330,0,0,0,0.00,0
,20161114,2330,2330,,,,2330,2330,0,0,0,0.00,0
,20161115,2330,2330,,,,2330,2330,0,0,0,0.00,0
,20161116,2330,2330,,,,2330,2330,0,0,0,0.00,0
,20161117,2330,2330,,,,2330,2330,0,0,0,0.00,0
,20161118,2330,2330,,,,2330,2330,0,0,0,0.00,0
,20161121,2330,2330,,,,2330,2330,0,0,0,0.00,0
,20161122,2330,2330,,,,2330,2330,0,0,0,0.00,0
,20161123,2330,2330,,,,2330,2330,0,0,0,0.00,0
,20161124,2330,2330,,,,2330,2330,0,0,0,0.00,0
,20161125,2330,2330,,,,2330,2330,0,0,0,0.00,0
,20161128,2330,2330,,,,2330,2330,0,0,0,0.00,0
,20161129,2330,2330,,,,2330,2330,0,0,0,0.00,0
,20161130,2330,2330,,,,2330,2330,0,0,0,0.00,0
,20161201,2330,2330,,,,2330,2330,0,0,0,0.00,0
,20161202,2330,2330,,,,2330,2330,0,0,0,0.00,0
,20161205,2330,2330,,,,2330,2330,0,0,0,0.00,0
,20161206,2330,2330,,,,2330,2330,0,0,0,0.00,0
,20161207,2330,2330,,,,2330,2330,0,0,0,0.00,0
,20161208,2330,2330,,,,2330,2330,0,0,0,0.00,0
,20161209,2330,2330,,,,2330,2330,0,0,0,0.00,0
,20161212,2330,2330,,,,2330,2330,0,0,0,0.00,0
,20161213,2330,2330,,,,2330,2330,0,0,0,0.00,0
,20161214,2330,2330,,,,2330,2330,0,0,0,0.00,0
,20161215,2330,2330,,,,2330,2330,0,0,0,0.00,0
,20161216,2330,2330,,,,2330,2330,0,0,0,0.00,0
,20161219,2330,2330,,,,2330,2330,0,0,0,0.00,0
,20161220,2330,2330,,,,2330,2330,0,0,0,0.00,0
,20161221,2330,2330,,,,2330,2330,0,0,0,0.00,0
,20161222,2330,2330,,,,2330,2330,0,0,0,0.00,0
,20161223,2330,2330,,,,2330,2330,0,0,0,0.00,0
,20161226,2330,2330,,,,2330,2330,0,0,0,0.00,0
,20161227,2330,2330,,,,2330,2330,0,0,0,0.00,0
,20161228,2330,2330,,,,2330,2330,0,0,0,0.00,0
,20161229,2330,2330,,,,2330,2330,0,0,0,0.00,0
,20161230,2330,2330,,,,2330,2330,0,0,0,0.00,0
wr1709,20160920,2427,2427,,,,2427,2427,0,0,0,0.00,0
,20160921,2427,2427,,,,2427,2427,0,0,0,0.00,0
,20160922,2427,2427,,,,2427,2427,0,0,0,0.00,0
,20160923,2427,2427,,,,2427,2427,0,0,0,0.00,0
,20160926,2427,2427,,,,2427,2427,0,0,0,0.00,0
,20160927,2427,2427,,,,2427,2427,0,0,0,0.00,0
,20160928,2427,2427,,,,2427,2427,0,0,0,0.00,0
,20160929,2427,2427,,,,2427,2427,0,0,0,0.00,0
,20160930,2427,2427,,,,2416,2416,-11,-11,0,0.00,0
,20161010,2416,2416,,,,2584,2584,168,168,0,0.00,0
,20161011,2584,2584,,,,2454,2454,-130,-130,0,0.00,0
,20161012,2454,2454,,,,2330,2330,-124,-124,0,0.00,0
,20161013,2330,2330,,,,2330,2330,0,0,0,0.00,0
,20161014,2330,2330,,,,2330,2330,0,0,0,0.00,0
,20161017,2330,2330,,,,2330,2330,0,0,0,0.00,0
,20161018,2330,2330,,,,2330,2330,0,0,0,0.00,0
,20161019,2330,2330,,,,2330,2330,0,0,0,0.00,0
,20161020,2330,2330,,,,2330,2330,0,0,0,0.00,0
,20161021,2330,2330,,,,2330,2330,0,0,0,0.00,0
,20161024,2330,2330,,,,2330,2330,0,0,0,0.00,0
,20161025,2330,2330,,,,2330,2330,0,0,0,0.00,0
,20161026,2330,2330,,,,2330,2330,0,0,0,0.00,0
,20161027,2330,2330,,,,2330,2330,0,0,0,0.00,0
,20161028,2330,2330,,,,2330,2330,0,0,0,0.00,0
,20161031,2330,2330,,,,2330,2330,0,0,0,0.00,0
,20161101,2330,2330,,,,2330,2330,0,0,0,0.00,0
,20161102,2330,2330,,,,2330,2330,0,0,0,0.00,0
,20161103,2330,2330,,,,2330,2330,0,0,0,0.00,0
,20161104,2330,2330,,,,2330,2330,0,0,0,0.00,0
,20161107,2330,2330,,,,2330,2330,0,0,0,0.00,0
,20161108,2330,2330,,,,2330,2330,0,0,0,0.00,0
,20161109,2330,2330,,,,2330,2330,0,0,0,0.00,0
,20161110,2330,2330,,,,2330,2330,0,0,0,0.00,0
,20161111,2330,2330,,,,2330,2330,0,0,0,0.00,0
,20161114,2330,2330,,,,2330,2330,0,0,0,0.00,0
,20161115,2330,2330,,,,2330,2330,0,0,0,0.00,0
,20161116,2330,2330,,,,2330,2330,0,0,0,0.00,0
,20161117,2330,2330,,,,2330,2330,0,0,0,0.00,0
,20161118,2330,2330,,,,2330,2330,0,0,0,0.00,0
,20161121,2330,2330,,,,2330,2330,0,0,0,0.00,0
,20161122,2330,2330,,,,2330,2330,0,0,0,0.00,0
,20161123,2330,2330,,,,2330,2330,0,0,0,0.00,0
,20161124,2330,2330,,,,2330,2330,0,0,0,0.00,0
,20161125,2330,2330,,,,2330,2330,0,0,0,0.00,0
,20161128,2330,2330,,,,2330,2330,0,0,0,0.00,0
,20161129,2330,2330,,,,2330,2330,0,0,0,0.00,0
,20161130,2330,2330,,,,2330,2330,0,0,0,0.00,0
,20161201,2330,2330,,,,2330,2330,0,0,0,0.00,0
,20161202,2330,2330,,,,2330,2330,0,0,0,0.00,0
,20161205,2330,2330,,,,2330,2330,0,0,0,0.00,0
,20161206,2330,2330,,,,2330,2330,0,0,0,0.00,0
,20161207,2330,2330,,,,2330,2330,0,0,0,0.00,0
,20161208,2330,2330,,,,2330,2330,0,0,0,0.00,0
,20161209,2330,2330,,,,2330,2330,0,0,0,0.00,0
,20161212,2330,2330,,,,2330,2330,0,0,0,0.00,0
,20161213,2330,2330,,,,2330,2330,0,0,0,0.00,0
,20161214,2330,2330,,,,2330,2330,0,0,0,0.00,0
,20161215,2330,2330,,,,2330,2330,0,0,0,0.00,0
,20161216,2330,2330,,,,2330,2330,0,0,0,0.00,0
,20161219,2330,2330,,,,2330,2330,0,0,0,0.00,0
,20161220,2330,2330,,,,2330,2330,0,0,0,0.00,0
,20161221,2330,2330,,,,2330,2330,0,0,0,0.00,0
,20161222,2330,2330,,,,2330,2330,0,0,0,0.00,0
,20161223,2330,2330,,,,2330,2330,0,0,0,0.00,0
,20161226,2330,2330,,,,2330,2330,0,0,0,0.00,0
,20161227,2330,2330,,,,2330,2330,0,0,0,0.00,0
,20161228,2330,2330,,,,2330,2330,0,0,0,0.00,0
,20161229,2330,2330,,,,2330,2330,0,0,0,0.00,0
,20161230,2330,2330,,,,2330,2330,0,0,0,0.00,0
wr1710,20161018,2330,2330,,,,2330,2330,0,0,0,0.00,0
,20161019,2330,2330,,,,2330,2330,0,0,0,0.00,0
,20161020,2330,2330,,,,2330,2330,0,0,0,0.00,0
,20161021,2330,2330,,,,2330,2330,0,0,0,0.00,0
,20161024,2330,2330,,,,2330,2330,0,0,0,0.00,0
,20161025,2330,2330,,,,2330,2330,0,0,0,0.00,0
,20161026,2330,2330,,,,2330,2330,0,0,0,0.00,0
,20161027,2330,2330,,,,2330,2330,0,0,0,0.00,0
,20161028,2330,2330,,,,2330,2330,0,0,0,0.00,0
,20161031,2330,2330,,,,2330,2330,0,0,0,0.00,0
,20161101,2330,2330,,,,2330,2330,0,0,0,0.00,0
,20161102,2330,2330,,,,2330,2330,0,0,0,0.00,0
,20161103,2330,2330,,,,2330,2330,0,0,0,0.00,0
,20161104,2330,2330,,,,2330,2330,0,0,0,0.00,0
,20161107,2330,2330,,,,2330,2330,0,0,0,0.00,0
,20161108,2330,2330,,,,2330,2330,0,0,0,0.00,0
,20161109,2330,2330,,,,2330,2330,0,0,0,0.00,0
,20161110,2330,2330,,,,2330,2330,0,0,0,0.00,0
,20161111,2330,2330,,,,2330,2330,0,0,0,0.00,0
,20161114,2330,2330,,,,2330,2330,0,0,0,0.00,0
,20161115,2330,2330,,,,2330,2330,0,0,0,0.00,0
,20161116,2330,2330,,,,2330,2330,0,0,0,0.00,0
,20161117,2330,2330,,,,2330,2330,0,0,0,0.00,0
,20161118,2330,2330,,,,2330,2330,0,0,0,0.00,0
,20161121,2330,2330,,,,2330,2330,0,0,0,0.00,0
,20161122,2330,2330,,,,2330,2330,0,0,0,0.00,0
,20161123,2330,2330,,,,2330,2330,0,0,0,0.00,0
,20161124,2330,2330,,,,2330,2330,0,0,0,0.00,0
,20161125,2330,2330,,,,2330,2330,0,0,0,0.00,0
,20161128,2330,2330,,,,2330,2330,0,0,0,0.00,0
,20161129,2330,2330,,,,2330,2330,0,0,0,0.00,0
,20161130,2330,2330,,,,2330,2330,0,0,0,0.00,0
,20161201,2330,2330,,,,2330,2330,0,0,0,0.00,0
,20161202,2330,2330,,,,2330,2330,0,0,0,0.00,0
,20161205,2330,2330,,,,2330,2330,0,0,0,0.00,0
,20161206,2330,2330,,,,2330,2330,0,0,0,0.00,0
,20161207,2330,2330,,,,2330,2330,0,0,0,0.00,0
,20161208,2330,2330,,,,2330,2330,0,0,0,0.00,0
,20161209,2330,2330,,,,2330,2330,0,0,0,0.00,0
,20161212,2330,2330,,,,2330,2330,0,0,0,0.00,0
,20161213,2330,2330,,,,2330,2330,0,0,0,0.00,0
,20161214,2330,2330,,,,2330,2330,0,0,0,0.00,0
,20161215,2330,2330,,,,2330,2330,0,0,0,0.00,0
,20161216,2330,2330,,,,2330,2330,0,0,0,0.00,0
,20161219,2330,2330,,,,2330,2330,0,0,0,0.00,0
,20161220,2330,2330,,,,2330,2330,0,0,0,0.00,0
,20161221,2330,2330,,,,2330,2330,0,0,0,0.00,0
,20161222,2330,2330,,,,2330,2330,0,0,0,0.00,0
,20161223,2330,2330,,,,2330,2330,0,0,0,0.00,0
,20161226,2330,2330,,,,2330,2330,0,0,0,0.00,0
,20161227,2330,2330,,,,2330,2330,0,0,0,0.00,0
,20161228,2330,2330,,,,2330,2330,0,0,0,0.00,0
,20161229,2330,2330,,,,2330,2330,0,0,0,0.00,0
,20161230,2330,2330,,,,2330,2330,0,0,0,0.00,0
wr1711,20161116,2330,2330,,,,2330,2330,0,0,0,0.00,0
,20161117,2330,2330,,,,2330,2330,0,0,0,0.00,0
,20161118,2330,2330,,,,2330,2330,0,0,0,0.00,0
,20161121,2330,2330,,,,2330,2330,0,0,0,0.00,0
,20161122,2330,2330,,,,2330,2330,0,0,0,0.00,0
,20161123,2330,2330,,,,2330,2330,0,0,0,0.00,0
,20161124,2330,2330,,,,2330,2330,0,0,0,0.00,0
,20161125,2330,2330,,,,2330,2330,0,0,0,0.00,0
,20161128,2330,2330,,,,2330,2330,0,0,0,0.00,0
,20161129,2330,2330,,,,2330,2330,0,0,0,0.00,0
,20161130,2330,2330,,,,2330,2330,0,0,0,0.00,0
,20161201,2330,2330,,,,2330,2330,0,0,0,0.00,0
,20161202,2330,2330,,,,2330,2330,0,0,0,0.00,0
,20161205,2330,2330,,,,2330,2330,0,0,0,0.00,0
,20161206,2330,2330,,,,2330,2330,0,0,0,0.00,0
,20161207,2330,2330,,,,2330,2330,0,0,0,0.00,0
,20161208,2330,2330,,,,2330,2330,0,0,0,0.00,0
,20161209,2330,2330,,,,2330,2330,0,0,0,0.00,0
,20161212,2330,2330,,,,2330,2330,0,0,0,0.00,0
,20161213,2330,2330,,,,2330,2330,0,0,0,0.00,0
,20161214,2330,2330,,,,2330,2330,0,0,0,0.00,0
,20161215,2330,2330,,,,2330,2330,0,0,0,0.00,0
,20161216,2330,2330,,,,2330,2330,0,0,0,0.00,0
,20161219,2330,2330,,,,2330,2330,0,0,0,0.00,0
,20161220,2330,2330,,,,2330,2330,0,0,0,0.00,0
,20161221,2330,2330,,,,2330,2330,0,0,0,0.00,0
,20161222,2330,2330,,,,2330,2330,0,0,0,0.00,0
,20161223,2330,2330,,,,2330,2330,0,0,0,0.00,0
,20161226,2330,2330,,,,2330,2330,0,0,0,0.00,0
,20161227,2330,2330,,,,2330,2330,0,0,0,0.00,0
,20161228,2330,2330,,,,2330,2330,0,0,0,0.00,0
,20161229,2330,2330,,,,2330,2330,0,0,0,0.00,0
,20161230,2330,2330,,,,2330,2330,0,0,0,0.00,0
wr1712,20161216,2330,2330,,,,2330,2330,0,0,0,0.00,0
,20161219,2330,2330,,,,2330,2330,0,0,0,0.00,0
,20161220,2330,2330,,,,2330,2330,0,0,0,0.00,0
,20161221,2330,2330,,,,2330,2330,0,0,0,0.00,0
,20161222,2330,2330,,,,2330,2330,0,0,0,0.00,0
,20161223,2330,2330,2097,2563,2097,2563,2330,233,0,8,18.64,8
,20161226,2563,2330,2516,2516,2516,2516,2516,186,186,8,20.13,4
,20161227,2516,2516,2767,2767,2767,2767,2767,251,251,4,11.07,0
,20161228,2767,2767,,,,2767,2767,0,0,0,0.00,0
,20161229,2767,2767,,,,2767,2767,0,0,0,0.00,0
,20161230,2767,2767,,,,2767,2767,0,0,0,0.00,0
zn1601,20160104,13320,13345,13255,13255,13070,13100,13140,-245,-205,1700,"11,170.18",20020
,20160105,13100,13140,13100,13245,13085,13235,13160,95,20,5840,"38,427.75",17520
,20160106,13235,13160,13185,13185,12980,12995,13045,-165,-115,2250,"14,680.85",16520
,20160107,12995,13045,13035,13050,12800,12830,12890,-215,-155,3350,"21,595.63",15100
,20160108,12830,12890,12795,12930,12645,12850,12795,-40,-95,1980,"12,667.13",14600
,20160111,12850,12795,12860,12870,12675,12765,12750,-30,-45,4850,"30,928.95",14910
,20160112,12765,12750,12765,12765,12350,12350,12555,-400,-195,4220,"26,495.85",13510
,20160113,12350,12555,12400,12460,12360,12450,12405,-105,-150,1510,"9,369.30",12550
,20160114,12450,12405,12400,12580,12360,12520,12480,115,75,3200,"19,971.65",10750
,20160115,12520,12480,12585,12680,12450,12450,12555,-30,75,2630,"16,514.18",9760
zn1602,20160104,13415,13415,13385,13430,13120,13145,13230,-270,-185,177552,"1,174,528.85",101214
,20160105,13145,13230,13130,13315,13120,13305,13200,75,-30,154744,"1,021,642.81",95760
,20160106,13305,13200,13210,13270,13015,13055,13125,-145,-75,89534,"587,572.91",85738
,20160107,13055,13125,13000,13105,12830,12870,12970,-255,-155,97888,"634,988.73",70586
,20160108,12870,12970,12825,12955,12670,12885,12835,-85,-135,89534,"574,681.17",63370
,20160111,12885,12835,12810,12940,12745,12800,12840,-35,5,53196,"341,526.97",62044
,20160112,12800,12840,12780,12835,12330,12385,12605,-455,-235,54892,"346,059.44",55978
,20160113,12385,12605,12470,12525,12370,12480,12460,-125,-145,29610,"184,518.05",51558
,20160114,12480,12460,12495,12660,12430,12580,12555,120,95,21864,"137,264.54",49402
,20160115,12580,12555,12570,12775,12485,12505,12630,-50,75,18948,"119,670.03",46840
,20160118,12505,12630,12455,12735,12405,12645,12610,15,-20,17864,"112,676.26",44806
,20160119,12645,12610,12635,12825,12610,12790,12725,180,115,16828,"107,083.75",41364
,20160120,12790,12725,12805,12820,12615,12675,12730,-50,5,11696,"74,447.34",37316
,20160121,12675,12730,12690,12715,12560,12585,12635,-145,-95,10840,"68,504.85",35490
,20160122,12585,12635,12605,12805,12590,12745,12730,110,95,10074,"64,137.92",32706
,20160125,12745,12730,12820,12845,12640,12720,12705,-10,-25,7128,"45,291.68",29638
,20160126,12720,12705,12720,12780,12680,12750,12720,45,15,9796,"62,325.73",28098
,20160127,12750,12720,12800,13070,12800,13020,12970,300,250,12250,"79,465.71",25194
,20160128,13020,12970,13030,13030,12910,12940,12985,-30,15,7590,"49,279.32",21500
,20160129,12940,12985,12935,13080,12860,12975,12920,-10,-65,6042,"39,031.43",19002
,20160201,12975,12920,13010,13130,12940,13055,13040,135,120,4822,"31,443.84",15940
,20160202,13055,13040,13080,13235,13080,13210,13175,170,135,4770,"31,431.75",14260
,20160203,13210,13175,13250,13385,13180,13360,13290,185,115,3740,"24,857.18",13980
,20160204,13360,13290,13380,13835,13380,13800,13700,510,410,1840,"12,605.80",13660
,20160205,13800,13700,13680,13680,13600,13660,13625,-40,-75,600,"4,088.30",13760
,20160215,13660,13625,13650,13795,12700,13640,13645,15,20,910,"6,208.48",13920
zn1603,20160104,13440,13430,13415,13450,13140,13165,13240,-265,-190,167156,"1,106,841.97",166822
,20160105,13165,13240,13135,13345,13135,13335,13235,95,-5,238844,"1,580,622.93",178592
,20160106,13335,13235,13255,13300,13030,13070,13140,-165,-95,382576,"2,514,058.42",180572
,20160107,13070,13140,13020,13120,12835,12885,12990,-255,-150,454548,"2,953,261.97",178146
,20160108,12885,12990,12800,12965,12670,12885,12840,-105,-150,574042,"3,686,308.18",179032
,20160111,12885,12840,12850,12960,12765,12840,12875,0,35,413970,"2,665,079.06",186480
,20160112,12840,12875,12805,12865,12335,12375,12625,-500,-250,534352,"3,373,182.51",203130
,20160113,12375,12625,12465,12535,12380,12490,12465,-135,-160,477974,"2,979,826.36",195966
,20160114,12490,12465,12500,12675,12440,12620,12555,155,90,496748,"3,118,592.48",190524
,20160115,12620,12555,12610,12810,12515,12530,12665,-25,110,609326,"3,858,848.98",188468
,20160118,12530,12665,12470,12775,12440,12690,12635,25,-30,500620,"3,163,178.84",177546
,20160119,12690,12635,12650,12880,12640,12830,12750,195,115,495620,"3,159,954.52",175946
,20160120,12830,12750,12865,12875,12660,12720,12780,-30,30,397918,"2,542,886.90",170376
,20160121,12720,12780,12715,12760,12595,12625,12685,-155,-95,396170,"2,513,113.20",172736
,20160122,12625,12685,12635,12865,12630,12785,12755,100,70,402478,"2,567,574.51",171580
,20160125,12785,12755,12850,12890,12685,12760,12775,5,20,273002,"1,744,441.36",165132
,20160126,12760,12775,12790,12840,12725,12795,12775,20,0,274738,"1,755,431.44",161396
,20160127,12795,12775,12950,13140,12895,13095,13025,320,250,468614,"3,052,922.69",154796
,20160128,13095,13025,13100,13100,12955,12980,13035,-45,10,358634,"2,338,231.41",149988
,20160129,12980,13035,12965,13085,12910,13080,12980,45,-55,280098,"1,818,525.95",136948
,20160201,13080,12980,13080,13210,13000,13140,13110,160,130,245050,"1,606,721.06",122992
,20160202,13140,13110,13155,13320,13100,13295,13210,185,100,208302,"1,376,206.83",114302
,20160203,13295,13210,13390,13445,13230,13415,13335,205,125,185674,"1,238,060.63",102742
,20160204,13415,13335,13435,13945,13395,13875,13670,540,335,158812,"1,085,724.66",90066
,20160205,13875,13670,13830,13900,13645,13770,13790,100,120,78132,"538,820.80",79084
,20160215,13770,13790,13745,13900,13645,13755,13800,-35,10,32664,"225,421.10",77310
,20160216,13755,13800,13710,13770,13565,13610,13665,-190,-135,43146,"294,810.50",71128
,20160217,13610,13665,13635,13665,13455,13515,13540,-150,-125,27830,"188,471.42",67120
,20160218,13515,13540,13520,13590,13485,13550,13540,10,0,17530,"118,696.44",64844
,20160219,13550,13540,13545,13895,13525,13855,13750,315,210,29384,"202,061.51",64042
,20160222,13855,13750,13865,14215,13810,14155,14080,405,330,27876,"196,307.02",59322
,20160223,14155,14080,14190,14260,14000,14060,14110,-20,30,26124,"184,333.23",55296
,20160224,14060,14110,14050,14050,13815,13890,13935,-220,-175,15344,"106,922.91",50678
,20160225,13890,13935,13890,14295,13865,14010,14130,75,195,17096,"120,806.90",47372
,20160226,14010,14130,14055,14070,13755,13905,13895,-225,-235,12874,"89,442.19",43160
,20160229,13905,13895,13905,14170,13900,13985,14000,90,105,10424,"72,971.06",38982
,20160301,13985,14000,14120,14120,13825,14030,13980,30,-20,3282,"22,943.17",36970
,20160302,14030,13980,14090,14295,14005,14250,14210,270,230,6200,"44,053.85",34430
,20160303,14250,14210,14225,14320,14185,14295,14260,85,50,3050,"21,751.80",32620
,20160304,14295,14260,14310,14520,14300,14325,14400,65,140,4230,"30,463.50",31770
,20160307,14325,14400,14320,14625,14230,14240,14355,-160,-45,3680,"26,415.95",31590
,20160308,14240,14355,14380,14440,14030,14155,14150,-200,-205,3810,"26,957.43",30290
,20160309,14155,14150,14120,14120,13735,13945,13865,-205,-285,1850,"12,829.60",29420
,20160310,13945,13865,14085,14090,13875,13990,13950,125,85,3850,"26,860.88",28620
,20160311,13990,13950,13900,14050,13900,14010,13955,60,5,420,"2,930.75",28430
,20160314,14010,13955,14040,14175,13950,14090,14030,135,75,2640,"18,525.80",28070
,20160315,14090,14030,14020,14040,13900,13930,13950,-100,-80,2220,"15,488.00",27690
zn1604,20160104,13445,13430,13400,13455,13150,13175,13260,-255,-170,29694,"196,878.00",70066
,20160105,13175,13260,13170,13350,13150,13350,13240,90,-20,26766,"177,222.80",70048
,20160106,13350,13240,13250,13300,13040,13085,13155,-155,-85,37524,"246,884.55",67638
,20160107,13085,13155,13050,13120,12850,12900,12995,-255,-160,45692,"296,954.19",73028
,20160108,12900,12995,12800,12980,12675,12890,12840,-105,-155,63398,"407,107.37",83444
,20160111,12890,12840,12855,12970,12775,12840,12875,0,35,46578,"299,922.92",87550
,20160112,12840,12875,12800,12875,12345,12360,12610,-515,-265,81196,"512,035.65",78852
,20160113,12360,12610,12405,12550,12380,12505,12470,-105,-140,60806,"379,239.04",75766
,20160114,12505,12470,12515,12690,12450,12640,12585,170,115,60658,"381,745.07",80134
,20160115,12640,12585,12670,12830,12535,12560,12680,-25,95,66234,"419,981.19",79830
,20160118,12560,12680,12520,12785,12465,12700,12655,20,-25,69902,"442,464.05",77700
,20160119,12700,12655,12680,12895,12665,12850,12770,195,115,62362,"398,254.58",79376
,20160120,12850,12770,12875,12895,12685,12745,12785,-25,15,64046,"409,477.47",88496
,20160121,12745,12785,12695,12775,12610,12640,12700,-145,-85,67340,"427,630.28",93746
,20160122,12640,12700,12640,12880,12640,12815,12775,115,75,67754,"432,838.48",95668
,20160125,12815,12775,12870,12915,12715,12785,12795,10,20,49070,"313,977.97",99518
,20160126,12785,12795,12820,12860,12755,12820,12810,25,15,55016,"352,389.11",99244
,20160127,12820,12810,12960,13170,12920,13110,13065,300,255,103128,"673,784.11",111688
,20160128,13110,13065,13065,13130,12990,13005,13070,-60,5,94126,"615,122.17",124204
,20160129,13005,13070,13005,13105,12945,13100,13015,30,-55,82750,"538,520.01",127698
,20160201,13100,13015,13110,13240,13040,13185,13150,170,135,120832,"794,572.54",128942
,20160202,13185,13150,13205,13365,13145,13340,13260,190,110,189248,"1,254,901.22",146650
,20160203,13340,13260,13400,13510,13275,13490,13395,230,135,243488,"1,630,893.32",173138
,20160204,13490,13395,13480,14010,13455,13945,13755,550,360,386774,"2,660,059.96",174538
,20160205,13945,13755,13890,13970,13705,13835,13845,80,90,258254,"1,788,135.26",165134
,20160215,13835,13845,13780,13960,13720,13815,13860,-30,15,165790,"1,148,953.41",170150
,20160216,13815,13860,13735,13830,13615,13660,13715,-200,-145,310634,"2,130,312.24",175224
,20160217,13660,13715,13660,13720,13505,13555,13605,-160,-110,288158,"1,960,855.55",177902
,20160218,13555,13605,13580,13650,13535,13615,13590,10,-15,255860,"1,738,975.55",179626
,20160219,13615,13590,13615,13960,13605,13915,13790,325,200,425508,"2,934,561.23",193010
,20160222,13915,13790,13945,14285,13870,14220,14110,430,320,446626,"3,151,209.13",205948
,20160223,14220,14110,14270,14320,14060,14140,14185,30,75,461744,"3,275,903.36",199672
,20160224,14140,14185,14115,14125,13870,13955,14000,-230,-185,434868,"3,044,128.60",177594
,20160225,13955,14000,13965,14360,13915,14070,14160,70,160,602836,"4,269,015.64",179230
,20160226,14070,14160,14120,14140,13815,13945,13965,-215,-195,666318,"4,652,635.34",160286
,20160229,13945,13965,13980,14235,13935,14050,14075,85,110,647704,"4,558,229.87",144680
,20160301,14050,14075,14215,14215,13860,14100,14070,25,-5,352114,"2,477,257.46",131290
,20160302,14100,14070,14170,14360,14065,14310,14215,240,145,253744,"1,804,115.65",123474
,20160303,14310,14215,14285,14400,14250,14340,14325,125,110,130998,"938,444.86",118148
,20160304,14340,14325,14435,14610,14350,14435,14450,110,125,130552,"943,493.93",101472
,20160307,14435,14450,14445,14690,14290,14355,14440,-95,-10,154610,"1,116,657.60",86688
,20160308,14355,14440,14410,14545,14115,14230,14285,-210,-155,95084,"679,147.35",79820
,20160309,14230,14285,14295,14315,13730,14015,14000,-270,-285,85940,"601,611.30",71716
,20160310,14015,14000,14125,14230,13970,14020,14075,20,75,43368,"305,298.05",68248
,20160311,14020,14075,14060,14100,13920,14090,14015,15,-60,24100,"168,895.09",66374
,20160314,14090,14015,14090,14280,14030,14115,14150,100,135,23026,"162,925.64",64788
,20160315,14115,14150,14115,14180,13975,13980,14050,-170,-100,20186,"141,843.48",64070
,20160316,13980,14050,13925,14015,13770,13925,13885,-125,-165,22764,"158,059.81",57752
,20160317,13925,13885,13875,14120,13875,14120,14020,235,135,16204,"113,607.92",53526
,20160318,14120,14020,14120,14520,14110,14350,14325,330,305,22856,"163,708.11",51758
,20160321,14350,14325,14360,14495,14230,14335,14370,10,45,12742,"91,576.79",50912
,20160322,14335,14370,14365,14515,14340,14380,14410,10,40,11958,"86,176.19",49902
,20160323,14380,14410,14385,14455,14300,14320,14360,-90,-50,8640,"62,044.40",48728
,20160324,14320,14360,14320,14320,14130,14130,14200,-230,-160,10988,"78,040.16",45366
,20160325,14130,14200,14095,14215,14005,14190,14130,-10,-70,5296,"37,419.59",43944
,20160328,14190,14130,14190,14305,14150,14155,14240,25,110,3812,"27,149.11",42514
,20160329,14155,14240,14165,14315,14050,14090,14180,-150,-60,4648,"32,956.15",41448
,20160330,14090,14180,14125,14200,14020,14065,14090,-115,-90,5860,"41,297.99",39400
,20160331,14065,14090,14075,14210,14040,14050,14090,-40,0,4324,"30,462.59",36660
,20160401,14050,14090,14110,14380,14110,14330,14305,240,215,2910,"20,819.28",35730
,20160405,14330,14305,14380,14430,14345,14350,14385,45,80,2290,"16,475.70",35350
,20160406,14350,14385,14290,14290,14160,14170,14235,-215,-150,3070,"21,857.15",33740
,20160407,14170,14235,14185,14215,14110,14130,14180,-105,-55,3900,"27,654.73",32040
,20160408,14130,14180,14000,14015,13880,13930,13940,-250,-240,3400,"23,698.50",30310
,20160411,13930,13940,14030,14135,14015,14020,14075,80,135,2840,"19,987.90",29790
,20160412,14020,14075,14020,14090,13985,14055,14010,-20,-65,3900,"27,322.00",30040
,20160413,14055,14010,14100,14710,14100,14700,14580,690,570,3510,"25,590.30",28150
,20160414,14700,14580,14850,15050,14700,14760,14840,180,260,2630,"19,519.78",27200
,20160415,14760,14840,14840,14900,14725,14765,14830,-75,-10,1970,"14,608.45",27380
zn1605,20160104,13445,13440,13350,13460,13155,13180,13275,-260,-165,8678,"57,603.67",22600
,20160105,13180,13275,13175,13360,13160,13345,13245,70,-30,7528,"49,855.40",22864
,20160106,13345,13245,13280,13305,13045,13100,13130,-145,-115,13832,"90,825.24",20514
,20160107,13100,13130,13050,13120,12850,12910,13005,-220,-125,15008,"97,620.47",21422
,20160108,12910,13005,12890,12980,12690,12900,12850,-105,-155,18184,"116,862.31",22672
,20160111,12900,12850,12870,12975,12780,12840,12880,-10,30,11274,"72,623.36",23268
,20160112,12840,12880,12800,12880,12360,12390,12615,-490,-265,22040,"139,054.24",28186
,20160113,12390,12615,12430,12550,12385,12535,12475,-80,-140,13752,"85,797.77",28454
,20160114,12535,12475,12545,12700,12460,12645,12590,170,115,15520,"97,712.41",30080
,20160115,12645,12590,12655,12840,12550,12565,12690,-25,100,16220,"102,941.28",30598
,20160118,12565,12690,12525,12790,12460,12715,12670,25,-20,23900,"151,454.76",29270
,20160119,12715,12670,12705,12900,12675,12865,12785,195,115,20152,"128,868.29",31144
,20160120,12865,12785,12870,12900,12700,12745,12795,-40,10,17130,"109,631.14",33388
,20160121,12745,12795,12710,12780,12600,12670,12705,-125,-90,20768,"131,959.94",37824
,20160122,12670,12705,12690,12900,12660,12835,12805,130,100,16056,"102,804.52",37436
,20160125,12835,12805,12870,12925,12740,12800,12805,-5,0,14938,"95,645.61",39102
,20160126,12800,12805,12815,12880,12780,12835,12825,30,20,13560,"86,977.74",39352
,20160127,12835,12825,12995,13195,12945,13145,13085,320,260,35526,"232,509.51",43762
,20160128,13145,13085,13155,13155,13010,13025,13085,-60,0,27424,"179,431.49",46522
,20160129,13025,13085,13015,13130,12975,13115,13035,30,-50,22214,"144,835.08",48296
,20160201,13115,13035,13115,13280,13075,13215,13180,180,145,30890,"203,592.82",47774
,20160202,13215,13180,13215,13390,13170,13380,13295,200,115,33248,"221,027.43",49806
,20160203,13380,13295,13410,13540,13310,13515,13430,220,135,35526,"238,630.01",53994
,20160204,13515,13430,13510,14045,13485,13970,13785,540,355,49922,"344,088.89",59326
,20160205,13970,13785,13945,13995,13740,13870,13865,85,80,26664,"184,877.01",57624
,20160215,13870,13865,13770,13985,13730,13845,13895,-20,30,25204,"175,145.47",59588
,20160216,13845,13895,13800,13865,13645,13695,13750,-200,-145,42812,"294,399.83",65088
,20160217,13695,13750,13700,13750,13540,13590,13640,-160,-110,48686,"332,068.36",71018
,20160218,13590,13640,13625,13685,13575,13660,13630,20,-10,41512,"282,967.67",75164
,20160219,13660,13630,13645,13985,13645,13950,13830,320,200,75892,"524,980.51",79344
,20160222,13950,13830,13985,14320,13905,14255,14155,425,325,90260,"639,013.51",84616
,20160223,14255,14155,14310,14350,14095,14175,14215,20,60,94402,"671,064.05",92924
,20160224,14175,14215,14170,14170,13905,13990,14035,-225,-180,98706,"692,762.47",100648
,20160225,13990,14035,13990,14420,13960,14155,14220,120,185,147110,"1,046,115.58",113906
,20160226,14155,14220,14195,14205,13880,14000,14025,-220,-195,176590,"1,238,753.63",124888
,20160229,14000,14025,14050,14300,14005,14115,14135,90,110,220322,"1,557,435.45",134812
,20160301,14115,14135,14255,14275,13935,14150,14120,15,-15,244808,"1,728,718.35",150584
,20160302,14150,14120,14215,14430,14120,14370,14285,250,165,395026,"2,822,351.13",173068
,20160303,14370,14285,14360,14480,14315,14420,14395,135,110,495832,"3,569,082.75",196780
,20160304,14420,14395,14490,14680,14410,14480,14505,85,110,627482,"4,552,291.35",190326
,20160307,14480,14505,14490,14785,14355,14420,14535,-85,30,1033434,"7,510,541.64",199524
,20160308,14420,14535,14485,14615,14165,14290,14355,-245,-180,850516,"6,105,854.51",181098
,20160309,14290,14355,14355,14370,13785,14090,14060,-265,-295,785172,"5,521,473.60",171398
,20160310,14090,14060,14190,14295,14030,14065,14150,5,90,566740,"4,009,938.12",179150
,20160311,14065,14150,14095,14165,13985,14160,14075,10,-75,449450,"3,163,466.36",175018
,20160314,14160,14075,14115,14335,14100,14180,14210,105,135,513666,"3,649,861.61",182740
,20160315,14180,14210,14200,14245,14025,14060,14115,-150,-95,438642,"3,096,031.06",177030
,20160316,14060,14115,13990,14075,13825,13970,13930,-145,-185,518388,"3,610,719.77",168932
,20160317,13970,13930,13930,14185,13920,14170,14060,240,130,400660,"2,817,129.42",159360
,20160318,14170,14060,14185,14595,14170,14405,14380,345,320,614274,"4,418,026.33",170160
,20160321,14405,14380,14460,14560,14290,14400,14420,20,40,448350,"3,233,671.81",166358
,20160322,14400,14420,14450,14585,14400,14440,14480,20,60,403238,"2,920,227.61",163904
,20160323,14440,14480,14445,14520,14355,14385,14425,-95,-55,293180,"2,114,864.19",151282
,20160324,14385,14425,14385,14385,14180,14200,14255,-225,-170,336172,"2,396,583.78",136934
,20160325,14200,14255,14120,14250,14060,14250,14170,-5,-85,167050,"1,183,608.14",131068
,20160328,14250,14170,14285,14350,14205,14205,14280,35,110,150100,"1,072,066.58",122722
,20160329,14205,14280,14230,14370,14080,14135,14235,-145,-45,181900,"1,294,688.69",112960
,20160330,14135,14235,14200,14240,14060,14120,14145,-115,-90,165678,"1,171,867.33",103018
,20160331,14120,14145,14110,14260,14055,14115,14145,-30,0,163664,"1,157,629.84",95844
,20160401,14115,14145,14135,14425,14130,14395,14305,250,160,148384,"1,061,511.33",85680
,20160405,14395,14305,14410,14485,14375,14400,14430,95,125,38800,"279,995.73",78676
,20160406,14400,14430,14370,14375,14185,14210,14290,-220,-140,47520,"339,630.20",71724
,20160407,14210,14290,14185,14270,14130,14155,14210,-135,-80,39628,"281,632.36",66724
,20160408,14155,14210,14030,14060,13900,13945,13975,-265,-235,48634,"339,833.93",59654
,20160411,13945,13975,13930,14180,13930,14035,14075,60,100,36914,"259,859.96",53868
,20160412,14035,14075,14020,14110,14000,14080,14050,5,-25,20308,"142,682.22",52802
,20160413,14080,14050,14195,14750,14195,14735,14575,685,525,38968,"283,979.40",49530
,20160414,14735,14575,14765,15145,14700,14820,14930,245,355,43966,"328,220.84",46986
,20160415,14820,14930,14950,14975,14715,14880,14855,-50,-75,19538,"145,133.37",44546
,20160418,14880,14855,14880,15250,14765,14960,15015,105,160,30138,"226,332.86",41374
,20160419,14960,15015,15150,15215,14895,15075,15050,60,35,23948,"180,251.79",38270
,20160420,15075,15050,15120,15240,14980,15075,15095,25,45,21014,"158,653.74",36140
,20160421,15075,15095,15125,15390,14995,15270,15150,175,55,28338,"214,712.20",33634
,20160422,15270,15150,15360,15395,14775,15010,14990,-140,-160,27992,"209,811.81",31862
,20160425,15010,14990,15055,15415,14915,15055,15125,65,135,15108,"114,268.88",31038
,20160426,15055,15125,15010,15065,14745,14745,14930,-380,-195,12314,"91,936.22",30662
,20160427,14745,14930,14885,15000,14770,14885,14915,-45,-15,11014,"82,139.28",29468
,20160428,14885,14915,14930,14975,14755,14855,14815,-60,-100,8936,"66,207.74",27428
,20160429,14855,14815,14855,15250,14855,15240,15095,425,280,6544,"49,406.54",25854
,20160503,15240,15095,15175,15280,15055,15215,15145,120,50,2574,"19,497.50",24720
,20160504,15215,15145,15100,15130,14815,14830,14935,-315,-210,3020,"22,557.40",23950
,20160505,14830,14935,14885,14945,14790,14800,14840,-135,-95,2660,"19,740.50",23700
,20160506,14800,14840,14855,14865,14650,14795,14710,-45,-130,3040,"22,363.85",23250
,20160509,14795,14710,14885,15020,14605,14670,14710,-40,0,5630,"41,418.53",21650
,20160510,14670,14710,14600,14680,14505,14630,14590,-80,-120,3540,"25,829.25",21240
,20160511,14630,14590,14670,14850,14670,14840,14735,250,145,2090,"15,402.10",21590
,20160512,14840,14735,14980,15180,14730,15100,15055,365,320,1580,"11,894.35",20460
,20160513,15100,15055,15020,15020,14800,14940,14900,-115,-155,960,"7,153.43",19720
,20160516,14940,14900,15020,15075,14995,15040,15030,140,130,1140,"8,569.50",19400
zn1606,20160104,13440,13455,13445,13445,13160,13185,13270,-270,-185,520,"3,450.39",9526
,20160105,13185,13270,13195,13360,13175,13345,13255,75,-15,1588,"10,526.69",9086
,20160106,13345,13255,13285,13285,13050,13090,13130,-165,-125,1590,"10,441.17",8476
,20160107,13090,13130,13060,13130,12865,12895,13030,-235,-100,2616,"17,047.90",8934
,20160108,12895,13030,12875,13000,12705,12900,12840,-130,-190,792,"5,084.74",8958
,20160111,12900,12840,12920,12965,12795,12855,12905,15,65,794,"5,123.78",9322
,20160112,12855,12905,12845,12880,12370,12390,12595,-515,-310,1306,"8,227.49",9644
,20160113,12390,12595,12475,12550,12400,12495,12500,-100,-95,1612,"10,076.58",10168
,20160114,12495,12500,12530,12700,12465,12670,12580,170,80,720,"4,530.13",10132
,20160115,12670,12580,12680,12900,12560,12570,12710,-10,130,974,"6,192.13",10048
,20160118,12570,12710,12505,12800,12500,12710,12645,0,-65,960,"6,069.78",10004
,20160119,12710,12645,12700,12910,12690,12880,12785,235,140,1236,"7,901.17",10474
,20160120,12880,12785,12890,12900,12710,12800,12825,15,40,1100,"7,055.73",10912
,20160121,12800,12825,12740,12785,12650,12665,12715,-160,-110,1002,"6,371.36",10984
,20160122,12665,12715,12715,12900,12680,12850,12815,135,100,782,"5,012.50",10866
,20160125,12850,12815,12910,12925,12740,12820,12810,5,-5,930,"5,958.58",10984
,20160126,12820,12810,12815,12885,12800,12860,12835,50,25,1022,"6,560.43",11284
,20160127,12860,12835,12995,13200,12950,13155,13105,320,270,2420,"15,858.59",11598
,20160128,13155,13105,13120,13155,13030,13045,13090,-60,-15,1068,"6,992.20",11370
,20160129,13045,13090,13055,13150,13000,13150,13055,60,-35,2280,"14,882.97",12218
,20160201,13150,13055,13150,13290,13100,13235,13205,180,150,1866,"12,322.73",12160
,20160202,13235,13205,13200,13415,13195,13400,13340,195,135,3098,"20,666.28",13568
,20160203,13400,13340,13465,13560,13340,13550,13465,210,125,2282,"15,367.84",13726
,20160204,13550,13465,13550,14065,13520,14010,13830,545,365,6120,"42,320.41",15082
,20160205,14010,13830,13995,14020,13770,13850,13870,20,40,3728,"25,856.51",15404
,20160215,13850,13870,13835,13995,13785,13860,13895,-10,25,5844,"40,614.75",16564
,20160216,13860,13895,13845,13875,13670,13720,13770,-175,-125,4304,"29,640.64",17162
,20160217,13720,13770,13720,13770,13560,13615,13655,-155,-115,7512,"51,290.84",17408
,20160218,13615,13655,13625,13700,13595,13685,13655,30,0,4710,"32,165.80",17896
,20160219,13685,13655,13680,14000,13675,13965,13865,310,210,13916,"96,493.79",23552
,20160222,13965,13865,13975,14330,13925,14285,14190,420,325,21010,"149,087.59",30794
,20160223,14285,14190,14315,14360,14110,14200,14220,10,30,25028,"178,008.38",37638
,20160224,14200,14220,14190,14190,13925,14010,14060,-210,-160,16804,"118,152.00",37546
,20160225,14010,14060,14015,14445,13975,14180,14260,120,200,37228,"265,485.11",43478
,20160226,14180,14260,14220,14235,13920,14040,14070,-220,-190,38060,"267,774.07",46266
,20160229,14040,14070,14100,14345,14060,14160,14190,90,120,47366,"336,123.17",52152
,20160301,14160,14190,14325,14325,13985,14205,14165,15,-25,37776,"267,552.69",52774
,20160302,14205,14165,14250,14470,14170,14435,14335,270,170,36762,"263,560.50",57410
,20160303,14435,14335,14415,14515,14360,14460,14435,125,100,41054,"296,387.11",63162
,20160304,14460,14435,14520,14720,14460,14530,14555,95,120,57144,"415,881.11",67844
,20160307,14530,14555,14560,14820,14410,14480,14575,-75,20,98068,"714,852.19",74780
,20160308,14480,14575,14530,14660,14210,14335,14395,-240,-180,84918,"611,259.06",75658
,20160309,14335,14395,14375,14405,13825,14135,14100,-260,-295,106310,"749,683.53",75242
,20160310,14135,14100,14245,14340,14075,14115,14190,15,90,85430,"606,128.48",79802
,20160311,14115,14190,14145,14210,14030,14210,14115,20,-75,68214,"481,583.28",81210
,20160314,14210,14115,14170,14365,14140,14220,14250,105,135,79552,"566,867.35",86276
,20160315,14220,14250,14245,14280,14060,14085,14150,-165,-100,71218,"503,924.99",85858
,20160316,14085,14150,14010,14105,13860,13990,13965,-160,-185,81088,"566,247.09",91140
,20160317,13990,13965,13970,14230,13960,14225,14110,260,145,79506,"561,034.49",102908
,20160318,14225,14110,14220,14640,14215,14460,14435,350,325,157068,"1,133,768.83",105486
,20160321,14460,14435,14500,14605,14325,14450,14465,15,30,121306,"877,497.77",107980
,20160322,14450,14465,14500,14625,14445,14485,14525,20,60,110236,"800,759.24",118094
,20160323,14485,14525,14465,14565,14405,14430,14470,-95,-55,96142,"695,687.44",112076
,20160324,14430,14470,14420,14430,14235,14240,14300,-230,-170,119156,"852,231.86",118704
,20160325,14240,14300,14120,14295,14080,14290,14205,-10,-95,71488,"507,746.28",117632
,20160328,14290,14205,14275,14390,14240,14255,14325,50,120,76734,"549,639.36",122954
,20160329,14255,14325,14265,14410,14125,14180,14270,-145,-55,91728,"654,616.59",127008
,20160330,14180,14270,14250,14275,14080,14140,14175,-130,-95,140428,"995,551.39",130210
,20160331,14140,14175,14140,14300,14075,14140,14170,-35,-5,153372,"1,086,845.77",133454
,20160401,14140,14170,14200,14475,14155,14445,14345,275,175,242164,"1,737,305.41",155220
,20160405,14445,14345,14485,14540,14420,14460,14475,115,130,143074,"1,035,754.74",165660
,20160406,14460,14475,14390,14410,14220,14240,14330,-235,-145,235568,"1,688,246.55",166608
,20160407,14240,14330,14200,14305,14160,14185,14240,-145,-90,235488,"1,677,223.02",158466
,20160408,14185,14240,14050,14085,13900,13955,13980,-285,-260,330896,"2,313,622.94",175514
,20160411,13955,13980,13980,14200,13965,14055,14095,75,115,307442,"2,166,808.88",178472
,20160412,14055,14095,14020,14140,14015,14115,14075,20,-20,243594,"1,714,728.38",186600
,20160413,14115,14075,14280,14775,14235,14775,14600,700,525,561464,"4,099,882.80",211782
,20160414,14775,14600,14810,15200,14740,14865,14980,265,380,779818,"5,842,205.72",207338
,20160415,14865,14980,14980,15025,14760,14925,14895,-55,-85,485822,"3,618,352.01",209612
,20160418,14925,14895,14900,15315,14815,14990,15065,95,170,713690,"5,377,616.67",222694
,20160419,14990,15065,15200,15275,14945,15140,15110,75,45,543140,"4,104,776.61",220084
,20160420,15140,15110,15170,15310,15030,15130,15160,20,50,532926,"4,040,604.09",210134
,20160421,15130,15160,15200,15460,15040,15325,15215,165,55,653826,"4,974,252.97",211608
,20160422,15325,15215,15420,15455,14825,15050,15045,-165,-170,620886,"4,671,842.95",178030
,20160425,15050,15045,15100,15500,14965,15120,15165,75,120,490190,"3,717,352.52",163432
,20160426,15120,15165,15080,15115,14775,14790,14970,-375,-195,351856,"2,634,195.16",146982
,20160427,14790,14970,14910,15060,14805,14925,14935,-45,-35,267814,"2,000,451.30",135750
,20160428,14925,14935,14985,15025,14790,14900,14870,-35,-65,275844,"2,051,575.52",123066
,20160429,14900,14870,14930,15320,14890,15290,15135,420,265,306392,"2,319,058.05",116350
,20160503,15290,15135,15205,15345,15110,15295,15215,160,80,122384,"931,303.18",108558
,20160504,15295,15215,15130,15205,14865,14880,15025,-335,-190,159056,"1,195,146.89",95374
,20160505,14880,15025,14940,15030,14845,14860,14930,-165,-95,103266,"771,048.52",88478
,20160506,14860,14930,14900,14960,14670,14820,14785,-110,-145,101408,"749,778.58",80072
,20160509,14820,14785,14820,15090,14620,14700,14825,-85,40,116084,"860,573.52",72536
,20160510,14700,14825,14730,14795,14495,14700,14625,-125,-200,68448,"500,578.11",64008
,20160511,14700,14625,14690,14905,14600,14850,14765,225,140,47672,"351,941.82",62726
,20160512,14850,14765,14990,15215,14905,15150,15065,385,300,60942,"459,167.16",59906
,20160513,15150,15065,15145,15230,14705,14985,14935,-80,-130,43446,"324,525.20",57656
,20160516,14985,14935,14975,15135,14900,15065,15040,130,105,32788,"246,570.13",56502
,20160517,15065,15040,15055,15185,14985,15140,15085,100,45,19456,"146,769.22",55104
,20160518,15140,15085,15065,15225,14920,14980,15055,-105,-30,22252,"167,539.75",53316
,20160519,14980,15055,14980,15060,14870,14925,14970,-130,-85,21470,"160,752.39",50700
,20160520,14925,14970,14815,14990,14770,14975,14885,5,-85,17188,"127,953.29",52030
,20160523,14975,14885,15025,15140,14715,14780,14880,-105,-5,21772,"162,017.38",49350
,20160524,14780,14880,14755,14810,14390,14435,14625,-445,-255,20656,"151,061.89",47752
,20160525,14435,14625,14485,14670,14470,14475,14545,-150,-80,22274,"162,031.56",44434
,20160526,14475,14545,14535,14900,14535,14870,14680,325,135,15042,"110,431.47",42298
,20160527,14870,14680,14890,15000,14770,14980,14900,300,220,10984,"81,847.72",41228
,20160530,14980,14900,15025,15050,14920,14985,14975,85,75,8188,"61,318.41",39776
,20160531,14985,14975,15000,15075,14885,15030,15000,55,25,8182,"61,372.44",37944
,20160601,15030,15000,15105,15105,14870,14880,14990,-120,-10,3494,"26,191.94",36740
,20160602,14880,14990,14890,15570,14890,15480,15410,490,420,12580,"96,958.40",36600
,20160603,15480,15410,15480,15525,15290,15510,15400,100,-10,4680,"36,042.75",36960
,20160606,15510,15400,15630,15760,15495,15665,15660,265,260,3220,"25,220.10",36830
,20160607,15665,15660,15695,15735,15550,15660,15610,0,-50,2750,"21,465.85",36840
,20160608,15660,15610,15580,15580,15410,15490,15470,-120,-140,2310,"17,873.00",36560
,20160613,15490,15470,15675,15950,15675,15830,15735,360,265,1960,"15,422.13",35710
,20160614,15830,15735,15705,15815,15590,15590,15700,-145,-35,3030,"23,788.83",35290
,20160615,15590,15700,15630,15630,15470,15595,15550,-105,-150,960,"7,465.28",35230
zn1607,20160104,13465,13470,13405,13405,13185,13255,13285,-215,-185,38,252.43,1034
,20160105,13255,13285,13230,13330,13230,13330,13280,45,-5,248,"1,646.80",940
,20160106,13330,13280,13235,13235,13065,13070,13100,-210,-180,108,707.60,978
,20160107,13070,13100,13115,13115,12925,12925,12955,-175,-145,44,285.07,986
,20160108,12925,12955,12760,12935,12760,12935,12900,-20,-55,170,"1,096.54",1068
,20160111,12935,12900,12945,12965,12800,12925,12930,25,30,162,"1,047.52",1120
,20160112,12925,12930,12745,12745,12400,12400,12595,-530,-335,282,"1,776.30",1202
,20160113,12400,12595,12475,12545,12460,12525,12520,-70,-75,62,388.15,1188
,20160114,12525,12520,12530,12715,12475,12655,12630,135,110,148,934.92,1164
,20160115,12655,12630,12680,12815,12600,12600,12690,-30,60,160,"1,015.57",1206
,20160118,12600,12690,12575,12750,12575,12740,12675,50,-15,146,925.35,1306
,20160119,12740,12675,12805,12850,12695,12840,12745,165,70,58,369.62,1320
,20160120,12840,12745,12895,12910,12735,12785,12860,40,115,174,"1,119.25",1436
,20160121,12785,12860,12735,12770,12735,12770,12755,-90,-105,10,63.78,1438
,20160122,12770,12755,12740,12910,12740,12865,12855,110,100,124,797.19,1404
,20160125,12865,12855,12860,12885,12790,12825,12835,-30,-20,222,"1,424.71",1540
,20160126,12825,12835,12890,12890,12850,12865,12865,30,30,206,"1,325.29",1652
,20160127,12865,12865,12975,13215,12975,13180,13110,315,245,1152,"7,552.87",2454
,20160128,13180,13110,13180,13180,13060,13065,13130,-45,20,122,801.11,2480
,20160129,13065,13130,12475,13165,12475,13165,13055,35,-75,432,"2,820.77",2224
,20160201,13165,13055,13170,13270,13115,13165,13240,110,185,154,"1,019.59",2134
,20160202,13165,13240,13270,13430,13235,13420,13360,180,120,132,882.01,2174
,20160203,13420,13360,13495,13820,13390,13575,13475,215,115,1002,"6,753.11",2590
,20160204,13575,13475,13565,14090,13565,14065,13815,590,340,586,"4,048.77",2606
,20160205,14065,13815,14005,14035,13790,13860,13840,45,25,942,"6,520.68",3014
,20160215,13860,13840,13860,14020,13850,13900,13920,60,80,300,"2,088.62",2986
,20160216,13900,13920,13840,13900,13700,13705,13780,-215,-140,222,"1,529.99",2998
,20160217,13705,13780,13750,13785,13580,13630,13630,-150,-150,292,"1,990.24",3024
,20160218,13630,13630,13680,13705,13630,13690,13670,60,40,248,"1,695.43",2994
,20160219,13690,13670,13695,14010,13695,13980,13925,310,255,1524,"10,613.58",3614
,20160222,13980,13925,13990,14335,13960,14280,14205,355,280,2306,"16,378.81",4714
,20160223,14280,14205,14345,14380,14140,14235,14230,30,25,1690,"12,027.70",4762
,20160224,14235,14230,14180,14180,13955,14005,14040,-225,-190,780,"5,476.37",5022
,20160225,14005,14040,14025,14460,14000,14195,14350,155,310,2216,"15,900.03",5930
,20160226,14195,14350,14245,14260,13975,14125,14095,-225,-255,1274,"8,980.96",6320
,20160229,14125,14095,14165,14370,14100,14200,14235,105,140,3062,"21,801.27",6592
,20160301,14200,14235,14345,14370,14030,14245,14210,10,-25,1768,"12,562.36",6464
,20160302,14245,14210,14305,14490,14205,14470,14375,260,165,2842,"20,432.26",7852
,20160303,14470,14375,14445,14535,14400,14505,14465,130,90,2206,"15,958.65",8196
,20160304,14505,14465,14555,14750,14500,14580,14575,115,110,2508,"18,279.88",8750
,20160307,14580,14575,14580,14855,14445,14505,14640,-70,65,5532,"40,499.56",10574
,20160308,14505,14640,14540,14690,14235,14340,14440,-300,-200,3608,"26,057.06",10382
,20160309,14340,14440,14365,14430,13860,14125,14145,-315,-295,5308,"37,542.14",11486
,20160310,14125,14145,14235,14365,14105,14140,14210,-5,65,3204,"22,767.83",11770
,20160311,14140,14210,14140,14240,14065,14240,14150,30,-60,2240,"15,850.52",11932
,20160314,14240,14150,14235,14390,14180,14250,14285,100,135,3728,"26,630.86",12094
,20160315,14250,14285,14250,14305,14100,14115,14170,-170,-115,3190,"22,603.42",12402
,20160316,14115,14170,14085,14135,13900,14025,14005,-145,-165,3448,"24,151.94",12786
,20160317,14025,14005,13995,14255,13955,14255,14160,250,155,3374,"23,892.10",13738
,20160318,14255,14160,14255,14660,14245,14480,14480,320,320,7306,"52,905.59",15524
,20160321,14480,14480,14505,14630,14360,14485,14505,5,25,12642,"91,686.42",16996
,20160322,14485,14505,14510,14650,14480,14520,14555,15,50,9618,"70,015.73",18192
,20160323,14520,14555,14520,14590,14435,14455,14505,-100,-50,12288,"89,139.86",17650
,20160324,14455,14505,14435,14450,14255,14270,14325,-235,-180,16828,"120,539.39",21802
,20160325,14270,14325,14235,14315,14135,14315,14235,-10,-90,7946,"56,569.24",21460
,20160328,14315,14235,14315,14410,14270,14280,14340,45,105,8112,"58,183.04",21790
,20160329,14280,14340,14280,14430,14145,14200,14275,-140,-65,12180,"86,960.37",24242
,20160330,14200,14275,14200,14290,14105,14165,14190,-110,-85,13166,"93,428.29",24092
,20160331,14165,14190,14165,14305,14095,14145,14180,-45,-10,17058,"120,949.54",27202
,20160401,14145,14180,14175,14485,14165,14460,14365,280,185,21156,"151,997.03",29832
,20160405,14460,14365,14400,14550,14400,14475,14495,110,130,15134,"109,688.92",32546
,20160406,14475,14495,14380,14430,14230,14245,14330,-250,-165,24230,"173,668.37",37430
,20160407,14245,14330,14200,14570,14170,14205,14260,-125,-70,28180,"200,987.35",37384
,20160408,14205,14260,14110,14110,13910,13965,13995,-295,-265,41032,"287,172.02",44532
,20160411,13965,13995,13950,14205,13950,14065,14100,70,105,38948,"274,660.90",45270
,20160412,14065,14100,14030,14150,14025,14130,14085,30,-15,38000,"267,697.61",47576
,20160413,14130,14085,14250,14785,14250,14785,14610,700,525,98936,"722,931.82",58796
,20160414,14785,14610,14805,15200,14760,14885,14995,275,385,136886,"1,026,600.87",65382
,20160415,14885,14995,15000,15035,14780,14940,14905,-55,-90,83018,"618,820.34",69966
,20160418,14940,14905,14905,15320,14835,15015,15090,110,185,125794,"949,159.70",80032
,20160419,15015,15090,15245,15290,14980,15165,15135,75,45,120436,"911,482.67",89826
,20160420,15165,15135,15200,15345,15080,15170,15205,35,70,140028,"1,064,617.96",99494
,20160421,15170,15205,15270,15485,15090,15345,15250,140,45,179884,"1,372,023.22",109170
,20160422,15345,15250,15445,15490,14870,15080,15085,-170,-165,199030,"1,501,320.15",99604
,20160425,15080,15085,15135,15530,15010,15145,15215,60,130,185474,"1,411,198.28",103714
,20160426,15145,15215,15105,15140,14830,14835,15000,-380,-215,157254,"1,179,731.13",109620
,20160427,14835,15000,14930,15095,14845,14965,14975,-35,-25,128926,"965,596.18",119284
,20160428,14965,14975,15010,15070,14830,14935,14910,-40,-65,134122,"1,000,083.14",119276
,20160429,14935,14910,14935,15360,14935,15350,15185,440,275,196868,"1,494,838.79",145086
,20160503,15350,15185,15250,15390,15155,15345,15260,160,75,116524,"889,250.46",150620
,20160504,15345,15260,15180,15260,14900,14925,15065,-335,-195,213356,"1,607,394.04",145928
,20160505,14925,15065,14960,15080,14885,14900,14975,-165,-90,303390,"2,271,975.96",158154
,20160506,14900,14975,14955,15010,14715,14865,14825,-110,-150,395974,"2,935,544.04",164638
,20160509,14865,14825,14850,15135,14650,14745,14875,-80,50,549774,"4,089,446.23",182614
,20160510,14745,14875,14780,14795,14515,14715,14645,-160,-230,382792,"2,803,833.97",168902
,20160511,14715,14645,14700,14935,14630,14905,14785,260,140,378172,"2,796,458.61",177578
,20160512,14905,14785,15030,15260,14940,15180,15105,395,320,488800,"3,692,249.14",189886
,20160513,15180,15105,15180,15275,14730,15020,14975,-85,-130,575576,"4,311,007.62",182376
,20160516,15020,14975,14950,15170,14925,15105,15070,130,95,433922,"3,270,504.28",196174
,20160517,15105,15070,15060,15220,15005,15190,15125,120,55,327140,"2,474,193.58",192568
,20160518,15190,15125,15115,15270,14955,15005,15100,-120,-25,379444,"2,865,465.82",174598
,20160519,15005,15100,14990,15095,14905,14945,15005,-155,-95,296070,"2,221,411.57",166442
,20160520,14945,15005,14865,15030,14805,15010,14920,5,-85,249428,"1,860,758.53",161664
,20160523,15010,14920,15070,15150,14740,14825,14920,-95,0,386476,"2,883,454.78",154576
,20160524,14825,14920,14775,14850,14445,14465,14645,-455,-275,486502,"3,563,557.28",175038
,20160525,14465,14645,14595,14700,14490,14525,14575,-120,-70,405952,"2,958,711.71",167378
,20160526,14525,14575,14630,14955,14575,14920,14715,345,140,391056,"2,877,561.13",152090
,20160527,14920,14715,14950,15050,14810,15005,14935,290,220,350080,"2,614,448.18",141640
,20160530,15005,14935,15070,15095,14950,15045,15015,110,80,231786,"1,740,551.61",131122
,20160531,15045,15015,15060,15130,14920,15095,15040,80,25,193010,"1,451,475.96",117952
,20160601,15095,15040,15180,15180,14900,14940,15045,-100,5,154168,"1,159,897.84",103664
,20160602,14940,15045,14970,15735,14910,15530,15370,485,325,230620,"1,772,720.19",94712
,20160603,15530,15370,15530,15590,15330,15550,15475,180,105,88306,"683,290.68",87408
,20160606,15550,15475,15650,15840,15535,15690,15700,215,225,77984,"612,184.35",81228
,20160607,15690,15700,15745,15830,15595,15700,15705,0,5,64152,"503,888.51",78484
,20160608,15700,15705,15665,15685,15435,15570,15525,-135,-180,55906,"434,053.67",71986
,20160613,15570,15525,15815,16020,15710,15795,15835,270,310,40430,"320,105.15",70034
,20160614,15795,15835,15845,15920,15650,15675,15785,-160,-50,30630,"241,792.65",64878
,20160615,15675,15785,15615,15685,15515,15685,15590,-100,-195,24756,"192,988.18",61020
,20160616,15685,15590,15775,15825,15500,15540,15640,-50,50,22720,"177,717.52",57786
,20160617,15540,15640,15540,15645,15340,15615,15480,-25,-160,25636,"198,483.24",53088
,20160620,15615,15480,15515,15625,15420,15550,15530,70,50,16804,"130,522.08",51528
,20160621,15550,15530,15550,15750,15510,15590,15645,60,115,21136,"165,357.16",45290
,20160622,15590,15645,15570,15765,15490,15710,15625,65,-20,14768,"115,409.90",42910
,20160623,15710,15625,15745,15795,15650,15760,15710,135,85,11212,"88,089.12",40622
,20160624,15760,15710,15750,15775,15420,15430,15565,-280,-145,17506,"136,243.55",37912
,20160627,15430,15565,15465,15680,15460,15640,15585,75,20,16140,"125,801.09",34686
,20160628,15640,15585,15590,15895,15510,15885,15660,300,75,16094,"126,024.73",32070
,20160629,15885,15660,16010,16295,15775,16140,16090,480,430,17058,"137,248.70",29512
,20160630,16140,16090,16065,16420,16055,16370,16295,280,205,11392,"92,837.00",26550
,20160701,16370,16295,16420,16490,16220,16460,16345,165,50,2960,"24,192.13",26850
,20160704,16460,16345,16495,16945,16495,16650,16700,305,355,3450,"28,809.30",26600
,20160705,16650,16700,16615,16650,16230,16340,16365,-360,-335,3430,"28,072.45",25410
,20160706,16340,16365,16475,16495,16155,16320,16290,-45,-75,3050,"24,849.80",24270
,20160707,16320,16290,16060,16460,16055,16270,16360,-20,70,3740,"30,598.45",22990
,20160708,16270,16360,16270,16400,16180,16355,16285,-5,-75,4500,"36,641.25",22000
,20160711,16355,16285,16560,16700,16400,16685,16535,400,250,2700,"22,322.90",21940
,20160712,16685,16535,16690,16715,16570,16640,16625,105,90,3390,"28,179.68",21490
,20160713,16640,16625,16855,17110,16790,17055,16920,430,295,1580,"13,366.80",21130
,20160714,17055,16920,16795,16840,16570,16840,16745,-80,-175,1760,"14,739.95",21440
,20160715,16840,16745,16670,16900,16670,16890,16820,145,75,1140,"9,587.70",21260
zn1608,20160104,13485,13445,13245,13275,13245,13275,13260,-170,-185,14,92.84,506
,20160105,13275,13260,13225,13340,13225,13340,13295,80,35,28,186.13,510
,20160106,13340,13295,13210,13210,13060,13110,13120,-185,-175,26,170.62,512
,20160107,13110,13120,13135,13135,13025,13025,13105,-95,-15,8,52.42,514
,20160108,13025,13105,12835,12995,12730,12995,12805,-110,-300,32,204.94,520
,20160111,12995,12805,12950,13000,12830,12940,12930,135,125,50,323.33,528
,20160112,12940,12930,12645,12665,12580,12640,12620,-290,-310,34,214.62,534
,20160113,12640,12620,12485,12585,12485,12545,12550,-75,-70,60,376.56,542
,20160114,12545,12550,12575,12735,12475,12680,12685,130,135,66,418.69,554
,20160115,12680,12685,12715,12855,12715,12720,12795,35,110,50,319.92,558
,20160118,12720,12795,12595,12820,12595,12795,12730,0,-65,42,267.33,560
,20160119,12795,12730,12845,12900,12735,12900,12795,170,65,80,511.93,608
,20160120,12900,12795,12920,12945,12770,12835,12850,40,55,58,372.73,646
,20160121,12835,12850,12805,12840,12695,12815,12785,-35,-65,48,306.86,670
,20160122,12815,12785,12745,12900,12745,12895,12870,110,85,38,244.55,666
,20160125,12895,12870,12915,12950,12760,12865,12850,-5,-20,86,552.56,706
,20160126,12865,12850,12875,12895,12850,12850,12880,0,30,40,257.67,722
,20160127,12850,12880,13010,13210,13010,13175,13135,295,255,28,183.94,722
,20160128,13175,13135,13150,13170,13120,13160,13145,25,10,28,184.06,726
,20160129,13160,13145,13125,13150,13030,13150,13115,5,-30,14,91.83,722
,20160201,13150,13115,13200,13300,13110,13110,13210,-5,95,12,79.29,720
,20160202,13110,13210,13275,13410,13275,13370,13355,160,145,8,53.43,720
,20160203,13370,13355,13480,13605,13435,13605,13480,250,125,26,175.29,716
,20160204,13605,13480,13650,14050,13650,14010,13960,530,480,92,642.29,720
,20160205,14010,13960,14025,14030,13865,13895,13915,-65,-45,64,445.41,718
,20160215,13895,13915,13945,13995,13860,13985,13935,70,20,14,97.56,718
,20160216,13985,13935,13835,13845,13705,13705,13795,-230,-140,34,234.52,728
,20160217,13705,13795,13800,13800,13600,13650,13680,-145,-115,14,95.79,730
,20160218,13650,13680,13695,13695,13680,13680,13680,0,0,12,82.11,726
,20160219,13680,13680,13755,14025,13755,14015,13905,335,225,120,834.51,734
,20160222,14015,13905,14005,14340,13965,14280,14215,375,310,158,"1,123.28",724
,20160223,14280,14215,14385,14385,14165,14235,14275,20,60,24,171.30,732
,20160224,14235,14275,14075,14270,13965,14050,14060,-225,-215,54,379.70,710
,20160225,14050,14060,14050,14460,14050,14260,14380,200,320,260,"1,869.72",748
,20160226,14260,14380,14270,14290,14030,14145,14135,-235,-245,122,862.25,818
,20160229,14145,14135,14180,14390,14160,14160,14280,25,145,232,"1,657.03",936
,20160301,14160,14280,14280,14315,14085,14220,14220,-60,-60,96,682.67,922
,20160302,14220,14220,14300,14500,14240,14500,14380,280,160,262,"1,884.34",1038
,20160303,14500,14380,14475,14550,14430,14550,14485,170,105,122,883.78,1096
,20160304,14550,14485,14575,14755,14510,14595,14630,110,145,198,"1,448.68",1198
,20160307,14595,14630,14580,14865,14440,14520,14580,-110,-50,370,"2,698.21",1238
,20160308,14520,14580,14500,14715,14300,14380,14445,-200,-135,330,"2,383.49",1414
,20160309,14380,14445,14450,14450,13895,14150,14160,-295,-285,360,"2,549.57",1300
,20160310,14150,14160,14310,14380,14145,14170,14270,10,110,198,"1,413.08",1348
,20160311,14170,14270,14175,14260,14100,14250,14175,-20,-95,214,"1,517.17",1476
,20160314,14250,14175,14225,14420,14200,14315,14315,140,140,226,"1,618.15",1486
,20160315,14315,14315,14225,14225,14150,14150,14200,-165,-115,98,695.93,1448
,20160316,14150,14200,14100,14150,13930,14060,14035,-140,-165,290,"2,035.73",1526
,20160317,14060,14035,14025,14270,14025,14270,14175,235,140,108,765.58,1520
,20160318,14270,14175,14300,14665,14300,14550,14475,375,300,824,"5,965.52",1934
,20160321,14550,14475,14500,14655,14440,14515,14550,40,75,446,"3,245.21",2004
,20160322,14515,14550,14535,14680,14505,14590,14580,40,30,608,"4,432.60",2218
,20160323,14590,14580,14505,14600,14475,14480,14515,-100,-65,304,"2,206.64",2156
,20160324,14480,14515,14435,14450,14280,14280,14350,-235,-165,888,"6,371.50",2490
,20160325,14280,14350,14190,14330,14190,14330,14280,-20,-70,352,"2,513.40",2534
,20160328,14330,14280,14365,14415,14300,14300,14375,20,95,356,"2,558.86",2656
,20160329,14300,14375,14340,14420,14150,14200,14290,-175,-85,820,"5,859.69",2720
,20160330,14200,14290,14255,14315,14125,14185,14215,-105,-75,968,"6,881.31",2756
,20160331,14185,14215,14190,14310,14110,14155,14170,-60,-45,798,"5,655.38",2980
,20160401,14155,14170,14225,14495,14200,14455,14405,285,235,756,"5,446.92",3218
,20160405,14455,14405,14480,14550,14450,14510,14495,105,90,1414,"10,248.92",3526
,20160406,14510,14495,14400,14450,14240,14255,14370,-240,-125,1598,"11,484.45",3798
,20160407,14255,14370,14235,14320,14200,14215,14270,-155,-100,1098,"7,835.88",3956
,20160408,14215,14270,14190,14190,13920,13980,14005,-290,-265,2468,"17,284.81",4954
,20160411,13980,14005,13985,14220,13985,14075,14110,70,105,1760,"12,417.19",5344
,20160412,14075,14110,14050,14145,14050,14140,14095,30,-15,816,"5,751.31",5468
,20160413,14140,14095,14280,14795,14270,14795,14665,700,570,7190,"52,721.61",8272
,20160414,14795,14665,14860,15210,14770,14900,15005,235,340,8156,"61,200.51",9848
,20160415,14900,15005,15010,15040,14785,14940,14900,-65,-105,4712,"35,109.76",9704
,20160418,14940,14900,14930,15335,14850,15035,15095,135,195,8828,"66,647.91",10506
,20160419,15035,15095,15240,15295,14990,15170,15155,75,60,8772,"66,485.81",12436
,20160420,15170,15155,15225,15355,15100,15200,15230,45,75,13518,"102,950.29",15296
,20160421,15200,15230,15265,15490,15110,15370,15295,140,65,21642,"165,549.52",18740
,20160422,15370,15295,15425,15500,14895,15095,15100,-200,-195,17780,"134,279.74",16866
,20160425,15095,15100,15005,15540,15005,15160,15280,60,180,23078,"176,342.91",22300
,20160426,15160,15280,15145,15165,14860,14860,15000,-420,-280,24078,"180,641.55",23254
,20160427,14860,15000,14950,15120,14875,14990,14995,-10,-5,15878,"119,076.07",23214
,20160428,14990,14995,15005,15085,14855,14965,14930,-30,-65,23364,"174,419.31",20536
,20160429,14965,14930,14970,15380,14970,15355,15215,425,285,28602,"217,624.83",24604
,20160503,15355,15215,15325,15410,15175,15375,15280,160,65,18008,"137,596.37",26308
,20160504,15375,15280,15240,15325,14940,14950,15100,-330,-180,29840,"225,292.49",27426
,20160505,14950,15100,14960,15110,14900,14925,14980,-175,-120,40276,"301,748.72",34684
,20160506,14925,14980,14970,15025,14735,14895,14845,-85,-135,44464,"330,103.82",37232
,20160509,14895,14845,14895,15155,14670,14745,14900,-100,55,78202,"582,666.12",49022
,20160510,14745,14900,14800,14820,14525,14735,14670,-165,-230,50174,"368,137.31",50448
,20160511,14735,14670,14720,14945,14645,14905,14800,235,130,39620,"293,271.99",53366
,20160512,14905,14800,15050,15270,14955,15200,15115,400,315,70660,"534,187.04",51902
,20160513,15200,15115,15195,15285,14760,15035,15000,-80,-115,101324,"760,034.50",53102
,20160516,15035,15000,14985,15180,14935,15120,15080,120,80,66730,"503,301.68",53860
,20160517,15120,15080,15065,15235,15030,15205,15140,125,60,60774,"460,175.39",58804
,20160518,15205,15140,15140,15280,14995,15025,15115,-115,-25,77190,"583,513.63",61196
,20160519,15025,15115,15035,15125,14935,14975,15030,-140,-85,70276,"528,181.34",65976
,20160520,14975,15030,14895,15055,14835,15035,14945,5,-85,64738,"483,797.22",73020
,20160523,15035,14945,15100,15175,14760,14845,14955,-100,10,104292,"779,948.00",76170
,20160524,14845,14955,14800,14880,14480,14500,14680,-455,-275,125180,"919,083.21",85124
,20160525,14500,14680,14610,14725,14525,14550,14600,-130,-80,102406,"747,749.25",90168
,20160526,14550,14600,14650,14980,14610,14950,14750,350,150,137162,"1,011,911.71",97064
,20160527,14950,14750,15000,15080,14835,15030,14960,280,210,122436,"916,108.85",107588
,20160530,15030,14960,15085,15100,14970,15060,15035,100,75,100686,"756,994.97",117398
,20160531,15060,15035,15075,15165,14945,15110,15075,75,40,112628,"849,146.34",118944
,20160601,15110,15075,15185,15205,14920,14970,15065,-105,-10,177388,"1,336,441.82",131056
,20160602,14970,15065,15000,15690,14935,15580,15445,515,380,657278,"5,076,510.62",217180
,20160603,15580,15445,15580,15630,15365,15590,15515,145,70,418406,"3,246,813.44",211698
,20160606,15590,15515,15700,15890,15580,15750,15740,235,225,461252,"3,630,294.26",226948
,20160607,15750,15740,15800,15870,15630,15755,15755,15,15,343848,"2,708,881.58",231406
,20160608,15755,15755,15705,15735,15475,15625,15570,-130,-185,385858,"3,004,518.12",218614
,20160613,15625,15570,15890,16070,15760,15860,15895,290,325,284918,"2,264,853.71",230354
,20160614,15860,15895,15895,15980,15690,15705,15840,-190,-55,337120,"2,670,148.99",227986
,20160615,15705,15840,15650,15730,15555,15725,15640,-115,-200,323680,"2,531,452.92",213030
,20160616,15725,15640,15830,15875,15540,15595,15690,-45,50,302736,"2,375,669.07",206594
,20160617,15595,15690,15590,15690,15380,15645,15530,-45,-160,318696,"2,474,957.21",197624
,20160620,15645,15530,15530,15665,15460,15590,15560,60,30,278240,"2,165,295.41",191632
,20160621,15590,15560,15600,15795,15550,15655,15695,95,135,285762,"2,242,877.35",186582
,20160622,15655,15695,15600,15810,15535,15770,15695,75,0,292744,"2,297,512.64",189214
,20160623,15770,15695,15810,15850,15690,15790,15765,95,70,217906,"1,718,088.60",185074
,20160624,15790,15765,15765,15820,15460,15495,15635,-270,-130,323172,"2,526,900.93",163300
,20160627,15495,15635,15525,15730,15500,15685,15630,50,-5,263356,"2,058,193.24",159694
,20160628,15685,15630,15620,15945,15550,15900,15735,270,105,351896,"2,768,608.73",161226
,20160629,15900,15735,16010,16345,15975,16210,16155,475,420,417438,"3,371,925.16",157604
,20160630,16210,16155,16170,16485,16105,16410,16320,255,165,294688,"2,404,672.89",143958
,20160701,16410,16320,16410,16530,16265,16485,16405,165,85,211980,"1,739,044.81",129290
,20160704,16485,16405,16510,16940,16490,16720,16730,315,325,184110,"1,540,408.05",112070
,20160705,16720,16730,16720,16720,16280,16410,16450,-320,-280,117178,"964,049.27",99018
,20160706,16410,16450,16500,16565,16230,16360,16375,-90,-75,104750,"857,829.33",88684
,20160707,16360,16375,16200,16545,16095,16330,16365,-45,-10,71084,"581,705.85",84110
,20160708,16330,16365,16390,16455,16215,16420,16340,55,-25,58784,"480,342.60",80550
,20160711,16420,16340,16510,16780,16440,16745,16595,405,255,51812,"430,003.30",77036
,20160712,16745,16595,16750,16815,16605,16725,16690,130,95,32360,"270,059.36",72450
,20160713,16725,16690,16905,17145,16810,16870,16980,180,290,44432,"377,234.44",67508
,20160714,16870,16980,16925,16945,16745,16940,16845,-40,-135,22530,"189,795.73",65000
,20160715,16940,16845,16955,17070,16810,17035,16920,190,75,21562,"182,446.64",63584
,20160718,17035,16920,17120,17205,16795,16855,16990,-65,70,27088,"230,141.91",59368
,20160719,16855,16990,16945,17285,16900,17220,17095,230,105,26570,"227,118.74",58336
,20160720,17220,17095,17280,17280,17055,17150,17155,55,60,14696,"126,074.56",56886
,20160721,17150,17155,17010,17330,16950,17330,17150,175,-5,17476,"149,871.76",54692
,20160722,17330,17150,17335,17495,17210,17240,17330,90,180,22112,"191,601.29",51440
,20160725,17240,17330,17250,17385,17080,17385,17250,55,-80,19742,"170,310.27",48022
,20160726,17385,17250,17385,17385,17030,17080,17170,-170,-80,19010,"163,238.09",43510
,20160727,17080,17170,17095,17150,16860,16910,17000,-260,-170,17082,"145,227.22",38782
,20160728,16910,17000,16890,16950,16665,16805,16790,-195,-210,16492,"138,460.05",32500
,20160729,16805,16790,16805,17000,16770,16800,16870,10,80,11800,"99,533.77",27020
,20160801,16800,16870,16900,17315,16810,17295,17125,425,255,5980,"51,212.68",24740
,20160802,17295,17125,17295,17320,17190,17320,17260,195,135,3530,"30,472.33",25160
,20160803,17320,17260,17375,17425,17150,17195,17240,-65,-20,3650,"31,471.10",23250
,20160804,17195,17240,17240,17320,17130,17200,17245,-40,5,3580,"30,869.38",21890
,20160805,17200,17245,17170,17340,17145,17335,17255,90,10,3310,"28,559.55",20510
,20160808,17335,17255,17275,17420,17260,17410,17350,155,95,2680,"23,250.13",18640
,20160809,17410,17350,17400,17400,17210,17210,17285,-140,-65,3180,"27,488.80",16240
,20160810,17210,17285,17235,17630,17210,17615,17390,330,105,3980,"34,608.18",15360
,20160811,17615,17390,17615,17655,17500,17530,17540,140,150,1960,"17,192.50",13900
,20160812,17530,17540,17480,17585,17400,17400,17445,-140,-95,1410,"12,301.65",13280
,20160815,17400,17445,17300,17300,17080,17105,17180,-340,-265,910,"7,818.83",12860
zn1609,20160104,13505,13500,13295,13295,13280,13280,13290,-220,-210,10,66.46,412
,20160105,13280,13290,13255,13425,13255,13365,13330,75,40,42,280.00,406
,20160106,13365,13330,13315,13315,13100,13115,13150,-215,-180,82,539.28,440
,20160107,13115,13150,13140,13140,12930,12930,12965,-220,-185,98,635.33,500
,20160108,12930,12965,12850,12970,12765,12970,12825,5,-140,130,833.78,536
,20160111,12970,12825,12975,12975,12930,12960,12950,135,125,12,77.70,540
,20160112,12960,12950,12830,12830,12315,12315,12555,-635,-395,274,"1,720.14",498
,20160113,12315,12555,12455,12570,12420,12530,12525,-25,-30,128,801.67,458
,20160114,12530,12525,12580,12735,12580,12700,12715,175,190,188,"1,195.50",408
,20160115,12700,12715,12720,12830,12645,12645,12710,-70,-5,144,915.13,470
,20160118,12645,12710,12560,13345,12400,12820,12755,110,45,422,"2,691.83",578
,20160119,12820,12755,12815,13390,12750,12920,12895,165,140,468,"3,018.21",564
,20160120,12920,12895,12985,12985,12820,12820,12865,-75,-30,46,295.90,568
,20160121,12820,12865,12740,12830,12740,12830,12815,-35,-50,12,76.89,576
,20160122,12830,12815,12785,12930,12785,12905,12850,90,35,106,681.31,606
,20160125,12905,12850,12965,12965,12840,12860,12875,10,25,172,"1,107.53",628
,20160126,12860,12875,12885,12915,12870,12870,12890,-5,15,88,567.33,644
,20160127,12870,12890,13030,13235,13010,13180,13105,290,215,122,799.55,620
,20160128,13180,13105,13200,13285,13060,13060,13170,-45,65,124,816.58,654
,20160129,13060,13170,13105,13165,13005,13155,13070,-15,-100,94,614.50,674
,20160201,13155,13070,13210,13300,13165,13195,13225,125,155,38,251.33,656
,20160202,13195,13225,13290,13465,13290,13465,13390,240,165,20,133.93,648
,20160203,13465,13390,13450,13585,13415,13585,13450,195,60,82,551.54,664
,20160204,13585,13450,13510,14105,13510,14090,14005,640,555,312,"2,185.37",594
,20160205,14090,14005,14015,14050,13820,13890,13970,-115,-35,124,866.18,564
,20160215,13890,13970,13960,14020,13920,13930,13950,-40,-20,42,293.01,548
,20160216,13930,13950,13830,13920,13750,13775,13810,-175,-140,108,745.96,612
,20160217,13775,13810,13675,13680,13615,13670,13645,-140,-165,26,177.42,610
,20160218,13670,13645,13710,13750,13705,13705,13720,60,75,6,41.17,610
,20160219,13705,13720,13890,14025,13830,14025,13930,305,210,70,487.59,624
,20160222,14025,13930,14060,14370,13995,14345,14255,415,325,76,541.87,648
,20160223,14345,14255,14330,14465,14200,14200,14330,-55,75,52,372.62,638
,20160224,14200,14330,14110,14185,14000,14035,14055,-295,-275,56,393.59,620
,20160225,14035,14055,14080,14435,14080,14260,14330,205,275,44,315.35,618
,20160226,14260,14330,14250,14300,14025,14200,14130,-130,-200,90,635.95,618
,20160229,14200,14130,14520,14520,14105,14280,14295,150,165,350,"2,502.38",780
,20160301,14280,14295,14335,14350,14110,14300,14285,5,-10,102,728.61,788
,20160302,14300,14285,14325,14510,14260,14505,14380,220,95,260,"1,869.53",930
,20160303,14505,14380,14490,14555,14425,14450,14490,70,110,350,"2,536.53",1090
,20160304,14450,14490,14555,14775,14505,14640,14645,150,155,500,"3,661.98",1278
,20160307,14640,14645,14620,14955,14395,14560,14595,-85,-50,1048,"7,650.22",1220
,20160308,14560,14595,14625,14735,14320,14375,14455,-220,-140,758,"5,479.78",1184
,20160309,14375,14455,14435,14435,13900,14210,14120,-245,-335,754,"5,324.69",1218
,20160310,14210,14120,14320,14380,14160,14215,14200,95,80,328,"2,328.93",1190
,20160311,14215,14200,14195,14270,14120,14270,14205,70,5,516,"3,665.70",1148
,20160314,14270,14205,14305,14445,14240,14285,14340,80,135,362,"2,595.89",1082
,20160315,14285,14340,14335,14335,14130,14145,14210,-195,-130,160,"1,137.14",1096
,20160316,14145,14210,14140,14140,13940,14070,14005,-140,-205,284,"1,989.36",1110
,20160317,14070,14005,14110,14295,14080,14280,14175,275,170,280,"1,984.69",1066
,20160318,14280,14175,14395,14695,14305,14590,14540,415,365,864,"6,283.29",1478
,20160321,14590,14540,14490,14655,14415,14520,14520,-20,-20,858,"6,230.24",1514
,20160322,14520,14520,14560,14670,14505,14540,14580,20,60,184,"1,341.48",1440
,20160323,14540,14580,14515,14575,14480,14515,14515,-65,-65,802,"5,820.62",1180
,20160324,14515,14515,14450,14450,14300,14300,14350,-215,-165,322,"2,311.08",1066
,20160325,14300,14350,14250,14350,14230,14335,14290,-15,-60,66,471.57,1092
,20160328,14335,14290,14490,14490,14285,14315,14375,25,85,264,"1,897.51",1194
,20160329,14315,14375,14440,14450,14230,14245,14385,-130,10,308,"2,215.31",1136
,20160330,14245,14385,14280,14310,14115,14175,14225,-210,-160,722,"5,136.02",1302
,20160331,14175,14225,14170,14320,14095,14185,14195,-40,-30,322,"2,285.42",1444
,20160401,14185,14195,14220,14505,14220,14485,14390,290,195,1322,"9,513.15",1694
,20160405,14485,14390,14400,14560,14400,14495,14500,105,110,1010,"7,324.81",2044
,20160406,14495,14500,14400,14445,14260,14280,14345,-220,-155,1128,"8,091.22",1892
,20160407,14280,14345,14250,14325,14210,14250,14270,-95,-75,472,"3,367.97",1978
,20160408,14250,14270,14080,14125,13925,13985,14035,-285,-235,1204,"8,450.45",2508
,20160411,13985,14035,13990,14240,13990,14090,14120,55,85,1198,"8,459.22",2488
,20160412,14090,14120,14105,14160,14060,14160,14105,40,-15,352,"2,482.79",2456
,20160413,14160,14105,14335,14810,14280,14800,14665,695,560,5786,"42,439.67",4450
,20160414,14800,14665,14850,15210,14685,14900,15035,235,370,7558,"56,835.70",5916
,20160415,14900,15035,15120,15120,14800,14945,14925,-90,-110,2874,"21,448.41",6092
,20160418,14945,14925,14965,15330,14860,15035,15120,110,195,5320,"40,219.21",6710
,20160419,15035,15120,15245,15300,15010,15190,15180,70,60,2912,"22,102.19",6892
,20160420,15190,15180,15210,15370,15110,15220,15220,40,40,4664,"35,494.01",6986
,20160421,15220,15220,15310,15520,15125,15390,15335,170,115,10084,"77,323.48",10844
,20160422,15390,15335,15485,15500,14900,15115,15110,-220,-225,5980,"45,182.75",10224
,20160425,15115,15110,15185,15545,15050,15180,15305,70,195,6304,"48,247.07",11370
,20160426,15180,15305,15165,15185,14880,14885,15025,-420,-280,5312,"39,911.23",11504
,20160427,14885,15025,14990,15135,14910,15015,15010,-10,-15,2146,"16,110.77",11676
,20160428,15015,15010,14920,15090,14870,14995,14950,-15,-60,5734,"42,863.08",10494
,20160429,14995,14950,15015,15390,15000,15365,15240,415,290,8116,"61,852.19",11862
,20160503,15365,15240,15295,15425,15190,15390,15305,150,65,4988,"38,171.39",12166
,20160504,15390,15305,15290,15295,14950,14950,15110,-355,-195,7488,"56,578.62",12324
,20160505,14950,15110,15045,15120,14920,14940,15010,-170,-100,8364,"62,773.59",12028
,20160506,14940,15010,14950,15040,14750,14900,14865,-110,-145,9776,"72,665.48",11602
,20160509,14900,14865,14900,15170,14670,14765,14930,-100,65,14014,"104,635.74",14116
,20160510,14765,14930,14860,14860,14180,14760,14670,-170,-260,8446,"61,966.98",13648
,20160511,14760,14670,14745,14950,14655,14925,14820,255,150,8074,"59,848.16",14768
,20160512,14925,14820,15055,15270,14960,15220,15135,400,315,15012,"113,625.37",16490
,20160513,15220,15135,15200,15290,14775,15035,14990,-100,-145,16648,"124,777.29",16066
,20160516,15035,14990,14985,15180,14945,15125,15095,135,105,12942,"97,685.70",17128
,20160517,15125,15095,15085,15245,15045,15200,15150,105,55,10322,"78,194.11",17728
,20160518,15200,15150,15150,15285,15005,15030,15130,-120,-20,13002,"98,382.50",18920
,20160519,15030,15130,15030,15145,14960,15000,15040,-130,-90,11936,"89,787.50",19444
,20160520,15000,15040,14915,15075,14860,15065,14965,25,-75,10546,"78,923.47",19206
,20160523,15065,14965,15120,15190,14790,14855,14975,-110,10,15274,"114,387.19",19202
,20160524,14855,14975,14840,14900,14505,14505,14695,-470,-280,17858,"131,228.84",20424
,20160525,14505,14695,14605,14745,14545,14600,14625,-95,-70,20696,"151,368.22",23122
,20160526,14600,14625,14655,15000,14640,14985,14790,360,165,19682,"145,554.01",23250
,20160527,14985,14790,15010,15100,14855,15055,14975,265,185,27284,"204,340.52",25548
,20160530,15055,14975,15120,15175,15000,15080,15055,105,80,21744,"163,708.59",29078
,20160531,15080,15055,15085,15180,14970,15130,15095,75,40,26272,"198,312.88",32974
,20160601,15130,15095,15200,15235,14955,15000,15095,-95,0,30940,"233,539.32",41074
,20160602,15000,15095,15010,15705,14965,15605,15450,510,355,88382,"682,920.17",54940
,20160603,15605,15450,15615,15650,15395,15620,15540,170,90,45680,"355,026.07",59542
,20160606,15620,15540,15710,15910,15605,15765,15770,225,230,69778,"550,234.39",69076
,20160607,15765,15770,15805,15890,15655,15770,15765,0,-5,47144,"371,687.01",72464
,20160608,15770,15765,15740,15750,15500,15645,15600,-120,-165,55726,"434,702.05",71960
,20160613,15645,15600,15900,16100,15800,15885,15925,285,325,60482,"481,686.82",78068
,20160614,15885,15925,15955,16000,15730,15760,15875,-165,-50,68512,"543,882.63",83282
,20160615,15760,15875,15700,15770,15590,15750,15675,-125,-200,65844,"516,160.65",82624
,20160616,15750,15675,15865,15910,15575,15620,15730,-55,55,62582,"492,345.20",87940
,20160617,15620,15730,15605,15730,15420,15680,15575,-50,-155,70090,"545,855.65",90716
,20160620,15680,15575,15585,15705,15500,15625,15605,50,30,67614,"527,693.11",95452
,20160621,15625,15605,15625,15830,15590,15695,15725,90,120,68618,"539,662.91",101442
,20160622,15695,15725,15655,15840,15575,15815,15720,90,-5,73274,"576,059.93",105018
,20160623,15815,15720,15870,15880,15735,15850,15800,130,80,71160,"562,336.04",113908
,20160624,15850,15800,15795,15855,15495,15535,15670,-265,-130,113660,"890,639.78",119610
,20160627,15535,15670,15550,15770,15545,15735,15665,65,-5,97512,"763,895.61",129798
,20160628,15735,15665,15650,15980,15600,15935,15775,270,110,153974,"1,214,795.87",154210
,20160629,15935,15775,16060,16385,16010,16240,16190,465,415,238888,"1,933,901.08",175738
,20160630,16240,16190,16200,16520,16140,16450,16365,260,175,203890,"1,668,337.61",192138
,20160701,16450,16365,16445,16570,16300,16545,16445,180,80,246792,"2,029,569.08",219258
,20160704,16545,16445,16565,16975,16530,16755,16775,310,330,482648,"4,048,414.69",243674
,20160705,16755,16775,16740,16760,16320,16450,16505,-325,-270,408016,"3,367,210.47",226580
,20160706,16450,16505,16570,16620,16270,16420,16430,-85,-75,501674,"4,122,363.87",229296
,20160707,16420,16430,16220,16600,16130,16395,16420,-35,-10,399630,"3,281,267.57",227466
,20160708,16395,16420,16430,16505,16250,16465,16390,45,-30,425202,"3,484,765.70",235612
,20160711,16465,16390,16580,16830,16480,16805,16640,415,250,389136,"3,238,293.13",247458
,20160712,16805,16640,16780,16860,16650,16770,16740,130,100,299680,"2,508,606.63",248244
,20160713,16770,16740,16980,17200,16860,16905,17025,165,285,574996,"4,895,060.71",251686
,20160714,16905,17025,16970,17000,16795,16990,16900,-35,-125,327256,"2,765,999.61",243374
,20160715,16990,16900,17000,17130,16855,17055,16970,155,70,315914,"2,681,087.09",247128
,20160718,17055,16970,17160,17250,16845,16940,17045,-30,75,434324,"3,702,067.30",255604
,20160719,16940,17045,16985,17340,16945,17290,17160,245,115,525210,"4,506,561.49",275322
,20160720,17290,17160,17300,17330,17100,17205,17215,45,55,414656,"3,569,567.31",267430
,20160721,17205,17215,17075,17395,17000,17380,17195,165,-20,408666,"3,514,178.21",275840
,20160722,17380,17195,17385,17555,17270,17285,17395,90,200,511672,"4,451,079.56",277190
,20160725,17285,17395,17300,17450,17135,17425,17305,30,-90,435580,"3,768,918.76",270778
,20160726,17425,17305,17410,17445,17095,17165,17260,-140,-45,423720,"3,656,984.34",251700
,20160727,17165,17260,17165,17215,16930,17015,17080,-245,-180,421572,"3,601,235.42",223808
,20160728,17015,17080,16980,17025,16730,16880,16860,-200,-220,399250,"3,365,891.77",179326
,20160729,16880,16860,16905,17075,16830,16870,16945,10,85,277402,"2,350,543.36",167602
,20160801,16870,16945,17005,17380,16870,17365,17140,420,195,270710,"2,320,472.44",150976
,20160802,17365,17140,17375,17400,17245,17365,17320,225,180,139046,"1,204,252.91",140588
,20160803,17365,17320,17440,17540,17210,17290,17375,-30,55,107834,"936,832.98",128724
,20160804,17290,17375,17290,17410,17160,17265,17275,-110,-100,76220,"658,425.13",123522
,20160805,17265,17275,17195,17400,17175,17385,17300,110,25,50106,"433,513.81",118878
,20160808,17385,17300,17385,17495,17255,17485,17360,185,60,43200,"375,048.52",114890
,20160809,17485,17360,17515,17515,17260,17310,17375,-50,15,40500,"351,905.76",110108
,20160810,17310,17375,17250,17735,17220,17710,17460,335,85,34760,"303,498.28",110180
,20160811,17710,17460,17730,17770,17540,17595,17645,135,185,34794,"307,025.91",104434
,20160812,17595,17645,17600,17620,17430,17475,17500,-170,-145,25660,"224,548.80",96542
,20160815,17475,17500,17255,17385,17065,17070,17230,-430,-270,40260,"346,904.39",83352
,20160816,17070,17230,17100,17380,17100,17295,17275,65,45,23118,"199,717.72",77684
,20160817,17295,17275,17295,17325,17175,17215,17235,-60,-40,14282,"123,102.22",75136
,20160818,17215,17235,17235,17535,17230,17500,17400,265,165,20610,"179,327.33",73082
,20160819,17500,17400,17545,17550,17350,17450,17430,50,30,14772,"128,750.43",71098
,20160822,17450,17430,17450,17520,17350,17365,17450,-65,20,15610,"136,222.47",68134
,20160823,17365,17450,17440,17610,17370,17535,17500,85,50,14754,"129,121.03",64472
,20160824,17535,17500,17540,17640,17505,17555,17555,55,55,10818,"94,978.28",61160
,20160825,17555,17555,17580,17615,17325,17510,17440,-45,-115,20918,"182,413.06",55564
,20160826,17510,17440,17510,18030,17495,17935,17855,495,415,19064,"170,216.31",53718
,20160829,17935,17855,17965,18110,17890,17970,17945,115,90,11966,"107,380.62",49024
,20160830,17970,17945,17955,18050,17830,17875,17880,-70,-65,14406,"128,817.34",43728
,20160831,17875,17880,17895,18185,17890,18040,18065,160,185,13850,"125,114.08",39380
,20160901,18040,18065,18085,18395,18020,18375,18230,310,165,7110,"64,823.08",36530
,20160902,18375,18230,18340,18565,18255,18540,18495,310,265,5730,"52,995.70",34350
,20160905,18540,18495,18610,18615,18370,18420,18420,-75,-75,6500,"59,878.43",31070
,20160906,18420,18420,18400,18465,18220,18305,18315,-115,-105,7160,"65,571.03",27190
,20160907,18305,18315,18220,18330,18150,18280,18255,-35,-60,2760,"25,195.13",25960
,20160908,18280,18255,18315,18380,18020,18065,18140,-190,-115,5960,"54,063.40",22790
,20160909,18065,18140,18070,18215,17980,18160,18140,20,0,3590,"32,561.38",21190
,20160912,18160,18140,18100,18120,17700,17785,17805,-355,-335,5770,"51,375.93",17480
,20160913,17785,17805,16915,17880,16915,17755,17805,-50,0,3900,"34,721.45",16960
,20160914,17755,17805,17645,17660,17500,17540,17570,-265,-235,1920,"16,871.90",16670
,20160919,17540,17570,16605,17625,16605,17490,17540,-80,-30,1200,"10,524.80",16530
zn1610,20160104,13500,13505,13305,13310,13200,13310,13280,-195,-225,8,53.13,222
,20160105,13310,13280,13320,13545,13305,13545,13460,265,180,28,188.50,236
,20160106,13545,13460,13350,13350,13135,13135,13205,-325,-255,10,66.04,228
,20160107,13135,13205,13135,13135,13000,13000,13065,-205,-140,4,26.14,228
,20160108,13000,13065,12800,12800,12775,12775,12785,-290,-280,4,25.58,228
,20160111,12775,12785,,,,12785,12785,0,0,0,0.00,228
,20160112,12785,12785,12585,12710,12585,12615,12665,-170,-120,10,63.33,226
,20160113,12615,12665,12480,12575,12480,12575,12555,-90,-110,10,62.78,232
,20160114,12575,12555,,,,12745,12745,190,190,0,0.00,232
,20160115,12745,12745,12725,12795,12645,12645,12740,-100,-5,34,216.61,228
,20160118,12645,12740,12610,12835,12610,12835,12645,95,-95,12,75.89,224
,20160119,12835,12645,12870,12915,12765,12915,12840,270,195,22,141.24,224
,20160120,12915,12840,12840,12840,12840,12840,12840,0,0,6,38.52,218
,20160121,12840,12840,12780,12780,12780,12780,12780,-60,-60,2,12.78,220
,20160122,12780,12780,12780,12915,12780,12915,12845,135,65,4,25.70,222
,20160125,12915,12845,12945,12945,12940,12940,12940,95,95,6,38.83,226
,20160126,12940,12940,,,,12940,12940,0,0,0,0.00,226
,20160127,12940,12940,13075,13220,13075,13220,13150,280,210,54,355.14,258
,20160128,13220,13150,13190,13190,13145,13145,13175,-5,25,8,52.71,256
,20160129,13145,13175,13050,13130,13050,13130,13100,-45,-75,6,39.31,256
,20160201,13130,13100,,,,13100,13100,0,0,0,0.00,256
,20160202,13100,13100,13400,13470,13350,13470,13395,370,295,16,107.19,260
,20160203,13470,13395,13485,13650,13435,13650,13505,255,110,50,337.67,300
,20160204,13650,13505,13605,14075,13605,14075,13955,570,450,70,488.57,274
,20160205,14075,13955,14025,14045,13895,13895,13970,-60,15,20,139.71,274
,20160215,13895,13970,14020,14020,14000,14000,14010,30,40,12,84.08,270
,20160216,14000,14010,13820,13895,13820,13820,13840,-190,-170,8,55.37,272
,20160217,13820,13840,13625,13625,13625,13625,13625,-215,-215,2,13.63,272
,20160218,13625,13625,13715,13715,13715,13715,13715,90,90,2,13.72,272
,20160219,13715,13715,13845,14025,13845,13990,13925,275,210,20,139.29,276
,20160222,13990,13925,14070,14340,13980,14340,14185,415,260,30,212.81,270
,20160223,14340,14185,14230,14230,14230,14230,14230,45,45,2,14.23,272
,20160224,14230,14230,14115,14115,14020,14020,14045,-210,-185,12,84.28,272
,20160225,14020,14045,14120,14485,14120,14420,14390,375,345,64,460.49,320
,20160226,14420,14390,14250,14265,14030,14215,14190,-175,-200,104,737.90,298
,20160229,14215,14190,14345,14365,14210,14210,14265,20,75,62,442.24,328
,20160301,14210,14265,14240,14240,14240,14240,14240,-25,-25,4,28.48,328
,20160302,14240,14240,14460,14540,14385,14540,14465,300,225,20,144.67,330
,20160303,14540,14465,14515,14595,14505,14595,14535,130,70,38,276.24,348
,20160304,14595,14535,14575,14765,14575,14650,14680,115,145,62,455.12,340
,20160307,14650,14680,14590,14890,14515,14595,14685,-85,5,68,499.42,344
,20160308,14595,14685,14645,14745,14320,14400,14480,-285,-205,74,535.89,342
,20160309,14400,14480,14350,14350,14120,14255,14280,-225,-200,12,85.69,340
,20160310,14255,14280,14240,14415,14195,14210,14275,-70,-5,24,171.34,344
,20160311,14210,14275,14295,14300,14175,14180,14235,-95,-40,24,170.85,344
,20160314,14180,14235,14410,14415,14365,14365,14375,130,140,24,172.53,340
,20160315,14365,14375,,,,14375,14375,0,0,0,0.00,340
,20160316,14375,14375,14000,14000,14000,14000,14000,-375,-375,4,28.00,340
,20160317,14000,14000,,,,14245,14245,245,245,0,0.00,340
,20160318,14245,14245,14400,14700,14400,14600,14605,355,360,54,394.42,346
,20160321,14600,14605,14555,14680,14450,14650,14630,45,25,186,"1,360.77",428
,20160322,14650,14630,14575,14620,14575,14580,14585,-50,-45,22,160.47,414
,20160323,14580,14585,14560,14560,14500,14510,14520,-75,-65,38,275.93,390
,20160324,14510,14520,14400,14435,14350,14410,14405,-110,-115,50,360.16,364
,20160325,14410,14405,14270,14325,14270,14325,14285,-80,-120,12,85.74,360
,20160328,14325,14285,14375,14375,14305,14305,14340,20,55,4,28.68,362
,20160329,14305,14340,14350,14440,14225,14225,14310,-115,-30,14,100.18,360
,20160330,14225,14310,14305,14305,14185,14225,14240,-85,-70,54,384.60,372
,20160331,14225,14240,14190,14210,14190,14210,14200,-30,-40,4,28.40,376
,20160401,14210,14200,14280,14500,14280,14500,14420,300,220,24,173.10,374
,20160405,14500,14420,14490,14550,14490,14550,14520,130,100,4,29.04,374
,20160406,14550,14520,14420,14420,14375,14405,14400,-115,-120,18,129.64,362
,20160407,14405,14400,14295,14320,14260,14260,14290,-140,-110,22,157.22,370
,20160408,14260,14290,14030,14060,13940,14005,13995,-285,-295,28,195.93,372
,20160411,14005,13995,13300,14200,13300,14195,13940,200,-55,44,306.68,374
,20160412,14195,13940,14125,14140,14085,14085,14110,145,170,18,127.03,372
,20160413,14085,14110,14440,14810,14420,14810,14535,700,425,136,988.65,362
,20160414,14810,14535,14840,15210,14805,14805,15015,270,480,162,"1,216.39",394
,20160415,14805,15015,15165,15165,14845,14900,14950,-115,-65,104,777.42,416
,20160418,14900,14950,14935,15325,14935,15040,15130,90,180,518,"3,919.40",628
,20160419,15040,15130,15295,15310,15050,15190,15155,60,25,364,"2,759.11",784
,20160420,15190,15155,15245,15355,15125,15195,15240,40,85,228,"1,737.90",766
,20160421,15195,15240,15300,15500,15165,15385,15315,145,75,492,"3,767.54",964
,20160422,15385,15315,15430,15435,14950,15120,15125,-195,-190,354,"2,677.64",874
,20160425,15120,15125,15205,15565,15100,15100,15210,-25,85,196,"1,490.78",914
,20160426,15100,15210,15115,15150,14910,14955,15020,-255,-190,278,"2,087.84",1018
,20160427,14955,15020,14920,15150,14920,15025,15065,5,45,128,964.43,1010
,20160428,15025,15065,15060,15110,14890,15005,14965,-60,-100,432,"3,233.01",1122
,20160429,15005,14965,15045,15395,15035,15335,15240,370,275,418,"3,185.22",1098
,20160503,15335,15240,15330,15420,15230,15340,15305,100,65,110,841.93,1106
,20160504,15340,15305,15300,15300,14960,14975,15080,-330,-225,334,"2,519.17",1020
,20160505,14975,15080,15050,15100,14940,14950,14995,-130,-85,440,"3,299.92",1052
,20160506,14950,14995,15000,15045,14785,14905,14860,-90,-135,532,"3,953.00",1106
,20160509,14905,14860,14925,15120,14700,14770,14915,-90,55,440,"3,281.97",1232
,20160510,14770,14915,14775,14795,14595,14750,14675,-165,-240,188,"1,379.86",1232
,20160511,14750,14675,14760,14950,14675,14930,14835,255,160,358,"2,656.17",1210
,20160512,14930,14835,15050,15270,14995,15220,15095,385,260,420,"3,170.71",1266
,20160513,15220,15095,15205,15265,14685,15055,15025,-40,-70,310,"2,329.58",1292
,20160516,15055,15025,15005,15180,14970,15125,15060,100,35,132,994.04,1270
,20160517,15125,15060,15065,15200,15065,15200,15165,140,105,280,"2,123.24",1368
,20160518,15200,15165,15150,15250,15015,15050,15125,-115,-40,396,"2,995.09",1362
,20160519,15050,15125,15065,15130,14975,15020,15020,-105,-105,146,"1,096.73",1376
,20160520,15020,15020,14910,15065,14885,15065,14970,45,-50,284,"2,126.33",1386
,20160523,15065,14970,15100,15200,14825,14890,15025,-80,55,286,"2,149.14",1286
,20160524,14890,15025,14795,14900,14525,14525,14705,-500,-320,372,"2,735.30",1330
,20160525,14525,14705,14640,14750,14580,14600,14640,-105,-65,1294,"9,474.82",1856
,20160526,14600,14640,14710,14950,14655,14950,14805,310,165,926,"6,854.90",1708
,20160527,14950,14805,15095,15105,14880,15100,14970,295,165,454,"3,398.35",1742
,20160530,15100,14970,15110,15110,15025,15095,15070,125,100,324,"2,441.53",1944
,20160531,15095,15070,15065,15190,14995,15155,15135,85,65,434,"3,284.56",2028
,20160601,15155,15135,15205,15210,14970,15005,15090,-130,-45,212,"1,599.95",2064
,20160602,15005,15090,15015,15715,14980,15625,15560,535,470,11062,"86,087.19",9696
,20160603,15625,15560,15610,15665,15410,15625,15570,65,10,6086,"47,393.46",10668
,20160606,15625,15570,15730,15910,15635,15785,15785,215,215,10522,"83,050.47",13950
,20160607,15785,15785,15805,15900,15670,15790,15775,5,-10,4604,"36,320.95",14142
,20160608,15790,15775,15730,15760,15515,15650,15615,-125,-160,6314,"49,305.22",14574
,20160613,15650,15615,15900,16110,15815,15885,15920,270,305,13842,"110,215.16",20052
,20160614,15885,15920,15915,16000,15760,15775,15875,-145,-45,7038,"55,878.70",20138
,20160615,15775,15875,15730,15780,15610,15770,15690,-105,-185,8336,"65,408.27",19438
,20160616,15770,15690,15895,15925,15610,15645,15755,-45,65,8718,"68,696.35",20796
,20160617,15645,15755,15635,15750,15450,15725,15595,-30,-160,12428,"96,912.54",20898
,20160620,15725,15595,15600,15725,15530,15655,15640,60,45,7856,"61,449.72",23048
,20160621,15655,15640,15670,15850,15620,15715,15765,75,125,8002,"63,077.68",24218
,20160622,15715,15765,15685,15860,15605,15830,15765,65,0,9858,"77,720.10",26146
,20160623,15830,15765,15890,15900,15760,15865,15835,100,70,6904,"54,671.52",27396
,20160624,15865,15835,15845,15880,15530,15545,15665,-290,-170,16298,"127,656.99",27072
,20160627,15545,15665,15625,15795,15575,15750,15690,85,25,13828,"108,503.17",29624
,20160628,15750,15690,15690,15995,15625,15970,15850,280,160,23816,"188,747.55",35830
,20160629,15970,15850,16040,16390,16030,16260,16210,410,360,42932,"347,991.07",43450
,20160630,16260,16210,16225,16585,16160,16470,16395,260,185,31590,"259,034.08",49328
,20160701,16470,16395,16450,16580,16320,16565,16470,170,75,31738,"261,373.28",54630
,20160704,16565,16470,16570,16970,16545,16775,16780,305,310,61400,"515,182.83",65554
,20160705,16775,16780,16660,16770,16345,16465,16530,-315,-250,55674,"460,156.71",66908
,20160706,16465,16530,16545,16635,16300,16460,16455,-70,-75,67450,"554,983.07",71744
,20160707,16460,16455,16285,16615,16115,16420,16455,-35,0,47434,"390,308.41",73786
,20160708,16420,16455,16465,16525,16280,16490,16410,35,-45,47814,"392,380.12",79234
,20160711,16490,16410,16620,16855,16515,16830,16670,420,260,53360,"444,880.98",90146
,20160712,16830,16670,16850,16885,16680,16805,16770,135,100,45980,"385,646.97",93840
,20160713,16805,16770,17000,17220,16895,16950,17050,180,280,107256,"914,358.62",105694
,20160714,16950,17050,16990,17035,16835,17015,16945,-35,-105,75294,"637,934.96",109710
,20160715,17015,16945,17045,17150,16895,17110,17010,165,65,76564,"651,332.31",113032
,20160718,17110,17010,17220,17280,16880,16990,17075,-20,65,104284,"890,423.49",122134
,20160719,16990,17075,17015,17365,16980,17320,17185,245,110,137120,"1,178,299.01",131566
,20160720,17320,17185,17300,17360,17150,17250,17250,65,65,109590,"945,328.50",138254
,20160721,17250,17250,17105,17430,17050,17420,17235,170,-15,131326,"1,131,868.28",149410
,20160722,17420,17235,17430,17590,17320,17335,17435,100,200,176246,"1,536,701.48",162068
,20160725,17335,17435,17360,17490,17185,17470,17350,35,-85,159334,"1,382,400.13",175770
,20160726,17470,17350,17450,17485,17145,17220,17305,-130,-45,157426,"1,362,442.59",185034
,20160727,17220,17305,17205,17265,16985,17065,17125,-240,-180,177720,"1,522,088.39",199888
,20160728,17065,17125,17045,17080,16800,16950,16925,-175,-200,200294,"1,695,258.97",197580
,20160729,16950,16925,16950,17140,16895,16930,17005,5,80,166588,"1,416,423.58",210072
,20160801,16930,17005,17050,17435,16935,17430,17220,425,215,266158,"2,291,656.15",231096
,20160802,17430,17220,17405,17465,17310,17440,17380,220,160,198138,"1,722,169.54",242718
,20160803,17440,17380,17510,17605,17260,17320,17430,-60,50,287244,"2,503,358.44",251052
,20160804,17320,17430,17355,17465,17210,17310,17330,-120,-100,306510,"2,656,159.53",261154
,20160805,17310,17330,17250,17460,17230,17435,17355,105,25,297964,"2,585,946.09",267916
,20160808,17435,17355,17430,17550,17310,17535,17420,180,65,278206,"2,423,819.60",281022
,20160809,17535,17420,17540,17565,17310,17325,17430,-95,10,281198,"2,450,767.78",266432
,20160810,17325,17430,17290,17800,17270,17790,17520,360,90,363428,"3,184,294.92",309736
,20160811,17790,17520,17780,17840,17590,17655,17705,135,185,349510,"3,094,619.52",303918
,20160812,17655,17705,17650,17680,17490,17495,17555,-210,-150,297940,"2,615,459.52",289760
,20160815,17495,17555,17355,17440,17100,17115,17275,-440,-280,400612,"3,460,684.28",266078
,20160816,17115,17275,17170,17415,17150,17335,17310,60,35,289172,"2,503,356.65",261842
,20160817,17335,17310,17350,17370,17215,17250,17280,-60,-30,241688,"2,088,442.26",249590
,20160818,17250,17280,17300,17585,17270,17550,17440,270,160,340112,"2,966,609.25",263948
,20160819,17550,17440,17600,17605,17395,17505,17495,65,55,226774,"1,983,858.56",243346
,20160822,17505,17495,17485,17575,17380,17385,17480,-110,-15,247782,"2,165,963.73",238124
,20160823,17385,17480,17435,17660,17405,17565,17535,85,55,258446,"2,266,432.13",240336
,20160824,17565,17535,17555,17670,17535,17595,17590,60,55,197852,"1,740,390.48",235898
,20160825,17595,17590,17595,17645,17330,17505,17460,-85,-130,366580,"3,200,731.52",219148
,20160826,17505,17460,17510,18030,17500,17940,17820,480,360,529324,"4,716,467.74",257040
,20160829,17940,17820,18025,18120,17885,17965,17965,145,145,364106,"3,271,199.98",244144
,20160830,17965,17965,17965,17980,17820,17865,17885,-100,-80,274692,"2,456,834.34",222034
,20160831,17865,17885,17905,18155,17865,17990,18035,105,150,366524,"3,305,832.22",208494
,20160901,17990,18035,18045,18390,17990,18370,18175,335,140,327230,"2,973,835.94",204488
,20160902,18370,18175,18330,18555,18250,18510,18415,335,240,253680,"2,336,197.64",182634
,20160905,18510,18415,18545,18600,18350,18410,18440,-5,25,171742,"1,583,533.02",157490
,20160906,18410,18440,18425,18465,18195,18290,18310,-150,-130,114318,"1,046,783.07",140764
,20160907,18290,18310,18235,18325,18110,18245,18215,-65,-95,83144,"757,349.65",134354
,20160908,18245,18215,18290,18380,18005,18070,18145,-145,-70,92710,"841,308.18",123782
,20160909,18070,18145,18030,18215,17945,18160,18110,15,-35,70160,"635,432.14",118532
,20160912,18160,18110,18105,18155,17705,17730,17880,-380,-230,97766,"874,141.52",101390
,20160913,17730,17880,17760,17895,17660,17780,17780,-100,-100,52352,"465,531.84",91802
,20160914,17780,17780,17780,17845,17510,17595,17635,-185,-145,55982,"493,672.58",85428
,20160919,17595,17635,17545,17660,17470,17535,17545,-100,-90,30936,"271,462.85",79792
,20160920,17535,17545,17545,17955,17545,17940,17850,395,305,34602,"308,826.38",76192
,20160921,17940,17850,17970,18175,17930,17955,18020,105,170,33446,"301,353.39",68764
,20160922,17955,18020,17880,18070,17740,17910,17930,-110,-90,30488,"273,327.88",63884
,20160923,17910,17930,17935,18065,17850,17940,17935,10,5,24324,"218,131.72",57838
,20160926,17940,17935,17850,17905,17570,17655,17675,-280,-260,27926,"246,836.53",50298
,20160927,17655,17675,17770,18070,17660,18030,17830,355,155,20932,"186,630.60",45712
,20160928,18030,17830,18075,18105,17925,18050,18015,220,185,19676,"177,253.22",41942
,20160929,18050,18015,18000,18285,17970,18160,18185,145,170,16982,"154,450.53",40964
,20160930,18160,18185,18205,18300,18135,18300,18200,115,15,11946,"108,712.45",37670
,20161010,18300,18200,18170,18495,18050,18360,18275,160,75,11330,"103,555.75",31140
,20161011,18360,18275,18235,18310,18090,18135,18170,-140,-105,9810,"89,136.50",23920
,20161012,18135,18170,17960,17960,17770,17835,17840,-335,-330,6720,"59,947.25",19240
,20161013,17835,17840,17960,18160,17755,17765,17850,-75,10,3160,"28,208.15",17160
,20161014,17765,17850,17575,18230,17575,17825,17905,-25,55,3620,"32,408.60",15740
,20161017,17825,17905,17910,18000,17880,17960,17910,55,5,1860,"16,658.00",15080
zn1611,20160104,13560,13560,13280,13295,13275,13275,13285,-285,-275,8,53.15,82
,20160105,13275,13285,13405,13500,13340,13415,13405,130,120,10,67.04,80
,20160106,13415,13405,13310,13310,13150,13150,13180,-255,-225,16,105.44,80
,20160107,13150,13180,13170,13170,13155,13155,13160,-25,-20,4,26.33,84
,20160108,13155,13160,12810,12850,12810,12850,12830,-310,-330,4,25.66,86
,20160111,12850,12830,,,,12955,12955,125,125,0,0.00,86
,20160112,12955,12955,12790,12790,12500,12500,12625,-455,-330,20,126.27,88
,20160113,12500,12625,12585,12635,12575,12590,12595,-35,-30,14,88.20,96
,20160114,12590,12595,12525,12720,12525,12710,12675,115,80,10,63.39,104
,20160115,12710,12675,12735,12805,12675,12675,12740,0,65,18,114.66,110
,20160118,12675,12740,12615,12615,12615,12615,12615,-125,-125,2,12.62,108
,20160119,12615,12615,12855,12855,12800,12855,12835,240,220,6,38.51,112
,20160120,12855,12835,12915,12915,12855,12860,12880,25,45,16,103.08,114
,20160121,12860,12880,12800,12800,12800,12800,12800,-80,-80,2,12.80,114
,20160122,12800,12800,12935,12945,12935,12945,12940,145,140,6,38.83,112
,20160125,12945,12940,12965,12965,12900,12900,12940,-40,0,12,77.66,110
,20160126,12900,12940,,,,12940,12940,0,0,0,0.00,110
,20160127,12940,12940,13235,13235,13235,13235,13235,295,295,2,13.24,110
,20160128,13235,13235,13160,13160,13160,13160,13160,-75,-75,4,26.32,114
,20160129,13160,13160,13125,13125,13125,13125,13125,-35,-35,2,13.13,114
,20160201,13125,13125,,,,13280,13280,155,155,0,0.00,114
,20160202,13280,13280,,,,13280,13280,0,0,0,0.00,114
,20160203,13280,13280,13500,13590,13475,13590,13530,310,250,18,121.79,110
,20160204,13590,13530,14085,14095,14030,14095,14060,565,530,10,70.32,114
,20160205,14095,14060,13990,13990,13920,13920,13965,-140,-95,6,41.90,118
,20160215,13920,13965,14045,14045,13955,13955,13985,-10,20,32,223.76,110
,20160216,13955,13985,13915,13915,13855,13855,13875,-130,-110,6,41.63,114
,20160217,13855,13875,13740,13740,13715,13715,13725,-160,-150,4,27.46,112
,20160218,13715,13725,,,,13815,13815,90,90,0,0.00,112
,20160219,13815,13815,13895,14040,13895,14040,14000,225,185,14,98.02,118
,20160222,14040,14000,14115,14395,14065,14395,14250,395,250,10,71.26,116
,20160223,14395,14250,14230,14230,14230,14230,14230,-20,-20,2,14.23,118
,20160224,14230,14230,14125,14125,14020,14060,14055,-170,-175,32,224.89,128
,20160225,14060,14055,14135,14505,14135,14465,14370,410,315,54,388.03,136
,20160226,14465,14370,14155,14205,14125,14205,14150,-165,-220,10,70.77,136
,20160229,14205,14150,14365,14375,14125,14225,14270,75,120,52,371.06,146
,20160301,14225,14270,14330,14330,14225,14225,14265,-45,-5,28,199.78,146
,20160302,14225,14265,14425,14425,14410,14410,14415,145,150,4,28.84,148
,20160303,14410,14415,14500,14640,14500,14640,14585,225,170,30,218.82,150
,20160304,14640,14585,14655,14815,14650,14650,14715,65,130,20,147.18,154
,20160307,14650,14715,14630,14945,14575,14595,14730,-120,15,60,442.04,172
,20160308,14595,14730,14550,14560,14290,14290,14485,-440,-245,34,246.26,178
,20160309,14290,14485,14350,14350,14015,14280,14125,-205,-360,68,480.31,142
,20160310,14280,14125,14325,14325,14225,14225,14285,100,160,8,57.14,146
,20160311,14225,14285,14205,14280,14185,14280,14235,-5,-50,12,85.42,148
,20160314,14280,14235,14340,14405,14285,14405,14355,170,120,10,71.79,148
,20160315,14405,14355,14285,14285,14285,14285,14285,-70,-70,2,14.29,148
,20160316,14285,14285,,,,14285,14285,0,0,0,0.00,148
,20160317,14285,14285,14265,14265,14265,14265,14265,-20,-20,6,42.80,148
,20160318,14265,14265,14410,14710,14410,14620,14575,355,310,12,87.47,154
,20160321,14620,14575,14510,14690,14510,14690,14595,115,20,12,87.58,158
,20160322,14690,14595,14620,14620,14555,14610,14595,15,0,8,58.40,158
,20160323,14610,14595,14530,14530,14530,14530,14530,-65,-65,6,43.59,154
,20160324,14530,14530,14525,14525,14345,14345,14420,-185,-110,24,173.05,156
,20160325,14345,14420,14310,14310,14310,14310,14310,-110,-110,2,14.31,156
,20160328,14310,14310,,,,14365,14365,55,55,0,0.00,156
,20160329,14365,14365,14365,14365,14265,14265,14315,-100,-50,8,57.26,154
,20160330,14265,14315,14250,14265,14250,14265,14255,-50,-60,4,28.52,154
,20160331,14265,14255,14195,14270,14195,14200,14220,-55,-35,6,42.67,152
,20160401,14200,14220,14360,14525,14360,14385,14420,165,200,8,57.69,152
,20160405,14385,14420,14500,14560,14500,14560,14520,140,100,6,43.56,152
,20160406,14560,14520,14410,14410,14350,14350,14370,-170,-150,14,100.61,154
,20160407,14350,14370,14365,14365,14270,14270,14330,-100,-40,10,71.66,152
,20160408,14270,14330,14125,14125,13965,13965,14070,-365,-260,44,309.61,152
,20160411,13965,14070,14060,14205,14060,14130,14155,60,85,16,113.28,152
,20160412,14130,14155,14145,14145,14110,14130,14125,-25,-30,6,42.39,152
,20160413,14130,14125,14405,14830,14300,14790,14710,665,585,126,926.94,190
,20160414,14790,14710,14860,15120,14790,14925,14965,215,255,28,209.55,192
,20160415,14925,14965,14965,15010,14845,14845,14945,-120,-20,18,134.54,202
,20160418,14845,14945,15135,15300,15045,15165,15215,220,270,36,273.93,200
,20160419,15165,15215,15285,15285,15120,15140,15205,-75,-10,12,91.24,196
,20160420,15140,15205,15260,15290,15155,15255,15255,50,50,22,167.81,178
,20160421,15255,15255,15255,15500,15255,15335,15305,80,50,50,382.66,166
,20160422,15335,15305,15495,15495,15020,15150,15155,-155,-150,10,75.79,162
,20160425,15150,15155,15235,15715,15115,15160,15160,5,5,44,333.53,142
,20160426,15160,15160,15135,15135,14815,14815,15045,-345,-115,14,105.35,144
,20160427,14815,15045,14970,15155,14930,15055,15025,10,-20,24,180.33,140
,20160428,15055,15025,15100,15100,14900,15000,14990,-25,-35,12,89.95,146
,20160429,15000,14990,15150,15370,15150,15335,15315,345,325,10,76.60,150
,20160503,15335,15315,15335,15405,15250,15250,15330,-65,15,58,444.60,182
,20160504,15250,15330,15175,15175,15065,15065,15165,-265,-165,44,333.65,216
,20160505,15065,15165,15060,15070,14975,14975,15045,-190,-120,10,75.25,214
,20160506,14975,15045,14900,14920,14840,14920,14890,-125,-155,24,178.71,214
,20160509,14920,14890,15050,15165,14835,14835,14995,-55,105,26,194.96,218
,20160510,14835,14995,14720,14855,14625,14760,14690,-235,-305,38,279.19,216
,20160511,14760,14690,14835,14910,14835,14910,14900,220,210,26,193.73,218
,20160512,14910,14900,15010,15270,15010,15270,15165,370,265,24,182.00,224
,20160513,15270,15165,15065,15085,14800,15020,15010,-145,-155,34,255.25,228
,20160516,15020,15010,15135,15185,15130,15130,15140,120,130,40,302.80,244
,20160517,15130,15140,15130,15245,15130,15205,15170,65,30,30,227.59,248
,20160518,15205,15170,15150,15235,15055,15055,15130,-115,-40,32,242.15,254
,20160519,15055,15130,15065,15095,15000,15000,15050,-130,-80,30,225.80,254
,20160520,15000,15050,14940,15070,14900,15040,15005,-10,-45,48,360.15,260
,20160523,15040,15005,15165,15195,14900,14940,14945,-65,-60,150,"1,121.07",348
,20160524,14940,14945,14805,14885,14600,14600,14680,-345,-265,84,616.72,330
,20160525,14600,14680,14660,14740,14605,14680,14690,0,10,272,"1,997.91",274
,20160526,14680,14690,14700,14900,14700,14900,14790,210,100,206,"1,523.81",438
,20160527,14900,14790,15065,15100,14895,15050,15000,260,210,78,585.10,460
,20160530,15050,15000,15125,15125,15065,15090,15080,90,80,80,603.26,508
,20160531,15090,15080,15085,15200,15025,15165,15130,85,50,48,363.15,506
,20160601,15165,15130,15180,15205,15020,15020,15105,-110,-25,74,558.91,518
,20160602,15020,15105,15000,15700,15000,15700,15565,595,460,950,"7,393.76",1070
,20160603,15700,15565,15595,15660,15465,15660,15570,95,5,188,"1,464.04",1066
,20160606,15660,15570,15750,15900,15705,15825,15840,255,270,738,"5,845.42",1468
,20160607,15825,15840,15825,15880,15680,15780,15785,-60,-55,130,"1,026.12",1494
,20160608,15780,15785,15735,15735,15535,15665,15630,-120,-155,608,"4,752.84",1586
,20160613,15665,15630,15955,16100,15855,15920,16005,290,375,1522,"12,181.13",2694
,20160614,15920,16005,15920,16000,15775,15785,15885,-220,-120,470,"3,733.83",2808
,20160615,15785,15885,15750,15780,15635,15750,15705,-135,-180,246,"1,932.13",2828
,20160616,15750,15705,15895,15925,15625,15625,15735,-80,30,580,"4,563.56",3100
,20160617,15625,15735,15635,15710,15480,15710,15630,-25,-105,850,"6,644.39",3452
,20160620,15710,15630,15625,15750,15550,15680,15650,50,20,782,"6,120.86",4004
,20160621,15680,15650,15660,15860,15650,15720,15790,70,140,842,"6,649.16",4320
,20160622,15720,15790,15645,15875,15615,15840,15785,50,-5,528,"4,167.69",4464
,20160623,15840,15785,15885,15910,15785,15870,15840,85,55,432,"3,422.17",4562
,20160624,15870,15840,15850,15885,15550,15550,15700,-290,-140,944,"7,412.56",4918
,20160627,15550,15700,15610,15780,15600,15765,15695,65,-5,744,"5,839.06",5038
,20160628,15765,15695,15730,16005,15650,15985,15940,290,245,812,"6,472.03",5334
,20160629,15985,15940,16075,16400,16050,16275,16220,335,280,5394,"43,749.95",8364
,20160630,16275,16220,16225,16540,16180,16500,16450,280,230,2850,"23,441.70",10072
,20160701,16500,16450,16500,16600,16345,16580,16500,130,50,2504,"20,662.20",11304
,20160704,16580,16500,16575,16975,16545,16790,16790,290,290,6138,"51,543.24",14272
,20160705,16790,16790,16770,16770,16360,16455,16540,-335,-250,4884,"40,399.11",15198
,20160706,16455,16540,16530,16640,16310,16495,16470,-45,-70,5606,"46,178.63",16212
,20160707,16495,16470,16310,16630,16200,16440,16485,-30,15,3578,"29,492.95",16014
,20160708,16440,16485,16440,16540,16330,16485,16430,0,-55,2228,"18,305.58",15766
,20160711,16485,16430,16560,16880,16550,16850,16730,420,300,4748,"39,720.15",17570
,20160712,16850,16730,16850,16905,16710,16805,16785,75,55,1790,"15,026.15",17620
,20160713,16805,16785,16980,17225,16920,16940,17075,155,290,11152,"95,226.29",21838
,20160714,16940,17075,16995,17040,16850,17030,16960,-45,-115,4330,"36,723.65",23000
,20160715,17030,16960,17055,17160,16915,17120,17025,160,65,4148,"35,317.42",24144
,20160718,17120,17025,17220,17290,16900,17000,17110,-25,85,9512,"81,391.32",25952
,20160719,17000,17110,17055,17385,17015,17350,17225,240,115,26910,"231,766.89",33112
,20160720,17350,17225,17350,17390,17180,17295,17285,70,60,16128,"139,415.56",36364
,20160721,17295,17285,17145,17455,17080,17445,17295,160,10,19858,"171,752.91",39630
,20160722,17445,17295,17450,17605,17350,17370,17470,75,175,23674,"206,844.74",43242
,20160725,17370,17470,17380,17535,17230,17515,17400,45,-70,22716,"197,637.02",47104
,20160726,17515,17400,17480,17520,17190,17260,17335,-140,-65,26482,"229,545.07",51668
,20160727,17260,17335,17255,17305,17035,17090,17160,-245,-175,26060,"223,630.44",58976
,20160728,17090,17160,17080,17120,16845,16990,16980,-170,-180,30766,"261,234.02",63060
,20160729,16990,16980,17020,17175,16935,16975,17050,-5,70,22358,"190,643.19",67824
,20160801,16975,17050,17080,17485,16980,17470,17280,420,230,40046,"346,005.43",75780
,20160802,17470,17280,17475,17500,17305,17470,17415,190,135,32044,"279,077.72",80902
,20160803,17470,17415,17540,17640,17300,17355,17465,-60,50,51476,"449,599.96",87756
,20160804,17355,17465,17385,17505,17250,17355,17365,-110,-100,35574,"308,960.03",89954
,20160805,17355,17365,17260,17490,17260,17470,17395,105,30,28274,"245,968.29",91034
,20160808,17470,17395,17460,17580,17350,17575,17470,180,75,34258,"299,310.37",95602
,20160809,17575,17470,17565,17595,17350,17370,17465,-100,-5,45838,"400,368.96",100020
,20160810,17370,17465,17370,17830,17320,17815,17565,350,100,59804,"525,291.28",109644
,20160811,17815,17565,17800,17865,17630,17680,17735,115,170,57984,"514,295.86",112258
,20160812,17680,17735,17680,17715,17525,17530,17590,-205,-145,51616,"454,084.78",111552
,20160815,17530,17590,17400,17475,17130,17175,17300,-415,-290,88512,"765,765.88",114132
,20160816,17175,17300,17215,17440,17185,17355,17335,55,35,69628,"603,658.99",121902
,20160817,17355,17335,17370,17400,17245,17280,17310,-55,-25,60142,"520,595.82",124978
,20160818,17280,17310,17310,17615,17300,17580,17470,270,160,83318,"727,918.44",135592
,20160819,17580,17470,17615,17630,17435,17530,17525,60,55,59088,"517,851.31",139876
,20160822,17530,17525,17525,17610,17415,17415,17515,-110,-10,72290,"633,218.21",144824
,20160823,17415,17515,17480,17680,17445,17595,17560,80,45,78838,"692,390.75",156022
,20160824,17595,17560,17575,17695,17565,17610,17615,50,55,69638,"613,377.14",165996
,20160825,17610,17615,17630,17670,17340,17495,17465,-120,-150,153506,"1,340,668.02",184674
,20160826,17495,17465,17500,18000,17500,17920,17805,455,340,232432,"2,069,487.91",227970
,20160829,17920,17805,17995,18095,17860,17945,17945,140,140,162290,"1,456,415.34",241520
,20160830,17945,17945,17950,17955,17805,17840,17865,-105,-80,155074,"1,385,201.71",256038
,20160831,17840,17865,17895,18130,17860,17955,18015,90,150,278560,"2,509,691.49",290696
,20160901,17955,18015,18000,18370,17965,18345,18170,330,155,307828,"2,796,632.99",332138
,20160902,18345,18170,18300,18550,18230,18515,18410,345,240,319008,"2,936,638.30",348710
,20160905,18515,18410,18555,18595,18340,18400,18440,-10,30,363022,"3,347,254.88",331278
,20160906,18400,18440,18410,18460,18190,18285,18310,-155,-130,312758,"2,863,507.78",321234
,20160907,18285,18310,18245,18320,18100,18235,18205,-75,-105,310242,"2,824,095.86",310582
,20160908,18235,18205,18280,18375,17980,18045,18140,-160,-65,424846,"3,854,177.06",308286
,20160909,18045,18140,18020,18205,17920,18155,18095,15,-45,347410,"3,143,846.08",308740
,20160912,18155,18095,18090,18145,17660,17720,17880,-375,-215,425478,"3,804,832.35",283614
,20160913,17720,17880,17730,17880,17640,17770,17770,-110,-110,292798,"2,602,028.18",276084
,20160914,17770,17770,17790,17835,17495,17570,17620,-200,-150,432280,"3,809,076.63",263898
,20160919,17570,17620,17550,17645,17450,17525,17530,-95,-90,214076,"1,876,771.96",265858
,20160920,17525,17530,17560,17945,17555,17915,17820,385,290,395300,"3,522,818.13",266488
,20160921,17915,17820,17975,18160,17905,17935,18005,115,185,368290,"3,316,166.77",252536
,20160922,17935,18005,17940,18045,17720,17910,17900,-95,-105,401354,"3,592,388.57",240630
,20160923,17910,17900,17980,18060,17850,17950,17950,50,50,304630,"2,734,443.39",226092
,20160926,17950,17950,17900,17915,17560,17660,17715,-290,-235,396132,"3,508,819.53",222622
,20160927,17660,17715,17705,18080,17655,18020,17840,305,125,394270,"3,517,501.85",210684
,20160928,18020,17840,18090,18110,17920,18040,18020,200,180,314098,"2,830,120.55",199662
,20160929,18040,18020,18020,18290,17990,18180,18180,160,160,286318,"2,603,025.31",181506
,20160930,18180,18180,18235,18325,18145,18255,18225,75,45,202684,"1,847,007.32",167862
,20161010,18255,18225,18190,18470,18025,18360,18270,135,45,129590,"1,183,940.31",159598
,20161011,18360,18270,18300,18360,18090,18160,18210,-110,-60,142174,"1,294,700.24",145384
,20161012,18160,18210,18010,18020,17745,17815,17840,-395,-370,126702,"1,130,429.43",127726
,20161013,17815,17840,17870,17990,17735,17780,17845,-60,5,76060,"678,782.91",120790
,20161014,17780,17845,17680,17930,17550,17840,17765,-5,-80,74056,"657,973.28",114708
,20161017,17840,17765,17855,18105,17830,18000,17955,235,190,51010,"457,987.66",108232
,20161018,18000,17955,18090,18300,17905,18230,18080,275,125,38864,"351,389.27",102334
,20161019,18230,18080,18230,18310,18115,18175,18200,95,120,33470,"304,599.46",99268
,20161020,18175,18200,18175,18405,18045,18305,18255,105,55,33894,"309,382.98",93586
,20161021,18305,18255,18270,18325,18155,18255,18245,0,-10,25958,"236,832.87",89018
,20161024,18255,18245,18150,18280,18090,18210,18175,-35,-70,35486,"322,486.28",76450
,20161025,18210,18175,18350,19080,18330,19015,18780,840,605,46594,"437,521.12",69142
,20161026,19015,18780,19045,19150,18740,18890,18900,110,120,35762,"338,021.42",65030
,20161027,18890,18900,18875,19020,18735,18900,18855,0,-45,22160,"208,941.30",62746
,20161028,18900,18855,18970,19300,18870,19125,19090,270,235,20830,"198,825.33",57898
,20161031,19125,19090,19155,19450,19100,19290,19270,200,180,16768,"161,574.44",52926
,20161101,19290,19270,19445,20055,19385,19875,19825,605,555,10096,"100,093.70",49700
,20161102,19875,19825,19850,19865,19365,19475,19645,-350,-180,8430,"82,806.05",43900
,20161103,19475,19645,19420,19720,19350,19685,19505,40,-140,8570,"83,590.18",37740
,20161104,19685,19505,19720,20005,19640,19750,19795,245,290,7510,"74,333.28",32480
,20161107,19750,19795,19700,20215,19660,20120,19895,325,100,4870,"48,451.88",29940
,20161108,20120,19895,20080,20125,19860,19905,19985,10,90,4880,"48,767.40",26740
,20161109,19905,19985,19885,20425,19715,19860,20005,-125,20,5900,"59,025.18",23530
,20161110,19860,20005,20105,21005,19955,20990,20605,985,600,3790,"39,051.18",22310
,20161111,20990,20605,20700,20940,20530,20930,20715,325,110,2190,"22,686.03",22390
,20161114,20930,20715,20725,21495,20210,21060,20685,345,-30,1130,"11,688.00",21880
,20161115,21060,20685,20690,21925,20690,21920,21725,1235,1040,2360,"25,635.53",21000
zn1612,20160104,13540,13575,13460,13560,13460,13560,13510,-15,-65,4,27.02,110
,20160105,13560,13510,13505,13505,13395,13415,13445,-95,-65,10,67.24,110
,20160106,13415,13445,13245,13250,13240,13240,13240,-205,-205,36,238.39,134
,20160107,13240,13240,13045,13045,13045,13045,13045,-195,-195,4,26.09,134
,20160108,13045,13045,12830,12830,12830,12830,12830,-215,-215,2,12.83,134
,20160111,12830,12830,,,,12830,12830,0,0,0,0.00,134
,20160112,12830,12830,12630,12630,12600,12600,12610,-230,-220,20,126.13,126
,20160113,12600,12610,12600,12600,12600,12600,12600,-10,-10,2,12.60,126
,20160114,12600,12600,12660,12725,12640,12715,12685,115,85,18,114.20,118
,20160115,12715,12685,12685,12765,12685,12760,12735,75,50,64,407.65,56
,20160118,12760,12735,12635,12635,12635,12635,12635,-100,-100,8,50.54,56
,20160119,12635,12635,12815,12815,12815,12815,12815,180,180,2,12.82,56
,20160120,12815,12815,12920,12920,12875,12875,12880,60,65,10,64.42,66
,20160121,12875,12880,,,,12875,12875,-5,-5,0,0.00,66
,20160122,12875,12875,12935,12935,12930,12930,12930,55,55,4,25.87,66
,20160125,12930,12930,12975,12975,12975,12975,12975,45,45,2,12.98,66
,20160126,12975,12975,,,,12975,12975,0,0,0,0.00,66
,20160127,12975,12975,13175,13270,13175,13270,13205,295,230,6,39.62,68
,20160128,13270,13205,,,,13130,13130,-75,-75,0,0.00,68
,20160129,13130,13130,,,,13130,13130,0,0,0,0.00,68
,20160201,13130,13130,13285,13360,13235,13250,13270,120,140,16,106.20,66
,20160202,13250,13270,,,,13270,13270,0,0,0,0.00,66
,20160203,13270,13270,13610,13625,13610,13625,13615,355,345,4,27.24,64
,20160204,13625,13615,13720,13720,13710,13710,13715,95,100,4,27.43,62
,20160205,13710,13715,13890,13925,13890,13925,13905,210,190,4,27.82,64
,20160215,13925,13905,14010,14010,13945,13945,13975,40,70,14,97.85,62
,20160216,13945,13975,13920,13930,13845,13880,13890,-95,-85,16,111.14,70
,20160217,13880,13890,13860,13860,13815,13815,13835,-75,-55,4,27.68,70
,20160218,13815,13835,,,,13925,13925,90,90,0,0.00,70
,20160219,13925,13925,13845,13990,13845,13990,13925,65,0,12,83.56,68
,20160222,13990,13925,14030,14360,14030,14360,14225,435,300,10,71.13,66
,20160223,14360,14225,14355,14355,14350,14350,14350,125,125,4,28.71,68
,20160224,14350,14350,14110,14110,14075,14075,14090,-275,-260,4,28.19,72
,20160225,14075,14090,14225,14500,14225,14240,14320,150,230,6,42.97,70
,20160226,14240,14320,14170,14175,14145,14175,14160,-145,-160,6,42.49,70
,20160229,14175,14160,14330,14475,14130,14265,14310,105,150,670,"4,794.96",138
,20160301,14265,14310,14405,14405,14350,14350,14375,40,65,16,115.04,134
,20160302,14350,14375,14360,14690,14290,14545,14510,170,135,26,188.65,136
,20160303,14545,14510,14605,14605,14540,14540,14570,30,60,18,131.17,138
,20160304,14540,14570,14620,14750,14620,14750,14675,180,105,24,176.12,134
,20160307,14750,14675,14620,14895,14590,14605,14705,-70,30,30,220.61,130
,20160308,14605,14705,14780,14780,14410,14410,14585,-295,-120,38,277.14,128
,20160309,14410,14585,14235,14300,14170,14300,14230,-285,-355,18,128.10,122
,20160310,14300,14230,14420,14420,14315,14335,14380,105,150,10,71.91,122
,20160311,14335,14380,14300,14310,14260,14300,14295,-80,-85,26,185.87,130
,20160314,14300,14295,14385,14480,14375,14480,14400,185,105,8,57.62,130
,20160315,14480,14400,14220,14310,14220,14255,14285,-145,-115,12,85.72,130
,20160316,14255,14285,14100,14130,14100,14115,14105,-170,-180,20,141.08,122
,20160317,14115,14105,14135,14135,14135,14135,14135,30,30,4,28.27,122
,20160318,14135,14135,14430,14745,14430,14640,14625,505,490,16,117.00,126
,20160321,14640,14625,14580,14715,14580,14685,14675,60,50,10,73.38,126
,20160322,14685,14675,14630,14660,14630,14660,14645,-15,-30,4,29.29,130
,20160323,14660,14645,14605,14605,14545,14550,14585,-95,-60,18,131.28,142
,20160324,14550,14585,14410,14510,14390,14390,14425,-195,-160,10,72.15,144
,20160325,14390,14425,14340,14340,14320,14320,14330,-105,-95,4,28.66,142
,20160328,14320,14330,14470,14470,14415,14465,14450,135,120,6,43.35,140
,20160329,14465,14450,14385,14385,14285,14285,14330,-165,-120,8,57.34,138
,20160330,14285,14330,14255,14285,14175,14255,14240,-75,-90,30,213.66,120
,20160331,14255,14240,14285,14285,14210,14230,14240,-10,0,6,42.73,122
,20160401,14230,14240,,,,14440,14440,200,200,0,0.00,122
,20160405,14440,14440,,,,14540,14540,100,100,0,0.00,122
,20160406,14540,14540,14445,14445,14355,14355,14380,-185,-160,14,100.69,134
,20160407,14355,14380,14375,14375,14340,14340,14355,-40,-25,4,28.72,134
,20160408,14340,14355,14160,14160,14000,14000,14070,-355,-285,38,267.34,138
,20160411,14000,14070,14175,14205,14130,14155,14160,85,90,42,297.37,158
,20160412,14155,14160,14170,14170,14125,14125,14140,-35,-20,6,42.42,156
,20160413,14125,14140,14450,14820,14435,14805,14685,665,545,88,646.36,148
,20160414,14805,14685,14860,15190,14850,14850,15000,165,315,32,240.04,144
,20160415,14850,15000,15000,15000,14900,14995,14965,-5,-35,6,44.90,146
,20160418,14995,14965,15195,15295,15195,15195,15235,230,270,24,182.86,156
,20160419,15195,15235,15245,15280,15120,15170,15190,-65,-45,22,167.12,156
,20160420,15170,15190,15245,15720,15185,15190,15300,0,110,32,244.82,168
,20160421,15190,15300,15290,15310,15035,15260,15250,-40,-50,26,198.28,176
,20160422,15260,15250,15480,15480,14985,15070,15120,-180,-130,44,332.73,186
,20160425,15070,15120,15240,15560,15135,15150,15320,30,200,18,137.92,192
,20160426,15150,15320,15135,15135,15055,15055,15080,-265,-240,6,45.25,190
,20160427,15055,15080,15130,15130,15120,15120,15125,40,45,6,45.38,188
,20160428,15120,15125,14985,15010,14950,14970,14980,-155,-145,12,89.91,192
,20160429,14970,14980,15135,15360,15135,15360,15265,380,285,14,106.88,192
,20160503,15360,15265,15350,15380,15350,15380,15355,115,90,8,61.43,198
,20160504,15380,15355,15265,15295,15050,15050,15185,-305,-170,42,318.91,212
,20160505,15050,15185,15085,15150,15030,15095,15085,-90,-100,16,120.71,208
,20160506,15095,15085,15060,15060,14875,14920,14935,-165,-150,26,194.20,220
,20160509,14920,14935,15065,15065,14745,14750,14905,-185,-30,20,149.07,224
,20160510,14750,14905,14810,14810,14690,14725,14725,-180,-180,26,191.47,212
,20160511,14725,14725,14795,14930,14780,14930,14880,205,155,66,491.08,224
,20160512,14930,14880,15110,15290,15090,15245,15175,365,295,22,166.94,222
,20160513,15245,15175,15210,15250,14920,15050,15010,-125,-165,132,990.95,262
,20160516,15050,15010,15140,15170,15020,15160,15100,150,90,22,166.13,268
,20160517,15160,15100,15130,15225,15130,15150,15160,50,60,28,212.26,274
,20160518,15150,15160,15160,15305,15160,15200,15230,40,70,16,121.88,274
,20160519,15200,15230,15120,15125,15120,15125,15120,-105,-110,4,30.25,274
,20160520,15125,15120,14910,15090,14910,15090,15010,-30,-110,38,285.19,278
,20160523,15090,15010,15140,15140,14815,14815,14955,-195,-55,20,149.58,288
,20160524,14815,14955,14820,14820,14630,14700,14770,-255,-185,84,620.49,258
,20160525,14700,14770,14665,14755,14525,14640,14630,-130,-140,112,819.40,278
,20160526,14640,14630,14715,14970,14715,14970,14815,340,185,24,177.79,270
,20160527,14970,14815,15080,15100,14950,15070,15000,255,185,18,135.01,284
,20160530,15070,15000,15065,15130,15065,15130,15095,130,95,160,"1,207.83",372
,20160531,15130,15095,15120,15210,15120,15180,15160,85,65,80,606.54,406
,20160601,15180,15160,15215,15230,15050,15050,15075,-110,-85,26,196.00,406
,20160602,15050,15075,15455,15700,15425,15640,15575,565,500,50,389.49,402
,20160603,15640,15575,15655,15835,15610,15675,15670,100,95,24,188.09,402
,20160606,15675,15670,15750,15885,15720,15830,15810,160,140,24,189.74,418
,20160607,15830,15810,15885,15885,15710,15820,15735,10,-75,58,456.37,456
,20160608,15820,15735,15715,15715,15565,15705,15630,-30,-105,36,281.38,446
,20160613,15705,15630,15850,16110,15850,15980,15910,350,280,154,"1,225.20",582
,20160614,15980,15910,15915,15975,15815,15815,15890,-95,-20,18,143.02,578
,20160615,15815,15890,15750,15760,15700,15705,15735,-185,-155,24,188.84,572
,20160616,15705,15735,15940,15940,15645,15665,15775,-70,40,94,741.63,590
,20160617,15665,15775,15650,15735,15550,15735,15660,-40,-115,46,360.19,588
,20160620,15735,15660,15710,15755,15600,15645,15655,-15,-5,302,"2,364.20",726
,20160621,15645,15655,15705,15870,15705,15745,15790,90,135,106,836.94,694
,20160622,15745,15790,15660,15885,15625,15855,15750,65,-40,74,582.81,696
,20160623,15855,15750,15895,15915,15825,15875,15870,125,120,70,555.56,718
,20160624,15875,15870,15735,15785,15535,15560,15640,-310,-230,208,"1,626.91",732
,20160627,15560,15640,15615,15795,15615,15785,15730,145,90,70,550.57,728
,20160628,15785,15730,15705,16015,15695,15990,15790,260,60,200,"1,579.17",794
,20160629,15990,15790,16170,16495,16105,16300,16235,510,445,106,860.63,800
,20160630,16300,16235,16220,16520,16185,16490,16415,255,180,308,"2,528.16",926
,20160701,16490,16415,16510,16590,16370,16535,16455,120,40,524,"4,311.24",1160
,20160704,16535,16455,16570,16900,16100,16800,16755,345,300,366,"3,067.01",1418
,20160705,16800,16755,16775,16775,16390,16480,16485,-275,-270,422,"3,478.48",1390
,20160706,16480,16485,16545,16635,16310,16635,16420,150,-65,618,"5,075.32",1730
,20160707,16635,16420,16255,16605,16255,16435,16510,15,90,412,"3,402.09",1582
,20160708,16435,16510,16495,16550,16350,16515,16440,5,-70,188,"1,545.55",1546
,20160711,16515,16440,16710,16870,16560,16815,16730,375,290,188,"1,572.69",1578
,20160712,16815,16730,16825,16895,16750,16795,16815,65,85,74,622.33,1580
,20160713,16795,16815,16995,17270,16955,16995,17085,180,270,560,"4,784.32",1692
,20160714,16995,17085,17000,17055,16860,17045,16965,-40,-120,254,"2,155.14",1796
,20160715,17045,16965,17065,17155,16920,17090,17030,125,65,112,953.81,1774
,20160718,17090,17030,17230,17290,16945,17060,17210,30,180,382,"3,287.81",1976
,20160719,17060,17210,17070,17390,17030,17360,17240,150,30,1162,"10,017.51",2580
,20160720,17360,17240,17360,17395,17200,17310,17295,70,55,2942,"25,445.74",4534
,20160721,17310,17295,17155,17470,17095,17435,17320,140,25,2582,"22,361.85",6096
,20160722,17435,17320,17470,17610,17375,17375,17505,55,185,2334,"20,432.82",6844
,20160725,17375,17505,17395,17520,17255,17520,17420,15,-85,1178,"10,260.87",7282
,20160726,17520,17420,17515,17525,17225,17280,17330,-140,-90,1132,"9,810.76",7616
,20160727,17280,17330,17295,17325,17055,17115,17130,-215,-200,4330,"37,091.09",9756
,20160728,17115,17130,17095,17120,16865,17000,16990,-130,-140,2370,"20,135.68",10254
,20160729,17000,16990,17025,17190,16970,16995,17060,5,70,1238,"10,561.16",10316
,20160801,16995,17060,17140,17500,17010,17485,17335,425,275,3924,"34,019.44",11296
,20160802,17485,17335,17470,17520,17360,17475,17455,140,120,2518,"21,976.42",12128
,20160803,17475,17455,17565,17660,17315,17365,17440,-90,-15,7082,"61,766.13",15056
,20160804,17365,17440,17365,17510,17275,17370,17370,-70,-70,3512,"30,508.94",15588
,20160805,17370,17370,17325,17510,17305,17505,17425,135,55,3416,"29,765.63",16456
,20160808,17505,17425,17505,17610,17375,17610,17515,185,90,5034,"44,093.29",18342
,20160809,17610,17515,17610,17620,17385,17400,17510,-115,-5,6248,"54,712.16",20346
,20160810,17400,17510,17400,17850,17370,17835,17615,325,105,11930,"105,076.97",24670
,20160811,17835,17615,17835,17880,17655,17715,17760,100,145,14494,"128,725.43",27502
,20160812,17715,17760,17715,17730,17550,17570,17610,-190,-150,11088,"97,652.35",30472
,20160815,17570,17610,17460,17495,17155,17165,17335,-445,-275,11128,"96,457.22",31766
,20160816,17165,17335,17175,17455,17175,17380,17360,45,25,12572,"109,131.18",33024
,20160817,17380,17360,17380,17420,17265,17300,17330,-60,-30,11956,"103,615.01",34230
,20160818,17300,17330,17325,17630,17320,17595,17475,265,145,13958,"121,964.40",37706
,20160819,17595,17475,17635,17655,17465,17550,17550,75,75,10438,"91,596.95",39582
,20160822,17550,17550,17545,17630,17435,17435,17540,-115,-10,12256,"107,497.89",41088
,20160823,17435,17540,17480,17695,17460,17610,17590,70,50,13010,"114,429.84",45006
,20160824,17610,17590,17610,17705,17580,17615,17625,25,35,7872,"69,383.84",45958
,20160825,17615,17625,17625,17675,17340,17470,17470,-155,-155,28084,"245,317.35",54162
,20160826,17470,17470,17405,17950,17405,17885,17770,415,300,38592,"342,898.13",60896
,20160829,17885,17770,17910,18045,17800,17900,17900,130,130,25318,"226,624.97",66736
,20160830,17900,17900,17900,17920,17760,17805,17820,-95,-80,25954,"231,294.18",66596
,20160831,17805,17820,17885,18080,17805,17920,17985,100,165,44376,"399,052.18",71418
,20160901,17920,17985,17965,18365,17935,18310,18115,325,130,48512,"439,399.42",82056
,20160902,18310,18115,18280,18490,18185,18460,18355,345,240,61762,"566,857.62",95652
,20160905,18460,18355,18500,18550,18320,18380,18405,25,50,69338,"638,104.13",98592
,20160906,18380,18405,18365,18430,18175,18260,18280,-145,-125,57100,"521,927.31",98504
,20160907,18260,18280,18215,18290,18085,18215,18185,-65,-95,49798,"452,808.75",98380
,20160908,18215,18185,18270,18345,17960,18020,18115,-165,-70,75880,"687,363.80",101824
,20160909,18020,18115,18005,18180,17905,18115,18070,0,-45,63592,"574,656.00",106068
,20160912,18115,18070,18070,18115,17660,17705,17835,-365,-235,100688,"898,103.31",106224
,20160913,17705,17835,17700,17860,17630,17750,17755,-85,-80,81988,"727,998.02",107342
,20160914,17750,17755,17780,17815,17485,17550,17605,-205,-150,105320,"927,144.80",105782
,20160919,17550,17605,17520,17640,17435,17480,17520,-125,-85,67194,"588,758.93",110116
,20160920,17480,17520,17550,17920,17540,17890,17805,370,285,122024,"1,086,521.08",121802
,20160921,17890,17805,17935,18130,17880,17905,17975,100,170,139322,"1,252,286.93",133642
,20160922,17905,17975,17910,18020,17700,17915,17880,-60,-95,146036,"1,305,913.36",141338
,20160923,17915,17880,17970,18060,17855,17950,17950,70,70,116832,"1,048,810.38",143486
,20160926,17950,17950,17900,17920,17570,17665,17705,-285,-245,165042,"1,461,280.30",153514
,20160927,17665,17705,17715,18070,17655,18020,17840,315,135,189584,"1,691,534.94",167754
,20160928,18020,17840,18100,18110,17930,18040,18020,200,180,162036,"1,460,232.21",175594
,20160929,18040,18020,18030,18290,17995,18180,18185,160,165,167796,"1,525,767.88",177848
,20160930,18180,18185,18235,18330,18150,18275,18230,90,45,139456,"1,271,237.71",181474
,20161010,18275,18230,18200,18480,18040,18390,18290,160,60,154682,"1,414,880.46",193770
,20161011,18390,18290,18310,18370,18095,18170,18215,-120,-75,285246,"2,598,213.92",205116
,20161012,18170,18215,18020,18020,17735,17790,17825,-425,-390,400856,"3,573,474.41",215874
,20161013,17790,17825,17855,17975,17705,17750,17835,-75,10,335120,"2,989,128.19",225498
,20161014,17750,17835,17660,17910,17520,17825,17735,-10,-100,419444,"3,719,868.11",220276
,20161017,17825,17735,17815,18090,17810,17990,17945,255,210,403608,"3,621,853.02",216584
,20161018,17990,17945,18050,18280,17885,18210,18060,265,115,390584,"3,527,418.72",221454
,20161019,18210,18060,18200,18295,18090,18160,18180,100,120,341726,"3,106,799.51",213156
,20161020,18160,18180,18170,18380,18020,18275,18220,95,40,364932,"3,324,738.60",218918
,20161021,18275,18220,18200,18290,18120,18200,18205,-20,-15,289800,"2,638,354.83",215250
,20161024,18200,18205,18100,18235,18040,18175,18140,-30,-65,361996,"3,283,923.45",213806
,20161025,18175,18140,18305,19045,18295,19010,18715,870,575,535570,"5,011,943.18",223252
,20161026,19010,18715,19075,19130,18720,18885,18885,170,170,395938,"3,739,278.07",211198
,20161027,18885,18885,18825,19000,18700,18875,18830,-10,-55,341180,"3,212,440.08",208878
,20161028,18875,18830,18935,19180,18840,19095,19010,265,180,307016,"2,918,507.57",202966
,20161031,19095,19010,19170,19405,19065,19330,19225,320,215,346256,"3,328,431.30",186882
,20161101,19330,19225,19395,20035,19335,19795,19770,570,545,406064,"4,014,562.09",166700
,20161102,19795,19770,19770,19815,19315,19400,19590,-370,-180,222084,"2,175,437.65",142278
,20161103,19400,19590,19410,19705,19300,19650,19465,60,-125,117384,"1,142,600.25",137600
,20161104,19650,19465,19665,20020,19565,19765,19800,300,335,136384,"1,350,227.57",128044
,20161107,19765,19800,19720,20245,19585,20105,19855,305,55,117946,"1,170,942.26",122410
,20161108,20105,19855,19995,20150,19800,19895,19965,40,110,93590,"934,411.94",114698
,20161109,19895,19965,19905,20435,19660,19855,20005,-110,40,112964,"1,130,151.26",109436
,20161110,19855,20005,19915,21000,19845,20875,20430,870,425,133550,"1,364,496.67",98736
,20161111,20875,20430,20930,20985,20490,20940,20725,510,295,78624,"814,897.85",86150
,20161114,20940,20725,20835,21790,20005,21250,20895,525,170,98554,"1,029,666.05",75844
,20161115,21250,20895,21150,22105,20830,21085,21430,190,535,59270,"635,171.64",69340
,20161116,21085,21430,20975,21730,20850,21240,21280,-190,-150,29974,"318,967.49",63542
,20161117,21240,21280,21185,21305,20240,20595,20700,-685,-580,21892,"226,590.02",59154
,20161118,20595,20700,20610,21050,20490,20890,20645,190,-55,16542,"170,783.37",55524
,20161121,20890,20645,20940,21460,20700,21340,21150,695,505,15020,"158,868.88",52038
,20161122,21340,21150,20945,21880,20945,21780,21545,630,395,12320,"132,721.61",48532
,20161123,21780,21545,21760,21775,21385,21595,21520,50,-25,13708,"147,511.61",42006
,20161124,21595,21520,21530,22810,21400,22580,22405,1060,885,21056,"235,921.75",36684
,20161125,22580,22405,22570,23150,22510,23025,22815,620,410,13422,"153,140.02",32692
,20161128,23025,22815,23035,24410,22995,24410,23890,1595,1075,12260,"146,468.94",30778
,20161129,24410,23890,24410,24930,23460,23735,24110,-155,220,22304,"268,923.53",24844
,20161130,23735,24110,23745,23880,22420,22460,22945,-1650,-1165,9612,"110,291.15",21580
,20161201,22460,22945,22765,23050,22310,22795,22725,-150,-220,4910,"55,796.25",18870
,20161202,22795,22725,22985,23030,21820,22220,22265,-505,-460,2930,"32,618.35",17810
,20161205,22220,22265,22110,22655,21910,22570,22370,305,105,3290,"36,800.00",17540
,20161206,22570,22370,22695,23205,22550,22680,22800,310,430,1710,"19,497.68",16950
,20161207,22680,22800,22780,23200,22780,23120,22985,320,185,600,"6,895.88",16880
,20161208,23120,22985,23260,23395,22450,22620,22665,-365,-320,1420,"16,094.73",16390
,20161209,22620,22665,22620,22800,21950,22400,22260,-265,-405,3320,"36,955.10",15300
,20161212,22400,22260,22455,22690,22150,22150,22540,-110,280,2250,"25,361.38",14260
,20161213,22150,22540,22200,22650,22140,22390,22300,-150,-240,660,"7,359.28",13750
,20161214,22390,22300,22575,22575,21770,22250,22110,-50,-190,2500,"27,640.25",13360
,20161215,22250,22110,22390,23650,22320,22660,22655,550,545,560,"6,344.43",13230
zn1701,20160118,12735,12735,12750,12750,12750,12750,12750,15,15,4,25.50,4
,20160119,12750,12750,12865,12865,12865,12865,12865,115,115,2,12.87,6
,20160120,12865,12865,12950,12985,12950,12985,12965,120,100,4,25.94,8
,20160121,12985,12965,12870,12870,12870,12870,12870,-95,-95,2,12.87,10
,20160122,12870,12870,12905,13140,12865,12945,12980,75,110,16,103.85,12
,20160125,12945,12980,12995,12995,12995,12995,12995,15,15,2,13.00,14
,20160126,12995,12995,,,,12995,12995,0,0,0,0.00,14
,20160127,12995,12995,13230,13235,13230,13235,13230,240,235,4,26.47,14
,20160128,13235,13230,,,,13230,13230,0,0,0,0.00,14
,20160129,13230,13230,,,,13190,13190,-40,-40,0,0.00,14
,20160201,13190,13190,,,,13190,13190,0,0,0,0.00,14
,20160202,13190,13190,12530,13500,12530,13500,13180,310,-10,24,158.21,32
,20160203,13500,13180,13545,13825,13545,13645,13660,465,480,26,177.64,42
,20160204,13645,13660,13710,14135,13710,14135,13820,475,160,26,179.71,50
,20160205,14135,13820,14130,14130,13950,13950,14025,130,205,8,56.11,48
,20160215,13950,14025,13990,13990,13990,13990,13990,-35,-35,2,13.99,46
,20160216,13990,13990,,,,13990,13990,0,0,0,0.00,46
,20160217,13990,13990,13850,13850,13795,13795,13820,-195,-170,4,27.65,42
,20160218,13795,13820,13815,13815,13400,13400,13560,-420,-260,10,67.82,50
,20160219,13400,13560,13855,14090,13855,14090,13965,530,405,22,153.66,60
,20160222,14090,13965,14050,14355,14050,14355,14240,390,275,10,71.21,64
,20160223,14355,14240,14485,14520,14230,14230,14395,-10,155,18,129.59,68
,20160224,14230,14395,14295,14295,14075,14075,14210,-320,-185,6,42.64,68
,20160225,14075,14210,14190,14585,14190,14295,14485,85,275,40,289.73,84
,20160226,14295,14485,14300,14300,14185,14245,14235,-240,-250,10,71.19,84
,20160229,14245,14235,14400,14415,14235,14300,14320,65,85,88,630.20,126
,20160301,14300,14320,14420,14420,14250,14350,14375,30,55,26,186.92,140
,20160302,14350,14375,14395,14555,14395,14555,14500,180,125,34,246.52,156
,20160303,14555,14500,14560,14625,14500,14540,14575,40,75,38,276.96,152
,20160304,14540,14575,14690,14825,14620,14630,14675,55,100,66,484.33,176
,20160307,14630,14675,14610,14980,14610,14655,14770,-20,95,78,576.17,190
,20160308,14655,14770,14740,14890,14390,14465,14550,-305,-220,120,873.12,202
,20160309,14465,14550,14420,14420,13860,14315,14215,-235,-335,86,611.41,214
,20160310,14315,14215,14415,14515,14235,14235,14380,20,165,74,532.22,208
,20160311,14235,14380,14180,14380,14180,14270,14305,-110,-75,18,128.76,210
,20160314,14270,14305,14395,14500,14350,14350,14390,45,85,16,115.14,206
,20160315,14350,14390,14365,14365,14365,14365,14365,-25,-25,2,14.37,208
,20160316,14365,14365,14085,14120,14020,14120,14070,-245,-295,10,70.37,210
,20160317,14120,14070,14300,14330,14300,14330,14315,260,245,4,28.63,214
,20160318,14330,14315,14395,14745,14395,14745,14615,430,300,22,160.77,228
,20160321,14745,14615,14600,15075,14465,14630,14680,15,65,40,293.63,242
,20160322,14630,14680,14655,14685,14595,14595,14655,-85,-25,16,117.24,248
,20160323,14595,14655,14610,14610,14610,14610,14610,-45,-45,2,14.61,250
,20160324,14610,14610,14485,14570,14380,14530,14480,-80,-130,56,405.44,252
,20160325,14530,14480,14360,14425,14345,14425,14365,-55,-115,14,100.59,262
,20160328,14425,14365,14465,14480,14360,14360,14425,-5,60,20,144.26,258
,20160329,14360,14425,14420,14420,14280,14280,14330,-145,-95,32,229.35,234
,20160330,14280,14330,14295,14320,14205,14215,14245,-115,-85,74,527.20,236
,20160331,14215,14245,14305,14305,14185,14185,14230,-60,-15,14,99.64,238
,20160401,14185,14230,14365,14530,14365,14500,14485,270,255,126,912.59,334
,20160405,14500,14485,14535,14600,14535,14570,14570,85,85,18,131.15,348
,20160406,14570,14570,14490,14495,14350,14350,14430,-220,-140,12,86.59,356
,20160407,14350,14430,14325,14350,14325,14325,14325,-105,-105,16,114.63,368
,20160408,14325,14325,14165,14165,14030,14050,14085,-275,-240,26,183.17,380
,20160411,14050,14085,14050,14240,14050,14180,14155,95,70,26,184.04,386
,20160412,14180,14155,14150,14220,14150,14220,14175,65,20,18,127.58,384
,20160413,14220,14175,14320,14880,14320,14805,14665,630,490,840,"6,160.81",824
,20160414,14805,14665,15100,15185,14790,14790,15000,125,335,182,"1,365.40",840
,20160415,14790,15000,14970,15000,14850,14945,14950,-55,-50,72,538.29,846
,20160418,14945,14950,14940,15325,14885,15125,15135,175,185,134,"1,014.14",886
,20160419,15125,15135,15250,15300,14630,15120,15095,-15,-40,164,"1,237.98",932
,20160420,15120,15095,15325,15365,15245,15295,15280,200,185,202,"1,543.67",1056
,20160421,15295,15280,15285,15480,15155,15400,15300,120,20,180,"1,377.23",1114
,20160422,15400,15300,15415,15415,15065,15085,15120,-215,-180,120,907.28,1154
,20160425,15085,15120,15285,15540,15100,15215,15195,95,75,336,"2,552.98",1074
,20160426,15215,15195,15180,15180,14915,14950,15035,-245,-160,104,782.02,1108
,20160427,14950,15035,15100,15140,15020,15020,15090,-15,55,72,543.42,1148
,20160428,15020,15090,15130,15130,14995,15050,15030,-40,-60,54,405.86,1148
,20160429,15050,15030,15120,15430,15090,15395,15310,365,280,216,"1,653.78",1258
,20160503,15395,15310,15315,15455,15315,15370,15390,60,80,60,461.75,1276
,20160504,15370,15390,15320,15320,15005,15045,15125,-345,-265,70,529.54,1294
,20160505,15045,15125,15060,15145,14980,15020,15040,-105,-85,30,225.60,1290
,20160506,15020,15040,15075,15075,14835,14945,14925,-95,-115,80,597.06,1276
,20160509,14945,14925,15010,15215,14680,14760,14895,-165,-30,428,"3,188.52",1406
,20160510,14760,14895,14815,14815,14630,14725,14725,-170,-170,92,677.50,1354
,20160511,14725,14725,14835,14975,14715,14925,14870,200,145,114,847.60,1384
,20160512,14925,14870,15010,15310,15010,15280,15210,410,340,306,"2,327.49",1488
,20160513,15280,15210,15320,15320,14850,14885,15055,-325,-155,240,"1,807.05",1498
,20160516,14885,15055,14985,15215,14985,15195,15130,140,75,260,"1,966.90",1574
,20160517,15195,15130,15130,15250,15085,15250,15180,120,50,384,"2,915.08",1620
,20160518,15250,15180,15150,15265,15040,15100,15145,-80,-35,280,"2,120.95",1634
,20160519,15100,15145,15025,15135,14990,15060,15080,-85,-65,26,196.09,1630
,20160520,15060,15080,14960,15105,14940,15105,14990,25,-90,62,464.80,1640
,20160523,15105,14990,15225,15260,14855,14935,15015,-55,25,174,"1,306.60",1654
,20160524,14935,15015,14820,14820,14515,14515,14740,-500,-275,164,"1,208.92",1652
,20160525,14515,14740,14645,14720,14600,14655,14665,-85,-75,252,"1,848.04",1626
,20160526,14655,14665,14740,14970,14725,14970,14795,305,130,96,710.38,1644
,20160527,14970,14795,15095,15125,14935,15110,15050,315,255,156,"1,174.01",1660
,20160530,15110,15050,15125,15140,15050,15095,15100,45,50,70,528.50,1652
,20160531,15095,15100,15070,15205,14965,15190,15115,90,15,130,982.75,1662
,20160601,15190,15115,15220,15230,15020,15030,15140,-85,25,132,999.35,1662
,20160602,15030,15140,15180,15740,15180,15685,15505,545,365,452,"3,504.74",1762
,20160603,15685,15505,15770,15770,15380,15695,15595,190,90,222,"1,731.07",1826
,20160606,15695,15595,15710,15930,15605,15855,15840,260,245,238,"1,885.34",1866
,20160607,15855,15840,15875,15920,15700,15830,15810,-10,-30,84,664.10,1890
,20160608,15830,15810,15775,15775,15545,15700,15655,-110,-155,356,"2,787.43",1974
,20160613,15700,15655,15870,16140,15870,15950,16025,295,370,420,"3,365.73",1896
,20160614,15950,16025,15980,16035,15830,15840,15930,-185,-95,218,"1,736.76",1886
,20160615,15840,15930,15815,15815,15685,15795,15770,-135,-160,336,"2,649.59",1958
,20160616,15795,15770,15855,15915,15680,15690,15760,-80,-10,336,"2,647.84",1910
,20160617,15690,15760,15690,15775,15520,15775,15665,15,-95,166,"1,300.60",1906
,20160620,15775,15665,15715,15760,15580,15720,15695,55,30,746,"5,854.32",2014
,20160621,15720,15695,15710,15900,15710,15800,15810,105,115,170,"1,344.08",2120
,20160622,15800,15810,15705,15895,15705,15885,15815,75,5,276,"2,182.64",2144
,20160623,15885,15815,15900,16050,15795,15890,15880,75,65,106,841.68,2142
,20160624,15890,15880,15875,15910,15560,15570,15720,-310,-160,508,"3,994.12",1992
,20160627,15570,15720,15645,15825,15645,15825,15695,105,-25,172,"1,349.95",1976
,20160628,15825,15695,15780,16045,15680,16005,15840,310,145,98,776.24,1970
,20160629,16005,15840,16190,16395,16075,16295,16250,455,410,504,"4,095.04",2038
,20160630,16295,16250,16215,16540,16215,16520,16490,270,240,450,"3,710.61",2214
,20160701,16520,16490,16480,16595,16360,16595,16510,105,20,172,"1,420.11",2160
,20160704,16595,16510,16600,16995,16600,16810,16815,300,305,692,"5,818.70",2138
,20160705,16810,16815,16745,16825,16415,16515,16575,-300,-240,266,"2,204.58",2210
,20160706,16515,16575,16620,16760,16305,16520,16490,-55,-85,344,"2,836.84",2168
,20160707,16520,16490,16325,16655,16305,16555,16565,65,75,274,"2,269.72",2148
,20160708,16555,16565,16555,16575,16355,16515,16445,-50,-120,194,"1,595.50",2152
,20160711,16515,16445,16640,16885,16615,16885,16785,440,340,108,906.40,2140
,20160712,16885,16785,16895,16980,16740,16835,16800,50,15,284,"2,385.96",2188
,20160713,16835,16800,17035,17260,16960,16995,17065,195,265,1294,"11,043.03",2332
,20160714,16995,17065,17000,17075,16875,17075,16985,10,-80,994,"8,443.52",2588
,20160715,17075,16985,17095,17185,16950,17125,17040,140,55,322,"2,743.98",2688
,20160718,17125,17040,17275,17315,16925,17025,17155,-15,115,622,"5,336.31",2914
,20160719,17025,17155,17050,17400,17015,17375,17235,220,80,5274,"45,451.20",5544
,20160720,17375,17235,17340,17405,17195,17320,17290,85,55,2404,"20,784.32",6784
,20160721,17320,17290,17185,17465,17085,17455,17325,165,35,2940,"25,471.73",8926
,20160722,17455,17325,17490,17625,17080,17400,17480,75,155,5296,"46,298.85",10768
,20160725,17400,17480,17400,17535,17235,17520,17365,40,-115,2966,"25,758.65",11740
,20160726,17520,17365,17500,17535,17205,17300,17365,-65,0,3118,"27,078.71",12880
,20160727,17300,17365,17265,17345,17050,17130,17180,-235,-185,4776,"41,031.26",14834
,20160728,17130,17180,17105,17140,16865,17040,17025,-140,-155,4224,"35,959.16",16092
,20160729,17040,17025,17045,17240,16610,17010,17070,-15,45,3766,"32,151.20",17966
,20160801,17010,17070,17150,17520,16865,17500,17295,430,225,5704,"49,331.91",19284
,20160802,17500,17295,17500,17535,17390,17535,17460,240,165,3098,"27,051.40",20232
,20160803,17535,17460,17585,17670,17340,17375,17505,-85,45,7044,"61,666.47",21166
,20160804,17375,17505,17405,17530,17300,17385,17400,-120,-105,3064,"26,661.15",21490
,20160805,17385,17400,17320,17535,17315,17530,17435,130,35,2000,"17,438.95",21464
,20160808,17530,17435,17490,17620,17400,17620,17520,185,85,2630,"23,041.75",21806
,20160809,17620,17520,17620,17640,17400,17415,17510,-105,-10,2074,"18,162.30",22060
,20160810,17415,17510,17380,17870,17375,17835,17605,325,95,4940,"43,493.11",23302
,20160811,17835,17605,17790,17910,17675,17720,17765,115,160,5528,"49,116.11",24330
,20160812,17720,17765,17715,17740,17565,17590,17620,-175,-145,7900,"69,610.64",26766
,20160815,17590,17620,17500,17500,17165,17170,17340,-450,-280,9742,"84,466.14",27534
,20160816,17170,17340,17235,17465,17210,17395,17355,55,15,8726,"75,725.43",30022
,20160817,17395,17355,17380,17440,17275,17300,17345,-55,-10,7042,"61,079.70",31380
,20160818,17300,17345,17370,17635,17315,17600,17495,255,150,8374,"73,261.43",33880
,20160819,17600,17495,17725,17725,17470,17560,17545,65,50,6888,"60,438.74",35576
,20160822,17560,17545,17545,17625,17435,17450,17540,-95,-5,5044,"44,241.68",35806
,20160823,17450,17540,17450,17705,17450,17630,17590,90,50,5900,"51,901.86",36336
,20160824,17630,17590,17610,17715,17570,17615,17625,25,35,6136,"54,086.02",36078
,20160825,17615,17625,17670,17675,17320,17445,17440,-180,-185,13670,"119,209.19",37948
,20160826,17445,17440,17455,17895,17455,17840,17755,400,315,20560,"182,527.11",43076
,20160829,17840,17755,17890,18015,17720,17860,17850,105,95,13692,"122,230.35",44762
,20160830,17860,17850,17850,17880,17720,17785,17785,-65,-65,15126,"134,512.51",46976
,20160831,17785,17785,17805,18030,17795,17870,17930,85,145,22760,"204,095.53",48928
,20160901,17870,17930,17895,18270,17875,18250,18080,320,150,22942,"207,436.70",53214
,20160902,18250,18080,18220,18440,18140,18420,18325,340,245,23040,"211,150.95",55348
,20160905,18420,18325,18465,18515,18300,18345,18380,20,55,29128,"267,716.12",55578
,20160906,18345,18380,18345,18400,18150,18240,18260,-140,-120,23354,"213,254.59",55974
,20160907,18240,18260,18215,18265,18055,18185,18155,-75,-105,25588,"232,280.37",55646
,20160908,18185,18155,18215,18320,17950,18000,18090,-155,-65,31604,"285,929.66",58220
,20160909,18000,18090,17995,18160,17890,18110,18055,20,-35,23728,"214,250.96",58096
,20160912,18110,18055,18055,18095,17650,17705,17830,-350,-225,35724,"318,511.70",56772
,20160913,17705,17830,17725,17850,17615,17745,17745,-85,-85,23080,"204,783.81",56056
,20160914,17745,17745,17750,17805,17470,17550,17580,-195,-165,35536,"312,406.22",57950
,20160919,17550,17580,17515,17625,17415,17470,17505,-110,-75,21426,"187,539.30",56950
,20160920,17470,17505,17535,18080,17520,17865,17785,360,280,38682,"343,984.73",60256
,20160921,17865,17785,17950,18115,17870,17890,17955,105,170,35748,"320,989.95",59582
,20160922,17890,17955,17940,18010,17690,17910,17870,-45,-85,40386,"360,881.03",62228
,20160923,17910,17870,17960,18055,17860,17950,17955,80,85,30772,"276,271.64",63384
,20160926,17950,17955,17890,17920,17580,17670,17720,-285,-235,42426,"375,956.13",67822
,20160927,17670,17720,17760,18065,17660,18015,17840,295,120,46406,"413,990.07",73402
,20160928,18015,17840,18100,18110,17935,18045,18020,205,180,50084,"451,380.44",78408
,20160929,18045,18020,18005,18290,17990,18180,18190,160,170,55990,"509,302.60",87334
,20160930,18180,18190,18225,18330,18155,18275,18235,85,45,41084,"374,643.64",96346
,20161010,18275,18235,18220,18500,18035,18390,18280,155,45,35944,"328,534.32",99770
,20161011,18390,18280,18295,18370,18090,18165,18210,-115,-70,66254,"603,316.85",101756
,20161012,18165,18210,18000,18010,17725,17790,17820,-420,-390,80096,"713,736.46",104868
,20161013,17790,17820,17840,17970,17700,17740,17820,-80,0,66930,"596,454.38",112406
,20161014,17740,17820,17670,17890,17510,17815,17725,-5,-95,94486,"837,433.38",117760
,20161017,17815,17725,17805,18065,17795,17965,17920,240,195,106798,"957,144.86",122910
,20161018,17965,17920,18040,18270,17880,18200,18045,280,125,109730,"990,227.90",129540
,20161019,18200,18045,18190,18280,18075,18135,18160,90,115,106344,"965,789.07",137340
,20161020,18135,18160,18160,18360,17995,18255,18205,95,45,117090,"1,065,873.67",147112
,20161021,18255,18205,18175,18265,18105,18175,18185,-30,-20,83906,"762,994.88",149104
,20161024,18175,18185,18075,18205,18015,18145,18115,-40,-70,107902,"977,383.88",158348
,20161025,18145,18115,18280,19020,18265,18980,18725,865,610,204384,"1,913,795.88",180962
,20161026,18980,18725,19025,19100,18700,18875,18865,150,140,153996,"1,452,811.94",186808
,20161027,18875,18865,18830,18980,18680,18845,18815,-20,-50,132540,"1,247,080.82",194914
,20161028,18845,18815,18895,19155,18820,19080,19000,265,185,145566,"1,382,899.82",213650
,20161031,19080,19000,19165,19385,19055,19320,19215,320,215,216510,"2,080,224.39",229738
,20161101,19320,19215,19385,20005,19310,19755,19760,540,545,527768,"5,214,708.47",253948
,20161102,19755,19760,19735,19785,19285,19380,19550,-380,-210,434130,"4,244,558.58",253280
,20161103,19380,19550,19370,19695,19275,19640,19465,90,-85,335448,"3,264,968.96",271812
,20161104,19640,19465,19655,20015,19545,19760,19800,295,335,510092,"5,050,521.62",268666
,20161107,19760,19800,19705,20225,19570,20070,19850,270,50,482574,"4,790,299.70",278680
,20161108,20070,19850,19980,20140,19765,19865,19955,15,105,402672,"4,017,744.13",267536
,20161109,19865,19955,19865,20415,19630,19840,20000,-115,45,672164,"6,723,199.41",257688
,20161110,19840,20000,19900,20965,19805,20845,20430,845,430,1071932,"10,950,826.97",277466
,20161111,20845,20430,20770,20955,20470,20910,20720,480,290,612050,"6,341,164.42",263988
,20161114,20910,20720,20785,21795,20000,21275,20850,555,130,1171850,"12,217,170.38",248924
,20161115,21275,20850,21230,22100,20855,21115,21470,265,620,1170376,"12,566,096.49",261496
,20161116,21115,21470,21010,21780,20870,21255,21340,-215,-130,865648,"9,237,240.09",260562
,20161117,21255,21340,21195,21335,20245,20570,20795,-770,-545,690764,"7,183,195.28",243348
,20161118,20570,20795,20625,20925,20485,20890,20685,95,-110,590784,"6,110,606.42",238522
,20161121,20890,20685,20985,21475,20700,21365,21110,680,425,856132,"9,038,266.42",254926
,20161122,21365,21110,21310,21880,21115,21800,21525,690,415,575752,"6,197,088.17",255266
,20161123,21800,21525,21730,21790,21385,21590,21580,65,55,478936,"5,168,572.45",240322
,20161124,21590,21580,21480,22870,21400,22570,22255,990,675,801494,"8,919,355.15",237204
,20161125,22570,22255,22535,23090,22500,23045,22815,790,560,586130,"6,687,307.27",227362
,20161128,23045,22815,23095,24410,23010,24410,23695,1595,880,515976,"6,113,165.53",214536
,20161129,24410,23695,24300,25060,23490,23780,24245,85,550,875196,"10,610,342.86",165694
,20161130,23780,24245,23960,23980,22545,22545,23015,-1700,-1230,779124,"8,967,599.18",129870
,20161201,22545,23015,22590,23185,22365,22895,22765,-120,-250,532324,"6,059,842.37",119540
,20161202,22895,22765,22990,23140,21940,22280,22605,-485,-160,354926,"4,011,817.25",107658
,20161205,22280,22605,22090,22780,21980,22620,22365,15,-240,199482,"2,230,805.75",100594
,20161206,22620,22365,22640,23360,22640,22810,22950,445,585,136822,"1,570,347.65",91328
,20161207,22810,22950,22835,23410,22710,23220,23070,270,120,92270,"1,064,391.90",85702
,20161208,23220,23070,23370,23630,22510,22750,23010,-320,-60,81902,"942,300.34",75678
,20161209,22750,23010,22825,22980,22080,22525,22415,-485,-595,64878,"727,271.34",67966
,20161212,22525,22415,22530,22880,22230,22285,22595,-130,180,40038,"452,334.42",62584
,20161213,22285,22595,22465,22620,22180,22505,22385,-90,-210,24486,"274,072.30",59842
,20161214,22505,22385,22640,22750,21980,22385,22305,0,-80,25760,"287,323.11",57590
,20161215,22385,22305,22595,23025,22215,22800,22680,495,375,36554,"414,576.44",54746
,20161216,22800,22680,22635,23025,22270,22510,22645,-170,-35,21652,"245,199.82",51330
,20161219,22510,22645,22385,22455,21425,21475,22050,-1170,-595,25272,"278,624.97",45706
,20161220,21475,22050,21125,21425,20615,20875,21000,-1175,-1050,21974,"230,740.93",43278
,20161221,20875,21000,21020,21370,21010,21195,21190,195,190,13096,"138,771.80",42036
,20161222,21195,21190,21180,21240,20590,20735,20915,-455,-275,11318,"118,374.54",41014
,20161223,20735,20915,20690,21270,20660,21130,21020,215,105,9644,"101,374.23",39440
,20161226,21130,21020,21090,21150,19545,19680,19935,-1340,-1085,16350,"162,990.63",35618
,20161227,19680,19935,19985,20240,19635,20180,19890,245,-45,11374,"113,142.69",32954
,20161228,20180,19890,20250,21015,20015,20540,20575,650,685,8780,"90,342.17",31556
,20161229,20540,20575,20670,21160,20465,20890,20890,315,315,6274,"65,545.14",29844
,20161230,20890,20890,20715,21890,20500,20700,20755,-190,-135,7498,"77,814.00",27706
zn1702,20160216,13990,13990,,,,13990,13990,0,0,0,0.00,0
,20160217,13990,13990,13740,13740,13740,13740,13740,-250,-250,2,13.74,2
,20160218,13740,13740,,,,13480,13480,-260,-260,0,0.00,2
,20160219,13480,13480,14010,14095,14010,14095,14065,615,585,12,84.40,14
,20160222,14095,14065,14150,14435,14150,14260,14280,195,215,12,85.70,22
,20160223,14260,14280,,,,14280,14280,0,0,0,0.00,22
,20160224,14280,14280,14225,14225,14225,14225,14225,-55,-55,2,14.23,24
,20160225,14225,14225,14385,14385,14345,14375,14375,150,150,12,86.26,34
,20160226,14375,14375,14195,14220,14195,14220,14200,-155,-175,16,113.63,20
,20160229,14220,14200,14435,14435,14300,14325,14355,125,155,16,114.86,30
,20160301,14325,14355,,,,14355,14355,0,0,0,0.00,30
,20160302,14355,14355,,,,14355,14355,0,0,0,0.00,30
,20160303,14355,14355,14620,14620,14620,14620,14620,265,265,2,14.62,30
,20160304,14620,14620,14795,14795,14470,14770,14680,150,60,12,88.10,34
,20160307,14770,14680,14760,14760,14670,14670,14715,-10,35,8,58.86,34
,20160308,14670,14715,14460,14460,14460,14460,14460,-255,-255,2,14.46,32
,20160309,14460,14460,14300,14495,13900,14355,14290,-105,-170,22,157.21,48
,20160310,14355,14290,14490,14490,14275,14275,14415,-15,125,6,43.25,44
,20160311,14275,14415,14300,14380,14300,14380,14325,-35,-90,24,171.92,66
,20160314,14380,14325,14575,14575,14405,14405,14490,80,165,4,28.98,68
,20160315,14405,14490,,,,14490,14490,0,0,0,0.00,68
,20160316,14490,14490,14060,14165,14060,14120,14110,-370,-380,14,98.77,68
,20160317,14120,14110,14160,14330,14160,14330,14220,220,110,6,42.66,72
,20160318,14330,14220,14455,14775,14455,14775,14650,555,430,10,73.26,76
,20160321,14775,14650,14690,14740,14690,14740,14715,90,65,4,29.43,78
,20160322,14740,14715,14700,14700,14690,14700,14695,-15,-20,6,44.09,76
,20160323,14700,14695,14640,14780,14585,14645,14635,-50,-60,12,87.84,80
,20160324,14645,14635,14475,14580,14475,14475,14495,-160,-140,20,144.96,88
,20160325,14475,14495,14380,14400,14380,14400,14385,-95,-110,6,43.17,92
,20160328,14400,14385,14460,14545,14395,14395,14455,10,70,10,72.29,92
,20160329,14395,14455,14320,14320,14315,14315,14315,-140,-140,30,214.78,122
,20160330,14315,14315,14320,14340,14230,14230,14295,-85,-20,40,285.98,154
,20160331,14230,14295,14340,14340,14225,14245,14245,-50,-50,30,213.72,170
,20160401,14245,14245,14425,14530,14425,14520,14510,275,265,36,261.22,198
,20160405,14520,14510,14555,14620,14555,14620,14575,110,65,8,58.31,202
,20160406,14620,14575,14510,14515,14385,14385,14475,-190,-100,10,72.39,198
,20160407,14385,14475,14340,14365,14340,14365,14350,-110,-125,8,57.41,202
,20160408,14365,14350,14140,14140,14080,14085,14105,-265,-245,10,70.53,204
,20160411,14085,14105,14210,14235,14140,14195,14195,90,90,18,127.78,204
,20160412,14195,14195,13775,14280,13775,14280,14120,85,-75,14,98.86,202
,20160413,14280,14120,14445,14825,14445,14825,14700,705,580,40,294.07,206
,20160414,14825,14700,14880,15175,14880,14950,15045,250,345,10,75.25,204
,20160415,14950,15045,,,,15045,15045,0,0,0,0.00,204
,20160418,15045,15045,14950,15140,14950,15135,15075,90,30,6,45.23,204
,20160419,15135,15075,15240,15265,15240,15265,15250,190,175,4,30.51,204
,20160420,15265,15250,15305,15315,15225,15225,15290,-25,40,12,91.75,206
,20160421,15225,15290,15380,15380,15380,15380,15380,90,90,2,15.38,206
,20160422,15380,15380,15270,15270,15095,15095,15200,-285,-180,10,76.02,202
,20160425,15095,15200,15455,15455,15150,15175,15305,-25,105,8,61.24,204
,20160426,15175,15305,15155,15155,15095,15095,15130,-210,-175,6,45.40,206
,20160427,15095,15130,15030,15030,15030,15030,15030,-100,-100,2,15.03,204
,20160428,15030,15030,15020,15020,15020,15020,15020,-10,-10,4,30.04,208
,20160429,15020,15020,15190,15435,15190,15435,15320,415,300,6,45.97,208
,20160503,15435,15320,,,,15320,15320,0,0,0,0.00,208
,20160504,15320,15320,15230,15230,15160,15160,15205,-160,-115,6,45.62,206
,20160505,15160,15205,,,,15205,15205,0,0,0,0.00,206
,20160506,15205,15205,,,,15000,15000,-205,-205,0,0.00,206
,20160509,15000,15000,14875,14875,14800,14800,14835,-200,-165,4,29.68,206
,20160510,14800,14835,14695,14720,14685,14720,14695,-115,-140,14,102.88,202
,20160511,14720,14695,,,,14695,14695,0,0,0,0.00,202
,20160512,14695,14695,15170,15170,15140,15140,15155,445,460,4,30.31,204
,20160513,15140,15155,14880,15055,14880,15055,14965,-100,-190,4,29.94,204
,20160516,15055,14965,,,,15035,15035,70,70,0,0.00,204
,20160517,15035,15035,15250,15250,15130,15180,15150,145,115,28,212.14,222
,20160518,15180,15150,,,,15150,15150,0,0,0,0.00,222
,20160519,15150,15150,15075,15135,15075,15135,15105,-15,-45,4,30.21,220
,20160520,15135,15105,14930,15110,14930,15110,14975,5,-130,64,479.29,212
,20160523,15110,14975,15195,15195,14895,14895,15015,-80,40,12,90.11,216
,20160524,14895,15015,14890,14890,14720,14720,14775,-295,-240,6,44.33,218
,20160525,14720,14775,14645,14645,14645,14645,14645,-130,-130,2,14.65,218
,20160526,14645,14645,14905,14905,14905,14905,14905,260,260,2,14.91,220
,20160527,14905,14905,15030,15030,15030,15030,15030,125,125,2,15.03,218
,20160530,15030,15030,,,,15030,15030,0,0,0,0.00,218
,20160531,15030,15030,,,,15030,15030,0,0,0,0.00,218
,20160601,15030,15030,,,,15030,15030,0,0,0,0.00,218
,20160602,15030,15030,15545,15700,15545,15640,15615,610,585,8,62.47,222
,20160603,15640,15615,15640,15640,15565,15565,15595,-50,-20,56,436.70,246
,20160606,15565,15595,15745,15865,15725,15855,15755,260,160,36,283.67,228
,20160607,15855,15755,15890,15940,15865,15940,15895,185,140,8,63.59,226
,20160608,15940,15895,15630,15630,15630,15630,15630,-265,-265,2,15.63,224
,20160613,15630,15630,15890,16140,15890,16140,15920,510,290,24,191.08,242
,20160614,16140,15920,15855,15855,15855,15855,15855,-65,-65,2,15.86,242
,20160615,15855,15855,15750,15820,15750,15800,15795,-55,-60,22,173.76,238
,20160616,15800,15795,15795,15795,15795,15795,15795,0,0,4,31.59,240
,20160617,15795,15795,,,,15795,15795,0,0,0,0.00,240
,20160620,15795,15795,15720,15720,15685,15700,15700,-95,-95,26,204.11,218
,20160621,15700,15700,15705,15875,15705,15790,15815,90,115,80,632.67,196
,20160622,15790,15815,15830,15905,15830,15905,15850,90,35,40,317.01,160
,20160623,15905,15850,15930,15935,15860,15910,15920,60,70,16,127.37,158
,20160624,15910,15920,15890,15890,15660,15660,15785,-260,-135,12,94.74,164
,20160627,15660,15785,15690,15690,15690,15690,15690,-95,-95,2,15.69,166
,20160628,15690,15690,15790,15790,15750,15750,15765,60,75,6,47.31,170
,20160629,15750,15765,16220,16410,16195,16195,16265,430,500,8,65.06,168
,20160630,16195,16265,16260,16550,16260,16490,16465,225,200,62,510.53,200
,20160701,16490,16465,16485,16520,16405,16490,16445,25,-20,24,197.36,192
,20160704,16490,16445,16660,17100,16560,16885,16855,440,410,120,"1,011.58",186
,20160705,16885,16855,16605,16605,16405,16500,16480,-355,-375,10,82.41,190
,20160706,16500,16480,16625,16625,16575,16580,16590,100,110,6,49.78,192
,20160707,16580,16590,16565,16575,16550,16550,16560,-40,-30,6,49.69,190
,20160708,16550,16560,16500,16525,16400,16430,16430,-130,-130,18,147.90,192
,20160711,16430,16430,,,,16460,16460,30,30,0,0.00,192
,20160712,16460,16460,16805,16805,16805,16805,16805,345,345,2,16.81,194
,20160713,16805,16805,17150,17210,16960,16960,17105,155,300,14,119.75,198
,20160714,16960,17105,17015,17015,17015,17015,17015,-90,-90,2,17.02,200
,20160715,17015,17015,17005,17110,16990,17080,17035,65,20,10,85.19,202
,20160718,17080,17035,17250,17260,16950,16950,17115,-85,80,24,205.39,212
,20160719,16950,17115,17050,17405,17050,17365,17275,250,160,360,"3,109.78",332
,20160720,17365,17275,17360,17405,17275,17300,17310,25,35,118,"1,021.58",302
,20160721,17300,17310,17380,17380,17375,17375,17375,65,65,6,52.14,296
,20160722,17375,17375,17580,17595,17420,17510,17535,135,160,26,227.97,288
,20160725,17510,17535,17480,17545,17320,17545,17430,10,-105,24,209.16,296
,20160726,17545,17430,17520,17520,17325,17325,17430,-105,0,26,226.65,286
,20160727,17325,17430,17315,17320,17225,17280,17290,-150,-140,62,536.04,296
,20160728,17280,17290,17045,17085,16925,17040,17010,-250,-280,42,357.27,314
,20160729,17040,17010,17225,17225,17225,17225,17225,215,215,4,34.45,314
,20160801,17225,17225,17520,17520,17480,17485,17490,260,265,8,69.97,310
,20160802,17485,17490,17495,17540,17435,17540,17480,50,-10,10,87.42,310
,20160803,17540,17480,17580,17600,17400,17400,17570,-80,90,412,"3,620.18",660
,20160804,17400,17570,17350,17495,17350,17385,17415,-185,-155,10,87.08,656
,20160805,17385,17415,17360,17465,17360,17465,17410,50,-5,4,34.83,656
,20160808,17465,17410,17370,17505,17370,17505,17435,95,25,4,34.88,660
,20160809,17505,17435,17560,17585,17430,17430,17535,-5,100,10,87.70,664
,20160810,17430,17535,17480,17820,17465,17820,17495,285,-40,340,"2,974.99",732
,20160811,17820,17495,17855,17900,17690,17710,17795,215,300,724,"6,443.10",592
,20160812,17710,17795,17720,17720,17630,17660,17685,-135,-110,42,371.41,592
,20160815,17660,17685,17505,17505,17190,17190,17310,-495,-375,256,"2,215.99",634
,20160816,17190,17310,17260,17510,17240,17415,17320,105,10,1290,"11,171.97",1636
,20160817,17415,17320,17290,17430,17290,17320,17370,0,50,210,"1,824.33",1664
,20160818,17320,17370,17345,17620,17345,17600,17455,230,85,710,"6,198.09",1780
,20160819,17600,17455,17500,17525,17500,17510,17510,55,55,36,315.21,1780
,20160822,17510,17510,17595,17600,17445,17445,17555,-65,45,894,"7,847.35",2406
,20160823,17445,17555,17475,17670,17475,17630,17590,75,35,778,"6,842.70",3066
,20160824,17630,17590,17650,17650,17585,17620,17615,30,25,570,"5,021.15",3586
,20160825,17620,17615,17650,17650,17305,17445,17465,-170,-150,3296,"28,783.39",3760
,20160826,17445,17465,17460,17870,17460,17775,17750,310,285,558,"4,952.33",3818
,20160829,17775,17750,17775,17940,17725,17765,17795,15,45,202,"1,797.60",3836
,20160830,17765,17795,17835,17835,17700,17720,17745,-75,-50,310,"2,751.07",3834
,20160831,17720,17745,17785,17980,17775,17795,17920,50,175,1258,"11,272.27",3952
,20160901,17795,17920,17885,18235,17855,18235,18070,315,150,3320,"30,001.04",5684
,20160902,18235,18070,18185,18380,18120,18380,18270,310,200,678,"6,195.05",5692
,20160905,18380,18270,18425,18470,18275,18330,18345,60,75,1056,"9,686.43",5924
,20160906,18330,18345,18275,18380,18145,18200,18250,-145,-95,560,"5,111.29",5848
,20160907,18200,18250,18115,18235,18040,18160,18140,-90,-110,366,"3,320.12",5876
,20160908,18160,18140,18225,18280,17940,17980,18080,-160,-60,856,"7,738.26",5648
,20160909,17980,18080,17980,18145,17880,18100,18045,20,-35,414,"3,735.40",5620
,20160912,18100,18045,18025,18075,17640,17680,17765,-365,-280,992,"8,811.78",5608
,20160913,17680,17765,17710,17820,17625,17725,17715,-40,-50,440,"3,897.65",5696
,20160914,17725,17715,17740,17770,17455,17530,17550,-185,-165,694,"6,090.68",5614
,20160919,17530,17550,17490,17610,17400,17445,17470,-105,-80,980,"8,561.31",5662
,20160920,17445,17470,17495,17880,17495,17840,17790,370,320,1026,"9,126.87",5744
,20160921,17840,17790,17935,18080,17855,17885,17945,95,155,2358,"21,159.89",6852
,20160922,17885,17945,17890,18000,17700,17900,17925,-45,-20,2226,"19,954.04",7794
,20160923,17900,17925,17965,18050,17865,17945,17940,20,15,1292,"11,589.80",7988
,20160926,17945,17940,17900,17915,17610,17660,17735,-280,-205,910,"8,071.11",8150
,20160927,17660,17735,17695,18060,17675,18030,17840,295,105,1806,"16,113.13",8496
,20160928,18030,17840,18100,18105,17950,18035,18025,195,185,868,"7,824.27",8456
,20160929,18035,18025,18010,18290,18010,18170,18205,145,180,2954,"26,893.94",9536
,20160930,18170,18205,18235,18325,18145,18295,18205,90,0,2724,"24,800.70",11034
,20161010,18295,18205,18175,18460,18050,18400,18245,195,40,1072,"9,780.50",11192
,20161011,18400,18245,18320,18365,18095,18160,18180,-85,-65,2734,"24,857.37",11890
,20161012,18160,18180,18030,18030,17720,17815,17820,-365,-360,5284,"47,080.78",13262
,20161013,17815,17820,17855,17950,17695,17750,17820,-70,0,4862,"43,328.26",15296
,20161014,17750,17820,17630,17880,17510,17790,17715,-30,-105,2846,"25,211.80",15786
,20161017,17790,17715,17815,18050,17805,17960,17910,245,195,5046,"45,198.48",17544
,20161018,17960,17910,17990,18250,17880,18195,18035,285,125,7294,"65,791.69",20310
,20161019,18195,18035,18195,18265,18070,18115,18165,80,130,7208,"65,471.47",22746
,20161020,18115,18165,18115,18345,18000,18230,18215,65,50,11806,"107,534.86",24880
,20161021,18230,18215,18200,18250,18095,18170,18180,-45,-35,7460,"67,811.45",25240
,20161024,18170,18180,18095,18190,18010,18145,18105,-35,-75,12284,"111,230.55",25242
,20161025,18145,18105,18200,19010,18200,18950,18690,845,585,33930,"317,108.88",33320
,20161026,18950,18690,18985,19070,18690,18835,18835,145,145,18482,"174,082.04",36720
,20161027,18835,18835,18810,18955,18665,18830,18810,-5,-25,18576,"174,753.70",39612
,20161028,18830,18810,18890,19130,18805,19050,18990,240,180,23916,"227,103.06",44338
,20161031,19050,18990,19130,19350,19035,19295,19180,305,190,34782,"333,601.75",51010
,20161101,19295,19180,19350,19980,19280,19705,19740,525,560,79288,"782,716.38",62402
,20161102,19705,19740,19665,19735,19255,19350,19510,-390,-230,56904,"555,169.55",69474
,20161103,19350,19510,19350,19660,19240,19615,19435,105,-75,43358,"421,353.51",74360
,20161104,19615,19435,19660,19975,19520,19725,19755,290,320,69520,"686,844.05",75404
,20161107,19725,19755,19645,20185,19545,20045,19855,290,100,81660,"810,826.08",72076
,20161108,20045,19855,19995,20100,19735,19825,19920,-30,65,73046,"727,667.41",70454
,20161109,19825,19920,19815,20375,19600,19800,19925,-120,5,98496,"981,410.04",74502
,20161110,19800,19925,19895,20910,19750,20815,20375,890,450,155588,"1,585,395.31",86664
,20161111,20815,20375,20800,21000,20425,20870,20675,495,300,118990,"1,230,346.69",86432
,20161114,20870,20675,20785,21740,20000,21255,20820,580,145,212874,"2,216,421.05",91672
,20161115,21255,20820,21125,22065,20850,21105,21425,285,605,157650,"1,688,933.49",100124
,20161116,21105,21425,21035,21755,20860,21240,21320,-185,-105,123538,"1,317,096.08",101300
,20161117,21240,21320,21215,21305,20240,20555,20745,-765,-575,94984,"985,235.71",99458
,20161118,20555,20745,20595,20900,20475,20890,20665,145,-80,71878,"742,695.28",101788
,20161121,20890,20665,20970,21440,20680,21335,21120,670,455,124738,"1,317,315.49",113542
,20161122,21335,21120,21295,21840,20875,21760,21515,640,395,116406,"1,252,254.71",119836
,20161123,21760,21515,21670,21760,21360,21560,21540,45,25,90092,"970,450.37",121272
,20161124,21560,21540,21450,22830,21360,22555,22265,1015,725,206240,"2,296,424.12",132514
,20161125,22555,22265,22500,23085,22480,23055,22830,790,565,172496,"1,969,221.95",151432
,20161128,23055,22830,23080,24425,23015,24425,23825,1595,995,191702,"2,283,824.07",172020
,20161129,24425,23825,24260,25180,23560,23785,24295,-40,470,382394,"4,645,354.57",183642
,20161130,23785,24295,24000,24020,22590,22590,23075,-1705,-1220,441120,"5,090,083.59",176872
,20161201,22590,23075,22685,23230,22380,22940,22830,-135,-245,448810,"5,123,276.87",191382
,20161202,22940,22830,23020,23205,22010,22350,22645,-480,-185,507434,"5,746,054.70",195386
,20161205,22350,22645,22170,22870,22070,22710,22480,65,-165,606052,"6,813,156.62",228462
,20161206,22710,22480,22750,23470,22750,22905,23050,425,570,699708,"8,065,429.13",241980
,20161207,22905,23050,22925,23525,22805,23310,23185,260,135,669040,"7,757,106.81",250362
,20161208,23310,23185,23460,23735,22580,22850,23120,-335,-65,702104,"8,117,690.34",245226
,20161209,22850,23120,23000,23075,22160,22615,22510,-505,-610,734204,"8,264,317.32",233912
,20161212,22615,22510,22650,22985,22315,22370,22670,-140,160,597642,"6,774,458.50",240086
,20161213,22370,22670,22520,22720,22230,22600,22490,-70,-180,577424,"6,493,988.57",226062
,20161214,22600,22490,22800,22845,21890,22485,22410,-5,-80,545890,"6,117,440.07",227840
,20161215,22485,22410,22635,23150,22310,22930,22730,520,320,624952,"7,103,613.50",231896
,20161216,22930,22730,22725,23150,22350,22615,22745,-115,15,538082,"6,119,794.83",215244
,20161219,22615,22745,22440,22575,21500,21550,22195,-1195,-550,588708,"6,533,190.75",211528
,20161220,21550,22195,21450,21535,20740,20990,21110,-1205,-1085,618812,"6,531,641.24",195482
,20161221,20990,21110,21205,21490,21125,21320,21295,210,185,402546,"4,286,433.95",194150
,20161222,21320,21295,21280,21355,20690,20830,21075,-465,-220,406682,"4,286,099.40",189448
,20161223,20830,21075,20770,21390,20755,21260,21155,185,80,581860,"6,155,953.12",188838
,20161226,21260,21155,21145,21255,19670,19805,20375,-1350,-780,615064,"6,266,119.56",168268
,20161227,19805,20375,19810,20325,19730,20265,19985,-110,-390,448214,"4,479,078.04",144844
,20161228,20265,19985,20250,21095,20080,20600,20630,615,645,576358,"5,946,154.04",135974
,20161229,20600,20630,20760,21260,20530,21050,20935,420,305,501280,"5,248,336.94",129694
,20161230,21050,20935,20980,21095,20565,20995,20835,60,-100,408530,"4,256,742.76",113984
zn1703,20160316,14490,14490,14110,14320,14065,14065,14180,-425,-310,14,99.27,6
,20160317,14065,14180,14285,14285,14285,14285,14285,105,105,2,14.29,6
,20160318,14285,14285,14600,14745,14550,14555,14640,270,355,12,87.85,12
,20160321,14555,14640,14505,14505,14505,14505,14505,-135,-135,2,14.51,14
,20160322,14505,14505,14610,14610,14610,14610,14610,105,105,2,14.61,16
,20160323,14610,14610,14610,14610,14610,14610,14610,0,0,2,14.61,16
,20160324,14610,14610,14520,14535,14500,14535,14515,-75,-95,6,43.56,12
,20160325,14535,14515,,,,14405,14405,-110,-110,0,0.00,12
,20160328,14405,14405,,,,14475,14475,70,70,0,0.00,12
,20160329,14475,14475,14320,14320,14320,14320,14320,-155,-155,40,286.40,52
,20160330,14320,14320,14375,14375,14250,14250,14325,-70,5,10,71.63,52
,20160331,14250,14325,14350,14350,14250,14250,14310,-75,-15,34,243.27,66
,20160401,14250,14310,14535,14535,14445,14445,14490,135,180,4,28.98,70
,20160405,14445,14490,,,,14555,14555,65,65,0,0.00,70
,20160406,14555,14555,14650,14650,14485,14485,14565,-70,10,6,43.70,72
,20160407,14485,14565,,,,14440,14440,-125,-125,0,0.00,72
,20160408,14440,14440,14135,14165,14080,14080,14115,-360,-325,10,70.59,72
,20160411,14080,14115,14145,14215,14145,14185,14180,70,65,10,70.90,76
,20160412,14185,14180,14165,14255,14155,14255,14190,75,10,12,85.17,72
,20160413,14255,14190,14450,14895,14275,14895,14690,705,500,48,352.67,82
,20160414,14895,14690,14905,15095,14830,14830,14945,140,255,14,104.62,82
,20160415,14830,14945,14905,14940,14905,14940,14920,-5,-25,4,29.85,82
,20160418,14940,14920,14895,15130,14895,15130,15010,210,90,4,30.03,84
,20160419,15130,15010,15080,15080,15080,15080,15080,70,70,2,15.08,86
,20160420,15080,15080,15350,15360,15320,15320,15335,240,255,20,153.40,98
,20160421,15320,15335,15270,15270,15270,15270,15270,-65,-65,2,15.27,98
,20160422,15270,15270,14960,15255,14960,15255,15140,-15,-130,14,106.00,96
,20160425,15255,15140,15440,15440,15165,15205,15225,65,85,14,106.58,106
,20160426,15205,15225,15150,15150,15150,15150,15150,-75,-75,2,15.15,104
,20160427,15150,15150,15055,15055,15055,15055,15055,-95,-95,4,30.11,102
,20160428,15055,15055,15045,15045,14995,14995,15020,-60,-35,4,30.04,104
,20160429,14995,15020,,,,15360,15360,340,340,0,0.00,104
,20160503,15360,15360,,,,15360,15360,0,0,0,0.00,104
,20160504,15360,15360,15115,15115,15115,15115,15115,-245,-245,4,30.23,106
,20160505,15115,15115,,,,15115,15115,0,0,0,0.00,106
,20160506,15115,15115,14925,14925,14875,14875,14900,-240,-215,4,29.80,108
,20160509,14875,14900,14825,14825,14765,14765,14795,-135,-105,4,29.59,106
,20160510,14765,14795,14815,14815,14665,14665,14725,-130,-70,18,132.56,108
,20160511,14665,14725,14850,14920,14850,14900,14865,175,140,16,118.92,102
,20160512,14900,14865,15155,15330,15130,15250,15215,385,350,14,106.53,110
,20160513,15250,15215,15240,15240,15010,15015,15055,-200,-160,10,75.29,110
,20160516,15015,15055,,,,15130,15130,75,75,0,0.00,110
,20160517,15130,15130,15155,15225,15155,15185,15185,55,55,16,121.51,112
,20160518,15185,15185,,,,15185,15185,0,0,0,0.00,112
,20160519,15185,15185,15115,15115,15100,15100,15105,-85,-80,4,30.22,112
,20160520,15100,15105,15000,15000,15000,15000,15000,-105,-105,4,30.00,110
,20160523,15000,15000,15075,15075,14900,14900,14970,-100,-30,8,59.88,110
,20160524,14900,14970,14825,14825,14800,14800,14810,-170,-160,8,59.25,106
,20160525,14800,14810,14700,14700,14700,14700,14700,-110,-110,2,14.70,104
,20160526,14700,14700,14750,15105,14750,15105,14845,405,145,30,222.72,112
,20160527,15105,14845,15045,15045,15035,15035,15040,190,195,4,30.08,112
,20160530,15035,15040,,,,15040,15040,0,0,0,0.00,112
,20160531,15040,15040,,,,15040,15040,0,0,0,0.00,112
,20160601,15040,15040,15205,15205,15125,15145,15185,105,145,26,197.46,126
,20160602,15145,15185,15080,15560,15080,15560,15355,375,170,8,61.43,126
,20160603,15560,15355,15665,15670,15590,15660,15635,305,280,26,203.26,140
,20160606,15660,15635,15825,15880,15590,15880,15700,245,65,82,643.80,158
,20160607,15880,15700,15850,16115,15760,15785,15865,85,165,24,190.38,146
,20160608,15785,15865,15675,15675,15675,15675,15675,-190,-190,2,15.68,146
,20160613,15675,15675,15945,16150,15920,16150,15955,475,280,26,207.44,148
,20160614,16150,15955,16035,16035,15880,15880,15955,-75,0,6,47.87,150
,20160615,15880,15955,15805,15825,15805,15825,15810,-130,-145,6,47.44,152
,20160616,15825,15810,,,,15810,15810,0,0,0,0.00,152
,20160617,15810,15810,15670,15905,15590,15785,15735,-25,-75,74,582.29,150
,20160620,15785,15735,15690,15760,15690,15760,15725,25,-10,18,141.55,146
,20160621,15760,15725,15815,15815,15815,15815,15815,90,90,2,15.82,146
,20160622,15815,15815,15830,15830,15830,15830,15830,15,15,2,15.83,146
,20160623,15830,15830,15905,15905,15905,15905,15905,75,75,8,63.62,148
,20160624,15905,15905,15895,15895,15695,15695,15795,-210,-110,4,31.59,148
,20160627,15695,15795,,,,15795,15795,0,0,0,0.00,148
,20160628,15795,15795,,,,15795,15795,0,0,0,0.00,148
,20160629,15795,15795,16270,16295,16170,16290,16255,495,460,28,227.64,156
,20160630,16290,16255,16295,16645,16270,16490,16445,235,190,28,230.29,146
,20160701,16490,16445,16520,16520,16520,16520,16520,75,75,2,16.52,144
,20160704,16520,16520,16760,17065,16760,16845,16855,325,335,32,269.74,152
,20160705,16845,16855,16805,16805,16465,16540,16595,-315,-260,30,248.97,154
,20160706,16540,16595,16430,16430,16430,16430,16430,-165,-165,2,16.43,154
,20160707,16430,16430,16375,16665,16375,16585,16475,155,45,34,280.14,140
,20160708,16585,16475,16520,16525,16375,16460,16430,-15,-45,64,525.90,132
,20160711,16460,16430,16710,16900,16710,16815,16805,385,375,6,50.43,130
,20160712,16815,16805,,,,16805,16805,0,0,0,0.00,130
,20160713,16805,16805,16985,17315,16985,16990,17080,185,275,18,153.75,138
,20160714,16990,17080,17020,17025,16955,16955,16980,-125,-100,14,118.89,138
,20160715,16955,16980,17200,17200,17160,17160,17185,180,205,8,68.75,140
,20160718,17160,17185,17295,17295,17025,17140,17160,-45,-25,46,394.68,148
,20160719,17140,17160,17080,17425,17050,17240,17190,80,30,40,343.86,132
,20160720,17240,17190,17325,17375,17325,17325,17345,135,155,16,138.80,124
,20160721,17325,17345,17175,17340,17170,17340,17230,-5,-115,8,68.93,126
,20160722,17340,17230,17300,17655,17300,17455,17570,225,340,60,527.16,120
,20160725,17455,17570,17490,17550,17465,17550,17530,-20,-40,136,"1,192.31",222
,20160726,17550,17530,17530,17530,17305,17310,17440,-220,-90,80,697.69,168
,20160727,17310,17440,17305,17305,17185,17185,17260,-255,-180,84,724.96,176
,20160728,17185,17260,17135,17135,16910,17090,17060,-170,-200,54,460.70,196
,20160729,17090,17060,17030,17030,17030,17030,17030,-30,-30,2,17.03,198
,20160801,17030,17030,17165,17530,17130,17530,17340,500,310,36,312.20,196
,20160802,17530,17340,17500,17555,17460,17555,17515,215,175,24,210.19,188
,20160803,17555,17515,17620,17630,17590,17625,17610,110,95,30,264.22,168
,20160804,17625,17610,,,,17455,17455,-155,-155,0,0.00,168
,20160805,17455,17455,17380,17540,17380,17540,17450,85,-5,10,87.26,170
,20160808,17540,17450,,,,17450,17450,0,0,0,0.00,170
,20160809,17450,17450,17465,17495,17465,17495,17480,45,30,4,34.96,170
,20160810,17495,17480,17420,17820,17420,17820,17790,340,310,112,996.33,268
,20160811,17820,17790,18045,18045,17890,17890,17965,100,175,4,35.94,266
,20160812,17890,17965,17620,17670,17620,17670,17645,-295,-320,4,35.29,266
,20160815,17670,17645,17510,17510,17285,17285,17390,-360,-255,14,121.75,264
,20160816,17285,17390,17305,17435,17305,17435,17335,45,-55,32,277.40,284
,20160817,17435,17335,17350,17390,17350,17390,17370,55,35,4,34.74,280
,20160818,17390,17370,17370,17615,17370,17580,17460,210,90,20,174.63,284
,20160819,17580,17460,17545,17580,17500,17550,17540,90,80,36,315.73,288
,20160822,17550,17540,17510,17605,17510,17510,17570,-30,30,36,316.32,294
,20160823,17510,17570,17505,17680,17505,17665,17635,95,65,126,"1,111.12",388
,20160824,17665,17635,17630,17665,17600,17630,17630,-5,-5,66,581.86,432
,20160825,17630,17630,17665,17665,17220,17350,17450,-280,-180,42,366.49,442
,20160826,17350,17450,17475,17830,17475,17780,17740,330,290,78,691.93,450
,20160829,17780,17740,17795,17830,17735,17800,17780,60,40,34,302.33,466
,20160830,17800,17780,17690,17775,17650,17700,17720,-80,-60,116,"1,027.88",390
,20160831,17700,17720,17970,17970,17815,17815,17935,95,215,464,"4,161.03",588
,20160901,17815,17935,18025,18185,18020,18180,18045,245,110,60,541.41,596
,20160902,18180,18045,18140,18335,18105,18335,18165,290,120,48,435.99,618
,20160905,18335,18165,18335,18400,18190,18345,18310,180,145,42,384.58,620
,20160906,18345,18310,18250,18350,18130,18130,18280,-180,-30,108,987.26,686
,20160907,18130,18280,18100,18150,18030,18150,18095,-130,-185,8,72.39,688
,20160908,18150,18095,18205,18205,17995,17995,18070,-100,-25,12,108.44,688
,20160909,17995,18070,18015,18015,18015,18015,18015,-55,-55,2,18.02,688
,20160912,18015,18015,18075,18075,17640,17640,17970,-375,-45,26,233.63,702
,20160913,17640,17970,17710,17770,17600,17705,17715,-265,-255,16,141.72,710
,20160914,17705,17715,17550,17600,17455,17455,17525,-260,-190,42,368.10,738
,20160919,17455,17525,17510,17510,17395,17395,17465,-130,-60,56,489.09,734
,20160920,17395,17465,17690,17850,17665,17820,17795,355,330,110,978.85,766
,20160921,17820,17795,17910,18060,17860,17950,17945,155,150,98,879.31,788
,20160922,17950,17945,17890,17995,17690,17890,17830,-55,-115,1198,"10,680.79",1266
,20160923,17890,17830,17960,18075,17910,17940,17975,110,145,314,"2,822.73",1400
,20160926,17940,17975,17900,17900,17620,17630,17665,-345,-310,404,"3,568.87",1508
,20160927,17630,17665,17695,18005,17670,18005,17795,340,130,100,889.87,1494
,20160928,18005,17795,18005,18060,18000,18030,18010,235,215,38,342.26,1504
,20160929,18030,18010,18070,18285,18070,18185,18225,175,215,210,"1,913.70",1588
,20160930,18185,18225,18255,18300,18155,18300,18245,75,20,116,"1,058.47",1638
,20161010,18300,18245,18185,18450,18065,18450,18270,205,25,140,"1,279.11",1738
,20161011,18450,18270,18305,18320,18110,18145,18180,-125,-90,418,"3,799.78",1922
,20161012,18145,18180,17980,17980,17715,17805,17800,-375,-380,1882,"16,752.95",3174
,20161013,17805,17800,17870,17920,17700,17715,17780,-85,-20,1306,"11,611.15",3916
,20161014,17715,17780,17620,17865,17520,17790,17755,10,-25,446,"3,960.37",4030
,20161017,17790,17755,17825,18020,17820,17995,17900,240,145,638,"5,710.48",4288
,20161018,17995,17900,18015,18250,17900,18200,18045,300,145,746,"6,731.49",4506
,20161019,18200,18045,18205,18250,18065,18125,18140,80,95,272,"2,467.72",4498
,20161020,18125,18140,18160,18330,18010,18260,18225,120,85,2282,"20,800.26",6348
,20161021,18260,18225,18150,18220,18085,18145,18150,-80,-75,436,"3,957.45",6408
,20161024,18145,18150,18035,18175,18000,18150,18085,0,-65,1282,"11,592.74",7500
,20161025,18150,18085,18250,18965,18240,18920,18675,835,590,2154,"20,115.98",8142
,20161026,18920,18675,18995,19035,18695,18835,18820,160,145,1570,"14,775.09",8714
,20161027,18835,18820,18775,18930,18700,18840,18815,20,-5,748,"7,037.23",8894
,20161028,18840,18815,18855,19100,18795,19055,18880,240,65,3878,"36,614.36",11094
,20161031,19055,18880,19105,19325,19015,19280,19175,400,295,4574,"43,855.10",13216
,20161101,19280,19175,19300,19935,19275,19700,19750,525,575,9940,"98,161.78",16390
,20161102,19700,19750,19675,19710,19250,19330,19470,-420,-280,10060,"97,935.79",19010
,20161103,19330,19470,19330,19640,19235,19610,19425,140,-45,6210,"60,319.49",18974
,20161104,19610,19425,19610,19955,19515,19705,19740,280,315,10316,"101,822.00",19522
,20161107,19705,19740,19685,20170,19540,20005,19840,265,100,13848,"137,378.63",18956
,20161108,20005,19840,19950,20070,19715,19795,19895,-45,55,18150,"180,591.98",18442
,20161109,19795,19895,19795,20330,19550,19725,19940,-170,45,23058,"229,942.17",19436
,20161110,19725,19940,19785,20865,19780,20760,20405,820,465,43780,"446,698.22",25562
,20161111,20760,20405,20715,20890,20390,20850,20650,445,245,22230,"229,550.70",24976
,20161114,20850,20650,20715,21705,19990,21220,20835,570,185,36790,"383,314.18",29088
,20161115,21220,20835,20950,22085,20800,21100,21495,265,660,32096,"344,993.00",32006
,20161116,21100,21495,21065,21720,20855,21240,21275,-255,-220,15596,"165,918.08",32442
,20161117,21240,21275,21185,21275,20205,20530,20740,-745,-535,17734,"183,906.61",31456
,20161118,20530,20740,20565,20875,20460,20875,20625,135,-115,12990,"133,961.49",33104
,20161121,20875,20625,20990,21415,20680,21295,21100,670,475,15562,"164,184.58",34130
,20161122,21295,21100,21295,21815,21070,21735,21525,635,425,13808,"148,633.83",34358
,20161123,21735,21525,21705,21730,21330,21515,21500,-10,-25,13004,"139,801.72",35452
,20161124,21515,21500,21480,22790,21335,22520,22290,1020,790,39534,"440,700.39",42078
,20161125,22520,22290,22485,23060,22440,23020,22790,730,500,26662,"303,828.28",42840
,20161128,23020,22790,23295,24385,22985,24385,23885,1595,1095,29978,"358,076.64",44990
,20161129,24385,23885,24385,25300,23580,23765,24290,-120,405,105318,"1,279,218.51",63712
,20161130,23765,24290,24075,24075,22585,22585,23065,-1705,-1225,116022,"1,338,119.24",72936
,20161201,22585,23065,22700,23210,22255,22930,22850,-135,-215,71786,"820,266.19",73632
,20161202,22930,22850,23025,23195,22015,22360,22510,-490,-340,60884,"685,378.48",73758
,20161205,22360,22510,22190,22880,22070,22660,22480,150,-30,57034,"641,068.12",78146
,20161206,22660,22480,22740,23475,22740,22900,23090,420,610,61182,"706,406.00",86878
,20161207,22900,23090,22950,23530,22820,23330,23200,240,110,58898,"683,290.07",94224
,20161208,23330,23200,23490,23750,22655,22855,23095,-345,-105,63862,"737,599.71",94234
,20161209,22855,23095,23005,23080,22165,22590,22515,-505,-580,82122,"924,515.73",100810
,20161212,22590,22515,22640,22995,22340,22425,22685,-90,170,69308,"786,233.45",101652
,20161213,22425,22685,22535,22740,22285,22620,22505,-65,-180,73410,"826,211.90",103002
,20161214,22620,22505,22790,22855,22055,22525,22440,20,-65,83402,"935,978.86",107452
,20161215,22525,22440,22670,23195,22350,23000,22835,560,395,118700,"1,355,334.55",117738
,20161216,23000,22835,22815,23210,22455,22700,22780,-135,-55,96234,"1,096,151.56",120140
,20161219,22700,22780,22500,22650,21620,21625,22220,-1155,-560,146828,"1,631,616.82",121986
,20161220,21625,22220,21500,21585,20805,21080,21170,-1140,-1050,151864,"1,607,628.70",127702
,20161221,21080,21170,21255,21565,21200,21385,21395,215,225,100306,"1,073,031.07",131718
,20161222,21385,21395,21340,21435,20775,20900,21125,-495,-270,102428,"1,081,976.67",141534
,20161223,20900,21125,20870,21475,20835,21330,21220,205,95,154670,"1,641,314.37",151202
,20161226,21330,21220,21220,21320,19730,19865,20305,-1355,-915,230840,"2,343,863.06",142352
,20161227,19865,20305,19840,20375,19805,20320,20070,15,-235,169252,"1,698,709.32",152048
,20161228,20320,20070,20295,21160,20150,20650,20710,580,640,295452,"3,059,910.75",154670
,20161229,20650,20710,20790,21500,20600,21095,21015,385,305,285888,"3,004,625.12",169946
,20161230,21095,21015,21015,21135,20635,21045,20895,30,-120,269094,"2,811,380.54",172370
zn1704,20160418,14920,14920,14980,15070,14975,14975,15000,55,80,10,75.01,6
,20160419,14975,15000,,,,15000,15000,0,0,0,0.00,6
,20160420,15000,15000,,,,15000,15000,0,0,0,0.00,6
,20160421,15000,15000,15325,15325,15325,15325,15325,325,325,2,15.33,4
,20160422,15325,15325,,,,15325,15325,0,0,0,0.00,4
,20160425,15325,15325,,,,15325,15325,0,0,0,0.00,4
,20160426,15325,15325,,,,15325,15325,0,0,0,0.00,4
,20160427,15325,15325,,,,15325,15325,0,0,0,0.00,4
,20160428,15325,15325,15055,15230,14990,15230,15055,-95,-270,14,105.39,8
,20160429,15230,15055,15235,15405,15235,15385,15340,330,285,16,122.74,16
,20160503,15385,15340,,,,15340,15340,0,0,0,0.00,16
,20160504,15340,15340,15335,15335,15315,15315,15320,-25,-20,8,61.30,10
,20160505,15315,15320,15020,15040,15020,15040,15030,-280,-290,6,45.10,10
,20160506,15040,15030,14975,15015,14885,14890,14955,-140,-75,14,104.71,12
,20160509,14890,14955,14860,14860,14825,14825,14840,-130,-115,4,29.69,10
,20160510,14825,14840,,,,14840,14840,0,0,0,0.00,10
,20160511,14840,14840,,,,14840,14840,0,0,0,0.00,10
,20160512,14840,14840,15155,15310,15055,15310,15175,470,335,8,60.71,14
,20160513,15310,15175,15130,15130,14865,14865,15015,-310,-160,40,300.31,42
,20160516,14865,15015,15060,15200,15060,15200,15140,185,125,6,45.43,40
,20160517,15200,15140,15185,15220,15185,15220,15190,80,50,10,75.96,44
,20160518,15220,15190,15245,15245,15245,15245,15245,55,55,4,30.49,46
,20160519,15245,15245,15240,15260,15075,15075,15190,-170,-55,18,136.73,50
,20160520,15075,15190,15105,15105,15105,15105,15105,-85,-85,2,15.11,48
,20160523,15105,15105,15190,15195,15190,15195,15190,90,85,4,30.39,48
,20160524,15195,15190,,,,15030,15030,-160,-160,0,0.00,48
,20160525,15030,15030,14720,14790,14720,14730,14740,-300,-290,8,58.96,50
,20160526,14730,14740,14845,15050,14845,15050,14965,310,225,10,74.84,58
,20160527,15050,14965,15140,15145,15035,15095,15080,130,115,22,165.91,66
,20160530,15095,15080,15170,15185,15095,15120,15130,40,50,16,121.06,66
,20160531,15120,15130,,,,15130,15130,0,0,0,0.00,66
,20160601,15130,15130,15275,15275,15025,15045,15135,-85,5,30,227.05,86
,20160602,15045,15135,15090,15745,15090,15705,15455,570,320,84,649.26,118
,20160603,15705,15455,15685,15730,15555,15730,15645,275,190,34,265.97,122
,20160606,15730,15645,15870,15970,15750,15830,15885,185,240,70,556.10,154
,20160607,15830,15885,15890,15935,15765,15795,15840,-90,-45,26,205.96,150
,20160608,15795,15840,15660,15765,15660,15715,15730,-125,-110,54,424.82,134
,20160613,15715,15730,15880,15980,15880,15930,15930,200,200,8,63.74,140
,20160614,15930,15930,15985,15985,15870,15870,15900,-60,-30,8,63.60,144
,20160615,15870,15900,15850,15850,15730,15840,15790,-60,-110,236,"1,863.50",350
,20160616,15840,15790,,,,15790,15790,0,0,0,0.00,350
,20160617,15790,15790,15700,15800,15605,15775,15715,-15,-75,38,298.67,356
,20160620,15775,15715,15760,15795,15690,15795,15735,80,20,30,236.09,346
,20160621,15795,15735,15755,15940,15735,15940,15815,205,80,18,142.36,348
,20160622,15940,15815,15735,15905,15735,15895,15875,80,60,28,222.30,336
,20160623,15895,15875,15970,15970,15910,15910,15940,35,65,22,175.38,328
,20160624,15910,15940,,,,15825,15825,-115,-115,0,0.00,328
,20160627,15825,15825,,,,15825,15825,0,0,0,0.00,328
,20160628,15825,15825,16055,16055,16055,16055,16055,230,230,10,80.28,338
,20160629,16055,16055,16305,16400,16200,16290,16265,235,210,14,113.89,336
,20160630,16290,16265,16395,16590,16395,16540,16535,275,270,26,214.96,340
,20160701,16540,16535,16450,16600,16450,16600,16525,65,-10,4,33.05,338
,20160704,16600,16525,16725,17010,16705,16970,16925,445,400,368,"3,114.39",334
,20160705,16970,16925,16630,16630,16630,16630,16630,-295,-295,2,16.63,332
,20160706,16630,16630,16475,16665,16430,16665,16480,35,-150,12,98.88,328
,20160707,16665,16480,16375,16615,16340,16580,16580,100,100,60,497.52,352
,20160708,16580,16580,16570,16605,16405,16590,16480,10,-100,108,890.09,338
,20160711,16590,16480,16710,16955,16660,16905,16775,425,295,64,536.84,334
,20160712,16905,16775,16890,16955,16775,16880,16870,105,95,64,540.00,334
,20160713,16880,16870,17125,17305,17110,17140,17175,270,305,60,515.38,314
,20160714,17140,17175,17095,17095,17075,17075,17090,-100,-85,8,68.36,318
,20160715,17075,17090,17145,17145,17010,17125,17070,35,-20,48,409.73,344
,20160718,17125,17070,17320,17320,16995,17090,17165,20,95,50,429.15,344
,20160719,17090,17165,17090,17375,17020,17020,17215,-145,50,36,309.91,348
,20160720,17020,17215,17325,17330,17245,17320,17305,105,90,18,155.75,342
,20160721,17320,17305,17405,17495,17405,17495,17450,190,145,4,34.90,342
,20160722,17495,17450,17505,17595,17465,17490,17490,40,40,30,262.41,358
,20160725,17490,17490,17500,17515,17410,17475,17460,-15,-30,30,261.97,342
,20160726,17475,17460,17435,17480,17350,17350,17445,-110,-15,88,767.64,332
,20160727,17350,17445,17320,17320,17145,17145,17255,-300,-190,6,51.78,336
,20160728,17145,17255,17140,17245,16670,17065,17090,-190,-165,148,"1,264.71",444
,20160729,17065,17090,17095,17185,17060,17060,17125,-30,35,28,239.80,444
,20160801,17060,17125,17200,17550,17200,17550,17465,425,340,58,506.62,436
,20160802,17550,17465,17515,17580,17445,17560,17500,95,35,42,367.57,440
,20160803,17560,17500,17630,17680,17420,17420,17600,-80,100,36,316.89,446
,20160804,17420,17600,17425,17505,17425,17505,17480,-95,-120,22,192.28,458
,20160805,17505,17480,17395,17575,17395,17555,17510,75,30,28,245.21,460
,20160808,17555,17510,17470,17610,17470,17610,17585,100,75,140,"1,231.29",530
,20160809,17610,17585,17640,17640,17420,17490,17515,-95,-70,86,753.30,522
,20160810,17490,17515,17425,17860,17425,17860,17580,345,65,34,298.92,538
,20160811,17860,17580,17880,17890,17725,17770,17775,190,195,46,408.84,564
,20160812,17770,17775,17675,17690,17655,17690,17675,-85,-100,12,106.05,568
,20160815,17690,17675,17490,17520,17380,17380,17460,-295,-215,38,331.76,564
,20160816,17380,17460,17325,17440,17325,17430,17400,-30,-60,18,156.60,560
,20160817,17430,17400,,,,17400,17400,0,0,0,0.00,560
,20160818,17400,17400,17400,17640,17400,17590,17540,190,140,28,245.60,578
,20160819,17590,17540,17630,17630,17530,17565,17580,25,40,52,457.13,562
,20160822,17565,17580,17540,17630,17480,17480,17565,-100,-15,28,245.95,566
,20160823,17480,17565,17535,17700,17535,17655,17655,90,90,90,794.69,572
,20160824,17655,17655,17670,17695,17635,17650,17665,-5,10,26,229.67,578
,20160825,17650,17665,17600,17600,17310,17400,17440,-265,-225,88,767.48,572
,20160826,17400,17440,17440,17850,17440,17815,17730,375,290,88,780.25,576
,20160829,17815,17730,17795,17915,17710,17770,17785,40,55,142,"1,263.02",584
,20160830,17770,17785,17705,18000,17645,17645,17725,-140,-60,44,390.06,574
,20160831,17645,17725,17860,17940,17760,17830,17850,105,125,26,232.06,584
,20160901,17830,17850,17810,18150,17810,18145,18075,295,225,70,632.68,558
,20160902,18145,18075,18095,18300,18095,18300,18230,225,155,6,54.70,556
,20160905,18300,18230,18400,18400,18295,18305,18325,75,95,32,293.21,542
,20160906,18305,18325,18270,18310,18030,18170,18140,-155,-185,62,562.40,530
,20160907,18170,18140,18110,18120,18025,18120,18085,-20,-55,34,307.47,530
,20160908,18120,18085,18225,18240,17860,17925,18050,-160,-35,56,505.50,518
,20160909,17925,18050,17860,18070,17860,18070,17965,20,-85,4,35.93,518
,20160912,18070,17965,17965,17965,17635,17635,17780,-330,-185,32,284.55,522
,20160913,17635,17780,17665,17795,17620,17670,17720,-110,-60,28,248.13,528
,20160914,17670,17720,17690,17730,17430,17430,17550,-290,-170,64,561.75,524
,20160919,17430,17550,17460,17500,17370,17445,17450,-105,-100,56,488.67,554
,20160920,17445,17450,17580,17800,17580,17800,17640,350,190,130,"1,146.80",534
,20160921,17800,17640,17895,18035,17885,17885,17955,245,315,38,341.17,532
,20160922,17885,17955,17820,17950,17670,17885,17775,-70,-180,154,"1,369.04",456
,20160923,17885,17775,17935,18035,17910,17910,17960,135,185,98,880.05,472
,20160926,17910,17960,17895,17905,17595,17595,17755,-365,-205,12,106.54,468
,20160927,17595,17755,17785,18025,17785,18025,17895,270,140,8,71.60,462
,20160928,18025,17895,18020,18020,18020,18020,18020,125,125,2,18.02,464
,20160929,18020,18020,18220,18250,18220,18250,18235,230,215,4,36.47,462
,20160930,18250,18235,18280,18280,18280,18280,18280,45,45,4,36.56,462
,20161010,18280,18280,18450,18450,18450,18450,18450,170,170,10,92.25,462
,20161011,18450,18450,18165,18170,18120,18130,18130,-320,-320,116,"1,051.56",544
,20161012,18130,18130,17940,17940,17730,17735,17800,-395,-330,122,"1,086.01",550
,20161013,17735,17800,17900,17920,17745,17745,17870,-55,70,56,500.38,564
,20161014,17745,17870,17595,18005,17550,17865,17760,-5,-110,46,408.59,582
,20161017,17865,17760,17885,17965,17860,17930,17920,170,160,76,681.12,600
,20161018,17930,17920,18095,18095,18095,18095,18095,175,175,2,18.10,598
,20161019,18095,18095,18265,18265,18130,18130,18175,35,80,20,181.77,608
,20161020,18130,18175,18105,18310,18010,18310,18145,135,-30,34,308.52,598
,20161021,18310,18145,18160,18205,18105,18105,18140,-40,-5,156,"1,415.26",588
,20161024,18105,18140,18105,18175,18000,18150,18050,10,-90,100,902.66,640
,20161025,18150,18050,18200,18945,18200,18905,18460,855,410,226,"2,086.22",592
,20161026,18905,18460,18915,18930,18745,18760,18830,300,370,32,301.36,608
,20161027,18760,18830,18775,18875,18505,18760,18730,-70,-100,10,93.67,610
,20161028,18760,18730,19000,19070,18935,19070,19025,340,295,18,171.23,610
,20161031,19070,19025,19115,19300,19060,19300,19130,275,105,116,"1,109.54",670
,20161101,19300,19130,19290,19935,19290,19695,19865,565,735,266,"2,642.60",682
,20161102,19695,19865,19655,19675,19255,19255,19450,-610,-415,458,"4,454.99",1002
,20161103,19255,19450,19275,19630,19250,19630,19425,180,-25,454,"4,410.12",1014
,20161104,19630,19425,19625,19890,19555,19630,19710,205,285,1270,"12,518.72",1920
,20161107,19630,19710,19590,20140,19555,20000,19830,290,120,428,"4,244.19",1920
,20161108,20000,19830,19905,20060,19770,19790,19920,-40,90,158,"1,574.01",1938
,20161109,19790,19920,19725,20310,19575,19750,19950,-170,30,314,"3,132.27",1978
,20161110,19750,19950,19845,20840,19800,20745,20460,795,510,1206,"12,337.71",2618
,20161111,20745,20460,20640,20830,20425,20830,20600,370,140,566,"5,830.33",2594
,20161114,20830,20600,20620,21685,19940,21165,21010,565,410,1060,"11,137.38",2636
,20161115,21165,21010,21145,22100,20780,20860,21715,-150,705,9182,"99,709.75",7670
,20161116,20860,21715,20925,21675,20835,21175,21280,-540,-435,4402,"46,847.59",8202
,20161117,21175,21280,21160,21230,20200,20500,20700,-780,-580,958,"9,915.42",8294
,20161118,20500,20700,20610,20830,20420,20805,20585,105,-115,1130,"11,630.98",8730
,20161121,20805,20585,20945,21360,20685,21280,21060,695,475,3154,"33,217.94",8820
,20161122,21280,21060,21320,21785,20000,21730,21490,670,430,1378,"14,808.77",9240
,20161123,21730,21490,21600,21675,21315,21500,21440,10,-50,4584,"49,144.50",10248
,20161124,21500,21440,21375,22725,21300,22440,22375,1000,935,7954,"88,996.68",12368
,20161125,22440,22375,22510,23025,22475,23000,22790,625,415,5034,"57,366.71",13984
,20161128,23000,22790,23050,24385,22980,24385,23695,1595,905,7610,"90,175.67",17524
,20161129,24385,23695,24245,25090,23555,23830,24145,135,450,11476,"138,559.52",19534
,20161130,23830,24145,23970,23970,22450,22495,23120,-1650,-1025,7756,"89,668.48",21316
,20161201,22495,23120,22495,23195,22310,22905,22830,-215,-290,19080,"217,806.21",25750
,20161202,22905,22830,22905,23160,21985,22285,22735,-545,-95,12728,"144,699.91",31690
,20161205,22285,22735,22250,22870,22050,22720,22350,-15,-385,9844,"110,011.85",32676
,20161206,22720,22350,22720,23450,22720,22905,23030,555,680,12858,"148,071.02",36860
,20161207,22905,23030,22905,23520,22810,23330,23185,300,155,6224,"72,159.22",37092
,20161208,23330,23185,23445,23740,22665,22840,23170,-345,-15,9242,"107,090.98",38264
,20161209,22840,23170,22895,23070,22195,22590,22515,-580,-655,10972,"123,521.67",38842
,20161212,22590,22515,22590,23000,22355,22425,22765,-90,250,7850,"89,370.34",39820
,20161213,22425,22765,22470,22765,22320,22635,22520,-130,-245,13180,"148,412.77",41246
,20161214,22635,22520,22720,22885,22000,22575,22485,55,-35,10802,"121,447.16",43538
,20161215,22575,22485,22765,23220,22380,23050,22890,565,405,13162,"150,648.15",45996
,20161216,23050,22890,22845,23215,22490,22695,22855,-195,-35,9202,"105,171.99",47352
,20161219,22695,22855,22455,22675,21660,21660,22250,-1195,-605,20962,"233,230.56",47322
,20161220,21660,22250,21650,21650,20840,21090,21185,-1160,-1065,25118,"266,088.69",47624
,20161221,21090,21185,21225,21590,21220,21420,21410,235,225,19008,"203,490.43",51032
,20161222,21420,21410,21300,21455,20810,20940,21125,-470,-285,18338,"193,704.60",53524
,20161223,20940,21125,20820,21490,20820,21365,21215,240,90,27650,"293,321.88",56050
,20161226,21365,21215,21295,21335,19730,19910,20335,-1305,-880,28060,"285,358.40",56248
,20161227,19910,20335,19665,20400,19665,20355,20105,20,-230,28650,"288,038.06",58484
,20161228,20355,20105,20480,21165,20165,20680,20780,575,675,40568,"421,511.06",66696
,20161229,20680,20780,20815,21340,20585,21170,21025,390,245,25274,"265,747.85",71802
,20161230,21170,21025,21130,21130,20645,21000,20905,-25,-120,20868,"218,152.57",73172
zn1705,20160517,15140,15140,,,,15140,15140,0,0,0,0.00,0
,20160518,15140,15140,,,,15140,15140,0,0,0,0.00,0
,20160519,15140,15140,15255,15325,15080,15080,15220,-60,80,30,228.31,26
,20160520,15080,15220,15050,15050,15050,15050,15050,-170,-170,2,15.05,28
,20160523,15050,15050,15195,15230,15085,15085,15175,35,125,16,121.42,32
,20160524,15085,15175,14950,14950,14950,14950,14950,-225,-225,2,14.95,34
,20160525,14950,14950,14735,14810,14670,14725,14720,-225,-230,28,206.10,38
,20160526,14725,14720,14990,14990,14990,14990,14990,270,270,6,44.97,44
,20160527,14990,14990,15160,15185,15000,15185,15060,195,70,20,150.65,56
,20160530,15185,15060,15100,15125,15100,15125,15105,65,45,6,45.33,56
,20160531,15125,15105,,,,15105,15105,0,0,0,0.00,56
,20160601,15105,15105,15255,15255,15165,15165,15225,60,120,10,76.13,64
,20160602,15165,15225,15145,15815,15145,15740,15550,515,325,40,311.09,80
,20160603,15740,15550,15690,15730,15555,15685,15635,135,85,56,437.83,96
,20160606,15685,15635,15845,15990,15625,15915,15855,280,220,246,"1,950.72",182
,20160607,15915,15855,15905,16010,15845,15845,15925,-10,70,20,159.29,180
,20160608,15845,15925,15750,15810,15605,15725,15725,-200,-200,68,534.69,166
,20160613,15725,15725,15995,15995,15955,15965,15965,240,240,56,447.03,188
,20160614,15965,15965,15995,16050,15855,15910,15950,-55,-15,16,127.64,196
,20160615,15910,15950,15795,15830,15750,15795,15785,-155,-165,20,157.90,196
,20160616,15795,15785,15905,15905,15770,15770,15845,-15,60,10,79.24,196
,20160617,15770,15845,15655,15845,15635,15845,15795,0,-50,100,789.88,196
,20160620,15845,15795,15745,15795,15690,15775,15750,-20,-45,40,315.02,198
,20160621,15775,15750,15770,15955,15760,15930,15910,180,160,36,286.43,198
,20160622,15930,15910,15780,15950,15765,15950,15905,40,-5,54,429.52,162
,20160623,15950,15905,15985,16000,15885,15950,15930,45,25,100,796.69,138
,20160624,15950,15930,15965,15965,15740,15740,15895,-190,-35,40,317.98,134
,20160627,15740,15895,,,,15895,15895,0,0,0,0.00,134
,20160628,15895,15895,15860,16080,15860,16080,16015,185,120,10,80.09,138
,20160629,16080,16015,16140,16455,16135,16295,16260,280,245,82,666.75,150
,20160630,16295,16260,16395,16605,16395,16560,16565,300,305,88,728.93,174
,20160701,16560,16565,16590,16590,16435,16450,16485,-115,-80,24,197.87,174
,20160704,16450,16485,16700,16970,16700,16865,16795,380,310,140,"1,175.70",198
,20160705,16865,16795,16780,16795,16435,16510,16595,-285,-200,54,448.09,220
,20160706,16510,16595,16610,16680,16420,16490,16520,-105,-75,92,759.96,200
,20160707,16490,16520,16380,16755,16375,16620,16610,100,90,82,681.07,198
,20160708,16620,16610,16595,16605,16430,16495,16520,-115,-90,78,644.30,194
,20160711,16495,16520,16715,16920,16650,16865,16820,345,300,100,841.20,200
,20160712,16865,16820,16885,16945,16845,16865,16900,45,80,50,422.55,188
,20160713,16865,16900,17030,17265,16875,17145,17095,245,195,82,700.90,214
,20160714,17145,17095,17060,17070,17030,17030,17035,-65,-60,28,238.53,214
,20160715,17030,17035,,,,17035,17035,0,0,0,0.00,214
,20160718,17035,17035,17355,17375,17000,17095,17190,60,155,48,412.66,226
,20160719,17095,17190,17105,17415,17080,17395,17300,205,110,46,397.96,222
,20160720,17395,17300,17280,17375,17280,17310,17325,10,25,28,242.58,228
,20160721,17310,17325,17150,17500,17150,17490,17340,165,15,68,589.61,256
,20160722,17490,17340,17520,17620,17445,17445,17505,105,165,108,945.34,330
,20160725,17445,17505,17420,17550,17360,17550,17525,45,20,134,"1,174.36",416
,20160726,17550,17525,17555,17565,17265,17340,17415,-185,-110,226,"1,968.33",392
,20160727,17340,17415,17325,17360,17140,17160,17230,-255,-185,138,"1,189.15",398
,20160728,17160,17230,17155,17175,16975,17050,17080,-180,-150,70,597.93,412
,20160729,17050,17080,17190,17195,16860,17060,17125,-20,45,24,205.55,408
,20160801,17060,17125,17210,17545,17170,17545,17420,420,295,64,557.51,394
,20160802,17545,17420,17490,17550,17490,17550,17510,130,90,10,87.57,394
,20160803,17550,17510,17630,17700,17410,17410,17590,-100,80,62,545.41,396
,20160804,17410,17590,17395,17490,17395,17435,17425,-155,-165,12,104.57,394
,20160805,17435,17425,17405,17560,17405,17560,17515,135,90,10,87.58,398
,20160808,17560,17515,17535,17535,17535,17535,17535,20,20,2,17.54,398
,20160809,17535,17535,17645,17645,17515,17515,17590,-20,55,12,105.56,386
,20160810,17515,17590,17595,17850,17590,17850,17695,260,105,12,106.17,394
,20160811,17850,17695,17885,17915,17730,17730,17860,35,165,92,821.70,398
,20160812,17730,17860,17670,17710,17645,17645,17675,-215,-185,24,212.14,406
,20160815,17645,17675,17480,17535,17350,17350,17450,-325,-225,56,488.71,390
,20160816,17350,17450,17335,17495,17335,17485,17450,35,0,28,244.37,398
,20160817,17485,17450,17385,17420,17385,17420,17400,-30,-50,12,104.42,400
,20160818,17420,17400,17405,17650,17405,17630,17540,230,140,16,140.34,404
,20160819,17630,17540,17660,17660,17550,17550,17590,10,50,18,158.34,408
,20160822,17550,17590,17605,17605,17505,17505,17555,-85,-35,4,35.11,410
,20160823,17505,17555,17550,17675,17550,17640,17650,85,95,26,229.45,410
,20160824,17640,17650,17655,17700,17640,17640,17660,-10,10,44,388.63,410
,20160825,17640,17660,17695,17695,17305,17365,17385,-295,-275,80,695.50,426
,20160826,17365,17385,17495,17850,17435,17765,17680,380,295,198,"1,750.40",512
,20160829,17765,17680,17735,17895,17695,17780,17780,100,100,168,"1,493.89",522
,20160830,17780,17780,17740,17795,17635,17635,17745,-145,-35,186,"1,650.38",466
,20160831,17635,17745,17785,17915,17650,17750,17820,5,75,110,980.25,474
,20160901,17750,17820,17770,18150,17765,18130,18005,310,185,154,"1,386.70",470
,20160902,18130,18005,18130,18310,18035,18275,18210,270,205,102,928.71,498
,20160905,18275,18210,18355,18355,18195,18265,18250,55,40,38,346.80,486
,20160906,18265,18250,18240,18290,18005,18095,18105,-155,-145,104,941.49,476
,20160907,18095,18105,18020,18130,17995,18110,18055,5,-50,28,252.79,482
,20160908,18110,18055,18130,18225,17885,17895,18040,-160,-15,56,505.24,478
,20160909,17895,18040,17925,18025,17895,18025,17950,-15,-90,16,143.63,476
,20160912,18025,17950,17750,17760,17610,17610,17685,-340,-265,62,548.38,458
,20160913,17610,17685,17585,17805,17585,17585,17730,-100,45,56,496.58,486
,20160914,17585,17730,17695,17730,17450,17450,17545,-280,-185,94,824.70,490
,20160919,17450,17545,17485,17560,17400,17410,17440,-135,-105,116,"1,011.60",488
,20160920,17410,17440,17510,17800,17510,17785,17705,345,265,106,938.38,472
,20160921,17785,17705,17865,18070,17830,17830,17915,125,210,214,"1,917.21",420
,20160922,17830,17915,17950,17995,17690,17885,17935,-30,20,214,"1,919.54",354
,20160923,17885,17935,17975,18040,17930,17935,17975,0,40,50,449.49,344
,20160926,17935,17975,17835,17880,17685,17685,17770,-290,-205,88,781.99,318
,20160927,17685,17770,17705,18065,17705,18010,17830,240,60,20,178.34,314
,20160928,18010,17830,18010,18050,17955,17990,18010,160,180,12,108.07,314
,20160929,17990,18010,18080,18300,18080,18200,18190,190,180,46,418.41,312
,20160930,18200,18190,18230,18265,18130,18255,18225,65,35,56,510.36,334
,20161010,18255,18225,16945,18445,16945,18445,18250,220,25,54,492.81,358
,20161011,18445,18250,18440,18440,18110,18150,18195,-100,-55,92,837.11,386
,20161012,18150,18195,18195,18195,17695,17705,17815,-490,-380,498,"4,436.90",678
,20161013,17705,17815,17915,17915,17710,17745,17785,-70,-30,14,124.53,670
,20161014,17745,17785,17550,17800,17485,17780,17670,-5,-115,36,318.12,670
,20161017,17780,17670,17945,17950,17850,17890,17885,220,215,22,196.78,664
,20161018,17890,17885,17910,18075,17910,18075,17980,190,95,26,233.76,662
,20161019,18075,17980,18095,18215,17915,17915,18105,-65,125,16,144.87,664
,20161020,17915,18105,18045,18300,18000,18240,18165,135,60,32,290.71,676
,20161021,18240,18165,18200,18200,18110,18110,18140,-55,-25,36,326.56,698
,20161024,18110,18140,18100,18195,18015,18120,18070,-20,-70,160,"1,445.94",722
,20161025,18120,18070,18240,18965,18240,18890,18555,820,485,448,"4,157.30",864
,20161026,18890,18555,18975,18990,18685,18700,18835,145,280,124,"1,167.83",824
,20161027,18700,18835,18865,18865,18690,18810,18745,-25,-90,48,449.89,818
,20161028,18810,18745,18795,19040,18785,18955,18955,210,210,118,"1,118.48",854
,20161031,18955,18955,19075,19300,19020,19300,19100,345,145,132,"1,260.70",880
,20161101,19300,19100,19395,19905,19365,19695,19755,595,655,252,"2,489.51",920
,20161102,19695,19755,19670,19680,19240,19330,19415,-425,-340,344,"3,340.02",1058
,20161103,19330,19415,19255,19625,19235,19625,19380,210,-35,106,"1,027.19",1040
,20161104,19625,19380,19665,19900,19540,19610,19780,230,400,210,"2,077.02",890
,20161107,19610,19780,19655,20170,19600,19940,19930,160,150,140,"1,395.41",898
,20161108,19940,19930,19895,20130,19750,19800,19845,-130,-85,164,"1,627.37",916
,20161109,19800,19845,19655,20315,19575,19705,19905,-140,60,126,"1,254.15",914
,20161110,19705,19905,19875,20825,19770,20815,20435,910,530,1152,"11,772.53",1210
,20161111,20815,20435,20670,20860,20430,20860,20690,425,255,1378,"14,258.52",1900
,20161114,20860,20690,20840,21925,19905,21260,20890,570,200,5898,"61,609.14",1534
,20161115,21260,20890,21110,22140,20725,21015,21550,125,660,2018,"21,744.27",1372
,20161116,21015,21550,20905,21650,20800,21200,21250,-350,-300,692,"7,353.73",1368
,20161117,21200,21250,21190,21230,20180,20480,20605,-770,-645,566,"5,831.23",1320
,20161118,20480,20605,20255,20845,20255,20845,20620,240,15,354,"3,650.39",1354
,20161121,20845,20620,20925,21370,20605,21195,21085,575,465,652,"6,874.50",1414
,20161122,21195,21085,21290,21800,21055,21690,21480,605,395,982,"10,547.11",1388
,20161123,21690,21480,21625,21730,21315,21450,21490,-30,10,1244,"13,368.26",1664
,20161124,21450,21490,21370,22735,21240,22420,22210,930,720,1336,"14,838.61",1944
,20161125,22420,22210,22525,22990,22495,22960,22720,750,510,1416,"16,087.41",2104
,20161128,22960,22720,23080,24310,22960,24310,23910,1590,1190,1846,"22,070.89",2664
,20161129,24310,23910,24500,25095,23505,23800,24290,-110,380,3534,"42,923.43",2524
,20161130,23800,24290,23965,23965,22585,22585,23000,-1705,-1290,3360,"38,641.28",2532
,20161201,22585,23000,22530,23190,22380,22890,22870,-110,-130,3784,"43,270.28",3916
,20161202,22890,22870,22965,23175,21990,22345,22550,-525,-320,2978,"33,581.53",4590
,20161205,22345,22550,22125,22890,22055,22805,22500,255,-50,2552,"28,713.53",4818
,20161206,22805,22500,22805,23455,22755,22875,23020,375,520,3134,"36,073.85",4328
,20161207,22875,23020,22930,23510,22795,23300,23165,280,145,2544,"29,469.26",4336
,20161208,23300,23165,23230,23910,22655,22875,23085,-290,-80,4476,"51,673.75",4792
,20161209,22875,23085,22985,23080,22235,22620,22565,-465,-520,3858,"43,534.42",5078
,20161212,22620,22565,22605,23020,22325,22435,22695,-130,130,4558,"51,730.94",4726
,20161213,22435,22695,22450,22795,22310,22630,22510,-65,-185,3204,"36,062.18",5082
,20161214,22630,22510,22750,22985,22140,22610,22470,100,-40,2168,"24,360.13",5538
,20161215,22610,22470,22675,23255,22390,23015,22920,545,450,4494,"51,502.86",6260
,20161216,23015,22920,22900,23245,22485,22740,22885,-180,-35,2554,"29,224.79",6310
,20161219,22740,22885,22655,22670,21670,21685,22255,-1200,-630,7278,"80,986.99",8158
,20161220,21685,22255,21510,21630,20870,21090,21220,-1165,-1035,7946,"84,315.50",10184
,20161221,21090,21220,21305,21600,21225,21430,21415,210,195,3044,"32,595.51",10236
,20161222,21430,21415,21360,21455,20825,20965,21135,-450,-280,4162,"43,983.56",10282
,20161223,20965,21135,20940,21510,20890,21350,21260,215,125,7148,"75,993.39",11280
,20161226,21350,21260,21315,21360,19770,19920,20415,-1340,-845,8252,"84,233.95",11602
,20161227,19920,20415,19920,20415,19870,20380,20135,-35,-280,5214,"52,502.98",12106
,20161228,20380,20135,20380,21175,20185,20620,20770,485,635,8120,"84,331.54",13294
,20161229,20620,20770,20725,21320,20580,21065,21030,295,260,9436,"99,235.84",15248
,20161230,21065,21030,21025,21130,20640,20995,20895,-35,-135,16904,"176,619.07",21680
zn1706,20160616,15785,15785,15885,15885,15795,15795,15840,10,55,4,31.68,4
,20160617,15795,15840,15650,15770,15650,15770,15700,-70,-140,6,47.11,6
,20160620,15770,15700,15715,15910,15670,15800,15870,100,170,930,"7,381.66",770
,20160621,15800,15870,15775,15940,15775,15850,15900,-20,30,124,985.87,774
,20160622,15850,15900,15775,15970,15695,15950,15785,50,-115,872,"6,882.39",172
,20160623,15950,15785,16000,16010,15865,15965,15940,180,155,44,350.79,178
,20160624,15965,15940,15935,15965,15805,15805,15905,-135,-35,8,63.63,174
,20160627,15805,15905,15780,15905,15590,15685,15800,-220,-105,44,347.70,186
,20160628,15685,15800,15865,16095,15760,16075,15860,275,60,76,602.73,180
,20160629,16075,15860,16285,16400,16200,16320,16265,460,405,46,374.11,208
,20160630,16320,16265,16370,16640,16290,16580,16505,315,240,110,907.78,256
,20160701,16580,16505,16585,16605,16375,16605,16515,100,10,28,231.24,258
,20160704,16605,16515,16855,17010,16855,17000,16955,485,440,6,50.87,258
,20160705,17000,16955,16855,16855,16465,16495,16640,-460,-315,88,732.20,302
,20160706,16495,16640,16690,16695,16335,16560,16545,-80,-95,92,761.18,304
,20160707,16560,16545,16355,16695,16355,16625,16635,80,90,116,964.90,280
,20160708,16625,16635,16630,16755,16430,16580,16525,-55,-110,134,"1,107.38",222
,20160711,16580,16525,16730,16940,16670,16890,16750,365,225,52,435.60,224
,20160712,16890,16750,16905,17100,16825,16825,16950,75,200,26,220.35,218
,20160713,16825,16950,17085,17195,17085,17115,17140,165,190,68,582.91,228
,20160714,17115,17140,17045,17045,17005,17045,17025,-95,-115,16,136.24,218
,20160715,17045,17025,17200,17200,17020,17020,17080,-5,55,10,85.41,218
,20160718,17020,17080,17325,17370,16910,17110,17070,30,-10,132,"1,126.80",294
,20160719,17110,17070,17120,17565,17105,17340,17290,270,220,32,276.67,292
,20160720,17340,17290,17390,17630,17280,17350,17385,60,95,78,678.11,282
,20160721,17350,17385,17175,17475,17150,17475,17320,90,-65,50,433.06,290
,20160722,17475,17320,17545,17635,17485,17505,17530,185,210,94,824.00,350
,20160725,17505,17530,17435,17595,17300,17475,17485,-55,-45,122,"1,066.73",344
,20160726,17475,17485,17800,17800,17280,17320,17555,-165,70,292,"2,563.74",364
,20160727,17320,17555,17270,17350,17140,17140,17250,-415,-305,128,"1,104.24",390
,20160728,17140,17250,17175,17175,16970,17095,17080,-155,-170,278,"2,374.25",498
,20160729,17095,17080,17150,17280,17005,17105,17185,25,105,72,618.79,464
,20160801,17105,17185,17215,17570,17200,17570,17465,385,280,452,"3,947.23",390
,20160802,17570,17465,17490,17600,17490,17600,17595,135,130,244,"2,146.59",598
,20160803,17600,17595,17645,17710,17475,17475,17650,-120,55,238,"2,100.79",676
,20160804,17475,17650,17420,17510,17420,17450,17460,-200,-190,20,174.64,690
,20160805,17450,17460,17415,17565,17395,17545,17465,85,5,10,87.34,692
,20160808,17545,17465,17495,17695,17435,17635,17550,170,85,14,122.87,688
,20160809,17635,17550,17640,17650,17480,17480,17600,-70,50,122,"1,073.70",792
,20160810,17480,17600,17530,17795,17450,17715,17670,115,70,126,"1,113.43",888
,20160811,17715,17670,17875,17945,17725,17790,17810,120,140,150,"1,335.87",898
,20160812,17790,17810,17785,17785,17510,17675,17660,-135,-150,18,158.98,902
,20160815,17675,17660,17545,17560,17245,17245,17400,-415,-260,40,348.07,906
,20160816,17245,17400,17365,17440,17355,17440,17385,40,-15,10,86.93,906
,20160817,17440,17385,17380,17475,17380,17410,17435,25,50,34,296.42,906
,20160818,17410,17435,17490,17645,17415,17645,17550,210,115,90,789.79,914
,20160819,17645,17550,17650,17685,17535,17550,17640,0,90,20,176.42,920
,20160822,17550,17640,17600,17600,17600,17600,17600,-40,-40,2,17.60,920
,20160823,17600,17600,17550,17700,17540,17605,17575,5,-25,24,210.90,908
,20160824,17605,17575,17730,17730,17645,17645,17685,70,110,4,35.38,908
,20160825,17645,17685,17610,17610,17300,17395,17385,-290,-300,94,817.14,882
,20160826,17395,17385,17465,17815,17465,17750,17665,365,280,100,883.30,888
,20160829,17750,17665,17725,17990,17685,17740,17780,75,115,162,"1,440.34",920
,20160830,17740,17780,17675,17745,17565,17600,17665,-180,-115,124,"1,095.39",924
,20160831,17600,17665,17700,17845,17700,17845,17800,180,135,26,231.43,926
,20160901,17845,17800,17760,18115,17750,18115,17945,315,145,100,897.38,962
,20160902,18115,17945,18110,18290,18055,18210,18195,265,250,210,"1,910.72",952
,20160905,18210,18195,18310,18330,18185,18185,18245,-10,50,46,419.65,958
,20160906,18185,18245,18205,18205,17990,18070,18055,-175,-190,40,361.20,956
,20160907,18070,18055,18030,18230,17950,18095,18020,40,-35,48,432.57,958
,20160908,18095,18020,18185,18215,17805,17850,18040,-170,20,54,487.18,954
,20160909,17850,18040,18000,18015,18000,18005,18005,-35,-35,10,90.04,960
,20160912,18005,18005,17945,17945,17565,17575,17685,-430,-320,72,636.81,948
,20160913,17575,17685,17635,17720,17395,17720,17650,35,-35,24,211.86,934
,20160914,17720,17650,17530,17585,17400,17420,17505,-230,-145,96,840.46,936
,20160919,17420,17505,17480,17505,17370,17395,17430,-110,-75,88,767.05,944
,20160920,17395,17430,17500,17805,17500,17775,17690,345,260,188,"1,663.08",996
,20160921,17775,17690,17845,18025,17795,17860,17905,170,215,150,"1,343.17",1056
,20160922,17860,17905,17780,17930,17640,17890,17800,-15,-105,200,"1,780.10",964
,20160923,17890,17800,17920,17980,17920,17930,17940,130,140,32,287.06,960
,20160926,17930,17940,17690,17785,17615,17660,17660,-280,-280,38,335.61,968
,20160927,17660,17660,17765,17995,17360,17995,17785,335,125,50,444.68,976
,20160928,17995,17785,17980,18040,17945,18040,17995,255,210,20,179.99,972
,20160929,18040,17995,18200,18200,18195,18200,18195,205,200,8,72.80,970
,20160930,18200,18195,18220,18300,18150,18300,18260,105,65,24,219.14,984
,20161010,18300,18260,18000,18405,18000,18385,18250,125,-10,20,182.52,980
,20161011,18385,18250,18245,18320,18100,18100,18240,-150,-10,56,510.82,982
,20161012,18100,18240,17960,17960,17685,17710,17790,-530,-450,30,266.89,982
,20161013,17710,17790,17875,17875,17660,17660,17745,-130,-45,60,532.37,988
,20161014,17660,17745,17475,17850,17475,17740,17720,-5,-25,46,407.63,978
,20161017,17740,17720,17910,18035,17845,17875,17915,155,195,74,662.99,1002
,20161018,17875,17915,17930,18075,17890,18075,17930,160,15,46,412.44,1010
,20161019,18075,17930,18190,18190,18085,18085,18135,155,205,22,199.50,1008
,20161020,18085,18135,18090,18320,17975,18235,18245,100,110,86,784.64,994
,20161021,18235,18245,18130,18190,18060,18165,18135,-80,-110,212,"1,922.70",1096
,20161024,18165,18135,18085,18095,18010,18095,18060,-40,-75,8,72.25,1100
,20161025,18095,18060,18300,18945,18300,18845,18595,785,535,100,929.82,1088
,20161026,18845,18595,18915,18920,18660,18720,18780,125,185,54,507.19,1082
,20161027,18720,18780,18690,18850,18685,18810,18730,30,-50,50,468.26,1086
,20161028,18810,18730,18785,19045,18765,19020,18875,290,145,34,320.93,1094
,20161031,19020,18875,19045,19240,18960,19240,19130,365,255,132,"1,262.85",1136
,20161101,19240,19130,19340,19935,19220,19670,19750,540,620,1094,"10,805.78",1008
,20161102,19670,19750,18765,19670,18765,19320,19410,-430,-340,360,"3,493.91",1098
,20161103,19320,19410,19355,19635,19245,19570,19385,160,-25,110,"1,066.32",1078
,20161104,19570,19385,19600,19900,19500,19585,19720,200,335,162,"1,597.46",1096
,20161107,19585,19720,19585,20100,19520,19900,19715,180,-5,108,"1,064.67",1088
,20161108,19900,19715,19890,19995,19760,19800,19920,85,205,90,896.45,1090
,20161109,19800,19920,19730,20300,19475,19740,19825,-180,-95,368,"3,648.33",1068
,20161110,19740,19825,19850,20815,19850,20815,20440,990,615,392,"4,006.59",1084
,20161111,20815,20440,21100,21100,20400,20785,20675,345,235,292,"3,019.00",1044
,20161114,20785,20675,20835,21500,20080,21290,20790,615,115,326,"3,389.46",1052
,20161115,21290,20790,21290,22000,20770,20870,21395,80,605,120,"1,283.86",1042
,20161116,20870,21395,20920,21600,20885,21035,21215,-360,-180,56,594.13,1034
,20161117,21035,21215,21070,21210,20300,20500,20570,-715,-645,76,781.75,1034
,20161118,20500,20570,20525,20800,20400,20800,20550,230,-20,80,822.01,1046
,20161121,20800,20550,20915,21335,20625,21185,21025,635,475,88,925.30,1068
,20161122,21185,21025,21245,21810,21135,21720,21755,695,730,792,"8,615.82",1656
,20161123,21720,21755,21600,21695,21255,21445,21550,-310,-205,718,"7,736.60",1126
,20161124,21445,21550,21445,22695,21250,22415,21985,865,435,156,"1,714.96",1094
,20161125,22415,21985,22615,22975,22460,22960,22735,975,750,256,"2,910.70",1066
,20161128,22960,22735,22990,24325,22990,24325,24235,1590,1500,188,"2,278.12",1118
,20161129,24325,24235,24590,25025,23690,23920,24240,-315,5,222,"2,690.91",1146
,20161130,23920,24240,23990,23990,22540,22540,23005,-1700,-1235,118,"1,357.36",1112
,20161201,22540,23005,22580,23105,22420,22870,22835,-135,-170,158,"1,804.25",1096
,20161202,22870,22835,23050,23110,22000,22400,22510,-435,-325,134,"1,508.49",1160
,20161205,22400,22510,22310,22865,22310,22740,22630,230,120,44,497.88,1156
,20161206,22740,22630,22815,23395,22735,22885,23075,255,445,94,"1,084.73",1158
,20161207,22885,23075,21590,23605,21590,23340,23155,265,80,34,393.64,1164
,20161208,23340,23155,23425,23710,22800,22830,22990,-325,-165,180,"2,069.26",1252
,20161209,22830,22990,22655,22800,22250,22655,22485,-335,-505,274,"3,080.71",1346
,20161212,22655,22485,22740,23000,22355,22405,22700,-80,215,178,"2,020.56",1318
,20161213,22405,22700,22545,22665,22380,22665,22495,-35,-205,54,607.37,1326
,20161214,22665,22495,22680,22680,22200,22640,22420,145,-75,46,515.68,1350
,20161215,22640,22420,22590,23160,22450,23010,22980,590,560,132,"1,516.91",1406
,20161216,23010,22980,22720,23070,22555,22695,22800,-285,-180,62,706.88,1412
,20161219,22695,22800,22560,22615,21725,21780,22190,-1020,-610,164,"1,819.68",1456
,20161220,21780,22190,21650,21650,20955,21150,21250,-1040,-940,212,"2,252.76",1448
,20161221,21150,21250,21395,21630,21275,21455,21455,205,205,140,"1,501.94",1486
,20161222,21455,21455,21470,21470,20860,20890,21145,-565,-310,490,"5,180.93",1584
,20161223,20890,21145,20950,21535,20920,21380,21265,235,120,312,"3,318.06",1654
,20161226,21380,21265,21375,21375,19790,19965,20075,-1300,-1190,686,"6,886.43",1830
,20161227,19965,20075,20070,20405,19900,20380,20095,305,20,142,"1,426.80",1812
,20161228,20380,20095,20275,21160,20220,20630,20780,535,685,808,"8,395.62",1998
,20161229,20630,20780,20770,21160,20665,21095,20955,315,175,206,"2,158.41",1946
,20161230,21095,20955,20970,21025,20690,20900,20870,-55,-85,352,"3,673.95",1950
zn1707,20160718,17080,17080,,,,17080,17080,0,0,0,0.00,0
,20160719,17080,17080,17170,17615,16870,17405,17340,325,260,74,641.67,54
,20160720,17405,17340,17460,17460,17320,17335,17350,-5,10,14,121.46,56
,20160721,17335,17350,17350,17495,17340,17400,17385,50,35,16,139.10,54
,20160722,17400,17385,17580,17580,17490,17535,17510,150,125,164,"1,436.21",210
,20160725,17535,17510,17365,17775,17365,17570,17490,60,-20,474,"4,146.18",578
,20160726,17570,17490,17560,17565,17350,17380,17395,-110,-95,314,"2,731.04",576
,20160727,17380,17395,17295,17305,17170,17180,17265,-215,-130,96,828.91,572
,20160728,17180,17265,17070,17130,16930,17130,17100,-135,-165,76,649.80,546
,20160729,17130,17100,17130,17415,17130,17160,17225,60,125,122,"1,050.90",650
,20160801,17160,17225,17220,17600,17220,17585,17520,360,295,136,"1,191.59",592
,20160802,17585,17520,17505,17605,17500,17605,17535,85,15,14,122.75,590
,20160803,17605,17535,17665,17730,17325,17445,17635,-90,100,38,335.07,580
,20160804,17445,17635,17520,17520,17390,17475,17435,-160,-200,16,139.49,590
,20160805,17475,17435,17560,17595,17560,17595,17575,160,140,4,35.16,592
,20160808,17595,17575,17575,17575,17575,17575,17575,0,0,10,87.88,602
,20160809,17575,17575,17535,17535,17535,17535,17535,-40,-40,2,17.54,602
,20160810,17535,17535,17550,17700,17530,17700,17635,165,100,206,"1,816.56",742
,20160811,17700,17635,17915,17995,17730,17790,17805,155,170,26,231.52,740
,20160812,17790,17805,17680,17710,17665,17670,17680,-135,-125,26,229.85,746
,20160815,17670,17680,17525,17570,17300,17395,17410,-285,-270,92,801.03,750
,20160816,17395,17410,17355,17420,17355,17385,17385,-25,-25,8,69.54,752
,20160817,17385,17385,,,,17385,17385,0,0,0,0.00,752
,20160818,17385,17385,17445,17670,17445,17625,17580,240,195,6,52.74,752
,20160819,17625,17580,,,,17580,17580,0,0,0,0.00,752
,20160822,17580,17580,17515,17635,17515,17635,17605,55,25,8,70.42,752
,20160823,17635,17605,17660,17695,17660,17675,17665,70,60,14,123.67,754
,20160824,17675,17665,17675,17695,17620,17645,17655,-20,-10,34,300.18,764
,20160825,17645,17655,17615,17615,17330,17405,17385,-250,-270,48,417.35,762
,20160826,17405,17385,17435,17795,17435,17795,17730,410,345,70,620.59,784
,20160829,17795,17730,17740,17880,17690,17705,17775,-25,45,76,675.51,788
,20160830,17705,17775,17690,17720,17580,17590,17655,-185,-120,104,918.30,792
,20160831,17590,17655,17790,17845,17640,17800,17760,145,105,60,532.95,800
,20160901,17800,17760,17830,18120,17805,18085,17975,325,215,92,826.91,794
,20160902,18085,17975,18070,18300,18070,18215,18190,240,215,432,"3,929.96",706
,20160905,18215,18190,18290,18290,18185,18190,18220,0,30,64,583.10,716
,20160906,18190,18220,18155,18175,17995,18085,18105,-135,-115,28,253.49,714
,20160907,18085,18105,17990,18090,17905,18065,18005,-40,-100,34,306.13,722
,20160908,18065,18005,18155,18200,17870,17895,18040,-110,35,66,595.47,726
,20160909,17895,18040,18015,18025,18000,18025,18010,-15,-30,20,180.11,730
,20160912,18025,18010,17970,17980,17525,17550,17635,-460,-375,210,"1,852.15",718
,20160913,17550,17635,17570,17695,17525,17575,17595,-60,-40,32,281.54,712
,20160914,17575,17595,17645,17645,17400,17400,17515,-195,-80,46,402.94,710
,20160919,17400,17515,17495,17495,17390,17390,17445,-125,-70,30,261.75,712
,20160920,17390,17445,17495,17765,17495,17745,17625,300,180,48,423.08,718
,20160921,17745,17625,17850,17980,17820,17840,17890,215,265,74,661.95,726
,20160922,17840,17890,17735,17925,17615,17845,17780,-45,-110,166,"1,476.06",708
,20160923,17845,17780,17880,17975,17880,17895,17915,115,135,30,268.78,710
,20160926,17895,17915,17845,17845,17845,17845,17845,-70,-70,2,17.85,710
,20160927,17845,17845,17680,17890,17680,17890,17770,45,-75,12,106.63,708
,20160928,17890,17770,17810,17960,17810,17960,17885,190,115,4,35.77,708
,20160929,17960,17885,18140,18230,18075,18230,18170,345,285,14,127.22,710
,20160930,18230,18170,18235,18295,18130,18285,18245,115,75,46,419.75,720
,20161010,18285,18245,18015,18420,18015,18405,18390,160,145,50,459.84,750
,20161011,18405,18390,18270,18330,18100,18135,18240,-255,-150,80,729.70,776
,20161012,18135,18240,17930,17930,17775,17795,17815,-445,-425,20,178.19,784
,20161013,17795,17815,17915,17915,17650,17650,17670,-165,-145,130,"1,148.86",756
,20161014,17650,17670,17490,17755,17460,17755,17630,85,-40,24,211.58,756
,20161017,17755,17630,17795,17975,17795,17840,17875,210,245,54,482.74,774
,20161018,17840,17875,17930,18075,17865,18075,17920,200,45,12,107.53,768
,20161019,18075,17920,18165,18165,18060,18065,18100,145,180,22,199.12,768
,20161020,18065,18100,18065,18240,17955,18240,18030,140,-70,18,162.30,776
,20161021,18240,18030,18105,18110,18105,18110,18105,80,75,10,90.53,768
,20161024,18110,18105,18035,18035,18020,18020,18025,-85,-80,4,36.06,768
,20161025,18020,18025,18195,18900,18195,18780,18595,755,570,30,278.97,768
,20161026,18780,18595,18940,18940,18655,18750,18775,155,180,14,131.45,764
,20161027,18750,18775,18775,18785,18630,18655,18685,-120,-90,18,168.21,762
,20161028,18655,18685,18765,19010,18745,19010,18830,325,145,24,226.00,768
,20161031,19010,18830,19030,19180,19015,19165,19065,335,235,20,190.69,754
,20161101,19165,19065,19260,19875,19260,19705,19775,640,710,732,"7,238.11",448
,20161102,19705,19775,19610,19655,19230,19290,19430,-485,-345,110,"1,068.87",416
,20161103,19290,19430,19280,19565,19230,19565,19345,135,-85,64,619.05,410
,20161104,19565,19345,19745,19880,19495,19630,19745,285,400,80,789.85,404
,20161107,19630,19745,19550,20160,19510,20030,19745,285,0,42,414.65,398
,20161108,20030,19745,19945,19975,19745,19825,19805,80,60,66,653.64,404
,20161109,19825,19805,19710,20250,19710,19775,19970,-30,165,90,898.83,404
,20161110,19775,19970,19910,20775,19900,20750,20505,780,535,306,"3,137.95",446
,20161111,20750,20505,20665,20820,20435,20770,20570,265,65,134,"1,378.30",424
,20161114,20770,20570,20705,21475,20020,21110,20685,540,115,152,"1,572.22",422
,20161115,21110,20685,21060,21925,20795,20950,21330,265,645,90,960.02,408
,20161116,20950,21330,20920,21285,20855,21000,21015,-330,-315,16,168.14,406
,20161117,21000,21015,20810,20810,20300,20500,20475,-515,-540,24,245.72,418
,20161118,20500,20475,20520,20715,20520,20715,20615,240,140,8,82.47,410
,20161121,20715,20615,21035,21180,20920,21180,21065,565,450,36,379.18,404
,20161122,21180,21065,21380,21680,21250,21680,21485,615,420,34,365.28,408
,20161123,21680,21485,21540,21615,21310,21460,21455,-25,-30,26,278.95,406
,20161124,21460,21455,21315,22710,21315,22410,22410,955,955,88,986.19,438
,20161125,22410,22410,22510,22835,22510,22825,22715,415,305,56,636.13,422
,20161128,22825,22715,23225,24305,23225,24305,24145,1590,1430,34,410.49,422
,20161129,24305,24145,24450,24605,23640,23655,24225,-490,80,144,"1,744.33",458
,20161130,23655,24225,23765,23835,22525,22530,23025,-1695,-1200,60,690.81,452
,20161201,22530,23025,22540,23085,22540,23045,22970,20,-55,42,482.44,460
,20161202,23045,22970,23000,23105,21985,21990,22580,-980,-390,40,451.64,470
,20161205,21990,22580,22075,22885,22075,22860,22625,280,45,96,"1,086.12",530
,20161206,22860,22625,22780,23335,22780,22905,23165,280,540,76,880.42,530
,20161207,22905,23165,22850,23395,22850,23290,23150,125,-15,24,277.85,538
,20161208,23290,23150,23500,23595,22800,22800,23005,-350,-145,24,276.09,546
,20161209,22800,23005,22620,22620,22335,22525,22455,-480,-550,22,247.05,544
,20161212,22525,22455,22730,22955,22500,22500,22610,45,155,74,836.66,542
,20161213,22500,22610,22620,22620,22445,22530,22525,-80,-85,46,518.16,538
,20161214,22530,22525,,,,22525,22525,0,0,0,0.00,538
,20161215,22525,22525,22590,23100,22555,23065,22785,540,260,58,660.80,514
,20161216,23065,22785,22710,23190,22600,22930,22825,145,40,42,479.34,522
,20161219,22930,22825,22560,22680,22000,22000,22400,-825,-425,18,201.63,518
,20161220,22000,22400,21675,21675,21000,21155,21200,-1245,-1200,96,"1,017.74",550
,20161221,21155,21200,21495,21620,21450,21540,21475,340,275,44,472.56,554
,20161222,21540,21475,21390,21390,20955,20955,21175,-520,-300,12,127.06,548
,20161223,20955,21175,21065,21595,20980,21160,21180,-15,5,26,275.39,550
,20161226,21160,21180,21000,21000,19820,20025,20170,-1155,-1010,44,443.77,552
,20161227,20025,20170,20125,20330,20000,20330,20080,160,-90,42,421.68,568
,20161228,20330,20080,20285,21010,20285,20765,20850,685,770,28,291.92,578
,20161229,20765,20850,20820,21130,20775,21130,21010,280,160,32,336.17,558
,20161230,21130,21010,20855,21000,20730,21000,20865,-10,-145,18,187.79,566
zn1708,20160816,17410,17410,16410,17495,16410,17495,16950,85,-460,4,33.91,0
,20160817,17495,16950,,,,16950,16950,0,0,0,0.00,0
,20160818,16950,16950,,,,16950,16950,0,0,0,0.00,0
,20160819,16950,16950,17670,17785,17565,17650,17645,700,695,12,105.90,6
,20160822,17650,17645,,,,17645,17645,0,0,0,0.00,6
,20160823,17645,17645,17720,17720,17720,17720,17720,75,75,8,70.88,14
,20160824,17720,17720,17685,17700,17685,17700,17695,-20,-25,18,159.29,32
,20160825,17700,17695,17700,17700,17350,17350,17385,-345,-310,24,208.67,54
,20160826,17350,17385,17495,17830,17495,17765,17745,380,360,82,727.58,124
,20160829,17765,17745,17770,17830,17680,17725,17740,-20,-5,80,709.75,178
,20160830,17725,17740,17685,17715,17605,17605,17675,-135,-65,94,830.80,254
,20160831,17605,17675,17695,17805,17685,17795,17760,120,85,48,426.31,290
,20160901,17795,17760,17760,18100,17760,18100,17950,340,190,170,"1,525.82",420
,20160902,18100,17950,18110,18280,18110,18185,18210,235,260,102,928.93,440
,20160905,18185,18210,18145,18245,18140,18180,18165,-30,-45,26,236.19,426
,20160906,18180,18165,18125,18200,17995,17995,18100,-170,-65,14,126.73,432
,20160907,17995,18100,18000,18035,17965,18025,18005,-75,-95,26,234.09,432
,20160908,18025,18005,18100,18325,17780,17850,18050,-155,45,140,"1,263.73",454
,20160909,17850,18050,17830,18010,17800,17975,17915,-75,-135,72,644.97,438
,20160912,17975,17915,17940,17940,17545,17580,17630,-335,-285,200,"1,763.36",346
,20160913,17580,17630,17535,17680,17490,17555,17585,-75,-45,72,633.15,344
,20160914,17555,17585,17620,17655,17425,17430,17505,-155,-80,86,752.75,338
,20160919,17430,17505,17505,17515,17355,17355,17445,-150,-60,100,872.27,352
,20160920,17355,17445,17455,17755,17105,17720,17585,275,140,210,"1,846.86",290
,20160921,17720,17585,17835,17935,17750,17850,17820,265,235,94,837.68,268
,20160922,17850,17820,17690,17820,17550,17820,17700,0,-120,220,"1,947.54",182
,20160923,17820,17700,18250,18250,17435,17940,17875,240,175,56,500.53,184
,20160926,17940,17875,,,,17715,17715,-160,-160,0,0.00,184
,20160927,17715,17715,,,,17900,17900,185,185,0,0.00,184
,20160928,17900,17900,17975,18030,17945,17970,17990,70,90,26,233.91,188
,20160929,17970,17990,17995,18200,17995,18200,18080,210,90,20,180.82,180
,20160930,18200,18080,18205,18260,18055,18260,18175,180,95,22,199.93,180
,20161010,18260,18175,18000,18405,18000,18385,18305,210,130,24,219.70,184
,20161011,18385,18305,18315,18315,18125,18125,18240,-180,-65,26,237.14,180
,20161012,18125,18240,17785,17840,17750,17750,17790,-490,-450,14,124.54,182
,20161013,17750,17790,17900,17925,17670,17670,17715,-120,-75,28,248.05,180
,20161014,17670,17715,17485,17700,17480,17640,17545,-75,-170,16,140.38,180
,20161017,17640,17545,17815,17905,17785,17905,17845,360,300,18,160.64,182
,20161018,17905,17845,17970,18200,17970,18200,18185,355,340,38,345.57,206
,20161019,18200,18185,18185,18185,18070,18100,18130,-85,-55,38,344.49,222
,20161020,18100,18130,18270,18270,18270,18270,18270,140,140,4,36.54,224
,20161021,18270,18270,18135,18135,18135,18135,18135,-135,-135,2,18.14,226
,20161024,18135,18135,,,,18135,18135,0,0,0,0.00,226
,20161025,18135,18135,18270,18885,18260,18825,18610,690,475,262,"2,438.51",254
,20161026,18825,18610,18910,18955,18600,18680,18665,70,55,176,"1,642.79",236
,20161027,18680,18665,18720,18735,18600,18735,18670,70,5,34,317.41,236
,20161028,18735,18670,18795,18925,18710,18910,18765,240,95,32,300.25,220
,20161031,18910,18765,19020,19180,19000,19085,19060,320,295,48,457.54,228
,20161101,19085,19060,19280,19870,19185,19655,19505,595,445,122,"1,190.10",226
,20161102,19655,19505,19610,19610,19170,19170,19470,-335,-35,38,369.94,226
,20161103,19170,19470,19250,19610,19200,19610,19310,140,-160,44,424.87,224
,20161104,19610,19310,19715,19915,19440,19665,19750,355,440,56,553.06,246
,20161107,19665,19750,19585,20140,19490,20005,19660,255,-90,30,294.96,246
,20161108,20005,19660,19925,19925,19735,19735,19755,75,95,28,276.62,218
,20161109,19735,19755,20025,20230,19740,19740,19955,-15,200,20,199.57,218
,20161110,19740,19955,19800,20830,19800,20750,20350,795,395,122,"1,241.53",240
,20161111,20750,20350,20630,20795,20355,20720,20635,370,285,158,"1,630.30",264
,20161114,20720,20635,20585,21530,20210,21200,20745,565,110,178,"1,846.36",234
,20161115,21200,20745,21300,21985,20815,20875,21335,130,590,106,"1,130.95",240
,20161116,20875,21335,20800,21590,20800,21100,21315,-235,-20,26,277.14,246
,20161117,21100,21315,20975,21010,20315,20315,20765,-1000,-550,6,62.30,244
,20161118,20315,20765,20550,20550,20550,20550,20550,-215,-215,4,41.10,248
,20161121,20550,20550,21015,21480,20765,21480,21200,930,650,22,233.21,250
,20161122,21480,21200,21215,21690,21215,21685,21525,485,325,26,279.86,262
,20161123,21685,21525,21355,21465,21165,21460,21360,-65,-165,14,149.55,262
,20161124,21460,21360,21700,22635,21515,22250,22160,890,800,28,310.24,276
,20161125,22250,22160,22565,22850,22395,22840,22725,680,565,64,727.25,306
,20161128,22840,22725,23050,24315,22930,24315,23705,1590,980,52,616.37,318
,20161129,24315,23705,24220,24835,23440,23850,24200,145,495,92,"1,113.28",314
,20161130,23850,24200,23775,23775,22505,22595,22880,-1605,-1320,84,961.01,280
,20161201,22595,22880,22705,22965,22705,22900,22830,20,-50,28,319.63,280
,20161202,22900,22830,22520,22520,21745,22220,22100,-610,-730,46,508.30,278
,20161205,22220,22100,22120,22825,21800,22695,22415,595,315,24,269.04,276
,20161206,22695,22415,22900,23200,22690,22815,22975,400,560,32,367.68,270
,20161207,22815,22975,23250,23350,23000,23350,23170,375,195,28,324.44,278
,20161208,23350,23170,23490,23595,22720,22720,23135,-450,-35,46,532.19,274
,20161209,22720,23135,22600,22600,22270,22480,22365,-655,-770,36,402.64,268
,20161212,22480,22365,22625,22845,22560,22845,22660,480,295,8,90.66,272
,20161213,22845,22660,22510,22600,22375,22600,22480,-60,-180,28,314.78,284
,20161214,22600,22480,22690,22690,22500,22600,22615,120,135,12,135.69,288
,20161215,22600,22615,22480,23200,22465,23025,22980,410,365,70,804.41,320
,20161216,23025,22980,22795,23135,22630,22800,22805,-180,-175,52,593.03,356
,20161219,22800,22805,22525,22525,22525,22525,22525,-280,-280,2,22.53,356
,20161220,22525,22525,21665,21665,21100,21100,21300,-1425,-1225,34,362.11,348
,20161221,21100,21300,21490,21620,21385,21385,21500,85,200,12,129.01,348
,20161222,21385,21500,21325,21345,20835,20970,21130,-530,-370,26,274.75,346
,20161223,20970,21130,20975,21400,20975,21370,21160,240,30,16,169.32,344
,20161226,21370,21160,20870,20910,19800,19915,20245,-1245,-915,20,202.50,340
,20161227,19915,20245,,,,20245,20245,0,0,0,0.00,340
,20161228,20245,20245,20285,20960,20285,20900,20810,655,565,18,187.30,350
,20161229,20900,20810,20780,21130,20770,21080,20995,270,185,32,335.96,372
,20161230,21080,20995,20995,20995,20880,20930,20920,-65,-75,14,146.45,380
zn1709,20160920,17445,17445,17585,17735,17585,17720,17680,275,235,10,88.41,6
,20160921,17720,17680,17840,17840,17795,17795,17805,115,125,12,106.86,14
,20160922,17795,17805,17580,17830,17580,17830,17745,25,-60,6,53.24,16
,20160923,17830,17745,17870,17955,17870,17895,17920,150,175,26,233.00,28
,20160926,17895,17920,17855,17855,17315,17620,17460,-300,-460,16,139.68,38
,20160927,17620,17460,17705,18030,17705,18030,17830,570,370,34,303.17,40
,20160928,18030,17830,18065,18065,17905,18035,18015,205,185,8,72.06,34
,20160929,18035,18015,18140,18140,18140,18140,18140,125,125,2,18.14,36
,20160930,18140,18140,18195,18265,18195,18265,18240,125,100,6,54.73,32
,20161010,18265,18240,16960,18405,16960,18390,18120,150,-120,20,181.24,30
,20161011,18390,18120,18280,18280,18140,18140,18190,20,70,8,72.78,28
,20161012,18140,18190,17820,17830,17765,17795,17810,-395,-380,24,213.72,42
,20161013,17795,17810,17820,17820,17635,17675,17685,-135,-125,16,141.52,48
,20161014,17675,17685,17530,17745,17510,17745,17570,60,-115,18,158.15,46
,20161017,17745,17570,17900,17925,17785,17880,17840,310,270,26,231.95,54
,20161018,17880,17840,17915,18120,17915,18120,17990,280,150,44,395.79,78
,20161019,18120,17990,18175,18175,17965,17965,18135,-25,145,22,199.52,82
,20161020,17965,18135,18095,18165,18000,18140,18110,5,-25,14,126.77,88
,20161021,18140,18110,18125,18125,18125,18125,18125,15,15,6,54.38,92
,20161024,18125,18125,18085,18085,18015,18075,18045,-50,-80,18,162.41,94
,20161025,18075,18045,18180,18900,18115,18825,18605,780,560,136,"1,265.20",142
,20161026,18825,18605,18805,18805,18610,18665,18690,60,85,56,523.33,150
,20161027,18665,18690,18685,18700,18660,18660,18685,-30,-5,20,186.88,150
,20161028,18660,18685,18695,19285,18695,18940,18880,255,195,34,321.01,154
,20161031,18940,18880,18995,19175,18935,19175,19065,295,185,56,533.93,156
,20161101,19175,19065,19285,19785,19165,19745,19530,680,465,92,898.52,208
,20161102,19745,19530,19590,19590,19135,19185,19325,-345,-205,56,541.15,206
,20161103,19185,19325,19260,19525,19210,19525,19330,200,5,32,309.29,208
,20161104,19525,19330,19670,19930,19490,19490,19710,160,380,58,571.69,206
,20161107,19490,19710,19540,20035,19485,19800,19680,90,-30,54,531.48,214
,20161108,19800,19680,19900,19995,19610,19785,19845,105,165,128,"1,270.11",190
,20161109,19785,19845,19755,20100,19585,19740,19825,-105,-20,68,674.09,192
,20161110,19740,19825,19930,20775,19880,20735,20225,910,400,104,"1,051.82",208
,20161111,20735,20225,20595,20790,20425,20700,20580,475,355,74,761.60,198
,20161114,20700,20580,20660,21465,20200,21185,20820,605,240,90,936.97,190
,20161115,21185,20820,21125,21920,20855,20855,21510,35,690,100,"1,075.70",202
,20161116,20855,21510,20900,21515,20900,21010,21220,-500,-290,82,870.09,198
,20161117,21010,21220,21195,21195,20210,20370,20630,-850,-590,54,557.02,184
,20161118,20370,20630,20530,20795,20400,20740,20560,110,-70,116,"1,192.75",228
,20161121,20740,20560,20885,21160,20765,21160,21025,600,465,90,946.18,234
,20161122,21160,21025,21165,21640,21000,21630,21320,605,295,68,725.00,236
,20161123,21630,21320,21435,21555,21245,21480,21420,160,100,62,664.16,232
,20161124,21480,21420,21280,22550,21270,22295,21960,875,540,38,417.31,244
,20161125,22295,21960,22510,22865,22420,22865,22600,905,640,110,"1,243.00",242
,20161128,22865,22600,22995,24180,22910,24180,23565,1580,965,114,"1,343.40",266
,20161129,24180,23565,24180,24855,23255,23525,24200,-40,635,284,"3,436.53",260
,20161130,23525,24200,23745,23745,22505,22505,22935,-1695,-1265,168,"1,926.80",214
,20161201,22505,22935,22610,23000,22400,23000,22635,65,-300,22,249.03,212
,20161202,23000,22635,23025,23025,21975,21975,22475,-660,-160,40,449.58,198
,20161205,21975,22475,22435,22665,22435,22665,22520,190,45,8,90.09,206
,20161206,22665,22520,22700,23220,22700,22905,22970,385,450,38,436.44,210
,20161207,22905,22970,22805,23285,22760,23285,23035,315,65,32,368.63,204
,20161208,23285,23035,23360,23635,22750,22775,23155,-260,120,60,694.75,202
,20161209,22775,23155,22965,23185,22300,22575,22535,-580,-620,46,518.31,212
,20161212,22575,22535,22735,22950,22555,22700,22770,165,235,24,273.27,214
,20161213,22700,22770,22510,22715,22465,22615,22545,-155,-225,32,360.78,232
,20161214,22615,22545,22740,22930,22260,22605,22625,60,80,40,452.54,228
,20161215,22605,22625,22675,23145,22475,22955,22790,330,165,46,524.24,228
,20161216,22955,22790,22805,23075,22555,22760,22835,-30,45,44,502.37,228
,20161219,22760,22835,22570,22690,21790,21790,22215,-1045,-620,92,"1,022.03",228
,20161220,21790,22215,21680,21680,21000,21245,21290,-970,-925,124,"1,320.02",212
,20161221,21245,21290,21390,21685,21390,21530,21605,240,315,32,345.75,192
,20161222,21530,21605,21440,21445,20970,21010,21120,-595,-485,46,485.86,188
,20161223,21010,21120,21020,21560,21020,21390,21405,270,285,20,214.08,188
,20161226,21390,21405,21270,21270,19905,20035,20545,-1370,-860,76,780.83,178
,20161227,20035,20545,20055,20380,20050,20380,20130,-165,-415,34,342.25,174
,20161228,20380,20130,20350,21020,20285,20850,20750,720,620,38,394.27,184
,20161229,20850,20750,20915,21210,20840,21100,21075,350,325,52,548.05,224
,20161230,21100,21075,20970,21060,20780,21060,20970,-15,-105,90,943.69,252
zn1710,20161018,17840,17840,17980,18055,17735,18055,17945,215,105,8,71.79,6
,20161019,18055,17945,18175,18200,17960,17990,18095,45,150,18,162.89,14
,20161020,17990,18095,18080,18280,18080,18175,18185,80,90,10,90.93,16
,20161021,18175,18185,18110,18170,18110,18130,18140,-55,-45,8,72.57,16
,20161024,18130,18140,18135,18135,17955,18100,18075,-40,-65,36,325.39,36
,20161025,18100,18075,18200,18875,18105,18805,18620,730,545,98,912.59,36
,20161026,18805,18620,18785,19010,18525,18630,18795,10,175,634,"5,959.31",58
,20161027,18630,18795,18690,18765,18640,18765,18700,-30,-95,30,280.50,62
,20161028,18765,18700,18735,18955,18640,18920,18805,220,105,70,658.21,48
,20161031,18920,18805,19050,19150,18895,19150,19060,345,255,58,552.81,68
,20161101,19150,19060,19240,19735,19205,19735,19625,675,565,64,628.14,100
,20161102,19735,19625,19555,19645,19410,19410,19515,-215,-110,24,234.20,106
,20161103,19410,19515,19220,19525,19135,19525,19345,10,-170,130,"1,257.64",74
,20161104,19525,19345,19650,19800,19465,19495,19700,150,355,154,"1,517.09",166
,20161107,19495,19700,19530,20105,19505,19935,19650,235,-50,190,"1,867.02",120
,20161108,19935,19650,19860,19930,19690,19770,19765,120,115,28,276.76,122
,20161109,19770,19765,19750,20150,19550,19650,19895,-115,130,158,"1,571.83",122
,20161110,19650,19895,19965,20750,19680,20740,20190,845,295,238,"2,402.85",154
,20161111,20740,20190,20595,20805,20315,20805,20555,615,365,124,"1,274.58",136
,20161114,20805,20555,20920,21735,20090,21150,20780,595,225,184,"1,912.18",168
,20161115,21150,20780,20755,22000,20755,20920,21300,140,520,214,"2,279.29",154
,20161116,20920,21300,20855,21520,20800,21100,21105,-200,-195,152,"1,604.28",172
,20161117,21100,21105,21160,21160,20160,20465,20460,-640,-645,210,"2,148.37",270
,20161118,20465,20460,20600,20815,20400,20815,20590,355,130,80,823.61,302
,20161121,20815,20590,20730,21245,20485,21135,20935,545,345,110,"1,151.69",302
,20161122,21135,20935,21065,21650,20800,21595,21335,660,400,104,"1,109.44",314
,20161123,21595,21335,21475,21535,21245,21455,21410,120,75,160,"1,712.94",310
,20161124,21455,21410,21325,22675,21320,22315,21940,905,530,172,"1,887.12",304
,20161125,22315,21940,22415,22870,22380,22785,22550,845,610,162,"1,826.58",296
,20161128,22785,22550,22765,24125,22765,24125,23750,1575,1200,106,"1,258.90",318
,20161129,24125,23750,24180,25030,23310,23865,24035,115,285,250,"3,004.92",278
,20161130,23865,24035,23715,23720,22350,22350,22840,-1685,-1195,90,"1,027.99",252
,20161201,22350,22840,22420,23000,22420,22920,22730,80,-110,52,591.07,264
,20161202,22920,22730,22975,23110,21965,22180,22440,-550,-290,182,"2,042.30",250
,20161205,22180,22440,22535,22705,21975,22705,22260,265,-180,30,333.93,250
,20161206,22705,22260,22680,23220,22680,22750,22880,490,620,34,388.98,256
,20161207,22750,22880,22790,23265,22695,23205,23010,325,130,42,483.24,268
,20161208,23205,23010,23340,23595,22705,22745,22985,-265,-25,44,505.68,268
,20161209,22745,22985,22905,22955,22065,22650,22500,-335,-485,316,"3,555.13",444
,20161212,22650,22500,22710,22870,22600,22855,22770,355,270,14,159.41,448
,20161213,22855,22770,22415,22645,22415,22465,22505,-305,-265,14,157.57,446
,20161214,22465,22505,22660,22725,22415,22415,22590,-90,85,52,587.38,456
,20161215,22415,22590,22490,23180,22490,23180,22900,590,310,104,"1,190.93",442
,20161216,23180,22900,22715,23190,22390,22900,22860,0,-40,96,"1,097.52",484
,20161219,22900,22860,22480,22635,21855,21855,22260,-1005,-600,140,"1,558.33",522
,20161220,21855,22260,21775,21775,21110,21190,21395,-1070,-865,96,"1,027.07",528
,20161221,21190,21395,21510,21550,21500,21550,21525,155,130,8,86.11,530
,20161222,21550,21525,21420,21470,21000,21020,21135,-505,-390,26,274.79,534
,20161223,21020,21135,21085,21500,20965,21440,21295,305,160,32,340.75,544
,20161226,21440,21295,21245,21250,19840,19980,20490,-1315,-805,62,635.24,548
,20161227,19980,20490,20225,20435,20000,20435,20180,-55,-310,44,444.05,540
,20161228,20435,20180,20370,21105,20280,20785,20720,605,540,98,"1,015.43",582
,20161229,20785,20720,20805,21190,20775,21190,20965,470,245,100,"1,048.25",612
,20161230,21190,20965,21020,21065,21020,21055,21045,90,80,46,484.08,630
zn1711,20161116,21300,21300,21120,21415,21120,21265,21300,-35,0,8,85.22,8
,20161117,21265,21300,21125,21125,20505,20505,20865,-795,-435,20,208.66,6
,20161118,20505,20865,20630,20705,20490,20705,20570,-160,-295,20,205.72,22
,20161121,20705,20570,20900,21250,20610,20925,21045,355,475,178,"1,873.30",140
,20161122,20925,21045,21005,21660,20310,21615,21425,570,380,42,449.94,148
,20161123,21615,21425,21515,21580,21320,21415,21385,-10,-40,22,235.24,142
,20161124,21415,21385,21375,22665,21250,22380,22040,995,655,68,749.40,158
,20161125,22380,22040,22415,22865,22165,22735,22600,695,560,38,429.47,152
,20161128,22735,22600,23195,24180,22555,24100,23870,1500,1270,54,644.61,154
,20161129,24100,23870,24425,24495,23450,23450,24075,-420,205,56,674.10,142
,20161130,23450,24075,24490,24490,22385,22385,22635,-1690,-1440,258,"2,920.33",86
,20161201,22385,22635,22380,22600,22375,22585,22480,-50,-155,32,359.72,80
,20161202,22585,22480,22935,22935,21995,22105,22315,-375,-165,100,"1,115.93",96
,20161205,22105,22315,21970,22690,21900,22690,22115,375,-200,160,"1,769.43",176
,20161206,22690,22115,22750,23285,22660,22730,22895,615,780,28,320.56,180
,20161207,22730,22895,22755,23200,22755,22955,22995,60,100,12,137.97,180
,20161208,22955,22995,23565,23565,22600,22795,23030,-200,35,22,253.38,180
,20161209,22795,23030,22900,22900,22210,22625,22485,-405,-545,78,877.04,232
,20161212,22625,22485,22640,23005,22455,22830,22780,345,295,64,729.04,240
,20161213,22830,22780,22470,22850,22365,22545,22505,-235,-275,22,247.57,238
,20161214,22545,22505,22730,22765,22400,22685,22585,180,80,90,"1,016.46",288
,20161215,22685,22585,22535,23355,22505,22990,23000,405,415,138,"1,587.28",268
,20161216,22990,23000,22765,23145,22715,22715,22930,-285,-70,52,596.27,282
,20161219,22715,22930,22615,22725,22000,22000,22380,-930,-550,88,984.83,334
,20161220,22000,22380,21765,21765,21040,21390,21385,-990,-995,108,"1,154.90",334
,20161221,21390,21385,21470,21620,21395,21485,21510,100,125,26,279.68,338
,20161222,21485,21510,21490,21580,21120,21120,21425,-390,-85,18,192.85,338
,20161223,21120,21425,21115,21680,21115,21455,21480,30,55,46,494.06,344
,20161226,21455,21480,21415,21415,19975,20045,20355,-1435,-1125,62,631.13,324
,20161227,20045,20355,20215,20420,20045,20420,20195,65,-160,118,"1,191.65",314
,20161228,20420,20195,20410,21150,20355,20720,20940,525,745,54,565.39,316
,20161229,20720,20940,20860,21220,20860,21220,21020,280,80,22,231.26,316
,20161230,21220,21020,20960,21055,20925,21055,21010,35,-10,10,105.05,316
zn1712,20161216,23000,23000,23120,23120,23120,23120,23120,120,120,2,23.12,2
,20161219,23120,23120,22690,22690,22690,22690,22690,-430,-430,2,22.69,4
,20161220,22690,22690,21655,21835,21105,21340,21410,-1350,-1280,24,256.96,12
,20161221,21340,21410,21555,21600,21555,21600,21575,190,165,4,43.16,14
,20161222,21600,21575,21465,21465,20870,20870,21165,-705,-410,4,42.34,18
,20161223,20870,21165,21105,21910,20980,21300,21220,135,55,24,254.66,24
,20161226,21300,21220,20900,20900,20000,20160,20435,-1060,-785,22,224.83,26
,20161227,20160,20435,20235,20475,20230,20475,20320,40,-115,12,121.92,34
,20161228,20475,20320,20430,21050,20370,20970,20735,650,415,70,725.82,42
,20161229,20970,20735,21235,21235,20745,21130,20955,395,220,116,"1,215.49",40
,20161230,21130,20955,21040,21040,21040,21040,21040,85,85,4,42.08,40
