合约,日期,前收盘,前结算,开盘价,最高价,最低价,收盘价,结算价,涨跌1,涨跌2,成交量,成交金额,持仓量
ag1701,20170103,3902,3994,3979,3995,3975,3991,3989,-3,-5,308,"1,843.03",23784
,20170104,3991,3989,3976,4033,3976,4024,4024,35,35,4340,"26,198.05",22624
,20170105,4024,4024,4028,4033,4008,4033,4025,9,1,560,"3,381.02",22080
,20170106,4033,4025,4026,4036,3981,3984,4013,-41,-12,456,"2,745.17",22040
,20170109,3984,4013,3984,4005,3968,3992,3992,-21,-21,2816,"16,864.51",20536
,20170110,3992,3992,4024,4030,4008,4026,4019,34,27,1964,"11,841.47",20552
,20170111,4026,4019,4011,4064,4011,4058,4055,39,36,1192,"7,251.90",20620
,20170112,4058,4055,4020,4050,4020,4042,4039,-13,-16,64,387.77,20580
,20170113,4042,4039,4026,4026,4004,4009,4015,-30,-24,1184,"7,131.32",20756
,20170116,4009,4015,4020,4228,3991,4050,4014,35,-1,1652,"9,948.20",21148
ag1702,20170103,4027,4029,3997,4010,3991,3991,3998,-38,-31,154,923.64,2140
,20170104,3991,3998,3991,4043,3991,4040,4032,42,34,32,193.54,2132
,20170105,4040,4032,4032,4057,4021,4052,4047,20,15,96,582.88,2084
,20170106,4052,4047,4041,4052,4000,4000,4041,-47,-6,224,"1,357.91",2038
,20170109,4000,4041,3994,4027,3994,4014,4013,-27,-28,216,"1,300.33",2068
,20170110,4014,4013,4032,4052,4032,4052,4043,39,30,72,436.73,2024
,20170111,4052,4043,4042,4081,4042,4080,4076,37,33,120,733.72,1906
,20170112,4080,4076,4058,4069,4044,4063,4055,-13,-21,88,535.33,1890
,20170113,4063,4055,4073,4073,4028,4030,4045,-25,-10,116,704.00,1864
,20170116,4030,4045,4015,4063,4006,4063,4041,18,-4,284,"1,721.60",2000
,20170117,4063,4041,4057,4074,4045,4059,4056,18,15,216,"1,314.19",2046
,20170118,4059,4056,4065,4091,4060,4060,4069,4,13,888,"5,420.58",2500
,20170119,4060,4069,4064,4071,4017,4032,4031,-37,-38,136,822.43,2586
,20170120,4032,4031,4037,4039,4018,4020,4028,-11,-3,140,845.94,2608
,20170123,4020,4028,4018,4054,4018,4048,4049,20,21,1978,"12,013.61",4162
,20170124,4048,4049,4048,4056,4041,4041,4048,-8,-1,128,777.34,4200
,20170125,4041,4048,4035,4051,3999,4006,4007,-42,-41,128,769.52,4262
,20170126,4006,4007,3999,4005,3899,3950,3963,-57,-44,182,"1,081.90",4228
,20170203,3950,3963,4029,4029,4021,4021,4026,58,63,44,265.75,4260
,20170206,4021,4026,4049,4067,4049,4066,4060,40,34,2256,"13,740.40",6260
,20170207,4066,4060,4069,4089,4065,4082,4075,22,15,972,"5,941.65",7016
,20170208,4082,4075,4085,4090,4071,4083,4083,8,8,280,"1,715.04",7204
,20170209,4083,4083,4103,4103,4093,4093,4097,10,14,300,"1,843.87",7340
,20170210,4093,4097,4097,4097,4067,4068,4068,-29,-29,556,"3,393.17",7776
,20170213,4068,4068,4127,4227,4036,4140,4138,72,70,612,"3,799.45",8252
,20170214,4140,4138,4138,4145,4041,4145,4137,7,-1,328,"2,035.55",8564
,20170215,4145,4137,4150,4150,4037,4099,4096,-38,-41,956,"5,874.23",8876
ag1703,20170103,4041,4032,4015,4042,4015,4041,4036,9,4,20,121.08,550
,20170104,4041,4036,4023,4122,4018,4064,4058,28,22,50,304.39,556
,20170105,4064,4058,4055,4060,4050,4050,4055,-8,-3,6,36.50,556
,20170106,4050,4055,,,,4055,4055,0,0,0,0.00,556
,20170109,4055,4055,4054,4055,4038,4047,4046,-8,-9,100,607.02,608
,20170110,4047,4046,4060,4075,4053,4069,4067,23,21,48,292.85,632
,20170111,4069,4067,4063,4108,4063,4096,4097,29,30,154,946.46,732
,20170112,4096,4097,4084,4090,4049,4083,4079,-14,-18,52,318.21,726
,20170113,4083,4079,,,,4079,4079,0,0,0,0.00,726
,20170116,4079,4079,4038,4095,4031,4094,4067,15,-12,206,"1,256.96",808
,20170117,4094,4067,4078,4096,4059,4075,4076,8,9,68,415.80,840
,20170118,4075,4076,4102,4102,4102,4102,4102,26,26,6,36.92,846
,20170119,4102,4102,4090,4090,4042,4042,4049,-60,-53,62,376.59,904
,20170120,4042,4049,4055,4055,4054,4054,4054,5,5,12,72.98,916
,20170123,4054,4054,4067,4067,4067,4067,4067,13,13,12,73.21,924
,20170124,4067,4067,4059,4065,4059,4065,4063,-2,-4,6,36.57,926
,20170125,4065,4063,4056,4061,4010,4018,4020,-45,-43,104,627.18,1002
,20170126,4018,4020,3986,3986,3966,3966,3978,-54,-42,8,47.74,1008
,20170203,3966,3978,4042,4042,4038,4038,4039,60,61,12,72.71,1012
,20170206,4038,4039,4030,4084,4030,4084,4078,45,39,304,"1,859.81",1268
,20170207,4084,4078,4102,4109,4085,4097,4091,19,13,680,"4,173.77",1608
,20170208,4097,4091,4095,4119,4095,4096,4102,5,11,32,196.90,1606
,20170209,4096,4102,4133,4136,4111,4113,4119,11,17,48,296.59,1592
,20170210,4113,4119,4125,4132,3903,4085,4060,-34,-59,396,"2,412.07",1622
,20170213,4085,4060,4112,4184,4112,4170,4163,110,103,1128,"7,045.40",2088
,20170214,4170,4163,4165,4186,4143,4171,4163,8,0,1438,"8,981.11",2902
,20170215,4171,4163,4190,4256,4051,4155,4166,-8,3,1262,"7,887.21",3504
,20170216,4155,4166,4145,4192,4145,4159,4180,-7,14,914,"5,731.00",4216
,20170217,4159,4180,4176,4180,4154,4168,4164,-12,-16,578,"3,610.68",4560
,20170220,4168,4164,4154,4156,4140,4145,4144,-19,-20,166,"1,031.90",4658
,20170221,4145,4144,4149,4170,4144,4166,4158,22,14,660,"4,117.11",5122
,20170222,4166,4158,4147,4167,4147,4160,4161,2,3,1184,"7,390.00",5946
,20170223,4160,4161,4185,4186,4150,4150,4167,-11,6,684,"4,275.52",6452
,20170224,4150,4167,4171,4209,4155,4204,4182,37,15,2020,"12,672.92",7646
,20170227,4204,4182,4240,4257,4230,4253,4246,71,64,348,"2,216.77",7536
,20170228,4253,4246,4240,4316,4200,4314,4232,68,-14,316,"2,006.15",7696
,20170301,4314,4232,4245,4245,4205,4217,4221,-15,-11,824,"5,218.04",7604
,20170302,4217,4221,4232,4232,4219,4222,4225,1,4,156,988.72,7704
,20170303,4222,4225,4202,4203,4090,4093,4098,-132,-127,2344,"14,409.70",7856
,20170306,4093,4098,4103,4108,4098,4100,4102,2,4,284,"1,747.64",7996
,20170307,4100,4102,4097,4097,4094,4094,4095,-8,-7,8,49.15,8004
,20170308,4094,4095,4073,4075,4057,4057,4064,-38,-31,268,"1,633.93",8080
,20170309,4057,4064,4030,4030,3991,3998,4002,-66,-62,168,"1,008.59",8108
,20170310,3998,4002,3998,3998,3927,3927,3987,-75,-15,28,167.49,8084
,20170313,3927,3987,,,,3987,3987,0,0,0,0.00,8084
,20170314,3987,3987,4002,4002,4002,4002,4002,15,15,4,24.01,8080
,20170315,4002,4002,4000,4000,3920,3985,3961,-17,-41,28,166.37,8072
ag1704,20170103,4073,4067,,,,4067,4067,0,0,0,0.00,790
,20170104,4067,4067,4096,4096,4096,4096,4096,29,29,2,12.29,792
,20170105,4096,4096,,,,4096,4096,0,0,0,0.00,792
,20170106,4096,4096,4060,4073,4050,4050,4061,-46,-35,12,73.11,792
,20170109,4050,4061,4071,4077,4060,4063,4065,2,4,90,548.86,854
,20170110,4063,4065,4081,4095,4081,4089,4088,24,23,42,257.55,856
,20170111,4089,4088,4116,4118,4116,4118,4117,30,29,12,74.12,866
,20170112,4118,4117,,,,4117,4117,0,0,0,0.00,866
,20170113,4117,4117,,,,4116,4116,-1,-1,0,0.00,866
,20170116,4116,4116,,,,4116,4116,0,0,0,0.00,866
,20170117,4116,4116,4092,4117,4092,4100,4100,-16,-16,20,123.00,866
,20170118,4100,4100,4118,4118,4118,4118,4118,18,18,8,49.42,866
,20170119,4118,4118,,,,4080,4080,-38,-38,0,0.00,866
,20170120,4080,4080,4070,4081,4063,4067,4071,-13,-9,18,109.92,868
,20170123,4067,4071,4065,4105,4065,4088,4094,17,23,82,503.66,862
,20170124,4088,4094,4088,4088,4082,4082,4083,-12,-11,22,134.77,872
,20170125,4082,4083,4065,4065,4040,4040,4055,-43,-28,16,97.34,878
,20170126,4040,4055,4007,4007,4007,4007,4007,-48,-48,4,24.04,878
,20170203,4007,4007,4077,4077,4077,4077,4077,70,70,6,36.69,878
,20170206,4077,4077,4116,4116,4110,4110,4111,33,34,12,74.00,880
,20170207,4110,4111,4118,4132,4112,4120,4116,9,5,376,"2,321.43",880
,20170208,4120,4116,4120,4135,4120,4135,4130,19,14,18,111.51,868
,20170209,4135,4130,4143,4147,4132,4132,4141,2,11,62,385.13,866
,20170210,4132,4141,4140,4144,4108,4108,4111,-33,-30,110,678.35,954
,20170213,4108,4111,4122,4186,4122,4186,4173,75,62,72,450.71,956
,20170214,4186,4173,4194,4197,4170,4195,4191,22,18,112,704.22,948
,20170215,4195,4191,4218,4218,4159,4159,4185,-32,-6,76,477.11,940
,20170216,4159,4185,4177,4200,4174,4180,4188,-5,3,68,427.25,948
,20170217,4180,4188,4194,4199,4168,4183,4180,-5,-8,280,"1,755.70",1196
,20170220,4183,4180,4193,4194,4156,4168,4177,-12,-3,300,"1,880.04",1266
,20170221,4168,4177,4177,4197,4166,4191,4183,14,6,758,"4,756.95",1798
,20170222,4191,4183,4175,4187,4174,4174,4181,-9,-2,62,388.86,1816
,20170223,4174,4181,4183,4202,4166,4166,4183,-15,2,274,"1,719.53",1972
,20170224,4166,4183,4202,4229,4199,4229,4208,46,25,318,"2,007.68",2042
,20170227,4229,4208,4265,4379,4253,4278,4271,70,63,166,"1,063.69",2022
,20170228,4278,4271,4263,4275,4249,4263,4258,-8,-13,314,"2,005.74",2086
,20170301,4263,4258,4262,4265,4226,4234,4234,-24,-24,104,660.63,2098
,20170302,4234,4234,4237,4237,4229,4231,4230,-3,-4,22,139.61,2088
,20170303,4231,4230,4232,4232,4113,4122,4133,-108,-97,94,582.89,2118
,20170306,4122,4133,4122,4150,4119,4119,4125,-14,-8,94,581.70,2106
,20170307,4119,4125,4129,4132,4111,4115,4126,-10,1,58,359.00,2078
,20170308,4115,4126,4100,4100,4077,4080,4082,-46,-44,172,"1,053.27",2160
,20170309,4080,4082,4074,4076,4012,4013,4047,-69,-35,90,546.40,2172
,20170310,4013,4047,4038,4047,3988,3990,4019,-57,-28,66,397.88,2142
,20170313,3990,4019,3985,4025,3985,4025,4015,6,-4,58,349.39,2124
,20170314,4025,4015,4009,4009,3998,3998,4002,-17,-13,14,84.05,2118
,20170315,3998,4002,4000,4006,3997,4006,4001,4,-1,402,"2,412.92",2300
,20170316,4006,4001,4007,4114,4007,4110,4105,109,104,364,"2,241.34",2416
,20170317,4110,4105,4093,4100,4092,4095,4096,-10,-9,140,860.16,2490
,20170320,4095,4096,4101,4113,4098,4107,4105,11,9,1386,"8,535.65",3688
,20170321,4107,4105,4099,4110,4085,4085,4103,-20,-2,126,775.57,3774
,20170322,4085,4103,4122,4130,4119,4130,4124,27,21,1440,"8,909.37",4802
,20170323,4130,4124,4120,4120,4114,4120,4118,-4,-6,12,74.13,4790
,20170324,4120,4118,4131,4135,4102,4105,4119,-13,1,120,741.47,4774
,20170327,4105,4119,4139,4153,4139,4153,4145,34,26,848,"5,273.67",5542
,20170328,4153,4145,4171,4173,4154,4155,4157,10,12,308,"1,920.80",5730
,20170329,4155,4157,4174,4174,4147,4147,4150,-10,-7,442,"2,751.69",6072
,20170330,4147,4150,4161,4161,4148,4160,4156,10,6,266,"1,658.56",6284
,20170331,4160,4156,4147,4149,4130,4145,4141,-11,-15,18,111.81,6280
,20170405,4145,4141,4164,4164,4162,4163,4163,22,22,72,449.60,6272
,20170406,4163,4163,4158,4162,4158,4159,4159,-4,-4,220,"1,372.64",6336
,20170407,4159,4159,4161,4228,4161,4217,4210,58,51,116,732.65,6404
,20170410,4217,4210,4028,4127,4028,4113,4116,-97,-94,356,"2,198.11",6548
,20170411,4113,4116,4105,4119,4105,4117,4110,1,-6,1356,"8,361.35",7368
,20170412,4117,4110,4190,4190,4180,4180,4189,70,79,432,"2,714.52",7768
,20170413,4180,4189,4208,4219,4208,4215,4214,26,25,460,"2,907.92",7312
,20170414,4215,4214,4214,4214,4213,4214,4213,0,-1,268,"1,693.90",7556
,20170417,4214,4213,4169,4230,4169,4220,4208,7,-5,68,429.26,7560
ag1705,20170103,4090,4089,4066,4081,4060,4062,4073,-27,-16,108,659.84,762
,20170104,4062,4073,4056,4117,4056,4111,4106,38,33,196,"1,207.41",790
,20170105,4111,4106,4129,4129,4085,4117,4108,11,2,422,"2,600.84",766
,20170106,4117,4108,4125,4125,4055,4055,4100,-53,-8,298,"1,833.11",790
,20170109,4055,4100,4063,4097,4063,4083,4083,-17,-17,66,404.24,794
,20170110,4083,4083,4098,4119,4095,4107,4106,24,23,162,997.91,766
,20170111,4107,4106,4103,4150,4099,4143,4126,37,20,106,656.04,756
,20170112,4143,4126,4120,4135,4105,4133,4124,7,-2,144,890.95,700
,20170113,4133,4124,4135,4135,4082,4097,4114,-27,-10,166,"1,024.48",696
,20170116,4097,4114,4098,4136,4072,4134,4096,20,-18,286,"1,757.60",716
,20170117,4134,4096,4113,4141,4104,4117,4116,21,20,152,938.59,710
,20170118,4117,4116,4126,4165,4118,4122,4135,6,19,342,"2,121.33",706
,20170119,4122,4135,4118,4136,4073,4082,4104,-53,-31,252,"1,551.58",720
,20170120,4082,4104,4096,4100,4074,4088,4087,-16,-17,188,"1,152.59",668
,20170123,4088,4087,4077,4116,4077,4106,4101,19,14,30,184.55,666
,20170124,4106,4101,4108,4118,4100,4100,4109,-1,8,86,530.14,680
,20170125,4100,4109,4095,4113,4047,4055,4074,-54,-35,244,"1,491.44",732
,20170126,4055,4074,4060,4060,4008,4015,4020,-59,-54,278,"1,676.57",766
,20170203,4015,4020,4086,4096,4073,4073,4087,53,67,84,515.06,736
,20170206,4073,4087,4075,4132,4075,4130,4106,43,19,94,579.06,742
,20170207,4130,4106,4142,4156,4126,4143,4136,37,30,198,"1,228.43",790
,20170208,4143,4136,4143,4168,4133,4148,4147,12,11,108,671.82,746
,20170209,4148,4147,4169,4274,4151,4151,4174,4,27,220,"1,377.56",804
,20170210,4151,4174,4154,4175,4125,4151,4150,-23,-24,430,"2,676.95",950
,20170213,4151,4150,4126,4228,4126,4207,4201,57,51,592,"3,730.51",790
,20170214,4207,4201,4203,4224,4185,4214,4203,13,2,198,"1,248.34",790
,20170215,4214,4203,4250,4250,4182,4198,4212,-5,9,368,"2,325.03",796
,20170216,4198,4212,4196,4237,4183,4208,4216,-4,4,192,"1,214.27",784
,20170217,4208,4216,4248,4249,4201,4207,4218,-9,2,114,721.30,798
,20170220,4207,4218,4214,4214,4188,4188,4199,-30,-19,92,579.50,800
,20170221,4188,4199,4192,4229,4192,4217,4206,18,7,114,719.27,794
,20170222,4217,4206,4199,4218,4190,4204,4204,-2,-2,134,845.10,788
,20170223,4204,4204,4205,4234,4201,4203,4216,-1,12,98,619.81,790
,20170224,4203,4216,4222,4263,4220,4262,4247,46,31,666,"4,243.68",928
,20170227,4262,4247,4299,4310,4280,4310,4296,63,49,146,941.00,956
,20170228,4310,4296,4301,4307,4277,4291,4291,-5,-5,222,"1,429.22",980
,20170301,4291,4291,4283,4297,4254,4270,4268,-21,-23,60,384.14,996
,20170302,4270,4268,4270,4278,4261,4268,4270,0,2,114,730.19,936
,20170303,4268,4270,4262,4263,4101,4135,4239,-135,-31,592,"3,764.92",1108
,20170306,4135,4239,4175,4286,4120,4120,4151,-119,-88,524,"3,262.81",1142
,20170307,4120,4151,4150,4163,4142,4150,4157,-1,6,490,"3,056.11",1448
,20170308,4150,4157,4141,4141,4100,4100,4113,-57,-44,136,839.24,1484
,20170309,4100,4113,4079,4101,4032,4050,4077,-63,-36,284,"1,736.94",1592
,20170310,4050,4077,4052,4074,4007,4013,4025,-64,-52,236,"1,425.03",1636
,20170313,4013,4025,4052,4052,4002,4052,4032,27,7,266,"1,609.16",1696
,20170314,4052,4032,4038,4049,4024,4024,4035,-8,3,206,"1,247.11",1738
,20170315,4024,4035,4031,4034,4013,4030,4024,-5,-11,510,"3,078.97",1974
,20170316,4030,4024,4024,4140,4019,4127,4111,103,87,564,"3,478.48",2162
,20170317,4127,4111,4132,4132,4111,4119,4117,8,6,104,642.28,2204
,20170320,4119,4117,4125,4140,4125,4132,4133,15,16,102,632.39,2162
,20170321,4132,4133,4150,4150,4110,4110,4121,-23,-12,142,877.79,2116
,20170322,4110,4121,4129,4162,4129,4150,4145,29,24,480,"2,984.54",2406
,20170323,4150,4145,4133,4142,4133,4136,4137,-9,-8,22,136.55,2404
,20170324,4136,4137,4143,4143,4127,4127,4134,-10,-3,38,235.64,2404
,20170327,4127,4134,4143,4357,4138,4357,4174,223,40,118,738.82,2428
,20170328,4357,4174,4250,4250,4174,4180,4187,6,13,268,"1,683.30",2390
,20170329,4180,4187,4187,4193,4163,4177,4175,-10,-12,90,563.74,2406
,20170330,4177,4175,4177,4184,4171,4180,4178,5,3,210,"1,316.33",2356
,20170331,4180,4178,4164,4169,4155,4169,4163,-9,-15,54,337.23,2320
,20170405,4169,4163,4185,4185,4178,4178,4182,15,19,28,175.65,2328
,20170406,4178,4182,4167,4183,4167,4181,4180,-1,-2,92,576.85,2354
,20170407,4181,4180,4181,4243,4181,4229,4217,49,37,200,"1,265.36",2358
,20170410,4229,4217,4241,4242,4050,4140,4174,-77,-43,164,"1,027.05",2402
,20170411,4140,4174,4128,4135,4106,4128,4128,-46,-46,22,136.22,2388
,20170412,4128,4128,4158,4221,4149,4195,4191,67,63,28,176.06,2382
,20170413,4195,4191,4200,4231,4195,4227,4219,36,28,50,316.47,2364
,20170414,4227,4219,4234,4234,4227,4230,4230,11,11,8,50.76,2358
,20170417,4230,4230,4283,4287,4240,4240,4267,10,37,72,460.91,2348
,20170418,4240,4267,4223,4228,4207,4216,4217,-51,-50,652,"4,124.36",2700
,20170419,4216,4217,4210,4210,4174,4177,4183,-40,-34,348,"2,183.68",2698
,20170420,4177,4183,4177,4186,4164,4164,4174,-19,-9,166,"1,039.51",2700
,20170421,4164,4174,4155,4170,4140,4143,4151,-31,-23,110,684.97,2702
,20170424,4143,4151,4127,4146,4114,4115,4129,-36,-22,40,247.74,2698
,20170425,4115,4129,4118,4137,4110,4134,4130,5,1,534,"3,308.70",3074
,20170426,4134,4130,4116,4123,4102,4102,4112,-28,-18,868,"5,354.53",3752
,20170427,4102,4112,4099,4099,4091,4091,4096,-21,-16,14,86.02,3758
,20170428,4091,4096,4093,4106,4086,4106,4090,10,-6,46,282.27,3756
,20170502,4106,4090,4021,4021,4010,4021,4012,-69,-78,68,409.29,3768
,20170503,4021,4012,4014,4019,4011,4011,4016,-1,4,32,192.79,3740
,20170504,4011,4016,3970,3972,3913,3913,3939,-103,-77,176,"1,040.10",3836
,20170505,3913,3939,3855,3932,3855,3926,3883,-13,-56,1244,"7,246.07",4416
,20170508,3926,3883,3909,3919,3909,3917,3916,34,33,292,"1,715.62",4428
,20170509,3917,3916,3910,3910,3890,3893,3906,-23,-10,424,"2,484.82",4748
,20170510,3893,3906,3872,3890,3858,3880,3865,-26,-41,188,"1,090.17",4736
,20170511,3880,3865,3900,3910,3900,3910,3902,45,37,36,210.76,4744
,20170512,3910,3902,3955,3968,3932,3932,3953,30,51,348,"2,063.69",4748
,20170515,3932,3953,3935,3935,3935,3935,3935,-18,-18,4,23.61,4748
ag1706,20170103,4113,4102,4076,4107,4070,4078,4088,-24,-14,224568,"1,377,371.13",702900
,20170104,4078,4088,4071,4145,4063,4130,4113,42,25,735862,"4,540,271.86",713016
,20170105,4130,4113,4129,4149,4102,4137,4126,24,13,589950,"3,651,578.39",709016
,20170106,4137,4126,4129,4147,4069,4075,4120,-51,-6,703100,"4,345,337.30",706882
,20170109,4075,4120,4090,4120,4083,4109,4102,-11,-18,478496,"2,944,267.80",701796
,20170110,4109,4102,4107,4140,4107,4126,4127,24,25,490692,"3,037,894.59",702764
,20170111,4126,4127,4123,4173,4115,4161,4153,34,26,599530,"3,735,010.37",705988
,20170112,4161,4153,4148,4154,4105,4150,4133,-3,-20,681992,"4,228,796.03",688200
,20170113,4150,4133,4150,4158,4100,4114,4130,-19,-3,510994,"3,165,925.27",696168
,20170116,4114,4130,4122,4156,4088,4145,4121,15,-9,658596,"4,071,200.48",725342
,20170117,4145,4121,4135,4163,4120,4134,4137,13,16,505562,"3,137,403.03",705192
,20170118,4134,4137,4139,4183,4129,4139,4154,2,17,751404,"4,682,817.84",695382
,20170119,4139,4154,4138,4162,4093,4103,4127,-51,-27,572116,"3,541,967.15",698376
,20170120,4103,4127,4115,4117,4087,4102,4104,-25,-23,468122,"2,882,153.76",676654
,20170123,4102,4104,4100,4138,4095,4128,4115,24,11,549726,"3,393,618.49",674800
,20170124,4128,4115,4128,4136,4112,4117,4125,2,10,303432,"1,877,566.08",662280
,20170125,4117,4125,4116,4130,4046,4075,4099,-50,-26,446408,"2,745,057.82",650518
,20170126,4075,4099,4073,4080,4020,4025,4042,-74,-57,396474,"2,404,085.93",641770
,20170203,4025,4042,4120,4125,4092,4095,4105,53,63,221832,"1,366,193.18",601966
,20170206,4095,4105,4091,4152,4082,4150,4122,45,17,514068,"3,179,197.47",625786
,20170207,4150,4122,4159,4173,4142,4162,4155,40,33,369010,"2,300,224.58",639496
,20170208,4162,4155,4163,4187,4148,4163,4166,8,11,428594,"2,678,585.88",650776
,20170209,4163,4166,4182,4207,4165,4170,4183,4,17,423838,"2,659,576.32",654004
,20170210,4170,4183,4177,4193,4143,4150,4163,-33,-20,424812,"2,653,374.33",644578
,20170213,4150,4163,4152,4247,4150,4229,4206,66,43,870748,"5,494,732.14",759940
,20170214,4229,4206,4228,4238,4203,4233,4222,27,16,482742,"3,057,311.25",782628
,20170215,4233,4222,4250,4260,4200,4220,4227,-2,5,686428,"4,352,468.56",735076
,20170216,4220,4227,4220,4250,4187,4226,4225,-1,-2,563782,"3,573,489.50",720300
,20170217,4226,4225,4237,4247,4214,4227,4232,2,7,449998,"2,856,803.89",696164
,20170220,4227,4232,4223,4235,4197,4209,4215,-23,-17,357236,"2,258,945.39",686032
,20170221,4209,4215,4212,4246,4210,4228,4226,13,11,516520,"3,274,564.06",737116
,20170222,4228,4226,4220,4238,4206,4224,4223,-2,-3,461768,"2,925,576.44",720434
,20170223,4224,4223,4229,4258,4213,4221,4229,-2,6,559492,"3,549,175.58",697432
,20170224,4221,4229,4235,4286,4231,4274,4257,45,28,885082,"5,652,343.32",784684
,20170227,4274,4257,4320,4329,4286,4327,4313,70,56,580022,"3,752,560.97",769484
,20170228,4327,4313,4319,4335,4297,4308,4314,-5,1,351914,"2,277,690.66",757246
,20170301,4308,4314,4308,4322,4275,4279,4298,-35,-16,460762,"2,970,677.24",723332
,20170302,4279,4298,4280,4305,4277,4295,4290,-3,-8,352324,"2,267,525.67",729612
,20170303,4295,4290,4286,4288,4140,4159,4201,-131,-89,804376,"5,069,243.03",630586
,20170306,4159,4201,4155,4200,4153,4168,4171,-33,-30,396936,"2,483,727.08",607798
,20170307,4168,4171,4171,4183,4156,4165,4168,-6,-3,242448,"1,515,943.04",597770
,20170308,4165,4168,4157,4158,4122,4126,4134,-42,-34,437032,"2,710,041.54",574606
,20170309,4126,4134,4111,4118,4054,4070,4089,-64,-45,507642,"3,114,308.12",573654
,20170310,4070,4089,4081,4097,4022,4030,4058,-59,-31,509184,"3,099,491.73",599674
,20170313,4030,4058,4035,4075,4018,4067,4053,9,-5,643614,"3,913,679.33",595154
,20170314,4067,4053,4053,4067,4039,4044,4055,-9,2,305228,"1,856,686.73",605900
,20170315,4044,4055,4052,4060,4035,4050,4048,-5,-7,301014,"1,828,002.25",608368
,20170316,4050,4048,4046,4165,4035,4150,4108,102,60,557384,"3,435,074.16",577220
,20170317,4150,4108,4156,4156,4123,4142,4138,34,30,336574,"2,089,490.82",580796
,20170320,4142,4138,4142,4163,4141,4155,4151,17,13,229576,"1,429,748.02",580570
,20170321,4155,4151,4155,4158,4131,4142,4143,-9,-8,239832,"1,490,441.34",563864
,20170322,4142,4143,4148,4186,4147,4175,4169,32,26,445152,"2,784,166.38",562422
,20170323,4175,4169,4168,4172,4156,4167,4163,-2,-6,231072,"1,443,265.28",556558
,20170324,4167,4163,4185,4188,4145,4150,4163,-13,0,347564,"2,170,727.47",536322
,20170327,4150,4163,4162,4204,4158,4200,4182,37,19,408914,"2,565,722.38",563642
,20170328,4200,4182,4214,4223,4196,4202,4208,20,26,352282,"2,223,799.74",559226
,20170329,4202,4208,4217,4225,4191,4201,4208,-7,0,395714,"2,497,846.19",559678
,20170330,4201,4208,4206,4211,4190,4205,4202,-3,-6,299836,"1,890,239.08",570306
,20170331,4205,4202,4203,4214,4180,4192,4193,-10,-9,422030,"2,654,768.72",544300
,20170405,4192,4193,4220,4222,4201,4209,4209,16,16,165778,"1,046,746.92",565790
,20170406,4209,4209,4208,4213,4190,4208,4204,-1,-5,279152,"1,760,580.36",577462
,20170407,4208,4204,4205,4281,4195,4259,4244,55,40,656318,"4,178,285.49",619888
,20170410,4259,4244,4276,4282,4035,4154,4195,-90,-49,634978,"3,995,804.39",529670
,20170411,4154,4195,4150,4165,4127,4157,4151,-38,-44,331990,"2,067,290.94",506596
,20170412,4157,4151,4164,4251,4163,4223,4207,72,56,579366,"3,656,167.90",514258
,20170413,4223,4207,4228,4265,4209,4257,4239,50,32,415164,"2,640,233.57",536180
,20170414,4257,4239,4264,4273,4236,4263,4252,24,13,297474,"1,897,626.37",542366
,20170417,4263,4252,4269,4337,4246,4272,4283,20,31,432558,"2,779,319.46",549852
,20170418,4272,4283,4260,4271,4230,4239,4250,-44,-33,331134,"2,111,006.77",543876
,20170419,4239,4250,4235,4244,4180,4198,4211,-52,-39,544872,"3,441,784.37",533188
,20170420,4198,4211,4208,4214,4182,4200,4197,-11,-14,309030,"1,945,906.51",515136
,20170421,4200,4197,4196,4197,4154,4161,4175,-36,-22,506174,"3,169,939.58",518440
,20170424,4161,4175,4155,4171,4131,4139,4152,-36,-23,473280,"2,947,985.28",477740
,20170425,4139,4152,4135,4163,4126,4150,4146,-2,-6,310932,"1,934,021.82",451372
,20170426,4150,4146,4132,4146,4113,4120,4129,-26,-17,339500,"2,103,042.40",426408
,20170427,4120,4129,4116,4125,4097,4115,4113,-14,-16,335172,"2,068,282.85",412556
,20170428,4115,4113,4115,4122,4103,4110,4111,-3,-2,280996,"1,733,063.51",391904
,20170502,4110,4111,4050,4052,4017,4037,4035,-74,-76,222902,"1,349,214.50",399038
,20170503,4037,4035,4024,4043,4022,4035,4032,0,-3,209404,"1,266,781.35",382704
,20170504,4035,4032,4027,4032,3875,3933,3971,-99,-61,548280,"3,265,921.69",378810
,20170505,3933,3971,3890,3951,3880,3923,3907,-48,-64,359334,"2,105,973.52",355994
,20170508,3923,3907,3925,3944,3908,3934,3926,27,19,247094,"1,455,438.81",349322
,20170509,3934,3926,3932,3932,3895,3916,3918,-10,-8,176252,"1,035,991.46",334770
,20170510,3916,3918,3896,3905,3866,3899,3893,-19,-25,190642,"1,113,403.70",313782
,20170511,3899,3893,3914,3935,3906,3931,3920,38,27,134170,"789,101.24",288704
,20170512,3931,3920,3927,3964,3918,3957,3941,37,21,98460,"582,061.41",266438
,20170515,3957,3941,3958,3990,3944,3981,3961,40,20,82356,"489,426.17",244864
,20170516,3981,3961,4017,4021,3984,4007,4002,46,41,86434,"518,988.53",215038
,20170517,4007,4002,4013,4026,3992,4015,4012,13,10,67284,"404,974.14",195892
,20170518,4015,4012,4023,4046,3996,4002,4024,-10,12,63282,"382,001.45",184374
,20170519,4002,4024,3996,4011,3961,3992,3989,-32,-35,51642,"309,042.22",176660
,20170522,3992,3989,4007,4015,3983,4003,4001,14,12,50668,"304,093.58",160264
,20170523,4003,4001,4020,4035,4011,4024,4024,23,23,49684,"299,910.01",143674
,20170524,4024,4024,4033,4041,3976,3987,4006,-37,-18,48768,"293,097.20",129086
,20170525,3987,4006,3997,4026,3986,4010,4007,4,1,32216,"193,636.53",121362
,20170526,4010,4007,4006,4012,3992,4009,4001,2,-6,27070,"162,464.60",110006
,20170531,4009,4001,4009,4020,3981,3987,3995,-14,-6,20214,"121,146.23",102048
,20170601,3987,3995,3994,3996,3963,3973,3982,-22,-13,17116,"102,246.73",95936
,20170602,3973,3982,3960,3968,3945,3958,3956,-24,-26,10312,"61,196.98",92376
,20170605,3958,3956,3977,4028,3974,4021,4013,65,57,16416,"98,820.83",84348
,20170606,4021,4013,4022,4056,4010,4045,4036,32,23,17840,"108,015.20",81868
,20170607,4045,4036,4050,4065,4044,4056,4054,20,18,5452,"33,160.07",80596
,20170608,4056,4054,4048,4056,4030,4049,4042,-5,-12,5292,"32,090.92",79064
,20170609,4049,4042,4045,4047,3976,3982,3998,-60,-44,6660,"39,944.89",74212
,20170612,3982,3998,3971,3980,3947,3951,3954,-47,-44,8224,"48,786.88",70392
,20170613,3951,3954,3840,3941,3840,3929,3926,-25,-28,5044,"29,705.84",67192
,20170614,3929,3926,3895,3945,3895,3940,3934,14,8,1740,"10,269.19",66256
,20170615,3940,3934,3985,4008,3915,3935,3965,1,31,5628,"33,478.52",66556
ag1707,20170103,4127,4132,4110,4110,4110,4110,4110,-22,-22,2,12.33,210
,20170104,4110,4110,4118,4159,4118,4149,4148,39,38,128,796.51,238
,20170105,4149,4148,4147,4147,4147,4147,4147,-1,-1,10,62.21,228
,20170106,4147,4147,4146,4146,4146,4146,4146,-1,-1,2,12.44,230
,20170109,4146,4146,4135,4135,4119,4123,4127,-23,-19,16,99.05,228
,20170110,4123,4127,4151,4158,4151,4151,4153,24,26,14,87.21,232
,20170111,4151,4153,4140,4193,4135,4188,4176,35,23,56,350.82,230
,20170112,4188,4176,4162,4162,4160,4160,4160,-16,-16,10,62.41,232
,20170113,4160,4160,4168,4168,4124,4124,4153,-36,-7,46,286.59,236
,20170116,4124,4153,4140,4152,4140,4152,4146,-1,-7,6,37.32,236
,20170117,4152,4146,,,,4146,4146,0,0,0,0.00,236
,20170118,4146,4146,,,,4146,4146,0,0,0,0.00,236
,20170119,4146,4146,4164,4179,4092,4092,4148,-54,2,10,62.23,240
,20170120,4092,4148,4139,4141,4139,4141,4140,-7,-8,4,24.84,240
,20170123,4141,4140,4140,4140,4127,4140,4134,0,-6,8,49.61,238
,20170124,4140,4134,4151,4154,4138,4138,4148,4,14,8,49.78,242
,20170125,4138,4148,4098,4108,4083,4093,4093,-55,-55,316,"1,940.30",262
,20170126,4093,4093,4096,4098,4041,4046,4063,-47,-30,38,231.65,246
,20170203,4046,4063,4127,4135,4127,4127,4128,64,65,10,61.93,244
,20170206,4127,4128,4119,4129,4119,4129,4126,1,-2,8,49.52,242
,20170207,4129,4126,4178,4178,4178,4178,4178,52,52,4,25.07,246
,20170208,4178,4178,4188,4195,4118,4188,4181,10,3,18,112.90,254
,20170209,4188,4181,4202,4202,4194,4194,4198,13,17,4,25.19,252
,20170210,4194,4198,4207,4210,4182,4187,4205,-11,7,38,239.71,284
,20170213,4187,4205,4243,4243,4243,4243,4243,38,38,2,12.73,286
,20170214,4243,4243,4236,4236,4236,4236,4236,-7,-7,6,38.12,280
,20170215,4236,4236,4260,4260,4235,4243,4244,7,8,16,101.88,278
,20170216,4243,4244,4230,4266,4230,4266,4258,22,14,40,255.49,286
,20170217,4266,4258,4245,4245,4245,4245,4245,-13,-13,2,12.74,288
,20170220,4245,4245,4250,4250,4221,4233,4233,-12,-12,20,127.00,290
,20170221,4233,4233,4236,4249,4236,4247,4241,14,8,90,572.56,262
,20170222,4247,4241,4230,4251,4223,4251,4230,10,-11,80,507.64,236
,20170223,4251,4230,4249,4249,4249,4249,4249,19,19,4,25.49,236
,20170224,4249,4249,4259,4287,4259,4287,4270,38,21,42,269.07,236
,20170227,4287,4270,,,,4302,4302,32,32,0,0.00,236
,20170228,4302,4302,4336,4336,4326,4326,4331,24,29,4,25.99,236
,20170301,4326,4331,4329,4329,4302,4302,4315,-29,-16,4,25.89,238
,20170302,4302,4315,4307,4307,4307,4307,4307,-8,-8,4,25.84,238
,20170303,4307,4307,4296,4299,4142,4196,4221,-111,-86,110,696.47,234
,20170306,4196,4221,4196,4200,4185,4191,4193,-30,-28,10,62.90,234
,20170307,4191,4193,4187,4187,4176,4185,4179,-8,-14,76,476.51,260
,20170308,4185,4179,4173,4173,4151,4156,4154,-23,-25,98,610.71,232
,20170309,4156,4154,4101,4118,4101,4104,4116,-50,-38,44,271.70,262
,20170310,4104,4116,4103,4103,4048,4048,4068,-68,-48,84,512.67,258
,20170313,4048,4068,4050,4091,4050,4091,4081,23,13,82,502.05,254
,20170314,4091,4081,4077,4084,4064,4064,4078,-17,-3,82,501.60,238
,20170315,4064,4078,4059,4070,4059,4070,4064,-8,-14,20,121.94,248
,20170316,4070,4064,4070,4180,4070,4167,4138,103,74,102,633.25,278
,20170317,4167,4138,4177,4177,4170,4172,4173,34,35,10,62.60,280
,20170320,4172,4173,4183,4183,4180,4180,4182,7,9,22,138.01,302
,20170321,4180,4182,4168,4168,4150,4151,4159,-31,-23,48,299.52,272
,20170322,4151,4159,4188,4203,4188,4203,4195,44,36,4,25.17,270
,20170323,4203,4195,4185,4185,4179,4182,4180,-13,-15,16,100.34,262
,20170324,4182,4180,4172,4179,4172,4179,4175,-1,-5,4,25.05,262
,20170327,4179,4175,4200,4216,4200,4216,4210,41,35,12,75.79,254
,20170328,4216,4210,4227,4234,4224,4224,4229,14,19,8,50.76,250
,20170329,4224,4229,4235,4238,4174,4216,4211,-13,-18,46,290.56,240
,20170330,4216,4211,4215,4231,4213,4213,4219,2,8,32,202.53,244
,20170331,4213,4219,4220,4226,4201,4201,4209,-18,-10,36,227.30,220
,20170405,4201,4209,4276,4276,4223,4228,4242,19,33,6,38.18,216
,20170406,4228,4242,4228,4228,4228,4228,4228,-14,-14,2,12.68,218
,20170407,4228,4228,4244,4290,4244,4290,4277,62,49,66,423.49,250
,20170410,4290,4277,4285,4285,4152,4188,4199,-89,-78,44,277.14,254
,20170411,4188,4199,4164,4184,4162,4184,4165,-15,-34,92,574.87,244
,20170412,4184,4165,4191,4272,4191,4250,4244,85,79,20,127.34,238
,20170413,4250,4244,4266,4281,4266,4281,4273,37,29,4,25.64,238
,20170414,4281,4273,4279,4281,4256,4281,4272,8,-1,8,51.27,236
,20170417,4281,4272,4300,4323,4284,4298,4307,26,35,30,193.85,234
,20170418,4298,4307,4272,4272,4272,4272,4272,-35,-35,4,25.63,230
,20170419,4272,4272,4230,4248,4226,4226,4236,-46,-36,20,127.10,234
,20170420,4226,4236,4208,4222,4208,4216,4216,-20,-20,16,101.20,226
,20170421,4216,4216,,,,4216,4216,0,0,0,0.00,226
,20170424,4216,4216,4170,4170,4170,4170,4170,-46,-46,2,12.51,226
,20170425,4170,4170,,,,4170,4170,0,0,0,0.00,226
,20170426,4170,4170,4159,4161,4159,4161,4160,-9,-10,4,24.96,226
,20170427,4161,4160,4141,4142,4132,4132,4134,-28,-26,36,223.28,226
,20170428,4132,4134,4142,4142,4126,4128,4135,-6,1,18,111.67,232
,20170502,4128,4135,4057,4060,4057,4060,4059,-75,-76,12,73.06,238
,20170503,4060,4059,4053,4056,4050,4055,4052,-4,-7,28,170.20,226
,20170504,4055,4052,4040,4041,3923,3950,3987,-102,-65,100,598.19,192
,20170505,3950,3987,3950,3950,3907,3945,3926,-42,-61,26,153.12,178
,20170508,3945,3926,3952,3955,3951,3955,3952,29,26,6,35.57,180
,20170509,3955,3952,,,,3952,3952,0,0,0,0.00,180
,20170510,3952,3952,3895,3925,3860,3916,3910,-36,-42,50,293.30,170
,20170511,3916,3910,3845,3950,3830,3950,3900,40,-10,106,620.15,206
,20170512,3950,3900,3895,3971,3880,3971,3929,71,29,154,907.80,314
,20170515,3971,3929,3965,3997,3962,3997,3975,68,46,14,83.49,314
,20170516,3997,3975,4031,4031,4006,4008,4019,33,44,56,337.66,306
,20170517,4008,4019,4035,4104,4009,4036,4032,17,13,46,278.24,286
,20170518,4036,4032,4048,4094,4033,4044,4048,12,16,138,837.99,276
,20170519,4044,4048,4044,4078,3987,4009,4021,-39,-27,46,277.49,266
,20170522,4009,4021,4021,4024,4008,4023,4020,2,-1,44,265.35,262
,20170523,4023,4020,4029,4060,4029,4044,4045,24,25,102,619.03,258
,20170524,4044,4045,3969,4051,3969,4005,4040,-40,-5,92,557.65,264
,20170525,4005,4040,3996,4038,3938,4037,4015,-3,-25,164,987.76,394
,20170526,4037,4015,4042,4057,4013,4024,4033,9,18,18,108.90,382
,20170531,4024,4033,4022,4022,4006,4012,4018,-21,-15,52,313.45,426
,20170601,4012,4018,3990,4195,3940,4001,4046,-17,28,174,"1,056.07",414
,20170602,4001,4046,3967,3986,3967,3969,3983,-77,-63,134,800.65,468
,20170605,3969,3983,4002,4055,3999,4031,4016,48,33,582,"3,506.37",724
,20170606,4031,4016,4038,4071,3975,4071,4046,55,30,350,"2,124.65",768
,20170607,4071,4046,4079,4091,4049,4075,4065,29,19,1582,"9,648.53",1204
,20170608,4075,4065,4066,4066,4063,4063,4064,-2,-1,4,24.39,1206
,20170609,4063,4064,4050,4050,4011,4011,4031,-53,-33,186,"1,124.74",1158
,20170612,4011,4031,3995,4004,3967,3970,3983,-61,-48,110,657.26,1206
,20170613,3970,3983,3954,3973,3941,3952,3947,-31,-36,122,722.47,1238
,20170614,3952,3947,3940,3964,3932,3960,3959,13,12,102,605.77,1258
,20170615,3960,3959,4024,4024,3950,3951,3981,-8,22,324,"1,934.99",1382
,20170616,3951,3981,3928,3946,3928,3943,3936,-38,-45,94,554.99,1380
,20170619,3943,3936,3936,3940,3924,3926,3933,-10,-3,308,"1,817.23",1446
,20170620,3926,3933,3921,3935,3919,3934,3926,1,-7,232,"1,366.33",1488
,20170621,3934,3926,3902,3915,3902,3911,3909,-15,-17,52,304.92,1498
,20170622,3911,3909,3911,3956,3903,3956,3942,47,33,84,496.70,1500
,20170623,3956,3942,3957,3957,3945,3955,3951,13,9,30,177.81,1486
,20170626,3955,3951,3974,3974,3951,3953,3957,2,6,148,878.56,1446
,20170627,3953,3957,3933,3938,3920,3938,3929,-19,-28,58,341.82,1448
,20170628,3938,3929,3940,3970,3940,3961,3959,32,30,12,71.27,1444
,20170629,3961,3959,3956,3968,3956,3968,3964,9,5,54,321.11,1438
,20170630,3968,3964,3928,3936,3883,3883,3924,-81,-40,64,376.76,1420
,20170703,3883,3924,3916,3916,3916,3916,3916,-8,-8,4,23.50,1420
,20170704,3916,3916,3865,3865,3791,3803,3831,-113,-85,244,"1,402.33",1444
,20170705,3803,3831,3791,3827,3791,3804,3817,-27,-14,40,229.03,1432
,20170706,3804,3817,3789,3798,3789,3796,3794,-21,-23,20,113.84,1436
,20170707,3796,3794,3784,3784,3757,3766,3767,-28,-27,60,339.07,1472
,20170710,3766,3767,3761,3761,3578,3578,3667,-189,-100,88,484.12,1496
,20170711,3578,3667,3500,3658,3500,3640,3610,-27,-57,184,996.43,1424
,20170712,3640,3610,3714,3714,3673,3673,3693,63,83,8,44.32,1424
,20170713,3673,3693,3730,3732,3730,3732,3730,39,37,24,134.29,1436
,20170714,3732,3730,,,,3730,3730,0,0,0,0.00,1436
,20170717,3730,3730,3730,3767,3730,3754,3754,24,24,36,202.72,1440
ag1708,20170103,4160,4144,,,,4144,4144,0,0,0,0.00,224
,20170104,4144,4144,4171,4171,4166,4166,4167,22,23,6,37.51,222
,20170105,4166,4167,4153,4153,4153,4153,4153,-14,-14,2,12.46,222
,20170106,4153,4153,4176,4176,4134,4134,4159,-19,6,6,37.43,224
,20170109,4134,4159,4137,4161,4137,4145,4145,-14,-14,12,74.62,224
,20170110,4145,4145,4153,4169,4153,4166,4163,21,18,12,74.95,222
,20170111,4166,4163,4156,4199,4156,4199,4190,36,27,16,100.57,224
,20170112,4199,4190,,,,4190,4190,0,0,0,0.00,224
,20170113,4190,4190,4178,4181,4158,4158,4174,-32,-16,10,62.62,216
,20170116,4158,4174,,,,4174,4174,0,0,0,0.00,216
,20170117,4174,4174,4165,4165,4165,4165,4165,-9,-9,4,24.99,212
,20170118,4165,4165,4196,4196,4196,4196,4196,31,31,2,12.59,212
,20170119,4196,4196,4177,4191,4177,4180,4181,-16,-15,14,87.82,206
,20170120,4180,4181,,,,4181,4181,0,0,0,0.00,206
,20170123,4181,4181,4159,4166,4154,4166,4161,-15,-20,8,49.93,208
,20170124,4166,4161,4155,4166,4154,4166,4157,5,-4,16,99.77,204
,20170125,4166,4157,4165,4165,4107,4107,4125,-50,-32,14,86.63,206
,20170126,4107,4125,,,,4098,4098,-27,-27,0,0.00,206
,20170203,4098,4098,,,,4116,4116,18,18,0,0.00,206
,20170206,4116,4116,4154,4184,4144,4184,4156,68,40,10,62.34,208
,20170207,4184,4156,,,,4157,4157,1,1,0,0.00,208
,20170208,4157,4157,4210,4210,4198,4198,4202,41,45,8,50.43,204
,20170209,4198,4202,,,,4202,4202,0,0,0,0.00,204
,20170210,4202,4202,4202,4211,4176,4176,4201,-26,-1,22,138.66,206
,20170213,4176,4201,4242,4301,4242,4271,4272,70,71,16,102.54,212
,20170214,4271,4272,4261,4273,4259,4273,4267,1,-5,22,140.83,220
,20170215,4273,4267,4256,4256,4256,4256,4256,-11,-11,2,12.77,220
,20170216,4256,4256,4248,4248,4248,4248,4248,-8,-8,2,12.74,220
,20170217,4248,4248,4270,4270,4265,4265,4266,17,18,6,38.40,222
,20170220,4265,4266,4259,4259,4249,4249,4254,-17,-12,4,25.52,224
,20170221,4249,4254,4258,4280,4257,4269,4265,15,11,16,102.38,228
,20170222,4269,4265,4275,4275,4260,4260,4267,-5,2,4,25.61,228
,20170223,4260,4267,,,,4267,4267,0,0,0,0.00,228
,20170224,4267,4267,4288,4313,4288,4313,4298,46,31,12,77.36,232
,20170227,4313,4298,4351,4364,4327,4327,4351,29,53,8,52.22,234
,20170228,4327,4351,4360,4360,4351,4351,4352,0,1,10,65.29,228
,20170301,4351,4352,4355,4355,4355,4355,4355,3,3,2,13.07,230
,20170302,4355,4355,4336,4336,4328,4328,4332,-27,-23,4,25.99,230
,20170303,4328,4332,4271,4271,4197,4211,4251,-121,-81,34,216.83,232
,20170306,4211,4251,4210,4210,4159,4209,4192,-42,-59,6,37.73,234
,20170307,4209,4192,,,,4192,4192,0,0,0,0.00,234
,20170308,4192,4192,,,,4192,4192,0,0,0,0.00,234
,20170309,4192,4192,,,,4163,4163,-29,-29,0,0.00,234
,20170310,4163,4163,,,,4114,4114,-49,-49,0,0.00,234
,20170313,4114,4114,4062,4123,4062,4123,4087,9,-27,10,61.32,234
,20170314,4123,4087,4098,4098,4075,4075,4088,-12,1,6,36.80,236
,20170315,4075,4088,4076,4094,4076,4094,4085,6,-3,4,24.51,234
,20170316,4094,4085,4082,4082,4082,4082,4082,-3,-3,2,12.25,232
,20170317,4082,4082,,,,4132,4132,50,50,0,0.00,232
,20170320,4132,4132,4186,4186,4186,4186,4186,54,54,4,25.12,232
,20170321,4186,4186,4174,4208,4162,4208,4176,22,-10,12,75.17,228
,20170322,4208,4176,4187,4197,4187,4197,4193,21,17,8,50.32,226
,20170323,4197,4193,,,,4193,4193,0,0,0,0.00,226
,20170324,4193,4193,4195,4195,4195,4195,4195,2,2,4,25.17,228
,20170327,4195,4195,4232,4232,4227,4232,4231,37,36,14,88.85,230
,20170328,4232,4231,4244,4244,4244,4244,4244,13,13,4,25.46,226
,20170329,4244,4244,,,,4244,4244,0,0,0,0.00,226
,20170330,4244,4244,4256,4256,4241,4241,4251,-3,7,6,38.26,228
,20170331,4241,4251,4227,4227,4216,4216,4221,-35,-30,4,25.33,226
,20170405,4216,4221,4239,4239,4239,4239,4239,18,18,2,12.72,226
,20170406,4239,4239,,,,4239,4239,0,0,0,0.00,226
,20170407,4239,4239,4296,4299,4296,4299,4296,60,57,8,51.56,228
,20170410,4299,4296,4191,4208,4177,4208,4194,-88,-102,66,415.21,226
,20170411,4208,4194,,,,4194,4194,0,0,0,0.00,226
,20170412,4194,4194,4205,4285,4205,4257,4247,63,53,18,114.69,220
,20170413,4257,4247,4296,4298,4296,4298,4296,51,49,42,270.68,252
,20170414,4298,4296,4301,4301,4301,4301,4301,5,5,2,12.90,252
,20170417,4301,4301,4324,4348,4316,4323,4335,22,34,30,195.08,244
,20170418,4323,4335,4297,4297,4297,4297,4297,-38,-38,2,12.89,244
,20170419,4297,4297,4243,4243,4243,4243,4243,-54,-54,2,12.73,244
,20170420,4243,4243,4246,4246,4237,4237,4241,-6,-2,4,25.45,242
,20170421,4237,4241,4227,4227,4209,4209,4217,-32,-24,10,63.26,244
,20170424,4209,4217,4195,4209,4192,4192,4199,-25,-18,30,188.97,232
,20170425,4192,4199,4188,4193,4188,4191,4188,-8,-11,20,125.66,228
,20170426,4191,4188,4174,4174,4160,4160,4164,-28,-24,6,37.48,224
,20170427,4160,4164,,,,4164,4164,0,0,0,0.00,224
,20170428,4164,4164,4150,4150,4150,4150,4150,-14,-14,2,12.45,224
,20170502,4150,4150,,,,4120,4120,-30,-30,0,0.00,224
,20170503,4120,4120,4076,4076,4076,4076,4076,-44,-44,2,12.23,224
,20170504,4076,4076,4042,4048,3966,3999,4017,-77,-59,30,180.79,230
,20170505,3999,4017,3944,3992,3903,3982,3950,-35,-67,70,414.76,242
,20170508,3982,3950,3968,3977,3966,3974,3973,24,23,54,321.89,266
,20170509,3974,3973,3973,3973,3960,3960,3963,-13,-10,22,130.80,256
,20170510,3960,3963,3948,3948,3925,3940,3937,-23,-26,56,330.75,266
,20170511,3940,3937,3964,3966,3957,3958,3963,21,26,16,95.11,262
,20170512,3958,3963,3963,4000,3963,3990,3976,27,13,10,59.65,258
,20170515,3990,3976,3989,4018,3985,4000,3987,24,11,54,323.01,254
,20170516,4000,3987,4048,4048,4011,4044,4036,57,49,98,593.40,310
,20170517,4044,4036,4039,4058,4034,4053,4045,17,9,16,97.08,308
,20170518,4053,4045,4071,4071,4065,4066,4068,21,23,60,366.18,348
,20170519,4066,4068,4047,4047,4000,4030,4023,-38,-45,50,301.78,342
,20170522,4030,4023,4045,4045,4028,4044,4039,21,16,22,133.29,342
,20170523,4044,4039,4057,4085,4057,4064,4066,25,27,42,256.19,336
,20170524,4064,4066,4078,4078,4013,4023,4056,-43,-10,46,279.92,322
,20170525,4023,4056,4025,4025,4025,4025,4025,-31,-31,2,12.08,324
,20170526,4025,4025,4029,4029,4029,4029,4029,4,4,2,12.09,326
,20170531,4029,4029,4073,4073,4023,4023,4034,-6,5,14,84.72,324
,20170601,4023,4034,4026,4027,4006,4006,4019,-28,-15,10,60.30,318
,20170602,4006,4019,3992,4004,3988,3999,3997,-20,-22,92,551.59,310
,20170605,3999,3997,4013,4055,4013,4055,4027,58,30,30,181.25,284
,20170606,4055,4027,,,,4027,4027,0,0,0,0.00,284
,20170607,4027,4027,4091,4094,4089,4094,4091,67,64,14,85.93,284
,20170608,4094,4091,4088,4088,4088,4088,4088,-3,-3,2,12.26,284
,20170609,4088,4088,4041,4041,4041,4041,4041,-47,-47,2,12.12,284
,20170612,4041,4041,3996,3996,3989,3989,3991,-52,-50,16,95.79,294
,20170613,3989,3991,,,,3991,3991,0,0,0,0.00,294
,20170614,3991,3991,3962,3987,3962,3987,3974,-4,-17,10,59.62,294
,20170615,3987,3974,4028,4028,3970,3970,4004,-4,30,8,48.06,294
,20170616,3970,4004,3954,3970,3954,3970,3955,-34,-49,22,130.53,292
,20170619,3970,3955,3963,3971,3939,3941,3947,-14,-8,34,201.31,312
,20170620,3941,3947,3945,3950,3934,3950,3938,3,-9,14,82.72,316
,20170621,3950,3938,3924,3939,3924,3933,3928,-5,-10,18,106.07,320
,20170622,3933,3928,3936,3971,3936,3963,3965,35,37,26,154.64,336
,20170623,3963,3965,3969,3978,3965,3971,3968,6,3,22,130.97,330
,20170626,3971,3968,3978,3978,3969,3969,3971,1,3,8,47.66,332
,20170627,3969,3971,3940,3950,3940,3950,3943,-21,-28,20,118.30,344
,20170628,3950,3943,3958,3988,3958,3982,3973,39,30,12,71.53,344
,20170629,3982,3973,,,,3973,3973,0,0,0,0.00,344
,20170630,3973,3973,3949,3949,3933,3933,3939,-40,-34,8,47.27,346
,20170703,3933,3939,3939,3939,3923,3933,3930,-6,-9,18,106.13,348
,20170704,3933,3930,3754,3888,3754,3820,3830,-110,-100,200,"1,149.18",460
,20170705,3820,3830,3808,3844,3799,3835,3810,5,-20,256,"1,463.04",452
,20170706,3835,3810,3815,3819,3808,3819,3811,9,1,40,228.69,468
,20170707,3819,3811,3849,3849,3783,3785,3799,-26,-12,26,148.18,462
,20170710,3785,3799,3755,3755,3616,3616,3650,-183,-149,106,580.37,546
,20170711,3616,3650,3606,3679,3606,3653,3647,3,-3,108,590.97,480
,20170712,3653,3647,3715,3715,3715,3715,3715,68,68,2,11.15,480
,20170713,3715,3715,3753,3755,3744,3746,3749,31,34,26,146.22,472
,20170714,3746,3749,,,,3741,3741,-8,-8,0,0.00,472
,20170717,3741,3741,3758,3783,3758,3773,3770,32,29,30,169.68,452
,20170718,3773,3770,3798,3798,3796,3796,3796,26,26,16,91.12,442
,20170719,3796,3796,3789,3789,3787,3787,3788,-9,-8,30,170.50,412
,20170720,3787,3788,3784,3784,3775,3781,3779,-7,-9,38,215.45,398
,20170721,3781,3779,3793,3816,3793,3816,3810,37,31,70,400.05,370
,20170724,3816,3810,3814,3822,3811,3817,3816,7,6,26,148.83,362
,20170725,3817,3816,3813,3820,3799,3808,3809,-8,-7,38,217.11,342
,20170726,3808,3809,3808,3828,3781,3782,3794,-27,-15,104,591.93,336
,20170727,3782,3794,3808,3845,3808,3841,3840,47,46,1456,"8,387.83",1678
,20170728,3841,3840,3849,3851,3815,3824,3827,-16,-13,28,160.76,1672
,20170731,3824,3827,3829,3845,3829,3839,3838,12,11,34,195.76,1676
,20170801,3839,3838,3845,3856,3842,3842,3849,4,11,512,"2,956.58",2120
,20170802,3842,3849,3822,3840,3822,3840,3834,-9,-15,200,"1,150.48",2144
,20170803,3840,3834,3827,3827,3817,3817,3819,-17,-15,16,91.67,2144
,20170804,3817,3819,3820,3820,3818,3820,3819,1,0,944,"5,409.02",3076
,20170807,3820,3819,3810,3810,3744,3744,3802,-75,-17,48,273.80,3088
,20170808,3744,3802,3746,3748,3734,3736,3741,-66,-61,52,291.84,3076
,20170809,3736,3741,3790,3790,3785,3785,3788,44,47,16,90.92,3076
,20170810,3785,3788,3850,3893,3836,3893,3857,105,69,16,92.57,3076
,20170811,3893,3857,,,,3920,3920,63,63,0,0.00,3076
,20170814,3920,3920,,,,3920,3920,0,0,0,0.00,3076
,20170815,3920,3920,3852,3852,3852,3852,3852,-68,-68,28,161.78,3076
ag1709,20170103,4184,4168,4165,4165,4165,4165,4165,-3,-3,2,12.50,548
,20170104,4165,4165,4200,4200,4178,4178,4194,13,29,12,75.49,546
,20170105,4178,4194,4190,4192,4182,4192,4188,-2,-6,6,37.69,544
,20170106,4192,4188,4161,4161,4117,4117,4124,-71,-64,12,74.24,542
,20170109,4117,4124,4151,4168,4151,4167,4162,43,38,24,149.87,540
,20170110,4167,4162,4175,4175,4175,4175,4175,13,13,2,12.53,538
,20170111,4175,4175,4199,4224,4199,4210,4209,35,34,54,340.97,514
,20170112,4210,4209,4199,4210,4191,4194,4199,-15,-10,34,214.17,502
,20170113,4194,4199,4180,4180,4172,4172,4174,-27,-25,10,62.61,504
,20170116,4172,4174,4159,4196,4159,4196,4182,22,8,46,288.58,504
,20170117,4196,4182,4187,4214,4187,4200,4195,18,13,10,62.93,512
,20170118,4200,4195,4215,4225,4213,4216,4217,21,22,12,75.91,510
,20170119,4216,4217,4196,4203,4159,4159,4193,-58,-24,58,364.86,504
,20170120,4159,4193,4156,4165,4155,4155,4158,-38,-35,20,124.75,496
,20170123,4155,4158,4175,4192,4159,4192,4179,34,21,8,50.15,498
,20170124,4192,4179,,,,4179,4179,0,0,0,0.00,498
,20170125,4179,4179,4160,4160,4133,4133,4153,-46,-26,14,87.23,488
,20170126,4133,4153,4097,4097,4097,4097,4097,-56,-56,2,12.29,490
,20170203,4097,4097,,,,4136,4136,39,39,0,0.00,490
,20170206,4136,4136,4169,4206,4169,4181,4181,45,45,26,163.08,502
,20170207,4181,4181,4202,4202,4202,4202,4202,21,21,2,12.61,500
,20170208,4202,4202,4209,4233,4209,4233,4219,31,17,18,113.93,508
,20170209,4233,4219,4233,4234,4223,4223,4231,4,12,10,63.47,504
,20170210,4223,4231,4240,4255,4205,4210,4218,-21,-13,16,101.24,512
,20170213,4210,4218,4268,4301,4266,4282,4286,64,68,30,192.91,518
,20170214,4282,4286,4274,4295,4270,4295,4282,9,-4,10,64.23,518
,20170215,4295,4282,4302,4302,4266,4266,4284,-16,2,4,25.70,516
,20170216,4266,4284,4278,4280,4278,4280,4279,-4,-5,10,64.19,506
,20170217,4280,4279,4301,4305,4281,4297,4293,18,14,12,77.28,508
,20170220,4297,4293,4290,4290,4266,4266,4281,-27,-12,22,141.30,522
,20170221,4266,4281,4281,4295,4281,4295,4287,14,6,10,64.32,522
,20170222,4295,4287,4281,4285,4265,4278,4276,-9,-11,40,256.60,522
,20170223,4278,4276,4300,4300,4283,4284,4290,8,14,26,167.32,504
,20170224,4284,4290,4295,4362,4288,4328,4324,38,34,126,817.36,484
,20170227,4328,4324,4357,4374,4354,4360,4363,36,39,46,301.05,472
,20170228,4360,4363,4364,4370,4364,4366,4365,3,2,24,157.16,460
,20170301,4366,4365,4351,4364,4351,4364,4359,-1,-6,18,117.71,466
,20170302,4364,4359,4355,4355,4335,4335,4344,-24,-15,8,52.13,470
,20170303,4335,4344,4331,4331,4211,4227,4249,-117,-95,84,535.41,482
,20170306,4227,4249,4215,4240,4215,4240,4226,-9,-23,32,202.89,476
,20170307,4240,4226,4234,4235,4221,4221,4228,-5,2,18,114.18,478
,20170308,4221,4228,4194,4200,4150,4187,4187,-41,-41,38,238.68,494
,20170309,4187,4187,4160,4204,4098,4130,4147,-57,-40,68,423.05,512
,20170310,4130,4147,4154,4155,4088,4091,4126,-56,-21,64,396.14,528
,20170313,4091,4126,4099,4129,4099,4129,4117,3,-9,70,432.32,570
,20170314,4129,4117,4122,4123,4119,4119,4121,2,4,12,74.19,574
,20170315,4119,4121,4105,4117,4098,4112,4107,-9,-14,64,394.35,590
,20170316,4112,4107,4108,4236,4108,4213,4199,106,92,70,440.99,610
,20170317,4213,4199,4213,4213,4192,4192,4197,-7,-2,8,50.37,602
,20170320,4192,4197,4208,4220,4207,4209,4209,12,12,96,606.19,662
,20170321,4209,4209,4211,4222,4189,4203,4205,-6,-4,48,302.78,644
,20170322,4203,4205,4217,4234,4217,4230,4227,25,22,38,240.99,640
,20170323,4230,4227,4227,4227,4219,4221,4220,-6,-7,38,240.56,614
,20170324,4221,4220,4207,4216,4173,4200,4195,-20,-25,234,"1,472.51",706
,20170327,4200,4195,4223,4263,4218,4263,4233,68,38,252,"1,600.21",628
,20170328,4263,4233,4256,4265,4255,4257,4259,24,26,36,230.01,612
,20170329,4257,4259,4269,4272,4247,4247,4263,-12,4,52,332.57,572
,20170330,4247,4263,,,,4263,4263,0,0,0,0.00,572
,20170331,4263,4263,4259,4259,4242,4242,4246,-21,-17,16,101.91,560
,20170405,4242,4246,4263,4263,4254,4257,4257,11,11,40,255.47,574
,20170406,4257,4257,4257,4267,4245,4263,4258,6,1,62,396.05,566
,20170407,4263,4258,4259,4332,4252,4311,4300,53,42,104,670.85,542
,20170410,4311,4300,4318,4321,4191,4211,4232,-89,-68,96,609.41,552
,20170411,4211,4232,4208,4214,4195,4214,4204,-18,-28,28,176.57,552
,20170412,4214,4204,4224,4304,4222,4278,4269,74,65,72,461.13,544
,20170413,4278,4269,4302,4326,4302,4321,4314,52,45,656,"4,245.10",866
,20170414,4321,4314,4321,4327,4298,4325,4314,11,0,152,983.76,850
,20170417,4325,4314,4342,4392,4320,4336,4346,22,32,178,"1,160.63",846
,20170418,4336,4346,4323,4323,4257,4316,4308,-30,-38,94,607.46,852
,20170419,4316,4308,4284,4302,4255,4257,4277,-51,-31,58,372.11,816
,20170420,4257,4277,4264,4269,4251,4258,4262,-19,-15,62,396.38,810
,20170421,4258,4262,4251,4254,4217,4218,4240,-44,-22,38,241.70,818
,20170424,4218,4240,4215,4236,4200,4207,4217,-33,-23,70,442.85,810
,20170425,4207,4217,4203,4217,4203,4215,4213,-2,-4,8,50.56,808
,20170426,4215,4213,4197,4206,4178,4178,4189,-35,-24,34,213.65,798
,20170427,4178,4189,4181,4185,4161,4171,4169,-18,-20,408,"2,551.77",612
,20170428,4171,4169,4177,4177,4157,4170,4169,1,0,106,662.95,642
,20170502,4170,4169,4088,4100,4088,4092,4094,-77,-75,48,294.81,648
,20170503,4092,4094,4087,4099,4087,4090,4093,-4,-1,110,675.47,696
,20170504,4090,4093,4071,4071,3944,3989,4021,-104,-72,310,"1,869.83",764
,20170505,3989,4021,3960,3995,3941,3980,3977,-41,-44,3014,"17,982.23",852
,20170508,3980,3977,4012,4012,3978,3990,3986,13,9,150,896.92,830
,20170509,3990,3986,3982,3987,3968,3976,3981,-10,-5,90,537.50,832
,20170510,3976,3981,3960,3988,3940,3959,3958,-22,-23,310,"1,840.63",860
,20170511,3959,3958,3973,3987,3961,3980,3978,22,20,478,"2,852.63",1132
,20170512,3980,3978,3983,4012,3973,4003,3996,25,18,418,"2,505.96",1330
,20170515,4003,3996,4008,4036,3989,4036,4008,40,12,180,"1,082.21",1280
,20170516,4036,4008,4098,4098,4036,4057,4055,49,47,298,"1,812.59",1266
,20170517,4057,4055,4050,4074,4041,4060,4061,5,6,162,986.86,1244
,20170518,4060,4061,4083,4093,4048,4055,4081,-6,20,606,"3,710.07",1076
,20170519,4055,4081,4041,4063,4013,4047,4040,-34,-41,124,751.62,1076
,20170522,4047,4040,4059,4063,4047,4055,4056,15,16,272,"1,655.12",1082
,20170523,4055,4056,4070,4094,4068,4081,4085,25,29,628,"3,848.16",934
,20170524,4081,4085,4103,4103,4041,4052,4067,-33,-18,108,658.86,944
,20170525,4052,4067,4061,4087,4051,4075,4072,8,5,268,"1,637.16",1048
,20170526,4075,4072,4062,4072,4056,4070,4065,-2,-7,426,"2,597.55",1156
,20170531,4070,4065,4073,4073,4040,4043,4059,-22,-6,136,828.04,1144
,20170601,4043,4059,4043,4052,4023,4037,4041,-22,-18,136,824.42,1142
,20170602,4037,4041,4021,4029,4001,4006,4015,-35,-26,178,"1,072.10",1126
,20170605,4006,4015,4036,4090,4034,4085,4062,70,47,176,"1,072.54",1094
,20170606,4085,4062,4078,4109,4078,4109,4099,47,37,292,"1,795.63",1220
,20170607,4109,4099,4120,4122,4101,4113,4110,14,11,184,"1,134.50",1238
,20170608,4113,4110,4104,4111,4088,4100,4099,-10,-11,76,467.29,1258
,20170609,4100,4099,4106,4106,4035,4037,4061,-62,-38,180,"1,096.60",1256
,20170612,4037,4061,4033,4038,4003,4005,4019,-56,-42,194,"1,169.76",1284
,20170613,4005,4019,3984,4011,3973,3973,3988,-46,-31,270,"1,615.48",1320
,20170614,3973,3988,3974,4005,3970,4002,3987,14,-1,276,"1,651.03",1350
,20170615,4002,3987,4066,4066,3984,3985,4032,-2,45,328,"1,983.82",1336
,20170616,3985,4032,3956,3990,3956,3989,3976,-43,-56,348,"2,075.99",1368
,20170619,3989,3976,3983,3983,3961,3961,3973,-15,-3,278,"1,656.91",1402
,20170620,3961,3973,3962,3972,3952,3965,3965,-8,-8,222,"1,320.55",1444
,20170621,3965,3965,3945,3954,3937,3954,3947,-11,-18,250,"1,480.36",1506
,20170622,3954,3947,3951,3998,3939,3993,3982,46,35,544,"3,249.47",1512
,20170623,3993,3982,3997,3997,3981,3994,3990,12,8,348,"2,082.82",1488
,20170626,3994,3990,4006,4006,3986,3996,3997,6,7,242,"1,451.02",1468
,20170627,3996,3997,3993,3993,3961,3978,3969,-19,-28,172,"1,024.05",1476
,20170628,3978,3969,3979,4011,3974,4003,3996,34,27,224,"1,342.90",1466
,20170629,4003,3996,3999,4005,3992,3998,3998,2,2,340,"2,039.43",1428
,20170630,3998,3998,3993,3993,3955,3956,3964,-42,-34,296,"1,760.37",1442
,20170703,3956,3964,3952,3969,3943,3956,3955,-8,-9,402,"2,385.09",1578
,20170704,3956,3955,3922,3922,3830,3855,3872,-100,-83,600,"3,484.89",1662
,20170705,3855,3872,3863,3867,3824,3854,3851,-18,-21,502,"2,899.82",1804
,20170706,3854,3851,3836,3870,3798,3836,3829,-15,-22,522,"2,998.52",1778
,20170707,3836,3829,3839,3843,3788,3812,3811,-17,-18,224,"1,280.51",1828
,20170710,3812,3811,3804,3804,3620,3620,3710,-191,-101,1186,"6,601.74",2184
,20170711,3620,3710,3631,3708,3622,3682,3674,-28,-36,902,"4,971.90",2106
,20170712,3682,3674,3698,3770,3691,3737,3729,63,55,1326,"7,417.87",2002
,20170713,3737,3729,3783,3787,3757,3761,3766,32,37,856,"4,835.82",1910
,20170714,3761,3766,3755,3757,3696,3701,3718,-65,-48,320,"1,784.94",1914
,20170717,3701,3718,3785,3846,3752,3787,3785,69,67,798,"4,531.53",1906
,20170718,3787,3785,3813,3824,3785,3794,3810,9,25,366,"2,091.99",1880
,20170719,3794,3810,3806,3810,3788,3805,3802,-5,-8,484,"2,760.68",1738
,20170720,3805,3802,3812,3816,3790,3796,3802,-6,0,190,"1,083.63",1664
,20170721,3796,3802,3809,3858,3796,3836,3822,34,20,332,"1,903.59",1546
,20170724,3836,3822,3843,3848,3821,3826,3836,4,14,226,"1,300.74",1528
,20170725,3826,3836,3839,3848,3820,3838,3835,2,-1,206,"1,185.03",1464
,20170726,3838,3835,3826,3854,3786,3798,3825,-37,-10,320,"1,836.09",1528
,20170727,3798,3825,3808,3869,3808,3856,3846,31,21,252,"1,453.98",1470
,20170728,3856,3846,3867,3913,3840,3843,3860,-3,14,238,"1,378.14",1424
,20170731,3843,3860,3855,3870,3855,3856,3860,-4,0,150,868.72,1352
,20170801,3856,3860,3871,3882,3859,3867,3873,7,13,448,"2,602.73",1586
,20170802,3867,3873,3862,3878,3824,3853,3862,-20,-11,408,"2,363.75",1590
,20170803,3853,3862,3845,3863,3832,3832,3838,-30,-24,108,621.80,1594
,20170804,3832,3838,3842,3859,3837,3852,3842,14,4,218,"1,256.42",1674
,20170807,3852,3842,3824,3830,3759,3759,3782,-83,-60,304,"1,724.71",1780
,20170808,3759,3782,3749,3766,3746,3756,3754,-26,-28,160,901.09,1812
,20170809,3756,3754,3766,3808,3755,3804,3776,50,22,132,747.71,1832
,20170810,3804,3776,3858,3921,3852,3916,3873,140,97,334,"1,940.80",1814
,20170811,3916,3873,3964,3967,3912,3921,3939,48,66,306,"1,808.15",1824
,20170814,3921,3939,3902,3970,3886,3938,3918,-1,-21,114,670.00,1814
,20170815,3938,3918,3932,3932,3883,3895,3899,-23,-19,202,"1,181.63",1678
,20170816,3895,3899,3845,3923,3845,3854,3864,-45,-35,936,"5,426.22",1852
,20170817,3854,3864,3869,3955,3866,3954,3894,90,30,1840,"10,748.42",2716
,20170818,3954,3894,3937,3947,3909,3927,3925,33,31,26,153.08,2706
,20170821,3927,3925,3970,3973,3892,3914,3919,-11,-6,194,"1,140.48",2700
,20170822,3914,3919,3915,3932,3908,3910,3913,-9,-6,184,"1,080.07",2688
,20170823,3910,3913,3925,3930,3893,3899,3905,-14,-8,44,257.79,2684
,20170824,3899,3905,3916,3919,3906,3907,3914,2,9,34,199.65,2672
,20170825,3907,3914,3905,3912,3902,3902,3906,-12,-8,18,105.48,2674
,20170828,3902,3906,3927,3928,3848,3928,3897,22,-9,198,"1,157.47",2652
,20170829,3928,3897,3935,3965,3935,3963,3955,66,58,450,"2,669.85",2980
,20170830,3963,3955,3955,3978,3932,3936,3950,-19,-5,114,675.52,2928
,20170831,3936,3950,3938,3940,3778,3778,3918,-172,-32,202,"1,187.32",3046
,20170901,3778,3918,3870,3958,3866,3931,3920,13,2,494,"2,905.02",3012
,20170904,3931,3920,3956,4000,3956,4000,3988,80,68,116,693.92,3072
,20170905,4000,3988,3983,3988,3982,3988,3985,0,-3,20,119.57,3060
,20170906,3988,3985,4000,4000,3980,3980,3988,-5,3,152,909.41,2996
,20170907,3980,3988,3994,3995,3960,3966,3974,-22,-14,460,"2,742.19",2956
,20170908,3966,3974,3982,3990,3980,3985,3984,11,10,96,573.80,2952
,20170911,3985,3984,3938,3938,3924,3924,3933,-60,-51,36,212.39,2948
,20170912,3924,3933,3952,3952,3907,3907,3932,-26,-1,12,70.78,2948
,20170913,3907,3932,,,,3932,3932,0,0,0,0.00,2948
,20170914,3932,3932,3916,3924,3903,3903,3910,-29,-22,36,211.16,2932
,20170915,3903,3910,3935,3935,3935,3935,3935,25,25,4,23.61,2932
ag1710,20170103,4144,4144,,,,4145,4145,1,1,0,0.00,164
,20170104,4145,4145,,,,4161,4161,16,16,0,0.00,164
,20170105,4161,4161,4214,4214,4214,4214,4214,53,53,2,12.64,162
,20170106,4214,4214,,,,4201,4201,-13,-13,0,0.00,162
,20170109,4201,4201,,,,4201,4201,0,0,0,0.00,162
,20170110,4201,4201,,,,4201,4201,0,0,0,0.00,162
,20170111,4201,4201,4233,4240,4233,4240,4238,39,37,10,63.58,152
,20170112,4240,4238,4217,4217,4197,4217,4213,-21,-25,12,75.84,148
,20170113,4217,4213,4200,4200,4200,4200,4200,-13,-13,4,25.20,152
,20170116,4200,4200,4200,4210,4200,4210,4201,10,1,18,113.43,146
,20170117,4210,4201,4212,4212,4212,4212,4212,11,11,2,12.64,146
,20170118,4212,4212,4209,4236,4203,4234,4222,22,10,20,126.68,162
,20170119,4234,4222,,,,4222,4222,0,0,0,0.00,162
,20170120,4222,4222,4169,4169,4169,4169,4169,-53,-53,4,25.01,158
,20170123,4169,4169,4201,4204,4201,4204,4202,35,33,4,25.22,158
,20170124,4204,4202,,,,4202,4202,0,0,0,0.00,158
,20170125,4202,4202,4199,4199,4156,4157,4170,-45,-32,6,37.54,158
,20170126,4157,4170,4118,4118,4077,4077,4097,-93,-73,16,98.35,154
,20170203,4077,4097,4176,4176,4176,4176,4176,79,79,2,12.53,152
,20170206,4176,4176,,,,4176,4176,0,0,0,0.00,152
,20170207,4176,4176,4234,4234,4234,4234,4234,58,58,2,12.70,150
,20170208,4234,4234,4225,4225,4225,4225,4225,-9,-9,2,12.68,150
,20170209,4225,4225,4244,4244,4244,4244,4244,19,19,4,25.46,148
,20170210,4244,4244,4247,4255,4247,4254,4250,10,6,8,51.01,150
,20170213,4254,4250,4234,4310,4234,4302,4273,52,23,14,89.73,146
,20170214,4302,4273,4306,4306,4306,4306,4306,33,33,2,12.92,144
,20170215,4306,4306,4307,4307,4284,4284,4295,-22,-11,4,25.77,142
,20170216,4284,4295,4305,4305,4305,4305,4305,10,10,4,25.83,138
,20170217,4305,4305,4305,4305,4305,4305,4305,0,0,2,12.92,138
,20170220,4305,4305,,,,4305,4305,0,0,0,0.00,138
,20170221,4305,4305,4296,4315,4283,4315,4298,10,-7,6,38.68,140
,20170222,4315,4298,,,,4298,4298,0,0,0,0.00,140
,20170223,4298,4298,4320,4320,4320,4320,4320,22,22,2,12.96,140
,20170224,4320,4320,,,,4320,4320,0,0,0,0.00,140
,20170227,4320,4320,4391,4391,4391,4391,4391,71,71,2,13.17,140
,20170228,4391,4391,4384,4386,4384,4386,4384,-5,-7,8,52.61,142
,20170301,4386,4384,,,,4384,4384,0,0,0,0.00,142
,20170302,4384,4384,,,,4384,4384,0,0,0,0.00,142
,20170303,4384,4384,4302,4302,4222,4249,4260,-135,-124,14,89.48,156
,20170306,4249,4260,,,,4260,4260,0,0,0,0.00,156
,20170307,4260,4260,4252,4252,4243,4243,4247,-17,-13,4,25.49,156
,20170308,4243,4247,,,,4247,4247,0,0,0,0.00,156
,20170309,4247,4247,4182,4182,4142,4152,4161,-95,-86,10,62.43,154
,20170310,4152,4161,4173,4173,4106,4106,4130,-55,-31,10,61.96,156
,20170313,4106,4130,4119,4151,4119,4151,4135,21,5,4,24.81,156
,20170314,4151,4135,4130,4130,4128,4128,4128,-7,-7,6,37.16,158
,20170315,4128,4128,,,,4128,4128,0,0,0,0.00,158
,20170316,4128,4128,4120,4238,4120,4238,4183,110,55,20,125.51,150
,20170317,4238,4183,,,,4183,4183,0,0,0,0.00,150
,20170320,4183,4183,4224,4230,4224,4230,4227,47,44,4,25.36,148
,20170321,4230,4227,4217,4217,4217,4217,4217,-10,-10,2,12.65,146
,20170322,4217,4217,4248,4248,4239,4248,4243,31,26,8,50.93,144
,20170323,4248,4243,,,,4243,4243,0,0,0,0.00,144
,20170324,4243,4243,4253,4255,4248,4255,4253,12,10,12,76.56,144
,20170327,4255,4253,4268,4293,4225,4273,4264,20,11,36,230.31,146
,20170328,4273,4264,4295,4295,4275,4281,4279,17,15,18,115.55,144
,20170329,4281,4279,4294,4294,4294,4294,4294,15,15,2,12.88,142
,20170330,4294,4294,4274,4274,4274,4274,4274,-20,-20,4,25.64,142
,20170331,4274,4274,4272,4272,4272,4272,4272,-2,-2,4,25.63,140
,20170405,4272,4272,,,,4272,4272,0,0,0,0.00,140
,20170406,4272,4272,,,,4272,4272,0,0,0,0.00,140
,20170407,4272,4272,4338,4343,4329,4329,4338,57,66,20,130.14,142
,20170410,4329,4338,4345,4345,4160,4239,4244,-99,-94,34,216.46,148
,20170411,4239,4244,4235,4235,4212,4212,4223,-32,-21,4,25.34,148
,20170412,4212,4223,4243,4252,4243,4252,4247,29,24,4,25.49,144
,20170413,4252,4247,4336,4336,4326,4326,4331,79,84,4,25.99,144
,20170414,4326,4331,,,,4331,4331,0,0,0,0.00,144
,20170417,4331,4331,4369,4369,4369,4369,4369,38,38,2,13.11,146
,20170418,4369,4369,4323,4323,4323,4323,4323,-46,-46,2,12.97,146
,20170419,4323,4323,4282,4282,4282,4282,4282,-41,-41,2,12.85,144
,20170420,4282,4282,4265,4272,4265,4272,4268,-10,-14,4,25.61,144
,20170421,4272,4268,4276,4276,4248,4248,4257,-20,-11,6,38.32,146
,20170424,4248,4257,4459,4459,4222,4222,4265,-35,8,14,89.57,148
,20170425,4222,4265,4212,4212,4212,4212,4212,-53,-53,2,12.64,150
,20170426,4212,4212,4213,4213,4213,4213,4213,1,1,4,25.28,146
,20170427,4213,4213,4182,4182,4182,4182,4182,-31,-31,2,12.55,146
,20170428,4182,4182,,,,4182,4182,0,0,0,0.00,146
,20170502,4182,4182,4133,4133,4112,4131,4123,-51,-59,10,61.86,150
,20170503,4131,4123,4131,4144,4110,4110,4122,-13,-1,64,395.75,154
,20170504,4110,4122,4102,4102,3982,4015,4044,-107,-78,78,473.21,176
,20170505,4015,4044,3984,4028,3974,4028,3987,-16,-57,38,227.29,174
,20170508,4028,3987,4005,4014,4005,4014,4011,27,24,12,72.21,174
,20170509,4014,4011,,,,4011,4011,0,0,0,0.00,174
,20170510,4011,4011,3982,3982,3972,3972,3974,-39,-37,28,166.94,186
,20170511,3972,3974,4006,4009,3987,3987,3998,13,24,12,71.98,188
,20170512,3987,3998,4028,4028,4028,4028,4028,30,30,2,12.08,186
,20170515,4028,4028,4020,4051,4020,4046,4035,18,7,120,726.40,222
,20170516,4046,4035,4070,4079,4066,4066,4072,31,37,18,109.94,224
,20170517,4066,4072,4078,4085,4061,4082,4072,10,0,34,207.71,214
,20170518,4082,4072,4087,4098,4054,4054,4084,-18,12,22,134.78,210
,20170519,4054,4084,4047,4047,4032,4032,4039,-52,-45,4,24.24,208
,20170522,4032,4039,4075,4075,4074,4074,4074,35,35,14,85.56,212
,20170523,4074,4074,4089,4109,4089,4097,4098,23,24,18,110.66,206
,20170524,4097,4098,4117,4117,4050,4050,4069,-48,-29,16,97.68,214
,20170525,4050,4069,4071,4098,4071,4090,4079,21,10,22,134.62,210
,20170526,4090,4079,4075,4089,4075,4089,4080,10,1,6,36.72,206
,20170531,4089,4080,4057,4062,4057,4062,4058,-18,-22,6,36.53,206
,20170601,4062,4058,4063,4063,4057,4057,4060,-1,2,8,48.72,208
,20170602,4057,4060,,,,4060,4060,0,0,0,0.00,208
,20170605,4060,4060,4088,4098,4088,4088,4091,28,31,6,36.82,206
,20170606,4088,4091,4100,4116,4100,4116,4105,25,14,20,123.17,202
,20170607,4116,4105,4128,4135,4128,4130,4130,25,25,34,210.67,218
,20170608,4130,4130,,,,4130,4130,0,0,0,0.00,218
,20170609,4130,4130,4117,4117,4071,4073,4079,-57,-51,36,220.29,208
,20170612,4073,4079,4052,4069,4031,4031,4047,-48,-32,28,169.98,214
,20170613,4031,4047,4012,4015,4004,4015,4010,-32,-37,60,360.94,214
,20170614,4015,4010,3998,4012,3998,4011,4007,1,-3,20,120.22,230
,20170615,4011,4007,4069,4075,4010,4010,4050,3,43,34,206.57,236
,20170616,4010,4050,3993,4008,3988,3988,3996,-62,-54,28,167.84,242
,20170619,3988,3996,3999,4012,3991,3991,4000,-5,4,6,36.01,248
,20170620,3991,4000,3983,3993,3982,3992,3986,-8,-14,10,59.80,252
,20170621,3992,3986,3972,3974,3962,3974,3970,-12,-16,8,47.65,256
,20170622,3974,3970,4017,4017,4008,4017,4014,47,44,6,36.13,256
,20170623,4017,4014,,,,4014,4014,0,0,0,0.00,256
,20170626,4014,4014,4028,4028,4017,4017,4022,3,8,4,24.14,256
,20170627,4017,4022,4017,4017,3982,3982,3990,-40,-32,10,59.86,262
,20170628,3982,3990,4006,4028,4006,4028,4019,38,29,14,84.41,258
,20170629,4028,4019,4051,4051,4017,4024,4032,5,13,50,302.45,260
,20170630,4024,4032,3982,3986,3982,3986,3984,-46,-48,6,35.86,264
,20170703,3986,3984,3972,3981,3971,3971,3975,-13,-9,14,83.48,264
,20170704,3971,3975,3932,3932,3809,3861,3891,-114,-84,102,595.39,270
,20170705,3861,3891,3887,3890,3877,3877,3884,-14,-7,14,81.58,276
,20170706,3877,3884,3844,3857,3841,3850,3848,-34,-36,22,126.98,286
,20170707,3850,3848,3855,3864,3822,3830,3837,-18,-11,24,138.15,292
,20170710,3830,3837,3831,3831,3645,3645,3727,-192,-110,86,480.83,322
,20170711,3645,3727,3654,3729,3644,3722,3677,-5,-50,44,242.69,312
,20170712,3722,3677,3732,3781,3717,3772,3752,95,75,40,225.16,302
,20170713,3772,3752,3798,3798,3777,3784,3786,32,34,24,136.30,308
,20170714,3784,3786,3781,3781,3728,3728,3755,-58,-31,18,101.39,312
,20170717,3728,3755,3742,3828,3742,3828,3806,73,51,48,274.07,320
,20170718,3828,3806,3838,3850,3831,3831,3839,25,33,74,426.20,318
,20170719,3831,3839,,,,3839,3839,0,0,0,0.00,318
,20170720,3839,3839,3813,3813,3813,3813,3813,-26,-26,28,160.15,306
,20170721,3813,3813,3818,3846,3818,3846,3836,33,23,6,34.53,308
,20170724,3846,3836,3864,3864,3858,3858,3861,22,25,6,34.76,302
,20170725,3858,3861,3849,3849,3849,3849,3849,-12,-12,2,11.55,300
,20170726,3849,3849,3868,3868,3830,3830,3840,-19,-9,18,103.69,302
,20170727,3830,3840,3858,3888,3858,3888,3874,48,34,6,34.87,302
,20170728,3888,3874,,,,3874,3874,0,0,0,0.00,302
,20170731,3874,3874,3882,3882,3882,3882,3882,8,8,4,23.29,302
,20170801,3882,3882,3892,3902,3884,3901,3893,19,11,56,327.02,290
,20170802,3901,3893,3896,3898,3881,3881,3891,-12,-2,6,35.03,290
,20170803,3881,3891,3854,3854,3853,3853,3853,-38,-38,8,46.24,286
,20170804,3853,3853,3868,3880,3860,3871,3865,18,12,76,440.66,278
,20170807,3871,3865,3834,3834,3781,3781,3795,-84,-70,44,250.47,286
,20170808,3781,3795,3783,3787,3783,3787,3785,-8,-10,32,181.68,280
,20170809,3787,3785,3824,3824,3824,3824,3824,39,39,4,22.94,276
,20170810,3824,3824,3876,3945,3862,3939,3928,115,104,174,"1,025.34",288
,20170811,3939,3928,3975,3975,3938,3938,3958,10,30,86,510.60,288
,20170814,3938,3958,3931,3974,3931,3960,3938,2,-20,46,271.76,266
,20170815,3960,3938,3957,3957,3946,3957,3954,19,16,8,47.45,260
,20170816,3957,3954,3891,3891,3869,3872,3880,-82,-74,124,721.82,310
,20170817,3872,3880,3978,3978,3963,3972,3971,92,91,70,417.04,300
,20170818,3972,3971,3958,3967,3956,3956,3960,-15,-11,22,130.69,294
,20170821,3956,3960,4000,4000,3922,3922,3968,-38,8,8,47.63,292
,20170822,3922,3968,3935,3942,3933,3933,3937,-35,-31,18,106.31,290
,20170823,3933,3937,3921,3937,3921,3929,3929,-8,-8,10,58.94,280
,20170824,3929,3929,3937,3937,3932,3932,3935,3,6,14,82.64,278
,20170825,3932,3935,3925,3930,3923,3923,3927,-12,-8,32,188.51,278
,20170828,3923,3927,3947,3964,3933,3948,3951,21,24,656,"3,888.24",258
,20170829,3948,3951,3983,3988,3975,3986,3985,35,34,52,310.83,252
,20170830,3986,3985,4005,4005,3956,3956,3975,-29,-10,90,536.63,228
,20170831,3956,3975,3960,3969,3943,3945,3946,-30,-29,152,899.80,298
,20170901,3945,3946,3964,3976,3959,3959,3966,13,20,78,464.04,328
,20170904,3959,3966,3968,4018,3968,4018,4002,52,36,100,600.41,298
,20170905,4018,4002,4005,4019,4000,4019,4005,17,3,34,204.27,300
,20170906,4019,4005,3999,3999,3999,3999,3999,-6,-6,4,23.99,300
,20170907,3999,3999,4005,4005,3997,3997,3998,-2,-1,12,71.97,304
,20170908,3997,3998,4001,4018,4001,4017,4007,19,9,78,468.83,252
,20170911,4017,4007,4000,4000,3955,3955,3977,-52,-30,18,107.40,242
,20170912,3955,3977,3955,3966,3955,3966,3960,-11,-17,4,23.76,240
,20170913,3966,3960,3948,3948,3948,3948,3948,-12,-12,2,11.84,240
,20170914,3948,3948,3942,3945,3933,3939,3940,-9,-8,20,118.22,240
,20170915,3939,3940,3942,3956,3941,3943,3948,3,8,66,390.85,240
,20170918,3943,3948,3931,3941,3922,3927,3933,-21,-15,34,200.60,236
,20170919,3927,3933,3909,3909,3871,3884,3881,-49,-52,24,139.74,234
,20170920,3884,3881,3888,3888,3881,3885,3884,4,3,14,81.58,226
,20170921,3885,3884,3879,3879,3879,3879,3879,-5,-5,8,46.55,220
,20170922,3879,3879,3828,3830,3821,3821,3829,-58,-50,154,884.67,356
,20170925,3821,3829,3818,3829,3792,3823,3815,-6,-14,48,274.73,338
,20170926,3823,3815,3823,3892,3805,3875,3874,60,59,1438,"8,357.54",1714
,20170927,3875,3874,3835,3846,3828,3846,3837,-28,-37,22,126.64,1714
,20170928,3846,3837,3877,3877,3814,3814,3828,-23,-9,14,80.40,1704
,20170929,3814,3828,3797,3832,3770,3830,3824,2,-4,64,367.18,1704
,20171009,3830,3824,3850,3870,3850,3870,3869,46,45,208,"1,207.32",1700
,20171010,3870,3869,3859,3860,3830,3830,3843,-39,-26,36,207.52,1712
,20171011,3830,3843,3850,3850,3850,3850,3850,7,7,12,69.30,1700
,20171012,3850,3850,,,,3860,3860,10,10,0,0.00,1700
,20171013,3860,3860,3880,3890,3880,3890,3886,30,26,12,69.96,1692
,20171016,3890,3886,3900,3900,3900,3900,3900,14,14,12,70.20,1684
ag1711,20170103,4186,4186,,,,4186,4186,0,0,0,0.00,56
,20170104,4186,4186,,,,4186,4186,0,0,0,0.00,56
,20170105,4186,4186,,,,4190,4190,4,4,0,0.00,56
,20170106,4190,4190,,,,4190,4190,0,0,0,0.00,56
,20170109,4190,4190,,,,4190,4190,0,0,0,0.00,56
,20170110,4190,4190,,,,4190,4190,0,0,0,0.00,56
,20170111,4190,4190,,,,4201,4201,11,11,0,0.00,56
,20170112,4201,4201,4239,4239,4237,4239,4238,38,37,6,38.15,52
,20170113,4239,4238,4239,4239,4207,4207,4208,-31,-30,112,706.96,162
,20170116,4207,4208,,,,4208,4208,0,0,0,0.00,162
,20170117,4208,4208,4245,4245,4245,4245,4245,37,37,2,12.74,160
,20170118,4245,4245,,,,4245,4245,0,0,0,0.00,160
,20170119,4245,4245,4221,4221,4221,4221,4221,-24,-24,2,12.66,160
,20170120,4221,4221,,,,4221,4221,0,0,0,0.00,160
,20170123,4221,4221,,,,4221,4221,0,0,0,0.00,160
,20170124,4221,4221,,,,4221,4221,0,0,0,0.00,160
,20170125,4221,4221,,,,4221,4221,0,0,0,0.00,160
,20170126,4221,4221,4129,4129,4111,4111,4123,-110,-98,6,37.11,158
,20170203,4111,4123,,,,4160,4160,37,37,0,0.00,158
,20170206,4160,4160,,,,4195,4195,35,35,0,0.00,158
,20170207,4195,4195,,,,4195,4195,0,0,0,0.00,158
,20170208,4195,4195,,,,4195,4195,0,0,0,0.00,158
,20170209,4195,4195,,,,4195,4195,0,0,0,0.00,158
,20170210,4195,4195,,,,4195,4195,0,0,0,0.00,158
,20170213,4195,4195,4249,4320,4239,4315,4273,120,78,84,538.50,152
,20170214,4315,4273,4300,4300,4300,4300,4300,27,27,2,12.90,152
,20170215,4300,4300,4322,4322,4294,4294,4308,-6,8,4,25.85,150
,20170216,4294,4308,4290,4341,4290,4340,4318,32,10,8,51.83,152
,20170217,4340,4318,,,,4318,4318,0,0,0,0.00,152
,20170220,4318,4318,4298,4298,4292,4292,4295,-26,-23,8,51.54,158
,20170221,4292,4295,,,,4295,4295,0,0,0,0.00,158
,20170222,4295,4295,,,,4295,4295,0,0,0,0.00,158
,20170223,4295,4295,,,,4295,4295,0,0,0,0.00,158
,20170224,4295,4295,,,,4295,4295,0,0,0,0.00,158
,20170227,4295,4295,4380,4404,4380,4404,4392,109,97,4,26.35,154
,20170228,4404,4392,,,,4392,4392,0,0,0,0.00,154
,20170301,4392,4392,,,,4392,4392,0,0,0,0.00,154
,20170302,4392,4392,,,,4392,4392,0,0,0,0.00,154
,20170303,4392,4392,4364,4367,4264,4264,4351,-128,-41,14,91.37,150
,20170306,4264,4351,,,,4332,4332,-19,-19,0,0.00,150
,20170307,4332,4332,4269,4269,4248,4256,4260,-76,-72,32,204.50,144
,20170308,4256,4260,4194,4194,4194,4194,4194,-66,-66,2,12.58,146
,20170309,4194,4194,4188,4196,4187,4190,4189,-4,-5,22,138.26,148
,20170310,4190,4189,4190,4190,4116,4154,4156,-35,-33,62,386.53,174
,20170313,4154,4156,4130,4173,4130,4158,4149,2,-7,28,174.29,190
,20170314,4158,4149,4148,4148,4140,4140,4146,-9,-3,8,49.75,192
,20170315,4140,4146,,,,4146,4146,0,0,0,0.00,192
,20170316,4146,4146,4274,4274,4221,4221,4243,75,97,12,76.37,188
,20170317,4221,4243,,,,4243,4243,0,0,0,0.00,188
,20170320,4243,4243,,,,4243,4243,0,0,0,0.00,188
,20170321,4243,4243,4233,4233,4233,4233,4233,-10,-10,2,12.70,186
,20170322,4233,4233,,,,4233,4233,0,0,0,0.00,186
,20170323,4233,4233,4257,4257,4257,4257,4257,24,24,4,25.54,186
,20170324,4257,4257,,,,4257,4257,0,0,0,0.00,186
,20170327,4257,4257,4278,4286,4278,4286,4282,29,25,4,25.69,186
,20170328,4286,4282,4301,4301,4301,4301,4301,19,19,2,12.90,184
,20170329,4301,4301,,,,4301,4301,0,0,0,0.00,184
,20170330,4301,4301,,,,4301,4301,0,0,0,0.00,184
,20170331,4301,4301,4282,4294,4282,4294,4292,-7,-9,12,77.26,192
,20170405,4294,4292,4297,4297,4297,4297,4297,5,5,2,12.89,192
,20170406,4297,4297,4296,4300,4296,4300,4298,3,1,4,25.79,194
,20170407,4300,4298,4311,4388,4311,4357,4355,59,57,18,117.60,198
,20170410,4357,4355,4201,4261,4198,4253,4208,-102,-147,64,404.00,230
,20170411,4253,4208,4241,4255,4226,4254,4242,46,34,38,241.84,236
,20170412,4254,4242,4330,4335,4330,4335,4332,93,90,4,26.00,236
,20170413,4335,4332,,,,4332,4332,0,0,0,0.00,236
,20170414,4332,4332,4345,4345,4345,4345,4345,13,13,2,13.04,236
,20170417,4345,4345,,,,4345,4345,0,0,0,0.00,236
,20170418,4345,4345,4361,4361,4361,4361,4361,16,16,2,13.08,236
,20170419,4361,4361,4293,4298,4293,4298,4296,-63,-65,8,51.56,232
,20170420,4298,4296,4278,4298,4278,4286,4287,-10,-9,20,128.62,228
,20170421,4286,4287,4290,4290,4268,4268,4282,-19,-5,12,77.09,228
,20170424,4268,4282,4267,4267,4267,4267,4267,-15,-15,2,12.80,226
,20170425,4267,4267,4228,4256,4228,4256,4235,-11,-32,24,152.48,204
,20170426,4256,4235,,,,4235,4235,0,0,0,0.00,204
,20170427,4235,4235,,,,4235,4235,0,0,0,0.00,204
,20170428,4235,4235,,,,4235,4235,0,0,0,0.00,204
,20170502,4235,4235,4130,4145,4129,4136,4134,-99,-101,10,62.01,208
,20170503,4136,4134,4123,4123,4123,4123,4123,-11,-11,2,12.37,208
,20170504,4123,4123,4110,4110,4084,4087,4098,-36,-25,10,61.48,212
,20170505,4087,4098,3974,3997,3974,3997,3987,-101,-111,18,107.66,212
,20170508,3997,3987,4006,4040,4006,4032,4026,45,39,6,36.23,212
,20170509,4032,4026,,,,4026,4026,0,0,0,0.00,212
,20170510,4026,4026,3995,3995,3978,3986,3987,-40,-39,18,107.65,210
,20170511,3986,3987,4011,4023,3990,4022,4010,35,23,32,192.52,202
,20170512,4022,4010,4017,4017,4017,4017,4017,7,7,2,12.05,200
,20170515,4017,4017,4054,4076,4035,4076,4053,59,36,14,85.12,198
,20170516,4076,4053,4101,4101,4085,4096,4092,43,39,20,122.78,186
,20170517,4096,4092,4088,4105,4078,4105,4091,13,-1,8,49.10,188
,20170518,4105,4091,4105,4121,4096,4096,4113,5,22,76,468.89,186
,20170519,4096,4113,4083,4094,4062,4074,4087,-39,-26,124,760.34,216
,20170522,4074,4087,4084,4084,4084,4084,4084,-3,-3,4,24.50,216
,20170523,4084,4084,4119,4130,4119,4122,4124,38,40,26,160.84,200
,20170524,4122,4124,4134,4134,4112,4112,4121,-12,-3,24,148.37,190
,20170525,4112,4121,4093,4104,4093,4104,4102,-17,-19,48,295.39,186
,20170526,4104,4102,4116,4116,4116,4116,4116,14,14,2,12.35,188
,20170531,4116,4116,4101,4102,4094,4094,4100,-22,-16,10,61.50,184
,20170601,4094,4100,4079,4094,4079,4085,4081,-15,-19,170,"1,040.66",198
,20170602,4085,4081,4056,4059,4056,4059,4057,-22,-24,10,60.86,190
,20170605,4059,4057,4112,4125,4112,4125,4118,68,61,4,24.71,190
,20170606,4125,4118,4131,4147,4131,4147,4139,29,21,4,24.83,190
,20170607,4147,4139,,,,4139,4139,0,0,0,0.00,190
,20170608,4139,4139,4128,4128,4128,4128,4128,-11,-11,2,12.38,190
,20170609,4128,4128,4086,4086,4086,4086,4086,-42,-42,2,12.26,188
,20170612,4086,4086,4100,4100,4050,4050,4088,-36,2,38,233.02,178
,20170613,4050,4088,,,,4088,4088,0,0,0,0.00,178
,20170614,4088,4088,4049,4049,4039,4049,4046,-39,-42,8,48.55,182
,20170615,4049,4046,4092,4092,4030,4030,4075,-16,29,14,85.58,178
,20170616,4030,4075,,,,4075,4075,0,0,0,0.00,178
,20170619,4075,4075,4019,4019,4019,4019,4019,-56,-56,12,72.34,186
,20170620,4019,4019,,,,4019,4019,0,0,0,0.00,186
,20170621,4019,4019,3986,3986,3986,3986,3986,-33,-33,20,119.58,182
,20170622,3986,3986,3986,4038,3986,4038,4028,52,42,24,145.01,168
,20170623,4038,4028,4027,4027,4027,4027,4027,-1,-1,2,12.08,168
,20170626,4027,4027,4045,4045,4038,4038,4041,11,14,16,97.00,168
,20170627,4038,4041,,,,4041,4041,0,0,0,0.00,168
,20170628,4041,4041,4023,4023,4023,4023,4023,-18,-18,2,12.07,168
,20170629,4023,4023,,,,4023,4023,0,0,0,0.00,168
,20170630,4023,4023,,,,4023,4023,0,0,0,0.00,168
,20170703,4023,4023,4003,4003,3983,3983,3994,-40,-29,8,47.93,168
,20170704,3983,3994,3910,3910,3868,3889,3889,-105,-105,8,46.67,168
,20170705,3889,3889,3871,3871,3871,3871,3871,-18,-18,2,11.61,166
,20170706,3871,3871,3871,3871,3857,3871,3864,0,-7,8,46.37,162
,20170707,3871,3864,3873,3873,3873,3873,3873,9,9,8,46.48,162
,20170710,3873,3873,3737,3737,3682,3682,3702,-191,-171,24,133.30,174
,20170711,3682,3702,3677,3745,3665,3709,3720,7,18,42,234.38,170
,20170712,3709,3720,3742,3802,3739,3797,3782,77,62,36,204.27,168
,20170713,3797,3782,3807,3807,3807,3807,3807,25,25,2,11.42,166
,20170714,3807,3807,3775,3775,3743,3743,3753,-64,-54,22,123.87,166
,20170717,3743,3753,3807,3836,3803,3836,3817,83,64,12,68.71,164
,20170718,3836,3817,,,,3817,3817,0,0,0,0.00,164
,20170719,3817,3817,,,,3817,3817,0,0,0,0.00,164
,20170720,3817,3817,,,,3817,3817,0,0,0,0.00,164
,20170721,3817,3817,3841,3841,3841,3841,3841,24,24,2,11.52,164
,20170724,3841,3841,,,,3841,3841,0,0,0,0.00,164
,20170725,3841,3841,3872,3874,3869,3873,3872,32,31,16,92.94,162
,20170726,3873,3872,3885,3885,3846,3846,3865,-26,-7,4,23.19,160
,20170727,3846,3865,3933,3933,3851,3909,3896,44,31,26,151.97,162
,20170728,3909,3896,3888,3895,3887,3890,3890,-6,-6,26,151.73,166
,20170731,3890,3890,3908,3908,3900,3900,3904,10,14,4,23.42,166
,20170801,3900,3904,3907,3922,3900,3922,3909,18,5,6,35.19,164
,20170802,3922,3909,3901,3901,3891,3891,3896,-18,-13,4,23.38,164
,20170803,3891,3896,3881,3885,3881,3885,3883,-11,-13,4,23.30,164
,20170804,3885,3883,,,,3883,3883,0,0,0,0.00,164
,20170807,3883,3883,,,,3883,3883,0,0,0,0.00,164
,20170808,3883,3883,3805,3818,3795,3818,3807,-65,-76,16,91.37,168
,20170809,3818,3807,3805,3846,3805,3846,3832,39,25,14,80.47,168
,20170810,3846,3832,3904,3949,3894,3949,3910,117,78,32,187.69,164
,20170811,3949,3910,4020,4020,3970,3970,3989,60,79,28,167.55,162
,20170814,3970,3989,4016,4016,4003,4004,4009,15,20,8,48.11,162
,20170815,4004,4009,3994,3994,3978,3978,3986,-31,-23,4,23.92,162
,20170816,3978,3986,3891,3891,3891,3891,3891,-95,-95,6,35.02,162
,20170817,3891,3891,3991,4001,3989,3989,3992,98,101,14,83.84,160
,20170818,3989,3992,,,,3992,3992,0,0,0,0.00,160
,20170821,3992,3992,3994,3994,3994,3994,3994,2,2,2,11.98,160
,20170822,3994,3994,,,,3994,3994,0,0,0,0.00,160
,20170823,3994,3994,3972,3972,3972,3972,3972,-22,-22,2,11.92,160
,20170824,3972,3972,3960,3960,3960,3960,3960,-12,-12,4,23.76,160
,20170825,3960,3960,3950,3950,3946,3946,3947,-14,-13,6,35.53,162
,20170828,3946,3947,3970,3970,3908,3964,3956,17,9,14,83.08,158
,20170829,3964,3956,3990,4010,3990,4004,4000,48,44,22,132.00,164
,20170830,4004,4000,4011,4011,3990,3990,4000,-10,0,12,72.01,166
,20170831,3990,4000,3984,3992,3966,3970,3969,-30,-31,62,369.18,180
,20170901,3970,3969,3982,3986,3982,3986,3984,17,15,6,35.86,180
,20170904,3986,3984,3992,4049,3945,4049,4007,65,23,160,961.71,182
,20170905,4049,4007,,,,4007,4007,0,0,0,0.00,182
,20170906,4007,4007,4026,4035,4026,4035,4027,28,20,46,277.87,212
,20170907,4035,4027,4026,4026,4017,4017,4022,-10,-5,10,60.34,206
,20170908,4017,4022,4020,4020,4020,4020,4020,-2,-2,2,12.06,206
,20170911,4020,4020,3980,3987,3964,3974,3978,-46,-42,84,501.27,216
,20170912,3974,3978,3977,3977,3966,3967,3970,-11,-8,14,83.37,216
,20170913,3967,3970,3973,3973,3973,3973,3973,3,3,2,11.92,216
,20170914,3973,3973,3948,3948,3948,3948,3948,-25,-25,20,118.44,236
,20170915,3948,3948,3962,3972,3962,3967,3967,19,19,10,59.51,238
,20170918,3967,3967,3956,3956,3951,3953,3953,-14,-14,6,35.58,236
,20170919,3953,3953,3927,3927,3891,3891,3919,-62,-34,46,270.44,224
,20170920,3891,3919,3899,3908,3899,3902,3901,-17,-18,24,140.45,240
,20170921,3902,3901,3898,3898,3898,3898,3898,-3,-3,12,70.16,232
,20170922,3898,3898,3840,3848,3840,3848,3841,-50,-57,10,57.62,232
,20170925,3848,3841,,,,3841,3841,0,0,0,0.00,232
,20170926,3841,3841,3842,3900,3831,3888,3878,47,37,66,383.94,232
,20170927,3888,3878,3875,3875,3863,3863,3869,-15,-9,4,23.21,232
,20170928,3863,3869,3854,3854,3831,3837,3842,-32,-27,10,57.63,230
,20170929,3837,3842,,,,3842,3842,0,0,0,0.00,230
,20171009,3842,3842,3850,3896,3850,3889,3873,47,31,40,232.41,230
,20171010,3889,3873,,,,3873,3873,0,0,0,0.00,230
,20171011,3873,3873,3880,3880,3862,3862,3876,-11,3,24,139.54,208
,20171012,3862,3876,,,,3876,3876,0,0,0,0.00,208
,20171013,3876,3876,3879,3887,3874,3887,3882,11,6,28,163.05,200
,20171016,3887,3882,3893,3914,3893,3914,3900,32,18,1172,"6,856.61",1298
,20171017,3914,3900,3916,3916,3874,3874,3891,-26,-9,56,326.90,1278
,20171018,3874,3891,3879,3888,3878,3881,3882,-10,-9,80,465.84,1262
,20171019,3881,3882,3864,3873,3860,3860,3863,-22,-19,10,57.95,1258
,20171020,3860,3863,3890,3890,3885,3885,3889,22,26,270,"1,575.41",1518
,20171023,3885,3889,3876,3884,3851,3851,3872,-38,-17,82,476.36,1540
,20171024,3851,3872,3867,3867,3867,3867,3867,-5,-5,2,11.60,1540
,20171025,3867,3867,3847,3847,3847,3847,3847,-20,-20,2,11.54,1540
,20171026,3847,3847,3869,3869,3855,3863,3864,16,17,838,"4,858.16",2322
,20171027,3863,3864,3848,3848,3826,3826,3829,-38,-35,16,91.90,2322
,20171030,3826,3829,3800,3821,3800,3815,3816,-14,-13,58,332.05,2300
,20171031,3815,3816,3813,3820,3813,3816,3816,0,0,8,45.80,2296
,20171101,3816,3816,3814,3836,3814,3836,3815,20,-1,440,"2,518.40",2732
,20171102,3836,3815,3837,3844,3837,3844,3839,29,24,16,92.14,2728
,20171103,3844,3839,3870,3870,3870,3870,3870,31,31,4,23.22,2728
,20171106,3870,3870,3855,3855,3831,3831,3843,-39,-27,8,46.12,2732
,20171107,3831,3843,3921,3921,3921,3921,3921,78,78,4,23.53,2736
,20171108,3921,3921,3852,3852,3852,3852,3852,-69,-69,8,46.22,2728
,20171109,3852,3852,3870,3906,3870,3906,3895,54,43,20,116.86,2724
,20171110,3906,3895,3867,3867,3862,3863,3862,-32,-33,560,"3,244.57",3284
,20171113,3863,3862,3836,3836,3836,3836,3836,-26,-26,4,23.02,3284
,20171114,3836,3836,3836,3836,3836,3836,3836,0,0,4,23.02,3280
,20171115,3836,3836,4026,4026,3852,3852,3945,16,109,196,"1,159.98",3376
ag1712,20170103,4242,4214,4230,4231,4200,4204,4215,-10,1,694,"4,388.74",3412
,20170104,4204,4215,4203,4272,4192,4248,4240,33,25,1964,"12,492.34",3730
,20170105,4248,4240,4248,4271,4228,4260,4252,20,12,2594,"16,546.22",4586
,20170106,4260,4252,4260,4266,4190,4195,4235,-57,-17,2254,"14,320.33",5072
,20170109,4195,4235,4212,4237,4204,4230,4220,-5,-15,2096,"13,270.00",5428
,20170110,4230,4220,4231,4255,4228,4241,4241,21,21,1706,"10,853.97",5666
,20170111,4241,4241,4239,4288,4231,4272,4270,31,29,3342,"21,406.78",6650
,20170112,4272,4270,4265,4265,4221,4262,4241,-8,-29,4872,"30,995.21",6626
,20170113,4262,4241,4262,4266,4210,4223,4231,-18,-10,2652,"16,834.32",7464
,20170116,4223,4231,4223,4327,4193,4253,4228,22,-3,2768,"17,558.54",7602
,20170117,4253,4228,4248,4267,4227,4240,4241,12,13,3176,"20,207.74",7960
,20170118,4240,4241,4251,4284,4236,4250,4253,9,12,2796,"17,840.27",8150
,20170119,4250,4253,4242,4266,4204,4215,4229,-38,-24,3192,"20,251.94",8820
,20170120,4215,4229,4219,4226,4200,4208,4214,-21,-15,2102,"13,287.59",8486
,20170123,4208,4214,4207,4242,4200,4230,4223,16,9,1614,"10,224.06",8594
,20170124,4230,4223,4230,4239,4217,4223,4229,0,6,2142,"13,590.42",8732
,20170125,4223,4229,4220,4231,4160,4173,4191,-56,-38,4036,"25,374.51",8634
,20170126,4173,4191,4173,4176,4119,4119,4140,-72,-51,3158,"19,612.37",8598
,20170203,4119,4140,4210,4220,4193,4195,4203,55,63,2560,"16,142.92",8954
,20170206,4195,4203,4196,4254,4186,4250,4229,47,26,4596,"29,158.80",9904
,20170207,4250,4229,4255,4275,4246,4268,4256,39,27,5394,"34,442.85",11158
,20170208,4268,4256,4268,4290,4253,4268,4269,12,13,4298,"27,526.94",11798
,20170209,4268,4269,4287,4312,4268,4274,4286,5,17,4172,"26,824.86",11938
,20170210,4274,4286,4276,4295,4248,4259,4265,-27,-21,4764,"30,479.07",12774
,20170213,4259,4265,4259,4354,4258,4337,4320,72,55,8560,"55,478.01",14304
,20170214,4337,4320,4336,4345,4311,4344,4329,24,9,5430,"35,265.77",15270
,20170215,4344,4329,4361,4366,4310,4322,4336,-7,7,10124,"65,860.30",15334
,20170216,4322,4336,4323,4355,4297,4331,4331,-5,-5,8136,"52,864.12",15778
,20170217,4331,4331,4341,4354,4324,4332,4338,1,7,5206,"33,882.17",15846
,20170220,4332,4338,4327,4339,4305,4313,4319,-25,-19,5284,"34,233.27",17598
,20170221,4313,4319,4321,4352,4319,4339,4333,20,14,7368,"47,894.06",18488
,20170222,4339,4333,4328,4344,4316,4333,4330,0,-3,5718,"37,143.68",19676
,20170223,4333,4330,4333,4360,4320,4325,4335,-5,5,5506,"35,805.86",19620
,20170224,4325,4335,4343,4385,4339,4377,4361,42,26,13670,"89,436.66",22304
,20170227,4377,4361,4423,4434,4386,4426,4415,65,54,8514,"56,385.56",23176
,20170228,4426,4415,4428,4438,4403,4412,4416,-3,1,4700,"31,135.19",23888
,20170301,4412,4416,4411,4428,4381,4387,4398,-29,-18,7738,"51,058.74",24414
,20170302,4387,4398,4391,4412,4384,4403,4397,5,-1,5260,"34,697.74",25158
,20170303,4403,4397,4397,4397,4246,4269,4305,-128,-92,19496,"125,906.98",28102
,20170306,4269,4305,4267,4308,4260,4278,4282,-27,-23,14362,"92,266.23",32140
,20170307,4278,4282,4286,4293,4267,4276,4281,-6,-1,8958,"57,534.63",34462
,20170308,4276,4281,4269,4269,4232,4233,4245,-48,-36,16228,"103,336.38",35748
,20170309,4233,4245,4216,4227,4171,4184,4201,-61,-44,18958,"119,470.50",39254
,20170310,4184,4201,4192,4209,4136,4143,4166,-58,-35,17966,"112,287.17",43392
,20170313,4143,4166,4150,4190,4135,4185,4171,19,5,17776,"111,235.63",46590
,20170314,4185,4171,4170,4185,4153,4158,4169,-13,-2,16650,"104,135.65",52920
,20170315,4158,4169,4161,4172,4147,4163,4160,-6,-9,13226,"82,531.50",54800
,20170316,4163,4160,4157,4281,4152,4267,4228,107,68,26664,"169,141.65",56242
,20170317,4267,4228,4267,4272,4239,4256,4254,28,26,11266,"71,895.71",57506
,20170320,4256,4254,4261,4276,4254,4271,4268,17,14,12554,"80,379.80",59308
,20170321,4271,4268,4270,4273,4250,4259,4259,-9,-9,13184,"84,244.15",61320
,20170322,4259,4259,4262,4300,4262,4290,4285,31,26,14298,"91,904.51",62414
,20170323,4290,4285,4284,4287,4272,4285,4280,0,-5,9446,"60,649.07",63062
,20170324,4285,4280,4300,4305,4261,4267,4279,-13,-1,15902,"102,078.64",62838
,20170327,4267,4279,4280,4320,4273,4318,4298,39,19,19744,"127,308.50",64246
,20170328,4318,4298,4328,4339,4313,4322,4324,24,26,19352,"125,544.94",64156
,20170329,4322,4324,4335,4340,4308,4317,4323,-7,-1,16924,"109,746.09",66802
,20170330,4317,4323,4322,4325,4304,4319,4316,-4,-7,13766,"89,127.19",68444
,20170331,4319,4316,4315,4330,4294,4306,4308,-10,-8,17922,"115,821.33",69142
,20170405,4306,4308,4340,4340,4315,4324,4324,16,16,12654,"82,077.05",70350
,20170406,4324,4324,4326,4331,4311,4326,4323,2,-1,16152,"104,741.38",73762
,20170407,4326,4323,4319,4393,4307,4370,4358,47,35,65390,"427,525.46",86636
,20170410,4370,4358,4375,4389,4188,4269,4301,-89,-57,43534,"280,889.00",87768
,20170411,4269,4301,4269,4278,4242,4273,4265,-28,-36,29474,"188,579.76",91126
,20170412,4273,4265,4279,4365,4279,4338,4322,73,57,50782,"329,238.77",96996
,20170413,4338,4322,4342,4381,4325,4373,4357,51,35,30062,"196,509.48",100678
,20170414,4373,4357,4381,4390,4352,4388,4368,31,11,24958,"163,544.33",102946
,20170417,4388,4368,4382,4437,4369,4387,4401,19,33,43192,"285,182.02",108920
,20170418,4387,4401,4375,4387,4345,4348,4365,-53,-36,38454,"251,809.22",113994
,20170419,4348,4365,4350,4357,4296,4312,4324,-53,-41,63418,"411,335.54",119558
,20170420,4312,4324,4321,4328,4294,4314,4311,-10,-13,33602,"217,308.23",120154
,20170421,4314,4311,4308,4311,4266,4273,4288,-38,-23,48424,"311,499.86",122434
,20170424,4273,4288,4265,4283,4242,4249,4261,-39,-27,77474,"495,291.00",146248
,20170425,4249,4261,4248,4274,4237,4259,4259,-2,-2,53934,"344,574.31",154808
,20170426,4259,4259,4241,4252,4228,4233,4241,-26,-18,66640,"424,002.24",159462
,20170427,4233,4241,4230,4236,4212,4224,4225,-17,-16,55116,"349,373.98",165836
,20170428,4224,4225,4227,4235,4213,4224,4222,-1,-3,71858,"455,083.86",183346
,20170502,4224,4222,4160,4168,4120,4153,4151,-69,-71,113288,"705,481.57",207356
,20170503,4153,4151,4137,4157,4137,4148,4148,-3,-3,92900,"578,076.17",236772
,20170504,4148,4148,4137,4148,3990,4047,4082,-101,-66,288458,"1,766,264.88",272236
,20170505,4047,4082,4004,4063,3992,4037,4019,-45,-63,200984,"1,211,704.10",296850
,20170508,4037,4019,4034,4056,4021,4045,4039,26,20,153738,"931,450.16",317068
,20170509,4045,4039,4041,4042,4005,4025,4028,-14,-11,153882,"929,766.15",342970
,20170510,4025,4028,4008,4012,3982,4002,4001,-26,-27,198064,"1,188,789.88",376096
,20170511,4002,4001,4014,4039,4007,4030,4023,29,22,269422,"1,625,946.86",404264
,20170512,4030,4023,4027,4066,4018,4053,4041,30,18,295202,"1,789,455.84",424938
,20170515,4053,4041,4055,4096,4045,4085,4066,44,25,301552,"1,839,226.27",440122
,20170516,4085,4066,4118,4129,4089,4110,4107,44,41,313340,"1,930,580.27",448432
,20170517,4110,4107,4112,4127,4091,4116,4111,9,4,303816,"1,873,571.70",457918
,20170518,4116,4111,4128,4141,4093,4104,4123,-7,12,395786,"2,447,887.43",466000
,20170519,4104,4123,4098,4111,4058,4096,4089,-27,-34,417590,"2,561,373.01",461030
,20170522,4096,4089,4110,4125,4086,4110,4105,21,16,342078,"2,106,553.89",465720
,20170523,4110,4105,4128,4150,4119,4134,4135,29,30,370502,"2,298,421.84",458760
,20170524,4134,4135,4142,4154,4083,4097,4122,-38,-13,415476,"2,569,005.16",461262
,20170525,4097,4122,4107,4141,4096,4125,4118,3,-4,336014,"2,075,695.64",451894
,20170526,4125,4118,4120,4128,4104,4125,4114,7,-4,205222,"1,266,729.35",439194
,20170531,4125,4114,4121,4134,4095,4103,4108,-11,-6,197482,"1,217,043.56",438024
,20170601,4103,4108,4111,4114,4073,4094,4094,-14,-14,370088,"2,273,203.77",454986
,20170602,4094,4094,4070,4087,4052,4067,4068,-27,-26,339768,"2,073,373.33",462558
,20170605,4067,4068,4085,4145,4084,4134,4116,66,48,536224,"3,311,014.49",468314
,20170606,4134,4116,4139,4172,4132,4164,4150,48,34,384634,"2,394,374.44",493824
,20170607,4164,4150,4171,4183,4157,4169,4169,19,19,284888,"1,781,815.33",486582
,20170608,4169,4169,4160,4171,4142,4163,4158,-6,-11,288932,"1,802,374.77",478652
,20170609,4163,4158,4158,4164,4091,4100,4123,-58,-35,480272,"2,970,796.61",468856
,20170612,4100,4123,4089,4094,4060,4062,4077,-61,-46,340710,"2,083,772.05",487224
,20170613,4062,4077,4049,4067,4031,4038,4045,-39,-32,357490,"2,169,472.22",512386
,20170614,4038,4045,4035,4064,4024,4055,4043,10,-2,346212,"2,099,771.98",521364
,20170615,4055,4043,4087,4125,4038,4041,4088,-2,45,641906,"3,936,750.38",513316
,20170616,4041,4088,4015,4048,4011,4038,4031,-50,-57,352178,"2,129,479.48",531084
,20170619,4038,4031,4036,4039,4016,4018,4025,-13,-6,297096,"1,794,104.95",566244
,20170620,4018,4025,4015,4030,4004,4023,4017,-2,-8,306358,"1,846,344.35",588042
,20170621,4023,4017,4010,4013,3986,4008,4002,-9,-15,311894,"1,872,366.44",598778
,20170622,4008,4002,3993,4055,3991,4043,4026,41,24,418214,"2,526,151.80",597128
,20170623,4043,4026,4049,4054,4032,4054,4042,28,16,280108,"1,698,582.55",598734
,20170626,4054,4042,4062,4064,4041,4049,4052,7,10,224968,"1,367,358.22",588128
,20170627,4049,4052,4026,4034,4010,4033,4021,-19,-31,306136,"1,846,917.59",598736
,20170628,4033,4021,4028,4069,4023,4055,4045,34,24,415480,"2,521,534.61",604754
,20170629,4055,4045,4058,4064,4047,4058,4054,13,9,270540,"1,645,450.74",603672
,20170630,4058,4054,4022,4032,4006,4013,4018,-41,-36,433374,"2,612,576.44",636078
,20170703,4013,4018,4006,4023,3995,4006,4009,-12,-9,330682,"1,988,613.58",655176
,20170704,4006,4009,3966,3967,3880,3898,3921,-111,-88,773716,"4,551,642.58",732314
,20170705,3898,3921,3882,3921,3871,3901,3897,-20,-24,346194,"2,024,088.54",726318
,20170706,3901,3897,3863,3899,3858,3885,3879,-12,-18,360546,"2,097,979.35",743088
,20170707,3885,3879,3885,3896,3839,3864,3865,-15,-14,490434,"2,843,565.59",781948
,20170710,3864,3865,3851,3858,3671,3671,3755,-194,-110,1280330,"7,213,250.83",814850
,20170711,3671,3755,3675,3766,3666,3732,3723,-23,-32,1138236,"6,356,924.87",746782
,20170712,3732,3723,3750,3828,3737,3788,3784,65,61,831476,"4,719,605.00",711912
,20170713,3788,3784,3831,3839,3807,3819,3820,35,36,522812,"2,996,107.85",693938
,20170714,3819,3820,3813,3816,3748,3769,3777,-51,-43,616266,"3,492,245.44",704370
,20170717,3769,3777,3840,3867,3820,3844,3840,67,63,551538,"3,177,440.36",669956
,20170718,3844,3840,3868,3878,3839,3849,3863,9,23,405784,"2,351,875.88",665568
,20170719,3849,3863,3865,3870,3845,3859,3858,-4,-5,365010,"2,112,703.33",651812
,20170720,3859,3858,3871,3873,3834,3853,3855,-5,-3,387868,"2,243,366.67",648652
,20170721,3853,3855,3860,3895,3846,3882,3876,27,21,524202,"3,048,103.65",650020
,20170724,3882,3876,3900,3909,3872,3880,3889,4,13,365130,"2,130,166.34",642570
,20170725,3880,3889,3899,3899,3873,3888,3885,-1,-4,288530,"1,681,595.50",631786
,20170726,3888,3885,3881,3907,3845,3857,3875,-28,-10,558632,"3,247,380.07",648476
,20170727,3857,3875,3861,3930,3859,3912,3896,37,21,499044,"2,916,759.24",626230
,20170728,3912,3896,3924,3929,3895,3904,3908,8,12,391850,"2,297,364.06",607278
,20170731,3904,3908,3916,3926,3905,3916,3916,8,8,326188,"1,916,132.17",606620
,20170801,3916,3916,3930,3939,3917,3922,3927,6,11,351678,"2,071,855.01",602186
,20170802,3922,3927,3917,3934,3905,3916,3917,-11,-10,342536,"2,012,600.06",597500
,20170803,3916,3917,3898,3925,3887,3889,3903,-28,-14,445798,"2,610,419.22",611790
,20170804,3889,3903,3897,3919,3893,3911,3903,8,0,347920,"2,037,252.53",604320
,20170807,3911,3903,3890,3891,3812,3823,3844,-80,-59,786380,"4,534,466.94",647196
,20170808,3823,3844,3809,3833,3803,3813,3816,-31,-28,402040,"2,301,863.21",645494
,20170809,3813,3816,3829,3870,3805,3863,3839,47,23,710198,"4,090,641.77",676832
,20170810,3863,3839,3912,3984,3905,3973,3937,134,98,867618,"5,124,416.10",687356
,20170811,3973,3937,4016,4026,3966,3983,3993,46,56,735684,"4,406,862.92",632854
,20170814,3983,3993,3969,4031,3949,4013,3990,20,-3,712064,"4,262,754.43",697790
,20170815,4013,3990,3987,4004,3933,3951,3969,-39,-21,637606,"3,796,079.62",638134
,20170816,3951,3969,3916,3926,3896,3906,3911,-63,-58,454056,"2,663,894.69",614374
,20170817,3906,3911,3911,4019,3902,4003,3970,92,59,939300,"5,594,219.01",694938
,20170818,4003,3970,3999,4011,3966,3985,3985,15,15,540820,"3,233,207.88",669376
,20170821,3985,3985,4018,4040,3946,3974,3991,-11,6,876044,"5,245,334.31",683540
,20170822,3974,3991,3984,4001,3962,3967,3981,-24,-10,463004,"2,765,198.87",707732
,20170823,3967,3981,3987,3993,3952,3967,3970,-14,-11,565526,"3,367,993.45",696094
,20170824,3967,3970,3970,3988,3963,3968,3973,-2,3,438452,"2,613,271.49",685388
,20170825,3968,3973,3963,3973,3948,3964,3961,-9,-12,379750,"2,256,396.76",681914
,20170828,3964,3961,3961,3997,3902,3985,3966,24,5,995662,"5,924,637.11",708856
,20170829,3985,3966,3995,4032,3976,4027,4008,61,42,664412,"3,995,287.64",720050
,20170830,4027,4008,4039,4049,3991,3996,4019,-12,11,599048,"3,612,128.76",674026
,20170831,3996,4019,4000,4009,3983,3990,3995,-29,-24,340426,"2,040,474.36",666338
,20170901,3990,3995,3996,4026,3994,4002,4008,7,13,521730,"3,137,130.57",683390
,20170904,4002,4008,4017,4075,4006,4062,4038,54,30,813464,"4,928,326.31",706900
,20170905,4062,4038,4055,4066,4046,4059,4056,21,18,330668,"2,012,113.21",719268
,20170906,4059,4056,4061,4074,4041,4054,4058,-2,2,517746,"3,151,527.14",687930
,20170907,4054,4058,4061,4063,4026,4035,4045,-23,-13,368638,"2,236,863.50",654914
,20170908,4035,4045,4054,4065,4039,4053,4052,8,7,584322,"3,551,746.84",636402
,20170911,4053,4052,4046,4048,3991,3994,4020,-58,-32,500356,"3,017,390.14",598448
,20170912,3994,4020,3990,4014,3983,3989,3998,-31,-22,321286,"1,926,764.48",597360
,20170913,3989,3998,3992,4003,3986,3987,3995,-11,-3,232620,"1,394,256.85",597806
,20170914,3987,3995,3985,3993,3969,3973,3978,-22,-17,315414,"1,882,187.75",598252
,20170915,3973,3978,3982,3997,3975,3979,3986,1,8,250216,"1,496,048.45",596030
,20170918,3979,3986,3977,3983,3961,3968,3970,-18,-16,390988,"2,328,567.62",605666
,20170919,3968,3970,3945,3950,3888,3919,3922,-51,-48,474574,"2,792,004.77",604674
,20170920,3919,3922,3916,3932,3914,3924,3923,2,1,213514,"1,256,555.22",590288
,20170921,3924,3923,3915,3942,3865,3867,3901,-56,-22,451872,"2,644,446.89",605646
,20170922,3867,3901,3850,3874,3849,3866,3863,-35,-38,309744,"1,795,153.34",585848
,20170925,3866,3863,3857,3871,3853,3862,3861,-1,-2,236762,"1,371,560.15",585542
,20170926,3862,3861,3862,3934,3856,3918,3906,57,45,512582,"3,003,901.30",573304
,20170927,3918,3906,3895,3900,3872,3884,3888,-22,-18,315432,"1,839,672.93",572360
,20170928,3884,3888,3870,3884,3850,3864,3867,-24,-21,288290,"1,672,384.25",571990
,20170929,3864,3867,3868,3884,3863,3874,3873,7,6,210862,"1,225,163.19",546142
,20171009,3874,3873,3879,3920,3875,3895,3905,22,32,257192,"1,506,885.22",563822
,20171010,3895,3905,3898,3908,3889,3901,3897,-4,-8,233624,"1,365,931.79",578446
,20171011,3901,3897,3905,3912,3888,3892,3899,-5,2,251774,"1,472,833.82",579534
,20171012,3892,3899,3896,3917,3881,3899,3899,0,0,249826,"1,461,376.26",560498
,20171013,3899,3899,3898,3923,3893,3912,3908,13,9,255324,"1,496,758.41",567122
,20171016,3912,3908,3917,3941,3910,3935,3923,27,15,365468,"2,150,644.22",597994
,20171017,3935,3923,3940,3944,3898,3910,3920,-13,-3,321536,"1,890,930.48",556634
,20171018,3910,3920,3905,3914,3897,3901,3904,-19,-16,224582,"1,315,167.42",551804
,20171019,3901,3904,3897,3901,3882,3888,3891,-16,-13,221608,"1,293,468.45",552324
,20171020,3888,3891,3888,3921,3887,3903,3907,12,16,366070,"2,145,672.14",549846
,20171023,3903,3907,3904,3909,3860,3878,3888,-29,-19,336840,"1,964,667.87",544438
,20171024,3878,3888,3870,3896,3866,3890,3883,2,-5,265846,"1,548,760.93",540332
,20171025,3890,3883,3882,3884,3868,3869,3874,-14,-9,210624,"1,223,989.66",520372
,20171026,3869,3874,3870,3888,3868,3880,3879,6,5,221262,"1,287,714.48",515788
,20171027,3880,3879,3875,3887,3825,3832,3852,-47,-27,403710,"2,333,039.76",541454
,20171030,3832,3852,3818,3857,3813,3841,3837,-11,-15,346112,"1,992,430.58",493898
,20171031,3841,3837,3835,3851,3831,3848,3844,11,7,183816,"1,059,906.86",463020
,20171101,3848,3844,3836,3848,3817,3842,3832,-2,-12,269616,"1,550,075.15",439898
,20171102,3842,3832,3845,3881,3837,3876,3867,44,35,373564,"2,167,264.10",430696
,20171103,3876,3867,3873,3893,3871,3881,3881,14,14,197298,"1,148,696.57",414246
,20171106,3881,3881,3885,3896,3846,3856,3861,-25,-20,318676,"1,845,842.02",392372
,20171107,3856,3861,3857,3903,3854,3887,3878,26,17,307460,"1,788,865.61",409084
,20171108,3887,3878,3878,3892,3867,3877,3877,-1,-1,191820,"1,115,674.10",386718
,20171109,3877,3877,3885,3895,3875,3887,3884,10,7,210164,"1,224,611.12",377382
,20171110,3887,3884,3889,3899,3872,3884,3883,0,-1,209946,"1,222,994.37",355896
,20171113,3884,3883,3885,3892,3856,3865,3870,-18,-13,229878,"1,334,726.15",347644
,20171114,3865,3870,3865,3882,3856,3869,3871,-1,1,158998,"923,419.57",346780
,20171115,3869,3871,3867,3885,3857,3870,3870,-1,-1,173878,"1,009,504.14",331994
,20171116,3870,3870,3878,3887,3864,3869,3874,-1,4,199974,"1,162,091.46",320566
,20171117,3869,3874,3872,3880,3869,3875,3875,1,1,123718,"719,111.91",307312
,20171120,3875,3875,3873,3916,3865,3893,3888,18,13,215894,"1,259,174.88",291502
,20171121,3893,3888,3894,3898,3858,3873,3874,-15,-14,205320,"1,193,264.34",239846
,20171122,3873,3874,3870,3877,3862,3867,3869,-7,-5,76926,"446,533.58",221142
,20171123,3867,3869,3865,3879,3865,3869,3872,0,3,69380,"402,974.74",201524
,20171124,3869,3872,3873,3878,3863,3871,3870,-1,-2,44070,"255,885.38",182670
,20171127,3871,3870,3864,3873,3853,3865,3862,-5,-8,53754,"311,433.75",157742
,20171128,3865,3862,3869,3880,3860,3866,3869,4,7,57040,"331,083.13",131052
,20171129,3866,3869,3871,3873,3822,3841,3845,-28,-24,49952,"288,110.44",109160
,20171130,3841,3845,3835,3841,3757,3766,3794,-79,-51,64588,"367,638.50",77790
,20171201,3766,3794,3769,3769,3711,3742,3744,-52,-50,23734,"133,291.24",66040
,20171204,3742,3744,3731,3756,3692,3731,3723,-13,-21,17144,"95,749.83",62068
,20171205,3731,3723,3721,3735,3711,3720,3722,-3,-1,13864,"77,411.17",56788
,20171206,3720,3722,3720,3720,3668,3679,3679,-43,-43,10164,"56,103.59",51920
,20171207,3679,3679,3671,3677,3578,3629,3648,-50,-31,7060,"38,642.38",49316
,20171208,3629,3648,3605,3614,3591,3603,3601,-45,-47,5912,"31,939.30",46408
,20171211,3603,3601,3613,3626,3590,3620,3614,19,13,11824,"64,114.41",44048
,20171212,3620,3614,3620,3622,3596,3602,3604,-12,-10,9128,"49,349.62",40948
,20171213,3602,3604,3594,3604,3580,3599,3595,-5,-9,3252,"17,537.40",39672
,20171214,3599,3595,3600,3678,3591,3672,3640,77,45,1116,"6,093.77",39584
,20171215,3672,3640,3657,3699,3631,3656,3661,16,21,2716,"14,917.88",40056
ag1801,20170117,4228,4228,,,,4228,4228,0,0,0,0.00,0
,20170118,4228,4228,4280,4294,4262,4294,4278,66,50,6,38.51,4
,20170119,4294,4278,,,,4278,4278,0,0,0,0.00,4
,20170120,4278,4278,,,,4278,4278,0,0,0,0.00,4
,20170123,4278,4278,,,,4278,4278,0,0,0,0.00,4
,20170124,4278,4278,,,,4278,4278,0,0,0,0.00,4
,20170125,4278,4278,4217,4217,4175,4175,4196,-103,-82,4,25.18,6
,20170126,4175,4196,,,,4145,4145,-51,-51,0,0.00,6
,20170203,4145,4145,,,,4145,4145,0,0,0,0.00,6
,20170206,4145,4145,4193,4193,4193,4193,4193,48,48,2,12.58,8
,20170207,4193,4193,,,,4193,4193,0,0,0,0.00,8
,20170208,4193,4193,4296,4296,4296,4296,4296,103,103,4,25.78,8
,20170209,4296,4296,4309,4309,4299,4299,4304,3,8,4,25.82,12
,20170210,4299,4304,4281,4281,4269,4269,4274,-35,-30,6,38.47,12
,20170213,4269,4274,,,,4306,4306,32,32,0,0.00,12
,20170214,4306,4306,,,,4306,4306,0,0,0,0.00,12
,20170215,4306,4306,4341,4341,4341,4341,4341,35,35,2,13.02,12
,20170216,4341,4341,4325,4325,4325,4325,4325,-16,-16,2,12.98,14
,20170217,4325,4325,4355,4355,4349,4349,4352,24,27,8,52.23,18
,20170220,4349,4352,4352,4352,4351,4351,4351,-1,-1,4,26.11,22
,20170221,4351,4351,4354,4369,4348,4356,4356,5,5,10,65.35,30
,20170222,4356,4356,4345,4351,4335,4351,4345,-5,-11,8,52.15,30
,20170223,4351,4345,4365,4365,4310,4334,4326,-11,-19,38,246.59,50
,20170224,4334,4326,4347,4384,4332,4384,4357,58,31,18,117.66,54
,20170227,4384,4357,4406,4437,4406,4435,4425,78,68,12,79.66,54
,20170228,4435,4425,4482,4482,4417,4435,4440,10,15,10,66.61,54
,20170301,4435,4440,4426,4430,4388,4408,4406,-32,-34,32,211.49,74
,20170302,4408,4406,4394,4394,4394,4394,4394,-12,-12,2,13.18,72
,20170303,4394,4394,4421,4433,4280,4295,4310,-99,-84,66,426.72,70
,20170306,4295,4310,4301,4301,4295,4295,4299,-15,-11,8,51.59,68
,20170307,4295,4299,4302,4304,4290,4290,4299,-9,0,12,77.40,68
,20170308,4290,4299,4265,4272,4255,4255,4261,-44,-38,10,63.92,76
,20170309,4255,4261,4228,4234,4179,4179,4217,-82,-44,28,177.11,86
,20170310,4179,4217,4216,4216,4148,4148,4183,-69,-34,12,75.30,96
,20170313,4148,4183,4159,4179,4159,4173,4171,-10,-12,18,112.64,92
,20170314,4173,4171,4186,4189,4182,4182,4187,11,16,264,"1,658.39",344
,20170315,4182,4187,4175,4175,4163,4173,4168,-14,-19,16,100.05,350
,20170316,4173,4168,4178,4288,4166,4280,4238,112,70,42,267.04,348
,20170317,4280,4238,,,,4238,4238,0,0,0,0.00,348
,20170320,4238,4238,4287,4288,4287,4288,4287,50,49,4,25.73,348
,20170321,4288,4287,4288,4288,4236,4263,4269,-24,-18,168,"1,075.91",476
,20170322,4263,4269,4285,4309,4282,4299,4291,30,22,40,257.51,476
,20170323,4299,4291,4299,4299,4296,4299,4297,8,6,12,77.36,476
,20170324,4299,4297,4305,4305,4265,4281,4284,-16,-13,592,"3,804.76",1060
,20170327,4281,4284,4303,4328,4303,4326,4320,42,36,30,194.42,1064
,20170328,4326,4320,4349,4350,4329,4339,4337,19,17,18,117.12,1064
,20170329,4339,4337,4345,4348,4319,4319,4336,-18,-1,28,182.15,1064
,20170330,4319,4336,4327,4328,4313,4328,4324,-8,-12,16,103.79,1066
,20170331,4328,4324,4315,4325,4301,4315,4312,-9,-12,28,181.13,1066
,20170405,4315,4312,4335,4337,4331,4331,4334,19,22,22,143.04,1064
,20170406,4331,4334,4336,4340,4333,4340,4335,6,1,10,65.04,1068
,20170407,4340,4335,4324,4397,4324,4378,4365,43,30,82,536.98,1104
,20170410,4378,4365,4348,4348,4273,4288,4290,-77,-75,50,321.77,1116
,20170411,4288,4290,4254,4286,4250,4286,4267,-4,-23,168,"1,075.40",1092
,20170412,4286,4267,4299,4372,4295,4341,4321,74,54,42,272.27,1102
,20170413,4341,4321,4386,4386,4374,4376,4378,55,57,12,78.81,1102
,20170414,4376,4378,4382,4382,4382,4382,4382,4,4,22,144.61,1102
,20170417,4382,4382,4402,4436,4382,4396,4415,14,33,66,437.16,1100
,20170418,4396,4415,4302,4386,4200,4360,4312,-55,-103,216,"1,397.11",1184
,20170419,4360,4312,4354,4366,4320,4320,4342,8,30,80,521.13,1150
,20170420,4320,4342,4338,4338,4313,4313,4323,-29,-19,136,882.00,1086
,20170421,4313,4323,4314,4314,4287,4288,4304,-35,-19,74,477.80,1080
,20170424,4288,4304,4276,4282,4268,4270,4274,-34,-30,30,192.33,1074
,20170425,4270,4274,4250,4270,4250,4269,4264,-5,-10,8,51.17,1068
,20170426,4269,4264,4250,4255,4238,4238,4250,-26,-14,30,191.25,1080
,20170427,4238,4250,4231,4231,4231,4231,4231,-19,-19,2,12.69,1078
,20170428,4231,4231,4231,4239,4226,4233,4232,2,1,22,139.67,1082
,20170502,4233,4232,4200,4200,4145,4163,4165,-69,-67,254,"1,587.04",1198
,20170503,4163,4165,4157,4165,4156,4162,4160,-3,-5,50,312.01,1188
,20170504,4162,4160,4155,4155,4008,4055,4093,-105,-67,280,"1,719.38",1240
,20170505,4055,4093,4029,4076,4009,4064,4032,-29,-61,86,520.20,1228
,20170508,4064,4032,4053,4064,4034,4056,4052,24,20,38,231.01,1220
,20170509,4056,4052,4048,4052,4040,4046,4046,-6,-6,68,412.76,1226
,20170510,4046,4046,4022,4026,3998,4009,4007,-37,-39,98,589.16,1272
,20170511,4009,4007,4036,4053,4027,4050,4043,43,36,56,339.68,1288
,20170512,4050,4043,4045,4080,4043,4075,4055,32,12,66,401.51,1262
,20170515,4075,4055,4061,4100,4061,4096,4082,41,27,12,73.48,1258
,20170516,4096,4082,4132,4132,4117,4121,4123,39,41,54,334.00,1236
,20170517,4121,4123,4115,4131,4115,4125,4120,2,-3,26,160.69,1220
,20170518,4125,4120,4144,4179,4120,4120,4135,0,15,56,347.40,1216
,20170519,4120,4135,4114,4124,4058,4118,4101,-17,-34,98,602.91,1264
,20170522,4118,4101,4122,4128,4104,4120,4121,19,20,110,680.04,1252
,20170523,4120,4121,4135,4159,4135,4159,4144,38,23,34,211.39,1240
,20170524,4159,4144,4159,4161,4105,4106,4121,-38,-23,28,173.12,1238
,20170525,4106,4121,4123,4150,4111,4140,4132,19,11,40,247.92,1254
,20170526,4140,4132,4133,4140,4120,4140,4127,8,-5,30,185.72,1250
,20170531,4140,4127,4135,4135,4114,4115,4120,-12,-7,46,284.32,1226
,20170601,4115,4120,4104,4118,4091,4091,4106,-29,-14,38,234.05,1230
,20170602,4091,4106,4078,4079,4076,4076,4077,-30,-29,8,48.93,1232
,20170605,4076,4077,4107,4158,4100,4143,4123,66,46,32,197.94,1236
,20170606,4143,4123,4160,4176,4160,4175,4168,52,45,16,100.04,1236
,20170607,4175,4168,4194,4194,4170,4182,4179,14,11,64,401.23,1240
,20170608,4182,4179,4174,4174,4155,4172,4164,-7,-15,108,674.68,1250
,20170609,4172,4164,4150,4151,4113,4113,4134,-51,-30,86,533.29,1240
,20170612,4113,4134,4109,4109,4076,4076,4092,-58,-42,36,221.01,1244
,20170613,4076,4092,4072,4078,4054,4054,4066,-38,-26,30,182.99,1244
,20170614,4054,4066,4050,4081,4050,4071,4064,5,-2,20,121.94,1246
,20170615,4071,4064,4140,4140,4026,4075,4108,11,44,66,406.71,1242
,20170616,4075,4108,4037,4061,4037,4057,4048,-51,-60,42,255.05,1246
,20170619,4057,4048,4050,4050,4039,4040,4041,-8,-7,16,96.98,1256
,20170620,4040,4041,4038,4039,4027,4039,4028,-2,-13,512,"3,093.77",1614
,20170621,4039,4028,4008,4026,4008,4016,4019,-12,-9,66,397.91,1622
,20170622,4016,4019,4014,4060,4013,4051,4051,32,32,62,376.83,1614
,20170623,4051,4051,4053,4062,4048,4062,4051,11,0,36,218.76,1614
,20170626,4062,4051,4076,4076,4055,4059,4065,8,14,42,256.11,1614
,20170627,4059,4065,4033,4039,4027,4038,4032,-27,-33,66,399.19,1610
,20170628,4038,4032,4074,4075,4074,4075,4074,43,42,4,24.45,1610
,20170629,4075,4074,4068,4075,4060,4071,4067,-3,-7,38,231.87,1608
,20170630,4071,4067,4026,4044,4026,4030,4032,-37,-35,110,665.32,1630
,20170703,4030,4032,4015,4034,4008,4015,4017,-17,-15,86,518.20,1618
,20170704,4015,4017,3971,3971,3893,3902,3929,-115,-88,1784,"10,514.35",2798
,20170705,3902,3929,3890,3928,3888,3903,3905,-26,-24,180,"1,054.61",2776
,20170706,3903,3905,3878,3909,3873,3892,3890,-13,-15,164,956.94,2806
,20170707,3892,3890,3898,3903,3854,3871,3872,-19,-18,356,"2,067.71",2822
,20170710,3871,3872,3870,3870,3678,3678,3758,-194,-114,602,"3,393.87",2822
,20170711,3678,3758,3737,3772,3680,3737,3732,-21,-26,530,"2,967.23",2712
,20170712,3737,3732,3758,3830,3752,3802,3796,70,64,270,"1,537.60",2674
,20170713,3802,3796,3850,3850,3820,3830,3830,34,34,112,643.50,2656
,20170714,3830,3830,3825,3825,3756,3785,3783,-45,-47,238,"1,350.89",2700
,20170717,3785,3783,3854,3873,3834,3855,3849,72,66,410,"2,367.51",2650
,20170718,3855,3849,3874,3885,3853,3853,3875,4,26,150,871.94,2638
,20170719,3853,3875,3874,3877,3854,3865,3862,-10,-13,444,"2,572.76",2414
,20170720,3865,3862,3876,3886,3861,3865,3880,3,18,1344,"7,823.35",1836
,20170721,3865,3880,3883,3905,3863,3898,3888,18,8,198,"1,154.83",1766
,20170724,3898,3888,3912,3915,3888,3896,3904,8,16,104,609.03,1732
,20170725,3896,3904,3899,3976,3891,3905,3904,1,0,234,"1,370.31",1838
,20170726,3905,3904,3908,3921,3867,3871,3888,-33,-16,140,816.50,1792
,20170727,3871,3888,3886,3993,3878,3928,3932,40,44,250,"1,474.62",1810
,20170728,3928,3932,3939,3944,3913,3923,3921,-9,-11,148,870.60,1742
,20170731,3923,3921,3927,3934,3927,3929,3929,8,8,62,365.47,1712
,20170801,3929,3929,3943,3951,3935,3938,3943,9,14,38,224.78,1708
,20170802,3938,3943,3929,3943,3922,3931,3931,-12,-12,82,483.52,1704
,20170803,3931,3931,3918,3938,3906,3906,3921,-25,-10,132,776.53,1700
,20170804,3906,3921,3912,3932,3909,3930,3922,9,1,408,"2,400.34",1720
,20170807,3930,3922,3885,3905,3835,3841,3868,-81,-54,422,"2,448.74",1790
,20170808,3841,3868,3825,3851,3825,3837,3838,-31,-30,160,921.17,1816
,20170809,3837,3838,3847,3902,3825,3882,3861,44,23,236,"1,366.85",1810
,20170810,3882,3861,3936,4000,3925,3990,3952,129,91,414,"2,454.41",1700
,20170811,3990,3952,4044,4058,3991,4002,4011,50,59,242,"1,456.28",1678
,20170814,4002,4011,3995,4046,3969,4029,4010,18,-1,232,"1,395.75",1676
,20170815,4029,4010,4012,4020,3951,3963,3985,-47,-25,270,"1,613.96",1728
,20170816,3963,3985,3938,3942,3916,3926,3931,-59,-54,156,919.86,1724
,20170817,3926,3931,3927,4058,3925,4026,3997,95,66,444,"2,662.58",1686
,20170818,4026,3997,4016,4025,3985,4004,4001,7,4,220,"1,320.47",1690
,20170821,4004,4001,4040,4058,3972,3987,4012,-14,11,210,"1,263.98",1710
,20170822,3987,4012,4007,4023,3986,3986,3996,-26,-16,276,"1,654.43",1690
,20170823,3986,3996,4006,4011,3975,3986,3988,-10,-8,128,765.78,1690
,20170824,3986,3988,3987,4009,3982,3982,3990,-6,2,308,"1,843.78",1652
,20170825,3982,3990,3986,3988,3970,3971,3976,-19,-14,74,441.37,1620
,20170828,3971,3976,3977,4010,3925,4009,3980,33,4,324,"1,934.30",1686
,20170829,4009,3980,4054,4054,3995,4044,4024,64,44,336,"2,028.25",1656
,20170830,4044,4024,4050,4068,4007,4007,4037,-17,13,416,"2,519.39",1532
,20170831,4007,4037,4010,4022,3999,4007,4013,-30,-24,82,493.61,1528
,20170901,4007,4013,4013,4038,4013,4019,4026,6,13,136,821.45,1520
,20170904,4019,4026,4034,4095,4026,4088,4080,62,54,968,"5,924.92",2048
,20170905,4088,4080,4068,4116,4065,4080,4080,0,0,254,"1,554.85",2034
,20170906,4080,4080,4080,4091,4062,4072,4079,-8,-1,324,"1,982.67",2054
,20170907,4072,4079,4082,4082,4049,4052,4057,-27,-22,550,"3,347.62",1984
,20170908,4052,4057,4080,4087,4059,4078,4074,21,17,194,"1,185.63",2016
,20170911,4078,4074,4061,4061,4012,4016,4028,-58,-46,170,"1,027.33",1934
,20170912,4016,4028,4016,4033,4008,4011,4022,-17,-6,94,567.20,1944
,20170913,4011,4022,4018,4023,4005,4005,4016,-17,-6,144,867.66,1930
,20170914,4005,4016,4007,4013,3991,3996,4000,-20,-16,172,"1,032.01",1958
,20170915,3996,4000,4001,4015,3993,3995,4004,-5,4,64,384.45,1954
,20170918,3995,4004,3989,3999,3983,3985,3988,-19,-16,50,299.12,1938
,20170919,3985,3988,3964,3967,3904,3938,3941,-50,-47,310,"1,832.70",1878
,20170920,3938,3941,3941,3950,3939,3949,3944,8,3,60,355.00,1876
,20170921,3949,3944,3958,3958,3887,3889,3910,-55,-34,126,739.12,1838
,20170922,3889,3910,3873,3895,3873,3882,3883,-28,-27,118,687.43,1842
,20170925,3882,3883,3883,3888,3872,3880,3883,-3,0,166,966.95,1860
,20170926,3880,3883,3878,3953,3877,3940,3927,57,44,280,"1,649.56",1812
,20170927,3940,3927,3914,3920,3891,3902,3908,-25,-19,116,680.01,1846
,20170928,3902,3908,3894,3903,3875,3879,3889,-29,-19,346,"2,018.72",1708
,20170929,3879,3889,3886,3897,3881,3881,3891,-8,2,66,385.24,1706
,20171009,3881,3891,3930,3935,3915,3915,3922,24,31,862,"5,071.82",2182
,20171010,3915,3922,3912,3925,3904,3918,3914,-4,-8,150,880.74,2158
,20171011,3918,3914,3920,3927,3901,3911,3915,-3,1,102,599.13,2152
,20171012,3911,3915,3919,3922,3916,3916,3918,1,3,28,164.59,2160
,20171013,3916,3918,3910,3945,3909,3936,3936,18,18,898,"5,302.91",1822
,20171016,3936,3936,3934,3960,3933,3960,3941,24,5,416,"2,459.47",1880
,20171017,3960,3941,3953,3961,3901,3925,3932,-16,-9,138,814.05,1850
,20171018,3925,3932,3916,3933,3916,3924,3926,-8,-6,90,530.10,1856
,20171019,3924,3926,3915,3924,3907,3914,3913,-12,-13,148,868.85,1856
,20171020,3914,3913,3920,3945,3920,3929,3934,16,21,106,625.52,1856
,20171023,3929,3934,3939,3939,3890,3907,3902,-27,-32,170,995.18,1866
,20171024,3907,3902,3852,3917,3852,3913,3902,11,0,84,491.73,1870
,20171025,3913,3902,3903,3904,3894,3894,3898,-8,-4,98,573.14,1866
,20171026,3894,3898,3870,3908,3870,3904,3898,6,0,48,280.69,1884
,20171027,3904,3898,3919,3919,3851,3851,3874,-47,-24,578,"3,359.18",2326
,20171030,3851,3874,3851,3871,3841,3862,3858,-12,-16,100,578.76,2314
,20171031,3862,3858,3866,3875,3785,3867,3862,9,4,194,"1,123.89",2330
,20171101,3867,3862,3863,3873,3843,3869,3857,7,-5,180,"1,041.45",2356
,20171102,3869,3857,3850,3916,3850,3889,3891,32,34,806,"4,704.41",1982
,20171103,3889,3891,3895,3908,3890,3900,3897,9,6,112,654.71,2014
,20171106,3900,3897,3909,3915,3860,3869,3879,-28,-18,436,"2,537.34",1980
,20171107,3869,3879,3878,3914,3872,3908,3900,29,21,466,"2,726.27",1994
,20171108,3908,3900,3905,3912,3889,3892,3898,-8,-2,78,456.16,1982
,20171109,3892,3898,3898,3915,3897,3908,3904,10,6,180,"1,054.19",2000
,20171110,3908,3904,3904,3920,3896,3903,3905,-1,1,910,"5,331.37",1992
,20171113,3903,3905,3911,3912,3863,3888,3891,-17,-14,424,"2,474.76",2028
,20171114,3888,3891,3882,3918,3881,3890,3891,-1,0,134,782.28,2030
,20171115,3890,3891,3885,3896,3863,3887,3887,-4,-4,178,"1,038.00",2006
,20171116,3887,3887,3897,3906,3885,3885,3895,-2,8,268,"1,566.04",2026
,20171117,3885,3895,3885,3901,3885,3899,3894,4,-1,140,817.77,2002
,20171120,3899,3894,3892,3950,3888,3916,3914,22,20,220,"1,291.78",2014
,20171121,3916,3914,3920,3920,3881,3890,3891,-24,-23,556,"3,245.16",2262
,20171122,3890,3891,3889,3898,3883,3887,3889,-4,-2,50,291.71,2260
,20171123,3887,3889,3891,3901,3884,3887,3891,-2,2,694,"4,051.40",2314
,20171124,3887,3891,3889,3902,3884,3898,3894,7,3,170,993.08,2232
,20171127,3898,3894,3889,3893,3880,3887,3884,-7,-10,108,629.34,2238
,20171128,3887,3884,3889,3905,3884,3888,3893,4,9,158,922.70,2198
,20171129,3888,3893,3891,3895,3849,3862,3863,-31,-30,382,"2,213.70",2130
,20171130,3862,3863,3857,3861,3787,3796,3828,-67,-35,654,"3,755.97",2166
,20171201,3796,3828,3776,3820,3765,3771,3776,-57,-52,456,"2,583.00",2266
,20171204,3771,3776,3762,3780,3721,3753,3746,-23,-30,994,"5,586.27",2364
,20171205,3753,3746,3755,3761,3745,3747,3751,1,5,546,"3,072.32",2430
,20171206,3747,3751,3742,3743,3696,3697,3706,-54,-45,742,"4,125.42",2712
,20171207,3697,3706,3701,3706,3647,3659,3670,-47,-36,458,"2,521.62",2836
,20171208,3659,3670,3629,3646,3613,3631,3628,-39,-42,830,"4,517.05",3000
,20171211,3631,3628,3634,3649,3615,3644,3640,16,12,344,"1,878.35",2960
,20171212,3644,3640,3643,3644,3626,3635,3629,-5,-11,248,"1,350.34",3108
,20171213,3635,3629,3636,3636,3617,3626,3622,-3,-7,68,369.53,3110
,20171214,3626,3622,3625,3704,3625,3694,3683,72,61,924,"5,105.97",3138
,20171215,3694,3683,3690,3696,3662,3675,3681,-8,-2,268,"1,479.97",3118
,20171218,3675,3681,3687,3703,3687,3692,3694,11,13,652,"3,612.77",3342
,20171219,3692,3694,3698,3707,3687,3705,3699,11,5,248,"1,376.39",3350
,20171220,3705,3699,3698,3703,3692,3696,3698,-3,-1,194,"1,076.17",3294
,20171221,3696,3698,3706,3709,3687,3695,3700,-3,2,104,577.29,3252
,20171222,3695,3700,3681,3703,3681,3691,3690,-9,-10,122,675.36,3206
,20171225,3691,3690,3690,3746,3690,3735,3729,45,39,156,872.75,3220
,20171226,3735,3729,3729,3742,3727,3740,3735,11,6,1466,"8,214.71",3218
,20171227,3740,3735,3746,3757,3746,3752,3752,17,17,340,"1,913.95",3140
,20171228,3752,3752,3765,3798,3765,3791,3779,39,27,158,895.68,3062
,20171229,3791,3779,3776,3817,3718,3718,3782,-61,3,396,"2,246.74",2828
ag1802,20170216,4341,4341,4269,4400,4269,4375,4351,34,10,22,143.61,8
,20170217,4375,4351,4386,4386,4358,4358,4375,7,24,6,39.38,8
,20170220,4358,4375,4350,4350,4350,4350,4350,-25,-25,2,13.05,10
,20170221,4350,4350,4377,4379,4330,4375,4368,25,18,22,144.17,20
,20170222,4375,4368,4378,4378,4356,4356,4367,-12,-1,4,26.20,20
,20170223,4356,4367,4371,4371,4363,4363,4367,-4,0,4,26.20,20
,20170224,4363,4367,4400,4411,4400,4404,4404,37,37,18,118.91,30
,20170227,4404,4404,4456,4458,4456,4458,4457,54,53,6,40.12,30
,20170228,4458,4457,4456,4484,4447,4454,4460,-3,3,28,187.32,38
,20170301,4454,4460,4444,4444,4403,4403,4431,-57,-29,8,53.18,38
,20170302,4403,4431,4444,4444,4444,4444,4444,13,13,4,26.66,42
,20170303,4444,4444,4425,4425,4306,4332,4354,-112,-90,6,39.19,44
,20170306,4332,4354,,,,4354,4354,0,0,0,0.00,44
,20170307,4354,4354,4316,4316,4302,4308,4311,-46,-43,14,90.53,48
,20170308,4308,4311,,,,4311,4311,0,0,0,0.00,48
,20170309,4311,4311,4243,4254,4201,4215,4207,-96,-104,232,"1,464.09",232
,20170310,4215,4207,4230,4230,4182,4182,4213,-25,6,14,88.47,240
,20170313,4182,4213,4155,4190,4155,4190,4172,-23,-41,4,25.04,238
,20170314,4190,4172,4209,4213,4188,4188,4205,16,33,116,731.73,346
,20170315,4188,4205,4185,4185,4185,4185,4185,-20,-20,2,12.56,348
,20170316,4185,4185,4192,4346,4192,4292,4276,107,91,26,166.77,348
,20170317,4292,4276,4297,4297,4287,4287,4292,11,16,4,25.75,350
,20170320,4287,4292,4304,4305,4304,4305,4304,13,12,4,25.83,354
,20170321,4305,4304,4305,4305,4279,4279,4292,-25,-12,4,25.75,354
,20170322,4279,4292,4304,4320,4296,4317,4313,25,21,50,323.53,372
,20170323,4317,4313,4314,4314,4314,4314,4314,1,1,2,12.94,374
,20170324,4314,4314,4325,4325,4299,4305,4302,-9,-12,22,141.99,378
,20170327,4305,4302,4340,4340,4337,4340,4339,38,37,6,39.05,380
,20170328,4340,4339,4366,4366,4349,4349,4358,10,19,26,169.97,394
,20170329,4349,4358,4337,4337,4337,4337,4337,-21,-21,4,26.02,390
,20170330,4337,4337,4346,4351,4338,4345,4345,8,8,10,65.19,386
,20170331,4345,4345,4336,4336,4331,4331,4333,-14,-12,4,26.00,384
,20170405,4331,4333,4352,4352,4352,4352,4352,19,19,2,13.06,384
,20170406,4352,4352,,,,4352,4352,0,0,0,0.00,384
,20170407,4352,4352,4392,4396,4392,4396,4394,44,42,6,39.55,380
,20170410,4396,4394,4297,4309,4264,4309,4288,-85,-106,20,128.66,392
,20170411,4309,4288,4300,4300,4271,4300,4290,12,2,6,38.61,388
,20170412,4300,4290,4390,4390,4368,4368,4377,78,87,6,39.40,392
,20170413,4368,4377,4392,4392,4392,4392,4392,15,15,10,65.88,388
,20170414,4392,4392,4398,4409,4398,4408,4405,16,13,14,92.52,396
,20170417,4408,4405,4434,4434,4434,4434,4434,29,29,4,26.60,396
,20170418,4434,4434,4406,4406,4387,4387,4399,-47,-35,6,39.60,392
,20170419,4387,4399,,,,4399,4399,0,0,0,0.00,392
,20170420,4399,4399,,,,4399,4399,0,0,0,0.00,392
,20170421,4399,4399,4334,4334,4300,4314,4323,-85,-76,10,64.85,394
,20170424,4314,4323,4301,4301,4280,4288,4287,-35,-36,22,141.49,388
,20170425,4288,4287,4280,4280,4274,4274,4277,-13,-10,4,25.66,388
,20170426,4274,4277,,,,4277,4277,0,0,0,0.00,388
,20170427,4277,4277,4250,4250,4250,4250,4250,-27,-27,2,12.75,386
,20170428,4250,4250,,,,4250,4250,0,0,0,0.00,386
,20170502,4250,4250,4187,4187,4187,4187,4187,-63,-63,2,12.56,384
,20170503,4187,4187,4190,4190,4173,4173,4177,-14,-10,8,50.13,390
,20170504,4173,4177,4162,4170,4120,4120,4140,-57,-37,16,99.38,394
,20170505,4120,4140,,,,4140,4140,0,0,0,0.00,394
,20170508,4140,4140,4063,4082,4063,4082,4072,-58,-68,4,24.44,398
,20170509,4082,4072,4066,4069,4061,4061,4065,-11,-7,12,73.19,404
,20170510,4061,4065,4037,4037,4037,4037,4037,-28,-28,2,12.11,406
,20170511,4037,4037,4051,4083,4051,4083,4067,46,30,4,24.40,406
,20170512,4083,4067,4077,4096,4077,4089,4087,22,20,6,36.79,408
,20170515,4089,4087,4118,4118,4118,4118,4118,31,31,2,12.35,410
,20170516,4118,4118,4136,4142,4136,4141,4139,23,21,6,37.26,414
,20170517,4141,4139,,,,4139,4139,0,0,0,0.00,414
,20170518,4139,4139,4159,4159,4140,4140,4149,1,10,4,24.90,416
,20170519,4140,4149,4113,4113,4108,4108,4111,-41,-38,6,37.00,416
,20170522,4108,4111,4120,4142,4120,4142,4134,31,23,8,49.62,418
,20170523,4142,4134,4170,4177,4170,4177,4173,43,39,4,25.04,414
,20170524,4177,4173,,,,4163,4163,-10,-10,0,0.00,414
,20170525,4163,4163,,,,4163,4163,0,0,0,0.00,414
,20170526,4163,4163,,,,4163,4163,0,0,0,0.00,414
,20170531,4163,4163,,,,4156,4156,-7,-7,0,0.00,414
,20170601,4156,4156,,,,4156,4156,0,0,0,0.00,414
,20170602,4156,4156,,,,4156,4156,0,0,0,0.00,414
,20170605,4156,4156,4124,4124,4124,4124,4124,-32,-32,2,12.37,416
,20170606,4124,4124,4176,4176,4176,4176,4176,52,52,2,12.53,418
,20170607,4176,4176,4213,4213,4213,4213,4213,37,37,2,12.64,418
,20170608,4213,4213,,,,4213,4213,0,0,0,0.00,418
,20170609,4213,4213,4148,4148,4136,4136,4144,-77,-69,8,49.73,422
,20170612,4136,4144,4114,4114,4098,4098,4106,-46,-38,4,24.64,424
,20170613,4098,4106,4077,4108,4073,4073,4080,-33,-26,12,73.45,430
,20170614,4073,4080,4067,4081,4051,4051,4064,-29,-16,8,48.77,428
,20170615,4051,4064,4136,4170,4084,4084,4128,20,64,22,136.25,428
,20170616,4084,4128,4053,4060,4053,4060,4057,-68,-71,8,48.69,430
,20170619,4060,4057,4070,4070,4067,4067,4069,10,12,6,36.62,430
,20170620,4067,4069,4039,4039,4039,4039,4039,-30,-30,2,12.12,430
,20170621,4039,4039,4033,4033,4033,4033,4033,-6,-6,2,12.10,430
,20170622,4033,4033,4068,4068,4068,4068,4068,35,35,2,12.20,430
,20170623,4068,4068,4071,4076,4065,4065,4070,-3,2,6,36.64,430
,20170626,4065,4070,4081,4081,4073,4073,4075,3,5,6,36.68,428
,20170627,4073,4075,4052,4052,4049,4049,4050,-26,-25,4,24.30,426
,20170628,4049,4050,4066,4093,4066,4093,4076,43,26,6,36.69,426
,20170629,4093,4076,4081,4094,4081,4094,4084,18,8,12,73.53,426
,20170630,4094,4084,4051,4068,4041,4041,4055,-43,-29,66,401.48,438
,20170703,4041,4055,4055,4055,4009,4046,4041,-9,-14,12,72.74,440
,20170704,4046,4041,3997,3997,3917,3919,3953,-122,-88,40,237.23,446
,20170705,3919,3953,3927,3980,3913,3980,3929,27,-24,20,117.89,450
,20170706,3980,3929,3872,3922,3872,3922,3915,-7,-14,68,399.34,486
,20170707,3922,3915,3923,3963,3865,3909,3905,-6,-10,36,210.87,504
,20170710,3909,3905,3870,3870,3709,3711,3783,-194,-122,26,147.55,500
,20170711,3711,3783,3743,3784,3709,3776,3744,-7,-39,50,280.81,498
,20170712,3776,3744,3847,3871,3815,3861,3847,117,103,46,265.45,514
,20170713,3861,3847,3868,3870,3852,3852,3861,5,14,14,81.08,518
,20170714,3852,3861,3824,3850,3788,3810,3814,-51,-47,10,57.22,520
,20170717,3810,3814,3867,3876,3867,3876,3871,62,57,6,34.84,518
,20170718,3876,3871,3902,3909,3863,3897,3891,26,20,44,256.82,504
,20170719,3897,3891,3895,3895,3895,3895,3895,4,4,2,11.69,502
,20170720,3895,3895,,,,3895,3895,0,0,0,0.00,502
,20170721,3895,3895,3888,3916,3888,3910,3900,15,5,8,46.81,502
,20170724,3910,3900,3917,3917,3900,3900,3908,0,8,4,23.45,502
,20170725,3900,3908,,,,3908,3908,0,0,0,0.00,502
,20170726,3908,3908,3890,3890,3890,3890,3890,-18,-18,4,23.34,502
,20170727,3890,3890,3900,3955,3889,3950,3933,60,43,16,94.40,506
,20170728,3950,3933,3945,3945,3935,3938,3939,5,6,6,35.45,506
,20170731,3938,3939,,,,3939,3939,0,0,0,0.00,506
,20170801,3939,3939,3957,3957,3947,3947,3952,8,13,4,23.71,508
,20170802,3947,3952,3955,3955,3943,3943,3950,-9,-2,10,59.25,510
,20170803,3943,3950,3944,3944,3944,3944,3944,-6,-6,2,11.83,508
,20170804,3944,3944,,,,3944,3944,0,0,0,0.00,508
,20170807,3944,3944,3840,3840,3840,3840,3840,-104,-104,2,11.52,506
,20170808,3840,3840,3850,3850,3850,3850,3850,10,10,2,11.55,504
,20170809,3850,3850,3845,3891,3835,3891,3857,41,7,6,34.71,506
,20170810,3891,3857,3949,3999,3933,3999,3947,142,90,22,130.25,502
,20170811,3999,3947,4006,4052,4004,4004,4027,57,80,26,157.08,504
,20170814,4004,4027,3980,4004,3980,4003,3989,-24,-38,12,71.81,500
,20170815,4003,3989,4016,4019,3969,3969,4005,-20,16,16,96.14,502
,20170816,3969,4005,3945,3950,3926,3950,3940,-55,-65,6,35.46,502
,20170817,3950,3940,,,,3993,3993,53,53,0,0.00,502
,20170818,3993,3993,4032,4032,4032,4032,4032,39,39,2,12.10,500
,20170821,4032,4032,4052,4052,3995,3995,4007,-37,-25,20,120.22,500
,20170822,3995,4007,4011,4021,4000,4000,4012,-7,5,8,48.15,498
,20170823,4000,4012,4019,4019,3990,3990,4001,-22,-11,6,36.01,498
,20170824,3990,4001,4002,4002,4002,4002,4002,1,1,4,24.01,500
,20170825,4002,4002,,,,4002,4002,0,0,0,0.00,500
,20170828,4002,4002,,,,4002,4002,0,0,0,0.00,500
,20170829,4002,4002,4017,4053,4017,4053,4044,51,42,8,48.53,494
,20170830,4053,4044,4063,4064,4028,4028,4051,-16,7,8,48.62,494
,20170831,4028,4051,4023,4023,4023,4023,4023,-28,-28,2,12.07,496
,20170901,4023,4023,4039,4050,4035,4035,4041,12,18,6,36.37,494
,20170904,4035,4041,4080,4091,4080,4091,4085,50,44,6,36.77,492
,20170905,4091,4085,4060,4096,4060,4096,4081,11,-4,8,48.98,492
,20170906,4096,4081,4090,4090,4090,4090,4090,9,9,2,12.27,492
,20170907,4090,4090,,,,4090,4090,0,0,0,0.00,492
,20170908,4090,4090,4077,4077,4077,4077,4077,-13,-13,2,12.23,492
,20170911,4077,4077,4054,4054,4048,4048,4051,-29,-26,4,24.31,494
,20170912,4048,4051,4035,4043,4020,4020,4032,-31,-19,8,48.39,498
,20170913,4020,4032,,,,4032,4032,0,0,0,0.00,498
,20170914,4032,4032,4019,4019,4015,4015,4015,-17,-17,10,60.24,508
,20170915,4015,4015,4027,4032,4027,4032,4029,17,14,6,36.26,510
,20170918,4032,4029,4014,4014,3991,4013,4003,-16,-26,10,60.05,510
,20170919,4013,4003,3974,3978,3970,3976,3975,-27,-28,20,119.25,518
,20170920,3976,3975,3957,3957,3957,3957,3957,-18,-18,2,11.87,516
,20170921,3957,3957,3962,3962,3921,3933,3936,-24,-21,42,247.97,542
,20170922,3933,3936,3893,3913,3893,3907,3906,-29,-30,18,105.48,542
,20170925,3907,3906,,,,3906,3906,0,0,0,0.00,542
,20170926,3906,3906,3905,3953,3905,3953,3933,47,27,74,436.61,544
,20170927,3953,3933,3946,3946,3924,3924,3938,-9,5,20,118.16,534
,20170928,3924,3938,3902,3902,3900,3900,3901,-38,-37,4,23.41,532
,20170929,3900,3901,3915,3915,3910,3910,3913,9,12,6,35.22,526
,20171009,3910,3913,3940,3940,3940,3940,3940,27,27,44,260.04,522
,20171010,3940,3940,3931,3931,3931,3931,3931,-9,-9,4,23.59,518
,20171011,3931,3931,,,,3931,3931,0,0,0,0.00,518
,20171012,3931,3931,,,,3931,3931,0,0,0,0.00,518
,20171013,3931,3931,3944,3944,3944,3944,3944,13,13,4,23.66,514
,20171016,3944,3944,3919,3975,3919,3975,3968,31,24,26,154.78,516
,20171017,3975,3968,3975,3975,3950,3950,3972,-18,4,18,107.25,514
,20171018,3950,3972,,,,3963,3963,-9,-9,0,0.00,514
,20171019,3963,3963,3925,3925,3925,3925,3925,-38,-38,2,11.78,512
,20171020,3925,3925,,,,3940,3940,15,15,0,0.00,512
,20171023,3940,3940,,,,3940,3940,0,0,0,0.00,512
,20171024,3940,3940,3929,3929,3929,3929,3929,-11,-11,2,11.79,512
,20171025,3929,3929,,,,3929,3929,0,0,0,0.00,512
,20171026,3929,3929,3921,3923,3921,3923,3922,-6,-7,12,70.61,502
,20171027,3923,3922,,,,3922,3922,0,0,0,0.00,502
,20171030,3922,3922,3880,3883,3873,3883,3879,-39,-43,8,46.56,502
,20171031,3883,3879,,,,3879,3879,0,0,0,0.00,502
,20171101,3879,3879,3878,3884,3878,3883,3881,4,2,8,46.58,498
,20171102,3883,3881,3892,3919,3892,3917,3912,36,31,100,586.91,430
,20171103,3917,3912,3923,3923,3923,3923,3923,11,11,2,11.77,430
,20171106,3923,3923,3891,3891,3891,3891,3891,-32,-32,2,11.67,430
,20171107,3891,3891,3926,3928,3926,3928,3927,37,36,12,70.70,438
,20171108,3928,3927,3930,3930,3918,3918,3927,-9,0,10,58.91,444
,20171109,3918,3927,3923,3923,3923,3923,3923,-4,-4,8,47.08,452
,20171110,3923,3923,3939,3939,3917,3929,3927,6,4,10,58.91,452
,20171113,3929,3927,3930,3930,3906,3915,3913,-12,-14,24,140.90,454
,20171114,3915,3913,3915,3915,3906,3906,3909,-7,-4,14,82.09,448
,20171115,3906,3909,3919,3923,3919,3923,3920,14,11,6,35.28,448
,20171116,3923,3920,,,,3920,3920,0,0,0,0.00,448
,20171117,3920,3920,3912,3920,3912,3912,3917,-8,-3,54,317.31,456
,20171120,3912,3917,3918,4025,3918,3935,3947,18,30,52,307.88,462
,20171121,3935,3947,3946,3946,3848,3910,3897,-37,-50,44,257.25,460
,20171122,3910,3897,3907,3907,3907,3907,3907,10,10,2,11.72,460
,20171123,3907,3907,3914,3915,3914,3915,3914,8,7,4,23.49,460
,20171124,3915,3914,3915,3916,3905,3915,3911,1,-3,34,199.47,442
,20171127,3915,3911,,,,3911,3911,0,0,0,0.00,442
,20171128,3911,3911,3923,3923,3913,3917,3917,6,6,6,35.26,444
,20171129,3917,3917,3882,3892,3882,3885,3885,-32,-32,12,69.94,444
,20171130,3885,3885,3872,3872,3821,3821,3849,-64,-36,46,265.62,438
,20171201,3821,3849,3785,3794,3781,3794,3785,-55,-64,18,102.20,434
,20171204,3794,3785,3771,3779,3738,3779,3764,-6,-21,36,203.27,448
,20171205,3779,3764,3780,3780,3769,3769,3773,5,9,22,124.54,440
,20171206,3769,3773,3760,3760,3718,3718,3747,-55,-26,8,44.97,440
,20171207,3718,3747,3714,3714,3669,3669,3691,-78,-56,10,55.37,440
,20171208,3669,3691,3655,3655,3639,3649,3645,-42,-46,54,295.29,454
,20171211,3649,3645,3664,3679,3660,3665,3666,20,21,28,154.00,454
,20171212,3665,3666,3666,3666,3654,3654,3661,-12,-5,50,274.61,452
,20171213,3654,3661,3655,3659,3655,3659,3656,-2,-5,6,32.91,456
,20171214,3659,3656,3647,3733,3647,3726,3711,70,55,74,411.95,462
,20171215,3726,3711,3714,3714,3689,3707,3705,-4,-6,82,455.74,496
,20171218,3707,3705,3720,3732,3720,3720,3723,15,18,110,614.37,540
,20171219,3720,3723,3714,3731,3713,3729,3721,6,-2,44,245.62,536
,20171220,3729,3721,3713,3733,3713,3729,3724,8,3,14,78.21,532
,20171221,3729,3724,3724,3726,3716,3719,3719,-5,-5,62,345.87,516
,20171222,3719,3719,3719,3720,3712,3717,3718,-2,-1,18,100.40,510
,20171225,3717,3718,3725,3765,3725,3758,3751,40,33,70,393.92,520
,20171226,3758,3751,3758,3762,3752,3762,3757,11,6,20,112.71,520
,20171227,3762,3757,3772,3780,3768,3770,3772,13,15,12,67.91,520
,20171228,3770,3772,3792,3853,3782,3808,3811,36,39,56,320.18,512
,20171229,3808,3811,3798,3813,3796,3807,3804,-4,-7,28,159.80,500
ag1803,20170316,4185,4185,4202,4319,4202,4296,4278,111,93,8,51.34,6
,20170317,4296,4278,4290,4302,4290,4302,4296,24,18,8,51.56,14
,20170320,4302,4296,4311,4315,4267,4315,4301,19,5,16,103.24,22
,20170321,4315,4301,4310,4310,4301,4306,4305,5,4,6,38.75,28
,20170322,4306,4305,4324,4339,4324,4339,4335,34,30,18,117.05,38
,20170323,4339,4335,,,,4335,4335,0,0,0,0.00,38
,20170324,4335,4335,4340,4340,4316,4318,4318,-17,-17,84,544.10,92
,20170327,4318,4318,4345,4345,4345,4345,4345,27,27,2,13.04,94
,20170328,4345,4345,4369,4370,4369,4370,4369,25,24,6,39.32,100
,20170329,4370,4369,4377,4378,4363,4363,4371,-6,2,10,65.57,102
,20170330,4363,4371,,,,4371,4371,0,0,0,0.00,102
,20170331,4371,4371,4354,4354,4354,4354,4354,-17,-17,6,39.19,102
,20170405,4354,4354,4403,4403,4363,4373,4372,19,18,34,223.02,124
,20170406,4373,4372,4371,4374,4366,4371,4370,-1,-2,20,131.10,120
,20170407,4371,4370,4361,4434,4361,4434,4387,64,17,32,210.61,134
,20170410,4434,4387,4430,4430,4282,4320,4358,-67,-29,46,300.72,152
,20170411,4320,4358,4315,4324,4300,4324,4315,-34,-43,14,90.62,154
,20170412,4324,4315,4329,4405,4329,4392,4383,77,68,20,131.51,154
,20170413,4392,4383,4391,4448,4391,4416,4423,33,40,12,79.62,158
,20170414,4416,4423,4415,4423,4415,4420,4419,-3,-4,38,251.88,184
,20170417,4420,4419,,,,4419,4419,0,0,0,0.00,184
,20170418,4419,4419,,,,4419,4419,0,0,0,0.00,184
,20170419,4419,4419,4396,4396,4368,4368,4386,-51,-33,6,39.48,186
,20170420,4368,4386,4361,4368,4356,4368,4361,-18,-25,6,39.26,186
,20170421,4368,4361,4349,4349,4324,4324,4335,-37,-26,16,104.06,184
,20170424,4324,4335,4310,4310,4302,4302,4306,-33,-29,6,38.75,182
,20170425,4302,4306,,,,4306,4306,0,0,0,0.00,182
,20170426,4306,4306,4298,4298,4288,4288,4290,-18,-16,8,51.49,184
,20170427,4288,4290,4272,4272,4272,4272,4272,-18,-18,4,25.63,186
,20170428,4272,4272,4272,4273,4263,4273,4269,1,-3,8,51.23,184
,20170502,4273,4269,,,,4254,4254,-15,-15,0,0.00,184
,20170503,4254,4254,4189,4205,4189,4194,4198,-60,-56,32,201.53,184
,20170504,4194,4198,4175,4175,4019,4107,4114,-91,-84,48,296.22,190
,20170505,4107,4114,4065,4082,4051,4082,4062,-32,-52,20,121.89,190
,20170508,4082,4062,4087,4099,4073,4081,4087,19,25,18,110.37,190
,20170509,4081,4087,,,,4087,4087,0,0,0,0.00,190
,20170510,4087,4087,4051,4051,4051,4051,4051,-36,-36,2,12.15,192
,20170511,4051,4051,,,,4051,4051,0,0,0,0.00,192
,20170512,4051,4051,4098,4101,4098,4101,4098,50,47,22,135.24,194
,20170515,4101,4098,4105,4105,4100,4100,4103,2,5,16,98.49,200
,20170516,4100,4103,4163,4163,4163,4163,4163,60,60,2,12.49,202
,20170517,4163,4163,4179,4179,4163,4163,4169,0,6,6,37.52,202
,20170518,4163,4169,4188,4188,4180,4187,4184,18,15,18,112.99,202
,20170519,4187,4184,,,,4179,4179,-5,-5,0,0.00,202
,20170522,4179,4179,4163,4168,4157,4157,4163,-22,-16,10,62.45,208
,20170523,4157,4163,4180,4185,4180,4185,4184,22,21,24,150.63,208
,20170524,4185,4184,,,,4184,4184,0,0,0,0.00,208
,20170525,4184,4184,4182,4182,4182,4182,4182,-2,-2,2,12.55,210
,20170526,4182,4182,,,,4182,4182,0,0,0,0.00,210
,20170531,4182,4182,,,,4182,4182,0,0,0,0.00,210
,20170601,4182,4182,4147,4148,4142,4148,4146,-34,-36,12,74.63,206
,20170602,4148,4146,4106,4106,4106,4106,4106,-40,-40,2,12.32,206
,20170605,4106,4106,,,,4106,4106,0,0,0,0.00,206
,20170606,4106,4106,4194,4194,4194,4194,4194,88,88,2,12.58,208
,20170607,4194,4194,4220,4223,4207,4207,4216,13,22,6,37.95,204
,20170608,4207,4216,,,,4216,4216,0,0,0,0.00,204
,20170609,4216,4216,,,,4216,4216,0,0,0,0.00,204
,20170612,4216,4216,4137,4137,4115,4119,4122,-97,-94,20,123.66,220
,20170613,4119,4122,4098,4098,4091,4095,4093,-27,-29,8,49.13,226
,20170614,4095,4093,4113,4113,4113,4113,4113,20,20,2,12.34,224
,20170615,4113,4113,4168,4168,4093,4093,4108,-20,-5,28,172.56,214
,20170616,4093,4108,,,,4108,4108,0,0,0,0.00,214
,20170619,4108,4108,,,,4108,4108,0,0,0,0.00,214
,20170620,4108,4108,,,,4108,4108,0,0,0,0.00,214
,20170621,4108,4108,,,,4105,4105,-3,-3,0,0.00,214
,20170622,4105,4105,,,,4105,4105,0,0,0,0.00,214
,20170623,4105,4105,,,,4105,4105,0,0,0,0.00,214
,20170626,4105,4105,,,,4105,4105,0,0,0,0.00,214
,20170627,4105,4105,4076,4076,4076,4076,4076,-29,-29,6,36.68,208
,20170628,4076,4076,4098,4098,4098,4098,4098,22,22,4,24.59,204
,20170629,4098,4098,,,,4098,4098,0,0,0,0.00,204
,20170630,4098,4098,4070,4070,4070,4070,4070,-28,-28,4,24.42,204
,20170703,4070,4070,4071,4071,4061,4061,4066,-9,-4,4,24.40,204
,20170704,4061,4066,3981,3981,3944,3944,3970,-122,-96,30,178.67,218
,20170705,3944,3970,3961,3961,3961,3961,3961,-9,-9,2,11.88,220
,20170706,3961,3961,3942,3942,3942,3942,3942,-19,-19,4,23.65,220
,20170707,3942,3942,3940,3940,3906,3909,3924,-33,-18,18,105.97,220
,20170710,3909,3924,,,,3801,3801,-123,-123,0,0.00,220
,20170711,3801,3801,3762,3784,3733,3774,3753,-27,-48,34,191.44,218
,20170712,3774,3753,3803,3864,3803,3864,3823,111,70,30,172.06,220
,20170713,3864,3823,3869,3879,3869,3879,3872,56,49,6,34.85,218
,20170714,3879,3872,3841,3841,3820,3820,3830,-52,-42,4,22.98,216
,20170717,3820,3830,3885,3895,3874,3895,3885,65,55,8,46.62,216
,20170718,3895,3885,3895,3911,3895,3899,3903,14,18,14,81.98,206
,20170719,3899,3903,3901,3909,3901,3909,3905,6,2,4,23.43,206
,20170720,3909,3905,3918,3918,3918,3918,3918,13,13,2,11.75,206
,20170721,3918,3918,,,,3918,3918,0,0,0,0.00,206
,20170724,3918,3918,,,,3918,3918,0,0,0,0.00,206
,20170725,3918,3918,3916,3916,3916,3916,3916,-2,-2,4,23.50,204
,20170726,3916,3916,,,,3916,3916,0,0,0,0.00,204
,20170727,3916,3916,3972,3972,3972,3972,3972,56,56,2,11.92,206
,20170728,3972,3972,,,,3972,3972,0,0,0,0.00,206
,20170731,3972,3972,3965,3965,3958,3958,3962,-14,-10,6,35.66,206
,20170801,3958,3962,,,,3962,3962,0,0,0,0.00,206
,20170802,3962,3962,,,,3962,3962,0,0,0,0.00,206
,20170803,3962,3962,,,,3962,3962,0,0,0,0.00,206
,20170804,3962,3962,,,,3962,3962,0,0,0,0.00,206
,20170807,3962,3962,3911,3911,3867,3867,3893,-95,-69,12,70.08,214
,20170808,3867,3893,3858,3858,3858,3858,3858,-35,-35,6,34.72,210
,20170809,3858,3858,3897,3899,3897,3899,3897,41,39,6,35.08,208
,20170810,3899,3897,3949,3971,3949,3971,3952,74,55,14,83.00,198
,20170811,3971,3952,4065,4065,4048,4055,4054,103,102,14,85.15,204
,20170814,4055,4054,4014,4050,4014,4050,4027,-4,-27,12,72.49,214
,20170815,4050,4027,4030,4030,4003,4003,4016,-24,-11,4,24.10,210
,20170816,4003,4016,3966,3966,3966,3966,3966,-50,-50,8,47.59,210
,20170817,3966,3966,,,,4009,4009,43,43,0,0.00,210
,20170818,4009,4009,,,,4009,4009,0,0,0,0.00,210
,20170821,4009,4009,,,,4009,4009,0,0,0,0.00,210
,20170822,4009,4009,,,,4009,4009,0,0,0,0.00,210
,20170823,4009,4009,4032,4032,4032,4032,4032,23,23,4,24.19,206
,20170824,4032,4032,,,,4032,4032,0,0,0,0.00,206
,20170825,4032,4032,4006,4006,4006,4006,4006,-26,-26,2,12.02,204
,20170828,4006,4006,,,,4006,4006,0,0,0,0.00,204
,20170829,4006,4006,,,,4020,4020,14,14,0,0.00,204
,20170830,4020,4020,,,,4020,4020,0,0,0,0.00,204
,20170831,4020,4020,4051,4055,4035,4035,4045,15,25,12,72.82,208
,20170901,4035,4045,4051,4051,4051,4051,4051,6,6,4,24.31,208
,20170904,4051,4051,4110,4110,4110,4110,4110,59,59,2,12.33,208
,20170905,4110,4110,,,,4110,4110,0,0,0,0.00,208
,20170906,4110,4110,4102,4102,4102,4102,4102,-8,-8,14,86.14,208
,20170907,4102,4102,,,,4102,4102,0,0,0,0.00,208
,20170908,4102,4102,4111,4111,4111,4111,4111,9,9,8,49.33,208
,20170911,4111,4111,,,,4095,4095,-16,-16,0,0.00,208
,20170912,4095,4095,4053,4055,4053,4055,4054,-40,-41,4,24.32,212
,20170913,4055,4054,4050,4052,4050,4052,4051,-2,-3,4,24.31,214
,20170914,4052,4051,4030,4030,4017,4017,4028,-34,-23,14,84.59,208
,20170915,4017,4028,4029,4029,4029,4029,4029,1,1,2,12.09,208
,20170918,4029,4029,4013,4014,4013,4014,4013,-15,-16,4,24.08,204
,20170919,4014,4013,3989,3993,3989,3993,3991,-20,-22,6,35.93,208
,20170920,3993,3991,3973,3982,3973,3982,3979,-9,-12,6,35.81,210
,20170921,3982,3979,3914,3919,3914,3919,3918,-60,-61,18,105.80,210
,20170922,3919,3918,3912,3924,3912,3924,3920,6,2,14,82.32,208
,20170925,3924,3920,3909,3915,3909,3915,3912,-5,-8,6,35.21,210
,20170926,3915,3912,,,,3926,3926,14,14,0,0.00,210
,20170927,3926,3926,3951,3951,3938,3938,3942,12,16,6,35.48,208
,20170928,3938,3942,3919,3919,3918,3918,3918,-24,-24,8,47.02,204
,20170929,3918,3918,,,,3918,3918,0,0,0,0.00,204
,20171009,3918,3918,3963,3963,3963,3963,3963,45,45,2,11.89,202
,20171010,3963,3963,,,,3963,3963,0,0,0,0.00,202
,20171011,3963,3963,,,,3963,3963,0,0,0,0.00,202
,20171012,3963,3963,3954,3997,3944,3960,3983,-3,20,80,477.97,256
,20171013,3960,3983,3960,3960,3960,3960,3960,-23,-23,24,142.56,256
,20171016,3960,3960,3975,3996,3975,3996,3989,36,29,6,35.90,252
,20171017,3996,3989,3993,3993,3952,3974,3971,-15,-18,10,59.57,248
,20171018,3974,3971,,,,3971,3971,0,0,0,0.00,248
,20171019,3971,3971,,,,3971,3971,0,0,0,0.00,248
,20171020,3971,3971,3966,3972,3966,3972,3968,1,-3,6,35.71,244
,20171023,3972,3968,3936,3946,3936,3946,3941,-22,-27,4,23.65,244
,20171024,3946,3941,3956,3979,3956,3956,3968,15,27,26,154.77,250
,20171025,3956,3968,3935,3936,3935,3936,3935,-32,-33,4,23.61,254
,20171026,3936,3935,3945,3945,3927,3943,3939,8,4,14,82.73,248
,20171027,3943,3939,,,,3939,3939,0,0,0,0.00,248
,20171030,3939,3939,3901,3908,3896,3908,3901,-31,-38,6,35.12,244
,20171031,3908,3901,,,,3901,3901,0,0,0,0.00,244
,20171101,3901,3901,3894,3894,3894,3894,3894,-7,-7,4,23.36,242
,20171102,3894,3894,3938,3938,3938,3938,3938,44,44,2,11.81,244
,20171103,3938,3938,,,,3938,3938,0,0,0,0.00,244
,20171106,3938,3938,,,,3938,3938,0,0,0,0.00,244
,20171107,3938,3938,3928,3972,3921,3948,3942,10,4,12,70.96,244
,20171108,3948,3942,3955,3955,3936,3937,3945,-5,3,26,153.88,256
,20171109,3937,3945,,,,3945,3945,0,0,0,0.00,256
,20171110,3945,3945,3948,3949,3945,3945,3946,0,1,18,106.55,260
,20171113,3945,3946,3949,3950,3924,3936,3947,-10,1,36,213.14,276
,20171114,3936,3947,3950,3950,3936,3936,3943,-11,-4,14,82.82,274
,20171115,3936,3943,,,,3943,3943,0,0,0,0.00,274
,20171116,3943,3943,,,,3943,3943,0,0,0,0.00,274
,20171117,3943,3943,,,,3943,3943,0,0,0,0.00,274
,20171120,3943,3943,3955,3955,3955,3955,3955,12,12,2,11.87,272
,20171121,3955,3955,3930,3930,3930,3930,3930,-25,-25,2,11.79,274
,20171122,3930,3930,3936,3936,3936,3936,3936,6,6,2,11.81,272
,20171123,3936,3936,3938,3940,3938,3940,3939,4,3,4,23.63,274
,20171124,3940,3939,,,,3939,3939,0,0,0,0.00,274
,20171127,3939,3939,3939,3942,3924,3928,3937,-11,-2,92,543.43,354
,20171128,3928,3937,3939,3945,3924,3924,3938,-13,1,22,129.98,364
,20171129,3924,3938,3941,3944,3895,3901,3931,-37,-7,98,577.94,424
,20171130,3901,3931,3880,3890,3835,3835,3855,-96,-76,34,196.65,446
,20171201,3835,3855,3826,3826,3804,3804,3812,-51,-43,22,125.81,458
,20171204,3804,3812,3794,3800,3762,3797,3784,-15,-28,130,738.03,502
,20171205,3797,3784,3789,3791,3780,3780,3787,-4,3,20,113.63,492
,20171206,3780,3787,3772,3782,3735,3781,3770,-6,-17,56,316.69,512
,20171207,3781,3770,3743,3743,3710,3710,3732,-60,-38,10,55.99,514
,20171208,3710,3732,3667,3695,3667,3671,3681,-61,-51,28,154.61,522
,20171211,3671,3681,3680,3700,3680,3700,3687,19,6,22,121.69,524
,20171212,3700,3687,3690,3690,3680,3680,3685,-7,-2,56,309.61,542
,20171213,3680,3685,3680,3681,3673,3681,3676,-4,-9,8,44.12,548
,20171214,3681,3676,3685,3750,3685,3750,3733,74,57,20,112.01,550
,20171215,3750,3733,3718,3718,3718,3718,3718,-15,-15,2,11.15,550
,20171218,3718,3718,3750,3754,3728,3739,3744,21,26,102,572.85,546
,20171219,3739,3744,3749,3753,3743,3743,3747,-1,3,22,123.65,540
,20171220,3743,3747,3738,3750,3738,3744,3748,-3,1,52,292.37,572
,20171221,3744,3748,3741,3741,3741,3741,3741,-7,-7,10,56.12,572
,20171222,3741,3741,3739,3739,3739,3739,3739,-2,-2,50,280.43,566
,20171225,3739,3739,3780,3783,3773,3773,3778,34,39,18,102.02,550
,20171226,3773,3778,3772,3783,3772,3783,3776,5,-2,18,101.97,552
,20171227,3783,3776,3799,3799,3790,3791,3793,15,17,6,34.14,550
,20171228,3791,3793,3817,3833,3807,3826,3822,33,29,32,183.48,548
,20171229,3826,3822,3814,3833,3810,3822,3823,0,1,66,378.50,504
ag1804,20170418,4419,4419,,,,4419,4419,0,0,0,0.00,0
,20170419,4419,4419,4392,4392,4389,4389,4390,-30,-29,4,26.34,2
,20170420,4389,4390,4387,4387,4359,4374,4371,-16,-19,18,118.04,12
,20170421,4374,4371,4351,4351,4333,4340,4343,-31,-28,8,52.12,16
,20170424,4340,4343,4310,4318,4310,4310,4312,-33,-31,10,64.69,16
,20170425,4310,4312,4318,4318,4318,4318,4318,6,6,2,12.95,16
,20170426,4318,4318,,,,4318,4318,0,0,0,0.00,16
,20170427,4318,4318,,,,4318,4318,0,0,0,0.00,16
,20170428,4318,4318,4288,4288,4283,4283,4284,-35,-34,6,38.56,16
,20170502,4283,4284,4200,4217,4200,4209,4212,-75,-72,12,75.82,16
,20170503,4209,4212,4205,4205,4205,4205,4205,-7,-7,4,25.23,16
,20170504,4205,4205,4190,4191,4079,4108,4156,-97,-49,62,386.57,34
,20170505,4108,4156,4075,4126,4075,4113,4095,-43,-61,46,282.56,56
,20170508,4113,4095,4112,4123,4093,4123,4099,28,4,18,110.69,48
,20170509,4123,4099,4096,4096,4089,4089,4091,-10,-8,8,49.10,50
,20170510,4089,4091,4080,4085,4070,4071,4077,-20,-14,22,134.55,50
,20170511,4071,4077,4095,4096,4095,4096,4095,19,18,4,24.57,52
,20170512,4096,4095,4112,4124,4112,4123,4119,28,24,6,37.08,56
,20170515,4123,4119,4154,4154,4154,4154,4154,35,35,4,24.92,60
,20170516,4154,4154,4180,4181,4161,4179,4175,25,21,16,100.21,58
,20170517,4179,4175,4194,4194,4180,4180,4185,5,10,6,37.67,58
,20170518,4180,4185,4197,4197,4197,4197,4197,12,12,2,12.59,60
,20170519,4197,4197,4165,4165,4150,4165,4159,-32,-38,10,62.39,58
,20170522,4165,4159,,,,4159,4159,0,0,0,0.00,58
,20170523,4159,4159,4193,4193,4193,4193,4193,34,34,2,12.58,60
,20170524,4193,4193,,,,4193,4193,0,0,0,0.00,60
,20170525,4193,4193,,,,4193,4193,0,0,0,0.00,60
,20170526,4193,4193,,,,4193,4193,0,0,0,0.00,60
,20170531,4193,4193,4119,4179,4119,4171,4164,-22,-29,20,124.94,70
,20170601,4171,4164,4161,4161,4155,4155,4158,-9,-6,12,74.86,72
,20170602,4155,4158,4138,4138,4138,4138,4138,-20,-20,2,12.41,74
,20170605,4138,4138,4198,4198,4196,4196,4197,58,59,4,25.18,74
,20170606,4196,4197,,,,4286,4286,89,89,0,0.00,74
,20170607,4286,4286,,,,4286,4286,0,0,0,0.00,74
,20170608,4286,4286,,,,4271,4271,-15,-15,0,0.00,74
,20170609,4271,4271,4177,4177,4166,4166,4171,-105,-100,4,25.03,76
,20170612,4166,4171,4157,4157,4130,4130,4143,-41,-28,12,74.58,82
,20170613,4130,4143,,,,4143,4143,0,0,0,0.00,82
,20170614,4143,4143,4100,4100,4100,4100,4100,-43,-43,2,12.30,82
,20170615,4100,4100,4183,4185,4121,4121,4162,21,62,14,87.41,84
,20170616,4121,4162,4101,4109,4101,4109,4105,-53,-57,4,24.63,86
,20170619,4109,4105,4100,4102,4095,4095,4099,-10,-6,8,49.19,92
,20170620,4095,4099,4129,4129,4129,4129,4129,30,30,4,24.77,96
,20170621,4129,4129,4068,4068,4068,4068,4068,-61,-61,2,12.20,96
,20170622,4068,4068,4073,4120,4073,4120,4088,52,20,6,36.80,98
,20170623,4120,4088,,,,4088,4088,0,0,0,0.00,98
,20170626,4088,4088,4140,4140,4123,4123,4135,35,47,14,86.85,108
,20170627,4123,4135,4093,4093,4093,4093,4093,-42,-42,2,12.28,106
,20170628,4093,4093,4109,4147,4109,4147,4128,54,35,28,173.42,110
,20170629,4147,4128,4126,4126,4123,4123,4124,-5,-4,10,61.87,112
,20170630,4123,4124,4099,4099,4095,4095,4097,-29,-27,4,24.58,110
,20170703,4095,4097,,,,4097,4097,0,0,0,0.00,110
,20170704,4097,4097,4039,4039,3996,3996,4017,-101,-80,4,24.11,108
,20170705,3996,4017,3981,3981,3980,3980,3980,-37,-37,14,83.59,114
,20170706,3980,3980,,,,3968,3968,-12,-12,0,0.00,114
,20170707,3968,3968,3944,3945,3930,3930,3939,-38,-29,12,70.92,118
,20170710,3930,3939,3747,3762,3747,3762,3754,-177,-185,4,22.53,118
,20170711,3762,3754,3782,3814,3748,3786,3776,32,22,62,351.18,118
,20170712,3786,3776,3852,3914,3852,3874,3876,98,100,10,58.15,120
,20170713,3874,3876,,,,3876,3876,0,0,0,0.00,120
,20170714,3876,3876,,,,3876,3876,0,0,0,0.00,120
,20170717,3876,3876,,,,3876,3876,0,0,0,0.00,120
,20170718,3876,3876,3940,3940,3940,3940,3940,64,64,2,11.82,120
,20170719,3940,3940,3924,3950,3924,3934,3936,-6,-4,10,59.05,122
,20170720,3934,3936,,,,3936,3936,0,0,0,0.00,122
,20170721,3936,3936,3953,3953,3953,3953,3953,17,17,2,11.86,120
,20170724,3953,3953,,,,3953,3953,0,0,0,0.00,120
,20170725,3953,3953,,,,3953,3953,0,0,0,0.00,120
,20170726,3953,3953,,,,3953,3953,0,0,0,0.00,120
,20170727,3953,3953,3986,3987,3986,3987,3986,34,33,4,23.92,118
,20170728,3987,3986,,,,3986,3986,0,0,0,0.00,118
,20170731,3986,3986,,,,3986,3986,0,0,0,0.00,118
,20170801,3986,3986,3992,3992,3992,3992,3992,6,6,10,59.88,108
,20170802,3992,3992,3992,3992,3992,3992,3992,0,0,4,23.95,112
,20170803,3992,3992,,,,3992,3992,0,0,0,0.00,112
,20170804,3992,3992,,,,3992,3992,0,0,0,0.00,112
,20170807,3992,3992,3899,3899,3899,3899,3899,-93,-93,4,23.39,108
,20170808,3899,3899,3879,3879,3879,3879,3879,-20,-20,2,11.64,108
,20170809,3879,3879,,,,3879,3879,0,0,0,0.00,108
,20170810,3879,3879,3957,3998,3957,3998,3977,119,98,4,23.87,110
,20170811,3998,3977,4102,4102,4045,4045,4086,68,109,26,159.36,126
,20170814,4045,4086,4050,4084,4050,4084,4067,-2,-19,4,24.40,130
,20170815,4084,4067,4039,4039,4039,4039,4039,-28,-28,2,12.12,130
,20170816,4039,4039,3978,3987,3978,3981,3983,-58,-56,18,107.54,130
,20170817,3981,3983,4078,4078,4078,4078,4078,95,95,8,48.94,130
,20170818,4078,4078,4070,4070,4051,4055,4056,-23,-22,8,48.68,132
,20170821,4055,4056,,,,4056,4056,0,0,0,0.00,132
,20170822,4056,4056,,,,4056,4056,0,0,0,0.00,132
,20170823,4056,4056,4059,4059,4025,4038,4036,-18,-20,8,48.44,136
,20170824,4038,4036,4041,4053,4041,4053,4047,17,11,4,24.28,138
,20170825,4053,4047,,,,4047,4047,0,0,0,0.00,138
,20170828,4047,4047,,,,4047,4047,0,0,0,0.00,138
,20170829,4047,4047,,,,4047,4047,0,0,0,0.00,138
,20170830,4047,4047,,,,4047,4047,0,0,0,0.00,138
,20170831,4047,4047,4062,4062,4062,4062,4062,15,15,4,24.37,134
,20170901,4062,4062,4077,4077,4077,4077,4077,15,15,2,12.23,132
,20170904,4077,4077,4134,4134,4134,4134,4134,57,57,2,12.40,132
,20170905,4134,4134,,,,4134,4134,0,0,0,0.00,132
,20170906,4134,4134,,,,4134,4134,0,0,0,0.00,132
,20170907,4134,4134,,,,4134,4134,0,0,0,0.00,132
,20170908,4134,4134,,,,4134,4134,0,0,0,0.00,132
,20170911,4134,4134,,,,4134,4134,0,0,0,0.00,132
,20170912,4134,4134,4060,4060,4060,4060,4060,-74,-74,6,36.54,126
,20170913,4060,4060,,,,4060,4060,0,0,0,0.00,126
,20170914,4060,4060,,,,4060,4060,0,0,0,0.00,126
,20170915,4060,4060,4070,4070,4070,4070,4070,10,10,4,24.42,126
,20170918,4070,4070,4034,4050,4034,4041,4040,-29,-30,20,121.22,122
,20170919,4041,4040,3988,3988,3988,3988,3988,-52,-52,2,11.96,120
,20170920,3988,3988,3995,3995,3995,3995,3995,7,7,2,11.99,118
,20170921,3995,3995,3995,3995,3995,3995,3995,0,0,2,11.99,120
,20170922,3995,3995,,,,3942,3942,-53,-53,0,0.00,120
,20170925,3942,3942,,,,3938,3938,-4,-4,0,0.00,120
,20170926,3938,3938,,,,3938,3938,0,0,0,0.00,120
,20170927,3938,3938,3953,3953,3953,3953,3953,15,15,2,11.86,120
,20170928,3953,3953,,,,3953,3953,0,0,0,0.00,120
,20170929,3953,3953,3939,3939,3939,3939,3939,-14,-14,4,23.63,116
,20171009,3939,3939,3978,3978,3978,3978,3978,39,39,2,11.93,114
,20171010,3978,3978,,,,3978,3978,0,0,0,0.00,114
,20171011,3978,3978,,,,3978,3978,0,0,0,0.00,114
,20171012,3978,3978,,,,3978,3978,0,0,0,0.00,114
,20171013,3978,3978,,,,3978,3978,0,0,0,0.00,114
,20171016,3978,3978,3991,4010,3991,4010,3995,32,17,20,119.85,118
,20171017,4010,3995,4013,4013,4013,4013,4013,18,18,6,36.12,112
,20171018,4013,4013,,,,4013,4013,0,0,0,0.00,112
,20171019,4013,4013,,,,4013,4013,0,0,0,0.00,112
,20171020,4013,4013,3956,4008,3956,4008,3982,-5,-31,4,23.89,112
,20171023,4008,3982,,,,3982,3982,0,0,0,0.00,112
,20171024,3982,3982,,,,3982,3982,0,0,0,0.00,112
,20171025,3982,3982,,,,3982,3982,0,0,0,0.00,112
,20171026,3982,3982,,,,3982,3982,0,0,0,0.00,112
,20171027,3982,3982,3920,3920,3920,3920,3920,-62,-62,6,35.28,106
,20171030,3920,3920,,,,3920,3920,0,0,0,0.00,106
,20171031,3920,3920,3910,3925,3910,3925,3917,5,-3,4,23.51,108
,20171101,3925,3917,3908,3908,3906,3906,3907,-11,-10,10,58.61,112
,20171102,3906,3907,3957,3957,3957,3957,3957,50,50,2,11.87,114
,20171103,3957,3957,,,,3957,3957,0,0,0,0.00,114
,20171106,3957,3957,3921,3921,3921,3921,3921,-36,-36,8,47.05,108
,20171107,3921,3921,,,,3921,3921,0,0,0,0.00,108
,20171108,3921,3921,3970,3970,3963,3963,3966,42,45,4,23.80,108
,20171109,3963,3966,3967,3974,3957,3974,3963,8,-3,8,47.57,112
,20171110,3974,3963,,,,3963,3963,0,0,0,0.00,112
,20171113,3963,3963,,,,3963,3963,0,0,0,0.00,112
,20171114,3963,3963,,,,3963,3963,0,0,0,0.00,112
,20171115,3963,3963,,,,3960,3960,-3,-3,0,0.00,112
,20171116,3960,3960,3965,3965,3965,3965,3965,5,5,6,35.69,112
,20171117,3965,3965,3963,3963,3950,3950,3956,-15,-9,4,23.74,110
,20171120,3950,3956,3975,3975,3975,3975,3975,19,19,4,23.85,106
,20171121,3975,3975,3950,3950,3950,3950,3950,-25,-25,2,11.85,106
,20171122,3950,3950,3946,3946,3945,3945,3945,-5,-5,4,23.67,104
,20171123,3945,3945,,,,3945,3945,0,0,0,0.00,104
,20171124,3945,3945,3952,3954,3952,3954,3952,9,7,10,59.29,114
,20171127,3954,3952,,,,3952,3952,0,0,0,0.00,114
,20171128,3952,3952,3955,3955,3955,3955,3955,3,3,2,11.87,114
,20171129,3955,3955,,,,3955,3955,0,0,0,0.00,114
,20171130,3955,3955,3901,3901,3858,3858,3872,-97,-83,6,34.85,116
,20171201,3858,3872,3825,3825,3825,3825,3825,-47,-47,6,34.43,118
,20171204,3825,3825,3797,3857,3797,3857,3817,32,-8,6,34.35,120
,20171205,3857,3817,3814,3815,3809,3810,3812,-7,-5,16,91.49,114
,20171206,3810,3812,3785,3785,3785,3785,3785,-27,-27,2,11.36,112
,20171207,3785,3785,3755,3755,3717,3755,3742,-30,-43,6,33.68,116
,20171208,3755,3742,3682,3682,3681,3682,3681,-60,-61,8,44.18,110
,20171211,3682,3681,3709,3709,3709,3709,3709,28,28,2,11.13,110
,20171212,3709,3709,,,,3709,3709,0,0,0,0.00,110
,20171213,3709,3709,,,,3709,3709,0,0,0,0.00,110
,20171214,3709,3709,3769,3769,3769,3769,3769,60,60,2,11.31,110
,20171215,3769,3769,3746,3746,3746,3746,3746,-23,-23,2,11.24,112
,20171218,3746,3746,3760,3776,3760,3776,3770,30,24,6,33.94,112
,20171219,3776,3770,,,,3770,3770,0,0,0,0.00,112
,20171220,3770,3770,,,,3770,3770,0,0,0,0.00,112
,20171221,3770,3770,3776,3776,3761,3761,3767,-9,-3,26,146.94,116
,20171222,3761,3767,3761,3763,3752,3757,3758,-10,-9,22,124.03,124
,20171225,3757,3758,3757,3770,3757,3770,3765,12,7,8,45.19,128
,20171226,3770,3765,3793,3793,3793,3793,3793,28,28,2,11.38,126
,20171227,3793,3793,3817,3817,3817,3817,3817,24,24,2,11.45,126
,20171228,3817,3817,3840,3852,3840,3852,3844,35,27,6,34.60,126
,20171229,3852,3844,3836,3853,3836,3845,3841,1,-3,10,57.62,126
ag1805,20170516,4154,4154,4175,4186,4175,4186,4180,32,26,4,25.08,2
,20170517,4186,4180,4201,4201,4201,4201,4201,21,21,2,12.60,4
,20170518,4201,4201,4220,4220,4182,4182,4201,-19,0,4,25.21,8
,20170519,4182,4201,4152,4152,4152,4152,4152,-49,-49,2,12.46,10
,20170522,4152,4152,4190,4199,4190,4199,4196,47,44,6,37.76,16
,20170523,4199,4196,4206,4206,4206,4206,4206,10,10,2,12.62,16
,20170524,4206,4206,4210,4210,4210,4210,4210,4,4,2,12.63,16
,20170525,4210,4210,4214,4220,4208,4208,4214,-2,4,10,63.22,24
,20170526,4208,4214,4185,4234,4147,4148,4199,-66,-15,22,138.58,32
,20170531,4148,4199,4210,4210,4200,4200,4202,1,3,16,100.86,44
,20170601,4200,4202,,,,4202,4202,0,0,0,0.00,44
,20170602,4202,4202,4148,4148,4148,4148,4148,-54,-54,2,12.44,42
,20170605,4148,4148,4182,4228,4182,4228,4214,80,66,8,50.57,42
,20170606,4228,4214,4231,4231,4169,4226,4215,12,1,10,63.23,42
,20170607,4226,4215,4247,4260,4247,4253,4255,38,40,8,51.06,44
,20170608,4253,4255,4243,4243,4243,4243,4243,-12,-12,2,12.73,44
,20170609,4243,4243,4191,4191,4191,4191,4191,-52,-52,4,25.15,44
,20170612,4191,4191,4158,4158,4153,4153,4156,-38,-35,8,49.88,50
,20170613,4153,4156,4139,4139,4122,4128,4126,-28,-30,26,160.93,58
,20170614,4128,4126,4120,4148,4120,4148,4138,22,12,6,37.25,58
,20170615,4148,4138,4194,4194,4117,4138,4155,0,17,16,99.73,58
,20170616,4138,4155,4116,4161,4093,4093,4123,-62,-32,18,111.33,66
,20170619,4093,4123,4123,4123,4109,4114,4116,-9,-7,12,74.09,70
,20170620,4114,4116,,,,4116,4116,0,0,0,0.00,70
,20170621,4116,4116,4088,4094,4079,4094,4089,-22,-27,10,61.34,72
,20170622,4094,4089,4083,4142,4083,4139,4115,50,26,18,111.11,68
,20170623,4139,4115,4127,4127,4127,4127,4127,12,12,2,12.38,70
,20170626,4127,4127,4139,4139,4139,4139,4139,12,12,2,12.42,72
,20170627,4139,4139,4119,4119,4119,4119,4119,-20,-20,4,24.71,74
,20170628,4119,4119,,,,4119,4119,0,0,0,0.00,74
,20170629,4119,4119,4141,4156,4137,4156,4143,37,24,14,87.01,86
,20170630,4156,4143,4114,4120,4102,4102,4112,-41,-31,10,61.69,88
,20170703,4102,4112,4096,4096,4096,4096,4096,-16,-16,2,12.29,90
,20170704,4096,4096,4058,4058,3990,3990,4022,-106,-74,12,72.41,100
,20170705,3990,4022,3974,4022,3974,4009,3997,-13,-25,16,95.95,100
,20170706,4009,3997,,,,3990,3990,-7,-7,0,0.00,100
,20170707,3990,3990,3982,3985,3940,3940,3973,-50,-17,34,202.64,116
,20170710,3940,3973,3922,3922,3800,3800,3828,-173,-145,24,137.82,132
,20170711,3800,3828,3820,3850,3774,3835,3810,7,-18,38,217.20,134
,20170712,3835,3810,3828,3896,3828,3896,3861,86,51,14,81.09,130
,20170713,3896,3861,,,,3861,3861,0,0,0,0.00,130
,20170714,3861,3861,3903,3903,3839,3873,3870,12,9,16,92.90,122
,20170717,3873,3870,3931,3931,3931,3931,3931,61,61,2,11.79,120
,20170718,3931,3931,3958,3963,3939,3963,3949,32,18,12,71.09,122
,20170719,3963,3949,3946,3946,3946,3946,3946,-3,-3,2,11.84,120
,20170720,3946,3946,3957,3957,3957,3957,3957,11,11,2,11.87,118
,20170721,3957,3957,3963,3963,3963,3963,3963,6,6,2,11.89,116
,20170724,3963,3963,,,,3963,3963,0,0,0,0.00,116
,20170725,3963,3963,3970,3982,3967,3967,3973,4,10,6,35.76,118
,20170726,3967,3973,3927,3927,3927,3927,3927,-46,-46,2,11.78,118
,20170727,3927,3927,4000,4013,4000,4013,4008,86,81,8,48.10,122
,20170728,4013,4008,4016,4016,3981,3981,3993,-27,-15,6,35.94,118
,20170731,3981,3993,,,,3993,3993,0,0,0,0.00,118
,20170801,3993,3993,4013,4014,4013,4014,4013,21,20,8,48.17,120
,20170802,4014,4013,4004,4004,4004,4004,4004,-9,-9,4,24.02,116
,20170803,4004,4004,,,,3980,3980,-24,-24,0,0.00,116
,20170804,3980,3980,3986,3986,3986,3986,3986,6,6,2,11.96,114
,20170807,3986,3986,3921,3921,3921,3921,3921,-65,-65,2,11.76,114
,20170808,3921,3921,,,,3921,3921,0,0,0,0.00,114
,20170809,3921,3921,,,,3921,3921,0,0,0,0.00,114
,20170810,3921,3921,,,,3921,3921,0,0,0,0.00,114
,20170811,3921,3921,4097,4097,4065,4065,4080,144,159,28,171.39,110
,20170814,4065,4080,,,,4080,4080,0,0,0,0.00,110
,20170815,4080,4080,,,,4080,4080,0,0,0,0.00,110
,20170816,4080,4080,,,,4059,4059,-21,-21,0,0.00,110
,20170817,4059,4059,4012,4105,3992,4105,4020,46,-39,22,132.67,106
,20170818,4105,4020,4098,4098,4082,4082,4090,62,70,4,24.54,104
,20170821,4082,4090,4111,4111,4108,4108,4109,18,19,4,24.66,102
,20170822,4108,4109,4067,4067,4060,4060,4063,-49,-46,4,24.38,106
,20170823,4060,4063,,,,4063,4063,0,0,0,0.00,106
,20170824,4063,4063,4095,4095,4059,4059,4068,-4,5,10,61.02,110
,20170825,4059,4068,,,,4068,4068,0,0,0,0.00,110
,20170828,4068,4068,4075,4075,4062,4067,4066,-1,-2,10,61.00,114
,20170829,4067,4066,4088,4109,4088,4109,4097,43,31,8,49.17,110
,20170830,4109,4097,4129,4129,4114,4114,4121,17,24,4,24.73,108
,20170831,4114,4121,4079,4079,4079,4079,4079,-42,-42,2,12.24,108
,20170901,4079,4079,,,,4079,4079,0,0,0,0.00,108
,20170904,4079,4079,4140,4156,4140,4156,4148,77,69,4,24.89,104
,20170905,4156,4148,4133,4146,4132,4146,4138,-2,-10,22,136.58,108
,20170906,4146,4138,,,,4138,4138,0,0,0,0.00,108
,20170907,4138,4138,4140,4140,4136,4136,4139,-2,1,8,49.67,102
,20170908,4136,4139,,,,4139,4139,0,0,0,0.00,102
,20170911,4139,4139,,,,4139,4139,0,0,0,0.00,102
,20170912,4139,4139,,,,4139,4139,0,0,0,0.00,102
,20170913,4139,4139,,,,4139,4139,0,0,0,0.00,102
,20170914,4139,4139,,,,4139,4139,0,0,0,0.00,102
,20170915,4139,4139,4073,4075,4073,4075,4074,-64,-65,4,24.44,106
,20170918,4075,4074,4033,4057,4033,4051,4047,-23,-27,6,36.42,104
,20170919,4051,4047,,,,4047,4047,0,0,0,0.00,104
,20170920,4047,4047,4012,4012,4012,4012,4012,-35,-35,2,12.04,106
,20170921,4012,4012,,,,4012,4012,0,0,0,0.00,106
,20170922,4012,4012,3960,3960,3952,3953,3957,-59,-55,16,94.97,110
,20170925,3953,3957,,,,3957,3957,0,0,0,0.00,110
,20170926,3957,3957,,,,3957,3957,0,0,0,0.00,110
,20170927,3957,3957,,,,3957,3957,0,0,0,0.00,110
,20170928,3957,3957,3948,3948,3937,3937,3939,-20,-18,10,59.09,106
,20170929,3937,3939,,,,3939,3939,0,0,0,0.00,106
,20171009,3939,3939,3989,3989,3989,3989,3989,50,50,8,47.87,102
,20171010,3989,3989,,,,3989,3989,0,0,0,0.00,102
,20171011,3989,3989,3996,3996,3996,3996,3996,7,7,2,11.99,100
,20171012,3996,3996,3988,3998,3985,3998,3992,2,-4,8,47.90,102
,20171013,3998,3992,3991,4025,3991,4025,4008,33,16,4,24.05,106
,20171016,4025,4008,4009,4064,4009,4064,4043,56,35,16,97.05,112
,20171017,4064,4043,4050,4050,4001,4012,4024,-31,-19,18,108.67,114
,20171018,4012,4024,4002,4002,4002,4002,4002,-22,-22,2,12.01,114
,20171019,4002,4002,3992,3992,3982,3984,3987,-18,-15,8,47.85,118
,20171020,3984,3987,3983,4046,3983,4046,3998,59,11,16,95.97,132
,20171023,4046,3998,3982,3982,3972,3972,3977,-26,-21,4,23.86,132
,20171024,3972,3977,3975,4032,3968,4000,3990,23,13,16,95.76,136
,20171025,4000,3990,,,,3990,3990,0,0,0,0.00,136
,20171026,3990,3990,3978,4026,3978,3983,4009,-7,19,16,96.22,140
,20171027,3983,4009,3989,3989,3924,3924,3941,-85,-68,102,602.98,202
,20171030,3924,3941,3929,3943,3918,3929,3928,-12,-13,28,165.00,216
,20171031,3929,3928,3929,3929,3929,3929,3929,1,1,2,11.79,216
,20171101,3929,3929,3923,3928,3923,3923,3926,-6,-3,10,58.89,214
,20171102,3923,3926,3941,3980,3941,3970,3966,44,40,44,261.79,216
,20171103,3970,3966,3982,3997,3976,3980,3985,14,19,60,358.68,220
,20171106,3980,3985,3983,3985,3943,3961,3963,-24,-22,62,368.64,226
,20171107,3961,3963,3875,3993,3875,3979,3966,16,3,44,261.81,220
,20171108,3979,3966,3956,3995,3955,3979,3972,13,6,10,59.59,226
,20171109,3979,3972,3979,3991,3979,3990,3984,18,12,18,107.58,228
,20171110,3990,3984,3969,3998,3969,3990,3992,6,8,96,574.97,312
,20171113,3990,3992,4000,4003,3961,3971,3985,-21,-7,146,872.86,324
,20171114,3971,3985,3972,3997,3943,3962,3969,-23,-16,50,297.68,318
,20171115,3962,3969,3964,3973,3964,3966,3969,-3,0,8,47.63,318
,20171116,3966,3969,3979,3979,3962,3963,3973,-6,4,18,107.28,318
,20171117,3963,3973,3980,3982,3974,3974,3979,1,6,12,71.63,320
,20171120,3974,3979,3970,3999,3969,3986,3981,7,2,92,549.51,316
,20171121,3986,3981,3987,4000,3960,3960,3981,-21,0,12,71.67,314
,20171122,3960,3981,3961,3974,3961,3966,3967,-15,-14,16,95.23,308
,20171123,3966,3967,3970,3979,3968,3968,3972,1,5,14,83.42,308
,20171124,3968,3972,3970,3975,3922,3970,3965,-2,-7,94,559.19,366
,20171127,3970,3965,3968,3968,3949,3960,3957,-5,-8,38,225.56,362
,20171128,3960,3957,3969,3977,3960,3966,3967,9,10,46,273.74,370
,20171129,3966,3967,3972,3972,3931,3932,3945,-35,-22,86,509.02,352
,20171130,3932,3945,3927,3933,3844,3884,3898,-61,-47,92,538.04,372
,20171201,3884,3898,3842,3876,3836,3842,3851,-56,-47,66,381.29,384
,20171204,3842,3851,3859,3867,3800,3833,3830,-18,-21,128,735.52,422
,20171205,3833,3830,3835,3841,3825,3838,3831,8,1,32,183.93,406
,20171206,3838,3831,3802,3812,3770,3779,3785,-52,-46,66,374.75,426
,20171207,3779,3785,3782,3782,3751,3754,3761,-31,-24,56,315.98,436
,20171208,3754,3761,3709,3724,3696,3707,3713,-54,-48,504,"2,807.31",878
,20171211,3707,3713,3728,3742,3683,3709,3714,-4,1,582,"3,242.48",490
,20171212,3709,3714,3733,3733,3713,3727,3718,13,4,84,468.56,484
,20171213,3727,3718,3711,3718,3699,3710,3708,-8,-10,94,522.87,512
,20171214,3710,3708,3706,3791,3706,3788,3756,80,48,130,732.43,524
,20171215,3788,3756,3788,3788,3722,3764,3768,8,12,32,180.89,516
,20171218,3764,3768,3776,3788,3773,3779,3779,11,11,92,521.63,524
,20171219,3779,3779,3792,3798,3774,3790,3786,11,7,102,579.31,516
,20171220,3790,3786,3781,3788,3773,3780,3778,-6,-8,462,"2,618.33",554
,20171221,3780,3778,3784,3792,3776,3776,3785,-2,7,144,817.65,538
,20171222,3776,3785,3773,3792,3768,3774,3775,-11,-10,148,838.24,526
,20171225,3774,3775,3775,3821,3775,3813,3810,38,35,176,"1,005.94",540
,20171226,3813,3810,3813,3830,3810,3821,3817,11,7,108,618.36,546
,20171227,3821,3817,3828,3857,3828,3856,3854,39,37,644,"3,723.52",1128
,20171228,3856,3854,3853,3877,3819,3874,3851,20,-3,798,"4,610.30",518
,20171229,3874,3851,3874,3874,3851,3862,3864,11,13,88,510.09,526
ag1806,20170616,4155,4155,4132,4156,4128,4147,4142,-8,-13,248,"1,540.85",90
,20170619,4147,4142,4145,4150,4130,4133,4140,-9,-2,194,"1,204.84",182
,20170620,4133,4140,4137,4140,4119,4135,4129,-5,-11,192,"1,189.41",276
,20170621,4135,4129,4112,4126,4105,4121,4115,-8,-14,206,"1,271.79",384
,20170622,4121,4115,4112,4179,4111,4155,4136,40,21,418,"2,593.73",460
,20170623,4155,4136,4165,4166,4148,4166,4156,30,20,230,"1,434.15",516
,20170626,4166,4156,4175,4176,4156,4163,4163,7,7,186,"1,161.62",554
,20170627,4163,4163,4140,4148,4126,4148,4135,-15,-28,300,"1,861.19",570
,20170628,4148,4135,4068,4178,4068,4167,4152,32,17,1068,"6,651.55",898
,20170629,4167,4152,4162,4171,4158,4170,4163,18,11,492,"3,073.00",1104
,20170630,4170,4163,4136,4142,4119,4124,4129,-39,-34,546,"3,382.00",1178
,20170703,4124,4129,4124,4133,4109,4118,4121,-11,-8,334,"2,065.01",1334
,20170704,4118,4121,4098,4098,3996,4012,4038,-109,-83,2060,"12,477.98",1982
,20170705,4012,4038,4001,4031,3986,4010,4011,-28,-27,760,"4,573.54",2092
,20170706,4010,4011,3992,4013,3972,3994,3991,-17,-20,912,"5,459.75",2394
,20170707,3994,3991,3994,4007,3953,3976,3975,-15,-16,1798,"10,722.71",2816
,20170710,3976,3975,3974,3974,3776,3776,3859,-199,-116,8830,"51,113.10",4692
,20170711,3776,3859,3783,3875,3777,3844,3832,-15,-27,5018,"28,850.02",5470
,20170712,3844,3832,3860,3934,3850,3897,3890,65,58,3340,"19,489.98",5314
,20170713,3897,3890,3921,3949,3918,3925,3930,35,40,2272,"13,395.07",5622
,20170714,3925,3930,3923,3923,3855,3875,3879,-55,-51,2540,"14,780.29",5980
,20170717,3875,3879,3930,3970,3930,3951,3948,72,69,2658,"15,743.49",6232
,20170718,3951,3948,3972,3984,3944,3955,3971,7,23,2368,"14,107.20",6514
,20170719,3955,3971,3984,3984,3952,3965,3963,-6,-8,2070,"12,307.74",6986
,20170720,3965,3963,3979,3980,3948,3957,3961,-6,-2,2614,"15,531.11",7102
,20170721,3957,3961,3967,3997,3953,3986,3978,25,17,2104,"12,554.72",7316
,20170724,3986,3978,4004,4014,3978,3984,3992,6,14,2544,"15,233.58",7312
,20170725,3984,3992,4002,4002,3978,3991,3988,-1,-4,2124,"12,708.86",7330
,20170726,3991,3988,3982,4007,3954,3963,3977,-25,-11,3268,"19,498.98",7306
,20170727,3963,3977,3960,4030,3960,4017,4007,40,30,2394,"14,390.64",7598
,20170728,4017,4007,4032,4033,3999,4005,4012,-2,5,1662,"10,004.19",7418
,20170731,4005,4012,4017,4030,4010,4017,4019,5,7,1102,"6,644.15",7476
,20170801,4017,4019,4030,4041,4021,4028,4030,9,11,1190,"7,195.28",7552
,20170802,4028,4030,4011,4035,4011,4021,4020,-9,-10,2132,"12,859.11",7682
,20170803,4021,4020,4002,4030,3993,3993,4006,-27,-14,1516,"9,110.53",7788
,20170804,3993,4006,4001,4021,3998,4015,4006,9,0,1888,"11,346.68",7566
,20170807,4015,4006,3996,3996,3922,3928,3948,-78,-58,4212,"24,949.74",8422
,20170808,3928,3948,3925,3939,3840,3920,3921,-28,-27,3638,"21,400.68",8930
,20170809,3920,3921,3940,3977,3916,3971,3953,50,32,4256,"25,241.96",9472
,20170810,3971,3953,4010,4089,4010,4079,4044,126,91,5718,"34,689.78",9286
,20170811,4079,4044,4118,4130,4073,4083,4099,39,55,6200,"38,127.24",9284
,20170814,4083,4099,4068,4134,4055,4120,4097,21,-2,4104,"25,224.63",9858
,20170815,4120,4097,4086,4108,4042,4054,4070,-43,-27,5892,"35,977.70",10632
,20170816,4054,4070,4030,4032,4005,4012,4018,-58,-52,4126,"24,872.15",11626
,20170817,4012,4018,4025,4123,4012,4111,4084,93,66,7924,"48,547.72",11828
,20170818,4111,4084,4100,4116,4076,4095,4092,11,8,4818,"29,576.92",12258
,20170821,4095,4092,4119,4148,4052,4080,4092,-12,0,9626,"59,090.82",13116
,20170822,4080,4092,4091,4107,4072,4078,4088,-14,-4,5156,"31,620.67",14438
,20170823,4078,4088,4097,4102,4063,4076,4077,-12,-11,7890,"48,257.15",16418
,20170824,4076,4077,4081,4095,4072,4074,4081,-3,4,4272,"26,153.01",16530
,20170825,4074,4081,4069,4080,4057,4074,4069,-7,-12,3654,"22,304.46",17024
,20170828,4074,4069,4070,4104,4013,4096,4073,27,4,9680,"59,150.41",17642
,20170829,4096,4073,4092,4142,4084,4137,4121,64,48,7898,"48,822.18",17920
,20170830,4137,4121,4158,4158,3992,4103,4120,-18,-1,7722,"47,724.77",17492
,20170831,4103,4120,4105,4116,4090,4099,4101,-21,-19,4240,"26,086.08",17260
,20170901,4099,4101,4100,4132,4100,4114,4115,13,14,4274,"26,385.04",17986
,20170904,4114,4115,4115,4184,4115,4174,4151,59,36,16116,"100,351.99",22554
,20170905,4174,4151,4156,4174,4154,4166,4164,15,13,6480,"40,480.78",23502
,20170906,4166,4164,4174,4182,4148,4161,4165,-3,1,11290,"70,537.14",24862
,20170907,4161,4165,4169,4169,4131,4140,4149,-25,-16,9672,"60,195.71",24678
,20170908,4140,4149,4168,4174,4145,4160,4161,11,12,16590,"103,566.09",28006
,20170911,4160,4161,4155,4155,4100,4100,4122,-61,-39,13374,"82,707.49",28644
,20170912,4100,4122,4098,4120,4092,4096,4105,-26,-17,6136,"37,790.49",29142
,20170913,4096,4105,4101,4115,4092,4094,4102,-11,-3,5012,"30,845.64",29382
,20170914,4094,4102,4099,4101,4075,4083,4085,-19,-17,8776,"53,777.16",30296
,20170915,4083,4085,4089,4106,4083,4085,4094,0,9,6060,"37,217.05",30472
,20170918,4085,4094,4083,4090,4068,4076,4076,-18,-18,7592,"46,426.40",30580
,20170919,4076,4076,4057,4057,4002,4024,4031,-52,-45,14120,"85,387.28",33442
,20170920,4024,4031,4024,4039,4023,4033,4031,2,0,5398,"32,643.88",34452
,20170921,4033,4031,4028,4049,3978,3979,4006,-52,-25,13944,"83,796.84",36702
,20170922,3979,4006,3969,3984,3961,3974,3973,-32,-33,9952,"59,317.32",37978
,20170925,3974,3973,3971,3980,3963,3969,3971,-4,-2,5692,"33,909.33",38706
,20170926,3969,3971,3970,4041,3968,4025,4014,54,43,12268,"73,867.63",39104
,20170927,4025,4014,4005,4008,3982,3992,3996,-22,-18,11146,"66,810.62",41098
,20170928,3992,3996,3980,3990,3960,3969,3973,-27,-23,7554,"45,026.85",40300
,20170929,3969,3973,3972,3986,3970,3983,3979,10,6,7516,"44,867.13",40416
,20171009,3983,3979,3988,4029,3982,4006,4014,27,35,8276,"49,834.61",41900
,20171010,4006,4014,4011,4019,4000,4010,4008,-4,-6,11220,"67,467.94",47016
,20171011,4010,4008,4024,4024,3999,4005,4012,-3,4,15560,"93,655.69",55144
,20171012,4005,4012,4009,4028,3992,4013,4010,1,-2,10362,"62,336.18",55056
,20171013,4013,4010,4002,4037,4002,4027,4020,17,10,10996,"66,309.08",57698
,20171016,4027,4020,4035,4053,4026,4051,4035,31,15,14086,"85,263.39",58778
,20171017,4051,4035,4053,4064,4011,4021,4035,-14,0,20458,"123,826.82",59812
,20171018,4021,4035,4020,4027,4008,4012,4016,-23,-19,13930,"83,914.96",61602
,20171019,4012,4016,4006,4012,3992,3998,4001,-18,-15,16310,"97,901.35",62762
,20171020,3998,4001,3998,4030,3996,4015,4017,14,16,19090,"115,037.67",63004
,20171023,4015,4017,4015,4023,3960,3991,3999,-26,-18,26010,"156,047.78",67860
,20171024,3991,3999,3990,4010,3978,4003,3996,4,-3,16210,"97,167.14",70820
,20171025,4003,3996,3996,3999,3981,3982,3987,-14,-9,22406,"134,028.10",79616
,20171026,3982,3987,3985,4002,3982,3995,3995,8,8,20316,"121,762.84",86728
,20171027,3995,3995,3990,4000,3800,3933,3953,-62,-42,59992,"355,799.16",100998
,20171030,3933,3953,3920,3960,3914,3941,3939,-12,-14,49778,"294,122.11",111998
,20171031,3941,3939,3936,3957,3930,3957,3948,18,9,34374,"203,564.20",120658
,20171101,3957,3948,3945,3960,3925,3955,3941,7,-7,73810,"436,359.02",143750
,20171102,3955,3941,3955,3994,3948,3990,3981,49,40,98180,"586,302.03",165108
,20171103,3990,3981,3990,4005,3983,3992,3994,11,13,59544,"356,810.98",172456
,20171106,3992,3994,4000,4010,3952,3965,3969,-29,-25,124174,"739,437.74",189926
,20171107,3965,3969,3967,4012,3964,4001,3992,32,23,112982,"676,679.62",206062
,20171108,4001,3992,3990,4008,3981,3990,3992,-2,0,79016,"473,159.46",208514
,20171109,3990,3992,3997,4011,3988,4002,3998,10,6,80176,"480,868.45",216628
,20171110,4002,3998,4004,4015,3988,3999,3998,1,0,95648,"573,700.88",232716
,20171113,3999,3998,4000,4008,3969,3981,3985,-17,-13,108600,"649,248.72",238344
,20171114,3981,3985,3983,3998,3971,3985,3986,0,1,78316,"468,327.88",244306
,20171115,3985,3986,3981,3998,3971,3985,3985,-1,-1,107238,"641,057.36",255098
,20171116,3985,3985,3995,4005,3980,3983,3991,-2,6,148792,"890,777.60",256914
,20171117,3983,3991,3988,3997,3985,3992,3991,1,0,92008,"550,846.59",272090
,20171120,3992,3991,3989,4029,3981,4010,4004,19,13,180866,"1,086,298.53",305346
,20171121,4010,4004,4010,4016,3975,3988,3991,-16,-13,249286,"1,492,566.62",323800
,20171122,3988,3991,3984,3995,3979,3985,3987,-6,-4,174516,"1,043,715.80",348610
,20171123,3985,3987,3985,3998,3983,3986,3991,-1,4,221842,"1,328,102.77",370020
,20171124,3986,3991,3988,4001,3983,3991,3991,0,0,186428,"1,116,297.35",399512
,20171127,3991,3991,3984,3994,3971,3984,3983,-7,-8,270676,"1,617,173.45",415322
,20171128,3984,3983,3990,4007,3980,3986,3990,3,7,369614,"2,212,525.55",447112
,20171129,3986,3990,3991,3993,3921,3956,3963,-34,-27,423802,"2,519,604.17",489300
,20171130,3956,3963,3951,3956,3873,3886,3915,-77,-48,470624,"2,764,218.54",537918
,20171201,3886,3915,3882,3884,3848,3862,3864,-53,-51,334126,"1,937,076.65",548544
,20171204,3862,3864,3845,3881,3815,3852,3847,-12,-17,603718,"3,483,991.14",561400
,20171205,3852,3847,3847,3857,3837,3840,3846,-7,-1,230912,"1,332,274.66",575932
,20171206,3840,3846,3835,3839,3788,3800,3806,-46,-40,460078,"2,626,587.68",596850
,20171207,3800,3806,3792,3800,3743,3756,3775,-50,-31,453546,"2,568,329.33",623120
,20171208,3756,3775,3729,3737,3712,3728,3725,-47,-50,370598,"2,071,021.43",626514
,20171211,3728,3725,3736,3753,3705,3744,3736,19,11,391586,"2,194,971.39",628010
,20171212,3744,3736,3746,3748,3725,3733,3733,-3,-3,243070,"1,361,333.91",653788
,20171213,3733,3733,3731,3738,3711,3725,3723,-8,-10,275892,"1,540,930.82",662334
,20171214,3725,3723,3723,3809,3720,3799,3770,76,47,520858,"2,945,691.23",656088
,20171215,3799,3770,3794,3801,3770,3781,3781,11,11,340010,"1,928,757.76",679098
,20171218,3781,3781,3791,3811,3787,3800,3800,19,19,389294,"2,219,102.37",672416
,20171219,3800,3800,3805,3816,3790,3806,3804,6,4,285846,"1,631,418.25",660232
,20171220,3806,3804,3807,3811,3793,3800,3800,-4,-4,212204,"1,209,852.69",658594
,20171221,3800,3800,3809,3812,3795,3797,3803,-3,3,223472,"1,275,003.80",647940
,20171222,3797,3803,3792,3809,3783,3797,3796,-6,-7,255662,"1,455,819.12",644278
,20171225,3797,3796,3798,3848,3793,3841,3828,45,32,432896,"2,486,053.21",639118
,20171226,3841,3828,3842,3847,3831,3844,3839,16,11,141256,"813,549.95",636776
,20171227,3844,3839,3850,3863,3848,3858,3855,19,16,210978,"1,220,005.00",627406
,20171228,3858,3855,3870,3901,3866,3891,3881,36,26,280708,"1,634,415.01",619308
,20171229,3891,3881,3886,3898,3869,3883,3885,2,4,257368,"1,499,848.16",596822
ag1807,20170718,3948,3948,,,,3948,3948,0,0,0,0.00,0
,20170719,3948,3948,,,,3948,3948,0,0,0,0.00,0
,20170720,3948,3948,3976,3976,3976,3976,3976,28,28,2,11.93,2
,20170721,3976,3976,,,,3993,3993,17,17,0,0.00,2
,20170724,3993,3993,4010,4010,4010,4010,4010,17,17,2,12.03,4
,20170725,4010,4010,,,,4010,4010,0,0,0,0.00,4
,20170726,4010,4010,,,,3999,3999,-11,-11,0,0.00,4
,20170727,3999,3999,3996,3996,3996,3996,3996,-3,-3,2,11.99,6
,20170728,3996,3996,4022,4030,4022,4030,4026,34,30,4,24.16,8
,20170731,4030,4026,,,,4026,4026,0,0,0,0.00,8
,20170801,4026,4026,,,,4026,4026,0,0,0,0.00,8
,20170802,4026,4026,,,,4026,4026,0,0,0,0.00,8
,20170803,4026,4026,,,,4018,4018,-8,-8,0,0.00,8
,20170804,4018,4018,,,,4018,4018,0,0,0,0.00,8
,20170807,4018,4018,4002,4002,3950,3956,3977,-62,-41,8,47.72,12
,20170808,3956,3977,3936,3936,3936,3936,3936,-41,-41,2,11.81,14
,20170809,3936,3936,3958,3977,3921,3977,3941,41,5,22,130.05,26
,20170810,3977,3941,4020,4080,4020,4080,4042,139,101,16,97.02,32
,20170811,4080,4042,4110,4120,4090,4090,4104,48,62,28,172.40,30
,20170814,4090,4104,4101,4128,4084,4084,4100,-20,-4,8,49.20,28
,20170815,4084,4100,4119,4119,4071,4071,4104,-29,4,8,49.26,32
,20170816,4071,4104,4030,4037,4021,4035,4030,-69,-74,8,48.37,32
,20170817,4035,4030,4055,4128,4055,4120,4083,90,53,16,98.01,34
,20170818,4120,4083,4095,4097,4095,4097,4096,14,13,4,24.58,30
,20170821,4097,4096,4132,4132,4115,4115,4124,19,28,6,37.12,30
,20170822,4115,4124,,,,4124,4124,0,0,0,0.00,30
,20170823,4124,4124,4080,4080,4080,4080,4080,-44,-44,2,12.24,28
,20170824,4080,4080,,,,4087,4087,7,7,0,0.00,28
,20170825,4087,4087,,,,4087,4087,0,0,0,0.00,28
,20170828,4087,4087,4116,4116,4108,4108,4112,21,25,4,24.67,30
,20170829,4108,4112,4132,4132,4132,4132,4132,20,20,2,12.40,28
,20170830,4132,4132,4131,4131,4131,4131,4131,-1,-1,2,12.39,28
,20170831,4131,4131,,,,4114,4114,-17,-17,0,0.00,28
,20170901,4114,4114,4132,4135,4129,4134,4132,20,18,8,49.59,30
,20170904,4134,4132,4178,4188,4177,4188,4181,56,49,6,37.63,32
,20170905,4188,4181,,,,4181,4181,0,0,0,0.00,32
,20170906,4181,4181,,,,4181,4181,0,0,0,0.00,32
,20170907,4181,4181,,,,4181,4181,0,0,0,0.00,32
,20170908,4181,4181,,,,4181,4181,0,0,0,0.00,32
,20170911,4181,4181,,,,4181,4181,0,0,0,0.00,32
,20170912,4181,4181,,,,4181,4181,0,0,0,0.00,32
,20170913,4181,4181,,,,4181,4181,0,0,0,0.00,32
,20170914,4181,4181,,,,4170,4170,-11,-11,0,0.00,32
,20170915,4170,4170,,,,4170,4170,0,0,0,0.00,32
,20170918,4170,4170,4088,4088,4088,4088,4088,-82,-82,2,12.26,32
,20170919,4088,4088,,,,4088,4088,0,0,0,0.00,32
,20170920,4088,4088,,,,4088,4088,0,0,0,0.00,32
,20170921,4088,4088,4020,4020,3984,3984,4002,-104,-86,4,24.01,34
,20170922,3984,4002,3990,3997,3972,3991,3989,-11,-13,10,59.84,36
,20170925,3991,3989,,,,3989,3989,0,0,0,0.00,36
,20170926,3989,3989,3983,3983,3983,3983,3983,-6,-6,6,35.85,42
,20170927,3983,3983,4011,4015,4010,4015,4011,32,28,8,48.14,48
,20170928,4015,4011,3990,3990,3990,3990,3990,-21,-21,2,11.97,48
,20170929,3990,3990,,,,3990,3990,0,0,0,0.00,48
,20171009,3990,3990,,,,3990,3990,0,0,0,0.00,48
,20171010,3990,3990,4019,4019,4017,4017,4018,27,28,4,24.11,48
,20171011,4017,4018,,,,4018,4018,0,0,0,0.00,48
,20171012,4018,4018,4021,4021,4018,4020,4019,2,1,6,36.18,48
,20171013,4020,4019,,,,4019,4019,0,0,0,0.00,48
,20171016,4019,4019,4039,4040,4015,4040,4031,21,12,6,36.28,50
,20171017,4040,4031,4034,4034,4034,4034,4034,3,3,2,12.10,48
,20171018,4034,4034,4030,4030,4030,4030,4030,-4,-4,2,12.09,48
,20171019,4030,4030,4019,4019,4019,4019,4019,-11,-11,2,12.06,48
,20171020,4019,4019,4016,4029,4016,4029,4022,10,3,4,24.14,48
,20171023,4029,4022,,,,4022,4022,0,0,0,0.00,48
,20171024,4022,4022,,,,4022,4022,0,0,0,0.00,48
,20171025,4022,4022,4045,4045,4000,4000,4022,-22,0,4,24.14,48
,20171026,4000,4022,4006,4007,4006,4007,4006,-15,-16,4,24.04,50
,20171027,4007,4006,,,,3964,3964,-42,-42,0,0.00,50
,20171030,3964,3964,,,,3964,3964,0,0,0,0.00,50
,20171031,3964,3964,,,,3964,3964,0,0,0,0.00,50
,20171101,3964,3964,,,,3964,3964,0,0,0,0.00,50
,20171102,3964,3964,,,,3964,3964,0,0,0,0.00,50
,20171103,3964,3964,,,,3964,3964,0,0,0,0.00,50
,20171106,3964,3964,4008,4008,3987,3987,3991,23,27,10,59.87,54
,20171107,3987,3991,3990,4010,3990,4005,4004,14,13,12,72.07,54
,20171108,4005,4004,4009,4009,4005,4005,4007,1,3,4,24.04,54
,20171109,4005,4007,,,,4007,4007,0,0,0,0.00,54
,20171110,4007,4007,4012,4012,4012,4012,4012,5,5,2,12.04,54
,20171113,4012,4012,4023,4023,4023,4023,4023,11,11,2,12.07,52
,20171114,4023,4023,,,,4023,4023,0,0,0,0.00,52
,20171115,4023,4023,,,,4023,4023,0,0,0,0.00,52
,20171116,4023,4023,,,,4023,4023,0,0,0,0.00,52
,20171117,4023,4023,,,,4023,4023,0,0,0,0.00,52
,20171120,4023,4023,,,,4023,4023,0,0,0,0.00,52
,20171121,4023,4023,,,,4023,4023,0,0,0,0.00,52
,20171122,4023,4023,4020,4020,4003,4009,4014,-14,-9,14,84.30,52
,20171123,4009,4014,4015,4029,4011,4011,4028,-3,14,282,"1,703.88",322
,20171124,4011,4028,4008,4018,3995,4018,4004,-10,-24,56,336.35,312
,20171127,4018,4004,4009,4010,4004,4004,4007,0,3,6,36.07,310
,20171128,4004,4007,4029,4029,4008,4008,4014,1,7,14,84.29,320
,20171129,4008,4014,3995,3995,3995,3995,3995,-19,-19,30,179.78,320
,20171130,3995,3995,3912,3928,3912,3913,3925,-82,-70,34,200.19,320
,20171201,3913,3925,3896,3896,3893,3893,3894,-32,-31,4,23.37,322
,20171204,3893,3894,3881,3890,3881,3890,3882,-4,-12,12,69.89,326
,20171205,3890,3882,,,,3882,3882,0,0,0,0.00,326
,20171206,3882,3882,3822,3838,3808,3838,3820,-44,-62,10,57.30,330
,20171207,3838,3820,3795,3795,3795,3795,3795,-25,-25,2,11.39,328
,20171208,3795,3795,3739,3751,3722,3749,3737,-46,-58,48,269.12,318
,20171211,3749,3737,,,,3761,3761,24,24,0,0.00,318
,20171212,3761,3761,3762,3766,3757,3765,3760,4,-1,22,124.08,318
,20171213,3765,3760,,,,3760,3760,0,0,0,0.00,318
,20171214,3760,3760,3801,3829,3801,3829,3812,69,52,18,102.92,310
,20171215,3829,3812,3805,3805,3805,3805,3805,-7,-7,2,11.42,312
,20171218,3805,3805,3840,3840,3805,3805,3822,0,17,4,22.94,312
,20171219,3805,3822,,,,3822,3822,0,0,0,0.00,312
,20171220,3822,3822,,,,3822,3822,0,0,0,0.00,312
,20171221,3822,3822,3820,3820,3820,3820,3820,-2,-2,18,103.14,296
,20171222,3820,3820,3816,3816,3816,3816,3816,-4,-4,2,11.45,294
,20171225,3816,3816,,,,3822,3822,6,6,0,0.00,294
,20171226,3822,3822,3862,3862,3862,3862,3862,40,40,4,23.17,294
,20171227,3862,3862,3885,3885,3885,3885,3885,23,23,2,11.66,292
,20171228,3885,3885,3898,3916,3898,3916,3907,31,22,4,23.44,292
,20171229,3916,3907,,,,3907,3907,0,0,0,0.00,292
ag1808,20170816,4104,4104,4032,4032,4032,4032,4032,-72,-72,2,12.10,2
,20170817,4032,4032,,,,4032,4032,0,0,0,0.00,2
,20170818,4032,4032,,,,4032,4032,0,0,0,0.00,2
,20170821,4032,4032,,,,4032,4032,0,0,0,0.00,2
,20170822,4032,4032,,,,4032,4032,0,0,0,0.00,2
,20170823,4032,4032,,,,4032,4032,0,0,0,0.00,2
,20170824,4032,4032,,,,4032,4032,0,0,0,0.00,2
,20170825,4032,4032,,,,4032,4032,0,0,0,0.00,2
,20170828,4032,4032,4102,4103,4100,4103,4101,71,69,10,61.52,10
,20170829,4103,4101,,,,4101,4101,0,0,0,0.00,10
,20170830,4101,4101,4156,4191,4130,4140,4148,39,47,22,136.91,20
,20170831,4140,4148,,,,4148,4148,0,0,0,0.00,20
,20170901,4148,4148,4138,4138,4138,4138,4138,-10,-10,2,12.41,22
,20170904,4138,4138,4170,4224,4170,4206,4196,68,58,18,113.31,26
,20170905,4206,4196,,,,4196,4196,0,0,0,0.00,26
,20170906,4196,4196,4187,4187,4187,4187,4187,-9,-9,2,12.56,24
,20170907,4187,4187,4175,4175,4175,4175,4175,-12,-12,4,25.05,28
,20170908,4175,4175,4183,4194,4172,4172,4188,-3,13,46,289.03,48
,20170911,4172,4188,4174,4174,4139,4146,4154,-42,-34,12,74.78,52
,20170912,4146,4154,4133,4171,4121,4132,4139,-22,-15,36,223.53,66
,20170913,4132,4139,,,,4139,4139,0,0,0,0.00,66
,20170914,4139,4139,4120,4120,4113,4113,4114,-26,-25,32,197.48,48
,20170915,4113,4114,4118,4119,4118,4119,4118,5,4,4,24.71,50
,20170918,4119,4118,,,,4118,4118,0,0,0,0.00,50
,20170919,4118,4118,4079,4079,4077,4077,4078,-41,-40,4,24.47,50
,20170920,4077,4078,,,,4078,4078,0,0,0,0.00,50
,20170921,4078,4078,4057,4073,4020,4020,4051,-58,-27,18,109.40,52
,20170922,4020,4051,3999,4003,3999,4003,4001,-48,-50,4,24.01,52
,20170925,4003,4001,,,,4001,4001,0,0,0,0.00,52
,20170926,4001,4001,4004,4060,4004,4060,4032,59,31,4,24.19,54
,20170927,4060,4032,4035,4035,4031,4031,4033,-1,1,4,24.20,54
,20170928,4031,4033,,,,4033,4033,0,0,0,0.00,54
,20170929,4033,4033,,,,4033,4033,0,0,0,0.00,54
,20171009,4033,4033,,,,4033,4033,0,0,0,0.00,54
,20171010,4033,4033,4042,4042,4039,4041,4040,8,7,10,60.61,60
,20171011,4041,4040,4054,4054,4051,4051,4053,11,13,8,48.64,62
,20171012,4051,4053,4043,4043,4043,4043,4043,-10,-10,2,12.13,62
,20171013,4043,4043,,,,4043,4043,0,0,0,0.00,62
,20171016,4043,4043,4065,4071,4058,4063,4065,20,22,10,60.98,62
,20171017,4063,4065,4081,4081,4081,4081,4081,16,16,2,12.24,64
,20171018,4081,4081,4053,4053,4053,4053,4053,-28,-28,2,12.16,62
,20171019,4053,4053,4033,4033,4033,4033,4033,-20,-20,2,12.10,62
,20171020,4033,4033,4040,4068,4040,4050,4051,17,18,14,85.07,64
,20171023,4050,4051,4040,4040,4040,4040,4040,-11,-11,2,12.12,64
,20171024,4040,4040,4017,4017,4017,4017,4017,-23,-23,2,12.05,64
,20171025,4017,4017,4025,4025,4025,4025,4025,8,8,2,12.08,62
,20171026,4025,4025,,,,4025,4025,0,0,0,0.00,62
,20171027,4025,4025,4003,4003,4003,4003,4003,-22,-22,2,12.01,64
,20171030,4003,4003,3959,3960,3959,3960,3959,-43,-44,6,35.63,60
,20171031,3960,3959,,,,3959,3959,0,0,0,0.00,60
,20171101,3959,3959,3975,3994,3949,3994,3972,35,13,6,35.75,64
,20171102,3994,3972,4046,4046,4016,4018,4028,46,56,8,48.34,64
,20171103,4018,4028,4035,4035,4030,4030,4032,2,4,4,24.20,64
,20171106,4030,4032,4003,4003,4003,4003,4003,-29,-29,2,12.01,66
,20171107,4003,4003,4008,4028,4008,4027,4019,24,16,10,60.30,64
,20171108,4027,4019,4033,4033,4022,4022,4027,3,8,4,24.17,64
,20171109,4022,4027,,,,4027,4027,0,0,0,0.00,64
,20171110,4027,4027,4044,4052,4044,4052,4048,25,21,4,24.29,62
,20171113,4052,4048,4034,4034,4034,4034,4034,-14,-14,2,12.10,64
,20171114,4034,4034,,,,4034,4034,0,0,0,0.00,64
,20171115,4034,4034,,,,4034,4034,0,0,0,0.00,64
,20171116,4034,4034,,,,4034,4034,0,0,0,0.00,64
,20171117,4034,4034,,,,4034,4034,0,0,0,0.00,64
,20171120,4034,4034,4025,4025,4022,4022,4023,-12,-11,8,48.28,56
,20171121,4022,4023,4034,4035,4034,4035,4034,12,11,6,36.31,62
,20171122,4035,4034,4026,4029,4023,4023,4026,-11,-8,6,36.23,66
,20171123,4023,4026,4030,4030,4030,4030,4030,4,4,2,12.09,68
,20171124,4030,4030,4022,4022,4022,4022,4022,-8,-8,2,12.07,66
,20171127,4022,4022,4027,4027,4027,4027,4027,5,5,4,24.16,68
,20171128,4027,4027,4039,4045,4039,4045,4040,18,13,22,133.35,72
,20171129,4045,4040,4030,4040,4002,4002,4033,-38,-7,26,157.30,96
,20171130,4002,4033,3999,3999,3999,3999,3999,-34,-34,2,12.00,98
,20171201,3999,3999,3930,3939,3905,3930,3918,-69,-81,24,141.05,116
,20171204,3930,3918,3917,3917,3879,3890,3895,-28,-23,58,338.90,120
,20171205,3890,3895,3902,3902,3891,3893,3897,-2,2,22,128.62,110
,20171206,3893,3897,3861,3861,3854,3854,3857,-43,-40,4,23.15,110
,20171207,3854,3857,,,,3857,3857,0,0,0,0.00,110
,20171208,3857,3857,3762,3779,3754,3771,3762,-86,-95,18,101.59,106
,20171211,3771,3762,,,,3785,3785,23,23,0,0.00,106
,20171212,3785,3785,3778,3778,3778,3778,3778,-7,-7,2,11.33,104
,20171213,3778,3778,3772,3772,3772,3772,3772,-6,-6,4,22.63,100
,20171214,3772,3772,3783,3842,3783,3841,3806,69,34,10,57.10,94
,20171215,3841,3806,3841,3841,3841,3841,3841,35,35,2,11.52,94
,20171218,3841,3841,,,,3841,3841,0,0,0,0.00,94
,20171219,3841,3841,,,,3841,3841,0,0,0,0.00,94
,20171220,3841,3841,3845,3845,3845,3845,3845,4,4,2,11.54,96
,20171221,3845,3845,,,,3845,3845,0,0,0,0.00,96
,20171222,3845,3845,3841,3847,3837,3837,3842,-8,-3,76,438.05,98
,20171225,3837,3842,3843,3906,3843,3899,3889,57,47,22,128.35,98
,20171226,3899,3889,3898,3900,3889,3889,3895,0,6,6,35.06,102
,20171227,3889,3895,3899,3904,3899,3904,3902,9,7,6,35.12,102
,20171228,3904,3902,3933,3944,3933,3944,3939,42,37,8,47.27,104
,20171229,3944,3939,3937,3937,3937,3937,3937,-2,-2,2,11.81,104
ag1809,20170918,4118,4118,4117,4119,4117,4119,4118,1,0,4,24.71,4
,20170919,4119,4118,,,,4118,4118,0,0,0,0.00,4
,20170920,4118,4118,,,,4118,4118,0,0,0,0.00,4
,20170921,4118,4118,4075,4075,4040,4040,4057,-78,-61,4,24.35,8
,20170922,4040,4057,4020,4020,4008,4008,4013,-49,-44,6,36.12,10
,20170925,4008,4013,,,,4013,4013,0,0,0,0.00,10
,20170926,4013,4013,4060,4060,4060,4060,4060,47,47,6,36.54,10
,20170927,4060,4060,4051,4051,4011,4011,4041,-49,-19,42,254.61,44
,20170928,4011,4041,4022,4022,4009,4009,4013,-32,-28,12,72.24,42
,20170929,4009,4013,4014,4020,3979,4018,3994,5,-19,32,191.74,34
,20171009,4018,3994,4058,4058,4050,4050,4054,56,60,6,36.49,38
,20171010,4050,4054,4044,4047,4040,4040,4043,-14,-11,10,60.65,40
,20171011,4040,4043,4061,4061,4052,4052,4056,9,13,12,73.02,44
,20171012,4052,4056,4056,4056,4056,4056,4056,0,0,2,12.17,44
,20171013,4056,4056,4061,4061,4061,4061,4061,5,5,2,12.18,44
,20171016,4061,4061,4073,4085,4069,4085,4076,24,15,8,48.92,44
,20171017,4085,4076,4062,4072,4062,4072,4065,-4,-11,6,36.59,38
,20171018,4072,4065,4064,4065,4059,4061,4061,-4,-4,12,73.11,48
,20171019,4061,4061,4041,4041,4041,4041,4041,-20,-20,4,24.25,52
,20171020,4041,4041,4063,4063,4063,4063,4063,22,22,2,12.19,50
,20171023,4063,4063,,,,4063,4063,0,0,0,0.00,50
,20171024,4063,4063,4025,4054,4025,4053,4037,-10,-26,16,96.90,58
,20171025,4053,4037,4030,4037,4030,4037,4035,0,-2,8,48.42,62
,20171026,4037,4035,4029,4038,4029,4038,4033,3,-2,4,24.20,60
,20171027,4038,4033,4041,4041,3989,3989,4020,-44,-13,14,84.42,62
,20171030,3989,4020,3985,4002,3977,3995,3987,-25,-33,16,95.71,72
,20171031,3995,3987,3997,4000,3990,4000,3995,13,8,6,35.96,74
,20171101,4000,3995,3985,4026,3985,4013,4010,18,15,36,216.58,96
,20171102,4013,4010,4009,4058,4009,4058,4036,48,26,26,157.43,90
,20171103,4058,4036,4055,4066,4044,4054,4054,18,18,36,218.95,94
,20171106,4054,4054,4058,4061,3985,4025,4028,-29,-26,58,350.47,100
,20171107,4025,4028,4051,4051,4050,4050,4050,22,22,8,48.61,96
,20171108,4050,4050,4039,4039,4039,4039,4039,-11,-11,2,12.12,94
,20171109,4039,4039,4053,4054,4053,4054,4053,15,14,4,24.32,94
,20171110,4054,4053,,,,4053,4053,0,0,0,0.00,94
,20171113,4053,4053,,,,4053,4053,0,0,0,0.00,94
,20171114,4053,4053,4049,4049,4016,4016,4032,-37,-21,18,108.87,90
,20171115,4016,4032,4038,4038,4038,4038,4038,6,6,2,12.11,90
,20171116,4038,4038,4058,4058,4058,4058,4058,20,20,2,12.17,90
,20171117,4058,4058,4042,4042,4042,4042,4042,-16,-16,6,36.38,88
,20171120,4042,4042,4069,4072,4065,4068,4068,26,26,10,61.03,92
,20171121,4068,4068,4075,4075,4037,4051,4059,-17,-9,46,280.11,104
,20171122,4051,4059,4056,4058,4052,4058,4054,-1,-5,8,48.66,112
,20171123,4058,4054,4062,4095,4046,4046,4067,-8,13,26,158.62,120
,20171124,4046,4067,4059,4074,4053,4074,4059,7,-8,32,194.88,116
,20171127,4074,4059,4052,4054,4052,4052,4052,-7,-7,22,133.73,134
,20171128,4052,4052,4044,4044,4044,4044,4044,-8,-8,2,12.13,134
,20171129,4044,4044,4060,4063,4020,4024,4033,-20,-11,56,338.82,154
,20171130,4024,4033,4014,4022,3960,3964,3984,-69,-49,58,346.64,162
,20171201,3964,3984,3948,3960,3925,3940,3943,-44,-41,58,343.06,186
,20171204,3940,3943,3941,3973,3900,3911,3917,-32,-26,226,"1,328.18",264
,20171205,3911,3917,3920,3920,3908,3908,3915,-9,-2,22,129.23,260
,20171206,3908,3915,3905,3908,3866,3877,3895,-38,-20,92,537.57,264
,20171207,3877,3895,3870,3870,3805,3823,3851,-72,-44,66,381.26,278
,20171208,3823,3851,3823,3823,3791,3809,3803,-42,-48,56,319.50,302
,20171211,3809,3803,3810,3828,3806,3817,3814,14,11,76,434.82,310
,20171212,3817,3814,3830,3830,3801,3808,3813,-6,-1,46,263.12,330
,20171213,3808,3813,3818,3822,3793,3805,3805,-8,-8,114,650.73,326
,20171214,3805,3805,3803,3883,3799,3876,3840,71,35,284,"1,636.04",378
,20171215,3876,3840,3872,3877,3850,3857,3860,17,20,108,625.33,380
,20171218,3857,3860,3867,3884,3864,3869,3874,9,14,126,732.26,378
,20171219,3869,3874,3866,3889,3866,3889,3877,15,3,90,523.42,372
,20171220,3889,3877,3867,3873,3863,3870,3868,-7,-9,30,174.06,370
,20171221,3870,3868,3871,3879,3864,3876,3874,8,6,70,406.85,390
,20171222,3876,3874,3862,3866,3858,3864,3862,-10,-12,22,127.46,390
,20171225,3864,3862,3872,3918,3872,3908,3908,46,46,76,445.60,392
,20171226,3908,3908,3903,3920,3900,3920,3911,12,3,58,340.34,396
,20171227,3920,3911,3930,3930,3922,3925,3925,14,14,22,129.54,396
,20171228,3925,3925,3940,3961,3940,3961,3949,36,24,24,142.19,398
,20171229,3961,3949,3849,3960,3849,3954,3949,5,0,28,165.89,392
ag1810,20171017,4076,4076,4100,4100,4100,4100,4100,24,24,2,12.30,2
,20171018,4100,4100,,,,4100,4100,0,0,0,0.00,2
,20171019,4100,4100,4067,4067,4057,4057,4063,-43,-37,8,48.76,6
,20171020,4057,4063,,,,4063,4063,0,0,0,0.00,6
,20171023,4063,4063,4052,4052,4046,4046,4049,-17,-14,4,24.29,8
,20171024,4046,4049,,,,4049,4049,0,0,0,0.00,8
,20171025,4049,4049,,,,4049,4049,0,0,0,0.00,8
,20171026,4049,4049,,,,4049,4049,0,0,0,0.00,8
,20171027,4049,4049,4036,4036,4036,4036,4036,-13,-13,2,12.11,8
,20171030,4036,4036,,,,4036,4036,0,0,0,0.00,8
,20171031,4036,4036,4022,4022,4022,4022,4022,-14,-14,2,12.07,10
,20171101,4022,4022,,,,4022,4022,0,0,0,0.00,10
,20171102,4022,4022,,,,4022,4022,0,0,0,0.00,10
,20171103,4022,4022,,,,4022,4022,0,0,0,0.00,10
,20171106,4022,4022,,,,4022,4022,0,0,0,0.00,10
,20171107,4022,4022,4102,4102,4102,4102,4102,80,80,4,24.61,14
,20171108,4102,4102,,,,4102,4102,0,0,0,0.00,14
,20171109,4102,4102,,,,4102,4102,0,0,0,0.00,14
,20171110,4102,4102,4115,4115,4070,4072,4089,-30,-13,14,85.88,16
,20171113,4072,4089,4060,4060,4060,4060,4060,-29,-29,2,12.18,16
,20171114,4060,4060,4058,4065,4058,4065,4059,5,-1,36,219.20,52
,20171115,4065,4059,4065,4065,4065,4065,4065,6,6,2,12.20,54
,20171116,4065,4065,,,,4065,4065,0,0,0,0.00,54
,20171117,4065,4065,,,,4065,4065,0,0,0,0.00,54
,20171120,4065,4065,,,,4065,4065,0,0,0,0.00,54
,20171121,4065,4065,4086,4086,4065,4072,4071,7,6,20,122.15,66
,20171122,4072,4071,,,,4071,4071,0,0,0,0.00,66
,20171123,4071,4071,4074,4080,4063,4063,4069,-8,-2,20,122.09,56
,20171124,4063,4069,4070,4072,4070,4072,4071,3,2,6,36.64,54
,20171127,4072,4071,4066,4067,4057,4067,4064,-4,-7,16,97.54,54
,20171128,4067,4064,4083,4083,4082,4082,4082,18,18,4,24.50,52
,20171129,4082,4082,,,,4082,4082,0,0,0,0.00,52
,20171130,4082,4082,4011,4026,3982,3985,4005,-97,-77,10,60.08,56
,20171201,3985,4005,,,,4005,4005,0,0,0,0.00,56
,20171204,4005,4005,3924,3977,3902,3960,3949,-45,-56,34,201.44,68
,20171205,3960,3949,3934,3940,3934,3940,3937,-9,-12,4,23.62,66
,20171206,3940,3937,3926,3926,3888,3905,3905,-32,-32,48,281.18,94
,20171207,3905,3905,3900,3900,3844,3844,3879,-61,-26,22,128.01,94
,20171208,3844,3879,3826,3829,3826,3829,3827,-50,-52,16,91.87,98
,20171211,3829,3827,3830,3851,3830,3851,3845,24,18,8,46.14,96
,20171212,3851,3845,3846,3853,3845,3845,3846,0,1,10,57.70,90
,20171213,3845,3846,,,,3846,3846,0,0,0,0.00,90
,20171214,3846,3846,3825,3930,3825,3903,3900,57,54,44,257.43,106
,20171215,3903,3900,3890,3890,3890,3890,3890,-10,-10,2,11.67,108
,20171218,3890,3890,3896,3908,3896,3901,3904,11,14,22,128.86,116
,20171219,3901,3904,3900,3904,3900,3904,3900,0,-4,10,58.51,118
,20171220,3904,3900,3892,3892,3892,3892,3892,-8,-8,2,11.68,120
,20171221,3892,3892,,,,3892,3892,0,0,0,0.00,120
,20171222,3892,3892,3880,3880,3879,3879,3879,-13,-13,6,34.91,124
,20171225,3879,3879,3896,3909,3896,3909,3898,30,19,14,81.86,128
,20171226,3909,3898,3928,3928,3926,3926,3927,28,29,4,23.56,132
,20171227,3926,3927,3946,3950,3909,3909,3940,-18,13,12,70.93,140
,20171228,3909,3940,3959,3985,3959,3985,3974,45,34,20,119.22,144
,20171229,3985,3974,3982,3982,3971,3971,3974,-3,0,6,35.77,144
ag1811,20171116,4065,4065,,,,4065,4065,0,0,0,0.00,0
,20171117,4065,4065,,,,4065,4065,0,0,0,0.00,0
,20171120,4065,4065,,,,4065,4065,0,0,0,0.00,0
,20171121,4065,4065,4085,4090,4085,4090,4087,25,22,4,24.53,4
,20171122,4090,4087,,,,4087,4087,0,0,0,0.00,4
,20171123,4087,4087,,,,4087,4087,0,0,0,0.00,4
,20171124,4087,4087,,,,4087,4087,0,0,0,0.00,4
,20171127,4087,4087,,,,4087,4087,0,0,0,0.00,4
,20171128,4087,4087,,,,4087,4087,0,0,0,0.00,4
,20171129,4087,4087,,,,4087,4087,0,0,0,0.00,4
,20171130,4087,4087,3996,4031,3996,4031,4024,-56,-63,10,60.36,14
,20171201,4031,4024,4003,4003,4003,4003,4003,-21,-21,4,24.02,18
,20171204,4003,4003,,,,4003,4003,0,0,0,0.00,18
,20171205,4003,4003,3951,3951,3951,3951,3951,-52,-52,2,11.85,20
,20171206,3951,3951,,,,3951,3951,0,0,0,0.00,20
,20171207,3951,3951,,,,3951,3951,0,0,0,0.00,20
,20171208,3951,3951,3858,3858,3843,3855,3850,-96,-101,10,57.76,28
,20171211,3855,3850,3851,3851,3851,3851,3851,1,1,4,23.11,32
,20171212,3851,3851,3861,3861,3842,3858,3856,7,5,12,69.42,34
,20171213,3858,3856,3852,3852,3852,3852,3852,-4,-4,2,11.56,34
,20171214,3852,3852,3843,3972,3764,3946,3863,94,11,158,915.58,84
,20171215,3946,3863,3940,3940,3922,3922,3931,59,68,28,165.10,70
,20171218,3922,3931,3928,3928,3908,3915,3921,-16,-10,54,317.62,62
,20171219,3915,3921,3911,3911,3911,3911,3911,-10,-10,2,11.73,64
,20171220,3911,3911,3910,3910,3908,3908,3908,-3,-3,8,46.91,66
,20171221,3908,3908,,,,3908,3908,0,0,0,0.00,66
,20171222,3908,3908,3900,3900,3900,3900,3900,-8,-8,2,11.70,66
,20171225,3900,3900,3933,3933,3933,3933,3933,33,33,2,11.80,66
,20171226,3933,3933,3936,3936,3936,3936,3936,3,3,4,23.62,66
,20171227,3936,3936,3953,3953,3917,3952,3937,16,1,14,82.68,76
,20171228,3952,3937,3966,3982,3958,3982,3971,45,34,22,131.05,76
,20171229,3982,3971,3989,4011,3987,3987,4000,16,29,22,132.02,82
ag1812,20171218,3931,3931,3928,3934,3910,3917,3921,-14,-10,460,"2,705.92",334
,20171219,3917,3921,3929,3931,3913,3923,3923,2,2,192,"1,129.83",420
,20171220,3923,3923,3926,3926,3913,3915,3917,-8,-6,232,"1,363.25",504
,20171221,3915,3917,3922,3926,3908,3912,3920,-5,3,120,705.60,568
,20171222,3912,3920,3905,3924,3901,3916,3912,-4,-8,140,821.68,618
,20171225,3916,3912,3915,3965,3915,3958,3942,46,30,226,"1,336.59",698
,20171226,3958,3942,3972,3972,3951,3962,3955,20,13,140,830.75,740
,20171227,3962,3955,3970,3978,3966,3976,3972,21,17,144,858.03,780
,20171228,3976,3972,3986,4017,3986,4006,4001,34,29,236,"1,416.39",870
,20171229,4006,4001,3995,4014,3978,3999,3991,-2,-10,1264,"7,567.17",1022
al1701,20170103,12800,12765,12830,12830,12600,12610,12675,-155,-90,6454,"40,914.62",50200
,20170104,12610,12675,12640,12680,12520,12670,12590,-5,-85,6210,"39,105.10",46940
,20170105,12670,12590,12660,12725,12570,12595,12635,5,45,4740,"29,951.90",45390
,20170106,12595,12635,12030,12690,12030,12535,12580,-100,-55,4380,"27,556.03",44450
,20170109,12535,12580,12675,12675,12515,12550,12590,-30,10,6130,"38,595.98",41660
,20170110,12550,12590,12550,12780,12510,12760,12635,170,45,15210,"96,100.63",31220
,20170111,12760,12635,12805,12915,12775,12875,12840,240,205,7820,"50,223.08",29820
,20170112,12875,12840,13050,13100,12860,13100,12925,260,85,11580,"74,839.08",21870
,20170113,13100,12925,13295,13480,13110,13260,13325,335,400,9160,"61,045.18",14570
,20170116,13260,13325,13445,13490,13190,13215,13310,-110,-15,9030,"60,096.43",8530
al1702,20170103,12795,12755,12850,12850,12560,12590,12680,-165,-75,85758,"543,776.33",200210
,20170104,12590,12680,12615,12665,12475,12645,12575,-35,-105,102012,"641,590.55",187340
,20170105,12645,12575,12645,12720,12530,12570,12635,-5,60,65560,"414,249.24",174728
,20170106,12570,12635,12590,12660,12500,12505,12570,-130,-65,44340,"278,679.67",166702
,20170109,12505,12570,12530,12675,12500,12525,12595,-45,25,47416,"298,693.46",160338
,20170110,12525,12595,12520,12820,12510,12815,12655,220,60,69210,"438,088.09",154478
,20170111,12815,12655,12850,12985,12805,12985,12905,330,250,76470,"493,551.34",131388
,20170112,12985,12905,12910,13220,12905,13210,13010,305,105,64178,"417,528.03",121236
,20170113,13210,13010,13280,13480,13155,13315,13350,305,340,67758,"452,309.79",114660
,20170116,13315,13350,13315,13435,13205,13310,13330,-40,-20,36020,"240,142.19",112562
,20170117,13310,13330,13365,13445,13145,13250,13300,-80,-30,41502,"276,088.92",103860
,20170118,13250,13300,13375,13375,13170,13260,13270,-40,-30,25080,"166,450.26",98198
,20170119,13260,13270,13260,13390,13210,13285,13275,15,5,24176,"160,508.02",92014
,20170120,13285,13275,13350,13380,13260,13270,13310,-5,35,25682,"170,923.87",86608
,20170123,13270,13310,13335,13795,13310,13620,13650,310,340,45744,"312,215.71",75048
,20170124,13620,13650,13655,13740,13595,13665,13670,15,20,20938,"143,115.96",67640
,20170125,13665,13670,13740,14050,13740,13990,13950,320,280,27526,"192,048.14",63564
,20170126,13990,13950,13895,13960,13595,13765,13745,-185,-205,11388,"78,279.15",58454
,20170203,13765,13745,13750,13820,13565,13690,13660,-55,-85,5654,"38,625.13",57940
,20170206,13690,13660,13650,13835,13490,13560,13665,-100,5,13940,"95,259.55",54520
,20170207,13560,13665,13610,13660,13465,13530,13510,-135,-155,12040,"81,331.70",52730
,20170208,13530,13510,13480,13630,13470,13590,13590,80,80,8020,"54,500.38",53490
,20170209,13590,13590,13555,13750,13555,13670,13705,80,115,11880,"81,423.45",51410
,20170210,13670,13705,13740,13750,13540,13660,13625,-45,-80,9690,"66,018.35",49320
,20170213,13660,13625,13700,13945,13700,13845,13820,220,195,13800,"95,389.55",42620
,20170214,13845,13820,13710,14245,13710,14240,14020,420,200,12460,"87,371.03",39130
,20170215,14240,14020,14240,14325,14030,14250,14225,230,205,8580,"61,042.55",33560
al1703,20170103,12840,12815,12875,12875,12610,12630,12715,-185,-100,83942,"533,767.25",221854
,20170104,12630,12715,12645,12690,12505,12680,12610,-35,-105,128864,"812,656.97",234466
,20170105,12680,12610,12665,12735,12555,12595,12650,-15,40,138436,"875,703.25",256458
,20170106,12595,12650,12625,12660,12505,12510,12590,-140,-60,125592,"790,622.47",271096
,20170109,12510,12590,12555,12710,12535,12580,12625,-10,35,196060,"1,238,089.63",282886
,20170110,12580,12625,12565,12870,12545,12870,12695,245,70,299154,"1,899,427.30",290586
,20170111,12870,12695,12925,13050,12855,13040,12960,345,265,297438,"1,927,481.31",285908
,20170112,13040,12960,13015,13280,12955,13280,13070,320,110,296242,"1,935,950.55",293964
,20170113,13280,13070,13390,13545,13210,13395,13405,325,335,432108,"2,897,131.99",306090
,20170116,13395,13405,13390,13500,13275,13390,13395,-15,-10,293590,"1,966,965.95",310520
,20170117,13390,13395,13410,13525,13215,13320,13375,-75,-20,332966,"2,226,800.17",307736
,20170118,13320,13375,13390,13445,13235,13335,13350,-40,-25,222246,"1,483,955.39",310268
,20170119,13335,13350,13355,13465,13270,13355,13355,5,5,215184,"1,437,023.58",305642
,20170120,13355,13355,13375,13455,13325,13335,13380,-20,25,230820,"1,544,320.58",296878
,20170123,13335,13380,13435,13890,13380,13690,13700,310,320,476428,"3,264,276.48",294896
,20170124,13690,13700,13720,13820,13660,13725,13740,25,40,224188,"1,540,268.52",272582
,20170125,13725,13740,13825,14140,13820,14050,14020,310,280,365258,"2,560,670.65",257794
,20170126,14050,14020,13965,14015,13630,13835,13815,-185,-205,280242,"1,936,141.08",233714
,20170203,13835,13815,13880,13880,13640,13760,13750,-55,-65,115482,"794,153.23",228000
,20170206,13760,13750,13740,13925,13520,13630,13760,-120,10,220494,"1,517,515.07",228002
,20170207,13630,13760,13625,13735,13525,13600,13620,-160,-140,156072,"1,063,179.06",225024
,20170208,13600,13620,13600,13740,13540,13695,13650,75,30,153854,"1,050,060.16",213580
,20170209,13695,13650,13660,13850,13660,13735,13785,85,135,153572,"1,058,732.09",204732
,20170210,13735,13785,13770,13855,13620,13760,13750,-25,-35,152686,"1,049,740.81",192266
,20170213,13760,13750,13800,14030,13770,13955,13915,205,165,181566,"1,263,588.19",185372
,20170214,13955,13915,13935,14340,13915,14325,14090,410,175,176090,"1,240,988.02",168766
,20170215,14325,14090,14320,14495,14110,14245,14270,155,180,131700,"939,700.23",155730
,20170216,14245,14270,14225,14490,14130,14275,14330,5,60,91942,"658,791.55",147702
,20170217,14275,14330,14205,14315,13950,13980,14135,-350,-195,64232,"453,970.90",139726
,20170220,13980,14135,13940,14100,13825,14045,13970,-90,-165,45320,"316,628.88",132804
,20170221,14045,13970,14065,14270,14045,14135,14165,165,195,38990,"276,211.52",126942
,20170222,14135,14165,14080,14200,13830,13860,14010,-305,-155,32180,"225,457.34",121588
,20170223,13860,14010,13855,14000,13715,13750,13820,-260,-190,35570,"245,865.39",114602
,20170224,13750,13820,13805,13845,13440,13605,13640,-215,-180,34996,"238,695.81",104834
,20170227,13605,13640,13665,13810,13620,13660,13685,20,45,27880,"190,818.06",97442
,20170228,13660,13685,13830,13855,13650,13695,13725,10,40,22520,"154,576.78",90538
,20170301,13695,13725,13600,14135,13600,14070,13935,345,210,20578,"143,383.02",89660
,20170302,14070,13935,14130,14180,13975,14030,14050,95,115,10150,"71,319.00",90140
,20170303,14030,14050,13955,14030,13770,14030,13890,-20,-160,14300,"99,322.03",86120
,20170306,14030,13890,14025,14040,13650,13650,13775,-240,-115,11730,"80,817.50",80970
,20170307,13650,13775,13615,13720,13580,13630,13645,-145,-130,10900,"74,366.50",77840
,20170308,13630,13645,13620,13750,13565,13600,13665,-45,20,14360,"98,133.20",72570
,20170309,13600,13665,13685,13685,13485,13505,13545,-160,-120,11260,"76,284.75",68370
,20170310,13505,13545,13405,14330,13400,13740,13580,195,35,10040,"68,173.35",65180
,20170313,13740,13580,13995,14000,13600,13680,13715,100,135,9290,"63,708.13",58130
,20170314,13680,13715,13780,13800,13470,13520,13685,-195,-30,11470,"78,487.45",48920
,20170315,13520,13685,13530,13615,13490,13560,13540,-125,-145,9470,"64,130.50",45400
al1704,20170103,12900,12875,12980,12980,12670,12690,12780,-185,-95,15212,"97,237.48",82376
,20170104,12690,12780,12690,12740,12575,12740,12665,-40,-115,20118,"127,420.60",84598
,20170105,12740,12665,12735,12790,12610,12635,12695,-30,30,21228,"134,749.42",88066
,20170106,12635,12695,12640,12705,12560,12570,12630,-125,-65,16450,"103,912.04",90182
,20170109,12570,12630,12610,12750,12590,12625,12670,-5,40,21412,"135,676.47",92398
,20170110,12625,12670,12570,12920,12570,12910,12750,240,80,41322,"263,521.85",102250
,20170111,12910,12750,13035,13115,12910,13105,13005,355,255,44616,"290,223.86",105364
,20170112,13105,13005,13095,13310,13005,13310,13115,305,110,60880,"399,303.16",108942
,20170113,13310,13115,13420,13580,13255,13420,13445,305,330,80912,"544,074.57",117226
,20170116,13420,13445,13435,13540,13325,13435,13440,-10,-5,56676,"380,959.53",119242
,20170117,13435,13440,13465,13555,13255,13365,13410,-75,-30,58148,"389,948.47",121516
,20170118,13365,13410,13440,13490,13290,13380,13400,-30,-10,51170,"342,909.48",124714
,20170119,13380,13400,13390,13505,13325,13405,13400,5,0,53764,"360,333.72",130708
,20170120,13405,13400,13415,13500,13370,13400,13435,0,35,65506,"440,135.45",137442
,20170123,13400,13435,13480,13940,13440,13755,13770,320,335,136018,"936,497.01",159708
,20170124,13755,13770,13755,13870,13710,13795,13795,25,25,71500,"493,214.54",168930
,20170125,13795,13795,13905,14180,13890,14095,14075,300,280,141424,"995,587.13",175066
,20170126,14095,14075,14000,14070,13695,13895,13875,-180,-200,104416,"724,472.08",187242
,20170203,13895,13875,13945,13970,13710,13825,13810,-50,-65,62730,"433,265.21",197144
,20170206,13825,13810,13825,13980,13605,13690,13825,-120,15,131426,"908,732.27",210534
,20170207,13690,13825,13695,13805,13590,13675,13680,-150,-145,89880,"614,917.72",226200
,20170208,13675,13680,13655,13815,13610,13775,13725,95,45,116576,"800,261.84",247574
,20170209,13775,13725,13750,13925,13750,13810,13865,85,140,127990,"887,314.95",255080
,20170210,13810,13865,13855,13930,13690,13835,13820,-30,-45,149256,"1,031,513.02",254890
,20170213,13835,13820,13870,14140,13850,14035,14005,215,185,260788,"1,826,694.50",271986
,20170214,14035,14005,14045,14435,14010,14415,14210,410,205,426604,"3,031,684.30",323084
,20170215,14415,14210,14390,14500,14205,14345,14355,135,145,443094,"3,180,936.87",322038
,20170216,14345,14355,14300,14580,14220,14365,14420,10,65,407896,"2,941,690.12",319268
,20170217,14365,14420,14275,14415,14030,14065,14240,-355,-180,364188,"2,593,612.09",316864
,20170220,14065,14240,14065,14195,13920,14145,14050,-95,-190,323658,"2,273,993.47",310782
,20170221,14145,14050,14130,14375,14130,14225,14265,175,215,295984,"2,111,155.49",314080
,20170222,14225,14265,14230,14305,13925,13955,14120,-310,-145,342076,"2,415,452.24",306374
,20170223,13955,14120,13980,14100,13805,13840,13945,-280,-175,310220,"2,163,393.33",290140
,20170224,13840,13945,13920,13940,13505,13715,13740,-230,-205,350992,"2,411,738.92",273230
,20170227,13715,13740,13780,13910,13710,13755,13805,15,65,305876,"2,111,651.94",261174
,20170228,13755,13805,13875,14030,13745,13770,13825,-35,20,297368,"2,055,946.29",249886
,20170301,13770,13825,13800,14250,13780,14180,14030,355,205,345876,"2,426,487.49",247298
,20170302,14180,14030,14220,14295,14080,14145,14195,115,165,248184,"1,761,880.51",243264
,20170303,14145,14195,14130,14180,13850,14165,14025,-30,-170,256302,"1,797,911.65",228312
,20170306,14165,14025,14120,14160,13725,13730,13945,-295,-80,266128,"1,855,596.43",220852
,20170307,13730,13945,13735,13825,13665,13750,13755,-195,-190,171484,"1,179,631.81",213644
,20170308,13750,13755,13720,13865,13665,13690,13760,-65,5,226390,"1,558,000.67",205618
,20170309,13690,13760,13755,13790,13555,13575,13645,-185,-115,182662,"1,246,556.16",189744
,20170310,13575,13645,13510,13870,13460,13830,13675,185,30,120928,"827,101.42",177678
,20170313,13830,13675,13895,13950,13615,13785,13765,110,90,115882,"797,769.46",171050
,20170314,13785,13765,13795,13860,13500,13575,13690,-190,-75,93416,"639,558.78",159576
,20170315,13575,13690,13535,13700,13510,13660,13620,-30,-70,65242,"444,415.82",151590
,20170316,13660,13620,13670,13890,13615,13870,13755,250,135,63890,"439,473.44",149046
,20170317,13870,13755,13900,13930,13630,13670,13755,-85,0,37742,"259,661.98",144642
,20170320,13670,13755,13705,13820,13630,13680,13720,-75,-35,30562,"209,718.28",140628
,20170321,13680,13720,13735,13800,13620,13780,13700,60,-20,35328,"242,084.07",137470
,20170322,13780,13700,13780,13885,13635,13715,13735,15,35,36584,"251,294.15",132132
,20170323,13715,13735,13770,13850,13570,13740,13705,5,-30,35662,"244,419.61",129090
,20170324,13740,13705,13765,13765,13600,13615,13665,-90,-40,30748,"210,129.47",121064
,20170327,13615,13665,13630,13705,13480,13625,13585,-40,-80,40380,"274,314.46",111612
,20170328,13625,13585,13645,13655,13460,13555,13555,-30,-30,27470,"186,209.99",104282
,20170329,13555,13555,13570,13795,13535,13730,13690,175,135,26666,"182,544.55",101028
,20170330,13730,13690,13730,13805,13670,13730,13730,40,40,18644,"128,022.75",99002
,20170331,13730,13730,13745,13885,13700,13880,13785,150,55,28144,"194,033.74",97180
,20170405,13880,13785,13880,14080,13780,14065,14005,280,220,16780,"117,540.13",94650
,20170406,14065,14005,14125,14155,13925,13985,14005,-20,0,13800,"96,649.43",92430
,20170407,13985,14005,14015,14030,13830,13915,13910,-90,-95,19160,"133,268.45",85790
,20170410,13915,13910,13850,14075,13850,13980,13960,70,50,12810,"89,442.15",82910
,20170411,13980,13960,13935,13935,13765,13800,13835,-160,-125,27110,"187,540.38",70510
,20170412,13800,13835,13800,13920,13780,13840,13865,5,30,15920,"110,392.88",63170
,20170413,13840,13865,13800,13985,13750,13935,13855,70,-10,13450,"93,183.45",55420
,20170414,13935,13855,13945,14070,13910,14020,14010,165,155,9580,"67,128.88",52270
,20170417,14020,14010,14100,14605,14025,14300,14370,290,360,12780,"91,842.73",48140
al1705,20170103,12960,12940,12995,13020,12735,12760,12850,-180,-90,10938,"70,292.08",73778
,20170104,12760,12850,12760,12800,12635,12790,12725,-60,-125,10358,"65,928.37",74414
,20170105,12790,12725,12790,12850,12670,12705,12745,-20,20,12378,"78,907.86",75856
,20170106,12705,12745,12715,12765,12615,12620,12690,-125,-55,13418,"85,139.81",76522
,20170109,12620,12690,12635,12800,12635,12695,12720,5,30,13226,"84,129.79",76246
,20170110,12695,12720,12690,12980,12655,12980,12810,260,90,29652,"189,988.61",79238
,20170111,12980,12810,13015,13150,12980,13150,13060,340,250,26000,"169,834.24",78086
,20170112,13150,13060,13115,13375,13060,13375,13175,315,115,30416,"200,428.40",79786
,20170113,13375,13175,13445,13645,13310,13470,13490,295,315,56108,"378,528.60",80962
,20170116,13470,13490,13495,13595,13380,13495,13500,5,10,27262,"184,050.86",82994
,20170117,13495,13500,13495,13605,13315,13425,13455,-75,-45,23604,"158,829.84",83016
,20170118,13425,13455,13485,13545,13350,13440,13460,-15,5,16366,"110,175.78",83708
,20170119,13440,13460,13445,13550,13385,13460,13455,0,-5,19384,"130,431.70",85352
,20170120,13460,13455,13490,13550,13435,13440,13495,-15,40,26254,"177,161.37",89344
,20170123,13440,13495,13550,13985,13500,13770,13795,275,300,45888,"316,574.82",93402
,20170124,13770,13795,13775,13910,13745,13835,13835,40,40,17314,"119,785.99",94340
,20170125,13835,13835,13895,14220,13895,14150,14120,315,285,53328,"376,501.49",100370
,20170126,14150,14120,14045,14100,13745,13950,13925,-170,-195,41080,"286,090.98",100088
,20170203,13950,13925,13955,13980,13760,13875,13870,-50,-55,27574,"191,276.46",103738
,20170206,13875,13870,13870,14030,13670,13745,13885,-125,15,41064,"285,111.43",106464
,20170207,13745,13885,13770,13860,13650,13735,13740,-150,-145,28784,"197,767.65",110960
,20170208,13735,13740,13730,13865,13670,13850,13790,110,50,28494,"196,528.58",113818
,20170209,13850,13790,13880,13985,13820,13885,13925,95,135,38074,"265,099.30",110958
,20170210,13885,13925,13925,13980,13760,13885,13880,-40,-45,50364,"349,576.31",115248
,20170213,13885,13880,13920,14195,13915,14105,14065,225,185,79508,"559,223.99",125040
,20170214,14105,14065,14125,14495,14080,14485,14265,420,200,101028,"720,770.44",130792
,20170215,14485,14265,14495,14560,14280,14410,14425,145,160,100266,"723,278.18",139514
,20170216,14410,14425,14350,14645,14295,14435,14480,10,55,88796,"642,919.11",142364
,20170217,14435,14480,14385,14480,14120,14140,14290,-340,-190,104010,"743,168.17",151272
,20170220,14140,14290,14175,14280,14005,14225,14135,-65,-155,109310,"772,807.47",159250
,20170221,14225,14135,14215,14455,14215,14315,14340,180,205,100380,"719,812.61",166886
,20170222,14315,14340,14315,14385,14015,14040,14190,-300,-150,104560,"741,978.91",174528
,20170223,14040,14190,14070,14190,13890,13930,14015,-260,-175,110490,"774,445.11",193232
,20170224,13930,14015,14005,14030,13530,13805,13835,-210,-180,132848,"919,250.85",206456
,20170227,13805,13835,13855,14000,13805,13845,13895,10,60,124894,"867,749.61",221782
,20170228,13845,13895,13950,14040,13840,13870,13920,-25,25,123362,"858,703.70",227426
,20170301,13870,13920,13885,14335,13880,14280,14120,360,200,187146,"1,321,480.24",229482
,20170302,14280,14120,14320,14390,14170,14235,14275,115,155,131742,"940,564.53",240888
,20170303,14235,14275,14220,14255,13965,14235,14120,-40,-155,162852,"1,149,760.92",249474
,20170306,14235,14120,14220,14255,13830,13830,14030,-290,-90,201920,"1,416,960.69",268504
,20170307,13830,14030,13805,13920,13765,13850,13850,-180,-180,125948,"872,432.43",273954
,20170308,13850,13850,13835,13960,13760,13805,13865,-45,15,197562,"1,369,683.93",283790
,20170309,13805,13865,13870,13890,13655,13675,13740,-190,-125,241154,"1,657,247.97",284362
,20170310,13675,13740,13605,13970,13550,13930,13780,190,40,269530,"1,857,081.65",292230
,20170313,13930,13780,13980,14050,13705,13880,13855,100,75,346136,"2,398,717.55",300436
,20170314,13880,13855,13900,13950,13590,13655,13760,-200,-95,338292,"2,327,727.34",301798
,20170315,13655,13760,13620,13780,13580,13750,13705,-10,-55,283110,"1,940,158.12",293878
,20170316,13750,13705,13765,13985,13695,13960,13845,255,140,374822,"2,595,041.89",301200
,20170317,13960,13845,14000,14025,13715,13760,13850,-85,5,253426,"1,755,572.81",303128
,20170320,13760,13850,13830,13910,13710,13770,13810,-80,-40,226636,"1,564,923.72",306562
,20170321,13770,13810,13830,13900,13700,13880,13805,70,-5,287178,"1,982,851.58",308716
,20170322,13880,13805,13895,13980,13720,13805,13845,0,40,366470,"2,536,912.89",296214
,20170323,13805,13845,13805,13910,13650,13835,13795,-10,-50,363300,"2,506,037.42",294422
,20170324,13835,13795,13815,13845,13685,13695,13760,-100,-35,301262,"2,072,980.79",304162
,20170327,13695,13760,13725,13805,13545,13715,13680,-45,-80,328544,"2,247,606.24",305358
,20170328,13715,13680,13705,13750,13540,13650,13640,-30,-40,327854,"2,236,643.53",287524
,20170329,13650,13640,13670,13895,13620,13835,13780,195,140,305598,"2,106,189.28",276548
,20170330,13835,13780,13840,13910,13760,13820,13835,40,55,227440,"1,573,644.63",269194
,20170331,13820,13835,13845,14000,13790,13995,13895,160,60,345774,"2,402,933.99",268522
,20170405,13995,13895,13930,14185,13880,14160,14085,265,190,227174,"1,599,941.98",269514
,20170406,14160,14085,14200,14270,14020,14095,14120,10,35,186456,"1,316,448.76",267862
,20170407,14095,14120,14100,14145,13905,14005,14020,-115,-100,241162,"1,690,995.77",252924
,20170410,14005,14020,13950,14180,13925,14070,14060,50,40,232078,"1,631,754.44",250024
,20170411,14070,14060,14050,14065,13835,13870,13940,-190,-120,217656,"1,517,239.14",218516
,20170412,13870,13940,13870,14015,13825,13865,13930,-75,-10,165932,"1,155,918.47",195892
,20170413,13865,13930,13850,14080,13765,14035,13910,105,-20,133516,"928,659.87",176484
,20170414,14035,13910,14000,14165,13980,14105,14065,195,155,88434,"622,094.16",165844
,20170417,14105,14065,14105,14745,14100,14395,14430,330,365,141218,"1,019,218.42",151534
,20170418,14395,14430,14400,14525,14325,14395,14400,-35,-30,76108,"548,048.52",139802
,20170419,14395,14400,14350,14425,14040,14165,14205,-235,-195,82938,"589,147.76",128062
,20170420,14165,14205,14150,14265,14010,14250,14115,45,-90,60420,"426,563.14",120186
,20170421,14250,14115,14300,14385,14220,14275,14290,160,175,37444,"267,573.79",116328
,20170424,14275,14290,14235,14285,14090,14230,14180,-60,-110,29834,"211,580.01",110148
,20170425,14230,14180,14230,14365,14125,14290,14245,110,65,36288,"258,510.06",103408
,20170426,14290,14245,14315,14405,14275,14300,14350,55,105,27502,"197,372.21",96032
,20170427,14300,14350,14315,14350,14250,14295,14290,-55,-60,25210,"180,160.44",89518
,20170428,14295,14290,14295,14310,14000,14000,14160,-290,-130,35670,"252,561.80",78010
,20170502,14000,14160,14050,14060,13770,13785,13950,-375,-210,18150,"126,634.20",69400
,20170503,13785,13950,13850,13900,13800,13900,13855,-50,-95,8230,"57,020.95",66370
,20170504,13900,13855,13840,13890,13705,13815,13820,-40,-35,10250,"70,830.55",62110
,20170505,13815,13820,13820,13945,13750,13880,13880,60,60,11050,"76,713.90",57320
,20170508,13880,13880,13880,13930,13620,13660,13735,-220,-145,15090,"103,633.55",53160
,20170509,13660,13735,13600,13740,13580,13730,13670,-5,-65,8520,"58,243.75",51200
,20170510,13730,13670,13700,13745,13685,13725,13715,55,45,9270,"63,580.90",48940
,20170511,13725,13715,13750,13770,13650,13740,13705,25,-10,11040,"75,657.05",44780
,20170512,13740,13705,13760,13830,13680,13795,13755,90,50,9220,"63,413.10",38300
,20170515,13795,13755,13800,13880,13750,13870,13840,115,85,12690,"87,821.70",32700
al1706,20170103,13000,12995,13005,13035,12810,12820,12910,-175,-85,1016,"6,559.55",26064
,20170104,12820,12910,12875,12875,12710,12820,12770,-90,-140,966,"6,168.19",26496
,20170105,12820,12770,12830,12910,12735,12770,12805,0,35,1374,"8,798.78",26946
,20170106,12770,12805,12770,12815,12680,12680,12745,-125,-60,1490,"9,495.71",27022
,20170109,12680,12745,12800,12850,12700,12735,12775,-10,30,978,"6,247.75",26912
,20170110,12735,12775,12735,13040,12715,13035,12885,260,110,2724,"17,554.46",27284
,20170111,13035,12885,13080,13210,13050,13210,13110,325,225,4746,"31,118.97",26244
,20170112,13210,13110,13210,13405,13115,13405,13205,295,95,3118,"20,589.65",26384
,20170113,13405,13205,13465,13695,13360,13520,13495,315,290,5466,"36,891.86",25982
,20170116,13520,13495,13520,13690,13430,13540,13520,45,25,4608,"31,156.56",26266
,20170117,13540,13520,13540,13635,13365,13495,13500,-25,-20,2492,"16,822.97",26202
,20170118,13495,13500,13560,13580,13405,13500,13510,0,10,5104,"34,480.24",25136
,20170119,13500,13510,13500,13600,13450,13515,13515,5,5,2394,"16,180.08",25210
,20170120,13515,13515,13515,13595,13490,13500,13550,-15,35,3496,"23,687.79",25768
,20170123,13500,13550,13565,14020,13565,13850,13860,300,310,10192,"70,647.77",27330
,20170124,13850,13860,13850,13950,13795,13870,13875,10,15,6994,"48,525.61",28864
,20170125,13870,13875,13920,14265,13920,14200,14165,325,290,12890,"91,306.34",33512
,20170126,14200,14165,14140,14150,13795,13990,13995,-175,-170,10536,"73,740.78",35744
,20170203,13990,13995,13975,14030,13815,13920,13925,-75,-70,6668,"46,426.95",37294
,20170206,13920,13925,13920,14075,13720,13805,13915,-120,-10,9714,"67,608.27",38200
,20170207,13805,13915,13805,13905,13710,13795,13795,-120,-120,9314,"64,258.61",38330
,20170208,13795,13795,13760,13940,13735,13910,13880,115,85,14006,"97,236.40",43070
,20170209,13910,13880,13880,14040,13880,13940,13980,60,100,10538,"73,677.75",44070
,20170210,13940,13980,13970,14035,13820,13940,13935,-40,-45,11300,"78,758.55",45590
,20170213,13940,13935,14005,14245,13970,14145,14110,210,175,21164,"149,335.43",49134
,20170214,14145,14110,14155,14545,14145,14540,14300,430,190,32364,"231,476.52",51154
,20170215,14540,14300,14555,14615,14335,14445,14485,145,185,26428,"191,440.31",54704
,20170216,14445,14485,14380,14690,14355,14485,14540,0,55,24354,"177,074.99",55956
,20170217,14485,14540,14405,14535,14185,14215,14345,-325,-195,18266,"131,057.92",55354
,20170220,14215,14345,14240,14360,14075,14295,14205,-50,-140,35120,"249,495.45",61788
,20170221,14295,14205,14270,14535,14270,14380,14410,175,205,21428,"154,431.73",63772
,20170222,14380,14410,14400,14450,14085,14110,14235,-300,-175,27932,"198,838.25",62218
,20170223,14110,14235,14120,14250,13970,14005,14080,-230,-155,31208,"219,718.40",68238
,20170224,14005,14080,14080,14100,13700,13870,13910,-210,-170,45110,"313,780.12",71480
,20170227,13870,13910,13915,14070,13880,13920,13965,10,55,25784,"180,089.47",74558
,20170228,13920,13965,14045,14125,13915,13940,13985,-25,20,26330,"184,138.54",77790
,20170301,13940,13985,13925,14415,13925,14350,14180,365,195,46234,"327,900.31",82972
,20170302,14350,14180,14385,14465,14240,14310,14350,130,170,39770,"285,396.25",87566
,20170303,14310,14350,14280,14320,14040,14320,14190,-30,-160,46962,"333,299.20",91052
,20170306,14320,14190,14290,14315,13915,13915,14105,-275,-85,43614,"307,681.48",95574
,20170307,13915,14105,13930,13995,13850,13910,13930,-195,-175,30690,"213,761.11",95372
,20170308,13910,13930,13900,14035,13845,13885,13935,-45,5,27580,"192,211.82",99838
,20170309,13885,13935,13925,13965,13740,13740,13810,-195,-125,56566,"390,712.40",97606
,20170310,13740,13810,13685,14040,13630,13990,13845,180,35,44622,"308,941.83",99520
,20170313,13990,13845,14025,14110,13770,13950,13920,105,75,46302,"322,367.35",100178
,20170314,13950,13920,13955,14015,13655,13720,13820,-200,-100,55750,"385,343.68",103560
,20170315,13720,13820,13680,13840,13650,13830,13775,10,-45,61690,"425,033.69",106200
,20170316,13830,13775,13845,14050,13770,14025,13910,250,135,72974,"507,579.59",112040
,20170317,14025,13910,14055,14090,13795,13830,13910,-80,0,61424,"427,320.67",119272
,20170320,13830,13910,13895,13980,13785,13835,13885,-75,-25,66894,"464,440.27",124362
,20170321,13835,13885,13890,13970,13785,13955,13880,70,-5,76442,"530,563.20",128396
,20170322,13955,13880,13985,14060,13800,13885,13920,5,40,103868,"722,944.29",136706
,20170323,13885,13920,13880,13990,13745,13915,13875,-5,-45,110120,"764,053.75",142154
,20170324,13915,13875,13915,13925,13775,13785,13840,-90,-35,96734,"669,595.01",150666
,20170327,13785,13840,13785,13890,13645,13790,13760,-50,-80,123296,"848,580.46",162554
,20170328,13790,13760,13775,13840,13635,13735,13730,-25,-30,120434,"826,799.04",166680
,20170329,13735,13730,13740,13960,13705,13910,13860,180,130,124336,"861,717.70",172524
,20170330,13910,13860,13940,13985,13850,13905,13920,45,60,104998,"730,794.77",176878
,20170331,13905,13920,13945,14100,13875,14100,13975,180,55,183446,"1,282,134.32",191284
,20170405,14100,13975,14010,14275,13960,14240,14170,265,195,155422,"1,101,400.98",211314
,20170406,14240,14170,14295,14350,14100,14175,14200,5,30,137474,"976,070.76",218812
,20170407,14175,14200,14185,14220,13985,14100,14105,-100,-95,182420,"1,286,675.09",214986
,20170410,14100,14105,14040,14270,14005,14155,14150,50,45,214622,"1,518,494.77",218310
,20170411,14155,14150,14115,14150,13935,13980,14030,-170,-120,240616,"1,688,051.83",237286
,20170412,13980,14030,14000,14110,13915,13970,14025,-60,-5,384342,"2,695,896.38",257978
,20170413,13970,14025,13940,14180,13875,14125,14010,100,-15,407398,"2,854,058.22",282878
,20170414,14125,14010,14105,14265,14075,14225,14165,215,155,304552,"2,157,552.08",305912
,20170417,14225,14165,14215,14995,14190,14485,14535,320,370,564666,"4,104,602.47",335724
,20170418,14485,14535,14545,14615,14420,14495,14495,-40,-40,346366,"2,510,386.95",338208
,20170419,14495,14495,14455,14530,14130,14255,14290,-240,-205,491608,"3,513,147.73",318802
,20170420,14255,14290,14255,14360,14085,14350,14210,60,-80,438790,"3,117,951.44",322064
,20170421,14350,14210,14385,14480,14310,14355,14380,145,170,326252,"2,345,818.76",323996
,20170424,14355,14380,14280,14380,14175,14330,14265,-50,-115,310140,"2,212,641.34",311426
,20170425,14330,14265,14320,14460,14215,14375,14330,110,65,350822,"2,514,231.57",318970
,20170426,14375,14330,14420,14500,14365,14375,14435,45,105,363414,"2,623,168.95",309530
,20170427,14375,14435,14400,14450,14335,14375,14385,-60,-50,237528,"1,708,627.83",305070
,20170428,14375,14385,14390,14395,13990,14015,14230,-370,-155,386486,"2,750,713.00",281130
,20170502,14015,14230,14060,14155,13830,13855,14005,-375,-225,251818,"1,763,394.32",258798
,20170503,13855,14005,13880,13985,13865,13960,13925,-45,-80,203724,"1,418,897.74",245578
,20170504,13960,13925,13915,13975,13750,13890,13885,-35,-40,281382,"1,954,021.48",241482
,20170505,13890,13885,13880,14015,13815,13950,13925,65,40,263886,"1,837,870.92",228848
,20170508,13950,13925,13935,14025,13650,13695,13820,-230,-105,313692,"2,168,087.43",223864
,20170509,13695,13820,13625,13825,13570,13790,13725,-30,-95,189126,"1,298,134.45",207824
,20170510,13790,13725,13800,13815,13735,13795,13775,70,50,123922,"853,603.80",198922
,20170511,13795,13775,13825,13950,13650,13795,13765,20,-10,110900,"763,420.71",185770
,20170512,13795,13765,13850,13890,13720,13815,13790,50,25,83412,"575,307.50",175682
,20170515,13815,13790,13830,13955,13780,13935,13880,145,90,67014,"465,171.70",165078
,20170516,13935,13880,13950,14000,13840,13915,13920,35,40,47126,"328,043.18",153148
,20170517,13915,13920,13960,14020,13930,13985,13970,65,50,40056,"279,879.52",149982
,20170518,13985,13970,13985,14060,13850,13885,13920,-85,-50,39148,"272,551.15",144708
,20170519,13885,13920,13885,14025,13805,13965,13950,45,30,39086,"272,672.51",139498
,20170522,13965,13950,14015,14090,13890,13935,13990,-15,40,47192,"330,213.93",127286
,20170523,13935,13990,13940,13965,13840,13850,13895,-140,-95,28076,"195,099.19",119882
,20170524,13850,13895,13860,14000,13860,13930,13935,35,40,26058,"181,562.97",110440
,20170525,13930,13935,13940,14050,13870,14025,13955,90,20,43376,"302,664.38",95678
,20170526,14025,13955,14025,14060,13980,14010,14015,55,60,29596,"207,434.23",85430
,20170531,14010,14015,13880,13950,13680,13680,13815,-335,-200,37140,"256,545.29",65500
,20170601,13680,13815,13670,13815,13660,13740,13730,-75,-85,15160,"104,085.78",58620
,20170602,13740,13730,13780,13795,13720,13725,13750,-5,20,7450,"51,235.35",55910
,20170605,13725,13750,13710,13805,13610,13670,13715,-80,-35,9420,"64,605.98",53800
,20170606,13670,13715,13700,13710,13595,13620,13630,-95,-85,9590,"65,361.78",52430
,20170607,13620,13630,13630,13675,13590,13610,13620,-20,-10,8140,"55,442.70",47980
,20170608,13610,13620,13610,13725,13605,13715,13685,95,65,9960,"68,156.55",44370
,20170609,13715,13685,13650,13720,13035,13540,13605,-145,-80,8880,"60,412.23",41580
,20170612,13540,13605,13580,13710,13560,13605,13620,0,15,7630,"51,971.55",39620
,20170613,13605,13620,13585,13635,13560,13580,13595,-40,-25,7300,"49,632.45",35250
,20170614,13580,13595,13580,13605,13530,13560,13580,-35,-15,9220,"62,609.03",30100
,20170615,13560,13580,13525,13545,13340,13365,13415,-215,-165,11280,"75,683.33",26770
al1707,20170103,13070,13085,13075,13095,12870,12880,12970,-205,-115,1080,"7,004.14",7238
,20170104,12880,12970,12900,12905,12795,12860,12855,-110,-115,36,231.42,7236
,20170105,12860,12855,12885,12970,12795,12795,12870,-60,15,448,"2,883.20",7346
,20170106,12795,12870,12795,12870,12735,12755,12805,-115,-65,848,"5,431.40",7592
,20170109,12755,12805,12850,12885,12770,12815,12835,10,30,172,"1,104.19",7620
,20170110,12815,12835,12800,13110,12785,13085,12875,250,40,348,"2,240.97",7770
,20170111,13085,12875,12710,13255,12710,13255,13175,380,300,924,"6,089.05",7736
,20170112,13255,13175,13215,13460,13185,13460,13275,285,100,578,"3,836.51",7826
,20170113,13460,13275,13630,13705,13435,13520,13545,245,270,1580,"10,702.55",7748
,20170116,13520,13545,13540,13740,13500,13570,13625,25,80,178,"1,212.96",7692
,20170117,13570,13625,13630,13665,13460,13545,13530,-80,-95,504,"3,410.29",7628
,20170118,13545,13530,13560,13600,13500,13545,13555,15,25,418,"2,833.63",7616
,20170119,13545,13555,13585,13630,13555,13570,13600,15,45,292,"1,985.61",7538
,20170120,13570,13600,13600,13665,13565,13565,13620,-35,20,1344,"9,152.81",7366
,20170123,13565,13620,13645,14065,13630,13890,13900,270,280,936,"6,505.73",7358
,20170124,13890,13900,13955,13995,13870,13930,13940,30,40,446,"3,108.86",7586
,20170125,13930,13940,14060,14300,14060,14215,14235,275,295,2754,"19,604.54",7760
,20170126,14215,14235,14110,14185,13860,14135,14090,-100,-145,1706,"12,021.71",8212
,20170203,14135,14090,14035,14075,13885,13980,13960,-110,-130,2766,"19,309.87",9762
,20170206,13980,13960,13985,14120,13780,13850,14010,-110,50,1734,"12,150.78",9574
,20170207,13850,14010,13890,13950,13765,13825,13875,-185,-135,1038,"7,201.88",9780
,20170208,13825,13875,13805,13985,13805,13980,13930,105,55,504,"3,511.35",9754
,20170209,13980,13930,13950,14090,13950,13980,14040,50,110,1156,"8,117.16",10370
,20170210,13980,14040,14050,14080,13795,13970,13975,-70,-65,1568,"10,957.89",10624
,20170213,13970,13975,14060,14275,14035,14220,14155,245,180,1676,"11,862.72",10824
,20170214,14220,14155,14225,14590,14225,14580,14420,425,265,2698,"19,454.33",11018
,20170215,14580,14420,14595,14655,14400,14420,14555,0,135,2060,"14,994.66",11658
,20170216,14420,14555,14425,14730,14405,14530,14660,-25,105,5296,"38,830.41",12844
,20170217,14530,14660,14465,14580,14240,14280,14370,-380,-290,1484,"10,663.83",13144
,20170220,14280,14370,14285,14410,14140,14365,14275,-5,-95,2964,"21,158.23",13858
,20170221,14365,14275,14385,14590,14380,14435,14480,160,205,2798,"20,263.83",14980
,20170222,14435,14480,14415,14500,14135,14190,14270,-290,-210,4018,"28,670.89",16200
,20170223,14190,14270,14215,14315,14045,14080,14140,-190,-130,8188,"57,904.92",19034
,20170224,14080,14140,14145,14145,13800,13945,13975,-195,-165,9586,"67,000.22",21822
,20170227,13945,13975,14045,14135,13955,13995,14030,20,55,1550,"10,874.07",21974
,20170228,13995,14030,14135,14185,13995,14030,14040,0,10,2476,"17,383.87",22954
,20170301,14030,14040,14040,14465,14040,14405,14305,365,265,6108,"43,701.14",24680
,20170302,14405,14305,14490,14525,14295,14370,14395,65,90,5032,"36,220.35",26914
,20170303,14370,14395,14320,14380,14110,14380,14260,-15,-135,6566,"46,828.70",28618
,20170306,14380,14260,14350,14380,13975,13975,14140,-285,-120,9750,"68,952.54",30556
,20170307,13975,14140,14000,14055,13920,14000,13995,-140,-145,6974,"48,801.62",31378
,20170308,14000,13995,13985,14095,13915,13935,14005,-60,10,5604,"39,247.55",32098
,20170309,13935,14005,14015,14030,13805,13810,13870,-195,-135,6488,"44,998.12",32796
,20170310,13810,13870,13775,14085,13550,14045,13895,175,25,14926,"103,710.23",37394
,20170313,14045,13895,14090,14165,13835,14000,13960,105,65,12214,"85,279.90",38180
,20170314,14000,13960,14005,14060,13715,13780,13850,-180,-110,13070,"90,519.95",38230
,20170315,13780,13850,13770,13895,13740,13885,13825,35,-25,8590,"59,397.92",37778
,20170316,13885,13825,13910,14095,13830,14060,13975,235,150,11082,"77,446.60",40788
,20170317,14060,13975,14085,14125,13855,13875,13940,-100,-35,11594,"80,813.93",40686
,20170320,13875,13940,13995,14030,13845,13910,13935,-30,-5,12444,"86,714.14",42372
,20170321,13910,13935,13955,14030,13850,14030,13955,95,20,16442,"114,731.65",46104
,20170322,14030,13955,14090,14120,13865,13945,14000,-10,45,21864,"153,078.17",51054
,20170323,13945,14000,13945,14045,13815,13980,13960,-20,-40,25374,"177,117.14",56396
,20170324,13980,13960,13980,13980,13850,13860,13905,-100,-55,16824,"116,987.24",58542
,20170327,13860,13905,13885,13960,13720,13865,13840,-40,-65,23264,"161,026.22",61098
,20170328,13865,13840,13850,13905,13720,13795,13795,-45,-45,18720,"129,164.90",62222
,20170329,13795,13795,13805,14025,13775,13970,13935,175,140,23398,"163,038.41",60426
,20170330,13970,13935,14010,14045,13920,13970,13985,35,50,12158,"85,017.48",61076
,20170331,13970,13985,13990,14135,13940,14135,14045,150,60,41764,"293,338.24",65558
,20170405,14135,14045,14080,14330,14025,14300,14230,255,185,23572,"167,745.41",68858
,20170406,14300,14230,14375,14400,14165,14245,14260,15,30,18748,"133,684.13",68618
,20170407,14245,14260,14255,14285,14050,14165,14165,-95,-95,36458,"258,242.13",74028
,20170410,14165,14165,14145,14330,14080,14220,14220,55,55,51268,"364,564.61",81494
,20170411,14220,14220,14220,14220,14030,14060,14115,-160,-105,55596,"392,399.58",92862
,20170412,14060,14115,14060,14190,14000,14065,14115,-50,0,71516,"504,807.72",98726
,20170413,14065,14115,14050,14255,13925,14215,14090,100,-25,58834,"414,559.38",102298
,20170414,14215,14090,14165,14340,14160,14280,14245,190,155,42216,"300,745.00",105374
,20170417,14280,14245,14285,14930,14280,14550,14630,305,385,114218,"835,728.91",120508
,20170418,14550,14630,14600,14690,14500,14565,14575,-65,-55,73680,"536,973.89",129398
,20170419,14565,14575,14550,14595,14225,14345,14365,-230,-210,129038,"927,030.08",132422
,20170420,14345,14365,14350,14435,14150,14420,14285,55,-80,125360,"895,633.45",136290
,20170421,14420,14285,14485,14555,14380,14430,14450,145,165,99410,"718,440.23",141296
,20170424,14430,14450,14360,14450,14255,14410,14340,-40,-110,104238,"747,587.41",137894
,20170425,14410,14340,14380,14530,14295,14460,14415,120,75,124462,"897,110.89",151356
,20170426,14460,14415,14510,14570,14435,14455,14505,40,90,125134,"907,595.96",165950
,20170427,14455,14505,14445,14520,14405,14450,14455,-55,-50,93162,"673,377.52",173658
,20170428,14450,14455,14495,14495,14120,14120,14305,-335,-150,173932,"1,244,178.15",175254
,20170502,14120,14305,14120,14235,13915,13945,14085,-360,-220,135250,"952,504.68",186036
,20170503,13945,14085,13960,14055,13950,14040,14005,-45,-80,97542,"683,168.64",192078
,20170504,14040,14005,13970,14050,13830,13965,13960,-40,-45,165572,"1,156,057.83",202470
,20170505,13965,13960,13950,14090,13900,14015,14010,55,50,161322,"1,130,148.81",217142
,20170508,14015,14010,14010,14085,13725,13770,13885,-240,-125,228992,"1,590,029.29",233804
,20170509,13770,13885,13700,13890,13650,13855,13795,-30,-90,155994,"1,076,051.26",245642
,20170510,13855,13795,13850,13870,13795,13845,13835,50,40,154126,"1,066,321.84",249576
,20170511,13845,13835,13870,13940,13685,13845,13805,10,-30,229888,"1,586,831.83",261936
,20170512,13845,13805,13900,13935,13745,13855,13830,50,25,241470,"1,670,095.22",258870
,20170515,13855,13830,13890,14025,13815,13985,13920,155,90,191484,"1,332,986.60",255472
,20170516,13985,13920,13990,14060,13890,13965,13975,45,55,184580,"1,290,160.90",262936
,20170517,13965,13975,14005,14080,13980,14055,14030,80,55,172428,"1,209,726.64",264724
,20170518,14055,14030,14065,14120,13905,13930,13985,-100,-45,162400,"1,135,682.36",266386
,20170519,13930,13985,13920,14090,13860,14030,13995,45,10,191010,"1,336,821.97",265264
,20170522,14030,13995,14105,14170,13950,13990,14060,-5,65,243462,"1,711,827.55",254118
,20170523,13990,14060,14010,14030,13900,13910,13955,-150,-105,186490,"1,301,365.55",256148
,20170524,13910,13955,13915,14065,13910,13985,13985,30,30,164190,"1,148,331.21",242952
,20170525,13985,13985,14020,14130,13920,14090,14020,105,35,275396,"1,930,788.43",219800
,20170526,14090,14020,14080,14140,14040,14085,14080,65,60,152124,"1,071,331.75",212262
,20170531,14085,14080,14000,14025,13710,13715,13885,-365,-195,219094,"1,521,313.73",221712
,20170601,13715,13885,13695,13890,13680,13805,13785,-80,-100,174396,"1,202,028.52",202546
,20170602,13805,13785,13845,13875,13780,13790,13820,5,35,111136,"768,219.70",198792
,20170605,13790,13820,13770,13880,13655,13745,13765,-75,-55,159644,"1,099,141.50",200260
,20170606,13745,13765,13680,13775,13625,13675,13700,-90,-65,157218,"1,076,989.19",190834
,20170607,13675,13700,13660,13750,13650,13690,13695,-10,-5,121322,"830,994.79",180708
,20170608,13690,13695,13695,13805,13660,13785,13735,90,40,104778,"719,760.63",167236
,20170609,13785,13735,13755,13800,13585,13620,13700,-115,-35,97010,"664,527.94",158936
,20170612,13620,13700,13675,13800,13645,13670,13710,-30,10,78408,"537,504.95",148114
,20170613,13670,13710,13675,13730,13645,13655,13680,-55,-30,53640,"366,937.45",140636
,20170614,13655,13680,13655,13700,13610,13625,13655,-55,-25,43228,"295,241.04",139084
,20170615,13625,13655,13625,13645,13430,13480,13505,-175,-150,69530,"469,644.51",135756
,20170616,13480,13505,13470,13565,13435,13530,13520,25,15,29802,"201,472.15",128682
,20170619,13530,13520,13540,13745,13495,13740,13645,220,125,40128,"273,825.35",119138
,20170620,13740,13645,13710,13950,13675,13920,13830,275,185,55918,"386,715.11",101722
,20170621,13920,13830,13860,13920,13795,13835,13850,5,20,28766,"199,225.81",93706
,20170622,13835,13850,13835,13910,13695,13700,13805,-150,-45,29292,"202,208.81",84754
,20170623,13700,13805,13750,13885,13715,13875,13760,70,-45,15260,"104,994.96",79902
,20170626,13875,13760,13855,13865,13775,13830,13810,70,50,16034,"110,753.99",76394
,20170627,13830,13810,13800,13855,13665,13855,13745,45,-65,17138,"117,796.46",73702
,20170628,13855,13745,13845,13900,13810,13880,13860,135,115,23730,"164,473.78",71704
,20170629,13880,13860,13860,13950,13840,13910,13900,50,40,22386,"155,584.99",68304
,20170630,13910,13900,13910,13935,13750,13840,13845,-60,-55,20952,"145,064.57",63044
,20170703,13840,13845,13880,14050,13860,14050,13985,205,140,17864,"124,919.62",61150
,20170704,14050,13985,14050,14065,13940,13970,13985,-15,0,12550,"87,767.60",59860
,20170705,13970,13985,13950,14125,13950,14085,14065,100,80,15830,"111,351.78",58860
,20170706,14085,14065,14060,14100,14010,14030,14060,-35,-5,10390,"73,062.33",57700
,20170707,14030,14060,14065,14080,13985,14055,14030,-5,-30,8300,"58,228.25",57010
,20170710,14055,14030,14060,14065,13980,14000,14020,-30,-10,7720,"54,134.63",56430
,20170711,14000,14020,14000,14005,13855,13980,13925,-40,-95,12300,"85,668.45",54210
,20170712,13980,13925,14005,14090,14000,14040,14045,115,120,16760,"117,698.05",53290
,20170713,14040,14045,14020,14170,14015,14155,14115,110,70,9170,"64,732.30",50710
,20170714,14155,14115,14155,14320,14155,14200,14235,85,120,8280,"58,933.98",47510
,20170717,14200,14235,14230,14340,14230,14330,14300,95,65,6080,"43,481.15",45000
al1708,20170103,13165,13150,13155,13155,12940,12940,13030,-210,-120,96,625.59,6026
,20170104,12940,13030,12985,12990,12855,12965,12910,-65,-120,52,335.70,6006
,20170105,12965,12910,12955,13015,12885,12885,12945,-25,35,112,724.97,6056
,20170106,12885,12945,12875,12940,12810,12825,12865,-120,-80,198,"1,273.94",6050
,20170109,12825,12865,12930,12960,12825,12885,12910,20,45,132,852.21,6044
,20170110,12885,12910,12855,13115,12855,13110,12940,200,30,198,"1,281.23",6088
,20170111,13110,12940,13200,13310,13160,13310,13210,370,270,438,"2,893.13",5874
,20170112,13310,13210,13270,13490,13240,13490,13335,280,125,262,"1,746.91",5848
,20170113,13490,13335,13700,13785,13525,13535,13670,200,335,502,"3,432.32",5646
,20170116,13535,13670,13550,13770,13550,13645,13695,-25,25,64,438.32,5648
,20170117,13645,13695,13685,13725,13535,13620,13610,-75,-85,120,816.66,5638
,20170118,13620,13610,13635,13670,13555,13630,13610,20,0,350,"2,382.50",5622
,20170119,13630,13610,13580,13690,13580,13625,13625,15,15,56,381.53,5604
,20170120,13625,13625,13650,13720,13635,13650,13660,25,35,120,819.66,5548
,20170123,13650,13660,13730,14105,13685,13955,13975,295,315,336,"2,348.14",5518
,20170124,13955,13975,13985,14020,13945,13990,13975,15,0,106,740.87,5528
,20170125,13990,13975,13990,14355,13990,14290,14265,315,290,952,"6,791.73",5680
,20170126,14290,14265,14175,14230,13925,14105,14130,-160,-135,528,"3,730.59",5714
,20170203,14105,14130,14085,14085,13950,14030,13995,-100,-135,290,"2,029.38",5652
,20170206,14030,13995,13990,14175,13855,13895,14000,-100,5,1704,"11,928.31",5996
,20170207,13895,14000,13955,14000,13825,13910,13925,-90,-75,580,"4,038.41",6218
,20170208,13910,13925,13860,14030,13855,14000,13970,75,45,310,"2,165.63",6072
,20170209,14000,13970,14060,14135,14055,14055,14100,85,130,646,"4,554.38",6086
,20170210,14055,14100,14080,14135,13950,14060,14040,-40,-60,430,"3,019.34",6134
,20170213,14060,14040,14180,14340,14155,14260,14200,220,160,834,"5,922.96",6216
,20170214,14260,14200,14300,14645,14300,14600,14460,400,260,988,"7,143.48",6078
,20170215,14600,14460,14655,14715,14455,14565,14610,105,150,746,"5,449.79",6024
,20170216,14565,14610,14495,14775,14490,14495,14725,-115,115,1528,"11,252.47",6558
,20170217,14495,14725,14490,14610,14305,14345,14435,-380,-290,676,"4,879.84",6538
,20170220,14345,14435,14305,14465,14205,14395,14350,-40,-85,422,"3,028.32",6656
,20170221,14395,14350,14470,14635,14450,14485,14550,135,200,710,"5,166.32",6670
,20170222,14485,14550,14500,14550,14220,14240,14345,-310,-205,626,"4,491.39",6702
,20170223,14240,14345,14240,14340,14105,14150,14170,-195,-175,868,"6,149.82",7084
,20170224,14150,14170,14295,14295,13895,14055,14035,-115,-135,588,"4,127.64",7172
,20170227,14055,14035,14055,14195,14030,14075,14070,40,35,1050,"7,387.00",7940
,20170228,14075,14070,14180,14245,14065,14080,14105,10,35,362,"2,553.47",7944
,20170301,14080,14105,14120,14510,14105,14430,14375,325,270,2234,"16,060.57",8506
,20170302,14430,14375,14525,14570,14385,14420,14495,45,120,444,"3,218.77",8612
,20170303,14420,14495,14365,14415,14170,14400,14320,-95,-175,722,"5,169.57",8758
,20170306,14400,14320,14420,14430,14055,14055,14255,-265,-65,3796,"27,057.67",9584
,20170307,14055,14255,13995,14115,13995,14035,14070,-220,-185,4006,"28,187.45",10626
,20170308,14035,14070,14045,14150,13980,14010,14055,-60,-15,3878,"27,253.15",11708
,20170309,14010,14055,14020,14055,13865,13880,13920,-175,-135,4392,"30,575.94",12384
,20170310,13880,13920,13780,14135,13770,14100,13945,180,25,12086,"84,278.61",15674
,20170313,14100,13945,14115,14205,13870,14060,13965,115,20,5292,"36,954.68",16134
,20170314,14060,13965,14055,14085,13765,13855,13955,-110,-10,13160,"91,854.49",20128
,20170315,13855,13955,13800,13940,13795,13935,13860,-20,-95,8822,"61,153.52",21720
,20170316,13935,13860,13955,14130,13880,14085,14015,225,155,6684,"46,842.00",24194
,20170317,14085,14015,14145,14165,13900,13935,14015,-80,0,7798,"54,656.61",25434
,20170320,13935,14015,13990,14065,13885,13955,13970,-60,-45,4234,"29,579.84",26108
,20170321,13955,13970,14015,14075,13905,14070,14000,100,30,3770,"26,395.62",26470
,20170322,14070,14000,14115,14165,13910,14000,14045,0,45,7362,"51,711.51",29862
,20170323,14000,14045,13980,14085,13865,14020,14015,-25,-30,10494,"73,560.97",34078
,20170324,14020,14015,14015,14015,13895,13920,13945,-95,-70,7358,"51,315.67",32618
,20170327,13920,13945,13805,14000,13780,13915,13900,-30,-45,5604,"38,955.57",33142
,20170328,13915,13900,13940,13965,13785,13865,13850,-35,-50,2838,"19,655.10",32854
,20170329,13865,13850,13890,14080,13845,14025,14000,175,150,9580,"67,061.80",34112
,20170330,14025,14000,14030,14090,13965,14000,14035,0,35,4012,"28,154.62",35590
,20170331,14000,14035,14050,14175,13990,14175,14100,140,65,7102,"50,070.35",36820
,20170405,14175,14100,14125,14375,14080,14330,14300,230,200,7452,"53,296.37",40776
,20170406,14330,14300,14355,14440,14220,14290,14320,-10,20,6296,"45,088.85",42504
,20170407,14290,14320,14295,14315,14100,14190,14210,-130,-110,6930,"49,238.12",44436
,20170410,14190,14210,14185,14370,14105,14270,14265,60,55,14048,"100,215.74",46370
,20170411,14270,14265,14255,14260,14090,14130,14160,-135,-105,11758,"83,275.87",44556
,20170412,14130,14160,14130,14245,14080,14125,14180,-35,20,36264,"257,181.32",46892
,20170413,14125,14180,14125,14310,14010,14265,14160,85,-20,28420,"201,244.34",50232
,20170414,14265,14160,14215,14400,14215,14340,14325,180,165,12958,"92,830.55",50808
,20170417,14340,14325,14355,14990,14355,14595,14695,270,370,38410,"282,291.01",53544
,20170418,14595,14695,14665,14750,14560,14615,14645,-80,-50,28996,"212,345.09",56006
,20170419,14615,14645,14590,14660,14300,14410,14435,-235,-210,45150,"325,951.76",50954
,20170420,14410,14435,14410,14485,14220,14455,14355,20,-80,23272,"167,040.14",49130
,20170421,14455,14355,14500,14610,14440,14480,14510,125,155,15276,"110,847.38",50006
,20170424,14480,14510,14465,14525,14315,14470,14415,-40,-95,19090,"137,625.15",52702
,20170425,14470,14415,14470,14590,14365,14515,14465,100,50,16702,"120,835.07",55588
,20170426,14515,14465,14545,14615,14500,14515,14555,50,90,19724,"143,552.77",59836
,20170427,14515,14555,14530,14575,14465,14510,14515,-45,-40,13370,"97,062.07",62068
,20170428,14510,14515,14510,14520,14200,14200,14350,-315,-165,32904,"236,117.15",61476
,20170502,14200,14350,14210,14305,13995,14020,14160,-330,-190,42952,"304,152.28",70888
,20170503,14020,14160,14030,14135,14025,14110,14080,-50,-80,24206,"170,411.32",73850
,20170504,14110,14080,14085,14130,13920,14040,14025,-40,-55,32820,"230,182.15",77036
,20170505,14040,14025,14040,14155,13980,14085,14080,60,55,40590,"285,778.45",77310
,20170508,14085,14080,14035,14145,13800,13840,13935,-240,-145,62640,"436,510.37",83662
,20170509,13840,13935,13815,13950,13730,13920,13865,-15,-70,32418,"224,793.49",86438
,20170510,13920,13865,13930,13930,13860,13905,13900,40,35,25250,"175,499.98",86826
,20170511,13905,13900,13955,14060,13735,13890,13845,-10,-55,39012,"270,146.44",91560
,20170512,13890,13845,13940,13980,13800,13905,13890,60,45,34972,"242,948.81",93436
,20170515,13905,13890,13915,14070,13870,14040,13985,150,95,31228,"218,375.64",97836
,20170516,14040,13985,14080,14120,13950,14020,14030,35,45,41382,"290,360.10",102440
,20170517,14020,14030,14060,14130,14035,14105,14080,75,50,36356,"255,995.36",104870
,20170518,14105,14080,14100,14170,13960,13980,14020,-100,-60,42336,"296,860.29",105500
,20170519,13980,14020,13940,14145,13915,14090,14040,70,20,61412,"431,232.66",111418
,20170522,14090,14040,14170,14235,14010,14045,14115,5,75,72630,"512,662.22",119568
,20170523,14045,14115,14075,14080,13965,13970,14010,-145,-105,59082,"413,962.67",127636
,20170524,13970,14010,13990,14120,13975,14040,14045,30,35,57834,"406,171.12",137060
,20170525,14040,14045,14090,14190,13945,14170,14075,125,30,117880,"829,721.49",138994
,20170526,14170,14075,14155,14195,14100,14155,14145,80,70,65692,"464,618.35",146906
,20170531,14155,14145,14050,14085,13765,13795,13950,-350,-195,110598,"771,691.41",163502
,20170601,13795,13950,13795,13955,13755,13870,13850,-80,-100,94520,"654,756.67",164884
,20170602,13870,13850,13920,13940,13850,13860,13890,10,40,54942,"381,616.68",167616
,20170605,13860,13890,13830,13945,13720,13810,13835,-80,-55,104988,"726,348.89",176390
,20170606,13810,13835,13760,13845,13690,13735,13765,-100,-70,127882,"880,148.77",190378
,20170607,13735,13765,13730,13815,13710,13750,13755,-15,-10,110030,"757,005.60",201654
,20170608,13750,13755,13745,13870,13725,13825,13795,70,40,115812,"798,978.24",204954
,20170609,13825,13795,13800,13865,13630,13645,13735,-150,-60,222832,"1,530,527.89",245680
,20170612,13645,13735,13725,13870,13700,13745,13765,10,30,205244,"1,413,015.49",232400
,20170613,13745,13765,13725,13795,13700,13705,13740,-60,-25,142566,"979,627.99",239534
,20170614,13705,13740,13705,13770,13665,13680,13720,-60,-20,165218,"1,133,417.09",241036
,20170615,13680,13720,13700,13710,13485,13555,13585,-165,-135,292708,"1,988,361.43",252988
,20170616,13555,13585,13530,13640,13505,13595,13575,10,-10,138752,"942,101.29",246020
,20170619,13595,13575,13595,13820,13565,13815,13705,240,130,189314,"1,297,618.27",222502
,20170620,13815,13705,13805,14030,13740,13995,13890,290,185,281798,"1,957,450.66",227922
,20170621,13995,13890,13960,13995,13870,13905,13925,15,35,162624,"1,132,654.48",210962
,20170622,13905,13925,13900,13985,13755,13765,13870,-160,-55,172830,"1,198,974.49",202744
,20170623,13765,13870,13805,13950,13790,13935,13835,65,-35,104596,"723,592.75",201086
,20170626,13935,13835,13935,13935,13840,13895,13875,60,40,84652,"587,475.87",200280
,20170627,13895,13875,13875,13940,13725,13930,13810,55,-65,161318,"1,114,115.00",192866
,20170628,13930,13810,13930,13980,13875,13955,13930,145,120,147040,"1,024,238.67",197882
,20170629,13955,13930,13945,14035,13910,13985,13970,55,40,169806,"1,186,418.93",196518
,20170630,13985,13970,13985,14020,13815,13945,13915,-25,-55,154014,"1,071,787.26",189936
,20170703,13945,13915,13950,14145,13945,14130,14050,215,135,163580,"1,149,441.30",193422
,20170704,14130,14050,14130,14160,14005,14040,14060,-10,10,119962,"843,623.69",185448
,20170705,14040,14060,14030,14220,14020,14170,14150,110,90,152764,"1,080,959.28",188084
,20170706,14170,14150,14120,14195,14090,14125,14145,-25,-5,91666,"648,446.24",177454
,20170707,14125,14145,14150,14175,14065,14140,14120,-5,-25,60762,"429,058.55",171052
,20170710,14140,14120,14105,14165,14065,14090,14115,-30,-5,49728,"351,017.68",167802
,20170711,14090,14115,14070,14110,13930,14090,14020,-25,-95,58260,"408,450.23",161452
,20170712,14090,14020,14075,14190,14060,14125,14135,105,115,56178,"397,085.46",158384
,20170713,14125,14135,14125,14265,14110,14235,14200,100,65,43542,"309,152.55",155106
,20170714,14235,14200,14325,14430,14250,14275,14330,75,130,65062,"466,323.60",148868
,20170717,14275,14330,14275,14450,14265,14390,14370,60,40,49212,"353,670.08",144508
,20170718,14390,14370,14380,14405,14200,14245,14305,-125,-65,29942,"214,198.75",136986
,20170719,14245,14305,14255,14400,14250,14385,14320,80,15,26072,"186,729.79",132508
,20170720,14385,14320,14330,14450,14310,14330,14380,10,60,27694,"199,179.75",126904
,20170721,14330,14380,14305,14395,14265,14345,14335,-35,-45,21418,"153,513.78",120708
,20170724,14345,14335,14370,14410,14285,14360,14330,25,-5,20938,"150,038.63",116312
,20170725,14360,14330,14315,14490,14300,14470,14430,140,100,35002,"252,606.59",109714
,20170726,14470,14430,14455,14540,14390,14420,14470,-10,40,42882,"310,264.57",97944
,20170727,14420,14470,14405,14440,14310,14345,14370,-125,-100,18270,"131,289.97",92894
,20170728,14345,14370,14380,14425,14215,14300,14315,-70,-55,25312,"181,226.24",86980
,20170731,14300,14315,14250,14450,14220,14445,14285,130,-30,18186,"129,899.99",77644
,20170801,14445,14285,14425,14450,14310,14310,14370,25,85,8494,"61,031.95",74370
,20170802,14310,14370,14310,14730,14310,14655,14545,285,175,21550,"156,735.25",72250
,20170803,14655,14545,14615,14725,14480,14510,14615,-35,70,8780,"64,170.53",70880
,20170804,14510,14615,14515,14650,14485,14565,14570,-50,-45,6020,"43,865.85",69820
,20170807,14565,14570,14565,15080,14550,14935,14860,365,290,15140,"112,505.08",69710
,20170808,14935,14860,15060,15405,15060,15240,15270,380,410,9160,"69,954.35",68840
,20170809,15240,15270,15275,16095,15275,16020,15870,750,600,11930,"94,686.60",66720
,20170810,16020,15870,16020,16210,15780,15900,15970,30,100,9840,"78,585.25",64880
,20170811,15900,15970,15935,16075,15780,15890,15880,-80,-90,5470,"43,443.20",61650
,20170814,15890,15880,15910,15985,15550,15625,15730,-255,-150,8990,"70,707.25",55030
,20170815,15625,15730,15645,15700,15425,15600,15605,-130,-125,7350,"57,350.03",53870
al1709,20170103,13230,13230,13190,13240,13015,13015,13125,-215,-105,360,"2,363.25",8754
,20170104,13015,13125,13050,13050,12930,13045,13015,-80,-110,214,"1,392.92",8784
,20170105,13045,13015,13045,13105,12920,12935,12995,-80,-20,332,"2,157.89",8842
,20170106,12935,12995,12960,13000,12850,12880,12940,-115,-55,370,"2,394.80",8778
,20170109,12880,12940,12975,13030,12900,12955,12975,15,35,322,"2,089.35",8776
,20170110,12955,12975,12940,13230,12915,13170,13115,195,140,390,"2,557.89",8764
,20170111,13170,13115,13280,13400,13220,13400,13280,285,165,894,"5,937.62",8642
,20170112,13400,13280,13340,13570,13295,13570,13420,290,140,980,"6,577.35",8374
,20170113,13570,13420,13765,13830,13550,13665,13705,245,285,656,"4,496.79",8310
,20170116,13665,13705,13635,13800,13500,13695,13700,-10,-5,480,"3,288.46",8310
,20170117,13695,13700,13765,13795,13590,13685,13680,-15,-20,412,"2,818.56",8316
,20170118,13685,13680,13740,13760,13625,13675,13680,-5,0,240,"1,641.62",8218
,20170119,13675,13680,13660,13750,13645,13695,13695,15,15,140,958.93,8172
,20170120,13695,13695,13695,13760,13680,13700,13720,5,25,166,"1,138.97",8128
,20170123,13700,13720,13755,14145,13735,13985,13995,265,275,764,"5,347.14",8076
,20170124,13985,13995,14055,14080,13950,14030,14025,35,30,232,"1,627.36",8076
,20170125,14030,14025,14155,14400,14150,14325,14325,300,300,532,"3,811.17",7992
,20170126,14325,14325,14290,14290,13955,14110,14135,-215,-190,290,"2,049.91",8034
,20170203,14110,14135,14440,14440,13990,14070,14060,-65,-75,322,"2,264.34",8078
,20170206,14070,14060,14065,14245,13855,13940,14095,-120,35,2396,"16,890.96",8438
,20170207,13940,14095,13955,14065,13890,13970,13950,-125,-145,454,"3,167.35",8540
,20170208,13970,13950,13935,14085,13900,14085,14030,135,80,534,"3,746.79",8474
,20170209,14085,14030,14095,14195,14065,14120,14145,90,115,328,"2,319.98",8424
,20170210,14120,14145,14150,14200,14000,14130,14080,-15,-65,824,"5,802.12",8362
,20170213,14130,14080,14185,14400,14170,14355,14310,275,230,1042,"7,458.07",8292
,20170214,14355,14310,14365,14715,14355,14695,14485,385,175,1604,"11,618.41",7738
,20170215,14695,14485,14695,14785,14535,14630,14660,145,175,1526,"11,185.67",7618
,20170216,14630,14660,14540,14820,14530,14645,14755,-15,95,1376,"10,153.89",7394
,20170217,14645,14755,14560,14680,14360,14390,14525,-365,-230,674,"4,896.21",7470
,20170220,14390,14525,14385,14535,14265,14460,14370,-65,-155,250,"1,796.34",7562
,20170221,14460,14370,14545,14680,14510,14550,14630,180,260,742,"5,428.97",7466
,20170222,14550,14630,14585,14605,14280,14325,14410,-305,-220,420,"3,026.11",7530
,20170223,14325,14410,14320,14425,14175,14235,14285,-175,-125,514,"3,671.36",7324
,20170224,14235,14285,14245,14245,13945,14155,14115,-130,-170,400,"2,823.66",7282
,20170227,14155,14115,14165,14260,14100,14105,14155,-10,40,268,"1,897.13",7326
,20170228,14105,14155,14255,14310,14125,14140,14215,-15,60,240,"1,705.81",7374
,20170301,14140,14215,14185,14605,14175,14515,14435,300,220,522,"3,767.55",7262
,20170302,14515,14435,14580,14625,14445,14485,14495,50,60,608,"4,407.94",7442
,20170303,14485,14495,14485,14485,14245,14470,14395,-25,-100,322,"2,317.88",7440
,20170306,14470,14395,14475,14475,14125,14125,14210,-270,-185,746,"5,301.17",7628
,20170307,14125,14210,14070,14190,14040,14085,14090,-125,-120,2240,"15,783.50",8530
,20170308,14085,14090,14065,14190,14010,14045,14080,-45,-10,4054,"28,547.55",9952
,20170309,14045,14080,14065,14110,13930,13930,13985,-150,-95,3012,"21,062.56",9630
,20170310,13930,13985,13900,14195,13765,14150,13960,165,-25,5052,"35,266.46",11518
,20170313,14150,13960,14170,14250,13940,14095,14045,135,85,8088,"56,804.94",14170
,20170314,14095,14045,14135,14165,13830,13910,13995,-135,-50,6100,"42,692.91",17340
,20170315,13910,13995,13880,13990,13860,13980,13910,-15,-85,9054,"62,982.73",17862
,20170316,13980,13910,14005,14170,13940,14130,14100,220,190,5896,"41,568.19",20408
,20170317,14130,14100,14210,14210,13945,13980,14090,-120,-10,3558,"25,067.67",21086
,20170320,13980,14090,14020,14105,13930,13970,14035,-120,-55,3090,"21,688.08",21344
,20170321,13970,14035,14045,14140,13940,14140,14020,105,-15,1618,"11,342.57",22056
,20170322,14140,14020,14155,14215,13950,14050,14065,30,45,12004,"84,429.71",29746
,20170323,14050,14065,13980,14140,13750,14075,13960,10,-105,10448,"72,948.34",33230
,20170324,14075,13960,14015,14050,13940,13970,14010,10,50,13858,"97,091.94",41586
,20170327,13970,14010,13940,14045,13845,13980,13955,-30,-55,7118,"49,666.05",42048
,20170328,13980,13955,13995,14015,13845,13925,13905,-30,-50,1406,"9,777.94",42264
,20170329,13925,13905,13990,14135,13905,14075,14035,170,130,14768,"103,644.90",51270
,20170330,14075,14035,14095,14135,14020,14045,14065,10,30,5568,"39,170.24",52474
,20170331,14045,14065,14110,14235,14000,14235,14140,170,75,11178,"79,037.39",57718
,20170405,14235,14140,14225,14430,14110,14395,14355,255,215,6800,"48,819.81",58550
,20170406,14395,14355,14475,14480,14270,14340,14380,-15,25,2210,"15,893.11",59024
,20170407,14340,14380,14375,14375,14135,14250,14265,-130,-115,3448,"24,596.15",58628
,20170410,14250,14265,14170,14425,14160,14305,14305,40,40,3754,"26,850.88",58824
,20170411,14305,14305,14330,14330,14145,14210,14215,-95,-90,5292,"37,614.95",59538
,20170412,14210,14215,14205,14300,14110,14180,14240,-35,25,17248,"122,817.85",59080
,20170413,14180,14240,14130,14365,14080,14340,14200,100,-40,13898,"98,693.46",59840
,20170414,14340,14200,14305,14440,14270,14395,14390,195,190,8190,"58,930.57",62200
,20170417,14395,14390,14430,15040,14410,14645,14740,255,350,25904,"190,935.05",69478
,20170418,14645,14740,14650,14795,14600,14670,14695,-70,-45,14864,"109,236.40",70368
,20170419,14670,14695,14560,14690,14205,14460,14475,-235,-220,23866,"172,764.70",66532
,20170420,14460,14475,14490,14535,14295,14520,14405,45,-70,9772,"70,387.39",65906
,20170421,14520,14405,14580,14665,14495,14550,14565,145,160,7224,"52,614.33",66746
,20170424,14550,14565,14500,14560,14370,14530,14465,-35,-100,6268,"45,335.53",66990
,20170425,14530,14465,14500,14640,14420,14565,14530,100,65,8716,"63,334.80",69086
,20170426,14565,14530,14595,14660,14545,14565,14600,35,70,8864,"64,722.31",69602
,20170427,14565,14600,14575,14615,14510,14555,14545,-45,-55,6308,"45,887.67",69534
,20170428,14555,14545,14560,14560,14255,14255,14395,-290,-150,14636,"105,348.43",69772
,20170502,14255,14395,14255,14360,14055,14070,14190,-325,-205,11854,"84,120.12",71518
,20170503,14070,14190,14065,14190,14040,14180,14130,-10,-60,11646,"82,295.89",72528
,20170504,14180,14130,14150,14175,13970,14095,14090,-35,-40,12302,"86,693.67",72264
,20170505,14095,14090,14080,14200,14030,14150,14135,60,45,18588,"131,412.46",73126
,20170508,14150,14135,14105,14190,13865,13890,13980,-245,-155,25948,"181,411.19",76066
,20170509,13890,13980,13850,14015,13800,13975,13925,-5,-55,11654,"81,152.31",75152
,20170510,13975,13925,13960,13990,13925,13970,13955,45,30,14612,"101,984.30",75756
,20170511,13970,13955,14065,14065,13790,13940,13900,-15,-55,17752,"123,407.95",76596
,20170512,13940,13900,14075,14075,13840,13940,13930,40,30,15764,"109,799.56",75106
,20170515,13940,13930,13995,14115,13915,14100,14020,170,90,10660,"74,748.60",76182
,20170516,14100,14020,14150,14155,13995,14065,14080,45,60,12302,"86,625.35",76526
,20170517,14065,14080,14150,14165,14080,14145,14120,65,40,10948,"77,308.34",77654
,20170518,14145,14120,14150,14225,14000,14025,14085,-95,-35,8684,"61,174.54",77708
,20170519,14025,14085,14000,14185,13955,14140,14085,55,0,11180,"78,754.95",77250
,20170522,14140,14085,14205,14285,14065,14100,14160,15,75,16866,"119,440.65",80796
,20170523,14100,14160,14110,14135,14010,14030,14065,-130,-95,14926,"104,986.65",83382
,20170524,14030,14065,14025,14180,14025,14105,14095,40,30,9248,"65,176.91",86076
,20170525,14105,14095,14135,14240,14030,14230,14135,135,40,16906,"119,514.53",86820
,20170526,14230,14135,14225,14250,14160,14210,14200,75,65,14352,"101,925.65",86962
,20170531,14210,14200,14150,14150,13875,13875,14000,-325,-200,36762,"257,355.00",92732
,20170601,13875,14000,13870,14020,13830,13935,13915,-65,-85,41474,"288,644.65",94388
,20170602,13935,13915,13965,14005,13915,13925,13950,10,35,19976,"139,375.05",92906
,20170605,13925,13950,13900,14005,13795,13880,13900,-70,-50,30626,"212,858.35",95376
,20170606,13880,13900,13875,13915,13760,13805,13825,-95,-75,39642,"274,110.81",97186
,20170607,13805,13825,13800,13885,13780,13820,13830,-5,5,28766,"198,929.65",96822
,20170608,13820,13830,13815,13930,13790,13895,13865,65,35,25538,"177,093.27",96682
,20170609,13895,13865,13855,13925,13695,13710,13800,-155,-65,55370,"382,088.06",99550
,20170612,13710,13800,13770,13925,13760,13805,13825,5,25,44978,"311,002.10",95732
,20170613,13805,13825,13780,13855,13770,13770,13800,-55,-25,29642,"204,587.59",96520
,20170614,13770,13800,13775,13835,13730,13740,13785,-60,-15,29798,"205,401.33",94730
,20170615,13740,13785,13740,13775,13565,13635,13655,-150,-130,79960,"546,007.71",110998
,20170616,13635,13655,13595,13715,13580,13670,13655,15,0,38558,"263,257.54",114314
,20170619,13670,13655,13660,13885,13640,13875,13780,220,125,70268,"484,199.32",105408
,20170620,13875,13780,13840,14105,13815,14080,13970,300,190,86600,"605,111.05",114948
,20170621,14080,13970,14050,14070,13940,13975,13995,5,25,46356,"324,485.40",118398
,20170622,13975,13995,13985,14050,13830,13830,13935,-165,-60,56906,"396,505.27",116704
,20170623,13830,13935,13885,14000,13860,14000,13900,65,-35,33388,"232,098.33",117762
,20170626,14000,13900,13970,14000,13905,13970,13945,70,45,33042,"230,438.50",122872
,20170627,13970,13945,13920,13995,13800,13995,13885,50,-60,62346,"432,861.85",130164
,20170628,13995,13885,13995,14045,13935,14020,13990,135,105,62584,"437,922.37",138188
,20170629,14020,13990,14000,14100,13970,14055,14040,65,50,71604,"502,712.58",146768
,20170630,14055,14040,14055,14095,13890,14020,13990,-20,-50,70716,"494,780.20",156452
,20170703,14020,13990,14010,14215,14010,14210,14125,220,135,108834,"768,890.95",173970
,20170704,14210,14125,14195,14235,14080,14115,14140,-10,15,86866,"614,195.49",185356
,20170705,14115,14140,14115,14305,14100,14265,14230,125,90,132642,"943,812.21",218290
,20170706,14265,14230,14230,14285,14170,14210,14230,-20,0,93814,"667,552.58",227450
,20170707,14210,14230,14240,14260,14150,14225,14205,-5,-25,130090,"924,200.28",244286
,20170710,14225,14205,14200,14255,14140,14175,14200,-30,-5,131094,"930,947.70",251602
,20170711,14175,14200,14150,14195,14005,14185,14105,-15,-95,177644,"1,253,137.43",259470
,20170712,14185,14105,14150,14285,14140,14215,14225,110,120,165746,"1,179,106.41",280912
,20170713,14215,14225,14200,14355,14200,14320,14285,95,60,152768,"1,091,427.13",299940
,20170714,14320,14285,14425,14535,14340,14375,14425,90,140,256834,"1,852,528.92",307672
,20170717,14375,14425,14360,14550,14355,14500,14465,75,40,232712,"1,683,321.51",334106
,20170718,14500,14465,14490,14500,14285,14350,14395,-115,-70,175180,"1,261,134.46",311274
,20170719,14350,14395,14350,14500,14345,14480,14420,85,25,156520,"1,128,838.93",313062
,20170720,14480,14420,14465,14555,14400,14420,14475,0,55,194078,"1,404,668.70",312238
,20170721,14420,14475,14425,14490,14355,14445,14430,-30,-45,153132,"1,105,169.78",299182
,20170724,14445,14430,14460,14510,14375,14455,14435,25,5,154976,"1,118,705.63",290504
,20170725,14455,14435,14430,14590,14390,14570,14510,135,75,198124,"1,437,526.07",303680
,20170726,14570,14510,14565,14645,14485,14510,14560,0,50,251852,"1,833,965.22",282886
,20170727,14510,14560,14490,14540,14400,14435,14465,-125,-95,162626,"1,176,442.11",268390
,20170728,14435,14465,14470,14530,14300,14380,14415,-85,-50,202250,"1,458,078.54",249946
,20170731,14380,14415,14350,14550,14310,14545,14390,130,-25,199496,"1,435,748.45",238398
,20170801,14545,14390,14545,14560,14390,14425,14460,35,70,146254,"1,057,767.03",222484
,20170802,14425,14460,14400,14840,14390,14765,14640,305,180,267824,"1,960,550.54",230790
,20170803,14765,14640,14745,14835,14560,14590,14710,-50,70,229688,"1,689,464.03",204782
,20170804,14590,14710,14640,14745,14560,14665,14650,-45,-60,95542,"699,860.11",193116
,20170807,14665,14650,14640,15200,14620,15040,14920,390,270,171448,"1,279,132.42",179228
,20170808,15040,14920,15100,15500,15045,15335,15335,415,415,178346,"1,367,614.95",164860
,20170809,15335,15335,15470,16205,15355,16095,15930,760,595,205462,"1,636,558.27",153502
,20170810,16095,15930,16040,16350,15815,15985,16070,55,140,103982,"835,712.71",143124
,20170811,15985,16070,16020,16160,15845,16010,15970,-60,-100,88942,"710,357.10",137788
,20170814,16010,15970,16095,16130,15570,15700,15845,-270,-125,71488,"566,505.63",131580
,20170815,15700,15845,15760,15795,15510,15715,15685,-130,-160,57548,"451,428.40",122808
,20170816,15715,15685,15810,16115,15725,16000,15955,315,270,48412,"386,306.21",118002
,20170817,16000,15955,16090,16555,16055,16420,16375,465,420,57036,"467,071.27",110120
,20170818,16420,16375,16200,16345,16010,16265,16200,-110,-175,38668,"313,262.67",103666
,20170821,16265,16200,16315,16485,16100,16325,16285,125,85,41938,"341,540.68",97992
,20170822,16325,16285,16325,16435,16165,16280,16270,-5,-15,27246,"221,705.31",94156
,20170823,16280,16270,16320,16385,16010,16125,16135,-145,-135,23484,"189,468.61",91842
,20170824,16125,16135,16165,16650,16165,16375,16475,240,340,41948,"345,569.79",85476
,20170825,16375,16475,16405,16560,16330,16525,16465,50,-10,22354,"184,070.24",85804
,20170828,16525,16465,16500,16530,16130,16285,16320,-180,-145,21032,"171,649.25",82468
,20170829,16285,16320,16270,16355,16100,16145,16205,-175,-115,18412,"149,183.44",80782
,20170830,16145,16205,16210,16320,16130,16275,16225,70,20,18676,"151,534.86",79270
,20170831,16275,16225,16205,16390,16135,16390,16325,165,100,18700,"152,667.97",73654
,20170901,16390,16325,16500,16600,16420,16580,16510,255,185,11454,"94,557.18",73590
,20170904,16580,16510,16465,16700,16365,16380,16560,-130,50,10950,"90,681.93",71210
,20170905,16380,16560,16395,16440,16310,16360,16375,-200,-185,10680,"87,446.40",67690
,20170906,16360,16375,16300,16380,16150,16170,16215,-205,-160,13600,"110,270.00",63940
,20170907,16170,16215,16200,16265,15985,15990,16130,-225,-85,11630,"93,805.30",61040
,20170908,15990,16130,16000,16100,15625,15780,15910,-350,-220,12240,"97,369.40",55380
,20170911,15780,15910,15790,16315,15665,16315,15925,405,15,10180,"81,080.90",54520
,20170912,16315,15925,16320,16405,16260,16400,16355,475,430,13380,"109,416.45",52820
,20170913,16400,16355,16400,16530,16335,16350,16450,-5,95,4330,"35,618.30",51610
,20170914,16350,16450,16310,16440,16175,16410,16340,-40,-110,7030,"57,441.33",49060
,20170915,16410,16340,16385,16385,16020,16035,16225,-305,-115,4390,"35,614.63",47730
al1710,20170103,13290,13270,13155,13195,13145,13170,13160,-100,-110,30,197.42,2320
,20170104,13170,13160,13080,13090,13000,13090,13060,-70,-100,16,104.50,2326
,20170105,13090,13060,13170,13170,13005,13005,13100,-55,40,26,170.33,2326
,20170106,13005,13100,13010,13060,12885,12950,12995,-150,-105,174,"1,130.98",2346
,20170109,12950,12995,13020,13080,12830,13065,13015,70,20,40,260.38,2340
,20170110,13065,13015,13010,13230,12975,13230,13125,215,110,68,446.28,2342
,20170111,13230,13125,13265,13395,13215,13395,13285,270,160,402,"2,670.56",2120
,20170112,13395,13285,13390,13600,13305,13600,13415,315,130,194,"1,301.30",2092
,20170113,13600,13415,13700,13845,13595,13595,13735,180,320,188,"1,291.10",2012
,20170116,13595,13735,13730,13815,13660,13660,13715,-75,-20,20,137.18,2008
,20170117,13660,13715,13775,13780,13685,13685,13715,-30,0,38,260.65,2002
,20170118,13685,13715,13750,13785,13640,13655,13715,-60,0,68,466.36,2004
,20170119,13655,13715,13710,13805,13685,13720,13720,5,5,20,137.24,2012
,20170120,13720,13720,13730,13850,13705,13705,13730,-15,10,62,425.75,2014
,20170123,13705,13730,13820,14150,13820,14060,14000,330,270,82,574.04,2036
,20170124,14060,14000,14035,14075,13985,14010,14035,10,35,28,196.51,2024
,20170125,14010,14035,14200,14405,14200,14350,14320,315,285,176,"1,260.37",2000
,20170126,14350,14320,14130,14195,14005,14130,14085,-190,-235,122,859.28,1928
,20170203,14130,14085,14115,14165,14000,14055,14055,-30,-30,60,421.77,1924
,20170206,14055,14055,14245,14255,13950,14000,14085,-55,30,994,"7,001.20",2178
,20170207,14000,14085,14030,14080,13915,14000,13965,-85,-120,96,670.51,2186
,20170208,14000,13965,13955,14100,13920,14095,14020,130,55,72,504.82,2186
,20170209,14095,14020,14190,14220,14190,14210,14205,190,185,12,85.24,2186
,20170210,14210,14205,14205,14240,13980,14240,14095,35,-110,44,310.17,2180
,20170213,14240,14095,14295,14410,14190,14385,14340,290,245,36,258.19,2190
,20170214,14385,14340,14390,14730,14390,14730,14565,390,225,256,"1,864.52",2200
,20170215,14730,14565,14755,14790,14535,14685,14695,120,130,208,"1,528.50",2192
,20170216,14685,14695,14575,14835,14575,14675,14750,-20,55,548,"4,042.38",2186
,20170217,14675,14750,14610,14880,14400,14400,14600,-350,-150,114,832.23,2182
,20170220,14400,14600,14420,14535,14340,14490,14390,-110,-210,98,705.30,2184
,20170221,14490,14390,14625,14715,14550,14580,14610,190,220,122,891.26,2224
,20170222,14580,14610,14615,14625,14325,14340,14500,-270,-110,256,"1,856.04",2220
,20170223,14340,14500,14400,14960,14220,14270,14365,-230,-135,210,"1,508.63",2232
,20170224,14270,14365,14335,14335,14025,14205,14175,-160,-190,446,"3,162.06",2140
,20170227,14205,14175,14270,14300,14175,14175,14215,0,40,112,796.21,2162
,20170228,14175,14215,14220,14395,14200,14225,14265,10,50,264,"1,883.33",2152
,20170301,14225,14265,14270,14590,14235,14590,14420,325,155,74,533.56,2156
,20170302,14590,14420,14640,14655,14500,14500,14575,80,155,176,"1,283.01",2216
,20170303,14500,14575,14430,14595,14305,14595,14450,20,-125,288,"2,081.10",2300
,20170306,14595,14450,14465,14540,14205,14205,14320,-245,-130,192,"1,375.04",2308
,20170307,14205,14320,14205,14220,14125,14130,14155,-190,-165,270,"1,911.04",2334
,20170308,14130,14155,14190,14220,14075,14090,14130,-65,-25,552,"3,901.26",2334
,20170309,14090,14130,14110,14125,14000,14020,14030,-110,-100,518,"3,634.71",2286
,20170310,14020,14030,13980,14240,13945,14230,14015,200,-15,1198,"8,397.48",2522
,20170313,14230,14015,14290,14315,14035,14135,14120,120,105,234,"1,652.58",2532
,20170314,14135,14120,14080,14150,13900,13975,14040,-145,-80,836,"5,869.76",3088
,20170315,13975,14040,13925,14040,13905,14040,13985,0,-55,330,"2,307.96",3098
,20170316,14040,13985,14065,14225,13980,14155,14160,170,175,2214,"15,675.65",3872
,20170317,14155,14160,14240,14240,14000,14000,14060,-160,-100,244,"1,715.75",3880
,20170320,14000,14060,14090,14135,13960,14000,14055,-60,-5,4398,"30,917.72",5052
,20170321,14000,14055,14100,14175,13990,14165,14070,110,15,1094,"7,697.90",5472
,20170322,14165,14070,14195,14270,14010,14070,14165,0,95,1396,"9,887.79",6112
,20170323,14070,14165,14025,14170,13815,14105,13940,-60,-225,4778,"33,314.30",7678
,20170324,14105,13940,14060,14100,13990,14000,14035,60,95,1620,"11,370.41",7960
,20170327,14000,14035,14030,14090,13915,13965,13960,-70,-75,2074,"14,480.06",7676
,20170328,13965,13960,14020,14040,13910,13955,13950,-5,-10,384,"2,679.27",7598
,20170329,13955,13950,14000,14195,13970,14195,14085,245,135,620,"4,366.82",7694
,20170330,14195,14085,14135,14195,14080,14085,14115,0,30,1274,"8,992.60",8004
,20170331,14085,14115,14140,14265,14085,14250,14210,135,95,1832,"13,018.80",8686
,20170405,14250,14210,14200,14465,14185,14425,14425,215,215,1112,"8,021.92",9154
,20170406,14425,14425,14510,14535,14320,14380,14425,-45,0,398,"2,870.90",9174
,20170407,14380,14425,14370,14380,14200,14240,14310,-185,-115,550,"3,935.56",9112
,20170410,14240,14310,14225,14465,14220,14340,14370,30,60,1688,"12,129.66",9860
,20170411,14340,14370,14315,14325,14195,14260,14285,-110,-85,1590,"11,357.58",10188
,20170412,14260,14285,14260,14335,14180,14230,14305,-55,20,4506,"32,231.57",11338
,20170413,14230,14305,14155,14400,14155,14375,14310,70,5,3886,"27,807.42",13512
,20170414,14375,14310,14340,14490,14320,14445,14435,135,125,920,"6,641.27",13434
,20170417,14445,14435,14510,15050,14455,14670,14740,235,305,3916,"28,869.59",14506
,20170418,14670,14740,14760,14805,14650,14700,14730,-40,-10,9012,"66,377.16",16374
,20170419,14700,14730,14680,14720,14410,14540,14545,-190,-185,7792,"56,677.79",15096
,20170420,14540,14545,14535,14585,14355,14540,14515,-5,-30,2590,"18,800.68",16066
,20170421,14540,14515,14610,14705,14530,14575,14610,60,95,3160,"23,088.92",17650
,20170424,14575,14610,14530,14590,14410,14555,14510,-55,-100,1664,"12,073.17",18084
,20170425,14555,14510,14470,14665,14450,14585,14575,75,65,7134,"51,996.84",23490
,20170426,14585,14575,14610,14685,14550,14590,14610,15,35,7810,"57,058.70",27510
,20170427,14590,14610,14580,14635,14535,14580,14570,-30,-40,1254,"9,138.38",27568
,20170428,14580,14570,14585,14585,14340,14340,14420,-230,-150,5356,"38,628.25",27688
,20170502,14340,14420,14320,14390,14105,14130,14225,-290,-195,3876,"27,569.62",28348
,20170503,14130,14225,14195,14465,14135,14245,14190,20,-35,2106,"14,944.33",28540
,20170504,14245,14190,14245,14245,14055,14155,14135,-35,-55,1416,"10,010.72",28978
,20170505,14155,14135,14125,14230,14090,14165,14200,30,65,9990,"70,932.25",34060
,20170508,14165,14200,14170,14230,13920,13965,14055,-235,-145,5198,"36,530.82",34746
,20170509,13965,14055,13965,14060,13855,14035,13975,-20,-80,3330,"23,274.42",34784
,20170510,14035,13975,14050,14050,13980,14005,14005,30,30,1380,"9,664.77",34736
,20170511,14005,14005,14070,14070,13845,13970,13950,-35,-55,2636,"18,390.06",34670
,20170512,13970,13950,14050,14050,13880,13980,13975,30,25,2526,"17,650.87",34810
,20170515,13980,13975,14005,14155,13960,14125,14040,150,65,1302,"9,143.04",35100
,20170516,14125,14040,14145,14190,14040,14080,14105,40,65,1882,"13,273.21",35118
,20170517,14080,14105,14165,14180,14105,14170,14145,65,40,1340,"9,479.44",35540
,20170518,14170,14145,14185,14250,14035,14050,14100,-95,-45,1494,"10,533.42",35866
,20170519,14050,14100,14000,14220,14000,14180,14135,80,35,1220,"8,624.32",35856
,20170522,14180,14135,14255,14295,14070,14140,14190,5,55,4496,"31,901.97",37174
,20170523,14140,14190,14110,14165,14065,14075,14100,-115,-90,2378,"16,768.25",37054
,20170524,14075,14100,14075,14210,14070,14150,14145,50,45,698,"4,937.02",37170
,20170525,14150,14145,14165,14285,14085,14260,14215,115,70,7652,"54,393.68",40660
,20170526,14260,14215,14265,14295,14215,14260,14250,45,35,2338,"16,661.21",41552
,20170531,14260,14250,14165,14195,13950,13950,14045,-300,-205,5244,"36,834.94",42816
,20170601,13950,14045,13990,14080,13920,14000,13990,-45,-55,8834,"61,809.43",42316
,20170602,14000,13990,14010,14060,13970,13970,14015,-20,25,4160,"29,159.73",43078
,20170605,13970,14015,13950,14060,13855,13925,13965,-90,-50,4198,"29,315.34",43450
,20170606,13925,13965,13915,13965,13830,13870,13895,-95,-70,3938,"27,364.67",44560
,20170607,13870,13895,13850,13955,13850,13880,13895,-15,0,10860,"75,456.72",44208
,20170608,13880,13895,13885,13990,13865,13960,13930,65,35,4496,"31,320.63",44102
,20170609,13960,13930,13930,13985,13755,13780,13820,-150,-110,22326,"154,298.60",46632
,20170612,13780,13820,13870,13980,13800,13875,13900,55,80,14092,"97,959.03",48430
,20170613,13875,13900,13845,13920,13835,13835,13880,-65,-20,10242,"71,082.46",50056
,20170614,13835,13880,13820,13900,13810,13825,13850,-55,-30,15218,"105,398.69",53620
,20170615,13825,13850,13850,13850,13650,13715,13735,-135,-115,42608,"292,682.48",57578
,20170616,13715,13735,13685,13785,13665,13740,13730,5,-5,13048,"89,599.01",56308
,20170619,13740,13730,13745,13955,13720,13955,13860,225,130,12684,"87,929.42",51934
,20170620,13955,13860,13930,14175,13890,14140,14045,280,185,21750,"152,742.20",48682
,20170621,14140,14045,14095,14140,14015,14035,14080,-10,35,10116,"71,234.88",48336
,20170622,14035,14080,14035,14120,13895,13910,14005,-170,-75,12142,"85,043.81",48290
,20170623,13910,14005,13930,14070,13925,14055,13965,50,-40,6432,"44,912.74",48556
,20170626,14055,13965,14060,14060,13975,14030,14010,65,45,4848,"33,966.52",48618
,20170627,14030,14010,13985,14055,13865,14050,13930,40,-80,18012,"125,478.13",52194
,20170628,14050,13930,14050,14100,14000,14080,14055,150,125,13850,"97,355.61",52704
,20170629,14080,14055,14065,14155,14035,14115,14095,60,40,17610,"124,139.31",54538
,20170630,14115,14095,14075,14140,13955,14075,14035,-20,-60,17012,"119,421.56",56916
,20170703,14075,14035,14060,14275,14060,14265,14185,230,150,30100,"213,521.03",59672
,20170704,14265,14185,14230,14295,14145,14170,14200,-15,15,24664,"175,147.80",62276
,20170705,14170,14200,14150,14365,14150,14310,14290,110,90,23646,"168,967.67",65930
,20170706,14310,14290,14310,14345,14240,14265,14295,-25,5,19140,"136,826.78",67762
,20170707,14265,14295,14325,14325,14215,14285,14265,-10,-30,16830,"120,074.93",68722
,20170710,14285,14265,14275,14315,14205,14235,14265,-30,0,20338,"145,064.19",70458
,20170711,14235,14265,14185,14260,14075,14260,14165,-5,-100,31332,"221,925.53",72708
,20170712,14260,14165,14170,14350,14170,14285,14295,120,130,34148,"244,073.64",77368
,20170713,14285,14295,14270,14425,14270,14400,14370,105,75,20390,"146,525.19",81204
,20170714,14400,14370,14480,14615,14415,14450,14510,80,140,50398,"365,752.61",87238
,20170717,14450,14510,14410,14650,14410,14600,14555,90,45,54182,"394,364.08",96056
,20170718,14600,14555,14590,14590,14380,14430,14475,-125,-80,42998,"311,212.07",99892
,20170719,14430,14475,14455,14580,14430,14550,14505,75,30,48706,"353,360.94",110826
,20170720,14550,14505,14565,14635,14485,14510,14555,5,50,59106,"430,240.76",117872
,20170721,14510,14555,14550,14575,14450,14515,14515,-40,-40,50532,"366,837.33",126572
,20170724,14515,14515,14540,14590,14455,14545,14520,30,5,46244,"335,771.47",133116
,20170725,14545,14520,14510,14670,14480,14660,14600,140,80,66078,"482,383.22",146594
,20170726,14660,14600,14670,14725,14580,14600,14650,0,50,111668,"818,070.37",151870
,20170727,14600,14650,14570,14635,14500,14540,14560,-110,-90,70514,"513,470.22",158658
,20170728,14540,14560,14575,14625,14395,14475,14510,-85,-50,92846,"673,800.69",158528
,20170731,14475,14510,14430,14640,14405,14635,14495,125,-15,102544,"743,312.09",178290
,20170801,14635,14495,14630,14650,14495,14520,14560,25,65,94386,"687,177.98",186112
,20170802,14520,14560,14515,14940,14480,14850,14745,290,185,229112,"1,689,429.43",239654
,20170803,14850,14745,14850,14930,14660,14685,14800,-60,55,248328,"1,837,858.98",256496
,20170804,14685,14800,14720,14850,14665,14765,14755,-35,-45,195978,"1,446,050.16",281964
,20170807,14765,14755,14780,15315,14720,15140,15040,385,285,511238,"3,844,590.18",343358
,20170808,15140,15040,15195,15620,15175,15435,15440,395,400,628248,"4,851,182.20",382520
,20170809,15435,15440,15545,16330,15460,16215,16040,775,600,1115798,"8,951,299.48",446478
,20170810,16215,16040,16195,16460,15925,16085,16180,45,140,946258,"7,656,131.05",444046
,20170811,16085,16180,16165,16275,15930,16090,16085,-90,-95,880432,"7,082,204.98",446204
,20170814,16090,16085,16180,16235,15680,15780,15970,-305,-115,773738,"6,179,586.88",409544
,20170815,15780,15970,15815,15890,15590,15810,15770,-160,-200,471046,"3,715,105.00",399048
,20170816,15810,15770,15895,16215,15825,16100,16045,330,275,581182,"4,662,553.18",399856
,20170817,16100,16045,16175,16660,16145,16520,16450,475,405,832690,"6,849,399.96",387990
,20170818,16520,16450,16400,16440,16090,16350,16285,-100,-165,543324,"4,424,846.27",368612
,20170821,16350,16285,16435,16585,16185,16430,16375,145,90,631432,"5,169,874.41",368102
,20170822,16430,16375,16420,16530,16250,16385,16385,10,10,418884,"3,432,741.31",354912
,20170823,16385,16385,16405,16485,16090,16210,16255,-175,-130,457530,"3,718,873.99",338614
,20170824,16210,16255,16290,16755,16265,16465,16555,210,300,707396,"5,856,671.19",329272
,20170825,16465,16555,16475,16655,16420,16620,16555,65,0,393254,"3,255,634.55",317742
,20170828,16620,16555,16580,16620,16210,16365,16390,-190,-165,449102,"3,680,570.17",294050
,20170829,16365,16390,16340,16450,16180,16245,16300,-145,-90,299046,"2,437,487.86",279616
,20170830,16245,16300,16360,16420,16205,16380,16310,80,10,357756,"2,917,588.48",258878
,20170831,16380,16310,16310,16490,16220,16465,16370,155,60,340632,"2,788,631.56",234044
,20170901,16465,16370,16610,16720,16505,16670,16595,300,225,294288,"2,442,372.60",222854
,20170904,16670,16595,16595,16820,16460,16480,16645,-115,50,276600,"2,302,142.48",194406
,20170905,16480,16645,16435,16560,16415,16465,16485,-180,-160,106248,"875,902.76",182568
,20170906,16465,16485,16450,16505,16220,16280,16345,-205,-140,117534,"960,691.57",169324
,20170907,16280,16345,16305,16375,16065,16075,16230,-270,-115,118932,"965,327.22",154086
,20170908,16075,16230,16120,16205,15700,15815,16000,-415,-230,124386,"995,176.33",138306
,20170911,15815,16000,15895,16450,15755,16440,16015,440,15,102346,"819,603.40",133066
,20170912,16440,16015,16405,16540,16380,16510,16470,495,455,69006,"568,427.09",130988
,20170913,16510,16470,16465,16670,16380,16470,16555,0,85,53854,"445,824.18",124874
,20170914,16470,16555,16370,16565,16270,16495,16430,-60,-125,61864,"508,245.96",119524
,20170915,16495,16430,16445,16510,16125,16145,16320,-285,-110,62220,"507,751.19",110444
,20170918,16145,16320,16165,16360,15990,16275,16190,-45,-130,43726,"353,973.30",105804
,20170919,16275,16190,16275,16530,16200,16380,16420,190,230,48820,"400,830.20",99312
,20170920,16380,16420,16485,17020,16320,16945,16725,525,305,75328,"629,953.44",96526
,20170921,16945,16725,16975,17130,16600,16685,16835,-40,110,55952,"471,115.47",90532
,20170922,16685,16835,16735,17010,16115,16290,16445,-545,-390,70938,"583,302.22",73060
,20170925,16290,16445,16440,16570,16245,16330,16375,-115,-70,31574,"258,523.56",68500
,20170926,16330,16375,16330,16530,16315,16420,16420,45,45,23748,"194,974.55",64938
,20170927,16420,16420,16375,16445,16220,16390,16350,-30,-70,27980,"228,798.79",59596
,20170928,16390,16350,16410,16415,16160,16235,16280,-115,-70,26304,"214,168.24",56350
,20170929,16235,16280,16315,16320,16100,16300,16235,20,-45,15904,"129,109.20",52532
,20171009,16300,16235,16330,16485,16300,16465,16420,230,185,15942,"130,909.69",51180
,20171010,16465,16420,16460,16570,16250,16280,16460,-140,40,20950,"172,418.85",54650
,20171011,16280,16460,16245,16350,16080,16160,16215,-300,-245,14550,"117,997.48",53690
,20171012,16160,16215,16160,16300,16100,16235,16195,20,-20,6980,"56,523.78",51920
,20171013,16235,16195,16230,16455,16215,16445,16365,250,170,9600,"78,570.63",51230
,20171016,16445,16365,16455,16470,16210,16275,16335,-90,-30,7500,"61,262.65",48980
al1711,20170103,13385,13335,13365,13380,13085,13085,13220,-250,-115,38,251.26,842
,20170104,13085,13220,13140,13150,13070,13150,13105,-70,-115,28,183.49,844
,20170105,13150,13105,13165,13200,13075,13075,13135,-30,30,18,118.22,850
,20170106,13075,13135,13055,13080,13000,13000,13055,-135,-80,88,574.60,864
,20170109,13000,13055,13050,13115,12995,13010,13050,-45,-5,172,"1,122.44",904
,20170110,13010,13050,13050,13255,13005,13255,13120,205,70,196,"1,286.13",1014
,20170111,13255,13120,13325,13430,13270,13425,13350,305,230,216,"1,442.06",1142
,20170112,13425,13350,13400,13635,13370,13635,13435,285,85,134,900.21,1128
,20170113,13635,13435,13865,13875,13640,13670,13795,235,360,130,896.90,1070
,20170116,13670,13795,13730,13840,13690,13690,13795,-105,0,122,841.79,1062
,20170117,13690,13795,13815,13840,13660,13700,13760,-95,-35,88,605.49,1066
,20170118,13700,13760,13780,13820,13750,13760,13770,0,10,38,261.69,1062
,20170119,13760,13770,13740,13820,13725,13770,13765,0,-5,26,178.97,1064
,20170120,13770,13765,13785,13830,13720,13720,13755,-45,-10,78,536.50,1112
,20170123,13720,13755,13785,14180,13775,14025,14040,270,285,240,"1,685.20",1094
,20170124,14025,14040,14070,14110,14025,14090,14090,50,50,52,366.36,1050
,20170125,14090,14090,14130,14435,14130,14410,14395,320,305,146,"1,050.88",972
,20170126,14410,14395,14290,14290,14050,14070,14130,-325,-265,48,339.19,968
,20170203,14070,14130,14210,14210,14020,14115,14045,-15,-85,106,744.46,1022
,20170206,14115,14045,14155,14290,14015,14050,14235,5,190,1390,"9,894.28",2060
,20170207,14050,14235,14040,14040,13985,14010,14000,-225,-235,42,294.10,2062
,20170208,14010,14000,14075,14150,14075,14150,14130,150,130,16,113.04,2058
,20170209,14150,14130,14260,14260,14260,14260,14260,130,130,42,299.46,2094
,20170210,14260,14260,14220,14280,14070,14255,14190,-5,-70,46,326.45,2094
,20170213,14255,14190,14320,14545,14320,14420,14410,230,220,76,547.72,2094
,20170214,14420,14410,14480,14740,14480,14740,14580,330,170,94,685.43,2082
,20170215,14740,14580,14820,14820,14580,14675,14685,95,105,42,308.42,2068
,20170216,14675,14685,14620,14900,14620,14640,14750,-45,65,40,295.03,2070
,20170217,14640,14750,14640,14695,14435,14435,14595,-315,-155,66,481.72,2070
,20170220,14435,14595,14415,14585,14345,14530,14490,-65,-105,46,333.31,2094
,20170221,14530,14490,14630,14730,14590,14605,14595,115,105,72,525.48,2044
,20170222,14605,14595,14665,14665,14320,14365,14460,-230,-135,36,260.36,2056
,20170223,14365,14460,14425,14445,14275,14315,14345,-145,-115,60,430.45,2106
,20170224,14315,14345,14310,14325,14020,14280,14245,-65,-100,50,356.15,2106
,20170227,14280,14245,14315,14330,14250,14250,14270,5,25,28,199.79,2106
,20170228,14250,14270,14385,14440,14240,14240,14310,-30,40,166,"1,188.14",2038
,20170301,14240,14310,14300,14715,14300,14640,14540,330,230,260,"1,890.71",2060
,20170302,14640,14540,14740,14740,14525,14535,14565,-5,25,128,932.24,2118
,20170303,14535,14565,14530,14550,14335,14540,14465,-25,-100,42,303.84,2130
,20170306,14540,14465,14415,14415,14265,14265,14310,-200,-155,8,57.24,2136
,20170307,14265,14310,14215,14290,14145,14160,14200,-150,-110,156,"1,107.67",2186
,20170308,14160,14200,14160,14260,14105,14155,14180,-45,-20,210,"1,489.14",2264
,20170309,14155,14180,14035,14120,14030,14065,14065,-115,-115,108,759.72,2258
,20170310,14065,14065,14005,14300,13985,14255,14090,190,25,366,"2,578.73",2076
,20170313,14255,14090,14285,14320,14090,14190,14195,100,105,106,752.42,2072
,20170314,14190,14195,14235,14265,13955,14020,14080,-175,-115,236,"1,661.49",2160
,20170315,14020,14080,13995,14095,13975,14095,14065,15,-15,210,"1,477.24",2062
,20170316,14095,14065,14085,14290,14085,14240,14210,175,145,156,"1,108.74",2074
,20170317,14240,14210,14290,14290,14040,14040,14175,-170,-35,110,779.87,2084
,20170320,14040,14175,14115,14170,13985,14075,14055,-100,-120,1418,"9,968.05",2476
,20170321,14075,14055,14150,14200,14015,14195,14100,140,45,466,"3,286.14",2646
,20170322,14195,14100,14270,14280,14080,14130,14200,30,100,1056,"7,499.81",3252
,20170323,14130,14200,14070,14200,14020,14200,14140,0,-60,94,664.69,3268
,20170324,14200,14140,14085,14130,14045,14050,14070,-90,-70,326,"2,293.77",3186
,20170327,14050,14070,14065,14075,13960,14070,14005,0,-65,556,"3,894.76",3186
,20170328,14070,14005,14015,14075,13960,14030,13985,25,-20,100,699.40,3170
,20170329,14030,13985,14160,14225,14115,14190,14165,205,180,238,"1,685.98",3166
,20170330,14190,14165,14155,14240,14140,14155,14170,-10,5,62,439.36,3150
,20170331,14155,14170,14190,14300,14185,14270,14235,100,65,160,"1,138.86",3160
,20170405,14270,14235,14240,14520,14215,14465,14365,230,130,110,790.31,3164
,20170406,14465,14365,14550,14550,14365,14390,14440,25,75,74,534.44,3168
,20170407,14390,14440,14385,14395,14265,14325,14340,-115,-100,46,329.87,3186
,20170410,14325,14340,14475,14480,14300,14420,14385,80,45,202,"1,453.19",3152
,20170411,14420,14385,14315,14325,14250,14255,14290,-130,-95,140,"1,000.48",3154
,20170412,14255,14290,14295,14395,14215,14305,14335,15,45,488,"3,498.04",3150
,20170413,14305,14335,14205,14400,14205,14360,14315,25,-20,298,"2,133.21",3152
,20170414,14360,14315,14410,14560,14410,14500,14480,185,165,214,"1,549.69",3146
,20170417,14500,14480,14560,15115,14510,14735,14805,255,325,226,"1,673.16",3156
,20170418,14735,14805,14770,14830,14690,14735,14770,-70,-35,648,"4,786.96",3372
,20170419,14735,14770,14765,14780,14465,14615,14590,-155,-180,324,"2,364.16",3354
,20170420,14615,14590,14565,14615,14445,14605,14535,15,-55,234,"1,700.94",3344
,20170421,14605,14535,14655,14735,14605,14615,14650,80,115,282,"2,066.22",3362
,20170424,14615,14650,14570,14620,14500,14560,14545,-90,-105,60,436.43,3388
,20170425,14560,14545,14590,14690,14520,14630,14625,85,80,168,"1,228.69",3398
,20170426,14630,14625,14655,14705,14605,14610,14645,-15,20,420,"3,076.07",3480
,20170427,14610,14645,14615,14635,14560,14595,14595,-50,-50,80,583.83,3492
,20170428,14595,14595,14560,14560,14395,14395,14445,-200,-150,800,"5,778.87",4088
,20170502,14395,14445,14315,14420,14165,14165,14260,-280,-185,176,"1,255.09",4132
,20170503,14165,14260,14205,14280,14200,14280,14250,20,-10,644,"4,589.26",4430
,20170504,14280,14250,14200,14295,14115,14210,14190,-40,-60,664,"4,711.66",4746
,20170505,14210,14190,14205,14280,14155,14210,14250,20,60,506,"3,605.45",4766
,20170508,14210,14250,14225,14260,13980,14035,14090,-215,-160,736,"5,185.93",5142
,20170509,14035,14090,13980,14105,13980,14070,14015,-20,-75,190,"1,331.43",5088
,20170510,14070,14015,14060,14080,14045,14050,14060,35,45,92,646.80,5116
,20170511,14050,14060,14115,14115,13900,14000,13995,-60,-65,2168,"15,174.10",5930
,20170512,14000,13995,14080,14080,13920,14020,14020,25,25,3902,"27,361.03",8312
,20170515,14020,14020,14040,14185,13970,14160,14045,140,25,2572,"18,065.20",8884
,20170516,14160,14045,14170,14205,14055,14110,14125,65,80,5064,"35,770.87",12544
,20170517,14110,14125,14160,14200,14135,14180,14160,55,35,3122,"22,105.65",14330
,20170518,14180,14160,14250,14250,14035,14070,14140,-90,-20,2418,"17,100.33",15436
,20170519,14070,14140,14055,14230,14050,14180,14170,40,30,1156,"8,191.48",15430
,20170522,14180,14170,14310,14310,14135,14150,14190,-20,20,1464,"10,387.99",15414
,20170523,14150,14190,14185,14185,14085,14085,14120,-105,-70,1536,"10,845.99",15526
,20170524,14085,14120,14085,14235,14085,14165,14165,45,45,324,"2,295.40",15504
,20170525,14165,14165,14235,14305,14120,14280,14200,115,35,730,"5,184.18",15668
,20170526,14280,14200,14310,14315,14200,14295,14280,95,80,374,"2,670.90",15670
,20170531,14295,14280,14160,14235,14000,14000,14080,-280,-200,2432,"17,125.02",15768
,20170601,14000,14080,14000,14125,13980,14040,14045,-40,-35,4302,"30,215.88",15568
,20170602,14040,14045,14055,14090,14025,14025,14050,-20,5,880,"6,183.46",15460
,20170605,14025,14050,14000,14100,13935,13990,13985,-60,-65,1142,"7,988.07",15828
,20170606,13990,13985,13940,14000,13900,13920,13935,-65,-50,738,"5,143.61",15924
,20170607,13920,13935,13890,14005,13890,13935,13970,0,35,1458,"10,185.79",15794
,20170608,13935,13970,13950,14025,13925,14015,13995,45,25,3064,"21,445.20",17450
,20170609,14015,13995,14015,14045,13810,13865,13870,-130,-125,3888,"26,972.81",17524
,20170612,13865,13870,13945,14015,13870,13925,13965,55,95,4276,"29,857.69",17824
,20170613,13925,13965,13910,13965,13880,13880,13925,-85,-40,2260,"15,736.17",18796
,20170614,13880,13925,13905,13945,13850,13850,13910,-75,-15,6026,"41,915.79",21472
,20170615,13850,13910,13885,13885,13705,13760,13775,-150,-135,17986,"123,893.53",28684
,20170616,13760,13775,13735,13835,13710,13795,13775,20,0,8358,"57,569.32",29262
,20170619,13795,13775,13825,14005,13775,14000,13905,225,130,2614,"18,174.19",29962
,20170620,14000,13905,14000,14215,13940,14190,14130,285,225,2654,"18,753.37",30086
,20170621,14190,14130,14165,14190,14070,14100,14125,-30,-5,1662,"11,739.10",30018
,20170622,14100,14125,14110,14165,13945,13955,14050,-170,-75,1100,"7,728.33",29720
,20170623,13955,14050,14000,14105,13980,14105,14020,55,-30,820,"5,748.80",29392
,20170626,14105,14020,14085,14085,14020,14065,14050,45,30,754,"5,298.62",29370
,20170627,14065,14050,14030,14120,13925,14120,13980,70,-70,4070,"28,458.33",29606
,20170628,14120,13980,14130,14150,14060,14135,14100,155,120,1484,"10,463.72",29284
,20170629,14135,14100,14100,14200,14095,14170,14150,70,50,1964,"13,899.22",29212
,20170630,14170,14150,14165,14190,14015,14130,14085,-20,-65,4972,"35,027.17",29900
,20170703,14130,14085,14085,14330,14085,14315,14230,230,145,6310,"44,908.78",29760
,20170704,14315,14230,14335,14335,14205,14230,14265,0,35,3832,"27,338.61",30604
,20170705,14230,14265,14220,14410,14220,14355,14360,90,95,4488,"32,232.59",31568
,20170706,14355,14360,14365,14400,14290,14320,14350,-40,-10,7190,"51,605.19",34516
,20170707,14320,14350,14380,14380,14275,14355,14315,5,-35,6784,"48,571.47",36974
,20170710,14355,14315,14275,14365,14265,14280,14325,-35,10,5518,"39,535.67",38120
,20170711,14280,14325,14275,14315,14140,14300,14220,-25,-105,8312,"59,106.51",39188
,20170712,14300,14220,14280,14415,14260,14355,14360,135,140,13048,"93,710.60",38886
,20170713,14355,14360,14370,14485,14345,14455,14435,95,75,6984,"50,423.28",40122
,20170714,14455,14435,14525,14680,14480,14525,14575,90,140,9846,"71,755.87",40940
,20170717,14525,14575,14505,14705,14505,14670,14650,95,75,19814,"145,180.98",44292
,20170718,14670,14650,14660,14670,14460,14520,14550,-130,-100,10376,"75,494.08",45322
,20170719,14520,14550,14510,14650,14510,14635,14590,85,40,10218,"74,550.11",45838
,20170720,14635,14590,14635,14705,14555,14585,14630,-5,40,15556,"113,822.19",48286
,20170721,14585,14630,14595,14660,14520,14595,14610,-35,-20,12098,"88,388.27",50360
,20170724,14595,14610,14620,14670,14535,14625,14590,15,-20,7412,"54,076.35",51336
,20170725,14625,14590,14605,14750,14565,14730,14700,140,110,15758,"115,827.09",55376
,20170726,14730,14700,14745,14805,14660,14700,14730,0,30,27604,"203,348.45",64456
,20170727,14700,14730,14675,14720,14585,14625,14645,-105,-85,19270,"141,110.64",68490
,20170728,14625,14645,14660,14710,14480,14560,14580,-85,-65,22186,"161,760.73",71774
,20170731,14560,14580,14540,14730,14490,14725,14575,145,-5,31540,"229,907.92",81572
,20170801,14725,14575,14760,14765,14575,14600,14640,25,65,27752,"203,169.11",84370
,20170802,14600,14640,14590,15020,14570,14940,14835,300,195,52806,"391,754.31",97028
,20170803,14940,14835,14930,15010,14745,14750,14875,-85,40,55040,"409,446.23",101516
,20170804,14750,14875,14795,14935,14755,14855,14845,-20,-30,59908,"444,796.50",103066
,20170807,14855,14845,14865,15400,14810,15230,15135,385,290,103024,"779,835.94",119860
,20170808,15230,15135,15265,15700,15260,15515,15530,380,395,143210,"1,112,207.47",136504
,20170809,15515,15530,15585,16405,15550,16270,16115,740,585,217954,"1,756,227.38",156384
,20170810,16270,16115,16275,16535,16010,16180,16265,65,150,239840,"1,951,093.67",176754
,20170811,16180,16265,16200,16360,16030,16165,16170,-100,-95,232412,"1,879,479.24",194034
,20170814,16165,16170,16280,16325,15790,15880,16045,-290,-125,254504,"2,042,112.76",200864
,20170815,15880,16045,15905,15990,15685,15895,15865,-150,-180,169958,"1,348,395.38",205588
,20170816,15895,15865,16010,16315,15925,16185,16140,320,275,211754,"1,709,323.58",226768
,20170817,16185,16140,16285,16750,16240,16615,16545,475,405,311438,"2,576,896.82",251814
,20170818,16615,16545,16505,16535,16200,16440,16385,-105,-160,235506,"1,929,663.62",262416
,20170821,16440,16385,16515,16680,16280,16530,16470,145,85,272790,"2,246,674.87",290068
,20170822,16530,16470,16530,16620,16350,16480,16480,10,10,188666,"1,555,027.43",303486
,20170823,16480,16480,16520,16580,16190,16295,16340,-185,-140,225556,"1,843,218.42",301934
,20170824,16295,16340,16400,16845,16355,16555,16640,215,300,395390,"3,290,498.44",333786
,20170825,16555,16640,16520,16750,16510,16705,16645,65,5,263398,"2,192,505.26",364762
,20170828,16705,16645,16655,16700,16300,16450,16480,-195,-165,283892,"2,339,787.03",370964
,20170829,16450,16480,16445,16540,16275,16340,16385,-140,-95,200306,"1,641,499.25",376020
,20170830,16340,16385,16465,16525,16305,16485,16405,100,20,261546,"2,145,897.79",399692
,20170831,16485,16405,16405,16595,16315,16560,16475,155,70,277648,"2,287,760.54",416252
,20170901,16560,16475,16795,16820,16605,16770,16705,295,230,341804,"2,855,056.78",440952
,20170904,16770,16705,16705,16935,16565,16585,16750,-120,45,570088,"4,775,130.42",442318
,20170905,16585,16750,16540,16665,16510,16565,16590,-185,-160,345510,"2,866,127.45",445378
,20170906,16565,16590,16535,16605,16315,16385,16445,-205,-145,415376,"3,415,765.36",436660
,20170907,16385,16445,16435,16475,16150,16150,16325,-295,-120,459624,"3,752,219.24",411738
,20170908,16150,16325,16225,16300,15785,15870,16100,-455,-225,500004,"4,025,335.81",392292
,20170911,15870,16100,15945,16550,15805,16530,16100,430,0,614164,"4,944,305.93",396534
,20170912,16530,16100,16530,16645,16485,16610,16575,510,475,519582,"4,307,165.95",413206
,20170913,16610,16575,16505,16780,16505,16560,16655,-15,80,468312,"3,900,838.46",415856
,20170914,16560,16655,16465,16670,16365,16590,16540,-65,-115,532280,"4,402,376.25",425678
,20170915,16590,16540,16575,16615,16220,16250,16415,-290,-125,515924,"4,234,870.89",407888
,20170918,16250,16415,16265,16465,16080,16370,16275,-45,-140,531816,"4,328,790.80",409402
,20170919,16370,16275,16380,16640,16305,16490,16500,215,225,517316,"4,268,608.48",421014
,20170920,16490,16500,16605,17145,16410,17055,16775,555,275,806514,"6,765,946.27",481690
,20170921,17055,16775,17130,17250,16705,16790,16960,15,185,791492,"6,712,056.06",451692
,20170922,16790,16960,16865,17125,16205,16410,16605,-550,-355,1008974,"8,378,096.38",392016
,20170925,16410,16605,16550,16680,16335,16420,16470,-185,-135,718406,"5,917,598.56",371886
,20170926,16420,16470,16485,16620,16410,16510,16515,40,45,458578,"3,786,941.02",336078
,20170927,16510,16515,16400,16550,16320,16490,16435,-25,-80,419272,"3,445,948.83",306690
,20170928,16490,16435,16520,16530,16240,16310,16380,-125,-55,452568,"3,706,811.15",271854
,20170929,16310,16380,16340,16405,16180,16345,16305,-35,-75,386486,"3,151,529.50",231372
,20171009,16345,16305,16420,16600,16365,16580,16510,275,205,204808,"1,690,712.39",217166
,20171010,16580,16510,16600,16700,16330,16360,16565,-150,55,210434,"1,743,063.48",198830
,20171011,16360,16565,16290,16450,16150,16235,16315,-330,-250,147240,"1,201,468.21",180972
,20171012,16235,16315,16225,16420,16130,16355,16265,40,-50,109910,"893,921.65",171062
,20171013,16355,16265,16360,16570,16315,16555,16465,290,200,96554,"794,962.66",163924
,20171016,16555,16465,16560,16595,16300,16370,16440,-95,-25,79246,"651,470.69",153886
,20171017,16370,16440,16395,16505,16205,16265,16320,-175,-120,55856,"455,859.36",148096
,20171018,16265,16320,16310,16320,15980,15990,16120,-330,-200,72464,"584,217.80",137992
,20171019,15990,16120,16010,16165,15835,16060,15995,-60,-125,48672,"389,273.76",133800
,20171020,16060,15995,16105,16310,16005,16245,16185,250,190,39432,"319,191.87",127668
,20171023,16245,16185,16240,16245,16070,16145,16180,-40,-5,30268,"244,900.61",122542
,20171024,16145,16180,16145,16280,16115,16175,16205,-5,25,25364,"205,547.73",116704
,20171025,16175,16205,16215,16320,16140,16165,16230,-40,25,31310,"254,144.17",108958
,20171026,16165,16230,16185,16450,16185,16400,16365,170,135,47126,"385,721.26",91688
,20171027,16400,16365,16370,16395,16165,16175,16290,-190,-75,29528,"240,538.55",85426
,20171030,16175,16290,16120,16265,16110,16195,16195,-95,-95,38310,"310,251.92",74634
,20171031,16195,16195,16200,16230,16125,16185,16175,-10,-20,28946,"234,143.77",64180
,20171101,16185,16175,16115,16360,16050,16050,16220,-125,45,12980,"105,285.20",61130
,20171102,16050,16220,16050,16125,15995,16080,16045,-140,-175,6400,"51,350.10",59560
,20171103,16080,16045,16060,16095,16000,16055,16045,10,0,6710,"53,844.15",59950
,20171106,16055,16045,16055,16140,15880,15975,15955,-70,-90,9050,"72,203.78",60030
,20171107,15975,15955,15975,15995,15790,15855,15895,-100,-60,16700,"132,728.80",56590
,20171108,15855,15895,15800,15820,15630,15675,15705,-220,-190,11910,"93,542.40",55780
,20171109,15675,15705,15640,15640,15160,15290,15370,-415,-335,15770,"121,211.75",54800
,20171110,15290,15370,15300,15400,15300,15320,15340,-50,-30,12120,"92,968.73",52290
,20171113,15320,15340,15380,15420,15325,15370,15380,30,40,6290,"48,377.10",48100
,20171114,15370,15380,15340,15435,15255,15305,15325,-75,-55,5950,"45,596.58",44060
,20171115,15305,15325,15330,15440,15155,15295,15265,-30,-60,10330,"78,853.48",40870
al1712,20170103,13430,13380,13250,13280,13225,13225,13260,-155,-120,136,901.91,478
,20170104,13225,13260,13240,13240,13130,13200,13185,-60,-75,98,646.18,542
,20170105,13200,13185,13245,13250,13175,13175,13225,-10,40,26,171.97,562
,20170106,13175,13225,13130,13135,13030,13100,13060,-125,-165,166,"1,084.01",708
,20170109,13100,13060,13100,13130,13050,13050,13090,-10,30,282,"1,845.93",948
,20170110,13050,13090,13090,13330,13080,13330,13220,240,130,114,753.74,954
,20170111,13330,13220,13380,13465,13300,13460,13360,240,140,288,"1,923.90",1108
,20170112,13460,13360,13455,13625,13390,13625,13435,265,75,324,"2,177.19",1292
,20170113,13625,13435,13915,13935,13680,13730,13820,295,385,108,746.35,1342
,20170116,13730,13820,13755,13865,13735,13735,13800,-85,-20,114,786.71,1372
,20170117,13735,13800,13840,13880,13680,13680,13810,-120,10,74,511.08,1378
,20170118,13680,13810,13755,13840,13720,13800,13785,-10,-25,40,275.71,1392
,20170119,13800,13785,13760,13850,13740,13760,13780,-25,-5,44,303.19,1408
,20170120,13760,13780,13815,13845,13785,13795,13815,15,35,18,124.36,1412
,20170123,13795,13815,13835,14290,13805,14040,14025,225,210,88,617.12,1430
,20170124,14040,14025,14040,14105,14005,14105,14050,80,25,6,42.15,1432
,20170125,14105,14050,14275,14435,14275,14410,14380,360,330,70,503.41,1460
,20170126,14410,14380,14280,14280,14030,14125,14145,-255,-235,30,212.21,1464
,20170203,14125,14145,14160,14195,14090,14165,14145,20,0,126,891.37,1476
,20170206,14165,14145,14395,14395,14090,14090,14280,-55,135,352,"2,513.79",1646
,20170207,14090,14280,14115,14115,14010,14065,14030,-215,-250,78,547.31,1650
,20170208,14065,14030,,,,14030,14030,0,0,0,0.00,1650
,20170209,14030,14030,14220,14250,14220,14250,14240,220,210,12,85.47,1638
,20170210,14250,14240,14205,14270,14085,14255,14175,15,-65,30,212.63,1634
,20170213,14255,14175,14360,14360,14360,14360,14360,185,185,4,28.72,1630
,20170214,14360,14360,14570,14765,14565,14745,14590,385,230,52,379.43,1640
,20170215,14745,14590,14660,14805,14545,14670,14770,80,180,108,797.78,1694
,20170216,14670,14770,14695,14880,14695,14770,14785,0,15,8,59.15,1694
,20170217,14770,14785,14700,14750,14445,14445,14530,-340,-255,48,348.83,1682
,20170220,14445,14530,14435,14570,14355,14570,14500,40,-30,50,362.57,1708
,20170221,14570,14500,14675,14790,14650,14650,14685,150,185,26,190.94,1690
,20170222,14650,14685,14480,14545,14355,14400,14460,-285,-225,20,144.64,1692
,20170223,14400,14460,14495,14495,14280,14285,14330,-175,-130,20,143.33,1698
,20170224,14285,14330,14355,14355,14070,14340,14140,10,-190,146,"1,032.38",1732
,20170227,14340,14140,14300,14410,14300,14330,14345,190,205,10,71.75,1734
,20170228,14330,14345,14425,14465,14295,14305,14440,-40,95,96,693.27,1676
,20170301,14305,14440,14345,14770,14340,14660,14615,220,175,52,380.03,1676
,20170302,14660,14615,14745,14745,14585,14585,14690,-30,75,42,308.54,1668
,20170303,14585,14690,14515,14585,14495,14585,14550,-105,-140,10,72.77,1668
,20170306,14585,14550,14490,14490,14365,14370,14420,-180,-130,14,100.94,1668
,20170307,14370,14420,14315,14315,14225,14225,14245,-195,-175,190,"1,353.65",1668
,20170308,14225,14245,14250,14380,14165,14185,14235,-60,-10,28,199.33,1664
,20170309,14185,14235,14250,14250,14105,14145,14135,-90,-100,288,"2,035.71",1678
,20170310,14145,14135,14155,14345,14055,14310,14240,175,105,52,370.27,1672
,20170313,14310,14240,14400,14415,14130,14235,14255,-5,15,28,199.57,1668
,20170314,14235,14255,14250,14270,14035,14035,14180,-220,-75,226,"1,602.41",1654
,20170315,14035,14180,14035,14170,14020,14135,14090,-45,-90,118,831.51,1642
,20170316,14135,14090,14235,14340,14170,14250,14245,160,155,100,712.36,1618
,20170317,14250,14245,14340,14340,14085,14085,14235,-160,-10,76,541.09,1622
,20170320,14085,14235,14165,14225,14015,14095,14120,-140,-115,232,"1,638.20",1650
,20170321,14095,14120,14160,14255,14050,14255,14175,135,55,272,"1,928.21",1700
,20170322,14255,14175,14340,14340,14115,14120,14190,-55,15,132,936.84,1700
,20170323,14120,14190,14115,14255,14090,14250,14170,60,-20,144,"1,020.30",1672
,20170324,14250,14170,14125,14155,14080,14080,14125,-90,-45,68,480.35,1676
,20170327,14080,14125,14070,14095,13995,14065,14045,-60,-80,100,702.36,1688
,20170328,14065,14045,13985,14120,13985,14060,14065,15,20,26,182.86,1690
,20170329,14060,14065,14085,14295,14080,14225,14175,160,110,202,"1,431.77",1642
,20170330,14225,14175,14190,14285,14160,14185,14230,10,55,44,313.07,1620
,20170331,14185,14230,14225,14375,14175,14335,14290,105,60,204,"1,457.86",1598
,20170405,14335,14290,14330,14555,14330,14520,14495,230,205,68,492.83,1592
,20170406,14520,14495,14595,14595,14410,14425,14450,-70,-45,86,621.47,1600
,20170407,14425,14450,14420,14420,14270,14390,14360,-60,-90,44,315.96,1596
,20170410,14390,14360,14295,14540,14295,14420,14445,60,85,170,"1,227.97",1568
,20170411,14420,14445,14400,14400,14250,14285,14315,-160,-130,88,630.00,1600
,20170412,14285,14315,14380,14435,14250,14325,14330,10,15,156,"1,118.11",1608
,20170413,14325,14330,14220,14500,14220,14470,14350,140,20,104,746.41,1634
,20170414,14470,14350,14455,14560,14425,14515,14480,165,130,66,477.85,1640
,20170417,14515,14480,14600,15110,14540,14745,14945,265,465,1436,"10,733.20",2618
,20170418,14745,14945,14875,14875,14750,14805,14795,-140,-150,1090,"8,065.43",3132
,20170419,14805,14795,14815,14820,14480,14635,14610,-160,-185,464,"3,390.53",3066
,20170420,14635,14610,14650,14670,14480,14670,14625,60,15,1026,"7,502.81",2652
,20170421,14670,14625,14720,14800,14640,14640,14715,15,90,974,"7,167.53",2814
,20170424,14640,14715,14570,14700,14510,14645,14575,-70,-140,82,597.76,2836
,20170425,14645,14575,14620,14725,14580,14635,14655,60,80,162,"1,187.41",2712
,20170426,14635,14655,14680,14765,14610,14630,14670,-25,15,356,"2,611.41",2736
,20170427,14630,14670,14625,14635,14580,14620,14590,-50,-80,78,569.10,2760
,20170428,14620,14590,14580,14580,14400,14400,14485,-190,-105,232,"1,680.40",2778
,20170502,14400,14485,14350,14440,14165,14185,14310,-300,-175,438,"3,134.83",2714
,20170503,14185,14310,14255,14310,14235,14300,14285,-10,-25,166,"1,185.93",2756
,20170504,14300,14285,14215,14335,14145,14240,14220,-45,-65,74,526.29,2756
,20170505,14240,14220,14240,14310,14180,14270,14280,50,60,230,"1,642.61",2622
,20170508,14270,14280,14235,14255,14020,14095,14135,-185,-145,126,890.64,2648
,20170509,14095,14135,14000,14115,14000,14050,14035,-85,-100,38,266.74,2648
,20170510,14050,14035,14160,14160,14060,14110,14105,75,70,172,"1,213.05",2618
,20170511,14110,14105,14150,14160,13955,14050,14045,-55,-60,192,"1,348.44",2686
,20170512,14050,14045,14145,14145,13970,14080,14060,35,15,184,"1,293.55",2744
,20170515,14080,14060,14085,14215,13990,14185,14125,125,65,84,593.32,2718
,20170516,14185,14125,14150,14160,14135,14140,14150,15,25,56,396.32,2758
,20170517,14140,14150,14190,14210,14180,14195,14190,45,40,228,"1,617.66",2874
,20170518,14195,14190,14185,14205,14090,14130,14145,-60,-45,68,481.03,2884
,20170519,14130,14145,14210,14215,14210,14210,14210,65,65,14,99.50,2874
,20170522,14210,14210,14260,14285,14180,14200,14225,-10,15,156,"1,109.72",2932
,20170523,14200,14225,14215,14215,14150,14150,14170,-75,-55,18,127.53,2916
,20170524,14150,14170,14175,14250,14155,14185,14190,15,20,30,212.88,2910
,20170525,14185,14190,14165,14320,14140,14310,14200,120,10,326,"2,314.60",2942
,20170526,14310,14200,14310,14340,14285,14285,14320,85,120,288,"2,062.49",3156
,20170531,14285,14320,14260,14260,14040,14040,14125,-280,-195,100,706.43,3130
,20170601,14040,14125,13975,14150,13975,14135,14080,10,-45,742,"5,223.99",3624
,20170602,14135,14080,14105,14135,14055,14075,14090,-5,10,62,436.93,3612
,20170605,14075,14090,14075,14145,14005,14025,14020,-65,-70,1366,"9,577.24",4750
,20170606,14025,14020,14000,14000,13945,13965,13970,-55,-50,40,279.46,4754
,20170607,13965,13970,13975,14030,13975,13975,13985,5,15,102,713.48,4770
,20170608,13975,13985,13990,14065,13990,14065,14050,80,65,190,"1,334.78",4764
,20170609,14065,14050,14020,14075,13850,13900,13925,-150,-125,582,"4,052.78",4926
,20170612,13900,13925,14035,14060,13950,13975,13990,50,65,1076,"7,529.28",5096
,20170613,13975,13990,13960,14010,13920,13920,13970,-70,-20,112,782.36,5096
,20170614,13920,13970,13965,14005,13915,13925,13965,-45,-5,574,"4,009.04",4968
,20170615,13925,13965,13915,13935,13750,13885,13830,-80,-135,1476,"10,209.29",5232
,20170616,13885,13830,13800,13890,13760,13850,13835,20,5,540,"3,736.15",5320
,20170619,13850,13835,13865,14055,13840,14050,13970,215,135,228,"1,592.95",5330
,20170620,14050,13970,14020,14255,14020,14210,14130,240,160,308,"2,176.67",5260
,20170621,14210,14130,14235,14235,14115,14120,14150,-10,20,198,"1,400.90",5256
,20170622,14120,14150,14165,14215,14000,14005,14100,-145,-50,182,"1,283.43",5134
,20170623,14005,14100,14055,14110,14030,14110,14060,10,-40,40,281.29,5128
,20170626,14110,14060,14125,14125,14080,14115,14100,55,40,46,324.32,5106
,20170627,14115,14100,14020,14165,13995,14165,14035,65,-65,2100,"14,740.73",5878
,20170628,14165,14035,14190,14205,14135,14180,14150,145,115,556,"3,935.04",6146
,20170629,14180,14150,14185,14250,14160,14225,14185,75,35,172,"1,220.32",6166
,20170630,14225,14185,14225,14230,14065,14200,14165,15,-20,1712,"12,128.46",7006
,20170703,14200,14165,14205,14380,14205,14365,14260,200,95,712,"5,078.33",7260
,20170704,14365,14260,14370,14370,14270,14285,14325,25,65,1280,"9,170.70",7688
,20170705,14285,14325,14330,14460,14300,14430,14415,105,90,534,"3,849.57",7620
,20170706,14430,14415,14415,14460,14360,14370,14410,-45,-5,392,"2,824.41",7698
,20170707,14370,14410,14400,14420,14340,14400,14370,-10,-40,1118,"8,033.26",8228
,20170710,14400,14370,14420,14420,14335,14350,14395,-20,25,1372,"9,875.82",8818
,20170711,14350,14395,14310,14390,14205,14365,14290,-30,-105,5488,"39,213.29",11660
,20170712,14365,14290,14365,14475,14350,14430,14435,140,145,5062,"36,545.01",13394
,20170713,14430,14435,14440,14555,14420,14520,14510,85,75,828,"6,007.32",13306
,20170714,14520,14510,14645,14745,14550,14595,14635,85,125,1936,"14,168.15",12926
,20170717,14595,14635,14570,14765,14570,14750,14720,115,85,1652,"12,161.26",13136
,20170718,14750,14720,14725,14735,14530,14590,14605,-130,-115,4370,"31,914.56",15120
,20170719,14590,14605,14595,14720,14595,14690,14690,85,85,2868,"21,068.21",14530
,20170720,14690,14690,14700,14765,14640,14650,14710,-40,20,1656,"12,183.80",14762
,20170721,14650,14710,14680,14720,14605,14670,14690,-40,-20,3436,"25,238.73",16058
,20170724,14670,14690,14695,14735,14615,14690,14655,0,-35,2956,"21,666.38",17594
,20170725,14690,14655,14675,14820,14640,14800,14750,145,95,2208,"16,289.31",18228
,20170726,14800,14750,14810,14875,14730,14760,14800,10,50,9836,"72,809.93",21162
,20170727,14760,14800,14765,14785,14655,14690,14705,-110,-95,3636,"26,742.71",22980
,20170728,14690,14705,14730,14780,14565,14650,14635,-55,-70,4858,"35,560.36",23750
,20170731,14650,14635,14625,14805,14575,14800,14640,165,5,3354,"24,556.63",24186
,20170801,14800,14640,14850,14850,14665,14670,14710,30,70,3260,"23,983.86",24654
,20170802,14670,14710,14675,15095,14650,15025,14945,315,235,5066,"37,857.79",25814
,20170803,15025,14945,15045,15090,14840,14860,14950,-85,5,9064,"67,756.59",27952
,20170804,14860,14950,14860,15015,14845,14940,14935,-10,-15,16396,"122,440.47",33550
,20170807,14940,14935,14920,15480,14905,15305,15240,370,305,36836,"280,693.60",40340
,20170808,15305,15240,15355,15765,15325,15590,15600,350,360,55256,"431,070.29",49316
,20170809,15590,15600,15675,16470,15625,16330,16190,730,590,49042,"397,024.17",52372
,20170810,16330,16190,16305,16595,16100,16245,16340,55,150,58564,"478,606.61",58312
,20170811,16245,16340,16260,16425,16110,16250,16245,-90,-95,48544,"394,311.45",61534
,20170814,16250,16245,16340,16400,15875,15960,16130,-285,-115,50782,"409,607.58",66830
,20170815,15960,16130,16005,16075,15775,15995,15955,-135,-175,37304,"297,642.57",72140
,20170816,15995,15955,16145,16395,16010,16265,16230,310,275,43110,"349,851.76",76466
,20170817,16265,16230,16400,16830,16330,16690,16655,460,425,77328,"644,100.61",92342
,20170818,16690,16655,16560,16615,16280,16530,16465,-125,-190,70666,"581,772.56",104724
,20170821,16530,16465,16600,16755,16355,16615,16545,150,80,59566,"492,887.63",109824
,20170822,16615,16545,16615,16695,16420,16555,16555,10,10,47044,"389,422.83",118122
,20170823,16555,16555,16570,16650,16270,16370,16425,-185,-130,56064,"460,518.37",119202
,20170824,16370,16425,16455,16910,16440,16620,16700,195,275,100404,"838,482.99",136436
,20170825,16620,16700,16510,16800,16510,16780,16690,80,-10,78336,"653,807.82",143820
,20170828,16780,16690,16680,16760,16360,16510,16530,-180,-160,76284,"630,633.10",146238
,20170829,16510,16530,16520,16600,16340,16395,16455,-135,-75,60252,"495,813.55",144164
,20170830,16395,16455,16525,16590,16375,16560,16480,105,25,84822,"699,042.50",150310
,20170831,16560,16480,16465,16665,16395,16635,16550,155,70,72296,"598,267.60",155772
,20170901,16635,16550,16785,16895,16685,16865,16780,315,230,78228,"656,374.52",163588
,20170904,16865,16780,16800,17010,16645,16670,16825,-110,45,146540,"1,233,104.44",170254
,20170905,16670,16825,16625,16740,16555,16630,16660,-195,-165,80888,"673,935.77",171122
,20170906,16630,16660,16600,16675,16405,16465,16525,-195,-135,84234,"695,986.24",176454
,20170907,16465,16525,16505,16560,16230,16235,16405,-290,-120,116500,"955,647.50",185440
,20170908,16235,16405,16250,16370,15845,15950,16155,-455,-250,145746,"1,177,553.01",181844
,20170911,15950,16155,16000,16620,15910,16615,16180,460,25,181026,"1,464,514.86",183968
,20170912,16615,16180,16590,16725,16575,16705,16660,525,480,186930,"1,557,499.46",206428
,20170913,16705,16660,16635,16880,16605,16670,16760,10,100,185200,"1,552,323.87",222344
,20170914,16670,16760,16575,16765,16460,16680,16630,-80,-130,197490,"1,642,341.70",225260
,20170915,16680,16630,16700,16720,16320,16340,16505,-290,-125,197220,"1,627,934.20",220768
,20170918,16340,16505,16335,16555,16180,16475,16375,-30,-130,200388,"1,640,849.99",220288
,20170919,16475,16375,16460,16720,16400,16580,16590,205,215,210466,"1,746,283.89",237000
,20170920,16580,16590,16715,17220,16510,17135,16860,545,270,320478,"2,701,904.38",279942
,20170921,17135,16860,17200,17320,16810,16885,17050,25,190,320938,"2,736,612.25",307194
,20170922,16885,17050,17000,17220,16300,16495,16695,-555,-355,501518,"4,187,319.99",313212
,20170925,16495,16695,16650,16775,16445,16510,16570,-185,-125,350332,"2,902,804.81",342730
,20170926,16510,16570,16620,16710,16505,16625,16615,55,45,241492,"2,006,338.85",358368
,20170927,16625,16615,16490,16650,16435,16600,16540,-15,-75,262022,"2,167,318.19",383026
,20170928,16600,16540,16640,16640,16350,16415,16480,-125,-60,272312,"2,244,431.31",402770
,20170929,16415,16480,16460,16500,16290,16445,16410,-35,-70,262306,"2,152,354.57",404826
,20171009,16445,16410,16525,16705,16470,16685,16615,275,205,228044,"1,894,963.96",426470
,20171010,16685,16615,16685,16820,16450,16460,16660,-155,45,420482,"3,503,580.35",449328
,20171011,16460,16660,16380,16560,16245,16330,16410,-330,-250,420896,"3,453,906.70",460506
,20171012,16330,16410,16310,16520,16230,16450,16365,40,-45,385382,"3,153,651.62",448520
,20171013,16450,16365,16460,16680,16415,16670,16570,305,205,413884,"3,429,071.06",462360
,20171016,16670,16570,16650,16700,16395,16470,16540,-100,-30,427222,"3,534,084.21",448776
,20171017,16470,16540,16525,16605,16290,16350,16425,-190,-115,410098,"3,368,354.99",458984
,20171018,16350,16425,16410,16415,16060,16080,16220,-345,-205,444652,"3,606,134.65",458912
,20171019,16080,16220,16100,16255,15910,16150,16080,-70,-140,411678,"3,310,542.72",442524
,20171020,16150,16080,16180,16395,16085,16325,16255,245,175,325658,"2,646,983.56",435452
,20171023,16325,16255,16310,16330,16145,16240,16250,-15,-5,307272,"2,497,259.86",411570
,20171024,16240,16250,16215,16370,16190,16260,16275,10,25,232518,"1,892,637.92",408380
,20171025,16260,16275,16305,16420,16225,16270,16320,-5,45,300890,"2,455,718.19",383892
,20171026,16270,16320,16320,16555,16275,16490,16445,170,125,352640,"2,899,662.21",345850
,20171027,16490,16445,16450,16485,16245,16265,16370,-180,-75,293630,"2,403,966.67",312454
,20171030,16265,16370,16230,16355,16190,16275,16275,-95,-95,289986,"2,360,156.28",289886
,20171031,16275,16275,16260,16315,16205,16265,16265,-10,-10,285346,"2,320,899.31",259314
,20171101,16265,16265,16185,16470,16125,16130,16295,-135,30,307894,"2,508,609.47",238878
,20171102,16130,16295,16230,16255,16075,16150,16155,-145,-140,169054,"1,365,759.84",224834
,20171103,16150,16155,16150,16195,16075,16140,16135,-15,-20,78832,"636,095.56",217974
,20171106,16140,16135,16170,16240,15945,16060,16075,-75,-60,99448,"799,546.36",211370
,20171107,16060,16075,16075,16090,15870,15930,16000,-145,-75,91252,"730,042.00",198744
,20171108,15930,16000,15900,15940,15710,15765,15805,-235,-195,102536,"810,510.98",179474
,20171109,15765,15805,15695,15745,15240,15390,15475,-415,-330,132828,"1,027,811.35",155160
,20171110,15390,15475,15350,15500,15345,15430,15430,-45,-45,59610,"459,917.02",150370
,20171113,15430,15430,15475,15535,15405,15470,15475,40,45,31686,"245,183.92",148830
,20171114,15470,15475,15485,15550,15340,15365,15435,-110,-40,34232,"264,217.21",142208
,20171115,15365,15435,15415,15565,15250,15380,15380,-55,-55,61862,"475,815.85",130582
,20171116,15380,15380,15425,15535,15360,15385,15435,5,55,28568,"220,481.43",127354
,20171117,15385,15435,15465,15465,15255,15315,15355,-120,-80,20900,"160,507.41",123786
,20171120,15315,15355,15300,15405,14985,15035,15170,-320,-185,42542,"322,782.03",117676
,20171121,15035,15170,15040,15070,14770,14810,14910,-360,-260,39628,"295,431.76",110100
,20171122,14810,14910,14820,14905,14715,14890,14825,-20,-85,27842,"206,411.75",107840
,20171123,14890,14825,14920,15065,14875,14910,14955,85,130,40540,"303,183.41",97782
,20171124,14910,14955,14950,15000,14855,14975,14920,20,-35,26872,"200,531.02",92778
,20171127,14975,14920,14995,15045,14790,14820,14930,-100,10,36848,"275,143.86",85528
,20171128,14820,14930,15640,15640,14185,14645,14770,-285,-160,31494,"232,599.98",79034
,20171129,14645,14770,14690,14720,14470,14510,14560,-260,-210,23882,"173,916.37",74386
,20171130,14510,14560,14470,14610,14220,14605,14345,45,-215,42216,"302,803.03",70744
,20171201,14605,14345,14565,14565,14420,14485,14475,140,130,13094,"94,787.43",72150
,20171204,14485,14475,14485,14760,14300,14420,14490,-55,15,13840,"100,302.10",71520
,20171205,14420,14490,14440,14570,14385,14420,14485,-70,-5,14500,"105,025.25",70570
,20171206,14420,14485,14435,14435,14100,14170,14195,-315,-290,12360,"87,735.55",70110
,20171207,14170,14195,14140,14195,13940,13990,14030,-205,-165,12150,"85,239.58",73010
,20171208,13990,14030,14015,14155,13975,14095,14055,65,25,8720,"61,297.00",73230
,20171211,14095,14055,14055,14150,14000,14010,14085,-45,30,10780,"75,925.95",71720
,20171212,14010,14085,13995,14165,13995,14025,14050,-60,-35,12080,"84,887.08",73590
,20171213,14025,14050,14055,14080,13900,14020,14035,-30,-15,5560,"39,023.23",71640
,20171214,14020,14035,14050,14100,14000,14050,14050,15,15,7300,"51,292.83",69710
,20171215,14050,14050,14080,14265,14075,14260,14165,210,115,11260,"79,768.83",68040
al1801,20170117,13800,13800,13870,14020,13680,13740,13840,-60,40,52,359.89,32
,20170118,13740,13840,13825,13825,13770,13780,13790,-60,-50,6,41.38,32
,20170119,13780,13790,13795,13850,13770,13835,13815,45,25,42,290.17,38
,20170120,13835,13815,13825,13860,13780,13860,13820,45,5,14,96.77,38
,20170123,13860,13820,13855,14160,13855,14075,14045,255,225,86,603.97,78
,20170124,14075,14045,14105,14105,14015,14100,14070,55,25,8,56.29,76
,20170125,14100,14070,14285,14480,14285,14440,14405,370,335,32,230.52,88
,20170126,14440,14405,14345,14345,14020,14235,14170,-170,-235,30,212.61,86
,20170203,14235,14170,14185,14250,14075,14115,14130,-55,-40,22,155.48,94
,20170206,14115,14130,14295,14410,14130,14130,14280,0,150,86,614.24,150
,20170207,14130,14280,14185,14215,14020,14135,14130,-145,-150,18,127.21,152
,20170208,14135,14130,14120,14240,14120,14175,14190,45,60,42,298.04,164
,20170209,14175,14190,14225,14475,14165,14165,14305,-25,115,70,500.78,198
,20170210,14165,14305,14300,14300,14150,14300,14210,-5,-95,52,369.58,196
,20170213,14300,14210,14325,14485,14325,14445,14435,235,225,52,375.42,212
,20170214,14445,14435,14495,14805,14495,14800,14630,365,195,274,"2,004.35",422
,20170215,14800,14630,14860,14870,14725,14845,14795,215,165,70,517.97,440
,20170216,14845,14795,14700,14940,14625,14685,14800,-110,5,50,370.03,448
,20170217,14685,14800,14700,14760,14440,14495,14570,-305,-230,108,786.93,448
,20170220,14495,14570,14405,14660,14360,14535,14490,-35,-80,54,391.30,464
,20170221,14535,14490,14655,14905,14610,14685,14690,195,200,38,279.14,458
,20170222,14685,14690,14690,14760,14435,14465,14535,-225,-155,38,276.24,466
,20170223,14465,14535,14450,14540,14330,14335,14420,-200,-115,84,605.85,452
,20170224,14335,14420,14410,14450,14060,14355,14215,-65,-205,186,"1,322.18",560
,20170227,14355,14215,14370,14475,14265,14470,14415,255,200,14,100.93,562
,20170228,14470,14415,14490,14600,14285,14360,14385,-55,-30,128,920.72,614
,20170301,14360,14385,14375,14790,14375,14670,14650,285,265,268,"1,963.73",700
,20170302,14670,14650,14755,14820,14650,14650,14760,0,110,28,206.65,704
,20170303,14650,14760,14605,14665,14570,14630,14630,-130,-130,36,263.42,708
,20170306,14630,14630,14675,14675,14170,14360,14425,-270,-205,88,634.91,698
,20170307,14360,14425,14330,14390,14300,14300,14325,-125,-100,32,229.25,688
,20170308,14300,14325,14300,14465,14215,14220,14265,-105,-60,34,242.52,690
,20170309,14220,14265,14200,14205,14105,14185,14170,-80,-95,56,396.84,702
,20170310,14185,14170,14185,14435,14185,14410,14280,240,110,78,557.09,718
,20170313,14410,14280,14425,14480,14200,14300,14310,20,30,90,644.14,730
,20170314,14300,14310,14180,14200,14075,14100,14095,-210,-215,162,"1,142.03",780
,20170315,14100,14095,14200,14230,14120,14160,14165,65,70,72,510.04,818
,20170316,14160,14165,14240,14390,14240,14355,14310,190,145,38,271.92,830
,20170317,14355,14310,14335,14340,14135,14160,14240,-150,-70,70,498.49,850
,20170320,14160,14240,14270,14270,14095,14115,14165,-125,-75,44,311.73,860
,20170321,14115,14165,14155,14300,14075,14300,14225,135,60,218,"1,550.86",890
,20170322,14300,14225,14350,14390,14145,14175,14300,-50,75,46,328.93,902
,20170323,14175,14300,14155,14295,14155,14295,14240,-5,-60,22,156.69,904
,20170324,14295,14240,14165,14240,14145,14145,14185,-95,-55,40,283.74,904
,20170327,14145,14185,14135,14135,14050,14135,14090,-50,-95,38,267.75,908
,20170328,14135,14090,14200,14200,14045,14090,14110,0,20,86,606.82,892
,20170329,14090,14110,14200,14275,14200,14200,14225,90,115,78,554.88,952
,20170330,14200,14225,14055,14315,14055,14230,14255,5,30,100,712.82,908
,20170331,14230,14255,14260,14370,14230,14370,14300,115,45,74,529.19,912
,20170405,14370,14300,14330,14585,14330,14535,14510,235,210,92,667.67,918
,20170406,14535,14510,14620,14620,14445,14470,14490,-40,-20,82,594.14,920
,20170407,14470,14490,14510,14535,14350,14380,14420,-110,-70,24,173.07,914
,20170410,14380,14420,14355,14535,14355,14500,14465,80,45,14,101.27,916
,20170411,14500,14465,14400,14400,14315,14325,14370,-140,-95,90,646.80,952
,20170412,14325,14370,14390,14440,14320,14320,14365,-50,-5,40,287.30,956
,20170413,14320,14365,14260,14515,14240,14515,14330,150,-35,62,444.27,974
,20170414,14515,14330,14465,14605,14465,14570,14560,240,230,32,233.00,976
,20170417,14570,14560,14570,15125,14570,14800,14880,240,320,482,"3,586.72",1186
,20170418,14800,14880,14845,14885,14800,14810,14840,-70,-40,68,504.65,1194
,20170419,14810,14840,14805,14820,14520,14665,14660,-175,-180,400,"2,932.52",1110
,20170420,14665,14660,14695,14700,14505,14680,14625,20,-35,34,248.70,1106
,20170421,14680,14625,14800,14800,14700,14700,14745,75,120,20,147.50,1094
,20170424,14700,14745,14580,14700,14525,14640,14635,-105,-110,40,292.74,1098
,20170425,14640,14635,14600,14750,14550,14700,14660,65,25,84,615.88,1104
,20170426,14700,14660,14710,14815,14635,14635,14715,-25,55,120,883.01,1126
,20170427,14635,14715,14650,14680,14615,14650,14640,-65,-75,26,190.33,1116
,20170428,14650,14640,14550,14550,14410,14450,14490,-190,-150,132,956.50,1128
,20170502,14450,14490,14400,14445,14250,14290,14355,-200,-135,182,"1,306.51",1244
,20170503,14290,14355,14270,14345,14125,14345,14285,-10,-70,40,285.75,1242
,20170504,14345,14285,14250,14330,14195,14285,14270,0,-15,52,371.15,1238
,20170505,14285,14270,14205,14345,14190,14290,14285,20,15,140,"1,000.25",1236
,20170508,14290,14285,14285,14285,14070,14070,14160,-215,-125,36,254.96,1230
,20170509,14070,14160,14035,14120,14035,14120,14075,-40,-85,38,267.46,1236
,20170510,14120,14075,14110,14115,14100,14105,14100,30,25,60,423.14,1280
,20170511,14105,14100,14175,14175,14000,14090,14080,-10,-20,54,380.29,1308
,20170512,14090,14080,14115,14130,14010,14095,14075,15,-5,94,661.56,1378
,20170515,14095,14075,14110,14230,14020,14230,14110,155,35,102,719.68,1370
,20170516,14230,14110,14250,14250,14100,14175,14175,65,65,90,637.92,1374
,20170517,14175,14175,14245,14250,14185,14240,14215,65,40,106,753.42,1388
,20170518,14240,14215,14225,14265,14105,14140,14170,-75,-45,38,269.25,1388
,20170519,14140,14170,14100,14270,14045,14260,14150,90,-20,42,297.16,1386
,20170522,14260,14150,14300,14395,14180,14225,14285,75,135,84,600.07,1370
,20170523,14225,14285,14240,14240,14125,14160,14170,-125,-115,102,722.74,1402
,20170524,14160,14170,14200,14225,14185,14215,14205,45,35,16,113.67,1404
,20170525,14215,14205,14280,14285,14180,14180,14195,-25,-10,46,326.51,1366
,20170526,14180,14195,14345,14360,14280,14305,14315,110,120,536,"3,837.41",1594
,20170531,14305,14315,14010,14315,14010,14055,14225,-260,-90,302,"2,148.34",1426
,20170601,14055,14225,14360,14360,13955,14120,14100,-105,-125,260,"1,833.26",1426
,20170602,14120,14100,14155,14155,14135,14135,14150,35,50,10,70.76,1424
,20170605,14135,14150,14005,14155,13990,14125,14060,-25,-90,18,126.56,1424
,20170606,14125,14060,14000,14045,13995,14045,14010,-15,-50,6,42.04,1424
,20170607,14045,14010,13980,14065,13980,14010,14005,0,-5,144,"1,008.63",1416
,20170608,14010,14005,14040,14110,14035,14080,14080,75,75,46,323.85,1418
,20170609,14080,14080,14110,14110,13915,13945,14020,-135,-60,70,490.86,1408
,20170612,13945,14020,13965,14100,13965,14040,14030,20,10,52,364.87,1426
,20170613,14040,14030,14045,14145,13985,13985,14050,-45,20,52,365.34,1418
,20170614,13985,14050,14015,14060,13985,14020,14005,-30,-45,138,966.42,1496
,20170615,14020,14005,13900,13945,13795,13920,13850,-85,-155,1028,"7,119.86",1770
,20170616,13920,13850,13830,13860,13830,13860,13830,10,-20,22,152.16,1768
,20170619,13860,13830,13920,14080,13890,14050,14000,220,170,126,882.31,1730
,20170620,14050,14000,14045,14300,14045,14260,14220,260,220,88,625.79,1726
,20170621,14260,14220,14225,14240,14185,14215,14210,-5,-10,68,483.28,1714
,20170622,14215,14210,14210,14265,14150,14150,14195,-60,-15,178,"1,263.72",1586
,20170623,14150,14195,14130,14130,14100,14100,14105,-95,-90,12,84.65,1586
,20170626,14100,14105,14130,14165,14130,14145,14150,40,45,28,198.12,1568
,20170627,14145,14150,14080,14230,14055,14230,14110,80,-40,1760,"12,419.46",2264
,20170628,14230,14110,14295,14395,14180,14250,14230,140,120,294,"2,092.29",2284
,20170629,14250,14230,14215,14280,14205,14270,14260,40,30,86,613.31,2282
,20170630,14270,14260,14290,14290,14120,14260,14220,0,-40,2134,"15,174.25",3348
,20170703,14260,14220,14290,14450,14270,14435,14325,215,105,622,"4,455.36",3598
,20170704,14435,14325,14400,14410,14310,14350,14385,25,60,216,"1,553.96",3632
,20170705,14350,14385,14380,14510,14370,14470,14420,85,35,582,"4,196.57",3936
,20170706,14470,14420,14460,14500,14405,14455,14445,35,25,280,"2,022.53",3844
,20170707,14455,14445,14410,14480,14410,14465,14425,20,-20,460,"3,318.45",4088
,20170710,14465,14425,14465,14465,14380,14395,14420,-30,-5,28,201.90,4076
,20170711,14395,14420,14355,14440,14280,14430,14370,10,-50,660,"4,743.52",4362
,20170712,14430,14370,14425,14535,14425,14485,14485,115,115,2860,"20,719.91",5132
,20170713,14485,14485,14460,14600,14460,14585,14545,100,60,158,"1,149.38",5212
,20170714,14585,14545,14700,14810,14605,14645,14700,100,155,352,"2,587.24",5332
,20170717,14645,14700,14685,14900,14660,14805,14755,105,55,188,"1,387.34",5406
,20170718,14805,14755,14780,14795,14620,14690,14665,-65,-90,2000,"14,669.17",6132
,20170719,14690,14665,14670,14795,14670,14765,14755,100,90,1044,"7,702.50",5896
,20170720,14765,14755,14785,14825,14700,14725,14775,-30,20,1864,"13,770.98",5740
,20170721,14725,14775,14735,14790,14675,14760,14745,-15,-30,530,"3,907.65",5756
,20170724,14760,14745,14780,14800,14675,14755,14715,10,-30,294,"2,163.52",5784
,20170725,14755,14715,14755,14865,14710,14860,14825,145,110,908,"6,730.80",5988
,20170726,14860,14825,14895,14920,14785,14810,14855,-15,30,630,"4,679.74",5902
,20170727,14810,14855,14815,14835,14715,14760,14760,-95,-95,628,"4,635.52",6188
,20170728,14760,14760,14815,14845,14630,14715,14735,-45,-25,614,"4,524.89",6450
,20170731,14715,14735,14705,14885,14645,14880,14775,145,40,370,"2,733.85",6406
,20170801,14880,14775,14865,14890,14750,14760,14800,-15,25,928,"6,868.57",6652
,20170802,14760,14800,14760,15190,14760,15080,15020,280,220,1636,"12,287.87",7070
,20170803,15080,15020,15095,15150,14925,14950,15055,-70,35,3886,"29,260.80",8738
,20170804,14950,15055,14960,15100,14915,15030,15025,-25,-30,3170,"23,814.76",9848
,20170807,15030,15025,15035,15550,15000,15400,15255,375,230,4924,"37,566.05",10644
,20170808,15400,15255,15480,15855,15370,15675,15670,420,415,14270,"111,831.41",11216
,20170809,15675,15670,15730,16525,15705,16380,16205,710,535,30998,"251,204.43",15416
,20170810,16380,16205,16355,16630,16160,16290,16425,85,220,26870,"220,717.71",16488
,20170811,16290,16425,16395,16500,16180,16330,16315,-95,-110,23002,"187,655.41",17862
,20170814,16330,16315,16335,16460,15955,16040,16215,-275,-100,25488,"206,693.15",20878
,20170815,16040,16215,16165,16165,15845,16075,16025,-140,-190,14524,"116,406.67",21948
,20170816,16075,16025,16200,16475,16095,16350,16335,325,310,26394,"215,632.21",27600
,20170817,16350,16335,16430,16905,16405,16730,16710,395,375,42398,"354,249.11",33460
,20170818,16730,16710,16630,16660,16300,16565,16520,-145,-190,32042,"264,671.92",33308
,20170821,16565,16520,16565,16810,16400,16635,16610,115,90,26378,"219,127.59",36094
,20170822,16635,16610,16615,16745,16475,16605,16605,-5,-5,28394,"235,791.17",40030
,20170823,16605,16605,16605,16705,16310,16430,16475,-175,-130,21642,"178,282.05",39704
,20170824,16430,16475,16490,16955,16490,16645,16760,170,285,45068,"377,681.54",43874
,20170825,16645,16760,16690,16820,16610,16800,16720,40,-40,33468,"279,866.06",49502
,20170828,16800,16720,16780,16780,16390,16540,16555,-180,-165,23914,"197,996.26",50454
,20170829,16540,16555,16520,16635,16385,16435,16485,-120,-70,26750,"220,547.16",53286
,20170830,16435,16485,16445,16635,16430,16605,16530,120,45,28790,"237,992.08",51810
,20170831,16605,16530,16510,16715,16450,16680,16600,150,70,21884,"181,687.13",53878
,20170901,16680,16600,16790,16940,16735,16900,16820,300,220,25722,"216,377.72",55770
,20170904,16900,16820,16800,17060,16700,16735,16860,-85,40,61422,"517,891.93",62602
,20170905,16735,16860,16740,16785,16630,16675,16715,-185,-145,39156,"327,314.47",69888
,20170906,16675,16715,16610,16725,16455,16525,16585,-190,-130,37720,"312,860.83",75438
,20170907,16525,16585,16560,16615,16270,16290,16455,-295,-130,64470,"530,571.61",83248
,20170908,16290,16455,16400,16425,15815,16000,16185,-455,-270,62640,"507,038.27",86646
,20170911,16000,16185,16085,16680,15970,16680,16290,495,105,72794,"593,037.80",86058
,20170912,16680,16290,16610,16800,16610,16790,16730,500,440,75032,"627,779.77",83626
,20170913,16790,16730,16730,16950,16615,16745,16840,15,110,47694,"401,653.97",90418
,20170914,16745,16840,16690,16840,16545,16750,16710,-90,-130,49020,"409,632.44",93338
,20170915,16750,16710,16720,16800,16390,16400,16570,-310,-140,62394,"517,005.01",97312
,20170918,16400,16570,16450,16630,16260,16550,16450,-20,-120,55084,"453,077.35",98994
,20170919,16550,16450,16550,16800,16480,16670,16675,220,225,65738,"548,174.51",107408
,20170920,16670,16675,16790,17270,16580,17180,16920,505,245,125894,"1,065,350.97",122152
,20170921,17180,16920,17270,17375,16880,16970,17115,50,195,122676,"1,049,803.11",125560
,20170922,16970,17115,17090,17275,16375,16585,16765,-530,-350,161234,"1,351,736.85",127310
,20170925,16585,16765,16760,16845,16505,16580,16640,-185,-125,101384,"843,544.59",133764
,20170926,16580,16640,16650,16790,16575,16710,16690,70,50,79396,"662,739.92",134706
,20170927,16710,16690,16580,16730,16515,16675,16615,-15,-75,76284,"633,829.84",139222
,20170928,16675,16615,16720,16720,16425,16490,16565,-125,-50,81694,"676,727.18",137124
,20170929,16490,16565,16510,16580,16370,16515,16490,-50,-75,70374,"580,313.49",138282
,20171009,16515,16490,16650,16780,16540,16755,16695,265,205,71776,"599,158.89",150638
,20171010,16755,16695,16740,16905,16510,16550,16755,-145,60,114712,"961,143.20",164404
,20171011,16550,16755,16500,16645,16340,16415,16500,-340,-255,93656,"772,876.68",165882
,20171012,16415,16500,16400,16605,16315,16535,16450,35,-50,77956,"641,358.78",173960
,20171013,16535,16450,16525,16760,16505,16740,16655,290,205,106176,"884,223.92",176682
,20171016,16740,16655,16725,16775,16475,16555,16620,-100,-35,116002,"964,131.43",174996
,20171017,16555,16620,16590,16680,16380,16430,16500,-190,-120,131362,"1,084,059.38",183498
,20171018,16430,16500,16500,16500,16150,16170,16285,-330,-215,147744,"1,203,153.41",198480
,20171019,16170,16285,16170,16340,16020,16225,16170,-60,-115,155382,"1,256,506.41",203282
,20171020,16225,16170,16250,16460,16150,16400,16330,230,160,141734,"1,157,429.39",214216
,20171023,16400,16330,16395,16400,16215,16310,16325,-20,-5,144358,"1,178,468.01",222422
,20171024,16310,16325,16305,16455,16275,16335,16365,10,40,118804,"972,190.67",234642
,20171025,16335,16365,16365,16515,16320,16355,16415,-10,50,184218,"1,512,023.15",268314
,20171026,16355,16415,16390,16655,16360,16590,16550,175,135,265762,"2,199,258.57",335754
,20171027,16590,16550,16545,16585,16345,16360,16465,-190,-85,192988,"1,589,177.50",347630
,20171030,16360,16465,16310,16460,16260,16380,16380,-85,-85,222468,"1,822,194.34",391552
,20171031,16380,16380,16345,16420,16310,16365,16370,-15,-10,203408,"1,665,124.45",408206
,20171101,16365,16370,16290,16575,16225,16235,16385,-135,15,339560,"2,782,394.08",426182
,20171102,16235,16385,16350,16350,16165,16245,16250,-140,-135,319504,"2,596,270.59",426952
,20171103,16245,16250,16220,16285,16165,16240,16230,-10,-20,213104,"1,729,508.76",425602
,20171106,16240,16230,16245,16335,16040,16160,16175,-70,-55,337210,"2,727,246.58",423690
,20171107,16160,16175,16155,16185,15960,16035,16085,-140,-90,370610,"2,981,236.07",431896
,20171108,16035,16085,15985,16030,15800,15850,15900,-235,-185,337870,"2,686,812.41",440134
,20171109,15850,15900,15790,15845,15320,15475,15560,-425,-340,560384,"4,360,923.34",432582
,20171110,15475,15560,15435,15600,15435,15520,15530,-40,-30,284122,"2,206,251.39",423772
,20171113,15520,15530,15545,15630,15495,15560,15565,30,35,191246,"1,488,384.15",417556
,20171114,15560,15565,15565,15645,15425,15470,15530,-95,-35,241748,"1,877,754.89",412846
,20171115,15470,15530,15485,15665,15340,15475,15480,-55,-50,390944,"3,025,969.20",402278
,20171116,15475,15480,15510,15635,15455,15480,15525,0,45,248360,"1,928,262.19",401224
,20171117,15480,15525,15550,15565,15345,15400,15455,-125,-70,199234,"1,539,807.76",403368
,20171120,15400,15455,15365,15495,15070,15130,15285,-325,-170,415180,"3,173,179.83",394446
,20171121,15130,15285,15130,15165,14865,14910,15005,-375,-280,329146,"2,469,722.11",375822
,20171122,14910,15005,14915,15000,14815,14995,14915,-10,-90,291388,"2,173,533.49",358030
,20171123,14995,14915,14935,15165,14935,15005,15065,90,150,314264,"2,367,678.60",342968
,20171124,15005,15065,15020,15100,14945,15045,15025,-20,-40,208550,"1,567,006.10",339806
,20171127,15045,15025,15050,15150,14885,14930,15035,-95,10,261926,"1,969,382.87",329012
,20171128,14930,15035,14985,15025,14730,14765,14870,-270,-165,249122,"1,852,347.81",325132
,20171129,14765,14870,14750,14840,14575,14615,14670,-255,-200,246776,"1,810,352.33",310592
,20171130,14615,14670,14580,14745,14340,14565,14530,-105,-140,434636,"3,158,626.19",266654
,20171201,14565,14530,14660,14700,14530,14600,14595,70,65,199288,"1,454,505.02",255404
,20171204,14600,14595,14575,14890,14415,14540,14645,-55,50,348302,"2,550,979.61",243896
,20171205,14540,14645,14585,14695,14500,14530,14600,-115,-45,192714,"1,407,028.28",231322
,20171206,14530,14600,14530,14595,14205,14300,14380,-300,-220,166528,"1,197,613.95",222250
,20171207,14300,14380,14320,14320,14065,14115,14175,-265,-205,105264,"746,112.22",212534
,20171208,14115,14175,14110,14280,14085,14225,14170,50,-5,78856,"558,835.00",207314
,20171211,14225,14170,14225,14280,14105,14145,14200,-25,30,71156,"505,268.76",202348
,20171212,14145,14200,14140,14310,14100,14150,14195,-50,-5,73688,"523,007.19",198444
,20171213,14150,14195,14190,14205,14030,14160,14135,-35,-60,55228,"390,456.33",195238
,20171214,14160,14135,14200,14230,14115,14165,14175,30,40,55556,"393,759.93",191424
,20171215,14165,14175,14205,14380,14195,14355,14300,180,125,70712,"505,632.66",187650
,20171218,14355,14300,14395,14515,14315,14405,14400,105,100,59722,"430,006.08",179024
,20171219,14405,14400,14450,14450,14325,14370,14380,-30,-20,44292,"318,470.93",169876
,20171220,14370,14380,14405,14610,14345,14585,14510,205,130,54292,"394,004.01",156550
,20171221,14585,14510,14650,14660,14500,14560,14565,50,55,45210,"329,343.78",150252
,20171222,14560,14565,14580,14630,14430,14510,14540,-55,-25,26590,"193,351.53",145038
,20171225,14510,14540,14555,14780,14525,14595,14665,55,125,45474,"333,487.51",137008
,20171226,14595,14665,14665,14665,14395,14500,14475,-165,-190,36978,"267,670.33",127800
,20171227,14500,14475,14520,14755,14500,14630,14615,155,140,34644,"253,183.30",120324
,20171228,14630,14615,14700,15020,14685,15000,14800,385,185,41024,"303,650.55",109642
,20171229,15000,14800,15000,15110,14915,15095,15020,295,220,41982,"315,353.14",99336
al1802,20170216,14795,14795,14805,15040,14695,14725,14855,-70,60,50,371.47,34
,20170217,14725,14855,14800,14875,14475,14485,14730,-370,-125,64,471.38,54
,20170220,14485,14730,14465,14690,14380,14645,14520,-85,-210,42,304.92,74
,20170221,14645,14520,14690,14880,14685,14715,14750,195,230,34,250.83,82
,20170222,14715,14750,14750,14760,14565,14565,14660,-185,-90,26,190.62,82
,20170223,14565,14660,14550,14600,14370,14370,14480,-290,-180,26,188.28,94
,20170224,14370,14480,14440,14450,14200,14435,14315,-45,-165,44,314.94,112
,20170227,14435,14315,14465,14570,14460,14560,14505,245,190,16,116.06,116
,20170228,14560,14505,14555,14615,14380,14450,14520,-55,15,40,290.47,96
,20170301,14450,14520,14485,14845,14485,14785,14690,265,170,60,440.82,106
,20170302,14785,14690,14850,14850,14680,14680,14760,-10,70,48,354.28,120
,20170303,14680,14760,14715,14715,14555,14705,14655,-55,-105,50,366.43,116
,20170306,14705,14655,14700,14700,14405,14405,14475,-250,-180,58,419.86,140
,20170307,14405,14475,14400,14455,14305,14375,14385,-100,-90,36,258.99,136
,20170308,14375,14385,14370,14425,14300,14300,14355,-85,-30,62,445.07,156
,20170309,14300,14355,14200,14360,14200,14360,14250,5,-105,14,99.78,160
,20170310,14360,14250,14280,14435,14210,14435,14345,185,95,64,459.14,160
,20170313,14435,14345,14420,14475,14245,14365,14335,20,-10,46,329.76,178
,20170314,14365,14335,14430,14430,14155,14165,14240,-170,-95,86,612.46,238
,20170315,14165,14240,14135,14265,14135,14230,14210,-10,-30,34,241.61,240
,20170316,14230,14210,14205,14400,14170,14380,14285,170,75,56,400.06,240
,20170317,14380,14285,14390,14390,14180,14185,14275,-100,-10,36,257.00,250
,20170320,14185,14275,14275,14290,14155,14170,14200,-105,-75,38,269.85,248
,20170321,14170,14200,14260,14340,14120,14340,14265,140,65,70,499.31,266
,20170322,14340,14265,14375,14435,14175,14240,14330,-25,65,130,931.46,342
,20170323,14240,14330,14155,14335,14155,14330,14245,0,-85,140,997.35,344
,20170324,14330,14245,14235,14250,14215,14235,14235,-10,-10,16,113.90,348
,20170327,14235,14235,14255,14255,14120,14150,14145,-85,-90,76,537.63,368
,20170328,14150,14145,14210,14215,14075,14075,14125,-70,-20,28,197.76,368
,20170329,14075,14125,14185,14335,14185,14260,14250,135,125,22,156.79,364
,20170330,14260,14250,14280,14360,14245,14245,14295,-5,45,62,443.16,354
,20170331,14245,14295,14340,14410,14315,14315,14380,20,85,30,215.71,366
,20170405,14315,14380,14530,14605,14530,14560,14575,180,195,46,335.31,376
,20170406,14560,14575,14650,14650,14460,14520,14525,-55,-50,94,682.87,370
,20170407,14520,14525,14495,14495,14350,14350,14405,-175,-120,22,158.49,372
,20170410,14350,14405,14405,14550,14405,14480,14490,75,85,28,202.90,388
,20170411,14480,14490,14425,14460,14365,14365,14410,-125,-80,36,259.44,408
,20170412,14365,14410,14460,14485,14340,14460,14425,50,15,60,432.89,396
,20170413,14460,14425,14315,14550,14315,14550,14405,125,-20,60,432.16,396
,20170414,14550,14405,14530,14660,14500,14585,14595,180,190,38,277.33,410
,20170417,14585,14595,14640,15140,14585,14855,14940,260,345,226,"1,688.65",462
,20170418,14855,14940,14905,14935,14825,14870,14880,-70,-60,148,"1,101.20",490
,20170419,14870,14880,14715,14765,14600,14720,14695,-160,-185,144,"1,058.38",490
,20170420,14720,14695,14730,14730,14540,14730,14660,35,-35,54,395.93,490
,20170421,14730,14660,14795,14855,14740,14750,14780,90,120,36,266.10,484
,20170424,14750,14780,14670,14725,14605,14715,14670,-65,-110,26,190.72,484
,20170425,14715,14670,14745,14765,14690,14730,14735,60,65,32,235.78,484
,20170426,14730,14735,14745,14820,14650,14665,14720,-70,-15,50,368.03,492
,20170427,14665,14720,14650,14650,14650,14650,14650,-70,-70,2,14.65,492
,20170428,14650,14650,14565,14565,14475,14490,14500,-160,-150,152,"1,102.30",510
,20170502,14490,14500,14450,14490,14290,14290,14400,-210,-100,74,532.87,522
,20170503,14290,14400,14315,14415,14315,14400,14355,0,-45,36,258.47,524
,20170504,14400,14355,14300,14380,14240,14240,14330,-115,-25,50,358.36,514
,20170505,14240,14330,14300,14400,14300,14305,14350,-25,20,40,287.09,514
,20170508,14305,14350,14310,14320,14130,14195,14190,-155,-160,34,241.28,508
,20170509,14195,14190,14000,14190,14000,14190,14110,0,-80,20,141.13,508
,20170510,14190,14110,14145,14155,14135,14135,14145,25,35,6,42.44,512
,20170511,14135,14145,14175,14175,14015,14150,14110,5,-35,40,282.25,516
,20170512,14150,14110,14150,14150,14065,14135,14125,25,15,22,155.40,500
,20170515,14135,14125,14145,14250,14130,14250,14185,125,60,10,70.94,500
,20170516,14250,14185,14285,14285,14160,14215,14240,30,55,14,99.70,500
,20170517,14215,14240,14235,14250,14230,14245,14240,5,0,28,199.36,526
,20170518,14245,14240,14205,14205,14150,14150,14175,-90,-65,4,28.36,524
,20170519,14150,14175,14280,14285,14260,14260,14275,85,100,14,99.96,512
,20170522,14260,14275,14345,14345,14265,14265,14320,-10,45,30,214.80,506
,20170523,14265,14320,14225,14225,14160,14200,14195,-120,-125,8,56.79,506
,20170524,14200,14195,14280,14280,14280,14280,14280,85,85,2,14.28,506
,20170525,14280,14280,14450,14455,14210,14325,14325,45,45,20,143.26,506
,20170526,14325,14325,14340,14390,14340,14365,14355,40,30,22,157.94,502
,20170531,14365,14355,14280,14300,14070,14070,14195,-285,-160,86,610.48,530
,20170601,14070,14195,14075,14195,14065,14195,14090,0,-105,150,"1,056.78",540
,20170602,14195,14090,14195,14195,14160,14175,14165,85,75,16,113.36,542
,20170605,14175,14165,14125,14235,14125,14195,14185,30,20,6,42.56,544
,20170606,14195,14185,14090,14095,14030,14095,14075,-90,-110,16,112.61,550
,20170607,14095,14075,14045,14060,14045,14060,14055,-15,-20,62,435.75,606
,20170608,14060,14055,14055,14120,14055,14110,14085,55,30,116,817.21,662
,20170609,14110,14085,14145,14160,13965,13985,14030,-100,-55,30,210.48,662
,20170612,13985,14030,14035,14080,14035,14080,14045,50,15,8,56.20,660
,20170613,14080,14045,14040,14040,14040,14040,14040,-5,-5,2,14.04,658
,20170614,14040,14040,14055,14055,14055,14055,14055,15,15,2,14.06,658
,20170615,14055,14055,14015,14015,13860,13930,13905,-125,-150,114,792.72,670
,20170616,13930,13905,13920,13960,13920,13955,13950,50,45,52,362.77,672
,20170619,13955,13950,14050,14100,14050,14100,14095,150,145,26,183.24,674
,20170620,14100,14095,14195,14340,14190,14310,14290,215,195,28,200.10,660
,20170621,14310,14290,14275,14275,14210,14210,14245,-80,-45,6,42.75,662
,20170622,14210,14245,14270,14270,14100,14100,14190,-145,-55,26,184.51,638
,20170623,14100,14190,14150,14150,14140,14140,14145,-50,-45,4,28.29,636
,20170626,14140,14145,14170,14190,14170,14190,14175,45,30,20,141.77,626
,20170627,14190,14175,14125,14255,14080,14255,14150,80,-25,388,"2,746.03",780
,20170628,14255,14150,14275,14300,14255,14260,14260,110,110,216,"1,540.46",792
,20170629,14260,14260,14270,14340,14260,14330,14295,70,35,20,142.99,786
,20170630,14330,14295,14270,14290,14185,14290,14275,-5,-20,324,"2,312.73",934
,20170703,14290,14275,14310,14450,14310,14430,14360,155,85,266,"1,910.43",988
,20170704,14430,14360,14400,14440,14400,14440,14435,80,75,68,490.92,1022
,20170705,14440,14435,14420,14500,14420,14500,14435,65,0,180,"1,299.21",1114
,20170706,14500,14435,14520,14520,14480,14480,14485,45,50,36,260.81,1092
,20170707,14480,14485,,,,14485,14485,0,0,0,0.00,1092
,20170710,14485,14485,14485,14485,14485,14485,14485,0,0,8,57.94,1090
,20170711,14485,14485,14370,14505,14300,14495,14405,10,-80,396,"2,853.02",1204
,20170712,14495,14405,14545,14600,14530,14550,14550,145,145,364,"2,648.92",1382
,20170713,14550,14550,14540,14640,14540,14630,14590,80,40,14,102.16,1382
,20170714,14630,14590,14720,14800,14660,14680,14755,90,165,114,841.23,1398
,20170717,14680,14755,14715,14855,14715,14845,14795,90,40,34,251.59,1400
,20170718,14845,14795,14825,14825,14685,14775,14750,-20,-45,1076,"7,936.87",1924
,20170719,14775,14750,14780,14860,14780,14860,14820,110,70,22,163.07,1914
,20170720,14860,14820,14865,14880,14780,14780,14855,-40,35,616,"4,575.72",1782
,20170721,14780,14855,14825,14855,14775,14800,14815,-55,-40,234,"1,733.76",1812
,20170724,14800,14815,14795,14815,14780,14815,14795,0,-20,10,73.99,1810
,20170725,14815,14795,14805,14945,14785,14880,14860,85,65,712,"5,290.46",1430
,20170726,14880,14860,14920,14945,14865,14875,14910,15,50,90,671.11,1438
,20170727,14875,14910,14890,14890,14790,14825,14810,-85,-100,68,503.65,1478
,20170728,14825,14810,14835,14845,14700,14790,14810,-20,0,72,533.20,1528
,20170731,14790,14810,14755,14920,14715,14920,14785,110,-25,54,399.30,1550
,20170801,14920,14785,14940,14940,14840,14845,14870,60,85,408,"3,033.91",1634
,20170802,14845,14870,14845,15220,14825,15180,14960,310,90,200,"1,496.10",1718
,20170803,15180,14960,15155,15180,15000,15010,15145,50,185,148,"1,120.95",1768
,20170804,15010,15145,15030,15125,15005,15090,15050,-55,-95,282,"2,122.10",1890
,20170807,15090,15050,15150,15580,14800,15575,15405,525,355,214,"1,648.60",1878
,20170808,15575,15405,15520,15930,15520,15740,15730,335,325,2464,"19,380.40",1936
,20170809,15740,15730,15845,16570,15845,16425,16395,695,665,3128,"25,647.71",2310
,20170810,16425,16395,16425,16645,16255,16335,16465,-60,70,840,"6,916.32",2610
,20170811,16335,16465,16380,16550,16135,16400,16320,-65,-145,890,"7,263.68",2658
,20170814,16400,16320,16400,16495,16050,16070,16230,-250,-90,870,"7,061.85",2734
,20170815,16070,16230,16070,16190,15920,16125,16085,-105,-145,168,"1,351.40",2742
,20170816,16125,16085,16295,16535,16200,16455,16425,370,340,502,"4,123.39",2632
,20170817,16455,16425,16460,16955,16460,16770,16810,345,385,6898,"57,990.76",5548
,20170818,16770,16810,16630,16690,16380,16620,16575,-190,-235,3726,"30,881.02",6368
,20170821,16620,16575,16680,16825,16475,16670,16680,95,105,5504,"45,906.20",8962
,20170822,16670,16680,16705,16760,16515,16650,16665,-30,-15,7124,"59,375.01",12200
,20170823,16650,16665,16670,16735,16370,16460,16535,-205,-130,1760,"14,551.14",12336
,20170824,16460,16535,16580,16965,16560,16640,16755,105,220,18982,"159,064.36",21082
,20170825,16640,16755,16660,16810,16620,16765,16715,10,-40,10118,"84,580.14",25734
,20170828,16765,16715,16755,16770,16390,16540,16560,-175,-155,5962,"49,371.85",26748
,20170829,16540,16560,16535,16630,16390,16445,16495,-115,-65,3868,"31,903.45",26818
,20170830,16445,16495,16565,16645,16440,16610,16555,115,60,12368,"102,378.77",27776
,20170831,16610,16555,16560,16735,16475,16700,16625,145,70,6522,"54,217.05",29030
,20170901,16700,16625,16855,16955,16760,16920,16855,295,230,5716,"48,177.23",30264
,20170904,16920,16855,16870,17090,16725,16750,16890,-105,35,4124,"34,830.15",30686
,20170905,16750,16890,16705,16795,16670,16700,16740,-190,-150,9560,"80,034.87",33654
,20170906,16700,16740,16675,16725,16475,16540,16600,-200,-140,6622,"54,969.90",35112
,20170907,16540,16600,16565,16620,16330,16330,16475,-270,-125,8218,"67,709.06",36408
,20170908,16330,16475,16350,16430,15905,16035,16240,-440,-235,4244,"34,463.70",36222
,20170911,16035,16240,16085,16665,16005,16660,16295,420,55,5900,"48,074.02",36340
,20170912,16660,16295,16675,16835,16665,16820,16760,525,465,8968,"75,161.71",37760
,20170913,16820,16760,16755,16980,16740,16785,16885,25,125,4164,"35,154.89",38058
,20170914,16785,16885,16720,16880,16600,16780,16755,-105,-130,4774,"39,996.47",37850
,20170915,16780,16755,16765,16805,16450,16460,16610,-295,-145,5626,"46,736.90",38220
,20170918,16460,16610,16485,16680,16300,16590,16510,-20,-100,5030,"41,527.51",38586
,20170919,16590,16510,16575,16845,16545,16710,16755,200,245,14390,"120,557.78",42786
,20170920,16710,16755,16805,17295,16635,17205,16955,450,200,14376,"121,873.82",45846
,20170921,17205,16955,17210,17400,16920,17000,17145,45,190,16460,"141,111.85",46566
,20170922,17000,17145,17085,17310,16420,16595,16680,-550,-465,25774,"214,968.44",46792
,20170925,16595,16680,16780,16880,16550,16635,16680,-45,0,10086,"84,117.26",46828
,20170926,16635,16680,16710,16825,16635,16760,16740,80,60,6842,"57,276.52",47506
,20170927,16760,16740,16660,16785,16570,16735,16680,-5,-60,6334,"52,834.95",47208
,20170928,16735,16680,16750,16785,16495,16580,16625,-100,-55,10944,"90,980.54",48030
,20170929,16580,16625,16625,16635,16445,16570,16550,-55,-75,12446,"102,997.17",49318
,20171009,16570,16550,16695,16830,16600,16810,16750,260,200,6886,"57,678.11",49690
,20171010,16810,16750,16810,16960,16600,16600,16820,-150,70,12922,"108,676.73",51292
,20171011,16600,16820,16600,16705,16405,16480,16570,-340,-250,12992,"107,666.91",53470
,20171012,16480,16570,16480,16660,16380,16595,16525,25,-45,13650,"112,815.97",55652
,20171013,16595,16525,16560,16805,16560,16785,16700,260,175,18960,"158,342.70",57012
,20171016,16785,16700,16785,16825,16540,16615,16685,-85,-15,20576,"171,702.21",57402
,20171017,16615,16685,16615,16735,16450,16490,16555,-195,-130,18830,"155,886.44",57496
,20171018,16490,16555,16505,16550,16220,16220,16345,-335,-210,27192,"222,293.77",62128
,20171019,16220,16345,16250,16400,16090,16290,16235,-55,-110,27624,"224,247.94",67206
,20171020,16290,16235,16310,16505,16220,16445,16395,210,160,26616,"218,225.89",72614
,20171023,16445,16395,16405,16455,16270,16370,16370,-25,-25,30108,"246,475.27",73174
,20171024,16370,16370,16340,16520,16335,16420,16425,50,55,28892,"237,309.98",77032
,20171025,16420,16425,16430,16590,16405,16430,16485,5,60,44888,"370,002.44",85958
,20171026,16430,16485,16445,16735,16445,16670,16635,185,150,44898,"373,527.71",94822
,20171027,16670,16635,16600,16675,16430,16440,16545,-195,-90,51276,"424,224.88",103148
,20171030,16440,16545,16380,16540,16360,16460,16465,-85,-80,32740,"269,560.79",106852
,20171031,16460,16465,16400,16505,16400,16455,16455,-10,-10,48488,"398,982.52",109922
,20171101,16455,16455,16385,16655,16325,16325,16470,-130,15,60602,"499,205.42",114552
,20171102,16325,16470,16405,16420,16260,16335,16340,-135,-130,53514,"437,312.86",120786
,20171103,16335,16340,16300,16375,16260,16335,16320,-5,-20,32962,"268,987.13",120864
,20171106,16335,16320,16355,16420,16135,16255,16260,-65,-60,53840,"437,793.57",126050
,20171107,16255,16260,16250,16280,16050,16115,16170,-145,-90,44160,"357,113.18",127018
,20171108,16115,16170,16055,16120,15895,15935,15985,-235,-185,63412,"506,931.83",128710
,20171109,15935,15985,15895,15920,15425,15585,15640,-400,-345,118040,"923,279.92",139478
,20171110,15585,15640,15575,15695,15545,15620,15620,-20,-20,60104,"469,538.23",143112
,20171113,15620,15620,15650,15720,15590,15655,15660,35,40,43298,"339,038.95",144500
,20171114,15655,15660,15640,15740,15520,15560,15625,-100,-35,61720,"482,252.87",146784
,20171115,15560,15625,15550,15745,15430,15560,15555,-65,-70,90176,"701,546.61",143074
,20171116,15560,15555,15600,15725,15545,15565,15615,10,60,66798,"521,635.09",149520
,20171117,15565,15615,15650,15655,15435,15490,15540,-125,-75,55616,"432,250.05",155162
,20171120,15490,15540,15460,15590,15170,15235,15380,-305,-160,141726,"1,089,904.15",166086
,20171121,15235,15380,15220,15255,14960,15005,15095,-375,-285,112994,"852,975.37",178628
,20171122,15005,15095,15005,15095,14910,15090,15015,-5,-80,108406,"813,873.07",184326
,20171123,15090,15015,15060,15260,15055,15100,15155,85,140,105052,"796,102.14",194224
,20171124,15100,15155,15095,15200,15045,15150,15125,-5,-30,81694,"617,826.83",203990
,20171127,15150,15125,15145,15250,14990,15050,15130,-75,5,118938,"899,785.41",226416
,20171128,15050,15130,15075,15130,14830,14865,14965,-265,-165,145948,"1,092,349.37",246916
,20171129,14865,14965,14855,14930,14680,14720,14770,-245,-195,148018,"1,093,403.85",262138
,20171130,14720,14770,14665,14840,14445,14815,14630,45,-140,283510,"2,074,286.45",289838
,20171201,14815,14630,14780,14810,14635,14705,14695,75,65,163266,"1,199,934.81",302394
,20171204,14705,14695,14700,14985,14500,14645,14730,-50,35,323628,"2,383,789.15",311542
,20171205,14645,14730,14645,14785,14590,14620,14690,-110,-40,217386,"1,597,033.83",323846
,20171206,14620,14690,14620,14660,14290,14395,14470,-295,-220,303836,"2,198,694.97",341350
,20171207,14395,14470,14395,14410,14150,14205,14265,-265,-205,267120,"1,905,640.41",352590
,20171208,14205,14265,14200,14375,14175,14320,14265,55,0,242676,"1,730,940.99",358090
,20171211,14320,14265,14295,14380,14200,14240,14295,-25,30,213830,"1,528,391.15",357908
,20171212,14240,14295,14245,14415,14190,14250,14300,-45,5,275322,"1,968,747.88",367276
,20171213,14250,14300,14290,14310,14110,14250,14230,-50,-70,254932,"1,814,192.27",374992
,20171214,14250,14230,14275,14340,14215,14275,14270,45,40,220954,"1,576,769.56",373404
,20171215,14275,14270,14320,14485,14295,14450,14405,180,135,323022,"2,326,709.62",377712
,20171218,14450,14405,14500,14630,14415,14515,14505,110,100,339260,"2,461,317.38",377414
,20171219,14515,14505,14535,14555,14430,14480,14485,-25,-20,248350,"1,799,035.68",364852
,20171220,14480,14485,14520,14720,14450,14685,14615,200,130,345940,"2,528,608.84",369418
,20171221,14685,14615,14725,14770,14615,14665,14685,50,70,294916,"2,165,422.16",355400
,20171222,14665,14685,14685,14745,14555,14630,14650,-55,-35,282534,"2,070,003.14",353526
,20171225,14630,14650,14685,14895,14620,14715,14770,65,120,383298,"2,831,523.46",351542
,20171226,14715,14770,14720,14755,14505,14610,14585,-160,-185,268318,"1,957,152.28",350670
,20171227,14610,14585,14665,14875,14610,14745,14730,160,145,357560,"2,633,772.56",335746
,20171228,14745,14730,14880,15145,14790,15125,14925,395,195,397660,"2,968,160.49",331990
,20171229,15125,14925,15120,15250,15020,15225,15125,300,200,342742,"2,592,776.66",308960
al1803,20170316,14210,14210,14345,14430,14345,14390,14385,180,175,6,43.17,2
,20170317,14390,14385,14360,14360,14235,14235,14255,-150,-130,14,99.80,10
,20170320,14235,14255,14295,14335,14185,14185,14290,-70,35,12,85.75,10
,20170321,14185,14290,14300,14395,14300,14390,14350,100,60,50,358.79,52
,20170322,14390,14350,14460,14465,14200,14235,14340,-115,-10,34,243.85,62
,20170323,14235,14340,14225,14365,14210,14365,14285,25,-55,26,185.74,60
,20170324,14365,14285,14290,14295,14225,14225,14245,-60,-40,26,185.21,72
,20170327,14225,14245,14205,14280,14160,14210,14210,-35,-35,46,326.93,70
,20170328,14210,14210,14195,14250,14125,14230,14195,20,-15,30,212.99,76
,20170329,14230,14195,14155,14395,14155,14350,14330,155,135,22,157.68,78
,20170330,14350,14330,14325,14390,14280,14305,14345,-25,15,46,329.97,82
,20170331,14305,14345,14365,14440,14335,14440,14380,95,35,34,244.54,88
,20170405,14440,14380,14480,14660,14480,14615,14635,235,255,100,731.88,154
,20170406,14615,14635,14685,14685,14515,14560,14565,-75,-70,48,349.64,156
,20170407,14560,14565,14485,14530,14395,14400,14445,-165,-120,80,577.82,194
,20170410,14400,14445,14385,14605,14385,14515,14505,70,60,46,333.72,214
,20170411,14515,14505,14490,14490,14385,14405,14430,-100,-75,174,"1,255.50",310
,20170412,14405,14430,14485,14505,14365,14400,14440,-30,10,76,548.73,332
,20170413,14400,14440,14355,14600,14330,14600,14460,160,20,128,925.72,374
,20170414,14600,14460,14545,14675,14525,14675,14590,215,130,74,539.91,380
,20170417,14675,14590,14685,15195,14530,14905,14995,315,405,374,"2,804.53",576
,20170418,14905,14995,14875,14990,14855,14895,14920,-100,-75,188,"1,402.86",614
,20170419,14895,14920,14900,14900,14630,14750,14730,-170,-190,146,"1,075.39",630
,20170420,14750,14730,14765,14765,14590,14760,14700,30,-30,44,323.49,632
,20170421,14760,14700,14785,14905,14770,14795,14825,95,125,76,563.51,640
,20170424,14795,14825,14715,14795,14650,14715,14710,-110,-115,38,279.54,640
,20170425,14715,14710,14770,14800,14715,14745,14740,35,30,36,265.39,656
,20170426,14745,14740,14745,14850,14675,14715,14740,-25,0,182,"1,341.51",600
,20170427,14715,14740,14715,14715,14675,14685,14690,-55,-50,20,146.91,604
,20170428,14685,14690,14625,14640,14520,14525,14565,-165,-125,96,699.21,570
,20170502,14525,14565,14530,14530,14310,14310,14375,-255,-190,228,"1,639.23",664
,20170503,14310,14375,14435,14435,14350,14415,14390,40,15,16,115.15,664
,20170504,14415,14390,14420,14420,14280,14285,14335,-105,-55,40,286.72,666
,20170505,14285,14335,14330,14515,14330,14395,14395,60,60,276,"1,986.62",628
,20170508,14395,14395,14280,14280,14140,14140,14205,-255,-190,68,483.03,642
,20170509,14140,14205,14030,14240,14030,14215,14185,10,-20,64,454.05,642
,20170510,14215,14185,14300,14300,14195,14195,14225,10,40,14,99.60,640
,20170511,14195,14225,14135,14200,14055,14200,14115,-25,-110,26,183.53,640
,20170512,14200,14115,14185,14205,14080,14175,14155,60,40,34,240.72,646
,20170515,14175,14155,14140,14245,14140,14245,14170,90,15,20,141.71,652
,20170516,14245,14170,14285,14295,14190,14190,14245,20,75,12,85.47,650
,20170517,14190,14245,14290,14300,14250,14250,14280,5,35,10,71.42,652
,20170518,14250,14280,14250,14315,14205,14205,14265,-75,-15,22,156.95,644
,20170519,14205,14265,14205,14325,14205,14295,14295,30,30,16,114.39,644
,20170522,14295,14295,14395,14420,14275,14280,14335,-15,40,56,401.51,656
,20170523,14280,14335,14240,14270,14225,14225,14255,-110,-80,22,156.82,648
,20170524,14225,14255,14320,14320,14275,14275,14290,20,35,12,85.74,650
,20170525,14275,14290,14365,14400,14240,14350,14330,60,40,36,257.94,648
,20170526,14350,14330,14400,14400,14345,14385,14370,55,40,14,100.62,644
,20170531,14385,14370,14315,14330,14130,14130,14210,-240,-160,34,241.60,642
,20170601,14130,14210,14130,14225,14125,14225,14130,15,-80,36,254.43,642
,20170602,14225,14130,14230,14230,14190,14190,14210,60,80,8,56.84,642
,20170605,14190,14210,14175,14235,14175,14195,14200,-15,-10,6,42.61,642
,20170606,14195,14200,14140,14150,14110,14110,14130,-90,-70,6,42.40,648
,20170607,14110,14130,14100,14125,14100,14120,14120,-10,-10,66,465.96,714
,20170608,14120,14120,14145,14195,14145,14195,14170,75,50,16,113.37,720
,20170609,14195,14170,14150,14150,14025,14025,14060,-145,-110,24,168.74,730
,20170612,14025,14060,14065,14190,14065,14155,14100,95,40,12,84.61,730
,20170613,14155,14100,14125,14125,14125,14125,14125,25,25,8,56.50,732
,20170614,14125,14125,14080,14080,14080,14080,14080,-45,-45,2,14.08,732
,20170615,14080,14080,14080,14080,13940,13985,13980,-95,-100,102,713.20,776
,20170616,13985,13980,13965,14010,13940,14010,13950,30,-30,26,181.37,796
,20170619,14010,13950,13995,14145,13975,14145,14090,195,140,12,84.55,794
,20170620,14145,14090,14230,14340,14210,14340,14245,250,155,18,128.22,794
,20170621,14340,14245,14280,14280,14280,14280,14280,35,35,6,42.84,794
,20170622,14280,14280,14260,14260,14170,14170,14205,-110,-75,24,170.52,792
,20170623,14170,14205,14205,14205,14205,14205,14205,0,0,16,113.64,792
,20170626,14205,14205,14215,14230,14215,14230,14225,25,20,8,56.91,796
,20170627,14230,14225,14170,14360,14095,14355,14210,130,-15,450,"3,197.60",1030
,20170628,14355,14210,14355,14355,14295,14335,14305,125,95,270,"1,931.32",1034
,20170629,14335,14305,14325,14350,14310,14320,14320,15,15,66,472.59,1054
,20170630,14320,14320,14345,14345,14215,14320,14290,0,-30,238,"1,700.76",1108
,20170703,14320,14290,14365,14500,14340,14500,14415,210,125,448,"3,229.53",1098
,20170704,14500,14415,14455,14475,14415,14415,14445,0,30,24,173.38,1096
,20170705,14415,14445,14500,14575,14475,14535,14530,90,85,84,610.36,1086
,20170706,14535,14530,14550,14565,14480,14525,14520,-5,-10,58,421.08,1100
,20170707,14525,14520,14500,14500,14475,14475,14485,-45,-35,4,28.98,1102
,20170710,14475,14485,14505,14515,14475,14475,14490,-10,5,22,159.41,1112
,20170711,14475,14490,14435,14555,14355,14545,14435,55,-55,446,"3,219.04",1374
,20170712,14545,14435,14570,14620,14570,14585,14590,150,155,20,145.93,1378
,20170713,14585,14590,14620,14700,14575,14680,14645,90,55,28,205.05,1390
,20170714,14680,14645,14750,14850,14720,14750,14770,105,125,114,842.02,1444
,20170717,14750,14770,14850,14940,14760,14905,14820,135,50,194,"1,437.81",1534
,20170718,14905,14820,14905,14905,14715,14800,14800,-20,-20,118,873.21,1600
,20170719,14800,14800,14815,14940,14805,14915,14845,115,45,54,400.88,1618
,20170720,14915,14845,14920,14960,14860,14900,14910,55,65,112,835.12,1638
,20170721,14900,14910,14890,14940,14830,14880,14875,-30,-35,238,"1,770.19",1788
,20170724,14880,14875,14935,14970,14855,14905,14895,30,20,142,"1,057.72",1846
,20170725,14905,14895,14890,15025,14865,14980,14940,85,45,632,"4,722.44",1952
,20170726,14980,14940,15035,15035,14950,14960,14990,20,50,74,554.80,1990
,20170727,14960,14990,14975,15020,14860,15020,14905,30,-85,132,984.05,2092
,20170728,15020,14905,14975,14975,14800,14880,14885,-25,-20,104,774.24,2158
,20170731,14880,14885,14835,15040,14810,15030,14925,145,40,88,656.71,2194
,20170801,15030,14925,15030,15030,14895,14910,14945,-15,20,202,"1,509.45",2238
,20170802,14910,14945,14920,15280,14910,15270,15150,325,205,318,"2,409.18",2352
,20170803,15270,15150,15230,15315,15070,15095,15210,-55,60,242,"1,840.95",2454
,20170804,15095,15210,15100,15215,15070,15200,15150,-10,-60,154,"1,166.69",2488
,20170807,15200,15150,15195,15680,15150,15505,15410,355,260,186,"1,433.51",2512
,20170808,15505,15410,15690,15960,15690,15810,15780,400,370,1138,"8,979.16",2416
,20170809,15810,15780,15905,16640,15865,16500,16435,720,655,826,"6,787.71",2522
,20170810,16500,16435,16475,16730,16280,16415,16515,-20,80,1634,"13,493.27",3196
,20170811,16415,16515,16435,16605,16275,16410,16420,-105,-95,460,"3,777.63",3370
,20170814,16410,16420,16560,16560,16110,16170,16330,-250,-90,348,"2,842.09",3400
,20170815,16170,16330,16150,16285,15975,16230,16130,-100,-200,254,"2,048.58",3338
,20170816,16230,16130,16385,16595,16255,16505,16425,375,295,144,"1,182.67",3346
,20170817,16505,16425,16555,17005,16540,16800,16835,375,410,1286,"10,826.40",3558
,20170818,16800,16835,16690,16725,16450,16675,16640,-160,-195,2960,"24,633.71",3914
,20170821,16675,16640,16755,16865,16510,16720,16730,80,90,3024,"25,302.67",4638
,20170822,16720,16730,16730,16780,16555,16665,16695,-65,-35,3482,"29,068.19",6390
,20170823,16665,16695,16700,16700,16400,16505,16530,-190,-165,544,"4,496.60",6500
,20170824,16505,16530,16615,16965,16560,16610,16730,80,200,10094,"84,449.49",12756
,20170825,16610,16730,16625,16780,16615,16760,16695,30,-35,4338,"36,219.20",14706
,20170828,16760,16695,16680,16725,16320,16555,16570,-140,-125,5300,"43,920.71",15792
,20170829,16555,16570,16545,16630,16400,16415,16495,-155,-75,2724,"22,472.21",15988
,20170830,16415,16495,16540,16650,16450,16620,16545,125,50,10260,"84,897.08",18248
,20170831,16620,16545,16565,16740,16485,16705,16650,160,105,8094,"67,399.67",22542
,20170901,16705,16650,16865,16940,16770,16915,16860,265,210,8134,"68,586.51",25794
,20170904,16915,16860,16805,17060,16730,16750,16890,-110,30,6176,"52,162.68",26736
,20170905,16750,16890,16705,16790,16670,16700,16740,-190,-150,13488,"112,921.54",32332
,20170906,16700,16740,16650,16735,16470,16540,16630,-200,-110,7708,"64,095.62",34604
,20170907,16540,16630,16560,16615,16325,16325,16505,-305,-125,7506,"61,961.73",36292
,20170908,16325,16505,16350,16435,15940,16050,16190,-455,-315,6206,"50,251.44",36450
,20170911,16050,16190,16100,16700,16020,16700,16320,510,130,7500,"61,208.52",38550
,20170912,16700,16320,16725,16845,16675,16835,16770,515,450,10218,"85,686.50",40308
,20170913,16835,16770,16800,16980,16750,16815,16890,45,120,4304,"36,357.26",40616
,20170914,16815,16890,16720,16900,16615,16815,16765,-75,-125,4324,"36,255.14",40536
,20170915,16815,16765,16765,16810,16455,16465,16635,-300,-130,5478,"45,567.16",40456
,20170918,16465,16635,16520,16685,16325,16610,16510,-25,-125,4820,"39,791.34",40622
,20170919,16610,16510,16575,16865,16550,16725,16780,215,270,10814,"90,748.63",44984
,20170920,16725,16780,16800,17310,16660,17260,16935,480,155,10502,"88,929.20",47530
,20170921,17260,16935,17325,17420,16955,17055,17155,120,220,12452,"106,814.95",47980
,20170922,17055,17155,17105,17330,16475,16650,16785,-505,-370,13258,"111,284.52",47522
,20170925,16650,16785,16760,16915,16595,16675,16735,-110,-50,5270,"44,098.32",47606
,20170926,16675,16735,16685,16900,16685,16820,16790,85,55,5684,"47,729.63",47976
,20170927,16820,16790,16785,16820,16625,16800,16730,10,-60,3360,"28,109.92",47646
,20170928,16800,16730,16820,16820,16540,16615,16680,-115,-50,3736,"31,167.05",47382
,20170929,16615,16680,16625,16675,16490,16615,16605,-65,-75,5446,"45,220.82",47890
,20171009,16615,16605,16610,16865,16605,16855,16780,250,175,3486,"29,248.99",48096
,20171010,16855,16780,16860,17000,16650,16650,16860,-130,80,8342,"70,326.12",49290
,20171011,16650,16860,16525,16750,16465,16550,16595,-310,-265,6284,"52,143.24",50512
,20171012,16550,16595,16530,16710,16435,16640,16555,45,-40,4498,"37,240.22",50784
,20171013,16640,16555,16635,16855,16620,16835,16760,280,205,6664,"55,847.74",52350
,20171016,16835,16760,16855,16870,16590,16670,16750,-90,-10,4850,"40,623.71",52856
,20171017,16670,16750,16700,16790,16510,16560,16615,-190,-135,6406,"53,227.71",54238
,20171018,16560,16615,16580,16610,16290,16325,16405,-290,-210,11500,"94,351.97",56574
,20171019,16325,16405,16300,16455,16170,16345,16300,-60,-105,11502,"93,754.80",56338
,20171020,16345,16300,16370,16555,16290,16515,16450,215,150,8250,"67,867.98",56518
,20171023,16515,16450,16485,16505,16300,16415,16420,-35,-30,9574,"78,613.22",56036
,20171024,16415,16420,16415,16585,16390,16485,16470,65,50,9874,"81,315.27",58466
,20171025,16485,16470,16520,16665,16475,16495,16560,25,90,7554,"62,550.36",59920
,20171026,16495,16560,16530,16800,16530,16740,16700,180,140,12472,"104,161.87",58800
,20171027,16740,16700,16720,16725,16505,16515,16605,-185,-95,15200,"126,220.03",59918
,20171030,16515,16605,16490,16620,16445,16545,16540,-60,-65,12222,"101,086.05",60012
,20171031,16545,16540,16500,16580,16475,16535,16525,-5,-15,15264,"126,124.85",58794
,20171101,16535,16525,16455,16720,16410,16415,16545,-110,20,27896,"230,775.53",61974
,20171102,16415,16545,16495,16495,16345,16420,16425,-125,-120,21336,"175,237.70",61800
,20171103,16420,16425,16405,16450,16345,16410,16395,-15,-30,11236,"92,134.72",62780
,20171106,16410,16395,16425,16500,16220,16340,16335,-55,-60,15396,"125,777.46",62686
,20171107,16340,16335,16325,16365,16135,16200,16255,-135,-80,10298,"83,712.94",63364
,20171108,16200,16255,16140,16200,15990,16035,16075,-220,-180,23168,"186,266.58",64426
,20171109,16035,16075,16000,16020,15520,15680,15725,-395,-350,65424,"514,455.25",61542
,20171110,15680,15725,15640,15790,15630,15700,15715,-25,-10,28946,"227,493.97",58576
,20171113,15700,15715,15680,15810,15680,15750,15750,35,35,18402,"144,933.42",60124
,20171114,15750,15750,15760,15835,15620,15655,15710,-95,-40,32286,"253,609.55",61814
,20171115,15655,15710,15685,15840,15520,15655,15660,-55,-50,32964,"258,167.06",64666
,20171116,15655,15660,15705,15805,15635,15655,15715,-5,55,18044,"141,803.54",66194
,20171117,15655,15715,15735,15745,15535,15595,15620,-120,-95,17176,"134,169.76",67626
,20171120,15595,15620,15535,15685,15265,15315,15415,-305,-205,50398,"388,481.56",75410
,20171121,15315,15415,15305,15350,15060,15100,15190,-315,-225,40432,"307,157.15",78572
,20171122,15100,15190,15120,15185,15010,15185,15115,-5,-75,29128,"220,146.90",81350
,20171123,15185,15115,15200,15355,15155,15190,15250,75,135,34986,"266,775.07",86888
,20171124,15190,15250,15195,15290,15140,15245,15220,-5,-30,28056,"213,518.92",93024
,20171127,15245,15220,15265,15350,15090,15120,15225,-100,5,51464,"391,841.74",98854
,20171128,15120,15225,15120,15225,14930,14965,15065,-260,-160,57418,"432,569.81",102952
,20171129,14965,15065,14955,15030,14775,14820,14865,-245,-200,51824,"385,225.58",104926
,20171130,14820,14865,14790,14935,14540,14920,14730,55,-135,76394,"562,715.62",115156
,20171201,14920,14730,14875,14910,14735,14805,14795,75,65,38798,"287,097.32",117848
,20171204,14805,14795,14790,15085,14610,14745,14805,-50,10,82640,"611,819.90",121452
,20171205,14745,14805,14755,14880,14685,14720,14790,-85,-15,48812,"360,972.85",120162
,20171206,14720,14790,14730,14770,14390,14485,14560,-305,-230,69414,"505,386.08",126692
,20171207,14485,14560,14480,14500,14250,14305,14360,-255,-200,61316,"440,333.17",134228
,20171208,14305,14360,14300,14470,14270,14420,14355,60,-5,55802,"400,629.17",135970
,20171211,14420,14355,14400,14480,14305,14345,14395,-10,40,44232,"318,403.71",140224
,20171212,14345,14395,14330,14515,14295,14350,14400,-45,5,55038,"396,370.96",142406
,20171213,14350,14400,14365,14420,14240,14355,14330,-45,-70,52370,"375,263.92",146526
,20171214,14355,14330,14330,14440,14315,14370,14370,40,40,41222,"296,249.01",150116
,20171215,14370,14370,14400,14585,14400,14560,14505,190,135,66310,"480,935.11",156198
,20171218,14560,14505,14630,14730,14515,14620,14615,115,110,89150,"651,522.21",172804
,20171219,14620,14615,14640,14655,14530,14570,14585,-45,-30,69146,"504,338.29",180712
,20171220,14570,14585,14615,14820,14560,14785,14720,200,135,94756,"697,416.76",188906
,20171221,14785,14720,14815,14865,14715,14755,14775,35,55,88432,"653,363.61",201956
,20171222,14755,14775,14770,14835,14650,14725,14745,-50,-30,88218,"650,417.60",206396
,20171225,14725,14745,14800,15000,14725,14810,14870,65,125,129910,"966,043.44",221240
,20171226,14810,14870,14815,14855,14600,14705,14680,-165,-190,108898,"799,569.67",241238
,20171227,14705,14680,14785,14970,14710,14850,14825,170,145,179340,"1,329,714.58",257190
,20171228,14850,14825,14975,15260,14895,15235,15030,410,205,198706,"1,493,716.90",280022
,20171229,15235,15030,15235,15450,15125,15340,15235,310,205,190850,"1,453,819.90",310574
al1804,20170418,14995,14995,14980,15045,14805,15045,14945,50,-50,20,149.48,14
,20170419,15045,14945,14935,14935,14590,14780,14740,-165,-205,28,206.42,24
,20170420,14780,14740,14750,14750,14630,14745,14670,5,-70,18,132.07,30
,20170421,14745,14670,14850,14920,14745,14870,14850,200,180,20,148.54,34
,20170424,14870,14850,14755,14845,14675,14745,14740,-105,-110,30,221.16,38
,20170425,14745,14740,14720,14840,14715,14780,14780,40,40,32,236.55,32
,20170426,14780,14780,14830,14830,14700,14700,14715,-80,-65,88,647.57,104
,20170427,14700,14715,14660,14725,14630,14725,14680,10,-35,26,190.89,102
,20170428,14725,14680,14630,14630,14580,14605,14610,-75,-70,20,146.11,114
,20170502,14605,14610,14505,14530,14390,14390,14470,-220,-140,22,159.22,118
,20170503,14390,14470,14395,14415,14380,14415,14395,-55,-75,6,43.19,124
,20170504,14415,14395,14405,14405,14300,14305,14355,-90,-40,14,100.49,124
,20170505,14305,14355,14415,14470,14360,14410,14420,55,65,28,201.94,118
,20170508,14410,14420,14350,14350,14180,14180,14255,-240,-165,8,57.03,116
,20170509,14180,14255,14175,14270,14175,14215,14225,-40,-30,22,156.49,112
,20170510,14215,14225,14230,14250,14230,14250,14240,25,15,4,28.48,112
,20170511,14250,14240,14260,14260,14100,14175,14215,-65,-25,18,127.94,116
,20170512,14175,14215,14210,14270,14130,14225,14205,10,-10,14,99.45,118
,20170515,14225,14205,14205,14205,14190,14190,14195,-15,-10,4,28.40,120
,20170516,14190,14195,14310,14320,14185,14260,14245,65,50,20,142.49,124
,20170517,14260,14245,14320,14320,14315,14315,14315,70,70,4,28.64,124
,20170518,14315,14315,14340,14340,14225,14245,14270,-70,-45,14,99.91,128
,20170519,14245,14270,14320,14320,14320,14320,14320,50,50,6,42.96,126
,20170522,14320,14320,14320,14430,14300,14300,14370,-20,50,26,186.86,132
,20170523,14300,14370,14310,14310,14235,14235,14270,-135,-100,4,28.55,132
,20170524,14235,14270,14320,14350,14290,14290,14310,20,40,8,57.25,134
,20170525,14290,14310,14355,14440,14285,14440,14370,130,60,30,215.57,146
,20170526,14440,14370,14445,14445,14370,14405,14410,35,40,10,72.05,146
,20170531,14405,14410,14305,14315,14195,14195,14240,-215,-170,28,199.43,144
,20170601,14195,14240,14160,14275,14145,14275,14190,35,-50,10,70.96,148
,20170602,14275,14190,14245,14255,14215,14255,14235,65,45,6,42.72,150
,20170605,14255,14235,14285,14285,14165,14185,14210,-50,-25,6,42.64,150
,20170606,14185,14210,14150,14185,14080,14120,14150,-90,-60,24,169.84,150
,20170607,14120,14150,14135,14145,14135,14145,14135,-5,-15,8,56.56,158
,20170608,14145,14135,14205,14275,14200,14275,14225,140,90,8,56.91,158
,20170609,14275,14225,14200,14230,14060,14065,14095,-160,-130,48,338.36,182
,20170612,14065,14095,14220,14240,14170,14170,14215,75,120,8,56.87,178
,20170613,14170,14215,14170,14170,14150,14150,14160,-65,-55,4,28.32,180
,20170614,14150,14160,14165,14165,14165,14165,14165,5,5,2,14.17,178
,20170615,14165,14165,14135,14135,13950,14060,14035,-105,-130,38,266.67,174
,20170616,14060,14035,14035,14045,14035,14045,14035,10,0,6,42.12,170
,20170619,14045,14035,14115,14290,14115,14240,14220,205,185,36,255.98,148
,20170620,14240,14220,14265,14375,14265,14375,14310,155,90,22,157.44,144
,20170621,14375,14310,14340,14340,14275,14275,14305,-35,-5,4,28.62,144
,20170622,14275,14305,14300,14310,14210,14250,14230,-55,-75,38,270.45,138
,20170623,14250,14230,14185,14225,14185,14220,14210,-10,-20,8,56.86,138
,20170626,14220,14210,14235,14235,14235,14235,14235,25,25,2,14.24,138
,20170627,14235,14235,14190,14345,14190,14345,14220,110,-15,22,156.47,152
,20170628,14345,14220,14360,14370,14325,14325,14345,105,125,10,71.74,146
,20170629,14325,14345,13960,14425,13960,14400,14170,55,-175,430,"3,047.12",334
,20170630,14400,14170,14365,14370,14270,14345,14325,175,155,34,243.61,332
,20170703,14345,14325,14495,14500,14485,14500,14495,175,170,8,57.98,334
,20170704,14500,14495,14440,14445,14440,14445,14440,-50,-55,6,43.33,328
,20170705,14445,14440,14505,14615,14505,14615,14590,175,150,10,72.96,330
,20170706,14615,14590,,,,14590,14590,0,0,0,0.00,330
,20170707,14590,14590,14595,14595,14595,14595,14595,5,5,2,14.60,328
,20170710,14595,14595,,,,14595,14595,0,0,0,0.00,328
,20170711,14595,14595,14440,14575,14405,14575,14510,-20,-85,24,174.17,348
,20170712,14575,14510,14650,14650,14650,14650,14650,140,140,2,14.65,348
,20170713,14650,14650,14735,14735,14690,14690,14710,40,60,4,29.43,348
,20170714,14690,14710,14850,14870,14840,14840,14850,130,140,8,59.41,350
,20170717,14840,14850,14825,14980,14770,14980,14850,130,0,66,490.07,362
,20170718,14980,14850,14925,14965,14280,14820,14735,-30,-115,60,442.12,378
,20170719,14820,14735,14910,14945,14910,14945,14925,210,190,4,29.86,380
,20170720,14945,14925,14975,14975,14865,14945,14900,20,-25,58,432.23,402
,20170721,14945,14900,14915,14920,14850,14920,14905,20,5,48,357.80,418
,20170724,14920,14905,14915,14955,14915,14955,14930,50,25,16,119.46,428
,20170725,14955,14930,14930,15015,14915,15005,14965,75,35,36,269.43,442
,20170726,15005,14965,15000,15050,15000,15010,15025,45,60,10,75.14,444
,20170727,15010,15025,14945,14945,14905,14905,14920,-120,-105,8,59.68,448
,20170728,14905,14920,14950,15000,14810,14915,14905,-5,-15,26,193.81,456
,20170731,14915,14905,14880,15055,14860,15055,14940,150,35,10,74.71,458
,20170801,15055,14940,14975,15000,14975,15000,14985,60,45,4,29.98,460
,20170802,15000,14985,14980,15280,14980,15270,15220,285,235,54,410.97,482
,20170803,15270,15220,15245,15310,15130,15130,15250,-90,30,26,198.29,494
,20170804,15130,15250,15160,15270,15130,15240,15205,-10,-45,50,380.13,502
,20170807,15240,15205,15230,15685,15205,15560,15520,355,315,140,"1,086.55",518
,20170808,15560,15520,15815,16050,15755,15850,15900,330,380,198,"1,574.18",544
,20170809,15850,15900,15920,16670,15920,16585,16450,685,550,224,"1,842.94",612
,20170810,16585,16450,16530,16750,16215,16430,16525,-20,75,280,"2,313.92",578
,20170811,16430,16525,16425,16620,16320,16440,16440,-85,-85,120,986.44,568
,20170814,16440,16440,16520,16550,16155,16180,16360,-260,-80,244,"1,996.38",660
,20170815,16180,16360,16140,16270,16070,16270,16130,-90,-230,136,"1,097.11",656
,20170816,16270,16130,16365,16620,16295,16545,16425,415,295,118,969.33,646
,20170817,16545,16425,16630,17030,16630,16850,16900,425,475,212,"1,791.58",618
,20170818,16850,16900,16715,16755,16500,16710,16675,-190,-225,294,"2,451.91",616
,20170821,16710,16675,16790,16900,16570,16830,16695,155,20,152,"1,269.10",624
,20170822,16830,16695,16740,16815,16600,16690,16690,-5,-5,378,"3,155.15",758
,20170823,16690,16690,16715,16715,16440,16545,16560,-145,-130,152,"1,258.72",790
,20170824,16545,16560,16715,16995,16575,16575,16790,15,230,1412,"11,855.76",1496
,20170825,16575,16790,16645,16800,16635,16770,16700,-20,-90,1420,"11,859.84",1868
,20170828,16770,16700,16680,16690,16425,16620,16585,-80,-115,400,"3,317.76",1818
,20170829,16620,16585,16555,16610,16435,16445,16520,-140,-65,184,"1,519.97",1878
,20170830,16445,16520,16570,16680,16485,16680,16570,160,50,2720,"22,536.51",2154
,20170831,16680,16570,16600,16760,16515,16730,16600,160,30,782,"6,491.95",2298
,20170901,16730,16600,16875,16950,16790,16915,16880,315,280,1874,"15,820.97",3018
,20170904,16915,16880,16870,17055,16735,16775,16965,-105,85,1814,"15,390.80",3584
,20170905,16775,16965,16735,16830,16710,16725,16750,-240,-215,562,"4,707.19",3698
,20170906,16725,16750,16720,16730,16545,16575,16600,-175,-150,344,"2,855.44",3704
,20170907,16575,16600,16620,16620,16340,16340,16545,-260,-55,776,"6,421.20",4014
,20170908,16340,16545,16360,16405,15995,16115,16195,-430,-350,750,"6,074.30",4524
,20170911,16115,16195,16065,16710,16065,16710,16275,515,80,380,"3,093.10",4472
,20170912,16710,16275,16720,16910,16720,16910,16775,635,500,4280,"35,904.95",5710
,20170913,16910,16775,16805,16985,16750,16820,16915,45,140,3244,"27,440.58",6644
,20170914,16820,16915,16770,16905,16620,16845,16735,-70,-180,1150,"9,623.79",6698
,20170915,16845,16735,16790,16810,16470,16480,16565,-255,-170,3078,"25,496.16",7364
,20170918,16480,16565,16490,16695,16335,16635,16560,70,-5,664,"5,498.75",7464
,20170919,16635,16560,16610,16880,16590,16755,16760,195,200,452,"3,788.52",7406
,20170920,16755,16760,16790,17335,16680,17260,17055,500,295,1732,"14,772.04",7774
,20170921,17260,17055,17330,17440,16970,17065,17180,10,125,3992,"34,295.94",8712
,20170922,17065,17180,17095,17340,16510,16655,16740,-525,-440,2314,"19,369.47",9668
,20170925,16655,16740,16820,16935,16635,16680,16760,-60,20,616,"5,163.20",9748
,20170926,16680,16760,16740,16885,16720,16845,16815,85,55,404,"3,397.03",9724
,20170927,16845,16815,16730,16850,16670,16850,16750,35,-65,692,"5,796.17",9734
,20170928,16850,16750,16850,16850,16570,16715,16700,-35,-50,324,"2,705.96",9794
,20170929,16715,16700,16685,16710,16575,16680,16665,-20,-35,436,"3,633.69",9692
,20171009,16680,16665,16780,16905,16780,16900,16845,235,180,638,"5,375.10",10152
,20171010,16900,16845,16905,17040,16670,16720,16945,-125,100,592,"5,016.44",10186
,20171011,16720,16945,16735,16775,16520,16570,16665,-375,-280,318,"2,649.99",10368
,20171012,16570,16665,16540,16735,16515,16730,16605,65,-60,318,"2,640.31",10500
,20171013,16730,16605,16670,16885,16670,16865,16805,260,200,1918,"16,116.00",10914
,20171016,16865,16805,16860,16900,16650,16730,16825,-75,20,1014,"8,531.14",11014
,20171017,16730,16825,16800,16820,16565,16600,16650,-225,-175,1180,"9,826.34",11024
,20171018,16600,16650,16655,16655,16350,16360,16455,-290,-195,1312,"10,795.52",11150
,20171019,16360,16455,16380,16500,16250,16395,16350,-60,-105,2418,"19,767.95",11652
,20171020,16395,16350,16335,16605,16330,16555,16495,205,145,1254,"10,345.32",11638
,20171023,16555,16495,16520,16550,16385,16470,16500,-25,5,1880,"15,513.81",11190
,20171024,16470,16500,16480,16640,16445,16545,16535,45,35,1466,"12,121.55",11114
,20171025,16545,16535,16590,16715,16535,16555,16620,20,85,2320,"19,283.59",11990
,20171026,16555,16620,16620,16850,16615,16800,16770,180,150,5132,"43,034.70",14362
,20171027,16800,16770,16730,16780,16565,16565,16700,-205,-70,1796,"15,000.76",15328
,20171030,16565,16700,16545,16690,16525,16600,16595,-100,-105,3406,"28,267.94",16764
,20171031,16600,16595,16535,16650,16535,16625,16585,30,-10,1024,"8,491.53",16748
,20171101,16625,16585,16550,16790,16490,16495,16600,-90,15,2714,"22,526.25",16748
,20171102,16495,16600,16560,16575,16415,16485,16500,-115,-100,1970,"16,256.19",16992
,20171103,16485,16500,16480,16520,16420,16470,16470,-30,-30,904,"7,444.68",17226
,20171106,16470,16470,16470,16575,16310,16425,16390,-45,-80,1690,"13,852.22",17590
,20171107,16425,16390,16400,16440,16215,16285,16315,-105,-75,1250,"10,197.89",17910
,20171108,16285,16315,16230,16265,16070,16115,16150,-200,-165,2646,"21,367.57",18090
,20171109,16115,16150,16070,16090,15620,15775,15845,-375,-305,8478,"67,171.66",19846
,20171110,15775,15845,15780,15885,15765,15800,15810,-45,-35,5142,"40,657.14",20516
,20171113,15800,15810,15785,15905,15770,15840,15840,30,30,3822,"30,278.10",21594
,20171114,15840,15840,15810,15915,15720,15760,15785,-80,-55,6796,"53,651.00",23750
,20171115,15760,15785,15755,15925,15605,15750,15720,-35,-65,5036,"39,587.27",24512
,20171116,15750,15720,15795,15895,15730,15755,15795,35,75,2488,"19,649.83",24760
,20171117,15755,15795,15805,15815,15615,15685,15690,-110,-105,4614,"36,205.45",25112
,20171120,15685,15690,15625,15775,15355,15410,15520,-280,-170,12750,"98,964.90",27268
,20171121,15410,15520,15355,15435,15145,15170,15265,-350,-255,13182,"100,624.93",30830
,20171122,15170,15265,15160,15270,15095,15250,15200,-15,-65,7108,"54,031.04",31434
,20171123,15250,15200,15250,15440,15250,15270,15335,70,135,4612,"35,362.93",31898
,20171124,15270,15335,15325,15380,15225,15330,15300,-5,-35,3936,"30,118.56",32628
,20171127,15330,15300,15355,15430,15180,15245,15305,-55,5,10174,"77,869.12",35364
,20171128,15245,15305,15250,15305,15020,15050,15140,-255,-165,9792,"74,125.46",38020
,20171129,15050,15140,15050,15115,14865,14915,14955,-225,-185,16868,"126,143.85",41250
,20171130,14915,14955,14825,15015,14635,14980,14820,25,-135,21690,"160,744.00",45108
,20171201,14980,14820,14960,14970,14825,14900,14880,80,60,9646,"71,783.80",46294
,20171204,14900,14880,14920,15170,14710,14835,14890,-45,10,24256,"180,592.95",48724
,20171205,14835,14890,14850,14970,14785,14805,14880,-85,-10,13794,"102,634.40",50088
,20171206,14805,14880,14820,14850,14490,14565,14635,-315,-245,14380,"105,252.81",51852
,20171207,14565,14635,14580,14595,14355,14395,14455,-240,-180,19368,"140,012.27",55200
,20171208,14395,14455,14395,14570,14375,14505,14465,50,10,13624,"98,552.79",56564
,20171211,14505,14465,14490,14580,14405,14445,14485,-20,20,12974,"93,989.28",59636
,20171212,14445,14485,14440,14610,14395,14450,14485,-35,0,16982,"123,012.88",61314
,20171213,14450,14485,14505,14505,14335,14445,14435,-40,-50,19258,"138,995.58",62900
,20171214,14445,14435,14445,14535,14415,14475,14475,40,40,10898,"78,875.44",62928
,20171215,14475,14475,14520,14675,14500,14660,14595,185,120,12730,"92,917.15",62964
,20171218,14660,14595,14715,14825,14615,14710,14705,115,110,13404,"98,558.34",64338
,20171219,14710,14705,14720,14850,14630,14670,14680,-35,-25,14860,"109,083.58",66360
,20171220,14670,14680,14700,14910,14655,14885,14830,205,150,18118,"134,346.22",67862
,20171221,14885,14830,14940,14955,14815,14855,14865,25,35,17968,"133,581.54",70998
,20171222,14855,14865,14875,14930,14750,14825,14835,-40,-30,21108,"156,594.61",74190
,20171225,14825,14835,14895,15100,14820,14910,14990,75,155,53106,"398,121.96",96572
,20171226,14910,14990,14865,14945,14700,14805,14770,-185,-220,34910,"257,880.57",101608
,20171227,14805,14770,14950,15065,14810,14960,14925,190,155,44386,"331,330.82",107026
,20171228,14960,14925,15025,15345,14995,15300,15120,375,195,52228,"394,957.57",115862
,20171229,15300,15120,15300,15800,15210,15425,15335,305,215,46960,"360,168.65",121132
al1805,20170516,14195,14195,,,,14195,14195,0,0,0,0.00,0
,20170517,14195,14195,14270,14340,14270,14335,14315,140,120,34,243.37,30
,20170518,14335,14315,14320,14320,14245,14245,14260,-70,-55,24,171.14,28
,20170519,14245,14260,14255,14370,14250,14350,14315,90,55,30,214.80,40
,20170522,14350,14315,14405,14470,14190,14320,14340,5,25,52,372.93,74
,20170523,14320,14340,14300,14480,14280,14280,14320,-60,-20,30,214.81,70
,20170524,14280,14320,14320,14400,14320,14325,14350,5,30,8,57.41,76
,20170525,14325,14350,14305,14390,14305,14390,14345,40,-5,4,28.70,76
,20170526,14390,14345,14420,14445,14390,14445,14425,100,80,14,100.98,78
,20170531,14445,14425,14350,14350,14185,14185,14270,-240,-155,48,342.60,96
,20170601,14185,14270,14175,14305,14175,14240,14240,-30,-30,24,170.89,96
,20170602,14240,14240,14240,14265,14240,14240,14250,0,10,14,99.76,100
,20170605,14240,14250,14185,14295,14185,14215,14255,-35,5,16,114.05,100
,20170606,14215,14255,14170,14225,14130,14185,14170,-70,-85,32,226.73,100
,20170607,14185,14170,14175,14175,14170,14170,14170,0,0,24,170.05,118
,20170608,14170,14170,14235,14270,14235,14270,14250,100,80,14,99.77,118
,20170609,14270,14250,14225,14245,14110,14135,14155,-115,-95,22,155.74,120
,20170612,14135,14155,14220,14220,14195,14195,14205,40,50,12,85.25,122
,20170613,14195,14205,,,,14205,14205,0,0,0,0.00,122
,20170614,14205,14205,14220,14220,14180,14180,14185,-25,-20,10,70.94,124
,20170615,14180,14185,14180,14180,14030,14105,14070,-80,-115,40,281.42,104
,20170616,14105,14070,14095,14105,14095,14105,14100,35,30,4,28.20,106
,20170619,14105,14100,14100,14275,14090,14275,14210,175,110,40,284.25,108
,20170620,14275,14210,14255,14440,14220,14405,14350,195,140,42,301.43,136
,20170621,14405,14350,14405,14405,14300,14300,14355,-50,5,16,114.87,142
,20170622,14300,14355,14270,14375,14265,14265,14300,-90,-55,40,286.10,134
,20170623,14265,14300,14235,14350,14225,14320,14285,20,-15,10,71.44,140
,20170626,14320,14285,14325,14325,14255,14265,14270,-20,-15,16,114.18,144
,20170627,14265,14270,14180,14405,14180,14405,14275,135,5,56,399.73,164
,20170628,14405,14275,14380,14455,14370,14455,14405,180,130,30,216.13,170
,20170629,14455,14405,14405,14445,14355,14435,14400,30,-5,40,288.09,178
,20170630,14435,14400,14410,14455,14300,14300,14385,-100,-15,20,143.89,178
,20170703,14300,14385,14440,14555,14435,14555,14505,170,120,46,333.63,210
,20170704,14555,14505,14495,14530,14460,14460,14490,-45,-15,18,130.43,210
,20170705,14460,14490,14525,14640,14520,14615,14605,125,115,116,847.16,232
,20170706,14615,14605,14565,14610,14545,14545,14570,-60,-35,10,72.87,236
,20170707,14545,14570,14600,14600,14550,14550,14560,-20,-10,20,145.62,240
,20170710,14550,14560,14595,14610,14535,14535,14570,-25,10,46,335.11,242
,20170711,14535,14570,14510,14575,14470,14575,14510,5,-60,22,159.65,236
,20170712,14575,14510,14615,14715,14615,14650,14650,140,140,44,322.33,254
,20170713,14650,14650,14635,14750,14635,14745,14705,95,55,24,176.47,264
,20170714,14745,14705,14825,14900,14800,14800,14850,95,145,76,564.33,296
,20170717,14800,14850,14840,15015,14805,14980,14955,130,105,176,"1,316.04",398
,20170718,14980,14955,14950,14950,14570,14850,14845,-105,-110,72,534.50,394
,20170719,14850,14845,14875,14975,14875,14960,14940,115,95,36,268.99,392
,20170720,14960,14940,15125,15125,14935,14935,14995,-5,55,80,599.80,406
,20170721,14935,14995,14915,14985,14900,14985,14925,-10,-70,64,477.68,396
,20170724,14985,14925,14980,15005,14900,14970,14945,45,20,34,254.13,396
,20170725,14970,14945,14945,15030,14935,15030,14980,85,35,32,239.70,404
,20170726,15030,14980,15060,15060,15010,15010,15035,30,55,22,165.40,410
,20170727,15010,15035,15060,15060,14960,14960,14980,-75,-55,32,239.74,412
,20170728,14960,14980,15025,15080,14900,14940,14990,-40,10,34,254.85,426
,20170731,14940,14990,14960,15120,14900,15075,14980,85,-10,20,149.84,420
,20170801,15075,14980,14995,15055,14955,15055,14985,75,5,60,449.56,420
,20170802,15055,14985,14985,15380,14975,15300,15260,315,275,100,763.23,476
,20170803,15300,15260,15300,15380,15200,15215,15315,-45,55,62,474.83,502
,20170804,15215,15315,15255,15320,15210,15275,15255,-40,-60,72,549.32,522
,20170807,15275,15255,15265,15740,15265,15600,15590,345,335,144,"1,122.56",572
,20170808,15600,15590,15710,16070,15690,15955,15885,365,295,122,969.24,568
,20170809,15955,15885,16005,16705,15995,16600,16455,715,570,372,"3,060.68",608
,20170810,16600,16455,16580,16775,16360,16480,16575,25,120,168,"1,392.69",588
,20170811,16480,16575,16505,16620,16345,16440,16490,-135,-85,200,"1,649.12",608
,20170814,16440,16490,16605,16620,16205,16215,16390,-275,-100,288,"2,360.70",682
,20170815,16215,16390,16190,16325,16095,16260,16215,-130,-175,100,810.87,668
,20170816,16260,16215,16460,16685,16350,16615,16565,400,350,182,"1,507.59",674
,20170817,16615,16565,16680,17065,16650,16935,16925,370,360,462,"3,910.22",794
,20170818,16935,16925,16830,16855,16580,16750,16735,-175,-190,650,"5,439.39",902
,20170821,16750,16735,16785,16990,16605,16810,16810,75,75,368,"3,093.78",894
,20170822,16810,16810,16845,16865,16600,16715,16750,-95,-60,358,"2,998.75",1076
,20170823,16715,16750,16765,16765,16465,16565,16580,-185,-170,214,"1,774.20",1120
,20170824,16565,16580,16670,17000,16625,16625,16825,45,245,1658,"13,950.61",1928
,20170825,16625,16825,16710,16825,16660,16780,16735,-45,-90,432,"3,615.40",2040
,20170828,16780,16735,16700,16790,16425,16630,16605,-105,-130,330,"2,739.96",2020
,20170829,16630,16605,16590,16640,16450,16485,16545,-120,-60,130,"1,075.69",1994
,20170830,16485,16545,16635,16690,16530,16690,16590,145,45,658,"5,459.65",1898
,20170831,16690,16590,16625,16790,16520,16715,16640,125,50,1390,"11,566.64",1788
,20170901,16715,16640,16945,16965,16825,16950,16900,310,260,586,"4,952.34",1920
,20170904,16950,16900,16950,17090,16760,16780,16980,-120,80,526,"4,466.34",1966
,20170905,16780,16980,16805,16865,16715,16760,16800,-220,-180,426,"3,579.15",2058
,20170906,16760,16800,16745,16785,16550,16630,16660,-170,-140,244,"2,032.82",2092
,20170907,16630,16660,16635,16645,16380,16380,16555,-280,-105,642,"5,315.43",2242
,20170908,16380,16555,16400,16495,16000,16165,16200,-390,-355,342,"2,770.98",2250
,20170911,16165,16200,16135,16740,16075,16740,16280,540,80,518,"4,216.59",2202
,20170912,16740,16280,16715,16850,16715,16850,16790,570,510,1898,"15,934.31",2692
,20170913,16850,16790,16825,16985,16800,16820,16940,30,150,1906,"16,144.46",3430
,20170914,16820,16940,16755,16910,16630,16880,16780,-60,-160,464,"3,892.99",3514
,20170915,16880,16780,16825,16830,16495,16495,16595,-285,-185,2846,"23,621.78",4388
,20170918,16495,16595,16505,16725,16365,16575,16575,-20,-20,524,"4,343.29",4560
,20170919,16575,16575,16650,16920,16600,16780,16815,205,240,1364,"11,470.61",4432
,20170920,16780,16815,16825,17320,16725,17285,17110,470,295,2964,"25,360.04",5782
,20170921,17285,17110,17305,17430,17010,17120,17205,10,95,2660,"22,885.90",6454
,20170922,17120,17205,17140,17360,16535,16700,16810,-505,-395,2248,"18,899.15",6608
,20170925,16700,16810,16820,16990,16650,16760,16790,-50,-20,3138,"26,350.70",6776
,20170926,16760,16790,16780,16900,16765,16860,16830,70,40,504,"4,241.97",6848
,20170927,16860,16830,16760,16890,16700,16865,16795,35,-35,474,"3,981.28",6796
,20170928,16865,16795,16890,16890,16615,16730,16735,-65,-60,762,"6,376.77",6510
,20170929,16730,16735,16730,16775,16605,16705,16685,-30,-50,680,"5,674.27",6346
,20171009,16705,16685,16770,16945,16770,16910,16870,225,185,268,"2,260.70",6416
,20171010,16910,16870,16950,17075,16715,16715,17005,-155,135,2470,"21,004.97",7904
,20171011,16715,17005,16720,16825,16540,16600,16685,-405,-320,1016,"8,478.25",8042
,20171012,16600,16685,16590,16795,16495,16710,16625,25,-60,1588,"13,203.98",8260
,20171013,16710,16625,16705,16930,16705,16885,16835,260,210,646,"5,439.00",8304
,20171016,16885,16835,16940,16950,16675,16750,16845,-85,10,1082,"9,113.41",8578
,20171017,16750,16845,16820,16870,16605,16665,16695,-180,-150,890,"7,429.88",8682
,20171018,16665,16695,16695,16700,16390,16410,16505,-285,-190,1876,"15,482.53",9046
,20171019,16410,16505,16400,16565,16300,16460,16405,-45,-100,2448,"20,083.00",9332
,20171020,16460,16405,16520,16665,16390,16595,16575,190,170,1096,"9,085.16",9362
,20171023,16595,16575,16575,16600,16410,16530,16530,-45,-45,1604,"13,260.57",9550
,20171024,16530,16530,16515,16695,16490,16600,16600,70,70,2854,"23,692.51",9552
,20171025,16600,16600,16620,16785,16585,16590,16660,-10,60,2978,"24,814.16",9372
,20171026,16590,16660,16650,16895,16650,16860,16770,200,110,3358,"28,162.85",10802
,20171027,16860,16770,16790,16850,16600,16605,16700,-165,-70,3034,"25,338.76",11436
,20171030,16605,16700,16555,16750,16530,16640,16670,-60,-30,4162,"34,696.40",11674
,20171031,16640,16670,16600,16705,16600,16670,16645,0,-25,1582,"13,166.80",11780
,20171101,16670,16645,16600,16845,16550,16570,16685,-75,40,2352,"19,622.19",11912
,20171102,16570,16685,16650,16660,16480,16550,16570,-135,-115,1578,"13,076.96",11988
,20171103,16550,16570,16550,16595,16495,16555,16540,-15,-30,846,"6,997.87",12106
,20171106,16555,16540,16570,16620,16360,16490,16490,-50,-50,4084,"33,673.82",12014
,20171107,16490,16490,16470,16560,16295,16370,16385,-120,-105,2128,"17,438.93",12670
,20171108,16370,16385,16335,16355,16145,16180,16240,-205,-145,2650,"21,518.05",13098
,20171109,16180,16240,16160,16160,15705,15865,15960,-375,-280,5066,"40,434.31",13584
,20171110,15865,15960,15855,15980,15855,15865,15900,-95,-60,2340,"18,603.89",14068
,20171113,15865,15900,15925,15995,15875,15930,15935,30,35,2596,"20,685.50",14922
,20171114,15930,15935,15945,16005,15800,15855,15875,-80,-60,3408,"27,053.87",15908
,20171115,15855,15875,15870,16015,15680,15840,15815,-35,-60,3656,"28,913.85",16502
,20171116,15840,15815,15900,15980,15820,15830,15885,15,70,1256,"9,976.03",16456
,20171117,15830,15885,15880,15920,15720,15780,15815,-105,-70,1306,"10,327.78",16606
,20171120,15780,15815,15710,15850,15455,15510,15580,-305,-235,5850,"45,575.50",16708
,20171121,15510,15580,15420,15530,15235,15270,15365,-310,-215,8850,"67,990.45",19520
,20171122,15270,15365,15265,15365,15190,15350,15300,-15,-65,5902,"45,161.89",20762
,20171123,15350,15300,15350,15520,15335,15355,15430,55,130,5568,"42,970.95",21196
,20171124,15355,15430,15355,15460,15280,15425,15395,-5,-35,4632,"35,665.85",22378
,20171127,15425,15395,15440,15515,15270,15330,15395,-65,0,6966,"53,634.12",24370
,20171128,15330,15395,15350,15395,15105,15145,15230,-250,-165,5760,"43,872.03",25602
,20171129,15145,15230,15185,15215,14955,14995,15035,-235,-195,8776,"65,982.32",27142
,20171130,14995,15035,14985,15090,14725,15090,14895,55,-140,10748,"80,067.40",29232
,20171201,15090,14895,15060,15060,14910,14975,14975,80,80,6766,"50,663.82",29870
,20171204,14975,14975,15020,15250,14795,14935,14990,-40,15,15052,"112,827.72",31922
,20171205,14935,14990,14935,15060,14880,14895,14970,-95,-20,10710,"80,180.11",33402
,20171206,14895,14970,14925,14955,14580,14665,14750,-305,-220,11872,"87,562.90",35088
,20171207,14665,14750,14745,14745,14450,14490,14545,-260,-205,17830,"129,670.04",41046
,20171208,14490,14545,14525,14660,14465,14595,14555,50,10,12816,"93,287.88",42412
,20171211,14595,14555,14585,14670,14500,14530,14585,-25,30,9778,"71,310.54",44090
,20171212,14530,14585,14510,14705,14495,14545,14585,-40,0,12728,"92,823.96",45494
,20171213,14545,14585,14585,14605,14440,14550,14540,-35,-45,11958,"86,938.50",46452
,20171214,14550,14540,14550,14645,14515,14565,14565,25,25,12630,"92,004.35",47166
,20171215,14565,14565,14615,14770,14590,14760,14695,195,130,19268,"141,598.48",49146
,20171218,14760,14695,14815,14920,14705,14805,14805,110,110,20620,"152,664.50",49914
,20171219,14805,14805,14790,14855,14720,14765,14785,-40,-20,21364,"157,941.70",52004
,20171220,14765,14785,14795,15000,14745,14970,14910,185,125,20546,"153,210.49",53646
,20171221,14970,14910,14995,15085,14900,14945,14970,35,60,19460,"145,678.82",54358
,20171222,14945,14970,14965,15025,14845,14910,14935,-60,-35,19120,"142,790.92",54714
,20171225,14910,14935,14950,15180,14910,15000,15050,65,115,26978,"203,056.97",55924
,20171226,15000,15050,15045,15045,14790,14895,14875,-155,-175,19498,"145,042.43",57762
,20171227,14895,14875,14950,15150,14900,15065,15015,190,140,30596,"229,743.96",59424
,20171228,15065,15015,15120,15435,15080,15420,15225,405,210,33844,"257,639.68",61854
,20171229,15420,15225,15415,15600,15300,15570,15425,345,200,30558,"235,697.35",63370
al1806,20170616,14070,14070,,,,14070,14070,0,0,0,0.00,0
,20170619,14070,14070,13405,14305,13405,14305,14095,235,25,24,169.19,16
,20170620,14305,14095,14225,14445,14225,14405,14365,310,270,38,272.98,54
,20170621,14405,14365,14435,14435,14300,14300,14370,-65,5,12,86.24,58
,20170622,14300,14370,14345,14345,14315,14315,14330,-55,-40,4,28.66,56
,20170623,14315,14330,14270,14350,14270,14350,14310,20,-20,4,28.62,56
,20170626,14350,14310,14145,14335,14145,14315,14225,5,-85,102,725.63,124
,20170627,14315,14225,14255,14445,14255,14445,14295,220,70,80,571.95,126
,20170628,14445,14295,14420,14440,14420,14440,14430,145,135,6,43.30,128
,20170629,14440,14430,14435,14475,14420,14470,14440,40,10,36,260.00,116
,20170630,14470,14440,14450,14450,14425,14425,14430,-15,-10,14,101.04,110
,20170703,14425,14430,14500,14595,14500,14590,14550,160,120,30,218.28,120
,20170704,14590,14550,14555,14555,14550,14550,14550,0,0,10,72.76,126
,20170705,14550,14550,14580,14670,14540,14670,14585,120,35,60,437.60,136
,20170706,14670,14585,14625,14630,14565,14630,14595,45,10,28,204.40,152
,20170707,14630,14595,14575,14625,14560,14625,14590,30,-5,82,598.29,174
,20170710,14625,14590,14615,14630,14605,14605,14615,15,25,18,131.57,176
,20170711,14605,14615,14570,14600,14505,14600,14560,-15,-55,16,116.50,174
,20170712,14600,14560,14710,14740,14670,14730,14720,170,160,42,309.17,192
,20170713,14730,14720,14715,14810,14670,14810,14735,90,15,20,147.39,196
,20170714,14810,14735,14870,14925,14825,14860,14890,125,155,62,461.67,234
,20170717,14860,14890,14870,15050,14840,15020,14970,130,80,150,"1,122.95",334
,20170718,15020,14970,15020,15020,14840,14860,14910,-110,-60,86,641.20,314
,20170719,14860,14910,14990,15030,14930,15030,14990,120,80,72,539.67,370
,20170720,15030,14990,15040,15080,14945,14945,15000,-45,10,58,435.05,388
,20170721,14945,15000,14980,15000,14930,14945,14955,-55,-45,38,284.22,400
,20170724,14945,14955,15035,15035,14930,14995,14965,40,10,42,314.28,402
,20170725,14995,14965,14990,15080,14945,15060,15015,95,50,62,465.49,438
,20170726,15060,15015,15065,15135,15065,15070,15085,55,70,16,120.72,432
,20170727,15070,15085,15070,15070,14980,15000,15000,-85,-85,74,555.17,434
,20170728,15000,15000,15045,15045,14930,14965,14965,-35,-35,48,359.23,434
,20170731,14965,14965,14960,15100,14925,15100,14980,135,15,28,209.79,428
,20170801,15100,14980,15130,15130,15000,15080,15065,100,85,8,60.28,430
,20170802,15080,15065,15010,15355,15010,15345,15275,280,210,76,580.60,462
,20170803,15345,15275,15300,15390,15240,15255,15330,-20,55,54,413.98,478
,20170804,15255,15330,15270,15385,15270,15355,15320,25,-10,36,275.76,492
,20170807,15355,15320,15315,15750,15310,15690,15610,370,290,160,"1,249.02",550
,20170808,15690,15610,15750,16090,15745,16005,15940,395,330,84,669.52,584
,20170809,16005,15940,16075,16695,16075,16690,16560,750,620,490,"4,057.77",708
,20170810,16690,16560,16640,16820,16380,16475,16620,-85,60,150,"1,246.83",682
,20170811,16475,16620,16415,16670,16385,16480,16495,-140,-125,136,"1,121.97",664
,20170814,16480,16495,16610,16640,16200,16305,16415,-190,-80,132,"1,083.47",704
,20170815,16305,16415,16275,16380,16130,16380,16260,-35,-155,60,487.86,708
,20170816,16380,16260,16455,16650,16380,16645,16540,385,280,116,959.54,746
,20170817,16645,16540,16665,17060,16665,17000,16930,460,390,194,"1,642.69",798
,20170818,17000,16930,16850,16850,16620,16850,16740,-80,-190,320,"2,679.16",638
,20170821,16850,16740,16840,16990,16660,16935,16825,195,85,46,387.03,642
,20170822,16935,16825,16875,16905,16675,16755,16825,-70,0,122,"1,026.42",720
,20170823,16755,16825,16825,16840,16575,16575,16670,-250,-155,46,383.42,714
,20170824,16575,16670,16790,17085,16700,16700,16875,30,205,372,"3,139.60",908
,20170825,16700,16875,16650,16855,16650,16805,16760,-70,-115,92,771.06,916
,20170828,16805,16760,16680,16690,16460,16625,16590,-135,-170,102,846.30,882
,20170829,16625,16590,16510,16510,16475,16475,16495,-115,-95,6,49.50,878
,20170830,16475,16495,16645,16710,16530,16710,16595,215,100,138,"1,145.29",842
,20170831,16710,16595,16605,16840,16605,16775,16695,180,100,136,"1,135.53",820
,20170901,16775,16695,16910,17000,16820,16965,16920,270,225,262,"2,217.11",836
,20170904,16965,16920,16960,17090,16790,16820,16995,-100,75,78,662.99,840
,20170905,16820,16995,16820,16840,16760,16840,16780,-155,-215,144,"1,208.20",952
,20170906,16840,16780,16700,16705,16580,16640,16645,-140,-135,152,"1,265.35",1054
,20170907,16640,16645,16680,16680,16400,16400,16560,-245,-85,94,778.47,1046
,20170908,16400,16560,16430,16435,16150,16150,16335,-410,-225,42,343.04,1034
,20170911,16150,16335,16155,16730,16140,16730,16330,395,-5,78,636.96,1020
,20170912,16730,16330,16750,16870,16730,16845,16805,515,475,214,"1,798.64",1072
,20170913,16845,16805,16855,16990,16800,16845,16920,40,115,128,"1,083.11",1080
,20170914,16845,16920,16800,16895,16640,16845,16810,-75,-110,66,554.80,1088
,20170915,16845,16810,16710,16800,16525,16550,16590,-260,-220,180,"1,493.14",1152
,20170918,16550,16590,16510,16680,16380,16600,16595,10,5,66,547.79,1160
,20170919,16600,16595,16660,16945,16660,16800,16840,205,245,160,"1,347.26",1136
,20170920,16800,16840,16855,17315,16750,17240,17045,400,205,614,"5,233.05",1424
,20170921,17240,17045,17350,17435,17035,17065,17250,20,205,918,"7,919.37",1710
,20170922,17065,17250,17135,17375,16555,16645,16970,-605,-280,324,"2,749.75",1720
,20170925,16645,16970,16790,16955,16665,16780,16810,-190,-160,704,"5,918.20",1746
,20170926,16780,16810,16800,16935,16780,16865,16860,55,50,130,"1,095.98",1700
,20170927,16865,16860,16750,16915,16715,16870,16815,10,-45,56,470.85,1710
,20170928,16870,16815,16910,16910,16630,16775,16750,-40,-65,424,"3,552.00",1606
,20170929,16775,16750,16790,16795,16650,16780,16725,30,-25,218,"1,823.29",1586
,20171009,16780,16725,16850,16975,16850,16950,16925,225,200,52,440.16,1586
,20171010,16950,16925,16950,17085,16880,16880,16985,-45,60,178,"1,512.04",1598
,20171011,16880,16985,16800,16805,16590,16615,16755,-370,-230,174,"1,457.69",1658
,20171012,16615,16755,16620,16800,16550,16800,16650,45,-105,292,"2,430.96",1642
,20171013,16800,16650,16885,16960,16840,16870,16885,220,235,114,962.58,1642
,20171016,16870,16885,16945,16950,16750,16810,16865,-75,-20,196,"1,652.99",1702
,20171017,16810,16865,16880,16880,16640,16680,16730,-185,-135,92,769.62,1708
,20171018,16680,16730,16560,16565,16425,16450,16505,-280,-225,172,"1,419.77",1800
,20171019,16450,16505,16425,16615,16330,16500,16470,-5,-35,520,"4,282.27",2042
,20171020,16500,16470,16475,16710,16475,16680,16650,210,180,334,"2,780.99",2238
,20171023,16680,16650,16660,16660,16500,16620,16605,-30,-45,270,"2,242.10",2370
,20171024,16620,16605,16605,16720,16570,16640,16665,35,60,558,"4,649.91",2442
,20171025,16640,16665,16680,16810,16660,16670,16725,5,60,274,"2,291.88",2612
,20171026,16670,16725,16715,16930,16710,16880,16825,155,100,274,"2,305.21",2664
,20171027,16880,16825,16810,16855,16660,16660,16790,-165,-35,208,"1,746.48",2748
,20171030,16660,16790,16720,16765,16680,16685,16715,-105,-75,246,"2,056.49",2880
,20171031,16685,16715,16675,16760,16670,16720,16705,5,-10,128,"1,069.37",2966
,20171101,16720,16705,16680,16900,16630,16670,16735,-35,30,478,"4,000.25",3168
,20171102,16670,16735,16700,16705,16570,16620,16615,-115,-120,206,"1,711.79",3172
,20171103,16620,16615,16615,16655,16565,16605,16605,-10,-10,102,846.87,3192
,20171106,16605,16605,16605,16670,16435,16555,16555,-50,-50,182,"1,506.73",3214
,20171107,16555,16555,16560,16560,16355,16430,16460,-125,-95,140,"1,152.20",3230
,20171108,16430,16460,16385,16425,16220,16275,16305,-185,-155,228,"1,859.01",3292
,20171109,16275,16305,16220,16220,15795,15965,16030,-340,-275,1346,"10,788.99",3702
,20171110,15965,16030,15930,16040,15930,15965,15975,-65,-55,440,"3,514.57",3900
,20171113,15965,15975,16005,16100,15970,16030,16005,55,30,650,"5,201.88",4260
,20171114,16030,16005,16000,16095,15900,15970,15970,-35,-35,580,"4,632.75",4488
,20171115,15970,15970,15960,16125,15815,15990,15885,20,-85,620,"4,925.59",4840
,20171116,15990,15885,15960,16080,15925,15925,16000,40,115,126,"1,008.20",4848
,20171117,15925,16000,15980,15980,15825,15880,15900,-120,-100,170,"1,351.53",4800
,20171120,15880,15900,15825,15940,15550,15570,15700,-330,-200,1138,"8,933.47",4524
,20171121,15570,15700,15590,15590,15325,15345,15440,-355,-260,636,"4,910.41",4486
,20171122,15345,15440,15350,15450,15300,15410,15390,-30,-50,232,"1,785.69",4502
,20171123,15410,15390,15475,15605,15410,15410,15510,20,120,208,"1,613.48",4458
,20171124,15410,15510,15420,15510,15405,15505,15475,-5,-35,78,603.69,4428
,20171127,15505,15475,15535,15595,15365,15410,15470,-65,-5,1308,"10,119.34",4988
,20171128,15410,15470,15430,15455,15205,15230,15325,-240,-145,708,"5,426.65",5360
,20171129,15230,15325,15230,15240,15070,15090,15130,-235,-195,456,"3,449.84",5454
,20171130,15090,15130,15095,15195,14830,15195,14955,65,-175,640,"4,786.32",5528
,20171201,15195,14955,15130,15130,15005,15065,15065,110,110,342,"2,576.33",5622
,20171204,15065,15065,15145,15300,14900,15015,15100,-50,35,198,"1,495.00",5644
,20171205,15015,15100,15105,15170,14985,15000,15080,-100,-20,708,"5,338.63",6002
,20171206,15000,15080,15015,15015,14700,14745,14790,-335,-290,1250,"9,246.13",6702
,20171207,14745,14790,14735,14775,14540,14590,14625,-200,-165,1308,"9,567.89",7500
,20171208,14590,14625,14605,14750,14570,14710,14610,85,-15,2552,"18,642.51",8936
,20171211,14710,14610,14680,14765,14620,14620,14705,10,95,3038,"22,343.92",10522
,20171212,14620,14705,14620,14800,14605,14640,14685,-65,-20,1622,"11,910.35",10938
,20171213,14640,14685,14670,14695,14550,14635,14630,-50,-55,2216,"16,214.11",11282
,20171214,14635,14630,14655,14730,14620,14660,14655,30,25,896,"6,567.41",11360
,20171215,14660,14655,14705,14855,14705,14840,14780,185,125,1196,"8,841.31",11544
,20171218,14840,14780,14830,15000,14815,14890,14885,110,105,1160,"8,635.68",11648
,20171219,14890,14885,14895,14940,14775,14830,14870,-55,-15,744,"5,533.10",11780
,20171220,14830,14870,14935,15095,14865,15050,15015,180,145,780,"5,855.96",11704
,20171221,15050,15015,15105,15135,14995,15035,15080,20,65,702,"5,294.33",11856
,20171222,15035,15080,15075,15110,14930,15015,15020,-65,-60,536,"4,025.42",11798
,20171225,15015,15020,15050,15260,15035,15085,15160,65,140,704,"5,337.08",11820
,20171226,15085,15160,15015,15075,14880,14965,14935,-195,-225,876,"6,543.14",12114
,20171227,14965,14935,15060,15220,14990,15135,15100,200,165,846,"6,389.37",12260
,20171228,15135,15100,15240,15525,15160,15525,15330,425,230,4836,"37,073.62",14448
,20171229,15525,15330,15525,15615,15410,15585,15510,255,180,1234,"9,570.73",14848
al1807,20170718,14970,14970,14985,14985,14890,14910,14915,-60,-55,10,74.60,8
,20170719,14910,14915,14990,15050,14970,15050,15025,135,110,14,105.21,22
,20170720,15050,15025,15035,15115,14960,15000,15050,-25,25,38,285.96,34
,20170721,15000,15050,14965,15050,14965,15050,15010,0,-40,12,90.08,42
,20170724,15050,15010,15005,15005,15005,15005,15005,-5,-5,4,30.01,44
,20170725,15005,15005,15010,15105,15010,15095,15060,90,55,20,150.62,60
,20170726,15095,15060,,,,15060,15060,0,0,0,0.00,60
,20170727,15060,15060,15075,15075,15015,15015,15025,-45,-35,26,195.37,72
,20170728,15015,15025,14980,14980,14950,14955,14955,-70,-70,10,74.79,72
,20170731,14955,14955,14990,15125,14940,15125,15060,170,105,54,406.67,88
,20170801,15125,15060,15145,15145,15040,15130,15120,70,60,38,287.31,104
,20170802,15130,15120,15115,15455,15060,15380,15335,260,215,134,"1,027.76",176
,20170803,15380,15335,15405,15435,15260,15260,15405,-75,70,86,662.59,230
,20170804,15260,15405,15315,15415,15300,15370,15355,-35,-50,70,537.57,202
,20170807,15370,15355,15355,15790,15355,15725,15615,370,260,88,687.23,234
,20170808,15725,15615,15800,16100,15795,16015,16005,400,390,150,"1,200.47",296
,20170809,16015,16005,16180,16775,16180,16690,16570,685,565,316,"2,618.82",488
,20170810,16690,16570,16660,16830,16440,16490,16640,-80,70,174,"1,447.97",516
,20170811,16490,16640,16480,16705,16450,16545,16565,-95,-75,46,381.05,508
,20170814,16545,16565,16590,16660,16285,16320,16430,-245,-135,176,"1,446.10",534
,20170815,16320,16430,16270,16380,16115,16305,16265,-125,-165,88,715.82,544
,20170816,16305,16265,16480,16735,16360,16655,16575,390,310,278,"2,303.99",706
,20170817,16655,16575,16735,17100,16695,17015,16905,440,330,330,"2,789.81",814
,20170818,17015,16905,16855,16890,16655,16820,16785,-85,-120,374,"3,139.18",674
,20170821,16820,16785,16845,16950,16685,16950,16815,165,30,38,319.55,670
,20170822,16950,16815,16910,16925,16715,16785,16855,-30,40,86,724.88,664
,20170823,16785,16855,16825,16935,16575,16720,16715,-135,-140,388,"3,243.54",812
,20170824,16720,16715,16765,17105,16680,16680,16935,-35,220,568,"4,810.77",982
,20170825,16680,16935,16750,16870,16715,16800,16820,-135,-115,110,925.10,974
,20170828,16800,16820,16845,16845,16480,16705,16625,-115,-195,304,"2,527.26",1098
,20170829,16705,16625,16675,16685,16500,16505,16575,-120,-50,54,447.65,1092
,20170830,16505,16575,16635,16740,16590,16725,16650,150,75,128,"1,065.86",1076
,20170831,16725,16650,16595,16830,16595,16775,16725,125,75,344,"2,876.84",954
,20170901,16775,16725,16950,17010,16855,16990,16940,265,215,122,"1,033.44",960
,20170904,16990,16940,16925,17110,16820,16840,16995,-100,55,58,492.94,948
,20170905,16840,16995,16840,16855,16780,16780,16825,-215,-170,6,50.48,944
,20170906,16780,16825,16775,16815,16605,16725,16690,-100,-135,66,550.86,946
,20170907,16725,16690,16720,16720,16420,16470,16600,-220,-90,46,381.91,928
,20170908,16470,16600,16450,16450,16160,16215,16305,-385,-295,142,"1,157.77",850
,20170911,16215,16305,16115,16750,16115,16750,16465,445,160,72,592.85,864
,20170912,16750,16465,16805,16890,16790,16890,16835,425,370,66,555.58,882
,20170913,16890,16835,16880,17000,16830,16855,16955,20,120,68,576.51,906
,20170914,16855,16955,16800,16945,16715,16900,16820,-55,-135,24,201.84,904
,20170915,16900,16820,16750,16860,16575,16605,16665,-215,-155,54,449.99,898
,20170918,16605,16665,16580,16750,16430,16680,16600,15,-65,24,199.22,894
,20170919,16680,16600,16695,16925,16695,16815,16795,215,195,42,352.71,908
,20170920,16815,16795,16900,17300,16775,17300,17010,505,215,98,833.63,910
,20170921,17300,17010,17395,17395,17030,17140,17190,130,180,104,893.98,956
,20170922,17140,17190,17185,17360,16510,16665,16800,-525,-390,232,"1,949.19",888
,20170925,16665,16800,16815,16930,16715,16800,16810,0,10,196,"1,647.38",770
,20170926,16800,16810,16870,16935,16840,16840,16895,30,85,64,540.76,732
,20170927,16840,16895,16755,16930,16725,16930,16840,35,-55,86,724.32,740
,20170928,16930,16840,16885,16885,16770,16775,16795,-65,-45,168,"1,411.15",786
,20170929,16775,16795,16790,16805,16730,16790,16760,-5,-35,66,553.18,762
,20171009,16790,16760,16845,17000,16845,17000,16950,240,190,24,203.42,778
,20171010,17000,16950,17005,17105,16920,16920,17020,-30,70,30,255.36,782
,20171011,16920,17020,16795,16850,16595,16660,16750,-360,-270,78,653.28,766
,20171012,16660,16750,16615,16810,16615,16810,16685,60,-65,48,400.49,764
,20171013,16810,16685,16810,16990,16810,16960,16920,275,235,92,778.44,734
,20171016,16960,16920,16975,16975,16770,16830,16835,-90,-85,36,303.06,752
,20171017,16830,16835,16895,16895,16645,16700,16720,-135,-115,56,468.26,750
,20171018,16700,16720,16645,16645,16450,16465,16500,-255,-220,64,528.12,744
,20171019,16465,16500,16400,16630,16355,16560,16450,60,-50,178,"1,464.06",766
,20171020,16560,16450,16540,16725,16540,16695,16650,245,200,68,566.11,720
,20171023,16695,16650,16600,16695,16600,16615,16655,-35,5,46,383.15,722
,20171024,16615,16655,16605,16750,16570,16685,16685,30,30,98,817.65,758
,20171025,16685,16685,16705,16820,16695,16695,16730,10,45,66,552.14,814
,20171026,16695,16730,16930,16945,16885,16885,16925,155,195,8,67.71,812
,20171027,16885,16925,16870,16905,16810,16840,16845,-85,-80,206,"1,735.54",878
,20171030,16840,16845,16785,16790,16740,16770,16760,-75,-85,134,"1,122.99",986
,20171031,16770,16760,16710,16785,16700,16785,16750,25,-10,30,251.25,1004
,20171101,16785,16750,16820,16930,16645,16695,16840,-55,90,144,"1,212.57",956
,20171102,16695,16840,16730,16740,16645,16705,16700,-135,-140,40,334.00,974
,20171103,16705,16700,16645,16740,16640,16670,16685,-30,-15,72,600.71,968
,20171106,16670,16685,16680,16680,16500,16580,16585,-105,-100,36,298.59,962
,20171107,16580,16585,16625,16625,16480,16510,16520,-75,-65,98,809.64,988
,20171108,16510,16520,16425,16450,16265,16325,16360,-195,-160,88,719.97,1014
,20171109,16325,16360,16165,16210,15905,16000,16090,-360,-270,258,"2,075.71",970
,20171110,16000,16090,16060,16085,16020,16045,16040,-45,-50,62,497.35,948
,20171113,16045,16040,16075,16165,16040,16100,16095,60,55,74,595.58,984
,20171114,16100,16095,16045,16140,16000,16035,16055,-60,-40,32,256.96,984
,20171115,16035,16055,16195,16195,15875,15990,16040,-65,-15,24,192.48,982
,20171116,15990,16040,16075,16140,16055,16100,16085,60,45,48,386.14,964
,20171117,16100,16085,16075,16075,15965,15965,16005,-120,-80,40,320.16,976
,20171120,15965,16005,15900,16000,15655,15660,15810,-345,-195,98,774.72,952
,20171121,15660,15810,15715,15715,15425,15430,15580,-380,-230,164,"1,277.75",992
,20171122,15430,15580,15505,15535,15405,15535,15475,-45,-105,54,417.86,998
,20171123,15535,15475,15595,15700,15550,15550,15615,75,140,40,312.31,1010
,20171124,15550,15615,15610,15610,15610,15610,15610,-5,-5,2,15.61,1008
,20171127,15610,15610,15665,15665,15480,15490,15540,-120,-70,204,"1,585.45",1072
,20171128,15490,15540,15520,15590,15305,15305,15445,-235,-95,70,540.65,1078
,20171129,15305,15445,15200,15295,15145,15180,15215,-265,-230,130,988.98,1136
,20171130,15180,15215,15180,15255,14915,15255,15055,40,-160,124,933.56,1168
,20171201,15255,15055,15165,15185,15085,15120,15125,65,70,164,"1,240.60",1058
,20171204,15120,15125,15225,15395,15000,15060,15175,-65,50,52,394.67,1064
,20171205,15060,15175,15165,15230,15080,15080,15130,-95,-45,280,"2,118.47",1178
,20171206,15080,15130,15080,15090,14780,14835,14895,-295,-235,300,"2,234.84",1336
,20171207,14835,14895,14845,14850,14660,14670,14700,-225,-195,92,676.22,1394
,20171208,14670,14700,14725,14820,14670,14785,14740,85,40,124,914.11,1368
,20171211,14785,14740,14750,14830,14720,14725,14780,-15,40,64,473.00,1416
,20171212,14725,14780,14695,14885,14695,14745,14800,-35,20,70,518.01,1428
,20171213,14745,14800,14740,14775,14645,14755,14730,-45,-70,130,957.59,1508
,20171214,14755,14730,14790,14790,14740,14755,14765,25,35,8,59.08,1504
,20171215,14755,14765,14855,14950,14850,14935,14900,170,135,78,581.16,1490
,20171218,14935,14900,14955,15020,14945,14980,14985,80,85,66,494.63,1492
,20171219,14980,14985,14960,15010,14905,14905,14950,-80,-35,256,"1,913.97",1594
,20171220,14905,14950,14955,15165,14955,15145,15095,195,145,92,694.44,1598
,20171221,15145,15095,15165,15210,15090,15120,15150,25,55,128,969.65,1584
,20171222,15120,15150,15150,15185,15020,15055,15125,-95,-25,60,453.88,1562
,20171225,15055,15125,15280,15285,15120,15120,15215,-5,90,60,456.45,1568
,20171226,15120,15215,15120,15140,14980,15045,15020,-170,-195,130,976.31,1602
,20171227,15045,15020,15270,15300,15110,15200,15190,180,170,186,"1,413.11",1552
,20171228,15200,15190,15320,15595,15260,15590,15390,400,200,220,"1,693.40",1600
,20171229,15590,15390,15570,15720,15520,15675,15650,285,260,212,"1,659.21",1640
al1808,20170816,16265,16265,16490,16950,16490,16685,16685,420,420,14,116.80,6
,20170817,16685,16685,16785,17085,16640,17085,16920,400,235,82,693.92,56
,20170818,17085,16920,17015,17015,16720,16930,16830,10,-90,30,252.52,64
,20170821,16930,16830,16945,16945,16705,16890,16845,60,15,10,84.25,64
,20170822,16890,16845,16875,16975,16875,16955,16945,110,100,44,372.85,94
,20170823,16955,16945,16845,16865,16665,16695,16805,-250,-140,28,235.29,114
,20170824,16695,16805,17025,17155,16725,16725,17005,-80,200,456,"3,878.14",392
,20170825,16725,17005,16800,16835,16685,16685,16795,-320,-210,60,503.93,418
,20170828,16685,16795,16765,16765,16585,16730,16690,-65,-105,40,333.82,422
,20170829,16730,16690,16635,16635,16545,16545,16575,-145,-115,30,248.66,416
,20170830,16545,16575,16610,16755,16595,16755,16650,180,75,84,699.41,414
,20170831,16755,16650,16650,16865,16650,16825,16735,175,85,56,468.63,434
,20170901,16825,16735,16880,17010,16880,16985,16930,250,195,56,474.07,446
,20170904,16985,16930,17005,17120,16840,16840,17000,-90,70,102,867.05,444
,20170905,16840,17000,16855,16890,16835,16835,16850,-165,-150,12,101.13,436
,20170906,16835,16850,16785,16860,16620,16640,16705,-210,-145,16,133.65,442
,20170907,16640,16705,16680,16680,16595,16595,16640,-110,-65,38,316.16,444
,20170908,16595,16640,16505,16555,16160,16220,16385,-420,-255,74,606.40,468
,20170911,16220,16385,16185,16770,16180,16760,16450,375,65,62,510.09,458
,20170912,16760,16450,16895,16895,16815,16880,16855,430,405,100,842.83,476
,20170913,16880,16855,16880,17020,16805,16870,16920,15,65,38,321.52,482
,20170914,16870,16920,16945,16945,16675,16885,16800,-35,-120,50,420.03,476
,20170915,16885,16800,16700,16880,16555,16555,16680,-245,-120,68,567.23,486
,20170918,16555,16680,16550,16700,16550,16615,16635,-65,-45,16,133.09,486
,20170919,16615,16635,16715,16950,16715,16840,16880,205,245,40,337.70,488
,20170920,16840,16880,16805,17340,16790,17290,17165,410,285,172,"1,476.45",512
,20170921,17290,17165,17425,17425,17020,17115,17250,-50,85,76,655.53,514
,20170922,17115,17250,17125,17400,16560,16580,17025,-670,-225,72,612.91,506
,20170925,16580,17025,16795,16845,16710,16820,16815,-205,-210,178,"1,496.66",486
,20170926,16820,16815,16830,16930,16830,16925,16910,110,95,74,625.78,454
,20170927,16925,16910,16795,16920,16780,16900,16860,-10,-50,36,303.53,442
,20170928,16900,16860,16780,16905,16720,16775,16780,-85,-80,10,83.90,440
,20170929,16775,16780,16785,16830,16745,16805,16805,25,25,32,268.88,448
,20171009,16805,16805,16940,17005,16940,16985,16975,180,170,14,118.84,454
,20171010,16985,16975,17015,17125,17010,17090,17080,115,105,14,119.56,458
,20171011,17090,17080,16850,16860,16650,16650,16790,-430,-290,32,268.71,450
,20171012,16650,16790,16675,16685,16675,16685,16680,-105,-110,4,33.36,448
,20171013,16685,16680,16795,16985,16795,16935,16930,255,250,32,270.89,450
,20171016,16935,16930,16975,16980,16770,16820,16890,-110,-40,18,152.02,448
,20171017,16820,16890,16820,16885,16675,16675,16740,-215,-150,60,502.29,446
,20171018,16675,16740,16730,16730,16460,16460,16515,-280,-225,128,"1,057.00",494
,20171019,16460,16515,16430,16600,16370,16595,16440,80,-75,272,"2,236.23",526
,20171020,16595,16440,16565,16725,16520,16725,16605,285,165,38,315.58,510
,20171023,16725,16605,16575,16710,16545,16650,16635,45,30,44,366.02,494
,20171024,16650,16635,16635,16745,16595,16700,16715,65,80,146,"1,220.45",552
,20171025,16700,16715,16750,16860,16750,16860,16800,145,85,36,302.45,576
,20171026,16860,16800,16855,16970,16855,16970,16930,170,130,16,135.45,570
,20171027,16970,16930,16905,16920,16835,16835,16860,-95,-70,42,354.09,572
,20171030,16835,16860,16725,16810,16725,16750,16770,-110,-90,56,469.62,618
,20171031,16750,16770,16760,16820,16755,16800,16795,30,25,38,319.18,632
,20171101,16800,16795,16785,16900,16700,16700,16755,-95,-40,90,754.19,704
,20171102,16700,16755,16775,16785,16670,16755,16735,0,-20,84,703.01,728
,20171103,16755,16735,16725,16745,16685,16745,16710,10,-25,20,167.14,738
,20171106,16745,16710,16710,16785,16550,16645,16610,-65,-100,68,564.76,758
,20171107,16645,16610,16655,16655,16465,16545,16575,-65,-35,16,132.63,758
,20171108,16545,16575,16485,16485,16320,16390,16395,-185,-180,68,557.59,780
,20171109,16390,16395,16160,16270,15920,15950,16010,-445,-385,268,"2,145.36",696
,20171110,15950,16010,16005,16130,16005,16075,16085,65,75,34,273.49,720
,20171113,16075,16085,16135,16210,16110,16155,16145,70,60,34,274.47,744
,20171114,16155,16145,16145,16170,16110,16110,16135,-35,-10,18,145.24,746
,20171115,16110,16135,16245,16245,15950,15950,16045,-185,-90,8,64.19,744
,20171116,15950,16045,16140,16215,16130,16170,16150,125,105,32,258.45,746
,20171117,16170,16150,16095,16095,16095,16095,16095,-55,-55,2,16.10,746
,20171120,16095,16095,15975,16070,15750,15750,15895,-345,-200,30,238.46,734
,20171121,15750,15895,15750,15750,15600,15615,15665,-280,-230,40,313.30,732
,20171122,15615,15665,15560,15590,15560,15590,15580,-75,-85,10,77.91,726
,20171123,15590,15580,15680,15760,15650,15670,15680,90,100,26,203.87,710
,20171124,15670,15680,15695,15720,15690,15690,15695,10,15,62,486.70,690
,20171127,15690,15695,15740,15740,15580,15580,15625,-115,-70,20,156.29,698
,20171128,15580,15625,15615,15680,15430,15430,15565,-195,-60,32,249.09,688
,20171129,15430,15565,15320,15375,15275,15350,15330,-215,-235,70,536.69,676
,20171130,15350,15330,15220,15295,14995,15255,15185,-75,-145,180,"1,367.00",638
,20171201,15255,15185,15255,15260,15200,15200,15215,15,30,26,197.85,642
,20171204,15200,15215,15330,15395,15060,15190,15275,-25,60,54,412.45,652
,20171205,15190,15275,15185,15305,15145,15145,15200,-130,-75,206,"1,565.74",694
,20171206,15145,15200,15130,15190,14885,14950,14950,-250,-250,128,956.85,784
,20171207,14950,14950,14905,14935,14765,14790,14815,-160,-135,58,429.64,780
,20171208,14790,14815,14765,14910,14725,14910,14770,95,-45,20,147.75,776
,20171211,14910,14770,14905,14935,14810,14825,14865,55,95,30,223.02,794
,20171212,14825,14865,14810,14970,14805,14820,14820,-45,-45,60,444.67,808
,20171213,14820,14820,14850,14850,14795,14795,14815,-25,-5,44,325.99,810
,20171214,14795,14815,14840,14840,14840,14840,14840,25,25,2,14.84,810
,20171215,14840,14840,14950,15010,14895,15010,14975,170,135,42,314.58,812
,20171218,15010,14975,15030,15150,15030,15045,15065,70,90,36,271.26,810
,20171219,15045,15065,15055,15055,15000,15000,15015,-65,-50,94,705.93,812
,20171220,15000,15015,15075,15230,15075,15205,15205,190,190,184,"1,399.23",886
,20171221,15205,15205,15255,15265,15145,15175,15235,-30,30,178,"1,356.05",888
,20171222,15175,15235,15070,15175,15070,15150,15135,-85,-100,36,272.45,884
,20171225,15150,15135,15280,15365,15280,15330,15325,195,190,28,214.59,888
,20171226,15330,15325,15230,15230,15055,15115,15150,-210,-175,48,363.69,898
,20171227,15115,15150,15155,15355,15155,15245,15235,95,85,124,944.59,882
,20171228,15245,15235,15365,15670,15355,15670,15455,435,220,58,448.21,900
,20171229,15670,15455,15580,15755,15580,15755,15665,300,210,60,470.02,934
al1809,20170918,16680,16680,16425,16695,16405,16635,16555,-45,-125,16,132.47,10
,20170919,16635,16555,16705,16960,16505,16920,16840,365,285,22,185.26,30
,20170920,16920,16840,16845,17325,16725,17140,17005,300,165,88,748.32,90
,20170921,17140,17005,17350,17440,17060,17185,17270,180,265,64,552.74,100
,20170922,17185,17270,17310,17375,16605,16605,16955,-665,-315,68,576.61,94
,20170925,16605,16955,16885,16970,16700,16800,16845,-155,-110,120,"1,010.83",152
,20170926,16800,16845,16800,16955,16800,16935,16920,90,75,82,693.73,168
,20170927,16935,16920,16855,16950,16800,16885,16855,-35,-65,36,303.46,176
,20170928,16885,16855,16900,16940,16745,16790,16815,-65,-40,42,353.19,180
,20170929,16790,16815,16830,16875,16725,16875,16805,60,-10,34,285.76,180
,20171009,16875,16805,16970,17050,16920,17035,16985,230,180,44,373.76,174
,20171010,17035,16985,17020,17120,16870,16870,17015,-115,30,150,"1,276.13",200
,20171011,16870,17015,16860,16925,16635,16675,16785,-340,-230,248,"2,081.63",268
,20171012,16675,16785,16650,16845,16645,16800,16735,15,-50,22,184.12,274
,20171013,16800,16735,16780,16995,16770,16980,16910,245,175,154,"1,302.38",282
,20171016,16980,16910,17000,17015,16790,16880,16930,-30,20,82,694.14,298
,20171017,16880,16930,16850,16850,16685,16730,16760,-200,-170,100,838.21,298
,20171018,16730,16760,16710,16715,16500,16535,16600,-225,-160,128,"1,062.54",300
,20171019,16535,16600,16445,16635,16415,16615,16490,15,-110,112,923.54,312
,20171020,16615,16490,16715,16800,16660,16765,16745,275,255,48,401.95,302
,20171023,16765,16745,16735,16755,16615,16680,16685,-65,-60,20,166.88,300
,20171024,16680,16685,16465,16830,16465,16750,16655,65,-30,228,"1,899.12",314
,20171025,16750,16655,16800,16880,16770,16770,16830,115,175,36,303.01,324
,20171026,16770,16830,16790,17010,16790,16960,16945,130,115,50,423.72,318
,20171027,16960,16945,16920,16935,16770,16780,16875,-165,-70,82,692.01,314
,20171030,16780,16875,16760,16825,16760,16825,16795,-50,-80,42,352.75,312
,20171031,16825,16795,16795,16865,16745,16850,16790,55,-5,120,"1,007.46",344
,20171101,16850,16790,16795,16995,16740,16760,16895,-30,105,174,"1,470.11",342
,20171102,16760,16895,16765,16825,16705,16755,16755,-140,-140,158,"1,323.84",394
,20171103,16755,16755,16755,16780,16745,16755,16755,0,0,18,150.83,390
,20171106,16755,16755,16760,16785,16600,16705,16665,-50,-90,70,583.28,400
,20171107,16705,16665,16675,16695,16520,16565,16625,-100,-40,68,565.35,406
,20171108,16565,16625,16530,16535,16380,16405,16455,-220,-170,72,592.45,430
,20171109,16405,16455,16245,16330,15970,16100,16155,-355,-300,158,"1,276.62",456
,20171110,16100,16155,16160,16200,16125,16125,16150,-30,-5,60,484.63,482
,20171113,16125,16150,16245,16275,16165,16165,16215,15,65,38,308.09,488
,20171114,16165,16215,16215,16295,16155,16155,16205,-60,-10,36,291.72,490
,20171115,16155,16205,16165,16165,15960,16100,16085,-105,-120,42,337.79,486
,20171116,16100,16085,16210,16290,16185,16185,16240,100,155,140,"1,136.87",422
,20171117,16185,16240,16260,16260,16095,16110,16160,-130,-80,26,210.12,426
,20171120,16110,16160,16065,16065,15810,15850,15950,-310,-210,78,622.06,418
,20171121,15850,15950,15840,15840,15605,15605,15765,-345,-185,66,520.25,436
,20171122,15605,15765,15670,15715,15585,15685,15675,-80,-90,74,580.13,418
,20171123,15685,15675,15790,15880,15790,15790,15825,115,150,24,189.92,432
,20171124,15790,15825,15780,15780,15780,15780,15780,-45,-45,8,63.12,436
,20171127,15780,15780,15795,15865,15645,15695,15770,-85,-10,32,252.33,430
,20171128,15695,15770,15765,15765,15480,15545,15565,-225,-205,74,575.92,434
,20171129,15545,15565,15485,15485,15315,15340,15375,-225,-190,54,415.25,430
,20171130,15340,15375,15250,15380,15075,15380,15225,5,-150,84,639.46,440
,20171201,15380,15225,15350,15350,15250,15280,15275,55,50,32,244.41,438
,20171204,15280,15275,15395,15570,15250,15260,15425,-15,150,36,277.68,442
,20171205,15260,15425,15260,15360,15235,15235,15270,-190,-155,46,351.24,472
,20171206,15235,15270,15235,15280,14950,14990,15100,-280,-170,66,498.45,488
,20171207,14990,15100,15050,15050,14830,14865,14945,-235,-155,98,732.46,526
,20171208,14865,14945,14845,15005,14810,15005,14855,60,-90,26,193.15,538
,20171211,15005,14855,14890,14970,14880,14935,14925,80,70,30,223.94,550
,20171212,14935,14925,14650,15025,14650,14935,14895,10,-30,30,223.47,552
,20171213,14935,14895,14855,14950,14855,14895,14895,0,0,22,163.86,554
,20171214,14895,14895,14925,15015,14860,14910,14960,15,65,152,"1,137.33",592
,20171215,14910,14960,14985,15080,14985,15075,15050,115,90,52,391.38,574
,20171218,15075,15050,15100,15230,15100,15140,15140,90,90,38,287.75,576
,20171219,15140,15140,15125,15140,15050,15065,15075,-75,-65,54,407.14,598
,20171220,15065,15075,15160,15330,15160,15280,15265,205,190,36,274.80,582
,20171221,15280,15265,15320,15355,15265,15290,15310,25,45,132,"1,010.61",552
,20171222,15290,15310,15310,15310,15190,15235,15230,-75,-80,32,243.73,538
,20171225,15235,15230,15280,15495,15250,15250,15390,20,160,48,369.47,546
,20171226,15250,15390,15230,15270,15135,15195,15180,-195,-210,28,212.55,542
,20171227,15195,15180,15460,15460,15255,15335,15315,155,135,64,490.19,522
,20171228,15335,15315,15430,15740,15425,15740,15565,425,250,46,358.04,526
,20171229,15740,15565,15700,15855,15685,15855,15750,290,185,30,236.30,536
al1810,20171017,16930,16930,,,,16880,16880,-50,-50,0,0.00,0
,20171018,16880,16880,16545,16705,16545,16605,16610,-275,-270,12,99.67,10
,20171019,16605,16610,16510,16510,16510,16510,16510,-100,-100,2,16.51,12
,20171020,16510,16510,16660,16795,16660,16795,16725,285,215,4,33.46,14
,20171023,16795,16725,16795,16820,16585,16820,16725,95,0,24,200.71,20
,20171024,16820,16725,16755,16780,16755,16780,16765,55,40,4,33.54,22
,20171025,16780,16765,16880,16905,16770,16770,16815,5,50,12,100.90,28
,20171026,16770,16815,16955,17005,16935,17000,16990,185,175,80,679.71,76
,20171027,17000,16990,16955,16995,16800,16800,16885,-190,-105,90,759.99,100
,20171030,16800,16885,16830,16915,16825,16865,16855,-20,-30,70,590.04,144
,20171031,16865,16855,16820,16880,16820,16880,16845,25,-10,42,353.79,162
,20171101,16880,16845,16895,17005,16800,16800,16910,-45,65,94,794.95,194
,20171102,16800,16910,16805,16850,16725,16840,16785,-70,-125,72,604.26,238
,20171103,16840,16785,16765,16830,16765,16820,16790,35,5,12,100.76,238
,20171106,16820,16790,16810,16845,16640,16735,16745,-55,-45,34,284.67,238
,20171107,16735,16745,16735,16735,16600,16600,16700,-145,-45,44,367.49,242
,20171108,16600,16700,16595,16595,16440,16440,16535,-260,-165,42,347.24,240
,20171109,16440,16535,16380,16380,16055,16135,16250,-400,-285,82,666.40,264
,20171110,16135,16250,16250,16250,16180,16220,16220,-30,-30,40,324.46,266
,20171113,16220,16220,16235,16310,16235,16285,16280,65,60,20,162.83,272
,20171114,16285,16280,16245,16405,16240,16260,16335,-20,55,30,245.09,268
,20171115,16260,16335,16305,16390,16115,16130,16210,-205,-125,52,421.51,272
,20171116,16130,16210,16320,16360,16200,16200,16270,-10,60,42,341.76,276
,20171117,16200,16270,16265,16265,16140,16215,16195,-55,-75,22,178.18,280
,20171120,16215,16195,16115,16180,15880,15910,16020,-285,-175,48,384.56,286
,20171121,15910,16020,15930,15930,15725,15755,15825,-265,-195,40,316.56,280
,20171122,15755,15825,15735,15795,15685,15780,15760,-45,-65,30,236.41,280
,20171123,15780,15760,15915,15955,15820,15820,15900,60,140,32,254.41,296
,20171124,15820,15900,15775,15865,15755,15865,15790,-35,-110,36,284.30,296
,20171127,15865,15790,15910,15910,15770,15770,15830,-20,40,34,269.17,304
,20171128,15770,15830,15795,15795,15550,15560,15650,-270,-180,8,62.60,306
,20171129,15560,15650,15585,15585,15440,15460,15480,-190,-170,44,340.65,306
,20171130,15460,15480,15410,15425,15215,15345,15300,-135,-180,90,688.72,312
,20171201,15345,15300,15395,15395,15315,15320,15350,20,50,20,153.54,304
,20171204,15320,15350,15455,15560,15190,15360,15410,10,60,72,554.85,314
,20171205,15360,15410,15405,15455,15330,15330,15375,-80,-35,56,430.52,332
,20171206,15330,15375,15315,15340,15045,15140,15180,-235,-195,58,440.25,332
,20171207,15140,15180,15125,15125,14910,14935,14955,-245,-225,64,478.71,314
,20171208,14935,14955,14885,15045,14885,15045,14915,90,-40,20,149.19,310
,20171211,15045,14915,14990,15075,14950,14960,15020,45,105,40,300.42,306
,20171212,14960,15020,,,,15020,15020,0,0,0,0.00,306
,20171213,15020,15020,14905,15000,14900,15000,14930,-20,-90,12,89.59,306
,20171214,15000,14930,,,,14930,14930,0,0,0,0.00,306
,20171215,14930,14930,15060,15165,15055,15140,15120,210,190,42,317.54,306
,20171218,15140,15120,15190,15275,15190,15210,15210,90,90,30,228.17,312
,20171219,15210,15210,15210,15210,15200,15200,15200,-10,-10,6,45.61,306
,20171220,15200,15200,15235,15395,15235,15350,15345,150,145,46,353.03,328
,20171221,15350,15345,15420,15440,15365,15400,15405,55,60,22,169.47,334
,20171222,15400,15405,15380,15395,15300,15310,15360,-95,-45,14,107.54,338
,20171225,15310,15360,15370,15515,15360,15365,15440,5,80,26,200.78,336
,20171226,15365,15440,15325,15335,15210,15270,15245,-170,-195,40,304.99,358
,20171227,15270,15245,15490,15500,15380,15420,15455,175,210,12,92.74,360
,20171228,15420,15455,15520,15800,15520,15765,15650,310,195,40,313.00,370
,20171229,15765,15650,15905,15925,15780,15810,15865,160,215,72,571.18,394
al1811,20171116,16210,16210,16355,16355,16270,16270,16290,60,80,8,65.18,8
,20171117,16270,16290,16305,16370,16200,16220,16265,-70,-25,20,162.67,18
,20171120,16220,16265,16040,16350,15880,16105,16140,-160,-125,44,355.14,32
,20171121,16105,16140,15880,15880,15880,15880,15880,-260,-260,10,79.40,40
,20171122,15880,15880,15835,15900,15780,15800,15850,-80,-30,14,110.97,44
,20171123,15800,15850,15965,16100,15860,15860,15970,10,120,18,143.76,40
,20171124,15860,15970,15890,15900,15865,15900,15890,-70,-80,16,127.12,56
,20171127,15900,15890,15935,15940,15855,15940,15915,50,25,8,63.67,56
,20171128,15940,15915,15855,15980,15590,15700,15830,-215,-85,28,221.63,70
,20171129,15700,15830,15620,15620,15515,15570,15555,-260,-275,42,326.71,96
,20171130,15570,15555,15490,15505,15190,15505,15435,-50,-120,134,"1,034.23",152
,20171201,15505,15435,,,,15435,15435,0,0,0,0.00,152
,20171204,15435,15435,15550,15590,15280,15280,15495,-155,60,38,294.41,176
,20171205,15280,15495,15455,15485,15455,15485,15470,-10,-25,8,61.88,176
,20171206,15485,15470,15430,15430,15115,15240,15255,-230,-215,144,"1,098.51",224
,20171207,15240,15255,15215,15215,14975,15030,15060,-225,-195,62,466.96,208
,20171208,15030,15060,15010,15150,14970,15150,15050,90,-10,24,180.61,210
,20171211,15150,15050,15145,15145,15005,15005,15085,-45,35,6,45.26,206
,20171212,15005,15085,15010,15155,15010,15080,15090,-5,5,24,181.12,212
,20171213,15080,15090,15095,15095,15095,15095,15095,5,5,2,15.10,212
,20171214,15095,15095,15095,15095,15095,15095,15095,0,0,10,75.48,212
,20171215,15095,15095,15195,15205,15150,15205,15180,110,85,24,182.22,212
,20171218,15205,15180,15250,15365,15250,15315,15290,135,110,32,244.65,238
,20171219,15315,15290,15260,15290,15220,15220,15255,-70,-35,6,45.77,238
,20171220,15220,15255,15305,15435,15300,15435,15375,180,120,20,153.78,246
,20171221,15435,15375,15500,15500,15415,15415,15455,40,80,4,30.92,244
,20171222,15415,15455,15415,15415,15415,15415,15415,-40,-40,4,30.83,248
,20171225,15415,15415,15585,15585,15460,15460,15540,45,125,6,46.63,246
,20171226,15460,15540,15370,15370,15290,15300,15330,-240,-210,44,337.31,272
,20171227,15300,15330,15540,15565,15465,15480,15515,150,185,14,108.64,274
,20171228,15480,15515,15580,15920,15580,15920,15750,405,235,70,551.29,288
,20171229,15920,15750,15880,16015,15830,16015,15915,265,165,18,143.25,290
al1812,20171218,15180,15180,15305,15425,15305,15335,15355,155,175,6,46.07,2
,20171219,15335,15355,,,,15355,15355,0,0,0,0.00,2
,20171220,15355,15355,15435,15535,15240,15535,15480,180,125,38,294.14,20
,20171221,15535,15480,15460,15460,15460,15460,15460,-20,-20,2,15.46,20
,20171222,15460,15460,15460,15460,15460,15460,15460,0,0,10,77.30,28
,20171225,15460,15460,15645,15645,15415,15505,15520,45,60,8,62.09,28
,20171226,15505,15520,15535,15535,15335,15335,15420,-185,-100,18,138.79,36
,20171227,15335,15420,,,,15435,15435,15,15,0,0.00,36
,20171228,15435,15435,15405,15915,15405,15915,15800,480,365,76,600.47,88
,20171229,15915,15800,15995,16110,15955,16110,16035,310,235,32,256.64,106
au1701,20170103,264.05,261.9,263.8,263.8,263.3,263.3,263.45,1.4,1.55,36,948.54,510
,20170104,263.3,263.45,262.9,262.9,262.5,262.55,262.55,-.9,-.9,42,"1,102.80",516
,20170105,262.55,262.55,264,264,264,264,264,1.45,1.45,54,"1,425.60",462
,20170106,264,264,,,,264,264,0,0,0,0.00,462
,20170109,264,264,262,262,262,262,262,-2,-2,6,157.20,462
,20170110,262,262,266,267,266,267,266.9,5,4.9,72,"1,921.80",396
,20170111,267,266.9,267.55,267.55,267.55,267.55,267.55,.65,.65,12,321.06,384
,20170112,267.55,267.55,,,,267.55,267.55,0,0,0,0.00,384
,20170113,267.55,267.55,269,269,269,269,269,1.45,1.45,12,322.80,372
,20170116,269,269,,,,269,269,0,0,0,0.00,372
au1702,20170103,265.35,264.95,265,265.15,264.1,264.3,264.75,-.65,-.2,124,"3,282.94",454
,20170104,264.3,264.75,263.65,265.25,263.65,265.25,264.9,.5,.15,132,"3,497.32",362
,20170105,265.25,264.9,265,265.45,264.8,265.45,265,.55,.1,66,"1,749.07",318
,20170106,265.45,265,265,265.7,265,265,265.3,0,.3,28,742.84,290
,20170109,265,265.3,265.65,265.65,265.2,265.6,265.5,.3,.2,8,212.42,284
,20170110,265.6,265.5,267.1,267.85,267.1,267.3,267.6,1.8,2.1,20,535.24,274
,20170111,267.3,267.6,266.9,268.15,266.9,267.9,267.65,.3,.05,158,"4,229.49",196
,20170112,267.9,267.65,268.55,268.9,267.85,268.9,268.2,1.25,.55,34,911.94,188
,20170113,268.9,268.2,268.35,268.35,267.7,268.35,267.95,.15,-.25,18,482.38,186
,20170116,268.35,267.95,269,270.35,268.95,270.25,269.55,2.3,1.6,28,754.85,160
,20170117,270.25,269.55,270.5,271.95,270.5,271.95,271.05,2.4,1.5,6,162.65,158
,20170118,271.95,271.05,271,271,270.05,270.05,270.85,-1,-.2,22,595.91,150
,20170119,270.05,270.85,267.3,268.45,267.25,267.4,267.55,-3.45,-3.3,18,481.67,140
,20170120,267.4,267.55,267.8,269.4,267.4,268.5,268.3,.95,.75,90,"2,415.02",108
,20170123,268.5,268.3,267.7,270.5,267.7,270.5,269.55,2.2,1.25,6,161.74,110
,20170124,270.5,269.55,269.75,270.2,268.4,268.7,269.25,-.85,-.3,24,646.21,106
,20170125,268.7,269.25,269.2,269.25,263.6,266.25,267.45,-3,-1.8,26,695.49,108
,20170126,266.25,267.45,259.1,265.2,259.1,265.2,262.9,-2.25,-4.55,18,473.27,102
,20170203,265.2,262.9,,,,262.9,262.9,0,0,0,0.00,102
,20170206,262.9,262.9,,,,262.9,262.9,0,0,0,0.00,102
,20170207,262.9,262.9,266.7,273,266.7,273,269.85,10.1,6.95,24,647.64,102
,20170208,273,269.85,,,,269.85,269.85,0,0,0,0.00,102
,20170209,269.85,269.85,,,,269.85,269.85,0,0,0,0.00,102
,20170210,269.85,269.85,,,,269.85,269.85,0,0,0,0.00,102
,20170213,269.85,269.85,,,,269.85,269.85,0,0,0,0.00,102
,20170214,269.85,269.85,,,,269.85,269.85,0,0,0,0.00,102
,20170215,269.85,269.85,269.3,269.3,269.3,269.3,269.3,-.55,-.55,6,161.58,102
au1703,20170103,269.95,269.95,268.3,268.3,268.3,268.3,268.3,-1.65,-1.65,2,53.66,2
,20170104,268.3,268.3,267.6,267.6,266.9,267.5,267.3,-.8,-1,6,160.40,6
,20170105,267.5,267.3,,,,267.4,267.4,.1,.1,0,0.00,6
,20170106,267.4,267.4,,,,267.4,267.4,0,0,0,0.00,6
,20170109,267.4,267.4,,,,267.4,267.4,0,0,0,0.00,6
,20170110,267.4,267.4,,,,267.4,267.4,0,0,0,0.00,6
,20170111,267.4,267.4,,,,267.4,267.4,0,0,0,0.00,6
,20170112,267.4,267.4,,,,267.4,267.4,0,0,0,0.00,6
,20170113,267.4,267.4,268.5,268.5,268.5,268.5,268.5,1.1,1.1,2,53.70,8
,20170116,268.5,268.5,269.35,270.5,267.95,269.25,269.3,.75,.8,18,484.81,16
,20170117,269.25,269.3,,,,270.8,270.8,1.5,1.5,0,0.00,16
,20170118,270.8,270.8,,,,270.8,270.8,0,0,0,0.00,16
,20170119,270.8,270.8,269.35,269.35,269.35,269.35,269.35,-1.45,-1.45,6,161.61,22
,20170120,269.35,269.35,272.1,272.1,265.75,270.35,269.6,1,.25,34,916.67,26
,20170123,270.35,269.6,269.2,270.75,267.95,270.75,269.65,1.15,.05,20,539.33,24
,20170124,270.75,269.65,,,,269.65,269.65,0,0,0,0.00,24
,20170125,269.65,269.65,,,,269.65,269.65,0,0,0,0.00,24
,20170126,269.65,269.65,262.3,268.1,262.3,268.1,264.25,-1.55,-5.4,6,158.57,26
,20170203,268.1,264.25,,,,264.25,264.25,0,0,0,0.00,26
,20170206,264.25,264.25,,,,264.25,264.25,0,0,0,0.00,26
,20170207,264.25,264.25,264.25,275.85,264.25,275.85,270,11.6,5.75,16,432.06,22
,20170208,275.85,270,,,,270,270,0,0,0,0.00,22
,20170209,270,270,,,,270,270,0,0,0,0.00,22
,20170210,270,270,270.7,270.7,270.7,270.7,270.7,.7,.7,2,54.14,20
,20170213,270.7,270.7,,,,270.7,270.7,0,0,0,0.00,20
,20170214,270.7,270.7,,,,270.7,270.7,0,0,0,0.00,20
,20170215,270.7,270.7,,,,270.7,270.7,0,0,0,0.00,20
,20170216,270.7,270.7,,,,273.15,273.15,2.45,2.45,0,0.00,20
,20170217,273.15,273.15,,,,273.15,273.15,0,0,0,0.00,20
,20170220,273.15,273.15,270.7,275.3,268.2,275.3,270.95,2.15,-2.2,18,487.74,14
,20170221,275.3,270.95,271,271,271,271,271,.05,.05,8,216.80,6
,20170222,271,271,,,,271,271,0,0,0,0.00,6
,20170223,271,271,,,,271,271,0,0,0,0.00,6
,20170224,271,271,279.6,279.6,279.6,279.6,279.6,8.6,8.6,6,167.76,0
,20170227,279.6,279.6,,,,279.6,279.6,0,0,0,0.00,0
,20170228,279.6,279.6,,,,279.6,279.6,0,0,0,0.00,0
,20170301,279.6,279.6,,,,279.6,279.6,0,0,0,0.00,0
,20170302,279.6,279.6,,,,279.6,279.6,0,0,0,0.00,0
,20170303,279.6,279.6,,,,279.6,279.6,0,0,0,0.00,0
,20170306,279.6,279.6,,,,279.6,279.6,0,0,0,0.00,0
,20170307,279.6,279.6,,,,279.6,279.6,0,0,0,0.00,0
,20170308,279.6,279.6,,,,279.6,279.6,0,0,0,0.00,0
,20170309,279.6,279.6,,,,279.6,279.6,0,0,0,0.00,0
,20170310,279.6,279.6,,,,279.6,279.6,0,0,0,0.00,0
,20170313,279.6,279.6,,,,279.6,279.6,0,0,0,0.00,0
,20170314,279.6,279.6,,,,279.6,279.6,0,0,0,0.00,0
,20170315,279.6,279.6,,,,279.6,279.6,0,0,0,0.00,0
au1704,20170103,269.95,269.8,268.4,269.25,268.4,269.25,269.1,-.55,-.7,14,376.75,318
,20170104,269.25,269.1,267.75,268.5,267,267.4,267.95,-1.7,-1.15,116,"3,108.37",352
,20170105,267.4,267.95,267,267.45,266.9,267.45,267.05,-.5,-.9,8,213.66,352
,20170106,267.45,267.05,267,267.3,267,267.3,267,.25,-.05,30,801.13,322
,20170109,267.3,267,267.05,267.4,267.05,267.4,267.2,.4,.2,4,106.89,320
,20170110,267.4,267.2,268.9,269.25,268.9,269.25,269.05,2.05,1.85,4,107.63,320
,20170111,269.25,269.05,269.55,269.55,269.1,269.1,269.3,.05,.25,4,107.73,320
,20170112,269.1,269.3,269.15,269.85,267.3,269.85,268.8,.55,-.5,40,"1,075.27",320
,20170113,269.85,268.8,268.6,268.6,268.6,268.6,268.6,-.2,-.2,18,483.48,306
,20170116,268.6,268.6,269.35,270.85,269.2,270.85,269.7,2.25,1.1,18,485.53,306
,20170117,270.85,269.7,272,272.4,271.95,272.4,271.95,2.7,2.25,26,707.18,306
,20170118,272.4,271.95,272.1,272.1,271,271.1,271.2,-.85,-.75,36,976.33,306
,20170119,271.1,271.2,269.6,269.6,268.35,268.5,269.05,-2.7,-2.15,74,"1,991.02",304
,20170120,268.5,269.05,268.4,269.1,268.35,269.1,268.65,.05,-.4,14,376.17,292
,20170123,269.1,268.65,269.05,271.6,269.05,271.15,270.6,2.5,1.95,6,162.36,290
,20170124,271.15,270.6,270.5,271.2,270.5,270.7,270.75,.1,.15,24,649.88,298
,20170125,270.7,270.75,270.7,270.7,267.85,268.3,268.65,-2.45,-2.1,48,"1,289.61",302
,20170126,268.3,268.65,268.25,268.25,265.45,266.2,266.4,-2.45,-2.25,48,"1,278.89",310
,20170203,266.2,266.4,268.75,270,268.5,269.5,269.55,3.1,3.15,34,916.57,288
,20170206,269.5,269.55,272.05,272.45,271.8,272.05,272,2.5,2.45,12,326.43,292
,20170207,272.05,272,273.2,274.95,273.2,274.25,274.05,2.25,2.05,54,"1,480.04",262
,20170208,274.25,274.05,274.8,275,274.8,275,274.95,.95,.9,14,384.93,266
,20170209,275,274.95,276.45,276.45,275.95,276.1,276.25,1.15,1.3,24,663.00,258
,20170210,276.1,276.25,273.2,276.8,273.15,273.15,273.65,-3.1,-2.6,18,492.64,256
,20170213,273.15,273.65,273.55,275.35,273.55,274.3,274.35,.65,.7,28,768.28,254
,20170214,274.3,274.35,273.35,273.35,273.35,273.35,273.35,-1,-1,4,109.34,256
,20170215,273.35,273.35,273.35,273.35,273.35,273.35,273.35,0,0,2,54.67,258
,20170216,273.35,273.35,272.25,275.05,272.15,274.9,273.25,1.55,-.1,18,491.85,262
,20170217,274.9,273.25,275,275.2,275,275.2,275.05,1.95,1.8,8,220.04,260
,20170220,275.2,275.05,276.2,276.25,274.7,275.15,275.4,.1,.35,66,"1,817.89",280
,20170221,275.15,275.4,275.6,276.3,274.65,275.55,275.15,.15,-.25,50,"1,375.89",278
,20170222,275.55,275.15,,,,275.15,275.15,0,0,0,0.00,278
,20170223,275.15,275.15,276.1,276.4,276.05,276.4,276.2,1.25,1.05,8,220.99,278
,20170224,276.4,276.2,278,279.15,277.6,278.75,278.5,2.55,2.3,282,"7,853.88",276
,20170227,278.75,278.5,280.15,280.25,279.25,280.25,279.75,1.75,1.25,20,559.57,270
,20170228,280.25,279.75,279.85,279.85,279,279.5,279.35,-.25,-.4,18,502.89,268
,20170301,279.5,279.35,279.5,279.5,279.5,279.5,279.5,.15,.15,8,223.60,262
,20170302,279.5,279.5,276.7,277.95,276.7,277.95,277.2,-1.55,-2.3,6,166.33,260
,20170303,277.95,277.2,276.95,277.2,275.3,275.75,276.35,-1.45,-.85,48,"1,326.48",256
,20170306,275.75,276.35,275.6,275.85,275.6,275.75,275.75,-.6,-.6,8,220.61,264
,20170307,275.75,275.75,275.8,275.8,275.8,275.8,275.8,.05,.05,2,55.16,266
,20170308,275.8,275.8,274.35,274.4,273.25,273.4,273.65,-2.4,-2.15,18,492.65,274
,20170309,273.4,273.65,,,,273.65,273.65,0,0,0,0.00,274
,20170310,273.65,273.65,270.05,270.05,269.1,269.65,269.75,-4,-3.9,102,"2,751.71",266
,20170313,269.65,269.75,270.25,272.1,270.25,272.1,271.55,2.35,1.8,16,434.48,262
,20170314,272.1,271.55,271.3,271.35,271.3,271.35,271.3,-.2,-.25,8,217.05,262
,20170315,271.35,271.3,271.1,271.15,270.25,270.7,270.65,-.6,-.65,24,649.59,258
,20170316,270.7,270.65,,,,270.65,270.65,0,0,0,0.00,258
,20170317,270.65,270.65,275.35,275.35,275.35,275.35,275.35,4.7,4.7,4,110.14,258
,20170320,275.35,275.35,275.7,276.05,275.65,276.05,275.85,.7,.5,8,220.69,258
,20170321,276.05,275.85,276.55,276.55,276.3,276.3,276.4,.45,.55,4,110.57,258
,20170322,276.3,276.4,276.4,278.3,276.4,276.75,277.55,.35,1.15,74,"2,053.93",244
,20170323,276.75,277.55,277.05,277.7,277.05,277.65,277.4,.1,-.15,24,665.78,248
,20170324,277.65,277.4,277.35,277.35,277.15,277.25,277.2,-.15,-.2,10,277.21,242
,20170327,277.25,277.2,277.45,277.45,277.45,277.45,277.45,.25,.25,2,55.49,244
,20170328,277.45,277.45,280.15,280.8,279.9,280.8,280.5,3.35,3.05,18,504.98,240
,20170329,280.8,280.5,281.45,281.45,278.6,279.3,279.65,-1.2,-.85,20,559.38,230
,20170330,279.3,279.65,280.8,280.8,276.3,278.95,278.65,-.7,-1,10,278.67,226
,20170331,278.95,278.65,279.15,279.15,279.15,279.15,279.15,.5,.5,4,111.66,222
,20170405,279.15,279.15,,,,279.15,279.15,0,0,0,0.00,222
,20170406,279.15,279.15,279.15,279.15,279.15,279.15,279.15,0,0,6,167.49,222
,20170407,279.15,279.15,,,,279.15,279.15,0,0,0,0.00,222
,20170410,279.15,279.15,,,,279.15,279.15,0,0,0,0.00,222
,20170411,279.15,279.15,,,,279.15,279.15,0,0,0,0.00,222
,20170412,279.15,279.15,,,,279.15,279.15,0,0,0,0.00,222
,20170413,279.15,279.15,,,,279.15,279.15,0,0,0,0.00,222
,20170414,279.15,279.15,,,,279.15,279.15,0,0,0,0.00,222
,20170417,279.15,279.15,,,,279.15,279.15,0,0,0,0.00,222
au1705,20170216,273.35,273.35,275.2,279.45,274.55,275.5,277.65,2.15,4.3,68,"1,888.12",34
,20170217,275.5,277.65,278.15,278.15,275.85,276.8,277.2,-.85,-.45,286,"7,929.10",34
,20170220,276.8,277.2,277.9,277.9,277.9,277.9,277.9,.7,.7,8,222.32,40
,20170221,277.9,277.9,277.25,277.25,275.5,275.5,275.95,-2.4,-1.95,36,993.50,28
,20170222,275.5,275.95,276.75,276.75,276.15,276.65,276.5,.7,.55,6,165.91,28
,20170223,276.65,276.5,,,,276.5,276.5,0,0,0,0.00,28
,20170224,276.5,276.5,278.05,280.5,277.5,280.45,279.55,3.95,3.05,278,"7,771.68",54
,20170227,280.45,279.55,281.75,281.75,279.4,280.6,280.85,1.05,1.3,24,674.15,50
,20170228,280.6,280.85,281.5,281.9,280.9,280.9,281.35,.05,.5,8,225.08,48
,20170301,280.9,281.35,280.8,281,277.4,278.15,279.2,-3.2,-2.15,50,"1,396.22",36
,20170302,278.15,279.2,,,,279.2,279.2,0,0,0,0.00,36
,20170303,279.2,279.2,278.35,278.35,276.5,276.7,277,-2.5,-2.2,12,332.41,32
,20170306,276.7,277,276.25,277.2,275.8,277.1,276.5,.1,-.5,32,884.80,24
,20170307,277.1,276.5,275.5,275.5,275.45,275.45,275.45,-1.05,-1.05,6,165.28,20
,20170308,275.45,275.45,275,275,272.95,272.95,273.95,-2.5,-1.5,4,109.59,22
,20170309,272.95,273.95,272.9,273.95,272.9,273.95,273.4,0,-.55,4,109.37,24
,20170310,273.95,273.4,272.8,272.8,270.55,271,271.1,-2.4,-2.3,30,813.41,36
,20170313,271,271.1,270.8,272.4,270.8,272.4,271.65,1.3,.55,18,489.04,28
,20170314,272.4,271.65,273.6,273.6,272,272,272.8,.35,1.15,4,109.12,28
,20170315,272,272.8,271.7,273.5,271.7,271.9,272.6,-.9,-.2,8,218.11,32
,20170316,271.9,272.6,273.2,277.75,271.95,276.2,275.05,3.6,2.45,40,"1,100.29",30
,20170317,276.2,275.05,275.8,278.25,275.8,276.1,276.85,1.05,1.8,20,553.78,32
,20170320,276.1,276.85,277.45,277.45,276.6,276.7,276.7,-.15,-.15,20,553.45,24
,20170321,276.7,276.7,,,,276.7,276.7,0,0,0,0.00,24
,20170322,276.7,276.7,278.8,280.85,278.6,279.65,279.55,2.95,2.85,60,"1,677.54",40
,20170323,279.65,279.55,,,,279.55,279.55,0,0,0,0.00,40
,20170324,279.55,279.55,,,,279.55,279.55,0,0,0,0.00,40
,20170327,279.55,279.55,281.5,283,280.45,280.45,281.85,.9,2.3,64,"1,804.11",62
,20170328,280.45,281.85,281.5,281.5,280.9,280.9,281.25,-.95,-.6,22,618.84,46
,20170329,280.9,281.25,281.4,281.4,279.35,280.1,279.85,-1.15,-1.4,32,895.53,38
,20170330,280.1,279.85,280.85,280.85,279.75,279.75,280.3,-.1,.45,4,112.12,36
,20170331,279.75,280.3,280.6,280.9,279.95,279.95,280.7,-.35,.4,14,392.98,36
,20170405,279.95,280.7,,,,280.7,280.7,0,0,0,0.00,36
,20170406,280.7,280.7,281.6,281.6,280.6,280.6,281.1,-.1,.4,4,112.44,36
,20170407,280.6,281.1,283.65,284.65,283.65,284.15,284.2,3.05,3.1,10,284.23,38
,20170410,284.15,284.2,281.6,281.7,281.6,281.7,281.65,-2.5,-2.55,12,338.00,40
,20170411,281.7,281.65,281.95,282.5,281.15,281.4,281.7,-.25,.05,20,563.41,44
,20170412,281.4,281.7,286.65,286.65,285,285.05,286.15,3.35,4.45,14,400.66,42
,20170413,285.05,286.15,,,,286.15,286.15,0,0,0,0.00,42
,20170414,286.15,286.15,286.75,287.15,286.75,286.9,286.9,.75,.75,8,229.54,44
,20170417,286.9,286.9,289.6,289.6,288.2,288.2,288.65,1.3,1.75,6,173.20,46
,20170418,288.2,288.65,285.3,287.25,285.3,286.35,286.25,-2.3,-2.4,14,400.78,40
,20170419,286.35,286.25,286.55,286.9,286.1,286.4,286.55,.15,.3,24,687.82,36
,20170420,286.4,286.55,286.25,286.35,285.8,285.85,286.1,-.7,-.45,14,400.57,28
,20170421,285.85,286.1,285,285.15,285,285.15,285.1,-.95,-1,10,285.12,26
,20170424,285.15,285.1,286,286,286,286,286,.9,.9,10,286.00,16
,20170425,286,286,,,,285.6,285.6,-.4,-.4,0,0.00,16
,20170426,285.6,285.6,283.3,287.3,279.2,279.2,282.1,-6.4,-3.5,46,"1,297.78",4
,20170427,279.2,282.1,,,,282.1,282.1,0,0,0,0.00,4
,20170428,282.1,282.1,282.45,288.2,275.8,282.5,282.25,.4,.15,10,282.25,0
,20170502,282.5,282.25,,,,282.25,282.25,0,0,0,0.00,0
,20170503,282.25,282.25,,,,282.25,282.25,0,0,0,0.00,0
,20170504,282.25,282.25,,,,282.25,282.25,0,0,0,0.00,0
,20170505,282.25,282.25,,,,282.25,282.25,0,0,0,0.00,0
,20170508,282.25,282.25,,,,282.25,282.25,0,0,0,0.00,0
,20170509,282.25,282.25,,,,282.25,282.25,0,0,0,0.00,0
,20170510,282.25,282.25,,,,282.25,282.25,0,0,0,0.00,0
,20170511,282.25,282.25,,,,282.25,282.25,0,0,0,0.00,0
,20170512,282.25,282.25,,,,282.25,282.25,0,0,0,0.00,0
,20170515,282.25,282.25,,,,282.25,282.25,0,0,0,0.00,0
au1706,20170103,271.35,270.35,269.7,271.15,269.45,269.75,270.3,-.6,-.05,134748,"3,642,465.21",391396
,20170104,269.75,270.3,268.5,271.25,268.35,270.4,269.95,.1,-.35,237240,"6,405,315.59",403990
,20170105,270.4,269.95,270.3,270.6,268.15,269.5,269.2,-.45,-.75,281262,"7,571,912.96",401602
,20170106,269.5,269.2,269,269.85,268.7,268.85,269.3,-.35,.1,231806,"6,242,967.62",394922
,20170109,268.85,269.3,268.65,270.4,268.65,269.75,269.5,.45,.2,175304,"4,725,011.64",395864
,20170110,269.75,269.5,270.35,272.1,270.2,271.5,271.15,2,1.65,201672,"5,468,907.49",401688
,20170111,271.5,271.15,271.25,272.4,270.9,271.85,271.65,.7,.5,183268,"4,979,190.94",396044
,20170112,271.85,271.65,271.7,272.55,268.65,272.25,270.7,.6,-.95,342304,"9,266,620.06",388946
,20170113,272.25,270.7,272.3,272.5,270.5,271.25,271.35,.55,.65,185390,"5,031,206.09",379636
,20170116,271.25,271.35,271.6,273.45,270.45,272.95,271.7,1.6,.35,215196,"5,847,313.56",382384
,20170117,272.95,271.7,272.5,274.9,272.25,274.6,273.55,2.9,1.85,158070,"4,324,263.42",383002
,20170118,274.6,273.55,274.1,274.95,272.45,273.5,274.1,-.05,.55,194254,"5,325,077.57",373502
,20170119,273.5,274.1,273.15,273.6,270.2,270.7,271.7,-3.4,-2.4,176830,"4,804,616.13",365152
,20170120,270.7,271.7,271.2,271.75,270.1,271.4,270.95,-.3,-.75,159596,"4,324,900.33",364202
,20170123,271.4,270.95,270.85,273.7,270.55,272.75,272.15,1.8,1.2,175522,"4,777,220.49",362246
,20170124,272.75,272.15,272.7,273.3,272.1,272.35,272.7,.2,.55,119818,"3,267,458.90",358716
,20170125,272.35,272.7,272.15,272.8,267.85,269.6,270.9,-3.1,-1.8,149430,"4,048,332.76",338086
,20170126,269.6,270.9,269.6,270.05,266.65,267.6,267.95,-3.3,-2.95,142822,"3,827,611.24",318662
,20170203,267.6,267.95,270.1,271.95,270.1,271.6,271.3,3.65,3.35,82082,"2,227,258.92",306362
,20170206,271.6,271.3,271.3,274.4,270.25,274.3,272.7,3,1.4,190770,"5,202,506.39",318510
,20170207,274.3,272.7,275.15,276.7,274.6,276.5,275.55,3.8,2.85,160366,"4,419,537.53",321182
,20170208,276.5,275.55,276.35,277.25,275.85,276.75,276.65,1.2,1.1,142374,"3,939,429.70",324290
,20170209,276.75,276.65,278.7,279.2,278.05,278.2,278.45,1.55,1.8,148408,"4,132,992.14",319670
,20170210,278.2,278.45,278.1,278.85,274.6,275.25,276.6,-3.2,-1.85,220922,"6,111,473.71",307194
,20170213,275.25,276.6,275.6,277.3,275.3,276.4,276.3,-.2,-.3,197398,"5,454,669.43",299460
,20170214,276.4,276.3,276,276.2,274.05,276,275.25,-.3,-1.05,163040,"4,488,022.46",296866
,20170215,276,275.25,276.6,276.7,274,274.95,275.25,-.3,0,188556,"5,190,690.45",292854
,20170216,274.95,275.25,275,277.15,273.5,276.35,275.4,1.1,.15,224336,"6,178,576.42",288304
,20170217,276.35,275.4,277.25,277.9,276.8,277.45,277.35,2.05,1.95,155914,"4,324,333.07",289940
,20170220,277.45,277.35,278.2,278.6,276.2,276.85,277.35,-.5,0,148746,"4,125,778.27",286374
,20170221,276.85,277.35,277.15,277.65,276.6,277.5,277.15,.15,-.2,99214,"2,749,727.44",285070
,20170222,277.5,277.15,276.5,278.15,275.75,277.2,277.05,.05,-.1,159914,"4,430,630.43",284724
,20170223,277.2,277.05,277.65,278.15,276.5,277.75,277.4,.7,.35,153238,"4,251,437.24",283014
,20170224,277.75,277.4,278.8,281.7,278.4,281.15,280,3.75,2.6,273622,"7,662,110.89",311104
,20170227,281.15,280,282.2,282.45,280.55,282.15,281.75,2.15,1.75,180334,"5,081,214.52",300578
,20170228,282.15,281.75,281.85,283.35,280.95,281.2,281.85,-.55,.1,160636,"4,527,809.71",294068
,20170301,281.2,281.85,281.15,281.95,278.65,279.15,280.15,-2.7,-1.7,209236,"5,862,730.28",283306
,20170302,279.15,280.15,279.1,280.4,278.15,279.45,279.25,-.7,-.9,170848,"4,770,974.10",281422
,20170303,279.45,279.25,278.9,279.25,276.9,277.4,278,-1.85,-1.25,238202,"6,622,075.51",275322
,20170306,277.4,278,276.9,278.55,276.5,277.45,277.3,-.55,-.7,182046,"5,048,910.05",275560
,20170307,277.45,277.3,277.45,277.9,276.1,276.4,276.85,-.9,-.45,137414,"3,804,727.17",277758
,20170308,276.4,276.85,276,276,274.5,274.55,275.05,-2.3,-1.8,174404,"4,797,162.83",271694
,20170309,274.55,275.05,273.95,274.7,272.6,273.25,273.65,-1.8,-1.4,213736,"5,848,957.54",275000
,20170310,273.25,273.65,273.4,273.85,271,271.05,272.35,-2.6,-1.3,200774,"5,468,947.11",274928
,20170313,271.05,272.35,271.15,273.65,270.75,273.65,272.25,1.3,-.1,247398,"6,735,694.73",267394
,20170314,273.65,272.25,272.5,273.1,272.2,272.35,272.65,.1,.4,129460,"3,530,056.44",270226
,20170315,272.35,272.65,272.55,273.25,271.6,272.5,272.5,-.15,-.15,150980,"4,114,513.84",270808
,20170316,272.5,272.5,271.8,277.3,271.6,277.15,274.95,4.65,2.45,261416,"7,188,209.47",274042
,20170317,277.15,274.95,278.15,278.25,276.5,277.05,277.05,2.1,2.1,137970,"3,822,611.99",267062
,20170320,277.05,277.05,277.4,278.55,276.95,278.45,277.8,1.4,.75,138722,"3,854,314.33",277684
,20170321,278.45,277.8,278.25,278.75,276.65,277.35,277.6,-.45,-.2,167944,"4,662,406.63",267612
,20170322,277.35,277.6,277.65,280.35,277.5,279.8,279.25,2.2,1.65,244648,"6,831,988.88",273378
,20170323,279.8,279.25,279.75,280.2,278.9,279.75,279.5,.5,.25,164432,"4,596,296.09",266140
,20170324,279.75,279.5,280.45,280.7,278.45,278.95,279.3,-.55,-.2,184200,"5,145,108.88",262698
,20170327,278.95,279.3,279.2,282.25,278.75,282,280.6,2.7,1.3,162888,"4,571,209.81",270268
,20170328,282,280.6,282.05,282.35,280.95,281.2,281.5,.6,.9,148832,"4,189,908.66",262582
,20170329,281.2,281.5,282.05,282.15,280.05,280.6,281.1,-.9,-.4,159592,"4,486,520.63",257224
,20170330,280.6,281.1,280.95,281.2,280.1,280.6,280.65,-.5,-.45,126756,"3,557,599.09",256928
,20170331,280.6,280.65,280.35,280.35,278.2,278.6,279.3,-2.05,-1.35,178510,"4,985,998.07",247488
,20170405,278.6,279.3,281.2,281.75,280.75,281.25,281.1,1.95,1.8,74992,"2,108,114.87",249036
,20170406,281.25,281.1,280.2,281.7,279.2,281.25,280.45,.15,-.65,198064,"5,555,229.49",242570
,20170407,281.25,280.45,281.05,285.45,280.4,283.5,283.05,3.05,2.6,294194,"8,327,840.75",250516
,20170410,283.5,283.05,284.45,285.05,281.15,282.2,283,-.85,-.05,254310,"7,198,135.93",239110
,20170411,282.2,283,281.25,282.95,280.9,282.75,281.95,-.25,-1.05,169940,"4,792,069.79",245826
,20170412,282.75,281.95,283.4,287.1,283.25,285.85,285.2,3.9,3.25,316430,"9,024,986.47",262642
,20170413,285.85,285.2,286.1,288,285.1,287.15,286.6,1.95,1.4,242774,"6,958,363.25",255082
,20170414,287.15,286.6,287.55,288.05,286.75,287.7,287.55,1.1,.95,152170,"4,376,094.70",259634
,20170417,287.7,287.55,288.05,290.05,286.95,287.2,288.15,-.35,.6,196830,"5,672,365.98",241540
,20170418,287.2,288.15,286.9,287.9,285.8,286.45,286.75,-1.7,-1.4,194112,"5,567,083.68",234448
,20170419,286.45,286.75,286.6,287.7,285.2,286.3,286.55,-.45,-.2,250222,"7,170,661.23",226460
,20170420,286.3,286.55,286.55,286.75,284.75,286.1,285.85,-.45,-.7,216358,"6,185,573.05",218118
,20170421,286.1,285.85,285.95,286.35,285.25,285.9,285.8,.05,-.05,170642,"4,877,612.80",209336
,20170424,285.9,285.8,286.35,287.95,283.5,283.9,285.8,-1.9,0,310052,"8,862,540.81",189796
,20170425,283.9,285.8,283.35,284.4,282.95,283.9,283.75,-1.9,-2.05,166292,"4,718,841.38",179352
,20170426,283.9,283.75,282.75,283.55,282.15,282.45,282.7,-1.3,-1.05,183112,"5,176,886.47",165780
,20170427,282.45,282.7,282.55,283.55,282.05,282.85,282.8,.15,.1,154594,"4,372,371.86",153054
,20170428,282.85,282.8,283.1,283.25,282.3,283.2,282.8,.4,0,129946,"3,675,302.64",140542
,20170502,283.2,282.8,281.2,281.45,280.5,280.75,280.9,-2.05,-1.9,88702,"2,492,036.99",126228
,20170503,280.75,280.9,280.1,280.7,279.7,280.2,280.25,-.7,-.65,67824,"1,901,056.43",115372
,20170504,280.2,280.25,279.95,280.2,275.4,276.25,278.25,-4,-2,149004,"4,146,183.14",106420
,20170505,276.25,278.25,275,276.55,274.1,275.75,275.1,-2.5,-3.15,105704,"2,908,391.93",95760
,20170508,275.75,275.1,275.3,276.1,275,275.4,275.5,.3,.4,68168,"1,878,323.26",86016
,20170509,275.4,275.5,275.85,276.3,274.55,275.35,275.5,-.15,0,50856,"1,401,089.76",73352
,20170510,275.35,275.5,274.5,274.5,272.4,274.1,273.75,-1.4,-1.75,38072,"1,042,315.22",66892
,20170511,274.1,273.75,274.2,274.6,273.15,274.2,274.05,.45,.3,25208,"690,941.41",61494
,20170512,274.2,274.05,274.1,275.5,274,275.25,274.8,1.2,.75,25278,"694,669.82",54398
,20170515,275.25,274.8,275.6,276.45,274.6,276.25,275.65,1.45,.85,24588,"677,806.36",48680
,20170516,276.25,275.65,276.75,277.45,276,277,276.8,1.35,1.15,20452,"566,132.31",44230
,20170517,277,276.8,277.05,278.3,276.5,278.1,277.65,1.3,.85,22394,"621,821.91",38252
,20170518,278.1,277.65,279.3,281.8,279.3,280.3,280.35,2.65,2.7,31378,"879,834.06",32296
,20170519,280.3,280.35,280.6,281.3,279,279.85,280.3,-.5,-.05,26120,"732,175.89",28764
,20170522,279.85,280.3,280.35,280.75,279.45,280.55,280.15,.25,-.15,12136,"340,008.90",26680
,20170523,280.55,280.15,281.1,282.1,280.7,282.05,281.5,1.9,1.35,12494,"351,738.40",22596
,20170524,282.05,281.5,282,282.15,278.75,279,280.2,-2.5,-1.3,12740,"357,023.71",19404
,20170525,279,280.2,279.5,280.85,278.9,280.25,280.1,.05,-.1,9958,"278,962.54",16018
,20170526,280.25,280.1,280,280.45,279,280.45,279.5,.35,-.6,9780,"273,364.79",13072
,20170531,280.45,279.5,279.55,280.3,278,278.45,279.15,-1.05,-.35,8156,"227,708.10",9942
,20170601,278.45,279.15,279.1,279.75,278.15,278.9,278.85,-.25,-.3,3702,"103,236.42",8382
,20170602,278.9,278.85,278.1,278.95,277.6,277.9,277.95,-.95,-.9,1728,"48,035.64",7920
,20170605,277.9,277.95,280.3,281.85,279.75,281.55,281,3.6,3.05,1854,"52,098.27",7332
,20170606,281.55,281,281.55,283.7,281.2,283.35,282.55,2.35,1.55,2238,"63,241.50",6132
,20170607,283.35,282.55,283.95,284.1,283.25,283.7,283.75,1.15,1.2,636,"18,049.62",5814
,20170608,283.7,283.75,283.75,283.9,282.5,283.2,282.9,-.55,-.85,702,"19,861.74",5466
,20170609,283.2,282.9,281.2,281.3,280,280.5,280.65,-2.4,-2.25,888,"24,924.09",5052
,20170612,280.5,280.65,279.35,279.75,278,278.75,278.75,-1.9,-1.9,1122,"31,276.08",4500
,20170613,278.75,278.75,280.35,280.8,279,279.6,279.35,.85,.6,372,"10,393.20",4410
,20170614,279.6,279.35,280,281.8,280,281.8,280.6,2.45,1.25,54,"1,515.24",4398
,20170615,281.8,280.6,292,292,281,281,283,.4,2.4,36,"1,018.83",4368
au1707,20170418,288.15,288.15,,,,288.15,288.15,0,0,0,0.00,0
,20170419,288.15,288.15,,,,288.15,288.15,0,0,0,0.00,0
,20170420,288.15,288.15,,,,288.15,288.15,0,0,0,0.00,0
,20170421,288.15,288.15,,,,288.15,288.15,0,0,0,0.00,0
,20170424,288.15,288.15,285.15,287.7,285.15,287.65,286.45,-.5,-1.7,32,916.66,14
,20170425,287.65,286.45,283.35,285.6,283.35,285.6,284.45,-.85,-2,4,113.79,16
,20170426,285.6,284.45,284.5,284.75,283.7,284.75,284.3,.3,-.15,6,170.59,14
,20170427,284.75,284.3,283.95,283.95,283.95,283.95,283.95,-.35,-.35,2,56.79,16
,20170428,283.95,283.95,283.9,283.9,283.75,283.75,283.75,-.2,-.2,12,340.53,6
,20170502,283.75,283.75,283.1,283.1,283.1,283.1,283.1,-.65,-.65,2,56.62,4
,20170503,283.1,283.1,,,,283.1,283.1,0,0,0,0.00,4
,20170504,283.1,283.1,,,,281.05,281.05,-2.05,-2.05,0,0.00,4
,20170505,281.05,281.05,280.8,280.8,275.75,275.75,278.25,-5.3,-2.8,4,111.31,4
,20170508,275.75,278.25,,,,278.25,278.25,0,0,0,0.00,4
,20170509,278.25,278.25,,,,278.25,278.25,0,0,0,0.00,4
,20170510,278.25,278.25,,,,278.25,278.25,0,0,0,0.00,4
,20170511,278.25,278.25,,,,278.25,278.25,0,0,0,0.00,4
,20170512,278.25,278.25,,,,278.25,278.25,0,0,0,0.00,4
,20170515,278.25,278.25,278.25,278.25,277.4,277.4,277.75,-.85,-.5,8,222.23,4
,20170516,277.4,277.75,279.65,279.8,278,279.45,279.3,1.7,1.55,38,"1,061.40",26
,20170517,279.45,279.3,280.15,280.15,279.75,279.75,280,.45,.7,10,280.01,18
,20170518,279.75,280,281.1,283.45,281.1,283.3,282.2,3.3,2.2,22,620.84,14
,20170519,283.3,282.2,,,,282.2,282.2,0,0,0,0.00,14
,20170522,282.2,282.2,,,,282.2,282.2,0,0,0,0.00,14
,20170523,282.2,282.2,282.2,282.3,281.05,282.3,281.85,.1,-.35,6,169.11,10
,20170524,282.3,281.85,282.85,282.85,280.45,280.45,281.75,-1.4,-.1,6,169.06,14
,20170525,280.45,281.75,282.5,282.5,282.5,282.5,282.5,.75,.75,2,56.50,12
,20170526,282.5,282.5,,,,282.5,282.5,0,0,0,0.00,12
,20170531,282.5,282.5,,,,282.15,282.15,-.35,-.35,0,0.00,12
,20170601,282.15,282.15,281,281,281,281,281,-1.15,-1.15,2,56.20,10
,20170602,281,281,,,,281,281,0,0,0,0.00,10
,20170605,281,281,,,,281,281,0,0,0,0.00,10
,20170606,281,281,,,,281,281,0,0,0,0.00,10
,20170607,281,281,,,,281,281,0,0,0,0.00,10
,20170608,281,281,285.95,285.95,284.55,285.7,285.4,4.7,4.4,6,171.24,14
,20170609,285.7,285.4,285.7,285.7,278,278,281.85,-7.4,-3.55,32,901.92,30
,20170612,278,281.85,,,,281.85,281.85,0,0,0,0.00,30
,20170613,281.85,281.85,278.15,279.85,278.15,278.25,279.45,-3.6,-2.4,22,614.88,14
,20170614,278.25,279.45,279.95,280,277.4,279.5,278.35,.05,-1.1,24,668.15,16
,20170615,279.5,278.35,,,,278.35,278.35,0,0,0,0.00,16
,20170616,278.35,278.35,,,,278.35,278.35,0,0,0,0.00,16
,20170619,278.35,278.35,278.35,278.35,278.35,278.35,278.35,0,0,6,167.01,10
,20170620,278.35,278.35,,,,278,278,-.35,-.35,0,0.00,10
,20170621,278,278,,,,278,278,0,0,0,0.00,10
,20170622,278,278,,,,278,278,0,0,0,0.00,10
,20170623,278,278,,,,278,278,0,0,0,0.00,10
,20170626,278,278,280.1,280.1,280.1,280.1,280.1,2.1,2.1,2,56.02,10
,20170627,280.1,280.1,280.1,280.1,275.6,275.6,278.15,-4.5,-1.95,14,389.44,0
,20170628,275.6,278.15,,,,278.15,278.15,0,0,0,0.00,0
,20170629,278.15,278.15,,,,278.15,278.15,0,0,0,0.00,0
,20170630,278.15,278.15,,,,278.15,278.15,0,0,0,0.00,0
,20170703,278.15,278.15,,,,278.15,278.15,0,0,0,0.00,0
,20170704,278.15,278.15,,,,278.15,278.15,0,0,0,0.00,0
,20170705,278.15,278.15,,,,278.15,278.15,0,0,0,0.00,0
,20170706,278.15,278.15,,,,278.15,278.15,0,0,0,0.00,0
,20170707,278.15,278.15,,,,278.15,278.15,0,0,0,0.00,0
,20170710,278.15,278.15,,,,278.15,278.15,0,0,0,0.00,0
,20170711,278.15,278.15,,,,278.15,278.15,0,0,0,0.00,0
,20170712,278.15,278.15,,,,278.15,278.15,0,0,0,0.00,0
,20170713,278.15,278.15,,,,278.15,278.15,0,0,0,0.00,0
,20170714,278.15,278.15,,,,278.15,278.15,0,0,0,0.00,0
,20170717,278.15,278.15,,,,278.15,278.15,0,0,0,0.00,0
au1708,20170103,271.3,271.4,,,,271.4,271.4,0,0,0,0.00,208
,20170104,271.4,271.4,269.75,269.75,269.75,269.75,269.75,-1.65,-1.65,2,53.95,208
,20170105,269.75,269.75,,,,269.75,269.75,0,0,0,0.00,208
,20170106,269.75,269.75,270.6,270.6,270.6,270.6,270.6,.85,.85,2,54.12,208
,20170109,270.6,270.6,270.55,270.55,270.1,270.35,270.35,-.25,-.25,8,216.31,206
,20170110,270.35,270.35,,,,270.35,270.35,0,0,0,0.00,206
,20170111,270.35,270.35,272,272,272,272,272,1.65,1.65,2,54.40,206
,20170112,272,272,272.35,273,272.35,273,272.5,1,.5,8,218.01,206
,20170113,273,272.5,271.5,272.25,271.1,271.75,271.55,-.75,-.95,18,488.82,196
,20170116,271.75,271.55,272.5,274.3,272.5,274.05,272.65,2.5,1.1,74,"2,017.67",176
,20170117,274.05,272.65,273.45,275.15,273.45,275.15,274.3,2.5,1.65,4,109.72,172
,20170118,275.15,274.3,274.75,274.75,274.75,274.75,274.75,.45,.45,2,54.95,170
,20170119,274.75,274.75,274.1,274.1,270.65,271.55,271.5,-3.2,-3.25,18,488.76,160
,20170120,271.55,271.5,272.65,273.8,272.65,273.8,272.75,2.3,1.25,90,"2,454.88",114
,20170123,273.8,272.75,272.4,274.2,272.4,274.2,272.85,1.45,.1,8,218.28,110
,20170124,274.2,272.85,273.7,274.2,273.7,274.2,274.05,1.35,1.2,8,219.26,110
,20170125,274.2,274.05,273.7,273.7,270.9,270.9,272.4,-3.15,-1.65,20,544.82,90
,20170126,270.9,272.4,269.05,269.75,269.05,269.55,269.55,-2.85,-2.85,16,431.29,92
,20170203,269.55,269.55,,,,269.55,269.55,0,0,0,0.00,92
,20170206,269.55,269.55,273,273.7,273,273.7,273.15,4.15,3.6,8,218.54,86
,20170207,273.7,273.15,276.8,277.2,276.45,277.15,276.85,4,3.7,12,332.24,82
,20170208,277.15,276.85,277.05,277.05,277.05,277.05,277.05,.2,.2,2,55.41,80
,20170209,277.05,277.05,280.25,280.3,279.7,279.7,280.05,2.65,3,12,336.06,78
,20170210,279.7,280.05,279.5,279.5,276.3,277,277.1,-3.05,-2.95,12,332.56,76
,20170213,277,277.1,278,278.3,277.75,277.75,277.95,.65,.85,12,333.56,72
,20170214,277.75,277.95,276.45,277.65,276.45,277.65,276.9,-.3,-1.05,6,166.14,72
,20170215,277.65,276.9,,,,276.9,276.9,0,0,0,0.00,72
,20170216,276.9,276.9,276.6,278.75,276.1,278.4,277,1.5,.1,62,"1,717.50",78
,20170217,278.4,277,279.15,279.15,279.15,279.15,279.15,2.15,2.15,4,111.66,76
,20170220,279.15,279.15,278.45,278.45,278.45,278.45,278.45,-.7,-.7,2,55.69,74
,20170221,278.45,278.45,,,,278.45,278.45,0,0,0,0.00,74
,20170222,278.45,278.45,277.85,277.85,277.85,277.85,277.85,-.6,-.6,2,55.57,74
,20170223,277.85,277.85,279.1,279.1,279.1,279.1,279.1,1.25,1.25,2,55.82,72
,20170224,279.1,279.1,281.1,282.4,281.1,282.4,282.05,3.3,2.95,80,"2,256.46",122
,20170227,282.4,282.05,283.85,284.2,283.85,284.2,284,2.15,1.95,4,113.61,122
,20170228,284.2,284,283.4,284.9,282.95,282.95,283.9,-1.05,-.1,30,851.73,122
,20170301,282.95,283.9,283.65,283.65,281.25,281.3,281.7,-2.6,-2.2,22,619.80,122
,20170302,281.3,281.7,,,,281.7,281.7,0,0,0,0.00,122
,20170303,281.7,281.7,280.5,280.5,280.5,280.5,280.5,-1.2,-1.2,2,56.10,122
,20170306,280.5,280.5,279.7,279.7,278.55,278.55,279.1,-1.95,-1.4,4,111.65,122
,20170307,278.55,279.1,278.3,278.3,278.3,278.3,278.3,-.8,-.8,2,55.66,122
,20170308,278.3,278.3,,,,278.3,278.3,0,0,0,0.00,122
,20170309,278.3,278.3,,,,278.3,278.3,0,0,0,0.00,122
,20170310,278.3,278.3,273.3,273.3,272.9,272.9,273,-5.4,-5.3,8,218.40,120
,20170313,272.9,273,274.65,275.45,274.65,275.45,275.05,2.45,2.05,4,110.02,120
,20170314,275.45,275.05,,,,275.05,275.05,0,0,0,0.00,120
,20170315,275.05,275.05,,,,275.05,275.05,0,0,0,0.00,120
,20170316,275.05,275.05,277.9,279.25,277.9,279.25,279,4.2,3.95,36,"1,004.44",150
,20170317,279.25,279,280.1,280.1,279,279,279.75,0,.75,22,615.54,152
,20170320,279,279.75,280.15,280.95,279.55,280.5,280.45,.75,.7,12,336.57,148
,20170321,280.5,280.45,,,,280.45,280.45,0,0,0,0.00,148
,20170322,280.45,280.45,280.6,282.45,280.6,281.9,281.65,1.45,1.2,10,281.67,150
,20170323,281.9,281.65,281.85,282.15,280.75,281.15,281.35,-.5,-.3,186,"5,233.18",76
,20170324,281.15,281.35,281,281,280.65,280.65,280.8,-.7,-.55,10,280.80,68
,20170327,280.65,280.8,281.55,283.25,281.55,283.25,282.85,2.45,2.05,10,282.86,62
,20170328,283.25,282.85,,,,282.85,282.85,0,0,0,0.00,62
,20170329,282.85,282.85,283.55,283.55,283.55,283.55,283.55,.7,.7,2,56.71,60
,20170330,283.55,283.55,,,,283.55,283.55,0,0,0,0.00,60
,20170331,283.55,283.55,281,281,281,281,281,-2.55,-2.55,2,56.20,58
,20170405,281,281,282.9,282.9,282.4,282.4,282.65,1.4,1.65,4,113.06,58
,20170406,282.4,282.65,,,,282.65,282.65,0,0,0,0.00,58
,20170407,282.65,282.65,282.25,286.35,282.25,286.35,283.7,3.7,1.05,6,170.22,60
,20170410,286.35,283.7,285,285,283.6,283.6,284.2,-.1,.5,6,170.52,62
,20170411,283.6,284.2,,,,284.2,284.2,0,0,0,0.00,62
,20170412,284.2,284.2,287.25,288.35,286.85,287.3,287.6,3.1,3.4,24,690.27,60
,20170413,287.3,287.6,287.15,289.3,287.15,288.35,288.6,.75,1,14,404.10,64
,20170414,288.35,288.6,289.45,289.45,288.95,288.95,289.2,.35,.6,4,115.68,60
,20170417,288.95,289.2,289.45,289.75,289,289,289.45,-.2,.25,18,521.02,64
,20170418,289,289.45,288,288,287,287.9,287.65,-1.55,-1.8,8,230.13,66
,20170419,287.9,287.65,287.65,288.6,287.4,287.7,287.8,.05,.15,26,748.33,66
,20170420,287.7,287.8,287.75,287.75,286.7,287.35,287.2,-.45,-.6,52,"1,493.50",70
,20170421,287.35,287.2,287,287.85,287,287.2,287.35,0,.15,34,977.00,62
,20170424,287.2,287.35,288.7,288.7,286.25,286.25,286.75,-1.1,-.6,10,286.77,62
,20170425,286.25,286.75,284.15,286,284.15,286,285.2,-.75,-1.55,8,228.16,62
,20170426,286,285.2,284.65,284.65,284.1,284.1,284.4,-1.1,-.8,8,227.55,56
,20170427,284.1,284.4,284,284.25,284,284.25,284.1,-.15,-.3,4,113.65,56
,20170428,284.25,284.1,284.9,284.9,283.75,284.8,284.35,.7,.25,8,227.51,56
,20170502,284.8,284.35,283,283,282.1,282.1,282.75,-2.25,-1.6,32,904.82,74
,20170503,282.1,282.75,281.9,281.9,281.9,281.9,281.9,-.85,-.85,16,451.04,74
,20170504,281.9,281.9,280.7,280.7,277.2,277.2,278.8,-4.7,-3.1,18,501.85,78
,20170505,277.2,278.8,276.05,277.8,276.05,277.8,276.9,-1,-1.9,42,"1,162.99",82
,20170508,277.8,276.9,277.4,277.4,277.4,277.4,277.4,.5,.5,2,55.48,80
,20170509,277.4,277.4,,,,277.4,277.4,0,0,0,0.00,80
,20170510,277.4,277.4,275.2,275.2,275.2,275.2,275.2,-2.2,-2.2,60,"1,651.20",128
,20170511,275.2,275.2,275.45,275.85,275.45,275.45,275.6,.25,.4,14,385.84,116
,20170512,275.45,275.6,275.6,277.05,275.6,277.05,276.3,1.45,.7,4,110.53,112
,20170515,277.05,276.3,276.75,276.75,276.75,276.75,276.75,.45,.45,6,166.05,118
,20170516,276.75,276.75,277.85,278.7,277.85,278.7,278.25,1.95,1.5,4,111.31,116
,20170517,278.7,278.25,280,280,279.15,279.3,279.45,1.05,1.2,6,167.69,114
,20170518,279.3,279.45,281.2,281.5,280.9,281.5,281.2,2.05,1.75,6,168.72,114
,20170519,281.5,281.2,281.3,281.3,281.3,281.3,281.3,.1,.1,2,56.26,114
,20170522,281.3,281.3,281.5,281.55,281.35,281.45,281.45,.15,.15,60,"1,688.81",86
,20170523,281.45,281.45,283.05,284.3,283.05,284.3,283.55,2.85,2.1,6,170.13,82
,20170524,284.3,283.55,284.35,284.35,281.3,281.3,283.1,-2.25,-.45,22,622.83,88
,20170525,281.3,283.1,,,,283.1,283.1,0,0,0,0.00,88
,20170526,283.1,283.1,281.7,282.5,281.7,282.5,282.1,-.6,-1,4,112.84,86
,20170531,282.5,282.1,,,,282.1,282.1,0,0,0,0.00,86
,20170601,282.1,282.1,,,,282.1,282.1,0,0,0,0.00,86
,20170602,282.1,282.1,,,,282.1,282.1,0,0,0,0.00,86
,20170605,282.1,282.1,,,,282.1,282.1,0,0,0,0.00,86
,20170606,282.1,282.1,283.55,285.55,283.55,285.55,284.35,3.45,2.25,14,398.14,84
,20170607,285.55,284.35,286.45,286.65,286,286,286.3,1.65,1.95,38,"1,088.09",86
,20170608,286,286.3,285.4,285.4,284.8,284.8,284.9,-1.5,-1.4,10,284.92,78
,20170609,284.8,284.9,284.3,284.3,282.25,282.25,283.1,-2.65,-1.8,14,396.37,78
,20170612,282.25,283.1,280.45,280.8,280.45,280.7,280.65,-2.4,-2.45,12,336.81,82
,20170613,280.7,280.65,281.6,281.6,280.05,280.05,280.9,-.6,.25,10,280.91,82
,20170614,280.05,280.9,279.7,281.45,279.7,281.45,280,.55,-.9,14,392.00,78
,20170615,281.45,280,282.35,283.7,280,280,281.55,0,1.55,8,225.25,80
,20170616,280,281.55,290,290,277.55,278.25,280.8,-3.3,-.75,46,"1,291.69",92
,20170619,278.25,280.8,279,279,278.4,278.4,278.7,-2.4,-2.1,8,222.97,90
,20170620,278.4,278.7,278.4,279.8,277.6,277.65,278.2,-1.05,-.5,42,"1,168.52",104
,20170621,277.65,278.2,278,278,278,278,278,-.2,-.2,2,55.60,104
,20170622,278,278,279.7,280.3,279.5,280,279.9,2,1.9,16,447.89,106
,20170623,280,279.9,,,,279.9,279.9,0,0,0,0.00,106
,20170626,279.9,279.9,280.05,280.05,279.75,279.85,279.85,-.05,-.05,36,"1,007.60",106
,20170627,279.85,279.85,277.6,279.85,277.4,278.65,278.5,-1.2,-1.35,54,"1,503.94",118
,20170628,278.65,278.5,278.15,278.15,277.3,277.7,277.85,-.8,-.65,12,333.46,118
,20170629,277.7,277.85,,,,277.85,277.85,0,0,0,0.00,118
,20170630,277.85,277.85,275.85,275.85,272.7,275.1,274.55,-2.75,-3.3,14,384.40,122
,20170703,275.1,274.55,273.8,273.8,273.8,273.8,273.8,-.75,-.75,2,54.76,122
,20170704,273.8,273.8,272.05,272.05,270.15,271.35,270.8,-2.45,-3,42,"1,137.42",116
,20170705,271.35,270.8,270.65,270.65,270.65,270.65,270.65,-.15,-.15,4,108.26,112
,20170706,270.65,270.65,,,,270.65,270.65,0,0,0,0.00,112
,20170707,270.65,270.65,271.8,271.8,271.8,271.8,271.8,1.15,1.15,6,163.08,112
,20170710,271.8,271.8,,,,271.8,271.8,0,0,0,0.00,112
,20170711,271.8,271.8,268.3,268.3,268,268,268.15,-3.8,-3.65,8,214.52,120
,20170712,268,268.15,,,,268.15,268.15,0,0,0,0.00,120
,20170713,268.15,268.15,269.9,270.55,269.9,270.55,270.3,2.4,2.15,12,324.40,120
,20170714,270.55,270.3,269.8,269.8,269.4,269.4,269.6,-.9,-.7,4,107.84,122
,20170717,269.4,269.6,271.25,271.45,271.25,271.45,271.35,1.85,1.75,14,379.93,108
,20170718,271.45,271.35,272.8,273.95,272.8,273.95,273.35,2.6,2,4,109.35,110
,20170719,273.95,273.35,272.15,272.85,272.1,272.85,272.45,-.5,-.9,24,653.92,118
,20170720,272.85,272.45,,,,272.45,272.45,0,0,0,0.00,118
,20170721,272.45,272.45,272.2,272.2,271.05,271.05,271.3,-1.4,-1.15,10,271.31,118
,20170724,271.05,271.3,273.85,274.5,271.05,272.6,273.35,1.3,2.05,20,546.79,110
,20170725,272.6,273.35,273.9,273.9,272.45,273.8,273.4,.45,.05,14,382.80,104
,20170726,273.8,273.4,273.2,273.2,268,271.05,270.95,-2.35,-2.45,62,"1,680.04",58
,20170727,271.05,270.95,274.1,275.3,274.1,275.3,274.2,4.35,3.25,24,658.09,34
,20170728,275.3,274.2,273.3,273.3,272.45,272.45,272.75,-1.75,-1.45,10,272.79,28
,20170731,272.45,272.75,277.85,278.4,271.5,275.5,274.95,2.75,2.2,80,"2,199.95",12
,20170801,275.5,274.95,271.1,271.1,271.1,271.1,271.1,-3.85,-3.85,6,162.66,12
,20170802,271.1,271.1,,,,271.1,271.1,0,0,0,0.00,12
,20170803,271.1,271.1,,,,271.6,271.6,.5,.5,0,0.00,12
,20170804,271.6,271.6,,,,271.6,271.6,0,0,0,0.00,12
,20170807,271.6,271.6,,,,271.6,271.6,0,0,0,0.00,12
,20170808,271.6,271.6,,,,271.6,271.6,0,0,0,0.00,12
,20170809,271.6,271.6,,,,271.6,271.6,0,0,0,0.00,12
,20170810,271.6,271.6,276,284.35,270,278,275.65,6.4,4.05,30,827.01,6
,20170811,278,275.65,,,,275.65,275.65,0,0,0,0.00,6
,20170814,275.65,275.65,,,,275.65,275.65,0,0,0,0.00,6
,20170815,275.65,275.65,,,,275.65,275.65,0,0,0,0.00,6
au1709,20170616,281.55,281.55,,,,281.55,281.55,0,0,0,0.00,0
,20170619,281.55,281.55,279.3,279.85,277.75,277.75,278.7,-3.8,-2.85,12,334.46,4
,20170620,277.75,278.7,,,,278.7,278.7,0,0,0,0.00,4
,20170621,278.7,278.7,,,,278.7,278.7,0,0,0,0.00,4
,20170622,278.7,278.7,280.3,280.3,279.35,279.35,279.8,.65,1.1,4,111.93,4
,20170623,279.35,279.8,,,,279.8,279.8,0,0,0,0.00,4
,20170626,279.8,279.8,,,,279.8,279.8,0,0,0,0.00,4
,20170627,279.8,279.8,,,,279.8,279.8,0,0,0,0.00,4
,20170628,279.8,279.8,278,279.15,277.55,279.05,278.4,-.75,-1.4,8,222.75,6
,20170629,279.05,278.4,,,,278.4,278.4,0,0,0,0.00,6
,20170630,278.4,278.4,275,275,275,275,275,-3.4,-3.4,2,55.00,8
,20170703,275,275,275.05,275.05,272.7,272.7,273.85,-2.3,-1.15,20,547.75,14
,20170704,272.7,273.85,272.3,272.3,272.3,272.3,272.3,-1.55,-1.55,2,54.46,12
,20170705,272.3,272.3,272.75,272.75,272.75,272.75,272.75,.45,.45,2,54.55,12
,20170706,272.75,272.75,,,,272.75,272.75,0,0,0,0.00,12
,20170707,272.75,272.75,272.15,272.15,272.15,272.15,272.15,-.6,-.6,2,54.43,12
,20170710,272.15,272.15,268.45,268.45,268.45,268.45,268.45,-3.7,-3.7,2,53.69,12
,20170711,268.45,268.45,,,,264.8,264.8,-3.65,-3.65,0,0.00,12
,20170712,264.8,264.8,271.2,271.2,269.6,269.6,270.7,4.8,5.9,14,379.04,22
,20170713,269.6,270.7,270.75,271.65,270.15,271.15,270.9,.45,.2,20,541.80,10
,20170714,271.15,270.9,270.7,270.7,268.5,270.35,269.65,-.55,-1.25,54,"1,456.29",16
,20170717,270.35,269.65,270.55,272.95,270.55,272.95,271.95,3.3,2.3,10,271.95,16
,20170718,272.95,271.95,,,,272.1,272.1,.15,.15,0,0.00,16
,20170719,272.1,272.1,,,,272.45,272.45,.35,.35,0,0.00,16
,20170720,272.45,272.45,272.45,272.45,272.45,272.45,272.45,0,0,2,54.49,14
,20170721,272.45,272.45,,,,271.3,271.3,-1.15,-1.15,0,0.00,14
,20170724,271.3,271.3,274.5,277.85,274.5,277.85,275.75,6.55,4.45,20,551.54,16
,20170725,277.85,275.75,,,,275.75,275.75,0,0,0,0.00,16
,20170726,275.75,275.75,276.25,276.25,274.35,274.35,275.2,-1.4,-.55,8,220.18,18
,20170727,274.35,275.2,274.3,274.3,274.3,274.3,274.3,-.9,-.9,12,329.16,6
,20170728,274.3,274.3,,,,274.3,274.3,0,0,0,0.00,6
,20170731,274.3,274.3,,,,274.3,274.3,0,0,0,0.00,6
,20170801,274.3,274.3,,,,270.45,270.45,-3.85,-3.85,0,0.00,6
,20170802,270.45,270.45,,,,270.45,270.45,0,0,0,0.00,6
,20170803,270.45,270.45,,,,270.45,270.45,0,0,0,0.00,6
,20170804,270.45,270.45,,,,270.45,270.45,0,0,0,0.00,6
,20170807,270.45,270.45,,,,271,271,.55,.55,0,0.00,6
,20170808,271,271,,,,271,271,0,0,0,0.00,6
,20170809,271,271,,,,271,271,0,0,0,0.00,6
,20170810,271,271,,,,271,271,0,0,0,0.00,6
,20170811,271,271,,,,271,271,0,0,0,0.00,6
,20170814,271,271,,,,271,271,0,0,0,0.00,6
,20170815,271,271,,,,271,271,0,0,0,0.00,6
,20170816,271,271,,,,271,271,0,0,0,0.00,6
,20170817,271,271,277.9,277.9,277.9,277.9,277.9,6.9,6.9,4,111.16,6
,20170818,277.9,277.9,,,,277.9,277.9,0,0,0,0.00,6
,20170821,277.9,277.9,,,,277.9,277.9,0,0,0,0.00,6
,20170822,277.9,277.9,,,,277.9,277.9,0,0,0,0.00,6
,20170823,277.9,277.9,,,,277.9,277.9,0,0,0,0.00,6
,20170824,277.9,277.9,,,,277.9,277.9,0,0,0,0.00,6
,20170825,277.9,277.9,,,,277.9,277.9,0,0,0,0.00,6
,20170828,277.9,277.9,,,,277.9,277.9,0,0,0,0.00,6
,20170829,277.9,277.9,,,,277.9,277.9,0,0,0,0.00,6
,20170830,277.9,277.9,277.9,277.9,277.9,277.9,277.9,0,0,4,111.16,2
,20170831,277.9,277.9,277.9,277.9,277.9,277.9,277.9,0,0,2,55.58,0
,20170901,277.9,277.9,,,,277.9,277.9,0,0,0,0.00,0
,20170904,277.9,277.9,,,,277.9,277.9,0,0,0,0.00,0
,20170905,277.9,277.9,,,,277.9,277.9,0,0,0,0.00,0
,20170906,277.9,277.9,,,,277.9,277.9,0,0,0,0.00,0
,20170907,277.9,277.9,,,,277.9,277.9,0,0,0,0.00,0
,20170908,277.9,277.9,,,,277.9,277.9,0,0,0,0.00,0
,20170911,277.9,277.9,,,,277.9,277.9,0,0,0,0.00,0
,20170912,277.9,277.9,,,,277.9,277.9,0,0,0,0.00,0
,20170913,277.9,277.9,,,,277.9,277.9,0,0,0,0.00,0
,20170914,277.9,277.9,,,,277.9,277.9,0,0,0,0.00,0
,20170915,277.9,277.9,,,,277.9,277.9,0,0,0,0.00,0
au1710,20170103,274,273.95,273.9,273.9,272.6,272.6,272.85,-1.35,-1.1,12,327.44,108
,20170104,272.6,272.85,272.15,273.4,272.15,272.8,272.9,-.05,.05,36,982.53,136
,20170105,272.8,272.9,271,271,271,271,271,-1.9,-1.9,2,54.20,136
,20170106,271,271,270.9,271.75,270.9,271.6,271.25,.6,.25,12,325.55,138
,20170109,271.6,271.25,271.7,271.85,271.7,271.85,271.8,.6,.55,6,163.08,134
,20170110,271.85,271.8,273.75,273.75,273.65,273.65,273.65,1.85,1.85,10,273.69,136
,20170111,273.65,273.65,273.25,273.95,273.15,273.95,273.6,.3,-.05,10,273.60,138
,20170112,273.95,273.6,273.85,273.85,273.85,273.85,273.85,.25,.25,4,109.54,134
,20170113,273.85,273.85,274.2,274.2,274.2,274.2,274.2,.35,.35,2,54.84,136
,20170116,274.2,274.2,273.65,275.1,273.65,275.1,274.15,.9,-.05,10,274.17,136
,20170117,275.1,274.15,274.4,274.95,274.4,274.95,274.7,.8,.55,12,329.68,134
,20170118,274.95,274.7,,,,274.7,274.7,0,0,0,0.00,134
,20170119,274.7,274.7,275.3,275.3,272.65,272.65,272.85,-2.05,-1.85,52,"1,418.83",134
,20170120,272.65,272.85,273.75,273.9,273.75,273.85,273.8,1,.95,16,438.11,128
,20170123,273.85,273.8,273.6,275.5,273.6,275.5,274.2,1.7,.4,6,164.54,124
,20170124,275.5,274.2,275.6,275.6,274.55,274.55,275.05,.35,.85,4,110.03,124
,20170125,274.55,275.05,274.55,274.65,272.1,272.1,274.1,-2.95,-.95,20,548.25,108
,20170126,272.1,274.1,270.05,270.7,269.7,270.7,270.1,-3.4,-4,24,648.28,98
,20170203,270.7,270.1,,,,270.1,270.1,0,0,0,0.00,98
,20170206,270.1,270.1,274.25,277.05,274.25,276.5,276.15,6.4,6.05,32,883.69,100
,20170207,276.5,276.15,277.5,278.25,277.35,278.25,277.55,2.1,1.4,24,666.22,90
,20170208,278.25,277.55,,,,277.55,277.55,0,0,0,0.00,90
,20170209,277.55,277.55,281.05,281.05,280.85,280.85,280.9,3.3,3.35,6,168.56,86
,20170210,280.85,280.9,277.35,277.8,277.35,277.8,277.55,-3.1,-3.35,4,111.03,86
,20170213,277.8,277.55,279,279,279,279,279,1.45,1.45,4,111.60,86
,20170214,279,279,278.65,278.65,277.3,277.3,277.7,-1.7,-1.3,16,444.33,86
,20170215,277.3,277.7,278.4,278.4,277.6,277.6,277.95,-.1,.25,6,166.77,84
,20170216,277.6,277.95,276.25,279.4,276.25,278.35,277.7,.4,-.25,10,277.73,84
,20170217,278.35,277.7,279.85,280,279.35,280,279.65,2.3,1.95,8,223.74,84
,20170220,280,279.65,280.8,280.8,280.25,280.25,280.4,.6,.75,6,168.26,84
,20170221,280.25,280.4,279.6,279.6,279.6,279.6,279.6,-.8,-.8,2,55.92,84
,20170222,279.6,279.6,278.75,279.65,278.6,279.65,279.1,.05,-.5,12,334.97,80
,20170223,279.65,279.1,279.75,280.1,279.75,280.1,279.8,1,.7,8,223.87,86
,20170224,280.1,279.8,282.35,283.35,282.35,282.75,282.8,2.95,3,8,226.24,88
,20170227,282.75,282.8,284.35,284.35,284.35,284.35,284.35,1.55,1.55,4,113.74,84
,20170228,284.35,284.35,283.95,284.85,283.95,284.85,284.6,.5,.25,8,227.70,84
,20170301,284.85,284.6,284.45,284.45,281.75,281.75,282.55,-2.85,-2.05,18,508.59,84
,20170302,281.75,282.55,,,,282.55,282.55,0,0,0,0.00,84
,20170303,282.55,282.55,280.8,280.8,280.2,280.2,280.5,-2.35,-2.05,4,112.20,82
,20170306,280.2,280.5,280.15,280.15,279.6,279.6,279.85,-.9,-.65,8,223.91,86
,20170307,279.6,279.85,280.2,280.2,280.2,280.2,280.2,.35,.35,2,56.04,84
,20170308,280.2,280.2,278,278,277.55,277.55,277.9,-2.65,-2.3,24,667.00,86
,20170309,277.55,277.9,276.9,276.9,275.2,275.2,276.45,-2.7,-1.45,14,387.03,80
,20170310,275.2,276.45,275.1,275.1,274.2,274.2,274.6,-2.25,-1.85,6,164.76,82
,20170313,274.2,274.6,274.8,276.3,274.8,276.3,275.95,1.7,1.35,14,386.37,78
,20170314,276.3,275.95,,,,275.95,275.95,0,0,0,0.00,78
,20170315,275.95,275.95,275.1,275.1,275.1,275.1,275.1,-.85,-.85,2,55.02,76
,20170316,275.1,275.1,279.15,279.15,279.05,279.05,279.1,3.95,4,4,111.64,78
,20170317,279.05,279.1,279.25,279.25,279.25,279.25,279.25,.15,.15,2,55.85,78
,20170320,279.25,279.25,280.15,280.3,280.15,280.3,280.25,1.05,1,22,616.60,92
,20170321,280.3,280.25,,,,280.25,280.25,0,0,0,0.00,92
,20170322,280.25,280.25,281.7,282.6,281.7,282.6,282.1,2.35,1.85,6,169.28,94
,20170323,282.6,282.1,282,282.55,281.2,281.2,281.5,-.9,-.6,44,"1,238.66",90
,20170324,281.2,281.5,281.3,281.3,281.3,281.3,281.3,-.2,-.2,2,56.26,88
,20170327,281.3,281.3,,,,281.3,281.3,0,0,0,0.00,88
,20170328,281.3,281.3,,,,281.3,281.3,0,0,0,0.00,88
,20170329,281.3,281.3,,,,281.3,281.3,0,0,0,0.00,88
,20170330,281.3,281.3,,,,281.3,281.3,0,0,0,0.00,88
,20170331,281.3,281.3,281,281,281,281,281,-.3,-.3,8,224.80,88
,20170405,281,281,,,,281,281,0,0,0,0.00,88
,20170406,281,281,282.4,282.4,282.4,282.4,282.4,1.4,1.4,2,56.48,86
,20170407,282.4,282.4,286.55,287.8,285.25,287.8,286.1,5.4,3.7,16,457.77,88
,20170410,287.8,286.1,286.8,286.85,283.65,284.2,284.95,-1.9,-1.15,36,"1,025.89",94
,20170411,284.2,284.95,283.95,285,283.75,285,284.45,.05,-.5,18,512.04,96
,20170412,285,284.45,286.75,287.85,286.6,287.85,287.05,3.4,2.6,16,459.32,90
,20170413,287.85,287.05,288.2,289.8,288.2,289.55,289.15,2.5,2.1,6,173.51,90
,20170414,289.55,289.15,289.95,289.95,289.95,289.95,289.95,.8,.8,2,57.99,90
,20170417,289.95,289.95,290.6,290.6,290.6,290.6,290.6,.65,.65,2,58.12,88
,20170418,290.6,290.6,289.1,289.3,288.35,288.8,288.8,-1.8,-1.8,28,808.77,102
,20170419,288.8,288.8,288.3,289.8,288.3,289.05,288.8,.25,0,16,462.08,96
,20170420,289.05,288.8,287.2,288.05,287.2,288.05,287.9,-.75,-.9,18,518.25,102
,20170421,288.05,287.9,287.7,287.7,287.7,287.7,287.7,-.2,-.2,2,57.54,100
,20170424,287.7,287.7,288.85,288.85,286,286,286.85,-1.7,-.85,14,401.61,92
,20170425,286,286.85,285.5,286.35,285.5,286.35,286,-.5,-.85,138,"3,947.35",128
,20170426,286.35,286,284.5,284.5,284.4,284.4,284.45,-1.6,-1.55,6,170.68,124
,20170427,284.4,284.45,284.4,285.1,284.4,285.1,284.65,.65,.2,24,683.22,100
,20170428,285.1,284.65,285.1,285.45,284.7,285.35,285.1,.7,.45,30,855.31,94
,20170502,285.35,285.1,283.4,283.45,283.15,283.15,283.3,-1.95,-1.8,14,396.68,82
,20170503,283.15,283.3,282.65,282.85,282.65,282.7,282.7,-.6,-.6,14,395.78,82
,20170504,282.7,282.7,282,282,278.8,278.8,281,-3.9,-1.7,10,281.00,78
,20170505,278.8,281,277.7,278.75,277.05,278.75,277.65,-2.25,-3.35,10,277.69,76
,20170508,278.75,277.65,278.1,278.2,277.75,277.75,278,.1,.35,6,166.81,76
,20170509,277.75,278,,,,278,278,0,0,0,0.00,76
,20170510,278,278,276.65,276.65,276.6,276.6,276.6,-1.4,-1.4,8,221.29,78
,20170511,276.6,276.6,,,,276.6,276.6,0,0,0,0.00,78
,20170512,276.6,276.6,,,,276.6,276.6,0,0,0,0.00,78
,20170515,276.6,276.6,277.85,278.3,277.75,277.75,277.95,1.15,1.35,6,166.78,76
,20170516,277.75,277.95,,,,277.95,277.95,0,0,0,0.00,76
,20170517,277.95,277.95,279.45,280.25,279.05,280.25,279.65,2.3,1.7,10,279.69,78
,20170518,280.25,279.65,282.7,283.85,282.4,282.4,283.25,2.75,3.6,24,679.81,76
,20170519,282.4,283.25,281.2,281.6,281.2,281.6,281.4,-1.65,-1.85,4,112.56,78
,20170522,281.6,281.4,282.6,282.6,281.85,282.05,282.25,.65,.85,24,677.50,78
,20170523,282.05,282.25,283.6,284.65,283.6,283.9,283.9,1.65,1.65,22,624.59,80
,20170524,283.9,283.9,283.9,283.9,281.55,281.65,282.2,-2.25,-1.7,12,338.68,78
,20170525,281.65,282.2,282.35,282.35,282.35,282.35,282.35,.15,.15,2,56.47,78
,20170526,282.35,282.35,,,,282.35,282.35,0,0,0,0.00,78
,20170531,282.35,282.35,,,,282,282,-.35,-.35,0,0.00,78
,20170601,282,282,,,,280.85,280.85,-1.15,-1.15,0,0.00,78
,20170602,280.85,280.85,279.7,280.2,279,279.5,279.65,-1.35,-1.2,28,783.08,76
,20170605,279.5,279.65,283.05,283.1,282.8,283.1,283,3.45,3.35,10,283.01,74
,20170606,283.1,283,,,,285.25,285.25,2.25,2.25,0,0.00,74
,20170607,285.25,285.25,285.3,285.3,285.3,285.3,285.3,.05,.05,2,57.06,74
,20170608,285.3,285.3,284,284,284,284,284,-1.3,-1.3,2,56.80,76
,20170609,284,284,283.2,283.2,283.2,283.2,283.2,-.8,-.8,2,56.64,74
,20170612,283.2,283.2,280.2,280.6,280.2,280.3,280.4,-2.9,-2.8,10,280.41,76
,20170613,280.3,280.4,,,,280.4,280.4,0,0,0,0.00,76
,20170614,280.4,280.4,,,,280.4,280.4,0,0,0,0.00,76
,20170615,280.4,280.4,282.35,282.35,278.2,278.2,280.5,-2.2,.1,14,392.76,82
,20170616,278.2,280.5,,,,280.5,280.5,0,0,0,0.00,82
,20170619,280.5,280.5,278.2,278.3,278.2,278.3,278.25,-2.2,-2.25,4,111.30,80
,20170620,278.3,278.25,277.5,277.5,277.5,277.5,277.5,-.75,-.75,2,55.50,80
,20170621,277.5,277.5,277.3,277.6,277.3,277.6,277.45,.1,-.05,4,110.98,80
,20170622,277.6,277.45,,,,277.45,277.45,0,0,0,0.00,80
,20170623,277.45,277.45,,,,277.45,277.45,0,0,0,0.00,80
,20170626,277.45,277.45,279.6,279.65,279.35,279.65,279.5,2.2,2.05,8,223.60,80
,20170627,279.65,279.5,277.55,277.8,277.25,277.8,277.55,-1.7,-1.95,18,499.62,86
,20170628,277.8,277.55,278.15,278.15,277.8,278,278,.45,.45,10,278.02,92
,20170629,278,278,277.7,278.2,277.7,277.75,277.85,-.25,-.15,10,277.85,88
,20170630,277.75,277.85,276,276.5,275,275,275.55,-2.85,-2.3,18,496.00,84
,20170703,275,275.55,275.1,275.1,273.8,273.8,274.1,-1.75,-1.45,8,219.30,82
,20170704,273.8,274.1,273.6,273.6,271.2,272,271.85,-2.1,-2.25,182,"4,947.78",126
,20170705,272,271.85,272.35,272.8,271.9,272.1,272.25,.25,.4,38,"1,034.60",126
,20170706,272.1,272.25,270.95,271.5,270.9,271.5,271.1,-.75,-1.15,6,162.67,122
,20170707,271.5,271.1,271.7,271.8,271.55,271.55,271.65,.45,.55,8,217.35,118
,20170710,271.55,271.65,270.95,270.95,268.05,268.1,269.05,-3.55,-2.6,64,"1,722.02",106
,20170711,268.1,269.05,268.95,270.45,268.95,269.5,269.25,.45,.2,32,861.66,98
,20170712,269.5,269.25,270.25,270.4,270.25,270.4,270.3,1.15,1.05,102,"2,757.33",112
,20170713,270.4,270.3,271.7,271.7,270.75,270.85,271.25,.55,.95,40,"1,085.19",94
,20170714,270.85,271.25,,,,271.25,271.25,0,0,0,0.00,94
,20170717,271.25,271.25,272.55,272.55,272.45,272.45,272.5,1.2,1.25,10,272.53,84
,20170718,272.45,272.5,272.8,273.8,272.8,273.4,273.45,.9,.95,106,"2,898.77",110
,20170719,273.4,273.45,,,,273.45,273.45,0,0,0,0.00,110
,20170720,273.45,273.45,273.7,273.95,273.4,273.4,273.65,-.05,.2,6,164.21,108
,20170721,273.4,273.65,273.6,275.1,273.6,275.1,274.5,1.45,.85,18,494.10,94
,20170724,275.1,274.5,275.9,276.4,275.65,276.3,275.9,1.8,1.4,20,551.85,76
,20170725,276.3,275.9,276.3,276.35,276,276,276.2,.1,.3,14,386.69,66
,20170726,276,276.2,275.6,275.6,273.55,273.55,274.95,-2.65,-1.25,12,329.95,64
,20170727,273.55,274.95,274.45,277.55,274.45,277.55,275.9,2.6,.95,16,441.51,56
,20170728,277.55,275.9,,,,275.9,275.9,0,0,0,0.00,56
,20170731,275.9,275.9,277.25,277.25,277.25,277.25,277.25,1.35,1.35,2,55.45,56
,20170801,277.25,277.25,,,,277.25,277.25,0,0,0,0.00,56
,20170802,277.25,277.25,277.9,278.35,277.9,278.35,278.1,1.1,.85,4,111.25,54
,20170803,278.35,278.1,,,,278.1,278.1,0,0,0,0.00,54
,20170804,278.1,278.1,,,,278.1,278.1,0,0,0,0.00,54
,20170807,278.1,278.1,276.65,276.65,275.15,275.15,275.75,-2.95,-2.35,22,606.72,58
,20170808,275.15,275.75,275.45,275.9,274.8,274.8,275.2,-.95,-.55,8,220.19,60
,20170809,274.8,275.2,275.15,275.85,274.1,275.85,274.75,.65,-.45,18,494.63,68
,20170810,275.85,274.75,276.85,277.45,276.6,277,277.05,2.25,2.3,24,664.98,70
,20170811,277,277.05,278.65,279.4,278.45,278.55,278.85,1.5,1.8,36,"1,003.91",66
,20170814,278.55,278.85,278.6,279.3,278.6,278.75,278.95,-.1,.1,14,390.55,68
,20170815,278.75,278.95,278.55,278.85,275.4,276.7,276.65,-2.25,-2.3,20,553.35,60
,20170816,276.7,276.65,275.85,277.25,275.85,277.25,276.7,.6,.05,22,608.81,70
,20170817,277.25,276.7,276.6,279.85,276.6,279.85,278.15,3.15,1.45,24,667.62,66
,20170818,279.85,278.15,279.2,279.55,278.65,279.45,279.25,1.3,1.1,124,"3,462.76",74
,20170821,279.45,279.25,279.15,279.15,278.9,278.95,279,-.3,-.25,6,167.40,76
,20170822,278.95,279,280.2,280.2,279.1,279.45,279.8,.45,.8,34,951.45,78
,20170823,279.45,279.8,278.55,278.55,278.4,278.4,278.45,-1.4,-1.35,4,111.39,74
,20170824,278.4,278.45,278.65,279.1,278.3,279.1,278.8,.65,.35,56,"1,561.28",78
,20170825,279.1,278.8,279.1,279.1,278.2,278.3,278.25,-.5,-.55,72,"2,003.46",104
,20170828,278.3,278.25,278.4,279.1,277.15,278.7,278.35,.45,.1,48,"1,336.18",114
,20170829,278.7,278.35,278.55,282.35,278.55,282.35,280.8,4,2.45,10,280.83,110
,20170830,282.35,280.8,282.85,282.85,279.8,279.8,280.5,-1,-.3,42,"1,178.10",136
,20170831,279.8,280.5,278.95,278.95,278.55,278.55,278.85,-1.95,-1.65,8,223.08,130
,20170901,278.55,278.85,278.55,278.55,278.55,278.55,278.55,-.3,-.3,2,55.71,128
,20170904,278.55,278.55,282.35,282.85,281.85,282.2,282.3,3.65,3.75,8,225.85,126
,20170905,282.2,282.3,281.6,281.6,281.45,281.45,281.55,-.85,-.75,8,225.25,124
,20170906,281.45,281.55,,,,281.55,281.55,0,0,0,0.00,124
,20170907,281.55,281.55,281.2,281.2,281.2,281.2,281.2,-.35,-.35,2,56.24,122
,20170908,281.2,281.2,,,,281.2,281.2,0,0,0,0.00,122
,20170911,281.2,281.2,281.05,281.15,280.6,281.15,281.1,-.05,-.1,44,"1,236.87",98
,20170912,281.15,281.1,,,,281.1,281.1,0,0,0,0.00,98
,20170913,281.1,281.1,280.5,280.5,280.5,280.5,280.5,-.6,-.6,12,336.60,102
,20170914,280.5,280.5,280.25,280.25,279.4,279.4,279.85,-1.1,-.65,22,615.74,90
,20170915,279.4,279.85,279.5,281.05,279.5,280.8,280.45,.95,.6,34,953.61,70
,20170918,280.8,280.45,294.35,294.35,266.6,279.5,279.95,-.95,-.5,28,783.86,62
,20170919,279.5,279.95,278.6,278.6,278.6,278.6,278.6,-1.35,-1.35,4,111.44,58
,20170920,278.6,278.6,280.4,280.4,279.6,279.6,279.8,1,1.2,8,223.84,58
,20170921,279.6,279.8,276.3,276.3,276.3,276.3,276.3,-3.5,-3.5,4,110.52,56
,20170922,276.3,276.3,277.1,277.1,274.45,275.9,276.05,-.4,-.25,50,"1,380.27",32
,20170925,275.9,276.05,275.4,275.95,275.4,275.8,275.55,-.25,-.5,18,496.04,14
,20170926,275.8,275.55,276.25,281.3,276.25,281,278.8,5.45,3.25,128,"3,569.16",10
,20170927,281,278.8,278,279.85,278,279.85,279.35,1.05,.55,8,223.50,8
,20170928,279.85,279.35,278.7,279.9,275.9,279.9,278.35,.55,-1,8,222.71,6
,20170929,279.9,278.35,278.1,278.1,278.1,278.1,278.1,-.25,-.25,6,166.86,0
,20171009,278.1,278.1,,,,278.1,278.1,0,0,0,0.00,0
,20171010,278.1,278.1,,,,278.1,278.1,0,0,0,0.00,0
,20171011,278.1,278.1,,,,278.1,278.1,0,0,0,0.00,0
,20171012,278.1,278.1,,,,278.1,278.1,0,0,0,0.00,0
,20171013,278.1,278.1,,,,278.1,278.1,0,0,0,0.00,0
,20171016,278.1,278.1,,,,278.1,278.1,0,0,0,0.00,0
au1711,20170816,276.65,276.65,,,,276.65,276.65,0,0,0,0.00,0
,20170817,276.65,276.65,,,,276.65,276.65,0,0,0,0.00,0
,20170818,276.65,276.65,,,,276.65,276.65,0,0,0,0.00,0
,20170821,276.65,276.65,281.85,281.85,278.65,278.9,280,2.25,3.35,20,560.09,2
,20170822,278.9,280,279.85,279.85,278.8,279.3,279.3,-.7,-.7,6,167.59,4
,20170823,279.3,279.3,279.5,279.5,279.5,279.5,279.5,.2,.2,2,55.90,4
,20170824,279.5,279.5,,,,279.5,279.5,0,0,0,0.00,4
,20170825,279.5,279.5,,,,279.5,279.5,0,0,0,0.00,4
,20170828,279.5,279.5,278.85,278.85,277.2,277.2,278.4,-2.3,-1.1,8,222.75,8
,20170829,277.2,278.4,279.65,286.25,279.65,286.25,282.95,7.85,4.55,4,113.18,8
,20170830,286.25,282.95,277.7,277.7,277.7,277.7,277.7,-5.25,-5.25,2,55.54,6
,20170831,277.7,277.7,,,,276.05,276.05,-1.65,-1.65,0,0.00,6
,20170901,276.05,276.05,,,,275.75,275.75,-.3,-.3,0,0.00,6
,20170904,275.75,275.75,,,,275.75,275.75,0,0,0,0.00,6
,20170905,275.75,275.75,,,,275.75,275.75,0,0,0,0.00,6
,20170906,275.75,275.75,,,,275.75,275.75,0,0,0,0.00,6
,20170907,275.75,275.75,286.85,286.85,279.9,279.9,283.35,4.15,7.6,36,"1,020.15",6
,20170908,279.9,283.35,,,,283.35,283.35,0,0,0,0.00,6
,20170911,283.35,283.35,,,,283.35,283.35,0,0,0,0.00,6
,20170912,283.35,283.35,284.4,284.4,279.5,279.5,281.9,-3.85,-1.45,16,451.05,8
,20170913,279.5,281.9,,,,281.9,281.9,0,0,0,0.00,8
,20170914,281.9,281.9,281.45,281.45,280.6,280.6,280.7,-1.3,-1.2,16,449.13,20
,20170915,280.6,280.7,280.7,280.7,280.7,280.7,280.7,0,0,14,392.98,6
,20170918,280.7,280.7,279.9,279.9,279.9,279.9,279.9,-.8,-.8,2,55.98,6
,20170919,279.9,279.9,,,,279.9,279.9,0,0,0,0.00,6
,20170920,279.9,279.9,,,,279.9,279.9,0,0,0,0.00,6
,20170921,279.9,279.9,,,,279.9,279.9,0,0,0,0.00,6
,20170922,279.9,279.9,,,,279.9,279.9,0,0,0,0.00,6
,20170925,279.9,279.9,,,,279.9,279.9,0,0,0,0.00,6
,20170926,279.9,279.9,,,,279.9,279.9,0,0,0,0.00,6
,20170927,279.9,279.9,,,,279.9,279.9,0,0,0,0.00,6
,20170928,279.9,279.9,,,,279.9,279.9,0,0,0,0.00,6
,20170929,279.9,279.9,,,,279.9,279.9,0,0,0,0.00,6
,20171009,279.9,279.9,277.35,278.2,276.9,278.2,277.45,-1.7,-2.45,22,610.39,16
,20171010,278.2,277.45,276.9,276.9,276.9,276.9,276.9,-.55,-.55,8,221.52,22
,20171011,276.9,276.9,276.6,276.6,276.2,276.2,276.25,-.7,-.65,16,442.00,10
,20171012,276.2,276.25,,,,276.25,276.25,0,0,0,0.00,10
,20171013,276.25,276.25,,,,276.25,276.25,0,0,0,0.00,10
,20171016,276.25,276.25,,,,276.25,276.25,0,0,0,0.00,10
,20171017,276.25,276.25,,,,276.25,276.25,0,0,0,0.00,10
,20171018,276.25,276.25,,,,276.25,276.25,0,0,0,0.00,10
,20171019,276.25,276.25,,,,276.25,276.25,0,0,0,0.00,10
,20171020,276.25,276.25,,,,276.25,276.25,0,0,0,0.00,10
,20171023,276.25,276.25,,,,276.25,276.25,0,0,0,0.00,10
,20171024,276.25,276.25,281.05,281.05,273.8,274.6,277.6,-1.65,1.35,8,222.10,10
,20171025,274.6,277.6,,,,277.6,277.6,0,0,0,0.00,10
,20171026,277.6,277.6,,,,277.6,277.6,0,0,0,0.00,10
,20171027,277.6,277.6,,,,277.6,277.6,0,0,0,0.00,10
,20171030,277.6,277.6,273.05,273.05,273.05,273.05,273.05,-4.55,-4.55,10,273.05,0
,20171031,273.05,273.05,,,,273.05,273.05,0,0,0,0.00,0
,20171101,273.05,273.05,,,,273.05,273.05,0,0,0,0.00,0
,20171102,273.05,273.05,,,,273.05,273.05,0,0,0,0.00,0
,20171103,273.05,273.05,,,,273.05,273.05,0,0,0,0.00,0
,20171106,273.05,273.05,,,,273.05,273.05,0,0,0,0.00,0
,20171107,273.05,273.05,,,,273.05,273.05,0,0,0,0.00,0
,20171108,273.05,273.05,,,,273.05,273.05,0,0,0,0.00,0
,20171109,273.05,273.05,,,,273.05,273.05,0,0,0,0.00,0
,20171110,273.05,273.05,,,,273.05,273.05,0,0,0,0.00,0
,20171113,273.05,273.05,,,,273.05,273.05,0,0,0,0.00,0
,20171114,273.05,273.05,,,,273.05,273.05,0,0,0,0.00,0
,20171115,273.05,273.05,,,,273.05,273.05,0,0,0,0.00,0
au1712,20170103,275.4,274.65,273.45,274.95,270.15,272.65,273.45,-2,-1.2,1762,"48,190.43",8874
,20170104,272.65,273.45,272.2,274.7,271.8,272.9,273,-.55,-.45,2186,"59,679.85",9526
,20170105,272.9,273,272.9,273.15,271,272,272.15,-1,-.85,1420,"38,647.05",9466
,20170106,272,272.15,271.9,272.4,271,271.55,271.5,-.6,-.65,3846,"104,435.33",9070
,20170109,271.55,271.5,272.2,272.8,271.35,272.4,272.25,.9,.75,1040,"28,316.49",9192
,20170110,272.4,272.25,272.4,274.75,272.4,274.1,274.15,1.85,1.9,878,"24,072.38",9188
,20170111,274.1,274.15,274.45,275,273.65,274.55,274.45,.4,.3,1312,"36,013.90",8966
,20170112,274.55,274.45,274.45,275.3,271,275.15,272.7,.7,-1.75,7460,"203,442.67",8598
,20170113,275.15,272.7,275.15,275.15,273.4,274.05,273.9,1.35,1.2,1456,"39,884.45",8458
,20170116,274.05,273.9,274.4,276.6,273.4,276,275,2.1,1.1,3142,"86,410.25",9334
,20170117,276,275,275.8,277.8,275.5,277.55,276.8,2.55,1.8,1772,"49,057.43",9388
,20170118,277.55,276.8,277.55,277.9,275.65,276.55,276.75,-.25,-.05,2626,"72,683.94",9390
,20170119,276.55,276.75,275.7,276.2,273.5,273.95,274.3,-2.8,-2.45,6210,"170,352.75",12536
,20170120,273.95,274.3,274.2,275.15,273.45,275,274.7,.7,.4,2346,"64,454.91",13530
,20170123,275,274.7,274.5,278.05,274,276.15,276.35,1.45,1.65,1634,"45,156.73",13830
,20170124,276.15,276.35,275.8,276.3,275.5,275.5,275.85,-.85,-.5,1358,"37,466.11",14286
,20170125,275.5,275.85,275.35,275.85,272.3,272.8,274,-3.05,-1.85,2870,"78,651.28",14760
,20170126,272.8,274,273.5,273.5,270,271.15,271.55,-2.85,-2.45,3778,"102,601.83",16098
,20170203,271.15,271.55,271.5,275.15,271.5,274.6,274.55,3.05,3,2592,"71,176.13",16052
,20170206,274.6,274.55,274.6,277.5,273.55,277.4,276.4,2.85,1.85,1814,"50,147.98",16324
,20170207,277.4,276.4,278.4,279.8,277.8,279.75,278.8,3.35,2.4,1368,"38,142.32",16594
,20170208,279.75,278.8,279.65,280.4,279,279.9,279.95,1.1,1.15,2048,"57,336.17",16980
,20170209,279.9,279.95,282,282.3,281.3,281.5,281.6,1.55,1.65,1784,"50,238.98",17780
,20170210,281.5,281.6,281.25,282,278,278.5,279.2,-3.1,-2.4,2092,"58,414.05",17942
,20170213,278.5,279.2,279,280.45,278.65,279.8,279.85,.6,.65,5712,"159,854.27",20950
,20170214,279.8,279.85,279.65,279.65,277.5,279.5,279.1,-.35,-.75,4092,"114,214.47",22888
,20170215,279.5,279.1,280,280.25,277.95,278.35,278.95,-.75,-.15,3574,"99,702.24",23904
,20170216,278.35,278.95,278.35,280.7,277.05,280.1,279.7,1.15,.75,3196,"89,404.50",24342
,20170217,280.1,279.7,280.7,281.4,280.45,280.85,280.95,1.15,1.25,3476,"97,665.15",24880
,20170220,280.85,280.95,281.7,282,280,280.45,280.6,-.5,-.35,4258,"119,479.91",25970
,20170221,280.45,280.6,280.65,281.3,280.3,281,280.7,.4,.1,4330,"121,560.87",28068
,20170222,281,280.7,280.2,281.7,279.5,280.95,280.85,.25,.15,2720,"76,393.02",28546
,20170223,280.95,280.85,281.55,281.7,280.2,281.15,281.1,.3,.25,3100,"87,150.34",28710
,20170224,281.15,281.1,281.85,285.05,281.85,284.6,283.8,3.5,2.7,4010,"113,809.00",29232
,20170227,284.6,283.8,285.6,285.8,284,285.4,285.35,1.6,1.55,5642,"161,009.04",31214
,20170228,285.4,285.35,285.05,286.65,284.2,284.55,284.9,-.8,-.45,3576,"101,880.76",31800
,20170301,284.55,284.9,284.55,285.15,282,282.3,282.95,-2.6,-1.95,6762,"191,346.09",33144
,20170302,282.3,282.95,282,283.25,281.4,282.75,282.45,-.2,-.5,2558,"72,262.75",33434
,20170303,282.75,282.45,282.1,282.4,280.05,280.4,280.65,-2.05,-1.8,3130,"87,858.99",34068
,20170306,280.4,280.65,280.25,281.95,279.5,280.55,280.55,-.1,-.1,6168,"173,069.14",35670
,20170307,280.55,280.55,280.55,280.8,279.15,279.25,279.85,-1.3,-.7,2600,"72,765.84",36426
,20170308,279.25,279.85,278.95,278.95,277.6,277.7,278,-2.15,-1.85,8304,"230,865.32",40128
,20170309,277.7,278,277.05,277.65,275.95,276.2,276.7,-1.8,-1.3,8386,"232,041.69",42068
,20170310,276.2,276.7,276.4,277,274.45,274.55,275.35,-2.15,-1.35,8182,"225,318.61",44670
,20170313,274.55,275.35,274.55,276.8,274.25,276.8,275.8,1.45,.45,8710,"240,246.39",44820
,20170314,276.8,275.8,276,276.4,275.5,275.6,275.95,-.2,.15,3710,"102,389.55",45838
,20170315,275.6,275.95,275.8,276.55,275.05,275.85,275.75,-.1,-.2,3348,"92,331.77",46806
,20170316,275.85,275.75,275.25,280.25,275,280.1,278.6,4.35,2.85,10760,"299,802.69",46490
,20170317,280.1,278.6,280.6,281.2,279.75,280.15,280.1,1.55,1.5,4084,"114,402.39",47254
,20170320,280.15,280.1,280.35,281.65,280.05,281.55,281.2,1.45,1.1,6502,"182,849.57",47640
,20170321,281.55,281.2,281,281.75,279.7,280.45,280.6,-.75,-.6,9308,"261,216.33",50284
,20170322,280.45,280.6,280.55,283.2,280.55,282.8,282.4,2.2,1.8,8526,"240,789.73",52116
,20170323,282.8,282.4,282.65,283.05,281.95,282.75,282.45,.35,.05,6356,"179,526.85",52842
,20170324,282.75,282.45,283.25,283.6,281.6,281.95,282.2,-.5,-.25,5980,"168,760.47",52716
,20170327,281.95,282.2,282.25,285.2,281.7,285,283.95,2.8,1.75,7488,"212,629.16",53442
,20170328,285,283.95,284.95,285.35,283.95,284.2,284.4,.25,.45,8642,"245,809.53",54040
,20170329,284.2,284.4,285.05,285.15,283.1,283.55,283.8,-.85,-.6,9150,"259,695.46",54552
,20170330,283.55,283.8,284,284.15,283.05,283.5,283.45,-.3,-.35,6954,"197,135.22",53408
,20170331,283.5,283.45,283,283.3,281.25,281.7,282.15,-1.75,-1.3,9366,"264,272.03",54058
,20170405,281.7,282.15,284,284.85,283.7,284.1,283.95,1.95,1.8,7400,"210,144.34",53630
,20170406,284.1,283.95,283.25,284.6,282.2,284.5,283.85,.55,-.1,13856,"393,365.54",56800
,20170407,284.5,283.85,284.2,288.75,283.6,286.9,286.6,3.05,2.75,29718,"851,836.12",60526
,20170410,286.9,286.6,287.55,288.25,284.2,285.35,285.4,-1.25,-1.2,22932,"654,498.72",58024
,20170411,285.35,285.4,284.6,286.05,284.1,285.75,285.25,.35,-.15,12806,"365,323.69",58844
,20170412,285.75,285.25,286.35,290.1,286.35,288.85,288.35,3.6,3.1,22048,"635,848.65",62256
,20170413,288.85,288.35,289.4,291,288.1,289.9,289.9,1.55,1.55,35872,"1,039,985.57",73344
,20170414,289.9,289.9,290.4,290.85,289.35,290.45,290.3,.55,.4,17058,"495,264.88",76424
,20170417,290.45,290.3,291,292.2,289.65,289.9,290.7,-.4,.4,34504,"1,003,098.08",85330
,20170418,289.9,290.7,289.45,290.35,288,288.9,289.1,-1.8,-1.6,40722,"1,177,316.28",92522
,20170419,288.9,289.1,288.95,290.1,287.6,288.85,289,-.25,-.1,31598,"913,304.61",98746
,20170420,288.85,289,289,289.3,287.5,288.15,288.2,-.85,-.8,34880,"1,005,370.44",111576
,20170421,288.15,288.2,288.15,288.5,287.4,288.15,288,-.05,-.2,14380,"414,158.49",112984
,20170424,288.15,288,288.5,290,285.7,286.4,287.7,-1.6,-.3,37762,"1,086,486.90",119016
,20170425,286.4,287.7,285.75,286.85,285.3,286.3,286.35,-1.4,-1.35,28280,"809,837.84",125956
,20170426,286.3,286.35,285.2,285.95,283.6,285.1,285.15,-1.25,-1.2,30530,"870,593.05",134330
,20170427,285.1,285.15,285.2,286.15,284.7,285.6,285.6,.45,.45,31178,"890,501.18",147064
,20170428,285.6,285.6,285.75,286.25,285.15,286.2,285.75,.6,.15,32364,"924,890.37",152706
,20170502,286.2,285.75,283.8,284.4,283.55,283.9,283.9,-1.85,-1.85,39920,"1,133,475.11",163774
,20170503,283.9,283.9,283.05,283.7,282.85,283.3,283.3,-.6,-.6,30714,"870,277.14",165456
,20170504,283.3,283.3,283,283.25,278.7,279.65,281.05,-3.65,-2.25,92606,"2,603,045.59",174724
,20170505,279.65,281.05,278.05,280,277.4,278.8,278.3,-2.25,-2.75,102698,"2,858,551.60",182136
,20170508,278.8,278.3,278.3,279.35,278.05,278.5,278.6,.2,.3,86346,"2,405,604.51",188964
,20170509,278.5,278.6,278.65,279.4,277.5,278.45,278.5,-.15,-.1,128798,"3,587,547.96",191426
,20170510,278.45,278.5,277.35,277.4,275.65,277.05,276.75,-1.45,-1.75,118918,"3,291,260.34",201004
,20170511,277.05,276.75,277.25,277.55,276.3,277.35,277.05,.6,.3,92586,"2,565,156.72",205942
,20170512,277.35,277.05,277,278.5,276.95,278.1,277.75,1.05,.7,119980,"3,332,865.07",211756
,20170515,278.1,277.75,278.75,279.55,277.75,279.4,278.65,1.65,.9,124840,"3,478,945.44",220070
,20170516,279.4,278.65,280.15,280.65,279,280,279.75,1.35,1.1,118992,"3,329,257.86",220422
,20170517,280,279.75,280.05,281.3,279.5,280.95,280.55,1.2,.8,133590,"3,747,981.65",230274
,20170518,280.95,280.55,282.5,284.75,282.35,283.25,283.4,2.7,2.85,230310,"6,527,883.30",237936
,20170519,283.25,283.4,283.55,284.2,281.6,282.65,282.95,-.75,-.45,186950,"5,289,943.14",244610
,20170522,282.65,282.95,283.3,283.6,282.15,283.3,282.9,.35,-.05,114482,"3,238,730.36",249876
,20170523,283.3,282.9,284.05,285.2,283.45,285.2,284.35,2.3,1.45,123256,"3,504,904.61",262554
,20170524,285.2,284.35,285,285.1,281.5,281.85,283.2,-2.5,-1.15,170178,"4,820,207.21",267980
,20170525,281.85,283.2,282.5,283.8,281.75,283.3,282.95,.1,-.25,136700,"3,867,949.37",275156
,20170526,283.3,282.95,282.75,283.5,282,283.35,282.5,.4,-.45,104532,"2,953,332.58",275262
,20170531,283.35,282.5,283.05,283.3,281.65,281.65,282.25,-.85,-.25,74258,"2,096,198.54",281108
,20170601,281.65,282.25,282.35,283.15,281.4,281.85,282.05,-.4,-.2,157458,"4,441,868.44",283362
,20170602,281.85,282.05,281.25,282.2,280.6,280.85,281,-1.2,-1.05,129192,"3,630,923.11",288512
,20170605,280.85,281,283,285.2,282.75,284.55,283.85,3.55,2.85,215452,"6,116,195.69",304850
,20170606,284.55,283.85,284.8,286.5,284.05,286.3,285.2,2.45,1.35,135910,"3,876,595.38",316800
,20170607,286.3,285.2,286.6,287.2,286.25,286.6,286.7,1.4,1.5,138618,"3,974,388.79",325410
,20170608,286.6,286.7,286.55,286.9,285.05,285.75,286,-.95,-.7,141700,"4,052,982.37",326824
,20170609,285.75,286,285.15,285.4,282.15,282.5,283.55,-3.5,-2.45,223770,"6,345,226.82",332974
,20170612,282.5,283.55,281.8,281.9,281,281.05,281.3,-2.5,-2.25,151544,"4,263,532.89",339722
,20170613,281.05,281.3,280.85,281.6,280.35,281.15,281.05,-.15,-.25,105884,"2,976,348.17",340090
,20170614,281.15,281.05,280.35,282.4,280.05,281.7,281.3,.65,.25,131122,"3,688,784.35",334782
,20170615,281.7,281.3,283,284.65,279.7,279.85,282.15,-1.45,.85,238286,"6,723,722.99",340830
,20170616,279.85,282.15,278.5,279.8,278.3,279.35,279.1,-2.8,-3.05,147956,"4,129,453.13",342074
,20170619,279.35,279.1,279.65,279.8,278.5,278.85,279.1,-.25,0,99854,"2,787,346.72",343958
,20170620,278.85,279.1,278.55,278.9,277.6,278.25,278.25,-.85,-.85,111782,"3,110,340.99",344998
,20170621,278.25,278.25,278.05,278.5,277.3,278.15,277.95,-.1,-.3,104238,"2,897,306.76",344970
,20170622,278.15,277.95,277.85,280.3,277.3,279.9,279.05,1.95,1.1,135198,"3,772,856.13",341690
,20170623,279.9,279.05,280.15,280.55,279.1,280.45,279.9,1.4,.85,119404,"3,342,389.18",337016
,20170626,280.45,279.9,281.55,281.55,280.35,280.6,280.7,.7,.8,78260,"2,196,872.13",333442
,20170627,280.6,280.7,278.35,279.45,277.9,279.4,278.55,-1.3,-2.15,170412,"4,747,593.94",326864
,20170628,279.4,278.55,278.6,279.3,278.05,278.75,278.65,.2,.1,168850,"4,705,428.09",332470
,20170629,278.75,278.65,278.95,279.15,277.7,278.15,278.35,-.5,-.3,158992,"4,425,584.89",337162
,20170630,278.15,278.35,276.4,277.35,275.4,275.5,276.2,-2.85,-2.15,221690,"6,123,246.21",338722
,20170703,275.5,276.2,275.3,276.3,274.35,274.6,275.1,-1.6,-1.1,142246,"3,913,769.80",343202
,20170704,274.6,275.1,273.25,273.35,271.6,272.6,272.45,-2.5,-2.65,190506,"5,190,612.39",346746
,20170705,272.6,272.45,272.7,273.3,272.05,272.4,272.6,-.05,.15,102604,"2,797,166.34",345904
,20170706,272.4,272.6,271.1,273.2,271.05,272.85,272.3,.25,-.3,129270,"3,520,572.88",346032
,20170707,272.85,272.3,272.9,273.25,271.6,272.2,272.3,-.1,0,115020,"3,132,004.70",347806
,20170710,272.2,272.3,272.25,272.35,268,268.8,269.75,-3.5,-2.55,241862,"6,525,096.64",349336
,20170711,268.8,269.75,269.35,270.7,268.95,270,269.9,.25,.15,139294,"3,760,237.02",347824
,20170712,270,269.9,270.1,271.65,269.25,271,270.75,1.1,.85,156136,"4,227,387.37",348784
,20170713,271,270.75,272.35,272.45,271.05,271.75,271.6,1,.85,154644,"4,200,891.47",352132
,20170714,271.75,271.6,271.5,271.5,269.85,270.65,270.6,-.95,-1,113550,"3,072,761.63",353988
,20170717,270.65,270.6,273.15,273.45,272.3,273,272.85,2.4,2.25,163458,"4,460,600.23",350286
,20170718,273,272.85,273.7,274.4,273.5,273.7,273.9,.85,1.05,125924,"3,449,202.37",341346
,20170719,273.7,273.9,274.3,274.75,273.85,274.05,274.15,.15,.25,113988,"3,125,235.02",336326
,20170720,274.05,274.15,274.55,274.75,273.9,274.2,274.2,.05,.05,100138,"2,746,034.51",343990
,20170721,274.2,274.2,274.3,275.85,273.5,275.8,274.95,1.6,.75,173552,"4,772,101.28",349878
,20170724,275.8,274.95,276.7,277.45,276.05,276.45,276.7,1.5,1.75,124830,"3,454,501.39",348868
,20170725,276.45,276.7,277.35,277.4,276.15,276.8,276.65,.1,-.05,99046,"2,740,129.96",346342
,20170726,276.8,276.65,276.1,276.5,274.15,274.4,275.35,-2.25,-1.3,142662,"3,928,255.71",350512
,20170727,274.4,275.35,274.8,278.05,274.6,277.6,276.75,2.25,1.4,164112,"4,541,847.77",342962
,20170728,277.6,276.75,277.9,277.95,276.6,277.25,277.3,.5,.55,149302,"4,140,851.02",338706
,20170731,277.25,277.3,277.95,278.95,277.65,278.05,278.35,.75,1.05,147076,"4,094,454.07",339218
,20170801,278.05,278.35,278.3,278.5,277.75,278,278.15,-.35,-.2,92472,"2,572,266.46",345998
,20170802,278,278.15,278,279.05,277.55,277.95,278.25,-.2,.1,160750,"4,473,550.48",349628
,20170803,277.95,278.25,277.6,278.8,276.6,276.9,277.65,-1.35,-.6,147540,"4,096,947.01",351140
,20170804,276.9,277.65,277.55,278.55,277.4,278.45,278,.8,.35,143116,"3,978,841.10",359734
,20170807,278.45,278,277,277.25,275.65,275.95,276.25,-2.05,-1.75,175064,"4,836,562.29",353954
,20170808,275.95,276.25,275.85,276.5,275.35,275.7,275.95,-.55,-.3,112310,"3,099,280.15",353302
,20170809,275.7,275.95,276.2,277.6,274.15,276.45,275.7,.5,-.25,186480,"5,141,824.09",353536
,20170810,276.45,275.7,278.1,278.8,277.4,278.45,278,2.75,2.3,187428,"5,210,566.27",350424
,20170811,278.45,278,279.35,280.3,278.85,279.85,279.6,1.85,1.6,222826,"6,230,685.91",355820
,20170814,279.85,279.6,279.75,280.3,278.55,279.75,279.6,.15,0,175078,"4,895,459.71",355662
,20170815,279.75,279.6,278.9,279.75,277,277.85,278.2,-1.75,-1.4,182520,"5,078,304.66",348620
,20170816,277.85,278.2,276.55,277.9,276.35,276.95,277.15,-1.25,-1.05,119916,"3,323,497.97",347326
,20170817,276.95,277.15,277.1,280.45,276.65,279.95,278.9,2.8,1.75,192184,"5,360,161.15",352070
,20170818,279.95,278.9,279.45,280.5,278.75,280.5,279.75,1.6,.85,144594,"4,045,713.05",360176
,20170821,280.5,279.75,281.8,282.6,278.75,279.7,280.5,-.05,.75,238136,"6,680,697.57",361748
,20170822,279.7,280.5,279.8,280.95,279,279.1,280.05,-1.4,-.45,149470,"4,185,978.74",358624
,20170823,279.1,280.05,279.65,280.4,278.35,279.15,279.15,-.9,-.9,148734,"4,151,927.66",354190
,20170824,279.15,279.15,279.75,279.9,279.05,279.25,279.5,.1,.35,119042,"3,327,273.04",355920
,20170825,279.25,279.5,279.3,279.75,278.6,279.05,279.05,-.45,-.45,111830,"3,120,827.54",358560
,20170828,279.05,279.05,278.95,280.9,276.5,280.45,279.2,1.4,.15,263900,"7,368,201.64",358164
,20170829,280.45,279.2,280.3,283.8,279.75,283.8,282.25,4.6,3.05,215014,"6,068,990.91",369830
,20170830,283.8,282.25,283.8,284.3,280.25,280.35,282.2,-1.9,-.05,220274,"6,216,554.88",358480
,20170831,280.35,282.2,280.35,281.3,279.2,279.9,280.3,-2.3,-1.9,141360,"3,962,580.14",358378
,20170901,279.9,280.3,280.9,282.65,280.7,281.8,281.9,1.5,1.6,173324,"4,886,238.16",357650
,20170904,281.8,281.9,282.25,285,281.2,284.2,283,2.3,1.1,248002,"7,019,227.01",358922
,20170905,284.2,283,283.2,284.05,282.75,283.65,283.4,.65,.4,118342,"3,353,946.80",359688
,20170906,283.65,283.4,282.9,284.45,282.85,284.1,283.75,.7,.35,167572,"4,755,585.88",356580
,20170907,284.1,283.75,283.9,284.1,282.4,283.05,283.2,-.7,-.55,171472,"4,856,644.22",354744
,20170908,283.05,283.2,283.65,283.95,282.75,283.7,283.4,.5,.2,234876,"6,657,098.41",346738
,20170911,283.7,283.4,283.25,283.85,281.75,282.4,282.95,-1,-.45,205840,"5,824,621.97",346546
,20170912,282.4,282.95,282.3,282.75,280.9,281.1,281.8,-1.85,-1.15,138828,"3,912,773.72",337000
,20170913,281.1,281.8,281.2,282.05,281.05,281.5,281.6,-.3,-.2,105588,"2,973,675.59",340730
,20170914,281.5,281.6,281.8,282.05,280.55,281.15,281.15,-.45,-.45,152354,"4,283,662.72",340358
,20170915,281.15,281.15,281.75,282.9,281.4,282.45,282.15,1.3,1,148056,"4,178,065.90",339532
,20170918,282.45,282.15,281.8,281.95,279.75,279.85,280.85,-2.3,-1.3,166142,"4,666,579.99",335756
,20170919,279.85,280.85,279.65,280.3,278.85,279.8,279.7,-1.05,-1.15,146266,"4,091,528.38",320598
,20170920,279.8,279.7,279.65,280.35,279.45,280.05,280.05,.35,.35,93828,"2,627,875.04",319206
,20170921,280.05,280.05,280.05,280.95,277.5,277.5,279,-2.55,-1.05,196020,"5,469,604.82",315744
,20170922,277.5,279,276.7,278,276.55,277.95,277.2,-1.05,-1.8,152812,"4,236,186.73",303544
,20170925,277.95,277.2,277.2,277.85,277,277.6,277.4,.4,.2,101102,"2,804,917.52",305276
,20170926,277.6,277.4,278,282.15,277.75,281.8,280.6,4.4,3.2,209918,"5,890,921.29",298340
,20170927,281.8,280.6,280.15,281.2,279.05,279.2,280.05,-1.4,-.55,177298,"4,965,763.36",302816
,20170928,279.2,280.05,278.55,278.95,277.35,277.7,278.05,-2.35,-2,157036,"4,366,754.29",289274
,20170929,277.7,278.05,278.05,279.05,277.75,278.9,278.4,.85,.35,99056,"2,757,733.71",286592
,20171009,278.9,278.4,276.4,277.6,276.1,276.75,277.05,-1.65,-1.35,96730,"2,680,307.21",294948
,20171010,276.75,277.05,276.65,277.3,276.4,276.65,276.75,-.4,-.3,89448,"2,475,768.76",297970
,20171011,276.65,276.75,276.65,277.3,275.85,276.1,276.5,-.65,-.25,102690,"2,839,766.79",301148
,20171012,276.1,276.5,276.35,277.5,275.5,277.1,276.6,.6,.1,106566,"2,948,100.35",301212
,20171013,277.1,276.6,276.75,277.5,276.3,277.2,276.9,.6,.3,81608,"2,259,847.32",298044
,20171016,277.2,276.9,277.75,278.85,277.3,278.7,278,1.8,1.1,122152,"3,395,963.96",296106
,20171017,278.7,278,279,279.05,277,277.25,277.75,-.75,-.25,132882,"3,691,276.04",283332
,20171018,277.25,277.75,276.75,276.95,276.1,276.15,276.55,-1.6,-1.2,109406,"3,025,939.43",278086
,20171019,276.15,276.55,275.95,276.45,275.2,275.7,275.7,-.85,-.85,108490,"2,991,134.59",269550
,20171020,275.7,275.7,276.2,276.9,275.8,276.05,276.25,.35,.55,116690,"3,223,899.39",265528
,20171023,276.05,276.25,276,276.05,274.8,274.9,275.3,-1.35,-.95,123402,"3,397,330.24",262902
,20171024,274.9,275.3,274.7,276.25,274.45,275.8,275.5,.5,.2,102460,"2,823,036.85",256802
,20171025,275.8,275.5,275.35,275.45,274.5,274.55,274.9,-.95,-.6,105748,"2,907,323.31",250284
,20171026,274.55,274.9,274.4,275.85,274.4,275.8,275.35,.9,.45,127364,"3,507,507.19",244458
,20171027,275.8,275.35,275.2,275.65,273.65,273.95,274.4,-1.4,-.95,146570,"4,022,459.42",237496
,20171030,273.95,274.4,273.65,274.8,273.65,274.3,274.3,-.1,-.1,132546,"3,635,898.79",220844
,20171031,274.3,274.3,274.25,275.15,274.15,274.5,274.6,.2,.3,129702,"3,562,114.12",197174
,20171101,274.5,274.6,273.9,274.15,273.1,273.9,273.55,-.7,-1.05,107352,"2,936,741.16",184966
,20171102,273.9,273.55,273.8,274.2,273,274,273.75,.45,.2,82780,"2,266,236.46",180296
,20171103,274,273.75,273.7,274.8,273.5,274,274.05,.25,.3,81612,"2,236,762.78",180534
,20171106,274,274.05,274.1,274.65,272.8,273.4,273.6,-.65,-.45,95554,"2,614,593.27",174718
,20171107,273.4,273.6,273.75,275.4,273.55,274.75,274.45,1.15,.85,81728,"2,243,292.37",163132
,20171108,274.75,274.45,274.8,275.05,273.9,274.8,274.65,.35,.2,63420,"1,741,870.50",160210
,20171109,274.8,274.65,275.1,276.15,275.05,275.75,275.55,1.1,.9,82990,"2,287,020.40",144354
,20171110,275.75,275.55,276.5,276.95,276,276.5,276.55,.95,1,69020,"1,908,896.36",136734
,20171113,276.5,276.55,276.85,276.9,274.95,275.35,275.65,-1.2,-.9,63550,"1,751,775.12",126392
,20171114,275.35,275.65,275.45,275.85,275.05,275.15,275.25,-.5,-.4,41322,"1,137,588.32",116442
,20171115,275.15,275.25,274.7,275.95,274,275.75,275.3,.5,.05,81570,"2,245,784.52",102316
,20171116,275.75,275.3,276.2,276.5,274.55,275.05,275.45,-.25,.15,55378,"1,525,601.31",90472
,20171117,275.05,275.45,275.5,276.2,274.9,276.2,275.7,.75,.25,42250,"1,164,946.05",78250
,20171120,276.2,275.7,276.2,278.5,276,277.45,277.15,1.75,1.45,48088,"1,332,764.02",66936
,20171121,277.45,277.15,277.4,277.75,275.2,276,276.25,-1.15,-.9,37980,"1,049,334.19",55804
,20171122,276,276.25,275.35,276.65,275,275.8,275.8,-.45,-.45,25608,"706,391.24",50614
,20171123,275.8,275.8,276.4,276.8,275.85,276.1,276.2,.3,.4,19470,"537,848.40",46584
,20171124,276.1,276.2,275.35,276.45,275.35,276.35,276.1,.15,-.1,16312,"450,393.40",40968
,20171127,276.35,276.1,275.75,276.45,275.65,276.4,276.1,.3,0,12152,"335,524.55",34582
,20171128,276.4,276.1,276.85,278,276.2,277.45,277.35,1.35,1.25,21518,"596,816.56",25794
,20171129,277.45,277.35,277.45,277.65,276.45,277.45,277.25,.1,-.1,13802,"382,723.04",19908
,20171130,277.45,277.25,277.25,277.25,273.7,273.9,275.3,-3.35,-1.95,15030,"413,844.18",13892
,20171201,273.9,275.3,274.05,274.05,271.3,272,272.45,-3.3,-2.85,4358,"118,741.28",11562
,20171204,272,272.45,271.95,274.25,271.1,272,271.95,-.45,-.5,2808,"76,372.08",10188
,20171205,272,271.95,272.1,272.45,271.65,271.85,272,-.1,.05,900,"24,484.20",9858
,20171206,271.85,272,271.8,271.85,269.9,270.85,270.6,-1.15,-1.4,1158,"31,335.75",9114
,20171207,270.85,270.6,270.6,270.7,268,268.65,269.15,-1.95,-1.45,696,"18,734.01",8616
,20171208,268.65,269.15,268,268,266.35,266.4,266.9,-2.75,-2.25,288,"7,687.89",8526
,20171211,266.4,266.9,266.4,266.55,262.95,265.5,264.85,-1.4,-2.05,2370,"62,780.13",8520
,20171212,265.5,264.85,266.25,266.3,258.3,263.15,262.85,-1.7,-2,3612,"94,959.30",8160
,20171213,263.15,262.85,259.3,265.6,259.3,265.45,265.2,2.6,2.35,390,"10,342.92",8202
,20171214,265.45,265.2,268.25,268.25,258.4,267,265.4,1.8,.2,144,"3,822.45",8160
,20171215,267,265.4,268,268.5,268,268.5,268.1,3.1,2.7,30,804.30,8160
au1801,20171017,278,278,,,,278,278,0,0,0,0.00,0
,20171018,278,278,278.25,278.25,277.95,277.95,277.95,-.05,-.05,28,778.39,24
,20171019,277.95,277.95,278.35,279.35,276.5,279.35,277.8,1.4,-.15,10,277.81,26
,20171020,279.35,277.8,278.05,279.3,278.05,278.85,278.45,1.05,.65,12,334.19,24
,20171023,278.85,278.45,276.05,276.1,275.3,275.3,276,-3.15,-2.45,26,717.67,28
,20171024,275.3,276,276.6,277.65,275.95,277.65,276.7,1.65,.7,8,221.36,28
,20171025,277.65,276.7,,,,276.7,276.7,0,0,0,0.00,28
,20171026,276.7,276.7,,,,276.7,276.7,0,0,0,0.00,28
,20171027,276.7,276.7,273.1,275.95,273.1,275.95,274.5,-.75,-2.2,4,109.81,28
,20171030,275.95,274.5,,,,274.5,274.5,0,0,0,0.00,28
,20171031,274.5,274.5,276.5,276.55,276.5,276.55,276.5,2.05,2,8,221.22,28
,20171101,276.55,276.5,276.55,277.85,273.6,275.2,275.65,-1.3,-.85,48,"1,323.31",28
,20171102,275.2,275.65,275.05,275.05,273.1,273.1,274.05,-2.55,-1.6,4,109.63,30
,20171103,273.1,274.05,,,,274.05,274.05,0,0,0,0.00,30
,20171106,274.05,274.05,275.75,275.75,274.4,275.6,275.25,1.55,1.2,6,165.15,30
,20171107,275.6,275.25,273.4,278.3,273.4,276.15,276.2,.9,.95,52,"1,436.42",40
,20171108,276.15,276.2,276.75,277.05,275.7,275.7,276.45,-.5,.25,8,221.16,40
,20171109,275.7,276.45,277.4,277.4,276.5,277,277,.55,.55,24,664.82,52
,20171110,277,277,277.7,277.7,277.7,277.7,277.7,.7,.7,4,111.08,56
,20171113,277.7,277.7,277.75,277.75,277.75,277.75,277.75,.05,.05,2,55.55,56
,20171114,277.75,277.75,276.1,276.75,276.1,276.75,276.3,-1,-1.45,6,165.79,56
,20171115,276.75,276.3,274.8,279.55,274.8,277.15,277.15,.85,.85,6,166.30,60
,20171116,277.15,277.15,277.25,277.25,275.2,275.2,276.15,-1.95,-1,12,331.40,56
,20171117,275.2,276.15,,,,276.15,276.15,0,0,0,0.00,56
,20171120,276.15,276.15,,,,276.15,276.15,0,0,0,0.00,56
,20171121,276.15,276.15,,,,276.15,276.15,0,0,0,0.00,56
,20171122,276.15,276.15,276.4,276.4,275.4,275.4,275.9,-.75,-.25,4,110.36,60
,20171123,275.4,275.9,276.45,276.6,275.1,276.55,276.1,.65,.2,22,607.50,52
,20171124,276.55,276.1,276.4,277.65,276.2,276.2,276.75,.1,.65,14,387.48,54
,20171127,276.2,276.75,275.6,277.7,275.6,277,277.05,.25,.3,24,665.03,64
,20171128,277,277.05,277.7,278.3,277.15,278.3,277.8,1.25,.75,34,944.57,50
,20171129,278.3,277.8,278.6,278.6,277.45,278.15,277.9,.35,.1,22,611.43,50
,20171130,278.15,277.9,276.6,276.85,276,276.85,276.5,-1.05,-1.4,36,995.54,70
,20171201,276.85,276.5,275.35,275.8,273.45,273.9,274.65,-2.6,-1.85,16,439.46,70
,20171204,273.9,274.65,273.15,273.8,273.15,273.8,273.45,-.85,-1.2,4,109.39,72
,20171205,273.8,273.45,274.05,274.05,274.05,274.05,274.05,.6,.6,4,109.62,68
,20171206,274.05,274.05,273.3,273.3,273.3,273.3,273.3,-.75,-.75,2,54.66,68
,20171207,273.3,273.3,,,,273.3,273.3,0,0,0,0.00,68
,20171208,273.3,273.3,269.3,269.3,269.3,269.3,269.3,-4,-4,2,53.86,66
,20171211,269.3,269.3,267.4,267.4,267.4,267.4,267.4,-1.9,-1.9,12,320.88,78
,20171212,267.4,267.4,271.25,271.25,267.45,268,268.1,.6,.7,20,536.22,72
,20171213,268,268.1,268.95,268.95,266.65,268.95,268.2,.85,.1,32,858.29,62
,20171214,268.95,268.2,270,271.8,270,271.8,271.3,3.6,3.1,8,217.06,62
,20171215,271.8,271.3,270.8,271.5,268.5,269.4,270,-1.9,-1.3,16,432.04,60
,20171218,269.4,270,269.85,269.85,269.85,269.85,269.85,-.15,-.15,4,107.94,60
,20171219,269.85,269.85,269.5,271,269.5,270.85,270.55,1,.7,8,216.47,56
,20171220,270.85,270.55,271.3,271.3,270.7,270.7,271,.15,.45,4,108.40,56
,20171221,270.7,271,270.05,270.05,270.05,270.05,270.05,-.95,-.95,2,54.01,56
,20171222,270.05,270.05,269.9,269.9,269.2,269.2,269.6,-.85,-.45,6,161.78,52
,20171225,269.2,269.6,270.1,271.65,270.1,271.65,271.25,2.05,1.65,8,217.01,50
,20171226,271.65,271.25,269.7,271.8,269.7,271.8,271.15,.55,-.1,50,"1,355.94",32
,20171227,271.8,271.15,271.75,271.75,271.75,271.75,271.75,.6,.6,12,326.10,32
,20171228,271.75,271.75,268.2,273.6,268.2,273.2,272.75,1.45,1,84,"2,291.45",84
,20171229,273.2,272.75,272,273.5,271.7,271.75,272.35,-1,-.4,12,326.84,84
au1802,20170117,275,275,275.9,275.9,275.9,275.9,275.9,.9,.9,2,55.18,2
,20170118,275.9,275.9,278.1,278.1,276,276,277.05,.1,1.15,4,110.82,4
,20170119,276,277.05,,,,277.05,277.05,0,0,0,0.00,4
,20170120,277.05,277.05,,,,277.05,277.05,0,0,0,0.00,4
,20170123,277.05,277.05,276.75,276.75,276.7,276.7,276.7,-.35,-.35,4,110.69,8
,20170124,276.7,276.7,,,,276.7,276.7,0,0,0,0.00,8
,20170125,276.7,276.7,274.9,274.9,274.9,274.9,274.9,-1.8,-1.8,4,109.96,6
,20170126,274.9,274.9,,,,272.45,272.45,-2.45,-2.45,0,0.00,6
,20170203,272.45,272.45,,,,272.45,272.45,0,0,0,0.00,6
,20170206,272.45,272.45,,,,272.45,272.45,0,0,0,0.00,6
,20170207,272.45,272.45,,,,274.8,274.8,2.35,2.35,0,0.00,6
,20170208,274.8,274.8,,,,275.95,275.95,1.15,1.15,0,0.00,6
,20170209,275.95,275.95,275.95,275.95,275.95,275.95,275.95,0,0,2,55.19,8
,20170210,275.95,275.95,278.35,278.35,278.35,278.35,278.35,2.4,2.4,2,55.67,10
,20170213,278.35,278.35,278.55,281.25,278.55,281.25,279.9,2.9,1.55,4,111.96,10
,20170214,281.25,279.9,,,,279.9,279.9,0,0,0,0.00,10
,20170215,279.9,279.9,279.65,279.65,278.6,278.6,279.1,-1.3,-.8,4,111.65,10
,20170216,278.6,279.1,,,,279.1,279.1,0,0,0,0.00,10
,20170217,279.1,279.1,280.9,281,280.9,281,280.95,1.9,1.85,4,112.38,10
,20170220,281,280.95,,,,280.95,280.95,0,0,0,0.00,10
,20170221,280.95,280.95,281.25,281.25,281,281,281.1,.05,.15,4,112.45,8
,20170222,281,281.1,,,,281.1,281.1,0,0,0,0.00,8
,20170223,281.1,281.1,281.6,282.65,281.3,282.1,281.85,1,.75,18,507.36,20
,20170224,282.1,281.85,285.2,285.2,284.8,285.2,285.05,3.35,3.2,6,171.04,22
,20170227,285.2,285.05,286.9,286.9,286.35,286.75,286.65,1.7,1.6,6,172.00,24
,20170228,286.75,286.65,,,,286.65,286.65,0,0,0,0.00,24
,20170301,286.65,286.65,284.6,284.6,283.65,283.65,284.1,-3,-2.55,4,113.65,26
,20170302,283.65,284.1,,,,284.1,284.1,0,0,0,0.00,26
,20170303,284.1,284.1,280.75,283.45,280.75,281.8,282.3,-2.3,-1.8,10,282.34,30
,20170306,281.8,282.3,,,,282.3,282.3,0,0,0,0.00,30
,20170307,282.3,282.3,281.45,281.45,281.45,281.45,281.45,-.85,-.85,2,56.29,30
,20170308,281.45,281.45,280.1,280.1,280.1,280.1,280.1,-1.35,-1.35,2,56.02,28
,20170309,280.1,280.1,277.95,277.95,277.95,277.95,277.95,-2.15,-2.15,2,55.59,30
,20170310,277.95,277.95,,,,277.95,277.95,0,0,0,0.00,30
,20170313,277.95,277.95,,,,277.95,277.95,0,0,0,0.00,30
,20170314,277.95,277.95,,,,277.95,277.95,0,0,0,0.00,30
,20170315,277.95,277.95,277.6,277.6,277.6,277.6,277.6,-.35,-.35,2,55.52,32
,20170316,277.6,277.6,,,,280.45,280.45,2.85,2.85,0,0.00,32
,20170317,280.45,280.45,282.5,282.5,281.4,281.4,281.95,.95,1.5,4,112.78,32
,20170320,281.4,281.95,282.95,283.8,282.5,282.5,283.05,.55,1.1,6,169.85,34
,20170321,282.5,283.05,282.45,282.45,281.7,281.7,282.05,-1.35,-1,4,112.83,38
,20170322,281.7,282.05,,,,282.05,282.05,0,0,0,0.00,38
,20170323,282.05,282.05,,,,282.05,282.05,0,0,0,0.00,38
,20170324,282.05,282.05,285,285,283.65,284.15,284.3,2.1,2.25,12,341.19,42
,20170327,284.15,284.3,284.5,285.65,284.4,285.65,284.8,1.35,.5,12,341.81,40
,20170328,285.65,284.8,286.4,286.4,285.65,285.65,285.8,.85,1,8,228.67,36
,20170329,285.65,285.8,285.3,285.3,285.3,285.3,285.3,-.5,-.5,4,114.12,40
,20170330,285.3,285.3,,,,285.3,285.3,0,0,0,0.00,40
,20170331,285.3,285.3,,,,285.3,285.3,0,0,0,0.00,40
,20170405,285.3,285.3,,,,285.3,285.3,0,0,0,0.00,40
,20170406,285.3,285.3,285.8,285.8,285.7,285.7,285.75,.4,.45,4,114.30,42
,20170407,285.7,285.75,285.6,285.6,285.6,285.6,285.6,-.15,-.15,6,171.36,46
,20170410,285.6,285.6,289.55,289.55,287,287.55,288,1.95,2.4,16,460.81,48
,20170411,287.55,288,,,,288,288,0,0,0,0.00,48
,20170412,288,288,289.25,291.25,289.25,290.4,290,2.4,2,14,406.05,48
,20170413,290.4,290,291.35,292.8,290.7,292.1,291.9,2.1,1.9,28,817.45,50
,20170414,292.1,291.9,292.3,293.25,292.3,292.35,292.55,.45,.65,14,409.57,54
,20170417,292.35,292.55,293.55,293.65,293.55,293.65,293.6,1.1,1.05,4,117.44,52
,20170418,293.65,293.6,291.65,292.15,291,291,291.35,-2.6,-2.25,22,640.98,66
,20170419,291,291.35,291.2,291.2,291.2,291.2,291.2,-.15,-.15,4,116.48,66
,20170420,291.2,291.2,290.45,290.45,289.9,290,290.1,-1.2,-1.1,22,638.30,60
,20170421,290,290.1,290.15,290.15,289.75,289.75,289.95,-.35,-.15,4,115.98,62
,20170424,289.75,289.95,291.45,291.55,287.85,287.85,289.7,-2.1,-.25,28,811.27,66
,20170425,287.85,289.7,,,,289.7,289.7,0,0,0,0.00,66
,20170426,289.7,289.7,287.25,287.5,287.1,287.5,287.3,-2.2,-2.4,8,229.87,64
,20170427,287.5,287.3,286.95,287.45,286.5,287.45,286.95,.15,-.35,12,344.35,70
,20170428,287.45,286.95,287.5,287.8,287.5,287.8,287.6,.85,.65,6,172.56,74
,20170502,287.8,287.6,273.3,286.45,273.3,285.4,283.95,-2.2,-3.65,14,397.56,74
,20170503,285.4,283.95,285,285.2,284.7,284.75,284.9,.8,.95,12,341.88,76
,20170504,284.75,284.9,284.3,284.45,280.7,281.3,281.8,-3.6,-3.1,30,845.44,72
,20170505,281.3,281.8,279.35,280.2,279.35,280.15,280.05,-1.65,-1.75,16,448.14,84
,20170508,280.15,280.05,280.35,280.35,280.35,280.35,280.35,.3,.3,2,56.07,82
,20170509,280.35,280.35,,,,280.35,280.35,0,0,0,0.00,82
,20170510,280.35,280.35,278.65,278.65,278.2,278.2,278.35,-2.15,-2,6,167.01,84
,20170511,278.2,278.35,279.05,279.05,278.6,278.6,278.75,.25,.4,6,167.25,82
,20170512,278.6,278.75,,,,278.75,278.75,0,0,0,0.00,82
,20170515,278.75,278.75,280.55,280.55,280.55,280.55,280.55,1.8,1.8,2,56.11,84
,20170516,280.55,280.55,,,,280.55,280.55,0,0,0,0.00,84
,20170517,280.55,280.55,282.5,282.5,282.45,282.45,282.45,1.9,1.9,4,112.99,82
,20170518,282.45,282.45,284.7,286.25,284.7,285.5,285.35,3.05,2.9,34,970.35,70
,20170519,285.5,285.35,285.15,285.15,283.85,283.85,284.4,-1.5,-.95,8,227.54,66
,20170522,283.85,284.4,284.55,284.75,284.55,284.6,284.6,.2,.2,8,227.69,62
,20170523,284.6,284.6,284.05,286.7,284.05,286.7,285.1,2.1,.5,22,627.28,64
,20170524,286.7,285.1,286.75,286.75,286.75,286.75,286.75,1.65,1.65,8,229.40,72
,20170525,286.75,286.75,285.55,285.55,284.55,284.55,285.1,-2.2,-1.65,6,171.08,72
,20170526,284.55,285.1,,,,285.1,285.1,0,0,0,0.00,72
,20170531,285.1,285.1,283.85,283.85,283.85,283.85,283.85,-1.25,-1.25,2,56.77,74
,20170601,283.85,283.85,284.7,284.7,283.55,283.55,284.2,-.3,.35,10,284.20,78
,20170602,283.55,284.2,282.9,282.9,282.9,282.9,282.9,-1.3,-1.3,4,113.16,78
,20170605,282.9,282.9,284.7,286.2,284.7,286.1,285.25,3.2,2.35,26,741.77,76
,20170606,286.1,285.25,287.3,287.75,287.3,287.75,287.5,2.5,2.25,8,230.02,78
,20170607,287.75,287.5,288.75,288.75,288.15,288.15,288.45,.65,.95,4,115.38,78
,20170608,288.15,288.45,287.95,287.95,286.7,286.7,286.95,-1.75,-1.5,18,516.58,86
,20170609,286.7,286.95,286.75,286.75,284.5,284.5,285.8,-2.45,-1.15,10,285.80,84
,20170612,284.5,285.8,283.05,283.05,282.55,282.55,282.65,-3.25,-3.15,16,452.29,90
,20170613,282.55,282.65,282.5,282.5,282.5,282.5,282.5,-.15,-.15,12,339.00,98
,20170614,282.5,282.5,282.1,282.1,282.1,282.1,282.1,-.4,-.4,2,56.42,98
,20170615,282.1,282.1,285.85,285.85,281.4,281.4,283.25,-.7,1.15,20,566.52,100
,20170616,281.4,283.25,280.05,280.05,280.05,280.05,280.05,-3.2,-3.2,2,56.01,98
,20170619,280.05,280.05,280.75,280.75,280.75,280.75,280.75,.7,.7,2,56.15,98
,20170620,280.75,280.75,279.9,280.2,279.6,280.2,279.85,-.55,-.9,18,503.73,100
,20170621,280.2,279.85,,,,279.85,279.85,0,0,0,0.00,100
,20170622,279.85,279.85,281.8,281.8,281.8,281.8,281.8,1.95,1.95,2,56.36,100
,20170623,281.8,281.8,,,,281.8,281.8,0,0,0,0.00,100
,20170626,281.8,281.8,,,,281.8,281.8,0,0,0,0.00,100
,20170627,281.8,281.8,280.5,280.5,280.5,280.5,280.5,-1.3,-1.3,2,56.10,100
,20170628,280.5,280.5,280.35,280.35,280.35,280.35,280.35,-.15,-.15,2,56.07,98
,20170629,280.35,280.35,280.25,280.25,279.8,280.05,280,-.3,-.35,14,392.06,104
,20170630,280.05,280,,,,280,280,0,0,0,0.00,104
,20170703,280,280,,,,280,280,0,0,0,0.00,104
,20170704,280,280,275.05,275.05,274.3,274.3,274.6,-5.7,-5.4,34,933.67,118
,20170705,274.3,274.6,274.3,275.45,273.85,274.25,274.55,-.35,-.05,16,439.31,114
,20170706,274.25,274.55,274.65,274.65,274.65,274.65,274.65,.1,.1,2,54.93,112
,20170707,274.65,274.65,274.05,274.05,274.05,274.05,274.05,-.6,-.6,2,54.81,114
,20170710,274.05,274.05,270.65,270.65,269.65,270,270.05,-4.05,-4,42,"1,134.36",138
,20170711,270,270.05,270.85,271.65,270.6,271.65,271.1,1.6,1.05,12,325.36,134
,20170712,271.65,271.1,,,,271.1,271.1,0,0,0,0.00,134
,20170713,271.1,271.1,273.25,273.25,273.25,273.25,273.25,2.15,2.15,2,54.65,134
,20170714,273.25,273.25,272.5,272.5,271.8,271.9,272.2,-1.35,-1.05,12,326.66,132
,20170717,271.9,272.2,274.25,274.4,273.65,274.3,273.9,2.1,1.7,22,602.66,124
,20170718,274.3,273.9,275.05,275.05,274.95,274.95,275,1.05,1.1,6,165.01,120
,20170719,274.95,275,275.6,275.6,275.6,275.6,275.6,.6,.6,2,55.12,118
,20170720,275.6,275.6,274.8,274.8,274.8,274.8,274.8,-.8,-.8,2,54.96,120
,20170721,274.8,274.8,276,277.05,276,277.05,276.6,2.25,1.8,16,442.59,122
,20170724,277.05,276.6,277.55,277.55,277.55,277.55,277.55,.95,.95,2,55.51,120
,20170725,277.55,277.55,277.5,277.5,277.5,277.5,277.5,-.05,-.05,2,55.50,118
,20170726,277.5,277.5,277.45,277.45,275.6,275.6,275.85,-1.9,-1.65,60,"1,655.14",148
,20170727,275.6,275.85,276.3,278.55,276.3,278.55,277.05,2.7,1.2,6,166.23,146
,20170728,278.55,277.05,277.7,278.4,276.35,278.15,277.75,1.1,.7,32,888.90,142
,20170731,278.15,277.75,282.8,282.8,278.55,278.9,279.85,1.15,2.1,8,223.90,142
,20170801,278.9,279.85,278.85,279.25,278.85,279.25,278.95,-.6,-.9,16,446.39,142
,20170802,279.25,278.95,279.05,279.55,278.7,278.7,279,-.25,.05,8,223.23,142
,20170803,278.7,279,278.2,278.35,277.85,278.25,278.05,-.75,-.95,14,389.32,142
,20170804,278.25,278.05,278.45,278.45,278.45,278.45,278.45,.4,.4,2,55.69,142
,20170807,278.45,278.45,277.1,277.1,276.75,276.75,276.9,-1.7,-1.55,4,110.77,140
,20170808,276.75,276.9,277,277,276.95,276.95,276.95,.05,.05,4,110.79,142
,20170809,276.95,276.95,276.3,277,275.2,277,276.15,.05,-.8,6,165.70,144
,20170810,277,276.15,278.5,278.5,278.5,278.5,278.5,2.35,2.35,2,55.70,144
,20170811,278.5,278.5,280.8,280.8,280.5,280.7,280.55,2.2,2.05,16,448.91,142
,20170814,280.7,280.55,280.2,280.8,280.2,280.5,280.35,-.05,-.2,12,336.46,146
,20170815,280.5,280.35,280,280.25,278.75,278.75,279.6,-1.6,-.75,12,335.56,144
,20170816,278.75,279.6,,,,279.6,279.6,0,0,0,0.00,144
,20170817,279.6,279.6,280.8,281.25,280.55,280.55,280.9,.95,1.3,8,224.73,144
,20170818,280.55,280.9,280.75,281,280.75,281,280.8,.1,-.1,6,168.50,148
,20170821,281,280.8,282.9,283.3,280.1,280.35,281.85,-.45,1.05,12,338.27,144
,20170822,280.35,281.85,280.9,282.75,280.25,280.25,281.95,-1.6,.1,82,"2,312.03",154
,20170823,280.25,281.95,279.9,280.3,279.55,280.3,279.85,-1.65,-2.1,12,335.84,150
,20170824,280.3,279.85,280.25,280.5,280.25,280.5,280.35,.65,.5,12,336.44,150
,20170825,280.5,280.35,279.75,279.75,279.75,279.75,279.75,-.6,-.6,2,55.95,150
,20170828,279.75,279.75,281.05,281.05,278.2,280.8,279.9,1.05,.15,30,839.70,146
,20170829,280.8,279.9,282.8,284.75,282.8,284.75,283.95,4.85,4.05,6,170.38,146
,20170830,284.75,283.95,284.8,284.9,280.85,281.45,283.5,-2.5,-.45,46,"1,304.22",154
,20170831,281.45,283.5,280.95,280.95,280.3,280.35,280.6,-3.15,-2.9,16,448.96,150
,20170901,280.35,280.6,282.85,282.85,282.85,282.85,282.85,2.25,2.25,2,56.57,150
,20170904,282.85,282.85,282.4,285.7,282.4,285.3,284.1,2.45,1.25,12,340.97,148
,20170905,285.3,284.1,284.05,284.4,284.05,284.4,284.2,.3,.1,4,113.69,152
,20170906,284.4,284.2,284.05,285,283.95,284.55,284.6,.35,.4,24,683.15,158
,20170907,284.55,284.6,284.5,284.5,284.5,284.5,284.5,-.1,-.1,2,56.90,156
,20170908,284.5,284.5,284.75,284.75,284.75,284.75,284.75,.25,.25,6,170.85,150
,20170911,284.75,284.75,283.9,283.9,283.2,283.4,283.45,-1.35,-1.3,8,226.78,146
,20170912,283.4,283.45,283.15,283.15,282.15,282.4,282.7,-1.05,-.75,8,226.16,150
,20170913,282.4,282.7,,,,282.7,282.7,0,0,0,0.00,150
,20170914,282.7,282.7,282.8,283.45,281.5,281.95,282.15,-.75,-.55,12,338.62,150
,20170915,281.95,282.15,,,,282.15,282.15,0,0,0,0.00,150
,20170918,282.15,282.15,282.25,282.55,281.25,281.25,282.1,-.9,-.05,18,507.81,142
,20170919,281.25,282.1,280.35,280.8,280.35,280.8,280.55,-1.3,-1.55,6,168.33,138
,20170920,280.8,280.55,280,282.2,280,281.3,280.75,.75,.2,42,"1,179.33",142
,20170921,281.3,280.75,281.45,281.45,278.25,278.25,280.1,-2.5,-.65,18,504.24,138
,20170922,278.25,280.1,277.95,278.6,277.75,278.55,278.2,-1.55,-1.9,8,222.57,134
,20170925,278.55,278.2,278.3,278.35,278.3,278.35,278.3,.15,.1,4,111.33,132
,20170926,278.35,278.3,281.8,282.1,281.8,282.1,282,3.8,3.7,6,169.20,136
,20170927,282.1,282,281.4,282,280.6,280.6,281.4,-1.4,-.6,42,"1,182.00",152
,20170928,280.6,281.4,279.8,279.8,278.4,279,279.15,-2.4,-2.25,30,837.57,144
,20170929,279,279.15,279.25,280.2,279.25,280,279.85,.85,.7,8,223.89,144
,20171009,280,279.85,277.25,278.9,277.25,278.9,277.8,-.95,-2.05,6,166.69,142
,20171010,278.9,277.8,278.1,278.25,278.1,278.25,278.15,.45,.35,8,222.52,148
,20171011,278.25,278.15,278,278,277.4,277.4,277.55,-.75,-.6,22,610.67,168
,20171012,277.4,277.55,277.65,278.45,277.6,278.45,278.05,.9,.5,28,778.56,184
,20171013,278.45,278.05,277.75,278.2,277.75,278.2,277.95,.15,-.1,8,222.38,186
,20171016,278.2,277.95,278.65,279.25,278.5,279.15,278.9,1.2,.95,26,725.26,198
,20171017,279.15,278.9,279.35,279.35,277.95,278.15,278.35,-.75,-.55,8,222.71,198
,20171018,278.15,278.35,277.85,277.9,277.4,277.45,277.6,-.9,-.75,54,"1,499.20",164
,20171019,277.45,277.6,277,277.25,276.8,276.8,277,-.8,-.6,18,498.68,162
,20171020,276.8,277,277.35,277.35,277.35,277.35,277.35,.35,.35,6,166.41,166
,20171023,277.35,277.35,276.85,277.15,276.1,276.1,276.9,-1.25,-.45,18,498.46,178
,20171024,276.1,276.9,276.1,277.15,276.1,277.15,276.6,.25,-.3,4,110.65,178
,20171025,277.15,276.6,276.1,276.1,276.1,276.1,276.1,-.5,-.5,6,165.66,178
,20171026,276.1,276.1,276.75,276.9,276.5,276.85,276.7,.75,.6,34,940.81,194
,20171027,276.85,276.7,276.15,276.15,275.3,275.6,275.5,-1.1,-1.2,56,"1,543.00",180
,20171030,275.6,275.5,275.45,276.15,275.45,275.6,275.85,.1,.35,28,772.51,190
,20171031,275.6,275.85,276.2,276.5,275.8,276.45,276.3,.6,.45,34,939.45,212
,20171101,276.45,276.3,275.75,275.9,275.25,275.9,275.65,-.4,-.65,60,"1,654.19",224
,20171102,275.9,275.65,275.55,276,275.45,275.65,275.65,0,0,20,551.36,222
,20171103,275.65,275.65,276,276.45,275.65,276,276.2,.35,.55,52,"1,436.29",226
,20171106,276,276.2,276.35,276.55,275.35,275.75,275.95,-.45,-.25,68,"1,876.75",220
,20171107,275.75,275.95,275.8,277.05,275.5,276.6,276.45,.65,.5,46,"1,271.80",224
,20171108,276.6,276.45,277.3,277.75,275.9,277.1,276.9,.65,.45,48,"1,329.20",226
,20171109,277.1,276.9,277.45,279.25,277.3,278.25,278.1,1.35,1.2,84,"2,336.13",228
,20171110,278.25,278.1,278.9,279.1,278.55,278.85,278.85,.75,.75,72,"2,007.80",216
,20171113,278.85,278.85,278.9,278.9,277.45,277.5,278.4,-1.35,-.45,136,"3,786.69",238
,20171114,277.5,278.4,277.5,277.9,277.25,277.3,277.45,-1.1,-.95,26,721.39,234
,20171115,277.3,277.45,276.9,278.1,276.9,277.9,277.6,.45,.15,14,388.67,236
,20171116,277.9,277.6,278.05,278.1,277,277,277.95,-.6,.35,38,"1,056.21",240
,20171117,277,277.95,277.3,278.1,277.3,278,277.85,.05,-.1,12,333.42,240
,20171120,278,277.85,277.95,279.8,277.95,278.65,279.15,.8,1.3,40,"1,116.60",230
,20171121,278.65,279.15,278.95,278.95,277.2,277.95,278,-1.2,-1.15,42,"1,167.61",244
,20171122,277.95,278,277.2,278.2,277.2,277.6,277.65,-.4,-.35,18,499.79,242
,20171123,277.6,277.65,277.9,278.35,277.75,277.75,278.05,.1,.4,52,"1,445.86",236
,20171124,277.75,278.05,277.65,278.15,277.65,278.15,277.95,.1,-.1,12,333.55,242
,20171127,278.15,277.95,277.9,278.05,277.5,277.9,277.8,-.05,-.15,30,833.46,236
,20171128,277.9,277.8,278.6,279.15,278.4,278.7,278.65,.9,.85,116,"3,232.76",232
,20171129,278.7,278.65,278.75,278.75,278.05,278.6,278.6,-.05,-.05,62,"1,727.57",190
,20171130,278.6,278.6,278.6,278.6,276.7,276.7,277.6,-1.9,-1,44,"1,221.44",192
,20171201,276.7,277.6,276.5,276.5,275.35,275.4,275.8,-2.2,-1.8,56,"1,544.55",194
,20171204,275.4,275.8,274.9,276.95,274.5,274.85,275.35,-.95,-.45,56,"1,542.22",202
,20171205,274.85,275.35,275,275.7,274.9,275.1,275.3,-.25,-.05,42,"1,156.39",202
,20171206,275.1,275.3,273.5,273.85,273.25,273.25,273.45,-2.05,-1.85,20,546.96,200
,20171207,273.25,273.45,273.35,273.4,271.3,271.7,272.4,-1.75,-1.05,12,326.90,206
,20171208,271.7,272.4,271.55,271.55,270.05,270.15,270.8,-2.25,-1.6,22,595.80,206
,20171211,270.15,270.8,270.4,270.4,269.2,269.25,269.5,-1.55,-1.3,152,"4,096.89",326
,20171212,269.25,269.5,269.6,269.6,267.3,268.45,268.65,-1.05,-.85,162,"4,352.16",324
,20171213,268.45,268.65,268.55,269.5,268.55,269.05,269.1,.4,.45,44,"1,184.04",302
,20171214,269.05,269.1,269.25,271.4,269.25,270.4,270.6,1.3,1.5,208,"5,629.18",314
,20171215,270.4,270.6,270.75,270.75,270.1,270.45,270.3,-.15,-.3,40,"1,081.21",312
,20171218,270.45,270.3,270.95,271.15,269.7,270.1,270.65,-.2,.35,158,"4,276.79",276
,20171219,270.1,270.65,270.75,271.55,270.5,271.5,271,.85,.35,54,"1,463.45",272
,20171220,271.5,271,270.55,271.35,270.45,270.8,270.85,-.2,-.15,70,"1,896.20",278
,20171221,270.8,270.85,270.8,271,270.35,270.35,270.55,-.5,-.3,20,541.19,280
,20171222,270.35,270.55,270.4,271,270.3,270.65,270.6,.1,.05,24,649.50,278
,20171225,270.65,270.6,270.95,272.75,270.95,272.75,271.8,2.15,1.2,24,652.32,272
,20171226,272.75,271.8,272.1,272.2,271.9,272.1,272.1,.3,.3,16,435.38,266
,20171227,272.1,272.1,272.25,272.9,272.25,272.65,272.5,.55,.4,18,490.58,260
,20171228,272.65,272.5,273.55,274.45,273.45,274.25,273.9,1.75,1.4,36,986.17,268
,20171229,274.25,273.9,270.55,274,270.55,274,273.25,.1,-.65,12,327.92,270
au1803,20171218,270.3,270.3,,,,270.3,270.3,0,0,0,0.00,0
,20171219,270.3,270.3,,,,270.3,270.3,0,0,0,0.00,0
,20171220,270.3,270.3,,,,270.3,270.3,0,0,0,0.00,0
,20171221,270.3,270.3,,,,270.3,270.3,0,0,0,0.00,0
,20171222,270.3,270.3,,,,270.3,270.3,0,0,0,0.00,0
,20171225,270.3,270.3,,,,270.75,270.75,.45,.45,0,0.00,0
,20171226,270.75,270.75,,,,270.75,270.75,0,0,0,0.00,0
,20171227,270.75,270.75,,,,270.75,270.75,0,0,0,0.00,0
,20171228,270.75,270.75,,,,272.25,272.25,1.5,1.5,0,0.00,0
,20171229,272.25,272.25,,,,272.35,272.35,.1,.1,0,0.00,0
au1804,20170316,277.6,277.6,276.65,280.95,276.65,280.95,278.8,3.35,1.2,4,111.52,4
,20170317,280.95,278.8,282,282,281.6,281.6,281.8,2.8,3,4,112.72,8
,20170320,281.6,281.8,,,,282.9,282.9,1.1,1.1,0,0.00,8
,20170321,282.9,282.9,,,,281.9,281.9,-1,-1,0,0.00,8
,20170322,281.9,281.9,,,,283.7,283.7,1.8,1.8,0,0.00,8
,20170323,283.7,283.7,,,,283.7,283.7,0,0,0,0.00,8
,20170324,283.7,283.7,,,,283.7,283.7,0,0,0,0.00,8
,20170327,283.7,283.7,282.45,286.05,282.45,284.9,284.55,1.2,.85,36,"1,024.41",24
,20170328,284.9,284.55,288.15,288.15,286.6,286.6,287.35,2.05,2.8,4,114.95,22
,20170329,286.6,287.35,,,,287.35,287.35,0,0,0,0.00,22
,20170330,287.35,287.35,,,,287.35,287.35,0,0,0,0.00,22
,20170331,287.35,287.35,284.05,284.05,284.05,284.05,284.05,-3.3,-3.3,2,56.81,22
,20170405,284.05,284.05,287.8,287.8,286.55,286.55,287.15,2.5,3.1,4,114.87,22
,20170406,286.55,287.15,,,,287.15,287.15,0,0,0,0.00,22
,20170407,287.15,287.15,286.25,291.1,286.25,290.1,289.15,2.95,2,6,173.49,24
,20170410,290.1,289.15,288.3,288.3,287.5,287.5,287.95,-1.65,-1.2,6,172.78,26
,20170411,287.5,287.95,,,,287.95,287.95,0,0,0,0.00,26
,20170412,287.95,287.95,290.25,292.85,289.8,291.1,291.05,3.15,3.1,16,465.74,22
,20170413,291.1,291.05,292.95,292.95,292.45,292.45,292.75,1.4,1.7,6,175.67,28
,20170414,292.45,292.75,293.8,293.8,291.95,291.95,292.85,-.8,.1,4,117.15,28
,20170417,291.95,292.85,294.05,294.05,292.3,292.7,293.25,-.15,.4,14,410.60,36
,20170418,292.7,293.25,291.3,291.8,291.3,291.8,291.65,-1.45,-1.6,8,233.34,36
,20170419,291.8,291.65,291.35,291.85,291,291.85,291.45,.2,-.2,26,757.84,56
,20170420,291.85,291.45,291,291,289.9,290.85,290.25,-.6,-1.2,22,638.58,68
,20170421,290.85,290.25,290.25,290.25,290.25,290.25,290.25,0,0,6,174.15,62
,20170424,290.25,290.25,290.7,290.7,288.55,288.55,289.4,-1.7,-.85,6,173.64,62
,20170425,288.55,289.4,287.9,288.85,287.9,288.1,288.2,-1.3,-1.2,14,403.48,62
,20170426,288.1,288.2,287.75,287.75,286.7,286.7,287.3,-1.5,-.9,12,344.80,62
,20170427,286.7,287.3,286.7,287.8,286.7,287.8,287.45,.5,.15,18,517.43,56
,20170428,287.8,287.45,288.05,288.35,288.05,288.35,288.15,.9,.7,6,172.90,60
,20170502,288.35,288.15,286.2,286.25,286.2,286.25,286.2,-1.9,-1.95,4,114.49,58
,20170503,286.25,286.2,285.65,286.3,285.1,285.65,285.75,-.55,-.45,56,"1,600.30",62
,20170504,285.65,285.75,285.4,285.4,284.8,284.8,285.15,-.95,-.6,14,399.24,60
,20170505,284.8,285.15,280.25,282.05,280,281.6,280.7,-3.55,-4.45,44,"1,235.26",70
,20170508,281.6,280.7,280.9,281.55,280.9,281.55,281.2,.85,.5,8,224.97,68
,20170509,281.55,281.2,282,282,280.45,280.8,281.3,-.4,.1,16,450.13,72
,20170510,280.8,281.3,279.75,280.15,278.65,279.7,279.4,-1.6,-1.9,24,670.66,76
,20170511,279.7,279.4,,,,279.4,279.4,0,0,0,0.00,76
,20170512,279.4,279.4,279.65,281.1,279.65,280.9,280.6,1.5,1.2,8,224.49,78
,20170515,280.9,280.6,,,,280.6,280.6,0,0,0,0.00,78
,20170516,280.6,280.6,282.85,282.85,282.2,282.2,282.55,1.6,1.95,6,169.53,78
,20170517,282.2,282.55,283.15,283.15,283.15,283.15,283.15,.6,.6,6,169.89,74
,20170518,283.15,283.15,286.4,286.65,286.3,286.65,286.5,3.5,3.35,14,401.15,78
,20170519,286.65,286.5,286.8,286.85,285.8,285.8,285.95,-.7,-.55,32,915.11,96
,20170522,285.8,285.95,285.1,285.5,285.1,285.5,285.3,-.45,-.65,4,114.12,96
,20170523,285.5,285.3,287.1,287.1,287.1,287.1,287.1,1.8,1.8,4,114.84,100
,20170524,287.1,287.1,286.65,286.65,285.05,285.05,286.1,-2.05,-1,8,228.90,100
,20170525,285.05,286.1,286.1,286.7,286.1,286.7,286.4,.6,.3,4,114.56,98
,20170526,286.7,286.4,,,,286.4,286.4,0,0,0,0.00,98
,20170531,286.4,286.4,,,,286.4,286.4,0,0,0,0.00,98
,20170601,286.4,286.4,285.15,285.15,284.3,284.3,284.8,-2.1,-1.6,10,284.81,98
,20170602,284.3,284.8,,,,284.8,284.8,0,0,0,0.00,98
,20170605,284.8,284.8,287.45,287.45,286.95,287.35,287.25,2.55,2.45,10,287.26,100
,20170606,287.35,287.25,,,,287.25,287.25,0,0,0,0.00,100
,20170607,287.25,287.25,289.7,289.7,288.6,289.3,289.4,2.05,2.15,42,"1,215.54",72
,20170608,289.3,289.4,288.85,288.85,287.85,287.85,288.4,-1.55,-1,16,461.51,68
,20170609,287.85,288.4,286.55,286.55,286.2,286.2,286.5,-2.2,-1.9,18,515.72,80
,20170612,286.2,286.5,283.8,284,283.6,284,283.75,-2.5,-2.75,10,283.76,82
,20170613,284,283.75,,,,283.75,283.75,0,0,0,0.00,82
,20170614,283.75,283.75,,,,283.75,283.75,0,0,0,0.00,82
,20170615,283.75,283.75,286.55,286.55,282.75,282.75,284.55,-1,.8,10,284.55,84
,20170616,282.75,284.55,,,,284.55,284.55,0,0,0,0.00,84
,20170619,284.55,284.55,281.25,281.75,281.25,281.75,281.55,-2.8,-3,6,168.95,84
,20170620,281.75,281.55,,,,281.55,281.55,0,0,0,0.00,84
,20170621,281.55,281.55,,,,281.55,281.55,0,0,0,0.00,84
,20170622,281.55,281.55,,,,281.55,281.55,0,0,0,0.00,84
,20170623,281.55,281.55,,,,282.4,282.4,.85,.85,0,0.00,84
,20170626,282.4,282.4,,,,282.4,282.4,0,0,0,0.00,84
,20170627,282.4,282.4,,,,282.4,282.4,0,0,0,0.00,84
,20170628,282.4,282.4,281.45,281.45,281.45,281.45,281.45,-.95,-.95,2,56.29,82
,20170629,281.45,281.45,281.15,281.15,280.9,280.9,281.05,-.55,-.4,6,168.64,80
,20170630,280.9,281.05,,,,278.85,278.85,-2.2,-2.2,0,0.00,80
,20170703,278.85,278.85,278.85,278.85,276.75,277.25,277.1,-1.6,-1.75,18,498.78,82
,20170704,277.25,277.1,275.05,275.05,274.5,274.5,274.75,-2.6,-2.35,8,219.82,84
,20170705,274.5,274.75,275.75,275.75,274.95,274.95,275.3,.2,.55,10,275.32,82
,20170706,274.95,275.3,273.9,275.4,273.9,275.4,274.6,.1,-.7,10,274.61,84
,20170707,275.4,274.6,275.75,275.75,275.75,275.75,275.75,1.15,1.15,2,55.15,86
,20170710,275.75,275.75,272.05,272.05,271.7,271.7,271.8,-4.05,-3.95,6,163.09,86
,20170711,271.7,271.8,272,272.95,272,272.95,272.65,1.15,.85,8,218.13,80
,20170712,272.95,272.65,,,,272.65,272.65,0,0,0,0.00,80
,20170713,272.65,272.65,,,,274.8,274.8,2.15,2.15,0,0.00,80
,20170714,274.8,274.8,273.5,273.5,273.5,273.5,273.5,-1.3,-1.3,2,54.70,80
,20170717,273.5,273.5,275.4,275.5,275.4,275.5,275.45,2,1.95,4,110.18,78
,20170718,275.5,275.45,,,,275.45,275.45,0,0,0,0.00,78
,20170719,275.45,275.45,,,,275.45,275.45,0,0,0,0.00,78
,20170720,275.45,275.45,,,,275.45,275.45,0,0,0,0.00,78
,20170721,275.45,275.45,278.25,278.25,277.5,278.1,277.95,2.65,2.5,6,166.77,78
,20170724,278.1,277.95,,,,277.95,277.95,0,0,0,0.00,78
,20170725,277.95,277.95,278.85,279.45,278.85,279.45,279.15,1.5,1.2,8,223.32,80
,20170726,279.45,279.15,277.8,278.4,277.8,277.8,278.05,-1.35,-1.1,12,333.66,86
,20170727,277.8,278.05,277.85,280.75,277.85,280.75,278.6,2.7,.55,8,222.88,86
,20170728,280.75,278.6,279.95,279.95,279.95,279.95,279.95,1.35,1.35,4,111.98,84
,20170731,279.95,279.95,,,,279.95,279.95,0,0,0,0.00,84
,20170801,279.95,279.95,,,,279.95,279.95,0,0,0,0.00,84
,20170802,279.95,279.95,,,,279.95,279.95,0,0,0,0.00,84
,20170803,279.95,279.95,,,,279.95,279.95,0,0,0,0.00,84
,20170804,279.95,279.95,,,,279.95,279.95,0,0,0,0.00,84
,20170807,279.95,279.95,278.25,278.9,278.25,278.9,278.45,-1.05,-1.5,6,167.08,86
,20170808,278.9,278.45,,,,278.45,278.45,0,0,0,0.00,86
,20170809,278.45,278.45,277.4,279.35,277.4,278.95,278.8,.5,.35,32,892.24,94
,20170810,278.95,278.8,280.95,280.95,280.4,280.4,280.65,1.6,1.85,16,449.07,84
,20170811,280.4,280.65,282.05,282.5,282.05,282.5,282.25,1.85,1.6,4,112.91,88
,20170814,282.5,282.25,282,283.65,282,283.65,282.4,1.4,.15,8,225.93,90
,20170815,283.65,282.4,280.5,280.5,280,280,280.25,-2.4,-2.15,4,112.10,92
,20170816,280,280.25,280.3,280.35,280.1,280.1,280.25,-.15,0,10,280.29,94
,20170817,280.1,280.25,280.25,283.3,280,283.3,280.7,3.05,.45,10,280.71,92
,20170818,283.3,280.7,,,,280.7,280.7,0,0,0,0.00,92
,20170821,280.7,280.7,282.65,282.65,282.65,282.65,282.65,1.95,1.95,2,56.53,94
,20170822,282.65,282.65,,,,282.65,282.65,0,0,0,0.00,94
,20170823,282.65,282.65,281.9,282.2,281.5,281.7,281.7,-.95,-.95,14,394.43,92
,20170824,281.7,281.7,282.6,282.6,282.6,282.6,282.6,.9,.9,2,56.52,92
,20170825,282.6,282.6,,,,282.6,282.6,0,0,0,0.00,92
,20170828,282.6,282.6,,,,282.6,282.6,0,0,0,0.00,92
,20170829,282.6,282.6,286,286,286,286,286,3.4,3.4,4,114.40,88
,20170830,286,286,,,,286,286,0,0,0,0.00,88
,20170831,286,286,,,,283.05,283.05,-2.95,-2.95,0,0.00,88
,20170901,283.05,283.05,,,,283.05,283.05,0,0,0,0.00,88
,20170904,283.05,283.05,,,,284.3,284.3,1.25,1.25,0,0.00,88
,20170905,284.3,284.3,286,286.2,286,286.2,286.1,1.9,1.8,6,171.68,92
,20170906,286.2,286.1,286.55,286.55,286.55,286.55,286.55,.45,.45,2,57.31,94
,20170907,286.55,286.55,,,,286.55,286.55,0,0,0,0.00,94
,20170908,286.55,286.55,286.65,286.65,286.65,286.65,286.65,.1,.1,4,114.66,94
,20170911,286.65,286.65,286.05,286.05,286.05,286.05,286.05,-.6,-.6,2,57.21,96
,20170912,286.05,286.05,,,,285.25,285.25,-.8,-.8,0,0.00,96
,20170913,285.25,285.25,,,,285.25,285.25,0,0,0,0.00,96
,20170914,285.25,285.25,283.75,283.75,283.75,283.75,283.75,-1.5,-1.5,2,56.75,94
,20170915,283.75,283.75,,,,283.75,283.75,0,0,0,0.00,94
,20170918,283.75,283.75,296.55,296.55,283.75,284.45,287.35,.7,3.6,8,229.88,94
,20170919,284.45,287.35,282.85,282.85,282.75,282.75,282.8,-4.6,-4.55,4,113.12,92
,20170920,282.75,282.8,283.4,283.4,283.4,283.4,283.4,.6,.6,2,56.68,92
,20170921,283.4,283.4,284.4,284.4,280.75,280.75,282.2,-2.65,-1.2,24,677.38,94
,20170922,280.75,282.2,280.25,280.25,280.25,280.25,280.25,-1.95,-1.95,2,56.05,94
,20170925,280.25,280.25,280.3,280.3,280.3,280.3,280.3,.05,.05,6,168.18,92
,20170926,280.3,280.3,281.1,284.75,281.1,284.75,284,4.45,3.7,16,454.43,94
,20170927,284.75,284,283.9,284.5,282.55,282.55,283.65,-1.45,-.35,22,624.05,98
,20170928,282.55,283.65,280.9,280.9,280.9,280.9,280.9,-2.75,-2.75,2,56.18,98
,20170929,280.9,280.9,,,,280.9,280.9,0,0,0,0.00,98
,20171009,280.9,280.9,280,280.85,279.9,279.9,280.15,-1,-.75,8,224.13,102
,20171010,279.9,280.15,,,,280.15,280.15,0,0,0,0.00,102
,20171011,280.15,280.15,280,280,279.5,279.5,279.75,-.65,-.4,4,111.90,102
,20171012,279.5,279.75,279.2,280.3,279.2,280.3,279.75,.55,0,4,111.90,102
,20171013,280.3,279.75,,,,279.75,279.75,0,0,0,0.00,102
,20171016,279.75,279.75,281.35,281.7,281.2,281.5,281.4,1.75,1.65,8,225.15,100
,20171017,281.5,281.4,281.8,281.8,280.8,280.8,281.3,-.6,-.1,4,112.52,98
,20171018,280.8,281.3,279.8,279.8,279.75,279.75,279.75,-1.55,-1.55,4,111.91,98
,20171019,279.75,279.75,279.25,279.25,278.4,278.8,278.85,-.95,-.9,20,557.70,108
,20171020,278.8,278.85,279.05,279.05,279.05,279.05,279.05,.2,.2,2,55.81,108
,20171023,279.05,279.05,,,,279.05,279.05,0,0,0,0.00,108
,20171024,279.05,279.05,277.95,279.6,277.95,279.05,278.85,0,-.2,20,557.71,112
,20171025,279.05,278.85,279.1,279.1,278.1,278.1,278.3,-.75,-.55,10,278.32,114
,20171026,278.1,278.3,278.25,278.65,278.25,278.6,278.5,.3,.2,6,167.10,112
,20171027,278.6,278.5,,,,278.5,278.5,0,0,0,0.00,112
,20171030,278.5,278.5,277.85,277.85,277.45,277.45,277.65,-1.05,-.85,4,111.06,108
,20171031,277.45,277.65,278.1,278.6,278.1,278.6,278.3,.95,.65,12,333.96,106
,20171101,278.6,278.3,,,,278.3,278.3,0,0,0,0.00,106
,20171102,278.3,278.3,277.3,277.4,277,277.25,277.25,-1.05,-1.05,18,499.05,108
,20171103,277.25,277.25,,,,277.25,277.25,0,0,0,0.00,108
,20171106,277.25,277.25,,,,277.25,277.25,0,0,0,0.00,108
,20171107,277.25,277.25,,,,277.25,277.25,0,0,0,0.00,108
,20171108,277.25,277.25,,,,277.25,277.25,0,0,0,0.00,108
,20171109,277.25,277.25,,,,277.25,277.25,0,0,0,0.00,108
,20171110,277.25,277.25,,,,277.25,277.25,0,0,0,0.00,108
,20171113,277.25,277.25,,,,277.25,277.25,0,0,0,0.00,108
,20171114,277.25,277.25,279.35,279.35,279.05,279.05,279.2,1.8,1.95,4,111.68,104
,20171115,279.05,279.2,,,,279.2,279.2,0,0,0,0.00,104
,20171116,279.2,279.2,,,,279.2,279.2,0,0,0,0.00,104
,20171117,279.2,279.2,279.7,279.85,279.55,279.8,279.75,.6,.55,20,559.54,110
,20171120,279.8,279.75,279.8,281.5,279.8,281.15,280.65,1.4,.9,24,673.56,102
,20171121,281.15,280.65,,,,280.65,280.65,0,0,0,0.00,102
,20171122,280.65,280.65,280,280,279.1,279.3,279.2,-1.35,-1.45,22,614.31,96
,20171123,279.3,279.2,280.35,280.35,280.35,280.35,280.35,1.15,1.15,4,112.14,94
,20171124,280.35,280.35,279.95,279.95,279.95,279.95,279.95,-.4,-.4,4,111.98,96
,20171127,279.95,279.95,,,,279.95,279.95,0,0,0,0.00,96
,20171128,279.95,279.95,280.75,280.85,280.7,280.85,280.75,.9,.8,6,168.46,90
,20171129,280.85,280.75,281.2,281.6,281.2,281.6,281.45,.85,.7,6,168.88,88
,20171130,281.6,281.45,279,279,279,279,279,-2.45,-2.45,2,55.80,88
,20171201,279,279,,,,279,279,0,0,0,0.00,88
,20171204,279,279,279.25,279.25,279.25,279.25,279.25,.25,.25,2,55.85,88
,20171205,279.25,279.25,278.5,278.5,277.3,277.3,277.9,-1.95,-1.35,4,111.16,86
,20171206,277.3,277.9,275.45,275.45,275.45,275.45,275.45,-2.45,-2.45,2,55.09,88
,20171207,275.45,275.45,276,276.2,274.95,275.45,275.6,0,.15,44,"1,212.66",118
,20171208,275.45,275.6,273.35,274.8,272,272,273.75,-3.6,-1.85,18,492.78,122
,20171211,272,273.75,272,272.25,271,271,271.8,-2.75,-1.95,228,"6,198.11",266
,20171212,271,271.8,270.15,270.15,268.9,269.95,269.8,-1.85,-2,38,"1,025.30",264
,20171213,269.95,269.8,,,,269.8,269.8,0,0,0,0.00,264
,20171214,269.8,269.8,270.2,270.2,270.2,270.2,270.2,.4,.4,2,54.04,262
,20171215,270.2,270.2,272.1,272.15,272.1,272.15,272.1,1.95,1.9,6,163.28,262
,20171218,272.15,272.1,272.75,272.75,272.75,272.75,272.75,.65,.65,2,54.55,262
,20171219,272.75,272.75,,,,272.75,272.75,0,0,0,0.00,262
,20171220,272.75,272.75,,,,272.75,272.75,0,0,0,0.00,262
,20171221,272.75,272.75,,,,272.75,272.75,0,0,0,0.00,262
,20171222,272.75,272.75,,,,272.75,272.75,0,0,0,0.00,262
,20171225,272.75,272.75,,,,272.75,272.75,0,0,0,0.00,262
,20171226,272.75,272.75,274.05,274.05,274.05,274.05,274.05,1.3,1.3,2,54.81,262
,20171227,274.05,274.05,275.25,275.25,275.25,275.25,275.25,1.2,1.2,4,110.10,262
,20171228,275.25,275.25,275.45,276.15,275.45,276.15,275.7,.9,.45,6,165.42,258
,20171229,276.15,275.7,275.85,275.85,275.85,275.85,275.85,.15,.15,2,55.17,258
au1806,20170516,280.6,280.6,281.55,283.55,281.55,282.45,282.5,1.85,1.9,48,"1,356.05",8
,20170517,282.45,282.5,282.65,285.3,282.55,283.7,283.8,1.2,1.3,14,397.32,14
,20170518,283.7,283.8,285.8,287.1,285.8,287,286.7,3.2,2.9,22,630.75,28
,20170519,287,286.7,286.7,286.7,284.5,285.1,285.3,-1.6,-1.4,16,456.55,36
,20170522,285.1,285.3,285.85,287.5,285.3,285.95,285.9,.65,.6,30,857.83,38
,20170523,285.95,285.9,287.1,287.95,286.6,287.65,287.35,1.75,1.45,18,517.27,46
,20170524,287.65,287.35,287.4,287.4,284.6,284.6,285.6,-2.75,-1.75,42,"1,199.66",50
,20170525,284.6,285.6,284.85,286.55,284.75,286.2,285.95,.6,.35,16,457.53,60
,20170526,286.2,285.95,285.35,285.8,284.75,285.8,285.25,-.15,-.7,20,570.56,64
,20170531,285.8,285.25,285.9,285.9,284.8,284.8,285.1,-.45,-.15,30,855.34,80
,20170601,284.8,285.1,284.8,285.3,284.5,284.75,284.8,-.35,-.3,48,"1,367.13",96
,20170602,284.75,284.8,284.2,284.55,283.4,283.7,283.85,-1.1,-.95,52,"1,476.04",110
,20170605,283.7,283.85,285.4,287.8,285.4,287.2,286.75,3.35,2.9,78,"2,236.77",142
,20170606,287.2,286.75,287.2,289.25,287,289,288.35,2.25,1.6,130,"3,748.59",198
,20170607,289,288.35,289.5,290,289.15,289.3,289.55,.95,1.2,168,"4,864.80",310
,20170608,289.3,289.55,289.3,289.5,288.2,288.7,288.85,-.85,-.7,96,"2,772.99",318
,20170609,288.7,288.85,287.15,288.25,285.2,285.35,286.2,-3.5,-2.65,294,"8,415.63",436
,20170612,285.35,286.2,284.35,284.8,284,284.25,284.3,-1.95,-1.9,420,"11,940.95",726
,20170613,284.25,284.3,283.6,284.5,283.4,284.15,284,-.15,-.3,118,"3,351.78",800
,20170614,284.15,284,283.4,285.5,283.25,284.9,284.5,.9,.5,238,"6,772.03",948
,20170615,284.9,284.5,285.95,287.4,282.8,282.9,285.4,-1.6,.9,224,"6,394.02",974
,20170616,282.9,285.4,281.4,283.05,281.4,282.45,282.4,-2.95,-3,2366,"66,826.03",2252
,20170619,282.45,282.4,282.6,282.85,281.45,281.6,281.75,-.8,-.65,1990,"56,076.40",3340
,20170620,281.6,281.75,281.45,281.5,280.4,280.9,281,-.85,-.75,4408,"123,874.29",6810
,20170621,280.9,281,280.45,281.05,278.2,280.7,280.35,-.3,-.65,1196,"33,534.56",7580
,20170622,280.7,280.35,280.7,282.85,280,282.65,281.6,2.3,1.25,450,"12,672.79",7662
,20170623,282.65,281.6,282.75,283.2,281.9,283.15,282.6,1.55,1,266,"7,517.41",7676
,20170626,283.15,282.6,283.7,283.7,283.1,283.35,283.3,.75,.7,212,"6,006.62",7698
,20170627,283.35,283.3,281.85,282.05,280.7,282.05,281.2,-1.25,-2.1,730,"20,529.20",7822
,20170628,282.05,281.2,281.4,282,280.85,281.6,281.55,.4,.35,1002,"28,213.00",7922
,20170629,281.6,281.55,281.85,281.9,280.7,281.05,281.3,-.5,-.25,1142,"32,129.38",8282
,20170630,281.05,281.3,280.3,280.3,276.5,278.2,278.8,-3.1,-2.5,1812,"50,521.02",8798
,20170703,278.2,278.8,278.2,279,277.15,277.35,277.7,-1.45,-1.1,584,"16,218.79",8846
,20170704,277.35,277.7,276.85,276.85,274.5,275.4,275.2,-2.3,-2.5,880,"24,221.60",9046
,20170705,275.4,275.2,275.4,276.1,274.95,275.05,275.1,-.15,-.1,3090,"85,018.08",11342
,20170706,275.05,275.1,274.05,275.85,273.75,275.4,275.1,.3,0,1282,"35,268.68",11640
,20170707,275.4,275.1,275.4,275.85,274.4,274.85,274.9,-.25,-.2,718,"19,738.19",11664
,20170710,274.85,274.9,274.85,274.9,270.9,271.45,273.25,-3.45,-1.65,1980,"54,109.39",11850
,20170711,271.45,273.25,272.1,273.4,271.75,272.9,272.5,-.35,-.75,800,"21,802.68",12040
,20170712,272.9,272.5,272.9,274.35,272.2,273.65,273.7,1.15,1.2,734,"20,092.15",12062
,20170713,273.65,273.7,274.4,275.3,274,274.55,274.4,.85,.7,852,"23,382.31",12028
,20170714,274.55,274.4,274.2,274.2,272.75,273.4,273.45,-1,-.95,568,"15,533.01",12032
,20170717,273.4,273.45,275.15,276,275.15,275.75,275.75,2.3,2.3,880,"24,266.10",12054
,20170718,275.75,275.75,276.35,277,276.3,276.35,276.55,.6,.8,1150,"31,804.79",12242
,20170719,276.35,276.55,277,277.15,276.55,276.7,276.85,.15,.3,408,"11,296.80",12272
,20170720,276.7,276.85,277.35,277.35,276.7,277.1,276.9,.25,.05,470,"13,015.46",12394
,20170721,277.1,276.9,277.2,278.65,276.5,278.6,278.05,1.7,1.15,2092,"58,177.19",12192
,20170724,278.6,278.05,279.1,280.95,279,279.15,279.65,1.1,1.6,378,"10,572.05",12196
,20170725,279.15,279.65,280.1,280.1,279.1,279.75,279.5,.1,-.15,234,"6,540.43",12192
,20170726,279.75,279.5,278.9,279.4,276.95,277.3,277.5,-2.2,-2,1486,"41,238.00",12590
,20170727,277.3,277.5,277.5,280.95,277.5,280.4,280.05,2.9,2.55,754,"21,116.94",12692
,20170728,280.4,280.05,280.5,280.65,279.6,279.9,279.85,-.15,-.2,3220,"90,120.51",15010
,20170731,279.9,279.85,280.5,281.7,280.4,280.9,281,1.05,1.15,930,"26,137.32",15240
,20170801,280.9,281,280.75,281.25,280.55,280.95,281,-.05,0,686,"19,278.35",15076
,20170802,280.95,281,280.6,281.8,280.5,280.75,281.05,-.25,.05,636,"17,877.13",15156
,20170803,280.75,281.05,280.7,281.55,279.5,279.65,280.45,-1.4,-.6,844,"23,671.10",15318
,20170804,279.65,280.45,280.05,281.45,280.05,281.35,280.85,.9,.4,1220,"34,264.68",15918
,20170807,281.35,280.85,280,280.1,278.55,278.65,278.95,-2.2,-1.9,1064,"29,685.13",15880
,20170808,278.65,278.95,278.6,279.35,278.2,278.55,278.8,-.4,-.15,1184,"33,014.13",15726
,20170809,278.55,278.8,278.65,280,277.05,279.3,278.75,.5,-.05,1906,"53,134.90",16118
,20170810,279.3,278.75,280.6,281.7,280.25,281.4,280.85,2.65,2.1,2156,"60,561.32",16460
,20170811,281.4,280.85,282,283.15,281.9,282.9,282.65,2.05,1.8,2592,"73,268.53",17506
,20170814,282.9,282.65,283.1,283.25,281.6,282.85,282.55,.2,-.1,848,"23,960.94",17540
,20170815,282.85,282.55,281.8,282.6,280.2,280.85,281.1,-1.7,-1.45,1388,"39,020.95",17840
,20170816,280.85,281.1,279.95,280.65,279.4,280.05,280.25,-1.05,-.85,2948,"82,621.63",18228
,20170817,280.05,280.25,279.95,283.45,279.65,283.1,281.9,2.85,1.65,3862,"108,876.24",18966
,20170818,283.1,281.9,282.5,283.5,282.05,283.45,282.95,1.55,1.05,1546,"43,745.11",19050
,20170821,283.45,282.95,284.1,285.55,281.2,282.7,282.95,-.25,0,3184,"90,107.06",19870
,20170822,282.7,282.95,283,284,282.1,282.1,282.85,-.85,-.1,1754,"49,619.20",19514
,20170823,282.1,282.85,282.6,283.35,281.4,282.15,282.3,-.7,-.55,2168,"61,212.51",19628
,20170824,282.15,282.3,282.6,282.9,282.1,282.35,282.4,.05,.1,1418,"40,051.04",19954
,20170825,282.35,282.4,282.4,282.8,281.25,282.25,282.1,-.15,-.3,2574,"72,623.88",21224
,20170828,282.25,282.1,282.05,283.9,280.05,283.85,282.6,1.75,.5,3602,"101,803.29",21886
,20170829,283.85,282.6,283.55,287,283.05,286.9,285.45,4.3,2.85,3646,"104,090.40",22266
,20170830,286.9,285.45,287.45,287.45,283.45,283.5,285.35,-1.95,-.1,4032,"115,056.33",22394
,20170831,283.5,285.35,283.8,284.5,282.5,283.15,283.4,-2.2,-1.95,2346,"66,489.40",22822
,20170901,283.15,283.4,284.05,285.9,283.95,285.05,285.2,1.65,1.8,2066,"58,929.61",23256
,20170904,285.05,285.2,285.5,288,284.5,287.45,286.15,2.25,.95,5298,"151,611.12",23794
,20170905,287.45,286.15,286.75,287.35,286.2,287.1,286.8,.95,.65,2272,"65,169.79",24492
,20170906,287.1,286.8,286.4,287.75,286.25,287.45,287.2,.65,.4,3402,"97,716.56",25354
,20170907,287.45,287.2,287.15,287.45,285.8,286.6,286.45,-.6,-.75,4586,"131,376.73",27060
,20170908,286.6,286.45,287.15,287.3,286.2,287.2,286.85,.75,.4,5224,"149,862.38",26996
,20170911,287.2,286.85,286.85,287.25,285.35,285.95,286.35,-.9,-.5,3958,"113,341.24",27894
,20170912,285.95,286.35,285.8,286.15,284.35,284.45,285.05,-1.9,-1.3,3084,"87,918.91",28490
,20170913,284.45,285.05,284.75,285.45,284.55,284.9,285.05,-.15,0,2658,"75,774.85",29336
,20170914,284.9,285.05,285.45,285.5,284.05,284.45,284.6,-.6,-.45,3936,"112,025.27",30542
,20170915,284.45,284.6,284.45,286.4,284.45,285.85,285.85,1.25,1.25,4426,"126,535.09",32192
,20170918,285.85,285.85,285.2,285.4,283.3,283.3,284.4,-2.55,-1.45,3514,"99,951.49",32336
,20170919,283.3,284.4,282.95,283.85,282.5,283.55,283.4,-.85,-1,5570,"157,862.96",34950
,20170920,283.55,283.4,283.85,283.95,283.15,283.8,283.7,.4,.3,1668,"47,328.03",35036
,20170921,283.8,283.7,283.65,284.5,281.1,281.25,282.6,-2.45,-1.1,3776,"106,721.90",35076
,20170922,281.25,282.6,280.7,281.55,280.15,281.5,280.75,-1.1,-1.85,4712,"132,291.96",34104
,20170925,281.5,280.75,281.25,281.35,280.6,281.15,280.9,.4,.15,4946,"138,955.25",34370
,20170926,281.15,280.9,281.6,285.65,281.4,285.2,284.1,4.3,3.2,6268,"178,086.71",35238
,20170927,285.2,284.1,283.9,284.6,282.45,282.75,283.4,-1.35,-.7,3930,"111,379.35",35712
,20170928,282.75,283.4,281.95,282.45,281.05,281.35,281.45,-2.05,-1.95,6502,"183,004.83",37370
,20170929,281.35,281.45,281.65,282.65,281.5,282.65,282,1.2,.55,2882,"81,284.56",36910
,20171009,282.65,282,280.35,280.95,279.3,280.4,280.55,-1.6,-1.45,6408,"179,778.24",36194
,20171010,280.4,280.55,280.15,280.9,280,280.2,280.3,-.35,-.25,3856,"108,099.46",36556
,20171011,280.2,280.3,280.4,280.75,279.55,279.7,280.05,-.6,-.25,3432,"96,117.96",36940
,20171012,279.7,280.05,279.85,281.15,279.15,280.8,280.35,.75,.3,7520,"210,856.19",39108
,20171013,280.8,280.35,280.1,281.1,280,280.9,280.6,.55,.25,5458,"153,155.16",39850
,20171016,280.9,280.6,281.35,282.4,281.05,282.25,281.55,1.65,.95,14766,"415,794.44",46120
,20171017,282.25,281.55,282.4,282.7,280.35,280.45,280.95,-1.1,-.6,22118,"621,489.39",55540
,20171018,280.45,280.95,280.25,280.3,279.2,279.35,279.8,-1.6,-1.15,17860,"499,745.77",62234
,20171019,279.35,279.8,279.1,279.75,278.45,278.95,278.85,-.85,-.95,17566,"489,837.16",68886
,20171020,278.95,278.85,279.4,280.25,279.05,279.15,279.4,.3,.55,14366,"401,403.57",73048
,20171023,279.15,279.4,279.05,279.25,278,278,278.3,-1.4,-1.1,15886,"442,113.36",77074
,20171024,278,278.3,278,279.45,277.6,279.25,278.85,.95,.55,11784,"328,613.28",80318
,20171025,279.25,278.85,278.55,278.85,277.95,278,278.3,-.85,-.55,11384,"316,817.23",84594
,20171026,278,278.3,277.95,279.5,277.8,279.5,278.95,1.2,.65,16648,"464,441.45",88180
,20171027,279.5,278.95,278.5,279.3,277.3,277.55,277.9,-1.4,-1.05,25810,"717,269.07",97496
,20171030,277.55,277.9,277.7,278.4,277.25,278,277.9,.1,0,17600,"489,129.25",103432
,20171031,278,277.9,277.7,279.45,277.7,278.55,278.7,.65,.8,42752,"1,191,572.98",121898
,20171101,278.55,278.7,278,278.35,277.15,278.1,277.65,-.6,-1.05,33460,"929,052.22",128822
,20171102,278.1,277.65,278,278.2,277.35,278.2,277.9,.55,.25,27222,"756,585.79",132582
,20171103,278.2,277.9,278.1,278.9,277.85,278.2,278.25,.3,.35,34282,"954,024.16",136642
,20171106,278.2,278.25,278.35,278.75,277.1,277.55,277.8,-.7,-.45,47652,"1,323,854.51",138076
,20171107,277.55,277.8,278.05,279.65,277.75,278.9,278.7,1.1,.9,33612,"936,803.41",140034
,20171108,278.9,278.7,278.8,279.25,278.15,278.95,278.9,.25,.2,37380,"1,042,546.63",147006
,20171109,278.95,278.9,279.5,280.4,279.25,279.95,279.75,1.05,.85,64840,"1,814,002.87",153996
,20171110,279.95,279.75,280.9,281.2,280.3,280.85,280.8,1.1,1.05,58324,"1,637,887.50",161310
,20171113,280.85,280.8,281.1,281.15,279.3,279.65,279.9,-1.15,-.9,43774,"1,225,399.56",160978
,20171114,279.65,279.9,279.8,280.15,279.2,279.3,279.5,-.6,-.4,36148,"1,010,408.81",163660
,20171115,279.3,279.5,278.85,280.3,278.25,279.8,279.45,.3,-.05,82062,"2,293,575.86",167836
,20171116,279.8,279.45,280.2,280.65,278.85,279.15,279.7,-.3,.25,109230,"3,055,219.91",170206
,20171117,279.15,279.7,279.35,280.1,279.05,280.1,279.6,.4,-.1,83458,"2,333,806.95",177048
,20171120,280.1,279.6,280,284.15,279.9,281.65,281.15,2.05,1.55,124816,"3,509,348.38",198364
,20171121,281.65,281.15,281.6,282,279.1,279.9,280.35,-1.25,-.8,125686,"3,523,757.62",194856
,20171122,279.9,280.35,279.35,280.6,279.25,279.95,279.8,-.4,-.55,98470,"2,755,622.60",197390
,20171123,279.95,279.8,280.15,280.95,279.85,280.1,280.3,.3,.5,92712,"2,599,057.27",200858
,20171124,280.1,280.3,280.15,280.45,279.5,280.45,280.05,.15,-.25,61598,"1,725,257.52",203922
,20171127,280.45,280.05,280.05,280.5,279.65,280.45,280.1,.4,.05,75548,"2,116,120.63",208924
,20171128,280.45,280.1,281.25,282.4,281,281.55,281.55,1.45,1.45,141338,"3,979,982.70",234998
,20171129,281.55,281.55,281.75,282.05,280.65,281.75,281.5,.2,-.05,89514,"2,520,049.58",235040
,20171130,281.75,281.5,281.55,281.6,279.3,279.55,280.25,-1.95,-1.25,160322,"4,493,376.32",219304
,20171201,279.55,280.25,279.35,279.35,277.4,277.75,278.2,-2.5,-2.05,116132,"3,231,250.95",223136
,20171204,277.75,278.2,277.6,279.95,276.7,277.55,278.05,-.65,-.15,158454,"4,406,010.28",228100
,20171205,277.55,278.05,277.3,278.3,277.25,277.7,277.65,-.35,-.4,77562,"2,153,550.80",232240
,20171206,277.7,277.65,277.55,277.7,275.1,276.05,276.1,-1.6,-1.55,151124,"4,173,057.53",239546
,20171207,276.05,276.1,275.85,276.35,273.45,274.15,275,-1.95,-1.1,128306,"3,528,834.09",251254
,20171208,274.15,275,273.65,273.95,272.05,272.35,272.9,-2.65,-2.1,115350,"3,147,986.82",264838
,20171211,272.35,272.9,272.25,273.2,271.5,272.55,272.3,-.35,-.6,112536,"3,064,864.49",265648
,20171212,272.55,272.3,272.9,272.9,271.25,271.9,271.9,-.4,-.4,77378,"2,103,991.52",269106
,20171213,271.9,271.9,271.6,272.05,270.9,271.85,271.45,-.05,-.45,77742,"2,110,667.10",267944
,20171214,271.85,271.45,271.75,275.15,271.6,274.25,273.5,2.8,2.05,148848,"4,071,306.90",262238
,20171215,274.25,273.5,274.1,274.6,273.5,274.25,273.95,.75,.45,84622,"2,318,595.72",264592
,20171218,274.25,273.95,274.75,275.3,273.7,274.4,274.35,.45,.4,110138,"3,022,008.70",265180
,20171219,274.4,274.35,274.95,275.9,274.45,275.55,275.1,1.2,.75,107556,"2,958,880.23",264386
,20171220,275.55,275.1,275.35,275.5,274.8,274.95,275.1,-.15,0,73426,"2,020,291.38",262544
,20171221,274.95,275.1,275.15,275.3,274.35,274.7,274.75,-.4,-.35,87822,"2,412,976.37",265840
,20171222,274.7,274.75,274.5,275.05,274.25,274.9,274.65,.15,-.1,64172,"1,762,789.10",266088
,20171225,274.9,274.65,275.25,276.75,274.9,276.6,275.9,1.95,1.25,85190,"2,350,667.74",262910
,20171226,276.6,275.9,276.45,276.6,275.6,276.5,276.25,.6,.35,41718,"1,152,615.24",262238
,20171227,276.5,276.25,276.5,277.2,276.3,277.15,276.8,.9,.55,71938,"1,991,375.06",255188
,20171228,277.15,276.8,277.45,278.55,277.35,278.05,277.9,1.25,1.1,75412,"2,095,758.85",253730
,20171229,278.05,277.9,278,278.3,277.45,277.8,277.9,-.1,0,70460,"1,958,330.02",247600
au1808,20170718,275.75,275.75,278.75,278.75,278.75,278.75,278.75,3,3,2,55.75,2
,20170719,278.75,278.75,,,,278.75,278.75,0,0,0,0.00,2
,20170720,278.75,278.75,,,,278.75,278.75,0,0,0,0.00,2
,20170721,278.75,278.75,,,,279.95,279.95,1.2,1.2,0,0.00,2
,20170724,279.95,279.95,,,,279.95,279.95,0,0,0,0.00,2
,20170725,279.95,279.95,,,,279.95,279.95,0,0,0,0.00,2
,20170726,279.95,279.95,282.6,282.6,279.1,279.1,280.75,-.85,.8,132,"3,706.51",6
,20170727,279.1,280.75,,,,283.3,283.3,2.55,2.55,0,0.00,6
,20170728,283.3,283.3,,,,283.3,283.3,0,0,0,0.00,6
,20170731,283.3,283.3,,,,283.3,283.3,0,0,0,0.00,6
,20170801,283.3,283.3,,,,283.3,283.3,0,0,0,0.00,6
,20170802,283.3,283.3,,,,283.3,283.3,0,0,0,0.00,6
,20170803,283.3,283.3,,,,283.3,283.3,0,0,0,0.00,6
,20170804,283.3,283.3,,,,283.3,283.3,0,0,0,0.00,6
,20170807,283.3,283.3,,,,283.3,283.3,0,0,0,0.00,6
,20170808,283.3,283.3,,,,283.3,283.3,0,0,0,0.00,6
,20170809,283.3,283.3,,,,283.3,283.3,0,0,0,0.00,6
,20170810,283.3,283.3,,,,283.3,283.3,0,0,0,0.00,6
,20170811,283.3,283.3,,,,283.3,283.3,0,0,0,0.00,6
,20170814,283.3,283.3,284.15,284.2,284.15,284.2,284.15,.9,.85,4,113.67,4
,20170815,284.2,284.15,,,,284.15,284.15,0,0,0,0.00,4
,20170816,284.15,284.15,,,,284.15,284.15,0,0,0,0.00,4
,20170817,284.15,284.15,283.8,283.8,283.8,283.8,283.8,-.35,-.35,2,56.76,4
,20170818,283.8,283.8,,,,283.8,283.8,0,0,0,0.00,4
,20170821,283.8,283.8,282.25,284.2,282.25,284.2,283.2,.4,-.6,8,226.58,8
,20170822,284.2,283.2,,,,283.2,283.2,0,0,0,0.00,8
,20170823,283.2,283.2,,,,283.2,283.2,0,0,0,0.00,8
,20170824,283.2,283.2,,,,283.2,283.2,0,0,0,0.00,8
,20170825,283.2,283.2,,,,283.2,283.2,0,0,0,0.00,8
,20170828,283.2,283.2,,,,283.6,283.6,.4,.4,0,0.00,8
,20170829,283.6,283.6,284.1,284.1,284.1,284.1,284.1,.5,.5,2,56.82,8
,20170830,284.1,284.1,285,285,285,285,285,.9,.9,2,57.00,10
,20170831,285,285,,,,285,285,0,0,0,0.00,10
,20170901,285,285,,,,285,285,0,0,0,0.00,10
,20170904,285,285,,,,285.95,285.95,.95,.95,0,0.00,10
,20170905,285.95,285.95,,,,285.95,285.95,0,0,0,0.00,10
,20170906,285.95,285.95,,,,285.95,285.95,0,0,0,0.00,10
,20170907,285.95,285.95,,,,285.95,285.95,0,0,0,0.00,10
,20170908,285.95,285.95,287.2,288.8,287.2,288.4,288.15,2.45,2.2,8,230.53,14
,20170911,288.4,288.15,,,,287.95,287.95,-.2,-.2,0,0.00,14
,20170912,287.95,287.95,286.35,286.35,286.35,286.35,286.35,-1.6,-1.6,2,57.27,16
,20170913,286.35,286.35,,,,286.35,286.35,0,0,0,0.00,16
,20170914,286.35,286.35,285.85,285.85,285.85,285.85,285.85,-.5,-.5,4,114.34,16
,20170915,285.85,285.85,286.95,287,286.95,287,286.95,1.15,1.1,4,114.79,16
,20170918,287,286.95,,,,286.95,286.95,0,0,0,0.00,16
,20170919,286.95,286.95,,,,286.95,286.95,0,0,0,0.00,16
,20170920,286.95,286.95,285.3,285.3,285.3,285.3,285.3,-1.65,-1.65,2,57.06,14
,20170921,285.3,285.3,284.2,284.2,283.05,283.05,283.75,-2.25,-1.55,6,170.26,18
,20170922,283.05,283.75,282.45,282.45,282.3,282.3,282.35,-1.45,-1.4,4,112.95,18
,20170925,282.3,282.35,,,,282.35,282.35,0,0,0,0.00,18
,20170926,282.35,282.35,285.9,286.95,285.9,286.5,286.45,4.15,4.1,8,229.17,22
,20170927,286.5,286.45,285.7,285.7,285.05,285.05,285.45,-1.4,-1,6,171.29,22
,20170928,285.05,285.45,283.5,283.65,282.8,282.8,283.3,-2.65,-2.15,6,169.99,24
,20170929,282.8,283.3,,,,283.3,283.3,0,0,0,0.00,24
,20171009,283.3,283.3,,,,283.3,283.3,0,0,0,0.00,24
,20171010,283.3,283.3,,,,283.3,283.3,0,0,0,0.00,24
,20171011,283.3,283.3,281.2,281.2,281.2,281.2,281.2,-2.1,-2.1,2,56.24,24
,20171012,281.2,281.2,,,,281.2,281.2,0,0,0,0.00,24
,20171013,281.2,281.2,,,,281.2,281.2,0,0,0,0.00,24
,20171016,281.2,281.2,,,,282.15,282.15,.95,.95,0,0.00,24
,20171017,282.15,282.15,,,,282.15,282.15,0,0,0,0.00,24
,20171018,282.15,282.15,281.85,281.85,281.85,281.85,281.85,-.3,-.3,2,56.37,24
,20171019,281.85,281.85,,,,281.85,281.85,0,0,0,0.00,24
,20171020,281.85,281.85,,,,281.85,281.85,0,0,0,0.00,24
,20171023,281.85,281.85,,,,281.85,281.85,0,0,0,0.00,24
,20171024,281.85,281.85,,,,281.85,281.85,0,0,0,0.00,24
,20171025,281.85,281.85,,,,281.85,281.85,0,0,0,0.00,24
,20171026,281.85,281.85,,,,281.85,281.85,0,0,0,0.00,24
,20171027,281.85,281.85,,,,281.85,281.85,0,0,0,0.00,24
,20171030,281.85,281.85,,,,281.85,281.85,0,0,0,0.00,24
,20171031,281.85,281.85,279.9,280.6,279.6,280.35,280.2,-1.5,-1.65,26,728.61,22
,20171101,280.35,280.2,,,,279.7,279.7,-.5,-.5,0,0.00,22
,20171102,279.7,279.7,,,,279.7,279.7,0,0,0,0.00,22
,20171103,279.7,279.7,,,,279.7,279.7,0,0,0,0.00,22
,20171106,279.7,279.7,279.55,279.65,279.55,279.65,279.6,-.05,-.1,12,335.56,32
,20171107,279.65,279.6,,,,280.45,280.45,.85,.85,0,0.00,32
,20171108,280.45,280.45,281.25,281.35,281.2,281.2,281.25,.75,.8,10,281.26,42
,20171109,281.2,281.25,282,282.15,279.45,282.15,280.9,.9,-.35,24,674.25,44
,20171110,282.15,280.9,282.75,283,282.75,283,282.85,2.1,1.95,4,113.15,42
,20171113,283,282.85,283,283,281.4,281.4,282.3,-1.45,-.55,6,169.38,44
,20171114,281.4,282.3,281.8,281.9,281.25,281.25,281.55,-1.05,-.75,8,225.25,44
,20171115,281.25,281.55,280.9,280.9,280.9,280.9,280.9,-.65,-.65,2,56.18,44
,20171116,280.9,280.9,,,,280.9,280.9,0,0,0,0.00,44
,20171117,280.9,280.9,281.5,281.95,281.5,281.95,281.7,1.05,.8,4,112.69,44
,20171120,281.95,281.7,282.65,283.75,282.65,283.65,283.2,1.95,1.5,28,793.01,40
,20171121,283.65,283.2,283.4,283.4,281.8,281.8,282.8,-1.4,-.4,8,226.26,44
,20171122,281.8,282.8,,,,282.8,282.8,0,0,0,0.00,44
,20171123,282.8,282.8,,,,282.8,282.8,0,0,0,0.00,44
,20171124,282.8,282.8,,,,282.8,282.8,0,0,0,0.00,44
,20171127,282.8,282.8,,,,282.8,282.8,0,0,0,0.00,44
,20171128,282.8,282.8,283.5,283.5,282.3,283.45,283.05,.65,.25,6,169.85,44
,20171129,283.45,283.05,282.2,282.2,282.2,282.2,282.2,-.85,-.85,2,56.44,46
,20171130,282.2,282.2,,,,282.2,282.2,0,0,0,0.00,46
,20171201,282.2,282.2,280.05,280.15,279.8,279.8,279.9,-2.4,-2.3,12,335.93,50
,20171204,279.8,279.9,279.3,281.35,277.85,280.3,280.35,.4,.45,26,729.00,50
,20171205,280.3,280.35,279.5,279.5,279.5,279.5,279.5,-.85,-.85,2,55.90,50
,20171206,279.5,279.5,277.6,277.6,277.6,277.6,277.6,-1.9,-1.9,4,111.04,46
,20171207,277.6,277.6,277.7,278.2,276.6,278.2,277.5,.6,-.1,6,166.50,44
,20171208,278.2,277.5,275.85,275.85,275.85,275.85,275.85,-1.65,-1.65,2,55.17,44
,20171211,275.85,275.85,274.4,274.65,274.4,274.65,274.55,-1.2,-1.3,6,164.74,46
,20171212,274.65,274.55,273.9,273.9,273.9,273.9,273.9,-.65,-.65,2,54.78,46
,20171213,273.9,273.9,273.8,275.55,273,275.55,273.95,1.65,.05,12,328.74,44
,20171214,275.55,273.95,274.85,276.95,274.85,276.8,276.3,2.85,2.35,12,331.60,50
,20171215,276.8,276.3,276.35,276.35,275.5,276.3,275.95,0,-.35,94,"2,593.97",54
,20171218,276.3,275.95,277.15,277.15,276.25,276.75,276.65,.8,.7,10,276.65,52
,20171219,276.75,276.65,277.95,277.95,277.95,277.95,277.95,1.3,1.3,2,55.59,52
,20171220,277.95,277.95,,,,277.95,277.95,0,0,0,0.00,52
,20171221,277.95,277.95,276.55,276.55,276.55,276.55,276.55,-1.4,-1.4,2,55.31,52
,20171222,276.55,276.55,,,,276.55,276.55,0,0,0,0.00,52
,20171225,276.55,276.55,277.85,277.85,277.85,277.85,277.85,1.3,1.3,2,55.57,52
,20171226,277.85,277.85,,,,277.85,277.85,0,0,0,0.00,52
,20171227,277.85,277.85,,,,277.85,277.85,0,0,0,0.00,52
,20171228,277.85,277.85,280.45,280.45,280.45,280.45,280.45,2.6,2.6,2,56.09,52
,20171229,280.45,280.45,,,,280.45,280.45,0,0,0,0.00,52
au1810,20170918,286.95,286.95,,,,286.95,286.95,0,0,0,0.00,0
,20170919,286.95,286.95,284.3,284.3,284.3,284.3,284.3,-2.65,-2.65,2,56.86,2
,20170920,284.3,284.3,,,,284.3,284.3,0,0,0,0.00,2
,20170921,284.3,284.3,,,,284.3,284.3,0,0,0,0.00,2
,20170922,284.3,284.3,,,,284.3,284.3,0,0,0,0.00,2
,20170925,284.3,284.3,,,,284.3,284.3,0,0,0,0.00,2
,20170926,284.3,284.3,285.7,286.2,285.7,286.2,285.95,1.9,1.65,4,114.38,6
,20170927,286.2,285.95,,,,285.95,285.95,0,0,0,0.00,6
,20170928,285.95,285.95,282.5,282.5,282.5,282.5,282.5,-3.45,-3.45,2,56.50,8
,20170929,282.5,282.5,,,,282.5,282.5,0,0,0,0.00,8
,20171009,282.5,282.5,,,,282.5,282.5,0,0,0,0.00,8
,20171010,282.5,282.5,,,,282.5,282.5,0,0,0,0.00,8
,20171011,282.5,282.5,,,,282.5,282.5,0,0,0,0.00,8
,20171012,282.5,282.5,,,,282.5,282.5,0,0,0,0.00,8
,20171013,282.5,282.5,,,,282.5,282.5,0,0,0,0.00,8
,20171016,282.5,282.5,283.7,283.7,283.7,283.7,283.7,1.2,1.2,2,56.74,8
,20171017,283.7,283.7,,,,283.7,283.7,0,0,0,0.00,8
,20171018,283.7,283.7,,,,283.7,283.7,0,0,0,0.00,8
,20171019,283.7,283.7,,,,283.65,283.65,-.05,-.05,0,0.00,8
,20171020,283.65,283.65,,,,283.65,283.65,0,0,0,0.00,8
,20171023,283.65,283.65,,,,283.65,283.65,0,0,0,0.00,8
,20171024,283.65,283.65,,,,283.65,283.65,0,0,0,0.00,8
,20171025,283.65,283.65,,,,283.65,283.65,0,0,0,0.00,8
,20171026,283.65,283.65,,,,283.05,283.05,-.6,-.6,0,0.00,8
,20171027,283.05,283.05,,,,281.95,281.95,-1.1,-1.1,0,0.00,8
,20171030,281.95,281.95,,,,281.95,281.95,0,0,0,0.00,8
,20171031,281.95,281.95,279.15,280.5,279.15,280.5,279.8,-1.45,-2.15,4,111.93,10
,20171101,280.5,279.8,,,,279.8,279.8,0,0,0,0.00,10
,20171102,279.8,279.8,,,,279.8,279.8,0,0,0,0.00,10
,20171103,279.8,279.8,280.9,280.9,279.7,280.35,280.45,.55,.65,8,224.37,14
,20171106,280.35,280.45,,,,280.45,280.45,0,0,0,0.00,14
,20171107,280.45,280.45,280,280,280,280,280,-.45,-.45,2,56.00,14
,20171108,280,280,281.05,281.05,280.85,280.85,280.95,.85,.95,4,112.38,16
,20171109,280.85,280.95,281.55,281.55,281.55,281.55,281.55,.6,.6,2,56.31,14
,20171110,281.55,281.55,,,,281.55,281.55,0,0,0,0.00,14
,20171113,281.55,281.55,,,,281.55,281.55,0,0,0,0.00,14
,20171114,281.55,281.55,,,,281.55,281.55,0,0,0,0.00,14
,20171115,281.55,281.55,281.75,281.75,281.75,281.75,281.75,.2,.2,2,56.35,16
,20171116,281.75,281.75,282.2,282.2,281.2,281.2,281.7,-.55,-.05,4,112.68,18
,20171117,281.2,281.7,,,,281.7,281.7,0,0,0,0.00,18
,20171120,281.7,281.7,281.7,283.85,281.7,283.35,282.9,1.65,1.2,12,339.48,20
,20171121,283.35,282.9,283.5,283.5,282,282,282.75,-.9,-.15,4,113.10,22
,20171122,282,282.75,,,,282.75,282.75,0,0,0,0.00,22
,20171123,282.75,282.75,,,,282.75,282.75,0,0,0,0.00,22
,20171124,282.75,282.75,,,,282.75,282.75,0,0,0,0.00,22
,20171127,282.75,282.75,281.95,281.95,281.95,281.95,281.95,-.8,-.8,2,56.39,24
,20171128,281.95,281.95,,,,281.95,281.95,0,0,0,0.00,24
,20171129,281.95,281.95,,,,281.95,281.95,0,0,0,0.00,24
,20171130,281.95,281.95,281.25,281.25,281.15,281.15,281.2,-.8,-.75,6,168.72,28
,20171201,281.15,281.2,279.85,279.85,279.85,279.85,279.85,-1.35,-1.35,6,167.91,34
,20171204,279.85,279.85,279.75,279.75,279.75,279.75,279.75,-.1,-.1,2,55.95,36
,20171205,279.75,279.75,279.7,279.7,279.7,279.7,279.7,-.05,-.05,4,111.88,32
,20171206,279.7,279.7,278.6,278.6,278.6,278.6,278.6,-1.1,-1.1,10,278.60,36
,20171207,278.6,278.6,278.1,278.1,277.1,277.45,277.65,-1.15,-.95,8,222.13,34
,20171208,277.45,277.65,,,,277.65,277.65,0,0,0,0.00,34
,20171211,277.65,277.65,,,,277.65,277.65,0,0,0,0.00,34
,20171212,277.65,277.65,274.15,274.15,274.15,274.15,274.15,-3.5,-3.5,2,54.83,32
,20171213,274.15,274.15,273.1,273.1,273.1,273.1,273.1,-1.05,-1.05,4,109.24,28
,20171214,273.1,273.1,277.25,277.25,277.25,277.25,277.25,4.15,4.15,4,110.90,32
,20171215,277.25,277.25,,,,277.25,277.25,0,0,0,0.00,32
,20171218,277.25,277.25,,,,277.25,277.25,0,0,0,0.00,32
,20171219,277.25,277.25,,,,277.25,277.25,0,0,0,0.00,32
,20171220,277.25,277.25,,,,277.25,277.25,0,0,0,0.00,32
,20171221,277.25,277.25,,,,277.25,277.25,0,0,0,0.00,32
,20171222,277.25,277.25,,,,277.25,277.25,0,0,0,0.00,32
,20171225,277.25,277.25,279.3,279.3,279.3,279.3,279.3,2.05,2.05,2,55.86,32
,20171226,279.3,279.3,,,,279.3,279.3,0,0,0,0.00,32
,20171227,279.3,279.3,,,,279.3,279.3,0,0,0,0.00,32
,20171228,279.3,279.3,,,,279.3,279.3,0,0,0,0.00,32
,20171229,279.3,279.3,,,,279.3,279.3,0,0,0,0.00,32
au1812,20171116,281.75,281.75,282.55,285.85,282.55,282.8,283.95,1.05,2.2,196,"5,566.22",26
,20171117,282.8,283.95,282.9,283.45,282.9,283.25,283.2,-.7,-.75,22,623.09,14
,20171120,283.25,283.2,285,285,284.1,284.9,284.75,1.7,1.55,24,683.40,28
,20171121,284.9,284.75,284.55,285.6,283,283.6,283.8,-1.15,-.95,50,"1,419.04",56
,20171122,283.6,283.8,282.9,283.85,282.8,282.9,283.2,-.9,-.6,16,453.14,62
,20171123,282.9,283.2,284.3,284.3,283.6,284,283.95,.8,.75,28,795.07,64
,20171124,284,283.95,284.1,284.35,283.6,284.35,283.9,.4,-.05,12,340.71,66
,20171127,284.35,283.9,283.85,284.3,283.6,284.25,284.05,.35,.15,28,795.45,80
,20171128,284.25,284.05,285.6,285.6,285.5,285.5,285.55,1.45,1.5,4,114.22,80
,20171129,285.5,285.55,285.9,285.9,285.3,285.3,285.6,-.25,.05,4,114.24,78
,20171130,285.3,285.6,284,284,283.2,283.2,283.8,-2.4,-1.8,20,567.60,78
,20171201,283.2,283.8,283,284.9,281.5,281.5,282.6,-2.3,-1.2,46,"1,300.14",100
,20171204,281.5,282.6,281.3,284.3,280.65,281.4,281.85,-1.2,-.75,58,"1,634.88",104
,20171205,281.4,281.85,281.5,281.75,281.3,281.55,281.45,-.3,-.4,18,506.65,106
,20171206,281.55,281.45,281.65,281.75,279.55,279.85,280.05,-1.6,-1.4,82,"2,296.44",152
,20171207,279.85,280.05,279.8,279.9,277.6,277.6,279.2,-2.45,-.85,24,670.16,150
,20171208,277.6,279.2,278,278.3,276.3,276.35,277.05,-2.85,-2.15,112,"3,103.06",186
,20171211,276.35,277.05,276.3,277.35,275.75,276.55,276.45,-.5,-.6,76,"2,101.10",226
,20171212,276.55,276.45,276.85,276.85,275.45,275.9,276,-.55,-.45,80,"2,208.31",274
,20171213,275.9,276,275.7,275.9,275,275.75,275.6,-.25,-.4,26,716.59,280
,20171214,275.75,275.6,275.9,278.95,275.05,278.6,277.45,3,1.85,50,"1,387.26",286
,20171215,278.6,277.45,278.25,278.25,277.5,278,277.9,.55,.45,40,"1,111.71",298
,20171218,278,277.9,279,279.15,277.3,279.1,278.55,1.2,.65,466,"12,981.59",646
,20171219,279.1,278.55,279,279.9,278.65,279.55,279.3,1,.75,176,"4,916.22",632
,20171220,279.55,279.3,279.3,279.95,278.5,279.15,279.25,-.15,-.05,144,"4,021.46",672
,20171221,279.15,279.25,267.1,290.9,267.1,278.85,280.35,-.4,1.1,142,"3,981.34",692
,20171222,278.85,280.35,278.55,279.15,278.55,279.05,278.9,-1.3,-1.45,82,"2,287.06",724
,20171225,279.05,278.9,279.2,280.95,279.15,280.6,280.35,1.7,1.45,112,"3,140.25",740
,20171226,280.6,280.35,280.6,280.75,280.35,280.5,280.55,.15,.2,70,"1,964.16",756
,20171227,280.5,280.55,280.5,281.35,280.5,281.3,280.95,.75,.4,32,899.11,772
,20171228,281.3,280.95,282.55,282.55,280.55,282.2,282,1.25,1.05,232,"6,543.21",862
,20171229,282.2,282,282,282.2,281.65,281.7,281.95,-.3,-.05,202,"5,696.36",964
bu1701,20170103,2500,2494,2510,2578,2430,2434,2480,-60,-14,1760,"4,364.93",12942
,20170104,2434,2480,2482,2482,2364,2424,2432,-56,-48,700,"1,703.20",12938
,20170105,2424,2432,2340,2468,2340,2434,2438,2,6,2428,"5,921.80",14248
,20170106,2434,2438,2428,2508,2424,2436,2460,-2,22,1294,"3,183.72",14228
,20170109,2436,2460,2448,2496,2444,2452,2466,-8,6,642,"1,583.65",14102
,20170110,2452,2466,2464,2464,2390,2432,2422,-34,-44,946,"2,292.71",13570
,20170111,2432,2422,2460,2516,2422,2432,2466,10,44,744,"1,836.08",13186
,20170112,2432,2466,2422,2478,2422,2430,2446,-36,-20,10,24.46,13188
,20170113,2430,2446,2520,2524,2454,2524,2522,78,76,414,"1,044.37",13188
,20170116,2524,2522,2452,2560,2452,2500,2506,-22,-16,894,"2,241.60",12402
bu1702,20170103,2540,2544,2580,2580,2482,2482,2550,-62,6,22,56.11,414
,20170104,2482,2550,2378,2470,2378,2426,2412,-124,-138,24,57.89,414
,20170105,2426,2412,2472,2480,2440,2442,2460,30,48,18,44.31,412
,20170106,2442,2460,2524,2524,2524,2524,2524,64,64,2,5.05,414
,20170109,2524,2524,2504,2558,2500,2516,2518,-8,-6,8,20.16,412
,20170110,2516,2518,2428,2482,2428,2482,2452,-36,-66,12,29.44,414
,20170111,2482,2452,2480,2480,2480,2480,2480,28,28,2,4.96,414
,20170112,2480,2480,,,,2480,2480,0,0,0,0.00,414
,20170113,2480,2480,2530,2530,2530,2530,2530,50,50,6,15.18,408
,20170116,2530,2530,2566,2580,2566,2574,2572,44,42,8,20.59,410
,20170117,2574,2572,,,,2494,2494,-78,-78,0,0.00,410
,20170118,2494,2494,2476,2492,2452,2492,2466,-2,-28,32,78.93,420
,20170119,2492,2466,2424,2490,2424,2456,2454,-10,-12,28,68.75,410
,20170120,2456,2454,2462,2462,2398,2398,2428,-56,-26,16,38.87,410
,20170123,2398,2428,2580,2580,2344,2420,2442,-8,14,38,92.84,408
,20170124,2420,2442,2478,2494,2404,2494,2452,52,10,30,73.56,406
,20170125,2494,2452,2514,2514,2514,2514,2514,62,62,2,5.03,406
,20170126,2514,2514,,,,2514,2514,0,0,0,0.00,406
,20170203,2514,2514,,,,2514,2514,0,0,0,0.00,406
,20170206,2514,2514,2632,2632,2548,2548,2574,34,60,24,61.81,400
,20170207,2548,2574,2566,2572,2468,2468,2528,-106,-46,8,20.23,400
,20170208,2468,2528,2438,2546,2438,2546,2498,18,-30,6,15.00,400
,20170209,2546,2498,,,,2498,2498,0,0,0,0.00,400
,20170210,2498,2498,2500,2520,2500,2520,2512,22,14,6,15.08,400
,20170213,2520,2512,,,,2512,2512,0,0,0,0.00,400
,20170214,2512,2512,,,,2512,2512,0,0,0,0.00,400
,20170215,2512,2512,,,,2512,2512,0,0,0,0.00,400
bu1703,20170103,2600,2584,2580,2640,2500,2500,2586,-84,2,808,"2,090.96",1054
,20170104,2500,2586,2524,2610,2480,2498,2510,-88,-76,646,"1,622.19",972
,20170105,2498,2510,2516,2538,2500,2510,2514,0,4,188,472.65,972
,20170106,2510,2514,2510,2588,2508,2530,2540,16,26,80,203.20,954
,20170109,2530,2540,2540,2568,2502,2562,2544,22,4,48,122.12,936
,20170110,2562,2544,2532,2552,2488,2520,2508,-24,-36,148,371.20,900
,20170111,2520,2508,2580,2596,2518,2546,2566,38,58,76,195.14,890
,20170112,2546,2566,2562,2594,2538,2550,2576,-16,10,22,56.67,884
,20170113,2550,2576,2584,2618,2584,2610,2604,34,28,116,302.16,876
,20170116,2610,2604,2616,2640,2586,2586,2616,-18,12,168,439.55,858
,20170117,2586,2616,2620,2634,2518,2518,2588,-98,-28,84,217.52,824
,20170118,2518,2588,2576,2576,2538,2556,2554,-32,-34,158,403.54,820
,20170119,2556,2554,2536,2540,2498,2526,2520,-28,-34,92,231.99,812
,20170120,2526,2520,2554,2554,2454,2454,2482,-66,-38,94,233.42,762
,20170123,2454,2482,2454,2494,2454,2468,2484,-14,2,90,223.61,760
,20170124,2468,2484,2486,2516,2486,2506,2502,22,18,8,20.03,762
,20170125,2506,2502,2498,2514,2478,2514,2508,12,6,26,65.24,770
,20170126,2514,2508,2498,2550,2498,2550,2536,42,28,30,76.08,762
,20170203,2550,2536,2554,2588,2534,2584,2542,48,6,138,351.02,760
,20170206,2584,2542,2558,2590,2558,2590,2572,48,30,142,365.47,738
,20170207,2590,2572,2562,2574,2536,2572,2560,0,-12,46,117.83,730
,20170208,2572,2560,2544,2598,2538,2598,2568,38,8,80,205.51,770
,20170209,2598,2568,2578,2612,2554,2554,2586,-14,18,128,331.18,752
,20170210,2554,2586,2596,2646,2566,2620,2622,34,36,218,571.63,770
,20170213,2620,2622,2660,2766,2660,2730,2702,108,80,608,"1,643.68",1210
,20170214,2730,2702,2750,2770,2716,2752,2752,50,50,274,754.28,1202
,20170215,2752,2752,2760,2760,2676,2676,2714,-76,-38,24,65.16,1192
,20170216,2676,2714,2676,2686,2630,2630,2648,-84,-66,24,63.58,1190
,20170217,2630,2648,2628,2648,2610,2640,2636,-8,-12,16,42.20,1184
,20170220,2640,2636,2608,2722,2596,2720,2704,84,68,174,470.66,1184
,20170221,2720,2704,2744,2748,2702,2702,2728,-2,24,22,60.06,1184
,20170222,2702,2728,2746,2746,2734,2734,2738,6,10,6,16.44,1184
,20170223,2734,2738,2654,2660,2618,2618,2648,-120,-90,18,47.67,1174
,20170224,2618,2648,2618,2698,2618,2698,2658,50,10,28,74.48,1176
,20170227,2698,2658,2730,2780,2730,2780,2754,122,96,4,11.02,1174
,20170228,2780,2754,2796,2796,2760,2760,2774,6,20,6,16.64,1172
,20170301,2760,2774,2768,2768,2690,2760,2754,-14,-20,112,308.47,1168
,20170302,2760,2754,,,,2754,2754,0,0,0,0.00,1168
,20170303,2754,2754,2750,2750,2662,2662,2710,-92,-44,8,21.69,1164
,20170306,2662,2710,2680,2690,2640,2690,2670,-20,-40,6,16.02,1160
,20170307,2690,2670,,,,2670,2670,0,0,0,0.00,1160
,20170308,2670,2670,2696,2696,2620,2620,2644,-50,-26,12,31.74,1160
,20170309,2620,2644,2556,2556,2480,2510,2514,-134,-130,162,407.30,1164
,20170310,2510,2514,2510,2530,2422,2490,2502,-24,-12,108,270.30,1144
,20170313,2490,2502,2528,2528,2528,2528,2528,26,26,40,101.12,1144
,20170314,2528,2528,,,,2500,2500,-28,-28,0,0.00,1144
,20170315,2500,2500,2500,2570,2500,2570,2546,70,46,12,30.56,1136
bu1704,20170103,2604,2610,2676,2728,2570,2570,2656,-40,46,38,100.94,198
,20170104,2570,2656,2582,2596,2522,2564,2570,-92,-86,42,107.99,194
,20170105,2564,2570,2570,2634,2528,2572,2598,2,28,40,103.96,198
,20170106,2572,2598,2630,2632,2630,2632,2630,34,32,6,15.78,194
,20170109,2632,2630,,,,2630,2630,0,0,0,0.00,194
,20170110,2630,2630,,,,2630,2630,0,0,0,0.00,194
,20170111,2630,2630,2658,2670,2588,2588,2632,-42,2,18,47.39,202
,20170112,2588,2632,2580,2650,2580,2624,2610,-8,-22,28,73.13,200
,20170113,2624,2610,2664,2664,2572,2656,2634,46,24,70,184.50,202
,20170116,2656,2634,2650,2650,2650,2650,2650,16,16,2,5.30,200
,20170117,2650,2650,2660,2660,2650,2650,2654,0,4,4,10.62,198
,20170118,2650,2654,2610,2618,2580,2580,2614,-74,-40,28,73.20,202
,20170119,2580,2614,,,,2610,2610,-4,-4,0,0.00,202
,20170120,2610,2610,2582,2582,2516,2516,2538,-94,-72,6,15.24,198
,20170123,2516,2538,,,,2538,2538,0,0,0,0.00,198
,20170124,2538,2538,2554,2554,2554,2554,2554,16,16,2,5.11,198
,20170125,2554,2554,2518,2550,2518,2550,2522,-4,-32,26,65.60,190
,20170126,2550,2522,2562,2562,2562,2562,2562,40,40,2,5.12,190
,20170203,2562,2562,2616,2616,2616,2616,2616,54,54,2,5.23,190
,20170206,2616,2616,2644,2670,2644,2644,2644,28,28,28,74.08,190
,20170207,2644,2644,,,,2644,2644,0,0,0,0.00,190
,20170208,2644,2644,2638,2640,2608,2634,2630,-10,-14,24,63.12,190
,20170209,2634,2630,2660,2660,2650,2650,2654,20,24,8,21.24,188
,20170210,2650,2654,2640,2710,2640,2710,2696,56,42,242,652.48,406
,20170213,2710,2696,2730,2840,2730,2830,2762,134,66,614,"1,696.70",1016
,20170214,2830,2762,2800,2824,2800,2824,2802,62,40,28,78.47,1014
,20170215,2824,2802,2782,2826,2738,2738,2782,-64,-20,30,83.48,1018
,20170216,2738,2782,2682,2682,2682,2682,2682,-100,-100,2,5.36,1018
,20170217,2682,2682,2728,2728,2688,2688,2704,6,22,10,27.04,1016
,20170220,2688,2704,2680,2786,2680,2754,2758,50,54,18,49.66,1016
,20170221,2754,2758,2766,2766,2706,2736,2740,-22,-18,10,27.40,1020
,20170222,2736,2740,2794,2794,2750,2750,2772,10,32,14,38.81,1018
,20170223,2750,2772,2760,2770,2688,2726,2718,-46,-54,18,48.92,1014
,20170224,2726,2718,2714,2728,2624,2728,2690,10,-28,14,37.67,1014
,20170227,2728,2690,2728,2804,2728,2804,2762,114,72,8,22.10,1014
,20170228,2804,2762,2802,2830,2800,2800,2814,38,52,42,118.24,1014
,20170301,2800,2814,2780,2850,2750,2750,2786,-64,-28,26,72.48,1014
,20170302,2750,2786,2816,2820,2728,2792,2784,6,-2,14,38.98,1014
,20170303,2792,2784,2732,2736,2728,2736,2732,-48,-52,6,16.39,1010
,20170306,2736,2732,2814,2818,2712,2734,2772,2,40,94,260.62,1010
,20170307,2734,2772,2708,2708,2708,2708,2708,-64,-64,2,5.42,1010
,20170308,2708,2708,2766,2790,2636,2678,2680,-30,-28,112,300.20,1008
,20170309,2678,2680,2666,2666,2520,2520,2582,-160,-98,22,56.81,1008
,20170310,2520,2582,2518,2550,2510,2530,2518,-52,-64,54,136.02,1010
,20170313,2530,2518,2544,2602,2510,2570,2564,52,46,98,251.42,1012
,20170314,2570,2564,2564,2612,2518,2518,2578,-46,14,60,154.70,1030
,20170315,2518,2578,2514,2582,2496,2576,2538,-2,-40,30,76.19,1024
,20170316,2576,2538,2578,2594,2542,2542,2576,4,38,8,20.61,1026
,20170317,2542,2576,,,,2576,2576,0,0,0,0.00,1026
,20170320,2576,2576,2612,2684,2586,2586,2630,10,54,22,57.87,1018
,20170321,2586,2630,2674,2674,2550,2600,2624,-30,-6,974,"2,557.62",1018
,20170322,2600,2624,2580,2584,2538,2538,2560,-86,-64,18,46.08,1022
,20170323,2538,2560,2504,2548,2494,2530,2526,-30,-34,24,60.66,1024
,20170324,2530,2526,2526,2526,2518,2526,2524,0,-2,8,20.19,1024
,20170327,2526,2524,2426,2454,2426,2454,2440,-70,-84,8,19.53,1024
,20170328,2454,2440,2470,2472,2470,2472,2470,32,30,8,19.77,1020
,20170329,2472,2470,2536,2536,2536,2536,2536,66,66,2,5.07,1020
,20170330,2536,2536,,,,2536,2536,0,0,0,0.00,1020
,20170331,2536,2536,2532,2572,2532,2572,2550,36,14,8,20.40,1018
,20170405,2572,2550,2602,2718,2602,2718,2660,168,110,86,228.86,1074
,20170406,2718,2660,2726,2726,2628,2628,2692,-32,32,20,53.86,1062
,20170407,2628,2692,,,,2692,2692,0,0,0,0.00,1062
,20170410,2692,2692,2574,2600,2574,2600,2582,-92,-110,20,51.64,1062
,20170411,2600,2582,,,,2582,2582,0,0,0,0.00,1062
,20170412,2582,2582,2404,2486,2402,2402,2436,-180,-146,8,19.50,1060
,20170413,2402,2436,2410,2410,2410,2410,2410,-26,-26,2,4.82,1060
,20170414,2410,2410,2370,2370,2370,2370,2370,-40,-40,10,23.70,1060
,20170417,2370,2370,2410,2410,2410,2410,2410,40,40,10,24.10,1060
bu1705,20170103,2700,2692,2746,2764,2610,2616,2672,-76,-20,10478,"28,007.74",8398
,20170104,2616,2672,2624,2654,2592,2614,2618,-58,-54,9568,"25,064.25",8774
,20170105,2614,2618,2628,2650,2602,2612,2624,-6,6,4744,"12,452.94",8574
,20170106,2612,2624,2632,2694,2616,2638,2658,14,34,6820,"18,137.14",8806
,20170109,2638,2658,2642,2688,2630,2670,2658,12,0,7264,"19,310.52",8386
,20170110,2670,2658,2662,2664,2586,2630,2620,-28,-38,6306,"16,522.09",8056
,20170111,2630,2620,2630,2718,2626,2650,2672,30,52,9602,"25,671.60",7456
,20170112,2650,2672,2648,2706,2636,2680,2672,8,0,7396,"19,762.78",7412
,20170113,2680,2672,2700,2740,2686,2716,2708,44,36,7036,"19,063.23",7930
,20170116,2716,2708,2720,2758,2696,2724,2728,16,20,8180,"22,317.16",7918
,20170117,2724,2728,2736,2744,2650,2652,2700,-76,-28,7914,"21,382.63",8020
,20170118,2652,2700,2698,2698,2642,2650,2662,-50,-38,5132,"13,668.19",8178
,20170119,2650,2662,2628,2638,2600,2632,2618,-30,-44,10076,"26,380.91",8994
,20170120,2632,2618,2632,2660,2534,2534,2594,-84,-24,7484,"19,428.33",9150
,20170123,2534,2594,2564,2600,2550,2572,2576,-22,-18,5132,"13,229.96",8370
,20170124,2572,2576,2572,2626,2560,2608,2588,32,12,5014,"12,983.88",8260
,20170125,2608,2588,2606,2624,2576,2616,2604,28,16,4354,"11,341.31",7998
,20170126,2616,2604,2616,2686,2598,2660,2636,56,32,3868,"10,196.05",8170
,20170203,2660,2636,2666,2704,2642,2690,2668,54,32,5904,"15,761.35",7812
,20170206,2690,2668,2690,2716,2676,2716,2696,48,28,2630,"7,094.93",7972
,20170207,2716,2696,2716,2720,2658,2684,2686,-12,-10,3028,"8,138.15",7900
,20170208,2684,2686,2686,2730,2656,2720,2686,34,0,3426,"9,205.47",8188
,20170209,2720,2686,2728,2732,2686,2696,2714,10,28,2436,"6,614.91",8214
,20170210,2696,2714,2704,2778,2690,2764,2744,50,30,5602,"15,373.37",8812
,20170213,2764,2744,2780,2924,2776,2898,2860,154,116,10168,"29,082.34",9568
,20170214,2898,2860,2878,2920,2864,2894,2892,34,32,5600,"16,205.34",9172
,20170215,2894,2892,2910,2936,2774,2784,2850,-108,-42,7894,"22,510.32",8786
,20170216,2784,2850,2800,2828,2736,2766,2790,-84,-60,6618,"18,471.40",8584
,20170217,2766,2790,2774,2802,2740,2766,2772,-24,-18,6018,"16,691.39",8778
,20170220,2766,2772,2756,2850,2726,2846,2798,74,26,6362,"17,809.18",8854
,20170221,2846,2798,2838,2860,2784,2804,2824,6,26,4882,"13,791.06",8626
,20170222,2804,2824,2864,2874,2812,2858,2844,34,20,7980,"22,700.72",8860
,20170223,2858,2844,2838,2856,2742,2760,2810,-84,-34,8118,"22,821.12",8800
,20170224,2760,2810,2772,2828,2732,2828,2782,18,-28,5000,"13,912.48",8708
,20170227,2828,2782,2822,2904,2818,2892,2872,110,90,5920,"17,013.49",8990
,20170228,2892,2872,2884,2900,2822,2848,2866,-24,-6,4674,"13,401.21",8488
,20170301,2848,2866,2844,2894,2824,2882,2868,16,2,12262,"35,173.54",8180
,20170302,2882,2868,2894,2898,2822,2834,2852,-34,-16,4246,"12,116.95",8154
,20170303,2834,2852,2828,2828,2750,2798,2794,-54,-58,5436,"15,189.25",8112
,20170306,2798,2794,2820,2832,2766,2786,2794,-8,0,3892,"10,878.02",8226
,20170307,2786,2794,2798,2812,2784,2792,2796,-2,2,2682,"7,500.11",8100
,20170308,2792,2796,2800,2854,2722,2734,2788,-62,-8,8400,"23,431.16",7560
,20170309,2734,2788,2718,2744,2592,2626,2646,-162,-142,9160,"24,248.38",6874
,20170310,2626,2646,2588,2640,2576,2600,2606,-46,-40,4820,"12,568.91",6628
,20170313,2600,2606,2610,2666,2546,2666,2602,60,-4,9052,"23,567.86",5814
,20170314,2666,2602,2666,2666,2578,2582,2620,-20,18,6006,"15,738.70",5674
,20170315,2582,2620,2554,2644,2550,2626,2606,6,-14,4050,"10,561.15",5514
,20170316,2626,2606,2636,2666,2618,2638,2640,32,34,3518,"9,291.38",5530
,20170317,2638,2640,2638,2656,2596,2646,2636,6,-4,3670,"9,674.41",4914
,20170320,2646,2636,2660,2694,2610,2650,2648,14,12,4464,"11,826.11",4890
,20170321,2650,2648,2646,2676,2580,2666,2644,18,-4,4406,"11,655.11",5084
,20170322,2666,2644,2666,2666,2538,2546,2594,-98,-50,6130,"15,902.48",4988
,20170323,2546,2594,2544,2594,2520,2550,2558,-44,-36,5578,"14,270.47",5822
,20170324,2550,2558,2542,2562,2522,2544,2544,-14,-14,3756,"9,559.23",6900
,20170327,2544,2544,2538,2558,2452,2490,2484,-54,-60,5962,"14,812.50",7166
,20170328,2490,2484,2490,2558,2476,2556,2526,72,42,3906,"9,872.59",7494
,20170329,2556,2526,2562,2588,2546,2578,2564,52,38,1382,"3,545.27",7356
,20170330,2578,2564,2584,2600,2554,2588,2574,24,10,2264,"5,828.89",7356
,20170331,2588,2574,2598,2608,2572,2594,2590,20,16,1788,"4,632.43",7314
,20170405,2594,2590,2610,2770,2610,2744,2692,154,102,3196,"8,608.40",7584
,20170406,2744,2692,2744,2756,2712,2736,2732,44,40,1818,"4,967.23",7620
,20170407,2736,2732,2756,2794,2682,2698,2738,-34,6,4450,"12,190.23",8204
,20170410,2698,2738,2688,2740,2666,2696,2694,-42,-44,1466,"3,950.38",8194
,20170411,2696,2694,2704,2714,2506,2514,2604,-180,-90,3578,"9,317.46",8132
,20170412,2514,2604,2520,2546,2484,2502,2516,-102,-88,1632,"4,109.37",8212
,20170413,2502,2516,2506,2526,2484,2506,2508,-10,-8,1262,"3,166.48",8166
,20170414,2506,2508,2506,2526,2394,2422,2440,-86,-68,2814,"6,869.45",8044
,20170417,2422,2440,2422,2494,2414,2470,2460,30,20,1478,"3,638.53",7874
,20170418,2470,2460,2476,2486,2432,2442,2452,-18,-8,960,"2,355.45",7710
,20170419,2442,2452,2442,2472,2368,2466,2424,14,-28,1158,"2,808.31",7574
,20170420,2466,2424,2478,2490,2390,2460,2438,36,14,974,"2,376.23",7414
,20170421,2460,2438,2440,2472,2420,2440,2446,2,8,842,"2,060.54",7332
,20170424,2440,2446,2460,2460,2396,2430,2418,-16,-28,998,"2,413.84",7284
,20170425,2430,2418,2434,2480,2422,2472,2462,54,44,1154,"2,841.65",7408
,20170426,2472,2462,2464,2476,2434,2458,2446,-4,-16,1820,"4,454.70",7924
,20170427,2458,2446,2442,2480,2438,2480,2462,34,16,2096,"5,164.28",7798
,20170428,2480,2462,2448,2520,2448,2504,2486,42,24,1250,"3,108.22",7676
,20170502,2504,2486,2504,2526,2492,2520,2502,34,16,88,220.34,7668
,20170503,2520,2502,2500,2510,2500,2508,2506,6,4,36,90.28,7666
,20170504,2508,2506,2494,2538,2410,2410,2456,-96,-50,1014,"2,491.72",6670
,20170505,2410,2456,2426,2426,2346,2360,2394,-96,-62,408,977.38,6644
,20170508,2360,2394,2390,2390,2352,2352,2372,-42,-22,14,33.22,6638
,20170509,2352,2372,2366,2398,2354,2386,2370,14,-2,130,308.28,6618
,20170510,2386,2370,2380,2420,2330,2370,2386,0,16,76,181.38,6644
,20170511,2370,2386,2384,2390,2374,2380,2380,-6,-6,48,114.25,6662
,20170512,2380,2380,2220,2400,2220,2400,2380,20,0,60,142.90,6716
,20170515,2400,2380,2330,2400,2330,2400,2394,20,14,106,253.90,6740
bu1706,20170103,2738,2722,2744,2840,2640,2648,2704,-74,-18,1150324,"3,112,688.71",661326
,20170104,2648,2704,2672,2688,2620,2654,2654,-50,-50,1246914,"3,310,167.12",660222
,20170105,2654,2654,2652,2688,2632,2646,2658,-8,4,1097738,"2,918,283.15",688436
,20170106,2646,2658,2656,2736,2648,2678,2694,20,36,1538938,"4,146,650.20",699410
,20170109,2678,2694,2688,2728,2660,2712,2692,18,-2,1451250,"3,908,583.11",707184
,20170110,2712,2692,2692,2696,2616,2666,2652,-26,-40,1431284,"3,798,602.02",718312
,20170111,2666,2652,2664,2750,2652,2674,2704,22,52,1717162,"4,644,230.18",727774
,20170112,2674,2704,2676,2734,2660,2702,2696,-2,-8,1208802,"3,260,965.09",718552
,20170113,2702,2696,2718,2768,2710,2744,2734,48,38,1322156,"3,616,577.15",754198
,20170116,2744,2734,2734,2786,2718,2746,2748,12,14,1064008,"2,924,482.53",711284
,20170117,2746,2748,2744,2774,2668,2672,2726,-76,-22,1109854,"3,025,905.73",683148
,20170118,2672,2726,2696,2712,2658,2676,2682,-50,-44,849038,"2,277,430.02",656518
,20170119,2676,2682,2654,2658,2620,2648,2640,-34,-42,834560,"2,204,782.66",682814
,20170120,2648,2640,2648,2686,2568,2570,2628,-70,-12,953984,"2,507,374.86",659442
,20170123,2570,2628,2580,2626,2578,2590,2600,-38,-28,667384,"1,735,600.13",626228
,20170124,2590,2600,2582,2650,2572,2634,2616,34,16,636856,"1,666,317.90",559254
,20170125,2634,2616,2632,2648,2594,2642,2626,26,10,482304,"1,267,013.18",528860
,20170126,2642,2626,2634,2696,2624,2694,2660,68,34,440686,"1,172,803.71",492340
,20170203,2694,2660,2708,2734,2666,2720,2700,60,40,469156,"1,267,421.97",520744
,20170206,2720,2700,2720,2748,2702,2742,2728,42,28,561190,"1,531,100.72",553114
,20170207,2742,2728,2738,2742,2684,2716,2714,-12,-14,495728,"1,345,755.10",555592
,20170208,2716,2714,2704,2762,2682,2758,2714,44,0,978580,"2,656,778.18",647474
,20170209,2758,2714,2760,2772,2718,2734,2750,20,36,714560,"1,965,418.23",593794
,20170210,2734,2750,2736,2822,2728,2808,2774,58,24,892050,"2,474,922.85",643434
,20170213,2808,2774,2828,2968,2818,2938,2902,164,128,1270770,"3,690,152.36",744990
,20170214,2938,2902,2940,2958,2904,2936,2932,34,30,624292,"1,830,862.23",733926
,20170215,2936,2932,2940,2978,2816,2826,2886,-106,-46,1190362,"3,436,477.53",650576
,20170216,2826,2886,2818,2868,2770,2806,2826,-80,-60,863988,"2,442,422.18",616676
,20170217,2806,2826,2808,2844,2776,2804,2814,-22,-12,741822,"2,087,670.09",611740
,20170220,2804,2814,2796,2890,2762,2884,2832,70,18,1006032,"2,849,827.61",660862
,20170221,2884,2832,2890,2902,2820,2842,2862,10,30,775316,"2,220,485.57",638140
,20170222,2842,2862,2860,2912,2850,2900,2884,38,22,1364286,"3,935,187.10",704140
,20170223,2900,2884,2880,2898,2780,2804,2850,-80,-34,1268384,"3,617,084.42",632528
,20170224,2804,2850,2820,2880,2772,2880,2824,30,-26,979666,"2,767,345.00",621212
,20170227,2880,2824,2874,2950,2870,2930,2912,106,88,1029086,"2,998,453.45",647612
,20170228,2930,2912,2930,2944,2868,2886,2908,-26,-4,789104,"2,294,741.43",615070
,20170301,2886,2908,2886,2956,2864,2940,2914,32,6,1236178,"3,604,405.42",670716
,20170302,2940,2914,2950,2956,2876,2888,2912,-26,-2,919922,"2,679,037.74",635498
,20170303,2888,2912,2876,2878,2826,2864,2856,-48,-56,900698,"2,572,518.69",607948
,20170306,2864,2856,2870,2894,2822,2842,2854,-14,-2,862948,"2,463,870.40",623272
,20170307,2842,2854,2844,2872,2840,2852,2854,-2,0,663238,"1,893,996.62",614666
,20170308,2852,2854,2860,2916,2776,2788,2848,-66,-6,1675160,"4,771,357.46",646300
,20170309,2788,2848,2790,2798,2656,2680,2712,-168,-136,1394214,"3,781,360.30",612408
,20170310,2680,2712,2650,2694,2628,2650,2662,-62,-50,993592,"2,646,101.84",613306
,20170313,2650,2662,2680,2716,2600,2714,2654,52,-8,1076320,"2,857,136.30",579396
,20170314,2714,2654,2706,2710,2618,2628,2664,-26,10,938012,"2,500,526.64",618666
,20170315,2628,2664,2596,2690,2588,2678,2644,14,-20,1032238,"2,730,043.18",566434
,20170316,2678,2644,2682,2716,2664,2694,2686,50,42,840262,"2,258,451.19",540376
,20170317,2694,2686,2696,2706,2638,2688,2678,2,-8,814874,"2,182,899.45",513452
,20170320,2688,2678,2696,2742,2650,2694,2700,16,22,873942,"2,360,723.32",515514
,20170321,2694,2700,2680,2724,2668,2724,2696,24,-4,864290,"2,330,721.78",521744
,20170322,2724,2696,2718,2718,2578,2590,2640,-106,-56,1121714,"2,962,206.21",577136
,20170323,2590,2640,2582,2626,2550,2578,2586,-62,-54,992454,"2,566,578.05",566142
,20170324,2578,2586,2570,2604,2560,2580,2582,-6,-4,678868,"1,753,470.06",555848
,20170327,2580,2582,2580,2592,2490,2522,2530,-60,-52,871810,"2,206,679.43",574366
,20170328,2522,2530,2520,2596,2512,2588,2558,58,28,833310,"2,132,014.26",545618
,20170329,2588,2558,2598,2624,2580,2616,2600,58,42,577008,"1,500,876.52",508158
,20170330,2616,2600,2602,2646,2584,2616,2612,16,12,699764,"1,828,637.02",524140
,20170331,2616,2612,2628,2654,2604,2620,2626,8,14,629272,"1,652,677.46",473130
,20170405,2620,2626,2654,2808,2654,2778,2740,152,114,790746,"2,168,110.58",479648
,20170406,2778,2740,2794,2796,2746,2780,2772,40,32,621244,"1,722,631.20",461690
,20170407,2780,2772,2788,2836,2722,2744,2774,-28,2,1092128,"3,030,372.99",445086
,20170410,2744,2774,2736,2776,2704,2734,2732,-40,-42,706452,"1,930,812.93",434102
,20170411,2734,2732,2742,2756,2546,2552,2652,-180,-80,1193670,"3,167,090.73",466432
,20170412,2552,2652,2564,2584,2520,2548,2556,-104,-96,641810,"1,640,530.30",419148
,20170413,2548,2556,2548,2566,2518,2540,2544,-16,-12,581482,"1,479,891.89",409952
,20170414,2540,2544,2544,2564,2424,2458,2480,-86,-64,1009050,"2,504,418.69",453074
,20170417,2458,2480,2466,2532,2454,2502,2494,22,14,640654,"1,597,998.18",416822
,20170418,2502,2494,2516,2522,2458,2472,2486,-22,-8,425662,"1,058,728.05",410206
,20170419,2472,2486,2470,2514,2402,2510,2458,24,-28,724128,"1,781,043.03",401276
,20170420,2510,2458,2510,2530,2420,2496,2472,38,14,639490,"1,581,822.10",365690
,20170421,2496,2472,2488,2510,2448,2472,2480,0,8,551230,"1,367,358.62",365824
,20170424,2472,2480,2480,2486,2422,2468,2452,-12,-28,431612,"1,059,006.91",330278
,20170425,2468,2452,2468,2516,2458,2508,2492,56,40,320056,"797,727.35",276104
,20170426,2508,2492,2506,2514,2466,2492,2486,0,-6,254938,"634,111.76",249740
,20170427,2492,2486,2484,2516,2472,2514,2498,28,12,179840,"449,518.25",220920
,20170428,2514,2498,2500,2564,2492,2550,2526,52,28,187028,"472,645.31",179228
,20170502,2550,2526,2554,2572,2530,2558,2546,32,20,53578,"136,502.02",170194
,20170503,2558,2546,2562,2566,2534,2552,2550,6,4,54086,"138,024.37",159392
,20170504,2552,2550,2548,2548,2422,2474,2486,-76,-64,103588,"257,696.68",145882
,20170505,2474,2486,2466,2474,2380,2382,2418,-104,-68,90366,"218,567.42",140874
,20170508,2382,2418,2402,2440,2398,2414,2418,-4,0,44974,"108,820.52",133214
,20170509,2414,2418,2406,2430,2388,2418,2412,0,-6,33618,"81,102.10",130958
,20170510,2418,2412,2412,2440,2400,2414,2418,2,6,37956,"91,777.82",126358
,20170511,2414,2418,2426,2456,2402,2436,2432,18,14,51364,"124,946.98",114838
,20170512,2436,2432,2446,2448,2368,2408,2404,-24,-28,48390,"116,424.23",108956
,20170515,2408,2404,2410,2456,2404,2452,2426,48,22,31356,"76,111.28",100460
,20170516,2452,2426,2488,2492,2444,2484,2466,58,40,39202,"96,710.79",94772
,20170517,2484,2466,2488,2508,2466,2496,2484,30,18,22804,"56,666.80",88722
,20170518,2496,2484,2508,2520,2458,2498,2496,14,12,36864,"92,040.80",86642
,20170519,2498,2496,2480,2536,2472,2528,2516,32,20,39126,"98,464.96",80364
,20170522,2528,2516,2530,2552,2514,2532,2532,16,16,29540,"74,818.02",76668
,20170523,2532,2532,2526,2542,2442,2448,2500,-84,-32,32202,"80,519.44",72480
,20170524,2448,2500,2458,2480,2410,2448,2444,-52,-56,24800,"60,635.50",68118
,20170525,2448,2444,2450,2510,2440,2492,2480,48,36,21388,"53,055.46",63648
,20170526,2492,2480,2476,2484,2382,2396,2414,-84,-66,24940,"60,254.54",55056
,20170531,2396,2414,2396,2410,2244,2260,2318,-154,-96,19564,"45,379.98",46846
,20170601,2260,2318,2250,2294,2242,2274,2266,-44,-52,15016,"34,053.11",39894
,20170602,2274,2266,2270,2278,2170,2238,2256,-28,-10,7812,"17,629.34",37706
,20170605,2238,2256,2220,2278,2214,2274,2256,18,0,4872,"10,996.80",36518
,20170606,2274,2256,2260,2308,2240,2300,2274,44,18,6464,"14,704.72",33370
,20170607,2300,2274,2302,2360,2288,2300,2304,26,30,4340,"10,007.43",31688
,20170608,2300,2304,2292,2308,2264,2286,2284,-18,-20,4058,"9,272.62",29928
,20170609,2286,2284,2286,2298,2254,2254,2272,-30,-12,5440,"12,367.00",27966
,20170612,2254,2272,2210,2268,2202,2232,2244,-40,-28,9782,"21,954.78",22582
,20170613,2232,2244,2312,2320,2200,2200,2232,-44,-12,640,"1,428.58",22296
,20170614,2200,2232,2220,2298,2152,2260,2224,28,-8,1090,"2,425.04",21898
,20170615,2260,2224,2172,2238,2160,2210,2206,-14,-18,2946,"6,501.77",20992
bu1707,20170117,2748,2748,2840,2840,2666,2702,2746,-46,-2,10,27.47,4
,20170118,2702,2746,2726,2726,2726,2726,2726,-20,-20,2,5.45,2
,20170119,2726,2726,,,,2726,2726,0,0,0,0.00,2
,20170120,2726,2726,2584,2688,2570,2610,2618,-116,-108,614,"1,607.66",6
,20170123,2610,2618,2620,2620,2620,2620,2620,2,2,4,10.48,2
,20170124,2620,2620,,,,2620,2620,0,0,0,0.00,2
,20170125,2620,2620,,,,2620,2620,0,0,0,0.00,2
,20170126,2620,2620,,,,2654,2654,34,34,0,0.00,2
,20170203,2654,2654,,,,2694,2694,40,40,0,0.00,2
,20170206,2694,2694,2760,2760,2760,2760,2760,66,66,2,5.52,4
,20170207,2760,2760,2724,2750,2724,2750,2736,-10,-24,4,10.95,4
,20170208,2750,2736,2758,2758,2706,2742,2730,6,-6,10,27.30,4
,20170209,2742,2730,,,,2730,2730,0,0,0,0.00,4
,20170210,2730,2730,,,,2754,2754,24,24,0,0.00,4
,20170213,2754,2754,2828,2910,2828,2910,2880,156,126,6,17.28,6
,20170214,2910,2880,,,,2882,2882,2,2,0,0.00,6
,20170215,2882,2882,,,,2882,2882,0,0,0,0.00,6
,20170216,2882,2882,2890,2904,2784,2812,2844,-70,-38,94,267.41,26
,20170217,2812,2844,2854,2854,2854,2854,2854,10,10,2,5.71,24
,20170220,2854,2854,2844,2886,2794,2886,2838,32,-16,30,85.19,20
,20170221,2886,2838,2852,2878,2852,2878,2864,40,26,4,11.46,18
,20170222,2878,2864,2934,2934,2934,2934,2934,70,70,2,5.87,18
,20170223,2934,2934,2904,2914,2888,2888,2900,-46,-34,10,29.02,12
,20170224,2888,2900,2868,2908,2852,2908,2876,8,-24,6,17.26,10
,20170227,2908,2876,3000,3000,2912,2912,2940,36,64,6,17.65,10
,20170228,2912,2940,,,,2940,2940,0,0,0,0.00,10
,20170301,2940,2940,,,,2940,2940,0,0,0,0.00,10
,20170302,2940,2940,2962,2962,2916,2954,2960,14,20,406,"1,201.84",28
,20170303,2954,2960,2880,2924,2880,2888,2900,-72,-60,8,23.20,28
,20170306,2888,2900,2876,2876,2876,2876,2876,-24,-24,2,5.75,28
,20170307,2876,2876,,,,2876,2876,0,0,0,0.00,28
,20170308,2876,2876,2938,2938,2844,2856,2890,-20,14,20,57.80,24
,20170309,2856,2890,,,,2752,2752,-138,-138,0,0.00,24
,20170310,2752,2752,2720,2720,2706,2706,2712,-46,-40,4,10.85,24
,20170313,2706,2712,,,,2712,2712,0,0,0,0.00,24
,20170314,2712,2712,2708,2738,2708,2738,2722,26,10,4,10.89,22
,20170315,2738,2722,,,,2722,2722,0,0,0,0.00,22
,20170316,2722,2722,2718,2718,2718,2718,2718,-4,-4,2,5.44,24
,20170317,2718,2718,,,,2718,2718,0,0,0,0.00,24
,20170320,2718,2718,2738,2776,2684,2718,2740,0,22,98,268.66,28
,20170321,2718,2740,,,,2740,2740,0,0,0,0.00,28
,20170322,2740,2740,2704,2704,2626,2660,2666,-80,-74,34,90.71,24
,20170323,2660,2666,2674,2674,2648,2648,2670,-18,4,24,64.12,46
,20170324,2648,2670,2650,2650,2650,2650,2650,-20,-20,2,5.30,48
,20170327,2650,2650,2600,2600,2540,2564,2572,-86,-78,48,123.50,66
,20170328,2564,2572,2578,2622,2552,2612,2596,40,24,40,103.90,54
,20170329,2612,2596,2620,2658,2620,2658,2628,62,32,10,26.30,50
,20170330,2658,2628,,,,2640,2640,12,12,0,0.00,50
,20170331,2640,2640,2656,2676,2640,2676,2656,36,16,6,15.94,48
,20170405,2676,2656,2738,2766,2738,2766,2746,110,90,6,16.48,46
,20170406,2766,2746,2748,2796,2748,2796,2766,50,20,60,166.04,22
,20170407,2796,2766,2760,2794,2710,2764,2732,-2,-34,102,278.80,68
,20170410,2764,2732,2744,2872,2728,2750,2796,18,64,156,436.35,12
,20170411,2750,2796,2758,2788,2600,2600,2682,-196,-114,18,48.30,16
,20170412,2600,2682,2578,2604,2532,2602,2574,-80,-108,12,30.90,10
,20170413,2602,2574,,,,2574,2574,0,0,0,0.00,10
,20170414,2574,2574,2446,2492,2446,2492,2472,-82,-102,16,39.56,10
,20170417,2492,2472,,,,2480,2480,8,8,0,0.00,10
,20170418,2480,2480,2506,2506,2506,2506,2506,26,26,4,10.02,10
,20170419,2506,2506,,,,2478,2478,-28,-28,0,0.00,10
,20170420,2478,2478,2508,2508,2454,2508,2490,30,12,68,169.44,24
,20170421,2508,2490,,,,2490,2490,0,0,0,0.00,24
,20170424,2490,2490,2476,2476,2476,2476,2476,-14,-14,4,9.90,20
,20170425,2476,2476,2462,2532,2462,2466,2508,-10,32,32,80.30,16
,20170426,2466,2508,2492,2492,2492,2492,2492,-16,-16,2,4.98,18
,20170427,2492,2492,2542,2556,2520,2532,2542,40,50,16,40.68,22
,20170428,2532,2542,2532,2600,2532,2570,2566,28,24,6,15.40,24
,20170502,2570,2566,,,,2566,2566,0,0,0,0.00,24
,20170503,2566,2566,,,,2566,2566,0,0,0,0.00,24
,20170504,2566,2566,2534,2534,2506,2506,2510,-60,-56,14,35.14,28
,20170505,2506,2510,,,,2408,2408,-102,-102,0,0.00,28
,20170508,2408,2408,2452,2452,2410,2446,2434,38,26,28,68.18,28
,20170509,2446,2434,,,,2434,2434,0,0,0,0.00,28
,20170510,2434,2434,,,,2434,2434,0,0,0,0.00,28
,20170511,2434,2434,2460,2460,2414,2448,2442,14,8,24,58.62,20
,20170512,2448,2442,2458,2458,2458,2458,2458,16,16,2,4.92,18
,20170515,2458,2458,,,,2458,2458,0,0,0,0.00,18
,20170516,2458,2458,,,,2504,2504,46,46,0,0.00,18
,20170517,2504,2504,,,,2504,2504,0,0,0,0.00,18
,20170518,2504,2504,,,,2504,2504,0,0,0,0.00,18
,20170519,2504,2504,2538,2578,2538,2578,2554,74,50,122,311.79,12
,20170522,2578,2554,,,,2554,2554,0,0,0,0.00,12
,20170523,2554,2554,,,,2554,2554,0,0,0,0.00,12
,20170524,2554,2554,2522,2522,2486,2486,2494,-68,-60,8,19.96,20
,20170525,2486,2494,2500,2500,2500,2500,2500,6,6,2,5.00,18
,20170526,2500,2500,,,,2500,2500,0,0,0,0.00,18
,20170531,2500,2500,,,,2402,2402,-98,-98,0,0.00,18
,20170601,2402,2402,,,,2348,2348,-54,-54,0,0.00,18
,20170602,2348,2348,2342,2342,2310,2310,2326,-38,-22,4,9.30,20
,20170605,2310,2326,2332,2332,2332,2332,2332,6,6,2,4.66,20
,20170606,2332,2332,,,,2332,2332,0,0,0,0.00,20
,20170607,2332,2332,,,,2332,2332,0,0,0,0.00,20
,20170608,2332,2332,2336,2336,2320,2320,2328,-12,-4,4,9.31,20
,20170609,2320,2328,2350,2350,2320,2320,2330,-8,2,6,13.98,22
,20170612,2320,2330,2318,2318,2288,2288,2302,-42,-28,4,9.21,24
,20170613,2288,2302,,,,2302,2302,0,0,0,0.00,24
,20170614,2302,2302,2202,2270,2202,2270,2246,-32,-56,6,13.48,22
,20170615,2270,2246,2300,2300,2300,2300,2300,54,54,6,13.80,28
,20170616,2300,2300,2284,2286,2242,2242,2270,-58,-30,18,40.87,24
,20170619,2242,2270,2296,2312,2296,2300,2302,30,32,6,13.82,26
,20170620,2300,2302,,,,2302,2302,0,0,0,0.00,26
,20170621,2302,2302,2280,2280,2256,2256,2270,-46,-32,6,13.63,26
,20170622,2256,2270,2270,2270,2270,2270,2270,0,0,2,4.54,24
,20170623,2270,2270,,,,2270,2270,0,0,0,0.00,24
,20170626,2270,2270,2312,2312,2234,2282,2278,12,8,46,104.84,30
,20170627,2282,2278,2234,2290,2234,2290,2252,12,-26,6,13.52,28
,20170628,2290,2252,2322,2328,2274,2274,2310,22,58,8,18.49,22
,20170629,2274,2310,2340,2340,2340,2340,2340,30,30,2,4.68,22
,20170630,2340,2340,2312,2312,2310,2310,2310,-30,-30,10,23.11,22
,20170703,2310,2310,2332,2332,2332,2332,2332,22,22,4,9.33,18
,20170704,2332,2332,2236,2236,2236,2236,2236,-96,-96,2,4.47,18
,20170705,2236,2236,2266,2266,2242,2242,2250,6,14,6,13.50,18
,20170706,2242,2250,,,,2250,2250,0,0,0,0.00,18
,20170707,2250,2250,,,,2250,2250,0,0,0,0.00,18
,20170710,2250,2250,,,,2250,2250,0,0,0,0.00,18
,20170711,2250,2250,2290,2290,2290,2290,2290,40,40,2,4.58,16
,20170712,2290,2290,2340,2342,2300,2300,2310,10,20,16,36.96,14
,20170713,2300,2310,,,,2310,2310,0,0,0,0.00,14
,20170714,2310,2310,,,,2310,2310,0,0,0,0.00,14
,20170717,2310,2310,,,,2310,2310,0,0,0,0.00,14
bu1708,20170216,2882,2882,,,,2882,2882,0,0,0,0.00,0
,20170217,2882,2882,,,,2882,2882,0,0,0,0.00,0
,20170220,2882,2882,,,,2882,2882,0,0,0,0.00,0
,20170221,2882,2882,,,,2882,2882,0,0,0,0.00,0
,20170222,2882,2882,,,,2882,2882,0,0,0,0.00,0
,20170223,2882,2882,,,,2882,2882,0,0,0,0.00,0
,20170224,2882,2882,,,,2882,2882,0,0,0,0.00,0
,20170227,2882,2882,,,,2882,2882,0,0,0,0.00,0
,20170228,2882,2882,2970,3016,2906,2908,2962,26,80,20,59.27,6
,20170301,2908,2962,2908,3054,2908,3054,2982,92,20,6,17.90,4
,20170302,3054,2982,2992,2992,2992,2992,2992,10,10,2,5.98,4
,20170303,2992,2992,2962,2962,2928,2928,2944,-64,-48,4,11.78,2
,20170306,2928,2944,,,,2944,2944,0,0,0,0.00,2
,20170307,2944,2944,,,,2944,2944,0,0,0,0.00,2
,20170308,2944,2944,2902,2904,2832,2832,2892,-112,-52,14,40.49,4
,20170309,2832,2892,2834,2834,2708,2708,2794,-184,-98,8,22.36,6
,20170310,2708,2794,2728,2772,2728,2772,2750,-22,-44,4,11.00,6
,20170313,2772,2750,2690,2690,2682,2682,2686,-68,-64,4,10.74,6
,20170314,2682,2686,,,,2686,2686,0,0,0,0.00,6
,20170315,2686,2686,,,,2686,2686,0,0,0,0.00,6
,20170316,2686,2686,,,,2682,2682,-4,-4,0,0.00,6
,20170317,2682,2682,,,,2674,2674,-8,-8,0,0.00,6
,20170320,2674,2674,,,,2696,2696,22,22,0,0.00,6
,20170321,2696,2696,,,,2692,2692,-4,-4,0,0.00,6
,20170322,2692,2692,,,,2692,2692,0,0,0,0.00,6
,20170323,2692,2692,,,,2696,2696,4,4,0,0.00,6
,20170324,2696,2696,,,,2674,2674,-22,-22,0,0.00,6
,20170327,2674,2674,,,,2596,2596,-78,-78,0,0.00,6
,20170328,2596,2596,,,,2620,2620,24,24,0,0.00,6
,20170329,2620,2620,,,,2652,2652,32,32,0,0.00,6
,20170330,2652,2652,,,,2664,2664,12,12,0,0.00,6
,20170331,2664,2664,,,,2680,2680,16,16,0,0.00,6
,20170405,2680,2680,,,,2772,2772,92,92,0,0.00,6
,20170406,2772,2772,2846,2848,2846,2848,2846,76,74,4,11.39,6
,20170407,2848,2846,,,,2812,2812,-34,-34,0,0.00,6
,20170410,2812,2812,2732,2788,2732,2788,2760,-24,-52,4,11.04,6
,20170411,2788,2760,,,,2648,2648,-112,-112,0,0.00,6
,20170412,2648,2648,2626,2652,2626,2652,2638,4,-10,4,10.56,4
,20170413,2652,2638,2564,2628,2564,2628,2596,-10,-42,34,88.28,8
,20170414,2628,2596,,,,2492,2492,-104,-104,0,0.00,8
,20170417,2492,2492,,,,2506,2506,14,14,0,0.00,8
,20170418,2506,2506,2486,2518,2486,2518,2490,12,-16,16,39.84,20
,20170419,2518,2490,2494,2496,2420,2496,2458,6,-32,72,177.00,50
,20170420,2496,2458,2514,2516,2428,2494,2444,36,-14,52,127.10,88
,20170421,2494,2444,2538,2582,2510,2540,2548,96,104,26,66.26,88
,20170424,2540,2548,,,,2532,2532,-16,-16,0,0.00,88
,20170425,2532,2532,2526,2526,2500,2500,2508,-32,-24,6,15.06,84
,20170426,2500,2508,2472,2556,2472,2532,2512,24,4,304,763.68,92
,20170427,2532,2512,2542,2556,2542,2556,2550,44,38,12,30.61,92
,20170428,2556,2550,2552,2588,2548,2584,2578,34,28,28,72.23,66
,20170502,2584,2578,,,,2578,2578,0,0,0,0.00,66
,20170503,2578,2578,,,,2578,2578,0,0,0,0.00,66
,20170504,2578,2578,2466,2480,2466,2480,2474,-98,-104,6,14.85,66
,20170505,2480,2474,2450,2462,2450,2456,2450,-18,-24,64,156.84,14
,20170508,2456,2450,2446,2446,2446,2446,2446,-4,-4,2,4.89,14
,20170509,2446,2446,,,,2446,2446,0,0,0,0.00,14
,20170510,2446,2446,,,,2446,2446,0,0,0,0.00,14
,20170511,2446,2446,2470,2474,2446,2474,2462,28,16,6,14.78,12
,20170512,2474,2462,,,,2462,2462,0,0,0,0.00,12
,20170515,2462,2462,2446,2516,2446,2516,2492,54,30,8,19.94,14
,20170516,2516,2492,,,,2510,2510,18,18,0,0.00,14
,20170517,2510,2510,,,,2510,2510,0,0,0,0.00,14
,20170518,2510,2510,,,,2510,2510,0,0,0,0.00,14
,20170519,2510,2510,2582,2586,2582,2586,2584,76,74,4,10.34,10
,20170522,2586,2584,2560,2608,2560,2608,2584,24,0,8,20.67,10
,20170523,2608,2584,,,,2584,2584,0,0,0,0.00,10
,20170524,2584,2584,2516,2516,2494,2510,2506,-74,-78,6,15.04,12
,20170525,2510,2506,2510,2514,2510,2514,2512,8,6,4,10.05,12
,20170526,2514,2512,,,,2512,2512,0,0,0,0.00,12
,20170531,2512,2512,2336,2336,2336,2336,2336,-176,-176,2,4.67,14
,20170601,2336,2336,2270,2334,2270,2334,2302,-2,-34,4,9.21,14
,20170602,2334,2302,,,,2302,2302,0,0,0,0.00,14
,20170605,2302,2302,,,,2302,2302,0,0,0,0.00,14
,20170606,2302,2302,2330,2344,2256,2344,2326,42,24,322,749.50,40
,20170607,2344,2326,2338,2338,2338,2338,2338,12,12,2,4.68,40
,20170608,2338,2338,2338,2338,2302,2302,2320,-36,-18,4,9.28,40
,20170609,2302,2320,,,,2320,2320,0,0,0,0.00,40
,20170612,2320,2320,2322,2360,2288,2332,2328,12,8,10,23.28,40
,20170613,2332,2328,2320,2320,2320,2320,2320,-8,-8,10,23.20,40
,20170614,2320,2320,2322,2322,2244,2268,2270,-52,-50,42,95.37,38
,20170615,2268,2270,2298,2298,2266,2268,2276,-2,6,6,13.66,38
,20170616,2268,2276,,,,2276,2276,0,0,0,0.00,38
,20170619,2276,2276,2242,2250,2242,2250,2246,-26,-30,4,8.98,38
,20170620,2250,2246,,,,2248,2248,2,2,0,0.00,38
,20170621,2248,2248,2224,2242,2176,2200,2198,-48,-50,92,202.38,58
,20170622,2200,2198,2198,2270,2198,2232,2242,34,44,96,215.40,12
,20170623,2232,2242,,,,2242,2242,0,0,0,0.00,12
,20170626,2242,2242,2234,2284,2230,2284,2248,42,6,164,368.93,14
,20170627,2284,2248,2266,2278,2250,2266,2260,18,12,44,99.46,20
,20170628,2266,2260,2292,2312,2292,2304,2306,44,46,114,262.89,128
,20170629,2304,2306,2328,2366,2318,2360,2324,54,18,138,320.81,20
,20170630,2360,2324,2346,2346,2344,2346,2344,22,20,6,14.07,18
,20170703,2346,2344,2358,2392,2358,2366,2368,22,24,10,23.69,24
,20170704,2366,2368,,,,2368,2368,0,0,0,0.00,24
,20170705,2368,2368,2344,2370,2344,2350,2354,-18,-14,24,56.50,24
,20170706,2350,2354,2290,2352,2290,2352,2330,-2,-24,6,13.98,28
,20170707,2352,2330,2382,2382,2342,2342,2360,12,30,8,18.88,28
,20170710,2342,2360,2346,2348,2346,2346,2346,-14,-14,16,37.54,32
,20170711,2346,2346,2370,2400,2370,2400,2384,54,38,38,90.62,64
,20170712,2400,2384,2400,2454,2396,2396,2426,12,42,42,101.91,92
,20170713,2396,2426,,,,2426,2426,0,0,0,0.00,92
,20170714,2426,2426,2426,2428,2426,2428,2426,2,0,4,9.71,92
,20170717,2428,2426,2506,2512,2460,2512,2502,86,76,54,135.17,122
,20170718,2512,2502,2520,2520,2500,2502,2516,0,14,20,50.32,122
,20170719,2502,2516,2508,2534,2508,2534,2520,18,4,4,10.08,122
,20170720,2534,2520,,,,2520,2520,0,0,0,0.00,122
,20170721,2520,2520,2528,2528,2476,2476,2482,-44,-38,20,49.67,122
,20170724,2476,2482,2460,2542,2442,2468,2490,-14,8,22,54.79,124
,20170725,2468,2490,2580,2580,2580,2580,2580,90,90,2,5.16,124
,20170726,2580,2580,2638,2638,2560,2568,2568,-12,-12,46,118.21,124
,20170727,2568,2568,2600,2600,2600,2600,2600,32,32,8,20.80,132
,20170728,2600,2600,,,,2596,2596,-4,-4,0,0.00,132
,20170731,2596,2596,2544,2640,2544,2640,2592,44,-4,4,10.37,134
,20170801,2640,2592,2620,2620,2600,2600,2610,8,18,30,78.33,162
,20170802,2600,2610,2604,2604,2476,2526,2520,-84,-90,32,80.68,162
,20170803,2526,2520,,,,2520,2520,0,0,0,0.00,162
,20170804,2520,2520,2482,2544,2452,2452,2494,-68,-26,50,124.77,162
,20170807,2452,2494,2482,2530,2450,2450,2486,-44,-8,6,14.92,162
,20170808,2450,2486,,,,2486,2486,0,0,0,0.00,162
,20170809,2486,2486,2478,2500,2478,2500,2490,14,4,10,24.91,162
,20170810,2500,2490,,,,2490,2490,0,0,0,0.00,162
,20170811,2490,2490,,,,2490,2490,0,0,0,0.00,162
,20170814,2490,2490,,,,2490,2490,0,0,0,0.00,162
,20170815,2490,2490,2346,2490,2346,2490,2392,0,-98,24,57.42,162
bu1709,20170103,2824,2810,2826,2890,2744,2752,2802,-58,-8,26198,"73,447.05",25904
,20170104,2752,2802,2776,2796,2706,2772,2764,-30,-38,21896,"60,549.06",26472
,20170105,2772,2764,2780,2806,2746,2754,2770,-10,6,13948,"38,662.50",27066
,20170106,2754,2770,2762,2836,2760,2784,2798,14,28,15582,"43,605.34",27756
,20170109,2784,2798,2792,2828,2768,2816,2796,18,-2,14532,"40,653.00",28048
,20170110,2816,2796,2796,2798,2726,2768,2756,-28,-40,22372,"61,683.18",31786
,20170111,2768,2756,2768,2842,2744,2768,2794,12,38,23360,"65,304.49",34854
,20170112,2768,2794,2768,2822,2750,2796,2788,2,-6,15384,"42,892.87",35712
,20170113,2796,2788,2810,2858,2804,2834,2828,46,40,16152,"45,689.36",37316
,20170116,2834,2828,2828,2880,2810,2838,2848,10,20,17288,"49,240.20",36942
,20170117,2838,2848,2840,2868,2772,2774,2830,-74,-18,17610,"49,839.34",35482
,20170118,2774,2830,2794,2816,2762,2780,2784,-50,-46,14164,"39,439.10",37172
,20170119,2780,2784,2770,2770,2726,2756,2748,-28,-36,16790,"46,161.78",39016
,20170120,2756,2748,2756,2790,2680,2684,2734,-64,-14,17526,"47,922.77",40188
,20170123,2684,2734,2696,2740,2692,2700,2710,-34,-24,12294,"33,334.56",41600
,20170124,2700,2710,2688,2760,2684,2748,2734,38,24,8918,"24,387.72",41096
,20170125,2748,2734,2742,2760,2710,2746,2742,12,8,9928,"27,222.61",41362
,20170126,2746,2742,2742,2798,2734,2798,2770,56,28,8326,"23,063.63",41244
,20170203,2798,2770,2802,2826,2766,2810,2796,40,26,20180,"56,439.08",48362
,20170206,2810,2796,2796,2836,2796,2834,2820,38,24,14094,"39,757.27",52366
,20170207,2834,2820,2834,2834,2786,2816,2808,-4,-12,11170,"31,386.90",53354
,20170208,2816,2808,2802,2850,2782,2848,2810,40,2,14890,"41,869.88",55162
,20170209,2848,2810,2850,2860,2814,2824,2842,14,32,13656,"38,825.70",56692
,20170210,2824,2842,2816,2910,2816,2896,2864,54,22,23894,"68,455.11",59256
,20170213,2896,2864,2904,3054,2904,3012,3000,148,136,40454,"121,432.12",63312
,20170214,3012,3000,3004,3034,2982,3010,3008,10,8,20514,"61,708.70",64274
,20170215,3010,3008,3014,3048,2904,2910,2964,-98,-44,35142,"104,201.47",62616
,20170216,2910,2964,2910,2956,2860,2886,2910,-78,-54,30056,"87,515.41",63514
,20170217,2886,2910,2892,2926,2864,2888,2896,-22,-14,19934,"57,741.14",63646
,20170220,2888,2896,2882,2982,2854,2980,2926,84,30,31306,"91,617.81",65104
,20170221,2980,2926,2970,2998,2920,2942,2962,16,36,30376,"89,977.24",63036
,20170222,2942,2962,2956,3006,2950,2996,2980,34,18,40544,"120,830.69",63604
,20170223,2996,2980,2980,2994,2880,2900,2950,-80,-30,41060,"121,189.94",61600
,20170224,2900,2950,2906,2972,2870,2972,2920,22,-30,35522,"103,743.71",62566
,20170227,2972,2920,2968,3036,2960,3020,3004,100,84,38846,"116,725.39",65078
,20170228,3020,3004,3020,3034,2966,2980,2998,-24,-6,25006,"75,001.84",63364
,20170301,2980,2998,2982,3044,2956,3032,3006,34,8,46688,"140,391.78",66370
,20170302,3032,3006,3044,3048,2984,2986,3010,-20,4,35002,"105,418.08",65688
,20170303,2986,3010,2966,2980,2930,2966,2960,-44,-50,32622,"96,596.90",67488
,20170306,2966,2960,2964,2984,2866,2922,2942,-38,-18,55160,"162,316.58",80692
,20170307,2922,2942,2920,2958,2920,2944,2942,2,0,25744,"75,780.46",80840
,20170308,2944,2942,2948,3004,2870,2880,2936,-62,-6,86984,"255,477.09",86244
,20170309,2880,2936,2892,2892,2750,2766,2798,-170,-138,90118,"252,292.57",84054
,20170310,2766,2798,2740,2782,2716,2736,2746,-62,-52,69738,"191,594.08",95842
,20170313,2736,2746,2746,2798,2680,2788,2728,42,-18,86002,"234,764.64",99588
,20170314,2788,2728,2776,2788,2702,2708,2744,-20,16,62010,"170,274.68",107102
,20170315,2708,2744,2660,2768,2660,2746,2722,2,-22,79504,"216,454.25",117328
,20170316,2746,2722,2760,2786,2730,2756,2754,34,32,65296,"179,895.27",120468
,20170317,2756,2754,2758,2762,2708,2746,2738,-8,-16,57570,"157,676.23",124610
,20170320,2746,2738,2746,2790,2716,2746,2752,8,14,64296,"177,057.38",128868
,20170321,2746,2752,2730,2762,2720,2756,2740,4,-12,64570,"177,036.93",136062
,20170322,2756,2740,2750,2756,2630,2642,2684,-98,-56,102524,"275,196.97",143182
,20170323,2642,2684,2636,2690,2612,2644,2650,-40,-34,82364,"218,294.13",138172
,20170324,2644,2650,2624,2668,2624,2646,2646,-4,-4,60390,"159,808.64",139970
,20170327,2646,2646,2650,2658,2582,2600,2606,-46,-40,95710,"249,428.50",143102
,20170328,2600,2606,2606,2668,2598,2648,2638,42,32,97468,"257,205.52",152478
,20170329,2648,2638,2648,2682,2640,2678,2662,40,24,81338,"216,578.63",149572
,20170330,2678,2662,2676,2700,2646,2682,2672,20,10,94290,"252,012.28",151484
,20170331,2682,2672,2688,2710,2670,2690,2688,18,16,79306,"213,287.32",145004
,20170405,2690,2688,2748,2876,2722,2862,2822,174,134,169798,"479,427.75",165412
,20170406,2862,2822,2878,2884,2834,2872,2858,50,36,136632,"390,603.40",168974
,20170407,2872,2858,2878,2914,2796,2824,2846,-34,-12,359210,"1,022,708.19",184330
,20170410,2824,2846,2812,2856,2780,2816,2812,-30,-34,270482,"761,032.41",197404
,20170411,2816,2812,2822,2840,2638,2652,2742,-160,-70,458512,"1,257,994.20",227034
,20170412,2652,2742,2648,2678,2618,2642,2650,-100,-92,270774,"718,084.88",244706
,20170413,2642,2650,2640,2680,2612,2658,2650,8,0,260926,"691,751.39",250392
,20170414,2658,2650,2662,2674,2520,2542,2580,-108,-70,460638,"1,188,882.28",256092
,20170417,2542,2580,2538,2614,2536,2572,2572,-8,-8,362248,"931,842.13",274512
,20170418,2572,2572,2578,2588,2530,2546,2554,-26,-18,270510,"691,175.03",288622
,20170419,2546,2554,2558,2598,2472,2586,2536,32,-18,501304,"1,271,509.25",300372
,20170420,2586,2536,2578,2612,2498,2580,2554,44,18,456546,"1,166,334.74",299098
,20170421,2580,2554,2574,2604,2538,2562,2570,8,16,477962,"1,228,603.05",315938
,20170424,2562,2570,2562,2566,2518,2550,2542,-20,-28,443418,"1,127,607.67",345078
,20170425,2550,2542,2538,2584,2536,2568,2562,26,20,436720,"1,119,579.64",378140
,20170426,2568,2562,2554,2568,2494,2532,2526,-30,-36,881824,"2,228,412.04",440726
,20170427,2532,2526,2530,2588,2512,2586,2562,60,36,768826,"1,970,383.52",436702
,20170428,2586,2562,2564,2648,2562,2638,2606,76,44,837834,"2,183,573.31",431722
,20170502,2638,2606,2636,2646,2606,2634,2626,28,20,370132,"972,399.56",447732
,20170503,2634,2626,2640,2646,2614,2634,2630,8,4,489678,"1,288,029.42",454340
,20170504,2634,2630,2624,2628,2480,2534,2550,-96,-80,1017558,"2,596,615.77",404394
,20170505,2534,2550,2520,2532,2412,2418,2466,-132,-84,1054616,"2,600,793.76",470550
,20170508,2418,2466,2430,2488,2430,2456,2458,-10,-8,652098,"1,603,369.70",446198
,20170509,2456,2458,2442,2478,2432,2468,2460,10,2,506390,"1,246,163.28",463628
,20170510,2468,2460,2460,2488,2438,2456,2460,-4,0,724454,"1,783,517.13",466522
,20170511,2456,2460,2468,2506,2446,2486,2476,26,16,970482,"2,404,080.88",482558
,20170512,2486,2476,2486,2498,2410,2458,2448,-18,-28,916918,"2,245,224.62",494408
,20170515,2458,2448,2460,2524,2448,2518,2484,70,36,698732,"1,736,006.09",475114
,20170516,2518,2484,2538,2556,2506,2554,2528,70,44,632034,"1,598,400.04",480300
,20170517,2554,2528,2554,2566,2528,2542,2544,14,16,588694,"1,498,459.53",456336
,20170518,2542,2544,2550,2568,2502,2550,2534,6,-10,815148,"2,066,922.27",475900
,20170519,2550,2534,2534,2606,2520,2596,2572,62,38,872552,"2,245,823.09",489584
,20170522,2596,2572,2602,2626,2582,2600,2604,28,32,682824,"1,778,732.82",509826
,20170523,2600,2604,2604,2624,2512,2518,2568,-86,-36,1009130,"2,591,675.29",510182
,20170524,2518,2568,2518,2536,2476,2516,2514,-52,-54,671976,"1,690,282.10",508694
,20170525,2516,2514,2504,2590,2504,2570,2550,56,36,731192,"1,864,903.23",509422
,20170526,2570,2550,2548,2560,2442,2474,2486,-76,-64,820480,"2,040,467.16",483474
,20170531,2474,2486,2476,2488,2322,2342,2400,-144,-86,732080,"1,757,907.98",556946
,20170601,2342,2400,2332,2372,2318,2354,2344,-46,-56,479544,"1,124,805.62",555638
,20170602,2354,2344,2348,2358,2308,2314,2330,-30,-14,589550,"1,374,762.41",589112
,20170605,2314,2330,2308,2364,2292,2346,2338,16,8,553922,"1,296,073.84",558402
,20170606,2346,2338,2328,2384,2316,2372,2350,34,12,632932,"1,487,394.20",553672
,20170607,2372,2350,2368,2382,2350,2364,2366,14,16,467468,"1,106,197.63",556006
,20170608,2364,2366,2356,2366,2318,2350,2340,-16,-26,726104,"1,700,504.52",553486
,20170609,2350,2340,2340,2364,2324,2332,2344,-8,4,467456,"1,096,209.04",566458
,20170612,2332,2344,2336,2362,2310,2340,2340,-4,-4,665564,"1,558,282.55",599636
,20170613,2340,2340,2350,2370,2306,2318,2336,-22,-4,772360,"1,805,729.68",638888
,20170614,2318,2336,2312,2330,2262,2326,2296,-10,-40,1212004,"2,783,038.30",645932
,20170615,2326,2296,2326,2340,2286,2292,2310,-4,14,863914,"1,996,274.20",660724
,20170616,2292,2310,2288,2320,2274,2304,2300,-6,-10,660490,"1,519,773.42",663754
,20170619,2304,2300,2312,2320,2258,2302,2296,2,-4,895938,"2,058,615.83",679304
,20170620,2302,2296,2306,2330,2294,2316,2310,20,14,792662,"1,832,244.30",698542
,20170621,2316,2310,2290,2312,2246,2266,2274,-44,-36,1070740,"2,436,730.64",785416
,20170622,2266,2274,2274,2284,2238,2250,2262,-24,-12,872010,"1,973,299.95",777942
,20170623,2250,2262,2258,2274,2248,2264,2260,2,-2,491608,"1,111,858.59",751318
,20170626,2264,2260,2264,2288,2244,2280,2270,20,10,574548,"1,304,878.04",726126
,20170627,2280,2270,2278,2294,2260,2294,2274,24,4,554676,"1,261,880.24",725164
,20170628,2294,2274,2298,2324,2290,2302,2306,28,32,689450,"1,590,788.41",697422
,20170629,2302,2306,2310,2360,2300,2342,2338,36,32,1086858,"2,543,122.52",690214
,20170630,2342,2338,2350,2362,2330,2352,2346,14,8,546400,"1,282,032.22",675358
,20170703,2352,2346,2352,2384,2350,2366,2370,20,24,724374,"1,716,829.71",681384
,20170704,2366,2370,2368,2392,2304,2330,2348,-40,-22,793870,"1,864,931.34",678866
,20170705,2330,2348,2330,2376,2328,2368,2354,20,6,623604,"1,468,567.59",666816
,20170706,2368,2354,2354,2376,2328,2374,2350,20,-4,734262,"1,726,466.68",678930
,20170707,2374,2350,2378,2412,2360,2376,2382,26,32,966554,"2,304,049.15",705408
,20170710,2376,2382,2374,2398,2346,2376,2372,-6,-10,740708,"1,757,821.80",687948
,20170711,2376,2372,2370,2472,2370,2448,2430,76,58,1049926,"2,553,008.90",726576
,20170712,2448,2430,2444,2494,2438,2452,2458,22,28,866896,"2,132,221.78",692584
,20170713,2452,2458,2452,2480,2430,2476,2460,18,2,745350,"1,834,281.66",705890
,20170714,2476,2460,2484,2534,2450,2514,2500,54,40,1233954,"3,085,591.84",709618
,20170717,2514,2500,2518,2584,2510,2574,2556,74,56,983528,"2,515,279.48",663390
,20170718,2574,2556,2572,2596,2552,2564,2574,8,18,649900,"1,672,898.72",635592
,20170719,2564,2574,2576,2608,2576,2596,2590,22,16,606816,"1,572,777.61",640036
,20170720,2596,2590,2598,2618,2570,2574,2594,-16,4,890886,"2,311,472.75",616022
,20170721,2574,2594,2584,2588,2524,2548,2552,-46,-42,823928,"2,102,816.10",553234
,20170724,2548,2552,2538,2568,2516,2558,2548,6,-4,593742,"1,513,226.90",555922
,20170725,2558,2548,2566,2654,2560,2644,2618,96,70,991876,"2,598,210.14",577056
,20170726,2644,2618,2654,2670,2614,2626,2642,8,24,924110,"2,441,653.15",526018
,20170727,2626,2642,2634,2676,2618,2650,2646,8,4,665126,"1,760,505.44",511688
,20170728,2650,2646,2644,2662,2568,2598,2618,-48,-28,846168,"2,215,707.16",439568
,20170731,2598,2618,2606,2676,2600,2670,2646,52,28,640262,"1,694,249.63",400392
,20170801,2670,2646,2660,2688,2644,2656,2664,10,18,475872,"1,268,032.23",375280
,20170802,2656,2664,2644,2656,2596,2620,2622,-44,-42,461956,"1,211,464.27",341574
,20170803,2620,2622,2626,2632,2560,2570,2602,-52,-20,369956,"962,841.29",303820
,20170804,2570,2602,2582,2618,2552,2562,2586,-40,-16,312104,"807,442.56",264818
,20170807,2562,2586,2562,2600,2502,2528,2548,-58,-38,263076,"670,390.85",214338
,20170808,2528,2548,2528,2560,2518,2558,2536,10,-12,122526,"310,829.63",186376
,20170809,2558,2536,2552,2596,2550,2580,2578,44,42,159760,"412,168.88",138012
,20170810,2580,2578,2592,2608,2560,2582,2586,4,8,96588,"249,953.11",112274
,20170811,2582,2586,2590,2604,2464,2472,2530,-114,-56,115764,"293,050.41",94094
,20170814,2472,2530,2468,2492,2464,2472,2476,-58,-54,41282,"102,231.59",87472
,20170815,2472,2476,2478,2504,2460,2478,2486,2,10,63858,"158,869.66",71374
,20170816,2478,2486,2470,2500,2460,2496,2478,10,-8,29100,"72,157.08",65036
,20170817,2496,2478,2510,2550,2470,2538,2522,60,44,41470,"104,669.86",60592
,20170818,2538,2522,2534,2560,2518,2558,2544,36,22,27030,"68,804.74",62174
,20170821,2558,2544,2558,2570,2530,2544,2552,0,8,29374,"74,970.02",60112
,20170822,2544,2552,2550,2558,2506,2550,2534,-2,-18,25632,"64,996.58",59422
,20170823,2550,2534,2546,2580,2520,2548,2552,14,18,43090,"110,015.00",51300
,20170824,2548,2552,2548,2582,2540,2578,2560,26,8,18418,"47,156.07",47686
,20170825,2578,2560,2566,2614,2562,2594,2586,34,26,24200,"62,600.74",43786
,20170828,2594,2586,2582,2604,2564,2578,2584,-8,-2,11666,"30,164.30",42508
,20170829,2578,2584,2578,2598,2516,2540,2556,-44,-28,13114,"33,522.79",40180
,20170830,2540,2556,2540,2552,2526,2548,2540,-8,-16,7526,"19,117.40",38070
,20170831,2548,2540,2540,2540,2466,2502,2502,-38,-38,11700,"29,288.01",33428
,20170901,2502,2502,2514,2554,2508,2538,2538,36,36,6540,"16,609.62",32576
,20170904,2538,2538,2556,2576,2428,2460,2504,-78,-34,7158,"17,937.10",31552
,20170905,2460,2504,2460,2480,2422,2444,2452,-60,-52,3086,"7,570.00",30860
,20170906,2444,2452,2448,2462,2430,2436,2448,-16,-4,1790,"4,385.33",30232
,20170907,2436,2448,2438,2460,2336,2358,2384,-90,-64,3186,"7,598.10",29272
,20170908,2358,2384,2354,2366,2296,2318,2344,-66,-40,4082,"9,569.70",27370
,20170911,2318,2344,2312,2342,2288,2328,2326,-16,-18,2958,"6,881.76",26068
,20170912,2328,2326,2320,2350,2320,2336,2334,10,8,2344,"5,471.40",25262
,20170913,2336,2334,2342,2430,2228,2340,2352,6,18,1472,"3,462.47",24322
,20170914,2340,2352,2418,2418,2344,2350,2350,-2,-2,314,738.28,24246
,20170915,2350,2350,2400,2400,2396,2396,2398,46,48,1024,"2,457.50",23222
bu1710,20170418,2572,2572,,,,2572,2572,0,0,0,0.00,0
,20170419,2572,2572,2482,2628,2470,2608,2536,36,-36,898,"2,277.90",278
,20170420,2608,2536,2608,2608,2484,2570,2580,34,44,238,614.22,84
,20170421,2570,2580,2576,2666,2536,2600,2588,20,8,106,274.54,48
,20170424,2600,2588,2564,2582,2554,2572,2568,-16,-20,16,41.09,40
,20170425,2572,2568,2598,2632,2564,2564,2608,-4,40,30,78.28,54
,20170426,2564,2608,2542,2570,2526,2564,2556,-44,-52,38,97.20,24
,20170427,2564,2556,2542,2612,2542,2582,2580,26,24,316,815.62,20
,20170428,2582,2580,2616,2664,2580,2640,2622,60,42,38,99.65,18
,20170502,2640,2622,,,,2622,2622,0,0,0,0.00,18
,20170503,2622,2622,2664,2664,2664,2664,2664,42,42,2,5.33,16
,20170504,2664,2664,2622,2622,2506,2528,2580,-136,-84,62,159.99,16
,20170505,2528,2580,2568,2568,2440,2468,2466,-112,-114,440,"1,085.34",20
,20170508,2468,2466,2488,2488,2470,2470,2480,4,14,6,14.88,20
,20170509,2470,2480,2476,2494,2476,2494,2484,14,4,4,9.94,18
,20170510,2494,2484,2474,2474,2468,2468,2470,-16,-14,10,24.70,20
,20170511,2468,2470,,,,2470,2470,0,0,0,0.00,20
,20170512,2470,2470,2472,2472,2470,2470,2470,0,0,400,988.40,20
,20170515,2470,2470,2470,2500,2470,2480,2482,10,12,10,24.82,26
,20170516,2480,2482,2530,2530,2516,2516,2522,34,40,4,10.09,30
,20170517,2516,2522,2554,2580,2526,2566,2560,44,38,26,66.60,28
,20170518,2566,2560,2546,2580,2546,2564,2566,4,6,16,41.06,24
,20170519,2564,2566,2576,2596,2576,2594,2586,28,20,8,20.69,24
,20170522,2594,2586,2664,2666,2602,2654,2642,68,56,222,586.56,22
,20170523,2654,2642,2664,2664,2608,2608,2634,-34,-8,6,15.80,22
,20170524,2608,2634,2566,2566,2500,2500,2532,-134,-102,4,10.13,22
,20170525,2500,2532,2534,2568,2534,2568,2548,36,16,14,35.68,32
,20170526,2568,2548,2528,2588,2442,2478,2478,-70,-70,452,"1,120.48",438
,20170531,2478,2478,2506,2510,2348,2368,2428,-110,-50,876,"2,127.92",454
,20170601,2368,2428,2398,2398,2334,2386,2356,-42,-72,20,47.12,458
,20170602,2386,2356,2354,2384,2318,2346,2318,-10,-38,622,"1,442.66",1060
,20170605,2346,2318,2362,2376,2340,2372,2356,54,38,54,127.22,1050
,20170606,2372,2356,2348,2392,2348,2384,2376,28,20,172,408.74,1134
,20170607,2384,2376,2382,2410,2382,2394,2392,18,16,590,"1,412.34",580
,20170608,2394,2392,2372,2374,2340,2374,2356,-18,-36,130,306.28,632
,20170609,2374,2356,2378,2416,2350,2350,2380,-6,24,56,133.29,594
,20170612,2350,2380,2340,2388,2340,2362,2360,-18,-20,94,221.87,580
,20170613,2362,2360,2374,2374,2340,2344,2352,-16,-8,20,47.07,580
,20170614,2344,2352,2304,2370,2294,2370,2316,18,-36,26,60.25,580
,20170615,2370,2316,2354,2360,2310,2316,2334,0,18,52,121.42,578
,20170616,2316,2334,2314,2342,2302,2322,2322,-12,-12,50,116.17,566
,20170619,2322,2322,2332,2332,2276,2276,2308,-46,-14,54,124.67,566
,20170620,2276,2308,2318,2350,2318,2320,2336,12,28,70,163.55,570
,20170621,2320,2336,2308,2318,2266,2286,2300,-50,-36,74,170.28,574
,20170622,2286,2300,2300,2306,2264,2270,2284,-30,-16,22,50.27,568
,20170623,2270,2284,2272,2284,2272,2280,2278,-4,-6,12,27.35,568
,20170626,2280,2278,2280,2300,2268,2300,2284,22,6,70,159.88,564
,20170627,2300,2284,2288,2292,2282,2284,2286,0,2,42,96.02,564
,20170628,2284,2286,2328,2328,2314,2314,2316,28,30,84,194.54,604
,20170629,2314,2316,2338,2366,2326,2352,2350,36,34,82,192.80,604
,20170630,2352,2350,2370,2378,2350,2374,2356,24,6,32,75.39,626
,20170703,2374,2356,2384,2412,2368,2412,2378,56,22,174,414.04,626
,20170704,2412,2378,2326,2412,2326,2330,2372,-48,-6,112,265.68,612
,20170705,2330,2372,2362,2392,2356,2390,2374,18,2,114,270.77,604
,20170706,2390,2374,2380,2392,2350,2392,2368,18,-6,24,56.86,604
,20170707,2392,2368,2412,2420,2378,2390,2404,22,36,104,250.03,606
,20170710,2390,2404,2384,2412,2368,2394,2390,-10,-14,62,148.20,604
,20170711,2394,2390,2422,2476,2422,2464,2458,74,68,46,113.14,606
,20170712,2464,2458,2458,2470,2458,2470,2466,12,8,16,39.47,606
,20170713,2470,2466,2474,2486,2458,2480,2472,14,6,34,84.11,608
,20170714,2480,2472,2510,2536,2510,2536,2522,64,50,36,90.80,608
,20170717,2536,2522,2580,2598,2580,2598,2586,76,64,6,15.52,608
,20170718,2598,2586,,,,2586,2586,0,0,0,0.00,608
,20170719,2586,2586,2604,2620,2598,2610,2610,24,24,28,73.11,620
,20170720,2610,2610,2602,2606,2584,2584,2600,-26,-10,12,31.22,618
,20170721,2584,2600,2580,2584,2558,2580,2574,-20,-26,10,25.76,616
,20170724,2580,2574,2550,2580,2550,2580,2564,6,-10,6,15.39,616
,20170725,2580,2564,2594,2664,2594,2654,2630,90,66,84,220.96,616
,20170726,2654,2630,2670,2688,2638,2640,2664,10,34,30,79.92,614
,20170727,2640,2664,2636,2660,2636,2652,2650,-12,-14,8,21.20,620
,20170728,2652,2650,2678,2678,2604,2608,2618,-42,-32,24,62.87,614
,20170731,2608,2618,2654,2680,2654,2680,2666,62,48,6,16.00,616
,20170801,2680,2666,2678,2698,2660,2666,2676,0,10,112,299.77,614
,20170802,2666,2676,2640,2654,2608,2624,2622,-52,-54,90,236.03,614
,20170803,2624,2622,2612,2628,2600,2602,2612,-20,-10,56,146.35,614
,20170804,2602,2612,2602,2666,2556,2594,2622,-18,10,68,178.35,610
,20170807,2594,2622,2600,2602,2526,2536,2558,-86,-64,24,61.43,608
,20170808,2536,2558,2508,2576,2508,2552,2552,-6,-6,94,240.04,608
,20170809,2552,2552,2584,2634,2564,2608,2600,56,48,78,202.81,614
,20170810,2608,2600,2628,2674,2614,2642,2638,42,38,28,73.92,624
,20170811,2642,2638,2668,2668,2514,2514,2540,-124,-98,68,172.77,608
,20170814,2514,2540,2532,2558,2504,2504,2520,-36,-20,50,126.00,606
,20170815,2504,2520,2520,2560,2520,2552,2544,32,24,12,30.54,610
,20170816,2552,2544,2516,2558,2514,2516,2520,-28,-24,54,136.18,604
,20170817,2516,2520,2566,2590,2540,2586,2564,66,44,86,220.61,606
,20170818,2586,2564,2582,2614,2582,2608,2596,44,32,96,249.24,650
,20170821,2608,2596,2646,2646,2600,2622,2622,26,26,88,230.82,668
,20170822,2622,2622,2512,2614,2512,2604,2562,-18,-60,50,128.14,708
,20170823,2604,2562,2596,2640,2560,2588,2606,26,44,92,239.88,672
,20170824,2588,2606,2610,2632,2594,2632,2612,26,6,22,57.49,672
,20170825,2632,2612,2600,2660,2592,2642,2620,30,8,32,83.88,674
,20170828,2642,2620,2646,2646,2646,2646,2646,26,26,6,15.88,674
,20170829,2646,2646,2618,2618,2594,2594,2606,-52,-40,12,31.29,672
,20170830,2594,2606,2578,2578,2578,2578,2578,-28,-28,4,10.31,672
,20170831,2578,2578,2578,2586,2524,2564,2552,-14,-26,38,96.98,674
,20170901,2564,2552,2558,2588,2558,2588,2572,36,20,14,36.02,670
,20170904,2588,2572,2610,2612,2498,2498,2574,-74,2,170,437.84,648
,20170905,2498,2574,,,,2528,2528,-46,-46,0,0.00,648
,20170906,2528,2528,2472,2518,2422,2506,2496,-22,-32,60,149.78,656
,20170907,2506,2496,2470,2492,2424,2424,2468,-72,-28,44,108.67,656
,20170908,2424,2468,2382,2408,2382,2408,2390,-60,-78,6,14.34,654
,20170911,2408,2390,2348,2368,2334,2334,2350,-56,-40,6,14.10,652
,20170912,2334,2350,2398,2398,2338,2368,2350,18,0,14,32.91,654
,20170913,2368,2350,2328,2328,2306,2306,2316,-44,-34,4,9.27,654
,20170914,2306,2316,2332,2376,2332,2358,2352,42,36,18,42.36,654
,20170915,2358,2352,2444,2444,2304,2350,2348,-2,-4,42,98.62,652
,20170918,2350,2348,2288,2386,2288,2386,2340,38,-8,16,37.45,652
,20170919,2386,2340,,,,2340,2340,0,0,0,0.00,652
,20170920,2340,2340,2304,2304,2304,2304,2304,-36,-36,2,4.61,652
,20170921,2304,2304,2292,2354,2268,2268,2328,-36,24,62,144.40,652
,20170922,2268,2328,2338,2346,2288,2288,2318,-40,-10,10,23.20,650
,20170925,2288,2318,2306,2320,2272,2298,2304,-20,-14,448,"1,032.81",260
,20170926,2298,2304,2312,2332,2308,2310,2314,6,10,92,212.93,168
,20170927,2310,2314,2332,2334,2312,2312,2330,-2,16,82,191.19,88
,20170928,2312,2330,2360,2360,2272,2272,2300,-58,-30,10,23.00,86
,20170929,2272,2300,2266,2266,2200,2200,2222,-100,-78,6,13.34,86
,20171009,2200,2222,2220,2290,2094,2210,2178,-12,-44,54,117.68,86
,20171010,2210,2178,2186,2186,2186,2186,2186,8,8,2,4.37,86
,20171011,2186,2186,2200,2200,2186,2186,2186,0,0,16,35.00,84
,20171012,2186,2186,,,,2250,2250,64,64,0,0.00,84
,20171013,2250,2250,,,,2250,2250,0,0,0,0.00,84
,20171016,2250,2250,2200,2200,2200,2200,2200,-50,-50,80,176.00,84
bu1711,20170516,2482,2482,,,,2482,2482,0,0,0,0.00,0
,20170517,2482,2482,2618,2618,2566,2566,2592,84,110,4,10.37,2
,20170518,2566,2592,2588,2588,2588,2588,2588,-4,-4,4,10.35,4
,20170519,2588,2588,2648,2648,2558,2586,2606,-2,18,10,26.08,2
,20170522,2586,2606,2656,2722,2602,2664,2648,58,42,148,392.02,6
,20170523,2664,2648,2632,2660,2598,2640,2630,-8,-18,10,26.31,2
,20170524,2640,2630,2574,2574,2558,2570,2566,-60,-64,6,15.40,2
,20170525,2570,2566,,,,2566,2566,0,0,0,0.00,2
,20170526,2566,2566,,,,2496,2496,-70,-70,0,0.00,2
,20170531,2496,2496,2564,2564,2564,2564,2564,68,68,2,5.13,2
,20170601,2564,2564,,,,2488,2488,-76,-76,0,0.00,2
,20170602,2488,2488,,,,2448,2448,-40,-40,0,0.00,2
,20170605,2448,2448,,,,2488,2488,40,40,0,0.00,2
,20170606,2488,2488,,,,2508,2508,20,20,0,0.00,2
,20170607,2508,2508,,,,2526,2526,18,18,0,0.00,2
,20170608,2526,2526,,,,2486,2486,-40,-40,0,0.00,2
,20170609,2486,2486,,,,2510,2510,24,24,0,0.00,2
,20170612,2510,2510,,,,2488,2488,-22,-22,0,0.00,2
,20170613,2488,2488,,,,2480,2480,-8,-8,0,0.00,2
,20170614,2480,2480,,,,2442,2442,-38,-38,0,0.00,2
,20170615,2442,2442,,,,2460,2460,18,18,0,0.00,2
,20170616,2460,2460,,,,2448,2448,-12,-12,0,0.00,2
,20170619,2448,2448,,,,2432,2432,-16,-16,0,0.00,2
,20170620,2432,2432,,,,2460,2460,28,28,0,0.00,2
,20170621,2460,2460,,,,2422,2422,-38,-38,0,0.00,2
,20170622,2422,2422,,,,2406,2406,-16,-16,0,0.00,2
,20170623,2406,2406,,,,2400,2400,-6,-6,0,0.00,2
,20170626,2400,2400,2290,2394,2290,2392,2364,-8,-36,8,18.92,8
,20170627,2392,2364,2338,2340,2338,2340,2338,-24,-26,4,9.36,8
,20170628,2340,2338,,,,2338,2338,0,0,0,0.00,8
,20170629,2338,2338,2392,2464,2360,2364,2408,26,70,450,"1,084.18",114
,20170630,2364,2408,2374,2376,2374,2374,2374,-34,-34,106,251.71,8
,20170703,2374,2374,2408,2418,2408,2418,2412,44,38,4,9.65,4
,20170704,2418,2412,,,,2412,2412,0,0,0,0.00,4
,20170705,2412,2412,,,,2412,2412,0,0,0,0.00,4
,20170706,2412,2412,,,,2412,2412,0,0,0,0.00,4
,20170707,2412,2412,2444,2444,2444,2444,2444,32,32,2,4.89,6
,20170710,2444,2444,2420,2460,2378,2460,2418,16,-26,6,14.52,8
,20170711,2460,2418,2450,2488,2450,2472,2470,54,52,6,14.82,4
,20170712,2472,2470,,,,2470,2470,0,0,0,0.00,4
,20170713,2470,2470,,,,2470,2470,0,0,0,0.00,4
,20170714,2470,2470,2554,2554,2550,2554,2552,84,82,6,15.32,4
,20170717,2554,2552,,,,2606,2606,54,54,0,0.00,4
,20170718,2606,2606,,,,2606,2606,0,0,0,0.00,4
,20170719,2606,2606,,,,2606,2606,0,0,0,0.00,4
,20170720,2606,2606,,,,2606,2606,0,0,0,0.00,4
,20170721,2606,2606,,,,2606,2606,0,0,0,0.00,4
,20170724,2606,2606,2566,2630,2566,2630,2598,24,-8,4,10.39,6
,20170725,2630,2598,2698,2710,2680,2680,2692,82,94,12,32.32,4
,20170726,2680,2692,2730,2734,2686,2686,2712,-6,20,18,48.84,6
,20170727,2686,2712,2716,2716,2716,2716,2716,4,4,2,5.43,4
,20170728,2716,2716,2706,2706,2706,2706,2706,-10,-10,2,5.41,2
,20170731,2706,2706,,,,2706,2706,0,0,0,0.00,2
,20170801,2706,2706,,,,2706,2706,0,0,0,0.00,2
,20170802,2706,2706,2712,2728,2694,2716,2710,10,4,710,"1,925.14",672
,20170803,2716,2710,2772,2772,2688,2688,2706,-22,-4,98,265.20,678
,20170804,2688,2706,2758,2758,2636,2676,2694,-30,-12,126,339.50,706
,20170807,2676,2694,2646,2676,2570,2602,2600,-92,-94,698,"1,814.91",244
,20170808,2602,2600,2600,2624,2594,2624,2606,24,6,10,26.07,246
,20170809,2624,2606,2668,2690,2616,2690,2660,84,54,58,154.28,248
,20170810,2690,2660,2690,2690,2690,2690,2690,30,30,4,10.76,248
,20170811,2690,2690,2604,2604,2538,2538,2560,-152,-130,118,302.11,180
,20170814,2538,2560,2564,2564,2542,2542,2554,-18,-6,20,51.10,186
,20170815,2542,2554,2582,2594,2568,2592,2580,38,26,32,82.62,182
,20170816,2592,2580,2548,2570,2548,2570,2560,-10,-20,24,61.44,182
,20170817,2570,2560,2640,2642,2626,2642,2634,82,74,10,26.35,176
,20170818,2642,2634,2652,2666,2652,2654,2654,20,20,90,238.88,90
,20170821,2654,2654,2676,2676,2676,2676,2676,22,22,86,230.14,36
,20170822,2676,2676,2662,2672,2616,2672,2648,-4,-28,28,74.15,36
,20170823,2672,2648,2672,2702,2630,2644,2656,-4,8,12,31.87,36
,20170824,2644,2656,,,,2656,2656,0,0,0,0.00,36
,20170825,2656,2656,2672,2738,2672,2696,2686,40,30,22,59.12,40
,20170828,2696,2686,2678,2678,2678,2678,2678,-8,-8,2,5.36,38
,20170829,2678,2678,2650,2650,2650,2650,2650,-28,-28,8,21.20,46
,20170830,2650,2650,2634,2634,2634,2634,2634,-16,-16,8,21.07,38
,20170831,2634,2634,2634,2634,2634,2634,2634,0,0,2,5.27,36
,20170901,2634,2634,2632,2672,2632,2672,2652,38,18,22,58.34,36
,20170904,2672,2652,2606,2606,2606,2606,2606,-46,-46,4,10.42,38
,20170905,2606,2606,,,,2606,2606,0,0,0,0.00,38
,20170906,2606,2606,2590,2590,2554,2554,2572,-52,-34,4,10.29,40
,20170907,2554,2572,2526,2526,2482,2482,2504,-90,-68,4,10.02,42
,20170908,2482,2504,2362,2468,2362,2442,2428,-62,-76,8,19.43,44
,20170911,2442,2428,,,,2428,2428,0,0,0,0.00,44
,20170912,2428,2428,,,,2428,2428,0,0,0,0.00,44
,20170913,2428,2428,2438,2438,2438,2438,2438,10,10,2,4.88,46
,20170914,2438,2438,2432,2462,2432,2436,2442,-2,4,6,14.66,46
,20170915,2436,2442,,,,2442,2442,0,0,0,0.00,46
,20170918,2442,2442,2442,2484,2442,2484,2456,42,14,6,14.74,46
,20170919,2484,2456,2492,2492,2418,2418,2448,-38,-8,24,58.79,48
,20170920,2418,2448,2388,2422,2388,2396,2402,-52,-46,6,14.41,48
,20170921,2396,2402,,,,2402,2402,0,0,0,0.00,48
,20170922,2402,2402,,,,2402,2402,0,0,0,0.00,48
,20170925,2402,2402,2398,2426,2396,2426,2408,24,6,10,24.09,50
,20170926,2426,2408,2378,2410,2378,2410,2388,2,-20,6,14.33,52
,20170927,2410,2388,2410,2440,2410,2410,2412,22,24,76,183.45,56
,20170928,2410,2412,2414,2414,2406,2406,2408,-6,-4,14,33.72,46
,20170929,2406,2408,2398,2410,2398,2410,2404,2,-4,10,24.05,42
,20171009,2410,2404,2374,2398,2360,2390,2388,-14,-16,46,109.89,36
,20171010,2390,2388,2376,2376,2366,2366,2370,-22,-18,22,52.15,38
,20171011,2366,2370,,,,2370,2370,0,0,0,0.00,38
,20171012,2370,2370,,,,2370,2370,0,0,0,0.00,38
,20171013,2370,2370,,,,2370,2370,0,0,0,0.00,38
,20171016,2370,2370,,,,2380,2380,10,10,0,0.00,38
,20171017,2380,2380,2438,2438,2438,2438,2438,58,58,2,4.88,38
,20171018,2438,2438,2398,2398,2398,2398,2398,-40,-40,2,4.80,36
,20171019,2398,2398,2396,2396,2396,2396,2396,-2,-2,2,4.79,36
,20171020,2396,2396,2378,2428,2378,2428,2402,32,6,4,9.61,36
,20171023,2428,2402,,,,2402,2402,0,0,0,0.00,36
,20171024,2402,2402,,,,2402,2402,0,0,0,0.00,36
,20171025,2402,2402,2442,2448,2390,2448,2440,46,38,26,63.45,36
,20171026,2448,2440,2448,2448,2410,2428,2436,-12,-4,18,43.87,38
,20171027,2428,2436,2446,2446,2394,2394,2420,-42,-16,4,9.68,38
,20171030,2394,2420,2448,2532,2408,2408,2452,-12,32,22,53.94,56
,20171031,2408,2452,,,,2452,2452,0,0,0,0.00,56
,20171101,2452,2452,,,,2446,2446,-6,-6,0,0.00,56
,20171102,2446,2446,,,,2400,2400,-46,-46,0,0.00,56
,20171103,2400,2400,,,,2400,2400,0,0,0,0.00,56
,20171106,2400,2400,,,,2400,2400,0,0,0,0.00,56
,20171107,2400,2400,2400,2450,2400,2450,2446,50,46,32,78.30,56
,20171108,2450,2446,,,,2446,2446,0,0,0,0.00,56
,20171109,2446,2446,,,,2446,2446,0,0,0,0.00,56
,20171110,2446,2446,2564,2564,2564,2564,2564,118,118,2,5.13,54
,20171113,2564,2564,,,,2564,2564,0,0,0,0.00,54
,20171114,2564,2564,,,,2498,2498,-66,-66,0,0.00,54
,20171115,2498,2498,2358,2358,2358,2358,2358,-140,-140,4,9.43,54
bu1712,20170103,2906,2900,2908,2982,2840,2854,2888,-46,-12,746,"2,155.49",3082
,20170104,2854,2888,2870,2886,2830,2878,2860,-10,-28,854,"2,442.76",3172
,20170105,2878,2860,2846,2890,2844,2844,2864,-16,4,1002,"2,871.16",3294
,20170106,2844,2864,2862,2922,2854,2862,2882,-2,18,1758,"5,067.66",3856
,20170109,2862,2882,2888,2920,2868,2910,2896,28,14,1410,"4,084.52",4180
,20170110,2910,2896,2888,2896,2812,2860,2846,-36,-50,2706,"7,703.95",4986
,20170111,2860,2846,2860,2928,2832,2848,2888,2,42,1458,"4,211.93",5448
,20170112,2848,2888,2852,2904,2842,2878,2874,-10,-14,650,"1,868.77",5526
,20170113,2878,2874,2894,2938,2890,2920,2912,46,38,886,"2,580.94",5630
,20170116,2920,2912,2918,2954,2904,2924,2928,12,16,824,"2,413.20",5600
,20170117,2924,2928,2924,2946,2866,2870,2908,-58,-20,1418,"4,125.88",5676
,20170118,2870,2908,2874,2900,2858,2870,2874,-38,-34,1254,"3,604.77",5794
,20170119,2870,2874,2854,2856,2822,2840,2840,-34,-34,772,"2,192.64",5828
,20170120,2840,2840,2840,2876,2780,2780,2828,-60,-12,914,"2,586.25",5820
,20170123,2780,2828,2804,2830,2792,2794,2810,-34,-18,446,"1,253.49",5754
,20170124,2794,2810,2794,2844,2794,2828,2828,18,18,614,"1,736.58",5898
,20170125,2828,2828,2828,2852,2804,2840,2832,12,4,506,"1,433.38",5826
,20170126,2840,2832,2828,2880,2828,2880,2854,48,22,320,913.59,5820
,20170203,2880,2854,2882,2904,2858,2890,2880,36,26,832,"2,397.62",5920
,20170206,2890,2880,2890,2920,2882,2914,2906,34,26,940,"2,732.99",6306
,20170207,2914,2906,2914,2914,2880,2902,2896,-4,-10,1370,"3,968.55",7054
,20170208,2902,2896,2902,2940,2878,2934,2898,38,2,896,"2,596.64",7238
,20170209,2934,2898,2934,2942,2912,2922,2932,24,34,910,"2,668.55",7410
,20170210,2922,2932,2918,2996,2916,2984,2956,52,24,1760,"5,204.65",8004
,20170213,2984,2956,2990,3136,2990,3096,3080,140,124,2598,"8,005.22",8826
,20170214,3096,3080,3090,3142,3072,3096,3100,16,20,2142,"6,641.13",8376
,20170215,3096,3100,3102,3130,3002,3002,3050,-98,-50,1496,"4,564.03",8290
,20170216,3002,3050,3002,3054,2962,2982,3002,-68,-48,2008,"6,031.94",8076
,20170217,2982,3002,2986,3022,2962,2982,2988,-20,-14,1038,"3,103.62",7966
,20170220,2982,2988,2976,3076,2956,3076,3030,88,42,1276,"3,867.92",8110
,20170221,3076,3030,3076,3090,3012,3028,3048,-2,18,1096,"3,341.35",7736
,20170222,3028,3048,3058,3090,3040,3080,3068,32,20,656,"2,013.34",7796
,20170223,3080,3068,3086,3086,2968,2982,3032,-86,-36,3006,"9,117.62",8606
,20170224,2982,3032,3010,3048,2954,3048,3006,16,-26,1866,"5,609.54",8932
,20170227,3048,3006,3036,3106,3036,3082,3078,76,72,1924,"5,925.53",9654
,20170228,3082,3078,3082,3098,3042,3054,3068,-24,-10,852,"2,614.96",9620
,20170301,3054,3068,3054,3114,3034,3114,3082,46,14,1718,"5,297.48",10192
,20170302,3114,3082,3114,3114,3060,3060,3082,-22,0,1052,"3,243.22",10354
,20170303,3060,3082,3060,3060,3008,3050,3034,-32,-48,916,"2,780.38",10232
,20170306,3050,3034,3046,3056,2986,2986,3014,-48,-20,1388,"4,185.72",10030
,20170307,2986,3014,2990,3036,2990,3024,3024,10,10,2428,"7,342.96",10792
,20170308,3024,3024,3036,3074,2950,2962,2996,-62,-28,3966,"11,883.32",10904
,20170309,2962,2996,2962,2966,2828,2828,2866,-168,-130,6068,"17,393.64",10880
,20170310,2828,2866,2812,2864,2798,2814,2828,-52,-38,3406,"9,638.27",11038
,20170313,2814,2828,2814,2850,2746,2840,2792,12,-36,8602,"24,032.22",12782
,20170314,2840,2792,2840,2846,2762,2762,2798,-30,6,3126,"8,752.54",11586
,20170315,2762,2798,2752,2848,2732,2818,2790,20,-8,6252,"17,450.87",10600
,20170316,2818,2790,2818,2854,2804,2814,2818,24,28,2580,"7,273.61",11170
,20170317,2814,2818,2806,2824,2780,2808,2798,-10,-20,4920,"13,775.15",11256
,20170320,2808,2798,2818,2848,2786,2806,2814,8,16,3418,"9,620.46",11334
,20170321,2806,2814,2798,2818,2778,2808,2794,-6,-20,4808,"13,436.18",11566
,20170322,2808,2794,2806,2806,2672,2686,2730,-108,-64,11964,"32,672.68",11466
,20170323,2686,2730,2680,2736,2662,2690,2694,-40,-36,6016,"16,212.56",11454
,20170324,2690,2694,2684,2718,2674,2702,2696,8,2,2908,"7,843.09",11398
,20170327,2702,2696,2696,2712,2638,2662,2662,-34,-34,4876,"12,980.56",10974
,20170328,2662,2662,2662,2728,2646,2696,2696,34,34,6468,"17,445.95",11060
,20170329,2696,2696,2710,2734,2692,2734,2714,38,18,2320,"6,297.04",11134
,20170330,2734,2714,2734,2752,2700,2734,2724,20,10,4152,"11,313.13",10120
,20170331,2734,2724,2742,2762,2720,2748,2746,24,22,4178,"11,474.43",8682
,20170405,2748,2746,2772,2938,2772,2920,2884,174,138,6558,"18,913.54",10154
,20170406,2920,2884,2924,2936,2896,2922,2916,38,32,4856,"14,160.92",10960
,20170407,2922,2916,2940,2968,2866,2896,2904,-20,-12,17536,"50,944.06",11060
,20170410,2896,2904,2886,2926,2854,2894,2892,-10,-12,19242,"55,680.32",15046
,20170411,2894,2892,2898,2910,2716,2722,2812,-170,-80,10752,"30,252.62",15950
,20170412,2722,2812,2732,2754,2696,2716,2728,-96,-84,6006,"16,395.96",15764
,20170413,2716,2728,2716,2762,2694,2746,2732,18,4,5988,"16,363.24",16100
,20170414,2746,2732,2748,2758,2610,2624,2660,-108,-72,8292,"22,062.28",16142
,20170417,2624,2660,2624,2700,2616,2650,2652,-10,-8,5322,"14,124.20",16074
,20170418,2650,2652,2656,2666,2600,2616,2626,-36,-26,4840,"12,717.33",15936
,20170419,2616,2626,2614,2664,2542,2662,2604,36,-22,10816,"28,170.80",15710
,20170420,2662,2604,2662,2786,2570,2662,2630,58,26,12286,"32,327.97",17764
,20170421,2662,2630,2656,2698,2628,2654,2668,24,38,11468,"30,607.71",18676
,20170424,2654,2668,2654,2656,2604,2636,2626,-32,-42,9564,"25,133.97",19138
,20170425,2636,2626,2634,2658,2616,2638,2638,12,12,7444,"19,647.13",21930
,20170426,2638,2638,2634,2638,2556,2600,2588,-38,-50,15360,"39,765.61",25488
,20170427,2600,2588,2588,2664,2580,2660,2632,72,44,11878,"31,275.36",26646
,20170428,2660,2632,2650,2720,2634,2708,2678,76,46,13554,"36,299.16",28536
,20170502,2708,2678,2706,2720,2684,2706,2702,28,24,5488,"14,828.69",30334
,20170503,2706,2702,2710,2710,2688,2698,2698,-4,-4,10394,"28,052.84",35084
,20170504,2698,2698,2690,2692,2544,2594,2610,-104,-88,20418,"53,299.87",31166
,20170505,2594,2610,2576,2588,2470,2470,2528,-140,-82,18482,"46,735.27",31008
,20170508,2470,2528,2484,2544,2484,2510,2514,-18,-14,9944,"25,009.42",31554
,20170509,2510,2514,2500,2536,2490,2528,2518,14,4,7836,"19,732.11",31382
,20170510,2528,2518,2524,2540,2498,2512,2516,-6,-2,11820,"29,739.12",31478
,20170511,2512,2516,2516,2554,2502,2536,2528,20,12,13606,"34,416.89",32218
,20170512,2536,2528,2540,2546,2472,2510,2506,-18,-22,9778,"24,511.29",32012
,20170515,2510,2506,2510,2580,2506,2572,2538,66,32,8620,"21,886.10",32642
,20170516,2572,2538,2596,2612,2566,2612,2586,74,48,8864,"22,926.00",34408
,20170517,2612,2586,2610,2624,2590,2602,2604,16,18,7914,"20,618.61",33444
,20170518,2602,2604,2608,2618,2558,2600,2590,-4,-14,18230,"47,239.84",34946
,20170519,2600,2590,2590,2664,2576,2656,2632,66,42,12354,"32,526.19",34400
,20170522,2656,2632,2658,2684,2650,2664,2666,32,34,9240,"24,646.88",34632
,20170523,2664,2666,2664,2690,2592,2592,2632,-74,-34,15966,"42,037.11",37046
,20170524,2592,2632,2604,2614,2556,2598,2594,-34,-38,16496,"42,795.74",40152
,20170525,2598,2594,2598,2662,2586,2642,2628,48,34,12078,"31,751.56",40328
,20170526,2642,2628,2624,2632,2520,2548,2556,-80,-72,23492,"60,054.60",41132
,20170531,2548,2556,2548,2562,2404,2416,2476,-140,-80,20192,"50,003.75",40334
,20170601,2416,2476,2414,2446,2398,2432,2422,-44,-54,16842,"40,803.26",39516
,20170602,2432,2422,2426,2434,2390,2392,2408,-30,-14,18868,"45,465.49",41374
,20170605,2392,2408,2388,2438,2366,2420,2418,12,10,18862,"45,612.11",41276
,20170606,2420,2418,2410,2448,2390,2436,2414,18,-4,18230,"44,027.48",42538
,20170607,2436,2414,2416,2444,2416,2428,2430,14,16,16548,"40,215.45",41588
,20170608,2428,2430,2420,2430,2394,2414,2412,-16,-18,20740,"50,038.45",41076
,20170609,2414,2412,2402,2426,2396,2404,2412,-8,0,11456,"27,646.28",41534
,20170612,2404,2412,2408,2430,2386,2414,2414,2,2,22462,"54,241.16",40444
,20170613,2414,2414,2424,2442,2390,2396,2412,-18,-2,22964,"55,432.04",41596
,20170614,2396,2412,2386,2406,2350,2400,2376,-12,-36,29432,"69,951.58",41686
,20170615,2400,2376,2400,2414,2368,2370,2386,-6,10,19738,"47,110.27",42118
,20170616,2370,2386,2370,2394,2358,2380,2378,-6,-8,19888,"47,299.20",43694
,20170619,2380,2378,2390,2396,2344,2380,2374,2,-4,22254,"52,870.55",45136
,20170620,2380,2374,2382,2424,2382,2408,2402,34,28,31022,"74,549.33",46712
,20170621,2408,2402,2378,2400,2340,2360,2364,-42,-38,30780,"72,824.35",48382
,20170622,2360,2364,2366,2374,2322,2332,2348,-32,-16,26672,"62,661.90",51944
,20170623,2332,2348,2344,2352,2332,2344,2342,-4,-6,23884,"55,939.79",54796
,20170626,2344,2342,2346,2368,2328,2356,2350,14,8,18242,"42,899.40",53798
,20170627,2356,2350,2352,2366,2336,2364,2346,14,-4,17834,"41,869.86",55500
,20170628,2364,2346,2370,2392,2364,2380,2378,34,32,23506,"55,899.56",56834
,20170629,2380,2378,2384,2430,2374,2408,2410,30,32,59908,"144,398.82",68530
,20170630,2408,2410,2408,2428,2402,2420,2414,10,4,34322,"82,911.91",75476
,20170703,2420,2414,2420,2446,2420,2436,2434,22,20,38842,"94,568.78",77856
,20170704,2436,2434,2440,2452,2378,2402,2416,-32,-18,34950,"84,455.67",79048
,20170705,2402,2416,2406,2462,2402,2454,2438,38,22,49300,"120,235.10",90654
,20170706,2454,2438,2436,2462,2416,2458,2438,20,0,48664,"118,688.26",93698
,20170707,2458,2438,2462,2496,2442,2466,2470,28,32,42198,"104,240.20",97676
,20170710,2466,2470,2466,2492,2436,2466,2464,-4,-6,61664,"152,016.79",110452
,20170711,2466,2464,2466,2550,2458,2540,2516,76,52,74242,"186,820.05",126976
,20170712,2540,2516,2530,2572,2520,2526,2538,10,22,73570,"186,761.06",133808
,20170713,2526,2538,2526,2560,2518,2558,2542,20,4,54448,"138,417.74",137442
,20170714,2558,2542,2562,2610,2532,2596,2588,54,46,123940,"320,939.45",164446
,20170717,2596,2588,2604,2664,2594,2652,2638,64,50,79528,"209,885.51",178518
,20170718,2652,2638,2648,2674,2632,2640,2650,2,12,58798,"155,917.78",186492
,20170719,2640,2650,2654,2676,2650,2662,2664,12,14,75180,"200,308.66",205512
,20170720,2662,2664,2660,2684,2652,2656,2668,-8,4,82032,"218,932.85",212674
,20170721,2656,2668,2666,2668,2606,2634,2632,-34,-36,153656,"404,535.06",244394
,20170724,2634,2632,2622,2648,2606,2640,2632,8,0,99042,"260,689.44",261482
,20170725,2640,2632,2644,2726,2642,2722,2696,90,64,188054,"507,226.47",297988
,20170726,2722,2696,2738,2740,2682,2700,2708,4,12,179724,"486,914.72",311934
,20170727,2700,2708,2706,2740,2686,2720,2718,12,10,174240,"473,590.06",346764
,20170728,2720,2718,2720,2732,2646,2674,2682,-44,-36,285078,"764,834.46",374694
,20170731,2674,2682,2680,2754,2678,2746,2722,64,40,269546,"734,176.04",391930
,20170801,2746,2722,2746,2764,2722,2738,2742,16,20,227776,"624,931.84",410182
,20170802,2738,2742,2728,2736,2674,2714,2708,-28,-34,300308,"813,499.81",425932
,20170803,2714,2708,2718,2728,2668,2670,2708,-38,0,360712,"976,819.44",457050
,20170804,2670,2708,2690,2742,2660,2678,2698,-30,-10,637956,"1,721,325.49",498622
,20170807,2678,2698,2686,2718,2614,2646,2660,-52,-38,854850,"2,274,983.78",504488
,20170808,2646,2660,2646,2678,2628,2678,2652,18,-8,589648,"1,564,364.44",528442
,20170809,2678,2652,2678,2736,2674,2718,2712,66,60,840446,"2,280,534.17",576792
,20170810,2718,2712,2728,2766,2694,2726,2728,14,16,742538,"2,026,539.39",560972
,20170811,2726,2728,2742,2748,2576,2584,2656,-144,-72,1194362,"3,173,879.03",535070
,20170814,2584,2656,2590,2618,2586,2594,2602,-62,-54,505194,"1,314,709.42",543930
,20170815,2594,2602,2588,2638,2586,2614,2618,12,16,793628,"2,078,810.61",567816
,20170816,2614,2618,2608,2632,2594,2626,2612,8,-6,477186,"1,247,196.32",588106
,20170817,2626,2612,2626,2698,2624,2682,2666,70,54,911802,"2,431,282.66",628244
,20170818,2682,2666,2672,2720,2666,2716,2696,50,30,698308,"1,883,093.16",657350
,20170821,2716,2696,2722,2738,2688,2716,2716,20,20,749344,"2,036,324.98",660416
,20170822,2716,2716,2716,2728,2656,2722,2694,6,-22,658716,"1,775,359.16",676586
,20170823,2722,2694,2716,2772,2666,2688,2726,-6,32,1340714,"3,655,731.61",721536
,20170824,2688,2726,2688,2746,2678,2740,2710,14,-16,836432,"2,267,564.85",742970
,20170825,2740,2710,2742,2798,2714,2756,2752,46,42,1084952,"2,986,467.95",754562
,20170828,2756,2752,2756,2782,2716,2742,2750,-10,-2,812104,"2,233,887.21",737316
,20170829,2742,2750,2744,2762,2684,2718,2722,-32,-28,941666,"2,564,418.25",738794
,20170830,2718,2722,2718,2734,2694,2710,2710,-12,-12,623066,"1,689,605.42",740524
,20170831,2710,2710,2708,2708,2620,2672,2664,-38,-46,735820,"1,960,929.51",752548
,20170901,2672,2664,2684,2724,2672,2704,2700,40,36,760764,"2,055,242.41",755690
,20170904,2704,2700,2712,2746,2590,2614,2674,-86,-26,1478126,"3,954,449.80",757072
,20170905,2614,2674,2618,2636,2582,2604,2608,-70,-66,896632,"2,338,968.39",790422
,20170906,2604,2608,2618,2636,2596,2608,2618,0,10,886368,"2,321,574.08",805838
,20170907,2608,2618,2620,2640,2510,2528,2574,-90,-44,1534516,"3,951,068.35",791664
,20170908,2528,2574,2530,2540,2456,2468,2502,-106,-72,1012090,"2,532,254.06",773090
,20170911,2468,2502,2464,2494,2446,2490,2474,-12,-28,710702,"1,759,389.65",729228
,20170912,2490,2474,2492,2510,2472,2498,2494,24,20,554610,"1,383,448.68",712816
,20170913,2498,2494,2502,2518,2462,2472,2488,-22,-6,677226,"1,685,940.40",711544
,20170914,2472,2488,2478,2512,2458,2474,2482,-14,-6,741650,"1,841,755.98",702170
,20170915,2474,2482,2484,2502,2432,2492,2474,10,-8,1192080,"2,950,534.36",692290
,20170918,2492,2474,2496,2526,2470,2504,2502,30,28,955928,"2,391,764.14",685852
,20170919,2504,2502,2498,2510,2454,2466,2478,-36,-24,791298,"1,961,408.28",709008
,20170920,2466,2478,2468,2486,2460,2474,2472,-4,-6,534660,"1,322,050.34",691906
,20170921,2474,2472,2478,2496,2408,2438,2454,-34,-18,931710,"2,287,323.04",681548
,20170922,2438,2454,2432,2488,2426,2486,2456,32,2,674120,"1,655,800.10",650542
,20170925,2486,2456,2488,2504,2474,2484,2488,28,32,641444,"1,596,214.26",641944
,20170926,2484,2488,2498,2516,2476,2502,2496,14,8,590602,"1,474,487.53",622062
,20170927,2502,2496,2498,2520,2484,2510,2502,14,6,518652,"1,298,608.76",605014
,20170928,2510,2502,2508,2516,2412,2434,2454,-68,-48,834566,"2,049,053.65",571860
,20170929,2434,2454,2442,2474,2422,2428,2448,-26,-6,527634,"1,291,723.53",541504
,20171009,2428,2448,2420,2444,2320,2354,2356,-94,-92,644356,"1,519,155.17",583004
,20171010,2354,2356,2366,2388,2358,2378,2372,22,16,441404,"1,047,721.79",580444
,20171011,2378,2372,2392,2416,2378,2402,2396,30,24,496650,"1,190,193.68",570994
,20171012,2402,2396,2400,2426,2370,2420,2402,24,6,469538,"1,127,908.27",553736
,20171013,2420,2402,2406,2434,2384,2426,2408,24,6,550530,"1,325,944.94",558688
,20171016,2426,2408,2430,2448,2372,2404,2406,-4,-2,681102,"1,639,386.92",577828
,20171017,2404,2406,2410,2426,2366,2416,2400,10,-6,778740,"1,869,854.84",549306
,20171018,2416,2400,2416,2430,2390,2412,2408,12,8,507884,"1,223,231.70",541856
,20171019,2412,2408,2418,2420,2360,2376,2392,-32,-16,615492,"1,473,197.08",554356
,20171020,2376,2392,2366,2410,2354,2400,2382,8,-10,509370,"1,213,592.68",526038
,20171023,2400,2382,2398,2432,2378,2414,2404,32,22,581196,"1,398,319.04",503974
,20171024,2414,2404,2412,2430,2406,2414,2418,10,14,351280,"849,637.40",488982
,20171025,2414,2418,2420,2500,2418,2490,2468,72,50,800802,"1,977,854.82",436066
,20171026,2490,2468,2490,2494,2474,2488,2482,20,14,350782,"871,086.25",434734
,20171027,2488,2482,2488,2508,2468,2482,2486,0,4,461826,"1,148,402.51",403804
,20171030,2482,2486,2480,2550,2456,2532,2514,46,28,656882,"1,652,534.09",426504
,20171031,2532,2514,2536,2546,2502,2506,2522,-8,8,457872,"1,154,972.37",410890
,20171101,2506,2522,2508,2522,2466,2478,2496,-44,-26,465264,"1,161,901.52",401040
,20171102,2478,2496,2480,2506,2464,2482,2486,-14,-10,357412,"888,858.89",381964
,20171103,2482,2486,2484,2518,2480,2506,2502,20,16,337242,"843,894.56",367404
,20171106,2506,2502,2504,2542,2486,2530,2518,28,16,429790,"1,082,245.70",364626
,20171107,2530,2518,2530,2568,2516,2544,2538,26,20,390530,"991,838.38",349334
,20171108,2544,2538,2546,2552,2524,2542,2538,4,0,246686,"626,225.49",320766
,20171109,2542,2538,2542,2570,2530,2540,2548,2,10,259694,"661,875.00",309644
,20171110,2540,2548,2538,2556,2532,2540,2542,-8,-6,214374,"545,203.66",301732
,20171113,2540,2542,2546,2590,2538,2582,2560,40,18,265238,"679,324.59",299184
,20171114,2582,2560,2584,2588,2560,2564,2568,4,8,172546,"443,395.06",278350
,20171115,2564,2568,2560,2580,2434,2450,2494,-118,-74,535306,"1,336,077.22",230512
,20171116,2450,2494,2448,2476,2448,2458,2462,-36,-32,146406,"360,558.90",217896
,20171117,2458,2462,2452,2472,2444,2462,2460,0,-2,147044,"361,876.30",209616
,20171120,2462,2460,2472,2546,2428,2542,2474,82,14,315534,"781,219.35",189652
,20171121,2542,2474,2532,2564,2522,2538,2538,64,64,267414,"679,143.50",166558
,20171122,2538,2538,2540,2576,2532,2550,2554,12,16,163254,"417,274.18",149742
,20171123,2550,2554,2552,2558,2510,2526,2538,-28,-16,131792,"334,517.81",114356
,20171124,2526,2538,2526,2542,2522,2532,2530,-6,-8,44090,"111,592.06",101048
,20171127,2532,2530,2538,2546,2476,2476,2506,-54,-24,64312,"161,176.04",83300
,20171128,2476,2506,2482,2500,2458,2472,2476,-34,-30,34330,"85,018.05",70464
,20171129,2472,2476,2474,2486,2462,2470,2474,-6,-2,27564,"68,217.94",62188
,20171130,2470,2474,2464,2492,2450,2482,2466,8,-8,27358,"67,502.22",50078
,20171201,2482,2466,2494,2508,2476,2498,2490,32,24,14864,"37,012.22",44032
,20171204,2498,2490,2500,2532,2494,2512,2508,22,18,10450,"26,217.00",41230
,20171205,2512,2508,2512,2532,2480,2496,2506,-12,-2,13442,"33,699.18",37248
,20171206,2496,2506,2496,2526,2482,2500,2502,-6,-4,9034,"22,619.00",33090
,20171207,2500,2502,2496,2496,2370,2382,2430,-120,-72,11098,"26,982.33",27464
,20171208,2382,2430,2390,2460,2390,2406,2416,-24,-14,5256,"12,703.38",25984
,20171211,2406,2416,2436,2440,2340,2384,2386,-32,-30,7286,"17,395.72",24250
,20171212,2384,2386,2384,2414,2340,2342,2384,-44,-2,9104,"21,713.80",22556
,20171213,2342,2384,2340,2490,2340,2372,2388,-12,4,1448,"3,458.68",21914
,20171214,2372,2388,2360,2428,2350,2350,2396,-38,8,2888,"6,922.72",19836
,20171215,2350,2396,2336,2372,2336,2372,2360,-24,-36,14,33.05,19834
bu1801,20170718,2638,2638,2704,2718,2644,2644,2676,6,38,46,123.10,6
,20170719,2644,2676,2680,2698,2670,2698,2682,22,6,14,37.56,14
,20170720,2698,2682,2690,2694,2664,2682,2676,0,-6,26,69.61,28
,20170721,2682,2676,2666,2700,2594,2644,2654,-32,-22,1128,"2,994.06",242
,20170724,2644,2654,2614,2676,2614,2662,2646,8,-8,296,783.48,82
,20170725,2662,2646,2666,2738,2664,2732,2684,86,38,1948,"5,230.54",1486
,20170726,2732,2684,2736,2768,2694,2704,2722,20,38,878,"2,390.30",1514
,20170727,2704,2722,2710,2754,2706,2726,2738,4,16,244,668.24,1534
,20170728,2726,2738,2740,2740,2656,2686,2690,-52,-48,708,"1,904.54",1488
,20170731,2686,2690,2698,2762,2696,2750,2724,60,34,1290,"3,515.46",1728
,20170801,2750,2724,2760,2778,2734,2746,2756,22,32,1484,"4,091.58",1830
,20170802,2746,2756,2742,2746,2682,2726,2718,-30,-38,1728,"4,697.45",1998
,20170803,2726,2718,2726,2744,2680,2696,2724,-22,6,6980,"19,020.29",4198
,20170804,2696,2724,2682,2752,2682,2706,2716,-18,-8,4174,"11,337.42",4364
,20170807,2706,2716,2712,2734,2642,2674,2678,-42,-38,9118,"24,427.30",4780
,20170808,2674,2678,2674,2702,2654,2696,2674,18,-4,4322,"11,558.49",5250
,20170809,2696,2674,2690,2762,2690,2746,2738,72,64,8360,"22,894.59",5328
,20170810,2746,2738,2776,2790,2576,2758,2750,20,12,6532,"17,964.42",5270
,20170811,2758,2750,2762,2778,2614,2622,2688,-128,-62,9258,"24,890.36",5990
,20170814,2622,2688,2620,2652,2618,2626,2634,-62,-54,4952,"13,045.77",6150
,20170815,2626,2634,2634,2670,2610,2652,2648,18,14,7594,"20,111.47",5580
,20170816,2652,2648,2632,2662,2628,2658,2644,10,-4,3702,"9,791.00",5512
,20170817,2658,2644,2658,2726,2658,2710,2694,66,50,7152,"19,276.76",5198
,20170818,2710,2694,2710,2742,2698,2738,2726,44,32,4546,"12,396.55",5068
,20170821,2738,2726,2746,2768,2720,2746,2746,20,20,5340,"14,673.99",5298
,20170822,2746,2746,2746,2756,2698,2752,2724,6,-22,6042,"16,466.91",5386
,20170823,2752,2724,2744,2806,2704,2720,2752,-4,28,14394,"39,639.89",4818
,20170824,2720,2752,2720,2772,2708,2770,2738,18,-14,6996,"19,167.79",5662
,20170825,2770,2738,2750,2822,2744,2782,2774,44,36,8342,"23,149.69",5698
,20170828,2782,2774,2790,2808,2746,2770,2778,-4,4,6484,"18,024.40",5366
,20170829,2770,2778,2790,2790,2718,2750,2754,-28,-24,7154,"19,702.48",5222
,20170830,2750,2754,2750,2762,2726,2742,2744,-12,-10,4410,"12,103.05",4998
,20170831,2742,2744,2740,2740,2674,2704,2694,-40,-50,7042,"18,979.40",5410
,20170901,2704,2694,2710,2750,2704,2732,2730,38,36,4984,"13,615.57",5532
,20170904,2732,2730,2732,2778,2624,2648,2702,-82,-28,18974,"51,305.52",7734
,20170905,2648,2702,2642,2674,2622,2644,2646,-58,-56,10868,"28,777.34",8254
,20170906,2644,2646,2648,2676,2640,2654,2662,8,16,11626,"30,956.15",8292
,20170907,2654,2662,2662,2676,2536,2572,2608,-90,-54,20388,"53,198.28",9790
,20170908,2572,2608,2572,2582,2486,2516,2542,-92,-66,11038,"28,066.38",9898
,20170911,2516,2542,2534,2540,2488,2530,2518,-12,-24,10322,"26,002.19",9784
,20170912,2530,2518,2530,2554,2518,2542,2538,24,20,6164,"15,654.39",9376
,20170913,2542,2538,2558,2562,2504,2514,2532,-24,-6,8220,"20,817.93",9312
,20170914,2514,2532,2522,2552,2504,2516,2526,-16,-6,7426,"18,760.73",9098
,20170915,2516,2526,2520,2552,2482,2540,2518,14,-8,11422,"28,765.76",9986
,20170918,2540,2518,2544,2568,2518,2552,2544,34,26,7578,"19,290.12",9552
,20170919,2552,2544,2552,2554,2500,2506,2524,-38,-20,6038,"15,241.75",10066
,20170920,2506,2524,2510,2528,2506,2522,2516,-2,-8,4864,"12,239.94",10298
,20170921,2522,2516,2522,2540,2452,2482,2494,-34,-22,8398,"20,951.07",9962
,20170922,2482,2494,2482,2542,2476,2532,2502,38,8,4900,"12,263.32",9574
,20170925,2532,2502,2522,2552,2520,2534,2534,32,32,6168,"15,633.24",8952
,20170926,2534,2534,2542,2562,2522,2546,2544,12,10,5278,"13,434.30",8082
,20170927,2546,2544,2544,2560,2530,2550,2546,6,2,3550,"9,039.21",7650
,20170928,2550,2546,2540,2558,2454,2478,2488,-68,-58,8932,"22,223.00",5828
,20170929,2478,2488,2486,2508,2462,2468,2484,-20,-4,3838,"9,538.73",5452
,20171009,2468,2484,2456,2478,2366,2394,2400,-90,-84,10468,"25,127.14",6850
,20171010,2394,2400,2394,2416,2394,2404,2404,4,4,10186,"24,507.37",7384
,20171011,2404,2404,2412,2436,2406,2422,2420,18,16,5556,"13,454.13",7822
,20171012,2422,2420,2418,2454,2392,2450,2426,30,6,6764,"16,414.19",7714
,20171013,2450,2426,2438,2466,2410,2454,2438,28,12,8376,"20,423.49",7640
,20171016,2454,2438,2456,2478,2414,2444,2438,6,0,9422,"22,983.03",7508
,20171017,2444,2438,2456,2462,2400,2452,2440,14,2,7428,"18,134.23",7380
,20171018,2452,2440,2452,2466,2432,2452,2448,12,8,4838,"11,846.93",7634
,20171019,2452,2448,2448,2458,2404,2410,2434,-38,-14,6280,"15,290.02",8270
,20171020,2410,2434,2402,2446,2396,2438,2420,4,-14,4482,"10,847.23",7792
,20171023,2438,2420,2434,2468,2420,2452,2444,32,24,5138,"12,562.16",7612
,20171024,2452,2444,2452,2468,2446,2452,2456,8,12,4760,"11,692.08",7398
,20171025,2452,2456,2456,2530,2456,2522,2504,66,48,9510,"23,829.78",6976
,20171026,2522,2504,2524,2524,2494,2512,2508,8,4,4618,"11,590.66",7330
,20171027,2512,2508,2502,2532,2496,2506,2510,-2,2,5028,"12,621.02",7516
,20171030,2506,2510,2504,2570,2474,2552,2540,42,30,7084,"17,998.82",7712
,20171031,2552,2540,2554,2564,2524,2532,2538,-8,-2,6584,"16,722.35",8462
,20171101,2532,2538,2532,2546,2494,2504,2522,-34,-16,8706,"21,971.16",7408
,20171102,2504,2522,2508,2544,2496,2514,2516,-8,-6,6246,"15,723.39",7244
,20171103,2514,2516,2506,2540,2506,2538,2530,22,14,5624,"14,230.99",6824
,20171106,2538,2530,2536,2574,2524,2568,2550,38,20,10616,"27,085.33",6950
,20171107,2568,2550,2560,2596,2554,2578,2574,28,24,9794,"25,223.64",7888
,20171108,2578,2574,2576,2584,2562,2580,2572,6,-2,3072,"7,907.10",7660
,20171109,2580,2572,2580,2606,2568,2576,2584,4,12,6602,"17,072.28",7860
,20171110,2576,2584,2576,2586,2556,2564,2570,-20,-14,5270,"13,544.12",8396
,20171113,2564,2570,2564,2608,2562,2602,2582,32,12,5954,"15,383.88",10082
,20171114,2602,2582,2600,2606,2578,2582,2586,0,4,6324,"16,365.59",10446
,20171115,2582,2586,2582,2590,2462,2470,2512,-116,-74,13194,"33,157.89",9952
,20171116,2470,2512,2470,2500,2470,2480,2484,-32,-28,5318,"13,214.32",10310
,20171117,2480,2484,2466,2490,2466,2484,2482,0,-2,2862,"7,104.26",10118
,20171120,2484,2482,2490,2562,2462,2556,2500,74,18,8696,"21,743.17",11506
,20171121,2556,2500,2552,2576,2540,2558,2556,58,56,10084,"25,779.42",11926
,20171122,2558,2556,2552,2590,2552,2572,2574,16,18,7784,"20,042.47",13338
,20171123,2572,2574,2576,2576,2530,2538,2554,-36,-20,8888,"22,701.90",14800
,20171124,2538,2554,2544,2560,2538,2552,2550,-2,-4,3408,"8,693.95",14728
,20171127,2552,2550,2562,2570,2502,2506,2532,-44,-18,10662,"27,014.41",13952
,20171128,2506,2532,2510,2522,2486,2494,2502,-38,-30,4560,"11,409.20",14048
,20171129,2494,2502,2498,2510,2490,2494,2498,-8,-4,3914,"9,779.91",13820
,20171130,2494,2498,2494,2516,2468,2502,2488,4,-10,8758,"21,802.96",13298
,20171201,2502,2488,2512,2536,2498,2524,2514,36,26,6580,"16,546.48",13830
,20171204,2524,2514,2532,2562,2518,2540,2542,26,28,6832,"17,377.84",14490
,20171205,2540,2542,2536,2570,2520,2532,2544,-10,2,7354,"18,712.98",13802
,20171206,2532,2544,2532,2568,2520,2544,2542,0,-2,6434,"16,360.63",13786
,20171207,2544,2542,2526,2534,2416,2416,2482,-126,-60,11692,"29,022.18",11144
,20171208,2416,2482,2424,2464,2420,2444,2444,-38,-38,4800,"11,732.96",11104
,20171211,2444,2444,2456,2474,2394,2442,2432,-2,-12,7902,"19,224.84",12578
,20171212,2442,2432,2448,2462,2386,2400,2428,-32,-4,5602,"13,606.49",13572
,20171213,2400,2428,2404,2430,2384,2426,2412,-2,-16,3578,"8,634.17",13524
,20171214,2426,2412,2426,2452,2404,2414,2428,2,16,4542,"11,032.48",12630
,20171215,2414,2428,2414,2430,2390,2420,2410,-8,-18,3328,"8,026.55",12676
,20171218,2420,2410,2416,2452,2410,2442,2434,32,24,2784,"6,779.36",12602
,20171219,2442,2434,2440,2440,2422,2428,2430,-6,-4,1910,"4,642.90",12420
,20171220,2428,2430,2438,2458,2430,2438,2446,8,16,4628,"11,328.83",11638
,20171221,2438,2446,2438,2440,2368,2378,2408,-68,-38,4824,"11,623.36",12022
,20171222,2378,2408,2382,2400,2374,2382,2386,-26,-22,2704,"6,452.30",11880
,20171225,2382,2386,2366,2396,2362,2392,2376,6,-10,1712,"4,070.30",11850
,20171226,2392,2376,2398,2404,2376,2392,2392,16,16,1966,"4,704.91",11862
,20171227,2392,2392,2400,2422,2384,2422,2406,30,14,1940,"4,668.66",11164
,20171228,2422,2406,2420,2426,2398,2420,2412,14,6,2660,"6,420.14",10742
,20171229,2420,2412,2422,2424,2410,2420,2418,8,6,4992,"12,080.00",10006
bu1802,20170816,2648,2648,2706,2716,2706,2716,2714,68,66,20,54.30,20
,20170817,2716,2714,,,,2714,2714,0,0,0,0.00,20
,20170818,2714,2714,,,,2714,2714,0,0,0,0.00,20
,20170821,2714,2714,2796,2796,2750,2750,2780,36,66,28,77.88,6
,20170822,2750,2780,2670,2740,2670,2740,2704,-40,-76,4,10.82,8
,20170823,2740,2704,2736,2748,2736,2748,2742,44,38,4,10.97,8
,20170824,2748,2742,2758,2758,2758,2758,2758,16,16,2,5.52,6
,20170825,2758,2758,,,,2758,2758,0,0,0,0.00,6
,20170828,2758,2758,,,,2758,2758,0,0,0,0.00,6
,20170829,2758,2758,,,,2758,2758,0,0,0,0.00,6
,20170830,2758,2758,,,,2758,2758,0,0,0,0.00,6
,20170831,2758,2758,,,,2708,2708,-50,-50,0,0.00,6
,20170901,2708,2708,,,,2708,2708,0,0,0,0.00,6
,20170904,2708,2708,,,,2682,2682,-26,-26,0,0.00,6
,20170905,2682,2682,,,,2682,2682,0,0,0,0.00,6
,20170906,2682,2682,,,,2682,2682,0,0,0,0.00,6
,20170907,2682,2682,,,,2628,2628,-54,-54,0,0.00,6
,20170908,2628,2628,,,,2562,2562,-66,-66,0,0.00,6
,20170911,2562,2562,2568,2568,2532,2532,2550,-30,-12,4,10.20,8
,20170912,2532,2550,,,,2550,2550,0,0,0,0.00,8
,20170913,2550,2550,2580,2580,2580,2580,2580,30,30,2,5.16,6
,20170914,2580,2580,,,,2574,2574,-6,-6,0,0.00,6
,20170915,2574,2574,2550,2550,2550,2550,2550,-24,-24,2,5.10,6
,20170918,2550,2550,2572,2572,2572,2572,2572,22,22,2,5.14,4
,20170919,2572,2572,2524,2524,2510,2510,2516,-62,-56,4,10.07,6
,20170920,2510,2516,2530,2556,2516,2516,2528,0,12,10,25.30,8
,20170921,2516,2528,2512,2512,2510,2510,2510,-18,-18,6,15.06,4
,20170922,2510,2510,2534,2542,2488,2542,2514,32,4,56,140.83,8
,20170925,2542,2514,2542,2548,2526,2548,2538,34,24,6,15.23,8
,20170926,2548,2538,,,,2538,2538,0,0,0,0.00,8
,20170927,2538,2538,,,,2538,2538,0,0,0,0.00,8
,20170928,2538,2538,2532,2532,2482,2482,2514,-56,-24,6,15.09,4
,20170929,2482,2514,,,,2514,2514,0,0,0,0.00,4
,20171009,2514,2514,2450,2450,2450,2450,2450,-64,-64,2,4.90,2
,20171010,2450,2450,,,,2450,2450,0,0,0,0.00,2
,20171011,2450,2450,,,,2450,2450,0,0,0,0.00,2
,20171012,2450,2450,,,,2456,2456,6,6,0,0.00,2
,20171013,2456,2456,,,,2474,2474,18,18,0,0.00,2
,20171016,2474,2474,2506,2506,2488,2490,2494,16,20,6,14.97,4
,20171017,2490,2494,,,,2492,2492,-2,-2,0,0.00,4
,20171018,2492,2492,,,,2492,2492,0,0,0,0.00,4
,20171019,2492,2492,2450,2450,2450,2450,2450,-42,-42,2,4.90,6
,20171020,2450,2450,2468,2468,2468,2468,2468,18,18,2,4.94,6
,20171023,2468,2468,,,,2468,2468,0,0,0,0.00,6
,20171024,2468,2468,,,,2468,2468,0,0,0,0.00,6
,20171025,2468,2468,2492,2510,2492,2510,2500,42,32,4,10.00,4
,20171026,2510,2500,2538,2538,2538,2538,2538,38,38,2,5.08,4
,20171027,2538,2538,2538,2538,2538,2538,2538,0,0,2,5.08,6
,20171030,2538,2538,,,,2538,2538,0,0,0,0.00,6
,20171031,2538,2538,2554,2554,2554,2554,2554,16,16,2,5.11,6
,20171101,2554,2554,2564,2564,2552,2552,2558,-2,4,48,122.81,8
,20171102,2552,2558,,,,2558,2558,0,0,0,0.00,8
,20171103,2558,2558,,,,2558,2558,0,0,0,0.00,8
,20171106,2558,2558,,,,2558,2558,0,0,0,0.00,8
,20171107,2558,2558,,,,2582,2582,24,24,0,0.00,8
,20171108,2582,2582,,,,2580,2580,-2,-2,0,0.00,8
,20171109,2580,2580,,,,2580,2580,0,0,0,0.00,8
,20171110,2580,2580,,,,2580,2580,0,0,0,0.00,8
,20171113,2580,2580,,,,2598,2598,18,18,0,0.00,8
,20171114,2598,2598,,,,2598,2598,0,0,0,0.00,8
,20171115,2598,2598,2560,2560,2460,2526,2514,-72,-84,6,15.09,8
,20171116,2526,2514,2504,2504,2504,2504,2504,-10,-10,2,5.01,6
,20171117,2504,2504,,,,2504,2504,0,0,0,0.00,6
,20171120,2504,2504,2486,2560,2464,2560,2494,56,-10,22,54.89,18
,20171121,2560,2494,,,,2540,2540,46,46,0,0.00,18
,20171122,2540,2540,2558,2626,2558,2626,2606,86,66,12,31.28,18
,20171123,2626,2606,2600,2630,2600,2630,2614,24,8,4,10.46,20
,20171124,2630,2614,2600,2600,2600,2600,2600,-14,-14,2,5.20,20
,20171127,2600,2600,2570,2570,2570,2570,2570,-30,-30,2,5.14,20
,20171128,2570,2570,2532,2540,2532,2540,2536,-30,-34,4,10.14,20
,20171129,2540,2536,,,,2536,2536,0,0,0,0.00,20
,20171130,2536,2536,,,,2536,2536,0,0,0,0.00,20
,20171201,2536,2536,2580,2580,2580,2580,2580,44,44,2,5.16,18
,20171204,2580,2580,,,,2580,2580,0,0,0,0.00,18
,20171205,2580,2580,,,,2580,2580,0,0,0,0.00,18
,20171206,2580,2580,,,,2580,2580,0,0,0,0.00,18
,20171207,2580,2580,2518,2518,2468,2488,2496,-92,-84,8,19.98,16
,20171208,2488,2496,,,,2496,2496,0,0,0,0.00,16
,20171211,2496,2496,,,,2496,2496,0,0,0,0.00,16
,20171212,2496,2496,2460,2460,2460,2460,2460,-36,-36,4,9.84,14
,20171213,2460,2460,2488,2504,2458,2484,2482,24,22,10,24.83,16
,20171214,2484,2482,2452,2452,2452,2452,2452,-30,-30,2,4.90,14
,20171215,2452,2452,2472,2472,2452,2452,2462,0,10,4,9.85,14
,20171218,2452,2462,2452,2452,2452,2452,2452,-10,-10,2,4.90,14
,20171219,2452,2452,,,,2452,2452,0,0,0,0.00,14
,20171220,2452,2452,,,,2452,2452,0,0,0,0.00,14
,20171221,2452,2452,2452,2472,2452,2452,2456,0,4,10,24.56,12
,20171222,2452,2456,,,,2456,2456,0,0,0,0.00,12
,20171225,2456,2456,,,,2456,2456,0,0,0,0.00,12
,20171226,2456,2456,2456,2456,2456,2456,2456,0,0,2,4.91,12
,20171227,2456,2456,,,,2456,2456,0,0,0,0.00,12
,20171228,2456,2456,2476,2476,2476,2476,2476,20,20,2,4.95,12
,20171229,2476,2476,,,,2476,2476,0,0,0,0.00,12
bu1803,20170103,2952,2962,3080,3080,2916,2916,2966,-46,4,146,433.06,58
,20170104,2916,2966,2906,2948,2900,2948,2910,-18,-56,28,81.52,40
,20170105,2948,2910,2956,2956,2940,2946,2946,36,36,6,17.68,42
,20170106,2946,2946,2950,2998,2928,2928,2962,-18,16,8,23.70,38
,20170109,2928,2962,2928,2928,2928,2928,2928,-34,-34,2,5.86,38
,20170110,2928,2928,2924,2924,2906,2924,2916,-4,-12,12,35.01,44
,20170111,2924,2916,2986,2986,2938,2938,2962,22,46,12,35.55,42
,20170112,2938,2962,2944,2944,2944,2944,2944,-18,-18,2,5.89,42
,20170113,2944,2944,2990,2992,2978,2980,2984,36,40,8,23.88,42
,20170116,2980,2984,3000,3000,2992,2992,2996,8,12,6,17.98,42
,20170117,2992,2996,2948,2948,2934,2934,2938,-62,-58,6,17.63,40
,20170118,2934,2938,2948,2948,2942,2942,2944,4,6,4,11.78,38
,20170119,2942,2944,,,,2944,2944,0,0,0,0.00,38
,20170120,2944,2944,2912,2912,2878,2878,2886,-66,-58,14,40.42,38
,20170123,2878,2886,2878,2878,2878,2878,2878,-8,-8,2,5.76,38
,20170124,2878,2878,,,,2880,2880,2,2,0,0.00,38
,20170125,2880,2880,,,,2880,2880,0,0,0,0.00,38
,20170126,2880,2880,2942,2942,2934,2934,2938,54,58,6,17.64,36
,20170203,2934,2938,2944,2976,2944,2976,2962,38,24,6,17.77,38
,20170206,2976,2962,,,,2980,2980,18,18,0,0.00,38
,20170207,2980,2980,,,,2980,2980,0,0,0,0.00,38
,20170208,2980,2980,2996,3000,2996,3000,2998,20,18,6,17.99,34
,20170209,3000,2998,,,,2998,2998,0,0,0,0.00,34
,20170210,2998,2998,3050,3050,3050,3050,3050,52,52,2,6.10,34
,20170213,3050,3050,3094,3150,3094,3114,3116,64,66,14,43.62,38
,20170214,3114,3116,3120,3146,3120,3146,3132,30,16,6,18.79,36
,20170215,3146,3132,3080,3080,3052,3052,3072,-80,-60,8,24.58,28
,20170216,3052,3072,3078,3078,3078,3078,3078,6,6,2,6.16,28
,20170217,3078,3078,3056,3056,3056,3056,3056,-22,-22,2,6.11,26
,20170220,3056,3056,3032,3032,3032,3032,3032,-24,-24,2,6.06,24
,20170221,3032,3032,,,,3034,3034,2,2,0,0.00,24
,20170222,3034,3034,3134,3134,3114,3114,3124,80,90,6,18.75,24
,20170223,3114,3124,3052,3142,3052,3052,3082,-72,-42,6,18.49,26
,20170224,3052,3082,3076,3076,3042,3072,3064,-10,-18,8,24.52,26
,20170227,3072,3064,3148,3148,3090,3118,3118,54,54,12,37.42,34
,20170228,3118,3118,3096,3096,3096,3096,3096,-22,-22,2,6.19,34
,20170301,3096,3096,,,,3096,3096,0,0,0,0.00,34
,20170302,3096,3096,,,,3096,3096,0,0,0,0.00,34
,20170303,3096,3096,3078,3144,3078,3144,3116,48,20,14,43.63,36
,20170306,3144,3116,3062,3062,3062,3062,3062,-54,-54,6,18.37,34
,20170307,3062,3062,,,,3062,3062,0,0,0,0.00,34
,20170308,3062,3062,3042,3042,3036,3036,3040,-26,-22,6,18.24,30
,20170309,3036,3040,3004,3004,2934,2934,2966,-106,-74,14,41.52,32
,20170310,2934,2966,2880,2880,2880,2880,2880,-86,-86,2,5.76,32
,20170313,2880,2880,2888,2922,2840,2922,2886,42,6,26,75.08,40
,20170314,2922,2886,2884,2904,2836,2836,2862,-50,-24,16,45.82,44
,20170315,2836,2862,2818,2964,2818,2928,2878,66,16,12,34.55,40
,20170316,2928,2878,2868,2912,2844,2844,2888,-34,10,52,150.20,56
,20170317,2844,2888,2888,2888,2844,2854,2856,-34,-32,8,22.86,50
,20170320,2854,2856,2912,2912,2912,2912,2912,56,56,2,5.82,52
,20170321,2912,2912,2848,2848,2842,2848,2844,-64,-68,26,73.95,78
,20170322,2848,2844,2830,2830,2752,2752,2806,-92,-38,24,67.36,68
,20170323,2752,2806,2750,2750,2722,2728,2732,-78,-74,10,27.33,74
,20170324,2728,2732,,,,2732,2732,0,0,0,0.00,74
,20170327,2732,2732,2726,2738,2700,2710,2724,-22,-8,28,76.27,54
,20170328,2710,2724,2774,2780,2750,2750,2762,26,38,8,22.11,52
,20170329,2750,2762,2770,2778,2770,2778,2774,16,12,6,16.65,56
,20170330,2778,2774,,,,2774,2774,0,0,0,0.00,56
,20170331,2774,2774,2734,2734,2734,2734,2734,-40,-40,2,5.47,56
,20170405,2734,2734,2850,2924,2848,2924,2900,190,166,56,162.46,46
,20170406,2924,2900,2960,2984,2960,2984,2970,84,70,26,77.22,46
,20170407,2984,2970,2994,3012,2938,2938,2980,-32,10,20,59.61,32
,20170410,2938,2980,2944,2980,2944,2960,2960,-20,-20,8,23.68,32
,20170411,2960,2960,2918,2918,2824,2824,2864,-136,-96,10,28.65,34
,20170412,2824,2864,2796,2814,2794,2814,2802,-50,-62,8,22.42,32
,20170413,2814,2802,2814,2814,2814,2814,2814,12,12,2,5.63,34
,20170414,2814,2814,2720,2736,2698,2698,2716,-116,-98,12,32.60,30
,20170417,2698,2716,2746,2746,2736,2736,2738,20,22,6,16.44,24
,20170418,2736,2738,,,,2738,2738,0,0,0,0.00,24
,20170419,2738,2738,2638,2726,2628,2688,2660,-50,-78,18,47.90,26
,20170420,2688,2660,,,,2660,2660,0,0,0,0.00,26
,20170421,2660,2660,2718,2750,2666,2666,2710,6,50,10,27.10,24
,20170424,2666,2710,,,,2710,2710,0,0,0,0.00,24
,20170425,2710,2710,2716,2716,2702,2702,2708,-8,-2,6,16.25,22
,20170426,2702,2708,2712,2756,2636,2756,2684,48,-24,18,48.31,28
,20170427,2756,2684,2678,2700,2678,2700,2688,16,4,4,10.76,24
,20170428,2700,2688,2722,2722,2722,2722,2722,34,34,2,5.44,22
,20170502,2722,2722,2778,2778,2778,2778,2778,56,56,4,11.11,18
,20170503,2778,2778,,,,2778,2778,0,0,0,0.00,18
,20170504,2778,2778,2718,2718,2636,2636,2686,-142,-92,16,43.00,26
,20170505,2636,2686,,,,2610,2610,-76,-76,0,0.00,26
,20170508,2610,2610,,,,2610,2610,0,0,0,0.00,26
,20170509,2610,2610,,,,2610,2610,0,0,0,0.00,26
,20170510,2610,2610,2594,2638,2580,2580,2598,-30,-12,14,36.39,26
,20170511,2580,2598,2594,2594,2566,2566,2582,-32,-16,6,15.49,30
,20170512,2566,2582,2618,2618,2618,2618,2618,36,36,2,5.24,30
,20170515,2618,2618,,,,2618,2618,0,0,0,0.00,30
,20170516,2618,2618,2600,2660,2600,2660,2630,42,12,4,10.52,28
,20170517,2660,2630,2674,2674,2668,2668,2670,38,40,4,10.68,26
,20170518,2668,2670,,,,2670,2670,0,0,0,0.00,26
,20170519,2670,2670,2714,2762,2712,2762,2722,92,52,12,32.67,20
,20170522,2762,2722,,,,2722,2722,0,0,0,0.00,20
,20170523,2722,2722,2670,2670,2670,2670,2670,-52,-52,2,5.34,18
,20170524,2670,2670,2676,2676,2676,2676,2676,6,6,2,5.35,16
,20170525,2676,2676,,,,2676,2676,0,0,0,0.00,16
,20170526,2676,2676,,,,2676,2676,0,0,0,0.00,16
,20170531,2676,2676,,,,2592,2592,-84,-84,0,0.00,16
,20170601,2592,2592,,,,2580,2580,-12,-12,0,0.00,16
,20170602,2580,2580,,,,2566,2566,-14,-14,0,0.00,16
,20170605,2566,2566,,,,2566,2566,0,0,0,0.00,16
,20170606,2566,2566,,,,2566,2566,0,0,0,0.00,16
,20170607,2566,2566,,,,2566,2566,0,0,0,0.00,16
,20170608,2566,2566,,,,2566,2566,0,0,0,0.00,16
,20170609,2566,2566,,,,2566,2566,0,0,0,0.00,16
,20170612,2566,2566,2484,2528,2484,2500,2500,-66,-66,24,60.04,32
,20170613,2500,2500,,,,2498,2498,-2,-2,0,0.00,32
,20170614,2498,2498,2450,2530,2450,2480,2494,-18,-4,10,24.94,36
,20170615,2480,2494,2500,2508,2466,2508,2490,14,-4,6,14.95,42
,20170616,2508,2490,,,,2490,2490,0,0,0,0.00,42
,20170619,2490,2490,2490,2490,2462,2464,2470,-26,-20,8,19.76,46
,20170620,2464,2470,2490,2490,2488,2488,2488,18,18,6,14.94,44
,20170621,2488,2488,2444,2446,2444,2446,2444,-42,-44,4,9.78,48
,20170622,2446,2444,2448,2448,2448,2448,2448,4,4,2,4.90,46
,20170623,2448,2448,2444,2444,2444,2444,2444,-4,-4,2,4.89,46
,20170626,2444,2444,2436,2494,2430,2444,2454,0,10,18,44.20,54
,20170627,2444,2454,,,,2454,2454,0,0,0,0.00,54
,20170628,2454,2454,2464,2490,2452,2452,2468,-2,14,6,14.81,56
,20170629,2452,2468,2478,2496,2478,2496,2482,28,14,8,19.86,54
,20170630,2496,2482,2466,2508,2466,2476,2484,-6,2,12,29.81,50
,20170703,2476,2484,2500,2512,2500,2512,2506,28,22,4,10.02,48
,20170704,2512,2506,2452,2498,2452,2498,2468,-8,-38,10,24.69,48
,20170705,2498,2468,,,,2468,2468,0,0,0,0.00,48
,20170706,2468,2468,,,,2468,2468,0,0,0,0.00,48
,20170707,2468,2468,2572,2572,2506,2554,2546,86,78,38,96.80,34
,20170710,2554,2546,2516,2548,2516,2546,2536,0,-10,6,15.22,34
,20170711,2546,2536,2558,2612,2530,2612,2566,76,30,16,41.06,26
,20170712,2612,2566,2606,2682,2602,2606,2618,40,52,34,89.06,32
,20170713,2606,2618,2624,2628,2616,2628,2622,10,4,6,15.74,30
,20170714,2628,2622,2652,2700,2652,2664,2652,42,30,110,291.92,134
,20170717,2664,2652,2708,2726,2650,2726,2694,74,42,26,70.05,136
,20170718,2726,2694,,,,2694,2694,0,0,0,0.00,136
,20170719,2694,2694,,,,2694,2694,0,0,0,0.00,136
,20170720,2694,2694,2710,2710,2710,2710,2710,16,16,2,5.42,136
,20170721,2710,2710,,,,2688,2688,-22,-22,0,0.00,136
,20170724,2688,2688,2740,2740,2644,2688,2690,0,2,6,16.14,138
,20170725,2688,2690,2750,2750,2750,2750,2750,60,60,2,5.50,138
,20170726,2750,2750,2762,2762,2762,2762,2762,12,12,2,5.52,136
,20170727,2762,2762,,,,2762,2762,0,0,0,0.00,136
,20170728,2762,2762,,,,2762,2762,0,0,0,0.00,136
,20170731,2762,2762,,,,2762,2762,0,0,0,0.00,136
,20170801,2762,2762,2804,2804,2746,2754,2768,-8,6,6,16.61,134
,20170802,2754,2768,2692,2752,2692,2752,2720,-16,-48,10,27.22,138
,20170803,2752,2720,2732,2758,2732,2740,2740,20,20,8,21.92,138
,20170804,2740,2740,2718,2748,2718,2722,2730,-18,-10,16,43.68,140
,20170807,2722,2730,2670,2670,2670,2670,2670,-60,-60,2,5.34,140
,20170808,2670,2670,2708,2708,2708,2708,2708,38,38,2,5.42,138
,20170809,2708,2708,2762,2782,2746,2746,2762,38,54,6,16.58,136
,20170810,2746,2762,2812,2812,2756,2770,2770,8,8,108,299.26,134
,20170811,2770,2770,2710,2710,2700,2700,2704,-70,-66,100,270.40,80
,20170814,2700,2704,2642,2678,2642,2678,2666,-26,-38,12,32.00,74
,20170815,2678,2666,2698,2698,2632,2632,2664,-34,-2,4,10.66,74
,20170816,2632,2664,2608,2716,2608,2674,2670,10,6,278,742.35,72
,20170817,2674,2670,2730,2732,2730,2732,2730,62,60,4,10.92,70
,20170818,2732,2730,,,,2730,2730,0,0,0,0.00,70
,20170821,2730,2730,2730,2888,2730,2788,2802,58,72,6,16.81,70
,20170822,2788,2802,2760,2774,2736,2774,2760,-28,-42,16,44.18,66
,20170823,2774,2760,2770,2838,2770,2802,2810,42,50,20,56.24,64
,20170824,2802,2810,2766,2792,2754,2780,2764,-30,-46,24,66.38,48
,20170825,2780,2764,2792,2852,2784,2842,2816,78,52,42,118.28,28
,20170828,2842,2816,2806,2806,2806,2806,2806,-10,-10,8,22.45,36
,20170829,2806,2806,2772,2772,2762,2762,2768,-44,-38,10,27.68,30
,20170830,2762,2768,,,,2768,2768,0,0,0,0.00,30
,20170831,2768,2768,2728,2728,2728,2728,2728,-40,-40,2,5.46,30
,20170901,2728,2728,,,,2728,2728,0,0,0,0.00,30
,20170904,2728,2728,,,,2728,2728,0,0,0,0.00,30
,20170905,2728,2728,2688,2688,2662,2668,2678,-60,-50,10,26.79,28
,20170906,2668,2678,2708,2712,2678,2692,2694,14,16,36,97.00,34
,20170907,2692,2694,2700,2700,2604,2604,2634,-90,-60,136,358.44,122
,20170908,2604,2634,2614,2614,2520,2560,2554,-74,-80,56,143.11,138
,20170911,2560,2554,,,,2554,2554,0,0,0,0.00,138
,20170912,2554,2554,,,,2554,2554,0,0,0,0.00,138
,20170913,2554,2554,,,,2554,2554,0,0,0,0.00,138
,20170914,2554,2554,2598,2598,2570,2570,2580,16,26,8,20.65,140
,20170915,2570,2580,2554,2554,2554,2554,2554,-26,-26,2,5.11,140
,20170918,2554,2554,,,,2554,2554,0,0,0,0.00,140
,20170919,2554,2554,,,,2554,2554,0,0,0,0.00,140
,20170920,2554,2554,2550,2550,2550,2550,2550,-4,-4,2,5.10,138
,20170921,2550,2550,2580,2580,2510,2532,2522,-18,-28,34,85.80,134
,20170922,2532,2522,2570,2570,2570,2570,2570,48,48,2,5.14,134
,20170925,2570,2570,,,,2570,2570,0,0,0,0.00,134
,20170926,2570,2570,,,,2578,2578,8,8,0,0.00,134
,20170927,2578,2578,2586,2586,2584,2584,2584,6,6,6,15.51,136
,20170928,2584,2584,2574,2574,2538,2538,2548,-46,-36,10,25.49,132
,20170929,2538,2548,2520,2520,2520,2520,2520,-28,-28,2,5.04,130
,20171009,2520,2520,2528,2530,2430,2452,2466,-68,-54,22,54.28,128
,20171010,2452,2466,2458,2464,2444,2444,2448,-22,-18,14,34.28,122
,20171011,2444,2448,2468,2476,2460,2468,2470,20,22,12,29.65,122
,20171012,2468,2470,2446,2466,2446,2466,2452,-4,-18,6,14.72,118
,20171013,2466,2452,2472,2472,2472,2472,2472,20,20,2,4.94,120
,20171016,2472,2472,2514,2514,2482,2482,2496,10,24,6,14.98,122
,20171017,2482,2496,,,,2496,2496,0,0,0,0.00,122
,20171018,2496,2496,2478,2528,2472,2484,2498,-12,2,24,59.96,116
,20171019,2484,2498,2460,2472,2460,2470,2464,-28,-34,8,19.72,118
,20171020,2470,2464,2422,2486,2422,2486,2456,22,-8,24,58.94,118
,20171023,2486,2456,2486,2528,2460,2494,2484,38,28,20,49.71,118
,20171024,2494,2484,2486,2500,2484,2500,2486,16,2,12,29.85,114
,20171025,2500,2486,2510,2548,2510,2548,2524,62,38,10,25.24,120
,20171026,2548,2524,2538,2538,2530,2530,2534,6,10,4,10.14,118
,20171027,2530,2534,2548,2548,2548,2548,2548,14,14,2,5.10,118
,20171030,2548,2548,2522,2580,2522,2574,2560,26,12,16,40.98,118
,20171031,2574,2560,2568,2578,2542,2550,2554,-10,-6,44,112.43,136
,20171101,2550,2554,2540,2574,2540,2564,2558,10,4,28,71.64,142
,20171102,2564,2558,2568,2580,2544,2544,2558,-14,0,16,40.94,138
,20171103,2544,2558,2560,2580,2560,2578,2574,20,16,24,61.78,130
,20171106,2578,2574,,,,2574,2574,0,0,0,0.00,130
,20171107,2574,2574,2596,2638,2596,2610,2618,36,44,52,136.20,130
,20171108,2610,2618,2602,2620,2602,2620,2610,2,-8,14,36.55,126
,20171109,2620,2610,2638,2640,2610,2610,2626,0,16,16,42.02,124
,20171110,2610,2626,2616,2618,2602,2602,2610,-24,-16,28,73.11,122
,20171113,2602,2610,2608,2632,2606,2630,2620,20,10,110,288.34,96
,20171114,2630,2620,2616,2628,2616,2618,2620,-2,0,28,73.37,80
,20171115,2618,2620,2616,2622,2530,2532,2582,-88,-38,80,206.61,98
,20171116,2532,2582,2538,2540,2536,2540,2538,-42,-44,22,55.85,118
,20171117,2540,2538,2544,2544,2530,2536,2534,-2,-4,10,25.35,116
,20171120,2536,2534,2532,2582,2518,2582,2546,48,12,52,132.48,114
,20171121,2582,2546,2600,2604,2584,2604,2598,58,52,28,72.77,110
,20171122,2604,2598,2580,2614,2580,2612,2600,14,2,24,62.42,100
,20171123,2612,2600,2630,2652,2628,2652,2634,52,34,44,115.96,96
,20171124,2652,2634,2620,2658,2620,2658,2638,24,4,22,58.08,98
,20171127,2658,2638,2626,2626,2612,2612,2620,-26,-18,6,15.73,100
,20171128,2612,2620,2612,2614,2594,2614,2608,-6,-12,8,20.87,100
,20171129,2614,2608,2600,2600,2600,2600,2600,-8,-8,2,5.20,100
,20171130,2600,2600,2618,2620,2616,2620,2616,20,16,14,36.64,96
,20171201,2620,2616,2614,2648,2608,2644,2626,28,10,26,68.28,88
,20171204,2644,2626,2644,2676,2640,2640,2666,14,40,38,101.34,104
,20171205,2640,2666,2638,2676,2632,2632,2662,-34,-4,26,69.24,96
,20171206,2632,2662,2660,2660,2652,2652,2656,-10,-6,6,15.94,98
,20171207,2652,2656,2634,2634,2516,2516,2596,-140,-60,10,25.97,98
,20171208,2516,2596,2520,2550,2516,2550,2532,-46,-64,10,25.32,94
,20171211,2550,2532,2516,2550,2516,2550,2532,18,0,4,10.13,96
,20171212,2550,2532,2540,2540,2516,2516,2524,-16,-8,6,15.14,98
,20171213,2516,2524,2560,2560,2518,2518,2538,-6,14,4,10.16,98
,20171214,2518,2538,2522,2522,2522,2522,2522,-16,-16,2,5.04,98
,20171215,2522,2522,2536,2536,2520,2520,2528,-2,6,4,10.11,96
,20171218,2520,2528,2566,2566,2566,2566,2566,38,38,2,5.13,96
,20171219,2566,2566,2560,2560,2560,2560,2560,-6,-6,4,10.24,96
,20171220,2560,2560,2552,2552,2552,2552,2552,-8,-8,4,10.21,92
,20171221,2552,2552,2516,2516,2516,2516,2516,-36,-36,32,80.51,92
,20171222,2516,2516,,,,2516,2516,0,0,0,0.00,92
,20171225,2516,2516,2482,2482,2482,2482,2482,-34,-34,2,4.96,90
,20171226,2482,2482,2512,2512,2512,2512,2512,30,30,2,5.02,90
,20171227,2512,2512,,,,2512,2512,0,0,0,0.00,90
,20171228,2512,2512,2512,2524,2512,2524,2518,12,6,4,10.07,90
,20171229,2524,2518,,,,2518,2518,0,0,0,0.00,90
bu1804,20171017,2496,2496,,,,2496,2496,0,0,0,0.00,0
,20171018,2496,2496,,,,2496,2496,0,0,0,0.00,0
,20171019,2496,2496,,,,2496,2496,0,0,0,0.00,0
,20171020,2496,2496,,,,2496,2496,0,0,0,0.00,0
,20171023,2496,2496,,,,2496,2496,0,0,0,0.00,0
,20171024,2496,2496,2494,2574,2494,2532,2532,36,36,22,55.74,4
,20171025,2532,2532,,,,2570,2570,38,38,0,0.00,4
,20171026,2570,2570,2594,2594,2546,2546,2570,-24,0,4,10.28,4
,20171027,2546,2570,,,,2570,2570,0,0,0,0.00,4
,20171030,2570,2570,,,,2582,2582,12,12,0,0.00,4
,20171031,2582,2582,,,,2582,2582,0,0,0,0.00,4
,20171101,2582,2582,,,,2582,2582,0,0,0,0.00,4
,20171102,2582,2582,,,,2582,2582,0,0,0,0.00,4
,20171103,2582,2582,,,,2598,2598,16,16,0,0.00,4
,20171106,2598,2598,2630,2630,2606,2606,2618,8,20,4,10.47,6
,20171107,2606,2618,,,,2664,2664,46,46,0,0.00,6
,20171108,2664,2664,,,,2664,2664,0,0,0,0.00,6
,20171109,2664,2664,2624,2624,2624,2624,2624,-40,-40,4,10.50,8
,20171110,2624,2624,2678,2678,2636,2636,2656,12,32,4,10.63,8
,20171113,2636,2656,2614,2646,2614,2644,2630,-12,-26,12,31.56,8
,20171114,2644,2630,,,,2630,2630,0,0,0,0.00,8
,20171115,2630,2630,2554,2566,2554,2566,2562,-64,-68,12,30.75,8
,20171116,2566,2562,,,,2562,2562,0,0,0,0.00,8
,20171117,2562,2562,2542,2560,2542,2560,2550,-2,-12,4,10.20,10
,20171120,2560,2550,,,,2562,2562,12,12,0,0.00,10
,20171121,2562,2562,,,,2562,2562,0,0,0,0.00,10
,20171122,2562,2562,,,,2564,2564,2,2,0,0.00,10
,20171123,2564,2564,,,,2564,2564,0,0,0,0.00,10
,20171124,2564,2564,,,,2568,2568,4,4,0,0.00,10
,20171127,2568,2568,2698,2698,2644,2644,2658,76,90,8,21.27,6
,20171128,2644,2658,2636,2636,2636,2636,2636,-22,-22,2,5.27,4
,20171129,2636,2636,,,,2636,2636,0,0,0,0.00,4
,20171130,2636,2636,,,,2636,2636,0,0,0,0.00,4
,20171201,2636,2636,,,,2636,2636,0,0,0,0.00,4
,20171204,2636,2636,,,,2676,2676,40,40,0,0.00,4
,20171205,2676,2676,2710,2710,2658,2658,2666,-18,-10,12,32.00,12
,20171206,2658,2666,,,,2666,2666,0,0,0,0.00,12
,20171207,2666,2666,,,,2606,2606,-60,-60,0,0.00,12
,20171208,2606,2606,2602,2602,2548,2548,2580,-58,-26,18,46.45,6
,20171211,2548,2580,,,,2580,2580,0,0,0,0.00,6
,20171212,2580,2580,,,,2570,2570,-10,-10,0,0.00,6
,20171213,2570,2570,,,,2570,2570,0,0,0,0.00,6
,20171214,2570,2570,,,,2552,2552,-18,-18,0,0.00,6
,20171215,2552,2552,,,,2552,2552,0,0,0,0.00,6
,20171218,2552,2552,,,,2552,2552,0,0,0,0.00,6
,20171219,2552,2552,,,,2552,2552,0,0,0,0.00,6
,20171220,2552,2552,,,,2552,2552,0,0,0,0.00,6
,20171221,2552,2552,,,,2516,2516,-36,-36,0,0.00,6
,20171222,2516,2516,,,,2516,2516,0,0,0,0.00,6
,20171225,2516,2516,,,,2516,2516,0,0,0,0.00,6
,20171226,2516,2516,,,,2516,2516,0,0,0,0.00,6
,20171227,2516,2516,,,,2516,2516,0,0,0,0.00,6
,20171228,2516,2516,,,,2516,2516,0,0,0,0.00,6
,20171229,2516,2516,,,,2516,2516,0,0,0,0.00,6
bu1805,20171116,2562,2562,,,,2562,2562,0,0,0,0.00,0
,20171117,2562,2562,2568,2620,2568,2604,2592,42,30,44,114.07,24
,20171120,2604,2592,2600,2656,2596,2656,2628,64,36,70,184.06,42
,20171121,2656,2628,2674,2688,2654,2672,2670,44,42,52,138.94,44
,20171122,2672,2670,2720,2720,2720,2720,2720,50,50,2,5.44,44
,20171123,2720,2720,2738,2748,2682,2724,2722,4,2,160,435.52,82
,20171124,2724,2722,2736,2760,2724,2760,2748,38,26,34,93.46,96
,20171127,2760,2748,2760,2768,2690,2720,2728,-28,-20,176,480.32,102
,20171128,2720,2728,2642,2702,2642,2702,2676,-26,-52,236,631.81,76
,20171129,2702,2676,2678,2712,2670,2684,2680,8,4,102,273.37,106
,20171130,2684,2680,2662,2722,2650,2710,2676,30,-4,156,417.60,134
,20171201,2710,2676,2730,2750,2700,2746,2722,70,46,88,239.62,128
,20171204,2746,2722,2758,2798,2734,2762,2772,40,50,344,954.04,216
,20171205,2762,2772,2750,2790,2724,2734,2758,-38,-14,196,540.65,232
,20171206,2734,2758,2728,2796,2706,2738,2750,-20,-8,190,522.74,202
,20171207,2738,2750,2706,2708,2588,2596,2640,-154,-110,282,744.73,212
,20171208,2596,2640,2556,2630,2554,2612,2596,-28,-44,334,867.57,170
,20171211,2612,2596,2654,2654,2580,2596,2612,0,16,198,517.49,184
,20171212,2596,2612,2636,2662,2546,2576,2590,-36,-22,226,585.48,186
,20171213,2576,2590,2560,2610,2560,2582,2578,-8,-12,132,340.36,184
,20171214,2582,2578,2616,2636,2572,2590,2594,12,16,234,607.36,140
,20171215,2590,2594,2574,2592,2566,2590,2578,-4,-16,112,288.75,160
,20171218,2590,2578,2602,2634,2592,2620,2614,42,36,170,444.58,214
,20171219,2620,2614,2616,2624,2588,2608,2610,-6,-4,396,"1,033.73",200
,20171220,2608,2610,2620,2636,2610,2610,2614,0,4,614,"1,605.88",516
,20171221,2610,2614,2618,2620,2538,2560,2568,-54,-46,1366,"3,509.99",208
,20171222,2560,2568,2560,2578,2552,2552,2566,-16,-2,216,554.38,138
,20171225,2552,2566,2570,2576,2534,2564,2558,-2,-8,176,450.55,222
,20171226,2564,2558,2578,2586,2554,2580,2574,22,16,138,355.44,240
,20171227,2580,2574,2586,2600,2562,2582,2578,8,4,282,727.04,296
,20171228,2582,2578,2602,2606,2580,2606,2598,28,20,230,597.65,222
,20171229,2606,2598,2598,2634,2582,2602,2596,4,-2,460,"1,194.74",214
bu1806,20170103,3004,2990,3030,3066,2956,2956,2994,-34,4,172,515.18,1166
,20170104,2956,2994,2980,2992,2938,2992,2958,-2,-36,122,361.05,1118
,20170105,2992,2958,2988,2990,2960,2984,2976,26,18,66,196.46,1136
,20170106,2984,2976,2986,3034,2980,2998,3008,22,32,120,361.15,1154
,20170109,2998,3008,3008,3020,2988,3016,3008,8,0,70,210.56,1190
,20170110,3016,3008,3028,3028,2940,2966,2966,-42,-42,74,219.62,1162
,20170111,2966,2966,3040,3040,2960,2960,2996,-6,30,98,293.70,1172
,20170112,2960,2996,2976,3016,2964,2984,2990,-12,-6,26,77.75,1172
,20170113,2984,2990,3036,3036,2996,3014,3012,24,22,52,156.63,1182
,20170116,3014,3012,3008,3044,3008,3016,3022,4,10,74,223.67,1182
,20170117,3016,3022,3012,3036,2958,2972,3014,-50,-8,172,518.66,1212
,20170118,2972,3014,2986,2998,2960,2978,2980,-36,-34,98,292.06,1200
,20170119,2978,2980,2956,2956,2930,2946,2944,-34,-36,32,94.22,1190
,20170120,2946,2944,2954,2954,2900,2900,2924,-44,-20,34,99.45,1190
,20170123,2900,2924,2912,2964,2908,2964,2926,40,2,34,99.52,1178
,20170124,2964,2926,2946,2956,2920,2938,2940,12,14,34,99.99,1166
,20170125,2938,2940,2950,2958,2922,2944,2940,4,0,46,135.26,1152
,20170126,2944,2940,2958,2978,2958,2978,2970,38,30,18,53.49,1148
,20170203,2978,2970,2984,3004,2970,2998,2984,28,14,40,119.38,1150
,20170206,2998,2984,3000,3020,2992,3020,3008,36,24,32,96.30,1160
,20170207,3020,3008,3004,3016,2990,3014,3002,6,-6,26,78.09,1170
,20170208,3014,3002,2998,3040,2992,3040,3002,38,0,80,240.21,1186
,20170209,3040,3002,3028,3048,3028,3028,3034,26,32,42,127.45,1186
,20170210,3028,3034,3036,3092,3032,3090,3066,56,32,118,361.92,1202
,20170213,3090,3066,3118,3204,3096,3152,3164,86,98,234,740.50,1264
,20170214,3152,3164,3148,3208,3148,3160,3174,-4,10,86,273.02,1262
,20170215,3160,3174,3164,3164,3092,3106,3126,-68,-48,58,181.41,1248
,20170216,3106,3126,3090,3128,3058,3058,3082,-68,-44,116,357.58,1242
,20170217,3058,3082,3160,3160,3062,3068,3086,-14,4,40,123.47,1234
,20170220,3068,3086,3078,3162,3054,3162,3118,76,32,72,224.58,1264
,20170221,3162,3118,3168,3168,3120,3120,3158,2,40,22,69.49,1270
,20170222,3120,3158,3140,3170,3130,3170,3152,12,-6,56,176.52,1278
,20170223,3170,3152,3142,3156,3074,3096,3110,-56,-42,50,155.52,1250
,20170224,3096,3110,3100,3126,3064,3126,3088,16,-22,196,605.52,1242
,20170227,3126,3088,3144,3190,3126,3182,3168,94,80,196,620.98,1246
,20170228,3182,3168,3186,3186,3140,3144,3168,-24,0,94,297.90,1270
,20170301,3144,3168,3160,3210,3142,3196,3186,28,18,60,191.17,1280
,20170302,3196,3186,3198,3198,3160,3164,3174,-22,-12,64,203.23,1282
,20170303,3164,3174,3142,3158,3130,3150,3142,-24,-32,54,169.76,1256
,20170306,3150,3142,3156,3156,3110,3114,3128,-28,-14,82,256.60,1290
,20170307,3114,3128,3126,3146,3126,3128,3136,0,8,16,50.19,1288
,20170308,3128,3136,3156,3172,3068,3080,3110,-56,-26,140,435.67,1304
,20170309,3080,3110,3070,3070,2946,2980,3002,-130,-108,226,678.76,1292
,20170310,2980,3002,2954,2998,2924,2974,2964,-28,-38,92,272.82,1290
,20170313,2974,2964,2974,3020,2930,3020,2956,56,-8,130,384.34,1266
,20170314,3020,2956,3038,3038,2948,2960,2970,4,14,92,273.38,1272
,20170315,2960,2970,2912,3036,2910,3010,2958,40,-12,340,"1,005.77",1236
,20170316,3010,2958,3022,3028,3004,3010,3010,52,52,82,246.89,1218
,20170317,3010,3010,2998,3008,2980,2982,2988,-28,-22,116,346.75,1192
,20170320,2982,2988,3018,3018,2968,2972,2982,-16,-6,82,244.53,1194
,20170321,2972,2982,2970,2992,2962,2974,2976,-8,-6,154,458.39,1200
,20170322,2974,2976,2978,2980,2874,2880,2908,-96,-68,170,494.49,1190
,20170323,2880,2908,2896,2928,2864,2874,2896,-34,-12,146,422.97,1174
,20170324,2874,2896,2874,2890,2870,2886,2878,-10,-18,30,86.35,1166
,20170327,2886,2878,2878,2878,2824,2856,2840,-22,-38,210,596.59,1166
,20170328,2856,2840,2856,2904,2842,2880,2864,40,24,102,292.21,1164
,20170329,2880,2864,2898,2898,2880,2892,2888,28,24,96,277.40,1208
,20170330,2892,2888,2878,2914,2864,2870,2878,-18,-10,60,172.78,1210
,20170331,2870,2878,2880,2912,2870,2878,2882,0,4,80,230.60,1234
,20170405,2878,2882,3058,3060,2876,3042,3008,160,126,198,595.59,1268
,20170406,3042,3008,3030,3050,3004,3038,3028,30,20,278,841.83,1330
,20170407,3038,3028,3032,3068,2992,3000,3020,-28,-8,892,"2,693.85",1734
,20170410,3000,3020,2996,3032,2984,3008,3010,-12,-10,262,788.74,1806
,20170411,3008,3010,3024,3024,2880,2890,2938,-120,-72,134,393.81,1788
,20170412,2890,2938,2878,2904,2840,2840,2880,-98,-58,160,460.93,1798
,20170413,2840,2880,2840,2888,2838,2870,2862,-10,-18,114,326.33,1820
,20170414,2870,2862,2878,2880,2750,2768,2798,-94,-64,214,599.02,1828
,20170417,2768,2798,2788,2826,2760,2784,2790,-14,-8,74,206.60,1822
,20170418,2784,2790,2786,2796,2746,2766,2772,-24,-18,52,144.16,1812
,20170419,2766,2772,2738,2784,2680,2782,2730,10,-42,368,"1,004.78",1912
,20170420,2782,2730,2798,2800,2720,2780,2758,50,28,90,248.37,1910
,20170421,2780,2758,2780,2808,2758,2758,2786,0,28,78,217.39,1918
,20170424,2758,2786,2766,2766,2732,2766,2750,-20,-36,34,93.55,1918
,20170425,2766,2750,2822,2822,2702,2768,2764,18,14,34,94.00,1918
,20170426,2768,2764,2794,2794,2708,2750,2732,-14,-32,84,229.53,1926
,20170427,2750,2732,2744,2776,2744,2764,2756,32,24,114,314.32,1932
,20170428,2764,2756,2758,2846,2758,2814,2814,58,58,200,562.92,2000
,20170502,2814,2814,2822,2830,2814,2830,2820,16,6,96,270.81,2042
,20170503,2830,2820,2824,2832,2820,2822,2826,2,6,116,327.90,2124
,20170504,2822,2826,2800,2806,2700,2728,2748,-98,-78,180,494.84,2162
,20170505,2728,2748,2720,2720,2634,2634,2666,-114,-82,300,799.99,2126
,20170508,2634,2666,2658,2692,2656,2668,2666,2,0,128,341.46,2084
,20170509,2668,2666,2654,2686,2650,2672,2670,6,4,82,219.10,2058
,20170510,2672,2670,2668,2692,2652,2664,2666,-6,-4,168,448.02,1984
,20170511,2664,2666,2684,2692,2604,2676,2656,10,-10,204,542.14,1940
,20170512,2676,2656,2674,2674,2624,2660,2652,4,-4,136,360.88,1936
,20170515,2660,2652,2660,2708,2646,2708,2674,56,22,140,374.58,1958
,20170516,2708,2674,2736,2740,2696,2720,2714,46,40,114,309.45,1978
,20170517,2720,2714,2728,2748,2704,2728,2726,14,12,196,534.62,2042
,20170518,2728,2726,2730,2748,2692,2722,2714,-4,-12,84,227.99,2052
,20170519,2722,2714,2710,2780,2710,2764,2758,50,44,186,513.04,2076
,20170522,2764,2758,2770,2802,2770,2780,2790,22,32,102,284.69,2114
,20170523,2780,2790,2802,2802,2720,2720,2772,-70,-18,278,771.06,2130
,20170524,2720,2772,2738,2740,2702,2724,2720,-48,-52,232,631.35,2144
,20170525,2724,2720,2726,2788,2720,2756,2754,36,34,104,286.56,2128
,20170526,2756,2754,2764,2764,2662,2688,2694,-66,-60,182,490.62,2198
,20170531,2688,2694,2682,2700,2544,2562,2618,-132,-76,448,"1,173.29",2026
,20170601,2562,2618,2556,2590,2550,2586,2578,-32,-40,420,"1,082.82",1786
,20170602,2586,2578,2570,2576,2540,2540,2556,-38,-22,230,587.88,1686
,20170605,2540,2556,2516,2590,2504,2564,2538,8,-18,300,761.42,1670
,20170606,2564,2538,2556,2590,2536,2580,2560,42,22,122,312.40,1674
,20170607,2580,2560,2576,2590,2574,2574,2580,14,20,28,72.27,1678
,20170608,2574,2580,2566,2578,2544,2572,2556,-8,-24,66,168.81,1668
,20170609,2572,2556,2560,2576,2552,2556,2562,0,6,46,117.92,1666
,20170612,2556,2562,2542,2578,2536,2568,2564,6,2,118,302.62,1674
,20170613,2568,2564,2570,2584,2544,2544,2564,-20,0,132,338.56,1700
,20170614,2544,2564,2544,2558,2508,2550,2528,-14,-36,594,"1,501.69",1768
,20170615,2550,2528,2564,2564,2520,2540,2542,12,14,78,198.31,1766
,20170616,2540,2542,2534,2550,2522,2542,2532,0,-10,124,314.20,1790
,20170619,2542,2532,2550,2606,2508,2554,2556,22,24,238,608.38,1792
,20170620,2554,2556,2554,2580,2552,2562,2566,6,10,342,878.13,1796
,20170621,2562,2566,2532,2562,2512,2526,2532,-40,-34,110,278.74,1838
,20170622,2526,2532,2530,2552,2504,2514,2532,-18,0,274,694.11,1938
,20170623,2514,2532,2518,2536,2506,2512,2514,-20,-18,446,"1,121.37",1792
,20170626,2512,2514,2508,2536,2504,2522,2520,8,6,100,252.04,1782
,20170627,2522,2520,2520,2536,2506,2532,2518,12,-2,332,836.60,1764
,20170628,2532,2518,2546,2554,2538,2548,2544,30,26,150,381.84,1780
,20170629,2548,2544,2552,2588,2544,2566,2572,22,28,290,746.22,1746
,20170630,2566,2572,2578,2588,2568,2580,2574,8,2,206,530.59,1708
,20170703,2580,2574,2590,2602,2582,2586,2592,12,18,270,699.94,1712
,20170704,2586,2592,2602,2610,2544,2562,2566,-30,-26,208,533.78,1696
,20170705,2562,2566,2562,2612,2562,2602,2592,36,26,378,980.32,1714
,20170706,2602,2592,2588,2618,2576,2606,2588,14,-4,108,279.63,1718
,20170707,2606,2588,2616,2642,2596,2610,2622,22,34,254,666.17,1722
,20170710,2610,2622,2598,2630,2584,2616,2612,-6,-10,354,924.71,1778
,20170711,2616,2612,2610,2676,2608,2670,2642,58,30,598,"1,580.52",2002
,20170712,2670,2642,2656,2696,2650,2660,2664,18,22,330,879.67,2056
,20170713,2660,2664,2660,2680,2640,2680,2666,16,2,218,581.39,2104
,20170714,2680,2666,2684,2732,2640,2720,2704,54,38,878,"2,374.16",2332
,20170717,2720,2704,2728,2766,2720,2758,2748,54,44,642,"1,765.22",2604
,20170718,2758,2748,2758,2776,2740,2740,2754,-8,6,578,"1,592.22",2522
,20170719,2740,2754,2760,2774,2754,2760,2760,6,6,468,"1,292.61",2464
,20170720,2760,2760,2770,2780,2750,2756,2764,-4,4,482,"1,333.21",2426
,20170721,2756,2764,2766,2766,2718,2734,2740,-30,-24,374,"1,025.38",2370
,20170724,2734,2740,2744,2750,2720,2740,2738,0,-2,160,438.16,2392
,20170725,2740,2738,2758,2818,2750,2812,2794,74,56,474,"1,324.77",2498
,20170726,2812,2794,2822,2834,2784,2790,2800,-4,6,374,"1,047.82",2434
,20170727,2790,2800,2800,2834,2788,2816,2810,16,10,476,"1,337.83",2498
,20170728,2816,2810,2816,2816,2738,2768,2780,-42,-30,324,901.29,2410
,20170731,2768,2780,2784,2846,2784,2832,2826,52,46,1258,"3,555.20",2972
,20170801,2832,2826,2830,2844,2806,2820,2824,-6,-2,1146,"3,236.43",3496
,20170802,2820,2824,2808,2810,2766,2796,2790,-28,-34,900,"2,511.07",3798
,20170803,2796,2790,2796,2812,2766,2766,2790,-24,0,804,"2,243.83",3746
,20170804,2766,2790,2766,2826,2756,2772,2784,-18,-6,868,"2,417.86",3710
,20170807,2772,2784,2772,2806,2700,2746,2746,-38,-38,3892,"10,693.59",4302
,20170808,2746,2746,2746,2758,2716,2758,2736,12,-10,3136,"8,584.36",5372
,20170809,2758,2736,2758,2820,2756,2808,2802,72,66,2976,"8,343.44",5674
,20170810,2808,2802,2818,2852,2794,2826,2828,24,26,2880,"8,145.78",5894
,20170811,2826,2828,2828,2852,2706,2716,2758,-112,-70,2698,"7,444.68",5820
,20170814,2716,2758,2726,2738,2708,2708,2724,-50,-34,1232,"3,357.42",5838
,20170815,2708,2724,2708,2748,2700,2722,2728,-2,4,1438,"3,923.44",5766
,20170816,2722,2728,2716,2746,2712,2728,2726,0,-2,712,"1,941.62",5726
,20170817,2728,2726,2728,2808,2728,2808,2778,82,52,2942,"8,173.54",6536
,20170818,2808,2778,2806,2830,2786,2830,2814,52,36,1490,"4,195.33",6976
,20170821,2830,2814,2826,2858,2806,2840,2838,26,24,2410,"6,844.11",7652
,20170822,2840,2838,2840,2874,2796,2866,2834,28,-4,1564,"4,432.80",8036
,20170823,2866,2834,2856,2908,2820,2824,2866,-10,32,3958,"11,347.72",8290
,20170824,2824,2866,2824,2878,2818,2878,2852,12,-14,1640,"4,677.52",8544
,20170825,2878,2852,2880,2924,2856,2904,2892,52,40,3036,"8,783.68",9106
,20170828,2904,2892,2908,2914,2862,2888,2886,-4,-6,1402,"4,048.32",9316
,20170829,2888,2886,2916,2916,2840,2870,2868,-16,-18,2940,"8,436.72",9694
,20170830,2870,2868,2870,2878,2840,2858,2860,-10,-8,2208,"6,317.65",10144
,20170831,2858,2860,2852,2854,2798,2838,2820,-22,-40,5430,"15,319.10",10984
,20170901,2838,2820,2840,2874,2832,2868,2858,48,38,4134,"11,818.50",11664
,20170904,2868,2858,2870,2898,2762,2784,2830,-74,-28,11130,"31,516.67",12298
,20170905,2784,2830,2794,2798,2738,2744,2764,-86,-66,11032,"30,505.21",14526
,20170906,2744,2764,2750,2792,2744,2768,2768,4,4,8554,"23,688.16",14998
,20170907,2768,2768,2780,2790,2682,2684,2720,-84,-48,12294,"33,452.12",15336
,20170908,2684,2720,2696,2702,2630,2640,2666,-80,-54,13740,"36,650.45",15716
,20170911,2640,2666,2640,2678,2610,2674,2654,8,-12,8988,"23,859.21",17184
,20170912,2674,2654,2688,2692,2662,2688,2682,34,28,5870,"15,744.90",18424
,20170913,2688,2682,2688,2702,2654,2662,2674,-20,-8,8094,"21,646.58",18306
,20170914,2662,2674,2664,2694,2646,2664,2668,-10,-6,10444,"27,884.81",19568
,20170915,2664,2668,2672,2690,2632,2684,2668,16,0,18194,"48,574.80",24088
,20170918,2684,2668,2686,2710,2662,2692,2690,24,22,12232,"32,905.56",24468
,20170919,2692,2690,2688,2698,2650,2652,2672,-38,-18,12116,"32,388.37",24676
,20170920,2652,2672,2662,2678,2656,2664,2664,-8,-8,6722,"17,913.64",24774
,20170921,2664,2664,2676,2682,2630,2662,2652,-2,-12,22774,"60,412.72",22356
,20170922,2662,2652,2658,2706,2654,2704,2678,52,26,17040,"45,646.47",22960
,20170925,2704,2678,2706,2722,2688,2702,2704,24,26,14680,"39,709.06",24022
,20170926,2702,2704,2710,2726,2692,2716,2710,12,6,10052,"27,245.40",24204
,20170927,2716,2710,2706,2718,2694,2702,2706,-8,-4,9792,"26,502.80",24888
,20170928,2702,2706,2702,2706,2608,2634,2646,-72,-60,24206,"64,068.04",24088
,20170929,2634,2646,2650,2676,2620,2634,2646,-12,0,14190,"37,558.30",26366
,20171009,2634,2646,2634,2640,2548,2572,2572,-74,-74,23938,"61,579.70",29100
,20171010,2572,2572,2570,2586,2534,2548,2550,-24,-22,22192,"56,617.26",36500
,20171011,2548,2550,2554,2578,2542,2560,2556,10,6,12640,"32,332.10",37398
,20171012,2560,2556,2548,2600,2532,2596,2572,40,16,18748,"48,252.95",34272
,20171013,2596,2572,2594,2616,2562,2612,2588,40,16,15712,"40,684.82",34444
,20171016,2612,2588,2622,2632,2578,2606,2602,18,14,21948,"57,117.77",37004
,20171017,2606,2602,2610,2620,2582,2606,2602,4,0,21232,"55,267.21",37468
,20171018,2606,2602,2606,2618,2588,2600,2602,-2,0,14380,"37,427.00",38998
,20171019,2600,2602,2602,2604,2540,2542,2568,-60,-34,27742,"71,276.26",45916
,20171020,2542,2568,2536,2592,2532,2588,2564,20,-4,27376,"70,240.12",47210
,20171023,2588,2564,2580,2610,2570,2602,2590,38,26,26318,"68,180.18",49778
,20171024,2602,2590,2610,2618,2592,2592,2604,2,14,22000,"57,318.97",54342
,20171025,2592,2604,2602,2660,2598,2648,2642,44,38,44414,"117,381.36",59894
,20171026,2648,2642,2648,2654,2630,2646,2640,4,-2,18364,"48,496.60",62944
,20171027,2646,2640,2638,2664,2624,2638,2642,-2,2,31786,"84,034.36",66614
,20171030,2638,2642,2626,2690,2608,2676,2668,34,26,57530,"153,581.06",83384
,20171031,2676,2668,2680,2692,2636,2646,2658,-22,-10,48588,"129,197.84",99744
,20171101,2646,2658,2650,2678,2624,2656,2656,-2,-2,65454,"173,853.62",113976
,20171102,2656,2656,2660,2676,2646,2664,2662,8,6,45230,"120,472.32",117326
,20171103,2664,2662,2664,2716,2660,2714,2692,52,30,61272,"165,014.33",132360
,20171106,2714,2692,2718,2732,2692,2724,2716,32,24,79850,"216,887.24",145124
,20171107,2724,2716,2726,2756,2716,2754,2740,38,24,87288,"239,173.71",170266
,20171108,2754,2740,2754,2754,2734,2742,2742,2,2,48394,"132,701.64",175988
,20171109,2742,2742,2742,2766,2730,2738,2744,-4,2,67372,"184,896.94",185724
,20171110,2738,2744,2738,2748,2722,2736,2734,-8,-10,68090,"186,257.08",186980
,20171113,2736,2734,2742,2770,2736,2766,2750,32,16,73420,"201,933.02",196674
,20171114,2766,2750,2768,2770,2748,2752,2758,2,8,58164,"160,418.01",198348
,20171115,2752,2758,2752,2762,2618,2622,2680,-136,-78,230644,"618,336.97",188396
,20171116,2622,2680,2634,2638,2622,2626,2628,-54,-52,72030,"189,395.78",185848
,20171117,2626,2628,2622,2640,2612,2632,2630,4,2,63154,"166,163.62",188604
,20171120,2632,2630,2644,2680,2626,2676,2654,46,24,123114,"326,756.04",193658
,20171121,2676,2654,2676,2700,2666,2696,2684,42,30,111322,"299,001.44",196704
,20171122,2696,2684,2698,2752,2688,2748,2724,64,40,173074,"471,565.89",217288
,20171123,2748,2724,2760,2776,2744,2758,2756,34,32,237008,"653,544.78",259840
,20171124,2758,2756,2758,2788,2742,2768,2762,12,6,195030,"538,993.00",277066
,20171127,2768,2762,2776,2784,2690,2702,2736,-60,-26,338392,"925,910.02",305088
,20171128,2702,2736,2698,2724,2682,2716,2706,-20,-30,213288,"577,261.43",307868
,20171129,2716,2706,2718,2728,2694,2698,2708,-8,2,260936,"707,011.98",313952
,20171130,2698,2708,2700,2744,2662,2744,2702,36,-6,399192,"1,078,647.26",315686
,20171201,2744,2702,2748,2786,2734,2774,2754,72,52,361000,"994,359.48",337762
,20171204,2774,2754,2784,2822,2760,2776,2784,22,30,413746,"1,152,368.44",360486
,20171205,2776,2784,2776,2822,2752,2766,2782,-18,-2,519208,"1,445,015.45",370620
,20171206,2766,2782,2762,2824,2752,2774,2782,-8,0,602006,"1,675,764.06",399004
,20171207,2774,2782,2764,2766,2614,2614,2682,-168,-100,729328,"1,957,138.46",328682
,20171208,2614,2682,2618,2660,2618,2640,2638,-42,-44,381824,"1,008,011.74",314768
,20171211,2640,2638,2656,2680,2596,2638,2638,0,0,462768,"1,220,910.70",300042
,20171212,2638,2638,2640,2662,2578,2608,2626,-30,-12,401254,"1,053,808.84",329060
,20171213,2608,2626,2612,2644,2576,2624,2614,-2,-12,387942,"1,014,552.48",305190
,20171214,2624,2614,2622,2648,2596,2616,2620,2,6,372276,"975,922.35",295804
,20171215,2616,2620,2620,2628,2594,2622,2610,2,-10,283280,"739,424.68",313004
,20171218,2622,2610,2622,2664,2614,2648,2642,38,32,367314,"970,962.28",307840
,20171219,2648,2642,2646,2652,2624,2636,2636,-6,-6,227130,"598,776.36",300776
,20171220,2636,2636,2642,2670,2632,2642,2654,6,18,324650,"861,727.02",296310
,20171221,2642,2654,2644,2652,2566,2588,2604,-66,-50,459484,"1,197,277.20",339244
,20171222,2588,2604,2586,2604,2578,2588,2592,-16,-12,258062,"669,005.44",345034
,20171225,2588,2592,2588,2600,2570,2596,2586,4,-6,293730,"759,637.93",346558
,20171226,2596,2586,2594,2612,2582,2604,2600,18,14,266756,"693,799.41",345222
,20171227,2604,2600,2600,2632,2586,2630,2612,30,12,448210,"1,170,779.76",349422
,20171228,2630,2612,2626,2640,2606,2624,2620,12,8,226584,"593,684.09",340394
,20171229,2624,2620,2624,2634,2606,2622,2620,2,0,223302,"585,209.81",339106
bu1809,20170103,3068,3064,3090,3090,3012,3012,3046,-52,-18,68,207.24,1202
,20170104,3012,3046,3066,3066,3002,3016,3028,-30,-18,126,381.56,1240
,20170105,3016,3028,3052,3062,3022,3026,3042,-2,14,18,54.76,1240
,20170106,3026,3042,3032,3084,3030,3048,3056,6,14,78,238.47,1256
,20170109,3048,3056,3052,3074,3032,3050,3050,-6,-6,72,219.67,1260
,20170110,3050,3050,3040,3040,2990,3028,3014,-22,-36,100,301.56,1206
,20170111,3028,3014,3052,3102,3022,3034,3058,20,44,96,293.68,1192
,20170112,3034,3058,3028,3078,3028,3052,3052,-6,-6,40,122.11,1196
,20170113,3052,3052,3092,3100,3064,3084,3082,32,30,80,246.65,1196
,20170116,3084,3082,3064,3098,3064,3074,3078,-8,-4,58,178.58,1190
,20170117,3074,3078,3090,3090,3016,3016,3034,-62,-44,138,418.76,1144
,20170118,3016,3034,3102,3104,3002,3028,3020,-6,-14,328,990.64,1102
,20170119,3028,3020,3006,3008,2990,3000,2998,-20,-22,80,239.90,1104
,20170120,3000,2998,3012,3030,2970,2970,2996,-28,-2,70,209.77,1082
,20170123,2970,2996,2970,2998,2960,2972,2972,-24,-24,58,172.48,1082
,20170124,2972,2972,2984,3010,2974,3002,2996,30,24,36,107.90,1088
,20170125,3002,2996,3008,3020,2986,3014,3008,18,12,28,84.24,1092
,20170126,3014,3008,3012,3036,3012,3028,3026,20,18,24,72.62,1090
,20170203,3028,3026,3050,3070,3040,3070,3054,44,28,52,158.84,1100
,20170206,3070,3054,3052,3084,3052,3084,3068,30,14,136,417.40,1182
,20170207,3084,3068,3066,3074,3050,3068,3064,0,-4,68,208.36,1210
,20170208,3068,3064,3054,3098,3048,3098,3064,34,0,104,318.78,1266
,20170209,3098,3064,3100,3102,3070,3092,3094,28,30,148,458.06,1356
,20170210,3092,3094,3080,3140,3080,3140,3110,46,16,128,398.32,1432
,20170213,3140,3110,3146,3238,3132,3222,3198,112,88,226,723.10,1502
,20170214,3222,3198,3242,3242,3208,3226,3218,28,20,58,186.75,1508
,20170215,3226,3218,3208,3216,3160,3170,3192,-48,-26,94,300.05,1524
,20170216,3170,3192,3160,3190,3126,3138,3152,-54,-40,86,271.11,1508
,20170217,3138,3152,3150,3172,3134,3140,3150,-12,-2,72,226.88,1494
,20170220,3140,3150,3140,3200,3132,3200,3176,50,26,68,215.97,1496
,20170221,3200,3176,3220,3220,3178,3186,3194,10,18,50,159.76,1506
,20170222,3186,3194,3204,3218,3182,3214,3208,20,14,64,205.36,1510
,20170223,3214,3208,3202,3210,3134,3174,3172,-34,-36,182,577.55,1524
,20170224,3174,3172,3170,3198,3136,3198,3158,26,-14,140,442.32,1462
,20170227,3198,3158,3196,3236,3196,3220,3220,62,62,86,277.06,1478
,20170228,3220,3220,3230,3230,3196,3196,3214,-24,-6,46,147.85,1468
,20170301,3196,3214,3200,3246,3190,3236,3224,22,10,76,245.08,1494
,20170302,3236,3224,3232,3232,3200,3218,3212,-6,-12,38,122.12,1478
,20170303,3218,3212,3196,3218,3176,3200,3192,-12,-20,60,191.62,1452
,20170306,3200,3192,3194,3198,3156,3156,3170,-36,-22,102,323.46,1400
,20170307,3156,3170,3170,3186,3158,3162,3170,-8,0,58,183.96,1388
,20170308,3162,3170,3188,3218,3112,3130,3150,-40,-20,334,"1,052.25",1294
,20170309,3130,3150,3100,3124,3014,3036,3060,-114,-90,468,"1,432.88",1072
,20170310,3036,3060,3008,3048,3006,3030,3026,-30,-34,50,151.30,1054
,20170313,3030,3026,3036,3088,3006,3088,3032,62,6,162,491.27,982
,20170314,3088,3032,2860,3084,2860,3036,3006,4,-26,176,529.06,964
,20170315,3036,3006,3008,3080,3004,3078,3034,72,28,100,303.50,962
,20170316,3078,3034,3098,3114,3062,3090,3092,56,58,248,767.28,998
,20170317,3090,3092,3070,3084,3064,3072,3078,-20,-14,102,314.10,958
,20170320,3072,3078,3102,3110,3058,3058,3082,-20,4,28,86.33,950
,20170321,3058,3082,3066,3078,3052,3066,3062,-16,-20,32,98.00,942
,20170322,3066,3062,3060,3060,2986,2986,3010,-76,-52,158,475.71,936
,20170323,2986,3010,2988,3024,2970,2986,3002,-24,-8,110,330.39,940
,20170324,2986,3002,2990,3004,2976,2990,2988,-12,-14,22,65.74,938
,20170327,2990,2988,2998,2998,2938,2952,2952,-36,-36,216,637.84,930
,20170328,2952,2952,2958,2994,2944,2978,2964,26,12,86,255.03,934
,20170329,2978,2964,2998,2998,2982,2998,2990,34,26,24,71.76,918
,20170330,2998,2990,2972,2980,2952,2952,2962,-38,-28,56,165.97,904
,20170331,2952,2962,2990,2992,2954,2962,2968,0,6,24,71.27,904
,20170405,2962,2968,3002,3130,3002,3108,3086,140,118,64,197.53,894
,20170406,3108,3086,3120,3158,3020,3120,3094,34,8,82,253.78,912
,20170407,3120,3094,3182,3182,3030,3038,3054,-56,-40,488,"1,491.28",1102
,20170410,3038,3054,3038,3060,3018,3038,3040,-16,-14,114,346.66,1094
,20170411,3038,3040,3042,3042,2920,2928,2976,-112,-64,168,500.20,1036
,20170412,2928,2976,2910,2950,2900,2900,2916,-76,-60,134,390.86,998
,20170413,2900,2916,2900,2944,2900,2910,2914,-6,-2,130,378.90,1064
,20170414,2910,2914,2912,2916,2800,2812,2844,-102,-70,114,324.26,1054
,20170417,2812,2844,2842,2860,2808,2824,2834,-20,-10,44,124.75,1046
,20170418,2824,2834,2840,2840,2780,2780,2826,-54,-8,82,231.75,1050
,20170419,2780,2826,2780,2828,2730,2804,2758,-22,-68,356,982.14,1018
,20170420,2804,2758,2828,2840,2750,2812,2790,54,32,106,295.80,1000
,20170421,2812,2790,2810,2848,2804,2806,2826,16,36,60,169.63,994
,20170424,2806,2826,2800,2802,2780,2802,2790,-24,-36,26,72.56,986
,20170425,2802,2790,2798,2820,2798,2810,2812,20,22,14,39.37,988
,20170426,2810,2812,2864,2864,2750,2768,2768,-44,-44,64,177.23,976
,20170427,2768,2768,2764,2820,2764,2810,2802,42,34,282,790.34,996
,20170428,2810,2802,2818,2884,2788,2870,2844,68,42,78,221.87,994
,20170502,2870,2844,2868,2870,2842,2870,2860,26,16,8,22.88,994
,20170503,2870,2860,2852,2868,2852,2866,2862,6,2,24,68.72,1004
,20170504,2866,2862,2832,2838,2758,2770,2806,-92,-56,60,168.46,972
,20170505,2770,2806,2766,2766,2680,2680,2714,-126,-92,168,456.16,900
,20170508,2680,2714,2728,2730,2706,2706,2720,-8,6,30,81.61,886
,20170509,2706,2720,2718,2738,2718,2720,2726,0,6,46,125.47,888
,20170510,2720,2726,2728,2736,2712,2722,2722,-4,-4,28,76.25,880
,20170511,2722,2722,2744,2746,2700,2728,2728,6,6,58,158.26,882
,20170512,2728,2728,2718,2728,2682,2728,2704,0,-24,54,146.05,888
,20170515,2728,2704,2738,2760,2708,2760,2730,56,26,106,289.39,910
,20170516,2760,2730,2760,2776,2748,2776,2760,46,30,24,66.24,914
,20170517,2776,2760,2786,2796,2768,2774,2780,14,20,44,122.36,924
,20170518,2774,2780,2782,2790,2762,2776,2772,-4,-8,46,127.56,918
,20170519,2776,2772,2770,2830,2770,2810,2808,38,36,56,157.30,916
,20170522,2810,2808,2820,2852,2820,2826,2836,18,28,30,85.11,908
,20170523,2826,2836,2836,2836,2762,2770,2802,-66,-34,48,134.54,914
,20170524,2770,2802,2766,2786,2760,2786,2762,-16,-40,130,359.20,968
,20170525,2786,2762,2786,2840,2786,2824,2810,62,48,56,157.40,928
,20170526,2824,2810,2804,2826,2726,2740,2758,-70,-52,64,176.53,898
,20170531,2740,2758,2734,2744,2626,2640,2668,-118,-90,130,346.87,820
,20170601,2640,2668,2640,2652,2606,2650,2636,-18,-32,178,469.55,698
,20170602,2650,2636,2616,2616,2608,2608,2612,-28,-24,4,10.45,700
,20170605,2608,2612,2590,2642,2590,2642,2608,30,-4,30,78.28,690
,20170606,2642,2608,2616,2650,2616,2630,2634,22,26,14,36.90,696
,20170607,2630,2634,2640,2652,2638,2652,2646,18,12,14,37.06,694
,20170608,2652,2646,2634,2636,2622,2636,2630,-10,-16,6,15.78,692
,20170609,2636,2630,2634,2654,2632,2636,2638,6,8,14,36.94,692
,20170612,2636,2638,2652,2652,2618,2636,2636,-2,-2,24,63.29,694
,20170613,2636,2636,2622,2666,2622,2640,2640,4,4,10,26.42,694
,20170614,2640,2640,2606,2646,2602,2634,2608,-6,-32,250,652.25,682
,20170615,2634,2608,2652,2652,2618,2624,2632,16,24,26,68.44,680
,20170616,2624,2632,2642,2642,2624,2624,2634,-8,2,8,21.07,680
,20170619,2624,2634,2628,2630,2600,2624,2620,-10,-14,58,151.99,684
,20170620,2624,2620,2652,2666,2628,2642,2658,22,38,236,627.35,672
,20170621,2642,2658,2622,2658,2606,2610,2628,-48,-30,48,126.20,682
,20170622,2610,2628,2632,2646,2610,2610,2636,-18,8,206,543.06,698
,20170623,2610,2636,2644,2644,2604,2606,2610,-30,-26,44,114.87,726
,20170626,2606,2610,2616,2624,2600,2618,2608,8,-2,34,88.72,732
,20170627,2618,2608,2618,2618,2606,2618,2614,10,6,62,162.08,730
,20170628,2618,2614,2636,2640,2624,2636,2634,22,20,38,100.12,730
,20170629,2636,2634,2634,2670,2634,2664,2658,30,24,62,164.84,722
,20170630,2664,2658,2662,2670,2648,2660,2660,2,2,98,260.72,750
,20170703,2660,2660,2680,2680,2654,2662,2674,2,14,114,304.86,772
,20170704,2662,2674,2682,2682,2626,2648,2648,-26,-26,74,196.09,774
,20170705,2648,2648,2654,2682,2620,2680,2662,32,14,82,218.36,750
,20170706,2680,2662,2648,2682,2648,2682,2670,20,8,12,32.05,744
,20170707,2682,2670,2712,2712,2650,2680,2680,10,10,78,209.16,744
,20170710,2680,2680,2670,2694,2660,2682,2682,2,2,30,80.46,740
,20170711,2682,2682,2696,2732,2696,2732,2722,50,40,76,206.88,756
,20170712,2732,2722,2712,2740,2704,2704,2720,-18,-2,76,206.80,774
,20170713,2704,2720,2720,2732,2708,2732,2718,12,-2,54,146.78,782
,20170714,2732,2718,2720,2780,2720,2768,2758,50,40,134,369.70,810
,20170717,2768,2758,2784,2806,2780,2790,2788,32,30,106,295.66,840
,20170718,2790,2788,2804,2812,2786,2786,2802,-2,14,16,44.85,840
,20170719,2786,2802,2816,2816,2812,2812,2812,10,10,6,16.88,840
,20170720,2812,2812,2796,2820,2796,2820,2812,8,0,28,78.76,850
,20170721,2820,2812,2788,2814,2768,2790,2792,-22,-20,42,117.33,850
,20170724,2790,2792,2792,2800,2770,2794,2786,2,-6,40,111.50,826
,20170725,2794,2786,2828,2864,2804,2864,2838,78,52,92,261.20,834
,20170726,2864,2838,2878,2878,2830,2830,2852,-8,14,30,85.60,826
,20170727,2830,2852,2838,2880,2838,2870,2866,18,14,62,177.80,832
,20170728,2870,2866,2858,2874,2804,2804,2846,-62,-20,50,142.39,836
,20170731,2804,2846,2852,2898,2846,2864,2862,18,16,426,"1,219.31",1094
,20170801,2864,2862,2842,2856,2796,2844,2834,-18,-28,156,442.40,1134
,20170802,2844,2834,2816,2828,2758,2796,2782,-38,-52,264,734.51,1258
,20170803,2796,2782,2802,2818,2780,2784,2798,2,16,190,531.87,1316
,20170804,2784,2798,2788,2834,2778,2790,2802,-8,4,120,336.28,1312
,20170807,2790,2802,2780,2800,2726,2750,2754,-52,-48,596,"1,642.11",1308
,20170808,2750,2754,2738,2776,2706,2766,2748,12,-6,452,"1,242.28",1358
,20170809,2766,2748,2782,2818,2780,2818,2802,70,54,150,420.56,1368
,20170810,2818,2802,2826,2864,2810,2834,2834,32,32,48,136.06,1354
,20170811,2834,2834,2832,2842,2702,2718,2752,-116,-82,254,699.22,1360
,20170814,2718,2752,2732,2738,2714,2724,2724,-28,-28,30,81.72,1368
,20170815,2724,2724,2690,2742,2690,2726,2728,2,4,68,185.52,1370
,20170816,2726,2728,2716,2730,2714,2728,2722,0,-6,28,76.24,1362
,20170817,2728,2722,2740,2798,2738,2784,2768,62,46,96,265.82,1372
,20170818,2784,2768,2782,2826,2782,2822,2806,54,38,72,202.06,1352
,20170821,2822,2806,2834,2846,2810,2840,2826,34,20,66,186.60,1344
,20170822,2840,2826,2824,2852,2800,2852,2824,26,-2,90,254.33,1324
,20170823,2852,2824,2832,2890,2820,2820,2858,-4,34,178,508.84,1328
,20170824,2820,2858,2830,2878,2830,2878,2850,20,-8,82,233.77,1330
,20170825,2878,2850,2868,2912,2862,2898,2878,48,28,116,334.06,1364
,20170828,2898,2878,2904,2904,2870,2896,2886,18,8,36,103.96,1376
,20170829,2896,2886,2900,2900,2860,2860,2880,-26,-6,84,242.05,1378
,20170830,2860,2880,2868,2870,2858,2870,2864,-10,-16,20,57.30,1370
,20170831,2870,2864,2840,2854,2810,2842,2828,-22,-36,32,90.50,1368
,20170901,2842,2828,2832,2880,2832,2878,2864,50,36,30,85.98,1366
,20170904,2878,2864,2890,2906,2786,2818,2828,-46,-36,98,277.16,1324
,20170905,2818,2828,2804,2826,2780,2790,2792,-38,-36,166,463.74,1258
,20170906,2790,2792,2802,2816,2790,2800,2800,8,8,26,72.83,1270
,20170907,2800,2800,2786,2820,2736,2736,2770,-64,-30,420,"1,163.55",1240
,20170908,2736,2770,2726,2760,2706,2740,2728,-30,-42,678,"1,850.30",1018
,20170911,2740,2728,2720,2744,2710,2738,2726,10,-2,278,758.37,896
,20170912,2738,2726,2756,2766,2734,2766,2752,40,26,120,330.36,904
,20170913,2766,2752,2796,2796,2730,2744,2772,-8,20,148,410.32,920
,20170914,2744,2772,2754,2762,2722,2750,2742,-22,-30,126,345.74,922
,20170915,2750,2742,2760,2760,2716,2758,2744,16,2,118,323.87,900
,20170918,2758,2744,2740,2772,2740,2766,2760,22,16,90,248.47,890
,20170919,2766,2760,2764,2770,2726,2726,2752,-34,-8,90,247.75,892
,20170920,2726,2752,2740,2746,2732,2742,2738,-10,-14,30,82.18,890
,20170921,2742,2738,2742,2760,2698,2732,2724,-6,-14,148,403.44,894
,20170922,2732,2724,2732,2760,2726,2752,2740,28,16,52,142.57,870
,20170925,2752,2740,2770,2780,2750,2766,2764,26,24,66,182.51,870
,20170926,2766,2764,2764,2782,2762,2772,2772,8,8,18,49.90,866
,20170927,2772,2772,2764,2776,2758,2764,2764,-8,-8,40,110.59,870
,20170928,2764,2764,2764,2778,2678,2700,2728,-64,-36,100,272.97,870
,20170929,2700,2728,2714,2724,2690,2690,2704,-38,-24,80,216.34,872
,20171009,2690,2704,2686,2706,2626,2638,2646,-66,-58,60,158.83,880
,20171010,2638,2646,2646,2652,2610,2620,2624,-26,-22,112,293.96,940
,20171011,2620,2624,2628,2654,2610,2626,2630,2,6,58,152.64,932
,20171012,2626,2630,2618,2668,2606,2668,2636,38,6,114,300.57,870
,20171013,2668,2636,2658,2686,2634,2686,2648,50,12,82,217.29,834
,20171016,2686,2648,2700,2700,2654,2674,2670,26,22,48,128.18,868
,20171017,2674,2670,2680,2688,2656,2678,2670,8,0,80,213.72,874
,20171018,2678,2670,2676,2676,2656,2670,2666,0,-4,70,186.68,872
,20171019,2670,2666,2656,2662,2616,2616,2638,-50,-28,100,263.92,918
,20171020,2616,2638,2620,2660,2618,2658,2638,20,0,128,337.74,904
,20171023,2658,2638,2666,2686,2648,2672,2662,34,24,36,95.90,888
,20171024,2672,2662,2680,2684,2672,2680,2678,18,16,14,37.51,886
,20171025,2680,2678,2698,2728,2698,2716,2712,38,34,58,157.34,880
,20171026,2716,2712,2716,2718,2702,2714,2710,2,-2,46,124.68,886
,20171027,2714,2710,2704,2732,2702,2706,2714,-4,4,114,309.42,898
,20171030,2706,2714,2694,2754,2690,2750,2740,36,26,72,197.28,886
,20171031,2750,2740,2758,2772,2712,2712,2736,-28,-4,76,208.02,878
,20171101,2712,2736,2706,2754,2706,2722,2726,-14,-10,32,87.27,878
,20171102,2722,2726,2744,2744,2730,2730,2734,4,8,28,76.59,874
,20171103,2730,2734,2742,2780,2730,2780,2760,46,26,156,430.62,876
,20171106,2780,2760,2788,2796,2762,2786,2782,26,22,74,205.96,862
,20171107,2786,2782,2762,2820,2762,2816,2800,34,18,188,526.44,846
,20171108,2816,2800,2802,2816,2800,2802,2806,2,6,66,185.27,852
,20171109,2802,2806,2814,2826,2800,2800,2812,-6,6,108,303.88,842
,20171110,2800,2812,2806,2806,2790,2802,2798,-10,-14,30,83.97,844
,20171113,2802,2798,2820,2834,2798,2824,2812,26,14,40,112.50,838
,20171114,2824,2812,2824,2830,2806,2816,2822,4,10,94,265.38,834
,20171115,2816,2822,2808,2818,2690,2690,2758,-132,-64,196,540.63,826
,20171116,2690,2758,2706,2712,2692,2700,2700,-58,-58,158,426.81,848
,20171117,2700,2700,2700,2710,2680,2706,2696,6,-4,166,447.80,822
,20171120,2706,2696,2710,2740,2702,2740,2720,44,24,214,582.45,812
,20171121,2740,2720,2736,2764,2734,2762,2748,42,28,62,170.42,810
,20171122,2762,2748,2780,2820,2772,2820,2798,72,50,44,123.18,796
,20171123,2820,2798,2824,2840,2818,2826,2824,28,26,42,118.65,796
,20171124,2826,2824,2840,2840,2826,2832,2832,8,8,24,68.00,788
,20171127,2832,2832,2840,2840,2776,2788,2812,-44,-20,172,484.00,840
,20171128,2788,2812,2790,2796,2768,2790,2780,-22,-32,58,161.35,850
,20171129,2790,2780,2776,2798,2774,2798,2784,18,4,26,72.40,852
,20171130,2798,2784,2766,2818,2756,2816,2786,32,2,124,345.68,892
,20171201,2816,2786,2816,2850,2812,2844,2824,58,38,106,299.51,884
,20171204,2844,2824,2850,2882,2836,2840,2864,16,40,92,263.64,880
,20171205,2840,2864,2850,2886,2830,2846,2852,-18,-12,258,736.10,886
,20171206,2846,2852,2850,2888,2830,2836,2860,-16,8,178,509.13,884
,20171207,2836,2860,2846,2846,2702,2702,2750,-158,-110,640,"1,760.32",1000
,20171208,2702,2750,2716,2736,2706,2716,2722,-34,-28,64,174.24,994
,20171211,2716,2722,2726,2756,2688,2708,2720,-14,-2,204,554.98,970
,20171212,2708,2720,2720,2728,2668,2684,2702,-36,-18,86,232.37,1020
,20171213,2684,2702,2658,2720,2658,2690,2704,-12,2,60,162.32,1016
,20171214,2690,2704,2690,2722,2690,2722,2706,18,2,110,297.78,1018
,20171215,2722,2706,2690,2742,2690,2708,2700,2,-6,124,335.02,1020
,20171218,2708,2700,2720,2748,2718,2740,2730,40,30,48,131.06,1010
,20171219,2740,2730,2726,2738,2718,2718,2728,-12,-2,46,125.49,1026
,20171220,2718,2728,2726,2750,2726,2730,2738,2,10,88,241.03,1022
,20171221,2730,2738,2738,2740,2666,2684,2704,-54,-34,158,427.52,1100
,20171222,2684,2704,2688,2692,2672,2680,2682,-24,-22,50,134.18,1096
,20171225,2680,2682,2668,2690,2668,2690,2676,8,-6,48,128.50,1090
,20171226,2690,2676,2696,2720,2680,2720,2698,44,22,174,469.57,1156
,20171227,2720,2698,2748,2748,2682,2710,2708,12,10,470,"1,273.15",1100
,20171228,2710,2708,2700,2710,2690,2692,2698,-16,-10,206,556.09,1148
,20171229,2692,2698,2674,2712,2674,2706,2694,8,-4,444,"1,196.32",1076
bu1812,20170103,3108,3102,3148,3156,3032,3034,3088,-68,-14,222,685.89,428
,20170104,3034,3088,3062,3082,3032,3064,3056,-24,-32,150,458.50,414
,20170105,3064,3056,3066,3098,3054,3060,3070,4,14,104,319.41,418
,20170106,3060,3070,3072,3116,3062,3062,3088,-8,18,108,333.58,424
,20170109,3062,3088,3064,3100,3060,3088,3084,0,-4,54,166.63,438
,20170110,3088,3084,3064,3070,3024,3060,3046,-24,-38,124,377.72,412
,20170111,3060,3046,3060,3126,3050,3062,3088,16,42,176,543.84,390
,20170112,3062,3088,3070,3112,3056,3094,3088,6,0,82,253.34,400
,20170113,3094,3088,3108,3128,3094,3102,3104,14,16,76,236.03,426
,20170116,3102,3104,3100,3116,3090,3104,3102,0,-2,180,558.47,490
,20170117,3104,3102,3118,3120,3050,3050,3094,-52,-8,62,191.84,478
,20170118,3050,3094,3064,3094,3034,3070,3058,-24,-36,218,666.82,474
,20170119,3070,3058,3050,3050,3022,3028,3030,-30,-28,60,181.86,444
,20170120,3028,3030,3050,3060,3002,3016,3026,-14,-4,56,169.47,432
,20170123,3016,3026,3042,3042,3000,3018,3010,-8,-16,56,168.57,432
,20170124,3018,3010,3010,3048,3006,3048,3026,38,16,40,121.06,430
,20170125,3048,3026,3014,3060,3014,3060,3042,34,16,12,36.52,428
,20170126,3060,3042,3060,3076,3052,3074,3062,32,20,50,153.19,424
,20170203,3074,3062,3098,3100,3056,3096,3082,34,20,60,184.92,438
,20170206,3096,3082,3040,3104,3040,3098,3082,16,0,140,431.76,510
,20170207,3098,3082,3102,3102,3072,3082,3082,0,0,30,92.48,514
,20170208,3082,3082,3074,3116,3072,3114,3086,32,4,90,277.83,542
,20170209,3114,3086,3122,3122,3106,3108,3112,22,26,62,193.05,578
,20170210,3108,3112,3102,3154,3092,3148,3116,36,4,90,280.49,610
,20170213,3148,3116,3190,3234,3166,3228,3204,112,88,222,711.38,648
,20170214,3228,3204,3248,3248,3184,3206,3220,2,16,46,148.17,644
,20170215,3206,3220,3224,3224,3160,3170,3186,-50,-34,74,235.83,632
,20170216,3170,3186,3152,3196,3130,3132,3160,-54,-26,50,158.09,628
,20170217,3132,3160,3166,3188,3142,3152,3160,-8,0,98,309.80,618
,20170220,3152,3160,3150,3218,3146,3218,3186,58,26,104,331.38,632
,20170221,3218,3186,3216,3220,3176,3196,3202,10,16,74,237.03,622
,20170222,3196,3202,3212,3226,3190,3226,3206,24,4,66,211.62,644
,20170223,3226,3206,3212,3220,3154,3176,3180,-30,-26,150,477.28,618
,20170224,3176,3180,3182,3212,3156,3212,3182,32,2,102,324.62,592
,20170227,3212,3182,3218,3250,3208,3236,3236,54,54,182,589.08,652
,20170228,3236,3236,3244,3246,3212,3218,3230,-18,-6,54,174.43,644
,20170301,3218,3230,3208,3268,3194,3250,3234,20,4,184,595.23,688
,20170302,3250,3234,3246,3246,3220,3232,3232,-2,-2,110,355.62,672
,20170303,3232,3232,3220,3232,3190,3210,3208,-22,-24,86,275.95,648
,20170306,3210,3208,3208,3220,3180,3188,3196,-20,-12,98,313.27,638
,20170307,3188,3196,3210,3212,3186,3200,3196,4,0,48,153.44,608
,20170308,3200,3196,3208,3236,3132,3156,3174,-40,-22,248,787.30,550
,20170309,3156,3174,3160,3160,3036,3068,3080,-106,-94,298,917.91,466
,20170310,3068,3080,3030,3076,3030,3050,3044,-30,-36,124,377.68,432
,20170313,3050,3044,3058,3128,3042,3128,3070,84,26,102,313.23,426
,20170314,3128,3070,3100,3114,3048,3058,3078,-12,8,108,332.62,402
,20170315,3058,3078,3032,3106,3030,3090,3060,12,-18,120,367.32,402
,20170316,3090,3060,3106,3122,3090,3108,3110,48,50,88,273.82,408
,20170317,3108,3110,3102,3108,3080,3096,3094,-14,-16,48,148.57,410
,20170320,3096,3094,3096,3124,3088,3088,3104,-6,10,34,105.54,406
,20170321,3088,3104,3076,3082,3068,3070,3074,-34,-30,26,79.94,402
,20170322,3070,3074,3076,3080,3024,3024,3040,-50,-34,176,535.08,388
,20170323,3024,3040,3008,3060,3004,3040,3022,0,-18,140,423.33,382
,20170324,3040,3022,3018,3036,3018,3032,3024,10,2,54,163.30,380
,20170327,3032,3024,3040,3040,2988,3002,3002,-22,-22,128,384.27,354
,20170328,3002,3002,2996,3066,2996,3028,3034,26,32,56,169.94,358
,20170329,3028,3034,3050,3058,3026,3044,3038,10,4,118,358.55,354
,20170330,3044,3038,3030,3046,3016,3018,3024,-20,-14,66,199.67,342
,20170331,3018,3024,3018,3040,3014,3030,3026,6,2,84,254.19,352
,20170405,3030,3026,3050,3154,3050,3140,3104,114,78,126,391.23,370
,20170406,3140,3104,3138,3148,3108,3126,3130,22,26,92,288.00,364
,20170407,3126,3130,3130,3130,3034,3040,3080,-90,-50,362,"1,115.27",548
,20170410,3040,3080,3020,3062,3018,3036,3038,-44,-42,94,285.74,556
,20170411,3036,3038,3046,3046,2938,2956,2990,-82,-48,160,478.66,516
,20170412,2956,2990,2956,2956,2914,2920,2940,-70,-50,214,629.40,518
,20170413,2920,2940,2910,2944,2910,2930,2926,-10,-14,96,281.04,524
,20170414,2930,2926,2930,2932,2824,2832,2868,-94,-58,98,281.10,522
,20170417,2832,2868,2834,2890,2834,2858,2866,-10,-2,68,194.93,534
,20170418,2858,2866,2880,2880,2832,2848,2846,-18,-20,20,56.92,538
,20170419,2848,2846,2806,2834,2748,2830,2790,-16,-56,196,547.20,566
,20170420,2830,2790,2852,2886,2762,2812,2812,22,22,100,281.27,562
,20170421,2812,2812,2834,2886,2820,2854,2852,42,40,76,216.86,568
,20170424,2854,2852,2824,2826,2802,2812,2814,-40,-38,46,129.48,580
,20170425,2812,2814,2810,2838,2808,2826,2824,12,10,48,135.58,574
,20170426,2826,2824,2836,2838,2770,2796,2790,-28,-34,80,223.31,568
,20170427,2796,2790,2816,2840,2796,2824,2818,34,28,34,95.84,576
,20170428,2824,2818,2826,2916,2826,2890,2878,72,60,82,236.14,574
,20170502,2890,2878,2868,2904,2868,2886,2884,8,6,28,80.80,592
,20170503,2886,2884,2880,2888,2874,2874,2878,-10,-6,44,126.68,598
,20170504,2874,2878,2856,2856,2776,2810,2806,-68,-72,90,252.70,598
,20170505,2810,2806,2806,2806,2712,2712,2746,-94,-60,98,269.28,588
,20170508,2712,2746,2740,2756,2734,2740,2746,-6,0,70,192.28,578
,20170509,2740,2746,2754,2762,2748,2756,2754,10,8,34,93.68,586
,20170510,2756,2754,2732,2776,2732,2744,2750,-10,-4,66,181.56,584
,20170511,2744,2750,2762,2774,2728,2760,2754,10,4,106,292.05,590
,20170512,2760,2754,2742,2758,2708,2746,2734,-8,-20,116,317.31,578
,20170515,2746,2734,2744,2784,2740,2778,2758,44,24,80,220.80,578
,20170516,2778,2758,2806,2806,2768,2802,2796,44,38,54,151.02,592
,20170517,2802,2796,2810,2816,2794,2804,2804,8,8,54,151.52,586
,20170518,2804,2804,2824,2826,2776,2802,2800,-2,-4,64,179.22,574
,20170519,2802,2800,2798,2840,2790,2832,2820,32,20,74,208.81,554
,20170522,2832,2820,2832,2874,2832,2844,2850,24,30,84,239.53,538
,20170523,2844,2850,2840,2866,2788,2800,2826,-50,-24,110,310.96,538
,20170524,2800,2826,2786,2808,2778,2808,2790,-18,-36,62,173.00,548
,20170525,2808,2790,2812,2866,2804,2844,2838,54,48,52,147.58,552
,20170526,2844,2838,2830,2842,2750,2752,2780,-86,-58,98,272.50,546
,20170531,2752,2780,2768,2768,2656,2662,2700,-118,-80,60,162.08,534
,20170601,2662,2700,2670,2702,2644,2700,2686,0,-14,200,537.41,392
,20170602,2700,2686,2680,2692,2650,2650,2672,-36,-14,78,208.48,422
,20170605,2650,2672,2660,2698,2660,2696,2686,24,14,50,134.31,410
,20170606,2696,2686,2680,2700,2662,2690,2680,4,-6,34,91.16,408
,20170607,2690,2680,2702,2702,2690,2690,2696,10,16,36,97.07,422
,20170608,2690,2696,2680,2698,2660,2690,2682,-6,-14,90,241.40,426
,20170609,2690,2682,2698,2698,2676,2676,2690,-6,8,16,43.06,430
,20170612,2676,2690,2686,2708,2670,2694,2690,4,0,30,80.73,434
,20170613,2694,2690,2718,2718,2678,2678,2698,-12,8,26,70.17,442
,20170614,2678,2698,2666,2716,2656,2702,2674,4,-24,78,208.67,424
,20170615,2702,2674,2702,2702,2676,2686,2690,12,16,36,96.84,412
,20170616,2686,2690,2680,2692,2662,2674,2676,-16,-14,122,326.52,402
,20170619,2674,2676,2678,2680,2650,2674,2666,-2,-10,60,160.03,408
,20170620,2674,2666,2672,2704,2672,2692,2692,26,26,120,323.20,472
,20170621,2692,2692,2672,2694,2646,2646,2666,-46,-26,114,304.09,468
,20170622,2646,2666,2678,2686,2668,2684,2678,18,12,182,487.67,416
,20170623,2684,2678,2686,2690,2670,2678,2682,0,4,38,101.97,404
,20170626,2678,2682,2686,2686,2676,2684,2682,2,0,38,101.96,398
,20170627,2684,2682,2670,2678,2666,2676,2672,-6,-10,66,176.44,418
,20170628,2676,2672,2700,2700,2676,2676,2686,4,14,130,349.31,486
,20170629,2676,2686,2686,2712,2680,2706,2700,20,14,154,415.89,552
,20170630,2706,2700,2704,2710,2692,2700,2700,0,0,66,178.26,574
,20170703,2700,2700,2710,2720,2686,2706,2706,6,6,92,249.10,606
,20170704,2706,2706,2710,2714,2654,2682,2688,-24,-18,72,193.54,618
,20170705,2682,2688,2696,2720,2694,2714,2708,26,20,52,140.90,636
,20170706,2714,2708,2718,2756,2690,2724,2712,16,4,82,222.39,630
,20170707,2724,2712,2736,2750,2680,2712,2718,0,6,76,206.58,644
,20170710,2712,2718,2706,2730,2698,2720,2716,2,-2,48,130.40,652
,20170711,2720,2716,2738,2760,2732,2760,2748,44,32,78,214.45,656
,20170712,2760,2748,2758,2786,2742,2742,2754,-6,6,90,247.94,654
,20170713,2742,2754,2756,2798,2744,2798,2760,44,6,50,138.07,660
,20170714,2798,2760,2784,2822,2750,2812,2788,52,28,108,301.22,678
,20170717,2812,2788,2822,2840,2810,2836,2828,48,40,48,135.78,694
,20170718,2836,2828,2890,2890,2828,2828,2846,0,18,98,279.01,694
,20170719,2828,2846,2842,2856,2834,2854,2846,8,0,44,125.29,704
,20170720,2854,2846,2854,2862,2836,2852,2852,6,6,66,188.25,722
,20170721,2852,2852,2856,2856,2812,2832,2834,-20,-18,76,215.40,708
,20170724,2832,2834,2834,2848,2812,2838,2834,4,0,70,198.52,710
,20170725,2838,2834,2848,2900,2844,2900,2882,66,48,82,236.42,714
,20170726,2900,2882,2900,2914,2866,2880,2890,-2,8,32,92.52,716
,20170727,2880,2890,2890,2918,2874,2902,2896,12,6,54,156.38,732
,20170728,2902,2896,2914,2914,2850,2860,2886,-36,-10,144,415.85,672
,20170731,2860,2886,2890,2920,2862,2874,2878,-12,-8,864,"2,487.17",994
,20170801,2874,2878,2860,2888,2766,2842,2834,-36,-44,2136,"6,055.52",2314
,20170802,2842,2834,2822,2822,2720,2772,2774,-62,-60,1870,"5,187.50",3302
,20170803,2772,2774,2780,2806,2750,2762,2778,-12,4,548,"1,522.97",3394
,20170804,2762,2778,2772,2812,2764,2776,2782,-2,4,654,"1,819.43",3576
,20170807,2776,2782,2754,2776,2614,2698,2668,-84,-114,14494,"38,692.79",12728
,20170808,2698,2668,2684,2750,2600,2736,2676,68,8,8202,"21,963.02",16106
,20170809,2736,2676,2690,2800,2690,2788,2756,112,80,1692,"4,666.38",16474
,20170810,2788,2756,2810,2840,2778,2808,2814,52,58,1870,"5,262.44",16546
,20170811,2808,2814,2802,2828,2680,2696,2748,-118,-66,2862,"7,868.00",16314
,20170814,2696,2748,2696,2712,2680,2680,2698,-68,-50,1070,"2,888.82",16342
,20170815,2680,2698,2686,2738,2680,2708,2726,10,28,6024,"16,430.28",15890
,20170816,2708,2726,2720,2728,2692,2726,2712,0,-14,492,"1,334.38",15948
,20170817,2726,2712,2728,2792,2726,2784,2760,72,48,3380,"9,330.59",16724
,20170818,2784,2760,2756,2820,2756,2800,2800,40,40,1760,"4,928.86",16848
,20170821,2800,2800,2818,2838,2790,2820,2816,20,16,3190,"8,983.62",17192
,20170822,2820,2816,2820,2848,2776,2834,2812,18,-4,2244,"6,311.09",16498
,20170823,2834,2812,2838,2884,2806,2806,2842,-6,30,2890,"8,215.60",16872
,20170824,2806,2842,2828,2876,2820,2876,2844,34,2,882,"2,508.96",16916
,20170825,2876,2844,2862,2910,2854,2882,2878,38,34,778,"2,239.19",16950
,20170828,2882,2878,2864,2902,2862,2888,2880,10,2,950,"2,736.88",17072
,20170829,2888,2880,2900,2900,2856,2884,2870,4,-10,1644,"4,720.98",17272
,20170830,2884,2870,2864,2882,2832,2852,2864,-18,-6,3512,"10,063.39",16398
,20170831,2852,2864,2868,2868,2810,2838,2830,-26,-34,2824,"7,996.01",16622
,20170901,2838,2830,2858,2892,2846,2888,2874,58,44,1180,"3,393.29",16830
,20170904,2888,2874,2894,2912,2812,2820,2872,-54,-2,3544,"10,185.01",17130
,20170905,2820,2872,2826,2860,2780,2820,2826,-52,-46,6216,"17,569.18",16692
,20170906,2820,2826,2846,2848,2808,2808,2830,-18,4,3384,"9,577.36",16098
,20170907,2808,2830,2824,2848,2780,2790,2814,-40,-16,13172,"37,075.08",14080
,20170908,2790,2814,2806,2826,2760,2802,2794,-12,-20,28322,"79,179.58",10884
,20170911,2802,2794,2762,2820,2762,2814,2790,20,-4,5658,"15,786.46",10576
,20170912,2814,2790,2814,2836,2806,2828,2820,38,30,1070,"3,019.38",10510
,20170913,2828,2820,2830,2838,2786,2792,2808,-28,-12,1876,"5,268.65",10468
,20170914,2792,2808,2792,2822,2756,2810,2804,2,-4,8180,"22,939.95",10370
,20170915,2810,2804,2822,2836,2790,2824,2810,20,6,3688,"10,365.63",10328
,20170918,2824,2810,2822,2840,2808,2824,2826,14,16,1962,"5,546.84",10604
,20170919,2824,2826,2822,2826,2792,2798,2808,-28,-18,1408,"3,955.62",10534
,20170920,2798,2808,2804,2810,2786,2800,2798,-8,-10,1166,"3,262.69",10474
,20170921,2800,2798,2808,2814,2768,2792,2788,-6,-10,2032,"5,667.61",10620
,20170922,2792,2788,2772,2808,2772,2808,2790,20,2,2276,"6,353.44",10592
,20170925,2808,2790,2796,2826,2796,2810,2814,20,24,1702,"4,792.74",10766
,20170926,2810,2814,2816,2902,2792,2826,2820,12,6,1272,"3,587.13",10662
,20170927,2826,2820,2816,2830,2808,2810,2818,-10,-2,1706,"4,808.46",10766
,20170928,2810,2818,2814,2814,2728,2730,2760,-88,-58,5790,"15,983.82",10856
,20170929,2730,2760,2744,2770,2732,2750,2754,-10,-6,1544,"4,252.51",10828
,20171009,2750,2754,2744,2744,2672,2684,2692,-70,-62,1184,"3,188.51",10956
,20171010,2684,2692,2690,2716,2654,2670,2676,-22,-16,1490,"3,990.06",11086
,20171011,2670,2676,2676,2692,2664,2674,2680,-2,4,584,"1,565.60",11034
,20171012,2674,2680,2668,2720,2660,2720,2696,40,16,758,"2,043.58",10936
,20171013,2720,2696,2720,2744,2686,2744,2718,48,22,722,"1,963.42",10810
,20171016,2744,2718,2746,2758,2718,2736,2736,18,18,914,"2,501.10",10796
,20171017,2736,2736,2736,2758,2720,2726,2746,-10,10,2278,"6,256.26",11726
,20171018,2726,2746,2730,2744,2702,2730,2720,-16,-26,880,"2,394.31",11430
,20171019,2730,2720,2726,2728,2680,2688,2702,-32,-18,1572,"4,249.33",11070
,20171020,2688,2702,2676,2732,2670,2724,2706,22,4,1052,"2,847.30",10896
,20171023,2724,2706,2714,2740,2706,2736,2726,30,20,768,"2,093.64",10892
,20171024,2736,2726,2736,2750,2724,2724,2736,-2,10,524,"1,434.26",10896
,20171025,2724,2736,2730,2788,2730,2776,2774,40,38,1646,"4,566.50",10832
,20171026,2776,2774,2770,2778,2764,2776,2772,2,-2,704,"1,952.16",10850
,20171027,2776,2772,2776,2796,2764,2768,2780,-4,8,1394,"3,877.08",10702
,20171030,2768,2780,2764,2824,2760,2800,2792,20,12,5302,"14,807.55",11428
,20171031,2800,2792,2810,2810,2754,2770,2778,-22,-14,930,"2,583.75",11574
,20171101,2770,2778,2764,2798,2756,2776,2782,-2,4,444,"1,235.30",11628
,20171102,2776,2782,2782,2792,2776,2786,2788,4,6,400,"1,115.25",11608
,20171103,2786,2788,2784,2828,2784,2824,2812,36,24,1038,"2,920.16",11736
,20171106,2824,2812,2826,2846,2816,2840,2832,28,20,638,"1,807.33",11766
,20171107,2840,2832,2840,2868,2834,2866,2856,34,24,716,"2,045.74",11848
,20171108,2866,2856,2860,2860,2854,2854,2856,-2,0,168,480.12,11918
,20171109,2854,2856,2856,2874,2842,2856,2854,0,-2,556,"1,587.23",12002
,20171110,2856,2854,2838,2856,2832,2848,2846,-6,-8,896,"2,550.51",12062
,20171113,2848,2846,2854,2874,2846,2870,2860,24,14,374,"1,069.71",12084
,20171114,2870,2860,2870,2886,2860,2868,2864,8,4,246,704.82,12080
,20171115,2868,2864,2860,2874,2750,2750,2798,-114,-66,1904,"5,327.60",11662
,20171116,2750,2798,2752,2768,2750,2752,2758,-46,-40,790,"2,179.98",11496
,20171117,2752,2758,2748,2764,2734,2756,2750,-2,-8,418,"1,149.62",11396
,20171120,2756,2750,2762,2794,2750,2788,2770,38,20,502,"1,391.01",11364
,20171121,2788,2770,2786,2814,2784,2800,2804,30,34,538,"1,508.82",11364
,20171122,2800,2804,2812,2868,2804,2852,2840,48,36,1168,"3,318.88",11472
,20171123,2852,2840,2866,2878,2854,2872,2870,32,30,1350,"3,875.47",11916
,20171124,2872,2870,2872,2896,2862,2892,2878,22,8,826,"2,378.63",11962
,20171127,2892,2878,2886,2900,2834,2836,2856,-42,-22,1566,"4,474.20",12330
,20171128,2836,2856,2828,2862,2828,2852,2846,-4,-10,1426,"4,059.46",12724
,20171129,2852,2846,2848,2862,2830,2850,2844,4,-2,630,"1,792.77",12704
,20171130,2850,2844,2838,2880,2818,2880,2846,36,2,2482,"7,065.22",13170
,20171201,2880,2846,2884,2906,2866,2892,2882,46,36,2132,"6,148.38",13884
,20171204,2892,2882,2898,2936,2886,2904,2910,22,28,1842,"5,361.96",13998
,20171205,2904,2910,2890,2938,2882,2888,2906,-22,-4,2764,"8,035.45",14432
,20171206,2888,2906,2880,2934,2872,2892,2900,-14,-6,3626,"10,521.37",15512
,20171207,2892,2900,2872,2872,2762,2770,2802,-130,-98,7268,"20,376.88",13980
,20171208,2770,2802,2768,2798,2768,2780,2782,-22,-20,1994,"5,549.42",13908
,20171211,2780,2782,2800,2816,2740,2768,2770,-14,-12,2922,"8,094.99",14042
,20171212,2768,2770,2756,2792,2716,2748,2758,-22,-12,2054,"5,665.60",14172
,20171213,2748,2758,2752,2782,2732,2766,2758,8,0,1884,"5,196.31",14104
,20171214,2766,2758,2776,2794,2740,2762,2764,4,6,2112,"5,839.60",14042
,20171215,2762,2764,2742,2776,2738,2768,2762,4,-2,3384,"9,348.77",14172
,20171218,2768,2762,2768,2808,2756,2796,2788,34,26,3328,"9,284.88",14306
,20171219,2796,2788,2794,2798,2764,2780,2778,-8,-10,2310,"6,417.84",14484
,20171220,2780,2778,2788,2810,2780,2796,2798,18,20,2172,"6,077.50",14670
,20171221,2796,2798,2794,2808,2748,2760,2786,-38,-12,6270,"17,470.38",14776
,20171222,2760,2786,2744,2770,2744,2768,2758,-18,-28,3050,"8,417.73",15590
,20171225,2768,2758,2752,2772,2742,2766,2754,8,-4,3584,"9,876.43",16000
,20171226,2766,2754,2766,2776,2754,2772,2766,18,12,2094,"5,795.20",16030
,20171227,2772,2766,2768,2794,2756,2788,2776,22,10,3360,"9,330.29",16138
,20171228,2788,2776,2784,2798,2774,2780,2784,4,8,1740,"4,844.20",16564
,20171229,2780,2784,2780,2790,2772,2784,2780,0,-4,1150,"3,199.24",16610
bu1903,20170316,3060,3060,3150,3150,3150,3150,3150,90,90,2,6.30,2
,20170317,3150,3150,3114,3114,3114,3114,3114,-36,-36,2,6.23,2
,20170320,3114,3114,3134,3134,3134,3134,3134,20,20,2,6.27,2
,20170321,3134,3134,,,,3134,3134,0,0,0,0.00,2
,20170322,3134,3134,,,,3098,3098,-36,-36,0,0.00,2
,20170323,3098,3098,,,,3080,3080,-18,-18,0,0.00,2
,20170324,3080,3080,,,,3080,3080,0,0,0,0.00,2
,20170327,3080,3080,3098,3098,3032,3032,3064,-48,-16,8,24.52,10
,20170328,3032,3064,3028,3028,3016,3016,3020,-48,-44,6,18.13,10
,20170329,3016,3020,3050,3060,3028,3060,3040,40,20,30,91.22,28
,20170330,3060,3040,3038,3044,3022,3040,3032,0,-8,20,60.66,42
,20170331,3040,3032,3040,3062,3022,3040,3038,8,6,24,72.94,56
,20170405,3040,3038,3062,3130,3062,3120,3108,82,70,12,37.31,58
,20170406,3120,3108,3146,3148,3100,3138,3132,30,24,26,81.44,74
,20170407,3138,3132,3102,3102,3076,3088,3088,-44,-44,8,24.71,74
,20170410,3088,3088,3016,3064,3016,3064,3038,-24,-50,38,115.48,88
,20170411,3064,3038,3042,3042,2940,2940,2998,-98,-40,66,197.93,84
,20170412,2940,2998,2976,2982,2948,2950,2966,-48,-32,50,148.35,58
,20170413,2950,2966,2936,2968,2936,2968,2954,2,-12,22,65.01,44
,20170414,2968,2954,2956,2956,2854,2870,2882,-84,-72,14,40.37,42
,20170417,2870,2882,2888,2888,2878,2878,2882,-4,0,6,17.30,38
,20170418,2878,2882,,,,2882,2882,0,0,0,0.00,38
,20170419,2882,2882,2824,2842,2802,2842,2818,-40,-64,20,56.39,36
,20170420,2842,2818,2902,2902,2808,2808,2868,-10,50,8,22.95,40
,20170421,2808,2868,2868,2868,2866,2866,2866,-2,-2,4,11.47,40
,20170424,2866,2866,2846,2846,2812,2832,2826,-34,-40,10,28.27,44
,20170425,2832,2826,2830,2858,2830,2840,2842,14,16,6,17.06,48
,20170426,2840,2842,2804,2814,2800,2814,2804,-28,-38,12,33.65,42
,20170427,2814,2804,2746,2790,2746,2790,2768,-14,-36,4,11.07,42
,20170428,2790,2768,2878,2910,2866,2910,2892,142,124,34,98.36,44
,20170502,2910,2892,2896,2912,2836,2912,2876,20,-16,28,80.57,38
,20170503,2912,2876,2882,2890,2876,2890,2884,14,8,8,23.08,40
,20170504,2890,2884,2864,2864,2810,2810,2826,-74,-58,18,50.89,44
,20170505,2810,2826,2794,2806,2730,2730,2774,-96,-52,34,94.38,40
,20170508,2730,2774,2746,2762,2740,2762,2746,-12,-28,10,27.47,42
,20170509,2762,2746,2750,2750,2746,2750,2748,4,2,6,16.49,44
,20170510,2750,2748,2740,2768,2730,2768,2750,20,2,8,22.00,44
,20170511,2768,2750,2740,2780,2740,2780,2758,30,8,66,182.14,72
,20170512,2780,2758,2754,2756,2734,2746,2744,-12,-14,14,38.43,70
,20170515,2746,2744,2778,2804,2778,2782,2786,38,42,8,22.29,72
,20170516,2782,2786,2816,2818,2800,2818,2808,32,22,8,22.47,72
,20170517,2818,2808,2806,2816,2806,2816,2810,8,2,4,11.24,72
,20170518,2816,2810,2810,2832,2786,2832,2796,22,-14,22,61.52,78
,20170519,2832,2796,2840,2856,2840,2856,2850,60,54,10,28.52,68
,20170522,2856,2850,2862,2868,2842,2868,2854,18,4,12,34.25,76
,20170523,2868,2854,2856,2856,2808,2834,2836,-20,-18,28,79.46,76
,20170524,2834,2836,2812,2812,2790,2790,2800,-46,-36,4,11.20,76
,20170525,2790,2800,2822,2890,2822,2890,2870,90,70,16,45.94,70
,20170526,2890,2870,2802,2814,2758,2758,2786,-112,-84,36,100.35,78
,20170531,2758,2786,2760,2760,2686,2688,2712,-98,-74,32,86.80,82
,20170601,2688,2712,2696,2718,2668,2718,2696,6,-16,28,75.51,78
,20170602,2718,2696,2696,2696,2686,2686,2690,-10,-6,4,10.76,74
,20170605,2686,2690,2688,2708,2680,2708,2694,18,4,14,37.74,70
,20170606,2708,2694,2714,2714,2714,2714,2714,20,20,2,5.43,70
,20170607,2714,2714,,,,2714,2714,0,0,0,0.00,70
,20170608,2714,2714,2698,2738,2680,2716,2704,2,-10,24,64.90,74
,20170609,2716,2704,,,,2704,2704,0,0,0,0.00,74
,20170612,2704,2704,2696,2748,2692,2720,2712,16,8,26,70.54,82
,20170613,2720,2712,2726,2730,2702,2718,2720,6,8,18,48.97,82
,20170614,2718,2720,2690,2732,2690,2722,2702,2,-18,24,64.86,78
,20170615,2722,2702,,,,2702,2702,0,0,0,0.00,78
,20170616,2702,2702,2696,2716,2690,2690,2702,-12,0,8,21.62,70
,20170619,2690,2702,2690,2724,2680,2690,2694,-12,-8,26,70.05,60
,20170620,2690,2694,2710,2730,2710,2728,2720,34,26,12,32.65,56
,20170621,2728,2720,2712,2714,2676,2690,2706,-30,-14,34,92.02,34
,20170622,2690,2706,,,,2706,2706,0,0,0,0.00,34
,20170623,2706,2706,,,,2706,2706,0,0,0,0.00,34
,20170626,2706,2706,2706,2706,2706,2706,2706,0,0,2,5.41,34
,20170627,2706,2706,2700,2700,2700,2700,2700,-6,-6,6,16.20,32
,20170628,2700,2700,2730,2736,2722,2736,2730,36,30,8,21.84,28
,20170629,2736,2730,2742,2744,2734,2734,2740,4,10,6,16.44,22
,20170630,2734,2740,,,,2740,2740,0,0,0,0.00,22
,20170703,2740,2740,2752,2752,2742,2742,2746,2,6,4,10.99,22
,20170704,2742,2746,,,,2746,2746,0,0,0,0.00,22
,20170705,2746,2746,2756,2768,2750,2768,2760,22,14,8,22.08,20
,20170706,2768,2760,2784,2784,2766,2780,2778,20,18,10,27.80,18
,20170707,2780,2778,,,,2778,2778,0,0,0,0.00,18
,20170710,2778,2778,,,,2778,2778,0,0,0,0.00,18
,20170711,2778,2778,2806,2826,2806,2826,2812,48,34,8,22.51,22
,20170712,2826,2812,2842,2842,2842,2842,2842,30,30,2,5.68,22
,20170713,2842,2842,,,,2842,2842,0,0,0,0.00,22
,20170714,2842,2842,2828,2884,2828,2884,2852,42,10,10,28.53,20
,20170717,2884,2852,2902,2902,2902,2902,2902,50,50,2,5.80,22
,20170718,2902,2902,,,,2902,2902,0,0,0,0.00,22
,20170719,2902,2902,2912,2912,2870,2870,2890,-32,-12,4,11.56,22
,20170720,2870,2890,2906,2906,2906,2906,2906,16,16,2,5.81,20
,20170721,2906,2906,,,,2906,2906,0,0,0,0.00,20
,20170724,2906,2906,,,,2906,2906,0,0,0,0.00,20
,20170725,2906,2906,,,,2956,2956,50,50,0,0.00,20
,20170726,2956,2956,,,,2956,2956,0,0,0,0.00,20
,20170727,2956,2956,,,,2956,2956,0,0,0,0.00,20
,20170728,2956,2956,,,,2956,2956,0,0,0,0.00,20
,20170731,2956,2956,,,,2948,2948,-8,-8,0,0.00,20
,20170801,2948,2948,2954,2978,2868,2920,2922,-28,-26,38,111.08,28
,20170802,2920,2922,,,,2860,2860,-62,-62,0,0.00,28
,20170803,2860,2860,2844,2844,2842,2842,2842,-18,-18,4,11.37,28
,20170804,2842,2842,,,,2846,2846,4,4,0,0.00,28
,20170807,2846,2846,2812,2812,2690,2730,2746,-116,-100,66,181.24,40
,20170808,2730,2746,2758,2782,2746,2782,2756,36,10,62,170.93,30
,20170809,2782,2756,,,,2840,2840,84,84,0,0.00,30
,20170810,2840,2840,,,,2840,2840,0,0,0,0.00,30
,20170811,2840,2840,2684,2782,2684,2782,2732,-58,-108,4,10.93,30
,20170814,2782,2732,,,,2732,2732,0,0,0,0.00,30
,20170815,2732,2732,2738,2778,2710,2770,2750,38,18,46,126.55,26
,20170816,2770,2750,,,,2750,2750,0,0,0,0.00,26
,20170817,2750,2750,,,,2750,2750,0,0,0,0.00,26
,20170818,2750,2750,,,,2790,2790,40,40,0,0.00,26
,20170821,2790,2790,,,,2802,2802,12,12,0,0.00,26
,20170822,2802,2802,2802,2864,2802,2834,2834,32,32,14,39.68,18
,20170823,2834,2834,2824,2870,2824,2870,2846,36,12,4,11.39,16
,20170824,2870,2846,2872,2922,2824,2888,2876,42,30,24,69.03,16
,20170825,2888,2876,2880,2928,2870,2890,2900,14,24,22,63.82,18
,20170828,2890,2900,,,,2900,2900,0,0,0,0.00,18
,20170829,2900,2900,2880,2880,2880,2880,2880,-20,-20,6,17.28,12
,20170830,2880,2880,,,,2880,2880,0,0,0,0.00,12
,20170831,2880,2880,2842,2842,2842,2842,2842,-38,-38,2,5.68,12
,20170901,2842,2842,,,,2886,2886,44,44,0,0.00,12
,20170904,2886,2886,,,,2886,2886,0,0,0,0.00,12
,20170905,2886,2886,2850,2876,2836,2876,2856,-10,-30,14,40.01,18
,20170906,2876,2856,2886,2888,2882,2882,2884,26,28,6,17.31,18
,20170907,2882,2884,2874,2874,2818,2860,2850,-24,-34,24,68.42,24
,20170908,2860,2850,2838,2850,2838,2850,2838,0,-12,38,107.87,62
,20170911,2850,2838,,,,2838,2838,0,0,0,0.00,62
,20170912,2838,2838,,,,2838,2838,0,0,0,0.00,62
,20170913,2838,2838,,,,2838,2838,0,0,0,0.00,62
,20170914,2838,2838,2842,2876,2842,2876,2850,38,12,8,22.80,56
,20170915,2876,2850,,,,2850,2850,0,0,0,0.00,56
,20170918,2850,2850,2906,2906,2906,2906,2906,56,56,2,5.81,54
,20170919,2906,2906,2878,2878,2878,2878,2878,-28,-28,28,80.58,26
,20170920,2878,2878,,,,2878,2878,0,0,0,0.00,26
,20170921,2878,2878,2842,2842,2842,2842,2842,-36,-36,4,11.37,24
,20170922,2842,2842,,,,2842,2842,0,0,0,0.00,24
,20170925,2842,2842,2860,2860,2860,2860,2860,18,18,2,5.72,24
,20170926,2860,2860,,,,2860,2860,0,0,0,0.00,24
,20170927,2860,2860,,,,2860,2860,0,0,0,0.00,24
,20170928,2860,2860,2788,2788,2788,2788,2788,-72,-72,4,11.15,20
,20170929,2788,2788,,,,2788,2788,0,0,0,0.00,20
,20171009,2788,2788,2710,2710,2710,2710,2710,-78,-78,2,5.42,22
,20171010,2710,2710,2738,2764,2738,2764,2750,54,40,4,11.00,18
,20171011,2764,2750,2734,2742,2734,2742,2738,-8,-12,4,10.95,14
,20171012,2742,2738,,,,2738,2738,0,0,0,0.00,14
,20171013,2738,2738,,,,2738,2738,0,0,0,0.00,14
,20171016,2738,2738,2734,2734,2734,2734,2734,-4,-4,2,5.47,12
,20171017,2734,2734,,,,2734,2734,0,0,0,0.00,12
,20171018,2734,2734,,,,2734,2734,0,0,0,0.00,12
,20171019,2734,2734,,,,2734,2734,0,0,0,0.00,12
,20171020,2734,2734,,,,2734,2734,0,0,0,0.00,12
,20171023,2734,2734,,,,2734,2734,0,0,0,0.00,12
,20171024,2734,2734,,,,2734,2734,0,0,0,0.00,12
,20171025,2734,2734,2768,2790,2768,2790,2778,56,44,4,11.12,16
,20171026,2790,2778,2840,2840,2756,2774,2780,-4,2,24,66.74,28
,20171027,2774,2780,2790,2790,2768,2790,2782,10,2,20,55.67,46
,20171030,2790,2782,2786,2786,2786,2786,2786,4,4,4,11.14,50
,20171031,2786,2786,2780,2866,2780,2840,2846,54,60,42,119.53,20
,20171101,2840,2846,2786,2844,2786,2844,2820,-2,-26,10,28.21,18
,20171102,2844,2820,,,,2820,2820,0,0,0,0.00,18
,20171103,2820,2820,,,,2820,2820,0,0,0,0.00,18
,20171106,2820,2820,2866,2866,2866,2866,2866,46,46,4,11.46,18
,20171107,2866,2866,,,,2874,2874,8,8,0,0.00,18
,20171108,2874,2874,,,,2874,2874,0,0,0,0.00,18
,20171109,2874,2874,,,,2874,2874,0,0,0,0.00,18
,20171110,2874,2874,,,,2874,2874,0,0,0,0.00,18
,20171113,2874,2874,,,,2874,2874,0,0,0,0.00,18
,20171114,2874,2874,,,,2874,2874,0,0,0,0.00,18
,20171115,2874,2874,2810,2810,2800,2800,2804,-74,-70,4,11.22,16
,20171116,2800,2804,,,,2804,2804,0,0,0,0.00,16
,20171117,2804,2804,,,,2804,2804,0,0,0,0.00,16
,20171120,2804,2804,,,,2804,2804,0,0,0,0.00,16
,20171121,2804,2804,2836,2836,2836,2836,2836,32,32,2,5.67,18
,20171122,2836,2836,2886,2886,2886,2886,2886,50,50,2,5.77,20
,20171123,2886,2886,,,,2886,2886,0,0,0,0.00,20
,20171124,2886,2886,,,,2886,2886,0,0,0,0.00,20
,20171127,2886,2886,,,,2886,2886,0,0,0,0.00,20
,20171128,2886,2886,,,,2886,2886,0,0,0,0.00,20
,20171129,2886,2886,2860,2860,2860,2860,2860,-26,-26,2,5.72,18
,20171130,2860,2860,,,,2860,2860,0,0,0,0.00,18
,20171201,2860,2860,,,,2860,2860,0,0,0,0.00,18
,20171204,2860,2860,,,,2920,2920,60,60,0,0.00,18
,20171205,2920,2920,,,,2920,2920,0,0,0,0.00,18
,20171206,2920,2920,,,,2920,2920,0,0,0,0.00,18
,20171207,2920,2920,2828,2828,2828,2828,2828,-92,-92,10,28.28,22
,20171208,2828,2828,,,,2828,2828,0,0,0,0.00,22
,20171211,2828,2828,,,,2828,2828,0,0,0,0.00,22
,20171212,2828,2828,2812,2812,2792,2792,2802,-36,-26,4,11.21,22
,20171213,2792,2802,,,,2802,2802,0,0,0,0.00,22
,20171214,2802,2802,,,,2802,2802,0,0,0,0.00,22
,20171215,2802,2802,,,,2802,2802,0,0,0,0.00,22
,20171218,2802,2802,,,,2802,2802,0,0,0,0.00,22
,20171219,2802,2802,,,,2802,2802,0,0,0,0.00,22
,20171220,2802,2802,,,,2802,2802,0,0,0,0.00,22
,20171221,2802,2802,,,,2802,2802,0,0,0,0.00,22
,20171222,2802,2802,,,,2802,2802,0,0,0,0.00,22
,20171225,2802,2802,,,,2802,2802,0,0,0,0.00,22
,20171226,2802,2802,,,,2802,2802,0,0,0,0.00,22
,20171227,2802,2802,,,,2802,2802,0,0,0,0.00,22
,20171228,2802,2802,,,,2802,2802,0,0,0,0.00,22
,20171229,2802,2802,,,,2802,2802,0,0,0,0.00,22
bu1906,20170616,2702,2702,2704,2736,2704,2730,2722,28,20,88,239.58,74
,20170619,2730,2722,2740,2740,2710,2726,2722,4,0,88,239.67,126
,20170620,2726,2722,2740,2770,2720,2756,2752,34,30,146,402.08,184
,20170621,2756,2752,2736,2764,2722,2738,2740,-14,-12,138,378.36,162
,20170622,2738,2740,2728,2758,2728,2744,2746,4,6,114,313.16,190
,20170623,2744,2746,2758,2762,2746,2746,2754,0,8,24,66.12,202
,20170626,2746,2754,2732,2750,2730,2746,2738,-8,-16,54,147.92,234
,20170627,2746,2738,2738,2748,2732,2748,2742,10,4,62,170.06,276
,20170628,2748,2742,2754,2766,2742,2754,2758,12,16,154,425.03,324
,20170629,2754,2758,2740,2786,2740,2784,2770,26,12,126,349.10,414
,20170630,2784,2770,2770,2790,2756,2776,2768,6,-2,78,215.92,462
,20170703,2776,2768,2794,2796,2780,2784,2788,16,20,68,189.60,484
,20170704,2784,2788,2796,2796,2758,2764,2768,-24,-20,76,210.43,460
,20170705,2764,2768,2778,2800,2772,2798,2790,30,22,80,223.26,520
,20170706,2798,2790,2782,2800,2768,2800,2788,10,-2,52,145.02,530
,20170707,2800,2788,2816,2820,2788,2790,2802,2,14,70,196.14,546
,20170710,2790,2802,2788,2848,2774,2800,2808,-2,6,238,668.68,566
,20170711,2800,2808,2804,2844,2788,2836,2812,28,4,184,517.56,592
,20170712,2836,2812,2834,2840,2818,2826,2830,14,18,114,322.70,640
,20170713,2826,2830,2830,2848,2818,2844,2834,14,4,138,391.28,662
,20170714,2844,2834,2856,2904,2834,2902,2878,68,44,370,"1,065.02",834
,20170717,2902,2878,2894,2928,2892,2918,2910,40,32,154,448.24,882
,20170718,2918,2910,2926,2930,2908,2910,2918,0,8,158,461.07,914
,20170719,2910,2918,2924,2942,2924,2930,2934,12,16,134,393.19,958
,20170720,2930,2934,2928,2958,2928,2954,2942,20,8,134,394.30,956
,20170721,2954,2942,2940,2944,2900,2920,2920,-22,-22,166,484.87,952
,20170724,2920,2920,2922,2932,2896,2928,2916,8,-4,70,204.22,942
,20170725,2928,2916,2936,2988,2930,2988,2968,72,52,494,"1,466.56",1246
,20170726,2988,2968,2992,3000,2960,2974,2980,6,12,134,399.40,1294
,20170727,2974,2980,2968,3004,2960,2994,2988,14,8,170,508.24,1340
,20170728,2994,2988,2990,2990,2936,2950,2964,-38,-24,214,634.36,1346
,20170731,2950,2964,2962,3016,2962,2990,2996,26,32,326,976.93,1430
,20170801,2990,2996,2976,2986,2902,2964,2946,-32,-50,1060,"3,123.28",1406
,20170802,2964,2946,2954,2966,2892,2924,2932,-22,-14,338,991.09,1458
,20170803,2924,2932,2928,2932,2900,2900,2912,-32,-20,188,547.73,1432
,20170804,2900,2912,2916,2950,2888,2900,2916,-12,4,238,694.12,1422
,20170807,2900,2916,2902,2902,2820,2838,2850,-78,-66,838,"2,388.44",1284
,20170808,2838,2850,2824,2830,2764,2830,2790,-20,-60,858,"2,395.26",826
,20170809,2830,2790,2806,2880,2806,2870,2860,80,70,84,240.26,844
,20170810,2870,2860,2872,2908,2868,2900,2886,40,26,94,271.46,846
,20170811,2900,2886,2900,2910,2808,2812,2842,-74,-44,180,511.85,800
,20170814,2812,2842,2820,2836,2806,2814,2822,-28,-20,102,287.84,794
,20170815,2814,2822,2832,2852,2820,2852,2838,30,16,140,397.36,792
,20170816,2852,2838,2852,2852,2822,2852,2834,14,-4,88,249.53,812
,20170817,2852,2834,2860,2898,2860,2878,2882,44,48,100,288.29,804
,20170818,2878,2882,2894,2912,2894,2906,2904,24,22,60,174.28,800
,20170821,2906,2904,2926,2928,2902,2914,2914,10,10,66,192.38,810
,20170822,2914,2914,2900,2942,2886,2940,2914,26,0,70,203.98,838
,20170823,2940,2914,2914,2978,2914,2948,2952,34,38,194,572.98,900
,20170824,2948,2952,2944,2972,2944,2972,2960,20,8,94,278.26,926
,20170825,2972,2960,2958,3000,2956,2976,2980,16,20,202,602.17,1012
,20170828,2976,2980,2984,2996,2966,2968,2986,-12,6,48,143.36,1032
,20170829,2968,2986,2984,2984,2948,2968,2964,-18,-22,64,189.73,1048
,20170830,2968,2964,2954,2974,2954,2968,2964,4,0,54,160.15,1054
,20170831,2968,2964,2944,2954,2920,2936,2934,-28,-30,148,434.44,1062
,20170901,2936,2934,2956,2976,2952,2962,2968,28,34,176,522.39,1102
,20170904,2962,2968,2946,2996,2926,2932,2956,-36,-12,342,"1,011.36",1072
,20170905,2932,2956,2936,2956,2926,2936,2936,-20,-20,38,111.62,1074
,20170906,2936,2936,2940,2948,2924,2926,2934,-10,-2,62,182.00,1052
,20170907,2926,2934,2930,2940,2880,2896,2906,-38,-28,438,"1,273.54",1044
,20170908,2896,2906,2878,2930,2860,2908,2892,2,-14,328,948.69,1074
,20170911,2908,2892,2906,2916,2876,2912,2890,20,-2,258,745.88,1066
,20170912,2912,2890,2916,2930,2914,2920,2922,30,32,80,233.87,1096
,20170913,2920,2922,2934,2936,2898,2904,2910,-18,-12,150,436.76,1134
,20170914,2904,2910,2902,2922,2900,2918,2908,8,-2,164,477.21,1190
,20170915,2918,2908,2922,2936,2900,2930,2922,22,14,200,584.60,1170
,20170918,2930,2922,2930,2934,2906,2922,2922,0,0,218,637.00,1284
,20170919,2922,2922,2918,2922,2894,2896,2906,-26,-16,206,598.86,1260
,20170920,2896,2906,2900,2904,2884,2896,2894,-10,-12,174,503.75,1250
,20170921,2896,2894,2910,2910,2878,2894,2896,0,2,196,567.82,1206
,20170922,2894,2896,2888,2908,2888,2908,2896,12,0,54,156.41,1208
,20170925,2908,2896,2916,2920,2890,2910,2910,14,14,132,384.14,1260
,20170926,2910,2910,2912,2924,2900,2912,2912,2,2,76,221.32,1292
,20170927,2912,2912,2910,2912,2906,2910,2910,-2,-2,38,110.60,1284
,20170928,2910,2910,2896,2902,2838,2838,2866,-72,-44,392,"1,123.74",1098
,20170929,2838,2866,2858,2870,2842,2850,2854,-16,-12,88,251.31,1082
,20171009,2850,2854,2832,2832,2786,2812,2808,-42,-46,174,488.69,1114
,20171010,2812,2808,2820,2826,2786,2786,2806,-22,-2,86,241.44,1128
,20171011,2786,2806,2804,2816,2794,2806,2806,0,0,120,336.88,1162
,20171012,2806,2806,2790,2830,2784,2828,2810,22,4,116,325.97,1174
,20171013,2828,2810,2820,2848,2808,2840,2824,30,14,74,209.00,1178
,20171016,2840,2824,2850,2862,2826,2840,2840,16,16,98,278.37,1208
,20171017,2840,2840,2840,2856,2832,2832,2838,-8,-2,60,170.38,1202
,20171018,2832,2838,2830,2842,2826,2836,2832,-2,-6,40,113.33,1188
,20171019,2836,2832,2826,2852,2800,2800,2818,-32,-14,108,304.54,1182
,20171020,2800,2818,2800,2836,2796,2836,2814,18,-4,118,332.14,1182
,20171023,2836,2814,2828,2850,2828,2844,2836,30,22,94,266.64,1184
,20171024,2844,2836,2844,2866,2842,2846,2850,10,14,62,176.82,1200
,20171025,2846,2850,2854,2894,2854,2886,2878,36,28,94,270.70,1226
,20171026,2886,2878,2880,2888,2874,2878,2878,0,0,78,224.55,1232
,20171027,2878,2878,2878,2896,2864,2876,2884,-2,6,64,184.66,1242
,20171030,2876,2884,2844,2916,2844,2888,2890,4,6,100,289.00,1250
,20171031,2888,2890,2880,2900,2860,2860,2878,-30,-12,64,184.19,1218
,20171101,2860,2878,2862,2892,2860,2872,2880,-6,2,60,172.81,1236
,20171102,2872,2880,2886,2894,2876,2882,2884,2,4,72,207.65,1228
,20171103,2882,2884,2888,2924,2882,2918,2908,34,24,342,994.58,1392
,20171106,2918,2908,2918,2934,2910,2928,2920,20,12,110,321.41,1452
,20171107,2928,2920,2922,2944,2920,2940,2934,20,14,150,440.36,1516
,20171108,2940,2934,2928,2940,2926,2934,2932,0,-2,66,193.57,1530
,20171109,2934,2932,2920,3050,2756,2938,2882,6,-50,298,858.86,1584
,20171110,2938,2882,2936,2936,2922,2930,2928,48,46,66,193.30,1600
,20171113,2930,2928,2940,2948,2922,2936,2938,8,10,58,170.41,1616
,20171114,2936,2938,2940,2946,2932,2946,2940,8,2,74,217.63,1620
,20171115,2946,2940,2940,2944,2848,2848,2884,-92,-56,346,998.31,1398
,20171116,2848,2884,2860,2860,2848,2860,2856,-24,-28,96,274.22,1378
,20171117,2860,2856,2842,2852,2842,2848,2846,-8,-10,64,182.25,1374
,20171120,2848,2846,2856,2876,2848,2876,2856,30,10,114,325.79,1404
,20171121,2876,2856,2884,2912,2864,2880,2878,24,22,92,264.79,1420
,20171122,2880,2878,2886,2936,2884,2926,2914,48,36,88,256.55,1450
,20171123,2926,2914,2928,2950,2928,2950,2938,36,24,96,282.23,1488
,20171124,2950,2938,2934,2966,2934,2960,2950,22,12,80,236.06,1532
,20171127,2960,2950,2968,2968,2916,2924,2934,-26,-16,40,117.37,1514
,20171128,2924,2934,2910,2938,2910,2938,2924,4,-10,48,140.40,1516
,20171129,2938,2924,2938,2940,2922,2922,2926,-2,2,80,234.24,1550
,20171130,2922,2926,2914,2946,2914,2944,2932,18,6,60,175.92,1552
,20171201,2944,2932,2950,2972,2944,2972,2960,40,28,108,319.69,1576
,20171204,2972,2960,2968,3000,2968,2984,2990,24,30,144,430.72,1546
,20171205,2984,2990,2964,3006,2964,2974,2986,-16,-4,116,346.49,1538
,20171206,2974,2986,2986,3004,2954,2968,2976,-18,-10,180,535.89,1568
,20171207,2968,2976,2950,2952,2870,2880,2912,-96,-64,312,908.90,1408
,20171208,2880,2912,2880,2896,2872,2880,2880,-32,-32,68,195.89,1378
,20171211,2880,2880,2888,2904,2852,2852,2868,-28,-12,218,625.44,1370
,20171212,2852,2868,2850,2900,2850,2866,2866,-2,-2,228,653.73,1316
,20171213,2866,2866,2852,2894,2852,2884,2878,18,12,54,155.49,1326
,20171214,2884,2878,2882,2900,2862,2870,2878,-8,0,58,166.95,1316
,20171215,2870,2878,2862,2884,2858,2884,2866,6,-12,44,126.14,1316
,20171218,2884,2866,2896,2902,2868,2902,2888,36,22,100,288.80,1338
,20171219,2902,2888,2886,2890,2870,2884,2882,-4,-6,70,201.82,1322
,20171220,2884,2882,2892,2900,2886,2890,2892,8,10,46,133.08,1332
,20171221,2890,2892,2898,2908,2858,2870,2878,-22,-14,122,351.26,1312
,20171222,2870,2878,2850,2866,2850,2862,2858,-16,-20,90,257.35,1294
,20171225,2862,2858,2856,2868,2830,2868,2850,10,-8,126,359.24,1228
,20171226,2868,2850,2866,2868,2858,2864,2860,14,10,46,131.65,1236
,20171227,2864,2860,2820,2880,2820,2876,2868,16,8,132,378.73,1276
,20171228,2876,2868,2872,2872,2862,2862,2868,-6,0,60,172.13,1320
,20171229,2862,2868,2862,2870,2850,2860,2858,-8,-10,210,600.22,1436
bu1909,20170918,2922,2922,2988,2988,2904,2952,2946,30,24,202,595.49,140
,20170919,2952,2946,2942,2958,2922,2924,2938,-22,-8,80,235.17,168
,20170920,2924,2938,2940,2946,2922,2940,2932,2,-6,104,304.97,166
,20170921,2940,2932,2950,2950,2914,2932,2936,0,4,136,399.39,238
,20170922,2932,2936,2932,2948,2924,2948,2936,12,0,98,287.84,252
,20170925,2948,2936,2960,2960,2936,2940,2946,4,10,56,165.04,268
,20170926,2940,2946,2954,2956,2932,2942,2944,-4,-2,104,306.36,316
,20170927,2942,2944,2946,2950,2934,2940,2942,-4,-2,86,253.18,308
,20170928,2940,2942,2940,2940,2882,2898,2912,-44,-30,100,291.27,268
,20170929,2898,2912,2914,2920,2886,2900,2904,-12,-8,78,226.55,270
,20171009,2900,2904,2838,2878,2828,2850,2844,-54,-60,54,153.59,288
,20171010,2850,2844,2858,2858,2828,2828,2840,-16,-4,82,232.91,282
,20171011,2828,2840,2840,2846,2832,2844,2842,4,2,92,261.52,324
,20171012,2844,2842,2840,2868,2820,2868,2850,26,8,52,148.27,318
,20171013,2868,2850,2866,2888,2842,2888,2860,38,10,58,165.92,338
,20171016,2888,2860,2880,2894,2864,2886,2878,26,18,94,270.68,358
,20171017,2886,2878,2886,2896,2878,2886,2886,8,8,126,363.64,366
,20171018,2886,2886,2882,2888,2874,2886,2880,0,-6,50,144.09,370
,20171019,2886,2880,2886,2886,2856,2858,2874,-22,-6,62,178.22,364
,20171020,2858,2874,2856,2880,2850,2876,2862,2,-12,68,194.75,360
,20171023,2876,2862,2880,2894,2852,2888,2880,26,18,92,265.06,388
,20171024,2888,2880,2880,2908,2880,2888,2896,8,16,84,243.36,396
,20171025,2888,2896,2898,2936,2898,2930,2920,34,24,118,344.68,430
,20171026,2930,2920,2912,2926,2912,2920,2920,0,0,68,198.56,436
,20171027,2920,2920,2912,2938,2912,2922,2924,2,4,92,269.07,470
,20171030,2922,2924,2910,2956,2910,2932,2930,8,6,114,334.10,482
,20171031,2932,2930,2938,2938,2914,2928,2926,-2,-4,104,304.44,474
,20171101,2928,2926,2912,2932,2912,2914,2920,-12,-6,72,210.30,476
,20171102,2914,2920,2914,2928,2914,2922,2922,2,2,52,152.02,490
,20171103,2922,2922,2914,2954,2914,2950,2938,28,16,162,476.19,572
,20171106,2950,2938,2948,2960,2946,2958,2954,20,16,86,254.08,622
,20171107,2958,2954,2960,2976,2954,2974,2966,20,12,158,468.89,664
,20171108,2974,2966,2974,2974,2954,2958,2962,-8,-4,76,225.12,662
,20171109,2958,2962,2946,3088,2784,2970,2904,8,-58,242,702.80,658
,20171110,2970,2904,2952,2974,2952,2960,2960,56,56,54,159.84,654
,20171113,2960,2960,2964,2976,2954,2974,2964,14,4,92,272.76,670
,20171114,2974,2964,2976,2980,2960,2974,2972,10,8,134,398.36,694
,20171115,2974,2972,2978,2982,2888,2888,2926,-84,-46,322,942.66,502
,20171116,2888,2926,2898,2906,2886,2892,2894,-34,-32,96,277.90,502
,20171117,2892,2894,2888,2898,2882,2894,2886,0,-8,68,196.37,496
,20171120,2894,2886,2892,2912,2882,2912,2892,26,6,212,613.51,492
,20171121,2912,2892,2900,2924,2900,2924,2912,32,20,96,279.62,502
,20171122,2924,2912,2916,2968,2916,2966,2946,54,34,136,400.82,534
,20171123,2966,2946,2972,2988,2962,2982,2976,36,30,124,369.03,604
,20171124,2982,2976,2972,2998,2972,2994,2988,18,12,56,167.34,626
,20171127,2994,2988,2998,2998,2962,2964,2976,-24,-12,72,214.39,628
,20171128,2964,2976,2964,2974,2960,2970,2966,-6,-10,74,219.56,638
,20171129,2970,2966,2966,2984,2964,2964,2972,-2,6,76,226.01,652
,20171130,2964,2972,2960,2984,2940,2984,2964,12,-8,92,272.74,620
,20171201,2984,2964,2984,3012,2978,3010,2992,46,28,142,425.08,698
,20171204,3010,2992,3006,3036,3000,3028,3020,36,28,88,265.92,726
,20171205,3028,3020,3026,3048,3010,3018,3026,-2,6,112,339.02,736
,20171206,3018,3026,3020,3040,3008,3018,3026,-8,0,86,260.33,734
,20171207,3018,3026,2996,2996,2914,2914,2960,-112,-66,212,627.67,608
,20171208,2914,2960,2934,2938,2912,2922,2930,-38,-30,32,93.81,596
,20171211,2922,2930,2948,2948,2912,2918,2928,-12,-2,88,257.75,604
,20171212,2918,2928,2926,2956,2908,2922,2932,-6,4,70,205.31,606
,20171213,2922,2932,2912,2942,2912,2928,2930,-4,-2,40,117.20,594
,20171214,2928,2930,2918,2940,2914,2920,2928,-10,-2,56,163.99,600
,20171215,2920,2928,2924,2924,2904,2918,2908,-10,-20,48,139.67,580
,20171218,2918,2908,2910,2946,2908,2934,2924,26,16,120,350.99,564
,20171219,2934,2924,2928,2930,2916,2922,2924,-2,0,84,245.76,554
,20171220,2922,2924,2932,2946,2928,2928,2936,4,12,42,123.37,554
,20171221,2928,2936,2932,2940,2890,2910,2914,-26,-22,80,233.17,534
,20171222,2910,2914,2916,2916,2900,2900,2904,-14,-10,36,104.56,518
,20171225,2900,2904,2896,2910,2886,2910,2894,6,-10,52,150.50,518
,20171226,2910,2894,2916,2916,2886,2902,2900,8,6,60,174.08,492
,20171227,2902,2900,2902,2916,2890,2912,2904,12,4,82,238.14,496
,20171228,2912,2904,2916,2916,2900,2904,2908,0,4,46,133.79,486
,20171229,2904,2908,2902,2904,2888,2892,2892,-16,-16,50,144.67,504
bu1912,20171218,2908,2908,2910,2966,2910,2962,2946,54,38,272,801.42,188
,20171219,2962,2946,2950,2956,2942,2944,2950,-2,4,130,383.61,220
,20171220,2944,2950,2956,2968,2952,2956,2960,6,10,168,497.51,316
,20171221,2956,2960,2950,2964,2930,2946,2948,-14,-12,266,784.20,248
,20171222,2946,2948,2948,2948,2926,2940,2936,-8,-12,76,223.14,246
,20171225,2940,2936,2924,2932,2908,2930,2922,-6,-14,142,414.96,296
,20171226,2930,2922,2936,2936,2920,2934,2926,12,4,174,509.34,422
,20171227,2934,2926,2936,2944,2914,2944,2934,18,8,200,586.90,536
,20171228,2944,2934,2946,2946,2930,2930,2936,-4,2,354,"1,039.89",796
,20171229,2930,2936,2930,2938,2918,2928,2926,-8,-10,280,819.44,884
cu1701,20170103,45200,45210,45470,45970,45420,45450,45780,240,570,18760,"429,448.45",41960
,20170104,45450,45780,45670,45670,44630,45270,45000,-510,-780,23690,"533,118.50",37920
,20170105,45270,45000,45210,45830,45110,45480,45560,480,560,16310,"371,585.10",35960
,20170106,45480,45560,45350,45430,44930,45090,45160,-470,-400,19080,"430,827.90",33120
,20170109,45090,45160,45160,45480,44880,45420,45330,260,170,17040,"386,253.70",28060
,20170110,45420,45330,45340,46000,45130,45910,45530,580,200,15420,"351,073.55",22820
,20170111,45910,45530,45910,46880,45910,46880,46660,1350,1130,14510,"338,588.15",17810
,20170112,46880,46660,46680,46890,46530,46720,46690,60,30,9580,"223,659.45",13420
,20170113,46720,46690,47040,47450,46820,47100,47240,410,550,8900,"210,247.50",11030
,20170116,47100,47240,47180,48000,47180,47580,47590,340,350,4330,"103,046.85",10600
cu1702,20170103,45360,45300,45440,46140,45440,45610,45890,310,590,54938,"1,260,688.99",124566
,20170104,45610,45890,45780,45820,44690,45360,45200,-530,-690,72186,"1,631,748.36",120298
,20170105,45360,45200,45270,46000,45220,45600,45690,400,490,59574,"1,361,185.04",114618
,20170106,45600,45690,45560,45600,44980,45180,45270,-510,-420,49220,"1,114,321.28",109790
,20170109,45180,45270,45110,45610,44950,45590,45370,320,100,39366,"893,089.47",110292
,20170110,45590,45370,45380,46120,45210,45980,45640,610,270,45380,"1,035,779.64",107136
,20170111,45980,45640,46210,47060,46210,46960,46790,1320,1150,60234,"1,409,362.23",105620
,20170112,46960,46790,46790,47020,46600,46820,46810,30,20,41142,"963,089.28",98888
,20170113,46820,46810,46950,47630,46950,47240,47320,430,510,45098,"1,067,233.38",96144
,20170116,47240,47320,47240,48200,47080,47780,47780,460,460,38442,"918,415.80",94276
,20170117,47780,47780,47700,47870,46410,46610,47040,-1170,-740,40534,"953,525.31",87012
,20170118,46610,47040,46660,46880,45800,46480,46350,-560,-690,35668,"826,779.54",82120
,20170119,46480,46350,46430,46720,46170,46580,46530,230,180,25116,"584,410.03",79396
,20170120,46580,46530,46380,46590,45910,45980,46340,-550,-190,39236,"909,133.62",70674
,20170123,45980,46340,46150,47100,46060,46750,46780,410,440,24802,"580,242.00",65176
,20170124,46750,46780,46680,47070,46400,46940,46810,160,30,20102,"470,575.37",59894
,20170125,46940,46810,47190,47690,47190,47490,47480,680,670,16042,"380,908.97",55564
,20170126,47490,47480,47380,48590,47310,47770,47660,290,180,13608,"324,334.55",51764
,20170203,47770,47660,46880,47350,46440,46620,46720,-1040,-940,9484,"221,563.43",50760
,20170206,46620,46720,46550,46790,46210,46460,46480,-260,-240,15760,"366,281.60",45950
,20170207,46460,46480,46460,46870,46130,46670,46690,190,210,15810,"369,151.80",42100
,20170208,46670,46690,46530,47450,46450,47450,47150,760,460,20250,"477,451.50",37800
,20170209,47450,47150,47500,47510,47010,47140,47250,-10,100,18090,"427,418.95",36270
,20170210,47140,47250,47240,47500,46720,47350,47010,100,-240,23590,"554,591.50",36000
,20170213,47350,47010,47300,50300,47280,49500,49320,2490,2310,15950,"393,348.60",32260
,20170214,49500,49320,49460,49630,49170,49630,49400,310,80,11510,"284,310.20",23940
,20170215,49630,49400,49680,49680,47670,48300,48490,-1100,-910,3070,"74,436.65",23390
cu1703,20170103,45500,45430,45630,46290,45630,45760,46040,330,610,183888,"4,233,393.01",193636
,20170104,45760,46040,45910,45980,44810,45520,45360,-520,-680,290606,"6,591,539.98",197220
,20170105,45520,45360,45400,46170,45360,45760,45850,400,490,318430,"7,301,206.84",206010
,20170106,45760,45850,45720,45770,45090,45350,45430,-500,-420,252160,"5,728,797.10",202332
,20170109,45350,45430,45260,45770,45090,45730,45470,300,40,201880,"4,589,920.36",204444
,20170110,45730,45470,45530,46270,45350,46110,45780,640,310,310498,"7,108,007.65",218778
,20170111,46110,45780,46340,47260,46340,47160,46950,1380,1170,371356,"8,719,402.53",225868
,20170112,47160,46950,46950,47200,46750,46980,46990,30,40,289596,"6,804,383.21",220550
,20170113,46980,46990,47110,47810,47110,47400,47500,410,510,362068,"8,599,992.89",215618
,20170116,47400,47500,47420,48390,47230,47950,47900,450,400,355334,"8,511,842.55",222522
,20170117,47950,47900,47880,48060,46540,46780,47320,-1120,-580,303912,"7,190,874.53",204580
,20170118,46780,47320,46850,47060,45930,46600,46550,-720,-770,308372,"7,178,517.57",197432
,20170119,46600,46550,46500,46880,46290,46730,46610,180,60,208420,"4,857,667.15",193114
,20170120,46730,46610,46570,46730,46000,46080,46420,-530,-190,236030,"5,478,897.65",180960
,20170123,46080,46420,46270,47280,46140,46850,46790,430,370,240234,"5,621,118.16",178494
,20170124,46850,46790,46810,47210,46500,47070,46870,280,80,187382,"4,391,977.22",175182
,20170125,47070,46870,47480,47880,47370,47650,47610,780,740,197238,"4,696,054.71",165856
,20170126,47650,47610,47460,48210,47450,48040,47820,430,210,188630,"4,510,634.74",159580
,20170203,48040,47820,47700,47710,46520,46780,46920,-1040,-900,119846,"2,812,090.08",153148
,20170206,46780,46920,46810,46980,46300,46600,46600,-320,-320,145150,"3,382,676.70",150708
,20170207,46600,46600,46620,47060,46560,46850,46810,250,210,129254,"3,025,476.88",149890
,20170208,46850,46810,46800,47690,46530,47660,47170,850,360,185624,"4,378,409.03",152378
,20170209,47660,47170,47580,47790,47210,47410,47530,240,360,153138,"3,639,603.78",150610
,20170210,47410,47530,47460,47820,46920,47610,47380,80,-150,199464,"4,725,545.65",152504
,20170213,47610,47380,47580,50330,47560,49870,49220,2490,1840,282176,"6,945,305.76",135290
,20170214,49870,49220,49550,49980,49400,49890,49680,670,460,108320,"2,690,832.43",127710
,20170215,49890,49680,49890,50060,48120,48560,48910,-1120,-770,123716,"3,025,723.98",116402
,20170216,48560,48910,48590,49150,48310,48560,48780,-350,-130,87568,"2,135,954.92",111234
,20170217,48560,48780,48450,48740,47970,48220,48400,-560,-380,67884,"1,642,798.09",105512
,20170220,48220,48400,48100,48620,47760,48520,48280,120,-120,60344,"1,456,832.44",100236
,20170221,48520,48280,48590,49100,48520,48690,48850,410,570,58410,"1,426,754.90",93596
,20170222,48690,48850,48690,48950,48300,48470,48630,-380,-220,50002,"1,215,851.13",91670
,20170223,48470,48630,48370,48750,48000,48220,48320,-410,-310,55498,"1,341,051.74",87624
,20170224,48220,48320,48420,48490,46950,47600,47460,-720,-860,70432,"1,671,664.90",79278
,20170227,47600,47460,47520,48100,47250,47530,47700,70,240,43412,"1,035,384.74",72698
,20170228,47530,47700,47670,47870,47250,47460,47640,-240,-60,38096,"907,514.53",64162
,20170301,47460,47640,47460,48530,47460,48420,48150,780,510,33492,"806,416.20",57580
,20170302,48420,48150,48580,48820,48120,48440,48430,290,280,20040,"485,288.75",56140
,20170303,48440,48430,48500,48500,47680,48050,47860,-380,-570,25030,"599,065.20",54480
,20170306,48050,47860,47940,48160,47520,47680,47900,-180,40,26440,"633,342.80",52750
,20170307,47680,47900,47500,47560,47240,47530,47430,-370,-470,27590,"654,407.40",48790
,20170308,47530,47430,47300,47350,46720,46910,46990,-520,-440,36180,"850,083.40",46170
,20170309,46910,46990,47020,47600,46120,46200,46480,-790,-510,32410,"753,298.55",41900
,20170310,46200,46480,45880,46400,45820,46300,46220,-180,-260,26260,"606,978.35",38130
,20170313,46300,46220,46350,47050,46160,47020,46690,800,470,21090,"492,357.60",30850
,20170314,47020,46690,47020,47070,46730,46850,46840,160,150,13390,"313,652.00",24930
,20170315,46850,46840,46680,47220,46350,47220,47020,380,180,8270,"194,466.10",21770
cu1704,20170103,45630,45570,45820,46430,45780,45900,46190,330,620,26376,"609,236.40",67036
,20170104,45900,46190,46040,46090,44950,45640,45460,-550,-730,36024,"818,967.04",69008
,20170105,45640,45460,45510,46270,45490,45900,45990,440,530,39368,"905,454.77",72474
,20170106,45900,45990,45870,45880,45230,45440,45530,-550,-460,31062,"707,237.89",71860
,20170109,45440,45530,45390,45870,45210,45840,45600,310,70,25526,"582,077.87",73188
,20170110,45840,45600,45670,46360,45500,46240,45930,640,330,38550,"885,386.12",75752
,20170111,46240,45930,46480,47370,46450,47270,47040,1340,1110,49742,"1,170,131.44",79152
,20170112,47270,47040,47100,47300,46880,47070,47100,30,60,41124,"968,521.68",80798
,20170113,47070,47100,47260,47910,47230,47510,47600,410,500,46614,"1,109,434.85",85268
,20170116,47510,47600,47550,48480,47350,48070,48010,470,410,46970,"1,127,531.50",88360
,20170117,48070,48010,48010,48150,46650,46880,47300,-1130,-710,53446,"1,264,231.09",91804
,20170118,46880,47300,46940,47150,46060,46710,46620,-590,-680,60138,"1,401,829.79",90588
,20170119,46710,46620,46630,46980,46410,46850,46730,230,110,41008,"958,167.56",92206
,20170120,46850,46730,46710,46820,46100,46150,46490,-580,-240,48660,"1,131,321.01",93808
,20170123,46150,46490,46380,47370,46250,46960,46890,470,400,52484,"1,230,592.50",102078
,20170124,46960,46890,46890,47320,46610,47200,47030,310,140,44760,"1,052,663.97",107104
,20170125,47200,47030,47570,47980,47500,47780,47750,750,720,52854,"1,261,943.34",114976
,20170126,47780,47750,47600,48280,47550,48070,47930,320,180,61178,"1,466,256.66",121024
,20170203,48070,47930,47790,47800,46650,46870,47060,-1060,-870,64984,"1,529,376.70",125860
,20170206,46870,47060,46940,47090,46420,46730,46740,-330,-320,79886,"1,867,061.98",136996
,20170207,46730,46740,46790,47190,46700,46990,46950,250,210,66358,"1,557,800.35",142738
,20170208,46990,46950,46910,47840,46700,47810,47360,860,410,117574,"2,784,449.23",156012
,20170209,47810,47360,47710,47950,47370,47590,47680,230,320,108768,"2,593,364.68",159288
,20170210,47590,47680,47620,48050,47120,47820,47570,140,-110,213852,"5,087,506.70",177982
,20170213,47820,47570,47800,50620,47780,50120,49550,2550,1980,616476,"15,275,068.92",245852
,20170214,50120,49550,49820,50250,49660,50110,49940,560,390,347374,"8,675,318.93",265978
,20170215,50110,49940,50090,50290,48290,48740,49120,-1200,-820,512812,"12,595,107.23",229176
,20170216,48740,49120,48740,49380,48510,48680,48970,-440,-150,376604,"9,221,226.16",228912
,20170217,48680,48970,48600,48960,48170,48360,48600,-610,-370,375026,"9,114,809.84",227192
,20170220,48360,48600,48280,48850,47950,48770,48420,170,-180,321866,"7,793,741.09",230668
,20170221,48770,48420,48870,49350,48750,48920,49050,500,630,295714,"7,252,748.54",227126
,20170222,48920,49050,48990,49210,48500,48660,48900,-390,-150,269764,"6,596,797.19",221726
,20170223,48660,48900,48530,48990,48160,48390,48570,-510,-330,287134,"6,974,140.58",218162
,20170224,48390,48570,48640,48700,47100,47760,47760,-810,-810,410140,"9,796,180.74",200836
,20170227,47760,47760,47700,48310,47400,47730,47870,-30,110,324820,"7,775,722.29",191912
,20170228,47730,47870,47910,48090,47440,47740,47830,-130,-40,282636,"6,760,547.40",188590
,20170301,47740,47830,47880,48800,47690,48650,48310,820,480,339392,"8,198,608.08",191314
,20170302,48650,48310,48780,49100,48330,48690,48710,380,400,261336,"6,365,943.56",189942
,20170303,48690,48710,48450,48470,47860,48280,48150,-430,-560,254492,"6,127,335.03",184934
,20170306,48280,48150,48130,48440,47710,47890,48150,-260,0,241164,"5,806,976.87",186286
,20170307,47890,48150,47750,47790,47380,47720,47640,-430,-510,184672,"4,399,133.32",182642
,20170308,47720,47640,47420,47620,46910,47140,47220,-500,-420,261772,"6,180,714.28",176410
,20170309,47140,47220,47220,47420,46310,46400,46830,-820,-390,238774,"5,591,147.99",165164
,20170310,46400,46830,46180,46670,45970,46550,46390,-280,-440,172770,"4,007,553.62",158204
,20170313,46550,46390,46620,47350,46360,47340,46850,950,460,153006,"3,584,748.35",153292
,20170314,47340,46850,47290,47380,46990,47160,47150,310,300,82132,"1,936,510.04",149770
,20170315,47160,47150,46970,47540,46610,47440,47240,290,90,89130,"2,105,258.58",147526
,20170316,47440,47240,47630,48000,47460,47920,47770,680,530,86682,"2,070,713.51",135280
,20170317,47920,47770,48010,48050,47450,47550,47690,-220,-80,56402,"1,345,059.15",131434
,20170320,47550,47690,47710,48030,47620,47680,47810,-10,120,61700,"1,475,147.55",124750
,20170321,47680,47810,47730,48130,46830,47100,47330,-710,-480,68442,"1,619,734.04",118670
,20170322,47100,47330,47060,47270,46250,46470,46580,-860,-750,70856,"1,650,254.29",115046
,20170323,46470,46580,46580,47160,46290,46950,46830,370,250,43920,"1,028,401.17",111146
,20170324,46950,46830,46950,47120,46540,46910,46820,80,-10,46278,"1,083,550.64",108272
,20170327,46910,46820,46770,47030,45970,46110,46230,-710,-590,58890,"1,361,532.51",106000
,20170328,46110,46230,45970,46830,45490,46580,46260,350,30,59642,"1,379,785.05",97382
,20170329,46580,46260,46650,47450,46490,47300,47140,1040,880,51788,"1,220,733.92",88362
,20170330,47300,47140,47300,47540,47000,47240,47220,100,80,44162,"1,042,705.57",79598
,20170331,47240,47220,47300,48110,47210,47540,47510,320,290,51162,"1,215,516.69",69706
,20170405,47540,47510,46830,47400,46830,47220,47150,-290,-360,25816,"608,639.12",64750
,20170406,47220,47150,47620,48030,47480,47620,47640,470,490,28290,"673,936.55",57290
,20170407,47620,47640,47740,47900,46770,46950,47400,-690,-240,33950,"804,723.75",53860
,20170410,46950,47400,46610,47350,46540,46890,46960,-510,-440,33840,"794,595.95",45090
,20170411,46890,46960,46890,46940,46450,46470,46610,-490,-350,33440,"779,443.50",39410
,20170412,46470,46610,46570,46790,46000,46040,46420,-570,-190,35910,"833,499.25",33150
,20170413,46040,46420,46020,46300,45500,46250,45870,-170,-550,23280,"533,943.10",24360
,20170414,46250,45870,45950,46200,45650,45900,45830,30,-40,10670,"244,545.20",20140
,20170417,45900,45830,46290,47100,45800,46890,46240,1060,410,8910,"206,024.90",18730
cu1705,20170103,45810,45720,46160,46580,45910,46010,46320,290,600,9446,"218,802.65",28730
,20170104,46010,46320,46040,46230,45110,45810,45610,-510,-710,15908,"362,792.22",29648
,20170105,45810,45610,45810,46400,45620,46050,46120,440,510,15212,"350,831.24",30310
,20170106,46050,46120,45990,46020,45360,45550,45670,-570,-450,14390,"328,625.95",30562
,20170109,45550,45670,45510,45980,45340,45960,45760,290,90,10136,"231,956.92",31042
,20170110,45960,45760,45770,46470,45610,46330,46050,570,290,15122,"348,187.01",31596
,20170111,46330,46050,46510,47490,46510,47450,47190,1400,1140,23148,"546,273.95",31644
,20170112,47450,47190,47170,47450,47050,47190,47240,0,50,19862,"469,154.49",33722
,20170113,47190,47240,47380,48050,47370,47620,47740,380,500,17078,"407,678.56",34282
,20170116,47620,47740,47520,48610,47490,48180,48220,440,480,21946,"529,124.64",37396
,20170117,48180,48220,48180,48270,46800,47020,47460,-1200,-760,23574,"559,463.48",39904
,20170118,47020,47460,47080,47290,46170,46800,46700,-660,-760,35506,"829,167.13",46020
,20170119,46800,46700,46620,47080,46490,46970,46860,270,160,18706,"438,286.75",49768
,20170120,46970,46860,46790,46920,46210,46300,46590,-560,-270,22424,"522,476.14",49754
,20170123,46300,46590,46390,47440,46340,47040,47010,450,420,22032,"517,934.57",51900
,20170124,47040,47010,47010,47390,46700,47280,47100,270,90,22536,"530,760.56",53588
,20170125,47280,47100,47780,48060,47530,47850,47850,750,750,30170,"721,861.57",57420
,20170126,47850,47850,47740,48360,47670,48130,48040,280,190,23838,"572,631.84",57938
,20170203,48130,48040,47950,47950,46780,47000,47120,-1040,-920,21298,"501,876.53",61138
,20170206,47000,47120,47030,47220,46580,46860,46870,-260,-250,24686,"578,583.74",65754
,20170207,46860,46870,46800,47300,46800,47100,47060,230,190,16712,"393,289.09",67772
,20170208,47100,47060,47060,47930,46840,47880,47480,820,420,31086,"738,115.63",70912
,20170209,47880,47480,47870,48050,47500,47720,47800,240,320,34948,"835,394.73",74720
,20170210,47720,47800,47810,48150,47280,47970,47720,170,-80,55402,"1,322,119.12",79590
,20170213,47970,47720,47970,50760,47940,50260,49700,2540,1980,125078,"3,108,367.20",96616
,20170214,50260,49700,49980,50350,49820,50220,50100,520,400,67190,"1,683,312.78",105018
,20170215,50220,50100,50230,50400,48500,48910,49300,-1190,-800,102828,"2,534,836.88",102186
,20170216,48910,49300,48910,49550,48690,48960,49140,-340,-160,89842,"2,207,502.46",109692
,20170217,48960,49140,48890,49120,48360,48550,48780,-590,-360,82658,"2,016,252.58",112542
,20170220,48550,48780,48490,49010,48130,48940,48600,160,-180,73576,"1,788,163.74",117344
,20170221,48940,48600,49070,49520,48920,49100,49200,500,600,92118,"2,266,447.05",122594
,20170222,49100,49200,49170,49380,48700,48840,49070,-360,-130,71136,"1,745,577.20",126192
,20170223,48840,49070,48740,49150,48360,48600,48750,-470,-320,71966,"1,754,492.03",129382
,20170224,48600,48750,48850,48880,47310,47950,47950,-800,-800,129564,"3,106,813.84",137294
,20170227,47950,47950,47900,48470,47600,47920,48080,-30,130,107564,"2,585,919.66",140718
,20170228,47920,48080,48120,48290,47650,47900,48020,-180,-60,100866,"2,421,852.01",149180
,20170301,47900,48020,48030,48970,47870,48830,48510,810,490,148992,"3,614,123.75",157224
,20170302,48830,48510,48940,49280,48520,48900,48910,390,400,108902,"2,663,409.40",165560
,20170303,48900,48910,48650,48690,48080,48480,48370,-430,-540,131508,"3,180,663.75",169114
,20170306,48480,48370,48350,48660,47930,48110,48360,-260,-10,138358,"3,345,992.65",177234
,20170307,48110,48360,47960,48000,47610,47930,47850,-430,-510,107360,"2,568,851.61",183720
,20170308,47930,47850,47610,47840,47100,47300,47410,-550,-440,196618,"4,661,227.31",183312
,20170309,47300,47410,47400,47590,46480,46570,46970,-840,-440,231422,"5,435,153.27",193698
,20170310,46570,46970,46300,46830,46140,46650,46560,-320,-410,207214,"4,824,186.42",199260
,20170313,46650,46560,46800,47560,46530,47560,47020,1000,460,328654,"7,727,690.78",202870
,20170314,47560,47020,47500,47580,47190,47360,47360,340,340,211346,"5,005,220.82",207094
,20170315,47360,47360,47150,47800,46820,47670,47440,310,80,307966,"7,306,245.91",215478
,20170316,47670,47440,47900,48250,47710,48160,47980,720,540,291370,"6,990,628.31",218718
,20170317,48160,47980,48270,48300,47660,47740,47940,-240,-40,220262,"5,280,464.43",217374
,20170320,47740,47940,47960,48280,47840,47980,48060,40,120,228262,"5,485,744.52",219224
,20170321,47980,48060,47980,48400,47030,47290,47660,-770,-400,347368,"8,279,118.50",220782
,20170322,47290,47660,47150,47500,46420,46660,46880,-1000,-780,321040,"7,525,209.37",225738
,20170323,46660,46880,46730,47340,46450,47120,46960,240,80,248072,"5,825,506.65",221334
,20170324,47120,46960,47120,47330,46710,47100,47010,140,50,259020,"6,089,477.65",220374
,20170327,47100,47010,47040,47240,46050,46260,46540,-750,-470,331254,"7,709,382.40",228898
,20170328,46260,46540,46100,47020,45600,46740,46330,200,-210,401114,"9,293,431.17",213026
,20170329,46740,46330,46860,47690,46670,47530,47260,1200,930,318226,"7,520,579.68",211298
,20170330,47530,47260,47500,47810,47200,47460,47480,200,220,263782,"6,263,221.01",203454
,20170331,47460,47480,47510,48390,47440,47750,47830,270,350,393114,"9,403,129.21",194190
,20170405,47750,47830,47090,47650,46980,47420,47320,-410,-510,148642,"3,517,410.87",189136
,20170406,47420,47320,47810,48300,47680,47810,47940,490,620,247964,"5,943,744.91",191346
,20170407,47810,47940,47900,48160,46930,47130,47640,-810,-300,318632,"7,591,022.80",187952
,20170410,47130,47640,46820,47570,46650,47050,47130,-590,-510,223444,"5,266,553.28",181914
,20170411,47050,47130,47020,47090,46520,46580,46750,-550,-380,195250,"4,564,703.85",180958
,20170412,46580,46750,46730,46980,46080,46150,46550,-600,-200,180800,"4,208,170.50",169452
,20170413,46150,46550,46020,46440,45480,46370,45950,-180,-600,171994,"3,952,087.15",157974
,20170414,46370,45950,46060,46400,45730,46050,46020,100,70,84868,"1,953,114.66",156934
,20170417,46050,46020,46090,47540,45870,46380,46520,360,500,101086,"2,351,457.87",149334
,20170418,46380,46520,46560,46830,45700,45780,46170,-740,-350,90332,"2,085,682.48",141886
,20170419,45780,46170,45780,46020,45100,45770,45630,-400,-540,94746,"2,161,791.93",131568
,20170420,45770,45630,45720,46050,44800,45550,45380,-80,-250,88530,"2,008,871.44",126128
,20170421,45550,45380,45680,46030,45410,45980,45730,600,350,62400,"1,427,072.14",117272
,20170424,45980,45730,45820,45980,45420,45870,45740,140,10,60654,"1,387,389.63",110062
,20170425,45870,45740,45770,46240,45510,45980,45900,240,160,53440,"1,226,551.85",101814
,20170426,45980,45900,46130,46350,45840,46160,46180,260,280,49388,"1,140,479.12",89738
,20170427,46160,46180,46250,46400,46080,46200,46200,20,20,41090,"949,321.29",82016
,20170428,46200,46200,46300,46360,45790,46310,46190,110,-10,43678,"1,008,908.82",72092
,20170502,46310,46190,46860,46950,46620,46680,46760,490,570,31622,"739,346.46",63500
,20170503,46680,46760,46790,46830,46430,46500,46540,-260,-220,24670,"574,187.95",57330
,20170504,46500,46540,45800,45920,45000,45160,45460,-1380,-1080,48170,"1,094,947.50",49670
,20170505,45160,45460,44990,45230,44680,44980,45070,-480,-390,31160,"702,252.35",44290
,20170508,44980,45070,45000,45460,44650,44650,44910,-420,-160,31010,"696,465.55",37980
,20170509,44650,44910,44570,44830,44480,44730,44690,-180,-220,25700,"574,326.65",32240
,20170510,44730,44690,44850,45100,44650,44790,44840,100,150,22650,"507,923.65",24550
,20170511,44790,44840,45410,45410,44650,45150,44880,310,40,17550,"393,903.25",16740
,20170512,45150,44880,45380,45380,44810,44860,44930,-20,50,11140,"250,282.45",10970
,20170515,44860,44930,45050,45360,44900,45280,45170,350,240,7740,"174,816.95",7270
cu1706,20170103,45930,45880,46220,46700,46100,46160,46470,280,590,2054,"47,732.99",8690
,20170104,46160,46470,46190,46360,45250,45960,45850,-510,-620,3028,"69,430.28",9232
,20170105,45960,45850,45960,46520,45790,46150,46230,300,380,2812,"65,007.26",9738
,20170106,46150,46230,46120,46120,45490,45650,45760,-580,-470,3714,"84,986.42",10716
,20170109,45650,45760,45580,46080,45450,46060,45870,300,110,1380,"31,651.85",10798
,20170110,46060,45870,45900,46550,45700,46420,46130,550,260,2518,"58,088.17",11774
,20170111,46420,46130,46520,47520,46520,47510,47280,1380,1150,3626,"85,735.69",12780
,20170112,47510,47280,47350,47540,47120,47340,47310,60,30,1796,"42,492.85",12968
,20170113,47340,47310,47440,48150,47440,47730,47870,420,560,1942,"46,483.13",12806
,20170116,47730,47870,47730,48730,47630,48280,48420,410,550,2160,"52,303.32",13176
,20170117,48280,48420,48280,48360,46940,47120,47710,-1300,-710,2694,"64,275.49",13040
,20170118,47120,47710,47310,47350,46260,46860,46690,-850,-1020,8092,"188,931.50",13534
,20170119,46860,46690,46790,47170,46600,47030,47010,340,320,2126,"49,975.22",13746
,20170120,47030,47010,46860,47000,46290,46340,46600,-670,-410,4108,"95,736.83",13826
,20170123,46340,46600,46600,47510,46450,47070,47160,470,560,4158,"98,050.74",14814
,20170124,47070,47160,46990,47450,46780,47340,47160,180,0,2016,"47,537.58",15034
,20170125,47340,47160,47750,48150,47700,47890,47920,730,760,6446,"154,455.79",16388
,20170126,47890,47920,47790,48430,47760,48180,48060,260,140,3072,"73,827.71",16360
,20170203,48180,48060,47870,47870,46880,47140,47240,-920,-820,3630,"85,741.80",16486
,20170206,47140,47240,47170,47290,46680,46970,46970,-270,-270,3996,"93,857.20",16878
,20170207,46970,46970,47000,47390,46920,47180,47170,210,200,1768,"41,702.98",16926
,20170208,47180,47170,47130,48030,46900,48010,47690,840,520,6006,"143,239.40",18520
,20170209,48010,47690,47930,48120,47630,47830,47900,140,210,3846,"92,127.57",19204
,20170210,47830,47900,47870,48270,47350,48110,47900,210,0,8732,"209,155.91",20498
,20170213,48110,47900,48020,50920,48020,50460,49800,2560,1900,25792,"642,253.99",25382
,20170214,50460,49800,50250,50500,49980,50330,50260,530,460,15082,"379,057.57",25918
,20170215,50330,50260,50340,50500,48620,49080,49430,-1180,-830,16980,"419,685.93",27706
,20170216,49080,49430,49080,49670,48850,49090,49220,-340,-210,13192,"324,693.03",30102
,20170217,49090,49220,49040,49260,48540,48680,48920,-540,-300,11636,"284,650.58",30532
,20170220,48680,48920,48630,49150,48300,49080,48790,160,-130,10662,"260,113.31",31660
,20170221,49080,48790,49120,49650,49060,49260,49370,470,580,13940,"344,163.98",33766
,20170222,49260,49370,49260,49520,48860,49010,49180,-360,-190,11080,"272,495.03",35648
,20170223,49010,49180,48930,49300,48540,48740,48880,-440,-300,13272,"324,387.81",36530
,20170224,48740,48880,48820,49030,47500,48110,48050,-770,-830,27972,"672,080.51",40652
,20170227,48110,48050,47980,48630,47780,48100,48230,50,180,13898,"335,170.80",42024
,20170228,48100,48230,48220,48440,47820,48050,48170,-180,-60,14904,"358,990.98",43270
,20170301,48050,48170,48200,49120,48030,49000,48710,830,540,28920,"704,348.85",45286
,20170302,49000,48710,49230,49430,48700,49060,49070,350,360,19426,"476,622.86",46704
,20170303,49060,49070,48880,48880,48240,48640,48520,-430,-550,25970,"630,102.69",47826
,20170306,48640,48520,48540,48820,48100,48270,48540,-250,20,27388,"664,752.93",50742
,20170307,48270,48540,48150,48170,47800,48110,48030,-430,-510,22270,"534,849.15",51742
,20170308,48110,48030,47860,48000,47270,47460,47570,-570,-460,39354,"936,058.51",55072
,20170309,47460,47570,47560,47750,46620,46710,47040,-860,-530,42690,"1,004,230.21",59734
,20170310,46710,47040,46500,46970,46300,46790,46730,-250,-310,43472,"1,015,731.88",61790
,20170313,46790,46730,46910,47670,46660,47650,47180,920,450,50874,"1,200,143.97",67304
,20170314,47650,47180,47610,47710,47330,47510,47500,330,320,29872,"709,565.91",70320
,20170315,47510,47500,47400,47910,46980,47820,47580,320,80,32568,"774,906.67",72290
,20170316,47820,47580,47930,48400,47890,48310,48160,730,580,46252,"1,113,793.22",75758
,20170317,48310,48160,48360,48460,47820,47930,48090,-230,-70,32602,"783,921.22",77512
,20170320,47930,48090,48060,48430,48020,48130,48220,40,130,38266,"922,652.89",80280
,20170321,48130,48220,48130,48550,47200,47440,47760,-780,-460,60682,"1,449,182.60",78910
,20170322,47440,47760,47280,47650,46560,46810,46990,-950,-770,73688,"1,731,623.59",87982
,20170323,46810,46990,46870,47480,46630,47270,47110,280,120,62394,"1,469,757.90",95168
,20170324,47270,47110,47270,47470,46870,47250,47170,140,60,64620,"1,524,174.76",96844
,20170327,47250,47170,47170,47380,46250,46430,46620,-740,-550,96718,"2,254,708.91",104070
,20170328,46430,46620,46300,47170,45770,46870,46520,250,-100,131278,"3,053,720.28",113154
,20170329,46870,46520,46980,47820,46840,47700,47440,1180,920,114098,"2,706,557.97",120348
,20170330,47700,47440,47640,47970,47370,47590,47610,150,170,91012,"2,166,788.16",126934
,20170331,47590,47610,47630,48550,47590,47930,48000,320,390,155576,"3,733,961.00",135094
,20170405,47930,48000,47240,47820,47170,47600,47500,-400,-500,89788,"2,132,669.63",139554
,20170406,47600,47500,47990,48490,47850,47980,48120,480,620,160926,"3,872,250.77",153446
,20170407,47980,48120,48050,48400,47090,47310,47790,-810,-330,269472,"6,440,070.86",168138
,20170410,47310,47790,46970,47700,46820,47180,47290,-610,-500,204850,"4,844,378.19",174068
,20170411,47180,47290,47170,47240,46650,46670,46860,-620,-430,251984,"5,904,282.16",196172
,20170412,46670,46860,46800,47090,46150,46230,46630,-630,-230,447660,"10,437,802.45",225448
,20170413,46230,46630,46070,46550,45520,46480,46040,-150,-590,511384,"11,774,069.93",229730
,20170414,46480,46040,46150,46520,45800,46110,46160,70,120,315686,"7,286,432.37",238902
,20170417,46110,46160,46150,47940,45960,46480,46610,320,450,450362,"10,497,698.57",229598
,20170418,46480,46610,46690,46920,45740,45850,46290,-760,-320,356194,"8,245,172.60",259004
,20170419,45850,46290,45850,46100,45110,45840,45630,-450,-660,501250,"11,436,472.07",256132
,20170420,45840,45630,45760,46140,44800,45560,45430,-70,-200,596204,"13,543,754.40",253888
,20170421,45560,45430,45750,46120,45460,46030,45770,600,340,391290,"8,956,280.19",248048
,20170424,46030,45770,45840,46060,45480,45910,45760,140,-10,352930,"8,076,255.93",236896
,20170425,45910,45760,45780,46360,45570,46030,45880,270,120,329762,"7,566,077.29",226570
,20170426,46030,45880,46220,46450,45880,46230,46230,350,350,262080,"6,058,002.85",218586
,20170427,46230,46230,46340,46510,46170,46290,46310,60,80,219242,"5,076,704.84",214012
,20170428,46290,46310,46330,46470,45840,46330,46230,20,-80,313460,"7,246,706.43",196602
,20170502,46330,46230,46950,47100,46690,46790,46870,560,640,141624,"3,319,572.81",186738
,20170503,46790,46870,46860,46940,46480,46580,46690,-290,-180,130726,"3,052,357.46",185484
,20170504,46580,46690,45870,45970,45010,45180,45550,-1510,-1140,309126,"7,040,537.57",182530
,20170505,45180,45550,45000,45280,44680,44980,45010,-570,-540,244258,"5,497,767.93",187830
,20170508,44980,45010,45000,45550,44650,44670,45080,-340,70,267810,"6,037,076.78",183304
,20170509,44670,45080,44640,44900,44420,44730,44690,-350,-390,168452,"3,764,744.60",174198
,20170510,44730,44690,44830,45200,44710,44820,44930,130,240,115818,"2,602,083.50",167234
,20170511,44820,44930,44980,45270,44630,45230,44910,300,-20,121998,"2,740,064.82",161000
,20170512,45230,44910,45520,45520,44830,44910,45020,0,110,92084,"2,073,009.21",158228
,20170515,44910,45020,45030,45490,44880,45430,45210,410,190,76212,"1,723,084.71",152632
,20170516,45430,45210,45530,45530,45010,45150,45230,-60,20,65736,"1,486,737.58",142826
,20170517,45150,45230,45260,45590,45240,45360,45370,130,140,66148,"1,500,641.92",132426
,20170518,45360,45370,45230,45450,44910,44920,45050,-450,-320,60920,"1,372,479.55",129196
,20170519,44920,45050,44630,45370,44570,45280,45160,230,110,67874,"1,532,617.69",119304
,20170522,45280,45160,45520,45970,45440,45780,45760,620,600,76852,"1,758,727.07",105662
,20170523,45780,45760,45910,46050,45720,45720,45880,-40,120,59264,"1,359,665.15",96752
,20170524,45720,45880,45850,46080,45490,45730,45790,-150,-90,58294,"1,334,851.87",88560
,20170525,45730,45790,45730,46000,45680,45950,45870,160,80,49298,"1,130,868.74",78068
,20170526,45950,45870,45890,46260,45810,45940,45920,70,50,43490,"998,643.71",68532
,20170531,45940,45920,45510,45770,45150,45180,45500,-740,-420,42784,"973,473.95",58186
,20170601,45180,45500,45300,45460,45060,45300,45250,-200,-250,30456,"689,180.62",51730
,20170602,45300,45250,45320,45500,45220,45320,45280,70,30,21850,"494,752.65",48330
,20170605,45320,45280,44900,45800,44840,45200,45200,-80,-80,24970,"564,328.30",45280
,20170606,45200,45200,45150,45250,44860,44860,45070,-340,-130,27580,"621,522.05",40030
,20170607,44860,45070,44830,45190,44670,44850,44970,-220,-100,26260,"590,523.05",35740
,20170608,44850,44970,44900,45240,44800,45130,44990,160,20,25190,"566,722.70",31790
,20170609,45130,44990,45370,45850,45360,45850,45630,860,640,29400,"670,837.50",23460
,20170612,45850,45630,46010,46330,45960,46150,46150,520,520,23460,"541,391.20",15570
,20170613,46150,46150,46060,46100,45700,45710,45890,-440,-260,17160,"393,791.10",10090
,20170614,45710,45890,45720,45850,45510,45760,45600,-130,-290,12250,"279,332.60",6020
,20170615,45760,45600,45560,45580,45250,45310,45360,-290,-240,4960,"112,507.55",4700
cu1707,20170103,46130,46070,46390,46900,46340,46340,46730,270,660,594,"13,879.00",2532
,20170104,46340,46730,46380,46520,45450,46140,46040,-590,-690,1050,"24,171.10",3174
,20170105,46140,46040,46030,46620,45990,46490,46440,450,400,158,"3,669.44",3198
,20170106,46490,46440,46060,46200,45720,45800,45930,-640,-510,364,"8,360.57",3268
,20170109,45800,45930,45830,46190,45600,46190,46010,260,80,354,"8,144.48",3400
,20170110,46190,46010,45940,46640,45800,46550,46210,540,200,670,"15,482.34",3724
,20170111,46550,46210,46860,47600,46860,47590,47350,1380,1140,758,"17,948.76",3788
,20170112,47590,47350,47400,47600,47340,47370,47420,20,70,246,"5,833.51",3828
,20170113,47370,47420,47750,48270,47620,47850,47980,430,560,342,"8,205.72",3840
,20170116,47850,47980,47820,48750,47680,48420,48450,440,470,100,"2,422.58",3816
,20170117,48420,48450,48310,48340,47090,47230,47560,-1220,-890,262,"6,231.22",3844
,20170118,47230,47560,47340,47450,46310,46990,46840,-570,-720,5050,"118,279.19",4940
,20170119,46990,46840,46810,47220,46680,47070,47030,230,190,1200,"28,218.82",5190
,20170120,47070,47030,46960,46960,46330,46400,46760,-630,-270,676,"15,807.10",5160
,20170123,46400,46760,46640,47520,46480,47130,47140,370,380,566,"13,343.33",5250
,20170124,47130,47140,47030,47470,46840,47440,47330,300,190,2618,"61,955.13",7416
,20170125,47440,47330,47830,48290,47820,47970,48040,640,710,1742,"41,849.58",7506
,20170126,47970,48040,47920,48500,47870,48480,48000,440,-40,734,"17,616.06",7756
,20170203,48480,48000,47810,47810,46990,47210,47270,-790,-730,332,"7,847.47",7880
,20170206,47210,47270,47200,47360,46790,47010,47060,-260,-210,956,"22,497.67",8270
,20170207,47010,47060,47210,47450,47090,47400,47320,340,260,166,"3,927.73",8254
,20170208,47400,47320,47080,48070,47040,48060,47700,740,380,1034,"24,660.93",8182
,20170209,48060,47700,48000,48220,47810,47940,48040,240,340,718,"17,247.47",8340
,20170210,47940,48040,48020,48370,47550,48150,48010,110,-30,1682,"40,376.70",8576
,20170213,48150,48010,48260,51110,48250,50560,49940,2550,1930,8002,"199,818.95",10982
,20170214,50560,49940,50330,50620,50120,50510,50430,570,490,2408,"60,720.85",11414
,20170215,50510,50430,50480,50590,48800,49210,49710,-1220,-720,2248,"55,878.90",11596
,20170216,49210,49710,49190,49760,49000,49200,49470,-510,-240,910,"22,509.15",11726
,20170217,49200,49470,49090,49380,48670,48860,49070,-610,-400,1422,"34,888.88",11990
,20170220,48860,49070,48860,49290,48480,49290,48940,220,-130,1254,"30,686.89",12202
,20170221,49290,48940,49350,49770,49210,49370,49490,430,550,1454,"35,984.60",12138
,20170222,49370,49490,49260,49620,48980,49150,49270,-340,-220,1672,"41,191.44",12558
,20170223,49150,49270,48960,49450,48680,48860,48990,-410,-280,1342,"32,872.79",13072
,20170224,48860,48990,49140,49140,47670,48270,48070,-720,-920,2482,"59,663.47",13596
,20170227,48270,48070,48240,48760,47930,48200,48300,130,230,1758,"42,456.99",14112
,20170228,48200,48300,48450,48580,48050,48150,48340,-150,40,1528,"36,935.89",14562
,20170301,48150,48340,48330,49260,48180,49140,48900,800,560,1714,"41,915.46",15128
,20170302,49140,48900,49300,49580,48840,49200,49190,300,290,1142,"28,087.81",15436
,20170303,49200,49190,48880,48960,48400,48800,48660,-390,-530,1648,"40,096.72",15846
,20170306,48800,48660,48680,48930,48280,48480,48600,-180,-60,1886,"45,831.71",16260
,20170307,48480,48600,48330,48330,47960,48210,48180,-390,-420,1512,"36,429.48",16378
,20170308,48210,48180,47950,48120,47460,47600,47720,-580,-460,4340,"103,558.55",16974
,20170309,47600,47720,47710,47870,46790,46830,47180,-890,-540,4718,"111,313.15",18026
,20170310,46830,47180,46580,47070,46440,46920,46840,-260,-340,3810,"89,237.28",18946
,20170313,46920,46840,47010,47790,46790,47790,47390,950,550,2584,"61,233.88",19240
,20170314,47790,47390,47730,47820,47490,47630,47630,240,240,1760,"41,921.95",19716
,20170315,47630,47630,47410,48040,47120,47980,47820,350,190,3768,"90,103.03",19896
,20170316,47980,47820,48110,48560,48010,48460,48310,640,490,3972,"95,945.54",20118
,20170317,48460,48310,48570,48570,47970,48020,48220,-290,-90,3286,"79,232.95",20804
,20170320,48020,48220,48120,48560,48120,48240,48320,20,100,4210,"101,725.98",21522
,20170321,48240,48320,48290,48690,47360,47600,47790,-720,-530,6666,"159,311.40",22920
,20170322,47600,47790,47570,47750,46720,46960,47070,-830,-720,11310,"266,224.54",26138
,20170323,46960,47070,46960,47620,46770,47400,47240,330,170,7050,"166,541.85",26520
,20170324,47400,47240,47460,47610,47030,47410,47350,170,110,9954,"235,705.82",28792
,20170327,47410,47350,47410,47530,46420,46550,46740,-800,-610,18422,"430,541.17",31880
,20170328,46550,46740,46450,47310,45940,47030,46610,290,-130,16618,"387,352.97",33532
,20170329,47030,46610,47120,47930,46980,47840,47610,1230,1000,15576,"370,831.63",35102
,20170330,47840,47610,47860,48110,47510,47750,47770,140,160,12538,"299,480.29",37592
,20170331,47750,47770,47800,48690,47730,48040,48080,270,310,22052,"530,137.24",39876
,20170405,48040,48080,47020,47950,47020,47720,47650,-360,-430,18614,"443,512.69",43356
,20170406,47720,47650,48080,48630,48000,48130,48240,480,590,25098,"605,405.99",46588
,20170407,48130,48240,48190,48480,47220,47420,47900,-820,-340,41024,"982,614.41",51924
,20170410,47420,47900,46990,47850,46980,47320,47420,-580,-480,37314,"884,742.95",56532
,20170411,47320,47420,47300,47360,46780,46800,46990,-620,-430,39646,"931,564.94",59684
,20170412,46800,46990,46950,47210,46300,46360,46720,-630,-270,54110,"1,264,230.48",62104
,20170413,46360,46720,46300,46680,45650,46600,46210,-120,-510,69050,"1,595,474.82",66716
,20170414,46600,46210,46380,46640,45960,46230,46260,20,50,40596,"939,122.91",70278
,20170417,46230,46260,46300,47780,46100,46600,46730,340,470,69660,"1,627,749.71",70976
,20170418,46600,46730,46750,47010,45860,45960,46360,-770,-370,55444,"1,285,344.96",80002
,20170419,45960,46360,45920,46180,45200,45910,45750,-450,-610,86176,"1,971,318.60",90162
,20170420,45910,45750,45850,46200,44860,45600,45450,-150,-300,102750,"2,335,339.12",92914
,20170421,45600,45450,45750,46160,45540,46080,45850,630,400,81842,"1,876,482.15",97668
,20170424,46080,45850,45910,46080,45520,45950,45820,100,-30,90504,"2,073,745.83",107910
,20170425,45950,45820,45810,46380,45610,46080,45970,260,150,92054,"2,115,908.90",113716
,20170426,46080,45970,46250,46550,45950,46320,46320,350,350,91370,"2,116,140.06",125166
,20170427,46320,46320,46400,46590,46260,46370,46390,50,70,73708,"1,709,790.66",126396
,20170428,46370,46390,46390,46510,45920,46360,46320,-30,-70,126548,"2,931,001.03",144398
,20170502,46360,46320,47000,47120,46740,46850,46910,530,590,74258,"1,741,816.45",150806
,20170503,46850,46910,46910,46990,46550,46630,46740,-280,-170,60298,"1,409,227.91",154124
,20170504,46630,46740,45950,46040,45040,45230,45580,-1510,-1160,190070,"4,332,119.72",165906
,20170505,45230,45580,45080,45310,44730,45000,45050,-580,-530,171390,"3,861,239.54",181902
,20170508,45000,45050,45010,45570,44650,44700,45050,-350,0,226734,"5,108,030.21",195984
,20170509,44700,45050,44620,44890,44420,44730,44700,-320,-350,179390,"4,009,518.17",195048
,20170510,44730,44700,44840,45240,44730,44860,44950,160,250,184178,"4,140,248.36",197138
,20170511,44860,44950,44980,45330,44660,45270,44940,320,-10,259366,"5,828,883.21",200902
,20170512,45270,44940,45510,45580,44830,44930,45030,-10,90,265148,"5,970,632.41",216568
,20170515,44930,45030,45080,45560,44900,45430,45200,400,170,204988,"4,632,741.14",214120
,20170516,45430,45200,45540,45570,45030,45170,45290,-30,90,196142,"4,442,279.93",220114
,20170517,45170,45290,45290,45650,45270,45390,45410,100,120,226698,"5,148,264.91",211564
,20170518,45390,45410,45240,45480,44920,44960,45130,-450,-280,251502,"5,675,511.87",224554
,20170519,44960,45130,44650,45400,44610,45300,45130,170,0,279650,"6,311,671.33",215514
,20170522,45300,45130,45570,46030,45470,45800,45810,670,680,316766,"7,256,174.75",204386
,20170523,45800,45810,45980,46130,45760,45770,45950,-40,140,199768,"4,589,854.72",205984
,20170524,45770,45950,45920,46160,45510,45780,45860,-170,-90,231488,"5,308,841.07",201670
,20170525,45780,45860,45900,46070,45730,45970,45910,110,50,202522,"4,649,627.42",199120
,20170526,45970,45910,45910,46350,45850,46000,46050,90,140,269820,"6,213,735.23",191230
,20170531,46000,46050,45690,45850,45170,45230,45540,-820,-510,211210,"4,810,035.71",174426
,20170601,45230,45540,45330,45540,45080,45340,45310,-200,-230,186044,"4,215,149.10",159794
,20170602,45340,45310,45450,45580,45250,45330,45380,20,70,145734,"3,307,408.35",157424
,20170605,45330,45380,44920,45460,44860,45240,45230,-140,-150,157696,"3,566,510.03",153784
,20170606,45240,45230,45150,45310,44880,44880,45130,-350,-100,117788,"2,658,084.70",153572
,20170607,44880,45130,44800,45250,44670,44850,45000,-280,-130,128200,"2,884,865.22",148722
,20170608,44850,45000,44930,45300,44820,45210,45030,210,30,87518,"1,970,889.68",141190
,20170609,45210,45030,45470,45930,45440,45900,45690,870,660,114570,"2,617,839.34",134402
,20170612,45900,45690,46160,46500,46040,46260,46250,570,560,86914,"2,010,191.76",128332
,20170613,46260,46250,46220,46240,45750,45760,45970,-490,-280,68968,"1,585,483.63",125568
,20170614,45760,45970,45550,45940,45550,45920,45740,-50,-230,71258,"1,629,779.24",123158
,20170615,45920,45740,45780,45850,45320,45550,45580,-190,-160,81210,"1,850,851.16",117238
,20170616,45550,45580,45480,45710,45310,45440,45530,-140,-50,57390,"1,306,614.62",112970
,20170619,45440,45530,45510,45670,45360,45570,45510,40,-20,52226,"1,188,461.96",105890
,20170620,45570,45510,45720,45990,45660,45760,45790,250,280,47722,"1,092,706.65",100080
,20170621,45760,45790,45520,45570,45300,45460,45420,-330,-370,49536,"1,125,169.95",99316
,20170622,45460,45420,45780,46150,45670,45720,45900,300,480,46970,"1,077,995.84",92810
,20170623,45720,45900,45960,46610,45820,46560,46090,660,190,46484,"1,071,256.63",87002
,20170626,46560,46090,46480,46720,46250,46680,46420,590,330,40488,"939,846.05",83000
,20170627,46680,46420,46590,46640,46340,46640,46460,220,40,39424,"915,850.63",76906
,20170628,46640,46460,46610,46890,46520,46830,46700,370,240,42124,"983,623.02",70546
,20170629,46830,46700,46720,47390,46680,47300,47170,600,470,45476,"1,072,699.68",66710
,20170630,47300,47170,47300,47520,47110,47380,47280,210,110,35942,"849,706.41",58650
,20170703,47380,47280,47300,47410,47150,47380,47250,100,-30,23940,"565,603.75",54010
,20170704,47380,47250,47250,47280,46750,46840,46940,-410,-310,30040,"705,144.40",50620
,20170705,46840,46940,46900,47120,46900,46950,47010,10,70,23350,"548,882.85",46560
,20170706,46950,47010,46780,46810,46500,46780,46680,-230,-330,22690,"529,598.40",40500
,20170707,46780,46680,46720,46950,46650,46950,46720,270,40,17180,"401,354.10",35860
,20170710,46950,46720,46720,46840,46570,46580,46690,-140,-30,26690,"623,144.60",28560
,20170711,46580,46690,46450,46940,46400,46830,46640,140,-50,24130,"562,816.70",23070
,20170712,46830,46640,46700,47200,46700,47020,47060,380,420,24310,"572,034.55",16950
,20170713,47020,47060,47120,47210,46890,47110,46980,50,-80,17180,"403,639.85",11350
,20170714,47110,46980,47040,47050,46760,46890,46850,-90,-130,9650,"226,079.25",5300
,20170717,46890,46850,47010,49660,46950,47560,47330,710,480,3340,"79,049.30",3710
cu1708,20170103,46300,46230,46600,47120,46600,46650,46980,420,750,290,"6,812.46",1860
,20170104,46650,46980,46650,46780,45680,46350,46220,-630,-760,492,"11,371.17",2030
,20170105,46350,46220,46200,46830,46200,46590,46580,370,360,690,"16,070.73",2376
,20170106,46590,46580,46220,46390,45870,45990,46110,-590,-470,320,"7,377.99",2520
,20170109,45990,46110,46010,46300,45740,46270,46180,160,70,574,"13,255.31",2986
,20170110,46270,46180,45960,46730,45960,46730,46390,550,210,312,"7,237.01",3154
,20170111,46730,46390,47000,47760,46980,47590,47470,1200,1080,1440,"34,180.92",3546
,20170112,47590,47470,47470,47780,47450,47590,47590,120,120,298,"7,091.09",3566
,20170113,47590,47590,47860,48450,47860,47920,48200,330,610,210,"5,061.53",3600
,20170116,47920,48200,47950,48900,47950,48560,48610,360,410,96,"2,333.32",3628
,20170117,48560,48610,48360,48360,47260,47310,47530,-1300,-1080,130,"3,089.66",3626
,20170118,47310,47530,47460,47480,46170,47060,46850,-470,-680,3920,"91,835.11",3894
,20170119,47060,46850,46860,47260,46750,47110,47050,260,200,126,"2,964.68",3854
,20170120,47110,47050,46850,47190,46380,46420,46740,-630,-310,230,"5,375.90",3724
,20170123,46420,46740,46590,47500,46500,47070,47240,330,500,666,"15,731.54",3940
,20170124,47070,47240,46910,47430,46820,47430,47310,190,70,904,"21,387.38",4404
,20170125,47430,47310,47750,48420,47750,48080,48180,770,870,4072,"98,098.21",6386
,20170126,48080,48180,48040,48600,48000,48490,48140,310,-40,384,"9,243.11",6384
,20170203,48490,48140,47600,47760,47100,47210,47380,-930,-760,66,"1,563.86",6388
,20170206,47210,47380,47360,47400,46840,47170,47190,-210,-190,124,"2,925.79",6418
,20170207,47170,47190,47400,47550,47290,47470,47470,280,280,44,"1,044.47",6404
,20170208,47470,47470,47120,48200,47120,48050,47980,580,510,198,"4,750.39",6422
,20170209,48050,47980,48130,48270,48000,48010,48130,30,150,86,"2,069.62",6448
,20170210,48010,48130,47770,48510,47770,48360,48140,230,10,1466,"35,292.03",6978
,20170213,48360,48140,48740,51350,48700,50700,50090,2560,1950,5450,"136,519.96",8880
,20170214,50700,50090,50520,50800,50330,50510,50550,420,460,1724,"43,581.03",9246
,20170215,50510,50550,50580,50660,48950,49340,49810,-1210,-740,1014,"25,253.75",9444
,20170216,49340,49810,49320,49870,49110,49260,49570,-550,-240,506,"12,542.30",9604
,20170217,49260,49570,49230,49440,48920,49000,49220,-570,-350,360,"8,860.48",9654
,20170220,49000,49220,48850,49360,48590,49250,49040,30,-180,570,"13,977.26",9584
,20170221,49250,49040,49440,49840,49310,49440,49630,400,590,1280,"31,768.55",10490
,20170222,49440,49630,49550,49710,49080,49230,49470,-400,-160,1190,"29,438.04",11070
,20170223,49230,49470,49040,49450,48800,48940,49130,-530,-340,328,"8,057.90",11188
,20170224,48940,49130,49210,49210,47820,48450,48260,-680,-870,1264,"30,501.68",11430
,20170227,48450,48260,48360,48790,48040,48340,48510,80,250,588,"14,263.21",11682
,20170228,48340,48510,48610,48610,48180,48260,48420,-250,-90,1794,"43,441.53",12790
,20170301,48260,48420,48470,49360,48270,49210,48680,790,260,1282,"31,205.76",12842
,20170302,49210,48680,49410,49620,48990,49270,49280,590,600,292,"7,195.18",12944
,20170303,49270,49280,49000,49050,48520,48910,48700,-370,-580,1366,"33,267.24",13732
,20170306,48910,48700,48810,49060,48400,48540,48720,-160,20,1094,"26,654.23",14274
,20170307,48540,48720,48390,48400,48080,48330,48280,-390,-440,888,"21,439.20",14806
,20170308,48330,48280,48130,48210,47570,47730,47860,-550,-420,1648,"39,439.21",14644
,20170309,47730,47860,47880,47970,46870,46880,47250,-980,-610,4554,"107,591.55",16854
,20170310,46880,47250,46670,47170,46500,47020,46930,-230,-320,4412,"103,530.01",18632
,20170313,47020,46930,47140,47880,46880,47830,47510,900,580,2534,"60,204.82",19164
,20170314,47830,47510,47780,47900,47580,47710,47750,200,240,924,"22,064.57",19012
,20170315,47710,47750,47520,48160,47250,48100,47900,350,150,1750,"41,915.67",18662
,20170316,48100,47900,47930,48640,47930,48520,48420,620,520,2040,"49,391.22",19318
,20170317,48520,48420,48660,48660,48080,48150,48320,-270,-100,794,"19,183.42",19338
,20170320,48150,48320,48410,48660,48300,48400,48480,80,160,1766,"42,815.18",19750
,20170321,48400,48480,48370,48770,47460,47680,47930,-800,-550,2648,"63,464.81",20266
,20170322,47680,47930,47680,47900,46830,47060,47140,-870,-790,2746,"64,724.21",20522
,20170323,47060,47140,47100,47740,46940,47570,47530,430,390,2008,"47,724.33",20838
,20170324,47570,47530,47580,47740,47170,47540,47450,10,-80,1440,"34,168.84",21060
,20170327,47540,47450,47340,47600,46560,46710,46820,-740,-630,3192,"74,734.89",21364
,20170328,46710,46820,46530,47420,46070,47150,46900,330,80,3548,"83,218.06",22578
,20170329,47150,46900,47320,48040,47080,47920,47620,1020,720,3142,"74,812.29",23888
,20170330,47920,47620,47920,48240,47640,47840,47880,220,260,1588,"38,019.56",24264
,20170331,47840,47880,47880,48790,47780,48200,48230,320,350,4976,"120,013.28",25880
,20170405,48200,48230,47530,48050,47330,47850,47750,-380,-480,2444,"58,357.45",26690
,20170406,47850,47750,48250,48770,48150,48250,48380,500,630,4982,"120,537.26",27794
,20170407,48250,48380,48400,48600,47370,47500,48080,-880,-300,6408,"154,058.05",29658
,20170410,47500,48080,47220,47970,47140,47480,47540,-600,-540,5420,"128,840.61",31044
,20170411,47480,47540,47480,47490,46900,46960,47120,-580,-420,9590,"225,962.65",31900
,20170412,46960,47120,46960,47330,46450,46500,46830,-620,-290,23492,"550,124.43",30844
,20170413,46500,46830,46400,46820,45800,46760,46330,-70,-500,13320,"308,578.81",31932
,20170414,46760,46330,46500,46740,46110,46400,46410,70,80,8376,"194,371.72",32566
,20170417,46400,46410,46470,47860,46200,46650,46890,240,480,21320,"499,912.29",35954
,20170418,46650,46890,46810,47130,45940,46030,46410,-860,-480,14690,"340,952.57",38778
,20170419,46030,46410,46070,46260,45290,45990,45850,-420,-560,22644,"519,158.32",43190
,20170420,45990,45850,45850,46250,44940,45700,45560,-150,-290,29112,"663,237.33",48844
,20170421,45700,45560,45870,46230,45590,46150,45910,590,350,14902,"342,081.43",50648
,20170424,46150,45910,45950,46150,45590,46000,45910,90,0,20358,"467,335.23",49366
,20170425,46000,45910,45950,46440,45690,46180,46050,270,140,24108,"555,201.68",54486
,20170426,46180,46050,46370,46640,46040,46460,46440,410,390,22776,"528,916.99",56226
,20170427,46460,46440,46550,46700,46360,46440,46470,0,30,12916,"300,129.09",58300
,20170428,46440,46470,46530,46650,46030,46650,46420,180,-50,34422,"799,074.07",68322
,20170502,46650,46420,47000,47190,46810,46930,46980,510,560,12738,"299,216.06",69896
,20170503,46930,46980,47050,47070,46640,46670,46790,-310,-190,11342,"265,361.14",72188
,20170504,46670,46790,45930,46110,45150,45350,45690,-1440,-1100,41326,"944,149.51",75848
,20170505,45350,45690,45120,45390,44820,45070,45120,-620,-570,38010,"857,622.04",83798
,20170508,45070,45120,45080,45610,44700,44710,45110,-410,-10,54686,"1,233,507.54",87474
,20170509,44710,45110,44700,44920,44500,44820,44740,-290,-370,41034,"918,064.89",94838
,20170510,44820,44740,44890,45270,44800,44900,44990,160,250,26394,"593,845.93",98222
,20170511,44900,44990,45080,45370,44710,45320,45010,330,20,34328,"772,672.51",103572
,20170512,45320,45010,45570,45640,44870,44990,45090,-20,80,34660,"781,458.98",107004
,20170515,44990,45090,45100,45540,44960,45480,45290,390,200,39208,"887,899.26",110568
,20170516,45480,45290,45590,45640,45110,45210,45320,-80,30,33172,"751,838.94",111640
,20170517,45210,45320,45310,45690,45310,45470,45460,150,140,39606,"900,417.21",115480
,20170518,45470,45460,45320,45540,44990,45040,45160,-420,-300,46830,"1,057,565.69",118904
,20170519,45040,45160,44790,45460,44690,45360,45160,200,0,53258,"1,202,777.89",119060
,20170522,45360,45160,45600,46090,45540,45860,45860,700,700,64606,"1,481,426.47",125008
,20170523,45860,45860,46030,46180,45830,45840,45990,-20,130,48382,"1,112,562.78",126774
,20170524,45840,45990,45940,46210,45560,45830,45890,-160,-100,84274,"1,933,854.18",147650
,20170525,45830,45890,45920,46110,45760,46010,45950,120,60,71016,"1,631,893.78",157054
,20170526,46010,45950,45990,46380,45900,46040,46080,90,130,80318,"1,850,882.45",165286
,20170531,46040,46080,45850,45890,45190,45240,45560,-840,-520,115244,"2,625,258.62",187636
,20170601,45240,45560,45320,45570,45110,45350,45330,-210,-230,132220,"2,997,247.88",196008
,20170602,45350,45330,45450,45610,45280,45380,45410,50,80,121784,"2,765,652.72",205450
,20170605,45380,45410,44980,45490,44900,45280,45250,-130,-160,157414,"3,562,138.18",207912
,20170606,45280,45250,45160,45350,44900,44920,45150,-330,-100,158238,"3,572,739.39",219982
,20170607,44920,45150,44850,45300,44680,44880,45020,-270,-130,277966,"6,258,131.55",223644
,20170608,44880,45020,44980,45360,44820,45260,45070,240,50,209292,"4,716,827.90",218882
,20170609,45260,45070,45530,46000,45490,45930,45750,860,680,281390,"6,438,114.77",220604
,20170612,45930,45750,46220,46600,46110,46370,46340,620,590,246512,"5,711,918.41",224214
,20170613,46370,46340,46290,46340,45810,45830,46070,-510,-270,197490,"4,549,700.09",223494
,20170614,45830,46070,45650,46020,45630,45960,45800,-110,-270,224422,"5,140,332.02",214510
,20170615,45960,45800,45850,45920,45380,45600,45650,-200,-150,220290,"5,029,090.04",208066
,20170616,45600,45650,45550,45800,45360,45490,45570,-160,-80,201860,"4,600,100.65",203636
,20170619,45490,45570,45590,45770,45430,45680,45600,110,30,163648,"3,731,358.49",198308
,20170620,45680,45600,45830,46100,45750,45840,45910,240,310,174480,"4,005,274.97",204040
,20170621,45840,45910,45590,45660,45360,45520,45500,-390,-410,193626,"4,405,137.64",205846
,20170622,45520,45500,45880,46250,45750,45810,45980,310,480,232072,"5,336,237.57",197882
,20170623,45810,45980,46070,46720,45900,46690,46210,710,230,229244,"5,297,156.37",209268
,20170626,46690,46210,46640,46840,46350,46820,46540,610,330,192652,"4,483,603.50",205720
,20170627,46820,46540,46680,46750,46430,46720,46570,180,30,165084,"3,844,785.44",193436
,20170628,46720,46570,46690,47000,46610,46920,46820,350,250,190654,"4,463,862.06",195242
,20170629,46920,46820,46860,47520,46770,47430,47220,610,400,274182,"6,474,203.33",188688
,20170630,47430,47220,47430,47670,47230,47460,47440,240,220,197134,"4,676,225.70",171202
,20170703,47460,47440,47410,47540,47250,47500,47380,60,-60,137202,"3,250,640.89",160750
,20170704,47500,47380,47340,47420,46830,46920,47120,-460,-260,139526,"3,287,664.45",148902
,20170705,46920,47120,46980,47250,46980,47040,47100,-80,-20,75760,"1,784,330.33",142162
,20170706,47040,47100,46790,46880,46590,46870,46740,-230,-360,77204,"1,804,319.54",136488
,20170707,46870,46740,46740,47040,46710,47010,46820,270,80,58216,"1,363,037.21",130588
,20170710,47010,46820,46840,46920,46650,46710,46770,-110,-50,68210,"1,595,131.79",129306
,20170711,46710,46770,46620,47050,46480,46920,46730,150,-40,71140,"1,662,510.53",127600
,20170712,46920,46730,46790,47330,46100,47120,47110,390,380,78702,"1,853,881.08",124096
,20170713,47120,47110,47300,47380,47000,47280,47170,170,60,61408,"1,448,514.40",123374
,20170714,47280,47170,47280,47310,46850,47070,47020,-100,-150,59786,"1,405,746.74",121680
,20170717,47070,47020,47070,47800,47030,47700,47410,680,390,69160,"1,639,497.83",116058
,20170718,47700,47410,47800,47930,47440,47560,47700,150,290,60642,"1,446,604.21",106596
,20170719,47560,47700,47590,47860,47550,47860,47670,160,-30,43394,"1,034,456.47",103420
,20170720,47860,47670,47790,47800,47460,47710,47640,40,-30,54688,"1,302,876.90",97440
,20170721,47710,47640,47710,48000,47350,47890,47720,250,80,47818,"1,140,957.01",94562
,20170724,47890,47720,48060,48110,47630,47680,47760,-40,40,43546,"1,039,895.20",91398
,20170725,47680,47760,47790,48550,47690,48420,48150,660,390,62188,"1,497,369.42",84388
,20170726,48420,48150,48850,50560,48850,49890,49680,1740,1530,81748,"2,031,002.10",75224
,20170727,49890,49680,49810,50240,49780,49890,49970,210,290,45866,"1,146,116.44",70930
,20170728,49890,49970,50020,50230,49440,49800,49820,-170,-150,43430,"1,081,846.40",64892
,20170731,49800,49820,49920,50710,49770,50540,50230,720,410,46120,"1,158,367.95",58284
,20170801,50540,50230,50220,50300,50000,50050,50180,-180,-50,26924,"675,583.84",57220
,20170802,50050,50180,50020,50180,49700,49900,49880,-280,-300,27190,"678,252.20",55300
,20170803,49900,49880,49950,50260,49730,49750,50090,-130,210,24740,"619,655.30",52280
,20170804,49750,50090,49950,50300,49830,50120,50120,30,30,23160,"580,405.55",48060
,20170807,50120,50120,50110,50700,49900,50140,50060,20,-60,30980,"775,528.80",43600
,20170808,50140,50060,50200,50750,50050,50140,50410,80,350,31540,"794,990.25",35780
,20170809,50140,50410,50170,51020,50150,50920,50770,510,360,33320,"845,936.50",30740
,20170810,50920,50770,50830,50900,50340,50450,50520,-320,-250,26680,"674,039.70",23890
,20170811,50450,50520,50390,50390,49510,49650,49760,-870,-760,23620,"587,749.40",16130
,20170814,49650,49760,49890,50120,49720,49790,49970,30,210,11580,"289,369.40",11210
,20170815,49790,49970,49900,50050,49790,49880,49950,-90,-20,5340,"133,384.20",8450
cu1709,20170103,46410,46380,46980,47590,46740,46740,47210,360,830,302,"7,129.11",2824
,20170104,46740,47210,47000,47000,45820,46560,46420,-650,-790,318,"7,381.33",2982
,20170105,46560,46420,46250,47140,46250,46720,46830,300,410,410,"9,600.43",3100
,20170106,46720,46830,46530,46730,45470,46080,46340,-750,-490,494,"11,448.09",3302
,20170109,46080,46340,46120,46620,46060,46360,46350,20,10,226,"5,237.56",3354
,20170110,46360,46350,46120,46880,45560,46880,46380,530,30,526,"12,198.06",3544
,20170111,46880,46380,46850,47990,46590,47700,47630,1320,1250,2516,"59,919.99",4790
,20170112,47700,47630,47540,47950,47190,47690,47770,60,140,434,"10,366.73",4744
,20170113,47690,47770,48250,48680,48000,48000,48450,230,680,1134,"27,472.57",4826
,20170116,48000,48450,48000,49060,48000,48650,48690,200,240,168,"4,090.73",4842
,20170117,48650,48690,48490,48740,47430,47500,48160,-1190,-530,238,"5,731.74",4816
,20170118,47500,48160,47520,47690,45950,47110,46890,-1050,-1270,2286,"53,598.66",3788
,20170119,47110,46890,46900,47300,46850,47150,47110,260,220,214,"5,040.80",3782
,20170120,47150,47110,46920,47060,46370,46460,46800,-650,-310,230,"5,382.33",3688
,20170123,46460,46800,46660,47530,46600,47120,47160,320,360,138,"3,254.04",3700
,20170124,47120,47160,46970,47480,46660,47480,47310,320,150,348,"8,231.98",3632
,20170125,47480,47310,47480,48630,47440,48230,48380,920,1070,4108,"99,380.43",5954
,20170126,48230,48380,48100,48690,47940,48600,48310,220,-70,748,"18,070.95",5932
,20170203,48600,48310,47710,47970,47140,47360,47600,-950,-710,256,"6,093.47",5922
,20170206,47360,47600,47410,47540,46970,47180,47250,-420,-350,260,"6,143.23",5952
,20170207,47180,47250,47460,47610,47360,47480,47520,230,270,376,"8,933.81",6058
,20170208,47480,47520,47310,48400,47240,48400,48070,880,550,588,"14,135.28",6068
,20170209,48400,48070,48120,48480,47940,48020,48270,-50,200,276,"6,661.41",6156
,20170210,48020,48270,48150,48600,47910,48420,48280,150,10,460,"11,106.25",6290
,20170213,48420,48280,48230,51580,48190,50800,50280,2520,2000,6152,"154,677.21",9106
,20170214,50800,50280,50980,50980,50420,50680,50700,400,420,1590,"40,307.70",9708
,20170215,50680,50700,50420,50750,49000,49420,49870,-1280,-830,964,"24,038.65",9764
,20170216,49420,49870,49570,49940,49170,49300,49760,-570,-110,736,"18,314.24",9916
,20170217,49300,49760,49510,49510,48820,48980,49160,-780,-600,338,"8,309.52",9852
,20170220,48980,49160,49000,49520,48620,49520,49060,360,-100,336,"8,242.34",9846
,20170221,49520,49060,49370,49970,49370,49550,49770,490,710,606,"15,082.95",9886
,20170222,49550,49770,49450,49840,49180,49330,49520,-440,-250,380,"9,409.28",9992
,20170223,49330,49520,49150,49570,48910,49070,49100,-450,-420,200,"4,910.52",9970
,20170224,49070,49100,49070,49290,47820,48580,48380,-520,-720,638,"15,433.90",9784
,20170227,48580,48380,48370,49010,48190,48440,48580,60,200,450,"10,931.98",9866
,20170228,48440,48580,48440,48800,48300,48440,48570,-140,-10,546,"13,260.27",9900
,20170301,48440,48570,48440,49490,48400,49360,48950,790,380,358,"8,763.25",9888
,20170302,49360,48950,49360,49750,49070,49390,49420,440,470,270,"6,672.06",9878
,20170303,49390,49420,49110,49120,48620,49020,48930,-400,-490,518,"12,674.99",10006
,20170306,49020,48930,48940,49210,48570,48640,48990,-290,60,578,"14,158.55",10114
,20170307,48640,48990,48480,48530,48190,48450,48420,-540,-570,564,"13,654.66",10376
,20170308,48450,48420,48180,48280,47680,47880,47910,-540,-510,942,"22,567.30",10608
,20170309,47880,47910,47970,48040,47020,47100,47460,-810,-450,874,"20,742.73",10910
,20170310,47100,47460,46710,47280,46660,47100,47070,-360,-390,582,"13,697.63",11174
,20170313,47100,47070,47100,47980,46990,47940,47550,870,480,706,"16,787.07",11066
,20170314,47940,47550,47750,48020,47700,47850,47850,300,300,428,"10,241.60",11134
,20170315,47850,47850,47690,48320,47430,48180,48010,330,160,614,"14,741.37",11244
,20170316,48180,48010,48180,48780,48180,48550,48540,540,530,192,"4,660.35",11286
,20170317,48550,48540,48550,48850,48220,48260,48470,-280,-70,198,"4,798.58",11272
,20170320,48260,48470,48640,48810,48420,48490,48600,20,130,530,"12,879.67",11238
,20170321,48490,48600,48420,48890,47620,47860,48220,-740,-380,852,"20,542.25",11434
,20170322,47860,48220,47680,47940,47020,47200,47350,-1020,-870,516,"12,218.51",11530
,20170323,47200,47350,47200,47890,47090,47750,47570,400,220,564,"13,417.13",11614
,20170324,47750,47570,47670,47870,47300,47750,47580,180,10,404,"9,612.95",11612
,20170327,47750,47580,47750,47750,46720,46860,47100,-720,-480,878,"20,677.28",11948
,20170328,46860,47100,46500,47580,46220,47250,47100,150,0,866,"20,396.51",12086
,20170329,47250,47100,47250,48180,47200,48010,47880,910,780,822,"19,682.00",12146
,20170330,48010,47880,47960,48400,47790,47970,48170,90,290,882,"21,244.52",12340
,20170331,47970,48170,47910,48950,47910,48360,48390,190,220,2800,"67,756.30",13726
,20170405,48360,48390,48150,48200,47530,48000,47980,-390,-410,630,"15,115.39",13950
,20170406,48000,47980,48430,48950,48350,48460,48630,480,650,2476,"60,207.17",15226
,20170407,48460,48630,48460,48770,47530,47760,48280,-870,-350,1698,"40,994.16",15522
,20170410,47760,48280,47340,48110,47290,47680,47730,-600,-550,1404,"33,510.29",15826
,20170411,47680,47730,47550,47670,47050,47090,47240,-640,-490,2436,"57,549.20",16598
,20170412,47090,47240,47090,47470,46580,46740,47030,-500,-210,3230,"75,958.09",17108
,20170413,46740,47030,46650,46950,45960,46870,46540,-160,-490,3580,"83,322.26",18030
,20170414,46870,46540,46510,46880,46260,46550,46570,10,30,2184,"50,861.85",18296
,20170417,46550,46570,46420,48010,46350,46800,47040,230,470,5298,"124,609.36",19398
,20170418,46800,47040,46800,47240,46060,46170,46570,-870,-470,4296,"100,040.01",19984
,20170419,46170,46570,46200,46380,45430,46100,45960,-470,-610,4428,"101,776.08",20812
,20170420,46100,45960,46080,46350,45050,45800,45610,-160,-350,7258,"165,543.88",21960
,20170421,45800,45610,45820,46320,45700,46230,45990,620,380,4850,"111,545.48",22436
,20170424,46230,45990,46010,46250,45690,46090,45970,100,-20,4834,"111,126.42",23074
,20170425,46090,45970,45970,46500,45800,46300,46220,330,250,4122,"95,263.56",23918
,20170426,46300,46220,46300,46740,46150,46500,46540,280,320,4392,"102,203.86",23908
,20170427,46500,46540,46500,46810,46500,46570,46600,30,60,3372,"78,568.04",23936
,20170428,46570,46600,46570,46700,46160,46510,46530,-90,-70,6226,"144,878.70",25218
,20170502,46510,46530,47050,47290,46920,47010,47090,480,560,4898,"115,335.22",25582
,20170503,47010,47090,47030,47160,46760,46820,46900,-270,-190,4042,"94,802.61",26634
,20170504,46820,46900,46100,46210,45190,45410,45760,-1490,-1140,12168,"278,444.72",28240
,20170505,45410,45760,45100,45490,44940,45230,45290,-530,-470,8978,"203,329.34",30466
,20170508,45230,45290,45220,45710,44800,44800,45170,-490,-120,12130,"273,989.75",32222
,20170509,44800,45170,44760,45000,44590,44870,44840,-300,-330,8208,"184,028.37",33170
,20170510,44870,44840,44990,45360,44900,44980,45070,140,230,6742,"151,946.91",34226
,20170511,44980,45070,45060,45450,44800,45400,45090,330,20,8822,"198,905.15",35020
,20170512,45400,45090,45670,45690,44980,45100,45190,10,100,10862,"245,459.64",38174
,20170515,45100,45190,45200,45630,45080,45630,45400,440,210,8640,"196,168.02",38450
,20170516,45630,45400,45710,45750,45210,45310,45390,-90,-10,12822,"291,010.42",39378
,20170517,45310,45390,45450,45790,45410,45540,45570,150,180,11018,"251,078.98",40456
,20170518,45540,45570,45360,45600,45080,45150,45260,-420,-310,14692,"332,532.72",43054
,20170519,45150,45260,44880,45540,44760,45420,45320,160,60,14488,"328,308.70",45350
,20170522,45420,45320,45680,46180,45630,45950,45960,630,640,18626,"428,037.87",47098
,20170523,45950,45960,46070,46270,45920,45950,46080,-10,120,17868,"411,750.76",50482
,20170524,45950,46080,45950,46310,45640,45890,45970,-190,-110,20580,"473,100.30",53006
,20170525,45890,45970,46050,46200,45860,46080,46060,110,90,14428,"332,314.81",56098
,20170526,46080,46060,46050,46450,45980,46110,46150,50,90,24428,"563,785.87",60328
,20170531,46110,46150,45790,46030,45280,45350,45630,-800,-520,30482,"695,591.46",64576
,20170601,45350,45630,45430,45630,45200,45450,45410,-180,-220,28008,"635,983.95",68352
,20170602,45450,45410,45500,45670,45370,45470,45500,60,90,23680,"538,729.48",73810
,20170605,45470,45500,45080,45540,45000,45370,45330,-130,-170,32324,"732,665.71",74874
,20170606,45370,45330,45300,45430,45000,45010,45220,-320,-110,27114,"613,118.47",78328
,20170607,45010,45220,44980,45370,44760,44940,45100,-280,-120,47024,"1,060,538.46",75992
,20170608,44940,45100,45020,45420,44910,45330,45150,230,50,33266,"751,118.31",75444
,20170609,45330,45150,45600,46070,45540,46020,45820,870,670,65826,"1,508,290.11",84868
,20170612,46020,45820,46290,46670,46200,46470,46420,650,600,53398,"1,239,391.51",92888
,20170613,46470,46420,46360,46420,45870,45900,46150,-520,-270,41598,"959,979.20",98764
,20170614,45900,46150,45730,46090,45710,46010,45890,-140,-260,45652,"1,047,638.25",101080
,20170615,46010,45890,45930,46000,45400,45710,45730,-180,-160,52456,"1,199,462.22",100094
,20170616,45710,45730,45610,45870,45450,45570,45650,-160,-80,44326,"1,011,920.72",102724
,20170619,45570,45650,45640,45850,45520,45780,45680,130,30,37684,"860,844.82",105712
,20170620,45780,45680,45890,46180,45850,45950,46000,270,320,43944,"1,010,722.05",108112
,20170621,45950,46000,45710,45760,45470,45610,45600,-390,-400,55734,"1,270,843.58",109964
,20170622,45610,45600,45950,46320,45850,45890,46070,290,470,76808,"1,769,329.73",115084
,20170623,45890,46070,46100,46830,46000,46820,46270,750,200,84576,"1,956,796.96",125420
,20170626,46820,46270,46780,46930,46470,46920,46640,650,370,74270,"1,732,241.94",137982
,20170627,46920,46640,46810,46840,46520,46820,46660,180,20,71884,"1,677,366.01",148654
,20170628,46820,46660,46810,47080,46700,47040,46910,380,250,83370,"1,955,593.35",156950
,20170629,47040,46910,46980,47640,46850,47570,47350,660,440,133152,"3,153,010.60",177462
,20170630,47570,47350,47580,47800,47350,47560,47550,210,200,103016,"2,449,458.09",180648
,20170703,47560,47550,47510,47650,47370,47600,47500,50,-50,104806,"2,489,375.61",188234
,20170704,47600,47500,47490,47550,46930,47030,47230,-470,-270,148008,"3,495,865.70",192256
,20170705,47030,47230,47110,47360,47080,47140,47210,-90,-20,121620,"2,871,249.45",197038
,20170706,47140,47210,46870,46980,46680,46960,46830,-250,-380,146812,"3,438,120.49",197406
,20170707,46960,46830,46860,47150,46800,47130,46920,300,90,123504,"2,897,930.19",202196
,20170710,47130,46920,46910,47040,46730,46770,46860,-150,-60,165672,"3,882,232.16",197104
,20170711,46770,46860,46680,47170,46580,47050,46840,190,-20,179100,"4,195,085.99",199104
,20170712,47050,46840,46920,47480,46850,47250,47210,410,370,223482,"5,275,761.07",201592
,20170713,47250,47210,47360,47520,47120,47400,47320,190,110,149728,"3,543,079.94",203072
,20170714,47400,47320,47440,47440,46930,47160,47150,-160,-170,165950,"3,912,299.41",202554
,20170717,47160,47150,47140,47930,47120,47810,47520,660,370,274074,"6,512,014.12",220578
,20170718,47810,47520,47950,48050,47560,47690,47840,170,320,204886,"4,901,638.82",212040
,20170719,47690,47840,47690,47980,47660,47960,47790,120,-50,155696,"3,720,741.92",216360
,20170720,47960,47790,47860,47910,47540,47790,47750,0,-40,199886,"4,772,432.99",213556
,20170721,47790,47750,47810,48110,47410,48000,47800,250,50,242490,"5,796,562.23",216742
,20170724,48000,47800,48200,48220,47720,47760,47890,-40,90,174398,"4,176,761.84",205308
,20170725,47760,47890,47890,48690,47790,48560,48240,670,350,277318,"6,688,981.91",210168
,20170726,48560,48240,49000,50730,48960,50050,49840,1810,1600,513720,"12,803,983.50",213502
,20170727,50050,49840,49980,50420,49910,50040,50150,200,310,267478,"6,707,948.23",207324
,20170728,50040,50150,50210,50410,49550,49940,50010,-210,-140,257912,"6,449,151.83",197566
,20170731,49940,50010,50060,50860,49920,50710,50340,700,330,285858,"7,195,892.49",183196
,20170801,50710,50340,50330,50460,50100,50180,50320,-160,-20,156298,"3,932,534.43",168870
,20170802,50180,50320,50160,50350,49820,50030,50070,-290,-250,164890,"4,128,476.64",161664
,20170803,50030,50070,50040,50420,49820,49820,50180,-250,110,152170,"3,818,211.24",153376
,20170804,49820,50180,50040,50450,49950,50250,50200,70,20,91938,"2,307,676.22",148852
,20170807,50250,50200,50230,50860,49970,50260,50230,60,30,119658,"3,005,732.85",143572
,20170808,50260,50230,50270,50960,50180,50280,50580,50,350,111634,"2,823,384.56",138526
,20170809,50280,50580,50320,51260,50080,51120,50910,540,330,120132,"3,058,009.68",133146
,20170810,51120,50910,51020,51150,50490,50630,50740,-280,-170,86438,"2,193,056.75",129914
,20170811,50630,50740,50630,50630,49640,49820,49960,-920,-780,125118,"3,125,747.86",121076
,20170814,49820,49960,50020,50310,49850,49920,50130,-40,170,63708,"1,596,941.81",123250
,20170815,49920,50130,50040,50250,49910,50200,50130,70,0,48526,"1,216,487.44",121236
,20170816,50200,50130,50240,50250,49750,50060,49990,-70,-140,58200,"1,454,869.90",116806
,20170817,50060,49990,50400,51520,50400,51290,51110,1300,1120,79280,"2,026,335.10",107902
,20170818,51290,51110,50940,51080,50500,50930,50730,-180,-380,57638,"1,462,034.08",105574
,20170821,50930,50730,50960,51750,50550,51520,51050,790,320,66414,"1,695,306.76",98560
,20170822,51520,51050,51510,52040,51250,52040,51550,990,500,54434,"1,403,059.94",95594
,20170823,52040,51550,52090,52140,51200,51430,51410,-120,-140,52966,"1,361,747.18",91528
,20170824,51430,51410,51420,51990,51230,51770,51640,360,230,46638,"1,204,372.67",88830
,20170825,51770,51640,51770,52680,51650,52650,52330,1010,690,54468,"1,425,277.76",85784
,20170828,52650,52330,52650,52810,51910,52780,52430,450,100,47202,"1,237,476.40",80718
,20170829,52780,52430,52780,52900,52320,52540,52590,110,160,48196,"1,267,352.96",75534
,20170830,52540,52590,52710,52840,52400,52600,52610,10,20,42696,"1,123,119.16",69886
,20170831,52600,52610,52600,52750,52000,52750,52580,140,-30,35568,"935,110.20",63234
,20170901,52750,52580,52810,52810,52460,52680,52600,100,20,29084,"764,949.08",53880
,20170904,52680,52600,52580,53230,52460,53030,52980,430,380,32910,"871,824.05",46780
,20170905,53030,52980,52970,53520,52920,53470,53220,490,240,28530,"759,288.80",42480
,20170906,53470,53220,53300,53300,52560,53020,52960,-200,-260,34680,"918,364.85",35290
,20170907,53020,52960,52970,53120,52530,52600,52850,-360,-110,30730,"812,148.60",30750
,20170908,52600,52850,52600,52670,51510,51620,52270,-1230,-580,38220,"999,013.05",25680
,20170911,51620,52270,51640,51640,50850,51400,51200,-870,-1070,27830,"712,477.20",19790
,20170912,51400,51200,51600,51720,51230,51470,51410,270,210,21540,"553,699.85",14640
,20170913,51470,51410,51000,51280,50820,50850,51070,-560,-340,16430,"419,542.55",10480
,20170914,50850,51070,50500,50620,50180,50220,50420,-850,-650,9850,"248,354.35",7570
,20170915,50220,50420,50350,50450,50060,50290,50220,-130,-200,3660,"91,910.60",6980
cu1710,20170103,46700,46590,47410,47600,47120,47120,47410,530,820,330,"7,823.57",1404
,20170104,47120,47410,47180,47300,46090,46790,46620,-620,-790,348,"8,113.48",1466
,20170105,46790,46620,46630,47390,46630,47030,47140,410,520,316,"7,448.53",1572
,20170106,47030,47140,46750,46910,46240,46310,46480,-830,-660,154,"3,579.35",1642
,20170109,46310,46480,46310,46650,46180,46400,46460,-80,-20,84,"1,951.52",1642
,20170110,46400,46460,46470,46880,46290,46790,46510,330,50,52,"1,209.31",1656
,20170111,46790,46510,47260,48380,47250,48020,48010,1510,1500,2660,"63,854.50",2876
,20170112,48020,48010,47870,48160,47770,47930,48050,-80,40,2392,"57,474.14",4650
,20170113,47930,48050,48340,48790,48180,48230,48540,180,490,1628,"39,517.67",4910
,20170116,48230,48540,48290,49360,48290,48890,49020,350,480,254,"6,226.00",4894
,20170117,48890,49020,48780,48970,47550,47700,48150,-1320,-870,490,"11,797.11",4898
,20170118,47700,48150,47840,47840,45990,47170,47040,-980,-1110,3758,"88,389.11",3284
,20170119,47170,47040,46960,47340,46880,47220,47210,180,170,1216,"28,705.65",4280
,20170120,47220,47210,47100,47140,46410,46460,46840,-750,-370,226,"5,293.47",4224
,20170123,46460,46840,46580,47590,46450,47100,47160,260,320,178,"4,197.76",4238
,20170124,47100,47160,47000,47630,46950,47630,47420,470,260,418,"9,912.49",4252
,20170125,47630,47420,48050,48720,47610,48360,48370,940,950,3580,"86,589.84",5774
,20170126,48360,48370,48130,48810,48130,48740,48470,370,100,210,"5,089.46",5734
,20170203,48740,48470,47760,48120,47260,47450,47690,-1020,-780,100,"2,384.91",5718
,20170206,47450,47690,47450,47570,47100,47350,47330,-340,-360,308,"7,289.67",5750
,20170207,47350,47330,47290,47680,47290,47570,47500,240,170,130,"3,087.92",5766
,20170208,47570,47500,47440,48420,47440,48420,48130,920,630,208,"5,006.54",5728
,20170209,48420,48130,48540,48630,48160,48270,48430,140,300,164,"3,971.41",5710
,20170210,48270,48430,48210,48710,48000,48560,48430,130,0,176,"4,262.50",5756
,20170213,48560,48430,48680,51820,48660,51000,50500,2570,2070,5278,"133,277.59",8194
,20170214,51000,50500,50910,51000,50510,50700,50800,200,300,1048,"26,620.08",8340
,20170215,50700,50800,50810,50900,49160,49650,49890,-1150,-910,1136,"28,342.45",8270
,20170216,49650,49890,49650,50050,49480,49480,49850,-410,-40,714,"17,798.00",8442
,20170217,49480,49850,49580,49580,49070,49350,49330,-500,-520,120,"2,959.80",8442
,20170220,49350,49330,48880,49640,48760,49550,49250,220,-80,150,"3,694.36",8406
,20170221,49550,49250,49690,50030,49610,49650,49820,400,570,84,"2,092.63",8404
,20170222,49650,49820,49740,49910,49300,49400,49620,-420,-200,84,"2,084.05",8426
,20170223,49400,49620,49190,49610,49000,49000,49220,-620,-400,150,"3,692.21",8368
,20170224,49000,49220,49350,49350,47970,48700,48350,-520,-870,228,"5,511.98",8364
,20170227,48700,48350,48660,49030,48320,48540,48610,190,260,146,"3,549.20",8364
,20170228,48540,48610,48860,48860,48400,48580,48710,-30,100,3372,"82,136.58",10740
,20170301,48580,48710,48740,49600,48580,49490,49170,780,460,578,"14,210.98",10880
,20170302,49490,49170,49700,49940,49360,49420,49510,250,340,128,"3,169.16",10898
,20170303,49420,49510,49050,49180,48750,49130,48980,-380,-530,90,"2,204.26",10906
,20170306,49130,48980,49080,49340,48650,48780,49010,-200,30,714,"17,498.69",11352
,20170307,48780,49010,48650,48650,48360,48580,48580,-430,-430,204,"4,955.67",11448
,20170308,48580,48580,48330,48420,47810,48160,48040,-420,-540,234,"5,621.64",11512
,20170309,48160,48040,48120,48170,47130,47290,47470,-750,-570,740,"17,566.72",11540
,20170310,47290,47470,47290,47430,46780,47290,47210,-180,-260,454,"10,718.26",11580
,20170313,47290,47210,47450,48070,47170,48070,47640,860,430,408,"9,718.74",11608
,20170314,48070,47640,48030,48130,47890,48030,48050,390,410,722,"17,349.10",11618
,20170315,48030,48050,47790,48420,47590,48300,48000,250,-50,326,"7,824.66",11616
,20170316,48300,48000,48580,48920,48390,48770,48680,770,680,172,"4,186.80",11620
,20170317,48770,48680,48870,48870,48380,48450,48590,-230,-90,130,"3,158.94",11604
,20170320,48450,48590,48610,49050,48570,48650,48850,60,260,502,"12,263.51",11738
,20170321,48650,48850,48670,48980,47790,48080,48460,-770,-390,182,"4,409.98",11754
,20170322,48080,48460,47930,47980,47140,47350,47430,-1110,-1030,334,"7,921.64",11886
,20170323,47350,47430,47420,47960,47250,47900,47640,470,210,184,"4,382.96",11850
,20170324,47900,47640,47640,48000,47470,47880,47680,240,40,140,"3,337.71",11854
,20170327,47880,47680,47730,47730,46940,47000,47070,-680,-610,254,"5,978.86",11946
,20170328,47000,47070,46850,47640,46370,47440,47160,370,90,252,"5,942.60",11950
,20170329,47440,47160,47580,48200,47380,48130,48010,970,850,330,"7,922.88",11846
,20170330,48130,48010,48100,48560,47890,48110,48430,100,420,502,"12,156.35",12146
,20170331,48110,48430,48280,49170,48280,48500,48720,70,290,840,"20,464.20",12430
,20170405,48500,48720,48010,48340,47840,48140,48160,-580,-560,224,"5,395.02",12438
,20170406,48140,48160,48570,49160,48510,48610,48820,450,660,2000,"48,821.78",13510
,20170407,48610,48820,48630,48880,47780,47780,48450,-1040,-370,2894,"70,112.34",13744
,20170410,47780,48450,47480,48200,47470,47810,47820,-640,-630,1000,"23,913.26",13822
,20170411,47810,47820,48200,48200,47240,47250,47450,-570,-370,504,"11,958.24",13948
,20170412,47250,47450,47530,47590,46760,46800,47160,-650,-290,544,"12,829.39",14264
,20170413,46800,47160,46730,47140,46200,47030,46680,-130,-480,780,"18,208.91",14480
,20170414,47030,46680,46830,47000,46420,46700,46710,20,30,250,"5,839.67",14526
,20170417,46700,46710,46850,48140,46620,46990,47190,280,480,1546,"36,478.97",15080
,20170418,46990,47190,47160,47400,46210,46320,46680,-870,-510,766,"17,879.42",15346
,20170419,46320,46680,46360,46460,45570,46270,46030,-410,-650,1548,"35,630.06",16040
,20170420,46270,46030,46160,46470,45190,45900,45800,-130,-230,2160,"49,466.71",16762
,20170421,45900,45800,46090,46450,45800,46340,46100,540,300,634,"14,616.75",16714
,20170424,46340,46100,46170,46300,45840,46240,46080,140,-20,700,"16,130.67",16764
,20170425,46240,46080,46160,46590,45900,46390,46390,310,310,730,"16,934.06",16874
,20170426,46390,46390,46590,46870,46370,46680,46700,290,310,794,"18,543.67",16648
,20170427,46680,46700,46760,46880,46660,46710,46730,10,30,486,"11,356.10",16844
,20170428,46710,46730,46740,46840,46300,46650,46660,-80,-70,754,"17,593.30",17184
,20170502,46650,46660,47020,47390,47020,47110,47240,450,580,1328,"31,371.99",17764
,20170503,47110,47240,47180,47300,46920,46940,47000,-300,-240,494,"11,611.30",17978
,20170504,46940,47000,46470,46470,45420,45620,45880,-1380,-1120,1714,"39,327.52",18658
,20170505,45620,45880,45210,45660,45100,45330,45420,-550,-460,2468,"56,049.46",19250
,20170508,45330,45420,45470,45840,44920,44920,45240,-500,-180,3492,"79,003.91",20964
,20170509,44920,45240,44850,45120,44720,44960,44950,-280,-290,2602,"58,488.03",21874
,20170510,44960,44950,44960,45500,44960,45130,45210,180,260,2754,"62,258.49",23060
,20170511,45130,45210,45320,45580,44930,45540,45260,330,50,2170,"49,114.89",23352
,20170512,45540,45260,45830,45840,45110,45250,45350,-10,90,1644,"37,285.26",23220
,20170515,45250,45350,45370,45800,45210,45800,45520,450,170,2536,"57,722.07",23810
,20170516,45800,45520,45860,45860,45330,45440,45560,-80,40,2610,"59,458.29",24386
,20170517,45440,45560,45590,45890,45550,45660,45700,100,140,2340,"53,477.15",24400
,20170518,45660,45700,45480,45720,45200,45270,45360,-430,-340,2786,"63,193.33",25260
,20170519,45270,45360,44930,45650,44910,45550,45400,190,40,2010,"45,628.02",25434
,20170522,45550,45400,45840,46290,45750,46040,46100,640,700,3832,"88,337.01",25390
,20170523,46040,46100,46310,46380,46040,46070,46210,-30,110,2728,"63,040.98",25484
,20170524,46070,46210,46190,46400,45760,46040,46130,-170,-80,4808,"110,898.01",25570
,20170525,46040,46130,46190,46310,45980,46210,46170,80,40,2382,"54,992.31",25818
,20170526,46210,46170,46170,46540,46100,46260,46260,90,90,3686,"85,272.26",26942
,20170531,46260,46260,45950,46080,45400,45470,45810,-790,-450,4916,"112,602.02",27464
,20170601,45470,45810,45550,45740,45320,45600,45520,-210,-290,5698,"129,705.82",27912
,20170602,45600,45520,45680,45800,45500,45600,45640,80,120,3036,"69,290.28",28734
,20170605,45600,45640,45200,45650,45090,45490,45420,-150,-220,4048,"91,938.83",28752
,20170606,45490,45420,45390,45530,45120,45160,45350,-260,-70,4418,"100,199.86",29570
,20170607,45160,45350,45000,45470,44880,45090,45180,-260,-170,6718,"151,768.17",30950
,20170608,45090,45180,45180,45520,45040,45510,45260,330,80,8492,"192,180.13",31372
,20170609,45510,45260,45690,46160,45680,46140,45930,880,670,10220,"234,748.70",32874
,20170612,46140,45930,46160,46790,46160,46560,46510,630,580,11384,"264,780.94",35884
,20170613,46560,46510,46410,46520,46000,46040,46240,-470,-270,7176,"165,936.33",37086
,20170614,46040,46240,45900,46190,45780,46130,45980,-110,-260,7288,"167,586.37",37234
,20170615,46130,45980,46000,46090,45600,45790,45840,-190,-140,7582,"173,785.76",37920
,20170616,45790,45840,45780,45970,45570,45660,45790,-180,-50,7636,"174,840.04",38308
,20170619,45660,45790,45780,45980,45650,45870,45810,80,20,5798,"132,814.86",38470
,20170620,45870,45810,45970,46280,45970,46070,46110,260,300,9438,"217,626.75",39872
,20170621,46070,46110,45830,45870,45590,45750,45710,-360,-400,9928,"226,931.33",39230
,20170622,45750,45710,46050,46430,45960,46000,46220,290,510,13796,"318,872.88",40396
,20170623,46000,46220,46260,46940,46120,46900,46440,680,220,17436,"404,875.52",45206
,20170626,46900,46440,46860,47050,46580,47000,46770,560,330,12608,"294,868.02",47366
,20170627,47000,46770,46880,46930,46630,46900,46780,130,10,14898,"348,484.95",49494
,20170628,46900,46780,46880,47190,46820,47140,47040,360,260,15664,"368,446.47",50444
,20170629,47140,47040,47100,47790,46990,47700,47540,660,500,42328,"1,006,161.77",63406
,20170630,47700,47540,47710,47950,47510,47730,47700,190,160,40320,"961,655.64",71676
,20170703,47730,47700,47630,47780,47500,47730,47630,30,-70,24496,"583,488.82",75356
,20170704,47730,47630,47600,47670,47070,47150,47310,-480,-320,30150,"713,283.29",75198
,20170705,47150,47310,47200,47500,47200,47250,47340,-60,30,21938,"519,320.11",77844
,20170706,47250,47340,47040,47090,46820,47090,46960,-250,-380,21436,"503,374.91",78724
,20170707,47090,46960,47040,47250,46910,47240,47010,280,50,23062,"542,120.69",81910
,20170710,47240,47010,47020,47150,46860,46920,46990,-90,-20,23446,"550,875.32",84090
,20170711,46920,46990,46800,47290,46700,47160,46960,170,-30,25598,"601,149.90",86768
,20170712,47160,46960,47000,47610,46840,47400,47330,440,370,41216,"975,424.27",93300
,20170713,47400,47330,47450,47660,47260,47510,47450,180,120,29432,"698,303.59",96824
,20170714,47510,47450,47560,47560,47070,47280,47270,-170,-180,30472,"720,261.31",101812
,20170717,47280,47270,47340,48030,47240,47910,47690,640,420,52272,"1,246,572.90",106908
,20170718,47910,47690,48100,48160,47680,47790,47950,100,260,47326,"1,134,758.84",111248
,20170719,47790,47950,47840,48070,47780,48070,47910,120,-40,35544,"851,519.77",117100
,20170720,48070,47910,47990,48020,47680,47880,47870,-30,-40,55330,"1,324,383.32",120562
,20170721,47880,47870,47920,48190,47510,48100,47920,230,50,59410,"1,423,732.61",124292
,20170724,48100,47920,48260,48280,47830,47880,48000,-40,80,50826,"1,219,857.93",123180
,20170725,47880,48000,47980,48790,47900,48660,48340,660,340,117018,"2,828,883.27",147460
,20170726,48660,48340,49040,50900,49040,50190,49980,1850,1640,225654,"5,639,801.14",171584
,20170727,50190,49980,50100,50550,50040,50190,50280,210,300,112426,"2,826,743.27",178978
,20170728,50190,50280,50370,50550,49670,50060,50120,-220,-160,120264,"3,013,990.01",181382
,20170731,50060,50120,50200,51000,50050,50820,50490,700,370,172772,"4,362,406.51",202394
,20170801,50820,50490,50430,50620,50250,50340,50460,-150,-30,123500,"3,116,337.54",203896
,20170802,50340,50460,50330,50520,49960,50170,50220,-290,-240,157788,"3,962,303.39",208830
,20170803,50170,50220,50200,50590,49980,49980,50330,-240,110,186936,"4,705,042.62",214520
,20170804,49980,50330,50220,50650,50110,50420,50380,90,50,215792,"5,436,675.17",229040
,20170807,50420,50380,50400,51060,50160,50440,50430,60,50,313780,"7,912,790.52",230156
,20170808,50440,50430,50460,51160,50350,50450,50760,20,330,321062,"8,149,537.88",237376
,20170809,50450,50760,50450,51460,50450,51310,51110,550,350,412874,"10,551,135.90",257988
,20170810,51310,51110,51210,51370,50640,50790,50940,-320,-170,287458,"7,322,677.85",237758
,20170811,50790,50940,50690,50730,49760,49970,50160,-970,-780,376090,"9,433,484.78",221268
,20170814,49970,50160,50210,50480,49980,50060,50280,-100,120,225496,"5,669,247.18",224246
,20170815,50060,50280,50200,50400,50060,50330,50240,50,-40,168522,"4,233,871.36",226518
,20170816,50330,50240,50330,50400,49880,50170,50090,-70,-150,221076,"5,537,613.76",227794
,20170817,50170,50090,50540,51680,50530,51470,51250,1380,1160,425214,"10,897,512.29",234874
,20170818,51470,51250,51090,51230,50620,51060,50910,-190,-340,259318,"6,601,598.79",223958
,20170821,51060,50910,51100,51920,50650,51650,51200,740,290,403734,"10,337,170.08",232220
,20170822,51650,51200,51640,52210,51370,52190,51750,990,550,385120,"9,965,769.63",233630
,20170823,52190,51750,52270,52330,51300,51560,51640,-190,-110,330686,"8,539,744.26",217544
,20170824,51560,51640,51510,52150,51360,51890,51760,250,120,291158,"7,535,574.32",220732
,20170825,51890,51760,51860,52840,51780,52770,52440,1010,680,376636,"9,875,985.85",221250
,20170828,52770,52440,52770,52970,52030,52920,52510,480,70,343244,"9,012,161.23",210336
,20170829,52920,52510,52960,53050,52430,52670,52710,160,200,246030,"6,484,993.32",195532
,20170830,52670,52710,52880,52980,52510,52700,52730,-10,20,235602,"6,212,470.93",189436
,20170831,52700,52730,52530,52880,52360,52820,52650,90,-80,212712,"5,600,545.09",183476
,20170901,52820,52650,52960,52960,52560,52800,52720,150,70,176536,"4,654,318.40",170188
,20170904,52800,52720,52530,53400,52500,53150,53010,430,290,215214,"5,705,086.76",165340
,20170905,53150,53010,53080,53700,53020,53610,53350,600,340,159896,"4,265,568.29",164734
,20170906,53610,53350,53400,53480,52650,53160,53110,-190,-240,178124,"4,730,869.69",146292
,20170907,53160,53110,53030,53280,52620,52720,52960,-390,-150,157402,"4,168,030.08",139150
,20170908,52720,52960,52730,52830,51600,51730,52330,-1230,-630,160584,"4,202,162.33",131184
,20170911,51730,52330,51620,51760,50870,51470,51290,-860,-1040,125468,"3,217,959.13",127504
,20170912,51470,51290,51700,51880,51360,51620,51590,330,300,83714,"2,159,605.05",125446
,20170913,51620,51590,51000,51440,50940,50970,51200,-620,-390,90312,"2,312,207.33",123900
,20170914,50970,51200,50560,50780,50320,50330,50530,-870,-670,101938,"2,575,783.06",120432
,20170915,50330,50530,50250,50560,50110,50330,50330,-200,-200,93372,"2,349,826.64",113706
,20170918,50330,50330,50220,50690,49820,50630,50370,300,40,89916,"2,264,864.68",108110
,20170919,50630,50370,50570,50820,50390,50640,50670,270,300,64206,"1,626,660.48",100812
,20170920,50640,50670,50650,50880,50460,50720,50690,50,20,57214,"1,450,136.95",95002
,20170921,50720,50690,50680,50760,49940,50170,50240,-520,-450,86922,"2,183,572.86",86764
,20170922,50170,50240,50150,50370,49300,49570,49710,-670,-530,87976,"2,186,818.73",79420
,20170925,49570,49710,49780,50430,49750,50230,50180,520,470,62928,"1,579,176.16",70302
,20170926,50230,50180,50170,50750,50110,50590,50510,410,330,54922,"1,387,222.94",63712
,20170927,50590,50510,50440,50620,50050,50500,50340,-10,-170,45648,"1,149,074.58",59204
,20170928,50500,50340,50570,50640,50090,50610,50360,270,20,49984,"1,258,801.33",51284
,20170929,50610,50360,50760,51920,50590,51580,51260,1220,900,35670,"914,322.56",46288
,20171009,51580,51260,52060,52320,51900,52110,52100,850,840,31928,"831,873.40",39140
,20171010,52110,52100,52100,52310,51850,51980,52130,-120,30,38230,"996,646.25",28930
,20171011,51980,52130,51940,52740,51940,52680,52370,550,240,26290,"688,490.65",24210
,20171012,52680,52370,52600,53970,52480,53730,53390,1360,1020,19420,"518,490.30",17440
,20171013,53730,53390,53800,54100,53650,53870,53790,480,400,16260,"437,353.30",12300
,20171016,53870,53790,54210,55450,53600,55300,54020,1510,230,5210,"140,735.40",10430
cu1711,20170103,46830,46800,47630,47980,47200,47210,47760,410,960,2374,"56,694.97",4370
,20170104,47210,47760,47420,47580,46280,47100,46950,-660,-810,764,"17,936.79",4592
,20170105,47100,46950,46920,47690,46910,47210,47480,260,530,3118,"74,031.38",6202
,20170106,47210,47480,47020,47190,46460,46510,46640,-970,-840,886,"20,661.80",6330
,20170109,46510,46640,46620,46910,46390,46750,46780,110,140,350,"8,186.87",6388
,20170110,46750,46780,46590,47200,46500,47190,46840,410,60,242,"5,667.74",6364
,20170111,47190,46840,47460,48590,47460,48190,48100,1350,1260,4708,"113,245.60",8654
,20170112,48190,48100,48000,48350,47940,48050,48130,-50,30,1254,"30,182.21",8762
,20170113,48050,48130,48490,48920,48200,48200,48690,70,560,1416,"34,478.31",8718
,20170116,48200,48690,48200,49360,48200,49050,49000,360,310,356,"8,722.88",8716
,20170117,49050,49000,48940,48990,47700,47860,48440,-1140,-560,314,"7,606.02",8694
,20170118,47860,48440,47980,48030,45040,47040,46390,-1400,-2050,12098,"280,632.37",5114
,20170119,47040,46390,47040,47380,46720,47220,47140,830,750,894,"21,072.39",4540
,20170120,47220,47140,47020,47050,46450,46470,46850,-670,-290,122,"2,858.35",4528
,20170123,46470,46850,46730,47570,46590,47240,47250,390,400,78,"1,843.08",4522
,20170124,47240,47250,46950,47510,46900,47510,47290,260,40,316,"7,472.95",4532
,20170125,47510,47290,47950,48920,47850,48440,48560,1150,1270,3468,"84,216.54",5148
,20170126,48440,48560,48210,48850,48190,48810,48490,250,-70,108,"2,618.82",5138
,20170203,48810,48490,47900,48120,47370,47500,47610,-990,-880,72,"1,713.96",5146
,20170206,47500,47610,47610,47620,47150,47300,47370,-310,-240,128,"3,032.12",5172
,20170207,47300,47370,47550,47710,47480,47700,47600,330,230,68,"1,618.59",5174
,20170208,47700,47600,47450,48540,47450,48270,48240,670,640,234,"5,644.94",5176
,20170209,48270,48240,48470,48760,48160,48360,48530,120,290,226,"5,484.68",5188
,20170210,48360,48530,48250,48880,48090,48660,48580,130,50,132,"3,206.45",5258
,20170213,48660,48580,48720,51900,48720,51190,50900,2610,2320,4950,"125,978.99",7414
,20170214,51190,50900,51000,51100,50630,50750,50910,-150,10,1156,"29,429.73",7616
,20170215,50750,50910,50920,50950,49400,49700,50020,-1210,-890,844,"21,109.57",7680
,20170216,49700,50020,49470,50100,49400,49400,49900,-620,-120,692,"17,267.66",7786
,20170217,49400,49900,49180,49580,49180,49430,49420,-470,-480,106,"2,619.59",7762
,20170220,49430,49420,49100,49690,48900,49670,49380,250,-40,116,"2,864.20",7742
,20170221,49670,49380,49820,50110,49730,49800,49980,420,600,172,"4,298.28",7794
,20170222,49800,49980,49710,49710,49450,49560,49570,-420,-410,6,148.72,7796
,20170223,49560,49570,49520,49520,49160,49210,49210,-360,-360,208,"5,118.31",7658
,20170224,49210,49210,49500,49500,47920,48730,48650,-480,-560,152,"3,697.73",7692
,20170227,48730,48650,48760,49150,48460,48640,48850,-10,200,86,"2,100.59",7674
,20170228,48640,48850,49010,49050,48600,48700,48840,-150,-10,146,"3,565.79",7688
,20170301,48700,48840,48820,49700,48690,49540,49200,700,360,72,"1,771.45",7684
,20170302,49540,49200,49880,49990,49460,49530,49730,330,530,54,"1,342.88",7674
,20170303,49530,49730,49190,49280,48850,49200,49080,-530,-650,38,932.65,7660
,20170306,49200,49080,49160,49410,48770,48770,49160,-310,80,182,"4,474.29",7680
,20170307,48770,49160,48680,48750,48390,48680,48630,-480,-530,50,"1,215.81",7668
,20170308,48680,48630,48400,48400,47990,48240,48130,-390,-500,198,"4,765.15",7662
,20170309,48240,48130,48180,48180,47260,47280,47660,-850,-470,292,"6,958.86",7582
,20170310,47280,47660,46920,47550,46890,47440,47370,-220,-290,104,"2,463.66",7586
,20170313,47440,47370,47690,48170,47300,48170,47800,800,430,184,"4,397.96",7678
,20170314,48170,47800,48200,48250,48030,48060,48180,260,380,506,"12,191.31",7572
,20170315,48060,48180,47950,48590,47690,48500,48060,320,-120,466,"11,198.62",7592
,20170316,48500,48060,48780,49000,48630,48920,48840,860,780,78,"1,904.84",7614
,20170317,48920,48840,48910,48910,48510,48510,48760,-330,-80,56,"1,365.44",7642
,20170320,48510,48760,48810,49270,48710,48710,48950,-50,190,198,"4,846.80",7690
,20170321,48710,48950,48920,48930,47930,48150,48460,-800,-490,54,"1,308.62",7694
,20170322,48150,48460,48070,48120,47280,47500,47680,-960,-780,96,"2,288.72",7676
,20170323,47500,47680,47520,48050,47460,47970,47940,290,260,48,"1,150.74",7700
,20170324,47970,47940,47950,47950,47750,47890,47870,-50,-70,36,861.70,7696
,20170327,47890,47870,47890,48000,46970,47130,47180,-740,-690,166,"3,916.32",7740
,20170328,47130,47180,46970,47770,46530,47560,47190,380,10,158,"3,728.13",7708
,20170329,47560,47190,47790,48390,47660,48300,48180,1110,990,116,"2,794.54",7748
,20170330,48300,48180,48410,48810,48070,48190,48540,10,360,658,"15,971.75",7992
,20170331,48190,48540,48500,49370,48480,48670,48930,130,390,682,"16,685.82",8208
,20170405,48670,48930,48000,48490,47980,48380,48240,-550,-690,152,"3,666.61",8214
,20170406,48380,48240,48750,49300,48690,48790,49010,550,770,1742,"42,693.73",9126
,20170407,48790,49010,48840,49070,47900,47900,48620,-1110,-390,388,"9,432.84",9204
,20170410,47900,48620,47830,48260,47750,48040,48040,-580,-580,304,"7,303.01",9214
,20170411,48040,48040,47900,47900,47390,47410,47580,-630,-460,410,"9,755.85",9270
,20170412,47410,47580,47490,47750,46950,46950,47330,-630,-250,220,"5,206.50",9264
,20170413,46950,47330,47020,47250,46420,47170,46870,-160,-460,298,"6,983.79",9342
,20170414,47170,46870,47000,47160,46620,46910,46890,40,20,206,"4,830.57",9330
,20170417,46910,46890,47090,48320,46840,47100,47400,210,510,380,"9,006.87",9378
,20170418,47100,47400,47350,47550,46380,46400,46850,-1000,-550,498,"11,666.45",9496
,20170419,46400,46850,46530,46650,45760,46390,46110,-460,-740,606,"13,972.52",9638
,20170420,46390,46110,46350,46590,45370,46010,45990,-100,-120,354,"8,141.62",9760
,20170421,46010,45990,46290,46530,46020,46400,46240,410,250,88,"2,034.89",9734
,20170424,46400,46240,46300,46450,45960,46420,46300,180,60,304,"7,037.66",9754
,20170425,46420,46300,46230,46730,46110,46510,46460,210,160,156,"3,623.95",9738
,20170426,46510,46460,46730,46940,46560,46820,46820,360,360,158,"3,699.04",9666
,20170427,46820,46820,46880,47000,46810,46890,46910,70,90,92,"2,158.25",9678
,20170428,46890,46910,46900,47020,46510,46730,46810,-180,-100,230,"5,384.16",9756
,20170502,46730,46810,47440,47570,47240,47290,47410,480,600,784,"18,588.25",10166
,20170503,47290,47410,47340,47410,47040,47090,47170,-320,-240,352,"8,303.07",10330
,20170504,47090,47170,46310,46480,45640,45770,46060,-1400,-1110,376,"8,659.88",10462
,20170505,45770,46060,45560,45760,45280,45540,45630,-520,-430,360,"8,213.54",10736
,20170508,45540,45630,45700,45950,45040,45040,45400,-590,-230,662,"15,028.19",11064
,20170509,45040,45400,45020,45320,44840,45180,45110,-220,-290,652,"14,707.44",11424
,20170510,45180,45110,45330,45660,45210,45290,45380,180,270,1250,"28,368.30",12240
,20170511,45290,45380,45490,45670,45130,45660,45400,280,20,144,"3,269.23",12294
,20170512,45660,45400,45880,45920,45300,45390,45490,-10,90,258,"5,869.08",12344
,20170515,45390,45490,45490,45870,45370,45840,45760,350,270,934,"21,370.43",12926
,20170516,45840,45760,45980,45980,45500,45590,45690,-170,-70,454,"10,372.53",12890
,20170517,45590,45690,45770,46040,45720,45810,45890,120,200,402,"9,224.70",12936
,20170518,45810,45890,45570,45850,45380,45520,45580,-370,-310,150,"3,418.72",12942
,20170519,45520,45580,45110,45730,45100,45720,45600,140,20,210,"4,788.78",12908
,20170522,45720,45600,45910,46480,45910,46210,46240,610,640,998,"23,074.81",13320
,20170523,46210,46240,46330,46530,46220,46220,46360,-20,120,502,"11,638.25",13384
,20170524,46220,46360,46520,47010,45930,46170,46170,-190,-190,3844,"88,744.97",13858
,20170525,46170,46170,46340,46440,46180,46330,46290,160,120,590,"13,657.12",13604
,20170526,46330,46290,46390,46680,46250,46360,46420,70,130,316,"7,334.83",13680
,20170531,46360,46420,46110,46210,45590,45650,45960,-770,-460,1340,"30,798.95",14564
,20170601,45650,45960,45750,45910,45480,45720,45750,-240,-210,1008,"23,058.61",14948
,20170602,45720,45750,45820,45920,45660,45720,45760,-30,10,214,"4,897.18",14988
,20170605,45720,45760,45230,45780,45230,45650,45600,-110,-160,838,"19,107.01",15180
,20170606,45650,45600,45530,45690,45260,45290,45500,-310,-100,616,"14,014.03",15224
,20170607,45290,45500,45130,45610,45030,45230,45340,-270,-160,748,"16,957.55",15310
,20170608,45230,45340,45290,45670,45200,45660,45430,320,90,1530,"34,755.60",15654
,20170609,45660,45430,45890,46310,45860,46230,46080,800,650,2600,"59,908.91",16206
,20170612,46230,46080,46580,46960,46470,46740,46720,660,640,2630,"61,438.06",16754
,20170613,46740,46720,46650,46690,46160,46190,46370,-530,-350,1576,"36,545.19",17238
,20170614,46190,46370,46070,46330,46000,46280,46130,-90,-240,1402,"32,337.94",17512
,20170615,46280,46130,46190,46240,45740,45970,46000,-160,-130,1558,"35,836.95",17704
,20170616,45970,46000,45910,46120,45750,45830,45950,-170,-50,800,"18,380.74",17778
,20170619,45830,45950,46000,46110,45800,46020,45970,70,20,1468,"33,744.43",18340
,20170620,46020,45970,46200,46420,46120,46210,46260,240,290,2306,"53,347.55",18730
,20170621,46210,46260,45960,46000,45760,45900,45880,-360,-380,1404,"32,210.12",18942
,20170622,45900,45880,46120,46590,46110,46170,46330,290,450,1962,"45,451.58",19200
,20170623,46170,46330,46280,47100,46270,47100,46690,770,360,3124,"72,937.02",19382
,20170626,47100,46690,47010,47200,46740,47190,46940,500,250,3444,"80,840.28",20516
,20170627,47190,46940,47040,47090,46800,47050,46950,110,10,2554,"59,965.23",20382
,20170628,47050,46950,47010,47350,46960,47260,47170,310,220,3336,"78,690.46",21198
,20170629,47260,47170,47220,47990,47150,47890,47720,720,550,15202,"362,753.93",25580
,20170630,47890,47720,47900,48170,47700,47880,47890,160,170,6846,"163,951.96",24694
,20170703,47880,47890,47860,47920,47670,47840,47770,-50,-120,4404,"105,205.00",25638
,20170704,47840,47770,47730,47790,47200,47270,47410,-500,-360,5082,"120,470.74",27284
,20170705,47270,47410,47370,47620,47360,47410,47460,0,50,3324,"78,879.97",28414
,20170706,47410,47460,47120,47200,46960,47190,47090,-270,-370,4298,"101,209.34",29888
,20170707,47190,47090,47170,47370,47040,47360,47170,270,80,2452,"57,833.03",30172
,20170710,47360,47170,47160,47280,47000,47020,47120,-150,-50,3650,"85,995.63",30322
,20170711,47020,47120,46900,47420,46840,47300,47090,180,-30,3582,"84,349.82",30568
,20170712,47300,47090,47150,47750,47100,47580,47530,490,440,7548,"179,385.93",31240
,20170713,47580,47530,47660,47800,47420,47640,47610,110,80,4124,"98,175.78",31496
,20170714,47640,47610,47680,47700,47210,47400,47410,-210,-200,3948,"93,593.05",31824
,20170717,47400,47410,47400,48170,47400,48000,47780,590,370,10872,"259,749.01",34232
,20170718,48000,47780,48180,48290,47820,47920,48080,140,300,12886,"309,822.05",37284
,20170719,47920,48080,47980,48190,47920,48180,48040,100,-40,8184,"196,602.13",38778
,20170720,48180,48040,48100,48140,47820,48030,47990,-10,-50,9274,"222,541.68",41184
,20170721,48030,47990,48050,48320,47650,48190,48040,200,50,11132,"267,438.38",43722
,20170724,48190,48040,48390,48410,47950,47970,48120,-70,80,8452,"203,356.67",44870
,20170725,47970,48120,48130,48920,48030,48810,48530,690,410,21042,"510,673.08",48882
,20170726,48810,48530,49100,51080,49100,50360,50120,1830,1590,75776,"1,899,250.62",60086
,20170727,50360,50120,50300,50710,50200,50310,50430,190,310,20770,"523,815.19",61122
,20170728,50310,50430,50470,50710,49830,50200,50250,-230,-180,25286,"635,352.89",65404
,20170731,50200,50250,50310,51150,50220,50990,50660,740,410,34458,"872,890.83",72356
,20170801,50990,50660,50680,50760,50410,50490,50610,-170,-50,18494,"468,032.70",72888
,20170802,50490,50610,50450,50660,50120,50330,50370,-280,-240,23428,"590,098.18",74632
,20170803,50330,50370,50340,50760,50150,50180,50520,-190,150,27320,"690,138.90",75656
,20170804,50180,50520,50370,50800,50270,50580,50570,60,50,29352,"742,202.38",78394
,20170807,50580,50570,50580,51270,50330,50620,50580,50,10,36496,"923,039.84",80458
,20170808,50620,50580,50620,51310,50530,50610,50950,30,370,49790,"1,268,470.87",88334
,20170809,50610,50950,50610,51620,50610,51460,51340,510,390,57480,"1,475,543.88",93588
,20170810,51460,51340,51450,51520,50800,50910,51070,-430,-270,39012,"996,276.93",98896
,20170811,50910,51070,50890,50890,49900,50100,50280,-970,-790,67588,"1,699,320.30",103508
,20170814,50100,50280,50350,50650,50150,50250,50440,-30,160,44102,"1,112,333.31",111514
,20170815,50250,50440,50340,50550,50240,50510,50430,70,-10,32266,"813,746.95",111984
,20170816,50510,50430,50450,50570,50030,50330,50260,-100,-170,44126,"1,109,104.72",114784
,20170817,50330,50260,50750,51840,50710,51600,51430,1340,1170,99360,"2,555,348.23",128362
,20170818,51600,51430,51250,51410,50800,51170,51050,-260,-380,76348,"1,948,950.67",128010
,20170821,51170,51050,51180,52040,50760,51790,51350,740,300,97150,"2,494,797.47",128846
,20170822,51790,51350,51800,52500,51510,52360,51900,1010,550,103326,"2,681,321.60",128804
,20170823,52360,51900,52400,52480,51440,51700,51780,-200,-120,81156,"2,101,493.73",126028
,20170824,51700,51780,51650,52280,51500,52010,51910,230,130,72992,"1,894,567.59",126950
,20170825,52010,51910,52010,52960,51930,52890,52580,980,670,99648,"2,620,145.80",133484
,20170828,52890,52580,52950,53110,52160,53070,52670,490,90,92546,"2,437,564.71",135828
,20170829,53070,52670,53080,53190,52550,52830,52830,160,160,83816,"2,214,381.34",138342
,20170830,52830,52830,53010,53100,52620,52820,52850,-10,20,86096,"2,275,415.10",148580
,20170831,52820,52850,52610,52970,52470,52900,52770,50,-80,79670,"2,102,152.88",153608
,20170901,52900,52770,53100,53100,52640,52890,52800,120,30,91590,"2,418,402.54",154508
,20170904,52890,52800,52630,53490,52560,53250,53100,450,300,136426,"3,622,502.17",162782
,20170905,53250,53100,53150,53830,53110,53740,53480,640,380,132624,"3,546,490.21",180662
,20170906,53740,53480,53490,53600,52730,53290,53220,-190,-260,172018,"4,578,111.95",179300
,20170907,53290,53220,53130,53400,52720,52790,53050,-430,-170,200062,"5,306,736.50",179950
,20170908,52790,53050,52780,52910,51650,51740,52380,-1310,-670,323194,"8,464,643.94",178582
,20170911,51740,52380,51700,51830,50910,51530,51340,-850,-1040,290212,"7,449,974.29",180608
,20170912,51530,51340,51760,51950,51420,51700,51680,360,340,219924,"5,683,313.68",185900
,20170913,51700,51680,51120,51510,50980,51000,51270,-680,-410,231800,"5,943,320.06",192222
,20170914,51000,51270,50640,50850,50370,50380,50580,-890,-690,285450,"7,220,172.90",189556
,20170915,50380,50580,50380,50620,50170,50380,50400,-200,-180,229932,"5,795,344.31",190910
,20170918,50380,50400,50240,50790,49860,50700,50350,300,-50,284904,"7,172,844.28",189400
,20170919,50700,50350,50650,50910,50460,50730,50730,380,380,177744,"4,508,878.90",187630
,20170920,50730,50730,50710,50990,50550,50810,50770,80,40,180602,"4,585,200.08",187284
,20170921,50810,50770,50770,50850,49940,50160,50380,-610,-390,257624,"6,489,813.83",189334
,20170922,50160,50380,50260,50470,49340,49630,49850,-750,-530,351468,"8,760,836.16",187612
,20170925,49630,49850,49840,50510,49820,50260,50160,410,310,247008,"6,195,401.74",179006
,20170926,50260,50160,50210,50820,50170,50640,50500,480,340,173940,"4,392,625.40",176102
,20170927,50640,50500,50460,50680,50080,50540,50370,40,-130,201670,"5,079,350.04",169582
,20170928,50540,50370,50590,50700,50060,50620,50410,250,40,247942,"6,249,784.40",161250
,20170929,50620,50410,50770,51850,50620,51840,51250,1430,840,292024,"7,483,656.35",139202
,20171009,51840,51250,52100,52400,51920,52110,52120,860,870,111732,"2,912,255.33",136710
,20171010,52110,52120,52020,52310,51800,51900,52070,-220,-50,148916,"3,877,232.13",139108
,20171011,51900,52070,51940,52540,51760,52470,52230,400,160,162238,"4,237,041.37",141090
,20171012,52470,52230,52440,53440,52260,53320,52970,1090,740,153954,"4,078,090.91",137818
,20171013,53320,52970,53450,53760,53260,53550,53500,580,530,95552,"2,556,072.39",134890
,20171016,53550,53500,53560,55340,53210,55060,54060,1560,560,129180,"3,492,213.73",132076
,20171017,55060,54060,55080,55830,54460,55160,55370,1100,1310,105426,"2,919,189.81",119454
,20171018,55160,55370,55200,55340,54560,55000,54970,-370,-400,68986,"1,896,380.69",112978
,20171019,55000,54970,54950,55280,54530,54700,54790,-270,-180,63342,"1,735,332.49",107452
,20171020,54700,54790,54500,55470,54230,55180,54850,390,60,62400,"1,711,410.16",100820
,20171023,55180,54850,55180,55220,54180,54500,54720,-350,-130,66770,"1,827,122.68",94268
,20171024,54500,54720,54610,55900,54610,55600,55520,880,800,66378,"1,842,872.05",89376
,20171025,55600,55520,55630,55680,54440,54750,55040,-770,-480,61670,"1,697,323.11",83184
,20171026,54750,55040,54910,55320,54800,54870,54980,-170,-60,49926,"1,372,508.45",79560
,20171027,54870,54980,54760,54970,53950,54100,54440,-880,-540,57240,"1,558,229.59",70706
,20171030,54100,54440,53800,53890,53370,53690,53630,-750,-810,47876,"1,283,854.97",62756
,20171031,53690,53630,53690,54260,53470,53880,53730,250,100,41656,"1,119,167.60",56450
,20171101,53880,53730,53600,54920,53520,54500,54430,770,700,30440,"828,478.05",53100
,20171102,54500,54430,54440,54440,53900,54060,54160,-370,-270,28150,"762,430.65",48940
,20171103,54060,54160,53860,54740,53860,54320,54390,160,230,24490,"666,029.90",45790
,20171106,54320,54390,54220,54670,53850,54530,54300,140,-90,22320,"606,095.95",39520
,20171107,54530,54300,54500,54870,54300,54460,54470,160,170,24900,"678,239.80",32960
,20171108,54460,54470,54220,54250,53370,53390,53650,-1080,-820,32560,"873,569.65",27580
,20171109,53390,53650,53390,53830,53080,53190,53450,-460,-200,24590,"657,278.05",21850
,20171110,53190,53450,53230,53650,53130,53590,53450,140,0,19530,"521,985.30",16410
,20171113,53590,53450,53520,53550,53350,53540,53450,90,0,15600,"416,937.60",11720
,20171114,53540,53450,53520,54290,53200,53780,53870,330,420,12230,"329,438.00",6670
,20171115,53780,53870,53700,53820,52560,52620,52820,-1250,-1050,4960,"131,000.00",6100
cu1712,20170103,47170,47010,47650,47980,47350,47350,47820,340,810,1766,"42,231.55",5004
,20170104,47350,47820,47570,47680,46560,47270,47130,-550,-690,2400,"56,562.31",6472
,20170105,47270,47130,47130,47800,47130,47360,47640,230,510,1554,"37,017.83",7266
,20170106,47360,47640,47230,47320,46620,46620,46910,-1020,-730,566,"13,276.58",7210
,20170109,46620,46910,46700,47040,46400,47040,46960,130,50,758,"17,799.86",7376
,20170110,47040,46960,46870,47320,46660,47300,47130,340,170,268,"6,316.32",7368
,20170111,47300,47130,47690,48580,47570,48460,48240,1330,1110,786,"18,959.07",7640
,20170112,48460,48240,48180,48430,48100,48150,48250,-90,10,540,"13,029.60",7858
,20170113,48150,48250,48690,49000,48450,48450,48770,200,520,628,"15,314.08",8166
,20170116,48450,48770,48530,49490,48530,49220,49130,450,360,204,"5,011.70",8164
,20170117,49220,49130,48960,49140,47800,47900,48630,-1230,-500,632,"15,367.97",8246
,20170118,47900,48630,48060,48060,45230,47070,46530,-1560,-2100,11994,"279,078.06",4338
,20170119,47070,46530,46870,47340,46730,47270,47070,740,540,426,"10,026.18",4270
,20170120,47270,47070,47100,47100,46410,46460,46810,-610,-260,222,"5,196.60",4238
,20170123,46460,46810,46620,47560,46610,47090,47220,280,410,158,"3,731.03",4220
,20170124,47090,47220,47100,47510,46950,47510,47220,290,0,202,"4,769.23",4236
,20170125,47510,47220,47990,48960,47920,48480,48750,1260,1530,4768,"116,242.42",6632
,20170126,48480,48750,48400,48900,48210,48800,48370,50,-380,190,"4,595.99",6648
,20170203,48800,48370,47890,48030,47360,47590,47700,-780,-670,92,"2,194.32",6644
,20170206,47590,47700,47550,47700,47180,47450,47450,-250,-250,258,"6,121.58",6716
,20170207,47450,47450,47490,47840,47470,47700,47610,250,160,308,"7,331.95",6886
,20170208,47700,47610,47650,48690,47620,48640,48330,1030,720,802,"19,382.40",7328
,20170209,48640,48330,48640,48840,48310,48360,48680,30,350,330,"8,033.05",7384
,20170210,48360,48680,48410,49060,48100,48780,48660,100,-20,232,"5,645.56",7474
,20170213,48780,48660,48880,52000,48850,51300,51010,2640,2350,6400,"163,246.17",10910
,20170214,51300,51010,51180,51240,50740,50960,50990,-50,-20,2012,"51,301.82",11536
,20170215,50960,50990,50970,51000,49250,49790,50110,-1200,-880,2554,"64,000.82",11736
,20170216,49790,50110,49790,50190,49510,49680,49900,-430,-210,828,"20,662.50",11684
,20170217,49680,49900,49700,49820,49200,49600,49560,-300,-340,334,"8,277.56",11584
,20170220,49600,49560,49470,49880,48970,49880,49500,320,-60,372,"9,207.21",11454
,20170221,49880,49500,50420,50420,49770,49960,50080,460,580,170,"4,256.91",11432
,20170222,49960,50080,49990,50140,49620,49680,49830,-400,-250,42,"1,046.44",11438
,20170223,49680,49830,49500,49990,49150,49380,49450,-450,-380,220,"5,440.56",11434
,20170224,49380,49450,49600,49600,48110,48870,48760,-580,-690,502,"12,240.02",11488
,20170227,48870,48760,48900,49310,48640,48800,48890,40,130,268,"6,552.08",11462
,20170228,48800,48890,49050,49130,48700,48800,48930,-90,40,1058,"25,885.88",12202
,20170301,48800,48930,48850,49790,48850,49660,49330,730,400,142,"3,502.70",12258
,20170302,49660,49330,49930,50050,49570,49700,49930,370,600,254,"6,342.07",12416
,20170303,49700,49930,49380,49390,48880,49370,49160,-560,-770,202,"4,965.72",12378
,20170306,49370,49160,49260,49500,48810,49030,49210,-130,50,240,"5,905.72",12390
,20170307,49030,49210,48830,48890,48640,48820,48740,-390,-470,130,"3,168.51",12410
,20170308,48820,48740,48570,48730,48030,48240,48260,-500,-480,328,"7,916.21",12370
,20170309,48240,48260,48110,48400,47350,47350,47830,-910,-430,300,"7,175.44",12356
,20170310,47350,47830,47250,47650,47030,47570,47470,-260,-360,486,"11,537.52",12236
,20170313,47570,47470,47550,48280,47380,48280,47860,810,390,170,"4,068.32",12294
,20170314,48280,47860,48350,48380,47980,48240,48270,380,410,76,"1,834.41",12308
,20170315,48240,48270,47960,48770,47840,48530,48110,260,-160,1330,"31,993.81",11822
,20170316,48530,48110,48890,49150,48640,49040,48930,930,820,360,"8,808.84",11976
,20170317,49040,48930,49090,49090,48590,48670,48790,-260,-140,190,"4,635.60",12010
,20170320,48670,48790,48950,49420,48820,48880,48990,90,200,804,"19,696.83",12468
,20170321,48880,48990,48930,49230,48050,48270,48440,-720,-550,332,"8,041.93",12584
,20170322,48270,48440,48140,48350,47460,47700,47710,-740,-730,348,"8,302.56",12378
,20170323,47700,47710,47700,48230,47670,48100,48010,390,300,112,"2,688.80",12390
,20170324,48100,48010,47990,48170,47800,48070,47900,60,-110,376,"9,006.79",12704
,20170327,48070,47900,47820,47990,47110,47200,47350,-700,-550,372,"8,808.05",12618
,20170328,47200,47350,47010,47890,46620,47580,47090,230,-260,350,"8,242.11",12514
,20170329,47580,47090,47740,48650,47740,48420,48180,1330,1090,258,"6,216.46",12484
,20170330,48420,48180,48430,48850,48170,48310,48430,130,250,896,"21,699.98",12770
,20170331,48310,48430,48360,49480,48360,48780,48970,350,540,844,"20,666.00",13054
,20170405,48780,48970,48350,48630,48100,48500,48270,-470,-700,310,"7,482.34",13078
,20170406,48500,48270,48920,49460,48860,48950,49220,680,950,1988,"48,926.93",14232
,20170407,48950,49220,49020,49240,48050,48250,48720,-970,-500,714,"17,393.80",14344
,20170410,48250,48720,47980,48650,47970,48200,48230,-520,-490,382,"9,213.62",14324
,20170411,48200,48230,48100,48100,47580,47640,47820,-590,-410,554,"13,248.57",14364
,20170412,47640,47820,47720,47950,47150,47230,47580,-590,-240,806,"19,174.76",14574
,20170413,47230,47580,47140,47420,46460,47400,46980,-180,-600,590,"13,861.10",14770
,20170414,47400,46980,47030,47360,46660,47040,47130,60,150,554,"13,056.11",14662
,20170417,47040,47130,47420,48480,46920,47340,47470,210,340,296,"7,026.40",14616
,20170418,47340,47470,47500,47720,46600,46620,47090,-850,-380,1272,"29,951.35",15120
,20170419,46620,47090,46650,46800,45910,46600,46400,-490,-690,1086,"25,197.03",15154
,20170420,46600,46400,46470,46710,45480,46150,45980,-250,-420,1428,"32,832.57",15290
,20170421,46150,45980,46380,46700,46140,46650,46400,670,420,300,"6,960.98",15264
,20170424,46650,46400,46400,46630,46110,46520,46330,120,-70,182,"4,216.20",15280
,20170425,46520,46330,46300,46870,46200,46600,46480,270,150,272,"6,321.76",15252
,20170426,46600,46480,46860,47120,46600,46940,46900,460,420,326,"7,646.30",15216
,20170427,46940,46900,47040,47180,46890,47010,47040,110,140,272,"6,398.23",15316
,20170428,47010,47040,47080,47150,46610,47000,46970,-40,-70,446,"10,476.40",15442
,20170502,47000,46970,47630,47690,47370,47420,47540,450,570,860,"20,443.77",15988
,20170503,47420,47540,47580,47590,47200,47200,47390,-340,-150,264,"6,255.56",16026
,20170504,47200,47390,46850,46850,45740,45900,46230,-1490,-1160,640,"14,796.47",16026
,20170505,45900,46230,45690,45920,45410,45600,45590,-630,-640,1172,"26,718.49",15904
,20170508,45600,45590,45870,46130,45270,45290,45560,-300,-30,1674,"38,141.25",16344
,20170509,45290,45560,45180,45410,45050,45350,45260,-210,-300,1222,"27,656.05",16554
,20170510,45350,45260,45350,45850,45350,45450,45560,190,300,1634,"37,223.63",17266
,20170511,45450,45560,45630,45900,45260,45800,45610,240,50,430,"9,806.84",17308
,20170512,45800,45610,46040,46090,45460,45550,45770,-60,160,266,"6,087.44",17346
,20170515,45550,45770,45690,46060,45550,46030,45870,260,100,464,"10,643.06",17560
,20170516,46030,45870,46110,46110,45640,45760,45800,-110,-70,1026,"23,497.82",18046
,20170517,45760,45800,45920,46170,45850,46040,45980,240,180,900,"20,692.05",18352
,20170518,46040,45980,45950,45950,45490,45640,45680,-340,-300,226,"5,162.77",18418
,20170519,45640,45680,45200,45930,45200,45890,45730,210,50,442,"10,108.32",18538
,20170522,45890,45730,46050,46590,46050,46380,46400,650,670,1010,"23,432.28",18818
,20170523,46380,46400,46560,46680,46350,46370,46530,-30,130,1114,"25,919.38",19124
,20170524,46370,46530,46380,46700,46120,46350,46440,-180,-90,1808,"41,989.02",19888
,20170525,46350,46440,46510,46590,46320,46470,46460,30,20,670,"15,565.88",20264
,20170526,46470,46460,46580,46850,46430,46570,46670,110,210,684,"15,963.84",20594
,20170531,46570,46670,46280,46370,45750,45760,46090,-910,-580,648,"14,936.06",20734
,20170601,45760,46090,45900,46080,45650,45840,45920,-250,-170,1196,"27,464.51",20860
,20170602,45840,45920,45890,46100,45810,45880,45960,-40,40,274,"6,296.97",20870
,20170605,45880,45960,45360,45950,45290,45820,45650,-140,-310,1904,"43,464.58",19994
,20170606,45820,45650,45700,45860,45400,45410,45610,-240,-40,1086,"24,768.16",19520
,20170607,45410,45610,45350,45750,45180,45380,45400,-230,-210,596,"13,531.33",19410
,20170608,45380,45400,45420,45820,45380,45810,45630,410,230,1358,"30,984.57",19628
,20170609,45810,45630,46170,46470,46010,46390,46220,760,590,1610,"37,210.63",19952
,20170612,46390,46220,46710,47170,46640,46840,46820,620,600,1640,"38,394.54",20112
,20170613,46840,46820,46790,46830,46300,46350,46570,-470,-250,710,"16,534.29",20174
,20170614,46350,46570,46230,46480,46150,46430,46300,-140,-270,648,"15,002.55",20130
,20170615,46430,46300,46380,46380,45950,46140,46150,-160,-150,656,"15,137.69",19994
,20170616,46140,46150,45960,46240,45940,46040,46060,-110,-90,292,"6,725.23",19982
,20170619,46040,46060,46120,46250,45960,46150,46110,90,50,782,"18,031.98",20218
,20170620,46150,46110,46390,46580,46280,46410,46440,300,330,840,"19,507.22",20502
,20170621,46410,46440,46060,46140,45920,46070,46040,-370,-400,596,"13,720.80",20560
,20170622,46070,46040,46380,46750,46260,46330,46510,290,470,794,"18,467.28",20626
,20170623,46330,46510,46520,47220,46430,47210,46700,700,190,1042,"24,334.81",21140
,20170626,47210,46700,47120,47370,46910,47320,47150,620,450,1492,"35,176.05",21814
,20170627,47320,47150,47180,47240,46990,47200,47080,50,-70,1118,"26,319.86",22150
,20170628,47200,47080,47190,47530,47150,47450,47380,370,300,1202,"28,476.61",22578
,20170629,47450,47380,47330,48230,47330,48080,47970,700,590,12162,"291,734.55",26088
,20170630,48080,47970,48140,48430,47910,48040,48140,70,170,4118,"99,129.03",25444
,20170703,48040,48140,47990,48100,47830,48060,47960,-80,-180,1340,"32,139.50",25694
,20170704,48060,47960,47850,47970,47400,47450,47680,-510,-280,1182,"28,184.16",25956
,20170705,47450,47680,47570,47780,47550,47560,47630,-120,-50,946,"22,532.87",26174
,20170706,47560,47630,47280,47380,47070,47380,47260,-250,-370,1030,"24,342.39",26284
,20170707,47380,47260,47340,47530,47100,47500,47330,240,70,494,"11,690.89",26292
,20170710,47500,47330,47340,47460,47170,47200,47310,-130,-20,1702,"40,267.78",26568
,20170711,47200,47310,47060,47600,47000,47540,47240,230,-70,1614,"38,128.78",26682
,20170712,47540,47240,47370,47930,47270,47690,47670,450,430,2876,"68,556.47",26840
,20170713,47690,47670,47860,47970,47600,47840,47780,170,110,1368,"32,687.63",27078
,20170714,47840,47780,47850,47860,47380,47550,47590,-230,-190,2116,"50,358.30",27486
,20170717,47550,47590,47570,48360,47550,48250,47950,660,360,3376,"80,954.06",28230
,20170718,48250,47950,48490,48500,48000,48130,48350,180,400,3580,"86,548.97",29238
,20170719,48130,48350,48150,48380,48100,48380,48220,30,-130,2808,"67,701.97",29492
,20170720,48380,48220,48250,48300,48000,48180,48180,-40,-40,2918,"70,305.64",29728
,20170721,48180,48180,48210,48510,47820,48360,48230,180,50,3486,"84,081.32",31162
,20170724,48360,48230,48580,48580,48130,48150,48270,-80,40,3424,"82,653.58",31980
,20170725,48150,48270,48360,49110,48210,49000,48670,730,400,9872,"240,251.97",35030
,20170726,49000,48670,49470,51270,49470,50600,50340,1930,1670,45178,"1,137,332.42",49174
,20170727,50600,50340,50580,50920,50410,50530,50650,190,310,12314,"311,865.13",49866
,20170728,50530,50650,50700,50910,50030,50400,50460,-250,-190,14082,"355,316.03",52228
,20170731,50400,50460,50480,51360,50400,51180,50890,720,430,16668,"424,140.27",56204
,20170801,51180,50890,51000,51000,50610,50680,50820,-210,-70,10094,"256,490.89",57420
,20170802,50680,50820,50650,50840,50310,50550,50550,-270,-270,10052,"254,113.70",57918
,20170803,50550,50550,50590,50930,50340,50340,50670,-210,120,11194,"283,627.88",58288
,20170804,50340,50670,50600,50970,50470,50750,50740,80,70,11226,"284,817.29",58710
,20170807,50750,50740,50730,51400,50510,50760,50790,20,50,12928,"328,318.72",59510
,20170808,50760,50790,50830,51490,50710,50770,51100,-20,310,13488,"344,648.65",60624
,20170809,50770,51100,50850,51780,50810,51610,51500,510,400,19894,"512,278.00",63348
,20170810,51610,51500,51500,51690,50970,51110,51270,-390,-230,14624,"374,933.95",66136
,20170811,51110,51270,51600,51600,50120,50300,50440,-970,-830,17576,"443,303.25",68812
,20170814,50300,50440,50580,50840,50320,50430,50580,-10,140,15574,"393,872.71",74620
,20170815,50430,50580,50450,50730,50410,50690,50600,110,20,7354,"186,072.70",75260
,20170816,50690,50600,50690,50750,50250,50520,50470,-80,-130,10072,"254,170.28",76412
,20170817,50520,50470,50940,52000,50810,51800,51600,1330,1130,30634,"790,394.73",80130
,20170818,51800,51600,51400,51570,50970,51420,51230,-180,-370,23974,"614,151.07",86390
,20170821,51420,51230,51420,52180,50980,51880,51470,650,240,29804,"767,081.54",91546
,20170822,51880,51470,51920,52470,51680,52440,52010,970,540,28182,"732,919.97",95836
,20170823,52440,52010,52500,52570,51590,51820,51920,-190,-90,23022,"597,687.77",96886
,20170824,51820,51920,51780,52400,51650,52150,52060,230,140,21778,"566,965.99",97514
,20170825,52150,52060,52190,53090,52070,53050,52760,990,700,42824,"1,129,787.19",100012
,20170828,53050,52760,53250,53250,52290,53220,52820,460,60,29376,"775,873.50",99890
,20170829,53220,52820,53230,53300,52680,52920,52970,100,150,23922,"633,574.96",99866
,20170830,52920,52970,53190,53230,52750,52950,52970,-20,0,28690,"759,874.41",105266
,20170831,52950,52970,52710,56140,52600,52980,52910,10,-60,34306,"907,717.12",114250
,20170901,52980,52910,53030,53110,52730,52950,52870,40,-40,41902,"1,107,875.35",118564
,20170904,52950,52870,52790,53560,52600,53340,53210,470,340,44146,"1,174,628.10",119438
,20170905,53340,53210,53340,53900,53210,53820,53550,610,340,32374,"866,943.93",121418
,20170906,53820,53550,53650,53680,52850,53350,53320,-200,-230,37472,"999,064.80",122968
,20170907,53350,53320,53230,53470,52800,52870,53100,-450,-220,42276,"1,122,554.00",122776
,20170908,52870,53100,52870,52980,51760,51880,52390,-1220,-710,84710,"2,219,322.16",127930
,20170911,51880,52390,51760,51920,51020,51600,51440,-790,-950,69208,"1,780,214.36",135552
,20170912,51600,51440,51820,52010,51500,51790,51740,350,300,51250,"1,325,958.90",135220
,20170913,51790,51740,51250,51600,51060,51080,51340,-660,-400,53326,"1,368,997.38",139796
,20170914,51080,51340,50680,50900,50460,50460,50670,-880,-670,64064,"1,623,186.95",137270
,20170915,50460,50670,50460,50690,50210,50450,50470,-220,-200,58436,"1,474,821.61",140030
,20170918,50450,50470,50330,50850,49930,50780,50430,310,-40,72366,"1,824,774.03",142968
,20170919,50780,50430,50720,51000,50550,50790,50820,360,390,44348,"1,126,954.87",144308
,20170920,50790,50820,50810,51060,50640,50900,50860,80,40,46580,"1,184,553.93",145988
,20170921,50900,50860,50860,50930,50070,50230,50460,-630,-400,75490,"1,904,699.21",150982
,20170922,50230,50460,50320,50530,49420,49690,49890,-770,-570,100344,"2,503,395.40",153372
,20170925,49690,49890,49900,50580,49890,50330,50250,440,360,89048,"2,237,452.82",150862
,20170926,50330,50250,50300,50860,50230,50670,50590,420,340,66692,"1,686,997.74",156688
,20170927,50670,50590,50500,50720,50150,50580,50450,-10,-140,75614,"1,907,470.59",158024
,20170928,50580,50450,50610,50720,50100,50660,50450,210,0,115712,"2,919,219.59",163732
,20170929,50660,50450,50780,51880,50660,51880,51320,1430,870,161078,"4,133,707.02",161508
,20171009,51880,51320,52120,52470,51950,52130,52170,810,850,87856,"2,291,876.32",169912
,20171010,52130,52170,52030,52320,51830,51870,52070,-300,-100,146488,"3,813,977.89",184924
,20171011,51870,52070,51890,52500,51710,52440,52200,370,130,205294,"5,358,940.62",192556
,20171012,52440,52200,52400,53350,52210,53210,52890,1010,690,351494,"9,295,380.52",204596
,20171013,53210,52890,53370,53670,53150,53410,53420,520,530,224032,"5,984,784.28",208236
,20171016,53410,53420,53420,55320,53100,55090,54080,1670,660,459982,"12,440,139.61",212304
,20171017,55090,54080,55280,55910,54980,55120,55410,1040,1330,374224,"10,368,751.09",206908
,20171018,55120,55410,55220,55340,54450,54890,54910,-520,-500,298918,"8,206,892.62",209684
,20171019,54890,54910,54850,55240,54470,54620,54780,-290,-130,267536,"7,328,213.21",205172
,20171020,54620,54780,54400,55410,54140,55100,54700,320,-80,283334,"7,749,451.43",209192
,20171023,55100,54700,55030,55140,54070,54390,54580,-310,-120,297772,"8,127,340.02",196648
,20171024,54390,54580,54650,55840,54570,55480,55300,900,720,303102,"8,381,044.23",209484
,20171025,55480,55300,55580,55590,54240,54590,54890,-710,-410,311784,"8,558,277.10",193512
,20171026,54590,54890,54900,55160,54670,54780,54870,-110,-20,253628,"6,958,494.51",186634
,20171027,54780,54870,54690,54880,53840,53990,54370,-880,-500,272016,"7,395,523.03",183546
,20171030,53990,54370,53600,53770,53250,53570,53510,-800,-860,246596,"6,598,017.12",166680
,20171031,53570,53510,53650,54170,53350,53820,53690,310,180,183950,"4,938,708.73",161186
,20171101,53820,53690,53560,54950,53430,54460,54210,770,520,260556,"7,063,050.01",153944
,20171102,54460,54210,54330,54420,53820,54050,54140,-160,-70,188854,"5,112,989.00",150202
,20171103,54050,54140,53880,54750,53850,54310,54380,170,240,190458,"5,178,726.58",151142
,20171106,54310,54380,54370,54690,53810,54580,54220,200,-160,145766,"3,952,388.98",149110
,20171107,54580,54220,54550,54930,54310,54500,54570,280,350,89018,"2,428,882.17",146340
,20171108,54500,54570,54240,54320,53350,53380,53720,-1190,-850,118876,"3,193,158.11",140924
,20171109,53380,53720,53610,53890,53060,53190,53510,-530,-210,92674,"2,479,752.84",137746
,20171110,53190,53510,53200,53730,53130,53560,53460,50,-50,66408,"1,775,237.68",134638
,20171113,53560,53460,53620,53670,53310,53590,53500,130,40,68716,"1,838,243.99",135106
,20171114,53590,53500,53420,54450,53200,53970,53990,470,490,87294,"2,356,559.86",132388
,20171115,53970,53990,53920,54020,52620,52830,53030,-1160,-960,100100,"2,654,603.97",132296
,20171116,52830,53030,53000,53050,52530,52790,52890,-240,-140,61364,"1,623,051.14",126778
,20171117,52790,52890,53020,53180,52660,52920,52890,30,0,60144,"1,590,642.25",120944
,20171120,52920,52890,52990,53430,52600,52920,52950,30,60,52468,"1,389,268.82",116166
,20171121,52920,52950,52990,53550,52860,53370,53270,420,320,58098,"1,547,470.03",111886
,20171122,53370,53270,53460,54150,53460,54000,53910,730,640,67962,"1,832,219.79",102782
,20171123,54000,53910,53880,54180,53750,53780,53910,-130,0,52490,"1,415,047.12",96256
,20171124,53780,53910,53740,54330,53740,54240,54100,330,190,42976,"1,162,570.16",92246
,20171127,54240,54100,54300,54580,53660,53730,54150,-370,50,53564,"1,450,444.49",83060
,20171128,53730,54150,53760,53920,53130,53350,53480,-800,-670,51928,"1,388,757.60",78706
,20171129,53350,53480,53160,53350,52930,53100,53160,-380,-320,50630,"1,345,960.79",70938
,20171130,53100,53160,52960,53000,52390,52790,52680,-370,-480,49122,"1,294,031.57",61974
,20171201,52790,52680,52990,53080,52590,52850,52750,170,70,26114,"688,767.29",56210
,20171204,52850,52750,52850,53590,52680,53480,53320,730,570,28650,"763,913.40",50770
,20171205,53480,53320,53480,53480,52450,52490,53000,-830,-320,33040,"875,631.55",44970
,20171206,52490,53000,52200,52200,51060,51410,51410,-1590,-1590,42800,"1,100,306.15",36910
,20171207,51410,51410,51420,51660,51150,51220,51370,-190,-40,25810,"662,976.65",31540
,20171208,51220,51370,51320,51720,51210,51620,51420,250,50,33300,"856,186.20",25700
,20171211,51620,51420,51560,51710,51190,51200,51470,-220,50,28620,"736,589.05",18880
,20171212,51200,51470,51430,52080,51340,51850,51810,380,340,26100,"676,220.70",12530
,20171213,51850,51810,51940,52140,51700,52070,51940,260,130,13770,"357,651.80",8610
,20171214,52070,51940,52190,52420,51950,52110,52240,170,300,6950,"181,549.80",5870
,20171215,52110,52240,52320,52820,52300,52690,52510,450,270,2970,"77,979.85",4630
cu1801,20170117,49130,49130,48860,48910,48000,48020,48110,-1110,-1020,84,"2,020.63",68
,20170118,48020,48110,48230,48230,46100,47100,46760,-1010,-1350,622,"14,543.90",346
,20170119,47100,46760,47000,47200,47000,47170,47150,410,390,26,612.96,368
,20170120,47170,47150,46940,47070,46560,46560,46930,-590,-220,44,"1,032.52",338
,20170123,46560,46930,46810,47400,46810,47170,47120,240,190,16,376.98,348
,20170124,47170,47120,47010,47550,46950,47520,47190,400,70,76,"1,793.37",334
,20170125,47520,47190,47990,49150,47940,48530,48660,1340,1470,366,"8,905.51",368
,20170126,48530,48660,48400,48890,48400,48840,48570,180,-90,48,"1,165.84",360
,20170203,48840,48570,48220,48220,47480,47620,47840,-950,-730,70,"1,674.63",350
,20170206,47620,47840,47280,47550,47280,47460,47420,-380,-420,28,664.01,360
,20170207,47460,47420,47700,47900,47650,47900,47760,480,340,22,525.46,360
,20170208,47900,47760,48110,48900,48110,48860,48600,1100,840,3512,"85,356.46",3110
,20170209,48860,48600,48880,49030,48470,48500,48890,-100,290,906,"22,149.05",3722
,20170210,48500,48890,48450,49280,48290,48970,49060,80,170,846,"20,754.09",4316
,20170213,48970,49060,48900,52250,48900,51470,51420,2410,2360,5580,"143,474.32",6796
,20170214,51470,51420,51400,51400,50920,51100,51130,-320,-290,1204,"30,783.10",6884
,20170215,51100,51130,51180,51270,49480,50000,50310,-1130,-820,796,"20,026.87",7098
,20170216,50000,50310,50000,50300,49780,49780,50080,-530,-230,668,"16,728.09",7204
,20170217,49780,50080,49690,49960,49380,49630,49720,-450,-360,384,"9,546.87",7278
,20170220,49630,49720,49480,49970,49030,49970,49500,250,-220,512,"12,674.15",7276
,20170221,49970,49500,49980,50450,49900,49970,50270,470,770,460,"11,563.07",7166
,20170222,49970,50270,50160,50200,49590,49830,49930,-440,-340,116,"2,896.07",7182
,20170223,49830,49930,49700,50030,49290,49510,49620,-420,-310,136,"3,374.55",7186
,20170224,49510,49620,49690,49690,48010,48980,48840,-640,-780,374,"9,134.26",7192
,20170227,48980,48840,48960,49330,48700,48920,48980,80,140,194,"4,751.24",7190
,20170228,48920,48980,49030,49230,48830,48830,49010,-150,30,60,"1,470.35",7194
,20170301,48830,49010,49190,49880,49190,49710,49630,700,620,46,"1,141.68",7198
,20170302,49710,49630,50050,50180,49480,49820,49870,190,240,110,"2,742.97",7194
,20170303,49820,49870,49590,49590,49000,49350,49220,-520,-650,90,"2,215.15",7172
,20170306,49350,49220,49400,49640,49000,49090,49400,-130,180,94,"2,322.15",7200
,20170307,49090,49400,48950,49010,48510,48910,48890,-490,-510,76,"1,858.15",7216
,20170308,48910,48890,48710,48710,48200,48520,48390,-370,-500,148,"3,581.30",7238
,20170309,48520,48390,48420,48480,47510,47590,47870,-800,-520,266,"6,366.84",7272
,20170310,47590,47870,47280,47750,47140,47620,47560,-250,-310,108,"2,568.30",7242
,20170313,47620,47560,47940,48220,47530,48180,48000,620,440,118,"2,832.48",7232
,20170314,48180,48000,48390,48450,48070,48230,48350,230,350,94,"2,272.88",7226
,20170315,48230,48350,48130,48780,47900,48680,48240,330,-110,320,"7,719.35",7254
,20170316,48680,48240,48920,49230,48850,49060,49040,820,800,134,"3,285.99",7234
,20170317,49060,49040,49160,49220,48730,48830,48890,-210,-150,168,"4,107.10",7240
,20170320,48830,48890,49070,49640,48980,49020,49250,130,360,658,"16,203.67",7372
,20170321,49020,49250,49090,49330,48190,48430,48570,-820,-680,226,"5,488.61",7344
,20170322,48430,48570,48400,48400,47630,47810,47870,-760,-700,70,"1,675.79",7368
,20170323,47810,47870,47740,48360,47730,48270,48120,400,250,84,"2,021.20",7358
,20170324,48270,48120,47950,48250,47880,48200,48090,80,-30,90,"2,164.26",7364
,20170327,48200,48090,48010,48200,47260,47390,47550,-700,-540,260,"6,182.62",7344
,20170328,47390,47550,46960,48000,46810,47800,47420,250,-130,130,"3,082.88",7348
,20170329,47800,47420,47950,48700,47950,48590,48310,1170,890,92,"2,222.28",7332
,20170330,48590,48310,48560,48950,48310,48430,48580,120,270,178,"4,323.92",7362
,20170331,48430,48580,48530,49800,48500,48900,49210,320,630,1004,"24,704.18",7858
,20170405,48900,49210,48350,48810,48300,48670,48540,-540,-670,108,"2,621.56",7882
,20170406,48670,48540,49030,49600,49020,49140,49430,600,890,1546,"38,216.33",8824
,20170407,49140,49430,49210,49430,48230,48500,48990,-930,-440,570,"13,963.95",8836
,20170410,48500,48990,47520,48690,47520,48410,48330,-580,-660,220,"5,317.01",8844
,20170411,48410,48330,48230,48230,47750,48120,48000,-210,-330,496,"11,905.83",8968
,20170412,48120,48000,47910,48190,47310,47310,47750,-690,-250,200,"4,775.45",8972
,20170413,47310,47750,47310,47590,46650,47410,47130,-340,-620,174,"4,100.81",8992
,20170414,47410,47130,47340,47480,47010,47170,47200,40,70,174,"4,106.70",8988
,20170417,47170,47200,47600,48440,47170,47410,47690,210,490,162,"3,863.25",9010
,20170418,47410,47690,47640,47880,46720,46720,47200,-970,-490,130,"3,068.58",9000
,20170419,46720,47200,46590,46860,46210,46690,46500,-510,-700,268,"6,231.57",9006
,20170420,46690,46500,46830,46930,45620,46360,46210,-140,-290,426,"9,843.14",9200
,20170421,46360,46210,46500,46880,46240,46760,46570,550,360,166,"3,865.85",9232
,20170424,46760,46570,46560,46720,46220,46700,46510,130,-60,72,"1,674.49",9252
,20170425,46700,46510,46420,47060,46380,46830,46720,320,210,78,"1,822.12",9242
,20170426,46830,46720,46900,47220,46800,47060,47080,340,360,108,"2,542.54",9194
,20170427,47060,47080,47200,47250,47010,47200,47170,120,90,264,"6,227.70",9348
,20170428,47200,47170,47190,47270,46810,47130,47100,-40,-70,178,"4,192.15",9434
,20170502,47130,47100,47700,47860,47540,47600,47750,500,650,730,"17,430.63",9884
,20170503,47600,47750,47660,47720,47360,47360,47530,-390,-220,46,"1,093.27",9896
,20170504,47360,47530,46660,46850,45910,46140,46390,-1390,-1140,246,"5,706.89",10002
,20170505,46140,46390,45800,46070,45580,45900,45780,-490,-610,298,"6,822.28",10150
,20170508,45900,45780,45930,46300,45490,45490,45850,-290,70,570,"13,067.71",10464
,20170509,45490,45850,45380,45590,45230,45490,45440,-360,-410,148,"3,362.79",10484
,20170510,45490,45440,45560,45980,45510,45600,45710,160,270,966,"22,082.42",11140
,20170511,45600,45710,45820,46100,45430,46020,45820,310,110,472,"10,815.46",11342
,20170512,46020,45820,46210,46340,45600,45640,45910,-180,90,686,"15,748.92",11568
,20170515,45640,45910,45930,46240,45650,46240,46000,330,90,510,"11,731.43",11762
,20170516,46240,46000,46100,46240,45830,45890,45950,-110,-50,768,"17,648.20",12076
,20170517,45890,45950,46020,46340,46020,46170,46090,220,140,354,"8,159.57",12248
,20170518,46170,46090,45910,46130,45680,45780,45900,-310,-190,142,"3,259.22",12230
,20170519,45780,45900,45400,46090,45400,46050,45930,150,30,132,"3,031.93",12256
,20170522,46050,45930,46210,46750,46210,46520,46620,590,690,924,"21,542.39",12612
,20170523,46520,46620,46630,46850,46500,46560,46690,-60,70,1028,"23,999.49",12958
,20170524,46560,46690,46660,46830,46240,46500,46560,-190,-130,694,"16,158.02",13008
,20170525,46500,46560,46640,46700,46510,46620,46610,60,50,90,"2,097.49",13002
,20170526,46620,46610,46590,46980,46540,46600,46730,-10,120,210,"4,907.62",13004
,20170531,46600,46730,46430,46470,45910,45970,46270,-760,-460,650,"15,039.03",13264
,20170601,45970,46270,46020,46210,45810,46000,46040,-270,-230,340,"7,827.99",13308
,20170602,46000,46040,46070,46230,45930,46020,46090,-20,50,172,"3,963.92",13290
,20170605,46020,46090,45570,46090,45550,45940,45860,-150,-230,398,"9,126.27",13524
,20170606,45940,45860,45850,46010,45610,45610,45800,-250,-60,198,"4,534.98",13566
,20170607,45610,45800,45450,45900,45360,45570,45670,-230,-130,110,"2,512.09",13596
,20170608,45570,45670,45640,46000,45550,46000,45850,330,180,748,"17,148.87",14090
,20170609,46000,45850,46150,47040,46150,46550,46410,700,560,1630,"37,830.51",14676
,20170612,46550,46410,46940,47270,46690,47020,46990,610,580,2100,"49,345.62",15480
,20170613,47020,46990,46890,47000,46480,46530,46800,-460,-190,606,"14,182.27",15484
,20170614,46530,46800,46470,46630,46350,46630,46430,-170,-370,180,"4,178.72",15524
,20170615,46630,46430,46500,46550,46210,46350,46320,-80,-110,252,"5,836.96",15596
,20170616,46350,46320,46280,46400,46100,46130,46180,-190,-140,98,"2,263.20",15570
,20170619,46130,46180,46350,46420,46120,46340,46290,160,110,312,"7,221.84",15736
,20170620,46340,46290,46570,46740,46500,46600,46620,310,330,524,"12,214.75",15800
,20170621,46600,46620,46320,46360,46100,46290,46240,-330,-380,342,"7,908.60",15924
,20170622,46290,46240,46570,46910,46430,46460,46690,220,450,370,"8,638.91",15920
,20170623,46460,46690,46690,49330,46620,47350,47050,660,360,378,"8,894.33",15914
,20170626,47350,47050,47540,47540,47090,47530,47280,480,230,242,"5,721.44",15958
,20170627,47530,47280,47410,47430,47180,47390,47310,110,30,948,"22,427.99",16176
,20170628,47390,47310,47380,47710,47380,47620,47500,310,190,794,"18,860.98",16344
,20170629,47620,47500,47550,48460,47500,48320,48240,820,740,7664,"184,884.51",21028
,20170630,48320,48240,48360,48680,48120,48200,48260,-40,20,8756,"211,322.46",25132
,20170703,48200,48260,48190,48330,48000,48220,48160,-40,-100,3368,"81,106.32",26532
,20170704,48220,48160,48080,48150,47580,47690,47750,-470,-410,2144,"51,189.05",26678
,20170705,47690,47750,47760,47960,47700,47700,47860,-50,110,1384,"33,121.17",26912
,20170706,47700,47860,47460,47580,47310,47560,47470,-300,-390,490,"11,631.40",26988
,20170707,47560,47470,47550,47760,47440,47720,47520,250,50,292,"6,937.95",27030
,20170710,47720,47520,47550,47640,47370,47400,47520,-120,0,1778,"42,253.30",27752
,20170711,47400,47520,47200,47800,47200,47740,47480,220,-40,1866,"44,305.97",28528
,20170712,47740,47480,47540,48130,47490,47940,47950,460,470,2712,"65,030.25",29558
,20170713,47940,47950,48050,48180,47810,48040,48010,90,60,540,"12,962.87",29640
,20170714,48040,48010,48050,48080,47580,47720,47760,-290,-250,958,"22,881.77",29418
,20170717,47720,47760,47770,48580,47770,48450,48160,690,400,1284,"30,920.35",29522
,20170718,48450,48160,48620,48730,48210,48340,48530,180,370,2150,"52,179.03",30306
,20170719,48340,48530,48400,48570,48300,48570,48400,40,-130,2330,"56,391.36",31190
,20170720,48570,48400,48490,48500,48200,48400,48410,0,10,1128,"27,305.17",31400
,20170721,48400,48410,48440,48680,48060,48550,48430,140,20,1528,"37,004.37",31748
,20170724,48550,48430,48800,48870,48340,48400,48470,-30,40,1650,"39,989.44",32346
,20170725,48400,48470,48570,49340,48420,49170,48880,700,410,4702,"114,934.30",32960
,20170726,49170,48880,49700,51520,49690,50850,50580,1970,1700,26910,"680,630.06",42580
,20170727,50850,50580,50700,51140,50660,50760,50870,180,290,5306,"134,969.78",42664
,20170728,50760,50870,50930,51140,48880,50660,50540,-210,-330,6398,"161,702.29",42624
,20170731,50660,50540,50720,51580,50640,51400,51130,860,590,5294,"135,349.10",42838
,20170801,51400,51130,51100,51170,50830,50910,51050,-220,-80,4966,"126,757.47",43292
,20170802,50910,51050,50980,51190,50510,50800,50780,-250,-270,4584,"116,392.77",43896
,20170803,50800,50780,50750,51140,50570,50600,50880,-180,100,5726,"145,671.82",42836
,20170804,50600,50880,50800,51180,50680,51030,50920,150,40,4098,"104,353.21",43000
,20170807,51030,50920,50960,51610,50730,51020,51030,100,110,8208,"209,460.14",43392
,20170808,51020,51030,51060,51670,50930,51020,51310,-10,280,7344,"188,423.41",43638
,20170809,51020,51310,51080,51990,51020,51910,51650,600,340,9542,"246,466.10",44034
,20170810,51910,51650,51840,51930,51200,51350,51460,-300,-190,7418,"190,884.48",44258
,20170811,51350,51460,51210,51290,50350,50490,50690,-970,-770,9028,"228,846.18",45208
,20170814,50490,50690,50790,51020,50520,50520,50830,-170,140,4382,"111,378.65",45324
,20170815,50520,50830,50740,50930,50620,50880,50820,50,-10,3966,"100,779.82",45756
,20170816,50880,50820,50910,50940,50450,50710,50650,-110,-170,3876,"98,172.48",45516
,20170817,50710,50650,51100,52220,51080,52000,51800,1350,1150,13308,"344,725.50",46042
,20170818,52000,51800,51600,51750,51190,51540,51440,-260,-360,7956,"204,631.86",46688
,20170821,51540,51440,51620,52360,51160,52100,51690,660,250,11738,"303,398.12",47642
,20170822,52100,51690,52100,52630,51850,52600,52200,910,510,14994,"391,417.63",50092
,20170823,52600,52200,52660,52800,51770,52050,52070,-150,-130,12328,"320,976.83",51210
,20170824,52050,52070,51980,52580,51840,52310,52270,240,200,11664,"304,856.01",51502
,20170825,52310,52270,52350,53260,52250,53240,52890,970,620,13664,"361,409.81",53240
,20170828,53240,52890,53240,53390,52470,53330,52990,440,100,13642,"361,484.47",54894
,20170829,53330,52990,53490,53490,52840,53060,53140,70,150,14230,"378,103.17",55950
,20170830,53060,53140,53330,53360,52900,53120,53120,-20,-20,8480,"225,255.92",55510
,20170831,53120,53120,52820,53240,52720,53130,53060,10,-60,11044,"293,049.83",54826
,20170901,53130,53060,53300,53300,52870,53120,53050,60,-10,11226,"297,782.76",54496
,20170904,53120,53050,53020,53720,52860,53500,53430,450,380,13298,"355,311.02",54276
,20170905,53500,53430,53450,54040,53360,54000,53700,570,270,8384,"225,145.15",53834
,20170906,54000,53700,53830,53830,53000,53510,53440,-190,-260,11442,"305,730.29",54884
,20170907,53510,53440,53460,53600,52960,53060,53260,-380,-180,12482,"332,405.53",55456
,20170908,53060,53260,53070,53120,51910,52050,52440,-1210,-820,34290,"899,236.90",52704
,20170911,52050,52440,51970,52080,51000,51800,51580,-640,-860,22142,"571,139.71",54978
,20170912,51800,51580,51850,52150,51650,51990,51900,410,320,12084,"313,595.39",55742
,20170913,51990,51900,51350,51720,51130,51240,51490,-660,-410,13922,"358,441.25",57620
,20170914,51240,51490,50910,51050,50610,50610,50820,-880,-670,21390,"543,575.76",58124
,20170915,50610,50820,50580,50840,50380,50600,50610,-220,-210,26804,"678,369.71",57246
,20170918,50600,50610,50600,50990,50090,50900,50560,290,-50,25366,"641,325.45",58972
,20170919,50900,50560,50890,51150,50720,50950,50990,390,430,18732,"477,589.55",61714
,20170920,50950,50990,50940,51200,50800,51040,51010,50,20,15506,"395,527.66",60824
,20170921,51040,51010,51040,51060,50220,50340,50550,-670,-460,23158,"585,403.24",60690
,20170922,50340,50550,50340,50680,49580,49830,49970,-720,-580,34558,"863,586.94",62670
,20170925,49830,49970,49980,50750,49980,50440,50370,470,400,27578,"694,599.32",65554
,20170926,50440,50370,50300,50970,50300,50820,50710,450,340,19410,"492,196.75",65778
,20170927,50820,50710,50600,50820,50280,50700,50560,-10,-150,24332,"615,182.66",68212
,20170928,50700,50560,50700,50790,50180,50750,50530,190,-30,26074,"658,782.20",70426
,20170929,50750,50530,50890,51960,50690,51950,51430,1420,900,49264,"1,267,034.73",76652
,20171009,51950,51430,52130,52530,52020,52180,52220,750,790,28632,"747,625.34",83552
,20171010,52180,52220,52100,52370,51880,51920,52100,-300,-120,42574,"1,109,251.50",94104
,20171011,51920,52100,51970,52490,51770,52420,52220,320,120,56058,"1,463,889.27",101084
,20171012,52420,52220,52400,53300,52210,53160,52870,940,650,121780,"3,219,777.65",101532
,20171013,53160,52870,53300,53590,53110,53380,53370,510,500,59298,"1,582,506.14",103440
,20171016,53380,53370,53410,55450,53070,55210,54250,1840,880,131882,"3,577,515.20",107732
,20171017,55210,54250,55320,56100,55080,55210,55570,960,1320,133774,"3,717,108.82",112070
,20171018,55210,55570,55260,55440,54530,55000,55000,-570,-570,82778,"2,276,416.59",113542
,20171019,55000,55000,54990,55330,54580,54720,54860,-280,-140,81532,"2,236,669.44",117110
,20171020,54720,54860,54500,55480,54210,55190,54860,330,0,100678,"2,761,945.46",118532
,20171023,55190,54860,55050,55230,54120,54480,54650,-380,-210,100390,"2,743,560.02",120646
,20171024,54480,54650,54700,55880,54630,55520,55360,870,710,108282,"2,997,597.09",133424
,20171025,55520,55360,55570,55650,54200,54570,54880,-790,-480,125144,"3,434,399.11",128514
,20171026,54570,54880,54880,55130,54650,54780,54870,-100,-10,90966,"2,495,769.23",129132
,20171027,54780,54870,54700,54880,53850,53970,54340,-900,-530,120542,"3,275,129.30",129300
,20171030,53970,54340,53600,53770,53250,53570,53500,-770,-840,115858,"3,099,319.84",136398
,20171031,53570,53500,53620,54160,53330,53780,53720,280,220,100534,"2,700,625.48",135082
,20171101,53780,53720,53500,54940,53420,54450,54230,730,510,171244,"4,643,587.84",138028
,20171102,54450,54230,54350,54430,53820,54040,54160,-190,-70,136664,"3,701,146.37",134734
,20171103,54040,54160,53880,54820,53880,54390,54430,230,270,203122,"5,528,851.75",150980
,20171106,54390,54430,54400,54780,53830,54670,54290,240,-140,232864,"6,321,134.02",159914
,20171107,54670,54290,54610,55060,54390,54600,54670,310,380,182902,"4,999,742.08",163296
,20171108,54600,54670,54300,54420,53370,53420,53770,-1250,-900,305714,"8,219,681.23",169932
,20171109,53420,53770,53620,53990,53060,53230,53540,-540,-230,275702,"7,381,560.95",170550
,20171110,53230,53540,53230,53780,53160,53580,53480,40,-60,197726,"5,287,678.84",170070
,20171113,53580,53480,53600,53720,53320,53650,53530,170,50,162226,"4,342,003.17",172618
,20171114,53650,53530,53480,54570,53230,54030,54060,500,530,358232,"9,684,684.50",172700
,20171115,54030,54060,53980,54110,52630,52850,53190,-1210,-870,409694,"10,897,263.02",171708
,20171116,52850,53190,53000,53110,52540,52810,52880,-380,-310,212728,"5,625,567.66",172834
,20171117,52810,52880,53060,53220,52660,52910,52930,30,50,212498,"5,624,773.60",178982
,20171120,52910,52930,52850,53480,52620,52950,52980,20,50,193784,"5,133,931.40",178796
,20171121,52950,52980,53040,53700,52910,53430,53280,450,300,224184,"5,973,285.21",174780
,20171122,53430,53280,53600,54260,53530,54110,53970,830,690,241988,"6,530,251.40",177316
,20171123,54110,53970,53970,54290,53800,53850,54050,-120,80,171736,"4,641,211.94",170162
,20171124,53850,54050,53840,54430,53800,54340,54150,290,100,168346,"4,558,565.94",169830
,20171127,54340,54150,54440,54700,53720,53770,54230,-380,80,220270,"5,973,183.05",164258
,20171128,53770,54230,53840,53990,53170,53410,53620,-820,-610,199140,"5,339,193.12",153502
,20171129,53410,53620,53180,53400,52940,53150,53180,-470,-440,184640,"4,909,963.09",149500
,20171130,53150,53180,52970,53050,52390,52840,52760,-340,-420,264586,"6,980,160.93",156818
,20171201,52840,52760,52990,53240,52620,52900,52850,140,90,150266,"3,970,830.92",153326
,20171204,52900,52850,52820,53690,52690,53550,53270,700,420,212682,"5,665,278.94",144672
,20171205,53550,53270,53480,53520,52450,52560,53060,-710,-210,169374,"4,493,631.35",147612
,20171206,52560,53060,52200,52270,51060,51410,51570,-1650,-1490,271462,"6,999,974.22",149500
,20171207,51410,51570,51440,51730,51150,51210,51430,-360,-140,131196,"3,374,092.26",145948
,20171208,51210,51430,51350,51840,51250,51670,51490,240,60,104318,"2,686,081.07",137418
,20171211,51670,51490,51580,51820,51230,51270,51530,-220,40,96862,"2,495,743.61",137106
,20171212,51270,51530,51500,52240,51370,52020,51890,490,360,94536,"2,453,044.05",128100
,20171213,52020,51890,52120,52360,51800,52240,52110,350,220,67576,"1,760,783.69",124524
,20171214,52240,52110,52480,52630,52090,52220,52400,110,290,71012,"1,860,658.81",116812
,20171215,52220,52400,52490,52970,52440,52840,52710,440,310,67740,"1,785,478.97",112720
,20171218,52840,52710,52750,53760,52700,53480,53410,770,700,71178,"1,901,019.17",104694
,20171219,53480,53410,53480,53700,53180,53280,53420,-130,10,52710,"1,408,004.22",99606
,20171220,53280,53420,53310,53770,53270,53570,53530,150,110,44290,"1,185,575.91",94928
,20171221,53570,53530,53770,54500,53700,54080,54120,550,590,47624,"1,288,941.06",91144
,20171222,54080,54120,54050,54390,53890,54330,54160,210,40,39710,"1,075,467.57",85724
,20171225,54330,54160,54280,55070,54230,54590,54730,430,570,44540,"1,218,983.53",79352
,20171226,54590,54730,54590,55150,54320,55100,54700,370,-30,39702,"1,085,928.80",69922
,20171227,55100,54700,55170,55270,54690,54820,54910,120,210,37818,"1,038,370.25",63502
,20171228,54820,54910,54910,55660,54870,55610,55260,700,350,33626,"929,192.73",59712
,20171229,55610,55260,55500,55680,55130,55150,55430,-110,170,29238,"810,420.38",51164
cu1802,20170216,50310,50310,50010,50370,49910,50000,50080,-310,-230,82,"2,053.32",68
,20170217,50000,50080,50000,50010,49450,49730,49740,-350,-340,156,"3,880.21",124
,20170220,49730,49740,49480,50050,48440,50000,49600,260,-140,164,"4,067.64",208
,20170221,50000,49600,50300,50530,50080,50090,50220,490,620,48,"1,205.33",224
,20170222,50090,50220,50210,50280,49790,49800,49960,-420,-260,52,"1,299.09",234
,20170223,49800,49960,49780,50100,49580,49610,49780,-350,-180,48,"1,194.77",258
,20170224,49610,49780,49050,49280,48330,49050,48840,-730,-940,190,"4,640.25",368
,20170227,49050,48840,49120,49510,49060,49070,49130,230,290,166,"4,078.59",446
,20170228,49070,49130,48960,49310,48960,49050,49120,-80,-10,24,589.48,442
,20170301,49050,49120,49220,50000,49050,49890,49530,770,410,128,"3,169.92",510
,20170302,49890,49530,50080,50130,49650,49880,49900,350,370,106,"2,645.01",532
,20170303,49880,49900,49600,49670,49160,49540,49360,-360,-540,148,"3,653.25",560
,20170306,49540,49360,49460,49650,49100,49160,49430,-200,70,112,"2,768.23",610
,20170307,49160,49430,49020,49050,48820,49050,48990,-380,-440,36,881.88,624
,20170308,49050,48990,48750,48750,48300,48400,48480,-590,-510,128,"3,102.77",628
,20170309,48400,48480,48330,48330,47510,47660,47850,-820,-630,216,"5,168.00",720
,20170310,47660,47850,47270,47830,47200,47810,47560,-40,-290,40,951.39,724
,20170313,47810,47560,47980,48400,47610,48400,48040,840,480,54,"1,297.10",744
,20170314,48400,48040,48440,48550,48160,48550,48420,510,380,24,581.10,756
,20170315,48550,48420,48280,48890,48020,48820,48390,400,-30,126,"3,049.16",840
,20170316,48820,48390,49030,49310,48980,49200,49150,810,760,78,"1,917.05",834
,20170317,49200,49150,49010,49010,48760,48820,48850,-330,-300,44,"1,074.78",848
,20170320,48820,48850,49400,49850,48350,49120,49480,270,630,2224,"55,026.07",2160
,20170321,49120,49480,49140,49510,48400,48580,48760,-900,-720,184,"4,486.60",2138
,20170322,48580,48760,48410,48650,47750,47880,48060,-880,-700,148,"3,556.96",2104
,20170323,47880,48060,48050,48490,47790,48390,48240,330,180,116,"2,798.29",2072
,20170324,48390,48240,48000,48420,48000,48300,48230,60,-10,64,"1,543.54",2060
,20170327,48300,48230,48190,48360,47400,47500,47900,-730,-330,102,"2,443.06",2034
,20170328,47500,47900,47410,48070,46950,47850,47220,-50,-680,112,"2,644.35",2020
,20170329,47850,47220,48070,48800,48030,48610,48510,1390,1290,128,"3,105.13",2004
,20170330,48610,48510,48650,49020,48470,48560,48800,50,290,98,"2,391.40",1996
,20170331,48560,48800,48800,50000,48800,49080,49660,280,860,2884,"71,611.64",4088
,20170405,49080,49660,48570,48980,48550,48860,48660,-800,-1000,438,"10,658.45",4100
,20170406,48860,48660,49210,49810,49200,49300,49590,640,930,764,"18,944.24",4496
,20170407,49300,49590,49390,49550,48430,48450,49130,-1140,-460,156,"3,832.55",4494
,20170410,48450,49130,48380,48830,48340,48560,48620,-570,-510,310,"7,536.40",4486
,20170411,48560,48620,48230,48380,47920,48000,48170,-620,-450,868,"20,909.98",4500
,20170412,48000,48170,48110,48300,47500,47500,48000,-670,-170,734,"17,619.34",4526
,20170413,47500,48000,47400,47680,46770,47590,47330,-410,-670,250,"5,916.73",4556
,20170414,47590,47330,47600,47670,47110,47320,47320,-10,-10,386,"9,134.23",4602
,20170417,47320,47320,47900,48570,47400,47450,47890,130,570,100,"2,394.61",4594
,20170418,47450,47890,47930,47930,46960,46960,47460,-930,-430,88,"2,088.58",4604
,20170419,46960,47460,46780,47050,46270,46900,46750,-560,-710,158,"3,693.78",4576
,20170420,46900,46750,47050,47110,45810,46160,46380,-590,-370,214,"4,963.11",4628
,20170421,46160,46380,46600,47030,46390,46910,46670,530,290,52,"1,213.57",4612
,20170424,46910,46670,46500,46870,46490,46810,46690,140,20,40,933.91,4620
,20170425,46810,46690,46550,47170,46470,46950,46880,260,190,70,"1,641.09",4604
,20170426,46950,46880,46950,47380,46950,47270,47260,390,380,46,"1,087.14",4578
,20170427,47270,47260,47420,47420,47210,47280,47340,20,80,228,"5,397.58",4738
,20170428,47280,47340,47020,47430,47020,47260,47230,-80,-110,94,"2,220.19",4758
,20170502,47260,47230,47880,48040,47720,47730,47920,500,690,686,"16,438.29",5206
,20170503,47730,47920,47820,47880,47590,47590,47680,-330,-240,46,"1,096.86",5228
,20170504,47590,47680,46930,47010,46270,46350,46580,-1330,-1100,244,"5,683.74",5338
,20170505,46350,46580,46030,46240,45800,46010,46020,-570,-560,108,"2,485.13",5398
,20170508,46010,46020,46060,46460,45610,45710,46040,-310,20,420,"9,668.91",5510
,20170509,45710,46040,45500,45680,45450,45650,45590,-390,-450,152,"3,464.99",5548
,20170510,45650,45590,45760,46150,45670,45770,45900,180,310,390,"8,952.01",5744
,20170511,45770,45900,45930,46230,45590,46150,46030,250,130,354,"8,148.52",5952
,20170512,46150,46030,46380,46440,45750,45930,45930,-100,-100,304,"6,982.56",5968
,20170515,45930,45930,46000,46360,45800,46360,46230,430,300,406,"9,385.91",6218
,20170516,46360,46230,46240,46450,45960,46060,46140,-170,-90,624,"14,397.86",6464
,20170517,46060,46140,46210,46500,46170,46300,46270,160,130,222,"5,136.46",6466
,20170518,46300,46270,46130,46250,45780,45850,45970,-420,-300,100,"2,298.96",6480
,20170519,45850,45970,45550,46220,45550,46120,46110,150,140,126,"2,905.43",6510
,20170522,46120,46110,46400,46910,46400,46680,46760,570,650,602,"14,076.70",6760
,20170523,46680,46760,46840,47030,46660,46670,46850,-90,90,1036,"24,269.07",7216
,20170524,46670,46850,46800,47000,46390,46650,46790,-200,-60,686,"16,049.35",7388
,20170525,46650,46790,46750,46870,46590,46750,46720,-40,-70,34,794.38,7394
,20170526,46750,46720,46940,47090,46720,46770,46950,50,230,50,"1,173.96",7398
,20170531,46770,46950,46520,46640,46080,46130,46450,-820,-500,596,"13,843.88",7798
,20170601,46130,46450,46030,46340,45970,46110,46130,-340,-320,90,"2,076.25",7774
,20170602,46110,46130,46290,46310,46070,46150,46250,20,120,276,"6,383.09",7936
,20170605,46150,46250,45810,46220,45730,46100,45980,-150,-270,192,"4,414.96",7998
,20170606,46100,45980,46020,46030,45760,45760,45940,-220,-40,144,"3,308.19",8028
,20170607,45760,45940,45570,46100,45530,45680,45920,-260,-20,198,"4,546.29",8058
,20170608,45680,45920,45810,46160,45680,46100,46010,180,90,604,"13,897.59",8436
,20170609,46100,46010,46290,46740,46290,46710,46560,700,550,1238,"28,821.82",9034
,20170612,46710,46560,47090,47520,47020,47200,47280,640,720,1462,"34,567.58",9746
,20170613,47200,47280,47110,47150,46690,46710,46910,-570,-370,268,"6,286.69",9738
,20170614,46710,46910,46600,46840,46540,46770,46650,-140,-260,198,"4,619.06",9692
,20170615,46770,46650,46750,46750,46310,46450,46480,-200,-170,324,"7,531.10",9698
,20170616,46450,46480,46400,46580,46210,46320,46370,-160,-110,126,"2,921.53",9672
,20170619,46320,46370,46470,46500,46310,46490,46460,120,90,246,"5,715.67",9848
,20170620,46490,46460,46690,46890,46650,46780,46770,320,310,78,"1,824.05",9840
,20170621,46780,46770,46450,46550,46300,46430,46430,-340,-340,564,"13,096.03",10236
,20170622,46430,46430,46810,47110,46630,46680,46870,250,440,180,"4,218.51",10210
,20170623,46680,46870,46890,47600,46800,47570,47180,700,310,352,"8,304.83",10174
,20170626,47570,47180,47520,47820,47290,47730,47530,550,350,390,"9,269.65",10286
,20170627,47730,47530,47590,47630,47370,47580,47480,50,-50,218,"5,176.16",10302
,20170628,47580,47480,47560,47930,47530,47800,47710,320,230,250,"5,964.13",10324
,20170629,47800,47710,47780,48720,47700,48550,48440,840,730,4712,"114,131.61",13144
,20170630,48550,48440,48630,48960,48350,48430,48600,-10,160,3816,"92,732.46",14706
,20170703,48430,48600,48390,48550,48240,48420,48400,-180,-200,1720,"41,631.72",15692
,20170704,48420,48400,48290,48350,47790,47930,47980,-470,-420,1552,"37,238.76",16098
,20170705,47930,47980,47950,48140,47950,47960,48050,-20,70,696,"16,724.40",16278
,20170706,47960,48050,47680,47800,47560,47780,47700,-270,-350,380,"9,063.15",16328
,20170707,47780,47700,47740,47910,47650,47910,47690,210,-10,164,"3,910.87",16302
,20170710,47910,47690,47770,47890,47610,47630,47800,-60,110,800,"19,120.09",16502
,20170711,47630,47800,47500,48070,47500,47910,47720,110,-80,848,"20,235.67",16886
,20170712,47910,47720,47790,48340,47750,48130,48090,410,370,634,"15,246.76",16994
,20170713,48130,48090,48300,48400,48030,48070,48240,-20,150,930,"22,432.04",17370
,20170714,48070,48240,48270,48330,47800,47910,48050,-330,-190,900,"21,624.51",17164
,20170717,47910,48050,48050,48830,47990,48420,48410,370,360,1284,"31,081.95",17350
,20170718,48420,48410,48790,48980,48420,48530,48720,120,310,1344,"32,744.34",17748
,20170719,48530,48720,48610,48750,48540,48750,48610,30,-110,568,"13,806.63",17710
,20170720,48750,48610,48600,48710,48420,48570,48620,-40,10,396,"9,628.68",17798
,20170721,48570,48620,48650,48890,48350,48740,48670,120,50,2038,"49,596.49",19048
,20170724,48740,48670,48920,48960,48430,48430,48700,-240,30,1090,"26,542.32",19528
,20170725,48430,48700,48800,49530,48660,49450,49140,750,440,2734,"67,185.31",20384
,20170726,49450,49140,49950,51760,49940,51030,50770,1890,1630,19978,"507,141.89",29504
,20170727,51030,50770,51040,51370,50870,50930,51130,160,360,3010,"76,952.47",29802
,20170728,50930,51130,51080,51320,50500,50790,50950,-340,-180,1648,"41,983.63",29816
,20170731,50790,50950,50980,51830,50880,51480,51600,530,650,4200,"108,380.09",32720
,20170801,51480,51600,51460,51460,51090,51090,51280,-510,-320,2644,"67,802.60",32800
,20170802,51090,51280,51080,51260,50780,50830,50990,-450,-290,750,"19,123.84",32776
,20170803,50830,50990,51020,51350,50780,50780,51050,-210,60,1396,"35,636.61",32758
,20170804,50780,51050,51010,51410,50910,51190,51140,140,90,914,"23,375.52",32764
,20170807,51190,51140,51200,51810,50990,51190,51260,50,120,1004,"25,735.27",32956
,20170808,51190,51260,51330,51900,51040,51040,51530,-220,270,1022,"26,332.89",33004
,20170809,51040,51530,51320,52200,51280,52060,51950,530,420,1766,"45,876.91",33100
,20170810,52060,51950,51970,52090,51460,51540,51660,-410,-290,912,"23,559.63",33028
,20170811,51540,51660,51470,51470,50600,50700,50890,-960,-770,1002,"25,496.88",33038
,20170814,50700,50890,51000,51230,50780,50820,51030,-70,140,460,"11,737.70",33094
,20170815,50820,51030,50970,51150,50840,51080,51060,50,30,520,"13,277.87",33136
,20170816,51080,51060,51130,51170,50710,50910,50900,-150,-160,776,"19,752.26",33046
,20170817,50910,50900,51420,52410,51390,52200,52060,1300,1160,2028,"52,795.28",33024
,20170818,52200,52060,51820,51940,51400,51710,51620,-350,-440,1276,"32,937.66",33232
,20170821,51710,51620,51870,52500,51420,52190,51930,570,310,1308,"33,966.95",33512
,20170822,52190,51930,52270,52830,52120,52790,52390,860,460,2412,"63,188.98",33600
,20170823,52790,52390,52900,52920,52000,52150,52220,-240,-170,1352,"35,307.39",33538
,20170824,52150,52220,52250,52800,52060,52520,52520,300,300,1160,"30,464.65",33618
,20170825,52520,52520,52620,53460,52440,53420,53140,900,620,1942,"51,603.97",33784
,20170828,53420,53140,53530,53590,52700,53510,53260,370,120,2366,"63,015.90",33810
,20170829,53510,53260,53680,53680,53060,53240,53330,-20,70,6012,"160,328.69",34118
,20170830,53240,53330,53510,53560,53100,53240,53320,-90,-10,4410,"117,581.21",34306
,20170831,53240,53320,53240,53420,52950,53310,53230,-10,-90,2976,"79,212.39",34404
,20170901,53310,53230,53410,53420,53080,53280,53220,50,-10,2308,"61,425.17",34464
,20170904,53280,53220,53100,53910,53090,53680,53550,460,330,1476,"39,522.67",34282
,20170905,53680,53550,53650,54200,53550,54160,53900,610,350,2194,"59,132.38",34322
,20170906,54160,53900,53950,53970,53150,53680,53620,-220,-280,2482,"66,548.58",34300
,20170907,53680,53620,53630,53770,53120,53190,53430,-430,-190,2290,"61,183.07",34574
,20170908,53190,53430,53160,53260,52120,52170,52580,-1260,-850,9514,"250,133.09",36438
,20170911,52170,52580,52170,52280,51400,51950,51780,-630,-800,7284,"188,606.06",37976
,20170912,51950,51780,52150,52320,51850,52120,52040,340,260,3418,"88,948.58",38690
,20170913,52120,52040,51710,51920,51420,51450,51640,-590,-400,3344,"86,355.97",39370
,20170914,51450,51640,51280,51280,50810,50810,51050,-830,-590,9436,"240,886.62",39554
,20170915,50810,51050,50790,51010,50520,50770,50770,-280,-280,10078,"255,877.19",40144
,20170918,50770,50770,50600,51140,50240,51100,50660,330,-110,11482,"290,844.41",40300
,20170919,51100,50660,51020,51300,50890,51120,51130,460,470,5622,"143,732.53",40562
,20170920,51120,51130,51090,51370,50960,51210,51170,80,40,5350,"136,893.13",40488
,20170921,51210,51170,51210,51250,50410,50540,50700,-630,-470,6976,"176,862.37",40412
,20170922,50540,50700,50630,50810,49770,49950,50170,-750,-530,10558,"264,879.48",41720
,20170925,49950,50170,50240,50860,50200,50610,50550,440,380,8694,"219,758.76",42132
,20170926,50610,50550,50530,51110,50500,50990,50820,440,270,4998,"127,019.10",42530
,20170927,50990,50820,50770,50940,50440,50810,50720,-10,-100,10154,"257,526.62",43076
,20170928,50810,50720,50900,50910,50310,50890,50660,170,-60,13868,"351,300.53",45360
,20170929,50890,50660,51010,52030,50880,52030,51530,1370,870,16784,"432,451.80",50336
,20171009,52030,51530,52310,52600,52120,52250,52320,720,790,8030,"210,069.01",52184
,20171010,52250,52320,52140,52460,51920,51990,52180,-330,-140,18226,"475,586.91",59986
,20171011,51990,52180,51920,52540,51830,52470,52280,290,100,31634,"826,913.93",69524
,20171012,52470,52280,52390,53410,52250,53210,52950,930,670,77014,"2,039,137.80",72972
,20171013,53210,52950,53380,53620,53150,53400,53390,450,440,20910,"558,279.85",74036
,20171016,53400,53390,53430,55630,53120,55370,54590,1980,1200,69354,"1,893,187.90",78856
,20171017,55370,54590,55580,56320,55250,55390,55780,800,1190,59546,"1,660,833.50",76268
,20171018,55390,55780,55420,55590,54660,55120,55110,-660,-670,23940,"659,685.91",77104
,20171019,55120,55110,54990,55420,54700,54860,54970,-250,-140,21708,"596,673.16",77962
,20171020,54860,54970,54600,55580,54380,55320,55040,350,70,22294,"613,535.25",80494
,20171023,55320,55040,55250,55350,54300,54600,54800,-440,-240,34066,"933,550.99",84414
,20171024,54600,54800,54720,55950,54720,55600,55510,800,710,39080,"1,084,706.79",88530
,20171025,55600,55510,55680,55730,54260,54640,55000,-870,-510,67158,"1,846,950.89",90212
,20171026,54640,55000,55000,55210,54740,54900,54950,-100,-50,33032,"907,588.20",92788
,20171027,54900,54950,54800,54980,53940,54050,54380,-900,-570,45174,"1,228,468.42",89800
,20171030,54050,54380,53830,53860,53350,53620,53590,-760,-790,26866,"719,893.51",90512
,20171031,53620,53590,53720,54220,53420,53850,53770,260,180,21236,"571,029.09",89984
,20171101,53850,53770,53590,54990,53510,54530,54270,760,500,41486,"1,125,924.52",92136
,20171102,54530,54270,54390,54500,53890,54090,54200,-180,-70,27478,"744,666.74",92616
,20171103,54090,54200,53970,54900,53960,54420,54500,220,300,55388,"1,509,408.30",99400
,20171106,54420,54500,54430,54880,53910,54780,54410,280,-90,44714,"1,216,573.33",103928
,20171107,54780,54410,54700,55120,54500,54700,54780,290,370,39258,"1,075,351.04",105504
,20171108,54700,54780,54400,54510,53470,53500,53820,-1280,-960,68260,"1,837,095.25",107044
,20171109,53500,53820,53760,54030,53170,53330,53570,-490,-250,46996,"1,258,823.25",104910
,20171110,53330,53570,53350,53870,53250,53650,53570,80,0,31410,"841,432.52",105176
,20171113,53650,53570,53640,53760,53400,53710,53610,140,40,22272,"597,109.28",105076
,20171114,53710,53610,53580,54730,53310,54140,54270,530,660,91736,"2,489,534.12",114112
,20171115,54140,54270,54080,54220,52700,52880,53260,-1390,-1010,105670,"2,814,039.78",114068
,20171116,52880,53260,53020,53190,52620,52920,52980,-340,-280,50984,"1,350,662.78",115958
,20171117,52920,52980,53120,53310,52770,53030,53020,50,40,44428,"1,178,000.30",119632
,20171120,53030,53020,53000,53550,52710,53080,53070,60,50,37656,"999,278.14",121780
,20171121,53080,53070,53100,53780,53010,53530,53390,460,320,46512,"1,241,739.55",126494
,20171122,53530,53390,53680,54370,53660,54250,54100,860,710,60480,"1,636,072.87",132730
,20171123,54250,54100,54090,54420,53910,53960,54160,-140,60,56958,"1,542,698.11",139072
,20171124,53960,54160,53960,54550,53920,54460,54290,300,130,52080,"1,413,905.06",142414
,20171127,54460,54290,54600,54800,53860,53940,54320,-350,30,76540,"2,078,935.62",143298
,20171128,53940,54320,53990,54120,53260,53480,53670,-840,-650,97368,"2,613,075.80",140208
,20171129,53480,53670,53300,53480,53030,53220,53260,-450,-410,90844,"2,419,594.94",148782
,20171130,53220,53260,53080,53120,52470,52860,52820,-400,-440,118050,"3,117,909.85",158780
,20171201,52860,52820,53010,53250,52680,52950,52880,130,60,77870,"2,059,216.66",161762
,20171204,52950,52880,52840,53750,52740,53650,53360,770,480,140490,"3,748,651.00",157590
,20171205,53650,53360,53570,53580,52480,52580,53060,-780,-300,150238,"3,986,436.90",175920
,20171206,52580,53060,52220,52290,51080,51450,51590,-1610,-1470,260564,"6,721,573.28",189004
,20171207,51450,51590,51480,51740,51170,51210,51440,-380,-150,166140,"4,273,429.39",198682
,20171208,51210,51440,51350,51900,51230,51700,51520,260,80,225810,"5,817,298.48",205392
,20171211,51700,51520,51590,51900,51240,51320,51560,-200,40,247112,"6,370,623.09",213576
,20171212,51320,51560,51500,52280,51410,52070,51910,510,350,272406,"7,070,496.79",187698
,20171213,52070,51910,52150,52440,51850,52350,52170,440,260,183984,"4,799,512.38",185552
,20171214,52350,52170,52560,52730,52150,52290,52470,120,300,213452,"5,599,993.69",189688
,20171215,52290,52470,52600,53040,52520,52920,52790,450,320,220234,"5,813,102.02",185326
,20171218,52920,52790,52870,53860,52780,53560,53470,770,680,256442,"6,857,203.72",174016
,20171219,53560,53470,53550,53840,53280,53390,53550,-80,80,188764,"5,054,280.89",175622
,20171220,53390,53550,53480,53930,53380,53680,53660,130,110,152574,"4,093,816.95",180464
,20171221,53680,53660,53870,54640,53810,54230,54270,570,610,247502,"6,716,809.74",181622
,20171222,54230,54270,54270,54550,54020,54500,54320,230,50,180564,"4,904,686.58",186666
,20171225,54500,54320,54400,55280,54380,54700,54810,380,490,226428,"6,205,318.28",189366
,20171226,54700,54810,54730,55310,54450,55240,54860,430,50,182436,"5,004,924.22",191628
,20171227,55240,54860,55380,55430,54810,54960,55110,100,250,182146,"5,019,481.63",183662
,20171228,54960,55110,55060,55840,55030,55770,55420,660,310,257758,"7,142,736.29",182368
,20171229,55770,55420,55580,55860,55260,55470,55600,50,180,210324,"5,847,758.10",164604
cu1803,20170316,48390,48390,49090,49430,49030,49240,49180,850,790,24,590.18,14
,20170317,49240,49180,49160,49250,49160,49240,49190,60,10,10,245.98,16
,20170320,49240,49190,49400,49950,49230,49250,49680,60,490,1052,"26,136.37",790
,20170321,49250,49680,49440,49440,48390,48660,48630,-1020,-1050,142,"3,453.22",802
,20170322,48660,48630,48610,48810,47850,48060,48260,-570,-370,162,"3,909.48",814
,20170323,48060,48260,48080,48620,47970,48540,48340,280,80,144,"3,480.91",830
,20170324,48540,48340,48260,48510,48050,48400,48390,60,50,42,"1,016.21",836
,20170327,48400,48390,48360,48360,47560,47600,47720,-790,-670,162,"3,865.97",884
,20170328,47600,47720,47520,48150,47040,48050,47270,330,-450,182,"4,302.33",882
,20170329,48050,47270,48250,48860,48070,48790,48620,1520,1350,312,"7,585.44",922
,20170330,48790,48620,48680,49100,48550,48620,48780,0,160,140,"3,414.86",918
,20170331,48620,48780,48940,50110,48910,49230,49710,450,930,3648,"90,680.65",3408
,20170405,49230,49710,48610,49090,48490,48920,48890,-790,-820,204,"4,986.96",3450
,20170406,48920,48890,49370,50080,49350,49490,49770,600,880,1650,"41,062.36",4300
,20170407,49490,49770,49550,49700,48650,48750,49310,-1020,-460,362,"8,926.63",4318
,20170410,48750,49310,48480,49190,48480,48700,48790,-610,-520,466,"11,369.49",4302
,20170411,48700,48790,48650,48650,48090,48090,48340,-700,-450,502,"12,135.15",4310
,20170412,48090,48340,48250,48440,47710,47740,48030,-600,-310,1050,"25,218.16",4314
,20170413,47740,48030,47600,47990,46950,47850,47540,-180,-490,528,"12,551.28",4326
,20170414,47850,47540,47820,47950,47310,47510,47520,-30,-20,496,"11,787.15",4306
,20170417,47510,47520,47920,48650,47510,47870,47980,350,460,162,"3,886.42",4336
,20170418,47870,47980,48070,48070,47090,47110,47530,-870,-450,154,"3,660.34",4348
,20170419,47110,47530,47070,47180,46330,47040,46790,-490,-740,302,"7,066.34",4352
,20170420,47040,46790,47080,47110,45960,46560,46390,-230,-400,178,"4,129.00",4374
,20170421,46560,46390,46730,47000,46570,47000,46750,610,360,54,"1,262.25",4374
,20170424,47000,46750,46760,47000,46600,47000,46760,250,10,98,"2,291.40",4372
,20170425,47000,46760,46750,47290,46630,47070,46930,310,170,54,"1,267.28",4374
,20170426,47070,46930,47210,47520,47170,47480,47350,550,420,48,"1,136.42",4378
,20170427,47480,47350,47400,47560,47320,47470,47460,120,110,196,"4,652.05",4466
,20170428,47470,47460,47310,47500,47100,47440,47310,-20,-150,128,"3,028.33",4464
,20170502,47440,47310,48060,48160,47910,47930,48060,620,750,548,"13,168.80",4778
,20170503,47930,48060,48020,48050,47700,47700,47870,-360,-190,134,"3,207.42",4776
,20170504,47700,47870,46970,47150,46200,46370,46780,-1500,-1090,512,"11,977.86",4822
,20170505,46370,46780,46260,46420,45950,46230,46190,-550,-590,180,"4,157.67",4850
,20170508,46230,46190,46220,46660,45790,45810,46050,-380,-140,966,"22,245.27",5156
,20170509,45810,46050,45680,45850,45470,45850,45760,-200,-290,328,"7,505.86",5238
,20170510,45850,45760,45920,46260,45810,45880,46050,120,290,316,"7,276.51",5294
,20170511,45880,46050,45960,46320,45750,46300,45980,250,-70,64,"1,471.57",5296
,20170512,46300,45980,46480,46480,45920,46000,46030,20,50,382,"8,792.44",5308
,20170515,46000,46030,46070,46480,46000,46480,46350,450,320,548,"12,701.42",5532
,20170516,46480,46350,46450,46540,46090,46160,46270,-190,-80,562,"13,003.16",5572
,20170517,46160,46270,46300,46650,46260,46450,46420,180,150,226,"5,245.47",5630
,20170518,46450,46420,46330,46410,45980,46010,46190,-410,-230,70,"1,616.76",5606
,20170519,46010,46190,46260,46420,46220,46420,46290,230,100,24,555.50,5598
,20170522,46420,46290,46570,47060,46560,46860,46930,570,640,398,"9,340.31",5818
,20170523,46860,46930,46930,47200,46850,46850,47050,-80,120,554,"13,033.15",6102
,20170524,46850,47050,46960,47200,46550,46820,46940,-230,-110,356,"8,356.40",6188
,20170525,46820,46940,46820,47000,46750,46900,46860,-40,-80,118,"2,765.06",6202
,20170526,46900,46860,47190,47260,46850,46920,46940,60,80,250,"5,867.92",6142
,20170531,46920,46940,46680,46800,46290,46290,46590,-650,-350,458,"10,670.71",6468
,20170601,46290,46590,46270,46480,46090,46250,46340,-340,-250,176,"4,078.55",6434
,20170602,46250,46340,46400,46460,46290,46360,46400,20,60,178,"4,130.47",6550
,20170605,46360,46400,45900,46340,45900,46180,46240,-220,-160,214,"4,948.01",6668
,20170606,46180,46240,46180,46180,46040,46050,46110,-190,-130,52,"1,199.11",6668
,20170607,46050,46110,45740,46290,45700,45780,46060,-330,-50,422,"9,719.20",6854
,20170608,45780,46060,45940,46300,45820,46300,46180,240,120,366,"8,452.56",7112
,20170609,46300,46180,46440,46920,46440,46910,46710,730,530,922,"21,536.85",7520
,20170612,46910,46710,47410,47780,47260,47390,47510,680,800,1190,"28,272.69",8240
,20170613,47390,47510,47290,47310,46880,47040,47120,-470,-390,142,"3,345.78",8250
,20170614,47040,47120,46810,47020,46720,46940,46800,-180,-320,374,"8,752.74",8280
,20170615,46940,46800,46910,46910,46460,46620,46650,-180,-150,504,"11,758.29",8260
,20170616,46620,46650,46560,46690,46400,46450,46560,-200,-90,94,"2,188.36",8262
,20170619,46450,46560,46620,46660,46430,46660,46610,100,50,278,"6,479.48",8438
,20170620,46660,46610,46870,47010,46800,46930,46900,320,290,42,985.09,8440
,20170621,46930,46900,46550,46720,46460,46630,46610,-270,-290,618,"14,402.58",8840
,20170622,46630,46610,46970,47380,46810,46870,47080,260,470,296,"6,968.05",8842
,20170623,46870,47080,47080,47780,46960,47780,47220,700,140,1240,"29,280.33",9190
,20170626,47780,47220,47680,47950,47480,47880,47650,660,430,744,"17,728.64",9524
,20170627,47880,47650,47790,47790,47570,47790,47670,140,20,262,"6,244.89",9522
,20170628,47790,47670,47750,48110,47750,47820,47950,150,280,276,"6,617.42",9578
,20170629,47820,47950,47930,49100,47930,48800,48630,850,680,3262,"79,327.17",10524
,20170630,48800,48630,49010,49160,48560,48660,48780,30,150,2986,"72,834.10",10912
,20170703,48660,48780,48580,48810,48470,48810,48670,30,-110,1416,"34,459.93",11706
,20170704,48810,48670,48530,48580,48000,48110,48230,-560,-440,724,"17,462.68",11914
,20170705,48110,48230,48210,48390,48190,48220,48260,-10,30,536,"12,935.26",12066
,20170706,48220,48260,47890,48030,47750,48000,47910,-260,-350,326,"7,809.34",12016
,20170707,48000,47910,47980,48170,47860,48150,47920,240,10,318,"7,620.64",12174
,20170710,48150,47920,47960,48140,47860,47860,48040,-60,120,882,"21,187.26",12546
,20170711,47860,48040,47740,48220,47680,48220,47960,180,-80,850,"20,386.53",12912
,20170712,48220,47960,48030,48570,47980,48340,48280,380,320,848,"20,471.19",12986
,20170713,48340,48280,48510,48590,48260,48440,48460,160,180,414,"10,032.98",13084
,20170714,48440,48460,48590,48600,48030,48130,48250,-330,-210,1480,"35,709.96",13434
,20170717,48130,48250,48310,49070,48190,48940,48690,690,440,1900,"46,256.51",14038
,20170718,48940,48690,49080,49220,48660,48700,49020,10,330,1414,"34,660.18",14456
,20170719,48700,49020,49000,49000,48750,48930,48880,-90,-140,2508,"61,305.10",15080
,20170720,48930,48880,48900,48900,48670,48830,48830,-50,-50,264,"6,445.70",15070
,20170721,48830,48830,48860,49120,48530,48940,48890,110,60,392,"9,582.78",15084
,20170724,48940,48890,49140,49140,48800,48830,48940,-60,50,2338,"57,219.62",17042
,20170725,48830,48940,49020,49760,48900,49710,49360,770,420,2744,"67,730.60",17834
,20170726,49710,49360,50310,52000,50120,51260,51110,1900,1750,17162,"438,608.82",27326
,20170727,51260,51110,51270,51590,51140,51210,51370,100,260,1052,"27,024.65",27354
,20170728,51210,51370,51380,51580,50720,51080,51100,-290,-270,880,"22,487.36",27310
,20170731,51080,51100,51200,52040,51080,51800,51640,700,540,826,"21,327.54",27334
,20170801,51800,51640,51510,51610,51330,51390,51500,-250,-140,932,"24,002.71",27338
,20170802,51390,51500,51290,51510,51000,51170,51300,-330,-200,970,"24,881.12",27348
,20170803,51170,51300,51240,51550,51020,51020,51250,-280,-50,988,"25,320.17",27374
,20170804,51020,51250,51190,51620,51120,51490,51340,240,90,476,"12,220.79",27400
,20170807,51490,51340,51420,52000,51180,51420,51420,80,80,522,"13,422.72",27436
,20170808,51420,51420,51600,52060,51410,51450,51750,30,330,584,"15,113.69",27420
,20170809,51450,51750,51540,52440,51540,52290,52230,540,480,414,"10,813.20",27406
,20170810,52290,52230,52200,52340,51710,51730,51980,-500,-250,244,"6,341.81",27404
,20170811,51730,51980,51640,51640,50800,50910,51000,-1070,-980,844,"21,524.02",27492
,20170814,50910,51000,51200,51440,51010,51020,51270,20,270,304,"7,794.39",27600
,20170815,51020,51270,51140,51370,51080,51320,51280,50,10,174,"4,461.41",27572
,20170816,51320,51280,51330,51330,50930,51130,51060,-150,-220,216,"5,515.36",27590
,20170817,51130,51060,51680,52610,51680,52360,52350,1300,1290,742,"19,424.18",27602
,20170818,52360,52350,52040,52160,51650,51970,51870,-380,-480,358,"9,286.11",27668
,20170821,51970,51870,52080,52760,51660,52420,52070,550,200,656,"17,081.62",27806
,20170822,52420,52070,52540,53040,52290,53040,52630,970,560,3362,"88,472.71",29362
,20170823,53040,52630,53110,53130,52230,52470,52560,-160,-70,326,"8,567.81",29314
,20170824,52470,52560,52240,53020,52240,52690,52770,130,210,360,"9,498.92",29318
,20170825,52690,52770,52770,53620,52690,53610,53340,840,570,1364,"36,380.68",29602
,20170828,53610,53340,53680,53800,52920,53720,53510,380,170,1036,"27,720.29",29732
,20170829,53720,53510,53780,54540,53300,53390,53560,-120,50,1574,"42,152.06",30000
,20170830,53390,53560,53570,53760,53300,53550,53510,-10,-50,2290,"61,278.35",30304
,20170831,53550,53510,53590,55870,53130,53500,53380,-10,-130,1762,"47,032.46",30420
,20170901,53500,53380,53570,53580,53310,53520,53420,140,40,1562,"41,721.20",30610
,20170904,53520,53420,53340,54060,53250,53920,53750,500,330,2042,"54,886.76",30618
,20170905,53920,53750,53840,54310,53750,54310,54100,560,350,634,"17,150.21",30662
,20170906,54310,54100,54090,54140,53390,53860,53860,-240,-240,942,"25,371.23",30630
,20170907,53860,53860,53810,53920,53330,53380,53630,-480,-230,544,"14,588.09",30738
,20170908,53380,53630,53370,53450,52340,52360,52830,-1270,-800,4156,"109,796.28",31438
,20170911,52360,52830,52460,52470,51620,52110,52000,-720,-830,3750,"97,509.49",32164
,20170912,52110,52000,52360,52570,52050,52340,52300,340,300,1000,"26,154.83",32128
,20170913,52340,52300,51720,52120,51650,51680,51860,-620,-440,2818,"73,074.39",32996
,20170914,51680,51860,51260,51470,50980,50980,51230,-880,-630,8378,"214,637.93",34102
,20170915,50980,51230,50980,51200,50710,50940,50920,-290,-310,8922,"227,169.37",36860
,20170918,50940,50920,50840,51300,50430,51260,50750,340,-170,2936,"74,509.81",36412
,20170919,51260,50750,51190,51460,51050,51300,51300,550,550,1250,"32,065.85",36348
,20170920,51300,51300,51250,51520,51110,51400,51350,100,50,2880,"73,951.62",37232
,20170921,51400,51350,51400,51400,50550,50680,50900,-670,-450,7582,"192,993.04",39286
,20170922,50680,50900,50810,50990,49930,50150,50280,-750,-620,9060,"227,773.60",40716
,20170925,50150,50280,50380,51040,50380,50760,50680,480,400,5474,"138,730.71",41578
,20170926,50760,50680,50760,51300,50700,51130,51110,450,430,2048,"52,337.55",42142
,20170927,51130,51110,50930,51100,50610,50980,50940,-130,-170,4746,"120,880.85",43026
,20170928,50980,50940,51040,51100,50500,51060,50820,120,-120,6016,"152,893.57",44100
,20170929,51060,50820,51300,52150,51060,52150,51580,1330,760,10640,"274,423.77",44370
,20171009,52150,51580,52450,52730,52270,52410,52480,830,900,2068,"54,269.23",44314
,20171010,52410,52480,52250,52610,52050,52100,52350,-380,-130,6392,"167,320.35",47634
,20171011,52100,52350,52040,52640,51900,52550,52400,200,50,15532,"406,965.40",53910
,20171012,52550,52400,52500,53620,51730,53340,53160,940,760,39948,"1,061,877.90",61164
,20171013,53340,53160,53450,53730,53260,53530,53480,370,320,13962,"373,387.30",64298
,20171016,53530,53480,53530,55800,53230,55520,54830,2040,1350,61512,"1,686,578.95",68462
,20171017,55520,54830,55620,56530,55450,55550,56020,720,1190,44310,"1,241,133.94",65018
,20171018,55550,56020,55640,55800,54840,55300,55310,-720,-710,12412,"343,312.30",63584
,20171019,55300,55310,55270,55590,54890,54990,55150,-320,-160,9680,"266,956.71",62686
,20171020,54990,55150,54930,55760,54560,55480,55240,330,90,10330,"285,322.83",64072
,20171023,55480,55240,55390,55520,54470,54760,54980,-480,-260,14544,"399,827.10",63934
,20171024,54760,54980,54900,56090,54900,55710,55730,730,750,23850,"664,596.08",71126
,20171025,55710,55730,55730,55830,54400,54760,55130,-970,-600,34936,"963,169.26",75040
,20171026,54760,55130,55010,55350,54870,55020,55080,-110,-50,18758,"516,624.98",78984
,20171027,55020,55080,55050,55130,54090,54170,54560,-910,-520,27246,"743,364.91",82538
,20171030,54170,54560,53900,54000,53510,53790,53730,-770,-830,16138,"433,622.50",83520
,20171031,53790,53730,53860,54340,53560,54010,53900,280,170,16942,"456,654.57",86786
,20171101,54010,53900,53730,55090,53640,54620,54410,720,510,19884,"541,021.61",89432
,20171102,54620,54410,54560,54610,54010,54240,54320,-170,-90,14572,"395,819.92",89172
,20171103,54240,54320,54240,55000,54090,54550,54610,230,290,25606,"699,173.20",91772
,20171106,54550,54610,54550,55010,54020,54950,54590,340,-20,25534,"697,025.11",96234
,20171107,54950,54590,54930,55270,54620,54820,54910,230,320,14800,"406,406.82",97810
,20171108,54820,54910,54600,54650,53610,53690,53960,-1220,-950,22164,"597,993.43",97434
,20171109,53690,53960,53900,54180,53310,53430,53790,-530,-170,18190,"489,260.44",97962
,20171110,53430,53790,53470,54010,53380,53780,53730,-10,-60,12874,"345,905.73",99418
,20171113,53780,53730,53780,53900,53500,53860,53760,130,30,9092,"244,430.32",99418
,20171114,53860,53760,53680,54900,53440,54310,54580,550,820,84334,"2,301,579.31",110268
,20171115,54310,54580,54360,54370,52830,53050,53340,-1530,-1240,59152,"1,577,787.46",107682
,20171116,53050,53340,53220,53320,52750,53060,53110,-280,-230,15166,"402,766.48",109048
,20171117,53060,53110,53160,53450,52920,53160,53160,50,50,17224,"457,844.71",110990
,20171120,53160,53160,53180,53680,52850,53220,53210,60,50,14522,"386,399.38",111838
,20171121,53220,53210,53290,53880,53160,53680,53540,470,330,16370,"438,234.73",113160
,20171122,53680,53540,53850,54490,53810,54380,54240,840,700,32200,"873,365.50",116394
,20171123,54380,54240,54200,54530,54070,54100,54300,-140,60,20728,"562,866.58",118894
,20171124,54100,54300,54130,54690,54070,54610,54420,310,120,26236,"713,948.91",123590
,20171127,54610,54420,54700,54930,54000,54050,54470,-370,50,31602,"860,823.43",124760
,20171128,54050,54470,54110,54230,53410,53620,53820,-850,-650,35294,"949,935.31",127596
,20171129,53620,53820,53500,53590,53180,53340,53410,-480,-410,33206,"886,808.33",133884
,20171130,53340,53410,53200,53250,52560,52990,52930,-420,-480,40396,"1,069,237.98",135598
,20171201,52990,52930,53030,53320,52800,53060,52980,130,50,22540,"597,128.00",135880
,20171204,53060,52980,53000,53840,52850,53730,53480,750,500,34580,"924,779.23",134226
,20171205,53730,53480,53630,53670,52570,52650,53110,-830,-370,46186,"1,226,693.06",138074
,20171206,52650,53110,52350,52380,51170,51490,51690,-1620,-1420,97556,"2,521,600.18",132904
,20171207,51490,51690,51450,51830,51260,51340,51530,-350,-160,37314,"961,566.32",135000
,20171208,51340,51530,51450,51980,51370,51840,51650,310,120,44396,"1,146,557.85",137388
,20171211,51840,51650,51700,51990,51350,51420,51660,-230,10,48486,"1,252,607.17",138330
,20171212,51420,51660,51560,52370,51470,52170,52050,510,390,72128,"1,877,323.76",135642
,20171213,52170,52050,52240,52520,51960,52460,52280,410,230,58206,"1,521,642.20",132910
,20171214,52460,52280,52720,52840,52260,52410,52590,130,310,49258,"1,295,337.71",132868
,20171215,52410,52590,52670,53140,52640,53040,52900,450,310,51574,"1,364,268.22",134050
,20171218,53040,52900,52980,53940,52880,53680,53590,780,690,67420,"1,806,682.63",139824
,20171219,53680,53590,53670,53960,53400,53500,53650,-90,60,49306,"1,322,761.66",144784
,20171220,53500,53650,53600,54040,53500,53820,53790,170,140,48574,"1,306,449.81",149848
,20171221,53820,53790,54000,54760,53950,54350,54390,560,600,76552,"2,082,050.70",157854
,20171222,54350,54390,54370,54730,54150,54650,54450,260,60,61316,"1,669,411.64",164542
,20171225,54650,54450,54560,55400,54540,54870,54970,420,520,86038,"2,365,103.39",176892
,20171226,54870,54970,54900,55450,54610,55380,54990,410,20,84684,"2,328,455.14",188078
,20171227,55380,54990,55550,55580,54960,55080,55220,90,230,87298,"2,410,584.64",194920
,20171228,55080,55220,55210,55970,55170,55920,55570,700,350,134900,"3,748,378.45",214212
,20171229,55920,55570,55750,55990,55400,55580,55740,10,170,106148,"2,958,577.48",220460
cu1804,20170418,47980,47980,48000,48010,47180,47200,47250,-780,-730,76,"1,795.72",70
,20170419,47200,47250,47000,47400,46650,47010,46980,-240,-270,234,"5,497.36",180
,20170420,47010,46980,47090,47320,46100,46630,46760,-350,-220,252,"5,892.56",310
,20170421,46630,46760,46820,47280,46650,47170,46960,410,200,96,"2,254.45",334
,20170424,47170,46960,47040,47080,46650,47030,46880,70,-80,98,"2,297.19",352
,20170425,47030,46880,46880,47400,46760,47250,47280,370,400,230,"5,437.49",468
,20170426,47250,47280,47290,47600,47140,47500,47460,220,180,114,"2,705.28",478
,20170427,47500,47460,47600,47690,47520,47600,47620,140,160,218,"5,190.79",594
,20170428,47600,47620,47400,47720,47300,47570,47490,-50,-130,74,"1,757.18",564
,20170502,47570,47490,47890,48370,47890,48060,48160,570,670,424,"10,211.15",812
,20170503,48060,48160,48130,48170,47820,47850,47970,-310,-190,196,"4,701.70",844
,20170504,47850,47970,47450,47450,46500,46660,46840,-1310,-1130,420,"9,836.82",1006
,20170505,46660,46840,46380,46520,46070,46340,46350,-500,-490,96,"2,224.94",1022
,20170508,46340,46350,46350,46820,45800,45800,46220,-550,-130,828,"19,136.66",1264
,20170509,45800,46220,45770,45940,45720,45930,45850,-290,-370,246,"5,639.96",1300
,20170510,45930,45850,46150,46400,45980,46040,46230,190,380,420,"9,708.67",1498
,20170511,46040,46230,46270,46470,45950,46380,46230,150,0,210,"4,854.68",1560
,20170512,46380,46230,46740,46740,46050,46140,46210,-90,-20,214,"4,944.57",1572
,20170515,46140,46210,46300,46640,46130,46590,46500,380,290,476,"11,067.67",1812
,20170516,46590,46500,46570,46680,46240,46310,46450,-190,-50,388,"9,011.74",1992
,20170517,46310,46450,46450,46850,46450,46640,46640,190,190,390,"9,096.23",2210
,20170518,46640,46640,46350,46600,46090,46160,46270,-480,-370,304,"7,033.38",2160
,20170519,46160,46270,45890,46610,45830,46440,46400,170,130,194,"4,501.17",2214
,20170522,46440,46400,46850,47170,46690,46950,47050,550,650,450,"10,588.13",2444
,20170523,46950,47050,47100,47310,46950,46990,47120,-60,70,444,"10,461.33",2612
,20170524,46990,47120,47120,47400,46710,46940,47110,-180,-10,936,"22,051.08",2814
,20170525,46940,47110,46960,47060,46890,47060,46970,-50,-140,138,"3,241.55",2824
,20170526,47060,46970,47190,47400,46980,47050,47190,80,220,88,"2,076.47",2838
,20170531,47050,47190,46960,46960,46410,46430,46710,-760,-480,220,"5,138.92",2884
,20170601,46430,46710,46450,46570,46270,46450,46440,-260,-270,292,"6,780.24",2846
,20170602,46450,46440,46580,46600,46390,46490,46530,50,90,92,"2,140.72",2828
,20170605,46490,46530,46100,46520,46090,46380,46420,-150,-110,452,"10,492.54",3158
,20170606,46380,46420,46340,46360,46050,46050,46280,-370,-140,52,"1,203.31",3158
,20170607,46050,46280,45900,46390,45840,45990,46170,-290,-110,418,"9,650.51",3248
,20170608,45990,46170,46090,46440,46010,46410,46340,240,170,282,"6,535.01",3396
,20170609,46410,46340,46590,47110,46590,47090,46910,750,570,866,"20,313.35",3936
,20170612,47090,46910,47470,47910,47330,47540,47550,630,640,668,"15,884.74",4076
,20170613,47540,47550,47450,47540,47010,47010,47330,-540,-220,184,"4,354.85",4068
,20170614,47010,47330,46970,47160,46850,47100,46980,-230,-350,198,"4,651.54",4044
,20170615,47100,46980,47000,47000,46610,46700,46800,-280,-180,392,"9,173.36",3972
,20170616,46700,46800,46680,46880,46520,46580,46620,-220,-180,136,"3,170.67",3982
,20170619,46580,46620,46750,46820,46570,46820,46710,200,90,512,"11,959.14",4178
,20170620,46820,46710,47050,47180,46940,47080,47070,370,360,82,"1,930.22",4206
,20170621,47080,47070,46770,46830,46600,46750,46720,-320,-350,246,"5,746.89",4302
,20170622,46750,46720,47060,47370,46950,46960,47200,240,480,370,"8,733.35",4466
,20170623,46960,47200,47200,47990,47070,47940,47630,740,430,1396,"33,251.64",5442
,20170626,47940,47630,48190,48190,47660,48140,47930,510,300,1970,"47,213.69",6756
,20170627,48140,47930,47980,47980,47750,47950,47830,20,-100,722,"17,269.46",6492
,20170628,47950,47830,47950,48370,47950,48160,48200,330,370,1566,"37,746.74",7398
,20170629,48160,48200,48280,49760,48260,49030,48880,830,680,6156,"150,472.04",10744
,20170630,49030,48880,49200,49330,48740,48950,49000,70,120,1374,"33,668.84",11018
,20170703,48950,49000,48820,49010,48670,48920,48860,-80,-140,550,"13,438.34",11068
,20170704,48920,48860,48700,48700,48240,48350,48470,-510,-390,834,"20,213.46",11550
,20170705,48350,48470,48440,48630,48410,48430,48500,-40,30,478,"11,591.60",11520
,20170706,48430,48500,48170,48230,47960,48230,48070,-270,-430,440,"10,577.12",11390
,20170707,48230,48070,48210,48340,48060,48340,48130,270,60,468,"11,264.61",11598
,20170710,48340,48130,48160,48370,48030,48110,48290,-20,160,672,"16,226.02",11898
,20170711,48110,48290,47890,48430,47890,48430,48130,140,-160,484,"11,649.07",11940
,20170712,48430,48130,48260,48720,48170,48600,48410,470,280,1134,"27,452.12",12298
,20170713,48600,48410,48770,48790,48520,48690,48680,280,270,116,"2,823.49",12316
,20170714,48690,48680,48690,48800,46360,48330,48550,-350,-130,1668,"40,496.09",12488
,20170717,48330,48550,48400,49240,48400,49210,48690,660,140,1904,"46,360.25",13116
,20170718,49210,48690,49290,49410,48860,48910,49090,220,400,628,"15,415.95",13220
,20170719,48910,49090,49070,49130,48930,49120,49010,30,-80,1078,"26,417.08",13246
,20170720,49120,49010,49120,49120,48880,49050,49020,40,10,308,"7,550.05",13218
,20170721,49050,49020,49060,49270,48950,49180,49050,160,30,134,"3,286.75",13218
,20170724,49180,49050,49160,49210,48980,49050,49150,0,100,610,"14,991.86",13704
,20170725,49050,49150,49250,50000,49080,49920,49620,770,470,3266,"81,035.10",14980
,20170726,49920,49620,50320,52130,50320,51560,51030,1940,1410,5904,"150,647.62",16152
,20170727,51560,51030,51440,51720,51320,51400,51510,370,480,602,"15,506.64",15722
,20170728,51400,51510,51540,51730,50920,51250,51120,-260,-390,398,"10,173.86",15528
,20170731,51250,51120,51380,52140,51380,52130,51720,1010,600,188,"4,862.30",15464
,20170801,52130,51720,51710,51780,51540,51570,51700,-150,-20,124,"3,205.98",15366
,20170802,51570,51700,51480,51690,51230,51360,51550,-340,-150,254,"6,547.41",15180
,20170803,51360,51550,51490,51750,51210,51210,51490,-340,-60,286,"7,363.71",15224
,20170804,51210,51490,51390,51810,51340,51650,51550,160,60,142,"3,660.58",15226
,20170807,51650,51550,51500,52150,51430,51610,51700,60,150,74,"1,913.04",15238
,20170808,51610,51700,52110,52270,51590,51600,51940,-100,240,60,"1,558.49",15234
,20170809,51600,51940,51750,52590,51750,52500,52400,560,460,96,"2,515.50",15196
,20170810,52500,52400,52430,52500,51860,51920,52110,-480,-290,52,"1,355.09",15194
,20170811,51920,52110,51900,51900,51080,51080,51380,-1030,-730,104,"2,671.86",15182
,20170814,51080,51380,51490,51590,51260,51260,51440,-120,60,86,"2,212.00",15190
,20170815,51260,51440,51340,51560,51270,51560,51450,120,10,172,"4,425.54",15200
,20170816,51560,51450,51530,51530,51120,51350,51320,-100,-130,90,"2,309.58",15174
,20170817,51350,51320,51830,52800,51830,52530,52350,1210,1030,166,"4,345.12",15180
,20170818,52530,52350,52270,52350,51810,52200,52100,-150,-250,234,"6,096.70",15190
,20170821,52200,52100,52340,53110,51950,52670,52380,570,280,314,"8,224.97",15202
,20170822,52670,52380,52970,53200,52540,53200,52810,820,430,662,"17,480.88",15234
,20170823,53200,52810,53320,53320,52400,52600,52670,-210,-140,522,"13,748.29",15272
,20170824,52600,52670,52650,53140,52640,52830,52910,160,240,176,"4,656.53",15236
,20170825,52830,52910,52950,53830,52950,53830,53530,920,620,616,"16,489.29",15210
,20170828,53830,53530,53390,53970,53220,53880,53740,350,210,296,"7,953.75",15216
,20170829,53880,53740,53950,54030,51180,53660,53740,-80,0,858,"23,058.51",15256
,20170830,53660,53740,53840,53960,53510,53730,53720,-10,-20,520,"13,969.19",15576
,20170831,53730,53720,53370,53820,53370,53730,53580,10,-140,476,"12,753.23",15594
,20170901,53730,53580,53770,53780,53510,53710,53620,130,40,512,"13,729.15",15656
,20170904,53710,53620,53560,54280,53460,54140,54060,520,440,1560,"42,173.55",16222
,20170905,54140,54060,54000,54530,54000,54530,54300,470,240,116,"3,149.95",16254
,20170906,54530,54300,54270,55590,53580,54130,54070,-170,-230,234,"6,326.27",16258
,20170907,54130,54070,53900,54150,53550,53600,53740,-470,-330,128,"3,439.45",16236
,20170908,53600,53740,53620,53660,52540,52560,53320,-1180,-420,2234,"59,563.18",16250
,20170911,52560,53320,52670,52670,51940,52400,52170,-920,-1150,466,"12,157.26",16282
,20170912,52400,52170,52550,52630,52280,52560,52480,390,310,134,"3,516.82",16294
,20170913,52560,52480,51950,52300,51880,51900,52040,-580,-440,628,"16,340.60",16612
,20170914,51900,52040,51460,51690,51220,51260,51430,-780,-610,1600,"41,145.86",17018
,20170915,51260,51430,51240,51400,50950,51120,51170,-310,-260,1300,"33,261.74",17310
,20170918,51120,51170,50970,51450,50640,51450,50950,280,-220,670,"17,069.70",17388
,20170919,51450,50950,51410,51650,51280,51520,51530,570,580,480,"12,369.00",17430
,20170920,51520,51530,51470,51720,51330,51580,51530,50,0,424,"10,926.43",17514
,20170921,51580,51530,51550,51610,50780,50940,51180,-590,-350,904,"23,135.31",17792
,20170922,50940,51180,50920,51160,50140,50400,50610,-780,-570,750,"18,982.31",18052
,20170925,50400,50610,50590,51250,50590,50960,50940,350,330,1940,"49,412.32",18918
,20170926,50960,50940,51000,51470,50920,51330,51280,390,340,474,"12,155.24",18994
,20170927,51330,51280,51140,51290,50810,51150,51090,-130,-190,914,"23,348.54",19142
,20170928,51150,51090,51270,51270,50710,51260,51020,170,-70,1594,"40,667.21",19154
,20170929,51260,51020,51330,52290,51270,52290,51800,1270,780,1374,"35,586.65",19098
,20171009,52290,51800,52290,52890,52290,52540,52630,740,830,1370,"36,058.11",19476
,20171010,52540,52630,52480,52800,52240,52240,52610,-390,-20,8860,"233,104.83",25636
,20171011,52240,52610,52230,52840,52110,52730,52630,120,20,7290,"191,865.37",27962
,20171012,52730,52630,52620,53870,52530,53510,53290,880,660,21554,"574,325.80",34692
,20171013,53510,53290,53660,53880,53430,53690,53680,400,390,4962,"133,184.36",34888
,20171016,53690,53680,53590,56050,53380,55800,55090,2120,1410,34250,"943,433.24",46894
,20171017,55800,55090,55970,56750,55680,55770,56180,680,1090,8964,"251,828.12",45538
,20171018,55770,56180,55840,55960,55080,55480,55530,-700,-650,3092,"85,852.47",45478
,20171019,55480,55530,55430,55700,55080,55190,55310,-340,-220,2696,"74,571.19",45292
,20171020,55190,55310,54920,55960,54760,55690,55520,380,210,3572,"99,175.34",45954
,20171023,55690,55520,55500,55730,54700,54960,55120,-560,-400,2610,"71,933.15",45990
,20171024,54960,55120,55240,56260,55150,55900,55930,780,810,5732,"160,321.72",47226
,20171025,55900,55930,55980,56020,54600,55000,55390,-930,-540,8426,"233,371.53",48194
,20171026,55000,55390,55260,55520,55070,55180,55250,-210,-140,2890,"79,838.33",48942
,20171027,55180,55250,55150,55290,54290,54350,54640,-900,-610,4386,"119,842.18",49252
,20171030,54350,54640,54000,54170,53710,53930,53910,-710,-730,3080,"83,031.08",49796
,20171031,53930,53910,54070,54500,53750,54180,54050,270,140,3694,"99,833.49",51032
,20171101,54180,54050,53900,55250,53820,54860,54640,810,590,3714,"101,481.57",51180
,20171102,54860,54640,54620,54780,54190,54380,54470,-260,-170,4046,"110,193.92",51362
,20171103,54380,54470,54240,55140,54230,54740,54710,270,240,6186,"169,240.92",51452
,20171106,54740,54710,54710,55180,54200,55110,54860,400,150,5562,"152,570.13",52330
,20171107,55110,54860,55050,55450,54800,54990,55060,130,200,5662,"155,877.28",53480
,20171108,54990,55060,54710,54820,53780,53850,54110,-1210,-950,5662,"153,191.72",53328
,20171109,53850,54110,54060,54340,53490,53590,54050,-520,-60,6276,"169,637.89",53560
,20171110,53590,54050,53690,54180,53580,53980,53940,-70,-110,2472,"66,671.16",53738
,20171113,53980,53940,54050,54050,53730,54010,53940,70,0,2590,"69,865.19",53940
,20171114,54010,53940,53870,55170,53660,54490,54700,550,760,25498,"697,402.41",59798
,20171115,54490,54700,54400,54560,53020,53200,53520,-1500,-1180,10478,"280,435.18",60922
,20171116,53200,53520,53390,53500,52940,53250,53310,-270,-210,9176,"244,586.66",62762
,20171117,53250,53310,53480,53600,53120,53350,53360,40,50,4482,"119,581.11",63418
,20171120,53350,53360,53310,53840,53050,53400,53410,40,50,5704,"152,345.76",63946
,20171121,53400,53410,53430,54070,53340,53860,53750,450,340,5024,"135,022.39",64246
,20171122,53860,53750,54020,54690,53990,54590,54410,840,660,8506,"231,439.16",65130
,20171123,54590,54410,54390,54710,54230,54250,54470,-160,60,7504,"204,371.81",66956
,20171124,54250,54470,54270,54860,54160,54800,54570,330,100,10242,"279,466.95",71282
,20171127,54800,54570,54930,55140,54170,54210,54640,-360,70,13522,"369,438.25",70716
,20171128,54210,54640,54280,54400,53590,53850,53960,-790,-680,10288,"277,572.54",71050
,20171129,53850,53960,53550,53760,53370,53540,53570,-420,-390,9892,"264,967.54",73872
,20171130,53540,53570,53340,53430,52750,53170,53090,-400,-480,11462,"304,273.90",74840
,20171201,53170,53090,53350,53540,52980,53220,53110,130,20,8430,"223,888.04",73744
,20171204,53220,53110,53080,53980,53050,53850,53670,740,560,8974,"240,825.18",73322
,20171205,53850,53670,53780,53820,52710,52800,53180,-870,-490,17100,"454,726.20",71840
,20171206,52800,53180,52500,52530,51330,51640,51750,-1540,-1430,36350,"940,628.89",70774
,20171207,51640,51750,51660,51950,51410,51440,51650,-310,-100,12576,"324,818.87",71424
,20171208,51440,51650,51650,52110,51500,51980,51810,330,160,16214,"420,070.73",72100
,20171211,51980,51810,51930,52110,51500,51540,51820,-270,10,13022,"337,422.48",72716
,20171212,51540,51820,51760,52530,51610,52300,52150,480,330,18060,"471,001.97",73082
,20171213,52300,52150,52300,52660,52110,52600,52410,450,260,20950,"549,082.92",78042
,20171214,52600,52410,52600,52970,52410,52550,52730,140,320,22030,"580,921.80",74490
,20171215,52550,52730,52770,53280,52770,53170,53070,440,340,15848,"420,603.91",74458
,20171218,53170,53070,53090,54070,53030,53790,53750,720,680,16222,"436,044.15",75862
,20171219,53790,53750,53860,54070,53550,53650,53790,-100,40,13190,"354,808.52",77428
,20171220,53650,53790,53700,54180,53660,53970,53940,180,150,10926,"294,698.59",78382
,20171221,53970,53940,54150,54880,54100,54490,54540,550,600,16572,"451,927.51",79438
,20171222,54490,54540,54500,54850,54290,54800,54600,260,60,13976,"381,566.70",80620
,20171225,54800,54600,54800,55550,54690,54990,55140,390,540,18284,"504,118.28",80736
,20171226,54990,55140,54990,55580,54750,55500,55160,360,20,21938,"605,053.98",83510
,20171227,55500,55160,55610,55710,55120,55240,55370,80,210,30990,"858,101.16",89816
,20171228,55240,55370,55300,56110,55300,56110,55750,740,380,43108,"1,201,670.41",96784
,20171229,56110,55750,55980,56130,55540,55750,55840,0,90,27132,"757,562.04",100094
cu1805,20170516,46500,46500,46750,46760,46270,46400,46530,-100,30,422,"9,818.53",370
,20170517,46400,46530,46650,47000,46620,46780,46840,250,310,832,"19,486.89",952
,20170518,46780,46840,46510,46750,46280,46310,46490,-530,-350,118,"2,742.96",954
,20170519,46310,46490,45910,46780,45910,46580,46650,90,160,804,"18,756.46",1366
,20170522,46580,46650,46840,47390,46830,47120,47140,470,490,722,"17,018.84",1764
,20170523,47120,47140,47200,47400,47010,47160,47260,20,120,308,"7,278.92",1806
,20170524,47160,47260,47230,47580,46870,47050,47200,-210,-60,828,"19,541.98",1966
,20170525,47050,47200,47080,47260,46960,47200,47110,0,-90,234,"5,512.10",2048
,20170526,47200,47110,47110,47580,47050,47250,47360,140,250,616,"14,589.40",2424
,20170531,47250,47360,47000,47100,46530,46530,46910,-830,-450,698,"16,372.49",2554
,20170601,46530,46910,46560,46690,46420,46610,46570,-300,-340,248,"5,774.68",2554
,20170602,46610,46570,46670,46760,46510,46600,46660,30,90,186,"4,339.94",2594
,20170605,46600,46660,46250,46620,46160,46570,46540,-90,-120,564,"13,125.48",2912
,20170606,46570,46540,46430,46560,46300,46300,46420,-240,-120,262,"6,081.04",2900
,20170607,46300,46420,46080,46550,46000,46090,46290,-330,-130,472,"10,924.62",3076
,20170608,46090,46290,46130,46670,46080,46510,46410,220,120,380,"8,819.44",3126
,20170609,46510,46410,46730,47300,46730,47200,47160,790,750,1154,"27,213.47",3806
,20170612,47200,47160,47630,47960,47470,47740,47680,580,520,1016,"24,223.52",3866
,20170613,47740,47680,47550,47650,47180,47200,47440,-480,-240,102,"2,419.48",3862
,20170614,47200,47440,47130,47280,46980,47250,47100,-190,-340,944,"22,233.40",4138
,20170615,47250,47100,47130,47140,46730,46800,46920,-300,-180,1072,"25,153.44",4578
,20170616,46800,46920,46730,46970,46560,46670,46730,-250,-190,112,"2,617.41",4600
,20170619,46670,46730,46810,47000,46640,46850,46770,120,40,754,"17,634.40",4970
,20170620,46850,46770,47100,47270,47030,47160,47160,390,390,150,"3,537.01",4966
,20170621,47160,47160,46830,46930,46700,46830,46810,-330,-350,164,"3,838.72",4948
,20170622,46830,46810,47170,47450,46990,47030,47240,220,430,354,"8,362.26",4998
,20170623,47030,47240,47510,48110,47140,48100,47670,860,430,1350,"32,177.51",5834
,20170626,48100,47670,48020,48320,47740,48210,48080,540,410,1722,"41,405.11",7012
,20170627,48210,48080,48120,48120,47910,48090,47980,10,-100,478,"11,469.23",6898
,20170628,48090,47980,48050,48480,48050,48210,48290,230,310,1036,"25,015.28",7166
,20170629,48210,48290,48390,49990,48210,49200,49300,910,1010,6800,"167,646.84",10544
,20170630,49200,49300,49300,49570,48970,49100,49300,-200,0,1418,"34,956.07",10950
,20170703,49100,49300,48980,49180,48900,49110,49020,-190,-280,594,"14,560.61",10944
,20170704,49110,49020,48940,48950,48470,48500,48700,-520,-320,776,"18,896.80",11356
,20170705,48500,48700,48680,48810,48580,48610,48670,-90,-30,528,"12,849.64",11360
,20170706,48610,48670,48350,48450,48170,48450,48270,-220,-400,540,"13,033.92",11374
,20170707,48450,48270,48420,48600,48320,48600,48390,330,120,402,"9,727.70",11562
,20170710,48600,48390,48410,48550,48290,48300,48410,-90,20,432,"10,456.67",11558
,20170711,48300,48410,48170,48650,48090,48580,48290,170,-120,376,"9,080.06",11582
,20170712,48580,48290,48430,48970,48370,48730,48710,440,420,1078,"26,256.85",12022
,20170713,48730,48710,48920,49030,48680,48880,48830,170,120,172,"4,199.98",12032
,20170714,48880,48830,48870,48970,48450,48520,48660,-310,-170,906,"22,045.55",12128
,20170717,48520,48660,48600,49490,48590,49320,48860,660,200,2150,"52,533.96",13168
,20170718,49320,48860,49520,49610,49050,49130,49340,270,480,492,"12,139.52",13202
,20170719,49130,49340,49240,49330,49140,49330,49210,-10,-130,382,"9,399.52",13220
,20170720,49330,49210,49220,49270,49030,49210,49170,0,-40,114,"2,803.20",13234
,20170721,49210,49170,49250,49480,49000,49430,49220,260,50,180,"4,430.02",13244
,20170724,49430,49220,49490,49520,49140,49250,49310,30,90,116,"2,860.48",13264
,20170725,49250,49310,49410,50200,49250,50160,49890,850,580,2454,"61,215.14",14438
,20170726,50160,49890,50590,52420,50590,51730,51460,1840,1570,2726,"70,152.67",14598
,20170727,51730,51460,51620,51970,51480,51590,51750,130,290,358,"9,263.77",14526
,20170728,51590,51750,51860,51940,51120,51390,51420,-360,-330,234,"6,016.65",14522
,20170731,51390,51420,51600,52360,51510,52170,51830,750,410,382,"9,900.85",14498
,20170801,52170,51830,51890,52040,51720,51720,51890,-110,60,94,"2,439.04",14488
,20170802,51720,51890,51670,51830,51380,51590,51560,-300,-330,144,"3,712.89",14502
,20170803,51590,51560,51650,51930,51410,51410,51670,-150,110,378,"9,767.37",14516
,20170804,51410,51670,51590,52070,51590,51850,51730,180,60,798,"20,643.35",14516
,20170807,51850,51730,51580,52400,51550,51800,51840,70,110,230,"5,961.79",14516
,20170808,51800,51840,51900,52490,51840,51860,52070,20,230,242,"6,300.64",14514
,20170809,51860,52070,52040,52820,51920,52590,52570,520,500,354,"9,305.91",14520
,20170810,52590,52570,52540,52740,52030,52130,52380,-440,-190,214,"5,604.98",14556
,20170811,52130,52380,51980,52000,51230,51270,51580,-1110,-800,178,"4,590.77",14556
,20170814,51270,51580,51730,51880,51410,51410,51710,-170,130,230,"5,946.67",14636
,20170815,51410,51710,51550,51760,51500,51710,51670,0,-40,112,"2,893.76",14656
,20170816,51710,51670,51590,51650,51360,51580,51510,-90,-160,152,"3,915.24",14652
,20170817,51580,51510,52010,53000,51990,52770,52640,1260,1130,350,"9,212.42",14688
,20170818,52770,52640,52500,52570,52060,52410,52350,-230,-290,154,"4,031.67",14662
,20170821,52410,52350,52450,53200,52040,52880,52570,530,220,358,"9,411.72",14688
,20170822,52880,52570,53110,53390,52710,53390,53130,820,560,788,"20,933.57",14494
,20170823,53390,53130,53490,53500,52610,52820,52780,-310,-350,482,"12,720.89",14490
,20170824,52820,52780,52810,53300,52650,53040,52940,260,160,254,"6,723.42",14478
,20170825,53040,52940,53160,54050,53160,54000,53780,1060,840,554,"14,899.67",14462
,20170828,54000,53780,53980,54140,53250,54140,53750,360,-30,222,"5,966.81",14454
,20170829,54140,53750,54100,54160,53720,53800,53950,50,200,654,"17,642.71",14394
,20170830,53800,53950,54030,54150,53720,53960,53880,10,-70,392,"10,561.37",14408
,20170831,53960,53880,53630,54050,53580,53960,53830,80,-50,460,"12,381.25",14412
,20170901,53960,53830,53960,53980,53690,53930,53870,100,40,184,"4,956.35",14408
,20170904,53930,53870,53780,54450,53720,54270,54170,400,300,282,"7,638.47",14426
,20170905,54270,54170,54300,54700,54200,54700,54450,530,280,94,"2,559.33",14448
,20170906,54700,54450,54490,54550,53730,54280,54230,-170,-220,184,"4,989.36",14448
,20170907,54280,54230,54000,54380,53770,53810,54020,-420,-210,162,"4,376.19",14450
,20170908,53810,54020,53810,53820,52750,52780,53190,-1240,-830,1966,"52,294.97",14472
,20170911,52780,53190,52820,52820,52020,52590,52370,-600,-820,450,"11,784.68",14420
,20170912,52590,52370,52780,52910,52500,52760,52750,390,380,338,"8,915.44",14446
,20170913,52760,52750,52170,52520,52050,52100,52330,-650,-420,582,"15,228.20",14450
,20170914,52100,52330,51680,51860,51350,51590,51650,-740,-680,1832,"47,311.80",14880
,20170915,51590,51650,51430,51600,51100,51340,51380,-310,-270,1126,"28,932.10",15246
,20170918,51340,51380,51200,51690,50800,51550,51210,170,-170,312,"7,988.87",15256
,20170919,51550,51210,51610,51860,51480,51730,51760,520,550,494,"12,786.54",15232
,20170920,51730,51760,51730,51900,51480,51760,51720,0,-40,298,"7,706.89",15268
,20170921,51760,51720,51750,51800,50960,51040,51470,-680,-250,1442,"37,115.33",15392
,20170922,51040,51470,51270,51390,50350,50540,50800,-930,-670,1170,"29,720.40",15624
,20170925,50540,50800,50770,51370,50770,51150,51110,350,310,1118,"28,573.01",16106
,20170926,51150,51110,51190,51630,51070,51550,51440,440,330,390,"10,031.78",16124
,20170927,51550,51440,51230,51460,51090,51380,51240,-60,-200,676,"17,319.51",16214
,20170928,51380,51240,51430,51430,50870,51400,51180,160,-60,680,"17,404.41",16174
,20170929,51400,51180,51500,52430,51430,52360,51950,1180,770,474,"12,312.16",16098
,20171009,52360,51950,52750,53050,52610,52680,52820,730,870,1576,"41,625.25",17114
,20171010,52680,52820,52670,52950,52400,52410,52740,-410,-80,1046,"27,587.03",17560
,20171011,52410,52740,52310,53010,52260,52950,52840,210,100,7630,"201,620.99",22586
,20171012,52950,52840,52860,54130,52670,53700,53590,860,750,19494,"522,356.46",35006
,20171013,53700,53590,53820,54100,53600,53860,53870,270,280,4108,"110,663.82",35230
,20171016,53860,53870,53830,56280,53540,56050,55240,2180,1370,25950,"716,751.34",43544
,20171017,56050,55240,56050,56970,55850,55970,56390,730,1150,5594,"157,743.65",43086
,20171018,55970,56390,56050,56160,55240,55650,55760,-740,-630,1966,"54,821.11",43128
,20171019,55650,55760,55590,55960,55270,55400,55480,-360,-280,2704,"75,018.43",43148
,20171020,55400,55480,55110,56170,54910,55850,55820,370,340,3778,"105,461.86",43666
,20171023,55850,55820,55800,55920,54910,55160,55370,-660,-450,2966,"82,118.52",43528
,20171024,55160,55370,55390,56440,55290,56070,56010,700,640,4158,"116,459.71",43308
,20171025,56070,56010,56170,56200,54790,55110,55460,-900,-550,5038,"139,725.21",43526
,20171026,55110,55460,55410,55660,55240,55360,55440,-100,-20,3022,"83,782.65",44138
,20171027,55360,55440,55340,55440,54460,54600,54810,-840,-630,5006,"137,190.01",44386
,20171030,54600,54810,54010,54310,53900,54090,54100,-720,-710,2128,"57,565.74",44238
,20171031,54090,54100,54090,54680,53910,54380,54250,280,150,1412,"38,307.23",44186
,20171101,54380,54250,54100,55400,54000,55010,54780,760,530,2600,"71,220.49",44306
,20171102,55010,54780,54900,54980,54370,54570,54680,-210,-100,2934,"80,226.98",44292
,20171103,54570,54680,54470,55360,54460,54920,54990,240,310,2102,"57,802.85",44238
,20171106,54920,54990,54810,55360,54380,55360,54920,370,-70,1932,"53,053.18",44182
,20171107,55360,54920,55280,55580,54990,55090,55210,170,290,1632,"45,057.87",44468
,20171108,55090,55210,54900,54960,53950,54010,54250,-1200,-960,4036,"109,481.31",45110
,20171109,54010,54250,54190,54480,53670,53830,53980,-420,-270,2352,"63,488.24",45200
,20171110,53830,53980,53580,54340,53580,54120,54070,140,90,1298,"35,095.93",45244
,20171113,54120,54070,54150,54250,53880,54200,54140,130,70,1854,"50,194.58",45440
,20171114,54200,54140,54100,55500,53820,54660,54980,520,840,16556,"455,205.99",45626
,20171115,54660,54980,54620,54700,53260,53340,53760,-1640,-1220,4838,"130,046.72",45518
,20171116,53340,53760,53520,53690,53130,53430,53500,-330,-260,4478,"119,795.10",46268
,20171117,53430,53500,53680,53800,53250,53600,53520,100,20,2112,"56,526.71",46470
,20171120,53600,53520,53460,54050,53240,53570,53630,50,110,1922,"51,544.46",46624
,20171121,53570,53630,53670,54280,53550,54050,53920,420,290,1830,"49,344.08",46716
,20171122,54050,53920,54150,54870,54150,54730,54630,810,710,2966,"81,021.24",47082
,20171123,54730,54630,54550,54900,54410,54470,54610,-160,-20,6044,"165,033.79",50372
,20171124,54470,54610,54480,55050,54440,54990,54760,380,150,3980,"108,991.80",51878
,20171127,54990,54760,55080,55320,54390,54490,54940,-270,180,5892,"161,859.42",52214
,20171128,54490,54940,54520,54600,53800,54050,54210,-890,-730,4652,"126,107.08",52318
,20171129,54050,54210,53910,53970,53580,53790,53800,-420,-410,4920,"132,364.35",52752
,20171130,53790,53800,53530,53640,52930,53380,53330,-420,-470,6676,"178,035.69",53556
,20171201,53380,53330,53660,53820,53160,53370,53370,40,40,6356,"169,627.08",53670
,20171204,53370,53370,53180,54180,53180,54030,53820,660,450,4010,"107,911.94",54084
,20171205,54030,53820,54010,54020,52900,53000,53510,-820,-310,4446,"118,970.34",54852
,20171206,53000,53510,52630,52710,51510,51790,52030,-1720,-1480,10410,"270,834.40",56662
,20171207,51790,52030,51870,52130,51590,51680,51860,-350,-170,4254,"110,314.69",56664
,20171208,51680,51860,51810,52270,51690,52170,52010,310,150,7026,"182,739.67",56706
,20171211,52170,52010,52170,52300,51700,51760,52000,-250,-10,4516,"117,429.35",57006
,20171212,51760,52000,51940,52680,51830,52520,52350,520,350,5700,"149,204.08",57292
,20171213,52520,52350,52630,52830,52290,52770,52600,420,250,7248,"190,657.74",58316
,20171214,52770,52600,52950,53140,52580,52730,52920,130,320,11852,"313,652.54",60984
,20171215,52730,52920,53020,53460,52950,53320,53210,400,290,8942,"237,909.44",63594
,20171218,53320,53210,53280,54250,53200,53990,53900,780,690,9464,"255,077.98",64344
,20171219,53990,53900,54090,54250,53730,53840,53950,-60,50,10010,"270,069.75",65522
,20171220,53840,53950,53940,54360,53830,54150,54120,200,170,7000,"189,424.22",66446
,20171221,54150,54120,54310,55060,54280,54630,54740,510,620,11986,"328,063.86",67790
,20171222,54630,54740,54680,55030,54480,54990,54780,250,40,13074,"358,127.78",70236
,20171225,54990,54780,54880,55700,54860,55200,55280,420,500,14716,"406,798.89",71724
,20171226,55200,55280,55190,55750,54940,55700,55300,420,20,15050,"416,149.74",75842
,20171227,55700,55300,55790,55900,55300,55400,55550,100,250,18172,"504,802.66",79628
,20171228,55400,55550,55500,56300,55490,56240,55900,690,350,27848,"778,432.96",83396
,20171229,56240,55900,55800,56320,55720,55910,56050,10,150,21158,"593,008.11",81950
cu1806,20170616,46920,46920,46850,47090,46780,46830,46940,-90,20,92,"2,159.42",74
,20170619,46830,46940,47030,47130,46750,46940,46940,0,0,368,"8,638.73",374
,20170620,46940,46940,47220,47400,47190,47230,47260,290,320,72,"1,701.54",400
,20170621,47230,47260,46960,47050,46800,46930,46910,-330,-350,352,"8,256.41",642
,20170622,46930,46910,47260,47520,47150,47150,47350,240,440,272,"6,439.89",796
,20170623,47150,47350,47370,48210,47320,48210,47520,860,170,448,"10,645.38",1066
,20170626,48210,47520,48100,48430,47850,48430,48170,910,650,1784,"42,971.66",2434
,20170627,48430,48170,48200,48240,48010,48180,48090,10,-80,898,"21,592.60",2884
,20170628,48180,48090,48130,48640,48130,48450,48490,360,400,1350,"32,731.51",3610
,20170629,48450,48490,48370,50420,48370,49380,49400,890,910,11962,"295,511.15",11322
,20170630,49380,49400,49450,49710,49160,49300,49450,-100,50,1822,"45,054.41",11978
,20170703,49300,49450,49200,49300,49070,49300,49190,-150,-260,560,"13,773.82",12112
,20170704,49300,49190,49110,49200,48660,48700,48890,-490,-300,382,"9,338.28",12168
,20170705,48700,48890,48860,49020,48780,48800,48920,-90,30,592,"14,483.02",12292
,20170706,48800,48920,48540,48660,48380,48650,48500,-270,-420,358,"8,682.53",12212
,20170707,48650,48500,48650,48800,48480,48780,48610,280,110,602,"14,631.90",12254
,20170710,48780,48610,48600,48730,48460,48470,48610,-140,0,322,"7,827.44",12378
,20170711,48470,48610,48320,48800,48270,48800,48380,190,-230,762,"18,433.06",12698
,20170712,48800,48380,48610,49200,48550,48980,48940,600,560,1218,"29,805.18",13234
,20170713,48980,48940,49160,49190,48860,49060,49010,120,70,222,"5,440.68",13336
,20170714,49060,49010,49050,49110,48600,48700,48850,-310,-160,496,"12,116.54",13376
,20170717,48700,48850,48800,49680,48780,49510,49320,660,470,2512,"61,948.81",14888
,20170718,49510,49320,51430,51440,49240,49240,49740,-80,420,1344,"33,426.49",15454
,20170719,49240,49740,49430,49550,49330,49550,49380,-190,-360,734,"18,125.06",15554
,20170720,49550,49380,48820,49510,48820,49380,49340,0,-40,448,"11,052.47",15706
,20170721,49380,49340,49370,49600,49100,49560,49390,220,50,248,"6,125.03",15770
,20170724,49560,49390,49660,49700,49300,49380,49480,-10,90,270,"6,681.10",15772
,20170725,49380,49480,49580,50400,49420,50300,50080,820,600,2198,"55,047.98",16248
,20170726,50300,50080,50750,52600,50740,51920,51620,1840,1540,2684,"69,279.24",16966
,20170727,51920,51620,51880,52140,51700,51760,51900,140,280,594,"15,415.55",16730
,20170728,51760,51900,51880,52090,51290,51610,51490,-290,-410,582,"14,984.62",16876
,20170731,51610,51490,51730,52550,51620,52410,51850,920,360,774,"20,069.13",16940
,20170801,52410,51850,52710,52710,51880,51880,52060,30,210,200,"5,206.70",16976
,20170802,51880,52060,51830,52050,51600,51730,51780,-330,-280,112,"2,899.81",16932
,20170803,51730,51780,51800,52090,51560,51560,51850,-220,70,576,"14,932.95",16958
,20170804,51560,51850,51780,52150,51760,51990,51890,140,40,900,"23,351.65",17236
,20170807,51990,51890,51910,52500,51720,51910,51990,20,100,160,"4,159.47",17222
,20170808,51910,51990,52030,52640,52000,52000,52340,10,350,328,"8,585.29",17138
,20170809,52000,52340,52070,52950,52060,52860,52590,520,250,238,"6,258.47",17184
,20170810,52860,52590,52690,52780,52210,52290,52470,-300,-120,256,"6,716.94",17112
,20170811,52290,52470,52200,52200,51320,51500,51630,-970,-840,324,"8,364.92",17056
,20170814,51500,51630,51900,52020,51570,51570,51830,-60,200,210,"5,442.64",17160
,20170815,51570,51830,51720,51920,51650,51870,51820,40,-10,462,"11,972.25",16982
,20170816,51870,51820,51750,51760,51500,51700,51650,-120,-170,142,"3,667.56",16940
,20170817,51700,51650,52270,53130,52260,52830,52810,1180,1160,470,"12,412.21",16946
,20170818,52830,52810,52520,52710,52190,52570,52420,-240,-390,228,"5,976.90",16932
,20170821,52570,52420,52770,53360,52200,53010,52750,590,330,342,"9,021.18",17008
,20170822,53010,52750,53250,53550,52880,53550,53290,800,540,1216,"32,401.49",16584
,20170823,53550,53290,53630,53630,52750,52920,53210,-370,-80,150,"3,990.84",16536
,20170824,52920,53210,52800,53500,52800,53320,53110,110,-100,174,"4,620.64",16486
,20170825,53320,53110,53270,54180,53270,54180,53900,1070,790,1152,"31,050.56",16028
,20170828,54180,53900,54170,54310,53450,54310,53900,410,0,202,"5,444.46",15924
,20170829,54310,53900,54270,54390,53940,54070,54130,170,230,1560,"42,224.64",15178
,20170830,54070,54130,54220,54370,53920,54130,54050,0,-80,212,"5,729.37",15136
,20170831,54130,54050,53820,54190,53780,54150,54090,100,40,1046,"28,293.62",14774
,20170901,54150,54090,54170,54200,53860,54160,54100,70,10,360,"9,738.77",14742
,20170904,54160,54100,53940,54690,53890,54490,54410,390,310,300,"8,162.86",14750
,20170905,54490,54410,54440,54850,54410,54850,54560,440,150,172,"4,692.35",14766
,20170906,54850,54560,54640,54720,54100,54460,54430,-100,-130,154,"4,191.73",14746
,20170907,54460,54430,54380,54550,53920,53990,54290,-440,-140,138,"3,746.05",14740
,20170908,53990,54290,54000,54000,52920,52960,53450,-1330,-840,354,"9,461.92",14772
,20170911,52960,53450,52880,52880,52250,52760,52540,-690,-910,382,"10,036.52",14792
,20170912,52760,52540,52930,53090,52610,52950,52910,410,370,208,"5,503.47",14740
,20170913,52950,52910,52510,52680,52250,52270,52410,-640,-500,92,"2,411.11",14724
,20170914,52270,52410,51890,52040,51600,51600,51810,-810,-600,1620,"41,968.93",14868
,20170915,51600,51810,51590,51760,51340,51550,51590,-260,-220,1188,"30,649.46",14866
,20170918,51550,51590,51310,51860,51010,51840,51420,250,-170,756,"19,439.38",14658
,20170919,51840,51420,51710,52010,51710,51930,51970,510,550,1172,"30,458.94",14250
,20170920,51930,51970,51830,52110,51720,52000,51910,30,-60,132,"3,426.08",14244
,20170921,52000,51910,52000,52010,51230,51300,51770,-610,-140,1330,"34,427.56",14262
,20170922,51300,51770,51410,51550,50580,50730,51010,-1040,-760,1012,"25,813.51",14602
,20170925,50730,51010,51020,51560,50980,51420,51280,410,270,640,"16,411.37",14688
,20170926,51420,51280,51400,51820,51340,51770,51620,490,340,624,"16,107.46",14674
,20170927,51770,51620,51360,51680,51250,51530,51520,-90,-100,806,"20,765.20",14546
,20170928,51530,51520,51590,51600,51110,51600,51370,80,-150,1258,"32,313.91",14670
,20170929,51600,51370,51630,52620,51560,52530,52160,1160,790,1470,"38,341.86",14772
,20171009,52530,52160,52710,53110,52710,52860,52920,700,760,370,"9,791.64",14800
,20171010,52860,52920,52600,53100,52550,52550,52920,-370,0,1478,"39,114.33",15464
,20171011,52550,52920,52480,53120,52480,53040,52960,120,40,1970,"52,175.22",16172
,20171012,53040,52960,52830,54300,52830,53840,53660,880,700,10590,"284,134.62",23080
,20171013,53840,53660,53840,54260,53780,54000,54120,340,460,3514,"95,102.37",25100
,20171016,54000,54120,54000,56460,53730,56200,55570,2080,1450,23506,"653,184.48",37812
,20171017,56200,55570,56380,57150,56090,56180,56600,610,1030,5972,"169,033.92",37920
,20171018,56180,56600,56300,56360,55460,55840,55940,-760,-660,2056,"57,506.87",37946
,20171019,55840,55940,55750,56100,55460,55590,55700,-350,-240,1446,"40,272.92",38074
,20171020,55590,55700,55240,56360,55070,56100,55900,400,200,2338,"65,347.64",38432
,20171023,56100,55900,55890,56070,55100,55350,55600,-550,-300,1618,"44,981.20",38518
,20171024,55350,55600,55580,56640,55510,56290,56280,690,680,2722,"76,601.56",38748
,20171025,56290,56280,56390,56400,54870,55270,55710,-1010,-570,3250,"90,544.77",38690
,20171026,55270,55710,55530,55800,55370,55520,55540,-190,-170,1692,"46,990.28",38782
,20171027,55520,55540,55560,55590,54570,54700,54940,-840,-600,2262,"62,143.20",39268
,20171030,54700,54940,54300,54490,54040,54270,54230,-670,-710,1302,"35,308.18",39374
,20171031,54270,54230,54320,54800,54080,54560,54380,330,150,1432,"38,941.04",39748
,20171101,54560,54380,54320,55500,54150,55100,54980,720,600,896,"24,631.88",39760
,20171102,55100,54980,55000,55100,54520,54660,54860,-320,-120,2780,"76,269.10",39846
,20171103,54660,54860,54650,55430,54650,55040,55080,180,220,1360,"37,456.36",39954
,20171106,55040,55080,54850,55460,54550,55400,55050,320,-30,1364,"37,550.74",40066
,20171107,55400,55050,55350,55690,55150,55300,55390,250,340,1176,"32,569.55",40150
,20171108,55300,55390,55000,55140,54130,54160,54320,-1230,-1070,2774,"75,353.96",39832
,20171109,54160,54320,54440,54660,53850,53950,54230,-370,-90,1552,"42,089.52",39716
,20171110,53950,54230,53920,54540,53590,54340,54340,110,110,1790,"48,639.91",39946
,20171113,54340,54340,54340,54470,54110,54450,54340,110,0,886,"24,076.61",40052
,20171114,54450,54340,53990,55730,53990,54860,55240,520,900,19294,"532,910.47",41334
,20171115,54860,55240,54810,54920,53440,53590,53970,-1650,-1270,3120,"84,201.86",41156
,20171116,53590,53970,53710,53880,53380,53620,53690,-350,-280,2498,"67,067.78",40416
,20171117,53620,53690,53870,54000,53470,53740,53750,50,60,1334,"35,852.81",40644
,20171120,53740,53750,53600,54200,53440,53770,53780,20,30,1088,"29,259.26",40550
,20171121,53770,53780,53970,54450,53750,54260,54120,480,340,742,"20,079.03",40486
,20171122,54260,54120,54390,55080,54390,54930,54860,810,740,1464,"40,160.74",40766
,20171123,54930,54860,54820,55090,54600,54620,54820,-240,-40,1026,"28,122.73",40806
,20171124,54620,54820,54640,55210,54640,55140,55000,320,180,1812,"49,833.56",40996
,20171127,55140,55000,55270,55460,54570,54640,55080,-360,80,1112,"30,626.04",41032
,20171128,54640,55080,54690,54770,53980,54220,54400,-860,-680,1034,"28,127.32",40976
,20171129,54220,54400,54080,54170,53800,54030,53980,-370,-420,886,"23,915.15",40930
,20171130,54030,53980,53750,53790,53150,53540,53470,-440,-510,1546,"41,334.61",41008
,20171201,53540,53470,53790,53790,53360,53580,53570,110,100,1448,"38,786.67",40970
,20171204,53580,53570,53550,54310,53470,54140,54020,570,450,1146,"30,956.58",40994
,20171205,54140,54020,54100,54160,53080,53230,53610,-790,-410,1830,"49,061.56",41048
,20171206,53230,53610,53010,53010,51680,51990,52170,-1620,-1440,15892,"414,555.34",42864
,20171207,51990,52170,52010,52270,51790,51800,51960,-370,-210,3012,"78,261.14",42876
,20171208,51800,51960,52050,52450,51870,52300,52150,340,190,2296,"59,868.34",42822
,20171211,52300,52150,52170,52460,51880,51940,52140,-210,-10,1904,"49,639.56",43290
,20171212,51940,52140,52190,52850,52020,52690,52530,550,390,1612,"42,347.08",43410
,20171213,52690,52530,52720,52990,52500,52920,52760,390,230,1260,"33,241.38",43358
,20171214,52920,52760,53170,53290,52770,52920,53070,160,310,1412,"37,471.95",43278
,20171215,52920,53070,53110,53600,53100,53430,53390,360,320,888,"23,709.08",43348
,20171218,53430,53390,53450,54390,53380,54130,54060,740,670,1660,"44,877.44",43348
,20171219,54130,54060,54110,54420,53910,53920,54130,-140,70,766,"20,732.31",43318
,20171220,53920,54130,54050,54530,54000,54310,54250,180,120,3272,"88,755.52",43548
,20171221,54310,54250,54430,55200,54430,54780,54870,530,620,2300,"63,101.99",44198
,20171222,54780,54870,54850,55180,54650,55110,54930,240,60,3116,"85,581.61",44784
,20171225,55110,54930,55140,55860,55120,55350,55460,420,530,2800,"77,652.53",45110
,20171226,55350,55460,55290,55900,55090,55870,55480,410,20,4662,"129,341.09",46394
,20171227,55870,55480,56290,56290,55490,55580,55710,100,230,2676,"74,551.78",46468
,20171228,55580,55710,55700,56570,55670,56370,56050,660,340,4788,"134,194.53",46686
,20171229,56370,56050,56030,56430,55900,56060,56230,10,180,5058,"142,215.14",47338
cu1807,20170718,49320,49320,49810,49990,49430,49480,49770,160,450,292,"7,267.35",216
,20170719,49480,49770,49600,49680,49500,49660,49580,-110,-190,198,"4,909.16",374
,20170720,49660,49580,49650,49690,49420,49580,49510,0,-70,166,"4,109.91",446
,20170721,49580,49510,49480,51900,49350,49650,49900,140,390,254,"6,337.73",534
,20170724,49650,49900,49620,49660,49480,49550,49600,-350,-300,210,"5,208.49",688
,20170725,49550,49600,49650,50620,49640,50550,50430,950,830,5318,"134,094.93",4480
,20170726,50550,50430,50880,52850,50880,52150,52280,1720,1850,3434,"89,778.53",6680
,20170727,52150,52280,52120,52320,51900,51920,52090,-360,-190,742,"19,326.68",6820
,20170728,51920,52090,52120,52310,51470,51800,51590,-290,-500,868,"22,394.39",6856
,20170731,51800,51590,51800,52700,51800,52540,52190,950,600,1530,"39,928.00",7414
,20170801,52540,52190,52270,52350,52060,52110,52250,-80,60,400,"10,450.49",7300
,20170802,52110,52250,52170,52170,51790,51910,52020,-340,-230,110,"2,861.39",7304
,20170803,51910,52020,51990,52300,51750,51750,52050,-270,30,464,"12,076.63",7352
,20170804,51750,52050,51980,52330,51980,52170,52160,120,110,906,"23,630.27",7682
,20170807,52170,52160,52170,52750,51920,52130,52150,-30,-10,292,"7,615.03",7734
,20170808,52130,52150,52300,52790,52090,52180,52420,30,270,382,"10,013.78",7898
,20170809,52180,52420,52270,53090,52190,52950,52850,530,430,278,"7,347.45",7940
,20170810,52950,52850,52850,52980,52320,52450,52530,-400,-320,528,"13,870.02",8072
,20170811,52450,52530,52280,52280,51560,51650,51840,-880,-690,272,"7,050.41",8030
,20170814,51650,51840,51980,52240,51740,51760,52030,-80,190,170,"4,422.85",8032
,20170815,51760,52030,51900,52050,51780,51990,51970,-40,-60,422,"10,966.35",8328
,20170816,51990,51970,51980,51990,51580,51860,51780,-110,-190,212,"5,488.96",8330
,20170817,51860,51780,52320,53270,52320,52970,52950,1190,1170,472,"12,496.21",8522
,20170818,52970,52950,52780,52870,52360,52730,52550,-220,-400,358,"9,406.55",8330
,20170821,52730,52550,52910,53500,52400,53160,52940,610,390,232,"6,141.31",8282
,20170822,53160,52940,53330,53790,53030,53720,53380,780,440,442,"11,797.98",8158
,20170823,53720,53380,53800,53800,52960,53100,53120,-280,-260,160,"4,250.20",8180
,20170824,53100,53120,53080,53610,52950,53370,53320,250,200,112,"2,986.08",8206
,20170825,53370,53320,53520,54350,53520,54300,54040,980,720,304,"8,214.64",8288
,20170828,54300,54040,54220,54410,53620,54410,54110,370,70,220,"5,952.96",8278
,20170829,54410,54110,54330,54520,54100,54240,54340,130,230,1890,"51,351.68",7392
,20170830,54240,54340,54580,54580,54130,54270,54330,-70,-10,364,"9,888.59",7380
,20170831,54270,54330,53990,54300,53990,54290,54220,-40,-110,272,"7,374.61",7450
,20170901,54290,54220,54280,54370,54060,54320,54230,100,10,76,"2,060.90",7452
,20170904,54320,54230,54100,54940,54100,54620,54450,390,220,156,"4,247.68",7466
,20170905,54620,54450,54590,55100,54590,55100,54810,650,360,100,"2,740.91",7478
,20170906,55100,54810,54790,54800,54200,54640,54450,-170,-360,164,"4,464.91",7440
,20170907,54640,54450,54530,54670,54100,54160,54250,-290,-200,182,"4,936.92",7404
,20170908,54160,54250,54040,54180,53120,53140,53780,-1110,-470,192,"5,163.20",7394
,20170911,53140,53780,53160,53160,52400,52880,52710,-900,-1070,144,"3,795.51",7358
,20170912,52880,52710,53180,53230,52830,53170,53050,460,340,488,"12,945.31",7700
,20170913,53170,53050,52480,52830,52350,52450,52530,-600,-520,122,"3,204.93",7692
,20170914,52450,52530,52020,52220,51790,51800,52060,-730,-470,408,"10,621.67",7676
,20170915,51800,52060,51820,51890,51510,51560,51710,-500,-350,310,"8,015.45",7724
,20170918,51560,51710,51480,52030,51200,52000,51600,290,-110,318,"8,204.97",7660
,20170919,52000,51600,51920,52190,51850,52140,52100,540,500,378,"9,847.49",7520
,20170920,52140,52100,52040,52200,51990,52170,52090,70,-10,46,"1,198.14",7498
,20170921,52170,52090,52110,52150,51400,51530,51840,-560,-250,520,"13,478.71",7416
,20170922,51530,51840,51520,51700,50780,50810,51090,-1030,-750,330,"8,430.29",7400
,20170925,50810,51090,51300,51760,51200,51600,51530,510,440,468,"12,059.68",7338
,20170926,51600,51530,51590,52020,51530,51960,51750,430,220,112,"2,898.27",7346
,20170927,51960,51750,51630,51780,51450,51690,51650,-60,-100,208,"5,372.14",7326
,20170928,51690,51650,51760,51760,51320,51740,51540,90,-110,864,"22,268.06",7192
,20170929,51740,51540,51910,52810,51770,52790,52370,1250,830,862,"22,571.79",7362
,20171009,52790,52370,52790,53350,52790,53080,53070,710,700,474,"12,578.58",7332
,20171010,53080,53070,53000,53240,52680,52730,52860,-340,-210,1724,"45,571.88",7064
,20171011,52730,52860,52640,53240,52580,53240,53040,380,180,1144,"30,340.47",6836
,20171012,53240,53040,53010,54340,53000,54010,53730,970,690,1664,"44,703.64",7358
,20171013,54010,53730,54010,54440,53940,54200,54350,470,620,1780,"48,371.84",8726
,20171016,54200,54350,54220,56710,53900,56500,56080,2150,1730,18508,"519,055.64",22094
,20171017,56500,56080,56610,57330,56240,56450,56780,370,700,2436,"69,162.07",22214
,20171018,56450,56780,56450,56450,55700,56000,56180,-780,-600,468,"13,146.56",22168
,20171019,56000,56180,55950,56300,55670,55800,55900,-380,-280,350,"9,783.08",22250
,20171020,55800,55900,55490,56570,55340,56290,56330,390,430,6740,"189,836.66",26682
,20171023,56290,56330,56320,56320,55240,55550,55770,-780,-560,1070,"29,841.84",26698
,20171024,55550,55770,55770,56850,55740,56480,56410,710,640,1594,"44,965.47",26806
,20171025,56480,56410,56600,56600,55060,55450,55830,-960,-580,3006,"83,921.04",26956
,20171026,55450,55830,55690,55900,55560,55650,55720,-180,-110,1548,"43,134.63",27058
,20171027,55650,55720,55660,55680,54800,54900,55090,-820,-630,858,"23,634.14",27164
,20171030,54900,55090,54550,54610,54240,54490,54420,-600,-670,762,"20,734.26",27214
,20171031,54490,54420,54350,54940,54280,54690,54540,270,120,458,"12,490.77",27218
,20171101,54690,54540,54400,57000,54350,55280,55260,740,720,356,"9,836.42",27228
,20171102,55280,55260,55110,55210,54690,54790,54930,-470,-330,958,"26,315.97",27330
,20171103,54790,54930,54910,55600,54850,55270,55290,340,360,258,"7,133.00",27404
,20171106,55270,55290,55080,55610,54700,55570,55140,280,-150,228,"6,286.88",27458
,20171107,55570,55140,55700,55730,55320,55500,55560,360,420,110,"3,056.02",27452
,20171108,55500,55560,55200,55200,54300,54360,54530,-1200,-1030,372,"10,144.04",27444
,20171109,54360,54530,54580,54770,54030,54130,54360,-400,-170,364,"9,894.08",27390
,20171110,54130,54360,54230,54660,54200,54460,54530,100,170,230,"6,271.85",27466
,20171113,54460,54530,54460,54650,54300,54590,54540,60,10,532,"14,509.19",27482
,20171114,54590,54540,54380,56020,54210,55050,55630,510,1090,19696,"547,913.99",28606
,20171115,55050,55630,55070,55070,53640,53780,54140,-1850,-1490,632,"17,111.02",28566
,20171116,53780,54140,53900,54210,53580,53780,53930,-360,-210,2036,"54,906.02",27684
,20171117,53780,53930,54000,54110,53730,53970,53920,40,-10,266,"7,171.89",27588
,20171120,53970,53920,53760,54330,53710,53990,53970,70,50,422,"11,388.97",27614
,20171121,53990,53970,54100,54630,53980,54420,54290,450,320,112,"3,040.38",27584
,20171122,54420,54290,54880,55270,54780,55100,55050,810,760,406,"11,176.22",27502
,20171123,55100,55050,54950,55220,54820,54820,55080,-230,30,102,"2,809.35",27502
,20171124,54820,55080,54830,55420,54830,55380,55180,300,100,262,"7,229.35",27452
,20171127,55380,55180,55380,55680,54760,54850,55140,-330,-40,460,"12,683.35",27442
,20171128,54850,55140,54840,54950,54180,54410,54490,-730,-650,1084,"29,537.38",27442
,20171129,54410,54490,54200,54340,53950,54130,54140,-360,-350,526,"14,239.38",27474
,20171130,54130,54140,53930,53970,53320,53650,53710,-490,-430,1540,"41,363.67",27518
,20171201,53650,53710,53920,53930,53590,53800,53740,90,30,252,"6,771.33",27488
,20171204,53800,53740,53670,54450,53630,54410,54130,670,390,672,"18,190.91",27566
,20171205,54410,54130,54280,54350,53250,53380,53860,-750,-270,646,"17,398.01",27534
,20171206,53380,53860,53000,53050,51820,52110,52340,-1750,-1520,3218,"84,217.71",27794
,20171207,52110,52340,52260,52430,51960,52050,52180,-290,-160,344,"8,974.98",27776
,20171208,52050,52180,52200,52550,52070,52520,52350,340,170,510,"13,351.31",27738
,20171211,52520,52350,52400,52620,52040,52120,52410,-230,60,870,"22,802.14",27770
,20171212,52120,52410,52330,52950,52210,52810,52720,400,310,488,"12,863.98",27784
,20171213,52810,52720,52850,53130,52650,53090,52940,370,220,534,"14,137.44",27876
,20171214,53090,52940,53090,53440,52930,53070,53170,130,230,412,"10,954.22",27852
,20171215,53070,53170,53420,53740,53320,53640,53500,470,330,694,"18,565.69",27862
,20171218,53640,53500,53580,54500,53580,54370,54260,870,760,532,"14,433.35",27848
,20171219,54370,54260,54280,54490,54090,54110,54250,-150,-10,346,"9,385.25",27858
,20171220,54110,54250,54200,54680,54200,54390,54430,140,180,442,"12,030.92",27890
,20171221,54390,54430,54730,55300,54730,55030,55020,600,590,472,"12,985.79",27860
,20171222,55030,55020,55090,55270,54850,55240,55050,220,30,654,"18,004.48",27836
,20171225,55240,55050,55240,56000,55240,55570,55610,520,560,612,"17,019.37",27826
,20171226,55570,55610,55430,56000,55260,56000,55740,390,130,786,"21,906.90",27692
,20171227,56000,55740,56190,56190,55650,55800,55890,60,150,490,"13,695.08",27644
,20171228,55800,55890,55890,56600,55840,56600,56190,710,300,1266,"35,569.04",27604
,20171229,56600,56190,56270,56550,56050,56260,56400,70,210,526,"14,834.76",27564
cu1808,20170816,51970,51970,52010,52110,51800,52110,51890,140,-80,52,"1,349.37",34
,20170817,52110,51890,52550,53380,52550,53140,53090,1250,1200,88,"2,336.16",72
,20170818,53140,53090,52910,53000,52480,52770,52730,-320,-360,62,"1,634.90",88
,20170821,52770,52730,52610,53580,52610,53240,53000,510,270,224,"5,937.11",176
,20170822,53240,53000,53480,53880,53150,53880,53540,880,540,124,"3,319.64",242
,20170823,53880,53540,53880,53940,53070,53290,53310,-250,-230,60,"1,599.44",238
,20170824,53290,53310,53260,53800,53260,53480,53560,170,250,44,"1,178.47",268
,20170825,53480,53560,53590,54440,53590,54420,54130,860,570,228,"6,170.88",392
,20170828,54420,54130,54350,54510,53820,54510,54310,380,180,146,"3,965.03",430
,20170829,54510,54310,54460,54680,54180,54330,54410,20,100,330,"8,978.35",558
,20170830,54330,54410,54590,54660,54270,54400,54420,-10,10,90,"2,448.96",552
,20170831,54400,54420,54150,54440,54140,54440,54310,20,-110,80,"2,172.41",582
,20170901,54440,54310,54290,54500,54250,54450,54400,140,90,74,"2,012.93",612
,20170904,54450,54400,54290,55040,54250,54850,54670,450,270,110,"3,006.93",642
,20170905,54850,54670,54680,55190,54610,55150,54870,480,200,102,"2,798.65",710
,20170906,55150,54870,54950,55050,54340,54770,54750,-100,-120,78,"2,135.36",714
,20170907,54770,54750,54510,54850,54300,54300,54560,-450,-190,52,"1,418.78",706
,20170908,54300,54560,54410,54410,53280,53320,53640,-1240,-920,400,"10,729.78",670
,20170911,53320,53640,53160,53210,52600,53150,52870,-490,-770,440,"11,632.64",696
,20170912,53150,52870,53300,53400,53000,53280,53250,410,380,178,"4,739.95",686
,20170913,53280,53250,52800,52970,52450,52600,52710,-650,-540,184,"4,850.03",768
,20170914,52600,52710,52190,52330,51920,52000,52110,-710,-600,208,"5,419.76",824
,20170915,52000,52110,51880,52030,51710,51740,51880,-370,-230,150,"3,891.55",868
,20170918,51740,51880,51680,52210,51360,52160,51840,280,-40,210,"5,443.56",872
,20170919,52160,51840,52050,52310,51980,52250,52200,410,360,250,"6,525.29",1012
,20170920,52250,52200,52070,52380,52070,52330,52270,130,70,170,"4,443.75",938
,20170921,52330,52270,52300,52320,51630,51630,51940,-640,-330,250,"6,492.53",898
,20170922,51630,51940,51660,51810,50880,51050,51230,-890,-710,122,"3,125.33",926
,20170925,51050,51230,51380,51870,51360,51740,51690,510,460,164,"4,238.87",972
,20170926,51740,51690,51750,52180,51750,52180,52020,490,330,34,884.37,966
,20170927,52180,52020,51860,51920,51600,51760,51770,-260,-250,174,"4,504.26",976
,20170928,51760,51770,51870,51900,51490,51880,51710,110,-60,176,"4,550.66",996
,20170929,51880,51710,52030,52880,52010,52750,52580,1040,870,158,"4,154.32",1028
,20171009,52750,52580,53250,53470,53110,53110,53220,530,640,24,638.67,1038
,20171010,53110,53220,53000,53330,52900,52900,53080,-320,-140,130,"3,450.25",1084
,20171011,52900,53080,52890,53360,52710,53360,53190,280,110,292,"7,766.66",1030
,20171012,53360,53190,53090,54360,53090,54250,53920,1060,730,520,"14,020.37",1084
,20171013,54250,53920,54350,54540,54150,54440,54380,520,460,112,"3,045.71",1088
,20171016,54440,54380,54360,56800,54050,56550,55990,2170,1610,888,"24,860.78",1458
,20171017,56550,55990,56790,57330,56430,56540,56850,550,860,516,"14,667.92",1460
,20171018,56540,56850,56580,59980,53690,56130,56540,-720,-310,478,"13,514.00",1592
,20171019,56130,56540,55990,56380,55780,56110,56080,-430,-460,168,"4,711.42",1640
,20171020,56110,56080,55580,56670,55570,56590,55930,510,-150,272,"7,606.67",1644
,20171023,56590,55930,56300,56350,55590,55900,55970,-30,40,122,"3,414.32",1688
,20171024,55900,55970,56030,56930,56030,56720,56660,750,690,182,"5,156.78",1680
,20171025,56720,56660,56460,56490,55280,55580,56000,-1080,-660,356,"9,969.48",1732
,20171026,55580,56000,55770,55960,55720,55740,55810,-260,-190,456,"12,726.75",1916
,20171027,55740,55810,55670,55750,54910,54980,55110,-830,-700,384,"10,582.03",2052
,20171030,54980,55110,54310,54700,54310,54570,54530,-540,-580,120,"3,272.33",2056
,20171031,54570,54530,54620,55050,54400,55050,54600,520,70,264,"7,207.77",2066
,20171101,55050,54600,54630,55680,54630,55600,55360,1000,760,46,"1,273.38",2060
,20171102,55600,55360,55030,55250,54850,54890,54990,-470,-370,404,"11,109.93",2084
,20171103,54890,54990,54910,55420,54910,55420,55210,430,220,56,"1,545.88",2116
,20171106,55420,55210,55350,55710,54750,55680,55280,470,70,72,"1,990.35",2154
,20171107,55680,55280,55820,55820,55340,55550,55570,270,290,30,833.60,2152
,20171108,55550,55570,55300,55300,54450,54500,54670,-1070,-900,72,"1,968.38",2180
,20171109,54500,54670,54710,54930,54270,54280,54660,-390,-10,138,"3,771.90",2150
,20171110,54280,54660,54400,54760,54400,54760,54680,100,20,92,"2,515.29",2160
,20171113,54760,54680,54530,54820,54450,54780,54740,100,60,756,"20,693.14",2572
,20171114,54780,54740,54580,56400,54580,55230,55950,490,1210,40794,"1,141,273.32",23386
,20171115,55230,55950,54760,55320,53870,53950,54330,-2000,-1620,956,"25,971.41",23412
,20171116,53950,54330,54100,54350,53790,53970,54120,-360,-210,3186,"86,225.44",23536
,20171117,53970,54120,54160,54250,53880,54120,54100,0,-20,458,"12,389.12",23516
,20171120,54120,54100,53940,54640,53880,54150,54260,50,160,404,"10,960.52",23464
,20171121,54150,54260,54320,54820,54180,54590,54480,330,220,180,"4,903.35",23442
,20171122,54590,54480,54960,55420,54960,55260,55260,780,780,752,"20,778.22",23498
,20171123,55260,55260,55190,55450,54970,54990,55220,-270,-40,656,"18,113.48",23552
,20171124,54990,55220,55000,55570,55000,55520,55360,300,140,422,"11,681.22",23646
,20171127,55520,55360,55450,55850,54950,55110,55460,-250,100,948,"26,291.58",23648
,20171128,55110,55460,55100,55160,54350,54610,54750,-850,-710,608,"16,646.10",23702
,20171129,54610,54750,54460,54510,54150,54330,54310,-420,-440,620,"16,838.38",23816
,20171130,54330,54310,54060,54140,53530,53900,53770,-410,-540,588,"15,808.98",24034
,20171201,53900,53770,54150,54150,53730,53950,53900,180,130,128,"3,450.02",24044
,20171204,53950,53900,53790,54670,53790,54520,54440,620,540,638,"17,368.80",24038
,20171205,54520,54440,54490,54510,53400,53500,54160,-940,-280,910,"24,645.38",24048
,20171206,53500,54160,53140,53140,52000,52300,52440,-1860,-1720,7678,"201,342.19",24270
,20171207,52300,52440,52340,52550,52110,52270,52320,-170,-120,386,"10,098.19",24270
,20171208,52270,52320,52320,52790,52230,52680,52550,360,230,356,"9,355.17",24246
,20171211,52680,52550,52500,52820,52220,52220,52560,-330,10,190,"4,993.98",24314
,20171212,52220,52560,52350,53140,52350,52980,52880,420,320,236,"6,240.07",24320
,20171213,52980,52880,53280,53290,52870,53260,53120,380,240,290,"7,702.92",24328
,20171214,53260,53120,53260,53620,53140,53200,53420,80,300,352,"9,402.43",24366
,20171215,53200,53420,53450,53920,53450,53820,53740,400,320,216,"5,804.80",24362
,20171218,53820,53740,53710,54680,53710,54530,54450,790,710,188,"5,118.66",24336
,20171219,54530,54450,54470,54650,54230,54340,54370,-110,-80,94,"2,555.55",24356
,20171220,54340,54370,54420,54800,54420,54590,54580,220,210,128,"3,493.44",24406
,20171221,54590,54580,54920,55450,54880,55180,55120,600,540,292,"8,048.94",24434
,20171222,55180,55120,55270,55500,55030,55500,55270,380,150,180,"4,975.07",24382
,20171225,55500,55270,55620,56180,55500,55610,55740,340,470,280,"7,804.86",24434
,20171226,55610,55740,55580,56200,55460,56200,55750,460,10,150,"4,181.48",24412
,20171227,56200,55750,56200,56230,55850,55940,56040,190,290,404,"11,320.77",24502
,20171228,55940,56040,56100,56760,56100,56760,56500,720,460,260,"7,345.01",24562
,20171229,56760,56500,56500,56720,56230,56410,56560,-90,60,334,"9,445.89",24584
cu1809,20170918,51880,51880,52030,52280,52030,52210,52190,330,310,30,782.89,20
,20170919,52210,52190,52320,52430,52270,52430,52360,240,170,80,"2,094.63",86
,20170920,52430,52360,52320,52550,52320,52490,52420,130,60,52,"1,363.14",108
,20170921,52490,52420,52420,52450,51730,51800,52050,-620,-370,126,"3,279.24",162
,20170922,51800,52050,51970,51980,51010,51200,51360,-850,-690,44,"1,129.95",176
,20170925,51200,51360,51480,52020,51370,51800,51790,440,430,118,"3,055.75",200
,20170926,51800,51790,51900,52320,51840,52290,52170,500,380,102,"2,660.96",228
,20170927,52290,52170,51980,52060,51730,51980,51940,-190,-230,182,"4,727.38",238
,20170928,51980,51940,52070,52070,51510,51940,51820,0,-120,174,"4,509.07",312
,20170929,51940,51820,52090,53000,52090,52900,52640,1080,820,178,"4,685.12",356
,20171009,52900,52640,53310,53530,53140,53360,53360,720,720,124,"3,308.58",422
,20171010,53360,53360,53200,53440,52950,53000,53160,-360,-200,250,"6,646.23",524
,20171011,53000,53160,52980,53460,52820,53460,53250,300,90,376,"10,011.92",650
,20171012,53460,53250,53320,54490,53310,54340,53980,1090,730,816,"22,026.41",1020
,20171013,54340,53980,54420,54640,54230,54450,54470,470,490,592,"16,123.91",1364
,20171016,54450,54470,54330,56980,54190,56590,55660,2120,1190,1206,"33,565.75",1990
,20171017,56590,55660,56880,57570,56550,56660,57050,1000,1390,400,"11,411.47",2000
,20171018,56660,57050,56710,56780,56000,56270,56390,-780,-660,258,"7,274.55",1970
,20171019,56270,56390,56180,56390,55970,56170,56200,-220,-190,200,"5,620.43",1958
,20171020,56170,56200,55870,56870,55700,56730,56380,530,180,180,"5,074.84",1934
,20171023,56730,56380,56550,56620,55630,56000,56170,-380,-210,216,"6,067.43",1918
,20171024,56000,56170,56170,57120,56110,56810,56710,640,540,228,"6,465.49",1976
,20171025,56810,56710,56840,56840,55420,55690,55940,-1020,-770,824,"23,050.44",2084
,20171026,55690,55940,55910,56150,55840,55880,56010,-60,70,236,"6,609.44",2086
,20171027,55880,56010,55930,55950,55100,55120,55430,-890,-580,298,"8,259.08",2054
,20171030,55120,55430,55020,55020,54520,54790,54740,-640,-690,182,"4,982.09",2042
,20171031,54790,54740,54760,55200,54560,55200,54790,460,50,198,"5,424.94",2056
,20171101,55200,54790,54720,55810,54580,55650,55470,860,680,290,"8,043.71",2042
,20171102,55650,55470,55450,55530,54960,55090,55190,-380,-280,288,"7,947.51",1932
,20171103,55090,55190,55010,55830,55010,55500,55510,310,320,126,"3,497.72",1936
,20171106,55500,55510,55360,55860,55010,55860,55480,350,-30,106,"2,940.52",1934
,20171107,55860,55480,55860,55990,55630,55750,55770,270,290,72,"2,007.92",1952
,20171108,55750,55770,55480,55480,54620,54640,54920,-1130,-850,310,"8,514.12",1940
,20171109,54640,54920,54820,55110,54400,54480,54760,-440,-160,206,"5,640.44",1948
,20171110,54480,54760,54510,55000,54500,54950,54730,190,-30,178,"4,871.35",1998
,20171113,54950,54730,54750,55170,54660,55020,55050,290,320,710,"19,543.27",2548
,20171114,55020,55050,54780,56860,54650,55470,56240,420,1190,33298,"936,429.29",19250
,20171115,55470,56240,55540,55540,54000,54180,54590,-2060,-1650,1128,"30,789.19",19236
,20171116,54180,54590,54270,54510,53970,54210,54340,-380,-250,1448,"39,345.94",19276
,20171117,54210,54340,54340,54520,54080,54300,54290,-40,-50,610,"16,560.49",19302
,20171120,54300,54290,54120,54830,54060,54350,54440,60,150,606,"16,495.38",19300
,20171121,54350,54440,54470,54990,54350,54780,54660,340,220,500,"13,666.42",19306
,20171122,54780,54660,54980,55590,54980,55470,55350,810,690,696,"19,262.37",19304
,20171123,55470,55350,55310,55620,55230,55230,55450,-120,100,290,"8,040.44",19294
,20171124,55230,55450,55340,55740,55340,55720,55590,270,140,312,"8,672.25",19272
,20171127,55720,55590,55740,56000,55160,55160,55660,-430,70,784,"21,819.97",19380
,20171128,55160,55660,55190,55320,54540,54730,54850,-930,-810,468,"12,836.74",19376
,20171129,54730,54850,54530,54680,54330,54550,54510,-300,-340,510,"13,900.82",19402
,20171130,54550,54510,54260,54350,53670,54080,54010,-430,-500,1028,"27,763.50",19596
,20171201,54080,54010,54200,54270,53900,54160,54090,150,80,150,"4,057.47",19578
,20171204,54160,54090,54160,54880,54040,54750,54630,660,540,180,"4,917.35",19564
,20171205,54750,54630,54660,54670,53700,53700,54080,-930,-550,422,"11,412.12",19624
,20171206,53700,54080,53300,53330,52220,52460,52520,-1620,-1560,954,"25,053.22",19512
,20171207,52460,52520,52500,52800,52330,52420,52510,-100,-10,258,"6,774.30",19498
,20171208,52420,52510,52480,52920,52350,52840,52690,330,180,178,"4,689.49",19504
,20171211,52840,52690,52720,52950,52410,52420,52720,-270,30,218,"5,747.52",19510
,20171212,52420,52720,52540,53260,52540,53200,53060,480,340,74,"1,963.52",19512
,20171213,53200,53060,53250,53530,53030,53440,53320,380,260,478,"12,745.34",19572
,20171214,53440,53320,53440,53770,53300,53370,53570,50,250,408,"10,928.77",19574
,20171215,53370,53570,53800,54050,53690,54010,53870,440,300,88,"2,370.30",19580
,20171218,54010,53870,54200,54880,54180,54700,54580,830,710,92,"2,510.93",19598
,20171219,54700,54580,54680,54760,54430,54450,54580,-130,0,74,"2,019.53",19594
,20171220,54450,54580,54590,54990,54590,54740,54800,160,220,32,876.81,19584
,20171221,54740,54800,54960,55640,54960,55330,55350,530,550,206,"5,701.69",19594
,20171222,55330,55350,55450,55660,55220,55520,55400,170,50,124,"3,435.07",19562
,20171225,55520,55400,55750,56260,55710,55820,55940,420,540,366,"10,238.55",19600
,20171226,55820,55940,55730,56360,55610,56360,56030,420,90,332,"9,301.01",19684
,20171227,56360,56030,56520,56520,56010,56050,56330,20,300,270,"7,605.15",19648
,20171228,56050,56330,56150,56950,56150,56840,56630,510,300,436,"12,346.31",19682
,20171229,56840,56630,56730,56900,56400,56500,56790,-130,160,226,"6,418.11",19700
cu1810,20171017,55660,55660,56910,57710,56610,56670,57240,1010,1580,550,"15,741.37",222
,20171018,56670,57240,56850,57000,56130,56370,56510,-870,-730,304,"8,589.91",218
,20171019,56370,56510,56400,56690,56010,56340,56380,-170,-130,194,"5,469.29",262
,20171020,56340,56380,56020,56930,55830,56820,56350,440,-30,310,"8,734.92",338
,20171023,56820,56350,57270,57270,55770,56150,56310,-200,-40,218,"6,138.79",370
,20171024,56150,56310,56480,57240,56380,56900,56990,590,680,294,"8,378.94",502
,20171025,56900,56990,56830,56910,55510,55870,56180,-1120,-810,458,"12,865.34",516
,20171026,55870,56180,56060,56280,55930,55950,56030,-230,-150,284,"7,957.56",628
,20171027,55950,56030,55790,56030,55130,55240,55590,-790,-440,388,"10,785.32",812
,20171030,55240,55590,54900,55000,54630,54830,54790,-760,-800,272,"7,452.18",854
,20171031,54830,54790,54870,55300,54770,55080,54920,290,130,304,"8,347.92",938
,20171101,55080,54920,54900,56090,54680,55750,55530,830,610,238,"6,608.84",1032
,20171102,55750,55530,55610,55610,55090,55120,55330,-410,-200,266,"7,359.57",950
,20171103,55120,55330,55270,55960,55270,55650,55630,320,300,262,"7,288.73",982
,20171106,55650,55630,55460,55970,55220,55920,55550,290,-80,110,"3,055.64",1000
,20171107,55920,55550,55890,56270,55700,55820,55880,270,330,138,"3,855.89",1060
,20171108,55820,55880,55400,55480,54800,54810,55080,-1070,-800,264,"7,270.69",1046
,20171109,54810,55080,54900,55250,54500,54580,54780,-500,-300,160,"4,382.72",1056
,20171110,54580,54780,54640,55130,54560,54910,54820,130,40,190,"5,208.54",1112
,20171113,54910,54820,54850,55320,54680,55190,55180,370,360,670,"18,485.74",1448
,20171114,55190,55180,55000,57330,54850,55680,56460,500,1280,28752,"811,756.24",17156
,20171115,55680,56460,55690,55780,54200,54440,54860,-2020,-1600,1774,"48,663.05",17282
,20171116,54440,54860,54510,54650,54180,54390,54520,-470,-340,830,"22,626.45",17260
,20171117,54390,54520,54640,54770,54280,54500,54510,-20,-10,1226,"33,417.83",17566
,20171120,54500,54510,54350,54900,54240,54530,54590,20,80,960,"26,204.69",17462
,20171121,54530,54590,54630,55140,54520,54940,54790,350,200,1162,"31,837.64",17518
,20171122,54940,54790,55170,55850,55170,55700,55610,910,820,910,"25,305.29",17478
,20171123,55700,55610,55670,55820,55410,55410,55680,-200,70,978,"27,232.12",17578
,20171124,55410,55680,55580,55940,55580,55870,55760,190,80,356,"9,927.04",17562
,20171127,55870,55760,56060,56210,55360,55390,55840,-370,80,750,"20,941.56",17588
,20171128,55390,55840,55380,55510,54760,54980,55120,-860,-720,864,"23,813.46",17546
,20171129,54980,55120,54830,54850,54510,54710,54710,-410,-410,720,"19,697.39",17594
,20171130,54710,54710,54470,54520,53870,54280,54220,-430,-490,948,"25,704.47",17630
,20171201,54280,54220,54450,54460,54090,54340,54300,120,80,250,"6,787.68",17648
,20171204,54340,54300,54090,55200,54090,54920,54830,620,530,334,"9,156.71",17636
,20171205,54920,54830,54810,54830,53780,53840,54430,-990,-400,772,"21,010.28",17642
,20171206,53840,54430,53460,53490,52420,52700,52830,-1730,-1600,722,"19,073.20",17516
,20171207,52700,52830,52650,52950,52500,52690,52670,-140,-160,252,"6,637.52",17536
,20171208,52690,52670,52740,53100,52540,53010,52840,340,170,208,"5,495.58",17546
,20171211,53010,52840,52940,53150,52610,52610,53050,-230,210,712,"18,887.38",17570
,20171212,52610,53050,52840,53480,52730,53400,53280,350,230,532,"14,174.05",17480
,20171213,53400,53280,53610,53670,53200,53670,53500,390,220,616,"16,479.75",17594
,20171214,53670,53500,53770,54000,53480,53560,53790,60,290,362,"9,736.19",17702
,20171215,53560,53790,53980,54250,53920,54190,54100,400,310,278,"7,520.07",17720
,20171218,54190,54100,54110,55030,54110,54840,54740,740,640,196,"5,365.08",17746
,20171219,54840,54740,54890,55010,54530,54530,54780,-210,40,164,"4,492.32",17746
,20171220,54530,54780,54780,55060,54740,55000,54910,220,130,56,"1,537.55",17734
,20171221,55000,54910,55000,55790,55000,55550,55520,640,610,252,"6,996.04",17708
,20171222,55550,55520,55620,55850,55390,55760,55620,240,100,114,"3,170.68",17694
,20171225,55760,55620,55940,56410,55870,55980,56160,360,540,382,"10,728.39",17700
,20171226,55980,56160,55930,56590,55810,56520,56030,360,-130,634,"17,761.61",17654
,20171227,56520,56030,56500,56650,56230,56300,56440,270,410,768,"21,675.76",17558
,20171228,56300,56440,56420,57100,56340,57080,56720,640,280,520,"14,747.31",17556
,20171229,57080,56720,56890,57120,56600,56780,56920,60,200,632,"17,987.71",17494
cu1811,20171116,54860,54860,54460,54750,54460,54680,54630,-180,-230,6,163.89,6
,20171117,54680,54630,54830,54830,54620,54800,54760,170,130,14,383.32,10
,20171120,54800,54760,54720,54720,54700,54700,54710,-60,-50,4,109.42,12
,20171121,54700,54710,54810,55200,54810,55130,55040,420,330,56,"1,541.23",56
,20171122,55130,55040,55450,55970,55450,55950,55670,910,630,22,612.39,72
,20171123,55950,55670,56170,56170,55650,55650,55850,-20,180,44,"1,228.78",102
,20171124,55650,55850,55580,56110,55580,56030,55850,180,0,122,"3,406.95",176
,20171127,56030,55850,56230,56310,55480,55480,55840,-370,-10,192,"5,360.94",166
,20171128,55480,55840,55630,55640,55000,55050,55340,-790,-500,88,"2,435.36",178
,20171129,55050,55340,54680,55000,54600,54830,54920,-510,-420,62,"1,702.71",228
,20171130,54830,54920,54610,54650,54090,54340,54380,-580,-540,206,"5,601.15",346
,20171201,54340,54380,54490,54490,54300,54460,54350,80,-30,74,"2,011.30",370
,20171204,54460,54350,54460,55180,54380,55060,54930,710,580,142,"3,900.26",456
,20171205,55060,54930,54970,55010,53900,53910,54690,-1020,-240,218,"5,962.09",586
,20171206,53910,54690,53680,53680,52680,52800,52930,-1890,-1760,214,"5,664.02",668
,20171207,52800,52930,52900,53050,52630,52630,52800,-300,-130,98,"2,587.36",714
,20171208,52630,52800,52880,53240,52680,53240,53070,440,270,106,"2,812.85",704
,20171211,53240,53070,52800,53230,52680,52680,53000,-390,-70,142,"3,763.42",794
,20171212,52680,53000,52970,53560,52800,53460,53380,460,380,90,"2,402.22",848
,20171213,53460,53380,53580,53680,53530,53630,53610,250,230,308,"8,256.05",986
,20171214,53630,53610,53880,54130,53700,53700,53910,90,300,136,"3,666.01",1026
,20171215,53700,53910,54020,54400,54020,54320,54220,410,310,74,"2,006.23",1062
,20171218,54320,54220,54390,55200,54390,54910,54950,690,730,150,"4,121.41",1112
,20171219,54910,54950,54990,55040,54730,54800,54920,-150,-30,98,"2,691.27",1100
,20171220,54800,54920,54980,55190,54930,55150,55050,230,130,86,"2,367.32",1124
,20171221,55150,55050,55400,55950,55390,55700,55650,650,600,78,"2,170.40",1122
,20171222,55700,55650,55600,55940,55520,55940,55670,290,20,50,"1,391.96",1120
,20171225,55940,55670,55920,56560,55920,56090,56270,420,600,132,"3,714.14",1154
,20171226,56090,56270,56060,56680,56050,56680,56200,410,-70,104,"2,922.65",1190
,20171227,56680,56200,56590,56650,56310,56340,56470,140,270,122,"3,444.90",1230
,20171228,56340,56470,56620,57230,56620,57230,57000,760,530,196,"5,586.20",1272
,20171229,57230,57000,57200,57230,56720,56820,57000,-180,0,176,"5,016.57",1342
cu1812,20171218,54220,54220,54580,55310,54580,55120,55000,900,780,68,"1,870.05",60
,20171219,55120,55000,55090,55200,54830,54900,54990,-100,-10,116,"3,189.75",158
,20171220,54900,54990,55080,55290,55080,55290,55170,300,180,76,"2,096.67",216
,20171221,55290,55170,55630,56000,55630,55740,55780,570,610,196,"5,467.28",314
,20171222,55740,55780,55910,56040,55700,56040,55860,260,80,48,"1,340.65",330
,20171225,56040,55860,56310,56670,56150,56160,56510,300,650,148,"4,181.93",400
,20171226,56160,56510,56160,56840,56130,56840,56470,330,-40,50,"1,411.86",416
,20171227,56840,56470,56710,56780,56500,56540,56630,70,160,86,"2,435.21",432
,20171228,56540,56630,56660,57370,56660,57250,57030,620,400,306,"8,725.70",660
,20171229,57250,57030,57340,57340,56840,57050,57110,20,80,194,"5,540.55",772
fu1702,20170103,4001,4001,,,,4001,4001,0,0,0,0.00,0
,20170104,4001,4001,,,,4001,4001,0,0,0,0.00,0
,20170105,4001,4001,,,,4001,4001,0,0,0,0.00,0
,20170106,4001,4001,,,,4001,4001,0,0,0,0.00,0
,20170109,4001,4001,,,,4001,4001,0,0,0,0.00,0
,20170110,4001,4001,,,,4001,4001,0,0,0,0.00,0
,20170111,4001,4001,,,,4001,4001,0,0,0,0.00,0
,20170112,4001,4001,,,,4001,4001,0,0,0,0.00,0
,20170113,4001,4001,,,,4001,4001,0,0,0,0.00,0
,20170116,4001,4001,,,,4001,4001,0,0,0,0.00,0
,20170117,4001,4001,,,,4001,4001,0,0,0,0.00,0
,20170118,4001,4001,,,,4001,4001,0,0,0,0.00,0
,20170119,4001,4001,,,,4001,4001,0,0,0,0.00,0
,20170120,4001,4001,,,,4001,4001,0,0,0,0.00,0
,20170123,4001,4001,,,,4001,4001,0,0,0,0.00,0
,20170124,4001,4001,,,,4001,4001,0,0,0,0.00,0
,20170125,4001,4001,,,,4001,4001,0,0,0,0.00,0
,20170126,4001,4001,,,,4001,4001,0,0,0,0.00,0
fu1703,20170103,4100,4100,,,,4100,4100,0,0,0,0.00,0
,20170104,4100,4100,,,,4100,4100,0,0,0,0.00,0
,20170105,4100,4100,,,,4100,4100,0,0,0,0.00,0
,20170106,4100,4100,,,,4100,4100,0,0,0,0.00,0
,20170109,4100,4100,,,,4100,4100,0,0,0,0.00,0
,20170110,4100,4100,,,,4100,4100,0,0,0,0.00,0
,20170111,4100,4100,,,,4100,4100,0,0,0,0.00,0
,20170112,4100,4100,,,,4100,4100,0,0,0,0.00,0
,20170113,4100,4100,,,,4100,4100,0,0,0,0.00,0
,20170116,4100,4100,,,,4100,4100,0,0,0,0.00,0
,20170117,4100,4100,,,,4100,4100,0,0,0,0.00,0
,20170118,4100,4100,,,,4100,4100,0,0,0,0.00,0
,20170119,4100,4100,,,,4100,4100,0,0,0,0.00,0
,20170120,4100,4100,,,,4100,4100,0,0,0,0.00,0
,20170123,4100,4100,,,,4100,4100,0,0,0,0.00,0
,20170124,4100,4100,,,,4100,4100,0,0,0,0.00,0
,20170125,4100,4100,,,,4100,4100,0,0,0,0.00,0
,20170126,4100,4100,,,,4100,4100,0,0,0,0.00,0
,20170203,4100,4100,,,,4100,4100,0,0,0,0.00,0
,20170206,4100,4100,,,,4100,4100,0,0,0,0.00,0
,20170207,4100,4100,,,,4100,4100,0,0,0,0.00,0
,20170208,4100,4100,,,,4100,4100,0,0,0,0.00,0
,20170209,4100,4100,,,,4100,4100,0,0,0,0.00,0
,20170210,4100,4100,,,,4100,4100,0,0,0,0.00,0
,20170213,4100,4100,,,,4100,4100,0,0,0,0.00,0
,20170214,4100,4100,,,,4100,4100,0,0,0,0.00,0
,20170215,4100,4100,,,,4100,4100,0,0,0,0.00,0
,20170216,4100,4100,,,,4100,4100,0,0,0,0.00,0
,20170217,4100,4100,,,,4100,4100,0,0,0,0.00,0
,20170220,4100,4100,,,,4100,4100,0,0,0,0.00,0
,20170221,4100,4100,,,,4100,4100,0,0,0,0.00,0
,20170222,4100,4100,,,,4100,4100,0,0,0,0.00,0
,20170223,4100,4100,,,,4100,4100,0,0,0,0.00,0
,20170224,4100,4100,,,,4100,4100,0,0,0,0.00,0
,20170227,4100,4100,,,,4100,4100,0,0,0,0.00,0
,20170228,4100,4100,,,,4100,4100,0,0,0,0.00,0
fu1704,20170103,4487,4496,4461,4600,4458,4560,4549,64,53,142,"3,230.03",200
,20170104,4560,4549,4471,4471,4322,4345,4358,-204,-191,172,"3,748.23",168
,20170105,4345,4358,4345,4412,4252,4326,4324,-32,-34,120,"2,594.52",160
,20170106,4326,4324,4432,4449,4290,4396,4399,72,75,148,"3,255.93",160
,20170109,4396,4399,4390,4450,4355,4450,4406,51,7,62,"1,365.94",150
,20170110,4450,4406,4306,4322,4188,4230,4234,-176,-172,116,"2,456.14",132
,20170111,4230,4234,4084,4280,4083,4260,4196,26,-38,136,"2,853.87",134
,20170112,4260,4196,4285,4380,4200,4267,4274,71,78,88,"1,880.95",128
,20170113,4267,4274,4310,4349,4293,4345,4324,71,50,36,778.41,122
,20170116,4345,4324,4352,4400,4341,4364,4360,40,36,42,915.75,110
,20170117,4364,4360,4364,4557,4334,4399,4449,39,89,46,"1,023.44",104
,20170118,4399,4449,4455,4522,4360,4464,4473,15,24,32,715.74,106
,20170119,4464,4473,4442,4479,4440,4479,4463,6,-10,10,223.16,106
,20170120,4479,4463,4452,4500,4386,4413,4440,-50,-23,34,754.84,102
,20170123,4413,4440,4453,4478,4344,4393,4428,-47,-12,36,797.16,106
,20170124,4393,4428,4352,4439,4283,4414,4354,-14,-74,48,"1,045.15",112
,20170125,4414,4354,4401,4442,4400,4400,4421,46,67,12,265.28,106
,20170126,4400,4421,4351,4475,4351,4442,4412,21,-9,20,441.23,100
,20170203,4442,4412,4473,4473,4405,4458,4453,46,41,24,534.43,100
,20170206,4458,4453,,,,4453,4453,0,0,0,0.00,100
,20170207,4453,4453,4497,4497,4430,4477,4441,24,-12,22,488.61,90
,20170208,4477,4441,4450,4476,4448,4476,4466,35,25,20,446.67,82
,20170209,4476,4466,4468,4494,4461,4493,4482,27,16,16,358.57,82
,20170210,4493,4482,4522,4522,4502,4512,4515,30,33,18,406.42,74
,20170213,4512,4515,4527,4685,4514,4521,4606,6,91,94,"2,164.95",96
,20170214,4521,4606,4461,4519,4391,4417,4439,-189,-167,46,"1,021.08",118
,20170215,4417,4439,4428,4431,4223,4227,4294,-212,-145,86,"1,846.67",128
,20170216,4227,4294,4102,4243,4082,4084,4138,-210,-156,84,"1,738.08",134
,20170217,4084,4138,4094,4104,4002,4015,4042,-123,-96,68,"1,374.47",142
,20170220,4015,4042,3946,3946,3937,3946,3943,-96,-99,8,157.74,142
,20170221,3946,3943,3808,3877,3800,3839,3839,-104,-104,56,"1,075.02",120
,20170222,3839,3839,3861,3964,3861,3866,3919,27,80,48,940.62,118
,20170223,3866,3919,3823,3965,3822,3899,3882,-20,-37,34,660.02,110
,20170224,3899,3882,3880,3880,3875,3875,3877,-7,-5,4,77.55,110
,20170227,3875,3877,3988,3988,3857,3857,3897,-20,20,24,467.66,106
,20170228,3857,3897,3889,4050,3880,3918,3968,21,71,74,"1,468.30",82
,20170301,3918,3968,3862,3920,3862,3920,3885,-48,-83,8,155.41,82
,20170302,3920,3885,,,,3885,3885,0,0,0,0.00,82
,20170303,3885,3885,3827,3899,3702,3755,3800,-130,-85,20,380.07,80
,20170306,3755,3800,3750,3760,3702,3760,3739,-40,-61,14,261.75,78
,20170307,3760,3739,3904,3904,3736,3808,3765,69,26,72,"1,355.50",68
,20170308,3808,3765,3809,3896,3780,3825,3842,60,77,44,845.39,64
,20170309,3825,3842,3844,3869,3823,3825,3834,-17,-8,18,345.14,60
,20170310,3825,3834,3799,3873,3770,3778,3805,-56,-29,20,380.52,54
,20170313,3778,3805,3701,3964,3700,3811,3823,6,18,24,458.79,50
,20170314,3811,3823,,,,3823,3823,0,0,0,0.00,50
,20170315,3823,3823,3760,3777,3731,3731,3761,-92,-62,8,150.45,48
,20170316,3731,3761,3732,3797,3732,3742,3760,-19,-1,16,300.83,38
,20170317,3742,3760,3736,3736,3712,3712,3722,-48,-38,6,111.67,34
,20170320,3712,3722,3748,3769,3730,3769,3744,47,22,10,187.21,28
,20170321,3769,3744,3800,3886,3750,3750,3823,6,79,14,267.67,24
,20170322,3750,3823,3751,3751,3750,3750,3750,-73,-73,6,112.52,22
,20170323,3750,3750,3757,3757,3720,3720,3744,-30,-6,6,112.32,22
,20170324,3720,3744,3779,3779,3731,3731,3755,-13,11,4,75.10,18
,20170327,3731,3755,3725,3730,3725,3730,3728,-25,-27,6,111.85,12
,20170328,3730,3728,3740,3892,3740,3892,3816,164,88,4,76.32,8
,20170329,3892,3816,3700,3815,3700,3815,3757,-1,-59,4,75.15,4
,20170330,3815,3757,3915,3915,3915,3915,3915,158,158,4,78.30,0
,20170331,3915,3915,,,,3915,3915,0,0,0,0.00,0
fu1705,20170103,4050,4050,,,,4098,4098,48,48,0,0.00,4
,20170104,4098,4098,,,,3926,3926,-172,-172,0,0.00,4
,20170105,3926,3926,,,,3895,3895,-31,-31,0,0.00,4
,20170106,3895,3895,,,,3963,3963,68,68,0,0.00,4
,20170109,3963,3963,,,,3969,3969,6,6,0,0.00,4
,20170110,3969,3969,,,,3814,3814,-155,-155,0,0.00,4
,20170111,3814,3814,,,,3780,3780,-34,-34,0,0.00,4
,20170112,3780,3780,,,,3851,3851,71,71,0,0.00,4
,20170113,3851,3851,,,,3896,3896,45,45,0,0.00,4
,20170116,3896,3896,,,,3929,3929,33,33,0,0.00,4
,20170117,3929,3929,,,,4009,4009,80,80,0,0.00,4
,20170118,4009,4009,,,,4209,4209,200,200,0,0.00,4
,20170119,4209,4209,,,,4199,4199,-10,-10,0,0.00,4
,20170120,4199,4199,,,,4177,4177,-22,-22,0,0.00,4
,20170123,4177,4177,,,,4166,4166,-11,-11,0,0.00,4
,20170124,4166,4166,,,,4097,4097,-69,-69,0,0.00,4
,20170125,4097,4097,,,,4160,4160,63,63,0,0.00,4
,20170126,4160,4160,,,,4151,4151,-9,-9,0,0.00,4
,20170203,4151,4151,3861,3861,3861,3861,3861,-290,-290,2,38.61,4
,20170206,3861,3861,,,,3861,3861,0,0,0,0.00,4
,20170207,3861,3861,,,,3851,3851,-10,-10,0,0.00,4
,20170208,3851,3851,,,,3873,3873,22,22,0,0.00,4
,20170209,3873,3873,,,,3886,3886,13,13,0,0.00,4
,20170210,3886,3886,,,,3915,3915,29,29,0,0.00,4
,20170213,3915,3915,,,,3994,3994,79,79,0,0.00,4
,20170214,3994,3994,,,,3849,3849,-145,-145,0,0.00,4
,20170215,3849,3849,,,,3723,3723,-126,-126,0,0.00,4
,20170216,3723,3723,,,,3587,3587,-136,-136,0,0.00,4
,20170217,3587,3587,,,,3766,3766,179,179,0,0.00,4
,20170220,3766,3766,,,,3674,3674,-92,-92,0,0.00,4
,20170221,3674,3674,,,,3577,3577,-97,-97,0,0.00,4
,20170222,3577,3577,,,,3755,3755,178,178,0,0.00,4
,20170223,3755,3755,,,,3719,3719,-36,-36,0,0.00,4
,20170224,3719,3719,3571,3571,3571,3571,3571,-148,-148,2,35.71,4
,20170227,3571,3571,,,,3749,3749,178,178,0,0.00,4
,20170228,3749,3749,,,,3817,3817,68,68,0,0.00,4
,20170301,3817,3817,,,,3737,3737,-80,-80,0,0.00,4
,20170302,3737,3737,,,,3737,3737,0,0,0,0.00,4
,20170303,3737,3737,,,,3655,3655,-82,-82,0,0.00,4
,20170306,3655,3655,,,,3837,3837,182,182,0,0.00,4
,20170307,3837,3837,3651,3651,3651,3651,3651,-186,-186,2,36.51,4
,20170308,3651,3651,,,,3726,3726,75,75,0,0.00,4
,20170309,3726,3726,,,,3719,3719,-7,-7,0,0.00,4
,20170310,3719,3719,,,,3691,3691,-28,-28,0,0.00,4
,20170313,3691,3691,,,,3708,3708,17,17,0,0.00,4
,20170314,3708,3708,,,,3708,3708,0,0,0,0.00,4
,20170315,3708,3708,3531,3893,3531,3893,3772,185,64,6,113.17,4
,20170316,3893,3772,,,,3771,3771,-1,-1,0,0.00,4
,20170317,3771,3771,,,,3771,3771,0,0,0,0.00,4
,20170320,3771,3771,,,,3771,3771,0,0,0,0.00,4
,20170321,3771,3771,3959,3959,3907,3907,3933,136,162,4,78.66,4
,20170322,3907,3933,,,,3933,3933,0,0,0,0.00,4
,20170323,3933,3933,3889,3889,3839,3839,3864,-94,-69,4,77.28,4
,20170324,3839,3864,,,,3875,3875,11,11,0,0.00,4
,20170327,3875,3875,,,,3875,3875,0,0,0,0.00,4
,20170328,3875,3875,,,,3966,3966,91,91,0,0.00,4
,20170329,3966,3966,,,,3905,3905,-61,-61,0,0.00,4
,20170330,3905,3905,3720,3720,3720,3720,3720,-185,-185,4,74.40,0
,20170331,3720,3720,,,,3720,3720,0,0,0,0.00,0
,20170405,3720,3720,,,,3720,3720,0,0,0,0.00,0
,20170406,3720,3720,,,,3720,3720,0,0,0,0.00,0
,20170407,3720,3720,,,,3720,3720,0,0,0,0.00,0
,20170410,3720,3720,,,,3720,3720,0,0,0,0.00,0
,20170411,3720,3720,,,,3720,3720,0,0,0,0.00,0
,20170412,3720,3720,,,,3720,3720,0,0,0,0.00,0
,20170413,3720,3720,,,,3720,3720,0,0,0,0.00,0
,20170414,3720,3720,,,,3720,3720,0,0,0,0.00,0
,20170417,3720,3720,,,,3720,3720,0,0,0,0.00,0
,20170418,3720,3720,,,,3720,3720,0,0,0,0.00,0
,20170419,3720,3720,,,,3720,3720,0,0,0,0.00,0
,20170420,3720,3720,,,,3720,3720,0,0,0,0.00,0
,20170421,3720,3720,,,,3720,3720,0,0,0,0.00,0
,20170424,3720,3720,,,,3720,3720,0,0,0,0.00,0
,20170425,3720,3720,,,,3720,3720,0,0,0,0.00,0
,20170426,3720,3720,,,,3720,3720,0,0,0,0.00,0
,20170427,3720,3720,,,,3720,3720,0,0,0,0.00,0
,20170428,3720,3720,,,,3720,3720,0,0,0,0.00,0
fu1706,20170103,3997,3997,,,,4044,4044,47,47,0,0.00,0
,20170104,4044,4044,,,,3874,3874,-170,-170,0,0.00,0
,20170105,3874,3874,,,,3843,3843,-31,-31,0,0.00,0
,20170106,3843,3843,,,,3910,3910,67,67,0,0.00,0
,20170109,3910,3910,,,,3916,3916,6,6,0,0.00,0
,20170110,3916,3916,,,,3763,3763,-153,-153,0,0.00,0
,20170111,3763,3763,,,,3729,3729,-34,-34,0,0.00,0
,20170112,3729,3729,,,,3799,3799,70,70,0,0.00,0
,20170113,3799,3799,,,,3843,3843,44,44,0,0.00,0
,20170116,3843,3843,,,,3875,3875,32,32,0,0.00,0
,20170117,3875,3875,,,,3954,3954,79,79,0,0.00,0
,20170118,3954,3954,,,,3975,3975,21,21,0,0.00,0
,20170119,3975,3975,,,,3966,3966,-9,-9,0,0.00,0
,20170120,3966,3966,,,,3945,3945,-21,-21,0,0.00,0
,20170123,3945,3945,,,,3934,3934,-11,-11,0,0.00,0
,20170124,3934,3934,,,,3868,3868,-66,-66,0,0.00,0
,20170125,3868,3868,,,,3927,3927,59,59,0,0.00,0
,20170126,3927,3927,,,,3919,3919,-8,-8,0,0.00,0
,20170203,3919,3919,,,,3645,3645,-274,-274,0,0.00,0
,20170206,3645,3645,,,,3645,3645,0,0,0,0.00,0
,20170207,3645,3645,,,,3635,3635,-10,-10,0,0.00,0
,20170208,3635,3635,,,,3656,3656,21,21,0,0.00,0
,20170209,3656,3656,,,,3669,3669,13,13,0,0.00,0
,20170210,3669,3669,,,,3696,3696,27,27,0,0.00,0
,20170213,3696,3696,,,,3770,3770,74,74,0,0.00,0
,20170214,3770,3770,,,,3633,3633,-137,-137,0,0.00,0
,20170215,3633,3633,,,,3514,3514,-119,-119,0,0.00,0
,20170216,3514,3514,,,,3386,3386,-128,-128,0,0.00,0
,20170217,3386,3386,,,,3307,3307,-79,-79,0,0.00,0
,20170220,3307,3307,,,,3226,3226,-81,-81,0,0.00,0
,20170221,3226,3226,,,,3141,3141,-85,-85,0,0.00,0
,20170222,3141,3141,3101,3101,3101,3101,3101,-40,-40,2,31.01,2
,20170223,3101,3101,,,,3256,3256,155,155,0,0.00,2
,20170224,3256,3256,,,,3418,3418,162,162,0,0.00,2
,20170227,3418,3418,,,,3588,3588,170,170,0,0.00,2
,20170228,3588,3588,,,,3653,3653,65,65,0,0.00,2
,20170301,3653,3653,3815,3815,3815,3815,3815,162,162,2,38.15,0
,20170302,3815,3815,,,,3815,3815,0,0,0,0.00,0
,20170303,3815,3815,,,,3732,3732,-83,-83,0,0.00,0
,20170306,3732,3732,,,,3672,3672,-60,-60,0,0.00,0
,20170307,3672,3672,,,,3493,3493,-179,-179,0,0.00,0
,20170308,3493,3493,,,,3565,3565,72,72,0,0.00,0
,20170309,3565,3565,,,,3558,3558,-7,-7,0,0.00,0
,20170310,3558,3558,,,,3531,3531,-27,-27,0,0.00,0
,20170313,3531,3531,,,,3547,3547,16,16,0,0.00,0
,20170314,3547,3547,,,,3547,3547,0,0,0,0.00,0
,20170315,3547,3547,,,,3608,3608,61,61,0,0.00,0
,20170316,3608,3608,,,,3607,3607,-1,-1,0,0.00,0
,20170317,3607,3607,,,,3570,3570,-37,-37,0,0.00,0
,20170320,3570,3570,,,,3591,3591,21,21,0,0.00,0
,20170321,3591,3591,,,,3745,3745,154,154,0,0.00,0
,20170322,3745,3745,,,,3674,3674,-71,-71,0,0.00,0
,20170323,3674,3674,,,,3609,3609,-65,-65,0,0.00,0
,20170324,3609,3609,,,,3619,3619,10,10,0,0.00,0
,20170327,3619,3619,3438,3799,3438,3799,3618,180,-1,4,72.37,0
,20170328,3799,3618,,,,3703,3703,85,85,0,0.00,0
,20170329,3703,3703,,,,3646,3646,-57,-57,0,0.00,0
,20170330,3646,3646,,,,3473,3473,-173,-173,0,0.00,0
,20170331,3473,3473,,,,3473,3473,0,0,0,0.00,0
,20170405,3473,3473,,,,3473,3473,0,0,0,0.00,0
,20170406,3473,3473,,,,3473,3473,0,0,0,0.00,0
,20170407,3473,3473,,,,3473,3473,0,0,0,0.00,0
,20170410,3473,3473,,,,3473,3473,0,0,0,0.00,0
,20170411,3473,3473,,,,3473,3473,0,0,0,0.00,0
,20170412,3473,3473,,,,3473,3473,0,0,0,0.00,0
,20170413,3473,3473,,,,3473,3473,0,0,0,0.00,0
,20170414,3473,3473,,,,3473,3473,0,0,0,0.00,0
,20170417,3473,3473,,,,3473,3473,0,0,0,0.00,0
,20170418,3473,3473,,,,3473,3473,0,0,0,0.00,0
,20170419,3473,3473,,,,3473,3473,0,0,0,0.00,0
,20170420,3473,3473,,,,3473,3473,0,0,0,0.00,0
,20170421,3473,3473,,,,3473,3473,0,0,0,0.00,0
,20170424,3473,3473,,,,3473,3473,0,0,0,0.00,0
,20170425,3473,3473,,,,3473,3473,0,0,0,0.00,0
,20170426,3473,3473,,,,3473,3473,0,0,0,0.00,0
,20170427,3473,3473,,,,3473,3473,0,0,0,0.00,0
,20170428,3473,3473,,,,3473,3473,0,0,0,0.00,0
,20170502,3473,3473,,,,3473,3473,0,0,0,0.00,0
,20170503,3473,3473,,,,3473,3473,0,0,0,0.00,0
,20170504,3473,3473,,,,3473,3473,0,0,0,0.00,0
,20170505,3473,3473,,,,3473,3473,0,0,0,0.00,0
,20170508,3473,3473,,,,3473,3473,0,0,0,0.00,0
,20170509,3473,3473,,,,3473,3473,0,0,0,0.00,0
,20170510,3473,3473,,,,3473,3473,0,0,0,0.00,0
,20170511,3473,3473,,,,3473,3473,0,0,0,0.00,0
,20170512,3473,3473,,,,3473,3473,0,0,0,0.00,0
,20170515,3473,3473,,,,3473,3473,0,0,0,0.00,0
,20170516,3473,3473,,,,3473,3473,0,0,0,0.00,0
,20170517,3473,3473,,,,3473,3473,0,0,0,0.00,0
,20170518,3473,3473,,,,3473,3473,0,0,0,0.00,0
,20170519,3473,3473,,,,3473,3473,0,0,0,0.00,0
,20170522,3473,3473,,,,3473,3473,0,0,0,0.00,0
,20170523,3473,3473,,,,3473,3473,0,0,0,0.00,0
,20170524,3473,3473,,,,3473,3473,0,0,0,0.00,0
,20170525,3473,3473,,,,3473,3473,0,0,0,0.00,0
,20170526,3473,3473,,,,3473,3473,0,0,0,0.00,0
,20170531,3473,3473,,,,3473,3473,0,0,0,0.00,0
fu1707,20170103,3955,3955,,,,4001,4001,46,46,0,0.00,0
,20170104,4001,4001,,,,3833,3833,-168,-168,0,0.00,0
,20170105,3833,3833,,,,3803,3803,-30,-30,0,0.00,0
,20170106,3803,3803,,,,3869,3869,66,66,0,0.00,0
,20170109,3869,3869,,,,3875,3875,6,6,0,0.00,0
,20170110,3875,3875,,,,3724,3724,-151,-151,0,0.00,0
,20170111,3724,3724,,,,3691,3691,-33,-33,0,0.00,0
,20170112,3691,3691,,,,3760,3760,69,69,0,0.00,0
,20170113,3760,3760,,,,3804,3804,44,44,0,0.00,0
,20170116,3804,3804,,,,3836,3836,32,32,0,0.00,0
,20170117,3836,3836,,,,3914,3914,78,78,0,0.00,0
,20170118,3914,3914,,,,3935,3935,21,21,0,0.00,0
,20170119,3935,3935,,,,3926,3926,-9,-9,0,0.00,0
,20170120,3926,3926,,,,3905,3905,-21,-21,0,0.00,0
,20170123,3905,3905,,,,3895,3895,-10,-10,0,0.00,0
,20170124,3895,3895,,,,3830,3830,-65,-65,0,0.00,0
,20170125,3830,3830,,,,3889,3889,59,59,0,0.00,0
,20170126,3889,3889,,,,3881,3881,-8,-8,0,0.00,0
,20170203,3881,3881,,,,3609,3609,-272,-272,0,0.00,0
,20170206,3609,3609,,,,3609,3609,0,0,0,0.00,0
,20170207,3609,3609,,,,3600,3600,-9,-9,0,0.00,0
,20170208,3600,3600,,,,3620,3620,20,20,0,0.00,0
,20170209,3620,3620,,,,3633,3633,13,13,0,0.00,0
,20170210,3633,3633,,,,3660,3660,27,27,0,0.00,0
,20170213,3660,3660,,,,3733,3733,73,73,0,0.00,0
,20170214,3733,3733,,,,3598,3598,-135,-135,0,0.00,0
,20170215,3598,3598,,,,3480,3480,-118,-118,0,0.00,0
,20170216,3480,3480,,,,3353,3353,-127,-127,0,0.00,0
,20170217,3353,3353,,,,3275,3275,-78,-78,0,0.00,0
,20170220,3275,3275,,,,3195,3195,-80,-80,0,0.00,0
,20170221,3195,3195,,,,3111,3111,-84,-84,0,0.00,0
,20170222,3111,3111,,,,3071,3071,-40,-40,0,0.00,0
,20170223,3071,3071,,,,3042,3042,-29,-29,0,0.00,0
,20170224,3042,3042,,,,2920,2920,-122,-122,0,0.00,0
,20170227,2920,2920,,,,3212,3212,292,292,0,0.00,0
,20170228,3212,3212,,,,3270,3270,58,58,0,0.00,0
,20170301,3270,3270,,,,3415,3415,145,145,0,0.00,0
,20170302,3415,3415,,,,3415,3415,0,0,0,0.00,0
,20170303,3415,3415,,,,3340,3340,-75,-75,0,0.00,0
,20170306,3340,3340,,,,3286,3286,-54,-54,0,0.00,0
,20170307,3286,3286,,,,3126,3126,-160,-160,0,0.00,0
,20170308,3126,3126,,,,3190,3190,64,64,0,0.00,0
,20170309,3190,3190,,,,3184,3184,-6,-6,0,0.00,0
,20170310,3184,3184,,,,3160,3160,-24,-24,0,0.00,0
,20170313,3160,3160,,,,3476,3476,316,316,0,0.00,0
,20170314,3476,3476,,,,3476,3476,0,0,0,0.00,0
,20170315,3476,3476,,,,3536,3536,60,60,0,0.00,0
,20170316,3536,3536,,,,3535,3535,-1,-1,0,0.00,0
,20170317,3535,3535,,,,3499,3499,-36,-36,0,0.00,0
,20170320,3499,3499,,,,3519,3519,20,20,0,0.00,0
,20170321,3519,3519,,,,3670,3670,151,151,0,0.00,0
,20170322,3670,3670,,,,3600,3600,-70,-70,0,0.00,0
,20170323,3600,3600,,,,3536,3536,-64,-64,0,0.00,0
,20170324,3536,3536,,,,3546,3546,10,10,0,0.00,0
,20170327,3546,3546,,,,3545,3545,-1,-1,0,0.00,0
,20170328,3545,3545,,,,3628,3628,83,83,0,0.00,0
,20170329,3628,3628,,,,3572,3572,-56,-56,0,0.00,0
,20170330,3572,3572,,,,3402,3402,-170,-170,0,0.00,0
,20170331,3402,3402,,,,3402,3402,0,0,0,0.00,0
,20170405,3402,3402,,,,3402,3402,0,0,0,0.00,0
,20170406,3402,3402,,,,3402,3402,0,0,0,0.00,0
,20170407,3402,3402,,,,3402,3402,0,0,0,0.00,0
,20170410,3402,3402,,,,3402,3402,0,0,0,0.00,0
,20170411,3402,3402,,,,3402,3402,0,0,0,0.00,0
,20170412,3402,3402,,,,3402,3402,0,0,0,0.00,0
,20170413,3402,3402,,,,3402,3402,0,0,0,0.00,0
,20170414,3402,3402,,,,3402,3402,0,0,0,0.00,0
,20170417,3402,3402,,,,3402,3402,0,0,0,0.00,0
,20170418,3402,3402,,,,3402,3402,0,0,0,0.00,0
,20170419,3402,3402,,,,3402,3402,0,0,0,0.00,0
,20170420,3402,3402,,,,3402,3402,0,0,0,0.00,0
,20170421,3402,3402,,,,3402,3402,0,0,0,0.00,0
,20170424,3402,3402,,,,3402,3402,0,0,0,0.00,0
,20170425,3402,3402,,,,3402,3402,0,0,0,0.00,0
,20170426,3402,3402,,,,3402,3402,0,0,0,0.00,0
,20170427,3402,3402,,,,3402,3402,0,0,0,0.00,0
,20170428,3402,3402,,,,3402,3402,0,0,0,0.00,0
,20170502,3402,3402,,,,3402,3402,0,0,0,0.00,0
,20170503,3402,3402,,,,3402,3402,0,0,0,0.00,0
,20170504,3402,3402,,,,3402,3402,0,0,0,0.00,0
,20170505,3402,3402,,,,3402,3402,0,0,0,0.00,0
,20170508,3402,3402,,,,3402,3402,0,0,0,0.00,0
,20170509,3402,3402,,,,3402,3402,0,0,0,0.00,0
,20170510,3402,3402,,,,3402,3402,0,0,0,0.00,0
,20170511,3402,3402,,,,3402,3402,0,0,0,0.00,0
,20170512,3402,3402,,,,3402,3402,0,0,0,0.00,0
,20170515,3402,3402,,,,3402,3402,0,0,0,0.00,0
,20170516,3402,3402,,,,3402,3402,0,0,0,0.00,0
,20170517,3402,3402,,,,3402,3402,0,0,0,0.00,0
,20170518,3402,3402,,,,3402,3402,0,0,0,0.00,0
,20170519,3402,3402,,,,3402,3402,0,0,0,0.00,0
,20170522,3402,3402,,,,3402,3402,0,0,0,0.00,0
,20170523,3402,3402,,,,3402,3402,0,0,0,0.00,0
,20170524,3402,3402,,,,3402,3402,0,0,0,0.00,0
,20170525,3402,3402,,,,3402,3402,0,0,0,0.00,0
,20170526,3402,3402,,,,3402,3402,0,0,0,0.00,0
,20170531,3402,3402,,,,3402,3402,0,0,0,0.00,0
,20170601,3402,3402,,,,3402,3402,0,0,0,0.00,0
,20170602,3402,3402,,,,3402,3402,0,0,0,0.00,0
,20170605,3402,3402,,,,3402,3402,0,0,0,0.00,0
,20170606,3402,3402,,,,3402,3402,0,0,0,0.00,0
,20170607,3402,3402,,,,3402,3402,0,0,0,0.00,0
,20170608,3402,3402,,,,3402,3402,0,0,0,0.00,0
,20170609,3402,3402,,,,3402,3402,0,0,0,0.00,0
,20170612,3402,3402,,,,3402,3402,0,0,0,0.00,0
,20170613,3402,3402,,,,3402,3402,0,0,0,0.00,0
,20170614,3402,3402,,,,3402,3402,0,0,0,0.00,0
,20170615,3402,3402,,,,3402,3402,0,0,0,0.00,0
,20170616,3402,3402,,,,3402,3402,0,0,0,0.00,0
,20170619,3402,3402,,,,3402,3402,0,0,0,0.00,0
,20170620,3402,3402,,,,3402,3402,0,0,0,0.00,0
,20170621,3402,3402,,,,3402,3402,0,0,0,0.00,0
,20170622,3402,3402,,,,3402,3402,0,0,0,0.00,0
,20170623,3402,3402,,,,3402,3402,0,0,0,0.00,0
,20170626,3402,3402,,,,3402,3402,0,0,0,0.00,0
,20170627,3402,3402,,,,3402,3402,0,0,0,0.00,0
,20170628,3402,3402,,,,3402,3402,0,0,0,0.00,0
,20170629,3402,3402,,,,3402,3402,0,0,0,0.00,0
,20170630,3402,3402,,,,3402,3402,0,0,0,0.00,0
fu1708,20170103,4147,4147,,,,4196,4196,49,49,0,0.00,0
,20170104,4196,4196,,,,4020,4020,-176,-176,0,0.00,0
,20170105,4020,4020,,,,3988,3988,-32,-32,0,0.00,0
,20170106,3988,3988,,,,4058,4058,70,70,0,0.00,0
,20170109,4058,4058,,,,4064,4064,6,6,0,0.00,0
,20170110,4064,4064,,,,3906,3906,-158,-158,0,0.00,0
,20170111,3906,3906,,,,3871,3871,-35,-35,0,0.00,0
,20170112,3871,3871,,,,3943,3943,72,72,0,0.00,0
,20170113,3943,3943,,,,3989,3989,46,46,0,0.00,0
,20170116,3989,3989,,,,4022,4022,33,33,0,0.00,0
,20170117,4022,4022,,,,4104,4104,82,82,0,0.00,0
,20170118,4104,4104,,,,4126,4126,22,22,0,0.00,0
,20170119,4126,4126,,,,4116,4116,-10,-10,0,0.00,0
,20170120,4116,4116,,,,4095,4095,-21,-21,0,0.00,0
,20170123,4095,4095,,,,4084,4084,-11,-11,0,0.00,0
,20170124,4084,4084,,,,4016,4016,-68,-68,0,0.00,0
,20170125,4016,4016,,,,4078,4078,62,62,0,0.00,0
,20170126,4078,4078,,,,4069,4069,-9,-9,0,0.00,0
,20170203,4069,4069,,,,3784,3784,-285,-285,0,0.00,0
,20170206,3784,3784,,,,3784,3784,0,0,0,0.00,0
,20170207,3784,3784,,,,3774,3774,-10,-10,0,0.00,0
,20170208,3774,3774,,,,3795,3795,21,21,0,0.00,0
,20170209,3795,3795,,,,3808,3808,13,13,0,0.00,0
,20170210,3808,3808,,,,3836,3836,28,28,0,0.00,0
,20170213,3836,3836,,,,3913,3913,77,77,0,0.00,0
,20170214,3913,3913,,,,3771,3771,-142,-142,0,0.00,0
,20170215,3771,3771,,,,3648,3648,-123,-123,0,0.00,0
,20170216,3648,3648,,,,3515,3515,-133,-133,0,0.00,0
,20170217,3515,3515,,,,3433,3433,-82,-82,0,0.00,0
,20170220,3433,3433,,,,3349,3349,-84,-84,0,0.00,0
,20170221,3349,3349,,,,3260,3260,-89,-89,0,0.00,0
,20170222,3260,3260,,,,3218,3218,-42,-42,0,0.00,0
,20170223,3218,3218,,,,3188,3188,-30,-30,0,0.00,0
,20170224,3188,3188,,,,3061,3061,-127,-127,0,0.00,0
,20170227,3061,3061,,,,3214,3214,153,153,0,0.00,0
,20170228,3214,3214,,,,3272,3272,58,58,0,0.00,0
,20170301,3272,3272,,,,3417,3417,145,145,0,0.00,0
,20170302,3417,3417,,,,3417,3417,0,0,0,0.00,0
,20170303,3417,3417,,,,3342,3342,-75,-75,0,0.00,0
,20170306,3342,3342,,,,3288,3288,-54,-54,0,0.00,0
,20170307,3288,3288,,,,3452,3452,164,164,0,0.00,0
,20170308,3452,3452,,,,3523,3523,71,71,0,0.00,0
,20170309,3523,3523,,,,3516,3516,-7,-7,0,0.00,0
,20170310,3516,3516,,,,3489,3489,-27,-27,0,0.00,0
,20170313,3489,3489,,,,3505,3505,16,16,0,0.00,0
,20170314,3505,3505,,,,3505,3505,0,0,0,0.00,0
,20170315,3505,3505,,,,3565,3565,60,60,0,0.00,0
,20170316,3565,3565,,,,3564,3564,-1,-1,0,0.00,0
,20170317,3564,3564,,,,3528,3528,-36,-36,0,0.00,0
,20170320,3528,3528,,,,3549,3549,21,21,0,0.00,0
,20170321,3549,3549,,,,3701,3701,152,152,0,0.00,0
,20170322,3701,3701,,,,3630,3630,-71,-71,0,0.00,0
,20170323,3630,3630,,,,3566,3566,-64,-64,0,0.00,0
,20170324,3566,3566,,,,3576,3576,10,10,0,0.00,0
,20170327,3576,3576,,,,3575,3575,-1,-1,0,0.00,0
,20170328,3575,3575,,,,3659,3659,84,84,0,0.00,0
,20170329,3659,3659,,,,3602,3602,-57,-57,0,0.00,0
,20170330,3602,3602,,,,3431,3431,-171,-171,0,0.00,0
,20170331,3431,3431,,,,3431,3431,0,0,0,0.00,0
,20170405,3431,3431,,,,3431,3431,0,0,0,0.00,0
,20170406,3431,3431,,,,3431,3431,0,0,0,0.00,0
,20170407,3431,3431,,,,3431,3431,0,0,0,0.00,0
,20170410,3431,3431,,,,3431,3431,0,0,0,0.00,0
,20170411,3431,3431,,,,3431,3431,0,0,0,0.00,0
,20170412,3431,3431,,,,3431,3431,0,0,0,0.00,0
,20170413,3431,3431,,,,3431,3431,0,0,0,0.00,0
,20170414,3431,3431,,,,3431,3431,0,0,0,0.00,0
,20170417,3431,3431,,,,3431,3431,0,0,0,0.00,0
,20170418,3431,3431,,,,3431,3431,0,0,0,0.00,0
,20170419,3431,3431,,,,3431,3431,0,0,0,0.00,0
,20170420,3431,3431,,,,3431,3431,0,0,0,0.00,0
,20170421,3431,3431,,,,3431,3431,0,0,0,0.00,0
,20170424,3431,3431,,,,3431,3431,0,0,0,0.00,0
,20170425,3431,3431,,,,3431,3431,0,0,0,0.00,0
,20170426,3431,3431,,,,3431,3431,0,0,0,0.00,0
,20170427,3431,3431,,,,3431,3431,0,0,0,0.00,0
,20170428,3431,3431,,,,3431,3431,0,0,0,0.00,0
,20170502,3431,3431,,,,3431,3431,0,0,0,0.00,0
,20170503,3431,3431,,,,3431,3431,0,0,0,0.00,0
,20170504,3431,3431,,,,3431,3431,0,0,0,0.00,0
,20170505,3431,3431,,,,3431,3431,0,0,0,0.00,0
,20170508,3431,3431,,,,3431,3431,0,0,0,0.00,0
,20170509,3431,3431,,,,3431,3431,0,0,0,0.00,0
,20170510,3431,3431,,,,3431,3431,0,0,0,0.00,0
,20170511,3431,3431,,,,3431,3431,0,0,0,0.00,0
,20170512,3431,3431,,,,3431,3431,0,0,0,0.00,0
,20170515,3431,3431,,,,3431,3431,0,0,0,0.00,0
,20170516,3431,3431,,,,3431,3431,0,0,0,0.00,0
,20170517,3431,3431,,,,3431,3431,0,0,0,0.00,0
,20170518,3431,3431,,,,3431,3431,0,0,0,0.00,0
,20170519,3431,3431,,,,3431,3431,0,0,0,0.00,0
,20170522,3431,3431,,,,3431,3431,0,0,0,0.00,0
,20170523,3431,3431,,,,3431,3431,0,0,0,0.00,0
,20170524,3431,3431,,,,3431,3431,0,0,0,0.00,0
,20170525,3431,3431,,,,3431,3431,0,0,0,0.00,0
,20170526,3431,3431,,,,3431,3431,0,0,0,0.00,0
,20170531,3431,3431,,,,3431,3431,0,0,0,0.00,0
,20170601,3431,3431,,,,3431,3431,0,0,0,0.00,0
,20170602,3431,3431,,,,3431,3431,0,0,0,0.00,0
,20170605,3431,3431,,,,3431,3431,0,0,0,0.00,0
,20170606,3431,3431,,,,3431,3431,0,0,0,0.00,0
,20170607,3431,3431,,,,3431,3431,0,0,0,0.00,0
,20170608,3431,3431,,,,3431,3431,0,0,0,0.00,0
,20170609,3431,3431,,,,3431,3431,0,0,0,0.00,0
,20170612,3431,3431,,,,3431,3431,0,0,0,0.00,0
,20170613,3431,3431,,,,3431,3431,0,0,0,0.00,0
,20170614,3431,3431,,,,3431,3431,0,0,0,0.00,0
,20170615,3431,3431,,,,3431,3431,0,0,0,0.00,0
,20170616,3431,3431,,,,3431,3431,0,0,0,0.00,0
,20170619,3431,3431,,,,3431,3431,0,0,0,0.00,0
,20170620,3431,3431,,,,3431,3431,0,0,0,0.00,0
,20170621,3431,3431,,,,3431,3431,0,0,0,0.00,0
,20170622,3431,3431,,,,3431,3431,0,0,0,0.00,0
,20170623,3431,3431,,,,3431,3431,0,0,0,0.00,0
,20170626,3431,3431,,,,3431,3431,0,0,0,0.00,0
,20170627,3431,3431,,,,3431,3431,0,0,0,0.00,0
,20170628,3431,3431,,,,3431,3431,0,0,0,0.00,0
,20170629,3431,3431,,,,3431,3431,0,0,0,0.00,0
,20170630,3431,3431,,,,3431,3431,0,0,0,0.00,0
,20170703,3431,3431,,,,3431,3431,0,0,0,0.00,0
,20170704,3431,3431,,,,3431,3431,0,0,0,0.00,0
,20170705,3431,3431,,,,3431,3431,0,0,0,0.00,0
,20170706,3431,3431,,,,3431,3431,0,0,0,0.00,0
,20170707,3431,3431,,,,3431,3431,0,0,0,0.00,0
,20170710,3431,3431,,,,3431,3431,0,0,0,0.00,0
,20170711,3431,3431,,,,3431,3431,0,0,0,0.00,0
,20170712,3431,3431,,,,3431,3431,0,0,0,0.00,0
,20170713,3431,3431,,,,3431,3431,0,0,0,0.00,0
,20170714,3431,3431,,,,3431,3431,0,0,0,0.00,0
,20170717,3431,3431,,,,3431,3431,0,0,0,0.00,0
,20170718,3431,3431,,,,3431,3431,0,0,0,0.00,0
,20170719,3431,3431,,,,3431,3431,0,0,0,0.00,0
,20170720,3431,3431,,,,3431,3431,0,0,0,0.00,0
,20170721,3431,3431,,,,3431,3431,0,0,0,0.00,0
,20170724,3431,3431,,,,3431,3431,0,0,0,0.00,0
,20170725,3431,3431,,,,3431,3431,0,0,0,0.00,0
,20170726,3431,3431,,,,3431,3431,0,0,0,0.00,0
,20170727,3431,3431,,,,3431,3431,0,0,0,0.00,0
,20170728,3431,3431,,,,3431,3431,0,0,0,0.00,0
,20170731,3431,3431,,,,3431,3431,0,0,0,0.00,0
fu1709,20170103,3880,3880,,,,3926,3926,46,46,0,0.00,0
,20170104,3926,3926,,,,3761,3761,-165,-165,0,0.00,0
,20170105,3761,3761,,,,3731,3731,-30,-30,0,0.00,0
,20170106,3731,3731,,,,3796,3796,65,65,0,0.00,0
,20170109,3796,3796,,,,3802,3802,6,6,0,0.00,0
,20170110,3802,3802,,,,3654,3654,-148,-148,0,0.00,0
,20170111,3654,3654,,,,3621,3621,-33,-33,0,0.00,0
,20170112,3621,3621,,,,3689,3689,68,68,0,0.00,0
,20170113,3689,3689,,,,3732,3732,43,43,0,0.00,0
,20170116,3732,3732,,,,3763,3763,31,31,0,0.00,0
,20170117,3763,3763,,,,3840,3840,77,77,0,0.00,0
,20170118,3840,3840,,,,3861,3861,21,21,0,0.00,0
,20170119,3861,3861,,,,3852,3852,-9,-9,0,0.00,0
,20170120,3852,3852,,,,3832,3832,-20,-20,0,0.00,0
,20170123,3832,3832,,,,3822,3822,-10,-10,0,0.00,0
,20170124,3822,3822,,,,3758,3758,-64,-64,0,0.00,0
,20170125,3758,3758,,,,3816,3816,58,58,0,0.00,0
,20170126,3816,3816,,,,3808,3808,-8,-8,0,0.00,0
,20170203,3808,3808,,,,3541,3541,-267,-267,0,0.00,0
,20170206,3541,3541,,,,3541,3541,0,0,0,0.00,0
,20170207,3541,3541,,,,3532,3532,-9,-9,0,0.00,0
,20170208,3532,3532,,,,3552,3552,20,20,0,0.00,0
,20170209,3552,3552,,,,3564,3564,12,12,0,0.00,0
,20170210,3564,3564,,,,3590,3590,26,26,0,0.00,0
,20170213,3590,3590,,,,3662,3662,72,72,0,0.00,0
,20170214,3662,3662,,,,3529,3529,-133,-133,0,0.00,0
,20170215,3529,3529,,,,3414,3414,-115,-115,0,0.00,0
,20170216,3414,3414,,,,3290,3290,-124,-124,0,0.00,0
,20170217,3290,3290,,,,3214,3214,-76,-76,0,0.00,0
,20170220,3214,3214,,,,3135,3135,-79,-79,0,0.00,0
,20170221,3135,3135,,,,3052,3052,-83,-83,0,0.00,0
,20170222,3052,3052,,,,3013,3013,-39,-39,0,0.00,0
,20170223,3013,3013,,,,2984,2984,-29,-29,0,0.00,0
,20170224,2984,2984,,,,2865,2865,-119,-119,0,0.00,0
,20170227,2865,2865,,,,3151,3151,286,286,0,0.00,0
,20170228,3151,3151,,,,3208,3208,57,57,0,0.00,0
,20170301,3208,3208,,,,3350,3350,142,142,0,0.00,0
,20170302,3350,3350,,,,3350,3350,0,0,0,0.00,0
,20170303,3350,3350,,,,3277,3277,-73,-73,0,0.00,0
,20170306,3277,3277,,,,3224,3224,-53,-53,0,0.00,0
,20170307,3224,3224,2901,3546,2901,3546,3349,322,125,8,133.96,4
,20170308,3546,3349,,,,3516,3516,167,167,0,0.00,4
,20170309,3516,3516,3690,3690,3690,3690,3690,174,174,2,36.90,2
,20170310,3690,3690,,,,3690,3690,0,0,0,0.00,2
,20170313,3690,3690,,,,3690,3690,0,0,0,0.00,2
,20170314,3690,3690,,,,3690,3690,0,0,0,0.00,2
,20170315,3690,3690,,,,3690,3690,0,0,0,0.00,2
,20170316,3690,3690,,,,3690,3690,0,0,0,0.00,2
,20170317,3690,3690,,,,3690,3690,0,0,0,0.00,2
,20170320,3690,3690,,,,3690,3690,0,0,0,0.00,2
,20170321,3690,3690,,,,3690,3690,0,0,0,0.00,2
,20170322,3690,3690,,,,3690,3690,0,0,0,0.00,2
,20170323,3690,3690,,,,3625,3625,-65,-65,0,0.00,2
,20170324,3625,3625,,,,3625,3625,0,0,0,0.00,2
,20170327,3625,3625,,,,3625,3625,0,0,0,0.00,2
,20170328,3625,3625,,,,3625,3625,0,0,0,0.00,2
,20170329,3625,3625,,,,3569,3569,-56,-56,0,0.00,2
,20170330,3569,3569,,,,3399,3399,-170,-170,0,0.00,2
,20170331,3399,3399,,,,3399,3399,0,0,0,0.00,2
,20170405,3399,3399,,,,3399,3399,0,0,0,0.00,2
,20170406,3399,3399,,,,3399,3399,0,0,0,0.00,2
,20170407,3399,3399,,,,3399,3399,0,0,0,0.00,2
,20170410,3399,3399,,,,3399,3399,0,0,0,0.00,2
,20170411,3399,3399,,,,3399,3399,0,0,0,0.00,2
,20170412,3399,3399,,,,3399,3399,0,0,0,0.00,2
,20170413,3399,3399,,,,3399,3399,0,0,0,0.00,2
,20170414,3399,3399,,,,3399,3399,0,0,0,0.00,2
,20170417,3399,3399,,,,3399,3399,0,0,0,0.00,2
,20170418,3399,3399,,,,3399,3399,0,0,0,0.00,2
,20170419,3399,3399,,,,3399,3399,0,0,0,0.00,2
,20170420,3399,3399,,,,3399,3399,0,0,0,0.00,2
,20170421,3399,3399,,,,3399,3399,0,0,0,0.00,2
,20170424,3399,3399,,,,3399,3399,0,0,0,0.00,2
,20170425,3399,3399,,,,3399,3399,0,0,0,0.00,2
,20170426,3399,3399,,,,3399,3399,0,0,0,0.00,2
,20170427,3399,3399,,,,3399,3399,0,0,0,0.00,2
,20170428,3399,3399,,,,3399,3399,0,0,0,0.00,2
,20170502,3399,3399,,,,3399,3399,0,0,0,0.00,2
,20170503,3399,3399,,,,3399,3399,0,0,0,0.00,2
,20170504,3399,3399,,,,3399,3399,0,0,0,0.00,2
,20170505,3399,3399,,,,3399,3399,0,0,0,0.00,2
,20170508,3399,3399,,,,3399,3399,0,0,0,0.00,2
,20170509,3399,3399,,,,3399,3399,0,0,0,0.00,2
,20170510,3399,3399,,,,3399,3399,0,0,0,0.00,2
,20170511,3399,3399,,,,3399,3399,0,0,0,0.00,2
,20170512,3399,3399,,,,3399,3399,0,0,0,0.00,2
,20170515,3399,3399,,,,3399,3399,0,0,0,0.00,2
,20170516,3399,3399,,,,3399,3399,0,0,0,0.00,2
,20170517,3399,3399,,,,3399,3399,0,0,0,0.00,2
,20170518,3399,3399,,,,3399,3399,0,0,0,0.00,2
,20170519,3399,3399,,,,3399,3399,0,0,0,0.00,2
,20170522,3399,3399,,,,3399,3399,0,0,0,0.00,2
,20170523,3399,3399,,,,3399,3399,0,0,0,0.00,2
,20170524,3399,3399,,,,3399,3399,0,0,0,0.00,2
,20170525,3399,3399,,,,3399,3399,0,0,0,0.00,2
,20170526,3399,3399,,,,3399,3399,0,0,0,0.00,2
,20170531,3399,3399,,,,3399,3399,0,0,0,0.00,2
,20170601,3399,3399,,,,3399,3399,0,0,0,0.00,2
,20170602,3399,3399,,,,3568,3568,169,169,0,0.00,2
,20170605,3568,3568,,,,3568,3568,0,0,0,0.00,2
,20170606,3568,3568,,,,3568,3568,0,0,0,0.00,2
,20170607,3568,3568,,,,3568,3568,0,0,0,0.00,2
,20170608,3568,3568,,,,3568,3568,0,0,0,0.00,2
,20170609,3568,3568,,,,3745,3745,177,177,0,0.00,2
,20170612,3745,3745,,,,3745,3745,0,0,0,0.00,2
,20170613,3745,3745,,,,3745,3745,0,0,0,0.00,2
,20170614,3745,3745,,,,3745,3745,0,0,0,0.00,2
,20170615,3745,3745,,,,3745,3745,0,0,0,0.00,2
,20170616,3745,3745,,,,3745,3745,0,0,0,0.00,2
,20170619,3745,3745,,,,3745,3745,0,0,0,0.00,2
,20170620,3745,3745,,,,3745,3745,0,0,0,0.00,2
,20170621,3745,3745,,,,3745,3745,0,0,0,0.00,2
,20170622,3745,3745,,,,3745,3745,0,0,0,0.00,2
,20170623,3745,3745,,,,3745,3745,0,0,0,0.00,2
,20170626,3745,3745,,,,3745,3745,0,0,0,0.00,2
,20170627,3745,3745,,,,3745,3745,0,0,0,0.00,2
,20170628,3745,3745,,,,3745,3745,0,0,0,0.00,2
,20170629,3745,3745,,,,3745,3745,0,0,0,0.00,2
,20170630,3745,3745,,,,3745,3745,0,0,0,0.00,2
,20170703,3745,3745,,,,3745,3745,0,0,0,0.00,2
,20170704,3745,3745,,,,3745,3745,0,0,0,0.00,2
,20170705,3745,3745,,,,3745,3745,0,0,0,0.00,2
,20170706,3745,3745,,,,3745,3745,0,0,0,0.00,2
,20170707,3745,3745,,,,3745,3745,0,0,0,0.00,2
,20170710,3745,3745,,,,3745,3745,0,0,0,0.00,2
,20170711,3745,3745,,,,3745,3745,0,0,0,0.00,2
,20170712,3745,3745,,,,3745,3745,0,0,0,0.00,2
,20170713,3745,3745,,,,3745,3745,0,0,0,0.00,2
,20170714,3745,3745,,,,3745,3745,0,0,0,0.00,2
,20170717,3745,3745,,,,3745,3745,0,0,0,0.00,2
,20170718,3745,3745,,,,3745,3745,0,0,0,0.00,2
,20170719,3745,3745,,,,3745,3745,0,0,0,0.00,2
,20170720,3745,3745,,,,3745,3745,0,0,0,0.00,2
,20170721,3745,3745,,,,3745,3745,0,0,0,0.00,2
,20170724,3745,3745,,,,3745,3745,0,0,0,0.00,2
,20170725,3745,3745,,,,3745,3745,0,0,0,0.00,2
,20170726,3745,3745,,,,3745,3745,0,0,0,0.00,2
,20170727,3745,3745,,,,3745,3745,0,0,0,0.00,2
,20170728,3745,3745,,,,3745,3745,0,0,0,0.00,2
,20170731,3745,3745,,,,3745,3745,0,0,0,0.00,2
,20170801,3745,3745,,,,3745,3745,0,0,0,0.00,2
,20170802,3745,3745,,,,3745,3745,0,0,0,0.00,2
,20170803,3745,3745,,,,3745,3745,0,0,0,0.00,2
,20170804,3745,3745,,,,3745,3745,0,0,0,0.00,2
,20170807,3745,3745,,,,3745,3745,0,0,0,0.00,2
,20170808,3745,3745,,,,3745,3745,0,0,0,0.00,2
,20170809,3745,3745,,,,3745,3745,0,0,0,0.00,2
,20170810,3745,3745,,,,3745,3745,0,0,0,0.00,2
,20170811,3745,3745,,,,3745,3745,0,0,0,0.00,2
,20170814,3745,3745,,,,3745,3745,0,0,0,0.00,2
,20170815,3745,3745,,,,3745,3745,0,0,0,0.00,2
,20170816,3745,3745,,,,3745,3745,0,0,0,0.00,2
,20170817,3745,3745,,,,3745,3745,0,0,0,0.00,2
,20170818,3745,3745,,,,3745,3745,0,0,0,0.00,2
,20170821,3745,3745,,,,3745,3745,0,0,0,0.00,2
,20170822,3745,3745,,,,3745,3745,0,0,0,0.00,2
,20170823,3745,3745,,,,3745,3745,0,0,0,0.00,2
,20170824,3745,3745,,,,3745,3745,0,0,0,0.00,2
,20170825,3745,3745,,,,3745,3745,0,0,0,0.00,2
,20170828,3745,3745,3745,3745,3745,3745,3745,0,0,2,37.45,0
,20170829,3745,3745,,,,3745,3745,0,0,0,0.00,0
,20170830,3745,3745,,,,3745,3745,0,0,0,0.00,0
,20170831,3745,3745,,,,3745,3745,0,0,0,0.00,0
fu1710,20170103,3910,3910,,,,3956,3956,46,46,0,0.00,0
,20170104,3956,3956,,,,3790,3790,-166,-166,0,0.00,0
,20170105,3790,3790,,,,3760,3760,-30,-30,0,0.00,0
,20170106,3760,3760,,,,3826,3826,66,66,0,0.00,0
,20170109,3826,3826,,,,3832,3832,6,6,0,0.00,0
,20170110,3832,3832,,,,3683,3683,-149,-149,0,0.00,0
,20170111,3683,3683,,,,3650,3650,-33,-33,0,0.00,0
,20170112,3650,3650,,,,3718,3718,68,68,0,0.00,0
,20170113,3718,3718,,,,3761,3761,43,43,0,0.00,0
,20170116,3761,3761,,,,3792,3792,31,31,0,0.00,0
,20170117,3792,3792,,,,3870,3870,78,78,0,0.00,0
,20170118,3870,3870,,,,3891,3891,21,21,0,0.00,0
,20170119,3891,3891,,,,3882,3882,-9,-9,0,0.00,0
,20170120,3882,3882,,,,3862,3862,-20,-20,0,0.00,0
,20170123,3862,3862,,,,3852,3852,-10,-10,0,0.00,0
,20170124,3852,3852,,,,3788,3788,-64,-64,0,0.00,0
,20170125,3788,3788,,,,3846,3846,58,58,0,0.00,0
,20170126,3846,3846,,,,3838,3838,-8,-8,0,0.00,0
,20170203,3838,3838,,,,3569,3569,-269,-269,0,0.00,0
,20170206,3569,3569,,,,3569,3569,0,0,0,0.00,0
,20170207,3569,3569,,,,3560,3560,-9,-9,0,0.00,0
,20170208,3560,3560,,,,3580,3580,20,20,0,0.00,0
,20170209,3580,3580,,,,3592,3592,12,12,0,0.00,0
,20170210,3592,3592,,,,3619,3619,27,27,0,0.00,0
,20170213,3619,3619,,,,3692,3692,73,73,0,0.00,0
,20170214,3692,3692,,,,3558,3558,-134,-134,0,0.00,0
,20170215,3558,3558,,,,3442,3442,-116,-116,0,0.00,0
,20170216,3442,3442,,,,3317,3317,-125,-125,0,0.00,0
,20170217,3317,3317,,,,3240,3240,-77,-77,0,0.00,0
,20170220,3240,3240,,,,3161,3161,-79,-79,0,0.00,0
,20170221,3161,3161,,,,3077,3077,-84,-84,0,0.00,0
,20170222,3077,3077,,,,3037,3037,-40,-40,0,0.00,0
,20170223,3037,3037,,,,3008,3008,-29,-29,0,0.00,0
,20170224,3008,3008,,,,2888,2888,-120,-120,0,0.00,0
,20170227,2888,2888,,,,3176,3176,288,288,0,0.00,0
,20170228,3176,3176,,,,3234,3234,58,58,0,0.00,0
,20170301,3234,3234,,,,3377,3377,143,143,0,0.00,0
,20170302,3377,3377,,,,3377,3377,0,0,0,0.00,0
,20170303,3377,3377,,,,3303,3303,-74,-74,0,0.00,0
,20170306,3303,3303,,,,3250,3250,-53,-53,0,0.00,0
,20170307,3250,3250,,,,3376,3376,126,126,0,0.00,0
,20170308,3376,3376,,,,3445,3445,69,69,0,0.00,0
,20170309,3445,3445,,,,3615,3615,170,170,0,0.00,0
,20170310,3615,3615,,,,3587,3587,-28,-28,0,0.00,0
,20170313,3587,3587,,,,3604,3604,17,17,0,0.00,0
,20170314,3604,3604,,,,3604,3604,0,0,0,0.00,0
,20170315,3604,3604,,,,3666,3666,62,62,0,0.00,0
,20170316,3666,3666,,,,3665,3665,-1,-1,0,0.00,0
,20170317,3665,3665,,,,3628,3628,-37,-37,0,0.00,0
,20170320,3628,3628,,,,3649,3649,21,21,0,0.00,0
,20170321,3649,3649,,,,3805,3805,156,156,0,0.00,0
,20170322,3805,3805,,,,3805,3805,0,0,0,0.00,0
,20170323,3805,3805,,,,3805,3805,0,0,0,0.00,0
,20170324,3805,3805,,,,3805,3805,0,0,0,0.00,0
,20170327,3805,3805,,,,3805,3805,0,0,0,0.00,0
,20170328,3805,3805,,,,3805,3805,0,0,0,0.00,0
,20170329,3805,3805,,,,3805,3805,0,0,0,0.00,0
,20170330,3805,3805,,,,3805,3805,0,0,0,0.00,0
,20170331,3805,3805,,,,3805,3805,0,0,0,0.00,0
,20170405,3805,3805,,,,3805,3805,0,0,0,0.00,0
,20170406,3805,3805,,,,3805,3805,0,0,0,0.00,0
,20170407,3805,3805,,,,3805,3805,0,0,0,0.00,0
,20170410,3805,3805,,,,3805,3805,0,0,0,0.00,0
,20170411,3805,3805,,,,3805,3805,0,0,0,0.00,0
,20170412,3805,3805,,,,3805,3805,0,0,0,0.00,0
,20170413,3805,3805,,,,3805,3805,0,0,0,0.00,0
,20170414,3805,3805,,,,3805,3805,0,0,0,0.00,0
,20170417,3805,3805,,,,3805,3805,0,0,0,0.00,0
,20170418,3805,3805,,,,3805,3805,0,0,0,0.00,0
,20170419,3805,3805,,,,3805,3805,0,0,0,0.00,0
,20170420,3805,3805,,,,3805,3805,0,0,0,0.00,0
,20170421,3805,3805,,,,3805,3805,0,0,0,0.00,0
,20170424,3805,3805,,,,3805,3805,0,0,0,0.00,0
,20170425,3805,3805,,,,3805,3805,0,0,0,0.00,0
,20170426,3805,3805,,,,3805,3805,0,0,0,0.00,0
,20170427,3805,3805,,,,3805,3805,0,0,0,0.00,0
,20170428,3805,3805,,,,3805,3805,0,0,0,0.00,0
,20170502,3805,3805,,,,3805,3805,0,0,0,0.00,0
,20170503,3805,3805,,,,3805,3805,0,0,0,0.00,0
,20170504,3805,3805,,,,3805,3805,0,0,0,0.00,0
,20170505,3805,3805,,,,3805,3805,0,0,0,0.00,0
,20170508,3805,3805,,,,3805,3805,0,0,0,0.00,0
,20170509,3805,3805,,,,3805,3805,0,0,0,0.00,0
,20170510,3805,3805,,,,3805,3805,0,0,0,0.00,0
,20170511,3805,3805,,,,3805,3805,0,0,0,0.00,0
,20170512,3805,3805,,,,3805,3805,0,0,0,0.00,0
,20170515,3805,3805,,,,3805,3805,0,0,0,0.00,0
,20170516,3805,3805,,,,3805,3805,0,0,0,0.00,0
,20170517,3805,3805,,,,3805,3805,0,0,0,0.00,0
,20170518,3805,3805,,,,3805,3805,0,0,0,0.00,0
,20170519,3805,3805,,,,3805,3805,0,0,0,0.00,0
,20170522,3805,3805,,,,3805,3805,0,0,0,0.00,0
,20170523,3805,3805,,,,3805,3805,0,0,0,0.00,0
,20170524,3805,3805,,,,3805,3805,0,0,0,0.00,0
,20170525,3805,3805,,,,3805,3805,0,0,0,0.00,0
,20170526,3805,3805,,,,3805,3805,0,0,0,0.00,0
,20170531,3805,3805,,,,3805,3805,0,0,0,0.00,0
,20170601,3805,3805,,,,3805,3805,0,0,0,0.00,0
,20170602,3805,3805,,,,3805,3805,0,0,0,0.00,0
,20170605,3805,3805,,,,3805,3805,0,0,0,0.00,0
,20170606,3805,3805,,,,3805,3805,0,0,0,0.00,0
,20170607,3805,3805,,,,3805,3805,0,0,0,0.00,0
,20170608,3805,3805,,,,3805,3805,0,0,0,0.00,0
,20170609,3805,3805,,,,3805,3805,0,0,0,0.00,0
,20170612,3805,3805,,,,3805,3805,0,0,0,0.00,0
,20170613,3805,3805,,,,3805,3805,0,0,0,0.00,0
,20170614,3805,3805,,,,3805,3805,0,0,0,0.00,0
,20170615,3805,3805,,,,3805,3805,0,0,0,0.00,0
,20170616,3805,3805,,,,3805,3805,0,0,0,0.00,0
,20170619,3805,3805,,,,3805,3805,0,0,0,0.00,0
,20170620,3805,3805,,,,3805,3805,0,0,0,0.00,0
,20170621,3805,3805,,,,3805,3805,0,0,0,0.00,0
,20170622,3805,3805,,,,3805,3805,0,0,0,0.00,0
,20170623,3805,3805,,,,3805,3805,0,0,0,0.00,0
,20170626,3805,3805,,,,3805,3805,0,0,0,0.00,0
,20170627,3805,3805,,,,3805,3805,0,0,0,0.00,0
,20170628,3805,3805,,,,3805,3805,0,0,0,0.00,0
,20170629,3805,3805,,,,3805,3805,0,0,0,0.00,0
,20170630,3805,3805,,,,3805,3805,0,0,0,0.00,0
,20170703,3805,3805,3438,3438,3438,3438,3438,-367,-367,2,34.38,2
,20170704,3438,3438,3334,3609,3334,3609,3471,171,33,12,208.29,0
,20170705,3609,3471,3401,3401,3401,3401,3401,-70,-70,2,34.01,2
,20170706,3401,3401,,,,3571,3571,170,170,0,0.00,2
,20170707,3571,3571,,,,3571,3571,0,0,0,0.00,2
,20170710,3571,3571,3749,3749,3688,3735,3730,164,159,8,149.21,2
,20170711,3735,3730,,,,3730,3730,0,0,0,0.00,2
,20170712,3730,3730,3916,3916,3799,3800,3818,70,88,14,267.30,6
,20170713,3800,3818,,,,3818,3818,0,0,0,0.00,6
,20170714,3818,3818,3793,3884,3732,3732,3803,-86,-15,6,114.09,6
,20170717,3732,3803,3781,3829,3781,3829,3805,26,2,4,76.10,6
,20170718,3829,3805,,,,3805,3805,0,0,0,0.00,6
,20170719,3805,3805,,,,3805,3805,0,0,0,0.00,6
,20170720,3805,3805,,,,3805,3805,0,0,0,0.00,6
,20170721,3805,3805,3615,3945,3615,3840,3770,35,-35,16,301.64,8
,20170724,3840,3770,3799,3799,3745,3745,3782,-25,12,10,189.10,6
,20170725,3745,3782,3671,3721,3671,3721,3696,-61,-86,8,147.84,4
,20170726,3721,3696,3742,3742,3691,3691,3716,-5,20,4,74.33,4
,20170727,3691,3716,,,,3716,3716,0,0,0,0.00,4
,20170728,3716,3716,,,,3716,3716,0,0,0,0.00,4
,20170731,3716,3716,,,,3716,3716,0,0,0,0.00,4
,20170801,3716,3716,3895,3895,3890,3890,3892,174,176,4,77.85,6
,20170802,3890,3892,3700,3700,3700,3700,3700,-192,-192,2,37.00,6
,20170803,3700,3700,3879,3879,3681,3753,3802,53,102,20,380.28,4
,20170804,3753,3802,3979,3979,3637,3824,3813,22,11,6,114.40,4
,20170807,3824,3813,3822,3947,3669,3726,3793,-87,-20,26,493.17,6
,20170808,3726,3793,3789,3789,3750,3765,3765,-28,-28,8,150.60,6
,20170809,3765,3765,3806,3806,3756,3756,3781,-9,16,4,75.62,4
,20170810,3756,3781,3806,3806,3806,3806,3806,25,25,2,38.06,6
,20170811,3806,3806,3855,3950,3800,3860,3866,54,60,8,154.65,6
,20170814,3860,3866,,,,3866,3866,0,0,0,0.00,6
,20170815,3866,3866,,,,3866,3866,0,0,0,0.00,6
,20170816,3866,3866,3879,3879,3879,3879,3879,13,13,2,38.79,6
,20170817,3879,3879,3984,3984,3984,3984,3984,105,105,2,39.84,8
,20170818,3984,3984,3786,4020,3786,3930,3880,-54,-104,8,155.22,4
,20170821,3930,3880,3880,4012,3880,3991,3942,111,62,12,236.53,4
,20170822,3991,3942,3950,3950,3950,3950,3950,8,8,2,39.50,2
,20170823,3950,3950,,,,3950,3950,0,0,0,0.00,2
,20170824,3950,3950,,,,3950,3950,0,0,0,0.00,2
,20170825,3950,3950,,,,3950,3950,0,0,0,0.00,2
,20170828,3950,3950,,,,3950,3950,0,0,0,0.00,2
,20170829,3950,3950,,,,3950,3950,0,0,0,0.00,2
,20170830,3950,3950,,,,3950,3950,0,0,0,0.00,2
,20170831,3950,3950,,,,3950,3950,0,0,0,0.00,2
,20170901,3950,3950,,,,3950,3950,0,0,0,0.00,2
,20170904,3950,3950,,,,3950,3950,0,0,0,0.00,2
,20170905,3950,3950,,,,3950,3950,0,0,0,0.00,2
,20170906,3950,3950,,,,3950,3950,0,0,0,0.00,2
,20170907,3950,3950,,,,3950,3950,0,0,0,0.00,2
,20170908,3950,3950,,,,3950,3950,0,0,0,0.00,2
,20170911,3950,3950,,,,3950,3950,0,0,0,0.00,2
,20170912,3950,3950,,,,3950,3950,0,0,0,0.00,2
,20170913,3950,3950,,,,3950,3950,0,0,0,0.00,2
,20170914,3950,3950,,,,3950,3950,0,0,0,0.00,2
,20170915,3950,3950,,,,3950,3950,0,0,0,0.00,2
,20170918,3950,3950,,,,3950,3950,0,0,0,0.00,2
,20170919,3950,3950,,,,3950,3950,0,0,0,0.00,2
,20170920,3950,3950,,,,3950,3950,0,0,0,0.00,2
,20170921,3950,3950,,,,3950,3950,0,0,0,0.00,2
,20170922,3950,3950,,,,3950,3950,0,0,0,0.00,2
,20170925,3950,3950,4000,4000,4000,4000,4000,50,50,2,40.00,0
,20170926,4000,4000,,,,4000,4000,0,0,0,0.00,0
,20170927,4000,4000,,,,4000,4000,0,0,0,0.00,0
,20170928,4000,4000,,,,4000,4000,0,0,0,0.00,0
,20170929,4000,4000,,,,4000,4000,0,0,0,0.00,0
fu1711,20170103,4009,4009,,,,4056,4056,47,47,0,0.00,6
,20170104,4056,4056,,,,4056,4056,0,0,0,0.00,6
,20170105,4056,4056,,,,4056,4056,0,0,0,0.00,6
,20170106,4056,4056,,,,4056,4056,0,0,0,0.00,6
,20170109,4056,4056,,,,4056,4056,0,0,0,0.00,6
,20170110,4056,4056,3853,3853,3853,3853,3853,-203,-203,2,38.53,4
,20170111,3853,3853,,,,3819,3819,-34,-34,0,0.00,4
,20170112,3819,3819,,,,3890,3890,71,71,0,0.00,4
,20170113,3890,3890,,,,3935,3935,45,45,0,0.00,4
,20170116,3935,3935,,,,3968,3968,33,33,0,0.00,4
,20170117,3968,3968,,,,4049,4049,81,81,0,0.00,4
,20170118,4049,4049,,,,4071,4071,22,22,0,0.00,4
,20170119,4071,4071,,,,4062,4062,-9,-9,0,0.00,4
,20170120,4062,4062,,,,4041,4041,-21,-21,0,0.00,4
,20170123,4041,4041,,,,4030,4030,-11,-11,0,0.00,4
,20170124,4030,4030,,,,3963,3963,-67,-67,0,0.00,4
,20170125,3963,3963,,,,4024,4024,61,61,0,0.00,4
,20170126,4024,4024,,,,4016,4016,-8,-8,0,0.00,4
,20170203,4016,4016,,,,3735,3735,-281,-281,0,0.00,4
,20170206,3735,3735,,,,3735,3735,0,0,0,0.00,4
,20170207,3735,3735,,,,3725,3725,-10,-10,0,0.00,4
,20170208,3725,3725,,,,3746,3746,21,21,0,0.00,4
,20170209,3746,3746,,,,3759,3759,13,13,0,0.00,4
,20170210,3759,3759,,,,3787,3787,28,28,0,0.00,4
,20170213,3787,3787,,,,3863,3863,76,76,0,0.00,4
,20170214,3863,3863,,,,3723,3723,-140,-140,0,0.00,4
,20170215,3723,3723,,,,3601,3601,-122,-122,0,0.00,4
,20170216,3601,3601,,,,3470,3470,-131,-131,0,0.00,4
,20170217,3470,3470,,,,3389,3389,-81,-81,0,0.00,4
,20170220,3389,3389,,,,3306,3306,-83,-83,0,0.00,4
,20170221,3306,3306,,,,3219,3219,-87,-87,0,0.00,4
,20170222,3219,3219,,,,3178,3178,-41,-41,0,0.00,4
,20170223,3178,3178,,,,3148,3148,-30,-30,0,0.00,4
,20170224,3148,3148,,,,3022,3022,-126,-126,0,0.00,4
,20170227,3022,3022,,,,3173,3173,151,151,0,0.00,4
,20170228,3173,3173,,,,3331,3331,158,158,0,0.00,4
,20170301,3331,3331,,,,3478,3478,147,147,0,0.00,4
,20170302,3478,3478,,,,3478,3478,0,0,0,0.00,4
,20170303,3478,3478,,,,3402,3402,-76,-76,0,0.00,4
,20170306,3402,3402,,,,3347,3347,-55,-55,0,0.00,4
,20170307,3347,3347,,,,3476,3476,129,129,0,0.00,4
,20170308,3476,3476,,,,3547,3547,71,71,0,0.00,4
,20170309,3547,3547,,,,3722,3722,175,175,0,0.00,4
,20170310,3722,3722,,,,3694,3694,-28,-28,0,0.00,4
,20170313,3694,3694,,,,3711,3711,17,17,0,0.00,4
,20170314,3711,3711,,,,3711,3711,0,0,0,0.00,4
,20170315,3711,3711,,,,3775,3775,64,64,0,0.00,4
,20170316,3775,3775,,,,3775,3775,0,0,0,0.00,4
,20170317,3775,3775,,,,3737,3737,-38,-38,0,0.00,4
,20170320,3737,3737,,,,3759,3759,22,22,0,0.00,4
,20170321,3759,3759,,,,3920,3920,161,161,0,0.00,4
,20170322,3920,3920,,,,3920,3920,0,0,0,0.00,4
,20170323,3920,3920,,,,3851,3851,-69,-69,0,0.00,4
,20170324,3851,3851,,,,3851,3851,0,0,0,0.00,4
,20170327,3851,3851,,,,3851,3851,0,0,0,0.00,4
,20170328,3851,3851,,,,3851,3851,0,0,0,0.00,4
,20170329,3851,3851,,,,3851,3851,0,0,0,0.00,4
,20170330,3851,3851,,,,3851,3851,0,0,0,0.00,4
,20170331,3851,3851,3699,3699,3658,3658,3678,-193,-173,4,73.57,2
,20170405,3658,3678,,,,3678,3678,0,0,0,0.00,2
,20170406,3678,3678,,,,3678,3678,0,0,0,0.00,2
,20170407,3678,3678,,,,3678,3678,0,0,0,0.00,2
,20170410,3678,3678,,,,3678,3678,0,0,0,0.00,2
,20170411,3678,3678,,,,3678,3678,0,0,0,0.00,2
,20170412,3678,3678,3857,3861,3600,3600,3772,-78,94,6,113.18,2
,20170413,3600,3772,3699,3699,3699,3699,3699,-73,-73,2,36.99,0
,20170414,3699,3699,,,,3699,3699,0,0,0,0.00,0
,20170417,3699,3699,,,,3699,3699,0,0,0,0.00,0
,20170418,3699,3699,,,,3699,3699,0,0,0,0.00,0
,20170419,3699,3699,,,,3699,3699,0,0,0,0.00,0
,20170420,3699,3699,,,,3699,3699,0,0,0,0.00,0
,20170421,3699,3699,,,,3699,3699,0,0,0,0.00,0
,20170424,3699,3699,,,,3699,3699,0,0,0,0.00,0
,20170425,3699,3699,,,,3699,3699,0,0,0,0.00,0
,20170426,3699,3699,,,,3699,3699,0,0,0,0.00,0
,20170427,3699,3699,,,,3699,3699,0,0,0,0.00,0
,20170428,3699,3699,,,,3699,3699,0,0,0,0.00,0
,20170502,3699,3699,3883,3883,3701,3701,3823,2,124,10,191.18,4
,20170503,3701,3823,3835,3835,3786,3786,3816,-37,-7,10,190.83,2
,20170504,3786,3816,,,,3816,3816,0,0,0,0.00,2
,20170505,3816,3816,,,,3816,3816,0,0,0,0.00,2
,20170508,3816,3816,,,,3816,3816,0,0,0,0.00,2
,20170509,3816,3816,,,,3816,3816,0,0,0,0.00,2
,20170510,3816,3816,,,,3816,3816,0,0,0,0.00,2
,20170511,3816,3816,,,,3816,3816,0,0,0,0.00,2
,20170512,3816,3816,3631,3824,3631,3824,3791,8,-25,12,227.48,6
,20170515,3824,3791,3824,3980,3778,3849,3871,58,80,48,929.09,6
,20170516,3849,3871,3813,3859,3772,3855,3818,-16,-53,16,305.49,2
,20170517,3855,3818,,,,3818,3818,0,0,0,0.00,2
,20170518,3818,3818,3805,3874,3805,3874,3833,56,15,6,115.01,2
,20170519,3874,3833,,,,3833,3833,0,0,0,0.00,2
,20170522,3833,3833,,,,3833,3833,0,0,0,0.00,2
,20170523,3833,3833,,,,3833,3833,0,0,0,0.00,2
,20170524,3833,3833,,,,3833,3833,0,0,0,0.00,2
,20170525,3833,3833,,,,3833,3833,0,0,0,0.00,2
,20170526,3833,3833,,,,3833,3833,0,0,0,0.00,2
,20170531,3833,3833,,,,3833,3833,0,0,0,0.00,2
,20170601,3833,3833,,,,3833,3833,0,0,0,0.00,2
,20170602,3833,3833,,,,3833,3833,0,0,0,0.00,2
,20170605,3833,3833,,,,3833,3833,0,0,0,0.00,2
,20170606,3833,3833,,,,3833,3833,0,0,0,0.00,2
,20170607,3833,3833,,,,3833,3833,0,0,0,0.00,2
,20170608,3833,3833,,,,3833,3833,0,0,0,0.00,2
,20170609,3833,3833,,,,3833,3833,0,0,0,0.00,2
,20170612,3833,3833,,,,3833,3833,0,0,0,0.00,2
,20170613,3833,3833,,,,3833,3833,0,0,0,0.00,2
,20170614,3833,3833,,,,3833,3833,0,0,0,0.00,2
,20170615,3833,3833,,,,3833,3833,0,0,0,0.00,2
,20170616,3833,3833,,,,3833,3833,0,0,0,0.00,2
,20170619,3833,3833,,,,3833,3833,0,0,0,0.00,2
,20170620,3833,3833,,,,3833,3833,0,0,0,0.00,2
,20170621,3833,3833,,,,3833,3833,0,0,0,0.00,2
,20170622,3833,3833,,,,3833,3833,0,0,0,0.00,2
,20170623,3833,3833,,,,3833,3833,0,0,0,0.00,2
,20170626,3833,3833,,,,3833,3833,0,0,0,0.00,2
,20170627,3833,3833,,,,3833,3833,0,0,0,0.00,2
,20170628,3833,3833,,,,3833,3833,0,0,0,0.00,2
,20170629,3833,3833,,,,3833,3833,0,0,0,0.00,2
,20170630,3833,3833,,,,3833,3833,0,0,0,0.00,2
,20170703,3833,3833,,,,3833,3833,0,0,0,0.00,2
,20170704,3833,3833,,,,3833,3833,0,0,0,0.00,2
,20170705,3833,3833,,,,3833,3833,0,0,0,0.00,2
,20170706,3833,3833,,,,3833,3833,0,0,0,0.00,2
,20170707,3833,3833,,,,3833,3833,0,0,0,0.00,2
,20170710,3833,3833,,,,3833,3833,0,0,0,0.00,2
,20170711,3833,3833,,,,3833,3833,0,0,0,0.00,2
,20170712,3833,3833,,,,3833,3833,0,0,0,0.00,2
,20170713,3833,3833,,,,3833,3833,0,0,0,0.00,2
,20170714,3833,3833,,,,3833,3833,0,0,0,0.00,2
,20170717,3833,3833,,,,3833,3833,0,0,0,0.00,2
,20170718,3833,3833,,,,3833,3833,0,0,0,0.00,2
,20170719,3833,3833,,,,3833,3833,0,0,0,0.00,2
,20170720,3833,3833,,,,3833,3833,0,0,0,0.00,2
,20170721,3833,3833,,,,3833,3833,0,0,0,0.00,2
,20170724,3833,3833,,,,3833,3833,0,0,0,0.00,2
,20170725,3833,3833,,,,3833,3833,0,0,0,0.00,2
,20170726,3833,3833,,,,3833,3833,0,0,0,0.00,2
,20170727,3833,3833,,,,3833,3833,0,0,0,0.00,2
,20170728,3833,3833,,,,3833,3833,0,0,0,0.00,2
,20170731,3833,3833,,,,3833,3833,0,0,0,0.00,2
,20170801,3833,3833,,,,3833,3833,0,0,0,0.00,2
,20170802,3833,3833,4024,4024,4024,4024,4024,191,191,2,40.24,4
,20170803,4024,4024,,,,4024,4024,0,0,0,0.00,4
,20170804,4024,4024,,,,4024,4024,0,0,0,0.00,4
,20170807,4024,4024,,,,4024,4024,0,0,0,0.00,4
,20170808,4024,4024,3824,3824,3822,3822,3823,-202,-201,4,76.46,4
,20170809,3822,3823,,,,3823,3823,0,0,0,0.00,4
,20170810,3823,3823,,,,3823,3823,0,0,0,0.00,4
,20170811,3823,3823,,,,3823,3823,0,0,0,0.00,4
,20170814,3823,3823,,,,3823,3823,0,0,0,0.00,4
,20170815,3823,3823,,,,3823,3823,0,0,0,0.00,4
,20170816,3823,3823,,,,3823,3823,0,0,0,0.00,4
,20170817,3823,3823,,,,3823,3823,0,0,0,0.00,4
,20170818,3823,3823,4010,4010,4010,4010,4010,187,187,2,40.10,2
,20170821,4010,4010,,,,4010,4010,0,0,0,0.00,2
,20170822,4010,4010,,,,4010,4010,0,0,0,0.00,2
,20170823,4010,4010,,,,4010,4010,0,0,0,0.00,2
,20170824,4010,4010,4204,4204,4204,4204,4204,194,194,2,42.04,4
,20170825,4204,4204,4199,4199,4199,4199,4199,-5,-5,2,41.99,2
,20170828,4199,4199,,,,4199,4199,0,0,0,0.00,2
,20170829,4199,4199,,,,4199,4199,0,0,0,0.00,2
,20170830,4199,4199,,,,4199,4199,0,0,0,0.00,2
,20170831,4199,4199,,,,4199,4199,0,0,0,0.00,2
,20170901,4199,4199,,,,4199,4199,0,0,0,0.00,2
,20170904,4199,4199,,,,4199,4199,0,0,0,0.00,2
,20170905,4199,4199,,,,4199,4199,0,0,0,0.00,2
,20170906,4199,4199,,,,4199,4199,0,0,0,0.00,2
,20170907,4199,4199,,,,4199,4199,0,0,0,0.00,2
,20170908,4199,4199,,,,4199,4199,0,0,0,0.00,2
,20170911,4199,4199,,,,4199,4199,0,0,0,0.00,2
,20170912,4199,4199,,,,4199,4199,0,0,0,0.00,2
,20170913,4199,4199,,,,4199,4199,0,0,0,0.00,2
,20170914,4199,4199,,,,4199,4199,0,0,0,0.00,2
,20170915,4199,4199,,,,4199,4199,0,0,0,0.00,2
,20170918,4199,4199,,,,4199,4199,0,0,0,0.00,2
,20170919,4199,4199,,,,4199,4199,0,0,0,0.00,2
,20170920,4199,4199,,,,4199,4199,0,0,0,0.00,2
,20170921,4199,4199,,,,4199,4199,0,0,0,0.00,2
,20170922,4199,4199,,,,4199,4199,0,0,0,0.00,2
,20170925,4199,4199,4024,4024,4024,4024,4024,-175,-175,2,40.24,0
,20170926,4024,4024,,,,4024,4024,0,0,0,0.00,0
,20170927,4024,4024,,,,4024,4024,0,0,0,0.00,0
,20170928,4024,4024,,,,4024,4024,0,0,0,0.00,0
,20170929,4024,4024,,,,4024,4024,0,0,0,0.00,0
,20171009,4024,4024,,,,4024,4024,0,0,0,0.00,0
,20171010,4024,4024,,,,4024,4024,0,0,0,0.00,0
,20171011,4024,4024,,,,4024,4024,0,0,0,0.00,0
,20171012,4024,4024,,,,4024,4024,0,0,0,0.00,0
,20171013,4024,4024,,,,4024,4024,0,0,0,0.00,0
,20171016,4024,4024,,,,4024,4024,0,0,0,0.00,0
,20171017,4024,4024,,,,4024,4024,0,0,0,0.00,0
,20171018,4024,4024,,,,4024,4024,0,0,0,0.00,0
,20171019,4024,4024,,,,4024,4024,0,0,0,0.00,0
,20171020,4024,4024,,,,4024,4024,0,0,0,0.00,0
,20171023,4024,4024,,,,4024,4024,0,0,0,0.00,0
,20171024,4024,4024,,,,4024,4024,0,0,0,0.00,0
,20171025,4024,4024,,,,4024,4024,0,0,0,0.00,0
,20171026,4024,4024,,,,4024,4024,0,0,0,0.00,0
,20171027,4024,4024,,,,4024,4024,0,0,0,0.00,0
,20171030,4024,4024,,,,4024,4024,0,0,0,0.00,0
,20171031,4024,4024,,,,4024,4024,0,0,0,0.00,0
fu1712,20170103,4164,4164,,,,4213,4213,49,49,0,0.00,0
,20170104,4213,4213,,,,4213,4213,0,0,0,0.00,0
,20170105,4213,4213,,,,4213,4213,0,0,0,0.00,0
,20170106,4213,4213,,,,4213,4213,0,0,0,0.00,0
,20170109,4213,4213,,,,4213,4213,0,0,0,0.00,0
,20170110,4213,4213,,,,4213,4213,0,0,0,0.00,0
,20170111,4213,4213,,,,4213,4213,0,0,0,0.00,0
,20170112,4213,4213,,,,4213,4213,0,0,0,0.00,0
,20170113,4213,4213,,,,4213,4213,0,0,0,0.00,0
,20170116,4213,4213,,,,4213,4213,0,0,0,0.00,0
,20170117,4213,4213,,,,4213,4213,0,0,0,0.00,0
,20170118,4213,4213,,,,4213,4213,0,0,0,0.00,0
,20170119,4213,4213,,,,4213,4213,0,0,0,0.00,0
,20170120,4213,4213,,,,4213,4213,0,0,0,0.00,0
,20170123,4213,4213,,,,4213,4213,0,0,0,0.00,0
,20170124,4213,4213,,,,4213,4213,0,0,0,0.00,0
,20170125,4213,4213,,,,4213,4213,0,0,0,0.00,0
,20170126,4213,4213,,,,4213,4213,0,0,0,0.00,0
,20170203,4213,4213,,,,4213,4213,0,0,0,0.00,0
,20170206,4213,4213,,,,4213,4213,0,0,0,0.00,0
,20170207,4213,4213,,,,4213,4213,0,0,0,0.00,0
,20170208,4213,4213,,,,4213,4213,0,0,0,0.00,0
,20170209,4213,4213,,,,4213,4213,0,0,0,0.00,0
,20170210,4213,4213,,,,4213,4213,0,0,0,0.00,0
,20170213,4213,4213,,,,4298,4298,85,85,0,0.00,0
,20170214,4298,4298,,,,4298,4298,0,0,0,0.00,0
,20170215,4298,4298,,,,4158,4158,-140,-140,0,0.00,0
,20170216,4158,4158,,,,4007,4007,-151,-151,0,0.00,0
,20170217,4007,4007,,,,4007,4007,0,0,0,0.00,0
,20170220,4007,4007,,,,3909,3909,-98,-98,0,0.00,0
,20170221,3909,3909,,,,3806,3806,-103,-103,0,0.00,0
,20170222,3806,3806,,,,3806,3806,0,0,0,0.00,0
,20170223,3806,3806,,,,3806,3806,0,0,0,0.00,0
,20170224,3806,3806,,,,3806,3806,0,0,0,0.00,0
,20170227,3806,3806,,,,3825,3825,19,19,0,0.00,0
,20170228,3825,3825,,,,3895,3895,70,70,0,0.00,0
,20170301,3895,3895,,,,3895,3895,0,0,0,0.00,0
,20170302,3895,3895,,,,3895,3895,0,0,0,0.00,0
,20170303,3895,3895,,,,3810,3810,-85,-85,0,0.00,0
,20170306,3810,3810,,,,3810,3810,0,0,0,0.00,0
,20170307,3810,3810,,,,3810,3810,0,0,0,0.00,0
,20170308,3810,3810,,,,3810,3810,0,0,0,0.00,0
,20170309,3810,3810,,,,3810,3810,0,0,0,0.00,0
,20170310,3810,3810,,,,3810,3810,0,0,0,0.00,0
,20170313,3810,3810,,,,3810,3810,0,0,0,0.00,0
,20170314,3810,3810,,,,3810,3810,0,0,0,0.00,0
,20170315,3810,3810,,,,3810,3810,0,0,0,0.00,0
,20170316,3810,3810,,,,3810,3810,0,0,0,0.00,0
,20170317,3810,3810,,,,3810,3810,0,0,0,0.00,0
,20170320,3810,3810,,,,3810,3810,0,0,0,0.00,0
,20170321,3810,3810,,,,3810,3810,0,0,0,0.00,0
,20170322,3810,3810,,,,3810,3810,0,0,0,0.00,0
,20170323,3810,3810,,,,3810,3810,0,0,0,0.00,0
,20170324,3810,3810,,,,3810,3810,0,0,0,0.00,0
,20170327,3810,3810,,,,3810,3810,0,0,0,0.00,0
,20170328,3810,3810,,,,3810,3810,0,0,0,0.00,0
,20170329,3810,3810,,,,3810,3810,0,0,0,0.00,0
,20170330,3810,3810,,,,3810,3810,0,0,0,0.00,0
,20170331,3810,3810,,,,3810,3810,0,0,0,0.00,0
,20170405,3810,3810,,,,3810,3810,0,0,0,0.00,0
,20170406,3810,3810,,,,3810,3810,0,0,0,0.00,0
,20170407,3810,3810,,,,3810,3810,0,0,0,0.00,0
,20170410,3810,3810,,,,3810,3810,0,0,0,0.00,0
,20170411,3810,3810,,,,3810,3810,0,0,0,0.00,0
,20170412,3810,3810,,,,3810,3810,0,0,0,0.00,0
,20170413,3810,3810,,,,3810,3810,0,0,0,0.00,0
,20170414,3810,3810,,,,3810,3810,0,0,0,0.00,0
,20170417,3810,3810,,,,3810,3810,0,0,0,0.00,0
,20170418,3810,3810,,,,3810,3810,0,0,0,0.00,0
,20170419,3810,3810,,,,3810,3810,0,0,0,0.00,0
,20170420,3810,3810,,,,3810,3810,0,0,0,0.00,0
,20170421,3810,3810,,,,3810,3810,0,0,0,0.00,0
,20170424,3810,3810,,,,3810,3810,0,0,0,0.00,0
,20170425,3810,3810,,,,3810,3810,0,0,0,0.00,0
,20170426,3810,3810,,,,3810,3810,0,0,0,0.00,0
,20170427,3810,3810,,,,3810,3810,0,0,0,0.00,0
,20170428,3810,3810,,,,3810,3810,0,0,0,0.00,0
,20170502,3810,3810,,,,3810,3810,0,0,0,0.00,0
,20170503,3810,3810,,,,3810,3810,0,0,0,0.00,0
,20170504,3810,3810,,,,3810,3810,0,0,0,0.00,0
,20170505,3810,3810,,,,3810,3810,0,0,0,0.00,0
,20170508,3810,3810,,,,3810,3810,0,0,0,0.00,0
,20170509,3810,3810,,,,3810,3810,0,0,0,0.00,0
,20170510,3810,3810,,,,3810,3810,0,0,0,0.00,0
,20170511,3810,3810,,,,3810,3810,0,0,0,0.00,0
,20170512,3810,3810,,,,3810,3810,0,0,0,0.00,0
,20170515,3810,3810,,,,3810,3810,0,0,0,0.00,0
,20170516,3810,3810,,,,3810,3810,0,0,0,0.00,0
,20170517,3810,3810,,,,3810,3810,0,0,0,0.00,0
,20170518,3810,3810,,,,3810,3810,0,0,0,0.00,0
,20170519,3810,3810,,,,3810,3810,0,0,0,0.00,0
,20170522,3810,3810,,,,3810,3810,0,0,0,0.00,0
,20170523,3810,3810,,,,3810,3810,0,0,0,0.00,0
,20170524,3810,3810,,,,3810,3810,0,0,0,0.00,0
,20170525,3810,3810,,,,3810,3810,0,0,0,0.00,0
,20170526,3810,3810,,,,3810,3810,0,0,0,0.00,0
,20170531,3810,3810,,,,3810,3810,0,0,0,0.00,0
,20170601,3810,3810,,,,3810,3810,0,0,0,0.00,0
,20170602,3810,3810,,,,3810,3810,0,0,0,0.00,0
,20170605,3810,3810,,,,3810,3810,0,0,0,0.00,0
,20170606,3810,3810,,,,3810,3810,0,0,0,0.00,0
,20170607,3810,3810,,,,3810,3810,0,0,0,0.00,0
,20170608,3810,3810,,,,3810,3810,0,0,0,0.00,0
,20170609,3810,3810,,,,3810,3810,0,0,0,0.00,0
,20170612,3810,3810,,,,3810,3810,0,0,0,0.00,0
,20170613,3810,3810,,,,3810,3810,0,0,0,0.00,0
,20170614,3810,3810,,,,3810,3810,0,0,0,0.00,0
,20170615,3810,3810,,,,3810,3810,0,0,0,0.00,0
,20170616,3810,3810,,,,3810,3810,0,0,0,0.00,0
,20170619,3810,3810,,,,3810,3810,0,0,0,0.00,0
,20170620,3810,3810,,,,3810,3810,0,0,0,0.00,0
,20170621,3810,3810,,,,3810,3810,0,0,0,0.00,0
,20170622,3810,3810,,,,3810,3810,0,0,0,0.00,0
,20170623,3810,3810,,,,3810,3810,0,0,0,0.00,0
,20170626,3810,3810,,,,3810,3810,0,0,0,0.00,0
,20170627,3810,3810,,,,3810,3810,0,0,0,0.00,0
,20170628,3810,3810,,,,3810,3810,0,0,0,0.00,0
,20170629,3810,3810,,,,3810,3810,0,0,0,0.00,0
,20170630,3810,3810,,,,3810,3810,0,0,0,0.00,0
,20170703,3810,3810,,,,3810,3810,0,0,0,0.00,0
,20170704,3810,3810,,,,3810,3810,0,0,0,0.00,0
,20170705,3810,3810,,,,3810,3810,0,0,0,0.00,0
,20170706,3810,3810,,,,3810,3810,0,0,0,0.00,0
,20170707,3810,3810,,,,3810,3810,0,0,0,0.00,0
,20170710,3810,3810,,,,3810,3810,0,0,0,0.00,0
,20170711,3810,3810,,,,3810,3810,0,0,0,0.00,0
,20170712,3810,3810,,,,3810,3810,0,0,0,0.00,0
,20170713,3810,3810,,,,3810,3810,0,0,0,0.00,0
,20170714,3810,3810,,,,3810,3810,0,0,0,0.00,0
,20170717,3810,3810,,,,3810,3810,0,0,0,0.00,0
,20170718,3810,3810,,,,3810,3810,0,0,0,0.00,0
,20170719,3810,3810,,,,3810,3810,0,0,0,0.00,0
,20170720,3810,3810,,,,3810,3810,0,0,0,0.00,0
,20170721,3810,3810,,,,3810,3810,0,0,0,0.00,0
,20170724,3810,3810,,,,3810,3810,0,0,0,0.00,0
,20170725,3810,3810,,,,3810,3810,0,0,0,0.00,0
,20170726,3810,3810,,,,3810,3810,0,0,0,0.00,0
,20170727,3810,3810,,,,3810,3810,0,0,0,0.00,0
,20170728,3810,3810,,,,3810,3810,0,0,0,0.00,0
,20170731,3810,3810,,,,3810,3810,0,0,0,0.00,0
,20170801,3810,3810,,,,3810,3810,0,0,0,0.00,0
,20170802,3810,3810,,,,3810,3810,0,0,0,0.00,0
,20170803,3810,3810,,,,3810,3810,0,0,0,0.00,0
,20170804,3810,3810,,,,3810,3810,0,0,0,0.00,0
,20170807,3810,3810,,,,3810,3810,0,0,0,0.00,0
,20170808,3810,3810,,,,3810,3810,0,0,0,0.00,0
,20170809,3810,3810,,,,3810,3810,0,0,0,0.00,0
,20170810,3810,3810,4189,4189,3869,3869,4029,59,219,4,80.58,4
,20170811,3869,4029,4089,4089,3843,3843,3966,-186,-63,4,79.32,2
,20170814,3843,3966,,,,3928,3928,-38,-38,0,0.00,2
,20170815,3928,3928,,,,3927,3927,-1,-1,0,0.00,2
,20170816,3927,3927,3832,3832,3832,3832,3832,-95,-95,2,38.32,0
,20170817,3832,3832,,,,3935,3935,103,103,0,0.00,0
,20170818,3935,3935,,,,3935,3935,0,0,0,0.00,0
,20170821,3935,3935,,,,3935,3935,0,0,0,0.00,0
,20170822,3935,3935,,,,3935,3935,0,0,0,0.00,0
,20170823,3935,3935,,,,3935,3935,0,0,0,0.00,0
,20170824,3935,3935,,,,3935,3935,0,0,0,0.00,0
,20170825,3935,3935,,,,3935,3935,0,0,0,0.00,0
,20170828,3935,3935,,,,3935,3935,0,0,0,0.00,0
,20170829,3935,3935,,,,3935,3935,0,0,0,0.00,0
,20170830,3935,3935,,,,3935,3935,0,0,0,0.00,0
,20170831,3935,3935,,,,3935,3935,0,0,0,0.00,0
,20170901,3935,3935,,,,3935,3935,0,0,0,0.00,0
,20170904,3935,3935,,,,3935,3935,0,0,0,0.00,0
,20170905,3935,3935,,,,3935,3935,0,0,0,0.00,0
,20170906,3935,3935,,,,3935,3935,0,0,0,0.00,0
,20170907,3935,3935,,,,3935,3935,0,0,0,0.00,0
,20170908,3935,3935,,,,3935,3935,0,0,0,0.00,0
,20170911,3935,3935,,,,3935,3935,0,0,0,0.00,0
,20170912,3935,3935,,,,3935,3935,0,0,0,0.00,0
,20170913,3935,3935,,,,3935,3935,0,0,0,0.00,0
,20170914,3935,3935,,,,3935,3935,0,0,0,0.00,0
,20170915,3935,3935,,,,3935,3935,0,0,0,0.00,0
,20170918,3935,3935,,,,3935,3935,0,0,0,0.00,0
,20170919,3935,3935,,,,3935,3935,0,0,0,0.00,0
,20170920,3935,3935,,,,3935,3935,0,0,0,0.00,0
,20170921,3935,3935,,,,3935,3935,0,0,0,0.00,0
,20170922,3935,3935,,,,3935,3935,0,0,0,0.00,0
,20170925,3935,3935,,,,3771,3771,-164,-164,0,0.00,0
,20170926,3771,3771,,,,3771,3771,0,0,0,0.00,0
,20170927,3771,3771,,,,3771,3771,0,0,0,0.00,0
,20170928,3771,3771,,,,3771,3771,0,0,0,0.00,0
,20170929,3771,3771,,,,3771,3771,0,0,0,0.00,0
,20171009,3771,3771,,,,3771,3771,0,0,0,0.00,0
,20171010,3771,3771,,,,3771,3771,0,0,0,0.00,0
,20171011,3771,3771,,,,3771,3771,0,0,0,0.00,0
,20171012,3771,3771,,,,3771,3771,0,0,0,0.00,0
,20171013,3771,3771,,,,3771,3771,0,0,0,0.00,0
,20171016,3771,3771,,,,3771,3771,0,0,0,0.00,0
,20171017,3771,3771,,,,3771,3771,0,0,0,0.00,0
,20171018,3771,3771,,,,3771,3771,0,0,0,0.00,0
,20171019,3771,3771,,,,3771,3771,0,0,0,0.00,0
,20171020,3771,3771,,,,3771,3771,0,0,0,0.00,0
,20171023,3771,3771,,,,3771,3771,0,0,0,0.00,0
,20171024,3771,3771,,,,3771,3771,0,0,0,0.00,0
,20171025,3771,3771,,,,3771,3771,0,0,0,0.00,0
,20171026,3771,3771,,,,3771,3771,0,0,0,0.00,0
,20171027,3771,3771,,,,3771,3771,0,0,0,0.00,0
,20171030,3771,3771,,,,3771,3771,0,0,0,0.00,0
,20171031,3771,3771,,,,3771,3771,0,0,0,0.00,0
,20171101,3771,3771,,,,3771,3771,0,0,0,0.00,0
,20171102,3771,3771,,,,3771,3771,0,0,0,0.00,0
,20171103,3771,3771,,,,3771,3771,0,0,0,0.00,0
,20171106,3771,3771,,,,3771,3771,0,0,0,0.00,0
,20171107,3771,3771,,,,3771,3771,0,0,0,0.00,0
,20171108,3771,3771,,,,3771,3771,0,0,0,0.00,0
,20171109,3771,3771,,,,3771,3771,0,0,0,0.00,0
,20171110,3771,3771,,,,3771,3771,0,0,0,0.00,0
,20171113,3771,3771,,,,3771,3771,0,0,0,0.00,0
,20171114,3771,3771,,,,3771,3771,0,0,0,0.00,0
,20171115,3771,3771,,,,3771,3771,0,0,0,0.00,0
,20171116,3771,3771,,,,3771,3771,0,0,0,0.00,0
,20171117,3771,3771,,,,3771,3771,0,0,0,0.00,0
,20171120,3771,3771,,,,3771,3771,0,0,0,0.00,0
,20171121,3771,3771,,,,3771,3771,0,0,0,0.00,0
,20171122,3771,3771,,,,3771,3771,0,0,0,0.00,0
,20171123,3771,3771,,,,3771,3771,0,0,0,0.00,0
,20171124,3771,3771,,,,3771,3771,0,0,0,0.00,0
,20171127,3771,3771,,,,3771,3771,0,0,0,0.00,0
,20171128,3771,3771,,,,3771,3771,0,0,0,0.00,0
,20171129,3771,3771,,,,3771,3771,0,0,0,0.00,0
,20171130,3771,3771,,,,3771,3771,0,0,0,0.00,0
fu1801,20170103,4164,4164,,,,4213,4213,49,49,0,0.00,0
,20170104,4213,4213,,,,4213,4213,0,0,0,0.00,0
,20170105,4213,4213,,,,4213,4213,0,0,0,0.00,0
,20170106,4213,4213,,,,4213,4213,0,0,0,0.00,0
,20170109,4213,4213,,,,4213,4213,0,0,0,0.00,0
,20170110,4213,4213,,,,4213,4213,0,0,0,0.00,0
,20170111,4213,4213,,,,4213,4213,0,0,0,0.00,0
,20170112,4213,4213,,,,4213,4213,0,0,0,0.00,0
,20170113,4213,4213,,,,4213,4213,0,0,0,0.00,0
,20170116,4213,4213,,,,4213,4213,0,0,0,0.00,0
,20170117,4213,4213,,,,4213,4213,0,0,0,0.00,0
,20170118,4213,4213,,,,4213,4213,0,0,0,0.00,0
,20170119,4213,4213,,,,4213,4213,0,0,0,0.00,0
,20170120,4213,4213,,,,4213,4213,0,0,0,0.00,0
,20170123,4213,4213,,,,4213,4213,0,0,0,0.00,0
,20170124,4213,4213,,,,4213,4213,0,0,0,0.00,0
,20170125,4213,4213,,,,4213,4213,0,0,0,0.00,0
,20170126,4213,4213,,,,4213,4213,0,0,0,0.00,0
,20170203,4213,4213,,,,4213,4213,0,0,0,0.00,0
,20170206,4213,4213,,,,4213,4213,0,0,0,0.00,0
,20170207,4213,4213,,,,4213,4213,0,0,0,0.00,0
,20170208,4213,4213,,,,4213,4213,0,0,0,0.00,0
,20170209,4213,4213,,,,4213,4213,0,0,0,0.00,0
,20170210,4213,4213,,,,4213,4213,0,0,0,0.00,0
,20170213,4213,4213,,,,4298,4298,85,85,0,0.00,0
,20170214,4298,4298,,,,4298,4298,0,0,0,0.00,0
,20170215,4298,4298,,,,4158,4158,-140,-140,0,0.00,0
,20170216,4158,4158,,,,4007,4007,-151,-151,0,0.00,0
,20170217,4007,4007,,,,4007,4007,0,0,0,0.00,0
,20170220,4007,4007,,,,3909,3909,-98,-98,0,0.00,0
,20170221,3909,3909,,,,3806,3806,-103,-103,0,0.00,0
,20170222,3806,3806,,,,3806,3806,0,0,0,0.00,0
,20170223,3806,3806,4186,4186,3889,3889,3991,83,185,8,159.65,2
,20170224,3889,3991,4190,4190,4000,4000,4095,9,104,4,81.90,2
,20170227,4000,4095,3916,3916,3916,3916,3916,-179,-179,2,39.16,2
,20170228,3916,3916,,,,3987,3987,71,71,0,0.00,2
,20170301,3987,3987,4186,4186,4186,4186,4186,199,199,2,41.86,2
,20170302,4186,4186,,,,4186,4186,0,0,0,0.00,2
,20170303,4186,4186,,,,4095,4095,-91,-91,0,0.00,2
,20170306,4095,4095,,,,4029,4029,-66,-66,0,0.00,2
,20170307,4029,4029,,,,4029,4029,0,0,0,0.00,2
,20170308,4029,4029,3827,4220,3827,4220,4023,191,-6,4,80.47,2
,20170309,4220,4023,,,,4023,4023,0,0,0,0.00,2
,20170310,4023,4023,,,,3992,3992,-31,-31,0,0.00,2
,20170313,3992,3992,,,,3992,3992,0,0,0,0.00,2
,20170314,3992,3992,,,,3992,3992,0,0,0,0.00,2
,20170315,3992,3992,,,,3992,3992,0,0,0,0.00,2
,20170316,3992,3992,,,,3992,3992,0,0,0,0.00,2
,20170317,3992,3992,,,,3952,3952,-40,-40,0,0.00,2
,20170320,3952,3952,,,,3952,3952,0,0,0,0.00,2
,20170321,3952,3952,3760,3760,3760,3760,3760,-192,-192,2,37.60,4
,20170322,3760,3760,3581,3581,3581,3581,3581,-179,-179,2,35.81,2
,20170323,3581,3581,,,,3518,3518,-63,-63,0,0.00,2
,20170324,3518,3518,,,,3528,3528,10,10,0,0.00,2
,20170327,3528,3528,,,,3527,3527,-1,-1,0,0.00,2
,20170328,3527,3527,,,,3610,3610,83,83,0,0.00,2
,20170329,3610,3610,,,,3554,3554,-56,-56,0,0.00,2
,20170330,3554,3554,,,,3385,3385,-169,-169,0,0.00,2
,20170331,3385,3385,3215,3215,3215,3215,3215,-170,-170,2,32.15,0
,20170405,3215,3215,,,,3215,3215,0,0,0,0.00,0
,20170406,3215,3215,,,,3215,3215,0,0,0,0.00,0
,20170407,3215,3215,,,,3215,3215,0,0,0,0.00,0
,20170410,3215,3215,,,,3215,3215,0,0,0,0.00,0
,20170411,3215,3215,,,,3215,3215,0,0,0,0.00,0
,20170412,3215,3215,,,,3297,3297,82,82,0,0.00,0
,20170413,3297,3297,,,,3233,3233,-64,-64,0,0.00,0
,20170414,3233,3233,,,,3233,3233,0,0,0,0.00,0
,20170417,3233,3233,,,,3233,3233,0,0,0,0.00,0
,20170418,3233,3233,,,,3233,3233,0,0,0,0.00,0
,20170419,3233,3233,,,,3233,3233,0,0,0,0.00,0
,20170420,3233,3233,,,,3233,3233,0,0,0,0.00,0
,20170421,3233,3233,,,,3233,3233,0,0,0,0.00,0
,20170424,3233,3233,,,,3233,3233,0,0,0,0.00,0
,20170425,3233,3233,,,,3233,3233,0,0,0,0.00,0
,20170426,3233,3233,,,,3233,3233,0,0,0,0.00,0
,20170427,3233,3233,,,,3233,3233,0,0,0,0.00,0
,20170428,3233,3233,,,,3233,3233,0,0,0,0.00,0
,20170502,3233,3233,,,,3341,3341,108,108,0,0.00,0
,20170503,3341,3341,,,,3335,3335,-6,-6,0,0.00,0
,20170504,3335,3335,,,,3335,3335,0,0,0,0.00,0
,20170505,3335,3335,,,,3335,3335,0,0,0,0.00,0
,20170508,3335,3335,,,,3335,3335,0,0,0,0.00,0
,20170509,3335,3335,,,,3335,3335,0,0,0,0.00,0
,20170510,3335,3335,,,,3335,3335,0,0,0,0.00,0
,20170511,3335,3335,,,,3335,3335,0,0,0,0.00,0
,20170512,3335,3335,,,,3313,3313,-22,-22,0,0.00,0
,20170515,3313,3313,,,,3383,3383,70,70,0,0.00,0
,20170516,3383,3383,,,,3337,3337,-46,-46,0,0.00,0
,20170517,3337,3337,,,,3337,3337,0,0,0,0.00,0
,20170518,3337,3337,,,,3350,3350,13,13,0,0.00,0
,20170519,3350,3350,,,,3350,3350,0,0,0,0.00,0
,20170522,3350,3350,,,,3350,3350,0,0,0,0.00,0
,20170523,3350,3350,,,,3350,3350,0,0,0,0.00,0
,20170524,3350,3350,,,,3350,3350,0,0,0,0.00,0
,20170525,3350,3350,,,,3350,3350,0,0,0,0.00,0
,20170526,3350,3350,,,,3350,3350,0,0,0,0.00,0
,20170531,3350,3350,,,,3350,3350,0,0,0,0.00,0
,20170601,3350,3350,,,,3350,3350,0,0,0,0.00,0
,20170602,3350,3350,,,,3350,3350,0,0,0,0.00,0
,20170605,3350,3350,,,,3350,3350,0,0,0,0.00,0
,20170606,3350,3350,,,,3350,3350,0,0,0,0.00,0
,20170607,3350,3350,,,,3350,3350,0,0,0,0.00,0
,20170608,3350,3350,,,,3350,3350,0,0,0,0.00,0
,20170609,3350,3350,,,,3350,3350,0,0,0,0.00,0
,20170612,3350,3350,,,,3350,3350,0,0,0,0.00,0
,20170613,3350,3350,,,,3350,3350,0,0,0,0.00,0
,20170614,3350,3350,,,,3350,3350,0,0,0,0.00,0
,20170615,3350,3350,,,,3350,3350,0,0,0,0.00,0
,20170616,3350,3350,,,,3350,3350,0,0,0,0.00,0
,20170619,3350,3350,,,,3350,3350,0,0,0,0.00,0
,20170620,3350,3350,,,,3350,3350,0,0,0,0.00,0
,20170621,3350,3350,,,,3350,3350,0,0,0,0.00,0
,20170622,3350,3350,,,,3350,3350,0,0,0,0.00,0
,20170623,3350,3350,,,,3350,3350,0,0,0,0.00,0
,20170626,3350,3350,,,,3350,3350,0,0,0,0.00,0
,20170627,3350,3350,,,,3350,3350,0,0,0,0.00,0
,20170628,3350,3350,,,,3350,3350,0,0,0,0.00,0
,20170629,3350,3350,,,,3350,3350,0,0,0,0.00,0
,20170630,3350,3350,,,,3350,3350,0,0,0,0.00,0
,20170703,3350,3350,,,,3182,3182,-168,-168,0,0.00,0
,20170704,3182,3182,,,,3341,3341,159,159,0,0.00,0
,20170705,3341,3341,,,,3273,3273,-68,-68,0,0.00,0
,20170706,3273,3273,,,,3273,3273,0,0,0,0.00,0
,20170707,3273,3273,,,,3273,3273,0,0,0,0.00,0
,20170710,3273,3273,,,,3418,3418,145,145,0,0.00,0
,20170711,3418,3418,,,,3418,3418,0,0,0,0.00,0
,20170712,3418,3418,,,,3499,3499,81,81,0,0.00,0
,20170713,3499,3499,,,,3499,3499,0,0,0,0.00,0
,20170714,3499,3499,,,,3485,3485,-14,-14,0,0.00,0
,20170717,3485,3485,,,,3486,3486,1,1,0,0.00,0
,20170718,3486,3486,,,,3486,3486,0,0,0,0.00,0
,20170719,3486,3486,,,,3486,3486,0,0,0,0.00,0
,20170720,3486,3486,,,,3486,3486,0,0,0,0.00,0
,20170721,3486,3486,,,,3454,3454,-32,-32,0,0.00,0
,20170724,3454,3454,,,,3464,3464,10,10,0,0.00,0
,20170725,3464,3464,,,,3385,3385,-79,-79,0,0.00,0
,20170726,3385,3385,,,,3403,3403,18,18,0,0.00,0
,20170727,3403,3403,,,,3403,3403,0,0,0,0.00,0
,20170728,3403,3403,,,,3403,3403,0,0,0,0.00,0
,20170731,3403,3403,,,,3403,3403,0,0,0,0.00,0
,20170801,3403,3403,,,,3564,3564,161,161,0,0.00,0
,20170802,3564,3564,,,,3741,3741,177,177,0,0.00,0
,20170803,3741,3741,,,,3844,3844,103,103,0,0.00,0
,20170804,3844,3844,,,,3844,3844,0,0,0,0.00,0
,20170807,3844,3844,,,,3844,3844,0,0,0,0.00,0
,20170808,3844,3844,,,,3651,3651,-193,-193,0,0.00,0
,20170809,3651,3651,,,,3666,3666,15,15,0,0.00,0
,20170810,3666,3666,,,,3666,3666,0,0,0,0.00,0
,20170811,3666,3666,,,,3608,3608,-58,-58,0,0.00,0
,20170814,3608,3608,,,,3608,3608,0,0,0,0.00,0
,20170815,3608,3608,,,,3608,3608,0,0,0,0.00,0
,20170816,3608,3608,,,,3520,3520,-88,-88,0,0.00,0
,20170817,3520,3520,,,,3615,3615,95,95,0,0.00,0
,20170818,3615,3615,,,,3791,3791,176,176,0,0.00,0
,20170821,3791,3791,,,,3851,3851,60,60,0,0.00,0
,20170822,3851,3851,,,,3858,3858,7,7,0,0.00,0
,20170823,3858,3858,,,,3858,3858,0,0,0,0.00,0
,20170824,3858,3858,,,,4044,4044,186,186,0,0.00,0
,20170825,4044,4044,,,,4039,4039,-5,-5,0,0.00,0
,20170828,4039,4039,,,,4039,4039,0,0,0,0.00,0
,20170829,4039,4039,,,,4039,4039,0,0,0,0.00,0
,20170830,4039,4039,,,,4039,4039,0,0,0,0.00,0
,20170831,4039,4039,,,,4039,4039,0,0,0,0.00,0
,20170901,4039,4039,,,,4039,4039,0,0,0,0.00,0
,20170904,4039,4039,,,,4039,4039,0,0,0,0.00,0
,20170905,4039,4039,,,,4039,4039,0,0,0,0.00,0
,20170906,4039,4039,,,,4039,4039,0,0,0,0.00,0
,20170907,4039,4039,,,,4039,4039,0,0,0,0.00,0
,20170908,4039,4039,,,,4039,4039,0,0,0,0.00,0
,20170911,4039,4039,,,,4039,4039,0,0,0,0.00,0
,20170912,4039,4039,,,,4039,4039,0,0,0,0.00,0
,20170913,4039,4039,,,,4039,4039,0,0,0,0.00,0
,20170914,4039,4039,,,,4039,4039,0,0,0,0.00,0
,20170915,4039,4039,,,,4039,4039,0,0,0,0.00,0
,20170918,4039,4039,,,,4039,4039,0,0,0,0.00,0
,20170919,4039,4039,,,,4039,4039,0,0,0,0.00,0
,20170920,4039,4039,,,,4039,4039,0,0,0,0.00,0
,20170921,4039,4039,,,,4039,4039,0,0,0,0.00,0
,20170922,4039,4039,,,,4039,4039,0,0,0,0.00,0
,20170925,4039,4039,,,,3870,3870,-169,-169,0,0.00,0
,20170926,3870,3870,,,,3870,3870,0,0,0,0.00,0
,20170927,3870,3870,,,,3870,3870,0,0,0,0.00,0
,20170928,3870,3870,,,,3870,3870,0,0,0,0.00,0
,20170929,3870,3870,,,,3870,3870,0,0,0,0.00,0
,20171009,3870,3870,,,,3870,3870,0,0,0,0.00,0
,20171010,3870,3870,,,,3870,3870,0,0,0,0.00,0
,20171011,3870,3870,,,,3870,3870,0,0,0,0.00,0
,20171012,3870,3870,,,,3870,3870,0,0,0,0.00,0
,20171013,3870,3870,,,,3870,3870,0,0,0,0.00,0
,20171016,3870,3870,,,,3870,3870,0,0,0,0.00,0
,20171017,3870,3870,,,,3870,3870,0,0,0,0.00,0
,20171018,3870,3870,,,,3870,3870,0,0,0,0.00,0
,20171019,3870,3870,,,,3870,3870,0,0,0,0.00,0
,20171020,3870,3870,,,,3870,3870,0,0,0,0.00,0
,20171023,3870,3870,,,,3870,3870,0,0,0,0.00,0
,20171024,3870,3870,,,,3870,3870,0,0,0,0.00,0
,20171025,3870,3870,,,,3870,3870,0,0,0,0.00,0
,20171026,3870,3870,,,,3870,3870,0,0,0,0.00,0
,20171027,3870,3870,,,,3870,3870,0,0,0,0.00,0
,20171030,3870,3870,,,,3870,3870,0,0,0,0.00,0
,20171031,3870,3870,,,,3870,3870,0,0,0,0.00,0
,20171101,3870,3870,,,,3870,3870,0,0,0,0.00,0
,20171102,3870,3870,,,,3870,3870,0,0,0,0.00,0
,20171103,3870,3870,,,,3870,3870,0,0,0,0.00,0
,20171106,3870,3870,,,,3870,3870,0,0,0,0.00,0
,20171107,3870,3870,,,,3870,3870,0,0,0,0.00,0
,20171108,3870,3870,,,,3870,3870,0,0,0,0.00,0
,20171109,3870,3870,,,,3870,3870,0,0,0,0.00,0
,20171110,3870,3870,,,,3870,3870,0,0,0,0.00,0
,20171113,3870,3870,,,,3870,3870,0,0,0,0.00,0
,20171114,3870,3870,,,,3870,3870,0,0,0,0.00,0
,20171115,3870,3870,,,,3870,3870,0,0,0,0.00,0
,20171116,3870,3870,,,,3870,3870,0,0,0,0.00,0
,20171117,3870,3870,,,,3870,3870,0,0,0,0.00,0
,20171120,3870,3870,,,,3870,3870,0,0,0,0.00,0
,20171121,3870,3870,,,,3870,3870,0,0,0,0.00,0
,20171122,3870,3870,,,,3870,3870,0,0,0,0.00,0
,20171123,3870,3870,,,,3870,3870,0,0,0,0.00,0
,20171124,3870,3870,,,,3870,3870,0,0,0,0.00,0
,20171127,3870,3870,,,,3870,3870,0,0,0,0.00,0
,20171128,3870,3870,,,,3870,3870,0,0,0,0.00,0
,20171129,3870,3870,,,,3870,3870,0,0,0,0.00,0
,20171130,3870,3870,,,,3870,3870,0,0,0,0.00,0
,20171201,3870,3870,,,,3870,3870,0,0,0,0.00,0
,20171204,3870,3870,,,,3870,3870,0,0,0,0.00,0
,20171205,3870,3870,,,,3870,3870,0,0,0,0.00,0
,20171206,3870,3870,,,,3870,3870,0,0,0,0.00,0
,20171207,3870,3870,,,,3870,3870,0,0,0,0.00,0
,20171208,3870,3870,,,,3870,3870,0,0,0,0.00,0
,20171211,3870,3870,,,,3870,3870,0,0,0,0.00,0
,20171212,3870,3870,,,,3870,3870,0,0,0,0.00,0
,20171213,3870,3870,,,,3870,3870,0,0,0,0.00,0
,20171214,3870,3870,,,,3870,3870,0,0,0,0.00,0
,20171215,3870,3870,,,,3870,3870,0,0,0,0.00,0
,20171218,3870,3870,,,,3870,3870,0,0,0,0.00,0
,20171219,3870,3870,,,,3870,3870,0,0,0,0.00,0
,20171220,3870,3870,,,,3870,3870,0,0,0,0.00,0
,20171221,3870,3870,,,,3870,3870,0,0,0,0.00,0
,20171222,3870,3870,,,,3870,3870,0,0,0,0.00,0
,20171225,3870,3870,,,,3870,3870,0,0,0,0.00,0
,20171226,3870,3870,,,,3870,3870,0,0,0,0.00,0
,20171227,3870,3870,,,,3870,3870,0,0,0,0.00,0
,20171228,3870,3870,,,,3870,3870,0,0,0,0.00,0
,20171229,3870,3870,,,,3870,3870,0,0,0,0.00,0
fu1803,20170301,3987,3987,,,,3987,3987,0,0,0,0.00,0
,20170302,3987,3987,,,,3987,3987,0,0,0,0.00,0
,20170303,3987,3987,,,,3900,3900,-87,-87,0,0.00,0
,20170306,3900,3900,,,,3900,3900,0,0,0,0.00,0
,20170307,3900,3900,,,,3900,3900,0,0,0,0.00,0
,20170308,3900,3900,,,,3900,3900,0,0,0,0.00,0
,20170309,3900,3900,,,,3900,3900,0,0,0,0.00,0
,20170310,3900,3900,,,,3870,3870,-30,-30,0,0.00,0
,20170313,3870,3870,,,,3870,3870,0,0,0,0.00,0
,20170314,3870,3870,,,,3870,3870,0,0,0,0.00,0
,20170315,3870,3870,,,,3937,3937,67,67,0,0.00,0
,20170316,3937,3937,,,,3937,3937,0,0,0,0.00,0
,20170317,3937,3937,,,,3897,3897,-40,-40,0,0.00,0
,20170320,3897,3897,,,,3897,3897,0,0,0,0.00,0
,20170321,3897,3897,,,,3897,3897,0,0,0,0.00,0
,20170322,3897,3897,,,,3711,3711,-186,-186,0,0.00,0
,20170323,3711,3711,,,,3711,3711,0,0,0,0.00,0
,20170324,3711,3711,,,,3721,3721,10,10,0,0.00,0
,20170327,3721,3721,,,,3721,3721,0,0,0,0.00,0
,20170328,3721,3721,,,,3808,3808,87,87,0,0.00,0
,20170329,3808,3808,,,,3808,3808,0,0,0,0.00,0
,20170330,3808,3808,,,,3808,3808,0,0,0,0.00,0
,20170331,3808,3808,,,,3808,3808,0,0,0,0.00,0
,20170405,3808,3808,,,,3808,3808,0,0,0,0.00,0
,20170406,3808,3808,,,,3808,3808,0,0,0,0.00,0
,20170407,3808,3808,,,,3808,3808,0,0,0,0.00,0
,20170410,3808,3808,,,,3808,3808,0,0,0,0.00,0
,20170411,3808,3808,,,,3808,3808,0,0,0,0.00,0
,20170412,3808,3808,,,,3808,3808,0,0,0,0.00,0
,20170413,3808,3808,,,,3808,3808,0,0,0,0.00,0
,20170414,3808,3808,,,,3808,3808,0,0,0,0.00,0
,20170417,3808,3808,,,,3808,3808,0,0,0,0.00,0
,20170418,3808,3808,,,,3808,3808,0,0,0,0.00,0
,20170419,3808,3808,,,,3808,3808,0,0,0,0.00,0
,20170420,3808,3808,,,,3808,3808,0,0,0,0.00,0
,20170421,3808,3808,,,,3808,3808,0,0,0,0.00,0
,20170424,3808,3808,,,,3808,3808,0,0,0,0.00,0
,20170425,3808,3808,,,,3808,3808,0,0,0,0.00,0
,20170426,3808,3808,,,,3808,3808,0,0,0,0.00,0
,20170427,3808,3808,,,,3808,3808,0,0,0,0.00,0
,20170428,3808,3808,,,,3808,3808,0,0,0,0.00,0
,20170502,3808,3808,,,,3808,3808,0,0,0,0.00,0
,20170503,3808,3808,,,,3808,3808,0,0,0,0.00,0
,20170504,3808,3808,,,,3808,3808,0,0,0,0.00,0
,20170505,3808,3808,,,,3808,3808,0,0,0,0.00,0
,20170508,3808,3808,,,,3808,3808,0,0,0,0.00,0
,20170509,3808,3808,,,,3808,3808,0,0,0,0.00,0
,20170510,3808,3808,,,,3808,3808,0,0,0,0.00,0
,20170511,3808,3808,,,,3808,3808,0,0,0,0.00,0
,20170512,3808,3808,,,,3808,3808,0,0,0,0.00,0
,20170515,3808,3808,,,,3808,3808,0,0,0,0.00,0
,20170516,3808,3808,,,,3808,3808,0,0,0,0.00,0
,20170517,3808,3808,,,,3808,3808,0,0,0,0.00,0
,20170518,3808,3808,,,,3808,3808,0,0,0,0.00,0
,20170519,3808,3808,,,,3808,3808,0,0,0,0.00,0
,20170522,3808,3808,,,,3808,3808,0,0,0,0.00,0
,20170523,3808,3808,,,,3808,3808,0,0,0,0.00,0
,20170524,3808,3808,,,,3808,3808,0,0,0,0.00,0
,20170525,3808,3808,,,,3808,3808,0,0,0,0.00,0
,20170526,3808,3808,,,,3808,3808,0,0,0,0.00,0
,20170531,3808,3808,,,,3808,3808,0,0,0,0.00,0
,20170601,3808,3808,,,,3808,3808,0,0,0,0.00,0
,20170602,3808,3808,,,,3808,3808,0,0,0,0.00,0
,20170605,3808,3808,,,,3808,3808,0,0,0,0.00,0
,20170606,3808,3808,,,,3808,3808,0,0,0,0.00,0
,20170607,3808,3808,,,,3808,3808,0,0,0,0.00,0
,20170608,3808,3808,,,,3808,3808,0,0,0,0.00,0
,20170609,3808,3808,,,,3808,3808,0,0,0,0.00,0
,20170612,3808,3808,,,,3808,3808,0,0,0,0.00,0
,20170613,3808,3808,,,,3808,3808,0,0,0,0.00,0
,20170614,3808,3808,,,,3808,3808,0,0,0,0.00,0
,20170615,3808,3808,,,,3808,3808,0,0,0,0.00,0
,20170616,3808,3808,,,,3808,3808,0,0,0,0.00,0
,20170619,3808,3808,,,,3808,3808,0,0,0,0.00,0
,20170620,3808,3808,,,,3808,3808,0,0,0,0.00,0
,20170621,3808,3808,,,,3808,3808,0,0,0,0.00,0
,20170622,3808,3808,,,,3808,3808,0,0,0,0.00,0
,20170623,3808,3808,,,,3808,3808,0,0,0,0.00,0
,20170626,3808,3808,,,,3808,3808,0,0,0,0.00,0
,20170627,3808,3808,,,,3808,3808,0,0,0,0.00,0
,20170628,3808,3808,,,,3808,3808,0,0,0,0.00,0
,20170629,3808,3808,,,,3808,3808,0,0,0,0.00,0
,20170630,3808,3808,,,,3808,3808,0,0,0,0.00,0
,20170703,3808,3808,,,,3808,3808,0,0,0,0.00,0
,20170704,3808,3808,,,,3808,3808,0,0,0,0.00,0
,20170705,3808,3808,,,,3808,3808,0,0,0,0.00,0
,20170706,3808,3808,,,,3808,3808,0,0,0,0.00,0
,20170707,3808,3808,,,,3808,3808,0,0,0,0.00,0
,20170710,3808,3808,,,,3808,3808,0,0,0,0.00,0
,20170711,3808,3808,,,,3808,3808,0,0,0,0.00,0
,20170712,3808,3808,,,,3808,3808,0,0,0,0.00,0
,20170713,3808,3808,,,,3808,3808,0,0,0,0.00,0
,20170714,3808,3808,,,,3808,3808,0,0,0,0.00,0
,20170717,3808,3808,,,,3808,3808,0,0,0,0.00,0
,20170718,3808,3808,,,,3808,3808,0,0,0,0.00,0
,20170719,3808,3808,,,,3808,3808,0,0,0,0.00,0
,20170720,3808,3808,,,,3808,3808,0,0,0,0.00,0
,20170721,3808,3808,,,,3808,3808,0,0,0,0.00,0
,20170724,3808,3808,,,,3808,3808,0,0,0,0.00,0
,20170725,3808,3808,,,,3808,3808,0,0,0,0.00,0
,20170726,3808,3808,,,,3808,3808,0,0,0,0.00,0
,20170727,3808,3808,,,,3808,3808,0,0,0,0.00,0
,20170728,3808,3808,,,,3808,3808,0,0,0,0.00,0
,20170731,3808,3808,,,,3808,3808,0,0,0,0.00,0
,20170801,3808,3808,,,,3808,3808,0,0,0,0.00,0
,20170802,3808,3808,,,,3808,3808,0,0,0,0.00,0
,20170803,3808,3808,,,,3808,3808,0,0,0,0.00,0
,20170804,3808,3808,,,,3808,3808,0,0,0,0.00,0
,20170807,3808,3808,,,,3808,3808,0,0,0,0.00,0
,20170808,3808,3808,,,,3808,3808,0,0,0,0.00,0
,20170809,3808,3808,,,,3808,3808,0,0,0,0.00,0
,20170810,3808,3808,,,,3808,3808,0,0,0,0.00,0
,20170811,3808,3808,,,,3808,3808,0,0,0,0.00,0
,20170814,3808,3808,,,,3808,3808,0,0,0,0.00,0
,20170815,3808,3808,,,,3808,3808,0,0,0,0.00,0
,20170816,3808,3808,,,,3808,3808,0,0,0,0.00,0
,20170817,3808,3808,,,,3911,3911,103,103,0,0.00,0
,20170818,3911,3911,,,,3911,3911,0,0,0,0.00,0
,20170821,3911,3911,,,,3911,3911,0,0,0,0.00,0
,20170822,3911,3911,,,,3911,3911,0,0,0,0.00,0
,20170823,3911,3911,,,,3911,3911,0,0,0,0.00,0
,20170824,3911,3911,,,,3911,3911,0,0,0,0.00,0
,20170825,3911,3911,,,,3911,3911,0,0,0,0.00,0
,20170828,3911,3911,,,,3911,3911,0,0,0,0.00,0
,20170829,3911,3911,,,,3911,3911,0,0,0,0.00,0
,20170830,3911,3911,,,,3911,3911,0,0,0,0.00,0
,20170831,3911,3911,,,,3911,3911,0,0,0,0.00,0
,20170901,3911,3911,4302,4302,3587,3869,3929,-42,18,10,196.48,0
,20170904,3869,3929,,,,3929,3929,0,0,0,0.00,0
,20170905,3929,3929,,,,3929,3929,0,0,0,0.00,0
,20170906,3929,3929,,,,3929,3929,0,0,0,0.00,0
,20170907,3929,3929,,,,3929,3929,0,0,0,0.00,0
,20170908,3929,3929,,,,3929,3929,0,0,0,0.00,0
,20170911,3929,3929,,,,3929,3929,0,0,0,0.00,0
,20170912,3929,3929,,,,3929,3929,0,0,0,0.00,0
,20170913,3929,3929,,,,3929,3929,0,0,0,0.00,0
,20170914,3929,3929,,,,3929,3929,0,0,0,0.00,0
,20170915,3929,3929,,,,3929,3929,0,0,0,0.00,0
,20170918,3929,3929,,,,3929,3929,0,0,0,0.00,0
,20170919,3929,3929,,,,3929,3929,0,0,0,0.00,0
,20170920,3929,3929,,,,3929,3929,0,0,0,0.00,0
,20170921,3929,3929,,,,3929,3929,0,0,0,0.00,0
,20170922,3929,3929,,,,3929,3929,0,0,0,0.00,0
,20170925,3929,3929,,,,3765,3765,-164,-164,0,0.00,0
,20170926,3765,3765,,,,3765,3765,0,0,0,0.00,0
,20170927,3765,3765,,,,3765,3765,0,0,0,0.00,0
,20170928,3765,3765,,,,3765,3765,0,0,0,0.00,0
,20170929,3765,3765,,,,3765,3765,0,0,0,0.00,0
,20171009,3765,3765,,,,3765,3765,0,0,0,0.00,0
,20171010,3765,3765,,,,3765,3765,0,0,0,0.00,0
,20171011,3765,3765,,,,3765,3765,0,0,0,0.00,0
,20171012,3765,3765,,,,3765,3765,0,0,0,0.00,0
,20171013,3765,3765,,,,3765,3765,0,0,0,0.00,0
,20171016,3765,3765,,,,3765,3765,0,0,0,0.00,0
,20171017,3765,3765,,,,3765,3765,0,0,0,0.00,0
,20171018,3765,3765,,,,3765,3765,0,0,0,0.00,0
,20171019,3765,3765,,,,3765,3765,0,0,0,0.00,0
,20171020,3765,3765,,,,3765,3765,0,0,0,0.00,0
,20171023,3765,3765,,,,3765,3765,0,0,0,0.00,0
,20171024,3765,3765,,,,3765,3765,0,0,0,0.00,0
,20171025,3765,3765,,,,3765,3765,0,0,0,0.00,0
,20171026,3765,3765,,,,3765,3765,0,0,0,0.00,0
,20171027,3765,3765,,,,3765,3765,0,0,0,0.00,0
,20171030,3765,3765,,,,3765,3765,0,0,0,0.00,0
,20171031,3765,3765,,,,3765,3765,0,0,0,0.00,0
,20171101,3765,3765,,,,3765,3765,0,0,0,0.00,0
,20171102,3765,3765,,,,3765,3765,0,0,0,0.00,0
,20171103,3765,3765,,,,3765,3765,0,0,0,0.00,0
,20171106,3765,3765,,,,3765,3765,0,0,0,0.00,0
,20171107,3765,3765,,,,3765,3765,0,0,0,0.00,0
,20171108,3765,3765,,,,3765,3765,0,0,0,0.00,0
,20171109,3765,3765,,,,3765,3765,0,0,0,0.00,0
,20171110,3765,3765,,,,3765,3765,0,0,0,0.00,0
,20171113,3765,3765,,,,3765,3765,0,0,0,0.00,0
,20171114,3765,3765,,,,3765,3765,0,0,0,0.00,0
,20171115,3765,3765,,,,3765,3765,0,0,0,0.00,0
,20171116,3765,3765,,,,3765,3765,0,0,0,0.00,0
,20171117,3765,3765,,,,3765,3765,0,0,0,0.00,0
,20171120,3765,3765,,,,3765,3765,0,0,0,0.00,0
,20171121,3765,3765,,,,3765,3765,0,0,0,0.00,0
,20171122,3765,3765,,,,3765,3765,0,0,0,0.00,0
,20171123,3765,3765,,,,3765,3765,0,0,0,0.00,0
,20171124,3765,3765,,,,3765,3765,0,0,0,0.00,0
,20171127,3765,3765,,,,3765,3765,0,0,0,0.00,0
,20171128,3765,3765,,,,3765,3765,0,0,0,0.00,0
,20171129,3765,3765,,,,3765,3765,0,0,0,0.00,0
,20171130,3765,3765,,,,3765,3765,0,0,0,0.00,0
,20171201,3765,3765,,,,3765,3765,0,0,0,0.00,0
,20171204,3765,3765,,,,3765,3765,0,0,0,0.00,0
,20171205,3765,3765,,,,3765,3765,0,0,0,0.00,0
,20171206,3765,3765,,,,3765,3765,0,0,0,0.00,0
,20171207,3765,3765,,,,3765,3765,0,0,0,0.00,0
,20171208,3765,3765,,,,3765,3765,0,0,0,0.00,0
,20171211,3765,3765,,,,3765,3765,0,0,0,0.00,0
,20171212,3765,3765,,,,3765,3765,0,0,0,0.00,0
,20171213,3765,3765,,,,3765,3765,0,0,0,0.00,0
,20171214,3765,3765,,,,3765,3765,0,0,0,0.00,0
,20171215,3765,3765,,,,3765,3765,0,0,0,0.00,0
,20171218,3765,3765,,,,3765,3765,0,0,0,0.00,0
,20171219,3765,3765,,,,3765,3765,0,0,0,0.00,0
,20171220,3765,3765,,,,3765,3765,0,0,0,0.00,0
,20171221,3765,3765,,,,3765,3765,0,0,0,0.00,0
,20171222,3765,3765,,,,3765,3765,0,0,0,0.00,0
,20171225,3765,3765,,,,3765,3765,0,0,0,0.00,0
,20171226,3765,3765,,,,3765,3765,0,0,0,0.00,0
,20171227,3765,3765,,,,3765,3765,0,0,0,0.00,0
,20171228,3765,3765,,,,3765,3765,0,0,0,0.00,0
,20171229,3765,3765,,,,3765,3765,0,0,0,0.00,0
fu1804,20170405,3808,3808,,,,3808,3808,0,0,0,0.00,0
,20170406,3808,3808,,,,3808,3808,0,0,0,0.00,0
,20170407,3808,3808,,,,3808,3808,0,0,0,0.00,0
,20170410,3808,3808,,,,3808,3808,0,0,0,0.00,0
,20170411,3808,3808,,,,3808,3808,0,0,0,0.00,0
,20170412,3808,3808,,,,3808,3808,0,0,0,0.00,0
,20170413,3808,3808,,,,3808,3808,0,0,0,0.00,0
,20170414,3808,3808,,,,3808,3808,0,0,0,0.00,0
,20170417,3808,3808,,,,3808,3808,0,0,0,0.00,0
,20170418,3808,3808,,,,3808,3808,0,0,0,0.00,0
,20170419,3808,3808,,,,3808,3808,0,0,0,0.00,0
,20170420,3808,3808,,,,3808,3808,0,0,0,0.00,0
,20170421,3808,3808,,,,3808,3808,0,0,0,0.00,0
,20170424,3808,3808,,,,3808,3808,0,0,0,0.00,0
,20170425,3808,3808,,,,3808,3808,0,0,0,0.00,0
,20170426,3808,3808,,,,3808,3808,0,0,0,0.00,0
,20170427,3808,3808,,,,3808,3808,0,0,0,0.00,0
,20170428,3808,3808,,,,3808,3808,0,0,0,0.00,0
,20170502,3808,3808,,,,3808,3808,0,0,0,0.00,0
,20170503,3808,3808,,,,3808,3808,0,0,0,0.00,0
,20170504,3808,3808,,,,3808,3808,0,0,0,0.00,0
,20170505,3808,3808,,,,3808,3808,0,0,0,0.00,0
,20170508,3808,3808,,,,3808,3808,0,0,0,0.00,0
,20170509,3808,3808,,,,3808,3808,0,0,0,0.00,0
,20170510,3808,3808,,,,3808,3808,0,0,0,0.00,0
,20170511,3808,3808,,,,3808,3808,0,0,0,0.00,0
,20170512,3808,3808,,,,3808,3808,0,0,0,0.00,0
,20170515,3808,3808,,,,3808,3808,0,0,0,0.00,0
,20170516,3808,3808,,,,3808,3808,0,0,0,0.00,0
,20170517,3808,3808,,,,3808,3808,0,0,0,0.00,0
,20170518,3808,3808,,,,3808,3808,0,0,0,0.00,0
,20170519,3808,3808,,,,3808,3808,0,0,0,0.00,0
,20170522,3808,3808,,,,3808,3808,0,0,0,0.00,0
,20170523,3808,3808,,,,3808,3808,0,0,0,0.00,0
,20170524,3808,3808,,,,3808,3808,0,0,0,0.00,0
,20170525,3808,3808,,,,3808,3808,0,0,0,0.00,0
,20170526,3808,3808,4188,4188,4188,4188,4188,380,380,2,41.88,2
,20170531,4188,4188,,,,3978,3978,-210,-210,0,0.00,2
,20170601,3978,3978,3779,4174,3779,3829,4010,-149,32,46,922.48,2
,20170602,3829,4010,,,,4010,4010,0,0,0,0.00,2
,20170605,4010,4010,,,,4010,4010,0,0,0,0.00,2
,20170606,4010,4010,,,,4010,4010,0,0,0,0.00,2
,20170607,4010,4010,,,,4010,4010,0,0,0,0.00,2
,20170608,4010,4010,,,,4010,4010,0,0,0,0.00,2
,20170609,4010,4010,,,,4010,4010,0,0,0,0.00,2
,20170612,4010,4010,,,,4010,4010,0,0,0,0.00,2
,20170613,4010,4010,,,,4010,4010,0,0,0,0.00,2
,20170614,4010,4010,4199,4199,3830,3911,3919,-99,-91,14,274.33,4
,20170615,3911,3919,3730,4023,3730,3987,3902,68,-17,20,390.27,4
,20170616,3987,3902,3717,3999,3717,3864,3906,-38,4,10,195.30,2
,20170619,3864,3906,4079,4079,4079,4079,4079,173,173,2,40.79,2
,20170620,4079,4079,3903,3903,3903,3903,3903,-176,-176,2,39.03,0
,20170621,3903,3903,4049,4049,3847,3847,3963,-56,60,10,198.16,2
,20170622,3847,3963,,,,3963,3963,0,0,0,0.00,2
,20170623,3963,3963,3773,3783,3773,3783,3778,-180,-185,4,75.56,2
,20170626,3783,3778,,,,3778,3778,0,0,0,0.00,2
,20170627,3778,3778,3790,3790,3790,3790,3790,12,12,2,37.90,0
,20170628,3790,3790,,,,3790,3790,0,0,0,0.00,0
,20170629,3790,3790,,,,3790,3790,0,0,0,0.00,0
,20170630,3790,3790,,,,3790,3790,0,0,0,0.00,0
,20170703,3790,3790,,,,3790,3790,0,0,0,0.00,0
,20170704,3790,3790,,,,3790,3790,0,0,0,0.00,0
,20170705,3790,3790,,,,3790,3790,0,0,0,0.00,0
,20170706,3790,3790,,,,3790,3790,0,0,0,0.00,0
,20170707,3790,3790,,,,3790,3790,0,0,0,0.00,0
,20170710,3790,3790,,,,3790,3790,0,0,0,0.00,0
,20170711,3790,3790,,,,3790,3790,0,0,0,0.00,0
,20170712,3790,3790,,,,3790,3790,0,0,0,0.00,0
,20170713,3790,3790,,,,3790,3790,0,0,0,0.00,0
,20170714,3790,3790,,,,3790,3790,0,0,0,0.00,0
,20170717,3790,3790,,,,3790,3790,0,0,0,0.00,0
,20170718,3790,3790,,,,3790,3790,0,0,0,0.00,0
,20170719,3790,3790,,,,3790,3790,0,0,0,0.00,0
,20170720,3790,3790,,,,3790,3790,0,0,0,0.00,0
,20170721,3790,3790,,,,3790,3790,0,0,0,0.00,0
,20170724,3790,3790,,,,3790,3790,0,0,0,0.00,0
,20170725,3790,3790,,,,3790,3790,0,0,0,0.00,0
,20170726,3790,3790,,,,3790,3790,0,0,0,0.00,0
,20170727,3790,3790,,,,3790,3790,0,0,0,0.00,0
,20170728,3790,3790,,,,3790,3790,0,0,0,0.00,0
,20170731,3790,3790,,,,3790,3790,0,0,0,0.00,0
,20170801,3790,3790,,,,3790,3790,0,0,0,0.00,0
,20170802,3790,3790,,,,3978,3978,188,188,0,0.00,0
,20170803,3978,3978,,,,4088,4088,110,110,0,0.00,0
,20170804,4088,4088,,,,4100,4100,12,12,0,0.00,0
,20170807,4100,4100,,,,4079,4079,-21,-21,0,0.00,0
,20170808,4079,4079,,,,3875,3875,-204,-204,0,0.00,0
,20170809,3875,3875,,,,3875,3875,0,0,0,0.00,0
,20170810,3875,3875,,,,4068,4068,193,193,0,0.00,0
,20170811,4068,4068,,,,4004,4004,-64,-64,0,0.00,0
,20170814,4004,4004,,,,4004,4004,0,0,0,0.00,0
,20170815,4004,4004,,,,4004,4004,0,0,0,0.00,0
,20170816,4004,4004,,,,3907,3907,-97,-97,0,0.00,0
,20170817,3907,3907,,,,4012,4012,105,105,0,0.00,0
,20170818,4012,4012,,,,4208,4208,196,196,0,0.00,0
,20170821,4208,4208,,,,4275,4275,67,67,0,0.00,0
,20170822,4275,4275,,,,4283,4283,8,8,0,0.00,0
,20170823,4283,4283,,,,4283,4283,0,0,0,0.00,0
,20170824,4283,4283,,,,4490,4490,207,207,0,0.00,0
,20170825,4490,4490,,,,4484,4484,-6,-6,0,0.00,0
,20170828,4484,4484,,,,4484,4484,0,0,0,0.00,0
,20170829,4484,4484,,,,4484,4484,0,0,0,0.00,0
,20170830,4484,4484,,,,4484,4484,0,0,0,0.00,0
,20170831,4484,4484,,,,4484,4484,0,0,0,0.00,0
,20170901,4484,4484,,,,4505,4505,21,21,0,0.00,0
,20170904,4505,4505,,,,4505,4505,0,0,0,0.00,0
,20170905,4505,4505,,,,4505,4505,0,0,0,0.00,0
,20170906,4505,4505,,,,4505,4505,0,0,0,0.00,0
,20170907,4505,4505,,,,4505,4505,0,0,0,0.00,0
,20170908,4505,4505,,,,4505,4505,0,0,0,0.00,0
,20170911,4505,4505,,,,4505,4505,0,0,0,0.00,0
,20170912,4505,4505,,,,4505,4505,0,0,0,0.00,0
,20170913,4505,4505,,,,4505,4505,0,0,0,0.00,0
,20170914,4505,4505,,,,4505,4505,0,0,0,0.00,0
,20170915,4505,4505,,,,4505,4505,0,0,0,0.00,0
,20170918,4505,4505,,,,4505,4505,0,0,0,0.00,0
,20170919,4505,4505,,,,4505,4505,0,0,0,0.00,0
,20170920,4505,4505,,,,4505,4505,0,0,0,0.00,0
,20170921,4505,4505,,,,4505,4505,0,0,0,0.00,0
,20170922,4505,4505,,,,4505,4505,0,0,0,0.00,0
,20170925,4505,4505,,,,4317,4317,-188,-188,0,0.00,0
,20170926,4317,4317,,,,4317,4317,0,0,0,0.00,0
,20170927,4317,4317,,,,4317,4317,0,0,0,0.00,0
,20170928,4317,4317,,,,4317,4317,0,0,0,0.00,0
,20170929,4317,4317,,,,4317,4317,0,0,0,0.00,0
,20171009,4317,4317,,,,4317,4317,0,0,0,0.00,0
,20171010,4317,4317,,,,4317,4317,0,0,0,0.00,0
,20171011,4317,4317,,,,4317,4317,0,0,0,0.00,0
,20171012,4317,4317,,,,4317,4317,0,0,0,0.00,0
,20171013,4317,4317,,,,4317,4317,0,0,0,0.00,0
,20171016,4317,4317,,,,4317,4317,0,0,0,0.00,0
,20171017,4317,4317,,,,4317,4317,0,0,0,0.00,0
,20171018,4317,4317,,,,4317,4317,0,0,0,0.00,0
,20171019,4317,4317,,,,4317,4317,0,0,0,0.00,0
,20171020,4317,4317,,,,4317,4317,0,0,0,0.00,0
,20171023,4317,4317,,,,4317,4317,0,0,0,0.00,0
,20171024,4317,4317,,,,4317,4317,0,0,0,0.00,0
,20171025,4317,4317,,,,4317,4317,0,0,0,0.00,0
,20171026,4317,4317,,,,4317,4317,0,0,0,0.00,0
,20171027,4317,4317,,,,4317,4317,0,0,0,0.00,0
,20171030,4317,4317,,,,4317,4317,0,0,0,0.00,0
,20171031,4317,4317,,,,4317,4317,0,0,0,0.00,0
,20171101,4317,4317,,,,4317,4317,0,0,0,0.00,0
,20171102,4317,4317,,,,4317,4317,0,0,0,0.00,0
,20171103,4317,4317,,,,4317,4317,0,0,0,0.00,0
,20171106,4317,4317,,,,4317,4317,0,0,0,0.00,0
,20171107,4317,4317,,,,4317,4317,0,0,0,0.00,0
,20171108,4317,4317,,,,4317,4317,0,0,0,0.00,0
,20171109,4317,4317,,,,4317,4317,0,0,0,0.00,0
,20171110,4317,4317,,,,4317,4317,0,0,0,0.00,0
,20171113,4317,4317,,,,4317,4317,0,0,0,0.00,0
,20171114,4317,4317,,,,4317,4317,0,0,0,0.00,0
,20171115,4317,4317,,,,4317,4317,0,0,0,0.00,0
,20171116,4317,4317,,,,4317,4317,0,0,0,0.00,0
,20171117,4317,4317,,,,4317,4317,0,0,0,0.00,0
,20171120,4317,4317,,,,4317,4317,0,0,0,0.00,0
,20171121,4317,4317,,,,4317,4317,0,0,0,0.00,0
,20171122,4317,4317,,,,4317,4317,0,0,0,0.00,0
,20171123,4317,4317,,,,4317,4317,0,0,0,0.00,0
,20171124,4317,4317,,,,4317,4317,0,0,0,0.00,0
,20171127,4317,4317,,,,4317,4317,0,0,0,0.00,0
,20171128,4317,4317,,,,4317,4317,0,0,0,0.00,0
,20171129,4317,4317,,,,4317,4317,0,0,0,0.00,0
,20171130,4317,4317,,,,4317,4317,0,0,0,0.00,0
,20171201,4317,4317,,,,4317,4317,0,0,0,0.00,0
,20171204,4317,4317,,,,4317,4317,0,0,0,0.00,0
,20171205,4317,4317,,,,4317,4317,0,0,0,0.00,0
,20171206,4317,4317,,,,4317,4317,0,0,0,0.00,0
,20171207,4317,4317,,,,4317,4317,0,0,0,0.00,0
,20171208,4317,4317,,,,4317,4317,0,0,0,0.00,0
,20171211,4317,4317,,,,4317,4317,0,0,0,0.00,0
,20171212,4317,4317,,,,4317,4317,0,0,0,0.00,0
,20171213,4317,4317,,,,4317,4317,0,0,0,0.00,0
,20171214,4317,4317,,,,4317,4317,0,0,0,0.00,0
,20171215,4317,4317,,,,4317,4317,0,0,0,0.00,0
,20171218,4317,4317,,,,4317,4317,0,0,0,0.00,0
,20171219,4317,4317,,,,4317,4317,0,0,0,0.00,0
,20171220,4317,4317,,,,4317,4317,0,0,0,0.00,0
,20171221,4317,4317,,,,4317,4317,0,0,0,0.00,0
,20171222,4317,4317,,,,4317,4317,0,0,0,0.00,0
,20171225,4317,4317,,,,4317,4317,0,0,0,0.00,0
,20171226,4317,4317,,,,4317,4317,0,0,0,0.00,0
,20171227,4317,4317,,,,4317,4317,0,0,0,0.00,0
,20171228,4317,4317,,,,4317,4317,0,0,0,0.00,0
,20171229,4317,4317,,,,4317,4317,0,0,0,0.00,0
fu1805,20170502,3808,3808,,,,3808,3808,0,0,0,0.00,0
,20170503,3808,3808,,,,3808,3808,0,0,0,0.00,0
,20170504,3808,3808,,,,3808,3808,0,0,0,0.00,0
,20170505,3808,3808,,,,3808,3808,0,0,0,0.00,0
,20170508,3808,3808,,,,3808,3808,0,0,0,0.00,0
,20170509,3808,3808,,,,3808,3808,0,0,0,0.00,0
,20170510,3808,3808,,,,3808,3808,0,0,0,0.00,0
,20170511,3808,3808,,,,3808,3808,0,0,0,0.00,0
,20170512,3808,3808,,,,3808,3808,0,0,0,0.00,0
,20170515,3808,3808,,,,3808,3808,0,0,0,0.00,0
,20170516,3808,3808,,,,3808,3808,0,0,0,0.00,0
,20170517,3808,3808,,,,3808,3808,0,0,0,0.00,0
,20170518,3808,3808,,,,3808,3808,0,0,0,0.00,0
,20170519,3808,3808,,,,3808,3808,0,0,0,0.00,0
,20170522,3808,3808,,,,3808,3808,0,0,0,0.00,0
,20170523,3808,3808,,,,3808,3808,0,0,0,0.00,0
,20170524,3808,3808,,,,3808,3808,0,0,0,0.00,0
,20170525,3808,3808,,,,3808,3808,0,0,0,0.00,0
,20170526,3808,3808,,,,3808,3808,0,0,0,0.00,0
,20170531,3808,3808,,,,3808,3808,0,0,0,0.00,0
,20170601,3808,3808,,,,3808,3808,0,0,0,0.00,0
,20170602,3808,3808,,,,3808,3808,0,0,0,0.00,0
,20170605,3808,3808,,,,3808,3808,0,0,0,0.00,0
,20170606,3808,3808,,,,3808,3808,0,0,0,0.00,0
,20170607,3808,3808,,,,3808,3808,0,0,0,0.00,0
,20170608,3808,3808,,,,3808,3808,0,0,0,0.00,0
,20170609,3808,3808,,,,3808,3808,0,0,0,0.00,0
,20170612,3808,3808,,,,3808,3808,0,0,0,0.00,0
,20170613,3808,3808,,,,3808,3808,0,0,0,0.00,0
,20170614,3808,3808,,,,3808,3808,0,0,0,0.00,0
,20170615,3808,3808,,,,3808,3808,0,0,0,0.00,0
,20170616,3808,3808,,,,3808,3808,0,0,0,0.00,0
,20170619,3808,3808,,,,3808,3808,0,0,0,0.00,0
,20170620,3808,3808,,,,3808,3808,0,0,0,0.00,0
,20170621,3808,3808,,,,3808,3808,0,0,0,0.00,0
,20170622,3808,3808,,,,3808,3808,0,0,0,0.00,0
,20170623,3808,3808,,,,3808,3808,0,0,0,0.00,0
,20170626,3808,3808,,,,3808,3808,0,0,0,0.00,0
,20170627,3808,3808,,,,3808,3808,0,0,0,0.00,0
,20170628,3808,3808,,,,3808,3808,0,0,0,0.00,0
,20170629,3808,3808,,,,3808,3808,0,0,0,0.00,0
,20170630,3808,3808,,,,3808,3808,0,0,0,0.00,0
,20170703,3808,3808,,,,3808,3808,0,0,0,0.00,0
,20170704,3808,3808,,,,3808,3808,0,0,0,0.00,0
,20170705,3808,3808,,,,3808,3808,0,0,0,0.00,0
,20170706,3808,3808,,,,3808,3808,0,0,0,0.00,0
,20170707,3808,3808,,,,3808,3808,0,0,0,0.00,0
,20170710,3808,3808,,,,3808,3808,0,0,0,0.00,0
,20170711,3808,3808,,,,3808,3808,0,0,0,0.00,0
,20170712,3808,3808,,,,3808,3808,0,0,0,0.00,0
,20170713,3808,3808,,,,3808,3808,0,0,0,0.00,0
,20170714,3808,3808,,,,3808,3808,0,0,0,0.00,0
,20170717,3808,3808,,,,3808,3808,0,0,0,0.00,0
,20170718,3808,3808,,,,3808,3808,0,0,0,0.00,0
,20170719,3808,3808,,,,3808,3808,0,0,0,0.00,0
,20170720,3808,3808,,,,3808,3808,0,0,0,0.00,0
,20170721,3808,3808,,,,3808,3808,0,0,0,0.00,0
,20170724,3808,3808,,,,3808,3808,0,0,0,0.00,0
,20170725,3808,3808,,,,3808,3808,0,0,0,0.00,0
,20170726,3808,3808,,,,3808,3808,0,0,0,0.00,0
,20170727,3808,3808,,,,3808,3808,0,0,0,0.00,0
,20170728,3808,3808,,,,3808,3808,0,0,0,0.00,0
,20170731,3808,3808,,,,3808,3808,0,0,0,0.00,0
,20170801,3808,3808,,,,3808,3808,0,0,0,0.00,0
,20170802,3808,3808,4188,4188,3473,3473,3830,-335,22,4,76.61,0
,20170803,3473,3830,,,,3830,3830,0,0,0,0.00,0
,20170804,3830,3830,,,,3830,3830,0,0,0,0.00,0
,20170807,3830,3830,,,,3830,3830,0,0,0,0.00,0
,20170808,3830,3830,,,,3638,3638,-192,-192,0,0.00,0
,20170809,3638,3638,,,,3653,3653,15,15,0,0.00,0
,20170810,3653,3653,,,,3835,3835,182,182,0,0.00,0
,20170811,3835,3835,,,,3835,3835,0,0,0,0.00,0
,20170814,3835,3835,,,,3835,3835,0,0,0,0.00,0
,20170815,3835,3835,,,,3835,3835,0,0,0,0.00,0
,20170816,3835,3835,,,,3835,3835,0,0,0,0.00,0
,20170817,3835,3835,,,,3938,3938,103,103,0,0.00,0
,20170818,3938,3938,,,,3938,3938,0,0,0,0.00,0
,20170821,3938,3938,,,,3938,3938,0,0,0,0.00,0
,20170822,3938,3938,,,,3938,3938,0,0,0,0.00,0
,20170823,3938,3938,,,,3938,3938,0,0,0,0.00,0
,20170824,3938,3938,,,,3938,3938,0,0,0,0.00,0
,20170825,3938,3938,,,,3938,3938,0,0,0,0.00,0
,20170828,3938,3938,,,,3938,3938,0,0,0,0.00,0
,20170829,3938,3938,,,,3938,3938,0,0,0,0.00,0
,20170830,3938,3938,,,,3938,3938,0,0,0,0.00,0
,20170831,3938,3938,,,,3938,3938,0,0,0,0.00,0
,20170901,3938,3938,,,,3956,3956,18,18,0,0.00,0
,20170904,3956,3956,,,,3956,3956,0,0,0,0.00,0
,20170905,3956,3956,,,,3956,3956,0,0,0,0.00,0
,20170906,3956,3956,,,,3956,3956,0,0,0,0.00,0
,20170907,3956,3956,,,,3956,3956,0,0,0,0.00,0
,20170908,3956,3956,,,,3956,3956,0,0,0,0.00,0
,20170911,3956,3956,,,,3956,3956,0,0,0,0.00,0
,20170912,3956,3956,,,,3956,3956,0,0,0,0.00,0
,20170913,3956,3956,,,,3956,3956,0,0,0,0.00,0
,20170914,3956,3956,,,,3956,3956,0,0,0,0.00,0
,20170915,3956,3956,,,,3956,3956,0,0,0,0.00,0
,20170918,3956,3956,,,,3956,3956,0,0,0,0.00,0
,20170919,3956,3956,,,,3956,3956,0,0,0,0.00,0
,20170920,3956,3956,,,,3956,3956,0,0,0,0.00,0
,20170921,3956,3956,,,,3956,3956,0,0,0,0.00,0
,20170922,3956,3956,,,,3956,3956,0,0,0,0.00,0
,20170925,3956,3956,,,,3791,3791,-165,-165,0,0.00,0
,20170926,3791,3791,,,,3791,3791,0,0,0,0.00,0
,20170927,3791,3791,,,,3791,3791,0,0,0,0.00,0
,20170928,3791,3791,,,,3791,3791,0,0,0,0.00,0
,20170929,3791,3791,,,,3791,3791,0,0,0,0.00,0
,20171009,3791,3791,,,,3791,3791,0,0,0,0.00,0
,20171010,3791,3791,,,,3791,3791,0,0,0,0.00,0
,20171011,3791,3791,,,,3791,3791,0,0,0,0.00,0
,20171012,3791,3791,,,,3791,3791,0,0,0,0.00,0
,20171013,3791,3791,,,,3791,3791,0,0,0,0.00,0
,20171016,3791,3791,,,,3791,3791,0,0,0,0.00,0
,20171017,3791,3791,,,,3791,3791,0,0,0,0.00,0
,20171018,3791,3791,,,,3791,3791,0,0,0,0.00,0
,20171019,3791,3791,,,,3791,3791,0,0,0,0.00,0
,20171020,3791,3791,,,,3791,3791,0,0,0,0.00,0
,20171023,3791,3791,,,,3791,3791,0,0,0,0.00,0
,20171024,3791,3791,,,,3791,3791,0,0,0,0.00,0
,20171025,3791,3791,,,,3791,3791,0,0,0,0.00,0
,20171026,3791,3791,,,,3791,3791,0,0,0,0.00,0
,20171027,3791,3791,,,,3791,3791,0,0,0,0.00,0
,20171030,3791,3791,,,,3791,3791,0,0,0,0.00,0
,20171031,3791,3791,,,,3791,3791,0,0,0,0.00,0
,20171101,3791,3791,,,,3791,3791,0,0,0,0.00,0
,20171102,3791,3791,,,,3791,3791,0,0,0,0.00,0
,20171103,3791,3791,,,,3791,3791,0,0,0,0.00,0
,20171106,3791,3791,,,,3791,3791,0,0,0,0.00,0
,20171107,3791,3791,,,,3791,3791,0,0,0,0.00,0
,20171108,3791,3791,,,,3791,3791,0,0,0,0.00,0
,20171109,3791,3791,,,,3791,3791,0,0,0,0.00,0
,20171110,3791,3791,,,,3791,3791,0,0,0,0.00,0
,20171113,3791,3791,,,,3791,3791,0,0,0,0.00,0
,20171114,3791,3791,,,,3791,3791,0,0,0,0.00,0
,20171115,3791,3791,,,,3791,3791,0,0,0,0.00,0
,20171116,3791,3791,,,,3791,3791,0,0,0,0.00,0
,20171117,3791,3791,,,,3791,3791,0,0,0,0.00,0
,20171120,3791,3791,,,,3791,3791,0,0,0,0.00,0
,20171121,3791,3791,,,,3791,3791,0,0,0,0.00,0
,20171122,3791,3791,,,,3791,3791,0,0,0,0.00,0
,20171123,3791,3791,,,,3791,3791,0,0,0,0.00,0
,20171124,3791,3791,,,,3791,3791,0,0,0,0.00,0
,20171127,3791,3791,,,,3791,3791,0,0,0,0.00,0
,20171128,3791,3791,,,,3791,3791,0,0,0,0.00,0
,20171129,3791,3791,,,,3791,3791,0,0,0,0.00,0
,20171130,3791,3791,,,,3791,3791,0,0,0,0.00,0
,20171201,3791,3791,,,,3791,3791,0,0,0,0.00,0
,20171204,3791,3791,,,,3791,3791,0,0,0,0.00,0
,20171205,3791,3791,,,,3791,3791,0,0,0,0.00,0
,20171206,3791,3791,,,,3791,3791,0,0,0,0.00,0
,20171207,3791,3791,,,,3791,3791,0,0,0,0.00,0
,20171208,3791,3791,,,,3791,3791,0,0,0,0.00,0
,20171211,3791,3791,,,,3791,3791,0,0,0,0.00,0
,20171212,3791,3791,,,,3791,3791,0,0,0,0.00,0
,20171213,3791,3791,,,,3791,3791,0,0,0,0.00,0
,20171214,3791,3791,,,,3791,3791,0,0,0,0.00,0
,20171215,3791,3791,,,,3791,3791,0,0,0,0.00,0
,20171218,3791,3791,,,,3791,3791,0,0,0,0.00,0
,20171219,3791,3791,,,,3791,3791,0,0,0,0.00,0
,20171220,3791,3791,,,,3791,3791,0,0,0,0.00,0
,20171221,3791,3791,,,,3791,3791,0,0,0,0.00,0
,20171222,3791,3791,,,,3791,3791,0,0,0,0.00,0
,20171225,3791,3791,,,,3791,3791,0,0,0,0.00,0
,20171226,3791,3791,,,,3791,3791,0,0,0,0.00,0
,20171227,3791,3791,,,,3791,3791,0,0,0,0.00,0
,20171228,3791,3791,,,,3791,3791,0,0,0,0.00,0
,20171229,3791,3791,,,,3791,3791,0,0,0,0.00,0
fu1806,20170601,3808,3808,,,,3808,3808,0,0,0,0.00,0
,20170602,3808,3808,,,,3808,3808,0,0,0,0.00,0
,20170605,3808,3808,,,,3808,3808,0,0,0,0.00,0
,20170606,3808,3808,,,,3808,3808,0,0,0,0.00,0
,20170607,3808,3808,,,,3808,3808,0,0,0,0.00,0
,20170608,3808,3808,,,,3808,3808,0,0,0,0.00,0
,20170609,3808,3808,,,,3808,3808,0,0,0,0.00,0
,20170612,3808,3808,,,,3808,3808,0,0,0,0.00,0
,20170613,3808,3808,,,,3808,3808,0,0,0,0.00,0
,20170614,3808,3808,,,,3808,3808,0,0,0,0.00,0
,20170615,3808,3808,,,,3808,3808,0,0,0,0.00,0
,20170616,3808,3808,,,,3808,3808,0,0,0,0.00,0
,20170619,3808,3808,,,,3808,3808,0,0,0,0.00,0
,20170620,3808,3808,,,,3808,3808,0,0,0,0.00,0
,20170621,3808,3808,,,,3808,3808,0,0,0,0.00,0
,20170622,3808,3808,,,,3808,3808,0,0,0,0.00,0
,20170623,3808,3808,,,,3808,3808,0,0,0,0.00,0
,20170626,3808,3808,,,,3808,3808,0,0,0,0.00,0
,20170627,3808,3808,,,,3808,3808,0,0,0,0.00,0
,20170628,3808,3808,,,,3808,3808,0,0,0,0.00,0
,20170629,3808,3808,,,,3808,3808,0,0,0,0.00,0
,20170630,3808,3808,,,,3808,3808,0,0,0,0.00,0
,20170703,3808,3808,,,,3808,3808,0,0,0,0.00,0
,20170704,3808,3808,,,,3808,3808,0,0,0,0.00,0
,20170705,3808,3808,,,,3808,3808,0,0,0,0.00,0
,20170706,3808,3808,,,,3808,3808,0,0,0,0.00,0
,20170707,3808,3808,,,,3808,3808,0,0,0,0.00,0
,20170710,3808,3808,,,,3808,3808,0,0,0,0.00,0
,20170711,3808,3808,,,,3808,3808,0,0,0,0.00,0
,20170712,3808,3808,,,,3808,3808,0,0,0,0.00,0
,20170713,3808,3808,,,,3808,3808,0,0,0,0.00,0
,20170714,3808,3808,,,,3808,3808,0,0,0,0.00,0
,20170717,3808,3808,,,,3808,3808,0,0,0,0.00,0
,20170718,3808,3808,,,,3808,3808,0,0,0,0.00,0
,20170719,3808,3808,,,,3808,3808,0,0,0,0.00,0
,20170720,3808,3808,,,,3808,3808,0,0,0,0.00,0
,20170721,3808,3808,,,,3808,3808,0,0,0,0.00,0
,20170724,3808,3808,,,,3808,3808,0,0,0,0.00,0
,20170725,3808,3808,,,,3808,3808,0,0,0,0.00,0
,20170726,3808,3808,,,,3808,3808,0,0,0,0.00,0
,20170727,3808,3808,,,,3808,3808,0,0,0,0.00,0
,20170728,3808,3808,,,,3808,3808,0,0,0,0.00,0
,20170731,3808,3808,,,,3808,3808,0,0,0,0.00,0
,20170801,3808,3808,,,,3808,3808,0,0,0,0.00,0
,20170802,3808,3808,,,,3808,3808,0,0,0,0.00,0
,20170803,3808,3808,,,,3808,3808,0,0,0,0.00,0
,20170804,3808,3808,,,,3808,3808,0,0,0,0.00,0
,20170807,3808,3808,,,,3808,3808,0,0,0,0.00,0
,20170808,3808,3808,,,,3808,3808,0,0,0,0.00,0
,20170809,3808,3808,,,,3808,3808,0,0,0,0.00,0
,20170810,3808,3808,,,,3808,3808,0,0,0,0.00,0
,20170811,3808,3808,,,,3808,3808,0,0,0,0.00,0
,20170814,3808,3808,,,,3808,3808,0,0,0,0.00,0
,20170815,3808,3808,,,,3808,3808,0,0,0,0.00,0
,20170816,3808,3808,,,,3808,3808,0,0,0,0.00,0
,20170817,3808,3808,,,,3911,3911,103,103,0,0.00,0
,20170818,3911,3911,,,,3911,3911,0,0,0,0.00,0
,20170821,3911,3911,,,,3911,3911,0,0,0,0.00,0
,20170822,3911,3911,,,,3911,3911,0,0,0,0.00,0
,20170823,3911,3911,,,,3911,3911,0,0,0,0.00,0
,20170824,3911,3911,,,,3911,3911,0,0,0,0.00,0
,20170825,3911,3911,,,,3911,3911,0,0,0,0.00,0
,20170828,3911,3911,,,,3911,3911,0,0,0,0.00,0
,20170829,3911,3911,,,,3911,3911,0,0,0,0.00,0
,20170830,3911,3911,,,,3911,3911,0,0,0,0.00,0
,20170831,3911,3911,,,,3911,3911,0,0,0,0.00,0
,20170901,3911,3911,,,,3929,3929,18,18,0,0.00,0
,20170904,3929,3929,,,,3929,3929,0,0,0,0.00,0
,20170905,3929,3929,,,,3929,3929,0,0,0,0.00,0
,20170906,3929,3929,,,,3929,3929,0,0,0,0.00,0
,20170907,3929,3929,,,,3929,3929,0,0,0,0.00,0
,20170908,3929,3929,,,,3929,3929,0,0,0,0.00,0
,20170911,3929,3929,,,,3929,3929,0,0,0,0.00,0
,20170912,3929,3929,,,,3929,3929,0,0,0,0.00,0
,20170913,3929,3929,,,,3929,3929,0,0,0,0.00,0
,20170914,3929,3929,,,,3929,3929,0,0,0,0.00,0
,20170915,3929,3929,,,,3929,3929,0,0,0,0.00,0
,20170918,3929,3929,,,,3929,3929,0,0,0,0.00,0
,20170919,3929,3929,,,,3929,3929,0,0,0,0.00,0
,20170920,3929,3929,,,,3929,3929,0,0,0,0.00,0
,20170921,3929,3929,,,,3929,3929,0,0,0,0.00,0
,20170922,3929,3929,,,,3929,3929,0,0,0,0.00,0
,20170925,3929,3929,,,,3765,3765,-164,-164,0,0.00,0
,20170926,3765,3765,,,,3765,3765,0,0,0,0.00,0
,20170927,3765,3765,,,,3765,3765,0,0,0,0.00,0
,20170928,3765,3765,,,,3765,3765,0,0,0,0.00,0
,20170929,3765,3765,,,,3765,3765,0,0,0,0.00,0
,20171009,3765,3765,,,,3765,3765,0,0,0,0.00,0
,20171010,3765,3765,,,,3765,3765,0,0,0,0.00,0
,20171011,3765,3765,,,,3765,3765,0,0,0,0.00,0
,20171012,3765,3765,,,,3765,3765,0,0,0,0.00,0
,20171013,3765,3765,,,,3765,3765,0,0,0,0.00,0
,20171016,3765,3765,,,,3765,3765,0,0,0,0.00,0
,20171017,3765,3765,,,,3765,3765,0,0,0,0.00,0
,20171018,3765,3765,,,,3765,3765,0,0,0,0.00,0
,20171019,3765,3765,,,,3765,3765,0,0,0,0.00,0
,20171020,3765,3765,,,,3765,3765,0,0,0,0.00,0
,20171023,3765,3765,,,,3765,3765,0,0,0,0.00,0
,20171024,3765,3765,,,,3765,3765,0,0,0,0.00,0
,20171025,3765,3765,,,,3765,3765,0,0,0,0.00,0
,20171026,3765,3765,,,,3765,3765,0,0,0,0.00,0
,20171027,3765,3765,,,,3765,3765,0,0,0,0.00,0
,20171030,3765,3765,,,,3765,3765,0,0,0,0.00,0
,20171031,3765,3765,,,,3765,3765,0,0,0,0.00,0
,20171101,3765,3765,,,,3765,3765,0,0,0,0.00,0
,20171102,3765,3765,,,,3765,3765,0,0,0,0.00,0
,20171103,3765,3765,,,,3765,3765,0,0,0,0.00,0
,20171106,3765,3765,,,,3765,3765,0,0,0,0.00,0
,20171107,3765,3765,,,,3765,3765,0,0,0,0.00,0
,20171108,3765,3765,,,,3765,3765,0,0,0,0.00,0
,20171109,3765,3765,,,,3765,3765,0,0,0,0.00,0
,20171110,3765,3765,,,,3765,3765,0,0,0,0.00,0
,20171113,3765,3765,,,,3765,3765,0,0,0,0.00,0
,20171114,3765,3765,,,,3765,3765,0,0,0,0.00,0
,20171115,3765,3765,,,,3765,3765,0,0,0,0.00,0
,20171116,3765,3765,,,,3765,3765,0,0,0,0.00,0
,20171117,3765,3765,,,,3765,3765,0,0,0,0.00,0
,20171120,3765,3765,,,,3765,3765,0,0,0,0.00,0
,20171121,3765,3765,,,,3765,3765,0,0,0,0.00,0
,20171122,3765,3765,,,,3765,3765,0,0,0,0.00,0
,20171123,3765,3765,,,,3765,3765,0,0,0,0.00,0
,20171124,3765,3765,,,,3765,3765,0,0,0,0.00,0
,20171127,3765,3765,,,,3765,3765,0,0,0,0.00,0
,20171128,3765,3765,,,,3765,3765,0,0,0,0.00,0
,20171129,3765,3765,,,,3765,3765,0,0,0,0.00,0
,20171130,3765,3765,,,,3765,3765,0,0,0,0.00,0
,20171201,3765,3765,,,,3765,3765,0,0,0,0.00,0
,20171204,3765,3765,,,,3765,3765,0,0,0,0.00,0
,20171205,3765,3765,,,,3765,3765,0,0,0,0.00,0
,20171206,3765,3765,,,,3765,3765,0,0,0,0.00,0
,20171207,3765,3765,,,,3765,3765,0,0,0,0.00,0
,20171208,3765,3765,,,,3765,3765,0,0,0,0.00,0
,20171211,3765,3765,,,,3765,3765,0,0,0,0.00,0
,20171212,3765,3765,,,,3765,3765,0,0,0,0.00,0
,20171213,3765,3765,,,,3765,3765,0,0,0,0.00,0
,20171214,3765,3765,,,,3765,3765,0,0,0,0.00,0
,20171215,3765,3765,,,,3765,3765,0,0,0,0.00,0
,20171218,3765,3765,,,,3765,3765,0,0,0,0.00,0
,20171219,3765,3765,,,,3765,3765,0,0,0,0.00,0
,20171220,3765,3765,,,,3765,3765,0,0,0,0.00,0
,20171221,3765,3765,,,,3765,3765,0,0,0,0.00,0
,20171222,3765,3765,,,,3765,3765,0,0,0,0.00,0
,20171225,3765,3765,,,,3765,3765,0,0,0,0.00,0
,20171226,3765,3765,,,,3765,3765,0,0,0,0.00,0
,20171227,3765,3765,,,,3765,3765,0,0,0,0.00,0
,20171228,3765,3765,,,,3765,3765,0,0,0,0.00,0
,20171229,3765,3765,,,,3765,3765,0,0,0,0.00,0
fu1807,20170703,3808,3808,,,,3808,3808,0,0,0,0.00,0
,20170704,3808,3808,,,,3808,3808,0,0,0,0.00,0
,20170705,3808,3808,,,,3808,3808,0,0,0,0.00,0
,20170706,3808,3808,,,,3808,3808,0,0,0,0.00,0
,20170707,3808,3808,,,,3808,3808,0,0,0,0.00,0
,20170710,3808,3808,,,,3808,3808,0,0,0,0.00,0
,20170711,3808,3808,,,,3808,3808,0,0,0,0.00,0
,20170712,3808,3808,,,,3808,3808,0,0,0,0.00,0
,20170713,3808,3808,,,,3808,3808,0,0,0,0.00,0
,20170714,3808,3808,,,,3808,3808,0,0,0,0.00,0
,20170717,3808,3808,,,,3808,3808,0,0,0,0.00,0
,20170718,3808,3808,,,,3808,3808,0,0,0,0.00,0
,20170719,3808,3808,,,,3808,3808,0,0,0,0.00,0
,20170720,3808,3808,,,,3808,3808,0,0,0,0.00,0
,20170721,3808,3808,,,,3808,3808,0,0,0,0.00,0
,20170724,3808,3808,,,,3808,3808,0,0,0,0.00,0
,20170725,3808,3808,,,,3808,3808,0,0,0,0.00,0
,20170726,3808,3808,,,,3808,3808,0,0,0,0.00,0
,20170727,3808,3808,,,,3808,3808,0,0,0,0.00,0
,20170728,3808,3808,,,,3808,3808,0,0,0,0.00,0
,20170731,3808,3808,,,,3808,3808,0,0,0,0.00,0
,20170801,3808,3808,,,,3808,3808,0,0,0,0.00,0
,20170802,3808,3808,,,,3808,3808,0,0,0,0.00,0
,20170803,3808,3808,,,,3808,3808,0,0,0,0.00,0
,20170804,3808,3808,,,,3808,3808,0,0,0,0.00,0
,20170807,3808,3808,,,,3808,3808,0,0,0,0.00,0
,20170808,3808,3808,,,,3808,3808,0,0,0,0.00,0
,20170809,3808,3808,,,,3808,3808,0,0,0,0.00,0
,20170810,3808,3808,,,,3808,3808,0,0,0,0.00,0
,20170811,3808,3808,,,,3808,3808,0,0,0,0.00,0
,20170814,3808,3808,,,,3808,3808,0,0,0,0.00,0
,20170815,3808,3808,,,,3808,3808,0,0,0,0.00,0
,20170816,3808,3808,,,,3808,3808,0,0,0,0.00,0
,20170817,3808,3808,,,,3911,3911,103,103,0,0.00,0
,20170818,3911,3911,,,,3911,3911,0,0,0,0.00,0
,20170821,3911,3911,,,,3911,3911,0,0,0,0.00,0
,20170822,3911,3911,,,,3911,3911,0,0,0,0.00,0
,20170823,3911,3911,,,,3911,3911,0,0,0,0.00,0
,20170824,3911,3911,,,,3911,3911,0,0,0,0.00,0
,20170825,3911,3911,,,,3911,3911,0,0,0,0.00,0
,20170828,3911,3911,,,,3911,3911,0,0,0,0.00,0
,20170829,3911,3911,,,,3911,3911,0,0,0,0.00,0
,20170830,3911,3911,,,,3911,3911,0,0,0,0.00,0
,20170831,3911,3911,,,,3911,3911,0,0,0,0.00,0
,20170901,3911,3911,,,,3911,3911,0,0,0,0.00,0
,20170904,3911,3911,,,,3911,3911,0,0,0,0.00,0
,20170905,3911,3911,,,,3911,3911,0,0,0,0.00,0
,20170906,3911,3911,,,,3911,3911,0,0,0,0.00,0
,20170907,3911,3911,,,,3911,3911,0,0,0,0.00,0
,20170908,3911,3911,,,,3911,3911,0,0,0,0.00,0
,20170911,3911,3911,,,,3911,3911,0,0,0,0.00,0
,20170912,3911,3911,,,,3911,3911,0,0,0,0.00,0
,20170913,3911,3911,,,,3911,3911,0,0,0,0.00,0
,20170914,3911,3911,,,,3911,3911,0,0,0,0.00,0
,20170915,3911,3911,,,,3911,3911,0,0,0,0.00,0
,20170918,3911,3911,,,,3911,3911,0,0,0,0.00,0
,20170919,3911,3911,,,,3911,3911,0,0,0,0.00,0
,20170920,3911,3911,,,,3911,3911,0,0,0,0.00,0
,20170921,3911,3911,,,,3911,3911,0,0,0,0.00,0
,20170922,3911,3911,,,,3911,3911,0,0,0,0.00,0
,20170925,3911,3911,,,,3748,3748,-163,-163,0,0.00,0
,20170926,3748,3748,,,,3748,3748,0,0,0,0.00,0
,20170927,3748,3748,,,,3748,3748,0,0,0,0.00,0
,20170928,3748,3748,,,,3748,3748,0,0,0,0.00,0
,20170929,3748,3748,,,,3748,3748,0,0,0,0.00,0
,20171009,3748,3748,,,,3748,3748,0,0,0,0.00,0
,20171010,3748,3748,,,,3748,3748,0,0,0,0.00,0
,20171011,3748,3748,,,,3748,3748,0,0,0,0.00,0
,20171012,3748,3748,,,,3748,3748,0,0,0,0.00,0
,20171013,3748,3748,,,,3748,3748,0,0,0,0.00,0
,20171016,3748,3748,,,,3748,3748,0,0,0,0.00,0
,20171017,3748,3748,,,,3748,3748,0,0,0,0.00,0
,20171018,3748,3748,,,,3748,3748,0,0,0,0.00,0
,20171019,3748,3748,,,,3748,3748,0,0,0,0.00,0
,20171020,3748,3748,,,,3748,3748,0,0,0,0.00,0
,20171023,3748,3748,,,,3748,3748,0,0,0,0.00,0
,20171024,3748,3748,,,,3748,3748,0,0,0,0.00,0
,20171025,3748,3748,,,,3748,3748,0,0,0,0.00,0
,20171026,3748,3748,,,,3748,3748,0,0,0,0.00,0
,20171027,3748,3748,,,,3748,3748,0,0,0,0.00,0
,20171030,3748,3748,,,,3748,3748,0,0,0,0.00,0
,20171031,3748,3748,,,,3748,3748,0,0,0,0.00,0
,20171101,3748,3748,,,,3748,3748,0,0,0,0.00,0
,20171102,3748,3748,,,,3748,3748,0,0,0,0.00,0
,20171103,3748,3748,,,,3748,3748,0,0,0,0.00,0
,20171106,3748,3748,,,,3748,3748,0,0,0,0.00,0
,20171107,3748,3748,,,,3748,3748,0,0,0,0.00,0
,20171108,3748,3748,,,,3748,3748,0,0,0,0.00,0
,20171109,3748,3748,,,,3748,3748,0,0,0,0.00,0
,20171110,3748,3748,,,,3748,3748,0,0,0,0.00,0
,20171113,3748,3748,,,,3748,3748,0,0,0,0.00,0
,20171114,3748,3748,,,,3748,3748,0,0,0,0.00,0
,20171115,3748,3748,,,,3748,3748,0,0,0,0.00,0
,20171116,3748,3748,,,,3748,3748,0,0,0,0.00,0
,20171117,3748,3748,,,,3748,3748,0,0,0,0.00,0
,20171120,3748,3748,,,,3748,3748,0,0,0,0.00,0
,20171121,3748,3748,,,,3748,3748,0,0,0,0.00,0
,20171122,3748,3748,,,,3748,3748,0,0,0,0.00,0
,20171123,3748,3748,,,,3748,3748,0,0,0,0.00,0
,20171124,3748,3748,,,,3748,3748,0,0,0,0.00,0
,20171127,3748,3748,,,,3748,3748,0,0,0,0.00,0
,20171128,3748,3748,,,,3748,3748,0,0,0,0.00,0
,20171129,3748,3748,,,,3748,3748,0,0,0,0.00,0
,20171130,3748,3748,,,,3748,3748,0,0,0,0.00,0
,20171201,3748,3748,,,,3748,3748,0,0,0,0.00,0
,20171204,3748,3748,,,,3748,3748,0,0,0,0.00,0
,20171205,3748,3748,,,,3748,3748,0,0,0,0.00,0
,20171206,3748,3748,,,,3748,3748,0,0,0,0.00,0
,20171207,3748,3748,,,,3748,3748,0,0,0,0.00,0
,20171208,3748,3748,,,,3748,3748,0,0,0,0.00,0
,20171211,3748,3748,,,,3748,3748,0,0,0,0.00,0
,20171212,3748,3748,,,,3748,3748,0,0,0,0.00,0
,20171213,3748,3748,,,,3748,3748,0,0,0,0.00,0
,20171214,3748,3748,,,,3748,3748,0,0,0,0.00,0
,20171215,3748,3748,,,,3748,3748,0,0,0,0.00,0
,20171218,3748,3748,,,,3748,3748,0,0,0,0.00,0
,20171219,3748,3748,,,,3748,3748,0,0,0,0.00,0
,20171220,3748,3748,,,,3748,3748,0,0,0,0.00,0
,20171221,3748,3748,,,,3748,3748,0,0,0,0.00,0
,20171222,3748,3748,,,,3748,3748,0,0,0,0.00,0
,20171225,3748,3748,,,,3748,3748,0,0,0,0.00,0
,20171226,3748,3748,,,,3748,3748,0,0,0,0.00,0
,20171227,3748,3748,,,,3748,3748,0,0,0,0.00,0
,20171228,3748,3748,,,,3748,3748,0,0,0,0.00,0
,20171229,3748,3748,,,,3748,3748,0,0,0,0.00,0
fu1808,20170801,3808,3808,,,,3808,3808,0,0,0,0.00,0
,20170802,3808,3808,,,,3808,3808,0,0,0,0.00,0
,20170803,3808,3808,,,,3808,3808,0,0,0,0.00,0
,20170804,3808,3808,,,,3808,3808,0,0,0,0.00,0
,20170807,3808,3808,,,,3808,3808,0,0,0,0.00,0
,20170808,3808,3808,,,,3808,3808,0,0,0,0.00,0
,20170809,3808,3808,,,,3808,3808,0,0,0,0.00,0
,20170810,3808,3808,,,,3808,3808,0,0,0,0.00,0
,20170811,3808,3808,,,,3808,3808,0,0,0,0.00,0
,20170814,3808,3808,,,,3808,3808,0,0,0,0.00,0
,20170815,3808,3808,,,,3808,3808,0,0,0,0.00,0
,20170816,3808,3808,,,,3808,3808,0,0,0,0.00,0
,20170817,3808,3808,,,,3911,3911,103,103,0,0.00,0
,20170818,3911,3911,,,,3911,3911,0,0,0,0.00,0
,20170821,3911,3911,,,,3911,3911,0,0,0,0.00,0
,20170822,3911,3911,,,,3911,3911,0,0,0,0.00,0
,20170823,3911,3911,,,,3911,3911,0,0,0,0.00,0
,20170824,3911,3911,,,,3911,3911,0,0,0,0.00,0
,20170825,3911,3911,,,,3911,3911,0,0,0,0.00,0
,20170828,3911,3911,,,,3911,3911,0,0,0,0.00,0
,20170829,3911,3911,,,,3911,3911,0,0,0,0.00,0
,20170830,3911,3911,,,,3911,3911,0,0,0,0.00,0
,20170831,3911,3911,,,,3911,3911,0,0,0,0.00,0
,20170901,3911,3911,,,,3911,3911,0,0,0,0.00,0
,20170904,3911,3911,,,,3911,3911,0,0,0,0.00,0
,20170905,3911,3911,,,,3911,3911,0,0,0,0.00,0
,20170906,3911,3911,,,,3911,3911,0,0,0,0.00,0
,20170907,3911,3911,,,,3911,3911,0,0,0,0.00,0
,20170908,3911,3911,,,,3911,3911,0,0,0,0.00,0
,20170911,3911,3911,,,,3911,3911,0,0,0,0.00,0
,20170912,3911,3911,,,,3911,3911,0,0,0,0.00,0
,20170913,3911,3911,,,,3911,3911,0,0,0,0.00,0
,20170914,3911,3911,,,,3911,3911,0,0,0,0.00,0
,20170915,3911,3911,,,,3911,3911,0,0,0,0.00,0
,20170918,3911,3911,,,,3911,3911,0,0,0,0.00,0
,20170919,3911,3911,,,,3911,3911,0,0,0,0.00,0
,20170920,3911,3911,,,,3911,3911,0,0,0,0.00,0
,20170921,3911,3911,,,,3911,3911,0,0,0,0.00,0
,20170922,3911,3911,,,,3911,3911,0,0,0,0.00,0
,20170925,3911,3911,,,,3748,3748,-163,-163,0,0.00,0
,20170926,3748,3748,,,,3748,3748,0,0,0,0.00,0
,20170927,3748,3748,,,,3748,3748,0,0,0,0.00,0
,20170928,3748,3748,,,,3748,3748,0,0,0,0.00,0
,20170929,3748,3748,,,,3748,3748,0,0,0,0.00,0
,20171009,3748,3748,,,,3748,3748,0,0,0,0.00,0
,20171010,3748,3748,,,,3748,3748,0,0,0,0.00,0
,20171011,3748,3748,,,,3748,3748,0,0,0,0.00,0
,20171012,3748,3748,,,,3748,3748,0,0,0,0.00,0
,20171013,3748,3748,,,,3748,3748,0,0,0,0.00,0
,20171016,3748,3748,,,,3748,3748,0,0,0,0.00,0
,20171017,3748,3748,,,,3748,3748,0,0,0,0.00,0
,20171018,3748,3748,,,,3748,3748,0,0,0,0.00,0
,20171019,3748,3748,,,,3748,3748,0,0,0,0.00,0
,20171020,3748,3748,,,,3748,3748,0,0,0,0.00,0
,20171023,3748,3748,,,,3748,3748,0,0,0,0.00,0
,20171024,3748,3748,,,,3748,3748,0,0,0,0.00,0
,20171025,3748,3748,,,,3748,3748,0,0,0,0.00,0
,20171026,3748,3748,,,,3748,3748,0,0,0,0.00,0
,20171027,3748,3748,,,,3748,3748,0,0,0,0.00,0
,20171030,3748,3748,,,,3748,3748,0,0,0,0.00,0
,20171031,3748,3748,,,,3748,3748,0,0,0,0.00,0
,20171101,3748,3748,,,,3748,3748,0,0,0,0.00,0
,20171102,3748,3748,,,,3748,3748,0,0,0,0.00,0
,20171103,3748,3748,,,,3748,3748,0,0,0,0.00,0
,20171106,3748,3748,,,,3748,3748,0,0,0,0.00,0
,20171107,3748,3748,,,,3748,3748,0,0,0,0.00,0
,20171108,3748,3748,,,,3748,3748,0,0,0,0.00,0
,20171109,3748,3748,,,,3748,3748,0,0,0,0.00,0
,20171110,3748,3748,,,,3748,3748,0,0,0,0.00,0
,20171113,3748,3748,,,,3748,3748,0,0,0,0.00,0
,20171114,3748,3748,,,,3748,3748,0,0,0,0.00,0
,20171115,3748,3748,,,,3748,3748,0,0,0,0.00,0
,20171116,3748,3748,,,,3748,3748,0,0,0,0.00,0
,20171117,3748,3748,,,,3748,3748,0,0,0,0.00,0
,20171120,3748,3748,,,,3748,3748,0,0,0,0.00,0
,20171121,3748,3748,,,,3748,3748,0,0,0,0.00,0
,20171122,3748,3748,,,,3748,3748,0,0,0,0.00,0
,20171123,3748,3748,,,,3748,3748,0,0,0,0.00,0
,20171124,3748,3748,,,,3748,3748,0,0,0,0.00,0
,20171127,3748,3748,,,,3748,3748,0,0,0,0.00,0
,20171128,3748,3748,,,,3748,3748,0,0,0,0.00,0
,20171129,3748,3748,,,,3748,3748,0,0,0,0.00,0
,20171130,3748,3748,,,,3748,3748,0,0,0,0.00,0
,20171201,3748,3748,,,,3748,3748,0,0,0,0.00,0
,20171204,3748,3748,,,,3748,3748,0,0,0,0.00,0
,20171205,3748,3748,,,,3748,3748,0,0,0,0.00,0
,20171206,3748,3748,,,,3748,3748,0,0,0,0.00,0
,20171207,3748,3748,,,,3748,3748,0,0,0,0.00,0
,20171208,3748,3748,,,,3748,3748,0,0,0,0.00,0
,20171211,3748,3748,,,,3748,3748,0,0,0,0.00,0
,20171212,3748,3748,,,,3748,3748,0,0,0,0.00,0
,20171213,3748,3748,,,,3748,3748,0,0,0,0.00,0
,20171214,3748,3748,,,,3748,3748,0,0,0,0.00,0
,20171215,3748,3748,,,,3748,3748,0,0,0,0.00,0
,20171218,3748,3748,,,,3748,3748,0,0,0,0.00,0
,20171219,3748,3748,,,,3748,3748,0,0,0,0.00,0
,20171220,3748,3748,,,,3748,3748,0,0,0,0.00,0
,20171221,3748,3748,,,,3748,3748,0,0,0,0.00,0
,20171222,3748,3748,,,,3748,3748,0,0,0,0.00,0
,20171225,3748,3748,,,,3748,3748,0,0,0,0.00,0
,20171226,3748,3748,,,,3748,3748,0,0,0,0.00,0
,20171227,3748,3748,,,,3748,3748,0,0,0,0.00,0
,20171228,3748,3748,,,,3748,3748,0,0,0,0.00,0
,20171229,3748,3748,,,,3748,3748,0,0,0,0.00,0
fu1809,20170901,3911,3911,,,,3911,3911,0,0,0,0.00,0
,20170904,3911,3911,,,,3911,3911,0,0,0,0.00,0
,20170905,3911,3911,,,,3911,3911,0,0,0,0.00,0
,20170906,3911,3911,,,,3911,3911,0,0,0,0.00,0
,20170907,3911,3911,,,,3911,3911,0,0,0,0.00,0
,20170908,3911,3911,,,,3911,3911,0,0,0,0.00,0
,20170911,3911,3911,,,,3911,3911,0,0,0,0.00,0
,20170912,3911,3911,,,,3911,3911,0,0,0,0.00,0
,20170913,3911,3911,,,,3911,3911,0,0,0,0.00,0
,20170914,3911,3911,,,,3911,3911,0,0,0,0.00,0
,20170915,3911,3911,,,,3911,3911,0,0,0,0.00,0
,20170918,3911,3911,,,,3911,3911,0,0,0,0.00,0
,20170919,3911,3911,,,,3911,3911,0,0,0,0.00,0
,20170920,3911,3911,,,,3911,3911,0,0,0,0.00,0
,20170921,3911,3911,,,,3911,3911,0,0,0,0.00,0
,20170922,3911,3911,,,,3911,3911,0,0,0,0.00,0
,20170925,3911,3911,,,,3748,3748,-163,-163,0,0.00,0
,20170926,3748,3748,,,,3748,3748,0,0,0,0.00,0
,20170927,3748,3748,,,,3748,3748,0,0,0,0.00,0
,20170928,3748,3748,,,,3748,3748,0,0,0,0.00,0
,20170929,3748,3748,,,,3748,3748,0,0,0,0.00,0
,20171009,3748,3748,,,,3748,3748,0,0,0,0.00,0
,20171010,3748,3748,,,,3748,3748,0,0,0,0.00,0
,20171011,3748,3748,,,,3748,3748,0,0,0,0.00,0
,20171012,3748,3748,,,,3748,3748,0,0,0,0.00,0
,20171013,3748,3748,,,,3748,3748,0,0,0,0.00,0
,20171016,3748,3748,,,,3748,3748,0,0,0,0.00,0
,20171017,3748,3748,,,,3748,3748,0,0,0,0.00,0
,20171018,3748,3748,,,,3748,3748,0,0,0,0.00,0
,20171019,3748,3748,,,,3748,3748,0,0,0,0.00,0
,20171020,3748,3748,,,,3748,3748,0,0,0,0.00,0
,20171023,3748,3748,,,,3748,3748,0,0,0,0.00,0
,20171024,3748,3748,,,,3748,3748,0,0,0,0.00,0
,20171025,3748,3748,,,,3748,3748,0,0,0,0.00,0
,20171026,3748,3748,,,,3748,3748,0,0,0,0.00,0
,20171027,3748,3748,,,,3748,3748,0,0,0,0.00,0
,20171030,3748,3748,,,,3748,3748,0,0,0,0.00,0
,20171031,3748,3748,,,,3748,3748,0,0,0,0.00,0
,20171101,3748,3748,,,,3748,3748,0,0,0,0.00,0
,20171102,3748,3748,,,,3748,3748,0,0,0,0.00,0
,20171103,3748,3748,,,,3748,3748,0,0,0,0.00,0
,20171106,3748,3748,,,,3748,3748,0,0,0,0.00,0
,20171107,3748,3748,,,,3748,3748,0,0,0,0.00,0
,20171108,3748,3748,,,,3748,3748,0,0,0,0.00,0
,20171109,3748,3748,,,,3748,3748,0,0,0,0.00,0
,20171110,3748,3748,,,,3748,3748,0,0,0,0.00,0
,20171113,3748,3748,,,,3748,3748,0,0,0,0.00,0
,20171114,3748,3748,,,,3748,3748,0,0,0,0.00,0
,20171115,3748,3748,,,,3748,3748,0,0,0,0.00,0
,20171116,3748,3748,,,,3748,3748,0,0,0,0.00,0
,20171117,3748,3748,,,,3748,3748,0,0,0,0.00,0
,20171120,3748,3748,,,,3748,3748,0,0,0,0.00,0
,20171121,3748,3748,,,,3748,3748,0,0,0,0.00,0
,20171122,3748,3748,,,,3748,3748,0,0,0,0.00,0
,20171123,3748,3748,,,,3748,3748,0,0,0,0.00,0
,20171124,3748,3748,,,,3748,3748,0,0,0,0.00,0
,20171127,3748,3748,,,,3748,3748,0,0,0,0.00,0
,20171128,3748,3748,,,,3748,3748,0,0,0,0.00,0
,20171129,3748,3748,,,,3748,3748,0,0,0,0.00,0
,20171130,3748,3748,,,,3748,3748,0,0,0,0.00,0
,20171201,3748,3748,,,,3748,3748,0,0,0,0.00,0
,20171204,3748,3748,,,,3748,3748,0,0,0,0.00,0
,20171205,3748,3748,,,,3748,3748,0,0,0,0.00,0
,20171206,3748,3748,,,,3748,3748,0,0,0,0.00,0
,20171207,3748,3748,,,,3748,3748,0,0,0,0.00,0
,20171208,3748,3748,,,,3748,3748,0,0,0,0.00,0
,20171211,3748,3748,,,,3748,3748,0,0,0,0.00,0
,20171212,3748,3748,,,,3748,3748,0,0,0,0.00,0
,20171213,3748,3748,,,,3748,3748,0,0,0,0.00,0
,20171214,3748,3748,,,,3748,3748,0,0,0,0.00,0
,20171215,3748,3748,,,,3748,3748,0,0,0,0.00,0
,20171218,3748,3748,,,,3748,3748,0,0,0,0.00,0
,20171219,3748,3748,,,,3748,3748,0,0,0,0.00,0
,20171220,3748,3748,,,,3748,3748,0,0,0,0.00,0
,20171221,3748,3748,,,,3748,3748,0,0,0,0.00,0
,20171222,3748,3748,,,,3748,3748,0,0,0,0.00,0
,20171225,3748,3748,,,,3748,3748,0,0,0,0.00,0
,20171226,3748,3748,,,,3748,3748,0,0,0,0.00,0
,20171227,3748,3748,,,,3748,3748,0,0,0,0.00,0
,20171228,3748,3748,,,,3748,3748,0,0,0,0.00,0
,20171229,3748,3748,,,,3748,3748,0,0,0,0.00,0
fu1810,20171009,3748,3748,,,,3748,3748,0,0,0,0.00,0
,20171010,3748,3748,,,,3748,3748,0,0,0,0.00,0
,20171011,3748,3748,,,,3748,3748,0,0,0,0.00,0
,20171012,3748,3748,,,,3748,3748,0,0,0,0.00,0
,20171013,3748,3748,,,,3748,3748,0,0,0,0.00,0
,20171016,3748,3748,,,,3748,3748,0,0,0,0.00,0
,20171017,3748,3748,,,,3748,3748,0,0,0,0.00,0
,20171018,3748,3748,,,,3748,3748,0,0,0,0.00,0
,20171019,3748,3748,,,,3748,3748,0,0,0,0.00,0
,20171020,3748,3748,,,,3748,3748,0,0,0,0.00,0
,20171023,3748,3748,,,,3748,3748,0,0,0,0.00,0
,20171024,3748,3748,,,,3748,3748,0,0,0,0.00,0
,20171025,3748,3748,,,,3748,3748,0,0,0,0.00,0
,20171026,3748,3748,,,,3748,3748,0,0,0,0.00,0
,20171027,3748,3748,,,,3748,3748,0,0,0,0.00,0
,20171030,3748,3748,,,,3748,3748,0,0,0,0.00,0
,20171031,3748,3748,,,,3748,3748,0,0,0,0.00,0
,20171101,3748,3748,,,,3748,3748,0,0,0,0.00,0
,20171102,3748,3748,,,,3748,3748,0,0,0,0.00,0
,20171103,3748,3748,,,,3748,3748,0,0,0,0.00,0
,20171106,3748,3748,,,,3748,3748,0,0,0,0.00,0
,20171107,3748,3748,,,,3748,3748,0,0,0,0.00,0
,20171108,3748,3748,,,,3748,3748,0,0,0,0.00,0
,20171109,3748,3748,,,,3748,3748,0,0,0,0.00,0
,20171110,3748,3748,,,,3748,3748,0,0,0,0.00,0
,20171113,3748,3748,,,,3748,3748,0,0,0,0.00,0
,20171114,3748,3748,,,,3748,3748,0,0,0,0.00,0
,20171115,3748,3748,,,,3748,3748,0,0,0,0.00,0
,20171116,3748,3748,,,,3748,3748,0,0,0,0.00,0
,20171117,3748,3748,,,,3748,3748,0,0,0,0.00,0
,20171120,3748,3748,,,,3748,3748,0,0,0,0.00,0
,20171121,3748,3748,,,,3748,3748,0,0,0,0.00,0
,20171122,3748,3748,,,,3748,3748,0,0,0,0.00,0
,20171123,3748,3748,,,,3748,3748,0,0,0,0.00,0
,20171124,3748,3748,,,,3748,3748,0,0,0,0.00,0
,20171127,3748,3748,,,,3748,3748,0,0,0,0.00,0
,20171128,3748,3748,,,,3748,3748,0,0,0,0.00,0
,20171129,3748,3748,,,,3748,3748,0,0,0,0.00,0
,20171130,3748,3748,,,,3748,3748,0,0,0,0.00,0
,20171201,3748,3748,,,,3748,3748,0,0,0,0.00,0
,20171204,3748,3748,,,,3748,3748,0,0,0,0.00,0
,20171205,3748,3748,,,,3748,3748,0,0,0,0.00,0
,20171206,3748,3748,,,,3748,3748,0,0,0,0.00,0
,20171207,3748,3748,,,,3748,3748,0,0,0,0.00,0
,20171208,3748,3748,,,,3748,3748,0,0,0,0.00,0
,20171211,3748,3748,,,,3748,3748,0,0,0,0.00,0
,20171212,3748,3748,,,,3748,3748,0,0,0,0.00,0
,20171213,3748,3748,,,,3748,3748,0,0,0,0.00,0
,20171214,3748,3748,,,,3748,3748,0,0,0,0.00,0
,20171215,3748,3748,,,,3748,3748,0,0,0,0.00,0
,20171218,3748,3748,,,,3748,3748,0,0,0,0.00,0
,20171219,3748,3748,,,,3748,3748,0,0,0,0.00,0
,20171220,3748,3748,,,,3748,3748,0,0,0,0.00,0
,20171221,3748,3748,,,,3748,3748,0,0,0,0.00,0
,20171222,3748,3748,,,,3748,3748,0,0,0,0.00,0
,20171225,3748,3748,,,,3748,3748,0,0,0,0.00,0
,20171226,3748,3748,,,,3748,3748,0,0,0,0.00,0
,20171227,3748,3748,,,,3748,3748,0,0,0,0.00,0
,20171228,3748,3748,,,,3748,3748,0,0,0,0.00,0
,20171229,3748,3748,,,,3748,3748,0,0,0,0.00,0
fu1811,20171101,3748,3748,,,,3748,3748,0,0,0,0.00,0
,20171102,3748,3748,,,,3748,3748,0,0,0,0.00,0
,20171103,3748,3748,,,,3748,3748,0,0,0,0.00,0
,20171106,3748,3748,,,,3748,3748,0,0,0,0.00,0
,20171107,3748,3748,,,,3748,3748,0,0,0,0.00,0
,20171108,3748,3748,,,,3748,3748,0,0,0,0.00,0
,20171109,3748,3748,,,,3748,3748,0,0,0,0.00,0
,20171110,3748,3748,,,,3748,3748,0,0,0,0.00,0
,20171113,3748,3748,,,,3748,3748,0,0,0,0.00,0
,20171114,3748,3748,,,,3748,3748,0,0,0,0.00,0
,20171115,3748,3748,,,,3748,3748,0,0,0,0.00,0
,20171116,3748,3748,,,,3748,3748,0,0,0,0.00,0
,20171117,3748,3748,,,,3748,3748,0,0,0,0.00,0
,20171120,3748,3748,,,,3748,3748,0,0,0,0.00,0
,20171121,3748,3748,,,,3748,3748,0,0,0,0.00,0
,20171122,3748,3748,,,,3748,3748,0,0,0,0.00,0
,20171123,3748,3748,,,,3748,3748,0,0,0,0.00,0
,20171124,3748,3748,,,,3748,3748,0,0,0,0.00,0
,20171127,3748,3748,,,,3748,3748,0,0,0,0.00,0
,20171128,3748,3748,,,,3748,3748,0,0,0,0.00,0
,20171129,3748,3748,,,,3748,3748,0,0,0,0.00,0
,20171130,3748,3748,,,,3748,3748,0,0,0,0.00,0
,20171201,3748,3748,,,,3748,3748,0,0,0,0.00,0
,20171204,3748,3748,,,,3748,3748,0,0,0,0.00,0
,20171205,3748,3748,,,,3748,3748,0,0,0,0.00,0
,20171206,3748,3748,,,,3748,3748,0,0,0,0.00,0
,20171207,3748,3748,,,,3748,3748,0,0,0,0.00,0
,20171208,3748,3748,,,,3748,3748,0,0,0,0.00,0
,20171211,3748,3748,,,,3748,3748,0,0,0,0.00,0
,20171212,3748,3748,,,,3748,3748,0,0,0,0.00,0
,20171213,3748,3748,,,,3748,3748,0,0,0,0.00,0
,20171214,3748,3748,,,,3748,3748,0,0,0,0.00,0
,20171215,3748,3748,,,,3748,3748,0,0,0,0.00,0
,20171218,3748,3748,,,,3748,3748,0,0,0,0.00,0
,20171219,3748,3748,,,,3748,3748,0,0,0,0.00,0
,20171220,3748,3748,,,,3748,3748,0,0,0,0.00,0
,20171221,3748,3748,,,,3748,3748,0,0,0,0.00,0
,20171222,3748,3748,,,,3748,3748,0,0,0,0.00,0
,20171225,3748,3748,,,,3748,3748,0,0,0,0.00,0
,20171226,3748,3748,,,,3748,3748,0,0,0,0.00,0
,20171227,3748,3748,,,,3748,3748,0,0,0,0.00,0
,20171228,3748,3748,,,,3748,3748,0,0,0,0.00,0
,20171229,3748,3748,,,,3748,3748,0,0,0,0.00,0
fu1812,20171201,3748,3748,,,,3748,3748,0,0,0,0.00,0
,20171204,3748,3748,,,,3748,3748,0,0,0,0.00,0
,20171205,3748,3748,,,,3748,3748,0,0,0,0.00,0
,20171206,3748,3748,,,,3748,3748,0,0,0,0.00,0
,20171207,3748,3748,,,,3748,3748,0,0,0,0.00,0
,20171208,3748,3748,,,,3748,3748,0,0,0,0.00,0
,20171211,3748,3748,,,,3748,3748,0,0,0,0.00,0
,20171212,3748,3748,,,,3748,3748,0,0,0,0.00,0
,20171213,3748,3748,,,,3748,3748,0,0,0,0.00,0
,20171214,3748,3748,,,,3748,3748,0,0,0,0.00,0
,20171215,3748,3748,,,,3748,3748,0,0,0,0.00,0
,20171218,3748,3748,,,,3748,3748,0,0,0,0.00,0
,20171219,3748,3748,,,,3748,3748,0,0,0,0.00,0
,20171220,3748,3748,,,,3748,3748,0,0,0,0.00,0
,20171221,3748,3748,,,,3748,3748,0,0,0,0.00,0
,20171222,3748,3748,,,,3748,3748,0,0,0,0.00,0
,20171225,3748,3748,,,,3748,3748,0,0,0,0.00,0
,20171226,3748,3748,,,,3748,3748,0,0,0,0.00,0
,20171227,3748,3748,,,,3748,3748,0,0,0,0.00,0
,20171228,3748,3748,,,,3748,3748,0,0,0,0.00,0
,20171229,3748,3748,,,,3748,3748,0,0,0,0.00,0
hc1701,20170103,3550,3604,3550,3670,3550,3612,3642,8,38,678,"2,469.72",9900
,20170104,3612,3642,3630,3640,3585,3585,3595,-57,-47,1920,"6,903.78",9240
,20170105,3585,3595,3658,3658,3628,3630,3646,35,51,540,"1,969.26",8820
,20170106,3630,3646,3649,3649,3620,3620,3638,-26,-8,360,"1,309.92",8460
,20170109,3620,3638,3639,3649,3639,3649,3645,11,7,420,"1,531.26",8160
,20170110,3649,3645,3650,3720,3601,3720,3662,75,17,480,"1,757.94",7980
,20170111,3720,3662,3725,3745,3725,3735,3739,73,77,360,"1,346.10",7620
,20170112,3735,3739,3730,3730,3730,3730,3730,-9,-9,180,671.40,7440
,20170113,3730,3730,3720,3720,3701,3701,3713,-29,-17,180,668.46,7320
,20170116,3701,3713,3701,3790,3701,3790,3745,77,32,120,449.46,7260
hc1702,20170103,3540,3540,,,,3540,3540,0,0,0,0.00,10
,20170104,3540,3540,,,,3540,3540,0,0,0,0.00,10
,20170105,3540,3540,,,,3540,3540,0,0,0,0.00,10
,20170106,3540,3540,,,,3540,3540,0,0,0,0.00,10
,20170109,3540,3540,3540,3540,3540,3540,3540,0,0,2,7.08,8
,20170110,3540,3540,,,,3540,3540,0,0,0,0.00,8
,20170111,3540,3540,,,,3614,3614,74,74,0,0.00,8
,20170112,3614,3614,,,,3614,3614,0,0,0,0.00,8
,20170113,3614,3614,,,,3614,3614,0,0,0,0.00,8
,20170116,3614,3614,,,,3720,3720,106,106,0,0.00,8
,20170117,3720,3720,,,,3720,3720,0,0,0,0.00,8
,20170118,3720,3720,,,,3720,3720,0,0,0,0.00,8
,20170119,3720,3720,,,,3720,3720,0,0,0,0.00,8
,20170120,3720,3720,,,,3720,3720,0,0,0,0.00,8
,20170123,3720,3720,3500,3974,3500,3974,3737,254,17,4,14.95,6
,20170124,3974,3737,3630,3630,3630,3630,3630,-107,-107,2,7.26,4
,20170125,3630,3630,,,,3630,3630,0,0,0,0.00,4
,20170126,3630,3630,3600,3600,3600,3600,3600,-30,-30,4,14.40,0
,20170203,3600,3600,,,,3600,3600,0,0,0,0.00,0
,20170206,3600,3600,,,,3600,3600,0,0,0,0.00,0
,20170207,3600,3600,,,,3600,3600,0,0,0,0.00,0
,20170208,3600,3600,,,,3600,3600,0,0,0,0.00,0
,20170209,3600,3600,,,,3600,3600,0,0,0,0.00,0
,20170210,3600,3600,,,,3600,3600,0,0,0,0.00,0
,20170213,3600,3600,,,,3600,3600,0,0,0,0.00,0
,20170214,3600,3600,,,,3600,3600,0,0,0,0.00,0
,20170215,3600,3600,,,,3600,3600,0,0,0,0.00,0
hc1703,20170103,3416,3416,,,,3416,3416,0,0,0,0.00,0
,20170104,3416,3416,,,,3416,3416,0,0,0,0.00,0
,20170105,3416,3416,,,,3416,3416,0,0,0,0.00,0
,20170106,3416,3416,,,,3416,3416,0,0,0,0.00,0
,20170109,3416,3416,,,,3416,3416,0,0,0,0.00,0
,20170110,3416,3416,,,,3432,3432,16,16,0,0.00,0
,20170111,3432,3432,,,,3504,3504,72,72,0,0.00,0
,20170112,3504,3504,,,,3495,3495,-9,-9,0,0.00,0
,20170113,3495,3495,,,,3479,3479,-16,-16,0,0.00,0
,20170116,3479,3479,3722,3722,3722,3722,3722,243,243,10,37.22,10
,20170117,3722,3722,,,,3722,3722,0,0,0,0.00,10
,20170118,3722,3722,,,,3722,3722,0,0,0,0.00,10
,20170119,3722,3722,,,,3722,3722,0,0,0,0.00,10
,20170120,3722,3722,,,,3722,3722,0,0,0,0.00,10
,20170123,3722,3722,3462,3462,3462,3462,3462,-260,-260,10,34.62,0
,20170124,3462,3462,,,,3362,3362,-100,-100,0,0.00,0
,20170125,3362,3362,,,,3362,3362,0,0,0,0.00,0
,20170126,3362,3362,,,,3334,3334,-28,-28,0,0.00,0
,20170203,3334,3334,,,,3334,3334,0,0,0,0.00,0
,20170206,3334,3334,,,,3334,3334,0,0,0,0.00,0
,20170207,3334,3334,,,,3334,3334,0,0,0,0.00,0
,20170208,3334,3334,3567,3567,3567,3567,3567,233,233,30,107.01,30
,20170209,3567,3567,3670,3671,3670,3670,3670,103,103,34,124.81,34
,20170210,3670,3670,,,,3670,3670,0,0,0,0.00,34
,20170213,3670,3670,3800,3800,3796,3796,3796,126,126,34,129.08,30
,20170214,3796,3796,,,,3796,3796,0,0,0,0.00,30
,20170215,3796,3796,,,,3760,3760,-36,-36,0,0.00,30
,20170216,3760,3760,,,,3760,3760,0,0,0,0.00,30
,20170217,3760,3760,3820,3820,3820,3820,3820,60,60,30,114.60,0
,20170220,3820,3820,,,,3820,3820,0,0,0,0.00,0
,20170221,3820,3820,,,,3820,3820,0,0,0,0.00,0
,20170222,3820,3820,4087,4087,3852,4049,4001,229,181,18,72.02,6
,20170223,4049,4001,,,,4001,4001,0,0,0,0.00,6
,20170224,4001,4001,,,,4001,4001,0,0,0,0.00,6
,20170227,4001,4001,3873,3873,3873,3873,3873,-128,-128,2,7.75,4
,20170228,3873,3873,4140,4140,3601,3601,3870,-272,-3,4,15.48,0
,20170301,3601,3870,,,,3870,3870,0,0,0,0.00,0
,20170302,3870,3870,,,,3870,3870,0,0,0,0.00,0
,20170303,3870,3870,,,,3870,3870,0,0,0,0.00,0
,20170306,3870,3870,,,,3870,3870,0,0,0,0.00,0
,20170307,3870,3870,,,,3870,3870,0,0,0,0.00,0
,20170308,3870,3870,,,,3870,3870,0,0,0,0.00,0
,20170309,3870,3870,,,,3870,3870,0,0,0,0.00,0
,20170310,3870,3870,,,,3870,3870,0,0,0,0.00,0
,20170313,3870,3870,,,,3870,3870,0,0,0,0.00,0
,20170314,3870,3870,,,,3870,3870,0,0,0,0.00,0
,20170315,3870,3870,,,,3870,3870,0,0,0,0.00,0
hc1704,20170103,3372,3372,3286,3399,3286,3399,3342,27,-30,8,26.74,0
,20170104,3399,3342,,,,3342,3342,0,0,0,0.00,0
,20170105,3342,3342,,,,3342,3342,0,0,0,0.00,0
,20170106,3342,3342,,,,3342,3342,0,0,0,0.00,0
,20170109,3342,3342,,,,3342,3342,0,0,0,0.00,0
,20170110,3342,3342,,,,3357,3357,15,15,0,0.00,0
,20170111,3357,3357,,,,3427,3427,70,70,0,0.00,0
,20170112,3427,3427,,,,3418,3418,-9,-9,0,0.00,0
,20170113,3418,3418,,,,3403,3403,-15,-15,0,0.00,0
,20170116,3403,3403,,,,3640,3640,237,237,0,0.00,0
,20170117,3640,3640,3718,3718,3718,3718,3718,78,78,40,148.72,40
,20170118,3718,3718,,,,3718,3718,0,0,0,0.00,40
,20170119,3718,3718,,,,3718,3718,0,0,0,0.00,40
,20170120,3718,3718,3488,3488,3488,3488,3488,-230,-230,4,13.95,40
,20170123,3488,3488,3449,3449,3449,3449,3449,-39,-39,36,124.16,4
,20170124,3449,3449,,,,3350,3350,-99,-99,0,0.00,4
,20170125,3350,3350,3506,3538,3502,3532,3515,182,165,12,42.18,6
,20170126,3532,3515,,,,3485,3485,-30,-30,0,0.00,6
,20170203,3485,3485,3503,3503,3470,3481,3491,-4,6,10,34.92,4
,20170206,3481,3491,,,,3491,3491,0,0,0,0.00,4
,20170207,3491,3491,,,,3491,3491,0,0,0,0.00,4
,20170208,3491,3491,,,,3734,3734,243,243,0,0.00,4
,20170209,3734,3734,,,,3842,3842,108,108,0,0.00,4
,20170210,3842,3842,,,,3842,3842,0,0,0,0.00,4
,20170213,3842,3842,,,,3842,3842,0,0,0,0.00,4
,20170214,3842,3842,,,,3842,3842,0,0,0,0.00,4
,20170215,3842,3842,3586,3754,3586,3754,3670,-88,-172,4,14.68,2
,20170216,3754,3670,,,,3670,3670,0,0,0,0.00,2
,20170217,3670,3670,,,,3728,3728,58,58,0,0.00,2
,20170220,3728,3728,,,,3728,3728,0,0,0,0.00,2
,20170221,3728,3728,,,,3728,3728,0,0,0,0.00,2
,20170222,3728,3728,,,,3728,3728,0,0,0,0.00,2
,20170223,3728,3728,,,,3728,3728,0,0,0,0.00,2
,20170224,3728,3728,,,,3728,3728,0,0,0,0.00,2
,20170227,3728,3728,,,,3728,3728,0,0,0,0.00,2
,20170228,3728,3728,,,,3725,3725,-3,-3,0,0.00,2
,20170301,3725,3725,,,,3725,3725,0,0,0,0.00,2
,20170302,3725,3725,,,,3725,3725,0,0,0,0.00,2
,20170303,3725,3725,3474,3566,3474,3566,3517,-159,-208,22,77.39,0
,20170306,3566,3517,,,,3517,3517,0,0,0,0.00,0
,20170307,3517,3517,,,,3517,3517,0,0,0,0.00,0
,20170308,3517,3517,,,,3517,3517,0,0,0,0.00,0
,20170309,3517,3517,,,,3517,3517,0,0,0,0.00,0
,20170310,3517,3517,,,,3517,3517,0,0,0,0.00,0
,20170313,3517,3517,,,,3517,3517,0,0,0,0.00,0
,20170314,3517,3517,,,,3517,3517,0,0,0,0.00,0
,20170315,3517,3517,,,,3517,3517,0,0,0,0.00,0
,20170316,3517,3517,,,,3517,3517,0,0,0,0.00,0
,20170317,3517,3517,,,,3517,3517,0,0,0,0.00,0
,20170320,3517,3517,,,,3517,3517,0,0,0,0.00,0
,20170321,3517,3517,,,,3517,3517,0,0,0,0.00,0
,20170322,3517,3517,,,,3517,3517,0,0,0,0.00,0
,20170323,3517,3517,,,,3517,3517,0,0,0,0.00,0
,20170324,3517,3517,,,,3517,3517,0,0,0,0.00,0
,20170327,3517,3517,,,,3517,3517,0,0,0,0.00,0
,20170328,3517,3517,,,,3517,3517,0,0,0,0.00,0
,20170329,3517,3517,,,,3517,3517,0,0,0,0.00,0
,20170330,3517,3517,,,,3517,3517,0,0,0,0.00,0
,20170331,3517,3517,,,,3517,3517,0,0,0,0.00,0
,20170405,3517,3517,,,,3517,3517,0,0,0,0.00,0
,20170406,3517,3517,,,,3517,3517,0,0,0,0.00,0
,20170407,3517,3517,,,,3517,3517,0,0,0,0.00,0
,20170410,3517,3517,,,,3517,3517,0,0,0,0.00,0
,20170411,3517,3517,,,,3517,3517,0,0,0,0.00,0
,20170412,3517,3517,,,,3517,3517,0,0,0,0.00,0
,20170413,3517,3517,,,,3517,3517,0,0,0,0.00,0
,20170414,3517,3517,,,,3517,3517,0,0,0,0.00,0
,20170417,3517,3517,,,,3517,3517,0,0,0,0.00,0
hc1705,20170103,3305,3329,3309,3401,3285,3298,3353,-31,24,251094,"842,010.70",365012
,20170104,3298,3353,3305,3388,3263,3370,3329,17,-24,359388,"1,196,652.81",376186
,20170105,3370,3329,3370,3420,3334,3358,3377,29,48,305690,"1,032,535.02",368132
,20170106,3358,3377,3360,3378,3256,3273,3325,-104,-52,427108,"1,420,416.68",403038
,20170109,3273,3325,3275,3465,3250,3449,3329,124,4,361934,"1,205,239.27",369388
,20170110,3449,3329,3446,3562,3415,3562,3486,233,157,355268,"1,238,515.49",370682
,20170111,3562,3486,3566,3595,3501,3569,3564,83,78,258764,"922,369.97",352188
,20170112,3569,3564,3546,3658,3542,3592,3604,28,40,300084,"1,081,723.83",360734
,20170113,3592,3604,3595,3627,3531,3566,3577,-38,-27,278424,"996,143.15",355414
,20170116,3566,3577,3566,3778,3550,3721,3689,144,112,344330,"1,270,243.27",371840
,20170117,3721,3689,3730,3758,3575,3629,3664,-60,-25,298790,"1,094,876.59",336686
,20170118,3629,3664,3637,3709,3597,3622,3638,-42,-26,244624,"890,163.95",339220
,20170119,3622,3638,3612,3635,3503,3551,3552,-87,-86,394556,"1,401,851.10",353554
,20170120,3551,3552,3530,3588,3451,3452,3526,-100,-26,262572,"925,969.08",348554
,20170123,3452,3526,3430,3505,3420,3462,3461,-64,-65,216014,"747,727.25",338214
,20170124,3462,3461,3446,3631,3446,3585,3555,124,94,280846,"998,413.70",326030
,20170125,3585,3555,3612,3612,3527,3600,3575,45,20,172702,"617,421.02",294494
,20170126,3600,3575,3600,3675,3591,3660,3643,85,68,192214,"700,281.06",295062
,20170203,3660,3643,3656,3656,3353,3382,3447,-261,-196,256076,"882,872.57",327960
,20170206,3382,3447,3350,3410,3340,3385,3382,-62,-65,233126,"788,481.08",334514
,20170207,3385,3382,3390,3485,3378,3469,3437,87,55,272670,"937,314.78",337782
,20170208,3469,3437,3460,3544,3430,3533,3496,96,59,240222,"839,919.57",328120
,20170209,3533,3496,3511,3575,3485,3489,3535,-7,39,238866,"844,439.34",335576
,20170210,3489,3535,3480,3684,3464,3620,3576,85,41,403074,"1,441,394.07",340464
,20170213,3620,3576,3639,3734,3623,3730,3685,154,109,250520,"923,288.59",331914
,20170214,3730,3685,3734,3750,3670,3728,3708,43,23,175802,"651,951.86",323006
,20170215,3728,3708,3724,3742,3651,3677,3698,-31,-10,240880,"890,832.82",331776
,20170216,3677,3698,3671,3788,3628,3653,3701,-45,3,346670,"1,283,141.02",335784
,20170217,3653,3701,3653,3755,3653,3741,3718,40,17,261706,"973,189.51",326020
,20170220,3741,3718,3756,3795,3708,3762,3752,44,34,323244,"1,212,935.03",330732
,20170221,3762,3752,3773,3844,3759,3780,3796,28,44,278712,"1,058,157.15",316522
,20170222,3780,3796,3777,3792,3647,3679,3706,-117,-90,362494,"1,343,509.59",352808
,20170223,3679,3706,3666,3708,3581,3608,3653,-98,-53,328150,"1,199,051.98",348952
,20170224,3608,3653,3620,3641,3470,3591,3549,-62,-104,481646,"1,709,817.42",368580
,20170227,3591,3549,3595,3755,3576,3728,3683,179,134,391194,"1,440,850.02",325158
,20170228,3728,3683,3732,3732,3545,3549,3661,-134,-22,406384,"1,487,807.50",361478
,20170301,3549,3661,3551,3641,3549,3594,3588,-67,-73,402018,"1,442,682.68",365252
,20170302,3594,3588,3599,3628,3555,3579,3588,-9,0,383166,"1,374,977.60",395852
,20170303,3579,3588,3585,3586,3450,3573,3514,-15,-74,464134,"1,631,389.35",432894
,20170306,3573,3514,3573,3585,3431,3467,3494,-47,-20,567930,"1,984,664.04",467692
,20170307,3467,3494,3449,3500,3443,3478,3469,-16,-25,299012,"1,037,424.56",429816
,20170308,3478,3469,3478,3487,3402,3423,3446,-46,-23,355630,"1,225,570.15",448244
,20170309,3423,3446,3420,3427,3330,3372,3375,-74,-71,327586,"1,105,920.17",424992
,20170310,3372,3375,3361,3468,3361,3423,3423,48,48,435588,"1,491,273.55",421022
,20170313,3423,3423,3426,3580,3385,3570,3467,147,44,483696,"1,677,238.44",416442
,20170314,3570,3467,3570,3580,3501,3538,3539,71,72,288230,"1,020,202.58",388456
,20170315,3538,3539,3520,3640,3505,3596,3577,57,38,387062,"1,384,662.67",403590
,20170316,3596,3577,3597,3630,3519,3578,3567,1,-10,303120,"1,081,484.55",403758
,20170317,3578,3567,3570,3608,3515,3542,3560,-25,-7,303828,"1,081,767.36",394460
,20170320,3542,3560,3545,3613,3520,3533,3565,-27,5,305920,"1,090,868.55",412998
,20170321,3533,3565,3525,3535,3440,3453,3487,-112,-78,344718,"1,202,172.81",369824
,20170322,3453,3487,3440,3453,3340,3358,3395,-129,-92,279036,"947,557.08",372700
,20170323,3358,3395,3361,3406,3344,3346,3375,-49,-20,193634,"653,654.30",356542
,20170324,3346,3375,3350,3401,3298,3353,3355,-22,-20,277550,"931,343.60",362340
,20170327,3353,3355,3349,3352,3156,3229,3243,-126,-112,272434,"883,656.51",331198
,20170328,3229,3243,3233,3279,3200,3217,3242,-26,-1,191414,"620,748.62",311022
,20170329,3217,3242,3220,3319,3220,3307,3271,65,29,145860,"477,193.52",291650
,20170330,3307,3271,3300,3319,3281,3300,3301,29,30,117296,"387,285.93",266566
,20170331,3300,3301,3294,3345,3270,3297,3306,-4,5,119596,"395,386.14",258668
,20170405,3297,3306,3312,3450,3312,3316,3342,10,36,79712,"266,447.36",240452
,20170406,3316,3342,3332,3332,3276,3294,3304,-48,-38,83604,"276,271.77",211958
,20170407,3294,3304,3271,3280,3208,3245,3249,-59,-55,97982,"318,362.57",188266
,20170410,3245,3249,3238,3268,3221,3223,3245,-26,-4,48150,"156,294.42",176584
,20170411,3223,3245,3221,3221,3150,3170,3187,-75,-58,46148,"147,079.16",167138
,20170412,3170,3187,3151,3168,3026,3028,3081,-159,-106,65124,"200,707.32",154894
,20170413,3028,3081,3026,3085,3018,3048,3053,-33,-28,59126,"180,556.23",132346
,20170414,3048,3053,3056,3129,3056,3089,3094,36,41,40170,"124,302.56",123486
,20170417,3089,3094,3094,3159,3051,3102,3106,8,12,37462,"116,393.08",111472
,20170418,3102,3106,3087,3105,2990,2998,3040,-108,-66,39028,"118,666.45",99270
,20170419,2998,3040,3001,3045,3000,3007,3019,-33,-21,27712,"83,690.19",87274
,20170420,3007,3019,3015,3075,2941,3026,2997,7,-22,30506,"91,439.98",79462
,20170421,3026,2997,3026,3068,3005,3035,3039,38,42,21990,"66,847.26",74796
,20170424,3035,3039,3031,3048,2982,3029,3013,-10,-26,26348,"79,395.52",59484
,20170425,3029,3013,3040,3074,3030,3061,3052,48,39,20112,"61,397.79",47446
,20170426,3061,3052,3061,3172,3048,3128,3105,76,53,20890,"64,864.27",34506
,20170427,3128,3105,3109,3141,3101,3123,3121,18,16,14652,"45,737.10",27714
,20170428,3123,3121,3120,3195,3117,3195,3133,74,12,22466,"70,405.60",17808
,20170502,3195,3133,3196,3208,3160,3180,3189,47,56,2868,"9,148.90",15720
,20170503,3180,3189,3167,3170,3123,3141,3143,-48,-46,3480,"10,939.50",13200
,20170504,3141,3143,3110,3110,2936,2950,2995,-193,-148,4740,"14,197.02",11640
,20170505,2950,2995,2950,2978,2916,2934,2947,-61,-48,3840,"11,317.98",10560
,20170508,2934,2947,2990,3010,2950,2975,2980,28,33,4020,"11,981.52",9720
,20170509,2975,2980,2980,3026,2950,2980,2974,0,-6,2220,"6,604.20",8820
,20170510,2980,2974,3015,3050,2980,3021,3012,47,38,1260,"3,796.14",8340
,20170511,3021,3012,3026,3030,3000,3030,3015,18,3,540,"1,628.46",8340
,20170512,3030,3015,3009,3009,3008,3009,3008,-6,-7,360,"1,083.06",7980
,20170515,3009,3008,3050,3180,3050,3180,3110,172,102,180,559.80,7920
hc1706,20170103,3380,3380,3369,3369,3262,3366,3354,-14,-26,16,53.67,64
,20170104,3366,3354,3349,3349,3349,3349,3349,-5,-5,2,6.70,64
,20170105,3349,3349,3261,3261,3261,3261,3261,-88,-88,8,26.09,64
,20170106,3261,3261,,,,3261,3261,0,0,0,0.00,64
,20170109,3261,3261,3274,3274,3190,3262,3242,1,-19,12,38.90,64
,20170110,3262,3242,3449,3468,3449,3468,3449,226,207,52,179.39,62
,20170111,3468,3449,3515,3515,3515,3515,3515,66,66,4,14.06,58
,20170112,3515,3515,3548,3548,3485,3485,3516,-30,1,4,14.07,56
,20170113,3485,3516,,,,3503,3503,-13,-13,0,0.00,56
,20170116,3503,3503,3698,3698,3583,3583,3640,80,137,12,43.69,52
,20170117,3583,3640,3523,3605,3523,3524,3544,-116,-96,8,28.36,48
,20170118,3524,3544,,,,3544,3544,0,0,0,0.00,48
,20170119,3544,3544,3457,3521,3457,3521,3489,-23,-55,4,13.96,48
,20170120,3521,3489,,,,3470,3470,-19,-19,0,0.00,48
,20170123,3470,3470,3478,3478,3330,3399,3402,-71,-68,6,20.41,48
,20170124,3399,3402,3399,3399,3367,3367,3383,-35,-19,4,13.53,50
,20170125,3367,3383,3569,3569,3467,3467,3518,84,135,4,14.07,48
,20170126,3467,3518,,,,3518,3518,0,0,0,0.00,48
,20170203,3518,3518,,,,3329,3329,-189,-189,0,0.00,48
,20170206,3329,3329,,,,3329,3329,0,0,0,0.00,48
,20170207,3329,3329,,,,3329,3329,0,0,0,0.00,48
,20170208,3329,3329,,,,3430,3430,101,101,0,0.00,48
,20170209,3430,3430,,,,3430,3430,0,0,0,0.00,48
,20170210,3430,3430,,,,3520,3520,90,90,0,0.00,48
,20170213,3520,3520,3620,3660,3620,3660,3658,140,138,46,168.28,48
,20170214,3660,3658,,,,3658,3658,0,0,0,0.00,48
,20170215,3658,3658,3645,3645,3645,3645,3645,-13,-13,12,43.74,60
,20170216,3645,3645,3603,3603,3603,3603,3603,-42,-42,4,14.41,56
,20170217,3603,3603,,,,3603,3603,0,0,0,0.00,56
,20170220,3603,3603,3757,3758,3757,3758,3757,155,154,8,30.06,64
,20170221,3758,3757,,,,3757,3757,0,0,0,0.00,64
,20170222,3757,3757,,,,3757,3757,0,0,0,0.00,64
,20170223,3757,3757,3710,3710,3620,3689,3673,-68,-84,6,22.04,64
,20170224,3689,3673,,,,3673,3673,0,0,0,0.00,64
,20170227,3673,3673,3688,3688,3599,3599,3643,-74,-30,4,14.57,64
,20170228,3599,3643,,,,3643,3643,0,0,0,0.00,64
,20170301,3643,3643,3499,3599,3499,3599,3549,-44,-94,4,14.20,64
,20170302,3599,3549,,,,3549,3549,0,0,0,0.00,64
,20170303,3549,3549,,,,3549,3549,0,0,0,0.00,64
,20170306,3549,3549,3505,3505,3505,3505,3505,-44,-44,2,7.01,64
,20170307,3505,3505,3423,3535,3423,3535,3469,30,-36,82,284.47,68
,20170308,3535,3469,3478,3478,3428,3428,3453,-41,-16,4,13.81,64
,20170309,3428,3453,3334,3457,3324,3427,3394,-26,-59,10,33.94,66
,20170310,3427,3394,,,,3394,3394,0,0,0,0.00,66
,20170313,3394,3394,,,,3438,3438,44,44,0,0.00,66
,20170314,3438,3438,,,,3438,3438,0,0,0,0.00,66
,20170315,3438,3438,,,,3502,3502,64,64,0,0.00,66
,20170316,3502,3502,3443,3443,3443,3443,3443,-59,-59,2,6.89,66
,20170317,3443,3443,,,,3477,3477,34,34,0,0.00,66
,20170320,3477,3477,3528,3638,3463,3463,3524,-14,47,24,84.59,66
,20170321,3463,3524,3558,3558,3425,3425,3505,-99,-19,26,91.15,66
,20170322,3425,3505,,,,3413,3413,-92,-92,0,0.00,66
,20170323,3413,3413,3424,3424,3306,3340,3369,-73,-44,16,53.92,64
,20170324,3340,3369,,,,3369,3369,0,0,0,0.00,64
,20170327,3369,3369,,,,3369,3369,0,0,0,0.00,64
,20170328,3369,3369,3244,3244,3213,3213,3223,-156,-146,6,19.34,64
,20170329,3213,3223,,,,3252,3252,29,29,0,0.00,64
,20170330,3252,3252,,,,3282,3282,30,30,0,0.00,64
,20170331,3282,3282,,,,3282,3282,0,0,0,0.00,64
,20170405,3282,3282,,,,3282,3282,0,0,0,0.00,64
,20170406,3282,3282,,,,3282,3282,0,0,0,0.00,64
,20170407,3282,3282,,,,3227,3227,-55,-55,0,0.00,64
,20170410,3227,3227,3120,3256,3120,3184,3186,-43,-41,6,19.12,64
,20170411,3184,3186,3186,3250,3125,3125,3207,-61,21,24,76.98,66
,20170412,3125,3207,,,,3101,3101,-106,-106,0,0.00,66
,20170413,3101,3101,,,,3101,3101,0,0,0,0.00,66
,20170414,3101,3101,3041,3189,3041,3067,3101,-34,0,14,43.42,68
,20170417,3067,3101,2997,3126,2997,3093,3080,-8,-21,50,154.04,66
,20170418,3093,3080,,,,3080,3080,0,0,0,0.00,66
,20170419,3080,3080,3002,3002,3002,3002,3002,-78,-78,2,6.00,68
,20170420,3002,3002,,,,2980,2980,-22,-22,0,0.00,68
,20170421,2980,2980,3022,3022,3022,3022,3022,42,42,12,36.26,68
,20170424,3022,3022,2995,3060,2933,2999,3007,-23,-15,88,264.65,66
,20170425,2999,3007,3015,3121,3015,3041,3062,34,55,54,165.35,98
,20170426,3041,3062,3049,3083,3046,3083,3062,21,0,38,116.38,88
,20170427,3083,3062,3090,3090,3001,3048,3046,-14,-16,8,24.37,84
,20170428,3048,3046,3031,3217,3031,3180,3142,134,96,40,125.69,66
,20170502,3180,3142,,,,3199,3199,57,57,0,0.00,66
,20170503,3199,3199,,,,3176,3176,-23,-23,0,0.00,66
,20170504,3176,3176,2993,3074,2953,2953,3026,-223,-150,402,"1,216.71",70
,20170505,2953,3026,2891,2891,2891,2891,2891,-135,-135,2,5.78,68
,20170508,2891,2891,3000,3000,2974,2974,2987,83,96,4,11.95,68
,20170509,2974,2987,,,,2981,2981,-6,-6,0,0.00,68
,20170510,2981,2981,,,,3019,3019,38,38,0,0.00,68
,20170511,3019,3019,,,,3022,3022,3,3,0,0.00,68
,20170512,3022,3022,,,,3015,3015,-7,-7,0,0.00,68
,20170515,3015,3015,,,,3117,3117,102,102,0,0.00,68
,20170516,3117,3117,,,,3117,3117,0,0,0,0.00,68
,20170517,3117,3117,,,,3117,3117,0,0,0,0.00,68
,20170518,3117,3117,,,,3117,3117,0,0,0,0.00,68
,20170519,3117,3117,3178,3178,3057,3057,3117,-60,0,4,12.47,66
,20170522,3057,3117,3200,3200,3200,3200,3200,83,83,2,6.40,64
,20170523,3200,3200,,,,3200,3200,0,0,0,0.00,64
,20170524,3200,3200,3221,3221,3221,3221,3221,21,21,2,6.44,64
,20170525,3221,3221,,,,3221,3221,0,0,0,0.00,64
,20170526,3221,3221,,,,3221,3221,0,0,0,0.00,64
,20170531,3221,3221,3221,3221,3046,3046,3133,-175,-88,4,12.53,60
,20170601,3046,3133,,,,3133,3133,0,0,0,0.00,60
,20170602,3133,3133,,,,3133,3133,0,0,0,0.00,60
,20170605,3133,3133,,,,3133,3133,0,0,0,0.00,60
,20170606,3133,3133,,,,3133,3133,0,0,0,0.00,60
,20170607,3133,3133,,,,3133,3133,0,0,0,0.00,60
,20170608,3133,3133,,,,3133,3133,0,0,0,0.00,60
,20170609,3133,3133,,,,3133,3133,0,0,0,0.00,60
,20170612,3133,3133,,,,3133,3133,0,0,0,0.00,60
,20170613,3133,3133,,,,3133,3133,0,0,0,0.00,60
,20170614,3133,3133,,,,3133,3133,0,0,0,0.00,60
,20170615,3133,3133,,,,3133,3133,0,0,0,0.00,60
hc1707,20170103,3204,3204,,,,3179,3179,-25,-25,0,0.00,4
,20170104,3179,3179,,,,3174,3174,-5,-5,0,0.00,4
,20170105,3174,3174,3345,3345,3317,3317,3334,143,160,10,33.34,8
,20170106,3317,3334,,,,3334,3334,0,0,0,0.00,8
,20170109,3334,3334,,,,3334,3334,0,0,0,0.00,8
,20170110,3334,3334,,,,3547,3547,213,213,0,0.00,8
,20170111,3547,3547,,,,3547,3547,0,0,0,0.00,8
,20170112,3547,3547,,,,3547,3547,0,0,0,0.00,8
,20170113,3547,3547,,,,3547,3547,0,0,0,0.00,8
,20170116,3547,3547,,,,3686,3686,139,139,0,0.00,8
,20170117,3686,3686,,,,3686,3686,0,0,0,0.00,8
,20170118,3686,3686,,,,3686,3686,0,0,0,0.00,8
,20170119,3686,3686,,,,3628,3628,-58,-58,0,0.00,8
,20170120,3628,3628,,,,3628,3628,0,0,0,0.00,8
,20170123,3628,3628,,,,3557,3557,-71,-71,0,0.00,8
,20170124,3557,3557,,,,3557,3557,0,0,0,0.00,8
,20170125,3557,3557,,,,3557,3557,0,0,0,0.00,8
,20170126,3557,3557,,,,3557,3557,0,0,0,0.00,8
,20170203,3557,3557,,,,3557,3557,0,0,0,0.00,8
,20170206,3557,3557,,,,3490,3490,-67,-67,0,0.00,8
,20170207,3490,3490,,,,3490,3490,0,0,0,0.00,8
,20170208,3490,3490,,,,3490,3490,0,0,0,0.00,8
,20170209,3490,3490,,,,3490,3490,0,0,0,0.00,8
,20170210,3490,3490,3490,3490,3490,3490,3490,0,0,4,13.96,8
,20170213,3490,3490,,,,3627,3627,137,137,0,0.00,8
,20170214,3627,3627,,,,3627,3627,0,0,0,0.00,8
,20170215,3627,3627,,,,3627,3627,0,0,0,0.00,8
,20170216,3627,3627,,,,3627,3627,0,0,0,0.00,8
,20170217,3627,3627,,,,3627,3627,0,0,0,0.00,8
,20170220,3627,3627,,,,3627,3627,0,0,0,0.00,8
,20170221,3627,3627,,,,3627,3627,0,0,0,0.00,8
,20170222,3627,3627,,,,3627,3627,0,0,0,0.00,8
,20170223,3627,3627,,,,3627,3627,0,0,0,0.00,8
,20170224,3627,3627,3538,3538,3538,3538,3538,-89,-89,4,14.15,4
,20170227,3538,3538,,,,3509,3509,-29,-29,0,0.00,4
,20170228,3509,3509,,,,3509,3509,0,0,0,0.00,4
,20170301,3509,3509,,,,3509,3509,0,0,0,0.00,4
,20170302,3509,3509,,,,3509,3509,0,0,0,0.00,4
,20170303,3509,3509,,,,3509,3509,0,0,0,0.00,4
,20170306,3509,3509,,,,3509,3509,0,0,0,0.00,4
,20170307,3509,3509,3479,3479,3364,3364,3421,-145,-88,4,13.69,4
,20170308,3364,3421,,,,3421,3421,0,0,0,0.00,4
,20170309,3421,3421,,,,3362,3362,-59,-59,0,0.00,4
,20170310,3362,3362,,,,3362,3362,0,0,0,0.00,4
,20170313,3362,3362,,,,3405,3405,43,43,0,0.00,4
,20170314,3405,3405,,,,3405,3405,0,0,0,0.00,4
,20170315,3405,3405,,,,3441,3441,36,36,0,0.00,4
,20170316,3441,3441,,,,3383,3383,-58,-58,0,0.00,4
,20170317,3383,3383,,,,3376,3376,-7,-7,0,0.00,4
,20170320,3376,3376,,,,3422,3422,46,46,0,0.00,4
,20170321,3422,3422,,,,3404,3404,-18,-18,0,0.00,4
,20170322,3404,3404,,,,3314,3314,-90,-90,0,0.00,4
,20170323,3314,3314,,,,3314,3314,0,0,0,0.00,4
,20170324,3314,3314,,,,3314,3314,0,0,0,0.00,4
,20170327,3314,3314,,,,3203,3203,-111,-111,0,0.00,4
,20170328,3203,3203,,,,3064,3064,-139,-139,0,0.00,4
,20170329,3064,3064,3278,3278,3176,3276,3252,212,188,8,26.02,4
,20170330,3276,3252,,,,3252,3252,0,0,0,0.00,4
,20170331,3252,3252,,,,3252,3252,0,0,0,0.00,4
,20170405,3252,3252,,,,3252,3252,0,0,0,0.00,4
,20170406,3252,3252,,,,3252,3252,0,0,0,0.00,4
,20170407,3252,3252,,,,3198,3198,-54,-54,0,0.00,4
,20170410,3198,3198,,,,3158,3158,-40,-40,0,0.00,4
,20170411,3158,3158,,,,3179,3179,21,21,0,0.00,4
,20170412,3179,3179,3033,3033,3017,3017,3025,-162,-154,6,18.15,6
,20170413,3017,3025,3032,3032,3026,3026,3030,1,5,6,18.18,0
,20170414,3026,3030,,,,3030,3030,0,0,0,0.00,0
,20170417,3030,3030,,,,3010,3010,-20,-20,0,0.00,0
,20170418,3010,3010,,,,2946,2946,-64,-64,0,0.00,0
,20170419,2946,2946,,,,2871,2871,-75,-75,0,0.00,0
,20170420,2871,2871,,,,2850,2850,-21,-21,0,0.00,0
,20170421,2850,2850,,,,2890,2890,40,40,0,0.00,0
,20170424,2890,2890,,,,2876,2876,-14,-14,0,0.00,0
,20170425,2876,2876,,,,2928,2928,52,52,0,0.00,0
,20170426,2928,2928,,,,2928,2928,0,0,0,0.00,0
,20170427,2928,2928,,,,2913,2913,-15,-15,0,0.00,0
,20170428,2913,2913,,,,3004,3004,91,91,0,0.00,0
,20170502,3004,3004,,,,3058,3058,54,54,0,0.00,0
,20170503,3058,3058,,,,3058,3058,0,0,0,0.00,0
,20170504,3058,3058,,,,2914,2914,-144,-144,0,0.00,0
,20170505,2914,2914,,,,2783,2783,-131,-131,0,0.00,0
,20170508,2783,2783,,,,2875,2875,92,92,0,0.00,0
,20170509,2875,2875,,,,2875,2875,0,0,0,0.00,0
,20170510,2875,2875,2875,2964,2875,2964,2919,89,44,4,11.68,2
,20170511,2964,2919,,,,2922,2922,3,3,0,0.00,2
,20170512,2922,2922,,,,2915,2915,-7,-7,0,0.00,2
,20170515,2915,2915,,,,2915,2915,0,0,0,0.00,2
,20170516,2915,2915,,,,2915,2915,0,0,0,0.00,2
,20170517,2915,2915,3025,3025,3025,3025,3025,110,110,2,6.05,0
,20170518,3025,3025,,,,3025,3025,0,0,0,0.00,0
,20170519,3025,3025,,,,3025,3025,0,0,0,0.00,0
,20170522,3025,3025,3236,3236,3126,3175,3193,150,168,198,632.29,6
,20170523,3175,3193,3193,3193,3193,3193,3193,0,0,6,19.16,0
,20170524,3193,3193,,,,3213,3213,20,20,0,0.00,0
,20170525,3213,3213,,,,3213,3213,0,0,0,0.00,0
,20170526,3213,3213,,,,3213,3213,0,0,0,0.00,0
,20170531,3213,3213,,,,3125,3125,-88,-88,0,0.00,0
,20170601,3125,3125,,,,3125,3125,0,0,0,0.00,0
,20170602,3125,3125,,,,3125,3125,0,0,0,0.00,0
,20170605,3125,3125,,,,3125,3125,0,0,0,0.00,0
,20170606,3125,3125,,,,3125,3125,0,0,0,0.00,0
,20170607,3125,3125,2947,3094,2947,3094,3020,-31,-105,4,12.08,2
,20170608,3094,3020,,,,3020,3020,0,0,0,0.00,2
,20170609,3020,3020,,,,3020,3020,0,0,0,0.00,2
,20170612,3020,3020,,,,3020,3020,0,0,0,0.00,2
,20170613,3020,3020,3201,3201,3079,3150,3142,130,122,16,50.28,0
,20170614,3150,3142,,,,3142,3142,0,0,0,0.00,0
,20170615,3142,3142,,,,3142,3142,0,0,0,0.00,0
,20170616,3142,3142,3330,3330,3121,3121,3225,-21,83,4,12.90,0
,20170619,3121,3225,,,,3225,3225,0,0,0,0.00,0
,20170620,3225,3225,,,,3225,3225,0,0,0,0.00,0
,20170621,3225,3225,,,,3225,3225,0,0,0,0.00,0
,20170622,3225,3225,,,,3225,3225,0,0,0,0.00,0
,20170623,3225,3225,,,,3225,3225,0,0,0,0.00,0
,20170626,3225,3225,3308,3418,3307,3418,3373,193,148,66,222.67,22
,20170627,3418,3373,3380,3556,3380,3556,3519,183,146,16,56.31,8
,20170628,3556,3519,3521,3521,3521,3521,3521,2,2,2,7.04,6
,20170629,3521,3521,3406,3728,3342,3407,3553,-114,32,94,334.00,2
,20170630,3407,3553,3691,3699,3401,3500,3560,-53,7,12,42.72,0
,20170703,3500,3560,,,,3560,3560,0,0,0,0.00,0
,20170704,3560,3560,,,,3560,3560,0,0,0,0.00,0
,20170705,3560,3560,,,,3560,3560,0,0,0,0.00,0
,20170706,3560,3560,,,,3560,3560,0,0,0,0.00,0
,20170707,3560,3560,,,,3560,3560,0,0,0,0.00,0
,20170710,3560,3560,,,,3560,3560,0,0,0,0.00,0
,20170711,3560,3560,,,,3560,3560,0,0,0,0.00,0
,20170712,3560,3560,,,,3560,3560,0,0,0,0.00,0
,20170713,3560,3560,,,,3560,3560,0,0,0,0.00,0
,20170714,3560,3560,,,,3560,3560,0,0,0,0.00,0
,20170717,3560,3560,,,,3560,3560,0,0,0,0.00,0
hc1708,20170103,3423,3423,,,,3397,3397,-26,-26,0,0.00,2
,20170104,3397,3397,,,,3397,3397,0,0,0,0.00,2
,20170105,3397,3397,,,,3397,3397,0,0,0,0.00,2
,20170106,3397,3397,,,,3397,3397,0,0,0,0.00,2
,20170109,3397,3397,,,,3397,3397,0,0,0,0.00,2
,20170110,3397,3397,,,,3614,3614,217,217,0,0.00,2
,20170111,3614,3614,,,,3614,3614,0,0,0,0.00,2
,20170112,3614,3614,,,,3614,3614,0,0,0,0.00,2
,20170113,3614,3614,,,,3614,3614,0,0,0,0.00,2
,20170116,3614,3614,,,,3614,3614,0,0,0,0.00,2
,20170117,3614,3614,,,,3614,3614,0,0,0,0.00,2
,20170118,3614,3614,,,,3614,3614,0,0,0,0.00,2
,20170119,3614,3614,,,,3557,3557,-57,-57,0,0.00,2
,20170120,3557,3557,,,,3557,3557,0,0,0,0.00,2
,20170123,3557,3557,,,,3557,3557,0,0,0,0.00,2
,20170124,3557,3557,,,,3557,3557,0,0,0,0.00,2
,20170125,3557,3557,,,,3557,3557,0,0,0,0.00,2
,20170126,3557,3557,,,,3624,3624,67,67,0,0.00,2
,20170203,3624,3624,,,,3429,3429,-195,-195,0,0.00,2
,20170206,3429,3429,,,,3429,3429,0,0,0,0.00,2
,20170207,3429,3429,,,,3429,3429,0,0,0,0.00,2
,20170208,3429,3429,,,,3429,3429,0,0,0,0.00,2
,20170209,3429,3429,,,,3429,3429,0,0,0,0.00,2
,20170210,3429,3429,,,,3429,3429,0,0,0,0.00,2
,20170213,3429,3429,,,,3563,3563,134,134,0,0.00,2
,20170214,3563,3563,3591,3697,3591,3697,3644,134,81,8,29.15,2
,20170215,3697,3644,,,,3644,3644,0,0,0,0.00,2
,20170216,3644,3644,,,,3644,3644,0,0,0,0.00,2
,20170217,3644,3644,,,,3644,3644,0,0,0,0.00,2
,20170220,3644,3644,,,,3644,3644,0,0,0,0.00,2
,20170221,3644,3644,,,,3644,3644,0,0,0,0.00,2
,20170222,3644,3644,,,,3644,3644,0,0,0,0.00,2
,20170223,3644,3644,,,,3644,3644,0,0,0,0.00,2
,20170224,3644,3644,,,,3554,3554,-90,-90,0,0.00,2
,20170227,3554,3554,,,,3525,3525,-29,-29,0,0.00,2
,20170228,3525,3525,,,,3525,3525,0,0,0,0.00,2
,20170301,3525,3525,,,,3434,3434,-91,-91,0,0.00,2
,20170302,3434,3434,,,,3434,3434,0,0,0,0.00,2
,20170303,3434,3434,,,,3364,3364,-70,-70,0,0.00,2
,20170306,3364,3364,,,,3364,3364,0,0,0,0.00,2
,20170307,3364,3364,,,,3364,3364,0,0,0,0.00,2
,20170308,3364,3364,3448,3448,3323,3323,3385,-41,21,4,13.54,2
,20170309,3323,3385,,,,3327,3327,-58,-58,0,0.00,2
,20170310,3327,3327,3424,3424,3314,3314,3369,-13,42,4,13.48,2
,20170313,3314,3369,3504,3504,3504,3504,3504,135,135,2,7.01,0
,20170314,3504,3504,,,,3504,3504,0,0,0,0.00,0
,20170315,3504,3504,,,,3541,3541,37,37,0,0.00,0
,20170316,3541,3541,,,,3481,3481,-60,-60,0,0.00,0
,20170317,3481,3481,,,,3474,3474,-7,-7,0,0.00,0
,20170320,3474,3474,,,,3521,3521,47,47,0,0.00,0
,20170321,3521,3521,,,,3502,3502,-19,-19,0,0.00,0
,20170322,3502,3502,,,,3410,3410,-92,-92,0,0.00,0
,20170323,3410,3410,,,,3366,3366,-44,-44,0,0.00,0
,20170324,3366,3366,,,,3346,3346,-20,-20,0,0.00,0
,20170327,3346,3346,,,,3234,3234,-112,-112,0,0.00,0
,20170328,3234,3234,,,,3094,3094,-140,-140,0,0.00,0
,20170329,3094,3094,,,,3283,3283,189,189,0,0.00,0
,20170330,3283,3283,,,,3283,3283,0,0,0,0.00,0
,20170331,3283,3283,,,,3287,3287,4,4,0,0.00,0
,20170405,3287,3287,,,,3323,3323,36,36,0,0.00,0
,20170406,3323,3323,,,,3285,3285,-38,-38,0,0.00,0
,20170407,3285,3285,,,,3230,3230,-55,-55,0,0.00,0
,20170410,3230,3230,,,,3189,3189,-41,-41,0,0.00,0
,20170411,3189,3189,,,,3210,3210,21,21,0,0.00,0
,20170412,3210,3210,3001,3001,3001,3001,3001,-209,-209,2,6.00,2
,20170413,3001,3001,3006,3006,3006,3006,3006,5,5,2,6.01,2
,20170414,3006,3006,,,,3006,3006,0,0,0,0.00,2
,20170417,3006,3006,,,,2986,2986,-20,-20,0,0.00,2
,20170418,2986,2986,,,,2923,2923,-63,-63,0,0.00,2
,20170419,2923,2923,,,,2848,2848,-75,-75,0,0.00,2
,20170420,2848,2848,,,,2827,2827,-21,-21,0,0.00,2
,20170421,2827,2827,,,,2866,2866,39,39,0,0.00,2
,20170424,2866,2866,,,,2852,2852,-14,-14,0,0.00,2
,20170425,2852,2852,,,,2904,2904,52,52,0,0.00,2
,20170426,2904,2904,,,,2904,2904,0,0,0,0.00,2
,20170427,2904,2904,,,,2889,2889,-15,-15,0,0.00,2
,20170428,2889,2889,3090,3091,3083,3091,3090,202,201,38,117.44,36
,20170502,3091,3090,3229,3229,3140,3140,3183,50,93,12,38.21,36
,20170503,3140,3183,,,,3137,3137,-46,-46,0,0.00,36
,20170504,3137,3137,3026,3046,2974,2974,3001,-163,-136,34,102.05,2
,20170505,2974,3001,,,,2867,2867,-134,-134,0,0.00,2
,20170508,2867,2867,,,,2962,2962,95,95,0,0.00,2
,20170509,2962,2962,,,,2956,2956,-6,-6,0,0.00,2
,20170510,2956,2956,,,,2956,2956,0,0,0,0.00,2
,20170511,2956,2956,,,,2956,2956,0,0,0,0.00,2
,20170512,2956,2956,2863,2863,2863,2863,2863,-93,-93,2,5.73,4
,20170515,2863,2863,,,,2960,2960,97,97,0,0.00,4
,20170516,2960,2960,,,,2960,2960,0,0,0,0.00,4
,20170517,2960,2960,,,,3071,3071,111,111,0,0.00,4
,20170518,3071,3071,,,,3071,3071,0,0,0,0.00,4
,20170519,3071,3071,,,,3071,3071,0,0,0,0.00,4
,20170522,3071,3071,3283,3283,3232,3232,3257,161,186,16,52.12,4
,20170523,3232,3257,,,,3257,3257,0,0,0,0.00,4
,20170524,3257,3257,,,,3278,3278,21,21,0,0.00,4
,20170525,3278,3278,,,,3278,3278,0,0,0,0.00,4
,20170526,3278,3278,,,,3278,3278,0,0,0,0.00,4
,20170531,3278,3278,3142,3142,3142,3142,3142,-136,-136,2,6.28,4
,20170601,3142,3142,,,,3142,3142,0,0,0,0.00,4
,20170602,3142,3142,,,,3142,3142,0,0,0,0.00,4
,20170605,3142,3142,,,,3142,3142,0,0,0,0.00,4
,20170606,3142,3142,,,,3142,3142,0,0,0,0.00,4
,20170607,3142,3142,,,,3036,3036,-106,-106,0,0.00,4
,20170608,3036,3036,,,,3036,3036,0,0,0,0.00,4
,20170609,3036,3036,,,,3036,3036,0,0,0,0.00,4
,20170612,3036,3036,,,,3036,3036,0,0,0,0.00,4
,20170613,3036,3036,,,,3159,3159,123,123,0,0.00,4
,20170614,3159,3159,3182,3182,3160,3160,3170,1,11,8,25.36,6
,20170615,3160,3170,,,,3170,3170,0,0,0,0.00,6
,20170616,3170,3170,,,,3254,3254,84,84,0,0.00,6
,20170619,3254,3254,,,,3254,3254,0,0,0,0.00,6
,20170620,3254,3254,,,,3254,3254,0,0,0,0.00,6
,20170621,3254,3254,,,,3254,3254,0,0,0,0.00,6
,20170622,3254,3254,,,,3254,3254,0,0,0,0.00,6
,20170623,3254,3254,3136,3329,3136,3329,3247,75,-7,10,32.47,6
,20170626,3329,3247,3248,3441,3222,3441,3333,194,86,172,573.38,54
,20170627,3441,3333,3455,3516,3455,3516,3495,183,162,128,447.43,22
,20170628,3516,3495,3614,3614,3551,3551,3563,56,68,10,35.64,14
,20170629,3551,3563,3545,3545,3452,3478,3490,-85,-73,26,90.74,6
,20170630,3478,3490,,,,3490,3490,0,0,0,0.00,6
,20170703,3490,3490,,,,3490,3490,0,0,0,0.00,6
,20170704,3490,3490,,,,3490,3490,0,0,0,0.00,6
,20170705,3490,3490,,,,3490,3490,0,0,0,0.00,6
,20170706,3490,3490,,,,3490,3490,0,0,0,0.00,6
,20170707,3490,3490,,,,3490,3490,0,0,0,0.00,6
,20170710,3490,3490,,,,3490,3490,0,0,0,0.00,6
,20170711,3490,3490,,,,3490,3490,0,0,0,0.00,6
,20170712,3490,3490,,,,3490,3490,0,0,0,0.00,6
,20170713,3490,3490,3699,3699,3619,3620,3670,130,180,12,44.04,12
,20170714,3620,3670,3686,3765,3612,3612,3687,-58,17,6,22.13,10
,20170717,3612,3687,,,,3687,3687,0,0,0,0.00,10
,20170718,3687,3687,3613,3860,3613,3642,3723,-45,36,14,52.12,10
,20170719,3642,3723,3890,3946,3781,3850,3852,127,129,66,254.25,10
,20170720,3850,3852,,,,3852,3852,0,0,0,0.00,10
,20170721,3852,3852,3827,3827,3627,3722,3704,-130,-148,20,74.09,8
,20170724,3722,3704,3622,3657,3622,3648,3638,-56,-66,14,50.94,4
,20170725,3648,3638,3514,3720,3514,3720,3637,82,-1,10,36.38,0
,20170726,3720,3637,,,,3637,3637,0,0,0,0.00,0
,20170727,3637,3637,,,,3637,3637,0,0,0,0.00,0
,20170728,3637,3637,,,,3637,3637,0,0,0,0.00,0
,20170731,3637,3637,,,,3637,3637,0,0,0,0.00,0
,20170801,3637,3637,,,,3637,3637,0,0,0,0.00,0
,20170802,3637,3637,,,,3637,3637,0,0,0,0.00,0
,20170803,3637,3637,,,,3637,3637,0,0,0,0.00,0
,20170804,3637,3637,,,,3637,3637,0,0,0,0.00,0
,20170807,3637,3637,,,,3637,3637,0,0,0,0.00,0
,20170808,3637,3637,,,,3637,3637,0,0,0,0.00,0
,20170809,3637,3637,,,,3637,3637,0,0,0,0.00,0
,20170810,3637,3637,,,,3637,3637,0,0,0,0.00,0
,20170811,3637,3637,,,,3637,3637,0,0,0,0.00,0
,20170814,3637,3637,,,,3637,3637,0,0,0,0.00,0
,20170815,3637,3637,,,,3637,3637,0,0,0,0.00,0
hc1709,20170103,3260,3292,,,,3292,3292,0,0,0,0.00,8
,20170104,3292,3292,3313,3313,3233,3233,3273,-59,-19,4,13.09,8
,20170105,3233,3273,,,,3273,3273,0,0,0,0.00,8
,20170106,3273,3273,,,,3273,3273,0,0,0,0.00,8
,20170109,3273,3273,,,,3253,3253,-20,-20,0,0.00,8
,20170110,3253,3253,3404,3454,3404,3454,3421,201,168,6,20.53,6
,20170111,3454,3421,3529,3529,3425,3425,3468,4,47,6,20.81,4
,20170112,3425,3468,,,,3468,3468,0,0,0,0.00,4
,20170113,3468,3468,,,,3468,3468,0,0,0,0.00,4
,20170116,3468,3468,3668,3710,3668,3696,3698,228,230,44,162.74,44
,20170117,3696,3698,,,,3600,3600,-98,-98,0,0.00,44
,20170118,3600,3600,3666,3666,3570,3570,3632,-30,32,32,116.24,44
,20170119,3570,3632,3490,3580,3490,3580,3520,-52,-112,6,21.12,44
,20170120,3580,3520,3565,3565,3469,3469,3517,-51,-3,4,14.07,46
,20170123,3469,3517,3461,3461,3461,3461,3461,-56,-56,2,6.92,44
,20170124,3461,3461,,,,3441,3441,-20,-20,0,0.00,44
,20170125,3441,3441,,,,3481,3481,40,40,0,0.00,44
,20170126,3481,3481,3481,3650,3481,3639,3623,158,142,74,268.17,68
,20170203,3639,3623,3450,3578,3397,3399,3414,-224,-209,40,136.58,74
,20170206,3399,3414,3438,3438,3438,3438,3438,24,24,6,20.63,74
,20170207,3438,3438,,,,3438,3438,0,0,0,0.00,74
,20170208,3438,3438,3556,3559,3448,3448,3486,10,48,36,125.52,76
,20170209,3448,3486,,,,3486,3486,0,0,0,0.00,76
,20170210,3486,3486,,,,3511,3511,25,25,0,0.00,76
,20170213,3511,3511,3511,3623,3511,3623,3571,112,60,42,149.98,40
,20170214,3623,3571,,,,3611,3611,40,40,0,0.00,40
,20170215,3611,3611,3660,3660,3580,3580,3620,-31,9,112,405.44,40
,20170216,3580,3620,3613,3778,3610,3621,3691,1,71,46,169.81,44
,20170217,3621,3691,3747,3747,3620,3620,3688,-71,-3,30,110.64,44
,20170220,3620,3688,3750,3750,3502,3611,3642,-77,-46,14,51.00,44
,20170221,3611,3642,3700,3700,3700,3700,3700,58,58,2,7.40,44
,20170222,3700,3700,3651,3717,3651,3717,3684,17,-16,4,14.74,42
,20170223,3717,3684,3631,3631,3532,3616,3609,-68,-75,18,64.97,48
,20170224,3616,3609,3496,3526,3451,3525,3488,-84,-121,176,613.96,40
,20170227,3525,3488,3600,3674,3455,3674,3592,186,104,16,57.48,36
,20170228,3674,3592,3467,3467,3467,3467,3467,-125,-125,2,6.93,36
,20170301,3467,3467,3434,3579,3434,3520,3500,53,33,20,70.01,40
,20170302,3520,3500,3555,3560,3555,3560,3556,60,56,8,28.45,36
,20170303,3560,3556,3560,3560,3394,3441,3467,-115,-89,82,284.36,36
,20170306,3441,3467,3500,3519,3371,3487,3462,20,-5,208,720.28,122
,20170307,3487,3462,3448,3494,3414,3474,3457,12,-5,216,746.86,122
,20170308,3474,3457,3499,3499,3385,3403,3432,-54,-25,70,240.31,122
,20170309,3403,3432,3381,3381,3344,3344,3358,-88,-74,6,20.15,118
,20170310,3344,3358,3344,3389,3344,3389,3370,31,12,24,80.89,112
,20170313,3389,3370,3394,3429,3358,3406,3401,36,31,62,210.88,116
,20170314,3406,3401,3406,3470,3379,3470,3422,69,21,128,438.12,112
,20170315,3470,3422,3481,3603,3414,3564,3524,142,102,232,817.57,84
,20170316,3564,3524,3524,3532,3440,3520,3508,-4,-16,96,336.82,40
,20170317,3520,3508,3501,3533,3473,3488,3503,-20,-5,154,539.59,56
,20170320,3488,3503,3529,3529,3409,3409,3490,-94,-13,30,104.73,36
,20170321,3409,3490,3469,3469,3366,3412,3405,-78,-85,140,476.71,30
,20170322,3412,3405,3346,3383,3188,3229,3279,-176,-126,104,341.10,66
,20170323,3229,3279,3267,3277,3203,3230,3254,-49,-25,292,950.33,84
,20170324,3230,3254,3175,3293,3175,3277,3254,23,0,236,768.13,62
,20170327,3277,3254,3261,3261,3120,3236,3186,-18,-68,308,981.53,122
,20170328,3236,3186,3175,3230,3162,3173,3192,-13,6,230,734.20,80
,20170329,3173,3192,3208,3276,3181,3248,3229,56,37,130,419.84,84
,20170330,3248,3229,3246,3279,3216,3248,3243,19,14,52,168.68,80
,20170331,3248,3243,3224,3293,3178,3210,3224,-33,-19,306,986.84,110
,20170405,3210,3224,3227,3281,3213,3243,3245,19,21,184,597.13,102
,20170406,3243,3245,3243,3243,3186,3232,3214,-13,-31,118,379.31,106
,20170407,3232,3214,3265,3267,3114,3147,3207,-67,-7,504,"1,616.42",198
,20170410,3147,3207,3106,3198,3106,3145,3167,-62,-40,684,"2,166.87",136
,20170411,3145,3167,3115,3153,3066,3081,3089,-86,-78,424,"1,309.90",266
,20170412,3081,3089,3005,3067,2910,2910,2982,-179,-107,254,757.60,282
,20170413,2910,2982,2903,3030,2867,3011,2958,29,-24,722,"2,136.36",152
,20170414,3011,2958,2963,3066,2963,2989,3009,31,51,688,"2,070.22",168
,20170417,2989,3009,2970,3057,2951,3030,3004,21,-5,270,811.30,192
,20170418,3030,3004,3021,3021,2930,2937,2956,-67,-48,214,632.79,168
,20170419,2937,2956,2945,2977,2925,2948,2941,-8,-15,132,388.34,142
,20170420,2948,2941,2972,2980,2852,2959,2933,18,-8,148,434.11,152
,20170421,2959,2933,2976,3039,2950,2997,2986,64,53,172,513.73,120
,20170424,2997,2986,2996,3002,2925,2975,2964,-11,-22,106,314.19,120
,20170425,2975,2964,3054,3054,2980,3023,3005,59,41,252,757.30,128
,20170426,3023,3005,3033,3098,3011,3054,3046,49,41,236,718.99,88
,20170427,3054,3046,3056,3069,3047,3067,3056,21,10,224,684.67,102
,20170428,3067,3056,3101,3158,3074,3158,3114,102,58,88,274.04,100
,20170502,3158,3114,3178,3199,3131,3145,3168,31,54,108,342.17,94
,20170503,3145,3168,3150,3150,3035,3112,3109,-56,-59,390,"1,212.88",126
,20170504,3112,3109,3132,3132,2909,2909,3007,-200,-102,426,"1,281.05",100
,20170505,2909,3007,2907,2928,2850,2897,2896,-110,-111,494,"1,430.74",118
,20170508,2897,2896,2954,2966,2901,2953,2926,57,30,646,"1,890.83",142
,20170509,2953,2926,2931,2945,2874,2882,2895,-44,-31,464,"1,343.46",146
,20170510,2882,2895,2912,2960,2895,2929,2927,34,32,320,936.76,162
,20170511,2929,2927,2977,2979,2871,2958,2920,31,-7,1406,"4,106.80",162
,20170512,2958,2920,2955,2956,2851,2851,2898,-69,-22,284,823.16,172
,20170515,2851,2898,2866,2972,2866,2918,2913,20,15,260,757.56,156
,20170516,2918,2913,2918,2939,2886,2911,2906,-2,-7,272,790.68,124
,20170517,2911,2906,2939,3055,2925,3050,3013,144,107,736,"2,217.74",150
,20170518,3050,3013,3051,3077,3007,3054,3049,41,36,282,859.82,162
,20170519,3054,3049,3089,3137,3002,3137,3055,88,6,490,"1,497.27",228
,20170522,3137,3055,3127,3236,3114,3181,3175,126,120,678,"2,152.82",388
,20170523,3181,3175,3260,3260,3147,3152,3194,-23,19,1018,"3,251.84",212
,20170524,3152,3194,3170,3205,3094,3138,3161,-56,-33,940,"2,972.10",168
,20170525,3138,3161,3150,3209,3127,3140,3162,-21,1,326,"1,031.00",192
,20170526,3140,3162,3148,3166,3068,3107,3118,-55,-44,262,816.94,156
,20170531,3107,3118,3130,3195,3043,3043,3099,-75,-19,446,"1,382.37",240
,20170601,3043,3099,3045,3072,2996,3038,3031,-61,-68,734,"2,225.35",346
,20170602,3038,3031,3038,3092,3016,3072,3049,41,18,268,817.27,356
,20170605,3072,3049,3043,3068,2985,2995,3017,-54,-32,328,989.81,326
,20170606,2995,3017,3008,3027,2969,3003,2992,-14,-25,436,"1,304.76",362
,20170607,3003,2992,3003,3029,2994,3000,3005,8,13,86,258.50,356
,20170608,3000,3005,3038,3120,2974,3050,3012,45,7,280,843.64,332
,20170609,3050,3012,3043,3122,3030,3101,3066,89,54,590,"1,809.21",532
,20170612,3101,3066,3109,3199,3109,3165,3153,99,87,472,"1,488.25",364
,20170613,3165,3153,3152,3171,3068,3068,3131,-85,-22,226,707.82,370
,20170614,3068,3131,3042,3183,3040,3183,3085,52,-46,232,715.77,390
,20170615,3183,3085,3188,3243,3133,3233,3196,148,111,972,"3,106.95",278
,20170616,3233,3196,3220,3272,3180,3199,3224,3,28,766,"2,469.87",330
,20170619,3199,3224,3206,3312,3194,3281,3265,57,41,402,"1,312.65",308
,20170620,3281,3265,3265,3287,3239,3272,3267,7,2,224,731.86,298
,20170621,3272,3267,3264,3264,3213,3242,3235,-25,-32,172,556.49,312
,20170622,3242,3235,3256,3313,3235,3249,3280,14,45,276,905.33,288
,20170623,3249,3280,3252,3285,3185,3278,3251,-2,-29,502,"1,632.12",264
,20170626,3278,3251,3285,3355,3225,3337,3295,86,44,486,"1,601.69",362
,20170627,3337,3295,3338,3396,3322,3396,3342,101,47,584,"1,952.17",354
,20170628,3396,3342,3403,3443,3393,3443,3424,101,82,204,698.54,398
,20170629,3443,3424,3428,3468,3368,3424,3416,0,-8,2036,"6,955.45",306
,20170630,3424,3416,3421,3439,3385,3439,3414,23,-2,372,"1,270.08",262
,20170703,3439,3414,3441,3516,3429,3512,3461,98,47,1340,"4,638.89",454
,20170704,3512,3461,3565,3565,3434,3444,3475,-17,14,820,"2,850.29",820
,20170705,3444,3475,3457,3541,3457,3486,3500,11,25,410,"1,435.05",986
,20170706,3486,3500,3482,3487,3403,3487,3452,-13,-48,780,"2,693.23",964
,20170707,3487,3452,3478,3512,3433,3508,3457,56,5,600,"2,074.27",926
,20170710,3508,3457,3514,3552,3487,3533,3522,76,65,226,796.05,938
,20170711,3533,3522,3533,3662,3514,3661,3596,139,74,454,"1,633.01",976
,20170712,3661,3596,3643,3686,3630,3656,3664,60,68,174,637.62,936
,20170713,3656,3664,3647,3736,3643,3730,3695,66,31,190,702.06,934
,20170714,3730,3695,3736,3737,3630,3674,3660,-21,-35,328,"1,200.56",1062
,20170717,3674,3660,3665,3782,3658,3757,3757,97,97,488,"1,833.49",1150
,20170718,3757,3757,3773,3773,3722,3736,3750,-21,-7,578,"2,167.50",1186
,20170719,3736,3750,3759,3817,3705,3817,3770,67,20,638,"2,405.88",1146
,20170720,3817,3770,3838,3838,3690,3705,3776,-65,6,1148,"4,335.80",1030
,20170721,3705,3776,3718,3730,3644,3708,3676,-68,-100,448,"1,647.20",1002
,20170724,3708,3676,3691,3729,3630,3690,3674,14,-2,712,"2,616.54",938
,20170725,3690,3674,3707,3735,3680,3724,3716,50,42,406,"1,508.82",894
,20170726,3724,3716,3740,3843,3720,3737,3753,21,37,262,983.52,876
,20170727,3737,3753,3720,3771,3629,3763,3736,10,-17,728,"2,720.19",720
,20170728,3763,3736,3776,3807,3732,3732,3763,-4,27,292,"1,099.03",640
,20170731,3732,3763,3787,3900,3787,3855,3865,92,102,1232,"4,761.84",430
,20170801,3855,3865,3855,3895,3837,3839,3858,-26,-7,136,524.70,382
,20170802,3839,3858,3828,3886,3806,3858,3860,0,2,626,"2,416.80",380
,20170803,3858,3860,3856,3906,3849,3870,3867,10,7,426,"1,647.52",230
,20170804,3870,3867,3865,3969,3865,3963,3935,96,68,124,488.01,238
,20170807,3963,3935,3970,4140,3970,4088,4090,153,155,226,924.49,262
,20170808,4088,4090,4080,4140,4050,4068,4089,-22,-1,176,719.78,208
,20170809,4068,4089,4077,4154,4030,4143,4102,54,13,146,598.91,170
,20170810,4143,4102,4130,4178,4120,4129,4161,27,59,110,457.75,148
,20170811,4129,4161,4130,4130,4046,4069,4100,-92,-61,26,106.60,140
,20170814,4069,4100,4064,4127,4014,4024,4048,-76,-52,146,591.04,150
,20170815,4024,4048,4022,4022,3955,3987,3986,-61,-62,44,175.39,136
,20170816,3987,3986,4023,4039,3978,3978,4007,-8,21,20,80.14,134
,20170817,3978,4007,,,,4007,4007,0,0,0,0.00,134
,20170818,4007,4007,4075,4179,4059,4100,4093,93,86,680,"2,783.75",548
,20170821,4100,4093,4068,4173,4000,4149,4062,56,-31,46,186.88,538
,20170822,4149,4062,4144,4150,4084,4084,4137,22,75,106,438.56,556
,20170823,4084,4137,4062,4069,3897,4000,3994,-137,-143,80,319.53,552
,20170824,4000,3994,4025,4088,4003,4007,4012,13,18,60,240.76,572
,20170825,4007,4012,4210,4210,4135,4167,4170,155,158,98,408.74,492
,20170828,4167,4170,4176,4176,4059,4070,4101,-100,-69,8,32.81,494
,20170829,4070,4101,4110,4300,4110,4148,4174,47,73,16,66.79,484
,20170830,4148,4174,4148,4222,4051,4156,4161,-18,-13,44,183.09,468
,20170831,4156,4161,4121,4197,4010,4197,4079,36,-82,80,326.37,420
,20170901,4197,4079,,,,4179,4179,100,100,0,0.00,420
,20170904,4179,4179,,,,4179,4179,0,0,0,0.00,420
,20170905,4179,4179,,,,4179,4179,0,0,0,0.00,420
,20170906,4179,4179,,,,4179,4179,0,0,0,0.00,420
,20170907,4179,4179,,,,4179,4179,0,0,0,0.00,420
,20170908,4179,4179,4300,4300,4300,4300,4300,121,121,60,258.00,420
,20170911,4300,4300,,,,4300,4300,0,0,0,0.00,420
,20170912,4300,4300,,,,4300,4300,0,0,0,0.00,420
,20170913,4300,4300,,,,4300,4300,0,0,0,0.00,420
,20170914,4300,4300,,,,4300,4300,0,0,0,0.00,420
,20170915,4300,4300,,,,4300,4300,0,0,0,0.00,420
hc1710,20170103,3215,3245,3218,3317,3198,3198,3272,-47,27,2004,"6,557.60",4370
,20170104,3198,3272,3198,3286,3166,3263,3218,-9,-54,5242,"16,870.96",5488
,20170105,3263,3218,3246,3300,3230,3242,3263,24,45,3644,"11,891.26",6400
,20170106,3242,3263,3242,3251,3153,3165,3205,-98,-58,6058,"19,421.26",7464
,20170109,3165,3205,3137,3327,3137,3326,3212,121,7,6004,"19,286.33",7508
,20170110,3326,3212,3351,3436,3297,3436,3360,224,148,5268,"17,704.08",7562
,20170111,3436,3360,3436,3461,3377,3430,3426,70,66,5144,"17,623.84",8110
,20170112,3430,3426,3426,3507,3405,3440,3459,14,33,7010,"24,252.21",8050
,20170113,3440,3459,3443,3476,3387,3419,3433,-40,-26,5200,"17,851.82",9094
,20170116,3419,3433,3417,3632,3398,3578,3544,145,111,8026,"28,446.21",9162
,20170117,3578,3544,3578,3612,3465,3510,3552,-34,8,8180,"29,063.10",9090
,20170118,3510,3552,3510,3581,3482,3507,3519,-45,-33,5076,"17,864.61",8528
,20170119,3507,3519,3507,3521,3414,3443,3460,-76,-59,10824,"37,458.53",9068
,20170120,3443,3460,3448,3481,3370,3370,3433,-90,-27,7590,"26,061.05",10062
,20170123,3370,3433,3377,3402,3340,3372,3368,-61,-65,6864,"23,123.29",9716
,20170124,3372,3368,3372,3523,3361,3481,3460,113,92,10480,"36,269.43",8660
,20170125,3481,3460,3509,3509,3438,3482,3472,22,12,5618,"19,511.07",8606
,20170126,3482,3472,3483,3558,3482,3547,3528,75,56,6374,"22,491.04",8728
,20170203,3547,3528,3547,3547,3308,3308,3368,-220,-160,12418,"41,828.85",9876
,20170206,3308,3368,3282,3327,3267,3289,3291,-79,-77,13296,"43,757.17",13446
,20170207,3289,3291,3288,3376,3280,3362,3327,71,36,8086,"26,902.30",13344
,20170208,3362,3327,3354,3435,3330,3424,3387,97,60,9332,"31,613.77",12998
,20170209,3424,3387,3439,3461,3380,3384,3425,-3,38,7164,"24,543.09",13356
,20170210,3384,3425,3385,3560,3361,3509,3456,84,31,10170,"35,148.53",13588
,20170213,3509,3456,3509,3613,3509,3605,3570,149,114,9498,"33,914.95",14372
,20170214,3605,3570,3605,3622,3545,3614,3588,44,18,10270,"36,851.99",13972
,20170215,3614,3588,3679,3679,3531,3558,3579,-30,-9,12588,"45,055.88",15988
,20170216,3558,3579,3532,3652,3509,3541,3579,-38,0,16106,"57,658.33",16842
,20170217,3541,3579,3541,3611,3541,3588,3582,9,3,15840,"56,746.62",20496
,20170220,3588,3582,3589,3641,3569,3627,3616,45,34,20954,"75,776.61",24654
,20170221,3627,3616,3637,3697,3624,3638,3658,22,42,12896,"47,175.56",26400
,20170222,3638,3658,3638,3649,3540,3575,3588,-83,-70,23380,"83,892.19",30350
,20170223,3575,3588,3575,3605,3481,3508,3554,-80,-34,28160,"100,099.23",34266
,20170224,3508,3554,3512,3538,3388,3493,3455,-61,-99,39060,"134,975.34",39118
,20170227,3493,3455,3483,3613,3473,3588,3556,133,101,28260,"100,505.42",43268
,20170228,3588,3556,3589,3595,3424,3428,3533,-128,-23,23050,"81,456.95",45940
,20170301,3428,3533,3428,3515,3422,3480,3472,-53,-61,27888,"96,832.26",50178
,20170302,3480,3472,3484,3491,3439,3460,3468,-12,-4,36072,"125,113.15",56236
,20170303,3460,3468,3460,3464,3346,3439,3401,-29,-67,41018,"139,511.03",61358
,20170306,3439,3401,3438,3450,3334,3346,3377,-55,-24,68830,"232,461.22",80534
,20170307,3346,3377,3355,3385,3321,3351,3353,-26,-24,49006,"164,333.71",92630
,20170308,3351,3353,3353,3360,3273,3276,3316,-77,-37,64970,"215,472.49",106720
,20170309,3276,3316,3280,3284,3190,3235,3239,-81,-77,72622,"235,242.08",122846
,20170310,3235,3239,3221,3284,3221,3250,3259,11,20,75240,"245,228.09",143990
,20170313,3250,3259,3252,3380,3214,3378,3289,119,30,106420,"350,026.03",156746
,20170314,3378,3289,3373,3380,3297,3329,3339,40,50,89048,"297,361.64",175260
,20170315,3329,3339,3325,3485,3306,3432,3415,93,76,127870,"436,753.69",188046
,20170316,3432,3415,3440,3450,3367,3444,3417,29,2,107848,"368,553.97",202072
,20170317,3444,3417,3438,3450,3374,3398,3413,-19,-4,108588,"370,624.69",209800
,20170320,3398,3413,3390,3460,3349,3366,3411,-47,-2,107766,"367,684.89",227564
,20170321,3366,3411,3359,3376,3279,3294,3320,-117,-91,144208,"478,876.37",240342
,20170322,3294,3320,3284,3287,3155,3165,3225,-155,-95,180364,"581,728.91",275674
,20170323,3165,3225,3166,3218,3151,3157,3190,-68,-35,184346,"588,111.98",296308
,20170324,3157,3190,3150,3220,3124,3183,3176,-7,-14,243170,"772,417.63",311532
,20170327,3183,3176,3183,3185,3036,3095,3094,-81,-82,276602,"856,008.51",341414
,20170328,3095,3094,3107,3150,3076,3086,3110,-8,16,270274,"840,677.68",364132
,20170329,3086,3110,3090,3238,3090,3213,3176,103,66,409058,"1,299,349.26",386276
,20170330,3213,3176,3202,3242,3170,3191,3202,15,26,345988,"1,108,156.57",398342
,20170331,3191,3202,3186,3260,3135,3165,3193,-37,-9,496612,"1,586,151.63",440240
,20170405,3165,3193,3200,3258,3158,3170,3215,-23,22,512032,"1,646,359.02",504066
,20170406,3170,3215,3174,3212,3124,3161,3162,-54,-53,664754,"2,102,190.09",521058
,20170407,3161,3162,3152,3153,3027,3078,3083,-84,-79,651634,"2,009,283.68",492014
,20170410,3078,3083,3075,3114,3049,3068,3078,-15,-5,538834,"1,658,593.76",488768
,20170411,3068,3078,3042,3077,3010,3030,3041,-48,-37,476812,"1,450,022.01",494244
,20170412,3030,3041,3023,3031,2903,2913,2954,-128,-87,615742,"1,819,223.07",557624
,20170413,2913,2954,2910,2992,2892,2954,2955,0,1,595990,"1,761,331.66",574770
,20170414,2954,2955,2960,3044,2957,2984,2995,29,40,614394,"1,840,303.94",564622
,20170417,2984,2995,2987,3039,2930,2973,2984,-22,-11,490074,"1,462,670.39",555732
,20170418,2973,2984,2970,2982,2870,2881,2917,-103,-67,454320,"1,325,421.44",557234
,20170419,2881,2917,2880,2926,2870,2893,2897,-24,-20,419262,"1,214,671.26",568372
,20170420,2893,2897,2895,2950,2801,2930,2875,33,-22,746814,"2,147,637.82",575326
,20170421,2930,2875,2935,2996,2900,2961,2950,86,75,632568,"1,866,192.75",583550
,20170424,2961,2950,2961,2967,2881,2956,2923,6,-27,545150,"1,593,536.00",591016
,20170425,2956,2923,2950,3012,2932,2992,2974,69,51,621878,"1,849,984.35",620160
,20170426,2992,2974,2984,3085,2973,3020,3025,46,51,573256,"1,734,353.60",603526
,20170427,3020,3025,3016,3063,3001,3063,3029,38,4,421662,"1,277,476.37",602756
,20170428,3063,3029,3060,3151,3060,3149,3107,120,78,627606,"1,950,506.07",618898
,20170502,3149,3107,3175,3196,3118,3142,3152,35,45,460484,"1,451,592.46",641856
,20170503,3142,3152,3148,3150,3081,3112,3109,-40,-43,642470,"1,997,925.09",672308
,20170504,3112,3109,3088,3096,2891,2891,2984,-218,-125,991184,"2,958,417.63",683832
,20170505,2891,2984,2904,2915,2845,2887,2889,-97,-95,737544,"2,131,148.30",677278
,20170508,2887,2889,2905,2983,2881,2931,2925,42,36,924352,"2,703,739.79",688888
,20170509,2931,2925,2925,2935,2861,2895,2898,-30,-27,738742,"2,141,409.90",710092
,20170510,2895,2898,2894,2952,2885,2930,2919,32,21,852552,"2,488,652.03",672418
,20170511,2930,2919,2935,2969,2855,2952,2915,33,-4,1111342,"3,239,935.55",625132
,20170512,2952,2915,2952,2956,2839,2840,2887,-75,-28,891972,"2,575,629.09",678120
,20170515,2840,2887,2852,2956,2844,2916,2900,29,13,788564,"2,287,517.71",625696
,20170516,2916,2900,2927,2932,2877,2916,2902,16,2,560054,"1,625,709.03",622310
,20170517,2916,2902,2916,3050,2915,3037,2997,135,95,978424,"2,932,665.73",647068
,20170518,3037,2997,3044,3065,2998,3048,3034,51,37,641014,"1,945,157.52",632224
,20170519,3048,3034,3018,3129,2991,3117,3069,83,35,841664,"2,583,319.39",622486
,20170522,3117,3069,3137,3229,3110,3170,3172,101,103,852262,"2,704,180.43",616938
,20170523,3170,3172,3172,3187,3134,3153,3163,-19,-9,514930,"1,629,069.42",619932
,20170524,3153,3163,3152,3200,3075,3128,3135,-35,-28,972812,"3,050,057.84",637596
,20170525,3128,3135,3156,3211,3118,3133,3156,-2,21,962388,"3,037,754.31",669824
,20170526,3133,3156,3135,3152,3052,3116,3101,-40,-55,857442,"2,659,363.99",648612
,20170531,3116,3101,3135,3185,3033,3037,3101,-64,0,765842,"2,375,000.92",662836
,20170601,3037,3101,3040,3058,2981,3021,3020,-80,-81,746000,"2,253,197.41",663500
,20170602,3021,3020,3026,3050,2982,3012,3020,-8,0,850236,"2,568,125.40",665108
,20170605,3012,3020,3003,3025,2925,2936,2970,-84,-50,812462,"2,413,453.25",643016
,20170606,2936,2970,2930,2961,2906,2938,2935,-32,-35,572148,"1,679,598.00",605956
,20170607,2938,2935,2944,2972,2932,2957,2950,22,15,398372,"1,175,491.37",608852
,20170608,2957,2950,2958,3016,2921,2974,2965,24,15,611274,"1,813,002.60",594430
,20170609,2974,2965,2976,3080,2969,3074,3035,109,70,810740,"2,460,770.22",608754
,20170612,3074,3035,3076,3148,3062,3104,3104,69,69,927994,"2,881,271.27",600614
,20170613,3104,3104,3108,3119,3006,3006,3067,-98,-37,725344,"2,224,662.61",558678
,20170614,3006,3067,3001,3123,2972,3120,3036,53,-31,1063822,"3,230,702.46",577838
,20170615,3120,3036,3123,3199,3067,3185,3142,149,106,1366450,"4,294,151.23",637642
,20170616,3185,3142,3179,3238,3147,3164,3188,22,46,1191692,"3,800,101.20",629628
,20170619,3164,3188,3169,3273,3158,3236,3216,48,28,1141494,"3,671,197.52",629960
,20170620,3236,3216,3239,3255,3204,3228,3229,12,13,1021286,"3,297,875.27",697516
,20170621,3228,3229,3219,3227,3164,3197,3195,-32,-34,1027614,"3,283,874.92",664554
,20170622,3197,3195,3205,3269,3185,3194,3232,-1,37,1196708,"3,867,809.92",668960
,20170623,3194,3232,3204,3242,3181,3238,3213,6,-19,1082752,"3,479,064.15",676898
,20170626,3238,3213,3240,3305,3217,3288,3257,75,44,1074242,"3,499,320.63",730922
,20170627,3288,3257,3288,3357,3271,3350,3306,93,49,948444,"3,136,460.57",750262
,20170628,3350,3306,3355,3411,3351,3389,3384,83,78,881750,"2,984,104.80",770712
,20170629,3389,3384,3395,3429,3354,3377,3387,-7,3,1265560,"4,287,592.53",753458
,20170630,3377,3387,3368,3398,3339,3383,3369,-4,-18,1016430,"3,425,149.64",689278
,20170703,3383,3369,3362,3468,3362,3460,3420,91,51,1091936,"3,734,732.98",720990
,20170704,3460,3420,3450,3477,3377,3391,3423,-29,3,934384,"3,199,171.40",646020
,20170705,3391,3423,3395,3483,3393,3430,3438,7,15,871370,"2,996,560.86",655614
,20170706,3430,3438,3416,3424,3330,3414,3385,-24,-53,1109048,"3,754,909.52",631052
,20170707,3414,3385,3414,3455,3366,3444,3406,59,21,928382,"3,162,137.45",628056
,20170710,3444,3406,3439,3489,3423,3452,3455,46,49,796760,"2,753,442.82",630762
,20170711,3452,3455,3450,3605,3438,3569,3528,114,73,807266,"2,848,686.34",662402
,20170712,3569,3528,3558,3627,3558,3590,3595,62,67,662424,"2,381,493.32",639846
,20170713,3590,3595,3595,3684,3577,3680,3626,85,31,776658,"2,816,346.71",666444
,20170714,3680,3626,3670,3676,3562,3598,3608,-28,-18,931526,"3,361,016.00",614900
,20170717,3598,3608,3591,3725,3589,3698,3678,90,70,932794,"3,430,857.56",666694
,20170718,3698,3678,3691,3709,3643,3657,3676,-21,-2,764066,"2,808,916.44",643482
,20170719,3657,3676,3678,3745,3663,3731,3711,55,35,768146,"2,850,701.70",663462
,20170720,3731,3711,3730,3732,3605,3617,3677,-94,-34,1245152,"4,579,058.87",588876
,20170721,3617,3677,3627,3653,3566,3629,3615,-48,-62,796922,"2,881,001.76",572402
,20170724,3629,3615,3636,3650,3538,3586,3590,-29,-25,803838,"2,885,822.46",531350
,20170725,3586,3590,3593,3645,3572,3631,3613,41,23,635346,"2,295,618.78",498060
,20170726,3631,3613,3637,3717,3618,3644,3668,31,55,738042,"2,707,636.39",470288
,20170727,3644,3668,3634,3674,3580,3666,3630,-2,-38,731162,"2,654,751.52",443962
,20170728,3666,3630,3668,3705,3626,3660,3663,30,33,733244,"2,686,040.90",444390
,20170731,3660,3663,3669,3815,3658,3802,3760,139,97,954838,"3,590,436.16",507980
,20170801,3802,3760,3796,3828,3758,3766,3783,6,23,465930,"1,763,075.34",493400
,20170802,3766,3783,3777,3817,3744,3797,3790,14,7,456908,"1,732,079.70",497850
,20170803,3797,3790,3791,3849,3775,3809,3808,19,18,615012,"2,342,536.50",474026
,20170804,3809,3808,3812,3912,3798,3897,3857,89,49,499736,"1,927,546.63",482666
,20170807,3897,3857,3893,4088,3882,4030,4023,173,166,693512,"2,790,343.89",457650
,20170808,4030,4023,4028,4099,3972,4010,4037,-13,14,504074,"2,035,050.80",411208
,20170809,4010,4037,4017,4103,3967,4098,4024,61,-13,539486,"2,171,171.64",394940
,20170810,4098,4024,4080,4137,4038,4073,4085,49,61,405240,"1,655,797.82",357544
,20170811,4073,4085,4060,4118,3987,4005,4045,-80,-40,337714,"1,366,251.19",319506
,20170814,4005,4045,4001,4042,3955,3965,3986,-80,-59,237742,"947,808.72",271780
,20170815,3965,3986,3957,3969,3877,3929,3917,-57,-69,163912,"642,151.65",247122
,20170816,3929,3917,3929,3956,3886,3901,3922,-16,5,110408,"433,069.40",235552
,20170817,3901,3922,3911,4038,3905,4015,3988,93,66,135960,"542,341.78",221442
,20170818,4015,3988,3999,4096,3991,4078,4026,90,38,88238,"355,248.03",214972
,20170821,4078,4026,4068,4156,4013,4134,4098,108,72,100752,"412,898.16",206832
,20170822,4134,4098,4130,4145,4070,4103,4106,5,8,57700,"236,937.82",201242
,20170823,4103,4106,4103,4103,3896,3956,3971,-150,-135,126976,"504,345.82",163654
,20170824,3956,3971,3949,4044,3925,4030,3999,59,28,57030,"228,107.95",161742
,20170825,4030,3999,4027,4195,4014,4116,4124,117,125,79382,"327,446.30",158464
,20170828,4116,4124,4113,4190,4023,4137,4094,13,-30,46122,"188,847.28",150308
,20170829,4137,4094,4134,4171,4081,4111,4133,17,39,50736,"209,736.53",141922
,20170830,4111,4133,4116,4139,4050,4125,4099,-8,-34,34130,"139,926.51",135856
,20170831,4125,4099,4100,4125,4020,4122,4066,23,-33,57066,"232,072.26",122388
,20170901,4122,4066,4105,4309,4103,4308,4220,242,154,70798,"298,834.52",115554
,20170904,4308,4220,4301,4436,4297,4338,4359,118,139,49244,"214,695.63",111928
,20170905,4338,4359,4338,4400,4324,4373,4366,14,7,21598,"94,314.47",103024
,20170906,4373,4366,4373,4410,4267,4271,4338,-95,-28,30334,"131,610.78",97436
,20170907,4271,4338,4275,4308,4246,4271,4278,-67,-60,17862,"76,426.00",89784
,20170908,4271,4278,4261,4330,4181,4191,4250,-87,-28,21372,"90,841.74",85380
,20170911,4191,4250,4190,4218,4135,4210,4185,-40,-65,15584,"65,224.55",78570
,20170912,4210,4185,4210,4238,4148,4216,4189,31,4,12446,"52,139.58",75824
,20170913,4216,4189,4210,4265,4170,4188,4212,-1,23,12112,"51,025.98",73492
,20170914,4188,4212,4176,4229,4131,4167,4183,-45,-29,24154,"101,057.19",67612
,20170915,4167,4183,4156,4188,4136,4162,4164,-21,-19,13384,"55,741.80",61622
,20170918,4162,4164,4161,4175,4091,4132,4127,-32,-37,12174,"50,251.17",56144
,20170919,4132,4127,4132,4163,4084,4084,4126,-43,-1,10580,"43,657.15",51568
,20170920,4084,4126,4085,4100,4030,4086,4067,-40,-59,11770,"47,880.00",48342
,20170921,4086,4067,4094,4127,3998,4004,4055,-63,-12,12170,"49,357.45",43166
,20170922,4004,4055,4001,4001,3858,3879,3954,-176,-101,15912,"62,931.41",37048
,20170925,3879,3954,3902,3932,3869,3910,3904,-44,-50,6572,"25,659.27",33442
,20170926,3910,3904,3910,3950,3910,3932,3938,28,34,5712,"22,495.27",32002
,20170927,3932,3938,3941,4004,3935,4003,3969,65,31,5136,"20,389.04",30176
,20170928,4003,3969,3981,4048,3918,3984,3983,15,14,6744,"26,867.41",28022
,20170929,3984,3983,3999,4154,3885,4149,3971,166,-12,7894,"31,349.98",24958
,20171009,4149,3971,4150,4178,4056,4060,4110,89,139,2938,"12,077.87",24300
,20171010,4060,4110,4025,4070,3955,3990,3984,-120,-126,5040,"20,079.90",22800
,20171011,3990,3984,4050,4050,3940,3941,3976,-43,-8,5100,"20,277.90",21240
,20171012,3941,3976,3921,4080,3921,4080,4030,104,54,1380,"5,561.88",21180
,20171013,4080,4030,4100,4200,4099,4180,4143,150,113,1860,"7,707.48",20880
,20171016,4180,4143,4300,4300,4220,4220,4273,77,130,180,769.20,20880
hc1711,20170103,3193,3193,3269,3269,3269,3269,3269,76,76,40,130.76,40
,20170104,3269,3269,,,,3269,3269,0,0,0,0.00,40
,20170105,3269,3269,,,,3314,3314,45,45,0,0.00,40
,20170106,3314,3314,,,,3180,3180,-134,-134,0,0.00,40
,20170109,3180,3180,,,,3187,3187,7,7,0,0.00,40
,20170110,3187,3187,,,,3334,3334,147,147,0,0.00,40
,20170111,3334,3334,,,,3399,3399,65,65,0,0.00,40
,20170112,3399,3399,,,,3432,3432,33,33,0,0.00,40
,20170113,3432,3432,,,,3406,3406,-26,-26,0,0.00,40
,20170116,3406,3406,,,,3516,3516,110,110,0,0.00,40
,20170117,3516,3516,,,,3516,3516,0,0,0,0.00,40
,20170118,3516,3516,,,,3483,3483,-33,-33,0,0.00,40
,20170119,3483,3483,3388,3388,3388,3388,3388,-95,-95,40,135.52,0
,20170120,3388,3388,,,,3362,3362,-26,-26,0,0.00,0
,20170123,3362,3362,,,,3362,3362,0,0,0,0.00,0
,20170124,3362,3362,3420,3442,3318,3442,3373,80,11,90,303.60,2
,20170125,3442,3373,,,,3385,3385,12,12,0,0.00,2
,20170126,3385,3385,,,,3440,3440,55,55,0,0.00,2
,20170203,3440,3440,,,,3284,3284,-156,-156,0,0.00,2
,20170206,3284,3284,,,,3208,3208,-76,-76,0,0.00,2
,20170207,3208,3208,,,,3243,3243,35,35,0,0.00,2
,20170208,3243,3243,,,,3243,3243,0,0,0,0.00,2
,20170209,3243,3243,,,,3280,3280,37,37,0,0.00,2
,20170210,3280,3280,,,,3309,3309,29,29,0,0.00,2
,20170213,3309,3309,,,,3418,3418,109,109,0,0.00,2
,20170214,3418,3418,,,,3435,3435,17,17,0,0.00,2
,20170215,3435,3435,,,,3426,3426,-9,-9,0,0.00,2
,20170216,3426,3426,3663,3663,3663,3663,3663,237,237,2,7.33,2
,20170217,3663,3663,,,,3666,3666,3,3,0,0.00,2
,20170220,3666,3666,,,,3701,3701,35,35,0,0.00,2
,20170221,3701,3701,,,,3744,3744,43,43,0,0.00,2
,20170222,3744,3744,,,,3672,3672,-72,-72,0,0.00,2
,20170223,3672,3672,,,,3637,3637,-35,-35,0,0.00,2
,20170224,3637,3637,,,,3536,3536,-101,-101,0,0.00,2
,20170227,3536,3536,,,,3639,3639,103,103,0,0.00,2
,20170228,3639,3639,,,,3616,3616,-23,-23,0,0.00,2
,20170301,3616,3616,,,,3553,3553,-63,-63,0,0.00,2
,20170302,3553,3553,,,,3549,3549,-4,-4,0,0.00,2
,20170303,3549,3549,,,,3480,3480,-69,-69,0,0.00,2
,20170306,3480,3480,,,,3455,3455,-25,-25,0,0.00,2
,20170307,3455,3455,,,,3430,3430,-25,-25,0,0.00,2
,20170308,3430,3430,,,,3392,3392,-38,-38,0,0.00,2
,20170309,3392,3392,,,,3392,3392,0,0,0,0.00,2
,20170310,3392,3392,,,,3413,3413,21,21,0,0.00,2
,20170313,3413,3413,,,,3444,3444,31,31,0,0.00,2
,20170314,3444,3444,3246,3362,3246,3362,3304,-82,-140,4,13.22,0
,20170315,3362,3304,,,,3379,3379,75,75,0,0.00,0
,20170316,3379,3379,,,,3381,3381,2,2,0,0.00,0
,20170317,3381,3381,,,,3377,3377,-4,-4,0,0.00,0
,20170320,3377,3377,,,,3375,3375,-2,-2,0,0.00,0
,20170321,3375,3375,,,,3285,3285,-90,-90,0,0.00,0
,20170322,3285,3285,,,,3191,3191,-94,-94,0,0.00,0
,20170323,3191,3191,,,,3156,3156,-35,-35,0,0.00,0
,20170324,3156,3156,,,,3156,3156,0,0,0,0.00,0
,20170327,3156,3156,,,,3075,3075,-81,-81,0,0.00,0
,20170328,3075,3075,,,,3091,3091,16,16,0,0.00,0
,20170329,3091,3091,,,,3157,3157,66,66,0,0.00,0
,20170330,3157,3157,,,,3183,3183,26,26,0,0.00,0
,20170331,3183,3183,,,,3174,3174,-9,-9,0,0.00,0
,20170405,3174,3174,,,,3196,3196,22,22,0,0.00,0
,20170406,3196,3196,3090,3158,3090,3146,3131,-50,-65,18,56.36,6
,20170407,3146,3131,,,,3053,3053,-78,-78,0,0.00,6
,20170410,3053,3053,,,,3053,3053,0,0,0,0.00,6
,20170411,3053,3053,,,,3016,3016,-37,-37,0,0.00,6
,20170412,3016,3016,,,,2930,2930,-86,-86,0,0.00,6
,20170413,2930,2930,,,,2930,2930,0,0,0,0.00,6
,20170414,2930,2930,,,,2930,2930,0,0,0,0.00,6
,20170417,2930,2930,,,,2930,2930,0,0,0,0.00,6
,20170418,2930,2930,,,,2864,2864,-66,-66,0,0.00,6
,20170419,2864,2864,,,,2864,2864,0,0,0,0.00,6
,20170420,2864,2864,,,,2842,2842,-22,-22,0,0.00,6
,20170421,2842,2842,,,,2843,2843,1,1,0,0.00,6
,20170424,2843,2843,,,,2817,2817,-26,-26,0,0.00,6
,20170425,2817,2817,,,,2866,2866,49,49,0,0.00,6
,20170426,2866,2866,,,,2915,2915,49,49,0,0.00,6
,20170427,2915,2915,,,,2919,2919,4,4,0,0.00,6
,20170428,2919,2919,,,,2994,2994,75,75,0,0.00,6
,20170502,2994,2994,,,,3037,3037,43,43,0,0.00,6
,20170503,3037,3037,3069,3078,3067,3078,3070,41,33,8,24.56,2
,20170504,3078,3070,,,,2947,2947,-123,-123,0,0.00,2
,20170505,2947,2947,,,,2853,2853,-94,-94,0,0.00,2
,20170508,2853,2853,,,,2888,2888,35,35,0,0.00,2
,20170509,2888,2888,,,,2888,2888,0,0,0,0.00,2
,20170510,2888,2888,,,,2888,2888,0,0,0,0.00,2
,20170511,2888,2888,,,,2884,2884,-4,-4,0,0.00,2
,20170512,2884,2884,2806,2806,2806,2806,2806,-78,-78,2,5.61,4
,20170515,2806,2806,,,,2819,2819,13,13,0,0.00,4
,20170516,2819,2819,2901,2901,2901,2901,2901,82,82,10,29.01,12
,20170517,2901,2901,2962,2973,2962,2973,2967,72,66,20,59.35,4
,20170518,2973,2967,3054,3054,3054,3054,3054,87,87,2,6.11,6
,20170519,3054,3054,3112,3152,3031,3093,3086,39,32,114,351.89,6
,20170522,3093,3086,3251,3251,3132,3163,3165,77,79,96,303.88,4
,20170523,3163,3165,3093,3173,3093,3158,3134,-7,-31,38,119.10,18
,20170524,3158,3134,3122,3151,3083,3083,3098,-51,-36,14,43.38,6
,20170525,3083,3098,,,,3098,3098,0,0,0,0.00,6
,20170526,3098,3098,,,,3098,3098,0,0,0,0.00,6
,20170531,3098,3098,,,,3098,3098,0,0,0,0.00,6
,20170601,3098,3098,,,,3017,3017,-81,-81,0,0.00,6
,20170602,3017,3017,,,,3017,3017,0,0,0,0.00,6
,20170605,3017,3017,,,,2967,2967,-50,-50,0,0.00,6
,20170606,2967,2967,,,,2932,2932,-35,-35,0,0.00,6
,20170607,2932,2932,,,,2932,2932,0,0,0,0.00,6
,20170608,2932,2932,,,,2932,2932,0,0,0,0.00,6
,20170609,2932,2932,,,,3001,3001,69,69,0,0.00,6
,20170612,3001,3001,3040,3040,3040,3040,3040,39,39,2,6.08,6
,20170613,3040,3040,3027,3027,3027,3027,3027,-13,-13,2,6.05,6
,20170614,3027,3027,,,,2997,2997,-30,-30,0,0.00,6
,20170615,2997,2997,3081,3081,3081,3081,3081,84,84,6,18.49,12
,20170616,3081,3081,,,,3126,3126,45,45,0,0.00,12
,20170619,3126,3126,,,,3153,3153,27,27,0,0.00,12
,20170620,3153,3153,3229,3229,3229,3229,3229,76,76,2,6.46,12
,20170621,3229,3229,,,,3195,3195,-34,-34,0,0.00,12
,20170622,3195,3195,3139,3139,3139,3139,3139,-56,-56,2,6.28,10
,20170623,3139,3139,,,,3120,3120,-19,-19,0,0.00,10
,20170626,3120,3120,3288,3288,3217,3217,3252,97,132,8,26.02,10
,20170627,3217,3252,,,,3301,3301,49,49,0,0.00,10
,20170628,3301,3301,,,,3301,3301,0,0,0,0.00,10
,20170629,3301,3301,,,,3304,3304,3,3,0,0.00,10
,20170630,3304,3304,,,,3287,3287,-17,-17,0,0.00,10
,20170703,3287,3287,3386,3389,3380,3380,3383,93,96,20,67.68,4
,20170704,3380,3383,,,,3386,3386,3,3,0,0.00,4
,20170705,3386,3386,,,,3386,3386,0,0,0,0.00,4
,20170706,3386,3386,,,,3334,3334,-52,-52,0,0.00,4
,20170707,3334,3334,3318,3374,3318,3374,3346,40,12,12,40.15,6
,20170710,3374,3346,3456,3456,3414,3414,3435,68,89,4,13.74,4
,20170711,3414,3435,,,,3508,3508,73,73,0,0.00,4
,20170712,3508,3508,,,,3574,3574,66,66,0,0.00,4
,20170713,3574,3574,,,,3605,3605,31,31,0,0.00,4
,20170714,3605,3605,,,,3587,3587,-18,-18,0,0.00,4
,20170717,3587,3587,,,,3656,3656,69,69,0,0.00,4
,20170718,3656,3656,,,,3654,3654,-2,-2,0,0.00,4
,20170719,3654,3654,,,,3654,3654,0,0,0,0.00,4
,20170720,3654,3654,,,,3621,3621,-33,-33,0,0.00,4
,20170721,3621,3621,,,,3560,3560,-61,-61,0,0.00,4
,20170724,3560,3560,,,,3535,3535,-25,-25,0,0.00,4
,20170725,3535,3535,3508,3511,3508,3511,3509,-24,-26,4,14.04,8
,20170726,3511,3509,3678,3678,3613,3623,3655,114,146,64,233.94,52
,20170727,3623,3655,,,,3655,3655,0,0,0,0.00,52
,20170728,3655,3655,,,,3688,3688,33,33,0,0.00,52
,20170731,3688,3688,,,,3688,3688,0,0,0,0.00,52
,20170801,3688,3688,,,,3711,3711,23,23,0,0.00,52
,20170802,3711,3711,,,,3718,3718,7,7,0,0.00,52
,20170803,3718,3718,3745,3817,3745,3812,3789,94,71,20,75.79,52
,20170804,3812,3789,3874,3913,3818,3875,3863,86,74,58,224.09,36
,20170807,3875,3863,3909,4092,3909,4059,3973,196,110,40,158.96,30
,20170808,4059,3973,,,,3973,3973,0,0,0,0.00,30
,20170809,3973,3973,4050,4050,4050,4050,4050,77,77,16,64.80,14
,20170810,4050,4050,,,,4050,4050,0,0,0,0.00,14
,20170811,4050,4050,3812,4008,3812,4008,3910,-42,-140,4,15.64,14
,20170814,4008,3910,,,,3910,3910,0,0,0,0.00,14
,20170815,3910,3910,3951,3951,3862,3862,3906,-48,-4,12,46.88,14
,20170816,3862,3906,,,,3906,3906,0,0,0,0.00,14
,20170817,3906,3906,4050,4050,3960,3960,4005,54,99,8,32.04,12
,20170818,3960,4005,,,,4005,4005,0,0,0,0.00,12
,20170821,4005,4005,,,,4076,4076,71,71,0,0.00,12
,20170822,4076,4076,,,,4084,4084,8,8,0,0.00,12
,20170823,4084,4084,4001,4001,3970,3970,3987,-114,-97,6,23.92,18
,20170824,3970,3987,3931,3990,3929,3990,3940,3,-47,12,47.28,16
,20170825,3990,3940,4050,4134,4050,4134,4098,194,158,6,24.59,18
,20170828,4134,4098,4150,4150,4120,4120,4135,22,37,4,16.54,14
,20170829,4120,4135,4149,4149,4148,4148,4148,13,13,4,16.59,10
,20170830,4148,4148,,,,4114,4114,-34,-34,0,0.00,10
,20170831,4114,4114,,,,4114,4114,0,0,0,0.00,10
,20170901,4114,4114,,,,4270,4270,156,156,0,0.00,10
,20170904,4270,4270,,,,4411,4411,141,141,0,0.00,10
,20170905,4411,4411,,,,4418,4418,7,7,0,0.00,10
,20170906,4418,4418,,,,4390,4390,-28,-28,0,0.00,10
,20170907,4390,4390,,,,4329,4329,-61,-61,0,0.00,10
,20170908,4329,4329,,,,4301,4301,-28,-28,0,0.00,10
,20170911,4301,4301,,,,4301,4301,0,0,0,0.00,10
,20170912,4301,4301,4239,4239,4133,4198,4190,-103,-111,6,25.14,8
,20170913,4198,4190,,,,4190,4190,0,0,0,0.00,8
,20170914,4190,4190,,,,4148,4148,-42,-42,0,0.00,8
,20170915,4148,4148,,,,4130,4130,-18,-18,0,0.00,8
,20170918,4130,4130,3990,3990,3990,3990,3990,-140,-140,4,15.96,12
,20170919,3990,3990,,,,3990,3990,0,0,0,0.00,12
,20170920,3990,3990,,,,3990,3990,0,0,0,0.00,12
,20170921,3990,3990,,,,3990,3990,0,0,0,0.00,12
,20170922,3990,3990,,,,3891,3891,-99,-99,0,0.00,12
,20170925,3891,3891,,,,3891,3891,0,0,0,0.00,12
,20170926,3891,3891,,,,3891,3891,0,0,0,0.00,12
,20170927,3891,3891,3953,3953,3953,3953,3953,62,62,6,23.72,12
,20170928,3953,3953,,,,3953,3953,0,0,0,0.00,12
,20170929,3953,3953,,,,3941,3941,-12,-12,0,0.00,12
,20171009,3941,3941,,,,4079,4079,138,138,0,0.00,12
,20171010,4079,4079,,,,4079,4079,0,0,0,0.00,12
,20171011,4079,4079,,,,4061,4061,-18,-18,0,0.00,12
,20171012,4061,4061,,,,4061,4061,0,0,0,0.00,12
,20171013,4061,4061,,,,4175,4175,114,114,0,0.00,12
,20171016,4175,4175,,,,4306,4306,131,131,0,0.00,12
,20171017,4306,4306,,,,4306,4306,0,0,0,0.00,12
,20171018,4306,4306,4223,4224,4223,4224,4223,-82,-83,8,33.79,10
,20171019,4224,4223,4025,4025,4023,4023,4024,-200,-199,8,32.20,10
,20171020,4023,4024,,,,4024,4024,0,0,0,0.00,10
,20171023,4024,4024,,,,4024,4024,0,0,0,0.00,10
,20171024,4024,4024,4024,4024,4024,4024,4024,0,0,12,48.29,22
,20171025,4024,4024,,,,4024,4024,0,0,0,0.00,22
,20171026,4024,4024,4000,4000,4000,4000,4000,-24,-24,8,32.00,22
,20171027,4000,4000,,,,4000,4000,0,0,0,0.00,22
,20171030,4000,4000,3950,3950,3950,3950,3950,-50,-50,12,47.40,10
,20171031,3950,3950,3995,3995,3985,3985,3991,35,41,10,39.91,0
,20171101,3985,3991,,,,3991,3991,0,0,0,0.00,0
,20171102,3991,3991,,,,3991,3991,0,0,0,0.00,0
,20171103,3991,3991,,,,3991,3991,0,0,0,0.00,0
,20171106,3991,3991,,,,3991,3991,0,0,0,0.00,0
,20171107,3991,3991,,,,3991,3991,0,0,0,0.00,0
,20171108,3991,3991,,,,3991,3991,0,0,0,0.00,0
,20171109,3991,3991,,,,3991,3991,0,0,0,0.00,0
,20171110,3991,3991,,,,3991,3991,0,0,0,0.00,0
,20171113,3991,3991,,,,3991,3991,0,0,0,0.00,0
,20171114,3991,3991,,,,3991,3991,0,0,0,0.00,0
,20171115,3991,3991,,,,3991,3991,0,0,0,0.00,0
hc1712,20170103,3379,3379,,,,3379,3379,0,0,0,0.00,0
,20170104,3379,3379,,,,3379,3379,0,0,0,0.00,0
,20170105,3379,3379,,,,3379,3379,0,0,0,0.00,0
,20170106,3379,3379,,,,3379,3379,0,0,0,0.00,0
,20170109,3379,3379,,,,3379,3379,0,0,0,0.00,0
,20170110,3379,3379,,,,3379,3379,0,0,0,0.00,0
,20170111,3379,3379,,,,3379,3379,0,0,0,0.00,0
,20170112,3379,3379,,,,3379,3379,0,0,0,0.00,0
,20170113,3379,3379,,,,3379,3379,0,0,0,0.00,0
,20170116,3379,3379,,,,3459,3459,80,80,0,0.00,0
,20170117,3459,3459,3520,3520,3520,3520,3520,61,61,24,84.48,24
,20170118,3520,3520,,,,3487,3487,-33,-33,0,0.00,24
,20170119,3487,3487,,,,3391,3391,-96,-96,0,0.00,24
,20170120,3391,3391,,,,3391,3391,0,0,0,0.00,24
,20170123,3391,3391,,,,3327,3327,-64,-64,0,0.00,24
,20170124,3327,3327,3410,3410,3355,3388,3382,61,55,82,277.38,24
,20170125,3388,3382,,,,3394,3394,12,12,0,0.00,24
,20170126,3394,3394,,,,3449,3449,55,55,0,0.00,24
,20170203,3449,3449,,,,3292,3292,-157,-157,0,0.00,24
,20170206,3292,3292,,,,3292,3292,0,0,0,0.00,24
,20170207,3292,3292,3320,3320,3250,3250,3285,-42,-7,4,13.14,24
,20170208,3250,3285,,,,3344,3344,59,59,0,0.00,24
,20170209,3344,3344,,,,3382,3382,38,38,0,0.00,24
,20170210,3382,3382,,,,3412,3412,30,30,0,0.00,24
,20170213,3412,3412,,,,3525,3525,113,113,0,0.00,24
,20170214,3525,3525,,,,3543,3543,18,18,0,0.00,24
,20170215,3543,3543,,,,3534,3534,-9,-9,0,0.00,24
,20170216,3534,3534,,,,3778,3778,244,244,0,0.00,24
,20170217,3778,3778,,,,3781,3781,3,3,0,0.00,24
,20170220,3781,3781,,,,3817,3817,36,36,0,0.00,24
,20170221,3817,3817,,,,3861,3861,44,44,0,0.00,24
,20170222,3861,3861,,,,3590,3590,-271,-271,0,0.00,24
,20170223,3590,3590,,,,3556,3556,-34,-34,0,0.00,24
,20170224,3556,3556,,,,3457,3457,-99,-99,0,0.00,24
,20170227,3457,3457,3618,3618,3492,3492,3555,35,98,8,28.44,24
,20170228,3492,3555,,,,3532,3532,-23,-23,0,0.00,24
,20170301,3532,3532,,,,3471,3471,-61,-61,0,0.00,24
,20170302,3471,3471,,,,3471,3471,0,0,0,0.00,24
,20170303,3471,3471,,,,3471,3471,0,0,0,0.00,24
,20170306,3471,3471,,,,3446,3446,-25,-25,0,0.00,24
,20170307,3446,3446,,,,3421,3421,-25,-25,0,0.00,24
,20170308,3421,3421,,,,3383,3383,-38,-38,0,0.00,24
,20170309,3383,3383,3188,3188,3188,3188,3188,-195,-195,22,70.14,24
,20170310,3188,3188,,,,3207,3207,19,19,0,0.00,24
,20170313,3207,3207,,,,3236,3236,29,29,0,0.00,24
,20170314,3236,3236,,,,3104,3104,-132,-132,0,0.00,24
,20170315,3104,3104,3321,3321,3321,3321,3321,217,217,40,132.84,34
,20170316,3321,3321,,,,3323,3323,2,2,0,0.00,34
,20170317,3323,3323,3394,3441,3394,3441,3396,118,73,34,115.49,24
,20170320,3441,3396,,,,3394,3394,-2,-2,0,0.00,24
,20170321,3394,3394,3332,3332,3332,3332,3332,-62,-62,2,6.66,24
,20170322,3332,3332,3165,3165,3165,3165,3165,-167,-167,8,25.32,32
,20170323,3165,3165,3168,3171,3168,3171,3169,6,4,4,12.68,36
,20170324,3171,3169,3153,3158,3148,3158,3153,-11,-16,8,25.22,32
,20170327,3158,3153,3044,3044,3044,3044,3044,-109,-109,2,6.09,30
,20170328,3044,3044,,,,3060,3060,16,16,0,0.00,30
,20170329,3060,3060,3123,3123,3123,3123,3123,63,63,2,6.25,28
,20170330,3123,3123,3175,3175,3175,3175,3175,52,52,2,6.35,28
,20170331,3175,3175,3070,3212,3070,3179,3153,4,-22,6,18.92,28
,20170405,3179,3153,3237,3237,3094,3094,3141,-59,-12,6,18.85,30
,20170406,3094,3141,3139,3139,3139,3139,3139,-2,-2,2,6.28,30
,20170407,3139,3139,3052,3052,3052,3052,3052,-87,-87,2,6.10,30
,20170410,3052,3052,,,,3047,3047,-5,-5,0,0.00,30
,20170411,3047,3047,,,,3010,3010,-37,-37,0,0.00,30
,20170412,3010,3010,,,,2924,2924,-86,-86,0,0.00,30
,20170413,2924,2924,,,,2924,2924,0,0,0,0.00,30
,20170414,2924,2924,,,,2924,2924,0,0,0,0.00,30
,20170417,2924,2924,,,,2924,2924,0,0,0,0.00,30
,20170418,2924,2924,,,,2858,2858,-66,-66,0,0.00,30
,20170419,2858,2858,,,,2858,2858,0,0,0,0.00,30
,20170420,2858,2858,,,,2858,2858,0,0,0,0.00,30
,20170421,2858,2858,2908,2908,2890,2890,2899,32,41,4,11.60,30
,20170424,2890,2899,,,,2899,2899,0,0,0,0.00,30
,20170425,2899,2899,,,,2899,2899,0,0,0,0.00,30
,20170426,2899,2899,,,,2899,2899,0,0,0,0.00,30
,20170427,2899,2899,,,,2960,2960,61,61,0,0.00,30
,20170428,2960,2960,,,,3010,3010,50,50,0,0.00,30
,20170502,3010,3010,,,,3040,3040,30,30,0,0.00,30
,20170503,3040,3040,,,,3040,3040,0,0,0,0.00,30
,20170504,3040,3040,,,,2918,2918,-122,-122,0,0.00,30
,20170505,2918,2918,,,,2825,2825,-93,-93,0,0.00,30
,20170508,2825,2825,,,,2825,2825,0,0,0,0.00,30
,20170509,2825,2825,2805,2880,2801,2830,2841,5,16,16,45.46,32
,20170510,2830,2841,2830,2830,2830,2830,2830,-11,-11,22,62.26,10
,20170511,2830,2830,,,,2830,2830,0,0,0,0.00,10
,20170512,2830,2830,2795,2859,2780,2780,2811,-50,-19,6,16.87,12
,20170515,2780,2811,,,,2811,2811,0,0,0,0.00,12
,20170516,2811,2811,,,,2840,2840,29,29,0,0.00,12
,20170517,2840,2840,,,,2930,2930,90,90,0,0.00,12
,20170518,2930,2930,,,,2957,2957,27,27,0,0.00,12
,20170519,2957,2957,,,,3019,3019,62,62,0,0.00,12
,20170522,3019,3019,3173,3173,3115,3115,3144,96,125,40,125.76,12
,20170523,3115,3144,3060,3060,3060,3060,3060,-84,-84,2,6.12,12
,20170524,3060,3060,,,,3060,3060,0,0,0,0.00,12
,20170525,3060,3060,,,,3060,3060,0,0,0,0.00,12
,20170526,3060,3060,3088,3100,3004,3036,3047,-24,-13,164,499.71,12
,20170531,3036,3047,,,,3047,3047,0,0,0,0.00,12
,20170601,3047,3047,2911,2987,2911,2987,2949,-60,-98,4,11.80,10
,20170602,2987,2949,,,,2949,2949,0,0,0,0.00,10
,20170605,2949,2949,,,,2900,2900,-49,-49,0,0.00,10
,20170606,2900,2900,,,,2900,2900,0,0,0,0.00,10
,20170607,2900,2900,,,,2900,2900,0,0,0,0.00,10
,20170608,2900,2900,,,,2915,2915,15,15,0,0.00,10
,20170609,2915,2915,3009,3009,3009,3009,3009,94,94,6,18.05,4
,20170612,3009,3009,,,,3009,3009,0,0,0,0.00,4
,20170613,3009,3009,,,,2996,2996,-13,-13,0,0.00,4
,20170614,2996,2996,3033,3033,2939,2939,2986,-57,-10,4,11.94,4
,20170615,2939,2986,,,,3044,3044,58,58,0,0.00,4
,20170616,3044,3044,,,,3089,3089,45,45,0,0.00,4
,20170619,3089,3089,,,,3116,3116,27,27,0,0.00,4
,20170620,3116,3116,,,,3116,3116,0,0,0,0.00,4
,20170621,3116,3116,3032,3133,3032,3133,3082,17,-34,4,12.33,4
,20170622,3133,3082,,,,3027,3027,-55,-55,0,0.00,4
,20170623,3027,3027,,,,3009,3009,-18,-18,0,0.00,4
,20170626,3009,3009,,,,3136,3136,127,127,0,0.00,4
,20170627,3136,3136,,,,3184,3184,48,48,0,0.00,4
,20170628,3184,3184,,,,3259,3259,75,75,0,0.00,4
,20170629,3259,3259,,,,3259,3259,0,0,0,0.00,4
,20170630,3259,3259,,,,3259,3259,0,0,0,0.00,4
,20170703,3259,3259,,,,3355,3355,96,96,0,0.00,4
,20170704,3355,3355,,,,3358,3358,3,3,0,0.00,4
,20170705,3358,3358,,,,3373,3373,15,15,0,0.00,4
,20170706,3373,3373,,,,3321,3321,-52,-52,0,0.00,4
,20170707,3321,3321,,,,3321,3321,0,0,0,0.00,4
,20170710,3321,3321,,,,3321,3321,0,0,0,0.00,4
,20170711,3321,3321,,,,3391,3391,70,70,0,0.00,4
,20170712,3391,3391,3566,3566,3496,3496,3554,105,163,12,42.65,12
,20170713,3496,3554,,,,3584,3584,30,30,0,0.00,12
,20170714,3584,3584,,,,3566,3566,-18,-18,0,0.00,12
,20170717,3566,3566,,,,3635,3635,69,69,0,0.00,12
,20170718,3635,3635,,,,3633,3633,-2,-2,0,0.00,12
,20170719,3633,3633,3646,3646,3646,3646,3646,13,13,8,29.17,4
,20170720,3646,3646,,,,3613,3613,-33,-33,0,0.00,4
,20170721,3613,3613,,,,3552,3552,-61,-61,0,0.00,4
,20170724,3552,3552,,,,3552,3552,0,0,0,0.00,4
,20170725,3552,3552,,,,3552,3552,0,0,0,0.00,4
,20170726,3552,3552,,,,3552,3552,0,0,0,0.00,4
,20170727,3552,3552,,,,3552,3552,0,0,0,0.00,4
,20170728,3552,3552,,,,3552,3552,0,0,0,0.00,4
,20170731,3552,3552,3765,3765,3683,3683,3724,131,172,4,14.90,6
,20170801,3683,3724,3735,3761,3665,3671,3708,-53,-16,8,29.66,4
,20170802,3671,3708,,,,3708,3708,0,0,0,0.00,4
,20170803,3708,3708,3712,3785,3712,3785,3757,77,49,14,52.60,10
,20170804,3785,3757,,,,3830,3830,73,73,0,0.00,10
,20170807,3830,3830,,,,3940,3940,110,110,0,0.00,10
,20170808,3940,3940,,,,3953,3953,13,13,0,0.00,10
,20170809,3953,3953,3889,3990,3889,3956,3970,3,17,44,174.71,10
,20170810,3956,3970,,,,3970,3970,0,0,0,0.00,10
,20170811,3970,3970,3971,3971,3873,3971,3938,1,-32,6,23.63,10
,20170814,3971,3938,,,,3938,3938,0,0,0,0.00,10
,20170815,3938,3938,,,,3890,3890,-48,-48,0,0.00,10
,20170816,3890,3890,3853,3853,3853,3853,3853,-37,-37,2,7.71,8
,20170817,3853,3853,,,,3913,3913,60,60,0,0.00,8
,20170818,3913,3913,,,,3971,3971,58,58,0,0.00,8
,20170821,3971,3971,4021,4021,4021,4021,4021,50,50,2,8.04,8
,20170822,4021,4021,,,,4021,4021,0,0,0,0.00,8
,20170823,4021,4021,4013,4013,3781,3781,3897,-240,-124,8,31.18,8
,20170824,3781,3897,,,,3851,3851,-46,-46,0,0.00,8
,20170825,3851,3851,4082,4082,4082,4082,4082,231,231,10,40.82,12
,20170828,4082,4082,,,,4082,4082,0,0,0,0.00,12
,20170829,4082,4082,4088,4096,4048,4083,4067,1,-15,18,73.21,6
,20170830,4083,4067,3993,3993,3993,3993,3993,-74,-74,6,23.96,12
,20170831,3993,3993,,,,3961,3961,-32,-32,0,0.00,12
,20170901,3961,3961,4074,4198,4074,4198,4156,237,195,6,24.94,18
,20170904,4198,4156,4260,4380,4260,4367,4349,211,193,46,200.09,34
,20170905,4367,4349,,,,4349,4349,0,0,0,0.00,34
,20170906,4349,4349,,,,4295,4295,-54,-54,0,0.00,34
,20170907,4295,4295,4266,4269,4223,4241,4244,-54,-51,14,59.43,30
,20170908,4241,4244,4291,4291,4188,4188,4235,-56,-9,24,101.65,32
,20170911,4188,4235,4194,4194,4194,4194,4194,-41,-41,4,16.78,32
,20170912,4194,4194,,,,4194,4194,0,0,0,0.00,32
,20170913,4194,4194,4244,4244,4153,4164,4200,-30,6,8,33.60,32
,20170914,4164,4200,4124,4124,4124,4124,4124,-76,-76,6,24.74,30
,20170915,4124,4124,,,,4124,4124,0,0,0,0.00,30
,20170918,4124,4124,,,,4124,4124,0,0,0,0.00,30
,20170919,4124,4124,4062,4062,4062,4062,4062,-62,-62,4,16.25,34
,20170920,4062,4062,3926,4005,3926,4005,3965,-57,-97,16,63.45,42
,20170921,4005,3965,,,,3965,3965,0,0,0,0.00,42
,20170922,3965,3965,3833,3834,3833,3833,3833,-132,-132,22,84.33,26
,20170925,3833,3833,3798,3798,3798,3798,3798,-35,-35,2,7.60,26
,20170926,3798,3798,,,,3831,3831,33,33,0,0.00,26
,20170927,3831,3831,,,,3831,3831,0,0,0,0.00,26
,20170928,3831,3831,,,,3845,3845,14,14,0,0.00,26
,20170929,3845,3845,3870,3971,3870,3971,3920,126,75,36,141.14,24
,20171009,3971,3920,4046,4046,4046,4046,4046,126,126,4,16.18,26
,20171010,4046,4046,3987,3987,3873,3873,3930,-173,-116,4,15.72,24
,20171011,3873,3930,,,,3922,3922,-8,-8,0,0.00,24
,20171012,3922,3922,,,,3975,3975,53,53,0,0.00,24
,20171013,3975,3975,4024,4024,4024,4024,4024,49,49,2,8.05,26
,20171016,4024,4024,4252,4252,4252,4252,4252,228,228,2,8.50,24
,20171017,4252,4252,,,,4252,4252,0,0,0,0.00,24
,20171018,4252,4252,4074,4088,4074,4088,4078,-164,-174,6,24.47,22
,20171019,4088,4078,,,,3886,3886,-192,-192,0,0.00,22
,20171020,3886,3886,,,,3886,3886,0,0,0,0.00,22
,20171023,3886,3886,,,,3886,3886,0,0,0,0.00,22
,20171024,3886,3886,,,,3886,3886,0,0,0,0.00,22
,20171025,3886,3886,4119,4119,4089,4089,4104,203,218,4,16.42,22
,20171026,4089,4104,,,,4079,4079,-25,-25,0,0.00,22
,20171027,4079,4079,,,,4079,4079,0,0,0,0.00,22
,20171030,4079,4079,,,,4028,4028,-51,-51,0,0.00,22
,20171031,4028,4028,,,,4069,4069,41,41,0,0.00,22
,20171101,4069,4069,,,,4069,4069,0,0,0,0.00,22
,20171102,4069,4069,,,,4069,4069,0,0,0,0.00,22
,20171103,4069,4069,,,,4069,4069,0,0,0,0.00,22
,20171106,4069,4069,,,,4069,4069,0,0,0,0.00,22
,20171107,4069,4069,,,,4069,4069,0,0,0,0.00,22
,20171108,4069,4069,,,,4069,4069,0,0,0,0.00,22
,20171109,4069,4069,,,,4069,4069,0,0,0,0.00,22
,20171110,4069,4069,,,,4069,4069,0,0,0,0.00,22
,20171113,4069,4069,,,,4069,4069,0,0,0,0.00,22
,20171114,4069,4069,,,,4069,4069,0,0,0,0.00,22
,20171115,4069,4069,4014,4015,3998,3998,4007,-71,-62,22,88.16,38
,20171116,3998,4007,4061,4125,4052,4125,4084,118,77,32,130.70,8
,20171117,4125,4084,,,,4084,4084,0,0,0,0.00,8
,20171120,4084,4084,,,,4084,4084,0,0,0,0.00,8
,20171121,4084,4084,,,,4084,4084,0,0,0,0.00,8
,20171122,4084,4084,,,,4084,4084,0,0,0,0.00,8
,20171123,4084,4084,4076,4076,4076,4076,4076,-8,-8,2,8.15,6
,20171124,4076,4076,,,,4076,4076,0,0,0,0.00,6
,20171127,4076,4076,,,,4076,4076,0,0,0,0.00,6
,20171128,4076,4076,,,,4099,4099,23,23,0,0.00,6
,20171129,4099,4099,,,,4150,4150,51,51,0,0.00,6
,20171130,4150,4150,4166,4166,4100,4100,4133,-50,-17,12,49.60,0
,20171201,4100,4133,,,,4133,4133,0,0,0,0.00,0
,20171204,4133,4133,,,,4133,4133,0,0,0,0.00,0
,20171205,4133,4133,,,,4133,4133,0,0,0,0.00,0
,20171206,4133,4133,,,,4133,4133,0,0,0,0.00,0
,20171207,4133,4133,,,,4133,4133,0,0,0,0.00,0
,20171208,4133,4133,,,,4133,4133,0,0,0,0.00,0
,20171211,4133,4133,,,,4133,4133,0,0,0,0.00,0
,20171212,4133,4133,,,,4133,4133,0,0,0,0.00,0
,20171213,4133,4133,,,,4133,4133,0,0,0,0.00,0
,20171214,4133,4133,,,,4133,4133,0,0,0,0.00,0
,20171215,4133,4133,,,,4133,4133,0,0,0,0.00,0
hc1801,20170117,3459,3459,3617,3617,3419,3436,3476,-23,17,66,229.44,58
,20170118,3436,3476,3366,3440,3351,3431,3418,-45,-58,128,437.55,146
,20170119,3431,3418,3422,3430,3370,3370,3404,-48,-14,26,88.52,152
,20170120,3370,3404,,,,3340,3340,-64,-64,0,0.00,152
,20170123,3340,3340,3299,3308,3269,3298,3288,-42,-52,22,72.35,166
,20170124,3298,3288,3316,3420,3316,3394,3381,106,93,92,311.07,188
,20170125,3394,3381,3400,3404,3388,3403,3397,22,16,12,40.77,194
,20170126,3403,3397,3401,3455,3368,3455,3415,58,18,38,129.79,200
,20170203,3455,3415,3350,3351,3253,3259,3291,-156,-124,120,394.95,278
,20170206,3259,3291,3251,3279,3207,3212,3235,-79,-56,218,705.27,448
,20170207,3212,3235,3206,3354,3206,3279,3269,44,34,96,313.84,452
,20170208,3279,3269,3270,3358,3250,3345,3307,76,38,236,780.52,382
,20170209,3345,3307,3352,3373,3311,3311,3343,4,36,108,361.14,380
,20170210,3311,3343,3292,3470,3291,3419,3378,76,35,122,412.19,402
,20170213,3419,3378,3425,3538,3425,3527,3473,149,95,174,604.31,382
,20170214,3527,3473,3530,3535,3463,3517,3514,44,41,70,246.02,366
,20170215,3517,3514,3520,3537,3476,3476,3497,-38,-17,44,153.87,378
,20170216,3476,3497,3452,3593,3442,3522,3516,25,19,72,253.21,376
,20170217,3522,3516,3489,3512,3475,3498,3486,-18,-30,176,613.65,394
,20170220,3498,3486,3522,3555,3502,3544,3533,58,47,388,"1,370.84",476
,20170221,3544,3533,3556,3617,3541,3554,3581,21,48,250,895.42,596
,20170222,3554,3581,3560,3567,3475,3487,3510,-94,-71,282,990.10,676
,20170223,3487,3510,3507,3529,3420,3438,3472,-72,-38,146,507.04,730
,20170224,3438,3472,3471,3472,3326,3422,3386,-50,-86,484,"1,639.27",978
,20170227,3422,3386,3438,3540,3415,3473,3449,87,63,458,"1,579.95",924
,20170228,3473,3449,3501,3501,3362,3362,3458,-87,9,198,684.86,906
,20170301,3362,3458,3398,3447,3359,3399,3395,-59,-63,544,"1,847.24",1076
,20170302,3399,3395,3402,3421,3358,3399,3398,4,3,524,"1,780.94",1350
,20170303,3399,3398,3391,3391,3300,3354,3327,-44,-71,602,"2,002.96",1676
,20170306,3354,3327,3373,3373,3263,3280,3308,-47,-19,814,"2,693.45",2208
,20170307,3280,3308,3279,3318,3261,3282,3286,-26,-22,494,"1,623.38",2418
,20170308,3282,3286,3278,3302,3218,3224,3259,-62,-27,658,"2,144.71",2802
,20170309,3224,3259,3223,3256,3141,3188,3187,-71,-72,1708,"5,444.62",3760
,20170310,3188,3187,3185,3230,3178,3193,3200,6,13,744,"2,381.45",3916
,20170313,3193,3200,3186,3310,3143,3288,3219,88,19,650,"2,092.36",3946
,20170314,3288,3219,3299,3313,3233,3253,3269,34,50,594,"1,942.17",3950
,20170315,3253,3269,3236,3401,3222,3371,3348,102,79,1180,"3,951.05",4046
,20170316,3371,3348,3371,3387,3310,3382,3355,34,7,1304,"4,376.04",4838
,20170317,3382,3355,3363,3380,3315,3359,3355,4,0,1096,"3,677.94",5162
,20170320,3359,3355,3362,3390,3291,3304,3348,-51,-7,1104,"3,696.92",5364
,20170321,3304,3348,3301,3312,3216,3224,3257,-124,-91,712,"2,319.41",5284
,20170322,3224,3257,3224,3226,3091,3091,3150,-166,-107,1208,"3,805.48",5888
,20170323,3091,3150,3111,3150,3092,3092,3121,-58,-29,1172,"3,658.61",6194
,20170324,3092,3121,3080,3149,3056,3106,3107,-15,-14,2006,"6,233.77",6370
,20170327,3106,3107,3080,3098,2966,3016,3013,-91,-94,2476,"7,461.28",6684
,20170328,3016,3013,3013,3055,2988,3013,3027,0,14,890,"2,694.03",6686
,20170329,3013,3027,3020,3145,3020,3135,3102,108,75,2204,"6,836.89",6986
,20170330,3135,3102,3128,3162,3100,3120,3131,18,29,1370,"4,290.67",6682
,20170331,3120,3131,3101,3196,3073,3106,3136,-25,5,2492,"7,815.08",7746
,20170405,3106,3136,3140,3200,3111,3125,3154,-11,18,6554,"20,672.47",11432
,20170406,3125,3154,3125,3153,3081,3115,3110,-39,-44,5712,"17,769.49",14490
,20170407,3115,3110,3090,3100,2971,3014,3036,-96,-74,5882,"17,859.21",14474
,20170410,3014,3036,3013,3044,2986,2998,3012,-38,-24,4936,"14,867.30",14252
,20170411,2998,3012,2998,3010,2954,2973,2980,-39,-32,5556,"16,559.97",15720
,20170412,2973,2980,2973,2975,2867,2875,2904,-105,-76,9868,"28,658.27",21344
,20170413,2875,2904,2881,2953,2860,2917,2912,13,8,8050,"23,447.12",23540
,20170414,2917,2912,2917,2991,2917,2943,2956,31,44,8642,"25,553.99",22294
,20170417,2943,2956,2951,2987,2800,2913,2925,-43,-31,9168,"26,823.78",20972
,20170418,2913,2925,2913,2921,2810,2820,2852,-105,-73,7116,"20,300.53",22880
,20170419,2820,2852,2820,2861,2813,2842,2842,-10,-10,6506,"18,491.83",21826
,20170420,2842,2842,2842,2930,2765,2880,2841,38,-1,12842,"36,494.63",26676
,20170421,2880,2841,2880,2950,2859,2915,2908,74,67,7830,"22,777.02",27266
,20170424,2915,2908,2915,2928,2846,2912,2887,4,-21,7754,"22,388.75",28244
,20170425,2912,2887,2936,2955,2887,2943,2926,56,39,8030,"23,497.62",26822
,20170426,2943,2926,2943,3023,2931,2971,2989,45,63,10244,"30,629.34",25876
,20170427,2971,2989,2971,3020,2955,3010,2982,21,-7,8118,"24,209.69",26144
,20170428,3010,2982,3021,3098,3012,3089,3048,107,66,11786,"35,928.28",24642
,20170502,3089,3048,3118,3139,3068,3089,3094,41,46,7612,"23,553.15",25960
,20170503,3089,3094,3085,3099,3042,3066,3066,-28,-28,12784,"39,206.24",30206
,20170504,3066,3066,3055,3055,2851,2853,2953,-213,-113,20666,"61,036.11",32918
,20170505,2853,2953,2880,2880,2807,2845,2846,-108,-107,15956,"45,418.22",35456
,20170508,2845,2846,2848,2927,2832,2885,2879,39,33,20942,"60,305.42",37852
,20170509,2885,2879,2867,2884,2818,2847,2844,-32,-35,16686,"47,468.48",41256
,20170510,2847,2844,2847,2894,2832,2876,2863,32,19,19344,"55,390.00",40882
,20170511,2876,2863,2876,2913,2798,2895,2853,32,-10,26908,"76,780.50",41876
,20170512,2895,2853,2901,2901,2802,2808,2846,-45,-7,20776,"59,137.68",45866
,20170515,2808,2846,2808,2903,2800,2866,2853,20,7,18994,"54,207.35",45254
,20170516,2866,2853,2863,2879,2835,2867,2857,14,4,13140,"37,542.77",46326
,20170517,2867,2857,2873,2984,2864,2974,2938,117,81,33398,"98,144.97",43402
,20170518,2974,2938,2972,2991,2930,2979,2960,41,22,18342,"54,305.23",43450
,20170519,2979,2960,2950,3052,2925,3047,3005,87,45,22308,"67,042.93",43658
,20170522,3047,3005,3053,3164,3037,3111,3106,106,101,28652,"89,020.39",45760
,20170523,3111,3106,3111,3129,3070,3086,3103,-20,-3,15750,"48,875.40",46714
,20170524,3086,3103,3086,3125,3013,3064,3065,-39,-38,24870,"76,245.25",46058
,20170525,3064,3065,3090,3129,3048,3051,3083,-14,18,20030,"61,768.71",47522
,20170526,3051,3083,3057,3075,2986,3042,3028,-41,-55,25306,"76,650.90",47026
,20170531,3042,3028,3042,3110,2951,2964,3034,-64,6,26460,"80,284.65",49154
,20170601,2964,3034,2972,2975,2910,2943,2944,-91,-90,20118,"59,231.66",49684
,20170602,2943,2944,2943,2964,2902,2925,2934,-19,-10,23150,"67,934.65",49862
,20170605,2925,2934,2920,2934,2836,2853,2882,-81,-52,25300,"72,928.28",50932
,20170606,2853,2882,2852,2885,2829,2866,2860,-16,-22,22976,"65,718.18",51974
,20170607,2866,2860,2861,2895,2855,2872,2873,12,13,18722,"53,793.52",53796
,20170608,2872,2873,2872,2933,2850,2887,2889,14,16,23934,"69,152.00",55298
,20170609,2887,2889,2888,2982,2884,2972,2938,83,49,31746,"93,273.62",58252
,20170612,2972,2938,2972,3020,2945,2979,2978,41,40,48262,"143,739.95",62604
,20170613,2979,2978,2976,3000,2907,2908,2962,-70,-16,28424,"84,204.86",62628
,20170614,2908,2962,2904,3010,2883,3005,2937,43,-25,40846,"119,968.14",62930
,20170615,3005,2937,3008,3069,2951,3060,3023,123,86,44880,"135,677.79",61898
,20170616,3060,3023,3054,3106,3042,3050,3071,27,48,29870,"91,741.54",62306
,20170619,3050,3071,3054,3141,3048,3111,3099,40,28,32010,"99,200.69",62622
,20170620,3111,3099,3105,3123,3080,3092,3101,-7,2,24884,"77,167.64",64044
,20170621,3092,3101,3092,3092,3037,3075,3066,-26,-35,35606,"109,170.15",71298
,20170622,3075,3066,3078,3135,3066,3071,3106,5,40,32054,"99,583.78",74284
,20170623,3071,3106,3077,3120,3066,3117,3091,11,-15,26616,"82,283.31",75106
,20170626,3117,3091,3120,3162,3092,3152,3130,61,39,29552,"92,521.74",78778
,20170627,3152,3130,3152,3205,3132,3205,3167,75,37,29668,"93,967.28",81254
,20170628,3205,3167,3206,3269,3206,3260,3240,93,73,45562,"147,625.60",87072
,20170629,3260,3240,3260,3300,3238,3261,3267,21,27,54266,"177,316.54",90606
,20170630,3261,3267,3249,3265,3212,3247,3241,-20,-26,55444,"179,707.38",90830
,20170703,3247,3241,3227,3335,3227,3328,3285,87,44,58106,"190,926.80",92488
,20170704,3328,3285,3321,3345,3248,3261,3292,-24,7,50578,"166,524.61",91112
,20170705,3261,3292,3266,3340,3265,3296,3299,4,7,45132,"148,893.65",90724
,20170706,3296,3299,3285,3288,3206,3271,3249,-28,-50,48976,"159,157.44",98988
,20170707,3271,3249,3265,3330,3235,3320,3281,71,32,63510,"208,418.97",112082
,20170710,3320,3281,3320,3384,3315,3348,3347,67,66,85838,"287,377.33",125128
,20170711,3348,3347,3338,3481,3336,3454,3409,107,62,60506,"206,312.59",126160
,20170712,3454,3409,3444,3503,3444,3466,3472,57,63,54926,"190,750.33",125796
,20170713,3466,3472,3469,3572,3458,3569,3517,97,45,62886,"221,206.85",136216
,20170714,3569,3517,3570,3570,3445,3472,3492,-45,-25,79954,"279,219.39",139036
,20170717,3472,3492,3470,3595,3462,3571,3549,79,57,85272,"302,636.72",137718
,20170718,3571,3549,3573,3584,3514,3527,3548,-22,-1,57628,"204,465.89",136814
,20170719,3527,3548,3538,3604,3527,3597,3579,49,31,68284,"244,427.48",138806
,20170720,3597,3579,3598,3598,3463,3475,3533,-104,-46,97374,"344,047.15",135986
,20170721,3475,3533,3488,3502,3431,3478,3469,-55,-64,66224,"229,777.84",134426
,20170724,3478,3469,3485,3508,3407,3462,3455,-7,-14,80904,"279,592.57",146388
,20170725,3462,3455,3489,3544,3446,3526,3503,71,48,100244,"351,218.98",159820
,20170726,3526,3503,3533,3621,3521,3550,3571,47,68,136420,"487,166.75",178482
,20170727,3550,3571,3545,3566,3488,3559,3529,-12,-42,149606,"528,016.47",193226
,20170728,3559,3529,3559,3606,3533,3555,3568,26,39,142352,"507,985.81",202066
,20170731,3555,3568,3565,3710,3556,3699,3652,131,84,182352,"666,008.17",220186
,20170801,3699,3652,3699,3724,3658,3670,3685,18,33,118272,"435,884.54",228122
,20170802,3670,3685,3679,3730,3645,3701,3702,16,17,172320,"638,063.56",251844
,20170803,3701,3702,3713,3794,3698,3770,3746,68,44,307794,"1,153,204.46",315624
,20170804,3770,3746,3774,3871,3756,3858,3819,112,73,328368,"1,254,037.63",379078
,20170807,3858,3819,3855,4048,3820,3985,3960,166,141,432002,"1,711,086.05",387898
,20170808,3985,3960,3987,4045,3900,3927,3968,-33,8,355250,"1,409,812.99",379380
,20170809,3927,3968,3942,4070,3906,4068,3984,100,16,481158,"1,917,262.21",431078
,20170810,4068,3984,4059,4114,3984,4028,4048,44,64,582518,"2,358,580.80",461566
,20170811,4028,4048,4005,4075,3908,3937,3993,-111,-55,795222,"3,175,992.23",453638
,20170814,3937,3993,3945,3973,3857,3876,3905,-117,-88,914124,"3,570,015.74",482986
,20170815,3876,3905,3863,3883,3775,3840,3822,-65,-83,1225080,"4,683,198.17",486790
,20170816,3840,3822,3833,3880,3816,3829,3842,7,20,1136992,"4,368,566.94",524118
,20170817,3829,3842,3843,3993,3841,3942,3930,100,88,1850838,"7,273,865.13",548294
,20170818,3942,3930,3933,4037,3916,4021,3960,91,30,1437854,"5,694,208.14",583506
,20170821,4021,3960,4010,4109,3943,4068,4036,108,76,1572408,"6,346,571.94",590180
,20170822,4068,4036,4051,4087,3993,4047,4041,11,5,1280314,"5,173,938.22",572152
,20170823,4047,4041,4037,4037,3798,3865,3883,-176,-158,2083776,"8,091,390.61",605400
,20170824,3865,3883,3865,3979,3840,3962,3925,79,42,1826126,"7,167,968.69",569488
,20170825,3962,3925,3948,4144,3942,4050,4058,125,133,1327118,"5,386,143.10",743460
,20170828,4050,4058,4050,4109,3936,4081,4025,23,-33,1001916,"4,033,439.51",698110
,20170829,4081,4025,4086,4117,4004,4054,4064,29,39,1147216,"4,663,193.30",844724
,20170830,4054,4064,4060,4093,3985,4068,4039,4,-25,916612,"3,702,580.10",829662
,20170831,4068,4039,4050,4075,3941,4072,4011,33,-28,1219378,"4,891,141.79",857990
,20170901,4072,4011,4058,4251,4046,4251,4149,240,138,1182752,"4,907,577.80",948926
,20170904,4251,4149,4255,4400,4245,4284,4307,135,158,1350438,"5,816,725.49",1007042
,20170905,4284,4307,4280,4362,4273,4338,4326,31,19,1029092,"4,452,125.76",1061864
,20170906,4338,4326,4339,4386,4215,4222,4295,-104,-31,1258036,"5,403,962.47",1022026
,20170907,4222,4295,4230,4269,4193,4217,4227,-78,-68,1019244,"4,309,140.53",975726
,20170908,4217,4227,4209,4296,4128,4151,4210,-76,-17,1287244,"5,419,753.09",1004982
,20170911,4151,4210,4150,4180,4074,4161,4138,-49,-72,861170,"3,563,685.00",909098
,20170912,4161,4138,4161,4198,4087,4177,4140,39,2,962154,"3,984,180.56",974686
,20170913,4177,4140,4180,4220,4098,4119,4157,-21,17,905418,"3,763,825.03",926584
,20170914,4119,4157,4125,4174,4051,4078,4104,-79,-53,1257662,"5,162,678.32",1039440
,20170915,4078,4104,4080,4109,4033,4065,4073,-39,-31,926212,"3,773,155.34",999576
,20170918,4065,4073,4074,4092,3986,4046,4033,-27,-40,941078,"3,795,735.06",994938
,20170919,4046,4033,4041,4079,3980,3982,4033,-51,0,698594,"2,817,988.91",946658
,20170920,3982,4033,3979,4028,3928,3993,3971,-40,-62,802262,"3,185,925.89",950842
,20170921,3993,3971,4003,4049,3885,3890,3974,-81,3,1065582,"4,235,586.83",997492
,20170922,3890,3974,3899,3899,3740,3765,3827,-209,-147,849046,"3,250,142.45",944166
,20170925,3765,3827,3785,3838,3757,3820,3800,-7,-27,757126,"2,877,781.01",927964
,20170926,3820,3800,3820,3870,3808,3846,3839,46,39,621426,"2,386,136.51",911152
,20170927,3846,3839,3850,3930,3843,3919,3888,80,49,859646,"3,342,923.58",947772
,20170928,3919,3888,3927,3972,3822,3880,3899,-8,11,1037750,"4,046,647.88",935344
,20170929,3880,3899,3883,3978,3788,3978,3883,79,-16,952792,"3,700,089.01",909868
,20171009,3978,3883,4030,4100,3970,4007,4030,124,147,662000,"2,668,432.69",925558
,20171010,4007,4030,4000,4016,3850,3850,3900,-180,-130,1063376,"4,147,721.23",969172
,20171011,3850,3900,3851,3900,3809,3814,3851,-86,-49,824900,"3,177,370.13",935412
,20171012,3814,3851,3820,4028,3800,4002,3895,151,44,1356036,"5,281,871.81",1105206
,20171013,4002,3895,4000,4128,3973,4128,4043,233,148,1146328,"4,634,676.87",1106168
,20171016,4128,4043,4148,4239,4126,4170,4171,127,128,1160688,"4,841,644.09",1154934
,20171017,4170,4171,4170,4180,4022,4049,4099,-122,-72,1319720,"5,410,522.25",1090000
,20171018,4049,4099,4050,4096,4010,4035,4058,-64,-41,879610,"3,569,840.56",1034298
,20171019,4035,4058,4035,4038,3892,3916,3949,-142,-109,1200404,"4,741,235.82",1047622
,20171020,3916,3949,3916,4114,3888,4113,3986,164,37,1169112,"4,660,300.25",999522
,20171023,4113,3986,4109,4110,3951,4040,4032,54,46,1187056,"4,786,560.40",984584
,20171024,4040,4032,4030,4112,4000,4078,4067,46,35,893518,"3,634,633.92",969866
,20171025,4078,4067,4088,4148,4013,4053,4077,-14,10,1011078,"4,122,392.90",976398
,20171026,4053,4077,4033,4046,3932,3946,3975,-131,-102,1164240,"4,628,222.24",994990
,20171027,3946,3975,3940,3955,3818,3834,3889,-141,-86,1199236,"4,664,442.64",1029576
,20171030,3834,3889,3837,3883,3810,3836,3846,-53,-43,800414,"3,078,947.68",945904
,20171031,3836,3846,3836,3939,3824,3886,3880,40,34,1044248,"4,052,530.83",951188
,20171101,3886,3880,3884,3895,3783,3785,3847,-95,-33,1281774,"4,932,016.57",931502
,20171102,3785,3847,3791,3882,3759,3831,3815,-16,-32,1236066,"4,715,787.39",922878
,20171103,3831,3815,3830,3900,3809,3823,3850,8,35,853608,"3,287,124.25",851342
,20171106,3823,3850,3830,3980,3824,3970,3916,120,66,862176,"3,376,899.01",832524
,20171107,3970,3916,3975,3993,3906,3924,3945,8,29,581644,"2,295,165.77",754966
,20171108,3924,3945,3920,3954,3872,3930,3906,-15,-39,649870,"2,538,858.41",758966
,20171109,3930,3906,3938,4012,3908,3942,3958,36,52,774356,"3,065,377.60",774804
,20171110,3942,3958,3945,4025,3918,4011,3977,53,19,739504,"2,941,092.63",771446
,20171113,4011,3977,4014,4083,3991,4059,4038,82,61,688700,"2,781,246.23",795544
,20171114,4059,4038,4055,4103,4030,4079,4068,41,30,454698,"1,849,814.93",760478
,20171115,4079,4068,4079,4110,3985,4036,4043,-32,-25,575982,"2,329,224.94",717370
,20171116,4036,4043,4047,4058,4004,4019,4033,-24,-10,419416,"1,691,655.27",677336
,20171117,4019,4033,4029,4038,3933,3934,3983,-99,-50,557308,"2,219,935.96",666258
,20171120,3934,3983,3930,3994,3926,3990,3960,7,-23,394074,"1,560,829.07",598824
,20171121,3990,3960,3974,4042,3974,4017,4009,57,49,332888,"1,334,852.66",530196
,20171122,4017,4009,4023,4058,3996,4045,4027,36,18,290380,"1,169,619.46",514566
,20171123,4045,4027,4053,4070,3970,3992,4015,-35,-12,340478,"1,367,145.50",462288
,20171124,3992,4015,3996,3996,3941,3985,3963,-30,-52,293200,"1,162,166.79",396244
,20171127,3985,3963,3985,4055,3974,4002,4014,39,51,253060,"1,015,981.58",360150
,20171128,4002,4014,4001,4100,4000,4080,4058,66,44,234408,"951,422.23",338782
,20171129,4080,4058,4080,4118,4049,4104,4087,46,29,164206,"671,168.70",323402
,20171130,4104,4087,4119,4190,4096,4107,4145,20,58,188354,"780,806.46",291790
,20171201,4107,4145,4117,4150,4100,4120,4121,-25,-24,118754,"489,477.28",251092
,20171204,4120,4121,4126,4243,4095,4220,4177,99,56,131028,"547,416.54",251984
,20171205,4220,4177,4210,4257,4191,4211,4223,34,46,103100,"435,422.52",239514
,20171206,4211,4223,4211,4212,4097,4118,4137,-105,-86,102798,"425,326.99",222088
,20171207,4118,4137,4118,4135,3977,4033,4072,-104,-65,111294,"453,259.42",196988
,20171208,4033,4072,4046,4140,4019,4135,4074,63,2,66262,"269,970.78",184318
,20171211,4135,4074,4140,4180,4100,4127,4133,53,59,55356,"228,825.49",179660
,20171212,4127,4133,4131,4180,4100,4108,4134,-25,1,54390,"224,901.72",175320
,20171213,4108,4134,4128,4128,4073,4105,4103,-29,-31,56282,"230,936.67",164232
,20171214,4105,4103,4116,4166,4098,4108,4129,5,26,59566,"245,959.51",158294
,20171215,4108,4129,4111,4150,4096,4133,4123,4,-6,45516,"187,689.17",145182
,20171218,4133,4123,4136,4183,4107,4132,4137,9,14,43630,"180,507.42",138924
,20171219,4132,4137,4132,4139,4083,4085,4104,-52,-33,53228,"218,488.72",119688
,20171220,4085,4104,4085,4115,4081,4111,4101,7,-3,32464,"133,137.79",103650
,20171221,4111,4101,4115,4138,4090,4129,4117,28,16,32972,"135,768.70",91716
,20171222,4129,4117,4129,4178,4127,4168,4157,51,40,24160,"100,441.99",83248
,20171225,4168,4157,4170,4189,4100,4110,4140,-47,-17,33534,"138,853.56",64598
,20171226,4110,4140,4109,4144,4101,4120,4123,-20,-17,24070,"99,241.87",57862
,20171227,4120,4123,4115,4135,4111,4120,4125,-3,2,11066,"45,649.64",50900
,20171228,4120,4125,4125,4151,4104,4146,4124,21,-1,10780,"44,462.96",44426
,20171229,4146,4124,4150,4180,4120,4160,4155,36,31,11490,"47,744.69",35886
hc1802,20170216,3497,3497,,,,3497,3497,0,0,0,0.00,0
,20170217,3497,3497,,,,3497,3497,0,0,0,0.00,0
,20170220,3497,3497,,,,3544,3544,47,47,0,0.00,0
,20170221,3544,3544,,,,3592,3592,48,48,0,0.00,0
,20170222,3592,3592,,,,3521,3521,-71,-71,0,0.00,0
,20170223,3521,3521,,,,3483,3483,-38,-38,0,0.00,0
,20170224,3483,3483,,,,3397,3397,-86,-86,0,0.00,0
,20170227,3397,3397,3462,3462,3462,3462,3462,65,65,2,6.92,2
,20170228,3462,3462,,,,3471,3471,9,9,0,0.00,2
,20170301,3471,3471,3433,3433,3333,3333,3399,-138,-72,6,20.40,0
,20170302,3333,3399,3333,3444,3333,3444,3388,45,-11,4,13.55,0
,20170303,3444,3388,,,,3388,3388,0,0,0,0.00,0
,20170306,3388,3388,,,,3369,3369,-19,-19,0,0.00,0
,20170307,3369,3369,,,,3346,3346,-23,-23,0,0.00,0
,20170308,3346,3346,,,,3346,3346,0,0,0,0.00,0
,20170309,3346,3346,,,,3346,3346,0,0,0,0.00,0
,20170310,3346,3346,,,,3360,3360,14,14,0,0.00,0
,20170313,3360,3360,,,,3360,3360,0,0,0,0.00,0
,20170314,3360,3360,,,,3412,3412,52,52,0,0.00,0
,20170315,3412,3412,,,,3494,3494,82,82,0,0.00,0
,20170316,3494,3494,,,,3502,3502,8,8,0,0.00,0
,20170317,3502,3502,,,,3502,3502,0,0,0,0.00,0
,20170320,3502,3502,,,,3495,3495,-7,-7,0,0.00,0
,20170321,3495,3495,,,,3400,3400,-95,-95,0,0.00,0
,20170322,3400,3400,3162,3162,3162,3162,3162,-238,-238,10,31.62,10
,20170323,3162,3162,3148,3148,3148,3148,3148,-14,-14,2,6.30,10
,20170324,3148,3148,,,,3148,3148,0,0,0,0.00,10
,20170327,3148,3148,3028,3028,3028,3028,3028,-120,-120,2,6.06,8
,20170328,3028,3028,,,,3042,3042,14,14,0,0.00,8
,20170329,3042,3042,3096,3098,3060,3080,3077,38,35,32,98.48,18
,20170330,3080,3077,3095,3095,3095,3095,3095,18,18,2,6.19,18
,20170331,3095,3095,,,,3100,3100,5,5,0,0.00,18
,20170405,3100,3100,,,,3117,3117,17,17,0,0.00,18
,20170406,3117,3117,,,,3074,3074,-43,-43,0,0.00,18
,20170407,3074,3074,,,,3001,3001,-73,-73,0,0.00,18
,20170410,3001,3001,3055,3056,3045,3045,3054,44,53,14,42.76,6
,20170411,3045,3054,,,,3022,3022,-32,-32,0,0.00,6
,20170412,3022,3022,,,,2945,2945,-77,-77,0,0.00,6
,20170413,2945,2945,,,,2953,2953,8,8,0,0.00,6
,20170414,2953,2953,,,,2998,2998,45,45,0,0.00,6
,20170417,2998,2998,,,,2958,2958,-40,-40,0,0.00,6
,20170418,2958,2958,,,,2884,2884,-74,-74,0,0.00,6
,20170419,2884,2884,,,,2874,2874,-10,-10,0,0.00,6
,20170420,2874,2874,,,,2874,2874,0,0,0,0.00,6
,20170421,2874,2874,,,,2942,2942,68,68,0,0.00,6
,20170424,2942,2942,,,,2921,2921,-21,-21,0,0.00,6
,20170425,2921,2921,,,,2921,2921,0,0,0,0.00,6
,20170426,2921,2921,,,,2984,2984,63,63,0,0.00,6
,20170427,2984,2984,,,,2984,2984,0,0,0,0.00,6
,20170428,2984,2984,,,,2984,2984,0,0,0,0.00,6
,20170502,2984,2984,,,,3031,3031,47,47,0,0.00,6
,20170503,3031,3031,,,,3004,3004,-27,-27,0,0.00,6
,20170504,3004,3004,,,,2911,2911,-93,-93,0,0.00,6
,20170505,2911,2911,,,,2900,2900,-11,-11,0,0.00,6
,20170508,2900,2900,,,,2934,2934,34,34,0,0.00,6
,20170509,2934,2934,2930,2930,2930,2930,2930,-4,-4,2,5.86,6
,20170510,2930,2930,,,,2950,2950,20,20,0,0.00,6
,20170511,2950,2950,,,,2940,2940,-10,-10,0,0.00,6
,20170512,2940,2940,,,,2933,2933,-7,-7,0,0.00,6
,20170515,2933,2933,,,,2941,2941,8,8,0,0.00,6
,20170516,2941,2941,,,,2945,2945,4,4,0,0.00,6
,20170517,2945,2945,,,,2945,2945,0,0,0,0.00,6
,20170518,2945,2945,,,,2945,2945,0,0,0,0.00,6
,20170519,2945,2945,,,,2945,2945,0,0,0,0.00,6
,20170522,2945,2945,3032,3121,3032,3097,3093,152,148,244,754.73,46
,20170523,3097,3093,3109,3109,3109,3109,3109,16,16,40,124.36,40
,20170524,3109,3109,,,,3109,3109,0,0,0,0.00,40
,20170525,3109,3109,,,,3109,3109,0,0,0,0.00,40
,20170526,3109,3109,,,,3109,3109,0,0,0,0.00,40
,20170531,3109,3109,,,,3094,3094,-15,-15,0,0.00,40
,20170601,3094,3094,,,,3094,3094,0,0,0,0.00,40
,20170602,3094,3094,2943,2943,2943,2943,2943,-151,-151,20,58.86,40
,20170605,2943,2943,,,,2943,2943,0,0,0,0.00,40
,20170606,2943,2943,,,,2912,2912,-31,-31,0,0.00,40
,20170607,2912,2912,,,,2912,2912,0,0,0,0.00,40
,20170608,2912,2912,,,,2912,2912,0,0,0,0.00,40
,20170609,2912,2912,,,,2961,2961,49,49,0,0.00,40
,20170612,2961,2961,2959,2959,2959,2959,2959,-2,-2,36,106.52,40
,20170613,2959,2959,,,,2959,2959,0,0,0,0.00,40
,20170614,2959,2959,2916,2986,2899,2986,2916,27,-43,42,122.51,12
,20170615,2986,2916,2950,3052,2900,3052,2980,136,64,10,29.80,14
,20170616,3052,2980,3001,3027,3001,3027,3009,47,29,16,48.14,14
,20170619,3027,3009,2993,2993,2993,2993,2993,-16,-16,4,11.97,14
,20170620,2993,2993,,,,2993,2993,0,0,0,0.00,14
,20170621,2993,2993,,,,2959,2959,-34,-34,0,0.00,14
,20170622,2959,2959,,,,2961,2961,2,2,0,0.00,14
,20170623,2961,2961,,,,2989,2989,28,28,0,0.00,14
,20170626,2989,2989,,,,3027,3027,38,38,0,0.00,14
,20170627,3027,3027,,,,3095,3095,68,68,0,0.00,14
,20170628,3095,3095,,,,3166,3166,71,71,0,0.00,14
,20170629,3166,3166,,,,3192,3192,26,26,0,0.00,14
,20170630,3192,3192,,,,3192,3192,0,0,0,0.00,14
,20170703,3192,3192,,,,3236,3236,44,44,0,0.00,14
,20170704,3236,3236,,,,3243,3243,7,7,0,0.00,14
,20170705,3243,3243,,,,3243,3243,0,0,0,0.00,14
,20170706,3243,3243,3153,3153,3153,3153,3153,-90,-90,2,6.31,14
,20170707,3153,3153,,,,3184,3184,31,31,0,0.00,14
,20170710,3184,3184,,,,3248,3248,64,64,0,0.00,14
,20170711,3248,3248,3305,3326,3305,3326,3315,78,67,40,132.62,14
,20170712,3326,3315,,,,3377,3377,62,62,0,0.00,14
,20170713,3377,3377,,,,3421,3421,44,44,0,0.00,14
,20170714,3421,3421,,,,3421,3421,0,0,0,0.00,14
,20170717,3421,3421,,,,3476,3476,55,55,0,0.00,14
,20170718,3476,3476,3525,3525,3525,3525,3525,49,49,2,7.05,14
,20170719,3525,3525,3461,3461,3461,3461,3461,-64,-64,2,6.92,14
,20170720,3461,3461,,,,3416,3416,-45,-45,0,0.00,14
,20170721,3416,3416,,,,3354,3354,-62,-62,0,0.00,14
,20170724,3354,3354,,,,3341,3341,-13,-13,0,0.00,14
,20170725,3341,3341,,,,3388,3388,47,47,0,0.00,14
,20170726,3388,3388,,,,3453,3453,65,65,0,0.00,14
,20170727,3453,3453,3508,3508,3478,3478,3493,25,40,4,13.97,12
,20170728,3478,3493,,,,3493,3493,0,0,0,0.00,12
,20170731,3493,3493,,,,3575,3575,82,82,0,0.00,12
,20170801,3575,3575,,,,3607,3607,32,32,0,0.00,12
,20170802,3607,3607,,,,3607,3607,0,0,0,0.00,12
,20170803,3607,3607,3684,3690,3684,3690,3685,83,78,22,81.08,22
,20170804,3690,3685,,,,3756,3756,71,71,0,0.00,22
,20170807,3756,3756,,,,3895,3895,139,139,0,0.00,22
,20170808,3895,3895,4074,4074,3900,3900,4011,5,116,42,168.50,22
,20170809,3900,4011,3935,4069,3904,4069,3941,58,-70,36,141.89,18
,20170810,4069,3941,,,,4005,4005,64,64,0,0.00,18
,20170811,4005,4005,,,,4005,4005,0,0,0,0.00,18
,20170814,4005,4005,,,,3930,3930,-75,-75,0,0.00,18
,20170815,3930,3930,,,,3863,3863,-67,-67,0,0.00,18
,20170816,3863,3863,,,,3863,3863,0,0,0,0.00,18
,20170817,3863,3863,,,,3863,3863,0,0,0,0.00,18
,20170818,3863,3863,3866,3969,3866,3969,3917,106,54,4,15.67,18
,20170821,3969,3917,4071,4071,4054,4054,4062,137,145,8,32.50,18
,20170822,4054,4062,,,,4062,4062,0,0,0,0.00,18
,20170823,4062,4062,3867,3933,3832,3832,3896,-230,-166,70,272.74,22
,20170824,3832,3896,,,,3938,3938,42,42,0,0.00,22
,20170825,3938,3938,4068,4068,4068,4068,4068,130,130,30,122.04,48
,20170828,4068,4068,3946,3946,3946,3946,3946,-122,-122,30,118.38,18
,20170829,3946,3946,,,,3946,3946,0,0,0,0.00,18
,20170830,3946,3946,,,,3922,3922,-24,-24,0,0.00,18
,20170831,3922,3922,,,,3922,3922,0,0,0,0.00,18
,20170901,3922,3922,,,,4157,4157,235,235,0,0.00,18
,20170904,4157,4157,4152,4266,4152,4266,4219,109,62,16,67.50,22
,20170905,4266,4219,,,,4219,4219,0,0,0,0.00,22
,20170906,4219,4219,,,,4219,4219,0,0,0,0.00,22
,20170907,4219,4219,4166,4166,4166,4166,4166,-53,-53,2,8.33,20
,20170908,4166,4166,4225,4247,4141,4142,4183,-24,17,14,58.57,20
,20170911,4142,4183,4119,4157,4119,4157,4138,-26,-45,4,16.55,20
,20170912,4157,4138,4102,4102,4102,4102,4102,-36,-36,4,16.41,22
,20170913,4102,4102,,,,4102,4102,0,0,0,0.00,22
,20170914,4102,4102,4046,4201,4046,4097,4092,-5,-10,16,65.47,16
,20170915,4097,4092,4058,4058,4058,4058,4058,-34,-34,4,16.23,18
,20170918,4058,4058,,,,4058,4058,0,0,0,0.00,18
,20170919,4058,4058,4020,4020,4020,4020,4020,-38,-38,16,64.32,16
,20170920,4020,4020,,,,3958,3958,-62,-62,0,0.00,16
,20170921,3958,3958,,,,3958,3958,0,0,0,0.00,16
,20170922,3958,3958,3790,3798,3732,3783,3767,-175,-191,10,37.68,20
,20170925,3783,3767,3742,3802,3742,3802,3762,35,-5,6,22.57,18
,20170926,3802,3762,3827,3827,3789,3789,3808,27,46,40,152.32,14
,20170927,3789,3808,,,,3829,3829,21,21,0,0.00,14
,20170928,3829,3829,3830,3930,3789,3789,3861,-40,32,10,38.62,20
,20170929,3789,3861,3745,3869,3745,3869,3823,8,-38,8,30.59,16
,20171009,3869,3823,3869,4038,3869,3926,3973,103,150,40,158.95,16
,20171010,3926,3973,,,,3874,3874,-99,-99,0,0.00,16
,20171011,3874,3874,,,,3874,3874,0,0,0,0.00,16
,20171012,3874,3874,3860,3874,3860,3874,3867,0,-7,4,15.47,16
,20171013,3874,3867,,,,4013,4013,146,146,0,0.00,16
,20171016,4013,4013,3781,4168,3781,4067,4015,54,2,22,88.35,16
,20171017,4067,4015,4139,4139,3939,3946,4012,-69,-3,42,168.52,30
,20171018,3946,4012,3886,4097,3886,4097,3995,85,-17,20,79.90,24
,20171019,4097,3995,,,,3995,3995,0,0,0,0.00,24
,20171020,3995,3995,,,,3995,3995,0,0,0,0.00,24
,20171023,3995,3995,,,,3995,3995,0,0,0,0.00,24
,20171024,3995,3995,,,,3995,3995,0,0,0,0.00,24
,20171025,3995,3995,3968,3968,3968,3968,3968,-27,-27,2,7.94,22
,20171026,3968,3968,,,,3968,3968,0,0,0,0.00,22
,20171027,3968,3968,3984,3984,3802,3885,3819,-83,-149,66,252.11,22
,20171030,3885,3819,3921,3921,3825,3825,3873,6,54,80,309.86,24
,20171031,3825,3873,,,,3873,3873,0,0,0,0.00,24
,20171101,3873,3873,3773,3773,3773,3773,3773,-100,-100,2,7.55,24
,20171102,3773,3773,3721,3870,3721,3870,3780,97,7,18,68.05,26
,20171103,3870,3780,3788,3919,3774,3898,3841,118,61,38,145.99,20
,20171106,3898,3841,3902,3902,3902,3902,3902,61,61,2,7.80,22
,20171107,3902,3902,,,,3902,3902,0,0,0,0.00,22
,20171108,3902,3902,3912,3912,3912,3912,3912,10,10,2,7.82,20
,20171109,3912,3912,,,,3912,3912,0,0,0,0.00,20
,20171110,3912,3912,3879,3879,3812,3812,3845,-100,-67,4,15.38,20
,20171113,3812,3845,,,,3845,3845,0,0,0,0.00,20
,20171114,3845,3845,4061,4061,3972,3972,3998,127,153,14,55.97,20
,20171115,3972,3998,3951,4015,3898,3898,3960,-100,-38,18,71.30,24
,20171116,3898,3960,3922,3978,3921,3921,3932,-39,-28,10,39.33,26
,20171117,3921,3932,3861,3861,3812,3813,3817,-119,-115,46,175.58,68
,20171120,3813,3817,3774,3865,3774,3805,3812,-12,-5,50,190.62,70
,20171121,3805,3812,3883,3896,3841,3890,3872,78,60,14,54.22,66
,20171122,3890,3872,3942,3942,3875,3875,3908,3,36,4,15.63,66
,20171123,3875,3908,3813,3813,3813,3813,3813,-95,-95,2,7.63,66
,20171124,3813,3813,3849,3849,3849,3849,3849,36,36,6,23.09,66
,20171127,3849,3849,3927,3961,3910,3911,3950,62,101,68,268.62,30
,20171128,3911,3950,3864,3911,3864,3867,3883,-83,-67,10,38.84,32
,20171129,3867,3883,3853,4028,3853,3980,3965,97,82,16,63.45,38
,20171130,3980,3965,3953,4120,3953,4007,4045,42,80,40,161.81,46
,20171201,4007,4045,,,,4045,4045,0,0,0,0.00,46
,20171204,4045,4045,4167,4167,4120,4120,4146,75,101,8,33.17,46
,20171205,4120,4146,4116,4179,4116,4121,4133,-25,-13,8,33.06,48
,20171206,4121,4133,4043,4367,3976,4150,4158,17,25,118,490.65,54
,20171207,4150,4158,4071,4090,3941,3941,4028,-217,-130,18,72.51,44
,20171208,3941,4028,3964,4087,3964,4087,4025,59,-3,4,16.10,46
,20171211,4087,4025,4055,4060,4055,4060,4057,35,32,8,32.46,40
,20171212,4060,4057,,,,4050,4050,-7,-7,0,0.00,40
,20171213,4050,4050,4002,4002,4002,4002,4002,-48,-48,2,8.00,40
,20171214,4002,4002,4033,4033,4033,4033,4033,31,31,2,8.07,40
,20171215,4033,4033,3963,3963,3963,3963,3963,-70,-70,2,7.93,40
,20171218,3963,3963,,,,3963,3963,0,0,0,0.00,40
,20171219,3963,3963,,,,3963,3963,0,0,0,0.00,40
,20171220,3963,3963,,,,3963,3963,0,0,0,0.00,40
,20171221,3963,3963,3933,3933,3913,3913,3923,-50,-40,4,15.69,40
,20171222,3913,3923,,,,3923,3923,0,0,0,0.00,40
,20171225,3923,3923,3723,3723,3723,3723,3723,-200,-200,2,7.45,40
,20171226,3723,3723,,,,3707,3707,-16,-16,0,0.00,40
,20171227,3707,3707,3900,3900,3853,3853,3890,146,183,10,38.91,44
,20171228,3853,3890,3832,4039,3832,4039,3995,149,105,94,375.54,86
,20171229,4039,3995,,,,4000,4000,5,5,0,0.00,86
hc1803,20170316,3494,3494,,,,3494,3494,0,0,0,0.00,0
,20170317,3494,3494,,,,3494,3494,0,0,0,0.00,0
,20170320,3494,3494,,,,3487,3487,-7,-7,0,0.00,0
,20170321,3487,3487,,,,3392,3392,-95,-95,0,0.00,0
,20170322,3392,3392,3150,3150,3150,3150,3150,-242,-242,2,6.30,2
,20170323,3150,3150,,,,3150,3150,0,0,0,0.00,2
,20170324,3150,3150,,,,3136,3136,-14,-14,0,0.00,2
,20170327,3136,3136,3029,3029,3029,3029,3029,-107,-107,2,6.06,2
,20170328,3029,3029,,,,3029,3029,0,0,0,0.00,2
,20170329,3029,3029,,,,3029,3029,0,0,0,0.00,2
,20170330,3029,3029,,,,3029,3029,0,0,0,0.00,2
,20170331,3029,3029,,,,3033,3033,4,4,0,0.00,2
,20170405,3033,3033,,,,3050,3050,17,17,0,0.00,2
,20170406,3050,3050,,,,3050,3050,0,0,0,0.00,2
,20170407,3050,3050,,,,3050,3050,0,0,0,0.00,2
,20170410,3050,3050,,,,3104,3104,54,54,0,0.00,2
,20170411,3104,3104,,,,3071,3071,-33,-33,0,0.00,2
,20170412,3071,3071,,,,2992,2992,-79,-79,0,0.00,2
,20170413,2992,2992,,,,2992,2992,0,0,0,0.00,2
,20170414,2992,2992,,,,3038,3038,46,46,0,0.00,2
,20170417,3038,3038,2950,2950,2950,2950,2950,-88,-88,2,5.90,4
,20170418,2950,2950,,,,2877,2877,-73,-73,0,0.00,4
,20170419,2877,2877,,,,2867,2867,-10,-10,0,0.00,4
,20170420,2867,2867,,,,2866,2866,-1,-1,0,0.00,4
,20170421,2866,2866,,,,2934,2934,68,68,0,0.00,4
,20170424,2934,2934,,,,2913,2913,-21,-21,0,0.00,4
,20170425,2913,2913,,,,2913,2913,0,0,0,0.00,4
,20170426,2913,2913,,,,2913,2913,0,0,0,0.00,4
,20170427,2913,2913,,,,2913,2913,0,0,0,0.00,4
,20170428,2913,2913,,,,2913,2913,0,0,0,0.00,4
,20170502,2913,2913,3070,3089,3070,3089,3079,176,166,4,12.32,2
,20170503,3089,3079,,,,3079,3079,0,0,0,0.00,2
,20170504,3079,3079,,,,2965,2965,-114,-114,0,0.00,2
,20170505,2965,2965,2880,2880,2860,2860,2866,-105,-99,6,17.20,8
,20170508,2860,2866,,,,2866,2866,0,0,0,0.00,8
,20170509,2866,2866,,,,2866,2866,0,0,0,0.00,8
,20170510,2866,2866,,,,2866,2866,0,0,0,0.00,8
,20170511,2866,2866,,,,2866,2866,0,0,0,0.00,8
,20170512,2866,2866,2823,2838,2823,2838,2830,-28,-36,4,11.32,8
,20170515,2838,2830,,,,2844,2844,14,14,0,0.00,8
,20170516,2844,2844,,,,2844,2844,0,0,0,0.00,8
,20170517,2844,2844,3043,3043,2970,2970,3006,126,162,4,12.03,8
,20170518,2970,3006,3014,3014,3014,3014,3014,8,8,2,6.03,8
,20170519,3014,3014,,,,3014,3014,0,0,0,0.00,8
,20170522,3014,3014,3186,3186,3075,3096,3135,82,121,136,426.46,6
,20170523,3096,3135,,,,3151,3151,16,16,0,0.00,6
,20170524,3151,3151,,,,3113,3113,-38,-38,0,0.00,6
,20170525,3113,3113,,,,3113,3113,0,0,0,0.00,6
,20170526,3113,3113,,,,3113,3113,0,0,0,0.00,6
,20170531,3113,3113,,,,3119,3119,6,6,0,0.00,6
,20170601,3119,3119,2931,2931,2931,2931,2931,-188,-188,4,11.72,10
,20170602,2931,2931,,,,2931,2931,0,0,0,0.00,10
,20170605,2931,2931,,,,2879,2879,-52,-52,0,0.00,10
,20170606,2879,2879,,,,2879,2879,0,0,0,0.00,10
,20170607,2879,2879,,,,2879,2879,0,0,0,0.00,10
,20170608,2879,2879,,,,2895,2895,16,16,0,0.00,10
,20170609,2895,2895,2950,2950,2950,2950,2950,55,55,2,5.90,8
,20170612,2950,2950,,,,2948,2948,-2,-2,0,0.00,8
,20170613,2948,2948,2929,2929,2929,2929,2929,-19,-19,2,5.86,6
,20170614,2929,2929,,,,2887,2887,-42,-42,0,0.00,6
,20170615,2887,2887,2990,3016,2989,3016,3000,129,113,10,30.00,10
,20170616,3016,3000,,,,3029,3029,29,29,0,0.00,10
,20170619,3029,3029,,,,3012,3012,-17,-17,0,0.00,10
,20170620,3012,3012,,,,3012,3012,0,0,0,0.00,10
,20170621,3012,3012,3008,3008,3008,3008,3008,-4,-4,2,6.02,10
,20170622,3008,3008,,,,3008,3008,0,0,0,0.00,10
,20170623,3008,3008,,,,3008,3008,0,0,0,0.00,10
,20170626,3008,3008,,,,3046,3046,38,38,0,0.00,10
,20170627,3046,3046,,,,3093,3093,47,47,0,0.00,10
,20170628,3093,3093,,,,3164,3164,71,71,0,0.00,10
,20170629,3164,3164,,,,3190,3190,26,26,0,0.00,10
,20170630,3190,3190,,,,3190,3190,0,0,0,0.00,10
,20170703,3190,3190,,,,3234,3234,44,44,0,0.00,10
,20170704,3234,3234,3284,3284,3254,3254,3269,20,35,4,13.08,10
,20170705,3254,3269,,,,3276,3276,7,7,0,0.00,10
,20170706,3276,3276,,,,3185,3185,-91,-91,0,0.00,10
,20170707,3185,3185,3201,3201,3201,3201,3201,16,16,2,6.40,10
,20170710,3201,3201,,,,3266,3266,65,65,0,0.00,10
,20170711,3266,3266,3278,3278,3278,3278,3278,12,12,2,6.56,10
,20170712,3278,3278,,,,3339,3339,61,61,0,0.00,10
,20170713,3339,3339,3424,3424,3424,3424,3424,85,85,2,6.85,10
,20170714,3424,3424,,,,3399,3399,-25,-25,0,0.00,10
,20170717,3399,3399,,,,3454,3454,55,55,0,0.00,10
,20170718,3454,3454,,,,3502,3502,48,48,0,0.00,10
,20170719,3502,3502,,,,3502,3502,0,0,0,0.00,10
,20170720,3502,3502,,,,3457,3457,-45,-45,0,0.00,10
,20170721,3457,3457,,,,3395,3395,-62,-62,0,0.00,10
,20170724,3395,3395,,,,3395,3395,0,0,0,0.00,10
,20170725,3395,3395,,,,3395,3395,0,0,0,0.00,10
,20170726,3395,3395,,,,3395,3395,0,0,0,0.00,10
,20170727,3395,3395,,,,3408,3408,13,13,0,0.00,10
,20170728,3408,3408,,,,3446,3446,38,38,0,0.00,10
,20170731,3446,3446,,,,3527,3527,81,81,0,0.00,10
,20170801,3527,3527,,,,3527,3527,0,0,0,0.00,10
,20170802,3527,3527,,,,3551,3551,24,24,0,0.00,10
,20170803,3551,3551,3653,3659,3653,3659,3658,108,107,18,65.85,16
,20170804,3659,3658,,,,3729,3729,71,71,0,0.00,16
,20170807,3729,3729,3952,3952,3952,3952,3952,223,223,2,7.90,18
,20170808,3952,3952,3980,3980,3899,3899,3969,-53,17,16,63.52,4
,20170809,3899,3969,,,,3969,3969,0,0,0,0.00,4
,20170810,3969,3969,,,,4033,4033,64,64,0,0.00,4
,20170811,4033,4033,4063,4063,3956,3956,4009,-77,-24,4,16.04,4
,20170814,3956,4009,,,,4009,4009,0,0,0,0.00,4
,20170815,4009,4009,3770,3770,3770,3770,3770,-239,-239,2,7.54,4
,20170816,3770,3770,,,,3770,3770,0,0,0,0.00,4
,20170817,3770,3770,,,,3856,3856,86,86,0,0.00,4
,20170818,3856,3856,,,,3910,3910,54,54,0,0.00,4
,20170821,3910,3910,,,,3930,3930,20,20,0,0.00,4
,20170822,3930,3930,,,,3930,3930,0,0,0,0.00,4
,20170823,3930,3930,3790,3820,3790,3820,3805,-110,-125,4,15.22,4
,20170824,3820,3805,3847,3847,3847,3847,3847,42,42,2,7.69,6
,20170825,3847,3847,,,,3973,3973,126,126,0,0.00,6
,20170828,3973,3973,,,,3973,3973,0,0,0,0.00,6
,20170829,3973,3973,3954,4013,3950,3981,3984,8,11,110,438.30,4
,20170830,3981,3984,,,,3984,3984,0,0,0,0.00,4
,20170831,3984,3984,,,,3956,3956,-28,-28,0,0.00,4
,20170901,3956,3956,,,,4092,4092,136,136,0,0.00,4
,20170904,4092,4092,,,,4153,4153,61,61,0,0.00,4
,20170905,4153,4153,,,,4153,4153,0,0,0,0.00,4
,20170906,4153,4153,,,,4153,4153,0,0,0,0.00,4
,20170907,4153,4153,,,,4153,4153,0,0,0,0.00,4
,20170908,4153,4153,,,,4153,4153,0,0,0,0.00,4
,20170911,4153,4153,,,,4153,4153,0,0,0,0.00,4
,20170912,4153,4153,,,,4116,4116,-37,-37,0,0.00,4
,20170913,4116,4116,,,,4132,4132,16,16,0,0.00,4
,20170914,4132,4132,,,,4121,4121,-11,-11,0,0.00,4
,20170915,4121,4121,,,,4070,4070,-51,-51,0,0.00,4
,20170918,4070,4070,4043,4043,3917,3917,3949,-153,-121,8,31.59,6
,20170919,3917,3949,,,,3949,3949,0,0,0,0.00,6
,20170920,3949,3949,,,,3949,3949,0,0,0,0.00,6
,20170921,3949,3949,3905,3905,3853,3853,3879,-96,-70,4,15.52,4
,20170922,3853,3879,3888,3888,3720,3785,3785,-94,-94,42,158.97,38
,20170925,3785,3785,,,,3785,3785,0,0,0,0.00,38
,20170926,3785,3785,,,,3785,3785,0,0,0,0.00,38
,20170927,3785,3785,,,,3834,3834,49,49,0,0.00,38
,20170928,3834,3834,3950,3950,3950,3950,3950,116,116,2,7.90,36
,20170929,3950,3950,,,,3911,3911,-39,-39,0,0.00,36
,20171009,3911,3911,,,,3911,3911,0,0,0,0.00,36
,20171010,3911,3911,,,,3785,3785,-126,-126,0,0.00,36
,20171011,3785,3785,,,,3738,3738,-47,-47,0,0.00,36
,20171012,3738,3738,,,,3731,3731,-7,-7,0,0.00,36
,20171013,3731,3731,3925,3925,3925,3925,3925,194,194,2,7.85,38
,20171016,3925,3925,4028,4028,4028,4028,4028,103,103,36,145.01,38
,20171017,4028,4028,,,,4025,4025,-3,-3,0,0.00,38
,20171018,4025,4025,,,,4007,4007,-18,-18,0,0.00,38
,20171019,4007,4007,,,,3900,3900,-107,-107,0,0.00,38
,20171020,3900,3900,,,,3936,3936,36,36,0,0.00,38
,20171023,3936,3936,,,,3936,3936,0,0,0,0.00,38
,20171024,3936,3936,,,,3936,3936,0,0,0,0.00,38
,20171025,3936,3936,,,,3936,3936,0,0,0,0.00,38
,20171026,3936,3936,,,,3837,3837,-99,-99,0,0.00,38
,20171027,3837,3837,,,,3693,3693,-144,-144,0,0.00,38
,20171030,3693,3693,,,,3745,3745,52,52,0,0.00,38
,20171031,3745,3745,3746,3868,3746,3860,3807,115,62,8,30.46,40
,20171101,3860,3807,3830,3830,3830,3830,3830,23,23,2,7.66,40
,20171102,3830,3830,,,,3830,3830,0,0,0,0.00,40
,20171103,3830,3830,3840,3840,3840,3840,3840,10,10,2,7.68,40
,20171106,3840,3840,3983,3983,3983,3983,3983,143,143,2,7.97,40
,20171107,3983,3983,,,,4013,4013,30,30,0,0.00,40
,20171108,4013,4013,,,,4023,4023,10,10,0,0.00,40
,20171109,4023,4023,,,,4077,4077,54,54,0,0.00,40
,20171110,4077,4077,,,,4007,4007,-70,-70,0,0.00,40
,20171113,4007,4007,,,,4007,4007,0,0,0,0.00,40
,20171114,4007,4007,,,,4007,4007,0,0,0,0.00,40
,20171115,4007,4007,3921,3921,3888,3888,3904,-119,-103,4,15.62,44
,20171116,3888,3904,3900,3900,3900,3900,3900,-4,-4,4,15.60,48
,20171117,3900,3900,,,,3850,3850,-50,-50,0,0.00,48
,20171120,3850,3850,,,,3850,3850,0,0,0,0.00,48
,20171121,3850,3850,,,,3911,3911,61,61,0,0.00,48
,20171122,3911,3911,,,,3947,3947,36,36,0,0.00,48
,20171123,3947,3947,,,,3947,3947,0,0,0,0.00,48
,20171124,3947,3947,,,,3947,3947,0,0,0,0.00,48
,20171127,3947,3947,,,,3947,3947,0,0,0,0.00,48
,20171128,3947,3947,,,,3947,3947,0,0,0,0.00,48
,20171129,3947,3947,,,,4030,4030,83,83,0,0.00,48
,20171130,4030,4030,4065,4065,4065,4065,4065,35,35,2,8.13,48
,20171201,4065,4065,,,,4065,4065,0,0,0,0.00,48
,20171204,4065,4065,4100,4202,4100,4120,4137,55,72,10,41.38,52
,20171205,4120,4137,,,,4137,4137,0,0,0,0.00,52
,20171206,4137,4137,4008,4008,3921,3921,3964,-216,-173,4,15.86,50
,20171207,3921,3964,,,,3840,3840,-124,-124,0,0.00,50
,20171208,3840,3840,3959,4049,3907,4009,3965,169,125,16,63.45,54
,20171211,4009,3965,4019,4054,3981,3981,4006,16,41,12,48.08,50
,20171212,3981,4006,4067,4067,3982,3982,4038,-24,32,6,24.23,52
,20171213,3982,4038,3960,3964,3960,3964,3961,-74,-77,18,71.31,64
,20171214,3964,3961,,,,3961,3961,0,0,0,0.00,64
,20171215,3961,3961,4054,4054,4054,4054,4054,93,93,2,8.11,64
,20171218,4054,4054,,,,4054,4054,0,0,0,0.00,64
,20171219,4054,4054,3970,3970,3970,3970,3970,-84,-84,46,182.62,74
,20171220,3970,3970,,,,3970,3970,0,0,0,0.00,74
,20171221,3970,3970,,,,3970,3970,0,0,0,0.00,74
,20171222,3970,3970,4050,4080,4049,4080,4054,110,84,40,162.19,94
,20171225,4080,4054,4023,4147,4023,4050,4071,-4,17,82,333.89,96
,20171226,4050,4071,4045,4045,4045,4045,4045,-26,-26,2,8.09,96
,20171227,4045,4045,3996,3996,3996,3996,3996,-49,-49,2,7.99,96
,20171228,3996,3996,3995,3996,3995,3996,3995,0,-1,4,15.98,98
,20171229,3996,3995,3994,3994,3982,3982,3986,-13,-9,6,23.92,98
hc1804,20170418,2950,2950,,,,2950,2950,0,0,0,0.00,0
,20170419,2950,2950,,,,2950,2950,0,0,0,0.00,0
,20170420,2950,2950,,,,2950,2950,0,0,0,0.00,0
,20170421,2950,2950,,,,2950,2950,0,0,0,0.00,0
,20170424,2950,2950,,,,2950,2950,0,0,0,0.00,0
,20170425,2950,2950,,,,2950,2950,0,0,0,0.00,0
,20170426,2950,2950,,,,2950,2950,0,0,0,0.00,0
,20170427,2950,2950,,,,2950,2950,0,0,0,0.00,0
,20170428,2950,2950,,,,2950,2950,0,0,0,0.00,0
,20170502,2950,2950,,,,2950,2950,0,0,0,0.00,0
,20170503,2950,2950,,,,2950,2950,0,0,0,0.00,0
,20170504,2950,2950,,,,2950,2950,0,0,0,0.00,0
,20170505,2950,2950,,,,2950,2950,0,0,0,0.00,0
,20170508,2950,2950,,,,2950,2950,0,0,0,0.00,0
,20170509,2950,2950,,,,2950,2950,0,0,0,0.00,0
,20170510,2950,2950,,,,2950,2950,0,0,0,0.00,0
,20170511,2950,2950,,,,2950,2950,0,0,0,0.00,0
,20170512,2950,2950,2808,2808,2808,2808,2808,-142,-142,2,5.62,2
,20170515,2808,2808,,,,2815,2815,7,7,0,0.00,2
,20170516,2815,2815,,,,2819,2819,4,4,0,0.00,2
,20170517,2819,2819,,,,2980,2980,161,161,0,0.00,2
,20170518,2980,2980,,,,2980,2980,0,0,0,0.00,2
,20170519,2980,2980,,,,3025,3025,45,45,0,0.00,2
,20170522,3025,3025,,,,3147,3147,122,122,0,0.00,2
,20170523,3147,3147,3114,3114,3114,3114,3114,-33,-33,2,6.23,0
,20170524,3114,3114,,,,3076,3076,-38,-38,0,0.00,0
,20170525,3076,3076,,,,3076,3076,0,0,0,0.00,0
,20170526,3076,3076,,,,3076,3076,0,0,0,0.00,0
,20170531,3076,3076,,,,3082,3082,6,6,0,0.00,0
,20170601,3082,3082,,,,3082,3082,0,0,0,0.00,0
,20170602,3082,3082,,,,2931,2931,-151,-151,0,0.00,0
,20170605,2931,2931,,,,2879,2879,-52,-52,0,0.00,0
,20170606,2879,2879,,,,2879,2879,0,0,0,0.00,0
,20170607,2879,2879,,,,2879,2879,0,0,0,0.00,0
,20170608,2879,2879,,,,2895,2895,16,16,0,0.00,0
,20170609,2895,2895,,,,2950,2950,55,55,0,0.00,0
,20170612,2950,2950,2977,2977,2977,2977,2977,27,27,20,59.54,20
,20170613,2977,2977,2966,3020,2927,3020,2962,43,-15,24,71.11,2
,20170614,3020,2962,,,,2919,2919,-43,-43,0,0.00,2
,20170615,2919,2919,,,,3033,3033,114,114,0,0.00,2
,20170616,3033,3033,,,,3033,3033,0,0,0,0.00,2
,20170619,3033,3033,,,,3016,3016,-17,-17,0,0.00,2
,20170620,3016,3016,3120,3120,3120,3120,3120,104,104,16,49.92,18
,20170621,3120,3120,,,,3115,3115,-5,-5,0,0.00,18
,20170622,3115,3115,3156,3156,3156,3156,3156,41,41,16,50.50,34
,20170623,3156,3156,,,,3141,3141,-15,-15,0,0.00,34
,20170626,3141,3141,,,,3141,3141,0,0,0,0.00,34
,20170627,3141,3141,,,,3178,3178,37,37,0,0.00,34
,20170628,3178,3178,,,,3251,3251,73,73,0,0.00,34
,20170629,3251,3251,,,,3278,3278,27,27,0,0.00,34
,20170630,3278,3278,,,,3278,3278,0,0,0,0.00,34
,20170703,3278,3278,,,,3278,3278,0,0,0,0.00,34
,20170704,3278,3278,,,,3313,3313,35,35,0,0.00,34
,20170705,3313,3313,,,,3320,3320,7,7,0,0.00,34
,20170706,3320,3320,,,,3227,3227,-93,-93,0,0.00,34
,20170707,3227,3227,,,,3243,3243,16,16,0,0.00,34
,20170710,3243,3243,,,,3243,3243,0,0,0,0.00,34
,20170711,3243,3243,3339,3339,3339,3339,3339,96,96,2,6.68,34
,20170712,3339,3339,,,,3339,3339,0,0,0,0.00,34
,20170713,3339,3339,3402,3449,3402,3449,3421,110,82,10,34.21,38
,20170714,3449,3421,3421,3421,3421,3421,3421,0,0,2,6.84,38
,20170717,3421,3421,,,,3476,3476,55,55,0,0.00,38
,20170718,3476,3476,,,,3476,3476,0,0,0,0.00,38
,20170719,3476,3476,,,,3476,3476,0,0,0,0.00,38
,20170720,3476,3476,,,,3431,3431,-45,-45,0,0.00,38
,20170721,3431,3431,,,,3369,3369,-62,-62,0,0.00,38
,20170724,3369,3369,,,,3356,3356,-13,-13,0,0.00,38
,20170725,3356,3356,,,,3402,3402,46,46,0,0.00,38
,20170726,3402,3402,,,,3430,3430,28,28,0,0.00,38
,20170727,3430,3430,,,,3469,3469,39,39,0,0.00,38
,20170728,3469,3469,,,,3469,3469,0,0,0,0.00,38
,20170731,3469,3469,,,,3469,3469,0,0,0,0.00,38
,20170801,3469,3469,,,,3469,3469,0,0,0,0.00,38
,20170802,3469,3469,,,,3469,3469,0,0,0,0.00,38
,20170803,3469,3469,3677,3677,3671,3677,3676,208,207,26,95.58,38
,20170804,3677,3676,3702,3808,3702,3808,3745,132,69,16,59.93,36
,20170807,3808,3745,3745,3745,3745,3745,3745,0,0,2,7.49,36
,20170808,3745,3745,3969,3969,3800,3853,3885,108,140,24,93.25,38
,20170809,3853,3885,3919,4019,3839,4019,3962,134,77,10,39.62,38
,20170810,4019,3962,3878,3878,3878,3878,3878,-84,-84,2,7.76,38
,20170811,3878,3878,3660,4028,3660,3887,3900,9,22,8,31.21,38
,20170814,3887,3900,3858,3858,3858,3858,3858,-42,-42,4,15.43,38
,20170815,3858,3858,,,,3819,3819,-39,-39,0,0.00,38
,20170816,3819,3819,,,,3811,3811,-8,-8,0,0.00,38
,20170817,3811,3811,,,,3825,3825,14,14,0,0.00,38
,20170818,3825,3825,,,,3881,3881,56,56,0,0.00,38
,20170821,3881,3881,,,,3930,3930,49,49,0,0.00,38
,20170822,3930,3930,,,,3930,3930,0,0,0,0.00,38
,20170823,3930,3930,,,,3880,3880,-50,-50,0,0.00,38
,20170824,3880,3880,3897,3897,3897,3897,3897,17,17,2,7.79,38
,20170825,3897,3897,,,,4025,4025,128,128,0,0.00,38
,20170828,4025,4025,,,,4025,4025,0,0,0,0.00,38
,20170829,4025,4025,,,,4025,4025,0,0,0,0.00,38
,20170830,4025,4025,3967,3967,3967,3967,3967,-58,-58,2,7.93,40
,20170831,3967,3967,3951,4019,3951,3962,4004,-5,37,26,104.12,58
,20170901,3962,4004,4119,4120,4119,4120,4119,116,115,22,90.62,42
,20170904,4120,4119,4170,4205,4170,4194,4194,75,75,22,92.27,56
,20170905,4194,4194,,,,4194,4194,0,0,0,0.00,56
,20170906,4194,4194,,,,4194,4194,0,0,0,0.00,56
,20170907,4194,4194,,,,4173,4173,-21,-21,0,0.00,56
,20170908,4173,4173,4090,4090,4061,4061,4075,-112,-98,4,16.30,58
,20170911,4061,4075,,,,4075,4075,0,0,0,0.00,58
,20170912,4075,4075,,,,4075,4075,0,0,0,0.00,58
,20170913,4075,4075,,,,4075,4075,0,0,0,0.00,58
,20170914,4075,4075,3946,3973,3946,3973,3949,-102,-126,24,94.78,40
,20170915,3973,3949,3936,3981,3936,3971,3961,22,12,14,55.46,40
,20170918,3971,3961,3891,3935,3891,3935,3916,-26,-45,14,54.83,40
,20170919,3935,3916,,,,3916,3916,0,0,0,0.00,40
,20170920,3916,3916,3859,3861,3858,3858,3860,-58,-56,40,154.42,34
,20170921,3858,3860,3770,3770,3770,3770,3770,-90,-90,2,7.54,34
,20170922,3770,3770,3789,3803,3635,3635,3761,-135,-9,10,37.61,28
,20170925,3635,3761,,,,3761,3761,0,0,0,0.00,28
,20170926,3761,3761,,,,3761,3761,0,0,0,0.00,28
,20170927,3761,3761,,,,3761,3761,0,0,0,0.00,28
,20170928,3761,3761,,,,3761,3761,0,0,0,0.00,28
,20170929,3761,3761,,,,3724,3724,-37,-37,0,0.00,28
,20171009,3724,3724,,,,3802,3802,78,78,0,0.00,28
,20171010,3802,3802,,,,3796,3796,-6,-6,0,0.00,28
,20171011,3796,3796,3661,3661,3661,3661,3661,-135,-135,2,7.32,30
,20171012,3661,3661,,,,3654,3654,-7,-7,0,0.00,30
,20171013,3654,3654,3866,3873,3846,3870,3868,216,214,38,147.02,58
,20171016,3870,3868,,,,3969,3969,101,101,0,0.00,58
,20171017,3969,3969,3967,4015,3913,3913,3983,-56,14,22,87.63,36
,20171018,3913,3983,,,,3983,3983,0,0,0,0.00,36
,20171019,3983,3983,3841,3841,3841,3841,3841,-142,-142,6,23.05,32
,20171020,3841,3841,3830,3960,3830,3960,3895,119,54,4,15.58,30
,20171023,3960,3895,,,,3895,3895,0,0,0,0.00,30
,20171024,3895,3895,3972,3972,3972,3972,3972,77,77,2,7.94,30
,20171025,3972,3972,3992,3992,3992,3992,3992,20,20,2,7.98,28
,20171026,3992,3992,,,,3889,3889,-103,-103,0,0.00,28
,20171027,3889,3889,3766,3766,3766,3766,3766,-123,-123,2,7.53,26
,20171030,3766,3766,,,,3766,3766,0,0,0,0.00,26
,20171031,3766,3766,,,,3829,3829,63,63,0,0.00,26
,20171101,3829,3829,,,,3829,3829,0,0,0,0.00,26
,20171102,3829,3829,,,,3829,3829,0,0,0,0.00,26
,20171103,3829,3829,,,,3829,3829,0,0,0,0.00,26
,20171106,3829,3829,,,,3971,3971,142,142,0,0.00,26
,20171107,3971,3971,,,,4001,4001,30,30,0,0.00,26
,20171108,4001,4001,3897,3897,3897,3897,3897,-104,-104,2,7.79,24
,20171109,3897,3897,,,,3897,3897,0,0,0,0.00,24
,20171110,3897,3897,,,,3897,3897,0,0,0,0.00,24
,20171113,3897,3897,,,,3897,3897,0,0,0,0.00,24
,20171114,3897,3897,3918,3918,3918,3918,3918,21,21,2,7.84,24
,20171115,3918,3918,3823,3823,3823,3823,3823,-95,-95,2,7.65,22
,20171116,3823,3823,,,,3823,3823,0,0,0,0.00,22
,20171117,3823,3823,,,,3823,3823,0,0,0,0.00,22
,20171120,3823,3823,,,,3823,3823,0,0,0,0.00,22
,20171121,3823,3823,,,,3883,3883,60,60,0,0.00,22
,20171122,3883,3883,,,,3919,3919,36,36,0,0.00,22
,20171123,3919,3919,3966,3967,3846,3917,3938,-2,19,164,645.86,46
,20171124,3917,3938,,,,3975,3975,37,37,0,0.00,46
,20171127,3975,3975,,,,4079,4079,104,104,0,0.00,46
,20171128,4079,4079,,,,4010,4010,-69,-69,0,0.00,46
,20171129,4010,4010,,,,4010,4010,0,0,0,0.00,46
,20171130,4010,4010,4050,4050,4050,4050,4050,40,40,2,8.10,44
,20171201,4050,4050,,,,4027,4027,-23,-23,0,0.00,44
,20171204,4027,4027,4170,4170,4050,4050,4110,23,83,4,16.44,46
,20171205,4050,4110,,,,4110,4110,0,0,0,0.00,46
,20171206,4110,4110,3911,3911,3911,3911,3911,-199,-199,2,7.82,48
,20171207,3911,3911,3922,3922,3844,3844,3881,-67,-30,6,23.29,42
,20171208,3844,3881,,,,4007,4007,126,126,0,0.00,42
,20171211,4007,4007,,,,3997,3997,-10,-10,0,0.00,42
,20171212,3997,3997,,,,3997,3997,0,0,0,0.00,42
,20171213,3997,3997,,,,3997,3997,0,0,0,0.00,42
,20171214,3997,3997,,,,3956,3956,-41,-41,0,0.00,42
,20171215,3956,3956,,,,3956,3956,0,0,0,0.00,42
,20171218,3956,3956,,,,3956,3956,0,0,0,0.00,42
,20171219,3956,3956,3863,3977,3831,3849,3847,-107,-109,44,169.28,42
,20171220,3849,3847,,,,3847,3847,0,0,0,0.00,42
,20171221,3847,3847,,,,3872,3872,25,25,0,0.00,42
,20171222,3872,3872,3940,3956,3940,3950,3947,78,75,60,236.86,66
,20171225,3950,3947,,,,3947,3947,0,0,0,0.00,66
,20171226,3947,3947,3839,3929,3839,3884,3861,-63,-86,12,46.34,66
,20171227,3884,3861,3870,3870,3870,3870,3870,9,9,2,7.74,66
,20171228,3870,3870,3981,3981,3981,3981,3981,111,111,2,7.96,66
,20171229,3981,3981,,,,3968,3968,-13,-13,0,0.00,66
hc1805,20170516,2815,2815,2849,2853,2820,2826,2832,11,17,160,453.18,130
,20170517,2826,2832,2856,2961,2839,2945,2917,113,85,150,437.57,204
,20170518,2945,2917,2942,2944,2903,2934,2929,17,12,198,579.96,256
,20170519,2934,2929,2858,2979,2858,2979,2924,50,-5,330,965.04,230
,20170522,2979,2924,2978,3120,2973,3071,3061,147,137,350,"1,071.68",312
,20170523,3071,3061,3071,3090,3012,3040,3049,-21,-12,258,786.88,330
,20170524,3040,3049,3032,3058,2974,3016,3015,-33,-34,212,639.21,374
,20170525,3016,3015,3015,3058,2994,2995,3019,-20,4,286,863.61,446
,20170526,2995,3019,2994,3006,2945,2977,2972,-42,-47,202,600.45,458
,20170531,2977,2972,3015,3042,2904,2904,2965,-68,-7,190,563.37,464
,20170601,2904,2965,2906,2915,2860,2899,2885,-66,-80,184,531.00,534
,20170602,2899,2885,2902,2911,2860,2874,2886,-11,1,298,860.12,640
,20170605,2874,2886,2872,2879,2800,2807,2821,-79,-65,852,"2,404.27",980
,20170606,2807,2821,2798,2839,2787,2817,2813,-4,-8,1786,"5,024.57",1902
,20170607,2817,2813,2821,2851,2816,2830,2834,17,21,658,"1,864.83",2174
,20170608,2830,2834,2821,2883,2808,2859,2848,25,14,1116,"3,178.60",2202
,20170609,2859,2848,2851,2921,2851,2920,2893,72,45,1990,"5,758.73",2552
,20170612,2920,2893,2920,2938,2870,2906,2904,13,11,2634,"7,651.02",2664
,20170613,2906,2904,2904,2915,2861,2862,2891,-42,-13,1340,"3,875.16",2728
,20170614,2862,2891,2860,2935,2834,2935,2872,44,-19,1626,"4,670.94",2800
,20170615,2935,2872,2933,2990,2889,2984,2956,112,84,2988,"8,834.11",3248
,20170616,2984,2956,2972,3030,2970,2974,3002,18,46,1700,"5,104.31",3558
,20170619,2974,3002,2982,3034,2975,3008,3007,6,5,1802,"5,419.94",3906
,20170620,3008,3007,3002,3024,2996,3011,3008,4,1,558,"1,679.02",3802
,20170621,3011,3008,2983,2994,2900,2988,2970,-20,-38,550,"1,633.89",3702
,20170622,2988,2970,2996,3049,2986,2986,3020,16,50,752,"2,271.09",3702
,20170623,2986,3020,2989,3035,2973,3027,3009,7,-11,598,"1,799.87",3720
,20170626,3027,3009,3031,3055,3010,3045,3035,36,26,908,"2,756.53",3810
,20170627,3045,3035,3045,3100,3039,3100,3065,65,30,622,"1,907.00",3794
,20170628,3100,3065,3111,3160,3111,3157,3139,92,74,1242,"3,899.67",3868
,20170629,3157,3139,3154,3197,3137,3148,3156,9,17,1494,"4,716.02",4450
,20170630,3148,3156,3138,3159,3118,3149,3137,-7,-19,1228,"3,852.82",4828
,20170703,3149,3137,3140,3238,3140,3238,3198,101,61,1114,"3,563.24",4852
,20170704,3238,3198,3229,3252,3153,3169,3202,-29,4,586,"1,876.44",4836
,20170705,3169,3202,3175,3239,3175,3200,3201,-2,-1,768,"2,458.96",4712
,20170706,3200,3201,3182,3186,3103,3166,3138,-35,-63,1766,"5,543.11",5008
,20170707,3166,3138,3177,3221,3135,3221,3166,83,28,1554,"4,920.36",5590
,20170710,3221,3166,3225,3279,3215,3246,3255,80,89,1258,"4,094.80",5670
,20170711,3246,3255,3249,3370,3238,3348,3319,93,64,1410,"4,681.00",5982
,20170712,3348,3319,3333,3399,3333,3357,3365,38,46,752,"2,530.68",6024
,20170713,3357,3365,3352,3456,3350,3456,3411,91,46,1506,"5,137.63",6572
,20170714,3456,3411,3450,3450,3325,3353,3360,-58,-51,1796,"6,036.04",7112
,20170717,3353,3360,3346,3445,3342,3429,3422,69,62,1730,"5,920.56",7512
,20170718,3429,3422,3429,3443,3372,3376,3412,-46,-10,586,"1,999.94",7582
,20170719,3376,3412,3398,3461,3370,3455,3435,43,23,1178,"4,047.21",7844
,20170720,3455,3435,3458,3458,3331,3337,3392,-98,-43,976,"3,311.04",7942
,20170721,3337,3392,3340,3372,3305,3351,3338,-41,-54,898,"2,998.14",7910
,20170724,3351,3338,3363,3369,3287,3341,3324,3,-14,902,"2,998.56",7830
,20170725,3341,3324,3341,3400,3319,3385,3356,61,32,780,"2,618.19",7874
,20170726,3385,3356,3396,3474,3392,3422,3443,66,87,1474,"5,076.39",8110
,20170727,3422,3443,3422,3438,3366,3424,3402,-19,-41,1232,"4,192.03",8034
,20170728,3424,3402,3428,3482,3419,3436,3451,34,49,1400,"4,831.80",8320
,20170731,3436,3451,3447,3580,3447,3576,3514,125,63,1648,"5,792.31",8476
,20170801,3576,3514,3553,3589,3526,3537,3556,23,42,1438,"5,114.05",8976
,20170802,3537,3556,3537,3601,3521,3590,3580,34,24,1418,"5,077.19",9346
,20170803,3590,3580,3590,3670,3576,3657,3631,77,51,4246,"15,421.15",10468
,20170804,3657,3631,3655,3748,3651,3723,3704,92,73,2474,"9,164.47",10890
,20170807,3723,3704,3732,3926,3699,3850,3853,146,149,4898,"18,873.97",12322
,20170808,3850,3853,3850,3900,3757,3807,3823,-46,-30,4114,"15,730.53",11658
,20170809,3807,3823,3807,3928,3782,3923,3856,100,33,2210,"8,522.92",11800
,20170810,3923,3856,3923,3956,3851,3885,3901,29,45,3762,"14,677.13",11554
,20170811,3885,3901,3899,3925,3767,3799,3849,-102,-52,4252,"16,366.36",11416
,20170814,3799,3849,3799,3826,3721,3741,3769,-108,-80,4958,"18,689.97",11718
,20170815,3741,3769,3741,3741,3640,3695,3684,-74,-85,4166,"15,349.10",11976
,20170816,3695,3684,3696,3721,3673,3686,3697,2,13,3568,"13,191.41",11910
,20170817,3686,3697,3686,3836,3686,3804,3783,107,86,8116,"30,703.30",11914
,20170818,3804,3783,3797,3890,3777,3883,3820,100,37,4534,"17,324.32",12584
,20170821,3883,3820,3883,3965,3801,3929,3894,109,74,6504,"25,330.77",12740
,20170822,3929,3894,3929,3948,3862,3913,3903,19,9,5304,"20,704.69",12824
,20170823,3913,3903,3913,3913,3694,3755,3767,-148,-136,11902,"44,846.46",13006
,20170824,3755,3767,3731,3863,3730,3842,3796,75,29,7008,"26,605.93",12354
,20170825,3842,3796,3818,3993,3818,3929,3930,133,134,21752,"85,490.55",12274
,20170828,3929,3930,3930,3966,3822,3946,3902,16,-28,23460,"91,556.81",14114
,20170829,3946,3902,3942,3980,3876,3905,3928,3,26,27728,"108,924.16",15138
,20170830,3905,3928,3911,3944,3849,3918,3896,-10,-32,19860,"77,375.35",16458
,20170831,3918,3896,3910,3933,3821,3931,3882,35,-14,28822,"111,902.24",18912
,20170901,3931,3882,3931,4099,3910,4083,4026,201,144,41966,"168,987.95",28760
,20170904,4083,4026,4083,4224,4079,4101,4131,75,105,63940,"264,176.94",31940
,20170905,4101,4131,4100,4166,4092,4152,4136,21,5,48716,"201,500.38",38714
,20170906,4152,4136,4158,4192,4064,4070,4125,-66,-11,60842,"250,976.86",40672
,20170907,4070,4125,4069,4101,4041,4061,4073,-64,-52,60498,"246,420.27",38424
,20170908,4061,4073,4063,4116,3985,3999,4053,-74,-20,66278,"268,689.29",40428
,20170911,3999,4053,3998,4015,3930,3995,3986,-58,-67,53208,"212,103.98",41622
,20170912,3995,3986,4002,4031,3943,4008,3986,22,0,60690,"241,918.08",44384
,20170913,4008,3986,4005,4035,3941,3955,3990,-31,4,55538,"221,635.43",45462
,20170914,3955,3990,3960,3988,3895,3906,3938,-84,-52,71322,"280,933.79",51744
,20170915,3906,3938,3908,3924,3861,3881,3895,-57,-43,58766,"228,946.59",54804
,20170918,3881,3895,3881,3897,3806,3871,3857,-24,-38,59538,"229,676.31",52392
,20170919,3871,3857,3870,3901,3807,3807,3859,-50,2,52616,"203,084.06",59554
,20170920,3807,3859,3812,3852,3765,3826,3804,-33,-55,58308,"221,852.26",55154
,20170921,3826,3804,3833,3869,3731,3735,3805,-69,1,76958,"292,832.38",59722
,20170922,3735,3805,3730,3738,3587,3606,3675,-199,-130,56256,"206,776.34",60220
,20170925,3606,3675,3612,3665,3600,3647,3634,-28,-41,48110,"174,855.45",60372
,20170926,3647,3634,3654,3692,3640,3669,3666,35,32,35996,"131,993.57",61046
,20170927,3669,3666,3674,3734,3665,3730,3705,64,39,48286,"178,907.70",66714
,20170928,3730,3705,3740,3780,3653,3690,3717,-15,12,64686,"240,481.12",67696
,20170929,3690,3717,3686,3769,3616,3769,3689,52,-28,60212,"222,171.86",65776
,20171009,3769,3689,3811,3867,3743,3774,3799,85,110,60106,"228,391.30",74098
,20171010,3774,3799,3763,3783,3642,3645,3683,-154,-116,73810,"271,872.26",78498
,20171011,3645,3683,3721,3721,3615,3628,3657,-55,-26,81270,"297,253.12",80766
,20171012,3628,3657,3630,3803,3598,3784,3686,127,29,110880,"408,719.47",85198
,20171013,3784,3686,3786,3907,3757,3907,3824,221,138,104102,"398,173.99",90328
,20171016,3907,3824,3907,3975,3887,3944,3926,120,102,112974,"443,598.21",87830
,20171017,3944,3926,3948,3957,3854,3871,3906,-55,-20,144520,"564,496.75",87706
,20171018,3871,3906,3871,3901,3844,3853,3875,-53,-31,100468,"389,327.52",92580
,20171019,3853,3875,3857,3857,3728,3746,3785,-129,-90,164394,"622,257.86",112770
,20171020,3746,3785,3746,3955,3725,3954,3848,169,63,221330,"851,794.06",121670
,20171023,3954,3848,3944,3954,3847,3925,3909,77,61,273752,"1,070,306.80",145880
,20171024,3925,3909,3920,3999,3893,3956,3959,47,50,284356,"1,125,858.59",173888
,20171025,3956,3959,3956,4019,3884,3907,3949,-52,-10,249438,"985,187.15",183912
,20171026,3907,3949,3892,3898,3802,3818,3840,-131,-109,326114,"1,252,480.96",199942
,20171027,3818,3840,3816,3827,3725,3730,3774,-110,-66,370620,"1,399,036.04",236704
,20171030,3730,3774,3730,3753,3702,3706,3728,-68,-46,243512,"907,835.08",254118
,20171031,3706,3728,3707,3812,3696,3771,3756,43,28,357522,"1,343,035.91",235184
,20171101,3771,3756,3780,3788,3680,3681,3748,-75,-8,386496,"1,448,797.28",273038
,20171102,3681,3748,3684,3773,3645,3744,3713,-4,-35,503816,"1,870,991.08",297586
,20171103,3744,3713,3744,3801,3725,3732,3758,19,45,358194,"1,346,361.19",298084
,20171106,3732,3758,3729,3873,3719,3860,3809,102,51,416456,"1,586,532.95",287364
,20171107,3860,3809,3855,3888,3825,3850,3853,41,44,296094,"1,140,962.49",301876
,20171108,3850,3853,3840,3864,3788,3843,3825,-10,-28,348416,"1,332,914.80",315188
,20171109,3843,3825,3854,3917,3812,3840,3867,15,42,496766,"1,921,005.83",317006
,20171110,3840,3867,3840,3903,3819,3900,3865,33,-2,442186,"1,709,484.23",313966
,20171113,3900,3865,3910,3938,3845,3890,3884,25,19,453550,"1,762,030.69",314070
,20171114,3890,3884,3890,3920,3859,3888,3889,4,5,370956,"1,442,728.61",314362
,20171115,3888,3889,3900,3922,3769,3794,3835,-95,-54,448066,"1,718,400.20",325178
,20171116,3794,3835,3814,3820,3764,3799,3799,-36,-36,389082,"1,478,233.35",348874
,20171117,3799,3799,3802,3816,3725,3741,3766,-58,-33,459722,"1,731,611.89",389322
,20171120,3741,3766,3739,3812,3734,3806,3770,40,4,458900,"1,730,162.75",373286
,20171121,3806,3770,3805,3882,3792,3863,3840,93,70,511308,"1,963,862.18",389334
,20171122,3863,3840,3863,3912,3845,3899,3879,59,39,534736,"2,074,695.20",416808
,20171123,3899,3879,3900,3918,3834,3857,3873,-22,-6,696962,"2,699,548.80",445892
,20171124,3857,3873,3852,3866,3788,3862,3820,-11,-53,725268,"2,771,002.10",460418
,20171127,3862,3820,3863,3929,3824,3840,3878,20,58,920420,"3,569,681.91",488230
,20171128,3840,3878,3841,3935,3838,3917,3893,39,15,892820,"3,476,182.95",517924
,20171129,3917,3893,3921,3989,3872,3973,3937,80,44,962496,"3,789,788.19",572600
,20171130,3973,3937,3976,4046,3957,3968,4005,31,68,995430,"3,987,173.49",617568
,20171201,3968,4005,3970,4012,3938,3989,3976,-16,-29,844508,"3,358,333.87",619856
,20171204,3989,3976,3988,4108,3961,4074,4045,98,69,991964,"4,012,992.32",663598
,20171205,4074,4045,4075,4102,4026,4050,4068,5,23,685184,"2,787,927.19",658770
,20171206,4050,4068,4048,4054,3913,3932,3972,-136,-96,865630,"3,438,717.36",623918
,20171207,3932,3972,3931,3955,3764,3832,3892,-140,-80,961868,"3,744,390.50",593898
,20171208,3832,3892,3832,3942,3829,3923,3875,31,-17,758400,"2,939,457.85",552862
,20171211,3923,3875,3935,3984,3888,3921,3930,46,55,855480,"3,362,592.41",561536
,20171212,3921,3930,3917,3990,3891,3914,3937,-16,7,727196,"2,863,146.62",568892
,20171213,3914,3937,3919,3919,3842,3864,3877,-73,-60,778466,"3,018,721.90",555480
,20171214,3864,3877,3874,3915,3840,3863,3874,-14,-3,786762,"3,048,592.55",564448
,20171215,3863,3874,3860,3940,3853,3926,3908,52,34,820372,"3,206,122.79",575068
,20171218,3926,3908,3930,3996,3865,3942,3928,34,20,1087416,"4,272,325.67",557724
,20171219,3942,3928,3938,3943,3821,3828,3877,-100,-51,1008346,"3,909,536.53",621500
,20171220,3828,3877,3830,3876,3806,3840,3841,-37,-36,721836,"2,772,969.28",611918
,20171221,3840,3841,3856,3924,3840,3881,3884,40,43,902692,"3,506,224.45",599880
,20171222,3881,3884,3880,3980,3870,3970,3935,86,51,805102,"3,168,164.47",624010
,20171225,3970,3935,3978,3979,3826,3829,3900,-106,-35,753756,"2,940,173.50",588408
,20171226,3829,3900,3825,3881,3819,3870,3855,-30,-45,542832,"2,092,711.82",606588
,20171227,3870,3855,3868,3899,3844,3857,3874,2,19,681648,"2,640,997.28",613948
,20171228,3857,3874,3850,3870,3816,3848,3845,-26,-29,617426,"2,374,098.38",625112
,20171229,3848,3845,3833,3898,3825,3846,3861,1,16,772990,"2,984,666.45",630966
hc1806,20170616,2956,2956,,,,2956,2956,0,0,0,0.00,0
,20170619,2956,2956,,,,2956,2956,0,0,0,0.00,0
,20170620,2956,2956,3108,3108,2902,2902,3005,-54,49,12,36.06,0
,20170621,2902,3005,,,,2967,2967,-38,-38,0,0.00,0
,20170622,2967,2967,,,,3017,3017,50,50,0,0.00,0
,20170623,3017,3017,,,,3006,3006,-11,-11,0,0.00,0
,20170626,3006,3006,3096,3097,3082,3082,3087,76,81,122,376.66,122
,20170627,3082,3087,3075,3075,3074,3074,3074,-13,-13,4,12.30,122
,20170628,3074,3074,3186,3186,3169,3169,3177,95,103,4,12.71,124
,20170629,3169,3177,3180,3180,3180,3180,3180,3,3,2,6.36,124
,20170630,3180,3180,,,,3180,3180,0,0,0,0.00,124
,20170703,3180,3180,,,,3180,3180,0,0,0,0.00,124
,20170704,3180,3180,3193,3193,3193,3193,3193,13,13,2,6.39,122
,20170705,3193,3193,,,,3192,3192,-1,-1,0,0.00,122
,20170706,3192,3192,,,,3192,3192,0,0,0,0.00,122
,20170707,3192,3192,,,,3220,3220,28,28,0,0.00,122
,20170710,3220,3220,,,,3310,3310,90,90,0,0.00,122
,20170711,3310,3310,,,,3375,3375,65,65,0,0.00,122
,20170712,3375,3375,3357,3358,3357,3358,3357,-17,-18,4,13.43,124
,20170713,3358,3357,3316,3380,3316,3380,3368,23,11,44,148.22,96
,20170714,3380,3368,3500,3500,3500,3500,3500,132,132,2,7.00,98
,20170717,3500,3500,3380,3410,3380,3410,3392,-90,-108,8,27.14,98
,20170718,3410,3392,3358,3358,3358,3358,3358,-34,-34,4,13.43,96
,20170719,3358,3358,,,,3381,3381,23,23,0,0.00,96
,20170720,3381,3381,,,,3339,3339,-42,-42,0,0.00,96
,20170721,3339,3339,,,,3339,3339,0,0,0,0.00,96
,20170724,3339,3339,3308,3308,3308,3308,3308,-31,-31,2,6.62,98
,20170725,3308,3308,3342,3342,3342,3342,3342,34,34,8,26.74,96
,20170726,3342,3342,3362,3362,3362,3362,3362,20,20,4,13.45,98
,20170727,3362,3362,,,,3362,3362,0,0,0,0.00,98
,20170728,3362,3362,,,,3362,3362,0,0,0,0.00,98
,20170731,3362,3362,,,,3497,3497,135,135,0,0.00,98
,20170801,3497,3497,3520,3520,3519,3519,3519,22,22,4,14.08,96
,20170802,3519,3519,3548,3599,3548,3599,3591,80,72,14,50.28,84
,20170803,3599,3591,3587,3649,3519,3606,3594,15,3,82,294.74,14
,20170804,3606,3594,,,,3638,3638,44,44,0,0.00,14
,20170807,3638,3638,,,,3784,3784,146,146,0,0.00,14
,20170808,3784,3784,,,,3784,3784,0,0,0,0.00,14
,20170809,3784,3784,3825,3825,3825,3825,3825,41,41,12,45.90,14
,20170810,3825,3825,,,,3825,3825,0,0,0,0.00,14
,20170811,3825,3825,3766,3766,3766,3766,3766,-59,-59,2,7.53,14
,20170814,3766,3766,,,,3757,3757,-9,-9,0,0.00,14
,20170815,3757,3757,,,,3672,3672,-85,-85,0,0.00,14
,20170816,3672,3672,,,,3672,3672,0,0,0,0.00,14
,20170817,3672,3672,,,,3729,3729,57,57,0,0.00,14
,20170818,3729,3729,,,,3773,3773,44,44,0,0.00,14
,20170821,3773,3773,,,,3773,3773,0,0,0,0.00,14
,20170822,3773,3773,,,,3814,3814,41,41,0,0.00,14
,20170823,3814,3814,,,,3682,3682,-132,-132,0,0.00,14
,20170824,3682,3682,,,,3710,3710,28,28,0,0.00,14
,20170825,3710,3710,,,,3841,3841,131,131,0,0.00,14
,20170828,3841,3841,,,,3841,3841,0,0,0,0.00,14
,20170829,3841,3841,,,,3841,3841,0,0,0,0.00,14
,20170830,3841,3841,,,,3841,3841,0,0,0,0.00,14
,20170831,3841,3841,,,,3841,3841,0,0,0,0.00,14
,20170901,3841,3841,,,,3984,3984,143,143,0,0.00,14
,20170904,3984,3984,4071,4071,4071,4071,4071,87,87,2,8.14,14
,20170905,4071,4071,4094,4094,4094,4094,4094,23,23,2,8.19,14
,20170906,4094,4094,,,,4083,4083,-11,-11,0,0.00,14
,20170907,4083,4083,,,,4031,4031,-52,-52,0,0.00,14
,20170908,4031,4031,,,,4010,4010,-21,-21,0,0.00,14
,20170911,4010,4010,,,,4001,4001,-9,-9,0,0.00,14
,20170912,4001,4001,,,,4001,4001,0,0,0,0.00,14
,20170913,4001,4001,,,,3968,3968,-33,-33,0,0.00,14
,20170914,3968,3968,,,,3917,3917,-51,-51,0,0.00,14
,20170915,3917,3917,,,,3896,3896,-21,-21,0,0.00,14
,20170918,3896,3896,3776,3776,3776,3776,3776,-120,-120,8,30.21,22
,20170919,3776,3776,,,,3776,3776,0,0,0,0.00,22
,20170920,3776,3776,,,,3776,3776,0,0,0,0.00,22
,20170921,3776,3776,3805,3805,3805,3805,3805,29,29,2,7.61,22
,20170922,3805,3805,3699,3699,3576,3576,3641,-229,-164,18,65.55,26
,20170925,3576,3641,3649,3649,3649,3649,3649,8,8,2,7.30,26
,20170926,3649,3649,3672,3672,3672,3672,3672,23,23,2,7.34,26
,20170927,3672,3672,3776,3776,3776,3776,3776,104,104,8,30.21,22
,20170928,3776,3776,3721,3721,3721,3721,3721,-55,-55,6,22.33,16
,20170929,3721,3721,,,,3721,3721,0,0,0,0.00,16
,20171009,3721,3721,3746,3746,3746,3746,3746,25,25,2,7.49,16
,20171010,3746,3746,,,,3708,3708,-38,-38,0,0.00,16
,20171011,3708,3708,,,,3682,3682,-26,-26,0,0.00,16
,20171012,3682,3682,3700,3711,3700,3711,3700,29,18,202,747.42,216
,20171013,3711,3700,3741,3788,3741,3788,3777,88,77,42,158.64,214
,20171016,3788,3777,3818,3895,3818,3827,3844,50,67,38,146.09,212
,20171017,3827,3844,3840,3900,3785,3896,3846,52,2,178,684.74,158
,20171018,3896,3846,3799,3800,3772,3783,3790,-63,-56,14,53.06,158
,20171019,3783,3790,3783,3792,3715,3720,3782,-70,-8,170,642.95,48
,20171020,3720,3782,3888,3888,3801,3849,3851,67,69,8,30.81,46
,20171023,3849,3851,3900,3900,3900,3900,3900,49,49,2,7.80,46
,20171024,3900,3900,,,,3950,3950,50,50,0,0.00,46
,20171025,3950,3950,3959,3959,3867,3867,3910,-83,-40,10,39.10,44
,20171026,3867,3910,3840,3840,3840,3840,3840,-70,-70,2,7.68,44
,20171027,3840,3840,3725,3756,3678,3739,3729,-101,-111,216,805.64,46
,20171030,3739,3729,,,,3729,3729,0,0,0,0.00,46
,20171031,3729,3729,3723,3792,3722,3789,3753,60,24,22,82.58,42
,20171101,3789,3753,,,,3753,3753,0,0,0,0.00,42
,20171102,3753,3753,3722,3722,3669,3671,3681,-82,-72,12,44.18,44
,20171103,3671,3681,,,,3726,3726,45,45,0,0.00,44
,20171106,3726,3726,,,,3777,3777,51,51,0,0.00,44
,20171107,3777,3777,,,,3821,3821,44,44,0,0.00,44
,20171108,3821,3821,3821,3850,3784,3806,3805,-15,-16,14,53.28,40
,20171109,3806,3805,3838,3852,3837,3852,3844,47,39,12,46.14,46
,20171110,3852,3844,,,,3863,3863,19,19,0,0.00,46
,20171113,3863,3863,,,,3863,3863,0,0,0,0.00,46
,20171114,3863,3863,,,,3871,3871,8,8,0,0.00,46
,20171115,3871,3871,3833,3836,3827,3832,3833,-39,-38,16,61.33,40
,20171116,3832,3833,3797,3797,3797,3797,3797,-36,-36,4,15.19,38
,20171117,3797,3797,,,,3797,3797,0,0,0,0.00,38
,20171120,3797,3797,3786,3790,3785,3785,3787,-12,-10,8,30.30,40
,20171121,3785,3787,,,,3787,3787,0,0,0,0.00,40
,20171122,3787,3787,,,,3826,3826,39,39,0,0.00,40
,20171123,3826,3826,3845,3849,3845,3849,3847,23,21,6,23.09,38
,20171124,3849,3847,,,,3847,3847,0,0,0,0.00,38
,20171127,3847,3847,,,,3847,3847,0,0,0,0.00,38
,20171128,3847,3847,3900,3924,3870,3906,3895,59,48,12,46.74,36
,20171129,3906,3895,3959,3966,3888,3939,3939,44,44,16,63.04,40
,20171130,3939,3939,3966,4002,3966,3976,3982,37,43,14,55.76,34
,20171201,3976,3982,,,,3982,3982,0,0,0,0.00,34
,20171204,3982,3982,,,,4051,4051,69,69,0,0.00,34
,20171205,4051,4051,,,,4051,4051,0,0,0,0.00,34
,20171206,4051,4051,,,,4051,4051,0,0,0,0.00,34
,20171207,4051,4051,3881,3946,3870,3870,3910,-181,-141,12,46.92,32
,20171208,3870,3910,3796,3796,3796,3796,3796,-114,-114,6,22.78,36
,20171211,3796,3796,3823,3823,3823,3823,3823,27,27,4,15.29,40
,20171212,3823,3823,3824,3907,3824,3827,3852,4,29,12,46.23,38
,20171213,3827,3852,3863,3863,3801,3831,3833,-21,-19,50,191.66,36
,20171214,3831,3833,3831,3831,3831,3831,3831,-2,-2,4,15.32,32
,20171215,3831,3831,,,,3864,3864,33,33,0,0.00,32
,20171218,3864,3864,3864,3866,3864,3866,3865,2,1,4,15.46,32
,20171219,3866,3865,3761,3805,3761,3805,3783,-60,-82,4,15.13,32
,20171220,3805,3783,,,,3783,3783,0,0,0,0.00,32
,20171221,3783,3783,,,,3825,3825,42,42,0,0.00,32
,20171222,3825,3825,3920,3920,3910,3910,3915,85,90,4,15.66,32
,20171225,3910,3915,,,,3880,3880,-35,-35,0,0.00,32
,20171226,3880,3880,,,,3835,3835,-45,-45,0,0.00,32
,20171227,3835,3835,,,,3835,3835,0,0,0,0.00,32
,20171228,3835,3835,,,,3835,3835,0,0,0,0.00,32
,20171229,3835,3835,,,,3835,3835,0,0,0,0.00,32
hc1807,20170718,3392,3392,,,,3392,3392,0,0,0,0.00,0
,20170719,3392,3392,,,,3392,3392,0,0,0,0.00,0
,20170720,3392,3392,,,,3392,3392,0,0,0,0.00,0
,20170721,3392,3392,,,,3392,3392,0,0,0,0.00,0
,20170724,3392,3392,,,,3392,3392,0,0,0,0.00,0
,20170725,3392,3392,,,,3392,3392,0,0,0,0.00,0
,20170726,3392,3392,,,,3392,3392,0,0,0,0.00,0
,20170727,3392,3392,3293,3293,3293,3293,3293,-99,-99,2,6.59,2
,20170728,3293,3293,,,,3340,3340,47,47,0,0.00,2
,20170731,3340,3340,,,,3401,3401,61,61,0,0.00,2
,20170801,3401,3401,,,,3422,3422,21,21,0,0.00,2
,20170802,3422,3422,3611,3611,3611,3611,3611,189,189,2,7.22,0
,20170803,3611,3611,,,,3611,3611,0,0,0,0.00,0
,20170804,3611,3611,,,,3683,3683,72,72,0,0.00,0
,20170807,3683,3683,,,,3831,3831,148,148,0,0.00,0
,20170808,3831,3831,,,,3831,3831,0,0,0,0.00,0
,20170809,3831,3831,,,,3872,3872,41,41,0,0.00,0
,20170810,3872,3872,,,,3872,3872,0,0,0,0.00,0
,20170811,3872,3872,,,,3812,3812,-60,-60,0,0.00,0
,20170814,3812,3812,,,,3733,3733,-79,-79,0,0.00,0
,20170815,3733,3733,,,,3649,3649,-84,-84,0,0.00,0
,20170816,3649,3649,,,,3649,3649,0,0,0,0.00,0
,20170817,3649,3649,,,,3733,3733,84,84,0,0.00,0
,20170818,3733,3733,,,,3770,3770,37,37,0,0.00,0
,20170821,3770,3770,,,,3843,3843,73,73,0,0.00,0
,20170822,3843,3843,3860,3899,3860,3899,3879,56,36,4,15.52,2
,20170823,3899,3879,,,,3879,3879,0,0,0,0.00,2
,20170824,3879,3879,,,,3879,3879,0,0,0,0.00,2
,20170825,3879,3879,,,,4016,4016,137,137,0,0.00,2
,20170828,4016,4016,,,,4016,4016,0,0,0,0.00,2
,20170829,4016,4016,,,,4016,4016,0,0,0,0.00,2
,20170830,4016,4016,,,,3983,3983,-33,-33,0,0.00,2
,20170831,3983,3983,,,,3983,3983,0,0,0,0.00,2
,20170901,3983,3983,,,,3983,3983,0,0,0,0.00,2
,20170904,3983,3983,,,,3983,3983,0,0,0,0.00,2
,20170905,3983,3983,,,,3983,3983,0,0,0,0.00,2
,20170906,3983,3983,,,,3972,3972,-11,-11,0,0.00,2
,20170907,3972,3972,,,,3922,3922,-50,-50,0,0.00,2
,20170908,3922,3922,,,,3903,3903,-19,-19,0,0.00,2
,20170911,3903,3903,,,,3838,3838,-65,-65,0,0.00,2
,20170912,3838,3838,,,,3838,3838,0,0,0,0.00,2
,20170913,3838,3838,,,,3842,3842,4,4,0,0.00,2
,20170914,3842,3842,,,,3792,3792,-50,-50,0,0.00,2
,20170915,3792,3792,,,,3751,3751,-41,-41,0,0.00,2
,20170918,3751,3751,,,,3635,3635,-116,-116,0,0.00,2
,20170919,3635,3635,3853,3853,3809,3809,3831,174,196,4,15.32,2
,20170920,3809,3831,,,,3831,3831,0,0,0,0.00,2
,20170921,3831,3831,,,,3860,3860,29,29,0,0.00,2
,20170922,3860,3860,3628,3628,3628,3628,3628,-232,-232,2,7.26,4
,20170925,3628,3628,,,,3628,3628,0,0,0,0.00,4
,20170926,3628,3628,,,,3650,3650,22,22,0,0.00,4
,20170927,3650,3650,,,,3753,3753,103,103,0,0.00,4
,20170928,3753,3753,,,,3698,3698,-55,-55,0,0.00,4
,20170929,3698,3698,,,,3670,3670,-28,-28,0,0.00,4
,20171009,3670,3670,,,,3694,3694,24,24,0,0.00,4
,20171010,3694,3694,,,,3694,3694,0,0,0,0.00,4
,20171011,3694,3694,,,,3668,3668,-26,-26,0,0.00,4
,20171012,3668,3668,,,,3686,3686,18,18,0,0.00,4
,20171013,3686,3686,3829,3829,3829,3829,3829,143,143,2,7.66,4
,20171016,3829,3829,,,,3897,3897,68,68,0,0.00,4
,20171017,3897,3897,,,,3899,3899,2,2,0,0.00,4
,20171018,3899,3899,,,,3842,3842,-57,-57,0,0.00,4
,20171019,3842,3842,,,,3833,3833,-9,-9,0,0.00,4
,20171020,3833,3833,3756,3756,3756,3756,3756,-77,-77,2,7.51,2
,20171023,3756,3756,,,,3756,3756,0,0,0,0.00,2
,20171024,3756,3756,,,,3804,3804,48,48,0,0.00,2
,20171025,3804,3804,3890,3908,3830,3833,3867,29,63,12,46.40,4
,20171026,3833,3867,,,,3797,3797,-70,-70,0,0.00,4
,20171027,3797,3797,,,,3688,3688,-109,-109,0,0.00,4
,20171030,3688,3688,,,,3688,3688,0,0,0,0.00,4
,20171031,3688,3688,,,,3712,3712,24,24,0,0.00,4
,20171101,3712,3712,,,,3712,3712,0,0,0,0.00,4
,20171102,3712,3712,,,,3712,3712,0,0,0,0.00,4
,20171103,3712,3712,,,,3712,3712,0,0,0,0.00,4
,20171106,3712,3712,,,,3762,3762,50,50,0,0.00,4
,20171107,3762,3762,,,,3762,3762,0,0,0,0.00,4
,20171108,3762,3762,,,,3762,3762,0,0,0,0.00,4
,20171109,3762,3762,,,,3762,3762,0,0,0,0.00,4
,20171110,3762,3762,,,,3761,3761,-1,-1,0,0.00,4
,20171113,3761,3761,,,,3780,3780,19,19,0,0.00,4
,20171114,3780,3780,,,,3785,3785,5,5,0,0.00,4
,20171115,3785,3785,,,,3747,3747,-38,-38,0,0.00,4
,20171116,3747,3747,3693,3734,3693,3734,3713,-13,-34,4,14.85,4
,20171117,3734,3713,,,,3681,3681,-32,-32,0,0.00,4
,20171120,3681,3681,,,,3671,3671,-10,-10,0,0.00,4
,20171121,3671,3671,,,,3739,3739,68,68,0,0.00,4
,20171122,3739,3739,,,,3777,3777,38,38,0,0.00,4
,20171123,3777,3777,,,,3777,3777,0,0,0,0.00,4
,20171124,3777,3777,,,,3777,3777,0,0,0,0.00,4
,20171127,3777,3777,3880,3880,3880,3880,3880,103,103,2,7.76,4
,20171128,3880,3880,3740,3740,3740,3740,3740,-140,-140,2,7.48,2
,20171129,3740,3740,,,,3783,3783,43,43,0,0.00,2
,20171130,3783,3783,,,,3824,3824,41,41,0,0.00,2
,20171201,3824,3824,,,,3824,3824,0,0,0,0.00,2
,20171204,3824,3824,,,,3890,3890,66,66,0,0.00,2
,20171205,3890,3890,,,,3890,3890,0,0,0,0.00,2
,20171206,3890,3890,,,,3798,3798,-92,-92,0,0.00,2
,20171207,3798,3798,,,,3665,3665,-133,-133,0,0.00,2
,20171208,3665,3665,,,,3558,3558,-107,-107,0,0.00,2
,20171211,3558,3558,,,,3583,3583,25,25,0,0.00,2
,20171212,3583,3583,,,,3610,3610,27,27,0,0.00,2
,20171213,3610,3610,,,,3592,3592,-18,-18,0,0.00,2
,20171214,3592,3592,,,,3590,3590,-2,-2,0,0.00,2
,20171215,3590,3590,,,,3621,3621,31,31,0,0.00,2
,20171218,3621,3621,,,,3621,3621,0,0,0,0.00,2
,20171219,3621,3621,,,,3544,3544,-77,-77,0,0.00,2
,20171220,3544,3544,,,,3511,3511,-33,-33,0,0.00,2
,20171221,3511,3511,,,,3721,3721,210,210,0,0.00,2
,20171222,3721,3721,,,,3808,3808,87,87,0,0.00,2
,20171225,3808,3808,,,,3808,3808,0,0,0,0.00,2
,20171226,3808,3808,,,,3808,3808,0,0,0,0.00,2
,20171227,3808,3808,,,,3808,3808,0,0,0,0.00,2
,20171228,3808,3808,,,,3808,3808,0,0,0,0.00,2
,20171229,3808,3808,3693,3846,3693,3789,3766,-19,-42,10,37.66,0
hc1808,20170816,3649,3649,,,,3649,3649,0,0,0,0.00,0
,20170817,3649,3649,,,,3649,3649,0,0,0,0.00,0
,20170818,3649,3649,,,,3649,3649,0,0,0,0.00,0
,20170821,3649,3649,,,,3720,3720,71,71,0,0.00,0
,20170822,3720,3720,,,,3720,3720,0,0,0,0.00,0
,20170823,3720,3720,,,,3720,3720,0,0,0,0.00,0
,20170824,3720,3720,,,,3720,3720,0,0,0,0.00,0
,20170825,3720,3720,,,,3720,3720,0,0,0,0.00,0
,20170828,3720,3720,,,,3821,3821,101,101,0,0.00,0
,20170829,3821,3821,,,,3821,3821,0,0,0,0.00,0
,20170830,3821,3821,,,,3821,3821,0,0,0,0.00,0
,20170831,3821,3821,,,,3821,3821,0,0,0,0.00,0
,20170901,3821,3821,,,,3850,3850,29,29,0,0.00,0
,20170904,3850,3850,,,,3934,3934,84,84,0,0.00,0
,20170905,3934,3934,,,,3934,3934,0,0,0,0.00,0
,20170906,3934,3934,,,,3934,3934,0,0,0,0.00,0
,20170907,3934,3934,,,,3934,3934,0,0,0,0.00,0
,20170908,3934,3934,,,,3934,3934,0,0,0,0.00,0
,20170911,3934,3934,,,,3934,3934,0,0,0,0.00,0
,20170912,3934,3934,,,,3934,3934,0,0,0,0.00,0
,20170913,3934,3934,,,,3934,3934,0,0,0,0.00,0
,20170914,3934,3934,,,,3934,3934,0,0,0,0.00,0
,20170915,3934,3934,,,,3934,3934,0,0,0,0.00,0
,20170918,3934,3934,,,,3920,3920,-14,-14,0,0.00,0
,20170919,3920,3920,,,,3873,3873,-47,-47,0,0.00,0
,20170920,3873,3873,,,,3873,3873,0,0,0,0.00,0
,20170921,3873,3873,,,,3873,3873,0,0,0,0.00,0
,20170922,3873,3873,,,,3640,3640,-233,-233,0,0.00,0
,20170925,3640,3640,,,,3640,3640,0,0,0,0.00,0
,20170926,3640,3640,,,,3640,3640,0,0,0,0.00,0
,20170927,3640,3640,,,,3659,3659,19,19,0,0.00,0
,20170928,3659,3659,,,,3659,3659,0,0,0,0.00,0
,20170929,3659,3659,,,,3659,3659,0,0,0,0.00,0
,20171009,3659,3659,3807,3807,3807,3807,3807,148,148,6,22.84,6
,20171010,3807,3807,,,,3807,3807,0,0,0,0.00,6
,20171011,3807,3807,,,,3780,3780,-27,-27,0,0.00,6
,20171012,3780,3780,,,,3798,3798,18,18,0,0.00,6
,20171013,3798,3798,,,,3945,3945,147,147,0,0.00,6
,20171016,3945,3945,,,,4015,4015,70,70,0,0.00,6
,20171017,4015,4015,,,,4017,4017,2,2,0,0.00,6
,20171018,4017,4017,,,,3958,3958,-59,-59,0,0.00,6
,20171019,3958,3958,3720,3757,3720,3720,3738,-238,-220,12,44.86,10
,20171020,3720,3738,3690,3700,3679,3700,3689,-38,-49,6,22.14,8
,20171023,3700,3689,,,,3689,3689,0,0,0,0.00,8
,20171024,3689,3689,,,,3689,3689,0,0,0,0.00,8
,20171025,3689,3689,,,,3722,3722,33,33,0,0.00,8
,20171026,3722,3722,,,,3722,3722,0,0,0,0.00,8
,20171027,3722,3722,,,,3615,3615,-107,-107,0,0.00,8
,20171030,3615,3615,,,,3615,3615,0,0,0,0.00,8
,20171031,3615,3615,3688,3720,3617,3720,3668,105,53,82,300.85,8
,20171101,3720,3668,3654,3677,3588,3588,3658,-80,-10,14,51.22,10
,20171102,3588,3658,,,,3658,3658,0,0,0,0.00,10
,20171103,3658,3658,,,,3658,3658,0,0,0,0.00,10
,20171106,3658,3658,,,,3708,3708,50,50,0,0.00,10
,20171107,3708,3708,3691,3691,3691,3691,3691,-17,-17,10,36.91,20
,20171108,3691,3691,3815,3816,3762,3762,3791,71,100,18,68.25,18
,20171109,3762,3791,,,,3791,3791,0,0,0,0.00,18
,20171110,3791,3791,3788,3788,3788,3788,3788,-3,-3,6,22.73,12
,20171113,3788,3788,3797,3826,3797,3826,3811,38,23,4,15.25,12
,20171114,3826,3811,,,,3811,3811,0,0,0,0.00,12
,20171115,3811,3811,3709,3709,3709,3709,3709,-102,-102,2,7.42,10
,20171116,3709,3709,,,,3709,3709,0,0,0,0.00,10
,20171117,3709,3709,3679,3679,3679,3679,3679,-30,-30,4,14.72,8
,20171120,3679,3679,,,,3682,3682,3,3,0,0.00,8
,20171121,3682,3682,,,,3751,3751,69,69,0,0.00,8
,20171122,3751,3751,,,,3789,3789,38,38,0,0.00,8
,20171123,3789,3789,,,,3789,3789,0,0,0,0.00,8
,20171124,3789,3789,,,,3789,3789,0,0,0,0.00,8
,20171127,3789,3789,,,,3789,3789,0,0,0,0.00,8
,20171128,3789,3789,3793,3793,3793,3793,3793,4,4,2,7.59,10
,20171129,3793,3793,,,,3795,3795,2,2,0,0.00,10
,20171130,3795,3795,,,,3836,3836,41,41,0,0.00,10
,20171201,3836,3836,,,,3836,3836,0,0,0,0.00,10
,20171204,3836,3836,,,,3836,3836,0,0,0,0.00,10
,20171205,3836,3836,3940,3940,3829,3829,3860,-7,24,14,54.05,24
,20171206,3829,3860,3839,3839,3839,3839,3839,-21,-21,2,7.68,22
,20171207,3839,3839,3907,3907,3653,3714,3747,-125,-92,18,67.46,20
,20171208,3714,3747,,,,3747,3747,0,0,0,0.00,20
,20171211,3747,3747,,,,3773,3773,26,26,0,0.00,20
,20171212,3773,3773,3799,3799,3799,3799,3799,26,26,2,7.60,18
,20171213,3799,3799,,,,3780,3780,-19,-19,0,0.00,18
,20171214,3780,3780,,,,3778,3778,-2,-2,0,0.00,18
,20171215,3778,3778,,,,3778,3778,0,0,0,0.00,18
,20171218,3778,3778,,,,3778,3778,0,0,0,0.00,18
,20171219,3778,3778,,,,3697,3697,-81,-81,0,0.00,18
,20171220,3697,3697,,,,3697,3697,0,0,0,0.00,18
,20171221,3697,3697,,,,3738,3738,41,41,0,0.00,18
,20171222,3738,3738,,,,3825,3825,87,87,0,0.00,18
,20171225,3825,3825,,,,3791,3791,-34,-34,0,0.00,18
,20171226,3791,3791,,,,3747,3747,-44,-44,0,0.00,18
,20171227,3747,3747,,,,3747,3747,0,0,0,0.00,18
,20171228,3747,3747,3695,3695,3695,3695,3695,-52,-52,6,22.17,12
,20171229,3695,3695,,,,3654,3654,-41,-41,0,0.00,12
hc1809,20170918,3934,3934,,,,3934,3934,0,0,0,0.00,0
,20170919,3934,3934,3844,3849,3819,3849,3837,-85,-97,6,23.02,6
,20170920,3849,3837,,,,3837,3837,0,0,0,0.00,6
,20170921,3837,3837,3745,3745,3667,3667,3706,-170,-131,4,14.82,8
,20170922,3667,3706,,,,3706,3706,0,0,0,0.00,8
,20170925,3706,3706,3662,3662,3662,3662,3662,-44,-44,2,7.32,6
,20170926,3662,3662,3580,3621,3580,3593,3587,-69,-75,18,64.58,18
,20170927,3593,3587,3672,3675,3672,3675,3673,88,86,4,14.69,18
,20170928,3675,3673,3723,3735,3611,3611,3695,-62,22,14,51.74,20
,20170929,3611,3695,3612,3663,3546,3650,3608,-45,-87,22,79.40,26
,20171009,3650,3608,3734,3734,3692,3692,3723,84,115,10,37.24,26
,20171010,3692,3723,3617,3653,3584,3584,3618,-139,-105,6,21.71,24
,20171011,3584,3618,3584,3584,3516,3516,3533,-102,-85,8,28.26,30
,20171012,3516,3533,3636,3659,3591,3591,3627,58,94,10,36.27,30
,20171013,3591,3627,3631,3768,3631,3768,3708,141,81,22,81.58,28
,20171016,3768,3708,3864,3866,3864,3866,3865,158,157,4,15.46,28
,20171017,3866,3865,,,,3865,3865,0,0,0,0.00,28
,20171018,3865,3865,,,,3808,3808,-57,-57,0,0.00,28
,20171019,3808,3808,3716,3716,3671,3671,3699,-137,-109,18,66.59,32
,20171020,3671,3699,3671,3780,3627,3691,3653,-8,-46,26,95.00,48
,20171023,3691,3653,3777,3777,3777,3777,3777,124,124,6,22.66,50
,20171024,3777,3777,3877,3896,3792,3792,3881,15,104,124,481.35,50
,20171025,3792,3881,,,,3881,3881,0,0,0,0.00,50
,20171026,3881,3881,3760,3799,3703,3769,3722,-112,-159,22,81.90,38
,20171027,3769,3722,3706,3708,3649,3669,3683,-53,-39,18,66.31,28
,20171030,3669,3683,3643,3694,3643,3694,3668,11,-15,8,29.35,32
,20171031,3694,3668,3698,3698,3683,3683,3690,15,22,4,14.76,30
,20171101,3683,3690,,,,3672,3672,-18,-18,0,0.00,30
,20171102,3672,3672,3600,3600,3600,3600,3600,-72,-72,2,7.20,28
,20171103,3600,3600,3674,3772,3674,3700,3730,100,130,42,156.70,24
,20171106,3700,3730,3763,3779,3763,3779,3773,49,43,8,30.19,22
,20171107,3779,3773,,,,3773,3773,0,0,0,0.00,22
,20171108,3773,3773,3750,3770,3678,3770,3745,-3,-28,26,97.38,28
,20171109,3770,3745,3805,3805,3727,3727,3782,-18,37,10,37.82,28
,20171110,3727,3782,3725,3757,3725,3757,3741,-25,-41,4,14.96,28
,20171113,3757,3741,3798,3798,3752,3752,3769,11,28,10,37.69,36
,20171114,3752,3769,3770,3770,3770,3770,3770,1,1,2,7.54,36
,20171115,3770,3770,3781,3781,3662,3665,3721,-105,-49,20,74.42,36
,20171116,3665,3721,3716,3716,3652,3652,3684,-69,-37,4,14.74,38
,20171117,3652,3684,3698,3719,3673,3690,3697,6,13,40,147.91,16
,20171120,3690,3697,,,,3687,3687,-10,-10,0,0.00,16
,20171121,3687,3687,3795,3795,3795,3795,3795,108,108,4,15.18,16
,20171122,3795,3795,3815,3815,3815,3815,3815,20,20,2,7.63,18
,20171123,3815,3815,3850,3850,3785,3785,3821,-30,6,14,53.50,22
,20171124,3785,3821,,,,3800,3800,-21,-21,0,0.00,22
,20171127,3800,3800,3778,3826,3766,3826,3793,26,-7,14,53.10,26
,20171128,3826,3793,,,,3793,3793,0,0,0,0.00,26
,20171129,3793,3793,3820,3844,3820,3844,3828,51,35,6,22.97,24
,20171130,3844,3828,3866,3866,3866,3866,3866,38,38,2,7.73,22
,20171201,3866,3866,3833,3833,3833,3833,3833,-33,-33,2,7.67,22
,20171204,3833,3833,3937,3937,3902,3902,3920,69,87,8,31.36,24
,20171205,3902,3920,3925,3925,3878,3878,3908,-42,-12,12,46.90,20
,20171206,3878,3908,,,,3908,3908,0,0,0,0.00,20
,20171207,3908,3908,,,,3815,3815,-93,-93,0,0.00,20
,20171208,3815,3815,,,,3815,3815,0,0,0,0.00,20
,20171211,3815,3815,3782,3782,3782,3782,3782,-33,-33,8,30.26,20
,20171212,3782,3782,3821,3821,3800,3800,3805,18,23,8,30.44,26
,20171213,3800,3805,3753,3768,3753,3768,3765,-37,-40,14,52.71,26
,20171214,3768,3765,3767,3767,3767,3767,3767,2,2,2,7.53,26
,20171215,3767,3767,,,,3767,3767,0,0,0,0.00,26
,20171218,3767,3767,3842,3842,3754,3754,3798,-13,31,4,15.19,26
,20171219,3754,3798,3726,3794,3725,3792,3756,-6,-42,46,172.79,24
,20171220,3792,3756,3720,3789,3682,3682,3730,-74,-26,6,22.38,24
,20171221,3682,3730,3506,3774,3506,3705,3668,-25,-62,50,183.41,26
,20171222,3705,3668,3735,3735,3735,3735,3735,67,67,2,7.47,26
,20171225,3735,3735,3764,3764,3666,3666,3715,-69,-20,4,14.86,28
,20171226,3666,3715,3693,3741,3693,3741,3717,26,2,4,14.87,28
,20171227,3741,3717,3744,3806,3700,3725,3741,8,24,16,59.86,28
,20171228,3725,3741,,,,3741,3741,0,0,0,0.00,28
,20171229,3741,3741,3701,3701,3701,3701,3701,-40,-40,2,7.40,28
hc1810,20171017,3865,3865,3760,3768,3672,3688,3713,-177,-152,2132,"7,917.31",1706
,20171018,3688,3713,3718,3745,3656,3674,3687,-39,-26,776,"2,861.68",1810
,20171019,3674,3687,3652,3699,3589,3605,3646,-82,-41,1326,"4,835.79",1896
,20171020,3605,3646,3600,3762,3586,3758,3684,112,38,1074,"3,957.44",1986
,20171023,3758,3684,3762,3765,3687,3747,3734,63,50,1566,"5,848.14",2330
,20171024,3747,3734,3753,3809,3735,3773,3785,39,51,932,"3,528.14",2414
,20171025,3773,3785,3774,3839,3725,3746,3775,-39,-10,886,"3,344.82",2364
,20171026,3746,3775,3741,3741,3652,3674,3685,-101,-90,1870,"6,892.77",2492
,20171027,3674,3685,3697,3697,3620,3630,3643,-55,-42,1546,"5,633.48",2948
,20171030,3630,3643,3621,3659,3605,3639,3638,-4,-5,3494,"12,713.96",4820
,20171031,3639,3638,3634,3702,3623,3675,3662,37,24,1008,"3,691.80",4752
,20171101,3675,3662,3677,3704,3609,3609,3665,-53,3,1510,"5,535.62",5198
,20171102,3609,3665,3610,3681,3579,3659,3625,-6,-40,2222,"8,056.81",5630
,20171103,3659,3625,3649,3718,3646,3665,3677,40,52,2448,"9,002.16",6380
,20171106,3665,3677,3682,3785,3653,3771,3727,94,50,3256,"12,135.93",6728
,20171107,3771,3727,3760,3789,3744,3761,3761,34,34,1430,"5,379.22",6662
,20171108,3761,3761,3761,3773,3716,3760,3742,-1,-19,1200,"4,490.95",6656
,20171109,3760,3742,3758,3830,3735,3759,3779,17,37,2212,"8,359.45",6826
,20171110,3759,3779,3757,3807,3732,3805,3774,26,-5,2056,"7,759.72",6772
,20171113,3805,3774,3801,3829,3734,3762,3768,-12,-6,4962,"18,698.70",6918
,20171114,3762,3768,3767,3775,3735,3746,3751,-22,-17,4770,"17,894.09",7986
,20171115,3746,3751,3740,3750,3646,3656,3684,-95,-67,6844,"25,216.53",11364
,20171116,3656,3684,3670,3678,3623,3652,3656,-32,-28,3686,"13,476.65",12008
,20171117,3652,3656,3655,3670,3611,3618,3639,-38,-17,2716,"9,883.65",12472
,20171120,3618,3639,3624,3685,3616,3676,3652,37,13,4780,"17,457.81",12496
,20171121,3676,3652,3683,3734,3669,3713,3707,61,55,3932,"14,577.57",12778
,20171122,3713,3707,3724,3757,3705,3742,3731,35,24,5136,"19,164.28",14018
,20171123,3742,3731,3745,3760,3690,3707,3719,-24,-12,5568,"20,707.44",15572
,20171124,3707,3719,3702,3705,3645,3700,3670,-19,-49,6418,"23,556.13",17138
,20171127,3700,3670,3700,3753,3669,3679,3718,9,48,6964,"25,896.56",18292
,20171128,3679,3718,3680,3733,3674,3720,3704,2,-14,12436,"46,069.34",23660
,20171129,3720,3704,3725,3761,3675,3751,3731,47,27,13016,"48,566.59",26436
,20171130,3751,3731,3757,3800,3737,3744,3776,13,45,17062,"64,441.43",31986
,20171201,3744,3776,3750,3785,3731,3760,3761,-16,-15,17412,"65,497.14",32636
,20171204,3760,3761,3750,3876,3750,3838,3833,77,72,16640,"63,797.70",36162
,20171205,3838,3833,3831,3862,3790,3807,3834,-26,1,16224,"62,214.39",37130
,20171206,3807,3834,3809,3820,3710,3714,3754,-120,-80,16352,"61,386.04",36398
,20171207,3714,3754,3722,3730,3571,3640,3686,-114,-68,23338,"86,034.65",39202
,20171208,3640,3686,3638,3720,3625,3698,3668,12,-18,19780,"72,570.23",38688
,20171211,3698,3668,3700,3754,3683,3709,3721,41,53,22976,"85,498.81",39940
,20171212,3709,3721,3715,3773,3684,3703,3725,-18,4,16226,"60,453.99",41166
,20171213,3703,3725,3701,3709,3652,3665,3677,-60,-48,15956,"58,673.34",42324
,20171214,3665,3677,3665,3710,3650,3673,3679,-4,2,26170,"96,297.17",47936
,20171215,3673,3679,3673,3730,3666,3714,3705,35,26,18178,"67,363.11",47668
,20171218,3714,3705,3714,3776,3683,3736,3721,31,16,25394,"94,498.27",47264
,20171219,3736,3721,3740,3740,3662,3667,3693,-54,-28,20134,"74,360.43",48342
,20171220,3667,3693,3668,3689,3642,3650,3663,-43,-30,18656,"68,349.38",50470
,20171221,3650,3663,3655,3720,3650,3689,3688,26,25,22748,"83,915.10",50804
,20171222,3689,3688,3688,3762,3680,3749,3728,61,40,20948,"78,108.29",49190
,20171225,3749,3728,3750,3759,3650,3651,3696,-77,-32,20284,"74,981.06",49500
,20171226,3651,3696,3650,3705,3650,3698,3676,2,-20,19716,"72,493.88",49778
,20171227,3698,3676,3698,3727,3680,3680,3706,4,30,25424,"94,230.78",48870
,20171228,3680,3706,3681,3706,3645,3682,3678,-24,-28,27708,"101,921.01",54186
,20171229,3682,3678,3680,3720,3671,3681,3699,3,21,30276,"112,016.44",54736
hc1811,20171116,3684,3684,3667,3667,3667,3667,3667,-17,-17,2,7.33,2
,20171117,3667,3667,,,,3667,3667,0,0,0,0.00,2
,20171120,3667,3667,,,,3667,3667,0,0,0,0.00,2
,20171121,3667,3667,,,,3722,3722,55,55,0,0.00,2
,20171122,3722,3722,,,,3746,3746,24,24,0,0.00,2
,20171123,3746,3746,,,,3733,3733,-13,-13,0,0.00,2
,20171124,3733,3733,,,,3733,3733,0,0,0,0.00,2
,20171127,3733,3733,,,,3733,3733,0,0,0,0.00,2
,20171128,3733,3733,,,,3733,3733,0,0,0,0.00,2
,20171129,3733,3733,,,,3733,3733,0,0,0,0.00,2
,20171130,3733,3733,,,,3778,3778,45,45,0,0.00,2
,20171201,3778,3778,,,,3778,3778,0,0,0,0.00,2
,20171204,3778,3778,3771,3771,3746,3756,3757,-22,-21,8,30.06,6
,20171205,3756,3757,,,,3757,3757,0,0,0,0.00,6
,20171206,3757,3757,,,,3757,3757,0,0,0,0.00,6
,20171207,3757,3757,,,,3689,3689,-68,-68,0,0.00,6
,20171208,3689,3689,,,,3689,3689,0,0,0,0.00,6
,20171211,3689,3689,,,,3689,3689,0,0,0,0.00,6
,20171212,3689,3689,,,,3689,3689,0,0,0,0.00,6
,20171213,3689,3689,,,,3689,3689,0,0,0,0.00,6
,20171214,3689,3689,,,,3691,3691,2,2,0,0.00,6
,20171215,3691,3691,,,,3691,3691,0,0,0,0.00,6
,20171218,3691,3691,,,,3691,3691,0,0,0,0.00,6
,20171219,3691,3691,,,,3663,3663,-28,-28,0,0.00,6
,20171220,3663,3663,,,,3663,3663,0,0,0,0.00,6
,20171221,3663,3663,,,,3663,3663,0,0,0,0.00,6
,20171222,3663,3663,,,,3703,3703,40,40,0,0.00,6
,20171225,3703,3703,,,,3671,3671,-32,-32,0,0.00,6
,20171226,3671,3671,,,,3671,3671,0,0,0,0.00,6
,20171227,3671,3671,,,,3671,3671,0,0,0,0.00,6
,20171228,3671,3671,,,,3671,3671,0,0,0,0.00,6
,20171229,3671,3671,,,,3671,3671,0,0,0,0.00,6
hc1812,20171218,3691,3691,,,,3691,3691,0,0,0,0.00,0
,20171219,3691,3691,,,,3691,3691,0,0,0,0.00,0
,20171220,3691,3691,,,,3691,3691,0,0,0,0.00,0
,20171221,3691,3691,,,,3691,3691,0,0,0,0.00,0
,20171222,3691,3691,,,,3691,3691,0,0,0,0.00,0
,20171225,3691,3691,,,,3691,3691,0,0,0,0.00,0
,20171226,3691,3691,,,,3691,3691,0,0,0,0.00,0
,20171227,3691,3691,,,,3691,3691,0,0,0,0.00,0
,20171228,3691,3691,,,,3691,3691,0,0,0,0.00,0
,20171229,3691,3691,,,,3691,3691,0,0,0,0.00,0
ni1701,20170103,84320,84000,83890,85300,83890,84210,84780,210,780,6626,"56,177.44",48348
,20170104,84210,84780,84440,84700,81900,83380,82910,-1400,-1870,5340,"44,276.04",48108
,20170105,83380,82910,83280,84250,83210,83750,83910,840,1000,4908,"41,186.41",45948
,20170106,83750,83910,83800,84170,82320,83150,83510,-760,-400,8484,"70,853.45",43500
,20170109,83150,83510,83310,84900,83310,84650,84420,1140,910,7092,"59,871.88",42384
,20170110,84650,84420,84470,86060,84470,85500,85330,1080,910,5124,"43,724.64",41196
,20170111,85500,85330,86100,86530,85620,86030,85980,700,650,3408,"29,303.51",40104
,20170112,86030,85980,85220,87600,83500,84100,84360,-1880,-1620,2136,"18,019.56",39336
,20170113,84100,84360,83200,84100,83130,83800,83780,-560,-580,1008,"8,445.96",39120
,20170116,83800,83780,85380,85500,84000,85000,85170,1220,1390,1356,"11,549.29",39444
ni1702,20170103,84460,84360,84940,85720,84680,84680,85210,320,850,70,596.53,138
,20170104,84680,85210,85170,85170,83040,83490,83830,-1720,-1380,32,268.26,134
,20170105,83490,83830,84980,85570,84400,84400,85010,570,1180,18,153.02,138
,20170106,84400,85010,84000,84940,83260,84080,84210,-930,-800,108,909.53,144
,20170109,84080,84210,84040,85230,83670,85190,84300,980,90,42,354.08,130
,20170110,85190,84300,85740,86240,85180,86240,85560,1940,1260,46,393.61,98
,20170111,86240,85560,86700,86700,86270,86270,86650,710,1090,18,155.97,82
,20170112,86270,86650,,,,84620,84620,-2030,-2030,0,0.00,82
,20170113,84620,84620,83630,84120,83630,84120,83750,-500,-870,16,134.00,94
,20170116,84120,83750,85850,85850,85500,85500,85540,1750,1790,16,136.88,106
,20170117,85500,85540,85020,85020,84560,84560,84650,-980,-890,10,84.66,98
,20170118,84560,84650,83900,84820,82850,82870,83570,-1780,-1080,96,802.36,108
,20170119,82870,83570,83800,83950,83330,83550,83710,-20,140,30,251.15,94
,20170120,83550,83710,83160,83160,80960,80960,82350,-2750,-1360,26,214.13,96
,20170123,80960,82350,81220,81990,80310,81840,81150,-510,-1200,62,503.17,88
,20170124,81840,81150,80750,81200,80750,81200,81050,50,-100,6,48.63,82
,20170125,81200,81050,80560,81450,80210,81000,80700,-50,-350,54,435.78,72
,20170126,81000,80700,81000,81000,80110,80110,80550,-590,-150,24,193.33,72
,20170203,80110,80550,82950,83890,82210,82210,83030,1660,2480,84,697.49,84
,20170206,82210,83030,,,,84800,84800,1770,1770,0,0.00,84
,20170207,84800,84800,,,,84800,84800,0,0,0,0.00,84
,20170208,84800,84800,84500,84500,84500,84500,84500,-300,-300,12,101.40,84
,20170209,84500,84500,,,,85200,85200,700,700,0,0.00,84
,20170210,85200,85200,,,,85200,85200,0,0,0,0.00,84
,20170213,85200,85200,87500,87500,86020,86020,87250,820,2050,72,628.22,132
,20170214,86020,87250,88000,88000,88000,88000,88000,750,750,36,316.80,96
,20170215,88000,88000,,,,88000,88000,0,0,0,0.00,96
ni1703,20170103,85020,85020,86010,86010,85650,85760,85840,740,820,12,103.02,216
,20170104,85760,85840,85570,85570,82800,84310,83060,-1530,-2780,322,"2,674.57",484
,20170105,84310,83060,84040,88280,84020,84560,84610,1500,1550,134,"1,133.83",482
,20170106,84560,84610,84420,84640,84030,84640,84360,30,-250,14,118.10,478
,20170109,84640,84360,84070,85690,84060,85430,84850,1070,490,228,"1,934.76",474
,20170110,85430,84850,85400,86020,85300,86020,85580,1170,730,212,"1,814.50",354
,20170111,86020,85580,87070,87740,86520,86520,87100,940,1520,30,261.32,358
,20170112,86520,87100,86620,87170,84710,85130,86210,-1970,-890,452,"3,897.10",280
,20170113,85130,86210,85130,86720,83200,84590,84480,-1620,-1730,140,"1,182.84",258
,20170116,84590,84480,84890,86710,84890,86410,86230,1930,1750,44,379.44,246
,20170117,86410,86230,86410,86410,83800,83800,85080,-2430,-1150,90,765.81,276
,20170118,83800,85080,85000,85460,83950,84360,84670,-720,-410,74,626.57,288
,20170119,84360,84670,84430,84530,84130,84130,84350,-540,-320,10,84.35,286
,20170120,84130,84350,83480,83580,82580,82650,83340,-1700,-1010,44,366.73,284
,20170123,82650,83340,82650,83110,81820,81820,82170,-1520,-1170,258,"2,120.17",444
,20170124,81820,82170,81600,82090,81600,81780,81780,-390,-390,148,"1,210.36",432
,20170125,81780,81780,81450,81760,80960,80960,81270,-820,-510,40,325.08,428
,20170126,80960,81270,81330,81870,80940,81790,81520,520,250,14,114.13,428
,20170203,81790,81520,84930,84940,83340,83340,84150,1820,2630,48,403.96,430
,20170206,83340,84150,85510,85510,85160,85160,85420,1010,1270,92,785.88,350
,20170207,85160,85420,85390,85540,85170,85420,85410,0,-10,50,427.06,328
,20170208,85420,85410,85510,86240,85280,86110,85690,700,280,214,"1,833.79",190
,20170209,86110,85690,86130,86130,86130,86130,86130,440,440,2,17.23,190
,20170210,86130,86130,85720,85720,85720,85720,85720,-410,-410,2,17.14,190
,20170213,85720,85720,86430,88450,86430,88200,87820,2480,2100,64,562.11,214
,20170214,88200,87820,88700,89000,88700,89000,88920,1180,1100,8,71.14,214
,20170215,89000,88920,89330,89330,88780,89060,88940,140,20,28,249.05,214
,20170216,89060,88940,89230,90830,89230,90830,89710,1890,770,18,161.48,230
,20170217,90830,89710,89870,90130,88800,89750,89850,40,140,82,736.83,242
,20170220,89750,89850,90000,90690,89200,90000,89900,150,50,184,"1,654.33",288
,20170221,90000,89900,89920,91090,89920,90980,90650,1080,750,70,634.57,270
,20170222,90980,90650,89480,89590,88580,88580,89280,-2070,-1370,46,410.72,256
,20170223,88580,89280,89130,89130,87300,87300,88180,-1980,-1100,80,705.52,292
,20170224,87300,88180,87890,87890,86770,87800,87560,-380,-620,84,735.52,314
,20170227,87800,87560,88170,90430,88170,88820,89760,1260,2200,18,161.57,310
,20170228,88820,89760,90010,91000,90010,90010,90290,250,530,14,126.41,300
,20170301,90010,90290,90400,90400,90400,90400,90400,110,110,24,216.96,300
,20170302,90400,90400,,,,90400,90400,0,0,0,0.00,300
,20170303,90400,90400,,,,90400,90400,0,0,0,0.00,300
,20170306,90400,90400,,,,90400,90400,0,0,0,0.00,300
,20170307,90400,90400,89900,89900,89900,89900,89900,-500,-500,12,107.88,300
,20170308,89900,89900,,,,89900,89900,0,0,0,0.00,300
,20170309,89900,89900,,,,89900,89900,0,0,0,0.00,300
,20170310,89900,89900,,,,89900,89900,0,0,0,0.00,300
,20170313,89900,89900,83610,83610,83610,83610,83610,-6290,-6290,12,100.33,312
,20170314,83610,83610,77760,84200,77760,83000,83460,-610,-150,432,"3,605.71",672
,20170315,83000,83460,,,,83800,83800,340,340,0,0.00,672
ni1704,20170103,85060,85060,85470,85470,85470,85470,85470,410,410,2,17.09,104
,20170104,85470,85470,85560,85560,85560,85560,85560,90,90,4,34.22,104
,20170105,85560,85560,85250,85250,84390,84390,84820,-1170,-740,4,33.93,106
,20170106,84390,84820,,,,84820,84820,0,0,0,0.00,106
,20170109,84820,84820,85440,86380,85440,85810,86030,990,1210,90,774.27,128
,20170110,85810,86030,85850,85850,85850,85850,85850,-180,-180,2,17.17,128
,20170111,85850,85850,,,,86540,86540,690,690,0,0.00,128
,20170112,86540,86540,85730,86040,85730,86040,85880,-500,-660,16,137.42,128
,20170113,86040,85880,83650,85640,83650,85640,84940,-240,-940,82,696.53,148
,20170116,85640,84940,86810,86810,86810,86810,86810,1870,1870,2,17.36,148
,20170117,86810,86810,,,,85660,85660,-1150,-1150,0,0.00,148
,20170118,85660,85660,84480,84990,84480,84990,84730,-670,-930,8,67.79,144
,20170119,84990,84730,85030,85030,84420,84760,84780,30,50,76,644.39,156
,20170120,84760,84780,84520,84520,82410,82410,84060,-2370,-720,10,84.07,148
,20170123,82410,84060,82650,82650,82650,82650,82650,-1410,-1410,6,49.59,148
,20170124,82650,82650,82880,82880,82030,82330,82390,-320,-260,42,346.04,136
,20170125,82330,82390,82410,82410,81180,81210,81560,-1180,-830,20,163.13,150
,20170126,81210,81560,80910,83040,80910,82120,82120,560,560,42,344.94,142
,20170203,82120,82120,84350,84350,84280,84350,84300,2230,2180,68,573.25,146
,20170206,84350,84300,85340,85670,85230,85230,85420,930,1120,10,85.43,148
,20170207,85230,85420,85740,86090,85740,86090,85820,670,400,8,68.66,156
,20170208,86090,85820,85810,85950,85810,85950,85850,130,30,14,120.19,160
,20170209,85950,85850,87000,87500,86410,86440,86880,590,1030,78,677.67,186
,20170210,86440,86880,85550,85550,85550,85550,85550,-1330,-1330,2,17.11,188
,20170213,85550,85550,87730,88910,87590,88460,88020,2910,2470,90,792.21,208
,20170214,88460,88020,89090,89560,88520,89560,88980,1540,960,50,444.91,174
,20170215,89560,88980,89220,89740,88340,88940,89280,-40,300,16,142.86,180
,20170216,88940,89280,89280,90950,89280,89600,90700,320,1420,90,816.39,192
,20170217,89600,90700,90380,91020,89900,90320,90760,-380,60,54,490.11,196
,20170220,90320,90760,90930,91200,90900,91000,90990,240,230,14,127.39,200
,20170221,91000,90990,91800,92150,91120,91160,91750,170,760,576,"5,285.02",230
,20170222,91160,91750,,,,90050,90050,-1700,-1700,0,0.00,230
,20170223,90050,90050,89500,89500,88070,88070,89200,-1980,-850,34,303.29,232
,20170224,88070,89200,88630,88640,87850,87850,88530,-1350,-670,36,318.74,242
,20170227,87850,88530,88410,90230,88410,90230,89540,1700,1010,14,125.36,230
,20170228,90230,89540,90510,91040,90510,90790,90910,1250,1370,266,"2,418.23",224
,20170301,90790,90910,90500,90500,89670,89960,90000,-950,-910,64,576.03,228
,20170302,89960,90000,89960,91000,89960,90840,90630,840,630,20,181.28,230
,20170303,90840,90630,90430,91280,88890,90590,90090,-40,-540,1440,"12,973.03",290
,20170306,90590,90090,90620,91680,90540,90820,90930,730,840,34,309.19,274
,20170307,90820,90930,90340,91210,90340,90340,90750,-590,-180,26,235.97,270
,20170308,90340,90750,90410,90410,87890,88100,88490,-2650,-2260,68,601.74,280
,20170309,88100,88490,87520,87520,82990,84010,84370,-4480,-4120,266,"2,244.46",188
,20170310,84010,84370,84410,84530,82850,83900,84130,-470,-240,432,"3,634.66",262
,20170313,83900,84130,82660,83610,81810,83610,82580,-520,-1550,46,379.88,260
,20170314,83610,82580,84060,84580,83500,83500,84060,920,1480,48,403.51,224
,20170315,83500,84060,84060,84060,84060,84060,84060,0,0,6,50.44,218
,20170316,84060,84060,85170,85650,84610,84850,85110,790,1050,18,153.20,224
,20170317,84850,85110,85150,85210,83750,83750,84660,-1360,-450,46,389.46,216
,20170320,83750,84660,84800,84800,84690,84690,84720,30,60,6,50.84,218
,20170321,84690,84720,84210,84840,84040,84050,84400,-670,-320,32,270.09,218
,20170322,84050,84400,83630,83630,82440,82460,82660,-1940,-1740,24,198.39,196
,20170323,82460,82660,82590,83350,82380,82900,83000,240,340,24,199.22,192
,20170324,82900,83000,82370,82370,82370,82370,82370,-630,-630,4,32.95,188
,20170327,82370,82370,81000,81000,79940,80140,80280,-2230,-2090,58,465.67,174
,20170328,80140,80280,80530,81400,80280,81400,80660,1120,380,80,645.28,130
,20170329,81400,80660,82520,82520,80610,80610,82120,-50,1460,146,"1,199.03",128
,20170330,80610,82120,,,,82000,82000,-120,-120,0,0.00,128
,20170331,82000,82000,81730,82500,80640,82500,81400,500,-600,16,130.24,120
,20170405,82500,81400,82500,82500,82500,82500,82500,1100,1100,12,99.00,120
,20170406,82500,82500,,,,82500,82500,0,0,0,0.00,120
,20170407,82500,82500,,,,82500,82500,0,0,0,0.00,120
,20170410,82500,82500,,,,82500,82500,0,0,0,0.00,120
,20170411,82500,82500,,,,82500,82500,0,0,0,0.00,120
,20170412,82500,82500,81880,81880,81880,81880,81880,-620,-620,12,98.26,132
,20170413,81880,81880,,,,81880,81880,0,0,0,0.00,132
,20170414,81880,81880,,,,81880,81880,0,0,0,0.00,132
,20170417,81880,81880,,,,81880,81880,0,0,0,0.00,132
ni1705,20170103,85560,85760,85560,87050,85500,86010,86410,250,650,269450,"2,328,575.55",539812
,20170104,86010,86410,86250,86460,83450,85130,84790,-1280,-1620,533246,"4,521,438.41",562026
,20170105,85130,84790,84710,86090,84650,85250,85410,460,620,418844,"3,577,435.58",556800
,20170106,85250,85410,85300,85840,84510,84810,85300,-600,-110,354012,"3,019,872.11",552744
,20170109,84810,85300,85050,86630,84960,86370,85830,1070,530,355704,"3,053,086.49",544016
,20170110,86370,85830,86180,87850,85940,87130,86770,1300,940,458082,"3,974,789.82",547840
,20170111,87130,86770,87560,88360,87230,87750,87810,980,1040,412296,"3,620,751.13",543488
,20170112,87750,87810,87310,88160,85150,85800,86590,-2010,-1220,532698,"4,612,900.42",576552
,20170113,85800,86590,83590,86280,83550,85510,85250,-1080,-1340,639938,"5,456,047.48",624132
,20170116,85510,85250,85150,87640,85110,86480,86640,1230,1390,563058,"4,878,511.29",621788
,20170117,86480,86640,86370,87190,84050,85220,85940,-1420,-700,507158,"4,358,810.29",630830
,20170118,85220,85940,85400,86190,84550,85090,85310,-850,-630,406068,"3,464,356.43",629616
,20170119,85090,85310,85220,85470,84600,84920,85050,-390,-260,312126,"2,654,941.68",631236
,20170120,84920,85050,84500,84860,81750,81780,83390,-3270,-1660,720128,"6,005,333.88",686800
,20170123,81780,83390,82000,83370,81800,82750,82560,-640,-830,462766,"3,820,827.71",681646
,20170124,82750,82560,82420,82980,81860,82430,82530,-130,-30,426562,"3,520,662.35",707082
,20170125,82430,82530,82650,82800,81410,81630,82180,-900,-350,406886,"3,344,058.61",717612
,20170126,81630,82180,81220,83170,81210,82540,82330,360,150,419980,"3,457,873.48",706268
,20170203,82540,82330,85800,85880,83570,84690,84660,2360,2330,352866,"2,987,580.54",662236
,20170206,84690,84660,84910,86480,84840,86160,85830,1500,1170,502648,"4,314,504.73",663282
,20170207,86160,85830,86300,86730,85700,86120,86220,290,390,314440,"2,711,356.94",644114
,20170208,86120,86220,86320,87110,85750,86810,86440,590,220,356268,"3,079,805.40",639410
,20170209,86810,86440,87050,87330,86420,86550,86970,110,530,287732,"2,502,466.98",629352
,20170210,86550,86970,86850,86980,85770,86750,86430,-220,-540,389706,"3,368,520.10",635332
,20170213,86750,86430,86980,89530,86930,89120,88530,2690,2100,548972,"4,860,467.89",626844
,20170214,89120,88530,89380,90260,88750,90260,89480,1730,950,411744,"3,684,402.36",620518
,20170215,90260,89480,90480,90790,88460,89810,89610,330,130,584512,"5,238,171.22",612146
,20170216,89810,89610,89760,92000,88810,90400,90510,790,900,611674,"5,536,473.87",593282
,20170217,90400,90510,90500,91710,89670,90690,90800,180,290,556330,"5,051,503.69",585026
,20170220,90690,90800,90890,91880,90050,91690,91090,890,290,474982,"4,327,028.43",580536
,20170221,91690,91090,91830,92550,91160,91510,91870,420,780,393138,"3,612,040.56",578048
,20170222,91510,91870,91660,91830,89020,89740,90310,-2130,-1560,492100,"4,444,317.03",569806
,20170223,89740,90310,89640,90500,88120,88590,89380,-1720,-930,423036,"3,781,110.27",561394
,20170224,88590,89380,88800,89230,87400,89110,88420,-270,-960,464838,"4,110,101.88",539676
,20170227,89110,88420,89000,91480,88560,90700,90220,2280,1800,558474,"5,039,033.04",531044
,20170228,90700,90220,90940,91500,90300,90690,90920,470,700,420894,"3,826,849.00",510886
,20170301,90690,90920,90800,91420,89180,91090,90440,170,-480,472650,"4,274,709.33",506920
,20170302,91090,90440,91270,91900,90620,91150,91360,710,920,391970,"3,581,190.63",492452
,20170303,91150,91360,90880,91030,89450,90800,90270,-560,-1090,413718,"3,734,808.22",494374
,20170306,90800,90270,90850,91880,90360,91040,91080,770,810,501870,"4,571,181.53",490760
,20170307,91040,91080,91050,91650,90520,91140,91110,60,30,348648,"3,176,740.21",488124
,20170308,91140,91110,91000,91090,87650,88100,89020,-3010,-2090,645388,"5,745,510.55",508730
,20170309,88100,89020,87980,88250,83000,84130,85410,-4890,-3610,724322,"6,186,524.67",495482
,20170310,84130,85410,83910,85090,83660,83690,84440,-1720,-970,401606,"3,391,351.51",490852
,20170313,83690,84440,83850,84790,82080,84070,83480,-370,-960,660964,"5,518,083.53",488520
,20170314,84070,83480,84160,85350,83500,83980,84590,500,1110,481678,"4,074,927.72",472350
,20170315,83980,84590,84200,85550,83360,84980,84670,390,80,429164,"3,634,086.43",474100
,20170316,84980,84670,85080,85950,84780,85510,85380,840,710,406986,"3,475,058.03",459520
,20170317,85510,85380,85480,85500,84120,84460,84810,-920,-570,385452,"3,269,213.49",468854
,20170320,84460,84810,84820,85540,84310,84450,84930,-360,120,347232,"2,949,312.75",448864
,20170321,84450,84930,84450,85180,83650,84300,84440,-630,-490,353398,"2,984,200.27",444418
,20170322,84300,84440,84190,84960,82310,82440,83570,-2000,-870,382710,"3,198,503.11",441206
,20170323,82440,83570,82500,83700,81880,82990,82860,-580,-710,310120,"2,569,897.30",414302
,20170324,82990,82860,82810,83270,82000,82510,82710,-350,-150,245506,"2,030,769.87",424832
,20170327,82510,82710,82400,82900,79560,80320,81260,-2390,-1450,453520,"3,685,382.09",413042
,20170328,80320,81260,80500,81740,80000,80930,80890,-330,-370,295030,"2,386,660.24",377206
,20170329,80930,80890,80900,82750,80600,82550,81900,1660,1010,316094,"2,588,830.92",356792
,20170330,82550,81900,82400,83310,81900,82320,82540,420,640,261944,"2,162,340.40",329242
,20170331,82320,82540,82410,83600,82330,83070,83020,530,480,300254,"2,492,951.51",306474
,20170405,83070,83020,82650,84700,82650,84230,83930,1210,910,155750,"1,307,352.83",283834
,20170406,84230,83930,84500,84950,84070,84690,84600,760,670,136474,"1,154,640.53",242860
,20170407,84690,84600,84950,85000,81700,82260,83320,-2340,-1280,157438,"1,311,815.37",218010
,20170410,82260,83320,82250,84330,81760,83310,83280,-10,-40,90026,"749,741.82",199274
,20170411,83310,83280,83410,83790,82500,83450,83270,170,-10,71154,"592,549.07",185414
,20170412,83450,83270,83440,83860,79900,80030,81340,-3240,-1930,89764,"730,147.51",174022
,20170413,80030,81340,80050,80900,79210,80200,80250,-1140,-1090,46258,"371,257.34",163006
,20170414,80200,80250,80100,80620,78770,79020,79610,-1230,-640,38136,"303,631.30",154650
,20170417,79020,79610,79020,80120,78520,78890,79360,-720,-250,36132,"286,766.40",146452
,20170418,78890,79360,78950,79670,78240,78530,79100,-830,-260,28384,"224,525.63",141116
,20170419,78530,79100,78470,78470,76120,77440,77040,-1660,-2060,44080,"339,625.53",132268
,20170420,77440,77040,77500,78120,76290,77860,77250,820,210,24322,"187,910.24",124476
,20170421,77860,77250,77590,78540,77370,77750,77870,500,620,21176,"164,898.16",120792
,20170424,77750,77870,77750,77890,76330,76930,76940,-940,-930,18818,"144,793.91",116158
,20170425,76930,76940,76720,77110,75660,75960,76230,-980,-710,24192,"184,439.78",110886
,20170426,75960,76230,75960,76640,75780,76160,76310,-70,80,20218,"154,301.60",103238
,20170427,76160,76310,76280,76610,75570,76120,76050,-190,-260,27290,"207,567.33",91426
,20170428,76120,76050,76150,77630,74540,77140,76790,1090,740,31254,"240,003.10",79492
,20170502,77140,76790,77540,78660,77470,78130,78350,1340,1560,8152,"63,872.86",78816
,20170503,78130,78350,78140,78430,77350,77560,77940,-790,-410,5544,"43,213.57",76056
,20170504,77560,77940,76710,76780,73360,74550,75710,-3390,-2230,4860,"36,799.02",73128
,20170505,74550,75710,74180,74190,73000,73000,73500,-2710,-2210,10416,"76,567.73",68820
,20170508,73000,73500,73550,75000,73540,74200,74000,700,500,3288,"24,333.26",67656
,20170509,74200,74000,74230,74800,74140,74700,74580,700,580,5472,"40,810.52",65448
,20170510,74700,74580,75010,75660,74000,74700,75010,120,430,7008,"52,572.78",63504
,20170511,74700,75010,74100,75600,74000,75500,74810,490,-200,4632,"34,653.16",59880
,20170512,75500,74810,75500,75570,75250,75350,75380,540,570,420,"3,166.25",59652
,20170515,75350,75380,75300,75790,75150,75600,75450,220,70,2880,"21,731.54",59064
ni1706,20170103,85680,85720,86450,87200,86450,87200,86800,1480,1080,16,138.88,424
,20170104,87200,86800,83940,84860,83940,84860,84240,-1940,-2560,6,50.55,424
,20170105,84860,84240,85880,85880,85370,85370,85620,1130,1380,4,34.25,424
,20170106,85370,85620,85550,85940,85550,85730,85770,110,150,10,85.78,422
,20170109,85730,85770,86520,86960,85940,86600,86550,830,780,396,"3,427.45",196
,20170110,86600,86550,86380,87530,86380,87530,86670,980,120,34,294.68,164
,20170111,87530,86670,88230,88230,87620,87620,87860,950,1190,20,175.73,160
,20170112,87620,87860,87830,88200,86080,86080,86870,-1780,-990,36,312.75,148
,20170113,86080,86870,86080,86080,84290,85930,85470,-940,-1400,50,427.37,138
,20170116,85930,85470,86800,87480,86800,87140,87140,1670,1670,16,139.43,132
,20170117,87140,87140,87150,87150,84500,85520,85380,-1620,-1760,26,222.00,132
,20170118,85520,85380,85260,85430,85260,85430,85340,50,-40,8,68.28,132
,20170119,85430,85340,85760,85770,85520,85520,85600,180,260,84,719.11,164
,20170120,85520,85600,84400,84400,82810,83190,83240,-2410,-2360,12,99.90,164
,20170123,83190,83240,83550,83560,83380,83380,83450,140,210,10,83.45,166
,20170124,83380,83450,83060,83170,82260,82950,82930,-500,-520,52,431.26,174
,20170125,82950,82930,82680,82680,82680,82680,82680,-250,-250,4,33.07,170
,20170126,82680,82680,,,,82680,82680,0,0,0,0.00,170
,20170203,82680,82680,85670,85670,85000,85000,85250,2320,2570,10,85.25,174
,20170206,85000,85250,85900,86600,85670,86560,86120,1310,870,44,378.94,172
,20170207,86560,86120,86480,86610,86190,86570,86450,450,330,30,259.36,166
,20170208,86570,86450,86730,87010,86340,86950,86840,500,390,34,295.26,146
,20170209,86950,86840,87210,87480,86950,86950,87320,110,480,34,296.89,156
,20170210,86950,87320,86980,86980,86980,86980,86980,-340,-340,4,34.79,156
,20170213,86980,86980,88630,89990,88630,89670,89520,2690,2540,82,734.08,168
,20170214,89670,89520,89990,90500,89220,90500,89860,980,340,34,305.53,160
,20170215,90500,89860,89770,90210,89680,89800,89980,-60,120,30,269.96,184
,20170216,89800,89980,89450,92380,89450,91070,91250,1090,1270,26,237.25,182
,20170217,91070,91250,91360,91870,90030,90830,91620,-420,370,442,"4,049.61",280
,20170220,90830,91620,92050,92060,91560,91770,91790,150,170,22,201.95,272
,20170221,91770,91790,91900,92690,91750,91750,92300,-40,510,60,553.81,254
,20170222,91750,92300,90900,90900,90750,90750,90820,-1550,-1480,4,36.33,252
,20170223,90750,90820,89750,90760,89040,89190,89780,-1630,-1040,62,556.68,242
,20170224,89190,89780,88430,90060,88260,89400,89110,-380,-670,18,160.40,248
,20170227,89400,89110,90640,91200,90240,91200,90690,2090,1580,16,145.12,256
,20170228,91200,90690,91220,91220,91220,91220,91220,530,530,2,18.24,256
,20170301,91220,91220,90920,91980,90390,91360,91110,140,-110,24,218.67,254
,20170302,91360,91110,92150,92150,92150,92150,92150,1040,1040,2,18.43,252
,20170303,92150,92150,90920,90920,89860,90640,90340,-1510,-1810,38,343.33,254
,20170306,90640,90340,91910,92270,91400,92030,91970,1690,1630,32,294.32,260
,20170307,92030,91970,91190,91880,91090,91180,91410,-790,-560,54,493.64,262
,20170308,91180,91410,90900,90900,85330,88930,89320,-2480,-2090,112,"1,000.47",266
,20170309,88930,89320,88440,88480,83750,84620,86180,-4700,-3140,64,551.60,258
,20170310,84620,86180,85120,85590,84440,84930,84780,-1250,-1400,24,203.49,262
,20170313,84930,84780,84700,84970,83390,84530,84220,-250,-560,82,690.68,250
,20170314,84530,84220,84590,85500,84150,84150,85010,-70,790,86,731.09,210
,20170315,84150,85010,84630,85610,84630,85380,85170,370,160,76,647.32,188
,20170316,85380,85170,85640,86100,85440,85850,85810,680,640,44,377.57,194
,20170317,85850,85810,85880,85950,84380,84850,85080,-960,-730,54,459.46,208
,20170320,84850,85080,85070,85720,84690,84990,85230,-90,150,56,477.32,194
,20170321,84990,85230,84370,85300,84300,84520,84850,-710,-380,30,254.57,188
,20170322,84520,84850,84420,84600,82800,83100,83220,-1750,-1630,72,599.25,188
,20170323,83100,83220,83170,83760,82740,83480,83240,260,20,36,299.68,174
,20170324,83480,83240,83460,84380,82920,82920,83400,-320,160,20,166.80,172
,20170327,82920,83400,83180,83180,79760,80880,81310,-2520,-2090,24,195.15,170
,20170328,80880,81310,81950,81950,81950,81950,81950,640,640,6,49.17,170
,20170329,81950,81950,82440,83000,82440,83000,82800,1050,850,10,82.80,172
,20170330,83000,82800,82650,82720,82650,82680,82690,-120,-110,10,82.69,176
,20170331,82680,82690,83450,84050,83120,83520,83390,830,700,198,"1,651.27",260
,20170405,83520,83390,84650,85190,84650,84890,85060,1500,1670,46,391.30,292
,20170406,84890,85060,85380,85480,82180,85100,84150,40,-910,82,690.09,276
,20170407,85100,84150,85380,85380,82880,82880,83930,-1270,-220,150,"1,258.97",210
,20170410,82880,83930,83160,84690,83160,83900,83890,-30,-40,36,302.02,194
,20170411,83900,83890,83890,84230,83780,84220,84060,330,170,22,184.93,186
,20170412,84220,84060,84410,84410,81150,81150,82380,-2910,-1680,100,823.88,218
,20170413,81150,82380,80970,81370,80970,80990,81110,-1390,-1270,22,178.45,228
,20170414,80990,81110,80890,81280,79600,79820,80580,-1290,-530,120,966.99,206
,20170417,79820,80580,80730,80730,78980,79690,79510,-890,-1070,126,"1,001.91",212
,20170418,79690,79510,80070,80330,79000,79000,79980,-510,470,260,"2,079.58",260
,20170419,79000,79980,79070,79070,77040,77450,77760,-2530,-2220,76,590.99,252
,20170420,77450,77760,78450,78490,76680,78480,78230,720,470,226,"1,768.11",340
,20170421,78480,78230,78490,78800,78090,78800,78450,570,220,78,611.94,348
,20170424,78800,78450,77460,77630,76770,77300,77330,-1150,-1120,12,92.80,344
,20170425,77300,77330,77300,77300,72250,76530,75350,-800,-1980,198,"1,492.08",358
,20170426,76530,75350,76740,77060,76230,76680,76760,1330,1410,48,368.48,346
,20170427,76680,76760,76620,76620,76200,76620,76330,-140,-430,38,290.09,362
,20170428,76620,76330,76110,77970,76110,77930,77640,1600,1310,80,621.16,392
,20170502,77930,77640,78360,78670,76830,78380,78310,740,670,52,407.24,372
,20170503,78380,78310,78500,78840,77940,77940,78540,-370,230,36,282.78,358
,20170504,77940,78540,76650,76690,74430,74920,75100,-3620,-3440,354,"2,658.72",354
,20170505,74920,75100,74760,74760,73560,73720,73960,-1380,-1140,78,576.91,312
,20170508,73720,73960,75100,75160,74290,74500,74590,540,630,26,193.95,310
,20170509,74500,74590,74570,75470,74550,75000,74820,410,230,140,"1,047.60",294
,20170510,75000,74820,75960,75960,75000,75190,75360,370,540,8,60.29,292
,20170511,75190,75360,75210,75730,74810,75600,75240,240,-120,32,240.77,286
,20170512,75600,75240,76190,76280,75300,75600,75690,360,450,30,227.08,276
,20170515,75600,75690,75300,76310,75300,75950,75800,260,110,40,303.23,262
,20170516,75950,75800,76020,76070,74880,75360,75420,-440,-380,28,211.20,264
,20170517,75360,75420,75270,75450,75270,75450,75380,30,-40,8,60.30,262
,20170518,75450,75380,75470,75470,74100,74260,74500,-1120,-880,8,59.60,262
,20170519,74260,74500,75000,75100,74500,74700,74730,200,230,16,119.57,256
,20170522,74700,74730,75380,76790,75380,76500,76230,1770,1500,50,381.19,244
,20170523,76500,76230,76500,76930,76500,76630,76600,400,370,98,750.71,204
,20170524,76630,76600,76200,76200,74800,75270,75150,-1330,-1450,34,255.53,184
,20170525,75270,75150,74750,75180,74750,75180,75010,30,-140,14,105.01,190
,20170526,75180,75010,74880,74880,73440,73440,74240,-1570,-770,46,341.50,180
,20170531,73440,74240,74250,74260,70850,72000,73040,-2240,-1200,62,452.90,180
,20170601,72000,73040,72680,72680,71500,72000,72070,-1040,-970,60,432.43,180
,20170602,72000,72070,,,,72070,72070,0,0,0,0.00,180
,20170605,72070,72070,,,,72070,72070,0,0,0,0.00,180
,20170606,72070,72070,70760,71500,70710,71500,71110,-570,-960,48,341.36,180
,20170607,71500,71110,,,,72200,72200,1090,1090,0,0.00,180
,20170608,72200,72200,,,,72200,72200,0,0,0,0.00,180
,20170609,72200,72200,,,,72200,72200,0,0,0,0.00,180
,20170612,72200,72200,,,,72800,72800,600,600,0,0.00,180
,20170613,72800,72800,,,,72800,72800,0,0,0,0.00,180
,20170614,72800,72800,71300,71300,71300,71300,71300,-1500,-1500,24,171.12,156
,20170615,71300,71300,,,,72200,72200,900,900,0,0.00,156
ni1707,20170103,86790,86790,,,,86790,86790,0,0,0,0.00,38
,20170104,86790,86790,,,,86130,86130,-660,-660,0,0.00,38
,20170105,86130,86130,,,,86130,86130,0,0,0,0.00,38
,20170106,86130,86130,,,,85920,85920,-210,-210,0,0.00,38
,20170109,85920,85920,,,,86050,86050,130,130,0,0.00,38
,20170110,86050,86050,,,,86050,86050,0,0,0,0.00,38
,20170111,86050,86050,,,,87350,87350,1300,1300,0,0.00,38
,20170112,87350,87350,87130,87130,86630,86630,86880,-720,-470,4,34.75,36
,20170113,86630,86880,87170,87170,86500,86500,86830,-380,-50,4,34.73,38
,20170116,86500,86830,86740,88140,86740,87630,87640,800,810,12,105.17,40
,20170117,87630,87640,87020,87020,86990,86990,86990,-650,-650,8,69.60,32
,20170118,86990,86990,85210,85210,85210,85210,85210,-1780,-1780,6,51.13,38
,20170119,85210,85210,85600,85600,85600,85600,85600,390,390,4,34.24,38
,20170120,85600,85600,84580,84580,83810,84030,83900,-1570,-1700,52,436.32,76
,20170123,84030,83900,84020,84020,84020,84020,84020,120,120,20,168.04,96
,20170124,84020,84020,83260,83770,83260,83640,83550,-380,-470,54,451.17,132
,20170125,83640,83550,82550,82550,82550,82550,82550,-1000,-1000,2,16.51,130
,20170126,82550,82550,,,,82810,82810,260,260,0,0.00,130
,20170203,82810,82810,,,,84510,84510,1700,1700,0,0.00,130
,20170206,84510,84510,86090,86090,86090,86090,86090,1580,1580,2,17.22,130
,20170207,86090,86090,,,,86090,86090,0,0,0,0.00,130
,20170208,86090,86090,,,,86540,86540,450,450,0,0.00,130
,20170209,86540,86540,86700,88430,86700,87680,87790,1140,1250,38,333.63,138
,20170210,87680,87790,,,,87790,87790,0,0,0,0.00,138
,20170213,87790,87790,,,,89180,89180,1390,1390,0,0.00,138
,20170214,89180,89180,,,,89900,89900,720,720,0,0.00,138
,20170215,89900,89900,89830,89830,89830,89830,89830,-70,-70,6,53.90,132
,20170216,89830,89830,92900,92900,91840,91840,92560,2010,2730,8,74.05,136
,20170217,91840,92560,,,,92510,92510,-50,-50,0,0.00,136
,20170220,92510,92510,,,,92510,92510,0,0,0,0.00,136
,20170221,92510,92510,92510,92510,92510,92510,92510,0,0,14,129.51,122
,20170222,92510,92510,91990,92420,90820,91240,91840,-1270,-670,240,"2,204.29",66
,20170223,91240,91840,90300,90300,90300,90300,90300,-1540,-1540,4,36.12,62
,20170224,90300,90300,,,,90300,90300,0,0,0,0.00,62
,20170227,90300,90300,92390,92390,92390,92390,92390,2090,2090,2,18.48,62
,20170228,92390,92390,91930,91930,91930,91930,91930,-460,-460,24,220.63,70
,20170301,91930,91930,90650,90650,90650,90650,90650,-1280,-1280,2,18.13,70
,20170302,90650,90650,,,,91460,91460,810,810,0,0.00,70
,20170303,91460,91460,,,,91460,91460,0,0,0,0.00,70
,20170306,91460,91460,,,,91460,91460,0,0,0,0.00,70
,20170307,91460,91460,91460,92510,91460,92000,91990,540,530,12,110.39,78
,20170308,92000,91990,,,,89720,89720,-2270,-2270,0,0.00,78
,20170309,89720,89720,85490,85490,85460,85460,85470,-4260,-4250,4,34.19,78
,20170310,85460,85470,,,,85470,85470,0,0,0,0.00,78
,20170313,85470,85470,,,,85470,85470,0,0,0,0.00,78
,20170314,85470,85470,85310,85310,85310,85310,85310,-160,-160,6,51.19,78
,20170315,85310,85310,85160,85160,85160,85160,85160,-150,-150,6,51.10,72
,20170316,85160,85160,86500,86500,86500,86500,86500,1340,1340,2,17.30,70
,20170317,86500,86500,,,,86140,86140,-360,-360,0,0.00,70
,20170320,86140,86140,85770,85770,85770,85770,85770,-370,-370,2,17.15,68
,20170321,85770,85770,,,,85770,85770,0,0,0,0.00,68
,20170322,85770,85770,83810,83820,83810,83820,83810,-1950,-1960,8,67.05,60
,20170323,83820,83810,83990,83990,83990,83990,83990,180,180,2,16.80,60
,20170324,83990,83990,,,,83990,83990,0,0,0,0.00,60
,20170327,83990,83990,83380,83380,83380,83380,83380,-610,-610,2,16.68,62
,20170328,83380,83380,82040,82400,81260,81260,81970,-2120,-1410,12,98.36,74
,20170329,81260,81970,81170,83600,81170,83600,82610,1630,640,14,115.66,84
,20170330,83600,82610,,,,82500,82500,-110,-110,0,0.00,84
,20170331,82500,82500,83580,84380,83480,83980,84000,1480,1500,22,184.80,90
,20170405,83980,84000,83610,83610,83610,83610,83610,-390,-390,2,16.72,90
,20170406,83610,83610,85560,85940,85330,85330,85610,1720,2000,6,51.37,90
,20170407,85330,85610,85360,85360,84060,84500,85080,-1110,-530,54,459.48,98
,20170410,84500,85080,83220,84550,83220,84550,84090,-530,-990,6,50.45,100
,20170411,84550,84090,84700,84700,84450,84450,84520,360,430,12,101.43,102
,20170412,84450,84520,81850,81850,81690,81690,81740,-2830,-2780,6,49.05,106
,20170413,81690,81740,81210,81210,81210,81210,81210,-530,-530,6,48.73,100
,20170414,81210,81210,80350,80830,80350,80830,80590,-380,-620,4,32.24,102
,20170417,80830,80590,,,,80590,80590,0,0,0,0.00,102
,20170418,80590,80590,80550,80550,80050,80100,80200,-490,-390,28,224.57,114
,20170419,80100,80200,79410,79410,77360,78150,78330,-2050,-1870,52,407.34,118
,20170420,78150,78330,78610,78610,77610,77610,78120,-720,-210,52,406.24,118
,20170421,77610,78120,78700,79040,78560,79040,78720,920,600,26,204.68,122
,20170424,79040,78720,78380,78380,78380,78380,78380,-340,-340,4,31.35,118
,20170425,78380,78380,77080,77380,77080,77300,77290,-1080,-1090,24,185.51,130
,20170426,77300,77290,77280,77280,77280,77280,77280,-10,-10,6,46.37,136
,20170427,77280,77280,76800,76800,76800,76800,76800,-480,-480,6,46.08,136
,20170428,76800,76800,78070,78760,77930,78170,78320,1370,1520,42,328.96,164
,20170502,78170,78320,79260,79260,78930,78930,79070,610,750,24,189.79,170
,20170503,78930,79070,78920,78920,78360,78360,78690,-710,-380,28,220.33,188
,20170504,78360,78690,76300,76300,74580,74580,75700,-4110,-2990,12,90.85,192
,20170505,74580,75700,74410,74410,73800,73800,74260,-1900,-1440,20,148.53,198
,20170508,73800,74260,75340,75340,74710,75130,74970,870,710,42,314.88,194
,20170509,75130,74970,75040,75660,75010,75550,75400,580,430,42,316.72,210
,20170510,75550,75400,75280,76260,75280,76260,76000,860,600,18,136.82,212
,20170511,76260,76000,75610,77070,74780,76070,76060,70,60,188,"1,430.07",264
,20170512,76070,76060,76500,76600,76050,76300,76420,240,360,68,519.69,270
,20170515,76300,76420,76050,76710,76050,76710,76360,290,-60,18,137.45,270
,20170516,76710,76360,76410,76920,75450,75450,76160,-910,-200,74,563.62,294
,20170517,75450,76160,75800,76110,75510,76110,75800,-50,-360,40,303.22,274
,20170518,76110,75800,74500,74530,74500,74530,74520,-1270,-1280,6,44.71,280
,20170519,74530,74520,74970,75450,74970,75150,75190,630,670,6,45.11,284
,20170522,75150,75190,77000,77420,77000,77100,77100,1910,1910,22,169.64,274
,20170523,77100,77100,77630,78190,76980,77280,77430,180,330,60,464.63,268
,20170524,77280,77430,76810,77300,75450,75450,76430,-1980,-1000,18,137.58,272
,20170525,75450,76430,75330,75330,75330,75330,75330,-1100,-1100,4,30.13,276
,20170526,75330,75330,75210,75210,74440,74700,74780,-630,-550,42,314.09,306
,20170531,74700,74780,74830,74830,72330,72400,73340,-2380,-1440,44,322.72,308
,20170601,72400,73340,72020,72950,71920,72740,72420,-600,-920,50,362.13,310
,20170602,72740,72420,72370,72450,71770,71770,72220,-650,-200,8,57.78,304
,20170605,71770,72220,72880,73060,72880,73060,72950,840,730,14,102.14,304
,20170606,73060,72950,72110,72390,72110,72350,72310,-600,-640,44,318.18,268
,20170607,72350,72310,72230,72810,72230,72560,72460,250,150,20,144.92,250
,20170608,72560,72460,72660,72660,71600,71600,72130,-860,-330,4,28.85,250
,20170609,71600,72130,71600,72330,71600,72330,72010,200,-120,22,158.42,248
,20170612,72330,72010,72330,73680,72330,73680,73190,1670,1180,12,87.83,246
,20170613,73680,73190,71800,71850,71800,71810,71820,-1380,-1370,6,43.09,242
,20170614,71810,71820,71830,71830,71830,71830,71830,10,10,4,28.73,242
,20170615,71830,71830,72650,72650,72650,72650,72650,820,820,16,116.24,226
,20170616,72650,72650,,,,72650,72650,0,0,0,0.00,226
,20170619,72650,72650,72500,72900,72000,72900,72660,250,10,20,145.32,228
,20170620,72900,72660,73640,73950,73640,73880,73780,1220,1120,24,177.08,228
,20170621,73880,73780,73780,73780,72880,73500,73390,-280,-390,8,58.71,230
,20170622,73500,73390,73700,74220,73350,73350,73480,-40,90,40,293.95,208
,20170623,73350,73480,74210,74210,73460,74000,73890,520,410,18,133.00,208
,20170626,74000,73890,74710,75450,73630,74040,74300,150,410,82,609.26,164
,20170627,74040,74300,73590,73590,73580,73580,73580,-720,-720,6,44.15,160
,20170628,73580,73580,73910,73910,73900,73900,73900,320,320,4,29.56,158
,20170629,73900,73900,74800,74800,73730,74500,74310,600,410,10,74.31,158
,20170630,74500,74310,74900,76930,74250,74250,75130,-60,820,62,465.85,132
,20170703,74250,75130,,,,76300,76300,1170,1170,0,0.00,132
,20170704,76300,76300,,,,76300,76300,0,0,0,0.00,132
,20170705,76300,76300,,,,76300,76300,0,0,0,0.00,132
,20170706,76300,76300,,,,76300,76300,0,0,0,0.00,132
,20170707,76300,76300,,,,75000,75000,-1300,-1300,0,0.00,132
,20170710,75000,75000,,,,75000,75000,0,0,0,0.00,132
,20170711,75000,75000,,,,75000,75000,0,0,0,0.00,132
,20170712,75000,75000,75000,75000,75000,75000,75000,0,0,12,90.00,132
,20170713,75000,75000,,,,75500,75500,500,500,0,0.00,132
,20170714,75500,75500,,,,75500,75500,0,0,0,0.00,132
,20170717,75500,75500,78000,78000,78000,78000,78000,2500,2500,12,93.60,144
ni1708,20170103,85980,85980,,,,85980,85980,0,0,0,0.00,100
,20170104,85980,85980,,,,85980,85980,0,0,0,0.00,100
,20170105,85980,85980,,,,85980,85980,0,0,0,0.00,100
,20170106,85980,85980,,,,85980,85980,0,0,0,0.00,100
,20170109,85980,85980,,,,85980,85980,0,0,0,0.00,100
,20170110,85980,85980,,,,85980,85980,0,0,0,0.00,100
,20170111,85980,85980,,,,85980,85980,0,0,0,0.00,100
,20170112,85980,85980,,,,85980,85980,0,0,0,0.00,100
,20170113,85980,85980,,,,85980,85980,0,0,0,0.00,100
,20170116,85980,85980,,,,85980,85980,0,0,0,0.00,100
,20170117,85980,85980,,,,85980,85980,0,0,0,0.00,100
,20170118,85980,85980,,,,85980,85980,0,0,0,0.00,100
,20170119,85980,85980,,,,85980,85980,0,0,0,0.00,100
,20170120,85980,85980,,,,84270,84270,-1710,-1710,0,0.00,100
,20170123,84270,84270,,,,84270,84270,0,0,0,0.00,100
,20170124,84270,84270,,,,84270,84270,0,0,0,0.00,100
,20170125,84270,84270,83670,83670,83670,83670,83670,-600,-600,2,16.73,102
,20170126,83670,83670,82990,82990,82990,82990,82990,-680,-680,2,16.60,100
,20170203,82990,82990,,,,82990,82990,0,0,0,0.00,100
,20170206,82990,82990,86230,87500,86210,87500,86420,4510,3430,14,120.99,110
,20170207,87500,86420,87220,87420,87210,87400,87350,980,930,26,227.13,110
,20170208,87400,87350,86630,87680,86630,87680,87390,330,40,20,174.79,106
,20170209,87680,87390,,,,87390,87390,0,0,0,0.00,106
,20170210,87390,87390,87340,87410,87160,87410,87260,20,-130,8,69.81,108
,20170213,87410,87260,90620,90620,90080,90080,90350,2820,3090,8,72.28,110
,20170214,90080,90350,91700,91700,90730,90730,91210,380,860,4,36.49,110
,20170215,90730,91210,91190,91190,91190,91190,91190,-20,-20,2,18.24,110
,20170216,91190,91190,,,,91190,91190,0,0,0,0.00,110
,20170217,91190,91190,92000,92000,92000,92000,92000,810,810,12,110.40,110
,20170220,92000,92000,,,,92000,92000,0,0,0,0.00,110
,20170221,92000,92000,92640,93260,92410,93000,92820,1000,820,52,482.69,108
,20170222,93000,92820,92020,92020,91430,91430,91720,-1390,-1100,16,146.76,102
,20170223,91430,91720,,,,90870,90870,-850,-850,0,0.00,102
,20170224,90870,90870,90240,90240,89760,89760,90080,-1110,-790,6,54.05,98
,20170227,89760,90080,,,,91700,91700,1620,1620,0,0.00,98
,20170228,91700,91700,92000,92000,92000,92000,92000,300,300,20,184.00,116
,20170301,92000,92000,91520,92050,91120,92050,91570,50,-430,26,238.10,124
,20170302,92050,91570,92850,92850,92540,92540,92630,970,1060,12,111.16,114
,20170303,92540,92630,,,,92630,92630,0,0,0,0.00,114
,20170306,92630,92630,,,,92630,92630,0,0,0,0.00,114
,20170307,92630,92630,92200,92200,92190,92200,92190,-430,-440,44,405.68,154
,20170308,92200,92190,91930,91930,88780,88780,89830,-3410,-2360,6,53.90,152
,20170309,88780,89830,86000,86000,85540,85540,85720,-4290,-4110,10,85.72,154
,20170310,85540,85720,85720,85720,85110,85110,85410,-610,-310,4,34.17,156
,20170313,85110,85410,86290,86300,84820,85260,85240,-150,-170,26,221.62,154
,20170314,85260,85240,,,,85240,85240,0,0,0,0.00,154
,20170315,85240,85240,,,,85240,85240,0,0,0,0.00,154
,20170316,85240,85240,86640,87080,86250,86790,86740,1550,1500,14,121.44,154
,20170317,86790,86740,,,,86590,86590,-150,-150,0,0.00,154
,20170320,86590,86590,85890,86270,85770,86270,86010,-320,-580,10,86.02,156
,20170321,86270,86010,86370,86370,85550,85600,85750,-410,-260,16,137.21,156
,20170322,85600,85750,84730,85790,83410,83900,84910,-1850,-840,344,"2,920.95",204
,20170323,83900,84910,84240,84710,84130,84350,84550,-560,-360,60,507.33,166
,20170324,84350,84550,84570,84570,83650,84200,84250,-350,-300,30,252.76,156
,20170327,84200,84250,83980,83980,80900,81560,82080,-2690,-2170,34,279.10,142
,20170328,81560,82080,81840,82820,81430,81430,82030,-650,-50,16,131.25,142
,20170329,81430,82030,83260,83960,83260,83650,83490,1620,1460,14,116.90,140
,20170330,83650,83490,,,,83490,83490,0,0,0,0.00,140
,20170331,83490,83490,84080,84980,84080,84270,84460,780,970,16,135.14,136
,20170405,84270,84460,85140,85740,85140,85740,85410,1280,950,14,119.59,138
,20170406,85740,85410,85950,86460,85950,86300,86110,890,700,50,430.58,156
,20170407,86300,86110,85100,85100,84050,84300,84810,-1810,-1300,20,169.62,148
,20170410,84300,84810,83810,84930,83660,84500,83940,-310,-870,30,251.83,144
,20170411,84500,83940,84750,84750,84700,84700,84720,760,780,10,84.72,134
,20170412,84700,84720,82800,82940,81800,81800,82070,-2920,-2650,22,180.56,136
,20170413,81800,82070,81600,81600,81360,81450,81460,-620,-610,8,65.17,130
,20170414,81450,81460,81820,81820,80300,80300,80720,-1160,-740,32,258.31,152
,20170417,80300,80720,80650,80650,80200,80200,80320,-520,-400,28,224.91,158
,20170418,80200,80320,80290,81080,79640,79640,80400,-680,80,36,289.45,146
,20170419,79640,80400,78270,78600,78060,78600,78430,-1800,-1970,16,125.50,140
,20170420,78600,78430,78820,78820,78820,78820,78820,390,390,4,31.53,136
,20170421,78820,78820,79450,79450,78950,79030,79030,210,210,28,221.29,146
,20170424,79030,79030,78490,78500,78000,78500,78160,-530,-870,38,297.04,164
,20170425,78500,78160,77580,77600,77250,77250,77500,-910,-660,16,124.00,152
,20170426,77250,77500,77520,77980,77520,77860,77730,360,230,24,186.56,150
,20170427,77860,77730,77540,77540,76920,77340,77200,-390,-530,48,370.60,162
,20170428,77340,77200,78500,79070,78500,78980,78780,1780,1580,14,110.30,158
,20170502,78980,78780,79050,79610,79050,79590,79460,810,680,10,79.46,152
,20170503,79590,79460,79360,79360,78910,78910,78990,-550,-470,18,142.19,134
,20170504,78910,78990,77510,77550,75100,75100,76390,-3890,-2600,82,626.44,200
,20170505,75100,76390,75340,75340,74500,74680,74720,-1710,-1670,18,134.51,206
,20170508,74680,74720,75010,76350,74830,75410,75460,690,740,44,332.03,210
,20170509,75410,75460,75980,76080,75620,75900,75870,440,410,38,288.32,214
,20170510,75900,75870,76620,76630,75800,75800,76370,-70,500,28,213.85,202
,20170511,75800,76370,75090,75090,75090,75090,75090,-1280,-1280,6,45.05,202
,20170512,75090,75090,76430,76710,76370,76400,76430,1310,1340,48,366.87,182
,20170515,76400,76430,76610,76980,76350,76980,76580,550,150,130,995.63,218
,20170516,76980,76580,76540,76540,76540,76540,76540,-40,-40,2,15.31,216
,20170517,76540,76540,76060,76580,76060,76580,76190,40,-350,36,274.30,206
,20170518,76580,76190,75580,75580,74980,75090,75240,-1100,-950,10,75.24,208
,20170519,75090,75240,74670,75950,74670,75950,75510,710,270,18,135.92,198
,20170522,75950,75510,75950,78170,75950,77610,77400,2100,1890,18,139.33,210
,20170523,77610,77400,77500,77500,77400,77400,77470,0,70,8,61.98,202
,20170524,77400,77470,77050,77500,75700,75870,77010,-1600,-460,58,446.66,210
,20170525,75870,77010,75900,75900,75400,75550,75580,-1460,-1430,30,226.76,208
,20170526,75550,75580,75180,75180,74710,74870,74970,-710,-610,30,224.93,208
,20170531,74870,74970,74570,74570,72300,72570,72940,-2400,-2030,36,262.59,206
,20170601,72570,72940,72570,72800,72400,72800,72530,-140,-410,36,261.12,200
,20170602,72800,72530,72410,72410,71200,71410,71930,-1120,-600,18,129.48,200
,20170605,71410,71930,72540,73200,72540,73200,72990,1270,1060,24,175.19,204
,20170606,73200,72990,72750,72750,72750,72750,72750,-240,-240,2,14.55,204
,20170607,72750,72750,72570,73550,72570,73390,73220,640,470,16,117.15,196
,20170608,73390,73220,72400,73480,72400,73200,72870,-20,-350,78,568.44,222
,20170609,73200,72870,72760,72870,72440,72540,72550,-330,-320,118,856.20,202
,20170612,72540,72550,72640,73700,72640,73700,73380,1150,830,60,440.31,196
,20170613,73700,73380,73350,73350,72300,72300,72820,-1080,-560,8,58.26,192
,20170614,72300,72820,72180,73010,72180,73010,72590,190,-230,4,29.04,190
,20170615,73010,72590,72680,72940,72680,72940,72820,350,230,12,87.39,180
,20170616,72940,72820,72960,73290,72920,73020,73130,200,310,26,190.15,186
,20170619,73020,73130,73600,74410,72530,73330,73240,200,110,24,175.79,184
,20170620,73330,73240,74270,74730,74220,74730,74330,1490,1090,30,223.01,192
,20170621,74730,74330,73670,73670,72700,73620,73320,-710,-1010,74,542.63,196
,20170622,73620,73320,74120,74120,73930,73930,73990,610,670,20,147.98,184
,20170623,73930,73990,74750,75490,74180,74590,74830,600,840,32,239.46,180
,20170626,74590,74830,75260,75370,74620,75200,75040,370,210,404,"3,031.81",188
,20170627,75200,75040,74630,74820,74600,74820,74690,-220,-350,28,209.16,186
,20170628,74820,74690,75220,75930,75080,75930,75370,1240,680,18,135.67,178
,20170629,75930,75370,,,,75610,75610,240,240,0,0.00,178
,20170630,75610,75610,75700,76080,75700,76080,75940,470,330,12,91.13,174
,20170703,76080,75940,77230,77230,76810,76810,77010,870,1070,6,46.21,174
,20170704,76810,77010,76600,76600,74940,74940,75860,-2070,-1150,8,60.69,174
,20170705,74940,75860,75000,75000,75000,75000,75000,-860,-860,2,15.00,174
,20170706,75000,75000,74880,74880,74760,74760,74800,-240,-200,6,44.88,172
,20170707,74760,74800,75110,75110,74100,74100,74540,-700,-260,30,223.64,178
,20170710,74100,74540,74000,74000,73850,73870,73900,-670,-640,16,118.25,178
,20170711,73870,73900,73470,74680,73300,74680,73500,780,-400,102,749.70,180
,20170712,74680,73500,74210,76170,74210,75800,75030,2300,1530,20,150.07,172
,20170713,75800,75030,75950,76130,75480,75990,75830,960,800,56,424.67,140
,20170714,75990,75830,76050,76050,75190,75800,75740,-30,-90,32,242.37,160
,20170717,75800,75740,77870,78240,77870,78240,78090,2500,2350,10,78.09,150
,20170718,78240,78090,78910,79900,78790,79480,79090,1390,1000,96,759.35,144
,20170719,79480,79090,79090,80200,79090,79330,79540,240,450,6,47.72,144
,20170720,79330,79540,78510,78510,78500,78500,78500,-1040,-1040,6,47.10,138
,20170721,78500,78500,,,,78500,78500,0,0,0,0.00,138
,20170724,78500,78500,77800,79440,77450,79440,78220,940,-280,32,250.31,142
,20170725,79440,78220,78900,78900,78900,78900,78900,680,680,2,15.78,140
,20170726,78900,78900,79790,81300,79790,80800,80810,1900,1910,36,290.93,124
,20170727,80800,80810,,,,80810,80810,0,0,0,0.00,124
,20170728,80810,80810,83380,83380,79620,80600,80700,-210,-110,44,355.09,110
,20170731,80600,80700,82850,84300,80940,83000,82750,2300,2050,70,579.28,108
,20170801,83000,82750,,,,82750,82750,0,0,0,0.00,108
,20170802,82750,82750,,,,82750,82750,0,0,0,0.00,108
,20170803,82750,82750,,,,82750,82750,0,0,0,0.00,108
,20170804,82750,82750,,,,83100,83100,350,350,0,0.00,108
,20170807,83100,83100,,,,83100,83100,0,0,0,0.00,108
,20170808,83100,83100,,,,83100,83100,0,0,0,0.00,108
,20170809,83100,83100,,,,85600,85600,2500,2500,0,0.00,108
,20170810,85600,85600,,,,86000,86000,400,400,0,0.00,108
,20170811,86000,86000,,,,86000,86000,0,0,0,0.00,108
,20170814,86000,86000,,,,86000,86000,0,0,0,0.00,108
,20170815,86000,86000,,,,86000,86000,0,0,0,0.00,108
ni1709,20170103,86920,87120,87490,88420,86880,87420,87780,300,660,3660,"32,127.65",29078
,20170104,87420,87780,87540,87870,84880,86600,86090,-1180,-1690,8016,"69,010.49",28720
,20170105,86600,86090,86400,87560,86100,86660,86870,570,780,6518,"56,628.06",29106
,20170106,86660,86870,86660,87270,86000,86230,86670,-640,-200,4222,"36,593.60",29002
,20170109,86230,86670,86340,88080,86340,87850,87370,1180,700,2974,"25,985.76",29204
,20170110,87850,87370,86980,89250,86980,88620,88300,1250,930,4538,"40,072.30",29680
,20170111,88620,88300,88710,89790,88710,89190,89220,890,920,3738,"33,351.24",29452
,20170112,89190,89220,88940,89610,86760,87190,87720,-2030,-1500,8662,"75,986.31",30780
,20170113,87190,87720,85490,87870,85070,86990,86780,-730,-940,11890,"103,186.44",32976
,20170116,86990,86780,86720,89060,86600,87970,88020,1190,1240,15822,"139,266.47",36614
,20170117,87970,88020,88000,88610,85520,86590,87180,-1430,-840,13528,"117,939.93",36834
,20170118,86590,87180,86980,87500,85900,86410,86680,-770,-500,14100,"122,229.79",39930
,20170119,86410,86680,86570,86860,86000,86400,86490,-280,-190,7314,"63,265.66",40386
,20170120,86400,86490,86150,86300,83250,83290,84720,-3200,-1770,15660,"132,678.76",43054
,20170123,83290,84720,83450,84800,83310,84120,84130,-600,-590,12966,"109,091.78",46892
,20170124,84120,84130,83970,84380,83340,83970,83980,-160,-150,11272,"94,666.43",48558
,20170125,83970,83980,84020,84250,82900,83060,83550,-920,-430,8354,"69,805.42",50100
,20170126,83060,83550,82870,84640,82660,83960,83840,410,290,15138,"126,920.52",55018
,20170203,83960,83840,87010,87900,85050,86160,86150,2320,2310,19998,"172,299.68",60152
,20170206,86160,86150,86470,88050,86350,87790,87450,1640,1300,27810,"243,225.97",68786
,20170207,87790,87450,87950,88320,87300,87760,87840,310,390,12582,"110,521.62",70982
,20170208,87760,87840,87910,88730,87420,88460,88170,620,330,16488,"145,377.96",76250
,20170209,88460,88170,88820,88970,88100,88240,88630,70,460,14042,"124,467.32",78218
,20170210,88240,88630,88560,88600,87450,88380,88130,-250,-500,22168,"195,386.61",83006
,20170213,88380,88130,88550,91200,88550,90840,90270,2710,2140,35372,"319,325.14",90266
,20170214,90840,90270,91140,91870,90360,91840,91190,1570,920,29944,"273,082.67",95834
,20170215,91840,91190,92030,92470,90150,91410,91320,220,130,35944,"328,259.85",98380
,20170216,91410,91320,91400,93710,90510,92110,92280,790,960,37032,"341,745.91",101688
,20170217,92110,92280,92120,93400,91300,92300,92430,20,150,34830,"321,941.17",104428
,20170220,92300,92430,92470,93500,91700,93260,92710,830,280,31012,"287,542.95",104940
,20170221,93260,92710,93330,94110,92810,93150,93440,440,730,27826,"260,019.31",106370
,20170222,93150,93440,93180,93430,90790,91390,91890,-2050,-1550,40572,"372,846.95",114476
,20170223,91390,91890,91270,92180,89810,90280,90930,-1610,-960,46524,"423,052.29",120568
,20170224,90280,90930,90610,90990,89110,90900,90230,-30,-700,72342,"652,765.71",144346
,20170227,90900,90230,90730,93240,90300,92520,91900,2290,1670,70762,"650,306.71",161372
,20170228,92520,91900,92630,93200,92100,92400,92620,500,720,55724,"516,117.17",166788
,20170301,92400,92620,92600,93120,90900,92850,92220,230,-400,68294,"629,873.64",174746
,20170302,92850,92220,92920,93550,92380,92840,93060,620,840,56176,"522,797.41",179840
,20170303,92840,93060,92650,92660,91180,92490,92000,-570,-1060,63532,"584,512.18",183908
,20170306,92490,92000,92490,93500,92050,92750,92800,750,800,62554,"580,511.24",186826
,20170307,92750,92800,92790,93280,92230,92810,92810,10,10,43658,"405,193.02",188696
,20170308,92810,92810,92670,92740,89310,89790,90640,-3020,-2170,100826,"913,944.63",189458
,20170309,89790,90640,89730,89900,84800,85760,86980,-4880,-3660,144624,"1,258,055.11",193804
,20170310,85760,86980,85630,86770,85300,85360,86090,-1620,-890,80650,"694,331.31",197008
,20170313,85360,86090,85510,86460,83750,85810,85180,-280,-910,134862,"1,148,797.58",204614
,20170314,85810,85180,85820,87100,85230,85690,86280,510,1100,96240,"830,373.75",208546
,20170315,85690,86280,85900,87290,85110,86760,86390,480,110,104300,"901,111.89",223370
,20170316,86760,86390,86810,87700,86600,87240,87140,850,750,101920,"888,198.65",236510
,20170317,87240,87140,87220,87240,85850,86160,86520,-980,-620,102968,"890,940.78",246900
,20170320,86160,86520,86430,87200,86020,86190,86620,-330,100,101504,"879,283.39",249962
,20170321,86190,86620,86190,86850,85430,86000,86130,-620,-490,106852,"920,358.82",254474
,20170322,86000,86130,85900,86700,84000,84020,85190,-2110,-940,142762,"1,216,257.20",266140
,20170323,84020,85190,84130,85400,83600,84670,84550,-520,-640,116202,"982,523.32",273500
,20170324,84670,84550,84400,84910,83680,84160,84370,-390,-180,101416,"855,711.26",280006
,20170327,84160,84370,84010,84570,81110,81890,82830,-2480,-1540,194396,"1,610,305.53",279860
,20170328,81890,82830,82100,83350,81580,82600,82580,-230,-250,145902,"1,204,988.10",286282
,20170329,82600,82580,82600,84500,82310,84250,83660,1670,1080,163564,"1,368,410.94",311096
,20170330,84250,83660,84050,85060,83660,84050,84270,390,610,166922,"1,406,721.12",328622
,20170331,84050,84270,84250,85370,84060,84860,84760,590,490,209452,"1,775,378.17",346334
,20170405,84860,84760,84600,86470,84500,86000,85700,1240,940,163730,"1,403,213.07",375432
,20170406,86000,85700,86250,86800,85900,86440,86390,740,690,284120,"2,454,688.60",405962
,20170407,86440,86390,86750,86980,83370,83970,84990,-2420,-1400,531658,"4,518,777.04",408378
,20170410,83970,84990,84000,86000,83460,85050,85040,60,50,414178,"3,522,514.04",409842
,20170411,85050,85040,85300,85580,84260,85230,85010,190,-30,453556,"3,855,992.44",408738
,20170412,85230,85010,85130,85600,81300,81620,83040,-3390,-1970,705532,"5,858,855.79",436898
,20170413,81620,83040,81600,82590,80930,81930,81950,-1110,-1090,447192,"3,664,949.78",441640
,20170414,81930,81950,81710,82360,80510,80680,81430,-1270,-520,440766,"3,589,383.68",470056
,20170417,80680,81430,80700,81900,80260,80690,81080,-740,-350,444438,"3,603,639.25",478168
,20170418,80690,81080,80800,81490,80010,80240,80850,-840,-230,387188,"3,130,551.64",491098
,20170419,80240,80850,80180,80230,77990,79200,78880,-1650,-1970,559702,"4,415,380.53",490114
,20170420,79200,78880,79350,79990,78050,79680,78990,800,110,488442,"3,858,231.40",483408
,20170421,79680,78990,79350,80390,79160,79540,79700,550,710,452068,"3,603,021.13",502128
,20170424,79540,79700,79700,79700,78130,78790,78810,-910,-890,436284,"3,438,407.40",522788
,20170425,78790,78810,78570,78970,77500,77800,78110,-1010,-700,481430,"3,760,738.12",555880
,20170426,77800,78110,77860,78490,77600,77990,78110,-120,0,364990,"2,851,252.29",554322
,20170427,77990,78110,78050,78500,77360,77920,77940,-190,-170,409656,"3,192,971.53",578378
,20170428,77920,77940,77800,79680,77400,79300,78580,1360,640,503414,"3,956,257.26",578682
,20170502,79300,78580,79600,80470,79420,80030,80070,1450,1490,206474,"1,653,406.43",577706
,20170503,80030,80070,80010,80320,79130,79380,79760,-690,-310,284020,"2,265,400.78",589762
,20170504,79380,79760,78800,78800,75500,76270,77380,-3490,-2380,595228,"4,606,384.53",590332
,20170505,76270,77380,76020,76270,74720,74820,75440,-2560,-1940,457438,"3,450,965.89",595164
,20170508,74820,75440,75090,76880,75080,75730,75960,290,520,515838,"3,918,702.54",575992
,20170509,75730,75960,76090,76680,75800,76490,76300,530,340,306394,"2,337,835.81",569112
,20170510,76490,76300,76800,77450,76020,76400,76860,100,560,386648,"2,971,808.12",561256
,20170511,76400,76860,76800,77250,75410,77130,76270,270,-590,467742,"3,567,539.85",555338
,20170512,77130,76270,77580,77700,76560,76990,77010,720,740,356894,"2,748,774.12",545076
,20170515,76990,77010,77460,77770,76630,77340,77190,330,180,390452,"3,014,039.82",547126
,20170516,77340,77190,77470,77750,75830,76600,76760,-590,-430,466560,"3,581,677.25",562082
,20170517,76600,76760,76210,77280,76210,76870,76700,110,-60,422786,"3,242,901.72",562424
,20170518,76870,76700,76750,77190,74710,75510,76070,-1190,-630,377374,"2,870,847.02",569318
,20170519,75510,76070,75230,76600,75180,76020,76040,-50,-30,403380,"3,067,344.71",561034
,20170522,76020,76040,76550,78500,76390,77850,77850,1810,1810,593256,"4,619,043.16",551926
,20170523,77850,77850,78150,78580,77500,77630,78080,-220,230,360972,"2,818,661.65",550136
,20170524,77630,78080,77750,77960,75800,76270,77050,-1810,-1030,409382,"3,154,440.11",558144
,20170525,76270,77050,76340,76540,75560,75920,76040,-1130,-1010,361662,"2,750,139.65",556452
,20170526,75920,76040,75790,76200,74990,75200,75520,-840,-520,406772,"3,072,195.33",556952
,20170531,75200,75520,75200,75980,72760,72950,74050,-2570,-1470,348308,"2,579,410.24",561388
,20170601,72950,74050,72930,73850,72620,73160,73220,-890,-830,310184,"2,271,351.18",548410
,20170602,73160,73220,73170,73460,71980,72080,72630,-1140,-590,365946,"2,658,075.51",559806
,20170605,72080,72630,72020,73660,71940,73110,73000,480,370,367468,"2,682,525.40",536734
,20170606,73110,73000,73010,73450,72700,72980,73110,-20,110,255328,"1,866,756.03",534422
,20170607,72980,73110,72900,74100,72760,73480,73490,370,380,374820,"2,754,732.26",527134
,20170608,73480,73490,73480,73770,72080,73200,72860,-290,-630,436998,"3,184,181.25",530542
,20170609,73200,72860,73010,73340,72610,72900,72940,40,80,276698,"2,018,439.38",542244
,20170612,72900,72940,73200,74380,73080,73880,73880,940,940,381494,"2,818,633.12",529994
,20170613,73880,73880,73880,73890,72230,72540,72830,-1340,-1050,360684,"2,626,941.66",554638
,20170614,72540,72830,72430,73380,71520,73190,72590,360,-240,397314,"2,884,476.65",543000
,20170615,73190,72590,73090,73690,72500,73300,73170,710,580,356100,"2,605,777.95",528834
,20170616,73300,73170,73250,74100,72850,73600,73500,430,330,321092,"2,360,085.83",518076
,20170619,73600,73500,73790,74200,72770,73900,73620,400,120,332320,"2,446,572.01",512002
,20170620,73900,73620,74050,75300,73880,74740,74750,1120,1130,457316,"3,418,469.55",511608
,20170621,74740,74750,74360,74560,73130,74120,73740,-630,-1010,368790,"2,719,617.26",517316
,20170622,74120,73740,74250,74680,73620,73840,74290,100,550,316972,"2,354,786.66",513356
,20170623,73840,74290,74150,75690,73990,75570,74910,1280,620,452686,"3,391,174.53",534972
,20170626,75570,74910,75600,75630,74910,75340,75270,430,360,277286,"2,087,226.32",517078
,20170627,75340,75270,75350,75480,74450,75270,74940,0,-330,314670,"2,358,321.94",510660
,20170628,75270,74940,75270,76220,75210,75890,75800,950,860,350184,"2,654,497.81",498600
,20170629,75890,75800,75710,76950,75460,76790,76330,990,530,392876,"2,998,869.11",510358
,20170630,76790,76330,76700,77000,75810,76650,76470,320,140,305508,"2,336,323.63",502622
,20170703,76650,76470,76570,77670,76330,77240,77010,770,540,333600,"2,569,117.78",498830
,20170704,77240,77010,77330,77400,74900,75200,76150,-1810,-860,418318,"3,185,762.98",482308
,20170705,75200,76150,75120,75850,74980,75250,75420,-900,-730,251716,"1,898,552.72",473228
,20170706,75250,75420,74930,75400,74520,75210,74950,-210,-470,260996,"1,956,425.77",471974
,20170707,75210,74950,75080,75370,74020,74650,74680,-300,-270,294290,"2,198,050.42",481046
,20170710,74650,74680,74300,74530,73330,73550,73920,-1130,-760,351594,"2,599,010.12",494450
,20170711,73550,73920,73380,74550,73010,74390,73900,470,-20,314240,"2,322,336.57",482330
,20170712,74390,73900,74270,76080,74200,75800,75360,1900,1460,421320,"3,175,296.04",469406
,20170713,75800,75360,75800,76420,75450,76220,76030,860,670,326082,"2,479,374.54",477912
,20170714,76220,76030,76110,76850,75300,76640,76020,610,-10,405906,"3,086,064.68",493560
,20170717,76640,76020,77020,79520,76930,79150,78420,3130,2400,606574,"4,757,326.45",509946
,20170718,79150,78420,79220,79990,78500,78970,79350,550,930,442626,"3,512,372.05",492454
,20170719,78970,79350,79150,80120,79020,79780,79630,430,280,413118,"3,289,891.03",483370
,20170720,79780,79630,80050,80110,78540,78900,79240,-730,-390,397550,"3,150,256.64",459674
,20170721,78900,79240,78930,79090,77500,78630,78240,-610,-1000,404482,"3,164,877.05",439770
,20170724,78630,78240,78950,79490,77550,78950,78640,710,400,430372,"3,384,728.90",437622
,20170725,78950,78640,78940,81260,78920,81120,80050,2480,1410,554328,"4,437,764.46",459916
,20170726,81120,80050,81300,82500,80550,80920,81500,870,1450,582920,"4,750,884.91",409040
,20170727,80920,81500,81300,81970,80720,81800,81490,300,-10,411584,"3,354,000.42",388900
,20170728,81800,81490,82050,82850,81100,82380,82210,890,720,508494,"4,180,637.90",365492
,20170731,82380,82210,82850,83890,82280,83000,83100,790,890,434380,"3,609,736.27",334618
,20170801,83000,83100,82800,83300,81530,81970,82380,-1130,-720,376464,"3,101,578.90",312194
,20170802,81970,82380,82340,83070,81710,82120,82400,-260,20,334746,"2,758,488.62",296054
,20170803,82120,82400,82350,84330,82230,82670,83290,270,890,386702,"3,221,015.89",276392
,20170804,82670,83290,83050,83850,82730,83610,83310,320,20,263552,"2,195,741.72",263610
,20170807,83610,83310,83550,84100,82090,83320,83030,10,-280,354970,"2,947,330.45",233168
,20170808,83320,83030,83390,83880,82500,82730,83310,-300,280,166250,"1,385,055.08",210602
,20170809,82730,83310,82880,86980,82660,86480,85230,3170,1920,206372,"1,759,009.91",175332
,20170810,86480,85230,86450,86760,85800,86370,86340,1140,1110,64242,"554,727.67",165388
,20170811,86370,86340,86360,89990,84700,85200,86320,-1140,-20,103098,"889,947.73",148432
,20170814,85200,86320,85210,85860,84360,84720,85200,-1600,-1120,52022,"443,267.46",136986
,20170815,84720,85200,84690,84690,82930,84020,83760,-1180,-1440,43606,"365,284.07",129086
,20170816,84020,83760,83780,84350,83120,83960,83720,200,-40,33590,"281,232.29",121676
,20170817,83960,83720,84580,86960,84580,86480,86100,2760,2380,44620,"384,220.96",114568
,20170818,86480,86100,86090,86840,85120,86680,86240,580,140,36712,"316,628.66",105342
,20170821,86680,86240,87100,90080,86550,89580,88480,3340,2240,52394,"463,619.04",99882
,20170822,89580,88480,89790,91150,89580,91070,90260,2590,1780,36486,"329,331.26",93492
,20170823,91070,90260,91990,91990,89600,91060,90840,800,580,28668,"260,430.03",89684
,20170824,91060,90840,91700,93630,90960,92770,92690,1930,1850,27728,"257,035.07",87632
,20170825,92770,92690,92770,93650,92320,93140,92960,450,270,15844,"147,291.17",85918
,20170828,93140,92960,93140,93140,90530,92260,91650,-700,-1310,14948,"136,999.36",83288
,20170829,92260,91650,91510,94160,91510,92860,93070,1210,1420,20054,"186,661.22",79020
,20170830,92860,93070,93590,93850,91580,92330,92510,-740,-560,9976,"92,295.03",75056
,20170831,92330,92510,92000,92580,91380,92440,92050,-70,-460,15220,"140,105.14",69916
,20170901,92440,92050,92290,93860,92100,93390,93270,1340,1220,7876,"73,461.64",65148
,20170904,93390,93270,93810,95900,93200,95050,95070,1780,1800,8136,"77,350.66",64740
,20170905,95050,95070,95070,95630,94800,95510,95200,440,130,5844,"55,636.40",61812
,20170906,95510,95200,95200,95250,93200,93730,94180,-1470,-1020,3972,"37,408.37",59760
,20170907,93730,94180,94130,95680,93610,94330,94590,150,410,3060,"28,945.26",58428
,20170908,94330,94590,94200,95550,91410,91810,92870,-2780,-1720,5844,"54,276.83",57588
,20170911,91810,92870,90650,90750,88670,90180,89580,-2690,-3290,6612,"59,231.27",53304
,20170912,90180,89580,91230,91320,90500,91000,90860,1420,1280,1716,"15,592.58",51840
,20170913,91000,90860,90730,92600,90340,91100,91890,240,1030,5844,"53,703.42",49284
,20170914,91100,91890,89210,91270,88050,88050,89800,-3840,-2090,4524,"40,627.82",47124
,20170915,88050,89800,88300,88620,86000,86950,87590,-2850,-2210,2568,"22,494.43",46920
ni1710,20170103,86430,86430,,,,86470,86470,40,40,0,0.00,74
,20170104,86470,86470,,,,86470,86470,0,0,0,0.00,74
,20170105,86470,86470,,,,86470,86470,0,0,0,0.00,74
,20170106,86470,86470,,,,86470,86470,0,0,0,0.00,74
,20170109,86470,86470,,,,86470,86470,0,0,0,0.00,74
,20170110,86470,86470,89210,89210,89210,89210,89210,2740,2740,6,53.53,68
,20170111,89210,89210,90010,90220,89280,89280,89770,70,560,68,610.44,104
,20170112,89280,89770,89450,89450,88290,88290,89040,-1480,-730,38,338.37,74
,20170113,88290,89040,,,,89040,89040,0,0,0,0.00,74
,20170116,89040,89040,,,,89040,89040,0,0,0,0.00,74
,20170117,89040,89040,,,,89040,89040,0,0,0,0.00,74
,20170118,89040,89040,87450,87450,87450,87450,87450,-1590,-1590,4,34.98,74
,20170119,87450,87450,,,,87450,87450,0,0,0,0.00,74
,20170120,87450,87450,,,,85660,85660,-1790,-1790,0,0.00,74
,20170123,85660,85660,,,,85660,85660,0,0,0,0.00,74
,20170124,85660,85660,,,,85660,85660,0,0,0,0.00,74
,20170125,85660,85660,,,,84640,84640,-1020,-1020,0,0.00,74
,20170126,84640,84640,,,,84640,84640,0,0,0,0.00,74
,20170203,84640,84640,86390,86390,86390,86390,86390,1750,1750,2,17.28,74
,20170206,86390,86390,,,,86970,86970,580,580,0,0.00,74
,20170207,86970,86970,88250,88250,88190,88190,88220,1220,1250,4,35.29,74
,20170208,88190,88220,88220,88410,88220,88410,88310,190,90,8,70.65,66
,20170209,88410,88310,88740,88970,88740,88970,88850,660,540,4,35.54,66
,20170210,88970,88850,,,,88850,88850,0,0,0,0.00,66
,20170213,88850,88850,,,,90060,90060,1210,1210,0,0.00,66
,20170214,90060,90060,,,,90880,90880,820,820,0,0.00,66
,20170215,90880,90880,91990,91990,91990,91990,91990,1110,1110,2,18.40,68
,20170216,91990,91990,92150,92960,92150,92960,92550,970,560,4,37.02,66
,20170217,92960,92550,92650,93210,92590,93210,92850,660,300,14,130.00,66
,20170220,93210,92850,,,,92850,92850,0,0,0,0.00,66
,20170221,92850,92850,93330,94060,93330,94060,93690,1210,840,4,37.48,62
,20170222,94060,93690,,,,92630,92630,-1060,-1060,0,0.00,62
,20170223,92630,92630,92080,92080,92080,92080,92080,-550,-550,2,18.42,64
,20170224,92080,92080,90850,90950,90850,90950,90880,-1130,-1200,6,54.53,64
,20170227,90950,90880,91160,92830,91160,92830,92490,1950,1610,10,92.50,68
,20170228,92830,92490,93130,93130,93070,93120,93110,630,620,10,93.11,70
,20170301,93120,93110,,,,93110,93110,0,0,0,0.00,70
,20170302,93110,93110,93720,93720,93240,93240,93480,130,370,4,37.39,70
,20170303,93240,93480,,,,93480,93480,0,0,0,0.00,70
,20170306,93480,93480,93360,93360,93320,93320,93340,-160,-140,4,37.34,72
,20170307,93320,93340,93420,93420,92840,92840,93130,-500,-210,4,37.25,72
,20170308,92840,93130,,,,91340,91340,-1790,-1790,0,0.00,72
,20170309,91340,91340,90000,90000,89090,89090,89440,-2250,-1900,8,71.56,72
,20170310,89090,89440,,,,88520,88520,-920,-920,0,0.00,72
,20170313,88520,88520,,,,87130,87130,-1390,-1390,0,0.00,72
,20170314,87130,87130,86430,87100,85750,86050,86360,-1080,-770,72,621.84,62
,20170315,86050,86360,,,,86360,86360,0,0,0,0.00,62
,20170316,86360,86360,88220,88230,87260,87510,87660,1150,1300,32,280.53,68
,20170317,87510,87660,,,,87660,87660,0,0,0,0.00,68
,20170320,87660,87660,,,,87660,87660,0,0,0,0.00,68
,20170321,87660,87660,87000,87000,87000,87000,87000,-660,-660,6,52.20,68
,20170322,87000,87000,86470,86470,86470,86470,86470,-530,-530,8,69.18,70
,20170323,86470,86470,,,,85820,85820,-650,-650,0,0.00,70
,20170324,85820,85820,85510,85510,84330,84350,84630,-1470,-1190,10,84.63,76
,20170327,84350,84630,,,,83370,83370,-1260,-1260,0,0.00,76
,20170328,83370,83370,,,,83370,83370,0,0,0,0.00,76
,20170329,83370,83370,,,,83370,83370,0,0,0,0.00,76
,20170330,83370,83370,,,,83370,83370,0,0,0,0.00,76
,20170331,83370,83370,85820,85820,85820,85820,85820,2450,2450,2,17.16,76
,20170405,85820,85820,,,,85820,85820,0,0,0,0.00,76
,20170406,85820,85820,86370,87160,86370,86830,86790,1010,970,60,520.76,86
,20170407,86830,86790,85750,86190,84770,84790,85800,-2000,-990,38,326.07,90
,20170410,84790,85800,84910,84910,84060,84060,84480,-1740,-1320,4,33.79,90
,20170411,84060,84480,,,,84480,84480,0,0,0,0.00,90
,20170412,84480,84480,82970,83600,82150,82150,82400,-2330,-2080,208,"1,713.94",92
,20170413,82150,82400,82720,83080,82540,83080,82730,680,330,20,165.47,98
,20170414,83080,82730,82560,82560,81350,81350,81950,-1380,-780,4,32.78,98
,20170417,81350,81950,82180,82180,80620,80620,81370,-1330,-580,14,113.93,102
,20170418,80620,81370,81440,81690,81440,81680,81600,310,230,6,48.96,100
,20170419,81680,81600,79980,79980,79200,79420,79550,-2180,-2050,52,413.71,112
,20170420,79420,79550,79910,80420,79000,80270,79590,720,40,26,206.94,104
,20170421,80270,79590,79970,80430,79970,80110,80200,520,610,8,64.16,100
,20170424,80110,80200,79310,79750,79310,79320,79530,-880,-670,8,63.63,98
,20170425,79320,79530,78680,78840,78680,78840,78830,-690,-700,52,409.94,144
,20170426,78840,78830,,,,78830,78830,0,0,0,0.00,144
,20170427,78830,78830,78790,79100,78790,79100,78910,270,80,10,78.91,142
,20170428,79100,78910,82050,82050,79710,79800,79970,890,1060,24,191.94,148
,20170502,79800,79970,80570,80840,80570,80780,80730,810,760,6,48.44,146
,20170503,80780,80730,80380,80620,79760,79850,80160,-880,-570,22,176.36,146
,20170504,79850,80160,79220,79220,78300,78300,78650,-1860,-1510,50,393.30,160
,20170505,78300,78650,75460,75680,75110,75380,75500,-3270,-3150,18,135.91,162
,20170508,75380,75500,76950,77300,76160,76460,76920,960,1420,66,507.71,170
,20170509,76460,76920,,,,76920,76920,0,0,0,0.00,170
,20170510,76920,76920,,,,76920,76920,0,0,0,0.00,170
,20170511,76920,76920,,,,76920,76920,0,0,0,0.00,170
,20170512,76920,76920,76990,76990,76990,76990,76990,70,70,2,15.40,172
,20170515,76990,76990,77830,77830,77250,77350,77450,360,460,36,278.82,174
,20170516,77350,77450,77820,77820,76390,76760,77310,-690,-140,46,355.63,214
,20170517,76760,77310,77100,77430,76970,77430,77290,120,-20,64,494.69,182
,20170518,77430,77290,,,,77170,77170,-120,-120,0,0.00,182
,20170519,77170,77170,75400,76940,75400,76340,75970,-830,-1200,16,121.55,180
,20170522,76340,75970,77370,77660,77290,77290,77440,1320,1470,6,46.46,178
,20170523,77290,77440,78670,78670,78670,78670,78670,1230,1230,2,15.73,178
,20170524,78670,78670,,,,78670,78670,0,0,0,0.00,178
,20170525,78670,78670,76690,76690,76280,76290,76430,-2380,-2240,8,61.14,180
,20170526,76290,76430,,,,76430,76430,0,0,0,0.00,180
,20170531,76430,76430,76410,76410,73340,73930,74100,-2500,-2330,16,118.57,194
,20170601,73930,74100,73630,73630,73630,73630,73630,-470,-470,8,58.90,190
,20170602,73630,73630,,,,73630,73630,0,0,0,0.00,190
,20170605,73630,73630,73880,74000,73800,74000,73840,370,210,14,103.38,202
,20170606,74000,73840,,,,73840,73840,0,0,0,0.00,202
,20170607,73840,73840,,,,73840,73840,0,0,0,0.00,202
,20170608,73840,73840,,,,73840,73840,0,0,0,0.00,202
,20170609,73840,73840,73270,73610,72970,72970,73330,-870,-510,42,308.00,200
,20170612,72970,73330,74500,74610,73970,74200,74290,870,960,48,356.59,200
,20170613,74200,74290,,,,73930,73930,-360,-360,0,0.00,200
,20170614,73930,73930,72470,72470,72470,72470,72470,-1460,-1460,4,28.99,204
,20170615,72470,72470,,,,72640,72640,170,170,0,0.00,204
,20170616,72640,72640,73980,75050,73870,73870,74160,1230,1520,68,504.35,246
,20170619,73870,74160,74360,74360,73540,74300,74110,140,-50,16,118.59,256
,20170620,74300,74110,74710,75400,74710,75380,75290,1270,1180,14,105.41,264
,20170621,75380,75290,73880,74180,73880,73960,74000,-1330,-1290,6,44.40,268
,20170622,73960,74000,74890,75260,74190,74190,74760,190,760,110,822.46,308
,20170623,74190,74760,75240,76050,74790,75850,75270,1090,510,58,436.59,304
,20170626,75850,75270,75600,75830,75330,75750,75650,480,380,76,574.96,322
,20170627,75750,75650,75470,75710,75470,75710,75680,60,30,22,166.51,344
,20170628,75710,75680,75810,75880,75810,75880,75840,200,160,4,30.34,344
,20170629,75880,75840,76010,77250,76010,77250,76550,1410,710,78,597.16,356
,20170630,77250,76550,77170,77310,76610,76780,76870,230,320,78,599.64,354
,20170703,76780,76870,76990,78080,76990,77530,77460,660,590,120,929.63,368
,20170704,77530,77460,82100,82100,75240,75670,77000,-1790,-460,76,585.21,354
,20170705,75670,77000,75950,75950,75950,75950,75950,-1050,-1050,6,45.57,348
,20170706,75950,75950,75140,75750,75080,75750,75580,-200,-370,106,801.23,406
,20170707,75750,75580,,,,75580,75580,0,0,0,0.00,406
,20170710,75580,75580,74690,74690,73580,73580,74430,-2000,-1150,24,178.65,410
,20170711,73580,74430,73920,74580,73620,74580,74290,150,-140,54,401.18,430
,20170712,74580,74290,75280,76270,75280,76100,75970,1810,1680,94,714.13,444
,20170713,76100,75970,76670,76670,76230,76650,76400,680,430,32,244.50,450
,20170714,76650,76400,76810,77000,76430,77000,76790,600,390,20,153.59,446
,20170717,77000,76790,77500,79570,77500,79500,78970,2710,2180,76,600.19,450
,20170718,79500,78970,79530,80000,78960,79200,79660,230,690,60,477.98,412
,20170719,79200,79660,79730,80470,79460,79970,80010,310,350,84,672.13,430
,20170720,79970,80010,80070,80070,79150,79250,79460,-760,-550,246,"1,954.76",456
,20170721,79250,79460,79440,79660,78260,79000,79050,-460,-410,176,"1,391.41",478
,20170724,79000,79050,79220,79620,78060,79270,79050,220,0,120,948.62,470
,20170725,79270,79050,79690,81330,79590,81330,80820,2280,1770,144,"1,163.82",450
,20170726,81330,80820,81770,83080,80950,80950,81660,130,840,118,963.64,418
,20170727,80950,81660,81500,82050,81500,82020,81960,360,300,28,229.51,402
,20170728,82020,81960,82770,82990,82510,82600,82740,640,780,66,546.09,368
,20170731,82600,82740,83380,83500,83030,83500,83280,760,540,8,66.63,366
,20170801,83500,83280,83240,83590,82030,82500,82650,-780,-630,36,297.56,374
,20170802,82500,82650,82820,83250,82090,82850,82810,200,160,38,314.69,368
,20170803,82850,82810,83100,84510,83100,84120,84050,1310,1240,272,"2,286.20",382
,20170804,84120,84050,83600,84470,83250,84470,83900,420,-150,252,"2,114.39",384
,20170807,84470,83900,83730,84730,83000,83610,83660,-290,-240,42,351.38,380
,20170808,83610,83660,83670,84150,83210,83220,83790,-440,130,74,620.12,384
,20170809,83220,83790,83490,87800,83480,86460,85630,2670,1840,210,"1,798.36",396
,20170810,86460,85630,87060,87060,86690,86760,86930,1130,1300,40,347.76,386
,20170811,86760,86930,86800,87360,85500,85600,86540,-1330,-390,60,519.25,396
,20170814,85600,86540,85950,86140,85500,85500,85930,-1040,-610,26,223.44,392
,20170815,85500,85930,84740,85140,83900,84470,84690,-1460,-1240,62,525.08,386
,20170816,84470,84690,83790,84410,83740,84410,83950,-280,-740,78,654.88,336
,20170817,84410,83950,85960,87250,85890,87250,86490,3300,2540,184,"1,591.57",372
,20170818,87250,86490,86630,87170,85830,87010,86670,520,180,100,866.74,390
,20170821,87010,86670,87860,90080,86970,89240,88280,2570,1610,264,"2,330.85",362
,20170822,89240,88280,89770,91120,89600,91120,90430,2840,2150,102,922.46,360
,20170823,91120,90430,92150,95740,90210,91450,91230,1020,800,306,"2,791.89",488
,20170824,91450,91230,92050,95250,92050,93400,93060,2170,1830,22,204.75,484
,20170825,93400,93060,93090,93510,92330,93500,93120,440,60,110,"1,024.41",482
,20170828,93500,93120,94000,94000,91000,92600,92470,-520,-650,230,"2,126.91",464
,20170829,92600,92470,93840,94940,92450,92450,94210,-20,1740,686,"6,462.90",694
,20170830,92450,94210,93960,93960,92220,92960,93160,-1250,-1050,32,298.11,682
,20170831,92960,93160,92000,92990,92000,92990,92590,-170,-570,36,333.32,666
,20170901,92990,92590,93140,94050,92220,94050,92580,1460,-10,442,"4,092.11",426
,20170904,94050,92580,94340,96370,93580,95900,95060,3320,2480,38,361.24,432
,20170905,95900,95060,95840,95840,95410,95410,95620,350,560,4,38.25,434
,20170906,95410,95620,95640,95640,93220,94250,94270,-1370,-1350,32,301.68,430
,20170907,94250,94270,94400,94800,94400,94800,94500,530,230,8,75.60,430
,20170908,94800,94500,93690,95500,92200,92200,94430,-2300,-70,16,151.10,428
,20170911,92200,94430,90830,90870,88760,90400,89670,-4030,-4760,320,"2,869.64",504
,20170912,90400,89670,90660,91450,90660,91300,91110,1630,1440,26,236.90,496
,20170913,91300,91110,92800,92850,91250,91840,92030,730,920,22,202.47,480
,20170914,91840,92030,90200,90440,87950,87950,89870,-4080,-2160,102,916.73,438
,20170915,87950,89870,88420,88420,87020,87360,87380,-2510,-2490,32,279.63,428
,20170918,87360,87380,87620,88320,86010,88290,87720,910,340,114,"1,000.05",380
,20170919,88290,87720,88420,88710,87350,87500,87960,-220,240,308,"2,709.43",362
,20170920,87500,87960,86500,89700,86500,89700,88720,1740,760,98,869.54,346
,20170921,89700,88720,89210,89210,87420,87420,88150,-1300,-570,24,211.57,334
,20170922,87420,88150,87130,87810,82920,82920,84060,-5230,-4090,40,336.27,322
,20170925,82920,84060,83210,83650,82050,83500,82740,-560,-1320,232,"1,919.74",296
,20170926,83500,82740,83670,85420,83670,84090,84320,1350,1580,88,742.08,254
,20170927,84090,84320,84400,85220,84010,85220,84550,900,230,18,152.20,240
,20170928,85220,84550,84490,84490,81280,82800,82170,-1750,-2380,134,"1,101.18",234
,20170929,82800,82170,82900,85520,82900,84210,83880,2040,1710,28,234.89,228
,20171009,84210,83880,,,,85510,85510,1630,1630,0,0.00,228
,20171010,85510,85510,86860,87580,86610,86610,87020,1100,1510,72,626.56,228
,20171011,86610,87020,87870,87870,87870,87870,87870,850,850,24,210.89,216
,20171012,87870,87870,,,,87870,87870,0,0,0,0.00,216
,20171013,87870,87870,,,,91100,91100,3230,3230,0,0.00,216
,20171016,91100,91100,93000,93200,93000,93200,93060,2100,1960,36,335.04,216
ni1711,20170103,88290,88290,88650,88650,88650,88650,88650,360,360,4,35.46,16
,20170104,88650,88650,,,,88650,88650,0,0,0,0.00,16
,20170105,88650,88650,,,,88650,88650,0,0,0,0.00,16
,20170106,88650,88650,,,,88650,88650,0,0,0,0.00,16
,20170109,88650,88650,,,,88650,88650,0,0,0,0.00,16
,20170110,88650,88650,89640,89640,89640,89640,89640,990,990,4,35.86,16
,20170111,89640,89640,,,,89640,89640,0,0,0,0.00,16
,20170112,89640,89640,,,,89640,89640,0,0,0,0.00,16
,20170113,89640,89640,,,,89640,89640,0,0,0,0.00,16
,20170116,89640,89640,88880,88880,88880,88880,88880,-760,-760,2,17.78,18
,20170117,88880,88880,88500,88630,88130,88130,88440,-750,-440,12,106.13,18
,20170118,88130,88440,,,,88440,88440,0,0,0,0.00,18
,20170119,88440,88440,,,,88440,88440,0,0,0,0.00,18
,20170120,88440,88440,,,,86630,86630,-1810,-1810,0,0.00,18
,20170123,86630,86630,85140,85140,85140,85140,85140,-1490,-1490,2,17.03,20
,20170124,85140,85140,,,,85140,85140,0,0,0,0.00,20
,20170125,85140,85140,,,,85140,85140,0,0,0,0.00,20
,20170126,85140,85140,,,,85140,85140,0,0,0,0.00,20
,20170203,85140,85140,,,,85290,85290,150,150,0,0.00,20
,20170206,85290,85290,,,,85290,85290,0,0,0,0.00,20
,20170207,85290,85290,,,,87020,87020,1730,1730,0,0.00,20
,20170208,87020,87020,,,,87500,87500,480,480,0,0.00,20
,20170209,87500,87500,,,,87500,87500,0,0,0,0.00,20
,20170210,87500,87500,,,,87530,87530,30,30,0,0.00,20
,20170213,87530,87530,,,,89660,89660,2130,2130,0,0.00,20
,20170214,89660,89660,,,,90580,90580,920,920,0,0.00,20
,20170215,90580,90580,,,,90580,90580,0,0,0,0.00,20
,20170216,90580,90580,,,,91080,91080,500,500,0,0.00,20
,20170217,91080,91080,93630,93630,93630,93630,93630,2550,2550,2,18.73,22
,20170220,93630,93630,93430,93430,93410,93410,93420,-220,-210,8,74.74,30
,20170221,93410,93420,,,,93420,93420,0,0,0,0.00,30
,20170222,93420,93420,,,,93050,93050,-370,-370,0,0.00,30
,20170223,93050,93050,92780,92780,92780,92780,92780,-270,-270,2,18.56,32
,20170224,92780,92780,91110,91500,91110,91500,91200,-1280,-1580,8,72.97,40
,20170227,91500,91200,,,,91860,91860,660,660,0,0.00,40
,20170228,91860,91860,92920,92920,92920,92920,92920,1060,1060,2,18.58,40
,20170301,92920,92920,,,,92920,92920,0,0,0,0.00,40
,20170302,92920,92920,,,,92920,92920,0,0,0,0.00,40
,20170303,92920,92920,,,,92920,92920,0,0,0,0.00,40
,20170306,92920,92920,,,,92920,92920,0,0,0,0.00,40
,20170307,92920,92920,,,,92920,92920,0,0,0,0.00,40
,20170308,92920,92920,,,,92920,92920,0,0,0,0.00,40
,20170309,92920,92920,,,,90990,90990,-1930,-1930,0,0.00,40
,20170310,90990,90990,87470,87470,87470,87470,87470,-3520,-3520,2,17.49,42
,20170313,87470,87470,,,,87470,87470,0,0,0,0.00,42
,20170314,87470,87470,,,,87470,87470,0,0,0,0.00,42
,20170315,87470,87470,,,,87470,87470,0,0,0,0.00,42
,20170316,87470,87470,,,,87470,87470,0,0,0,0.00,42
,20170317,87470,87470,,,,87470,87470,0,0,0,0.00,42
,20170320,87470,87470,,,,87470,87470,0,0,0,0.00,42
,20170321,87470,87470,,,,87470,87470,0,0,0,0.00,42
,20170322,87470,87470,,,,87470,87470,0,0,0,0.00,42
,20170323,87470,87470,,,,86810,86810,-660,-660,0,0.00,42
,20170324,86810,86810,,,,86810,86810,0,0,0,0.00,42
,20170327,86810,86810,,,,86300,86300,-510,-510,0,0.00,42
,20170328,86300,86300,82820,83780,82820,83780,83300,-2520,-3000,4,33.32,46
,20170329,83780,83300,84560,84560,84560,84560,84560,1260,1260,2,16.91,46
,20170330,84560,84560,,,,84560,84560,0,0,0,0.00,46
,20170331,84560,84560,86010,86010,86010,86010,86010,1450,1450,2,17.20,46
,20170405,86010,86010,,,,86010,86010,0,0,0,0.00,46
,20170406,86010,86010,,,,86010,86010,0,0,0,0.00,46
,20170407,86010,86010,,,,85030,85030,-980,-980,0,0.00,46
,20170410,85030,85030,,,,83720,83720,-1310,-1310,0,0.00,46
,20170411,83720,83720,,,,83720,83720,0,0,0,0.00,46
,20170412,83720,83720,85950,86300,82590,83830,85020,110,1300,14,119.03,50
,20170413,83830,85020,,,,85020,85020,0,0,0,0.00,50
,20170414,85020,85020,,,,84220,84220,-800,-800,0,0.00,50
,20170417,84220,84220,,,,83630,83630,-590,-590,0,0.00,50
,20170418,83630,83630,,,,83630,83630,0,0,0,0.00,50
,20170419,83630,83630,,,,81530,81530,-2100,-2100,0,0.00,50
,20170420,81530,81530,78760,79230,78760,79230,79040,-2300,-2490,10,79.04,44
,20170421,79230,79040,80550,80550,80490,80490,80520,1450,1480,4,32.21,44
,20170424,80490,80520,79930,79930,79930,79930,79930,-590,-590,2,15.99,44
,20170425,79930,79930,,,,79930,79930,0,0,0,0.00,44
,20170426,79930,79930,78750,78890,78490,78890,78670,-1040,-1260,16,125.88,52
,20170427,78890,78670,79140,79140,78140,78140,78950,-530,280,16,126.33,60
,20170428,78140,78950,,,,80010,80010,1060,1060,0,0.00,60
,20170502,80010,80010,,,,80010,80010,0,0,0,0.00,60
,20170503,80010,80010,,,,80010,80010,0,0,0,0.00,60
,20170504,80010,80010,,,,78510,78510,-1500,-1500,0,0.00,60
,20170505,78510,78510,,,,75370,75370,-3140,-3140,0,0.00,60
,20170508,75370,75370,77650,77650,77650,77650,77650,2280,2280,2,15.53,62
,20170509,77650,77650,77290,77290,77290,77290,77290,-360,-360,2,15.46,62
,20170510,77290,77290,,,,77290,77290,0,0,0,0.00,62
,20170511,77290,77290,76760,76760,76760,76760,76760,-530,-530,2,15.35,62
,20170512,76760,76760,77780,78250,77560,77880,77890,1120,1130,442,"3,442.82",190
,20170515,77880,77890,78080,78340,78080,78340,78220,450,330,18,140.81,174
,20170516,78340,78220,77630,77630,77260,77260,77400,-960,-820,10,77.41,166
,20170517,77260,77400,77670,78180,77600,78090,77870,690,470,24,186.91,156
,20170518,78090,77870,78170,78170,76100,76100,77540,-1770,-330,50,387.74,158
,20170519,76100,77540,76200,77270,76200,77190,76660,-350,-880,40,306.66,160
,20170522,77190,76660,79130,79300,79130,79300,79210,2640,2550,16,126.74,148
,20170523,79300,79210,78970,78970,78970,78970,78970,-240,-240,2,15.79,148
,20170524,78970,78970,,,,78970,78970,0,0,0,0.00,148
,20170525,78970,78970,,,,76720,76720,-2250,-2250,0,0.00,148
,20170526,76720,76720,,,,76720,76720,0,0,0,0.00,148
,20170531,76720,76720,76840,76840,76840,76840,76840,120,120,2,15.37,150
,20170601,76840,76840,,,,76350,76350,-490,-490,0,0.00,150
,20170602,76350,76350,73510,73510,73180,73180,73340,-3170,-3010,4,29.34,150
,20170605,73180,73340,74360,74900,74300,74300,74330,960,990,114,847.46,234
,20170606,74300,74330,,,,74330,74330,0,0,0,0.00,234
,20170607,74330,74330,,,,74330,74330,0,0,0,0.00,234
,20170608,74330,74330,,,,74330,74330,0,0,0,0.00,234
,20170609,74330,74330,,,,74330,74330,0,0,0,0.00,234
,20170612,74330,74330,,,,74330,74330,0,0,0,0.00,234
,20170613,74330,74330,74680,74680,73660,73660,74410,-670,80,14,104.18,242
,20170614,73660,74410,,,,74410,74410,0,0,0,0.00,242
,20170615,74410,74410,,,,74410,74410,0,0,0,0.00,242
,20170616,74410,74410,74760,74760,74510,74510,74630,100,220,4,29.85,244
,20170619,74510,74630,73580,74160,73580,74160,73870,-470,-760,4,29.55,244
,20170620,74160,73870,75600,75780,75290,75380,75500,1510,1630,14,105.70,244
,20170621,75380,75500,74830,75250,74780,74780,74930,-720,-570,36,269.76,244
,20170622,74780,74930,74880,74880,74880,74880,74880,-50,-50,6,44.93,238
,20170623,74880,74880,,,,74880,74880,0,0,0,0.00,238
,20170626,74880,74880,75990,75990,75640,75640,75940,760,1060,14,106.32,226
,20170627,75640,75940,,,,75940,75940,0,0,0,0.00,226
,20170628,75940,75940,,,,75940,75940,0,0,0,0.00,226
,20170629,75940,75940,,,,76660,76660,720,720,0,0.00,226
,20170630,76660,76660,,,,76980,76980,320,320,0,0.00,226
,20170703,76980,76980,77780,77780,77780,77780,77780,800,800,2,15.56,224
,20170704,77780,77780,,,,77310,77310,-470,-470,0,0.00,224
,20170705,77310,77310,76540,76540,76540,76540,76540,-770,-770,8,61.23,232
,20170706,76540,76540,,,,76540,76540,0,0,0,0.00,232
,20170707,76540,76540,,,,76540,76540,0,0,0,0.00,232
,20170710,76540,76540,75050,75050,74490,74490,74770,-2050,-1770,4,29.91,230
,20170711,74490,74770,74300,75100,74300,74950,74590,180,-180,16,119.34,232
,20170712,74950,74590,75500,76120,75500,76120,75960,1530,1370,8,60.77,230
,20170713,76120,75960,76660,76660,76660,76660,76660,700,700,4,30.66,226
,20170714,76660,76660,,,,76660,76660,0,0,0,0.00,226
,20170717,76660,76660,78670,79500,78670,79500,79310,2840,2650,42,333.12,240
,20170718,79500,79310,79980,80130,79600,80130,79890,820,580,16,127.83,246
,20170719,80130,79890,79580,80970,79580,80250,80610,360,720,70,564.29,262
,20170720,80250,80610,80140,80150,80140,80150,80140,-460,-470,10,80.15,266
,20170721,80150,80140,,,,79730,79730,-410,-410,0,0.00,266
,20170724,79730,79730,79400,79400,79400,79400,79400,-330,-330,8,63.52,266
,20170725,79400,79400,81630,81630,80810,80810,81120,1410,1720,64,519.19,258
,20170726,80810,81120,81870,82480,81770,82010,82040,890,920,58,475.89,268
,20170727,82010,82040,81830,81830,81830,81830,81830,-210,-210,4,32.73,266
,20170728,81830,81830,82560,82560,82110,82190,82350,360,520,8,65.88,266
,20170731,82190,82350,82960,84000,82850,83680,83550,1330,1200,74,618.27,302
,20170801,83680,83550,83400,83410,83400,83410,83400,-140,-150,10,83.41,302
,20170802,83410,83400,83340,83340,82550,82550,83060,-850,-340,14,116.29,304
,20170803,82550,83060,83290,84810,83070,83070,83860,10,800,30,251.60,310
,20170804,83070,83860,83430,83680,83430,83680,83550,-180,-310,4,33.42,310
,20170807,83680,83550,83660,84290,82700,84290,83460,740,-90,154,"1,285.40",312
,20170808,84290,83460,84030,84260,83500,83660,83680,200,220,92,769.92,374
,20170809,83660,83680,83630,87840,83630,87290,86170,3610,2490,80,689.37,364
,20170810,87290,86170,87300,87300,86910,86910,87140,740,970,18,156.85,360
,20170811,86910,87140,86910,88150,86130,86130,86760,-1010,-380,38,329.72,360
,20170814,86130,86760,85850,86090,85380,85380,85830,-1380,-930,52,446.33,368
,20170815,85380,85830,84950,84950,83570,84790,84470,-1040,-1360,18,152.05,372
,20170816,84790,84470,84490,84550,83740,84550,84250,80,-220,40,337.02,372
,20170817,84550,84250,85930,87400,85930,87110,86650,2860,2400,86,745.22,388
,20170818,87110,86650,86880,87080,86430,86920,86870,270,220,30,260.61,388
,20170821,86920,86870,87400,90430,87400,89500,88620,2630,1750,762,"6,752.90",1060
,20170822,89500,88620,90220,90910,90220,90560,90840,1940,2220,206,"1,871.41",1226
,20170823,90560,90840,91480,91880,89610,89610,90830,-1230,-10,42,381.52,1222
,20170824,89610,90830,91050,93490,91050,93340,91900,2510,1070,24,220.56,1224
,20170825,93340,91900,93060,93110,92960,92960,93020,1060,1120,68,632.57,1242
,20170828,92960,93020,91000,92580,91000,92330,91530,-690,-1490,70,640.71,1238
,20170829,92330,91530,92530,94100,92350,92350,93500,820,1970,42,392.71,1244
,20170830,92350,93500,93060,93340,92500,92510,92910,-990,-590,36,334.49,1244
,20170831,92510,92910,92120,92790,92020,92790,92420,-120,-490,240,"2,218.14",1160
,20170901,92790,92420,92630,93950,92480,93950,92920,1530,500,44,408.88,1130
,20170904,93950,92920,94010,96580,94010,96020,95690,3100,2770,26,248.81,1116
,20170905,96020,95690,95330,95620,94800,95500,95250,-190,-440,58,552.47,1112
,20170906,95500,95250,95470,95630,93760,94280,94170,-970,-1080,62,583.88,1114
,20170907,94280,94170,95360,95360,93880,93880,94390,-290,220,10,94.40,1114
,20170908,93880,94390,93940,95420,91600,91600,94170,-2790,-220,244,"2,297.78",1148
,20170911,91600,94170,90230,90410,88510,90050,89650,-4120,-4520,90,806.87,1128
,20170912,90050,89650,91000,91470,90470,90930,91110,1280,1460,58,528.46,1134
,20170913,90930,91110,91680,92590,91180,91640,91820,530,710,16,146.92,1130
,20170914,91640,91820,89740,89740,87610,87610,89210,-4210,-2610,12,107.06,1122
,20170915,87610,89210,88180,88520,86800,87000,87720,-2210,-1490,642,"5,631.90",1160
,20170918,87000,87720,87640,87860,87500,87860,87510,140,-210,54,472.60,1110
,20170919,87860,87510,88330,88330,86920,87250,87590,-260,80,20,175.20,1116
,20170920,87250,87590,88110,89270,88110,88990,89000,1400,1410,30,267.01,1092
,20170921,88990,89000,88230,88570,86930,87020,87310,-1980,-1690,346,"3,021.27",1104
,20170922,87020,87310,86950,88300,82120,82880,84430,-4430,-2880,112,945.64,1128
,20170925,82880,84430,83420,84040,82930,83610,83370,-820,-1060,156,"1,300.72",1158
,20170926,83610,83370,83650,84300,83650,84000,83940,630,570,50,419.70,1154
,20170927,84000,83940,83800,84600,83800,84440,84340,500,400,26,219.29,1150
,20170928,84440,84340,83560,83560,80990,82980,82790,-1360,-1550,86,712.03,1116
,20170929,82980,82790,83010,84800,83010,84600,84300,1810,1510,54,455.27,1110
,20171009,84600,84300,85100,87390,85100,87370,86690,3070,2390,30,260.09,1110
,20171010,87370,86690,87310,87810,87310,87400,87670,710,980,14,122.75,1116
,20171011,87400,87670,88100,88400,88000,88060,88180,390,510,12,105.82,1116
,20171012,88060,88180,88960,91070,88960,91070,90140,2890,1960,36,324.53,1114
,20171013,91070,90140,91520,92570,91500,92570,91760,2430,1620,118,"1,082.79",1080
,20171016,92570,91760,93000,93990,92920,93910,93630,2150,1870,38,355.80,1078
,20171017,93910,93630,94300,94880,93820,94440,94530,810,900,104,983.20,1028
,20171018,94440,94530,93650,95340,91590,93900,93650,-630,-880,140,"1,311.16",1008
,20171019,93900,93650,94450,95290,93410,94050,94460,400,810,38,358.98,1002
,20171020,94050,94460,95340,96790,95320,96790,96030,2330,1570,34,326.52,990
,20171023,96790,96030,95540,95540,93720,94930,94620,-1100,-1410,44,416.35,984
,20171024,94930,94620,94220,95900,94130,95900,95010,1280,390,42,399.06,952
,20171025,95900,95010,96300,96730,95060,95060,96060,50,1050,52,499.52,962
,20171026,95060,96060,95780,95790,93980,95450,95360,-610,-700,110,"1,048.97",962
,20171027,95450,95360,93990,93990,93080,93190,93400,-2170,-1960,12,112.08,950
,20171030,93190,93400,93670,93670,93670,93670,93670,270,270,2,18.73,948
,20171031,93670,93670,92900,94170,91770,92960,93630,-710,-40,40,374.54,924
,20171101,92960,93630,,,,93630,93630,0,0,0,0.00,924
,20171102,93630,93630,,,,99240,99240,5610,5610,0,0.00,924
,20171103,99240,99240,,,,99240,99240,0,0,0,0.00,924
,20171106,99240,99240,101810,102200,101810,102200,102000,2960,2760,24,244.81,912
,20171107,102200,102000,,,,102000,102000,0,0,0,0.00,912
,20171108,102000,102000,100200,100290,100200,100290,100240,-1710,-1760,24,240.59,900
,20171109,100290,100240,,,,100240,100240,0,0,0,0.00,900
,20171110,100240,100240,,,,100240,100240,0,0,0,0.00,900
,20171113,100240,100240,,,,100240,100240,0,0,0,0.00,900
,20171114,100240,100240,,,,100240,100240,0,0,0,0.00,900
,20171115,100240,100240,94220,94220,94220,94220,94220,-6020,-6020,588,"5,540.14",336
ni1712,20170103,88880,89280,,,,89280,89280,0,0,0,0.00,48
,20170104,89280,89280,85660,87370,85660,87370,86510,-1910,-2770,4,34.61,48
,20170105,87370,86510,87980,87980,87820,87820,87870,1310,1360,6,52.72,48
,20170106,87820,87870,,,,87870,87870,0,0,0,0.00,48
,20170109,87870,87870,,,,87870,87870,0,0,0,0.00,48
,20170110,87870,87870,,,,87870,87870,0,0,0,0.00,48
,20170111,87870,87870,,,,87870,87870,0,0,0,0.00,48
,20170112,87870,87870,,,,87870,87870,0,0,0,0.00,48
,20170113,87870,87870,88700,88700,88200,88280,88290,410,420,12,105.96,48
,20170116,88280,88290,,,,88290,88290,0,0,0,0.00,48
,20170117,88290,88290,,,,88290,88290,0,0,0,0.00,48
,20170118,88290,88290,87730,87730,87730,87730,87730,-560,-560,2,17.55,48
,20170119,87730,87730,,,,87730,87730,0,0,0,0.00,48
,20170120,87730,87730,,,,87730,87730,0,0,0,0.00,48
,20170123,87730,87730,,,,87730,87730,0,0,0,0.00,48
,20170124,87730,87730,,,,87730,87730,0,0,0,0.00,48
,20170125,87730,87730,,,,87730,87730,0,0,0,0.00,48
,20170126,87730,87730,,,,87730,87730,0,0,0,0.00,48
,20170203,87730,87730,,,,87730,87730,0,0,0,0.00,48
,20170206,87730,87730,87930,88800,87930,88800,88510,1070,780,6,53.11,52
,20170207,88800,88510,,,,88510,88510,0,0,0,0.00,52
,20170208,88510,88510,88290,89610,88290,89610,89150,1100,640,8,71.32,54
,20170209,89610,89150,,,,89150,89150,0,0,0,0.00,54
,20170210,89150,89150,,,,89150,89150,0,0,0,0.00,54
,20170213,89150,89150,,,,90690,90690,1540,1540,0,0.00,54
,20170214,90690,90690,91160,92760,91160,92760,91910,2070,1220,38,349.29,40
,20170215,92760,91910,,,,91910,91910,0,0,0,0.00,40
,20170216,91910,91910,92650,94360,91610,94360,92480,2450,570,30,277.47,40
,20170217,94360,92480,93260,96330,92020,94040,93980,1560,1500,1214,"11,409.39",366
,20170220,94040,93980,93590,94950,91610,94190,93850,210,-130,1554,"14,584.74",372
,20170221,94190,93850,94470,95700,94470,94730,95080,880,1230,818,"7,778.07",474
,20170222,94730,95080,93530,94000,92570,92650,93470,-2430,-1610,596,"5,571.02",430
,20170223,92650,93470,92580,93590,90910,91180,92540,-2290,-930,1640,"15,176.83",404
,20170224,91180,92540,92090,92200,90660,90660,91530,-1880,-1010,34,311.23,392
,20170227,90660,91530,92250,93840,92190,93840,93250,2310,1720,34,317.05,386
,20170228,93840,93250,94220,94560,93750,94160,94120,910,870,20,188.25,380
,20170301,94160,94120,94320,94320,94320,94320,94320,200,200,2,18.86,380
,20170302,94320,94320,,,,94320,94320,0,0,0,0.00,380
,20170303,94320,94320,,,,94320,94320,0,0,0,0.00,380
,20170306,94320,94320,94710,94720,94530,94570,94660,250,340,12,113.59,372
,20170307,94570,94660,93730,94600,93730,93800,94010,-860,-650,26,244.44,348
,20170308,93800,94010,91950,91970,91260,91260,91690,-2750,-2320,18,165.05,330
,20170309,91260,91690,89130,89650,88020,88020,88610,-3670,-3080,10,88.61,324
,20170310,88020,88610,87050,87050,86620,86620,86830,-1990,-1780,8,69.47,320
,20170313,86620,86830,87640,87720,85220,86560,86570,-270,-260,140,"1,212.05",394
,20170314,86560,86570,87270,88980,87120,87510,87770,940,1200,60,526.65,362
,20170315,87510,87770,87030,88800,87030,88100,87390,330,-380,140,"1,223.59",276
,20170316,88100,87390,88830,88830,88560,88670,88740,1280,1350,10,88.74,266
,20170317,88670,88740,88070,88070,88070,88070,88070,-670,-670,2,17.61,266
,20170320,88070,88070,88070,88070,88070,88070,88070,0,0,2,17.61,264
,20170321,88070,88070,87400,87690,87400,87690,87590,-380,-480,6,52.56,258
,20170322,87690,87590,87290,87290,85680,85750,86170,-1840,-1420,18,155.11,256
,20170323,85750,86170,86420,86430,85950,85950,86180,-220,10,40,344.74,256
,20170324,85950,86180,85440,85440,85440,85440,85440,-740,-740,24,205.06,256
,20170327,85440,85440,85320,85320,82350,83360,83480,-2080,-1960,54,450.82,226
,20170328,83360,83480,83110,84510,83110,84510,84110,1030,630,26,218.69,232
,20170329,84510,84110,83560,85810,83560,85400,84500,1290,390,46,388.71,230
,20170330,85400,84500,85550,86690,85270,85510,86240,1010,1740,224,"1,931.97",246
,20170331,85510,86240,85950,86490,85950,86140,86160,-100,-80,14,120.63,244
,20170405,86140,86160,86680,87160,86340,87160,86510,1000,350,46,397.99,242
,20170406,87160,86510,,,,86690,86690,180,180,0,0.00,242
,20170407,86690,86690,88090,88090,85690,85720,86460,-970,-230,32,276.68,236
,20170410,85720,86460,84900,86190,84900,86190,85250,-270,-1210,66,562.71,234
,20170411,86190,85250,86040,86510,85960,86320,86310,1070,1060,58,500.63,214
,20170412,86320,86310,86900,86900,83350,83860,84360,-2450,-1950,164,"1,383.64",206
,20170413,83860,84360,83150,83840,82480,83580,83130,-780,-1230,14,116.39,198
,20170414,83580,83130,82170,82180,82000,82000,82110,-1130,-1020,6,49.27,200
,20170417,82000,82110,82320,83060,81900,81900,82600,-210,490,130,"1,073.82",194
,20170418,81900,82600,82220,82290,81500,81500,82220,-1100,-380,26,213.78,206
,20170419,81500,82220,81480,81480,79780,80080,80170,-2140,-2050,32,256.57,206
,20170420,80080,80170,80930,81040,80550,81040,80750,870,580,28,226.11,222
,20170421,81040,80750,80680,81690,80680,80990,81090,240,340,98,794.78,220
,20170424,80990,81090,80480,80480,79810,80110,80050,-980,-1040,20,160.10,232
,20170425,80110,80050,79960,80030,79000,79000,79670,-1050,-380,174,"1,386.40",340
,20170426,79000,79670,79260,79800,79010,79800,79520,130,-150,28,222.66,332
,20170427,79800,79520,79300,79360,78960,79220,79160,-300,-360,22,174.17,340
,20170428,79220,79160,79270,80840,79000,80810,80170,1650,1010,114,913.96,374
,20170502,80810,80170,80930,81780,80920,81300,81550,1130,1380,168,"1,370.09",436
,20170503,81300,81550,81300,81450,81000,81000,81250,-550,-300,12,97.51,438
,20170504,81000,81250,79830,79830,77220,77780,78750,-3470,-2500,124,976.52,498
,20170505,77780,78750,77210,77240,76260,76260,76950,-2490,-1800,50,384.77,518
,20170508,76260,76950,77610,78080,77300,77420,77660,470,710,54,419.38,514
,20170509,77420,77660,77440,77670,77440,77670,77530,10,-130,10,77.54,504
,20170510,77670,77530,78400,78740,77760,77760,78200,230,670,84,656.88,520
,20170511,77760,78200,78200,78680,76820,78680,77920,480,-280,68,529.90,538
,20170512,78680,77920,79040,79040,78280,78280,78630,360,710,28,220.17,544
,20170515,78280,78630,78490,78950,78490,78730,78760,100,130,12,94.51,538
,20170516,78730,78760,78620,78620,77530,77580,77970,-1180,-790,28,218.33,552
,20170517,77580,77970,77830,78360,77820,78360,78020,390,50,10,78.02,546
,20170518,78360,78020,78510,78510,76660,76900,76960,-1120,-1060,126,969.76,576
,20170519,76900,76960,76760,77890,76720,77540,77460,580,500,78,604.21,598
,20170522,77540,77460,78020,79690,78020,79320,79140,1860,1680,180,"1,424.54",708
,20170523,79320,79140,79250,79580,79140,79200,79360,60,220,82,650.76,748
,20170524,79200,79360,78490,79050,77200,77650,78580,-1710,-780,232,"1,823.16",932
,20170525,77650,78580,77510,77770,77020,77170,77340,-1410,-1240,22,170.15,928
,20170526,77170,77340,76500,76610,76500,76540,76550,-800,-790,18,137.79,928
,20170531,76540,76550,76680,76680,73710,73710,74530,-2840,-2020,100,745.38,982
,20170601,73710,74530,74170,74500,73730,74450,74250,-80,-280,22,163.36,982
,20170602,74450,74250,74170,74450,73410,73420,73620,-830,-630,86,633.17,920
,20170605,73420,73620,74210,74760,74210,74640,74500,1020,880,30,223.51,918
,20170606,74640,74500,74350,74350,74270,74270,74320,-230,-180,6,44.59,912
,20170607,74270,74320,74890,74890,74830,74830,74860,510,540,12,89.83,902
,20170608,74830,74860,73730,73730,73730,73730,73730,-1130,-1130,2,14.75,900
,20170609,73730,73730,74600,74600,74090,74090,74340,360,610,4,29.74,896
,20170612,74090,74340,74480,75030,74480,75030,74750,690,410,4,29.90,894
,20170613,75030,74750,74520,74520,73880,73880,73950,-870,-800,28,207.07,888
,20170614,73880,73950,,,,73950,73950,0,0,0,0.00,888
,20170615,73950,73950,74700,74750,74470,74470,74580,520,630,20,149.16,900
,20170616,74470,74580,74450,74940,74340,74940,74440,360,-140,50,372.23,926
,20170619,74940,74440,75020,75020,74280,74510,74670,70,230,8,59.74,926
,20170620,74510,74670,75430,75930,75430,75930,75840,1260,1170,16,121.36,926
,20170621,75930,75840,75510,75510,74820,74850,75020,-990,-820,84,630.23,956
,20170622,74850,75020,75580,75670,75010,75010,75440,-10,420,10,75.44,962
,20170623,75010,75440,75980,76330,75960,76330,76100,890,660,54,410.96,1002
,20170626,76330,76100,,,,76100,76100,0,0,0,0.00,1002
,20170627,76100,76100,76320,76560,76320,76490,76430,390,330,32,244.58,1002
,20170628,76490,76430,77010,77060,76720,77020,76980,590,550,28,215.56,1002
,20170629,77020,76980,77250,77640,77250,77600,77500,620,520,10,77.51,1000
,20170630,77600,77500,77260,77620,77260,77620,77480,120,-20,6,46.49,1002
,20170703,77620,77480,78610,78610,78300,78300,78350,820,870,30,235.05,1030
,20170704,78300,78350,76600,76680,76600,76600,76630,-1750,-1720,8,61.31,1024
,20170705,76600,76630,76470,76470,76470,76470,76470,-160,-160,2,15.29,1022
,20170706,76470,76470,76270,76270,75940,75960,76000,-510,-470,14,106.40,1008
,20170707,75960,76000,75570,75570,75570,75570,75570,-430,-430,2,15.11,1008
,20170710,75570,75570,75330,75370,74630,74630,75140,-940,-430,14,105.20,998
,20170711,74630,75140,74670,75830,74670,75830,75010,690,-130,36,270.04,998
,20170712,75830,75010,75470,76940,75470,76760,76640,1750,1630,50,383.22,1010
,20170713,76760,76640,77270,77270,76580,77170,76910,530,270,222,"1,707.59",1108
,20170714,77170,76910,77250,77620,76760,77620,77380,710,470,156,"1,207.16",1202
,20170717,77620,77380,77870,79990,75910,79890,79230,2510,1850,478,"3,787.23",878
,20170718,79890,79230,79960,80380,79560,79640,79960,410,730,138,"1,103.50",770
,20170719,79640,79960,80300,80660,80210,80640,80320,680,360,98,787.17,702
,20170720,80640,80320,80720,80720,79590,79880,80280,-440,-40,40,321.13,688
,20170721,79880,80280,79740,79740,78550,79660,79000,-620,-1280,120,948.08,676
,20170724,79660,79000,79820,80280,79030,79050,79810,50,810,28,223.48,680
,20170725,79050,79810,80330,81710,80240,81710,81160,1900,1350,410,"3,327.86",416
,20170726,81710,81160,82130,82900,81820,82240,82320,1080,1160,518,"4,264.59",172
,20170727,82240,82320,82170,83140,82170,83140,82450,820,130,22,181.40,160
,20170728,83140,82450,84160,84160,82590,82880,83400,430,950,64,533.81,156
,20170731,82880,83400,83990,84570,83470,83720,83940,320,540,40,335.79,146
,20170801,83720,83940,83800,83800,82750,83000,83200,-940,-740,36,299.53,148
,20170802,83000,83200,83260,84120,82900,83120,83370,-80,170,156,"1,300.71",222
,20170803,83120,83370,83600,85180,83600,83700,84330,330,960,106,894.00,264
,20170804,83700,84330,83950,84750,83890,84750,84310,420,-20,44,370.97,262
,20170807,84750,84310,84110,84880,83120,84450,84060,140,-250,166,"1,395.50",258
,20170808,84450,84060,84080,84900,83800,83800,84480,-260,420,62,523.82,258
,20170809,83800,84480,83950,87860,83950,87630,85690,3150,1210,74,634.12,262
,20170810,87630,85690,87660,87740,87050,87460,87520,1770,1830,500,"4,376.35",340
,20170811,87460,87520,87850,87850,85700,85700,86640,-1820,-880,20,173.28,350
,20170814,85700,86640,86100,86750,85500,85630,85760,-1010,-880,64,548.92,376
,20170815,85630,85760,85380,85530,83800,85140,85110,-620,-650,26,221.30,376
,20170816,85140,85110,,,,85110,85110,0,0,0,0.00,376
,20170817,85110,85110,85790,87740,85790,87490,86930,2380,1820,18,156.48,382
,20170818,87490,86930,87400,87400,87400,87400,87400,470,470,8,69.92,390
,20170821,87400,87400,90210,92450,90210,90540,91010,3140,3610,206,"1,875.01",324
,20170822,90540,91010,90540,91960,90540,91380,91220,370,210,54,492.62,346
,20170823,91380,91220,92010,93080,90330,91330,92080,110,860,138,"1,270.72",310
,20170824,91330,92080,92310,94420,91750,94320,93540,2240,1460,50,467.70,288
,20170825,94320,93540,93960,94170,93770,93890,94000,350,460,22,206.81,282
,20170828,93890,94000,93580,93750,91200,92950,92240,-1050,-1760,96,885.60,280
,20170829,92950,92240,95050,95050,92470,93360,93720,1120,1480,48,449.87,262
,20170830,93360,93720,94010,94010,92750,93420,93200,-300,-520,36,335.52,272
,20170831,93420,93200,92450,93300,92190,92990,92810,-210,-390,30,278.46,270
,20170901,92990,92810,93200,94640,93200,94400,94190,1590,1380,24,226.07,262
,20170904,94400,94190,94280,98330,94130,96370,96530,2180,2340,74,714.35,260
,20170905,96370,96530,96100,96110,95510,96110,95960,-420,-570,30,287.89,252
,20170906,96110,95960,95800,95840,93760,94740,94610,-1220,-1350,72,681.25,246
,20170907,94740,94610,94100,96300,94100,95390,95530,780,920,40,382.13,262
,20170908,95390,95530,93960,94270,92170,92840,93510,-2690,-2020,46,430.17,274
,20170911,92840,93510,90850,91180,89220,90290,90030,-3220,-3480,70,630.26,284
,20170912,90290,90030,91760,92010,90980,92010,91450,1980,1420,86,786.52,304
,20170913,92010,91450,90890,93480,90890,92050,92000,600,550,502,"4,618.57",324
,20170914,92050,92000,90980,91010,88470,88470,89860,-3530,-2140,172,"1,545.72",302
,20170915,88470,89860,88790,88940,86700,87150,88490,-2710,-1370,118,"1,044.24",302
,20170918,87150,88490,87780,88260,86110,88120,87880,-370,-610,78,685.49,306
,20170919,88120,87880,88170,88470,87180,87300,88040,-580,160,166,"1,461.52",300
,20170920,87300,88040,86820,89990,86460,89990,88150,1950,110,28,246.82,290
,20170921,89990,88150,89960,89960,87050,87700,88230,-450,80,214,"1,888.31",284
,20170922,87700,88230,87290,88210,83340,84300,85810,-3930,-2420,306,"2,625.99",222
,20170925,84300,85810,83910,84100,83220,83880,83640,-1930,-2170,30,250.94,218
,20170926,83880,83640,83780,84670,83780,84510,84110,870,470,26,218.69,226
,20170927,84510,84110,83780,84800,83780,84700,84590,590,480,38,321.48,214
,20170928,84700,84590,84520,84520,82810,82850,83110,-1740,-1480,16,132.99,206
,20170929,82850,83110,84330,84480,84060,84060,84210,950,1100,14,117.91,210
,20171009,84060,84210,85770,86330,85770,86330,86040,2120,1830,8,68.83,208
,20171010,86330,86040,87260,87690,86850,86850,87200,810,1160,18,156.97,212
,20171011,86850,87200,87460,87750,86460,87410,87260,210,60,14,122.17,212
,20171012,87410,87260,88620,90000,88410,90000,89100,2740,1840,22,196.03,214
,20171013,90000,89100,91260,91410,90770,91200,91020,2100,1920,20,182.06,206
,20171016,91200,91020,92500,93260,91750,92880,92760,1860,1740,42,389.61,208
,20171017,92880,92760,93530,94850,92730,92730,93920,-30,1160,56,525.99,220
,20171018,92730,93920,92820,93900,92480,93530,93250,-390,-670,18,167.86,218
,20171019,93530,93250,94520,94890,92790,94060,94000,810,750,34,319.63,218
,20171020,94060,94000,93480,97210,93480,97210,95420,3210,1420,18,171.76,220
,20171023,97210,95420,96020,96020,94120,94730,95160,-690,-260,76,723.24,218
,20171024,94730,95160,94860,96040,94650,96040,95520,880,360,24,229.25,226
,20171025,96040,95520,96320,96430,95050,95050,95960,-470,440,16,153.54,222
,20171026,95050,95960,94950,95510,94950,95510,95200,-450,-760,24,228.49,230
,20171027,95510,95200,95330,95330,92120,92120,93610,-3080,-1590,16,149.79,232
,20171030,92120,93610,92540,92540,92540,92540,92540,-1070,-1070,2,18.51,230
,20171031,92540,92540,92940,94960,92720,94960,93700,2420,1160,36,337.33,228
,20171101,94960,93700,95050,98810,95050,98810,95870,5110,2170,20,191.75,226
,20171102,98810,95870,100680,101620,99690,100850,100860,4980,4990,106,"1,069.19",232
,20171103,100850,100860,100920,101300,99030,100990,101010,130,150,82,828.36,192
,20171106,100990,101010,100770,102750,100420,102750,101410,1740,400,24,243.39,190
,20171107,102750,101410,102750,102750,102230,102740,102450,1330,1040,66,676.20,138
,20171108,102740,102450,101860,101860,100330,101190,100970,-1260,-1480,14,141.36,136
,20171109,101190,100970,101010,101010,98780,98780,100560,-2190,-410,10,100.56,136
,20171110,98780,100560,98780,99500,98780,98850,99080,-1710,-1480,48,475.62,128
,20171113,98850,99080,99330,99330,97190,99000,98680,-80,-400,36,355.25,106
,20171114,99000,98680,99430,100450,99060,99060,99720,380,1040,10,99.72,98
,20171115,99060,99720,98930,98930,93730,93730,93880,-5990,-5840,84,788.65,102
,20171116,93730,93880,93130,93640,92600,93200,93000,-680,-880,90,837.04,90
,20171117,93200,93000,93300,93900,92290,92290,93170,-710,170,20,186.35,90
,20171120,92290,93170,92890,92890,92000,92300,92310,-870,-860,48,443.12,54
,20171121,92300,92310,93500,94180,92580,93300,93230,990,920,32,298.34,54
,20171122,93300,93230,94900,94900,94080,94080,94280,850,1050,8,75.43,54
,20171123,94080,94280,94370,94950,94310,94310,94370,30,90,36,339.76,42
,20171124,94310,94370,96230,96230,96230,96230,96230,1860,1860,2,19.25,42
,20171127,96230,96230,96240,96820,93660,93660,94600,-2570,-1630,20,189.20,40
,20171128,93660,94600,93850,93850,91730,91730,92290,-2870,-2310,8,73.83,38
,20171129,91730,92290,90770,90770,90770,90770,90770,-1520,-1520,4,36.31,38
,20171130,90770,90770,89930,90160,88800,90160,89650,-610,-1120,24,215.18,24
,20171201,90160,89650,,,,89650,89650,0,0,0,0.00,24
,20171204,89650,89650,91460,91460,91460,91460,91460,1810,1810,12,109.75,12
,20171205,91460,91460,89000,89000,89000,89000,89000,-2460,-2460,12,106.80,12
,20171206,89000,89000,,,,89000,89000,0,0,0,0.00,12
,20171207,89000,89000,,,,88950,88950,-50,-50,0,0.00,12
,20171208,88950,88950,88800,88800,88800,88800,88800,-150,-150,12,106.56,12
,20171211,88800,88800,,,,88800,88800,0,0,0,0.00,12
,20171212,88800,88800,,,,88800,88800,0,0,0,0.00,12
,20171213,88800,88800,,,,88800,88800,0,0,0,0.00,12
,20171214,88800,88800,,,,88800,88800,0,0,0,0.00,12
,20171215,88800,88800,,,,88800,88800,0,0,0,0.00,12
ni1801,20170117,88290,88290,77330,90490,77330,88220,88210,-70,-80,164,"1,446.74",90
,20170118,88220,88210,88500,89000,87600,88050,88140,-160,-70,46,405.45,112
,20170119,88050,88140,87950,88300,87750,87980,88060,-160,-80,12,105.68,116
,20170120,87980,88060,87690,88220,84610,84900,85840,-3160,-2220,220,"1,888.61",280
,20170123,84900,85840,84940,86490,84940,85690,85520,-150,-320,76,649.96,330
,20170124,85690,85520,84990,85950,84990,85320,85440,-200,-80,130,"1,110.80",404
,20170125,85320,85440,85670,85760,84500,84500,84870,-940,-570,192,"1,629.59",534
,20170126,84500,84870,84870,86140,84770,86140,85630,1270,760,230,"1,969.61",716
,20170203,86140,85630,88690,90130,86680,87770,87650,2140,2020,174,"1,525.23",748
,20170206,87770,87650,86800,89620,86800,89100,89080,1450,1430,220,"1,959.87",868
,20170207,89100,89080,89710,89930,88880,89300,89340,220,260,120,"1,072.13",920
,20170208,89300,89340,89440,90220,89010,89890,89600,550,260,296,"2,652.23",1036
,20170209,89890,89600,91180,91180,89850,89850,90140,250,540,250,"2,253.63",1190
,20170210,89850,90140,90000,90500,89030,89890,89680,-250,-460,330,"2,959.47",1232
,20170213,89890,89680,90360,92860,90360,92430,92070,2750,2390,740,"6,813.47",1434
,20170214,92430,92070,92720,93380,92160,93380,92780,1310,710,266,"2,468.14",1516
,20170215,93380,92780,93810,94030,91960,93060,92950,280,170,418,"3,885.32",1540
,20170216,93060,92950,92860,95380,92360,93860,94120,910,1170,620,"5,835.47",1648
,20170217,93860,94120,93680,95020,93160,93960,93950,-160,-170,454,"4,265.46",1718
,20170220,93960,93950,94240,95120,93460,94970,94520,1020,570,936,"8,847.27",1778
,20170221,94970,94520,94950,95890,94650,94890,95290,370,770,488,"4,650.55",1844
,20170222,94890,95290,95010,95010,92520,93080,93590,-2210,-1700,818,"7,656.24",2038
,20170223,93080,93590,93080,93770,91480,91950,92510,-1640,-1080,1128,"10,435.67",2060
,20170224,91950,92510,92370,92600,90900,92520,92010,10,-500,866,"7,968.10",2400
,20170227,92520,92010,92570,94960,92130,94250,93940,2240,1930,1160,"10,897.64",2970
,20170228,94250,93940,94430,94990,93950,94190,94420,250,480,1316,"12,426.13",3408
,20170301,94190,94420,94150,94840,92800,94520,93970,100,-450,494,"4,642.36",3410
,20170302,94520,93970,94870,95290,94150,94550,94800,580,830,332,"3,147.40",3430
,20170303,94550,94800,94300,94350,92920,94280,93740,-520,-1060,392,"3,674.63",3438
,20170306,94280,93740,94260,95160,93800,94440,94470,700,730,506,"4,780.37",3458
,20170307,94440,94470,94380,95000,94150,94550,94520,80,50,476,"4,499.53",3472
,20170308,94550,94520,94360,94450,91050,91420,92400,-3100,-2120,1324,"12,233.89",3318
,20170309,91420,92400,91800,91800,86640,87550,88660,-4850,-3740,2398,"21,262.33",4168
,20170310,87550,88660,87600,88600,87160,87200,88050,-1460,-610,1588,"13,982.56",4584
,20170313,87200,88050,87200,88230,85620,87560,86820,-490,-1230,1632,"14,169.21",5018
,20170314,87560,86820,87730,88830,87000,87400,88040,580,1220,1410,"12,413.80",5176
,20170315,87400,88040,87760,89100,87190,88450,88300,410,260,2158,"19,055.98",5446
,20170316,88450,88300,88690,89390,88380,89020,88890,720,590,832,"7,396.12",5526
,20170317,89020,88890,88850,88990,87660,87880,88340,-1010,-550,640,"5,654.36",5662
,20170320,87880,88340,87700,88920,87700,88000,88390,-340,50,1116,"9,864.38",5848
,20170321,88000,88390,87810,88600,87200,87710,87770,-680,-620,1226,"10,761.33",5984
,20170322,87710,87770,87620,88350,85890,85890,86620,-1880,-1150,1640,"14,206.44",6080
,20170323,85890,86620,85980,87090,85400,86380,86280,-240,-340,1292,"11,147.69",6096
,20170324,86380,86280,85980,86650,85560,85830,85980,-450,-300,654,"5,623.39",6110
,20170327,85830,85980,85680,86250,82970,83590,84540,-2390,-1440,2588,"21,881.18",6764
,20170328,83590,84540,83830,85090,83390,84270,84270,-270,-270,1382,"11,647.38",6930
,20170329,84270,84270,84460,86110,84140,86000,85230,1730,960,740,"6,307.18",7000
,20170330,86000,85230,86000,86860,85500,85790,86000,560,770,1048,"9,013.70",7160
,20170331,85790,86000,85790,87180,85790,86560,86510,560,510,1100,"9,516.77",7338
,20170405,86560,86510,85800,88270,85800,87860,87430,1350,920,1380,"12,065.67",7856
,20170406,87860,87430,87990,88510,87510,88160,88110,730,680,2366,"20,846.86",7804
,20170407,88160,88110,88600,88600,85110,85770,86640,-2340,-1470,2304,"19,963.69",7816
,20170410,85770,86640,85510,87700,85290,86890,86830,250,190,1896,"16,463.31",8052
,20170411,86890,86830,86890,87290,86060,86910,86700,80,-130,2340,"20,288.94",8080
,20170412,86910,86700,86910,87350,83300,83470,84770,-3230,-1930,3144,"26,652.61",8636
,20170413,83470,84770,83340,84330,82720,83660,83540,-1110,-1230,1362,"11,379.07",8922
,20170414,83660,83540,83540,84060,82210,82480,83010,-1060,-530,2148,"17,832.60",9312
,20170417,82480,83010,82810,83600,82040,82480,82810,-530,-200,2228,"18,450.41",9788
,20170418,82480,82810,82500,83200,81790,82060,82550,-750,-260,1328,"10,963.13",10124
,20170419,82060,82550,82060,82060,79800,80940,80560,-1610,-1990,3604,"29,037.22",10778
,20170420,80940,80560,80940,81670,79800,81400,80700,840,140,2678,"21,612.57",11126
,20170421,81400,80700,81400,82000,80880,81330,81330,630,630,2404,"19,553.78",11848
,20170424,81330,81330,81290,81300,79860,80270,80370,-1060,-960,2236,"17,971.77",12388
,20170425,80270,80370,80270,80650,79200,79490,79960,-880,-410,3374,"26,980.68",13154
,20170426,79490,79960,79610,80200,79300,79700,79890,-260,-70,3310,"26,445.94",14144
,20170427,79700,79890,79700,80180,79100,79560,79530,-330,-360,3654,"29,063.03",15028
,20170428,79560,79530,79560,81240,79080,81000,80320,1470,790,4018,"32,273.69",15538
,20170502,81000,80320,81200,82190,81110,81690,81740,1370,1420,1588,"12,980.80",15522
,20170503,81690,81740,81690,82010,80850,81040,81380,-700,-360,2054,"16,715.99",15882
,20170504,81040,81380,80580,80580,77200,77950,78900,-3430,-2480,7254,"57,238.74",17096
,20170505,77950,78900,77780,77980,76500,76560,77110,-2340,-1790,7246,"55,878.61",18384
,20170508,76560,77110,76660,78580,76660,77420,77580,310,470,5576,"43,260.37",18468
,20170509,77420,77580,77810,78360,77560,78110,78000,530,420,3866,"30,156.08",19108
,20170510,78110,78000,78360,79200,77800,78130,78490,130,490,3886,"30,502.27",18874
,20170511,78130,78490,78490,78950,77140,78840,77930,350,-560,6186,"48,208.13",19148
,20170512,78840,77930,79260,79410,78300,78630,78780,700,850,4874,"38,400.02",19152
,20170515,78630,78780,79000,79420,78310,79030,78870,250,90,2890,"22,796.24",18896
,20170516,79030,78870,79110,79430,77580,78210,78290,-660,-580,7516,"58,845.49",20864
,20170517,78210,78290,77850,78950,77820,78470,78320,180,30,5978,"46,820.04",21270
,20170518,78470,78320,78470,78860,76580,77130,77750,-1190,-570,7104,"55,234.94",22086
,20170519,77130,77750,76970,78160,76830,77630,77530,-120,-220,7400,"57,374.99",23202
,20170522,77630,77530,78030,80090,78030,79390,79420,1860,1890,10314,"81,921.64",24812
,20170523,79390,79420,79510,80080,79010,79160,79610,-260,190,5090,"40,524.69",25490
,20170524,79160,79610,79160,79450,77240,77650,78520,-1960,-1090,11804,"92,692.00",28930
,20170525,77650,78520,77900,77990,77040,77450,77560,-1070,-960,5788,"44,893.49",29154
,20170526,77450,77560,77450,77700,76520,76700,76960,-860,-600,5614,"43,206.98",29556
,20170531,76700,76960,76510,77440,74210,74380,75670,-2580,-1290,9806,"74,202.73",30934
,20170601,74380,75670,74360,75230,74060,74700,74630,-970,-1040,8380,"62,542.37",32650
,20170602,74700,74630,74610,74870,73600,73700,73950,-930,-680,14638,"108,262.37",37598
,20170605,73700,73950,73710,75250,73680,74770,74610,820,660,12408,"92,577.07",40436
,20170606,74770,74610,74580,75100,74300,74660,74680,50,70,7870,"58,777.07",41542
,20170607,74660,74680,74650,75700,74400,75090,75070,410,390,9998,"75,055.68",42340
,20170608,75090,75070,75060,75350,73700,74840,74410,-230,-660,15090,"112,287.50",45420
,20170609,74840,74410,74730,74920,74200,74500,74540,90,130,9200,"68,581.49",47234
,20170612,74500,74540,74650,75960,74650,75500,75450,960,910,11652,"87,923.68",47210
,20170613,75500,75450,75390,75450,73850,74090,74360,-1360,-1090,16658,"123,874.32",51370
,20170614,74090,74360,74060,74930,73040,74790,74140,430,-220,17176,"127,346.64",52800
,20170615,74790,74140,74690,75180,74070,74750,74700,610,560,15778,"117,873.10",54514
,20170616,74750,74700,74720,75570,74320,75010,74980,310,280,16194,"121,429.79",57110
,20170619,75010,74980,75310,75680,74310,75430,75130,450,150,14032,"105,425.69",58580
,20170620,75430,75130,75430,76850,75430,76190,76230,1060,1100,23688,"180,589.75",60126
,20170621,76190,76230,75990,76020,74510,75540,75240,-690,-990,23010,"173,149.11",63560
,20170622,75540,75240,75610,76120,75120,75300,75730,60,490,16866,"127,727.33",64658
,20170623,75300,75730,75550,77080,75450,77030,76310,1300,580,20572,"156,989.21",67564
,20170626,77030,76310,76950,77060,76340,76760,76690,450,380,12208,"93,634.64",67796
,20170627,76760,76690,76760,76870,75870,76700,76400,10,-290,14320,"109,412.80",69268
,20170628,76700,76400,76790,77630,76650,77280,77190,880,790,17450,"134,706.00",70748
,20170629,77280,77190,77170,78450,76880,78290,77820,1100,630,29330,"228,251.89",76184
,20170630,78290,77820,78190,78470,77310,78100,77990,280,170,30540,"238,191.95",80558
,20170703,78100,77990,78100,79060,77770,78610,78410,620,420,20838,"163,407.27",83512
,20170704,78610,78410,78640,78790,76300,76630,77490,-1780,-920,41330,"320,271.37",83816
,20170705,76630,77490,76600,77280,76420,76660,76850,-830,-640,20818,"160,006.58",87136
,20170706,76660,76850,76490,76830,75980,76700,76430,-150,-420,24832,"189,799.26",92504
,20170707,76700,76430,76620,76850,75530,76100,76140,-330,-290,39358,"299,696.71",97112
,20170710,76100,76140,75800,75990,74800,74950,75360,-1190,-780,49468,"372,837.26",102612
,20170711,74950,75360,74800,76010,74500,75820,75360,460,0,37468,"282,377.56",109010
,20170712,75820,75360,75780,77600,75650,77200,76790,1840,1430,52818,"405,627.88",113948
,20170713,77200,76790,77150,77800,76680,77440,77250,650,460,50930,"393,450.30",119164
,20170714,77440,77250,77330,77820,76500,77590,77240,340,-10,61978,"478,776.42",135684
,20170717,77590,77240,77880,80390,77880,80020,79240,2780,2000,81818,"648,399.59",136628
,20170718,80020,79240,80210,80880,79500,80020,80260,780,1020,59384,"476,631.04",142128
,20170719,80020,80260,80100,81080,79980,80900,80580,640,320,55092,"443,941.26",148698
,20170720,80900,80580,81050,81300,79730,80050,80410,-530,-170,81528,"655,614.53",159888
,20170721,80050,80410,80010,80260,78800,79700,79490,-710,-920,97094,"771,883.92",175116
,20170724,79700,79490,80050,80500,78720,80080,79750,590,260,100830,"804,159.73",180594
,20170725,80080,79750,80140,82470,80060,82400,81270,2650,1520,130386,"1,059,766.44",196600
,20170726,82400,81270,82610,83860,81950,82310,82820,1040,1550,184254,"1,526,171.20",214934
,20170727,82310,82820,82700,83580,82210,83470,83030,650,210,165340,"1,372,947.18",252090
,20170728,83470,83030,83600,84380,82610,83930,83700,900,670,198696,"1,663,127.10",265742
,20170731,83930,83700,84330,85330,83780,84540,84610,840,910,176398,"1,492,565.19",278488
,20170801,84540,84610,84320,84720,83030,83450,83790,-1160,-820,178832,"1,498,511.11",291256
,20170802,83450,83790,83810,84530,83150,83570,83860,-220,70,212670,"1,783,632.18",302356
,20170803,83570,83860,83750,85860,83650,84060,84800,200,940,347622,"2,947,890.19",322512
,20170804,84060,84800,84300,85400,84150,85120,84810,320,10,251036,"2,129,173.45",339208
,20170807,85120,84810,85140,85600,83460,84950,84480,140,-330,447828,"3,783,568.19",364612
,20170808,84950,84480,84940,85490,84030,84300,84830,-180,350,426502,"3,618,420.36",382076
,20170809,84300,84830,84510,88720,84200,88060,86880,3230,2050,797146,"6,926,189.55",440984
,20170810,88060,86880,88100,88350,87390,87940,87940,1060,1060,430670,"3,787,731.01",444146
,20170811,87940,87940,87920,89350,86170,86650,87880,-1290,-60,743956,"6,538,281.70",439030
,20170814,86650,87880,86750,87330,85800,86190,86630,-1690,-1250,434792,"3,766,790.29",445486
,20170815,86190,86630,86030,86100,84320,85410,85220,-1220,-1410,502432,"4,282,128.88",446978
,20170816,85410,85220,85100,85800,84560,85380,85110,160,-110,466886,"3,973,892.55",462362
,20170817,85380,85110,86180,88460,86100,87940,87650,2830,2540,748108,"6,557,339.00",484210
,20170818,87940,87650,87590,88300,86510,88090,87640,440,-10,559800,"4,906,512.16",497772
,20170821,88090,87640,88350,91570,88020,91030,89880,3390,2240,1074542,"9,658,297.99",512342
,20170822,91030,89880,91400,92500,91020,92480,91680,2600,1800,646120,"5,923,761.77",524528
,20170823,92480,91680,93200,93400,90770,92230,92090,550,410,855648,"7,880,134.85",517910
,20170824,92230,92090,92780,94980,92160,94000,93870,1910,1780,935532,"8,781,933.60",522940
,20170825,94000,93870,94120,94870,93500,94280,94200,410,330,633788,"5,970,811.08",514296
,20170828,94280,94200,94130,94260,91630,93520,92830,-680,-1370,791342,"7,346,254.76",510978
,20170829,93520,92830,93490,95400,92860,94070,94460,1240,1630,907194,"8,569,560.72",523110
,20170830,94070,94460,94600,95070,92710,93440,93800,-1020,-660,775834,"7,278,059.87",514760
,20170831,93440,93800,93000,93780,92440,93610,93070,-190,-730,656318,"6,108,540.13",522766
,20170901,93610,93070,93700,95120,93320,94650,94200,1580,1130,656320,"6,182,617.28",545594
,20170904,94650,94200,95210,97720,94220,96300,95970,2100,1770,808516,"7,760,046.18",544964
,20170905,96300,95970,96380,96910,95850,96730,96450,760,480,464864,"4,484,077.11",548606
,20170906,96730,96450,96480,96700,94000,94900,95360,-1550,-1090,778090,"7,420,382.67",525196
,20170907,94900,95360,95100,97070,94480,95410,95740,50,380,802680,"7,685,007.46",536370
,20170908,95410,95740,95410,96470,92230,92750,94600,-2990,-1140,1106122,"10,464,081.41",530408
,20170911,92750,94600,92500,92570,89190,91230,90530,-3370,-4070,1158076,"10,484,131.43",507256
,20170912,91230,90530,91390,92780,91080,92100,91900,1570,1370,855572,"7,863,521.17",513386
,20170913,92100,91900,91490,93850,91100,92370,92780,470,880,952540,"8,837,821.03",516216
,20170914,92370,92780,91230,91850,88300,88400,90160,-4380,-2620,1317614,"11,879,656.40",517240
,20170915,88400,90160,89420,89480,87380,87760,88610,-2400,-1550,921470,"8,165,540.99",501614
,20170918,87760,88610,87530,88880,85650,88530,87640,-80,-970,1220366,"10,696,105.13",489962
,20170919,88530,87640,88530,89180,87000,87400,88350,-240,710,904102,"7,987,891.68",496876
,20170920,87400,88350,87350,90560,86400,89920,88650,1570,300,1095548,"9,712,817.89",500052
,20170921,89920,88650,90200,90800,87470,87960,89170,-690,520,1049908,"9,362,039.26",489486
,20170922,87960,89170,87570,88890,83810,83810,86020,-5360,-3150,1145464,"9,853,796.05",530674
,20170925,83810,86020,84010,84890,83050,84060,83950,-1960,-2070,610436,"5,125,001.71",491886
,20170926,84060,83950,83800,85470,83710,84530,84670,580,720,456260,"3,863,181.88",472920
,20170927,84530,84670,84100,85520,83820,84980,84650,310,-20,451702,"3,823,807.00",476148
,20170928,84980,84650,85040,85190,82500,83510,83570,-1140,-1080,574776,"4,803,498.36",479662
,20170929,83510,83570,83500,85280,83280,84800,84470,1230,900,423764,"3,579,845.62",430448
,20171009,84800,84470,85500,87530,85380,87290,86540,2820,2070,286030,"2,475,365.58",441240
,20171010,87290,86540,87310,88460,86700,87400,87730,860,1190,474880,"4,166,512.32",468904
,20171011,87400,87730,87650,88420,86530,87970,87810,240,80,445716,"3,914,170.01",469048
,20171012,87970,87810,88050,90980,87040,90420,89370,2610,1560,548782,"4,904,902.38",480042
,20171013,90420,89370,90230,92370,90030,92290,91390,2920,2020,403930,"3,691,827.86",465920
,20171016,92290,91390,93020,93950,91850,93430,92950,2040,1560,522072,"4,853,118.11",467186
,20171017,93430,92950,94000,95350,92930,93400,94240,450,1290,649058,"6,116,925.82",469172
,20171018,93400,94240,93700,94790,92720,94710,93900,470,-340,492036,"4,620,279.35",467996
,20171019,94710,93900,94610,95610,92930,94290,94240,390,340,720048,"6,785,809.13",502384
,20171020,94290,94240,94100,97680,93430,97650,95330,3410,1090,584724,"5,574,388.15",517902
,20171023,97650,95330,97450,97750,93680,94800,95290,-530,-40,699144,"6,662,299.91",493476
,20171024,94800,95290,95000,96590,94300,96390,95750,1100,460,467980,"4,480,977.19",488414
,20171025,96390,95750,96450,97280,94880,95490,96120,-260,370,463142,"4,452,091.40",481718
,20171026,95490,96120,95740,96290,95070,95600,95630,-520,-490,350534,"3,352,448.13",460594
,20171027,95600,95630,95680,95900,92220,92540,93890,-3090,-1740,560272,"5,260,906.29",480432
,20171030,92540,93890,91940,93400,91760,92630,92620,-1260,-1270,385454,"3,570,386.09",438826
,20171031,92630,92620,92830,95360,92620,95210,93720,2590,1100,441586,"4,138,968.52",471036
,20171101,95210,93720,95100,99340,94760,99340,96250,5620,2530,283060,"2,724,467.66",442476
,20171102,99340,96250,101100,102650,99880,101450,101010,5200,4760,693742,"7,007,584.09",496556
,20171103,101450,101010,100990,101860,99020,101320,100700,310,-310,602778,"6,070,459.65",463650
,20171106,101320,100700,101150,103420,100000,103230,101740,2530,1040,539920,"5,493,329.28",490642
,20171107,103230,101740,103220,103290,101860,102930,102640,1190,900,392152,"4,025,435.43",454628
,20171108,102930,102640,102630,102670,100200,101130,101320,-1510,-1320,493738,"5,002,715.87",459324
,20171109,101130,101320,100990,101870,98330,99110,100340,-2210,-980,520504,"5,223,046.53",425388
,20171110,99110,100340,98680,99850,97930,99120,99020,-1220,-1320,367614,"3,640,442.46",382180
,20171113,99120,99020,99460,99680,97520,99650,98660,630,-360,327036,"3,226,558.09",355582
,20171114,99650,98660,99190,101050,98650,98830,99850,170,1190,298038,"2,975,930.29",323724
,20171115,98830,99850,98800,99340,93850,93850,95920,-6000,-3930,349208,"3,349,626.18",296178
,20171116,93850,95920,93380,94210,93110,93330,93660,-2590,-2260,167136,"1,565,406.75",267918
,20171117,93330,93660,93400,94460,91820,92130,92930,-1530,-730,190920,"1,774,362.51",266698
,20171120,92130,92930,92500,93550,92140,93260,92850,330,-80,113136,"1,050,576.47",242650
,20171121,93260,92850,93350,94360,92160,93620,93620,770,770,138886,"1,300,308.92",231376
,20171122,93620,93620,93810,95110,93500,94140,94330,520,710,105086,"991,364.56",211748
,20171123,94140,94330,94090,95650,93320,93450,94820,-880,490,106262,"1,007,649.15",210192
,20171124,93450,94820,93550,96100,92580,95930,94570,1110,-250,90216,"853,257.55",196308
,20171127,95930,94570,95800,96500,92600,93320,94910,-1250,340,76718,"728,134.23",190712
,20171128,93320,94910,93400,93500,90520,91340,91860,-3570,-3050,80128,"736,061.62",181086
,20171129,91340,91860,91400,92110,90180,90750,91220,-1110,-640,79194,"722,429.78",168894
,20171130,90750,91220,90550,91480,89280,90200,90680,-1020,-540,66468,"602,743.06",152476
,20171201,90200,90680,90370,90740,88820,89330,89660,-1350,-1020,51002,"457,321.48",143614
,20171204,89330,89660,88960,91560,88880,91370,90650,1710,990,58120,"526,876.13",141156
,20171205,91370,90650,91550,91800,89140,89440,90630,-1210,-20,39892,"361,562.76",130556
,20171206,89440,90630,89600,89600,86520,87160,87540,-3470,-3090,45048,"394,367.57",127918
,20171207,87160,87540,87110,87710,86090,86570,87030,-970,-510,36410,"316,889.21",119678
,20171208,86570,87030,86610,88760,86610,88350,87900,1320,870,32432,"285,097.93",113824
,20171211,88350,87900,88350,88700,86800,87210,87600,-690,-300,28126,"246,399.42",107198
,20171212,87210,87600,87420,89600,87220,89070,88810,1470,1210,27692,"245,948.85",99004
,20171213,89070,88810,89070,89880,87800,89350,89180,540,370,23540,"209,947.31",91832
,20171214,89350,89180,89360,90570,88400,89020,89530,-160,350,33664,"301,421.16",83500
,20171215,89020,89530,89270,90210,89150,89870,89680,340,150,18308,"164,197.03",78020
,20171218,89870,89680,90390,93600,89810,93110,92230,3430,2550,31410,"289,694.94",76012
,20171219,93110,92230,93110,94930,92620,94040,93960,1810,1730,26482,"248,832.05",65782
,20171220,94040,93960,94240,94800,93730,94490,94290,530,330,13930,"131,347.97",63272
,20171221,94490,94290,94880,96270,94460,95000,95250,710,960,10436,"99,404.48",60614
,20171222,95000,95250,95280,95560,93800,94940,94800,-310,-450,8828,"83,696.71",58566
,20171225,94940,94800,94890,96660,93750,94150,95310,-650,510,15582,"148,516.37",56582
,20171226,94150,95310,94050,94680,93180,94630,94020,-680,-1290,8238,"77,454.44",53270
,20171227,94630,94020,94630,95150,92900,93700,93760,-320,-260,7408,"69,461.11",51242
,20171228,93700,93760,94000,96340,93410,95650,94830,1890,1070,10780,"102,230.25",48218
,20171229,95650,94830,96500,96500,95110,96400,95810,1570,980,12160,"116,510.20",44374
ni1802,20170216,92950,92950,,,,94120,94120,1170,1170,0,0.00,0
,20170217,94120,94120,,,,93950,93950,-170,-170,0,0.00,0
,20170220,93950,93950,93510,93510,93510,93510,93510,-440,-440,2,18.70,2
,20170221,93510,93510,93540,96510,93540,93630,95050,120,1540,10,95.05,4
,20170222,93630,95050,95010,95010,93390,94600,94400,-450,-650,8,75.52,2
,20170223,94600,94400,,,,94400,94400,0,0,0,0.00,2
,20170224,94400,94400,,,,93890,93890,-510,-510,0,0.00,2
,20170227,93890,93890,,,,93890,93890,0,0,0,0.00,2
,20170228,93890,93890,,,,93890,93890,0,0,0,0.00,2
,20170301,93890,93890,,,,93440,93440,-450,-450,0,0.00,2
,20170302,93440,93440,,,,93440,93440,0,0,0,0.00,2
,20170303,93440,93440,,,,93440,93440,0,0,0,0.00,2
,20170306,93440,93440,,,,93440,93440,0,0,0,0.00,2
,20170307,93440,93440,,,,93440,93440,0,0,0,0.00,2
,20170308,93440,93440,,,,93440,93440,0,0,0,0.00,2
,20170309,93440,93440,,,,89660,89660,-3780,-3780,0,0.00,2
,20170310,89660,89660,,,,89040,89040,-620,-620,0,0.00,2
,20170313,89040,89040,,,,89040,89040,0,0,0,0.00,2
,20170314,89040,89040,,,,89040,89040,0,0,0,0.00,2
,20170315,89040,89040,89230,89230,88400,88400,88590,-640,-450,12,106.32,12
,20170316,88400,88590,89470,89470,89300,89300,89400,710,810,6,53.64,16
,20170317,89300,89400,,,,88850,88850,-550,-550,0,0.00,16
,20170320,88850,88850,,,,88850,88850,0,0,0,0.00,16
,20170321,88850,88850,,,,88850,88850,0,0,0,0.00,16
,20170322,88850,88850,,,,87690,87690,-1160,-1160,0,0.00,16
,20170323,87690,87690,,,,87340,87340,-350,-350,0,0.00,16
,20170324,87340,87340,,,,87340,87340,0,0,0,0.00,16
,20170327,87340,87340,,,,85880,85880,-1460,-1460,0,0.00,16
,20170328,85880,85880,84340,84340,84340,84340,84340,-1540,-1540,2,16.87,18
,20170329,84340,84340,,,,85300,85300,960,960,0,0.00,18
,20170330,85300,85300,,,,86070,86070,770,770,0,0.00,18
,20170331,86070,86070,,,,86580,86580,510,510,0,0.00,18
,20170405,86580,86580,,,,87500,87500,920,920,0,0.00,18
,20170406,87500,87500,,,,87500,87500,0,0,0,0.00,18
,20170407,87500,87500,,,,86040,86040,-1460,-1460,0,0.00,18
,20170410,86040,86040,,,,86230,86230,190,190,0,0.00,18
,20170411,86230,86230,,,,86230,86230,0,0,0,0.00,18
,20170412,86230,86230,,,,84310,84310,-1920,-1920,0,0.00,18
,20170413,84310,84310,83100,83100,83100,83100,83100,-1210,-1210,2,16.62,18
,20170414,83100,83100,,,,83100,83100,0,0,0,0.00,18
,20170417,83100,83100,,,,83100,83100,0,0,0,0.00,18
,20170418,83100,83100,82900,82900,82900,82900,82900,-200,-200,2,16.58,18
,20170419,82900,82900,,,,80910,80910,-1990,-1990,0,0.00,18
,20170420,80910,80910,,,,80910,80910,0,0,0,0.00,18
,20170421,80910,80910,,,,80910,80910,0,0,0,0.00,18
,20170424,80910,80910,,,,80910,80910,0,0,0,0.00,18
,20170425,80910,80910,,,,80910,80910,0,0,0,0.00,18
,20170426,80910,80910,,,,80840,80840,-70,-70,0,0.00,18
,20170427,80840,80840,,,,80840,80840,0,0,0,0.00,18
,20170428,80840,80840,,,,80840,80840,0,0,0,0.00,18
,20170502,80840,80840,,,,80840,80840,0,0,0,0.00,18
,20170503,80840,80840,,,,80840,80840,0,0,0,0.00,18
,20170504,80840,80840,,,,78380,78380,-2460,-2460,0,0.00,18
,20170505,78380,78380,,,,76600,76600,-1780,-1780,0,0.00,18
,20170508,76600,76600,78600,78600,78600,78600,78600,2000,2000,2,15.72,18
,20170509,78600,78600,,,,78600,78600,0,0,0,0.00,18
,20170510,78600,78600,,,,78600,78600,0,0,0,0.00,18
,20170511,78600,78600,,,,78600,78600,0,0,0,0.00,18
,20170512,78600,78600,79330,79330,78670,78670,78890,70,290,6,47.33,20
,20170515,78670,78890,,,,78890,78890,0,0,0,0.00,20
,20170516,78890,78890,78570,78570,78570,78570,78570,-320,-320,4,31.43,20
,20170517,78570,78570,,,,78570,78570,0,0,0,0.00,20
,20170518,78570,78570,,,,78520,78520,-50,-50,0,0.00,20
,20170519,78520,78520,,,,78520,78520,0,0,0,0.00,20
,20170522,78520,78520,79150,79150,79150,79150,79150,630,630,2,15.83,18
,20170523,79150,79150,,,,79150,79150,0,0,0,0.00,18
,20170524,79150,79150,79380,79390,78990,78990,79220,-160,70,10,79.23,24
,20170525,78990,79220,,,,78250,78250,-970,-970,0,0.00,24
,20170526,78250,78250,,,,78250,78250,0,0,0,0.00,24
,20170531,78250,78250,,,,76930,76930,-1320,-1320,0,0.00,24
,20170601,76930,76930,,,,76930,76930,0,0,0,0.00,24
,20170602,76930,76930,,,,76930,76930,0,0,0,0.00,24
,20170605,76930,76930,,,,76930,76930,0,0,0,0.00,24
,20170606,76930,76930,,,,76930,76930,0,0,0,0.00,24
,20170607,76930,76930,75360,75360,75360,75360,75360,-1570,-1570,2,15.07,24
,20170608,75360,75360,,,,75360,75360,0,0,0,0.00,24
,20170609,75360,75360,,,,75360,75360,0,0,0,0.00,24
,20170612,75360,75360,,,,75360,75360,0,0,0,0.00,24
,20170613,75360,75360,76110,76280,75290,76280,75890,920,530,6,45.54,28
,20170614,76280,75890,73900,73900,73900,73900,73900,-1990,-1990,4,29.56,28
,20170615,73900,73900,75240,75360,75130,75130,75240,1230,1340,10,75.24,34
,20170616,75130,75240,75200,75530,75200,75530,75360,290,120,4,30.15,32
,20170619,75530,75360,75890,75890,75890,75890,75890,530,530,2,15.18,30
,20170620,75890,75890,76630,76630,76420,76420,76490,530,600,6,45.89,34
,20170621,76420,76490,76180,76180,75510,75510,75840,-980,-650,4,30.34,34
,20170622,75510,75840,,,,75840,75840,0,0,0,0.00,34
,20170623,75840,75840,,,,75840,75840,0,0,0,0.00,34
,20170626,75840,75840,,,,76110,76110,270,270,0,0.00,34
,20170627,76110,76110,,,,76110,76110,0,0,0,0.00,34
,20170628,76110,76110,,,,76110,76110,0,0,0,0.00,34
,20170629,76110,76110,,,,76110,76110,0,0,0,0.00,34
,20170630,76110,76110,,,,76270,76270,160,160,0,0.00,34
,20170703,76270,76270,,,,76270,76270,0,0,0,0.00,34
,20170704,76270,76270,78610,78610,78360,78360,78440,2090,2170,6,47.07,36
,20170705,78360,78440,,,,77800,77800,-640,-640,0,0.00,36
,20170706,77800,77800,,,,77800,77800,0,0,0,0.00,36
,20170707,77800,77800,,,,77800,77800,0,0,0,0.00,36
,20170710,77800,77800,,,,77010,77010,-790,-790,0,0.00,36
,20170711,77010,77010,75650,75870,75650,75870,75760,-1140,-1250,12,90.91,38
,20170712,75870,75760,76740,76740,76740,76740,76740,980,980,2,15.35,38
,20170713,76740,76740,77230,77780,77230,77780,77590,1040,850,12,93.12,50
,20170714,77780,77590,77840,78040,77840,78040,77990,450,400,42,327.57,68
,20170717,78040,77990,79800,79800,79800,79800,79800,1810,1810,2,15.96,70
,20170718,79800,79800,80510,81050,79930,80560,80510,760,710,8,64.41,70
,20170719,80560,80510,,,,80510,80510,0,0,0,0.00,70
,20170720,80510,80510,80750,80750,80440,80620,80560,110,50,18,145.01,60
,20170721,80620,80560,79690,80170,79440,79440,79680,-1120,-880,16,127.49,52
,20170724,79440,79680,80280,80280,80260,80260,80270,580,590,16,128.43,52
,20170725,80260,80270,,,,80270,80270,0,0,0,0.00,52
,20170726,80270,80270,,,,80270,80270,0,0,0,0.00,52
,20170727,80270,80270,83120,83830,83120,83830,83520,3560,3250,50,417.65,50
,20170728,83830,83520,,,,83520,83520,0,0,0,0.00,50
,20170731,83520,83520,,,,83520,83520,0,0,0,0.00,50
,20170801,83520,83520,84910,84910,84910,84910,84910,1390,1390,2,16.98,50
,20170802,84910,84910,84090,84980,84080,84220,84520,-690,-390,40,338.10,60
,20170803,84220,84520,85820,85820,85820,85820,85820,1300,1300,8,68.66,52
,20170804,85820,85820,84600,84600,84600,84600,84600,-1220,-1220,2,16.92,52
,20170807,84600,84600,,,,84600,84600,0,0,0,0.00,52
,20170808,84600,84600,,,,84600,84600,0,0,0,0.00,52
,20170809,84600,84600,88020,88020,88010,88010,88010,3410,3410,14,123.22,66
,20170810,88010,88010,87950,88470,87950,88470,88210,460,200,22,194.08,62
,20170811,88470,88210,,,,88210,88210,0,0,0,0.00,62
,20170814,88210,88210,,,,88210,88210,0,0,0,0.00,62
,20170815,88210,88210,,,,88210,88210,0,0,0,0.00,62
,20170816,88210,88210,,,,88210,88210,0,0,0,0.00,62
,20170817,88210,88210,88450,88450,88450,88450,88450,240,240,8,70.76,62
,20170818,88450,88450,87610,87610,87270,87270,87440,-1180,-1010,8,69.95,62
,20170821,87270,87440,,,,87440,87440,0,0,0,0.00,62
,20170822,87440,87440,92460,92680,91840,92680,92600,5240,5160,30,277.83,82
,20170823,92680,92600,92410,92410,91140,91140,91940,-1460,-660,6,55.17,82
,20170824,91140,91940,,,,91940,91940,0,0,0,0.00,82
,20170825,91940,91940,,,,92270,92270,330,330,0,0.00,82
,20170828,92270,92270,,,,92270,92270,0,0,0,0.00,82
,20170829,92270,92270,94680,95500,94680,95500,95090,3230,2820,4,38.04,84
,20170830,95500,95090,,,,95090,95090,0,0,0,0.00,84
,20170831,95090,95090,,,,94350,94350,-740,-740,0,0.00,84
,20170901,94350,94350,93980,95310,93980,95140,94950,790,600,14,132.94,86
,20170904,95140,94950,95540,97500,95180,96730,96160,1780,1210,14,134.63,80
,20170905,96730,96160,96730,97000,96240,96700,96420,540,260,226,"2,179.16",272
,20170906,96700,96420,96470,96650,95110,95760,96410,-660,-10,88,848.45,276
,20170907,95760,96410,95510,95870,94780,95550,95370,-860,-1040,216,"2,060.16",78
,20170908,95550,95370,94800,96430,93000,93360,94970,-2010,-400,70,664.80,92
,20170911,93360,94970,91390,91390,91390,91390,91390,-3580,-3580,2,18.28,94
,20170912,91390,91390,92210,92210,92040,92100,92120,710,730,48,442.18,102
,20170913,92100,92120,92970,92970,92250,92800,92680,680,560,30,278.07,128
,20170914,92800,92680,90530,91260,89800,89800,90530,-2880,-2150,10,90.53,128
,20170915,89800,90530,89240,89480,87690,87690,88920,-2840,-1610,14,124.49,122
,20170918,87690,88920,87000,88980,86950,88630,88210,-290,-710,32,282.27,148
,20170919,88630,88210,88660,88660,87750,88100,88160,-110,-50,66,581.91,188
,20170920,88100,88160,89550,89900,89550,89900,89770,1740,1610,10,89.77,190
,20170921,89900,89770,89240,89240,89240,89240,89240,-530,-530,2,17.85,190
,20170922,89240,89240,,,,86090,86090,-3150,-3150,0,0.00,190
,20170925,86090,86090,84000,84510,84000,84200,84450,-1890,-1640,60,506.71,198
,20170926,84200,84450,84650,85260,84590,85100,84950,650,500,14,118.94,192
,20170927,85100,84950,84630,84880,84630,84880,84750,-70,-200,4,33.90,192
,20170928,84880,84750,84700,84700,84700,84700,84700,-50,-50,4,33.88,192
,20170929,84700,84700,,,,84700,84700,0,0,0,0.00,192
,20171009,84700,84700,,,,86530,86530,1830,1830,0,0.00,192
,20171010,86530,86530,,,,86770,86770,240,240,0,0.00,192
,20171011,86770,86770,88300,88300,88200,88200,88280,1430,1510,16,141.26,198
,20171012,88200,88280,88200,89780,88200,89780,88910,1500,630,36,320.10,178
,20171013,89780,88910,90430,92660,90430,92300,92080,3390,3170,24,221.01,176
,20171016,92300,92080,92940,93790,92200,93790,92610,1710,530,22,203.76,176
,20171017,93790,92610,94700,94900,93820,93840,94390,1230,1780,20,188.79,170
,20171018,93840,94390,94180,94240,93500,94240,93900,-150,-490,22,206.58,170
,20171019,94240,93900,93680,94190,93680,94190,93930,290,30,4,37.57,170
,20171020,94190,93930,97000,97210,97000,97210,97100,3280,3170,4,38.84,166
,20171023,97210,97100,97100,97570,93930,95290,95200,-1810,-1900,142,"1,351.93",186
,20171024,95290,95200,,,,95510,95510,310,310,0,0.00,186
,20171025,95510,95510,96200,96590,96200,96590,96220,1080,710,32,307.92,176
,20171026,96590,96220,95280,95850,95030,95030,95380,-1190,-840,6,57.23,176
,20171027,95030,95380,,,,93610,93610,-1770,-1770,0,0.00,176
,20171030,93610,93610,92950,92950,92950,92950,92950,-660,-660,4,37.18,176
,20171031,92950,92950,92890,95400,92890,95400,94330,2450,1380,38,358.48,174
,20171101,95400,94330,94960,99980,94960,98830,98220,4500,3890,70,687.59,180
,20171102,98830,98220,101930,102360,99940,101290,100680,3070,2460,106,"1,067.30",190
,20171103,101290,100680,101000,101320,99350,101320,100400,640,-280,68,682.74,192
,20171106,101320,100400,100870,103530,100870,103010,101750,2610,1350,46,468.09,196
,20171107,103010,101750,102920,102920,102350,102400,102600,650,850,22,225.73,190
,20171108,102400,102600,101960,101960,100710,101250,101140,-1350,-1460,18,182.06,188
,20171109,101250,101140,101370,101400,98650,98650,100560,-2490,-580,40,402.27,190
,20171110,98650,100560,,,,100560,100560,0,0,0,0.00,190
,20171113,100560,100560,99380,99460,98350,99460,99240,-1100,-1320,18,178.64,186
,20171114,99460,99240,99310,100800,99040,99080,99650,-160,410,14,139.51,182
,20171115,99080,99650,95760,95760,94240,94240,94880,-5410,-4770,36,341.58,186
,20171116,94240,94880,92800,93880,92800,93850,93510,-1030,-1370,6,56.11,184
,20171117,93850,93510,93510,94250,92820,92820,93350,-690,-160,8,74.68,184
,20171120,92820,93350,93000,93000,92700,92700,92850,-650,-500,4,37.14,180
,20171121,92700,92850,93380,93380,92780,92780,93080,-70,230,8,74.46,184
,20171122,92780,93080,94830,94830,94830,94830,94830,1750,1750,4,37.93,184
,20171123,94830,94830,94500,95400,94240,94240,94770,-590,-60,18,170.60,176
,20171124,94240,94770,93080,96540,93080,95810,95240,1040,470,12,114.29,176
,20171127,95810,95240,95480,96460,93630,93650,95150,-1590,-90,20,190.30,176
,20171128,93650,95150,93000,93000,93000,93000,93000,-2150,-2150,2,18.60,176
,20171129,93000,93000,91620,91620,90540,90540,90990,-2460,-2010,12,109.20,184
,20171130,90540,90990,90810,91470,90000,90000,90750,-990,-240,26,235.97,176
,20171201,90000,90750,89710,89880,89710,89880,89840,-870,-910,302,"2,713.17",292
,20171204,89880,89840,89290,91500,89290,91500,90290,1660,450,226,"2,040.59",176
,20171205,91500,90290,91500,91530,89880,89880,90740,-410,450,74,671.50,160
,20171206,89880,90740,89200,89370,87060,87400,89150,-3340,-1590,192,"1,711.76",296
,20171207,87400,89150,87340,87630,86700,86990,87220,-2160,-1930,44,383.78,282
,20171208,86990,87220,87480,88470,87410,88310,87510,1090,290,176,"1,540.30",196
,20171211,88310,87510,87300,88200,87300,88200,87690,690,180,6,52.62,190
,20171212,88200,87690,88540,89880,88540,89000,89020,1310,1330,16,142.44,194
,20171213,89000,89020,89340,89340,88290,88290,89010,-730,-10,20,178.02,188
,20171214,88290,89010,88650,88650,88650,88650,88650,-360,-360,2,17.73,188
,20171215,88650,88650,89200,89950,89200,89230,89460,580,810,20,178.93,198
,20171218,89230,89460,89670,93590,89670,93270,92730,3810,3270,102,945.86,196
,20171219,93270,92730,92720,94450,92720,94450,93150,1720,420,8,74.52,202
,20171220,94450,93150,94230,94350,93920,94350,94220,1200,1070,18,169.61,208
,20171221,94350,94220,95460,95670,94970,95090,95190,870,970,26,247.51,198
,20171222,95090,95190,95530,95530,94760,95010,95150,-180,-40,10,95.16,202
,20171225,95010,95150,96170,96200,94580,94620,95330,-530,180,36,343.21,194
,20171226,94620,95330,93970,94060,93800,93800,93970,-1530,-1360,8,75.18,186
,20171227,93800,93970,95910,95910,93790,93790,94650,-180,680,18,170.37,188
,20171228,93790,94650,94530,96250,94530,96250,95130,1600,480,16,152.22,188
,20171229,96250,95130,95810,97040,95650,96220,96020,1090,890,112,"1,075.46",164
ni1803,20170316,88590,88590,89520,89520,89520,89520,89520,930,930,2,17.90,2
,20170317,89520,89520,89360,89360,89360,89360,89360,-160,-160,2,17.87,4
,20170320,89360,89360,89100,89100,89100,89100,89100,-260,-260,4,35.64,8
,20170321,89100,89100,,,,89100,89100,0,0,0,0.00,8
,20170322,89100,89100,,,,89100,89100,0,0,0,0.00,8
,20170323,89100,89100,,,,89100,89100,0,0,0,0.00,8
,20170324,89100,89100,,,,88790,88790,-310,-310,0,0.00,8
,20170327,88790,88790,86320,86320,86320,86320,86320,-2470,-2470,2,17.26,10
,20170328,86320,86320,,,,86320,86320,0,0,0,0.00,10
,20170329,86320,86320,84950,84950,84950,84950,84950,-1370,-1370,2,16.99,12
,20170330,84950,84950,,,,85720,85720,770,770,0,0.00,12
,20170331,85720,85720,,,,86230,86230,510,510,0,0.00,12
,20170405,86230,86230,,,,87140,87140,910,910,0,0.00,12
,20170406,87140,87140,,,,88000,88000,860,860,0,0.00,12
,20170407,88000,88000,,,,88000,88000,0,0,0,0.00,12
,20170410,88000,88000,86490,86840,86490,86830,86700,-1170,-1300,10,86.70,22
,20170411,86830,86700,,,,86700,86700,0,0,0,0.00,22
,20170412,86700,86700,,,,86700,86700,0,0,0,0.00,22
,20170413,86700,86700,,,,85450,85450,-1250,-1250,0,0.00,22
,20170414,85450,85450,,,,84910,84910,-540,-540,0,0.00,22
,20170417,84910,84910,83550,83550,83210,83210,83380,-1700,-1530,4,33.35,26
,20170418,83210,83380,82640,82770,82640,82770,82670,-610,-710,12,99.21,22
,20170419,82770,82670,81170,81170,80810,81170,81050,-1500,-1620,6,48.63,24
,20170420,81170,81050,81620,81620,81620,81620,81620,570,570,2,16.32,24
,20170421,81620,81620,81910,82090,81520,82070,81890,450,270,8,65.52,30
,20170424,82070,81890,,,,81890,81890,0,0,0,0.00,30
,20170425,81890,81890,,,,81470,81470,-420,-420,0,0.00,30
,20170426,81470,81470,,,,81470,81470,0,0,0,0.00,30
,20170427,81470,81470,79810,79810,79810,79810,79810,-1660,-1660,2,15.96,28
,20170428,79810,79810,,,,80600,80600,790,790,0,0.00,28
,20170502,80600,80600,,,,80600,80600,0,0,0,0.00,28
,20170503,80600,80600,,,,80600,80600,0,0,0,0.00,28
,20170504,80600,80600,,,,78150,78150,-2450,-2450,0,0.00,28
,20170505,78150,78150,77900,77990,77640,77640,77820,-510,-330,14,108.95,40
,20170508,77640,77820,78230,78230,78230,78230,78230,410,410,2,15.65,40
,20170509,78230,78230,,,,78230,78230,0,0,0,0.00,40
,20170510,78230,78230,,,,78230,78230,0,0,0,0.00,40
,20170511,78230,78230,78400,78400,78400,78400,78400,170,170,4,31.36,40
,20170512,78400,78400,,,,78400,78400,0,0,0,0.00,40
,20170515,78400,78400,,,,78400,78400,0,0,0,0.00,40
,20170516,78400,78400,,,,78400,78400,0,0,0,0.00,40
,20170517,78400,78400,79300,79300,79300,79300,79300,900,900,2,15.86,38
,20170518,79300,79300,,,,79300,79300,0,0,0,0.00,38
,20170519,79300,79300,,,,79300,79300,0,0,0,0.00,38
,20170522,79300,79300,80290,80700,80290,80320,80370,1020,1070,10,80.38,40
,20170523,80320,80370,80180,80180,80060,80060,80100,-310,-270,12,96.12,42
,20170524,80060,80100,78600,78600,78600,78600,78600,-1500,-1500,2,15.72,44
,20170525,78600,78600,,,,78600,78600,0,0,0,0.00,44
,20170526,78600,78600,,,,78600,78600,0,0,0,0.00,44
,20170531,78600,78600,,,,77090,77090,-1510,-1510,0,0.00,44
,20170601,77090,77090,75630,75630,75630,75630,75630,-1460,-1460,2,15.13,46
,20170602,75630,75630,75480,75480,74530,74530,74970,-1100,-660,10,74.97,52
,20170605,74530,74970,75150,75730,75150,75730,75440,760,470,4,30.18,54
,20170606,75730,75440,,,,75440,75440,0,0,0,0.00,54
,20170607,75440,75440,75940,76110,75700,75700,75920,260,480,8,60.74,56
,20170608,75700,75920,75700,75700,74780,74980,75140,-940,-780,10,75.14,62
,20170609,74980,75140,75590,75590,75590,75590,75590,450,450,2,15.12,60
,20170612,75590,75590,76300,76300,75890,75890,76090,300,500,8,60.88,60
,20170613,75890,76090,75290,75290,74900,74900,75080,-1190,-1010,6,45.05,62
,20170614,74900,75080,75220,75490,75220,75380,75320,300,240,8,60.26,62
,20170615,75380,75320,75580,75580,75580,75580,75580,260,260,4,30.23,62
,20170616,75580,75580,,,,75580,75580,0,0,0,0.00,62
,20170619,75580,75580,,,,76110,76110,530,530,0,0.00,62
,20170620,76110,76110,77130,77320,77130,77320,77250,1210,1140,6,46.35,62
,20170621,77320,77250,76530,76530,76530,76530,76530,-720,-720,2,15.31,62
,20170622,76530,76530,76530,76530,76530,76530,76530,0,0,4,30.61,62
,20170623,76530,76530,,,,76530,76530,0,0,0,0.00,62
,20170626,76530,76530,77600,77600,77600,77600,77600,1070,1070,4,31.04,58
,20170627,77600,77600,,,,77600,77600,0,0,0,0.00,58
,20170628,77600,77600,78420,78420,78320,78320,78380,720,780,6,47.03,60
,20170629,78320,78380,78530,78530,78530,78530,78530,150,150,2,15.71,58
,20170630,78530,78530,,,,78530,78530,0,0,0,0.00,58
,20170703,78530,78530,,,,78530,78530,0,0,0,0.00,58
,20170704,78530,78530,78030,78030,78030,78030,78030,-500,-500,2,15.61,58
,20170705,78030,78030,,,,78030,78030,0,0,0,0.00,58
,20170706,78030,78030,,,,78030,78030,0,0,0,0.00,58
,20170707,78030,78030,,,,78030,78030,0,0,0,0.00,58
,20170710,78030,78030,,,,78030,78030,0,0,0,0.00,58
,20170711,78030,78030,76030,76460,76030,76460,76220,-1570,-1810,16,121.96,58
,20170712,76460,76220,,,,76220,76220,0,0,0,0.00,58
,20170713,76220,76220,78060,78910,77930,77930,78110,1710,1890,20,156.24,78
,20170714,77930,78110,78000,78510,77340,78380,78270,270,160,24,187.85,92
,20170717,78380,78270,79020,80870,79020,79840,79680,1570,1410,34,270.93,100
,20170718,79840,79680,,,,79680,79680,0,0,0,0.00,100
,20170719,79680,79680,81330,81330,81330,81330,81330,1650,1650,2,16.27,100
,20170720,81330,81330,80960,81190,80960,81190,81070,-140,-260,4,32.43,96
,20170721,81190,81070,80360,80420,79840,80230,80210,-840,-860,8,64.17,88
,20170724,80230,80210,80900,80900,80900,80900,80900,690,690,6,48.54,88
,20170725,80900,80900,83110,83110,83110,83110,83110,2210,2210,2,16.62,88
,20170726,83110,83110,83620,83620,83620,83620,83620,510,510,2,16.72,86
,20170727,83620,83620,83740,83900,83710,83900,83790,280,170,14,117.31,76
,20170728,83900,83790,85000,85340,84300,85340,84620,1550,830,18,152.32,66
,20170731,85340,84620,85390,85470,85390,85470,85430,850,810,4,34.17,64
,20170801,85470,85430,85310,85310,85310,85310,85310,-120,-120,2,17.06,66
,20170802,85310,85310,83980,83980,83980,83980,83980,-1330,-1330,2,16.80,66
,20170803,83980,83980,85030,85030,85030,85030,85030,1050,1050,2,17.01,66
,20170804,85030,85030,,,,85030,85030,0,0,0,0.00,66
,20170807,85030,85030,85990,85990,85010,85010,85500,-20,470,4,34.20,66
,20170808,85010,85500,,,,85500,85500,0,0,0,0.00,66
,20170809,85500,85500,86070,88560,86070,88560,86920,3060,1420,8,69.54,64
,20170810,88560,86920,88910,88960,88620,88960,88790,2040,1870,22,195.35,62
,20170811,88960,88790,,,,88790,88790,0,0,0,0.00,62
,20170814,88790,88790,,,,88790,88790,0,0,0,0.00,62
,20170815,88790,88790,,,,87980,87980,-810,-810,0,0.00,62
,20170816,87980,87980,,,,87580,87580,-400,-400,0,0.00,62
,20170817,87580,87580,,,,87810,87810,230,230,0,0.00,62
,20170818,87810,87810,88010,88010,88010,88010,88010,200,200,2,17.60,60
,20170821,88010,88010,,,,89370,89370,1360,1360,0,0.00,60
,20170822,89370,89370,92820,93410,92820,93270,93130,3900,3760,8,74.50,60
,20170823,93270,93130,93570,93570,91930,91930,92750,-1200,-380,4,37.10,60
,20170824,91930,92750,95900,95900,94860,95460,95500,2710,2750,36,343.83,72
,20170825,95460,95500,94630,94630,94630,94630,94630,-870,-870,2,18.93,72
,20170828,94630,94630,93220,93220,93220,93220,93220,-1410,-1410,10,93.22,82
,20170829,93220,93220,94970,95910,94710,95470,95210,2250,1990,24,228.53,76
,20170830,95470,95210,94220,94220,94220,94220,94220,-990,-990,6,56.53,82
,20170831,94220,94220,94150,94150,94150,94150,94150,-70,-70,2,18.83,82
,20170901,94150,94150,94950,95280,94950,95280,95110,1130,960,4,38.05,84
,20170904,95280,95110,,,,95110,95110,0,0,0,0.00,84
,20170905,95110,95110,97000,97170,96860,97170,97000,2060,1890,18,174.61,82
,20170906,97170,97000,,,,95500,95500,-1500,-1500,0,0.00,82
,20170907,95500,95500,95800,96940,95560,95920,96110,420,610,66,634.35,80
,20170908,95920,96110,95500,95960,93270,93270,93880,-2840,-2230,52,488.18,108
,20170911,93270,93880,91890,91890,89920,91190,90890,-2690,-2990,190,"1,726.96",246
,20170912,91190,90890,92430,93560,91850,92610,92350,1720,1460,462,"4,266.75",592
,20170913,92610,92350,92260,94260,92260,92950,93360,600,1010,262,"2,446.13",754
,20170914,92950,93360,92100,92300,89050,89050,90700,-4310,-2660,564,"5,115.98",1166
,20170915,89050,90700,89890,89980,87930,88290,89010,-2410,-1690,514,"4,575.29",1282
,20170918,88290,89010,88600,89230,86580,89020,88310,10,-700,834,"7,365.30",1676
,20170919,89020,88310,89090,89640,87700,87920,88580,-390,270,684,"6,059.02",1806
,20170920,87920,88580,87150,90980,87150,90360,88980,1780,400,306,"2,722.89",1796
,20170921,90360,88980,90960,91070,88020,88450,88960,-530,-20,364,"3,238.26",1844
,20170922,88450,88960,88140,89130,83760,84060,85950,-4900,-3010,240,"2,062.95",1924
,20170925,84060,85950,84280,84990,83650,84500,84330,-1450,-1620,128,"1,079.44",1988
,20170926,84500,84330,84830,85810,84360,84940,85320,610,990,424,"3,617.91",2106
,20170927,84940,85320,84740,85760,84460,85250,85140,-70,-180,582,"4,955.50",2252
,20170928,85250,85140,85310,85380,82900,83700,83680,-1440,-1460,504,"4,217.66",2334
,20170929,83700,83680,83940,85260,83570,85000,84760,1320,1080,178,"1,508.80",2348
,20171009,85000,84760,85710,87670,85640,87400,87010,2640,2250,274,"2,384.28",2330
,20171010,87400,87010,87350,88420,87050,87730,88110,720,1100,212,"1,868.03",2362
,20171011,87730,88110,87850,88470,86870,88070,88040,-40,-70,1008,"8,875.36",2634
,20171012,88070,88040,88250,90710,87330,90350,89530,2310,1490,1046,"9,365.76",3008
,20171013,90350,89530,90390,92300,90290,92130,91520,2600,1990,1098,"10,049.03",3158
,20171016,92130,91520,92840,93980,92060,93580,93090,2060,1570,1896,"17,650.95",3326
,20171017,93580,93090,94070,95480,93410,93660,94420,570,1330,990,"9,348.33",3342
,20171018,93660,94420,93920,94880,93110,94880,94130,460,-290,752,"7,079.09",3410
,20171019,94880,94130,94860,95560,93240,94470,94330,340,200,878,"8,282.36",3490
,20171020,94470,94330,94110,97600,93660,97600,95760,3270,1430,826,"7,910.47",3954
,20171023,97600,95760,97380,97760,93890,95070,95380,-690,-380,1012,"9,653.13",4728
,20171024,95070,95380,94860,96710,94610,96530,95990,1150,610,1274,"12,230.35",4916
,20171025,96530,95990,96580,97350,95140,95690,96400,-300,410,1000,"9,640.63",4966
,20171026,95690,96400,95750,96390,95300,95800,95800,-600,-600,566,"5,422.36",4808
,20171027,95800,95800,95770,95840,92490,92720,93750,-3080,-2050,1402,"13,144.27",4112
,20171030,92720,93750,92210,93530,92010,93100,92880,-650,-870,922,"8,563.63",3854
,20171031,93100,92880,92850,95450,92850,95450,93630,2570,750,974,"9,119.95",3558
,20171101,95450,93630,95020,99240,95020,99240,96030,5610,2400,482,"4,629.09",3502
,20171102,99240,96030,101160,102680,100060,101300,101170,5270,5140,730,"7,385.91",3316
,20171103,101300,101170,102530,102530,99230,101450,101240,280,70,1412,"14,296.41",2910
,20171106,101450,101240,101230,103520,100680,103350,102090,2110,850,1300,"13,271.72",2888
,20171107,103350,102090,103180,103310,102000,102890,102670,800,580,1624,"16,674.86",2432
,20171108,102890,102670,102640,102640,100400,101250,101560,-1420,-1110,1278,"12,979.94",2262
,20171109,101250,101560,101370,101840,98560,99250,100460,-2310,-1100,2362,"23,730.92",2144
,20171110,99250,100460,98820,99980,98120,99390,99280,-1070,-1180,2270,"22,538.28",2448
,20171113,99390,99280,99460,99940,97630,99940,99080,660,-200,1884,"18,667.34",2768
,20171114,99940,99080,99610,101490,99070,99290,100290,210,1210,3342,"33,517.16",2758
,20171115,99290,100290,99320,99750,94270,94270,96740,-6020,-3550,5808,"56,188.50",2934
,20171116,94270,96740,94120,94710,93660,93800,94170,-2940,-2570,5086,"47,897.58",3396
,20171117,93800,94170,94200,94880,92510,92540,93560,-1630,-610,2616,"24,477.13",3788
,20171120,92540,93560,92850,93960,92600,93690,93270,130,-290,1608,"14,998.85",4298
,20171121,93690,93270,93500,94830,92850,93970,94140,700,870,2122,"19,977.26",4492
,20171122,93970,94140,94090,95550,94040,94740,94770,600,630,2914,"27,616.41",4122
,20171123,94740,94770,94810,96250,93800,94010,95350,-760,580,2422,"23,095.47",3856
,20171124,94010,95350,93630,96560,93620,96420,95460,1070,110,1742,"16,630.69",3726
,20171127,96420,95460,96470,96880,93090,93660,95350,-1800,-110,1290,"12,300.72",3888
,20171128,93660,95350,93580,94010,91190,91610,92800,-3740,-2550,1104,"10,245.14",4212
,20171129,91610,92800,92060,92490,90720,91620,91740,-1180,-1060,608,"5,578.22",4184
,20171130,91620,91740,91270,92390,89940,90770,91320,-970,-420,994,"9,077.53",4334
,20171201,90770,91320,91050,91250,89370,89910,90190,-1410,-1130,1590,"14,340.22",4326
,20171204,89910,90190,89870,92250,89810,91980,91100,1790,910,894,"8,144.93",4128
,20171205,91980,91100,91860,92580,89950,90040,91280,-1060,180,1154,"10,534.46",4274
,20171206,90040,91280,90010,90010,87230,87870,88260,-3410,-3020,1448,"12,780.60",4548
,20171207,87870,88260,87830,88250,86750,87060,87500,-1200,-760,656,"5,740.39",4768
,20171208,87060,87500,87430,89390,87430,88790,88610,1290,1110,910,"8,063.77",4648
,20171211,88790,88610,88920,89100,87440,87650,88170,-960,-440,908,"8,006.32",5044
,20171212,87650,88170,87770,90040,87740,89390,89140,1220,970,580,"5,170.25",5106
,20171213,89390,89140,90060,90060,88370,89600,89450,460,310,2256,"20,181.32",5192
,20171214,89600,89450,89650,90700,88640,89110,89510,-340,60,1874,"16,774.99",5434
,20171215,89110,89510,89520,90310,89500,89810,89890,300,380,1764,"15,857.97",5570
,20171218,89810,89890,90010,94000,90010,93450,92790,3560,2900,1520,"14,105.08",5324
,20171219,93450,92790,93390,95460,93180,94450,94490,1660,1700,1132,"10,696.84",5148
,20171220,94450,94490,94290,95150,94200,94950,94730,460,240,1084,"10,269.71",5126
,20171221,94950,94730,95760,96780,95010,95630,95710,900,980,1424,"13,630.36",5154
,20171222,95630,95710,96010,96070,94500,95540,95420,-170,-290,1732,"16,528.37",5228
,20171225,95540,95420,95460,97300,94520,94660,96330,-760,910,1146,"11,040.55",5136
,20171226,94660,96330,93850,95430,93830,95240,94530,-1090,-1800,396,"3,743.54",5066
,20171227,95240,94530,95690,95690,93790,94080,94730,-450,200,116,"1,098.95",5046
,20171228,94080,94730,94310,97060,94290,96280,95020,1550,290,1190,"11,307.80",3998
,20171229,96280,95020,96080,97140,95830,96430,96490,1410,1470,234,"2,257.97",4048
ni1804,20170418,83380,83380,,,,83380,83380,0,0,0,0.00,0
,20170419,83380,83380,81140,81140,81140,81140,81140,-2240,-2240,2,16.23,2
,20170420,81140,81140,,,,81140,81140,0,0,0,0.00,2
,20170421,81140,81140,,,,81140,81140,0,0,0,0.00,2
,20170424,81140,81140,,,,81140,81140,0,0,0,0.00,2
,20170425,81140,81140,,,,80730,80730,-410,-410,0,0.00,2
,20170426,80730,80730,,,,80730,80730,0,0,0,0.00,2
,20170427,80730,80730,,,,80730,80730,0,0,0,0.00,2
,20170428,80730,80730,,,,80730,80730,0,0,0,0.00,2
,20170502,80730,80730,,,,80730,80730,0,0,0,0.00,2
,20170503,80730,80730,82180,82180,82180,82180,82180,1450,1450,2,16.44,2
,20170504,82180,82180,,,,79680,79680,-2500,-2500,0,0.00,2
,20170505,79680,79680,,,,79340,79340,-340,-340,0,0.00,2
,20170508,79340,79340,,,,79340,79340,0,0,0,0.00,2
,20170509,79340,79340,,,,79340,79340,0,0,0,0.00,2
,20170510,79340,79340,,,,79340,79340,0,0,0,0.00,2
,20170511,79340,79340,,,,79340,79340,0,0,0,0.00,2
,20170512,79340,79340,,,,79340,79340,0,0,0,0.00,2
,20170515,79340,79340,80790,80800,79190,79190,79860,-150,520,10,79.87,6
,20170516,79190,79860,78900,79090,78900,79090,79010,-770,-850,10,79.02,16
,20170517,79090,79010,78790,79290,78790,79290,78980,280,-30,6,47.39,22
,20170518,79290,78980,79500,79500,77910,77990,78460,-990,-520,6,47.08,28
,20170519,77990,78460,78100,78110,78100,78110,78100,-350,-360,4,31.24,28
,20170522,78110,78100,81000,81000,80280,80620,80780,2520,2680,10,80.78,34
,20170523,80620,80780,,,,80780,80780,0,0,0,0.00,34
,20170524,80780,80780,80490,80490,80490,80490,80490,-290,-290,2,16.10,32
,20170525,80490,80490,,,,80490,80490,0,0,0,0.00,32
,20170526,80490,80490,,,,78890,78890,-1600,-1600,0,0.00,32
,20170531,78890,78890,,,,77560,77560,-1330,-1330,0,0.00,32
,20170601,77560,77560,,,,77560,77560,0,0,0,0.00,32
,20170602,77560,77560,75110,75110,75110,75110,75110,-2450,-2450,2,15.02,30
,20170605,75110,75110,,,,75270,75270,160,160,0,0.00,30
,20170606,75270,75270,,,,75270,75270,0,0,0,0.00,30
,20170607,75270,75270,,,,75270,75270,0,0,0,0.00,30
,20170608,75270,75270,,,,75270,75270,0,0,0,0.00,30
,20170609,75270,75270,,,,75270,75270,0,0,0,0.00,30
,20170612,75270,75270,,,,75270,75270,0,0,0,0.00,30
,20170613,75270,75270,75480,75490,75480,75490,75480,220,210,6,45.29,36
,20170614,75490,75480,,,,75480,75480,0,0,0,0.00,36
,20170615,75480,75480,,,,75480,75480,0,0,0,0.00,36
,20170616,75480,75480,,,,75480,75480,0,0,0,0.00,36
,20170619,75480,75480,,,,76010,76010,530,530,0,0.00,36
,20170620,76010,76010,77680,77680,77000,77000,77300,990,1290,22,170.07,32
,20170621,77000,77300,,,,77300,77300,0,0,0,0.00,32
,20170622,77300,77300,76680,76820,76680,76820,76690,-480,-610,16,122.72,44
,20170623,76820,76690,77240,77240,77240,77240,77240,550,550,2,15.45,42
,20170626,77240,77240,,,,77240,77240,0,0,0,0.00,42
,20170627,77240,77240,77460,77460,77450,77450,77450,210,210,6,46.47,40
,20170628,77450,77450,78290,78290,78290,78290,78290,840,840,2,15.66,40
,20170629,78290,78290,,,,78430,78430,140,140,0,0.00,40
,20170630,78430,78430,,,,78600,78600,170,170,0,0.00,40
,20170703,78600,78600,,,,78600,78600,0,0,0,0.00,40
,20170704,78600,78600,,,,78090,78090,-510,-510,0,0.00,40
,20170705,78090,78090,,,,78090,78090,0,0,0,0.00,40
,20170706,78090,78090,,,,78090,78090,0,0,0,0.00,40
,20170707,78090,78090,,,,78090,78090,0,0,0,0.00,40
,20170710,78090,78090,,,,78090,78090,0,0,0,0.00,40
,20170711,78090,78090,,,,78090,78090,0,0,0,0.00,40
,20170712,78090,78090,,,,78090,78090,0,0,0,0.00,40
,20170713,78090,78090,78110,78110,78110,78110,78110,20,20,2,15.62,42
,20170714,78110,78110,78410,78410,78410,78410,78410,300,300,2,15.68,42
,20170717,78410,78410,79210,80180,79210,80180,79390,1770,980,14,111.15,56
,20170718,80180,79390,81200,81440,80900,80900,81220,1510,1830,8,64.98,58
,20170719,80900,81220,81630,81630,81630,81630,81630,410,410,2,16.33,58
,20170720,81630,81630,81880,81880,81610,81610,81740,-20,110,4,32.70,58
,20170721,81610,81740,81200,81200,80640,80640,80920,-1100,-820,10,80.93,58
,20170724,80640,80920,,,,80920,80920,0,0,0,0.00,58
,20170725,80920,80920,,,,80920,80920,0,0,0,0.00,58
,20170726,80920,80920,,,,81410,81410,490,490,0,0.00,58
,20170727,81410,81410,83610,84060,83610,83990,83920,2580,2510,8,67.14,56
,20170728,83990,83920,,,,83920,83920,0,0,0,0.00,56
,20170731,83920,83920,,,,83920,83920,0,0,0,0.00,56
,20170801,83920,83920,,,,83920,83920,0,0,0,0.00,56
,20170802,83920,83920,84760,84760,84760,84760,84760,840,840,2,16.95,56
,20170803,84760,84760,85510,85510,85510,85510,85510,750,750,4,34.20,60
,20170804,85510,85510,,,,85510,85510,0,0,0,0.00,60
,20170807,85510,85510,,,,85510,85510,0,0,0,0.00,60
,20170808,85510,85510,85910,85910,85910,85910,85910,400,400,2,17.18,60
,20170809,85910,85910,,,,87330,87330,1420,1420,0,0.00,60
,20170810,87330,87330,89450,89450,89450,89450,89450,2120,2120,2,17.89,62
,20170811,89450,89450,89940,90430,89830,90430,90020,980,570,14,126.03,66
,20170814,90430,90020,87830,87830,87830,87830,87830,-2190,-2190,2,17.57,66
,20170815,87830,87830,,,,87830,87830,0,0,0,0.00,66
,20170816,87830,87830,,,,87830,87830,0,0,0,0.00,66
,20170817,87830,87830,89270,89270,89270,89270,89270,1440,1440,14,124.98,56
,20170818,89270,89270,,,,89270,89270,0,0,0,0.00,56
,20170821,89270,89270,92190,92190,92190,92190,92190,2920,2920,2,18.44,56
,20170822,92190,92190,93310,94060,93310,94060,93970,1870,1780,18,169.16,72
,20170823,94060,93970,94380,94380,93810,93810,93900,-160,-70,18,169.03,62
,20170824,93810,93900,94270,95620,94270,95620,94570,1720,670,18,170.23,66
,20170825,95620,94570,95580,95580,95580,95580,95580,1010,1010,2,19.12,68
,20170828,95580,95580,94170,94490,94170,94490,94230,-1090,-1350,10,94.23,72
,20170829,94490,94230,,,,94230,94230,0,0,0,0.00,72
,20170830,94230,94230,,,,94230,94230,0,0,0,0.00,72
,20170831,94230,94230,94490,94490,94490,94490,94490,260,260,4,37.80,68
,20170901,94490,94490,95110,95730,95110,95730,95520,1240,1030,6,57.31,68
,20170904,95730,95520,,,,95520,95520,0,0,0,0.00,68
,20170905,95520,95520,,,,95520,95520,0,0,0,0.00,68
,20170906,95520,95520,,,,95520,95520,0,0,0,0.00,68
,20170907,95520,95520,95680,96720,95680,96720,96200,1200,680,4,38.48,68
,20170908,96720,96200,96000,96690,96000,96690,96340,490,140,8,77.08,70
,20170911,96690,96340,92600,92600,90550,90550,91290,-5790,-5050,18,164.33,80
,20170912,90550,91290,92420,92420,92420,92420,92420,1130,1130,2,18.48,78
,20170913,92420,92420,,,,92420,92420,0,0,0,0.00,78
,20170914,92420,92420,91850,91850,91800,91800,91820,-620,-600,4,36.73,74
,20170915,91800,91820,89120,89120,89120,89120,89120,-2700,-2700,8,71.30,82
,20170918,89120,89120,,,,89120,89120,0,0,0,0.00,82
,20170919,89120,89120,,,,89120,89120,0,0,0,0.00,82
,20170920,89120,89120,87690,91020,87690,91020,89740,1900,620,10,89.74,88
,20170921,91020,89740,90800,91090,87890,88760,89630,-980,-110,8,71.71,90
,20170922,88760,89630,,,,86600,86600,-3030,-3030,0,0.00,90
,20170925,86600,86600,85040,85160,85040,85160,85070,-1440,-1530,8,68.06,98
,20170926,85160,85070,,,,85070,85070,0,0,0,0.00,98
,20170927,85070,85070,85070,85560,85070,85560,85390,490,320,6,51.24,96
,20170928,85560,85390,85390,85390,83640,83640,84700,-1750,-690,20,169.42,100
,20170929,83640,84700,82680,82680,82680,82680,82680,-2020,-2020,2,16.54,100
,20171009,82680,82680,87100,87100,87100,87100,87100,4420,4420,2,17.42,100
,20171010,87100,87100,88000,88000,87750,87750,87950,650,850,10,87.95,92
,20171011,87750,87950,,,,87950,87950,0,0,0,0.00,92
,20171012,87950,87950,,,,89550,89550,1600,1600,0,0.00,92
,20171013,89550,89550,90490,90490,90490,90490,90490,940,940,2,18.10,94
,20171016,90490,90490,93830,93830,93830,93830,93830,3340,3340,2,18.77,92
,20171017,93830,93830,94760,95720,94470,94630,94850,800,1020,24,227.66,86
,20171018,94630,94850,93370,94860,93370,94100,94140,-750,-710,20,188.29,80
,20171019,94100,94140,94200,94200,93710,93710,94030,-430,-110,12,112.84,92
,20171020,93710,94030,97130,97130,97130,97130,97130,3100,3100,2,19.43,92
,20171023,97130,97130,,,,97130,97130,0,0,0,0.00,92
,20171024,97130,97130,96590,96590,96590,96590,96590,-540,-540,8,77.27,84
,20171025,96590,96590,,,,96590,96590,0,0,0,0.00,84
,20171026,96590,96590,,,,95990,95990,-600,-600,0,0.00,84
,20171027,95990,95990,94730,94730,93660,93660,94040,-2330,-1950,30,282.14,74
,20171030,93660,94040,93190,93190,93190,93190,93190,-850,-850,2,18.64,74
,20171031,93190,93190,,,,93190,93190,0,0,0,0.00,74
,20171101,93190,93190,95720,95800,95490,95800,95680,2610,2490,8,76.55,70
,20171102,95800,95680,101420,101420,100020,101420,100940,5740,5260,72,726.84,96
,20171103,101420,100940,101530,101600,100790,101260,101420,320,480,24,243.43,100
,20171106,101260,101420,102400,102400,102400,102400,102400,980,980,2,20.48,102
,20171107,102400,102400,103510,103510,102620,102960,103050,560,650,12,123.67,98
,20171108,102960,103050,,,,102610,102610,-440,-440,0,0.00,98
,20171109,102610,102610,99020,99020,99000,99000,99000,-3610,-3610,6,59.40,94
,20171110,99000,99000,99920,99920,99920,99920,99920,920,920,2,19.98,94
,20171113,99920,99920,99280,99470,98350,99410,98770,-510,-1150,74,730.92,98
,20171114,99410,98770,99690,100690,99650,100690,99990,1920,1220,8,79.99,96
,20171115,100690,99990,99850,99850,94770,94770,97420,-5220,-2570,42,409.19,102
,20171116,94770,97420,93970,94950,93730,93830,94290,-3590,-3130,202,"1,904.83",122
,20171117,93830,94290,93040,93040,92380,92380,92710,-1910,-1580,12,111.25,122
,20171120,92380,92710,92370,93720,92370,93100,93070,390,360,26,241.99,108
,20171121,93100,93070,,,,93070,93070,0,0,0,0.00,108
,20171122,93070,93070,,,,93070,93070,0,0,0,0.00,108
,20171123,93070,93070,95110,95300,95110,95300,95170,2230,2100,6,57.10,102
,20171124,95300,95170,,,,95280,95280,110,110,0,0.00,102
,20171127,95280,95280,95830,95830,93700,93700,94410,-1580,-870,6,56.65,104
,20171128,93700,94410,93720,94180,91350,91350,92130,-3060,-2280,30,276.39,104
,20171129,91350,92130,92020,92250,91640,92080,91970,-50,-160,146,"1,342.77",112
,20171130,92080,91970,91200,91640,90380,90770,91080,-1200,-890,22,200.38,110
,20171201,90770,91080,91010,91010,91010,91010,91010,-70,-70,12,109.21,106
,20171204,91010,91010,,,,91010,91010,0,0,0,0.00,106
,20171205,91010,91010,92300,92300,90030,90030,91340,-980,330,34,310.57,92
,20171206,90030,91340,88050,88110,87200,87900,87780,-3440,-3560,18,158.01,82
,20171207,87900,87780,,,,87780,87780,0,0,0,0.00,82
,20171208,87780,87780,88800,89340,88800,88910,88930,1130,1150,10,88.93,78
,20171211,88910,88930,,,,88930,88930,0,0,0,0.00,78
,20171212,88930,88930,,,,88930,88930,0,0,0,0.00,78
,20171213,88930,88930,90340,90340,89380,89380,89810,450,880,8,71.85,80
,20171214,89380,89810,89170,89930,89160,89930,89490,120,-320,26,232.67,88
,20171215,89930,89490,89640,89980,89640,89880,89820,390,330,20,179.65,92
,20171218,89880,89820,,,,90310,90310,490,490,0,0.00,92
,20171219,90310,90310,93910,94970,93380,94160,93790,3850,3480,74,694.12,102
,20171220,94160,93790,,,,93790,93790,0,0,0,0.00,102
,20171221,93790,93790,95430,95430,95430,95430,95430,1640,1640,2,19.09,102
,20171222,95430,95430,,,,95430,95430,0,0,0,0.00,102
,20171225,95430,95430,96300,96380,96290,96380,96320,950,890,12,115.59,98
,20171226,96380,96320,94430,95610,94430,95610,94970,-710,-1350,16,151.96,104
,20171227,95610,94970,95810,95810,93840,93840,94890,-1130,-80,10,94.89,102
,20171228,93840,94890,95780,95780,95780,95780,95780,890,890,4,38.31,106
,20171229,95780,95780,96100,96910,96100,96880,96630,1100,850,14,135.29,102
ni1805,20170516,79860,79860,80500,80550,79280,79510,79730,-350,-130,98,781.41,56
,20170517,79510,79730,79470,80300,79470,79860,79900,130,170,52,415.49,82
,20170518,79860,79900,80000,80440,78500,78750,79270,-1150,-630,116,919.57,130
,20170519,78750,79270,78560,79790,78350,79590,79190,320,-80,144,"1,140.42",158
,20170522,79590,79190,80130,81970,79960,81300,81200,2110,2010,100,812.09,190
,20170523,81300,81200,81650,81800,80880,80880,81380,-320,180,50,406.92,196
,20170524,80880,81380,80890,81040,79000,79590,80480,-1790,-900,132,"1,062.41",248
,20170525,79590,80480,79390,79630,78930,79190,79240,-1290,-1240,56,443.80,282
,20170526,79190,79240,79090,79140,78260,78400,78580,-840,-660,280,"2,200.31",440
,20170531,78400,78580,78840,81600,75820,75930,77470,-2650,-1110,728,"5,640.14",626
,20170601,75930,77470,76000,76760,75750,76010,76220,-1460,-1250,104,792.70,682
,20170602,76010,76220,76410,76410,75000,75150,75400,-1070,-820,546,"4,117.11",922
,20170605,75150,75400,75330,76650,75250,76210,75980,810,580,182,"1,383.02",912
,20170606,76210,75980,76170,76530,75850,76290,76360,310,380,2028,"15,486.97",2040
,20170607,76290,76360,76040,77370,76040,76650,76810,290,450,1948,"14,963.84",2866
,20170608,76650,76810,76610,76940,75400,76450,76250,-360,-560,2602,"19,841.51",4266
,20170609,76450,76250,76180,76480,75900,76170,76210,-80,-40,1156,"8,810.72",4836
,20170612,76170,76210,76260,77570,76260,77200,76970,990,760,1052,"8,097.90",5286
,20170613,77200,76970,77150,77150,75600,75950,76020,-1020,-950,1960,"14,901.03",6430
,20170614,75950,76020,75810,76620,74910,76360,75820,340,-200,2294,"17,393.25",7342
,20170615,76360,75820,76500,76780,75800,76520,76380,700,560,602,"4,598.13",7494
,20170616,76520,76380,76410,77190,76110,76810,76700,430,320,472,"3,620.43",7516
,20170619,76810,76700,76930,77410,76060,77110,76840,410,140,1740,"13,371.71",7342
,20170620,77110,76840,77220,78570,77080,77510,77650,670,810,9038,"70,185.63",4682
,20170621,77510,77650,77380,77410,76000,76880,76760,-770,-890,600,"4,605.81",4896
,20170622,76880,76760,77200,77530,76560,76700,77190,-60,430,536,"4,137.53",5028
,20170623,76700,77190,76890,78460,76830,78280,77730,1090,540,554,"4,306.69",5014
,20170626,78280,77730,78290,78380,77840,78100,78140,370,410,1012,"7,908.37",5160
,20170627,78100,78140,78260,78300,77270,78080,77770,-60,-370,516,"4,013.23",5266
,20170628,78080,77770,78280,79000,78260,78740,78650,970,880,368,"2,894.35",5414
,20170629,78740,78650,78460,79740,78400,79600,79240,950,590,348,"2,757.83",5436
,20170630,79600,79240,79500,79720,78770,79320,79250,80,10,454,"3,598.20",5484
,20170703,79320,79250,79340,80400,79200,80050,79830,800,580,664,"5,301.37",5652
,20170704,80050,79830,80030,80090,77800,77980,78760,-1850,-1070,1914,"15,076.53",5996
,20170705,77980,78760,78050,78640,77850,77870,78250,-890,-510,422,"3,302.55",6158
,20170706,77870,78250,77730,78180,77430,78100,77790,-150,-460,506,"3,936.49",6278
,20170707,78100,77790,78180,78230,77000,77510,77420,-280,-370,890,"6,891.11",6532
,20170710,77510,77420,77200,77320,76140,76320,76660,-1100,-760,1284,"9,844.24",6894
,20170711,76320,76660,76230,77300,75900,77260,76570,600,-90,676,"5,176.44",7052
,20170712,77260,76570,77190,78800,77190,78530,78170,1960,1600,1354,"10,584.99",7046
,20170713,78530,78170,78480,79160,78150,78840,78650,670,480,1730,"13,606.65",7582
,20170714,78840,78650,78550,79020,77910,78950,78460,300,-190,1268,"9,949.04",7596
,20170717,78950,78460,79260,81160,79140,80750,80140,2290,1680,3350,"26,850.24",7670
,20170718,80750,80140,81000,81760,80500,80900,81180,760,1040,1156,"9,384.42",7726
,20170719,80900,81180,81000,82040,80990,81900,81560,720,380,1034,"8,433.73",7806
,20170720,81900,81560,81800,82010,80970,81290,81400,-270,-160,1052,"8,563.68",7718
,20170721,81290,81400,81260,81520,80280,81000,80930,-400,-470,1108,"8,967.86",8080
,20170724,81000,80930,81390,81800,80080,81450,81090,520,160,1106,"8,968.59",8194
,20170725,81450,81090,81600,83760,81450,83760,82620,2670,1530,910,"7,519.20",8356
,20170726,83760,82620,83770,85040,83360,83730,84110,1110,1490,1478,"12,431.47",8264
,20170727,83730,84110,83920,84830,83570,84800,84330,690,220,1250,"10,542.05",8352
,20170728,84800,84330,84890,85610,83890,85120,84810,790,480,1766,"14,977.83",8210
,20170731,85120,84810,85670,86560,84400,85870,85860,1060,1050,1298,"11,145.88",8274
,20170801,85870,85860,85620,86170,84460,84910,85050,-950,-810,948,"8,063.27",8380
,20170802,84910,85050,84800,85910,84520,84870,85180,-180,130,906,"7,717.79",8522
,20170803,84870,85180,85170,87110,85070,85570,86190,390,1010,1814,"15,635.88",8818
,20170804,85570,86190,85990,86800,85550,86800,86210,610,20,1122,"9,673.11",9054
,20170807,86800,86210,86670,86970,84800,86040,85930,-170,-280,2582,"22,187.29",9166
,20170808,86040,85930,86270,86890,85580,85620,86260,-310,330,1500,"12,940.43",9396
,20170809,85620,86260,85880,90290,85660,89540,88690,3280,2430,2638,"23,398.98",9686
,20170810,89540,88690,89620,89730,88880,89400,89370,710,680,1436,"12,833.87",9690
,20170811,89400,89370,89280,90780,86520,88200,89180,-1170,-190,3394,"30,269.88",9388
,20170814,88200,89180,88210,88830,87380,87670,88120,-1510,-1060,1532,"13,500.94",9594
,20170815,87670,88120,87450,87530,85680,86790,86690,-1330,-1430,2978,"25,818.30",10404
,20170816,86790,86690,86470,87190,86060,86820,86520,130,-170,2348,"20,316.96",10986
,20170817,86820,86520,87500,89830,87500,89280,89010,2760,2490,2456,"21,861.32",11012
,20170818,89280,89010,88980,89700,88020,89550,89050,540,40,2624,"23,368.90",11446
,20170821,89550,89050,89680,93000,89400,92460,91260,3410,2210,6768,"61,767.03",12840
,20170822,92460,91260,92790,93880,92400,93830,93030,2570,1770,3614,"33,623.59",13136
,20170823,93830,93030,94500,94710,92150,93670,93570,640,540,5392,"50,457.48",14182
,20170824,93670,93570,94030,96360,93510,95300,95090,1730,1520,6958,"66,167.90",15506
,20170825,95300,95090,95360,96140,94950,95400,95520,310,430,6306,"60,237.58",16896
,20170828,95400,95520,95400,95520,91760,94870,94230,-650,-1290,6978,"65,759.37",17256
,20170829,94870,94230,94870,96670,94180,95370,95710,1140,1480,6492,"62,141.14",17220
,20170830,95370,95710,95930,96300,94000,94620,95080,-1090,-630,5730,"54,481.27",18122
,20170831,94620,95080,93990,94970,93670,94830,94300,-250,-780,5736,"54,092.04",18598
,20170901,94830,94300,94830,96210,94540,95860,95440,1560,1140,5346,"51,027.52",19452
,20170904,95860,95440,96210,98720,95560,97610,97320,2170,1880,9200,"89,539.26",20132
,20170905,97610,97320,97610,98100,97100,97840,97690,520,370,6852,"66,940.27",20642
,20170906,97840,97690,97790,97860,95130,96030,96550,-1660,-1140,9264,"89,446.67",21286
,20170907,96030,96550,96220,98170,95640,96530,96910,-20,360,9542,"92,475.45",22112
,20170908,96530,96910,96530,97390,93130,93620,95540,-3290,-1370,14260,"136,254.08",22802
,20170911,93620,95540,93490,93520,90050,92270,91600,-3270,-3940,20512,"187,900.46",22448
,20170912,92270,91600,92450,93850,92160,93220,92960,1620,1360,18170,"168,908.93",21764
,20170913,93220,92960,92670,94920,92300,93510,94010,550,1050,15726,"147,840.77",21600
,20170914,93510,94010,92200,93040,89370,89510,91240,-4500,-2770,18628,"169,976.34",23414
,20170915,89510,91240,90400,90560,88390,88850,89620,-2390,-1620,16292,"146,018.65",25596
,20170918,88850,89620,88490,89870,86700,89540,88700,-80,-920,18678,"165,688.03",26162
,20170919,89540,88700,89420,90240,88150,88240,89210,-460,510,19862,"177,193.85",28944
,20170920,88240,89210,88210,91320,87360,90720,89540,1510,330,18702,"167,474.54",32700
,20170921,90720,89540,90830,91600,88310,88830,89890,-710,350,23500,"211,261.43",38210
,20170922,88830,89890,88240,89780,84490,84490,86570,-5400,-3320,40632,"351,768.92",47094
,20170925,84490,86570,84800,85690,83900,84750,84820,-1820,-1750,40626,"344,615.47",54946
,20170926,84750,84820,84580,86110,84520,85220,85360,400,540,28634,"244,437.55",59000
,20170927,85220,85360,84840,85920,84500,85380,85230,20,-130,35848,"305,544.60",66008
,20170928,85380,85230,85360,85570,82880,83680,84040,-1550,-1190,50468,"424,182.87",70392
,20170929,83680,84040,83550,85410,83500,85050,84740,1010,700,44060,"373,370.77",81884
,20171009,85050,84740,85750,87810,85600,87650,86930,2910,2190,39008,"339,118.72",88030
,20171010,87650,86930,87760,88970,87210,87820,88220,890,1290,46496,"410,198.75",92444
,20171011,87820,88220,87980,88880,86930,88420,88220,200,0,43870,"387,024.27",93820
,20171012,88420,88220,88550,91030,87510,90660,89840,2440,1620,68820,"618,333.96",103270
,20171013,90660,89840,90450,92590,90330,92500,91600,2660,1760,56954,"521,707.66",110252
,20171016,92500,91600,93300,94230,92150,93820,93270,2220,1670,83618,"779,971.98",121258
,20171017,93820,93270,94490,95840,93510,93930,94890,660,1620,151180,"1,434,550.91",154168
,20171018,93930,94890,94130,95300,93330,95230,94410,340,-480,89148,"841,654.62",166442
,20171019,95230,94410,95200,96000,93400,94600,94700,190,290,133250,"1,261,967.06",175978
,20171020,94600,94700,94490,98180,93840,98070,95740,3370,1040,122610,"1,173,915.30",191622
,20171023,98070,95740,97860,98290,94000,95150,95600,-590,-140,191040,"1,826,431.96",191174
,20171024,95150,95600,95300,97060,94700,96970,96210,1370,610,197856,"1,903,620.31",219392
,20171025,96970,96210,97000,97770,95300,95900,96580,-310,370,163490,"1,578,986.61",225890
,20171026,95900,96580,96120,96720,95540,96060,96120,-520,-460,120162,"1,155,029.69",231434
,20171027,96060,96120,96240,96300,92820,93040,94310,-3080,-1810,221532,"2,089,386.34",236084
,20171030,93040,94310,92560,93900,92310,93110,93140,-1200,-1170,147730,"1,376,032.13",241488
,20171031,93110,93140,93460,96040,93150,95810,94390,2670,1250,188434,"1,778,783.50",270332
,20171101,95810,94390,95700,100050,95480,100050,97100,5660,2710,150742,"1,463,787.28",294266
,20171102,100050,97100,101550,103290,100420,102100,101650,5000,4550,397090,"4,036,532.48",320608
,20171103,102100,101650,101700,102490,99430,101920,101320,270,-330,361392,"3,661,779.21",332830
,20171106,101920,101320,101800,103990,100860,103820,102430,2500,1110,363374,"3,722,156.39",363296
,20171107,103820,102430,103850,103880,102500,103620,103270,1190,840,275154,"2,841,776.22",372484
,20171108,103620,103270,103200,103320,100500,101640,101830,-1630,-1440,432422,"4,403,426.87",366496
,20171109,101640,101830,101640,102430,98900,99620,100790,-2210,-1040,484612,"4,884,642.20",358974
,20171110,99620,100790,99080,100480,98460,99890,99620,-900,-1170,387724,"3,862,852.78",384484
,20171113,99890,99620,100170,100690,98000,100610,99440,990,-180,569746,"5,665,948.27",432102
,20171114,100610,99440,100300,102090,98980,99610,100700,170,1260,722264,"7,273,909.00",460264
,20171115,99610,100700,99600,100250,94650,94650,96590,-6050,-4110,1020166,"9,853,873.97",415680
,20171116,94650,96590,94060,94940,93810,94060,94380,-2530,-2210,555910,"5,246,717.27",440942
,20171117,94060,94380,94280,95200,92550,92750,93630,-1630,-750,729388,"6,829,926.84",446794
,20171120,92750,93630,92980,94200,92720,93850,93490,220,-140,562330,"5,257,276.91",450508
,20171121,93850,93490,93780,95040,92770,94270,94230,780,740,744220,"7,012,833.23",452852
,20171122,94270,94230,94400,95880,94220,95010,95070,780,840,694380,"6,602,149.39",453118
,20171123,95010,95070,94800,96590,94060,94220,95660,-850,590,737944,"7,059,808.45",459164
,20171124,94220,95660,94370,97090,93100,96880,95500,1220,-160,766624,"7,321,711.18",477402
,20171127,96880,95500,96810,97510,93340,94050,95730,-1450,230,820532,"7,855,753.06",468650
,20171128,94050,95730,93980,94370,91340,92110,92860,-3620,-2870,856704,"7,955,911.69",505722
,20171129,92110,92860,92050,92850,90820,91710,91990,-1150,-870,750210,"6,901,801.87",520318
,20171130,91710,91990,91590,92470,90110,91070,91560,-920,-430,882386,"8,079,837.33",522160
,20171201,91070,91560,91300,91590,89570,90150,90600,-1410,-960,828688,"7,508,540.17",536670
,20171204,90150,90600,89660,92680,89660,92370,91450,1770,850,1098330,"10,044,387.58",540244
,20171205,92370,91450,92370,92860,90130,90450,91580,-1000,130,880782,"8,066,813.99",541806
,20171206,90450,91580,90400,90510,87410,88000,88600,-3580,-2980,1073438,"9,511,444.52",541218
,20171207,88000,88600,88000,88580,86890,87410,87830,-1190,-770,727326,"6,388,241.27",545794
,20171208,87410,87830,87550,89510,87540,89120,88680,1290,850,847188,"7,513,616.06",548842
,20171211,89120,88680,89200,89550,87600,87850,88460,-830,-220,826928,"7,315,192.29",558502
,20171212,87850,88460,88160,90390,87950,89610,89460,1150,1000,827532,"7,403,379.67",548384
,20171213,89610,89460,89850,90500,88360,89820,89630,360,170,715744,"6,415,842.00",547330
,20171214,89820,89630,89900,90950,88610,89210,89810,-420,180,793088,"7,122,755.44",549136
,20171215,89210,89810,89450,90480,89390,90110,89980,300,170,609468,"5,484,168.05",543076
,20171218,90110,89980,90380,94340,90100,93740,92660,3760,2680,1246374,"11,549,416.61",533474
,20171219,93740,92660,93800,95740,93290,94650,94660,1990,2000,879420,"8,325,323.09",530108
,20171220,94650,94660,94800,95350,94250,95130,94880,470,220,638360,"6,056,805.86",535476
,20171221,95130,94880,95730,96990,95150,95740,95930,860,1050,876622,"8,409,794.48",536736
,20171222,95740,95930,96110,96280,94520,95890,95620,-40,-310,704014,"6,732,142.22",529120
,20171225,95890,95620,95940,97650,94800,95060,96480,-560,860,795058,"7,670,951.25",529004
,20171226,95060,96480,95080,95830,94020,95630,94850,-850,-1630,587488,"5,572,631.27",526066
,20171227,95630,94850,95720,96190,93900,94590,95060,-260,210,650904,"6,187,736.54",518078
,20171228,94590,95060,94940,97480,94480,96810,95990,1750,930,874524,"8,395,309.51",539596
,20171229,96810,95990,96560,97610,96160,96870,96880,880,890,799816,"7,749,209.30",506260
ni1806,20170616,76380,76380,77090,77820,75510,75520,76480,-860,100,8,61.19,2
,20170619,75520,76480,,,,76480,76480,0,0,0,0.00,2
,20170620,76480,76480,,,,76480,76480,0,0,0,0.00,2
,20170621,76480,76480,,,,76480,76480,0,0,0,0.00,2
,20170622,76480,76480,,,,76480,76480,0,0,0,0.00,2
,20170623,76480,76480,,,,76500,76500,20,20,0,0.00,2
,20170626,76500,76500,78130,78230,77540,78200,77940,1700,1440,70,545.58,62
,20170627,78200,77940,78050,78480,77700,78480,78040,540,100,64,499.48,10
,20170628,78480,78040,79550,79550,78830,78830,79190,790,1150,4,31.68,12
,20170629,78830,79190,,,,79790,79790,600,600,0,0.00,12
,20170630,79790,79790,,,,79790,79790,0,0,0,0.00,12
,20170703,79790,79790,,,,79790,79790,0,0,0,0.00,12
,20170704,79790,79790,,,,79790,79790,0,0,0,0.00,12
,20170705,79790,79790,,,,79790,79790,0,0,0,0.00,12
,20170706,79790,79790,,,,79790,79790,0,0,0,0.00,12
,20170707,79790,79790,,,,79790,79790,0,0,0,0.00,12
,20170710,79790,79790,,,,79790,79790,0,0,0,0.00,12
,20170711,79790,79790,,,,79790,79790,0,0,0,0.00,12
,20170712,79790,79790,,,,79790,79790,0,0,0,0.00,12
,20170713,79790,79790,78910,78910,78910,78910,78910,-880,-880,6,47.35,18
,20170714,78910,78910,78620,78640,78620,78640,78630,-270,-280,4,31.45,20
,20170717,78640,78630,79740,80910,79740,80910,80260,2280,1630,30,240.80,32
,20170718,80910,80260,81630,81660,81010,81010,81450,750,1190,8,65.16,32
,20170719,81010,81450,81730,82410,81730,82410,82070,960,620,4,32.83,32
,20170720,82410,82070,81920,81920,81140,81140,81650,-930,-420,6,48.99,36
,20170721,81140,81650,81470,81470,80550,81030,80850,-620,-800,16,129.36,46
,20170724,81030,80850,80740,80740,80740,80740,80740,-110,-110,2,16.15,44
,20170725,80740,80740,,,,80740,80740,0,0,0,0.00,44
,20170726,80740,80740,85130,85130,84410,84410,84770,3670,4030,4,33.91,46
,20170727,84410,84770,84600,84750,84600,84750,84670,-20,-100,4,33.87,44
,20170728,84750,84670,,,,84670,84670,0,0,0,0.00,44
,20170731,84670,84670,,,,84700,84700,30,30,0,0.00,44
,20170801,84700,84700,86060,86060,86060,86060,86060,1360,1360,2,17.21,44
,20170802,86060,86060,85440,85440,85250,85250,85340,-810,-720,4,34.14,44
,20170803,85250,85340,,,,85340,85340,0,0,0,0.00,44
,20170804,85340,85340,,,,85750,85750,410,410,0,0.00,44
,20170807,85750,85750,,,,85750,85750,0,0,0,0.00,44
,20170808,85750,85750,,,,85750,85750,0,0,0,0.00,44
,20170809,85750,85750,,,,88580,88580,2830,2830,0,0.00,44
,20170810,88580,88580,,,,88580,88580,0,0,0,0.00,44
,20170811,88580,88580,89950,89950,89950,89950,89950,1370,1370,6,53.97,50
,20170814,89950,89950,,,,89080,89080,-870,-870,0,0.00,50
,20170815,89080,89080,86700,88010,86700,86830,87120,-2250,-1960,8,69.70,52
,20170816,86830,87120,86820,86820,86820,86820,86820,-300,-300,2,17.36,52
,20170817,86820,86820,,,,86820,86820,0,0,0,0.00,52
,20170818,86820,86820,,,,86820,86820,0,0,0,0.00,52
,20170821,86820,86820,,,,88970,88970,2150,2150,0,0.00,52
,20170822,88970,88970,,,,90700,90700,1730,1730,0,0.00,52
,20170823,90700,90700,93260,94190,93260,94190,93830,3490,3130,6,56.30,56
,20170824,94190,93830,,,,93830,93830,0,0,0,0.00,56
,20170825,93830,93830,95730,95730,95730,95730,95730,1900,1900,4,38.29,52
,20170828,95730,95730,93790,93790,93790,93790,93790,-1940,-1940,4,37.52,48
,20170829,93790,93790,,,,94140,94140,350,350,0,0.00,48
,20170830,94140,94140,,,,93520,93520,-620,-620,0,0.00,48
,20170831,93520,93520,,,,92750,92750,-770,-770,0,0.00,48
,20170901,92750,92750,95620,95930,95500,95930,95670,3180,2920,8,76.54,46
,20170904,95930,95670,96990,96990,96990,96990,96990,1320,1320,2,19.40,46
,20170905,96990,96990,,,,96990,96990,0,0,0,0.00,46
,20170906,96990,96990,97780,97780,95990,96020,96640,-970,-350,16,154.64,52
,20170907,96020,96640,96390,97580,96060,97580,96670,940,30,6,58.01,56
,20170908,97580,96670,96030,97510,94080,94080,95790,-2590,-880,22,210.76,58
,20170911,94080,95790,,,,91840,91840,-3950,-3950,0,0.00,58
,20170912,91840,91840,,,,91910,91910,70,70,0,0.00,58
,20170913,91910,91910,94780,94780,94780,94780,94780,2870,2870,4,37.91,58
,20170914,94780,94780,92240,92240,92240,92240,92240,-2540,-2540,2,18.45,58
,20170915,92240,92240,,,,90600,90600,-1640,-1640,0,0.00,58
,20170918,90600,90600,,,,90600,90600,0,0,0,0.00,58
,20170919,90600,90600,,,,90600,90600,0,0,0,0.00,58
,20170920,90600,90600,90220,91230,90180,91230,90610,630,10,10,90.61,56
,20170921,91230,90610,90920,90920,90920,90920,90920,310,310,4,36.37,60
,20170922,90920,90920,,,,87560,87560,-3360,-3360,0,0.00,60
,20170925,87560,87560,85550,85560,84650,84650,85370,-2910,-2190,10,85.38,60
,20170926,84650,85370,85550,85840,85340,85840,85640,470,270,8,68.51,66
,20170927,85840,85640,,,,85640,85640,0,0,0,0.00,66
,20170928,85640,85640,85640,85640,85640,85640,85640,0,0,6,51.38,72
,20170929,85640,85640,84710,84710,84710,84710,84710,-930,-930,2,16.94,74
,20171009,84710,84710,,,,84710,84710,0,0,0,0.00,74
,20171010,84710,84710,,,,85960,85960,1250,1250,0,0.00,74
,20171011,85960,85960,,,,85960,85960,0,0,0,0.00,74
,20171012,85960,85960,91110,91110,91110,91110,91110,5150,5150,2,18.22,76
,20171013,91110,91110,91900,92820,91900,92800,92410,1690,1300,8,73.93,80
,20171016,92800,92410,,,,92820,92820,410,410,0,0.00,80
,20171017,92820,92820,95350,95790,94470,95050,95320,2230,2500,28,266.91,74
,20171018,95050,95320,94550,94550,94500,94500,94530,-820,-790,6,56.72,80
,20171019,94500,94530,,,,94530,94530,0,0,0,0.00,80
,20171020,94530,94530,94650,98140,94650,98140,96410,3610,1880,8,77.13,84
,20171023,98140,96410,95000,95320,95000,95320,95240,-1090,-1170,8,76.19,84
,20171024,95320,95240,96760,96760,96760,96760,96760,1520,1520,2,19.35,82
,20171025,96760,96760,97370,97370,97240,97240,97300,480,540,4,38.92,84
,20171026,97240,97300,95910,96410,95910,96410,96160,-890,-1140,4,38.46,82
,20171027,96410,96160,95310,95310,95310,95310,95310,-850,-850,2,19.06,82
,20171030,95310,95310,93730,93730,93510,93510,93620,-1800,-1690,4,37.45,80
,20171031,93510,93620,93630,96040,93630,96040,94490,2420,870,8,75.60,74
,20171101,96040,94490,95990,96770,95920,96620,96320,2130,1830,104,"1,001.78",70
,20171102,96620,96320,102000,102090,100750,101240,101660,4920,5340,78,793.01,104
,20171103,101240,101660,101920,102380,100860,102380,101740,720,80,18,183.14,104
,20171106,102380,101740,101510,103310,101180,101420,101950,-320,210,32,326.26,112
,20171107,101420,101950,103510,103510,103370,103370,103410,1420,1460,14,144.78,108
,20171108,103370,103410,102860,103400,101310,102120,102690,-1290,-720,18,184.85,102
,20171109,102120,102690,102170,102170,99140,99500,99810,-3190,-2880,26,259.52,104
,20171110,99500,99810,99380,100360,98900,100360,99590,550,-220,8,79.68,104
,20171113,100360,99590,98800,99220,98800,99220,99110,-370,-480,8,79.29,102
,20171114,99220,99110,100000,101890,100000,100020,100920,910,1810,20,201.85,90
,20171115,100020,100920,99830,100200,95070,95470,98060,-5450,-2860,32,313.81,88
,20171116,95470,98060,,,,97070,97070,-990,-990,0,0.00,88
,20171117,97070,97070,93740,93740,93330,93330,93520,-3740,-3550,10,93.52,84
,20171120,93330,93520,93430,93500,92910,93500,93210,-20,-310,64,596.55,92
,20171121,93500,93210,93750,95240,93200,94580,94080,1370,870,10,94.09,94
,20171122,94580,94080,,,,94080,94080,0,0,0,0.00,94
,20171123,94080,94080,96680,96680,95250,95300,95880,1220,1800,8,76.71,94
,20171124,95300,95880,94410,94410,94410,94410,94410,-1470,-1470,2,18.88,94
,20171127,94410,94410,94430,94430,90740,90740,91840,-3670,-2570,12,110.21,106
,20171128,90740,91840,95010,95020,91690,91800,92680,-40,840,106,982.43,140
,20171129,91800,92680,92150,92500,91800,91960,92140,-720,-540,64,589.73,128
,20171130,91960,92140,92010,93000,92010,92680,92210,540,70,36,331.96,128
,20171201,92680,92210,90660,91750,89770,89770,90820,-2440,-1390,110,999.09,172
,20171204,89770,90820,89450,92600,89450,92600,90780,1780,-40,328,"2,977.90",170
,20171205,92600,90780,92030,92030,91400,91470,91660,690,880,30,274.99,154
,20171206,91470,91660,90350,90350,87640,87960,88760,-3700,-2900,20,177.54,138
,20171207,87960,88760,87420,87420,87420,87420,87420,-1340,-1340,2,17.48,136
,20171208,87420,87420,88390,89580,88310,88920,88890,1500,1470,44,391.15,124
,20171211,88920,88890,88050,88050,88050,88050,88050,-840,-840,8,70.44,116
,20171212,88050,88050,,,,88050,88050,0,0,0,0.00,116
,20171213,88050,88050,90420,90760,89700,90210,90490,2160,2440,52,470.58,152
,20171214,90210,90490,90100,91080,89600,89600,90150,-890,-340,38,342.60,172
,20171215,89600,90150,89820,90240,89800,89830,89960,-320,-190,78,701.72,164
,20171218,89830,89960,91440,93950,91440,93510,93320,3550,3360,52,485.30,134
,20171219,93510,93320,94130,94660,93770,94450,93980,1130,660,304,"2,857.19",182
,20171220,94450,93980,,,,93980,93980,0,0,0,0.00,182
,20171221,93980,93980,96880,96880,95530,95630,96330,1650,2350,14,134.86,174
,20171222,95630,96330,94970,96830,94970,95870,95480,-460,-850,54,515.60,174
,20171225,95870,95480,96610,97240,95810,96870,96630,1390,1150,30,289.90,174
,20171226,96870,96630,94930,95970,94650,95970,95240,-660,-1390,12,114.29,162
,20171227,95970,95240,95650,96400,95300,95450,95710,210,470,48,459.41,132
,20171228,95450,95710,95720,95720,95720,95720,95720,10,10,2,19.14,130
,20171229,95720,95720,96700,97140,96660,96660,96790,940,1070,12,116.16,120
ni1807,20170718,80260,80260,81800,82890,80150,81860,81720,1600,1460,20,163.45,6
,20170719,81860,81720,,,,81720,81720,0,0,0,0.00,6
,20170720,81720,81720,,,,81720,81720,0,0,0,0.00,6
,20170721,81720,81720,81340,81340,81340,81340,81340,-380,-380,2,16.27,6
,20170724,81340,81340,80880,80880,80880,80880,80880,-460,-460,2,16.18,8
,20170725,80880,80880,,,,82410,82410,1530,1530,0,0.00,8
,20170726,82410,82410,,,,86520,86520,4110,4110,0,0.00,8
,20170727,86520,86520,,,,86230,86230,-290,-290,0,0.00,8
,20170728,86230,86230,85480,85760,85480,85480,85570,-750,-660,6,51.34,12
,20170731,85480,85570,86200,86360,86200,86360,86300,790,730,6,51.78,16
,20170801,86360,86300,85560,85560,84940,84940,85240,-1360,-1060,6,51.15,20
,20170802,84940,85240,,,,85240,85240,0,0,0,0.00,20
,20170803,85240,85240,86320,87170,86320,87170,86950,1930,1710,8,69.57,24
,20170804,87170,86950,,,,86950,86950,0,0,0,0.00,24
,20170807,86950,86950,86770,86770,86380,86620,86590,-330,-360,20,173.20,26
,20170808,86620,86590,87330,87330,87330,87330,87330,740,740,2,17.47,26
,20170809,87330,87330,88280,90410,88280,90410,89340,3080,2010,4,35.74,30
,20170810,90410,89340,,,,89340,89340,0,0,0,0.00,30
,20170811,89340,89340,90300,91040,89930,91040,90480,1700,1140,14,126.67,34
,20170814,91040,90480,,,,90480,90480,0,0,0,0.00,34
,20170815,90480,90480,,,,90480,90480,0,0,0,0.00,34
,20170816,90480,90480,,,,90480,90480,0,0,0,0.00,34
,20170817,90480,90480,,,,90480,90480,0,0,0,0.00,34
,20170818,90480,90480,89630,90230,88990,90230,89610,-250,-870,6,53.77,36
,20170821,90230,89610,91310,93660,91310,93660,92480,4050,2870,4,36.99,38
,20170822,93660,92480,,,,92480,92480,0,0,0,0.00,38
,20170823,92480,92480,94600,94600,93980,94570,94420,2090,1940,10,94.42,40
,20170824,94570,94420,,,,94420,94420,0,0,0,0.00,40
,20170825,94420,94420,96100,96100,96100,96100,96100,1680,1680,2,19.22,40
,20170828,96100,96100,,,,96100,96100,0,0,0,0.00,40
,20170829,96100,96100,,,,96100,96100,0,0,0,0.00,40
,20170830,96100,96100,,,,96080,96080,-20,-20,0,0.00,40
,20170831,96080,96080,,,,96080,96080,0,0,0,0.00,40
,20170901,96080,96080,,,,96080,96080,0,0,0,0.00,40
,20170904,96080,96080,,,,96080,96080,0,0,0,0.00,40
,20170905,96080,96080,,,,97090,97090,1010,1010,0,0.00,40
,20170906,97090,97090,98000,98000,96160,96490,96790,-600,-300,332,"3,213.61",160
,20170907,96490,96790,96260,98000,96260,98000,97530,1210,740,10,97.54,162
,20170908,98000,97530,96540,97490,94100,94530,96230,-3000,-1300,34,327.21,152
,20170911,94530,96230,92500,92500,91000,91140,91720,-5090,-4510,10,91.73,152
,20170912,91140,91720,92830,92920,92830,92920,92870,1200,1150,4,37.15,150
,20170913,92920,92870,,,,92870,92870,0,0,0,0.00,150
,20170914,92870,92870,91310,91310,90430,90430,90870,-2440,-2000,4,36.35,148
,20170915,90430,90870,,,,90500,90500,-370,-370,0,0.00,148
,20170918,90500,90500,89820,89820,88330,89560,89330,-940,-1170,12,107.20,150
,20170919,89560,89330,89700,89700,88790,89000,88980,-330,-350,14,124.58,144
,20170920,89000,88980,,,,89150,89150,170,170,0,0.00,144
,20170921,89150,89150,90810,90810,89570,89570,90380,420,1230,8,72.31,146
,20170922,89570,90380,87800,88000,87800,88000,87900,-2380,-2480,4,35.16,146
,20170925,88000,87900,84910,85570,84910,85560,85370,-2340,-2530,16,136.59,146
,20170926,85560,85370,85600,86220,85600,86220,85900,850,530,14,120.27,140
,20170927,86220,85900,85180,85620,85180,85610,85550,-290,-350,34,290.90,140
,20170928,85610,85550,85380,85380,84010,84170,84240,-1380,-1310,48,404.39,150
,20170929,84170,84240,,,,84490,84490,250,250,0,0.00,150
,20171009,84490,84490,,,,86670,86670,2180,2180,0,0.00,150
,20171010,86670,86670,88510,88510,88510,88510,88510,1840,1840,2,17.70,150
,20171011,88510,88510,,,,88510,88510,0,0,0,0.00,150
,20171012,88510,88510,89880,91300,89780,91250,90730,2740,2220,16,145.17,156
,20171013,91250,90730,,,,91510,91510,780,780,0,0.00,156
,20171016,91510,91510,,,,91510,91510,0,0,0,0.00,156
,20171017,91510,91510,95020,95640,94830,94830,95090,3320,3580,14,133.13,156
,20171018,94830,95090,,,,95090,95090,0,0,0,0.00,156
,20171019,95090,95090,94050,95040,94050,95040,94380,-50,-710,6,56.63,154
,20171020,95040,94380,95990,98070,95990,98070,96960,3690,2580,8,77.57,160
,20171023,98070,96960,98250,98250,95060,95650,96850,-1310,-110,12,116.22,158
,20171024,95650,96850,,,,96850,96850,0,0,0,0.00,158
,20171025,96850,96850,97600,97670,95980,96000,96740,-850,-110,866,"8,378.46",1006
,20171026,96000,96740,,,,96740,96740,0,0,0,0.00,1006
,20171027,96740,96740,94240,94330,94240,94330,94240,-2410,-2500,22,207.35,1006
,20171030,94330,94240,93570,93570,92990,93370,93300,-870,-940,84,783.73,1012
,20171031,93370,93300,93860,94350,93860,94350,94070,1050,770,12,112.89,1012
,20171101,94350,94070,95860,99470,95610,99470,96210,5400,2140,282,"2,713.16",1066
,20171102,99470,96210,101800,101980,100500,101980,101560,5770,5350,788,"8,003.54",1270
,20171103,101980,101560,101880,102280,99760,102000,101580,440,20,758,"7,700.14",1308
,20171106,102000,101580,101880,103910,101140,103910,101890,2330,310,504,"5,135.48",1374
,20171107,103910,101890,103720,103780,102660,103450,103230,1560,1340,858,"8,857.80",1462
,20171108,103450,103230,103200,103200,100910,101770,101810,-1460,-1420,1192,"12,136.20",1844
,20171109,101770,101810,101720,102430,99060,99840,100820,-1970,-990,2536,"25,568.29",2698
,20171110,99840,100820,99390,100580,98630,100020,99940,-800,-880,2304,"23,026.50",3220
,20171113,100020,99940,99860,100640,98680,100640,99690,700,-250,3092,"30,826.43",4430
,20171114,100640,99690,100410,102370,99560,99690,100710,0,1020,4820,"48,546.00",5290
,20171115,99690,100710,99880,100330,94660,94660,97230,-6050,-3480,5226,"50,817.37",4944
,20171116,94660,97230,94460,95150,94120,94330,94610,-2900,-2620,3700,"35,009.00",4836
,20171117,94330,94610,94550,95400,92840,92970,93810,-1640,-800,2840,"26,643.79",4796
,20171120,92970,93810,92910,94430,92910,94270,93800,460,-10,1584,"14,859.18",4736
,20171121,94270,93800,93930,95320,93140,94610,94470,810,670,2270,"21,446.35",5064
,20171122,94610,94470,94860,96090,94550,95350,95360,880,890,2194,"20,923.08",5230
,20171123,95350,95360,95430,96860,94440,94540,95870,-820,510,1758,"16,855.15",5416
,20171124,94540,95870,93900,97310,93900,97160,95840,1290,-30,2428,"23,271.48",5636
,20171127,97160,95840,96960,97560,93690,94310,96180,-1530,340,4674,"44,957.60",6528
,20171128,94310,96180,94340,94620,91670,92410,93140,-3770,-3040,3654,"34,033.89",7132
,20171129,92410,93140,92600,93070,91220,91970,92350,-1170,-790,4216,"38,937.61",8348
,20171130,91970,92350,91910,92800,90470,91420,91860,-930,-490,4998,"45,916.15",8994
,20171201,91420,91860,91730,91910,89960,90530,90910,-1330,-950,6570,"59,733.46",10214
,20171204,90530,90910,90380,92930,90380,92680,91780,1770,870,5106,"46,863.24",10898
,20171205,92680,91780,92490,93130,90420,90590,92030,-1190,250,7990,"73,538.50",11706
,20171206,90590,92030,90810,90810,87730,88310,88880,-3720,-3150,9068,"80,597.42",11858
,20171207,88310,88880,88100,88780,87130,87580,88100,-1300,-780,6318,"55,662.87",13020
,20171208,87580,88100,87760,89700,87760,89360,88860,1260,760,6440,"57,225.89",13348
,20171211,89360,88860,89470,89710,87840,88030,88690,-830,-170,7430,"65,903.50",14248
,20171212,88030,88690,88430,93910,88160,89840,89390,1150,700,9844,"87,999.31",14572
,20171213,89840,89390,89960,90670,88710,90160,89860,770,470,9320,"83,755.77",15110
,20171214,90160,89860,90220,91210,89000,89600,90150,-260,290,6452,"58,165.07",15538
,20171215,89600,90150,89860,90760,89690,90460,90280,310,130,4676,"42,216.90",16066
,20171218,90460,90280,91300,94670,90460,93970,93240,3690,2960,8098,"75,509.98",16340
,20171219,93970,93240,94170,95940,93610,94920,94740,1680,1500,4680,"44,338.81",16448
,20171220,94920,94740,94960,95590,94540,95210,95110,470,370,6308,"59,996.04",18750
,20171221,95210,95110,95850,97030,95370,95860,95980,750,870,7432,"71,332.43",19942
,20171222,95860,95980,96260,96450,94840,96240,95860,260,-120,7922,"75,947.10",20282
,20171225,96240,95860,96240,97930,95310,95460,96910,-400,1050,6132,"59,427.01",20606
,20171226,95460,96910,95490,96220,94340,96090,95310,-820,-1600,9020,"85,973.96",22986
,20171227,96090,95310,96090,96590,94380,95040,95500,-270,190,11342,"108,326.97",23586
,20171228,95040,95500,95430,97840,94930,97200,96130,1700,630,12470,"119,884.32",24302
,20171229,97200,96130,96890,97960,96610,97290,97250,1160,1120,15712,"152,813.36",26748
ni1808,20170816,90480,90480,86930,86930,86930,86930,86930,-3550,-3550,2,17.39,2
,20170817,86930,86930,88780,88780,88780,88780,88780,1850,1850,2,17.76,4
,20170818,88780,88780,,,,88780,88780,0,0,0,0.00,4
,20170821,88780,88780,93760,93760,93760,93760,93760,4980,4980,2,18.75,6
,20170822,93760,93760,,,,93760,93760,0,0,0,0.00,6
,20170823,93760,93760,94000,94000,94000,94000,94000,240,240,2,18.80,6
,20170824,94000,94000,,,,94000,94000,0,0,0,0.00,6
,20170825,94000,94000,,,,95670,95670,1670,1670,0,0.00,6
,20170828,95670,95670,,,,95670,95670,0,0,0,0.00,6
,20170829,95670,95670,,,,95670,95670,0,0,0,0.00,6
,20170830,95670,95670,,,,95670,95670,0,0,0,0.00,6
,20170831,95670,95670,,,,95670,95670,0,0,0,0.00,6
,20170901,95670,95670,,,,95670,95670,0,0,0,0.00,6
,20170904,95670,95670,,,,95670,95670,0,0,0,0.00,6
,20170905,95670,95670,,,,96840,96840,1170,1170,0,0.00,6
,20170906,96840,96840,94430,97300,94420,97300,95890,460,-950,106,"1,016.54",22
,20170907,97300,95890,97870,97870,97870,97870,97870,1980,1980,4,39.15,22
,20170908,97870,97870,97430,97430,97430,97430,97430,-440,-440,8,77.94,22
,20170911,97430,97430,91580,92790,91580,92790,91720,-4640,-5710,30,275.18,26
,20170912,92790,91720,92610,93340,92610,93340,93070,1620,1350,16,148.91,22
,20170913,93340,93070,,,,93070,93070,0,0,0,0.00,22
,20170914,93070,93070,90910,90910,90910,90910,90910,-2160,-2160,2,18.18,24
,20170915,90910,90910,90790,90790,90790,90790,90790,-120,-120,2,18.16,24
,20170918,90790,90790,89380,89630,89380,89630,89500,-1160,-1290,4,35.80,26
,20170919,89630,89500,90790,90790,90790,90790,90790,1290,1290,6,54.47,32
,20170920,90790,90790,90220,90220,90220,90220,90220,-570,-570,2,18.04,34
,20170921,90220,90220,89870,89870,89870,89870,89870,-350,-350,2,17.97,34
,20170922,89870,89870,,,,87110,87110,-2760,-2760,0,0.00,34
,20170925,87110,87110,85990,86570,85550,85550,86020,-1560,-1090,8,68.82,40
,20170926,85550,86020,86030,86030,86030,86030,86030,10,10,2,17.21,40
,20170927,86030,86030,86360,86610,86130,86510,86440,480,410,26,224.74,54
,20170928,86510,86440,86470,86470,84810,84930,85640,-1510,-800,8,68.51,58
,20170929,84930,85640,85320,85320,85320,85320,85320,-320,-320,2,17.06,58
,20171009,85320,85320,,,,87300,87300,1980,1980,0,0.00,58
,20171010,87300,87300,,,,87770,87770,470,470,0,0.00,58
,20171011,87770,87770,89140,89830,89140,89830,89480,2060,1710,4,35.79,56
,20171012,89830,89480,90240,90240,90240,90240,90240,760,760,2,18.05,56
,20171013,90240,90240,92840,92840,92840,92840,92840,2600,2600,2,18.57,54
,20171016,92840,92840,,,,93520,93520,680,680,0,0.00,54
,20171017,93520,93520,95960,96240,95570,96130,95900,2610,2380,30,287.70,38
,20171018,96130,95900,95710,95710,95710,95710,95710,-190,-190,2,19.14,40
,20171019,95710,95710,95350,95350,95350,95350,95350,-360,-360,2,19.07,42
,20171020,95350,95350,98500,98500,98500,98500,98500,3150,3150,2,19.70,42
,20171023,98500,98500,95360,96020,95360,96020,95520,-2480,-2980,8,76.42,48
,20171024,96020,95520,,,,96010,96010,490,490,0,0.00,48
,20171025,96010,96010,,,,96010,96010,0,0,0,0.00,48
,20171026,96010,96010,,,,96010,96010,0,0,0,0.00,48
,20171027,96010,96010,,,,94950,94950,-1060,-1060,0,0.00,48
,20171030,94950,94950,93330,93330,93330,93330,93330,-1620,-1620,6,56.00,48
,20171031,93330,93330,,,,93880,93880,550,550,0,0.00,48
,20171101,93880,93880,98200,98200,98200,98200,98200,4320,4320,2,19.64,50
,20171102,98200,98200,102210,102210,101130,101960,101760,3760,3560,10,101.76,56
,20171103,101960,101760,101280,103000,100850,102190,101910,430,150,10,101.91,58
,20171106,102190,101910,,,,103470,103470,1560,1560,0,0.00,58
,20171107,103470,103470,,,,103470,103470,0,0,0,0.00,58
,20171108,103470,103470,102260,102260,102260,102260,102260,-1210,-1210,2,20.45,58
,20171109,102260,102260,101000,101000,101000,101000,101000,-1260,-1260,4,40.40,58
,20171110,101000,101000,,,,101000,101000,0,0,0,0.00,58
,20171113,101000,101000,,,,101000,101000,0,0,0,0.00,58
,20171114,101000,101000,100990,101000,100990,101000,100990,0,-10,4,40.40,58
,20171115,101000,100990,98430,98440,95780,96430,97500,-4560,-3490,20,195.01,74
,20171116,96430,97500,95340,95340,95340,95340,95340,-2160,-2160,2,19.07,74
,20171117,95340,95340,,,,95340,95340,0,0,0,0.00,74
,20171120,95340,95340,93730,94500,93730,94500,94240,-840,-1100,12,113.09,74
,20171121,94500,94240,94570,94570,94570,94570,94570,330,330,2,18.91,74
,20171122,94570,94570,,,,94570,94570,0,0,0,0.00,74
,20171123,94570,94570,96100,96100,96100,96100,96100,1530,1530,2,19.22,72
,20171124,96100,96100,97780,97780,97780,97780,97780,1680,1680,2,19.56,74
,20171127,97780,97780,,,,98130,98130,350,350,0,0.00,74
,20171128,98130,98130,94840,94970,92290,93210,93820,-4920,-4310,8,75.06,76
,20171129,93210,93820,,,,93820,93820,0,0,0,0.00,76
,20171130,93820,93820,89870,94550,89870,90900,92460,-2920,-1360,8,73.97,76
,20171201,90900,92460,90900,90900,90900,90900,90900,-1560,-1560,2,18.18,76
,20171204,90900,90900,,,,90900,90900,0,0,0,0.00,76
,20171205,90900,90900,92500,92500,91950,91950,92190,1050,1290,18,165.95,58
,20171206,91950,92190,88300,88300,88300,88300,88300,-3890,-3890,2,17.66,56
,20171207,88300,88300,,,,88300,88300,0,0,0,0.00,56
,20171208,88300,88300,89200,89200,89200,89200,89200,900,900,4,35.68,52
,20171211,89200,89200,,,,89200,89200,0,0,0,0.00,52
,20171212,89200,89200,,,,89380,89380,180,180,0,0.00,52
,20171213,89380,89380,89420,90420,89170,90110,89970,730,590,22,197.94,54
,20171214,90110,89970,91300,91730,90900,90900,91500,930,1530,36,329.41,88
,20171215,90900,91500,90260,90450,90250,90390,90390,-1110,-1110,38,343.49,86
,20171218,90390,90390,94040,94040,94040,94040,94040,3650,3650,2,18.81,86
,20171219,94040,94040,95180,95180,95180,95180,95180,1140,1140,6,57.11,80
,20171220,95180,95180,95320,95320,95320,95320,95320,140,140,2,19.06,82
,20171221,95320,95320,95930,96220,95930,96220,96070,900,750,4,38.43,82
,20171222,96220,96070,,,,96070,96070,0,0,0,0.00,82
,20171225,96070,96070,,,,96070,96070,0,0,0,0.00,82
,20171226,96070,96070,95760,95760,95700,95700,95730,-370,-340,4,38.29,78
,20171227,95700,95730,95760,95760,95160,95340,95460,-390,-270,10,95.46,74
,20171228,95340,95460,95530,95530,95530,95530,95530,70,70,2,19.11,72
,20171229,95530,95530,97900,98020,97900,98020,97960,2490,2430,4,39.18,72
ni1809,20170918,90790,90790,90490,91540,86800,90890,90300,100,-490,76,686.30,34
,20170919,90890,90300,90660,91000,89880,89880,90370,-420,70,104,939.91,98
,20170920,89880,90370,87970,91980,87970,91980,90830,1610,460,148,"1,344.31",138
,20170921,91980,90830,92090,92850,89820,90020,91200,-810,370,138,"1,258.59",168
,20170922,90020,91200,90000,90970,85750,85800,88170,-5400,-3030,464,"4,091.16",248
,20170925,85800,88170,86200,87080,85330,85920,86220,-2250,-1950,454,"3,914.44",418
,20170926,85920,86220,85960,87360,85960,86350,86670,130,450,234,"2,028.29",540
,20170927,86350,86670,86060,87240,85890,86610,86370,-60,-300,126,"1,088.35",584
,20170928,86610,86370,86630,86630,84180,84800,84970,-1570,-1400,342,"2,906.28",684
,20170929,84800,84970,84860,86200,84330,85820,85410,850,440,162,"1,383.64",722
,20171009,85820,85410,87000,88300,86420,88120,87530,2710,2120,226,"1,978.20",724
,20171010,88120,87530,88360,89400,87820,88450,88660,920,1130,254,"2,252.05",740
,20171011,88450,88660,88830,89360,87700,88830,88670,170,10,136,"1,206.00",762
,20171012,88830,88670,88460,91360,88160,91300,90280,2630,1610,238,"2,148.88",808
,20171013,91300,90280,91390,93310,91280,93310,92220,3030,1940,140,"1,291.18",818
,20171016,93310,92220,93680,94800,93020,94440,93910,2220,1690,290,"2,723.52",844
,20171017,94440,93910,94920,96380,94220,95000,95620,1090,1710,448,"4,284.14",886
,20171018,95000,95620,94900,95800,94290,95770,95020,150,-600,184,"1,748.45",888
,20171019,95770,95020,95770,96500,94220,95130,95400,110,380,264,"2,518.71",918
,20171020,95130,95400,95400,98500,94800,98500,96740,3100,1340,360,"3,482.72",1046
,20171023,98500,96740,98700,98700,94970,96180,96430,-560,-310,470,"4,532.42",984
,20171024,96180,96430,95680,97550,95560,97500,96890,1070,460,418,"4,050.28",1038
,20171025,97500,96890,97770,98340,96170,96850,97260,-40,370,426,"4,143.41",1032
,20171026,96850,97260,96600,97580,96410,96850,97020,-410,-240,236,"2,289.90",1042
,20171027,96850,97020,96820,96880,93800,94110,95100,-2910,-1920,470,"4,469.92",1060
,20171030,94110,95100,93480,94650,93270,93950,93860,-1150,-1240,270,"2,534.33",1108
,20171031,93950,93860,94240,96800,94100,96610,95030,2750,1170,334,"3,174.05",1144
,20171101,96610,95030,96610,100730,96280,100730,99620,5700,4590,700,"6,973.49",1414
,20171102,100730,99620,101210,103720,101200,102340,102250,2720,2630,1230,"12,576.88",1588
,20171103,102340,102250,102290,103150,100490,102800,102110,550,-140,726,"7,413.73",1650
,20171106,102800,102110,102410,104500,101700,104370,103310,2260,1200,662,"6,839.58",1810
,20171107,104370,103310,104400,104450,103250,104300,103900,990,590,516,"5,361.50",1834
,20171108,104300,103900,103830,103950,101500,102430,102630,-1470,-1270,1784,"18,310.85",2476
,20171109,102430,102630,102350,103300,99460,100640,101230,-1990,-1400,1578,"15,975.18",2628
,20171110,100640,101230,100090,101500,99300,100770,100540,-460,-690,1562,"15,705.80",2894
,20171113,100770,100540,100820,101300,99020,101300,100330,760,-210,2400,"24,079.39",3450
,20171114,101300,100330,100960,102780,100280,100280,101460,-50,1130,1236,"12,541.61",3574
,20171115,100280,101460,100500,100940,95370,95450,97120,-6010,-4340,3740,"36,325.84",3726
,20171116,95450,97120,95300,95800,93500,95090,95260,-2030,-1860,1374,"13,089.87",4048
,20171117,95090,95260,95190,96140,93580,93820,94500,-1440,-760,2346,"22,171.89",4596
,20171120,93820,94500,94060,95640,93700,94810,94430,310,-70,1088,"10,274.90",4604
,20171121,94810,94430,94900,95880,93700,95000,95120,570,690,806,"7,666.83",4682
,20171122,95000,95120,95240,96710,94840,95920,96020,800,900,1270,"12,195.02",4764
,20171123,95920,96020,96250,97370,95010,95170,96480,-850,460,1618,"15,611.81",5204
,20171124,95170,96480,95090,97780,94530,97580,96040,1100,-440,1620,"15,559.96",5490
,20171127,97580,96040,97410,98050,94260,94860,96140,-1180,100,1428,"13,729.95",5482
,20171128,94860,96140,95000,95200,92170,92910,93510,-3230,-2630,1900,"17,767.97",5962
,20171129,92910,93510,92820,93570,91780,92500,92780,-1010,-730,1652,"15,327.37",6450
,20171130,92500,92780,92340,93200,90880,91830,92310,-950,-470,2884,"26,623.51",7284
,20171201,91830,92310,91990,92390,90390,91050,91320,-1260,-990,2178,"19,891.32",7856
,20171204,91050,91320,90640,93490,90570,93200,92320,1880,1000,2414,"22,287.55",8460
,20171205,93200,92320,93260,93700,91000,91120,92350,-1200,30,3148,"29,073.09",9626
,20171206,91120,92350,91320,91320,88300,88900,89450,-3450,-2900,2290,"20,484.63",9838
,20171207,88900,89450,88690,89370,87700,88160,88560,-1290,-890,1256,"11,123.53",9960
,20171208,88160,88560,88530,90250,88420,90000,89460,1440,900,1770,"15,835.31",10160
,20171211,90000,89460,89500,90260,88470,88700,89160,-760,-300,1128,"10,057.88",10196
,20171212,88700,89160,89180,91160,88780,90470,90420,1310,1260,1574,"14,232.81",10638
,20171213,90470,90420,90600,91190,89200,90580,90270,160,-150,5012,"45,244.88",13158
,20171214,90580,90270,90690,91500,89250,89970,90550,-300,280,2278,"20,627.45",13618
,20171215,89970,90550,89850,91000,89850,90690,90480,140,-70,2844,"25,734.26",14308
,20171218,90690,90480,91110,94860,90770,94380,93330,3900,2850,3468,"32,368.51",14632
,20171219,94380,93330,94440,96270,94000,95130,95220,1800,1890,2334,"22,225.40",14598
,20171220,95130,95220,95280,95810,94800,95620,95410,400,190,2828,"26,982.89",15828
,20171221,95620,95410,96240,97470,95600,96220,96660,810,1250,6518,"63,005.51",18512
,20171222,96220,96660,96220,96840,95000,96470,96270,-190,-390,3330,"32,060.21",18842
,20171225,96470,96270,96540,98300,95610,95780,97170,-490,900,5628,"54,691.02",18934
,20171226,95780,97170,95870,96670,94830,96400,95710,-770,-1460,3148,"30,131.80",19014
,20171227,96400,95710,96600,96940,94750,95410,95760,-300,50,5368,"51,405.38",19658
,20171228,95410,95760,95740,98290,95380,97540,96810,1780,1050,3618,"35,026.51",19998
,20171229,97540,96810,97700,98500,97120,97630,97800,820,990,7616,"74,488.31",21300
ni1810,20171017,93910,93910,,,,93910,93910,0,0,0,0.00,0
,20171018,93910,93910,,,,93910,93910,0,0,0,0.00,0
,20171019,93910,93910,94220,95600,93600,95600,94410,1690,500,8,75.53,4
,20171020,95600,94410,98500,98500,98500,98500,98500,4090,4090,2,19.70,4
,20171023,98500,98500,98880,98880,96010,97230,97370,-1270,-1130,6,58.42,4
,20171024,97230,97370,95460,98990,95460,97400,97510,30,140,24,234.05,6
,20171025,97400,97510,,,,97510,97510,0,0,0,0.00,6
,20171026,97510,97510,97410,97410,97410,97410,97410,-100,-100,4,38.96,10
,20171027,97410,97410,,,,95440,95440,-1970,-1970,0,0.00,10
,20171030,95440,95440,,,,95440,95440,0,0,0,0.00,10
,20171031,95440,95440,,,,95440,95440,0,0,0,0.00,10
,20171101,95440,95440,98200,101160,98200,101160,100790,5720,5350,26,262.07,30
,20171102,101160,100790,102000,103680,101020,103440,102220,2650,1430,52,531.58,62
,20171103,103440,102220,100870,102840,100850,102840,101440,620,-780,8,81.15,54
,20171106,102840,101440,103880,104620,103400,104020,103820,2580,2380,18,186.89,60
,20171107,104020,103820,102930,104090,102930,104090,103510,270,-310,8,82.81,64
,20171108,104090,103510,102100,102880,102060,102360,102530,-1150,-980,18,184.57,70
,20171109,102360,102530,103000,103000,100010,100010,102170,-2520,-360,22,224.79,70
,20171110,100010,102170,100360,101590,100150,101210,100990,-960,-1180,20,201.99,72
,20171113,101210,100990,100760,104440,99680,101010,101270,20,280,42,425.36,56
,20171114,101010,101270,101160,102590,100600,100600,101480,-670,210,28,284.17,66
,20171115,100600,101480,100440,100440,96050,96430,97480,-5050,-4000,28,272.96,78
,20171116,96430,97480,,,,96190,96190,-1290,-1290,0,0.00,78
,20171117,96190,96190,93840,95060,93840,95060,94650,-1130,-1540,6,56.79,74
,20171120,95060,94650,,,,94650,94650,0,0,0,0.00,74
,20171121,94650,94650,96300,96300,95140,95140,95720,490,1070,4,38.29,76
,20171122,95140,95720,96730,96730,96730,96730,96730,1010,1010,2,19.35,78
,20171123,96730,96730,,,,96330,96330,-400,-400,0,0.00,78
,20171124,96330,96330,97050,97050,97050,97050,97050,720,720,2,19.41,78
,20171127,97050,97050,98030,98070,96960,96960,97670,-90,620,8,78.14,82
,20171128,96960,97670,,,,94260,94260,-3410,-3410,0,0.00,82
,20171129,94260,94260,,,,93960,93960,-300,-300,0,0.00,82
,20171130,93960,93960,,,,93110,93110,-850,-850,0,0.00,82
,20171201,93110,93110,,,,92280,92280,-830,-830,0,0.00,82
,20171204,92280,92280,,,,92390,92390,110,110,0,0.00,82
,20171205,92390,92390,,,,92390,92390,0,0,0,0.00,82
,20171206,92390,92390,91200,91200,91200,91200,91200,-1190,-1190,2,18.24,80
,20171207,91200,91200,,,,89550,89550,-1650,-1650,0,0.00,80
,20171208,89550,89550,,,,89550,89550,0,0,0,0.00,80
,20171211,89550,89550,,,,89550,89550,0,0,0,0.00,80
,20171212,89550,89550,90950,90950,90950,90950,90950,1400,1400,2,18.19,82
,20171213,90950,90950,91250,91250,90500,90500,91000,-450,50,6,54.60,82
,20171214,90500,91000,91680,91690,89810,89810,90740,-1190,-260,12,108.90,92
,20171215,89810,90740,90560,90850,90560,90840,90750,100,10,12,108.91,102
,20171218,90840,90750,,,,93540,93540,2790,2790,0,0.00,102
,20171219,93540,93540,94540,95630,94540,95500,95220,1960,1680,6,57.13,104
,20171220,95500,95220,,,,95220,95220,0,0,0,0.00,104
,20171221,95220,95220,96760,96760,96440,96440,96600,1220,1380,4,38.64,106
,20171222,96440,96600,95530,95530,95530,95530,95530,-1070,-1070,4,38.21,106
,20171225,95530,95530,96930,97270,96930,97270,97090,1740,1560,8,77.67,102
,20171226,97270,97090,95480,95840,95480,95840,95660,-1250,-1430,4,38.26,98
,20171227,95840,95660,96230,96230,95700,95700,95960,40,300,4,38.39,98
,20171228,95700,95960,96100,96240,96100,96240,96210,280,250,12,115.46,88
,20171229,96240,96210,97550,98180,97460,98050,97900,1840,1690,18,176.22,80
ni1811,20171116,97480,97480,95520,95520,95090,95090,95300,-2390,-2180,4,38.12,4
,20171117,95090,95300,,,,95300,95300,0,0,0,0.00,4
,20171120,95300,95300,,,,95300,95300,0,0,0,0.00,4
,20171121,95300,95300,,,,95300,95300,0,0,0,0.00,4
,20171122,95300,95300,,,,95300,95300,0,0,0,0.00,4
,20171123,95300,95300,,,,95300,95300,0,0,0,0.00,4
,20171124,95300,95300,,,,96620,96620,1320,1320,0,0.00,4
,20171127,96620,96620,97700,97700,95010,95010,95800,-1610,-820,8,76.64,4
,20171128,95010,95800,93210,93570,93210,93570,93390,-2230,-2410,4,37.36,8
,20171129,93570,93390,92710,92710,92710,92710,92710,-680,-680,2,18.54,8
,20171130,92710,92710,,,,92710,92710,0,0,0,0.00,8
,20171201,92710,92710,,,,92710,92710,0,0,0,0.00,8
,20171204,92710,92710,92640,92640,92640,92640,92640,-70,-70,2,18.53,8
,20171205,92640,92640,,,,92640,92640,0,0,0,0.00,8
,20171206,92640,92640,90010,90010,90010,90010,90010,-2630,-2630,2,18.00,10
,20171207,90010,90010,89090,89090,89090,89090,89090,-920,-920,2,17.82,12
,20171208,89090,89090,90110,90110,90110,90110,90110,1020,1020,2,18.02,10
,20171211,90110,90110,,,,90050,90050,-60,-60,0,0.00,10
,20171212,90050,90050,,,,90200,90200,150,150,0,0.00,10
,20171213,90200,90200,,,,90200,90200,0,0,0,0.00,10
,20171214,90200,90200,,,,90200,90200,0,0,0,0.00,10
,20171215,90200,90200,,,,90220,90220,20,20,0,0.00,10
,20171218,90220,90220,92920,94940,92920,94940,94270,4720,4050,12,113.13,16
,20171219,94940,94270,,,,94270,94270,0,0,0,0.00,16
,20171220,94270,94270,95320,95320,95320,95320,95320,1050,1050,2,19.06,18
,20171221,95320,95320,96960,96960,96500,96500,96650,1180,1330,6,57.99,20
,20171222,96500,96650,,,,96650,96650,0,0,0,0.00,20
,20171225,96650,96650,97620,97620,97620,97620,97620,970,970,6,58.57,24
,20171226,97620,97620,,,,97620,97620,0,0,0,0.00,24
,20171227,97620,97620,,,,96640,96640,-980,-980,0,0.00,24
,20171228,96640,96640,98270,98280,98270,98280,98270,1640,1630,4,39.31,28
,20171229,98280,98270,98410,98410,98410,98410,98410,140,140,4,39.36,28
ni1812,20171218,90220,90220,93210,93210,93210,93210,93210,2990,2990,2,18.64,2
,20171219,93210,93210,95750,95750,95750,95750,95750,2540,2540,2,19.15,4
,20171220,95750,95750,95820,95820,95820,95820,95820,70,70,2,19.16,6
,20171221,95820,95820,,,,95820,95820,0,0,0,0.00,6
,20171222,95820,95820,,,,95820,95820,0,0,0,0.00,6
,20171225,95820,95820,97570,97570,96020,96320,97090,500,1270,12,116.52,16
,20171226,96320,97090,,,,97090,97090,0,0,0,0.00,16
,20171227,97090,97090,,,,97030,97030,-60,-60,0,0.00,16
,20171228,97030,97030,96510,96510,96510,96510,96510,-520,-520,6,57.91,20
,20171229,96510,96510,98100,98100,98100,98100,98100,1590,1590,2,19.62,20
pb1701,20170103,17700,17720,17955,18035,17415,17625,17860,-95,140,960,"8,573.25",9970
,20170104,17625,17860,17865,17870,17495,17780,17630,-80,-230,620,"5,466.58",9570
,20170105,17780,17630,17945,18065,17785,18050,17965,420,335,1210,"10,871.40",9200
,20170106,18050,17965,18100,18250,17960,18090,18075,125,110,1700,"15,367.48",8150
,20170109,18090,18075,18155,18295,17950,18060,18225,-15,150,670,"6,106.05",8180
,20170110,18060,18225,18300,18650,18300,18650,18430,425,205,730,"6,728.45",8260
,20170111,18650,18430,18655,19200,18550,18550,18620,120,190,440,"4,096.98",7980
,20170112,18550,18620,18500,18650,18380,18450,18545,-170,-75,190,"1,762.05",7930
,20170113,18450,18545,19400,19545,18450,18450,19210,-95,665,70,672.48,7920
,20170116,18450,19210,18700,19000,18610,18725,18800,-485,-410,660,"6,205.63",7870
pb1702,20170103,17665,17555,17670,17910,17385,17410,17695,-145,140,47136,"417,096.65",39824
,20170104,17410,17695,17515,17720,17280,17715,17465,20,-230,86380,"754,406.16",40278
,20170105,17715,17465,17730,18030,17690,17910,17850,445,385,92726,"827,596.62",39076
,20170106,17910,17850,17885,18120,17720,17960,17900,110,50,90676,"811,650.11",39686
,20170109,17960,17900,18035,18185,17840,18090,18055,190,155,76450,"690,161.74",38338
,20170110,18090,18055,18060,18865,18040,18755,18465,700,410,91306,"843,165.13",35774
,20170111,18755,18465,18800,19015,18620,18780,18795,315,330,75406,"708,690.62",30978
,20170112,18780,18795,18770,18840,18360,18660,18615,-135,-180,80420,"748,628.52",30484
,20170113,18660,18615,18760,19020,18400,18555,18730,-60,115,65508,"613,611.24",28200
,20170116,18555,18730,18720,19140,18545,18845,18895,115,165,73290,"692,432.61",27060
,20170117,18845,18895,19000,19095,18175,18280,18720,-615,-175,52290,"489,502.93",22930
,20170118,18280,18720,18375,18720,18000,18570,18515,-150,-205,30112,"278,767.35",21454
,20170119,18570,18515,18555,18610,18265,18400,18400,-115,-115,21428,"197,166.23",17978
,20170120,18400,18400,18480,18530,17805,17915,18275,-485,-125,14732,"134,645.65",15654
,20170123,17915,18275,18165,18930,18010,18620,18420,345,145,12064,"111,130.46",13524
,20170124,18620,18420,18605,18765,18280,18495,18555,75,135,5980,"55,485.45",11626
,20170125,18495,18555,18660,18810,18500,18640,18695,85,140,4286,"40,069.94",10592
,20170126,18640,18695,18640,19355,18595,19230,18805,535,110,3564,"33,516.46",9734
,20170203,19230,18805,18785,18785,18360,18410,18530,-395,-275,884,"8,190.96",9010
,20170206,18410,18530,18385,18720,18385,18560,18620,30,90,1870,"17,410.98",8460
,20170207,18560,18620,18410,18770,18300,18770,18700,150,80,1780,"16,644.90",7620
,20170208,18770,18700,18800,19265,18800,19220,19060,520,360,3310,"31,546.55",7290
,20170209,19220,19060,19440,19475,19145,19145,19215,85,155,2670,"25,655.00",7270
,20170210,19145,19215,19200,19370,19030,19330,19135,115,-80,3340,"31,959.08",7380
,20170213,19330,19135,19550,19950,19550,19780,19805,645,670,1880,"18,620.73",7330
,20170214,19780,19805,19705,19710,18685,19700,19510,-105,-295,850,"8,292.08",7700
,20170215,19700,19510,19270,19380,19200,19290,19285,-220,-225,320,"3,086.33",7750
pb1703,20170103,17565,17455,17760,17760,17270,17290,17590,-165,135,12076,"106,232.54",21144
,20170104,17290,17590,17390,17620,17200,17620,17405,30,-185,22036,"191,777.97",21622
,20170105,17620,17405,17650,17950,17625,17840,17775,435,370,28616,"254,380.51",22850
,20170106,17840,17775,17800,17975,17640,17865,17805,90,30,24396,"217,198.09",24122
,20170109,17865,17805,17850,18050,17800,18020,17950,215,145,32470,"291,481.92",24984
,20170110,18020,17950,18020,18830,17950,18750,18460,800,510,44558,"411,304.70",28580
,20170111,18750,18460,18820,19050,18675,18820,18845,360,385,45070,"424,760.70",28608
,20170112,18820,18845,18820,18880,18360,18590,18615,-255,-230,48284,"449,446.69",30204
,20170113,18590,18615,18700,18950,18415,18600,18710,-15,95,40548,"379,332.44",29470
,20170116,18600,18710,18725,19200,18590,18900,18945,190,235,56336,"533,651.79",32734
,20170117,18900,18945,19065,19150,18155,18310,18700,-635,-245,63132,"590,294.48",32668
,20170118,18310,18700,18400,18690,18290,18530,18505,-170,-195,64946,"600,963.23",34270
,20170119,18530,18505,18505,18605,18305,18375,18420,-130,-85,61182,"563,538.89",36830
,20170120,18375,18420,18460,18500,17825,17975,18260,-445,-160,69276,"632,647.61",36364
,20170123,17975,18260,18150,19000,18015,18725,18525,465,265,93252,"863,797.59",35628
,20170124,18725,18525,18700,18860,18350,18580,18645,55,120,70230,"654,722.87",36010
,20170125,18580,18645,18660,18920,18655,18750,18795,105,150,63992,"601,404.55",35702
,20170126,18750,18795,18750,19070,18665,19015,18900,220,105,63892,"603,916.97",34952
,20170203,19015,18900,18785,18885,18405,18495,18600,-405,-300,29480,"274,165.17",35930
,20170206,18495,18600,18515,18870,18475,18680,18655,80,55,52748,"492,080.38",35324
,20170207,18680,18655,18670,18920,18635,18825,18795,170,140,45978,"432,094.39",37632
,20170208,18825,18795,18800,19415,18705,19250,19080,455,285,77908,"743,332.52",42080
,20170209,19250,19080,19275,19630,19210,19245,19425,165,345,66112,"642,137.83",42292
,20170210,19245,19425,19290,19525,19180,19435,19360,10,-65,67618,"654,662.93",42558
,20170213,19435,19360,19565,20070,19495,19915,19775,555,415,80550,"796,628.75",42480
,20170214,19915,19775,19990,20015,19525,19830,19760,55,-15,63154,"624,089.09",39048
,20170215,19830,19760,19820,19855,19250,19335,19460,-425,-300,63144,"614,504.23",35934
,20170216,19335,19460,19240,19440,18900,18990,19235,-470,-225,65042,"625,563.44",32616
,20170217,18990,19235,18890,18980,18655,18695,18830,-540,-405,53782,"506,458.17",29868
,20170220,18695,18830,18735,18880,18600,18785,18740,-45,-90,43702,"409,533.14",27458
,20170221,18785,18740,18900,19300,18875,19075,19055,335,315,30438,"290,004.93",25806
,20170222,19075,19055,19075,19075,18600,18730,18810,-325,-245,18886,"177,651.78",21464
,20170223,18730,18810,18880,19040,18505,18645,18840,-165,30,12854,"121,112.48",18584
,20170224,18645,18840,18830,18830,18330,18680,18560,-160,-280,10832,"100,534.98",16476
,20170227,18680,18560,18640,18895,18385,18425,18650,-135,90,8302,"77,427.48",15126
,20170228,18425,18650,18545,18590,18285,18290,18430,-360,-220,7902,"72,820.05",12632
,20170301,18290,18430,18495,18540,18350,18505,18430,75,0,2712,"24,994.83",11340
,20170302,18505,18430,18610,18840,18575,18715,18745,285,315,1630,"15,277.78",10700
,20170303,18715,18745,18535,18560,18335,18460,18405,-285,-340,1240,"11,411.63",10550
,20170306,18460,18405,18390,18525,17965,17965,18260,-440,-145,1250,"11,414.90",10440
,20170307,17965,18260,17905,18010,17850,17885,17920,-375,-340,460,"4,121.83",10310
,20170308,17885,17920,17825,17850,17655,17840,17785,-80,-135,1100,"9,783.88",9800
,20170309,17840,17785,17865,17965,17500,17500,17595,-285,-190,3820,"33,613.68",9670
,20170310,17500,17595,17610,17795,17610,17795,17710,200,115,1160,"10,274.55",9430
,20170313,17795,17710,17975,18130,17920,18130,18000,420,290,1070,"9,630.68",9650
,20170314,18130,18000,18000,18110,17940,17990,18015,-10,15,990,"8,919.20",9450
,20170315,17990,18015,17800,18000,17700,17850,17865,-165,-150,790,"7,056.85",9050
pb1704,20170103,17450,17405,17605,17735,17260,17260,17560,-145,155,1030,"9,044.27",6622
,20170104,17260,17560,17365,17645,17180,17645,17350,85,-210,1662,"14,421.47",6920
,20170105,17645,17350,17640,17905,17600,17815,17765,465,415,1104,"9,808.92",7190
,20170106,17815,17765,17765,17945,17650,17810,17795,45,30,1446,"12,866.69",7560
,20170109,17810,17795,17850,18040,17755,18010,17935,215,140,1444,"12,952.36",7892
,20170110,18010,17935,18030,18800,17960,18780,18560,845,625,1920,"17,821.14",8108
,20170111,18780,18560,18805,19040,18690,18810,18880,250,320,4008,"37,835.85",8574
,20170112,18810,18880,18790,18880,18385,18570,18610,-310,-270,3112,"28,957.26",8828
,20170113,18570,18610,18730,18950,18425,18620,18745,10,135,2442,"22,893.53",9186
,20170116,18620,18745,18735,19215,18630,18925,19010,180,265,4138,"39,332.54",8978
,20170117,18925,19010,19150,19195,18200,18360,18700,-650,-310,3666,"34,279.45",8942
,20170118,18360,18700,18480,18700,18350,18540,18540,-160,-160,2478,"22,971.85",9612
,20170119,18540,18540,18530,18580,18350,18375,18450,-165,-90,3554,"32,794.36",10238
,20170120,18375,18450,18510,18530,17880,18015,18260,-435,-190,4234,"38,662.80",11340
,20170123,18015,18260,18220,19045,18060,18740,18550,480,290,5396,"50,048.00",11662
,20170124,18740,18550,18765,18910,18400,18610,18695,60,145,3172,"29,650.68",12016
,20170125,18610,18695,18695,18950,18695,18805,18835,110,140,3454,"32,534.98",12012
,20170126,18805,18835,18805,19100,18750,19025,18940,190,105,5990,"56,726.06",13074
,20170203,19025,18940,18890,18920,18455,18555,18640,-385,-300,4120,"38,401.80",14422
,20170206,18555,18640,18585,18895,18530,18700,18720,60,80,4684,"43,846.21",14290
,20170207,18700,18720,18750,18980,18670,18865,18845,145,125,7088,"66,804.07",15586
,20170208,18865,18845,18850,19450,18745,19330,19145,485,300,15494,"148,334.75",18026
,20170209,19330,19145,19360,19685,19280,19315,19480,170,335,11952,"116,435.98",18844
,20170210,19315,19480,19380,19560,19200,19495,19415,15,-65,15522,"150,698.13",19722
,20170213,19495,19415,19590,20155,19540,19990,19870,575,455,27890,"277,115.32",23618
,20170214,19990,19870,20060,20095,19620,19915,19850,45,-20,19342,"191,989.95",25560
,20170215,19915,19850,19885,19940,19295,19400,19530,-450,-320,26642,"260,172.98",28082
,20170216,19400,19530,19335,19515,18980,19070,19305,-460,-225,26764,"258,379.33",28794
,20170217,19070,19305,18910,19020,18725,18750,18880,-555,-425,31566,"298,025.58",28730
,20170220,18750,18880,18780,18895,18645,18870,18790,-10,-90,26060,"244,854.08",28946
,20170221,18870,18790,18940,19320,18935,19150,19140,360,350,39954,"382,454.82",32372
,20170222,19150,19140,19100,19140,18705,18825,18895,-315,-245,48118,"454,677.05",35342
,20170223,18825,18895,18950,19135,18605,18720,18930,-175,35,56996,"539,593.07",38170
,20170224,18720,18930,18810,18910,18430,18800,18660,-130,-270,66652,"622,027.74",37580
,20170227,18800,18660,18775,18980,18480,18545,18750,-115,90,75758,"710,329.07",38712
,20170228,18545,18750,18630,18695,18380,18450,18540,-300,-210,80110,"742,770.21",40788
,20170301,18450,18540,18515,18685,18440,18625,18550,85,10,60048,"556,987.02",41740
,20170302,18625,18550,18740,19010,18680,18835,18830,285,280,64060,"603,197.44",40280
,20170303,18835,18830,18765,18765,18425,18570,18570,-260,-260,49694,"461,468.95",39002
,20170306,18570,18570,18545,18640,18010,18075,18385,-495,-185,67300,"618,746.47",41038
,20170307,18075,18385,18100,18205,17950,17990,18055,-395,-330,50322,"454,358.36",40794
,20170308,17990,18055,18010,18115,17715,17990,17905,-65,-150,64988,"581,952.76",38088
,20170309,17990,17905,18050,18090,17550,17625,17825,-280,-80,70560,"628,944.79",36646
,20170310,17625,17825,17675,17950,17675,17840,17825,15,0,45930,"409,388.71",34140
,20170313,17840,17825,17905,18260,17780,18160,18000,335,175,64710,"582,408.39",32062
,20170314,18160,18000,18185,18330,17915,18030,18125,30,125,44656,"404,784.97",29266
,20170315,18030,18125,17860,18180,17650,18055,17945,-70,-180,64710,"580,650.01",30202
,20170316,18055,17945,18030,18430,18030,18430,18275,485,330,47476,"433,822.22",28118
,20170317,18430,18275,18480,18480,18160,18345,18300,70,25,31440,"287,721.46",25818
,20170320,18345,18300,18385,18600,18190,18440,18450,140,150,38304,"353,385.25",24874
,20170321,18440,18450,18525,18525,18160,18340,18340,-110,-110,32150,"294,873.64",23030
,20170322,18340,18340,18480,18495,17880,18015,18205,-325,-135,22300,"203,024.68",20258
,20170323,18015,18205,18220,18675,18100,18500,18405,295,200,17870,"164,489.76",18284
,20170324,18500,18405,18510,18510,17995,18125,18170,-280,-235,8364,"75,995.93",17300
,20170327,18125,18170,18095,18195,17615,17640,17895,-530,-275,8114,"72,600.76",15860
,20170328,17640,17895,17665,17710,17060,17140,17325,-755,-570,6264,"54,264.61",14766
,20170329,17140,17325,17265,17560,17120,17480,17335,155,10,4890,"42,390.56",14174
,20170330,17480,17335,17375,17460,17030,17125,17230,-210,-105,3148,"27,122.43",13036
,20170331,17125,17230,17165,17450,16830,16840,17255,-390,25,2330,"20,106.14",11586
,20170405,16840,17255,17110,17460,17110,17360,17355,105,100,1146,"9,945.20",10840
,20170406,17360,17355,17395,17505,17300,17450,17375,95,20,7740,"67,249.60",7860
,20170407,17450,17375,17445,17445,16210,16210,16925,-1165,-450,3000,"25,394.95",7410
,20170410,16210,16925,16265,16410,16160,16310,16270,-615,-655,1180,"9,601.85",7220
,20170411,16310,16270,16240,16400,16180,16245,16280,-25,10,840,"6,838.25",6940
,20170412,16245,16280,16350,16350,15975,16150,16135,-130,-145,470,"3,791.88",6900
,20170413,16150,16135,16210,16485,16210,16385,16315,250,180,790,"6,445.98",6960
,20170414,16385,16315,16340,16425,16080,16080,16335,-235,20,210,"1,715.25",6870
,20170417,16080,16335,16515,16535,15300,16400,16300,65,-35,310,"2,527.23",6860
pb1705,20170103,17470,17450,17650,17805,17290,17300,17620,-150,170,376,"3,312.76",1880
,20170104,17300,17620,17400,17600,17215,17600,17365,-20,-255,626,"5,435.43",1950
,20170105,17600,17365,17690,17950,17630,17830,17750,465,385,564,"5,005.87",1988
,20170106,17830,17750,17780,17980,17665,17790,17770,40,20,492,"4,372.53",2010
,20170109,17790,17770,17865,18035,17775,18015,17940,245,170,358,"3,212.01",2036
,20170110,18015,17940,18015,18795,17945,18750,18525,810,585,538,"4,984.47",2050
,20170111,18750,18525,18790,19055,18675,18855,18845,330,320,860,"8,105.35",2086
,20170112,18855,18845,18800,18890,18405,18595,18615,-250,-230,880,"8,191.16",2242
,20170113,18595,18615,18710,19000,18405,18610,18730,-5,115,722,"6,762.97",2322
,20170116,18610,18730,18655,19240,18635,18925,18990,195,260,908,"8,622.78",2560
,20170117,18925,18990,19040,19175,18200,18360,18710,-630,-280,1182,"11,057.94",2510
,20170118,18360,18710,18385,18720,18370,18630,18540,-80,-170,506,"4,691.13",2474
,20170119,18630,18540,18540,18570,18400,18410,18445,-130,-95,606,"5,590.12",2610
,20170120,18410,18445,18470,18570,17665,18015,18210,-430,-235,576,"5,245.71",2656
,20170123,18015,18210,18160,19020,18080,18750,18640,540,430,1334,"12,434.80",2952
,20170124,18750,18640,18850,18910,18445,18600,18685,-40,45,462,"4,316.28",2952
,20170125,18600,18685,18695,18940,18695,18830,18840,145,155,582,"5,483.10",2936
,20170126,18830,18840,18715,19080,18715,19050,18955,210,115,918,"8,700.47",2824
,20170203,19050,18955,18855,19005,18460,18530,18690,-425,-265,592,"5,532.82",2890
,20170206,18530,18690,18535,18885,18480,18705,18730,15,40,1102,"10,321.97",3090
,20170207,18705,18730,18730,18960,18685,18900,18830,170,100,1434,"13,501.64",3638
,20170208,18900,18830,18830,19440,18775,19375,19185,545,355,2896,"27,784.92",4590
,20170209,19375,19185,19400,19685,19305,19350,19515,165,330,2334,"22,774.79",5338
,20170210,19350,19515,19410,19555,19235,19490,19455,-25,-60,4770,"46,407.23",7106
,20170213,19490,19455,19590,20150,19520,19985,19815,530,360,6194,"61,372.54",8700
,20170214,19985,19815,20045,20100,19680,19930,19875,115,60,3892,"38,681.83",8978
,20170215,19930,19875,19925,19965,19305,19450,19590,-425,-285,3536,"34,642.82",8618
,20170216,19450,19590,19380,19550,19015,19110,19345,-480,-245,3636,"35,172.06",8706
,20170217,19110,19345,18950,19065,18765,18820,18920,-525,-425,4450,"42,106.26",9252
,20170220,18820,18920,18810,18940,18690,18870,18835,-50,-85,4402,"41,458.25",10704
,20170221,18870,18835,19000,19395,19000,19200,19155,365,320,4120,"39,464.72",10534
,20170222,19200,19155,19130,19170,18750,18860,18965,-295,-190,3908,"37,064.09",11284
,20170223,18860,18965,19000,19190,18675,18795,19000,-170,35,5078,"48,250.05",12174
,20170224,18795,19000,19000,19000,18485,18795,18740,-205,-260,3716,"34,820.92",12394
,20170227,18795,18740,18795,19060,18570,18625,18820,-115,80,7766,"73,079.09",13410
,20170228,18625,18820,18700,18755,18430,18525,18590,-295,-230,8070,"75,017.92",14420
,20170301,18525,18590,18575,18780,18515,18685,18635,95,45,7948,"74,067.74",15260
,20170302,18685,18635,18800,19350,18785,18920,18905,285,270,13686,"129,392.13",16358
,20170303,18920,18905,18820,18845,18545,18675,18680,-230,-225,10898,"101,799.24",18148
,20170306,18675,18680,18645,18725,18100,18160,18425,-520,-255,17368,"160,017.34",20162
,20170307,18160,18425,18155,18290,18040,18085,18140,-340,-285,11936,"108,287.68",21216
,20170308,18085,18140,18065,18195,17805,18080,17995,-60,-145,20020,"180,138.12",23154
,20170309,18080,17995,18160,18195,17660,17720,17920,-275,-75,16460,"147,489.16",23966
,20170310,17720,17920,17755,18045,17755,17945,17925,25,5,13968,"125,216.13",24362
,20170313,17945,17925,18025,18350,17900,18260,18105,335,180,19186,"173,686.13",24164
,20170314,18260,18105,18325,18440,18005,18140,18215,35,110,17502,"159,437.22",25128
,20170315,18140,18215,17950,18280,17755,18160,18045,-55,-170,31148,"281,047.56",30494
,20170316,18160,18045,18170,18540,18170,18540,18390,495,345,34162,"314,124.07",35356
,20170317,18540,18390,18590,18590,18310,18455,18420,65,30,26778,"246,629.83",35274
,20170320,18455,18420,18535,18715,18320,18545,18550,125,130,38192,"354,306.13",37612
,20170321,18545,18550,18560,18605,18200,18445,18430,-105,-120,40570,"373,902.88",38988
,20170322,18445,18430,18600,18600,17925,18060,18225,-370,-205,62290,"567,762.28",41484
,20170323,18060,18225,18325,18790,18175,18605,18510,380,285,100258,"927,891.06",46156
,20170324,18605,18510,18605,18605,18100,18230,18250,-280,-260,83668,"763,651.95",47766
,20170327,18230,18250,18160,18315,17690,17730,18020,-520,-230,79576,"716,981.39",48246
,20170328,17730,18020,17750,17810,17145,17275,17405,-745,-615,112008,"974,769.12",53248
,20170329,17275,17405,17410,17700,17230,17525,17455,120,50,122042,"1,065,360.39",55650
,20170330,17525,17455,17455,17585,17115,17270,17380,-185,-75,106494,"925,525.88",57486
,20170331,17270,17380,17320,17590,17265,17400,17410,20,30,91066,"792,750.06",52558
,20170405,17400,17410,17300,17625,17200,17535,17470,125,60,47766,"417,281.55",49080
,20170406,17535,17470,17560,17695,17420,17580,17540,110,70,60640,"531,916.07",50662
,20170407,17580,17540,17650,17650,16310,16325,17060,-1215,-480,124938,"1,065,787.86",51654
,20170410,16325,17060,16350,16655,16240,16480,16460,-580,-600,90798,"747,316.68",45026
,20170411,16480,16460,16465,16550,16240,16340,16380,-120,-80,72748,"595,830.84",43252
,20170412,16340,16380,16460,16520,15920,16250,16250,-130,-130,95498,"775,991.28",41142
,20170413,16250,16250,16335,16545,16135,16485,16365,235,115,65180,"533,358.62",38526
,20170414,16485,16365,16455,16505,16085,16175,16315,-190,-50,58510,"477,424.31",36460
,20170417,16175,16315,16170,16760,16135,16445,16465,130,150,59890,"493,149.27",33834
,20170418,16445,16465,16440,16605,15895,16140,16225,-325,-240,53628,"435,135.34",31228
,20170419,16140,16225,16090,16125,15510,15915,15780,-310,-445,41408,"326,803.25",25820
,20170420,15915,15780,16035,16210,15780,16115,16000,335,220,20596,"164,780.58",24052
,20170421,16115,16000,16145,16250,15955,16045,16105,45,105,14042,"113,076.82",22682
,20170424,16045,16105,15975,16025,15740,15935,15880,-170,-225,9198,"73,035.99",21716
,20170425,15935,15880,15945,15990,15800,15885,15865,5,-15,7258,"57,575.64",19358
,20170426,15885,15865,15950,16125,15885,16030,16020,165,155,4728,"37,875.10",17880
,20170427,16030,16020,16090,16150,16000,16055,16060,35,40,7268,"58,364.46",14322
,20170428,16055,16060,16155,16315,16060,16265,16160,205,100,5564,"44,961.28",11500
,20170502,16265,16160,16450,16700,16310,16360,16485,200,325,930,"7,667.40",11520
,20170503,16360,16485,16305,16385,16130,16150,16225,-335,-260,1070,"8,681.73",11400
,20170504,16150,16225,16030,16065,15820,15960,15995,-265,-230,1560,"12,478.75",10990
,20170505,15960,15995,15875,16090,15875,15965,16010,-30,15,1250,"10,007.70",10930
,20170508,15965,16010,15980,16050,15720,15920,15845,-90,-165,2250,"17,826.03",10250
,20170509,15920,15845,15920,16025,15840,15940,15935,95,90,1020,"8,129.25",9700
,20170510,15940,15935,16050,16160,16000,16050,16080,115,145,1620,"13,026.00",9530
,20170511,16050,16080,16150,16290,16040,16290,16140,210,60,920,"7,424.63",9630
,20170512,16290,16140,16150,16150,15990,16000,16025,-140,-115,180,"1,442.45",9600
,20170515,16000,16025,15800,15925,15775,15840,15820,-185,-205,670,"5,301.00",9390
pb1706,20170103,17370,17475,17800,17805,17550,17550,17720,75,245,10,88.62,458
,20170104,17550,17720,17505,17530,17300,17525,17400,-195,-320,56,487.23,468
,20170105,17525,17400,17715,17915,17700,17840,17830,440,430,124,"1,105.48",494
,20170106,17840,17830,17815,18055,17705,17900,17835,70,5,88,784.86,502
,20170109,17900,17835,17980,18055,17870,18050,18000,215,165,150,"1,350.25",566
,20170110,18050,18000,18215,18790,18195,18710,18525,710,525,352,"3,261.02",668
,20170111,18710,18525,18900,18995,18670,18795,18805,270,280,300,"2,820.97",860
,20170112,18795,18805,18730,18855,18405,18645,18620,-160,-185,202,"1,880.87",872
,20170113,18645,18620,18900,18900,18495,18550,18685,-70,65,176,"1,644.72",894
,20170116,18550,18685,18680,19130,18600,18950,18935,265,250,232,"2,197.02",980
,20170117,18950,18935,19100,19100,18300,18300,18745,-635,-190,94,881.03,958
,20170118,18300,18745,18430,18605,18430,18605,18510,-140,-235,12,111.07,958
,20170119,18605,18510,18495,18540,18400,18450,18450,-60,-60,56,516.70,958
,20170120,18450,18450,18505,18505,17985,18000,18125,-450,-325,96,870.11,962
,20170123,18000,18125,18150,18920,18100,18920,18485,795,360,36,332.79,954
,20170124,18920,18485,18700,18855,18415,18520,18570,35,85,68,631.51,950
,20170125,18520,18570,18855,18855,18835,18835,18840,265,270,8,75.36,956
,20170126,18835,18840,18915,19045,18795,19045,18930,205,90,34,321.86,942
,20170203,19045,18930,18720,18760,18540,18575,18720,-355,-210,30,280.83,964
,20170206,18575,18720,18585,18860,18585,18805,18775,85,55,44,413.14,964
,20170207,18805,18775,18680,18885,18680,18850,18805,75,30,8,75.24,964
,20170208,18850,18805,18795,19385,18790,19385,19035,580,230,104,990.08,1024
,20170209,19385,19035,19655,19655,19300,19300,19495,265,460,42,409.50,1036
,20170210,19300,19495,19435,19535,19300,19455,19395,-40,-100,132,"1,280.38",1040
,20170213,19455,19395,19640,20085,19530,20005,19920,610,525,682,"6,793.08",1350
,20170214,20005,19920,20000,20040,19700,19920,19865,0,-55,560,"5,563.04",1556
,20170215,19920,19865,19680,19755,19340,19510,19570,-355,-295,360,"3,523.12",1638
,20170216,19510,19570,19365,19580,19100,19100,19405,-470,-165,550,"5,336.73",1698
,20170217,19100,19405,19050,19100,18830,18940,18990,-465,-415,824,"7,824.56",1922
,20170220,18940,18990,18915,18960,18770,18920,18890,-70,-100,884,"8,351.45",2186
,20170221,18920,18890,19070,19385,19040,19260,19135,370,245,356,"3,406.57",2160
,20170222,19260,19135,19260,19260,18850,18945,18980,-190,-155,120,"1,139.06",2180
,20170223,18945,18980,19010,19205,18695,18795,19015,-185,35,182,"1,730.41",2270
,20170224,18795,19015,19005,19005,18560,18915,18775,-100,-240,112,"1,051.52",2276
,20170227,18915,18775,18850,19070,18665,18695,18835,-80,60,122,"1,149.17",2308
,20170228,18695,18835,18650,18785,18495,18555,18670,-280,-165,244,"2,278.10",2294
,20170301,18555,18670,18630,18820,18580,18740,18705,70,35,320,"2,992.92",2394
,20170302,18740,18705,18835,19165,18835,19000,19000,295,295,1124,"10,680.02",3016
,20170303,19000,19000,18895,18895,18570,18790,18715,-210,-285,442,"4,136.56",3144
,20170306,18790,18715,18765,18775,18200,18255,18500,-460,-215,366,"3,386.31",3214
,20170307,18255,18500,18255,18330,18100,18160,18215,-340,-285,684,"6,230.13",3422
,20170308,18160,18215,18135,18270,17885,18175,18065,-40,-150,1468,"13,261.21",3610
,20170309,18175,18065,18220,18255,17750,17815,17975,-250,-90,828,"7,441.72",3902
,20170310,17815,17975,17880,18110,17880,17965,18015,-10,40,2034,"18,325.29",4906
,20170313,17965,18015,18075,18420,17845,18395,18210,380,195,1776,"16,173.21",5386
,20170314,18395,18210,18365,18495,18090,18180,18325,-30,115,1502,"13,764.08",6004
,20170315,18180,18325,18055,18360,17830,18235,18145,-90,-180,1646,"14,935.83",6598
,20170316,18235,18145,18285,18600,18285,18600,18455,455,310,2360,"21,781.27",7238
,20170317,18600,18455,18600,18630,18370,18500,18510,45,55,1628,"15,068.61",7734
,20170320,18500,18510,18610,18770,18400,18620,18610,110,100,3816,"35,508.56",8966
,20170321,18620,18610,18655,18680,18320,18535,18470,-75,-140,3696,"34,135.37",9488
,20170322,18535,18470,18630,18645,17975,18150,18320,-320,-150,5130,"46,996.66",10534
,20170323,18150,18320,18400,18840,18265,18670,18575,350,255,6384,"59,297.57",12464
,20170324,18670,18575,18680,18680,18195,18300,18360,-275,-215,4740,"43,515.41",13366
,20170327,18300,18360,18295,18390,17770,17815,18020,-545,-340,7380,"66,501.82",14744
,20170328,17815,18020,17805,17890,17240,17350,17495,-670,-525,10498,"91,856.00",17432
,20170329,17350,17495,17505,17810,17335,17635,17560,140,65,12744,"111,920.89",19980
,20170330,17635,17560,17595,17705,17230,17375,17465,-185,-95,13290,"116,068.78",22678
,20170331,17375,17465,17400,17715,17380,17520,17515,55,50,15766,"138,090.74",24764
,20170405,17520,17515,17420,17745,17350,17650,17580,135,65,9644,"84,789.53",25810
,20170406,17650,17580,17660,17835,17530,17695,17660,115,80,16740,"147,815.84",30156
,20170407,17695,17660,17770,17770,16420,16420,17065,-1240,-595,43620,"372,242.25",28444
,20170410,16420,17065,16420,16750,16340,16545,16535,-520,-530,34912,"288,707.43",31632
,20170411,16545,16535,16570,16600,16350,16430,16485,-105,-50,36504,"300,902.66",34140
,20170412,16430,16485,16565,16640,16145,16360,16370,-125,-115,45690,"374,010.03",36770
,20170413,16360,16370,16365,16650,16240,16580,16480,210,110,34516,"284,420.62",37880
,20170414,16580,16480,16590,16610,16175,16265,16410,-215,-70,42030,"344,931.04",39818
,20170417,16265,16410,16230,16885,16230,16510,16555,100,145,52710,"436,372.61",39248
,20170418,16510,16555,16540,16650,15980,16210,16270,-345,-285,66004,"537,055.03",44112
,20170419,16210,16270,16125,16150,15550,15915,15805,-355,-465,111596,"882,131.49",45230
,20170420,15915,15805,15950,16225,15865,16160,16040,355,235,98740,"791,917.89",44432
,20170421,16160,16040,16145,16320,16010,16085,16150,45,110,85816,"693,138.05",45446
,20170424,16085,16150,16000,16065,15775,15990,15910,-160,-240,89942,"715,637.04",47072
,20170425,15990,15910,16020,16045,15800,15945,15930,35,20,60358,"480,850.48",49114
,20170426,15945,15930,16010,16210,15955,16110,16095,180,165,74400,"598,776.03",48294
,20170427,16110,16095,16135,16250,16100,16180,16175,85,80,56412,"456,365.15",49650
,20170428,16180,16175,16255,16430,16155,16355,16275,180,100,77538,"631,144.93",48768
,20170502,16355,16275,16500,16860,16360,16485,16565,210,290,38988,"322,978.35",48396
,20170503,16485,16565,16500,16520,16195,16230,16345,-335,-220,50978,"416,630.69",49898
,20170504,16230,16345,16185,16230,15870,15995,16085,-350,-260,62948,"506,373.15",50078
,20170505,15995,16085,15950,16205,15905,16020,16090,-65,5,59216,"476,399.03",49308
,20170508,16020,16090,16050,16185,15805,16050,15995,-40,-95,74984,"599,752.08",49714
,20170509,16050,15995,16070,16115,15915,16050,16010,55,15,53752,"430,392.71",49436
,20170510,16050,16010,16060,16280,16055,16190,16175,180,165,66604,"538,721.51",46860
,20170511,16190,16175,16170,16425,16060,16340,16225,165,50,65074,"527,999.01",45568
,20170512,16340,16225,16295,16320,15980,16020,16135,-205,-90,65580,"529,067.43",44224
,20170515,16020,16135,16070,16115,15845,15965,15940,-170,-195,62448,"497,766.92",42494
,20170516,15965,15940,15955,16040,15500,15715,15750,-225,-190,69968,"551,033.53",42310
,20170517,15715,15750,15680,15785,15605,15710,15690,-40,-60,48900,"383,644.38",39916
,20170518,15710,15690,15780,15795,15395,15425,15580,-265,-110,56398,"439,373.83",41712
,20170519,15425,15580,15355,15540,15140,15385,15370,-195,-210,60680,"466,440.72",39936
,20170522,15385,15370,15500,15815,15500,15730,15725,360,355,54122,"425,622.96",35608
,20170523,15730,15725,15805,15955,15600,15795,15775,70,50,44096,"347,884.40",30974
,20170524,15795,15775,15760,15940,15605,15910,15730,135,-45,34732,"273,248.74",24760
,20170525,15910,15730,15940,15970,15790,15910,15875,180,145,15244,"121,013.54",21458
,20170526,15910,15875,15950,15950,15825,15910,15900,35,25,14130,"112,366.43",15302
,20170531,15910,15900,15755,16150,15745,15745,15960,-155,60,6612,"52,780.24",13318
,20170601,15745,15960,15795,16115,15795,16000,16000,40,40,2798,"22,385.66",12030
,20170602,16000,16000,16100,16160,15945,16140,16075,140,75,790,"6,350.18",11780
,20170605,16140,16075,16055,16515,16055,16415,16330,340,255,2680,"21,886.58",10910
,20170606,16415,16330,16400,16610,16355,16550,16510,220,180,2780,"22,955.10",10950
,20170607,16550,16510,16520,16680,16315,16385,16430,-125,-80,1910,"15,692.55",10810
,20170608,16385,16430,16340,16630,16320,16610,16485,180,55,1720,"14,180.98",10710
,20170609,16610,16485,16640,16860,16525,16860,16620,375,135,780,"6,482.93",10640
,20170612,16860,16620,16930,17320,16805,17070,16975,450,355,1270,"10,779.38",10410
,20170613,17070,16975,16930,16930,16700,16800,16840,-175,-135,1130,"9,514.73",10370
,20170614,16800,16840,16900,17180,16750,16935,16905,95,65,770,"6,510.28",10270
,20170615,16935,16905,17250,17250,16870,17160,17105,255,200,1020,"8,725.08",9980
pb1707,20170103,17450,17395,16910,17770,16910,17770,17675,375,280,26,229.81,174
,20170104,17770,17675,17535,17615,17535,17615,17575,-60,-100,4,35.15,172
,20170105,17615,17575,17790,17790,17775,17775,17780,200,205,4,35.57,170
,20170106,17775,17780,17780,17885,17780,17885,17865,105,85,12,107.21,160
,20170109,17885,17865,17935,18060,17935,18060,17995,195,130,10,89.98,162
,20170110,18060,17995,18030,19250,18030,18800,18365,805,370,58,532.63,184
,20170111,18800,18365,19050,19050,18650,18760,18805,395,440,8,75.22,186
,20170112,18760,18805,18585,18655,18585,18595,18605,-210,-200,8,74.43,184
,20170113,18595,18605,18640,18705,18635,18635,18695,30,90,36,336.55,210
,20170116,18635,18695,19100,19150,19100,19150,19110,455,415,8,76.45,212
,20170117,19150,19110,19150,19150,18500,18500,18960,-610,-150,12,113.78,208
,20170118,18500,18960,,,,18960,18960,0,0,0,0.00,208
,20170119,18960,18960,,,,18960,18960,0,0,0,0.00,208
,20170120,18960,18960,18000,18000,18000,18000,18000,-960,-960,18,162.00,214
,20170123,18000,18000,18130,18680,18130,18680,18410,680,410,6,55.24,212
,20170124,18680,18410,,,,18410,18410,0,0,0,0.00,212
,20170125,18410,18410,18835,18835,18835,18835,18835,425,425,2,18.84,214
,20170126,18835,18835,18915,19050,18915,18925,18930,90,95,18,170.40,216
,20170203,18925,18930,,,,18930,18930,0,0,0,0.00,216
,20170206,18930,18930,18755,18755,18755,18755,18755,-175,-175,2,18.76,218
,20170207,18755,18755,18755,18850,18755,18850,18780,95,25,32,300.55,206
,20170208,18850,18780,19215,19400,19215,19235,19280,455,500,14,134.98,204
,20170209,19235,19280,19605,19605,19385,19385,19525,105,245,18,175.76,214
,20170210,19385,19525,19535,19535,19535,19535,19535,10,10,2,19.54,214
,20170213,19535,19535,19650,20000,19590,20000,19730,465,195,42,414.42,216
,20170214,20000,19730,19725,19905,19695,19880,19780,150,50,66,652.90,248
,20170215,19880,19780,19590,19695,19345,19540,19545,-240,-235,32,312.75,244
,20170216,19540,19545,19310,19555,19120,19120,19330,-425,-215,62,599.32,282
,20170217,19120,19330,19080,19080,18870,18945,18940,-385,-390,156,"1,477.68",342
,20170220,18945,18940,18885,18995,18780,18850,18860,-90,-80,140,"1,320.51",348
,20170221,18850,18860,19860,19860,19110,19275,19280,415,420,26,250.68,358
,20170222,19275,19280,18985,19045,18885,18885,18960,-395,-320,30,284.45,376
,20170223,18885,18960,19175,19215,18800,18845,18900,-115,-60,112,"1,058.49",448
,20170224,18845,18900,18990,18990,18660,18895,18760,-5,-140,20,187.64,430
,20170227,18895,18760,18930,19060,18705,18750,18810,-10,50,18,169.30,438
,20170228,18750,18810,18595,18595,18530,18530,18550,-280,-260,20,185.50,426
,20170301,18530,18550,18750,18750,18710,18710,18730,160,180,16,149.85,434
,20170302,18710,18730,18925,19155,18910,19155,19015,425,285,42,399.33,462
,20170303,19155,19015,18855,18855,18700,18720,18770,-295,-245,32,300.40,472
,20170306,18720,18770,18525,18525,18520,18520,18520,-250,-250,12,111.13,482
,20170307,18520,18520,18250,18375,18225,18290,18265,-230,-255,22,200.96,488
,20170308,18290,18265,18225,18295,17970,18180,18035,-85,-230,98,883.86,444
,20170309,18180,18035,18235,18235,17925,17925,18000,-110,-35,92,828.05,436
,20170310,17925,18000,18045,18110,17980,18110,18050,110,50,22,198.56,436
,20170313,18110,18050,18235,18290,18235,18290,18260,240,210,4,36.53,434
,20170314,18290,18260,18450,18450,18180,18235,18330,-25,70,76,696.57,462
,20170315,18235,18330,18100,18330,18000,18180,18245,-150,-85,46,419.70,454
,20170316,18180,18245,18560,18570,18345,18570,18400,325,155,82,754.47,516
,20170317,18570,18400,18485,18600,18485,18540,18555,140,155,100,927.96,576
,20170320,18540,18555,18645,18780,18475,18600,18665,45,110,534,"4,984.77",944
,20170321,18600,18665,18645,18650,18375,18625,18520,-40,-145,280,"2,593.16",992
,20170322,18625,18520,18585,18605,18015,18165,18225,-355,-295,344,"3,135.41",1090
,20170323,18165,18225,18350,18880,18310,18725,18695,500,470,622,"5,815.57",1492
,20170324,18725,18695,18660,18660,18250,18275,18425,-420,-270,166,"1,529.58",1536
,20170327,18275,18425,18270,18335,17875,17875,18180,-550,-245,276,"2,509.31",1676
,20170328,17875,18180,17875,17875,17385,17400,17570,-780,-610,460,"4,041.33",1732
,20170329,17400,17570,17600,17790,17465,17640,17600,70,30,256,"2,253.17",1724
,20170330,17640,17600,17570,17940,17345,17515,17565,-85,-35,196,"1,721.78",1790
,20170331,17515,17565,17470,17770,17465,17620,17560,55,-5,394,"3,459.54",1846
,20170405,17620,17560,17510,17760,17510,17695,17655,135,95,174,"1,535.99",1940
,20170406,17695,17655,17640,17870,17630,17790,17700,135,45,596,"5,276.09",2196
,20170407,17790,17700,17820,17855,16460,16460,17080,-1240,-620,1530,"13,068.21",2432
,20170410,16460,17080,16490,16800,16400,16600,16545,-480,-535,1542,"12,758.46",2382
,20170411,16600,16545,16630,16660,16405,16505,16570,-40,25,3174,"26,296.92",3486
,20170412,16505,16570,16625,16735,16255,16435,16510,-135,-60,4056,"33,491.15",5166
,20170413,16435,16510,16505,16740,16365,16680,16595,170,85,4422,"36,694.88",6476
,20170414,16680,16595,16645,16705,16285,16350,16515,-245,-80,1270,"10,488.72",6312
,20170417,16350,16515,16385,16975,16355,16615,16655,100,140,1260,"10,493.05",6326
,20170418,16615,16655,16555,16785,16065,16280,16335,-375,-320,2264,"18,495.06",6712
,20170419,16280,16335,16190,16210,15605,15935,15865,-400,-470,2682,"21,280.58",7218
,20170420,15935,15865,16050,16250,15910,16190,16075,325,210,2624,"21,095.80",7550
,20170421,16190,16075,16145,16325,16045,16105,16185,30,110,2506,"20,284.29",7700
,20170424,16105,16185,16010,16080,15820,16020,15915,-165,-270,3306,"26,314.42",8104
,20170425,16020,15915,16020,16050,15900,15985,15975,70,60,2474,"19,761.35",8830
,20170426,15985,15975,16050,16245,16000,16170,16140,195,165,2908,"23,471.59",9724
,20170427,16170,16140,16210,16295,16180,16265,16245,125,105,6732,"54,686.79",13932
,20170428,16265,16245,16320,16495,16225,16440,16350,195,105,8382,"68,524.50",16226
,20170502,16440,16350,16565,16925,16435,16555,16635,205,285,6168,"51,311.22",16956
,20170503,16555,16635,16585,16590,16265,16320,16405,-315,-230,6354,"52,133.22",17640
,20170504,16320,16405,16205,16285,15955,16090,16145,-315,-260,9966,"80,461.78",18880
,20170505,16090,16145,15995,16300,15975,16130,16185,-15,40,11124,"90,024.43",20560
,20170508,16130,16185,16135,16275,15900,16125,16080,-60,-105,11982,"96,336.48",21570
,20170509,16125,16080,16125,16200,16000,16145,16105,65,25,8912,"71,777.26",23158
,20170510,16145,16105,16165,16375,16155,16285,16265,180,160,15110,"122,903.53",23986
,20170511,16285,16265,16260,16525,16160,16465,16315,200,50,17916,"146,192.13",25738
,20170512,16465,16315,16410,16420,16075,16110,16210,-205,-105,22766,"184,542.44",27296
,20170515,16110,16210,16115,16180,15920,16065,16025,-145,-185,26490,"212,286.72",28062
,20170516,16065,16025,16060,16135,15615,15800,15830,-225,-195,30512,"241,564.32",31118
,20170517,15800,15830,15760,15880,15705,15795,15780,-35,-50,25616,"202,155.59",31288
,20170518,15795,15780,15895,15895,15495,15535,15670,-245,-110,31710,"248,475.80",35958
,20170519,15535,15670,15425,15640,15235,15470,15460,-200,-210,36562,"282,683.83",37792
,20170522,15470,15460,15660,15920,15605,15830,15820,370,360,42408,"335,500.48",36876
,20170523,15830,15820,15875,16040,15700,15865,15870,45,50,43906,"348,442.78",39546
,20170524,15865,15870,15840,15975,15655,15930,15795,60,-75,55654,"439,561.02",40930
,20170525,15930,15795,15920,15980,15815,15930,15885,135,90,45214,"359,159.52",41276
,20170526,15930,15885,15930,16010,15855,15980,15950,95,65,51978,"414,543.87",42692
,20170531,15980,15950,15930,16215,15770,15835,15985,-115,35,47906,"382,946.36",43148
,20170601,15835,15985,15865,16170,15800,16090,16020,105,35,66008,"528,743.73",43596
,20170602,16090,16020,16075,16250,16000,16185,16130,165,110,64596,"521,082.38",43184
,20170605,16185,16130,16110,16630,16040,16500,16385,370,255,81638,"668,830.37",44030
,20170606,16500,16385,16450,16720,16400,16605,16590,220,205,78250,"649,136.79",44846
,20170607,16605,16590,16590,16780,16375,16480,16525,-110,-65,86514,"714,979.07",42986
,20170608,16480,16525,16485,16750,16370,16670,16535,145,10,64474,"533,195.70",41870
,20170609,16670,16535,16675,16920,16530,16850,16710,315,175,64594,"539,722.27",41812
,20170612,16850,16710,16985,17120,16825,17070,16975,360,265,59566,"505,601.83",39296
,20170613,17070,16975,17035,17050,16725,16825,16870,-150,-105,60088,"506,971.01",38156
,20170614,16825,16870,16975,17030,16685,16975,16870,105,0,64860,"547,141.57",35972
,20170615,16975,16870,16975,17215,16920,17110,17105,240,235,68668,"587,364.81",36828
,20170616,17110,17105,17125,17380,17120,17295,17285,190,180,50788,"439,000.62",35858
,20170619,17295,17285,17280,17485,17165,17405,17310,120,25,50992,"441,389.10",33574
,20170620,17405,17310,17410,17780,17355,17675,17560,365,250,51894,"455,676.83",34806
,20170621,17675,17560,17620,17740,17460,17600,17575,40,15,56964,"500,660.88",32566
,20170622,17600,17575,17785,17835,17605,17660,17725,85,150,51356,"455,211.67",30262
,20170623,17660,17725,17750,17780,17380,17460,17560,-265,-165,44926,"394,532.16",25646
,20170626,17460,17560,17495,17500,17100,17300,17250,-260,-310,49698,"428,759.20",21760
,20170627,17300,17250,17290,17480,17190,17430,17290,180,40,20752,"179,415.51",18030
,20170628,17430,17290,17350,17885,17350,17730,17680,440,390,12936,"114,364.90",14432
,20170629,17730,17680,17715,17920,17630,17805,17790,125,110,5722,"50,901.25",13192
,20170630,17805,17790,17800,17930,17705,17880,17825,90,35,3922,"34,957.01",12000
,20170703,17880,17825,17840,18305,17820,18280,18095,455,270,1510,"13,665.20",10970
,20170704,18280,18095,18160,18310,17785,17870,18095,-225,0,3690,"33,392.45",8860
,20170705,17870,18095,17890,18000,17550,17560,17835,-535,-260,2010,"17,928.35",7210
,20170706,17560,17835,17460,17835,17410,17835,17585,0,-250,1400,"12,309.98",6350
,20170707,17835,17585,17750,17965,17720,17960,17795,375,210,980,"8,720.98",5540
,20170710,17960,17795,17995,18000,17675,17680,17825,-115,30,850,"7,577.03",5060
,20170711,17680,17825,17610,18000,17610,17980,17850,155,25,1530,"13,657.60",4580
,20170712,17980,17850,18120,18120,17915,17995,17960,145,110,1960,"17,601.63",4570
,20170713,17995,17960,17920,17980,17885,17960,17925,0,-35,300,"2,688.90",4530
,20170714,17960,17925,17655,17655,17500,17580,17585,-345,-340,190,"1,670.73",4340
,20170717,17580,17585,17820,18000,17700,17840,17860,255,275,520,"4,643.75",4320
pb1708,20170103,17675,17675,17760,17760,17760,17760,17760,85,85,2,17.76,134
,20170104,17760,17760,17465,17615,17355,17605,17465,-155,-295,16,139.72,130
,20170105,17605,17465,17840,17890,17790,17790,17850,325,385,18,160.66,134
,20170106,17790,17850,,,,17850,17850,0,0,0,0.00,134
,20170109,17850,17850,17965,18105,17945,18105,18005,255,155,24,216.08,142
,20170110,18105,18005,18075,18590,18065,18590,18290,585,285,18,164.63,134
,20170111,18590,18290,18980,19325,18760,18780,19040,490,750,84,799.83,134
,20170112,18780,19040,18830,18830,18525,18525,18660,-515,-380,16,149.29,132
,20170113,18525,18660,18745,18820,18525,18525,18735,-135,75,30,281.04,140
,20170116,18525,18735,18960,18960,18960,18960,18960,225,225,2,18.96,138
,20170117,18960,18960,18980,18980,18410,18410,18630,-550,-330,20,186.34,142
,20170118,18410,18630,,,,18630,18630,0,0,0,0.00,142
,20170119,18630,18630,18560,18560,18560,18560,18560,-70,-70,18,167.04,134
,20170120,18560,18560,,,,18100,18100,-460,-460,0,0.00,134
,20170123,18100,18100,18170,18170,18170,18170,18170,70,70,2,18.17,136
,20170124,18170,18170,18600,18600,18600,18600,18600,430,430,2,18.60,138
,20170125,18600,18600,,,,18600,18600,0,0,0,0.00,138
,20170126,18600,18600,18920,18950,18920,18940,18935,340,335,6,56.81,136
,20170203,18940,18935,,,,18880,18880,-55,-55,0,0.00,136
,20170206,18880,18880,18655,18655,18655,18655,18655,-225,-225,2,18.66,136
,20170207,18655,18655,18775,18790,18775,18790,18780,135,125,10,93.91,126
,20170208,18790,18780,19015,19435,19015,19435,19210,655,430,22,211.32,116
,20170209,19435,19210,19465,19650,19465,19465,19545,255,335,24,234.54,110
,20170210,19465,19545,,,,19545,19545,0,0,0,0.00,110
,20170213,19545,19545,19635,19635,19635,19635,19635,90,90,2,19.64,112
,20170214,19635,19635,19895,19920,19825,19840,19850,205,215,24,238.24,104
,20170215,19840,19850,,,,19790,19790,-60,-60,0,0.00,104
,20170216,19790,19790,19470,19470,19430,19430,19450,-360,-340,4,38.90,104
,20170217,19430,19450,18985,19005,18920,18920,18960,-530,-490,14,132.74,102
,20170220,18920,18960,18875,18915,18765,18915,18880,-45,-80,46,434.30,126
,20170221,18915,18880,19175,19300,19175,19300,19235,420,355,4,38.48,126
,20170222,19300,19235,18980,19015,18970,19015,18985,-220,-250,6,56.97,128
,20170223,19015,18985,19095,19095,19050,19050,19070,65,85,6,57.22,128
,20170224,19050,19070,19010,19010,18960,18960,18985,-110,-85,10,94.94,130
,20170227,18960,18985,18990,19025,18990,19025,19005,40,20,4,38.02,128
,20170228,19025,19005,18770,18770,18770,18770,18770,-235,-235,2,18.77,128
,20170301,18770,18770,18700,18700,18700,18700,18700,-70,-70,2,18.70,126
,20170302,18700,18700,18895,19115,18875,19115,18965,415,265,16,151.74,134
,20170303,19115,18965,18890,18890,18750,18750,18810,-215,-155,22,206.96,144
,20170306,18750,18810,18600,18600,18600,18600,18600,-210,-210,2,18.60,144
,20170307,18600,18600,,,,18470,18470,-130,-130,0,0.00,144
,20170308,18470,18470,17980,18185,17955,18185,18035,-285,-435,54,487.01,148
,20170309,18185,18035,18200,18200,17945,17945,18095,-90,60,42,380.06,150
,20170310,17945,18095,,,,18095,18095,0,0,0,0.00,150
,20170313,18095,18095,18210,18325,18210,18325,18265,230,170,4,36.54,148
,20170314,18325,18265,18485,18485,18285,18480,18385,215,120,30,275.80,162
,20170315,18480,18385,18100,18370,17940,18240,18090,-145,-295,48,434.17,172
,20170316,18240,18090,18525,18600,18465,18545,18525,455,435,26,240.88,166
,20170317,18545,18525,18595,18650,18520,18540,18580,15,55,10,92.90,162
,20170320,18540,18580,18745,18745,18560,18620,18685,40,105,34,317.69,180
,20170321,18620,18685,18680,18680,18420,18630,18570,-55,-115,44,408.64,180
,20170322,18630,18570,18685,18685,18110,18110,18540,-460,-30,56,519.23,214
,20170323,18110,18540,18600,18805,18380,18700,18695,160,155,136,"1,271.52",296
,20170324,18700,18695,18605,18605,18290,18290,18385,-405,-310,20,183.86,296
,20170327,18290,18385,18335,18400,17900,17900,18215,-485,-170,116,"1,056.49",324
,20170328,17900,18215,17675,17675,17460,17535,17540,-680,-675,92,806.89,350
,20170329,17535,17540,17615,17815,17495,17580,17645,40,105,100,882.33,400
,20170330,17580,17645,17590,17820,17385,17510,17660,-135,15,216,"1,907.58",572
,20170331,17510,17660,17580,17825,17525,17630,17605,-30,-55,134,"1,179.86",644
,20170405,17630,17605,17550,17765,17550,17715,17700,110,95,54,478.03,664
,20170406,17715,17700,17815,17880,17660,17765,17775,65,75,20,177.77,660
,20170407,17765,17775,17730,17730,16590,16590,17170,-1185,-605,32,274.74,662
,20170410,16590,17170,16485,16845,16475,16660,16635,-510,-535,480,"3,993.53",948
,20170411,16660,16635,16625,16690,16505,16530,16610,-105,-25,652,"5,415.61",1406
,20170412,16530,16610,16680,16770,16335,16530,16595,-80,-15,658,"5,460.17",1168
,20170413,16530,16595,16590,16810,16465,16810,16660,215,65,228,"1,899.31",1266
,20170414,16810,16660,16795,16795,16680,16680,16720,20,60,16,133.78,1258
,20170417,16680,16720,16660,16940,16600,16630,16755,-90,35,156,"1,307.18",1252
,20170418,16630,16755,16680,16805,16150,16335,16400,-420,-355,590,"4,838.81",1274
,20170419,16335,16400,16165,16165,15660,15965,15905,-435,-495,1032,"8,207.43",1942
,20170420,15965,15905,16150,16245,15965,16190,16085,285,180,552,"4,440.73",2192
,20170421,16190,16085,16180,16330,16045,16100,16175,15,90,436,"3,526.99",2376
,20170424,16100,16175,16020,16080,15845,16000,15955,-175,-220,196,"1,564.04",2420
,20170425,16000,15955,16000,16010,15900,15995,15980,40,25,648,"5,177.63",2834
,20170426,15995,15980,16105,16275,16015,16175,16150,195,170,1068,"8,624.46",3242
,20170427,16175,16150,16215,16295,16215,16280,16260,130,110,630,"5,123.45",3316
,20170428,16280,16260,16345,16500,16240,16400,16365,140,105,1154,"9,445.35",4232
,20170502,16400,16365,16650,16945,16485,16590,16675,225,310,1008,"8,406.44",4616
,20170503,16590,16675,16600,16600,16310,16330,16475,-345,-200,540,"4,449.49",4824
,20170504,16330,16475,16215,16285,15975,16090,16175,-385,-300,632,"5,112.01",4900
,20170505,16090,16175,16070,16320,16070,16155,16205,-20,30,850,"6,888.95",5176
,20170508,16155,16205,16210,16300,15955,16155,16115,-50,-90,714,"5,754.12",5376
,20170509,16155,16115,16135,16225,16070,16210,16145,95,30,340,"2,745.00",5494
,20170510,16210,16145,16185,16430,16180,16320,16295,175,150,436,"3,553.33",5598
,20170511,16320,16295,16355,16545,16240,16500,16385,205,90,698,"5,718.70",5698
,20170512,16500,16385,16585,16585,16110,16135,16275,-250,-110,1060,"8,626.73",6144
,20170515,16135,16275,16220,16220,15970,16120,16080,-155,-195,2084,"16,759.94",5870
,20170516,16120,16080,16170,16175,15690,15875,15885,-205,-195,1750,"13,901.58",6224
,20170517,15875,15885,15820,15945,15760,15835,15840,-50,-45,1558,"12,341.45",6274
,20170518,15835,15840,15935,15950,15560,15565,15735,-275,-105,946,"7,443.95",6382
,20170519,15565,15735,15300,15675,15290,15585,15495,-150,-240,1124,"8,709.88",6476
,20170522,15585,15495,15685,15960,15685,15880,15890,385,395,2048,"16,275.35",7054
,20170523,15880,15890,15985,16105,15760,15915,15930,25,40,2634,"20,980.15",7834
,20170524,15915,15930,15855,16080,15700,15945,15830,15,-100,2824,"22,358.05",7730
,20170525,15945,15830,15945,15995,15835,15930,15900,100,70,4086,"32,489.64",7832
,20170526,15930,15900,15945,16025,15875,15980,15960,80,60,2268,"18,100.84",7950
,20170531,15980,15960,15945,16230,15805,15885,16010,-75,50,5350,"42,833.15",8556
,20170601,15885,16010,15900,16220,15845,16115,16065,105,55,9450,"75,926.87",10004
,20170602,16115,16065,16115,16300,16040,16250,16190,185,125,11162,"90,356.80",10924
,20170605,16250,16190,16150,16670,16100,16550,16430,360,240,16348,"134,337.35",13822
,20170606,16550,16430,16495,16750,16450,16635,16625,205,195,16252,"135,100.90",16222
,20170607,16635,16625,16600,16795,16405,16525,16545,-100,-80,22358,"184,994.15",18262
,20170608,16525,16545,16535,16790,16420,16710,16595,165,50,17978,"149,181.00",20544
,20170609,16710,16595,16715,16950,16565,16875,16745,280,150,21460,"179,694.60",21276
,20170612,16875,16745,17000,17150,16845,17080,17000,335,255,19994,"169,992.93",23686
,20170613,17080,17000,17055,17055,16705,16800,16845,-200,-155,27066,"227,973.74",27442
,20170614,16800,16845,16950,16955,16630,16820,16785,-25,-60,28956,"243,070.34",26560
,20170615,16820,16785,16835,17000,16775,16895,16915,110,130,25506,"215,743.63",27080
,20170616,16895,16915,16950,17220,16875,17185,17115,270,200,27236,"233,136.91",29020
,20170619,17185,17115,17120,17395,17085,17355,17240,240,125,26738,"230,509.58",29900
,20170620,17355,17240,17385,17650,17315,17550,17475,310,235,32416,"283,305.32",32830
,20170621,17550,17475,17500,17575,17310,17385,17420,-90,-55,33012,"287,564.55",33186
,20170622,17385,17420,17580,17695,17475,17535,17585,115,165,41850,"368,056.34",34448
,20170623,17535,17585,17650,17665,17210,17375,17440,-210,-145,40458,"352,836.92",35830
,20170626,17375,17440,17385,17405,17050,17180,17185,-260,-255,57296,"492,397.89",39018
,20170627,17180,17185,17200,17440,17130,17405,17260,220,75,55670,"480,511.03",40682
,20170628,17405,17260,17410,17890,17390,17715,17660,455,400,81712,"721,599.45",42506
,20170629,17715,17660,17675,17865,17590,17735,17735,75,75,62458,"553,894.94",41686
,20170630,17735,17735,17750,17880,17580,17800,17755,65,20,63714,"565,631.37",42578
,20170703,17800,17755,17800,18170,17725,18100,17930,345,175,54544,"489,095.27",43814
,20170704,18100,17930,18050,18210,17655,17765,17975,-165,45,55684,"500,597.39",43638
,20170705,17765,17975,17705,17930,17420,17475,17690,-500,-285,77920,"689,256.95",41690
,20170706,17475,17690,17440,17650,17315,17580,17450,-110,-240,54754,"477,792.49",40296
,20170707,17580,17450,17645,17850,17530,17810,17655,360,205,46536,"410,820.23",40234
,20170710,17810,17655,17750,17890,17545,17580,17730,-75,75,55864,"495,357.40",39612
,20170711,17580,17730,17600,18000,17500,17985,17760,255,30,66932,"594,471.87",41878
,20170712,17985,17760,17950,18085,17810,17920,17950,160,190,50180,"450,437.90",40168
,20170713,17920,17950,17950,17995,17785,17885,17880,-65,-70,32140,"287,385.78",38954
,20170714,17885,17880,17865,17905,17470,17600,17615,-280,-265,46050,"405,650.00",37408
,20170717,17600,17615,17695,17890,17560,17835,17770,220,155,40386,"358,911.10",35468
,20170718,17835,17770,17760,17940,17510,17635,17725,-135,-45,44976,"398,698.63",34018
,20170719,17635,17725,17560,17635,17410,17535,17530,-190,-195,39424,"345,591.55",31818
,20170720,17535,17530,17425,17485,17230,17370,17340,-160,-190,42540,"368,872.07",26864
,20170721,17370,17340,17410,17465,17220,17460,17355,120,15,40034,"347,490.57",23756
,20170724,17460,17355,17560,17635,17375,17445,17515,90,160,24926,"218,314.32",20034
,20170725,17445,17515,17415,17590,17205,17580,17460,65,-55,16656,"145,426.88",17128
,20170726,17580,17460,17610,18070,17600,17880,17740,420,280,16484,"146,216.90",13512
,20170727,17880,17740,17870,18150,17800,18130,17985,390,245,9554,"85,936.59",12574
,20170728,18130,17985,18120,18210,17880,18020,18060,35,75,7186,"64,907.53",11618
,20170731,18020,18060,18065,18400,18065,18285,18240,225,180,5862,"53,468.18",9164
,20170801,18285,18240,18300,18330,18145,18165,18205,-75,-35,1434,"13,053.39",8150
,20170802,18165,18205,18170,18385,18145,18350,18225,145,20,1660,"15,129.00",7530
,20170803,18350,18225,18500,18700,18430,18555,18610,330,385,840,"7,817.60",7260
,20170804,18555,18610,18450,18650,18450,18640,18610,30,0,1100,"10,236.73",6420
,20170807,18640,18610,18610,18910,18555,18875,18810,265,200,780,"7,337.40",6400
,20170808,18875,18810,19030,19110,19000,19035,19040,225,230,670,"6,379.63",5930
,20170809,19035,19040,18960,19815,18950,19770,19530,730,490,820,"8,007.60",5770
,20170810,19770,19530,19655,19655,19360,19450,19465,-80,-65,980,"9,538.78",5720
,20170811,19450,19465,19100,19175,18995,18995,19115,-470,-350,50,477.98,5680
,20170814,18995,19115,19125,19995,18800,18800,19090,-315,-25,1490,"14,222.33",4290
,20170815,18800,19090,20100,20200,19000,19995,19825,905,735,70,693.98,4280
pb1709,20170103,17590,17580,17700,17800,17695,17695,17755,115,175,18,159.82,158
,20170104,17695,17755,17470,17665,17470,17665,17535,-90,-220,10,87.69,158
,20170105,17665,17535,17900,17915,17860,17865,17880,330,345,10,89.41,150
,20170106,17865,17880,17940,18075,17890,17905,17940,25,60,12,107.66,146
,20170109,17905,17940,17960,18100,17945,18035,18005,95,65,22,198.06,144
,20170110,18035,18005,18070,18865,18070,18865,18390,860,385,58,533.42,154
,20170111,18865,18390,19020,19085,18760,18775,18860,385,470,26,245.18,158
,20170112,18775,18860,18835,18895,18545,18720,18735,-140,-125,22,206.11,160
,20170113,18720,18735,18830,18880,18545,18590,18755,-145,20,28,262.63,166
,20170116,18590,18755,18740,19125,18740,19075,19005,320,250,18,171.05,158
,20170117,19075,19005,19165,19165,18465,18490,18795,-515,-210,50,469.93,154
,20170118,18490,18795,18430,18720,18430,18720,18530,-75,-265,6,55.59,152
,20170119,18720,18530,,,,18475,18475,-55,-55,0,0.00,152
,20170120,18475,18475,,,,18100,18100,-375,-375,0,0.00,152
,20170123,18100,18100,19200,19200,19200,19200,19200,1100,1100,2,19.20,154
,20170124,19200,19200,18735,18735,18735,18735,18735,-465,-465,2,18.74,154
,20170125,18735,18735,18920,18920,18920,18920,18920,185,185,2,18.92,152
,20170126,18920,18920,18930,18930,18930,18930,18930,10,10,4,37.86,148
,20170203,18930,18930,18925,18925,18710,18710,18870,-220,-60,10,94.35,144
,20170206,18710,18870,18780,18780,18780,18780,18780,-90,-90,2,18.78,146
,20170207,18780,18780,18715,18760,18715,18760,18745,-20,-35,6,56.24,142
,20170208,18760,18745,18940,19290,18940,19155,19160,410,415,18,172.46,136
,20170209,19155,19160,19295,19645,19295,19390,19560,230,400,26,254.32,142
,20170210,19390,19560,19335,19335,19335,19335,19335,-225,-225,2,19.34,142
,20170213,19335,19335,19635,20000,19635,20000,19865,665,530,12,119.21,134
,20170214,20000,19865,19910,19910,19795,19795,19815,-70,-50,10,99.09,142
,20170215,19795,19815,19675,19675,19675,19675,19675,-140,-140,2,19.68,140
,20170216,19675,19675,19380,19380,19230,19230,19320,-445,-355,6,57.97,138
,20170217,19230,19320,19015,19065,18925,18925,19020,-395,-300,10,95.10,142
,20170220,18925,19020,18885,18900,18835,18900,18860,-120,-160,10,94.32,140
,20170221,18900,18860,19260,19260,19260,19260,19260,400,400,2,19.26,142
,20170222,19260,19260,19025,19025,19025,19025,19025,-235,-235,2,19.03,142
,20170223,19025,19025,,,,19025,19025,0,0,0,0.00,142
,20170224,19025,19025,19005,19005,19005,19005,19005,-20,-20,2,19.01,140
,20170227,19005,19005,18855,19050,18855,18905,18920,-100,-85,8,75.69,148
,20170228,18905,18920,18765,18765,18765,18765,18765,-155,-155,2,18.77,148
,20170301,18765,18765,18650,18695,18650,18695,18670,-70,-95,4,37.35,150
,20170302,18695,18670,18940,19180,18925,19025,19065,355,395,22,209.76,160
,20170303,19025,19065,19025,19025,18800,18850,18850,-215,-215,14,131.97,168
,20170306,18850,18850,18585,18585,18370,18420,18440,-430,-410,8,73.78,172
,20170307,18420,18440,18355,18395,18255,18280,18335,-160,-105,14,128.35,168
,20170308,18280,18335,18025,18160,18025,18160,18075,-175,-260,6,54.23,164
,20170309,18160,18075,18195,18260,17790,17985,17950,-90,-125,112,"1,005.25",122
,20170310,17985,17950,18015,18120,18015,18120,18065,170,115,4,36.14,120
,20170313,18120,18065,18300,18300,18300,18300,18300,235,235,2,18.30,118
,20170314,18300,18300,18565,18565,18565,18565,18565,265,265,2,18.57,118
,20170315,18565,18565,18080,18360,18080,18360,18200,-205,-365,8,72.81,118
,20170316,18360,18200,18505,18715,18505,18665,18595,465,395,8,74.40,120
,20170317,18665,18595,18550,18600,18550,18600,18575,5,-20,4,37.15,120
,20170320,18600,18575,,,,18575,18575,0,0,0,0.00,120
,20170321,18575,18575,18575,18575,18575,18575,18575,0,0,2,18.58,118
,20170322,18575,18575,18645,18645,18050,18190,18235,-385,-340,26,237.09,114
,20170323,18190,18235,18555,18785,18445,18785,18595,550,360,18,167.37,116
,20170324,18785,18595,,,,18595,18595,0,0,0,0.00,116
,20170327,18595,18595,18300,18300,18055,18055,18220,-540,-375,26,236.92,124
,20170328,18055,18220,17440,17655,17440,17520,17540,-700,-680,32,280.65,132
,20170329,17520,17540,17505,17795,17430,17645,17645,105,105,12,105.87,136
,20170330,17645,17645,17730,17775,17400,17400,17645,-245,0,12,105.88,136
,20170331,17400,17645,17540,17765,17540,17765,17650,120,5,4,35.31,138
,20170405,17765,17650,17735,17800,17645,17800,17735,150,85,14,124.16,140
,20170406,17800,17735,17775,17775,17775,17775,17775,40,40,4,35.55,140
,20170407,17775,17775,17685,17775,16630,16685,17295,-1090,-480,58,501.57,158
,20170410,16685,17295,16420,16835,16420,16680,16615,-615,-680,108,897.39,174
,20170411,16680,16615,16860,16860,16545,16560,16660,-55,45,132,"1,099.59",256
,20170412,16560,16660,16795,16795,16460,16615,16600,-45,-60,70,581.13,282
,20170413,16615,16600,16590,16885,16550,16885,16690,285,90,132,"1,101.72",314
,20170414,16885,16690,16800,16800,16495,16495,16645,-195,-45,6,49.94,314
,20170417,16495,16645,16885,16885,16700,16700,16725,55,80,26,217.43,336
,20170418,16700,16725,16735,16735,16240,16425,16430,-300,-295,134,"1,100.93",384
,20170419,16425,16430,16225,16230,15680,15865,15945,-565,-485,928,"7,399.96",706
,20170420,15865,15945,16005,16235,15945,16165,16095,220,150,178,"1,432.81",744
,20170421,16165,16095,16300,16300,16145,16145,16200,50,105,106,858.76,752
,20170424,16145,16200,16020,16020,15860,15955,15940,-245,-260,36,286.93,756
,20170425,15955,15940,16940,16940,15915,15960,16005,20,65,50,400.15,770
,20170426,15960,16005,16135,16255,16135,16200,16230,195,225,60,486.97,762
,20170427,16200,16230,16240,16310,16235,16295,16280,65,50,100,814.17,798
,20170428,16295,16280,16355,16450,16280,16420,16440,140,160,282,"2,318.21",1054
,20170502,16420,16440,16420,16955,16420,16560,16650,120,210,340,"2,830.65",1346
,20170503,16560,16650,16555,16620,16330,16330,16460,-320,-190,72,592.59,1372
,20170504,16330,16460,16260,16295,15980,16090,16155,-370,-305,426,"3,441.19",1562
,20170505,16090,16155,16060,16345,16060,16190,16270,35,115,340,"2,765.95",1660
,20170508,16190,16270,16205,16410,15930,16200,16150,-70,-120,286,"2,309.60",1736
,20170509,16200,16150,16130,16245,16075,16220,16160,70,10,36,290.93,1720
,20170510,16220,16160,16220,16425,16170,16350,16310,190,150,74,603.47,1716
,20170511,16350,16310,16405,16575,16290,16530,16400,220,90,206,"1,689.31",1790
,20170512,16530,16400,16445,16460,16160,16170,16215,-230,-185,514,"4,168.47",2220
,20170515,16170,16215,16240,16240,15985,16155,16095,-60,-120,156,"1,255.77",2234
,20170516,16155,16095,16195,16195,15765,15890,15895,-205,-200,470,"3,736.10",2216
,20170517,15890,15895,15875,15915,15820,15845,15865,-50,-30,100,793.29,2250
,20170518,15845,15865,15905,15930,15600,15620,15770,-245,-95,216,"1,703.55",2302
,20170519,15620,15770,15430,15710,15330,15580,15490,-190,-280,154,"1,193.10",2334
,20170522,15580,15490,15760,15985,15760,15920,15930,430,440,360,"2,868.05",2488
,20170523,15920,15930,15960,16140,15800,15955,16000,25,70,228,"1,824.02",2556
,20170524,15955,16000,15955,16000,15730,15985,15860,-15,-140,534,"4,234.91",2532
,20170525,15985,15860,16035,16035,15835,15905,15915,45,55,690,"5,490.72",2580
,20170526,15905,15915,15965,16040,15930,16010,16015,95,100,2186,"17,507.48",4582
,20170531,16010,16015,15960,16225,15835,15900,16150,-115,135,1502,"12,129.08",5644
,20170601,15900,16150,15935,16200,15885,16105,16095,-45,-55,498,"4,008.51",5820
,20170602,16105,16095,16180,16320,16085,16270,16185,175,90,528,"4,273.28",6018
,20170605,16270,16185,16215,16650,16205,16535,16435,350,250,2208,"18,144.75",6516
,20170606,16535,16435,16500,16730,16460,16635,16630,200,195,2336,"19,427.55",7156
,20170607,16635,16630,16670,16790,16415,16530,16570,-100,-60,2404,"19,919.47",7976
,20170608,16530,16570,16560,16790,16430,16715,16575,145,5,924,"7,658.13",8110
,20170609,16715,16575,16735,16950,16570,16895,16760,320,185,2098,"17,585.03",8358
,20170612,16895,16760,17100,17725,16855,17065,17020,305,260,2712,"23,084.23",9174
,20170613,17065,17020,17010,17045,16610,16720,16745,-300,-275,3654,"30,599.79",10782
,20170614,16720,16745,16790,16875,16550,16680,16650,-65,-95,5650,"47,040.86",12326
,20170615,16680,16650,16680,16880,16630,16680,16755,30,105,3536,"29,629.28",12628
,20170616,16680,16755,16720,17060,16720,17055,16965,300,210,2090,"17,728.91",12538
,20170619,17055,16965,16980,17345,16975,17275,17130,310,165,2756,"23,606.62",11504
,20170620,17275,17130,17340,17565,17255,17490,17420,360,290,2934,"25,556.32",12044
,20170621,17490,17420,17390,17445,17170,17235,17285,-185,-135,3164,"27,347.09",12848
,20170622,17235,17285,17430,17570,17345,17410,17435,125,150,4414,"38,486.42",13562
,20170623,17410,17435,17560,17560,17165,17270,17290,-165,-145,4462,"38,583.60",14122
,20170626,17270,17290,17310,17325,16975,17090,17115,-200,-175,6060,"51,859.38",15140
,20170627,17090,17115,17105,17395,17050,17365,17190,250,75,5068,"43,570.23",15026
,20170628,17365,17190,17445,17850,17380,17670,17630,480,440,9086,"80,113.88",15340
,20170629,17670,17630,17645,17760,17560,17660,17670,30,40,8028,"70,929.63",16928
,20170630,17660,17670,17660,17790,17465,17695,17630,25,-40,7690,"67,789.05",17506
,20170703,17695,17630,17660,18050,17625,17985,17865,355,235,10504,"93,852.30",18568
,20170704,17985,17865,17960,18090,17580,17680,17855,-185,-10,10216,"91,213.27",19886
,20170705,17680,17855,17570,18865,17370,17385,17615,-470,-240,14808,"130,423.92",20846
,20170706,17385,17615,17395,17520,17255,17485,17360,-130,-255,11180,"97,053.40",20942
,20170707,17485,17360,17485,17755,17435,17730,17585,370,225,12060,"106,053.83",21714
,20170710,17730,17585,17670,17800,17450,17475,17635,-110,50,12532,"110,501.11",22346
,20170711,17475,17635,17490,17935,17420,17895,17680,260,45,20016,"176,988.14",23698
,20170712,17895,17680,17860,18010,17760,17860,17885,180,205,18180,"162,601.25",24302
,20170713,17860,17885,17880,17945,17720,17850,17835,-35,-50,11088,"98,895.10",24696
,20170714,17850,17835,17845,17860,17430,17565,17570,-270,-265,21052,"184,974.31",25154
,20170717,17565,17570,17640,17845,17525,17815,17740,245,170,19798,"175,637.32",26854
,20170718,17815,17740,17785,17900,17490,17610,17705,-130,-35,26016,"230,319.58",27686
,20170719,17610,17705,17565,17610,17405,17515,17515,-190,-190,29986,"262,668.08",29894
,20170720,17515,17515,17430,17445,17150,17330,17300,-185,-215,39776,"344,146.69",28996
,20170721,17330,17300,17360,17450,17205,17430,17345,130,45,32570,"282,536.54",29164
,20170724,17430,17345,17500,17645,17365,17460,17510,115,165,39868,"349,100.64",33750
,20170725,17460,17510,17460,17650,17430,17645,17520,135,10,52444,"459,493.43",37202
,20170726,17645,17520,17660,18125,17660,17935,17840,415,320,97296,"868,081.26",38322
,20170727,17935,17840,17910,18230,17850,18215,18065,375,225,90310,"815,811.40",46834
,20170728,18215,18065,18185,18300,17965,18030,18135,-35,70,84370,"765,155.58",45274
,20170731,18030,18135,18135,18480,18100,18400,18295,265,160,75518,"690,852.81",49012
,20170801,18400,18295,18350,18425,18165,18185,18280,-110,-15,39984,"365,468.09",46258
,20170802,18185,18280,18185,18455,18135,18440,18295,160,15,51802,"473,975.74",47084
,20170803,18440,18295,18430,18780,18380,18425,18585,130,290,63154,"586,892.11",46952
,20170804,18425,18585,18475,18725,18450,18685,18605,100,20,38284,"356,188.28",46788
,20170807,18685,18605,18670,19105,18555,18935,18795,330,190,66948,"629,189.14",45436
,20170808,18935,18795,19010,19165,18970,19035,19070,240,275,49790,"474,831.44",41160
,20170809,19035,19070,19010,20200,18905,19700,19385,630,315,67198,"651,339.66",37578
,20170810,19700,19385,19585,19635,19305,19420,19455,35,70,58342,"567,658.75",35432
,20170811,19420,19455,19410,19430,18920,19010,19130,-445,-325,56930,"544,627.99",31662
,20170814,19010,19130,19090,19220,18905,19050,19085,-80,-45,39346,"375,478.53",30156
,20170815,19050,19085,19040,19325,19000,19215,19175,130,90,34336,"329,267.53",27802
,20170816,19215,19175,19300,19500,19210,19430,19355,255,180,23040,"223,002.83",22942
,20170817,19430,19355,19550,20515,19550,20365,20105,1010,750,26668,"268,126.23",19978
,20170818,20365,20105,20095,20175,19520,19810,19845,-295,-260,21400,"212,349.68",16526
,20170821,19810,19845,19775,20015,19375,19630,19640,-215,-205,14642,"143,803.55",14778
,20170822,19630,19640,19650,19685,19140,19470,19445,-170,-195,11332,"110,203.46",13986
,20170823,19470,19445,19565,20000,19380,19635,19720,190,275,9030,"89,052.10",12974
,20170824,19635,19720,19575,19800,19460,19510,19595,-210,-125,8904,"87,238.97",10996
,20170825,19510,19595,19330,19675,19240,19585,19450,-10,-145,4048,"39,374.86",10168
,20170828,19585,19450,19585,19680,18950,19175,19180,-275,-270,4810,"46,139.41",9456
,20170829,19175,19180,19235,19365,18955,19355,19195,175,15,3180,"30,520.97",8594
,20170830,19355,19195,19505,19680,19305,19645,19530,450,335,1638,"15,998.53",7856
,20170831,19645,19530,19585,19785,19460,19600,19605,70,75,2916,"28,590.67",5740
,20170901,19600,19605,19515,19750,19400,19750,19585,145,-20,1070,"10,478.00",5250
,20170904,19750,19585,19725,19990,19725,19835,19875,250,290,940,"9,341.85",4570
,20170905,19835,19875,19815,19970,19705,19900,19805,25,-70,1530,"15,154.03",3380
,20170906,19900,19805,19690,19725,19200,19320,19425,-485,-380,1900,"18,455.93",2370
,20170907,19320,19425,19465,19500,19260,19260,19370,-165,-55,1000,"9,685.13",1910
,20170908,19260,19370,19395,19500,19100,19100,19370,-270,0,850,"8,233.03",1450
,20170911,19100,19370,18850,19395,18800,19200,18970,-170,-400,580,"5,502.23",1010
,20170912,19200,18970,19200,19840,18960,19305,19365,335,395,150,"1,452.43",920
,20170913,19305,19365,,,,19365,19365,0,0,0,0.00,920
,20170914,19365,19365,20515,20515,20515,20515,20515,1150,1150,10,102.58,910
,20170915,20515,20515,19850,20490,19850,20350,20075,-165,-440,50,501.95,900
pb1710,20170103,17640,17645,17715,17715,17530,17530,17650,-115,5,6,52.96,118
,20170104,17530,17650,17555,17555,17465,17465,17500,-185,-150,6,52.51,116
,20170105,17465,17500,18105,18105,17810,17860,17895,360,395,38,340.04,110
,20170106,17860,17895,,,,17895,17895,0,0,0,0.00,110
,20170109,17895,17895,18040,18040,17980,17980,18010,85,115,4,36.02,108
,20170110,17980,18010,18020,18800,18020,18800,18190,790,180,42,382.07,76
,20170111,18800,18190,,,,18495,18495,305,305,0,0.00,76
,20170112,18495,18495,18885,18885,18545,18650,18690,155,195,6,56.08,76
,20170113,18650,18690,18755,18755,18755,18755,18755,65,65,2,18.76,76
,20170116,18755,18755,19260,19260,19025,19025,19120,270,365,8,76.48,78
,20170117,19025,19120,19045,19045,18455,18455,18780,-665,-340,8,75.13,74
,20170118,18455,18780,,,,18710,18710,-70,-70,0,0.00,74
,20170119,18710,18710,,,,18710,18710,0,0,0,0.00,74
,20170120,18710,18710,,,,18100,18100,-610,-610,0,0.00,74
,20170123,18100,18100,,,,18520,18520,420,420,0,0.00,74
,20170124,18520,18520,18630,18635,18625,18635,18625,115,105,12,111.78,62
,20170125,18635,18625,,,,18625,18625,0,0,0,0.00,62
,20170126,18625,18625,,,,18740,18740,115,115,0,0.00,62
,20170203,18740,18740,18905,18910,18875,18875,18895,135,155,6,56.69,64
,20170206,18875,18895,,,,18895,18895,0,0,0,0.00,64
,20170207,18895,18895,18750,18750,18750,18750,18750,-145,-145,2,18.75,66
,20170208,18750,18750,18865,19435,18705,19435,19090,685,340,70,668.22,62
,20170209,19435,19090,19465,19585,19455,19585,19515,495,425,20,195.19,54
,20170210,19585,19515,19505,19615,19375,19390,19475,-125,-40,10,97.39,56
,20170213,19390,19475,20025,20025,20025,20025,20025,550,550,6,60.08,50
,20170214,20025,20025,,,,20025,20025,0,0,0,0.00,50
,20170215,20025,20025,19560,19560,19560,19560,19560,-465,-465,2,19.56,52
,20170216,19560,19560,19420,19420,19420,19420,19420,-140,-140,6,58.26,56
,20170217,19420,19420,19065,19065,18905,18905,19005,-515,-415,6,57.02,58
,20170220,18905,19005,18870,18935,18870,18935,18910,-70,-95,6,56.74,60
,20170221,18935,18910,,,,19180,19180,270,270,0,0.00,60
,20170222,19180,19180,,,,19180,19180,0,0,0,0.00,60
,20170223,19180,19180,,,,19160,19160,-20,-20,0,0.00,60
,20170224,19160,19160,19010,19010,19010,19010,19010,-150,-150,2,19.01,62
,20170227,19010,19010,19015,19050,18895,18895,18980,-115,-30,10,94.92,68
,20170228,18895,18980,,,,18980,18980,0,0,0,0.00,68
,20170301,18980,18980,18820,18915,18820,18915,18865,-65,-115,4,37.74,72
,20170302,18915,18865,18935,19045,18935,19045,18990,180,125,4,37.98,74
,20170303,19045,18990,18935,18935,18840,18840,18885,-150,-105,4,37.78,74
,20170306,18840,18885,18575,18575,18575,18575,18575,-310,-310,2,18.58,74
,20170307,18575,18575,18305,18305,18305,18305,18305,-270,-270,2,18.31,72
,20170308,18305,18305,,,,18305,18305,0,0,0,0.00,72
,20170309,18305,18305,18280,18290,17935,17935,18140,-370,-165,12,108.85,74
,20170310,17935,18140,18020,18020,18020,18020,18020,-120,-120,2,18.02,76
,20170313,18020,18020,18335,18485,18280,18485,18365,465,345,6,55.10,76
,20170314,18485,18365,,,,18365,18365,0,0,0,0.00,76
,20170315,18365,18365,18155,18540,18155,18310,18395,-55,30,12,110.40,78
,20170316,18310,18395,18520,18645,18520,18555,18570,160,175,6,55.72,76
,20170317,18555,18570,18705,18705,18470,18585,18570,15,0,14,130.00,70
,20170320,18585,18570,18755,18755,18600,18600,18675,30,105,4,37.36,70
,20170321,18600,18675,,,,18675,18675,0,0,0,0.00,70
,20170322,18675,18675,18695,18695,18145,18145,18415,-530,-260,10,92.09,68
,20170323,18145,18415,18675,18675,18675,18675,18675,260,260,2,18.68,70
,20170324,18675,18675,18560,18560,18560,18560,18560,-115,-115,2,18.56,70
,20170327,18560,18560,18455,18455,18455,18455,18455,-105,-105,2,18.46,68
,20170328,18455,18455,17775,17775,17430,17505,17560,-950,-895,16,140.51,78
,20170329,17505,17560,17665,17735,17665,17735,17700,175,140,4,35.40,78
,20170330,17735,17700,17785,17805,17515,17515,17685,-185,-15,10,88.44,84
,20170331,17515,17685,17810,17815,17650,17650,17755,-35,70,6,53.28,88
,20170405,17650,17755,17810,17810,17810,17810,17810,55,55,2,17.81,90
,20170406,17810,17810,17955,17955,17710,17710,17830,-100,20,4,35.67,94
,20170407,17710,17830,17805,17805,17070,17070,17610,-760,-220,22,193.74,96
,20170410,17070,17610,16735,16910,16640,16765,16840,-845,-770,38,320.04,100
,20170411,16765,16840,,,,16840,16840,0,0,0,0.00,100
,20170412,16840,16840,16420,16700,16420,16600,16615,-240,-225,22,182.80,110
,20170413,16600,16615,16710,16710,16710,16710,16710,95,95,2,16.71,110
,20170414,16710,16710,,,,16710,16710,0,0,0,0.00,110
,20170417,16710,16710,,,,16780,16780,70,70,0,0.00,110
,20170418,16780,16780,16810,16810,16415,16465,16590,-315,-190,14,116.14,114
,20170419,16465,16590,16005,16035,15855,15985,15955,-605,-635,56,446.76,136
,20170420,15985,15955,16185,16190,16015,16160,16095,205,140,286,"2,302.28",342
,20170421,16160,16095,16200,16265,16120,16120,16205,25,110,50,405.14,356
,20170424,16120,16205,16040,16040,15890,15890,15955,-315,-250,14,111.69,352
,20170425,15890,15955,15970,16035,15935,16035,15985,80,30,32,255.82,360
,20170426,16035,15985,16270,16270,16265,16265,16265,280,280,4,32.54,360
,20170427,16265,16265,16320,16320,16290,16310,16305,45,40,22,179.36,368
,20170428,16310,16305,,,,16305,16305,0,0,0,0.00,368
,20170502,16305,16305,16765,16805,16740,16785,16770,480,465,10,83.86,370
,20170503,16785,16770,16600,16600,16585,16585,16590,-185,-180,4,33.19,370
,20170504,16585,16590,16265,16265,16230,16230,16245,-360,-345,8,64.99,376
,20170505,16230,16245,16155,16300,16155,16300,16250,55,5,6,48.76,378
,20170508,16300,16250,16285,16290,16285,16290,16285,40,35,6,48.87,380
,20170509,16290,16285,16190,16200,16190,16200,16195,-85,-90,4,32.39,378
,20170510,16200,16195,,,,16195,16195,0,0,0,0.00,378
,20170511,16195,16195,16385,16385,16355,16355,16370,160,175,10,81.87,378
,20170512,16355,16370,16205,16225,16205,16225,16215,-145,-155,4,32.43,380
,20170515,16225,16215,16150,16150,16105,16105,16125,-110,-90,4,32.26,382
,20170516,16105,16125,16110,16115,15780,15860,15865,-265,-260,500,"3,967.28",814
,20170517,15860,15865,15855,15890,15850,15890,15860,25,-5,12,95.18,816
,20170518,15890,15860,15890,15890,15680,15700,15720,-160,-140,28,220.09,820
,20170519,15700,15720,15505,15705,15505,15705,15580,-15,-140,14,109.06,818
,20170522,15705,15580,15695,16000,15695,15960,15915,380,335,22,175.08,816
,20170523,15960,15915,15820,16175,15820,16000,16055,85,140,86,690.53,856
,20170524,16000,16055,15780,15920,15780,15920,15850,-135,-205,4,31.70,852
,20170525,15920,15850,16030,16055,15855,15855,15970,5,120,136,"1,086.28",862
,20170526,15855,15970,15995,16030,15910,16030,16015,60,45,850,"6,808.16",1690
,20170531,16030,16015,16090,16200,15855,15855,16170,-160,155,530,"4,285.32",2132
,20170601,15855,16170,15925,16180,15925,16110,16140,-60,-30,104,839.41,2204
,20170602,16110,16140,16105,16310,16090,16310,16250,170,110,72,585.11,2266
,20170605,16310,16250,16185,16620,16185,16540,16445,290,195,272,"2,236.57",2348
,20170606,16540,16445,16490,16725,16485,16635,16640,190,195,552,"4,593.02",2622
,20170607,16635,16640,16650,16755,16400,16520,16625,-120,-15,76,631.87,2624
,20170608,16520,16625,16580,16635,16470,16635,16545,10,-80,430,"3,557.47",3008
,20170609,16635,16545,16760,16905,16610,16905,16740,360,195,190,"1,590.45",3098
,20170612,16905,16740,17035,17070,16865,17035,17020,295,280,230,"1,957.72",3160
,20170613,17035,17020,17025,17025,16600,16725,16765,-295,-255,842,"7,059.27",3444
,20170614,16725,16765,16770,16780,16495,16565,16575,-200,-190,1534,"12,714.24",3730
,20170615,16565,16575,16595,16715,16515,16605,16655,30,80,892,"7,430.12",3884
,20170616,16605,16655,16645,16930,16645,16925,16865,270,210,454,"3,828.49",3992
,20170619,16925,16865,16905,17290,16905,17250,17080,385,215,954,"8,148.85",3516
,20170620,17250,17080,17305,17515,17200,17390,17385,310,305,378,"3,286.37",3494
,20170621,17390,17385,17350,17350,17090,17100,17205,-285,-180,768,"6,607.30",3790
,20170622,17100,17205,17150,17420,17150,17215,17280,10,75,812,"7,017.44",4134
,20170623,17215,17280,17455,17455,17050,17140,17210,-140,-70,524,"4,509.30",4232
,20170626,17140,17210,17135,17145,16820,16980,17005,-230,-205,518,"4,404.80",4354
,20170627,16980,17005,17005,17325,16940,17290,17115,285,110,1246,"10,663.23",4788
,20170628,17290,17115,17340,17760,17335,17585,17520,470,405,2182,"19,115.00",5552
,20170629,17585,17520,17600,17620,17320,17540,17545,20,25,1284,"11,266.75",6226
,20170630,17540,17545,17540,17640,17340,17530,17490,-15,-55,1472,"12,874.22",6894
,20170703,17530,17490,17530,17900,17525,17840,17755,350,265,592,"5,256.43",6928
,20170704,17840,17755,17765,17945,17500,17575,17790,-180,35,348,"3,095.97",7006
,20170705,17575,17790,17525,17670,17285,17320,17495,-470,-295,774,"6,772.37",7038
,20170706,17320,17495,17275,17380,17170,17365,17275,-130,-220,820,"7,083.85",7100
,20170707,17365,17275,17395,17645,17320,17600,17495,325,220,376,"3,289.94",7160
,20170710,17600,17495,17545,17665,17380,17380,17525,-115,30,982,"8,605.77",7574
,20170711,17380,17525,17390,17820,17330,17775,17565,250,40,1170,"10,275.62",7928
,20170712,17775,17565,17785,17910,17700,17725,17770,160,205,1638,"14,554.37",7936
,20170713,17725,17770,17810,17850,17660,17790,17745,20,-25,1192,"10,578.94",8226
,20170714,17790,17745,17795,17815,17410,17570,17495,-175,-250,1732,"15,152.43",8542
,20170717,17570,17495,17570,17815,17550,17775,17705,280,210,688,"6,091.45",8544
,20170718,17775,17705,17765,17870,17495,17615,17710,-90,5,1870,"16,559.69",8794
,20170719,17615,17710,17525,17630,17425,17510,17505,-200,-205,1542,"13,499.42",9150
,20170720,17510,17505,17480,17480,17195,17325,17310,-180,-195,1168,"10,109.49",9078
,20170721,17325,17310,17310,17450,17200,17445,17345,135,35,2480,"21,510.21",9234
,20170724,17445,17345,17515,17645,17370,17470,17520,125,175,2826,"24,762.67",10198
,20170725,17470,17520,17440,17670,17435,17655,17530,135,10,4192,"36,750.18",11694
,20170726,17655,17530,17765,18145,17685,17970,17865,440,335,9582,"85,599.99",13926
,20170727,17970,17865,18060,18235,17865,18150,18065,285,200,9578,"86,534.40",16402
,20170728,18150,18065,18140,18250,17930,18020,18095,-45,30,10404,"94,141.75",17436
,20170731,18020,18095,18095,18440,18055,18385,18270,290,175,11166,"102,009.04",19036
,20170801,18385,18270,18325,18390,18140,18190,18250,-80,-20,9182,"83,805.17",19532
,20170802,18190,18250,18180,18425,18105,18400,18285,150,35,13800,"126,185.22",20386
,20170803,18400,18285,18475,18750,18360,18435,18570,150,285,18498,"171,762.79",20722
,20170804,18435,18570,18435,18725,18425,18670,18600,100,30,13274,"123,471.56",21748
,20170807,18670,18600,18675,19120,18550,18960,18820,360,220,30094,"283,216.38",25762
,20170808,18960,18820,19050,19200,19010,19050,19110,230,290,27002,"258,035.62",28308
,20170809,19050,19110,18995,19815,18900,19690,19400,580,290,42436,"411,646.74",29742
,20170810,19690,19400,19585,19635,19280,19405,19440,5,40,40102,"389,819.57",29524
,20170811,19405,19440,19495,19495,18905,18985,19135,-455,-305,36666,"350,862.17",28236
,20170814,18985,19135,19045,19210,18880,19030,19075,-105,-60,29830,"284,538.85",28764
,20170815,19030,19075,19005,19320,18985,19220,19185,145,110,37496,"359,773.01",32630
,20170816,19220,19185,19280,19510,19235,19440,19375,255,190,56094,"543,453.64",37402
,20170817,19440,19375,19580,20535,19580,20365,20180,990,805,130414,"1,315,923.02",44950
,20170818,20365,20180,19995,20170,19535,19840,19840,-340,-340,131260,"1,302,241.38",45584
,20170821,19840,19840,19785,20040,19380,19620,19625,-220,-215,145256,"1,425,326.61",48796
,20170822,19620,19625,19600,19685,19015,19355,19370,-270,-255,118946,"1,152,036.35",48804
,20170823,19355,19370,19420,19940,19270,19570,19670,200,300,191074,"1,879,605.56",48942
,20170824,19570,19670,19500,19750,19300,19415,19540,-255,-130,114416,"1,118,029.90",49878
,20170825,19415,19540,19205,19525,19180,19490,19360,-50,-180,97480,"943,610.34",51816
,20170828,19490,19360,19480,19600,18745,19025,19080,-335,-280,114462,"1,092,217.02",47518
,20170829,19025,19080,19100,19175,18805,19150,18990,70,-90,83242,"790,420.93",49290
,20170830,19150,18990,19375,19500,19110,19465,19335,475,345,114048,"1,102,685.51",48170
,20170831,19465,19335,19400,19570,19260,19300,19390,-35,55,119548,"1,159,091.37",48288
,20170901,19300,19390,19380,19550,19185,19535,19385,145,-5,78458,"760,623.39",46962
,20170904,19535,19385,19425,19820,19410,19530,19625,145,240,83556,"819,898.21",47056
,20170905,19530,19625,19550,19600,19400,19515,19495,-110,-130,54606,"532,333.64",46138
,20170906,19515,19495,19385,19400,18790,19015,19100,-480,-395,103286,"986,573.38",44712
,20170907,19015,19100,19020,19220,18900,18905,19080,-195,-20,59768,"570,264.95",42994
,20170908,18905,19080,18975,19220,18635,18900,19005,-180,-75,84158,"799,768.26",41032
,20170911,18900,19005,18860,18860,18480,18785,18670,-220,-335,86038,"803,191.75",39990
,20170912,18785,18670,18785,19145,18715,19090,18875,420,205,73312,"691,995.08",40968
,20170913,19090,18875,18995,19695,18920,19515,19445,640,570,101050,"982,474.18",41160
,20170914,19515,19445,19580,20035,19410,19905,19765,460,320,114582,"1,132,552.53",40778
,20170915,19905,19765,19985,20085,19640,19820,19885,55,120,107168,"1,065,733.27",36984
,20170918,19820,19885,19975,20700,19650,20350,20145,465,260,112378,"1,132,127.71",37024
,20170919,20350,20145,20330,20660,20330,20470,20505,325,360,48430,"496,585.20",35780
,20170920,20470,20505,20645,21240,20330,21145,20790,640,285,44586,"463,517.21",33592
,20170921,21145,20790,21150,21425,21135,21190,21270,400,480,35994,"382,883.70",31172
,20170922,21190,21270,21375,21790,20650,20945,21175,-325,-95,45174,"478,384.65",28000
,20170925,20945,21175,21175,21675,20925,21350,21350,175,175,24948,"266,342.03",25434
,20170926,21350,21350,21430,21600,21250,21575,21420,225,70,11242,"120,407.19",23022
,20170927,21575,21420,21490,21585,21250,21485,21415,65,-5,9596,"102,765.96",19466
,20170928,21485,21415,21425,21495,21290,21455,21365,40,-50,7726,"82,550.43",16416
,20170929,21455,21365,21570,22055,21380,21850,21670,485,305,6588,"71,382.49",13410
,20171009,21850,21670,22000,22120,21695,21865,21920,195,250,2100,"23,016.85",11670
,20171010,21865,21920,21755,21840,21500,21505,21660,-415,-260,3740,"40,512.10",8460
,20171011,21505,21660,21620,21795,21300,21400,21570,-260,-90,3010,"32,464.10",5930
,20171012,21400,21570,21300,21510,21000,21150,21140,-420,-430,1600,"16,914.28",5010
,20171013,21150,21140,21150,21180,20600,20800,20900,-340,-240,1070,"11,181.53",4730
,20171016,20800,20900,20800,20900,20700,20750,20795,-150,-105,350,"3,639.13",4690
pb1711,20170103,17525,17560,17420,17420,17420,17420,17420,-140,-140,2,17.42,86
,20170104,17420,17420,17510,17655,17420,17655,17510,235,90,18,157.63,86
,20170105,17655,17510,,,,17905,17905,395,395,0,0.00,86
,20170106,17905,17905,17800,17870,17800,17870,17835,-35,-70,4,35.67,84
,20170109,17870,17835,18090,18105,18085,18100,18090,265,255,20,180.93,100
,20170110,18100,18090,18095,18800,18080,18800,18495,710,405,36,332.99,90
,20170111,18800,18495,19035,19050,18780,18815,18865,320,370,26,245.26,88
,20170112,18815,18865,18650,18680,18490,18490,18610,-375,-255,10,93.07,82
,20170113,18490,18610,18720,18720,18720,18720,18720,110,110,2,18.72,84
,20170116,18720,18720,18735,19160,18735,19025,18910,305,190,20,189.12,98
,20170117,19025,18910,18980,18980,18415,18415,18695,-495,-215,4,37.40,102
,20170118,18415,18695,18440,18500,18440,18500,18460,-195,-235,6,55.38,102
,20170119,18500,18460,,,,18460,18460,0,0,0,0.00,102
,20170120,18460,18460,,,,18365,18365,-95,-95,0,0.00,102
,20170123,18365,18365,18825,19065,18825,19065,18945,700,580,4,37.89,102
,20170124,19065,18945,,,,18945,18945,0,0,0,0.00,102
,20170125,18945,18945,18955,18955,18955,18955,18955,10,10,2,18.96,102
,20170126,18955,18955,18950,18950,18950,18950,18950,-5,-5,6,56.85,102
,20170203,18950,18950,,,,19105,19105,155,155,0,0.00,102
,20170206,19105,19105,,,,19010,19010,-95,-95,0,0.00,102
,20170207,19010,19010,18925,18925,18925,18925,18925,-85,-85,2,18.93,100
,20170208,18925,18925,19450,19450,19345,19345,19395,420,470,4,38.80,102
,20170209,19345,19395,19640,19640,19560,19560,19600,165,205,6,58.81,100
,20170210,19560,19600,,,,19600,19600,0,0,0,0.00,100
,20170213,19600,19600,19660,20150,19660,19970,19950,370,350,12,119.70,100
,20170214,19970,19950,,,,19950,19950,0,0,0,0.00,100
,20170215,19950,19950,19615,19615,19450,19580,19520,-370,-430,8,78.10,94
,20170216,19580,19520,19430,19430,19430,19430,19430,-90,-90,2,19.43,96
,20170217,19430,19430,19035,19105,18890,18890,19045,-540,-385,18,171.44,100
,20170220,18890,19045,18870,18895,18870,18880,18885,-165,-160,12,113.33,94
,20170221,18880,18885,,,,19180,19180,295,295,0,0.00,94
,20170222,19180,19180,,,,19180,19180,0,0,0,0.00,94
,20170223,19180,19180,19210,19215,19210,19215,19210,35,30,4,38.43,94
,20170224,19215,19210,18890,18890,18750,18800,18815,-410,-395,8,75.28,96
,20170227,18800,18815,18815,19030,18815,19030,18945,215,130,16,151.58,98
,20170228,19030,18945,,,,18945,18945,0,0,0,0.00,98
,20170301,18945,18945,18745,18830,18745,18830,18785,-115,-160,4,37.58,98
,20170302,18830,18785,18970,19200,18970,19120,19120,335,335,18,172.12,106
,20170303,19120,19120,18955,18955,18835,18860,18900,-260,-220,8,75.61,104
,20170306,18860,18900,,,,18900,18900,0,0,0,0.00,104
,20170307,18900,18900,,,,18900,18900,0,0,0,0.00,104
,20170308,18900,18900,,,,18895,18895,-5,-5,0,0.00,104
,20170309,18895,18895,18305,18305,18305,18305,18305,-590,-590,2,18.31,104
,20170310,18305,18305,,,,18305,18305,0,0,0,0.00,104
,20170313,18305,18305,18400,18400,18400,18400,18400,95,95,2,18.40,106
,20170314,18400,18400,18515,18515,18295,18295,18350,-105,-50,8,73.40,100
,20170315,18295,18350,18410,18410,18410,18410,18410,60,60,2,18.41,102
,20170316,18410,18410,,,,18650,18650,240,240,0,0.00,102
,20170317,18650,18650,18640,18640,18640,18640,18640,-10,-10,4,37.28,104
,20170320,18640,18640,18640,18640,18640,18640,18640,0,0,4,37.28,100
,20170321,18640,18640,,,,18640,18640,0,0,0,0.00,100
,20170322,18640,18640,18665,18665,18385,18385,18525,-255,-115,4,37.05,102
,20170323,18385,18525,18840,18840,18840,18840,18840,315,315,4,37.68,98
,20170324,18840,18840,18460,18460,18455,18455,18455,-385,-385,8,73.83,98
,20170327,18455,18455,18255,18255,18255,18255,18255,-200,-200,2,18.26,98
,20170328,18255,18255,17750,17750,17500,17690,17635,-565,-620,10,88.19,90
,20170329,17690,17635,17560,17560,17495,17495,17525,-140,-110,4,35.06,92
,20170330,17495,17525,17640,17775,17580,17580,17665,55,140,6,53.00,94
,20170331,17580,17665,17815,17815,17670,17670,17740,5,75,4,35.49,94
,20170405,17670,17740,17700,17865,17700,17865,17800,125,60,6,53.41,92
,20170406,17865,17800,17985,17985,17745,17745,17865,-55,65,4,35.73,90
,20170407,17745,17865,17800,17800,17565,17565,17735,-300,-130,8,70.96,88
,20170410,17565,17735,16720,16990,16720,16750,16840,-985,-895,46,387.37,106
,20170411,16750,16840,16735,16760,16735,16760,16745,-80,-95,4,33.50,104
,20170412,16760,16745,16850,16850,16620,16695,16770,-50,25,10,83.87,100
,20170413,16695,16770,16700,16780,16700,16780,16730,10,-40,10,83.66,100
,20170414,16780,16730,16910,16910,16780,16780,16845,50,115,4,33.69,100
,20170417,16780,16845,,,,16925,16925,80,80,0,0.00,100
,20170418,16925,16925,16915,16915,16720,16720,16850,-205,-75,8,67.41,98
,20170419,16720,16850,16045,16125,15840,16090,15930,-760,-920,68,541.68,118
,20170420,16090,15930,16250,16260,16025,16255,16170,325,240,20,161.71,120
,20170421,16255,16170,16255,16270,16235,16235,16250,65,80,6,48.76,114
,20170424,16235,16250,16075,16075,15900,16015,15985,-235,-265,16,127.90,106
,20170425,16015,15985,16045,16070,15990,16070,16035,85,50,58,465.07,128
,20170426,16070,16035,16285,16285,16285,16285,16285,250,250,2,16.29,128
,20170427,16285,16285,16315,16365,16315,16365,16335,80,50,10,81.69,128
,20170428,16365,16335,16495,16495,16495,16495,16495,160,160,2,16.50,128
,20170502,16495,16495,16775,16815,16770,16815,16785,320,290,6,50.36,126
,20170503,16815,16785,,,,16705,16705,-80,-80,0,0.00,126
,20170504,16705,16705,16295,16295,16295,16295,16295,-410,-410,4,32.59,130
,20170505,16295,16295,,,,16300,16300,5,5,0,0.00,130
,20170508,16300,16300,16310,16335,16150,16150,16275,-150,-25,8,65.10,128
,20170509,16150,16275,,,,16275,16275,0,0,0,0.00,128
,20170510,16275,16275,,,,16275,16275,0,0,0,0.00,128
,20170511,16275,16275,16280,16450,16280,16450,16320,175,45,8,65.29,124
,20170512,16450,16320,16260,16260,16260,16260,16260,-60,-60,4,32.52,122
,20170515,16260,16260,16130,16135,16130,16135,16130,-125,-130,4,32.27,124
,20170516,16135,16130,16120,16225,15875,15875,16065,-255,-65,18,144.61,130
,20170517,15875,16065,,,,16065,16065,0,0,0,0.00,130
,20170518,16065,16065,15975,15975,15975,15975,15975,-90,-90,2,15.98,132
,20170519,15975,15975,15535,15660,15535,15630,15615,-345,-360,8,62.46,134
,20170522,15630,15615,,,,15615,15615,0,0,0,0.00,134
,20170523,15615,15615,16110,16125,15970,16025,16040,410,425,56,449.18,120
,20170524,16025,16040,15880,15935,15880,15935,15915,-105,-125,8,63.67,124
,20170525,15935,15915,15985,16020,15890,16020,15980,105,65,24,191.81,130
,20170526,16020,15980,16040,16085,15990,16085,16030,105,50,8,64.12,130
,20170531,16085,16030,16215,16215,15900,15900,16105,-130,75,8,64.43,130
,20170601,15900,16105,15955,16200,15955,16200,16075,95,-30,4,32.16,128
,20170602,16200,16075,16130,16240,16130,16240,16210,165,135,28,227.00,144
,20170605,16240,16210,16590,16625,16390,16625,16535,415,325,6,49.61,148
,20170606,16625,16535,16585,16685,16585,16685,16650,150,115,6,49.96,152
,20170607,16685,16650,16685,16685,16515,16515,16605,-135,-45,8,66.43,150
,20170608,16515,16605,16775,16775,16775,16775,16775,170,170,2,16.78,150
,20170609,16775,16775,,,,16850,16850,75,75,0,0.00,150
,20170612,16850,16850,17075,17075,16930,16930,16975,80,125,10,84.88,148
,20170613,16930,16975,16850,16850,16610,16745,16740,-230,-235,40,334.83,172
,20170614,16745,16740,16765,16770,16510,16545,16575,-195,-165,966,"8,007.80",744
,20170615,16545,16575,16550,16710,16510,16600,16590,25,15,112,929.07,742
,20170616,16600,16590,16675,16845,16675,16845,16780,255,190,42,352.40,730
,20170619,16845,16780,16895,17215,16850,17200,17005,420,225,100,850.30,682
,20170620,17200,17005,17170,17400,17160,17300,17275,295,270,62,535.53,674
,20170621,17300,17275,17250,17250,17065,17065,17140,-210,-135,68,582.83,680
,20170622,17065,17140,17285,17285,17140,17175,17180,35,40,24,206.18,692
,20170623,17175,17180,17320,17320,16985,17135,17110,-45,-70,52,444.99,684
,20170626,17135,17110,17070,17075,16825,16910,16920,-200,-190,340,"2,877.07",538
,20170627,16910,16920,16945,17275,16920,17225,17050,305,130,232,"1,977.88",430
,20170628,17225,17050,17240,17600,17240,17525,17440,475,390,102,889.64,392
,20170629,17525,17440,17485,17505,17345,17470,17480,30,40,196,"1,713.50",488
,20170630,17470,17480,17435,17535,17320,17420,17480,-60,0,102,891.68,532
,20170703,17420,17480,17650,17780,17500,17740,17655,260,175,70,618.04,534
,20170704,17740,17655,17705,17845,17400,17400,17770,-255,115,90,799.73,562
,20170705,17400,17770,17425,17550,17245,17250,17395,-520,-375,164,"1,426.79",526
,20170706,17250,17395,17215,17260,17120,17170,17155,-225,-240,24,205.87,532
,20170707,17170,17155,17255,17530,17255,17530,17395,375,240,60,521.88,562
,20170710,17530,17395,17455,17515,17300,17300,17430,-95,35,22,191.78,562
,20170711,17300,17430,17375,17700,17375,17700,17565,270,135,10,87.85,560
,20170712,17700,17565,17720,17720,17720,17720,17720,155,155,20,177.20,578
,20170713,17720,17720,17735,17735,17680,17680,17705,-40,-15,12,106.24,574
,20170714,17680,17705,17720,17720,17355,17505,17480,-200,-225,64,559.45,568
,20170717,17505,17480,17660,17750,17660,17750,17695,270,215,26,230.06,562
,20170718,17750,17695,17745,17825,17560,17580,17695,-115,0,60,530.89,564
,20170719,17580,17695,17500,17505,17450,17505,17460,-190,-235,130,"1,135.22",554
,20170720,17505,17460,17375,17400,17230,17395,17300,-65,-160,92,795.82,508
,20170721,17395,17300,17335,17495,17300,17495,17380,195,80,602,"5,232.52",954
,20170724,17495,17380,17525,17650,17420,17420,17535,40,155,162,"1,420.38",1012
,20170725,17420,17535,17450,17615,17410,17615,17510,80,-25,906,"7,932.90",1556
,20170726,17615,17510,17690,18075,17680,17890,17805,380,295,1408,"12,536.11",2444
,20170727,17890,17805,17830,18130,17825,18045,17975,240,170,2296,"20,640.97",4110
,20170728,18045,17975,18030,18135,17840,17880,17995,-95,20,528,"4,751.53",4132
,20170731,17880,17995,17990,18325,17970,18320,18185,325,190,706,"6,419.49",4256
,20170801,18320,18185,18265,18285,18055,18100,18150,-85,-35,836,"7,586.95",4352
,20170802,18100,18150,18110,18355,18055,18355,18160,205,10,1030,"9,354.36",4656
,20170803,18355,18160,18340,18680,18340,18365,18475,205,315,1232,"11,380.71",4794
,20170804,18365,18475,18370,18650,18365,18640,18510,165,35,1018,"9,422.13",4984
,20170807,18640,18510,18585,19055,18500,18950,18790,440,280,908,"8,532.60",5228
,20170808,18950,18790,19030,19135,18965,18990,19055,200,265,1722,"16,407.61",5968
,20170809,18990,19055,18935,19760,18880,19610,19360,555,305,3104,"30,050.09",6664
,20170810,19610,19360,19445,19555,19220,19350,19375,-10,15,2160,"20,927.58",6718
,20170811,19350,19375,19365,19365,18850,18890,19070,-485,-305,1642,"15,660.23",6972
,20170814,18890,19070,19030,19155,18875,19010,19065,-60,-5,1930,"18,402.17",6624
,20170815,19010,19065,18985,19280,18955,19190,19155,125,90,3662,"35,075.20",7926
,20170816,19190,19155,19200,19460,19195,19415,19325,260,170,3856,"37,258.80",9228
,20170817,19415,19325,19575,20465,19535,20340,20110,1015,785,6250,"62,858.07",9804
,20170818,20340,20110,19920,20120,19495,19825,19775,-285,-335,5256,"51,975.09",10188
,20170821,19825,19775,19750,20025,19370,19575,19600,-200,-175,10256,"100,519.42",10762
,20170822,19575,19600,19565,19620,18940,19235,19260,-365,-340,10198,"98,226.83",12792
,20170823,19235,19260,19350,19810,19165,19530,19530,270,270,16208,"158,275.34",12998
,20170824,19530,19530,19425,19660,19285,19360,19455,-170,-75,16496,"160,468.36",14854
,20170825,19360,19455,19190,19425,19100,19385,19275,-70,-180,11726,"113,030.13",16500
,20170828,19385,19275,19380,19480,18645,18940,19010,-335,-265,17188,"163,402.07",17074
,20170829,18940,19010,18995,19060,18720,18980,18865,-30,-145,14026,"132,334.48",19786
,20170830,18980,18865,19235,19370,18970,19330,19220,465,355,17138,"164,706.62",19872
,20170831,19330,19220,19260,19450,19135,19175,19255,-45,35,13942,"134,254.87",21430
,20170901,19175,19255,19255,19430,19080,19395,19275,140,20,21014,"202,542.45",23106
,20170904,19395,19275,19300,19690,19300,19410,19510,135,235,24954,"243,433.67",26164
,20170905,19410,19510,19400,19465,19240,19360,19350,-150,-160,20404,"197,443.44",27158
,20170906,19360,19350,19200,19225,18645,18775,18935,-575,-415,33954,"321,472.89",29374
,20170907,18775,18935,18840,19010,18510,18640,18840,-295,-95,21478,"202,363.98",29670
,20170908,18640,18840,18600,18905,18305,18535,18680,-305,-160,29668,"277,101.07",29344
,20170911,18535,18680,18460,18500,18130,18425,18310,-255,-370,32174,"294,576.55",30240
,20170912,18425,18310,18450,18730,18370,18660,18535,350,225,33162,"307,372.40",32242
,20170913,18660,18535,18565,19145,18485,18880,18890,345,355,51674,"488,112.29",34540
,20170914,18880,18890,18925,19285,18765,19210,19070,320,180,62790,"598,835.70",38354
,20170915,19210,19070,19300,19660,19090,19110,19380,40,310,97598,"945,755.01",42158
,20170918,19110,19380,19255,19945,18955,19830,19515,450,135,116864,"1,140,576.29",48170
,20170919,19830,19515,19820,20175,19815,19895,19995,380,480,123222,"1,232,038.13",57534
,20170920,19895,19995,20010,20770,19720,20645,20335,650,340,209848,"2,133,859.65",73812
,20170921,20645,20335,20650,20915,20515,20650,20715,315,380,240456,"2,490,552.28",80994
,20170922,20650,20715,20845,21070,19845,20225,20470,-490,-245,367750,"3,764,428.52",79242
,20170925,20225,20470,20500,20970,20180,20600,20575,130,105,365516,"3,761,136.35",88710
,20170926,20600,20575,20680,20880,20470,20820,20660,245,85,157588,"1,628,240.98",108840
,20170927,20820,20660,20660,20790,20405,20705,20615,45,-45,138138,"1,424,080.02",100222
,20170928,20705,20615,20590,20660,20390,20650,20535,35,-80,109590,"1,125,261.08",90194
,20170929,20650,20535,20790,21350,20500,21220,20850,685,315,131634,"1,372,555.34",93530
,20171009,21220,20850,21220,21430,20920,21150,21160,300,310,51224,"541,958.33",84770
,20171010,21150,21160,21110,21160,20640,20650,20890,-510,-270,76200,"796,001.65",83162
,20171011,20650,20890,20720,21000,20560,20665,20760,-225,-130,69344,"719,885.56",79002
,20171012,20665,20760,20720,20850,20450,20730,20630,-30,-130,63348,"653,541.19",77930
,20171013,20730,20630,20740,20890,20480,20645,20695,15,65,61408,"635,547.61",73756
,20171016,20645,20695,20685,20840,20360,20600,20560,-95,-135,68590,"705,249.61",70866
,20171017,20600,20560,20550,20805,20180,20265,20480,-295,-80,46260,"473,725.64",61564
,20171018,20265,20480,20275,20300,19670,19745,19980,-735,-500,42922,"428,885.86",54688
,20171019,19745,19980,19755,19975,19325,19350,19700,-630,-280,36238,"357,034.24",44554
,20171020,19350,19700,19360,19790,19070,19580,19405,-120,-295,30046,"291,541.81",38674
,20171023,19580,19405,19450,19695,19305,19515,19495,110,90,13758,"134,122.32",33586
,20171024,19515,19495,19530,19790,19425,19595,19645,100,150,10936,"107,443.62",28748
,20171025,19595,19645,19580,19605,19205,19245,19380,-400,-265,11856,"114,902.99",23938
,20171026,19245,19380,19280,19505,19205,19280,19325,-100,-55,7328,"70,822.43",20506
,20171027,19280,19325,19245,19250,18650,18745,18940,-580,-385,8026,"76,007.06",15826
,20171030,18745,18940,18855,18855,18250,18305,18485,-635,-455,7480,"69,136.86",11476
,20171031,18305,18485,18290,18660,18185,18625,18390,140,-95,3560,"32,740.98",9190
,20171101,18625,18390,18650,19025,18500,18660,18775,270,385,2220,"20,845.78",7760
,20171102,18660,18775,18675,18845,18525,18630,18620,-145,-155,1250,"11,639.45",7500
,20171103,18630,18620,18590,18700,18390,18435,18540,-185,-80,2130,"19,745.28",6690
,20171106,18435,18540,18575,18710,18010,18670,18535,130,-5,1980,"18,353.98",7410
,20171107,18670,18535,18750,18915,18700,18720,18770,185,235,1600,"15,019.00",7550
,20171108,18720,18770,18845,18900,18600,18600,18750,-170,-20,540,"5,063.65",7500
,20171109,18600,18750,18755,18840,18620,18805,18745,55,-5,620,"5,811.20",7420
,20171110,18805,18745,18765,19205,18765,19205,19135,460,390,530,"5,071.28",7520
,20171113,19205,19135,19380,19380,19180,19205,19240,70,105,910,"8,755.55",7620
,20171114,19205,19240,19175,19180,19020,19060,19115,-180,-125,570,"5,448.70",7660
,20171115,19060,19115,18045,18620,18045,18570,18425,-545,-690,610,"5,619.88",7520
pb1712,20170103,17525,17650,18165,18165,18165,18165,18165,515,515,2,18.17,30
,20170104,18165,18165,,,,17895,17895,-270,-270,0,0.00,30
,20170105,17895,17895,17905,17910,17905,17910,17905,15,10,4,35.82,28
,20170106,17910,17905,,,,17905,17905,0,0,0,0.00,28
,20170109,17905,17905,18095,18095,18095,18095,18095,190,190,2,18.10,30
,20170110,18095,18095,18145,18715,18145,18715,18520,620,425,6,55.57,32
,20170111,18715,18520,18795,18795,18795,18795,18795,275,275,2,18.80,34
,20170112,18795,18795,18695,18695,18695,18695,18695,-100,-100,2,18.70,34
,20170113,18695,18695,18780,18780,18780,18780,18780,85,85,12,112.68,40
,20170116,18780,18780,18785,19065,18785,19065,18940,285,160,20,189.42,46
,20170117,19065,18940,19125,19125,18470,18480,18610,-460,-330,10,93.07,44
,20170118,18480,18610,,,,18610,18610,0,0,0,0.00,44
,20170119,18610,18610,18585,18585,18585,18585,18585,-25,-25,2,18.59,42
,20170120,18585,18585,,,,17640,17640,-945,-945,0,0.00,42
,20170123,17640,17640,,,,18195,18195,555,555,0,0.00,42
,20170124,18195,18195,,,,18195,18195,0,0,0,0.00,42
,20170125,18195,18195,,,,18195,18195,0,0,0,0.00,42
,20170126,18195,18195,,,,18195,18195,0,0,0,0.00,42
,20170203,18195,18195,,,,18235,18235,40,40,0,0.00,42
,20170206,18235,18235,,,,18620,18620,385,385,0,0.00,42
,20170207,18620,18620,,,,18620,18620,0,0,0,0.00,42
,20170208,18620,18620,19400,19400,19400,19400,19400,780,780,2,19.40,42
,20170209,19400,19400,,,,19400,19400,0,0,0,0.00,42
,20170210,19400,19400,,,,19360,19360,-40,-40,0,0.00,42
,20170213,19360,19360,19780,20070,19780,20015,19975,655,615,8,79.90,48
,20170214,20015,19975,,,,19975,19975,0,0,0,0.00,48
,20170215,19975,19975,19685,19685,19565,19565,19625,-410,-350,4,39.25,46
,20170216,19565,19625,,,,19625,19625,0,0,0,0.00,46
,20170217,19625,19625,19050,19050,18905,18905,18975,-720,-650,8,75.91,50
,20170220,18905,18975,,,,18975,18975,0,0,0,0.00,50
,20170221,18975,18975,,,,18975,18975,0,0,0,0.00,50
,20170222,18975,18975,,,,18975,18975,0,0,0,0.00,50
,20170223,18975,18975,,,,18975,18975,0,0,0,0.00,50
,20170224,18975,18975,18750,18760,18750,18760,18755,-215,-220,8,75.02,56
,20170227,18760,18755,18820,19035,18740,18740,18960,-15,205,20,189.62,54
,20170228,18740,18960,18835,18870,18770,18835,18835,-125,-125,22,207.21,48
,20170301,18835,18835,18755,18900,18750,18900,18810,65,-25,8,75.26,46
,20170302,18900,18810,18940,19130,18940,18950,18990,140,180,8,75.96,46
,20170303,18950,18990,18890,18890,18890,18890,18890,-100,-100,2,18.89,46
,20170306,18890,18890,18535,18595,18535,18595,18565,-295,-325,4,37.13,46
,20170307,18595,18565,18350,18350,18350,18350,18350,-215,-215,2,18.35,48
,20170308,18350,18350,,,,18350,18350,0,0,0,0.00,48
,20170309,18350,18350,,,,18350,18350,0,0,0,0.00,48
,20170310,18350,18350,,,,18350,18350,0,0,0,0.00,48
,20170313,18350,18350,,,,18445,18445,95,95,0,0.00,48
,20170314,18445,18445,,,,18390,18390,-55,-55,0,0.00,48
,20170315,18390,18390,,,,18450,18450,60,60,0,0.00,48
,20170316,18450,18450,,,,18680,18680,230,230,0,0.00,48
,20170317,18680,18680,,,,18680,18680,0,0,0,0.00,48
,20170320,18680,18680,,,,18680,18680,0,0,0,0.00,48
,20170321,18680,18680,18680,18680,18680,18680,18680,0,0,4,37.36,44
,20170322,18680,18680,,,,18680,18680,0,0,0,0.00,44
,20170323,18680,18680,,,,18995,18995,315,315,0,0.00,44
,20170324,18995,18995,18590,18590,18590,18590,18590,-405,-405,2,18.59,46
,20170327,18590,18590,18490,18490,18245,18245,18365,-345,-225,4,36.74,46
,20170328,18245,18365,,,,18365,18365,0,0,0,0.00,46
,20170329,18365,18365,17520,17900,17515,17600,17705,-765,-660,22,194.79,54
,20170330,17600,17705,17645,17835,17575,17575,17735,-130,30,18,159.64,60
,20170331,17575,17735,17795,17835,17660,17660,17760,-75,25,6,53.29,62
,20170405,17660,17760,17735,17735,17735,17735,17735,-25,-25,2,17.74,62
,20170406,17735,17735,17735,17800,17735,17800,17765,65,30,4,35.54,66
,20170407,17800,17765,17790,17815,16770,16780,17575,-985,-190,32,281.26,76
,20170410,16780,17575,16645,16945,16645,16800,16835,-775,-740,14,117.87,74
,20170411,16800,16835,,,,16740,16740,-95,-95,0,0.00,74
,20170412,16740,16740,16860,16860,16850,16850,16850,110,110,12,101.11,80
,20170413,16850,16850,16725,16975,16725,16960,16825,110,-25,20,168.29,88
,20170414,16960,16825,16905,16905,16585,16850,16810,25,-15,8,67.25,88
,20170417,16850,16810,16965,16965,16965,16965,16965,155,155,2,16.97,88
,20170418,16965,16965,17010,17015,16610,16610,16790,-355,-175,16,134.33,86
,20170419,16610,16790,16280,16280,15925,16080,16025,-710,-765,38,304.49,96
,20170420,16080,16025,16280,16285,16110,16125,16190,100,165,14,113.36,102
,20170421,16125,16190,16320,16445,16290,16315,16340,125,150,22,179.78,106
,20170424,16315,16340,16015,16025,16015,16015,16015,-325,-325,6,48.06,106
,20170425,16015,16015,16085,16085,16070,16070,16080,55,65,6,48.24,108
,20170426,16070,16080,,,,16080,16080,0,0,0,0.00,108
,20170427,16080,16080,,,,16080,16080,0,0,0,0.00,108
,20170428,16080,16080,,,,16105,16105,25,25,0,0.00,108
,20170502,16105,16105,16795,16900,16785,16900,16835,795,730,18,151.54,108
,20170503,16900,16835,,,,16450,16450,-385,-385,0,0.00,108
,20170504,16450,16450,,,,16215,16215,-235,-235,0,0.00,108
,20170505,16215,16215,,,,16215,16215,0,0,0,0.00,108
,20170508,16215,16215,16230,16230,16160,16170,16195,-45,-20,10,81.00,114
,20170509,16170,16195,,,,16195,16195,0,0,0,0.00,114
,20170510,16195,16195,,,,16195,16195,0,0,0,0.00,114
,20170511,16195,16195,,,,16225,16225,30,30,0,0.00,114
,20170512,16225,16225,16210,16225,16205,16225,16210,0,-15,6,48.64,116
,20170515,16225,16210,16230,16230,16125,16130,16145,-80,-65,10,80.74,120
,20170516,16130,16145,16170,16170,15870,15930,16000,-215,-145,10,80.00,122
,20170517,15930,16000,,,,16000,16000,0,0,0,0.00,122
,20170518,16000,16000,15805,15805,15805,15805,15805,-195,-195,2,15.81,122
,20170519,15805,15805,15500,15600,15500,15600,15565,-205,-240,8,62.27,124
,20170522,15600,15565,15920,16025,15920,16025,15990,460,425,10,79.95,124
,20170523,16025,15990,15990,16125,15990,16005,16080,15,90,12,96.48,128
,20170524,16005,16080,15970,15970,15860,15950,15935,-130,-145,12,95.63,134
,20170525,15950,15935,15995,16050,15905,15945,15980,10,45,38,303.69,144
,20170526,15945,15980,15935,16100,15925,16100,16020,120,40,40,320.42,152
,20170531,16100,16020,16270,16270,15930,15930,16050,-90,30,6,48.16,152
,20170601,15930,16050,15925,16240,15925,16240,16050,190,0,6,48.15,152
,20170602,16240,16050,16150,16295,16135,16295,16160,245,110,22,177.77,138
,20170605,16295,16160,16595,16595,16540,16560,16565,400,405,6,49.70,136
,20170606,16560,16565,16535,16650,16535,16650,16565,85,0,20,165.66,126
,20170607,16650,16565,16790,16790,16580,16580,16620,15,55,10,83.12,126
,20170608,16580,16620,16585,16780,16525,16780,16585,160,-35,12,99.51,124
,20170609,16780,16585,16765,16800,16730,16730,16760,145,175,20,167.63,122
,20170612,16730,16760,17060,17070,16905,17070,17000,310,240,12,102.00,126
,20170613,17070,17000,16990,16990,16650,16675,16750,-325,-250,46,385.36,154
,20170614,16675,16750,16785,16785,16500,16530,16560,-220,-190,114,943.98,188
,20170615,16530,16560,16530,16680,16530,16600,16635,40,75,18,149.73,196
,20170616,16600,16635,16655,16760,16650,16760,16685,125,50,8,66.75,192
,20170619,16760,16685,16825,17150,16825,17150,16945,465,260,32,271.16,168
,20170620,17150,16945,17220,17350,17065,17315,17285,370,340,30,259.33,154
,20170621,17315,17285,17135,17135,17135,17135,17135,-150,-150,16,137.08,158
,20170622,17135,17135,17250,17265,17145,17230,17195,95,60,14,120.38,168
,20170623,17230,17195,17055,17145,16990,16990,17035,-205,-160,44,374.79,178
,20170626,16990,17035,16930,16950,16880,16880,16915,-155,-120,8,67.67,176
,20170627,16880,16915,16925,17195,16830,17195,16970,280,55,14,118.81,174
,20170628,17195,16970,17295,17550,17245,17550,17410,580,440,8,69.64,166
,20170629,17550,17410,,,,17410,17410,0,0,0,0.00,166
,20170630,17410,17410,17410,17410,17365,17365,17370,-45,-40,24,208.47,190
,20170703,17365,17370,17425,17700,17415,17700,17590,330,220,76,668.58,152
,20170704,17700,17590,17615,17755,17400,17400,17635,-190,45,18,158.72,146
,20170705,17400,17635,17385,17495,17200,17200,17300,-435,-335,36,311.46,168
,20170706,17200,17300,17185,17210,17050,17210,17120,-90,-180,30,256.84,170
,20170707,17210,17120,17255,17400,17255,17400,17315,280,195,8,69.27,170
,20170710,17400,17315,17490,17490,17330,17410,17390,95,75,8,69.57,164
,20170711,17410,17390,17220,17595,17220,17595,17400,205,10,6,52.21,160
,20170712,17595,17400,17675,17760,17675,17760,17715,360,315,4,35.44,160
,20170713,17760,17715,17610,17645,17580,17580,17625,-135,-90,10,88.13,154
,20170714,17580,17625,17655,17655,17290,17495,17455,-130,-170,28,244.38,166
,20170717,17495,17455,17515,17745,17515,17700,17670,245,215,18,159.06,166
,20170718,17700,17670,17750,17800,17535,17535,17675,-135,5,58,512.68,162
,20170719,17535,17675,17450,17580,17450,17465,17470,-210,-205,44,384.44,194
,20170720,17465,17470,17365,17365,17225,17265,17320,-205,-150,40,346.47,216
,20170721,17265,17320,17325,17405,17260,17405,17305,85,-15,450,"3,894.52",646
,20170724,17405,17305,,,,17305,17305,0,0,0,0.00,646
,20170725,17305,17305,17425,17550,17425,17530,17510,225,205,30,262.72,644
,20170726,17530,17510,17690,18030,17675,17865,17890,355,380,112,"1,002.11",672
,20170727,17865,17890,17890,18075,17835,17920,17945,30,55,206,"1,848.46",748
,20170728,17920,17945,17980,18085,17705,17705,17995,-240,50,58,521.90,758
,20170731,17705,17995,18040,18250,17935,18205,18120,210,125,24,217.47,752
,20170801,18205,18120,18140,18140,18050,18090,18085,-30,-35,26,235.17,762
,20170802,18090,18085,18065,18210,18055,18210,18095,125,10,40,361.98,748
,20170803,18210,18095,18345,18505,18305,18480,18420,385,325,56,515.76,756
,20170804,18480,18420,18375,18575,18290,18565,18510,145,90,118,"1,092.22",764
,20170807,18565,18510,18515,18930,18455,18930,18705,420,195,30,280.63,772
,20170808,18930,18705,19000,19040,18900,18995,18990,290,285,324,"3,077.08",952
,20170809,18995,18990,18840,19600,18840,19600,19250,610,260,520,"5,005.15",1340
,20170810,19600,19250,19425,19440,19175,19265,19320,15,70,152,"1,468.45",1334
,20170811,19265,19320,19255,19255,18850,18940,19030,-380,-290,150,"1,427.38",1350
,20170814,18940,19030,19040,19100,18820,18940,18960,-90,-70,106,"1,005.12",1354
,20170815,18940,18960,18900,19220,18900,19085,19105,125,145,550,"5,255.10",1580
,20170816,19085,19105,19135,19340,19090,19305,19235,200,130,168,"1,616.02",1608
,20170817,19305,19235,19430,20340,19430,20245,19955,1010,720,498,"4,968.85",1816
,20170818,20245,19955,19775,20020,19445,19840,19720,-115,-235,262,"2,583.48",1828
,20170821,19840,19720,19695,19950,19340,19470,19550,-250,-170,318,"3,108.94",1786
,20170822,19470,19550,19510,19510,18890,19170,19185,-380,-365,384,"3,683.57",1768
,20170823,19170,19185,19335,19720,19230,19450,19505,265,320,346,"3,374.91",1750
,20170824,19450,19505,19295,19510,19210,19230,19355,-275,-150,462,"4,471.75",1916
,20170825,19230,19355,19110,19335,19095,19315,19225,-40,-130,226,"2,172.76",1948
,20170828,19315,19225,19320,19415,18590,18835,18870,-390,-355,402,"3,793.43",1944
,20170829,18835,18870,18800,18935,18630,18895,18805,25,-65,534,"5,021.48",2212
,20170830,18895,18805,19140,19260,18890,19205,19160,400,355,598,"5,729.46",2312
,20170831,19205,19160,19080,19305,19050,19065,19145,-95,-15,260,"2,488.87",2350
,20170901,19065,19145,19100,19320,19050,19275,19205,130,60,348,"3,342.34",2318
,20170904,19275,19205,19205,19530,19200,19305,19405,100,200,948,"9,199.30",2860
,20170905,19305,19405,19270,19330,19110,19225,19200,-180,-205,484,"4,647.27",2748
,20170906,19225,19200,19115,19115,18510,18610,18745,-590,-455,1084,"10,161.92",2796
,20170907,18610,18745,18710,18825,18400,18400,18615,-345,-130,1214,"11,301.20",2848
,20170908,18400,18615,18530,18655,18070,18295,18390,-320,-225,1198,"11,017.46",2822
,20170911,18295,18390,18220,18250,17855,18165,18070,-225,-320,2438,"22,032.32",3140
,20170912,18165,18070,18205,18455,18135,18275,18300,205,230,3392,"31,037.88",4272
,20170913,18275,18300,18130,18750,18105,18490,18525,190,225,2166,"20,067.88",4606
,20170914,18490,18525,18660,18950,18430,18875,18760,350,235,3368,"31,597.90",5130
,20170915,18875,18760,18885,19315,18625,18625,18975,-135,215,2720,"25,811.83",5730
,20170918,18625,18975,18845,19500,18525,19355,19090,380,115,4940,"47,156.95",6632
,20170919,19355,19090,19300,19715,19300,19410,19540,320,450,3914,"38,242.24",7088
,20170920,19410,19540,19535,20285,19310,20180,19960,640,420,6382,"63,704.15",9054
,20170921,20180,19960,20180,20445,19950,20120,20215,160,255,9708,"98,146.16",9782
,20170922,20120,20215,20305,20415,19310,19645,19875,-570,-340,13504,"134,215.83",11146
,20170925,19645,19875,19960,20370,19805,20185,20120,310,245,16184,"162,812.47",14338
,20170926,20185,20120,20250,20385,20085,20345,20230,225,110,16104,"162,920.51",15478
,20170927,20345,20230,20230,20385,20000,20305,20205,75,-25,28970,"292,672.54",19630
,20170928,20305,20205,20225,20285,20050,20240,20175,35,-30,28512,"287,648.55",20984
,20170929,20240,20175,20345,20665,20070,20660,20350,485,175,39504,"401,995.32",22962
,20171009,20660,20350,20660,21030,20415,20755,20755,405,405,29228,"303,349.36",25658
,20171010,20755,20755,20720,20730,20180,20205,20475,-550,-280,47554,"486,872.00",26542
,20171011,20205,20475,20310,20500,20095,20305,20310,-170,-165,52334,"531,504.65",29842
,20171012,20305,20310,20325,20420,20030,20375,20230,65,-80,55736,"563,837.42",30672
,20171013,20375,20230,20395,20525,20105,20270,20335,40,105,60044,"610,526.56",33302
,20171016,20270,20335,20285,20500,20060,20435,20335,100,0,85698,"871,378.32",40026
,20171017,20435,20335,20495,20670,19930,20090,20335,-245,0,92420,"939,710.50",39656
,20171018,20090,20335,20090,20160,19265,19395,19670,-940,-665,107556,"1,058,064.46",42474
,20171019,19395,19670,19405,19570,19170,19200,19400,-470,-270,84344,"818,255.37",44656
,20171020,19200,19400,19195,19490,18850,19270,19150,-130,-250,119748,"1,146,643.30",45554
,20171023,19270,19150,19185,19390,18910,19295,19200,145,50,114172,"1,096,258.37",46208
,20171024,19295,19200,19220,19585,19210,19385,19425,185,225,88096,"855,658.16",46426
,20171025,19385,19425,19375,19390,18980,19025,19205,-400,-220,92038,"883,911.93",49642
,20171026,19025,19205,19090,19375,19045,19110,19175,-95,-30,86248,"826,951.28",51482
,20171027,19110,19175,19110,19135,18520,18635,18825,-540,-350,101866,"958,947.88",53734
,20171030,18635,18825,18635,18670,18200,18265,18455,-560,-370,91732,"846,514.96",54748
,20171031,18265,18455,18255,18650,18180,18610,18375,155,-80,82962,"762,385.23",50524
,20171101,18610,18375,18540,19105,18450,18715,18710,340,335,92770,"867,973.14",47228
,20171102,18715,18710,18755,18825,18555,18705,18685,-5,-25,68494,"639,981.35",46832
,20171103,18705,18685,18730,18815,18450,18590,18630,-95,-55,74206,"691,390.11",46178
,20171106,18590,18630,18670,18865,18515,18790,18655,160,25,62584,"583,854.15",45152
,20171107,18790,18655,18850,19045,18735,18835,18890,180,235,66300,"626,325.08",42714
,20171108,18835,18890,18835,19100,18640,18670,18840,-220,-50,60492,"569,894.35",42544
,20171109,18670,18840,18825,19010,18680,18860,18855,20,15,56558,"533,208.86",40386
,20171110,18860,18855,18935,19340,18785,19290,19095,435,240,68978,"658,604.61",40542
,20171113,19290,19095,19305,19430,19200,19260,19320,165,225,71272,"688,605.76",38036
,20171114,19260,19320,19205,19360,19020,19115,19185,-205,-135,65480,"628,134.19",37090
,20171115,19115,19185,19165,19185,18520,18725,18795,-460,-390,55878,"525,238.50",33982
,20171116,18725,18795,18610,18700,18345,18515,18485,-280,-310,39790,"367,782.32",29432
,20171117,18515,18485,18650,18680,18330,18490,18510,5,25,19670,"182,072.02",27896
,20171120,18490,18510,18470,18790,18400,18670,18600,160,90,12586,"117,066.48",24164
,20171121,18670,18600,18655,18780,18505,18680,18665,80,65,10890,"101,658.01",21532
,20171122,18680,18665,18815,18970,18715,18940,18875,275,210,7886,"74,431.25",18802
,20171123,18940,18875,18915,18915,18320,18340,18620,-535,-255,8960,"83,419.25",16228
,20171124,18340,18620,18310,18560,18310,18515,18430,-105,-190,4732,"43,611.65",14870
,20171127,18515,18430,18645,18680,18205,18275,18475,-155,45,7168,"66,219.96",12378
,20171128,18275,18475,18310,18435,18150,18375,18295,-100,-180,6256,"57,237.17",10624
,20171129,18375,18295,18375,18410,18070,18240,18265,-55,-30,2138,"19,525.43",10356
,20171130,18240,18265,18245,18880,18070,18350,18240,85,-25,1820,"16,598.54",9596
,20171201,18350,18240,18490,18695,18410,18695,18505,455,265,2926,"27,073.36",8970
,20171204,18695,18505,18800,19330,18775,18960,19060,455,555,1870,"17,824.68",9330
,20171205,18960,19060,18960,19060,18865,18870,18965,-190,-95,670,"6,353.88",9300
,20171206,18870,18965,18835,18930,18445,18735,18695,-230,-270,850,"7,945.98",9070
,20171207,18735,18695,18705,18805,18550,18580,18670,-115,-25,520,"4,854.63",8960
,20171208,18580,18670,18725,18725,18325,18480,18575,-190,-95,760,"7,059.38",8870
,20171211,18480,18575,18530,18530,18355,18480,18420,-95,-155,480,"4,420.90",8600
,20171212,18480,18420,18550,19085,18525,19080,18935,660,515,720,"6,817.50",8780
,20171213,19080,18935,18970,19170,18960,19170,19040,235,105,540,"5,141.03",8830
,20171214,19170,19040,19200,19200,18900,18940,18940,-100,-100,210,"1,988.80",8780
,20171215,18940,18940,18900,19200,18800,18800,18950,-140,10,270,"2,558.68",8630
pb1801,20170117,18940,18940,,,,18940,18940,0,0,0,0.00,0
,20170118,18940,18940,,,,18700,18700,-240,-240,0,0.00,0
,20170119,18700,18700,,,,18670,18670,-30,-30,0,0.00,0
,20170120,18670,18670,,,,17720,17720,-950,-950,0,0.00,0
,20170123,17720,17720,18965,18965,18620,18620,18790,900,1070,8,75.17,2
,20170124,18620,18790,19275,19275,18790,18790,19015,0,225,6,57.05,6
,20170125,18790,19015,,,,19015,19015,0,0,0,0.00,6
,20170126,19015,19015,18940,18940,18940,18940,18940,-75,-75,2,18.94,4
,20170203,18940,18940,18525,18880,18525,18880,18700,-60,-240,4,37.41,6
,20170206,18880,18700,19130,19130,18915,18915,19020,215,320,4,38.05,8
,20170207,18915,19020,18980,18980,18980,18980,18980,-40,-40,4,37.96,12
,20170208,18980,18980,,,,19085,19085,105,105,0,0.00,12
,20170209,19085,19085,,,,19085,19085,0,0,0,0.00,12
,20170210,19085,19085,,,,19260,19260,175,175,0,0.00,12
,20170213,19260,19260,19750,19750,19750,19750,19750,490,490,2,19.75,12
,20170214,19750,19750,19960,19960,19960,19960,19960,210,210,2,19.96,14
,20170215,19960,19960,19610,19920,19260,19920,19535,-40,-425,10,97.68,18
,20170216,19920,19535,,,,19480,19480,-55,-55,0,0.00,18
,20170217,19480,19480,,,,19235,19235,-245,-245,0,0.00,18
,20170220,19235,19235,,,,19235,19235,0,0,0,0.00,18
,20170221,19235,19235,,,,19235,19235,0,0,0,0.00,18
,20170222,19235,19235,,,,19235,19235,0,0,0,0.00,18
,20170223,19235,19235,18715,18715,18715,18715,18715,-520,-520,4,37.43,18
,20170224,18715,18715,19000,19015,18765,18765,18900,50,185,10,94.52,22
,20170227,18765,18900,18835,19085,18635,18745,18980,-155,80,22,208.79,30
,20170228,18745,18980,18880,18880,18875,18875,18875,-105,-105,4,37.76,30
,20170301,18875,18875,,,,18850,18850,-25,-25,0,0.00,30
,20170302,18850,18850,18885,18990,18885,18990,18935,140,85,4,37.88,30
,20170303,18990,18935,18915,18915,18830,18830,18870,-105,-65,4,37.75,32
,20170306,18830,18870,,,,18650,18650,-220,-220,0,0.00,32
,20170307,18650,18650,,,,18430,18430,-220,-220,0,0.00,32
,20170308,18430,18430,,,,18170,18170,-260,-260,0,0.00,32
,20170309,18170,18170,,,,18170,18170,0,0,0,0.00,32
,20170310,18170,18170,,,,18170,18170,0,0,0,0.00,32
,20170313,18170,18170,,,,18195,18195,25,25,0,0.00,32
,20170314,18195,18195,,,,18195,18195,0,0,0,0.00,32
,20170315,18195,18195,,,,18195,18195,0,0,0,0.00,32
,20170316,18195,18195,18630,18630,18585,18585,18605,390,410,4,37.22,34
,20170317,18585,18605,,,,18605,18605,0,0,0,0.00,34
,20170320,18605,18605,18750,18750,18750,18750,18750,145,145,2,18.75,36
,20170321,18750,18750,,,,18750,18750,0,0,0,0.00,36
,20170322,18750,18750,,,,18625,18625,-125,-125,0,0.00,36
,20170323,18625,18625,,,,18625,18625,0,0,0,0.00,36
,20170324,18625,18625,18530,18530,18495,18495,18510,-130,-115,4,37.03,38
,20170327,18495,18510,18515,18515,18515,18515,18515,5,5,2,18.52,38
,20170328,18515,18515,18080,18080,17740,17740,17910,-775,-605,4,35.82,38
,20170329,17740,17910,17750,17810,17595,17665,17685,-245,-225,12,106.12,40
,20170330,17665,17685,17795,17795,17585,17585,17645,-100,-40,8,70.60,46
,20170331,17585,17645,17675,17835,17675,17695,17725,50,80,8,70.91,48
,20170405,17695,17725,17830,17830,17830,17830,17830,105,105,2,17.83,46
,20170406,17830,17830,,,,17830,17830,0,0,0,0.00,46
,20170407,17830,17830,17720,17720,16855,16915,17100,-915,-730,8,68.41,44
,20170410,16915,17100,16970,16970,16815,16815,16930,-285,-170,10,84.65,50
,20170411,16815,16930,,,,16835,16835,-95,-95,0,0.00,50
,20170412,16835,16835,16945,16985,16680,16680,16900,-155,65,10,84.51,56
,20170413,16680,16900,16730,17040,16730,17025,16940,125,40,18,152.48,64
,20170414,17025,16940,,,,16940,16940,0,0,0,0.00,64
,20170417,16940,16940,,,,16940,16940,0,0,0,0.00,64
,20170418,16940,16940,16855,16860,16690,16690,16815,-250,-125,10,84.08,62
,20170419,16690,16815,16125,16190,15990,16100,16065,-715,-750,26,208.89,72
,20170420,16100,16065,16390,16400,16220,16330,16325,265,260,12,97.98,82
,20170421,16330,16325,16415,16420,16345,16420,16365,95,40,14,114.58,80
,20170424,16420,16365,16180,16190,16180,16190,16185,-175,-180,4,32.37,84
,20170425,16190,16185,16110,16110,16085,16085,16095,-100,-90,4,32.20,88
,20170426,16085,16095,16405,16405,16405,16405,16405,310,310,2,16.41,88
,20170427,16405,16405,16420,16420,16320,16320,16385,-85,-20,6,49.16,92
,20170428,16320,16385,,,,16385,16385,0,0,0,0.00,92
,20170502,16385,16385,,,,16385,16385,0,0,0,0.00,92
,20170503,16385,16385,16650,16650,16590,16590,16620,205,235,4,33.24,92
,20170504,16590,16620,16150,16150,16150,16150,16150,-470,-470,4,32.30,94
,20170505,16150,16150,,,,16150,16150,0,0,0,0.00,94
,20170508,16150,16150,16260,16260,16200,16200,16230,50,80,4,32.46,98
,20170509,16200,16230,,,,16230,16230,0,0,0,0.00,98
,20170510,16230,16230,,,,16230,16230,0,0,0,0.00,98
,20170511,16230,16230,16330,16715,16330,16715,16410,485,180,10,82.05,100
,20170512,16715,16410,16545,16545,16545,16545,16545,135,135,2,16.55,98
,20170515,16545,16545,16090,16090,16090,16090,16090,-455,-455,2,16.09,98
,20170516,16090,16090,16145,16145,15990,15990,16065,-100,-25,4,32.14,98
,20170517,15990,16065,,,,16025,16025,-40,-40,0,0.00,98
,20170518,16025,16025,15730,15730,15730,15730,15730,-295,-295,2,15.73,98
,20170519,15730,15730,,,,15730,15730,0,0,0,0.00,98
,20170522,15730,15730,15970,15990,15970,15990,15980,260,250,4,31.96,96
,20170523,15990,15980,,,,15980,15980,0,0,0,0.00,96
,20170524,15980,15980,15980,15985,15980,15985,15980,5,0,4,31.97,96
,20170525,15985,15980,15940,15940,15940,15940,15940,-40,-40,8,63.76,100
,20170526,15940,15940,16100,16100,16100,16100,16100,160,160,4,32.20,100
,20170531,16100,16100,16115,16135,15970,15970,16070,-130,-30,16,128.59,112
,20170601,15970,16070,16100,16210,16100,16210,16145,140,75,14,113.03,106
,20170602,16210,16145,16145,16415,16145,16415,16245,270,100,14,113.74,106
,20170605,16415,16245,16575,16650,16550,16550,16590,305,345,6,49.78,108
,20170606,16550,16590,16555,16700,16555,16700,16640,110,50,16,133.15,108
,20170607,16700,16640,16675,16675,16380,16510,16445,-130,-195,16,131.60,104
,20170608,16510,16445,16600,16830,16600,16815,16690,370,245,16,133.55,102
,20170609,16815,16690,16650,17010,16650,16725,16765,35,75,18,150.90,110
,20170612,16725,16765,16945,17075,16920,17055,17025,290,260,14,119.18,118
,20170613,17055,17025,17005,17005,16560,16785,16765,-240,-260,12,100.61,122
,20170614,16785,16765,16760,16760,16500,16515,16640,-250,-125,26,216.35,122
,20170615,16515,16640,16515,16600,16515,16600,16555,-40,-85,12,99.35,128
,20170616,16600,16555,16535,16790,16520,16695,16685,140,130,26,216.91,130
,20170619,16695,16685,16755,17045,16755,17045,16935,360,250,30,254.04,114
,20170620,17045,16935,17075,17075,17075,17075,17075,140,140,6,51.23,112
,20170621,17075,17075,17110,17110,16990,17020,17040,-55,-35,8,68.18,114
,20170622,17020,17040,17300,17300,17300,17300,17300,260,260,4,34.60,114
,20170623,17300,17300,17035,17155,16960,17005,17025,-295,-275,34,289.48,134
,20170626,17005,17025,16860,17045,16850,16895,16920,-130,-105,90,761.55,186
,20170627,16895,16920,16890,17170,16890,17170,17060,250,140,16,136.49,180
,20170628,17170,17060,,,,17135,17135,75,75,0,0.00,180
,20170629,17135,17135,17385,17430,17375,17430,17390,295,255,16,139.14,176
,20170630,17430,17390,17310,17310,17310,17310,17310,-80,-80,2,17.31,174
,20170703,17310,17310,17470,17600,17470,17600,17530,290,220,46,403.23,156
,20170704,17600,17530,17570,17600,17305,17305,17445,-225,-85,12,104.69,152
,20170705,17305,17445,17305,17305,17140,17140,17200,-305,-245,24,206.42,162
,20170706,17140,17200,17075,17075,17030,17055,17065,-145,-135,30,255.99,184
,20170707,17055,17065,17220,17415,17100,17410,17245,345,180,40,344.95,156
,20170710,17410,17245,,,,17205,17205,-40,-40,0,0.00,156
,20170711,17205,17205,17325,17330,17325,17330,17325,125,120,4,34.66,158
,20170712,17330,17325,17605,17775,17445,17615,17610,290,285,22,193.74,158
,20170713,17615,17610,17500,17550,17490,17550,17510,-60,-100,6,52.54,158
,20170714,17550,17510,17530,17570,17210,17315,17320,-195,-190,40,346.49,146
,20170717,17315,17320,17450,17740,17450,17640,17495,320,175,64,559.98,114
,20170718,17640,17495,17555,17605,17505,17505,17560,10,65,10,87.81,112
,20170719,17505,17560,17485,17540,17415,17540,17495,-20,-65,18,157.49,118
,20170720,17540,17495,17335,17410,17250,17250,17285,-245,-210,30,259.31,136
,20170721,17250,17285,17400,17475,17400,17475,17415,190,130,30,261.28,164
,20170724,17475,17415,17515,17520,17450,17450,17475,35,60,10,87.39,162
,20170725,17450,17475,17545,17565,17545,17565,17555,90,80,4,35.11,164
,20170726,17565,17555,17695,18000,17680,17945,17875,390,320,42,375.41,152
,20170727,17945,17875,17835,18050,17835,17915,17990,40,115,86,773.58,194
,20170728,17915,17990,18050,18055,17815,17815,17975,-175,-15,116,"1,042.74",256
,20170731,17815,17975,18020,18155,18020,18155,18055,180,80,14,126.41,256
,20170801,18155,18055,18190,18190,17875,17875,18000,-180,-55,20,180.01,260
,20170802,17875,18000,18030,18150,18005,18150,18055,150,55,18,162.51,260
,20170803,18150,18055,18185,18550,18185,18320,18390,265,335,42,386.20,278
,20170804,18320,18390,18350,18530,18205,18460,18395,70,5,190,"1,747.94",314
,20170807,18460,18395,18450,18895,18395,18815,18535,420,140,48,444.89,314
,20170808,18815,18535,18955,18960,18790,18920,18905,385,370,20,189.06,316
,20170809,18920,18905,18745,19360,18745,19360,19155,455,250,142,"1,360.11",386
,20170810,19360,19155,19335,19430,19060,19215,19260,60,105,80,770.53,396
,20170811,19215,19260,19100,19195,18765,18800,18945,-460,-315,174,"1,648.27",388
,20170814,18800,18945,18985,19085,18785,18925,18965,-20,20,122,"1,156.89",428
,20170815,18925,18965,18930,19160,18880,19005,19035,40,70,230,"2,189.49",532
,20170816,19005,19035,19110,19275,19055,19200,19155,165,120,50,478.88,542
,20170817,19200,19155,19410,20250,19410,20175,19755,1020,600,474,"4,682.95",842
,20170818,20175,19755,19755,19945,19310,19605,19675,-150,-80,182,"1,790.64",846
,20170821,19605,19675,19595,19885,19300,19460,19530,-215,-145,490,"4,785.11",876
,20170822,19460,19530,19455,19515,18845,19090,19145,-440,-385,392,"3,753.32",848
,20170823,19090,19145,19390,19650,19170,19420,19430,275,285,344,"3,342.35",804
,20170824,19420,19430,19430,19515,19160,19210,19365,-220,-65,98,948.91,810
,20170825,19210,19365,19210,19295,19030,19295,19165,-70,-200,222,"2,127.59",856
,20170828,19295,19165,19300,19300,18570,18760,18785,-405,-380,268,"2,517.31",868
,20170829,18760,18785,18860,18895,18605,18850,18765,65,-20,394,"3,697.29",1008
,20170830,18850,18765,18995,19300,18825,19155,19050,390,285,310,"2,952.81",982
,20170831,19155,19050,19040,19230,18980,19030,19070,-20,20,148,"1,411.28",972
,20170901,19030,19070,19260,19260,18920,19205,19150,135,80,440,"4,213.76",1032
,20170904,19205,19150,19110,19425,19105,19160,19265,10,115,854,"8,227.25",1328
,20170905,19160,19265,19140,19175,19000,19100,19075,-165,-190,340,"3,243.32",1388
,20170906,19100,19075,18950,18970,18455,18500,18690,-575,-385,716,"6,692.22",1500
,20170907,18500,18690,18640,18680,18275,18280,18485,-410,-205,548,"5,064.92",1682
,20170908,18280,18485,18135,18795,17885,18000,18250,-485,-235,922,"8,415.30",1904
,20170911,18000,18250,18060,18060,17710,17970,17880,-280,-370,262,"2,342.38",1894
,20170912,17970,17880,17965,18245,17935,18035,18050,155,170,652,"5,885.80",2124
,20170913,18035,18050,17905,18390,17860,18245,18230,195,180,846,"7,712.31",2276
,20170914,18245,18230,18270,19155,18160,18630,18500,400,270,752,"6,957.87",2246
,20170915,18630,18500,18745,19030,18355,18405,18695,-95,195,852,"7,964.25",2360
,20170918,18405,18695,18530,19250,18250,19050,18955,355,260,1516,"14,370.62",2590
,20170919,19050,18955,19105,19300,19045,19100,19195,145,240,980,"9,406.50",2692
,20170920,19100,19195,19285,19955,18895,19845,19545,650,350,1422,"13,898.19",2862
,20170921,19845,19545,19920,20100,19590,19810,19880,265,335,1822,"18,110.86",2954
,20170922,19810,19880,20200,20200,19050,19390,19710,-490,-170,2804,"27,635.16",3528
,20170925,19390,19710,19700,20060,19515,19835,19820,125,110,2684,"26,602.18",3464
,20170926,19835,19820,19875,20245,19760,20070,19950,250,130,1878,"18,736.39",3860
,20170927,20070,19950,19975,20100,19785,20020,19965,70,15,1504,"15,016.56",4074
,20170928,20020,19965,19955,20000,19790,19945,19910,-20,-55,1354,"13,480.22",4170
,20170929,19945,19910,19990,20315,19770,20280,20030,370,120,2742,"27,464.06",4880
,20171009,20280,20030,20335,20700,20100,20455,20460,425,430,2564,"26,233.03",5450
,20171010,20455,20460,20395,20435,19900,19900,20215,-560,-245,3166,"32,003.05",6098
,20171011,19900,20215,19955,20255,19840,20100,20060,-115,-155,4054,"40,669.33",6674
,20171012,20100,20060,20085,20200,19800,20140,20015,80,-45,3216,"32,187.67",7112
,20171013,20140,20015,20185,20295,19905,20065,20125,50,110,3912,"39,365.35",7936
,20171016,20065,20125,20070,20300,19845,20235,20150,110,25,6770,"68,216.76",8762
,20171017,20235,20150,20295,20500,19845,19970,20175,-180,25,7150,"72,134.19",9200
,20171018,19970,20175,20010,20030,19080,19240,19530,-935,-645,7268,"70,987.25",9264
,20171019,19240,19530,19240,19420,19085,19105,19255,-425,-275,8268,"79,607.98",9756
,20171020,19105,19255,19095,19375,18770,19160,19065,-95,-190,10106,"96,347.06",10248
,20171023,19160,19065,19160,19345,18790,19190,19095,125,30,7302,"69,730.59",10870
,20171024,19190,19095,19190,19480,19165,19285,19300,190,205,6552,"63,229.05",11326
,20171025,19285,19300,19255,19285,18925,18970,19100,-330,-200,11824,"112,945.17",12774
,20171026,18970,19100,19040,19320,18990,19035,19135,-65,35,10960,"104,869.66",13082
,20171027,19035,19135,19100,19100,18500,18605,18795,-530,-340,16108,"151,377.03",15720
,20171030,18605,18795,18660,18660,18230,18295,18450,-500,-345,18082,"166,842.19",18932
,20171031,18295,18450,18290,18650,18195,18610,18415,160,-35,21420,"197,274.54",20508
,20171101,18610,18415,18595,19120,18470,18730,18745,315,330,24130,"226,174.31",22188
,20171102,18730,18745,18810,18845,18570,18735,18705,-10,-40,23032,"215,443.18",22824
,20171103,18735,18705,18740,18825,18510,18615,18660,-90,-45,28988,"270,515.26",24200
,20171106,18615,18660,18750,18915,18580,18870,18725,210,65,23096,"216,238.60",25934
,20171107,18870,18725,18910,19065,18760,18840,18910,115,185,29874,"282,531.98",27960
,20171108,18840,18910,18825,19090,18685,18720,18860,-190,-50,31678,"298,735.43",29768
,20171109,18720,18860,18905,19050,18710,18895,18895,35,35,33328,"314,919.57",30864
,20171110,18895,18895,18950,19340,18815,19320,19120,425,225,45556,"435,600.67",34494
,20171113,19320,19120,19345,19435,19225,19280,19325,160,205,42452,"410,245.93",35744
,20171114,19280,19325,19225,19350,19040,19095,19180,-230,-145,44988,"431,507.43",36568
,20171115,19095,19180,19095,19180,18530,18720,18800,-460,-380,52106,"489,820.62",34786
,20171116,18720,18800,18650,18675,18385,18495,18485,-305,-315,47010,"434,503.41",39188
,20171117,18495,18485,18580,18605,18270,18410,18445,-75,-40,49316,"454,838.06",41048
,20171120,18410,18445,18400,18755,18325,18660,18570,215,125,52986,"492,093.05",41836
,20171121,18660,18570,18610,18810,18495,18675,18655,105,85,61314,"572,041.15",43086
,20171122,18675,18655,18770,18975,18715,18955,18850,300,195,57164,"538,782.55",44540
,20171123,18955,18850,18910,18920,18290,18300,18645,-550,-205,84326,"786,297.56",48952
,20171124,18300,18645,18330,18575,18270,18520,18430,-125,-215,68964,"635,555.79",46800
,20171127,18520,18430,18685,18695,18235,18300,18510,-130,80,65796,"608,979.26",48782
,20171128,18300,18510,18300,18495,18130,18380,18340,-130,-170,75850,"695,593.15",49794
,20171129,18380,18340,18400,18480,18055,18260,18275,-80,-65,68318,"624,420.79",47408
,20171130,18260,18275,18250,18415,18185,18375,18290,100,15,57352,"524,555.69",45902
,20171201,18375,18290,18510,18765,18385,18750,18560,460,270,62056,"575,901.06",44492
,20171204,18750,18560,18830,19385,18770,18950,19085,390,525,83666,"798,394.18",46026
,20171205,18950,19085,19115,19150,18850,18910,19010,-175,-75,61952,"588,936.66",43146
,20171206,18910,19010,18900,18970,18480,18720,18680,-290,-330,58974,"550,940.94",40212
,20171207,18720,18680,18820,18915,18560,18680,18755,0,75,56268,"527,715.00",38232
,20171208,18680,18755,18705,18850,18380,18550,18625,-205,-130,66464,"619,094.15",37242
,20171211,18550,18625,18440,18620,18360,18490,18470,-135,-155,50950,"470,589.70",37242
,20171212,18490,18470,18595,19525,18560,19155,18870,685,400,79530,"750,546.41",41644
,20171213,19155,18870,19250,19280,19025,19270,19170,400,300,52326,"501,552.35",39568
,20171214,19270,19170,19260,19265,19000,19050,19140,-120,-30,36026,"344,855.68",37010
,20171215,19050,19140,18955,19075,18900,18980,18990,-160,-150,27368,"259,870.42",34158
,20171218,18980,18990,19050,19465,18980,19315,19220,325,230,38016,"365,413.34",32010
,20171219,19315,19220,19465,19550,19190,19250,19365,30,145,25402,"245,982.06",28590
,20171220,19250,19365,19290,19435,19165,19330,19300,-35,-65,15668,"151,208.95",24094
,20171221,19330,19300,19290,19350,18880,19175,19160,-125,-140,14252,"136,549.37",21198
,20171222,19175,19160,19135,19265,18950,19245,19050,85,-110,10664,"101,588.42",19316
,20171225,19245,19050,19135,19245,19005,19095,19130,45,80,7446,"71,230.82",17228
,20171226,19095,19130,19095,19150,18890,18950,18980,-180,-150,5690,"54,004.28",15298
,20171227,18950,18980,18980,19050,18890,19025,18985,45,5,4400,"41,775.05",13620
,20171228,19025,18985,19145,19250,19020,19170,19175,185,190,3994,"38,297.18",12552
,20171229,19170,19175,19105,19200,19060,19180,19105,5,-70,3798,"36,283.59",9380
pb1802,20170216,19535,19535,,,,19440,19440,-95,-95,0,0.00,0
,20170217,19440,19440,,,,18795,18795,-645,-645,0,0.00,0
,20170220,18795,18795,,,,18640,18640,-155,-155,0,0.00,0
,20170221,18640,18640,19220,19220,19220,19220,19220,580,580,2,19.22,2
,20170222,19220,19220,,,,18985,18985,-235,-235,0,0.00,2
,20170223,18985,18985,,,,18470,18470,-515,-515,0,0.00,2
,20170224,18470,18470,,,,18770,18770,300,300,0,0.00,2
,20170227,18770,18770,18905,19040,18905,19040,18970,270,200,4,37.95,4
,20170228,19040,18970,,,,18865,18865,-105,-105,0,0.00,4
,20170301,18865,18865,,,,18840,18840,-25,-25,0,0.00,4
,20170302,18840,18840,,,,18840,18840,0,0,0,0.00,4
,20170303,18840,18840,18965,18965,18400,18860,18740,20,-100,6,56.23,10
,20170306,18860,18740,,,,18650,18650,-90,-90,0,0.00,10
,20170307,18650,18650,18205,18575,18205,18575,18390,-75,-260,4,36.78,8
,20170308,18575,18390,,,,18390,18390,0,0,0,0.00,8
,20170309,18390,18390,18275,18275,18275,18275,18275,-115,-115,2,18.28,10
,20170310,18275,18275,,,,18275,18275,0,0,0,0.00,10
,20170313,18275,18275,18530,18530,18530,18530,18530,255,255,4,37.06,10
,20170314,18530,18530,18535,18535,18535,18535,18535,5,5,2,18.54,8
,20170315,18535,18535,,,,18535,18535,0,0,0,0.00,8
,20170316,18535,18535,18575,18575,18575,18575,18575,40,40,2,18.58,10
,20170317,18575,18575,,,,18575,18575,0,0,0,0.00,10
,20170320,18575,18575,18820,18820,18820,18820,18820,245,245,2,18.82,10
,20170321,18820,18820,,,,18820,18820,0,0,0,0.00,10
,20170322,18820,18820,18395,18395,18395,18395,18395,-425,-425,2,18.40,10
,20170323,18395,18395,18895,18895,18730,18730,18810,335,415,4,37.63,14
,20170324,18730,18810,18715,18715,18540,18540,18625,-270,-185,4,37.26,12
,20170327,18540,18625,18230,18230,18230,18230,18230,-395,-395,2,18.23,12
,20170328,18230,18230,17910,17910,17520,17520,17660,-710,-570,20,176.60,28
,20170329,17520,17660,17745,17855,17440,17855,17630,195,-30,12,105.79,32
,20170330,17855,17630,17785,17785,17565,17565,17630,-65,0,8,70.52,36
,20170331,17565,17630,17730,17730,17730,17730,17730,100,100,2,17.73,38
,20170405,17730,17730,,,,17800,17800,70,70,0,0.00,38
,20170406,17800,17800,,,,17830,17830,30,30,0,0.00,38
,20170407,17830,17830,17825,17825,17710,17710,17755,-120,-75,10,88.80,44
,20170410,17710,17755,16765,16965,16765,16820,16840,-935,-915,12,101.05,52
,20170411,16820,16840,16785,16785,16785,16785,16785,-55,-55,2,16.79,54
,20170412,16785,16785,16950,17000,16545,16855,16790,70,5,48,403.03,70
,20170413,16855,16790,16745,17190,16745,17190,16980,400,190,58,492.52,92
,20170414,17190,16980,17115,17115,16920,16920,17040,-60,60,10,85.22,90
,20170417,16920,17040,,,,17040,17040,0,0,0,0.00,90
,20170418,17040,17040,17060,17060,16870,16870,16970,-170,-70,8,67.89,82
,20170419,16870,16970,16465,16465,16000,16070,16200,-900,-770,78,631.82,64
,20170420,16070,16200,16275,16405,16195,16195,16315,-5,115,40,326.38,78
,20170421,16195,16315,16390,16430,16390,16430,16405,115,90,10,82.04,74
,20170424,16430,16405,16165,16165,15980,16120,16095,-285,-310,8,64.39,70
,20170425,16120,16095,16165,16165,16165,16165,16165,70,70,2,16.17,70
,20170426,16165,16165,16400,16400,16400,16400,16400,235,235,6,49.20,68
,20170427,16400,16400,16455,16455,16320,16340,16380,-60,-20,26,212.97,62
,20170428,16340,16380,,,,16540,16540,160,160,0,0.00,62
,20170502,16540,16540,16930,16930,16855,16855,16890,315,350,4,33.79,60
,20170503,16855,16890,16655,16710,16600,16600,16655,-290,-235,6,49.97,62
,20170504,16600,16655,16265,16340,16065,16065,16220,-590,-435,10,81.10,64
,20170505,16065,16220,16145,16440,16145,16395,16265,175,45,12,97.60,66
,20170508,16395,16265,16305,16305,16270,16270,16285,5,20,4,32.58,66
,20170509,16270,16285,,,,16285,16285,0,0,0,0.00,66
,20170510,16285,16285,16500,16500,16500,16500,16500,215,215,2,16.50,68
,20170511,16500,16500,16445,16445,16380,16380,16395,-120,-105,10,81.99,68
,20170512,16380,16395,16375,16375,16275,16275,16325,-120,-70,4,32.65,70
,20170515,16275,16325,16100,16100,16100,16100,16100,-225,-225,2,16.10,68
,20170516,16100,16100,16190,16190,15995,15995,16090,-105,-10,4,32.19,72
,20170517,15995,16090,16000,16000,16000,16000,16000,-90,-90,4,32.00,68
,20170518,16000,16000,15735,15735,15735,15735,15735,-265,-265,2,15.74,66
,20170519,15735,15735,,,,15735,15735,0,0,0,0.00,66
,20170522,15735,15735,,,,15950,15950,215,215,0,0.00,66
,20170523,15950,15950,16025,16045,16025,16045,16030,95,80,12,96.19,54
,20170524,16045,16030,,,,16030,16030,0,0,0,0.00,54
,20170525,16030,16030,16070,16070,15970,15975,16000,-55,-30,8,64.01,58
,20170526,15975,16000,16100,16100,16100,16100,16100,100,100,2,16.10,58
,20170531,16100,16100,,,,16100,16100,0,0,0,0.00,58
,20170601,16100,16100,16195,16195,16195,16195,16195,95,95,2,16.20,58
,20170602,16195,16195,16330,16330,16330,16330,16330,135,135,4,32.66,62
,20170605,16330,16330,,,,16570,16570,240,240,0,0.00,62
,20170606,16570,16570,16725,16725,16725,16725,16725,155,155,2,16.73,64
,20170607,16725,16725,16470,16470,16470,16470,16470,-255,-255,2,16.47,64
,20170608,16470,16470,16625,16625,16625,16625,16625,155,155,2,16.63,66
,20170609,16625,16625,16810,16900,16730,16900,16810,275,185,6,50.44,66
,20170612,16900,16810,17050,17050,17050,17050,17050,240,240,4,34.10,70
,20170613,17050,17050,,,,17050,17050,0,0,0,0.00,70
,20170614,17050,17050,16615,16735,16540,16540,16590,-510,-460,16,132.74,76
,20170615,16540,16590,16615,16615,16615,16615,16615,25,25,2,16.62,78
,20170616,16615,16615,16725,16735,16725,16735,16730,120,115,4,33.46,78
,20170619,16735,16730,16800,17000,16800,17000,16930,270,200,6,50.80,74
,20170620,17000,16930,,,,17065,17065,135,135,0,0.00,74
,20170621,17065,17065,,,,17065,17065,0,0,0,0.00,74
,20170622,17065,17065,,,,17325,17325,260,260,0,0.00,74
,20170623,17325,17325,,,,17140,17140,-185,-185,0,0.00,74
,20170626,17140,17140,,,,17070,17070,-70,-70,0,0.00,74
,20170627,17070,17070,17155,17155,17155,17155,17155,85,85,2,17.16,72
,20170628,17155,17155,,,,17155,17155,0,0,0,0.00,72
,20170629,17155,17155,17410,17410,17410,17410,17410,255,255,2,17.41,74
,20170630,17410,17410,17305,17305,17305,17305,17305,-105,-105,2,17.31,74
,20170703,17305,17305,17560,17560,17560,17560,17560,255,255,2,17.56,72
,20170704,17560,17560,,,,17560,17560,0,0,0,0.00,72
,20170705,17560,17560,17050,17050,17050,17050,17050,-510,-510,2,17.05,72
,20170706,17050,17050,17045,17045,17045,17045,17045,-5,-5,2,17.05,70
,20170707,17045,17045,17345,17345,17345,17345,17345,300,300,6,52.04,76
,20170710,17345,17345,,,,17345,17345,0,0,0,0.00,76
,20170711,17345,17345,,,,17475,17475,130,130,0,0.00,76
,20170712,17475,17475,17540,17540,17540,17540,17540,65,65,2,17.54,76
,20170713,17540,17540,17520,17520,17440,17520,17495,-20,-45,10,87.48,74
,20170714,17520,17495,17510,17510,17225,17225,17325,-270,-170,14,121.30,82
,20170717,17225,17325,17415,17515,17415,17515,17430,190,105,12,104.59,74
,20170718,17515,17430,17660,17675,17520,17530,17580,100,150,10,87.92,78
,20170719,17530,17580,17335,17490,17335,17490,17395,-90,-185,16,139.17,84
,20170720,17490,17395,17300,17300,17170,17270,17265,-125,-130,14,120.88,92
,20170721,17270,17265,17355,17355,17320,17320,17335,55,70,4,34.68,96
,20170724,17320,17335,,,,17395,17395,60,60,0,0.00,96
,20170725,17395,17395,,,,17555,17555,160,160,0,0.00,96
,20170726,17555,17555,17670,17955,17670,17955,17860,400,305,22,196.51,102
,20170727,17955,17860,17985,18015,17880,17880,17945,20,85,24,215.35,106
,20170728,17880,17945,18005,18005,17960,18000,17980,55,35,14,125.87,100
,20170731,18000,17980,18150,18190,18150,18190,18170,210,190,4,36.34,98
,20170801,18190,18170,,,,18170,18170,0,0,0,0.00,98
,20170802,18170,18170,,,,18170,18170,0,0,0,0.00,98
,20170803,18170,18170,,,,18170,18170,0,0,0,0.00,98
,20170804,18170,18170,,,,18425,18425,255,255,0,0.00,98
,20170807,18425,18425,18825,18825,18825,18825,18825,400,400,2,18.83,96
,20170808,18825,18825,,,,18825,18825,0,0,0,0.00,96
,20170809,18825,18825,19150,19275,19150,19195,19185,370,360,12,115.13,102
,20170810,19195,19185,19320,19320,19320,19320,19320,135,135,2,19.32,102
,20170811,19320,19320,18980,18980,18980,18980,18980,-340,-340,2,18.98,100
,20170814,18980,18980,18900,18900,18900,18900,18900,-80,-80,6,56.70,100
,20170815,18900,18900,19045,19045,18980,18980,19020,80,120,14,133.16,104
,20170816,18980,19020,19085,19125,19045,19125,19085,105,65,6,57.26,102
,20170817,19125,19085,19635,19895,19635,19895,19765,810,680,4,39.53,102
,20170818,19895,19765,19715,19715,19415,19550,19615,-215,-150,10,98.08,102
,20170821,19550,19615,19545,19720,19300,19420,19455,-195,-160,48,466.92,106
,20170822,19420,19455,19345,19345,18845,19080,19110,-375,-345,36,344.01,120
,20170823,19080,19110,19270,19575,19120,19575,19255,465,145,52,500.67,122
,20170824,19575,19255,19180,19180,19180,19180,19180,-75,-75,2,19.18,120
,20170825,19180,19180,19095,19215,19050,19155,19135,-25,-45,22,210.53,118
,20170828,19155,19135,19315,19315,18640,18730,18915,-405,-220,18,170.28,114
,20170829,18730,18915,18650,18660,18650,18660,18655,-255,-260,4,37.31,112
,20170830,18660,18655,19055,19105,18810,19030,19000,375,345,90,855.11,130
,20170831,19030,19000,20040,20040,18810,19050,19070,50,70,54,515.00,114
,20170901,19050,19070,18940,19090,18940,19090,19025,20,-45,10,95.14,112
,20170904,19090,19025,19155,19355,19115,19115,19200,90,175,44,422.44,126
,20170905,19115,19200,19100,19130,18960,18960,19080,-240,-120,24,228.96,128
,20170906,18960,19080,18490,18635,18450,18470,18505,-610,-575,20,185.06,140
,20170907,18470,18505,18545,18555,18515,18555,18530,50,25,24,222.42,152
,20170908,18555,18530,18330,18375,17725,17805,18145,-725,-385,108,980.04,184
,20170911,17805,18145,17830,17865,17610,17800,17760,-345,-385,24,213.14,188
,20170912,17800,17760,18005,18100,17870,17915,17945,155,185,14,125.63,198
,20170913,17915,17945,18105,18300,18105,18110,18180,165,235,24,218.19,200
,20170914,18110,18180,18055,18335,18055,18335,18135,155,-45,18,163.25,196
,20170915,18335,18135,18305,18835,18305,18350,18530,215,395,18,166.79,190
,20170918,18350,18530,18495,19075,17950,19000,18940,470,410,114,"1,079.63",258
,20170919,19000,18940,19040,19055,18930,19015,19025,75,85,56,532.80,228
,20170920,19015,19025,18950,19720,18950,19720,19395,695,370,36,349.14,208
,20170921,19720,19395,19585,19585,19585,19585,19585,190,190,4,39.17,208
,20170922,19585,19585,19975,19975,19000,19010,19360,-575,-225,30,290.42,210
,20170925,19010,19360,19630,19695,19630,19635,19645,275,285,8,78.59,208
,20170926,19635,19645,19745,20085,19730,19900,19810,255,165,120,"1,188.82",288
,20170927,19900,19810,19725,19860,19645,19860,19770,50,-40,80,790.94,356
,20170928,19860,19770,19850,19895,19650,19830,19780,60,10,134,"1,325.28",384
,20170929,19830,19780,19950,20030,19710,19950,19935,170,155,162,"1,614.87",464
,20171009,19950,19935,20090,20475,20090,20355,20165,420,230,110,"1,109.22",456
,20171010,20355,20165,20085,20165,19775,19775,20080,-390,-85,54,542.24,450
,20171011,19775,20080,20075,20075,19900,19900,19990,-180,-90,280,"2,798.61",662
,20171012,19900,19990,19685,20040,19685,20040,19825,50,-165,122,"1,209.55",678
,20171013,20040,19825,20080,20315,19830,20030,20085,205,260,310,"3,113.19",840
,20171016,20030,20085,19895,20200,19775,20180,20055,95,-30,252,"2,527.56",820
,20171017,20180,20055,20220,20385,19800,19845,20195,-210,140,168,"1,696.77",798
,20171018,19845,20195,19915,19915,19100,19100,19490,-1095,-705,168,"1,637.33",804
,20171019,19100,19490,19145,19460,19090,19125,19240,-365,-250,292,"2,809.68",944
,20171020,19125,19240,19080,19290,18805,19145,19000,-95,-240,94,893.14,956
,20171023,19145,19000,19105,19240,18800,19165,19065,165,65,78,743.58,960
,20171024,19165,19065,19205,19445,19170,19300,19310,235,245,224,"2,163.22",1048
,20171025,19300,19310,19255,19255,18975,19100,19100,-210,-210,150,"1,432.72",1048
,20171026,19100,19100,19020,19300,19000,19045,19130,-55,30,182,"1,740.95",1096
,20171027,19045,19130,19055,19060,18535,18600,18870,-530,-260,188,"1,773.84",1098
,20171030,18600,18870,18535,18655,18265,18330,18490,-540,-380,516,"4,770.86",1270
,20171031,18330,18490,18295,18680,18255,18625,18385,135,-105,438,"4,026.76",1402
,20171101,18625,18385,18590,19080,18500,18790,18760,405,375,374,"3,508.72",1462
,20171102,18790,18760,18795,18825,18620,18710,18730,-50,-30,592,"5,545.50",1474
,20171103,18710,18730,18745,18820,18555,18695,18690,-35,-40,424,"3,963.15",1498
,20171106,18695,18690,18740,18960,18620,18940,18755,250,65,282,"2,644.99",1500
,20171107,18940,18755,18995,19105,18815,18870,18985,115,230,526,"4,994.23",1478
,20171108,18870,18985,18885,19090,18760,18770,18900,-215,-85,452,"4,271.79",1472
,20171109,18770,18900,18970,19090,18780,18940,18940,40,40,518,"4,906.73",1522
,20171110,18940,18940,18940,19380,18875,19360,19180,420,240,2394,"22,960.65",2254
,20171113,19360,19180,19385,19470,19240,19295,19350,115,170,2264,"21,904.95",2838
,20171114,19295,19350,19200,19350,19075,19095,19185,-255,-165,2710,"25,999.56",3362
,20171115,19095,19185,19125,19165,18575,18695,18815,-490,-370,2144,"20,171.02",4022
,20171116,18695,18815,18550,18665,18380,18480,18470,-335,-345,2608,"24,086.43",4768
,20171117,18480,18470,18565,18600,18275,18405,18425,-65,-45,2630,"24,229.75",5184
,20171120,18405,18425,18370,18725,18320,18645,18565,220,140,2746,"25,492.45",5550
,20171121,18645,18565,18635,18740,18385,18670,18615,105,50,3422,"31,856.69",6042
,20171122,18670,18615,18705,19000,18705,18960,18825,345,210,3714,"34,964.99",6940
,20171123,18960,18825,18905,18905,18315,18335,18655,-490,-170,4864,"45,373.41",7222
,20171124,18335,18655,18335,18590,18290,18550,18450,-105,-205,6110,"56,373.06",8616
,20171127,18550,18450,18665,18710,18305,18370,18520,-80,70,7016,"64,972.76",9938
,20171128,18370,18520,18405,18515,17405,18410,18280,-110,-240,7412,"67,746.61",10274
,20171129,18410,18280,18410,18485,18100,18290,18300,10,20,10348,"94,707.69",12522
,20171130,18290,18300,18310,18420,18205,18400,18305,100,5,11146,"102,017.02",13190
,20171201,18400,18305,18550,18750,18405,18750,18570,445,265,12786,"118,740.20",14578
,20171204,18750,18570,18845,19350,18770,18950,19065,380,495,20480,"195,275.21",16662
,20171205,18950,19065,19050,19110,18850,18885,18995,-180,-70,18054,"171,475.72",17372
,20171206,18885,18995,18850,18950,18465,18725,18675,-270,-320,22184,"207,172.16",17188
,20171207,18725,18675,18775,18875,18540,18670,18745,-5,70,21128,"198,052.68",18076
,20171208,18670,18745,18720,18835,18300,18530,18605,-215,-140,32576,"303,090.43",19060
,20171211,18530,18605,18430,18600,18340,18485,18455,-120,-150,30900,"285,189.27",19166
,20171212,18485,18455,18510,19100,18510,19060,18825,605,370,40128,"377,794.41",22276
,20171213,19060,18825,19150,19235,18960,19225,19095,400,270,35052,"334,715.99",26198
,20171214,19225,19095,19190,19215,18970,19050,19105,-45,10,28432,"271,609.81",27040
,20171215,19050,19105,18905,19040,18865,18985,18955,-120,-150,25676,"243,354.64",28492
,20171218,18985,18955,18990,19430,18950,19295,19190,340,235,46154,"442,939.95",31538
,20171219,19295,19190,19420,19520,19170,19235,19350,45,160,45822,"443,415.65",36224
,20171220,19235,19350,19225,19440,19180,19335,19305,-15,-45,40670,"392,631.67",40766
,20171221,19335,19305,19295,19350,18850,19170,19165,-135,-140,71234,"682,604.19",39350
,20171222,19170,19165,19125,19250,18955,19235,19065,70,-100,52008,"495,815.16",41314
,20171225,19235,19065,19175,19280,19020,19125,19155,60,90,52386,"501,809.11",41690
,20171226,19125,19155,19170,19170,18890,19000,19030,-155,-125,39720,"377,952.45",41148
,20171227,19000,19030,19095,19110,18910,19040,19015,10,-15,42186,"401,132.70",40832
,20171228,19040,19015,19170,19330,19085,19250,19220,235,205,56130,"539,524.88",43754
,20171229,19250,19220,19200,19240,19100,19170,19160,-50,-60,45266,"433,681.25",40306
pb1803,20170316,18535,18535,,,,18575,18575,40,40,0,0.00,0
,20170317,18575,18575,,,,18565,18565,-10,-10,0,0.00,0
,20170320,18565,18565,18820,18820,18460,18460,18700,-105,135,6,56.10,2
,20170321,18460,18700,,,,18700,18700,0,0,0,0.00,2
,20170322,18700,18700,,,,18275,18275,-425,-425,0,0.00,2
,20170323,18275,18275,18695,18975,18445,18715,18735,440,460,10,93.68,8
,20170324,18715,18735,18675,18675,18135,18530,18450,-205,-285,18,166.08,8
,20170327,18530,18450,18485,18485,18200,18200,18340,-250,-110,4,36.69,10
,20170328,18200,18340,17725,17725,17525,17545,17565,-795,-775,10,87.85,18
,20170329,17545,17565,17655,17860,17550,17765,17655,200,90,24,211.92,36
,20170330,17765,17655,17685,17825,17685,17825,17765,170,110,6,53.31,36
,20170331,17825,17765,,,,17865,17865,100,100,0,0.00,36
,20170405,17865,17865,17800,17800,17795,17795,17795,-70,-70,4,35.60,40
,20170406,17795,17795,17990,17990,17935,17935,17960,140,165,4,35.93,44
,20170407,17935,17960,17735,17735,17730,17730,17730,-230,-230,4,35.47,44
,20170410,17730,17730,16660,16980,16660,16825,16830,-905,-900,8,67.33,46
,20170411,16825,16830,16835,16835,16835,16835,16835,5,5,2,16.84,48
,20170412,16835,16835,16920,16920,16550,16805,16700,-30,-135,20,167.01,62
,20170413,16805,16700,,,,16890,16890,190,190,0,0.00,62
,20170414,16890,16890,17065,17115,16845,16850,16965,-40,75,12,101.79,66
,20170417,16850,16965,17290,17290,17230,17230,17270,265,305,6,51.81,64
,20170418,17230,17270,17185,17185,16865,16865,17040,-405,-230,6,51.13,62
,20170419,16865,17040,16445,16450,16050,16130,16245,-910,-795,42,341.18,72
,20170420,16130,16245,16395,16415,16280,16320,16355,75,110,24,196.28,74
,20170421,16320,16355,16420,16455,16410,16410,16425,55,70,14,115.00,64
,20170424,16410,16425,16085,16085,16085,16085,16085,-340,-340,4,32.17,66
,20170425,16085,16085,16145,16145,16145,16145,16145,60,60,4,32.29,70
,20170426,16145,16145,16440,16505,16425,16470,16455,325,310,22,181.01,60
,20170427,16470,16455,16460,16475,16440,16440,16455,-15,0,12,98.76,66
,20170428,16440,16455,16540,16570,16540,16570,16550,115,95,6,49.65,72
,20170502,16570,16550,16965,16970,16965,16970,16965,420,415,4,33.94,72
,20170503,16970,16965,,,,16845,16845,-120,-120,0,0.00,72
,20170504,16845,16845,16300,16300,16300,16300,16300,-545,-545,2,16.30,72
,20170505,16300,16300,16390,16390,16390,16390,16390,90,90,2,16.39,72
,20170508,16390,16390,16340,16390,16340,16390,16365,0,-25,4,32.73,72
,20170509,16390,16365,,,,16365,16365,0,0,0,0.00,72
,20170510,16365,16365,16465,16465,16465,16465,16465,100,100,2,16.47,70
,20170511,16465,16465,16425,16425,16425,16425,16425,-40,-40,2,16.43,70
,20170512,16425,16425,16305,16305,16275,16275,16290,-150,-135,4,32.58,70
,20170515,16275,16290,16205,16205,16200,16200,16200,-90,-90,4,32.41,66
,20170516,16200,16200,16025,16025,16025,16025,16025,-175,-175,2,16.03,66
,20170517,16025,16025,15980,15980,15980,15980,15980,-45,-45,2,15.98,64
,20170518,15980,15980,,,,15980,15980,0,0,0,0.00,64
,20170519,15980,15980,,,,15980,15980,0,0,0,0.00,64
,20170522,15980,15980,,,,16230,16230,250,250,0,0.00,64
,20170523,16230,16230,16040,16040,16040,16040,16040,-190,-190,2,16.04,62
,20170524,16040,16040,,,,16040,16040,0,0,0,0.00,62
,20170525,16040,16040,15990,16175,15975,15975,15985,-65,-55,48,383.65,102
,20170526,15975,15985,16125,16125,16125,16125,16125,140,140,2,16.13,104
,20170531,16125,16125,,,,16125,16125,0,0,0,0.00,104
,20170601,16125,16125,,,,16220,16220,95,95,0,0.00,104
,20170602,16220,16220,16205,16330,16205,16330,16290,110,70,10,81.46,104
,20170605,16330,16290,16635,16635,16600,16600,16615,310,325,4,33.24,104
,20170606,16600,16615,16615,16720,16615,16720,16665,105,50,6,50.00,104
,20170607,16720,16665,,,,16665,16665,0,0,0,0.00,104
,20170608,16665,16665,16550,16800,16550,16800,16665,135,0,10,83.33,104
,20170609,16800,16665,16755,16950,16670,16950,16785,285,120,38,318.93,106
,20170612,16950,16785,16950,16950,16950,16950,16950,165,165,4,33.90,106
,20170613,16950,16950,16850,16850,16805,16830,16825,-120,-125,6,50.49,106
,20170614,16830,16825,,,,16810,16810,-15,-15,0,0.00,106
,20170615,16810,16810,16575,16575,16575,16575,16575,-235,-235,2,16.58,108
,20170616,16575,16575,16560,16805,16560,16800,16740,225,165,8,66.97,110
,20170619,16800,16740,16700,16750,16675,16750,16715,10,-25,10,83.59,108
,20170620,16750,16715,17275,17275,17265,17265,17265,550,550,22,189.97,122
,20170621,17265,17265,17015,17015,16990,16990,16995,-275,-270,6,51.00,126
,20170622,16990,16995,,,,16995,16995,0,0,0,0.00,126
,20170623,16995,16995,,,,16995,16995,0,0,0,0.00,126
,20170626,16995,16995,,,,16995,16995,0,0,0,0.00,126
,20170627,16995,16995,17075,17110,17075,17110,17095,115,100,6,51.30,126
,20170628,17110,17095,17340,17495,17340,17385,17385,290,290,10,86.93,126
,20170629,17385,17385,,,,17385,17385,0,0,0,0.00,126
,20170630,17385,17385,17350,17350,17080,17080,17215,-305,-170,4,34.43,128
,20170703,17080,17215,17355,17355,17355,17355,17355,140,140,4,34.71,128
,20170704,17355,17355,,,,17355,17355,0,0,0,0.00,128
,20170705,17355,17355,17315,17315,16980,16985,17180,-370,-175,10,85.91,122
,20170706,16985,17180,16950,16985,16595,16970,16845,-210,-335,22,185.34,114
,20170707,16970,16845,,,,17250,17250,405,405,0,0.00,114
,20170710,17250,17250,17300,17300,17300,17300,17300,50,50,4,34.60,116
,20170711,17300,17300,17260,17260,17260,17260,17260,-40,-40,2,17.26,116
,20170712,17260,17260,17535,17535,17535,17535,17535,275,275,2,17.54,116
,20170713,17535,17535,,,,17535,17535,0,0,0,0.00,116
,20170714,17535,17535,17495,17495,17215,17215,17320,-320,-215,10,86.60,112
,20170717,17215,17320,17310,17540,17310,17540,17445,220,125,26,226.85,108
,20170718,17540,17445,17625,17625,17430,17470,17510,25,65,14,122.57,106
,20170719,17470,17510,17410,17410,17315,17375,17350,-135,-160,14,121.48,108
,20170720,17375,17350,17450,17450,17450,17450,17450,100,100,2,17.45,110
,20170721,17450,17450,17425,17425,17425,17425,17425,-25,-25,2,17.43,110
,20170724,17425,17425,17570,17570,17570,17570,17570,145,145,4,35.14,106
,20170725,17570,17570,,,,17570,17570,0,0,0,0.00,106
,20170726,17570,17570,17985,18015,17985,18015,18000,445,430,4,36.00,102
,20170727,18015,18000,17750,17980,17750,17930,17920,-70,-80,16,143.37,104
,20170728,17930,17920,17980,17980,17965,17965,17970,45,50,18,161.77,110
,20170731,17965,17970,,,,17970,17970,0,0,0,0.00,110
,20170801,17970,17970,18125,18125,18110,18120,18115,150,145,6,54.36,110
,20170802,18120,18115,18005,18035,18005,18035,18020,-80,-95,4,36.04,108
,20170803,18035,18020,,,,18350,18350,330,330,0,0.00,108
,20170804,18350,18350,18400,18440,18400,18440,18420,90,70,4,36.84,108
,20170807,18440,18420,,,,18680,18680,260,260,0,0.00,108
,20170808,18680,18680,,,,19050,19050,370,370,0,0.00,108
,20170809,19050,19050,19200,19240,19185,19240,19205,190,155,12,115.24,118
,20170810,19240,19205,19310,19310,19010,19160,19145,-45,-60,12,114.88,118
,20170811,19160,19145,19055,19055,18720,18720,18895,-425,-250,18,170.08,126
,20170814,18720,18895,18970,18970,18970,18970,18970,75,75,2,18.97,126
,20170815,18970,18970,19000,19000,18975,18975,18990,5,20,6,56.98,122
,20170816,18975,18990,19185,19185,19185,19185,19185,195,195,2,19.19,120
,20170817,19185,19185,19310,20080,19310,20080,19750,895,565,12,118.51,120
,20170818,20080,19750,19680,19680,19340,19530,19510,-220,-240,8,78.05,118
,20170821,19530,19510,19660,19760,19215,19235,19545,-275,35,18,175.92,128
,20170822,19235,19545,19225,19260,18900,19030,19100,-515,-445,8,76.42,130
,20170823,19030,19100,19215,19565,19215,19565,19345,465,245,12,116.09,128
,20170824,19565,19345,19325,19395,19165,19165,19305,-180,-40,16,154.48,138
,20170825,19165,19305,19000,19130,19000,19010,19045,-295,-260,10,95.24,130
,20170828,19010,19045,18890,18890,18690,18690,18790,-355,-255,6,56.38,132
,20170829,18690,18790,,,,18790,18790,0,0,0,0.00,132
,20170830,18790,18790,18990,19060,18850,19060,18965,270,175,12,113.81,132
,20170831,19060,18965,18965,18965,18965,18965,18965,0,0,6,56.90,126
,20170901,18965,18965,19095,19095,19015,19015,19055,50,90,10,95.29,126
,20170904,19015,19055,19240,19315,19240,19315,19285,260,230,8,77.16,122
,20170905,19315,19285,19015,19015,18960,18960,18975,-325,-310,8,75.90,124
,20170906,18960,18975,18500,18640,18500,18620,18595,-355,-380,8,74.38,122
,20170907,18620,18595,18535,18535,18210,18210,18350,-385,-245,12,110.12,124
,20170908,18210,18350,18275,18275,17950,17950,18205,-400,-145,10,91.04,124
,20170911,17950,18205,17700,17700,17700,17700,17700,-505,-505,2,17.70,126
,20170912,17700,17700,,,,17775,17775,75,75,0,0.00,126
,20170913,17775,17775,17965,17965,17965,17965,17965,190,190,2,17.97,128
,20170914,17965,17965,18200,18200,18195,18200,18195,235,230,8,72.80,130
,20170915,18200,18195,18560,18560,18515,18515,18530,320,335,6,55.59,124
,20170918,18515,18530,18120,18120,18120,18120,18120,-410,-410,2,18.12,126
,20170919,18120,18120,18640,18640,18640,18640,18640,520,520,2,18.64,126
,20170920,18640,18640,18895,18895,18895,18895,18895,255,255,2,18.90,126
,20170921,18895,18895,19335,19635,19335,19635,19485,740,590,4,38.97,128
,20170922,19635,19485,19065,19065,18900,18900,18980,-585,-505,4,37.97,128
,20170925,18900,18980,19300,19395,19100,19395,19220,415,240,8,76.90,130
,20170926,19395,19220,19500,19500,19500,19500,19500,280,280,2,19.50,128
,20170927,19500,19500,19605,19745,19600,19680,19665,180,165,64,629.35,148
,20170928,19680,19665,19660,19665,19600,19630,19630,-35,-35,58,569.37,160
,20170929,19630,19630,19630,19900,19630,19870,19765,240,135,72,711.59,220
,20171009,19870,19765,20205,20205,20030,20140,20130,375,365,10,100.66,216
,20171010,20140,20130,19590,19735,19590,19735,19660,-395,-470,4,39.33,218
,20171011,19735,19660,19845,19880,19840,19840,19855,180,195,16,158.85,212
,20171012,19840,19855,19760,19950,19760,19950,19795,95,-60,12,118.80,214
,20171013,19950,19795,20010,20010,19915,19915,19960,120,165,4,39.93,212
,20171016,19915,19960,19975,20055,19965,19965,20005,5,45,10,100.04,210
,20171017,19965,20005,20200,20255,19910,19910,20145,-95,140,16,161.17,210
,20171018,19910,20145,19855,19855,19350,19350,19595,-795,-550,10,97.98,210
,20171019,19350,19595,19130,19130,19130,19130,19130,-465,-465,2,19.13,210
,20171020,19130,19130,18825,19310,18825,19160,19070,30,-60,10,95.35,214
,20171023,19160,19070,,,,19090,19090,20,20,0,0.00,214
,20171024,19090,19090,19340,19395,19250,19250,19335,160,245,12,116.03,214
,20171025,19250,19335,19145,19145,19080,19080,19105,-255,-230,16,152.86,218
,20171026,19080,19105,19095,19265,19035,19035,19130,-70,25,6,57.40,214
,20171027,19035,19130,19015,19015,18550,18600,18875,-530,-255,22,207.64,208
,20171030,18600,18875,18590,18590,18290,18290,18425,-585,-450,26,239.58,212
,20171031,18290,18425,18345,18640,18220,18640,18340,215,-85,10,91.72,210
,20171101,18640,18340,18550,18910,18550,18855,18805,515,465,8,75.22,214
,20171102,18855,18805,18830,18830,18600,18760,18690,-45,-115,10,93.47,214
,20171103,18760,18690,18770,18770,18575,18575,18670,-115,-20,4,37.35,214
,20171106,18575,18670,18700,18700,18680,18700,18690,30,20,6,56.08,218
,20171107,18700,18690,19075,19075,19010,19010,19045,320,355,14,133.34,216
,20171108,19010,19045,18910,18910,18755,18755,18830,-290,-215,4,37.67,216
,20171109,18755,18830,18880,18985,18815,18820,18940,-10,110,24,227.33,232
,20171110,18820,18940,19060,19340,19005,19340,19315,400,375,146,"1,410.18",334
,20171113,19340,19315,19435,19435,19340,19340,19385,25,70,4,38.78,332
,20171114,19340,19385,19120,19275,19120,19195,19210,-190,-175,8,76.85,326
,20171115,19195,19210,19130,19130,18685,18685,18920,-525,-290,30,283.84,312
,20171116,18685,18920,19250,19250,18420,18420,18580,-500,-340,56,520.28,332
,20171117,18420,18580,18520,18585,18345,18415,18480,-165,-100,34,314.16,334
,20171120,18415,18480,18395,18645,18350,18620,18550,140,70,60,556.62,346
,20171121,18620,18550,18505,18695,18505,18675,18655,125,105,132,"1,231.50",374
,20171122,18675,18655,18725,18985,18725,18985,18825,330,170,130,"1,223.71",352
,20171123,18985,18825,18875,18905,18495,18495,18690,-330,-135,118,"1,102.85",376
,20171124,18495,18690,18415,18640,18335,18540,18500,-150,-190,80,740.18,378
,20171127,18540,18500,18715,18715,18355,18385,18625,-115,125,106,987.27,434
,20171128,18385,18625,18410,18530,18215,18385,18370,-240,-255,380,"3,490.86",574
,20171129,18385,18370,18395,18430,18180,18295,18305,-75,-65,216,"1,977.47",676
,20171130,18295,18305,18300,18390,18215,18370,18285,65,-20,1510,"13,805.50",1720
,20171201,18370,18285,18370,18735,18370,18730,18550,445,265,744,"6,901.57",2128
,20171204,18730,18550,18815,19270,18755,18930,18965,380,415,1294,"12,270.63",2532
,20171205,18930,18965,19015,19175,18870,18880,19010,-85,45,1606,"15,266.51",2932
,20171206,18880,19010,18820,18955,18500,18750,18705,-260,-305,1050,"9,821.40",3240
,20171207,18750,18705,18780,18870,18565,18650,18755,-55,50,1640,"15,382.03",3694
,20171208,18650,18755,18740,18805,18390,18540,18600,-215,-155,1874,"17,432.60",4230
,20171211,18540,18600,18395,18610,18355,18460,18470,-140,-130,2036,"18,802.70",4832
,20171212,18460,18470,18580,19000,18550,18995,18775,525,305,3572,"33,535.36",6478
,20171213,18995,18775,19055,19135,18890,19120,19010,345,235,2698,"25,647.50",7290
,20171214,19120,19010,19095,19140,18925,19000,19050,-10,40,1982,"18,881.98",7698
,20171215,19000,19050,18900,18990,18825,18950,18925,-100,-125,1222,"11,565.50",7712
,20171218,18950,18925,18960,19375,18940,19240,19170,315,245,1602,"15,358.32",7896
,20171219,19240,19170,19320,19440,19125,19160,19300,-10,130,3290,"31,752.48",9150
,20171220,19160,19300,19200,19385,19130,19275,19240,-25,-60,3622,"34,851.72",10172
,20171221,19275,19240,19240,19295,18800,19095,19090,-145,-150,6534,"62,377.39",10886
,20171222,19095,19090,19055,19145,18895,19085,18980,-5,-110,2744,"26,047.07",11342
,20171225,19085,18980,19070,19195,18955,19060,19070,80,90,7748,"73,888.17",13066
,20171226,19060,19070,19090,19100,18825,18965,18965,-105,-105,4690,"44,475.43",13478
,20171227,18965,18965,19030,19030,18845,18990,18950,25,-15,4786,"45,352.70",14000
,20171228,18990,18950,19100,19275,19010,19210,19165,260,215,6752,"64,705.54",14392
,20171229,19210,19165,19185,19205,19075,19125,19135,-40,-30,6110,"58,461.23",14238
pb1804,20170418,17270,17270,,,,17270,17270,0,0,0,0.00,0
,20170419,17270,17270,16525,16525,16105,16105,16315,-1165,-955,4,32.63,2
,20170420,16105,16315,,,,16425,16425,110,110,0,0.00,2
,20170421,16425,16425,,,,16495,16495,70,70,0,0.00,2
,20170424,16495,16495,,,,16495,16495,0,0,0,0.00,2
,20170425,16495,16495,16175,16175,16175,16175,16175,-320,-320,2,16.18,4
,20170426,16175,16175,16280,16450,16280,16450,16365,275,190,4,32.73,6
,20170427,16450,16365,,,,16365,16365,0,0,0,0.00,6
,20170428,16365,16365,16565,16565,16565,16565,16565,200,200,2,16.57,8
,20170502,16565,16565,,,,16565,16565,0,0,0,0.00,8
,20170503,16565,16565,,,,16565,16565,0,0,0,0.00,8
,20170504,16565,16565,,,,16565,16565,0,0,0,0.00,8
,20170505,16565,16565,16430,16430,16430,16430,16430,-135,-135,2,16.43,10
,20170508,16430,16430,,,,16430,16430,0,0,0,0.00,10
,20170509,16430,16430,,,,16430,16430,0,0,0,0.00,10
,20170510,16430,16430,,,,16430,16430,0,0,0,0.00,10
,20170511,16430,16430,,,,16430,16430,0,0,0,0.00,10
,20170512,16430,16430,16210,16210,16210,16210,16210,-220,-220,2,16.21,10
,20170515,16210,16210,16120,16210,16120,16210,16165,0,-45,4,32.33,10
,20170516,16210,16165,,,,16165,16165,0,0,0,0.00,10
,20170517,16165,16165,,,,16165,16165,0,0,0,0.00,10
,20170518,16165,16165,,,,16040,16040,-125,-125,0,0.00,10
,20170519,16040,16040,,,,16005,16005,-35,-35,0,0.00,10
,20170522,16005,16005,,,,16005,16005,0,0,0,0.00,10
,20170523,16005,16005,16125,16125,16125,16125,16125,120,120,2,16.13,8
,20170524,16125,16125,,,,16125,16125,0,0,0,0.00,8
,20170525,16125,16125,16070,16070,15985,15985,16010,-140,-115,8,64.04,14
,20170526,15985,16010,16120,16125,16120,16125,16120,115,110,6,48.37,20
,20170531,16125,16120,,,,16120,16120,0,0,0,0.00,20
,20170601,16120,16120,,,,16150,16150,30,30,0,0.00,20
,20170602,16150,16150,16240,16335,16240,16335,16290,185,140,8,65.18,28
,20170605,16335,16290,16520,16520,16520,16520,16520,230,230,2,16.52,28
,20170606,16520,16520,16585,16680,16585,16680,16630,160,110,6,49.90,26
,20170607,16680,16630,,,,16630,16630,0,0,0,0.00,26
,20170608,16630,16630,16645,16645,16645,16645,16645,15,15,2,16.65,28
,20170609,16645,16645,16785,16865,16785,16865,16835,220,190,6,50.51,30
,20170612,16865,16835,16965,17085,16955,17080,17020,245,185,8,68.09,32
,20170613,17080,17020,16905,16905,16780,16780,16850,-240,-170,8,67.41,38
,20170614,16780,16850,16515,16515,16515,16515,16515,-335,-335,2,16.52,40
,20170615,16515,16515,,,,16515,16515,0,0,0,0.00,40
,20170616,16515,16515,16600,16650,16600,16640,16625,125,110,18,149.64,46
,20170619,16640,16625,16695,16895,16695,16895,16795,270,170,4,33.59,46
,20170620,16895,16795,17270,17270,17270,17270,17270,475,475,2,17.27,46
,20170621,17270,17270,16890,16890,16890,16890,16890,-380,-380,2,16.89,46
,20170622,16890,16890,,,,16890,16890,0,0,0,0.00,46
,20170623,16890,16890,,,,16890,16890,0,0,0,0.00,46
,20170626,16890,16890,16815,16925,16815,16925,16875,35,-15,8,67.51,50
,20170627,16925,16875,16925,16925,16925,16925,16925,50,50,2,16.93,50
,20170628,16925,16925,17365,17470,17365,17470,17410,545,485,6,52.24,48
,20170629,17470,17410,,,,17410,17410,0,0,0,0.00,48
,20170630,17410,17410,17360,17395,17360,17395,17365,-15,-45,12,104.20,52
,20170703,17395,17365,17375,17425,17000,17425,17265,60,-100,12,103.60,60
,20170704,17425,17265,,,,17265,17265,0,0,0,0.00,60
,20170705,17265,17265,17005,17005,17000,17000,17000,-265,-265,18,153.04,68
,20170706,17000,17000,16965,16965,16965,16965,16965,-35,-35,2,16.97,66
,20170707,16965,16965,17240,17240,17240,17240,17240,275,275,2,17.24,66
,20170710,17240,17240,,,,17285,17285,45,45,0,0.00,66
,20170711,17285,17285,17265,17290,17265,17290,17275,5,-10,16,138.21,50
,20170712,17290,17275,17510,17510,17510,17510,17510,235,235,2,17.51,52
,20170713,17510,17510,,,,17465,17465,-45,-45,0,0.00,52
,20170714,17465,17465,17465,17465,17200,17230,17270,-235,-195,10,86.35,52
,20170717,17230,17270,17335,17435,17335,17430,17405,160,135,18,156.65,50
,20170718,17430,17405,17605,17605,17440,17440,17495,35,90,8,70.00,58
,20170719,17440,17495,17350,17440,17345,17345,17390,-150,-105,12,104.35,62
,20170720,17345,17390,17210,17210,17210,17210,17210,-180,-180,2,17.21,62
,20170721,17210,17210,,,,17185,17185,-25,-25,0,0.00,62
,20170724,17185,17185,17515,17555,17510,17555,17525,370,340,6,52.58,64
,20170725,17555,17525,17465,17585,17465,17540,17510,15,-15,10,87.57,66
,20170726,17540,17510,17705,17705,17705,17705,17705,195,195,2,17.71,66
,20170727,17705,17705,17895,18070,17895,17945,17975,240,270,16,143.82,72
,20170728,17945,17975,18005,18005,17945,17945,17965,-30,-10,18,161.73,60
,20170731,17945,17965,17930,17930,17930,17930,17930,-35,-35,2,17.93,62
,20170801,17930,17930,,,,17930,17930,0,0,0,0.00,62
,20170802,17930,17930,,,,17930,17930,0,0,0,0.00,62
,20170803,17930,17930,18395,18475,18325,18325,18410,395,480,8,73.65,66
,20170804,18325,18410,,,,18410,18410,0,0,0,0.00,66
,20170807,18410,18410,18410,18795,18320,18745,18500,335,90,12,111.00,70
,20170808,18745,18500,,,,18505,18505,5,5,0,0.00,70
,20170809,18505,18505,19180,19215,19180,19215,19190,710,685,6,57.58,72
,20170810,19215,19190,19105,19105,19105,19105,19105,-85,-85,4,38.21,76
,20170811,19105,19105,18985,18985,18865,18865,18955,-240,-150,12,113.75,72
,20170814,18865,18955,18725,18725,18725,18725,18725,-230,-230,2,18.73,72
,20170815,18725,18725,18985,18985,18985,18985,18985,260,260,2,18.99,72
,20170816,18985,18985,18970,19065,18970,19065,19030,80,45,10,95.16,76
,20170817,19065,19030,19585,19950,19585,19830,19780,800,750,14,138.49,84
,20170818,19830,19780,19465,19465,19265,19265,19365,-515,-415,4,38.73,82
,20170821,19265,19365,19595,19595,19280,19425,19375,60,10,28,271.25,96
,20170822,19425,19375,19340,19340,18900,18950,19100,-425,-275,34,324.78,104
,20170823,18950,19100,19320,19580,19320,19435,19430,335,330,34,330.35,88
,20170824,19435,19430,19270,19270,19105,19105,19185,-325,-245,4,38.38,92
,20170825,19105,19185,19010,19010,19010,19010,19010,-175,-175,2,19.01,90
,20170828,19010,19010,18535,18535,18535,18535,18535,-475,-475,2,18.54,88
,20170829,18535,18535,,,,18535,18535,0,0,0,0.00,88
,20170830,18535,18535,,,,18710,18710,175,175,0,0.00,88
,20170831,18710,18710,18950,18950,18950,18950,18950,240,240,2,18.95,86
,20170901,18950,18950,19100,19100,19100,19100,19100,150,150,6,57.30,80
,20170904,19100,19100,19170,19400,19135,19240,19260,140,160,24,231.14,86
,20170905,19240,19260,19025,19025,19025,19025,19025,-235,-235,2,19.03,88
,20170906,19025,19025,18785,18835,18555,18620,18685,-405,-340,24,224.23,92
,20170907,18620,18685,18555,18555,18300,18300,18485,-385,-200,14,129.42,96
,20170908,18300,18485,,,,17880,17880,-605,-605,0,0.00,96
,20170911,17880,17880,17700,17700,17595,17595,17645,-285,-235,4,35.30,100
,20170912,17595,17645,,,,17645,17645,0,0,0,0.00,100
,20170913,17645,17645,17700,17700,17700,17700,17700,55,55,2,17.70,100
,20170914,17700,17700,,,,17820,17820,120,120,0,0.00,100
,20170915,17820,17820,,,,17955,17955,135,135,0,0.00,100
,20170918,17955,17955,18425,18695,18425,18695,18560,740,605,4,37.12,100
,20170919,18695,18560,18535,18535,18535,18535,18535,-25,-25,2,18.54,102
,20170920,18535,18535,18545,18570,18545,18570,18560,35,25,8,74.26,100
,20170921,18570,18560,19495,19495,18925,18925,19210,365,650,4,38.42,98
,20170922,18925,19210,19200,19200,18500,18600,18740,-610,-470,8,74.97,98
,20170925,18600,18740,18985,18985,18985,18985,18985,245,245,2,18.99,96
,20170926,18985,18985,19385,19385,19380,19380,19380,395,395,4,38.77,94
,20170927,19380,19380,19065,19275,19065,19275,19115,-105,-265,8,76.47,88
,20170928,19275,19115,19060,19465,19060,19465,19240,350,125,16,153.96,78
,20170929,19465,19240,19565,19750,19565,19750,19685,510,445,12,118.12,74
,20171009,19750,19685,,,,19685,19685,0,0,0,0.00,74
,20171010,19685,19685,19555,19555,19555,19555,19555,-130,-130,2,19.56,76
,20171011,19555,19555,19555,19775,19550,19700,19670,145,115,32,314.74,90
,20171012,19700,19670,19555,19830,19550,19830,19615,160,-55,24,235.42,106
,20171013,19830,19615,19875,20250,19875,20100,19955,485,340,38,379.20,124
,20171016,20100,19955,,,,19955,19955,0,0,0,0.00,124
,20171017,19955,19955,20080,20080,19955,19955,20015,0,60,4,40.04,124
,20171018,19955,20015,19300,19300,19300,19300,19300,-715,-715,4,38.60,124
,20171019,19300,19300,19195,19350,19080,19080,19170,-220,-130,18,172.53,124
,20171020,19080,19170,18830,19220,18830,19220,19025,50,-145,4,38.05,126
,20171023,19220,19025,,,,19025,19025,0,0,0,0.00,126
,20171024,19025,19025,,,,19025,19025,0,0,0,0.00,126
,20171025,19025,19025,19105,19105,19030,19030,19065,5,40,4,38.14,128
,20171026,19030,19065,19105,19105,19105,19105,19105,40,40,2,19.11,126
,20171027,19105,19105,19000,19000,18570,18615,18650,-490,-455,20,186.53,128
,20171030,18615,18650,,,,18205,18205,-445,-445,0,0.00,128
,20171031,18205,18205,18270,18660,18270,18660,18425,455,220,6,55.28,130
,20171101,18660,18425,18525,18905,18525,18860,18795,435,370,8,75.20,130
,20171102,18860,18795,18765,18850,18710,18760,18760,-35,-35,10,93.80,126
,20171103,18760,18760,,,,18760,18760,0,0,0,0.00,126
,20171106,18760,18760,18715,18800,18715,18800,18755,40,-5,4,37.52,128
,20171107,18800,18755,19110,19110,18955,18955,19030,200,275,4,38.07,128
,20171108,18955,19030,18980,18980,18905,18940,18940,-90,-90,6,56.83,126
,20171109,18940,18940,,,,18940,18940,0,0,0,0.00,126
,20171110,18940,18940,19100,19370,19100,19325,19220,385,280,8,76.90,126
,20171113,19325,19220,19320,19400,19320,19400,19385,180,165,14,135.72,122
,20171114,19400,19385,19190,19320,19190,19320,19260,-65,-125,8,77.06,124
,20171115,19320,19260,18670,18685,18670,18670,18675,-590,-585,6,56.03,122
,20171116,18670,18675,18590,18625,18495,18495,18570,-180,-105,6,55.71,120
,20171117,18495,18570,18370,18370,18370,18370,18370,-200,-200,2,18.37,118
,20171120,18370,18370,18700,18700,18670,18670,18685,300,315,4,37.37,118
,20171121,18670,18685,18525,18565,18520,18565,18525,-120,-160,16,148.22,124
,20171122,18565,18525,,,,18695,18695,170,170,0,0.00,124
,20171123,18695,18695,18780,18780,18505,18505,18730,-190,35,28,262.23,148
,20171124,18505,18730,18435,18435,18435,18435,18435,-295,-295,2,18.44,146
,20171127,18435,18435,18575,18575,18375,18410,18435,-25,0,10,92.18,146
,20171128,18410,18435,18450,18450,18345,18365,18385,-70,-50,10,91.94,148
,20171129,18365,18385,,,,18385,18385,0,0,0,0.00,148
,20171130,18385,18385,18265,18385,18265,18295,18335,-90,-50,18,165.03,150
,20171201,18295,18335,18610,18615,18515,18575,18570,240,235,14,130.02,150
,20171204,18575,18570,18815,19220,18750,19000,19135,430,565,68,650.60,170
,20171205,19000,19135,19090,19090,18920,18920,18965,-215,-170,34,322.41,180
,20171206,18920,18965,18770,18770,18565,18675,18655,-290,-310,46,429.12,172
,20171207,18675,18655,18820,18860,18770,18770,18825,115,170,12,112.96,172
,20171208,18770,18825,18875,18875,18520,18630,18785,-195,-40,18,169.07,172
,20171211,18630,18785,18565,18600,18430,18430,18530,-355,-255,30,278.00,174
,20171212,18430,18530,18930,18930,18605,18865,18765,335,235,42,394.11,180
,20171213,18865,18765,18970,19030,18950,18950,18970,185,205,58,550.21,196
,20171214,18950,18970,19070,19085,18920,18920,19020,-50,50,18,171.20,200
,20171215,18920,19020,18850,19030,18820,18900,18960,-120,-60,148,"1,403.39",296
,20171218,18900,18960,19010,19360,19010,19130,19195,170,235,22,211.15,282
,20171219,19130,19195,19270,19305,19160,19160,19275,-35,80,26,250.59,286
,20171220,19160,19275,19160,19245,19145,19220,19200,-55,-75,106,"1,017.76",290
,20171221,19220,19200,19205,19205,18925,19040,19020,-160,-180,228,"2,168.56",348
,20171222,19040,19020,18900,19010,18900,18925,18940,-95,-80,56,530.46,386
,20171225,18925,18940,18860,19125,18860,18980,18985,40,45,168,"1,594.97",458
,20171226,18980,18985,19005,19050,18835,18970,18925,-15,-60,34,321.79,466
,20171227,18970,18925,18965,19040,18860,18970,18925,45,0,116,"1,097.82",490
,20171228,18970,18925,19015,19210,19010,19145,19130,220,205,310,"2,965.63",630
,20171229,19145,19130,19100,19160,19070,19125,19125,-5,-5,98,937.25,624
pb1805,20170516,16165,16165,,,,15990,15990,-175,-175,0,0.00,0
,20170517,15990,15990,,,,15990,15990,0,0,0,0.00,0
,20170518,15990,15990,,,,15990,15990,0,0,0,0.00,0
,20170519,15990,15990,15645,15645,15645,15645,15645,-345,-345,2,15.65,2
,20170522,15645,15645,,,,16005,16005,360,360,0,0.00,2
,20170523,16005,16005,,,,16005,16005,0,0,0,0.00,2
,20170524,16005,16005,,,,16005,16005,0,0,0,0.00,2
,20170525,16005,16005,16005,16005,15995,15995,16000,-10,-5,6,48.01,8
,20170526,15995,16000,,,,16000,16000,0,0,0,0.00,8
,20170531,16000,16000,,,,16000,16000,0,0,0,0.00,8
,20170601,16000,16000,,,,16150,16150,150,150,0,0.00,8
,20170602,16150,16150,,,,16150,16150,0,0,0,0.00,8
,20170605,16150,16150,16575,16575,16575,16575,16575,425,425,2,16.58,10
,20170606,16575,16575,16605,16605,16565,16565,16585,-10,10,4,33.17,12
,20170607,16565,16585,,,,16585,16585,0,0,0,0.00,12
,20170608,16585,16585,,,,16585,16585,0,0,0,0.00,12
,20170609,16585,16585,,,,16890,16890,305,305,0,0.00,12
,20170612,16890,16890,17075,17075,17075,17075,17075,185,185,4,34.15,16
,20170613,17075,17075,,,,17075,17075,0,0,0,0.00,16
,20170614,17075,17075,16685,16685,16620,16620,16650,-455,-425,8,66.61,20
,20170615,16620,16650,,,,16650,16650,0,0,0,0.00,20
,20170616,16650,16650,16760,16760,16510,16680,16640,30,-10,10,83.21,26
,20170619,16680,16640,,,,16640,16640,0,0,0,0.00,26
,20170620,16640,16640,,,,16800,16800,160,160,0,0.00,26
,20170621,16800,16800,16900,16900,16900,16900,16900,100,100,6,50.70,26
,20170622,16900,16900,17100,17100,17100,17100,17100,200,200,6,51.30,26
,20170623,17100,17100,16885,16885,16885,16885,16885,-215,-215,2,16.89,28
,20170626,16885,16885,16790,16910,16790,16880,16870,-5,-15,10,84.37,32
,20170627,16880,16870,16895,16895,16895,16895,16895,25,25,2,16.90,32
,20170628,16895,16895,17395,17395,17395,17395,17395,500,500,2,17.40,32
,20170629,17395,17395,17400,17400,17400,17400,17400,5,5,2,17.40,34
,20170630,17400,17400,17395,17395,17270,17270,17330,-130,-70,4,34.67,34
,20170703,17270,17330,,,,17330,17330,0,0,0,0.00,34
,20170704,17330,17330,,,,17245,17245,-85,-85,0,0.00,34
,20170705,17245,17245,,,,17245,17245,0,0,0,0.00,34
,20170706,17245,17245,,,,17245,17245,0,0,0,0.00,34
,20170707,17245,17245,,,,17245,17245,0,0,0,0.00,34
,20170710,17245,17245,,,,17245,17245,0,0,0,0.00,34
,20170711,17245,17245,17270,17465,17220,17465,17335,220,90,10,86.68,30
,20170712,17465,17335,,,,17335,17335,0,0,0,0.00,30
,20170713,17335,17335,,,,17290,17290,-45,-45,0,0.00,30
,20170714,17290,17290,17185,17210,17170,17210,17185,-80,-105,6,51.57,32
,20170717,17210,17185,17335,17340,17335,17340,17335,155,150,6,52.01,30
,20170718,17340,17335,17540,17540,17405,17405,17470,70,135,4,34.95,32
,20170719,17405,17470,17295,17395,17295,17295,17345,-175,-125,16,138.78,40
,20170720,17295,17345,17250,17280,17115,17280,17190,-65,-155,18,154.74,50
,20170721,17280,17190,,,,17165,17165,-25,-25,0,0.00,50
,20170724,17165,17165,17380,17485,17375,17485,17410,320,245,6,52.24,48
,20170725,17485,17410,17495,17500,17495,17500,17495,90,85,4,35.00,50
,20170726,17500,17495,,,,17495,17495,0,0,0,0.00,50
,20170727,17495,17495,17875,18155,17875,17955,18020,460,525,24,216.25,48
,20170728,17955,18020,18030,18030,17890,17890,17950,-130,-70,24,215.41,52
,20170731,17890,17950,17840,17840,17840,17840,17840,-110,-110,4,35.68,52
,20170801,17840,17840,17980,17980,17980,17980,17980,140,140,2,17.98,52
,20170802,17980,17980,17980,18085,17975,18085,18020,105,40,10,90.11,52
,20170803,18085,18020,18270,18270,18200,18200,18235,180,215,4,36.47,48
,20170804,18200,18235,,,,18235,18235,0,0,0,0.00,48
,20170807,18235,18235,18370,18660,18370,18660,18515,425,280,4,37.03,48
,20170808,18660,18515,18840,18840,18840,18840,18840,325,325,2,18.84,46
,20170809,18840,18840,19020,19230,19020,19230,19150,390,310,10,95.77,52
,20170810,19230,19150,19275,19275,19090,19090,19170,-60,20,6,57.52,54
,20170811,19090,19170,19045,19045,19045,19045,19045,-125,-125,2,19.05,56
,20170814,19045,19045,,,,18815,18815,-230,-230,0,0.00,56
,20170815,18815,18815,18980,18980,18980,18980,18980,165,165,2,18.98,58
,20170816,18980,18980,,,,18980,18980,0,0,0,0.00,58
,20170817,18980,18980,19610,20115,19610,20005,19915,1025,935,28,278.84,72
,20170818,20005,19915,19615,19615,19280,19430,19500,-485,-415,16,156.01,74
,20170821,19430,19500,19700,19700,19215,19215,19375,-285,-125,22,213.13,80
,20170822,19215,19375,19320,19325,18800,18875,19055,-500,-320,70,667.01,110
,20170823,18875,19055,19240,19490,19015,19300,19320,245,265,38,367.09,112
,20170824,19300,19320,19300,19300,19010,19010,19155,-310,-165,12,114.93,108
,20170825,19010,19155,18975,19020,18945,19005,18975,-150,-180,10,94.89,112
,20170828,19005,18975,19090,19090,18520,18520,18745,-455,-230,102,956.19,170
,20170829,18520,18745,18460,18750,18460,18605,18620,-140,-125,26,242.07,168
,20170830,18605,18620,18980,19045,18810,19010,18935,390,315,46,435.60,172
,20170831,19010,18935,18910,19005,18855,18945,18930,10,-5,28,265.05,160
,20170901,18945,18930,18880,19005,18880,19005,18965,75,35,16,151.75,160
,20170904,19005,18965,19100,19235,18980,19220,19160,255,195,18,172.46,154
,20170905,19220,19160,19045,19045,18855,18965,18940,-195,-220,10,94.72,152
,20170906,18965,18940,18545,19130,18430,18430,18670,-510,-270,68,634.80,172
,20170907,18430,18670,18370,18370,18050,18190,18195,-480,-475,20,181.98,172
,20170908,18190,18195,18170,18170,17850,17975,17990,-220,-205,10,89.97,166
,20170911,17975,17990,17850,17850,17290,17540,17580,-450,-410,30,263.73,176
,20170912,17540,17580,17640,17915,17595,17805,17750,225,170,24,213.06,188
,20170913,17805,17750,17700,17700,17575,17575,17615,-175,-135,6,52.85,190
,20170914,17575,17615,17800,18135,17800,18135,17965,520,350,4,35.94,190
,20170915,18135,17965,17730,18285,17695,18190,18110,225,145,36,325.99,194
,20170918,18190,18110,18150,18555,18120,18555,18380,445,270,18,165.44,184
,20170919,18555,18380,18520,18670,18520,18570,18605,190,225,8,74.43,186
,20170920,18570,18605,18490,18915,18420,18910,18750,305,145,50,468.86,152
,20170921,18910,18750,19500,19500,18755,18970,18990,220,240,72,683.70,142
,20170922,18970,18990,18875,19055,18320,18655,18710,-335,-280,58,542.69,142
,20170925,18655,18710,18760,18965,18680,18680,18850,-30,140,42,395.89,132
,20170926,18680,18850,18940,19210,18835,19210,19070,360,220,26,247.93,132
,20170927,19210,19070,19050,19495,19020,19305,19230,235,160,116,"1,115.42",134
,20170928,19305,19230,19305,19400,19190,19400,19270,170,40,50,481.81,120
,20170929,19400,19270,19375,19695,19250,19695,19530,425,260,76,742.29,122
,20171009,19695,19530,19655,19990,19655,19785,19810,255,280,42,416.02,120
,20171010,19785,19810,19510,19700,19390,19450,19480,-360,-330,76,740.32,156
,20171011,19450,19480,19450,19700,19400,19620,19570,140,90,132,"1,291.70",224
,20171012,19620,19570,19605,19860,19440,19680,19580,110,10,140,"1,370.88",250
,20171013,19680,19580,19675,19900,19560,19740,19815,160,235,112,"1,109.91",264
,20171016,19740,19815,19620,20520,19620,19820,19880,5,65,132,"1,312.38",266
,20171017,19820,19880,20050,20100,19680,19680,19960,-200,80,52,519.07,270
,20171018,19680,19960,19645,19645,19050,19120,19305,-840,-655,152,"1,467.43",292
,20171019,19120,19305,19145,19490,19020,19150,19265,-155,-40,182,"1,753.22",372
,20171020,19150,19265,18995,19250,18880,19190,19010,-75,-255,182,"1,730.07",412
,20171023,19190,19010,19070,19165,18925,19165,19065,155,55,42,400.45,418
,20171024,19165,19065,19125,19390,19125,19390,19285,325,220,22,212.14,418
,20171025,19390,19285,19120,19150,18960,18960,19080,-325,-205,22,209.92,418
,20171026,18960,19080,19280,19280,18965,18965,19000,-115,-80,46,437.01,460
,20171027,18965,19000,19055,19130,18540,18625,18825,-375,-175,148,"1,393.32",438
,20171030,18625,18825,18630,18650,18340,18340,18510,-485,-315,60,555.32,446
,20171031,18340,18510,18350,18730,18290,18730,18395,220,-115,156,"1,435.17",458
,20171101,18730,18395,18560,19030,18560,18740,18870,345,475,58,547.37,456
,20171102,18740,18870,18695,18890,18600,18835,18785,-35,-85,62,582.37,462
,20171103,18835,18785,18865,18870,18640,18640,18770,-145,-15,34,319.12,472
,20171106,18640,18770,18770,19000,18700,18950,18815,180,45,76,715.04,470
,20171107,18950,18815,19080,19165,18885,18905,19050,90,235,76,723.98,484
,20171108,18905,19050,19095,19095,18785,18810,18925,-240,-125,48,454.25,482
,20171109,18810,18925,18975,19145,18900,18905,18990,-20,65,46,436.87,486
,20171110,18905,18990,19025,19400,19005,19400,19235,410,245,60,577.14,494
,20171113,19400,19235,19415,19440,19275,19350,19375,115,140,82,794.38,498
,20171114,19350,19375,19160,19380,19155,19165,19265,-210,-110,104,"1,001.78",488
,20171115,19165,19265,19185,19185,18660,18745,18805,-520,-460,98,921.57,496
,20171116,18745,18805,18650,18650,18450,18595,18550,-210,-255,108,"1,001.71",508
,20171117,18595,18550,18595,18615,18355,18450,18455,-100,-95,56,516.84,514
,20171120,18450,18455,18400,18730,18400,18655,18640,200,185,102,950.83,536
,20171121,18655,18640,18695,18770,18485,18605,18585,-35,-55,40,371.74,544
,20171122,18605,18585,18745,19040,18745,18980,18875,395,290,96,906.15,542
,20171123,18980,18875,18880,18925,18385,18385,18780,-490,-95,422,"3,963.06",666
,20171124,18385,18780,18365,18700,18365,18625,18535,-155,-245,128,"1,186.50",662
,20171127,18625,18535,18665,18855,18410,18415,18640,-120,105,564,"5,257.08",998
,20171128,18415,18640,18410,18570,18160,18480,18450,-160,-190,424,"3,912.16",1118
,20171129,18480,18450,18450,18490,18210,18360,18335,-90,-115,228,"2,090.50",1126
,20171130,18360,18335,18335,18495,18290,18340,18340,5,5,186,"1,705.73",1102
,20171201,18340,18340,18695,18695,18500,18660,18590,320,250,244,"2,268.34",1082
,20171204,18660,18590,18870,19280,18815,18995,19040,405,450,518,"4,931.42",1192
,20171205,18995,19040,19060,19160,18860,18935,19020,-105,-20,344,"3,272.08",1250
,20171206,18935,19020,19000,19000,18615,18820,18740,-200,-280,590,"5,528.72",1164
,20171207,18820,18740,18870,18905,18615,18700,18810,-40,70,512,"4,815.92",1182
,20171208,18700,18810,18860,18945,18420,18520,18625,-290,-185,702,"6,538.29",1268
,20171211,18520,18625,18360,18645,18360,18485,18480,-140,-145,430,"3,973.65",1300
,20171212,18485,18480,18640,19000,18540,18975,18795,495,315,840,"7,894.69",1470
,20171213,18975,18795,19080,19105,18900,19090,19015,295,220,494,"4,697.01",1550
,20171214,19090,19015,19190,19190,18905,18905,19015,-110,0,392,"3,727.23",1612
,20171215,18905,19015,18870,19035,18805,18980,18940,-35,-75,414,"3,921.02",1644
,20171218,18980,18940,19015,19325,18950,19190,19125,250,185,550,"5,259.58",1696
,20171219,19190,19125,19380,19380,19150,19150,19290,25,165,374,"3,607.71",1726
,20171220,19150,19290,19190,19355,19160,19275,19240,-15,-50,444,"4,271.69",1728
,20171221,19275,19240,19230,19270,18835,19045,19060,-195,-180,412,"3,927.09",1770
,20171222,19045,19060,19000,19090,18880,19090,18950,30,-110,352,"3,335.35",1794
,20171225,19090,18950,19040,19150,18910,19000,19040,50,90,566,"5,388.34",1888
,20171226,19000,19040,19045,19085,18850,18975,18935,-65,-105,326,"3,086.84",1914
,20171227,18975,18935,18980,19010,18855,18980,18955,45,20,208,"1,971.38",1938
,20171228,18980,18955,18995,19250,18995,19185,19095,230,140,880,"8,402.35",2064
,20171229,19185,19095,19085,19195,19085,19180,19150,85,55,678,"6,491.92",2102
pb1806,20170616,16650,16650,16600,16640,16450,16580,16565,-70,-85,24,198.81,16
,20170619,16580,16565,16735,16960,16695,16950,16785,385,220,14,117.53,10
,20170620,16950,16785,16945,16945,16945,16945,16945,160,160,2,16.95,10
,20170621,16945,16945,,,,17045,17045,100,100,0,0.00,10
,20170622,17045,17045,17065,17065,16940,16940,17000,-105,-45,4,34.01,12
,20170623,16940,17000,,,,17000,17000,0,0,0,0.00,12
,20170626,17000,17000,16700,16870,16690,16695,16765,-305,-235,16,134.13,18
,20170627,16695,16765,16740,16740,16740,16740,16740,-25,-25,4,33.48,20
,20170628,16740,16740,17195,17440,17195,17440,17315,700,575,4,34.64,20
,20170629,17440,17315,,,,17315,17315,0,0,0,0.00,20
,20170630,17315,17315,,,,17245,17245,-70,-70,0,0.00,20
,20170703,17245,17245,17405,17405,17405,17405,17405,160,160,4,34.81,24
,20170704,17405,17405,17480,17480,17480,17480,17480,75,75,4,34.96,20
,20170705,17480,17480,17190,17190,16990,16990,17090,-490,-390,4,34.18,22
,20170706,16990,17090,,,,17090,17090,0,0,0,0.00,22
,20170707,17090,17090,17085,17225,17050,17225,17125,135,35,10,85.65,24
,20170710,17225,17125,17140,17140,17140,17140,17140,15,15,2,17.14,22
,20170711,17140,17140,17465,17465,17465,17465,17465,325,325,2,17.47,24
,20170712,17465,17465,17495,17530,17270,17270,17400,-195,-65,10,87.02,28
,20170713,17270,17400,,,,17355,17355,-45,-45,0,0.00,28
,20170714,17355,17355,17270,17295,17270,17295,17280,-60,-75,4,34.57,30
,20170717,17295,17280,17640,17640,17640,17640,17640,360,360,2,17.64,30
,20170718,17640,17640,17460,17635,17460,17635,17575,-5,-65,6,52.73,34
,20170719,17635,17575,17305,17385,17295,17315,17330,-260,-245,16,138.65,44
,20170720,17315,17330,17210,17210,17205,17205,17205,-125,-125,4,34.42,48
,20170721,17205,17205,,,,17180,17180,-25,-25,0,0.00,48
,20170724,17180,17180,17345,17555,17345,17555,17450,375,270,4,34.90,50
,20170725,17555,17450,17490,17490,17490,17490,17490,40,40,6,52.47,56
,20170726,17490,17490,17860,17860,17860,17860,17860,370,370,2,17.86,56
,20170727,17860,17860,17915,17950,17860,17950,17925,90,65,32,286.83,70
,20170728,17950,17925,18015,18015,17750,17750,17935,-175,10,32,286.99,86
,20170731,17750,17935,17900,18100,17900,18100,18000,165,65,4,36.00,84
,20170801,18100,18000,,,,18000,18000,0,0,0,0.00,84
,20170802,18000,18000,17950,18065,17950,18065,17985,65,-15,6,53.97,86
,20170803,18065,17985,18170,18365,18165,18365,18285,380,300,10,91.43,86
,20170804,18365,18285,,,,18285,18285,0,0,0,0.00,86
,20170807,18285,18285,18665,18750,18665,18750,18705,465,420,4,37.42,88
,20170808,18750,18705,18815,18855,18800,18800,18835,95,130,10,94.18,90
,20170809,18800,18835,18715,19175,18715,19145,19015,310,180,14,133.11,102
,20170810,19145,19015,19330,19335,19125,19160,19240,145,225,20,192.45,114
,20170811,19160,19240,19045,19100,18840,18840,18985,-400,-255,50,474.71,130
,20170814,18840,18985,18705,18705,18705,18705,18705,-280,-280,2,18.71,128
,20170815,18705,18705,18850,18970,18850,18970,18905,265,200,6,56.72,132
,20170816,18970,18905,,,,18905,18905,0,0,0,0.00,132
,20170817,18905,18905,19345,19950,19345,19950,19645,1045,740,22,216.15,142
,20170818,19950,19645,19590,19645,19475,19475,19545,-170,-100,16,156.39,134
,20170821,19475,19545,19205,19275,19180,19240,19235,-305,-310,14,134.66,138
,20170822,19240,19235,19210,19210,19210,19210,19210,-25,-25,2,19.21,138
,20170823,19210,19210,19400,19400,19175,19210,19270,0,60,12,115.62,144
,20170824,19210,19270,19275,19275,19230,19230,19250,-40,-20,8,77.01,140
,20170825,19230,19250,18950,19170,18835,19015,19000,-235,-250,16,152.01,138
,20170828,19015,19000,18800,18800,18435,18435,18585,-565,-415,6,55.76,140
,20170829,18435,18585,,,,18585,18585,0,0,0,0.00,140
,20170830,18585,18585,18970,19010,18900,19010,18940,425,355,16,151.55,148
,20170831,19010,18940,18955,18965,18865,18865,18930,-75,-10,12,113.58,138
,20170901,18865,18930,18890,19115,18890,18990,18995,60,65,12,113.98,134
,20170904,18990,18995,19115,19115,19060,19060,19095,65,100,14,133.70,148
,20170905,19060,19095,18925,18925,18770,18780,18830,-315,-265,14,131.84,148
,20170906,18780,18830,18700,18700,18315,18440,18545,-390,-285,20,185.47,140
,20170907,18440,18545,18480,18480,18190,18190,18285,-355,-260,10,91.44,134
,20170908,18190,18285,18200,18200,18200,18200,18200,-85,-85,2,18.20,134
,20170911,18200,18200,17715,17715,17715,17715,17715,-485,-485,2,17.72,136
,20170912,17715,17715,,,,17715,17715,0,0,0,0.00,136
,20170913,17715,17715,17660,17715,17660,17715,17685,0,-30,4,35.38,138
,20170914,17715,17685,,,,17685,17685,0,0,0,0.00,138
,20170915,17685,17685,,,,17685,17685,0,0,0,0.00,138
,20170918,17685,17685,18200,18495,17680,18495,18175,810,490,10,90.89,136
,20170919,18495,18175,18410,18410,18350,18350,18385,175,210,6,55.17,134
,20170920,18350,18385,18575,18775,18575,18720,18690,335,305,6,56.07,136
,20170921,18720,18690,18920,19290,18835,18865,19010,175,320,20,190.14,136
,20170922,18865,19010,18595,18595,18535,18535,18565,-475,-445,4,37.13,138
,20170925,18535,18565,18850,18850,18785,18785,18815,220,250,4,37.64,136
,20170926,18785,18815,18905,18905,18905,18905,18905,90,90,2,18.91,136
,20170927,18905,18905,18800,19230,18800,19230,18980,325,75,6,56.95,134
,20170928,19230,18980,19175,19235,19145,19235,19180,255,200,14,134.27,126
,20170929,19235,19180,19365,19545,19255,19545,19360,365,180,10,96.81,126
,20171009,19545,19360,19680,19680,19650,19650,19660,290,300,6,58.98,124
,20171010,19650,19660,19485,19485,19275,19275,19345,-385,-315,6,58.04,128
,20171011,19275,19345,19440,19495,19405,19495,19455,150,110,10,97.28,132
,20171012,19495,19455,19495,19585,19255,19375,19475,-80,20,26,253.20,142
,20171013,19375,19475,19530,19730,19530,19730,19705,255,230,16,157.64,132
,20171016,19730,19705,19645,19890,19645,19890,19805,185,100,6,59.43,132
,20171017,19890,19805,19920,19920,19740,19740,19830,-65,25,4,39.66,130
,20171018,19740,19830,19450,19560,19005,19175,19155,-655,-675,58,555.51,162
,20171019,19175,19155,19175,19495,19105,19105,19260,-50,105,78,751.18,186
,20171020,19105,19260,18965,19290,18880,19185,19035,-75,-225,50,475.88,208
,20171023,19185,19035,,,,19120,19120,85,85,0,0.00,208
,20171024,19120,19120,19245,19330,19245,19330,19285,210,165,4,38.58,210
,20171025,19330,19285,19120,19120,19085,19085,19100,-200,-185,4,38.21,210
,20171026,19085,19100,,,,19100,19100,0,0,0,0.00,210
,20171027,19100,19100,18805,19055,18805,19055,18945,-45,-155,10,94.73,214
,20171030,19055,18945,18570,18570,18515,18515,18540,-430,-405,4,37.09,212
,20171031,18515,18540,18315,18480,18315,18480,18395,-60,-145,4,36.80,214
,20171101,18480,18395,18610,19035,18610,19035,18820,640,425,4,37.65,212
,20171102,19035,18820,18815,18815,18815,18815,18815,-5,-5,2,18.82,212
,20171103,18815,18815,18855,18855,18675,18675,18765,-140,-50,4,37.53,212
,20171106,18675,18765,18800,18800,18800,18800,18800,35,35,2,18.80,212
,20171107,18800,18800,19085,19085,19085,19085,19085,285,285,2,19.09,212
,20171108,19085,19085,,,,19085,19085,0,0,0,0.00,212
,20171109,19085,19085,,,,19085,19085,0,0,0,0.00,212
,20171110,19085,19085,19395,19395,19380,19380,19385,295,300,4,38.78,208
,20171113,19380,19385,19425,19425,19425,19425,19425,40,40,2,19.43,208
,20171114,19425,19425,19295,19295,19115,19115,19205,-310,-220,4,38.41,208
,20171115,19115,19205,19100,19100,19100,19100,19100,-105,-105,2,19.10,206
,20171116,19100,19100,18635,18635,18635,18635,18635,-465,-465,2,18.64,206
,20171117,18635,18635,18615,18635,18615,18635,18620,0,-15,6,55.87,200
,20171120,18635,18620,18440,18690,18440,18690,18565,70,-55,4,37.13,200
,20171121,18690,18565,18580,18645,18580,18645,18610,80,45,4,37.23,200
,20171122,18645,18610,18815,18935,18815,18935,18865,325,255,8,75.46,196
,20171123,18935,18865,18615,18615,18430,18430,18535,-435,-330,6,55.61,192
,20171124,18430,18535,18475,18645,18475,18645,18585,110,50,10,92.94,190
,20171127,18645,18585,18700,18775,18490,18490,18630,-95,45,20,186.32,196
,20171128,18490,18630,18515,18515,18420,18465,18465,-165,-165,10,92.34,196
,20171129,18465,18465,18350,18360,18350,18360,18355,-105,-110,4,36.71,198
,20171130,18360,18355,18280,18380,18280,18380,18330,25,-25,4,36.66,198
,20171201,18380,18330,18665,18665,18620,18620,18640,290,310,8,74.57,198
,20171204,18620,18640,18860,19250,18850,19120,19060,480,420,32,304.98,198
,20171205,19120,19060,19105,19175,18935,18935,19065,-125,5,42,400.42,180
,20171206,18935,19065,18780,18780,18625,18725,18715,-340,-350,10,93.59,178
,20171207,18725,18715,18905,18905,18905,18905,18905,190,190,4,37.81,178
,20171208,18905,18905,18710,18710,18570,18570,18660,-335,-245,14,130.64,170
,20171211,18570,18660,,,,18660,18660,0,0,0,0.00,170
,20171212,18660,18660,18605,18955,18605,18955,18830,295,170,10,94.16,170
,20171213,18955,18830,19130,19130,18965,18965,19040,135,210,8,76.16,170
,20171214,18965,19040,19095,19095,19095,19095,19095,55,55,2,19.10,170
,20171215,19095,19095,18950,18985,18950,18955,18960,-140,-135,10,94.82,172
,20171218,18955,18960,18970,19320,18970,19180,19180,220,220,12,115.09,174
,20171219,19180,19180,19310,19310,19310,19310,19310,130,130,4,38.62,170
,20171220,19310,19310,19270,19270,19270,19270,19270,-40,-40,2,19.27,170
,20171221,19270,19270,19030,19030,19030,19030,19030,-240,-240,8,76.12,178
,20171222,19030,19030,18990,19015,18990,19000,18995,-30,-35,16,151.99,174
,20171225,19000,18995,19090,19110,18990,19065,19055,70,60,40,381.13,184
,20171226,19065,19055,19000,19000,18830,18985,18925,-70,-130,8,75.70,182
,20171227,18985,18925,18940,18940,18925,18925,18930,0,5,4,37.87,180
,20171228,18925,18930,19035,19190,19035,19190,19125,260,195,30,286.89,196
,20171229,19190,19125,19150,19155,19095,19095,19120,-30,-5,56,535.49,188
pb1807,20170718,17640,17640,17815,17815,17150,17155,17400,-485,-240,12,104.40,2
,20170719,17155,17400,,,,17400,17400,0,0,0,0.00,2
,20170720,17400,17400,,,,17275,17275,-125,-125,0,0.00,2
,20170721,17275,17275,16955,17340,16955,17340,17080,65,-195,6,51.25,8
,20170724,17340,17080,17300,17300,17300,17300,17300,220,220,2,17.30,8
,20170725,17300,17300,17500,17500,17500,17500,17500,200,200,2,17.50,10
,20170726,17500,17500,,,,17870,17870,370,370,0,0.00,10
,20170727,17870,17870,18020,18020,17970,17970,17990,100,120,8,71.97,14
,20170728,17970,17990,,,,17990,17990,0,0,0,0.00,14
,20170731,17990,17990,,,,17990,17990,0,0,0,0.00,14
,20170801,17990,17990,,,,17990,17990,0,0,0,0.00,14
,20170802,17990,17990,,,,17990,17990,0,0,0,0.00,14
,20170803,17990,17990,18225,18400,18225,18385,18360,395,370,12,110.17,24
,20170804,18385,18360,18360,18360,18360,18360,18360,0,0,2,18.36,26
,20170807,18360,18360,18695,18695,18615,18690,18660,330,300,10,93.31,22
,20170808,18690,18660,,,,18790,18790,130,130,0,0.00,22
,20170809,18790,18790,19320,19435,19320,19435,19375,645,585,4,38.76,22
,20170810,19435,19375,19270,19270,19270,19270,19270,-105,-105,4,38.54,20
,20170811,19270,19270,,,,19015,19015,-255,-255,0,0.00,20
,20170814,19015,19015,,,,18800,18800,-215,-215,0,0.00,20
,20170815,18800,18800,18830,18970,18830,18970,18905,170,105,20,189.08,24
,20170816,18970,18905,18970,18970,18960,18960,18965,55,60,4,37.93,26
,20170817,18960,18965,19590,19905,19590,19905,19685,940,720,14,137.81,32
,20170818,19905,19685,19595,19695,19485,19485,19580,-200,-105,16,156.64,34
,20170821,19485,19580,,,,19580,19580,0,0,0,0.00,34
,20170822,19580,19580,18780,18965,18780,18965,18870,-615,-710,8,75.50,36
,20170823,18965,18870,19395,19395,19250,19250,19305,380,435,10,96.54,38
,20170824,19250,19305,19185,19355,19120,19120,19185,-185,-120,24,230.27,52
,20170825,19120,19185,18815,19070,18815,19070,18875,-115,-310,8,75.52,52
,20170828,19070,18875,19110,19110,18460,18490,18685,-385,-190,6,56.06,50
,20170829,18490,18685,,,,18685,18685,0,0,0,0.00,50
,20170830,18685,18685,18935,19020,18910,19020,18955,335,270,6,56.87,54
,20170831,19020,18955,,,,18940,18940,-15,-15,0,0.00,54
,20170901,18940,18940,18935,18935,18900,18900,18925,-40,-15,10,94.64,58
,20170904,18900,18925,18995,19180,18995,19180,19115,255,190,6,57.36,60
,20170905,19180,19115,,,,18880,18880,-235,-235,0,0.00,60
,20170906,18880,18880,18670,18670,18525,18525,18595,-355,-285,4,37.20,58
,20170907,18525,18595,18370,18370,18370,18370,18370,-225,-225,2,18.37,58
,20170908,18370,18370,,,,17980,17980,-390,-390,0,0.00,58
,20170911,17980,17980,,,,17700,17700,-280,-280,0,0.00,58
,20170912,17700,17700,,,,17700,17700,0,0,0,0.00,58
,20170913,17700,17700,17685,17685,17600,17600,17665,-100,-35,10,88.34,66
,20170914,17600,17665,,,,17665,17665,0,0,0,0.00,66
,20170915,17665,17665,,,,17665,17665,0,0,0,0.00,66
,20170918,17665,17665,18200,18400,17810,18400,18210,735,545,12,109.28,64
,20170919,18400,18210,18460,18460,18460,18460,18460,250,250,2,18.46,66
,20170920,18460,18460,,,,18625,18625,165,165,0,0.00,66
,20170921,18625,18625,18805,18885,18805,18885,18830,260,205,8,75.33,70
,20170922,18885,18830,18615,18615,18210,18295,18355,-535,-475,8,73.44,68
,20170925,18295,18355,,,,18355,18355,0,0,0,0.00,68
,20170926,18355,18355,18675,18910,18675,18910,18740,555,385,14,131.19,60
,20170927,18910,18740,19130,19130,19130,19130,19130,390,390,2,19.13,60
,20170928,19130,19130,18855,19065,18855,19065,18925,-65,-205,6,56.78,60
,20170929,19065,18925,19195,19370,19035,19370,19225,445,300,10,96.13,64
,20171009,19370,19225,19445,19720,19445,19720,19580,495,355,4,39.17,60
,20171010,19720,19580,,,,19400,19400,-180,-180,0,0.00,60
,20171011,19400,19400,19310,19370,19310,19370,19335,-30,-65,6,58.02,64
,20171012,19370,19335,19260,19400,18970,19380,19305,45,-30,22,212.38,66
,20171013,19380,19305,19515,19580,19425,19575,19530,270,225,14,136.73,66
,20171016,19575,19530,19785,19790,19785,19790,19785,260,255,6,59.36,72
,20171017,19790,19785,19950,19965,19705,19705,19870,-80,85,6,59.62,72
,20171018,19705,19870,19420,19420,18985,18985,19275,-885,-595,6,57.83,74
,20171019,18985,19275,19150,19805,19060,19060,19195,-215,-80,76,729.59,102
,20171020,19060,19195,18850,19230,18850,19230,18980,35,-215,18,170.82,104
,20171023,19230,18980,19135,19135,19135,19135,19135,155,155,2,19.14,102
,20171024,19135,19135,19210,19210,19210,19210,19210,75,75,2,19.21,100
,20171025,19210,19210,19155,19155,19155,19155,19155,-55,-55,2,19.16,100
,20171026,19155,19155,,,,19155,19155,0,0,0,0.00,100
,20171027,19155,19155,18905,18980,18905,18980,18940,-175,-215,4,37.89,98
,20171030,18980,18940,18555,18580,18365,18365,18475,-575,-465,8,73.90,100
,20171031,18365,18475,18500,18555,18485,18555,18510,80,35,6,55.54,100
,20171101,18555,18510,18960,18960,18900,18900,18930,390,420,4,37.86,104
,20171102,18900,18930,18835,18835,18835,18835,18835,-95,-95,2,18.84,106
,20171103,18835,18835,,,,18835,18835,0,0,0,0.00,106
,20171106,18835,18835,18820,18820,18795,18795,18805,-40,-30,4,37.62,108
,20171107,18795,18805,,,,18900,18900,95,95,0,0.00,108
,20171108,18900,18900,,,,18900,18900,0,0,0,0.00,108
,20171109,18900,18900,,,,18900,18900,0,0,0,0.00,108
,20171110,18900,18900,,,,19435,19435,535,535,0,0.00,108
,20171113,19435,19435,19410,19545,19410,19545,19455,110,20,14,136.19,118
,20171114,19545,19455,,,,19455,19455,0,0,0,0.00,118
,20171115,19455,19455,,,,19195,19195,-260,-260,0,0.00,118
,20171116,19195,19195,18680,18680,18585,18585,18645,-610,-550,6,55.94,114
,20171117,18585,18645,18575,18655,18395,18395,18575,-250,-70,68,631.55,128
,20171120,18395,18575,18460,18705,18460,18705,18605,130,30,8,74.44,128
,20171121,18705,18605,18565,18565,18565,18565,18565,-40,-40,2,18.57,128
,20171122,18565,18565,18945,18945,18945,18945,18945,380,380,8,75.78,128
,20171123,18945,18945,,,,18700,18700,-245,-245,0,0.00,128
,20171124,18700,18700,18500,18640,18500,18640,18570,-60,-130,4,37.14,128
,20171127,18640,18570,18710,18710,18480,18480,18595,-90,25,46,427.80,102
,20171128,18480,18595,18490,18755,18390,18455,18640,-140,45,24,223.72,100
,20171129,18455,18640,18555,18555,18390,18390,18410,-250,-230,14,128.90,98
,20171130,18390,18410,18380,18445,18360,18445,18395,35,-15,12,110.38,106
,20171201,18445,18395,18585,18585,18585,18585,18585,190,190,2,18.59,108
,20171204,18585,18585,18870,19305,18860,19060,19055,475,470,18,171.51,110
,20171205,19060,19055,,,,19055,19055,0,0,0,0.00,110
,20171206,19055,19055,18760,18830,18665,18830,18730,-225,-325,26,243.53,108
,20171207,18830,18730,18855,18855,18855,18855,18855,125,125,2,18.86,106
,20171208,18855,18855,18850,18850,18550,18640,18645,-215,-210,18,167.81,104
,20171211,18640,18645,18535,18535,18535,18535,18535,-110,-110,2,18.54,104
,20171212,18535,18535,18680,18930,18680,18930,18855,395,320,14,131.99,108
,20171213,18930,18855,19125,19125,19075,19105,19100,250,245,12,114.63,112
,20171214,19105,19100,19085,19085,19085,19085,19085,-15,-15,2,19.09,114
,20171215,19085,19085,18970,19010,18940,19010,18975,-75,-110,18,170.79,108
,20171218,19010,18975,19055,19340,19055,19330,19265,355,290,8,77.06,104
,20171219,19330,19265,19350,19350,19195,19195,19245,-70,-20,6,57.74,106
,20171220,19195,19245,19310,19310,19310,19310,19310,65,65,2,19.31,104
,20171221,19310,19310,19325,19325,18995,18995,19160,-315,-150,4,38.32,104
,20171222,18995,19160,19010,19055,19010,19025,19025,-135,-135,12,114.18,104
,20171225,19025,19025,19140,19165,18870,19020,19015,-5,-10,44,418.44,116
,20171226,19020,19015,18870,18870,18870,18870,18870,-145,-145,2,18.87,114
,20171227,18870,18870,18985,18995,18985,18995,18990,125,120,6,56.98,112
,20171228,18995,18990,19115,19255,19115,19255,19165,265,175,24,230.02,118
,20171229,19255,19165,19110,19150,19110,19150,19135,-15,-30,10,95.68,116
pb1808,20170816,18905,18905,18990,18990,18990,18990,18990,85,85,2,18.99,2
,20170817,18990,18990,19660,19895,19660,19895,19775,905,785,4,39.56,6
,20170818,19895,19775,19465,19465,19465,19465,19465,-310,-310,2,19.47,6
,20170821,19465,19465,,,,19465,19465,0,0,0,0.00,6
,20170822,19465,19465,,,,19465,19465,0,0,0,0.00,6
,20170823,19465,19465,19560,19560,19260,19260,19410,-205,-55,8,77.64,10
,20170824,19260,19410,19255,19255,19255,19255,19255,-155,-155,2,19.26,10
,20170825,19255,19255,18940,19010,18940,19010,18975,-245,-280,4,37.95,14
,20170828,19010,18975,18500,18500,18500,18500,18500,-475,-475,2,18.50,14
,20170829,18500,18500,,,,18375,18375,-125,-125,0,0.00,14
,20170830,18375,18375,18830,18830,18800,18800,18820,425,445,6,56.46,14
,20170831,18800,18820,,,,18810,18810,-10,-10,0,0.00,14
,20170901,18810,18810,,,,18795,18795,-15,-15,0,0.00,14
,20170904,18795,18795,19175,19175,19175,19175,19175,380,380,6,57.53,18
,20170905,19175,19175,,,,18850,18850,-325,-325,0,0.00,18
,20170906,18850,18850,18535,18535,18535,18535,18535,-315,-315,2,18.54,18
,20170907,18535,18535,18195,18195,18195,18195,18195,-340,-340,2,18.20,18
,20170908,18195,18195,,,,17900,17900,-295,-295,0,0.00,18
,20170911,17900,17900,,,,17700,17700,-200,-200,0,0.00,18
,20170912,17700,17700,,,,17700,17700,0,0,0,0.00,18
,20170913,17700,17700,,,,17700,17700,0,0,0,0.00,18
,20170914,17700,17700,17700,17700,17700,17700,17700,0,0,2,17.70,20
,20170915,17700,17700,,,,17700,17700,0,0,0,0.00,20
,20170918,17700,17700,17895,18325,17850,18325,18105,625,405,14,126.76,28
,20170919,18325,18105,18660,18660,18490,18490,18575,385,470,4,37.15,30
,20170920,18490,18575,18540,18750,18500,18690,18600,115,25,18,167.43,40
,20170921,18690,18600,,,,18600,18600,0,0,0,0.00,40
,20170922,18600,18600,18715,18715,18160,18160,18530,-440,-70,6,55.59,40
,20170925,18160,18530,,,,18530,18530,0,0,0,0.00,40
,20170926,18530,18530,,,,18530,18530,0,0,0,0.00,40
,20170927,18530,18530,,,,18530,18530,0,0,0,0.00,40
,20170928,18530,18530,19085,19085,19085,19085,19085,555,555,2,19.09,40
,20170929,19085,19085,,,,19385,19385,300,300,0,0.00,40
,20171009,19385,19385,19460,19460,19460,19460,19460,75,75,2,19.46,40
,20171010,19460,19460,,,,19460,19460,0,0,0,0.00,40
,20171011,19460,19460,19325,19325,19195,19255,19255,-205,-205,12,115.55,46
,20171012,19255,19255,19225,19260,19225,19245,19240,-10,-15,6,57.73,44
,20171013,19245,19240,19430,19475,19430,19475,19450,235,210,4,38.91,42
,20171016,19475,19450,,,,19515,19515,65,65,0,0.00,42
,20171017,19515,19515,,,,19515,19515,0,0,0,0.00,42
,20171018,19515,19515,19515,19515,19515,19515,19515,0,0,2,19.52,42
,20171019,19515,19515,19280,19285,19070,19070,19190,-445,-325,24,230.30,60
,20171020,19070,19190,18990,19180,18885,19180,18970,-10,-220,24,227.69,64
,20171023,19180,18970,18900,18900,18900,18900,18900,-70,-70,2,18.90,64
,20171024,18900,18900,19205,19205,19205,19205,19205,305,305,2,19.21,66
,20171025,19205,19205,,,,19205,19205,0,0,0,0.00,66
,20171026,19205,19205,19085,19085,19085,19085,19085,-120,-120,2,19.09,64
,20171027,19085,19085,,,,18800,18800,-285,-285,0,0.00,64
,20171030,18800,18800,18600,18600,18360,18360,18445,-440,-355,6,55.34,66
,20171031,18360,18445,,,,18630,18630,185,185,0,0.00,66
,20171101,18630,18630,,,,18750,18750,120,120,0,0.00,66
,20171102,18750,18750,18745,18750,18745,18750,18745,0,-5,4,37.50,68
,20171103,18750,18745,18700,18700,18700,18700,18700,-45,-45,2,18.70,68
,20171106,18700,18700,,,,18880,18880,180,180,0,0.00,68
,20171107,18880,18880,19145,19145,18955,18955,19050,75,170,4,38.10,72
,20171108,18955,19050,19000,19000,19000,19000,19000,-50,-50,2,19.00,70
,20171109,19000,19000,19000,19000,19000,19000,19000,0,0,2,19.00,72
,20171110,19000,19000,19325,19325,19325,19325,19325,325,325,2,19.33,74
,20171113,19325,19325,,,,19325,19325,0,0,0,0.00,74
,20171114,19325,19325,19300,19300,19300,19300,19300,-25,-25,2,19.30,72
,20171115,19300,19300,19090,19090,19090,19090,19090,-210,-210,2,19.09,72
,20171116,19090,19090,18595,18595,18595,18595,18595,-495,-495,2,18.60,70
,20171117,18595,18595,18635,18635,18505,18505,18570,-90,-25,4,37.14,70
,20171120,18505,18570,18680,18680,18680,18680,18680,110,110,2,18.68,70
,20171121,18680,18680,,,,18680,18680,0,0,0,0.00,70
,20171122,18680,18680,,,,18950,18950,270,270,0,0.00,70
,20171123,18950,18950,,,,18700,18700,-250,-250,0,0.00,70
,20171124,18700,18700,18650,18650,18650,18650,18650,-50,-50,2,18.65,70
,20171127,18650,18650,18750,18750,18495,18495,18625,-155,-25,12,111.77,72
,20171128,18495,18625,18515,18515,18515,18515,18515,-110,-110,2,18.52,72
,20171129,18515,18515,18445,18445,18445,18445,18445,-70,-70,2,18.45,72
,20171130,18445,18445,18420,18420,18405,18405,18410,-40,-35,6,55.23,68
,20171201,18405,18410,18680,18690,18645,18645,18675,235,265,18,168.10,64
,20171204,18645,18675,18890,19135,18890,19135,18980,460,305,6,56.94,66
,20171205,19135,18980,,,,18980,18980,0,0,0,0.00,66
,20171206,18980,18980,18860,18860,18660,18835,18725,-145,-255,14,131.09,60
,20171207,18835,18725,18900,18900,18900,18900,18900,175,175,2,18.90,62
,20171208,18900,18900,18600,18600,18600,18600,18600,-300,-300,2,18.60,62
,20171211,18600,18600,,,,18600,18600,0,0,0,0.00,62
,20171212,18600,18600,18860,18990,18860,18965,18915,365,315,8,75.68,66
,20171213,18965,18915,19160,19160,18890,19125,19075,210,160,28,267.08,66
,20171214,19125,19075,19115,19125,19115,19125,19120,50,45,4,38.24,64
,20171215,19125,19120,18960,18985,18950,18985,18960,-135,-160,8,75.86,56
,20171218,18985,18960,19150,19150,19150,19150,19150,190,190,2,19.15,56
,20171219,19150,19150,19370,19370,19370,19370,19370,220,220,2,19.37,58
,20171220,19370,19370,,,,19370,19370,0,0,0,0.00,58
,20171221,19370,19370,19315,19315,19050,19050,19135,-320,-235,6,57.42,54
,20171222,19050,19135,19070,19070,18910,18910,18990,-225,-145,4,37.98,54
,20171225,18910,18990,19010,19130,19010,19130,19065,140,75,6,57.20,52
,20171226,19130,19065,,,,19065,19065,0,0,0,0.00,52
,20171227,19065,19065,19015,19015,19015,19015,19015,-50,-50,2,19.02,52
,20171228,19015,19015,19140,19145,19110,19140,19125,125,110,10,95.65,50
,20171229,19140,19125,,,,19125,19125,0,0,0,0.00,50
pb1809,20170918,17700,17700,,,,17795,17795,95,95,0,0.00,0
,20170919,17795,17795,18590,18590,18590,18590,18590,795,795,4,37.18,4
,20170920,18590,18590,18700,18700,18700,18700,18700,110,110,2,18.70,4
,20170921,18700,18700,19310,19310,18260,18590,18775,-110,75,22,206.53,6
,20170922,18590,18775,18495,18495,17840,18180,18230,-595,-545,18,164.09,14
,20170925,18180,18230,18350,18350,18335,18335,18340,105,110,4,36.69,14
,20170926,18335,18340,18520,18580,18520,18580,18560,240,220,8,74.25,10
,20170927,18580,18560,18805,19160,18805,19160,18920,600,360,12,113.54,16
,20170928,19160,18920,,,,18920,18920,0,0,0,0.00,16
,20170929,18920,18920,19440,19440,19440,19440,19440,520,520,2,19.44,14
,20171009,19440,19440,19450,19450,19450,19450,19450,10,10,2,19.45,12
,20171010,19450,19450,,,,19300,19300,-150,-150,0,0.00,12
,20171011,19300,19300,,,,19300,19300,0,0,0,0.00,12
,20171012,19300,19300,,,,19285,19285,-15,-15,0,0.00,12
,20171013,19285,19285,19375,19375,19375,19375,19375,90,90,2,19.38,12
,20171016,19375,19375,19575,19720,19575,19720,19625,345,250,6,58.88,14
,20171017,19720,19625,19405,19405,19405,19405,19405,-220,-220,2,19.41,16
,20171018,19405,19405,19375,19375,18335,18940,19025,-465,-380,20,190.27,30
,20171019,18940,19025,,,,19025,19025,0,0,0,0.00,30
,20171020,19025,19025,18860,18860,18860,18860,18860,-165,-165,2,18.86,30
,20171023,18860,18860,18925,18925,18925,18925,18925,65,65,2,18.93,30
,20171024,18925,18925,,,,19130,19130,205,205,0,0.00,30
,20171025,19130,19130,,,,19130,19130,0,0,0,0.00,30
,20171026,19130,19130,,,,19130,19130,0,0,0,0.00,30
,20171027,19130,19130,18760,18760,18760,18760,18760,-370,-370,2,18.76,30
,20171030,18760,18760,18610,18610,18610,18610,18610,-150,-150,2,18.61,30
,20171031,18610,18610,18500,18500,18500,18500,18500,-110,-110,2,18.50,32
,20171101,18500,18500,18890,19055,18890,19055,18970,555,470,4,37.95,32
,20171102,19055,18970,,,,18970,18970,0,0,0,0.00,32
,20171103,18970,18970,18835,18835,18740,18740,18800,-230,-170,6,56.41,32
,20171106,18740,18800,,,,18880,18880,80,80,0,0.00,32
,20171107,18880,18880,,,,18880,18880,0,0,0,0.00,32
,20171108,18880,18880,,,,18880,18880,0,0,0,0.00,32
,20171109,18880,18880,,,,18880,18880,0,0,0,0.00,32
,20171110,18880,18880,19240,19385,19240,19385,19310,505,430,4,38.63,32
,20171113,19385,19310,19340,19415,19340,19415,19390,105,80,6,58.17,34
,20171114,19415,19390,,,,19390,19390,0,0,0,0.00,34
,20171115,19390,19390,18715,18715,18715,18715,18715,-675,-675,4,37.43,38
,20171116,18715,18715,18595,18595,18595,18595,18595,-120,-120,2,18.60,40
,20171117,18595,18595,18660,18660,18660,18660,18660,65,65,2,18.66,40
,20171120,18660,18660,18510,18705,18510,18705,18605,45,-55,4,37.22,40
,20171121,18705,18605,,,,18605,18605,0,0,0,0.00,40
,20171122,18605,18605,18910,18910,18910,18910,18910,305,305,2,18.91,40
,20171123,18910,18910,18675,18675,18500,18500,18570,-410,-340,8,74.30,42
,20171124,18500,18570,,,,18570,18570,0,0,0,0.00,42
,20171127,18570,18570,18750,18755,18575,18575,18690,5,120,6,56.08,42
,20171128,18575,18690,18560,18635,18465,18465,18550,-225,-140,6,55.66,44
,20171129,18465,18550,,,,18550,18550,0,0,0,0.00,44
,20171130,18550,18550,18450,18450,18450,18450,18450,-100,-100,2,18.45,44
,20171201,18450,18450,18635,18730,18635,18730,18680,280,230,4,37.37,46
,20171204,18730,18680,18880,19140,18880,19090,19035,410,355,6,57.11,48
,20171205,19090,19035,19025,19025,19025,19025,19025,-10,-10,2,19.03,50
,20171206,19025,19025,19330,19330,18700,18700,18880,-325,-145,16,151.08,50
,20171207,18700,18880,,,,18880,18880,0,0,0,0.00,50
,20171208,18880,18880,18650,18935,18630,18630,18725,-250,-155,16,149.82,44
,20171211,18630,18725,18495,18670,18485,18520,18560,-205,-165,26,241.34,48
,20171212,18520,18560,18680,19190,18680,19190,18880,630,320,20,188.80,40
,20171213,19190,18880,19185,19185,19050,19070,19105,190,225,52,496.80,40
,20171214,19070,19105,19150,19155,18960,18965,19060,-140,-45,52,495.66,44
,20171215,18965,19060,18870,19070,18870,19000,19000,-60,-60,112,"1,064.24",46
,20171218,19000,19000,19080,19410,19080,19185,19265,185,265,68,655.07,40
,20171219,19185,19265,19450,19455,19200,19200,19365,-65,100,126,"1,220.31",56
,20171220,19200,19365,19275,19310,19210,19310,19265,-55,-100,82,790.04,60
,20171221,19310,19265,19275,19300,18995,19090,19200,-175,-65,82,787.37,76
,20171222,19090,19200,19085,19090,18880,19000,18965,-200,-235,180,"1,707.00",76
,20171225,19000,18965,19030,19160,19010,19010,19080,45,115,110,"1,049.45",80
,20171226,19010,19080,19010,19070,18920,18925,19025,-155,-55,70,666.01,76
,20171227,18925,19025,18995,19030,18910,18975,18955,-50,-70,22,208.54,74
,20171228,18975,18955,19080,19220,19035,19220,19120,265,165,70,669.35,80
,20171229,19220,19120,19155,19180,19085,19180,19140,60,20,90,861.42,78
pb1810,20171017,19625,19625,19585,19585,19310,19315,19450,-310,-175,24,233.43,4
,20171018,19315,19450,19230,19230,18990,18990,19110,-460,-340,6,57.34,8
,20171019,18990,19110,19195,19195,19195,19195,19195,85,85,2,19.20,6
,20171020,19195,19195,18865,18875,18865,18875,18870,-320,-325,4,37.74,8
,20171023,18875,18870,19200,19200,18840,19015,19005,145,135,14,133.04,10
,20171024,19015,19005,19135,19135,19135,19135,19135,130,130,4,38.27,8
,20171025,19135,19135,18955,19095,18905,18905,19005,-230,-130,8,76.03,10
,20171026,18905,19005,19055,19280,19055,19280,19130,275,125,6,57.39,14
,20171027,19280,19130,18815,18815,18815,18815,18815,-315,-315,2,18.82,12
,20171030,18815,18815,18605,18605,18500,18500,18540,-315,-275,10,92.72,20
,20171031,18500,18540,18500,18500,18500,18500,18500,-40,-40,6,55.50,22
,20171101,18500,18500,19100,19100,18915,18915,19005,415,505,4,38.02,20
,20171102,18915,19005,,,,19005,19005,0,0,0,0.00,20
,20171103,19005,19005,18650,18650,18650,18650,18650,-355,-355,2,18.65,18
,20171106,18650,18650,18875,19050,18875,19045,18965,395,315,10,94.84,16
,20171107,19045,18965,19055,19200,19055,19130,19110,165,145,8,76.44,18
,20171108,19130,19110,,,,19110,19110,0,0,0,0.00,18
,20171109,19110,19110,,,,19110,19110,0,0,0,0.00,18
,20171110,19110,19110,,,,19110,19110,0,0,0,0.00,18
,20171113,19110,19110,19450,19450,19385,19385,19405,275,295,6,58.22,18
,20171114,19385,19405,,,,19405,19405,0,0,0,0.00,18
,20171115,19405,19405,18785,18930,18590,18805,18730,-600,-675,40,374.65,22
,20171116,18805,18730,18860,18860,18860,18860,18860,130,130,2,18.86,22
,20171117,18860,18860,18650,18650,18405,18515,18530,-345,-330,10,92.67,22
,20171120,18515,18530,18700,18700,18700,18700,18700,170,170,2,18.70,24
,20171121,18700,18700,,,,18700,18700,0,0,0,0.00,24
,20171122,18700,18700,18960,18960,18960,18960,18960,260,260,2,18.96,22
,20171123,18960,18960,18590,18590,18590,18590,18590,-370,-370,2,18.59,24
,20171124,18590,18590,18645,18645,18645,18645,18645,55,55,2,18.65,26
,20171127,18645,18645,18590,18590,18550,18550,18570,-95,-75,4,37.14,26
,20171128,18550,18570,18575,18575,18485,18485,18545,-85,-25,6,55.64,28
,20171129,18485,18545,,,,18545,18545,0,0,0,0.00,28
,20171130,18545,18545,18490,18490,18490,18490,18490,-55,-55,2,18.49,28
,20171201,18490,18490,18705,18715,18705,18715,18710,225,220,4,37.42,28
,20171204,18715,18710,18910,19340,18910,19140,19155,430,445,22,210.75,38
,20171205,19140,19155,,,,19155,19155,0,0,0,0.00,38
,20171206,19155,19155,18950,18950,18765,18765,18855,-390,-300,4,37.72,36
,20171207,18765,18855,19000,19000,19000,19000,19000,145,145,2,19.00,34
,20171208,19000,19000,,,,19000,19000,0,0,0,0.00,34
,20171211,19000,19000,,,,19000,19000,0,0,0,0.00,34
,20171212,19000,19000,18910,19145,18910,18985,18995,-15,-5,10,94.98,30
,20171213,18985,18995,19160,19160,19160,19160,19160,165,165,2,19.16,30
,20171214,19160,19160,19135,19235,19030,19160,19130,0,-30,10,95.66,32
,20171215,19160,19130,19050,19050,19050,19050,19050,-80,-80,2,19.05,30
,20171218,19050,19050,19345,19345,19345,19345,19345,295,295,2,19.35,30
,20171219,19345,19345,19395,19395,19215,19215,19305,-130,-40,4,38.61,30
,20171220,19215,19305,19320,19320,19320,19320,19320,15,15,2,19.32,30
,20171221,19320,19320,19125,19125,19090,19090,19105,-230,-215,6,57.32,30
,20171222,19090,19105,19030,19030,19025,19025,19025,-80,-80,4,38.06,30
,20171225,19025,19025,,,,19025,19025,0,0,0,0.00,30
,20171226,19025,19025,,,,19025,19025,0,0,0,0.00,30
,20171227,19025,19025,,,,19025,19025,0,0,0,0.00,30
,20171228,19025,19025,19190,19190,19190,19190,19190,165,165,2,19.19,28
,20171229,19190,19190,,,,19190,19190,0,0,0,0.00,28
pb1811,20171116,18730,18730,,,,18730,18730,0,0,0,0.00,0
,20171117,18730,18730,18710,18710,18710,18710,18710,-20,-20,2,18.71,2
,20171120,18710,18710,18730,18730,18730,18730,18730,20,20,2,18.73,4
,20171121,18730,18730,18780,18780,18645,18690,18700,-40,-30,14,130.92,6
,20171122,18690,18700,18775,18775,18775,18775,18775,75,75,4,37.55,10
,20171123,18775,18775,18935,18935,18720,18720,18790,-55,15,6,56.38,8
,20171124,18720,18790,18540,18655,18540,18655,18595,-135,-195,4,37.20,8
,20171127,18655,18595,18635,18765,18585,18585,18640,-10,45,8,74.57,14
,20171128,18585,18640,,,,18640,18640,0,0,0,0.00,14
,20171129,18640,18640,,,,18640,18640,0,0,0,0.00,14
,20171130,18640,18640,18420,18490,18420,18490,18465,-150,-175,6,55.40,18
,20171201,18490,18465,18640,18640,18640,18640,18640,175,175,2,18.64,20
,20171204,18640,18640,19265,19265,19180,19180,19220,540,580,4,38.45,22
,20171205,19180,19220,,,,19220,19220,0,0,0,0.00,22
,20171206,19220,19220,,,,18995,18995,-225,-225,0,0.00,22
,20171207,18995,18995,,,,18995,18995,0,0,0,0.00,22
,20171208,18995,18995,,,,18995,18995,0,0,0,0.00,22
,20171211,18995,18995,,,,18995,18995,0,0,0,0.00,22
,20171212,18995,18995,18925,18925,18910,18910,18915,-85,-80,6,56.75,24
,20171213,18910,18915,19165,19175,19165,19175,19170,260,255,6,57.52,28
,20171214,19175,19170,19200,19200,18935,19050,19060,-120,-110,14,133.45,28
,20171215,19050,19060,18945,19035,18945,18980,19010,-80,-50,14,133.10,42
,20171218,18980,19010,19010,19455,19010,19290,19215,280,205,32,307.50,42
,20171219,19290,19215,19395,19395,19190,19190,19275,-25,60,6,57.83,46
,20171220,19190,19275,19330,19330,19330,19330,19330,55,55,2,19.33,48
,20171221,19330,19330,19055,19055,19050,19050,19050,-280,-280,16,152.43,56
,20171222,19050,19050,19040,19040,19040,19040,19040,-10,-10,10,95.20,56
,20171225,19040,19040,19155,19155,19110,19110,19130,70,90,10,95.67,62
,20171226,19110,19130,18920,19125,18860,19125,18970,-5,-160,20,189.74,64
,20171227,19125,18970,,,,18970,18970,0,0,0,0.00,64
,20171228,18970,18970,,,,19195,19195,225,225,0,0.00,64
,20171229,19195,19195,,,,19195,19195,0,0,0,0.00,64
pb1812,20171218,19010,19010,,,,19010,19010,0,0,0,0.00,0
,20171219,19010,19010,,,,19010,19010,0,0,0,0.00,0
,20171220,19010,19010,,,,19010,19010,0,0,0,0.00,0
,20171221,19010,19010,,,,19010,19010,0,0,0,0.00,0
,20171222,19010,19010,,,,19010,19010,0,0,0,0.00,0
,20171225,19010,19010,,,,19010,19010,0,0,0,0.00,0
,20171226,19010,19010,,,,19010,19010,0,0,0,0.00,0
,20171227,19010,19010,,,,19010,19010,0,0,0,0.00,0
,20171228,19010,19010,,,,19010,19010,0,0,0,0.00,0
,20171229,19010,19010,,,,19010,19010,0,0,0,0.00,0
rb1701,20170103,2923,2954,2988,2999,2925,2941,2954,-13,0,3302,"9,755.37",12360
,20170104,2941,2954,2935,2990,2908,2980,2941,26,-13,3420,"10,061.28",10320
,20170105,2980,2941,2955,3008,2953,3008,2985,67,44,2520,"7,523.58",8520
,20170106,3008,2985,3013,3013,2960,2960,2987,-25,2,600,"1,792.44",8040
,20170109,2960,2987,3008,3039,2981,3039,3008,52,21,2040,"6,137.82",6900
,20170110,3039,3008,3049,3218,3049,3218,3121,210,113,1980,"6,180.36",5640
,20170111,3218,3121,3130,3220,3120,3199,3181,78,60,1560,"4,962.66",4680
,20170112,3199,3181,3200,3235,3160,3160,3208,-21,27,420,"1,347.60",4680
,20170113,3160,3208,3165,3165,3165,3165,3165,-43,-43,120,379.80,4620
,20170116,3165,3165,3300,3300,3300,3300,3300,135,135,60,198.00,4620
rb1702,20170103,2892,2895,2973,3004,2870,2870,2895,-25,0,204,590.72,3234
,20170104,2870,2895,2835,2940,2835,2940,2887,45,-8,252,727.76,3146
,20170105,2940,2887,2932,2960,2919,2919,2941,32,54,248,729.59,3150
,20170106,2919,2941,2900,2980,2900,2936,2932,-5,-9,118,346.05,3140
,20170109,2936,2932,2940,3005,2912,3005,2977,73,45,148,440.66,3130
,20170110,3005,2977,3019,3160,3019,3160,3094,183,117,282,872.54,3174
,20170111,3160,3094,3158,3180,3156,3173,3167,79,73,608,"1,925.97",2894
,20170112,3173,3167,3168,3238,3150,3189,3199,22,32,734,"2,348.49",2864
,20170113,3189,3199,3208,3208,3170,3170,3191,-29,-8,278,887.17,2790
,20170116,3170,3191,3192,3374,3187,3359,3326,168,135,1012,"3,366.38",2828
,20170117,3359,3326,3371,3379,3221,3300,3313,-26,-13,334,"1,106.83",2700
,20170118,3300,3313,3290,3366,3290,3312,3319,-1,6,220,730.31,2720
,20170119,3312,3319,3270,3310,3270,3310,3282,-9,-37,80,262.60,2716
,20170120,3310,3282,3246,3300,3203,3230,3274,-52,-8,224,733.48,2648
,20170123,3230,3274,3210,3210,3156,3198,3182,-76,-92,90,286.39,2578
,20170124,3198,3182,3230,3345,3216,3320,3279,138,97,224,734.53,2440
,20170125,3320,3279,3323,3434,3280,3340,3368,61,89,578,"1,947.02",2084
,20170126,3340,3368,3360,3439,3220,3248,3307,-120,-61,272,899.60,2100
,20170203,3248,3307,,,,3250,3250,-57,-57,0,0.00,2100
,20170206,3250,3250,3150,3150,3130,3130,3140,-120,-110,240,753.60,2160
,20170207,3130,3140,3082,3082,3082,3082,3082,-58,-58,660,"2,034.12",2160
,20170208,3082,3082,3275,3275,3275,3275,3275,193,193,60,196.50,2160
,20170209,3275,3275,,,,3275,3275,0,0,0,0.00,2160
,20170210,3275,3275,,,,3275,3275,0,0,0,0.00,2160
,20170213,3275,3275,3400,3400,3400,3400,3400,125,125,120,408.00,2160
,20170214,3400,3400,3636,3636,3636,3636,3636,236,236,60,218.16,2160
,20170215,3636,3636,3386,3386,3386,3386,3386,-250,-250,60,203.16,2160
rb1703,20170103,2878,2895,2914,2914,2878,2878,2903,-17,8,20,58.07,3012
,20170104,2878,2903,2863,2967,2850,2950,2890,47,-13,118,341.08,3056
,20170105,2950,2890,2922,3006,2922,2971,2975,81,85,296,880.70,3120
,20170106,2971,2975,2947,2989,2927,2930,2958,-45,-17,48,141.99,3112
,20170109,2930,2958,2886,3030,2886,3030,3006,72,48,340,"1,022.28",3278
,20170110,3030,3006,3035,3170,3021,3170,3096,164,90,436,"1,349.90",3276
,20170111,3170,3096,3168,3207,3140,3182,3176,86,80,442,"1,404.05",3354
,20170112,3182,3176,3169,3250,3158,3210,3206,34,30,308,987.66,3512
,20170113,3210,3206,3219,3249,3172,3190,3206,-16,0,238,763.20,3538
,20170116,3190,3206,3187,3423,3178,3398,3337,192,131,302,"1,008.03",3584
,20170117,3398,3337,3347,3400,3267,3296,3346,-41,9,122,408.27,3566
,20170118,3296,3346,3295,3320,3280,3320,3300,-26,-46,108,356.41,3568
,20170119,3320,3300,3302,3313,3251,3279,3281,-21,-19,44,144.37,3566
,20170120,3279,3281,3279,3306,3220,3220,3268,-61,-13,74,241.88,3536
,20170123,3220,3268,3201,3220,3179,3200,3192,-68,-76,48,153.25,3506
,20170124,3200,3192,3203,3352,3203,3301,3307,109,115,590,"1,951.29",3426
,20170125,3301,3307,3301,3335,3262,3304,3284,-3,-23,158,518.90,3460
,20170126,3304,3284,3351,3370,3325,3370,3351,86,67,94,315.08,3428
,20170203,3370,3351,3172,3260,3101,3167,3168,-184,-183,452,"1,432.36",3384
,20170206,3167,3168,3135,3163,3130,3160,3151,-8,-17,100,315.20,3382
,20170207,3160,3151,3197,3233,3144,3233,3197,82,46,86,274.97,3350
,20170208,3233,3197,3192,3300,3192,3280,3252,83,55,42,136.62,3344
,20170209,3280,3252,3324,3349,3298,3300,3309,48,57,94,311.05,3300
,20170210,3300,3309,3273,3428,3273,3428,3323,119,14,90,299.13,3238
,20170213,3428,3323,3442,3539,3406,3532,3490,209,167,338,"1,179.81",3004
,20170214,3532,3490,3540,3540,3485,3518,3506,28,16,460,"1,612.90",2720
,20170215,3518,3506,3472,3527,3463,3525,3496,19,-10,28,97.91,2718
,20170216,3525,3496,3555,3629,3467,3511,3546,15,50,116,411.40,2708
,20170217,3511,3546,3533,3610,3506,3610,3571,64,25,260,928.53,2614
,20170220,3610,3571,3630,3684,3602,3671,3644,100,73,634,"2,310.86",2408
,20170221,3671,3644,3670,3758,3670,3678,3706,34,62,224,830.36,2272
,20170222,3678,3706,3697,3730,3625,3638,3654,-68,-52,194,709.07,2152
,20170223,3638,3654,3658,3680,3581,3590,3655,-64,1,856,"3,129.00",2022
,20170224,3590,3655,3600,3629,3520,3628,3563,-27,-92,356,"1,268.43",1780
,20170227,3628,3563,3638,3794,3572,3724,3715,161,152,154,572.24,1682
,20170228,3724,3715,3845,3975,3761,3975,3871,260,156,730,"2,825.84",1680
,20170301,3975,3871,3996,4000,3701,3800,3845,-71,-26,780,"2,999.76",1560
,20170302,3800,3845,,,,3845,3845,0,0,0,0.00,1560
,20170303,3845,3845,3700,3730,3700,3730,3715,-115,-130,120,445.80,1440
,20170306,3730,3715,3640,3640,3640,3640,3640,-75,-75,60,218.40,1380
,20170307,3640,3640,3655,3655,3650,3650,3652,10,12,180,657.36,1200
,20170308,3650,3652,,,,3652,3652,0,0,0,0.00,1200
,20170309,3652,3652,,,,3652,3652,0,0,0,0.00,1200
,20170310,3652,3652,3680,3680,3609,3609,3632,-43,-20,180,653.88,1080
,20170313,3609,3632,,,,3650,3650,18,18,0,0.00,1080
,20170314,3650,3650,3750,3750,3750,3750,3750,100,100,60,225.00,1140
,20170315,3750,3750,,,,3750,3750,0,0,0,0.00,1140
rb1704,20170103,2898,2895,2911,2943,2862,2865,2888,-30,-7,126,363.90,1720
,20170104,2865,2888,2873,2959,2850,2959,2884,71,-4,174,501.86,1718
,20170105,2959,2884,2953,3000,2937,2977,2961,93,77,284,840.94,1918
,20170106,2977,2961,2951,2996,2932,2932,2970,-29,9,92,273.24,1890
,20170109,2932,2970,2940,3050,2911,3050,2957,80,-13,116,343.03,1856
,20170110,3050,2957,3054,3163,3050,3162,3121,205,164,314,980.11,1718
,20170111,3162,3121,3197,3213,3143,3182,3174,61,53,484,"1,536.64",1628
,20170112,3182,3174,3165,3256,3165,3211,3230,37,56,124,400.57,1640
,20170113,3211,3230,3219,3219,3196,3197,3202,-33,-28,22,70.46,1644
,20170116,3197,3202,3315,3398,3300,3391,3367,189,165,56,188.61,1650
,20170117,3391,3367,3380,3380,3206,3282,3319,-85,-48,58,192.50,1650
,20170118,3282,3319,,,,3319,3319,0,0,0,0.00,1650
,20170119,3319,3319,3280,3294,3221,3266,3259,-53,-60,206,671.42,1690
,20170120,3266,3259,3266,3284,3220,3220,3258,-39,-1,132,430.08,1682
,20170123,3220,3258,3179,3203,3170,3201,3190,-57,-68,118,376.43,1664
,20170124,3201,3190,3200,3319,3192,3300,3253,110,63,62,201.70,1666
,20170125,3300,3253,3280,3321,3269,3299,3287,46,34,230,756.20,1614
,20170126,3299,3287,3312,3363,3312,3362,3348,75,61,194,649.69,1728
,20170203,3362,3348,3289,3296,3090,3162,3172,-186,-176,162,513.95,1730
,20170206,3162,3172,3132,3158,3100,3117,3129,-55,-43,406,"1,270.67",1682
,20170207,3117,3129,3124,3206,3116,3200,3141,71,12,140,439.75,1676
,20170208,3200,3141,3190,3264,3190,3232,3208,91,67,38,121.93,1654
,20170209,3232,3208,3287,3306,3261,3282,3283,74,75,306,"1,004.87",1564
,20170210,3282,3283,3256,3438,3241,3405,3331,122,48,162,539.78,1504
,20170213,3405,3331,3414,3514,3405,3489,3466,158,135,28,97.05,1500
,20170214,3489,3466,3474,3497,3436,3476,3464,10,-2,712,"2,466.54",1768
,20170215,3476,3464,3491,3499,3440,3453,3470,-11,6,48,166.58,1756
,20170216,3453,3470,3475,3607,3417,3512,3532,42,62,950,"3,356.20",1700
,20170217,3512,3532,3494,3565,3494,3546,3544,14,12,124,439.55,1638
,20170220,3546,3544,3586,3620,3549,3608,3598,64,54,88,316.71,1666
,20170221,3608,3598,3634,3723,3610,3659,3676,61,78,70,257.37,1660
,20170222,3659,3676,3663,3686,3582,3609,3631,-67,-45,78,283.26,1650
,20170223,3609,3631,3588,3635,3588,3600,3613,-31,-18,42,151.77,1656
,20170224,3600,3613,3548,3570,3480,3570,3502,-43,-111,108,378.31,1716
,20170227,3570,3502,3605,3714,3578,3688,3665,186,163,148,542.49,1656
,20170228,3688,3665,3671,3731,3575,3575,3663,-90,-2,810,"2,967.82",1682
,20170301,3575,3663,3575,3663,3558,3657,3608,-6,-55,538,"1,941.36",1702
,20170302,3657,3608,3660,3694,3643,3673,3669,65,61,274,"1,005.43",1706
,20170303,3673,3669,3662,3685,3575,3685,3605,16,-64,278,"1,002.45",1642
,20170306,3685,3605,3650,3688,3603,3618,3645,13,40,390,"1,421.83",1780
,20170307,3618,3645,3605,3661,3597,3621,3628,-24,-17,180,653.11,1770
,20170308,3621,3628,3630,3641,3591,3596,3608,-32,-20,122,440.27,1786
,20170309,3596,3608,3662,3662,3497,3545,3528,-63,-80,594,"2,096.18",1780
,20170310,3545,3528,3544,3594,3544,3577,3572,49,44,102,364.41,1770
,20170313,3577,3572,3569,3743,3542,3730,3671,158,99,452,"1,659.57",1562
,20170314,3730,3671,3728,3740,3686,3740,3715,69,44,194,720.75,1494
,20170315,3740,3715,3701,3819,3701,3770,3787,55,72,116,439.38,1468
,20170316,3770,3787,3780,3822,3778,3822,3804,35,17,184,700.09,1390
,20170317,3822,3804,3800,3810,3729,3762,3779,-42,-25,96,362.85,1402
,20170320,3762,3779,3756,3832,3748,3756,3799,-23,20,110,417.94,1372
,20170321,3756,3799,3752,3792,3675,3675,3714,-124,-85,236,876.54,1236
,20170322,3675,3714,3689,3706,3600,3620,3656,-94,-58,100,365.68,1206
,20170323,3620,3656,3649,3650,3590,3630,3631,-26,-25,54,196.08,1178
,20170324,3630,3631,3595,3670,3595,3639,3619,8,-12,220,796.35,1002
,20170327,3639,3619,3601,3622,3450,3505,3513,-114,-106,62,217.84,982
,20170328,3505,3513,3511,3554,3470,3470,3517,-43,4,124,436.14,882
,20170329,3470,3517,3517,3588,3504,3588,3538,71,21,108,382.20,886
,20170330,3588,3538,3594,3657,3585,3656,3619,118,81,50,180.98,894
,20170331,3656,3619,3668,3872,3668,3872,3774,253,155,332,"1,253.29",840
,20170405,3872,3774,3872,3872,3750,3750,3811,-24,37,120,457.32,780
,20170406,3750,3811,3730,3730,3620,3620,3691,-191,-120,600,"2,214.72",720
,20170407,3620,3691,3510,3510,3510,3510,3510,-181,-181,60,210.60,720
,20170410,3510,3510,3530,3530,3530,3530,3530,20,20,60,211.80,660
,20170411,3530,3530,3540,3540,3495,3495,3517,-35,-13,120,422.10,600
,20170412,3495,3517,3480,3480,3480,3480,3480,-37,-37,60,208.80,540
,20170413,3480,3480,,,,3480,3480,0,0,0,0.00,540
,20170414,3480,3480,,,,3480,3480,0,0,0,0.00,540
,20170417,3480,3480,,,,3480,3480,0,0,0,0.00,540
rb1705,20170103,2867,2911,2889,2998,2839,2851,2914,-60,3,2581552,"7,523,117.00",2526810
,20170104,2851,2914,2860,2957,2827,2930,2892,16,-22,3988998,"11,538,819.57",2531598
,20170105,2930,2892,2930,2998,2913,2941,2953,49,61,3639036,"10,747,806.51",2493862
,20170106,2941,2953,2940,2988,2900,2912,2943,-41,-10,3621876,"10,661,470.04",2505026
,20170109,2912,2943,2915,3049,2893,3048,2960,105,17,3590906,"10,630,289.60",2486996
,20170110,3048,2960,3048,3167,3028,3167,3095,207,135,3923264,"12,145,373.47",2580862
,20170111,3167,3095,3177,3202,3135,3182,3173,87,78,3167658,"10,051,200.83",2471864
,20170112,3182,3173,3179,3260,3158,3207,3212,34,39,3534488,"11,355,926.54",2690826
,20170113,3207,3212,3212,3247,3167,3194,3207,-18,-5,2951466,"9,466,254.50",2585936
,20170116,3194,3207,3190,3418,3173,3375,3318,168,111,4048262,"13,435,562.90",2667728
,20170117,3375,3318,3370,3402,3240,3284,3326,-34,8,3555120,"11,827,371.29",2527596
,20170118,3284,3326,3292,3350,3243,3292,3287,-34,-39,3353896,"11,024,837.56",2505772
,20170119,3292,3287,3280,3306,3220,3256,3262,-31,-25,3144640,"10,258,064.13",2531502
,20170120,3256,3262,3252,3296,3193,3194,3251,-68,-11,3147490,"10,233,397.44",2508784
,20170123,3194,3251,3191,3205,3143,3180,3174,-71,-77,2358234,"7,486,331.24",2345226
,20170124,3180,3174,3178,3344,3170,3292,3263,118,89,2952718,"9,635,420.70",2469476
,20170125,3292,3263,3300,3320,3255,3299,3287,36,24,1804324,"5,932,158.77",2265996
,20170126,3299,3287,3292,3380,3290,3369,3339,82,52,1896002,"6,331,520.87",2254872
,20170203,3369,3339,3349,3358,3071,3113,3174,-226,-165,2496492,"7,925,058.72",2244062
,20170206,3113,3174,3110,3132,3062,3082,3097,-92,-77,2416472,"7,484,513.32",2445734
,20170207,3082,3097,3090,3176,3067,3165,3129,68,32,2591874,"8,110,827.24",2472670
,20170208,3165,3129,3161,3248,3129,3243,3198,114,69,2989688,"9,561,839.95",2566662
,20170209,3243,3198,3248,3276,3202,3206,3239,8,41,2410544,"7,810,096.08",2528692
,20170210,3206,3239,3198,3398,3181,3328,3292,89,53,4366112,"14,374,678.23",2757728
,20170213,3328,3292,3351,3451,3332,3437,3399,145,107,3014236,"10,246,054.37",2750650
,20170214,3437,3399,3449,3450,3382,3442,3419,43,20,2325770,"7,953,807.13",2705168
,20170215,3442,3419,3442,3458,3350,3391,3412,-28,-7,3270782,"11,162,213.92",2854176
,20170216,3391,3412,3370,3509,3359,3381,3421,-31,9,4521314,"15,470,092.27",2782674
,20170217,3381,3421,3394,3489,3389,3473,3451,52,30,3593002,"12,402,049.07",2815816
,20170220,3473,3451,3481,3557,3461,3546,3517,95,66,3980198,"14,000,088.75",3194206
,20170221,3546,3517,3566,3630,3552,3575,3589,58,72,3226564,"11,580,913.52",3058306
,20170222,3575,3589,3572,3589,3508,3525,3546,-64,-43,3227458,"11,446,676.25",2943694
,20170223,3525,3546,3506,3566,3444,3483,3512,-63,-34,3698790,"12,992,034.52",2830814
,20170224,3483,3512,3512,3515,3373,3498,3449,-14,-63,3970238,"13,694,907.16",2856986
,20170227,3498,3449,3498,3648,3485,3612,3573,163,124,3932404,"14,051,960.21",3013542
,20170228,3612,3573,3610,3623,3467,3471,3564,-102,-9,3752392,"13,376,157.37",2851838
,20170301,3471,3564,3488,3579,3469,3542,3516,-22,-48,3596716,"12,647,990.98",2870166
,20170302,3542,3516,3545,3597,3525,3553,3558,37,42,2936158,"10,448,189.65",2882066
,20170303,3553,3558,3555,3567,3440,3566,3499,8,-59,4145656,"14,507,420.54",3087546
,20170306,3566,3499,3569,3580,3450,3467,3511,-32,12,4069720,"14,291,729.58",2897968
,20170307,3467,3511,3445,3509,3442,3494,3477,-17,-34,3009698,"10,465,203.90",2810242
,20170308,3494,3477,3492,3508,3410,3425,3459,-52,-18,3776446,"13,065,621.40",2975960
,20170309,3425,3459,3417,3444,3348,3389,3390,-70,-69,3374018,"11,440,928.61",2819092
,20170310,3389,3390,3385,3427,3380,3402,3404,12,14,2693822,"9,171,558.92",2796138
,20170313,3402,3404,3410,3606,3353,3604,3461,200,57,4616948,"15,981,531.27",2961672
,20170314,3604,3461,3603,3615,3556,3594,3585,133,124,2793100,"10,013,423.33",2815632
,20170315,3594,3585,3592,3692,3566,3641,3629,56,44,3284492,"11,920,356.27",2676568
,20170316,3641,3629,3630,3677,3575,3625,3621,-4,-8,2365448,"8,565,878.56",2469850
,20170317,3625,3621,3615,3628,3552,3575,3588,-46,-33,2009228,"7,211,096.76",2260584
,20170320,3575,3588,3571,3644,3560,3581,3599,-7,11,1887018,"6,792,063.90",2115278
,20170321,3581,3599,3580,3588,3470,3476,3524,-123,-75,1964284,"6,922,934.81",1773462
,20170322,3476,3524,3463,3498,3395,3405,3448,-119,-76,1615206,"5,570,686.47",1610564
,20170323,3405,3448,3409,3450,3400,3417,3429,-31,-19,973338,"3,337,730.64",1440258
,20170324,3417,3429,3411,3472,3388,3414,3429,-15,0,1020990,"3,501,512.90",1354532
,20170327,3414,3429,3412,3422,3243,3309,3322,-120,-107,1027344,"3,413,666.83",1173432
,20170328,3309,3322,3309,3374,3283,3298,3324,-24,2,646254,"2,148,697.95",1009600
,20170329,3298,3324,3310,3385,3303,3373,3338,49,14,652690,"2,179,227.21",941032
,20170330,3373,3338,3374,3400,3354,3379,3378,41,40,429502,"1,450,897.59",852436
,20170331,3379,3378,3370,3435,3360,3407,3398,29,20,562856,"1,912,841.32",785704
,20170405,3407,3398,3441,3499,3403,3458,3461,60,63,352456,"1,219,903.05",671880
,20170406,3458,3461,3463,3479,3411,3415,3438,-46,-23,258072,"887,442.17",597048
,20170407,3415,3438,3394,3399,3284,3319,3332,-119,-106,344124,"1,146,797.25",513244
,20170410,3319,3332,3320,3357,3315,3324,3332,-8,0,191542,"638,327.84",470354
,20170411,3324,3332,3310,3310,3256,3271,3281,-61,-51,213886,"701,883.25",426374
,20170412,3271,3281,3260,3275,3144,3154,3209,-127,-72,235488,"755,829.39",374466
,20170413,3154,3209,3149,3235,3148,3190,3193,-19,-16,157690,"503,645.83",343384
,20170414,3190,3193,3199,3260,3193,3216,3226,23,33,126410,"407,850.57",314114
,20170417,3216,3226,3219,3275,3192,3217,3226,-9,0,129558,"418,048.37",284092
,20170418,3217,3226,3214,3214,3055,3072,3131,-154,-95,183228,"573,690.08",236448
,20170419,3072,3131,3060,3110,3056,3091,3084,-40,-47,90896,"280,361.67",198942
,20170420,3091,3084,3098,3151,3023,3115,3083,31,-1,87726,"270,475.52",177290
,20170421,3115,3083,3119,3170,3096,3142,3134,59,51,82794,"259,514.77",152864
,20170424,3142,3134,3134,3159,3106,3153,3131,19,-3,55406,"173,481.29",126284
,20170425,3153,3131,3151,3210,3149,3202,3183,71,52,54266,"172,756.52",108352
,20170426,3202,3183,3192,3301,3192,3258,3248,75,65,51844,"168,437.52",96504
,20170427,3258,3248,3263,3317,3244,3315,3285,67,37,43684,"143,525.83",77718
,20170428,3315,3285,3317,3444,3317,3409,3375,124,90,55552,"187,529.87",44624
,20170502,3409,3375,3449,3493,3421,3483,3470,108,95,7724,"26,808.10",38280
,20170503,3483,3470,3473,3500,3470,3495,3486,25,16,5460,"19,036.86",33780
,20170504,3495,3486,3490,3490,3413,3453,3456,-33,-30,6720,"23,230.14",29760
,20170505,3453,3456,3442,3505,3442,3502,3483,46,27,7800,"27,173.28",23460
,20170508,3502,3483,3510,3625,3510,3625,3577,142,94,10260,"36,702.42",15360
,20170509,3625,3577,3666,3693,3613,3625,3650,48,73,6240,"22,780.68",10980
,20170510,3625,3650,3650,3900,3650,3894,3824,244,174,10560,"40,384.02",3420
,20170511,3894,3824,3894,3894,3700,3750,3816,-74,-8,1320,"5,037.84",2700
,20170512,3750,3816,3750,3750,3570,3620,3643,-196,-173,360,"1,311.60",2340
,20170515,3620,3643,3570,3570,3570,3570,3570,-73,-73,120,428.40,2220
rb1706,20170103,2839,2888,2877,2958,2822,2822,2910,-66,22,532,"1,548.28",1518
,20170104,2822,2910,2840,2929,2805,2908,2867,-2,-43,472,"1,353.34",1522
,20170105,2908,2867,2895,2964,2883,2928,2926,61,59,158,462.44,1528
,20170106,2928,2926,2901,2964,2870,2882,2909,-44,-17,374,"1,088.01",1588
,20170109,2882,2909,2870,3004,2870,3004,2934,95,25,250,733.61,1572
,20170110,3004,2934,3004,3139,3004,3138,3082,204,148,210,647.34,1572
,20170111,3138,3082,3136,3160,3100,3123,3137,41,55,228,715.34,1538
,20170112,3123,3137,3133,3201,3124,3169,3169,32,32,50,158.46,1546
,20170113,3169,3169,3190,3200,3153,3155,3176,-14,7,66,209.62,1544
,20170116,3155,3176,3140,3366,3134,3323,3275,147,99,132,432.34,1566
,20170117,3323,3275,3333,3363,3200,3220,3302,-55,27,56,184.91,1560
,20170118,3220,3302,3237,3319,3234,3247,3261,-55,-41,56,182.66,1558
,20170119,3247,3261,3260,3267,3181,3211,3212,-50,-49,188,603.97,1570
,20170120,3211,3212,3228,3245,3202,3202,3224,-10,12,70,225.73,1546
,20170123,3202,3224,3130,3154,3104,3148,3131,-76,-93,84,263.01,1512
,20170124,3148,3131,3156,3285,3154,3226,3249,95,118,168,545.90,1466
,20170125,3226,3249,3253,3267,3198,3265,3251,16,2,154,500.69,1450
,20170126,3265,3251,3265,3316,3265,3316,3288,65,37,90,295.93,1450
,20170203,3316,3288,3229,3229,3035,3080,3104,-208,-184,116,360.12,1462
,20170206,3080,3104,3092,3093,3034,3065,3068,-39,-36,188,576.79,1472
,20170207,3065,3068,3046,3132,3046,3124,3104,56,36,218,676.75,1422
,20170208,3124,3104,3134,3195,3098,3178,3153,74,49,120,378.39,1410
,20170209,3178,3153,3198,3234,3164,3166,3195,13,42,278,888.46,1428
,20170210,3166,3195,3146,3341,3141,3273,3240,78,45,140,453.63,1394
,20170213,3273,3240,3298,3411,3272,3394,3358,154,118,206,691.82,1388
,20170214,3394,3358,3386,3400,3331,3382,3361,24,3,156,524.43,1388
,20170215,3382,3361,3394,3394,3321,3340,3359,-21,-2,132,443.39,1374
,20170216,3340,3359,3339,3455,3322,3329,3384,-30,25,196,663.28,1370
,20170217,3329,3384,3356,3444,3356,3397,3408,13,24,290,988.49,1284
,20170220,3397,3408,3461,3499,3407,3483,3458,75,50,1190,"4,115.09",1094
,20170221,3483,3458,3506,3579,3503,3532,3536,74,78,204,721.40,998
,20170222,3532,3536,3530,3531,3462,3462,3496,-74,-40,128,447.57,960
,20170223,3462,3496,3480,3509,3416,3416,3454,-80,-42,140,483.68,946
,20170224,3416,3454,3436,3473,3336,3444,3434,-10,-20,712,"2,445.49",878
,20170227,3444,3434,3458,3593,3437,3544,3534,110,100,268,947.21,802
,20170228,3544,3534,3553,3569,3432,3433,3523,-101,-11,222,782.11,756
,20170301,3433,3523,3452,3500,3425,3460,3448,-63,-75,168,579.39,734
,20170302,3460,3448,3484,3524,3464,3484,3492,36,44,130,454.01,756
,20170303,3484,3492,3457,3482,3384,3482,3438,-10,-54,176,605.13,762
,20170306,3482,3438,3500,3542,3400,3400,3457,-38,19,228,788.23,788
,20170307,3400,3457,3379,3448,3379,3425,3429,-32,-28,96,329.27,768
,20170308,3425,3429,3424,3445,3360,3364,3393,-65,-36,182,617.57,804
,20170309,3364,3393,3366,3390,3300,3334,3363,-59,-30,236,793.84,806
,20170310,3334,3363,3334,3374,3320,3365,3353,2,-10,102,342.04,844
,20170313,3365,3353,3343,3526,3317,3514,3395,161,42,320,"1,086.66",754
,20170314,3514,3395,3544,3548,3494,3522,3520,127,125,196,689.94,734
,20170315,3522,3520,3540,3605,3487,3549,3539,29,19,156,552.14,700
,20170316,3549,3539,3566,3596,3510,3557,3565,18,26,624,"2,224.69",690
,20170317,3557,3565,3534,3534,3480,3523,3512,-42,-53,462,"1,622.68",892
,20170320,3523,3512,3503,3563,3486,3486,3509,-26,-3,414,"1,452.84",726
,20170321,3486,3509,3491,3491,3399,3402,3445,-107,-64,178,613.32,756
,20170322,3402,3445,3388,3440,3320,3331,3382,-114,-63,242,818.61,794
,20170323,3331,3382,3338,3364,3328,3363,3346,-19,-36,86,287.78,766
,20170324,3363,3346,3316,3380,3316,3326,3344,-20,-2,156,521.79,790
,20170327,3326,3344,3327,3340,3175,3235,3257,-109,-87,240,781.77,784
,20170328,3235,3257,3235,3294,3214,3214,3245,-43,-12,112,363.54,776
,20170329,3214,3245,3250,3300,3237,3300,3270,55,25,140,457.87,738
,20170330,3300,3270,3291,3323,3291,3306,3307,36,37,542,"1,792.67",782
,20170331,3306,3307,3304,3358,3286,3314,3325,7,18,230,764.97,746
,20170405,3314,3325,3350,3395,3329,3340,3370,15,45,166,559.54,730
,20170406,3340,3370,3340,3368,3310,3336,3348,-34,-22,116,388.48,718
,20170407,3336,3348,3300,3300,3200,3218,3244,-130,-104,342,"1,109.48",802
,20170410,3218,3244,3232,3264,3224,3228,3247,-16,3,100,324.71,810
,20170411,3228,3247,3195,3224,3181,3195,3199,-52,-48,228,729.38,776
,20170412,3195,3199,3181,3191,3072,3081,3121,-118,-78,292,911.49,844
,20170413,3081,3121,3101,3140,3048,3107,3113,-14,-8,356,"1,108.35",632
,20170414,3107,3113,3124,3177,3092,3105,3116,-8,3,388,"1,209.37",574
,20170417,3105,3116,3140,3169,3076,3125,3117,9,1,284,885.47,558
,20170418,3125,3117,3112,3116,2981,2981,3057,-136,-60,212,648.18,568
,20170419,2981,3057,2981,3030,2979,3008,3005,-49,-52,340,"1,022.04",612
,20170420,3008,3005,3029,3063,2958,3030,3013,25,8,242,729.36,594
,20170421,3030,3013,3043,3070,3012,3055,3047,42,34,556,"1,694.19",610
,20170424,3055,3047,3034,3049,3000,3047,3021,0,-26,90,271.91,610
,20170425,3047,3021,3065,3099,3050,3090,3071,69,50,188,577.40,652
,20170426,3090,3071,3096,3153,3073,3120,3128,49,57,166,519.32,650
,20170427,3120,3128,3109,3139,3109,3135,3121,7,-7,132,412.02,608
,20170428,3135,3121,3158,3243,3154,3238,3201,117,80,282,902.77,720
,20170502,3238,3201,3166,3282,3166,3261,3253,60,52,306,995.65,838
,20170503,3261,3253,3274,3307,3235,3305,3282,52,29,476,"1,562.53",880
,20170504,3305,3282,3284,3284,3146,3194,3236,-88,-46,464,"1,501.78",1034
,20170505,3194,3236,3170,3256,3170,3224,3228,-12,-8,286,923.32,1130
,20170508,3224,3228,3283,3381,3251,3332,3318,104,90,340,"1,128.42",1074
,20170509,3332,3318,3323,3340,3299,3320,3317,2,-1,190,630.41,1058
,20170510,3320,3317,3319,3462,3319,3456,3409,139,92,302,"1,029.73",1130
,20170511,3456,3409,3466,3520,3339,3424,3445,15,36,470,"1,619.52",982
,20170512,3424,3445,3422,3422,3358,3365,3381,-80,-64,124,419.30,928
,20170515,3365,3381,3365,3387,3310,3366,3359,-15,-22,176,591.19,834
,20170516,3366,3359,3359,3385,3333,3370,3365,11,6,270,908.58,764
,20170517,3370,3365,3352,3433,3331,3420,3395,55,30,80,271.66,768
,20170518,3420,3395,3450,3500,3411,3468,3449,73,54,330,"1,138.38",520
,20170519,3468,3449,3459,3545,3459,3543,3516,94,67,106,372.73,502
,20170522,3543,3516,3588,3728,3561,3700,3653,184,137,230,840.29,444
,20170523,3700,3653,3738,3738,3634,3678,3693,25,40,206,760.83,382
,20170524,3678,3693,3652,3735,3624,3681,3691,-12,-2,200,738.28,336
,20170525,3681,3691,3602,3730,3602,3690,3691,-1,0,92,339.63,304
,20170526,3690,3691,3747,3747,3675,3745,3719,54,28,124,461.25,278
,20170531,3745,3719,3975,3995,3726,3986,3865,267,146,362,"1,399.37",240
,20170601,3986,3865,3999,3999,3999,3999,3999,134,134,60,239.94,240
,20170602,3999,3999,3801,3801,3800,3800,3800,-199,-199,120,456.06,240
,20170605,3800,3800,3550,3550,3550,3550,3550,-250,-250,60,213.00,180
,20170606,3550,3550,,,,3550,3550,0,0,0,0.00,180
,20170607,3550,3550,3795,3795,3795,3795,3795,245,245,60,227.70,180
,20170608,3795,3795,,,,3795,3795,0,0,0,0.00,180
,20170609,3795,3795,,,,3795,3795,0,0,0,0.00,180
,20170612,3795,3795,,,,3795,3795,0,0,0,0.00,180
,20170613,3795,3795,3800,3800,3800,3800,3800,5,5,60,228.00,120
,20170614,3800,3800,,,,3800,3800,0,0,0,0.00,120
,20170615,3800,3800,,,,3800,3800,0,0,0,0.00,120
rb1707,20170103,2865,2869,2868,2927,2850,2850,2900,-19,31,24,69.62,1248
,20170104,2850,2900,2830,2907,2801,2907,2829,7,-71,136,384.83,1268
,20170105,2907,2829,2921,2935,2921,2935,2928,106,99,4,11.71,1264
,20170106,2935,2928,2929,2929,2880,2880,2918,-48,-10,16,46.70,1270
,20170109,2880,2918,2880,2966,2823,2966,2930,48,12,60,175.83,1280
,20170110,2966,2930,2986,3120,2978,3120,3022,190,92,134,404.96,1280
,20170111,3120,3022,3122,3130,3082,3082,3114,60,92,144,448.45,1286
,20170112,3082,3114,3104,3190,3087,3130,3145,16,31,42,132.09,1290
,20170113,3130,3145,3163,3170,3103,3103,3151,-42,6,16,50.42,1288
,20170116,3103,3151,3107,3315,3099,3310,3242,159,91,30,97.28,1286
,20170117,3310,3242,3310,3316,3206,3206,3264,-36,22,50,163.25,1294
,20170118,3206,3264,3223,3276,3200,3234,3245,-30,-19,200,649.17,1244
,20170119,3234,3245,3224,3227,3173,3220,3189,-25,-56,38,121.20,1250
,20170120,3220,3189,3207,3248,3150,3150,3213,-39,24,14,44.98,1246
,20170123,3150,3213,3124,3148,3119,3131,3130,-82,-83,216,676.19,1228
,20170124,3131,3130,3150,3275,3150,3230,3232,100,102,90,290.91,1152
,20170125,3230,3232,3251,3251,3187,3219,3194,-13,-38,190,606.86,1118
,20170126,3219,3194,3277,3277,3275,3277,3276,83,82,12,39.32,1116
,20170203,3277,3276,3204,3214,3050,3070,3121,-206,-155,200,624.36,1118
,20170206,3070,3121,3028,3082,3027,3064,3060,-57,-61,104,318.34,1122
,20170207,3064,3060,3055,3123,3055,3111,3101,51,41,32,99.24,1108
,20170208,3111,3101,3103,3200,3103,3187,3135,86,34,374,"1,172.57",1238
,20170209,3187,3135,3230,3230,3179,3210,3203,75,68,102,326.71,1220
,20170210,3210,3203,3207,3314,3197,3268,3265,65,62,122,398.42,1178
,20170213,3268,3265,3286,3366,3277,3352,3310,87,45,60,198.61,1142
,20170214,3352,3310,3367,3367,3276,3318,3344,8,34,44,147.16,1122
,20170215,3318,3344,3305,3350,3305,3350,3337,6,-7,48,160.22,1084
,20170216,3350,3337,3354,3472,3294,3310,3358,-27,21,46,154.48,1070
,20170217,3310,3358,3322,3389,3322,3389,3367,31,9,48,161.63,1056
,20170220,3389,3367,3436,3450,3436,3446,3443,79,76,32,110.20,1072
,20170221,3446,3443,3471,3521,3464,3469,3495,26,52,126,440.47,1040
,20170222,3469,3495,3501,3507,3436,3440,3469,-55,-26,46,159.60,1042
,20170223,3440,3469,3438,3482,3372,3372,3398,-97,-71,98,333.08,1080
,20170224,3372,3398,3414,3414,3305,3400,3361,2,-37,60,201.66,1060
,20170227,3400,3361,3444,3534,3396,3500,3458,139,97,104,359.72,1026
,20170228,3500,3458,3507,3535,3462,3462,3487,4,29,18,62.77,1024
,20170301,3462,3487,3393,3454,3393,3442,3432,-45,-55,16,54.91,1024
,20170302,3442,3432,3452,3486,3440,3457,3455,25,23,24,82.93,1032
,20170303,3457,3455,3452,3452,3360,3429,3406,-26,-49,48,163.51,1032
,20170306,3429,3406,3451,3454,3349,3366,3396,-40,-10,150,509.51,1038
,20170307,3366,3396,3303,3400,3301,3390,3369,-6,-27,106,357.20,1044
,20170308,3390,3369,3388,3390,3307,3307,3353,-62,-16,86,288.41,1004
,20170309,3307,3353,3331,3331,3240,3270,3270,-83,-83,34,111.20,1000
,20170310,3270,3270,3303,3303,3303,3303,3303,33,33,2,6.61,1000
,20170313,3303,3303,3320,3436,3309,3436,3377,133,74,76,256.69,1024
,20170314,3436,3377,3415,3461,3402,3461,3445,84,68,110,379.03,1022
,20170315,3461,3445,3457,3547,3443,3499,3504,54,59,114,399.50,1014
,20170316,3499,3504,3510,3525,3455,3503,3493,-1,-11,50,174.69,996
,20170317,3503,3493,3484,3492,3423,3476,3466,-17,-27,88,305.05,978
,20170320,3476,3466,3441,3503,3441,3445,3463,-21,-3,102,353.26,982
,20170321,3445,3463,3406,3443,3352,3352,3390,-111,-73,42,142.40,988
,20170322,3352,3390,3338,3358,3272,3280,3311,-110,-79,68,225.17,998
,20170323,3280,3311,3273,3320,3273,3278,3287,-33,-24,62,203.79,956
,20170324,3278,3287,3268,3305,3253,3254,3276,-33,-11,92,301.41,920
,20170327,3254,3276,3244,3254,3096,3138,3176,-138,-100,70,222.37,906
,20170328,3138,3176,3166,3218,3148,3149,3174,-27,-2,104,330.13,894
,20170329,3149,3174,3164,3242,3164,3242,3196,68,22,66,211.00,902
,20170330,3242,3196,3239,3263,3210,3210,3238,14,42,62,200.78,898
,20170331,3210,3238,3238,3303,3222,3239,3252,1,14,52,169.10,904
,20170405,3239,3252,3292,3345,3275,3293,3309,41,57,148,489.88,914
,20170406,3293,3309,3304,3316,3265,3265,3287,-44,-22,78,256.39,924
,20170407,3265,3287,3224,3225,3134,3138,3192,-149,-95,200,638.41,916
,20170410,3138,3192,3162,3191,3135,3135,3160,-57,-32,28,88.50,930
,20170411,3135,3160,3125,3151,3111,3131,3135,-29,-25,46,144.22,930
,20170412,3131,3135,3116,3122,3030,3030,3057,-105,-78,96,293.53,870
,20170413,3030,3057,3031,3080,3031,3050,3064,-7,7,38,116.46,878
,20170414,3050,3064,3068,3115,3059,3079,3089,15,25,32,98.86,876
,20170417,3079,3089,3100,3134,3034,3070,3068,-19,-21,238,730.24,884
,20170418,3070,3068,3068,3078,2956,2956,3015,-112,-53,206,621.23,920
,20170419,2956,3015,2937,2996,2920,2983,2969,-32,-46,212,629.63,898
,20170420,2983,2969,3008,3022,2911,2963,2940,-6,-29,426,"1,252.62",914
,20170421,2963,2940,3005,3030,2976,3011,2998,71,58,262,785.73,890
,20170424,3011,2998,3001,3015,2932,3015,2979,17,-19,184,548.16,830
,20170425,3015,2979,3031,3176,3012,3031,3024,52,45,78,235.89,880
,20170426,3031,3024,3039,3105,3039,3047,3066,23,42,14,42.93,880
,20170427,3047,3066,3064,3100,3064,3084,3075,18,9,84,258.31,858
,20170428,3084,3075,3134,3196,3127,3185,3153,110,78,52,163.98,846
,20170502,3185,3153,3233,3260,3201,3232,3226,79,73,198,638.76,828
,20170503,3232,3226,3224,3238,3206,3235,3223,9,-3,156,502.81,874
,20170504,3235,3223,3222,3222,3082,3082,3147,-141,-76,164,516.14,874
,20170505,3082,3147,3067,3125,3067,3123,3095,-24,-52,60,185.74,884
,20170508,3123,3095,3180,3228,3148,3218,3183,123,88,206,655.79,970
,20170509,3218,3183,3222,3241,3196,3209,3212,26,29,56,179.88,968
,20170510,3209,3212,3241,3333,3241,3313,3286,101,74,236,775.57,982
,20170511,3313,3286,3341,3366,3267,3312,3323,26,37,300,997.01,928
,20170512,3312,3323,3312,3312,3224,3224,3262,-99,-61,74,241.41,902
,20170515,3224,3262,3221,3272,3216,3272,3245,10,-17,92,298.63,938
,20170516,3272,3245,3245,3288,3230,3247,3259,2,14,210,684.60,886
,20170517,3247,3259,3288,3349,3286,3345,3316,86,57,88,291.86,880
,20170518,3345,3316,3336,3407,3325,3390,3362,74,46,194,652.23,878
,20170519,3390,3362,3382,3465,3382,3460,3451,98,89,202,697.11,876
,20170522,3460,3451,3482,3605,3480,3589,3550,138,99,142,504.11,856
,20170523,3589,3550,3607,3658,3518,3565,3594,15,44,818,"2,940.02",954
,20170524,3565,3594,3538,3558,3478,3536,3525,-58,-69,322,"1,135.26",1006
,20170525,3536,3525,3455,3578,3455,3510,3539,-15,14,104,368.11,984
,20170526,3510,3539,3500,3609,3500,3609,3554,70,15,288,"1,023.76",1122
,20170531,3609,3554,3652,3685,3570,3610,3612,56,58,236,852.46,1188
,20170601,3610,3612,3600,3649,3590,3629,3617,17,5,162,585.98,1184
,20170602,3629,3617,3604,3642,3599,3615,3608,-2,-9,344,"1,241.16",1242
,20170605,3615,3608,3600,3619,3569,3570,3601,-38,-7,544,"1,959.01",1454
,20170606,3570,3601,3544,3579,3520,3561,3550,-40,-51,220,781.17,1448
,20170607,3561,3550,3552,3589,3552,3561,3568,11,18,190,678.05,1480
,20170608,3561,3568,3568,3601,3550,3574,3581,6,13,140,501.46,1468
,20170609,3574,3581,3572,3596,3566,3585,3584,4,3,150,537.70,1452
,20170612,3585,3584,3600,3606,3581,3595,3599,11,15,92,331.19,1440
,20170613,3595,3599,3553,3654,3553,3567,3585,-32,-14,60,215.14,1446
,20170614,3567,3585,3568,3624,3560,3624,3608,39,23,176,635.04,1374
,20170615,3624,3608,3616,3618,3585,3585,3598,-23,-10,140,503.81,1348
,20170616,3585,3598,3615,3615,3584,3591,3598,-7,0,280,"1,007.65",1378
,20170619,3591,3598,3599,3640,3590,3601,3599,3,1,274,986.38,1264
,20170620,3601,3599,3600,3643,3577,3584,3588,-15,-11,560,"2,009.83",890
,20170621,3584,3588,3556,3556,3540,3555,3549,-33,-39,316,"1,121.51",708
,20170622,3555,3549,3598,3600,3549,3581,3584,32,35,34,121.86,704
,20170623,3581,3584,3543,3588,3539,3571,3576,-13,-8,36,128.75,708
,20170626,3571,3576,3589,3605,3545,3560,3573,-16,-3,234,836.24,640
,20170627,3560,3573,3565,3774,3495,3609,3581,36,8,158,565.94,602
,20170628,3609,3581,3630,3648,3591,3626,3622,45,41,136,492.72,516
,20170629,3626,3622,3592,3629,3592,3600,3605,-22,-17,48,173.07,494
,20170630,3600,3605,3634,3857,3583,3650,3692,45,87,356,"1,314.55",422
,20170703,3650,3692,3800,3800,3800,3800,3800,108,108,62,235.60,360
,20170704,3800,3800,,,,3780,3780,-20,-20,0,0.00,360
,20170705,3780,3780,,,,3770,3770,-10,-10,0,0.00,360
,20170706,3770,3770,,,,3700,3700,-70,-70,0,0.00,360
,20170707,3700,3700,3650,3650,3650,3650,3650,-50,-50,60,219.00,360
,20170710,3650,3650,,,,3650,3650,0,0,0,0.00,360
,20170711,3650,3650,,,,3650,3650,0,0,0,0.00,360
,20170712,3650,3650,,,,3650,3650,0,0,0,0.00,360
,20170713,3650,3650,,,,3650,3650,0,0,0,0.00,360
,20170714,3650,3650,,,,3650,3650,0,0,0,0.00,360
,20170717,3650,3650,,,,3650,3650,0,0,0,0.00,360
rb1708,20170103,2841,2867,2860,2909,2860,2899,2896,32,29,22,63.71,184
,20170104,2899,2896,2826,2871,2810,2869,2838,-27,-58,200,567.68,294
,20170105,2869,2838,2878,2936,2859,2890,2895,52,57,80,231.66,326
,20170106,2890,2895,2875,2900,2833,2833,2880,-62,-15,22,63.37,332
,20170109,2833,2880,2848,2968,2847,2966,2918,86,38,32,93.40,322
,20170110,2966,2918,2980,3087,2965,3087,3002,169,84,42,126.09,310
,20170111,3087,3002,3113,3123,3034,3069,3091,67,89,78,241.16,310
,20170112,3069,3091,3090,3164,3083,3141,3117,50,26,42,130.94,314
,20170113,3141,3117,3120,3125,3085,3085,3100,-32,-17,10,31.00,314
,20170116,3085,3100,3139,3283,3139,3283,3226,183,126,64,206.51,310
,20170117,3283,3226,3272,3287,3164,3194,3233,-32,7,64,206.92,324
,20170118,3194,3233,3185,3250,3184,3218,3199,-15,-34,92,294.39,286
,20170119,3218,3199,3205,3215,3144,3199,3183,0,-16,52,165.53,286
,20170120,3199,3183,3210,3210,3138,3138,3188,-45,5,16,51.01,286
,20170123,3138,3188,3110,3139,3107,3130,3123,-58,-65,56,174.92,294
,20170124,3130,3123,3136,3247,3125,3216,3213,93,90,128,411.36,386
,20170125,3216,3213,3238,3238,3201,3233,3217,20,4,200,643.51,268
,20170126,3233,3217,3224,3264,3224,3263,3258,46,41,42,136.85,290
,20170203,3263,3258,3062,3224,3060,3095,3119,-163,-139,124,386.81,294
,20170206,3095,3119,3087,3087,3067,3067,3079,-52,-40,70,215.54,330
,20170207,3067,3079,3055,3127,3055,3121,3089,42,10,92,284.25,372
,20170208,3121,3089,3119,3184,3106,3178,3153,89,64,10,31.53,368
,20170209,3178,3153,3198,3201,3176,3176,3195,23,42,68,217.31,370
,20170210,3176,3195,3156,3335,3152,3266,3283,71,88,100,328.31,432
,20170213,3266,3283,3299,3391,3299,3385,3373,102,90,36,121.43,444
,20170214,3385,3373,3391,3391,3306,3372,3330,-1,-43,248,826.01,378
,20170215,3372,3330,3367,3388,3286,3332,3325,2,-5,38,126.35,370
,20170216,3332,3325,3310,3392,3294,3304,3331,-21,6,14,46.63,366
,20170217,3304,3331,3310,3387,3295,3359,3341,28,10,90,300.71,318
,20170220,3359,3341,3407,3437,3352,3407,3405,66,64,146,497.22,336
,20170221,3407,3405,3451,3500,3449,3463,3473,58,68,28,97.25,324
,20170222,3463,3473,3482,3489,3417,3426,3472,-47,-1,154,534.79,406
,20170223,3426,3472,3420,3469,3403,3431,3424,-41,-48,28,95.89,396
,20170224,3431,3424,3422,3432,3330,3432,3384,8,-40,38,128.61,396
,20170227,3432,3384,3446,3531,3432,3531,3491,147,107,72,251.36,450
,20170228,3531,3491,3511,3522,3418,3418,3490,-73,-1,90,314.10,430
,20170301,3418,3490,3390,3438,3390,3438,3410,-52,-80,24,81.84,428
,20170302,3438,3410,3449,3473,3447,3447,3453,37,43,14,48.35,434
,20170303,3447,3453,3443,3443,3338,3417,3380,-36,-73,56,189.28,410
,20170306,3417,3380,3475,3475,3344,3344,3423,-36,43,24,82.16,426
,20170307,3344,3423,3354,3393,3354,3364,3371,-59,-52,38,128.11,446
,20170308,3364,3371,3382,3382,3293,3293,3345,-78,-26,52,173.97,434
,20170309,3293,3345,3311,3311,3212,3241,3238,-104,-107,58,187.84,438
,20170310,3241,3238,3269,3278,3232,3259,3243,21,5,28,90.81,436
,20170313,3259,3243,3285,3341,3285,3341,3317,98,74,90,298.54,438
,20170314,3341,3317,3396,3397,3365,3385,3380,68,63,78,263.71,448
,20170315,3385,3380,3363,3490,3363,3486,3435,106,55,28,96.21,444
,20170316,3486,3435,3491,3491,3449,3485,3471,50,36,20,69.43,434
,20170317,3485,3471,3472,3472,3378,3446,3449,-25,-22,30,103.49,442
,20170320,3446,3449,3445,3465,3371,3371,3437,-78,-12,258,886.91,474
,20170321,3371,3437,3388,3388,3314,3315,3340,-122,-97,48,160.33,474
,20170322,3315,3340,3286,3302,3178,3218,3244,-122,-96,44,142.74,456
,20170323,3218,3244,3215,3255,3215,3232,3237,-12,-7,12,38.84,456
,20170324,3232,3237,3213,3242,3204,3242,3219,5,-18,6,19.32,452
,20170327,3242,3219,3208,3227,3090,3127,3158,-92,-61,80,252.67,484
,20170328,3127,3158,3160,3200,3140,3140,3171,-18,13,40,126.86,478
,20170329,3140,3171,3170,3237,3170,3215,3195,44,24,48,153.41,472
,20170330,3215,3195,3240,3245,3201,3201,3231,6,36,62,200.34,454
,20170331,3201,3231,3204,3264,3204,3250,3242,19,11,22,71.33,452
,20170405,3250,3242,3267,3325,3267,3280,3301,38,59,18,59.43,452
,20170406,3280,3301,3265,3266,3223,3231,3236,-70,-65,20,64.73,440
,20170407,3231,3236,3203,3203,3081,3100,3148,-136,-88,52,163.70,454
,20170410,3100,3148,3106,3358,3106,3113,3137,-35,-11,152,476.89,424
,20170411,3113,3137,3086,3113,3086,3113,3103,-24,-34,6,18.62,422
,20170412,3113,3103,3044,3044,2986,3011,3008,-92,-95,12,36.10,416
,20170413,3011,3008,3011,3071,3011,3049,3045,41,37,14,42.63,420
,20170414,3049,3045,3035,3080,2982,3024,3019,-21,-26,148,446.83,464
,20170417,3024,3019,2963,3008,2963,2992,2973,-27,-46,56,166.49,444
,20170418,2992,2973,3011,3035,2899,2899,2960,-74,-13,142,420.44,510
,20170419,2899,2960,2912,2952,2912,2952,2935,-8,-25,178,522.53,452
,20170420,2952,2935,2900,2974,2886,2960,2939,25,4,172,505.68,466
,20170421,2960,2939,2978,3031,2963,2974,2985,35,46,114,340.38,508
,20170424,2974,2985,3005,3005,2954,2969,2981,-16,-4,12,35.78,514
,20170425,2969,2981,3004,3005,2996,2996,3000,15,19,26,78.01,516
,20170426,2996,3000,3016,3061,3016,3061,3043,61,43,12,36.52,514
,20170427,3061,3043,,,,3043,3043,0,0,0,0.00,514
,20170428,3043,3043,,,,3043,3043,0,0,0,0.00,514
,20170502,3043,3043,3151,3220,3151,3207,3202,164,159,164,525.23,518
,20170503,3207,3202,3190,3217,3169,3217,3191,15,-11,26,82.97,506
,20170504,3217,3191,3160,3160,2980,3005,3059,-186,-132,64,195.78,494
,20170505,3005,3059,3031,3072,2943,3024,3026,-35,-33,122,369.27,514
,20170508,3024,3026,3050,3110,3050,3079,3084,53,58,38,117.22,516
,20170509,3079,3084,3118,3133,3086,3115,3105,31,21,26,80.73,526
,20170510,3115,3105,3125,3199,3125,3195,3179,90,74,128,406.91,524
,20170511,3195,3179,3214,3238,3121,3213,3162,34,-17,166,524.97,538
,20170512,3213,3162,3187,3187,3149,3149,3167,-13,5,14,44.34,526
,20170515,3149,3167,3110,3170,3110,3170,3113,3,-54,32,99.64,498
,20170516,3170,3113,3132,3155,3125,3125,3148,12,35,60,188.89,490
,20170517,3125,3148,3195,3259,3195,3259,3228,111,80,66,213.08,482
,20170518,3259,3228,3259,3295,3244,3295,3255,67,27,64,208.37,506
,20170519,3295,3255,3281,3378,3274,3378,3352,123,97,82,274.88,510
,20170522,3378,3352,3385,3499,3385,3488,3478,136,126,148,514.87,540
,20170523,3488,3478,3490,3499,3442,3444,3474,-34,-4,134,465.59,596
,20170524,3444,3474,3451,3475,3358,3398,3417,-76,-57,36,123.02,594
,20170525,3398,3417,3396,3434,3368,3374,3390,-43,-27,388,"1,315.45",648
,20170526,3374,3390,3365,3440,3356,3440,3409,50,19,352,"1,200.13",632
,20170531,3440,3409,3399,3469,3357,3425,3410,16,1,132,450.13,652
,20170601,3425,3410,3395,3481,3386,3420,3413,10,3,138,471.01,642
,20170602,3420,3413,3384,3450,3384,3430,3431,17,18,674,"2,313.08",1030
,20170605,3430,3431,3431,3454,3352,3361,3389,-70,-42,316,"1,071.16",1046
,20170606,3361,3389,3302,3369,3302,3368,3353,-21,-36,110,368.83,1014
,20170607,3368,3353,3392,3403,3340,3366,3364,13,11,48,161.51,1020
,20170608,3366,3364,3369,3408,3332,3365,3370,1,6,90,303.32,1014
,20170609,3365,3370,3369,3394,3369,3380,3382,10,12,120,405.85,946
,20170612,3380,3382,3413,3435,3385,3414,3412,32,30,100,341.25,940
,20170613,3414,3412,3429,3429,3318,3323,3381,-89,-31,124,419.26,944
,20170614,3323,3381,3336,3468,3332,3468,3408,87,27,68,231.76,942
,20170615,3468,3408,3457,3499,3411,3444,3472,36,64,198,687.54,924
,20170616,3444,3472,3467,3481,3407,3450,3443,-22,-29,162,557.88,946
,20170619,3450,3443,3449,3475,3428,3450,3444,7,1,368,"1,267.73",700
,20170620,3450,3444,3430,3431,3380,3389,3397,-55,-47,170,577.63,666
,20170621,3389,3397,3378,3378,3322,3360,3349,-37,-48,398,"1,333.05",592
,20170622,3360,3349,3403,3403,3342,3346,3374,-3,25,132,445.46,606
,20170623,3346,3374,3306,3390,3305,3390,3339,16,-35,50,166.99,608
,20170626,3390,3339,3405,3441,3340,3393,3404,54,65,434,"1,477.38",684
,20170627,3393,3404,3412,3456,3382,3445,3401,41,-3,350,"1,190.54",840
,20170628,3445,3401,3474,3510,3442,3505,3482,104,81,160,557.21,844
,20170629,3505,3482,3520,3550,3497,3526,3526,44,44,96,338.53,876
,20170630,3526,3526,3520,3550,3493,3550,3520,24,-6,136,478.76,960
,20170703,3550,3520,3561,3598,3540,3598,3572,78,52,82,292.92,962
,20170704,3598,3572,3525,3646,3525,3560,3592,-12,20,94,337.66,980
,20170705,3560,3592,3623,3658,3603,3637,3625,45,33,70,253.81,992
,20170706,3637,3625,3620,3678,3607,3678,3636,53,11,170,618.28,992
,20170707,3678,3636,3661,3681,3646,3679,3660,43,24,68,248.93,988
,20170710,3679,3660,3684,3698,3669,3693,3684,33,24,112,412.70,1008
,20170711,3693,3684,3694,3810,3694,3810,3765,126,81,82,308.75,1002
,20170712,3810,3765,3786,3811,3784,3790,3802,25,37,208,791.00,942
,20170713,3790,3802,3776,3802,3776,3800,3795,-2,-7,136,516.21,946
,20170714,3800,3795,3784,3786,3756,3772,3770,-23,-25,132,497.76,922
,20170717,3772,3770,3810,3817,3791,3817,3811,47,41,90,343.05,930
,20170718,3817,3811,3798,3798,3794,3794,3796,-17,-15,4,15.18,930
,20170719,3794,3796,3788,3834,3788,3833,3816,37,20,26,99.24,916
,20170720,3833,3816,3828,3828,3770,3770,3797,-46,-19,100,379.70,894
,20170721,3770,3797,3771,3822,3745,3800,3776,3,-21,46,173.73,892
,20170724,3800,3776,3862,3862,3770,3812,3803,36,27,58,220.61,900
,20170725,3812,3803,3800,3925,3800,3884,3891,81,88,88,342.41,866
,20170726,3884,3891,3929,3929,3906,3910,3919,19,28,94,368.39,852
,20170727,3910,3919,3916,3916,3871,3881,3897,-38,-22,260,"1,013.41",888
,20170728,3881,3897,3888,3922,3872,3922,3901,25,4,92,358.98,878
,20170731,3922,3901,3914,4166,3881,4100,3992,199,91,316,"1,261.59",720
,20170801,4100,3992,,,,3947,3947,-45,-45,0,0.00,720
,20170802,3947,3947,,,,3947,3947,0,0,0,0.00,720
,20170803,3947,3947,,,,3947,3947,0,0,0,0.00,720
,20170804,3947,3947,,,,3950,3950,3,3,0,0.00,720
,20170807,3950,3950,,,,3950,3950,0,0,0,0.00,720
,20170808,3950,3950,,,,3963,3963,13,13,0,0.00,720
,20170809,3963,3963,,,,3963,3963,0,0,0,0.00,720
,20170810,3963,3963,4209,4209,4209,4209,4209,246,246,60,252.54,720
,20170811,4209,4209,,,,4209,4209,0,0,0,0.00,720
,20170814,4209,4209,,,,4209,4209,0,0,0,0.00,720
,20170815,4209,4209,,,,4209,4209,0,0,0,0.00,720
rb1709,20170103,2853,2887,2863,2950,2817,2823,2904,-64,17,1720,"4,996.36",3256
,20170104,2823,2904,2791,2917,2791,2898,2856,-6,-48,1848,"5,279.00",3312
,20170105,2898,2856,2897,2955,2880,2900,2920,44,64,1700,"4,964.03",3352
,20170106,2900,2920,2895,2943,2861,2869,2900,-51,-20,1052,"3,051.45",3234
,20170109,2869,2900,2873,2986,2856,2986,2915,86,15,1414,"4,123.20",3276
,20170110,2986,2915,2997,3119,2978,3115,3044,200,129,1816,"5,528.98",3496
,20170111,3115,3044,3115,3135,3085,3119,3115,75,71,1498,"4,667.75",3334
,20170112,3119,3115,3121,3190,3102,3148,3156,33,41,2158,"6,812.54",3368
,20170113,3148,3156,3157,3173,3108,3130,3141,-26,-15,1056,"3,317.62",3338
,20170116,3130,3141,3128,3339,3111,3301,3275,160,134,8448,"27,670.95",4098
,20170117,3301,3275,3284,3313,3193,3245,3254,-30,-21,1660,"5,402.51",3786
,20170118,3245,3254,3250,3287,3200,3239,3234,-15,-20,1168,"3,777.32",3574
,20170119,3239,3234,3219,3249,3180,3208,3209,-26,-25,814,"2,612.75",3488
,20170120,3208,3209,3214,3249,3156,3159,3199,-50,-10,1632,"5,221.78",3332
,20170123,3159,3199,3159,3167,3113,3143,3137,-56,-62,818,"2,566.08",3388
,20170124,3143,3137,3136,3282,3136,3235,3211,98,74,1744,"5,600.20",3208
,20170125,3235,3211,3249,3250,3200,3240,3215,29,4,1370,"4,404.61",3680
,20170126,3240,3215,3248,3299,3237,3296,3266,81,51,982,"3,208.15",3668
,20170203,3296,3266,3270,3270,3014,3102,3155,-164,-111,6234,"19,673.96",3442
,20170206,3102,3155,3092,3115,3056,3077,3080,-78,-75,3020,"9,301.97",4054
,20170207,3077,3080,3055,3138,3055,3123,3094,43,14,2678,"8,286.67",5378
,20170208,3123,3094,3118,3190,3096,3181,3152,87,58,1530,"4,823.80",5238
,20170209,3181,3152,3181,3210,3158,3165,3187,13,35,836,"2,664.81",5210
,20170210,3165,3187,3199,3315,3140,3279,3236,92,49,2140,"6,925.33",5280
,20170213,3279,3236,3280,3380,3280,3378,3343,142,107,2224,"7,435.89",4984
,20170214,3378,3343,3386,3392,3325,3377,3358,34,15,2114,"7,099.97",4548
,20170215,3377,3358,3373,3375,3306,3331,3347,-27,-11,1350,"4,518.85",4562
,20170216,3331,3347,3333,3569,3301,3325,3369,-22,22,2970,"10,007.39",4852
,20170217,3325,3369,3325,3385,3325,3370,3366,1,-3,1666,"5,608.70",4662
,20170220,3370,3366,3370,3428,3357,3425,3401,59,35,2092,"7,115.94",4844
,20170221,3425,3401,3436,3488,3427,3441,3462,40,61,2036,"7,048.81",4828
,20170222,3441,3462,3439,3462,3390,3432,3422,-30,-40,2454,"8,398.69",4636
,20170223,3432,3422,3379,3451,3363,3386,3412,-36,-10,1498,"5,111.60",4696
,20170224,3386,3412,3395,3408,3302,3408,3363,-4,-49,1896,"6,376.35",4732
,20170227,3408,3363,3410,3503,3382,3471,3455,108,92,2838,"9,807.01",5036
,20170228,3471,3455,3470,3478,3350,3350,3438,-105,-17,3934,"13,527.68",5166
,20170301,3350,3438,3350,3438,3347,3416,3398,-22,-40,2510,"8,529.27",5048
,20170302,3416,3398,3411,3456,3400,3421,3427,23,29,2468,"8,457.89",5780
,20170303,3421,3427,3409,3429,3336,3405,3369,-22,-58,2412,"8,128.10",5734
,20170306,3405,3369,3398,3412,3319,3326,3358,-43,-11,3442,"11,561.12",6200
,20170307,3326,3358,3318,3366,3318,3352,3342,-6,-16,2232,"7,461.00",5986
,20170308,3352,3342,3346,3353,3273,3277,3310,-65,-32,2718,"8,999.16",6004
,20170309,3277,3310,3222,3288,3191,3244,3234,-66,-76,3268,"10,569.95",6384
,20170310,3244,3234,3236,3274,3225,3237,3255,3,21,2692,"8,764.34",5902
,20170313,3237,3255,3238,3387,3199,3387,3277,132,22,5318,"17,427.41",6632
,20170314,3387,3277,3400,3400,3308,3348,3348,71,71,3100,"10,379.77",6476
,20170315,3348,3348,3311,3497,3311,3451,3429,103,81,9504,"32,593.59",6612
,20170316,3451,3429,3459,3482,3400,3472,3446,43,17,5020,"17,301.63",6602
,20170317,3472,3446,3465,3470,3376,3409,3421,-37,-25,3354,"11,475.00",6314
,20170320,3409,3421,3395,3465,3372,3387,3421,-34,0,11014,"37,683.72",7596
,20170321,3387,3421,3385,3394,3275,3279,3322,-142,-99,6962,"23,131.08",8260
,20170322,3279,3322,3278,3291,3151,3163,3214,-159,-108,7724,"24,825.62",9222
,20170323,3163,3214,3150,3233,3150,3179,3202,-35,-12,7272,"23,288.91",9424
,20170324,3179,3202,3178,3250,3150,3198,3206,-4,4,10626,"34,076.46",8954
,20170327,3198,3206,3177,3196,3055,3108,3111,-98,-95,6642,"20,669.81",8786
,20170328,3108,3111,3105,3161,3086,3098,3118,-13,7,8038,"25,067.75",8132
,20170329,3098,3118,3118,3218,3114,3207,3174,89,56,5074,"16,106.57",8020
,20170330,3207,3174,3198,3225,3163,3183,3195,9,21,5694,"18,193.19",8142
,20170331,3183,3195,3178,3260,3150,3182,3201,-13,6,8956,"28,670.37",8102
,20170405,3182,3201,3230,3321,3215,3262,3286,61,85,13598,"44,690.48",9126
,20170406,3262,3286,3258,3288,3199,3205,3239,-81,-47,8642,"27,993.46",8432
,20170407,3205,3239,3190,3190,3032,3084,3111,-155,-128,9404,"29,260.36",8418
,20170410,3084,3111,3080,3144,3052,3067,3082,-44,-29,6688,"20,614.74",8832
,20170411,3067,3082,3051,3095,3027,3047,3059,-35,-23,5338,"16,333.68",8958
,20170412,3047,3059,3039,3055,2930,2938,2994,-121,-65,8910,"26,679.01",9796
,20170413,2938,2994,2942,3014,2920,2974,2971,-20,-23,9206,"27,358.39",8510
,20170414,2974,2971,2952,3058,2940,2984,3002,13,31,8090,"24,293.97",8356
,20170417,2984,3002,2987,3045,2940,2973,2990,-29,-12,7120,"21,292.71",8404
,20170418,2973,2990,2978,2990,2869,2878,2926,-112,-64,6238,"18,256.24",8846
,20170419,2878,2926,2861,2920,2861,2907,2889,-19,-37,8228,"23,772.89",9024
,20170420,2907,2889,2892,2978,2792,2940,2894,51,5,8426,"24,388.25",9084
,20170421,2940,2894,2926,3014,2923,2978,2970,84,76,7704,"22,888.25",8576
,20170424,2978,2970,2970,2990,2905,2973,2944,3,-26,7534,"22,186.45",9240
,20170425,2973,2944,2953,3003,2944,2993,2976,49,32,5788,"17,230.10",9042
,20170426,2993,2976,2998,3080,2981,3008,3025,32,49,7974,"24,122.44",9500
,20170427,3008,3025,2993,3066,2993,3056,3028,31,3,5832,"17,664.66",9734
,20170428,3056,3028,3057,3150,3056,3147,3107,119,79,10010,"31,103.65",11338
,20170502,3147,3107,3171,3195,3150,3177,3173,70,66,11502,"36,498.43",12684
,20170503,3177,3173,3180,3195,3138,3170,3166,-3,-7,14210,"44,993.98",13064
,20170504,3170,3166,3150,3164,2950,2974,3054,-192,-112,21270,"64,975.50",11038
,20170505,2974,3054,2971,3005,2922,2981,2977,-73,-77,19760,"58,835.77",10728
,20170508,2981,2977,2991,3076,2990,3051,3039,74,62,30484,"92,654.92",13518
,20170509,3051,3039,3042,3086,3031,3068,3052,29,13,13162,"40,177.67",13484
,20170510,3068,3052,3060,3139,3056,3134,3109,82,57,13702,"42,602.05",14092
,20170511,3134,3109,3144,3164,3024,3123,3087,14,-22,19692,"60,807.30",12846
,20170512,3123,3087,3125,3133,3016,3017,3069,-70,-18,17274,"53,017.51",12478
,20170515,3017,3069,3032,3109,2982,3071,3059,2,-10,12968,"39,672.86",12084
,20170516,3071,3059,3072,3088,3040,3070,3060,11,1,12254,"37,507.79",11740
,20170517,3070,3060,3086,3179,3069,3174,3136,114,76,17366,"54,468.16",13826
,20170518,3174,3136,3162,3231,3155,3226,3189,90,53,17160,"54,727.48",14282
,20170519,3226,3189,3201,3314,3164,3308,3256,119,67,20288,"66,059.83",15068
,20170522,3308,3256,3304,3447,3304,3403,3393,147,137,24888,"84,462.11",18018
,20170523,3403,3393,3409,3417,3351,3356,3382,-37,-11,17536,"59,315.86",16664
,20170524,3356,3382,3355,3383,3256,3314,3325,-68,-57,23596,"78,477.12",14564
,20170525,3314,3325,3301,3359,3280,3291,3318,-34,-7,18002,"59,739.38",13172
,20170526,3291,3318,3288,3319,3249,3315,3282,-3,-36,12730,"41,780.97",12788
,20170531,3315,3282,3310,3342,3208,3210,3261,-72,-21,12880,"42,013.05",12730
,20170601,3210,3261,3208,3258,3195,3245,3222,-16,-39,12700,"40,931.64",13572
,20170602,3245,3222,3245,3257,3202,3215,3223,-7,1,15782,"50,873.45",15930
,20170605,3215,3223,3209,3250,3117,3133,3188,-90,-35,20648,"65,832.75",15786
,20170606,3133,3188,3128,3150,3066,3138,3114,-50,-74,15682,"48,845.12",16306
,20170607,3138,3114,3136,3172,3114,3139,3143,25,29,8372,"26,317.41",16336
,20170608,3139,3143,3121,3204,3108,3153,3155,10,12,13942,"43,990.43",16574
,20170609,3153,3155,3153,3196,3129,3191,3171,36,16,9946,"31,546.95",14334
,20170612,3191,3171,3191,3222,3176,3202,3201,31,30,8960,"28,681.44",14094
,20170613,3202,3201,3202,3215,3100,3104,3161,-97,-40,8060,"25,482.39",13970
,20170614,3104,3161,3104,3264,3095,3259,3177,98,16,13338,"42,380.36",14536
,20170615,3259,3177,3250,3290,3202,3273,3252,96,75,16732,"54,414.06",13984
,20170616,3273,3252,3273,3302,3229,3248,3263,-4,11,13852,"45,206.00",13556
,20170619,3248,3263,3248,3310,3244,3266,3276,3,13,12946,"42,422.89",11704
,20170620,3266,3276,3271,3271,3210,3230,3243,-46,-33,8088,"26,229.73",11064
,20170621,3230,3243,3219,3220,3139,3180,3172,-63,-71,10702,"33,953.38",10918
,20170622,3180,3172,3179,3227,3131,3133,3193,-39,21,9364,"29,903.10",10958
,20170623,3133,3193,3133,3211,3133,3208,3168,15,-25,6534,"20,702.03",10708
,20170626,3208,3168,3208,3255,3186,3252,3220,84,52,9300,"29,949.13",11438
,20170627,3252,3220,3249,3309,3232,3308,3272,88,52,7984,"26,126.52",11234
,20170628,3308,3272,3308,3360,3308,3352,3337,80,65,6926,"23,118.60",12168
,20170629,3352,3337,3360,3399,3335,3377,3368,40,31,8458,"28,488.87",11984
,20170630,3377,3368,3377,3419,3347,3412,3372,44,4,7926,"26,731.28",12790
,20170703,3412,3372,3411,3480,3386,3477,3435,105,63,9058,"31,115.66",13720
,20170704,3477,3435,3477,3513,3418,3428,3464,-7,29,11684,"40,475.16",13700
,20170705,3428,3464,3428,3557,3428,3505,3505,41,41,12142,"42,564.55",14600
,20170706,3505,3505,3499,3524,3468,3513,3492,8,-13,7740,"27,028.28",14202
,20170707,3513,3492,3520,3523,3476,3517,3501,25,9,8010,"28,049.06",14680
,20170710,3517,3501,3530,3564,3500,3547,3528,46,27,7860,"27,734.71",14994
,20170711,3547,3528,3545,3685,3530,3659,3616,131,88,9006,"32,566.09",16376
,20170712,3659,3616,3659,3700,3644,3664,3673,48,57,7872,"28,919.99",16678
,20170713,3664,3673,3653,3735,3651,3730,3692,57,19,8566,"31,631.48",17714
,20170714,3730,3692,3730,3737,3550,3650,3665,-42,-27,12838,"47,061.39",16200
,20170717,3650,3665,3640,3734,3632,3712,3701,47,36,8238,"30,496.80",16904
,20170718,3712,3701,3712,3726,3656,3676,3692,-25,-9,8406,"31,042.42",15194
,20170719,3676,3692,3676,3760,3668,3753,3716,61,24,7606,"28,270.85",15974
,20170720,3753,3716,3753,3753,3604,3614,3678,-102,-38,10228,"37,624.18",14576
,20170721,3614,3678,3614,3658,3591,3648,3625,-30,-53,8824,"31,994.00",13448
,20170724,3648,3625,3648,3680,3591,3651,3631,26,6,6816,"24,750.34",12882
,20170725,3651,3631,3651,3691,3615,3670,3652,39,21,8500,"31,044.26",12602
,20170726,3670,3652,3671,3728,3665,3685,3697,33,45,6892,"25,480.31",12612
,20170727,3685,3697,3696,3720,3645,3691,3679,-6,-18,7804,"28,717.23",12178
,20170728,3691,3679,3681,3718,3663,3689,3689,10,10,7160,"26,418.54",11854
,20170731,3689,3689,3689,3868,3686,3858,3789,169,100,10624,"40,255.37",11610
,20170801,3858,3789,3839,3875,3819,3850,3846,61,57,6138,"23,607.65",11138
,20170802,3850,3846,3850,3888,3817,3865,3864,19,18,4068,"15,722.26",11178
,20170803,3865,3864,3865,3917,3840,3903,3881,39,17,5970,"23,171.91",10878
,20170804,3903,3881,3903,4000,3885,3976,3951,95,70,7186,"28,392.78",10018
,20170807,3976,3951,3995,4227,3962,4164,4122,213,171,11772,"48,533.20",9394
,20170808,4164,4122,4156,4213,4115,4141,4169,19,47,6288,"26,217.75",8802
,20170809,4141,4169,4141,4179,4100,4150,4130,-19,-39,4682,"19,339.40",8974
,20170810,4150,4130,4140,4157,4111,4124,4131,-6,1,4302,"17,775.35",8264
,20170811,4124,4131,4124,4152,4017,4056,4096,-75,-35,5372,"22,004.00",8166
,20170814,4056,4096,4067,4111,4036,4050,4065,-46,-31,2654,"10,789.37",7946
,20170815,4050,4065,4050,4050,3997,4035,4023,-30,-42,2864,"11,522.43",7918
,20170816,4035,4023,4035,4042,3989,3995,4013,-28,-10,1874,"7,521.87",8048
,20170817,3995,4013,3995,4106,3995,4058,4060,45,47,3022,"12,270.33",7700
,20170818,4058,4060,4058,4123,4044,4122,4070,62,10,1062,"4,322.77",7396
,20170821,4122,4070,4122,4178,4061,4165,4114,95,44,1222,"5,028.30",7090
,20170822,4165,4114,4165,4186,4125,4164,4139,50,25,1170,"4,843.46",6986
,20170823,4164,4139,4164,4164,4021,4054,4065,-85,-74,1346,"5,472.52",6830
,20170824,4054,4065,4053,4124,4036,4092,4085,27,20,462,"1,887.71",6660
,20170825,4092,4085,4108,4193,4108,4162,4150,77,65,518,"2,149.95",6528
,20170828,4162,4150,4147,4163,4100,4130,4135,-20,-15,898,"3,713.91",6410
,20170829,4130,4135,4156,4174,4102,4128,4150,-7,15,280,"1,162.16",6352
,20170830,4128,4150,4139,4188,4100,4147,4121,-3,-29,734,"3,025.32",6166
,20170831,4147,4121,4116,4345,4095,4327,4151,206,30,5008,"20,789.49",2400
,20170901,4327,4151,4249,4249,4210,4240,4233,89,82,180,761.94,2400
,20170904,4240,4233,4300,4300,4300,4300,4300,67,67,480,"2,064.00",1920
,20170905,4300,4300,,,,4303,4303,3,3,0,0.00,1920
,20170906,4303,4303,,,,4303,4303,0,0,0,0.00,1920
,20170907,4303,4303,4300,4300,4300,4300,4300,-3,-3,240,"1,032.00",1860
,20170908,4300,4300,,,,4300,4300,0,0,0,0.00,1860
,20170911,4300,4300,4300,4397,4300,4397,4364,97,64,180,785.64,1800
,20170912,4397,4364,4395,4540,4395,4440,4467,76,103,660,"2,948.52",1140
,20170913,4440,4467,,,,4467,4467,0,0,0,0.00,1140
,20170914,4467,4467,,,,4467,4467,0,0,0,0.00,1140
,20170915,4467,4467,,,,4467,4467,0,0,0,0.00,1140
rb1710,20170103,2831,2870,2840,2947,2806,2821,2879,-49,9,172002,"495,294.89",197798
,20170104,2821,2879,2826,2908,2795,2881,2849,2,-30,246528,"702,559.95",216428
,20170105,2881,2849,2881,2946,2868,2895,2904,46,55,183548,"533,141.87",216808
,20170106,2895,2904,2891,2935,2845,2857,2891,-47,-13,190426,"550,566.83",221026
,20170109,2857,2891,2857,2985,2840,2984,2905,93,14,226220,"657,325.74",226908
,20170110,2984,2905,2983,3108,2966,3108,3037,203,132,248200,"754,025.21",227366
,20170111,3108,3037,3113,3131,3071,3109,3104,72,67,257130,"798,317.45",231306
,20170112,3109,3104,3103,3186,3089,3126,3139,22,35,249928,"784,693.57",235006
,20170113,3126,3139,3139,3164,3090,3112,3127,-27,-12,221844,"693,763.07",241012
,20170116,3112,3127,3103,3331,3097,3284,3241,157,114,318140,"1,031,179.07",253460
,20170117,3284,3241,3277,3309,3179,3223,3246,-18,5,283388,"919,962.95",243770
,20170118,3223,3246,3222,3278,3186,3216,3221,-30,-25,273056,"879,584.47",245456
,20170119,3216,3221,3210,3244,3174,3205,3205,-16,-16,305732,"980,017.19",230406
,20170120,3205,3205,3204,3235,3150,3150,3196,-55,-9,259978,"830,969.27",232974
,20170123,3150,3196,3155,3159,3101,3133,3129,-63,-67,225456,"705,479.69",235758
,20170124,3133,3129,3133,3276,3130,3233,3207,104,78,318110,"1,020,400.94",248070
,20170125,3233,3207,3235,3250,3190,3230,3223,23,16,195738,"630,895.51",250914
,20170126,3230,3223,3226,3288,3225,3283,3257,60,34,220264,"717,520.88",261782
,20170203,3283,3257,3262,3275,3007,3089,3124,-168,-133,327034,"1,021,832.38",281574
,20170206,3089,3124,3088,3112,3042,3057,3066,-67,-58,434062,"1,330,868.25",307882
,20170207,3057,3066,3060,3119,3042,3109,3086,43,20,570850,"1,761,678.55",330610
,20170208,3109,3086,3112,3177,3052,3175,3130,89,44,635414,"1,989,373.95",356862
,20170209,3175,3130,3177,3202,3143,3148,3172,18,42,431190,"1,367,857.47",393464
,20170210,3148,3172,3146,3309,3130,3263,3223,91,51,785202,"2,530,887.34",438768
,20170213,3263,3223,3277,3372,3268,3363,3331,140,108,863360,"2,876,441.82",466552
,20170214,3363,3331,3366,3380,3309,3363,3346,32,15,628500,"2,103,208.51",482710
,20170215,3363,3346,3365,3375,3289,3317,3336,-29,-10,783960,"2,615,895.85",495246
,20170216,3317,3336,3300,3411,3286,3312,3340,-24,4,1261342,"4,213,166.02",539098
,20170217,3312,3340,3308,3375,3308,3360,3352,20,12,733410,"2,458,798.61",563452
,20170220,3360,3352,3372,3415,3341,3404,3388,52,36,874494,"2,962,814.95",613384
,20170221,3404,3388,3419,3480,3414,3434,3446,46,58,547394,"1,886,511.82",622916
,20170222,3434,3446,3436,3448,3382,3399,3409,-47,-37,587402,"2,002,861.11",624152
,20170223,3399,3409,3389,3440,3341,3367,3394,-42,-15,824382,"2,798,707.06",647568
,20170224,3367,3394,3380,3391,3283,3382,3341,-12,-53,811800,"2,713,011.18",676148
,20170227,3382,3341,3380,3491,3365,3463,3436,122,95,1085152,"3,728,786.01",688816
,20170228,3463,3436,3460,3466,3325,3327,3418,-109,-18,882050,"3,015,178.53",712302
,20170301,3327,3418,3335,3420,3325,3388,3371,-30,-47,952188,"3,210,347.70",723850
,20170302,3388,3371,3388,3424,3369,3397,3393,26,22,755812,"2,565,181.83",695020
,20170303,3397,3393,3408,3408,3305,3373,3344,-20,-49,1141814,"3,818,936.34",744934
,20170306,3373,3344,3378,3385,3277,3284,3319,-60,-25,1302276,"4,323,313.44",821958
,20170307,3284,3319,3280,3336,3267,3321,3310,2,-9,972744,"3,220,367.64",873568
,20170308,3321,3310,3320,3325,3232,3236,3278,-74,-32,1189324,"3,899,065.38",940036
,20170309,3236,3278,3236,3253,3155,3206,3203,-72,-75,1270084,"4,068,682.46",979770
,20170310,3206,3203,3204,3240,3194,3203,3219,0,16,1114500,"3,587,629.19",973432
,20170313,3203,3219,3207,3343,3160,3342,3242,123,23,1926046,"6,244,744.59",952258
,20170314,3342,3242,3340,3349,3270,3300,3305,58,63,1240166,"4,099,638.25",921872
,20170315,3300,3305,3294,3461,3280,3415,3392,110,87,2805496,"9,518,927.56",1006870
,20170316,3415,3392,3412,3448,3365,3439,3413,47,21,1943052,"6,632,330.63",1184786
,20170317,3439,3413,3435,3439,3341,3369,3386,-44,-27,2007724,"6,798,260.14",1243734
,20170320,3369,3386,3370,3428,3318,3334,3376,-52,-10,2693626,"9,094,011.17",1382082
,20170321,3334,3376,3341,3348,3224,3229,3272,-147,-104,2970956,"9,721,490.23",1550554
,20170322,3229,3272,3218,3243,3108,3117,3169,-155,-103,3525616,"11,173,227.27",1832902
,20170323,3117,3169,3119,3182,3118,3127,3151,-42,-18,2961120,"9,331,270.49",1967156
,20170324,3127,3151,3130,3199,3097,3140,3151,-11,0,4315812,"13,600,014.06",2086352
,20170327,3140,3151,3138,3145,3003,3057,3061,-94,-90,4210368,"12,890,625.56",2172364
,20170328,3057,3061,3058,3108,3035,3050,3072,-11,11,3860972,"11,861,314.28",2311302
,20170329,3050,3072,3062,3177,3061,3169,3124,97,52,4705728,"14,705,230.60",2384386
,20170330,3169,3124,3169,3189,3121,3142,3154,18,30,3670026,"11,578,506.79",2419084
,20170331,3142,3154,3140,3224,3112,3152,3166,-2,12,5570154,"17,636,493.31",2465042
,20170405,3152,3166,3200,3285,3173,3222,3238,56,72,4368094,"14,147,127.89",2455878
,20170406,3222,3238,3237,3247,3157,3162,3196,-76,-42,4956264,"15,842,985.81",2627898
,20170407,3162,3196,3136,3145,2985,3038,3058,-158,-138,6128296,"18,742,697.68",2754252
,20170410,3038,3058,3030,3058,2987,3000,3021,-58,-37,4221712,"12,756,914.35",2804536
,20170411,3000,3021,2990,3029,2950,2982,2998,-39,-23,4500688,"13,494,178.05",2847282
,20170412,2982,2998,2975,2992,2888,2893,2931,-105,-67,4743762,"13,906,558.42",2929150
,20170413,2893,2931,2888,2961,2879,2917,2925,-14,-6,4355624,"12,742,029.61",2850832
,20170414,2917,2925,2925,2999,2907,2942,2951,17,26,5676496,"16,751,793.70",2805770
,20170417,2942,2951,2942,2991,2884,2912,2932,-39,-19,5247354,"15,386,784.33",2765320
,20170418,2912,2932,2917,2929,2815,2824,2868,-108,-64,4828746,"13,851,427.31",2929440
,20170419,2824,2868,2819,2862,2811,2852,2839,-16,-29,3665450,"10,406,472.34",2845128
,20170420,2852,2839,2853,2928,2775,2889,2842,50,3,6177936,"17,562,850.08",2755486
,20170421,2889,2842,2898,2967,2867,2928,2920,86,78,6859930,"20,037,119.87",2718328
,20170424,2928,2920,2923,2942,2851,2927,2894,7,-26,5467910,"15,829,488.05",2757128
,20170425,2927,2894,2925,2958,2896,2948,2930,54,36,5236738,"15,346,602.01",2927716
,20170426,2948,2930,2955,3032,2934,2967,2981,37,51,5939958,"17,707,916.83",3046648
,20170427,2967,2981,2970,3018,2958,3016,2985,35,4,4814822,"14,373,912.86",3152884
,20170428,3016,2985,3035,3116,3026,3115,3066,130,81,6604372,"20,249,803.16",3301826
,20170502,3115,3066,3152,3160,3105,3134,3133,68,67,3349462,"10,494,556.10",3394692
,20170503,3134,3133,3143,3151,3094,3131,3123,-2,-10,4945434,"15,445,987.86",3672130
,20170504,3131,3123,3120,3126,2904,2931,3007,-192,-116,10040322,"30,199,282.19",3344158
,20170505,2931,3007,2949,2955,2891,2931,2931,-76,-76,7220490,"21,166,445.58",3396782
,20170508,2931,2931,2948,3049,2933,3004,2987,73,56,9812676,"29,314,419.82",3584572
,20170509,3004,2987,2998,3035,2980,3016,3001,29,14,6250494,"18,759,452.35",3705088
,20170510,3016,3001,3009,3084,3005,3077,3056,76,55,7391280,"22,588,579.78",3791240
,20170511,3077,3056,3084,3108,2962,3060,3030,4,-26,10250286,"31,065,675.62",3700338
,20170512,3060,3030,3068,3078,2939,2941,3000,-89,-30,9412260,"28,244,232.98",3922756
,20170515,2941,3000,2950,3032,2925,2991,2981,-9,-19,7079212,"21,103,717.68",3777186
,20170516,2991,2981,2997,3005,2958,2999,2983,18,2,5715242,"17,053,788.97",3792070
,20170517,2999,2983,3005,3118,2993,3110,3066,127,83,8553152,"26,227,185.45",4042906
,20170518,3110,3066,3111,3159,3080,3144,3120,78,54,7669748,"23,934,362.51",4272028
,20170519,3144,3120,3118,3249,3095,3244,3186,124,66,9364778,"29,843,322.46",4357650
,20170522,3244,3186,3254,3385,3246,3342,3325,156,139,9224152,"30,675,756.66",4515004
,20170523,3342,3325,3349,3356,3285,3295,3320,-30,-5,6647362,"22,070,593.03",4416246
,20170524,3295,3320,3288,3317,3191,3246,3258,-74,-62,9760882,"31,802,093.41",4330496
,20170525,3246,3258,3247,3298,3210,3219,3254,-39,-4,9362346,"30,470,533.47",4141028
,20170526,3219,3254,3221,3249,3172,3240,3212,-14,-42,7427212,"23,860,586.10",4039408
,20170531,3240,3212,3248,3273,3089,3095,3181,-117,-31,6663064,"21,197,835.10",3993662
,20170601,3095,3181,3102,3127,3057,3092,3094,-89,-87,7377354,"22,830,330.07",4116502
,20170602,3092,3094,3098,3108,3021,3026,3057,-68,-37,9046274,"27,656,860.70",4174198
,20170605,3026,3057,3010,3055,2938,2939,2989,-118,-68,7983244,"23,869,120.42",4259372
,20170606,2939,2989,2928,2973,2906,2959,2941,-30,-48,6740960,"19,831,231.87",4112454
,20170607,2959,2941,2959,2996,2935,2962,2965,21,24,6244994,"18,519,229.56",4237182
,20170608,2962,2965,2968,3025,2924,2968,2972,3,7,9025802,"26,829,060.73",4077740
,20170609,2968,2972,2968,3021,2954,3017,2992,45,20,6275936,"18,781,138.06",4086840
,20170612,3017,2992,3030,3051,3000,3033,3030,41,38,6298340,"19,088,579.41",4090012
,20170613,3033,3030,3035,3045,2932,2935,2995,-95,-35,5864856,"17,566,884.23",4316160
,20170614,2935,2995,2935,3086,2930,3084,2998,89,3,8388128,"25,152,340.57",4100690
,20170615,3084,2998,3080,3124,3023,3111,3080,113,82,8854462,"27,278,199.99",4169474
,20170616,3111,3080,3105,3156,3075,3091,3113,11,33,7986648,"24,867,480.08",3921532
,20170619,3091,3113,3100,3185,3093,3140,3137,27,24,7269176,"22,805,493.58",3884594
,20170620,3140,3137,3144,3150,3084,3109,3119,-28,-18,6469594,"20,180,764.25",3918006
,20170621,3109,3119,3099,3100,3034,3069,3060,-50,-59,6953398,"21,278,431.42",3881838
,20170622,3069,3060,3079,3123,3030,3031,3087,-29,27,8068116,"24,911,801.24",3860464
,20170623,3031,3087,3037,3110,3034,3104,3062,17,-25,6795422,"20,812,547.00",3837146
,20170626,3104,3062,3105,3149,3088,3148,3115,86,53,6297226,"19,621,429.94",3909278
,20170627,3148,3115,3152,3225,3132,3224,3173,109,58,6593804,"20,926,355.07",4064658
,20170628,3224,3173,3226,3291,3224,3279,3258,106,85,6083548,"19,824,539.28",4243248
,20170629,3279,3258,3288,3330,3252,3297,3291,39,33,8409380,"27,681,123.13",4287144
,20170630,3297,3291,3291,3355,3273,3347,3306,56,15,7499712,"24,800,578.58",4577550
,20170703,3347,3306,3341,3415,3333,3413,3373,107,67,7327914,"24,721,717.25",4727336
,20170704,3413,3373,3405,3448,3341,3360,3393,-13,20,7666870,"26,017,971.95",4533484
,20170705,3360,3393,3370,3474,3369,3420,3422,27,29,8665272,"29,658,257.18",4535336
,20170706,3420,3422,3400,3423,3345,3417,3392,-5,-30,7893368,"26,778,108.25",4552136
,20170707,3417,3392,3421,3432,3353,3428,3387,36,-5,7705736,"26,105,898.74",4507758
,20170710,3428,3387,3435,3479,3405,3442,3439,55,52,6567710,"22,588,134.22",4569212
,20170711,3442,3439,3438,3597,3429,3565,3522,126,83,7074976,"24,918,897.97",4711298
,20170712,3565,3522,3565,3615,3553,3575,3582,53,60,5648724,"20,237,173.17",4709702
,20170713,3575,3582,3580,3660,3560,3657,3607,75,25,6170360,"22,258,840.01",4832902
,20170714,3657,3607,3658,3658,3528,3551,3578,-56,-29,8422600,"30,136,959.07",4367644
,20170717,3551,3578,3535,3668,3534,3627,3614,49,36,6886134,"24,891,901.03",4403500
,20170718,3627,3614,3627,3652,3573,3586,3615,-28,1,6543818,"23,657,010.49",4374682
,20170719,3586,3615,3598,3688,3583,3679,3646,64,31,6243064,"22,766,598.50",4361042
,20170720,3679,3646,3667,3675,3488,3496,3582,-150,-64,8574736,"30,715,486.04",3954248
,20170721,3496,3582,3510,3547,3467,3525,3506,-57,-76,6661080,"23,357,814.57",3777024
,20170724,3525,3506,3528,3566,3455,3516,3507,10,1,5893656,"20,671,580.70",3864674
,20170725,3516,3507,3523,3590,3485,3568,3540,61,33,6185898,"21,898,245.29",3752382
,20170726,3568,3540,3579,3639,3547,3568,3591,28,51,6233630,"22,389,514.50",3421350
,20170727,3568,3591,3555,3599,3504,3570,3553,-21,-38,6196006,"22,017,784.59",3389820
,20170728,3570,3553,3566,3595,3530,3558,3565,5,12,5509860,"19,643,011.83",3201420
,20170731,3558,3565,3565,3740,3559,3733,3663,168,98,6960054,"25,501,541.02",3091474
,20170801,3733,3663,3710,3759,3693,3698,3716,35,53,4104670,"15,256,728.43",2894894
,20170802,3698,3716,3695,3748,3662,3725,3719,9,3,3965622,"14,749,554.56",2768436
,20170803,3725,3719,3715,3791,3702,3776,3746,57,27,4027018,"15,089,123.49",2628888
,20170804,3776,3746,3780,3899,3765,3882,3833,136,87,3464504,"13,282,892.29",2459486
,20170807,3882,3833,3880,4101,3866,4079,4021,246,188,4377190,"17,600,834.52",2102350
,20170808,4079,4021,4070,4119,4016,4046,4072,25,51,2527256,"10,292,140.62",1778738
,20170809,4046,4072,4042,4088,3981,4080,4027,8,-45,2181938,"8,788,501.97",1606986
,20170810,4080,4027,4065,4074,4002,4032,4041,5,14,1243152,"5,023,592.35",1406208
,20170811,4032,4041,4012,4054,3906,3945,3986,-96,-55,1394218,"5,558,153.71",1227604
,20170814,3945,3986,3941,3981,3920,3932,3948,-54,-38,763866,"3,015,773.70",1125714
,20170815,3932,3948,3920,3940,3869,3912,3901,-36,-47,545020,"2,126,498.39",1055050
,20170816,3912,3901,3911,3922,3842,3854,3882,-47,-19,410780,"1,594,657.23",928540
,20170817,3854,3882,3860,3971,3860,3927,3914,45,32,495042,"1,937,838.04",859956
,20170818,3927,3914,3920,3996,3902,3990,3939,76,25,228438,"899,999.02",799846
,20170821,3990,3939,3967,4090,3935,4052,4016,113,77,349440,"1,403,565.61",755990
,20170822,4052,4016,4060,4068,3993,4030,4028,14,12,220206,"887,183.91",694180
,20170823,4030,4028,4020,4020,3850,3909,3914,-119,-114,310552,"1,215,740.46",627570
,20170824,3909,3914,3910,3980,3878,3958,3939,44,25,177404,"698,796.86",600818
,20170825,3958,3939,3950,4052,3944,4015,4005,76,66,238020,"953,427.55",566054
,20170828,4015,4005,4015,4036,3901,4005,3969,0,-36,189616,"752,710.47",517208
,20170829,4005,3969,4007,4021,3940,3962,3983,-7,14,183742,"731,979.75",496814
,20170830,3962,3983,3989,3989,3912,3959,3945,-24,-38,151176,"596,535.04",464296
,20170831,3959,3945,3945,4000,3890,4000,3941,55,-4,168402,"663,838.07",443930
,20170901,4000,3941,4000,4147,3975,4132,4071,191,130,244386,"994,981.72",421524
,20170904,4132,4071,4126,4260,4118,4146,4176,75,105,185274,"773,786.12",356422
,20170905,4146,4176,4146,4200,4128,4174,4167,-2,-9,81366,"339,113.93",344356
,20170906,4174,4167,4177,4211,4100,4103,4148,-64,-19,111562,"462,792.67",333694
,20170907,4103,4148,4113,4120,4056,4075,4092,-73,-56,91448,"374,220.77",310258
,20170908,4075,4092,4075,4119,4010,4040,4063,-52,-29,113114,"459,655.04",286530
,20170911,4040,4063,4027,4058,3974,4052,4022,-11,-41,72526,"291,752.75",267182
,20170912,4052,4022,4056,4108,4040,4107,4072,85,50,76576,"311,877.55",262272
,20170913,4107,4072,4098,4139,4080,4090,4105,18,33,65040,"267,035.07",251594
,20170914,4090,4105,4104,4113,4021,4032,4063,-73,-42,82562,"335,500.27",239724
,20170915,4032,4063,4033,4042,3994,4006,4019,-57,-44,67916,"272,988.57",210562
,20170918,4006,4019,3991,4050,3981,4046,4019,27,0,53424,"214,755.05",205330
,20170919,4046,4019,4046,4094,4033,4037,4057,18,38,53196,"215,854.18",190126
,20170920,4037,4057,4037,4061,4020,4050,4038,-7,-19,38650,"156,100.71",180382
,20170921,4050,4038,4051,4073,3989,3990,4023,-48,-15,52108,"209,669.31",150574
,20170922,3990,4023,3996,3996,3852,3887,3936,-136,-87,60092,"236,565.36",124102
,20170925,3887,3936,3900,3953,3872,3912,3909,-24,-27,36058,"140,976.22",108280
,20170926,3912,3909,3914,3965,3914,3933,3942,24,33,28656,"112,974.86",98430
,20170927,3933,3942,3928,3945,3854,3912,3903,-30,-39,38798,"151,459.89",81606
,20170928,3912,3903,3909,3944,3881,3903,3905,0,2,33620,"131,304.68",61324
,20170929,3903,3905,3903,3983,3880,3982,3913,77,8,44510,"174,175.65",28058
,20171009,3982,3913,3980,3980,3901,3906,3944,-7,31,9758,"38,494.36",22560
,20171010,3906,3944,3891,3891,3787,3800,3845,-144,-99,11580,"44,535.84",12840
,20171011,3800,3845,3795,3819,3630,3690,3787,-155,-58,7440,"28,176.06",8940
,20171012,3690,3787,3797,3850,3745,3850,3787,63,0,960,"3,636.00",9000
,20171013,3850,3787,3855,3899,3854,3899,3871,112,84,600,"2,322.66",9060
,20171016,3899,3871,3980,3990,3810,3815,3905,-56,34,1080,"4,218.42",8760
rb1711,20170103,2828,2859,2843,2922,2789,2789,2872,-70,13,226,649.11,1100
,20170104,2789,2872,2820,2885,2780,2881,2824,9,-48,146,412.41,1150
,20170105,2881,2824,2867,2907,2858,2884,2881,60,57,88,253.61,1150
,20170106,2884,2881,2868,2910,2836,2836,2881,-45,0,72,207.50,1158
,20170109,2836,2881,2840,2946,2837,2946,2869,65,-12,58,166.43,1170
,20170110,2946,2869,2954,3069,2949,3062,3006,193,137,152,456.92,1146
,20170111,3062,3006,3149,3149,3062,3071,3094,65,88,112,346.55,1150
,20170112,3071,3094,3095,3164,3078,3136,3128,42,34,88,275.29,1182
,20170113,3136,3128,3128,3147,3084,3090,3115,-38,-13,108,336.50,1214
,20170116,3090,3115,3093,3305,3082,3261,3233,146,118,188,607.97,1176
,20170117,3261,3233,3259,3288,3158,3205,3240,-28,7,76,246.27,1180
,20170118,3205,3240,3200,3225,3167,3210,3202,-30,-38,70,224.21,1178
,20170119,3210,3202,3204,3215,3151,3176,3186,-26,-16,70,223.06,1172
,20170120,3176,3186,3194,3195,3129,3134,3172,-52,-14,36,114.19,1182
,20170123,3134,3172,3101,3134,3090,3109,3114,-63,-58,124,386.17,1206
,20170124,3109,3114,3115,3254,3115,3203,3211,89,97,98,314.69,1164
,20170125,3203,3211,3224,3225,3188,3189,3207,-22,-4,38,121.87,1176
,20170126,3189,3207,3211,3270,3208,3270,3241,63,34,72,233.37,1190
,20170203,3270,3241,3052,3171,2991,3068,3084,-173,-157,268,826.78,1156
,20170206,3068,3084,3035,3072,3018,3045,3044,-39,-40,62,188.75,1158
,20170207,3045,3044,3041,3088,3030,3088,3053,44,9,76,232.03,1142
,20170208,3088,3053,3105,3144,3039,3144,3103,91,50,54,167.56,1144
,20170209,3144,3103,3149,3170,3113,3113,3151,10,48,44,138.66,1142
,20170210,3113,3151,3109,3270,3108,3251,3212,100,61,196,629.69,1188
,20170213,3251,3212,3246,3351,3246,3335,3315,123,103,152,503.91,1134
,20170214,3335,3315,3345,3346,3295,3328,3323,13,8,260,864.16,1110
,20170215,3328,3323,3308,3316,3248,3286,3292,-37,-31,74,243.62,1112
,20170216,3286,3292,3275,3376,3259,3297,3310,5,18,106,350.87,1110
,20170217,3297,3310,3292,3340,3292,3315,3323,5,13,210,698.04,1092
,20170220,3315,3323,3360,3392,3318,3358,3365,35,42,98,329.82,1098
,20170221,3358,3365,3390,3442,3384,3391,3413,26,48,86,293.58,1102
,20170222,3391,3413,3390,3398,3350,3368,3369,-45,-44,70,235.85,1108
,20170223,3368,3369,3352,3400,3329,3330,3373,-39,4,72,242.91,1122
,20170224,3330,3373,3362,3362,3264,3351,3306,-22,-67,62,205.02,1124
,20170227,3351,3306,3361,3460,3347,3426,3408,120,102,64,218.15,1116
,20170228,3426,3408,3441,3441,3305,3305,3377,-103,-31,100,337.78,1122
,20170301,3305,3377,3298,3390,3298,3386,3344,9,-33,26,86.97,1118
,20170302,3386,3344,3365,3388,3351,3354,3358,10,14,66,221.64,1126
,20170303,3354,3358,3363,3365,3284,3330,3318,-28,-40,62,205.77,1128
,20170306,3330,3318,3383,3383,3248,3257,3305,-61,-13,116,383.47,1178
,20170307,3257,3305,3251,3297,3251,3265,3282,-40,-23,30,98.47,1170
,20170308,3265,3282,3270,3270,3212,3212,3234,-70,-48,66,213.50,1202
,20170309,3212,3234,3223,3225,3159,3169,3217,-65,-17,182,585.67,1196
,20170310,3169,3217,3192,3200,3178,3185,3189,-32,-28,54,172.23,1220
,20170313,3185,3189,3188,3299,3133,3292,3212,103,23,76,244.14,1230
,20170314,3292,3212,3302,3316,3239,3243,3262,31,50,156,508.94,1188
,20170315,3243,3262,3291,3402,3291,3368,3345,106,83,126,421.51,1188
,20170316,3368,3345,3381,3400,3320,3400,3380,55,35,36,121.71,1182
,20170317,3400,3380,3364,3380,3316,3316,3352,-64,-28,68,227.96,1198
,20170320,3316,3352,3322,3378,3300,3300,3335,-52,-17,112,373.59,1210
,20170321,3300,3335,3323,3323,3201,3201,3262,-134,-73,100,326.29,1240
,20170322,3201,3262,3183,3196,3090,3092,3145,-170,-117,100,314.53,1242
,20170323,3092,3145,3111,3140,3094,3103,3123,-42,-22,62,193.63,1242
,20170324,3103,3123,3082,3150,3067,3119,3114,-4,-9,72,224.22,1258
,20170327,3119,3114,3103,3103,2959,3019,3033,-95,-81,116,351.83,1278
,20170328,3019,3033,3021,3072,3001,3001,3029,-32,-4,64,193.89,1316
,20170329,3001,3029,3039,3115,3039,3105,3089,76,60,68,210.08,1314
,20170330,3105,3089,3123,3141,3089,3107,3119,18,30,118,368.09,1288
,20170331,3107,3119,3127,3151,3082,3082,3134,-37,15,56,175.52,1284
,20170405,3082,3134,3142,3245,3142,3175,3194,41,60,80,255.58,1268
,20170406,3175,3194,3199,3199,3126,3127,3159,-67,-35,72,227.50,1274
,20170407,3127,3159,3055,3059,2959,3000,3034,-159,-125,106,321.62,1272
,20170410,3000,3034,3013,3017,2966,2966,2980,-68,-54,178,530.61,1248
,20170411,2966,2980,2945,2969,2945,2969,2948,-11,-32,62,182.79,1298
,20170412,2969,2948,2903,2937,2853,2853,2887,-95,-61,186,537.04,1292
,20170413,2853,2887,2850,2941,2845,2923,2903,36,16,232,673.53,1260
,20170414,2923,2903,2945,2954,2873,2892,2910,-11,7,232,675.31,1256
,20170417,2892,2910,2940,2941,2841,2884,2888,-26,-22,78,225.29,1244
,20170418,2884,2888,2876,2876,2783,2789,2806,-99,-82,62,174.03,1260
,20170419,2789,2806,2790,2819,2790,2806,2803,0,-3,98,274.75,1272
,20170420,2806,2803,2829,2872,2803,2816,2835,13,32,166,470.72,1252
,20170421,2816,2835,2852,2919,2849,2883,2877,48,42,130,374.03,1212
,20170424,2883,2877,2884,2884,2841,2846,2853,-31,-24,8,22.82,1210
,20170425,2846,2853,2888,2909,2870,2901,2879,48,26,36,103.65,1232
,20170426,2901,2879,2918,2991,2898,2973,2935,94,56,74,217.24,1242
,20170427,2973,2935,2931,2967,2926,2967,2937,32,2,34,99.89,1238
,20170428,2967,2937,2995,3106,2985,3060,3031,123,94,354,"1,073.13",1236
,20170502,3060,3031,3093,3110,3055,3082,3083,51,52,134,413.20,1218
,20170503,3082,3083,3086,3089,3052,3086,3074,3,-9,42,129.13,1228
,20170504,3086,3074,3069,3083,2861,2874,2943,-200,-131,142,417.93,1178
,20170505,2874,2943,2858,2900,2840,2890,2879,-53,-64,110,316.73,1158
,20170508,2890,2879,2929,2970,2897,2956,2936,77,57,470,"1,380.09",1162
,20170509,2956,2936,2952,2970,2928,2928,2935,-8,-1,266,780.88,1184
,20170510,2928,2935,2949,3019,2941,3002,2990,67,55,108,322.99,1212
,20170511,3002,2990,3022,3023,2911,3018,2957,28,-33,356,"1,053.02",1178
,20170512,3018,2957,2997,2997,2901,2901,2936,-56,-21,52,152.70,1208
,20170515,2901,2936,2880,2970,2880,2940,2935,4,-1,60,176.12,1224
,20170516,2940,2935,2947,2947,2897,2932,2925,-3,-10,6,17.55,1226
,20170517,2932,2925,2940,3048,2940,3025,3004,100,79,182,546.79,1186
,20170518,3025,3004,3036,3074,3001,3056,3037,52,33,94,285.51,1196
,20170519,3056,3037,3027,3164,3027,3164,3112,127,75,68,211.62,1182
,20170522,3164,3112,3179,3285,3179,3266,3236,154,124,194,627.96,1158
,20170523,3266,3236,3260,3260,3220,3233,3240,-3,4,216,700.02,1134
,20170524,3233,3240,3206,3241,3128,3159,3186,-81,-54,142,452.47,1130
,20170525,3159,3186,3180,3220,3138,3138,3182,-48,-4,148,470.99,1138
,20170526,3138,3182,3135,3170,3101,3169,3142,-13,-40,282,886.25,1138
,20170531,3169,3142,3172,3188,3029,3029,3107,-113,-35,140,435.10,1178
,20170601,3029,3107,3033,3043,3000,3018,3026,-89,-81,154,466.07,1220
,20170602,3018,3026,2918,3043,2918,2978,2986,-48,-40,112,334.48,1220
,20170605,2978,2986,2952,2979,2888,2905,2916,-81,-70,138,402.52,1268
,20170606,2905,2916,2872,2915,2839,2906,2878,-10,-38,970,"2,792.39",1438
,20170607,2906,2878,2907,2935,2876,2883,2896,5,18,312,903.85,1414
,20170608,2883,2896,2884,2930,2864,2907,2887,11,-9,210,606.31,1400
,20170609,2907,2887,2909,2948,2894,2948,2924,61,37,76,222.27,1376
,20170612,2948,2924,2953,2976,2937,2976,2950,52,26,824,"2,431.43",1546
,20170613,2976,2950,2967,2974,2875,2879,2921,-71,-29,244,712.93,1580
,20170614,2879,2921,2873,3000,2851,2999,2925,78,4,320,936.10,1568
,20170615,2999,2925,3015,3046,2953,3026,2995,101,70,200,599.09,1506
,20170616,3026,2995,3025,3078,3014,3015,3043,20,48,158,480.86,1474
,20170619,3015,3043,3019,3107,3019,3066,3041,23,-2,108,328.45,1482
,20170620,3066,3041,3049,3067,3012,3028,3048,-13,7,72,219.51,1474
,20170621,3028,3048,3028,3028,2969,2980,2981,-68,-67,80,238.48,1482
,20170622,2980,2981,3011,3047,2956,2956,3021,-25,40,292,882.25,1498
,20170623,2956,3021,2970,2999,2966,2991,2979,-30,-42,82,244.30,1498
,20170626,2991,2979,3040,3058,3020,3055,3042,76,63,94,286.02,1490
,20170627,3055,3042,3080,3135,3051,3121,3078,79,36,208,640.32,1532
,20170628,3121,3078,3150,3223,3143,3201,3168,123,90,734,"2,325.65",1366
,20170629,3201,3168,3178,3229,3171,3203,3191,35,23,28,89.36,1362
,20170630,3203,3191,3204,3260,3171,3255,3212,64,21,352,"1,130.75",1324
,20170703,3255,3212,3256,3301,3256,3300,3272,88,60,250,818.09,1270
,20170704,3300,3272,3451,3451,3254,3260,3306,-12,34,180,595.15,1266
,20170705,3260,3306,3294,3383,3292,3330,3324,24,18,472,"1,569.30",1280
,20170706,3330,3324,3304,3325,3258,3325,3307,1,-17,202,668.15,1252
,20170707,3325,3307,3328,3328,3282,3314,3310,7,3,214,708.42,1250
,20170710,3314,3310,3346,3385,3327,3352,3357,42,47,160,537.23,1270
,20170711,3352,3357,3363,3501,3362,3475,3443,118,86,202,695.65,1244
,20170712,3475,3443,3487,3528,3464,3500,3493,57,50,124,433.16,1228
,20170713,3500,3493,3499,3558,3485,3555,3506,62,13,212,743.45,1244
,20170714,3555,3506,3562,3562,3438,3464,3507,-42,1,140,491.00,1228
,20170717,3464,3507,3474,3575,3470,3547,3518,40,11,222,781.15,1272
,20170718,3547,3518,3532,3561,3493,3506,3511,-12,-7,88,309.01,1238
,20170719,3506,3511,3541,3598,3538,3598,3565,87,54,84,299.46,1270
,20170720,3598,3565,3669,3669,3426,3426,3510,-139,-55,302,"1,060.23",1214
,20170721,3426,3510,3415,3452,3391,3451,3419,-59,-91,158,540.32,1176
,20170724,3451,3419,3449,3449,3380,3435,3416,16,-3,60,204.99,1198
,20170725,3435,3416,3445,3507,3409,3500,3454,84,38,422,"1,457.62",1202
,20170726,3500,3454,3510,3554,3471,3486,3505,32,51,172,602.94,1220
,20170727,3486,3505,3491,3512,3430,3485,3471,-20,-34,396,"1,374.80",1214
,20170728,3485,3471,3498,3529,3476,3476,3503,5,32,392,"1,373.19",1244
,20170731,3476,3503,3502,3659,3502,3650,3560,147,57,202,719.24,1206
,20170801,3650,3560,3640,3662,3609,3623,3637,63,77,704,"2,561.06",1226
,20170802,3623,3637,3604,3693,3597,3693,3646,56,9,848,"3,092.33",1324
,20170803,3693,3646,3673,3749,3664,3745,3685,99,39,1212,"4,466.78",1864
,20170804,3745,3685,3739,3850,3737,3839,3768,154,83,920,"3,466.78",1976
,20170807,3839,3768,3845,4031,3821,3971,3961,203,193,790,"3,129.87",1972
,20170808,3971,3961,4008,4087,3928,3928,4009,-33,48,296,"1,186.77",1964
,20170809,3928,4009,3978,4040,3934,4040,3982,31,-27,296,"1,178.77",1982
,20170810,4040,3982,4025,4049,3971,4000,4014,18,32,384,"1,541.48",2032
,20170811,4000,4014,3967,4024,3871,3896,3960,-118,-54,270,"1,069.25",2010
,20170814,3896,3960,3903,3967,3855,3871,3892,-89,-68,248,965.28,1976
,20170815,3871,3892,3849,3865,3786,3830,3819,-62,-73,262,"1,000.77",1902
,20170816,3830,3819,3821,3828,3769,3780,3806,-39,-13,178,677.53,1864
,20170817,3780,3806,3804,3902,3791,3877,3859,71,53,386,"1,489.64",1792
,20170818,3877,3859,3853,3913,3841,3913,3876,54,17,86,333.34,1788
,20170821,3913,3876,3958,4049,3887,4012,3965,136,89,154,610.71,1834
,20170822,4012,3965,4022,4041,3964,3999,3998,34,33,86,343.86,1828
,20170823,3999,3998,3899,3911,3731,3869,3856,-129,-142,208,802.15,1806
,20170824,3869,3856,3860,3929,3820,3928,3892,72,36,88,342.57,1800
,20170825,3928,3892,3903,4018,3903,3976,3950,84,58,286,"1,129.85",1866
,20170828,3976,3950,3971,3979,3869,3967,3913,17,-37,182,712.27,1838
,20170829,3967,3913,3987,3991,3884,3937,3944,24,31,188,741.58,1842
,20170830,3937,3944,3945,3945,3877,3925,3913,-19,-31,58,227.01,1842
,20170831,3925,3913,3884,3972,3848,3972,3922,59,9,90,353.00,1874
,20170901,3972,3922,3954,4124,3951,4104,4041,182,119,772,"3,119.86",1908
,20170904,4104,4041,4089,4200,4089,4132,4139,91,98,190,786.59,1818
,20170905,4132,4139,4106,4162,4101,4126,4129,-13,-10,42,173.43,1812
,20170906,4126,4129,4145,4145,4043,4060,4093,-69,-36,774,"3,168.72",1840
,20170907,4060,4093,4056,4080,4010,4010,4055,-83,-38,186,754.39,1824
,20170908,4010,4055,4030,4088,3952,3979,4018,-76,-37,250,"1,004.65",1864
,20170911,3979,4018,3969,3998,3920,3998,3967,-20,-51,124,491.96,1856
,20170912,3998,3967,4004,4054,3978,4022,4007,55,40,82,328.64,1868
,20170913,4022,4007,4039,4093,4024,4045,4055,38,48,514,"2,084.43",1868
,20170914,4045,4055,4038,4050,3980,3989,4004,-66,-51,116,464.51,1820
,20170915,3989,4004,3976,3985,3911,3950,3962,-54,-42,226,895.62,1862
,20170918,3950,3962,3952,3970,3920,3960,3947,-2,-15,126,497.36,1890
,20170919,3960,3947,3980,3998,3923,3923,3961,-24,14,222,879.51,1762
,20170920,3923,3961,3944,3960,3909,3960,3925,-1,-36,466,"1,829.10",1382
,20170921,3960,3925,3973,3988,3879,3879,3915,-46,-10,472,"1,847.91",1086
,20170922,3879,3915,3865,3896,3785,3820,3859,-95,-56,404,"1,559.07",1280
,20170925,3820,3859,3862,3862,3805,3854,3847,-5,-12,376,"1,446.84",1520
,20170926,3854,3847,3858,3905,3855,3856,3866,9,19,176,680.49,1606
,20170927,3856,3866,3866,3897,3815,3864,3864,-2,-2,398,"1,538.17",1598
,20170928,3864,3864,3843,3898,3835,3855,3871,-9,7,212,820.66,1572
,20170929,3855,3871,3859,3919,3814,3919,3859,48,-12,322,"1,242.62",1428
,20171009,3919,3859,3910,3980,3879,3885,3899,26,40,564,"2,199.21",1242
,20171010,3885,3899,3840,3865,3782,3782,3820,-117,-79,248,947.51,1260
,20171011,3782,3820,3780,3811,3744,3752,3786,-68,-34,416,"1,575.15",1218
,20171012,3752,3786,3712,3826,3712,3805,3758,19,-28,414,"1,556.00",1420
,20171013,3805,3758,3791,3910,3784,3910,3832,152,74,364,"1,394.93",1406
,20171016,3910,3832,3877,3967,3853,3875,3888,43,56,280,"1,088.88",1312
,20171017,3875,3888,3851,3851,3752,3778,3802,-110,-86,304,"1,155.96",1264
,20171018,3778,3802,3814,3814,3746,3746,3765,-56,-37,334,"1,257.55",1342
,20171019,3746,3765,3712,3745,3676,3695,3700,-70,-65,296,"1,095.31",1274
,20171020,3695,3700,3725,3828,3701,3826,3768,126,68,224,844.18,1260
,20171023,3826,3768,3779,3809,3716,3806,3768,38,0,140,527.66,1248
,20171024,3806,3768,3782,3836,3752,3821,3797,53,29,146,554.40,1298
,20171025,3821,3797,3808,3886,3765,3765,3803,-32,6,108,410.80,1274
,20171026,3765,3803,3765,3794,3715,3737,3739,-66,-64,248,927.49,1298
,20171027,3737,3739,3738,3738,3650,3650,3680,-89,-59,86,316.54,1334
,20171030,3650,3680,3650,3665,3625,3625,3641,-55,-39,50,182.06,1320
,20171031,3625,3641,3648,3750,3571,3575,3682,-66,41,962,"3,542.67",1620
,20171101,3575,3682,3701,3701,3701,3701,3701,19,19,60,222.06,1620
,20171102,3701,3701,,,,3701,3701,0,0,0,0.00,1620
,20171103,3701,3701,3750,3750,3697,3697,3743,-4,42,480,"1,796.82",1200
,20171106,3697,3743,3830,3838,3830,3838,3834,95,91,120,460.08,1200
,20171107,3838,3834,3889,3889,3889,3889,3889,55,55,300,"1,166.70",1200
,20171108,3889,3889,3850,3850,3802,3811,3817,-78,-72,300,"1,145.10",1020
,20171109,3811,3817,3891,3891,3891,3891,3891,74,74,60,233.46,960
,20171110,3891,3891,,,,3891,3891,0,0,0,0.00,960
,20171113,3891,3891,3950,3950,3950,3950,3950,59,59,180,711.00,900
,20171114,3950,3950,3692,4099,3692,4099,3895,149,-55,120,467.46,900
,20171115,4099,3895,4121,4121,3905,3905,3977,10,82,180,715.86,720
rb1712,20170103,2848,2855,2930,2930,2826,2826,2906,-29,51,24,69.74,210
,20170104,2826,2906,2818,2931,2800,2878,2816,-28,-90,106,298.56,308
,20170105,2878,2816,2892,2935,2892,2935,2910,119,94,8,23.29,306
,20170106,2935,2910,2902,2923,2829,2858,2892,-52,-18,28,80.99,314
,20170109,2858,2892,2868,2963,2868,2923,2915,31,23,36,104.95,312
,20170110,2923,2915,2985,3119,2976,3118,3012,203,97,36,108.43,318
,20170111,3118,3012,3118,3127,3102,3126,3118,114,106,22,68.61,310
,20170112,3126,3118,3096,3172,3096,3120,3140,2,22,14,43.97,310
,20170113,3120,3140,3142,3161,3110,3110,3137,-30,-3,6,18.83,312
,20170116,3110,3137,3140,3346,3140,3290,3295,153,158,36,118.65,316
,20170117,3290,3295,3279,3298,3170,3188,3261,-107,-34,146,476.17,328
,20170118,3188,3261,3190,3203,3162,3199,3188,-62,-73,20,63.76,322
,20170119,3199,3188,3195,3195,3149,3149,3164,-39,-24,12,37.97,322
,20170120,3149,3164,3180,3180,3100,3100,3157,-64,-7,26,82.09,336
,20170123,3100,3157,3090,3090,3080,3080,3085,-77,-72,18,55.54,328
,20170124,3080,3085,3146,3225,3140,3200,3175,115,90,24,76.22,342
,20170125,3200,3175,3200,3200,3174,3174,3191,-1,16,6,19.15,340
,20170126,3174,3191,3197,3228,3197,3224,3208,33,17,16,51.33,346
,20170203,3224,3208,3044,3400,3041,3054,3107,-154,-101,256,795.57,334
,20170206,3054,3107,3025,3066,3012,3028,3027,-79,-80,98,296.65,364
,20170207,3028,3027,3015,3067,3015,3067,3030,40,3,62,187.91,386
,20170208,3067,3030,3087,3123,3055,3100,3092,70,62,78,241.18,400
,20170209,3100,3092,3139,3145,3106,3106,3128,14,36,34,106.38,396
,20170210,3106,3128,3150,3262,3110,3200,3173,72,45,92,291.96,400
,20170213,3200,3173,3224,3316,3224,3316,3288,143,115,74,243.35,390
,20170214,3316,3288,3323,3323,3249,3299,3296,11,8,56,184.60,390
,20170215,3299,3296,3315,3317,3250,3264,3274,-32,-22,72,235.79,408
,20170216,3264,3274,3236,3333,3225,3259,3271,-15,-3,86,281.32,436
,20170217,3259,3271,3270,3311,3270,3293,3283,22,12,16,52.53,430
,20170220,3293,3283,3310,3339,3289,3333,3313,50,30,60,198.81,442
,20170221,3333,3313,3340,3402,3340,3360,3382,47,69,34,115.01,424
,20170222,3360,3382,3350,3355,3350,3355,3352,-27,-30,14,46.94,422
,20170223,3355,3352,3312,3312,3263,3263,3291,-89,-61,14,46.08,420
,20170224,3263,3291,3332,3332,3221,3298,3263,7,-28,56,182.73,426
,20170227,3298,3263,3324,3412,3302,3394,3360,131,97,32,107.53,438
,20170228,3394,3360,3383,3386,3376,3376,3381,16,21,6,20.29,440
,20170301,3376,3381,3284,3316,3274,3300,3304,-81,-77,22,72.71,444
,20170302,3300,3304,3337,3337,3318,3320,3320,16,16,34,112.91,444
,20170303,3320,3320,3320,3320,3236,3274,3264,-46,-56,36,117.52,438
,20170306,3274,3264,3284,3289,3207,3208,3258,-56,-6,42,136.86,448
,20170307,3208,3258,3184,3227,3184,3205,3207,-53,-51,20,64.14,450
,20170308,3205,3207,3228,3228,3153,3165,3188,-42,-19,22,70.14,466
,20170309,3165,3188,3166,3166,3124,3124,3149,-64,-39,12,37.79,460
,20170310,3124,3149,3129,3140,3129,3140,3139,-9,-10,22,69.06,458
,20170313,3140,3139,3143,3216,3118,3216,3179,77,40,142,451.52,458
,20170314,3216,3179,3308,3308,3172,3172,3216,-7,37,30,96.49,456
,20170315,3172,3216,3221,3382,3215,3333,3304,117,88,102,337.10,426
,20170316,3333,3304,3307,3361,3301,3355,3332,51,28,30,99.99,422
,20170317,3355,3332,3333,3338,3286,3286,3311,-46,-21,46,152.33,424
,20170320,3286,3311,3279,3330,3251,3251,3294,-60,-17,26,85.64,428
,20170321,3251,3294,3253,3253,3168,3194,3228,-100,-66,36,116.23,436
,20170322,3194,3228,3132,3163,3055,3055,3114,-173,-114,42,130.80,454
,20170323,3055,3114,3051,3091,3050,3071,3072,-43,-42,28,86.04,456
,20170324,3071,3072,3040,3096,3039,3058,3062,-14,-10,46,140.89,478
,20170327,3058,3062,2969,2969,2902,2930,2937,-132,-125,36,105.74,470
,20170328,2930,2937,2965,3001,2955,2970,2981,33,44,38,113.28,498
,20170329,2970,2981,2974,3058,2974,3046,3013,65,32,26,78.35,492
,20170330,3046,3013,3070,3101,3021,3057,3070,44,57,144,442.22,462
,20170331,3057,3070,3049,3134,3024,3045,3110,-25,40,86,267.46,506
,20170405,3045,3110,3104,3174,3077,3114,3129,4,19,186,582.12,504
,20170406,3114,3129,3132,3143,3073,3085,3101,-44,-28,142,440.37,454
,20170407,3085,3101,3051,3060,2934,2939,2994,-162,-107,152,455.17,464
,20170410,2939,2994,2961,2967,2948,2948,2957,-46,-37,40,118.32,454
,20170411,2948,2957,2927,2948,2914,2929,2943,-28,-14,72,211.96,512
,20170412,2929,2943,2927,2927,2845,2848,2871,-95,-72,58,166.57,510
,20170413,2848,2871,2836,2918,2836,2893,2881,22,10,46,132.53,500
,20170414,2893,2881,2919,2932,2871,2871,2910,-10,29,38,110.62,506
,20170417,2871,2910,2920,2920,2830,2860,2878,-50,-32,54,155.46,542
,20170418,2860,2878,2858,2858,2760,2762,2822,-116,-56,48,135.50,556
,20170419,2762,2822,2780,2792,2777,2792,2789,-30,-33,46,128.31,576
,20170420,2792,2789,2813,2843,2721,2820,2792,31,3,160,446.83,580
,20170421,2820,2792,2860,2905,2848,2866,2862,74,70,118,337.76,556
,20170424,2866,2862,2858,2870,2799,2870,2835,8,-27,142,402.68,548
,20170425,2870,2835,2872,2895,2857,2889,2877,54,42,78,224.42,528
,20170426,2889,2877,2902,2966,2886,2948,2924,71,47,136,397.78,580
,20170427,2948,2924,2905,2931,2896,2931,2908,7,-16,70,203.59,544
,20170428,2931,2908,2963,3006,2936,2990,2966,82,58,268,795.10,498
,20170502,2990,2966,3050,3055,3026,3033,3043,67,77,38,115.66,504
,20170503,3033,3043,3042,3046,3012,3042,3027,-1,-16,48,145.34,488
,20170504,3042,3027,3021,3022,2817,2836,2907,-191,-120,50,145.38,508
,20170505,2836,2907,2856,2856,2801,2822,2827,-85,-80,102,288.42,546
,20170508,2822,2827,2830,2899,2803,2864,2812,37,-15,692,"1,946.02",536
,20170509,2864,2812,2880,2880,2825,2830,2846,18,34,48,136.65,542
,20170510,2830,2846,2875,2905,2868,2897,2886,51,40,34,98.13,546
,20170511,2897,2886,2921,2922,2826,2910,2878,24,-8,50,143.93,532
,20170512,2910,2878,2881,2907,2833,2907,2865,29,-13,26,74.51,530
,20170515,2907,2865,2780,2880,2780,2840,2853,-25,-12,46,131.25,546
,20170516,2840,2853,2833,2854,2818,2832,2835,-21,-18,26,73.72,554
,20170517,2832,2835,2859,2950,2836,2931,2904,96,69,184,534.37,554
,20170518,2931,2904,2941,2986,2888,2968,2942,64,38,64,188.34,568
,20170519,2968,2942,2950,3060,2950,3060,3005,118,63,60,180.30,540
,20170522,3060,3005,3073,3189,3073,3124,3120,119,115,164,511.84,538
,20170523,3124,3120,3144,3169,3111,3111,3140,-9,20,76,238.66,536
,20170524,3111,3140,3104,3121,3045,3052,3059,-88,-81,64,195.78,544
,20170525,3052,3059,3066,3106,3047,3047,3078,-12,19,88,270.90,550
,20170526,3047,3078,3036,3066,3003,3055,3038,-23,-40,172,522.59,536
,20170531,3055,3038,3060,3098,2975,2983,3031,-55,-7,158,479.02,548
,20170601,2983,3031,2941,2951,2907,2951,2925,-80,-106,36,105.33,550
,20170602,2951,2925,2912,3020,2862,2862,2893,-63,-32,110,318.29,538
,20170605,2862,2893,2867,2873,2770,2795,2820,-98,-73,144,406.08,620
,20170606,2795,2820,2778,2839,2778,2835,2812,15,-8,414,"1,164.21",702
,20170607,2835,2812,2829,2876,2823,2824,2832,12,20,84,237.90,690
,20170608,2824,2832,2848,2880,2805,2850,2852,18,20,110,313.80,730
,20170609,2850,2852,2844,2903,2824,2903,2872,51,20,112,321.72,710
,20170612,2903,2872,2903,2927,2879,2910,2908,38,36,48,139.60,712
,20170613,2910,2908,2926,2926,2839,2840,2862,-68,-46,206,589.68,648
,20170614,2840,2862,2845,2935,2843,2930,2899,68,37,162,469.71,626
,20170615,2930,2899,2950,2977,2912,2977,2964,78,65,194,575.03,736
,20170616,2977,2964,2973,3017,2964,2992,2986,28,22,298,889.94,728
,20170619,2992,2986,3000,3046,2992,3020,3025,34,39,98,296.46,698
,20170620,3020,3025,3020,3024,2975,2994,3004,-31,-21,50,150.23,706
,20170621,2994,3004,2962,2962,2933,2956,2951,-48,-53,36,106.25,718
,20170622,2956,2951,3005,3016,2960,2960,2991,9,40,122,364.96,736
,20170623,2960,2991,2947,2991,2934,2991,2965,0,-26,96,284.68,752
,20170626,2991,2965,2999,3034,2993,3014,3010,49,45,118,355.28,752
,20170627,3014,3010,3025,3076,3013,3076,3043,66,33,158,480.93,724
,20170628,3076,3043,3107,3150,3107,3150,3131,107,88,106,331.96,704
,20170629,3150,3131,3151,3203,3126,3175,3168,44,37,116,367.51,698
,20170630,3175,3168,3150,3204,3150,3178,3171,10,3,102,323.46,680
,20170703,3178,3171,3189,3240,3186,3240,3211,69,40,74,237.63,666
,20170704,3240,3211,3241,3282,3188,3188,3244,-23,33,114,369.85,668
,20170705,3188,3244,3330,3330,3194,3249,3248,5,4,152,493.82,628
,20170706,3249,3248,3222,3239,3189,3239,3219,-9,-29,30,96.58,628
,20170707,3239,3219,3221,3254,3202,3253,3224,34,5,120,386.95,660
,20170710,3253,3224,3277,3329,3277,3306,3306,82,82,262,866.35,692
,20170711,3306,3306,3301,3409,3297,3385,3346,79,40,228,763.03,634
,20170712,3385,3346,3410,3458,3383,3413,3418,67,72,76,259.80,660
,20170713,3413,3418,3428,3505,3416,3503,3449,85,31,210,724.45,684
,20170714,3503,3449,3501,3514,3408,3415,3452,-34,3,78,269.30,706
,20170717,3415,3452,3406,3508,3406,3479,3477,27,25,124,431.17,760
,20170718,3479,3477,3507,3536,3441,3441,3458,-36,-19,232,802.27,898
,20170719,3441,3458,3464,3528,3464,3522,3502,64,44,180,630.44,928
,20170720,3522,3502,3515,3515,3380,3380,3410,-122,-92,252,859.48,1074
,20170721,3380,3410,3392,3416,3353,3416,3388,6,-22,206,698.05,900
,20170724,3416,3388,3407,3418,3352,3391,3384,3,-4,86,291.06,890
,20170725,3391,3384,3424,3458,3382,3449,3425,65,41,68,232.91,908
,20170726,3449,3425,3458,3518,3456,3478,3489,53,64,152,530.40,976
,20170727,3478,3489,3467,3488,3435,3476,3455,-13,-34,56,193.51,960
,20170728,3476,3455,3496,3538,3470,3491,3503,36,48,316,"1,107.26",1028
,20170731,3491,3503,3521,3649,3501,3640,3570,137,67,354,"1,264.12",1170
,20170801,3640,3570,3639,3663,3597,3597,3626,27,56,294,"1,066.10",1176
,20170802,3597,3626,3591,3681,3588,3681,3655,55,29,192,701.80,1214
,20170803,3681,3655,3670,3744,3666,3734,3703,79,48,460,"1,703.55",1350
,20170804,3734,3703,3747,3834,3739,3829,3794,126,91,518,"1,965.76",1478
,20170807,3829,3794,3806,4059,3806,3982,3974,188,180,524,"2,082.60",1510
,20170808,3982,3974,3983,4036,3913,3921,3973,-53,-1,798,"3,170.95",1598
,20170809,3921,3973,3950,4033,3920,4027,3972,54,-1,566,"2,248.52",1460
,20170810,4027,3972,4014,4033,3950,3991,3998,19,26,602,"2,406.94",1554
,20170811,3991,3998,3962,4015,3850,3886,3936,-112,-62,502,"1,976.09",1452
,20170814,3886,3936,3885,3924,3829,3845,3877,-91,-59,346,"1,341.68",1336
,20170815,3845,3877,3807,3831,3742,3805,3785,-72,-92,238,901.06,1172
,20170816,3805,3785,3730,3807,3730,3742,3767,-43,-18,114,429.48,1152
,20170817,3742,3767,3778,3896,3767,3863,3845,96,78,88,338.44,1138
,20170818,3863,3845,3871,3929,3828,3929,3866,84,21,76,293.85,1152
,20170821,3929,3866,3911,4025,3856,3990,3941,124,75,116,457.21,1154
,20170822,3990,3941,4012,4024,3942,3980,3969,39,28,154,611.30,1146
,20170823,3980,3969,3930,3939,3784,3866,3864,-103,-105,272,"1,051.15",1126
,20170824,3866,3864,3813,3931,3813,3908,3903,44,39,168,655.85,1208
,20170825,3908,3903,3934,4000,3929,3951,3969,48,66,382,"1,516.18",1298
,20170828,3951,3969,3959,3983,3852,3954,3897,-15,-72,154,600.21,1236
,20170829,3954,3897,3937,3990,3885,3915,3944,18,47,168,662.69,1234
,20170830,3915,3944,3915,3930,3858,3930,3881,-14,-63,384,"1,490.35",1246
,20170831,3930,3881,3880,3948,3823,3941,3903,60,22,64,249.82,1258
,20170901,3941,3903,3967,4132,3941,4072,4061,169,158,434,"1,762.87",1444
,20170904,4072,4061,4093,4208,4086,4108,4147,47,86,1108,"4,595.84",1518
,20170905,4108,4147,4102,4157,4097,4120,4126,-27,-21,172,709.82,1524
,20170906,4120,4126,4119,4150,4034,4034,4096,-92,-30,698,"2,859.37",1550
,20170907,4034,4096,4039,4068,3988,3988,4035,-108,-61,404,"1,630.36",1530
,20170908,3988,4035,4001,4080,3950,3978,4012,-57,-23,394,"1,580.96",1524
,20170911,3978,4012,3960,3993,3900,3990,3959,-22,-53,230,910.79,1570
,20170912,3990,3959,3979,4018,3960,4010,3980,51,21,458,"1,823.26",1676
,20170913,4010,3980,4010,4060,3979,3999,4007,19,27,1102,"4,415.80",1808
,20170914,3999,4007,3982,4010,3900,3919,3966,-88,-41,364,"1,443.75",1862
,20170915,3919,3966,3900,3936,3860,3888,3904,-78,-62,266,"1,038.58",1938
,20170918,3888,3904,3878,3907,3850,3907,3892,3,-12,876,"3,409.47",2108
,20170919,3907,3892,3903,3943,3880,3880,3906,-12,14,182,710.90,2164
,20170920,3880,3906,3880,3946,3860,3946,3898,40,-8,416,"1,621.71",2276
,20170921,3946,3898,3946,3946,3761,3815,3872,-83,-26,330,"1,277.88",2310
,20170922,3815,3872,3825,3834,3748,3748,3811,-124,-61,450,"1,715.18",2548
,20170925,3748,3811,3769,3808,3732,3782,3772,-29,-39,290,"1,094.16",2558
,20170926,3782,3772,3829,3836,3773,3810,3812,38,40,116,442.29,2544
,20170927,3810,3812,3813,3869,3790,3843,3831,31,19,310,"1,187.75",2598
,20170928,3843,3831,3869,3886,3759,3783,3806,-48,-25,396,"1,507.34",2558
,20170929,3783,3806,3782,3852,3718,3836,3779,30,-27,320,"1,209.38",2548
,20171009,3836,3779,3942,3953,3839,3859,3882,80,103,252,978.27,2524
,20171010,3859,3882,3803,3835,3712,3738,3755,-144,-127,282,"1,059.10",2588
,20171011,3738,3755,3707,3777,3700,3700,3734,-55,-21,652,"2,434.87",2586
,20171012,3700,3734,3685,3828,3663,3797,3743,63,9,514,"1,923.96",2564
,20171013,3797,3743,3827,3900,3796,3900,3823,157,80,1490,"5,696.61",2496
,20171016,3900,3823,3924,3935,3838,3870,3881,47,58,510,"1,979.32",2470
,20171017,3870,3881,3811,3849,3750,3750,3793,-131,-88,562,"2,131.85",2544
,20171018,3750,3793,3750,3772,3733,3733,3750,-60,-43,230,862.61,2522
,20171019,3733,3750,3700,3755,3641,3684,3676,-66,-74,832,"3,058.44",2240
,20171020,3684,3676,3664,3798,3664,3795,3750,119,74,370,"1,387.71",2132
,20171023,3795,3750,3844,3867,3694,3777,3754,27,4,156,585.66,2106
,20171024,3777,3754,3791,3802,3762,3780,3767,26,13,256,964.37,2062
,20171025,3780,3767,3774,3814,3734,3734,3760,-33,-7,148,556.51,1948
,20171026,3734,3760,3737,3745,3685,3685,3706,-75,-54,68,252.06,1972
,20171027,3685,3706,3663,3709,3645,3645,3665,-61,-41,152,557.13,1994
,20171030,3645,3665,3659,3659,3620,3638,3645,-27,-20,36,131.25,1988
,20171031,3638,3645,3621,3710,3595,3710,3654,65,9,196,716.23,1934
,20171101,3710,3654,3678,3690,3653,3653,3667,-1,13,248,909.44,1864
,20171102,3653,3667,3690,3747,3690,3700,3725,33,58,216,804.77,1806
,20171103,3700,3725,3692,3700,3688,3700,3692,-25,-33,70,258.45,1810
,20171106,3700,3692,3725,3815,3694,3815,3767,123,75,290,"1,092.47",1866
,20171107,3815,3767,3817,3837,3782,3795,3809,28,42,78,297.17,1882
,20171108,3795,3809,3792,3825,3782,3819,3794,10,-15,28,106.25,1880
,20171109,3819,3794,3859,3923,3841,3868,3865,74,71,390,"1,507.61",1596
,20171110,3868,3865,3864,3937,3856,3937,3869,72,4,244,944.07,1388
,20171113,3937,3869,3915,4048,3915,3998,3999,129,130,240,959.79,1278
,20171114,3998,3999,3992,4040,3988,4040,4002,41,3,54,216.11,1274
,20171115,4040,4002,4040,4040,3983,4009,4009,7,7,414,"1,659.85",982
,20171116,4009,4009,4001,4019,3974,4019,4005,10,-4,138,552.74,878
,20171117,4019,4005,4016,4016,3992,4010,4000,5,-5,124,496.03,870
,20171120,4010,4000,4020,4020,3989,4010,3990,10,-10,194,774.08,870
,20171121,4010,3990,4013,4040,4008,4011,4015,21,25,14,56.22,876
,20171122,4011,4015,4060,4061,4007,4019,4025,4,10,36,144.91,872
,20171123,4019,4025,4093,4093,4092,4092,4092,67,67,22,90.04,866
,20171124,4092,4092,4098,4098,4051,4080,4068,-12,-24,98,398.75,850
,20171127,4080,4068,4123,4189,4068,4137,4152,69,84,208,863.68,838
,20171128,4137,4152,4155,4182,4105,4105,4138,-47,-14,276,"1,142.32",592
,20171129,4105,4138,4080,4250,4065,4250,4147,112,9,328,"1,360.34",586
,20171130,4250,4147,4293,4437,4210,4374,4370,227,223,274,"1,197.65",540
,20171201,4374,4370,4353,4353,4348,4348,4351,-22,-19,180,783.24,480
,20171204,4348,4351,4400,4400,4400,4400,4400,49,49,120,528.00,360
,20171205,4400,4400,4595,4595,4595,4595,4595,195,195,60,275.70,300
,20171206,4595,4595,,,,4550,4550,-45,-45,0,0.00,300
,20171207,4550,4550,4330,4330,4330,4330,4330,-220,-220,60,259.80,300
,20171208,4330,4330,,,,4330,4330,0,0,0,0.00,300
,20171211,4330,4330,,,,4330,4330,0,0,0,0.00,300
,20171212,4330,4330,4460,4460,4460,4460,4460,130,130,60,267.60,300
,20171213,4460,4460,,,,4460,4460,0,0,0,0.00,300
,20171214,4460,4460,4772,4772,4772,4772,4772,312,312,60,286.32,300
,20171215,4772,4772,,,,4772,4772,0,0,0,0.00,300
rb1801,20170117,3295,3295,3285,3285,3123,3165,3201,-130,-94,3418,"10,943.97",2196
,20170118,3165,3201,3180,3214,3137,3160,3162,-41,-39,2228,"7,045.89",2784
,20170119,3160,3162,3168,3182,3121,3142,3147,-20,-15,1424,"4,482.18",3114
,20170120,3142,3147,3150,3179,3081,3092,3132,-55,-15,2760,"8,644.45",4228
,20170123,3092,3132,3092,3109,3051,3075,3078,-57,-54,2132,"6,562.94",4314
,20170124,3075,3078,3079,3200,3075,3165,3148,87,70,4704,"14,811.31",5150
,20170125,3165,3148,3171,3176,3120,3150,3151,2,3,1946,"6,133.65",5552
,20170126,3150,3151,3149,3220,3149,3215,3186,64,35,2604,"8,297.71",5378
,20170203,3215,3186,3215,3216,2950,3050,3074,-136,-112,5126,"15,760.55",6342
,20170206,3050,3074,3030,3052,2985,3002,3010,-72,-64,4940,"14,873.60",8526
,20170207,3002,3010,3002,3055,2986,3041,3022,31,12,4838,"14,622.95",9048
,20170208,3041,3022,3033,3108,3025,3103,3072,81,50,6282,"19,303.79",10034
,20170209,3103,3072,3104,3128,3080,3081,3105,9,33,5014,"15,568.55",10642
,20170210,3081,3105,3081,3235,3000,3191,3145,86,40,7628,"23,997.49",10208
,20170213,3191,3145,3181,3299,3181,3291,3265,146,120,10308,"33,661.67",11292
,20170214,3291,3265,3292,3315,3234,3283,3271,18,6,11130,"36,411.58",14148
,20170215,3283,3271,3288,3296,3215,3235,3253,-36,-18,11852,"38,557.43",16980
,20170216,3235,3253,3233,3310,3203,3218,3252,-35,-1,16222,"52,757.13",20476
,20170217,3218,3252,3217,3276,3216,3258,3255,6,3,9932,"32,333.27",21362
,20170220,3258,3255,3251,3307,3246,3297,3283,42,28,11586,"38,045.85",22390
,20170221,3297,3283,3300,3386,3300,3341,3351,58,68,12144,"40,703.50",23090
,20170222,3341,3351,3341,3353,3288,3302,3316,-49,-35,7758,"25,732.08",23532
,20170223,3302,3316,3290,3341,3250,3275,3302,-41,-14,11526,"38,065.18",25656
,20170224,3275,3302,3280,3300,3196,3278,3241,-24,-61,13554,"43,936.85",26342
,20170227,3278,3241,3276,3390,3265,3355,3334,114,93,15086,"50,304.42",26558
,20170228,3355,3334,3356,3363,3231,3231,3320,-103,-14,13886,"46,102.20",27234
,20170301,3231,3320,3231,3315,3230,3290,3272,-30,-48,16476,"53,918.22",31412
,20170302,3290,3272,3290,3320,3275,3290,3293,18,21,20510,"67,543.70",36080
,20170303,3290,3293,3290,3296,3186,3243,3221,-50,-72,44886,"144,581.25",51552
,20170306,3243,3221,3242,3251,3154,3161,3195,-60,-26,31052,"99,214.39",59600
,20170307,3161,3195,3155,3204,3143,3182,3179,-13,-16,23152,"73,621.97",64606
,20170308,3182,3179,3183,3194,3115,3120,3157,-59,-22,29540,"93,283.46",66422
,20170309,3120,3157,3118,3132,3053,3103,3098,-54,-59,32952,"102,089.90",67658
,20170310,3103,3098,3098,3135,3088,3102,3110,4,12,17762,"55,255.56",67676
,20170313,3102,3110,3102,3213,3055,3213,3128,103,18,27312,"85,443.57",69768
,20170314,3213,3128,3219,3221,3152,3169,3178,41,50,23350,"74,222.51",69938
,20170315,3169,3178,3172,3337,3156,3305,3280,127,102,59688,"195,807.03",63170
,20170316,3305,3280,3305,3333,3262,3329,3302,49,22,26258,"86,707.23",62918
,20170317,3329,3302,3335,3337,3222,3247,3266,-55,-36,39964,"130,553.26",74572
,20170320,3247,3266,3245,3300,3200,3216,3250,-50,-16,30078,"97,763.64",77214
,20170321,3216,3250,3227,3227,3112,3119,3152,-131,-98,47284,"149,056.37",86608
,20170322,3119,3152,3111,3124,2990,2995,3052,-157,-100,65582,"200,218.89",107712
,20170323,2995,3052,3000,3047,2983,2988,3019,-64,-33,60252,"181,959.32",121782
,20170324,2988,3019,2980,3044,2961,2992,2998,-27,-21,62708,"188,058.49",127816
,20170327,2992,2998,2994,2998,2866,2909,2909,-89,-89,91684,"266,764.23",142692
,20170328,2909,2909,2903,2953,2889,2901,2920,-8,11,54960,"160,504.81",148036
,20170329,2901,2920,2901,3018,2901,3013,2972,93,52,77780,"231,187.17",157960
,20170330,3013,2972,3013,3036,2985,3007,3014,35,42,88546,"266,880.00",177690
,20170331,3007,3014,3015,3103,2977,3020,3033,6,19,124338,"377,208.15",191068
,20170405,3020,3033,3097,3129,3032,3071,3090,38,57,92192,"284,892.71",197550
,20170406,3071,3090,3077,3098,3039,3050,3064,-40,-26,96426,"295,522.77",214028
,20170407,3050,3064,3030,3030,2893,2934,2955,-130,-109,194548,"575,039.81",263128
,20170410,2934,2955,2924,2944,2880,2891,2914,-64,-41,119584,"348,501.77",279776
,20170411,2891,2914,2888,2924,2860,2883,2895,-31,-19,111138,"321,775.86",288986
,20170412,2883,2895,2880,2891,2815,2819,2846,-76,-49,101886,"290,067.30",304302
,20170413,2819,2846,2814,2885,2802,2847,2852,1,6,124944,"356,341.39",310656
,20170414,2847,2852,2850,2909,2832,2860,2868,8,16,125504,"360,062.36",312276
,20170417,2860,2868,2860,2897,2800,2810,2832,-58,-36,120760,"342,087.17",324014
,20170418,2810,2832,2812,2830,2718,2729,2774,-103,-58,135576,"376,213.20",348458
,20170419,2729,2774,2735,2753,2718,2745,2739,-29,-35,106084,"290,635.59",352616
,20170420,2745,2739,2746,2801,2685,2795,2748,56,9,165364,"454,544.25",354550
,20170421,2795,2748,2800,2878,2774,2835,2826,87,78,171538,"484,780.59",338508
,20170424,2835,2826,2825,2853,2765,2832,2807,6,-19,131080,"368,040.26",352112
,20170425,2832,2807,2825,2857,2809,2846,2833,39,26,116828,"331,081.65",345756
,20170426,2846,2833,2848,2913,2834,2858,2873,25,40,139680,"401,339.84",351988
,20170427,2858,2873,2863,2900,2850,2897,2873,24,0,118544,"340,612.75",350896
,20170428,2897,2873,2915,2973,2884,2969,2928,96,55,178662,"523,210.75",352228
,20170502,2969,2928,3000,3016,2973,3005,2995,77,67,117230,"351,138.26",344798
,20170503,3005,2995,3009,3016,2962,2984,2985,-11,-10,102124,"304,921.57",354226
,20170504,2984,2985,2973,2978,2776,2789,2861,-196,-124,286762,"820,660.67",398776
,20170505,2789,2861,2800,2815,2740,2772,2780,-89,-81,214480,"596,373.77",413786
,20170508,2772,2780,2783,2847,2741,2796,2791,16,11,321092,"896,209.73",460352
,20170509,2796,2791,2792,2812,2760,2791,2784,0,-7,159542,"444,237.00",471078
,20170510,2791,2784,2782,2834,2780,2829,2814,45,30,221502,"623,394.89",471804
,20170511,2829,2814,2840,2866,2750,2834,2804,20,-10,301768,"846,432.64",467030
,20170512,2834,2804,2829,2840,2733,2734,2785,-70,-19,264174,"735,768.84",500612
,20170515,2734,2785,2740,2806,2716,2769,2762,-16,-23,250470,"691,994.63",496668
,20170516,2769,2762,2775,2786,2742,2762,2761,0,-1,173608,"479,401.27",497176
,20170517,2762,2761,2768,2862,2758,2858,2815,97,54,357594,"1,006,848.39",469042
,20170518,2858,2815,2861,2880,2817,2859,2852,44,37,221564,"631,939.24",480900
,20170519,2859,2852,2841,2950,2810,2947,2899,95,47,359278,"1,041,873.10",453580
,20170522,2947,2899,2947,3085,2942,3038,3016,139,117,405144,"1,222,021.65",447174
,20170523,3038,3016,3053,3062,2991,3003,3027,-13,11,273456,"827,874.86",469296
,20170524,3003,3027,2998,3035,2925,2978,2980,-49,-47,340374,"1,014,539.32",490768
,20170525,2978,2980,2978,3025,2945,2946,2987,-34,7,329220,"983,556.91",498358
,20170526,2946,2987,2947,2976,2902,2967,2939,-20,-48,282506,"830,371.61",502970
,20170531,2967,2939,2980,3013,2838,2844,2922,-95,-17,314376,"918,699.09",547700
,20170601,2844,2922,2845,2869,2805,2835,2838,-87,-84,299018,"848,829.16",588794
,20170602,2835,2838,2836,2847,2778,2781,2807,-57,-31,340164,"955,071.54",639406
,20170605,2781,2807,2770,2789,2701,2701,2738,-106,-69,409612,"1,121,667.59",721816
,20170606,2701,2738,2697,2766,2688,2754,2733,16,-5,425028,"1,161,879.42",705226
,20170607,2754,2733,2750,2788,2741,2762,2762,29,29,253788,"701,146.86",711592
,20170608,2762,2762,2763,2802,2727,2775,2767,13,5,363124,"1,004,913.18",718732
,20170609,2775,2767,2771,2835,2767,2833,2797,66,30,328120,"918,079.33",738380
,20170612,2833,2797,2841,2859,2802,2844,2836,47,39,314706,"892,795.99",750708
,20170613,2844,2836,2845,2859,2770,2770,2814,-66,-22,264170,"743,488.92",749848
,20170614,2770,2814,2768,2866,2761,2865,2807,51,-7,340834,"956,750.73",724364
,20170615,2865,2807,2860,2908,2813,2904,2868,97,61,402812,"1,155,419.71",741488
,20170616,2904,2868,2900,2939,2887,2900,2911,32,43,357898,"1,041,920.19",752924
,20170619,2900,2911,2904,2985,2902,2956,2940,45,29,346554,"1,019,215.19",793672
,20170620,2956,2940,2959,2962,2902,2921,2934,-19,-6,313950,"921,163.50",807874
,20170621,2921,2934,2908,2915,2856,2897,2887,-37,-47,333384,"962,743.03",806372
,20170622,2897,2887,2907,2952,2881,2882,2921,-5,34,454866,"1,329,000.66",808186
,20170623,2882,2921,2892,2936,2882,2932,2901,11,-20,292738,"849,349.46",807308
,20170626,2932,2901,2932,2956,2913,2954,2932,53,31,288452,"845,972.91",805678
,20170627,2954,2932,2954,3024,2942,3022,2979,90,47,323568,"963,930.46",814398
,20170628,3022,2979,3027,3098,3025,3080,3059,101,80,338430,"1,035,403.82",802320
,20170629,3080,3059,3084,3138,3065,3105,3099,46,40,459656,"1,424,846.38",792832
,20170630,3105,3099,3101,3131,3079,3123,3103,24,4,315466,"979,115.67",783410
,20170703,3123,3103,3122,3186,3113,3186,3150,83,47,355596,"1,120,316.38",809582
,20170704,3186,3150,3185,3201,3100,3113,3151,-37,1,482912,"1,521,794.70",810450
,20170705,3113,3151,3128,3207,3121,3171,3164,20,13,556082,"1,759,724.71",786398
,20170706,3171,3164,3155,3168,3108,3161,3141,-3,-23,360146,"1,131,267.38",773950
,20170707,3161,3141,3160,3220,3129,3213,3173,72,32,649508,"2,060,977.70",864334
,20170710,3213,3173,3210,3274,3206,3234,3242,61,69,793100,"2,571,730.48",940740
,20170711,3234,3242,3235,3349,3231,3323,3286,81,44,680426,"2,235,930.81",907418
,20170712,3323,3286,3328,3383,3312,3339,3346,53,60,504096,"1,686,755.68",919142
,20170713,3339,3346,3340,3449,3330,3448,3391,102,45,739104,"2,506,813.10",982022
,20170714,3448,3391,3450,3452,3333,3351,3378,-40,-13,886154,"2,993,968.19",1009820
,20170717,3351,3378,3338,3450,3335,3422,3407,44,29,751954,"2,562,037.58",1012964
,20170718,3422,3407,3420,3440,3368,3383,3409,-24,2,668628,"2,279,500.86",1004894
,20170719,3383,3409,3388,3467,3374,3465,3436,56,27,767302,"2,636,633.11",1019620
,20170720,3465,3436,3459,3463,3303,3309,3383,-127,-53,926904,"3,136,464.79",1055556
,20170721,3309,3383,3318,3349,3288,3327,3319,-56,-64,777374,"2,580,208.17",1079298
,20170724,3327,3319,3330,3368,3280,3329,3318,10,-1,787734,"2,614,306.18",1116518
,20170725,3329,3318,3330,3407,3308,3387,3366,69,48,1156732,"3,894,273.01",1161830
,20170726,3387,3366,3399,3479,3395,3437,3436,71,70,1633938,"5,615,717.02",1335600
,20170727,3437,3436,3429,3459,3385,3442,3421,6,-15,1610662,"5,510,946.18",1440424
,20170728,3442,3421,3435,3490,3415,3435,3451,14,30,1860224,"6,420,460.89",1498932
,20170731,3435,3451,3450,3604,3441,3596,3531,145,80,2132950,"7,532,043.60",1564674
,20170801,3596,3531,3580,3610,3545,3559,3573,28,42,1591240,"5,686,631.27",1594136
,20170802,3559,3573,3549,3644,3531,3627,3606,54,33,2773724,"10,004,028.12",1892428
,20170803,3627,3606,3650,3713,3620,3705,3667,99,61,3919706,"14,375,692.32",2295486
,20170804,3705,3667,3718,3795,3693,3774,3751,107,84,4499920,"16,879,951.92",2338326
,20170807,3774,3751,3780,4013,3755,3928,3907,177,156,6692770,"26,151,184.87",2217192
,20170808,3928,3907,3921,3996,3841,3884,3917,-23,10,6067812,"23,771,582.79",2375240
,20170809,3884,3917,3891,4008,3867,4006,3928,89,11,7154166,"28,103,909.94",2670588
,20170810,4006,3928,3988,4016,3915,3964,3969,36,41,7482000,"29,699,663.81",2782816
,20170811,3964,3969,3945,3993,3812,3862,3907,-107,-62,9155740,"35,779,651.10",2901410
,20170814,3862,3907,3861,3894,3786,3807,3835,-100,-72,7245232,"27,787,498.07",3259910
,20170815,3807,3835,3800,3809,3695,3747,3746,-88,-89,4333142,"16,235,805.86",3349820
,20170816,3747,3746,3742,3769,3696,3707,3730,-39,-16,3306254,"12,335,015.92",3375502
,20170817,3707,3730,3726,3860,3721,3809,3795,79,65,5557758,"21,095,967.24",3285680
,20170818,3809,3795,3800,3900,3776,3895,3823,100,28,3634340,"13,896,929.95",3194436
,20170821,3895,3823,3868,3994,3803,3962,3913,139,90,4277788,"16,742,968.57",3285512
,20170822,3962,3913,3970,3998,3887,3933,3935,20,22,3381224,"13,306,900.63",3249920
,20170823,3933,3935,3918,3918,3710,3779,3795,-156,-140,5422838,"20,584,395.84",3506930
,20170824,3779,3795,3779,3880,3746,3858,3827,63,32,4439100,"16,990,299.81",3273082
,20170825,3858,3827,3855,3978,3846,3930,3926,103,99,4113372,"16,149,294.34",3107668
,20170828,3930,3926,3920,3960,3805,3932,3881,6,-45,4434592,"17,214,034.84",3240038
,20170829,3932,3881,3926,3950,3839,3882,3900,1,19,4324476,"16,868,894.83",3337800
,20170830,3882,3900,3885,3908,3808,3868,3856,-32,-44,4006358,"15,452,074.05",3271128
,20170831,3868,3856,3854,3929,3782,3927,3851,71,-5,5042166,"19,419,783.08",3623044
,20170901,3927,3851,3915,4097,3903,4062,3993,211,142,5397808,"21,558,086.21",3874380
,20170904,4062,3993,4060,4194,4040,4060,4098,67,105,4660264,"19,098,801.13",3722486
,20170905,4060,4098,4060,4127,4051,4084,4088,-14,-10,3474268,"14,204,138.85",3731902
,20170906,4084,4088,4081,4137,3983,3986,4055,-102,-33,4279668,"17,356,353.60",3764716
,20170907,3986,4055,3998,4027,3934,3958,3982,-97,-73,4500946,"17,924,327.80",3658508
,20170908,3958,3982,3951,4038,3887,3916,3961,-66,-21,5079692,"20,122,481.63",3633306
,20170911,3916,3961,3912,3946,3835,3915,3901,-46,-60,3909502,"15,252,143.14",3502388
,20170912,3915,3901,3915,3965,3878,3959,3923,58,22,4357690,"17,095,606.25",3525144
,20170913,3959,3923,3951,4001,3900,3914,3948,-9,25,4162678,"16,438,009.86",3538916
,20170914,3914,3948,3913,3940,3818,3831,3880,-117,-68,5110450,"19,833,459.02",3787372
,20170915,3831,3880,3831,3858,3777,3805,3820,-75,-60,3729164,"14,247,319.15",3631466
,20170918,3805,3820,3808,3830,3742,3801,3787,-19,-33,3851596,"14,588,793.47",3679306
,20170919,3801,3787,3796,3834,3735,3740,3789,-47,2,3327328,"12,609,979.12",3603726
,20170920,3740,3789,3738,3788,3707,3758,3746,-31,-43,3418992,"12,809,078.68",3576370
,20170921,3758,3746,3768,3799,3650,3655,3723,-91,-23,4317254,"16,075,335.23",3831526
,20170922,3655,3723,3650,3654,3527,3554,3598,-169,-125,3657024,"13,158,619.60",3719066
,20170925,3554,3598,3574,3628,3531,3603,3583,5,-15,3402282,"12,192,518.41",3628502
,20170926,3603,3583,3599,3650,3586,3614,3616,31,33,3101096,"11,216,296.75",3517756
,20170927,3614,3616,3613,3684,3608,3679,3644,63,28,3315054,"12,081,981.77",3478262
,20170928,3679,3644,3690,3724,3571,3606,3641,-38,-3,4395896,"16,008,967.50",3445714
,20170929,3606,3641,3615,3699,3524,3695,3603,54,-38,3387018,"12,204,795.03",3102004
,20171009,3695,3603,3762,3795,3674,3701,3733,98,130,2497018,"9,322,051.29",3060556
,20171010,3701,3733,3695,3702,3552,3553,3601,-180,-132,3736474,"13,457,863.61",3466974
,20171011,3553,3601,3550,3618,3512,3523,3567,-78,-34,3363060,"11,996,057.90",3449682
,20171012,3523,3567,3523,3700,3503,3667,3579,100,12,4779306,"17,106,270.26",3639820
,20171013,3667,3579,3665,3820,3643,3815,3718,236,139,4049004,"15,056,035.58",3544560
,20171016,3815,3718,3818,3878,3772,3824,3813,106,95,3796496,"14,477,890.35",3440906
,20171017,3824,3813,3824,3835,3715,3740,3773,-73,-40,3919334,"14,787,815.24",3393398
,20171018,3740,3773,3739,3770,3685,3686,3733,-87,-40,2916468,"10,888,383.43",3202978
,20171019,3686,3733,3691,3691,3566,3604,3620,-129,-113,3844860,"13,921,005.69",3336864
,20171020,3604,3620,3601,3777,3591,3776,3679,156,59,3610592,"13,284,065.65",3165510
,20171023,3776,3679,3777,3778,3602,3700,3694,21,15,4416066,"16,316,617.80",3120240
,20171024,3700,3694,3698,3777,3672,3739,3730,45,36,3076650,"11,477,409.61",2923036
,20171025,3739,3730,3745,3814,3680,3703,3739,-27,9,3378510,"12,633,409.79",2894110
,20171026,3703,3739,3682,3705,3628,3650,3665,-89,-74,3187124,"11,681,463.11",2778456
,20171027,3650,3665,3650,3665,3565,3577,3619,-88,-46,2991008,"10,825,874.29",2786198
,20171030,3577,3619,3581,3628,3561,3571,3591,-48,-28,2092610,"7,515,704.64",2600058
,20171031,3571,3591,3575,3665,3535,3628,3597,37,6,3080286,"11,081,573.94",2677192
,20171101,3628,3597,3634,3657,3561,3563,3615,-34,18,2340156,"8,461,872.65",2520602
,20171102,3563,3615,3580,3680,3555,3642,3622,27,7,2629562,"9,526,817.75",2361794
,20171103,3642,3622,3638,3667,3593,3612,3631,-10,9,1712470,"6,218,361.44",2166496
,20171106,3612,3631,3622,3748,3612,3736,3687,105,56,1871584,"6,900,644.04",2162330
,20171107,3736,3687,3739,3752,3682,3707,3715,20,28,1233250,"4,582,486.65",1965170
,20171108,3707,3715,3705,3743,3675,3724,3705,9,-10,1226686,"4,546,071.59",1929012
,20171109,3724,3705,3736,3832,3725,3760,3775,55,70,1794952,"6,776,393.06",1853406
,20171110,3760,3775,3761,3839,3752,3834,3790,59,15,1233370,"4,675,116.24",1773142
,20171113,3834,3790,3850,3915,3813,3894,3860,104,70,1615718,"6,237,000.26",1794552
,20171114,3894,3860,3900,3954,3873,3946,3911,86,51,978962,"3,828,845.26",1705284
,20171115,3946,3911,3950,3953,3845,3883,3888,-28,-23,1295864,"5,039,323.61",1575790
,20171116,3883,3888,3901,3906,3842,3872,3879,-16,-9,941950,"3,654,391.13",1521458
,20171117,3872,3879,3869,3888,3842,3854,3865,-25,-14,731014,"2,825,953.02",1425474
,20171120,3854,3865,3852,3895,3834,3879,3869,14,4,867802,"3,357,756.31",1330388
,20171121,3879,3869,3880,3949,3865,3926,3908,57,39,698156,"2,728,972.89",1272886
,20171122,3926,3908,3940,3968,3917,3955,3944,47,36,575890,"2,271,712.38",1198942
,20171123,3955,3944,3964,3993,3946,3970,3966,26,22,522390,"2,072,038.41",1158576
,20171124,3970,3966,3970,3997,3917,3993,3964,27,-2,478502,"1,897,070.95",1105982
,20171127,3993,3964,3993,4121,3992,4100,4065,136,101,895760,"3,641,335.21",1155466
,20171128,4100,4065,4102,4156,4102,4150,4129,85,64,717056,"2,961,367.64",1125106
,20171129,4150,4129,4158,4193,4127,4181,4153,52,24,633104,"2,629,712.64",1106440
,20171130,4181,4153,4194,4327,4187,4247,4256,94,103,1118090,"4,758,783.66",992256
,20171201,4247,4256,4250,4302,4226,4278,4266,22,10,666766,"2,844,865.45",917830
,20171204,4278,4266,4281,4403,4256,4399,4336,133,70,621312,"2,694,182.27",867048
,20171205,4399,4336,4399,4444,4375,4392,4412,56,76,536370,"2,366,940.24",800274
,20171206,4392,4412,4390,4396,4313,4344,4355,-68,-57,504860,"2,198,993.77",750124
,20171207,4344,4355,4355,4363,4104,4169,4256,-186,-99,654336,"2,785,075.31",644432
,20171208,4169,4256,4179,4308,4136,4283,4217,27,-39,454926,"1,918,682.54",601280
,20171211,4283,4217,4283,4340,4232,4299,4293,82,76,339790,"1,459,002.64",582598
,20171212,4299,4293,4300,4343,4275,4305,4303,12,10,244442,"1,052,010.06",550798
,20171213,4305,4303,4303,4374,4252,4350,4324,47,21,404204,"1,747,791.58",564590
,20171214,4350,4324,4337,4354,4250,4263,4297,-61,-27,311794,"1,340,089.96",472040
,20171215,4263,4297,4258,4260,4169,4205,4208,-92,-89,322846,"1,358,693.68",410176
,20171218,4205,4208,4215,4279,4207,4244,4237,36,29,215212,"912,005.91",366700
,20171219,4244,4237,4250,4260,4163,4187,4213,-50,-24,135960,"572,878.06",338788
,20171220,4187,4213,4170,4193,4151,4168,4170,-45,-43,87000,"362,810.07",300068
,20171221,4168,4170,4168,4230,4168,4211,4198,41,28,90754,"381,062.62",262884
,20171222,4211,4198,4207,4266,4207,4260,4241,62,43,86756,"367,977.64",237348
,20171225,4260,4241,4250,4269,4159,4163,4206,-78,-35,88804,"373,566.51",205032
,20171226,4163,4206,4158,4160,4041,4095,4105,-111,-101,120330,"493,964.19",153572
,20171227,4095,4105,4080,4125,4065,4090,4100,-15,-5,49648,"203,579.21",133756
,20171228,4090,4100,4092,4151,4082,4141,4116,41,16,48444,"199,420.56",109160
,20171229,4141,4116,4140,4256,4130,4248,4215,132,99,81230,"342,399.08",56894
rb1802,20170216,3253,3253,3206,3283,3200,3200,3229,-53,-24,32,103.34,26
,20170217,3200,3229,3232,3259,3232,3238,3246,9,17,26,84.40,42
,20170220,3238,3246,3300,3300,3259,3286,3277,40,31,36,118.00,72
,20170221,3286,3277,3316,3371,3312,3342,3329,65,52,64,213.11,116
,20170222,3342,3329,3326,3334,3278,3321,3302,-8,-27,46,151.91,152
,20170223,3321,3302,3236,3328,3236,3251,3266,-51,-36,108,352.79,206
,20170224,3251,3266,3275,3275,3190,3263,3224,-3,-42,140,451.49,280
,20170227,3263,3224,3254,3361,3254,3331,3312,107,88,114,377.58,318
,20170228,3331,3312,3327,3335,3234,3234,3300,-78,-12,86,283.84,294
,20170301,3234,3300,3232,3300,3210,3280,3253,-20,-47,80,260.30,316
,20170302,3280,3253,3280,3299,3260,3262,3281,9,28,100,328.12,366
,20170303,3262,3281,3239,3241,3169,3210,3198,-71,-83,208,665.36,472
,20170306,3210,3198,3218,3218,3133,3138,3170,-60,-28,144,456.51,560
,20170307,3138,3170,3144,3179,3140,3155,3162,-15,-8,160,505.98,602
,20170308,3155,3162,3169,3169,3100,3100,3131,-62,-31,184,576.12,738
,20170309,3100,3131,3101,3106,3044,3087,3081,-44,-50,288,887.53,778
,20170310,3087,3081,3085,3111,3070,3085,3088,4,7,160,494.19,788
,20170313,3085,3088,3100,3183,3040,3183,3094,95,6,326,"1,008.75",770
,20170314,3183,3094,3193,3194,3138,3143,3163,49,69,66,208.77,774
,20170315,3143,3163,3140,3302,3140,3297,3220,134,57,612,"1,970.78",730
,20170316,3297,3220,3277,3310,3233,3305,3280,85,60,222,728.28,738
,20170317,3305,3280,3348,3348,3213,3235,3249,-45,-31,286,929.26,784
,20170320,3235,3249,3181,3272,3181,3181,3229,-68,-20,212,684.67,874
,20170321,3181,3229,3198,3200,3099,3103,3126,-126,-103,506,"1,582.08",1210
,20170322,3103,3126,3103,3103,2968,2977,3027,-149,-99,640,"1,937.83",1610
,20170323,2977,3027,2997,3027,2968,2968,2999,-59,-28,258,773.81,1688
,20170324,2968,2999,2955,3011,2941,2972,2985,-27,-14,382,"1,140.53",1730
,20170327,2972,2985,2972,2972,2848,2897,2905,-88,-80,454,"1,319.32",1954
,20170328,2897,2905,2900,2931,2871,2871,2902,-34,-3,274,795.26,1996
,20170329,2871,2902,2892,2987,2892,2987,2957,85,55,592,"1,750.78",1952
,20170330,2987,2957,2985,3010,2962,2998,2991,41,34,284,849.49,1846
,20170331,2998,2991,2983,3071,2959,2994,3012,3,21,680,"2,048.29",1792
,20170405,2994,3012,3030,3095,3012,3039,3049,27,37,520,"1,585.54",1800
,20170406,3039,3049,3045,3065,3007,3022,3027,-27,-22,278,841.78,1796
,20170407,3022,3027,3010,3010,2871,2912,2936,-115,-91,712,"2,090.62",2100
,20170410,2912,2936,2912,2930,2864,2876,2893,-60,-43,210,607.73,2192
,20170411,2876,2893,2841,2898,2840,2873,2867,-20,-26,196,562.05,2226
,20170412,2873,2867,2853,2871,2794,2794,2825,-73,-42,358,"1,011.35",2388
,20170413,2794,2825,2798,2858,2784,2822,2826,-3,1,250,706.67,2434
,20170414,2822,2826,2845,2887,2811,2833,2842,7,16,474,"1,347.14",2398
,20170417,2833,2842,2839,2869,2780,2780,2810,-62,-32,348,977.96,2512
,20170418,2780,2810,2795,2807,2701,2701,2758,-109,-52,646,"1,782.14",2894
,20170419,2701,2758,2700,2733,2700,2726,2721,-32,-37,452,"1,230.08",3030
,20170420,2726,2721,2738,2769,2669,2769,2733,48,12,1136,"3,105.51",3318
,20170421,2769,2733,2780,2848,2757,2814,2803,81,70,722,"2,024.31",3208
,20170424,2814,2803,2812,2828,2745,2803,2787,0,-16,526,"1,466.47",3228
,20170425,2803,2787,2820,2830,2791,2819,2808,32,21,344,966.23,3196
,20170426,2819,2808,2832,2888,2811,2829,2845,21,37,304,865.02,3156
,20170427,2829,2845,2839,2870,2828,2870,2844,25,-1,206,585.94,3138
,20170428,2870,2844,2885,2940,2863,2940,2901,96,57,340,986.67,3142
,20170502,2940,2901,2976,2987,2950,2976,2971,75,70,180,534.89,3130
,20170503,2976,2971,2978,2978,2941,2952,2957,-19,-14,172,508.68,3140
,20170504,2952,2957,2952,2952,2750,2761,2833,-196,-124,960,"2,719.96",3084
,20170505,2761,2833,2780,2780,2718,2751,2755,-82,-78,640,"1,763.24",3302
,20170508,2751,2755,2769,2815,2718,2767,2768,12,13,892,"2,469.73",3512
,20170509,2767,2768,2761,2779,2732,2765,2755,-3,-13,252,694.50,3618
,20170510,2765,2755,2759,2798,2756,2792,2780,37,25,472,"1,312.41",3612
,20170511,2792,2780,2798,2829,2722,2796,2775,16,-5,796,"2,209.22",3550
,20170512,2796,2775,2809,2809,2705,2706,2758,-69,-17,596,"1,643.99",3800
,20170515,2706,2758,2706,2773,2693,2737,2736,-21,-22,626,"1,713.02",3974
,20170516,2737,2736,2740,2744,2716,2735,2732,-1,-4,330,901.84,4010
,20170517,2735,2732,2731,2817,2730,2809,2781,77,49,858,"2,386.48",3640
,20170518,2809,2781,2806,2833,2778,2811,2817,30,36,266,749.35,3656
,20170519,2811,2817,2784,2899,2774,2892,2858,75,41,596,"1,703.63",3610
,20170522,2892,2858,2904,3017,2896,2982,2959,124,101,696,"2,060.04",3272
,20170523,2982,2959,2961,3010,2922,2927,2963,-32,4,248,734.94,3272
,20170524,2927,2963,2934,2960,2868,2918,2912,-45,-51,474,"1,380.71",3238
,20170525,2918,2912,2919,2958,2888,2888,2927,-24,15,244,714.26,3240
,20170526,2888,2927,2877,2900,2850,2900,2877,-27,-50,282,811.31,3202
,20170531,2900,2877,2904,2940,2800,2800,2872,-77,-5,218,626.29,3180
,20170601,2800,2872,2781,2809,2758,2769,2781,-103,-91,156,433.97,3180
,20170602,2769,2781,2773,2774,2734,2741,2750,-40,-31,162,445.53,3260
,20170605,2741,2750,2721,2740,2646,2681,2698,-69,-52,414,"1,117.37",3400
,20170606,2681,2698,2700,2730,2694,2718,2708,20,10,1262,"3,417.98",3784
,20170607,2718,2708,2720,2746,2710,2724,2732,16,24,112,306.01,3784
,20170608,2724,2732,2721,2771,2700,2743,2732,11,0,154,420.88,3798
,20170609,2743,2732,2736,2789,2736,2787,2766,55,34,86,237.94,3790
,20170612,2787,2766,2795,2815,2763,2815,2795,49,29,154,430.44,3782
,20170613,2815,2795,2814,2816,2750,2756,2781,-39,-14,512,"1,424.06",3952
,20170614,2756,2781,2742,2821,2732,2820,2782,39,1,520,"1,446.86",3904
,20170615,2820,2782,2818,2860,2773,2860,2824,78,42,506,"1,429.09",3934
,20170616,2860,2824,2852,2887,2840,2850,2863,26,39,394,"1,128.03",3842
,20170619,2850,2863,2850,2930,2850,2897,2906,34,43,806,"2,342.90",3844
,20170620,2897,2906,2896,2902,2866,2876,2883,-30,-23,234,674.85,3838
,20170621,2876,2883,2862,2884,2822,2853,2845,-30,-38,366,"1,041.31",3798
,20170622,2853,2845,2933,2933,2846,2847,2879,2,34,254,731.33,3798
,20170623,2847,2879,2860,2887,2847,2887,2858,8,-21,314,897.44,3834
,20170626,2887,2858,2877,2906,2876,2906,2895,48,37,192,555.87,3814
,20170627,2906,2895,2907,2965,2896,2964,2930,69,35,300,879.29,3818
,20170628,2964,2930,2969,3035,2969,3030,3002,100,72,276,828.76,3756
,20170629,3030,3002,3046,3079,3017,3044,3042,42,40,276,839.83,3732
,20170630,3044,3042,3031,3079,3015,3065,3041,23,-1,630,"1,916.15",3512
,20170703,3065,3041,3070,3126,3065,3126,3098,85,57,188,582.56,3464
,20170704,3126,3098,3125,3144,3045,3055,3080,-43,-18,700,"2,156.51",3414
,20170705,3055,3080,3068,3134,3068,3117,3103,37,23,526,"1,632.67",3172
,20170706,3117,3103,3098,3108,3051,3104,3083,1,-20,302,931.31,3166
,20170707,3104,3083,3109,3151,3070,3151,3101,68,18,966,"2,996.14",3048
,20170710,3151,3101,3148,3204,3141,3174,3179,73,78,146,464.14,3030
,20170711,3174,3179,3167,3279,3166,3279,3220,100,41,178,573.25,2972
,20170712,3279,3220,3261,3312,3247,3267,3270,47,50,188,614.87,2940
,20170713,3267,3270,3275,3366,3261,3354,3324,84,54,638,"2,121.17",2796
,20170714,3354,3324,3371,3371,3272,3302,3329,-22,5,158,526.14,2778
,20170717,3302,3329,3335,3372,3327,3352,3354,23,25,226,758.06,2722
,20170718,3352,3354,3365,3365,3300,3309,3338,-45,-16,422,"1,408.83",2664
,20170719,3309,3338,3311,3395,3311,3395,3367,57,29,78,262.63,2622
,20170720,3395,3367,3361,3361,3245,3245,3304,-122,-63,86,284.17,2614
,20170721,3245,3304,3251,3276,3166,3274,3251,-30,-53,50,162.59,2602
,20170724,3274,3251,3287,3287,3223,3271,3253,20,2,32,104.11,2598
,20170725,3271,3253,3277,3330,3249,3322,3308,69,55,166,549.24,2594
,20170726,3322,3308,3347,3404,3334,3377,3366,69,58,290,976.19,2628
,20170727,3377,3366,3350,3381,3312,3370,3351,4,-15,174,583.23,2610
,20170728,3370,3351,3390,3417,3351,3351,3387,0,36,124,420.05,2612
,20170731,3351,3387,3373,3549,3373,3535,3470,148,83,166,576.12,2606
,20170801,3535,3470,3529,3529,3488,3494,3504,24,34,56,196.25,2594
,20170802,3494,3504,3505,3570,3505,3570,3556,66,52,130,462.34,2598
,20170803,3570,3556,3581,3638,3569,3636,3595,80,39,150,539.36,2624
,20170804,3636,3595,3656,3746,3651,3723,3694,128,99,172,635.40,2614
,20170807,3723,3694,3704,3944,3703,3853,3868,159,174,368,"1,423.67",2640
,20170808,3853,3868,3888,3929,3810,3819,3878,-49,10,56,217.21,2626
,20170809,3819,3878,3834,3930,3808,3930,3852,52,-26,102,393.00,2648
,20170810,3930,3852,3920,3949,3868,3904,3915,52,63,734,"2,874.29",2680
,20170811,3904,3915,3877,3914,3760,3790,3862,-125,-53,168,648.98,2654
,20170814,3790,3862,3797,3831,3721,3721,3762,-141,-100,376,"1,414.60",2606
,20170815,3721,3762,3724,3726,3623,3686,3667,-76,-95,246,902.18,2614
,20170816,3686,3667,3666,3696,3644,3650,3665,-17,-2,114,417.91,2602
,20170817,3650,3665,3680,3792,3670,3751,3736,86,71,198,739.77,2582
,20170818,3751,3736,3755,3829,3717,3829,3753,93,17,64,240.20,2584
,20170821,3829,3753,3800,3916,3744,3881,3843,128,90,178,684.08,2612
,20170822,3881,3843,3886,3921,3830,3873,3872,30,29,190,735.74,2594
,20170823,3873,3872,3817,3842,3657,3747,3737,-125,-135,294,"1,098.79",2550
,20170824,3747,3737,3692,3807,3684,3787,3760,50,23,118,443.79,2554
,20170825,3787,3760,3724,3906,3724,3854,3847,94,87,234,900.26,2588
,20170828,3854,3847,3879,3891,3751,3863,3824,16,-23,836,"3,197.26",2582
,20170829,3863,3824,3849,3885,3789,3793,3841,-31,17,134,514.73,2590
,20170830,3793,3841,3834,3844,3750,3818,3792,-23,-49,124,470.27,2580
,20170831,3818,3792,3772,3860,3726,3848,3797,56,5,306,"1,161.99",2570
,20170901,3848,3797,3856,4026,3847,4006,3903,209,106,224,874.35,2630
,20170904,4006,3903,4009,4106,3986,4010,4036,107,133,422,"1,703.49",2684
,20170905,4010,4036,4005,4049,3995,4022,4023,-14,-13,180,724.25,2642
,20170906,4022,4023,4024,4049,3922,3922,3990,-101,-33,392,"1,564.33",2624
,20170907,3922,3990,3929,3961,3875,3893,3909,-97,-81,144,562.93,2604
,20170908,3893,3909,3901,3968,3833,3860,3899,-49,-10,276,"1,076.32",2604
,20170911,3860,3899,3848,3861,3797,3860,3832,-39,-67,112,429.20,2590
,20170912,3860,3832,3840,3889,3828,3880,3862,48,30,134,517.52,2590
,20170913,3880,3862,3894,3928,3840,3845,3891,-17,29,172,669.26,2606
,20170914,3845,3891,3848,3863,3761,3772,3806,-119,-85,190,723.22,2570
,20170915,3772,3806,3757,3789,3719,3734,3757,-72,-49,108,405.77,2564
,20170918,3734,3757,3758,3758,3696,3734,3718,-23,-39,88,327.23,2568
,20170919,3734,3718,3747,3754,3680,3680,3730,-38,12,154,574.51,2560
,20170920,3680,3730,3666,3692,3645,3663,3679,-67,-51,294,"1,081.72",2508
,20170921,3663,3679,3693,3717,3588,3588,3663,-91,-16,200,732.72,2536
,20170922,3588,3663,3576,3579,3476,3476,3530,-187,-133,214,755.61,2538
,20170925,3476,3530,3485,3544,3451,3524,3511,-6,-19,128,449.50,2526
,20170926,3524,3511,3530,3563,3522,3543,3540,32,29,36,127.46,2532
,20170927,3543,3540,3550,3600,3544,3595,3579,55,39,338,"1,209.93",2344
,20170928,3595,3579,3607,3643,3501,3533,3549,-46,-30,276,979.61,2314
,20170929,3533,3549,3539,3602,3459,3602,3511,53,-38,146,512.71,2240
,20171009,3602,3511,3634,3701,3602,3609,3661,98,150,198,725.03,2252
,20171010,3609,3661,3614,3614,3490,3495,3535,-166,-126,418,"1,477.80",2302
,20171011,3495,3535,3478,3538,3451,3473,3504,-62,-31,266,932.20,2312
,20171012,3473,3504,3450,3600,3435,3580,3513,76,9,1028,"3,611.98",2336
,20171013,3580,3513,3588,3711,3576,3700,3644,187,131,1072,"3,906.59",2556
,20171016,3700,3644,3722,3763,3697,3718,3722,74,78,346,"1,287.94",2552
,20171017,3718,3722,3720,3744,3657,3694,3716,-28,-6,288,"1,070.29",2570
,20171018,3694,3716,3673,3696,3650,3650,3677,-66,-39,138,507.55,2562
,20171019,3650,3677,3620,3627,3520,3551,3552,-126,-125,330,"1,172.39",2682
,20171020,3551,3552,3546,3700,3542,3700,3634,148,82,1044,"3,794.14",3464
,20171023,3700,3634,3702,3703,3550,3650,3643,16,9,624,"2,273.80",3502
,20171024,3650,3643,3660,3716,3639,3677,3681,34,38,444,"1,634.36",3634
,20171025,3677,3681,3680,3747,3639,3669,3707,-12,26,238,882.29,3628
,20171026,3669,3707,3621,3645,3586,3597,3613,-110,-94,318,"1,149.21",3670
,20171027,3597,3613,3633,3633,3523,3523,3577,-90,-36,182,651.10,3638
,20171030,3523,3577,3515,3561,3513,3513,3539,-64,-38,308,"1,090.19",3668
,20171031,3513,3539,3501,3599,3494,3574,3522,35,-17,278,979.34,3668
,20171101,3574,3522,3564,3599,3518,3518,3562,-4,40,376,"1,339.59",3678
,20171102,3518,3562,3518,3638,3503,3595,3568,33,6,508,"1,812.78",3678
,20171103,3595,3568,3596,3620,3554,3570,3595,2,27,314,"1,129.05",3754
,20171106,3570,3595,3570,3713,3558,3685,3682,90,87,1082,"3,984.99",4104
,20171107,3685,3682,3696,3719,3657,3681,3686,-1,4,1048,"3,863.72",4376
,20171108,3681,3686,3672,3706,3645,3683,3671,-3,-15,364,"1,336.48",4372
,20171109,3683,3671,3699,3797,3699,3736,3735,65,64,456,"1,703.22",4576
,20171110,3736,3735,3730,3776,3718,3776,3745,41,10,72,269.68,4562
,20171113,3776,3745,3813,3826,3764,3819,3801,74,56,596,"2,265.50",4218
,20171114,3819,3801,3812,3852,3790,3828,3831,27,30,310,"1,187.85",4080
,20171115,3828,3831,3838,3843,3716,3773,3756,-58,-75,474,"1,780.40",4042
,20171116,3773,3756,3750,3785,3739,3770,3765,14,9,912,"3,434.25",3914
,20171117,3770,3765,3769,3774,3720,3721,3734,-44,-31,466,"1,740.41",3834
,20171120,3721,3734,3742,3774,3736,3758,3753,24,19,144,540.50,3792
,20171121,3758,3753,3771,3842,3766,3842,3790,89,37,116,439.68,3802
,20171122,3842,3790,3836,3882,3820,3882,3853,92,63,156,601.12,3800
,20171123,3882,3853,3879,3898,3863,3869,3877,16,24,104,403.25,3764
,20171124,3869,3877,3850,3874,3840,3874,3864,-3,-13,138,533.24,3722
,20171127,3874,3864,3894,4018,3873,3950,3947,86,83,112,442.07,3742
,20171128,3950,3947,3963,3997,3940,3989,3980,42,33,310,"1,233.83",3714
,20171129,3989,3980,3969,4039,3954,4039,4002,59,22,442,"1,769.21",3770
,20171130,4039,4002,4076,4161,4041,4087,4089,85,87,360,"1,472.14",3904
,20171201,4087,4089,4091,4159,4070,4081,4103,-8,14,388,"1,592.25",3896
,20171204,4081,4103,4100,4212,4098,4212,4192,109,89,356,"1,492.42",3960
,20171205,4212,4192,4189,4268,4189,4227,4231,35,39,726,"3,072.12",3700
,20171206,4227,4231,4189,4231,4139,4149,4178,-82,-53,366,"1,529.49",3688
,20171207,4149,4178,4165,4177,3967,4014,4143,-164,-35,902,"3,737.07",3360
,20171208,4014,4143,4019,4120,4005,4120,4082,-23,-61,302,"1,233.03",3416
,20171211,4120,4082,4121,4174,4101,4110,4125,28,43,166,684.85,3422
,20171212,4110,4125,4114,4169,4100,4131,4119,6,-6,300,"1,235.95",3394
,20171213,4131,4119,4123,4180,4101,4165,4144,46,25,294,"1,218.34",3408
,20171214,4165,4144,4150,4151,4087,4107,4121,-37,-23,278,"1,145.82",3320
,20171215,4107,4121,4090,4090,4020,4074,4047,-47,-74,350,"1,416.47",3422
,20171218,4074,4047,4052,4186,4047,4068,4076,21,29,308,"1,255.66",3422
,20171219,4068,4076,4080,4087,4012,4027,4040,-49,-36,120,484.84,3388
,20171220,4027,4040,3990,4036,3989,4011,4010,-29,-30,94,377.01,3398
,20171221,4011,4010,4032,4065,4008,4053,4038,43,28,248,"1,001.48",3436
,20171222,4053,4038,4052,4162,4052,4123,4130,85,92,310,"1,280.52",3344
,20171225,4123,4130,4140,4145,4017,4038,4068,-92,-62,184,748.58,3284
,20171226,4038,4068,4020,4081,3975,4011,4019,-57,-49,202,811.85,3300
,20171227,4011,4019,4004,4054,3988,3988,4002,-31,-17,386,"1,544.81",3370
,20171228,3988,4002,3990,4011,3980,3989,3995,-13,-7,348,"1,390.59",3522
,20171229,3989,3995,4018,4062,3978,3987,4027,-8,32,550,"2,215.22",3488
rb1803,20170316,3220,3220,3246,3329,3240,3329,3278,109,58,8,26.23,6
,20170317,3329,3278,3205,3205,3205,3205,3205,-73,-73,4,12.82,10
,20170320,3205,3205,3211,3275,3186,3186,3218,-19,13,34,109.42,34
,20170321,3186,3218,3201,3201,3089,3099,3145,-119,-73,40,125.80,58
,20170322,3099,3145,3081,3095,2981,2986,3030,-159,-115,158,478.82,178
,20170323,2986,3030,3008,3019,2972,2972,3002,-58,-28,196,588.44,264
,20170324,2972,3002,2981,3014,2921,2979,2975,-23,-27,338,"1,005.58",466
,20170327,2979,2975,2964,2968,2854,2900,2919,-75,-56,182,531.27,578
,20170328,2900,2919,2908,2933,2880,2880,2907,-39,-12,94,273.32,600
,20170329,2880,2907,2918,2990,2918,2981,2969,74,62,186,552.34,598
,20170330,2981,2969,2971,3030,2971,2971,2990,2,21,98,293.02,584
,20170331,2971,2990,2975,3075,2956,2998,3007,8,17,178,535.35,620
,20170405,2998,3007,3050,3100,3023,3041,3058,34,51,220,672.77,638
,20170406,3041,3058,3066,3069,3010,3044,3033,-14,-25,76,230.55,650
,20170407,3044,3033,3000,3000,2888,2888,2928,-145,-105,238,696.94,826
,20170410,2888,2928,2908,2929,2868,2876,2901,-52,-27,258,748.69,1036
,20170411,2876,2901,2868,2900,2850,2882,2877,-19,-24,76,218.66,1048
,20170412,2882,2877,2850,2874,2800,2805,2830,-72,-47,174,492.45,1112
,20170413,2805,2830,2846,2861,2787,2832,2836,2,6,168,476.50,1124
,20170414,2832,2836,2841,2889,2818,2835,2846,-1,10,172,489.60,1116
,20170417,2835,2846,2849,2871,2788,2798,2812,-48,-34,148,416.31,1182
,20170418,2798,2812,2811,2811,2710,2712,2767,-100,-45,268,741.67,1344
,20170419,2712,2767,2669,2736,2669,2727,2723,-40,-44,228,620.84,1376
,20170420,2727,2723,2759,2777,2670,2777,2731,54,8,196,535.35,1370
,20170421,2777,2731,2779,2848,2765,2790,2806,59,75,188,527.57,1292
,20170424,2790,2806,2807,2823,2733,2807,2779,1,-27,148,411.33,1312
,20170425,2807,2779,2818,2839,2796,2828,2818,49,39,130,366.36,1316
,20170426,2828,2818,2837,2893,2818,2848,2851,30,33,118,336.45,1304
,20170427,2848,2851,2850,2876,2825,2876,2843,25,-8,224,637.01,1300
,20170428,2876,2843,2890,2950,2873,2928,2904,85,61,140,406.66,1222
,20170502,2928,2904,2975,2982,2930,2980,2972,76,68,54,160.49,1218
,20170503,2980,2972,2971,2975,2945,2965,2964,-7,-8,96,284.64,1158
,20170504,2965,2964,2961,2961,2756,2759,2862,-205,-102,196,561.07,1202
,20170505,2759,2862,2785,2785,2730,2755,2760,-107,-102,166,458.27,1294
,20170508,2755,2760,2798,2801,2693,2773,2762,13,2,218,602.21,1384
,20170509,2773,2762,2773,2780,2737,2764,2756,2,-6,94,259.13,1362
,20170510,2764,2756,2766,2808,2766,2788,2787,32,31,94,261.99,1362
,20170511,2788,2787,2810,2838,2723,2809,2795,22,8,146,408.13,1358
,20170512,2809,2795,2777,2779,2701,2701,2751,-94,-44,72,198.08,1380
,20170515,2701,2751,2728,2784,2681,2739,2726,-12,-25,136,370.75,1418
,20170516,2739,2726,2753,2754,2718,2733,2738,7,12,94,257.38,1442
,20170517,2733,2738,2743,2829,2743,2829,2789,91,51,138,384.91,1418
,20170518,2829,2789,2817,2831,2778,2831,2807,42,18,100,280.80,1382
,20170519,2831,2807,2774,2876,2774,2875,2838,68,31,88,249.74,1390
,20170522,2875,2838,2892,2988,2872,2947,2936,109,98,284,833.94,1352
,20170523,2947,2936,2936,2973,2904,2912,2934,-24,-2,96,281.75,1354
,20170524,2912,2934,2919,2948,2861,2911,2896,-23,-38,130,376.49,1336
,20170525,2911,2896,2910,2940,2882,2882,2911,-14,15,98,285.37,1322
,20170526,2882,2911,2883,2894,2846,2894,2867,-17,-44,122,349.81,1294
,20170531,2894,2867,2892,2923,2780,2780,2840,-87,-27,98,278.39,1308
,20170601,2780,2840,2778,2804,2765,2770,2776,-70,-64,50,138.83,1330
,20170602,2770,2776,2763,2770,2732,2743,2752,-33,-24,118,324.84,1352
,20170605,2743,2752,2735,2743,2685,2694,2701,-58,-51,252,680.73,1528
,20170606,2694,2701,2670,2748,2667,2729,2700,28,-1,270,729.24,1668
,20170607,2729,2700,2722,2746,2705,2738,2737,38,37,122,334.00,1658
,20170608,2738,2737,2740,2777,2726,2748,2755,11,18,50,137.76,1648
,20170609,2748,2755,2740,2793,2740,2793,2766,38,11,62,171.49,1636
,20170612,2793,2766,2794,2818,2766,2806,2796,40,30,90,251.73,1608
,20170613,2806,2796,2811,2820,2760,2761,2772,-35,-24,104,288.39,1610
,20170614,2761,2772,2754,2837,2753,2827,2795,55,23,172,480.90,1624
,20170615,2827,2795,2820,2857,2786,2857,2822,62,27,176,496.84,1648
,20170616,2857,2822,2853,2889,2842,2861,2860,39,38,120,343.28,1614
,20170619,2861,2860,2877,2927,2866,2912,2913,52,53,154,448.72,1594
,20170620,2912,2913,2911,2915,2860,2878,2888,-35,-25,92,265.76,1602
,20170621,2878,2888,2869,2882,2837,2863,2850,-25,-38,86,245.17,1584
,20170622,2863,2850,2883,2918,2867,2867,2891,17,41,84,242.89,1578
,20170623,2867,2891,2865,2898,2857,2894,2869,3,-22,32,91.84,1576
,20170626,2894,2869,2906,2918,2891,2918,2909,49,40,20,58.19,1580
,20170627,2918,2909,2919,2976,2915,2976,2941,67,32,50,147.07,1578
,20170628,2976,2941,2992,3036,2986,3031,3011,90,70,140,421.54,1528
,20170629,3031,3011,3047,3072,3023,3052,3051,41,40,146,445.45,1510
,20170630,3052,3051,3047,3070,3045,3045,3059,-6,8,60,183.58,1492
,20170703,3045,3059,3065,3133,3065,3114,3090,55,31,54,166.89,1494
,20170704,3114,3090,3129,3144,3065,3071,3101,-19,11,114,353.60,1486
,20170705,3071,3101,3239,3239,3087,3120,3113,19,12,160,498.13,1460
,20170706,3120,3113,3111,3111,3060,3099,3091,-14,-22,60,185.49,1460
,20170707,3099,3091,3085,3140,3083,3136,3104,45,13,284,881.62,1368
,20170710,3136,3104,3170,3185,3158,3158,3169,54,65,110,348.66,1358
,20170711,3158,3169,3182,3232,3173,3232,3199,63,30,138,441.56,1346
,20170712,3232,3199,3271,3304,3252,3278,3283,79,84,64,210.12,1350
,20170713,3278,3283,3279,3355,3264,3336,3314,53,31,124,410.95,1292
,20170714,3336,3314,3348,3348,3264,3270,3309,-44,-5,48,158.87,1308
,20170717,3270,3309,3288,3365,3288,3352,3336,43,27,42,140.12,1276
,20170718,3352,3336,3326,3347,3300,3304,3331,-32,-5,26,86.62,1256
,20170719,3304,3331,3334,3361,3334,3361,3343,30,12,18,60.18,1244
,20170720,3361,3343,3326,3331,3258,3258,3284,-85,-59,56,183.93,1250
,20170721,3258,3284,3237,3249,3222,3230,3233,-54,-51,36,116.39,1248
,20170724,3230,3233,3240,3250,3229,3250,3246,17,13,24,77.91,1246
,20170725,3250,3246,3266,3312,3235,3311,3288,65,42,80,263.07,1204
,20170726,3311,3288,3328,3369,3328,3362,3352,74,64,42,140.78,1212
,20170727,3362,3352,3345,3361,3316,3352,3342,0,-10,44,147.06,1206
,20170728,3352,3342,3376,3405,3340,3340,3381,-2,39,74,250.21,1224
,20170731,3340,3381,3394,3511,3394,3511,3455,130,74,54,186.58,1200
,20170801,3511,3455,3515,3518,3474,3484,3503,29,48,26,91.10,1198
,20170802,3484,3503,3478,3552,3462,3552,3544,49,41,104,368.61,1188
,20170803,3552,3544,3568,3636,3565,3634,3584,90,40,120,430.09,1214
,20170804,3634,3584,3649,3728,3648,3728,3665,144,81,110,403.22,1206
,20170807,3728,3665,3692,3921,3692,3847,3851,182,186,136,523.82,1186
,20170808,3847,3851,3868,3891,3788,3788,3871,-63,20,62,240.06,1224
,20170809,3788,3871,3793,3883,3793,3883,3830,12,-41,36,137.90,1206
,20170810,3883,3830,3871,3920,3856,3888,3893,58,63,90,350.37,1200
,20170811,3888,3893,3838,3871,3748,3783,3821,-110,-72,46,175.79,1192
,20170814,3783,3821,3775,3785,3709,3709,3746,-112,-75,80,299.70,1202
,20170815,3709,3746,3709,3721,3624,3663,3636,-83,-110,160,581.90,1194
,20170816,3663,3636,3657,3668,3636,3636,3651,0,15,16,58.42,1200
,20170817,3636,3651,3661,3761,3648,3736,3721,85,70,54,200.99,1200
,20170818,3736,3721,3757,3813,3721,3813,3760,92,39,26,97.78,1200
,20170821,3813,3760,3811,3914,3773,3880,3860,120,100,66,254.81,1200
,20170822,3880,3860,3897,3903,3825,3860,3859,0,-1,108,416.82,1232
,20170823,3860,3859,3828,3828,3660,3716,3718,-143,-141,190,706.57,1210
,20170824,3716,3718,3726,3788,3683,3760,3739,42,21,90,336.53,1214
,20170825,3760,3739,3773,3887,3773,3861,3848,122,109,252,969.91,1244
,20170828,3861,3848,3857,3890,3759,3869,3801,21,-47,288,"1,094.87",1318
,20170829,3869,3801,3856,3866,3784,3852,3818,51,17,198,756.02,1302
,20170830,3852,3818,3817,3823,3761,3823,3799,5,-19,68,258.33,1290
,20170831,3823,3799,3770,3830,3729,3829,3761,30,-38,238,895.23,1278
,20170901,3829,3761,3860,4013,3833,4001,3932,240,171,116,456.19,1244
,20170904,4001,3932,4022,4088,3980,3990,4034,58,102,70,282.40,1260
,20170905,3990,4034,4001,4043,3986,3993,4006,-41,-28,98,392.62,1264
,20170906,3993,4006,4016,4016,3923,3923,3963,-83,-43,76,301.19,1262
,20170907,3923,3963,3922,3925,3881,3881,3911,-82,-52,44,172.11,1286
,20170908,3881,3911,3872,3958,3830,3830,3896,-81,-15,108,420.81,1278
,20170911,3830,3896,3812,3851,3788,3851,3816,-45,-80,64,244.26,1246
,20170912,3851,3816,3849,3888,3827,3837,3850,21,34,20,77.01,1244
,20170913,3837,3850,3879,3923,3825,3842,3884,-8,34,82,318.51,1212
,20170914,3842,3884,3825,3865,3761,3765,3817,-119,-67,132,503.94,1226
,20170915,3765,3817,3752,3761,3718,3718,3745,-99,-72,24,89.88,1228
,20170918,3718,3745,3694,3750,3694,3733,3740,-12,-5,256,957.59,1448
,20170919,3733,3740,3720,3752,3691,3693,3709,-47,-31,124,459.99,1522
,20170920,3693,3709,3662,3690,3655,3689,3661,-20,-48,122,446.76,1584
,20170921,3689,3661,3715,3715,3582,3583,3658,-78,-3,160,585.29,1648
,20170922,3583,3658,3574,3584,3468,3483,3561,-175,-97,192,683.78,1748
,20170925,3483,3561,3498,3538,3466,3515,3512,-46,-49,128,449.59,1768
,20170926,3515,3512,3550,3550,3550,3550,3550,38,38,10,35.50,1768
,20170927,3550,3550,3544,3607,3529,3592,3561,42,11,88,313.43,1766
,20170928,3592,3561,3618,3618,3514,3527,3535,-34,-26,60,212.13,1748
,20170929,3527,3535,3466,3615,3466,3615,3548,80,13,104,369.05,1710
,20171009,3615,3548,3660,3691,3604,3604,3649,56,101,90,328.45,1734
,20171010,3604,3649,3571,3571,3488,3507,3517,-142,-132,220,773.78,1762
,20171011,3507,3517,3473,3528,3458,3471,3487,-46,-30,48,167.39,1776
,20171012,3471,3487,3450,3600,3440,3578,3515,91,28,674,"2,369.52",1826
,20171013,3578,3515,3566,3707,3566,3707,3641,192,126,474,"1,725.89",1948
,20171016,3707,3641,3707,3768,3699,3739,3724,98,83,226,841.63,2044
,20171017,3739,3724,3709,3748,3678,3707,3714,-17,-10,104,386.30,2090
,20171018,3707,3714,3685,3714,3641,3641,3684,-73,-30,174,641.16,2154
,20171019,3641,3684,3617,3617,3525,3568,3550,-116,-134,216,766.90,2326
,20171020,3568,3550,3551,3705,3539,3696,3577,146,27,770,"2,754.86",2564
,20171023,3696,3577,3701,3701,3576,3665,3660,88,83,694,"2,540.49",2856
,20171024,3665,3660,3650,3725,3634,3708,3678,48,18,1658,"6,099.71",3510
,20171025,3708,3678,3694,3766,3667,3683,3729,5,51,482,"1,797.56",3716
,20171026,3683,3729,3646,3672,3604,3604,3635,-125,-94,716,"2,602.72",4138
,20171027,3604,3635,3618,3626,3550,3550,3595,-85,-40,704,"2,531.35",4144
,20171030,3550,3595,3556,3576,3539,3557,3564,-38,-31,48,171.09,4138
,20171031,3557,3564,3534,3610,3504,3610,3560,46,-4,186,662.24,4152
,20171101,3610,3560,3573,3619,3542,3542,3589,-18,29,286,"1,026.62",4286
,20171102,3542,3589,3540,3656,3529,3621,3602,32,13,732,"2,636.76",4640
,20171103,3621,3602,3605,3642,3582,3582,3616,-20,14,452,"1,634.64",4846
,20171106,3582,3616,3593,3732,3585,3717,3674,101,58,398,"1,462.53",5014
,20171107,3717,3674,3711,3731,3673,3697,3703,23,29,938,"3,474.00",5680
,20171108,3697,3703,3684,3712,3660,3697,3684,-6,-19,300,"1,105.42",5754
,20171109,3697,3684,3731,3816,3707,3741,3769,57,85,494,"1,862.24",5814
,20171110,3741,3769,3723,3788,3723,3773,3742,4,-27,186,696.07,5846
,20171113,3773,3742,3811,3814,3748,3808,3784,66,42,1090,"4,124.95",5322
,20171114,3808,3784,3815,3849,3791,3832,3823,48,39,278,"1,062.82",5220
,20171115,3832,3823,3831,3838,3709,3750,3756,-73,-67,892,"3,350.78",4890
,20171116,3750,3756,3768,3779,3735,3748,3754,-8,-2,132,495.56,4832
,20171117,3748,3754,3746,3746,3680,3680,3704,-74,-50,56,207.45,4840
,20171120,3680,3704,3706,3771,3706,3752,3746,48,42,216,809.27,4824
,20171121,3752,3746,3769,3826,3761,3809,3801,63,55,222,844.01,4708
,20171122,3809,3801,3820,3869,3814,3869,3842,68,41,256,983.60,4660
,20171123,3869,3842,3858,3884,3850,3857,3866,15,24,314,"1,214.05",4614
,20171124,3857,3866,3803,3854,3796,3854,3827,-12,-39,144,551.10,4646
,20171127,3854,3827,3849,3938,3843,3882,3881,55,54,722,"2,802.28",4442
,20171128,3882,3881,3870,3953,3870,3953,3928,72,47,376,"1,477.10",4408
,20171129,3953,3928,3945,4031,3922,4029,3975,101,47,484,"1,924.03",4342
,20171130,4029,3975,4042,4111,4029,4060,4065,85,90,420,"1,707.43",4236
,20171201,4060,4065,4064,4106,4020,4052,4063,-13,-2,280,"1,137.71",4182
,20171204,4052,4063,4043,4178,4042,4145,4142,82,79,976,"4,042.87",4234
,20171205,4145,4142,4145,4179,4131,4136,4158,-6,16,510,"2,120.75",3998
,20171206,4136,4158,4108,4135,4046,4046,4070,-112,-88,104,423.28,3944
,20171207,4046,4070,4066,4079,3935,3965,4030,-105,-40,546,"2,200.88",3738
,20171208,3965,4030,4041,4050,3970,4050,4011,20,-19,156,625.82,3738
,20171211,4050,4011,4066,4095,4031,4042,4066,31,55,134,544.95,3742
,20171212,4042,4066,4069,4098,4013,4026,4073,-40,7,108,439.93,3746
,20171213,4026,4073,4013,4054,4002,4038,4019,-35,-54,264,"1,061.07",3770
,20171214,4038,4019,4054,4067,3991,3993,4034,-26,15,42,169.43,3756
,20171215,3993,4034,3859,4050,3859,4003,3994,-31,-40,234,934.74,3818
,20171218,4003,3994,4022,4067,3993,4036,4042,42,48,450,"1,819.06",3650
,20171219,4036,4042,4035,4035,3945,3958,3974,-84,-68,110,437.22,3570
,20171220,3958,3974,3931,3972,3931,3955,3964,-19,-10,78,309.25,3552
,20171221,3955,3964,3998,4031,3977,4010,3995,46,31,98,391.53,3580
,20171222,4010,3995,4010,4100,4001,4099,4074,104,79,176,717.06,3620
,20171225,4099,4074,4091,4091,3946,3964,4007,-110,-67,238,953.89,3708
,20171226,3964,4007,3962,3993,3947,3977,3972,-30,-35,122,484.66,3746
,20171227,3977,3972,3979,3988,3952,3974,3972,2,0,154,611.77,3848
,20171228,3974,3972,3958,3988,3927,3977,3961,5,-11,210,831.87,3942
,20171229,3977,3961,3966,4014,3947,3969,3990,8,29,286,"1,141.17",3972
rb1804,20170418,2812,2812,2772,2782,2728,2728,2757,-84,-55,12,33.09,4
,20170419,2728,2757,2732,2734,2732,2734,2733,-23,-24,4,10.93,6
,20170420,2734,2733,,,,2741,2741,8,8,0,0.00,6
,20170421,2741,2741,2793,2840,2793,2814,2821,73,80,82,231.35,6
,20170424,2814,2821,2825,2825,2791,2791,2808,-30,-13,6,16.85,10
,20170425,2791,2808,2820,2830,2820,2830,2828,22,20,12,33.94,18
,20170426,2830,2828,,,,2845,2845,17,17,0,0.00,18
,20170427,2845,2845,2868,2877,2826,2877,2859,32,14,10,28.60,20
,20170428,2877,2859,2888,2941,2888,2940,2918,81,59,44,128.42,46
,20170502,2940,2918,2992,3106,2952,3106,2986,188,68,24,71.67,46
,20170503,3106,2986,2980,2985,2949,2969,2973,-17,-13,54,160.59,58
,20170504,2969,2973,2918,2921,2764,2789,2815,-184,-158,214,602.53,218
,20170505,2789,2815,2769,2788,2733,2765,2763,-50,-52,122,337.15,262
,20170508,2765,2763,2783,2818,2733,2778,2776,15,13,114,316.54,266
,20170509,2778,2776,2785,2785,2748,2748,2768,-28,-8,68,188.22,280
,20170510,2748,2768,2765,2801,2765,2799,2783,31,15,136,378.57,302
,20170511,2799,2783,2807,2807,2740,2796,2767,13,-16,126,348.71,286
,20170512,2796,2767,2778,2910,2716,2716,2751,-51,-16,150,412.73,358
,20170515,2716,2751,2723,2780,2697,2731,2736,-20,-15,100,273.66,376
,20170516,2731,2736,2752,2752,2730,2730,2735,-6,-1,46,125.85,376
,20170517,2730,2735,2761,2818,2729,2805,2775,70,40,122,338.58,334
,20170518,2805,2775,2809,2814,2752,2805,2799,30,24,136,380.79,322
,20170519,2805,2799,2782,2862,2781,2862,2824,63,25,120,338.94,320
,20170522,2862,2824,2855,2980,2845,2948,2911,124,87,246,716.29,330
,20170523,2948,2911,2970,2971,2886,2917,2923,6,12,52,152.03,324
,20170524,2917,2923,2913,2932,2863,2909,2885,-14,-38,90,259.72,334
,20170525,2909,2885,2894,2930,2875,2875,2907,-10,22,94,273.34,316
,20170526,2875,2907,2873,2873,2828,2857,2857,-50,-50,136,388.64,294
,20170531,2857,2857,2879,2905,2760,2760,2827,-97,-30,84,237.55,308
,20170601,2760,2827,2773,2774,2744,2744,2760,-83,-67,38,104.88,316
,20170602,2744,2760,2750,2750,2730,2739,2744,-21,-16,104,285.43,394
,20170605,2739,2744,2717,2734,2694,2707,2710,-37,-34,110,298.18,424
,20170606,2707,2710,2687,2745,2687,2734,2723,24,13,136,370.35,436
,20170607,2734,2723,2735,2761,2729,2744,2744,21,21,58,159.16,430
,20170608,2744,2744,2740,2774,2740,2743,2762,-1,18,72,198.87,406
,20170609,2743,2762,2751,2786,2751,2778,2772,16,10,38,105.36,408
,20170612,2778,2772,2792,2810,2772,2810,2790,38,18,44,122.80,396
,20170613,2810,2790,2782,2785,2759,2759,2773,-31,-17,120,332.81,410
,20170614,2759,2773,2748,2817,2748,2809,2783,36,10,112,311.77,396
,20170615,2809,2783,2806,2850,2783,2846,2822,63,39,114,321.76,396
,20170616,2846,2822,2855,2881,2844,2848,2853,26,31,62,176.92,404
,20170619,2848,2853,2888,2900,2888,2900,2893,47,40,8,23.14,400
,20170620,2900,2893,2895,2895,2864,2876,2884,-17,-9,170,490.42,424
,20170621,2876,2884,2849,2857,2833,2857,2845,-27,-39,46,130.87,418
,20170622,2857,2845,2877,2897,2856,2856,2878,11,33,28,80.61,420
,20170623,2856,2878,2865,2894,2860,2894,2866,16,-12,44,126.11,424
,20170626,2894,2866,2888,2919,2887,2911,2897,45,31,96,278.12,410
,20170627,2911,2897,2915,2945,2910,2945,2921,48,24,40,116.86,408
,20170628,2945,2921,2987,3008,2987,3008,2996,87,75,22,65.93,406
,20170629,3008,2996,3042,3067,3036,3061,3057,65,61,58,177.31,432
,20170630,3061,3057,3079,3079,3057,3073,3066,16,9,24,73.60,444
,20170703,3073,3066,3069,3108,3068,3108,3082,42,16,22,67.81,434
,20170704,3108,3082,3150,3150,3050,3066,3104,-16,22,30,93.14,454
,20170705,3066,3104,3102,3115,3091,3095,3098,-9,-6,76,235.49,474
,20170706,3095,3098,3086,3086,3070,3074,3078,-24,-20,10,30.79,468
,20170707,3074,3078,3091,3282,3080,3282,3095,204,17,126,390.06,484
,20170710,3282,3095,3179,3197,3137,3180,3179,85,84,34,108.09,494
,20170711,3180,3179,3197,3288,3196,3288,3223,109,44,134,431.92,510
,20170712,3288,3223,3271,3317,3252,3260,3279,37,56,54,177.09,528
,20170713,3260,3279,3278,3349,3260,3345,3297,66,18,110,362.75,528
,20170714,3345,3297,3333,3333,3298,3305,3320,8,23,16,53.13,524
,20170717,3305,3320,3284,3359,3284,3347,3329,27,9,20,66.60,522
,20170718,3347,3329,3346,3352,3293,3302,3324,-27,-5,36,119.69,532
,20170719,3302,3324,3321,3374,3318,3349,3342,25,18,40,133.68,518
,20170720,3349,3342,3334,3341,3240,3248,3281,-94,-61,44,144.37,516
,20170721,3248,3281,3249,3258,3227,3258,3239,-23,-42,76,246.20,546
,20170724,3258,3239,3270,3270,3228,3252,3248,13,9,10,32.48,550
,20170725,3252,3248,3267,3313,3267,3312,3292,64,44,12,39.51,554
,20170726,3312,3292,3322,3376,3322,3363,3363,71,71,48,161.43,592
,20170727,3363,3363,3338,3369,3321,3328,3344,-35,-19,30,100.34,586
,20170728,3328,3344,3365,3388,3363,3363,3375,19,31,58,195.75,590
,20170731,3363,3375,3413,3500,3399,3500,3452,125,77,34,117.38,590
,20170801,3500,3452,3504,3504,3481,3481,3490,29,38,6,20.94,596
,20170802,3481,3490,3463,3570,3463,3570,3520,80,30,22,77.44,604
,20170803,3570,3520,3559,3643,3559,3643,3600,123,80,62,223.23,604
,20170804,3643,3600,3651,3713,3626,3696,3672,96,72,42,154.25,608
,20170807,3696,3672,3708,3924,3680,3850,3834,178,162,70,268.39,612
,20170808,3850,3834,3834,3860,3740,3740,3802,-94,-32,56,212.94,630
,20170809,3740,3802,3797,3824,3787,3788,3802,-14,0,10,38.03,628
,20170810,3788,3802,3867,3871,3833,3870,3853,68,51,20,77.07,628
,20170811,3870,3853,3831,3867,3719,3745,3802,-108,-51,36,136.87,624
,20170814,3745,3802,3752,3762,3682,3695,3714,-107,-88,56,208.00,628
,20170815,3695,3714,3685,3709,3627,3641,3659,-73,-55,34,124.42,632
,20170816,3641,3659,3615,3646,3607,3613,3622,-46,-37,50,181.15,652
,20170817,3613,3622,3640,3749,3633,3720,3695,98,73,80,295.68,622
,20170818,3720,3695,3733,3780,3697,3780,3727,85,32,68,253.44,616
,20170821,3780,3727,3782,3974,3727,3858,3799,131,72,46,174.78,624
,20170822,3858,3799,3880,3883,3825,3837,3854,38,55,38,146.48,628
,20170823,3837,3854,3816,3816,3696,3711,3759,-143,-95,60,225.54,634
,20170824,3711,3759,3703,3762,3669,3755,3714,-4,-45,90,334.28,634
,20170825,3755,3714,3758,3875,3756,3841,3829,127,115,44,168.50,628
,20170828,3841,3829,3838,3871,3763,3833,3803,4,-26,146,555.34,622
,20170829,3833,3803,3781,3854,3771,3793,3821,-10,18,92,351.56,618
,20170830,3793,3821,3811,3822,3750,3822,3794,1,-27,56,212.49,626
,20170831,3822,3794,3768,3818,3724,3818,3787,24,-7,122,462.04,644
,20170901,3818,3787,3845,3999,3831,3974,3901,187,114,54,210.68,650
,20170904,3974,3901,3912,4058,3912,4000,3993,99,92,68,271.58,648
,20170905,4000,3993,3988,4016,3964,3984,3988,-9,-5,42,167.53,650
,20170906,3984,3988,4005,4005,3901,3901,3955,-87,-33,94,371.80,666
,20170907,3901,3955,3915,3936,3876,3876,3906,-79,-49,66,257.86,654
,20170908,3876,3906,3900,3900,3830,3830,3850,-76,-56,10,38.50,660
,20170911,3830,3850,3811,3855,3780,3840,3814,-10,-36,72,274.67,662
,20170912,3840,3814,3821,3859,3809,3856,3835,42,21,52,199.43,646
,20170913,3856,3835,3840,3840,3839,3839,3839,4,4,14,53.75,636
,20170914,3839,3839,3799,3832,3764,3764,3783,-75,-56,12,45.40,640
,20170915,3764,3783,3761,3761,3711,3726,3742,-57,-41,30,112.28,650
,20170918,3726,3742,3723,3740,3679,3727,3731,-15,-11,410,"1,529.96",990
,20170919,3727,3731,3715,3749,3684,3684,3706,-47,-25,116,429.95,1056
,20170920,3684,3706,3650,3675,3636,3658,3653,-48,-53,132,482.20,1114
,20170921,3658,3653,3702,3702,3582,3582,3634,-71,-19,52,188.98,1112
,20170922,3582,3634,3540,3544,3481,3481,3532,-153,-102,90,317.93,1172
,20170925,3481,3532,3482,3528,3462,3510,3500,-22,-32,34,119.01,1172
,20170926,3510,3500,3527,3530,3517,3530,3524,30,24,12,42.30,1172
,20170927,3530,3524,3546,3564,3526,3543,3541,19,17,60,212.51,1172
,20170928,3543,3541,3594,3594,3490,3532,3528,-9,-13,36,127.03,1172
,20170929,3532,3528,3539,3603,3478,3603,3556,75,28,36,128.04,1172
,20171009,3603,3556,3653,3694,3598,3616,3675,60,119,116,426.39,1172
,20171010,3616,3675,3588,3588,3474,3474,3529,-201,-146,108,381.18,1192
,20171011,3474,3529,3468,3504,3468,3490,3487,-39,-42,24,83.71,1188
,20171012,3490,3487,3450,3595,3439,3595,3477,108,-10,274,952.94,1306
,20171013,3595,3477,3574,3717,3571,3717,3620,240,143,284,"1,028.35",1304
,20171016,3717,3620,3710,3765,3696,3732,3721,112,101,112,416.76,1290
,20171017,3732,3721,3728,3763,3691,3737,3733,16,12,222,828.79,1318
,20171018,3737,3733,3725,3730,3673,3673,3708,-60,-25,1074,"3,982.84",1708
,20171019,3673,3708,3633,3633,3552,3584,3594,-124,-114,306,"1,100.00",1844
,20171020,3584,3594,3598,3744,3592,3744,3638,150,44,260,946.06,1924
,20171023,3744,3638,3733,3739,3620,3708,3680,70,42,688,"2,532.38",2132
,20171024,3708,3680,3640,3774,3640,3764,3696,84,16,1346,"4,975.34",1806
,20171025,3764,3696,3740,3803,3693,3730,3752,34,56,928,"3,481.92",2520
,20171026,3730,3752,3703,3737,3678,3689,3700,-63,-52,670,"2,479.45",2936
,20171027,3689,3700,3669,3708,3619,3619,3665,-81,-35,342,"1,253.57",3002
,20171030,3619,3665,3617,3648,3611,3611,3636,-54,-29,72,261.81,3032
,20171031,3611,3636,3606,3701,3596,3701,3640,65,4,230,837.36,3118
,20171101,3701,3640,3667,3712,3626,3626,3676,-14,36,1154,"4,242.20",4050
,20171102,3626,3676,3627,3733,3602,3710,3694,34,18,376,"1,389.13",4052
,20171103,3710,3694,3716,3730,3664,3664,3705,-30,11,226,837.54,4066
,20171106,3664,3705,3699,3801,3699,3798,3756,93,51,170,638.54,4082
,20171107,3798,3756,3799,3810,3751,3783,3789,27,33,2144,"8,123.81",4552
,20171108,3783,3789,3750,3789,3733,3786,3751,-3,-38,130,487.76,4596
,20171109,3786,3751,3783,3870,3765,3795,3835,44,84,540,"2,071.29",4468
,20171110,3795,3835,3800,3849,3774,3849,3822,14,-13,296,"1,131.56",4404
,20171113,3849,3822,3853,3872,3807,3848,3831,26,9,588,"2,252.81",4186
,20171114,3848,3831,3858,3889,3836,3876,3861,45,30,194,749.15,4116
,20171115,3876,3861,3862,3888,3751,3779,3795,-82,-66,436,"1,654.64",4010
,20171116,3779,3795,3783,3784,3750,3763,3765,-32,-30,242,911.22,4008
,20171117,3763,3765,3766,3771,3688,3688,3735,-77,-30,190,709.73,3958
,20171120,3688,3735,3714,3781,3708,3762,3722,27,-13,444,"1,652.73",3918
,20171121,3762,3722,3773,3834,3770,3829,3810,107,88,148,563.88,3880
,20171122,3829,3810,3834,3885,3826,3877,3846,67,36,614,"2,361.78",3860
,20171123,3877,3846,3799,3901,3799,3860,3884,14,38,194,753.58,3818
,20171124,3860,3884,3837,3863,3812,3857,3840,-27,-44,136,522.33,3780
,20171127,3857,3840,3870,3927,3841,3885,3891,45,51,250,972.95,3740
,20171128,3885,3891,3882,3933,3881,3933,3902,42,11,230,897.57,3720
,20171129,3933,3902,3924,4020,3898,4012,3965,110,63,188,745.43,3748
,20171130,4012,3965,4024,4102,4006,4046,4051,81,86,272,"1,102.05",3782
,20171201,4046,4051,4051,4070,4006,4044,4034,-7,-17,142,572.92,3728
,20171204,4044,4034,4027,4166,4023,4125,4137,91,103,800,"3,310.12",3642
,20171205,4125,4137,4132,4160,4098,4110,4126,-27,-11,468,"1,931.16",3620
,20171206,4110,4126,4107,4107,3988,4001,4027,-125,-99,546,"2,199.04",3468
,20171207,4001,4027,4009,4022,3889,3925,3986,-102,-41,630,"2,511.22",3358
,20171208,3925,3986,3925,3989,3901,3989,3922,3,-64,150,588.34,3344
,20171211,3989,3922,3988,4053,3969,3993,4009,71,87,174,697.61,3280
,20171212,3993,4009,3993,4065,3970,3980,4023,-29,14,412,"1,657.80",3092
,20171213,3980,4023,3969,3982,3917,3933,3950,-90,-73,126,497.71,3034
,20171214,3933,3950,3936,3956,3879,3895,3932,-55,-18,364,"1,431.58",3040
,20171215,3895,3932,3881,3925,3872,3923,3906,-9,-26,306,"1,195.44",3154
,20171218,3923,3906,3951,4009,3920,3956,3952,50,46,266,"1,051.33",3184
,20171219,3956,3952,3930,3930,3874,3885,3891,-67,-61,340,"1,323.00",3372
,20171220,3885,3891,3875,3916,3861,3869,3893,-22,2,294,"1,144.83",3390
,20171221,3869,3893,3909,3966,3896,3945,3928,52,35,172,675.76,3396
,20171222,3945,3928,3960,4040,3956,4032,4012,104,84,998,"4,004.79",3572
,20171225,4032,4012,4027,4027,3877,3883,3924,-129,-88,242,949.84,3566
,20171226,3883,3924,3877,3930,3877,3921,3911,-3,-13,394,"1,541.17",3752
,20171227,3921,3911,3910,3925,3887,3892,3906,-19,-5,504,"1,968.89",3936
,20171228,3892,3906,3870,3888,3840,3868,3862,-38,-44,274,"1,058.40",4040
,20171229,3868,3862,3850,3919,3850,3878,3896,16,34,620,"2,415.64",4344
rb1805,20170516,2736,2736,2739,2740,2694,2706,2708,-30,-28,7720,"20,907.65",5638
,20170517,2706,2708,2709,2785,2702,2780,2742,72,34,12162,"33,353.47",9286
,20170518,2780,2742,2781,2789,2745,2766,2770,24,28,13680,"37,900.86",15220
,20170519,2766,2770,2760,2835,2703,2832,2796,62,26,31418,"87,855.72",21658
,20170522,2832,2796,2841,2960,2818,2921,2885,125,89,37270,"107,542.48",26460
,20170523,2921,2885,2928,2947,2878,2894,2914,9,29,25764,"75,077.75",31250
,20170524,2894,2914,2899,2923,2830,2876,2877,-38,-37,34276,"98,620.38",36920
,20170525,2876,2877,2876,2901,2840,2842,2872,-35,-5,35468,"101,883.19",41782
,20170526,2842,2872,2842,2859,2792,2838,2818,-34,-54,34674,"97,744.59",40876
,20170531,2838,2818,2842,2873,2735,2737,2802,-81,-16,30074,"84,274.15",50010
,20170601,2737,2802,2749,2759,2710,2742,2734,-60,-68,30274,"82,784.14",60590
,20170602,2742,2734,2747,2749,2701,2702,2717,-32,-17,41144,"111,793.18",68518
,20170605,2702,2717,2700,2713,2668,2670,2683,-47,-34,49090,"131,726.61",84742
,20170606,2670,2683,2673,2733,2654,2718,2705,35,22,45884,"124,132.27",85544
,20170607,2718,2705,2720,2749,2712,2723,2727,18,22,26000,"70,908.74",88452
,20170608,2723,2727,2720,2750,2702,2732,2726,5,-1,38188,"104,132.03",88172
,20170609,2732,2726,2730,2773,2729,2772,2749,46,23,30900,"84,964.45",83678
,20170612,2772,2749,2775,2788,2747,2774,2769,25,20,31598,"87,521.61",81872
,20170613,2774,2769,2780,2787,2738,2738,2763,-31,-6,26886,"74,303.56",83916
,20170614,2738,2763,2745,2797,2722,2796,2759,33,-4,38842,"107,179.80",81672
,20170615,2796,2759,2796,2835,2759,2834,2799,75,40,38676,"108,265.04",77872
,20170616,2834,2799,2831,2864,2820,2837,2841,38,42,31820,"90,430.74",78132
,20170619,2837,2841,2837,2896,2836,2877,2864,36,23,33220,"95,153.35",76288
,20170620,2877,2864,2885,2885,2831,2853,2858,-11,-6,27914,"79,804.83",77834
,20170621,2853,2858,2840,2855,2802,2836,2825,-22,-33,25186,"71,160.09",79790
,20170622,2836,2825,2846,2885,2826,2826,2858,1,33,35536,"101,570.99",77942
,20170623,2826,2858,2835,2873,2830,2872,2845,14,-13,30862,"87,808.62",79978
,20170626,2872,2845,2872,2894,2858,2892,2872,47,27,28732,"82,530.75",80012
,20170627,2892,2872,2890,2945,2880,2943,2909,71,37,27232,"79,244.70",75970
,20170628,2943,2909,2945,3015,2944,3008,2978,99,69,31200,"92,936.51",75978
,20170629,3008,2978,3009,3068,3005,3029,3029,51,51,56990,"172,648.17",79650
,20170630,3029,3029,3037,3048,3000,3046,3026,17,-3,35912,"108,689.25",77800
,20170703,3046,3026,3048,3113,3036,3111,3074,85,48,38120,"117,191.42",73246
,20170704,3111,3074,3111,3122,3023,3036,3076,-38,2,41732,"128,371.66",75394
,20170705,3036,3076,3038,3119,3038,3080,3075,4,-1,42060,"129,367.66",75300
,20170706,3080,3075,3067,3075,3028,3074,3054,-1,-21,23822,"72,754.83",75012
,20170707,3074,3054,3069,3118,3047,3109,3076,55,22,45646,"140,420.12",79456
,20170710,3109,3076,3124,3166,3108,3136,3141,60,65,36774,"115,508.92",82122
,20170711,3136,3141,3130,3235,3130,3219,3181,78,40,33874,"107,769.87",82858
,20170712,3219,3181,3220,3267,3201,3213,3231,32,50,33766,"109,114.56",83714
,20170713,3213,3231,3215,3313,3206,3309,3258,78,27,37700,"122,852.36",86522
,20170714,3309,3258,3315,3316,3213,3228,3256,-30,-2,43038,"140,143.55",87534
,20170717,3228,3256,3220,3314,3213,3290,3276,34,20,35862,"117,505.97",86942
,20170718,3290,3276,3295,3307,3235,3242,3274,-34,-2,40492,"132,605.55",85938
,20170719,3242,3274,3242,3328,3240,3325,3292,51,18,35606,"117,236.57",87088
,20170720,3325,3292,3325,3325,3196,3200,3252,-92,-40,46232,"150,364.78",89340
,20170721,3200,3252,3202,3227,3173,3205,3201,-47,-51,34916,"111,785.63",88324
,20170724,3205,3201,3210,3236,3166,3201,3196,0,-5,33068,"105,703.11",90488
,20170725,3201,3196,3200,3273,3182,3254,3233,58,37,42012,"135,849.06",90256
,20170726,3254,3233,3265,3342,3260,3298,3301,65,68,64986,"214,531.14",100738
,20170727,3298,3301,3298,3320,3270,3313,3293,12,-8,57082,"188,001.59",105728
,20170728,3313,3293,3313,3358,3300,3317,3327,24,34,62126,"206,730.12",108894
,20170731,3317,3327,3325,3472,3318,3464,3405,137,78,74376,"253,257.64",108782
,20170801,3464,3405,3446,3471,3420,3437,3447,32,42,51400,"177,183.22",106178
,20170802,3437,3447,3437,3522,3403,3510,3488,63,41,81022,"282,671.19",113800
,20170803,3510,3488,3519,3594,3507,3588,3557,100,69,140832,"500,982.77",126050
,20170804,3588,3557,3594,3673,3591,3655,3641,98,84,128708,"468,665.32",128560
,20170807,3655,3641,3660,3895,3630,3772,3778,131,137,200900,"759,061.86",146352
,20170808,3772,3778,3772,3815,3671,3722,3759,-56,-19,155846,"585,946.21",158432
,20170809,3722,3759,3723,4022,3707,3837,3766,78,7,146034,"550,018.85",174000
,20170810,3837,3766,3831,3848,3760,3804,3808,38,42,140084,"533,455.63",175654
,20170811,3804,3808,3783,3841,3666,3702,3747,-106,-61,166826,"625,123.74",172618
,20170814,3702,3747,3703,3726,3623,3648,3675,-99,-72,149386,"549,016.65",171934
,20170815,3648,3675,3648,3652,3540,3585,3585,-90,-90,223192,"800,309.36",187174
,20170816,3585,3585,3585,3603,3546,3561,3575,-24,-10,247432,"884,753.60",202810
,20170817,3561,3575,3572,3724,3571,3681,3661,106,86,444440,"1,627,435.37",204178
,20170818,3681,3661,3662,3755,3652,3745,3692,84,31,326894,"1,206,938.79",220928
,20170821,3745,3692,3725,3843,3665,3814,3777,122,85,462156,"1,745,934.12",238684
,20170822,3814,3777,3817,3848,3769,3803,3804,26,27,381486,"1,451,344.17",235706
,20170823,3803,3804,3791,3793,3598,3648,3670,-156,-134,567512,"2,082,986.90",252140
,20170824,3648,3670,3642,3732,3620,3707,3684,37,14,523306,"1,928,350.85",249710
,20170825,3707,3684,3712,3837,3696,3801,3786,117,102,594604,"2,251,370.22",254294
,20170828,3801,3786,3795,3842,3693,3801,3771,15,-15,693926,"2,616,845.98",280650
,20170829,3801,3771,3801,3829,3733,3764,3784,-7,13,723906,"2,739,355.15",290352
,20170830,3764,3784,3771,3787,3701,3754,3744,-30,-40,602828,"2,257,266.50",294400
,20170831,3754,3744,3745,3803,3684,3801,3739,57,-5,694802,"2,597,885.67",304658
,20170901,3801,3739,3797,3965,3781,3916,3863,177,124,857726,"3,313,666.61",311034
,20170904,3916,3863,3916,4042,3909,3935,3958,72,95,745754,"2,951,893.11",311712
,20170905,3935,3958,3934,3979,3911,3951,3947,-7,-11,632426,"2,496,567.66",313950
,20170906,3951,3947,3949,4019,3856,3862,3925,-85,-22,686978,"2,696,473.87",308400
,20170907,3862,3925,3872,3897,3823,3846,3862,-79,-63,734088,"2,835,184.42",305770
,20170908,3846,3862,3842,3902,3775,3805,3843,-57,-19,788018,"3,028,623.81",298008
,20170911,3805,3843,3799,3819,3722,3793,3779,-50,-64,700284,"2,646,925.47",319200
,20170912,3793,3779,3795,3833,3762,3827,3800,48,21,754100,"2,866,163.81",324694
,20170913,3827,3800,3820,3857,3763,3779,3815,-21,15,679762,"2,593,555.15",340706
,20170914,3779,3815,3772,3806,3698,3709,3754,-106,-61,883932,"3,318,477.54",354628
,20170915,3709,3754,3703,3734,3658,3675,3697,-79,-57,694120,"2,566,189.58",340146
,20170918,3675,3697,3675,3696,3623,3681,3665,-16,-32,678770,"2,488,153.82",352078
,20170919,3681,3665,3678,3708,3616,3620,3669,-45,4,620844,"2,278,269.25",386120
,20170920,3620,3669,3618,3650,3586,3628,3619,-41,-50,643002,"2,327,335.87",390278
,20170921,3628,3619,3633,3659,3528,3530,3597,-89,-22,854910,"3,075,591.51",449046
,20170922,3530,3597,3528,3534,3406,3428,3473,-169,-124,731168,"2,539,434.75",462024
,20170925,3428,3473,3438,3491,3406,3458,3446,-15,-27,674362,"2,324,099.33",469664
,20170926,3458,3446,3460,3502,3449,3469,3474,23,28,621550,"2,159,541.45",474386
,20170927,3469,3474,3465,3524,3464,3520,3491,46,17,645130,"2,252,711.22",484664
,20170928,3520,3491,3526,3573,3440,3470,3498,-21,7,937258,"3,279,430.23",503824
,20170929,3470,3498,3475,3540,3393,3538,3459,40,-39,730722,"2,527,785.73",487692
,20171009,3538,3459,3560,3630,3509,3539,3561,80,102,545044,"1,941,035.00",488632
,20171010,3539,3561,3540,3543,3408,3411,3453,-150,-108,919970,"3,177,443.31",567012
,20171011,3411,3453,3400,3455,3373,3376,3415,-77,-38,883256,"3,016,444.21",604512
,20171012,3376,3415,3374,3518,3358,3498,3417,83,2,1354108,"4,628,033.64",616008
,20171013,3498,3417,3500,3629,3472,3625,3538,208,121,1228744,"4,347,483.89",606332
,20171016,3625,3538,3625,3700,3602,3661,3637,123,99,1287762,"4,683,840.24",600870
,20171017,3661,3637,3660,3695,3616,3639,3654,2,17,1626240,"5,943,363.37",686998
,20171018,3639,3654,3639,3682,3609,3611,3646,-43,-8,1259888,"4,594,182.75",724588
,20171019,3611,3646,3607,3609,3509,3537,3552,-109,-94,1457114,"5,176,877.38",758232
,20171020,3537,3552,3535,3709,3532,3700,3625,148,73,1718776,"6,231,256.89",870704
,20171023,3700,3625,3696,3703,3564,3677,3661,52,36,2395574,"8,770,829.29",921148
,20171024,3677,3661,3677,3757,3651,3730,3717,69,56,2024412,"7,525,709.51",1031016
,20171025,3730,3717,3735,3793,3672,3702,3727,-15,10,2360048,"8,797,552.86",1095370
,20171026,3702,3727,3673,3720,3645,3677,3678,-50,-49,2432504,"8,948,106.79",1164444
,20171027,3677,3678,3671,3695,3603,3609,3648,-69,-30,2772720,"10,116,715.26",1249516
,20171030,3609,3648,3600,3637,3584,3589,3611,-59,-37,1899190,"6,858,676.95",1332168
,20171031,3589,3611,3581,3684,3573,3652,3624,41,13,2318804,"8,404,546.55",1402514
,20171101,3652,3624,3656,3690,3580,3582,3649,-42,25,2353544,"8,590,426.00",1438966
,20171102,3582,3649,3594,3724,3572,3692,3658,43,9,3449374,"12,620,713.62",1651092
,20171103,3692,3658,3687,3729,3635,3656,3679,-2,21,2898544,"10,664,193.32",1707178
,20171106,3656,3679,3657,3780,3652,3769,3725,90,46,3271024,"12,184,579.23",1856436
,20171107,3769,3725,3766,3794,3730,3753,3757,28,32,2406142,"9,041,114.04",1894938
,20171108,3753,3757,3748,3767,3703,3744,3735,-13,-22,3103482,"11,592,526.83",1959504
,20171109,3744,3735,3746,3846,3733,3760,3786,25,51,4970730,"18,823,092.03",2091288
,20171110,3760,3786,3760,3806,3727,3796,3770,10,-16,3690886,"13,917,357.61",2188334
,20171113,3796,3770,3810,3845,3740,3803,3781,33,11,4635840,"17,528,354.50",2194094
,20171114,3803,3781,3799,3830,3769,3804,3801,23,20,3540442,"13,458,974.40",2152082
,20171115,3804,3801,3805,3828,3676,3705,3739,-96,-62,4239284,"15,850,812.36",2059768
,20171116,3705,3739,3718,3728,3656,3680,3695,-59,-44,3629530,"13,411,294.86",2096952
,20171117,3680,3695,3681,3703,3621,3632,3657,-63,-38,3698712,"13,527,909.50",2195094
,20171120,3632,3657,3627,3707,3627,3696,3665,39,8,3677614,"13,481,142.14",2158640
,20171121,3696,3665,3698,3778,3676,3763,3732,98,67,3923448,"14,643,719.99",2190902
,20171122,3763,3732,3769,3828,3761,3817,3794,85,62,3833336,"14,544,286.84",2312996
,20171123,3817,3794,3817,3858,3808,3826,3829,32,35,4006456,"15,340,967.50",2394930
,20171124,3826,3829,3830,3833,3724,3814,3796,-15,-33,3491612,"13,255,122.01",2362552
,20171127,3814,3796,3815,3888,3792,3833,3845,37,49,4268610,"16,414,783.92",2441546
,20171128,3833,3845,3845,3882,3832,3872,3858,27,13,3196028,"12,333,183.92",2579070
,20171129,3872,3858,3885,3966,3840,3957,3899,99,41,4711928,"18,372,479.68",2895656
,20171130,3957,3899,3960,4043,3948,3990,3997,91,98,5024632,"20,086,437.52",2924900
,20171201,3990,3997,3993,4018,3928,3977,3977,-20,-20,4326984,"17,208,646.48",2893706
,20171204,3977,3977,3972,4104,3952,4056,4039,79,62,4711716,"19,032,238.35",3005296
,20171205,4056,4039,4057,4085,4004,4025,4051,-14,12,3812332,"15,445,667.20",2978208
,20171206,4025,4051,4025,4032,3905,3916,3956,-135,-95,4813668,"19,043,498.96",2955474
,20171207,3916,3956,3926,3942,3759,3828,3877,-128,-79,5701228,"22,106,679.20",2780650
,20171208,3828,3877,3830,3912,3806,3895,3851,18,-26,4421804,"17,028,746.54",2670450
,20171211,3895,3851,3893,3967,3872,3912,3917,61,66,5323908,"20,854,225.65",2676260
,20171212,3912,3917,3923,3988,3862,3884,3925,-33,8,5101036,"20,022,821.76",2714088
,20171213,3884,3925,3884,3892,3816,3831,3848,-94,-77,5618008,"21,618,469.48",2781522
,20171214,3831,3848,3832,3860,3773,3786,3819,-62,-29,4839396,"18,481,991.97",2756276
,20171215,3786,3819,3782,3839,3770,3824,3806,5,-13,3715426,"14,141,780.15",2652164
,20171218,3824,3806,3839,3918,3810,3874,3856,68,50,5875636,"22,660,651.81",2580740
,20171219,3874,3856,3876,3878,3778,3791,3823,-65,-33,4955962,"18,947,312.83",2679418
,20171220,3791,3823,3789,3835,3761,3804,3801,-19,-22,4264388,"16,211,143.89",2648114
,20171221,3804,3801,3811,3884,3795,3853,3843,52,42,5351426,"20,566,640.73",2445204
,20171222,3853,3843,3853,3954,3850,3942,3908,99,65,4986930,"19,492,831.14",2658714
,20171225,3942,3908,3944,3948,3784,3787,3860,-121,-48,5165730,"19,940,207.88",2490232
,20171226,3787,3860,3780,3836,3774,3822,3807,-38,-53,4103050,"15,620,476.11",2541856
,20171227,3822,3807,3820,3829,3784,3792,3809,-15,2,4050510,"15,428,698.77",2599962
,20171228,3792,3809,3780,3800,3740,3758,3765,-51,-44,4411490,"16,612,234.94",2776556
,20171229,3758,3765,3753,3824,3748,3794,3794,29,29,4377144,"16,608,550.91",2524270
rb1806,20170616,2799,2799,2774,2844,2774,2825,2827,26,28,90,254.49,52
,20170619,2825,2827,2832,2873,2821,2861,2856,34,29,134,382.72,126
,20170620,2861,2856,2861,2863,2819,2835,2849,-21,-7,246,701.02,312
,20170621,2835,2849,2819,2823,2790,2818,2803,-31,-46,172,482.25,414
,20170622,2818,2803,2830,2858,2814,2815,2836,12,33,334,947.35,534
,20170623,2815,2836,2820,2847,2809,2844,2826,8,-10,284,802.73,618
,20170626,2844,2826,2840,2869,2836,2869,2850,43,24,996,"2,839.52",802
,20170627,2869,2850,2864,2917,2860,2917,2887,67,37,420,"1,212.82",820
,20170628,2917,2887,2930,2988,2925,2973,2951,86,64,258,761.48,796
,20170629,2973,2951,2980,3024,2980,2992,2992,41,41,242,724.27,812
,20170630,2992,2992,2974,3007,2965,2992,2989,0,-3,286,855.10,800
,20170703,2992,2989,3003,3056,3003,3056,3031,67,42,118,357.76,804
,20170704,3056,3031,3054,3077,2998,3001,3029,-30,-2,176,533.24,826
,20170705,3001,3029,3011,3099,3011,3053,3049,24,20,240,731.96,860
,20170706,3053,3049,3024,3031,2991,3030,3007,-19,-42,298,896.26,880
,20170707,3030,3007,3019,3062,2996,3052,3021,45,14,278,840.03,876
,20170710,3052,3021,3061,3131,3061,3102,3095,81,74,352,"1,089.54",912
,20170711,3102,3095,3104,3196,3100,3180,3154,85,59,546,"1,722.10",972
,20170712,3180,3154,3195,3244,3161,3172,3195,18,41,312,997.07,1020
,20170713,3172,3195,3176,3275,3169,3260,3215,65,20,212,681.63,1008
,20170714,3260,3215,3265,3265,3180,3199,3219,-16,4,300,965.70,1018
,20170717,3199,3219,3199,3268,3199,3252,3241,33,22,198,641.81,982
,20170718,3252,3241,3256,3267,3204,3210,3234,-31,-7,136,439.92,1034
,20170719,3210,3234,3219,3287,3214,3285,3254,51,20,196,637.92,1008
,20170720,3285,3254,3249,3254,3158,3158,3204,-96,-50,258,826.72,1076
,20170721,3158,3204,3180,3188,3142,3165,3170,-39,-34,204,646.77,1160
,20170724,3165,3170,3179,3190,3132,3178,3160,8,-10,228,720.66,1238
,20170725,3178,3160,3170,3232,3155,3215,3195,55,35,230,734.94,1146
,20170726,3215,3195,3231,3301,3230,3255,3271,60,76,386,"1,262.62",1152
,20170727,3255,3271,3248,3288,3222,3280,3265,9,-6,298,972.98,1094
,20170728,3280,3265,3283,3312,3270,3275,3288,10,23,318,"1,045.64",1096
,20170731,3275,3288,3300,3426,3300,3418,3361,130,73,498,"1,673.99",878
,20170801,3418,3361,3419,3428,3392,3399,3407,38,46,122,415.77,924
,20170802,3399,3407,3393,3477,3393,3477,3455,70,48,290,"1,001.97",936
,20170803,3477,3455,3483,3564,3483,3556,3527,101,72,166,585.63,920
,20170804,3556,3527,3572,3653,3560,3631,3607,104,80,178,642.05,986
,20170807,3631,3607,3609,3849,3598,3765,3681,158,74,768,"2,827.74",1146
,20170808,3765,3681,3746,3783,3635,3680,3712,-1,31,534,"1,982.32",1024
,20170809,3680,3712,3710,3792,3678,3787,3738,75,26,172,642.94,984
,20170810,3787,3738,3787,3812,3721,3776,3765,38,27,276,"1,039.40",952
,20170811,3776,3765,3741,3777,3636,3658,3713,-107,-52,262,973.02,922
,20170814,3658,3713,3657,3671,3591,3595,3635,-118,-78,380,"1,381.43",876
,20170815,3595,3635,3608,3640,3498,3551,3572,-84,-63,992,"3,544.19",1202
,20170816,3551,3572,3541,3568,3515,3524,3556,-48,-16,560,"1,991.82",1428
,20170817,3524,3556,3540,3693,3540,3658,3632,102,76,486,"1,765.54",1472
,20170818,3658,3632,3629,3711,3628,3706,3661,74,29,194,710.26,1502
,20170821,3706,3661,3694,3806,3648,3778,3748,117,87,572,"2,144.16",1252
,20170822,3778,3748,3787,3807,3736,3778,3762,30,14,468,"1,760.77",1130
,20170823,3778,3762,3703,3703,3564,3629,3640,-133,-122,412,"1,499.76",1188
,20170824,3629,3640,3629,3690,3597,3661,3644,21,4,302,"1,100.64",1268
,20170825,3661,3644,3675,3779,3675,3766,3748,122,104,108,404.86,1226
,20170828,3766,3748,3774,3781,3680,3755,3734,7,-14,196,731.90,1184
,20170829,3755,3734,3776,3798,3700,3708,3742,-26,8,206,770.88,1128
,20170830,3708,3742,3725,3746,3680,3737,3717,-5,-25,82,304.85,1128
,20170831,3737,3717,3699,3759,3661,3759,3708,42,-9,128,474.74,1094
,20170901,3759,3708,3760,3919,3751,3894,3818,186,110,234,893.46,1076
,20170904,3894,3818,3895,3990,3886,3899,3926,81,108,144,565.35,1078
,20170905,3899,3926,3904,3935,3851,3909,3911,-17,-15,206,805.80,1082
,20170906,3909,3911,3955,3955,3827,3827,3877,-84,-34,288,"1,116.79",1108
,20170907,3827,3877,3844,3846,3788,3795,3826,-82,-51,82,313.80,1116
,20170908,3795,3826,3800,3860,3755,3763,3824,-63,-2,194,742.03,1102
,20170911,3763,3824,3734,3783,3700,3772,3743,-52,-81,120,449.22,1092
,20170912,3772,3743,3763,3799,3736,3784,3766,41,23,260,979.19,1244
,20170913,3784,3766,3790,3813,3732,3732,3780,-34,14,88,332.67,1246
,20170914,3732,3780,3744,3773,3669,3677,3744,-103,-36,286,"1,070.81",1368
,20170915,3677,3744,3647,3677,3622,3648,3653,-96,-91,190,694.08,1422
,20170918,3648,3653,3643,3653,3598,3644,3636,-9,-17,336,"1,222.01",1578
,20170919,3644,3636,3647,3666,3598,3598,3632,-38,-4,102,370.52,1582
,20170920,3598,3632,3577,3620,3556,3593,3579,-39,-53,198,708.73,1608
,20170921,3593,3579,3622,3622,3500,3502,3551,-77,-28,236,838.20,1650
,20170922,3502,3551,3502,3502,3357,3363,3444,-188,-107,562,"1,935.57",1452
,20170925,3363,3444,3367,3457,3367,3411,3421,-33,-23,208,711.64,1480
,20170926,3411,3421,3431,3460,3427,3428,3441,7,20,118,406.11,1536
,20170927,3428,3441,3448,3469,3435,3469,3450,28,9,76,262.21,1536
,20170928,3469,3450,3469,3537,3411,3421,3484,-29,34,76,264.80,1510
,20170929,3421,3484,3399,3490,3381,3490,3426,6,-58,50,171.31,1508
,20171009,3490,3426,3536,3576,3504,3512,3530,86,104,88,310.65,1478
,20171010,3512,3530,3490,3492,3371,3382,3417,-148,-113,114,389.61,1510
,20171011,3382,3417,3360,3415,3341,3341,3373,-76,-44,54,182.17,1524
,20171012,3341,3373,3333,3463,3321,3463,3375,90,2,162,546.83,1522
,20171013,3463,3375,3445,3580,3429,3580,3487,205,112,164,571.93,1470
,20171016,3580,3487,3571,3630,3571,3630,3597,143,110,110,395.71,1402
,20171017,3630,3597,3610,3645,3584,3627,3614,30,17,160,578.27,1370
,20171018,3627,3614,3596,3638,3522,3592,3601,-22,-13,64,230.51,1370
,20171019,3592,3601,3566,3566,3487,3492,3514,-109,-87,110,386.57,1356
,20171020,3492,3514,3524,3662,3524,3661,3627,147,113,94,341.00,1296
,20171023,3661,3627,3636,3654,3534,3643,3616,16,-11,96,347.20,1280
,20171024,3643,3616,3675,3709,3668,3694,3688,78,72,30,110.65,1284
,20171025,3694,3688,3672,3740,3630,3655,3680,-33,-8,154,566.82,1266
,20171026,3655,3680,3624,3662,3597,3630,3631,-50,-49,100,363.15,1236
,20171027,3630,3631,3604,3636,3575,3576,3605,-55,-26,156,562.48,1262
,20171030,3576,3605,3578,3588,3555,3555,3576,-50,-29,34,121.59,1270
,20171031,3555,3576,3547,3637,3525,3609,3588,33,12,324,"1,162.70",1236
,20171101,3609,3588,3585,3633,3549,3559,3615,-29,27,454,"1,641.42",1238
,20171102,3559,3615,3555,3660,3532,3630,3603,15,-12,88,317.14,1228
,20171103,3630,3603,3652,3657,3586,3595,3626,-8,23,22,79.77,1236
,20171106,3595,3626,3630,3730,3626,3725,3698,99,72,46,170.13,1244
,20171107,3725,3698,3710,3738,3688,3711,3714,13,16,82,304.62,1244
,20171108,3711,3714,3695,3715,3659,3712,3689,-2,-25,48,177.11,1240
,20171109,3712,3689,3709,3780,3692,3699,3727,10,38,92,342.90,1234
,20171110,3699,3727,3688,3754,3686,3743,3732,16,5,192,716.69,1174
,20171113,3743,3732,3720,3733,3704,3733,3719,1,-13,78,290.12,1160
,20171114,3733,3719,3745,3766,3735,3753,3740,34,21,334,"1,249.38",1128
,20171115,3753,3740,3753,3765,3622,3655,3693,-85,-47,306,"1,130.31",1020
,20171116,3655,3693,3647,3647,3595,3640,3619,-53,-74,72,260.60,1032
,20171117,3640,3619,3628,3637,3577,3594,3615,-25,-4,86,310.90,1026
,20171120,3594,3615,3586,3649,3579,3633,3613,18,-2,216,780.58,1082
,20171121,3633,3613,3640,3714,3635,3687,3672,74,59,180,661.00,1100
,20171122,3687,3672,3718,3750,3691,3750,3721,78,49,142,528.45,1132
,20171123,3750,3721,3766,3777,3739,3751,3759,30,38,92,345.85,1112
,20171124,3751,3759,3679,3753,3679,3753,3737,-6,-22,86,321.40,1110
,20171127,3753,3737,3743,3807,3731,3760,3777,23,40,124,468.43,1094
,20171128,3760,3777,3777,3810,3770,3807,3787,30,10,158,598.48,1090
,20171129,3807,3787,3813,3898,3781,3885,3847,98,60,512,"1,969.95",1136
,20171130,3885,3847,3882,3950,3875,3889,3914,42,67,520,"2,035.40",1106
,20171201,3889,3914,3917,3917,3839,3901,3902,-13,-12,112,437.08,1080
,20171204,3901,3902,3902,4011,3865,3976,3967,74,65,102,404.70,1074
,20171205,3976,3967,3981,4002,3932,3937,3972,-30,5,178,707.08,1082
,20171206,3937,3972,3941,3941,3831,3833,3880,-139,-92,70,271.66,1078
,20171207,3833,3880,3848,3848,3738,3738,3807,-142,-73,170,647.34,1028
,20171208,3738,3807,3743,3825,3736,3825,3778,18,-29,112,423.22,1032
,20171211,3825,3778,3827,3888,3811,3829,3854,51,76,110,423.96,966
,20171212,3829,3854,3841,3896,3800,3800,3878,-54,24,246,954.10,956
,20171213,3800,3878,3802,3802,3740,3758,3768,-120,-110,202,761.15,1016
,20171214,3758,3768,3810,3810,3725,3741,3758,-27,-10,940,"3,532.91",1306
,20171215,3741,3758,3733,3791,3719,3781,3755,23,-3,232,871.24,1302
,20171218,3781,3755,3785,3855,3764,3819,3822,64,67,4794,"18,324.54",1452
,20171219,3819,3822,3790,3809,3735,3744,3785,-78,-37,1868,"7,070.80",2724
,20171220,3744,3785,3750,3784,3729,3761,3752,-24,-33,548,"2,056.41",2896
,20171221,3761,3752,3782,3816,3750,3802,3793,50,41,172,652.46,2860
,20171222,3802,3793,3831,3893,3817,3890,3870,97,77,246,952.11,2830
,20171225,3890,3870,3878,3883,3741,3743,3811,-127,-59,276,"1,052.03",2844
,20171226,3743,3811,3736,3782,3729,3775,3751,-36,-60,244,915.31,2914
,20171227,3775,3751,3770,3779,3750,3755,3764,4,13,320,"1,204.64",2740
,20171228,3755,3764,3731,3757,3697,3725,3719,-39,-45,326,"1,212.61",2800
,20171229,3725,3719,3718,3777,3708,3747,3738,28,19,282,"1,054.31",2782
rb1807,20170718,3241,3241,3259,3259,3200,3215,3221,-26,-20,20,64.43,20
,20170719,3215,3221,3239,3317,3239,3275,3265,54,44,54,176.36,34
,20170720,3275,3265,3304,3304,3169,3169,3220,-96,-45,78,251.23,82
,20170721,3169,3220,3176,3181,3146,3177,3163,-43,-57,56,177.17,106
,20170724,3177,3163,3175,3175,3143,3143,3160,-20,-3,10,31.60,116
,20170725,3143,3160,3184,3231,3184,3219,3206,59,46,28,89.79,114
,20170726,3219,3206,3271,3303,3239,3250,3272,44,66,168,549.78,174
,20170727,3250,3272,3254,3285,3248,3263,3262,-9,-10,126,411.08,90
,20170728,3263,3262,3286,3307,3273,3307,3288,45,26,40,131.52,70
,20170731,3307,3288,3321,3438,3309,3432,3343,144,55,88,294.22,104
,20170801,3432,3343,3415,3425,3393,3412,3416,69,73,40,136.67,130
,20170802,3412,3416,3397,3485,3385,3473,3414,57,-2,116,396.10,102
,20170803,3473,3414,3481,3555,3481,3550,3523,136,109,128,450.96,100
,20170804,3550,3523,3583,3649,3563,3626,3602,103,79,74,266.56,88
,20170807,3626,3602,3600,3854,3596,3759,3741,157,139,182,680.87,140
,20170808,3759,3741,3768,3776,3655,3691,3702,-50,-39,190,703.47,206
,20170809,3691,3702,3706,3790,3659,3790,3735,88,33,134,500.60,210
,20170810,3790,3735,3761,3810,3725,3770,3776,35,41,144,543.80,204
,20170811,3770,3776,3750,3784,3602,3661,3701,-115,-75,244,903.13,192
,20170814,3661,3701,3660,3691,3580,3610,3640,-91,-61,80,291.24,216
,20170815,3610,3640,3607,3611,3521,3546,3557,-94,-83,200,711.44,158
,20170816,3546,3557,3539,3564,3517,3525,3542,-32,-15,252,892.82,254
,20170817,3525,3542,3555,3681,3555,3648,3640,106,98,204,742.62,236
,20170818,3648,3640,3637,3699,3622,3699,3651,59,11,70,255.62,252
,20170821,3699,3651,3699,3786,3654,3765,3744,114,93,80,299.53,252
,20170822,3765,3744,3779,3808,3726,3759,3754,15,10,216,810.90,252
,20170823,3759,3754,3723,3723,3560,3618,3633,-136,-121,144,523.19,264
,20170824,3618,3633,3601,3674,3579,3668,3639,35,6,104,378.52,298
,20170825,3668,3639,3688,3787,3688,3753,3744,114,105,142,531.68,264
,20170828,3753,3744,3756,3788,3664,3756,3712,12,-32,132,490.02,286
,20170829,3756,3712,3764,3769,3660,3713,3716,1,4,174,646.73,304
,20170830,3713,3716,3726,3726,3667,3713,3700,-3,-16,130,481.07,314
,20170831,3713,3700,3693,3744,3646,3744,3708,44,8,254,942.04,298
,20170901,3744,3708,3749,3892,3739,3872,3805,164,97,202,768.72,322
,20170904,3872,3805,3878,3946,3854,3863,3902,58,97,144,561.95,314
,20170905,3863,3902,3889,3912,3877,3883,3895,-19,-7,40,155.80,312
,20170906,3883,3895,3916,3926,3819,3821,3861,-74,-34,48,185.35,316
,20170907,3821,3861,3822,3839,3777,3792,3807,-69,-54,68,258.89,332
,20170908,3792,3807,3807,3839,3737,3762,3799,-45,-8,56,212.78,340
,20170911,3762,3799,3749,3771,3716,3763,3744,-36,-55,48,179.74,344
,20170912,3763,3744,3763,3792,3737,3774,3767,30,23,40,150.71,344
,20170913,3774,3767,3788,3806,3741,3741,3784,-26,17,38,143.79,332
,20170914,3741,3784,3697,3814,3665,3666,3715,-118,-69,82,304.67,354
,20170915,3666,3715,3667,3677,3630,3642,3655,-73,-60,92,336.28,388
,20170918,3642,3655,3638,3659,3590,3659,3629,4,-26,82,297.59,388
,20170919,3659,3629,3628,3660,3595,3603,3645,-26,16,72,262.46,362
,20170920,3603,3645,3568,3607,3564,3607,3577,-38,-68,70,250.40,368
,20170921,3607,3577,3635,3635,3502,3502,3557,-75,-20,74,263.26,368
,20170922,3502,3557,3502,3502,3418,3418,3458,-139,-99,20,69.17,372
,20170925,3418,3458,3419,3434,3381,3389,3411,-69,-47,102,347.96,368
,20170926,3389,3411,3434,3454,3434,3454,3443,43,32,10,34.43,368
,20170927,3454,3443,3436,3496,3436,3482,3466,39,23,106,367.46,408
,20170928,3482,3466,3495,3530,3404,3413,3460,-53,-6,110,380.70,354
,20170929,3413,3460,3388,3485,3384,3485,3430,25,-30,32,109.76,346
,20171009,3485,3430,3524,3583,3485,3485,3513,55,83,46,161.60,328
,20171010,3485,3513,3458,3458,3380,3390,3436,-123,-77,40,137.48,338
,20171011,3390,3436,3365,3414,3344,3344,3378,-92,-58,42,141.89,350
,20171012,3344,3378,3370,3418,3356,3418,3378,40,0,26,87.84,346
,20171013,3418,3378,3459,3582,3439,3582,3487,204,109,70,244.12,318
,20171016,3582,3487,3595,3641,3576,3583,3601,96,114,48,172.88,304
,20171017,3583,3601,3595,3639,3574,3600,3594,-1,-7,126,452.88,284
,20171018,3600,3594,3631,3631,3576,3576,3601,-18,7,18,64.83,280
,20171019,3576,3601,3540,3542,3488,3496,3521,-105,-80,42,147.90,276
,20171020,3496,3521,3516,3659,3516,3658,3588,137,67,42,150.73,256
,20171023,3658,3588,3580,3647,3556,3647,3600,59,12,90,324.09,252
,20171024,3647,3600,3657,3686,3618,3686,3664,86,64,38,139.24,248
,20171025,3686,3664,3662,3732,3619,3651,3690,-13,26,110,406.01,318
,20171026,3651,3690,3635,3656,3601,3639,3624,-51,-66,136,492.90,272
,20171027,3639,3624,3599,3623,3569,3623,3594,-1,-30,40,143.77,276
,20171030,3623,3594,3577,3582,3560,3560,3571,-34,-23,14,50.00,278
,20171031,3560,3571,3557,3628,3539,3628,3576,57,5,18,64.37,274
,20171101,3628,3576,3628,3647,3599,3641,3622,65,46,10,36.23,276
,20171102,3641,3622,3588,3665,3553,3665,3598,43,-24,36,129.53,278
,20171103,3665,3598,3658,3658,3596,3596,3613,-2,15,22,79.51,292
,20171106,3596,3613,3681,3700,3681,3700,3688,87,75,20,73.77,290
,20171107,3700,3688,3722,3722,3709,3712,3717,24,29,22,81.79,282
,20171108,3712,3717,3682,3697,3651,3690,3679,-27,-38,48,176.59,300
,20171109,3690,3679,3737,3770,3690,3694,3728,15,49,26,96.94,300
,20171110,3694,3728,3706,3716,3706,3716,3709,-12,-19,16,59.35,298
,20171113,3716,3709,3753,3759,3691,3739,3737,30,28,170,635.35,418
,20171114,3739,3737,3727,3743,3707,3716,3733,-21,-4,160,597.36,298
,20171115,3716,3733,3660,3660,3610,3628,3639,-105,-94,24,87.36,298
,20171116,3628,3639,3633,3633,3590,3617,3617,-22,-22,14,50.65,302
,20171117,3617,3617,3605,3617,3544,3560,3596,-57,-21,72,258.94,294
,20171120,3560,3596,3574,3624,3574,3624,3584,28,-12,32,114.70,288
,20171121,3624,3584,3663,3669,3660,3669,3664,85,80,6,21.98,288
,20171122,3669,3664,3705,3735,3691,3735,3715,71,51,30,111.46,272
,20171123,3735,3715,3738,3746,3736,3742,3741,27,26,14,52.38,260
,20171124,3742,3741,3756,3756,3718,3718,3734,-23,-7,8,29.87,258
,20171127,3718,3734,3722,3761,3722,3742,3741,8,7,34,127.22,270
,20171128,3742,3741,3753,3756,3753,3756,3755,15,14,8,30.04,270
,20171129,3756,3755,3798,3853,3798,3853,3831,98,76,22,84.30,280
,20171130,3853,3831,3890,3893,3887,3887,3889,56,58,22,85.57,292
,20171201,3887,3889,3887,3889,3822,3843,3869,-46,-20,38,147.06,302
,20171204,3843,3869,3919,3961,3860,3930,3927,61,58,74,290.64,320
,20171205,3930,3927,3929,3939,3875,3875,3899,-52,-28,22,85.80,318
,20171206,3875,3899,3836,3836,3764,3791,3795,-108,-104,40,151.80,312
,20171207,3791,3795,3791,3791,3684,3692,3755,-103,-40,84,315.48,306
,20171208,3692,3755,3695,3766,3678,3759,3710,4,-45,142,526.95,338
,20171211,3759,3710,3767,3798,3765,3777,3789,67,79,50,189.48,326
,20171212,3777,3789,3765,3835,3750,3758,3810,-31,21,958,"3,650.43",746
,20171213,3758,3810,3735,3781,3712,3746,3746,-64,-64,138,516.95,762
,20171214,3746,3746,3739,3752,3695,3698,3728,-48,-18,72,268.45,752
,20171215,3698,3728,3699,3748,3681,3734,3707,6,-21,98,363.30,698
,20171218,3734,3707,3750,3770,3687,3762,3751,55,44,584,"2,190.63",410
,20171219,3762,3751,3755,3755,3685,3689,3721,-62,-30,188,699.61,450
,20171220,3689,3721,3704,3725,3699,3709,3715,-12,-6,70,260.08,444
,20171221,3709,3715,3726,3781,3712,3761,3758,46,43,118,443.56,386
,20171222,3761,3758,3777,3832,3754,3819,3779,61,21,154,582.04,342
,20171225,3819,3779,3844,3844,3701,3702,3755,-77,-24,128,480.66,328
,20171226,3702,3755,3692,3749,3692,3749,3715,-6,-40,12,44.58,338
,20171227,3749,3715,3737,3745,3709,3745,3729,30,14,30,111.89,344
,20171228,3745,3729,3705,3705,3664,3688,3682,-41,-47,120,441.86,368
,20171229,3688,3682,3688,3750,3688,3709,3722,27,40,54,200.99,380
rb1808,20170816,3557,3557,,,,3557,3557,0,0,0,0.00,0
,20170817,3557,3557,3650,3661,3650,3654,3655,97,98,6,21.93,6
,20170818,3654,3655,3645,3734,3626,3724,3698,69,43,24,88.77,18
,20170821,3724,3698,3700,3837,3655,3760,3763,62,65,64,240.83,28
,20170822,3760,3763,3781,3790,3701,3739,3743,-24,-20,34,127.29,26
,20170823,3739,3743,3655,3676,3559,3632,3626,-111,-117,22,79.78,34
,20170824,3632,3626,3660,3660,3618,3618,3639,-8,13,4,14.56,36
,20170825,3618,3639,3685,3766,3657,3764,3753,125,114,80,300.28,88
,20170828,3764,3753,3774,3774,3670,3754,3733,1,-20,74,276.27,38
,20170829,3754,3733,3757,3778,3694,3708,3724,-25,-9,16,59.60,38
,20170830,3708,3724,3728,3728,3656,3714,3699,-10,-25,68,251.58,72
,20170831,3714,3699,3679,3737,3647,3737,3693,38,-6,36,132.96,72
,20170901,3737,3693,3784,3906,3721,3885,3801,192,108,210,798.21,174
,20170904,3885,3801,3882,3941,3882,3900,3911,99,110,26,101.71,172
,20170905,3900,3911,3893,3921,3876,3899,3902,-12,-9,130,507.33,138
,20170906,3899,3902,3905,3921,3820,3820,3876,-82,-26,46,178.31,136
,20170907,3820,3876,3819,3835,3775,3775,3811,-101,-65,62,236.31,146
,20170908,3775,3811,3784,3845,3737,3751,3784,-60,-27,60,227.07,160
,20170911,3751,3784,3735,3766,3696,3755,3725,-29,-59,34,126.67,158
,20170912,3755,3725,3766,3786,3742,3781,3763,56,38,56,210.76,162
,20170913,3781,3763,3778,3795,3730,3737,3768,-26,5,28,105.53,160
,20170914,3737,3768,3732,3752,3670,3670,3710,-98,-58,44,163.26,158
,20170915,3670,3710,3661,3673,3626,3637,3652,-73,-58,116,423.69,198
,20170918,3637,3652,3621,3652,3577,3651,3637,-1,-15,462,"1,680.69",552
,20170919,3651,3637,3647,3668,3593,3600,3637,-37,0,132,480.11,568
,20170920,3600,3637,3561,3628,3561,3601,3604,-36,-33,284,"1,023.70",592
,20170921,3601,3604,3611,3621,3505,3527,3556,-77,-48,132,469.40,630
,20170922,3527,3556,3480,3488,3404,3404,3410,-152,-146,438,"1,494.01",304
,20170925,3404,3410,3404,3448,3365,3426,3430,16,20,336,"1,152.68",302
,20170926,3426,3430,3431,3460,3426,3431,3443,1,13,120,413.21,302
,20170927,3431,3443,3460,3483,3455,3476,3466,33,23,56,194.15,312
,20170928,3476,3466,3489,3535,3387,3387,3454,-79,-12,38,131.27,308
,20170929,3387,3454,3411,3490,3411,3490,3460,36,6,26,89.98,314
,20171009,3490,3460,3520,3578,3478,3493,3538,33,78,476,"1,684.15",548
,20171010,3493,3538,3450,3490,3382,3387,3431,-151,-107,140,480.46,534
,20171011,3387,3431,3370,3397,3361,3361,3374,-70,-57,8,27.00,532
,20171012,3361,3374,3338,3466,3312,3439,3341,65,-33,318,"1,062.50",358
,20171013,3439,3341,3448,3574,3421,3574,3493,233,152,146,510.09,346
,20171016,3574,3493,3569,3616,3560,3605,3599,112,106,216,777.43,280
,20171017,3605,3599,3585,3607,3565,3565,3589,-34,-10,140,502.46,264
,20171018,3565,3589,3578,3608,3560,3560,3589,-29,0,52,186.65,242
,20171019,3560,3589,3533,3533,3472,3478,3498,-111,-91,96,335.90,220
,20171020,3478,3498,3497,3638,3497,3630,3594,132,96,60,215.65,220
,20171023,3630,3594,3628,3628,3566,3625,3593,31,-1,30,107.81,210
,20171024,3625,3593,3622,3669,3581,3669,3596,76,3,84,302.10,264
,20171025,3669,3596,3634,3685,3596,3596,3651,0,55,82,299.43,296
,20171026,3596,3651,3597,3649,3554,3612,3616,-39,-35,140,506.37,256
,20171027,3612,3616,3596,3613,3551,3551,3585,-65,-31,36,129.07,262
,20171030,3551,3585,3549,3579,3544,3545,3560,-40,-25,20,71.21,256
,20171031,3545,3560,3532,3610,3525,3607,3561,47,1,38,135.32,260
,20171101,3607,3561,3590,3620,3542,3542,3587,-19,26,16,57.40,258
,20171102,3542,3587,3533,3644,3531,3625,3604,38,17,40,144.20,252
,20171103,3625,3604,3636,3636,3590,3595,3606,-9,2,18,64.92,254
,20171106,3595,3606,3601,3717,3601,3692,3671,86,65,24,88.13,256
,20171107,3692,3671,,,,3671,3671,0,0,0,0.00,256
,20171108,3671,3671,3669,3697,3644,3697,3667,26,-4,36,132.02,250
,20171109,3697,3667,3719,3760,3681,3681,3708,14,41,42,155.77,260
,20171110,3681,3708,3701,3709,3689,3708,3703,0,-5,32,118.52,258
,20171113,3708,3703,3683,3720,3683,3720,3695,17,-8,10,36.95,256
,20171114,3720,3695,3722,3750,3720,3734,3731,39,36,10,37.32,252
,20171115,3734,3731,3732,3732,3612,3631,3646,-100,-85,34,123.98,252
,20171116,3631,3646,3605,3637,3593,3615,3617,-31,-29,18,65.12,250
,20171117,3615,3617,3593,3593,3564,3572,3572,-45,-45,28,100.02,240
,20171120,3572,3572,3585,3600,3571,3600,3583,28,11,16,57.34,238
,20171121,3600,3583,3632,3683,3624,3683,3636,100,53,68,247.28,232
,20171122,3683,3636,3744,3744,3707,3741,3730,105,94,18,67.15,240
,20171123,3741,3730,3762,3762,3755,3758,3758,28,28,8,30.07,238
,20171124,3758,3758,3688,3688,3688,3688,3688,-70,-70,2,7.38,236
,20171127,3688,3688,3721,3780,3721,3740,3751,52,63,34,127.56,230
,20171128,3740,3751,3748,3774,3734,3774,3767,23,16,52,195.90,276
,20171129,3774,3767,3769,3828,3760,3823,3791,56,24,92,348.81,300
,20171130,3823,3791,3844,3880,3823,3844,3860,53,69,80,308.88,318
,20171201,3844,3860,3785,3874,3785,3818,3826,-42,-34,114,436.19,314
,20171204,3818,3826,3811,3920,3810,3900,3884,74,58,94,365.16,318
,20171205,3900,3884,3891,3903,3833,3833,3866,-51,-18,104,402.14,260
,20171206,3833,3866,3836,3857,3741,3745,3807,-121,-59,38,144.67,232
,20171207,3745,3807,3750,3751,3609,3640,3711,-167,-96,110,408.23,218
,20171208,3640,3711,3655,3728,3655,3728,3706,17,-5,20,74.13,226
,20171211,3728,3706,3737,3777,3718,3754,3746,48,40,60,224.81,202
,20171212,3754,3746,3739,3777,3692,3692,3726,-54,-20,8,29.81,204
,20171213,3692,3726,3699,3699,3670,3684,3686,-42,-40,58,213.81,228
,20171214,3684,3686,3690,3708,3651,3665,3675,-21,-11,152,558.72,348
,20171215,3665,3675,3657,3718,3654,3696,3701,21,26,366,"1,354.91",476
,20171218,3696,3701,3733,3771,3698,3749,3740,48,39,152,568.55,468
,20171219,3749,3740,3745,3745,3682,3682,3709,-58,-31,86,318.99,464
,20171220,3682,3709,3667,3715,3666,3688,3688,-21,-21,18,66.40,462
,20171221,3688,3688,3718,3752,3694,3741,3726,53,38,96,357.78,462
,20171222,3741,3726,3743,3790,3743,3790,3764,64,38,16,60.23,464
,20171225,3790,3764,3800,3800,3678,3683,3710,-81,-54,90,333.92,456
,20171226,3683,3710,3680,3726,3680,3726,3696,16,-14,12,44.35,466
,20171227,3726,3696,3715,3719,3695,3695,3711,-1,15,48,178.14,462
,20171228,3695,3711,3678,3691,3659,3679,3676,-32,-35,26,95.58,472
,20171229,3679,3676,3709,3728,3709,3718,3722,42,46,44,163.80,474
rb1809,20170918,3652,3652,3634,3655,3590,3631,3646,-21,-6,872,"3,179.72",828
,20170919,3631,3646,3655,3666,3590,3590,3638,-56,-8,218,793.20,892
,20170920,3590,3638,3581,3610,3560,3580,3584,-58,-54,174,623.74,924
,20170921,3580,3584,3603,3616,3500,3504,3555,-80,-29,286,"1,016.96",1020
,20170922,3504,3555,3461,3500,3367,3390,3413,-165,-142,1266,"4,321.31",444
,20170925,3390,3413,3431,3440,3375,3420,3405,7,-8,392,"1,334.81",546
,20170926,3420,3405,3416,3447,3381,3390,3413,-15,8,1214,"4,143.89",1122
,20170927,3390,3413,3402,3429,3388,3409,3402,-4,-11,850,"2,891.92",1570
,20170928,3409,3402,3430,3450,3332,3362,3386,-40,-16,1736,"5,878.99",1934
,20170929,3362,3386,3359,3399,3300,3395,3353,9,-33,950,"3,186.22",2086
,20171009,3395,3353,3400,3456,3380,3405,3415,52,62,1020,"3,483.62",2154
,20171010,3405,3415,3392,3400,3333,3335,3358,-80,-57,1500,"5,038.47",2672
,20171011,3335,3358,3337,3377,3319,3321,3347,-37,-11,998,"3,340.47",2862
,20171012,3321,3347,3320,3391,3300,3383,3330,36,-17,2478,"8,252.13",3086
,20171013,3383,3330,3370,3498,3362,3496,3427,166,97,2342,"8,026.69",3094
,20171016,3496,3427,3495,3544,3485,3536,3511,109,84,2216,"7,781.52",3224
,20171017,3536,3511,3537,3546,3500,3514,3520,3,9,2130,"7,497.85",3128
,20171018,3514,3520,3510,3563,3503,3522,3536,2,16,1850,"6,542.78",2524
,20171019,3522,3536,3520,3520,3433,3454,3470,-82,-66,1932,"6,704.36",2840
,20171020,3454,3470,3474,3574,3439,3574,3512,104,42,1638,"5,753.07",2664
,20171023,3574,3512,3579,3579,3494,3552,3540,40,28,1894,"6,706.29",2530
,20171024,3552,3540,3535,3612,3532,3579,3585,39,45,1262,"4,525.12",2518
,20171025,3579,3585,3610,3645,3550,3569,3585,-16,0,1368,"4,904.98",2466
,20171026,3569,3585,3569,3593,3523,3568,3565,-17,-20,1062,"3,786.24",2430
,20171027,3568,3565,3560,3575,3510,3516,3540,-49,-25,972,"3,440.99",2414
,20171030,3516,3540,3510,3534,3491,3502,3516,-38,-24,470,"1,652.75",2472
,20171031,3502,3516,3490,3553,3479,3532,3518,16,2,832,"2,927.23",2510
,20171101,3532,3518,3533,3574,3505,3505,3556,-13,38,1448,"5,149.47",2562
,20171102,3505,3556,3501,3609,3484,3572,3554,16,-2,1138,"4,045.08",2540
,20171103,3572,3554,3562,3600,3545,3553,3569,-1,15,686,"2,448.51",2514
,20171106,3553,3569,3560,3655,3552,3652,3605,83,36,868,"3,129.57",2554
,20171107,3652,3605,3659,3664,3627,3651,3651,46,46,798,"2,913.64",2510
,20171108,3651,3651,3663,3663,3605,3636,3632,-15,-19,684,"2,484.43",2428
,20171109,3636,3632,3644,3722,3634,3659,3666,27,34,1198,"4,392.59",2352
,20171110,3659,3666,3651,3675,3616,3675,3647,9,-19,954,"3,480.13",2272
,20171113,3675,3647,3682,3684,3617,3661,3647,14,0,1354,"4,938.24",2458
,20171114,3661,3647,3654,3666,3628,3644,3648,-3,1,894,"3,262.10",2532
,20171115,3644,3648,3650,3656,3542,3571,3593,-77,-55,1168,"4,197.74",2526
,20171116,3571,3593,3576,3593,3536,3577,3566,-16,-27,582,"2,075.86",2450
,20171117,3577,3566,3569,3580,3533,3538,3552,-28,-14,626,"2,223.99",2514
,20171120,3538,3552,3547,3599,3539,3596,3562,44,10,856,"3,049.30",2390
,20171121,3596,3562,3599,3654,3582,3644,3621,82,59,808,"2,926.10",2338
,20171122,3644,3621,3645,3695,3641,3687,3672,66,51,2252,"8,270.46",1884
,20171123,3687,3672,3686,3715,3661,3689,3691,17,19,858,"3,167.72",1960
,20171124,3689,3691,3666,3688,3622,3676,3664,-15,-27,802,"2,938.56",2012
,20171127,3676,3664,3690,3729,3664,3680,3696,16,32,702,"2,594.75",1978
,20171128,3680,3696,3686,3700,3668,3693,3686,-3,-10,478,"1,761.94",1970
,20171129,3693,3686,3689,3749,3660,3747,3709,61,23,1662,"6,165.08",2322
,20171130,3747,3709,3745,3785,3729,3753,3763,44,54,1914,"7,203.26",1992
,20171201,3753,3763,3759,3775,3713,3740,3742,-23,-21,808,"3,023.71",1946
,20171204,3740,3742,3733,3862,3727,3816,3809,74,67,1392,"5,302.36",1898
,20171205,3816,3809,3821,3840,3771,3781,3807,-28,-2,936,"3,563.55",1956
,20171206,3781,3807,3749,3797,3703,3715,3745,-92,-62,1070,"4,007.38",1858
,20171207,3715,3745,3717,3717,3583,3625,3663,-120,-82,1100,"4,030.23",1956
,20171208,3625,3663,3618,3689,3615,3684,3651,21,-12,720,"2,628.75",2018
,20171211,3684,3651,3680,3733,3670,3694,3700,43,49,924,"3,419.45",1980
,20171212,3694,3700,3707,3752,3667,3679,3707,-21,7,1384,"5,131.38",2110
,20171213,3679,3707,3672,3681,3630,3648,3651,-59,-56,1422,"5,192.75",2480
,20171214,3648,3651,3651,3668,3608,3633,3640,-18,-11,990,"3,604.55",2582
,20171215,3633,3640,3634,3665,3626,3665,3644,25,4,648,"2,361.46",2494
,20171218,3665,3644,3667,3720,3646,3689,3679,45,35,2460,"9,050.92",2816
,20171219,3689,3679,3685,3692,3642,3643,3661,-36,-18,1004,"3,676.39",3108
,20171220,3643,3661,3621,3661,3621,3640,3643,-21,-18,922,"3,359.69",3336
,20171221,3640,3643,3648,3690,3623,3669,3665,26,22,1882,"6,898.68",3230
,20171222,3669,3665,3674,3746,3666,3731,3712,66,47,1186,"4,403.24",3100
,20171225,3731,3712,3769,3769,3630,3630,3670,-82,-42,1040,"3,817.77",3048
,20171226,3630,3670,3624,3682,3624,3682,3651,12,-19,610,"2,227.46",3120
,20171227,3682,3651,3672,3689,3655,3666,3675,15,24,1314,"4,829.00",3618
,20171228,3666,3675,3655,3666,3625,3650,3643,-25,-32,1326,"4,831.27",4072
,20171229,3650,3643,3646,3691,3645,3666,3675,23,32,1824,"6,704.25",3880
rb1810,20171017,3511,3511,3501,3509,3424,3437,3458,-74,-53,23676,"81,884.00",18600
,20171018,3437,3458,3442,3486,3437,3450,3463,-8,5,13024,"45,104.86",22706
,20171019,3450,3463,3451,3454,3370,3388,3404,-75,-59,19262,"65,575.82",25352
,20171020,3388,3404,3389,3538,3385,3531,3470,127,66,27676,"96,045.77",32090
,20171023,3531,3470,3529,3536,3440,3518,3498,48,28,28950,"101,291.51",35280
,20171024,3518,3498,3520,3587,3492,3560,3556,62,58,25180,"89,564.75",39436
,20171025,3560,3556,3569,3620,3515,3540,3569,-16,13,28308,"101,037.28",40430
,20171026,3540,3569,3549,3558,3500,3533,3523,-36,-46,29416,"103,638.19",44982
,20171027,3533,3523,3530,3534,3469,3483,3499,-40,-24,43592,"152,551.03",58264
,20171030,3483,3499,3476,3496,3455,3461,3477,-38,-22,21434,"74,535.29",60278
,20171031,3461,3477,3458,3535,3421,3511,3489,34,12,28784,"100,455.14",63136
,20171101,3511,3489,3510,3537,3464,3464,3510,-25,21,32058,"112,545.32",68890
,20171102,3464,3510,3464,3568,3450,3548,3521,38,11,60500,"213,044.62",77104
,20171103,3548,3521,3547,3576,3505,3527,3539,6,18,47510,"168,154.09",77156
,20171106,3527,3539,3526,3629,3524,3620,3595,81,56,70978,"255,229.12",100572
,20171107,3620,3595,3619,3638,3591,3613,3611,18,16,43468,"156,974.67",102994
,20171108,3613,3611,3608,3618,3566,3601,3595,-10,-16,54084,"194,467.50",109144
,20171109,3601,3595,3600,3692,3582,3603,3631,8,36,108338,"393,474.12",113274
,20171110,3603,3631,3610,3627,3575,3616,3606,-15,-25,81914,"295,459.78",117744
,20171113,3616,3606,3620,3645,3553,3597,3585,-9,-21,135810,"486,911.74",141950
,20171114,3597,3585,3596,3603,3559,3580,3581,-5,-4,85040,"304,579.62",148948
,20171115,3580,3581,3579,3595,3480,3508,3526,-73,-55,122362,"431,474.27",157598
,20171116,3508,3526,3509,3525,3477,3510,3506,-16,-20,70790,"248,204.21",154638
,20171117,3510,3506,3509,3515,3470,3480,3489,-26,-17,74984,"261,670.71",157138
,20171120,3480,3489,3480,3542,3473,3537,3503,48,14,89408,"313,223.04",158628
,20171121,3537,3503,3543,3594,3517,3583,3563,80,60,81852,"291,660.75",161916
,20171122,3583,3563,3585,3628,3573,3621,3602,58,39,95152,"342,821.17",164368
,20171123,3621,3602,3612,3644,3601,3619,3621,17,19,110238,"399,246.85",176426
,20171124,3619,3621,3616,3619,3534,3614,3593,-7,-28,80924,"290,789.19",176610
,20171127,3614,3593,3616,3664,3598,3620,3631,27,38,120874,"438,982.24",179664
,20171128,3620,3631,3620,3636,3602,3623,3618,-8,-13,116414,"421,227.14",209512
,20171129,3623,3618,3627,3665,3585,3658,3628,40,10,157130,"570,163.23",244950
,20171130,3658,3628,3654,3720,3654,3690,3690,62,62,206984,"763,931.82",291190
,20171201,3690,3690,3692,3705,3636,3672,3674,-18,-16,153474,"563,893.94",301124
,20171204,3672,3674,3664,3789,3656,3746,3738,72,64,172430,"644,693.34",314670
,20171205,3746,3738,3754,3766,3701,3717,3742,-21,4,112156,"419,751.07",318996
,20171206,3717,3742,3714,3731,3630,3639,3673,-103,-69,161378,"592,870.08",310650
,20171207,3639,3673,3645,3648,3517,3558,3601,-115,-72,183512,"660,953.81",330402
,20171208,3558,3601,3558,3620,3539,3608,3581,7,-20,143160,"512,699.28",327510
,20171211,3608,3581,3615,3667,3597,3625,3633,44,52,171868,"624,538.10",316888
,20171212,3625,3633,3632,3687,3592,3606,3637,-27,4,150820,"548,595.33",323074
,20171213,3606,3637,3609,3613,3558,3573,3583,-64,-54,178042,"637,972.07",322722
,20171214,3573,3583,3555,3608,3555,3574,3577,-9,-6,175758,"628,818.24",324294
,20171215,3574,3577,3570,3603,3558,3597,3579,20,2,141648,"507,018.96",324268
,20171218,3597,3579,3606,3665,3598,3635,3623,56,44,201736,"730,912.34",317478
,20171219,3635,3623,3636,3636,3586,3587,3609,-36,-14,143958,"519,562.69",326702
,20171220,3587,3609,3590,3610,3573,3583,3589,-26,-20,129022,"463,142.02",336248
,20171221,3583,3589,3588,3633,3570,3614,3608,25,19,191304,"690,378.25",338460
,20171222,3614,3608,3618,3689,3612,3678,3653,70,45,191734,"700,412.65",323416
,20171225,3678,3653,3679,3685,3574,3575,3616,-78,-37,196478,"710,657.38",347816
,20171226,3575,3616,3572,3632,3567,3626,3599,10,-17,196024,"705,604.43",328388
,20171227,3626,3599,3625,3640,3600,3603,3622,4,23,222706,"806,660.01",334934
,20171228,3603,3622,3603,3617,3573,3602,3592,-20,-30,218028,"783,368.39",324740
,20171229,3602,3592,3600,3637,3593,3609,3618,17,26,174774,"632,342.84",314524
rb1811,20171116,3526,3526,3520,3520,3450,3476,3477,-50,-49,176,611.96,122
,20171117,3476,3477,3473,3476,3441,3444,3457,-33,-20,66,228.21,174
,20171120,3444,3457,3458,3501,3456,3501,3484,44,27,48,167.25,174
,20171121,3501,3484,3488,3554,3479,3548,3508,64,24,54,189.45,152
,20171122,3548,3508,3564,3594,3527,3579,3560,71,52,190,676.51,182
,20171123,3579,3560,3587,3600,3563,3563,3585,3,25,104,372.94,220
,20171124,3563,3585,3564,3574,3534,3573,3558,-12,-27,138,491.08,304
,20171127,3573,3558,3589,3609,3560,3589,3583,31,25,256,917.49,268
,20171128,3589,3583,3588,3596,3565,3576,3578,-7,-5,170,608.30,414
,20171129,3576,3578,3576,3607,3544,3604,3582,26,4,156,558.84,460
,20171130,3604,3582,3618,3668,3599,3644,3641,62,59,1112,"4,049.43",1254
,20171201,3644,3641,3640,3658,3590,3626,3640,-15,-1,730,"2,657.33",1774
,20171204,3626,3640,3617,3726,3610,3699,3689,59,49,392,"1,446.25",1816
,20171205,3699,3689,3688,3712,3658,3665,3689,-24,0,262,966.60,1948
,20171206,3665,3689,3672,3672,3579,3579,3609,-110,-80,646,"2,332.03",2180
,20171207,3579,3609,3590,3596,3470,3515,3546,-94,-63,430,"1,524.99",2422
,20171208,3515,3546,3515,3573,3492,3561,3548,15,2,714,"2,533.57",2750
,20171211,3561,3548,3572,3612,3553,3570,3585,22,37,302,"1,082.85",2686
,20171212,3570,3585,3585,3630,3548,3561,3599,-24,14,380,"1,367.69",2812
,20171213,3561,3599,3548,3565,3520,3529,3534,-70,-65,640,"2,262.02",2864
,20171214,3529,3534,3530,3552,3508,3518,3530,-16,-4,386,"1,362.60",3040
,20171215,3518,3530,3521,3559,3512,3559,3533,29,3,216,763.20,2998
,20171218,3559,3533,3555,3611,3550,3583,3575,50,42,452,"1,616.30",2974
,20171219,3583,3575,3575,3585,3540,3547,3557,-28,-18,98,348.62,3020
,20171220,3547,3557,3450,3558,3450,3537,3541,-20,-16,250,885.35,3098
,20171221,3537,3541,3550,3584,3530,3565,3561,24,20,172,612.64,3048
,20171222,3565,3561,3611,3637,3565,3624,3605,63,44,324,"1,168.26",2948
,20171225,3624,3605,3614,3628,3531,3536,3570,-69,-35,380,"1,356.74",3178
,20171226,3536,3570,3521,3585,3521,3578,3547,8,-23,280,993.19,3182
,20171227,3578,3547,3581,3594,3560,3565,3577,18,30,268,958.86,3200
,20171228,3565,3577,3565,3570,3533,3560,3549,-17,-28,406,"1,441.25",3326
,20171229,3560,3549,3555,3589,3552,3568,3570,19,21,320,"1,142.61",3286
rb1812,20171218,3533,3533,3580,3606,3552,3578,3573,45,40,156,557.47,100
,20171219,3578,3573,3684,3684,3465,3540,3557,-33,-16,66,234.80,126
,20171220,3540,3557,3533,3557,3530,3530,3538,-27,-19,52,184.01,154
,20171221,3530,3538,3545,3599,3533,3548,3556,10,18,178,633.13,164
,20171222,3548,3556,3596,3625,3561,3611,3595,55,39,96,345.13,176
,20171225,3611,3595,3617,3617,3532,3532,3562,-63,-33,138,491.60,278
,20171226,3532,3562,3535,3576,3532,3575,3550,13,-12,118,418.95,322
,20171227,3575,3550,3574,3588,3557,3565,3573,15,23,118,421.62,376
,20171228,3565,3573,3557,3558,3536,3556,3548,-17,-25,158,560.59,448
,20171229,3556,3548,3550,3582,3550,3552,3569,4,21,170,606.89,452
ru1701,20170103,17745,17645,17745,18280,17745,17840,18035,195,390,2420,"43,645.73",17728
,20170104,17840,18035,17840,18055,17300,18010,17745,-25,-290,1922,"34,112.83",17146
,20170105,18010,17745,17970,18000,17565,17565,17730,-180,-15,2096,"37,169.28",16366
,20170106,17565,17730,17605,17740,17320,17380,17510,-350,-220,2188,"38,314.40",15446
,20170109,17380,17510,17405,18445,17365,18415,17940,905,430,2196,"39,405.47",14606
,20170110,18415,17940,18250,18990,18160,18800,18565,860,625,2258,"41,924.82",13890
,20170111,18800,18565,18825,19250,18690,19100,18910,535,345,1914,"36,199.32",13200
,20170112,19100,18910,19055,20000,18705,19935,19745,1025,835,542,"10,702.87",12986
,20170113,19935,19745,19720,19980,19615,19710,19795,-35,50,448,"8,868.26",13030
,20170116,19710,19795,19720,21175,19690,21175,20625,1380,830,734,"15,141.43",12648
ru1703,20170103,18045,18095,18045,18245,18045,18245,18145,150,50,4,72.58,150
,20170104,18245,18145,18125,18125,17580,17745,17815,-400,-330,6,106.90,150
,20170105,17745,17815,18220,18220,17940,18010,18065,195,250,10,180.67,152
,20170106,18010,18065,,,,17850,17850,-215,-215,0,0.00,152
,20170109,17850,17850,17575,18775,17575,18665,18275,815,425,86,"1,571.96",184
,20170110,18665,18275,18725,19020,18695,19020,18710,745,435,60,"1,122.74",138
,20170111,19020,18710,19100,19100,19000,19100,19055,390,345,28,533.54,132
,20170112,19100,19055,19295,19710,19295,19710,19505,655,450,8,156.05,132
,20170113,19710,19505,19975,20270,19975,20160,20145,655,640,24,483.48,140
,20170116,20160,20145,20170,21150,20055,21150,20650,1005,505,36,743.48,146
,20170117,21150,20650,21185,21400,20605,20800,20940,150,290,34,712.10,138
,20170118,20800,20940,21280,21280,20750,20980,21075,40,135,22,463.72,136
,20170119,20980,21075,21015,21375,20850,20990,21160,-85,85,376,"7,957.35",156
,20170120,20990,21160,20815,20870,19675,19680,20215,-1480,-945,46,929.96,172
,20170123,19680,20215,19550,19905,19530,19740,19785,-475,-430,22,435.31,170
,20170124,19740,19785,19740,19980,19460,19955,19785,170,0,60,"1,187.11",160
,20170125,19955,19785,20150,20150,20130,20130,20140,345,355,4,80.56,162
,20170126,20130,20140,20475,20940,20045,20880,20660,740,520,36,743.79,162
,20170203,20880,20660,20850,20990,19870,19870,20350,-790,-310,92,"1,872.48",170
,20170206,19870,20350,20000,20000,19670,19715,19855,-635,-495,10,198.59,172
,20170207,19715,19855,20050,20370,19950,20370,20165,515,310,14,282.33,178
,20170208,20370,20165,20640,20640,20640,20640,20640,475,475,2,41.28,178
,20170209,20640,20640,20180,20530,20180,20410,20445,-230,-195,72,"1,472.33",178
,20170210,20410,20445,20210,20980,20210,20970,20345,525,-100,28,569.69,180
,20170213,20970,20345,20990,21730,20935,21730,21380,1385,1035,16,342.13,192
,20170214,21730,21380,22000,22000,21440,21705,21605,325,225,24,518.53,194
,20170215,21705,21605,21995,21995,21210,21210,21500,-395,-105,30,645.10,182
,20170216,21210,21500,21040,21400,20865,21400,21100,-100,-400,26,548.65,178
,20170217,21400,21100,19985,19985,19750,19820,19850,-1280,-1250,6,119.11,176
,20170220,19820,19850,19915,20070,19515,20060,19925,210,75,16,318.83,176
,20170221,20060,19925,,,,19815,19815,-110,-110,0,0.00,176
,20170222,19815,19815,19670,19670,19580,19580,19625,-235,-190,4,78.50,176
,20170223,19580,19625,19775,19930,18615,18615,19615,-1010,-10,32,627.72,176
,20170224,18615,19615,18420,18420,18420,18420,18420,-1195,-1195,8,147.36,176
,20170227,18420,18420,,,,18420,18420,0,0,0,0.00,176
,20170228,18420,18420,,,,18250,18250,-170,-170,0,0.00,176
,20170301,18250,18250,18430,18430,18090,18330,18270,80,20,8,146.16,176
,20170302,18330,18270,,,,18270,18270,0,0,0,0.00,176
,20170303,18270,18270,,,,18270,18270,0,0,0,0.00,176
,20170306,18270,18270,18700,18700,18700,18700,18700,430,430,16,299.20,160
,20170307,18700,18700,,,,18700,18700,0,0,0,0.00,160
,20170308,18700,18700,,,,18700,18700,0,0,0,0.00,160
,20170309,18700,18700,17390,17390,17390,17390,17390,-1310,-1310,4,69.56,160
,20170310,17390,17390,17425,17620,17000,17620,17390,230,0,30,521.78,160
,20170313,17620,17390,,,,17390,17390,0,0,0,0.00,160
,20170314,17390,17390,16505,17420,16505,17420,17260,30,-130,12,207.17,160
,20170315,17420,17260,17060,17060,17060,17060,17060,-200,-200,2,34.12,160
ru1704,20170103,17995,18030,,,,18170,18170,140,140,0,0.00,152
,20170104,18170,18170,,,,18280,18280,110,110,0,0.00,152
,20170105,18280,18280,18125,18275,17885,17985,18080,-295,-200,10,180.83,152
,20170106,17985,18080,,,,17855,17855,-225,-225,0,0.00,152
,20170109,17855,17855,,,,18255,18255,400,400,0,0.00,152
,20170110,18255,18255,,,,18990,18990,735,735,0,0.00,152
,20170111,18990,18990,,,,19360,19360,370,370,0,0.00,152
,20170112,19360,19360,20060,20185,19900,20185,20045,825,685,410,"8,220.39",154
,20170113,20185,20045,20175,20180,20145,20180,20175,135,130,84,"1,695.04",74
,20170116,20180,20175,21190,21455,21190,21455,21320,1280,1145,34,724.98,74
,20170117,21455,21320,21360,21375,21050,21050,21280,-270,-40,22,468.20,74
,20170118,21050,21280,21110,21295,21110,21205,21170,-75,-110,46,973.86,40
,20170119,21205,21170,,,,21155,21155,-15,-15,0,0.00,40
,20170120,21155,21155,19735,19775,19735,19775,19755,-1380,-1400,4,79.02,42
,20170123,19775,19755,19615,19750,19545,19750,19660,-5,-95,8,157.31,42
,20170124,19750,19660,19640,19640,19640,19640,19640,-20,-20,2,39.28,40
,20170125,19640,19640,20050,20435,20050,20135,20205,495,565,6,121.24,38
,20170126,20135,20205,,,,21230,21230,1025,1025,0,0.00,38
,20170203,21230,21230,,,,20270,20270,-960,-960,0,0.00,38
,20170206,20270,20270,20150,20150,20135,20135,20135,-135,-135,10,201.38,38
,20170207,20135,20135,20455,20455,20365,20365,20410,230,275,118,"2,408.71",38
,20170208,20365,20410,,,,20410,20410,0,0,0,0.00,38
,20170209,20410,20410,20485,20540,20270,20480,20380,70,-30,36,733.71,56
,20170210,20480,20380,20425,20975,20410,20880,20550,500,170,34,698.77,36
,20170213,20880,20550,21750,21820,21680,21680,21750,1130,1200,14,304.50,44
,20170214,21680,21750,21955,21955,21830,21830,21890,80,140,4,87.57,46
,20170215,21830,21890,21730,21730,21370,21700,21600,-190,-290,6,129.60,46
,20170216,21700,21600,21530,21530,21530,21530,21530,-70,-70,8,172.24,50
,20170217,21530,21530,20255,20425,20020,20120,20315,-1410,-1215,116,"2,356.73",48
,20170220,20120,20315,20345,20345,19885,20075,20060,-240,-255,24,481.45,50
,20170221,20075,20060,20380,20385,19925,19950,20080,-110,20,44,883.57,58
,20170222,19950,20080,,,,19975,19975,-105,-105,0,0.00,58
,20170223,19975,19975,19895,19895,18635,18635,19130,-1340,-845,32,612.27,72
,20170224,18635,19130,18540,18640,18530,18580,18570,-550,-560,8,148.58,72
,20170227,18580,18570,18825,18825,18615,18825,18725,255,155,18,337.07,66
,20170228,18825,18725,,,,18410,18410,-315,-315,0,0.00,66
,20170301,18410,18410,19190,19195,18415,18615,18790,205,380,100,"1,879.01",78
,20170302,18615,18790,18665,18665,18585,18665,18635,-125,-155,6,111.83,78
,20170303,18665,18635,18580,19030,18510,19030,18640,395,5,66,"1,230.51",84
,20170306,19030,18640,18070,19160,18070,18745,18790,105,150,20,375.87,80
,20170307,18745,18790,18535,18540,18410,18520,18475,-270,-315,26,480.44,88
,20170308,18520,18475,18505,18505,17540,17600,17905,-875,-570,56,"1,002.89",86
,20170309,17600,17905,17640,17715,17340,17420,17580,-485,-325,44,773.71,86
,20170310,17420,17580,17665,17665,17445,17505,17535,-75,-45,12,210.46,90
,20170313,17505,17535,17525,17650,17045,17560,17390,25,-145,34,591.35,92
,20170314,17560,17390,17610,17625,17300,17300,17550,-90,160,10,175.52,90
,20170315,17300,17550,17285,17555,17155,17555,17365,5,-185,14,243.11,88
,20170316,17555,17365,17625,17800,17245,17245,17590,-120,225,18,316.69,88
,20170317,17245,17590,17670,18060,17670,18060,17860,470,270,26,464.45,94
,20170320,18060,17860,18175,18225,17835,17835,18080,-25,220,28,506.33,100
,20170321,17835,18080,17690,17700,17225,17295,17530,-785,-550,16,280.49,100
,20170322,17295,17530,17380,17380,16605,16605,16955,-925,-575,12,203.51,106
,20170323,16605,16955,16945,16945,16255,16550,16535,-405,-420,14,231.55,102
,20170324,16550,16535,16500,16500,16325,16395,16460,-140,-75,14,230.44,102
,20170327,16395,16460,16300,16300,15445,15445,15550,-1015,-910,18,279.94,86
,20170328,15445,15550,15600,15800,15600,15800,15700,250,150,8,125.60,94
,20170329,15800,15700,15850,15855,15850,15850,15850,150,150,14,221.92,86
,20170330,15850,15850,15675,16090,15675,16090,15880,240,30,4,63.53,86
,20170331,16090,15880,15800,15800,15800,15800,15800,-80,-80,2,31.60,86
,20170405,15800,15800,,,,15800,15800,0,0,0,0.00,86
,20170406,15800,15800,16230,16230,16050,16100,16125,300,325,6,96.76,92
,20170407,16100,16125,15430,15430,15240,15280,15315,-845,-810,6,91.90,96
,20170410,15280,15315,14900,14900,14900,14900,14900,-415,-415,2,29.80,98
,20170411,14900,14900,14505,14835,14505,14740,14745,-160,-155,32,471.88,112
,20170412,14740,14745,14150,14150,14140,14140,14140,-605,-605,6,84.86,118
,20170413,14140,14140,,,,14140,14140,0,0,0,0.00,118
,20170414,14140,14140,14100,14160,14100,14160,14130,20,-10,4,56.52,120
,20170417,14160,14130,,,,14130,14130,0,0,0,0.00,120
ru1705,20170103,18350,18170,18380,18875,18305,18360,18635,190,465,352158,"6,562,511.90",242004
,20170104,18360,18635,18455,18650,17820,18530,18265,-105,-370,581234,"10,618,196.21",255616
,20170105,18530,18265,18500,18550,18070,18075,18325,-190,60,505940,"9,271,618.69",250880
,20170106,18075,18325,18110,18260,17810,17855,18015,-470,-310,443232,"7,984,840.42",258706
,20170109,17855,18015,17860,18995,17825,18970,18430,955,415,525384,"9,684,071.51",277264
,20170110,18970,18430,18985,19350,18870,19270,19055,840,625,486934,"9,279,762.13",276020
,20170111,19270,19055,19340,19635,19155,19555,19380,500,325,453522,"8,789,588.39",281938
,20170112,19555,19380,19530,20475,19470,20295,20065,915,685,673560,"13,515,074.03",297160
,20170113,20295,20065,20110,20620,20110,20330,20380,265,315,536300,"10,930,515.59",297392
,20170116,20330,20380,20285,21730,20240,21515,21150,1135,770,579418,"12,255,166.87",300430
,20170117,21515,21150,21490,21760,20830,21250,21320,100,170,574236,"12,243,305.15",299436
,20170118,21250,21320,21350,21595,20930,21295,21275,-25,-45,539832,"11,485,077.97",298870
,20170119,21295,21275,21295,21435,20970,21155,21225,-120,-50,479118,"10,170,786.02",296140
,20170120,21155,21225,21110,21190,19735,19735,20450,-1490,-775,732102,"14,973,438.66",269548
,20170123,19735,20450,19785,20235,19715,19845,19955,-605,-495,379200,"7,567,633.91",255162
,20170124,19845,19955,19850,20420,19535,20240,20075,285,120,489532,"9,829,549.46",261052
,20170125,20240,20075,20310,20455,19975,20220,20235,145,160,349688,"7,077,298.21",248458
,20170126,20220,20235,20360,21475,20300,21475,21000,1240,765,442654,"9,295,747.93",260568
,20170203,21475,21000,21475,21480,19925,20175,20430,-825,-570,338534,"6,917,088.52",248324
,20170206,20175,20430,20175,20365,19880,20080,20160,-350,-270,347538,"7,007,804.00",258420
,20170207,20080,20160,20130,20730,19955,20680,20280,520,120,516704,"10,479,914.28",282360
,20170208,20680,20280,20645,21030,20450,20725,20715,445,435,438590,"9,085,769.78",273718
,20170209,20725,20715,20730,20925,20400,20585,20695,-130,-20,421226,"8,719,071.35",273500
,20170210,20585,20695,20480,21350,20410,20970,20855,275,160,529878,"11,053,016.43",284662
,20170213,20970,20855,21050,22135,21025,22005,21685,1150,830,536406,"11,632,950.40",298660
,20170214,22005,21685,21995,22070,21610,22015,21890,330,205,362700,"7,941,087.19",295868
,20170215,22015,21890,21950,22310,21390,21550,21715,-340,-175,536040,"11,640,955.85",293510
,20170216,21550,21715,21480,21780,20225,20320,21180,-1395,-535,638776,"13,532,093.57",282244
,20170217,20320,21180,20395,20635,20025,20380,20380,-800,-800,513092,"10,457,788.74",274468
,20170220,20380,20380,20405,20525,19750,20300,20200,-80,-180,490040,"9,899,344.54",272918
,20170221,20300,20200,20400,20700,19915,20090,20345,-110,145,525568,"10,692,991.01",277494
,20170222,20090,20345,20000,20160,19620,20040,19940,-305,-405,529904,"10,567,752.96",282578
,20170223,20040,19940,19950,20120,18565,18690,19420,-1250,-520,617992,"12,004,254.11",296156
,20170224,18690,19420,18830,18850,18360,18800,18665,-620,-755,369218,"6,892,300.36",282682
,20170227,18800,18665,18845,19015,18560,18785,18805,120,140,425564,"8,003,222.80",277430
,20170228,18785,18805,18720,18800,18160,18490,18520,-315,-285,535634,"9,921,637.26",289578
,20170301,18490,18520,18510,19095,18490,18745,18725,225,205,458414,"8,583,837.42",273944
,20170302,18745,18725,18765,18930,18520,18855,18760,130,35,404224,"7,584,732.28",279934
,20170303,18855,18760,18800,19185,18540,19100,18870,340,110,515968,"9,738,234.84",271838
,20170306,19100,18870,19185,19250,18635,18710,18960,-160,90,407294,"7,723,291.52",258368
,20170307,18710,18960,18675,18730,18410,18625,18615,-335,-345,303084,"5,642,908.13",256298
,20170308,18625,18615,18605,18665,17660,17780,18035,-835,-580,473724,"8,545,092.17",283816
,20170309,17780,18035,17855,17915,17505,17555,17720,-480,-315,362070,"6,416,929.59",270434
,20170310,17555,17720,17575,17885,17345,17640,17675,-80,-45,399642,"7,065,023.79",272508
,20170313,17640,17675,17700,17920,17150,17820,17560,145,-115,491128,"8,626,411.20",266382
,20170314,17820,17560,17805,18015,17400,17515,17700,-45,140,457176,"8,092,255.75",263600
,20170315,17515,17700,17450,17900,17220,17715,17615,15,-85,441240,"7,773,501.26",249744
,20170316,17715,17615,17755,18060,17350,17820,17700,205,85,460760,"8,157,273.46",248104
,20170317,17820,17700,17820,18295,17730,18230,18010,530,310,415798,"7,490,360.10",228244
,20170320,18230,18010,18270,18320,17760,17880,18065,-130,55,274590,"4,960,507.27",209360
,20170321,17880,18065,17860,17955,17425,17510,17675,-555,-390,227178,"4,016,052.47",191946
,20170322,17510,17675,17485,17620,16515,16560,16995,-1115,-680,269006,"4,572,602.21",191478
,20170323,16560,16995,16560,16795,16400,16580,16610,-415,-385,147970,"2,458,178.46",171384
,20170324,16580,16610,16640,16740,16330,16435,16560,-175,-50,136286,"2,257,022.11",163738
,20170327,16435,16560,16460,16485,15500,15640,15865,-920,-695,137334,"2,179,403.99",136622
,20170328,15640,15865,15605,16035,15535,15715,15790,-150,-75,91084,"1,438,633.70",121624
,20170329,15715,15790,15800,16255,15775,16070,15990,280,200,76950,"1,230,779.41",110292
,20170330,16070,15990,16070,16135,15650,15810,15905,-180,-85,60940,"969,476.84",101316
,20170331,15810,15905,15810,16075,15755,15785,15895,-120,-10,57744,"918,054.72",92972
,20170405,15785,15895,15885,16650,15820,16435,16295,540,400,54586,"889,487.23",81872
,20170406,16435,16295,16405,16520,16130,16285,16330,-10,35,27360,"446,825.39",79098
,20170407,16285,16330,16205,16245,15185,15185,15540,-1145,-790,47944,"745,169.82",76752
,20170410,15185,15540,15100,15295,14850,14965,15040,-575,-500,35950,"540,725.13",68820
,20170411,14965,15040,14770,15130,14520,14865,14915,-175,-125,30274,"451,595.98",67840
,20170412,14865,14915,14860,14970,14075,14190,14405,-725,-510,36838,"530,772.25",60988
,20170413,14190,14405,14200,14650,14160,14450,14405,45,0,26100,"376,045.48",58034
,20170414,14450,14405,14425,14595,14035,14280,14300,-125,-105,20118,"287,751.95",54006
,20170417,14280,14300,14270,14660,14210,14355,14395,55,95,21784,"313,680.29",52270
,20170418,14355,14395,14425,14495,14005,14055,14235,-340,-160,17166,"244,411.45",48034
,20170419,14055,14235,13965,14000,13455,13845,13795,-390,-440,22120,"305,172.86",43414
,20170420,13845,13795,13860,14335,13630,14295,13935,500,140,24912,"347,221.69",38788
,20170421,14295,13935,14330,14460,14135,14280,14325,345,390,15928,"228,228.74",37080
,20170424,14280,14325,14210,14335,13900,14285,14160,-40,-165,11302,"160,058.97",33796
,20170425,14285,14160,14285,14480,14105,14150,14290,-10,130,11580,"165,489.90",31766
,20170426,14150,14290,14105,14400,13960,14030,14190,-260,-100,10534,"149,529.80",28582
,20170427,14030,14190,14125,14125,13895,14085,14035,-105,-155,8192,"114,978.60",26272
,20170428,14085,14035,14100,14405,13960,14240,14215,205,180,10584,"150,478.97",22330
,20170502,14240,14215,14230,14800,14200,14735,14675,520,460,4720,"69,268.30",21920
,20170503,14735,14675,14605,14830,14545,14570,14640,-105,-35,1824,"26,704.12",21542
,20170504,14570,14640,14425,14425,13615,13615,13870,-1025,-770,4726,"65,568.09",19658
,20170505,13615,13870,13540,13595,13070,13125,13295,-745,-575,2996,"39,842.05",18376
,20170508,13125,13295,13260,13425,13060,13110,13255,-185,-40,1320,"17,500.04",17844
,20170509,13110,13255,13050,13200,12950,13120,13085,-135,-170,2350,"30,751.38",17064
,20170510,13120,13085,13165,13285,12700,12785,13010,-300,-75,4292,"55,855.10",16676
,20170511,12785,13010,12785,13250,12785,13215,12985,205,-25,972,"12,622.20",16766
,20170512,13215,12985,13280,13280,12930,13020,12990,35,5,310,"4,027.26",16764
,20170515,13020,12990,13020,13290,12510,13240,13125,250,135,426,"5,591.60",16696
ru1706,20170103,18165,18095,18710,18850,18400,18400,18735,305,640,16,299.79,240
,20170104,18400,18735,18500,18650,17950,18650,18330,-85,-405,46,843.39,232
,20170105,18650,18330,18480,18555,18215,18215,18380,-115,50,58,"1,066.06",248
,20170106,18215,18380,18090,18200,17850,17925,18090,-455,-290,64,"1,157.98",230
,20170109,17925,18090,17960,18670,17895,18670,18395,580,305,26,478.35,226
,20170110,18670,18395,18990,19235,18955,19215,19055,820,660,1034,"19,706.60",992
,20170111,19215,19055,19280,19580,19225,19580,19260,525,205,912,"17,568.05",316
,20170112,19580,19260,19975,20405,19815,20185,20275,925,1015,72,"1,459.91",330
,20170113,20185,20275,21560,21560,20170,20360,20405,85,130,50,"1,020.33",320
,20170116,20360,20405,20675,21645,20675,21625,21390,1220,985,104,"2,224.77",316
,20170117,21625,21390,21490,21725,20900,21390,21235,0,-155,80,"1,699.14",320
,20170118,21390,21235,22150,22150,21020,21325,21470,90,235,90,"1,932.43",316
,20170119,21325,21470,21360,21360,21140,21250,21210,-220,-260,86,"1,824.48",314
,20170120,21250,21210,20940,21105,19800,19800,20520,-1410,-690,264,"5,417.47",308
,20170123,19800,20520,19850,20245,19800,19845,20065,-675,-455,114,"2,287.63",316
,20170124,19845,20065,19930,20355,19650,20255,20000,190,-65,112,"2,240.11",318
,20170125,20255,20000,20330,20430,20130,20310,20285,310,285,124,"2,515.75",218
,20170126,20310,20285,20660,21465,20655,21445,21135,1160,850,78,"1,648.58",232
,20170203,21445,21135,21110,21185,20095,20200,20500,-935,-635,84,"1,722.00",264
,20170206,20200,20500,19995,20370,19995,20115,20120,-385,-380,54,"1,086.56",296
,20170207,20115,20120,20250,20555,20005,20555,20280,435,160,86,"1,744.43",248
,20170208,20555,20280,20645,21000,20600,20770,20845,490,565,56,"1,167.51",228
,20170209,20770,20845,20750,20900,20600,20680,20700,-165,-145,78,"1,614.97",298
,20170210,20680,20700,20680,21300,20475,21175,21005,475,305,196,"4,117.69",304
,20170213,21175,21005,21340,22095,21280,22095,21570,1090,565,70,"1,510.05",280
,20170214,22095,21570,21940,22065,21840,22065,21945,495,375,8,175.59,282
,20170215,22065,21945,22000,22275,21570,21690,21870,-255,-75,68,"1,487.48",288
,20170216,21690,21870,21525,21840,20450,20450,21365,-1420,-505,68,"1,452.87",294
,20170217,20450,21365,20635,20635,20365,20365,20490,-1000,-875,30,614.71,308
,20170220,20365,20490,20495,20495,19895,20320,20160,-170,-330,88,"1,774.46",322
,20170221,20320,20160,20440,20775,20000,20130,20310,-30,150,156,"3,168.91",318
,20170222,20130,20310,20135,20175,19635,20160,20005,-150,-305,142,"2,841.09",302
,20170223,20160,20005,20080,20080,18745,18750,19150,-1255,-855,88,"1,685.55",340
,20170224,18750,19150,18800,18850,18635,18760,18715,-390,-435,70,"1,310.14",338
,20170227,18760,18715,18955,19055,18715,18715,18900,0,185,114,"2,155.13",338
,20170228,18715,18900,18750,18815,18365,18525,18620,-375,-280,68,"1,266.49",330
,20170301,18525,18620,18605,19000,18605,18735,18770,115,150,70,"1,314.23",312
,20170302,18735,18770,18830,18960,18730,18925,18810,155,40,76,"1,429.62",310
,20170303,18925,18810,18995,19110,18630,19110,18880,300,70,14,264.35,310
,20170306,19110,18880,19235,19235,18765,18765,19065,-115,185,24,457.63,318
,20170307,18765,19065,18660,18780,18565,18565,18665,-500,-400,6,112.01,320
,20170308,18565,18665,18375,18375,17785,17885,17990,-780,-675,10,179.92,316
,20170309,17885,17990,17825,17845,17615,17735,17760,-255,-230,48,852.63,308
,20170310,17735,17760,17920,17980,17445,17755,17765,-5,5,26,461.97,312
,20170313,17755,17765,17875,17970,17295,17970,17450,205,-315,688,"12,006.21",326
,20170314,17970,17450,17870,17995,17540,17620,17820,170,370,40,712.91,318
,20170315,17620,17820,17560,17935,17345,17850,17730,30,-90,74,"1,312.02",314
,20170316,17850,17730,17905,18100,17635,17635,17930,-95,200,24,430.36,314
,20170317,17635,17930,18075,18315,17930,18315,18165,385,235,28,508.71,306
,20170320,18315,18165,18385,18385,18250,18350,18330,185,165,44,806.62,298
,20170321,18350,18330,17995,17995,17590,17590,17800,-740,-530,26,462.82,298
,20170322,17590,17800,17550,17625,16750,16750,17170,-1050,-630,50,858.51,294
,20170323,16750,17170,16730,16855,16550,16770,16725,-400,-445,52,869.73,320
,20170324,16770,16725,16780,16830,16545,16545,16710,-180,-15,34,568.27,320
,20170327,16545,16710,16580,16580,15625,15750,15830,-960,-880,54,855.06,324
,20170328,15750,15830,15700,16080,15695,15940,15875,110,45,20,317.50,322
,20170329,15940,15875,16240,16280,16205,16230,16245,355,370,20,324.97,332
,20170330,16230,16245,16200,16200,15830,15930,15940,-315,-305,20,318.82,324
,20170331,15930,15940,16070,16070,15975,16030,16025,90,85,20,320.57,314
,20170405,16030,16025,16300,16705,16300,16580,16475,555,450,54,889.74,304
,20170406,16580,16475,16685,16685,16330,16420,16480,-55,5,24,395.58,300
,20170407,16420,16480,15775,15850,15530,15740,15630,-740,-850,96,"1,500.61",256
,20170410,15740,15630,15205,15205,15115,15125,15135,-505,-495,14,211.90,244
,20170411,15125,15135,15120,15225,15100,15165,15125,30,-10,20,302.51,234
,20170412,15165,15125,15165,15165,14425,14475,14720,-650,-405,20,294.46,238
,20170413,14475,14720,13870,14810,13870,14595,14485,-125,-235,68,985.24,256
,20170414,14595,14485,14640,14700,14345,14485,14575,0,90,86,"1,253.49",254
,20170417,14485,14575,14625,14745,14565,14705,14655,130,80,14,205.20,254
,20170418,14705,14655,14420,14420,14180,14180,14270,-475,-385,22,314.03,248
,20170419,14180,14270,14090,14140,13845,13845,14000,-425,-270,8,112.01,248
,20170420,13845,14000,14025,14320,13935,14320,14035,320,35,32,449.17,248
,20170421,14320,14035,14455,14595,14315,14315,14450,280,415,30,433.63,248
,20170424,14315,14450,14410,14410,14100,14100,14250,-350,-200,10,142.50,244
,20170425,14100,14250,14355,14530,14355,14530,14465,280,215,6,86.81,244
,20170426,14530,14465,14350,14350,14350,14350,14350,-115,-115,2,28.70,244
,20170427,14350,14350,14100,14350,14100,14175,14185,-175,-165,26,368.82,248
,20170428,14175,14185,14200,14480,14200,14375,14405,190,220,40,576.37,262
,20170502,14375,14405,14720,14865,14720,14790,14790,385,385,10,147.92,262
,20170503,14790,14790,14700,14700,14645,14645,14660,-145,-130,6,87.98,262
,20170504,14645,14660,14440,14440,13710,13710,13960,-950,-700,12,167.52,262
,20170505,13710,13960,13590,13590,13345,13350,13430,-610,-530,12,161.18,264
,20170508,13350,13430,13360,13415,13065,13245,13275,-185,-155,22,292.14,264
,20170509,13245,13275,13015,13240,13015,13240,13165,-35,-110,6,78.99,262
,20170510,13240,13165,13245,13310,12900,12900,13065,-265,-100,102,"1,332.65",260
,20170511,12900,13065,13140,13305,13120,13305,13210,240,145,12,158.54,256
,20170512,13305,13210,13245,13260,13100,13190,13150,-20,-60,100,"1,315.35",286
,20170515,13190,13150,13405,13405,13350,13350,13355,200,205,14,187.01,274
,20170516,13350,13355,13455,13615,13455,13615,13525,260,170,22,297.58,272
,20170517,13615,13525,13630,13630,13595,13595,13610,70,85,4,54.45,268
,20170518,13595,13610,13595,13595,13130,13130,13395,-480,-215,10,133.98,268
,20170519,13130,13395,13405,13520,13405,13520,13460,125,65,4,53.85,266
,20170522,13520,13460,13790,13950,13505,13520,13765,60,305,68,936.10,276
,20170523,13520,13765,13590,14000,13480,13655,13775,-110,10,32,440.92,274
,20170524,13655,13775,13625,13625,13260,13365,13380,-410,-395,10,133.83,272
,20170525,13365,13380,13360,13470,13350,13470,13360,90,-20,30,400.90,272
,20170526,13470,13360,12960,13195,12960,13100,13105,-260,-255,28,366.99,260
,20170531,13100,13105,13000,13000,12300,12300,12640,-805,-465,226,"2,857.40",298
,20170601,12300,12640,12155,12155,12150,12150,12150,-490,-490,24,291.62,318
,20170602,12150,12150,12300,12300,12235,12235,12275,85,125,32,392.82,316
,20170605,12235,12275,12240,12240,12225,12235,12235,-40,-40,26,318.11,340
,20170606,12235,12235,12130,12300,12130,12200,12180,-35,-55,12,146.18,340
,20170607,12200,12180,12440,12440,11985,12100,12130,-80,-50,106,"1,285.90",284
,20170608,12100,12130,12200,12200,12200,12200,12200,70,70,20,244.00,266
,20170609,12200,12200,,,,12200,12200,0,0,0,0.00,266
,20170612,12200,12200,12495,12495,12395,12395,12445,195,245,4,49.78,264
,20170613,12395,12445,12425,12450,12425,12450,12445,5,0,14,174.25,252
,20170614,12450,12445,12200,12670,12200,12670,12290,225,-155,18,221.24,250
,20170615,12670,12290,,,,12290,12290,0,0,0,0.00,250
ru1707,20170103,18260,18260,18650,18650,18405,18405,18465,145,205,8,147.73,106
,20170104,18405,18465,,,,18465,18465,0,0,0,0.00,106
,20170105,18465,18465,,,,18465,18465,0,0,0,0.00,106
,20170106,18465,18465,18160,18160,17960,17960,18060,-505,-405,4,72.24,106
,20170109,17960,18060,18720,19160,18720,19160,18940,1100,880,4,75.76,106
,20170110,19160,18940,19045,19360,18940,19210,19110,270,170,46,879.13,102
,20170111,19210,19110,19390,19390,19285,19285,19305,175,195,10,193.06,100
,20170112,19285,19305,,,,20320,20320,1015,1015,0,0.00,100
,20170113,20320,20320,20270,20450,20270,20445,20390,125,70,8,163.13,98
,20170116,20445,20390,,,,20545,20545,155,155,0,0.00,98
,20170117,20545,20545,21045,21045,20960,21040,21015,495,470,6,126.09,98
,20170118,21040,21015,21440,21440,21440,21440,21440,425,425,2,42.88,98
,20170119,21440,21440,21420,21420,21125,21275,21295,-165,-145,14,298.13,96
,20170120,21275,21295,21035,21035,20100,20100,20530,-1195,-765,12,246.41,98
,20170123,20100,20530,19920,20080,19855,19855,19955,-675,-575,20,399.15,110
,20170124,19855,19955,20025,20150,19605,20150,19895,195,-60,24,477.54,96
,20170125,20150,19895,20400,20400,19955,20050,20130,155,235,20,402.67,92
,20170126,20050,20130,20925,21440,20925,21440,21195,1310,1065,18,381.58,90
,20170203,21440,21195,20970,20970,20120,20120,20450,-1075,-745,14,286.33,82
,20170206,20120,20450,20360,20360,20260,20260,20310,-190,-140,4,81.24,82
,20170207,20260,20310,20150,20425,20135,20425,20235,115,-75,6,121.42,84
,20170208,20425,20235,20665,20940,20590,20730,20705,495,470,10,207.07,78
,20170209,20730,20705,20765,20785,20565,20700,20755,-5,50,28,581.23,100
,20170210,20700,20755,20645,20830,20615,20830,20670,75,-85,18,372.07,102
,20170213,20830,20670,,,,21225,21225,555,555,0,0.00,102
,20170214,21225,21225,22180,22180,22180,22180,22180,955,955,2,44.36,102
,20170215,22180,22180,21845,21950,21705,21885,21825,-295,-355,12,261.91,100
,20170216,21885,21825,21505,21505,20465,20465,20905,-1360,-920,16,334.55,104
,20170217,20465,20905,20555,20690,20270,20350,20475,-555,-430,66,"1,351.45",114
,20170220,20350,20475,20530,20530,19945,19945,20355,-530,-120,46,936.37,112
,20170221,19945,20355,20545,20770,20200,20200,20540,-155,185,16,328.64,110
,20170222,20200,20540,20065,20180,19980,20180,20055,-360,-485,8,160.45,108
,20170223,20180,20055,20140,20140,18765,18765,19360,-1290,-695,12,232.32,112
,20170224,18765,19360,18975,18975,18760,18760,18900,-600,-460,24,453.69,112
,20170227,18760,18900,18850,18850,18850,18850,18850,-50,-50,2,37.70,112
,20170228,18850,18850,18875,18875,18520,18710,18670,-140,-180,22,410.74,110
,20170301,18710,18670,18905,19000,18865,18870,18905,200,235,20,378.16,104
,20170302,18870,18905,19025,19025,18970,19020,19005,115,100,16,304.13,98
,20170303,19020,19005,19060,19110,19060,19110,19075,105,70,6,114.46,98
,20170306,19110,19075,19335,19335,18960,18960,19185,-115,110,28,537.27,94
,20170307,18960,19185,18845,18845,18845,18845,18845,-340,-340,2,37.69,92
,20170308,18845,18845,18525,18525,17960,18000,18240,-845,-605,22,401.29,96
,20170309,18000,18240,18000,18000,17800,17800,17900,-440,-340,6,107.40,96
,20170310,17800,17900,18020,18020,17825,18000,17885,100,-15,18,321.94,108
,20170313,18000,17885,17725,18090,17455,18055,17815,170,-70,20,356.39,102
,20170314,18055,17815,,,,17815,17815,0,0,0,0.00,102
,20170315,17815,17815,17655,18005,17600,17930,17795,115,-20,8,142.38,100
,20170316,17930,17795,18155,18315,18155,18210,18245,415,450,12,218.97,102
,20170317,18210,18245,18140,18500,18065,18500,18165,255,-80,18,327.03,102
,20170320,18500,18165,18365,18365,18100,18100,18230,-65,65,8,145.85,98
,20170321,18100,18230,18155,18220,17965,17965,18035,-265,-195,14,252.49,94
,20170322,17965,18035,17770,17805,16950,17005,17270,-1030,-765,24,414.51,98
,20170323,17005,17270,16910,16985,16685,16985,16860,-285,-410,6,101.16,98
,20170324,16985,16860,16635,16635,16625,16625,16630,-235,-230,4,66.52,98
,20170327,16625,16630,16045,16045,15820,15890,15885,-740,-745,30,476.67,94
,20170328,15890,15885,15910,16035,15880,15955,15935,70,50,10,159.39,96
,20170329,15955,15935,16145,16450,16100,16450,16230,515,295,10,162.30,94
,20170330,16450,16230,16155,16155,16055,16055,16120,-175,-110,6,96.73,94
,20170331,16055,16120,16120,16190,16120,16190,16155,70,35,4,64.62,98
,20170405,16190,16155,16190,16550,16190,16550,16435,395,280,10,164.36,96
,20170406,16550,16435,16700,16710,16700,16710,16705,275,270,4,66.82,92
,20170407,16710,16705,15915,15920,15535,15535,15715,-1170,-990,82,"1,288.95",98
,20170410,15535,15715,15475,15505,15215,15275,15450,-440,-265,68,"1,050.66",130
,20170411,15275,15450,15055,15320,15020,15260,15175,-190,-275,36,546.36,126
,20170412,15260,15175,14850,14850,14500,14500,14655,-675,-520,12,175.87,128
,20170413,14500,14655,,,,14720,14720,65,65,0,0.00,128
,20170414,14720,14720,14850,14850,14675,14675,14780,-45,60,20,295.60,132
,20170417,14675,14780,14720,14720,14610,14675,14660,-105,-120,12,175.93,128
,20170418,14675,14660,14755,14755,14325,14325,14650,-335,-10,14,205.12,122
,20170419,14325,14650,14215,14215,13920,14060,14045,-590,-605,60,842.70,108
,20170420,14060,14045,14170,14195,14090,14195,14160,150,115,8,113.30,104
,20170421,14195,14160,14620,14645,14460,14490,14550,330,390,8,116.43,100
,20170424,14490,14550,14310,14310,14310,14310,14310,-240,-240,2,28.62,100
,20170425,14310,14310,14485,14580,14485,14580,14515,270,205,6,87.10,98
,20170426,14580,14515,14240,14550,14240,14550,14355,35,-160,16,229.75,98
,20170427,14550,14355,14235,14380,14235,14380,14305,25,-50,8,114.45,98
,20170428,14380,14305,14255,14620,14255,14620,14465,315,160,10,144.67,98
,20170502,14620,14465,14710,14955,14710,14955,14780,490,315,10,147.81,98
,20170503,14955,14780,,,,14785,14785,5,5,0,0.00,98
,20170504,14785,14785,14160,14160,14000,14000,14050,-785,-735,10,140.51,90
,20170505,14000,14050,13575,13575,13435,13435,13450,-615,-600,54,726.40,116
,20170508,13435,13450,13500,13500,13500,13500,13500,50,50,4,54.00,112
,20170509,13500,13500,,,,13425,13425,-75,-75,0,0.00,112
,20170510,13425,13425,13445,13590,13445,13590,13515,165,90,18,243.27,116
,20170511,13590,13515,,,,13515,13515,0,0,0,0.00,116
,20170512,13515,13515,13360,13360,13295,13295,13350,-220,-165,16,213.63,104
,20170515,13295,13350,13385,13560,13385,13560,13500,210,150,28,378.08,110
,20170516,13560,13500,14445,14445,13355,13475,13720,-25,220,8,109.77,110
,20170517,13475,13720,13990,13990,13570,13570,13720,-150,0,46,631.27,120
,20170518,13570,13720,13530,13575,13220,13285,13360,-435,-360,12,160.36,114
,20170519,13285,13360,13250,13665,13130,13575,13505,215,145,42,567.28,118
,20170522,13575,13505,13840,13900,13585,13585,13745,80,240,16,219.93,112
,20170523,13585,13745,13685,14025,13685,14025,13770,280,25,12,165.27,112
,20170524,14025,13770,13460,13470,13440,13470,13455,-300,-315,6,80.74,112
,20170525,13470,13455,13565,13590,13565,13590,13575,135,120,4,54.31,112
,20170526,13590,13575,13300,13300,13250,13250,13275,-325,-300,6,79.66,112
,20170531,13250,13275,13310,13310,13175,13175,13240,-100,-35,4,52.97,112
,20170601,13175,13240,12365,12390,12310,12340,12325,-900,-915,34,419.17,120
,20170602,12340,12325,12390,12390,12350,12350,12370,25,45,4,49.48,118
,20170605,12350,12370,12185,12410,12185,12395,12340,25,-30,8,98.75,118
,20170606,12395,12340,12305,12370,12305,12370,12335,30,-5,4,49.35,116
,20170607,12370,12335,12325,12350,12280,12350,12315,15,-20,6,73.91,118
,20170608,12350,12315,12350,12350,12125,12315,12260,0,-55,6,73.58,116
,20170609,12315,12260,12260,12260,12260,12260,12260,0,0,2,24.52,116
,20170612,12260,12260,12365,12570,12365,12570,12515,310,255,8,100.13,124
,20170613,12570,12515,12365,12365,12365,12365,12365,-150,-150,6,74.19,118
,20170614,12365,12365,12450,12750,12450,12700,12630,335,265,6,75.80,116
,20170615,12700,12630,12795,12795,12695,12695,12755,65,125,6,76.55,116
,20170616,12695,12755,12890,12890,12890,12890,12890,135,135,2,25.78,114
,20170619,12890,12890,12820,12820,12560,12560,12660,-330,-230,8,101.29,112
,20170620,12560,12660,12575,12575,12280,12505,12470,-155,-190,10,124.72,116
,20170621,12505,12470,,,,12440,12440,-30,-30,0,0.00,116
,20170622,12440,12440,12630,12630,12200,12200,12400,-240,-40,8,99.22,114
,20170623,12200,12400,12330,12540,12330,12540,12460,140,60,14,174.49,110
,20170626,12540,12460,12510,12805,12510,12535,12635,75,175,18,227.44,106
,20170627,12535,12635,12515,12725,12390,12540,12570,-95,-65,10,125.70,106
,20170628,12540,12570,12840,12940,12840,12940,12920,370,350,10,129.20,100
,20170629,12940,12920,12925,13590,12925,13590,13145,670,225,14,184.08,94
,20170630,13590,13145,13180,13180,13100,13105,13140,-40,-5,8,105.13,90
,20170703,13105,13140,13150,13510,13150,13275,13295,135,155,8,106.39,90
,20170704,13275,13295,12520,12660,12520,12660,12540,-635,-755,32,401.36,114
,20170705,12660,12540,12725,12725,12430,12720,12675,180,135,42,532.50,112
,20170706,12720,12675,12470,12610,12470,12480,12490,-195,-185,26,324.82,86
,20170707,12480,12490,,,,12490,12490,0,0,0,0.00,86
,20170710,12490,12490,12640,12740,12460,12670,12570,180,80,16,201.14,92
,20170711,12670,12570,12945,12945,12435,12565,12540,-5,-30,52,652.20,86
,20170712,12565,12540,13405,13405,12705,12705,13015,165,475,16,208.26,86
,20170713,12705,13015,12910,12910,12910,12910,12910,-105,-105,16,206.56,86
,20170714,12910,12910,,,,12910,12910,0,0,0,0.00,86
,20170717,12910,12910,,,,12910,12910,0,0,0,0.00,86
ru1708,20170103,18555,18385,18935,18950,18935,18950,18935,565,550,8,151.51,60
,20170104,18950,18935,18315,18345,18315,18345,18325,-590,-610,10,183.27,62
,20170105,18345,18325,18930,18930,18660,18660,18750,335,425,6,112.50,62
,20170106,18660,18750,,,,18335,18335,-415,-415,0,0.00,62
,20170109,18335,18335,,,,19070,19070,735,735,0,0.00,62
,20170110,19070,19070,19200,19440,19200,19390,19250,320,180,36,693.07,76
,20170111,19390,19250,19485,19485,19485,19485,19485,235,235,2,38.97,74
,20170112,19485,19485,,,,20360,20360,875,875,0,0.00,74
,20170113,20360,20360,20485,20485,20485,20485,20485,125,125,2,40.97,72
,20170116,20485,20485,,,,21545,21545,1060,1060,0,0.00,72
,20170117,21545,21545,21410,21410,21410,21410,21410,-135,-135,2,42.82,70
,20170118,21410,21410,21410,21475,21410,21475,21440,65,30,4,85.77,70
,20170119,21475,21440,21420,21440,21275,21325,21365,-115,-75,8,170.92,70
,20170120,21325,21365,21090,21100,19970,19970,20800,-1395,-565,68,"1,414.56",72
,20170123,19970,20800,20085,20120,19945,20120,20050,-680,-750,6,120.30,70
,20170124,20120,20050,,,,20055,20055,5,5,0,0.00,70
,20170125,20055,20055,20320,20370,20195,20195,20310,140,255,8,162.51,64
,20170126,20195,20310,21235,21500,21235,21500,21355,1190,1045,20,427.14,64
,20170203,21500,21355,21090,21090,21090,21090,21090,-265,-265,4,84.36,68
,20170206,21090,21090,20225,20235,20225,20235,20230,-855,-860,4,80.92,68
,20170207,20235,20230,,,,20595,20595,365,365,0,0.00,68
,20170208,20595,20595,,,,20625,20625,30,30,0,0.00,68
,20170209,20625,20625,,,,20625,20625,0,0,0,0.00,68
,20170210,20625,20625,,,,20970,20970,345,345,0,0.00,68
,20170213,20970,20970,,,,21910,21910,940,940,0,0.00,68
,20170214,21910,21910,,,,21995,21995,85,85,0,0.00,68
,20170215,21995,21995,21905,21960,21785,21960,21900,-35,-95,8,175.22,64
,20170216,21960,21900,21535,21710,20925,20990,21300,-910,-600,12,255.61,60
,20170217,20990,21300,20540,20655,20540,20615,20615,-685,-685,8,164.93,54
,20170220,20615,20615,,,,20615,20615,0,0,0,0.00,54
,20170221,20615,20615,20880,20880,20265,20365,20410,-250,-205,24,489.94,62
,20170222,20365,20410,20150,20350,20130,20350,20195,-60,-215,8,161.56,60
,20170223,20350,20195,19120,19120,19120,19120,19120,-1075,-1075,4,76.48,60
,20170224,19120,19120,19170,19170,18840,18995,18945,-125,-175,36,682.15,56
,20170227,18995,18945,19185,19185,19120,19120,19145,175,200,6,114.88,58
,20170228,19120,19145,18840,18840,18840,18840,18840,-305,-305,20,376.80,68
,20170301,18840,18840,18845,19110,18845,19110,18925,270,85,12,227.13,62
,20170302,19110,18925,19055,19055,19055,19055,19055,130,130,2,38.11,60
,20170303,19055,19055,,,,19280,19280,225,225,0,0.00,60
,20170306,19280,19280,,,,19260,19260,-20,-20,0,0.00,60
,20170307,19260,19260,,,,19165,19165,-95,-95,0,0.00,60
,20170308,19165,19165,18625,18625,17930,18145,18210,-1020,-955,16,291.40,64
,20170309,18145,18210,18110,18110,18035,18105,18090,-105,-120,8,144.72,66
,20170310,18105,18090,,,,18055,18055,-35,-35,0,0.00,66
,20170313,18055,18055,18020,18020,17965,18020,17990,-35,-65,8,143.94,68
,20170314,18020,17990,,,,17990,17990,0,0,0,0.00,68
,20170315,17990,17990,18105,18125,17990,18125,18070,135,80,6,108.44,66
,20170316,18125,18070,,,,18070,18070,0,0,0,0.00,66
,20170317,18070,18070,18335,18460,18335,18435,18410,365,340,12,220.96,74
,20170320,18435,18410,18640,18640,18170,18170,18465,-240,55,18,332.43,66
,20170321,18170,18465,18025,18025,18025,18025,18025,-440,-440,2,36.05,68
,20170322,18025,18025,17080,17080,16940,16940,17050,-1085,-975,10,170.52,62
,20170323,16940,17050,17065,17120,17035,17120,17080,70,30,8,136.66,66
,20170324,17120,17080,17030,17125,16900,16910,16950,-170,-130,34,576.43,72
,20170327,16910,16950,16785,16785,15865,15995,16100,-955,-850,24,386.51,72
,20170328,15995,16100,16140,16290,16075,16075,16180,-25,80,8,129.45,74
,20170329,16075,16180,16280,16505,16280,16505,16425,325,245,6,98.57,72
,20170330,16505,16425,,,,16235,16235,-190,-190,0,0.00,72
,20170331,16235,16235,16265,16380,15095,16255,15950,20,-285,74,"1,180.57",90
,20170405,16255,15950,16530,17040,16015,16840,16440,890,490,476,"7,825.49",452
,20170406,16840,16440,16790,16835,16560,16560,16640,120,200,210,"3,494.55",274
,20170407,16560,16640,16040,16080,15675,15675,15805,-965,-835,274,"4,331.46",68
,20170410,15675,15805,15675,15675,15360,15560,15565,-245,-240,32,498.09,60
,20170411,15560,15565,15410,15450,15410,15450,15435,-115,-130,6,92.62,56
,20170412,15450,15435,15280,15280,14740,14790,14950,-645,-485,46,687.83,52
,20170413,14790,14950,,,,14935,14935,-15,-15,0,0.00,52
,20170414,14935,14935,14670,14750,14610,14610,14680,-325,-255,10,146.80,52
,20170417,14610,14680,15060,15065,14700,14700,14915,20,235,182,"2,714.59",78
,20170418,14700,14915,14865,14865,14550,14550,14770,-365,-145,8,118.16,70
,20170419,14550,14770,14120,14130,14120,14130,14120,-640,-650,6,84.74,72
,20170420,14130,14120,14215,14215,14215,14215,14215,95,95,4,56.86,68
,20170421,14215,14215,,,,14650,14650,435,435,0,0.00,68
,20170424,14650,14650,14650,14670,14470,14470,14565,-180,-85,72,"1,048.92",64
,20170425,14470,14565,14720,14845,14520,14520,14640,-45,75,24,351.40,62
,20170426,14520,14640,14810,14810,14715,14715,14760,75,120,4,59.05,62
,20170427,14715,14760,14515,14515,14400,14400,14455,-360,-305,12,173.49,60
,20170428,14400,14455,14520,14800,14510,14790,14525,335,70,140,"2,034.00",60
,20170502,14790,14525,15160,15160,15160,15160,15160,635,635,2,30.32,62
,20170503,15160,15160,15030,15130,15020,15020,15060,-140,-100,24,361.49,64
,20170504,15020,15060,14280,16110,14005,14005,14590,-1055,-470,28,408.57,64
,20170505,14005,14590,14005,14005,13565,13565,13710,-1025,-880,82,"1,124.39",82
,20170508,13565,13710,13605,13785,13605,13690,13705,-20,-5,38,520.82,74
,20170509,13690,13705,13530,13620,13410,13620,13520,-85,-185,6,81.12,70
,20170510,13620,13520,13630,13630,13210,13260,13365,-260,-155,10,133.69,70
,20170511,13260,13365,13275,13285,13210,13285,13255,-80,-110,6,79.54,68
,20170512,13285,13255,13400,13450,13400,13450,13420,195,165,12,161.07,64
,20170515,13450,13420,13390,13550,13390,13490,13465,70,45,84,"1,131.29",68
,20170516,13490,13465,13505,13610,13505,13610,13555,145,90,4,54.23,64
,20170517,13610,13555,13690,13690,13690,13690,13690,135,135,2,27.38,64
,20170518,13690,13690,13505,13505,13505,13505,13505,-185,-185,2,27.01,62
,20170519,13505,13505,13630,13695,13615,13670,13650,165,145,12,163.83,58
,20170522,13670,13650,13765,14000,13690,13700,13830,50,180,30,414.92,52
,20170523,13700,13830,13780,14175,13780,13850,13890,20,60,20,277.87,48
,20170524,13850,13890,13945,14225,13560,13670,14030,-220,140,232,"3,256.10",48
,20170525,13670,14030,13575,13815,13575,13815,13675,-215,-355,8,109.43,52
,20170526,13815,13675,13645,13645,13335,13335,13445,-340,-230,24,322.78,50
,20170531,13335,13445,14200,14200,12405,12405,12980,-1040,-465,136,"1,765.65",74
,20170601,12405,12980,12460,12485,12290,12465,12410,-515,-570,32,397.14,74
,20170602,12465,12410,12400,12410,12355,12410,12380,0,-30,62,767.75,72
,20170605,12410,12380,12215,12470,12215,12455,12265,75,-115,46,564.29,70
,20170606,12455,12265,12310,12505,12305,12500,12405,235,140,26,322.64,64
,20170607,12500,12405,11550,12450,11550,12400,12270,-5,-135,16,196.36,60
,20170608,12400,12270,12500,12500,12195,12320,12355,50,85,16,197.73,58
,20170609,12320,12355,12335,12440,12335,12440,12380,85,25,394,"4,877.84",94
,20170612,12440,12380,12570,12670,12565,12670,12585,290,205,50,629.44,82
,20170613,12670,12585,12650,12650,12550,12550,12575,-35,-10,52,654.01,82
,20170614,12550,12575,12685,12800,12685,12750,12745,175,170,6,76.47,80
,20170615,12750,12745,12845,12845,12700,12700,12730,-45,-15,18,229.15,78
,20170616,12700,12730,13010,13010,12960,13010,12985,280,255,10,129.88,76
,20170619,13010,12985,12995,12995,12555,12675,12810,-310,-175,56,717.44,94
,20170620,12675,12810,12650,12680,12375,12600,12585,-210,-225,42,528.75,118
,20170621,12600,12585,12470,12560,12415,12415,12445,-170,-140,82,"1,020.80",132
,20170622,12415,12445,12660,12755,12520,12520,12660,75,215,48,607.73,98
,20170623,12520,12660,12390,12610,12390,12610,12510,-50,-150,10,125.12,104
,20170626,12610,12510,12680,12680,12500,12580,12625,70,115,68,858.68,94
,20170627,12580,12625,12740,12745,12660,12695,12695,70,70,20,253.97,96
,20170628,12695,12695,13090,13090,12875,12925,13025,230,330,46,599.27,64
,20170629,12925,13025,12970,13565,12910,13490,13215,465,190,90,"1,189.76",70
,20170630,13490,13215,13205,13260,13205,13260,13240,45,25,6,79.45,70
,20170703,13260,13240,13460,13460,13460,13460,13460,220,220,2,26.92,68
,20170704,13460,13460,13385,13450,12650,12650,13060,-810,-400,14,182.86,70
,20170705,12650,13060,12845,13940,12725,12780,12865,-280,-195,44,566.18,68
,20170706,12780,12865,12670,12845,12670,12845,12760,-20,-105,62,791.39,88
,20170707,12845,12760,13015,13015,12650,12760,12795,0,35,30,383.94,74
,20170710,12760,12795,12760,12760,12645,12645,12705,-150,-90,28,355.79,78
,20170711,12645,12705,12770,12770,12765,12765,12765,60,60,4,51.07,76
,20170712,12765,12765,12765,13645,12765,13105,13280,340,515,22,292.16,80
,20170713,13105,13280,13105,13105,13060,13060,13080,-220,-200,4,52.33,78
,20170714,13060,13080,13210,13210,12970,12970,13030,-110,-50,8,104.25,76
,20170717,12970,13030,13290,13475,13270,13345,13365,315,335,94,"1,256.68",64
,20170718,13345,13365,13520,13520,13200,13200,13305,-165,-60,6,79.84,60
,20170719,13200,13305,13215,13855,13215,13855,13560,550,255,20,271.23,62
,20170720,13855,13560,13645,14060,13630,14010,13825,450,265,58,802.05,54
,20170721,14010,13825,13700,13880,13545,13850,13695,25,-130,42,575.22,56
,20170724,13850,13695,13720,13860,13430,13430,13650,-265,-45,8,109.23,56
,20170725,13430,13650,13450,13645,13265,13545,13430,-105,-220,22,295.48,54
,20170726,13545,13430,13910,13910,13355,13355,13645,-75,215,14,191.06,54
,20170727,13355,13645,13155,13400,13155,13400,13290,-245,-355,22,292.38,54
,20170728,13400,13290,12760,12760,12440,12440,12570,-850,-720,6,75.44,54
,20170731,12440,12570,12520,12520,12360,12360,12440,-210,-130,8,99.52,54
,20170801,12360,12440,12545,12545,12545,12545,12545,105,105,4,50.18,58
,20170802,12545,12545,,,,12545,12545,0,0,0,0.00,58
,20170803,12545,12545,12405,12405,12405,12405,12405,-140,-140,2,24.81,58
,20170804,12405,12405,12365,12545,12365,12545,12485,140,80,6,74.91,52
,20170807,12545,12485,,,,12485,12485,0,0,0,0.00,52
,20170808,12485,12485,12465,12465,12465,12465,12465,-20,-20,4,49.86,52
,20170809,12465,12465,13335,13335,13335,13335,13335,870,870,2,26.67,52
,20170810,13335,13335,12780,12780,12780,12780,12780,-555,-555,4,51.12,48
,20170811,12780,12780,13670,13670,13670,13670,13670,890,890,2,27.34,48
,20170814,13670,13670,12710,12710,12710,12710,12710,-960,-960,2,25.42,46
,20170815,12710,12710,,,,12710,12710,0,0,0,0.00,46
ru1709,20170103,18705,18545,18775,19210,18620,18685,18975,140,430,42074,"798,456.00",55882
,20170104,18685,18975,18755,18970,18195,18860,18600,-115,-375,65126,"1,211,409.86",56062
,20170105,18860,18600,18810,18895,18420,18440,18660,-160,60,50658,"945,468.93",56068
,20170106,18440,18660,18490,18600,18180,18230,18380,-430,-280,46908,"862,171.68",55744
,20170109,18230,18380,18200,19300,18185,19280,18785,900,405,61334,"1,152,456.48",61140
,20170110,19280,18785,19280,19585,19155,19505,19325,720,540,64146,"1,239,889.24",63656
,20170111,19505,19325,19600,19910,19415,19865,19645,540,320,56716,"1,114,312.60",63370
,20170112,19865,19645,19805,20740,19780,20575,20360,930,715,80796,"1,645,255.57",64266
,20170113,20575,20360,20420,20855,20400,20600,20645,240,285,66630,"1,375,827.33",65470
,20170116,20600,20645,20550,21960,20500,21775,21450,1130,805,89160,"1,912,834.82",64504
,20170117,21775,21450,21705,21970,21080,21490,21565,40,115,76514,"1,650,148.71",66650
,20170118,21490,21565,21555,21830,21155,21505,21490,-60,-75,69784,"1,499,658.29",66288
,20170119,21505,21490,21490,21595,21130,21275,21400,-215,-90,69080,"1,478,331.93",66910
,20170120,21275,21400,21240,21295,19900,19900,20500,-1500,-900,118436,"2,428,422.32",64774
,20170123,19900,20500,19915,20185,19785,19850,19990,-650,-510,54010,"1,079,821.99",66890
,20170124,19850,19990,19870,20325,19580,20195,20025,205,35,56738,"1,136,451.06",66672
,20170125,20195,20025,20275,20425,19980,20245,20225,220,200,38222,"773,066.12",65388
,20170126,20245,20225,20390,21550,20335,21535,21125,1310,900,66814,"1,411,560.71",70166
,20170203,21535,21125,21500,21500,20180,20365,20610,-760,-515,60674,"1,250,760.82",69106
,20170206,20365,20610,20380,20515,20130,20300,20345,-310,-265,59414,"1,208,919.94",69532
,20170207,20300,20345,20370,20810,20130,20795,20435,450,90,79952,"1,633,928.87",75214
,20170208,20795,20435,20795,21095,20565,20850,20800,415,365,87110,"1,812,079.48",76858
,20170209,20850,20800,20815,21015,20580,20740,20825,-60,25,77800,"1,620,573.48",77956
,20170210,20740,20825,20655,21425,20530,21080,20970,255,145,101952,"2,138,439.65",79684
,20170213,21080,20970,21130,22240,21130,22160,21830,1190,860,113780,"2,484,190.38",82484
,20170214,22160,21830,22115,22240,21735,22185,22020,355,190,80706,"1,777,197.36",82854
,20170215,22185,22020,22100,22450,21600,21725,21895,-295,-125,111382,"2,438,934.59",82836
,20170216,21725,21895,21675,21980,20480,20600,21425,-1295,-470,142924,"3,062,793.26",82356
,20170217,20600,21425,20620,20915,20285,20655,20640,-770,-785,112194,"2,316,078.97",80570
,20170220,20655,20640,20695,20780,20005,20580,20460,-60,-180,120186,"2,459,010.94",80056
,20170221,20580,20460,20655,20965,20230,20410,20630,-50,170,127908,"2,638,919.71",86132
,20170222,20410,20630,20290,20430,20010,20325,20245,-305,-385,120362,"2,436,878.34",85722
,20170223,20325,20245,20245,20400,18940,19050,19685,-1195,-560,164914,"3,246,793.03",83238
,20170224,19050,19685,19200,19225,18735,19170,19045,-515,-640,100454,"1,913,194.41",82450
,20170227,19170,19045,19220,19390,18965,19165,19200,120,155,126076,"2,421,199.22",82160
,20170228,19165,19200,19140,19195,18570,18870,18915,-330,-285,163042,"3,084,037.91",84546
,20170301,18870,18915,18880,19370,18880,19115,19065,200,150,127000,"2,421,740.60",86434
,20170302,19115,19065,19120,19310,18925,19235,19150,170,85,123556,"2,366,330.52",89968
,20170303,19235,19150,19195,19520,18955,19475,19245,325,95,155680,"2,996,763.14",92576
,20170306,19475,19245,19550,19615,19090,19160,19360,-85,115,149718,"2,898,923.55",94224
,20170307,19160,19360,19095,19155,18900,19060,19055,-300,-305,121896,"2,323,080.37",95774
,20170308,19060,19055,19040,19095,18075,18160,18440,-895,-615,204282,"3,767,543.39",104164
,20170309,18160,18440,18220,18290,17905,17960,18095,-480,-345,149320,"2,702,521.86",106160
,20170310,17960,18095,17965,18280,17785,18085,18095,-10,0,182392,"3,301,160.91",111168
,20170313,18085,18095,18140,18280,17600,18215,17980,120,-115,238924,"4,296,432.92",115932
,20170314,18215,17980,18200,18415,17835,17945,18115,-35,135,235234,"4,262,337.84",123300
,20170315,17945,18115,17880,18340,17665,18180,18070,65,-45,274844,"4,966,908.08",134138
,20170316,18180,18070,18200,18505,17845,18345,18185,275,115,360238,"6,551,738.40",146976
,20170317,18345,18185,18345,18785,18235,18720,18510,535,325,411978,"7,627,397.21",147162
,20170320,18720,18510,18750,18830,18235,18335,18550,-175,40,355178,"6,588,765.23",156638
,20170321,18335,18550,18320,18430,17890,17975,18135,-575,-415,380814,"6,906,081.56",168210
,20170322,17975,18135,17925,18110,16960,17010,17440,-1125,-695,518714,"9,046,827.28",174634
,20170323,17010,17440,16990,17260,16850,17040,17075,-400,-365,347410,"5,932,560.76",180254
,20170324,17040,17075,17080,17230,16785,16865,17010,-210,-65,499410,"8,496,141.35",195756
,20170327,16865,17010,16865,16930,15980,16150,16325,-860,-685,531862,"8,683,474.52",213190
,20170328,16150,16325,16110,16550,16030,16235,16300,-90,-25,492174,"8,023,607.70",218104
,20170329,16235,16300,16310,16750,16265,16615,16495,315,195,536692,"8,853,752.91",227682
,20170330,16615,16495,16590,16670,16130,16300,16405,-195,-90,533044,"8,745,808.14",236764
,20170331,16300,16405,16295,16625,16260,16335,16430,-70,25,556778,"9,148,139.80",226476
,20170405,16335,16430,16450,17220,16370,16970,16870,540,440,538834,"9,091,014.00",238790
,20170406,16970,16870,16970,17045,16670,16815,16860,-55,-10,474720,"8,004,428.26",248128
,20170407,16815,16860,16730,16790,15675,15675,16065,-1185,-795,778364,"12,508,000.16",265622
,20170410,15675,16065,15645,15860,15405,15520,15590,-545,-475,606236,"9,452,575.21",279458
,20170411,15520,15590,15350,15700,15220,15410,15470,-180,-120,636108,"9,841,261.63",286286
,20170412,15410,15470,15380,15515,14660,14770,15000,-700,-470,749924,"11,250,355.05",291256
,20170413,14770,15000,14775,15220,14725,14985,14975,-15,-25,650630,"9,744,621.81",293842
,20170414,14985,14975,14975,15155,14570,14830,14860,-145,-115,693770,"10,311,286.17",298666
,20170417,14830,14860,14800,15235,14760,14905,14950,45,90,752662,"11,253,454.67",303926
,20170418,14905,14950,14905,15050,14520,14610,14780,-340,-170,664682,"9,826,151.57",313158
,20170419,14610,14780,14455,14550,13950,14385,14330,-395,-450,747390,"10,711,479.64",315490
,20170420,14385,14330,14380,14835,14100,14800,14440,470,110,895504,"12,934,537.70",324378
,20170421,14800,14440,14860,14990,14660,14805,14835,365,395,766570,"11,373,252.79",312124
,20170424,14805,14835,14760,14850,14360,14815,14660,-20,-175,783968,"11,494,118.42",320412
,20170425,14815,14660,14830,15000,14600,14670,14795,10,135,715572,"10,589,131.71",318528
,20170426,14670,14795,14610,14935,14465,14510,14695,-285,-100,823822,"12,109,973.76",315106
,20170427,14510,14695,14550,14630,14380,14610,14520,-85,-175,764790,"11,107,818.24",322398
,20170428,14610,14520,14595,14960,14470,14760,14730,240,210,771302,"11,361,531.38",310258
,20170502,14760,14730,14850,15345,14700,15245,15185,515,455,505904,"7,684,158.68",325246
,20170503,15245,15185,15200,15285,15035,15095,15145,-90,-40,507724,"7,690,469.88",329930
,20170504,15095,15145,15000,15000,14080,14080,14390,-1065,-755,813816,"11,711,105.50",334670
,20170505,14080,14390,14005,14100,13555,13600,13805,-790,-585,737360,"10,181,847.23",345448
,20170508,13600,13805,13735,13940,13520,13565,13735,-240,-70,743100,"10,208,418.82",356786
,20170509,13565,13735,13560,13710,13410,13630,13560,-105,-175,719780,"9,761,366.77",365416
,20170510,13630,13560,13630,13790,13225,13305,13535,-255,-25,812882,"11,003,228.05",381290
,20170511,13305,13535,13395,13780,13310,13725,13515,190,-20,874664,"11,825,410.31",371592
,20170512,13725,13515,13815,13870,13360,13540,13540,25,25,786958,"10,656,839.90",363308
,20170515,13540,13540,13560,13850,13470,13715,13675,175,135,636892,"8,711,899.36",367820
,20170516,13715,13675,13785,13935,13500,13925,13700,250,25,824104,"11,292,495.46",388066
,20170517,13925,13700,13995,14030,13710,13785,13850,85,150,816296,"11,307,225.77",378846
,20170518,13785,13850,13725,13810,13325,13490,13545,-360,-305,856814,"11,607,700.98",385002
,20170519,13490,13545,13285,13900,13185,13775,13670,230,125,914914,"12,507,832.32",385564
,20170522,13775,13670,13805,14290,13740,13850,14025,180,355,1075250,"15,084,718.16",381356
,20170523,13850,14025,13895,14360,13845,13960,14080,-65,55,985258,"13,873,696.19",380918
,20170524,13960,14080,13960,14180,13555,13700,13870,-380,-210,937816,"13,009,374.86",382370
,20170525,13700,13870,13595,13955,13585,13750,13765,-120,-105,804422,"11,073,272.48",382836
,20170526,13750,13765,13750,13850,13390,13465,13570,-300,-195,596938,"8,101,866.20",409060
,20170531,13465,13570,13290,13610,12510,12510,12970,-1060,-600,669312,"8,681,823.19",426754
,20170601,12510,12970,12525,12635,12350,12480,12485,-490,-485,508038,"6,345,202.09",424872
,20170602,12480,12485,12500,12595,12350,12405,12485,-80,0,490404,"6,123,403.98",432432
,20170605,12405,12485,12310,12675,12270,12530,12505,45,20,550380,"6,883,171.45",440514
,20170606,12530,12505,12410,12605,12360,12455,12490,-50,-15,568080,"7,097,652.88",436216
,20170607,12455,12490,12400,12650,12320,12550,12505,60,15,676180,"8,456,537.88",456582
,20170608,12550,12505,12505,12555,12215,12405,12420,-100,-85,695058,"8,634,800.69",467026
,20170609,12405,12420,12450,12600,12410,12475,12485,55,65,463774,"5,791,235.76",457114
,20170612,12475,12485,12490,12790,12435,12675,12630,190,145,581414,"7,344,084.32",472512
,20170613,12675,12630,12705,12765,12255,12325,12540,-305,-90,504400,"6,327,054.83",468940
,20170614,12325,12540,12350,12980,12320,12900,12685,360,145,835854,"10,604,767.82",475100
,20170615,12900,12685,12905,12965,12685,12845,12820,160,135,594424,"7,622,752.42",454764
,20170616,12845,12820,12805,13140,12755,12875,12930,55,110,636620,"8,231,655.98",451970
,20170619,12875,12930,12870,12940,12510,12690,12735,-240,-195,661010,"8,420,079.51",458542
,20170620,12690,12735,12680,12815,12370,12630,12660,-105,-75,591338,"7,489,079.20",455542
,20170621,12630,12660,12510,12620,12410,12565,12525,-95,-135,477884,"5,987,493.16",444876
,20170622,12565,12525,12630,12825,12350,12410,12620,-115,95,635878,"8,026,216.62",469982
,20170623,12410,12620,12430,12735,12400,12670,12575,50,-45,566676,"7,126,684.65",446326
,20170626,12670,12575,12710,12820,12530,12730,12685,155,110,452040,"5,735,416.99",438752
,20170627,12730,12685,12685,12960,12650,12955,12795,270,110,517804,"6,626,615.95",451316
,20170628,12955,12795,13000,13200,12910,13080,13040,285,245,591554,"7,715,494.98",451418
,20170629,13080,13040,13055,13680,12970,13500,13345,460,305,883624,"11,792,985.41",473082
,20170630,13500,13345,13520,13550,13210,13335,13360,-10,15,545024,"7,281,865.20",452708
,20170703,13335,13360,13340,13570,13335,13500,13455,140,95,513074,"6,904,777.97",456138
,20170704,13500,13455,13510,13560,12625,12715,13055,-740,-400,788708,"10,297,137.43",459880
,20170705,12715,13055,12750,12925,12730,12830,12825,-225,-230,498180,"6,391,367.12",448148
,20170706,12830,12825,12765,12935,12635,12900,12815,75,-10,526846,"6,751,604.85",449658
,20170707,12900,12815,12900,13045,12690,12885,12850,70,35,555216,"7,136,264.07",455068
,20170710,12885,12850,12820,12945,12520,12690,12735,-160,-115,698240,"8,893,719.03",474676
,20170711,12690,12735,12660,13015,12570,12910,12815,175,80,666544,"8,543,909.98",478294
,20170712,12910,12815,12870,13420,12835,13235,13200,420,385,893966,"11,804,497.84",487320
,20170713,13235,13200,13185,13310,13075,13245,13200,45,0,582052,"7,684,194.58",483026
,20170714,13245,13200,13270,13495,13010,13455,13240,255,40,902542,"11,954,090.73",503488
,20170717,13455,13240,13465,13720,13380,13495,13520,255,280,832902,"11,263,076.49",485782
,20170718,13495,13520,13495,13675,13305,13460,13515,-60,-5,746528,"10,090,188.30",473710
,20170719,13460,13515,13490,14070,13420,14045,13680,530,165,872474,"11,938,504.32",483328
,20170720,14045,13680,14065,14320,13940,14035,14095,355,415,812150,"11,447,890.10",447460
,20170721,14035,14095,14010,14105,13720,13970,13920,-125,-175,691752,"9,632,347.52",431116
,20170724,13970,13920,13925,13975,13360,13515,13665,-405,-255,639658,"8,741,939.40",428290
,20170725,13515,13665,13500,13820,13415,13640,13635,-25,-30,545874,"7,443,139.45",418744
,20170726,13640,13635,13690,13850,13310,13420,13600,-215,-35,681534,"9,270,623.99",430406
,20170727,13420,13600,13400,13540,13325,13480,13445,-120,-155,384880,"5,176,273.98",394310
,20170728,13480,13445,13480,13600,12500,12500,13060,-945,-385,686942,"8,972,839.44",364704
,20170731,12500,13060,12500,12625,12305,12545,12485,-515,-575,421674,"5,265,714.08",286854
,20170801,12545,12485,12505,12620,12400,12430,12505,-55,20,220726,"2,760,752.26",273360
,20170802,12430,12505,12430,12550,12125,12275,12350,-230,-155,210694,"2,602,486.37",251254
,20170803,12275,12350,12310,12500,12300,12400,12395,50,45,115380,"1,430,602.66",223332
,20170804,12400,12395,12490,12855,12410,12755,12670,360,275,153056,"1,939,817.24",196108
,20170807,12755,12670,12760,13150,12705,12930,12885,260,215,128744,"1,659,255.48",166882
,20170808,12930,12885,12930,12990,12685,12815,12855,-70,-30,82982,"1,066,759.58",155894
,20170809,12815,12855,12845,13200,12755,13190,13040,335,185,97498,"1,271,784.08",132622
,20170810,13190,13040,13245,13280,13080,13205,13190,165,150,59826,"789,283.13",121622
,20170811,13205,13190,13195,13280,12710,12825,12935,-365,-255,74862,"968,604.44",114788
,20170814,12825,12935,12870,12890,12665,12735,12775,-200,-160,43880,"560,778.64",107954
,20170815,12735,12775,12785,12995,12665,12940,12850,165,75,46618,"599,129.37",99518
,20170816,12940,12850,12955,13100,12915,13020,13005,170,155,27846,"362,233.10",95258
,20170817,13020,13005,13095,13495,13050,13145,13250,140,245,48262,"639,560.85",86336
,20170818,13145,13250,13105,13235,12960,13185,13120,-65,-130,25334,"332,487.21",81882
,20170821,13185,13120,13210,13350,13145,13250,13255,130,135,25054,"332,145.21",77272
,20170822,13250,13255,13265,13315,13060,13250,13215,-5,-40,21652,"286,164.20",71276
,20170823,13250,13215,13255,13300,13045,13130,13160,-85,-55,17208,"226,480.96",65766
,20170824,13130,13160,13130,13220,13065,13145,13145,-15,-15,12674,"166,637.59",61584
,20170825,13145,13145,13145,13450,13115,13380,13305,235,160,21892,"291,335.70",55610
,20170828,13380,13305,13450,13450,13140,13315,13285,10,-20,11186,"148,658.45",50586
,20170829,13315,13285,13355,13365,13055,13175,13215,-110,-70,14030,"185,444.41",44600
,20170830,13175,13215,13315,13315,13140,13205,13200,-10,-15,9106,"120,199.90",39996
,20170831,13205,13200,13200,13330,13065,13275,13250,75,50,15690,"207,928.10",31648
,20170901,13275,13250,13230,13375,13230,13340,13305,90,55,5572,"74,156.91",28440
,20170904,13340,13305,13240,13935,13240,13830,13705,525,400,8586,"117,697.68",24424
,20170905,13830,13705,13760,13990,13760,13960,13910,255,205,5278,"73,437.48",21296
,20170906,13960,13910,14010,14405,13850,14210,14150,300,240,4984,"70,533.34",19046
,20170907,14210,14150,14210,14315,14060,14155,14190,5,40,2636,"37,408.51",17834
,20170908,14155,14190,14175,14185,13360,13590,13820,-600,-370,3544,"48,993.15",16720
,20170911,13590,13820,13665,13700,13335,13580,13540,-240,-280,3536,"47,888.08",15260
,20170912,13580,13540,13580,13700,13400,13445,13515,-95,-25,4458,"60,255.49",12980
,20170913,13445,13515,13515,13735,13455,13645,13550,130,35,474,"6,422.98",12908
,20170914,13645,13550,13645,13645,13355,13415,13555,-135,5,1130,"15,320.56",12028
,20170915,13415,13555,13415,13415,12810,12855,13225,-700,-330,1086,"14,364.55",11644
ru1710,20170103,18595,18635,19020,19020,18985,18985,19000,350,365,4,76.01,54
,20170104,18985,19000,18315,18315,18315,18315,18315,-685,-685,2,36.63,54
,20170105,18315,18315,18830,18830,18830,18830,18830,515,515,8,150.64,48
,20170106,18830,18830,,,,18830,18830,0,0,0,0.00,48
,20170109,18830,18830,18830,18830,18830,18830,18830,0,0,2,37.66,48
,20170110,18830,18830,19290,19490,19225,19490,19315,660,485,10,193.17,46
,20170111,19490,19315,19660,19660,19660,19660,19660,345,345,2,39.32,44
,20170112,19660,19660,20390,20640,20390,20600,20505,940,845,8,164.04,46
,20170113,20600,20505,20550,20550,20550,20550,20550,45,45,4,82.20,44
,20170116,20550,20550,20900,21665,20885,21665,21275,1115,725,8,170.21,38
,20170117,21665,21275,21800,21800,21395,21395,21530,120,255,20,430.64,44
,20170118,21395,21530,,,,21530,21530,0,0,0,0.00,44
,20170119,21530,21530,21575,21575,21345,21345,21405,-185,-125,16,342.53,42
,20170120,21345,21405,21295,21295,20055,20090,20610,-1315,-795,44,906.86,40
,20170123,20090,20610,19950,20145,19790,19790,19955,-820,-655,12,239.47,42
,20170124,19790,19955,19880,20275,19870,20275,19950,320,-5,12,239.45,38
,20170125,20275,19950,20335,20360,20180,20180,20315,230,365,12,243.79,36
,20170126,20180,20315,,,,20315,20315,0,0,0,0.00,36
,20170203,20315,20315,21135,21145,20280,20405,20695,90,380,64,"1,324.61",40
,20170206,20405,20695,20400,20400,20365,20365,20380,-330,-315,4,81.53,38
,20170207,20365,20380,20775,20800,20775,20800,20785,420,405,4,83.15,40
,20170208,20800,20785,20920,20920,20755,20765,20825,-20,40,12,249.94,44
,20170209,20765,20825,,,,20825,20825,0,0,0,0.00,44
,20170210,20825,20825,20685,20840,20570,20840,20740,15,-85,12,248.93,40
,20170213,20840,20740,21950,21955,21930,21955,21945,1215,1205,8,175.58,38
,20170214,21955,21945,,,,21945,21945,0,0,0,0.00,38
,20170215,21945,21945,22565,22565,21740,21795,22115,-150,170,12,265.43,36
,20170216,21795,22115,21660,21660,20870,20870,21350,-1245,-765,28,597.82,42
,20170217,20870,21350,20775,20830,20580,20580,20710,-770,-640,20,414.21,54
,20170220,20580,20710,20580,20580,20410,20450,20480,-260,-230,6,122.88,54
,20170221,20450,20480,,,,20480,20480,0,0,0,0.00,54
,20170222,20480,20480,20180,20335,20080,20235,20200,-245,-280,16,323.22,54
,20170223,20235,20200,19620,19620,19100,19100,19415,-1100,-785,8,155.33,60
,20170224,19100,19415,19205,19205,18995,18995,19040,-420,-375,88,"1,675.76",126
,20170227,18995,19040,19285,19440,19185,19440,19280,400,240,108,"2,082.55",62
,20170228,19440,19280,19085,19135,19045,19080,19100,-200,-180,12,229.23,60
,20170301,19080,19100,19350,19350,19350,19350,19350,250,250,2,38.70,60
,20170302,19350,19350,19185,19355,19175,19175,19275,-175,-75,56,"1,079.49",60
,20170303,19175,19275,,,,19475,19475,200,200,0,0.00,60
,20170306,19475,19475,19455,19455,19390,19390,19420,-85,-55,4,77.69,60
,20170307,19390,19420,19100,19215,19015,19015,19140,-405,-280,20,382.82,68
,20170308,19015,19140,18255,18275,18185,18185,18235,-955,-905,14,255.35,64
,20170309,18185,18235,17930,18155,17930,18155,18005,-80,-230,28,504.20,68
,20170310,18155,18005,,,,18085,18085,80,80,0,0.00,68
,20170313,18085,18085,17955,17955,17875,17875,17915,-210,-170,4,71.66,68
,20170314,17875,17915,,,,17950,17950,35,35,0,0.00,68
,20170315,17950,17950,18140,18345,18105,18345,18200,395,250,16,291.25,68
,20170316,18345,18200,18410,18420,17905,18380,18210,180,10,30,546.36,68
,20170317,18380,18210,18420,18815,18390,18700,18575,490,365,20,371.52,66
,20170320,18700,18575,18715,18720,18440,18440,18685,-135,110,422,"7,885.70",140
,20170321,18440,18685,18430,18455,17995,18040,18275,-645,-410,34,621.37,118
,20170322,18040,18275,17185,17295,17030,17070,17150,-1205,-1125,30,514.54,132
,20170323,17070,17150,16995,17300,16995,17060,17085,-90,-65,104,"1,777.27",140
,20170324,17060,17085,17230,17255,16835,16990,17085,-95,0,304,"5,195.21",114
,20170327,16990,17085,16955,16955,16015,16115,16380,-970,-705,38,622.50,104
,20170328,16115,16380,16135,16600,16135,16310,16375,-70,-5,34,556.90,100
,20170329,16310,16375,16335,16800,16335,16595,16615,220,240,26,432.00,96
,20170330,16595,16615,16345,16425,16320,16425,16360,-190,-255,6,98.18,94
,20170331,16425,16360,16525,16525,16525,16525,16525,165,165,2,33.05,92
,20170405,16525,16525,16480,17025,16480,17010,16740,485,215,30,502.34,88
,20170406,17010,16740,,,,16740,16740,0,0,0,0.00,88
,20170407,16740,16740,16335,16410,15745,15750,16150,-990,-590,76,"1,227.76",80
,20170410,15750,16150,15750,15850,15535,15650,15760,-500,-390,76,"1,198.01",80
,20170411,15650,15760,15460,15460,15460,15460,15460,-300,-300,2,30.92,78
,20170412,15460,15460,15545,15545,14855,14855,15130,-605,-330,38,575.02,72
,20170413,14855,15130,14950,15065,14870,15065,14960,-65,-170,6,89.77,76
,20170414,15065,14960,15100,15190,14845,14910,15095,-50,135,36,543.43,76
,20170417,14910,15095,15005,15235,14885,14885,14945,-210,-150,196,"2,929.87",240
,20170418,14885,14945,15095,15095,14680,14680,14990,-265,45,54,809.55,238
,20170419,14680,14990,14220,14505,14215,14505,14325,-485,-665,10,143.26,240
,20170420,14505,14325,14520,14520,14195,14400,14340,75,15,18,258.15,236
,20170421,14400,14340,14935,14995,14780,14860,14870,520,530,42,624.72,236
,20170424,14860,14870,14875,14915,14550,14915,14755,45,-115,34,501.78,238
,20170425,14915,14755,14910,15030,14775,14830,14925,75,170,40,597.04,238
,20170426,14830,14925,14730,15005,14645,14920,14720,-5,-205,992,"14,604.94",1086
,20170427,14920,14720,14715,14715,14535,14620,14645,-100,-75,8,117.17,1084
,20170428,14620,14645,14635,14930,14635,14900,14805,255,160,20,296.17,1086
,20170502,14900,14805,15070,15400,15070,15375,15285,570,480,14,213.99,1086
,20170503,15375,15285,15335,15335,15175,15250,15260,-35,-25,24,366.27,1082
,20170504,15250,15260,14880,14880,14190,14190,14205,-1070,-1055,636,"9,035.58",496
,20170505,14190,14205,14175,14210,13760,13885,13915,-320,-290,54,751.56,506
,20170508,13885,13915,13785,13985,13605,13605,13800,-310,-115,506,"6,983.56",134
,20170509,13605,13800,13595,13775,13560,13775,13610,-25,-190,28,381.18,130
,20170510,13775,13610,13775,13800,13335,13400,13545,-210,-65,48,650.26,124
,20170511,13400,13545,13420,13775,13400,13775,13460,230,-85,100,"1,346.03",128
,20170512,13775,13460,13650,13650,13560,13600,13615,140,155,20,272.32,120
,20170515,13600,13615,13690,13690,13645,13645,13665,30,50,4,54.67,118
,20170516,13645,13665,13670,13900,13670,13840,13800,175,135,28,386.46,114
,20170517,13840,13800,14100,14100,13820,13980,13915,180,115,60,835.08,108
,20170518,13980,13915,13740,13855,13695,13695,13825,-220,-90,46,636.13,110
,20170519,13695,13825,13335,13910,13335,13885,13785,60,-40,36,496.34,114
,20170522,13885,13785,14085,14380,13920,13965,14020,180,235,124,"1,738.59",118
,20170523,13965,14020,13995,14340,13530,14110,14125,90,105,686,"9,690.70",126
,20170524,14110,14125,14075,14280,13680,13860,14110,-265,-15,144,"2,032.30",132
,20170525,13860,14110,13755,13865,13715,13835,13780,-275,-330,16,220.55,122
,20170526,13835,13780,13815,13835,13485,13485,13700,-295,-80,34,465.91,118
,20170531,13485,13700,13420,13695,12600,12600,13010,-1100,-690,60,780.73,138
,20170601,12600,13010,12605,12685,12490,12585,12570,-425,-440,138,"1,735.16",136
,20170602,12585,12570,12630,12665,12465,12495,12600,-75,30,192,"2,420.02",136
,20170605,12495,12600,12445,12745,12445,12600,12510,0,-90,112,"1,401.18",122
,20170606,12600,12510,12565,12665,12470,12665,12545,155,35,28,351.30,122
,20170607,12665,12545,12530,12700,12440,12615,12590,70,45,38,478.57,126
,20170608,12615,12590,12580,12600,12455,12455,12535,-135,-55,32,401.17,134
,20170609,12455,12535,12575,12680,12540,12540,12580,5,45,32,402.63,130
,20170612,12540,12580,12625,12765,12570,12730,12690,150,110,36,456.86,142
,20170613,12730,12690,12725,12770,12270,12270,12695,-420,5,72,914.09,150
,20170614,12270,12695,12430,13030,12420,13030,12855,335,160,172,"2,211.61",144
,20170615,13030,12855,12990,13035,12805,12925,12970,70,115,64,830.37,134
,20170616,12925,12970,12885,13210,12870,12965,12985,-5,15,36,467.55,144
,20170619,12965,12985,12845,12885,12720,12815,12810,-170,-175,320,"4,100.10",146
,20170620,12815,12810,12865,12865,12520,12585,12645,-225,-165,32,404.69,152
,20170621,12585,12645,12625,12640,12600,12640,12620,-5,-25,14,176.72,152
,20170622,12640,12620,12820,12870,12450,12530,12700,-90,80,186,"2,362.83",160
,20170623,12530,12700,12535,12785,12535,12785,12625,85,-75,14,176.76,156
,20170626,12785,12625,12715,12975,12710,12975,12785,350,160,36,460.43,158
,20170627,12975,12785,12865,13025,12745,12990,12905,205,120,66,851.86,148
,20170628,12990,12905,13085,13290,13030,13065,13100,160,195,90,"1,179.41",138
,20170629,13065,13100,13150,13625,13070,13620,13470,520,370,64,862.08,132
,20170630,13620,13470,13505,13505,13345,13390,13425,-80,-45,12,161.12,132
,20170703,13390,13425,13495,13545,13450,13545,13495,120,70,36,485.98,130
,20170704,13545,13495,13580,13580,12795,12795,13045,-700,-450,36,469.71,130
,20170705,12795,13045,12895,12955,12860,12915,12905,-130,-140,32,412.98,124
,20170706,12915,12905,12860,12985,12750,12985,12860,80,-45,46,591.72,134
,20170707,12985,12860,13025,13025,12850,12960,12910,100,50,46,593.87,140
,20170710,12960,12910,12890,12990,12690,12800,12835,-110,-75,64,821.53,166
,20170711,12800,12835,12815,13070,12815,13060,12875,225,40,22,283.33,152
,20170712,13060,12875,13065,13455,13065,13320,13270,445,395,94,"1,247.67",140
,20170713,13320,13270,13270,13295,13220,13290,13265,20,-5,28,371.44,138
,20170714,13290,13265,13505,13545,13180,13545,13240,280,-25,248,"3,283.71",150
,20170717,13545,13240,13545,13740,13480,13535,13600,295,360,186,"2,530.21",216
,20170718,13535,13600,13565,13670,13380,13480,13555,-120,-45,78,"1,057.45",188
,20170719,13480,13555,13510,14145,13510,14145,13815,590,260,264,"3,647.68",216
,20170720,14145,13815,14110,14375,14040,14150,14145,335,330,232,"3,282.01",200
,20170721,14150,14145,14100,14110,13810,14080,13980,-65,-165,96,"1,342.36",186
,20170724,14080,13980,14015,14045,13345,13690,13745,-290,-235,90,"1,237.37",160
,20170725,13690,13745,13550,13850,13550,13770,13720,25,-25,48,658.71,148
,20170726,13770,13720,13910,13910,13445,13530,13645,-190,-75,80,"1,091.67",168
,20170727,13530,13645,13510,13635,13500,13595,13545,-50,-100,56,758.56,158
,20170728,13595,13545,13650,13650,12595,12635,12910,-910,-635,172,"2,220.83",204
,20170731,12635,12910,12550,12735,12490,12645,12640,-265,-270,1406,"17,774.19",308
,20170801,12645,12640,12675,12700,12565,12575,12610,-65,-30,478,"6,028.89",688
,20170802,12575,12610,12610,12640,12305,12405,12455,-205,-155,434,"5,406.09",690
,20170803,12405,12455,12430,12585,12430,12520,12495,65,40,96,"1,199.69",660
,20170804,12520,12495,12585,12960,12585,12865,12800,370,305,80,"1,024.30",622
,20170807,12865,12800,12905,13250,12860,13055,13065,255,265,196,"2,561.06",644
,20170808,13055,13065,13090,13130,12785,12945,13000,-120,-65,558,"7,256.32",664
,20170809,12945,13000,13010,13370,13010,13335,13220,335,220,148,"1,956.89",644
,20170810,13335,13220,13345,13420,13280,13375,13335,155,115,162,"2,160.48",606
,20170811,13375,13335,13420,13425,12860,12905,13125,-430,-210,420,"5,513.14",590
,20170814,12905,13125,13015,13045,12850,12920,12945,-205,-180,60,776.96,592
,20170815,12920,12945,12985,13150,12815,13110,12980,165,35,198,"2,570.37",558
,20170816,13110,12980,13140,13235,13085,13165,13155,185,175,272,"3,578.68",440
,20170817,13165,13155,13260,13590,13260,13300,13405,145,250,86,"1,153.07",456
,20170818,13300,13405,13290,13390,13185,13340,13270,-65,-135,44,584.07,440
,20170821,13340,13270,13485,13545,13315,13385,13420,115,150,156,"2,093.81",434
,20170822,13385,13420,13445,13445,13240,13375,13380,-45,-40,258,"3,452.91",254
,20170823,13375,13380,13405,13405,13165,13245,13280,-135,-100,40,531.36,246
,20170824,13245,13280,13265,13330,13200,13230,13275,-50,-5,24,318.61,236
,20170825,13230,13275,13275,13590,13270,13495,13420,220,145,146,"1,959.68",244
,20170828,13495,13420,13530,13550,13340,13410,13465,-10,45,62,834.83,212
,20170829,13410,13465,13445,13500,13255,13335,13370,-130,-95,52,695.48,226
,20170830,13335,13370,13355,13365,13305,13325,13330,-45,-40,24,319.96,236
,20170831,13325,13330,13350,13450,13325,13400,13375,70,45,44,588.52,254
,20170901,13400,13375,13415,13460,13405,13405,13425,30,50,6,80.56,254
,20170904,13405,13425,13435,14050,13435,13955,13905,530,480,160,"2,225.16",240
,20170905,13955,13905,14000,14110,13930,14040,14000,135,95,62,868.06,266
,20170906,14040,14000,14120,14460,13760,14435,14255,435,255,58,827.06,268
,20170907,14435,14255,14315,14370,14155,14220,14265,-35,10,30,428.01,270
,20170908,14220,14265,14280,14280,13515,13650,14010,-615,-255,64,896.83,272
,20170911,13650,14010,13710,13805,13630,13630,13745,-380,-265,16,219.95,272
,20170912,13630,13745,13770,13770,13550,13625,13605,-120,-140,44,598.77,264
,20170913,13625,13605,13615,13835,13615,13710,13735,105,130,28,384.59,266
,20170914,13710,13735,13580,13645,13440,13545,13535,-190,-200,80,"1,082.82",232
,20170915,13545,13535,13370,13475,13110,13110,13380,-425,-155,32,428.28,238
,20170918,13110,13380,12980,13030,12575,12635,12715,-745,-665,134,"1,703.86",224
,20170919,12635,12715,12625,12700,12500,12500,12665,-215,-50,40,506.70,224
,20170920,12500,12665,12420,12520,12395,12490,12450,-175,-215,204,"2,540.64",310
,20170921,12490,12450,12540,12540,11960,12000,12205,-450,-245,110,"1,342.95",326
,20170922,12000,12205,11980,12080,11900,12050,11935,-155,-270,30,358.15,328
,20170925,12050,11935,12140,12180,12080,12160,12120,225,185,66,800.14,364
,20170926,12160,12120,12160,12310,12140,12270,12235,150,115,16,195.83,360
,20170927,12270,12235,12225,12335,12195,12280,12240,45,5,46,563.11,364
,20170928,12280,12240,12250,12260,11380,11380,11800,-860,-440,232,"2,738.73",476
,20170929,11380,11800,11075,11330,10805,10980,11080,-820,-720,106,"1,174.90",486
,20171009,10980,11080,11210,11210,11120,11120,11165,40,85,4,44.66,482
,20171010,11120,11165,11305,11310,11165,11200,11205,35,40,158,"1,770.52",552
,20171011,11200,11205,11230,11410,11100,11240,11180,35,-25,82,917.01,564
,20171012,11240,11180,11150,11230,11150,11210,11185,30,5,50,559.38,552
,20171013,11210,11185,11230,11235,11200,11200,11220,15,35,38,426.42,574
,20171016,11200,11220,11250,11990,11250,11990,11495,770,275,60,689.70,574
ru1711,20170103,18750,18800,19240,19305,19115,19115,19220,315,420,18,346.02,502
,20170104,19115,19220,18945,19015,18380,19015,18695,-205,-525,40,747.99,492
,20170105,19015,18695,18990,18995,18675,18800,18845,105,150,36,678.55,468
,20170106,18800,18845,18590,18705,18360,18375,18455,-470,-390,34,627.63,474
,20170109,18375,18455,18900,19335,18900,19335,19085,880,630,24,458.11,468
,20170110,19335,19085,19470,19590,19170,19550,19270,465,185,1360,"26,213.53",1178
,20170111,19550,19270,19580,20010,19470,19990,19700,720,430,1382,"27,230.86",522
,20170112,19990,19700,20010,20805,20010,20680,20545,980,845,424,"8,711.18",548
,20170113,20680,20545,20630,20905,20545,20715,20745,170,200,132,"2,738.97",558
,20170116,20715,20745,20645,21915,20645,21830,21520,1085,775,200,"4,304.37",622
,20170117,21830,21520,21785,22025,21205,21600,21635,80,115,196,"4,240.52",692
,20170118,21600,21635,21610,21830,21285,21595,21590,-40,-45,56,"1,209.08",670
,20170119,21595,21590,21550,21605,21320,21365,21465,-225,-125,28,601.06,678
,20170120,21365,21465,21280,21330,19970,19985,20435,-1480,-1030,658,"13,449.00",598
,20170123,19985,20435,20075,20265,19950,19950,20120,-485,-315,154,"3,098.89",608
,20170124,19950,20120,20030,20305,19705,20235,19860,115,-260,1122,"22,286.22",1238
,20170125,20235,19860,20165,20365,19945,20135,20245,275,385,90,"1,822.21",1224
,20170126,20135,20245,20375,21705,20340,21595,21465,1350,1220,1402,"30,096.44",972
,20170203,21595,21465,21660,21660,20325,20520,20620,-945,-845,286,"5,898.51",890
,20170206,20520,20620,20625,20675,20320,20410,20510,-210,-110,142,"2,912.43",848
,20170207,20410,20510,20480,20880,20350,20880,20705,370,195,128,"2,650.42",858
,20170208,20880,20705,20835,21125,20675,20930,20975,225,270,116,"2,433.47",870
,20170209,20930,20975,20910,21055,20680,20820,20915,-155,-60,34,711.16,864
,20170210,20820,20915,20820,21525,20820,21220,21275,305,360,78,"1,659.77",870
,20170213,21220,21275,21385,22325,21385,22200,22240,925,965,1130,"25,133.20",1750
,20170214,22200,22240,22130,22130,21995,22125,22085,-115,-155,22,485.92,1750
,20170215,22125,22085,22300,22545,21900,21935,22080,-150,-5,46,"1,015.77",1742
,20170216,21935,22080,21645,22000,20635,20770,21190,-1310,-890,152,"3,221.16",1706
,20170217,20770,21190,20780,20915,20410,20780,20710,-410,-480,1162,"24,066.68",744
,20170220,20780,20710,20720,20760,20350,20610,20525,-100,-185,58,"1,190.64",740
,20170221,20610,20525,20855,21045,20330,20510,20765,-15,240,76,"1,578.47",744
,20170222,20510,20765,20510,20510,20165,20440,20345,-325,-420,58,"1,180.10",748
,20170223,20440,20345,20415,20425,19115,19140,19760,-1205,-585,84,"1,660.01",758
,20170224,19140,19760,19385,19390,18900,19270,19235,-490,-525,52,"1,000.24",744
,20170227,19270,19235,19400,19485,19220,19285,19345,50,110,54,"1,044.69",750
,20170228,19285,19345,19120,19180,18720,18875,18950,-470,-395,54,"1,023.56",730
,20170301,18875,18950,19000,19395,19000,19150,19215,200,265,26,499.60,720
,20170302,19150,19215,19335,19400,19095,19270,19290,55,75,50,964.54,718
,20170303,19270,19290,19310,19640,19185,19580,19480,290,190,34,662.36,712
,20170306,19580,19480,19610,19610,19440,19440,19540,-40,60,8,156.34,706
,20170307,19440,19540,19080,19240,19080,19155,19175,-385,-365,10,191.79,710
,20170308,19155,19175,19120,19120,18195,18210,18515,-965,-660,52,963.03,706
,20170309,18210,18515,18360,18360,17980,18100,18225,-415,-290,84,"1,531.16",686
,20170310,18100,18225,18210,18300,18020,18230,18170,5,-55,20,363.47,686
,20170313,18230,18170,18195,18385,17820,18385,18085,215,-85,64,"1,157.65",662
,20170314,18385,18085,18285,18300,17980,18040,18125,-45,40,46,833.78,658
,20170315,18040,18125,18075,18290,18075,18290,18205,165,80,6,109.25,656
,20170316,18290,18205,18430,18585,17995,18340,18335,135,130,18,330.09,656
,20170317,18340,18335,18440,18885,18370,18885,18475,550,140,46,849.95,652
,20170320,18885,18475,18885,18885,18525,18525,18725,50,250,58,"1,086.27",630
,20170321,18525,18725,18400,18525,18100,18100,18350,-625,-375,14,256.92,636
,20170322,18100,18350,18015,18175,17105,17165,17635,-1185,-715,96,"1,693.08",644
,20170323,17165,17635,17185,17315,17030,17195,17160,-440,-475,46,789.51,652
,20170324,17195,17160,17125,17130,16945,16945,17055,-215,-105,22,375.22,640
,20170327,16945,17055,17000,17000,16110,16190,16425,-865,-630,80,"1,314.25",656
,20170328,16190,16425,16275,16550,16275,16300,16395,-125,-30,24,393.52,670
,20170329,16300,16395,16395,16790,16390,16725,16565,330,170,20,331.33,674
,20170330,16725,16565,16705,16705,16360,16360,16570,-205,5,16,265.14,670
,20170331,16360,16570,16065,16620,16065,16400,16400,-170,-170,24,393.65,676
,20170405,16400,16400,16810,17285,16800,17100,17030,700,630,16,272.51,672
,20170406,17100,17030,16875,16980,16870,16980,16910,-50,-120,30,507.37,668
,20170407,16980,16910,16555,16555,15725,15725,16100,-1185,-810,34,547.42,674
,20170410,15725,16100,15800,15930,15550,15810,15675,-290,-425,36,564.30,670
,20170411,15810,15675,15810,15810,15385,15585,15640,-90,-35,22,344.15,660
,20170412,15585,15640,15490,15490,14885,14885,15110,-755,-530,54,815.95,676
,20170413,14885,15110,14995,15350,14995,15350,15150,240,40,38,575.81,696
,20170414,15350,15150,15190,15200,14830,15005,15120,-145,-30,1052,"15,909.80",1664
,20170417,15005,15120,14935,15350,14935,14995,15135,-125,15,48,726.62,1646
,20170418,14995,15135,15055,15055,14770,14790,14910,-345,-225,28,417.50,1642
,20170419,14790,14910,14630,14690,14295,14530,14490,-380,-420,24,347.79,1636
,20170420,14530,14490,14590,15000,14290,15000,14725,510,235,60,883.79,1634
,20170421,15000,14725,15000,15140,14870,14890,15000,165,275,72,"1,080.26",1636
,20170424,14890,15000,14885,15000,14605,15000,14890,0,-110,206,"3,067.56",1638
,20170425,15000,14890,15000,15155,14845,14845,15030,-45,140,604,"9,081.05",1656
,20170426,14845,15030,14760,15075,14655,14740,14920,-290,-110,468,"6,983.42",1708
,20170427,14740,14920,14760,14850,14615,14850,14725,-70,-195,194,"2,857.06",1786
,20170428,14850,14725,14855,15110,14785,14955,15000,230,275,466,"6,991.96",1860
,20170502,14955,15000,15045,15525,14970,15405,15330,405,330,126,"1,931.68",1872
,20170503,15405,15330,15360,15420,15185,15225,15260,-105,-70,514,"7,843.87",2036
,20170504,15225,15260,14845,14945,14190,14210,14275,-1050,-985,732,"10,449.92",2006
,20170505,14210,14275,14120,14190,13660,13700,13860,-575,-415,682,"9,453.35",1998
,20170508,13700,13860,13835,14025,13600,13690,13835,-170,-25,538,"7,443.66",2018
,20170509,13690,13835,13675,13800,13555,13800,13630,-35,-205,96,"1,308.64",2018
,20170510,13800,13630,13770,13850,13335,13430,13605,-200,-25,130,"1,768.97",2020
,20170511,13430,13605,13500,13870,13465,13830,13540,225,-65,530,"7,177.28",2036
,20170512,13830,13540,13700,13730,13450,13615,13660,75,120,460,"6,284.80",2000
,20170515,13615,13660,13650,13875,13650,13765,13735,105,75,126,"1,730.70",1994
,20170516,13765,13735,13855,13995,13630,13995,13840,260,105,466,"6,450.97",2060
,20170517,13995,13840,14055,14060,13825,13865,13965,25,125,282,"3,939.08",1986
,20170518,13865,13965,13825,13885,13445,13570,13585,-395,-380,120,"1,630.32",1996
,20170519,13570,13585,13450,13970,13355,13905,13815,320,230,224,"3,095.00",2000
,20170522,13905,13815,13895,14355,13830,13960,14145,145,330,372,"5,262.92",2028
,20170523,13960,14145,14010,14410,13850,14075,14165,-70,20,1644,"23,287.63",2606
,20170524,14075,14165,14110,14290,13735,13855,14100,-310,-65,438,"6,177.26",2578
,20170525,13855,14100,13800,14045,13765,13905,13890,-195,-210,280,"3,889.42",2600
,20170526,13905,13890,13890,13965,13550,13580,13605,-310,-285,1294,"17,607.32",2336
,20170531,13580,13605,13440,13715,12630,12680,12925,-925,-680,290,"3,749.60",2416
,20170601,12680,12925,12675,12725,12500,12630,12605,-295,-320,362,"4,564.60",2496
,20170602,12630,12605,12645,12690,12490,12555,12555,-50,-50,450,"5,651.34",2454
,20170605,12555,12555,12205,12785,12205,12660,12620,105,65,638,"8,052.31",2610
,20170606,12660,12620,12560,12690,12500,12560,12585,-60,-35,320,"4,028.37",2608
,20170607,12560,12585,12515,12705,12455,12680,12595,95,10,350,"4,409.27",2604
,20170608,12680,12595,12635,12645,12360,12505,12480,-90,-115,454,"5,667.01",2716
,20170609,12505,12480,12575,12675,12530,12580,12590,100,110,432,"5,440.13",2782
,20170612,12580,12590,12610,12850,12540,12750,12780,160,190,710,"9,075.40",2842
,20170613,12750,12780,12750,12825,12375,12410,12660,-370,-120,422,"5,343.68",2920
,20170614,12410,12660,12450,13050,12425,13000,12715,340,55,768,"9,767.39",3010
,20170615,13000,12715,13040,13040,12790,12950,12895,235,180,802,"10,345.45",2986
,20170616,12950,12895,12870,13215,12870,12985,13045,90,150,628,"8,192.55",2998
,20170619,12985,13045,12975,13015,12635,12800,12810,-245,-235,372,"4,767.04",3082
,20170620,12800,12810,12865,12930,12550,12735,12770,-75,-40,756,"9,655.50",3256
,20170621,12735,12770,12600,12690,12540,12665,12625,-105,-145,704,"8,888.57",3556
,20170622,12665,12625,12695,12920,12490,12500,12735,-125,110,688,"8,762.42",3726
,20170623,12500,12735,12565,12825,12520,12790,12700,55,-35,862,"10,951.38",3786
,20170626,12790,12700,12795,12860,12660,12810,12785,110,85,774,"9,897.08",4184
,20170627,12810,12785,12865,13020,12755,13020,12915,235,130,630,"8,136.86",4382
,20170628,13020,12915,13090,13230,13025,13135,13130,220,215,918,"12,053.39",4750
,20170629,13135,13130,13170,13715,13080,13560,13420,430,290,2284,"30,662.46",5536
,20170630,13560,13420,13580,13605,13315,13360,13390,-60,-30,1342,"17,973.18",5510
,20170703,13360,13390,13410,13590,13365,13585,13470,195,80,1204,"16,218.84",5498
,20170704,13585,13470,13610,13620,12655,12815,13115,-655,-355,1354,"17,757.73",5804
,20170705,12815,13115,12840,12995,12830,12920,12915,-195,-200,722,"9,328.10",5852
,20170706,12920,12915,12870,13035,12750,13000,12900,85,-15,784,"10,116.43",5956
,20170707,13000,12900,13040,13120,12800,12990,12930,90,30,1032,"13,347.26",6266
,20170710,12990,12930,12935,13000,12630,12770,12810,-160,-120,1516,"19,426.82",6888
,20170711,12770,12810,12750,13085,12680,12980,12900,170,90,1200,"15,480.47",7124
,20170712,12980,12900,12940,13480,12940,13285,13265,385,365,2100,"27,861.15",7650
,20170713,13285,13265,13260,13360,13135,13295,13260,30,-5,1166,"15,463.69",7826
,20170714,13295,13260,13345,13515,13080,13480,13305,220,45,2016,"26,823.61",8368
,20170717,13480,13305,13515,13715,13420,13490,13550,185,245,3578,"48,498.15",9934
,20170718,13490,13550,13535,13675,13350,13515,13545,-35,-5,3592,"48,662.74",10484
,20170719,13515,13545,13505,14080,13480,14055,13715,510,170,4316,"59,203.11",11612
,20170720,14055,13715,14005,14320,13965,14080,14120,365,405,4224,"59,659.32",11724
,20170721,14080,14120,14050,14140,13130,14015,13905,-105,-215,4032,"56,065.37",12572
,20170724,14015,13905,13900,14000,13500,13600,13715,-305,-190,4768,"65,402.59",13768
,20170725,13600,13715,13580,13915,13515,13740,13710,25,-5,4290,"58,823.60",14044
,20170726,13740,13710,13800,13920,13500,13585,13715,-125,5,7832,"107,419.25",16028
,20170727,13585,13715,13535,13635,13450,13580,13545,-135,-170,5216,"70,662.77",18088
,20170728,13580,13545,13555,13685,12595,12595,13005,-950,-540,17340,"225,548.11",23444
,20170731,12595,13005,12650,12745,12465,12670,12615,-335,-390,15076,"190,237.76",27454
,20170801,12670,12615,12670,12755,12600,12625,12675,10,60,10798,"136,866.35",29874
,20170802,12625,12675,12605,12730,12360,12490,12530,-185,-145,12288,"154,001.16",31252
,20170803,12490,12530,12495,12710,12490,12600,12595,70,65,9442,"118,959.42",31150
,20170804,12600,12595,12615,13025,12600,12940,12845,345,250,13366,"171,735.59",30568
,20170807,12940,12845,12955,13250,12860,13100,13030,255,185,17502,"228,134.15",32022
,20170808,13100,13030,13100,13180,12905,13025,13055,-5,25,13416,"175,175.05",33144
,20170809,13025,13055,13025,13470,12980,13460,13285,405,230,23944,"318,174.89",29740
,20170810,13460,13285,13460,13540,13350,13480,13455,195,170,15812,"212,758.01",32594
,20170811,13480,13455,13465,13550,12955,13095,13185,-360,-270,22656,"298,758.99",33272
,20170814,13095,13185,13125,13160,12955,13015,13050,-170,-135,11628,"151,787.87",34806
,20170815,13015,13050,13000,13270,12955,13195,13120,145,70,15200,"199,441.29",35006
,20170816,13195,13120,13195,13370,13170,13290,13275,170,155,12254,"162,683.80",35042
,20170817,13290,13275,13330,13790,13325,13410,13525,135,250,22284,"301,490.50",36034
,20170818,13410,13525,13450,13495,13250,13445,13390,-80,-135,12998,"174,082.34",35906
,20170821,13445,13390,13510,13625,13360,13500,13500,110,110,14178,"191,454.81",35162
,20170822,13500,13500,13520,13590,13325,13515,13475,15,-25,11870,"159,985.51",35334
,20170823,13515,13475,13535,13545,13300,13375,13405,-100,-70,10968,"147,033.07",35338
,20170824,13375,13405,13375,13490,13330,13395,13405,-10,0,9496,"127,309.45",35662
,20170825,13395,13405,13335,13795,13335,13670,13585,265,180,17954,"243,959.12",36358
,20170828,13670,13585,13685,13710,13415,13590,13555,5,-30,10748,"145,698.13",36770
,20170829,13590,13555,13600,13630,13320,13440,13480,-115,-75,10700,"144,274.83",36720
,20170830,13440,13480,13495,13515,13385,13465,13455,-15,-25,6794,"91,418.18",36826
,20170831,13465,13455,13470,13610,13300,13550,13520,95,65,11952,"161,636.83",37922
,20170901,13550,13520,13640,13650,13535,13610,13590,90,70,8226,"111,832.08",38436
,20170904,13610,13590,13635,14235,13590,14105,13990,515,400,19210,"268,843.16",37020
,20170905,14105,13990,14105,14270,14080,14240,14180,250,190,10208,"144,775.40",37194
,20170906,14240,14180,14300,14690,14090,14475,14425,295,245,16670,"240,512.69",36644
,20170907,14475,14425,14485,14565,14325,14410,14450,-15,25,12302,"177,823.82",37110
,20170908,14410,14450,14450,14450,13610,13870,14095,-580,-355,16218,"228,653.14",37542
,20170911,13870,14095,13910,13985,13620,13840,13815,-255,-280,15670,"216,504.48",37382
,20170912,13840,13815,13940,13955,13720,13795,13825,-20,10,11686,"161,581.43",37478
,20170913,13795,13825,13775,14050,13760,13895,13890,70,65,9892,"137,437.51",37048
,20170914,13895,13890,13880,13880,13540,13630,13740,-260,-150,12226,"167,993.34",37490
,20170915,13630,13740,13665,13685,13100,13165,13395,-575,-345,17814,"238,705.57",38596
,20170918,13165,13395,13190,13225,12680,12780,12860,-615,-535,19432,"249,973.96",40310
,20170919,12780,12860,12820,12915,12590,12635,12775,-225,-85,9592,"122,583.82",41360
,20170920,12635,12775,12695,12695,12440,12605,12565,-170,-210,11724,"147,348.37",41122
,20170921,12605,12565,12695,12695,12090,12125,12375,-440,-190,15416,"190,834.21",42018
,20170922,12125,12375,12230,12230,12005,12175,12135,-200,-240,8548,"103,759.22",41492
,20170925,12175,12135,12280,12315,12110,12235,12225,100,90,8370,"102,345.75",41278
,20170926,12235,12225,12255,12400,12200,12325,12300,100,75,11028,"135,659.10",40038
,20170927,12325,12300,12320,12420,12265,12370,12360,70,60,7918,"97,904.52",38758
,20170928,12370,12360,12340,12390,11490,11490,11730,-870,-630,14620,"171,547.41",37482
,20170929,11490,11730,11460,11460,10810,11255,11125,-475,-605,24662,"274,422.37",33324
,20171009,11255,11125,11445,11445,11030,11215,11225,90,100,7914,"88,852.74",32880
,20171010,11215,11225,11300,11390,11220,11300,11305,75,80,6972,"78,849.41",32240
,20171011,11300,11305,11305,11365,11110,11280,11255,-25,-50,7640,"86,015.76",31484
,20171012,11280,11255,11225,11385,11130,11315,11275,60,20,5710,"64,383.89",30820
,20171013,11315,11275,11400,11495,11285,11490,11390,215,115,7330,"83,523.49",29286
,20171016,11490,11390,11500,11710,11415,11530,11515,140,125,4898,"56,413.72",28716
,20171017,11530,11515,11470,11545,11240,11440,11390,-75,-125,4676,"53,279.94",27838
,20171018,11440,11390,11485,11525,11380,11430,11465,40,75,3368,"38,617.07",27224
,20171019,11430,11465,11490,11575,11305,11330,11440,-135,-25,5462,"62,502.38",26454
,20171020,11330,11440,11285,11595,11255,11540,11455,100,15,3528,"40,427.06",25532
,20171023,11540,11455,11540,11620,11270,11395,11415,-60,-40,4070,"46,470.35",25304
,20171024,11395,11415,11455,11545,11300,11395,11410,-20,-5,3666,"41,837.61",24828
,20171025,11395,11410,11395,11580,11260,11455,11445,45,35,4392,"50,283.16",23794
,20171026,11455,11445,11415,11540,11340,11470,11445,25,0,3306,"37,851.79",22460
,20171027,11470,11445,11470,11505,11210,11315,11375,-130,-70,4152,"47,234.01",22038
,20171030,11315,11375,11315,11335,11210,11230,11260,-145,-115,2888,"32,532.63",21338
,20171031,11230,11260,11230,11250,11120,11120,11195,-140,-65,5734,"64,213.40",19030
,20171101,11120,11195,11195,11455,11160,11370,11335,175,140,3400,"38,541.53",17636
,20171102,11370,11335,11285,11590,11285,11525,11465,190,130,1724,"19,770.21",16874
,20171103,11525,11465,11500,11555,11465,11555,11515,90,50,1454,"16,747.28",16184
,20171106,11555,11515,11505,12090,11500,12015,11845,500,330,2030,"24,053.84",15132
,20171107,12015,11845,11930,12080,11840,11940,11970,95,125,1332,"15,944.12",14572
,20171108,11940,11970,11890,11950,11800,11830,11875,-140,-95,1198,"14,230.82",14174
,20171109,11830,11875,11805,12035,11800,11855,11930,-20,55,2088,"24,914.81",13594
,20171110,11855,11930,11810,11890,11600,11670,11755,-260,-175,3172,"37,296.88",12008
,20171113,11670,11755,11605,11795,11565,11750,11705,-5,-50,2014,"23,581.03",10616
,20171114,11750,11705,11750,11805,11700,11750,11735,45,30,968,"11,361.62",9974
,20171115,11750,11735,11750,11795,11200,11300,11390,-435,-345,1326,"15,108.08",9160
ru1801,20170117,21520,21520,22775,23250,22535,23100,22925,1580,1405,1440,"33,018.65",644
,20170118,23100,22925,23245,23270,22830,23100,23055,175,130,886,"20,427.99",820
,20170119,23100,23055,23050,23175,22785,22805,22970,-250,-85,468,"10,751.00",802
,20170120,22805,22970,22860,22870,21600,21760,22195,-1210,-775,1160,"25,749.26",922
,20170123,21760,22195,21700,21875,21530,21630,21680,-565,-515,396,"8,585.30",964
,20170124,21630,21680,21630,22040,21305,21855,21785,175,105,486,"10,589.50",1134
,20170125,21855,21785,21850,22075,21700,21900,21885,115,100,220,"4,814.85",1134
,20170126,21900,21885,22070,23305,21990,23295,22945,1410,1060,602,"13,815.16",1154
,20170203,23295,22945,23075,23075,22000,22140,22330,-805,-615,522,"11,656.79",1134
,20170206,22140,22330,22140,22255,21935,22090,22130,-240,-200,952,"21,068.15",1184
,20170207,22090,22130,22235,22410,21980,22390,22210,260,80,1290,"28,652.99",1396
,20170208,22390,22210,22330,22535,22135,22425,22355,215,145,1514,"33,851.40",2004
,20170209,22425,22355,22340,22525,22200,22340,22385,-15,30,766,"17,148.56",2222
,20170210,22340,22385,22240,22905,22190,22620,22600,235,215,974,"22,016.65",2574
,20170213,22620,22600,22700,23960,22685,23870,23580,1270,980,3068,"72,350.18",3452
,20170214,23870,23580,23935,23935,23435,23830,23685,250,105,912,"21,605.26",3494
,20170215,23830,23685,23745,24085,23340,23515,23595,-170,-90,2164,"51,069.20",3750
,20170216,23515,23595,23460,23775,22430,22560,23060,-1035,-535,1332,"30,719.91",3668
,20170217,22560,23060,22560,22635,21985,22270,22395,-790,-665,2172,"48,652.44",3198
,20170220,22270,22395,22370,22425,21785,22310,22095,-85,-300,1188,"26,253.28",3062
,20170221,22310,22095,22330,22655,21935,22150,22290,55,195,1206,"26,886.70",3088
,20170222,22150,22290,22110,22115,21765,22040,21945,-250,-345,1320,"28,967.67",3326
,20170223,22040,21945,21910,22100,20710,20835,21320,-1110,-625,1488,"31,729.65",3124
,20170224,20835,21320,20930,20990,20510,20920,20795,-400,-525,978,"20,338.63",3226
,20170227,20920,20795,20970,21115,20720,20920,20950,125,155,1028,"21,537.65",3360
,20170228,20920,20950,20900,20930,20455,20700,20695,-250,-255,2034,"42,095.34",3382
,20170301,20700,20695,20740,21150,20675,20885,20865,190,170,910,"18,989.64",3510
,20170302,20885,20865,20930,21065,20750,20980,20920,115,55,644,"13,474.64",3544
,20170303,20980,20920,20965,21275,20800,21265,21040,345,120,872,"18,346.99",3662
,20170306,21265,21040,21295,21345,20810,20905,21105,-135,65,1394,"29,423.36",3976
,20170307,20905,21105,20785,20875,20635,20750,20760,-355,-345,1634,"33,924.72",4220
,20170308,20750,20760,20760,20765,19800,19875,20115,-885,-645,2110,"42,445.35",4478
,20170309,19875,20115,19920,19980,19605,19650,19785,-465,-330,1284,"25,408.36",4612
,20170310,19650,19785,19650,19950,19470,19695,19770,-90,-15,1362,"26,932.54",5106
,20170313,19695,19770,19790,19830,19255,19760,19625,-10,-145,3852,"75,600.36",7016
,20170314,19760,19625,19805,19960,19430,19525,19735,-100,110,2148,"42,399.59",7408
,20170315,19525,19735,19500,19885,19275,19770,19685,35,-50,1910,"37,604.25",7708
,20170316,19770,19685,19825,20165,19535,19980,19865,295,180,3166,"62,904.82",8494
,20170317,19980,19865,19925,20350,19865,20310,20135,445,270,3302,"66,501.48",9708
,20170320,20310,20135,20325,20380,19830,19920,20150,-215,15,2988,"60,221.12",10488
,20170321,19920,20150,19895,20000,19480,19520,19695,-630,-455,3132,"61,686.49",10636
,20170322,19520,19695,19600,19660,18550,18585,18905,-1110,-790,6012,"113,684.44",10138
,20170323,18585,18905,18605,18845,18435,18550,18665,-355,-240,7408,"138,295.49",12564
,20170324,18550,18665,18585,18720,18280,18340,18495,-325,-170,7018,"129,827.77",14044
,20170327,18340,18495,18340,18375,17375,17555,17735,-940,-760,9632,"170,868.17",15194
,20170328,17555,17735,17545,17930,17460,17630,17725,-105,-10,8036,"142,446.02",16806
,20170329,17630,17725,17725,18110,17650,17965,17880,240,155,9554,"170,853.39",18722
,20170330,17965,17880,17940,18015,17530,17745,17785,-135,-95,10458,"185,996.49",19198
,20170331,17745,17785,17700,18120,17700,17855,17950,70,165,8680,"155,835.98",19166
,20170405,17855,17950,17850,18775,17850,18545,18430,595,480,9378,"172,863.13",19852
,20170406,18545,18430,18590,18635,18305,18470,18485,40,55,10852,"200,643.61",21196
,20170407,18470,18485,18405,18445,17240,17325,17710,-1160,-775,16262,"288,079.80",21142
,20170410,17325,17710,17240,17585,17210,17300,17355,-410,-355,10236,"177,671.74",21732
,20170411,17300,17355,17155,17460,17010,17195,17245,-160,-110,9268,"159,845.90",21822
,20170412,17195,17245,17195,17275,16525,16640,16795,-605,-450,13712,"230,340.45",22628
,20170413,16640,16795,16660,17050,16610,16890,16815,95,20,9916,"166,738.32",23238
,20170414,16890,16815,16890,17015,16445,16740,16740,-75,-75,13484,"225,761.49",24360
,20170417,16740,16740,16745,17015,16560,16675,16810,-65,70,12178,"204,719.68",24238
,20170418,16675,16810,16685,16805,16310,16360,16520,-450,-290,9792,"161,789.14",24382
,20170419,16360,16520,16220,16280,15725,16090,16090,-430,-430,17106,"275,261.55",26082
,20170420,16090,16090,16035,16560,15805,16545,16160,455,70,18510,"299,160.25",27248
,20170421,16545,16160,16550,16785,16430,16555,16595,395,435,16156,"268,175.30",27914
,20170424,16555,16595,16490,16765,16250,16705,16510,110,-85,23466,"387,435.80",31906
,20170425,16705,16510,16760,16950,16530,16655,16725,145,215,21006,"351,359.33",33346
,20170426,16655,16725,16610,16965,16460,16530,16730,-195,5,26386,"441,444.01",33672
,20170427,16530,16730,16575,16730,16370,16610,16540,-120,-190,24654,"407,778.55",33716
,20170428,16610,16540,16580,16860,16400,16730,16685,190,145,19388,"323,535.00",32830
,20170502,16730,16685,16845,17195,16685,17140,17055,455,370,15764,"268,858.54",32520
,20170503,17140,17055,17095,17170,16975,17060,17055,5,0,13316,"227,156.01",33498
,20170504,17060,17055,17000,17000,15860,15980,16285,-1075,-770,34086,"555,257.60",34562
,20170505,15980,16285,15950,16035,15570,15620,15810,-665,-475,27726,"438,445.51",35452
,20170508,15620,15810,15700,15945,15575,15640,15770,-170,-40,27052,"426,687.65",36316
,20170509,15640,15770,15670,15670,15340,15575,15530,-195,-240,28312,"439,747.72",37796
,20170510,15575,15530,15545,15725,15165,15235,15480,-295,-50,29462,"456,189.22",38834
,20170511,15235,15480,15315,15790,15235,15750,15490,270,10,37516,"581,190.08",41956
,20170512,15750,15490,15800,15865,15345,15525,15545,35,55,30038,"466,985.30",40186
,20170515,15525,15545,15545,15780,15420,15705,15645,160,100,21564,"337,435.82",41034
,20170516,15705,15645,15770,15860,15525,15850,15680,205,35,26778,"419,971.73",41104
,20170517,15850,15680,15905,15960,15695,15745,15830,65,150,32588,"515,925.25",42274
,20170518,15745,15830,15700,15785,15330,15480,15525,-350,-305,31624,"491,104.36",42158
,20170519,15480,15525,15275,15900,15120,15790,15670,265,145,35618,"558,148.71",43068
,20170522,15790,15670,15785,16260,15710,15820,16000,150,330,45536,"728,768.94",44698
,20170523,15820,16000,15875,16320,15820,15930,16045,-70,45,45386,"728,434.97",46254
,20170524,15930,16045,15910,16140,15500,15680,15825,-365,-220,40634,"643,221.62",46846
,20170525,15680,15825,15595,15950,15595,15740,15760,-85,-65,40902,"644,620.66",48056
,20170526,15740,15760,15740,15840,15405,15490,15570,-270,-190,47138,"734,018.29",48034
,20170531,15490,15570,15325,15625,14640,14695,15065,-875,-505,63746,"960,385.31",49798
,20170601,14695,15065,14710,14765,14450,14635,14620,-430,-445,46750,"683,677.34",51874
,20170602,14635,14620,14670,14760,14465,14510,14610,-110,-10,45270,"661,449.75",54056
,20170605,14510,14610,14435,14775,14390,14670,14610,60,0,58040,"848,105.14",56804
,20170606,14670,14610,14530,14720,14500,14560,14615,-50,5,50972,"745,149.15",59518
,20170607,14560,14615,14495,14750,14460,14650,14610,35,-5,54474,"795,965.73",61038
,20170608,14650,14610,14625,14630,14305,14445,14475,-165,-135,71338,"1,032,642.34",61536
,20170609,14445,14475,14495,14610,14450,14495,14515,20,40,48730,"707,548.89",61638
,20170612,14495,14515,14500,14785,14430,14675,14630,160,115,56258,"823,273.60",62720
,20170613,14675,14630,14680,14740,14280,14335,14560,-295,-70,51118,"744,442.03",62418
,20170614,14335,14560,14340,15045,14320,14965,14715,405,155,91644,"1,348,935.64",68234
,20170615,14965,14715,14975,15030,14780,14940,14900,225,185,63790,"950,784.62",68534
,20170616,14940,14900,14910,15200,14845,14975,15030,75,130,71646,"1,076,924.59",71768
,20170619,14975,15030,14955,15030,14650,14815,14845,-215,-185,74244,"1,102,234.24",72244
,20170620,14815,14845,14800,14945,14480,14725,14785,-120,-60,68780,"1,016,914.22",72604
,20170621,14725,14785,14600,14695,14500,14630,14610,-155,-175,62088,"907,113.65",72154
,20170622,14630,14610,14700,14885,14470,14515,14690,-95,80,67612,"993,356.19",73536
,20170623,14515,14690,14510,14760,14485,14725,14635,35,-55,67584,"989,266.35",71942
,20170626,14725,14635,14720,14850,14605,14790,14745,155,110,52004,"767,038.14",73790
,20170627,14790,14745,14780,14975,14705,14970,14835,225,90,64104,"951,042.80",75762
,20170628,14970,14835,15000,15215,14940,15105,15075,270,240,79796,"1,203,011.96",78446
,20170629,15105,15075,15105,15580,15005,15395,15325,320,250,118778,"1,820,698.53",80466
,20170630,15395,15325,15400,15430,15160,15280,15270,-45,-55,76034,"1,161,142.65",81280
,20170703,15280,15270,15295,15505,15270,15380,15385,110,115,78260,"1,204,302.21",85712
,20170704,15380,15385,15400,15435,14570,14645,14955,-740,-430,112744,"1,686,578.06",86954
,20170705,14645,14955,14665,14895,14665,14820,14790,-135,-165,75698,"1,119,887.81",88392
,20170706,14820,14790,14790,14940,14640,14930,14805,140,15,81632,"1,208,766.81",91124
,20170707,14930,14805,14930,15065,14720,14895,14875,90,70,94310,"1,403,192.11",93636
,20170710,14895,14875,14840,14925,14550,14680,14755,-195,-120,120310,"1,775,303.72",96726
,20170711,14680,14755,14640,14910,14565,14815,14780,60,25,118642,"1,753,646.13",103228
,20170712,14815,14780,14755,15370,14755,15190,15130,410,350,173074,"2,618,918.28",115056
,20170713,15190,15130,15150,15320,15050,15260,15185,130,55,147850,"2,245,396.33",123090
,20170714,15260,15185,15305,15470,15050,15440,15235,255,50,215730,"3,287,356.61",128984
,20170717,15440,15235,15410,15690,15365,15505,15510,270,275,192906,"2,992,769.31",137942
,20170718,15505,15510,15490,15810,15470,15650,15660,140,150,240856,"3,772,428.47",153308
,20170719,15650,15660,15660,16465,15610,16445,15965,785,305,327598,"5,230,830.36",175620
,20170720,16445,15965,16470,16690,16305,16410,16485,445,520,339626,"5,599,151.56",173202
,20170721,16410,16485,16365,16500,16040,16330,16275,-155,-210,348946,"5,680,063.27",181758
,20170724,16330,16275,16275,16365,15805,15915,16090,-360,-185,356886,"5,742,405.11",190336
,20170725,15915,16090,15900,16330,15870,16170,16125,80,35,342360,"5,521,277.97",207532
,20170726,16170,16125,16220,16470,15890,15990,16215,-135,90,534678,"8,670,721.58",224586
,20170727,15990,16215,15965,16145,15815,16115,16010,-100,-205,430404,"6,890,919.86",244984
,20170728,16115,16010,16105,16380,14935,15090,15665,-920,-345,925092,"14,491,948.81",255302
,20170731,15090,15665,15120,15450,15060,15325,15265,-340,-400,604548,"9,228,719.48",273156
,20170801,15325,15265,15295,15505,15190,15275,15340,10,75,505552,"7,756,202.84",285654
,20170802,15275,15340,15250,15460,15010,15235,15265,-105,-75,650548,"9,932,770.18",295388
,20170803,15235,15265,15225,15395,15150,15245,15290,-20,25,539160,"8,243,770.82",302916
,20170804,15245,15290,15290,15870,15155,15705,15550,415,260,790104,"12,288,291.91",322866
,20170807,15705,15550,15710,16305,15705,16030,15950,480,400,847940,"13,527,336.61",325008
,20170808,16030,15950,16040,16240,15800,16070,16055,120,105,749864,"12,040,389.81",335632
,20170809,16070,16055,16090,16750,15990,16615,16450,560,395,916844,"15,084,862.02",355952
,20170810,16615,16450,16635,16730,16320,16460,16495,10,45,768906,"12,686,031.51",362356
,20170811,16460,16495,16435,16630,15615,15935,16100,-560,-395,1120384,"18,041,563.17",347966
,20170814,15935,16100,15980,16150,15805,15920,15985,-180,-115,645622,"10,323,186.20",350486
,20170815,15920,15985,15905,16320,15660,16215,16045,230,60,986582,"15,831,905.90",369766
,20170816,16215,16045,16200,16395,16110,16265,16255,220,210,745886,"12,125,092.54",368166
,20170817,16265,16255,16315,16990,16285,16435,16600,180,345,1112480,"18,471,202.80",375492
,20170818,16435,16600,16400,16660,16110,16580,16440,-20,-160,832842,"13,693,043.84",378644
,20170821,16580,16440,16580,16770,16350,16585,16595,145,155,998940,"16,581,858.68",388256
,20170822,16585,16595,16600,16800,16330,16700,16585,105,-10,863710,"14,328,135.05",393066
,20170823,16700,16585,16710,16735,16265,16475,16485,-110,-100,832532,"13,726,057.67",370900
,20170824,16475,16485,16470,16620,16310,16420,16475,-65,-10,756384,"12,462,377.63",374756
,20170825,16420,16475,16410,16935,16350,16720,16680,245,205,796220,"13,281,184.09",381114
,20170828,16720,16680,16710,16795,16350,16645,16600,-35,-80,583214,"9,681,569.76",371230
,20170829,16645,16600,16645,16725,16205,16445,16475,-155,-125,731904,"12,059,224.34",376098
,20170830,16445,16475,16520,16520,16235,16395,16380,-80,-95,537050,"8,799,497.49",381540
,20170831,16395,16380,16365,16695,16095,16545,16490,165,110,805736,"13,287,535.02",379710
,20170901,16545,16490,16575,16720,16525,16620,16615,130,125,530500,"8,816,175.37",380170
,20170904,16620,16615,16615,17410,16590,17165,17090,550,475,1043544,"17,839,119.16",403304
,20170905,17165,17090,17185,17435,17150,17335,17270,245,180,616938,"10,655,439.42",409944
,20170906,17335,17270,17500,17840,17200,17570,17520,300,250,882434,"15,462,312.28",409100
,20170907,17570,17520,17605,17725,17360,17490,17545,-30,25,756956,"13,281,692.71",408526
,20170908,17490,17545,17495,17520,16500,16760,17120,-785,-425,1092626,"18,711,205.61",394108
,20170911,16760,17120,16800,16850,16320,16665,16620,-455,-500,726502,"12,077,265.54",387678
,20170912,16665,16620,16710,16820,16580,16750,16705,130,85,572112,"9,558,872.44",391752
,20170913,16750,16705,16705,17055,16630,16775,16820,70,115,758170,"12,754,787.21",394282
,20170914,16775,16820,16725,16770,16360,16420,16580,-400,-240,779666,"12,927,546.59",388754
,20170915,16420,16580,16450,16490,15680,15725,16115,-855,-465,956858,"15,419,917.09",392842
,20170918,15725,16115,15790,15820,15055,15210,15345,-905,-770,853950,"13,106,506.19",385936
,20170919,15210,15345,15220,15335,14905,14960,15185,-385,-160,616980,"9,370,734.87",390512
,20170920,14960,15185,15000,15175,14775,15085,14975,-100,-210,665654,"9,970,537.10",380702
,20170921,15085,14975,15120,15190,14440,14515,14795,-460,-180,947200,"14,015,231.21",387530
,20170922,14515,14795,14580,14665,14330,14565,14535,-230,-260,689214,"10,019,551.40",374564
,20170925,14565,14535,14685,14730,14445,14580,14585,45,50,535508,"7,810,670.62",373688
,20170926,14580,14585,14605,14825,14490,14625,14640,40,55,562254,"8,231,757.47",372248
,20170927,14625,14640,14570,14730,14510,14655,14630,15,-10,446130,"6,527,024.94",368308
,20170928,14655,14630,14650,14680,13605,13605,14025,-1025,-605,644526,"9,042,685.70",366652
,20170929,13605,14025,13500,13550,12905,13495,13265,-530,-760,908032,"12,045,815.04",322566
,20171009,13495,13265,13615,13660,13165,13350,13340,85,75,414786,"5,533,422.76",333978
,20171010,13350,13340,13360,13450,13215,13315,13350,-25,10,473376,"6,320,322.96",339224
,20171011,13315,13350,13320,13475,12920,13245,13220,-105,-130,732788,"9,689,323.97",341652
,20171012,13245,13220,13145,13550,13040,13375,13245,155,25,671972,"8,903,015.82",341330
,20171013,13375,13245,13420,13680,13360,13575,13505,330,260,646960,"8,740,193.43",334588
,20171016,13575,13505,13600,13930,13405,13580,13620,75,115,746286,"10,167,247.75",335468
,20171017,13580,13620,13575,13675,13175,13530,13450,-90,-170,730018,"9,822,144.71",330826
,20171018,13530,13450,13520,13720,13470,13570,13600,120,150,603424,"8,208,970.41",330796
,20171019,13570,13600,13600,13785,13320,13365,13570,-235,-30,905204,"12,286,903.96",333818
,20171020,13365,13570,13355,13800,13210,13700,13535,130,-35,672996,"9,111,876.36",322072
,20171023,13700,13535,13700,13840,13315,13500,13520,-35,-15,753614,"10,189,336.73",322792
,20171024,13500,13520,13500,13630,13360,13425,13490,-95,-30,691724,"9,332,378.31",330444
,20171025,13425,13490,13440,13680,13215,13535,13505,45,15,678650,"9,166,500.54",316364
,20171026,13535,13505,13535,13645,13330,13555,13520,50,15,573424,"7,752,858.38",314698
,20171027,13555,13520,13570,13615,13120,13330,13425,-190,-95,734474,"9,861,541.10",339184
,20171030,13330,13425,13290,13425,13235,13285,13320,-140,-105,456754,"6,086,060.85",336908
,20171031,13285,13320,13300,13355,13150,13260,13270,-60,-50,447752,"5,943,367.75",330744
,20171101,13260,13270,13285,13855,13280,13595,13565,325,295,749974,"10,176,977.16",322278
,20171102,13595,13565,13575,13905,13520,13785,13715,220,150,582486,"7,989,805.38",319946
,20171103,13785,13715,13745,13820,13590,13690,13705,-25,-10,415098,"5,690,760.93",309840
,20171106,13690,13705,13670,14235,13650,14135,13995,430,290,664656,"9,302,996.34",318544
,20171107,14135,13995,14130,14210,13855,13990,14040,-5,45,492552,"6,917,785.90",304450
,20171108,13990,14040,13940,14015,13765,13820,13915,-220,-125,466646,"6,493,463.06",308852
,20171109,13820,13915,13840,14150,13725,13805,13930,-110,15,665294,"9,269,237.08",306714
,20171110,13805,13930,13760,13950,13750,13855,13860,-75,-70,406892,"5,639,721.46",302570
,20171113,13855,13860,13865,14255,13755,14155,14030,295,170,664298,"9,322,969.81",303012
,20171114,14155,14030,14120,14295,14060,14105,14160,75,130,467968,"6,627,337.73",297136
,20171115,14105,14160,14105,14180,13215,13270,13550,-890,-610,693528,"9,398,165.72",277216
,20171116,13270,13550,13285,13415,13190,13270,13310,-280,-240,352230,"4,688,265.13",273962
,20171117,13270,13310,13325,13400,13250,13295,13315,-15,5,308578,"4,109,893.84",265204
,20171120,13295,13315,13315,13450,13180,13385,13320,70,5,342166,"4,558,202.26",259524
,20171121,13385,13320,13400,13470,12820,13335,13220,15,-100,583362,"7,712,106.22",252020
,20171122,13335,13220,13365,13460,13270,13390,13365,170,145,330630,"4,420,314.67",244842
,20171123,13390,13365,13420,13825,13365,13725,13685,360,320,514348,"7,040,239.13",226696
,20171124,13725,13685,13725,13920,13655,13845,13800,160,115,367944,"5,077,926.80",219306
,20171127,13845,13800,13850,13955,13320,13410,13630,-390,-170,430178,"5,865,042.59",206304
,20171128,13410,13630,13410,13600,13305,13545,13450,-85,-180,224764,"3,023,920.48",184420
,20171129,13545,13450,13540,13820,13485,13765,13680,315,230,220058,"3,011,124.18",155486
,20171130,13765,13680,13750,13895,13460,13505,13700,-175,20,177564,"2,433,194.45",135630
,20171201,13505,13700,13580,14100,13565,14065,13850,365,150,167682,"2,322,799.11",120988
,20171204,14065,13850,14300,14495,14075,14410,14295,560,445,136910,"1,957,673.51",109036
,20171205,14410,14295,14465,14465,14085,14220,14275,-75,-20,85142,"1,215,674.22",102836
,20171206,14220,14275,14185,14250,13575,13835,13885,-440,-390,82872,"1,150,945.24",93622
,20171207,13835,13885,13865,14010,13360,13550,13805,-335,-80,89928,"1,241,737.18",86030
,20171208,13550,13805,13565,13680,13410,13615,13565,-190,-240,56644,"768,566.16",81722
,20171211,13615,13565,13685,13825,13430,13550,13615,-15,50,62336,"848,869.33",78668
,20171212,13550,13615,13650,13750,13505,13670,13635,55,20,43910,"598,876.67",76390
,20171213,13670,13635,13670,13770,13480,13610,13605,-25,-30,43434,"591,044.41",74170
,20171214,13610,13605,13600,13965,13525,13800,13765,195,160,53332,"734,345.76",70048
,20171215,13800,13765,13815,14000,13770,13940,13885,175,120,31074,"431,528.13",68406
,20171218,13940,13885,13945,14230,13910,14075,14060,190,175,36426,"512,189.44",64678
,20171219,14075,14060,14075,14075,13780,13920,13935,-140,-125,25862,"360,504.25",62438
,20171220,13920,13935,13970,14080,13880,13975,13975,40,40,23690,"331,164.69",60452
,20171221,13975,13975,14000,14125,13825,13905,13940,-70,-35,22364,"311,831.33",58646
,20171222,13905,13940,13880,13925,13430,13535,13620,-405,-320,35744,"486,851.66",54282
,20171225,13535,13620,13545,13730,13510,13565,13620,-55,0,22140,"301,637.25",50278
,20171226,13565,13620,13530,13915,13250,13840,13710,220,90,20236,"277,524.58",46044
,20171227,13840,13710,13840,13920,13675,13715,13815,5,105,15472,"213,776.14",41966
,20171228,13715,13815,13695,13765,13495,13735,13660,-80,-155,13538,"184,967.96",38326
,20171229,13735,13660,13735,13775,13570,13630,13675,-30,15,15348,"209,929.93",32456
ru1803,20170316,19685,19685,19970,19980,19930,19930,19960,245,275,6,119.76,4
,20170317,19930,19960,20065,20265,20065,20265,20165,305,205,4,80.66,6
,20170320,20265,20165,20370,20470,19980,19980,20270,-185,105,12,243.24,10
,20170321,19980,20270,,,,19880,19880,-390,-390,0,0.00,10
,20170322,19880,19880,,,,19795,19795,-85,-85,0,0.00,10
,20170323,19795,19795,18420,18805,18420,18805,18510,-990,-1285,12,222.15,18
,20170324,18805,18510,18480,18520,18475,18520,18490,10,-20,6,110.95,16
,20170327,18520,18490,18405,18405,17685,17685,17820,-805,-670,18,320.79,22
,20170328,17685,17820,17670,18010,17670,17845,17775,25,-45,34,604.49,24
,20170329,17845,17775,17870,18200,17870,18105,18060,330,285,14,252.86,28
,20170330,18105,18060,18110,18110,17865,17930,17925,-130,-135,22,394.38,28
,20170331,17930,17925,18095,18095,18095,18095,18095,170,170,2,36.19,30
,20170405,18095,18095,18400,18710,18310,18565,18600,470,505,34,632.53,46
,20170406,18565,18600,18550,18630,18455,18565,18540,-35,-60,30,556.31,44
,20170407,18565,18540,18420,18420,17465,17565,17810,-975,-730,26,463.16,56
,20170410,17565,17810,17335,17525,17335,17500,17410,-310,-400,14,243.74,68
,20170411,17500,17410,17250,17475,17200,17360,17350,-50,-60,18,312.33,68
,20170412,17360,17350,17335,17355,16710,16710,17090,-640,-260,34,581.11,56
,20170413,16710,17090,16775,17140,16775,17140,16935,50,-155,12,203.22,56
,20170414,17140,16935,17030,17110,16705,16885,16880,-50,-55,14,236.32,60
,20170417,16885,16880,17110,17160,16875,16875,17070,-5,190,20,341.49,64
,20170418,16875,17070,16690,16790,16690,16790,16740,-280,-330,4,66.96,62
,20170419,16790,16740,16180,16405,16180,16200,16275,-540,-465,16,260.40,72
,20170420,16200,16275,16285,16645,16145,16645,16320,370,45,26,424.42,80
,20170421,16645,16320,16775,16780,16590,16590,16720,270,400,10,167.22,76
,20170424,16590,16720,16695,16730,16530,16730,16640,10,-80,18,299.54,70
,20170425,16730,16640,16920,16980,16815,16885,16900,245,260,8,135.20,68
,20170426,16885,16900,16665,17000,16665,16915,16835,15,-65,32,538.75,70
,20170427,16915,16835,16760,16785,16580,16780,16695,-55,-140,34,567.78,82
,20170428,16780,16695,16770,16955,16680,16925,16860,230,165,22,370.92,78
,20170502,16925,16860,17275,17340,17275,17315,17305,455,445,12,207.67,74
,20170503,17315,17305,17215,17215,17190,17205,17200,-100,-105,10,172.01,68
,20170504,17205,17200,16245,16245,16200,16200,16230,-1000,-970,8,129.87,68
,20170505,16200,16230,16010,16010,16010,16010,16010,-220,-220,6,96.06,70
,20170508,16010,16010,15930,16000,15915,15945,15945,-65,-65,22,350.79,72
,20170509,15945,15945,15585,15830,15535,15830,15655,-115,-290,16,250.53,80
,20170510,15830,15655,15430,15430,15420,15420,15425,-235,-230,6,92.55,80
,20170511,15420,15425,15475,15900,15475,15890,15645,465,220,30,469.48,90
,20170512,15890,15645,15675,15675,15580,15580,15615,-65,-30,12,187.42,84
,20170515,15580,15615,,,,15615,15615,0,0,0,0.00,84
,20170516,15615,15615,15915,15915,15915,15915,15915,300,300,2,31.83,84
,20170517,15915,15915,15965,16080,15960,16075,16005,160,90,14,224.07,84
,20170518,16075,16005,15525,15690,15525,15690,15625,-315,-380,18,281.32,86
,20170519,15690,15625,16065,16065,16000,16000,16030,375,405,4,64.13,88
,20170522,16000,16030,16195,16275,16105,16105,16175,75,145,10,161.79,88
,20170523,16105,16175,16435,16435,16085,16085,16280,-90,105,6,97.69,88
,20170524,16085,16280,15925,15925,15770,15770,15850,-510,-430,6,95.10,90
,20170525,15770,15850,15910,15910,15910,15910,15910,60,60,6,95.46,90
,20170526,15910,15910,15860,15860,15665,15665,15760,-245,-150,4,63.05,92
,20170531,15665,15760,15765,15765,15120,15120,15240,-640,-520,12,182.93,94
,20170601,15120,15240,14865,14865,14865,14865,14865,-375,-375,2,29.73,96
,20170602,14865,14865,14940,14940,14770,14770,14840,-95,-25,8,118.75,100
,20170605,14770,14840,14710,14855,14600,14855,14735,15,-105,20,294.72,96
,20170606,14855,14735,,,,14735,14735,0,0,0,0.00,96
,20170607,14735,14735,14745,14745,14745,14745,14745,10,10,4,58.98,100
,20170608,14745,14745,,,,14745,14745,0,0,0,0.00,100
,20170609,14745,14745,14760,14760,14670,14670,14710,-75,-35,8,117.69,102
,20170612,14670,14710,14875,14875,14800,14800,14835,90,125,4,59.35,102
,20170613,14800,14835,14800,14800,14660,14660,14725,-175,-110,6,88.36,98
,20170614,14660,14725,14980,15185,14980,15185,15085,460,360,8,120.70,102
,20170615,15185,15085,,,,15085,15085,0,0,0,0.00,102
,20170616,15085,15085,15335,15335,15335,15335,15335,250,250,2,30.67,100
,20170619,15335,15335,14865,15090,14865,15070,15045,-265,-290,12,180.54,96
,20170620,15070,15045,,,,15045,15045,0,0,0,0.00,96
,20170621,15045,15045,16080,16080,14740,14740,15425,-305,380,20,308.55,106
,20170622,14740,15425,14570,14990,14570,14985,14880,-440,-545,26,386.91,106
,20170623,14985,14880,,,,14880,14880,0,0,0,0.00,106
,20170626,14880,14880,14940,15000,14830,14870,14910,-10,30,8,119.28,104
,20170627,14870,14910,15100,15120,15100,15120,15110,210,200,4,60.44,100
,20170628,15120,15110,15360,15360,15360,15360,15360,250,250,2,30.72,98
,20170629,15360,15360,15480,15755,15480,15590,15570,230,210,20,311.48,100
,20170630,15590,15570,15390,15390,15390,15390,15390,-180,-180,2,30.78,98
,20170703,15390,15390,15495,15610,15495,15610,15550,220,160,4,62.21,98
,20170704,15610,15550,15250,15250,14890,14890,15070,-660,-480,4,60.28,94
,20170705,14890,15070,15015,15065,14930,15065,15000,-5,-70,6,90.02,92
,20170706,15065,15000,,,,15000,15000,0,0,0,0.00,92
,20170707,15000,15000,,,,15000,15000,0,0,0,0.00,92
,20170710,15000,15000,14870,14870,14805,14805,14865,-195,-135,50,743.37,96
,20170711,14805,14865,14800,15000,14800,15000,14910,135,45,6,89.46,98
,20170712,15000,14910,15070,15250,15070,15250,15115,340,205,26,393.11,112
,20170713,15250,15115,15275,15290,15275,15290,15280,175,165,4,61.13,110
,20170714,15290,15280,15355,15585,15255,15320,15395,40,115,10,153.95,112
,20170717,15320,15395,15495,15645,15330,15635,15555,240,160,20,311.19,104
,20170718,15635,15555,15800,15855,15655,15655,15805,100,250,20,316.18,102
,20170719,15655,15805,15840,16275,15840,16275,16160,470,355,20,323.29,94
,20170720,16275,16160,16600,16600,16480,16600,16520,440,360,34,561.75,90
,20170721,16600,16520,16600,16670,16190,16615,16395,95,-125,20,327.99,96
,20170724,16615,16395,16275,16295,16080,16185,16205,-210,-190,14,226.88,100
,20170725,16185,16205,16185,16380,16075,16380,16210,175,5,6,97.28,102
,20170726,16380,16210,16380,16380,16380,16380,16380,170,170,4,65.52,100
,20170727,16380,16380,16050,16170,16005,16170,16055,-210,-325,12,192.70,96
,20170728,16170,16055,16310,16440,15140,15140,15975,-915,-80,24,383.51,104
,20170731,15140,15975,15285,15535,15285,15410,15400,-565,-575,20,308.09,110
,20170801,15410,15400,15470,15470,15415,15415,15440,15,40,4,61.77,110
,20170802,15415,15440,15325,15360,15325,15360,15340,-80,-100,4,61.37,112
,20170803,15360,15340,15455,15530,15455,15530,15480,190,140,6,92.89,116
,20170804,15530,15480,15500,16005,15500,15950,15920,470,440,98,"1,560.31",128
,20170807,15950,15920,15905,16460,15905,16115,16150,195,230,68,"1,098.20",146
,20170808,16115,16150,16195,16375,16100,16195,16230,45,80,56,909.08,118
,20170809,16195,16230,16060,16840,16060,16775,16555,545,325,36,596.01,112
,20170810,16775,16555,16645,16705,16570,16705,16605,150,50,14,232.51,118
,20170811,16705,16605,16225,16225,15925,16000,16010,-605,-595,40,640.54,140
,20170814,16000,16010,16100,16250,16060,16060,16135,50,125,28,451.78,140
,20170815,16060,16135,16090,16100,15900,16100,16000,-35,-135,10,160.02,140
,20170816,16100,16000,16290,16470,16290,16470,16360,470,360,44,719.98,122
,20170817,16470,16360,16620,17130,16580,17045,16750,685,390,34,569.56,112
,20170818,17045,16750,16525,16690,16350,16475,16460,-275,-290,106,"1,745.08",112
,20170821,16475,16460,16685,16915,16685,16765,16825,305,365,332,"5,586.35",200
,20170822,16765,16825,16820,16885,16560,16885,16730,60,-95,208,"3,480.47",162
,20170823,16885,16730,16680,16700,16480,16525,16600,-205,-130,70,"1,162.24",158
,20170824,16525,16600,16735,16775,16550,16665,16690,65,90,128,"2,136.59",172
,20170825,16665,16690,16615,17010,16595,16995,16880,305,190,38,641.61,168
,20170828,16995,16880,16765,16830,16545,16800,16725,-80,-155,56,936.82,192
,20170829,16800,16725,16810,16810,16460,16585,16620,-140,-105,94,"1,562.51",224
,20170830,16585,16620,16585,16675,16535,16555,16585,-65,-35,10,165.87,228
,20170831,16555,16585,16540,16820,16345,16820,16580,235,-5,86,"1,426.03",274
,20170901,16820,16580,16805,16850,16800,16850,16830,270,250,10,168.31,268
,20170904,16850,16830,16935,17470,16935,17275,17305,445,475,82,"1,419.06",260
,20170905,17275,17305,17360,17450,17360,17435,17400,130,95,12,208.80,264
,20170906,17435,17400,17440,17960,17440,17800,17880,400,480,96,"1,716.90",194
,20170907,17800,17880,17730,17730,17590,17590,17640,-290,-240,6,105.85,190
,20170908,17590,17640,17520,17600,16715,16895,17245,-745,-395,32,551.97,198
,20170911,16895,17245,16555,16820,16555,16820,16650,-425,-595,30,499.60,202
,20170912,16820,16650,16880,16880,16880,16880,16880,230,230,2,33.76,202
,20170913,16880,16880,,,,16910,16910,30,30,0,0.00,202
,20170914,16910,16910,16595,16690,16590,16690,16640,-220,-270,14,232.97,196
,20170915,16690,16640,16220,16255,16220,16255,16230,-385,-410,10,162.33,198
,20170918,16255,16230,15650,15680,15275,15360,15395,-870,-835,28,431.11,190
,20170919,15360,15395,15420,15420,15120,15120,15315,-275,-80,8,122.52,196
,20170920,15120,15315,15055,15120,15055,15120,15085,-195,-230,4,60.35,196
,20170921,15120,15085,15200,15200,14715,14715,14905,-370,-180,18,268.32,202
,20170922,14715,14905,14515,14835,14365,14795,14580,-110,-325,216,"3,150.17",164
,20170925,14795,14580,14795,14815,14745,14815,14785,235,205,24,354.91,162
,20170926,14815,14785,14815,14815,14750,14750,14795,-35,10,10,147.95,152
,20170927,14750,14795,14725,14895,14725,14765,14795,-30,0,6,88.77,152
,20170928,14765,14795,14835,14835,13755,13835,14055,-960,-740,566,"7,955.38",546
,20170929,13835,14055,13565,13630,13200,13615,13385,-440,-670,178,"2,382.54",576
,20171009,13615,13385,13695,13720,13445,13490,13540,105,155,64,866.79,582
,20171010,13490,13540,13550,13575,13550,13575,13560,35,20,6,81.37,584
,20171011,13575,13560,13365,13395,13200,13390,13320,-170,-240,12,159.86,586
,20171012,13390,13320,13475,13550,13405,13550,13475,230,155,6,80.86,584
,20171013,13550,13475,13670,13805,13670,13805,13735,330,260,4,54.95,588
,20171016,13805,13735,13945,14095,13680,13760,13845,25,110,44,609.32,582
,20171017,13760,13845,13750,13840,13500,13760,13710,-85,-135,32,438.82,572
,20171018,13760,13710,13785,13885,13705,13815,13845,105,135,28,387.77,554
,20171019,13815,13845,13610,13895,13610,13630,13730,-215,-115,286,"3,927.48",742
,20171020,13630,13730,13500,13900,13500,13850,13690,120,-40,26,356.01,736
,20171023,13850,13690,13825,13825,13700,13730,13775,40,85,26,358.17,734
,20171024,13730,13775,,,,13775,13775,0,0,0,0.00,734
,20171025,13775,13775,13710,13830,13635,13700,13710,-75,-65,16,219.42,736
,20171026,13700,13710,13590,13785,13590,13710,13735,0,25,28,384.69,732
,20171027,13710,13735,13670,13755,13490,13490,13555,-245,-180,142,"1,925.30",742
,20171030,13490,13555,13490,13510,13490,13490,13490,-65,-65,128,"1,726.79",730
,20171031,13490,13490,13475,13475,13475,13475,13475,-15,-15,6,80.85,728
,20171101,13475,13475,13585,13910,13470,13820,13710,345,235,24,329.14,728
,20171102,13820,13710,13800,14010,13800,13915,13930,205,220,20,278.62,736
,20171103,13915,13930,13845,13845,13845,13845,13845,-85,-85,4,55.38,736
,20171106,13845,13845,13905,14420,13900,14380,14225,535,380,54,768.36,736
,20171107,14380,14225,14325,14385,14065,14180,14150,-45,-75,42,594.43,738
,20171108,14180,14150,14125,14170,14020,14020,14065,-130,-85,38,534.59,742
,20171109,14020,14065,14020,14310,13995,13995,14090,-70,25,14,197.28,746
,20171110,13995,14090,14060,14140,14015,14070,14065,-20,-25,50,703.31,742
,20171113,14070,14065,14135,14360,13980,14320,14160,255,95,46,651.52,744
,20171114,14320,14160,14300,14440,14280,14290,14365,130,205,36,517.30,738
,20171115,14290,14365,14330,14330,13425,13450,13660,-915,-705,50,683.01,742
,20171116,13450,13660,13555,13565,13490,13515,13520,-145,-140,18,243.44,742
,20171117,13515,13520,13510,13560,13455,13500,13520,-20,0,42,567.86,734
,20171120,13500,13520,13450,13525,13450,13525,13500,5,-20,24,324.00,734
,20171121,13525,13500,13515,13550,13175,13395,13445,-105,-55,62,833.80,736
,20171122,13395,13445,13610,13610,13545,13550,13570,105,125,12,162.88,732
,20171123,13550,13570,13625,13955,13625,13910,13845,340,275,20,276.94,732
,20171124,13910,13845,14050,14085,13995,14000,14045,155,200,720,"10,112.60",158
,20171127,14000,14045,13995,14025,13560,13560,13820,-485,-225,54,746.36,160
,20171128,13560,13820,13585,13795,13585,13795,13680,-25,-140,6,82.09,162
,20171129,13795,13680,13800,14000,13800,13900,13940,220,260,24,334.59,162
,20171130,13900,13940,13925,14170,13775,13775,13980,-165,40,136,"1,901.40",238
,20171201,13775,13980,13915,14285,13885,14280,14150,300,170,106,"1,500.33",170
,20171204,14280,14150,14530,14645,14400,14605,14540,455,390,42,610.68,174
,20171205,14605,14540,14535,14580,14420,14490,14490,-50,-50,38,550.63,172
,20171206,14490,14490,14160,14160,13905,14110,14070,-380,-420,56,787.97,164
,20171207,14110,14070,14185,14285,14035,14225,14190,155,120,14,198.71,158
,20171208,14225,14190,13860,13935,13695,13935,13820,-255,-370,20,276.40,162
,20171211,13935,13820,13785,13795,13785,13795,13790,-25,-30,4,55.16,162
,20171212,13795,13790,13960,13960,13960,13960,13960,170,170,2,27.92,160
,20171213,13960,13960,14040,14040,13850,13940,13930,-20,-30,22,306.56,176
,20171214,13940,13930,14180,14220,14055,14055,14160,125,230,8,113.29,170
,20171215,14055,14160,14075,14265,14075,14200,14190,40,30,12,170.30,174
,20171218,14200,14190,14310,14505,14280,14350,14390,160,200,20,287.81,174
,20171219,14350,14390,,,,14265,14265,-125,-125,0,0.00,174
,20171220,14265,14265,14360,14360,14360,14360,14360,95,95,2,28.72,172
,20171221,14360,14360,14210,14260,14200,14260,14230,-100,-130,8,113.86,166
,20171222,14260,14230,13935,13975,13805,13910,13870,-320,-360,20,277.48,172
,20171225,13910,13870,,,,13880,13880,10,10,0,0.00,172
,20171226,13880,13880,13665,14200,13665,14200,13995,320,115,28,391.96,152
,20171227,14200,13995,14200,14200,14090,14090,14120,95,125,8,112.97,156
,20171228,14090,14120,14025,14100,13865,14080,13995,-40,-125,24,335.96,166
,20171229,14080,13995,14050,14090,13975,14030,14035,35,40,20,280.73,156
ru1804,20170418,17070,17070,,,,17070,17070,0,0,0,0.00,0
,20170419,17070,17070,,,,17070,17070,0,0,0,0.00,0
,20170420,17070,17070,,,,17070,17070,0,0,0,0.00,0
,20170421,17070,17070,,,,17070,17070,0,0,0,0.00,0
,20170424,17070,17070,,,,17070,17070,0,0,0,0.00,0
,20170425,17070,17070,16800,16800,16800,16800,16800,-270,-270,2,33.60,2
,20170426,16800,16800,16810,17100,16810,16970,16965,170,165,12,203.63,6
,20170427,16970,16965,16735,16735,16735,16735,16735,-230,-230,2,33.47,4
,20170428,16735,16735,16935,17095,16935,17095,17020,360,285,6,102.13,8
,20170502,17095,17020,17000,17315,17000,17315,17140,295,120,8,137.12,12
,20170503,17315,17140,17315,17315,17250,17250,17280,110,140,4,69.13,12
,20170504,17250,17280,16935,16935,16480,16480,16745,-800,-535,12,200.95,12
,20170505,16480,16745,16060,16060,16060,16060,16060,-685,-685,2,32.12,14
,20170508,16060,16060,16130,16170,16100,16100,16130,40,70,6,96.80,14
,20170509,16100,16130,15875,16130,15830,15895,15930,-235,-200,8,127.46,16
,20170510,15895,15930,16015,16015,16015,16015,16015,85,85,2,32.03,18
,20170511,16015,16015,15750,16025,15740,15965,15880,-50,-135,20,317.69,28
,20170512,15965,15880,15780,15780,15780,15780,15780,-100,-100,2,31.56,28
,20170515,15780,15780,15770,15955,15770,15955,15860,175,80,4,63.45,26
,20170516,15955,15860,15890,16050,15890,16050,15960,190,100,22,351.13,38
,20170517,16050,15960,16035,16095,16025,16065,16060,105,100,22,353.39,40
,20170518,16065,16060,16065,16065,15620,15620,15790,-440,-270,6,94.74,42
,20170519,15620,15790,15825,15825,15825,15825,15825,35,35,2,31.65,40
,20170522,15825,15825,16125,16380,16035,16060,16215,235,390,18,291.89,38
,20170523,16060,16215,16225,16465,16225,16270,16310,55,95,10,163.13,34
,20170524,16270,16310,15865,15870,15865,15870,15865,-440,-445,4,63.47,36
,20170525,15870,15865,15960,15960,15960,15960,15960,95,95,2,31.92,36
,20170526,15960,15960,,,,15960,15960,0,0,0,0.00,36
,20170531,15960,15960,15165,15165,15165,15165,15165,-795,-795,2,30.33,36
,20170601,15165,15165,14765,14940,14765,14940,14845,-225,-320,12,178.18,40
,20170602,14940,14845,14885,14885,14815,14815,14850,-30,5,4,59.40,40
,20170605,14815,14850,,,,14850,14850,0,0,0,0.00,40
,20170606,14850,14850,,,,14850,14850,0,0,0,0.00,40
,20170607,14850,14850,14815,14890,14790,14890,14845,40,-5,16,237.58,46
,20170608,14890,14845,14860,14860,14680,14705,14775,-140,-70,8,118.21,50
,20170609,14705,14775,14825,14825,14765,14765,14790,-10,15,6,88.75,54
,20170612,14765,14790,14810,14970,14755,14920,14865,130,75,20,297.33,58
,20170613,14920,14865,14740,14790,14740,14790,14770,-75,-95,6,88.64,52
,20170614,14790,14770,15040,15040,15040,15040,15040,270,270,2,30.08,54
,20170615,15040,15040,15160,15160,15105,15105,15150,65,110,18,272.77,38
,20170616,15105,15150,15255,15405,15110,15210,15225,60,75,60,913.61,42
,20170619,15210,15225,,,,15225,15225,0,0,0,0.00,42
,20170620,15225,15225,15050,15050,15030,15030,15040,-195,-185,4,60.16,44
,20170621,15030,15040,14825,14825,14765,14765,14795,-275,-245,4,59.18,48
,20170622,14765,14795,,,,14795,14795,0,0,0,0.00,48
,20170623,14795,14795,,,,14795,14795,0,0,0,0.00,48
,20170626,14795,14795,,,,14795,14795,0,0,0,0.00,48
,20170627,14795,14795,,,,14795,14795,0,0,0,0.00,48
,20170628,14795,14795,15270,15305,15270,15305,15285,510,490,4,61.15,50
,20170629,15305,15285,15350,15720,15350,15610,15495,325,210,10,154.98,52
,20170630,15610,15495,15410,15470,15310,15430,15385,-65,-110,10,153.86,54
,20170703,15430,15385,,,,15385,15385,0,0,0,0.00,54
,20170704,15385,15385,15240,15240,15010,15010,15095,-375,-290,6,90.57,52
,20170705,15010,15095,15055,15055,15055,15055,15055,-40,-40,2,30.11,50
,20170706,15055,15055,14995,15095,14995,15095,15060,40,5,6,90.37,54
,20170707,15095,15060,15000,15080,15000,15080,15040,20,-20,4,60.16,52
,20170710,15080,15040,14885,14885,14885,14885,14885,-155,-155,10,148.85,62
,20170711,14885,14885,14755,15050,14740,15050,14835,165,-50,10,148.36,72
,20170712,15050,14835,15095,15435,15035,15320,15205,485,370,14,212.93,76
,20170713,15320,15205,,,,15205,15205,0,0,0,0.00,76
,20170714,15205,15205,,,,15205,15205,0,0,0,0.00,76
,20170717,15205,15205,,,,15205,15205,0,0,0,0.00,76
,20170718,15205,15205,15770,15860,15600,15600,15775,395,570,14,220.85,72
,20170719,15600,15775,15885,16575,15840,16575,16245,800,470,26,422.40,62
,20170720,16575,16245,16490,16735,16485,16615,16600,370,355,20,332.02,56
,20170721,16615,16600,16620,16635,16310,16635,16465,35,-135,8,131.75,52
,20170724,16635,16465,16130,16130,16130,16130,16130,-335,-335,2,32.26,52
,20170725,16130,16130,,,,16130,16130,0,0,0,0.00,52
,20170726,16130,16130,16515,16620,16095,16095,16400,-35,270,32,524.88,56
,20170727,16095,16400,16110,16135,16030,16135,16090,-265,-310,6,96.55,60
,20170728,16135,16090,15800,15800,15800,15800,15800,-290,-290,2,31.60,58
,20170731,15800,15800,15365,15620,15360,15620,15480,-180,-320,22,340.63,58
,20170801,15620,15480,15560,15720,15485,15485,15575,5,95,10,155.79,60
,20170802,15485,15575,15485,15565,15375,15375,15465,-200,-110,14,216.55,58
,20170803,15375,15465,15445,15445,15445,15445,15445,-20,-20,2,30.89,58
,20170804,15445,15445,15450,15940,15440,15940,15670,495,225,8,125.39,56
,20170807,15940,15670,15970,16505,15970,16015,16125,345,455,14,225.77,62
,20170808,16015,16125,,,,16160,16160,35,35,0,0.00,62
,20170809,16160,16160,16570,16805,16570,16805,16685,645,525,12,200.27,60
,20170810,16805,16685,,,,16670,16670,-15,-15,0,0.00,60
,20170811,16670,16670,16170,16170,15955,15980,16035,-690,-635,14,224.55,58
,20170814,15980,16035,,,,16035,16035,0,0,0,0.00,58
,20170815,16035,16035,,,,16035,16035,0,0,0,0.00,58
,20170816,16035,16035,,,,16430,16430,395,395,0,0.00,58
,20170817,16430,16430,16620,17130,16615,17075,16905,645,475,12,202.86,62
,20170818,17075,16905,16470,16470,16470,16470,16470,-435,-435,2,32.94,62
,20170821,16470,16470,16765,16950,16765,16950,16875,480,405,6,101.27,64
,20170822,16950,16875,16910,16910,16910,16910,16910,35,35,2,33.82,62
,20170823,16910,16910,16730,16730,16700,16700,16715,-210,-195,4,66.86,64
,20170824,16700,16715,,,,16715,16715,0,0,0,0.00,64
,20170825,16715,16715,17055,17055,16985,16985,17020,270,305,4,68.08,62
,20170828,16985,17020,17010,17010,16790,16790,16900,-230,-120,4,67.60,64
,20170829,16790,16900,16645,16645,16645,16645,16645,-255,-255,2,33.29,62
,20170830,16645,16645,,,,16645,16645,0,0,0,0.00,62
,20170831,16645,16645,16635,16635,16635,16635,16635,-10,-10,2,33.27,62
,20170901,16635,16635,,,,16885,16885,250,250,0,0.00,62
,20170904,16885,16885,17040,17655,17040,17530,17335,645,450,8,138.71,60
,20170905,17530,17335,17620,17620,17620,17620,17620,285,285,2,35.24,60
,20170906,17620,17620,,,,17620,17620,0,0,0,0.00,60
,20170907,17620,17620,17880,17880,17780,17780,17820,160,200,6,106.92,60
,20170908,17780,17820,17440,17640,17440,17640,17540,-180,-280,4,70.16,62
,20170911,17640,17540,,,,17540,17540,0,0,0,0.00,62
,20170912,17540,17540,17065,17065,16950,16950,17025,-590,-515,6,102.16,64
,20170913,16950,17025,17120,17120,17120,17120,17120,95,95,2,34.24,64
,20170914,17120,17120,16980,16980,16980,16980,16980,-140,-140,2,33.96,62
,20170915,16980,16980,16350,16350,16350,16350,16350,-630,-630,2,32.70,64
,20170918,16350,16350,15880,15880,15445,15490,15575,-860,-775,10,155.77,60
,20170919,15490,15575,15345,15345,15345,15345,15345,-230,-230,4,61.38,64
,20170920,15345,15345,15255,15380,15200,15350,15285,5,-60,16,244.57,66
,20170921,15350,15285,15100,15100,15100,15100,15100,-185,-185,2,30.20,66
,20170922,15100,15100,,,,15100,15100,0,0,0,0.00,66
,20170925,15100,15100,14965,14965,14965,14965,14965,-135,-135,2,29.93,66
,20170926,14965,14965,15020,15020,14925,14925,14970,-40,5,4,59.89,62
,20170927,14925,14970,,,,14970,14970,0,0,0,0.00,62
,20170928,14970,14970,14190,14190,13920,13920,13985,-1050,-985,8,111.90,64
,20170929,13920,13985,13695,13770,13635,13770,13685,-215,-300,14,191.60,70
,20171009,13770,13685,,,,13685,13685,0,0,0,0.00,70
,20171010,13685,13685,,,,13685,13685,0,0,0,0.00,70
,20171011,13685,13685,13700,13700,13700,13700,13700,15,15,2,27.40,70
,20171012,13700,13700,13540,13540,13540,13540,13540,-160,-160,2,27.08,72
,20171013,13540,13540,,,,13540,13540,0,0,0,0.00,72
,20171016,13540,13540,13930,14095,13800,13800,13940,260,400,6,83.65,72
,20171017,13800,13940,13890,13890,13715,13715,13830,-225,-110,6,82.99,72
,20171018,13715,13830,,,,13830,13830,0,0,0,0.00,72
,20171019,13830,13830,,,,13830,13830,0,0,0,0.00,72
,20171020,13830,13830,13640,13985,13640,13985,13765,155,-65,10,137.68,72
,20171023,13985,13765,13900,13900,13660,13660,13780,-105,15,4,55.12,76
,20171024,13660,13780,,,,13780,13780,0,0,0,0.00,76
,20171025,13780,13780,,,,13780,13780,0,0,0,0.00,76
,20171026,13780,13780,13860,13860,13850,13850,13855,70,75,4,55.42,74
,20171027,13850,13855,13850,13850,13505,13525,13625,-330,-230,20,272.51,72
,20171030,13525,13625,13545,13635,13545,13635,13605,10,-20,6,81.63,72
,20171031,13635,13605,13635,13635,13555,13580,13595,-25,-10,12,163.19,72
,20171101,13580,13595,14065,14065,14065,14065,14065,470,470,2,28.13,72
,20171102,14065,14065,,,,14065,14065,0,0,0,0.00,72
,20171103,14065,14065,14105,14105,14105,14105,14105,40,40,2,28.21,70
,20171106,14105,14105,14040,14475,13995,14475,14275,370,170,58,828.20,110
,20171107,14475,14275,14445,14480,14280,14280,14420,5,145,8,115.37,116
,20171108,14280,14420,14315,14410,14245,14245,14330,-175,-90,48,687.92,114
,20171109,14245,14330,14205,14425,14150,14155,14230,-175,-100,8,113.87,120
,20171110,14155,14230,14240,14240,14175,14175,14195,-55,-35,6,85.19,120
,20171113,14175,14195,14175,14475,14115,14475,14255,280,60,18,256.61,116
,20171114,14475,14255,14450,14480,14425,14430,14445,175,190,18,260.06,98
,20171115,14430,14445,14485,14485,13630,13630,14090,-815,-355,14,197.27,90
,20171116,13630,14090,13680,13680,13570,13630,13625,-460,-465,6,81.76,90
,20171117,13630,13625,,,,13625,13625,0,0,0,0.00,90
,20171120,13625,13625,13700,13700,13700,13700,13700,75,75,2,27.40,90
,20171121,13700,13700,13700,13700,13700,13700,13700,0,0,4,54.80,90
,20171122,13700,13700,,,,13700,13700,0,0,0,0.00,90
,20171123,13700,13700,14005,14105,13960,13960,14020,260,320,6,84.14,90
,20171124,13960,14020,14010,14060,14010,14060,14035,40,15,4,56.14,92
,20171127,14060,14035,13760,13760,13725,13725,13740,-310,-295,10,137.41,82
,20171128,13725,13740,13730,13730,13680,13680,13700,-60,-40,6,82.20,82
,20171129,13680,13700,13860,14075,13860,14050,13990,350,290,10,139.91,82
,20171130,14050,13990,14095,14215,14035,14160,14130,170,140,18,254.39,82
,20171201,14160,14130,14055,14420,13950,14310,14300,180,170,48,686.55,80
,20171204,14310,14300,14760,14760,14590,14590,14675,290,375,4,58.70,80
,20171205,14590,14675,14760,14760,14655,14670,14685,-5,10,24,352.50,70
,20171206,14670,14685,14595,14595,14265,14265,14375,-420,-310,6,86.25,64
,20171207,14265,14375,14300,14300,14300,14300,14300,-75,-75,2,28.60,64
,20171208,14300,14300,13935,14035,13935,14035,13985,-265,-315,4,55.94,60
,20171211,14035,13985,,,,13985,13985,0,0,0,0.00,60
,20171212,13985,13985,14130,14130,14130,14130,14130,145,145,2,28.26,62
,20171213,14130,14130,,,,14130,14130,0,0,0,0.00,62
,20171214,14130,14130,14340,14340,14340,14340,14340,210,210,2,28.68,60
,20171215,14340,14340,14420,14450,14315,14315,14375,-25,35,80,"1,150.18",60
,20171218,14315,14375,14435,14485,14330,14485,14420,110,45,18,259.57,62
,20171219,14485,14420,14345,14345,14345,14345,14345,-75,-75,2,28.69,64
,20171220,14345,14345,,,,14345,14345,0,0,0,0.00,64
,20171221,14345,14345,14400,14400,14305,14305,14350,-40,5,4,57.41,64
,20171222,14305,14350,14190,14190,13935,13935,14010,-415,-340,32,448.40,68
,20171225,13935,14010,13985,13985,13985,13985,13985,-25,-25,6,83.91,62
,20171226,13985,13985,13915,14200,13915,14200,14095,215,110,12,169.17,68
,20171227,14200,14095,,,,14095,14095,0,0,0,0.00,68
,20171228,14095,14095,14225,14225,14065,14065,14105,-30,10,8,112.84,64
,20171229,14065,14105,14105,14175,14105,14175,14140,70,35,4,56.56,64
ru1805,20170516,15860,15860,16090,16090,15810,16050,15935,190,75,310,"4,939.92",216
,20170517,16050,15935,16165,16165,15900,15925,16035,-10,100,268,"4,297.89",306
,20170518,15925,16035,15940,16000,15560,15705,15765,-330,-270,192,"3,027.76",304
,20170519,15705,15765,15560,16135,15500,16060,15900,295,135,252,"4,007.75",348
,20170522,16060,15900,16000,16420,16000,16050,16240,150,340,206,"3,345.97",382
,20170523,16050,16240,16055,16560,16055,16130,16265,-110,25,240,"3,903.72",464
,20170524,16130,16265,16200,16355,15800,15970,16005,-295,-260,306,"4,897.92",502
,20170525,15970,16005,15950,16120,15850,15920,15975,-85,-30,338,"5,400.59",514
,20170526,15920,15975,15610,16055,15610,15705,15760,-270,-215,388,"6,115.59",570
,20170531,15705,15760,15760,15830,14870,14970,15370,-790,-390,514,"7,900.81",660
,20170601,14970,15370,14980,15070,14760,14875,14890,-495,-480,276,"4,110.87",690
,20170602,14875,14890,14945,15020,14745,14745,14870,-145,-20,216,"3,212.47",728
,20170605,14745,14870,14705,15010,14695,14910,14855,40,-15,322,"4,784.10",800
,20170606,14910,14855,14840,14990,14750,14805,14865,-50,10,280,"4,162.23",856
,20170607,14805,14865,14790,14950,14705,14900,14855,35,-10,308,"4,576.58",920
,20170608,14900,14855,14850,14870,14485,14650,14680,-205,-175,528,"7,751.89",1080
,20170609,14650,14680,14700,14845,14700,14745,14765,65,85,304,"4,488.58",1112
,20170612,14745,14765,14745,14955,14695,14905,14865,140,100,328,"4,875.99",1088
,20170613,14905,14865,14895,14960,14540,14600,14800,-265,-65,486,"7,194.39",1156
,20170614,14600,14800,14645,15300,14580,15205,14965,405,165,870,"13,022.86",1306
,20170615,15205,14965,15225,15270,15020,15150,15135,185,170,406,"6,145.11",1322
,20170616,15150,15135,15135,15425,15095,15215,15255,80,120,656,"10,009.38",1328
,20170619,15215,15255,15270,15275,14920,15090,15100,-165,-155,742,"11,207.26",1362
,20170620,15090,15100,15085,15205,14805,14960,14990,-140,-110,950,"14,244.31",1572
,20170621,14960,14990,14875,14915,14730,14860,14840,-130,-150,500,"7,422.22",1558
,20170622,14860,14840,14970,15100,14725,14760,14940,-80,100,592,"8,845.04",1682
,20170623,14760,14940,14830,14985,14730,14950,14845,10,-95,608,"9,027.79",1688
,20170626,14950,14845,14995,15065,14850,15005,14975,160,130,362,"5,421.36",1756
,20170627,15005,14975,15005,15220,14945,15195,15075,220,100,572,"8,624.79",1824
,20170628,15195,15075,15270,15445,15220,15340,15325,265,250,1028,"15,756.21",2020
,20170629,15340,15325,15310,15795,15250,15610,15490,285,165,1732,"26,832.27",2552
,20170630,15610,15490,15630,15630,15375,15485,15480,-5,-10,1670,"25,854.59",3188
,20170703,15485,15480,15535,15705,15515,15570,15575,90,95,1052,"16,388.29",3660
,20170704,15570,15575,15610,15610,14805,14910,15195,-665,-380,1774,"26,962.24",3742
,20170705,14910,15195,14935,15130,14915,15045,15030,-150,-165,756,"11,364.27",3770
,20170706,15045,15030,15045,15170,14875,15150,15005,120,-25,1204,"18,071.64",3870
,20170707,15150,15005,15155,15290,14960,15130,15105,125,100,1104,"16,678.22",4074
,20170710,15130,15105,15045,15120,14800,14835,14940,-270,-165,4652,"69,513.36",6354
,20170711,14835,14940,14805,15075,14725,14975,14980,35,40,4466,"66,910.96",8446
,20170712,14975,14980,14925,15480,14900,15280,15215,300,235,9204,"140,054.72",12846
,20170713,15280,15215,15265,15400,15125,15345,15250,130,35,5016,"76,512.22",13768
,20170714,15345,15250,15375,15580,15130,15550,15335,300,85,3858,"59,167.33",13652
,20170717,15550,15335,15500,15810,15485,15625,15635,290,300,4084,"63,857.48",14194
,20170718,15625,15635,15635,15935,15610,15765,15790,130,155,4086,"64,533.06",14558
,20170719,15765,15790,15825,16665,15755,16640,16130,850,340,6614,"106,703.46",15282
,20170720,16640,16130,16520,16800,16475,16620,16635,490,505,11494,"191,243.64",15906
,20170721,16620,16635,16655,16710,16260,16515,16465,-120,-170,7932,"130,622.22",16924
,20170724,16515,16465,16435,16545,16090,16155,16290,-310,-175,9758,"158,971.78",17544
,20170725,16155,16290,16150,16560,16115,16435,16370,145,80,9090,"148,809.41",19422
,20170726,16435,16370,16450,16685,16060,16150,16420,-220,50,18026,"296,023.24",23804
,20170727,16150,16420,16085,16285,16000,16285,16165,-135,-255,12210,"197,375.97",26068
,20170728,16285,16165,16300,16510,15150,15330,15775,-835,-390,24462,"385,940.56",29158
,20170731,15330,15775,15345,15780,15310,15660,15555,-115,-220,20738,"322,627.55",33350
,20170801,15660,15555,15660,15810,15470,15540,15640,-15,85,18992,"297,123.70",34216
,20170802,15540,15640,15540,15710,15325,15530,15555,-110,-85,16646,"258,949.39",35944
,20170803,15530,15555,15540,15635,15430,15485,15550,-70,-5,13816,"214,906.44",36508
,20170804,15485,15550,15525,16105,15420,15960,15820,410,270,16964,"268,373.04",37702
,20170807,15960,15820,15965,16560,15965,16230,16220,410,400,24972,"405,093.73",38208
,20170808,16230,16220,16270,16440,16065,16265,16275,45,55,17950,"292,164.64",38608
,20170809,16265,16275,16285,17000,16230,16845,16740,570,465,30162,"504,935.65",40236
,20170810,16845,16740,16840,16975,16560,16700,16745,-40,5,23456,"392,795.17",42016
,20170811,16700,16745,16660,16860,15860,16215,16330,-530,-415,37634,"614,588.50",41810
,20170814,16215,16330,16220,16435,16105,16220,16285,-110,-45,22430,"365,287.26",43038
,20170815,16220,16285,16185,16600,15950,16500,16330,215,45,33106,"540,723.47",44646
,20170816,16500,16330,16485,16680,16415,16555,16535,225,205,22106,"365,620.94",44950
,20170817,16555,16535,16535,17260,16535,16695,16905,160,370,45092,"762,465.81",47084
,20170818,16695,16905,16680,16935,16430,16855,16710,-50,-195,30102,"503,099.04",47218
,20170821,16855,16710,16870,17080,16680,16925,16905,215,195,46092,"779,328.26",48626
,20170822,16925,16905,16935,17100,16650,17010,16895,105,-10,39724,"671,214.24",49430
,20170823,17010,16895,16995,17050,16645,16840,16830,-55,-65,38824,"653,543.86",49866
,20170824,16840,16830,16840,16975,16690,16780,16835,-50,5,39164,"659,426.11",51710
,20170825,16780,16835,16705,17280,16705,17060,17040,225,205,45488,"775,297.14",52398
,20170828,17060,17040,17060,17150,16760,17015,16960,-25,-80,38988,"661,301.00",51910
,20170829,17015,16960,17000,17100,16630,16840,16865,-120,-95,43760,"738,182.47",51708
,20170830,16840,16865,16910,16915,16640,16770,16765,-95,-100,29224,"489,948.00",53392
,20170831,16770,16765,16725,17080,16510,16920,16860,155,95,40072,"675,666.79",55254
,20170901,16920,16860,16925,17090,16910,16970,16990,110,130,27220,"462,487.46",56598
,20170904,16970,16990,16975,17740,16950,17490,17430,500,440,63730,"1,111,022.64",57904
,20170905,17490,17430,17495,17770,17480,17680,17620,250,190,36132,"636,659.33",59888
,20170906,17680,17620,17825,18120,17505,17895,17840,275,220,51956,"927,008.44",61522
,20170907,17895,17840,17905,18015,17680,17815,17845,-25,5,41024,"732,196.63",62582
,20170908,17815,17845,17825,17850,16855,17080,17425,-765,-420,62732,"1,093,295.71",62202
,20170911,17080,17425,17150,17180,16630,16985,16930,-440,-495,49620,"840,212.67",62468
,20170912,16985,16930,17025,17190,16920,17090,17050,160,120,39140,"667,502.31",64618
,20170913,17090,17050,17070,17380,16990,17100,17160,50,110,44704,"767,215.80",65976
,20170914,17100,17160,17070,17085,16705,16740,16905,-420,-255,56918,"962,233.05",65682
,20170915,16740,16905,16760,16820,16020,16045,16440,-860,-465,70504,"1,159,314.45",65342
,20170918,16045,16440,16110,16150,15390,15550,15680,-890,-760,75608,"1,185,669.78",62770
,20170919,15550,15680,15555,15680,15300,15340,15540,-340,-140,42198,"655,817.78",61936
,20170920,15340,15540,15385,15560,15165,15465,15360,-75,-180,50296,"772,708.03",64032
,20170921,15465,15360,15505,15580,14840,14905,15195,-455,-165,85694,"1,302,332.53",67532
,20170922,14905,15195,14940,15050,14730,14960,14920,-235,-275,56828,"848,126.00",67924
,20170925,14960,14920,15085,15140,14840,14965,14980,45,60,47850,"716,993.45",69570
,20170926,14965,14980,14980,15180,14870,14995,15020,15,40,48582,"729,861.28",70618
,20170927,14995,15020,14940,15090,14880,15010,14995,-10,-25,35458,"531,832.65",70426
,20170928,15010,14995,15000,15040,13945,13945,14330,-1050,-665,72068,"1,032,959.36",67434
,20170929,13945,14330,13875,13970,13355,13950,13695,-380,-635,89744,"1,229,488.29",70542
,20171009,13950,13695,14040,14100,13610,13765,13785,70,90,52612,"725,336.82",77314
,20171010,13765,13785,13765,13890,13680,13740,13795,-45,10,47172,"650,779.63",81670
,20171011,13740,13795,13775,13885,13365,13675,13645,-120,-150,69666,"950,831.96",85242
,20171012,13675,13645,13550,13965,13480,13820,13685,175,40,63462,"868,569.34",86448
,20171013,13820,13685,13835,14100,13795,14015,13945,330,260,64868,"904,675.49",89116
,20171016,14015,13945,14050,14345,13865,14030,14050,85,105,87196,"1,225,236.04",91778
,20171017,14030,14050,14035,14105,13670,13975,13915,-75,-135,94950,"1,321,247.30",95178
,20171018,13975,13915,13995,14150,13920,14025,14040,110,125,68510,"961,978.96",94388
,20171019,14025,14040,14060,14220,13810,13840,14015,-200,-25,96116,"1,347,328.82",97098
,20171020,13840,14015,13810,14230,13700,14145,13990,130,-25,84342,"1,180,080.31",94876
,20171023,14145,13990,14150,14300,13800,13950,13975,-40,-15,91180,"1,274,423.07",100066
,20171024,13950,13975,13975,14075,13850,13890,13950,-85,-25,96416,"1,345,403.15",107598
,20171025,13890,13950,13900,14120,13705,13985,13965,35,15,97336,"1,359,586.64",104104
,20171026,13985,13965,13990,14095,13815,14015,13975,50,10,78112,"1,091,717.71",105162
,20171027,14015,13975,14050,14070,13610,13800,13900,-175,-75,114426,"1,590,551.00",113880
,20171030,13800,13900,13760,13890,13705,13755,13790,-145,-110,75624,"1,043,180.58",118950
,20171031,13755,13790,13780,13815,13630,13735,13740,-55,-50,75138,"1,032,700.69",120862
,20171101,13735,13740,13780,14275,13760,14060,14030,320,290,136264,"1,912,316.79",119118
,20171102,14060,14030,14055,14365,13950,14255,14190,225,160,122600,"1,740,277.96",123292
,20171103,14255,14190,14205,14285,14065,14150,14180,-40,-10,94348,"1,338,074.12",127484
,20171106,14150,14180,14135,14675,14115,14605,14445,425,265,148716,"2,148,416.05",134618
,20171107,14605,14445,14600,14685,14320,14475,14515,30,70,131928,"1,915,317.59",142974
,20171108,14475,14515,14400,14485,14245,14290,14385,-225,-130,131396,"1,890,751.44",148522
,20171109,14290,14385,14290,14610,14205,14270,14400,-115,15,203400,"2,929,491.08",154150
,20171110,14270,14400,14220,14420,14220,14345,14335,-55,-65,121800,"1,746,224.50",158204
,20171113,14345,14335,14330,14710,14235,14620,14505,285,170,204994,"2,974,152.79",163266
,20171114,14620,14505,14570,14765,14520,14570,14630,65,125,161306,"2,360,602.29",166022
,20171115,14570,14630,14550,14655,13670,13735,14015,-895,-615,246760,"3,458,823.41",166050
,20171116,13735,14015,13750,13875,13630,13720,13765,-295,-250,121080,"1,666,906.40",171076
,20171117,13720,13765,13775,13830,13700,13750,13765,-15,0,111654,"1,537,203.50",173430
,20171120,13750,13765,13765,13905,13650,13855,13785,90,20,126224,"1,740,332.64",175650
,20171121,13855,13785,13860,13950,13285,13820,13690,35,-95,259742,"3,556,905.84",187856
,20171122,13820,13690,13820,13935,13730,13855,13835,165,145,180838,"2,502,769.40",192812
,20171123,13855,13835,13865,14295,13835,14200,14155,365,320,293618,"4,157,436.32",197198
,20171124,14200,14155,14180,14370,14135,14315,14265,160,110,241402,"3,444,100.85",211392
,20171127,14315,14265,14320,14415,13780,13825,14085,-440,-180,377592,"5,320,026.54",223494
,20171128,13825,14085,13825,14045,13720,13980,13880,-105,-205,310772,"4,314,380.17",234184
,20171129,13980,13880,13965,14295,13915,14210,14140,330,260,421974,"5,968,464.20",256994
,20171130,14210,14140,14175,14375,13850,13915,14130,-225,-10,525600,"7,429,011.36",269204
,20171201,13915,14130,13990,14590,13955,14525,14315,395,185,680188,"9,738,700.91",306818
,20171204,14525,14315,14760,15020,14565,14925,14795,610,480,632140,"9,354,801.82",328288
,20171205,14925,14795,14945,14950,14575,14715,14770,-80,-25,535360,"7,908,104.11",332458
,20171206,14715,14770,14650,14755,14025,14330,14365,-440,-405,615300,"8,838,985.16",317406
,20171207,14330,14365,14330,14500,13800,13970,14280,-395,-85,768078,"10,968,556.04",317688
,20171208,13970,14280,14010,14150,13855,14065,14020,-215,-260,512426,"7,186,426.86",317742
,20171211,14065,14020,14100,14310,13880,14020,14075,0,55,663120,"9,335,923.23",320290
,20171212,14020,14075,14050,14250,13975,14165,14115,90,40,499498,"7,050,776.72",327168
,20171213,14165,14115,14165,14260,13935,14080,14075,-35,-40,571220,"8,042,755.41",331210
,20171214,14080,14075,14080,14460,13990,14280,14240,205,165,732182,"10,429,703.49",333112
,20171215,14280,14240,14290,14500,14250,14415,14365,175,125,485676,"6,978,398.22",339872
,20171218,14415,14365,14450,14725,14385,14560,14535,195,170,602080,"8,753,037.71",351980
,20171219,14560,14535,14560,14560,14250,14420,14410,-115,-125,417764,"6,021,701.62",344600
,20171220,14420,14410,14450,14580,14350,14470,14460,60,50,426326,"6,166,167.06",350954
,20171221,14470,14460,14480,14620,14300,14365,14430,-95,-30,441452,"6,370,226.82",354924
,20171222,14365,14430,14360,14400,13890,14005,14095,-425,-335,695814,"9,808,522.02",361582
,20171225,14005,14095,14050,14210,13980,14030,14080,-65,-15,429952,"6,055,026.85",367588
,20171226,14030,14080,14025,14400,13700,14315,14185,235,105,619972,"8,797,268.26",364198
,20171227,14315,14185,14300,14410,14135,14170,14280,-15,95,451242,"6,444,644.78",365680
,20171228,14170,14280,14170,14250,13950,14200,14130,-80,-150,489628,"6,918,536.08",364728
,20171229,14200,14130,14170,14255,14035,14105,14140,-25,10,388104,"5,489,483.69",361926
ru1806,20170616,15135,15135,,,,15135,15135,0,0,0,0.00,0
,20170619,15135,15135,15005,15340,15005,15340,15170,205,35,4,60.69,2
,20170620,15340,15170,14935,15160,14935,14980,15065,-190,-105,12,180.78,6
,20170621,14980,15065,14880,14880,14880,14880,14880,-185,-185,2,29.76,8
,20170622,14880,14880,,,,14880,14880,0,0,0,0.00,8
,20170623,14880,14880,,,,14880,14880,0,0,0,0.00,8
,20170626,14880,14880,14940,14940,14940,14940,14940,60,60,2,29.88,10
,20170627,14940,14940,15020,15020,15020,15020,15020,80,80,2,30.04,8
,20170628,15020,15020,,,,15020,15020,0,0,0,0.00,8
,20170629,15020,15020,15620,15620,15620,15620,15620,600,600,6,93.72,6
,20170630,15620,15620,,,,15620,15620,0,0,0,0.00,6
,20170703,15620,15620,15635,15635,15630,15630,15630,10,10,4,62.53,10
,20170704,15630,15630,15305,15305,15050,15050,15180,-580,-450,8,121.45,14
,20170705,15050,15180,15110,15110,14960,14960,15010,-220,-170,6,90.06,18
,20170706,14960,15010,,,,15010,15010,0,0,0,0.00,18
,20170707,15010,15010,,,,15010,15010,0,0,0,0.00,18
,20170710,15010,15010,14995,14995,14895,14930,14930,-80,-80,22,328.52,30
,20170711,14930,14930,14930,15050,14930,15050,14990,120,60,4,59.96,28
,20170712,15050,14990,15095,15370,15095,15275,15195,285,205,42,638.28,30
,20170713,15275,15195,15180,15270,15180,15270,15225,75,30,4,60.90,30
,20170714,15270,15225,,,,15225,15225,0,0,0,0.00,30
,20170717,15225,15225,15710,15885,15710,15885,15795,660,570,4,63.19,32
,20170718,15885,15795,15785,15905,15660,15660,15765,-135,-30,24,378.38,34
,20170719,15660,15765,15730,16450,15730,16450,16040,685,275,12,192.53,36
,20170720,16450,16040,16460,16765,16460,16620,16620,580,580,18,299.23,48
,20170721,16620,16620,16395,16485,16395,16485,16425,-135,-195,16,262.86,44
,20170724,16485,16425,16245,16335,16245,16335,16290,-90,-135,4,65.16,44
,20170725,16335,16290,16535,16535,16400,16400,16465,110,175,4,65.87,48
,20170726,16400,16465,16560,16600,16135,16135,16395,-330,-70,20,327.95,46
,20170727,16135,16395,16220,16220,16220,16220,16220,-175,-175,4,64.88,48
,20170728,16220,16220,16255,16370,15325,15370,15770,-850,-450,38,599.26,66
,20170731,15370,15770,15365,15685,15360,15610,15530,-160,-240,16,248.53,62
,20170801,15610,15530,15655,15755,15515,15515,15700,-15,170,32,502.41,58
,20170802,15515,15700,15615,15615,15520,15570,15550,-130,-150,36,559.91,52
,20170803,15570,15550,15590,15605,15500,15500,15540,-50,-10,12,186.48,56
,20170804,15500,15540,15515,16070,15515,16070,15930,530,390,8,127.45,52
,20170807,16070,15930,16385,16410,16150,16285,16305,355,375,12,195.66,56
,20170808,16285,16305,16315,16350,16285,16285,16315,-20,10,6,97.90,58
,20170809,16285,16315,16335,16970,16335,16920,16740,605,425,16,267.90,58
,20170810,16920,16740,16765,16765,16765,16765,16765,25,25,2,33.53,58
,20170811,16765,16765,16260,16260,16000,16000,16080,-765,-685,20,321.67,60
,20170814,16000,16080,16250,16390,16250,16310,16320,230,240,16,261.16,66
,20170815,16310,16320,16300,16420,16300,16420,16360,100,40,4,65.44,70
,20170816,16420,16360,16570,16660,16570,16585,16605,225,245,8,132.87,72
,20170817,16585,16605,16780,17295,16760,16760,16980,155,375,18,305.70,72
,20170818,16760,16980,16765,16895,16565,16895,16735,-85,-245,14,234.33,74
,20170821,16895,16735,16935,17115,16845,17115,16935,380,200,8,135.51,74
,20170822,17115,16935,16850,17050,16850,17050,16950,115,15,4,67.80,72
,20170823,17050,16950,16885,16890,16885,16890,16885,-60,-65,4,67.55,74
,20170824,16890,16885,16885,16885,16860,16860,16870,-25,-15,4,67.49,72
,20170825,16860,16870,17155,17245,17075,17140,17165,270,295,14,240.33,66
,20170828,17140,17165,,,,17165,17165,0,0,0,0.00,66
,20170829,17165,17165,17030,17030,16810,16900,16920,-265,-245,94,"1,590.82",132
,20170830,16900,16920,16830,16830,16605,16660,16715,-260,-205,978,"16,351.45",1032
,20170831,16660,16715,16550,16955,16540,16855,16755,140,40,14,234.59,1030
,20170901,16855,16755,16905,16925,16850,16850,16900,95,145,20,338.02,1040
,20170904,16850,16900,16930,17595,16930,17400,17245,500,345,30,517.47,1048
,20170905,17400,17245,17565,17605,17515,17605,17575,360,330,22,386.72,1056
,20170906,17605,17575,17610,18035,17595,17810,17835,235,260,44,784.83,1070
,20170907,17810,17835,17750,17760,17750,17760,17755,-75,-80,4,71.02,1072
,20170908,17760,17755,17555,17630,16895,17020,17360,-735,-395,22,382.01,1076
,20170911,17020,17360,17025,17025,16635,16750,16810,-610,-550,18,302.66,1078
,20170912,16750,16810,16920,17060,16785,16935,16900,125,90,18,304.27,1084
,20170913,16935,16900,17015,17035,17000,17035,17015,135,115,6,102.10,1086
,20170914,17035,17015,16675,16795,16675,16720,16730,-295,-285,10,167.32,1088
,20170915,16720,16730,16270,16270,16085,16190,16165,-540,-565,8,129.32,1092
,20170918,16190,16165,15970,15970,15390,15480,15570,-685,-595,38,591.73,1088
,20170919,15480,15570,15475,15565,15465,15465,15495,-105,-75,24,371.92,1082
,20170920,15465,15495,,,,15495,15495,0,0,0,0.00,1082
,20170921,15495,15495,15430,15460,15035,15035,15205,-460,-290,22,334.53,1094
,20170922,15035,15205,14785,14785,14785,14785,14785,-420,-420,2,29.57,1094
,20170925,14785,14785,,,,14785,14785,0,0,0,0.00,1094
,20170926,14785,14785,14975,14975,14975,14975,14975,190,190,2,29.95,1094
,20170927,14975,14975,,,,14975,14975,0,0,0,0.00,1094
,20170928,14975,14975,14505,14505,13925,13925,14055,-1050,-920,26,365.48,1090
,20170929,13925,14055,13770,13925,13345,13900,13620,-155,-435,60,817.37,1092
,20171009,13900,13620,13900,13925,13650,13650,13775,30,155,16,220.47,1090
,20171010,13650,13775,13760,13770,13705,13745,13740,-30,-35,12,164.91,1090
,20171011,13745,13740,13745,13780,13360,13695,13685,-45,-55,42,574.82,1098
,20171012,13695,13685,13615,13720,13595,13665,13665,-20,-20,26,355.37,1100
,20171013,13665,13665,13365,14060,13365,14060,13860,395,195,42,582.17,1092
,20171016,14060,13860,14020,14260,14020,14065,14115,205,255,6,84.69,1090
,20171017,14065,14115,13965,14065,13700,13940,13935,-175,-180,82,"1,142.71",1126
,20171018,13940,13935,14380,14380,13965,14050,14055,115,120,68,955.87,1164
,20171019,14050,14055,14055,14140,13850,13870,14035,-185,-20,64,898.43,1190
,20171020,13870,14035,13815,14145,13815,14145,13945,110,-90,20,278.90,1186
,20171023,14145,13945,14185,14185,13935,13950,14005,5,60,34,476.28,1188
,20171024,13950,14005,13930,13980,13870,13875,13900,-130,-105,18,250.24,1194
,20171025,13875,13900,13905,14095,13800,13965,13985,65,85,34,475.55,1184
,20171026,13965,13985,13980,13980,13980,13980,13980,-5,-5,20,279.60,1188
,20171027,13980,13980,13985,13985,13760,13800,13820,-180,-160,112,"1,548.18",1108
,20171030,13800,13820,13795,13860,13735,13735,13785,-85,-35,16,220.58,1102
,20171031,13735,13785,13715,13750,13715,13745,13740,-40,-45,10,137.41,1100
,20171101,13745,13740,13500,14250,13500,14095,14095,355,355,70,986.86,1104
,20171102,14095,14095,14050,14220,14050,14200,14155,105,60,6,84.94,1106
,20171103,14200,14155,14220,14220,14080,14115,14155,-40,0,98,"1,387.67",1090
,20171106,14115,14155,14145,14600,14090,14585,14445,430,290,72,"1,040.31",1096
,20171107,14585,14445,14885,14885,14310,14430,14470,-15,25,68,984.14,1094
,20171108,14430,14470,14405,14460,14275,14275,14355,-195,-115,196,"2,813.77",1102
,20171109,14275,14355,14275,14520,14275,14295,14360,-60,5,36,517.08,1108
,20171110,14295,14360,14310,14370,14310,14355,14340,-5,-20,12,172.12,1110
,20171113,14355,14340,14350,14635,14300,14565,14520,225,180,94,"1,365.26",1112
,20171114,14565,14520,14600,14675,14530,14595,14605,75,85,46,672.00,1094
,20171115,14595,14605,14625,14660,13635,13795,14020,-810,-585,100,"1,402.22",1106
,20171116,13795,14020,13780,13820,13670,13670,13770,-350,-250,104,"1,432.22",1110
,20171117,13670,13770,13810,13820,13740,13740,13780,-30,10,28,385.91,1108
,20171120,13740,13780,13760,13850,13760,13845,13805,65,25,36,497.01,1096
,20171121,13845,13805,13805,13855,13350,13795,13685,-10,-120,82,"1,122.30",1092
,20171122,13795,13685,14075,14075,13800,13855,13850,170,165,82,"1,135.81",1110
,20171123,13855,13850,14130,14255,13850,14160,14140,310,290,146,"2,064.98",1094
,20171124,14160,14140,14180,14510,14135,14330,14310,190,170,594,"8,500.47",648
,20171127,14330,14310,14345,14400,13860,13970,14165,-340,-145,764,"10,822.49",286
,20171128,13970,14165,14125,14125,13885,14090,13970,-75,-195,76,"1,062.00",308
,20171129,14090,13970,14260,14390,14245,14325,14335,355,365,56,802.99,306
,20171130,14325,14335,14305,14465,14040,14065,14275,-270,-60,92,"1,313.49",350
,20171201,14065,14275,14180,14655,14105,14585,14420,310,145,180,"2,595.84",286
,20171204,14585,14420,15030,15030,14945,15010,14985,590,565,18,269.77,276
,20171205,15010,14985,14935,14955,14725,14805,14825,-180,-160,112,"1,660.71",256
,20171206,14805,14825,14425,14450,14165,14415,14385,-410,-440,34,489.14,256
,20171207,14415,14385,14395,14555,13905,14035,14265,-350,-120,78,"1,112.81",252
,20171208,14035,14265,14040,14205,13990,14180,14085,-85,-180,72,"1,014.43",250
,20171211,14180,14085,14130,14130,13955,14065,14065,-20,-20,28,393.87,246
,20171212,14065,14065,14145,14265,14145,14165,14200,100,135,40,568.14,244
,20171213,14165,14200,14255,14275,14140,14170,14200,-30,0,16,227.25,246
,20171214,14170,14200,14330,14530,14320,14385,14405,185,205,18,259.35,246
,20171215,14385,14405,14420,14570,14415,14530,14480,125,75,20,289.60,244
,20171218,14530,14480,14545,14785,14515,14665,14655,185,175,32,468.96,246
,20171219,14665,14655,14500,14510,14480,14480,14495,-175,-160,6,86.98,246
,20171220,14480,14495,14480,14685,14480,14505,14585,10,90,260,"3,792.88",252
,20171221,14505,14585,14605,14615,14445,14490,14530,-95,-55,16,232.48,254
,20171222,14490,14530,14485,14485,14040,14100,14155,-430,-375,74,"1,047.68",250
,20171225,14100,14155,14240,14285,14240,14285,14255,130,100,6,85.53,250
,20171226,14285,14255,13940,14460,13850,14405,14155,150,-100,30,424.68,240
,20171227,14405,14155,14380,14475,14280,14280,14385,125,230,20,287.74,242
,20171228,14280,14385,14315,14315,14080,14135,14210,-250,-175,8,113.69,242
,20171229,14135,14210,14320,14320,14220,14235,14250,25,40,14,199.54,248
ru1807,20170718,15795,15795,15775,15775,15720,15720,15745,-75,-50,4,62.99,2
,20170719,15720,15745,15905,16740,15905,16740,16320,995,575,4,65.29,4
,20170720,16740,16320,,,,16320,16320,0,0,0,0.00,4
,20170721,16320,16320,,,,16320,16320,0,0,0,0.00,4
,20170724,16320,16320,16520,16520,16155,16220,16235,-100,-85,14,227.29,12
,20170725,16220,16235,16340,16390,16230,16390,16320,155,85,6,97.92,12
,20170726,16390,16320,16350,16360,16340,16360,16350,40,30,6,98.10,14
,20170727,16360,16350,16220,16220,16220,16220,16220,-130,-130,2,32.44,16
,20170728,16220,16220,16235,16235,16200,16205,16215,-15,-5,8,129.75,22
,20170731,16205,16215,15730,15740,15730,15740,15735,-475,-480,4,62.94,22
,20170801,15740,15735,15720,15720,15720,15720,15720,-15,-15,2,31.44,22
,20170802,15720,15720,15530,15680,15515,15680,15575,-40,-145,10,155.78,28
,20170803,15680,15575,15750,15750,15640,15640,15695,65,120,4,62.78,28
,20170804,15640,15695,16140,16140,16080,16080,16110,385,415,4,64.44,26
,20170807,16080,16110,16220,16340,16220,16295,16300,185,190,22,358.67,34
,20170808,16295,16300,,,,16300,16300,0,0,0,0.00,34
,20170809,16300,16300,16510,16990,16510,16990,16805,690,505,8,134.45,28
,20170810,16990,16805,17090,17115,16825,16825,17010,20,205,6,102.06,28
,20170811,16825,17010,16905,17010,16320,16320,16805,-690,-205,10,168.05,30
,20170814,16320,16805,,,,16805,16805,0,0,0,0.00,30
,20170815,16805,16805,16600,16600,16600,16600,16600,-205,-205,4,66.40,30
,20170816,16600,16600,16700,16730,16700,16730,16715,130,115,4,66.86,30
,20170817,16730,16715,16860,17210,16860,16860,16975,145,260,6,101.86,32
,20170818,16860,16975,16710,16710,16710,16710,16710,-265,-265,2,33.42,30
,20170821,16710,16710,16940,17200,16940,17200,17070,490,360,4,68.28,30
,20170822,17200,17070,16990,17210,16895,17210,17030,140,-40,6,102.19,28
,20170823,17210,17030,,,,17030,17030,0,0,0,0.00,28
,20170824,17030,17030,,,,17030,17030,0,0,0,0.00,28
,20170825,17030,17030,,,,17030,17030,0,0,0,0.00,28
,20170828,17030,17030,,,,17030,17030,0,0,0,0.00,28
,20170829,17030,17030,16990,16990,16990,16990,16990,-40,-40,2,33.98,28
,20170830,16990,16990,16990,16990,16460,16460,16615,-530,-375,298,"4,951.84",270
,20170831,16460,16615,16390,16880,16390,16880,16695,265,80,20,333.94,276
,20170901,16880,16695,16750,16810,16610,16645,16700,-50,5,146,"2,438.46",402
,20170904,16645,16700,16645,17345,16590,17280,17080,580,380,120,"2,050.12",416
,20170905,17280,17080,17240,17595,17225,17440,17390,360,310,88,"1,530.40",438
,20170906,17440,17390,17520,17885,17260,17790,17510,400,120,110,"1,926.27",506
,20170907,17790,17510,17660,17660,17375,17475,17560,-35,50,84,"1,475.32",536
,20170908,17475,17560,17290,17290,16690,16690,17010,-870,-550,10,170.13,544
,20170911,16690,17010,16840,16840,16365,16570,16510,-440,-500,498,"8,222.52",876
,20170912,16570,16510,16675,16740,16570,16670,16665,160,155,106,"1,766.65",914
,20170913,16670,16665,16625,16970,16625,16740,16790,75,125,24,402.96,918
,20170914,16740,16790,16585,16670,16395,16395,16555,-395,-235,100,"1,655.55",916
,20170915,16395,16555,16370,16425,15675,15675,16245,-880,-310,100,"1,624.59",920
,20170918,15675,16245,15785,15960,15250,15500,15775,-745,-470,800,"12,623.86",1012
,20170919,15500,15775,15490,15550,15400,15400,15470,-375,-305,24,371.35,1008
,20170920,15400,15470,15065,15320,15065,15280,15240,-190,-230,290,"4,420.80",1236
,20170921,15280,15240,15420,15450,14785,14790,15240,-450,0,66,"1,006.11",1232
,20170922,14790,15240,14855,14925,14715,14830,14810,-410,-430,24,355.46,1238
,20170925,14830,14810,14940,14995,14785,14785,14885,-25,75,14,208.45,1236
,20170926,14785,14885,14900,15025,14855,14905,14930,20,45,12,179.17,1234
,20170927,14905,14930,14830,14950,14830,14900,14940,-30,10,122,"1,823.08",1232
,20170928,14900,14940,14890,14955,13890,13890,14250,-1050,-690,90,"1,282.83",1264
,20170929,13890,14250,13820,13950,13380,13950,13750,-300,-500,106,"1,457.82",1246
,20171009,13950,13750,13775,13975,13775,13850,13830,100,80,50,691.70,1230
,20171010,13850,13830,13825,13960,13800,13800,13855,-30,25,16,221.73,1232
,20171011,13800,13855,13780,13935,13675,13795,13785,-60,-70,34,468.84,1234
,20171012,13795,13785,13720,14080,13670,14080,13815,295,30,100,"1,381.59",1234
,20171013,14080,13815,13970,14110,13950,14105,14020,290,205,28,392.64,1224
,20171016,14105,14020,14135,14250,14000,14140,14130,120,110,46,650.12,1220
,20171017,14140,14130,14180,14190,13865,14115,14095,-15,-35,48,676.78,1218
,20171018,14115,14095,14225,14225,14065,14100,14175,5,80,162,"2,296.84",1216
,20171019,14100,14175,14090,14280,14005,14015,14145,-160,-30,32,452.65,1212
,20171020,14015,14145,13905,14210,13905,14200,14050,55,-95,14,196.75,1210
,20171023,14200,14050,14120,14120,14000,14050,14050,0,0,28,393.41,1216
,20171024,14050,14050,14055,14055,13975,13980,14010,-70,-40,40,560.56,1210
,20171025,13980,14010,13910,14115,13910,14020,14030,10,20,22,308.67,1208
,20171026,14020,14030,14080,14080,13980,13980,13980,-50,-50,42,587.36,1208
,20171027,13980,13980,13980,14115,13675,13675,13995,-305,15,18,251.95,1212
,20171030,13675,13995,13840,13880,13825,13835,13835,-160,-160,18,249.06,1210
,20171031,13835,13835,13860,13860,13860,13860,13860,25,25,2,27.72,1212
,20171101,13860,13860,14195,14295,14140,14150,14195,290,335,42,596.28,1216
,20171102,14150,14195,14090,14345,14090,14300,14260,105,65,14,199.67,1214
,20171103,14300,14260,,,,14260,14260,0,0,0,0.00,1214
,20171106,14260,14260,14215,14630,14215,14630,14475,370,215,24,347.51,1212
,20171107,14630,14475,14560,14685,14400,14500,14565,25,90,24,349.57,1210
,20171108,14500,14565,14500,14500,14390,14390,14470,-175,-95,8,115.76,1218
,20171109,14390,14470,14395,14560,14335,14375,14430,-95,-40,16,230.89,1220
,20171110,14375,14430,14415,14415,14385,14410,14400,-20,-30,6,86.42,1224
,20171113,14410,14400,14500,14750,14430,14635,14625,235,225,68,994.62,1192
,20171114,14635,14625,14645,14760,14610,14610,14690,-15,65,20,293.81,1192
,20171115,14610,14690,14625,14625,13705,13870,14080,-820,-610,36,506.99,1192
,20171116,13870,14080,13820,13835,13800,13800,13815,-280,-265,8,110.53,1194
,20171117,13800,13815,13800,13895,13800,13815,13835,0,20,20,276.77,1190
,20171120,13815,13835,13850,13850,13850,13850,13850,15,15,2,27.70,1190
,20171121,13850,13850,13855,13905,13680,13905,13825,55,-25,20,276.59,1186
,20171122,13905,13825,13885,13950,13850,13920,13895,95,70,28,389.19,1186
,20171123,13920,13895,13955,14280,13955,14245,14185,350,290,12,170.25,1182
,20171124,14245,14185,14310,14375,14310,14350,14345,165,160,14,200.87,1182
,20171127,14350,14345,14265,14265,13910,14025,14030,-320,-315,980,"13,753.43",438
,20171128,14025,14030,14105,14210,13990,14175,14080,145,50,126,"1,774.16",438
,20171129,14175,14080,14215,14480,14170,14365,14365,285,285,34,488.56,434
,20171130,14365,14365,14460,14525,14065,14200,14330,-165,-35,56,802.72,394
,20171201,14200,14330,14235,14720,14195,14670,14395,340,65,118,"1,699.18",310
,20171204,14670,14395,14910,15175,14740,15070,15030,675,635,92,"1,382.87",272
,20171205,15070,15030,15030,15070,14835,14835,14970,-195,-60,86,"1,287.70",272
,20171206,14835,14970,14430,14535,14430,14500,14490,-470,-480,16,231.84,268
,20171207,14500,14490,14575,14640,14445,14445,14545,-45,55,18,261.82,268
,20171208,14445,14545,14195,14300,14195,14300,14245,-245,-300,4,56.99,266
,20171211,14300,14245,14415,14415,14215,14285,14305,40,60,6,85.83,268
,20171212,14285,14305,14360,14365,14315,14360,14340,55,35,10,143.43,268
,20171213,14360,14340,14390,14390,14300,14305,14335,-35,-5,12,172.03,264
,20171214,14305,14335,14430,14635,14355,14440,14470,105,135,36,521.07,258
,20171215,14440,14470,14460,14510,14460,14510,14485,40,15,6,86.91,254
,20171218,14510,14485,14655,14790,14635,14775,14700,290,215,24,352.86,250
,20171219,14775,14700,14540,14565,14540,14565,14545,-135,-155,28,407.37,262
,20171220,14565,14545,14670,14670,14580,14580,14625,35,80,4,58.50,262
,20171221,14580,14625,14620,14620,14580,14600,14600,-25,-25,6,87.60,262
,20171222,14600,14600,14405,14405,14280,14280,14305,-320,-295,20,286.12,280
,20171225,14280,14305,14260,14315,14260,14315,14285,10,-20,4,57.15,278
,20171226,14315,14285,14045,14550,13950,14550,14165,265,-120,18,255.05,282
,20171227,14550,14165,14560,14560,14380,14380,14455,215,290,26,375.86,264
,20171228,14380,14455,,,,14455,14455,0,0,0,0.00,264
,20171229,14455,14455,14300,14300,14300,14300,14300,-155,-155,2,28.60,262
ru1808,20170816,16600,16600,,,,16600,16600,0,0,0,0.00,0
,20170817,16600,16600,16960,16960,16960,16960,16960,360,360,2,33.92,2
,20170818,16960,16960,,,,16960,16960,0,0,0,0.00,2
,20170821,16960,16960,,,,16960,16960,0,0,0,0.00,2
,20170822,16960,16960,,,,16960,16960,0,0,0,0.00,2
,20170823,16960,16960,17155,17155,17090,17090,17130,130,170,6,102.80,6
,20170824,17090,17130,16835,16835,16835,16835,16835,-295,-295,2,33.67,6
,20170825,16835,16835,,,,16835,16835,0,0,0,0.00,6
,20170828,16835,16835,17160,17160,17160,17160,17160,325,325,4,68.64,6
,20170829,17160,17160,,,,17160,17160,0,0,0,0.00,6
,20170830,17160,17160,16875,16875,16580,16580,16700,-580,-460,46,768.34,36
,20170831,16580,16700,16885,16885,16885,16885,16885,185,185,2,33.77,36
,20170901,16885,16885,16645,16990,16645,16750,16840,-135,-45,10,168.41,40
,20170904,16750,16840,,,,16840,16840,0,0,0,0.00,40
,20170905,16840,16840,17140,17560,17125,17475,17290,635,450,40,691.66,44
,20170906,17475,17290,17445,17900,17445,17765,17615,475,325,40,704.76,70
,20170907,17765,17615,17660,17710,17495,17570,17630,-45,15,42,740.60,96
,20170908,17570,17630,17475,17475,17195,17195,17355,-435,-275,8,138.87,96
,20170911,17195,17355,16885,17050,16340,16650,16675,-705,-680,44,733.82,114
,20170912,16650,16675,16780,16820,16630,16735,16745,60,70,76,"1,272.89",166
,20170913,16735,16745,16720,16925,16720,16800,16795,55,50,14,235.16,174
,20170914,16800,16795,16565,16625,16520,16520,16575,-275,-220,8,132.62,178
,20170915,16520,16575,16420,16420,16350,16350,16385,-225,-190,4,65.54,176
,20170918,16350,16385,15870,16075,15455,15540,15735,-845,-650,138,"2,171.53",208
,20170919,15540,15735,15585,15600,15540,15540,15595,-195,-140,212,"3,307.01",398
,20170920,15540,15595,15225,15430,15225,15430,15305,-165,-290,8,122.46,402
,20170921,15430,15305,15535,15575,14860,15045,15095,-260,-210,798,"12,047.20",1160
,20170922,15045,15095,14840,14950,14820,14820,14860,-275,-235,30,445.85,1166
,20170925,14820,14860,15035,15035,15035,15035,15035,175,175,2,30.07,1164
,20170926,15035,15035,15035,15035,14980,14980,15005,-55,-30,4,60.03,1162
,20170927,14980,15005,14950,15000,14895,15000,14935,-5,-70,12,179.26,1168
,20170928,15000,14935,14995,15010,13885,13885,14565,-1050,-370,86,"1,252.83",1180
,20170929,13885,14565,13885,14055,13500,14055,13815,-510,-750,54,746.13,1168
,20171009,14055,13815,,,,13900,13900,85,85,0,0.00,1168
,20171010,13900,13900,13890,13955,13885,13885,13905,-15,5,8,111.26,1168
,20171011,13885,13905,13925,13925,13800,13800,13860,-105,-45,4,55.45,1166
,20171012,13800,13860,13870,13985,13775,13985,13855,125,-5,22,304.82,1166
,20171013,13985,13855,14035,14190,14035,14170,14135,315,280,16,226.16,1164
,20171016,14170,14135,14240,14415,14225,14225,14280,90,145,8,114.24,1164
,20171017,14225,14280,14180,14215,13940,14200,14145,-80,-135,24,339.59,1162
,20171018,14200,14145,14250,14250,14250,14250,14250,105,105,2,28.50,1164
,20171019,14250,14250,14210,14220,14080,14080,14145,-170,-105,8,113.18,1162
,20171020,14080,14145,13935,14340,13935,14320,14185,175,40,10,141.88,1162
,20171023,14320,14185,14250,14250,14140,14140,14195,-45,10,4,56.78,1164
,20171024,14140,14195,,,,14195,14195,0,0,0,0.00,1164
,20171025,14195,14195,14105,14105,14105,14105,14105,-90,-90,2,28.21,1164
,20171026,14105,14105,14115,14275,14080,14160,14160,55,55,120,"1,699.78",1076
,20171027,14160,14160,,,,14160,14160,0,0,0,0.00,1076
,20171030,14160,14160,13980,13980,13950,13960,13965,-200,-195,8,111.73,1074
,20171031,13960,13965,13905,13990,13905,13990,13930,25,-35,6,83.60,1078
,20171101,13990,13930,14030,14295,14030,14295,14185,365,255,6,85.12,1078
,20171102,14295,14185,14425,14425,14425,14425,14425,240,240,2,28.85,1080
,20171103,14425,14425,,,,14425,14425,0,0,0,0.00,1080
,20171106,14425,14425,14560,14750,14560,14750,14690,325,265,16,235.10,1082
,20171107,14750,14690,14700,14780,14520,14520,14700,-170,10,30,441.06,1094
,20171108,14520,14700,14510,14585,14510,14585,14560,-115,-140,6,87.36,1096
,20171109,14585,14560,14500,14670,14500,14500,14565,-60,5,12,174.78,1098
,20171110,14500,14565,14375,14540,14375,14540,14430,-25,-135,6,86.58,1096
,20171113,14540,14430,14595,14845,14480,14845,14620,415,190,14,204.71,1100
,20171114,14845,14620,14740,14825,14720,14720,14765,100,145,16,236.27,1090
,20171115,14720,14765,14650,14650,13940,13975,14145,-790,-620,48,679.14,1076
,20171116,13975,14145,,,,13955,13955,-190,-190,0,0.00,1076
,20171117,13955,13955,,,,13955,13955,0,0,0,0.00,1076
,20171120,13955,13955,14085,14085,14010,14010,14060,55,105,6,84.36,1078
,20171121,14010,14060,14040,14080,13615,14080,13905,20,-155,22,305.98,1074
,20171122,14080,13905,13980,14040,13980,14010,14020,105,115,10,140.22,1080
,20171123,14010,14020,14250,14365,14250,14350,14305,330,285,12,171.70,1078
,20171124,14350,14305,14445,14445,14445,14445,14445,140,140,2,28.89,1078
,20171127,14445,14445,14420,14420,14000,14085,14320,-360,-125,156,"2,234.37",1068
,20171128,14085,14320,14085,14215,14000,14180,14100,-140,-220,56,789.83,1078
,20171129,14180,14100,14200,14530,14200,14450,14370,350,270,32,459.99,1076
,20171130,14450,14370,14450,14455,14190,14215,14385,-155,15,30,431.66,1068
,20171201,14215,14385,14210,14620,14210,14580,14580,195,195,92,"1,341.36",1010
,20171204,14580,14580,14920,15205,14800,15150,15195,570,615,960,"14,589.37",128
,20171205,15150,15195,15180,15180,14920,14920,15085,-275,-110,24,362.06,126
,20171206,14920,15085,14940,14940,14530,14530,14825,-555,-260,8,118.62,122
,20171207,14530,14825,14625,14625,14365,14365,14490,-460,-335,12,173.93,124
,20171208,14365,14490,14310,14440,14260,14440,14360,-50,-130,8,114.90,126
,20171211,14440,14360,14530,14530,14250,14290,14280,-70,-80,20,285.64,128
,20171212,14290,14280,14560,14560,14385,14385,14425,105,145,38,548.28,118
,20171213,14385,14425,14415,14460,14345,14345,14425,-80,0,10,144.26,120
,20171214,14345,14425,14660,14660,14490,14500,14585,75,160,28,408.49,110
,20171215,14500,14585,14610,14760,14610,14745,14705,160,120,6,88.23,106
,20171218,14745,14705,14845,14935,14685,14935,14790,230,85,22,325.41,96
,20171219,14935,14790,,,,14790,14790,0,0,0,0.00,96
,20171220,14790,14790,14740,14845,14650,14670,14730,-120,-60,72,"1,060.60",116
,20171221,14670,14730,14620,14620,14620,14620,14620,-110,-110,2,29.24,116
,20171222,14620,14620,14645,14645,14225,14335,14375,-285,-245,22,316.25,116
,20171225,14335,14375,14515,14515,14290,14305,14315,-70,-60,24,343.63,100
,20171226,14305,14315,14050,14475,14050,14450,14235,135,-80,16,227.78,94
,20171227,14450,14235,14530,14600,14490,14490,14555,255,320,14,203.82,88
,20171228,14490,14555,,,,14510,14510,-45,-45,0,0.00,88
,20171229,14510,14510,14410,14410,14325,14380,14360,-130,-150,16,229.78,88
ru1809,20170918,16385,16385,15970,16290,15330,15735,15900,-650,-485,4604,"73,214.68",2952
,20170919,15735,15900,15740,15830,15500,15545,15700,-355,-200,1804,"28,328.95",3716
,20170920,15545,15700,15515,15735,15360,15635,15570,-65,-130,2028,"31,579.14",4746
,20170921,15635,15570,15700,15750,15025,15090,15295,-480,-275,3894,"59,559.19",6066
,20170922,15090,15295,15105,15220,14910,15145,15110,-150,-185,1434,"21,671.78",6332
,20170925,15145,15110,15180,15310,15005,15145,15155,35,45,1306,"19,796.48",6570
,20170926,15145,15155,15215,15340,15045,15155,15180,0,25,1852,"28,122.20",7454
,20170927,15155,15180,15100,15240,15060,15170,15165,-10,-15,1370,"20,777.93",7650
,20170928,15170,15165,15180,15205,14100,14100,14450,-1065,-715,6420,"92,787.11",9726
,20170929,14100,14450,14075,14230,13615,14225,13955,-225,-495,6370,"88,895.81",10400
,20171009,14225,13955,14440,14440,13930,14090,14060,135,105,4660,"65,522.72",11884
,20171010,14090,14060,14100,14195,14000,14055,14105,-5,45,2512,"35,438.05",12330
,20171011,14055,14105,14070,14185,13700,13980,13945,-125,-160,3596,"50,161.89",12914
,20171012,13980,13945,13870,14270,13795,14140,14005,195,60,3118,"43,669.71",13358
,20171013,14140,14005,14165,14400,14130,14320,14275,315,270,3752,"53,560.44",13286
,20171016,14320,14275,14335,14645,14190,14380,14365,105,90,4264,"61,258.26",13950
,20171017,14380,14365,14405,14425,14030,14325,14235,-40,-130,4756,"67,715.56",14510
,20171018,14325,14235,14330,14475,14235,14315,14375,80,140,4484,"64,469.84",14296
,20171019,14315,14375,14350,14530,14145,14160,14350,-215,-25,5214,"74,839.11",14144
,20171020,14160,14350,14165,14535,14055,14460,14310,110,-40,4770,"68,280.32",14108
,20171023,14460,14310,14410,14560,14140,14280,14305,-30,-5,6576,"94,098.93",14970
,20171024,14280,14305,14340,14420,14230,14280,14305,-25,0,6274,"89,760.85",15610
,20171025,14280,14305,14280,14450,14110,14315,14330,10,25,6932,"99,358.84",15376
,20171026,14315,14330,14315,14420,14185,14350,14320,20,-10,4296,"61,526.71",15446
,20171027,14350,14320,14350,14385,13885,14130,14195,-190,-125,6854,"97,315.36",15822
,20171030,14130,14195,14095,14230,14055,14090,14130,-105,-65,3596,"50,817.48",16018
,20171031,14090,14130,14100,14145,14000,14070,14085,-60,-45,3776,"53,194.02",16612
,20171101,14070,14085,14070,14550,14070,14360,14350,275,265,7592,"108,971.14",16586
,20171102,14360,14350,14360,14660,14315,14580,14505,230,155,5776,"83,794.84",17024
,20171103,14580,14505,14555,14580,14380,14435,14480,-70,-25,5588,"80,921.64",17410
,20171106,14435,14480,14435,14915,14415,14850,14735,370,255,9670,"142,487.75",19016
,20171107,14850,14735,14855,14975,14660,14785,14815,50,80,9116,"135,078.24",19174
,20171108,14785,14815,14705,14785,14575,14600,14695,-215,-120,6364,"93,527.09",19718
,20171109,14600,14695,14600,14885,14520,14585,14715,-110,20,8970,"132,004.05",19862
,20171110,14585,14715,14545,14725,14510,14655,14650,-60,-65,4832,"70,798.49",20008
,20171113,14655,14650,14700,14990,14585,14930,14825,280,175,9992,"148,147.41",20398
,20171114,14930,14825,14910,15050,14845,14865,14930,40,105,9212,"137,574.46",20764
,20171115,14865,14930,14880,14955,14010,14055,14305,-875,-625,16056,"229,683.77",21708
,20171116,14055,14305,14130,14195,13985,14070,14110,-235,-195,8364,"118,016.60",22122
,20171117,14070,14110,14145,14185,14055,14095,14120,-15,10,6048,"85,400.41",22250
,20171120,14095,14120,14125,14225,14020,14185,14115,65,-5,7638,"107,832.55",22658
,20171121,14185,14115,14185,14240,13665,14140,14015,25,-100,17080,"239,448.18",23496
,20171122,14140,14015,14190,14265,14095,14215,14185,200,170,9014,"127,874.88",23888
,20171123,14215,14185,14230,14620,14180,14490,14490,305,305,17442,"252,770.91",24610
,20171124,14490,14490,14490,14660,14435,14600,14570,110,80,14384,"209,635.00",25928
,20171127,14600,14570,14620,14700,14110,14180,14385,-390,-185,21204,"305,071.33",25890
,20171128,14180,14385,14170,14370,14085,14350,14225,-35,-160,14430,"205,318.27",26052
,20171129,14350,14225,14350,14625,14275,14565,14470,340,245,18566,"268,737.18",26588
,20171130,14565,14470,14525,14690,14205,14250,14460,-220,-10,19174,"277,284.48",27360
,20171201,14250,14460,14280,14915,14280,14860,14665,400,205,26578,"389,780.60",26956
,20171204,14860,14665,15015,15325,14905,15270,15140,605,475,28360,"429,373.91",27420
,20171205,15270,15140,15260,15270,14890,15035,15090,-105,-50,30614,"462,003.02",28732
,20171206,15035,15090,14900,15065,14375,14695,14680,-395,-410,29972,"440,004.94",28890
,20171207,14695,14680,14650,14865,14165,14365,14630,-315,-50,32312,"472,853.37",29520
,20171208,14365,14630,14365,14510,14230,14445,14390,-185,-240,19854,"285,775.25",29764
,20171211,14445,14390,14440,14670,14235,14380,14450,-10,60,33100,"478,381.62",31644
,20171212,14380,14450,14390,14585,14335,14540,14475,90,25,25468,"368,679.98",31448
,20171213,14540,14475,14580,14620,14325,14455,14455,-20,-20,26148,"378,001.31",32280
,20171214,14455,14455,14455,14810,14370,14655,14610,200,155,29672,"433,610.76",31504
,20171215,14655,14610,14655,14850,14635,14765,14725,155,115,20622,"303,749.91",31594
,20171218,14765,14725,14790,15040,14720,14875,14830,150,105,27196,"403,423.97",33802
,20171219,14875,14830,14860,14865,14570,14745,14740,-85,-90,22608,"333,270.36",33794
,20171220,14745,14740,14765,14905,14690,14795,14785,55,45,20516,"303,403.08",34050
,20171221,14795,14785,14820,14950,14640,14710,14760,-75,-25,20462,"302,044.86",34226
,20171222,14710,14760,14705,14740,14245,14360,14435,-400,-325,32504,"469,280.80",36080
,20171225,14360,14435,14405,14565,14335,14385,14435,-50,0,23526,"339,689.17",37226
,20171226,14385,14435,14405,14745,14060,14650,14525,215,90,40718,"591,456.19",37796
,20171227,14650,14525,14580,14730,14480,14510,14620,-15,95,30250,"442,267.94",39016
,20171228,14510,14620,14520,14580,14300,14540,14480,-80,-140,33824,"489,906.47",40120
,20171229,14540,14480,14535,14590,14385,14450,14480,-30,0,33500,"485,197.70",41540
ru1810,20171017,14365,14365,14140,14435,14140,14330,14270,-35,-95,8,114.18,4
,20171018,14330,14270,14395,14470,14395,14470,14430,200,160,4,57.73,4
,20171019,14470,14430,14365,14590,14325,14325,14450,-105,20,16,231.24,12
,20171020,14325,14450,,,,14450,14450,0,0,0,0.00,12
,20171023,14450,14450,,,,14450,14450,0,0,0,0.00,12
,20171024,14450,14450,14500,14500,14195,14370,14305,-80,-145,90,"1,287.48",16
,20171025,14370,14305,,,,14305,14305,0,0,0,0.00,16
,20171026,14305,14305,14305,14305,14305,14305,14305,0,0,2,28.61,16
,20171027,14305,14305,14250,14250,14130,14130,14180,-175,-125,6,85.08,14
,20171030,14130,14180,14165,14200,14120,14160,14160,-20,-20,8,113.29,16
,20171031,14160,14160,14110,14110,14110,14110,14110,-50,-50,2,28.22,18
,20171101,14110,14110,14495,14495,14495,14495,14495,385,385,2,28.99,18
,20171102,14495,14495,,,,14575,14575,80,80,0,0.00,18
,20171103,14575,14575,14665,14665,14580,14580,14620,5,45,4,58.49,20
,20171106,14580,14620,14690,14895,14690,14895,14820,275,200,8,118.58,22
,20171107,14895,14820,14930,14930,14875,14875,14905,55,85,10,149.06,28
,20171108,14875,14905,14745,14765,14745,14765,14750,-140,-155,6,88.51,34
,20171109,14765,14750,14915,14915,14630,14630,14770,-120,20,4,59.09,36
,20171110,14630,14770,14675,14790,14640,14790,14705,20,-65,8,117.65,34
,20171113,14790,14705,,,,14915,14915,210,210,0,0.00,34
,20171114,14915,14915,,,,14915,14915,0,0,0,0.00,34
,20171115,14915,14915,14240,14240,14115,14115,14185,-800,-730,10,141.88,24
,20171116,14115,14185,14095,14095,14095,14095,14095,-90,-90,2,28.19,26
,20171117,14095,14095,14155,14155,14155,14155,14155,60,60,2,28.31,24
,20171120,14155,14155,,,,14180,14180,25,25,0,0.00,24
,20171121,14180,14180,,,,14180,14180,0,0,0,0.00,24
,20171122,14180,14180,14220,14220,14220,14220,14220,40,40,2,28.44,22
,20171123,14220,14220,,,,14490,14490,270,270,0,0.00,22
,20171124,14490,14490,14490,14690,14445,14690,14580,200,90,30,437.40,18
,20171127,14690,14580,14200,14200,14200,14200,14200,-380,-380,2,28.40,16
,20171128,14200,14200,,,,14355,14355,155,155,0,0.00,16
,20171129,14355,14355,14425,14670,14425,14670,14520,315,165,6,87.13,14
,20171130,14670,14520,,,,14345,14345,-175,-175,0,0.00,14
,20171201,14345,14345,14915,14915,14915,14915,14915,570,570,2,29.83,14
,20171204,14915,14915,,,,14915,14915,0,0,0,0.00,14
,20171205,14915,14915,,,,14915,14915,0,0,0,0.00,14
,20171206,14915,14915,14765,14765,14750,14750,14755,-165,-160,4,59.03,12
,20171207,14750,14755,14700,14700,14650,14650,14665,-105,-90,6,88.00,12
,20171208,14650,14665,,,,14665,14665,0,0,0,0.00,12
,20171211,14665,14665,,,,14665,14665,0,0,0,0.00,12
,20171212,14665,14665,,,,14665,14665,0,0,0,0.00,12
,20171213,14665,14665,,,,14560,14560,-105,-105,0,0.00,12
,20171214,14560,14560,,,,14715,14715,155,155,0,0.00,12
,20171215,14715,14715,14855,14855,14855,14855,14855,140,140,2,29.71,14
,20171218,14855,14855,14925,14925,14925,14925,14925,70,70,4,59.70,10
,20171219,14925,14925,,,,14925,14925,0,0,0,0.00,10
,20171220,14925,14925,,,,14925,14925,0,0,0,0.00,10
,20171221,14925,14925,,,,14925,14925,0,0,0,0.00,10
,20171222,14925,14925,14480,14480,14480,14480,14480,-445,-445,2,28.96,10
,20171225,14480,14480,,,,14480,14480,0,0,0,0.00,10
,20171226,14480,14480,,,,14665,14665,185,185,0,0.00,10
,20171227,14665,14665,,,,14665,14665,0,0,0,0.00,10
,20171228,14665,14665,,,,14665,14665,0,0,0,0.00,10
,20171229,14665,14665,,,,14665,14665,0,0,0,0.00,10
ru1811,20171116,14185,14185,14315,14345,14230,14230,14295,45,110,14,200.14,12
,20171117,14230,14295,14235,14325,14235,14325,14280,30,-15,4,57.12,10
,20171120,14325,14280,14245,14245,14235,14235,14240,-45,-40,6,85.44,16
,20171121,14235,14240,14060,14285,14060,14285,14180,45,-60,12,170.18,16
,20171122,14285,14180,14240,14340,14240,14340,14290,160,110,6,85.74,22
,20171123,14340,14290,14320,14695,14310,14550,14545,260,255,30,436.48,20
,20171124,14550,14545,14645,14710,14645,14710,14665,165,120,6,88.01,22
,20171127,14710,14665,14575,14575,14280,14280,14425,-385,-240,4,57.71,24
,20171128,14280,14425,14310,14310,14265,14265,14285,-160,-140,4,57.15,24
,20171129,14265,14285,14475,14710,14475,14710,14625,425,340,6,87.76,30
,20171130,14710,14625,14530,14530,14390,14390,14480,-235,-145,6,86.89,32
,20171201,14390,14480,14750,14750,14750,14750,14750,270,270,2,29.50,32
,20171204,14750,14750,15095,15365,15040,15325,15210,575,460,14,212.98,36
,20171205,15325,15210,15240,15240,15110,15110,15185,-100,-25,10,151.88,40
,20171206,15110,15185,15095,15155,14575,14820,14845,-365,-340,28,415.77,38
,20171207,14820,14845,14870,14870,14390,14510,14730,-335,-115,16,235.69,40
,20171208,14510,14730,14275,15760,13695,14640,14710,-90,-20,412,"6,062.52",76
,20171211,14640,14710,14620,14700,14550,14555,14595,-155,-115,26,379.53,84
,20171212,14555,14595,14550,14575,14550,14575,14570,-20,-25,32,466.35,54
,20171213,14575,14570,14680,14680,14500,14520,14550,-50,-20,8,116.40,54
,20171214,14520,14550,14800,14865,14655,14655,14805,105,255,10,148.08,54
,20171215,14655,14805,14830,15005,14830,15005,14885,200,80,12,178.63,58
,20171218,15005,14885,15040,15065,14880,15065,15020,180,135,10,150.23,62
,20171219,15065,15020,14845,14915,14845,14915,14880,-105,-140,12,178.57,62
,20171220,14915,14880,14895,14895,14855,14855,14880,-25,0,6,89.29,60
,20171221,14855,14880,14800,14800,14800,14800,14800,-80,-80,2,29.60,62
,20171222,14800,14800,14665,14665,14485,14585,14580,-215,-220,8,116.64,62
,20171225,14585,14580,14680,14680,14650,14650,14665,70,85,4,58.66,66
,20171226,14650,14665,,,,14725,14725,60,60,0,0.00,66
,20171227,14725,14725,14795,14855,14780,14795,14820,70,95,26,385.34,86
,20171228,14795,14820,14695,14695,14530,14640,14615,-180,-205,8,116.93,86
,20171229,14640,14615,14725,14725,14630,14630,14675,15,60,18,264.18,102
sn1701,20170103,146080,146480,143200,148870,143200,148070,147940,1590,1460,712,"10,533.75",5692
,20170104,148070,147940,149000,149730,147700,149170,148990,1230,1050,716,"10,667.81",5864
,20170105,149170,148990,148820,151400,148410,151400,150170,2410,1180,296,"4,445.24",5912
,20170106,151400,150170,155610,155620,150400,151130,152050,960,1880,352,"5,352.41",5784
,20170109,151130,152050,150040,152450,150040,151830,151520,-220,-530,212,"3,212.31",5696
,20170110,151830,151520,151070,153870,151070,152700,151880,1180,360,200,"3,037.65",5640
,20170111,152700,151880,152290,153310,151010,152650,152620,770,740,140,"2,136.80",5652
,20170112,152650,152620,149900,149900,145510,148000,147570,-4620,-5050,76,"1,121.54",5648
,20170113,148000,147570,148500,149800,146050,148000,148530,430,960,116,"1,722.96",5648
,20170116,148000,148530,150000,150000,150000,150000,150000,1470,1470,8,120.00,5648
sn1702,20170103,148130,148130,151850,151850,149210,149210,150530,1080,2400,4,60.21,4
,20170104,149210,150530,,,,151600,151600,1070,1070,0,0.00,4
,20170105,151600,151600,,,,152800,152800,1200,1200,0,0.00,4
,20170106,152800,152800,150290,152650,150290,152650,151470,-150,-1330,4,60.59,2
,20170109,152650,151470,,,,150940,150940,-530,-530,0,0.00,2
,20170110,150940,150940,,,,151300,151300,360,360,0,0.00,2
,20170111,151300,151300,,,,152040,152040,740,740,0,0.00,2
,20170112,152040,152040,148930,148930,147950,147950,148440,-4090,-3600,4,59.38,2
,20170113,147950,148440,,,,149400,149400,960,960,0,0.00,2
,20170116,149400,149400,,,,150870,150870,1470,1470,0,0.00,2
,20170117,150870,150870,,,,150870,150870,0,0,0,0.00,2
,20170118,150870,150870,,,,150870,150870,0,0,0,0.00,2
,20170119,150870,150870,,,,150870,150870,0,0,0,0.00,2
,20170120,150870,150870,143990,143990,143990,143990,143990,-6880,-6880,2,28.80,0
,20170123,143990,143990,,,,143990,143990,0,0,0,0.00,0
,20170124,143990,143990,,,,143990,143990,0,0,0,0.00,0
,20170125,143990,143990,,,,143990,143990,0,0,0,0.00,0
,20170126,143990,143990,,,,143990,143990,0,0,0,0.00,0
,20170203,143990,143990,,,,143990,143990,0,0,0,0.00,0
,20170206,143990,143990,,,,143990,143990,0,0,0,0.00,0
,20170207,143990,143990,,,,143990,143990,0,0,0,0.00,0
,20170208,143990,143990,,,,143990,143990,0,0,0,0.00,0
,20170209,143990,143990,,,,143990,143990,0,0,0,0.00,0
,20170210,143990,143990,,,,143990,143990,0,0,0,0.00,0
,20170213,143990,143990,,,,143990,143990,0,0,0,0.00,0
,20170214,143990,143990,,,,143990,143990,0,0,0,0.00,0
,20170215,143990,143990,,,,143990,143990,0,0,0,0.00,0
sn1703,20170103,144950,144950,151480,151480,149000,149000,150650,4050,5700,6,90.39,22
,20170104,149000,150650,152080,152080,149030,149030,151060,-1620,410,6,90.64,20
,20170105,149030,151060,,,,152260,152260,1200,1200,0,0.00,20
,20170106,152260,152260,155710,155710,155710,155710,155710,3450,3450,2,31.14,22
,20170109,155710,155710,,,,155170,155170,-540,-540,0,0.00,22
,20170110,155170,155170,151050,151050,151050,151050,151050,-4120,-4120,2,30.21,20
,20170111,151050,151050,151820,151820,151810,151810,151810,760,760,6,91.09,16
,20170112,151810,151810,,,,148210,148210,-3600,-3600,0,0.00,16
,20170113,148210,148210,,,,149170,149170,960,960,0,0.00,16
,20170116,149170,149170,,,,150640,150640,1470,1470,0,0.00,16
,20170117,150640,150640,148610,149000,148610,149000,148800,-1640,-1840,4,59.52,14
,20170118,149000,148800,,,,148800,148800,0,0,0,0.00,14
,20170119,148800,148800,147200,147200,147200,147200,147200,-1600,-1600,2,29.44,12
,20170120,147200,147200,,,,140480,140480,-6720,-6720,0,0.00,12
,20170123,140480,140480,143350,143350,143350,143350,143350,2870,2870,2,28.67,10
,20170124,143350,143350,,,,143350,143350,0,0,0,0.00,10
,20170125,143350,143350,,,,143350,143350,0,0,0,0.00,10
,20170126,143350,143350,,,,143350,143350,0,0,0,0.00,10
,20170203,143350,143350,,,,143350,143350,0,0,0,0.00,10
,20170206,143350,143350,,,,143350,143350,0,0,0,0.00,10
,20170207,143350,143350,,,,143350,143350,0,0,0,0.00,10
,20170208,143350,143350,,,,143350,143350,0,0,0,0.00,10
,20170209,143350,143350,,,,143350,143350,0,0,0,0.00,10
,20170210,143350,143350,,,,143350,143350,0,0,0,0.00,10
,20170213,143350,143350,,,,143350,143350,0,0,0,0.00,10
,20170214,143350,143350,,,,143350,143350,0,0,0,0.00,10
,20170215,143350,143350,,,,143350,143350,0,0,0,0.00,10
,20170216,143350,143350,,,,143350,143350,0,0,0,0.00,10
,20170217,143350,143350,,,,143350,143350,0,0,0,0.00,10
,20170220,143350,143350,,,,143350,143350,0,0,0,0.00,10
,20170221,143350,143350,145270,145330,145270,145330,145300,1980,1950,4,58.12,10
,20170222,145330,145300,,,,145300,145300,0,0,0,0.00,10
,20170223,145300,145300,,,,145300,145300,0,0,0,0.00,10
,20170224,145300,145300,,,,145300,145300,0,0,0,0.00,10
,20170227,145300,145300,,,,145300,145300,0,0,0,0.00,10
,20170228,145300,145300,146000,146000,142580,142580,144860,-2720,-440,12,173.83,4
,20170301,142580,144860,,,,144860,144860,0,0,0,0.00,4
,20170302,144860,144860,,,,144860,144860,0,0,0,0.00,4
,20170303,144860,144860,,,,144860,144860,0,0,0,0.00,4
,20170306,144860,144860,,,,144860,144860,0,0,0,0.00,4
,20170307,144860,144860,,,,144860,144860,0,0,0,0.00,4
,20170308,144860,144860,,,,144860,144860,0,0,0,0.00,4
,20170309,144860,144860,,,,144860,144860,0,0,0,0.00,4
,20170310,144860,144860,155000,155000,155000,155000,155000,10140,10140,4,62.00,0
,20170313,155000,155000,,,,155000,155000,0,0,0,0.00,0
,20170314,155000,155000,,,,155000,155000,0,0,0,0.00,0
,20170315,155000,155000,,,,155000,155000,0,0,0,0.00,0
sn1704,20170103,145620,145620,,,,151340,151340,5720,5720,0,0.00,0
,20170104,151340,151340,,,,151750,151750,410,410,0,0.00,0
,20170105,151750,151750,,,,152950,152950,1200,1200,0,0.00,0
,20170106,152950,152950,,,,156410,156410,3460,3460,0,0.00,0
,20170109,156410,156410,,,,155860,155860,-550,-550,0,0.00,0
,20170110,155860,155860,,,,151720,151720,-4140,-4140,0,0.00,0
,20170111,151720,151720,,,,152480,152480,760,760,0,0.00,0
,20170112,152480,152480,,,,148860,148860,-3620,-3620,0,0.00,0
,20170113,148860,148860,,,,149820,149820,960,960,0,0.00,0
,20170116,149820,149820,,,,151300,151300,1480,1480,0,0.00,0
,20170117,151300,151300,147010,151600,147010,151600,149300,300,-2000,8,119.44,4
,20170118,151600,149300,,,,149300,149300,0,0,0,0.00,4
,20170119,149300,149300,,,,147690,147690,-1610,-1610,0,0.00,4
,20170120,147690,147690,,,,140950,140950,-6740,-6740,0,0.00,4
,20170123,140950,140950,,,,143820,143820,2870,2870,0,0.00,4
,20170124,143820,143820,,,,143820,143820,0,0,0,0.00,4
,20170125,143820,143820,,,,143820,143820,0,0,0,0.00,4
,20170126,143820,143820,,,,143820,143820,0,0,0,0.00,4
,20170203,143820,143820,,,,143820,143820,0,0,0,0.00,4
,20170206,143820,143820,,,,143820,143820,0,0,0,0.00,4
,20170207,143820,143820,,,,143820,143820,0,0,0,0.00,4
,20170208,143820,143820,,,,143820,143820,0,0,0,0.00,4
,20170209,143820,143820,,,,143820,143820,0,0,0,0.00,4
,20170210,143820,143820,,,,143820,143820,0,0,0,0.00,4
,20170213,143820,143820,,,,143820,143820,0,0,0,0.00,4
,20170214,143820,143820,,,,143820,143820,0,0,0,0.00,4
,20170215,143820,143820,149530,150390,146000,150390,148060,6570,4240,8,118.45,0
,20170216,150390,148060,,,,148060,148060,0,0,0,0.00,0
,20170217,148060,148060,,,,148060,148060,0,0,0,0.00,0
,20170220,148060,148060,,,,148060,148060,0,0,0,0.00,0
,20170221,148060,148060,,,,150070,150070,2010,2010,0,0.00,0
,20170222,150070,150070,,,,150070,150070,0,0,0,0.00,0
,20170223,150070,150070,,,,150070,150070,0,0,0,0.00,0
,20170224,150070,150070,,,,150070,150070,0,0,0,0.00,0
,20170227,150070,150070,,,,150070,150070,0,0,0,0.00,0
,20170228,150070,150070,,,,149610,149610,-460,-460,0,0.00,0
,20170301,149610,149610,,,,149610,149610,0,0,0,0.00,0
,20170302,149610,149610,,,,149610,149610,0,0,0,0.00,0
,20170303,149610,149610,,,,149610,149610,0,0,0,0.00,0
,20170306,149610,149610,,,,149610,149610,0,0,0,0.00,0
,20170307,149610,149610,,,,149610,149610,0,0,0,0.00,0
,20170308,149610,149610,,,,149610,149610,0,0,0,0.00,0
,20170309,149610,149610,,,,149610,149610,0,0,0,0.00,0
,20170310,149610,149610,,,,160080,160080,10470,10470,0,0.00,0
,20170313,160080,160080,,,,160080,160080,0,0,0,0.00,0
,20170314,160080,160080,,,,160080,160080,0,0,0,0.00,0
,20170315,160080,160080,,,,160080,160080,0,0,0,0.00,0
,20170316,160080,160080,,,,160080,160080,0,0,0,0.00,0
,20170317,160080,160080,,,,160080,160080,0,0,0,0.00,0
,20170320,160080,160080,,,,160080,160080,0,0,0,0.00,0
,20170321,160080,160080,,,,160080,160080,0,0,0,0.00,0
,20170322,160080,160080,,,,160080,160080,0,0,0,0.00,0
,20170323,160080,160080,,,,160080,160080,0,0,0,0.00,0
,20170324,160080,160080,,,,160080,160080,0,0,0,0.00,0
,20170327,160080,160080,,,,160080,160080,0,0,0,0.00,0
,20170328,160080,160080,,,,160080,160080,0,0,0,0.00,0
,20170329,160080,160080,,,,160080,160080,0,0,0,0.00,0
,20170330,160080,160080,148870,148870,148870,148870,148870,-11210,-11210,2,29.77,2
,20170331,148870,148870,139670,142800,139670,142800,141230,-6070,-7640,4,56.49,0
,20170405,142800,141230,,,,141230,141230,0,0,0,0.00,0
,20170406,141230,141230,,,,141230,141230,0,0,0,0.00,0
,20170407,141230,141230,,,,141230,141230,0,0,0,0.00,0
,20170410,141230,141230,,,,141230,141230,0,0,0,0.00,0
,20170411,141230,141230,,,,141230,141230,0,0,0,0.00,0
,20170412,141230,141230,,,,141230,141230,0,0,0,0.00,0
,20170413,141230,141230,,,,141230,141230,0,0,0,0.00,0
,20170414,141230,141230,,,,141230,141230,0,0,0,0.00,0
,20170417,141230,141230,,,,141230,141230,0,0,0,0.00,0
sn1705,20170103,146820,146890,147380,150790,146800,150270,149750,3380,2860,15106,"226,220.67",10962
,20170104,150270,149750,150300,151860,148420,150720,150170,970,420,25698,"385,907.61",11748
,20170105,150720,150170,150690,155560,149620,154930,151370,4760,1200,25876,"391,690.39",14332
,20170106,154930,151370,153540,154480,151870,152900,153160,1530,1790,27994,"428,770.13",16016
,20170109,152900,153160,153090,153800,152300,153260,153190,100,30,18838,"288,583.80",16688
,20170110,153260,153190,153260,155810,152300,154800,154070,1610,880,26632,"410,331.41",18410
,20170111,154800,154070,156000,156000,152660,153180,154210,-890,140,20568,"317,180.94",17184
,20170112,153180,154210,152760,152960,147620,149590,150600,-4620,-3610,34190,"514,911.95",14814
,20170113,149590,150600,149240,150790,148410,149200,149610,-1400,-990,18084,"270,570.95",13582
,20170116,149200,149610,148980,152380,148980,150280,150730,670,1120,16638,"250,800.14",13032
,20170117,150280,150730,150030,150940,145510,146840,148390,-3890,-2340,18968,"281,468.46",13326
,20170118,146840,148390,146790,149070,146570,147710,147750,-680,-640,13972,"206,444.49",12996
,20170119,147710,147750,147100,148780,147100,148200,147980,450,230,12098,"179,027.52",12336
,20170120,148200,147980,148500,149040,144010,144080,146330,-3900,-1650,17896,"261,889.42",13506
,20170123,144080,146330,143970,146210,143310,144820,144970,-1510,-1360,17298,"250,772.26",13222
,20170124,144820,144970,144000,146820,143860,145560,145380,590,410,11690,"169,951.64",12490
,20170125,145560,145380,146880,148730,145440,148220,147100,2840,1720,10542,"155,077.14",11430
,20170126,148220,147100,148000,150000,145880,149030,147920,1930,820,8568,"126,746.01",10876
,20170203,149030,147920,146010,148990,146010,146100,147150,-1820,-770,5784,"85,114.96",11128
,20170206,146100,147150,146140,147070,145120,145510,146010,-1640,-1140,10614,"154,975.31",11946
,20170207,145510,146010,144600,145890,143530,144600,144590,-1410,-1420,18212,"263,329.17",13624
,20170208,144600,144590,142830,144710,142440,143960,143860,-630,-730,23812,"342,562.88",15130
,20170209,143960,143860,143560,146760,143350,145730,145300,1870,1440,24580,"357,157.42",13956
,20170210,145730,145300,146000,146470,145250,146040,145940,740,640,17978,"262,372.97",13292
,20170213,146040,145940,146050,150580,146050,150350,148550,4410,2610,24744,"367,595.45",12428
,20170214,150350,148550,150360,150800,149180,150750,150060,2200,1510,20138,"302,209.34",12824
,20170215,150750,150060,151000,151670,147280,148500,148820,-1560,-1240,22100,"328,910.63",11774
,20170216,148500,148820,149080,150340,148000,148510,149030,-310,210,19586,"291,897.78",11980
,20170217,148510,149030,148440,148990,146140,146690,147840,-2340,-1190,15526,"229,541.01",11800
,20170220,146690,147840,146690,148580,145660,147970,147060,130,-780,16770,"246,633.46",11706
,20170221,147970,147060,148520,149730,147980,149000,148830,1940,1770,15798,"235,134.55",11932
,20170222,149000,148830,149560,149560,147650,148150,148410,-680,-420,11680,"173,354.23",11570
,20170223,148150,148410,147990,148460,145000,145200,146780,-3210,-1630,16352,"240,030.86",12796
,20170224,145200,146780,145980,145990,144000,145530,145040,-1250,-1740,17000,"246,576.06",12688
,20170227,145530,145040,145900,148230,145500,147020,146830,1980,1790,16250,"238,607.41",11624
,20170228,147020,146830,147120,147900,145640,145750,146920,-1080,90,13362,"196,314.55",11906
,20170301,145750,146920,145740,146750,145320,145980,146070,-940,-850,12504,"182,649.16",12280
,20170302,145980,146070,146220,148410,146220,147650,147440,1580,1370,16406,"241,902.97",11594
,20170303,147650,147440,147770,147770,145310,145900,146170,-1540,-1270,16420,"240,017.37",12184
,20170306,145900,146170,145900,146500,144680,145090,145630,-1080,-540,16130,"234,903.27",12612
,20170307,145090,145630,144960,145390,143750,144390,144680,-1240,-950,15228,"220,321.39",13716
,20170308,144390,144680,144340,144400,142610,142880,143390,-1800,-1290,17132,"245,656.39",14792
,20170309,142880,143390,142260,143350,139900,140930,141910,-2460,-1480,23170,"328,820.65",17046
,20170310,140930,141910,140880,143240,138890,142890,141340,980,-570,24188,"341,878.36",16736
,20170313,142890,141340,143110,145180,142310,145180,143610,3840,2270,24876,"357,262.89",14760
,20170314,145180,143610,145320,145380,143760,144110,144490,500,880,12904,"186,450.53",13818
,20170315,144110,144490,144200,146450,144000,145880,145700,1390,1210,21580,"314,435.99",13560
,20170316,145880,145700,146440,147480,145810,147250,146760,1550,1060,13910,"204,154.22",12810
,20170317,147250,146760,147800,147980,145900,146750,146820,-10,60,14650,"215,105.35",12860
,20170320,146750,146820,147600,147800,146420,146950,147150,130,330,12224,"179,880.59",12882
,20170321,146950,147150,147150,147530,145570,146580,146640,-570,-510,14932,"218,969.56",13148
,20170322,146580,146640,147260,147320,145050,145790,146170,-850,-470,18074,"264,188.69",13292
,20170323,145790,146170,146020,147110,145330,146550,146330,380,160,13976,"204,512.30",12958
,20170324,146550,146330,146110,146860,145250,146330,146200,0,-130,14316,"209,303.31",13076
,20170327,146330,146200,146140,146140,142120,142470,143920,-3730,-2280,19000,"273,451.36",13846
,20170328,142470,143920,141800,144000,141150,142650,142580,-1270,-1340,17420,"248,384.43",13184
,20170329,142650,142580,142820,144300,142150,143660,143410,1080,830,12884,"184,770.94",12450
,20170330,143660,143410,143410,144100,142550,143000,143300,-410,-110,11778,"168,789.50",13136
,20170331,143000,143300,142210,143920,142200,142680,143110,-620,-190,12830,"183,610.98",12680
,20170405,142680,143110,142810,143990,141660,143350,143060,240,-50,9080,"129,903.43",12694
,20170406,143350,143060,143340,146800,143340,146730,145050,3670,1990,16256,"235,803.98",12894
,20170407,146730,145050,146730,147100,145300,145970,146130,920,1080,20114,"293,939.32",12186
,20170410,145970,146130,145970,146340,145010,145220,145740,-910,-390,10504,"153,095.03",11728
,20170411,145220,145740,145820,145880,141600,141630,143450,-4110,-2290,17252,"247,495.65",12484
,20170412,141630,143450,141840,142590,140110,140800,141370,-2650,-2080,20156,"284,956.95",12810
,20170413,140800,141370,141110,143090,140110,142360,141460,990,90,18824,"266,294.35",12282
,20170414,142360,141460,142240,143470,140880,140970,142060,-490,600,11530,"163,801.09",12204
,20170417,140970,142060,140960,143180,138260,142880,141250,820,-810,19336,"273,122.28",11372
,20170418,142880,141250,141800,143130,141800,142300,142470,1050,1220,9488,"135,176.17",10796
,20170419,142300,142470,142860,142880,139590,140580,140930,-1890,-1540,15186,"214,029.11",10980
,20170420,140580,140930,141000,141980,138500,140960,140380,30,-550,17416,"244,498.61",10600
,20170421,140960,140380,140220,141500,139490,139720,140490,-660,110,14112,"198,264.93",9844
,20170424,139720,140490,138920,139730,135610,137220,137670,-3270,-2820,22442,"308,960.74",10448
,20170425,137220,137670,136310,138390,136310,137610,137310,-60,-360,11912,"163,564.78",8598
,20170426,137610,137310,137990,138660,137020,137610,137720,300,410,10396,"143,181.07",6614
,20170427,137610,137720,137890,141100,137680,139980,139840,2260,2120,7818,"109,334.07",5258
,20170428,139980,139840,145010,145140,138920,140700,140620,860,780,2746,"38,616.55",4516
,20170502,140700,140620,141800,143650,141800,142450,142970,1830,2350,668,"9,550.60",4240
,20170503,142450,142970,141740,142440,141130,141130,141970,-1840,-1000,420,"5,963.13",4044
,20170504,141130,141970,140730,140730,138850,139220,140090,-2750,-1880,432,"6,052.20",3900
,20170505,139220,140090,139730,140340,138550,138940,139550,-1150,-540,340,"4,744.84",3776
,20170508,138940,139550,139250,139540,138050,138400,138840,-1150,-710,172,"2,388.12",3724
,20170509,138400,138840,138800,139990,138800,139900,139700,1060,860,84,"1,173.52",3704
,20170510,139900,139700,138310,140710,138310,139000,138990,-700,-710,132,"1,834.78",3668
,20170511,139000,138990,139000,139000,138750,139000,138930,10,-60,32,444.60,3660
,20170512,139000,138930,,,,138930,138930,0,0,0,0.00,3660
,20170515,138930,138930,139500,139500,138500,138800,139170,-130,240,104,"1,447.40",3596
sn1706,20170103,145710,145710,,,,148550,148550,2840,2840,0,0.00,4
,20170104,148550,148550,150960,150960,147980,147980,149470,-570,920,4,59.79,4
,20170105,147980,149470,,,,150660,150660,1190,1190,0,0.00,4
,20170106,150660,150660,,,,152440,152440,1780,1780,0,0.00,4
,20170109,152440,152440,,,,152470,152470,30,30,0,0.00,4
,20170110,152470,152470,,,,153350,153350,880,880,0,0.00,4
,20170111,153350,153350,,,,153490,153490,140,140,0,0.00,4
,20170112,153490,153490,,,,149890,149890,-3600,-3600,0,0.00,4
,20170113,149890,149890,,,,148910,148910,-980,-980,0,0.00,4
,20170116,148910,148910,,,,150030,150030,1120,1120,0,0.00,4
,20170117,150030,150030,149010,149010,148560,148560,148780,-1470,-1250,8,119.03,4
,20170118,148560,148780,,,,148140,148140,-640,-640,0,0.00,4
,20170119,148140,148140,,,,148370,148370,230,230,0,0.00,4
,20170120,148370,148370,143180,143180,143170,143170,143170,-5200,-5200,14,200.45,16
,20170123,143170,143170,144690,146710,143180,146710,145370,3540,2200,16,232.59,6
,20170124,146710,145370,147320,148300,147320,148300,147970,2930,2600,6,88.78,6
,20170125,148300,147970,146180,146180,146180,146180,146180,-1790,-1790,2,29.24,4
,20170126,146180,146180,,,,147000,147000,820,820,0,0.00,4
,20170203,147000,147000,144650,144650,144650,144650,144650,-2350,-2350,2,28.93,2
,20170206,144650,144650,,,,143520,143520,-1130,-1130,0,0.00,2
,20170207,143520,143520,,,,142120,142120,-1400,-1400,0,0.00,2
,20170208,142120,142120,,,,141400,141400,-720,-720,0,0.00,2
,20170209,141400,141400,,,,142810,142810,1410,1410,0,0.00,2
,20170210,142810,142810,,,,143440,143440,630,630,0,0.00,2
,20170213,143440,143440,,,,146010,146010,2570,2570,0,0.00,2
,20170214,146010,146010,,,,147500,147500,1490,1490,0,0.00,2
,20170215,147500,147500,,,,146280,146280,-1220,-1220,0,0.00,2
,20170216,146280,146280,,,,146490,146490,210,210,0,0.00,2
,20170217,146490,146490,,,,145320,145320,-1170,-1170,0,0.00,2
,20170220,145320,145320,149330,149330,145530,148010,147520,2690,2200,52,767.14,18
,20170221,148010,147520,,,,147520,147520,0,0,0,0.00,18
,20170222,147520,147520,,,,147520,147520,0,0,0,0.00,18
,20170223,147520,147520,149430,149430,145640,145640,148670,-1880,1150,10,148.67,16
,20170224,145640,148670,,,,146870,146870,-1800,-1800,0,0.00,16
,20170227,146870,146870,,,,146870,146870,0,0,0,0.00,16
,20170228,146870,146870,,,,146870,146870,0,0,0,0.00,16
,20170301,146870,146870,,,,146870,146870,0,0,0,0.00,16
,20170302,146870,146870,148310,148310,148310,148310,148310,1440,1440,2,29.66,16
,20170303,148310,148310,,,,147260,147260,-1050,-1050,0,0.00,16
,20170306,147260,147260,,,,146270,146270,-990,-990,0,0.00,16
,20170307,146270,146270,,,,146270,146270,0,0,0,0.00,16
,20170308,146270,146270,,,,146270,146270,0,0,0,0.00,16
,20170309,146270,146270,142120,142120,142120,142120,142120,-4150,-4150,2,28.42,16
,20170310,142120,142120,,,,142530,142530,410,410,0,0.00,16
,20170313,142530,142530,143290,143880,143170,143170,143560,640,1030,24,344.55,4
,20170314,143170,143560,144000,144000,144000,144000,144000,440,440,2,28.80,2
,20170315,144000,144000,,,,145210,145210,1210,1210,0,0.00,2
,20170316,145210,145210,,,,146270,146270,1060,1060,0,0.00,2
,20170317,146270,146270,,,,146330,146330,60,60,0,0.00,2
,20170320,146330,146330,,,,146660,146660,330,330,0,0.00,2
,20170321,146660,146660,,,,146150,146150,-510,-510,0,0.00,2
,20170322,146150,146150,,,,145680,145680,-470,-470,0,0.00,2
,20170323,145680,145680,,,,145840,145840,160,160,0,0.00,2
,20170324,145840,145840,,,,145710,145710,-130,-130,0,0.00,2
,20170327,145710,145710,,,,143430,143430,-2280,-2280,0,0.00,2
,20170328,143430,143430,,,,142100,142100,-1330,-1330,0,0.00,2
,20170329,142100,142100,141750,141780,141560,141560,141730,-540,-370,16,226.77,18
,20170330,141560,141730,145770,146340,141930,142000,144480,270,2750,44,635.72,14
,20170331,142000,144480,142490,142490,142490,142490,142490,-1990,-1990,8,113.99,6
,20170405,142490,142490,,,,142790,142790,300,300,0,0.00,6
,20170406,142790,142790,142790,142790,142790,142790,142790,0,0,2,28.56,4
,20170407,142790,142790,,,,143850,143850,1060,1060,0,0.00,4
,20170410,143850,143850,144260,144520,143970,144520,144210,670,360,26,374.95,22
,20170411,144520,144210,146380,146380,142100,143860,143190,-350,-1020,62,887.78,22
,20170412,143860,143190,140760,149940,140020,141070,141790,-2120,-1400,48,680.62,8
,20170413,141070,141790,143780,145150,141950,142110,143660,320,1870,38,545.92,10
,20170414,142110,143660,,,,142880,142880,-780,-780,0,0.00,10
,20170417,142880,142880,142470,142470,142470,142470,142470,-410,-410,2,28.49,8
,20170418,142470,142470,,,,142470,142470,0,0,0,0.00,8
,20170419,142470,142470,141210,142900,140100,141840,141080,-630,-1390,40,564.35,8
,20170420,141840,141080,141180,142340,141180,142340,141760,1260,680,4,56.70,8
,20170421,142340,141760,,,,141760,141760,0,0,0,0.00,8
,20170424,141760,141760,137700,139390,136980,136980,137940,-4780,-3820,8,110.35,8
,20170425,136980,137940,140020,140020,140020,140020,140020,2080,2080,2,28.00,8
,20170426,140020,140020,,,,139580,139580,-440,-440,0,0.00,8
,20170427,139580,139580,,,,139580,139580,0,0,0,0.00,8
,20170428,139580,139580,139460,142450,136990,140790,139890,1210,310,288,"4,028.85",20
,20170502,140790,139890,141450,143860,141140,142680,142560,2790,2670,54,769.83,14
,20170503,142680,142560,142380,142380,142380,142380,142380,-180,-180,8,113.90,6
,20170504,142380,142380,142840,142840,141390,141390,142170,-990,-210,6,85.30,6
,20170505,141390,142170,141380,141380,141350,141350,141360,-820,-810,4,56.55,6
,20170508,141350,141360,136650,136650,136650,136650,136650,-4710,-4710,2,27.33,6
,20170509,136650,136650,142300,142300,142300,142300,142300,5650,5650,2,28.46,6
,20170510,142300,142300,141000,141000,141000,141000,141000,-1300,-1300,2,28.20,4
,20170511,141000,141000,,,,140940,140940,-60,-60,0,0.00,4
,20170512,140940,140940,,,,140940,140940,0,0,0,0.00,4
,20170515,140940,140940,,,,141180,141180,240,240,0,0.00,4
,20170516,141180,141180,,,,141180,141180,0,0,0,0.00,4
,20170517,141180,141180,,,,141180,141180,0,0,0,0.00,4
,20170518,141180,141180,,,,141180,141180,0,0,0,0.00,4
,20170519,141180,141180,,,,141180,141180,0,0,0,0.00,4
,20170522,141180,141180,142170,142170,142150,142150,142160,970,980,4,56.86,4
,20170523,142150,142160,142150,142150,142150,142150,142150,-10,-10,2,28.43,4
,20170524,142150,142150,,,,142150,142150,0,0,0,0.00,4
,20170525,142150,142150,,,,142150,142150,0,0,0,0.00,4
,20170526,142150,142150,,,,142150,142150,0,0,0,0.00,4
,20170531,142150,142150,,,,142150,142150,0,0,0,0.00,4
,20170601,142150,142150,,,,142150,142150,0,0,0,0.00,4
,20170602,142150,142150,141300,141300,141300,141300,141300,-850,-850,4,56.52,0
,20170605,141300,141300,,,,141300,141300,0,0,0,0.00,0
,20170606,141300,141300,,,,141300,141300,0,0,0,0.00,0
,20170607,141300,141300,,,,141300,141300,0,0,0,0.00,0
,20170608,141300,141300,,,,141300,141300,0,0,0,0.00,0
,20170609,141300,141300,,,,141300,141300,0,0,0,0.00,0
,20170612,141300,141300,,,,141300,141300,0,0,0,0.00,0
,20170613,141300,141300,,,,141300,141300,0,0,0,0.00,0
,20170614,141300,141300,,,,141300,141300,0,0,0,0.00,0
,20170615,141300,141300,,,,141300,141300,0,0,0,0.00,0
sn1707,20170103,144550,144550,,,,147360,147360,2810,2810,0,0.00,0
,20170104,147360,147360,,,,148270,148270,910,910,0,0.00,0
,20170105,148270,148270,,,,149450,149450,1180,1180,0,0.00,0
,20170106,149450,149450,,,,151220,151220,1770,1770,0,0.00,0
,20170109,151220,151220,,,,151250,151250,30,30,0,0.00,0
,20170110,151250,151250,,,,152120,152120,870,870,0,0.00,0
,20170111,152120,152120,,,,152250,152250,130,130,0,0.00,0
,20170112,152250,152250,,,,148680,148680,-3570,-3570,0,0.00,0
,20170113,148680,148680,,,,147710,147710,-970,-970,0,0.00,0
,20170116,147710,147710,,,,148820,148820,1110,1110,0,0.00,0
,20170117,148820,148820,,,,147580,147580,-1240,-1240,0,0.00,0
,20170118,147580,147580,,,,146940,146940,-640,-640,0,0.00,0
,20170119,146940,146940,,,,147160,147160,220,220,0,0.00,0
,20170120,147160,147160,,,,142000,142000,-5160,-5160,0,0.00,0
,20170123,142000,142000,,,,144180,144180,2180,2180,0,0.00,0
,20170124,144180,144180,,,,146760,146760,2580,2580,0,0.00,0
,20170125,146760,146760,,,,144980,144980,-1780,-1780,0,0.00,0
,20170126,144980,144980,,,,145790,145790,810,810,0,0.00,0
,20170203,145790,145790,,,,143450,143450,-2340,-2340,0,0.00,0
,20170206,143450,143450,,,,142330,142330,-1120,-1120,0,0.00,0
,20170207,142330,142330,,,,140940,140940,-1390,-1390,0,0.00,0
,20170208,140940,140940,,,,140220,140220,-720,-720,0,0.00,0
,20170209,140220,140220,,,,141620,141620,1400,1400,0,0.00,0
,20170210,141620,141620,,,,142240,142240,620,620,0,0.00,0
,20170213,142240,142240,,,,144790,144790,2550,2550,0,0.00,0
,20170214,144790,144790,,,,146270,146270,1480,1480,0,0.00,0
,20170215,146270,146270,,,,145060,145060,-1210,-1210,0,0.00,0
,20170216,145060,145060,,,,145260,145260,200,200,0,0.00,0
,20170217,145260,145260,,,,144100,144100,-1160,-1160,0,0.00,0
,20170220,144100,144100,,,,146280,146280,2180,2180,0,0.00,0
,20170221,146280,146280,,,,148040,148040,1760,1760,0,0.00,0
,20170222,148040,148040,,,,147630,147630,-410,-410,0,0.00,0
,20170223,147630,147630,,,,148780,148780,1150,1150,0,0.00,0
,20170224,148780,148780,,,,147020,147020,-1760,-1760,0,0.00,0
,20170227,147020,147020,,,,148830,148830,1810,1810,0,0.00,0
,20170228,148830,148830,,,,148920,148920,90,90,0,0.00,0
,20170301,148920,148920,,,,148060,148060,-860,-860,0,0.00,0
,20170302,148060,148060,,,,149510,149510,1450,1450,0,0.00,0
,20170303,149510,149510,,,,148220,148220,-1290,-1290,0,0.00,0
,20170306,148220,148220,,,,147670,147670,-550,-550,0,0.00,0
,20170307,147670,147670,,,,146700,146700,-970,-970,0,0.00,0
,20170308,146700,146700,,,,145390,145390,-1310,-1310,0,0.00,0
,20170309,145390,145390,,,,141260,141260,-4130,-4130,0,0.00,0
,20170310,141260,141260,,,,140690,140690,-570,-570,0,0.00,0
,20170313,140690,140690,,,,141700,141700,1010,1010,0,0.00,0
,20170314,141700,141700,,,,142130,142130,430,430,0,0.00,0
,20170315,142130,142130,,,,143320,143320,1190,1190,0,0.00,0
,20170316,143320,143320,,,,144370,144370,1050,1050,0,0.00,0
,20170317,144370,144370,,,,144430,144430,60,60,0,0.00,0
,20170320,144430,144430,,,,144750,144750,320,320,0,0.00,0
,20170321,144750,144750,,,,144250,144250,-500,-500,0,0.00,0
,20170322,144250,144250,,,,143780,143780,-470,-470,0,0.00,0
,20170323,143780,143780,,,,143930,143930,150,150,0,0.00,0
,20170324,143930,143930,,,,143800,143800,-130,-130,0,0.00,0
,20170327,143800,143800,,,,141550,141550,-2250,-2250,0,0.00,0
,20170328,141550,141550,,,,140230,140230,-1320,-1320,0,0.00,0
,20170329,140230,140230,,,,139860,139860,-370,-370,0,0.00,0
,20170330,139860,139860,,,,142570,142570,2710,2710,0,0.00,0
,20170331,142570,142570,,,,140600,140600,-1970,-1970,0,0.00,0
,20170405,140600,140600,,,,140550,140550,-50,-50,0,0.00,0
,20170406,140550,140550,,,,140550,140550,0,0,0,0.00,0
,20170407,140550,140550,,,,141600,141600,1050,1050,0,0.00,0
,20170410,141600,141600,,,,141950,141950,350,350,0,0.00,0
,20170411,141950,141950,,,,140940,140940,-1010,-1010,0,0.00,0
,20170412,140940,140940,,,,139560,139560,-1380,-1380,0,0.00,0
,20170413,139560,139560,,,,141400,141400,1840,1840,0,0.00,0
,20170414,141400,141400,,,,142000,142000,600,600,0,0.00,0
,20170417,142000,142000,,,,141590,141590,-410,-410,0,0.00,0
,20170418,141590,141590,,,,142810,142810,1220,1220,0,0.00,0
,20170419,142810,142810,,,,141420,141420,-1390,-1390,0,0.00,0
,20170420,141420,141420,,,,141420,141420,0,0,0,0.00,0
,20170421,141420,141420,,,,141530,141530,110,110,0,0.00,0
,20170424,141530,141530,,,,137710,137710,-3820,-3820,0,0.00,0
,20170425,137710,137710,,,,139780,139780,2070,2070,0,0.00,0
,20170426,139780,139780,,,,140200,140200,420,420,0,0.00,0
,20170427,140200,140200,,,,140200,140200,0,0,0,0.00,0
,20170428,140200,140200,,,,140510,140510,310,310,0,0.00,0
,20170502,140510,140510,,,,143190,143190,2680,2680,0,0.00,0
,20170503,143190,143190,,,,143000,143000,-190,-190,0,0.00,0
,20170504,143000,143000,,,,142780,142780,-220,-220,0,0.00,0
,20170505,142780,142780,,,,141970,141970,-810,-810,0,0.00,0
,20170508,141970,141970,,,,137230,137230,-4740,-4740,0,0.00,0
,20170509,137230,137230,,,,142900,142900,5670,5670,0,0.00,0
,20170510,142900,142900,,,,141590,141590,-1310,-1310,0,0.00,0
,20170511,141590,141590,,,,141530,141530,-60,-60,0,0.00,0
,20170512,141530,141530,,,,141530,141530,0,0,0,0.00,0
,20170515,141530,141530,,,,141770,141770,240,240,0,0.00,0
,20170516,141770,141770,,,,141770,141770,0,0,0,0.00,0
,20170517,141770,141770,,,,141770,141770,0,0,0,0.00,0
,20170518,141770,141770,,,,141770,141770,0,0,0,0.00,0
,20170519,141770,141770,,,,141770,141770,0,0,0,0.00,0
,20170522,141770,141770,,,,142750,142750,980,980,0,0.00,0
,20170523,142750,142750,147150,147150,147150,147150,147150,4400,4400,2,29.43,2
,20170524,147150,147150,144160,144160,144160,144160,144160,-2990,-2990,2,28.83,0
,20170525,144160,144160,,,,144160,144160,0,0,0,0.00,0
,20170526,144160,144160,,,,144160,144160,0,0,0,0.00,0
,20170531,144160,144160,,,,144160,144160,0,0,0,0.00,0
,20170601,144160,144160,,,,144160,144160,0,0,0,0.00,0
,20170602,144160,144160,,,,143290,143290,-870,-870,0,0.00,0
,20170605,143290,143290,,,,143290,143290,0,0,0,0.00,0
,20170606,143290,143290,,,,143290,143290,0,0,0,0.00,0
,20170607,143290,143290,,,,143290,143290,0,0,0,0.00,0
,20170608,143290,143290,,,,143290,143290,0,0,0,0.00,0
,20170609,143290,143290,,,,143290,143290,0,0,0,0.00,0
,20170612,143290,143290,,,,143290,143290,0,0,0,0.00,0
,20170613,143290,143290,,,,143290,143290,0,0,0,0.00,0
,20170614,143290,143290,147340,147340,141540,141540,144440,-1750,1150,4,57.78,2
,20170615,141540,144440,,,,144440,144440,0,0,0,0.00,2
,20170616,144440,144440,,,,144440,144440,0,0,0,0.00,2
,20170619,144440,144440,,,,144440,144440,0,0,0,0.00,2
,20170620,144440,144440,,,,144440,144440,0,0,0,0.00,2
,20170621,144440,144440,,,,144440,144440,0,0,0,0.00,2
,20170622,144440,144440,,,,144440,144440,0,0,0,0.00,2
,20170623,144440,144440,,,,144440,144440,0,0,0,0.00,2
,20170626,144440,144440,,,,144440,144440,0,0,0,0.00,2
,20170627,144440,144440,141960,141960,141960,141960,141960,-2480,-2480,2,28.39,0
,20170628,141960,141960,,,,141960,141960,0,0,0,0.00,0
,20170629,141960,141960,,,,141960,141960,0,0,0,0.00,0
,20170630,141960,141960,,,,141960,141960,0,0,0,0.00,0
,20170703,141960,141960,,,,141960,141960,0,0,0,0.00,0
,20170704,141960,141960,,,,141960,141960,0,0,0,0.00,0
,20170705,141960,141960,,,,141960,141960,0,0,0,0.00,0
,20170706,141960,141960,,,,141960,141960,0,0,0,0.00,0
,20170707,141960,141960,,,,141960,141960,0,0,0,0.00,0
,20170710,141960,141960,,,,141960,141960,0,0,0,0.00,0
,20170711,141960,141960,,,,141960,141960,0,0,0,0.00,0
,20170712,141960,141960,,,,141960,141960,0,0,0,0.00,0
,20170713,141960,141960,,,,141960,141960,0,0,0,0.00,0
,20170714,141960,141960,,,,141960,141960,0,0,0,0.00,0
,20170717,141960,141960,,,,141960,141960,0,0,0,0.00,0
sn1708,20170103,144420,144420,,,,147230,147230,2810,2810,0,0.00,0
,20170104,147230,147230,,,,148140,148140,910,910,0,0.00,0
,20170105,148140,148140,,,,149320,149320,1180,1180,0,0.00,0
,20170106,149320,149320,,,,151090,151090,1770,1770,0,0.00,0
,20170109,151090,151090,,,,151120,151120,30,30,0,0.00,0
,20170110,151120,151120,,,,151990,151990,870,870,0,0.00,0
,20170111,151990,151990,,,,152120,152120,130,130,0,0.00,0
,20170112,152120,152120,,,,148560,148560,-3560,-3560,0,0.00,0
,20170113,148560,148560,,,,147590,147590,-970,-970,0,0.00,0
,20170116,147590,147590,,,,148700,148700,1110,1110,0,0.00,0
,20170117,148700,148700,,,,147460,147460,-1240,-1240,0,0.00,0
,20170118,147460,147460,,,,146820,146820,-640,-640,0,0.00,0
,20170119,146820,146820,,,,147040,147040,220,220,0,0.00,0
,20170120,147040,147040,,,,141890,141890,-5150,-5150,0,0.00,0
,20170123,141890,141890,,,,144070,144070,2180,2180,0,0.00,0
,20170124,144070,144070,,,,146650,146650,2580,2580,0,0.00,0
,20170125,146650,146650,,,,144870,144870,-1780,-1780,0,0.00,0
,20170126,144870,144870,,,,145680,145680,810,810,0,0.00,0
,20170203,145680,145680,,,,143350,143350,-2330,-2330,0,0.00,0
,20170206,143350,143350,,,,142230,142230,-1120,-1120,0,0.00,0
,20170207,142230,142230,,,,140840,140840,-1390,-1390,0,0.00,0
,20170208,140840,140840,,,,140130,140130,-710,-710,0,0.00,0
,20170209,140130,140130,,,,141530,141530,1400,1400,0,0.00,0
,20170210,141530,141530,,,,142150,142150,620,620,0,0.00,0
,20170213,142150,142150,,,,144700,144700,2550,2550,0,0.00,0
,20170214,144700,144700,,,,146170,146170,1470,1470,0,0.00,0
,20170215,146170,146170,,,,144970,144970,-1200,-1200,0,0.00,0
,20170216,144970,144970,,,,145170,145170,200,200,0,0.00,0
,20170217,145170,145170,,,,144010,144010,-1160,-1160,0,0.00,0
,20170220,144010,144010,,,,146190,146190,2180,2180,0,0.00,0
,20170221,146190,146190,,,,147950,147950,1760,1760,0,0.00,0
,20170222,147950,147950,,,,147540,147540,-410,-410,0,0.00,0
,20170223,147540,147540,,,,148690,148690,1150,1150,0,0.00,0
,20170224,148690,148690,,,,146930,146930,-1760,-1760,0,0.00,0
,20170227,146930,146930,,,,148740,148740,1810,1810,0,0.00,0
,20170228,148740,148740,,,,148830,148830,90,90,0,0.00,0
,20170301,148830,148830,,,,147970,147970,-860,-860,0,0.00,0
,20170302,147970,147970,,,,149420,149420,1450,1450,0,0.00,0
,20170303,149420,149420,,,,148130,148130,-1290,-1290,0,0.00,0
,20170306,148130,148130,,,,147580,147580,-550,-550,0,0.00,0
,20170307,147580,147580,,,,146610,146610,-970,-970,0,0.00,0
,20170308,146610,146610,,,,145300,145300,-1310,-1310,0,0.00,0
,20170309,145300,145300,,,,141170,141170,-4130,-4130,0,0.00,0
,20170310,141170,141170,,,,140600,140600,-570,-570,0,0.00,0
,20170313,140600,140600,,,,141610,141610,1010,1010,0,0.00,0
,20170314,141610,141610,,,,142040,142040,430,430,0,0.00,0
,20170315,142040,142040,,,,143230,143230,1190,1190,0,0.00,0
,20170316,143230,143230,,,,144270,144270,1040,1040,0,0.00,0
,20170317,144270,144270,,,,144330,144330,60,60,0,0.00,0
,20170320,144330,144330,,,,144650,144650,320,320,0,0.00,0
,20170321,144650,144650,,,,144150,144150,-500,-500,0,0.00,0
,20170322,144150,144150,,,,143680,143680,-470,-470,0,0.00,0
,20170323,143680,143680,,,,143830,143830,150,150,0,0.00,0
,20170324,143830,143830,,,,143700,143700,-130,-130,0,0.00,0
,20170327,143700,143700,,,,141460,141460,-2240,-2240,0,0.00,0
,20170328,141460,141460,,,,140140,140140,-1320,-1320,0,0.00,0
,20170329,140140,140140,,,,139770,139770,-370,-370,0,0.00,0
,20170330,139770,139770,,,,142480,142480,2710,2710,0,0.00,0
,20170331,142480,142480,,,,140510,140510,-1970,-1970,0,0.00,0
,20170405,140510,140510,,,,140460,140460,-50,-50,0,0.00,0
,20170406,140460,140460,,,,140460,140460,0,0,0,0.00,0
,20170407,140460,140460,,,,141510,141510,1050,1050,0,0.00,0
,20170410,141510,141510,,,,141860,141860,350,350,0,0.00,0
,20170411,141860,141860,,,,140850,140850,-1010,-1010,0,0.00,0
,20170412,140850,140850,,,,139470,139470,-1380,-1380,0,0.00,0
,20170413,139470,139470,,,,141310,141310,1840,1840,0,0.00,0
,20170414,141310,141310,,,,141910,141910,600,600,0,0.00,0
,20170417,141910,141910,,,,141500,141500,-410,-410,0,0.00,0
,20170418,141500,141500,,,,142720,142720,1220,1220,0,0.00,0
,20170419,142720,142720,,,,141330,141330,-1390,-1390,0,0.00,0
,20170420,141330,141330,141450,141450,140610,140610,141030,-720,-300,8,112.82,0
,20170421,140610,141030,,,,141140,141140,110,110,0,0.00,0
,20170424,141140,141140,,,,137330,137330,-3810,-3810,0,0.00,0
,20170425,137330,137330,,,,139400,139400,2070,2070,0,0.00,0
,20170426,139400,139400,,,,139820,139820,420,420,0,0.00,0
,20170427,139820,139820,,,,139820,139820,0,0,0,0.00,0
,20170428,139820,139820,,,,140130,140130,310,310,0,0.00,0
,20170502,140130,140130,,,,142800,142800,2670,2670,0,0.00,0
,20170503,142800,142800,,,,142610,142610,-190,-190,0,0.00,0
,20170504,142610,142610,139100,139100,139100,139100,139100,-3510,-3510,2,27.82,2
,20170505,139100,139100,,,,138310,138310,-790,-790,0,0.00,2
,20170508,138310,138310,138320,138320,138320,138320,138320,10,10,2,27.66,4
,20170509,138320,138320,141050,141050,141050,141050,141050,2730,2730,2,28.21,2
,20170510,141050,141050,,,,139760,139760,-1290,-1290,0,0.00,2
,20170511,139760,139760,,,,139700,139700,-60,-60,0,0.00,2
,20170512,139700,139700,,,,139700,139700,0,0,0,0.00,2
,20170515,139700,139700,,,,139940,139940,240,240,0,0.00,2
,20170516,139940,139940,138320,142510,138310,142510,139650,2570,-290,76,"1,061.37",2
,20170517,142510,139650,142990,142990,142990,142990,142990,3340,3340,2,28.60,0
,20170518,142990,142990,,,,142990,142990,0,0,0,0.00,0
,20170519,142990,142990,,,,142990,142990,0,0,0,0.00,0
,20170522,142990,142990,146550,146550,146040,146040,146220,3050,3230,6,87.73,2
,20170523,146040,146220,,,,146220,146220,0,0,0,0.00,2
,20170524,146220,146220,,,,145280,145280,-940,-940,0,0.00,2
,20170525,145280,145280,145500,145500,145500,145500,145500,220,220,2,29.10,2
,20170526,145500,145500,,,,145500,145500,0,0,0,0.00,2
,20170531,145500,145500,,,,144260,144260,-1240,-1240,0,0.00,2
,20170601,144260,144260,141020,145510,141020,144160,143350,-100,-910,8,114.69,4
,20170602,144160,143350,,,,143350,143350,0,0,0,0.00,4
,20170605,143350,143350,,,,143350,143350,0,0,0,0.00,4
,20170606,143350,143350,,,,143350,143350,0,0,0,0.00,4
,20170607,143350,143350,,,,142480,142480,-870,-870,0,0.00,4
,20170608,142480,142480,,,,142480,142480,0,0,0,0.00,4
,20170609,142480,142480,,,,142480,142480,0,0,0,0.00,4
,20170612,142480,142480,,,,142480,142480,0,0,0,0.00,4
,20170613,142480,142480,145390,145390,145390,145390,145390,2910,2910,2,29.08,2
,20170614,145390,145390,145230,145230,145230,145230,145230,-160,-160,2,29.05,0
,20170615,145230,145230,,,,145230,145230,0,0,0,0.00,0
,20170616,145230,145230,,,,145230,145230,0,0,0,0.00,0
,20170619,145230,145230,,,,145230,145230,0,0,0,0.00,0
,20170620,145230,145230,,,,145230,145230,0,0,0,0.00,0
,20170621,145230,145230,,,,145230,145230,0,0,0,0.00,0
,20170622,145230,145230,,,,145230,145230,0,0,0,0.00,0
,20170623,145230,145230,,,,145230,145230,0,0,0,0.00,0
,20170626,145230,145230,,,,145230,145230,0,0,0,0.00,0
,20170627,145230,145230,,,,142730,142730,-2500,-2500,0,0.00,0
,20170628,142730,142730,,,,142730,142730,0,0,0,0.00,0
,20170629,142730,142730,,,,142730,142730,0,0,0,0.00,0
,20170630,142730,142730,,,,142730,142730,0,0,0,0.00,0
,20170703,142730,142730,,,,142730,142730,0,0,0,0.00,0
,20170704,142730,142730,,,,142730,142730,0,0,0,0.00,0
,20170705,142730,142730,151280,151280,142200,142200,147390,-530,4660,16,235.82,4
,20170706,142200,147390,143000,143000,143000,143000,143000,-4390,-4390,2,28.60,2
,20170707,143000,143000,,,,143000,143000,0,0,0,0.00,2
,20170710,143000,143000,,,,143000,143000,0,0,0,0.00,2
,20170711,143000,143000,,,,143000,143000,0,0,0,0.00,2
,20170712,143000,143000,,,,143000,143000,0,0,0,0.00,2
,20170713,143000,143000,,,,143000,143000,0,0,0,0.00,2
,20170714,143000,143000,,,,143000,143000,0,0,0,0.00,2
,20170717,143000,143000,144990,144990,144990,144990,144990,1990,1990,2,29.00,0
,20170718,144990,144990,,,,144990,144990,0,0,0,0.00,0
,20170719,144990,144990,,,,144990,144990,0,0,0,0.00,0
,20170720,144990,144990,,,,144990,144990,0,0,0,0.00,0
,20170721,144990,144990,,,,144990,144990,0,0,0,0.00,0
,20170724,144990,144990,,,,144990,144990,0,0,0,0.00,0
,20170725,144990,144990,,,,144990,144990,0,0,0,0.00,0
,20170726,144990,144990,,,,144990,144990,0,0,0,0.00,0
,20170727,144990,144990,,,,144990,144990,0,0,0,0.00,0
,20170728,144990,144990,,,,144990,144990,0,0,0,0.00,0
,20170731,144990,144990,,,,144990,144990,0,0,0,0.00,0
,20170801,144990,144990,,,,144990,144990,0,0,0,0.00,0
,20170802,144990,144990,,,,144990,144990,0,0,0,0.00,0
,20170803,144990,144990,,,,144990,144990,0,0,0,0.00,0
,20170804,144990,144990,,,,144990,144990,0,0,0,0.00,0
,20170807,144990,144990,,,,144990,144990,0,0,0,0.00,0
,20170808,144990,144990,,,,144990,144990,0,0,0,0.00,0
,20170809,144990,144990,,,,144990,144990,0,0,0,0.00,0
,20170810,144990,144990,,,,144990,144990,0,0,0,0.00,0
,20170811,144990,144990,,,,144990,144990,0,0,0,0.00,0
,20170814,144990,144990,,,,144990,144990,0,0,0,0.00,0
,20170815,144990,144990,,,,144990,144990,0,0,0,0.00,0
sn1709,20170103,147860,148060,150060,151000,149980,150710,150670,2650,2610,92,"1,386.17",88
,20170104,150710,150670,152000,152000,148720,150600,150690,-70,20,44,663.07,92
,20170105,150600,150690,151350,153570,150540,153570,151840,2880,1150,62,941.47,126
,20170106,153570,151840,153570,154410,152420,152420,153660,580,1820,62,952.73,134
,20170109,152420,153660,153040,155050,153040,154200,153830,540,170,106,"1,630.68",140
,20170110,154200,153830,153910,156210,150010,155480,154550,1650,720,174,"2,689.20",140
,20170111,155480,154550,155870,156120,153820,154350,154830,-200,280,226,"3,499.16",176
,20170112,154350,154830,154500,154500,148950,150300,151880,-4530,-2950,146,"2,217.58",176
,20170113,150300,151880,149990,151360,149250,149540,150280,-2340,-1600,172,"2,584.88",162
,20170116,149540,150280,150310,153300,149890,151440,151550,1160,1270,36,545.58,154
,20170117,151440,151550,151450,151500,147470,147740,149960,-3810,-1590,38,569.86,160
,20170118,147740,149960,147930,149380,147930,149380,148320,-580,-1640,66,978.91,158
,20170119,149380,148320,148500,149690,148500,149260,148980,940,660,34,506.56,168
,20170120,149260,148980,150250,150250,145630,145650,147520,-3330,-1460,150,"2,212.84",170
,20170123,145650,147520,144980,146970,144980,146970,145970,-550,-1550,28,408.72,168
,20170124,146970,145970,145610,147890,145610,147300,146690,1330,720,22,322.74,164
,20170125,147300,146690,147400,149840,147390,148950,148710,2260,2020,28,416.40,166
,20170126,148950,148710,149280,149280,148250,148250,148590,-460,-120,6,89.16,170
,20170203,148250,148590,149830,149830,148080,148080,149030,-510,440,40,596.13,178
,20170206,148080,149030,147840,148000,146890,147320,147670,-1710,-1360,54,797.46,190
,20170207,147320,147670,145630,146440,145630,146300,146010,-1370,-1660,36,525.67,206
,20170208,146300,146010,144750,146000,144750,145950,145480,-60,-530,54,785.64,222
,20170209,145950,145480,146290,148130,146290,147500,147470,2020,1990,30,442.43,232
,20170210,147500,147470,148040,148200,147100,147900,147700,430,230,34,502.19,240
,20170213,147900,147700,148620,152200,148620,151910,151190,4210,3490,228,"3,447.32",294
,20170214,151910,151190,152280,152290,151570,151990,151880,800,690,158,"2,399.79",334
,20170215,151990,151880,152790,152790,149470,150450,150990,-1430,-890,106,"1,600.59",390
,20170216,150450,150990,150650,151640,150180,150500,150990,-490,0,106,"1,600.56",414
,20170217,150500,150990,150380,150800,148000,148580,148830,-2410,-2160,96,"1,428.83",428
,20170220,148580,148830,148610,150130,147500,149580,148860,750,30,86,"1,280.26",432
,20170221,149580,148860,150150,151060,150000,150770,150340,1910,1480,164,"2,465.64",488
,20170222,150770,150340,150340,150570,149160,149520,149720,-820,-620,36,539.03,480
,20170223,149520,149720,149400,149400,146750,146900,147880,-2820,-1840,140,"2,070.41",504
,20170224,146900,147880,147040,147700,146000,147130,146970,-750,-910,112,"1,646.11",492
,20170227,147130,146970,147750,149500,147310,148370,148390,1400,1420,108,"1,602.62",516
,20170228,148370,148390,148400,148930,147450,147520,148170,-870,-220,64,948.30,518
,20170301,147520,148170,147210,147770,146090,147110,147060,-1060,-1110,190,"2,794.23",560
,20170302,147110,147060,148640,149420,147800,148000,148650,940,1590,276,"4,102.75",584
,20170303,148000,148650,148230,148230,146470,147010,146870,-1640,-1780,98,"1,439.42",582
,20170306,147010,146870,147100,147610,146010,146160,146670,-710,-200,110,"1,613.44",604
,20170307,146160,146670,145830,146330,144950,144990,145810,-1680,-860,218,"3,178.83",670
,20170308,144990,145810,145380,145380,143730,144030,144400,-1780,-1410,92,"1,328.48",680
,20170309,144030,144400,143010,144500,141300,141920,143330,-2480,-1070,418,"5,991.28",748
,20170310,141920,143330,141350,144010,139630,143330,140990,0,-2340,684,"9,643.98",942
,20170313,143330,140990,143520,145500,142810,144510,144320,3520,3330,252,"3,637.10",970
,20170314,144510,144320,142380,145690,142380,144470,144800,150,480,396,"5,734.36",1212
,20170315,144470,144800,145160,146820,145100,145950,146050,1150,1250,292,"4,264.66",1264
,20170316,145950,146050,146290,147890,146290,147460,147090,1410,1040,150,"2,206.42",1300
,20170317,147460,147090,148080,148080,146570,147300,147340,210,250,276,"4,066.82",1358
,20170320,147300,147340,147680,148210,147120,147660,147590,320,250,686,"10,125.12",1696
,20170321,147660,147590,148370,148570,146540,147120,147650,-470,60,668,"9,863.26",1882
,20170322,147120,147650,147830,148030,145830,147100,146800,-550,-850,424,"6,224.36",1868
,20170323,147100,146800,147100,148770,146780,147840,147640,1040,840,590,"8,711.26",1786
,20170324,147840,147640,147670,148270,146880,147670,147530,30,-110,446,"6,579.97",1752
,20170327,147670,147530,147480,147660,144120,144500,145550,-3030,-1980,1278,"18,602.09",1626
,20170328,144500,145550,143970,146090,143100,144550,144360,-1000,-1190,690,"9,961.17",1648
,20170329,144550,144360,144880,146180,144150,145770,145420,1410,1060,208,"3,024.89",1662
,20170330,145770,145420,145110,145690,144310,144750,144900,-670,-520,250,"3,622.73",1700
,20170331,144750,144900,144650,145700,144310,144490,144940,-410,40,398,"5,768.94",1700
,20170405,144490,144940,144510,145820,143670,145390,144850,450,-90,382,"5,533.57",1768
,20170406,145390,144850,145640,148220,145640,148220,147060,3370,2210,830,"12,206.66",1918
,20170407,148220,147060,148190,148790,146530,147010,147450,-50,390,1504,"22,177.41",2020
,20170410,147010,147450,146840,147770,146450,146620,147090,-830,-360,632,"9,296.43",2042
,20170411,146620,147090,147000,147000,143380,143380,145050,-3710,-2040,1974,"28,633.97",2600
,20170412,143380,145050,143000,143930,141710,142580,142820,-2470,-2230,3098,"44,248.10",3354
,20170413,142580,142820,142390,144500,141570,143560,142850,740,30,3194,"45,626.47",3528
,20170414,143560,142850,143000,144500,141800,141990,143010,-860,160,2040,"29,174.25",3898
,20170417,141990,143010,141910,144470,139830,143760,142690,750,-320,3978,"56,762.18",3954
,20170418,143760,142690,144090,144260,142890,143450,143500,760,810,2126,"30,509.17",4082
,20170419,143450,143500,143450,143760,140580,141770,141780,-1730,-1720,5494,"77,896.63",4886
,20170420,141770,141780,142500,143300,139330,142350,141340,570,-440,8316,"117,538.39",6062
,20170421,142350,141340,141020,142690,140690,140990,141610,-350,270,5878,"83,240.72",6398
,20170424,140990,141610,140490,140720,136900,138300,138760,-3310,-2850,13578,"188,421.51",9148
,20170425,138300,138760,137700,139400,137530,138600,138350,-160,-410,8188,"113,285.29",10428
,20170426,138600,138350,138590,139340,137900,138290,138530,-60,180,8722,"120,831.47",12506
,20170427,138290,138530,139030,142390,138890,141050,140850,2520,2320,12554,"176,830.38",11680
,20170428,141050,140850,139100,142500,139100,142420,141590,1570,740,14648,"207,401.30",11512
,20170502,142420,141590,142980,145790,142690,144660,144700,3070,3110,10510,"152,081.41",11370
,20170503,144660,144700,144800,144800,142840,142960,143630,-1740,-1070,12948,"185,972.12",11418
,20170504,142960,143630,142400,142440,140640,141580,141760,-2050,-1870,16926,"239,951.15",12212
,20170505,141580,141760,141010,142730,140500,140700,141720,-1060,-40,18384,"260,546.93",12798
,20170508,140700,141720,140700,141750,139610,139610,140670,-2110,-1050,18132,"255,078.02",13350
,20170509,139610,140670,139810,142120,139810,141870,140970,1200,300,16882,"237,988.62",13698
,20170510,141870,140970,141850,142630,141140,141230,141800,260,830,13262,"188,060.01",13502
,20170511,141230,141800,141510,142350,140050,142250,141100,450,-700,17502,"246,967.95",13986
,20170512,142250,141100,142600,143500,141700,142050,142230,950,1130,13882,"197,455.85",13856
,20170515,142050,142230,142160,142390,140520,141600,141120,-630,-1110,17118,"241,575.50",13948
,20170516,141600,141120,141030,142450,140230,141000,140910,-120,-210,18322,"258,178.46",14314
,20170517,141000,140910,141020,143360,140700,143190,142070,2280,1160,20462,"290,715.06",15348
,20170518,143190,142070,143190,144320,142490,143960,143590,1890,1520,19490,"279,873.52",16150
,20170519,143960,143590,143590,144940,143300,144050,144240,460,650,17542,"253,039.94",16878
,20170522,144050,144240,144820,147660,144390,145150,146010,910,1770,26512,"387,102.20",17480
,20170523,145150,146010,145850,146190,144700,144990,145610,-1020,-400,15522,"226,027.62",18056
,20170524,144990,145610,145010,145440,143850,144290,144630,-1320,-980,10020,"144,929.20",17920
,20170525,144290,144630,144200,146000,143940,146000,144960,1370,330,13866,"201,009.76",19228
,20170526,146000,144960,145980,146340,144580,144820,145470,-140,510,15314,"222,774.84",18486
,20170531,144820,145470,144880,145480,142710,143240,143810,-2230,-1660,13220,"190,118.67",17678
,20170601,143240,143810,143310,144500,142110,143660,143400,-150,-410,16312,"233,923.33",17822
,20170602,143660,143400,143500,144100,142550,142710,143500,-690,100,11498,"165,007.04",18184
,20170605,142710,143500,142090,143970,142090,142500,142920,-1000,-580,15698,"224,367.48",17746
,20170606,142500,142920,142660,143650,141740,143300,142620,380,-300,15702,"223,956.00",19138
,20170607,143300,142620,142900,144440,141400,141700,142800,-920,180,24842,"354,755.76",20194
,20170608,141700,142800,141640,142300,140990,141810,141630,-990,-1170,17354,"245,792.87",19454
,20170609,141810,141630,141290,142040,141170,142040,141620,410,-10,13662,"193,484.44",19044
,20170612,142040,141620,141680,142500,141500,142190,142020,570,400,14584,"207,132.21",18744
,20170613,142190,142020,142500,145660,141700,144860,143880,2840,1860,29214,"420,357.88",20618
,20170614,144860,143880,144700,146280,144020,146260,145220,2380,1340,26028,"377,978.88",22212
,20170615,146260,145220,145840,146180,144500,144790,145140,-430,-80,20584,"298,765.77",21236
,20170616,144790,145140,144480,146200,144480,145600,145390,460,250,15758,"229,113.19",21356
,20170619,145600,145390,145580,145760,143750,144440,144730,-950,-660,21724,"314,418.45",19834
,20170620,144440,144730,144280,144820,142950,143230,143920,-1500,-810,13668,"196,715.50",19834
,20170621,143230,143920,143090,143480,142210,142950,142890,-970,-1030,17716,"253,151.41",19914
,20170622,142950,142890,143060,145170,143060,144700,144160,1810,1270,19460,"280,554.07",19678
,20170623,144700,144160,144780,145360,143160,144440,144290,280,130,14338,"206,888.02",18970
,20170626,144440,144290,144440,144650,142510,142880,143400,-1410,-890,13744,"197,092.18",20138
,20170627,142880,143400,142880,143230,141740,142970,142460,-430,-940,14826,"211,220.40",20328
,20170628,142970,142460,142880,144670,142830,144450,143710,1990,1250,16806,"241,527.62",19576
,20170629,144450,143710,144450,145330,143920,145190,144750,1480,1040,14526,"210,268.81",20662
,20170630,145190,144750,145440,146200,144850,145650,145510,900,760,17474,"254,265.41",21676
,20170703,145650,145510,145730,145970,145000,145610,145500,100,-10,11030,"160,486.80",22158
,20170704,145610,145500,145900,146600,144300,144760,145470,-740,-30,16606,"241,570.21",21638
,20170705,144760,145470,144510,146120,144510,145530,145370,60,-100,11706,"170,178.92",22184
,20170706,145530,145370,145150,145300,143740,143830,144260,-1540,-1110,14124,"203,764.39",21008
,20170707,143830,144260,143900,144590,143800,144340,144170,80,-90,11220,"161,765.86",21052
,20170710,144340,144170,144300,144850,142850,143420,143680,-750,-490,16618,"238,771.95",20488
,20170711,143420,143680,143420,144790,143020,144750,143920,1070,240,13310,"191,566.47",20584
,20170712,144750,143920,144640,145520,144520,145420,145080,1500,1160,15388,"223,257.82",20890
,20170713,145420,145080,145700,146350,145000,145900,145720,820,640,12480,"181,862.64",22194
,20170714,145900,145720,145520,145800,143310,143400,144390,-2320,-1330,19682,"284,188.80",20500
,20170717,143400,144390,143750,145790,143310,145450,144660,1060,270,16670,"241,160.15",20572
,20170718,145450,144660,145440,145780,144380,145600,145130,940,470,12746,"184,984.35",20420
,20170719,145600,145130,145600,148240,145600,147400,146930,2270,1800,39350,"578,185.82",24884
,20170720,147400,146930,146960,147490,146090,146260,146810,-670,-120,15154,"222,479.74",24540
,20170721,146260,146810,146200,146690,145140,145500,145740,-1310,-1070,16600,"241,929.61",22394
,20170724,145500,145740,145870,147300,145500,146540,146430,800,690,17574,"257,338.30",23108
,20170725,146540,146430,146460,147280,146200,147050,146770,620,340,13634,"200,113.02",23532
,20170726,147050,146770,147500,148400,146520,146840,147450,70,680,24546,"361,953.32",22866
,20170727,146840,147450,146910,150570,146910,150320,148950,2870,1500,44936,"669,343.67",27864
,20170728,150320,148950,150300,151500,148410,149080,150030,130,1080,36612,"549,314.53",25942
,20170731,149080,150030,149410,150640,148800,149910,149990,-120,-40,20548,"308,201.29",25650
,20170801,149910,149990,149780,149960,147210,147290,148420,-2700,-1570,17580,"260,929.57",24076
,20170802,147290,148420,147290,147890,145790,146300,146420,-2120,-2000,16312,"238,843.74",23038
,20170803,146300,146420,146480,147960,146320,147360,147230,940,810,10982,"161,695.58",22050
,20170804,147360,147230,147980,148980,147500,148410,148230,1180,1000,14934,"221,376.79",21022
,20170807,148410,148230,148920,148920,147090,147990,147750,-240,-480,12294,"181,649.09",20900
,20170808,147990,147750,147990,148850,146200,146860,147560,-890,-190,15868,"234,160.82",20870
,20170809,146860,147560,146560,147560,146240,147470,147000,-90,-560,23510,"345,605.95",21148
,20170810,147470,147000,147830,148400,146350,147400,147280,400,280,17184,"253,095.97",20278
,20170811,147400,147280,147190,147540,144590,145550,146260,-1730,-1020,17490,"255,815.39",20218
,20170814,145550,146260,145740,146200,144200,144200,145220,-2060,-1040,11820,"171,656.19",20216
,20170815,144200,145220,143050,145290,143050,144700,144530,-520,-690,10006,"144,624.71",19568
,20170816,144700,144530,144140,145500,143010,143410,143790,-1120,-740,13132,"188,834.91",19226
,20170817,143410,143790,143200,146180,143200,145540,145070,1750,1280,20348,"295,201.81",17130
,20170818,145540,145070,145340,145340,143900,144700,144580,-370,-490,10484,"151,580.39",16320
,20170821,144700,144580,144820,145530,144100,144700,144820,120,240,12170,"176,253.06",15888
,20170822,144700,144820,144440,145250,144050,144510,144640,-310,-180,11220,"162,296.22",15598
,20170823,144510,144640,144930,144930,141810,142340,142770,-2300,-1870,16306,"232,804.69",15408
,20170824,142340,142770,142840,143920,142540,143660,143350,890,580,10404,"149,143.80",13902
,20170825,143660,143350,144440,144440,143270,143700,143770,350,420,10480,"150,678.54",13656
,20170828,143700,143770,143660,144290,142240,144110,143250,340,-520,10778,"154,405.48",12810
,20170829,144110,143250,144490,145500,143620,144330,144660,1080,1410,10816,"156,471.28",11318
,20170830,144330,144660,144520,144920,142800,143540,143850,-1120,-810,7022,"101,014.36",10456
,20170831,143540,143850,143540,145400,142620,144730,144390,880,540,4040,"58,337.36",9728
,20170901,144730,144390,143810,145260,143810,144500,144720,110,330,1048,"15,167.58",9384
,20170904,144500,144720,144500,145170,144370,144380,144860,-340,140,1652,"23,932.44",9084
,20170905,144380,144860,143840,144700,143600,143600,143970,-1260,-890,1028,"14,800.72",8380
,20170906,143600,143970,143660,143780,142600,142600,143320,-1370,-650,1648,"23,619.98",7744
,20170907,142600,143320,142700,142800,141940,142090,142230,-1230,-1090,956,"13,597.66",7548
,20170908,142090,142230,141880,142870,140920,141840,141770,-390,-460,404,"5,727.71",7432
,20170911,141840,141770,141600,142230,140500,142000,141610,230,-160,916,"12,972.07",7168
,20170912,142000,141610,142130,142220,141520,141620,141850,10,240,744,"10,554.34",6924
,20170913,141620,141850,142100,142400,141620,142200,141910,350,60,320,"4,541.26",6832
,20170914,142200,141910,141300,143000,141200,141800,142040,-110,130,512,"7,272.63",6704
,20170915,141800,142040,141820,141820,139810,140100,140790,-1940,-1250,380,"5,350.38",6672
sn1710,20170103,148970,148970,,,,151590,151590,2620,2620,0,0.00,4
,20170104,151590,151590,,,,151610,151610,20,20,0,0.00,4
,20170105,151610,151610,,,,152770,152770,1160,1160,0,0.00,4
,20170106,152770,152770,153740,156220,153740,154740,155080,1970,2310,16,248.14,4
,20170109,154740,155080,153690,153690,153690,153690,153690,-1390,-1390,2,30.74,4
,20170110,153690,153690,154700,154700,154700,154700,154700,1010,1010,2,30.94,4
,20170111,154700,154700,,,,154980,154980,280,280,0,0.00,4
,20170112,154980,154980,,,,152030,152030,-2950,-2950,0,0.00,4
,20170113,152030,152030,,,,150430,150430,-1600,-1600,0,0.00,4
,20170116,150430,150430,,,,151700,151700,1270,1270,0,0.00,4
,20170117,151700,151700,,,,150110,150110,-1590,-1590,0,0.00,4
,20170118,150110,150110,,,,148460,148460,-1650,-1650,0,0.00,4
,20170119,148460,148460,,,,149120,149120,660,660,0,0.00,4
,20170120,149120,149120,,,,147660,147660,-1460,-1460,0,0.00,4
,20170123,147660,147660,,,,146100,146100,-1560,-1560,0,0.00,4
,20170124,146100,146100,,,,146820,146820,720,720,0,0.00,4
,20170125,146820,146820,148990,148990,148990,148990,148990,2170,2170,4,59.60,4
,20170126,148990,148990,150700,150700,148830,148830,149760,-160,770,8,119.81,0
,20170203,148830,149760,,,,150200,150200,440,440,0,0.00,0
,20170206,150200,150200,,,,148830,148830,-1370,-1370,0,0.00,0
,20170207,148830,148830,,,,147160,147160,-1670,-1670,0,0.00,0
,20170208,147160,147160,,,,146630,146630,-530,-530,0,0.00,0
,20170209,146630,146630,,,,148640,148640,2010,2010,0,0.00,0
,20170210,148640,148640,,,,148870,148870,230,230,0,0.00,0
,20170213,148870,148870,,,,152390,152390,3520,3520,0,0.00,0
,20170214,152390,152390,,,,153090,153090,700,700,0,0.00,0
,20170215,153090,153090,,,,152200,152200,-890,-890,0,0.00,0
,20170216,152200,152200,,,,152200,152200,0,0,0,0.00,0
,20170217,152200,152200,,,,150020,150020,-2180,-2180,0,0.00,0
,20170220,150020,150020,,,,150050,150050,30,30,0,0.00,0
,20170221,150050,150050,,,,151540,151540,1490,1490,0,0.00,0
,20170222,151540,151540,,,,150920,150920,-620,-620,0,0.00,0
,20170223,150920,150920,,,,149070,149070,-1850,-1850,0,0.00,0
,20170224,149070,149070,,,,148150,148150,-920,-920,0,0.00,0
,20170227,148150,148150,,,,149580,149580,1430,1430,0,0.00,0
,20170228,149580,149580,,,,149360,149360,-220,-220,0,0.00,0
,20170301,149360,149360,,,,148240,148240,-1120,-1120,0,0.00,0
,20170302,148240,148240,,,,149840,149840,1600,1600,0,0.00,0
,20170303,149840,149840,,,,148050,148050,-1790,-1790,0,0.00,0
,20170306,148050,148050,,,,147850,147850,-200,-200,0,0.00,0
,20170307,147850,147850,,,,146990,146990,-860,-860,0,0.00,0
,20170308,146990,146990,,,,145560,145560,-1430,-1430,0,0.00,0
,20170309,145560,145560,,,,144480,144480,-1080,-1080,0,0.00,0
,20170310,144480,144480,,,,142120,142120,-2360,-2360,0,0.00,0
,20170313,142120,142120,,,,145480,145480,3360,3360,0,0.00,0
,20170314,145480,145480,,,,145970,145970,490,490,0,0.00,0
,20170315,145970,145970,,,,147230,147230,1260,1260,0,0.00,0
,20170316,147230,147230,,,,148280,148280,1050,1050,0,0.00,0
,20170317,148280,148280,,,,148540,148540,260,260,0,0.00,0
,20170320,148540,148540,,,,148790,148790,250,250,0,0.00,0
,20170321,148790,148790,,,,148850,148850,60,60,0,0.00,0
,20170322,148850,148850,,,,147990,147990,-860,-860,0,0.00,0
,20170323,147990,147990,,,,148840,148840,850,850,0,0.00,0
,20170324,148840,148840,,,,148730,148730,-110,-110,0,0.00,0
,20170327,148730,148730,,,,146740,146740,-1990,-1990,0,0.00,0
,20170328,146740,146740,,,,145540,145540,-1200,-1200,0,0.00,0
,20170329,145540,145540,,,,146610,146610,1070,1070,0,0.00,0
,20170330,146610,146610,,,,146090,146090,-520,-520,0,0.00,0
,20170331,146090,146090,,,,146130,146130,40,40,0,0.00,0
,20170405,146130,146130,,,,146040,146040,-90,-90,0,0.00,0
,20170406,146040,146040,,,,148270,148270,2230,2230,0,0.00,0
,20170407,148270,148270,,,,148660,148660,390,390,0,0.00,0
,20170410,148660,148660,,,,148300,148300,-360,-360,0,0.00,0
,20170411,148300,148300,,,,146240,146240,-2060,-2060,0,0.00,0
,20170412,146240,146240,,,,143990,143990,-2250,-2250,0,0.00,0
,20170413,143990,143990,,,,144020,144020,30,30,0,0.00,0
,20170414,144020,144020,,,,144180,144180,160,160,0,0.00,0
,20170417,144180,144180,,,,143850,143850,-330,-330,0,0.00,0
,20170418,143850,143850,,,,144670,144670,820,820,0,0.00,0
,20170419,144670,144670,,,,142940,142940,-1730,-1730,0,0.00,0
,20170420,142940,142940,,,,142940,142940,0,0,0,0.00,0
,20170421,142940,142940,,,,143210,143210,270,270,0,0.00,0
,20170424,143210,143210,,,,140330,140330,-2880,-2880,0,0.00,0
,20170425,140330,140330,,,,139920,139920,-410,-410,0,0.00,0
,20170426,139920,139920,,,,140100,140100,180,180,0,0.00,0
,20170427,140100,140100,,,,140130,140130,30,30,0,0.00,0
,20170428,140130,140130,,,,140860,140860,730,730,0,0.00,0
,20170502,140860,140860,,,,143950,143950,3090,3090,0,0.00,0
,20170503,143950,143950,,,,142880,142880,-1070,-1070,0,0.00,0
,20170504,142880,142880,,,,141020,141020,-1860,-1860,0,0.00,0
,20170505,141020,141020,,,,140980,140980,-40,-40,0,0.00,0
,20170508,140980,140980,,,,139940,139940,-1040,-1040,0,0.00,0
,20170509,139940,139940,,,,140240,140240,300,300,0,0.00,0
,20170510,140240,140240,,,,141060,141060,820,820,0,0.00,0
,20170511,141060,141060,,,,140370,140370,-690,-690,0,0.00,0
,20170512,140370,140370,,,,141500,141500,1130,1130,0,0.00,0
,20170515,141500,141500,,,,140390,140390,-1110,-1110,0,0.00,0
,20170516,140390,140390,,,,140180,140180,-210,-210,0,0.00,0
,20170517,140180,140180,,,,141330,141330,1150,1150,0,0.00,0
,20170518,141330,141330,,,,142850,142850,1520,1520,0,0.00,0
,20170519,142850,142850,,,,143500,143500,650,650,0,0.00,0
,20170522,143500,143500,,,,145260,145260,1760,1760,0,0.00,0
,20170523,145260,145260,,,,144860,144860,-400,-400,0,0.00,0
,20170524,144860,144860,,,,143890,143890,-970,-970,0,0.00,0
,20170525,143890,143890,,,,144220,144220,330,330,0,0.00,0
,20170526,144220,144220,,,,144720,144720,500,500,0,0.00,0
,20170531,144720,144720,,,,143060,143060,-1660,-1660,0,0.00,0
,20170601,143060,143060,,,,142650,142650,-410,-410,0,0.00,0
,20170602,142650,142650,,,,142750,142750,100,100,0,0.00,0
,20170605,142750,142750,141130,141240,141130,141240,141180,-1510,-1570,4,56.47,4
,20170606,141240,141180,,,,141840,141840,660,660,0,0.00,4
,20170607,141840,141840,,,,141840,141840,0,0,0,0.00,4
,20170608,141840,141840,,,,141840,141840,0,0,0,0.00,4
,20170609,141840,141840,,,,141830,141830,-10,-10,0,0.00,4
,20170612,141830,141830,,,,141830,141830,0,0,0,0.00,4
,20170613,141830,141830,,,,143690,143690,1860,1860,0,0.00,4
,20170614,143690,143690,,,,144300,144300,610,610,0,0.00,4
,20170615,144300,144300,,,,144300,144300,0,0,0,0.00,4
,20170616,144300,144300,,,,144300,144300,0,0,0,0.00,4
,20170619,144300,144300,143480,145730,143480,145730,144600,1430,300,4,57.84,4
,20170620,145730,144600,,,,144460,144460,-140,-140,0,0.00,4
,20170621,144460,144460,,,,144460,144460,0,0,0,0.00,4
,20170622,144460,144460,,,,144460,144460,0,0,0,0.00,4
,20170623,144460,144460,,,,144460,144460,0,0,0,0.00,4
,20170626,144460,144460,143070,143070,143060,143060,143060,-1400,-1400,4,57.23,0
,20170627,143060,143060,,,,142120,142120,-940,-940,0,0.00,0
,20170628,142120,142120,,,,143370,143370,1250,1250,0,0.00,0
,20170629,143370,143370,,,,144410,144410,1040,1040,0,0.00,0
,20170630,144410,144410,,,,145160,145160,750,750,0,0.00,0
,20170703,145160,145160,,,,145150,145150,-10,-10,0,0.00,0
,20170704,145150,145150,,,,145120,145120,-30,-30,0,0.00,0
,20170705,145120,145120,,,,145020,145020,-100,-100,0,0.00,0
,20170706,145020,145020,,,,143920,143920,-1100,-1100,0,0.00,0
,20170707,143920,143920,,,,143830,143830,-90,-90,0,0.00,0
,20170710,143830,143830,,,,143340,143340,-490,-490,0,0.00,0
,20170711,143340,143340,145250,145250,142310,142310,143780,-1030,440,4,57.51,0
,20170712,142310,143780,,,,144940,144940,1160,1160,0,0.00,0
,20170713,144940,144940,,,,145580,145580,640,640,0,0.00,0
,20170714,145580,145580,,,,144250,144250,-1330,-1330,0,0.00,0
,20170717,144250,144250,,,,144520,144520,270,270,0,0.00,0
,20170718,144520,144520,,,,144990,144990,470,470,0,0.00,0
,20170719,144990,144990,,,,146790,146790,1800,1800,0,0.00,0
,20170720,146790,146790,,,,146670,146670,-120,-120,0,0.00,0
,20170721,146670,146670,143680,147670,143680,146600,145980,-70,-690,6,87.59,0
,20170724,146600,145980,,,,146670,146670,690,690,0,0.00,0
,20170725,146670,146670,,,,147010,147010,340,340,0,0.00,0
,20170726,147010,147010,,,,147700,147700,690,690,0,0.00,0
,20170727,147700,147700,,,,149200,149200,1500,1500,0,0.00,0
,20170728,149200,149200,,,,150280,150280,1080,1080,0,0.00,0
,20170731,150280,150280,,,,150240,150240,-40,-40,0,0.00,0
,20170801,150240,150240,152340,152340,148880,148880,150510,-1360,270,14,210.72,6
,20170802,148880,150510,,,,148480,148480,-2030,-2030,0,0.00,6
,20170803,148480,148480,,,,148480,148480,0,0,0,0.00,6
,20170804,148480,148480,148640,148640,148640,148640,148640,160,160,2,29.73,4
,20170807,148640,148640,,,,148160,148160,-480,-480,0,0.00,4
,20170808,148160,148160,148180,148760,148180,148760,148470,600,310,4,59.39,4
,20170809,148760,148470,,,,147910,147910,-560,-560,0,0.00,4
,20170810,147910,147910,,,,148190,148190,280,280,0,0.00,4
,20170811,148190,148190,148170,148420,146390,148420,147660,230,-530,6,88.60,4
,20170814,148420,147660,,,,146610,146610,-1050,-1050,0,0.00,4
,20170815,146610,146610,,,,145920,145920,-690,-690,0,0.00,4
,20170816,145920,145920,144350,144350,144350,144350,144350,-1570,-1570,2,28.87,4
,20170817,144350,144350,,,,145640,145640,1290,1290,0,0.00,4
,20170818,145640,145640,,,,145150,145150,-490,-490,0,0.00,4
,20170821,145150,145150,145110,147300,145110,145650,146380,500,1230,14,204.94,6
,20170822,145650,146380,147870,147870,145190,145910,147150,-470,770,68,"1,000.67",50
,20170823,145910,147150,144670,144720,141620,143790,143870,-3360,-3280,20,287.75,50
,20170824,143790,143870,143600,143600,143600,143600,143600,-270,-270,4,57.44,46
,20170825,143600,143600,143900,143950,142800,143940,143850,340,250,44,632.97,16
,20170828,143940,143850,143380,143380,143380,143380,143380,-470,-470,12,172.06,28
,20170829,143380,143380,144710,144900,144710,144900,144870,1520,1490,24,347.70,14
,20170830,144900,144870,143730,144320,143730,144320,143840,-550,-1030,10,143.85,20
,20170831,144320,143840,145190,146630,145190,145950,146280,2110,2440,64,936.24,32
,20170901,145950,146280,148300,148300,145350,145630,147190,-650,910,52,765.41,34
,20170904,145630,147190,146600,146600,144300,144300,145860,-2890,-1330,32,466.77,44
,20170905,144300,145860,144920,145130,144540,145130,144870,-730,-990,20,289.76,32
,20170906,145130,144870,143200,144820,143200,144820,144010,-50,-860,4,57.60,34
,20170907,144820,144010,143170,143170,142510,142510,142610,-1500,-1400,24,342.29,32
,20170908,142510,142610,142030,144230,142030,142400,142880,-210,270,20,285.77,32
,20170911,142400,142880,,,,142720,142720,-160,-160,0,0.00,32
,20170912,142720,142720,,,,142720,142720,0,0,0,0.00,32
,20170913,142720,142720,,,,142780,142780,60,60,0,0.00,32
,20170914,142780,142780,,,,142780,142780,0,0,0,0.00,32
,20170915,142780,142780,,,,141530,141530,-1250,-1250,0,0.00,32
,20170918,141530,141530,,,,141530,141530,0,0,0,0.00,32
,20170919,141530,141530,,,,141530,141530,0,0,0,0.00,32
,20170920,141530,141530,,,,143300,143300,1770,1770,0,0.00,32
,20170921,143300,143300,,,,143300,143300,0,0,0,0.00,32
,20170922,143300,143300,,,,143300,143300,0,0,0,0.00,32
,20170925,143300,143300,145000,145000,143500,143500,143680,200,380,32,459.80,32
,20170926,143500,143680,143000,144500,143000,144500,143660,820,-20,18,258.60,40
,20170927,144500,143660,,,,143660,143660,0,0,0,0.00,40
,20170928,143660,143660,,,,143660,143660,0,0,0,0.00,40
,20170929,143660,143660,,,,146000,146000,2340,2340,0,0.00,40
,20171009,146000,146000,,,,146000,146000,0,0,0,0.00,40
,20171010,146000,146000,,,,146000,146000,0,0,0,0.00,40
,20171011,146000,146000,,,,146000,146000,0,0,0,0.00,40
,20171012,146000,146000,,,,146000,146000,0,0,0,0.00,40
,20171013,146000,146000,,,,146000,146000,0,0,0,0.00,40
,20171016,146000,146000,,,,146000,146000,0,0,0,0.00,40
sn1711,20170103,151470,151470,,,,154140,154140,2670,2670,0,0.00,2
,20170104,154140,154140,,,,154160,154160,20,20,0,0.00,2
,20170105,154160,154160,,,,155340,155340,1180,1180,0,0.00,2
,20170106,155340,155340,,,,157690,157690,2350,2350,0,0.00,2
,20170109,157690,157690,,,,156270,156270,-1420,-1420,0,0.00,2
,20170110,156270,156270,,,,157290,157290,1020,1020,0,0.00,2
,20170111,157290,157290,,,,157570,157570,280,280,0,0.00,2
,20170112,157570,157570,,,,154570,154570,-3000,-3000,0,0.00,2
,20170113,154570,154570,,,,152940,152940,-1630,-1630,0,0.00,2
,20170116,152940,152940,,,,154230,154230,1290,1290,0,0.00,2
,20170117,154230,154230,,,,152610,152610,-1620,-1620,0,0.00,2
,20170118,152610,152610,,,,150940,150940,-1670,-1670,0,0.00,2
,20170119,150940,150940,,,,151610,151610,670,670,0,0.00,2
,20170120,151610,151610,,,,150120,150120,-1490,-1490,0,0.00,2
,20170123,150120,150120,,,,148540,148540,-1580,-1580,0,0.00,2
,20170124,148540,148540,,,,149280,149280,740,740,0,0.00,2
,20170125,149280,149280,,,,151480,151480,2200,2200,0,0.00,2
,20170126,151480,151480,,,,152260,152260,780,780,0,0.00,2
,20170203,152260,152260,,,,152710,152710,450,450,0,0.00,2
,20170206,152710,152710,,,,151320,151320,-1390,-1390,0,0.00,2
,20170207,151320,151320,,,,149620,149620,-1700,-1700,0,0.00,2
,20170208,149620,149620,,,,149080,149080,-540,-540,0,0.00,2
,20170209,149080,149080,,,,151120,151120,2040,2040,0,0.00,2
,20170210,151120,151120,,,,151350,151350,230,230,0,0.00,2
,20170213,151350,151350,,,,154930,154930,3580,3580,0,0.00,2
,20170214,154930,154930,,,,155640,155640,710,710,0,0.00,2
,20170215,155640,155640,,,,154730,154730,-910,-910,0,0.00,2
,20170216,154730,154730,,,,154730,154730,0,0,0,0.00,2
,20170217,154730,154730,,,,152520,152520,-2210,-2210,0,0.00,2
,20170220,152520,152520,,,,152550,152550,30,30,0,0.00,2
,20170221,152550,152550,,,,154070,154070,1520,1520,0,0.00,2
,20170222,154070,154070,,,,153440,153440,-630,-630,0,0.00,2
,20170223,153440,153440,,,,151560,151560,-1880,-1880,0,0.00,2
,20170224,151560,151560,,,,150630,150630,-930,-930,0,0.00,2
,20170227,150630,150630,,,,152080,152080,1450,1450,0,0.00,2
,20170228,152080,152080,,,,151850,151850,-230,-230,0,0.00,2
,20170301,151850,151850,,,,150710,150710,-1140,-1140,0,0.00,2
,20170302,150710,150710,,,,152330,152330,1620,1620,0,0.00,2
,20170303,152330,152330,,,,150510,150510,-1820,-1820,0,0.00,2
,20170306,150510,150510,,,,150310,150310,-200,-200,0,0.00,2
,20170307,150310,150310,,,,149430,149430,-880,-880,0,0.00,2
,20170308,149430,149430,,,,147980,147980,-1450,-1450,0,0.00,2
,20170309,147980,147980,,,,146880,146880,-1100,-1100,0,0.00,2
,20170310,146880,146880,,,,144480,144480,-2400,-2400,0,0.00,2
,20170313,144480,144480,,,,147900,147900,3420,3420,0,0.00,2
,20170314,147900,147900,,,,148390,148390,490,490,0,0.00,2
,20170315,148390,148390,,,,149670,149670,1280,1280,0,0.00,2
,20170316,149670,149670,,,,150740,150740,1070,1070,0,0.00,2
,20170317,150740,150740,,,,151000,151000,260,260,0,0.00,2
,20170320,151000,151000,,,,151260,151260,260,260,0,0.00,2
,20170321,151260,151260,150000,150000,144190,144190,147110,-7070,-4150,16,235.38,8
,20170322,144190,147110,148060,148060,144970,144970,147030,-2140,-80,6,88.22,4
,20170323,144970,147030,144550,144550,144550,144550,144550,-2480,-2480,2,28.91,4
,20170324,144550,144550,,,,144440,144440,-110,-110,0,0.00,4
,20170327,144440,144440,146950,146950,143230,144500,145400,60,960,8,116.33,2
,20170328,144500,145400,,,,144210,144210,-1190,-1190,0,0.00,2
,20170329,144210,144210,,,,145270,145270,1060,1060,0,0.00,2
,20170330,145270,145270,,,,144750,144750,-520,-520,0,0.00,2
,20170331,144750,144750,,,,144790,144790,40,40,0,0.00,2
,20170405,144790,144790,,,,144700,144700,-90,-90,0,0.00,2
,20170406,144700,144700,,,,146910,146910,2210,2210,0,0.00,2
,20170407,146910,146910,,,,147300,147300,390,390,0,0.00,2
,20170410,147300,147300,,,,146940,146940,-360,-360,0,0.00,2
,20170411,146940,146940,,,,144900,144900,-2040,-2040,0,0.00,2
,20170412,144900,144900,,,,142680,142680,-2220,-2220,0,0.00,2
,20170413,142680,142680,,,,142710,142710,30,30,0,0.00,2
,20170414,142710,142710,,,,142870,142870,160,160,0,0.00,2
,20170417,142870,142870,143430,143430,143430,143430,143430,560,560,2,28.69,0
,20170418,143430,143430,,,,144240,144240,810,810,0,0.00,0
,20170419,144240,144240,,,,142510,142510,-1730,-1730,0,0.00,0
,20170420,142510,142510,,,,142510,142510,0,0,0,0.00,0
,20170421,142510,142510,,,,142780,142780,270,270,0,0.00,0
,20170424,142780,142780,,,,139910,139910,-2870,-2870,0,0.00,0
,20170425,139910,139910,,,,139500,139500,-410,-410,0,0.00,0
,20170426,139500,139500,,,,139680,139680,180,180,0,0.00,0
,20170427,139680,139680,,,,140240,140240,560,560,0,0.00,0
,20170428,140240,140240,,,,140970,140970,730,730,0,0.00,0
,20170502,140970,140970,,,,144060,144060,3090,3090,0,0.00,0
,20170503,144060,144060,,,,142990,142990,-1070,-1070,0,0.00,0
,20170504,142990,142990,,,,141130,141130,-1860,-1860,0,0.00,0
,20170505,141130,141130,,,,141090,141090,-40,-40,0,0.00,0
,20170508,141090,141090,,,,140050,140050,-1040,-1040,0,0.00,0
,20170509,140050,140050,,,,140350,140350,300,300,0,0.00,0
,20170510,140350,140350,,,,141170,141170,820,820,0,0.00,0
,20170511,141170,141170,,,,140480,140480,-690,-690,0,0.00,0
,20170512,140480,140480,,,,141610,141610,1130,1130,0,0.00,0
,20170515,141610,141610,,,,140500,140500,-1110,-1110,0,0.00,0
,20170516,140500,140500,,,,140290,140290,-210,-210,0,0.00,0
,20170517,140290,140290,,,,141450,141450,1160,1160,0,0.00,0
,20170518,141450,141450,,,,142970,142970,1520,1520,0,0.00,0
,20170519,142970,142970,,,,143620,143620,650,650,0,0.00,0
,20170522,143620,143620,,,,145380,145380,1760,1760,0,0.00,0
,20170523,145380,145380,,,,144980,144980,-400,-400,0,0.00,0
,20170524,144980,144980,,,,144010,144010,-970,-970,0,0.00,0
,20170525,144010,144010,,,,144340,144340,330,330,0,0.00,0
,20170526,144340,144340,,,,144840,144840,500,500,0,0.00,0
,20170531,144840,144840,,,,143180,143180,-1660,-1660,0,0.00,0
,20170601,143180,143180,,,,142770,142770,-410,-410,0,0.00,0
,20170602,142770,142770,,,,142870,142870,100,100,0,0.00,0
,20170605,142870,142870,,,,141300,141300,-1570,-1570,0,0.00,0
,20170606,141300,141300,,,,141010,141010,-290,-290,0,0.00,0
,20170607,141010,141010,,,,141190,141190,180,180,0,0.00,0
,20170608,141190,141190,,,,140030,140030,-1160,-1160,0,0.00,0
,20170609,140030,140030,,,,140020,140020,-10,-10,0,0.00,0
,20170612,140020,140020,,,,140420,140420,400,400,0,0.00,0
,20170613,140420,140420,,,,142260,142260,1840,1840,0,0.00,0
,20170614,142260,142260,,,,143580,143580,1320,1320,0,0.00,0
,20170615,143580,143580,,,,143500,143500,-80,-80,0,0.00,0
,20170616,143500,143500,,,,143750,143750,250,250,0,0.00,0
,20170619,143750,143750,,,,144050,144050,300,300,0,0.00,0
,20170620,144050,144050,,,,143240,143240,-810,-810,0,0.00,0
,20170621,143240,143240,,,,142210,142210,-1030,-1030,0,0.00,0
,20170622,142210,142210,,,,143480,143480,1270,1270,0,0.00,0
,20170623,143480,143480,,,,143610,143610,130,130,0,0.00,0
,20170626,143610,143610,,,,142220,142220,-1390,-1390,0,0.00,0
,20170627,142220,142220,,,,141290,141290,-930,-930,0,0.00,0
,20170628,141290,141290,,,,142530,142530,1240,1240,0,0.00,0
,20170629,142530,142530,,,,143560,143560,1030,1030,0,0.00,0
,20170630,143560,143560,,,,144310,144310,750,750,0,0.00,0
,20170703,144310,144310,,,,144300,144300,-10,-10,0,0.00,0
,20170704,144300,144300,,,,144270,144270,-30,-30,0,0.00,0
,20170705,144270,144270,,,,144170,144170,-100,-100,0,0.00,0
,20170706,144170,144170,,,,143070,143070,-1100,-1100,0,0.00,0
,20170707,143070,143070,,,,142980,142980,-90,-90,0,0.00,0
,20170710,142980,142980,,,,142490,142490,-490,-490,0,0.00,0
,20170711,142490,142490,,,,142920,142920,430,430,0,0.00,0
,20170712,142920,142920,,,,144070,144070,1150,1150,0,0.00,0
,20170713,144070,144070,,,,144700,144700,630,630,0,0.00,0
,20170714,144700,144700,,,,143370,143370,-1330,-1330,0,0.00,0
,20170717,143370,143370,,,,143640,143640,270,270,0,0.00,0
,20170718,143640,143640,,,,144100,144100,460,460,0,0.00,0
,20170719,144100,144100,,,,145890,145890,1790,1790,0,0.00,0
,20170720,145890,145890,,,,145770,145770,-120,-120,0,0.00,0
,20170721,145770,145770,,,,145080,145080,-690,-690,0,0.00,0
,20170724,145080,145080,,,,145760,145760,680,680,0,0.00,0
,20170725,145760,145760,,,,146100,146100,340,340,0,0.00,0
,20170726,146100,146100,,,,146780,146780,680,680,0,0.00,0
,20170727,146780,146780,,,,148270,148270,1490,1490,0,0.00,0
,20170728,148270,148270,,,,149350,149350,1080,1080,0,0.00,0
,20170731,149350,149350,,,,149310,149310,-40,-40,0,0.00,0
,20170801,149310,149310,,,,149580,149580,270,270,0,0.00,0
,20170802,149580,149580,,,,147560,147560,-2020,-2020,0,0.00,0
,20170803,147560,147560,,,,148380,148380,820,820,0,0.00,0
,20170804,148380,148380,,,,148530,148530,150,150,0,0.00,0
,20170807,148530,148530,,,,148050,148050,-480,-480,0,0.00,0
,20170808,148050,148050,,,,148350,148350,300,300,0,0.00,0
,20170809,148350,148350,150780,150780,150780,150780,150780,2430,2430,2,30.16,2
,20170810,150780,150780,,,,151070,151070,290,290,0,0.00,2
,20170811,151070,151070,,,,150520,150520,-550,-550,0,0.00,2
,20170814,150520,150520,,,,149450,149450,-1070,-1070,0,0.00,2
,20170815,149450,149450,,,,148740,148740,-710,-710,0,0.00,2
,20170816,148740,148740,,,,147130,147130,-1610,-1610,0,0.00,2
,20170817,147130,147130,,,,148440,148440,1310,1310,0,0.00,2
,20170818,148440,148440,,,,147940,147940,-500,-500,0,0.00,2
,20170821,147940,147940,,,,149200,149200,1260,1260,0,0.00,2
,20170822,149200,149200,,,,149990,149990,790,790,0,0.00,2
,20170823,149990,149990,,,,146650,146650,-3340,-3340,0,0.00,2
,20170824,146650,146650,,,,146370,146370,-280,-280,0,0.00,2
,20170825,146370,146370,,,,146630,146630,260,260,0,0.00,2
,20170828,146630,146630,,,,146630,146630,0,0,0,0.00,2
,20170829,146630,146630,148220,148220,148220,148220,148220,1590,1590,2,29.64,2
,20170830,148220,148220,,,,147170,147170,-1050,-1050,0,0.00,2
,20170831,147170,147170,,,,149670,149670,2500,2500,0,0.00,2
,20170901,149670,149670,,,,150600,150600,930,930,0,0.00,2
,20170904,150600,150600,,,,149240,149240,-1360,-1360,0,0.00,2
,20170905,149240,149240,,,,148230,148230,-1010,-1010,0,0.00,2
,20170906,148230,148230,,,,147350,147350,-880,-880,0,0.00,2
,20170907,147350,147350,141490,141490,141490,141490,141490,-5860,-5860,2,28.30,2
,20170908,141490,141490,,,,141760,141760,270,270,0,0.00,2
,20170911,141760,141760,,,,141600,141600,-160,-160,0,0.00,2
,20170912,141600,141600,,,,141840,141840,240,240,0,0.00,2
,20170913,141840,141840,143090,143090,141580,142820,142490,980,650,6,85.50,2
,20170914,142820,142490,,,,142490,142490,0,0,0,0.00,2
,20170915,142490,142490,146180,146180,141570,142920,143680,430,1190,10,143.68,6
,20170918,142920,143680,,,,143680,143680,0,0,0,0.00,6
,20170919,143680,143680,,,,143680,143680,0,0,0,0.00,6
,20170920,143680,143680,,,,143710,143710,30,30,0,0.00,6
,20170921,143710,143710,,,,143710,143710,0,0,0,0.00,6
,20170922,143710,143710,,,,143710,143710,0,0,0,0.00,6
,20170925,143710,143710,,,,143710,143710,0,0,0,0.00,6
,20170926,143710,143710,,,,145380,145380,1670,1670,0,0.00,6
,20170927,145380,145380,145080,146000,144700,145320,145230,-60,-150,10,145.24,6
,20170928,145320,145230,,,,145230,145230,0,0,0,0.00,6
,20170929,145230,145230,,,,145230,145230,0,0,0,0.00,6
,20171009,145230,145230,,,,145290,145290,60,60,0,0.00,6
,20171010,145290,145290,,,,145290,145290,0,0,0,0.00,6
,20171011,145290,145290,,,,145200,145200,-90,-90,0,0.00,6
,20171012,145200,145200,144410,144410,144410,144410,144410,-790,-790,2,28.88,6
,20171013,144410,144410,,,,144410,144410,0,0,0,0.00,6
,20171016,144410,144410,145950,145950,144210,145600,145330,1190,920,16,232.54,10
,20171017,145600,145330,,,,145330,145330,0,0,0,0.00,10
,20171018,145330,145330,,,,144550,144550,-780,-780,0,0.00,10
,20171019,144550,144550,,,,144250,144250,-300,-300,0,0.00,10
,20171020,144250,144250,143770,143800,143750,143800,143780,-450,-470,8,115.02,14
,20171023,143800,143780,,,,143780,143780,0,0,0,0.00,14
,20171024,143780,143780,,,,143780,143780,0,0,0,0.00,14
,20171025,143780,143780,,,,143780,143780,0,0,0,0.00,14
,20171026,143780,143780,143630,144000,143630,144000,143930,220,150,12,172.73,24
,20171027,144000,143930,,,,143930,143930,0,0,0,0.00,24
,20171030,143930,143930,143500,143500,143500,143500,143500,-430,-430,6,86.10,28
,20171031,143500,143500,142850,142850,142850,142850,142850,-650,-650,4,57.14,32
,20171101,142850,142850,,,,142850,142850,0,0,0,0.00,32
,20171102,142850,142850,140110,140110,139980,139980,140040,-2870,-2810,8,112.04,32
,20171103,139980,140040,145890,145890,136460,136460,141170,-3580,1130,8,112.94,36
,20171106,136460,141170,142500,142500,142500,142500,142500,1330,1330,8,114.00,44
,20171107,142500,142500,142000,142000,142000,142000,142000,-500,-500,4,56.80,40
,20171108,142000,142000,,,,142000,142000,0,0,0,0.00,40
,20171109,142000,142000,,,,142000,142000,0,0,0,0.00,40
,20171110,142000,142000,142000,142000,142000,142000,142000,0,0,4,56.80,40
,20171113,142000,142000,,,,142000,142000,0,0,0,0.00,40
,20171114,142000,142000,,,,142000,142000,0,0,0,0.00,40
,20171115,142000,142000,,,,142000,142000,0,0,0,0.00,40
sn1712,20170103,148400,148400,,,,151010,151010,2610,2610,0,0.00,0
,20170104,151010,151010,,,,151030,151030,20,20,0,0.00,0
,20170105,151030,151030,,,,152190,152190,1160,1160,0,0.00,0
,20170106,152190,152190,,,,154490,154490,2300,2300,0,0.00,0
,20170109,154490,154490,,,,153100,153100,-1390,-1390,0,0.00,0
,20170110,153100,153100,,,,154100,154100,1000,1000,0,0.00,0
,20170111,154100,154100,,,,154370,154370,270,270,0,0.00,0
,20170112,154370,154370,,,,151430,151430,-2940,-2940,0,0.00,0
,20170113,151430,151430,,,,149830,149830,-1600,-1600,0,0.00,0
,20170116,149830,149830,,,,151090,151090,1260,1260,0,0.00,0
,20170117,151090,151090,,,,149500,149500,-1590,-1590,0,0.00,0
,20170118,149500,149500,,,,147860,147860,-1640,-1640,0,0.00,0
,20170119,147860,147860,,,,148520,148520,660,660,0,0.00,0
,20170120,148520,148520,,,,147060,147060,-1460,-1460,0,0.00,0
,20170123,147060,147060,,,,145510,145510,-1550,-1550,0,0.00,0
,20170124,145510,145510,,,,146230,146230,720,720,0,0.00,0
,20170125,146230,146230,,,,148390,148390,2160,2160,0,0.00,0
,20170126,148390,148390,,,,149160,149160,770,770,0,0.00,0
,20170203,149160,149160,,,,149600,149600,440,440,0,0.00,0
,20170206,149600,149600,,,,148240,148240,-1360,-1360,0,0.00,0
,20170207,148240,148240,,,,146580,146580,-1660,-1660,0,0.00,0
,20170208,146580,146580,,,,146050,146050,-530,-530,0,0.00,0
,20170209,146050,146050,,,,148050,148050,2000,2000,0,0.00,0
,20170210,148050,148050,,,,148280,148280,230,230,0,0.00,0
,20170213,148280,148280,,,,151790,151790,3510,3510,0,0.00,0
,20170214,151790,151790,,,,152480,152480,690,690,0,0.00,0
,20170215,152480,152480,,,,151590,151590,-890,-890,0,0.00,0
,20170216,151590,151590,,,,151590,151590,0,0,0,0.00,0
,20170217,151590,151590,,,,149420,149420,-2170,-2170,0,0.00,0
,20170220,149420,149420,,,,149450,149450,30,30,0,0.00,0
,20170221,149450,149450,,,,150930,150930,1480,1480,0,0.00,0
,20170222,150930,150930,,,,150310,150310,-620,-620,0,0.00,0
,20170223,150310,150310,,,,148460,148460,-1850,-1850,0,0.00,0
,20170224,148460,148460,,,,147550,147550,-910,-910,0,0.00,0
,20170227,147550,147550,,,,148970,148970,1420,1420,0,0.00,0
,20170228,148970,148970,,,,148750,148750,-220,-220,0,0.00,0
,20170301,148750,148750,,,,147640,147640,-1110,-1110,0,0.00,0
,20170302,147640,147640,,,,149230,149230,1590,1590,0,0.00,0
,20170303,149230,149230,,,,147450,147450,-1780,-1780,0,0.00,0
,20170306,147450,147450,,,,147250,147250,-200,-200,0,0.00,0
,20170307,147250,147250,,,,146390,146390,-860,-860,0,0.00,0
,20170308,146390,146390,,,,144970,144970,-1420,-1420,0,0.00,0
,20170309,144970,144970,,,,143890,143890,-1080,-1080,0,0.00,0
,20170310,143890,143890,,,,141540,141540,-2350,-2350,0,0.00,0
,20170313,141540,141540,,,,144890,144890,3350,3350,0,0.00,0
,20170314,144890,144890,,,,145370,145370,480,480,0,0.00,0
,20170315,145370,145370,,,,146620,146620,1250,1250,0,0.00,0
,20170316,146620,146620,,,,147660,147660,1040,1040,0,0.00,0
,20170317,147660,147660,,,,147910,147910,250,250,0,0.00,0
,20170320,147910,147910,,,,148160,148160,250,250,0,0.00,0
,20170321,148160,148160,,,,144090,144090,-4070,-4070,0,0.00,0
,20170322,144090,144090,,,,144010,144010,-80,-80,0,0.00,0
,20170323,144010,144010,,,,141580,141580,-2430,-2430,0,0.00,0
,20170324,141580,141580,,,,141470,141470,-110,-110,0,0.00,0
,20170327,141470,141470,,,,142410,142410,940,940,0,0.00,0
,20170328,142410,142410,,,,141250,141250,-1160,-1160,0,0.00,0
,20170329,141250,141250,,,,142290,142290,1040,1040,0,0.00,0
,20170330,142290,142290,,,,141790,141790,-500,-500,0,0.00,0
,20170331,141790,141790,,,,141830,141830,40,40,0,0.00,0
,20170405,141830,141830,,,,141740,141740,-90,-90,0,0.00,0
,20170406,141740,141740,,,,143910,143910,2170,2170,0,0.00,0
,20170407,143910,143910,,,,144290,144290,380,380,0,0.00,0
,20170410,144290,144290,,,,143940,143940,-350,-350,0,0.00,0
,20170411,143940,143940,,,,141940,141940,-2000,-2000,0,0.00,0
,20170412,141940,141940,,,,139760,139760,-2180,-2180,0,0.00,0
,20170413,139760,139760,,,,139780,139780,20,20,0,0.00,0
,20170414,139780,139780,,,,139930,139930,150,150,0,0.00,0
,20170417,139930,139930,,,,140470,140470,540,540,0,0.00,0
,20170418,140470,140470,,,,141270,141270,800,800,0,0.00,0
,20170419,141270,141270,,,,139580,139580,-1690,-1690,0,0.00,0
,20170420,139580,139580,,,,139140,139140,-440,-440,0,0.00,0
,20170421,139140,139140,,,,139400,139400,260,260,0,0.00,0
,20170424,139400,139400,,,,136600,136600,-2800,-2800,0,0.00,0
,20170425,136600,136600,,,,136200,136200,-400,-400,0,0.00,0
,20170426,136200,136200,,,,136380,136380,180,180,0,0.00,0
,20170427,136380,136380,,,,138660,138660,2280,2280,0,0.00,0
,20170428,138660,138660,,,,139380,139380,720,720,0,0.00,0
,20170502,139380,139380,,,,142440,142440,3060,3060,0,0.00,0
,20170503,142440,142440,,,,141380,141380,-1060,-1060,0,0.00,0
,20170504,141380,141380,,,,139540,139540,-1840,-1840,0,0.00,0
,20170505,139540,139540,,,,139500,139500,-40,-40,0,0.00,0
,20170508,139500,139500,,,,138470,138470,-1030,-1030,0,0.00,0
,20170509,138470,138470,,,,138760,138760,290,290,0,0.00,0
,20170510,138760,138760,,,,139580,139580,820,820,0,0.00,0
,20170511,139580,139580,,,,138890,138890,-690,-690,0,0.00,0
,20170512,138890,138890,,,,140010,140010,1120,1120,0,0.00,0
,20170515,140010,140010,,,,138920,138920,-1090,-1090,0,0.00,0
,20170516,138920,138920,,,,138710,138710,-210,-210,0,0.00,0
,20170517,138710,138710,,,,139850,139850,1140,1140,0,0.00,0
,20170518,139850,139850,,,,141350,141350,1500,1500,0,0.00,0
,20170519,141350,141350,,,,141990,141990,640,640,0,0.00,0
,20170522,141990,141990,,,,143730,143730,1740,1740,0,0.00,0
,20170523,143730,143730,,,,143340,143340,-390,-390,0,0.00,0
,20170524,143340,143340,,,,142380,142380,-960,-960,0,0.00,0
,20170525,142380,142380,,,,142710,142710,330,330,0,0.00,0
,20170526,142710,142710,,,,143210,143210,500,500,0,0.00,0
,20170531,143210,143210,,,,141570,141570,-1640,-1640,0,0.00,0
,20170601,141570,141570,,,,141170,141170,-400,-400,0,0.00,0
,20170602,141170,141170,,,,141270,141270,100,100,0,0.00,0
,20170605,141270,141270,,,,139720,139720,-1550,-1550,0,0.00,0
,20170606,139720,139720,,,,139430,139430,-290,-290,0,0.00,0
,20170607,139430,139430,,,,139610,139610,180,180,0,0.00,0
,20170608,139610,139610,,,,138470,138470,-1140,-1140,0,0.00,0
,20170609,138470,138470,,,,138460,138460,-10,-10,0,0.00,0
,20170612,138460,138460,,,,138850,138850,390,390,0,0.00,0
,20170613,138850,138850,,,,140670,140670,1820,1820,0,0.00,0
,20170614,140670,140670,,,,141980,141980,1310,1310,0,0.00,0
,20170615,141980,141980,,,,141900,141900,-80,-80,0,0.00,0
,20170616,141900,141900,,,,142140,142140,240,240,0,0.00,0
,20170619,142140,142140,,,,142440,142440,300,300,0,0.00,0
,20170620,142440,142440,,,,141640,141640,-800,-800,0,0.00,0
,20170621,141640,141640,,,,140630,140630,-1010,-1010,0,0.00,0
,20170622,140630,140630,,,,141880,141880,1250,1250,0,0.00,0
,20170623,141880,141880,,,,142010,142010,130,130,0,0.00,0
,20170626,142010,142010,,,,140630,140630,-1380,-1380,0,0.00,0
,20170627,140630,140630,,,,139710,139710,-920,-920,0,0.00,0
,20170628,139710,139710,,,,140940,140940,1230,1230,0,0.00,0
,20170629,140940,140940,,,,141960,141960,1020,1020,0,0.00,0
,20170630,141960,141960,,,,142700,142700,740,740,0,0.00,0
,20170703,142700,142700,,,,142690,142690,-10,-10,0,0.00,0
,20170704,142690,142690,,,,142660,142660,-30,-30,0,0.00,0
,20170705,142660,142660,,,,142560,142560,-100,-100,0,0.00,0
,20170706,142560,142560,,,,141470,141470,-1090,-1090,0,0.00,0
,20170707,141470,141470,,,,141380,141380,-90,-90,0,0.00,0
,20170710,141380,141380,,,,140900,140900,-480,-480,0,0.00,0
,20170711,140900,140900,,,,141330,141330,430,430,0,0.00,0
,20170712,141330,141330,,,,142470,142470,1140,1140,0,0.00,0
,20170713,142470,142470,,,,143100,143100,630,630,0,0.00,0
,20170714,143100,143100,,,,141790,141790,-1310,-1310,0,0.00,0
,20170717,141790,141790,,,,142060,142060,270,270,0,0.00,0
,20170718,142060,142060,,,,142520,142520,460,460,0,0.00,0
,20170719,142520,142520,,,,144290,144290,1770,1770,0,0.00,0
,20170720,144290,144290,,,,144170,144170,-120,-120,0,0.00,0
,20170721,144170,144170,,,,143490,143490,-680,-680,0,0.00,0
,20170724,143490,143490,,,,144170,144170,680,680,0,0.00,0
,20170725,144170,144170,,,,144500,144500,330,330,0,0.00,0
,20170726,144500,144500,,,,145170,145170,670,670,0,0.00,0
,20170727,145170,145170,,,,146650,146650,1480,1480,0,0.00,0
,20170728,146650,146650,,,,147710,147710,1060,1060,0,0.00,0
,20170731,147710,147710,,,,147670,147670,-40,-40,0,0.00,0
,20170801,147670,147670,,,,147930,147930,260,260,0,0.00,0
,20170802,147930,147930,,,,145930,145930,-2000,-2000,0,0.00,0
,20170803,145930,145930,,,,146740,146740,810,810,0,0.00,0
,20170804,146740,146740,,,,146890,146890,150,150,0,0.00,0
,20170807,146890,146890,,,,146410,146410,-480,-480,0,0.00,0
,20170808,146410,146410,151550,151560,149780,149780,151040,3370,4630,14,211.47,10
,20170809,149780,151040,148050,148050,148050,148050,148050,-2990,-2990,2,29.61,10
,20170810,148050,148050,149690,150630,148810,150630,149640,2580,1590,16,239.43,10
,20170811,150630,149640,,,,149500,149500,-140,-140,0,0.00,10
,20170814,149500,149500,146750,146750,146720,146720,146740,-2780,-2760,6,88.04,14
,20170815,146720,146740,,,,146050,146050,-690,-690,0,0.00,14
,20170816,146050,146050,145940,145940,145940,145940,145940,-110,-110,2,29.19,14
,20170817,145940,145940,,,,147240,147240,1300,1300,0,0.00,14
,20170818,147240,147240,,,,146740,146740,-500,-500,0,0.00,14
,20170821,146740,146740,,,,147990,147990,1250,1250,0,0.00,14
,20170822,147990,147990,,,,148770,148770,780,780,0,0.00,14
,20170823,148770,148770,,,,145450,145450,-3320,-3320,0,0.00,14
,20170824,145450,145450,146250,146250,146230,146230,146240,780,790,20,292.49,20
,20170825,146230,146240,,,,146500,146500,260,260,0,0.00,20
,20170828,146500,146500,,,,146500,146500,0,0,0,0.00,20
,20170829,146500,146500,,,,148080,148080,1580,1580,0,0.00,20
,20170830,148080,148080,,,,147030,147030,-1050,-1050,0,0.00,20
,20170831,147030,147030,144270,147910,144270,147910,144820,880,-2210,90,"1,303.39",66
,20170901,147910,144820,,,,145700,145700,880,880,0,0.00,66
,20170904,145700,145700,148200,148460,147120,147320,148110,1620,2410,68,"1,007.15",62
,20170905,147320,148110,147090,147090,147090,147090,147090,-1020,-1020,2,29.42,62
,20170906,147090,147090,,,,147090,147090,0,0,0,0.00,62
,20170907,147090,147090,,,,141240,141240,-5850,-5850,0,0.00,62
,20170908,141240,141240,,,,141510,141510,270,270,0,0.00,62
,20170911,141510,141510,143500,144390,143500,144390,143560,2880,2050,36,516.83,32
,20170912,144390,143560,,,,143810,143810,250,250,0,0.00,32
,20170913,143810,143810,144130,144130,144130,144130,144130,320,320,2,28.83,32
,20170914,144130,144130,,,,144260,144260,130,130,0,0.00,32
,20170915,144260,144260,,,,145460,145460,1200,1200,0,0.00,32
,20170918,145460,145460,,,,145460,145460,0,0,0,0.00,32
,20170919,145460,145460,,,,145460,145460,0,0,0,0.00,32
,20170920,145460,145460,,,,145460,145460,0,0,0,0.00,32
,20170921,145460,145460,,,,145460,145460,0,0,0,0.00,32
,20170922,145460,145460,,,,145460,145460,0,0,0,0.00,32
,20170925,145460,145460,,,,145850,145850,390,390,0,0.00,32
,20170926,145850,145850,145530,145530,144790,144790,145290,-1060,-560,32,464.95,60
,20170927,144790,145290,145510,146580,145470,146580,145810,1290,520,14,204.14,64
,20170928,146580,145810,,,,145810,145810,0,0,0,0.00,64
,20170929,145810,145810,,,,145810,145810,0,0,0,0.00,64
,20171009,145810,145810,145980,146400,145980,146400,146190,590,380,8,116.95,60
,20171010,146400,146190,,,,146190,146190,0,0,0,0.00,60
,20171011,146190,146190,,,,146190,146190,0,0,0,0.00,60
,20171012,146190,146190,144370,144370,144370,144370,144370,-1820,-1820,4,57.75,64
,20171013,144370,144370,,,,144370,144370,0,0,0,0.00,64
,20171016,144370,144370,146600,147040,145770,147040,146500,2670,2130,8,117.20,68
,20171017,147040,146500,,,,146500,146500,0,0,0,0.00,68
,20171018,146500,146500,145390,145390,145390,145390,145390,-1110,-1110,2,29.08,70
,20171019,145390,145390,,,,145390,145390,0,0,0,0.00,70
,20171020,145390,145390,143800,143800,142860,143610,143380,-1780,-2010,10,143.39,74
,20171023,143610,143380,,,,143380,143380,0,0,0,0.00,74
,20171024,143380,143380,144210,144210,144210,144210,144210,830,830,4,57.68,74
,20171025,144210,144210,,,,144210,144210,0,0,0,0.00,74
,20171026,144210,144210,,,,144360,144360,150,150,0,0.00,74
,20171027,144360,144360,,,,144360,144360,0,0,0,0.00,74
,20171030,144360,144360,153010,153010,143110,143110,146950,-1250,2590,28,411.46,76
,20171031,143110,146950,,,,146280,146280,-670,-670,0,0.00,76
,20171101,146280,146280,,,,146280,146280,0,0,0,0.00,76
,20171102,146280,146280,,,,143400,143400,-2880,-2880,0,0.00,76
,20171103,143400,143400,,,,144560,144560,1160,1160,0,0.00,76
,20171106,144560,144560,143900,143900,143900,143900,143900,-660,-660,2,28.78,78
,20171107,143900,143900,,,,143390,143390,-510,-510,0,0.00,78
,20171108,143390,143390,,,,143390,143390,0,0,0,0.00,78
,20171109,143390,143390,140710,141040,140290,140290,140770,-3100,-2620,56,788.36,92
,20171110,140290,140770,142000,142260,142000,142260,142020,1490,1250,18,255.65,74
,20171113,142260,142020,142020,142660,142020,142650,142490,630,470,8,114.00,80
,20171114,142650,142490,,,,142490,142490,0,0,0,0.00,80
,20171115,142490,142490,,,,142490,142490,0,0,0,0.00,80
,20171116,142490,142490,,,,142490,142490,0,0,0,0.00,80
,20171117,142490,142490,142490,142490,141000,141000,142240,-1490,-250,24,341.38,56
,20171120,141000,142240,141610,141610,141610,141610,141610,-630,-630,2,28.32,54
,20171121,141610,141610,,,,141610,141610,0,0,0,0.00,54
,20171122,141610,141610,142300,142300,142300,142300,142300,690,690,6,85.38,54
,20171123,142300,142300,,,,142000,142000,-300,-300,0,0.00,54
,20171124,142000,142000,142200,142200,142200,142200,142200,200,200,2,28.44,56
,20171127,142200,142200,,,,142200,142200,0,0,0,0.00,56
,20171128,142200,142200,,,,142200,142200,0,0,0,0.00,56
,20171129,142200,142200,,,,142200,142200,0,0,0,0.00,56
,20171130,142200,142200,139600,139600,139600,139600,139600,-2600,-2600,10,139.60,56
,20171201,139600,139600,,,,139600,139600,0,0,0,0.00,56
,20171204,139600,139600,,,,139600,139600,0,0,0,0.00,56
,20171205,139600,139600,137810,139000,137810,139000,138400,-600,-1200,40,553.62,56
,20171206,139000,138400,,,,138400,138400,0,0,0,0.00,56
,20171207,138400,138400,,,,138400,138400,0,0,0,0.00,56
,20171208,138400,138400,,,,138400,138400,0,0,0,0.00,56
,20171211,138400,138400,,,,138400,138400,0,0,0,0.00,56
,20171212,138400,138400,,,,138400,138400,0,0,0,0.00,56
,20171213,138400,138400,,,,138400,138400,0,0,0,0.00,56
,20171214,138400,138400,,,,138400,138400,0,0,0,0.00,56
,20171215,138400,138400,,,,138400,138400,0,0,0,0.00,56
sn1801,20170117,151090,151090,148840,148840,148840,148840,148840,-2250,-2250,2,29.77,2
,20170118,148840,148840,,,,147210,147210,-1630,-1630,0,0.00,2
,20170119,147210,147210,,,,147870,147870,660,660,0,0.00,2
,20170120,147870,147870,,,,146420,146420,-1450,-1450,0,0.00,2
,20170123,146420,146420,,,,144880,144880,-1540,-1540,0,0.00,2
,20170124,144880,144880,145990,148550,145990,147740,147490,2860,2610,8,117.99,10
,20170125,147740,147490,147890,151720,147890,149970,150520,2480,3030,26,391.37,26
,20170126,149970,150520,,,,150520,150520,0,0,0,0.00,26
,20170203,150520,150520,,,,150960,150960,440,440,0,0.00,26
,20170206,150960,150960,,,,150960,150960,0,0,0,0.00,26
,20170207,150960,150960,,,,150140,150140,-820,-820,0,0.00,26
,20170208,150140,150140,,,,150080,150080,-60,-60,0,0.00,26
,20170209,150080,150080,,,,150080,150080,0,0,0,0.00,26
,20170210,150080,150080,,,,150080,150080,0,0,0,0.00,26
,20170213,150080,150080,,,,150080,150080,0,0,0,0.00,26
,20170214,150080,150080,151820,152290,151820,152290,152050,2210,1970,8,121.64,34
,20170215,152290,152050,150220,150870,150220,150530,150460,-1520,-1590,8,120.37,40
,20170216,150530,150460,151010,151880,151000,151880,151320,1420,860,8,121.06,46
,20170217,151880,151320,,,,151320,151320,0,0,0,0.00,46
,20170220,151320,151320,,,,151000,151000,-320,-320,0,0.00,46
,20170221,151000,151000,151780,151780,151000,151350,151170,350,170,22,332.59,38
,20170222,151350,151170,150890,150890,150890,150890,150890,-280,-280,2,30.18,38
,20170223,150890,150890,150890,151310,148470,149090,149980,-1800,-910,20,299.98,38
,20170224,149090,149980,,,,149980,149980,0,0,0,0.00,38
,20170227,149980,149980,,,,151430,151430,1450,1450,0,0.00,38
,20170228,151430,151430,149400,149400,149400,149400,149400,-2030,-2030,2,29.88,36
,20170301,149400,149400,147790,148510,147790,148360,148220,-1040,-1180,6,88.93,34
,20170302,148360,148220,149040,150510,149040,149570,149690,1350,1470,12,179.63,38
,20170303,149570,149690,148220,148220,148220,148220,148220,-1470,-1470,4,59.29,34
,20170306,148220,148220,147480,147480,147480,147480,147480,-740,-740,2,29.50,36
,20170307,147480,147480,,,,147480,147480,0,0,0,0.00,36
,20170308,147480,147480,147110,147110,143930,146030,145760,-1450,-1720,8,116.61,38
,20170309,146030,145760,143090,143090,143090,143090,143090,-2670,-2670,2,28.62,38
,20170310,143090,143090,144420,144420,144420,144420,144420,1330,1330,2,28.88,38
,20170313,144420,144420,,,,144420,144420,0,0,0,0.00,38
,20170314,144420,144420,145480,149370,145480,149370,147420,4950,3000,4,58.97,40
,20170315,149370,147420,147810,147860,147810,147860,147830,440,410,4,59.13,38
,20170316,147860,147830,,,,147830,147830,0,0,0,0.00,38
,20170317,147830,147830,,,,147830,147830,0,0,0,0.00,38
,20170320,147830,147830,147370,147380,147370,147380,147370,-450,-460,4,58.95,40
,20170321,147380,147370,,,,147370,147370,0,0,0,0.00,40
,20170322,147370,147370,,,,147370,147370,0,0,0,0.00,40
,20170323,147370,147370,147940,148750,147940,148420,148270,1050,900,14,207.59,42
,20170324,148420,148270,,,,148270,148270,0,0,0,0.00,42
,20170327,148270,148270,145330,145330,145010,145020,145160,-3250,-3110,8,116.13,46
,20170328,145020,145160,144940,144940,144940,144940,144940,-220,-220,2,28.99,48
,20170329,144940,144940,146410,146410,145850,145850,146130,910,1190,4,58.45,48
,20170330,145850,146130,,,,146130,146130,0,0,0,0.00,48
,20170331,146130,146130,,,,146130,146130,0,0,0,0.00,48
,20170405,146130,146130,,,,146130,146130,0,0,0,0.00,48
,20170406,146130,146130,147500,147500,147500,147500,147500,1370,1370,2,29.50,48
,20170407,147500,147500,148560,148700,147710,148160,148330,660,830,16,237.34,44
,20170410,148160,148330,147760,149690,147760,149690,148720,1360,390,4,59.49,42
,20170411,149690,148720,145030,147480,144460,144830,145450,-3890,-3270,14,203.63,48
,20170412,144830,145450,143830,143830,143420,143420,143570,-2030,-1880,6,86.14,50
,20170413,143420,143570,142150,144280,142130,144280,143430,710,-140,14,200.81,56
,20170414,144280,143430,144960,145160,143010,143410,144420,-20,990,18,259.96,60
,20170417,143410,144420,142680,144450,142680,144300,143960,-120,-460,8,115.17,62
,20170418,144300,143960,,,,144780,144780,820,820,0,0.00,62
,20170419,144780,144780,142970,142970,141290,141290,142350,-3490,-2430,14,199.29,68
,20170420,141290,142350,143420,143570,141650,142610,142770,260,420,14,199.88,66
,20170421,142610,142770,142430,143700,142430,142580,142700,-190,-70,28,399.57,74
,20170424,142580,142700,140770,140770,140770,140770,140770,-1930,-1930,2,28.15,74
,20170425,140770,140770,137710,140500,137710,139510,138940,-1260,-1830,28,389.03,84
,20170426,139510,138940,139430,140380,139430,139910,139900,970,960,16,223.85,76
,20170427,139910,139900,141170,141650,140990,141620,141440,1720,1540,24,339.47,78
,20170428,141620,141440,142570,143350,141070,142950,142440,1510,1000,42,598.28,90
,20170502,142950,142440,144890,145500,144890,145000,145260,2560,2820,32,464.84,98
,20170503,145000,145260,144910,144910,144000,144000,144120,-1260,-1140,26,374.73,120
,20170504,144000,144120,142900,143000,141810,142530,142300,-1590,-1820,72,"1,024.56",128
,20170505,142530,142300,142450,143320,141530,141530,142490,-770,190,36,512.99,138
,20170508,141530,142490,141960,142860,140900,141180,141860,-1310,-630,50,709.33,140
,20170509,141180,141860,141530,142510,141530,142510,142080,650,220,32,454.67,136
,20170510,142510,142080,143030,143490,142230,142480,142760,400,680,34,485.41,142
,20170511,142480,142760,141920,142870,141590,142870,142120,110,-640,14,198.97,138
,20170512,142870,142120,143510,143510,142500,143100,143150,980,1030,50,715.79,154
,20170515,143100,143150,143120,143120,141600,142240,142130,-910,-1020,64,909.67,146
,20170516,142240,142130,142190,142190,141130,141620,141610,-510,-520,80,"1,132.89",160
,20170517,141620,141610,141620,143960,141340,143570,142600,1960,990,220,"3,137.36",182
,20170518,143570,142600,143560,145020,143360,144680,144260,2080,1660,100,"1,442.61",220
,20170519,144680,144260,144400,145410,144250,144800,144860,540,600,82,"1,187.91",246
,20170522,144800,144860,145130,148230,145130,145900,146620,1040,1760,100,"1,466.28",268
,20170523,145900,146620,146490,146630,145270,145300,146060,-1320,-560,72,"1,051.65",300
,20170524,145300,146060,145640,145780,144800,144900,145480,-1160,-580,50,727.43,300
,20170525,144900,145480,145050,146480,145050,146480,145760,1000,280,54,787.11,304
,20170526,146480,145760,146890,146990,145310,145450,145820,-310,60,58,845.78,322
,20170531,145450,145820,145620,145980,143450,143500,144890,-2320,-930,114,"1,651.78",318
,20170601,143500,144890,143640,144910,143020,144370,144170,-520,-720,54,778.56,338
,20170602,144370,144170,144510,144590,143440,143440,144220,-730,50,98,"1,413.38",354
,20170605,143440,144220,143090,144620,143090,143260,143750,-960,-470,112,"1,610.07",376
,20170606,143260,143750,142570,144210,142500,144210,143210,460,-540,96,"1,374.82",400
,20170607,144210,143210,143870,144620,142130,142610,143610,-600,400,298,"4,279.81",420
,20170608,142610,143610,142350,142980,141650,142640,142390,-970,-1220,122,"1,737.27",422
,20170609,142640,142390,141820,142760,141820,142530,142440,140,50,158,"2,250.67",418
,20170612,142530,142440,142680,143220,142410,143200,142850,760,410,118,"1,685.74",450
,20170613,143200,142850,142760,146140,142580,145450,144360,2600,1510,508,"7,333.69",686
,20170614,145450,144360,145430,146600,144600,146600,145490,2240,1130,288,"4,190.23",810
,20170615,146600,145490,146280,146280,145130,145220,145460,-270,-30,156,"2,269.23",784
,20170616,145220,145460,145210,146500,145110,145650,145900,190,440,198,"2,888.91",788
,20170619,145650,145900,145490,145950,144600,145240,145210,-660,-690,242,"3,514.22",734
,20170620,145240,145210,145250,145390,143840,144110,144690,-1100,-520,162,"2,344.08",732
,20170621,144110,144690,143990,144360,143160,143830,143910,-860,-780,238,"3,425.19",678
,20170622,143830,143910,144260,146000,144180,145450,145320,1540,1410,190,"2,761.10",656
,20170623,145450,145320,145800,146020,144100,145210,145140,-110,-180,152,"2,206.13",672
,20170626,145210,145140,145180,145180,143600,143750,144580,-1390,-560,212,"3,065.28",682
,20170627,143750,144580,144060,144060,142740,143860,143450,-720,-1130,244,"3,500.30",640
,20170628,143860,143450,143990,145470,143990,145300,144820,1850,1370,398,"5,764.23",728
,20170629,145300,144820,145230,146140,144820,146140,145410,1320,590,238,"3,460.82",746
,20170630,146140,145410,146600,147030,145760,146500,146510,1090,1100,142,"2,080.49",754
,20170703,146500,146510,146460,146880,146000,146560,146380,50,-130,104,"1,522.38",748
,20170704,146560,146380,146200,147280,145410,145410,146450,-970,70,220,"3,221.91",754
,20170705,145410,146450,145950,146860,145750,146400,146250,-50,-200,172,"2,515.60",746
,20170706,146400,146250,146090,146090,144680,144900,145080,-1350,-1170,76,"1,102.66",746
,20170707,144900,145080,145110,145890,144800,145060,145180,-20,100,232,"3,368.29",750
,20170710,145060,145180,145100,145120,143790,144510,144490,-670,-690,298,"4,305.93",760
,20170711,144510,144490,144190,145740,144020,145740,144980,1250,490,120,"1,739.82",768
,20170712,145740,144980,145850,146570,145660,146160,146100,1180,1120,158,"2,308.47",844
,20170713,146160,146100,146690,147430,144590,147200,146650,1100,550,442,"6,482.29",922
,20170714,147200,146650,146620,146850,144500,144540,145540,-2110,-1110,244,"3,551.19",906
,20170717,144540,145540,144600,146930,144530,146590,145660,1050,120,356,"5,185.51",942
,20170718,146590,145660,146640,146800,145510,146390,146230,730,570,492,"7,194.95",948
,20170719,146390,146230,147010,149160,146980,148550,148020,2320,1790,524,"7,756.61",1054
,20170720,148550,148020,148280,148400,147500,147500,147870,-520,-150,176,"2,602.61",1128
,20170721,147500,147870,147630,147740,146380,146730,146800,-1140,-1070,302,"4,433.43",1180
,20170724,146730,146800,147000,148450,146620,147570,147550,770,750,382,"5,636.71",1250
,20170725,147570,147550,148000,148490,147440,148230,148010,680,460,242,"3,582.06",1298
,20170726,148230,148010,148360,149700,148000,148230,148760,220,750,640,"9,520.75",1420
,20170727,148230,148760,148560,151940,148560,151580,150430,2820,1670,1316,"19,797.54",1898
,20170728,151580,150430,151800,152840,150010,150680,151350,250,920,1536,"23,248.55",2174
,20170731,150680,151350,151000,152280,150830,151740,151660,390,310,646,"9,797.66",2326
,20170801,151740,151660,151740,151950,149080,149250,150160,-2410,-1500,940,"14,115.76",2524
,20170802,149250,150160,149000,149640,143560,148930,148660,-1230,-1500,1342,"19,950.29",2688
,20170803,148930,148660,148910,150100,148910,149570,149580,910,920,570,"8,526.24",2626
,20170804,149570,149580,150010,150980,149550,150570,150250,990,670,868,"13,041.94",2760
,20170807,150570,150250,150630,150740,149340,150080,149980,-170,-270,920,"13,798.99",2876
,20170808,150080,149980,150320,151230,148500,149220,149930,-760,-50,1410,"21,140.57",3240
,20170809,149220,149930,149000,150500,148550,150500,149600,570,-330,4390,"65,677.90",4540
,20170810,150500,149600,151290,151430,148820,149980,150130,380,530,3098,"46,511.95",4536
,20170811,149980,150130,149700,150390,147440,148300,148940,-1830,-1190,4130,"61,515.03",4552
,20170814,148300,148940,149260,149260,147010,147050,148050,-1890,-890,2954,"43,735.37",4852
,20170815,147050,148050,147100,147990,146780,147510,147350,-540,-700,2468,"36,366.67",5158
,20170816,147510,147350,147310,148220,145910,146070,146610,-1280,-740,4312,"63,218.28",5876
,20170817,146070,146610,146360,148980,146350,148490,147990,1880,1380,8898,"131,688.79",6816
,20170818,148490,147990,148070,148230,146740,147570,147470,-420,-520,4546,"67,043.43",7334
,20170821,147570,147470,147860,148030,146860,147590,147510,120,40,5776,"85,205.00",7434
,20170822,147590,147510,147600,148100,146800,147440,147490,-70,-20,4344,"64,072.22",8142
,20170823,147440,147490,147490,147580,144660,145310,145740,-2180,-1750,7614,"110,967.60",9542
,20170824,145310,145740,145770,146800,145360,146500,146180,760,440,5902,"86,278.20",10124
,20170825,146500,146180,146480,147070,145940,146460,146620,280,440,5788,"84,866.45",10266
,20170828,146460,146620,146450,147230,145010,146980,146190,360,-430,5992,"87,599.16",11340
,20170829,146980,146190,147130,148470,146620,147310,147600,1120,1410,8682,"128,152.19",12324
,20170830,147310,147600,147520,147880,146100,146270,146800,-1330,-800,9048,"132,828.72",13148
,20170831,146270,146800,145810,148470,145610,147970,147410,1170,610,16154,"238,141.36",15290
,20170901,147970,147410,148200,148390,147270,147650,147730,240,320,11858,"175,179.91",15560
,20170904,147650,147730,147420,148790,147400,147540,147950,-190,220,20622,"305,105.05",16104
,20170905,147540,147950,147710,147890,146360,146630,147020,-1320,-930,14502,"213,217.48",16868
,20170906,146630,147020,146470,146970,145400,145500,146250,-1520,-770,15210,"222,451.47",18026
,20170907,145500,146250,145680,145940,144810,144920,145250,-1330,-1000,13788,"200,271.05",18656
,20170908,144920,145250,145100,145750,143700,144700,144940,-550,-310,18120,"262,635.33",18990
,20170911,144700,144940,144860,145200,143120,144650,144230,-290,-710,16992,"245,086.28",19048
,20170912,144650,144230,144320,145470,144320,145060,144770,830,540,12872,"186,358.95",19450
,20170913,145060,144770,144750,145370,144520,145150,145050,380,280,10368,"150,390.29",18852
,20170914,145150,145050,144800,145950,143830,144370,144860,-680,-190,16908,"244,942.43",18590
,20170915,144370,144860,145000,145370,142660,142900,144000,-1960,-860,16592,"238,925.48",20148
,20170918,142900,144000,143290,144860,142440,144300,143690,300,-310,13812,"198,477.08",19404
,20170919,144300,143690,144040,145890,143940,145270,144980,1580,1290,14156,"205,244.23",19374
,20170920,145270,144980,145980,146590,145110,146220,145790,1240,810,13742,"200,354.75",19194
,20170921,146220,145790,146070,146590,144300,144770,145450,-1020,-340,17334,"252,136.20",18498
,20170922,144770,145450,144770,145180,143200,144200,144070,-1250,-1380,18858,"271,699.64",17992
,20170925,144200,144070,144820,146180,143790,145350,145070,1280,1000,19596,"284,289.90",18656
,20170926,145350,145070,145490,147200,145340,147200,146460,2130,1390,16312,"238,908.92",19156
,20170927,147200,146460,146510,147450,146300,147260,146920,800,460,13112,"192,643.47",19096
,20170928,147260,146920,147130,147330,145820,146320,146320,-600,-600,12634,"184,871.18",17820
,20170929,146320,146320,146380,147130,146230,146840,146620,520,300,9678,"141,903.61",17644
,20171009,146840,146620,146380,148400,145520,148300,147550,1680,930,11256,"166,092.30",19210
,20171010,148300,147550,148030,148580,146500,146750,147440,-800,-110,15268,"225,118.18",19038
,20171011,146750,147440,147050,147370,145610,145760,146480,-1680,-960,15476,"226,705.18",19256
,20171012,145760,146480,145800,146580,145050,146320,145660,-160,-820,16908,"246,289.71",18862
,20171013,146320,145660,146430,147200,146030,146920,146550,1260,890,10754,"157,604.24",18470
,20171016,146920,146550,146780,148000,146560,147880,147320,1330,770,18636,"274,552.30",19412
,20171017,147880,147320,147800,147970,146730,147090,147320,-230,0,12750,"187,838.39",19016
,20171018,147090,147320,146900,146900,145210,145480,146090,-1840,-1230,15880,"231,992.44",19716
,20171019,145480,146090,144840,145400,144380,144740,144890,-1350,-1200,12582,"182,305.16",19862
,20171020,144740,144890,144120,145100,144060,144600,144510,-290,-380,14308,"206,775.76",20718
,20171023,144600,144510,144360,144970,143700,144750,144170,240,-340,16506,"237,972.96",21028
,20171024,144750,144170,144450,145650,144330,145020,144940,850,770,11500,"166,686.57",20554
,20171025,145020,144940,145130,145260,144700,145010,144900,70,-40,7914,"114,675.90",20216
,20171026,145010,144900,145230,145900,144800,145210,145340,310,440,8952,"130,111.14",20194
,20171027,145210,145340,145410,145410,143700,143710,144490,-1630,-850,12358,"178,567.17",20642
,20171030,143710,144490,143610,144970,143130,143700,144030,-790,-460,8400,"120,990.45",20368
,20171031,143700,144030,143800,144140,142760,143680,143450,-350,-580,11760,"168,699.19",21184
,20171101,143680,143450,142920,145510,140970,144410,142970,960,-480,34374,"491,452.51",21770
,20171102,144410,142970,144930,144930,143560,144160,144220,1190,1250,14418,"207,949.62",21004
,20171103,144160,144220,143340,144400,143340,143920,144020,-300,-200,7568,"108,996.43",20710
,20171106,143920,144020,143920,144500,143500,144220,144050,200,30,9876,"142,264.62",20106
,20171107,144220,144050,144210,144380,142600,142720,143260,-1330,-790,15786,"226,155.79",22056
,20171108,142720,143260,142880,143050,141420,141750,142240,-1510,-1020,13082,"186,090.25",22986
,20171109,141750,142240,141600,142690,141230,142080,141950,-160,-290,12164,"172,673.18",22630
,20171110,142080,141950,142030,144180,141840,143900,143260,1950,1310,17550,"251,423.97",21112
,20171113,143900,143260,143900,144490,143120,143820,143750,560,490,10778,"154,934.83",20320
,20171114,143820,143750,143110,144800,142850,144010,143900,260,150,12116,"174,357.05",20024
,20171115,144010,143900,144010,144070,141900,143010,142880,-890,-1020,16050,"229,323.56",20196
,20171116,143010,142880,143220,143800,142810,143110,143280,230,400,10142,"145,317.91",20016
,20171117,143110,143280,143770,143890,142300,142480,142880,-800,-400,10220,"146,027.16",20202
,20171120,142480,142880,142400,143470,142330,142650,142820,-230,-60,8444,"120,605.03",19790
,20171121,142650,142820,142880,143400,142210,142940,142880,120,60,10768,"153,858.61",19802
,20171122,142940,142880,142940,143500,142390,142750,142840,-130,-40,9056,"129,356.70",20094
,20171123,142750,142840,142710,142960,141150,141700,142060,-1140,-780,15402,"218,802.17",21838
,20171124,141700,142060,141780,143330,141620,143280,142470,1220,410,13624,"194,111.47",20960
,20171127,143280,142470,143800,144000,142910,143120,143260,650,790,13264,"190,020.60",19930
,20171128,143120,143260,143120,143730,142660,142960,143180,-300,-80,12718,"182,103.25",19834
,20171129,142960,143180,142930,143070,142230,142420,142750,-760,-430,9878,"141,013.87",19858
,20171130,142420,142750,142420,142950,141410,141590,142060,-1160,-690,13762,"195,514.44",20030
,20171201,141590,142060,142010,142090,140200,140670,141050,-1390,-1010,16116,"227,331.11",20932
,20171204,140670,141050,140950,141980,140210,141700,141310,650,260,11336,"160,200.31",19702
,20171205,141700,141310,141500,141850,140300,140350,141140,-960,-170,8796,"124,150.73",19744
,20171206,140350,141140,140190,141000,139200,140750,140090,-390,-1050,12178,"170,604.26",18858
,20171207,140750,140090,141100,141100,139330,139700,140160,-390,70,8680,"121,663.60",18444
,20171208,139700,140160,139880,140280,139020,139230,139540,-930,-620,10160,"141,778.22",19084
,20171211,139230,139540,139220,139500,137600,137600,138660,-1940,-880,13386,"185,613.08",19772
,20171212,137600,138660,137710,138480,136010,137340,137040,-1320,-1620,25698,"352,167.48",19640
,20171213,137340,137040,137000,137560,133550,134120,135480,-2920,-1560,22896,"310,212.59",22034
,20171214,134120,135480,133330,135640,132410,134600,134020,-880,-1460,29384,"393,822.17",19706
,20171215,134600,134020,134600,135300,134100,134390,134540,370,520,12766,"171,757.25",18514
,20171218,134390,134540,135050,137850,134970,137420,136240,2880,1700,19682,"268,165.99",16628
,20171219,137420,136240,137570,138380,137000,137150,137620,910,1380,10932,"150,452.66",14814
,20171220,137150,137620,137160,138500,136850,137990,137730,370,110,9976,"137,402.07",13522
,20171221,137990,137730,138380,139300,137640,137980,138260,250,530,9302,"128,618.54",12628
,20171222,137980,138260,137990,138340,137190,137680,137730,-580,-530,6884,"94,819.84",11838
,20171225,137680,137730,137060,138890,137060,138200,138180,470,450,8660,"119,665.93",10560
,20171226,138200,138180,138390,141150,137840,141020,139180,2840,1000,10526,"146,508.19",8570
,20171227,141020,139180,140220,141480,139670,140410,140550,1230,1370,5078,"71,373.04",7740
,20171228,140410,140550,140410,142000,139930,142000,140760,1450,210,2668,"37,554.95",6752
,20171229,142000,140760,142000,143290,141500,142800,142640,2040,1880,2214,"31,581.05",5668
sn1802,20170216,150460,150460,,,,151320,151320,860,860,0,0.00,0
,20170217,151320,151320,,,,149160,149160,-2160,-2160,0,0.00,0
,20170220,149160,149160,135010,147010,135000,147010,135730,-2150,-13430,126,"1,710.26",118
,20170221,147010,135730,,,,145230,145230,9500,9500,0,0.00,118
,20170222,145230,145230,147300,147300,147300,147300,147300,2070,2070,2,29.46,118
,20170223,147300,147300,147320,147320,147320,147320,147320,20,20,2,29.46,118
,20170224,147320,147320,,,,146410,146410,-910,-910,0,0.00,118
,20170227,146410,146410,148930,148930,148930,148930,148930,2520,2520,2,29.79,116
,20170228,148930,148930,,,,148930,148930,0,0,0,0.00,116
,20170301,148930,148930,147940,148450,147940,148450,148190,-480,-740,4,59.28,114
,20170302,148450,148190,148200,148200,148200,148200,148200,10,10,6,88.92,112
,20170303,148200,148200,148850,148850,148510,148510,148660,310,460,14,208.13,104
,20170306,148510,148660,150000,150000,150000,150000,150000,1340,1340,10,150.00,94
,20170307,150000,150000,148180,149000,147000,147000,148910,-3000,-1090,90,"1,340.27",6
,20170308,147000,148910,,,,147170,147170,-1740,-1740,0,0.00,6
,20170309,147170,147170,,,,144470,144470,-2700,-2700,0,0.00,6
,20170310,144470,144470,,,,144470,144470,0,0,0,0.00,6
,20170313,144470,144470,,,,144470,144470,0,0,0,0.00,6
,20170314,144470,144470,,,,147470,147470,3000,3000,0,0.00,6
,20170315,147470,147470,,,,147880,147880,410,410,0,0.00,6
,20170316,147880,147880,,,,147880,147880,0,0,0,0.00,6
,20170317,147880,147880,,,,147880,147880,0,0,0,0.00,6
,20170320,147880,147880,,,,147420,147420,-460,-460,0,0.00,6
,20170321,147420,147420,,,,143370,143370,-4050,-4050,0,0.00,6
,20170322,143370,143370,,,,143290,143290,-80,-80,0,0.00,6
,20170323,143290,143290,,,,143290,143290,0,0,0,0.00,6
,20170324,143290,143290,,,,143180,143180,-110,-110,0,0.00,6
,20170327,143180,143180,,,,140170,140170,-3010,-3010,0,0.00,6
,20170328,140170,140170,,,,139950,139950,-220,-220,0,0.00,6
,20170329,139950,139950,,,,141090,141090,1140,1140,0,0.00,6
,20170330,141090,141090,,,,140590,140590,-500,-500,0,0.00,6
,20170331,140590,140590,,,,140630,140630,40,40,0,0.00,6
,20170405,140630,140630,,,,140550,140550,-80,-80,0,0.00,6
,20170406,140550,140550,,,,141860,141860,1310,1310,0,0.00,6
,20170407,141860,141860,,,,141860,141860,0,0,0,0.00,6
,20170410,141860,141860,,,,142230,142230,370,370,0,0.00,6
,20170411,142230,142230,,,,139100,139100,-3130,-3130,0,0.00,6
,20170412,139100,139100,,,,137300,137300,-1800,-1800,0,0.00,6
,20170413,137300,137300,,,,137170,137170,-130,-130,0,0.00,6
,20170414,137170,137170,,,,138110,138110,940,940,0,0.00,6
,20170417,138110,138110,,,,137670,137670,-440,-440,0,0.00,6
,20170418,137670,137670,,,,138450,138450,780,780,0,0.00,6
,20170419,138450,138450,,,,136120,136120,-2330,-2330,0,0.00,6
,20170420,136120,136120,,,,140290,140290,4170,4170,0,0.00,6
,20170421,140290,140290,,,,140220,140220,-70,-70,0,0.00,6
,20170424,140220,140220,,,,138320,138320,-1900,-1900,0,0.00,6
,20170425,138320,138320,,,,136520,136520,-1800,-1800,0,0.00,6
,20170426,136520,136520,,,,136520,136520,0,0,0,0.00,6
,20170427,136520,136520,,,,139860,139860,3340,3340,0,0.00,6
,20170428,139860,139860,,,,139860,139860,0,0,0,0.00,6
,20170502,139860,139860,,,,139860,139860,0,0,0,0.00,6
,20170503,139860,139860,,,,138760,138760,-1100,-1100,0,0.00,6
,20170504,138760,138760,141430,141430,141430,141430,141430,2670,2670,2,28.29,4
,20170505,141430,141430,,,,141620,141620,190,190,0,0.00,4
,20170508,141620,141620,,,,141620,141620,0,0,0,0.00,4
,20170509,141620,141620,,,,141620,141620,0,0,0,0.00,4
,20170510,141620,141620,,,,142300,142300,680,680,0,0.00,4
,20170511,142300,142300,,,,142300,142300,0,0,0,0.00,4
,20170512,142300,142300,,,,143330,143330,1030,1030,0,0.00,4
,20170515,143330,143330,,,,142310,142310,-1020,-1020,0,0.00,4
,20170516,142310,142310,,,,141790,141790,-520,-520,0,0.00,4
,20170517,141790,141790,,,,142780,142780,990,990,0,0.00,4
,20170518,142780,142780,,,,144440,144440,1660,1660,0,0.00,4
,20170519,144440,144440,,,,145040,145040,600,600,0,0.00,4
,20170522,145040,145040,,,,146800,146800,1760,1760,0,0.00,4
,20170523,146800,146800,,,,146240,146240,-560,-560,0,0.00,4
,20170524,146240,146240,,,,145660,145660,-580,-580,0,0.00,4
,20170525,145660,145660,,,,145940,145940,280,280,0,0.00,4
,20170526,145940,145940,,,,146000,146000,60,60,0,0.00,4
,20170531,146000,146000,,,,145070,145070,-930,-930,0,0.00,4
,20170601,145070,145070,,,,144350,144350,-720,-720,0,0.00,4
,20170602,144350,144350,,,,144400,144400,50,50,0,0.00,4
,20170605,144400,144400,,,,143930,143930,-470,-470,0,0.00,4
,20170606,143930,143930,,,,143380,143380,-550,-550,0,0.00,4
,20170607,143380,143380,,,,143780,143780,400,400,0,0.00,4
,20170608,143780,143780,,,,142560,142560,-1220,-1220,0,0.00,4
,20170609,142560,142560,,,,142610,142610,50,50,0,0.00,4
,20170612,142610,142610,,,,143020,143020,410,410,0,0.00,4
,20170613,143020,143020,,,,143020,143020,0,0,0,0.00,4
,20170614,143020,143020,,,,144140,144140,1120,1120,0,0.00,4
,20170615,144140,144140,,,,144110,144110,-30,-30,0,0.00,4
,20170616,144110,144110,,,,144550,144550,440,440,0,0.00,4
,20170619,144550,144550,,,,143870,143870,-680,-680,0,0.00,4
,20170620,143870,143870,,,,143360,143360,-510,-510,0,0.00,4
,20170621,143360,143360,,,,142590,142590,-770,-770,0,0.00,4
,20170622,142590,142590,,,,142590,142590,0,0,0,0.00,4
,20170623,142590,142590,,,,142410,142410,-180,-180,0,0.00,4
,20170626,142410,142410,,,,141860,141860,-550,-550,0,0.00,4
,20170627,141860,141860,,,,140750,140750,-1110,-1110,0,0.00,4
,20170628,140750,140750,,,,140750,140750,0,0,0,0.00,4
,20170629,140750,140750,,,,141320,141320,570,570,0,0.00,4
,20170630,141320,141320,,,,142390,142390,1070,1070,0,0.00,4
,20170703,142390,142390,,,,142390,142390,0,0,0,0.00,4
,20170704,142390,142390,,,,142450,142450,60,60,0,0.00,4
,20170705,142450,142450,,,,142260,142260,-190,-190,0,0.00,4
,20170706,142260,142260,,,,141120,141120,-1140,-1140,0,0.00,4
,20170707,141120,141120,,,,141220,141220,100,100,0,0.00,4
,20170710,141220,141220,148210,148210,142760,142760,145480,1540,4260,4,58.19,4
,20170711,142760,145480,,,,145970,145970,490,490,0,0.00,4
,20170712,145970,145970,,,,147100,147100,1130,1130,0,0.00,4
,20170713,147100,147100,,,,147660,147660,560,560,0,0.00,4
,20170714,147660,147660,,,,146540,146540,-1120,-1120,0,0.00,4
,20170717,146540,146540,,,,146660,146660,120,120,0,0.00,4
,20170718,146660,146660,,,,147240,147240,580,580,0,0.00,4
,20170719,147240,147240,,,,149040,149040,1800,1800,0,0.00,4
,20170720,149040,149040,,,,148890,148890,-150,-150,0,0.00,4
,20170721,148890,148890,,,,147810,147810,-1080,-1080,0,0.00,4
,20170724,147810,147810,,,,148570,148570,760,760,0,0.00,4
,20170725,148570,148570,,,,148570,148570,0,0,0,0.00,4
,20170726,148570,148570,,,,149320,149320,750,750,0,0.00,4
,20170727,149320,149320,,,,151000,151000,1680,1680,0,0.00,4
,20170728,151000,151000,,,,151930,151930,930,930,0,0.00,4
,20170731,151930,151930,,,,152240,152240,310,310,0,0.00,4
,20170801,152240,152240,,,,152240,152240,0,0,0,0.00,4
,20170802,152240,152240,,,,150720,150720,-1520,-1520,0,0.00,4
,20170803,150720,150720,,,,151650,151650,930,930,0,0.00,4
,20170804,151650,151650,,,,152330,152330,680,680,0,0.00,4
,20170807,152330,152330,146920,151690,146920,149960,149520,-2370,-2810,30,448.57,4
,20170808,149960,149520,,,,149470,149470,-50,-50,0,0.00,4
,20170809,149470,149470,,,,149140,149140,-330,-330,0,0.00,4
,20170810,149140,149140,,,,149670,149670,530,530,0,0.00,4
,20170811,149670,149670,,,,148490,148490,-1180,-1180,0,0.00,4
,20170814,148490,148490,,,,148490,148490,0,0,0,0.00,4
,20170815,148490,148490,,,,147790,147790,-700,-700,0,0.00,4
,20170816,147790,147790,,,,147040,147040,-750,-750,0,0.00,4
,20170817,147040,147040,,,,148430,148430,1390,1390,0,0.00,4
,20170818,148430,148430,,,,147910,147910,-520,-520,0,0.00,4
,20170821,147910,147910,,,,147950,147950,40,40,0,0.00,4
,20170822,147950,147950,147180,147180,147180,147180,147180,-770,-770,2,29.44,4
,20170823,147180,147180,,,,145430,145430,-1750,-1750,0,0.00,4
,20170824,145430,145430,,,,145870,145870,440,440,0,0.00,4
,20170825,145870,145870,,,,146310,146310,440,440,0,0.00,4
,20170828,146310,146310,,,,146310,146310,0,0,0,0.00,4
,20170829,146310,146310,,,,146310,146310,0,0,0,0.00,4
,20170830,146310,146310,,,,145520,145520,-790,-790,0,0.00,4
,20170831,145520,145520,,,,146130,146130,610,610,0,0.00,4
,20170901,146130,146130,,,,146440,146440,310,310,0,0.00,4
,20170904,146440,146440,,,,146650,146650,210,210,0,0.00,4
,20170905,146650,146650,,,,146650,146650,0,0,0,0.00,4
,20170906,146650,146650,,,,145880,145880,-770,-770,0,0.00,4
,20170907,145880,145880,,,,144880,144880,-1000,-1000,0,0.00,4
,20170908,144880,144880,,,,144880,144880,0,0,0,0.00,4
,20170911,144880,144880,,,,144170,144170,-710,-710,0,0.00,4
,20170912,144170,144170,,,,144170,144170,0,0,0,0.00,4
,20170913,144170,144170,,,,144450,144450,280,280,0,0.00,4
,20170914,144450,144450,,,,144260,144260,-190,-190,0,0.00,4
,20170915,144260,144260,,,,143400,143400,-860,-860,0,0.00,4
,20170918,143400,143400,,,,143400,143400,0,0,0,0.00,4
,20170919,143400,143400,,,,143400,143400,0,0,0,0.00,4
,20170920,143400,143400,,,,143400,143400,0,0,0,0.00,4
,20170921,143400,143400,,,,143070,143070,-330,-330,0,0.00,4
,20170922,143070,143070,,,,141710,141710,-1360,-1360,0,0.00,4
,20170925,141710,141710,,,,141710,141710,0,0,0,0.00,4
,20170926,141710,141710,,,,143060,143060,1350,1350,0,0.00,4
,20170927,143060,143060,,,,143060,143060,0,0,0,0.00,4
,20170928,143060,143060,,,,143060,143060,0,0,0,0.00,4
,20170929,143060,143060,,,,143350,143350,290,290,0,0.00,4
,20171009,143350,143350,,,,143350,143350,0,0,0,0.00,4
,20171010,143350,143350,,,,143350,143350,0,0,0,0.00,4
,20171011,143350,143350,,,,143350,143350,0,0,0,0.00,4
,20171012,143350,143350,,,,142550,142550,-800,-800,0,0.00,4
,20171013,142550,142550,,,,142550,142550,0,0,0,0.00,4
,20171016,142550,142550,,,,143300,143300,750,750,0,0.00,4
,20171017,143300,143300,,,,143300,143300,0,0,0,0.00,4
,20171018,143300,143300,,,,143300,143300,0,0,0,0.00,4
,20171019,143300,143300,,,,143300,143300,0,0,0,0.00,4
,20171020,143300,143300,,,,143300,143300,0,0,0,0.00,4
,20171023,143300,143300,,,,143300,143300,0,0,0,0.00,4
,20171024,143300,143300,,,,143300,143300,0,0,0,0.00,4
,20171025,143300,143300,,,,143300,143300,0,0,0,0.00,4
,20171026,143300,143300,,,,143300,143300,0,0,0,0.00,4
,20171027,143300,143300,,,,143300,143300,0,0,0,0.00,4
,20171030,143300,143300,,,,143300,143300,0,0,0,0.00,4
,20171031,143300,143300,,,,143300,143300,0,0,0,0.00,4
,20171101,143300,143300,,,,143300,143300,0,0,0,0.00,4
,20171102,143300,143300,,,,143300,143300,0,0,0,0.00,4
,20171103,143300,143300,,,,143100,143100,-200,-200,0,0.00,4
,20171106,143100,143100,,,,143100,143100,0,0,0,0.00,4
,20171107,143100,143100,,,,143100,143100,0,0,0,0.00,4
,20171108,143100,143100,140730,143750,140730,143130,142260,30,-840,62,882.06,4
,20171109,143130,142260,,,,141970,141970,-290,-290,0,0.00,4
,20171110,141970,141970,,,,143280,143280,1310,1310,0,0.00,4
,20171113,143280,143280,,,,143770,143770,490,490,0,0.00,4
,20171114,143770,143770,,,,143920,143920,150,150,0,0.00,4
,20171115,143920,143920,,,,142900,142900,-1020,-1020,0,0.00,4
,20171116,142900,142900,,,,143300,143300,400,400,0,0.00,4
,20171117,143300,143300,,,,142900,142900,-400,-400,0,0.00,4
,20171120,142900,142900,,,,142840,142840,-60,-60,0,0.00,4
,20171121,142840,142840,,,,142840,142840,0,0,0,0.00,4
,20171122,142840,142840,,,,142800,142800,-40,-40,0,0.00,4
,20171123,142800,142800,,,,142020,142020,-780,-780,0,0.00,4
,20171124,142020,142020,,,,142430,142430,410,410,0,0.00,4
,20171127,142430,142430,,,,143220,143220,790,790,0,0.00,4
,20171128,143220,143220,,,,143140,143140,-80,-80,0,0.00,4
,20171129,143140,143140,,,,142710,142710,-430,-430,0,0.00,4
,20171130,142710,142710,,,,142710,142710,0,0,0,0.00,4
,20171201,142710,142710,,,,142710,142710,0,0,0,0.00,4
,20171204,142710,142710,,,,142980,142980,270,270,0,0.00,4
,20171205,142980,142980,,,,142980,142980,0,0,0,0.00,4
,20171206,142980,142980,,,,142980,142980,0,0,0,0.00,4
,20171207,142980,142980,,,,143050,143050,70,70,0,0.00,4
,20171208,143050,143050,,,,142420,142420,-630,-630,0,0.00,4
,20171211,142420,142420,,,,141520,141520,-900,-900,0,0.00,4
,20171212,141520,141520,,,,139860,139860,-1660,-1660,0,0.00,4
,20171213,139860,139860,,,,138270,138270,-1590,-1590,0,0.00,4
,20171214,138270,138270,,,,136780,136780,-1490,-1490,0,0.00,4
,20171215,136780,136780,,,,137310,137310,530,530,0,0.00,4
,20171218,137310,137310,,,,139050,139050,1740,1740,0,0.00,4
,20171219,139050,139050,,,,140460,140460,1410,1410,0,0.00,4
,20171220,140460,140460,136320,137680,136320,137680,136990,-2780,-3470,8,109.59,6
,20171221,137680,136990,137080,141060,137080,139230,138410,2240,1420,26,359.88,6
,20171222,139230,138410,,,,138410,138410,0,0,0,0.00,6
,20171225,138410,138410,137710,138640,137710,138640,138170,230,-240,4,55.27,8
,20171226,138640,138170,139960,139970,138260,138260,139110,90,940,8,111.29,8
,20171227,138260,139110,,,,139110,139110,0,0,0,0.00,8
,20171228,139110,139110,,,,139310,139310,200,200,0,0.00,8
,20171229,139310,139310,,,,139310,139310,0,0,0,0.00,8
sn1803,20170316,147880,147880,,,,148930,148930,1050,1050,0,0.00,0
,20170317,148930,148930,,,,149190,149190,260,260,0,0.00,0
,20170320,149190,149190,,,,148730,148730,-460,-460,0,0.00,0
,20170321,148730,148730,,,,144640,144640,-4090,-4090,0,0.00,0
,20170322,144640,144640,,,,144560,144560,-80,-80,0,0.00,0
,20170323,144560,144560,,,,145450,145450,890,890,0,0.00,0
,20170324,145450,145450,,,,145340,145340,-110,-110,0,0.00,0
,20170327,145340,145340,,,,142290,142290,-3050,-3050,0,0.00,0
,20170328,142290,142290,,,,142070,142070,-220,-220,0,0.00,0
,20170329,142070,142070,,,,143230,143230,1160,1160,0,0.00,0
,20170330,143230,143230,,,,142720,142720,-510,-510,0,0.00,0
,20170331,142720,142720,,,,142760,142760,40,40,0,0.00,0
,20170405,142760,142760,,,,142670,142670,-90,-90,0,0.00,0
,20170406,142670,142670,,,,144000,144000,1330,1330,0,0.00,0
,20170407,144000,144000,,,,144810,144810,810,810,0,0.00,0
,20170410,144810,144810,,,,145190,145190,380,380,0,0.00,0
,20170411,145190,145190,,,,141990,141990,-3200,-3200,0,0.00,0
,20170412,141990,141990,,,,140150,140150,-1840,-1840,0,0.00,0
,20170413,140150,140150,,,,140010,140010,-140,-140,0,0.00,0
,20170414,140010,140010,,,,140970,140970,960,960,0,0.00,0
,20170417,140970,140970,,,,140520,140520,-450,-450,0,0.00,0
,20170418,140520,140520,,,,141320,141320,800,800,0,0.00,0
,20170419,141320,141320,,,,138950,138950,-2370,-2370,0,0.00,0
,20170420,138950,138950,,,,139360,139360,410,410,0,0.00,0
,20170421,139360,139360,,,,139290,139290,-70,-70,0,0.00,0
,20170424,139290,139290,,,,137400,137400,-1890,-1890,0,0.00,0
,20170425,137400,137400,,,,135610,135610,-1790,-1790,0,0.00,0
,20170426,135610,135610,,,,136550,136550,940,940,0,0.00,0
,20170427,136550,136550,,,,140460,140460,3910,3910,0,0.00,0
,20170428,140460,140460,,,,141460,141460,1000,1000,0,0.00,0
,20170502,141460,141460,,,,144260,144260,2800,2800,0,0.00,0
,20170503,144260,144260,,,,143130,143130,-1130,-1130,0,0.00,0
,20170504,143130,143130,,,,145880,145880,2750,2750,0,0.00,0
,20170505,145880,145880,,,,146080,146080,200,200,0,0.00,0
,20170508,146080,146080,,,,145440,145440,-640,-640,0,0.00,0
,20170509,145440,145440,,,,145670,145670,230,230,0,0.00,0
,20170510,145670,145670,,,,146370,146370,700,700,0,0.00,0
,20170511,146370,146370,,,,145710,145710,-660,-660,0,0.00,0
,20170512,145710,145710,,,,146770,146770,1060,1060,0,0.00,0
,20170515,146770,146770,,,,145730,145730,-1040,-1040,0,0.00,0
,20170516,145730,145730,,,,145190,145190,-540,-540,0,0.00,0
,20170517,145190,145190,,,,146210,146210,1020,1020,0,0.00,0
,20170518,146210,146210,,,,147910,147910,1700,1700,0,0.00,0
,20170519,147910,147910,,,,148530,148530,620,620,0,0.00,0
,20170522,148530,148530,,,,150340,150340,1810,1810,0,0.00,0
,20170523,150340,150340,,,,149760,149760,-580,-580,0,0.00,0
,20170524,149760,149760,,,,149170,149170,-590,-590,0,0.00,0
,20170525,149170,149170,,,,149450,149450,280,280,0,0.00,0
,20170526,149450,149450,,,,149510,149510,60,60,0,0.00,0
,20170531,149510,149510,,,,148550,148550,-960,-960,0,0.00,0
,20170601,148550,148550,,,,147810,147810,-740,-740,0,0.00,0
,20170602,147810,147810,,,,147860,147860,50,50,0,0.00,0
,20170605,147860,147860,,,,147380,147380,-480,-480,0,0.00,0
,20170606,147380,147380,,,,146820,146820,-560,-560,0,0.00,0
,20170607,146820,146820,,,,147230,147230,410,410,0,0.00,0
,20170608,147230,147230,145430,145430,141830,141830,143630,-5400,-3600,4,57.45,0
,20170609,141830,143630,,,,143680,143680,50,50,0,0.00,0
,20170612,143680,143680,,,,144100,144100,420,420,0,0.00,0
,20170613,144100,144100,,,,145620,145620,1520,1520,0,0.00,0
,20170614,145620,145620,,,,146760,146760,1140,1140,0,0.00,0
,20170615,146760,146760,,,,146730,146730,-30,-30,0,0.00,0
,20170616,146730,146730,,,,147170,147170,440,440,0,0.00,0
,20170619,147170,147170,,,,146470,146470,-700,-700,0,0.00,0
,20170620,146470,146470,,,,145950,145950,-520,-520,0,0.00,0
,20170621,145950,145950,,,,145160,145160,-790,-790,0,0.00,0
,20170622,145160,145160,,,,146580,146580,1420,1420,0,0.00,0
,20170623,146580,146580,,,,146390,146390,-190,-190,0,0.00,0
,20170626,146390,146390,,,,145830,145830,-560,-560,0,0.00,0
,20170627,145830,145830,,,,144690,144690,-1140,-1140,0,0.00,0
,20170628,144690,144690,,,,146080,146080,1390,1390,0,0.00,0
,20170629,146080,146080,,,,146670,146670,590,590,0,0.00,0
,20170630,146670,146670,,,,147780,147780,1110,1110,0,0.00,0
,20170703,147780,147780,,,,147650,147650,-130,-130,0,0.00,0
,20170704,147650,147650,,,,147720,147720,70,70,0,0.00,0
,20170705,147720,147720,,,,147520,147520,-200,-200,0,0.00,0
,20170706,147520,147520,,,,146340,146340,-1180,-1180,0,0.00,0
,20170707,146340,146340,,,,146440,146440,100,100,0,0.00,0
,20170710,146440,146440,,,,150860,150860,4420,4420,0,0.00,0
,20170711,150860,150860,,,,151370,151370,510,510,0,0.00,0
,20170712,151370,151370,,,,152540,152540,1170,1170,0,0.00,0
,20170713,152540,152540,,,,153120,153120,580,580,0,0.00,0
,20170714,153120,153120,,,,151960,151960,-1160,-1160,0,0.00,0
,20170717,151960,151960,,,,152080,152080,120,120,0,0.00,0
,20170718,152080,152080,,,,152680,152680,600,600,0,0.00,0
,20170719,152680,152680,,,,154550,154550,1870,1870,0,0.00,0
,20170720,154550,154550,,,,154390,154390,-160,-160,0,0.00,0
,20170721,154390,154390,,,,153270,153270,-1120,-1120,0,0.00,0
,20170724,153270,153270,,,,154060,154060,790,790,0,0.00,0
,20170725,154060,154060,,,,154540,154540,480,480,0,0.00,0
,20170726,154540,154540,,,,155320,155320,780,780,0,0.00,0
,20170727,155320,155320,,,,157070,157070,1750,1750,0,0.00,0
,20170728,157070,157070,,,,158030,158030,960,960,0,0.00,0
,20170731,158030,158030,,,,158360,158360,330,330,0,0.00,0
,20170801,158360,158360,,,,156800,156800,-1560,-1560,0,0.00,0
,20170802,156800,156800,,,,155230,155230,-1570,-1570,0,0.00,0
,20170803,155230,155230,,,,156190,156190,960,960,0,0.00,0
,20170804,156190,156190,,,,156890,156890,700,700,0,0.00,0
,20170807,156890,156890,,,,153990,153990,-2900,-2900,0,0.00,0
,20170808,153990,153990,,,,153940,153940,-50,-50,0,0.00,0
,20170809,153940,153940,,,,153600,153600,-340,-340,0,0.00,0
,20170810,153600,153600,,,,154140,154140,540,540,0,0.00,0
,20170811,154140,154140,,,,152920,152920,-1220,-1220,0,0.00,0
,20170814,152920,152920,,,,152010,152010,-910,-910,0,0.00,0
,20170815,152010,152010,,,,151290,151290,-720,-720,0,0.00,0
,20170816,151290,151290,,,,150530,150530,-760,-760,0,0.00,0
,20170817,150530,150530,,,,151950,151950,1420,1420,0,0.00,0
,20170818,151950,151950,,,,151420,151420,-530,-530,0,0.00,0
,20170821,151420,151420,,,,151460,151460,40,40,0,0.00,0
,20170822,151460,151460,,,,150670,150670,-790,-790,0,0.00,0
,20170823,150670,150670,,,,148880,148880,-1790,-1790,0,0.00,0
,20170824,148880,148880,,,,149330,149330,450,450,0,0.00,0
,20170825,149330,149330,,,,149780,149780,450,450,0,0.00,0
,20170828,149780,149780,,,,149340,149340,-440,-440,0,0.00,0
,20170829,149340,149340,,,,150780,150780,1440,1440,0,0.00,0
,20170830,150780,150780,,,,149960,149960,-820,-820,0,0.00,0
,20170831,149960,149960,,,,150590,150590,630,630,0,0.00,0
,20170901,150590,150590,150940,150940,150940,150940,150940,350,350,2,30.19,2
,20170904,150940,150940,,,,151160,151160,220,220,0,0.00,2
,20170905,151160,151160,,,,150210,150210,-950,-950,0,0.00,2
,20170906,150210,150210,,,,149420,149420,-790,-790,0,0.00,2
,20170907,149420,149420,,,,148390,148390,-1030,-1030,0,0.00,2
,20170908,148390,148390,,,,148070,148070,-320,-320,0,0.00,2
,20170911,148070,148070,,,,147350,147350,-720,-720,0,0.00,2
,20170912,147350,147350,,,,147910,147910,560,560,0,0.00,2
,20170913,147910,147910,,,,148190,148190,280,280,0,0.00,2
,20170914,148190,148190,,,,148000,148000,-190,-190,0,0.00,2
,20170915,148000,148000,,,,147120,147120,-880,-880,0,0.00,2
,20170918,147120,147120,,,,146810,146810,-310,-310,0,0.00,2
,20170919,146810,146810,,,,146810,146810,0,0,0,0.00,2
,20170920,146810,146810,,,,147630,147630,820,820,0,0.00,2
,20170921,147630,147630,,,,147290,147290,-340,-340,0,0.00,2
,20170922,147290,147290,,,,145890,145890,-1400,-1400,0,0.00,2
,20170925,145890,145890,,,,146900,146900,1010,1010,0,0.00,2
,20170926,146900,146900,,,,148300,148300,1400,1400,0,0.00,2
,20170927,148300,148300,,,,148760,148760,460,460,0,0.00,2
,20170928,148760,148760,,,,148160,148160,-600,-600,0,0.00,2
,20170929,148160,148160,,,,148460,148460,300,300,0,0.00,2
,20171009,148460,148460,,,,149410,149410,950,950,0,0.00,2
,20171010,149410,149410,,,,149300,149300,-110,-110,0,0.00,2
,20171011,149300,149300,,,,148330,148330,-970,-970,0,0.00,2
,20171012,148330,148330,,,,147500,147500,-830,-830,0,0.00,2
,20171013,147500,147500,,,,148400,148400,900,900,0,0.00,2
,20171016,148400,148400,,,,149180,149180,780,780,0,0.00,2
,20171017,149180,149180,,,,149180,149180,0,0,0,0.00,2
,20171018,149180,149180,,,,147930,147930,-1250,-1250,0,0.00,2
,20171019,147930,147930,,,,146710,146710,-1220,-1220,0,0.00,2
,20171020,146710,146710,,,,146330,146330,-380,-380,0,0.00,2
,20171023,146330,146330,,,,145980,145980,-350,-350,0,0.00,2
,20171024,145980,145980,,,,146760,146760,780,780,0,0.00,2
,20171025,146760,146760,,,,146720,146720,-40,-40,0,0.00,2
,20171026,146720,146720,,,,147160,147160,440,440,0,0.00,2
,20171027,147160,147160,,,,146300,146300,-860,-860,0,0.00,2
,20171030,146300,146300,,,,145840,145840,-460,-460,0,0.00,2
,20171031,145840,145840,,,,145250,145250,-590,-590,0,0.00,2
,20171101,145250,145250,,,,144760,144760,-490,-490,0,0.00,2
,20171102,144760,144760,,,,146030,146030,1270,1270,0,0.00,2
,20171103,146030,146030,,,,145830,145830,-200,-200,0,0.00,2
,20171106,145830,145830,,,,145860,145860,30,30,0,0.00,2
,20171107,145860,145860,,,,145060,145060,-800,-800,0,0.00,2
,20171108,145060,145060,,,,144210,144210,-850,-850,0,0.00,2
,20171109,144210,144210,,,,143920,143920,-290,-290,0,0.00,2
,20171110,143920,143920,,,,145240,145240,1320,1320,0,0.00,2
,20171113,145240,145240,,,,145730,145730,490,490,0,0.00,2
,20171114,145730,145730,,,,145880,145880,150,150,0,0.00,2
,20171115,145880,145880,,,,144840,144840,-1040,-1040,0,0.00,2
,20171116,144840,144840,,,,145240,145240,400,400,0,0.00,2
,20171117,145240,145240,,,,144830,144830,-410,-410,0,0.00,2
,20171120,144830,144830,,,,144770,144770,-60,-60,0,0.00,2
,20171121,144770,144770,,,,144830,144830,60,60,0,0.00,2
,20171122,144830,144830,,,,144790,144790,-40,-40,0,0.00,2
,20171123,144790,144790,,,,144000,144000,-790,-790,0,0.00,2
,20171124,144000,144000,,,,144420,144420,420,420,0,0.00,2
,20171127,144420,144420,,,,145220,145220,800,800,0,0.00,2
,20171128,145220,145220,,,,145140,145140,-80,-80,0,0.00,2
,20171129,145140,145140,,,,144700,144700,-440,-440,0,0.00,2
,20171130,144700,144700,141750,144080,141750,144080,142910,-620,-1790,4,57.17,2
,20171201,144080,142910,,,,141900,141900,-1010,-1010,0,0.00,2
,20171204,141900,141900,,,,142170,142170,270,270,0,0.00,2
,20171205,142170,142170,,,,142000,142000,-170,-170,0,0.00,2
,20171206,142000,142000,,,,140940,140940,-1060,-1060,0,0.00,2
,20171207,140940,140940,,,,141010,141010,70,70,0,0.00,2
,20171208,141010,141010,,,,140390,140390,-620,-620,0,0.00,2
,20171211,140390,140390,,,,139500,139500,-890,-890,0,0.00,2
,20171212,139500,139500,,,,137870,137870,-1630,-1630,0,0.00,2
,20171213,137870,137870,,,,136300,136300,-1570,-1570,0,0.00,2
,20171214,136300,136300,,,,134830,134830,-1470,-1470,0,0.00,2
,20171215,134830,134830,,,,135350,135350,520,520,0,0.00,2
,20171218,135350,135350,,,,137060,137060,1710,1710,0,0.00,2
,20171219,137060,137060,,,,138450,138450,1390,1390,0,0.00,2
,20171220,138450,138450,,,,135020,135020,-3430,-3430,0,0.00,2
,20171221,135020,135020,,,,136420,136420,1400,1400,0,0.00,2
,20171222,136420,136420,,,,135900,135900,-520,-520,0,0.00,2
,20171225,135900,135900,,,,135660,135660,-240,-240,0,0.00,2
,20171226,135660,135660,,,,136580,136580,920,920,0,0.00,2
,20171227,136580,136580,,,,137920,137920,1340,1340,0,0.00,2
,20171228,137920,137920,,,,138120,138120,200,200,0,0.00,2
,20171229,138120,138120,,,,139960,139960,1840,1840,0,0.00,2
sn1804,20170418,140520,140520,,,,141320,141320,800,800,0,0.00,0
,20170419,141320,141320,,,,138950,138950,-2370,-2370,0,0.00,0
,20170420,138950,138950,,,,140900,140900,1950,1950,0,0.00,0
,20170421,140900,140900,,,,140830,140830,-70,-70,0,0.00,0
,20170424,140830,140830,,,,138920,138920,-1910,-1910,0,0.00,0
,20170425,138920,138920,,,,137110,137110,-1810,-1810,0,0.00,0
,20170426,137110,137110,,,,138060,138060,950,950,0,0.00,0
,20170427,138060,138060,,,,140640,140640,2580,2580,0,0.00,0
,20170428,140640,140640,,,,141640,141640,1000,1000,0,0.00,0
,20170502,141640,141640,,,,144440,144440,2800,2800,0,0.00,0
,20170503,144440,144440,,,,143310,143310,-1130,-1130,0,0.00,0
,20170504,143310,143310,,,,146060,146060,2750,2750,0,0.00,0
,20170505,146060,146060,,,,146260,146260,200,200,0,0.00,0
,20170508,146260,146260,,,,145610,145610,-650,-650,0,0.00,0
,20170509,145610,145610,,,,145840,145840,230,230,0,0.00,0
,20170510,145840,145840,,,,146540,146540,700,700,0,0.00,0
,20170511,146540,146540,,,,145880,145880,-660,-660,0,0.00,0
,20170512,145880,145880,,,,146940,146940,1060,1060,0,0.00,0
,20170515,146940,146940,,,,145890,145890,-1050,-1050,0,0.00,0
,20170516,145890,145890,,,,145350,145350,-540,-540,0,0.00,0
,20170517,145350,145350,,,,146370,146370,1020,1020,0,0.00,0
,20170518,146370,146370,,,,148070,148070,1700,1700,0,0.00,0
,20170519,148070,148070,,,,148690,148690,620,620,0,0.00,0
,20170522,148690,148690,,,,150500,150500,1810,1810,0,0.00,0
,20170523,150500,150500,,,,149920,149920,-580,-580,0,0.00,0
,20170524,149920,149920,,,,149330,149330,-590,-590,0,0.00,0
,20170525,149330,149330,,,,149610,149610,280,280,0,0.00,0
,20170526,149610,149610,,,,149670,149670,60,60,0,0.00,0
,20170531,149670,149670,,,,148710,148710,-960,-960,0,0.00,0
,20170601,148710,148710,,,,147970,147970,-740,-740,0,0.00,0
,20170602,147970,147970,,,,148020,148020,50,50,0,0.00,0
,20170605,148020,148020,,,,147540,147540,-480,-480,0,0.00,0
,20170606,147540,147540,,,,146980,146980,-560,-560,0,0.00,0
,20170607,146980,146980,,,,147390,147390,410,410,0,0.00,0
,20170608,147390,147390,,,,143780,143780,-3610,-3610,0,0.00,0
,20170609,143780,143780,,,,143830,143830,50,50,0,0.00,0
,20170612,143830,143830,,,,144250,144250,420,420,0,0.00,0
,20170613,144250,144250,,,,145770,145770,1520,1520,0,0.00,0
,20170614,145770,145770,,,,146910,146910,1140,1140,0,0.00,0
,20170615,146910,146910,,,,146880,146880,-30,-30,0,0.00,0
,20170616,146880,146880,,,,147320,147320,440,440,0,0.00,0
,20170619,147320,147320,,,,146620,146620,-700,-700,0,0.00,0
,20170620,146620,146620,,,,146100,146100,-520,-520,0,0.00,0
,20170621,146100,146100,,,,145310,145310,-790,-790,0,0.00,0
,20170622,145310,145310,,,,146730,146730,1420,1420,0,0.00,0
,20170623,146730,146730,,,,146540,146540,-190,-190,0,0.00,0
,20170626,146540,146540,,,,145980,145980,-560,-560,0,0.00,0
,20170627,145980,145980,,,,144840,144840,-1140,-1140,0,0.00,0
,20170628,144840,144840,,,,146230,146230,1390,1390,0,0.00,0
,20170629,146230,146230,,,,146820,146820,590,590,0,0.00,0
,20170630,146820,146820,,,,147930,147930,1110,1110,0,0.00,0
,20170703,147930,147930,,,,147800,147800,-130,-130,0,0.00,0
,20170704,147800,147800,,,,147870,147870,70,70,0,0.00,0
,20170705,147870,147870,,,,147670,147670,-200,-200,0,0.00,0
,20170706,147670,147670,,,,146490,146490,-1180,-1180,0,0.00,0
,20170707,146490,146490,,,,146590,146590,100,100,0,0.00,0
,20170710,146590,146590,,,,151010,151010,4420,4420,0,0.00,0
,20170711,151010,151010,,,,151520,151520,510,510,0,0.00,0
,20170712,151520,151520,,,,152690,152690,1170,1170,0,0.00,0
,20170713,152690,152690,,,,153270,153270,580,580,0,0.00,0
,20170714,153270,153270,,,,152110,152110,-1160,-1160,0,0.00,0
,20170717,152110,152110,,,,152230,152230,120,120,0,0.00,0
,20170718,152230,152230,,,,152830,152830,600,600,0,0.00,0
,20170719,152830,152830,,,,154700,154700,1870,1870,0,0.00,0
,20170720,154700,154700,,,,154540,154540,-160,-160,0,0.00,0
,20170721,154540,154540,,,,153420,153420,-1120,-1120,0,0.00,0
,20170724,153420,153420,,,,154210,154210,790,790,0,0.00,0
,20170725,154210,154210,,,,154700,154700,490,490,0,0.00,0
,20170726,154700,154700,,,,155480,155480,780,780,0,0.00,0
,20170727,155480,155480,,,,157230,157230,1750,1750,0,0.00,0
,20170728,157230,157230,,,,158190,158190,960,960,0,0.00,0
,20170731,158190,158190,,,,158520,158520,330,330,0,0.00,0
,20170801,158520,158520,,,,156960,156960,-1560,-1560,0,0.00,0
,20170802,156960,156960,,,,155390,155390,-1570,-1570,0,0.00,0
,20170803,155390,155390,,,,156350,156350,960,960,0,0.00,0
,20170804,156350,156350,,,,157050,157050,700,700,0,0.00,0
,20170807,157050,157050,,,,154150,154150,-2900,-2900,0,0.00,0
,20170808,154150,154150,,,,154100,154100,-50,-50,0,0.00,0
,20170809,154100,154100,,,,153760,153760,-340,-340,0,0.00,0
,20170810,153760,153760,,,,154310,154310,550,550,0,0.00,0
,20170811,154310,154310,,,,153090,153090,-1220,-1220,0,0.00,0
,20170814,153090,153090,,,,152180,152180,-910,-910,0,0.00,0
,20170815,152180,152180,,,,151460,151460,-720,-720,0,0.00,0
,20170816,151460,151460,,,,150690,150690,-770,-770,0,0.00,0
,20170817,150690,150690,,,,152110,152110,1420,1420,0,0.00,0
,20170818,152110,152110,,,,151580,151580,-530,-530,0,0.00,0
,20170821,151580,151580,,,,151620,151620,40,40,0,0.00,0
,20170822,151620,151620,,,,150830,150830,-790,-790,0,0.00,0
,20170823,150830,150830,,,,149040,149040,-1790,-1790,0,0.00,0
,20170824,149040,149040,,,,149490,149490,450,450,0,0.00,0
,20170825,149490,149490,,,,149940,149940,450,450,0,0.00,0
,20170828,149940,149940,,,,149500,149500,-440,-440,0,0.00,0
,20170829,149500,149500,,,,150940,150940,1440,1440,0,0.00,0
,20170830,150940,150940,,,,150120,150120,-820,-820,0,0.00,0
,20170831,150120,150120,,,,150750,150750,630,630,0,0.00,0
,20170901,150750,150750,,,,151100,151100,350,350,0,0.00,0
,20170904,151100,151100,,,,151320,151320,220,220,0,0.00,0
,20170905,151320,151320,,,,150370,150370,-950,-950,0,0.00,0
,20170906,150370,150370,,,,149580,149580,-790,-790,0,0.00,0
,20170907,149580,149580,,,,148550,148550,-1030,-1030,0,0.00,0
,20170908,148550,148550,,,,148230,148230,-320,-320,0,0.00,0
,20170911,148230,148230,,,,147510,147510,-720,-720,0,0.00,0
,20170912,147510,147510,,,,148070,148070,560,560,0,0.00,0
,20170913,148070,148070,,,,148350,148350,280,280,0,0.00,0
,20170914,148350,148350,,,,148160,148160,-190,-190,0,0.00,0
,20170915,148160,148160,,,,147280,147280,-880,-880,0,0.00,0
,20170918,147280,147280,,,,146970,146970,-310,-310,0,0.00,0
,20170919,146970,146970,,,,148290,148290,1320,1320,0,0.00,0
,20170920,148290,148290,,,,149120,149120,830,830,0,0.00,0
,20170921,149120,149120,,,,148780,148780,-340,-340,0,0.00,0
,20170922,148780,148780,,,,147370,147370,-1410,-1410,0,0.00,0
,20170925,147370,147370,,,,148390,148390,1020,1020,0,0.00,0
,20170926,148390,148390,,,,149810,149810,1420,1420,0,0.00,0
,20170927,149810,149810,,,,150280,150280,470,470,0,0.00,0
,20170928,150280,150280,,,,149670,149670,-610,-610,0,0.00,0
,20170929,149670,149670,,,,149980,149980,310,310,0,0.00,0
,20171009,149980,149980,,,,150940,150940,960,960,0,0.00,0
,20171010,150940,150940,146310,149670,145800,149670,147860,-1270,-3080,8,118.29,4
,20171011,149670,147860,,,,146400,146400,-1460,-1460,0,0.00,4
,20171012,146400,146400,146400,146400,146400,146400,146400,0,0,2,29.28,4
,20171013,146400,146400,,,,147290,147290,890,890,0,0.00,4
,20171016,147290,147290,,,,148060,148060,770,770,0,0.00,4
,20171017,148060,148060,,,,148060,148060,0,0,0,0.00,4
,20171018,148060,148060,,,,146820,146820,-1240,-1240,0,0.00,4
,20171019,146820,146820,,,,145610,145610,-1210,-1210,0,0.00,4
,20171020,145610,145610,,,,145230,145230,-380,-380,0,0.00,4
,20171023,145230,145230,145780,145780,144640,144640,145210,-590,-20,4,58.08,4
,20171024,144640,145210,,,,145990,145990,780,780,0,0.00,4
,20171025,145990,145990,,,,145950,145950,-40,-40,0,0.00,4
,20171026,145950,145950,,,,146390,146390,440,440,0,0.00,4
,20171027,146390,146390,,,,145530,145530,-860,-860,0,0.00,4
,20171030,145530,145530,,,,145070,145070,-460,-460,0,0.00,4
,20171031,145070,145070,,,,144480,144480,-590,-590,0,0.00,4
,20171101,144480,144480,,,,143990,143990,-490,-490,0,0.00,4
,20171102,143990,143990,,,,145250,145250,1260,1260,0,0.00,4
,20171103,145250,145250,,,,145050,145050,-200,-200,0,0.00,4
,20171106,145050,145050,,,,145080,145080,30,30,0,0.00,4
,20171107,145080,145080,,,,144280,144280,-800,-800,0,0.00,4
,20171108,144280,144280,,,,143440,143440,-840,-840,0,0.00,4
,20171109,143440,143440,,,,143150,143150,-290,-290,0,0.00,4
,20171110,143150,143150,,,,144470,144470,1320,1320,0,0.00,4
,20171113,144470,144470,,,,144960,144960,490,490,0,0.00,4
,20171114,144960,144960,,,,145110,145110,150,150,0,0.00,4
,20171115,145110,145110,144200,144200,144200,144200,144200,-910,-910,2,28.84,4
,20171116,144200,144200,,,,144600,144600,400,400,0,0.00,4
,20171117,144600,144600,,,,144200,144200,-400,-400,0,0.00,4
,20171120,144200,144200,,,,144140,144140,-60,-60,0,0.00,4
,20171121,144140,144140,,,,144200,144200,60,60,0,0.00,4
,20171122,144200,144200,,,,144160,144160,-40,-40,0,0.00,4
,20171123,144160,144160,,,,143370,143370,-790,-790,0,0.00,4
,20171124,143370,143370,,,,143790,143790,420,420,0,0.00,4
,20171127,143790,143790,144270,144270,144270,144270,144270,480,480,2,28.85,6
,20171128,144270,144270,,,,144190,144190,-80,-80,0,0.00,6
,20171129,144190,144190,144130,144130,144130,144130,144130,-60,-60,2,28.83,4
,20171130,144130,144130,,,,142350,142350,-1780,-1780,0,0.00,4
,20171201,142350,142350,,,,141340,141340,-1010,-1010,0,0.00,4
,20171204,141340,141340,142910,142910,140670,140670,141790,-670,450,4,56.72,2
,20171205,140670,141790,,,,141620,141620,-170,-170,0,0.00,2
,20171206,141620,141620,,,,140560,140560,-1060,-1060,0,0.00,2
,20171207,140560,140560,,,,140630,140630,70,70,0,0.00,2
,20171208,140630,140630,,,,140010,140010,-620,-620,0,0.00,2
,20171211,140010,140010,,,,139120,139120,-890,-890,0,0.00,2
,20171212,139120,139120,,,,137490,137490,-1630,-1630,0,0.00,2
,20171213,137490,137490,,,,135930,135930,-1560,-1560,0,0.00,2
,20171214,135930,135930,,,,134470,134470,-1460,-1460,0,0.00,2
,20171215,134470,134470,,,,134990,134990,520,520,0,0.00,2
,20171218,134990,134990,,,,136700,136700,1710,1710,0,0.00,2
,20171219,136700,136700,,,,138090,138090,1390,1390,0,0.00,2
,20171220,138090,138090,,,,134670,134670,-3420,-3420,0,0.00,2
,20171221,134670,134670,,,,136070,136070,1400,1400,0,0.00,2
,20171222,136070,136070,,,,135550,135550,-520,-520,0,0.00,2
,20171225,135550,135550,,,,135310,135310,-240,-240,0,0.00,2
,20171226,135310,135310,,,,136230,136230,920,920,0,0.00,2
,20171227,136230,136230,,,,137570,137570,1340,1340,0,0.00,2
,20171228,137570,137570,,,,137770,137770,200,200,0,0.00,2
,20171229,137770,137770,,,,139610,139610,1840,1840,0,0.00,2
sn1805,20170516,145890,145890,,,,145350,145350,-540,-540,0,0.00,0
,20170517,145350,145350,,,,146370,146370,1020,1020,0,0.00,0
,20170518,146370,146370,,,,148070,148070,1700,1700,0,0.00,0
,20170519,148070,148070,148300,148300,144490,144490,146390,-3580,-1680,8,117.12,4
,20170522,144490,146390,,,,146390,146390,0,0,0,0.00,4
,20170523,146390,146390,,,,145830,145830,-560,-560,0,0.00,4
,20170524,145830,145830,150510,154530,143480,146310,147900,480,2070,16,236.65,8
,20170525,146310,147900,146510,146790,146510,146510,146700,-1390,-1200,16,234.73,18
,20170526,146510,146700,,,,146700,146700,0,0,0,0.00,18
,20170531,146700,146700,147300,147300,144580,145130,145640,-1570,-1060,12,174.77,28
,20170601,145130,145640,,,,145640,145640,0,0,0,0.00,28
,20170602,145640,145640,,,,145640,145640,0,0,0,0.00,28
,20170605,145640,145640,145130,145980,145130,145980,145420,340,-220,12,174.51,28
,20170606,145980,145420,145020,145020,144970,144970,144990,-450,-430,4,58.00,30
,20170607,144970,144990,,,,144990,144990,0,0,0,0.00,30
,20170608,144990,144990,,,,144990,144990,0,0,0,0.00,30
,20170609,144990,144990,,,,144990,144990,0,0,0,0.00,30
,20170612,144990,144990,144810,144810,144810,144810,144810,-180,-180,2,28.96,28
,20170613,144810,144810,147430,147430,147430,147430,147430,2620,2620,2,29.49,30
,20170614,147430,147430,146320,148410,145860,147890,147160,460,-270,18,264.89,44
,20170615,147890,147160,147680,147680,146350,146350,147210,-810,50,6,88.33,48
,20170616,146350,147210,146650,147730,146650,147730,147030,520,-180,10,147.03,50
,20170619,147730,147030,147010,147010,146050,146050,146710,-980,-320,8,117.37,52
,20170620,146050,146710,146550,146550,145300,145300,145930,-1410,-780,10,145.94,54
,20170621,145300,145930,145660,145660,144760,144930,145080,-1000,-850,8,116.07,52
,20170622,144930,145080,145570,146990,145570,146990,146300,1910,1220,16,234.08,58
,20170623,146990,146300,146510,146510,146150,146150,146330,-150,30,4,58.53,60
,20170626,146150,146330,145880,146490,144970,144970,145530,-1360,-800,12,174.64,54
,20170627,144970,145530,,,,145530,145530,0,0,0,0.00,54
,20170628,145530,145530,145210,146330,145210,146330,145750,800,220,12,174.91,60
,20170629,146330,145750,,,,146100,146100,350,350,0,0.00,60
,20170630,146100,146100,147200,147810,147200,147510,147500,1410,1400,18,265.51,60
,20170703,147510,147500,147600,147600,147530,147530,147560,30,60,4,59.03,58
,20170704,147530,147560,146240,146240,146150,146150,146180,-1410,-1380,10,146.18,54
,20170705,146150,146180,,,,146180,146180,0,0,0,0.00,54
,20170706,146180,146180,146750,146750,146000,146000,146370,-180,190,4,58.55,50
,20170707,146000,146370,145530,145530,145530,145530,145530,-840,-840,2,29.11,52
,20170710,145530,145530,145900,146650,145570,145570,146090,40,560,10,146.09,52
,20170711,145570,146090,146020,146170,146000,146110,146070,20,-20,8,116.86,50
,20170712,146110,146070,146740,146770,146610,146610,146720,540,650,10,146.73,56
,20170713,146610,146720,,,,147280,147280,560,560,0,0.00,56
,20170714,147280,147280,,,,146160,146160,-1120,-1120,0,0.00,56
,20170717,146160,146160,,,,146280,146280,120,120,0,0.00,56
,20170718,146280,146280,148080,148080,146770,146770,147420,490,1140,4,58.97,60
,20170719,146770,147420,148570,149290,147610,149290,148620,1870,1200,10,148.62,62
,20170720,149290,148620,148820,148870,148140,148650,148670,30,50,10,148.67,68
,20170721,148650,148670,148330,148330,147460,147460,148090,-1210,-580,36,533.13,72
,20170724,147460,148090,147580,147850,147580,147850,147710,-240,-380,4,59.09,70
,20170725,147850,147710,,,,147710,147710,0,0,0,0.00,70
,20170726,147710,147710,149740,149780,149520,149520,149680,1810,1970,6,89.81,70
,20170727,149520,149680,149920,152620,149920,152620,150760,2940,1080,34,512.62,76
,20170728,152620,150760,152640,153270,151000,151000,152650,240,1890,20,305.32,82
,20170731,151000,152650,151850,153100,151780,152450,152350,-200,-300,12,182.82,88
,20170801,152450,152350,151710,151710,149920,150240,150770,-2110,-1580,26,392.01,94
,20170802,150240,150770,149290,151080,149120,151080,149690,310,-1080,20,299.40,104
,20170803,151080,149690,150490,150490,150490,150490,150490,800,800,2,30.10,102
,20170804,150490,150490,150850,151490,150850,151490,151010,1000,520,8,120.81,106
,20170807,151490,151010,151050,151050,150390,150800,150920,-210,-90,38,573.50,102
,20170808,150800,150920,151430,151430,150000,150000,150890,-920,-30,14,211.25,104
,20170809,150000,150890,149140,151330,149140,150690,150310,-200,-580,82,"1,232.61",108
,20170810,150690,150310,151020,151570,150130,150860,151030,550,720,56,845.79,96
,20170811,150860,151030,150090,150990,149010,149960,149860,-1070,-1170,38,569.48,106
,20170814,149960,149860,149410,149590,147600,147600,149150,-2260,-710,46,686.10,94
,20170815,147600,149150,147840,148900,147400,148210,148350,-940,-800,22,326.38,98
,20170816,148210,148350,148830,148830,147320,147320,148070,-1030,-280,4,59.23,94
,20170817,147320,148070,148580,149470,147900,149450,148850,1380,780,44,654.96,96
,20170818,149450,148850,148440,148700,148440,148700,148570,-150,-280,4,59.43,98
,20170821,148700,148570,148230,148480,148170,148480,148280,-90,-290,12,177.94,96
,20170822,148480,148280,148180,148410,148180,148410,148250,130,-30,6,88.95,96
,20170823,148410,148250,147740,147740,146000,146000,146740,-2250,-1510,14,205.44,98
,20170824,146000,146740,144800,147410,144800,147250,146920,510,180,22,323.24,100
,20170825,147250,146920,148190,148400,147090,147090,147890,170,970,12,177.47,100
,20170828,147090,147890,146150,148190,146150,148190,147450,300,-440,14,206.43,102
,20170829,148190,147450,148890,149250,148890,149250,149070,1800,1620,4,59.63,100
,20170830,149250,149070,147850,147850,146720,147040,147100,-2030,-1970,20,294.21,96
,20170831,147040,147100,148960,148960,148570,148580,148700,1480,1600,6,89.22,100
,20170901,148580,148700,148780,148780,148670,148740,148730,40,30,8,118.99,100
,20170904,148740,148730,149010,149560,148760,148760,149120,30,390,14,208.78,98
,20170905,148760,149120,147780,148320,147130,147130,147830,-1990,-1290,12,177.40,98
,20170906,147130,147830,147950,147950,146660,146660,147180,-1170,-650,14,206.06,102
,20170907,146660,147180,146550,146570,146030,146030,146330,-1150,-850,12,175.61,102
,20170908,146030,146330,146140,146550,144340,145050,145750,-1280,-580,40,583.00,116
,20170911,145050,145750,145040,145750,144610,145750,145250,0,-500,30,435.76,118
,20170912,145750,145250,146120,146120,146120,146120,146120,870,870,2,29.22,118
,20170913,146120,146120,145590,146880,145590,146320,146310,200,190,74,"1,082.73",132
,20170914,146320,146310,145320,146970,145320,145940,146260,-370,-50,32,468.04,134
,20170915,145940,146260,146200,146270,144000,144250,145070,-2010,-1190,26,377.20,138
,20170918,144250,145070,144850,145430,144400,145100,144800,30,-270,48,695.07,148
,20170919,145100,144800,145180,146880,145150,145920,145770,1120,970,32,466.48,156
,20170920,145920,145770,146490,147540,146370,147340,146760,1570,990,62,909.95,178
,20170921,147340,146760,147500,147660,145290,145830,146350,-930,-410,78,"1,141.58",174
,20170922,145830,146350,145360,146310,144330,144830,145340,-1520,-1010,112,"1,627.88",178
,20170925,144830,145340,145630,147010,144830,146460,146090,1120,750,34,496.72,182
,20170926,146460,146090,146540,148920,146540,148000,147550,1910,1460,54,796.80,192
,20170927,148000,147550,148000,148350,147620,148300,148050,750,500,24,355.33,194
,20170928,148300,148050,148320,148320,147000,147050,147380,-1000,-670,34,501.09,190
,20170929,147050,147380,147760,147860,147460,147660,147570,280,190,70,"1,033.03",192
,20171009,147660,147570,147350,149220,147350,149020,148970,1450,1400,28,417.13,192
,20171010,149020,148970,149040,149040,147820,147880,148490,-1090,-480,24,356.39,184
,20171011,147880,148490,147040,148200,147040,147060,147730,-1430,-760,40,590.95,188
,20171012,147060,147730,146690,147630,145800,147510,146710,-220,-1020,88,"1,291.11",184
,20171013,147510,146710,147360,148260,147010,148260,147610,1550,900,46,679.02,178
,20171016,148260,147610,149690,149690,148000,148730,148670,1120,1060,94,"1,397.59",210
,20171017,148730,148670,148690,149000,147950,148300,148550,-370,-120,54,802.21,200
,20171018,148300,148550,147900,147910,146290,146290,147340,-2260,-1210,108,"1,591.29",182
,20171019,146290,147340,145820,146290,145800,145850,145980,-1490,-1360,58,846.73,204
,20171020,145850,145980,145220,146190,145220,145880,145640,-100,-340,62,902.97,208
,20171023,145880,145640,144970,145960,144970,145960,145250,320,-390,78,"1,133.01",200
,20171024,145960,145250,145670,146560,145670,146560,146100,1310,850,50,730.50,200
,20171025,146560,146100,146120,146300,146000,146300,146100,200,0,28,409.08,206
,20171026,146300,146100,146320,147070,146020,146890,146410,790,310,32,468.52,214
,20171027,146890,146410,146660,146660,145120,145220,145780,-1190,-630,64,932.99,230
,20171030,145220,145780,144290,145800,144290,145240,145270,-540,-510,88,"1,278.44",240
,20171031,145240,145270,144970,145370,144020,144920,144690,-350,-580,126,"1,823.18",264
,20171101,144920,144690,144220,146390,142200,145750,144020,1060,-670,436,"6,279.57",318
,20171102,145750,144020,145880,146050,144960,145580,145570,1560,1550,142,"2,067.20",302
,20171103,145580,145570,145160,145910,145000,145020,145380,-550,-190,204,"2,965.90",368
,20171106,145020,145380,145250,145720,144760,145390,145310,10,-70,152,"2,208.82",402
,20171107,145390,145310,145220,145230,143000,143610,144050,-1700,-1260,222,"3,198.08",472
,20171108,143610,144050,143380,143980,142400,142450,143230,-1600,-820,310,"4,440.35",610
,20171109,142450,143230,142490,143590,142420,143470,142930,240,-300,274,"3,916.42",636
,20171110,143470,142930,142880,145690,142880,145180,144240,2250,1310,488,"7,038.99",644
,20171113,145180,144240,145780,145780,144500,145020,145190,780,950,120,"1,742.31",642
,20171114,145020,145190,144340,146100,144340,145380,145260,190,70,270,"3,922.03",686
,20171115,145380,145260,145320,145500,143680,144600,144690,-660,-570,622,"9,000.18",752
,20171116,144600,144690,145080,145210,144430,144730,144750,40,60,256,"3,705.65",732
,20171117,144730,144750,145080,145130,143690,144080,144310,-670,-440,322,"4,647.05",728
,20171120,144080,144310,144100,144510,143750,144190,144130,-120,-180,236,"3,401.57",738
,20171121,144190,144130,144240,144990,143610,144600,144470,470,340,548,"7,917.41",886
,20171122,144600,144470,144810,145040,144300,144400,144510,-70,40,288,"4,161.95",892
,20171123,144400,144510,144400,144690,142800,143290,143380,-1220,-1130,550,"7,886.02",1100
,20171124,143290,143380,143400,145320,143230,145140,144450,1760,1070,934,"13,492.47",1298
,20171127,145140,144450,145500,145890,144920,145000,145220,550,770,600,"8,713.24",1370
,20171128,145000,145220,144910,145600,144800,145100,145140,-120,-80,424,"6,154.28",1400
,20171129,145100,145140,144900,145410,144670,144750,144990,-390,-150,540,"7,829.99",1732
,20171130,144750,144990,144970,145440,143900,144100,144600,-890,-390,1064,"15,385.99",2046
,20171201,144100,144600,144500,144570,142700,142980,143560,-1620,-1040,1494,"21,448.28",2252
,20171204,142980,143560,142970,144230,142760,143920,143740,360,180,1174,"16,875.46",2388
,20171205,143920,143740,143810,144180,142900,142940,143550,-800,-190,880,"12,633.19",2618
,20171206,142940,143550,142940,143220,142020,142890,142530,-660,-1020,1936,"27,595.12",3280
,20171207,142890,142530,142860,143040,141800,142290,142460,-240,-70,994,"14,160.73",3554
,20171208,142290,142460,142150,142560,141570,141570,141970,-890,-490,1778,"25,242.54",3906
,20171211,141570,141970,141610,142000,140080,140360,141030,-1610,-940,2572,"36,273.81",4596
,20171212,140360,141030,140090,141000,138270,139830,139410,-1200,-1620,5312,"74,057.10",5658
,20171213,139830,139410,139550,140200,136540,136810,138280,-2600,-1130,5996,"82,913.34",7282
,20171214,136810,138280,136490,138460,135220,137150,136880,-1130,-1400,9652,"132,121.80",8548
,20171215,137150,136880,137560,138070,136740,137190,137390,310,510,3904,"53,637.66",9552
,20171218,137190,137390,138010,140860,137850,140410,139190,3020,1800,8132,"113,196.66",10080
,20171219,140410,139190,140500,141500,139800,140010,140460,820,1270,6270,"88,072.82",10970
,20171220,140010,140460,140290,141000,139860,140750,140570,290,110,6110,"85,893.61",11822
,20171221,140750,140570,140900,141890,140480,140810,141030,240,460,5358,"75,564.72",12534
,20171222,140810,141030,140760,141130,140000,140500,140480,-530,-550,4924,"69,175.39",13354
,20171225,140500,140480,140040,141700,140040,141300,140980,820,500,7134,"100,576.35",14294
,20171226,141300,140980,141300,143210,140610,143210,141810,2230,830,9920,"140,676.60",15530
,20171227,143210,141810,143220,143500,142350,142890,142860,1080,1050,6614,"94,493.13",15380
,20171228,142890,142860,143030,144460,142610,144390,143150,1530,290,11290,"161,626.88",16068
,20171229,144390,143150,144100,145000,143590,144840,144450,1690,1300,15210,"219,723.39",16212
sn1806,20170616,147210,147210,,,,147030,147030,-180,-180,0,0.00,0
,20170619,147030,147030,,,,147030,147030,0,0,0,0.00,0
,20170620,147030,147030,,,,146250,146250,-780,-780,0,0.00,0
,20170621,146250,146250,,,,145400,145400,-850,-850,0,0.00,0
,20170622,145400,145400,,,,146620,146620,1220,1220,0,0.00,0
,20170623,146620,146620,,,,146650,146650,30,30,0,0.00,0
,20170626,146650,146650,,,,145840,145840,-810,-810,0,0.00,0
,20170627,145840,145840,,,,144700,144700,-1140,-1140,0,0.00,0
,20170628,144700,144700,,,,144920,144920,220,220,0,0.00,0
,20170629,144920,144920,,,,145510,145510,590,590,0,0.00,0
,20170630,145510,145510,,,,146900,146900,1390,1390,0,0.00,0
,20170703,146900,146900,,,,146960,146960,60,60,0,0.00,0
,20170704,146960,146960,,,,145580,145580,-1380,-1380,0,0.00,0
,20170705,145580,145580,,,,145380,145380,-200,-200,0,0.00,0
,20170706,145380,145380,,,,145570,145570,190,190,0,0.00,0
,20170707,145570,145570,,,,144730,144730,-840,-840,0,0.00,0
,20170710,144730,144730,,,,145280,145280,550,550,0,0.00,0
,20170711,145280,145280,,,,145260,145260,-20,-20,0,0.00,0
,20170712,145260,145260,,,,145910,145910,650,650,0,0.00,0
,20170713,145910,145910,,,,146460,146460,550,550,0,0.00,0
,20170714,146460,146460,,,,145350,145350,-1110,-1110,0,0.00,0
,20170717,145350,145350,,,,145470,145470,120,120,0,0.00,0
,20170718,145470,145470,,,,146600,146600,1130,1130,0,0.00,0
,20170719,146600,146600,,,,147790,147790,1190,1190,0,0.00,0
,20170720,147790,147790,,,,147830,147830,40,40,0,0.00,0
,20170721,147830,147830,,,,147250,147250,-580,-580,0,0.00,0
,20170724,147250,147250,,,,146870,146870,-380,-380,0,0.00,0
,20170725,146870,146870,,,,147330,147330,460,460,0,0.00,0
,20170726,147330,147330,,,,149290,149290,1960,1960,0,0.00,0
,20170727,149290,149290,,,,150370,150370,1080,1080,0,0.00,0
,20170728,150370,150370,,,,152260,152260,1890,1890,0,0.00,0
,20170731,152260,152260,,,,151960,151960,-300,-300,0,0.00,0
,20170801,151960,151960,,,,150380,150380,-1580,-1580,0,0.00,0
,20170802,150380,150380,,,,149310,149310,-1070,-1070,0,0.00,0
,20170803,149310,149310,,,,150100,150100,790,790,0,0.00,0
,20170804,150100,150100,,,,150610,150610,510,510,0,0.00,0
,20170807,150610,150610,,,,150520,150520,-90,-90,0,0.00,0
,20170808,150520,150520,,,,150490,150490,-30,-30,0,0.00,0
,20170809,150490,150490,,,,149910,149910,-580,-580,0,0.00,0
,20170810,149910,149910,,,,150630,150630,720,720,0,0.00,0
,20170811,150630,150630,,,,149460,149460,-1170,-1170,0,0.00,0
,20170814,149460,149460,,,,148750,148750,-710,-710,0,0.00,0
,20170815,148750,148750,,,,147950,147950,-800,-800,0,0.00,0
,20170816,147950,147950,,,,147670,147670,-280,-280,0,0.00,0
,20170817,147670,147670,,,,148450,148450,780,780,0,0.00,0
,20170818,148450,148450,,,,148170,148170,-280,-280,0,0.00,0
,20170821,148170,148170,,,,147880,147880,-290,-290,0,0.00,0
,20170822,147880,147880,,,,147850,147850,-30,-30,0,0.00,0
,20170823,147850,147850,,,,146340,146340,-1510,-1510,0,0.00,0
,20170824,146340,146340,,,,146520,146520,180,180,0,0.00,0
,20170825,146520,146520,,,,147480,147480,960,960,0,0.00,0
,20170828,147480,147480,,,,147040,147040,-440,-440,0,0.00,0
,20170829,147040,147040,,,,148650,148650,1610,1610,0,0.00,0
,20170830,148650,148650,,,,146690,146690,-1960,-1960,0,0.00,0
,20170831,146690,146690,,,,148280,148280,1590,1590,0,0.00,0
,20170901,148280,148280,,,,148310,148310,30,30,0,0.00,0
,20170904,148310,148310,,,,148700,148700,390,390,0,0.00,0
,20170905,148700,148700,,,,147410,147410,-1290,-1290,0,0.00,0
,20170906,147410,147410,,,,146760,146760,-650,-650,0,0.00,0
,20170907,146760,146760,,,,145920,145920,-840,-840,0,0.00,0
,20170908,145920,145920,,,,145340,145340,-580,-580,0,0.00,0
,20170911,145340,145340,,,,144840,144840,-500,-500,0,0.00,0
,20170912,144840,144840,,,,145700,145700,860,860,0,0.00,0
,20170913,145700,145700,,,,145890,145890,190,190,0,0.00,0
,20170914,145890,145890,,,,145840,145840,-50,-50,0,0.00,0
,20170915,145840,145840,,,,144660,144660,-1180,-1180,0,0.00,0
,20170918,144660,144660,,,,144390,144390,-270,-270,0,0.00,0
,20170919,144390,144390,,,,145360,145360,970,970,0,0.00,0
,20170920,145360,145360,,,,146350,146350,990,990,0,0.00,0
,20170921,146350,146350,,,,145940,145940,-410,-410,0,0.00,0
,20170922,145940,145940,,,,144930,144930,-1010,-1010,0,0.00,0
,20170925,144930,144930,,,,145680,145680,750,750,0,0.00,0
,20170926,145680,145680,,,,147140,147140,1460,1460,0,0.00,0
,20170927,147140,147140,,,,147640,147640,500,500,0,0.00,0
,20170928,147640,147640,,,,146970,146970,-670,-670,0,0.00,0
,20170929,146970,146970,,,,147160,147160,190,190,0,0.00,0
,20171009,147160,147160,,,,148560,148560,1400,1400,0,0.00,0
,20171010,148560,148560,,,,148080,148080,-480,-480,0,0.00,0
,20171011,148080,148080,,,,147330,147330,-750,-750,0,0.00,0
,20171012,147330,147330,,,,146320,146320,-1010,-1010,0,0.00,0
,20171013,146320,146320,,,,147220,147220,900,900,0,0.00,0
,20171016,147220,147220,,,,148280,148280,1060,1060,0,0.00,0
,20171017,148280,148280,,,,148160,148160,-120,-120,0,0.00,0
,20171018,148160,148160,,,,146950,146950,-1210,-1210,0,0.00,0
,20171019,146950,146950,,,,145600,145600,-1350,-1350,0,0.00,0
,20171020,145600,145600,,,,145260,145260,-340,-340,0,0.00,0
,20171023,145260,145260,,,,144870,144870,-390,-390,0,0.00,0
,20171024,144870,144870,,,,145710,145710,840,840,0,0.00,0
,20171025,145710,145710,,,,145710,145710,0,0,0,0.00,0
,20171026,145710,145710,,,,146020,146020,310,310,0,0.00,0
,20171027,146020,146020,,,,145390,145390,-630,-630,0,0.00,0
,20171030,145390,145390,,,,144880,144880,-510,-510,0,0.00,0
,20171031,144880,144880,,,,144300,144300,-580,-580,0,0.00,0
,20171101,144300,144300,,,,143630,143630,-670,-670,0,0.00,0
,20171102,143630,143630,,,,145180,145180,1550,1550,0,0.00,0
,20171103,145180,145180,,,,144990,144990,-190,-190,0,0.00,0
,20171106,144990,144990,,,,144920,144920,-70,-70,0,0.00,0
,20171107,144920,144920,,,,143670,143670,-1250,-1250,0,0.00,0
,20171108,143670,143670,,,,142850,142850,-820,-820,0,0.00,0
,20171109,142850,142850,,,,142550,142550,-300,-300,0,0.00,0
,20171110,142550,142550,,,,143850,143850,1300,1300,0,0.00,0
,20171113,143850,143850,,,,144790,144790,940,940,0,0.00,0
,20171114,144790,144790,,,,144860,144860,70,70,0,0.00,0
,20171115,144860,144860,,,,144290,144290,-570,-570,0,0.00,0
,20171116,144290,144290,,,,144350,144350,60,60,0,0.00,0
,20171117,144350,144350,,,,143910,143910,-440,-440,0,0.00,0
,20171120,143910,143910,,,,143730,143730,-180,-180,0,0.00,0
,20171121,143730,143730,,,,143730,143730,0,0,0,0.00,0
,20171122,143730,143730,,,,143770,143770,40,40,0,0.00,0
,20171123,143770,143770,,,,142640,142640,-1130,-1130,0,0.00,0
,20171124,142640,142640,,,,143710,143710,1070,1070,0,0.00,0
,20171127,143710,143710,,,,144470,144470,760,760,0,0.00,0
,20171128,144470,144470,,,,144390,144390,-80,-80,0,0.00,0
,20171129,144390,144390,,,,144250,144250,-140,-140,0,0.00,0
,20171130,144250,144250,,,,143860,143860,-390,-390,0,0.00,0
,20171201,143860,143860,,,,142820,142820,-1040,-1040,0,0.00,0
,20171204,142820,142820,,,,143000,143000,180,180,0,0.00,0
,20171205,143000,143000,,,,142810,142810,-190,-190,0,0.00,0
,20171206,142810,142810,,,,141800,141800,-1010,-1010,0,0.00,0
,20171207,141800,141800,,,,141730,141730,-70,-70,0,0.00,0
,20171208,141730,141730,,,,141240,141240,-490,-490,0,0.00,0
,20171211,141240,141240,138620,138620,138620,138620,138620,-2620,-2620,28,388.14,28
,20171212,138620,138620,138840,140790,138310,140280,140080,1660,1460,54,756.47,2
,20171213,140280,140080,,,,138940,138940,-1140,-1140,0,0.00,2
,20171214,138940,138940,,,,138940,138940,0,0,0,0.00,2
,20171215,138940,138940,,,,139450,139450,510,510,0,0.00,2
,20171218,139450,139450,,,,141280,141280,1830,1830,0,0.00,2
,20171219,141280,141280,,,,142570,142570,1290,1290,0,0.00,2
,20171220,142570,142570,,,,142690,142690,120,120,0,0.00,2
,20171221,142690,142690,,,,143150,143150,460,460,0,0.00,2
,20171222,143150,143150,,,,142590,142590,-560,-560,0,0.00,2
,20171225,142590,142590,,,,143090,143090,500,500,0,0.00,2
,20171226,143090,143090,142720,142720,142040,142040,142380,-1050,-710,8,113.90,2
,20171227,142040,142380,,,,143440,143440,1060,1060,0,0.00,2
,20171228,143440,143440,,,,143740,143740,300,300,0,0.00,2
,20171229,143740,143740,,,,145050,145050,1310,1310,0,0.00,2
sn1807,20170718,145470,145470,,,,146600,146600,1130,1130,0,0.00,0
,20170719,146600,146600,,,,147790,147790,1190,1190,0,0.00,0
,20170720,147790,147790,,,,147830,147830,40,40,0,0.00,0
,20170721,147830,147830,,,,147250,147250,-580,-580,0,0.00,0
,20170724,147250,147250,,,,146870,146870,-380,-380,0,0.00,0
,20170725,146870,146870,,,,147330,147330,460,460,0,0.00,0
,20170726,147330,147330,,,,149290,149290,1960,1960,0,0.00,0
,20170727,149290,149290,150600,150600,150600,150600,150600,1310,1310,2,30.12,2
,20170728,150600,150600,,,,150600,150600,0,0,0,0.00,2
,20170731,150600,150600,,,,150300,150300,-300,-300,0,0.00,2
,20170801,150300,150300,151460,151460,150720,150720,151090,420,790,4,60.44,0
,20170802,150720,151090,,,,150010,150010,-1080,-1080,0,0.00,0
,20170803,150010,150010,,,,150810,150810,800,800,0,0.00,0
,20170804,150810,150810,,,,151330,151330,520,520,0,0.00,0
,20170807,151330,151330,,,,151240,151240,-90,-90,0,0.00,0
,20170808,151240,151240,,,,151210,151210,-30,-30,0,0.00,0
,20170809,151210,151210,,,,150630,150630,-580,-580,0,0.00,0
,20170810,150630,150630,,,,151350,151350,720,720,0,0.00,0
,20170811,151350,151350,,,,150180,150180,-1170,-1170,0,0.00,0
,20170814,150180,150180,,,,149470,149470,-710,-710,0,0.00,0
,20170815,149470,149470,,,,148670,148670,-800,-800,0,0.00,0
,20170816,148670,148670,,,,148390,148390,-280,-280,0,0.00,0
,20170817,148390,148390,,,,149170,149170,780,780,0,0.00,0
,20170818,149170,149170,,,,148880,148880,-290,-290,0,0.00,0
,20170821,148880,148880,,,,148590,148590,-290,-290,0,0.00,0
,20170822,148590,148590,,,,148560,148560,-30,-30,0,0.00,0
,20170823,148560,148560,,,,147050,147050,-1510,-1510,0,0.00,0
,20170824,147050,147050,,,,147230,147230,180,180,0,0.00,0
,20170825,147230,147230,,,,148200,148200,970,970,0,0.00,0
,20170828,148200,148200,,,,147760,147760,-440,-440,0,0.00,0
,20170829,147760,147760,,,,149380,149380,1620,1620,0,0.00,0
,20170830,149380,149380,149090,149090,146620,146620,147850,-2760,-1530,4,59.14,2
,20170831,146620,147850,147490,147490,147490,147490,147490,-360,-360,2,29.50,0
,20170901,147490,147490,,,,147520,147520,30,30,0,0.00,0
,20170904,147520,147520,,,,147910,147910,390,390,0,0.00,0
,20170905,147910,147910,,,,146630,146630,-1280,-1280,0,0.00,0
,20170906,146630,146630,,,,145980,145980,-650,-650,0,0.00,0
,20170907,145980,145980,,,,145140,145140,-840,-840,0,0.00,0
,20170908,145140,145140,,,,144560,144560,-580,-580,0,0.00,0
,20170911,144560,144560,,,,144060,144060,-500,-500,0,0.00,0
,20170912,144060,144060,,,,144920,144920,860,860,0,0.00,0
,20170913,144920,144920,,,,145110,145110,190,190,0,0.00,0
,20170914,145110,145110,,,,145060,145060,-50,-50,0,0.00,0
,20170915,145060,145060,,,,143880,143880,-1180,-1180,0,0.00,0
,20170918,143880,143880,,,,143610,143610,-270,-270,0,0.00,0
,20170919,143610,143610,,,,144570,144570,960,960,0,0.00,0
,20170920,144570,144570,,,,145550,145550,980,980,0,0.00,0
,20170921,145550,145550,,,,145140,145140,-410,-410,0,0.00,0
,20170922,145140,145140,,,,144140,144140,-1000,-1000,0,0.00,0
,20170925,144140,144140,,,,144880,144880,740,740,0,0.00,0
,20170926,144880,144880,,,,146330,146330,1450,1450,0,0.00,0
,20170927,146330,146330,,,,146820,146820,490,490,0,0.00,0
,20170928,146820,146820,,,,146150,146150,-670,-670,0,0.00,0
,20170929,146150,146150,,,,146340,146340,190,190,0,0.00,0
,20171009,146340,146340,,,,147730,147730,1390,1390,0,0.00,0
,20171010,147730,147730,,,,147260,147260,-470,-470,0,0.00,0
,20171011,147260,147260,,,,146510,146510,-750,-750,0,0.00,0
,20171012,146510,146510,,,,145500,145500,-1010,-1010,0,0.00,0
,20171013,145500,145500,,,,146390,146390,890,890,0,0.00,0
,20171016,146390,146390,,,,147450,147450,1060,1060,0,0.00,0
,20171017,147450,147450,,,,147330,147330,-120,-120,0,0.00,0
,20171018,147330,147330,,,,146130,146130,-1200,-1200,0,0.00,0
,20171019,146130,146130,,,,144780,144780,-1350,-1350,0,0.00,0
,20171020,144780,144780,,,,144440,144440,-340,-340,0,0.00,0
,20171023,144440,144440,,,,144060,144060,-380,-380,0,0.00,0
,20171024,144060,144060,,,,144900,144900,840,840,0,0.00,0
,20171025,144900,144900,,,,144900,144900,0,0,0,0.00,0
,20171026,144900,144900,,,,145210,145210,310,310,0,0.00,0
,20171027,145210,145210,,,,144580,144580,-630,-630,0,0.00,0
,20171030,144580,144580,,,,144080,144080,-500,-500,0,0.00,0
,20171031,144080,144080,,,,143510,143510,-570,-570,0,0.00,0
,20171101,143510,143510,,,,142850,142850,-660,-660,0,0.00,0
,20171102,142850,142850,,,,144390,144390,1540,1540,0,0.00,0
,20171103,144390,144390,,,,144200,144200,-190,-190,0,0.00,0
,20171106,144200,144200,,,,144130,144130,-70,-70,0,0.00,0
,20171107,144130,144130,,,,142880,142880,-1250,-1250,0,0.00,0
,20171108,142880,142880,,,,142070,142070,-810,-810,0,0.00,0
,20171109,142070,142070,,,,141770,141770,-300,-300,0,0.00,0
,20171110,141770,141770,,,,143070,143070,1300,1300,0,0.00,0
,20171113,143070,143070,,,,144010,144010,940,940,0,0.00,0
,20171114,144010,144010,,,,144070,144070,60,60,0,0.00,0
,20171115,144070,144070,,,,143510,143510,-560,-560,0,0.00,0
,20171116,143510,143510,,,,143570,143570,60,60,0,0.00,0
,20171117,143570,143570,,,,143140,143140,-430,-430,0,0.00,0
,20171120,143140,143140,,,,142960,142960,-180,-180,0,0.00,0
,20171121,142960,142960,,,,143300,143300,340,340,0,0.00,0
,20171122,143300,143300,,,,143340,143340,40,40,0,0.00,0
,20171123,143340,143340,,,,142220,142220,-1120,-1120,0,0.00,0
,20171124,142220,142220,,,,143290,143290,1070,1070,0,0.00,0
,20171127,143290,143290,,,,144050,144050,760,760,0,0.00,0
,20171128,144050,144050,,,,143970,143970,-80,-80,0,0.00,0
,20171129,143970,143970,,,,143830,143830,-140,-140,0,0.00,0
,20171130,143830,143830,,,,143440,143440,-390,-390,0,0.00,0
,20171201,143440,143440,,,,142410,142410,-1030,-1030,0,0.00,0
,20171204,142410,142410,,,,142590,142590,180,180,0,0.00,0
,20171205,142590,142590,,,,142410,142410,-180,-180,0,0.00,0
,20171206,142410,142410,,,,141400,141400,-1010,-1010,0,0.00,0
,20171207,141400,141400,,,,141330,141330,-70,-70,0,0.00,0
,20171208,141330,141330,,,,140840,140840,-490,-490,0,0.00,0
,20171211,140840,140840,,,,138220,138220,-2620,-2620,0,0.00,0
,20171212,138220,138220,,,,139680,139680,1460,1460,0,0.00,0
,20171213,139680,139680,,,,138540,138540,-1140,-1140,0,0.00,0
,20171214,138540,138540,,,,137140,137140,-1400,-1400,0,0.00,0
,20171215,137140,137140,,,,137650,137650,510,510,0,0.00,0
,20171218,137650,137650,,,,139460,139460,1810,1810,0,0.00,0
,20171219,139460,139460,,,,140730,140730,1270,1270,0,0.00,0
,20171220,140730,140730,,,,140840,140840,110,110,0,0.00,0
,20171221,140840,140840,,,,141300,141300,460,460,0,0.00,0
,20171222,141300,141300,,,,140750,140750,-550,-550,0,0.00,0
,20171225,140750,140750,,,,141250,141250,500,500,0,0.00,0
,20171226,141250,141250,,,,140540,140540,-710,-710,0,0.00,0
,20171227,140540,140540,,,,141580,141580,1040,1040,0,0.00,0
,20171228,141580,141580,,,,141870,141870,290,290,0,0.00,0
,20171229,141870,141870,,,,143160,143160,1290,1290,0,0.00,0
sn1808,20170816,148670,148670,,,,148390,148390,-280,-280,0,0.00,0
,20170817,148390,148390,,,,149170,149170,780,780,0,0.00,0
,20170818,149170,149170,,,,148880,148880,-290,-290,0,0.00,0
,20170821,148880,148880,,,,148590,148590,-290,-290,0,0.00,0
,20170822,148590,148590,,,,148560,148560,-30,-30,0,0.00,0
,20170823,148560,148560,,,,147050,147050,-1510,-1510,0,0.00,0
,20170824,147050,147050,,,,147230,147230,180,180,0,0.00,0
,20170825,147230,147230,,,,148200,148200,970,970,0,0.00,0
,20170828,148200,148200,,,,147760,147760,-440,-440,0,0.00,0
,20170829,147760,147760,,,,149380,149380,1620,1620,0,0.00,0
,20170830,149380,149380,,,,147850,147850,-1530,-1530,0,0.00,0
,20170831,147850,147850,,,,147490,147490,-360,-360,0,0.00,0
,20170901,147490,147490,,,,147520,147520,30,30,0,0.00,0
,20170904,147520,147520,,,,147910,147910,390,390,0,0.00,0
,20170905,147910,147910,,,,146630,146630,-1280,-1280,0,0.00,0
,20170906,146630,146630,,,,145980,145980,-650,-650,0,0.00,0
,20170907,145980,145980,,,,145140,145140,-840,-840,0,0.00,0
,20170908,145140,145140,,,,144560,144560,-580,-580,0,0.00,0
,20170911,144560,144560,,,,144060,144060,-500,-500,0,0.00,0
,20170912,144060,144060,,,,144920,144920,860,860,0,0.00,0
,20170913,144920,144920,,,,145110,145110,190,190,0,0.00,0
,20170914,145110,145110,,,,145060,145060,-50,-50,0,0.00,0
,20170915,145060,145060,,,,143880,143880,-1180,-1180,0,0.00,0
,20170918,143880,143880,,,,143610,143610,-270,-270,0,0.00,0
,20170919,143610,143610,,,,144570,144570,960,960,0,0.00,0
,20170920,144570,144570,,,,145550,145550,980,980,0,0.00,0
,20170921,145550,145550,,,,145140,145140,-410,-410,0,0.00,0
,20170922,145140,145140,,,,144140,144140,-1000,-1000,0,0.00,0
,20170925,144140,144140,,,,144880,144880,740,740,0,0.00,0
,20170926,144880,144880,,,,146330,146330,1450,1450,0,0.00,0
,20170927,146330,146330,,,,146820,146820,490,490,0,0.00,0
,20170928,146820,146820,,,,146150,146150,-670,-670,0,0.00,0
,20170929,146150,146150,,,,146340,146340,190,190,0,0.00,0
,20171009,146340,146340,,,,147730,147730,1390,1390,0,0.00,0
,20171010,147730,147730,,,,147260,147260,-470,-470,0,0.00,0
,20171011,147260,147260,,,,146510,146510,-750,-750,0,0.00,0
,20171012,146510,146510,,,,145500,145500,-1010,-1010,0,0.00,0
,20171013,145500,145500,,,,146390,146390,890,890,0,0.00,0
,20171016,146390,146390,,,,147450,147450,1060,1060,0,0.00,0
,20171017,147450,147450,,,,147330,147330,-120,-120,0,0.00,0
,20171018,147330,147330,,,,146130,146130,-1200,-1200,0,0.00,0
,20171019,146130,146130,,,,144780,144780,-1350,-1350,0,0.00,0
,20171020,144780,144780,,,,144440,144440,-340,-340,0,0.00,0
,20171023,144440,144440,,,,144060,144060,-380,-380,0,0.00,0
,20171024,144060,144060,,,,144900,144900,840,840,0,0.00,0
,20171025,144900,144900,,,,144900,144900,0,0,0,0.00,0
,20171026,144900,144900,,,,145210,145210,310,310,0,0.00,0
,20171027,145210,145210,,,,144580,144580,-630,-630,0,0.00,0
,20171030,144580,144580,,,,144080,144080,-500,-500,0,0.00,0
,20171031,144080,144080,,,,143510,143510,-570,-570,0,0.00,0
,20171101,143510,143510,,,,142850,142850,-660,-660,0,0.00,0
,20171102,142850,142850,,,,144390,144390,1540,1540,0,0.00,0
,20171103,144390,144390,,,,144200,144200,-190,-190,0,0.00,0
,20171106,144200,144200,,,,144130,144130,-70,-70,0,0.00,0
,20171107,144130,144130,,,,142880,142880,-1250,-1250,0,0.00,0
,20171108,142880,142880,,,,142070,142070,-810,-810,0,0.00,0
,20171109,142070,142070,,,,141770,141770,-300,-300,0,0.00,0
,20171110,141770,141770,,,,143070,143070,1300,1300,0,0.00,0
,20171113,143070,143070,,,,144010,144010,940,940,0,0.00,0
,20171114,144010,144010,,,,144070,144070,60,60,0,0.00,0
,20171115,144070,144070,,,,143510,143510,-560,-560,0,0.00,0
,20171116,143510,143510,,,,143570,143570,60,60,0,0.00,0
,20171117,143570,143570,,,,143140,143140,-430,-430,0,0.00,0
,20171120,143140,143140,,,,142960,142960,-180,-180,0,0.00,0
,20171121,142960,142960,,,,143300,143300,340,340,0,0.00,0
,20171122,143300,143300,,,,143340,143340,40,40,0,0.00,0
,20171123,143340,143340,,,,142220,142220,-1120,-1120,0,0.00,0
,20171124,142220,142220,,,,143290,143290,1070,1070,0,0.00,0
,20171127,143290,143290,142450,145480,142450,145480,143960,2190,670,4,57.59,0
,20171128,145480,143960,,,,143880,143880,-80,-80,0,0.00,0
,20171129,143880,143880,,,,143740,143740,-140,-140,0,0.00,0
,20171130,143740,143740,,,,143350,143350,-390,-390,0,0.00,0
,20171201,143350,143350,,,,142320,142320,-1030,-1030,0,0.00,0
,20171204,142320,142320,,,,142500,142500,180,180,0,0.00,0
,20171205,142500,142500,,,,142320,142320,-180,-180,0,0.00,0
,20171206,142320,142320,,,,141310,141310,-1010,-1010,0,0.00,0
,20171207,141310,141310,,,,141240,141240,-70,-70,0,0.00,0
,20171208,141240,141240,,,,140750,140750,-490,-490,0,0.00,0
,20171211,140750,140750,,,,138130,138130,-2620,-2620,0,0.00,0
,20171212,138130,138130,,,,139590,139590,1460,1460,0,0.00,0
,20171213,139590,139590,,,,138450,138450,-1140,-1140,0,0.00,0
,20171214,138450,138450,,,,137050,137050,-1400,-1400,0,0.00,0
,20171215,137050,137050,,,,137560,137560,510,510,0,0.00,0
,20171218,137560,137560,,,,139370,139370,1810,1810,0,0.00,0
,20171219,139370,139370,,,,140640,140640,1270,1270,0,0.00,0
,20171220,140640,140640,,,,140750,140750,110,110,0,0.00,0
,20171221,140750,140750,,,,141210,141210,460,460,0,0.00,0
,20171222,141210,141210,,,,140660,140660,-550,-550,0,0.00,0
,20171225,140660,140660,140210,140210,140210,140210,140210,-450,-450,14,196.29,14
,20171226,140210,140210,142600,143830,142600,143120,142980,2910,2770,14,200.18,10
,20171227,143120,142980,143400,144260,143260,143850,143730,870,750,18,258.72,8
,20171228,143850,143730,143600,143600,143600,143600,143600,-130,-130,4,57.44,4
,20171229,143600,143600,,,,144910,144910,1310,1310,0,0.00,4
sn1809,20170918,143880,143880,145320,146150,145320,146150,145730,2270,1850,4,58.29,4
,20170919,146150,145730,146300,146300,146300,146300,146300,570,570,2,29.26,6
,20170920,146300,146300,147550,147580,147550,147580,147560,1280,1260,4,59.03,6
,20170921,147580,147560,,,,147560,147560,0,0,0,0.00,6
,20170922,147560,147560,,,,147560,147560,0,0,0,0.00,6
,20170925,147560,147560,145580,147390,145580,147390,146480,-170,-1080,4,58.59,10
,20170926,147390,146480,,,,146480,146480,0,0,0,0.00,10
,20170927,146480,146480,149780,149780,148320,148330,148710,1850,2230,34,505.62,34
,20170928,148330,148710,148290,148380,147660,147660,148110,-1050,-600,6,88.87,34
,20170929,147660,148110,148110,148110,148110,148110,148110,0,0,2,29.62,36
,20171009,148110,148110,,,,149520,149520,1410,1410,0,0.00,36
,20171010,149520,149520,150900,150900,148280,148710,149700,-810,180,26,389.23,42
,20171011,148710,149700,148800,148800,147960,147960,148210,-1740,-1490,8,118.57,50
,20171012,147960,148210,147650,148580,146890,148550,147500,340,-710,38,560.51,46
,20171013,148550,147500,149030,149030,148360,148680,148610,1180,1110,20,297.23,36
,20171016,148680,148610,149000,149110,148600,148880,148890,270,280,8,119.12,34
,20171017,148880,148890,149600,149710,149600,149710,149630,820,740,6,89.78,30
,20171018,149710,149630,148050,148170,147920,148170,148040,-1460,-1590,6,88.83,32
,20171019,148170,148040,147730,147730,147730,147730,147730,-310,-310,2,29.55,32
,20171020,147730,147730,146070,146140,146070,146140,146090,-1590,-1640,6,87.66,38
,20171023,146140,146090,145820,146110,145820,146090,146040,0,-50,10,146.04,38
,20171024,146090,146040,,,,146040,146040,0,0,0,0.00,38
,20171025,146040,146040,147090,147130,147090,147130,147110,1090,1070,4,58.84,36
,20171026,147130,147110,147280,147280,147280,147280,147280,170,170,4,58.91,36
,20171027,147280,147280,,,,147280,147280,0,0,0,0.00,36
,20171030,147280,147280,,,,147280,147280,0,0,0,0.00,36
,20171031,147280,147280,145000,145000,145000,145000,145000,-2280,-2280,2,29.00,34
,20171101,145000,145000,145310,146690,145310,146580,146080,1580,1080,8,116.87,36
,20171102,146580,146080,146770,146770,146040,146050,146280,-30,200,6,87.77,38
,20171103,146050,146280,146130,146160,146130,146160,146140,-120,-140,4,58.46,40
,20171106,146160,146140,145650,145650,145650,145650,145650,-490,-490,2,29.13,40
,20171107,145650,145650,,,,145650,145650,0,0,0,0.00,40
,20171108,145650,145650,144450,144460,143950,143980,144200,-1670,-1450,10,144.21,44
,20171109,143980,144200,143750,143750,143720,143720,143730,-480,-470,4,57.49,48
,20171110,143720,143730,144400,145650,144400,145630,144980,1900,1250,18,260.98,56
,20171113,145630,144980,144960,145930,144960,145930,145470,950,490,8,116.38,58
,20171114,145930,145470,146020,146020,144640,145830,145490,360,20,6,87.30,60
,20171115,145830,145490,145320,145320,144500,145280,144940,-210,-550,18,260.90,64
,20171116,145280,144940,144610,144610,144610,144610,144610,-330,-330,2,28.92,64
,20171117,144610,144610,145650,145650,144980,144980,145090,370,480,12,174.11,60
,20171120,144980,145090,,,,145090,145090,0,0,0,0.00,60
,20171121,145090,145090,145470,145470,145410,145410,145440,320,350,4,58.18,64
,20171122,145410,145440,,,,145440,145440,0,0,0,0.00,64
,20171123,145440,145440,145080,145340,144000,144190,144720,-1250,-720,18,260.51,60
,20171124,144190,144720,144470,146180,144420,146100,144960,1380,240,14,202.96,60
,20171127,146100,144960,145820,145820,145820,145820,145820,860,860,2,29.16,58
,20171128,145820,145820,145790,145970,145790,145970,145880,150,60,4,58.35,58
,20171129,145970,145880,146130,146200,146130,146200,146170,320,290,6,87.70,64
,20171130,146200,146170,145830,146190,145350,145400,145600,-770,-570,26,378.56,72
,20171201,145400,145600,145760,145830,143870,144770,144880,-830,-720,36,521.60,84
,20171204,144770,144880,144870,145390,144850,144850,145010,-30,130,22,319.04,96
,20171205,144850,145010,145410,145410,144700,144700,145100,-310,90,20,290.20,96
,20171206,144700,145100,144390,145100,144070,144820,144670,-280,-430,20,289.35,90
,20171207,144820,144670,145090,145090,143790,144020,144450,-650,-220,34,491.16,110
,20171208,144020,144450,144270,144270,143250,143250,143670,-1200,-780,34,488.49,122
,20171211,143250,143670,143190,144090,135500,142860,142840,-810,-830,82,"1,171.31",112
,20171212,142860,142840,140400,141350,139970,141350,140430,-1490,-2410,18,252.78,120
,20171213,141350,140430,141630,141630,138900,138900,139880,-1530,-550,20,279.77,124
,20171214,138900,139880,138390,139670,137950,138600,138730,-1280,-1150,14,194.23,130
,20171215,138600,138730,138700,138700,138700,138700,138700,-30,-30,4,55.48,128
,20171218,138700,138700,140730,141250,140480,141250,140670,2550,1970,22,309.48,128
,20171219,141250,140670,141490,142520,141490,141840,142000,1170,1330,62,880.44,140
,20171220,141840,142000,141620,142400,141620,141880,142050,-120,50,40,568.21,130
,20171221,141880,142050,142740,143360,142300,142500,142650,450,600,26,370.91,138
,20171222,142500,142650,142010,142130,141760,142130,141960,-520,-690,6,85.18,138
,20171225,142130,141960,142700,143380,142140,142250,142440,290,480,38,541.30,140
,20171226,142250,142440,142700,143640,142700,143540,143190,1100,750,8,114.55,142
,20171227,143540,143190,144210,144280,144200,144200,144220,1010,1030,8,115.38,142
,20171228,144200,144220,144240,144500,144240,144500,144360,280,140,6,86.62,142
,20171229,144500,144360,145620,146610,145410,145810,145890,1450,1530,28,408.50,150
sn1810,20171017,148890,148890,,,,149630,149630,740,740,0,0.00,0
,20171018,149630,149630,,,,148040,148040,-1590,-1590,0,0.00,0
,20171019,148040,148040,,,,147730,147730,-310,-310,0,0.00,0
,20171020,147730,147730,,,,146090,146090,-1640,-1640,0,0.00,0
,20171023,146090,146090,,,,146040,146040,-50,-50,0,0.00,0
,20171024,146040,146040,,,,146890,146890,850,850,0,0.00,0
,20171025,146890,146890,,,,147960,147960,1070,1070,0,0.00,0
,20171026,147960,147960,,,,148130,148130,170,170,0,0.00,0
,20171027,148130,148130,,,,147490,147490,-640,-640,0,0.00,0
,20171030,147490,147490,,,,146980,146980,-510,-510,0,0.00,0
,20171031,146980,146980,,,,144700,144700,-2280,-2280,0,0.00,0
,20171101,144700,144700,,,,145780,145780,1080,1080,0,0.00,0
,20171102,145780,145780,,,,145980,145980,200,200,0,0.00,0
,20171103,145980,145980,,,,145840,145840,-140,-140,0,0.00,0
,20171106,145840,145840,,,,145350,145350,-490,-490,0,0.00,0
,20171107,145350,145350,,,,145350,145350,0,0,0,0.00,0
,20171108,145350,145350,,,,145350,145350,0,0,0,0.00,0
,20171109,145350,145350,,,,145350,145350,0,0,0,0.00,0
,20171110,145350,145350,,,,145350,145350,0,0,0,0.00,0
,20171113,145350,145350,,,,145350,145350,0,0,0,0.00,0
,20171114,145350,145350,,,,145350,145350,0,0,0,0.00,0
,20171115,145350,145350,,,,145350,145350,0,0,0,0.00,0
,20171116,145350,145350,,,,145350,145350,0,0,0,0.00,0
,20171117,145350,145350,,,,145830,145830,480,480,0,0.00,0
,20171120,145830,145830,,,,145650,145650,-180,-180,0,0.00,0
,20171121,145650,145650,,,,146000,146000,350,350,0,0.00,0
,20171122,146000,146000,,,,146040,146040,40,40,0,0.00,0
,20171123,146040,146040,,,,145320,145320,-720,-720,0,0.00,0
,20171124,145320,145320,,,,145560,145560,240,240,0,0.00,0
,20171127,145560,145560,,,,146420,146420,860,860,0,0.00,0
,20171128,146420,146420,,,,146480,146480,60,60,0,0.00,0
,20171129,146480,146480,,,,146770,146770,290,290,0,0.00,0
,20171130,146770,146770,,,,146190,146190,-580,-580,0,0.00,0
,20171201,146190,146190,,,,145470,145470,-720,-720,0,0.00,0
,20171204,145470,145470,,,,145600,145600,130,130,0,0.00,0
,20171205,145600,145600,,,,145690,145690,90,90,0,0.00,0
,20171206,145690,145690,,,,145260,145260,-430,-430,0,0.00,0
,20171207,145260,145260,,,,145040,145040,-220,-220,0,0.00,0
,20171208,145040,145040,,,,144250,144250,-790,-790,0,0.00,0
,20171211,144250,144250,,,,143410,143410,-840,-840,0,0.00,0
,20171212,143410,143410,,,,140990,140990,-2420,-2420,0,0.00,0
,20171213,140990,140990,,,,140440,140440,-550,-550,0,0.00,0
,20171214,140440,140440,,,,139290,139290,-1150,-1150,0,0.00,0
,20171215,139290,139290,,,,139250,139250,-40,-40,0,0.00,0
,20171218,139250,139250,,,,141230,141230,1980,1980,0,0.00,0
,20171219,141230,141230,,,,142570,142570,1340,1340,0,0.00,0
,20171220,142570,142570,,,,142620,142620,50,50,0,0.00,0
,20171221,142620,142620,,,,143220,143220,600,600,0,0.00,0
,20171222,143220,143220,,,,142530,142530,-690,-690,0,0.00,0
,20171225,142530,142530,,,,143010,143010,480,480,0,0.00,0
,20171226,143010,143010,,,,143760,143760,750,750,0,0.00,0
,20171227,143760,143760,,,,144800,144800,1040,1040,0,0.00,0
,20171228,144800,144800,,,,144940,144940,140,140,0,0.00,0
,20171229,144940,144940,,,,146480,146480,1540,1540,0,0.00,0
sn1811,20171116,145350,145350,,,,145010,145010,-340,-340,0,0.00,0
,20171117,145010,145010,,,,145010,145010,0,0,0,0.00,0
,20171120,145010,145010,,,,144830,144830,-180,-180,0,0.00,0
,20171121,144830,144830,,,,145170,145170,340,340,0,0.00,0
,20171122,145170,145170,,,,145210,145210,40,40,0,0.00,0
,20171123,145210,145210,,,,144490,144490,-720,-720,0,0.00,0
,20171124,144490,144490,,,,144730,144730,240,240,0,0.00,0
,20171127,144730,144730,,,,145580,145580,850,850,0,0.00,0
,20171128,145580,145580,,,,145630,145630,50,50,0,0.00,0
,20171129,145630,145630,,,,145920,145920,290,290,0,0.00,0
,20171130,145920,145920,,,,145350,145350,-570,-570,0,0.00,0
,20171201,145350,145350,,,,144640,144640,-710,-710,0,0.00,0
,20171204,144640,144640,,,,144770,144770,130,130,0,0.00,0
,20171205,144770,144770,,,,144860,144860,90,90,0,0.00,0
,20171206,144860,144860,,,,144430,144430,-430,-430,0,0.00,0
,20171207,144430,144430,,,,144210,144210,-220,-220,0,0.00,0
,20171208,144210,144210,,,,143430,143430,-780,-780,0,0.00,0
,20171211,143430,143430,,,,142600,142600,-830,-830,0,0.00,0
,20171212,142600,142600,,,,140190,140190,-2410,-2410,0,0.00,0
,20171213,140190,140190,,,,139640,139640,-550,-550,0,0.00,0
,20171214,139640,139640,,,,139640,139640,0,0,0,0.00,0
,20171215,139640,139640,,,,139600,139600,-40,-40,0,0.00,0
,20171218,139600,139600,,,,141580,141580,1980,1980,0,0.00,0
,20171219,141580,141580,,,,142920,142920,1340,1340,0,0.00,0
,20171220,142920,142920,,,,142970,142970,50,50,0,0.00,0
,20171221,142970,142970,,,,143580,143580,610,610,0,0.00,0
,20171222,143580,143580,,,,142890,142890,-690,-690,0,0.00,0
,20171225,142890,142890,,,,143380,143380,490,490,0,0.00,0
,20171226,143380,143380,,,,144130,144130,750,750,0,0.00,0
,20171227,144130,144130,,,,145170,145170,1040,1040,0,0.00,0
,20171228,145170,145170,,,,145310,145310,140,140,0,0.00,0
,20171229,145310,145310,,,,146850,146850,1540,1540,0,0.00,0
sn1812,20171218,139600,139600,,,,141580,141580,1980,1980,0,0.00,0
,20171219,141580,141580,,,,142920,142920,1340,1340,0,0.00,0
,20171220,142920,142920,,,,142970,142970,50,50,0,0.00,0
,20171221,142970,142970,,,,143580,143580,610,610,0,0.00,0
,20171222,143580,143580,,,,142890,142890,-690,-690,0,0.00,0
,20171225,142890,142890,,,,143380,143380,490,490,0,0.00,0
,20171226,143380,143380,,,,144130,144130,750,750,0,0.00,0
,20171227,144130,144130,,,,145170,145170,1040,1040,0,0.00,0
,20171228,145170,145170,,,,145310,145310,140,140,0,0.00,0
,20171229,145310,145310,,,,146850,146850,1540,1540,0,0.00,0
wr1701,20170103,2353,2353,,,,2353,2353,0,0,0,0.00,0
,20170104,2353,2353,,,,2353,2353,0,0,0,0.00,0
,20170105,2353,2353,,,,2353,2353,0,0,0,0.00,0
,20170106,2353,2353,,,,2353,2353,0,0,0,0.00,0
,20170109,2353,2353,,,,2353,2353,0,0,0,0.00,0
,20170110,2353,2353,,,,2353,2353,0,0,0,0.00,0
,20170111,2353,2353,,,,2353,2353,0,0,0,0.00,0
,20170112,2353,2353,,,,2353,2353,0,0,0,0.00,0
,20170113,2353,2353,,,,2353,2353,0,0,0,0.00,0
,20170116,2353,2353,,,,2353,2353,0,0,0,0.00,0
wr1702,20170103,2305,2305,,,,2305,2305,0,0,0,0.00,0
,20170104,2305,2305,,,,2305,2305,0,0,0,0.00,0
,20170105,2305,2305,,,,2305,2305,0,0,0,0.00,0
,20170106,2305,2305,,,,2305,2305,0,0,0,0.00,0
,20170109,2305,2305,,,,2305,2305,0,0,0,0.00,0
,20170110,2305,2305,,,,2305,2305,0,0,0,0.00,0
,20170111,2305,2305,,,,2305,2305,0,0,0,0.00,0
,20170112,2305,2305,,,,2305,2305,0,0,0,0.00,0
,20170113,2305,2305,,,,2305,2305,0,0,0,0.00,0
,20170116,2305,2305,,,,2305,2305,0,0,0,0.00,0
,20170117,2305,2305,,,,2305,2305,0,0,0,0.00,0
,20170118,2305,2305,,,,2305,2305,0,0,0,0.00,0
,20170119,2305,2305,,,,2305,2305,0,0,0,0.00,0
,20170120,2305,2305,,,,2305,2305,0,0,0,0.00,0
,20170123,2305,2305,,,,2305,2305,0,0,0,0.00,0
,20170124,2305,2305,,,,2305,2305,0,0,0,0.00,0
,20170125,2305,2305,,,,2305,2305,0,0,0,0.00,0
,20170126,2305,2305,,,,2305,2305,0,0,0,0.00,0
,20170203,2305,2305,,,,2305,2305,0,0,0,0.00,0
,20170206,2305,2305,,,,2305,2305,0,0,0,0.00,0
,20170207,2305,2305,,,,2305,2305,0,0,0,0.00,0
,20170208,2305,2305,,,,2305,2305,0,0,0,0.00,0
,20170209,2305,2305,,,,2305,2305,0,0,0,0.00,0
,20170210,2305,2305,,,,2305,2305,0,0,0,0.00,0
,20170213,2305,2305,,,,2305,2305,0,0,0,0.00,0
,20170214,2305,2305,,,,2305,2305,0,0,0,0.00,0
,20170215,2305,2305,,,,2305,2305,0,0,0,0.00,0
wr1703,20170103,2331,2331,,,,2331,2331,0,0,0,0.00,0
,20170104,2331,2331,,,,2331,2331,0,0,0,0.00,0
,20170105,2331,2331,,,,2331,2331,0,0,0,0.00,0
,20170106,2331,2331,,,,2331,2331,0,0,0,0.00,0
,20170109,2331,2331,,,,2331,2331,0,0,0,0.00,0
,20170110,2331,2331,,,,2331,2331,0,0,0,0.00,0
,20170111,2331,2331,,,,2331,2331,0,0,0,0.00,0
,20170112,2331,2331,,,,2331,2331,0,0,0,0.00,0
,20170113,2331,2331,,,,2331,2331,0,0,0,0.00,0
,20170116,2331,2331,,,,2331,2331,0,0,0,0.00,0
,20170117,2331,2331,,,,2331,2331,0,0,0,0.00,0
,20170118,2331,2331,,,,2331,2331,0,0,0,0.00,0
,20170119,2331,2331,,,,2331,2331,0,0,0,0.00,0
,20170120,2331,2331,,,,2331,2331,0,0,0,0.00,0
,20170123,2331,2331,,,,2331,2331,0,0,0,0.00,0
,20170124,2331,2331,,,,2331,2331,0,0,0,0.00,0
,20170125,2331,2331,,,,2331,2331,0,0,0,0.00,0
,20170126,2331,2331,,,,2331,2331,0,0,0,0.00,0
,20170203,2331,2331,,,,2331,2331,0,0,0,0.00,0
,20170206,2331,2331,,,,2331,2331,0,0,0,0.00,0
,20170207,2331,2331,,,,2331,2331,0,0,0,0.00,0
,20170208,2331,2331,,,,2331,2331,0,0,0,0.00,0
,20170209,2331,2331,,,,2331,2331,0,0,0,0.00,0
,20170210,2331,2331,,,,2331,2331,0,0,0,0.00,0
,20170213,2331,2331,,,,2331,2331,0,0,0,0.00,0
,20170214,2331,2331,,,,2331,2331,0,0,0,0.00,0
,20170215,2331,2331,,,,2331,2331,0,0,0,0.00,0
,20170216,2331,2331,,,,2331,2331,0,0,0,0.00,0
,20170217,2331,2331,,,,2331,2331,0,0,0,0.00,0
,20170220,2331,2331,,,,2331,2331,0,0,0,0.00,0
,20170221,2331,2331,,,,2331,2331,0,0,0,0.00,0
,20170222,2331,2331,,,,2331,2331,0,0,0,0.00,0
,20170223,2331,2331,,,,2331,2331,0,0,0,0.00,0
,20170224,2331,2331,,,,2331,2331,0,0,0,0.00,0
,20170227,2331,2331,,,,2331,2331,0,0,0,0.00,0
,20170228,2331,2331,,,,2331,2331,0,0,0,0.00,0
,20170301,2331,2331,,,,2331,2331,0,0,0,0.00,0
,20170302,2331,2331,,,,2331,2331,0,0,0,0.00,0
,20170303,2331,2331,,,,2331,2331,0,0,0,0.00,0
,20170306,2331,2331,,,,2331,2331,0,0,0,0.00,0
,20170307,2331,2331,,,,2331,2331,0,0,0,0.00,0
,20170308,2331,2331,,,,2331,2331,0,0,0,0.00,0
,20170309,2331,2331,,,,2331,2331,0,0,0,0.00,0
,20170310,2331,2331,,,,2331,2331,0,0,0,0.00,0
,20170313,2331,2331,,,,2331,2331,0,0,0,0.00,0
,20170314,2331,2331,,,,2331,2331,0,0,0,0.00,0
,20170315,2331,2331,,,,2331,2331,0,0,0,0.00,0
wr1704,20170103,2330,2330,,,,2330,2330,0,0,0,0.00,0
,20170104,2330,2330,,,,2330,2330,0,0,0,0.00,0
,20170105,2330,2330,,,,2330,2330,0,0,0,0.00,0
,20170106,2330,2330,,,,2330,2330,0,0,0,0.00,0
,20170109,2330,2330,,,,2330,2330,0,0,0,0.00,0
,20170110,2330,2330,,,,2330,2330,0,0,0,0.00,0
,20170111,2330,2330,,,,2330,2330,0,0,0,0.00,0
,20170112,2330,2330,,,,2330,2330,0,0,0,0.00,0
,20170113,2330,2330,,,,2330,2330,0,0,0,0.00,0
,20170116,2330,2330,,,,2330,2330,0,0,0,0.00,0
,20170117,2330,2330,,,,2330,2330,0,0,0,0.00,0
,20170118,2330,2330,,,,2330,2330,0,0,0,0.00,0
,20170119,2330,2330,,,,2330,2330,0,0,0,0.00,0
,20170120,2330,2330,,,,2330,2330,0,0,0,0.00,0
,20170123,2330,2330,,,,2330,2330,0,0,0,0.00,0
,20170124,2330,2330,,,,2330,2330,0,0,0,0.00,0
,20170125,2330,2330,,,,2330,2330,0,0,0,0.00,0
,20170126,2330,2330,,,,2330,2330,0,0,0,0.00,0
,20170203,2330,2330,,,,2330,2330,0,0,0,0.00,0
,20170206,2330,2330,,,,2330,2330,0,0,0,0.00,0
,20170207,2330,2330,,,,2330,2330,0,0,0,0.00,0
,20170208,2330,2330,,,,2330,2330,0,0,0,0.00,0
,20170209,2330,2330,,,,2330,2330,0,0,0,0.00,0
,20170210,2330,2330,,,,2330,2330,0,0,0,0.00,0
,20170213,2330,2330,,,,2330,2330,0,0,0,0.00,0
,20170214,2330,2330,,,,2330,2330,0,0,0,0.00,0
,20170215,2330,2330,,,,2330,2330,0,0,0,0.00,0
,20170216,2330,2330,,,,2330,2330,0,0,0,0.00,0
,20170217,2330,2330,,,,2330,2330,0,0,0,0.00,0
,20170220,2330,2330,,,,2330,2330,0,0,0,0.00,0
,20170221,2330,2330,,,,2330,2330,0,0,0,0.00,0
,20170222,2330,2330,,,,2330,2330,0,0,0,0.00,0
,20170223,2330,2330,,,,2330,2330,0,0,0,0.00,0
,20170224,2330,2330,,,,2330,2330,0,0,0,0.00,0
,20170227,2330,2330,,,,2330,2330,0,0,0,0.00,0
,20170228,2330,2330,,,,2330,2330,0,0,0,0.00,0
,20170301,2330,2330,,,,2330,2330,0,0,0,0.00,0
,20170302,2330,2330,,,,2330,2330,0,0,0,0.00,0
,20170303,2330,2330,,,,2330,2330,0,0,0,0.00,0
,20170306,2330,2330,,,,2330,2330,0,0,0,0.00,0
,20170307,2330,2330,,,,2330,2330,0,0,0,0.00,0
,20170308,2330,2330,,,,2330,2330,0,0,0,0.00,0
,20170309,2330,2330,,,,2330,2330,0,0,0,0.00,0
,20170310,2330,2330,,,,2330,2330,0,0,0,0.00,0
,20170313,2330,2330,,,,2330,2330,0,0,0,0.00,0
,20170314,2330,2330,,,,2330,2330,0,0,0,0.00,0
,20170315,2330,2330,,,,2330,2330,0,0,0,0.00,0
,20170316,2330,2330,,,,2330,2330,0,0,0,0.00,0
,20170317,2330,2330,,,,2330,2330,0,0,0,0.00,0
,20170320,2330,2330,,,,2330,2330,0,0,0,0.00,0
,20170321,2330,2330,,,,2330,2330,0,0,0,0.00,0
,20170322,2330,2330,,,,2330,2330,0,0,0,0.00,0
,20170323,2330,2330,,,,2330,2330,0,0,0,0.00,0
,20170324,2330,2330,,,,2330,2330,0,0,0,0.00,0
,20170327,2330,2330,,,,2330,2330,0,0,0,0.00,0
,20170328,2330,2330,,,,2330,2330,0,0,0,0.00,0
,20170329,2330,2330,,,,2330,2330,0,0,0,0.00,0
,20170330,2330,2330,,,,2330,2330,0,0,0,0.00,0
,20170331,2330,2330,,,,2330,2330,0,0,0,0.00,0
,20170405,2330,2330,,,,2330,2330,0,0,0,0.00,0
,20170406,2330,2330,,,,2330,2330,0,0,0,0.00,0
,20170407,2330,2330,,,,2330,2330,0,0,0,0.00,0
,20170410,2330,2330,,,,2330,2330,0,0,0,0.00,0
,20170411,2330,2330,,,,2330,2330,0,0,0,0.00,0
,20170412,2330,2330,,,,2330,2330,0,0,0,0.00,0
,20170413,2330,2330,,,,2330,2330,0,0,0,0.00,0
,20170414,2330,2330,,,,2330,2330,0,0,0,0.00,0
,20170417,2330,2330,,,,2330,2330,0,0,0,0.00,0
wr1705,20170103,2330,2330,,,,2330,2330,0,0,0,0.00,0
,20170104,2330,2330,,,,2330,2330,0,0,0,0.00,0
,20170105,2330,2330,,,,2330,2330,0,0,0,0.00,0
,20170106,2330,2330,,,,2330,2330,0,0,0,0.00,0
,20170109,2330,2330,,,,2330,2330,0,0,0,0.00,0
,20170110,2330,2330,,,,2330,2330,0,0,0,0.00,0
,20170111,2330,2330,,,,2330,2330,0,0,0,0.00,0
,20170112,2330,2330,,,,2330,2330,0,0,0,0.00,0
,20170113,2330,2330,,,,2330,2330,0,0,0,0.00,0
,20170116,2330,2330,,,,2330,2330,0,0,0,0.00,0
,20170117,2330,2330,,,,2330,2330,0,0,0,0.00,0
,20170118,2330,2330,,,,2330,2330,0,0,0,0.00,0
,20170119,2330,2330,,,,2330,2330,0,0,0,0.00,0
,20170120,2330,2330,,,,2330,2330,0,0,0,0.00,0
,20170123,2330,2330,,,,2330,2330,0,0,0,0.00,0
,20170124,2330,2330,,,,2330,2330,0,0,0,0.00,0
,20170125,2330,2330,,,,2330,2330,0,0,0,0.00,0
,20170126,2330,2330,,,,2330,2330,0,0,0,0.00,0
,20170203,2330,2330,,,,2330,2330,0,0,0,0.00,0
,20170206,2330,2330,,,,2330,2330,0,0,0,0.00,0
,20170207,2330,2330,,,,2330,2330,0,0,0,0.00,0
,20170208,2330,2330,,,,2330,2330,0,0,0,0.00,0
,20170209,2330,2330,,,,2330,2330,0,0,0,0.00,0
,20170210,2330,2330,,,,2330,2330,0,0,0,0.00,0
,20170213,2330,2330,,,,2330,2330,0,0,0,0.00,0
,20170214,2330,2330,,,,2330,2330,0,0,0,0.00,0
,20170215,2330,2330,,,,2330,2330,0,0,0,0.00,0
,20170216,2330,2330,,,,2330,2330,0,0,0,0.00,0
,20170217,2330,2330,,,,2330,2330,0,0,0,0.00,0
,20170220,2330,2330,,,,2330,2330,0,0,0,0.00,0
,20170221,2330,2330,,,,2330,2330,0,0,0,0.00,0
,20170222,2330,2330,,,,2330,2330,0,0,0,0.00,0
,20170223,2330,2330,,,,2330,2330,0,0,0,0.00,0
,20170224,2330,2330,,,,2330,2330,0,0,0,0.00,0
,20170227,2330,2330,,,,2330,2330,0,0,0,0.00,0
,20170228,2330,2330,,,,2330,2330,0,0,0,0.00,0
,20170301,2330,2330,,,,2330,2330,0,0,0,0.00,0
,20170302,2330,2330,,,,2330,2330,0,0,0,0.00,0
,20170303,2330,2330,,,,2330,2330,0,0,0,0.00,0
,20170306,2330,2330,,,,2330,2330,0,0,0,0.00,0
,20170307,2330,2330,,,,2330,2330,0,0,0,0.00,0
,20170308,2330,2330,,,,2330,2330,0,0,0,0.00,0
,20170309,2330,2330,,,,2330,2330,0,0,0,0.00,0
,20170310,2330,2330,,,,2330,2330,0,0,0,0.00,0
,20170313,2330,2330,,,,2330,2330,0,0,0,0.00,0
,20170314,2330,2330,,,,2330,2330,0,0,0,0.00,0
,20170315,2330,2330,,,,2330,2330,0,0,0,0.00,0
,20170316,2330,2330,,,,2330,2330,0,0,0,0.00,0
,20170317,2330,2330,,,,2330,2330,0,0,0,0.00,0
,20170320,2330,2330,,,,2330,2330,0,0,0,0.00,0
,20170321,2330,2330,2388,2388,2388,2388,2388,58,58,2,4.78,2
,20170322,2388,2388,,,,2507,2507,119,119,0,0.00,2
,20170323,2507,2507,,,,2632,2632,125,125,0,0.00,2
,20170324,2632,2632,,,,2763,2763,131,131,0,0.00,2
,20170327,2763,2763,,,,2901,2901,138,138,0,0.00,2
,20170328,2901,2901,,,,2901,2901,0,0,0,0.00,2
,20170329,2901,2901,3046,3046,3046,3046,3046,145,145,2,6.09,0
,20170330,3046,3046,,,,3046,3046,0,0,0,0.00,0
,20170331,3046,3046,,,,3046,3046,0,0,0,0.00,0
,20170405,3046,3046,,,,3046,3046,0,0,0,0.00,0
,20170406,3046,3046,,,,3046,3046,0,0,0,0.00,0
,20170407,3046,3046,,,,3046,3046,0,0,0,0.00,0
,20170410,3046,3046,,,,3046,3046,0,0,0,0.00,0
,20170411,3046,3046,,,,3046,3046,0,0,0,0.00,0
,20170412,3046,3046,,,,3046,3046,0,0,0,0.00,0
,20170413,3046,3046,,,,3046,3046,0,0,0,0.00,0
,20170414,3046,3046,,,,3046,3046,0,0,0,0.00,0
,20170417,3046,3046,,,,3046,3046,0,0,0,0.00,0
,20170418,3046,3046,,,,3046,3046,0,0,0,0.00,0
,20170419,3046,3046,,,,3046,3046,0,0,0,0.00,0
,20170420,3046,3046,,,,3046,3046,0,0,0,0.00,0
,20170421,3046,3046,,,,3046,3046,0,0,0,0.00,0
,20170424,3046,3046,,,,3046,3046,0,0,0,0.00,0
,20170425,3046,3046,,,,3046,3046,0,0,0,0.00,0
,20170426,3046,3046,,,,3046,3046,0,0,0,0.00,0
,20170427,3046,3046,,,,3046,3046,0,0,0,0.00,0
,20170428,3046,3046,,,,3046,3046,0,0,0,0.00,0
,20170502,3046,3046,,,,3046,3046,0,0,0,0.00,0
,20170503,3046,3046,,,,3046,3046,0,0,0,0.00,0
,20170504,3046,3046,,,,3046,3046,0,0,0,0.00,0
,20170505,3046,3046,,,,3046,3046,0,0,0,0.00,0
,20170508,3046,3046,,,,3046,3046,0,0,0,0.00,0
,20170509,3046,3046,,,,3046,3046,0,0,0,0.00,0
,20170510,3046,3046,,,,3046,3046,0,0,0,0.00,0
,20170511,3046,3046,,,,3046,3046,0,0,0,0.00,0
,20170512,3046,3046,,,,3046,3046,0,0,0,0.00,0
,20170515,3046,3046,,,,3046,3046,0,0,0,0.00,0
wr1706,20170103,2330,2330,,,,2330,2330,0,0,0,0.00,0
,20170104,2330,2330,,,,2330,2330,0,0,0,0.00,0
,20170105,2330,2330,,,,2330,2330,0,0,0,0.00,0
,20170106,2330,2330,,,,2330,2330,0,0,0,0.00,0
,20170109,2330,2330,,,,2330,2330,0,0,0,0.00,0
,20170110,2330,2330,,,,2330,2330,0,0,0,0.00,0
,20170111,2330,2330,,,,2330,2330,0,0,0,0.00,0
,20170112,2330,2330,,,,2330,2330,0,0,0,0.00,0
,20170113,2330,2330,,,,2330,2330,0,0,0,0.00,0
,20170116,2330,2330,,,,2330,2330,0,0,0,0.00,0
,20170117,2330,2330,,,,2330,2330,0,0,0,0.00,0
,20170118,2330,2330,,,,2330,2330,0,0,0,0.00,0
,20170119,2330,2330,,,,2330,2330,0,0,0,0.00,0
,20170120,2330,2330,,,,2330,2330,0,0,0,0.00,0
,20170123,2330,2330,,,,2330,2330,0,0,0,0.00,0
,20170124,2330,2330,,,,2330,2330,0,0,0,0.00,0
,20170125,2330,2330,,,,2330,2330,0,0,0,0.00,0
,20170126,2330,2330,,,,2330,2330,0,0,0,0.00,0
,20170203,2330,2330,,,,2330,2330,0,0,0,0.00,0
,20170206,2330,2330,,,,2330,2330,0,0,0,0.00,0
,20170207,2330,2330,,,,2330,2330,0,0,0,0.00,0
,20170208,2330,2330,,,,2330,2330,0,0,0,0.00,0
,20170209,2330,2330,,,,2330,2330,0,0,0,0.00,0
,20170210,2330,2330,,,,2330,2330,0,0,0,0.00,0
,20170213,2330,2330,,,,2330,2330,0,0,0,0.00,0
,20170214,2330,2330,,,,2330,2330,0,0,0,0.00,0
,20170215,2330,2330,,,,2330,2330,0,0,0,0.00,0
,20170216,2330,2330,,,,2330,2330,0,0,0,0.00,0
,20170217,2330,2330,,,,2330,2330,0,0,0,0.00,0
,20170220,2330,2330,,,,2330,2330,0,0,0,0.00,0
,20170221,2330,2330,,,,2330,2330,0,0,0,0.00,0
,20170222,2330,2330,,,,2330,2330,0,0,0,0.00,0
,20170223,2330,2330,,,,2330,2330,0,0,0,0.00,0
,20170224,2330,2330,,,,2330,2330,0,0,0,0.00,0
,20170227,2330,2330,,,,2330,2330,0,0,0,0.00,0
,20170228,2330,2330,,,,2330,2330,0,0,0,0.00,0
,20170301,2330,2330,,,,2330,2330,0,0,0,0.00,0
,20170302,2330,2330,,,,2330,2330,0,0,0,0.00,0
,20170303,2330,2330,,,,2330,2330,0,0,0,0.00,0
,20170306,2330,2330,,,,2330,2330,0,0,0,0.00,0
,20170307,2330,2330,,,,2330,2330,0,0,0,0.00,0
,20170308,2330,2330,,,,2330,2330,0,0,0,0.00,0
,20170309,2330,2330,,,,2330,2330,0,0,0,0.00,0
,20170310,2330,2330,,,,2330,2330,0,0,0,0.00,0
,20170313,2330,2330,,,,2330,2330,0,0,0,0.00,0
,20170314,2330,2330,,,,2330,2330,0,0,0,0.00,0
,20170315,2330,2330,,,,2330,2330,0,0,0,0.00,0
,20170316,2330,2330,,,,2330,2330,0,0,0,0.00,0
,20170317,2330,2330,,,,2330,2330,0,0,0,0.00,0
,20170320,2330,2330,,,,2330,2330,0,0,0,0.00,0
,20170321,2330,2330,,,,2388,2388,58,58,0,0.00,0
,20170322,2388,2388,,,,2388,2388,0,0,0,0.00,0
,20170323,2388,2388,,,,2388,2388,0,0,0,0.00,0
,20170324,2388,2388,,,,2388,2388,0,0,0,0.00,0
,20170327,2388,2388,,,,2388,2388,0,0,0,0.00,0
,20170328,2388,2388,,,,2388,2388,0,0,0,0.00,0
,20170329,2388,2388,,,,2507,2507,119,119,0,0.00,0
,20170330,2507,2507,,,,2507,2507,0,0,0,0.00,0
,20170331,2507,2507,,,,2507,2507,0,0,0,0.00,0
,20170405,2507,2507,,,,2507,2507,0,0,0,0.00,0
,20170406,2507,2507,,,,2507,2507,0,0,0,0.00,0
,20170407,2507,2507,,,,2507,2507,0,0,0,0.00,0
,20170410,2507,2507,,,,2507,2507,0,0,0,0.00,0
,20170411,2507,2507,,,,2507,2507,0,0,0,0.00,0
,20170412,2507,2507,,,,2507,2507,0,0,0,0.00,0
,20170413,2507,2507,,,,2507,2507,0,0,0,0.00,0
,20170414,2507,2507,,,,2507,2507,0,0,0,0.00,0
,20170417,2507,2507,,,,2507,2507,0,0,0,0.00,0
,20170418,2507,2507,,,,2507,2507,0,0,0,0.00,0
,20170419,2507,2507,,,,2507,2507,0,0,0,0.00,0
,20170420,2507,2507,,,,2507,2507,0,0,0,0.00,0
,20170421,2507,2507,,,,2507,2507,0,0,0,0.00,0
,20170424,2507,2507,,,,2507,2507,0,0,0,0.00,0
,20170425,2507,2507,,,,2507,2507,0,0,0,0.00,0
,20170426,2507,2507,,,,2507,2507,0,0,0,0.00,0
,20170427,2507,2507,,,,2507,2507,0,0,0,0.00,0
,20170428,2507,2507,,,,2507,2507,0,0,0,0.00,0
,20170502,2507,2507,,,,2507,2507,0,0,0,0.00,0
,20170503,2507,2507,,,,2507,2507,0,0,0,0.00,0
,20170504,2507,2507,,,,2507,2507,0,0,0,0.00,0
,20170505,2507,2507,,,,2507,2507,0,0,0,0.00,0
,20170508,2507,2507,,,,2507,2507,0,0,0,0.00,0
,20170509,2507,2507,,,,2507,2507,0,0,0,0.00,0
,20170510,2507,2507,,,,2507,2507,0,0,0,0.00,0
,20170511,2507,2507,,,,2507,2507,0,0,0,0.00,0
,20170512,2507,2507,,,,2507,2507,0,0,0,0.00,0
,20170515,2507,2507,,,,2507,2507,0,0,0,0.00,0
,20170516,2507,2507,,,,2507,2507,0,0,0,0.00,0
,20170517,2507,2507,,,,2507,2507,0,0,0,0.00,0
,20170518,2507,2507,,,,2507,2507,0,0,0,0.00,0
,20170519,2507,2507,,,,2507,2507,0,0,0,0.00,0
,20170522,2507,2507,,,,2507,2507,0,0,0,0.00,0
,20170523,2507,2507,,,,2507,2507,0,0,0,0.00,0
,20170524,2507,2507,,,,2507,2507,0,0,0,0.00,0
,20170525,2507,2507,,,,2507,2507,0,0,0,0.00,0
,20170526,2507,2507,,,,2507,2507,0,0,0,0.00,0
,20170531,2507,2507,,,,2507,2507,0,0,0,0.00,0
,20170601,2507,2507,,,,2507,2507,0,0,0,0.00,0
,20170602,2507,2507,,,,2507,2507,0,0,0,0.00,0
,20170605,2507,2507,,,,2507,2507,0,0,0,0.00,0
,20170606,2507,2507,,,,2507,2507,0,0,0,0.00,0
,20170607,2507,2507,,,,2507,2507,0,0,0,0.00,0
,20170608,2507,2507,,,,2507,2507,0,0,0,0.00,0
,20170609,2507,2507,,,,2507,2507,0,0,0,0.00,0
,20170612,2507,2507,,,,2507,2507,0,0,0,0.00,0
,20170613,2507,2507,,,,2507,2507,0,0,0,0.00,0
,20170614,2507,2507,,,,2507,2507,0,0,0,0.00,0
,20170615,2507,2507,,,,2507,2507,0,0,0,0.00,0
wr1707,20170103,2330,2330,,,,2330,2330,0,0,0,0.00,0
,20170104,2330,2330,,,,2330,2330,0,0,0,0.00,0
,20170105,2330,2330,,,,2330,2330,0,0,0,0.00,0
,20170106,2330,2330,,,,2330,2330,0,0,0,0.00,0
,20170109,2330,2330,,,,2330,2330,0,0,0,0.00,0
,20170110,2330,2330,,,,2330,2330,0,0,0,0.00,0
,20170111,2330,2330,,,,2330,2330,0,0,0,0.00,0
,20170112,2330,2330,,,,2330,2330,0,0,0,0.00,0
,20170113,2330,2330,,,,2330,2330,0,0,0,0.00,0
,20170116,2330,2330,,,,2330,2330,0,0,0,0.00,0
,20170117,2330,2330,,,,2330,2330,0,0,0,0.00,0
,20170118,2330,2330,,,,2330,2330,0,0,0,0.00,0
,20170119,2330,2330,,,,2330,2330,0,0,0,0.00,0
,20170120,2330,2330,,,,2330,2330,0,0,0,0.00,0
,20170123,2330,2330,,,,2330,2330,0,0,0,0.00,0
,20170124,2330,2330,,,,2330,2330,0,0,0,0.00,0
,20170125,2330,2330,,,,2330,2330,0,0,0,0.00,0
,20170126,2330,2330,,,,2330,2330,0,0,0,0.00,0
,20170203,2330,2330,,,,2330,2330,0,0,0,0.00,0
,20170206,2330,2330,,,,2330,2330,0,0,0,0.00,0
,20170207,2330,2330,,,,2330,2330,0,0,0,0.00,0
,20170208,2330,2330,,,,2330,2330,0,0,0,0.00,0
,20170209,2330,2330,,,,2330,2330,0,0,0,0.00,0
,20170210,2330,2330,,,,2330,2330,0,0,0,0.00,0
,20170213,2330,2330,,,,2330,2330,0,0,0,0.00,0
,20170214,2330,2330,,,,2330,2330,0,0,0,0.00,0
,20170215,2330,2330,,,,2330,2330,0,0,0,0.00,0
,20170216,2330,2330,,,,2330,2330,0,0,0,0.00,0
,20170217,2330,2330,,,,2330,2330,0,0,0,0.00,0
,20170220,2330,2330,,,,2330,2330,0,0,0,0.00,0
,20170221,2330,2330,,,,2330,2330,0,0,0,0.00,0
,20170222,2330,2330,,,,2330,2330,0,0,0,0.00,0
,20170223,2330,2330,,,,2330,2330,0,0,0,0.00,0
,20170224,2330,2330,,,,2330,2330,0,0,0,0.00,0
,20170227,2330,2330,,,,2330,2330,0,0,0,0.00,0
,20170228,2330,2330,,,,2330,2330,0,0,0,0.00,0
,20170301,2330,2330,,,,2330,2330,0,0,0,0.00,0
,20170302,2330,2330,,,,2330,2330,0,0,0,0.00,0
,20170303,2330,2330,,,,2330,2330,0,0,0,0.00,0
,20170306,2330,2330,,,,2330,2330,0,0,0,0.00,0
,20170307,2330,2330,,,,2330,2330,0,0,0,0.00,0
,20170308,2330,2330,,,,2330,2330,0,0,0,0.00,0
,20170309,2330,2330,,,,2330,2330,0,0,0,0.00,0
,20170310,2330,2330,,,,2330,2330,0,0,0,0.00,0
,20170313,2330,2330,,,,2330,2330,0,0,0,0.00,0
,20170314,2330,2330,,,,2330,2330,0,0,0,0.00,0
,20170315,2330,2330,,,,2330,2330,0,0,0,0.00,0
,20170316,2330,2330,,,,2330,2330,0,0,0,0.00,0
,20170317,2330,2330,,,,2330,2330,0,0,0,0.00,0
,20170320,2330,2330,,,,2330,2330,0,0,0,0.00,0
,20170321,2330,2330,,,,2388,2388,58,58,0,0.00,0
,20170322,2388,2388,,,,2388,2388,0,0,0,0.00,0
,20170323,2388,2388,,,,2388,2388,0,0,0,0.00,0
,20170324,2388,2388,,,,2388,2388,0,0,0,0.00,0
,20170327,2388,2388,,,,2388,2388,0,0,0,0.00,0
,20170328,2388,2388,,,,2388,2388,0,0,0,0.00,0
,20170329,2388,2388,,,,2507,2507,119,119,0,0.00,0
,20170330,2507,2507,,,,2507,2507,0,0,0,0.00,0
,20170331,2507,2507,,,,2507,2507,0,0,0,0.00,0
,20170405,2507,2507,,,,2507,2507,0,0,0,0.00,0
,20170406,2507,2507,,,,2507,2507,0,0,0,0.00,0
,20170407,2507,2507,,,,2507,2507,0,0,0,0.00,0
,20170410,2507,2507,,,,2507,2507,0,0,0,0.00,0
,20170411,2507,2507,,,,2507,2507,0,0,0,0.00,0
,20170412,2507,2507,,,,2507,2507,0,0,0,0.00,0
,20170413,2507,2507,,,,2507,2507,0,0,0,0.00,0
,20170414,2507,2507,,,,2507,2507,0,0,0,0.00,0
,20170417,2507,2507,,,,2507,2507,0,0,0,0.00,0
,20170418,2507,2507,,,,2507,2507,0,0,0,0.00,0
,20170419,2507,2507,,,,2507,2507,0,0,0,0.00,0
,20170420,2507,2507,,,,2507,2507,0,0,0,0.00,0
,20170421,2507,2507,,,,2507,2507,0,0,0,0.00,0
,20170424,2507,2507,,,,2507,2507,0,0,0,0.00,0
,20170425,2507,2507,,,,2507,2507,0,0,0,0.00,0
,20170426,2507,2507,,,,2507,2507,0,0,0,0.00,0
,20170427,2507,2507,,,,2507,2507,0,0,0,0.00,0
,20170428,2507,2507,,,,2507,2507,0,0,0,0.00,0
,20170502,2507,2507,,,,2507,2507,0,0,0,0.00,0
,20170503,2507,2507,,,,2507,2507,0,0,0,0.00,0
,20170504,2507,2507,,,,2507,2507,0,0,0,0.00,0
,20170505,2507,2507,,,,2507,2507,0,0,0,0.00,0
,20170508,2507,2507,,,,2507,2507,0,0,0,0.00,0
,20170509,2507,2507,,,,2507,2507,0,0,0,0.00,0
,20170510,2507,2507,,,,2507,2507,0,0,0,0.00,0
,20170511,2507,2507,,,,2507,2507,0,0,0,0.00,0
,20170512,2507,2507,,,,2507,2507,0,0,0,0.00,0
,20170515,2507,2507,,,,2507,2507,0,0,0,0.00,0
,20170516,2507,2507,,,,2507,2507,0,0,0,0.00,0
,20170517,2507,2507,,,,2507,2507,0,0,0,0.00,0
,20170518,2507,2507,,,,2507,2507,0,0,0,0.00,0
,20170519,2507,2507,,,,2507,2507,0,0,0,0.00,0
,20170522,2507,2507,,,,2507,2507,0,0,0,0.00,0
,20170523,2507,2507,,,,2507,2507,0,0,0,0.00,0
,20170524,2507,2507,,,,2507,2507,0,0,0,0.00,0
,20170525,2507,2507,,,,2507,2507,0,0,0,0.00,0
,20170526,2507,2507,,,,2507,2507,0,0,0,0.00,0
,20170531,2507,2507,,,,2507,2507,0,0,0,0.00,0
,20170601,2507,2507,,,,2507,2507,0,0,0,0.00,0
,20170602,2507,2507,,,,2507,2507,0,0,0,0.00,0
,20170605,2507,2507,,,,2507,2507,0,0,0,0.00,0
,20170606,2507,2507,,,,2507,2507,0,0,0,0.00,0
,20170607,2507,2507,,,,2507,2507,0,0,0,0.00,0
,20170608,2507,2507,,,,2507,2507,0,0,0,0.00,0
,20170609,2507,2507,,,,2507,2507,0,0,0,0.00,0
,20170612,2507,2507,,,,2507,2507,0,0,0,0.00,0
,20170613,2507,2507,,,,2507,2507,0,0,0,0.00,0
,20170614,2507,2507,,,,2507,2507,0,0,0,0.00,0
,20170615,2507,2507,,,,2507,2507,0,0,0,0.00,0
,20170616,2507,2507,,,,2507,2507,0,0,0,0.00,0
,20170619,2507,2507,,,,2507,2507,0,0,0,0.00,0
,20170620,2507,2507,,,,2507,2507,0,0,0,0.00,0
,20170621,2507,2507,,,,2507,2507,0,0,0,0.00,0
,20170622,2507,2507,,,,2507,2507,0,0,0,0.00,0
,20170623,2507,2507,,,,2507,2507,0,0,0,0.00,0
,20170626,2507,2507,,,,2507,2507,0,0,0,0.00,0
,20170627,2507,2507,,,,2507,2507,0,0,0,0.00,0
,20170628,2507,2507,,,,2507,2507,0,0,0,0.00,0
,20170629,2507,2507,,,,2507,2507,0,0,0,0.00,0
,20170630,2507,2507,,,,2507,2507,0,0,0,0.00,0
,20170703,2507,2507,,,,2507,2507,0,0,0,0.00,0
,20170704,2507,2507,,,,2507,2507,0,0,0,0.00,0
,20170705,2507,2507,,,,2507,2507,0,0,0,0.00,0
,20170706,2507,2507,,,,2507,2507,0,0,0,0.00,0
,20170707,2507,2507,,,,2507,2507,0,0,0,0.00,0
,20170710,2507,2507,,,,2507,2507,0,0,0,0.00,0
,20170711,2507,2507,,,,2507,2507,0,0,0,0.00,0
,20170712,2507,2507,,,,2507,2507,0,0,0,0.00,0
,20170713,2507,2507,,,,2507,2507,0,0,0,0.00,0
,20170714,2507,2507,,,,2507,2507,0,0,0,0.00,0
,20170717,2507,2507,,,,2507,2507,0,0,0,0.00,0
wr1708,20170103,2330,2330,,,,2330,2330,0,0,0,0.00,0
,20170104,2330,2330,,,,2330,2330,0,0,0,0.00,0
,20170105,2330,2330,,,,2330,2330,0,0,0,0.00,0
,20170106,2330,2330,,,,2330,2330,0,0,0,0.00,0
,20170109,2330,2330,,,,2330,2330,0,0,0,0.00,0
,20170110,2330,2330,,,,2330,2330,0,0,0,0.00,0
,20170111,2330,2330,,,,2330,2330,0,0,0,0.00,0
,20170112,2330,2330,,,,2330,2330,0,0,0,0.00,0
,20170113,2330,2330,,,,2330,2330,0,0,0,0.00,0
,20170116,2330,2330,,,,2330,2330,0,0,0,0.00,0
,20170117,2330,2330,,,,2330,2330,0,0,0,0.00,0
,20170118,2330,2330,,,,2330,2330,0,0,0,0.00,0
,20170119,2330,2330,,,,2330,2330,0,0,0,0.00,0
,20170120,2330,2330,,,,2330,2330,0,0,0,0.00,0
,20170123,2330,2330,,,,2330,2330,0,0,0,0.00,0
,20170124,2330,2330,,,,2330,2330,0,0,0,0.00,0
,20170125,2330,2330,,,,2330,2330,0,0,0,0.00,0
,20170126,2330,2330,,,,2330,2330,0,0,0,0.00,0
,20170203,2330,2330,,,,2330,2330,0,0,0,0.00,0
,20170206,2330,2330,,,,2330,2330,0,0,0,0.00,0
,20170207,2330,2330,,,,2330,2330,0,0,0,0.00,0
,20170208,2330,2330,,,,2330,2330,0,0,0,0.00,0
,20170209,2330,2330,,,,2330,2330,0,0,0,0.00,0
,20170210,2330,2330,,,,2330,2330,0,0,0,0.00,0
,20170213,2330,2330,,,,2330,2330,0,0,0,0.00,0
,20170214,2330,2330,,,,2330,2330,0,0,0,0.00,0
,20170215,2330,2330,,,,2330,2330,0,0,0,0.00,0
,20170216,2330,2330,,,,2330,2330,0,0,0,0.00,0
,20170217,2330,2330,,,,2330,2330,0,0,0,0.00,0
,20170220,2330,2330,,,,2330,2330,0,0,0,0.00,0
,20170221,2330,2330,,,,2330,2330,0,0,0,0.00,0
,20170222,2330,2330,,,,2330,2330,0,0,0,0.00,0
,20170223,2330,2330,,,,2330,2330,0,0,0,0.00,0
,20170224,2330,2330,,,,2330,2330,0,0,0,0.00,0
,20170227,2330,2330,,,,2330,2330,0,0,0,0.00,0
,20170228,2330,2330,,,,2330,2330,0,0,0,0.00,0
,20170301,2330,2330,,,,2330,2330,0,0,0,0.00,0
,20170302,2330,2330,,,,2330,2330,0,0,0,0.00,0
,20170303,2330,2330,,,,2330,2330,0,0,0,0.00,0
,20170306,2330,2330,,,,2330,2330,0,0,0,0.00,0
,20170307,2330,2330,,,,2330,2330,0,0,0,0.00,0
,20170308,2330,2330,,,,2330,2330,0,0,0,0.00,0
,20170309,2330,2330,,,,2330,2330,0,0,0,0.00,0
,20170310,2330,2330,,,,2330,2330,0,0,0,0.00,0
,20170313,2330,2330,,,,2330,2330,0,0,0,0.00,0
,20170314,2330,2330,,,,2330,2330,0,0,0,0.00,0
,20170315,2330,2330,,,,2330,2330,0,0,0,0.00,0
,20170316,2330,2330,,,,2330,2330,0,0,0,0.00,0
,20170317,2330,2330,,,,2330,2330,0,0,0,0.00,0
,20170320,2330,2330,,,,2330,2330,0,0,0,0.00,0
,20170321,2330,2330,,,,2388,2388,58,58,0,0.00,0
,20170322,2388,2388,,,,2388,2388,0,0,0,0.00,0
,20170323,2388,2388,,,,2388,2388,0,0,0,0.00,0
,20170324,2388,2388,,,,2388,2388,0,0,0,0.00,0
,20170327,2388,2388,,,,2388,2388,0,0,0,0.00,0
,20170328,2388,2388,,,,2388,2388,0,0,0,0.00,0
,20170329,2388,2388,,,,2507,2507,119,119,0,0.00,0
,20170330,2507,2507,,,,2507,2507,0,0,0,0.00,0
,20170331,2507,2507,,,,2507,2507,0,0,0,0.00,0
,20170405,2507,2507,,,,2507,2507,0,0,0,0.00,0
,20170406,2507,2507,,,,2507,2507,0,0,0,0.00,0
,20170407,2507,2507,,,,2507,2507,0,0,0,0.00,0
,20170410,2507,2507,,,,2507,2507,0,0,0,0.00,0
,20170411,2507,2507,,,,2507,2507,0,0,0,0.00,0
,20170412,2507,2507,,,,2507,2507,0,0,0,0.00,0
,20170413,2507,2507,,,,2507,2507,0,0,0,0.00,0
,20170414,2507,2507,,,,2507,2507,0,0,0,0.00,0
,20170417,2507,2507,,,,2507,2507,0,0,0,0.00,0
,20170418,2507,2507,,,,2507,2507,0,0,0,0.00,0
,20170419,2507,2507,,,,2507,2507,0,0,0,0.00,0
,20170420,2507,2507,,,,2507,2507,0,0,0,0.00,0
,20170421,2507,2507,,,,2507,2507,0,0,0,0.00,0
,20170424,2507,2507,,,,2507,2507,0,0,0,0.00,0
,20170425,2507,2507,,,,2507,2507,0,0,0,0.00,0
,20170426,2507,2507,,,,2507,2507,0,0,0,0.00,0
,20170427,2507,2507,,,,2507,2507,0,0,0,0.00,0
,20170428,2507,2507,,,,2507,2507,0,0,0,0.00,0
,20170502,2507,2507,,,,2507,2507,0,0,0,0.00,0
,20170503,2507,2507,,,,2507,2507,0,0,0,0.00,0
,20170504,2507,2507,,,,2507,2507,0,0,0,0.00,0
,20170505,2507,2507,,,,2507,2507,0,0,0,0.00,0
,20170508,2507,2507,,,,2507,2507,0,0,0,0.00,0
,20170509,2507,2507,,,,2507,2507,0,0,0,0.00,0
,20170510,2507,2507,,,,2507,2507,0,0,0,0.00,0
,20170511,2507,2507,,,,2507,2507,0,0,0,0.00,0
,20170512,2507,2507,,,,2507,2507,0,0,0,0.00,0
,20170515,2507,2507,,,,2507,2507,0,0,0,0.00,0
,20170516,2507,2507,,,,2507,2507,0,0,0,0.00,0
,20170517,2507,2507,,,,2507,2507,0,0,0,0.00,0
,20170518,2507,2507,,,,2507,2507,0,0,0,0.00,0
,20170519,2507,2507,,,,2507,2507,0,0,0,0.00,0
,20170522,2507,2507,,,,2507,2507,0,0,0,0.00,0
,20170523,2507,2507,,,,2507,2507,0,0,0,0.00,0
,20170524,2507,2507,,,,2507,2507,0,0,0,0.00,0
,20170525,2507,2507,,,,2507,2507,0,0,0,0.00,0
,20170526,2507,2507,,,,2507,2507,0,0,0,0.00,0
,20170531,2507,2507,,,,2507,2507,0,0,0,0.00,0
,20170601,2507,2507,,,,2507,2507,0,0,0,0.00,0
,20170602,2507,2507,,,,2507,2507,0,0,0,0.00,0
,20170605,2507,2507,,,,2507,2507,0,0,0,0.00,0
,20170606,2507,2507,,,,2507,2507,0,0,0,0.00,0
,20170607,2507,2507,,,,2507,2507,0,0,0,0.00,0
,20170608,2507,2507,,,,2507,2507,0,0,0,0.00,0
,20170609,2507,2507,,,,2507,2507,0,0,0,0.00,0
,20170612,2507,2507,,,,2507,2507,0,0,0,0.00,0
,20170613,2507,2507,,,,2507,2507,0,0,0,0.00,0
,20170614,2507,2507,,,,2507,2507,0,0,0,0.00,0
,20170615,2507,2507,,,,2507,2507,0,0,0,0.00,0
,20170616,2507,2507,,,,2507,2507,0,0,0,0.00,0
,20170619,2507,2507,,,,2507,2507,0,0,0,0.00,0
,20170620,2507,2507,,,,2507,2507,0,0,0,0.00,0
,20170621,2507,2507,,,,2507,2507,0,0,0,0.00,0
,20170622,2507,2507,,,,2507,2507,0,0,0,0.00,0
,20170623,2507,2507,,,,2507,2507,0,0,0,0.00,0
,20170626,2507,2507,,,,2507,2507,0,0,0,0.00,0
,20170627,2507,2507,,,,2507,2507,0,0,0,0.00,0
,20170628,2507,2507,,,,2507,2507,0,0,0,0.00,0
,20170629,2507,2507,,,,2507,2507,0,0,0,0.00,0
,20170630,2507,2507,,,,2507,2507,0,0,0,0.00,0
,20170703,2507,2507,,,,2507,2507,0,0,0,0.00,0
,20170704,2507,2507,,,,2507,2507,0,0,0,0.00,0
,20170705,2507,2507,,,,2507,2507,0,0,0,0.00,0
,20170706,2507,2507,,,,2507,2507,0,0,0,0.00,0
,20170707,2507,2507,,,,2507,2507,0,0,0,0.00,0
,20170710,2507,2507,,,,2507,2507,0,0,0,0.00,0
,20170711,2507,2507,,,,2507,2507,0,0,0,0.00,0
,20170712,2507,2507,,,,2507,2507,0,0,0,0.00,0
,20170713,2507,2507,,,,2507,2507,0,0,0,0.00,0
,20170714,2507,2507,,,,2507,2507,0,0,0,0.00,0
,20170717,2507,2507,,,,2507,2507,0,0,0,0.00,0
,20170718,2507,2507,,,,2507,2507,0,0,0,0.00,0
,20170719,2507,2507,,,,2507,2507,0,0,0,0.00,0
,20170720,2507,2507,,,,2507,2507,0,0,0,0.00,0
,20170721,2507,2507,,,,2507,2507,0,0,0,0.00,0
,20170724,2507,2507,,,,2507,2507,0,0,0,0.00,0
,20170725,2507,2507,,,,2507,2507,0,0,0,0.00,0
,20170726,2507,2507,,,,2507,2507,0,0,0,0.00,0
,20170727,2507,2507,,,,2507,2507,0,0,0,0.00,0
,20170728,2507,2507,,,,2507,2507,0,0,0,0.00,0
,20170731,2507,2507,,,,2507,2507,0,0,0,0.00,0
,20170801,2507,2507,,,,2507,2507,0,0,0,0.00,0
,20170802,2507,2507,,,,2507,2507,0,0,0,0.00,0
,20170803,2507,2507,,,,2507,2507,0,0,0,0.00,0
,20170804,2507,2507,,,,2507,2507,0,0,0,0.00,0
,20170807,2507,2507,,,,2507,2507,0,0,0,0.00,0
,20170808,2507,2507,,,,2507,2507,0,0,0,0.00,0
,20170809,2507,2507,,,,2507,2507,0,0,0,0.00,0
,20170810,2507,2507,,,,2507,2507,0,0,0,0.00,0
,20170811,2507,2507,,,,2507,2507,0,0,0,0.00,0
,20170814,2507,2507,,,,2507,2507,0,0,0,0.00,0
,20170815,2507,2507,,,,2507,2507,0,0,0,0.00,0
wr1709,20170103,2330,2330,,,,2330,2330,0,0,0,0.00,0
,20170104,2330,2330,,,,2330,2330,0,0,0,0.00,0
,20170105,2330,2330,,,,2330,2330,0,0,0,0.00,0
,20170106,2330,2330,,,,2330,2330,0,0,0,0.00,0
,20170109,2330,2330,,,,2330,2330,0,0,0,0.00,0
,20170110,2330,2330,,,,2330,2330,0,0,0,0.00,0
,20170111,2330,2330,,,,2330,2330,0,0,0,0.00,0
,20170112,2330,2330,,,,2330,2330,0,0,0,0.00,0
,20170113,2330,2330,,,,2330,2330,0,0,0,0.00,0
,20170116,2330,2330,,,,2330,2330,0,0,0,0.00,0
,20170117,2330,2330,,,,2330,2330,0,0,0,0.00,0
,20170118,2330,2330,,,,2330,2330,0,0,0,0.00,0
,20170119,2330,2330,,,,2330,2330,0,0,0,0.00,0
,20170120,2330,2330,,,,2330,2330,0,0,0,0.00,0
,20170123,2330,2330,,,,2330,2330,0,0,0,0.00,0
,20170124,2330,2330,,,,2330,2330,0,0,0,0.00,0
,20170125,2330,2330,,,,2330,2330,0,0,0,0.00,0
,20170126,2330,2330,,,,2330,2330,0,0,0,0.00,0
,20170203,2330,2330,,,,2330,2330,0,0,0,0.00,0
,20170206,2330,2330,,,,2330,2330,0,0,0,0.00,0
,20170207,2330,2330,,,,2330,2330,0,0,0,0.00,0
,20170208,2330,2330,,,,2330,2330,0,0,0,0.00,0
,20170209,2330,2330,,,,2330,2330,0,0,0,0.00,0
,20170210,2330,2330,,,,2330,2330,0,0,0,0.00,0
,20170213,2330,2330,,,,2330,2330,0,0,0,0.00,0
,20170214,2330,2330,,,,2330,2330,0,0,0,0.00,0
,20170215,2330,2330,,,,2330,2330,0,0,0,0.00,0
,20170216,2330,2330,,,,2330,2330,0,0,0,0.00,0
,20170217,2330,2330,,,,2330,2330,0,0,0,0.00,0
,20170220,2330,2330,,,,2330,2330,0,0,0,0.00,0
,20170221,2330,2330,,,,2330,2330,0,0,0,0.00,0
,20170222,2330,2330,,,,2330,2330,0,0,0,0.00,0
,20170223,2330,2330,,,,2330,2330,0,0,0,0.00,0
,20170224,2330,2330,,,,2330,2330,0,0,0,0.00,0
,20170227,2330,2330,,,,2330,2330,0,0,0,0.00,0
,20170228,2330,2330,,,,2330,2330,0,0,0,0.00,0
,20170301,2330,2330,,,,2330,2330,0,0,0,0.00,0
,20170302,2330,2330,,,,2330,2330,0,0,0,0.00,0
,20170303,2330,2330,,,,2330,2330,0,0,0,0.00,0
,20170306,2330,2330,,,,2330,2330,0,0,0,0.00,0
,20170307,2330,2330,,,,2330,2330,0,0,0,0.00,0
,20170308,2330,2330,,,,2330,2330,0,0,0,0.00,0
,20170309,2330,2330,,,,2330,2330,0,0,0,0.00,0
,20170310,2330,2330,,,,2330,2330,0,0,0,0.00,0
,20170313,2330,2330,,,,2330,2330,0,0,0,0.00,0
,20170314,2330,2330,,,,2330,2330,0,0,0,0.00,0
,20170315,2330,2330,,,,2330,2330,0,0,0,0.00,0
,20170316,2330,2330,,,,2330,2330,0,0,0,0.00,0
,20170317,2330,2330,,,,2330,2330,0,0,0,0.00,0
,20170320,2330,2330,,,,2330,2330,0,0,0,0.00,0
,20170321,2330,2330,,,,2388,2388,58,58,0,0.00,0
,20170322,2388,2388,,,,2388,2388,0,0,0,0.00,0
,20170323,2388,2388,,,,2388,2388,0,0,0,0.00,0
,20170324,2388,2388,,,,2388,2388,0,0,0,0.00,0
,20170327,2388,2388,,,,2388,2388,0,0,0,0.00,0
,20170328,2388,2388,,,,2388,2388,0,0,0,0.00,0
,20170329,2388,2388,,,,2507,2507,119,119,0,0.00,0
,20170330,2507,2507,,,,2507,2507,0,0,0,0.00,0
,20170331,2507,2507,,,,2507,2507,0,0,0,0.00,0
,20170405,2507,2507,,,,2507,2507,0,0,0,0.00,0
,20170406,2507,2507,,,,2507,2507,0,0,0,0.00,0
,20170407,2507,2507,,,,2507,2507,0,0,0,0.00,0
,20170410,2507,2507,,,,2507,2507,0,0,0,0.00,0
,20170411,2507,2507,,,,2507,2507,0,0,0,0.00,0
,20170412,2507,2507,,,,2507,2507,0,0,0,0.00,0
,20170413,2507,2507,,,,2507,2507,0,0,0,0.00,0
,20170414,2507,2507,,,,2507,2507,0,0,0,0.00,0
,20170417,2507,2507,,,,2507,2507,0,0,0,0.00,0
,20170418,2507,2507,,,,2507,2507,0,0,0,0.00,0
,20170419,2507,2507,,,,2507,2507,0,0,0,0.00,0
,20170420,2507,2507,,,,2507,2507,0,0,0,0.00,0
,20170421,2507,2507,,,,2507,2507,0,0,0,0.00,0
,20170424,2507,2507,,,,2507,2507,0,0,0,0.00,0
,20170425,2507,2507,,,,2507,2507,0,0,0,0.00,0
,20170426,2507,2507,,,,2507,2507,0,0,0,0.00,0
,20170427,2507,2507,,,,2507,2507,0,0,0,0.00,0
,20170428,2507,2507,,,,2507,2507,0,0,0,0.00,0
,20170502,2507,2507,,,,2507,2507,0,0,0,0.00,0
,20170503,2507,2507,,,,2507,2507,0,0,0,0.00,0
,20170504,2507,2507,,,,2507,2507,0,0,0,0.00,0
,20170505,2507,2507,,,,2507,2507,0,0,0,0.00,0
,20170508,2507,2507,,,,2507,2507,0,0,0,0.00,0
,20170509,2507,2507,,,,2507,2507,0,0,0,0.00,0
,20170510,2507,2507,,,,2507,2507,0,0,0,0.00,0
,20170511,2507,2507,,,,2507,2507,0,0,0,0.00,0
,20170512,2507,2507,,,,2507,2507,0,0,0,0.00,0
,20170515,2507,2507,,,,2507,2507,0,0,0,0.00,0
,20170516,2507,2507,,,,2507,2507,0,0,0,0.00,0
,20170517,2507,2507,,,,2507,2507,0,0,0,0.00,0
,20170518,2507,2507,,,,2507,2507,0,0,0,0.00,0
,20170519,2507,2507,,,,2507,2507,0,0,0,0.00,0
,20170522,2507,2507,,,,2507,2507,0,0,0,0.00,0
,20170523,2507,2507,,,,2507,2507,0,0,0,0.00,0
,20170524,2507,2507,,,,2507,2507,0,0,0,0.00,0
,20170525,2507,2507,,,,2507,2507,0,0,0,0.00,0
,20170526,2507,2507,,,,2507,2507,0,0,0,0.00,0
,20170531,2507,2507,,,,2507,2507,0,0,0,0.00,0
,20170601,2507,2507,,,,2507,2507,0,0,0,0.00,0
,20170602,2507,2507,,,,2507,2507,0,0,0,0.00,0
,20170605,2507,2507,,,,2507,2507,0,0,0,0.00,0
,20170606,2507,2507,,,,2507,2507,0,0,0,0.00,0
,20170607,2507,2507,,,,2507,2507,0,0,0,0.00,0
,20170608,2507,2507,,,,2507,2507,0,0,0,0.00,0
,20170609,2507,2507,,,,2507,2507,0,0,0,0.00,0
,20170612,2507,2507,,,,2507,2507,0,0,0,0.00,0
,20170613,2507,2507,,,,2507,2507,0,0,0,0.00,0
,20170614,2507,2507,,,,2507,2507,0,0,0,0.00,0
,20170615,2507,2507,,,,2507,2507,0,0,0,0.00,0
,20170616,2507,2507,,,,2507,2507,0,0,0,0.00,0
,20170619,2507,2507,,,,2507,2507,0,0,0,0.00,0
,20170620,2507,2507,,,,2507,2507,0,0,0,0.00,0
,20170621,2507,2507,,,,2507,2507,0,0,0,0.00,0
,20170622,2507,2507,,,,2507,2507,0,0,0,0.00,0
,20170623,2507,2507,,,,2507,2507,0,0,0,0.00,0
,20170626,2507,2507,,,,2507,2507,0,0,0,0.00,0
,20170627,2507,2507,,,,2507,2507,0,0,0,0.00,0
,20170628,2507,2507,,,,2507,2507,0,0,0,0.00,0
,20170629,2507,2507,,,,2507,2507,0,0,0,0.00,0
,20170630,2507,2507,,,,2507,2507,0,0,0,0.00,0
,20170703,2507,2507,,,,2507,2507,0,0,0,0.00,0
,20170704,2507,2507,,,,2507,2507,0,0,0,0.00,0
,20170705,2507,2507,,,,2507,2507,0,0,0,0.00,0
,20170706,2507,2507,,,,2507,2507,0,0,0,0.00,0
,20170707,2507,2507,,,,2507,2507,0,0,0,0.00,0
,20170710,2507,2507,,,,2507,2507,0,0,0,0.00,0
,20170711,2507,2507,,,,2507,2507,0,0,0,0.00,0
,20170712,2507,2507,,,,2507,2507,0,0,0,0.00,0
,20170713,2507,2507,,,,2507,2507,0,0,0,0.00,0
,20170714,2507,2507,,,,2507,2507,0,0,0,0.00,0
,20170717,2507,2507,,,,2507,2507,0,0,0,0.00,0
,20170718,2507,2507,,,,2507,2507,0,0,0,0.00,0
,20170719,2507,2507,,,,2507,2507,0,0,0,0.00,0
,20170720,2507,2507,,,,2507,2507,0,0,0,0.00,0
,20170721,2507,2507,,,,2507,2507,0,0,0,0.00,0
,20170724,2507,2507,,,,2507,2507,0,0,0,0.00,0
,20170725,2507,2507,,,,2507,2507,0,0,0,0.00,0
,20170726,2507,2507,,,,2507,2507,0,0,0,0.00,0
,20170727,2507,2507,,,,2507,2507,0,0,0,0.00,0
,20170728,2507,2507,,,,2507,2507,0,0,0,0.00,0
,20170731,2507,2507,,,,2507,2507,0,0,0,0.00,0
,20170801,2507,2507,,,,2507,2507,0,0,0,0.00,0
,20170802,2507,2507,,,,2507,2507,0,0,0,0.00,0
,20170803,2507,2507,,,,2507,2507,0,0,0,0.00,0
,20170804,2507,2507,,,,2507,2507,0,0,0,0.00,0
,20170807,2507,2507,,,,2507,2507,0,0,0,0.00,0
,20170808,2507,2507,,,,2507,2507,0,0,0,0.00,0
,20170809,2507,2507,,,,2507,2507,0,0,0,0.00,0
,20170810,2507,2507,,,,2507,2507,0,0,0,0.00,0
,20170811,2507,2507,,,,2507,2507,0,0,0,0.00,0
,20170814,2507,2507,,,,2507,2507,0,0,0,0.00,0
,20170815,2507,2507,,,,2507,2507,0,0,0,0.00,0
,20170816,2507,2507,,,,2507,2507,0,0,0,0.00,0
,20170817,2507,2507,,,,2507,2507,0,0,0,0.00,0
,20170818,2507,2507,,,,2507,2507,0,0,0,0.00,0
,20170821,2507,2507,,,,2507,2507,0,0,0,0.00,0
,20170822,2507,2507,,,,2507,2507,0,0,0,0.00,0
,20170823,2507,2507,,,,2507,2507,0,0,0,0.00,0
,20170824,2507,2507,,,,2507,2507,0,0,0,0.00,0
,20170825,2507,2507,,,,2507,2507,0,0,0,0.00,0
,20170828,2507,2507,,,,2507,2507,0,0,0,0.00,0
,20170829,2507,2507,,,,2507,2507,0,0,0,0.00,0
,20170830,2507,2507,,,,2507,2507,0,0,0,0.00,0
,20170831,2507,2507,,,,2507,2507,0,0,0,0.00,0
,20170901,2507,2507,,,,2507,2507,0,0,0,0.00,0
,20170904,2507,2507,,,,2507,2507,0,0,0,0.00,0
,20170905,2507,2507,,,,2507,2507,0,0,0,0.00,0
,20170906,2507,2507,,,,2507,2507,0,0,0,0.00,0
,20170907,2507,2507,,,,2507,2507,0,0,0,0.00,0
,20170908,2507,2507,,,,2507,2507,0,0,0,0.00,0
,20170911,2507,2507,,,,2507,2507,0,0,0,0.00,0
,20170912,2507,2507,,,,2507,2507,0,0,0,0.00,0
,20170913,2507,2507,,,,2507,2507,0,0,0,0.00,0
,20170914,2507,2507,,,,2507,2507,0,0,0,0.00,0
,20170915,2507,2507,,,,2507,2507,0,0,0,0.00,0
wr1710,20170103,2330,2330,,,,2330,2330,0,0,0,0.00,0
,20170104,2330,2330,,,,2330,2330,0,0,0,0.00,0
,20170105,2330,2330,,,,2330,2330,0,0,0,0.00,0
,20170106,2330,2330,,,,2330,2330,0,0,0,0.00,0
,20170109,2330,2330,,,,2330,2330,0,0,0,0.00,0
,20170110,2330,2330,,,,2330,2330,0,0,0,0.00,0
,20170111,2330,2330,,,,2330,2330,0,0,0,0.00,0
,20170112,2330,2330,,,,2330,2330,0,0,0,0.00,0
,20170113,2330,2330,,,,2330,2330,0,0,0,0.00,0
,20170116,2330,2330,,,,2330,2330,0,0,0,0.00,0
,20170117,2330,2330,,,,2330,2330,0,0,0,0.00,0
,20170118,2330,2330,,,,2330,2330,0,0,0,0.00,0
,20170119,2330,2330,,,,2330,2330,0,0,0,0.00,0
,20170120,2330,2330,,,,2330,2330,0,0,0,0.00,0
,20170123,2330,2330,,,,2330,2330,0,0,0,0.00,0
,20170124,2330,2330,,,,2330,2330,0,0,0,0.00,0
,20170125,2330,2330,,,,2330,2330,0,0,0,0.00,0
,20170126,2330,2330,,,,2330,2330,0,0,0,0.00,0
,20170203,2330,2330,,,,2330,2330,0,0,0,0.00,0
,20170206,2330,2330,,,,2330,2330,0,0,0,0.00,0
,20170207,2330,2330,,,,2330,2330,0,0,0,0.00,0
,20170208,2330,2330,,,,2330,2330,0,0,0,0.00,0
,20170209,2330,2330,,,,2330,2330,0,0,0,0.00,0
,20170210,2330,2330,,,,2330,2330,0,0,0,0.00,0
,20170213,2330,2330,,,,2330,2330,0,0,0,0.00,0
,20170214,2330,2330,,,,2330,2330,0,0,0,0.00,0
,20170215,2330,2330,,,,2330,2330,0,0,0,0.00,0
,20170216,2330,2330,,,,2330,2330,0,0,0,0.00,0
,20170217,2330,2330,,,,2330,2330,0,0,0,0.00,0
,20170220,2330,2330,,,,2330,2330,0,0,0,0.00,0
,20170221,2330,2330,,,,2330,2330,0,0,0,0.00,0
,20170222,2330,2330,,,,2330,2330,0,0,0,0.00,0
,20170223,2330,2330,,,,2330,2330,0,0,0,0.00,0
,20170224,2330,2330,,,,2330,2330,0,0,0,0.00,0
,20170227,2330,2330,,,,2330,2330,0,0,0,0.00,0
,20170228,2330,2330,,,,2330,2330,0,0,0,0.00,0
,20170301,2330,2330,,,,2330,2330,0,0,0,0.00,0
,20170302,2330,2330,,,,2330,2330,0,0,0,0.00,0
,20170303,2330,2330,,,,2330,2330,0,0,0,0.00,0
,20170306,2330,2330,,,,2330,2330,0,0,0,0.00,0
,20170307,2330,2330,,,,2563,2563,233,233,0,0.00,0
,20170308,2563,2563,,,,2563,2563,0,0,0,0.00,0
,20170309,2563,2563,,,,2563,2563,0,0,0,0.00,0
,20170310,2563,2563,,,,2563,2563,0,0,0,0.00,0
,20170313,2563,2563,,,,2563,2563,0,0,0,0.00,0
,20170314,2563,2563,,,,2563,2563,0,0,0,0.00,0
,20170315,2563,2563,,,,2563,2563,0,0,0,0.00,0
,20170316,2563,2563,,,,2563,2563,0,0,0,0.00,0
,20170317,2563,2563,,,,2563,2563,0,0,0,0.00,0
,20170320,2563,2563,,,,2563,2563,0,0,0,0.00,0
,20170321,2563,2563,,,,2626,2626,63,63,0,0.00,0
,20170322,2626,2626,,,,2626,2626,0,0,0,0.00,0
,20170323,2626,2626,,,,2626,2626,0,0,0,0.00,0
,20170324,2626,2626,,,,2626,2626,0,0,0,0.00,0
,20170327,2626,2626,,,,2626,2626,0,0,0,0.00,0
,20170328,2626,2626,,,,2626,2626,0,0,0,0.00,0
,20170329,2626,2626,,,,2757,2757,131,131,0,0.00,0
,20170330,2757,2757,,,,2757,2757,0,0,0,0.00,0
,20170331,2757,2757,,,,2757,2757,0,0,0,0.00,0
,20170405,2757,2757,,,,2757,2757,0,0,0,0.00,0
,20170406,2757,2757,,,,2757,2757,0,0,0,0.00,0
,20170407,2757,2757,2482,3032,2482,3032,2757,275,0,4,11.03,0
,20170410,3032,2757,,,,2757,2757,0,0,0,0.00,0
,20170411,2757,2757,,,,2757,2757,0,0,0,0.00,0
,20170412,2757,2757,,,,2757,2757,0,0,0,0.00,0
,20170413,2757,2757,,,,2757,2757,0,0,0,0.00,0
,20170414,2757,2757,,,,2757,2757,0,0,0,0.00,0
,20170417,2757,2757,,,,2757,2757,0,0,0,0.00,0
,20170418,2757,2757,,,,2757,2757,0,0,0,0.00,0
,20170419,2757,2757,,,,2757,2757,0,0,0,0.00,0
,20170420,2757,2757,,,,2757,2757,0,0,0,0.00,0
,20170421,2757,2757,,,,2757,2757,0,0,0,0.00,0
,20170424,2757,2757,,,,2757,2757,0,0,0,0.00,0
,20170425,2757,2757,,,,2757,2757,0,0,0,0.00,0
,20170426,2757,2757,2621,2621,2621,2621,2621,-136,-136,40,104.84,40
,20170427,2621,2621,2502,2752,2502,2652,2664,31,43,8,21.32,38
,20170428,2652,2664,2797,2797,2797,2797,2797,133,133,8,22.38,42
,20170502,2797,2797,2936,2936,2936,2936,2936,139,139,2,5.87,44
,20170503,2936,2936,3079,3080,3012,3012,3076,76,140,46,141.54,8
,20170504,3012,3076,3040,3040,2922,2922,2953,-154,-123,8,23.63,0
,20170505,2922,2953,,,,2953,2953,0,0,0,0.00,0
,20170508,2953,2953,,,,2953,2953,0,0,0,0.00,0
,20170509,2953,2953,,,,2953,2953,0,0,0,0.00,0
,20170510,2953,2953,,,,2953,2953,0,0,0,0.00,0
,20170511,2953,2953,,,,2953,2953,0,0,0,0.00,0
,20170512,2953,2953,,,,2953,2953,0,0,0,0.00,0
,20170515,2953,2953,,,,2953,2953,0,0,0,0.00,0
,20170516,2953,2953,,,,2953,2953,0,0,0,0.00,0
,20170517,2953,2953,,,,2953,2953,0,0,0,0.00,0
,20170518,2953,2953,,,,2953,2953,0,0,0,0.00,0
,20170519,2953,2953,,,,2953,2953,0,0,0,0.00,0
,20170522,2953,2953,,,,2953,2953,0,0,0,0.00,0
,20170523,2953,2953,,,,2953,2953,0,0,0,0.00,0
,20170524,2953,2953,,,,2953,2953,0,0,0,0.00,0
,20170525,2953,2953,,,,2953,2953,0,0,0,0.00,0
,20170526,2953,2953,,,,2953,2953,0,0,0,0.00,0
,20170531,2953,2953,,,,2953,2953,0,0,0,0.00,0
,20170601,2953,2953,,,,2953,2953,0,0,0,0.00,0
,20170602,2953,2953,,,,2953,2953,0,0,0,0.00,0
,20170605,2953,2953,,,,2953,2953,0,0,0,0.00,0
,20170606,2953,2953,,,,2953,2953,0,0,0,0.00,0
,20170607,2953,2953,,,,2953,2953,0,0,0,0.00,0
,20170608,2953,2953,,,,2953,2953,0,0,0,0.00,0
,20170609,2953,2953,,,,2953,2953,0,0,0,0.00,0
,20170612,2953,2953,,,,2953,2953,0,0,0,0.00,0
,20170613,2953,2953,,,,2953,2953,0,0,0,0.00,0
,20170614,2953,2953,,,,2953,2953,0,0,0,0.00,0
,20170615,2953,2953,,,,2953,2953,0,0,0,0.00,0
,20170616,2953,2953,,,,2953,2953,0,0,0,0.00,0
,20170619,2953,2953,,,,2953,2953,0,0,0,0.00,0
,20170620,2953,2953,,,,2953,2953,0,0,0,0.00,0
,20170621,2953,2953,,,,2953,2953,0,0,0,0.00,0
,20170622,2953,2953,,,,2953,2953,0,0,0,0.00,0
,20170623,2953,2953,,,,2953,2953,0,0,0,0.00,0
,20170626,2953,2953,,,,2953,2953,0,0,0,0.00,0
,20170627,2953,2953,,,,2953,2953,0,0,0,0.00,0
,20170628,2953,2953,,,,2953,2953,0,0,0,0.00,0
,20170629,2953,2953,,,,2953,2953,0,0,0,0.00,0
,20170630,2953,2953,,,,2953,2953,0,0,0,0.00,0
,20170703,2953,2953,,,,2953,2953,0,0,0,0.00,0
,20170704,2953,2953,,,,2953,2953,0,0,0,0.00,0
,20170705,2953,2953,,,,2953,2953,0,0,0,0.00,0
,20170706,2953,2953,,,,2953,2953,0,0,0,0.00,0
,20170707,2953,2953,,,,2953,2953,0,0,0,0.00,0
,20170710,2953,2953,,,,2953,2953,0,0,0,0.00,0
,20170711,2953,2953,,,,2953,2953,0,0,0,0.00,0
,20170712,2953,2953,,,,2953,2953,0,0,0,0.00,0
,20170713,2953,2953,,,,2953,2953,0,0,0,0.00,0
,20170714,2953,2953,,,,2953,2953,0,0,0,0.00,0
,20170717,2953,2953,,,,2953,2953,0,0,0,0.00,0
,20170718,2953,2953,2808,3100,2808,3100,2954,147,1,4,11.82,4
,20170719,3100,2954,,,,3190,3190,236,236,0,0.00,4
,20170720,3190,3190,3320,3341,3036,3180,3190,-10,0,26,82.95,12
,20170721,3180,3190,,,,3190,3190,0,0,0,0.00,12
,20170724,3190,3190,3299,3301,3299,3301,3299,111,109,16,52.79,0
,20170725,3301,3299,,,,3299,3299,0,0,0,0.00,0
,20170726,3299,3299,,,,3299,3299,0,0,0,0.00,0
,20170727,3299,3299,,,,3299,3299,0,0,0,0.00,0
,20170728,3299,3299,,,,3299,3299,0,0,0,0.00,0
,20170731,3299,3299,,,,3299,3299,0,0,0,0.00,0
,20170801,3299,3299,,,,3299,3299,0,0,0,0.00,0
,20170802,3299,3299,,,,3299,3299,0,0,0,0.00,0
,20170803,3299,3299,,,,3299,3299,0,0,0,0.00,0
,20170804,3299,3299,,,,3299,3299,0,0,0,0.00,0
,20170807,3299,3299,,,,3299,3299,0,0,0,0.00,0
,20170808,3299,3299,,,,3299,3299,0,0,0,0.00,0
,20170809,3299,3299,,,,3299,3299,0,0,0,0.00,0
,20170810,3299,3299,,,,3299,3299,0,0,0,0.00,0
,20170811,3299,3299,,,,3299,3299,0,0,0,0.00,0
,20170814,3299,3299,,,,3299,3299,0,0,0,0.00,0
,20170815,3299,3299,,,,3299,3299,0,0,0,0.00,0
,20170816,3299,3299,,,,3299,3299,0,0,0,0.00,0
,20170817,3299,3299,,,,3299,3299,0,0,0,0.00,0
,20170818,3299,3299,,,,3299,3299,0,0,0,0.00,0
,20170821,3299,3299,,,,3299,3299,0,0,0,0.00,0
,20170822,3299,3299,,,,3299,3299,0,0,0,0.00,0
,20170823,3299,3299,,,,3299,3299,0,0,0,0.00,0
,20170824,3299,3299,,,,3299,3299,0,0,0,0.00,0
,20170825,3299,3299,,,,3299,3299,0,0,0,0.00,0
,20170828,3299,3299,,,,3299,3299,0,0,0,0.00,0
,20170829,3299,3299,,,,3299,3299,0,0,0,0.00,0
,20170830,3299,3299,,,,3299,3299,0,0,0,0.00,0
,20170831,3299,3299,,,,3299,3299,0,0,0,0.00,0
,20170901,3299,3299,,,,3299,3299,0,0,0,0.00,0
,20170904,3299,3299,,,,3299,3299,0,0,0,0.00,0
,20170905,3299,3299,,,,3299,3299,0,0,0,0.00,0
,20170906,3299,3299,,,,3299,3299,0,0,0,0.00,0
,20170907,3299,3299,,,,3299,3299,0,0,0,0.00,0
,20170908,3299,3299,,,,3299,3299,0,0,0,0.00,0
,20170911,3299,3299,,,,3299,3299,0,0,0,0.00,0
,20170912,3299,3299,,,,3299,3299,0,0,0,0.00,0
,20170913,3299,3299,,,,3299,3299,0,0,0,0.00,0
,20170914,3299,3299,,,,3299,3299,0,0,0,0.00,0
,20170915,3299,3299,,,,3299,3299,0,0,0,0.00,0
,20170918,3299,3299,,,,3299,3299,0,0,0,0.00,0
,20170919,3299,3299,,,,3299,3299,0,0,0,0.00,0
,20170920,3299,3299,,,,3299,3299,0,0,0,0.00,0
,20170921,3299,3299,,,,3299,3299,0,0,0,0.00,0
,20170922,3299,3299,,,,3299,3299,0,0,0,0.00,0
,20170925,3299,3299,,,,3299,3299,0,0,0,0.00,0
,20170926,3299,3299,,,,3299,3299,0,0,0,0.00,0
,20170927,3299,3299,,,,3299,3299,0,0,0,0.00,0
,20170928,3299,3299,,,,3299,3299,0,0,0,0.00,0
,20170929,3299,3299,,,,3299,3299,0,0,0,0.00,0
,20171009,3299,3299,,,,3299,3299,0,0,0,0.00,0
,20171010,3299,3299,,,,3299,3299,0,0,0,0.00,0
,20171011,3299,3299,,,,3299,3299,0,0,0,0.00,0
,20171012,3299,3299,,,,3299,3299,0,0,0,0.00,0
,20171013,3299,3299,,,,3299,3299,0,0,0,0.00,0
,20171016,3299,3299,,,,3299,3299,0,0,0,0.00,0
wr1711,20170103,2330,2330,,,,2330,2330,0,0,0,0.00,0
,20170104,2330,2330,,,,2330,2330,0,0,0,0.00,0
,20170105,2330,2330,,,,2330,2330,0,0,0,0.00,0
,20170106,2330,2330,,,,2330,2330,0,0,0,0.00,0
,20170109,2330,2330,,,,2330,2330,0,0,0,0.00,0
,20170110,2330,2330,,,,2330,2330,0,0,0,0.00,0
,20170111,2330,2330,,,,2330,2330,0,0,0,0.00,0
,20170112,2330,2330,,,,2330,2330,0,0,0,0.00,0
,20170113,2330,2330,,,,2330,2330,0,0,0,0.00,0
,20170116,2330,2330,,,,2330,2330,0,0,0,0.00,0
,20170117,2330,2330,,,,2330,2330,0,0,0,0.00,0
,20170118,2330,2330,,,,2330,2330,0,0,0,0.00,0
,20170119,2330,2330,,,,2330,2330,0,0,0,0.00,0
,20170120,2330,2330,,,,2330,2330,0,0,0,0.00,0
,20170123,2330,2330,,,,2330,2330,0,0,0,0.00,0
,20170124,2330,2330,,,,2330,2330,0,0,0,0.00,0
,20170125,2330,2330,,,,2330,2330,0,0,0,0.00,0
,20170126,2330,2330,,,,2330,2330,0,0,0,0.00,0
,20170203,2330,2330,,,,2330,2330,0,0,0,0.00,0
,20170206,2330,2330,,,,2330,2330,0,0,0,0.00,0
,20170207,2330,2330,,,,2330,2330,0,0,0,0.00,0
,20170208,2330,2330,,,,2330,2330,0,0,0,0.00,0
,20170209,2330,2330,,,,2330,2330,0,0,0,0.00,0
,20170210,2330,2330,,,,2330,2330,0,0,0,0.00,0
,20170213,2330,2330,,,,2330,2330,0,0,0,0.00,0
,20170214,2330,2330,,,,2330,2330,0,0,0,0.00,0
,20170215,2330,2330,,,,2330,2330,0,0,0,0.00,0
,20170216,2330,2330,,,,2330,2330,0,0,0,0.00,0
,20170217,2330,2330,,,,2330,2330,0,0,0,0.00,0
,20170220,2330,2330,,,,2330,2330,0,0,0,0.00,0
,20170221,2330,2330,,,,2330,2330,0,0,0,0.00,0
,20170222,2330,2330,,,,2330,2330,0,0,0,0.00,0
,20170223,2330,2330,,,,2330,2330,0,0,0,0.00,0
,20170224,2330,2330,,,,2330,2330,0,0,0,0.00,0
,20170227,2330,2330,,,,2330,2330,0,0,0,0.00,0
,20170228,2330,2330,,,,2330,2330,0,0,0,0.00,0
,20170301,2330,2330,,,,2330,2330,0,0,0,0.00,0
,20170302,2330,2330,,,,2330,2330,0,0,0,0.00,0
,20170303,2330,2330,,,,2330,2330,0,0,0,0.00,0
,20170306,2330,2330,,,,2330,2330,0,0,0,0.00,0
,20170307,2330,2330,,,,2330,2330,0,0,0,0.00,0
,20170308,2330,2330,,,,2330,2330,0,0,0,0.00,0
,20170309,2330,2330,,,,2330,2330,0,0,0,0.00,0
,20170310,2330,2330,,,,2330,2330,0,0,0,0.00,0
,20170313,2330,2330,,,,2330,2330,0,0,0,0.00,0
,20170314,2330,2330,,,,2330,2330,0,0,0,0.00,0
,20170315,2330,2330,,,,2330,2330,0,0,0,0.00,0
,20170316,2330,2330,,,,2330,2330,0,0,0,0.00,0
,20170317,2330,2330,,,,2330,2330,0,0,0,0.00,0
,20170320,2330,2330,,,,2330,2330,0,0,0,0.00,0
,20170321,2330,2330,,,,2388,2388,58,58,0,0.00,0
,20170322,2388,2388,,,,2388,2388,0,0,0,0.00,0
,20170323,2388,2388,,,,2388,2388,0,0,0,0.00,0
,20170324,2388,2388,,,,2388,2388,0,0,0,0.00,0
,20170327,2388,2388,,,,2388,2388,0,0,0,0.00,0
,20170328,2388,2388,,,,2388,2388,0,0,0,0.00,0
,20170329,2388,2388,,,,2507,2507,119,119,0,0.00,0
,20170330,2507,2507,,,,2507,2507,0,0,0,0.00,0
,20170331,2507,2507,,,,2507,2507,0,0,0,0.00,0
,20170405,2507,2507,,,,2507,2507,0,0,0,0.00,0
,20170406,2507,2507,,,,2507,2507,0,0,0,0.00,0
,20170407,2507,2507,,,,2507,2507,0,0,0,0.00,0
,20170410,2507,2507,,,,2507,2507,0,0,0,0.00,0
,20170411,2507,2507,,,,2507,2507,0,0,0,0.00,0
,20170412,2507,2507,,,,2507,2507,0,0,0,0.00,0
,20170413,2507,2507,,,,2507,2507,0,0,0,0.00,0
,20170414,2507,2507,,,,2507,2507,0,0,0,0.00,0
,20170417,2507,2507,,,,2507,2507,0,0,0,0.00,0
,20170418,2507,2507,,,,2507,2507,0,0,0,0.00,0
,20170419,2507,2507,,,,2507,2507,0,0,0,0.00,0
,20170420,2507,2507,,,,2507,2507,0,0,0,0.00,0
,20170421,2507,2507,,,,2507,2507,0,0,0,0.00,0
,20170424,2507,2507,,,,2507,2507,0,0,0,0.00,0
,20170425,2507,2507,,,,2507,2507,0,0,0,0.00,0
,20170426,2507,2507,,,,2383,2383,-124,-124,0,0.00,0
,20170427,2383,2383,,,,2422,2422,39,39,0,0.00,0
,20170428,2422,2422,,,,2542,2542,120,120,0,0.00,0
,20170502,2542,2542,,,,2668,2668,126,126,0,0.00,0
,20170503,2668,2668,,,,2796,2796,128,128,0,0.00,0
,20170504,2796,2796,,,,2684,2684,-112,-112,0,0.00,0
,20170505,2684,2684,,,,2684,2684,0,0,0,0.00,0
,20170508,2684,2684,,,,2684,2684,0,0,0,0.00,0
,20170509,2684,2684,,,,2684,2684,0,0,0,0.00,0
,20170510,2684,2684,,,,2684,2684,0,0,0,0.00,0
,20170511,2684,2684,,,,2684,2684,0,0,0,0.00,0
,20170512,2684,2684,,,,2684,2684,0,0,0,0.00,0
,20170515,2684,2684,,,,2684,2684,0,0,0,0.00,0
,20170516,2684,2684,,,,2684,2684,0,0,0,0.00,0
,20170517,2684,2684,,,,2684,2684,0,0,0,0.00,0
,20170518,2684,2684,,,,2684,2684,0,0,0,0.00,0
,20170519,2684,2684,,,,2684,2684,0,0,0,0.00,0
,20170522,2684,2684,,,,2684,2684,0,0,0,0.00,0
,20170523,2684,2684,,,,2684,2684,0,0,0,0.00,0
,20170524,2684,2684,,,,2684,2684,0,0,0,0.00,0
,20170525,2684,2684,,,,2684,2684,0,0,0,0.00,0
,20170526,2684,2684,,,,2684,2684,0,0,0,0.00,0
,20170531,2684,2684,,,,2684,2684,0,0,0,0.00,0
,20170601,2684,2684,,,,2684,2684,0,0,0,0.00,0
,20170602,2684,2684,,,,2684,2684,0,0,0,0.00,0
,20170605,2684,2684,,,,2684,2684,0,0,0,0.00,0
,20170606,2684,2684,,,,2684,2684,0,0,0,0.00,0
,20170607,2684,2684,,,,2684,2684,0,0,0,0.00,0
,20170608,2684,2684,,,,2684,2684,0,0,0,0.00,0
,20170609,2684,2684,,,,2684,2684,0,0,0,0.00,0
,20170612,2684,2684,,,,2684,2684,0,0,0,0.00,0
,20170613,2684,2684,,,,2684,2684,0,0,0,0.00,0
,20170614,2684,2684,,,,2684,2684,0,0,0,0.00,0
,20170615,2684,2684,,,,2684,2684,0,0,0,0.00,0
,20170616,2684,2684,,,,2684,2684,0,0,0,0.00,0
,20170619,2684,2684,,,,2684,2684,0,0,0,0.00,0
,20170620,2684,2684,,,,2684,2684,0,0,0,0.00,0
,20170621,2684,2684,,,,2684,2684,0,0,0,0.00,0
,20170622,2684,2684,,,,2684,2684,0,0,0,0.00,0
,20170623,2684,2684,,,,2684,2684,0,0,0,0.00,0
,20170626,2684,2684,,,,2684,2684,0,0,0,0.00,0
,20170627,2684,2684,,,,2684,2684,0,0,0,0.00,0
,20170628,2684,2684,,,,2684,2684,0,0,0,0.00,0
,20170629,2684,2684,,,,2684,2684,0,0,0,0.00,0
,20170630,2684,2684,,,,2684,2684,0,0,0,0.00,0
,20170703,2684,2684,,,,2684,2684,0,0,0,0.00,0
,20170704,2684,2684,,,,2684,2684,0,0,0,0.00,0
,20170705,2684,2684,,,,2684,2684,0,0,0,0.00,0
,20170706,2684,2684,,,,2684,2684,0,0,0,0.00,0
,20170707,2684,2684,,,,2684,2684,0,0,0,0.00,0
,20170710,2684,2684,,,,2684,2684,0,0,0,0.00,0
,20170711,2684,2684,,,,2684,2684,0,0,0,0.00,0
,20170712,2684,2684,,,,2684,2684,0,0,0,0.00,0
,20170713,2684,2684,,,,2684,2684,0,0,0,0.00,0
,20170714,2684,2684,,,,2684,2684,0,0,0,0.00,0
,20170717,2684,2684,,,,2684,2684,0,0,0,0.00,0
,20170718,2684,2684,,,,2684,2684,0,0,0,0.00,0
,20170719,2684,2684,,,,2684,2684,0,0,0,0.00,0
,20170720,2684,2684,,,,2684,2684,0,0,0,0.00,0
,20170721,2684,2684,,,,2684,2684,0,0,0,0.00,0
,20170724,2684,2684,,,,2776,2776,92,92,0,0.00,0
,20170725,2776,2776,,,,2776,2776,0,0,0,0.00,0
,20170726,2776,2776,,,,2776,2776,0,0,0,0.00,0
,20170727,2776,2776,,,,2776,2776,0,0,0,0.00,0
,20170728,2776,2776,,,,2776,2776,0,0,0,0.00,0
,20170731,2776,2776,,,,2776,2776,0,0,0,0.00,0
,20170801,2776,2776,,,,2776,2776,0,0,0,0.00,0
,20170802,2776,2776,,,,2776,2776,0,0,0,0.00,0
,20170803,2776,2776,,,,2776,2776,0,0,0,0.00,0
,20170804,2776,2776,,,,2776,2776,0,0,0,0.00,0
,20170807,2776,2776,,,,2776,2776,0,0,0,0.00,0
,20170808,2776,2776,,,,2776,2776,0,0,0,0.00,0
,20170809,2776,2776,,,,2776,2776,0,0,0,0.00,0
,20170810,2776,2776,,,,2776,2776,0,0,0,0.00,0
,20170811,2776,2776,,,,2776,2776,0,0,0,0.00,0
,20170814,2776,2776,,,,2776,2776,0,0,0,0.00,0
,20170815,2776,2776,,,,2776,2776,0,0,0,0.00,0
,20170816,2776,2776,,,,2776,2776,0,0,0,0.00,0
,20170817,2776,2776,,,,2776,2776,0,0,0,0.00,0
,20170818,2776,2776,,,,2776,2776,0,0,0,0.00,0
,20170821,2776,2776,,,,2776,2776,0,0,0,0.00,0
,20170822,2776,2776,,,,2776,2776,0,0,0,0.00,0
,20170823,2776,2776,,,,2776,2776,0,0,0,0.00,0
,20170824,2776,2776,,,,2776,2776,0,0,0,0.00,0
,20170825,2776,2776,,,,2776,2776,0,0,0,0.00,0
,20170828,2776,2776,,,,2776,2776,0,0,0,0.00,0
,20170829,2776,2776,,,,2776,2776,0,0,0,0.00,0
,20170830,2776,2776,,,,2776,2776,0,0,0,0.00,0
,20170831,2776,2776,,,,2776,2776,0,0,0,0.00,0
,20170901,2776,2776,,,,2776,2776,0,0,0,0.00,0
,20170904,2776,2776,,,,2776,2776,0,0,0,0.00,0
,20170905,2776,2776,,,,2776,2776,0,0,0,0.00,0
,20170906,2776,2776,,,,2776,2776,0,0,0,0.00,0
,20170907,2776,2776,,,,2776,2776,0,0,0,0.00,0
,20170908,2776,2776,,,,2776,2776,0,0,0,0.00,0
,20170911,2776,2776,,,,2776,2776,0,0,0,0.00,0
,20170912,2776,2776,,,,2776,2776,0,0,0,0.00,0
,20170913,2776,2776,,,,2776,2776,0,0,0,0.00,0
,20170914,2776,2776,,,,2776,2776,0,0,0,0.00,0
,20170915,2776,2776,,,,2776,2776,0,0,0,0.00,0
,20170918,2776,2776,,,,2776,2776,0,0,0,0.00,0
,20170919,2776,2776,,,,2776,2776,0,0,0,0.00,0
,20170920,2776,2776,,,,2776,2776,0,0,0,0.00,0
,20170921,2776,2776,,,,2776,2776,0,0,0,0.00,0
,20170922,2776,2776,,,,2776,2776,0,0,0,0.00,0
,20170925,2776,2776,,,,2776,2776,0,0,0,0.00,0
,20170926,2776,2776,,,,2776,2776,0,0,0,0.00,0
,20170927,2776,2776,,,,2776,2776,0,0,0,0.00,0
,20170928,2776,2776,,,,2776,2776,0,0,0,0.00,0
,20170929,2776,2776,,,,2776,2776,0,0,0,0.00,0
,20171009,2776,2776,,,,2776,2776,0,0,0,0.00,0
,20171010,2776,2776,,,,2776,2776,0,0,0,0.00,0
,20171011,2776,2776,,,,2776,2776,0,0,0,0.00,0
,20171012,2776,2776,,,,2776,2776,0,0,0,0.00,0
,20171013,2776,2776,,,,2776,2776,0,0,0,0.00,0
,20171016,2776,2776,,,,2776,2776,0,0,0,0.00,0
,20171017,2776,2776,,,,2776,2776,0,0,0,0.00,0
,20171018,2776,2776,,,,2776,2776,0,0,0,0.00,0
,20171019,2776,2776,,,,2776,2776,0,0,0,0.00,0
,20171020,2776,2776,,,,2776,2776,0,0,0,0.00,0
,20171023,2776,2776,,,,2776,2776,0,0,0,0.00,0
,20171024,2776,2776,,,,2776,2776,0,0,0,0.00,0
,20171025,2776,2776,,,,2776,2776,0,0,0,0.00,0
,20171026,2776,2776,,,,2776,2776,0,0,0,0.00,0
,20171027,2776,2776,,,,2776,2776,0,0,0,0.00,0
,20171030,2776,2776,,,,2776,2776,0,0,0,0.00,0
,20171031,2776,2776,,,,2776,2776,0,0,0,0.00,0
,20171101,2776,2776,,,,2776,2776,0,0,0,0.00,0
,20171102,2776,2776,,,,2776,2776,0,0,0,0.00,0
,20171103,2776,2776,,,,2776,2776,0,0,0,0.00,0
,20171106,2776,2776,,,,2776,2776,0,0,0,0.00,0
,20171107,2776,2776,,,,2776,2776,0,0,0,0.00,0
,20171108,2776,2776,,,,2776,2776,0,0,0,0.00,0
,20171109,2776,2776,,,,2776,2776,0,0,0,0.00,0
,20171110,2776,2776,,,,2776,2776,0,0,0,0.00,0
,20171113,2776,2776,,,,2776,2776,0,0,0,0.00,0
,20171114,2776,2776,,,,2776,2776,0,0,0,0.00,0
,20171115,2776,2776,,,,2776,2776,0,0,0,0.00,0
wr1712,20170103,2767,2767,,,,2767,2767,0,0,0,0.00,0
,20170104,2767,2767,,,,2767,2767,0,0,0,0.00,0
,20170105,2767,2767,,,,2767,2767,0,0,0,0.00,0
,20170106,2767,2767,,,,2767,2767,0,0,0,0.00,0
,20170109,2767,2767,,,,2767,2767,0,0,0,0.00,0
,20170110,2767,2767,,,,2767,2767,0,0,0,0.00,0
,20170111,2767,2767,,,,2767,2767,0,0,0,0.00,0
,20170112,2767,2767,,,,2767,2767,0,0,0,0.00,0
,20170113,2767,2767,,,,2767,2767,0,0,0,0.00,0
,20170116,2767,2767,,,,2767,2767,0,0,0,0.00,0
,20170117,2767,2767,,,,2767,2767,0,0,0,0.00,0
,20170118,2767,2767,,,,2767,2767,0,0,0,0.00,0
,20170119,2767,2767,,,,2767,2767,0,0,0,0.00,0
,20170120,2767,2767,,,,2767,2767,0,0,0,0.00,0
,20170123,2767,2767,,,,2767,2767,0,0,0,0.00,0
,20170124,2767,2767,,,,2767,2767,0,0,0,0.00,0
,20170125,2767,2767,,,,2767,2767,0,0,0,0.00,0
,20170126,2767,2767,,,,2767,2767,0,0,0,0.00,0
,20170203,2767,2767,,,,2767,2767,0,0,0,0.00,0
,20170206,2767,2767,,,,2767,2767,0,0,0,0.00,0
,20170207,2767,2767,,,,2767,2767,0,0,0,0.00,0
,20170208,2767,2767,,,,2767,2767,0,0,0,0.00,0
,20170209,2767,2767,,,,2767,2767,0,0,0,0.00,0
,20170210,2767,2767,,,,2767,2767,0,0,0,0.00,0
,20170213,2767,2767,,,,2767,2767,0,0,0,0.00,0
,20170214,2767,2767,,,,2767,2767,0,0,0,0.00,0
,20170215,2767,2767,,,,2767,2767,0,0,0,0.00,0
,20170216,2767,2767,,,,2767,2767,0,0,0,0.00,0
,20170217,2767,2767,,,,2767,2767,0,0,0,0.00,0
,20170220,2767,2767,,,,2767,2767,0,0,0,0.00,0
,20170221,2767,2767,,,,2767,2767,0,0,0,0.00,0
,20170222,2767,2767,,,,2767,2767,0,0,0,0.00,0
,20170223,2767,2767,,,,2767,2767,0,0,0,0.00,0
,20170224,2767,2767,,,,2767,2767,0,0,0,0.00,0
,20170227,2767,2767,,,,2767,2767,0,0,0,0.00,0
,20170228,2767,2767,,,,2767,2767,0,0,0,0.00,0
,20170301,2767,2767,2629,2632,2629,2632,2630,-135,-137,4,10.52,2
,20170302,2632,2630,,,,2761,2761,131,131,0,0.00,2
,20170303,2761,2761,2899,2899,2899,2899,2899,138,138,4,11.60,4
,20170306,2899,2899,3043,3043,3043,3043,3043,144,144,8,24.34,4
,20170307,3043,3043,,,,3043,3043,0,0,0,0.00,4
,20170308,3043,3043,,,,3043,3043,0,0,0,0.00,4
,20170309,3043,3043,,,,3043,3043,0,0,0,0.00,4
,20170310,3043,3043,,,,3043,3043,0,0,0,0.00,4
,20170313,3043,3043,,,,3043,3043,0,0,0,0.00,4
,20170314,3043,3043,,,,3043,3043,0,0,0,0.00,4
,20170315,3043,3043,,,,3043,3043,0,0,0,0.00,4
,20170316,3043,3043,,,,3100,3100,57,57,0,0.00,4
,20170317,3100,3100,,,,3200,3200,100,100,0,0.00,4
,20170320,3200,3200,,,,3200,3200,0,0,0,0.00,4
,20170321,3200,3200,,,,3279,3279,79,79,0,0.00,4
,20170322,3279,3279,,,,3279,3279,0,0,0,0.00,4
,20170323,3279,3279,,,,3279,3279,0,0,0,0.00,4
,20170324,3279,3279,,,,3279,3279,0,0,0,0.00,4
,20170327,3279,3279,,,,3279,3279,0,0,0,0.00,4
,20170328,3279,3279,,,,3279,3279,0,0,0,0.00,4
,20170329,3279,3279,,,,3442,3442,163,163,0,0.00,4
,20170330,3442,3442,,,,3442,3442,0,0,0,0.00,4
,20170331,3442,3442,,,,3442,3442,0,0,0,0.00,4
,20170405,3442,3442,,,,3442,3442,0,0,0,0.00,4
,20170406,3442,3442,,,,3442,3442,0,0,0,0.00,4
,20170407,3442,3442,,,,3442,3442,0,0,0,0.00,4
,20170410,3442,3442,3270,3270,3270,3270,3270,-172,-172,2,6.54,4
,20170411,3270,3270,,,,3270,3270,0,0,0,0.00,4
,20170412,3270,3270,,,,3270,3270,0,0,0,0.00,4
,20170413,3270,3270,,,,3270,3270,0,0,0,0.00,4
,20170414,3270,3270,,,,3270,3270,0,0,0,0.00,4
,20170417,3270,3270,,,,3270,3270,0,0,0,0.00,4
,20170418,3270,3270,,,,3270,3270,0,0,0,0.00,4
,20170419,3270,3270,3108,3300,3108,3300,3162,30,-108,8,25.30,4
,20170420,3300,3162,,,,3162,3162,0,0,0,0.00,4
,20170421,3162,3162,,,,3162,3162,0,0,0,0.00,4
,20170424,3162,3162,,,,3162,3162,0,0,0,0.00,4
,20170425,3162,3162,,,,3162,3162,0,0,0,0.00,4
,20170426,3162,3162,,,,3006,3006,-156,-156,0,0.00,4
,20170427,3006,3006,,,,3055,3055,49,49,0,0.00,4
,20170428,3055,3055,3156,3156,3156,3156,3156,101,101,4,12.62,0
,20170502,3156,3156,,,,3312,3312,156,156,0,0.00,0
,20170503,3312,3312,,,,3470,3470,158,158,0,0.00,0
,20170504,3470,3470,,,,3331,3331,-139,-139,0,0.00,0
,20170505,3331,3331,,,,3331,3331,0,0,0,0.00,0
,20170508,3331,3331,,,,3331,3331,0,0,0,0.00,0
,20170509,3331,3331,,,,3331,3331,0,0,0,0.00,0
,20170510,3331,3331,,,,3331,3331,0,0,0,0.00,0
,20170511,3331,3331,,,,3331,3331,0,0,0,0.00,0
,20170512,3331,3331,,,,3331,3331,0,0,0,0.00,0
,20170515,3331,3331,,,,3331,3331,0,0,0,0.00,0
,20170516,3331,3331,,,,3331,3331,0,0,0,0.00,0
,20170517,3331,3331,,,,3331,3331,0,0,0,0.00,0
,20170518,3331,3331,,,,3331,3331,0,0,0,0.00,0
,20170519,3331,3331,,,,3331,3331,0,0,0,0.00,0
,20170522,3331,3331,,,,3331,3331,0,0,0,0.00,0
,20170523,3331,3331,,,,3331,3331,0,0,0,0.00,0
,20170524,3331,3331,,,,3331,3331,0,0,0,0.00,0
,20170525,3331,3331,,,,3331,3331,0,0,0,0.00,0
,20170526,3331,3331,,,,3331,3331,0,0,0,0.00,0
,20170531,3331,3331,,,,3331,3331,0,0,0,0.00,0
,20170601,3331,3331,,,,3331,3331,0,0,0,0.00,0
,20170602,3331,3331,,,,3331,3331,0,0,0,0.00,0
,20170605,3331,3331,,,,3331,3331,0,0,0,0.00,0
,20170606,3331,3331,,,,3331,3331,0,0,0,0.00,0
,20170607,3331,3331,,,,3331,3331,0,0,0,0.00,0
,20170608,3331,3331,,,,3331,3331,0,0,0,0.00,0
,20170609,3331,3331,,,,3331,3331,0,0,0,0.00,0
,20170612,3331,3331,,,,3331,3331,0,0,0,0.00,0
,20170613,3331,3331,,,,3331,3331,0,0,0,0.00,0
,20170614,3331,3331,,,,3331,3331,0,0,0,0.00,0
,20170615,3331,3331,,,,3331,3331,0,0,0,0.00,0
,20170616,3331,3331,,,,3331,3331,0,0,0,0.00,0
,20170619,3331,3331,,,,3331,3331,0,0,0,0.00,0
,20170620,3331,3331,,,,3331,3331,0,0,0,0.00,0
,20170621,3331,3331,,,,3331,3331,0,0,0,0.00,0
,20170622,3331,3331,,,,3331,3331,0,0,0,0.00,0
,20170623,3331,3331,,,,3331,3331,0,0,0,0.00,0
,20170626,3331,3331,,,,3331,3331,0,0,0,0.00,0
,20170627,3331,3331,,,,3331,3331,0,0,0,0.00,0
,20170628,3331,3331,,,,3331,3331,0,0,0,0.00,0
,20170629,3331,3331,,,,3331,3331,0,0,0,0.00,0
,20170630,3331,3331,,,,3331,3331,0,0,0,0.00,0
,20170703,3331,3331,,,,3331,3331,0,0,0,0.00,0
,20170704,3331,3331,,,,3331,3331,0,0,0,0.00,0
,20170705,3331,3331,,,,3331,3331,0,0,0,0.00,0
,20170706,3331,3331,,,,3331,3331,0,0,0,0.00,0
,20170707,3331,3331,,,,3331,3331,0,0,0,0.00,0
,20170710,3331,3331,,,,3331,3331,0,0,0,0.00,0
,20170711,3331,3331,,,,3331,3331,0,0,0,0.00,0
,20170712,3331,3331,,,,3331,3331,0,0,0,0.00,0
,20170713,3331,3331,,,,3331,3331,0,0,0,0.00,0
,20170714,3331,3331,,,,3331,3331,0,0,0,0.00,0
,20170717,3331,3331,,,,3331,3331,0,0,0,0.00,0
,20170718,3331,3331,,,,3332,3332,1,1,0,0.00,0
,20170719,3332,3332,,,,3332,3332,0,0,0,0.00,0
,20170720,3332,3332,,,,3332,3332,0,0,0,0.00,0
,20170721,3332,3332,,,,3332,3332,0,0,0,0.00,0
,20170724,3332,3332,,,,3446,3446,114,114,0,0.00,0
,20170725,3446,3446,,,,3446,3446,0,0,0,0.00,0
,20170726,3446,3446,,,,3446,3446,0,0,0,0.00,0
,20170727,3446,3446,,,,3446,3446,0,0,0,0.00,0
,20170728,3446,3446,,,,3446,3446,0,0,0,0.00,0
,20170731,3446,3446,,,,3446,3446,0,0,0,0.00,0
,20170801,3446,3446,,,,3446,3446,0,0,0,0.00,0
,20170802,3446,3446,,,,3446,3446,0,0,0,0.00,0
,20170803,3446,3446,,,,3446,3446,0,0,0,0.00,0
,20170804,3446,3446,,,,3446,3446,0,0,0,0.00,0
,20170807,3446,3446,,,,3446,3446,0,0,0,0.00,0
,20170808,3446,3446,,,,3446,3446,0,0,0,0.00,0
,20170809,3446,3446,,,,3446,3446,0,0,0,0.00,0
,20170810,3446,3446,,,,3446,3446,0,0,0,0.00,0
,20170811,3446,3446,,,,3446,3446,0,0,0,0.00,0
,20170814,3446,3446,,,,3446,3446,0,0,0,0.00,0
,20170815,3446,3446,,,,3446,3446,0,0,0,0.00,0
,20170816,3446,3446,,,,3446,3446,0,0,0,0.00,0
,20170817,3446,3446,,,,3446,3446,0,0,0,0.00,0
,20170818,3446,3446,,,,3446,3446,0,0,0,0.00,0
,20170821,3446,3446,,,,3446,3446,0,0,0,0.00,0
,20170822,3446,3446,,,,3446,3446,0,0,0,0.00,0
,20170823,3446,3446,,,,3446,3446,0,0,0,0.00,0
,20170824,3446,3446,,,,3446,3446,0,0,0,0.00,0
,20170825,3446,3446,,,,3446,3446,0,0,0,0.00,0
,20170828,3446,3446,,,,3446,3446,0,0,0,0.00,0
,20170829,3446,3446,,,,3446,3446,0,0,0,0.00,0
,20170830,3446,3446,,,,3446,3446,0,0,0,0.00,0
,20170831,3446,3446,,,,3446,3446,0,0,0,0.00,0
,20170901,3446,3446,,,,3446,3446,0,0,0,0.00,0
,20170904,3446,3446,,,,3446,3446,0,0,0,0.00,0
,20170905,3446,3446,,,,3446,3446,0,0,0,0.00,0
,20170906,3446,3446,,,,3446,3446,0,0,0,0.00,0
,20170907,3446,3446,,,,3446,3446,0,0,0,0.00,0
,20170908,3446,3446,,,,3446,3446,0,0,0,0.00,0
,20170911,3446,3446,,,,3446,3446,0,0,0,0.00,0
,20170912,3446,3446,,,,3446,3446,0,0,0,0.00,0
,20170913,3446,3446,,,,3446,3446,0,0,0,0.00,0
,20170914,3446,3446,,,,3446,3446,0,0,0,0.00,0
,20170915,3446,3446,,,,3446,3446,0,0,0,0.00,0
,20170918,3446,3446,,,,3446,3446,0,0,0,0.00,0
,20170919,3446,3446,,,,3446,3446,0,0,0,0.00,0
,20170920,3446,3446,,,,3446,3446,0,0,0,0.00,0
,20170921,3446,3446,,,,3446,3446,0,0,0,0.00,0
,20170922,3446,3446,,,,3446,3446,0,0,0,0.00,0
,20170925,3446,3446,,,,3446,3446,0,0,0,0.00,0
,20170926,3446,3446,,,,3446,3446,0,0,0,0.00,0
,20170927,3446,3446,,,,3446,3446,0,0,0,0.00,0
,20170928,3446,3446,,,,3446,3446,0,0,0,0.00,0
,20170929,3446,3446,,,,3446,3446,0,0,0,0.00,0
,20171009,3446,3446,,,,3446,3446,0,0,0,0.00,0
,20171010,3446,3446,,,,3446,3446,0,0,0,0.00,0
,20171011,3446,3446,,,,3446,3446,0,0,0,0.00,0
,20171012,3446,3446,,,,3446,3446,0,0,0,0.00,0
,20171013,3446,3446,,,,3446,3446,0,0,0,0.00,0
,20171016,3446,3446,,,,3446,3446,0,0,0,0.00,0
,20171017,3446,3446,,,,3446,3446,0,0,0,0.00,0
,20171018,3446,3446,,,,3446,3446,0,0,0,0.00,0
,20171019,3446,3446,,,,3446,3446,0,0,0,0.00,0
,20171020,3446,3446,,,,3446,3446,0,0,0,0.00,0
,20171023,3446,3446,,,,3446,3446,0,0,0,0.00,0
,20171024,3446,3446,,,,3446,3446,0,0,0,0.00,0
,20171025,3446,3446,,,,3446,3446,0,0,0,0.00,0
,20171026,3446,3446,,,,3446,3446,0,0,0,0.00,0
,20171027,3446,3446,,,,3446,3446,0,0,0,0.00,0
,20171030,3446,3446,,,,3446,3446,0,0,0,0.00,0
,20171031,3446,3446,,,,3446,3446,0,0,0,0.00,0
,20171101,3446,3446,,,,3446,3446,0,0,0,0.00,0
,20171102,3446,3446,,,,3446,3446,0,0,0,0.00,0
,20171103,3446,3446,,,,3446,3446,0,0,0,0.00,0
,20171106,3446,3446,,,,3446,3446,0,0,0,0.00,0
,20171107,3446,3446,,,,3446,3446,0,0,0,0.00,0
,20171108,3446,3446,,,,3446,3446,0,0,0,0.00,0
,20171109,3446,3446,,,,3446,3446,0,0,0,0.00,0
,20171110,3446,3446,,,,3446,3446,0,0,0,0.00,0
,20171113,3446,3446,,,,3446,3446,0,0,0,0.00,0
,20171114,3446,3446,,,,3446,3446,0,0,0,0.00,0
,20171115,3446,3446,,,,3446,3446,0,0,0,0.00,0
,20171116,3446,3446,,,,3446,3446,0,0,0,0.00,0
,20171117,3446,3446,,,,3446,3446,0,0,0,0.00,0
,20171120,3446,3446,,,,3446,3446,0,0,0,0.00,0
,20171121,3446,3446,,,,3446,3446,0,0,0,0.00,0
,20171122,3446,3446,,,,3446,3446,0,0,0,0.00,0
,20171123,3446,3446,,,,3446,3446,0,0,0,0.00,0
,20171124,3446,3446,,,,3446,3446,0,0,0,0.00,0
,20171127,3446,3446,,,,3446,3446,0,0,0,0.00,0
,20171128,3446,3446,,,,3446,3446,0,0,0,0.00,0
,20171129,3446,3446,,,,3446,3446,0,0,0,0.00,0
,20171130,3446,3446,,,,3446,3446,0,0,0,0.00,0
,20171201,3446,3446,,,,3446,3446,0,0,0,0.00,0
,20171204,3446,3446,,,,3446,3446,0,0,0,0.00,0
,20171205,3446,3446,,,,3446,3446,0,0,0,0.00,0
,20171206,3446,3446,,,,3446,3446,0,0,0,0.00,0
,20171207,3446,3446,,,,3446,3446,0,0,0,0.00,0
,20171208,3446,3446,,,,3446,3446,0,0,0,0.00,0
,20171211,3446,3446,,,,3446,3446,0,0,0,0.00,0
,20171212,3446,3446,,,,3446,3446,0,0,0,0.00,0
,20171213,3446,3446,,,,3446,3446,0,0,0,0.00,0
,20171214,3446,3446,,,,3446,3446,0,0,0,0.00,0
,20171215,3446,3446,,,,3446,3446,0,0,0,0.00,0
wr1801,20170117,2767,2767,,,,2767,2767,0,0,0,0.00,0
,20170118,2767,2767,,,,2767,2767,0,0,0,0.00,0
,20170119,2767,2767,,,,2767,2767,0,0,0,0.00,0
,20170120,2767,2767,,,,2767,2767,0,0,0,0.00,0
,20170123,2767,2767,,,,2767,2767,0,0,0,0.00,0
,20170124,2767,2767,,,,2767,2767,0,0,0,0.00,0
,20170125,2767,2767,,,,2767,2767,0,0,0,0.00,0
,20170126,2767,2767,,,,2767,2767,0,0,0,0.00,0
,20170203,2767,2767,,,,2767,2767,0,0,0,0.00,0
,20170206,2767,2767,,,,2767,2767,0,0,0,0.00,0
,20170207,2767,2767,,,,2767,2767,0,0,0,0.00,0
,20170208,2767,2767,,,,2767,2767,0,0,0,0.00,0
,20170209,2767,2767,,,,2767,2767,0,0,0,0.00,0
,20170210,2767,2767,,,,2767,2767,0,0,0,0.00,0
,20170213,2767,2767,,,,2767,2767,0,0,0,0.00,0
,20170214,2767,2767,,,,2767,2767,0,0,0,0.00,0
,20170215,2767,2767,,,,2767,2767,0,0,0,0.00,0
,20170216,2767,2767,,,,2767,2767,0,0,0,0.00,0
,20170217,2767,2767,,,,2767,2767,0,0,0,0.00,0
,20170220,2767,2767,,,,2767,2767,0,0,0,0.00,0
,20170221,2767,2767,,,,2767,2767,0,0,0,0.00,0
,20170222,2767,2767,,,,2767,2767,0,0,0,0.00,0
,20170223,2767,2767,,,,2767,2767,0,0,0,0.00,0
,20170224,2767,2767,,,,2767,2767,0,0,0,0.00,0
,20170227,2767,2767,,,,2767,2767,0,0,0,0.00,0
,20170228,2767,2767,,,,2767,2767,0,0,0,0.00,0
,20170301,2767,2767,,,,2630,2630,-137,-137,0,0.00,0
,20170302,2630,2630,,,,2630,2630,0,0,0,0.00,0
,20170303,2630,2630,,,,2761,2761,131,131,0,0.00,0
,20170306,2761,2761,,,,2898,2898,137,137,0,0.00,0
,20170307,2898,2898,,,,2898,2898,0,0,0,0.00,0
,20170308,2898,2898,,,,2898,2898,0,0,0,0.00,0
,20170309,2898,2898,,,,2898,2898,0,0,0,0.00,0
,20170310,2898,2898,,,,2898,2898,0,0,0,0.00,0
,20170313,2898,2898,,,,2898,2898,0,0,0,0.00,0
,20170314,2898,2898,,,,2898,2898,0,0,0,0.00,0
,20170315,2898,2898,,,,2898,2898,0,0,0,0.00,0
,20170316,2898,2898,,,,2898,2898,0,0,0,0.00,0
,20170317,2898,2898,,,,2898,2898,0,0,0,0.00,0
,20170320,2898,2898,,,,2898,2898,0,0,0,0.00,0
,20170321,2898,2898,,,,2970,2970,72,72,0,0.00,0
,20170322,2970,2970,,,,2970,2970,0,0,0,0.00,0
,20170323,2970,2970,,,,2970,2970,0,0,0,0.00,0
,20170324,2970,2970,,,,2970,2970,0,0,0,0.00,0
,20170327,2970,2970,,,,2970,2970,0,0,0,0.00,0
,20170328,2970,2970,,,,2970,2970,0,0,0,0.00,0
,20170329,2970,2970,,,,3118,3118,148,148,0,0.00,0
,20170330,3118,3118,,,,3118,3118,0,0,0,0.00,0
,20170331,3118,3118,,,,3118,3118,0,0,0,0.00,0
,20170405,3118,3118,,,,3118,3118,0,0,0,0.00,0
,20170406,3118,3118,,,,3118,3118,0,0,0,0.00,0
,20170407,3118,3118,,,,3118,3118,0,0,0,0.00,0
,20170410,3118,3118,,,,2962,2962,-156,-156,0,0.00,0
,20170411,2962,2962,,,,2962,2962,0,0,0,0.00,0
,20170412,2962,2962,,,,2962,2962,0,0,0,0.00,0
,20170413,2962,2962,,,,2962,2962,0,0,0,0.00,0
,20170414,2962,2962,,,,2962,2962,0,0,0,0.00,0
,20170417,2962,2962,,,,2962,2962,0,0,0,0.00,0
,20170418,2962,2962,,,,2962,2962,0,0,0,0.00,0
,20170419,2962,2962,,,,2864,2864,-98,-98,0,0.00,0
,20170420,2864,2864,,,,2864,2864,0,0,0,0.00,0
,20170421,2864,2864,,,,2864,2864,0,0,0,0.00,0
,20170424,2864,2864,,,,2864,2864,0,0,0,0.00,0
,20170425,2864,2864,,,,2864,2864,0,0,0,0.00,0
,20170426,2864,2864,,,,2722,2722,-142,-142,0,0.00,0
,20170427,2722,2722,,,,2767,2767,45,45,0,0.00,0
,20170428,2767,2767,,,,2858,2858,91,91,0,0.00,0
,20170502,2858,2858,,,,3000,3000,142,142,0,0.00,0
,20170503,3000,3000,,,,3143,3143,143,143,0,0.00,0
,20170504,3143,3143,,,,3017,3017,-126,-126,0,0.00,0
,20170505,3017,3017,,,,3017,3017,0,0,0,0.00,0
,20170508,3017,3017,,,,3017,3017,0,0,0,0.00,0
,20170509,3017,3017,,,,3017,3017,0,0,0,0.00,0
,20170510,3017,3017,,,,3017,3017,0,0,0,0.00,0
,20170511,3017,3017,,,,3017,3017,0,0,0,0.00,0
,20170512,3017,3017,,,,3017,3017,0,0,0,0.00,0
,20170515,3017,3017,,,,3017,3017,0,0,0,0.00,0
,20170516,3017,3017,,,,3017,3017,0,0,0,0.00,0
,20170517,3017,3017,,,,3017,3017,0,0,0,0.00,0
,20170518,3017,3017,,,,3017,3017,0,0,0,0.00,0
,20170519,3017,3017,,,,3017,3017,0,0,0,0.00,0
,20170522,3017,3017,,,,3017,3017,0,0,0,0.00,0
,20170523,3017,3017,,,,3017,3017,0,0,0,0.00,0
,20170524,3017,3017,,,,3017,3017,0,0,0,0.00,0
,20170525,3017,3017,,,,3017,3017,0,0,0,0.00,0
,20170526,3017,3017,,,,3017,3017,0,0,0,0.00,0
,20170531,3017,3017,,,,3017,3017,0,0,0,0.00,0
,20170601,3017,3017,,,,3017,3017,0,0,0,0.00,0
,20170602,3017,3017,,,,3017,3017,0,0,0,0.00,0
,20170605,3017,3017,,,,3017,3017,0,0,0,0.00,0
,20170606,3017,3017,,,,3017,3017,0,0,0,0.00,0
,20170607,3017,3017,,,,3017,3017,0,0,0,0.00,0
,20170608,3017,3017,,,,3017,3017,0,0,0,0.00,0
,20170609,3017,3017,,,,3017,3017,0,0,0,0.00,0
,20170612,3017,3017,,,,3017,3017,0,0,0,0.00,0
,20170613,3017,3017,,,,3017,3017,0,0,0,0.00,0
,20170614,3017,3017,,,,3017,3017,0,0,0,0.00,0
,20170615,3017,3017,,,,3017,3017,0,0,0,0.00,0
,20170616,3017,3017,,,,3017,3017,0,0,0,0.00,0
,20170619,3017,3017,,,,3017,3017,0,0,0,0.00,0
,20170620,3017,3017,,,,3017,3017,0,0,0,0.00,0
,20170621,3017,3017,,,,3017,3017,0,0,0,0.00,0
,20170622,3017,3017,,,,3017,3017,0,0,0,0.00,0
,20170623,3017,3017,,,,3017,3017,0,0,0,0.00,0
,20170626,3017,3017,,,,3017,3017,0,0,0,0.00,0
,20170627,3017,3017,,,,3017,3017,0,0,0,0.00,0
,20170628,3017,3017,,,,3017,3017,0,0,0,0.00,0
,20170629,3017,3017,,,,3017,3017,0,0,0,0.00,0
,20170630,3017,3017,,,,3017,3017,0,0,0,0.00,0
,20170703,3017,3017,,,,3017,3017,0,0,0,0.00,0
,20170704,3017,3017,,,,3017,3017,0,0,0,0.00,0
,20170705,3017,3017,,,,3017,3017,0,0,0,0.00,0
,20170706,3017,3017,,,,3017,3017,0,0,0,0.00,0
,20170707,3017,3017,,,,3017,3017,0,0,0,0.00,0
,20170710,3017,3017,,,,3017,3017,0,0,0,0.00,0
,20170711,3017,3017,,,,3017,3017,0,0,0,0.00,0
,20170712,3017,3017,,,,3017,3017,0,0,0,0.00,0
,20170713,3017,3017,,,,3017,3017,0,0,0,0.00,0
,20170714,3017,3017,,,,3017,3017,0,0,0,0.00,0
,20170717,3017,3017,,,,3017,3017,0,0,0,0.00,0
,20170718,3017,3017,,,,3018,3018,1,1,0,0.00,0
,20170719,3018,3018,,,,3018,3018,0,0,0,0.00,0
,20170720,3018,3018,,,,3018,3018,0,0,0,0.00,0
,20170721,3018,3018,,,,3018,3018,0,0,0,0.00,0
,20170724,3018,3018,,,,3121,3121,103,103,0,0.00,0
,20170725,3121,3121,,,,3121,3121,0,0,0,0.00,0
,20170726,3121,3121,,,,3121,3121,0,0,0,0.00,0
,20170727,3121,3121,,,,3121,3121,0,0,0,0.00,0
,20170728,3121,3121,,,,3121,3121,0,0,0,0.00,0
,20170731,3121,3121,,,,3121,3121,0,0,0,0.00,0
,20170801,3121,3121,,,,3121,3121,0,0,0,0.00,0
,20170802,3121,3121,,,,3121,3121,0,0,0,0.00,0
,20170803,3121,3121,,,,3121,3121,0,0,0,0.00,0
,20170804,3121,3121,,,,3121,3121,0,0,0,0.00,0
,20170807,3121,3121,,,,3121,3121,0,0,0,0.00,0
,20170808,3121,3121,,,,3121,3121,0,0,0,0.00,0
,20170809,3121,3121,,,,3121,3121,0,0,0,0.00,0
,20170810,3121,3121,,,,3121,3121,0,0,0,0.00,0
,20170811,3121,3121,,,,3121,3121,0,0,0,0.00,0
,20170814,3121,3121,,,,3121,3121,0,0,0,0.00,0
,20170815,3121,3121,,,,3121,3121,0,0,0,0.00,0
,20170816,3121,3121,,,,3121,3121,0,0,0,0.00,0
,20170817,3121,3121,,,,3121,3121,0,0,0,0.00,0
,20170818,3121,3121,,,,3121,3121,0,0,0,0.00,0
,20170821,3121,3121,,,,3121,3121,0,0,0,0.00,0
,20170822,3121,3121,,,,3121,3121,0,0,0,0.00,0
,20170823,3121,3121,,,,3121,3121,0,0,0,0.00,0
,20170824,3121,3121,,,,3121,3121,0,0,0,0.00,0
,20170825,3121,3121,,,,3121,3121,0,0,0,0.00,0
,20170828,3121,3121,,,,3121,3121,0,0,0,0.00,0
,20170829,3121,3121,,,,3121,3121,0,0,0,0.00,0
,20170830,3121,3121,,,,3121,3121,0,0,0,0.00,0
,20170831,3121,3121,,,,3121,3121,0,0,0,0.00,0
,20170901,3121,3121,,,,3121,3121,0,0,0,0.00,0
,20170904,3121,3121,,,,3121,3121,0,0,0,0.00,0
,20170905,3121,3121,,,,3121,3121,0,0,0,0.00,0
,20170906,3121,3121,,,,3121,3121,0,0,0,0.00,0
,20170907,3121,3121,,,,3121,3121,0,0,0,0.00,0
,20170908,3121,3121,,,,3121,3121,0,0,0,0.00,0
,20170911,3121,3121,,,,3121,3121,0,0,0,0.00,0
,20170912,3121,3121,,,,3121,3121,0,0,0,0.00,0
,20170913,3121,3121,,,,3121,3121,0,0,0,0.00,0
,20170914,3121,3121,,,,3121,3121,0,0,0,0.00,0
,20170915,3121,3121,,,,3121,3121,0,0,0,0.00,0
,20170918,3121,3121,,,,3121,3121,0,0,0,0.00,0
,20170919,3121,3121,,,,3121,3121,0,0,0,0.00,0
,20170920,3121,3121,,,,3121,3121,0,0,0,0.00,0
,20170921,3121,3121,,,,3121,3121,0,0,0,0.00,0
,20170922,3121,3121,,,,3121,3121,0,0,0,0.00,0
,20170925,3121,3121,,,,3121,3121,0,0,0,0.00,0
,20170926,3121,3121,,,,3121,3121,0,0,0,0.00,0
,20170927,3121,3121,,,,3121,3121,0,0,0,0.00,0
,20170928,3121,3121,,,,3121,3121,0,0,0,0.00,0
,20170929,3121,3121,,,,3121,3121,0,0,0,0.00,0
,20171009,3121,3121,,,,3121,3121,0,0,0,0.00,0
,20171010,3121,3121,,,,3121,3121,0,0,0,0.00,0
,20171011,3121,3121,,,,3121,3121,0,0,0,0.00,0
,20171012,3121,3121,,,,3121,3121,0,0,0,0.00,0
,20171013,3121,3121,,,,3121,3121,0,0,0,0.00,0
,20171016,3121,3121,,,,3121,3121,0,0,0,0.00,0
,20171017,3121,3121,,,,3121,3121,0,0,0,0.00,0
,20171018,3121,3121,,,,3121,3121,0,0,0,0.00,0
,20171019,3121,3121,,,,3121,3121,0,0,0,0.00,0
,20171020,3121,3121,,,,3121,3121,0,0,0,0.00,0
,20171023,3121,3121,,,,3121,3121,0,0,0,0.00,0
,20171024,3121,3121,,,,3121,3121,0,0,0,0.00,0
,20171025,3121,3121,,,,3121,3121,0,0,0,0.00,0
,20171026,3121,3121,,,,3121,3121,0,0,0,0.00,0
,20171027,3121,3121,,,,3121,3121,0,0,0,0.00,0
,20171030,3121,3121,,,,3121,3121,0,0,0,0.00,0
,20171031,3121,3121,,,,3121,3121,0,0,0,0.00,0
,20171101,3121,3121,,,,3121,3121,0,0,0,0.00,0
,20171102,3121,3121,,,,3121,3121,0,0,0,0.00,0
,20171103,3121,3121,,,,3121,3121,0,0,0,0.00,0
,20171106,3121,3121,,,,3121,3121,0,0,0,0.00,0
,20171107,3121,3121,,,,3121,3121,0,0,0,0.00,0
,20171108,3121,3121,,,,3121,3121,0,0,0,0.00,0
,20171109,3121,3121,,,,3121,3121,0,0,0,0.00,0
,20171110,3121,3121,,,,3121,3121,0,0,0,0.00,0
,20171113,3121,3121,,,,3121,3121,0,0,0,0.00,0
,20171114,3121,3121,,,,3121,3121,0,0,0,0.00,0
,20171115,3121,3121,,,,3121,3121,0,0,0,0.00,0
,20171116,3121,3121,,,,3121,3121,0,0,0,0.00,0
,20171117,3121,3121,,,,3121,3121,0,0,0,0.00,0
,20171120,3121,3121,,,,3121,3121,0,0,0,0.00,0
,20171121,3121,3121,,,,3121,3121,0,0,0,0.00,0
,20171122,3121,3121,,,,3121,3121,0,0,0,0.00,0
,20171123,3121,3121,,,,3121,3121,0,0,0,0.00,0
,20171124,3121,3121,,,,3121,3121,0,0,0,0.00,0
,20171127,3121,3121,,,,3121,3121,0,0,0,0.00,0
,20171128,3121,3121,,,,3121,3121,0,0,0,0.00,0
,20171129,3121,3121,,,,3121,3121,0,0,0,0.00,0
,20171130,3121,3121,,,,3121,3121,0,0,0,0.00,0
,20171201,3121,3121,,,,3121,3121,0,0,0,0.00,0
,20171204,3121,3121,,,,3121,3121,0,0,0,0.00,0
,20171205,3121,3121,,,,3121,3121,0,0,0,0.00,0
,20171206,3121,3121,,,,3121,3121,0,0,0,0.00,0
,20171207,3121,3121,,,,3121,3121,0,0,0,0.00,0
,20171208,3121,3121,,,,3121,3121,0,0,0,0.00,0
,20171211,3121,3121,,,,3121,3121,0,0,0,0.00,0
,20171212,3121,3121,,,,3121,3121,0,0,0,0.00,0
,20171213,3121,3121,,,,3121,3121,0,0,0,0.00,0
,20171214,3121,3121,,,,3121,3121,0,0,0,0.00,0
,20171215,3121,3121,,,,3121,3121,0,0,0,0.00,0
,20171218,3121,3121,,,,3121,3121,0,0,0,0.00,0
,20171219,3121,3121,,,,3121,3121,0,0,0,0.00,0
,20171220,3121,3121,,,,3121,3121,0,0,0,0.00,0
,20171221,3121,3121,,,,3121,3121,0,0,0,0.00,0
,20171222,3121,3121,,,,3121,3121,0,0,0,0.00,0
,20171225,3121,3121,,,,3121,3121,0,0,0,0.00,0
,20171226,3121,3121,,,,3121,3121,0,0,0,0.00,0
,20171227,3121,3121,,,,3121,3121,0,0,0,0.00,0
,20171228,3121,3121,,,,3121,3121,0,0,0,0.00,0
,20171229,3121,3121,,,,3121,3121,0,0,0,0.00,0
wr1802,20170216,2767,2767,,,,2767,2767,0,0,0,0.00,0
,20170217,2767,2767,,,,2767,2767,0,0,0,0.00,0
,20170220,2767,2767,,,,2767,2767,0,0,0,0.00,0
,20170221,2767,2767,,,,2767,2767,0,0,0,0.00,0
,20170222,2767,2767,,,,2767,2767,0,0,0,0.00,0
,20170223,2767,2767,,,,2767,2767,0,0,0,0.00,0
,20170224,2767,2767,,,,2767,2767,0,0,0,0.00,0
,20170227,2767,2767,,,,2767,2767,0,0,0,0.00,0
,20170228,2767,2767,,,,2767,2767,0,0,0,0.00,0
,20170301,2767,2767,,,,2630,2630,-137,-137,0,0.00,0
,20170302,2630,2630,,,,2630,2630,0,0,0,0.00,0
,20170303,2630,2630,,,,2761,2761,131,131,0,0.00,0
,20170306,2761,2761,,,,2898,2898,137,137,0,0.00,0
,20170307,2898,2898,,,,2898,2898,0,0,0,0.00,0
,20170308,2898,2898,,,,2898,2898,0,0,0,0.00,0
,20170309,2898,2898,,,,2898,2898,0,0,0,0.00,0
,20170310,2898,2898,,,,2898,2898,0,0,0,0.00,0
,20170313,2898,2898,,,,2898,2898,0,0,0,0.00,0
,20170314,2898,2898,,,,2898,2898,0,0,0,0.00,0
,20170315,2898,2898,,,,2898,2898,0,0,0,0.00,0
,20170316,2898,2898,,,,2898,2898,0,0,0,0.00,0
,20170317,2898,2898,,,,2898,2898,0,0,0,0.00,0
,20170320,2898,2898,,,,2898,2898,0,0,0,0.00,0
,20170321,2898,2898,,,,2970,2970,72,72,0,0.00,0
,20170322,2970,2970,,,,2970,2970,0,0,0,0.00,0
,20170323,2970,2970,,,,2970,2970,0,0,0,0.00,0
,20170324,2970,2970,,,,2970,2970,0,0,0,0.00,0
,20170327,2970,2970,,,,2970,2970,0,0,0,0.00,0
,20170328,2970,2970,,,,2970,2970,0,0,0,0.00,0
,20170329,2970,2970,,,,3118,3118,148,148,0,0.00,0
,20170330,3118,3118,,,,3118,3118,0,0,0,0.00,0
,20170331,3118,3118,,,,3118,3118,0,0,0,0.00,0
,20170405,3118,3118,,,,3118,3118,0,0,0,0.00,0
,20170406,3118,3118,,,,3118,3118,0,0,0,0.00,0
,20170407,3118,3118,,,,3118,3118,0,0,0,0.00,0
,20170410,3118,3118,,,,2962,2962,-156,-156,0,0.00,0
,20170411,2962,2962,,,,2962,2962,0,0,0,0.00,0
,20170412,2962,2962,,,,2962,2962,0,0,0,0.00,0
,20170413,2962,2962,,,,2962,2962,0,0,0,0.00,0
,20170414,2962,2962,,,,2962,2962,0,0,0,0.00,0
,20170417,2962,2962,,,,2962,2962,0,0,0,0.00,0
,20170418,2962,2962,,,,2962,2962,0,0,0,0.00,0
,20170419,2962,2962,,,,2864,2864,-98,-98,0,0.00,0
,20170420,2864,2864,,,,2864,2864,0,0,0,0.00,0
,20170421,2864,2864,,,,2864,2864,0,0,0,0.00,0
,20170424,2864,2864,,,,2864,2864,0,0,0,0.00,0
,20170425,2864,2864,,,,2864,2864,0,0,0,0.00,0
,20170426,2864,2864,,,,2722,2722,-142,-142,0,0.00,0
,20170427,2722,2722,,,,2767,2767,45,45,0,0.00,0
,20170428,2767,2767,,,,2858,2858,91,91,0,0.00,0
,20170502,2858,2858,,,,3000,3000,142,142,0,0.00,0
,20170503,3000,3000,,,,3143,3143,143,143,0,0.00,0
,20170504,3143,3143,,,,3017,3017,-126,-126,0,0.00,0
,20170505,3017,3017,,,,3017,3017,0,0,0,0.00,0
,20170508,3017,3017,,,,3017,3017,0,0,0,0.00,0
,20170509,3017,3017,,,,3017,3017,0,0,0,0.00,0
,20170510,3017,3017,,,,3017,3017,0,0,0,0.00,0
,20170511,3017,3017,,,,3017,3017,0,0,0,0.00,0
,20170512,3017,3017,,,,3017,3017,0,0,0,0.00,0
,20170515,3017,3017,,,,3017,3017,0,0,0,0.00,0
,20170516,3017,3017,,,,3017,3017,0,0,0,0.00,0
,20170517,3017,3017,,,,3017,3017,0,0,0,0.00,0
,20170518,3017,3017,,,,3017,3017,0,0,0,0.00,0
,20170519,3017,3017,,,,3017,3017,0,0,0,0.00,0
,20170522,3017,3017,,,,3017,3017,0,0,0,0.00,0
,20170523,3017,3017,,,,3017,3017,0,0,0,0.00,0
,20170524,3017,3017,,,,3017,3017,0,0,0,0.00,0
,20170525,3017,3017,,,,3017,3017,0,0,0,0.00,0
,20170526,3017,3017,,,,3017,3017,0,0,0,0.00,0
,20170531,3017,3017,,,,3017,3017,0,0,0,0.00,0
,20170601,3017,3017,,,,3017,3017,0,0,0,0.00,0
,20170602,3017,3017,,,,3017,3017,0,0,0,0.00,0
,20170605,3017,3017,,,,3017,3017,0,0,0,0.00,0
,20170606,3017,3017,,,,3017,3017,0,0,0,0.00,0
,20170607,3017,3017,,,,3017,3017,0,0,0,0.00,0
,20170608,3017,3017,,,,3017,3017,0,0,0,0.00,0
,20170609,3017,3017,,,,3017,3017,0,0,0,0.00,0
,20170612,3017,3017,,,,3017,3017,0,0,0,0.00,0
,20170613,3017,3017,,,,3017,3017,0,0,0,0.00,0
,20170614,3017,3017,,,,3017,3017,0,0,0,0.00,0
,20170615,3017,3017,,,,3017,3017,0,0,0,0.00,0
,20170616,3017,3017,,,,3017,3017,0,0,0,0.00,0
,20170619,3017,3017,,,,3017,3017,0,0,0,0.00,0
,20170620,3017,3017,,,,3017,3017,0,0,0,0.00,0
,20170621,3017,3017,,,,3017,3017,0,0,0,0.00,0
,20170622,3017,3017,,,,3017,3017,0,0,0,0.00,0
,20170623,3017,3017,,,,3017,3017,0,0,0,0.00,0
,20170626,3017,3017,,,,3017,3017,0,0,0,0.00,0
,20170627,3017,3017,,,,3017,3017,0,0,0,0.00,0
,20170628,3017,3017,,,,3017,3017,0,0,0,0.00,0
,20170629,3017,3017,,,,3017,3017,0,0,0,0.00,0
,20170630,3017,3017,,,,3017,3017,0,0,0,0.00,0
,20170703,3017,3017,,,,3017,3017,0,0,0,0.00,0
,20170704,3017,3017,,,,3017,3017,0,0,0,0.00,0
,20170705,3017,3017,,,,3017,3017,0,0,0,0.00,0
,20170706,3017,3017,,,,3017,3017,0,0,0,0.00,0
,20170707,3017,3017,,,,3017,3017,0,0,0,0.00,0
,20170710,3017,3017,,,,3017,3017,0,0,0,0.00,0
,20170711,3017,3017,,,,3017,3017,0,0,0,0.00,0
,20170712,3017,3017,,,,3017,3017,0,0,0,0.00,0
,20170713,3017,3017,,,,3017,3017,0,0,0,0.00,0
,20170714,3017,3017,,,,3017,3017,0,0,0,0.00,0
,20170717,3017,3017,,,,3017,3017,0,0,0,0.00,0
,20170718,3017,3017,,,,3018,3018,1,1,0,0.00,0
,20170719,3018,3018,,,,3018,3018,0,0,0,0.00,0
,20170720,3018,3018,,,,3018,3018,0,0,0,0.00,0
,20170721,3018,3018,,,,3018,3018,0,0,0,0.00,0
,20170724,3018,3018,,,,3121,3121,103,103,0,0.00,0
,20170725,3121,3121,,,,3121,3121,0,0,0,0.00,0
,20170726,3121,3121,,,,3121,3121,0,0,0,0.00,0
,20170727,3121,3121,,,,3121,3121,0,0,0,0.00,0
,20170728,3121,3121,,,,3121,3121,0,0,0,0.00,0
,20170731,3121,3121,,,,3121,3121,0,0,0,0.00,0
,20170801,3121,3121,,,,3121,3121,0,0,0,0.00,0
,20170802,3121,3121,,,,3121,3121,0,0,0,0.00,0
,20170803,3121,3121,,,,3121,3121,0,0,0,0.00,0
,20170804,3121,3121,,,,3121,3121,0,0,0,0.00,0
,20170807,3121,3121,,,,3121,3121,0,0,0,0.00,0
,20170808,3121,3121,,,,3121,3121,0,0,0,0.00,0
,20170809,3121,3121,,,,3121,3121,0,0,0,0.00,0
,20170810,3121,3121,,,,3121,3121,0,0,0,0.00,0
,20170811,3121,3121,,,,3121,3121,0,0,0,0.00,0
,20170814,3121,3121,,,,3121,3121,0,0,0,0.00,0
,20170815,3121,3121,,,,3121,3121,0,0,0,0.00,0
,20170816,3121,3121,,,,3121,3121,0,0,0,0.00,0
,20170817,3121,3121,,,,3121,3121,0,0,0,0.00,0
,20170818,3121,3121,,,,3121,3121,0,0,0,0.00,0
,20170821,3121,3121,,,,3121,3121,0,0,0,0.00,0
,20170822,3121,3121,,,,3121,3121,0,0,0,0.00,0
,20170823,3121,3121,,,,3121,3121,0,0,0,0.00,0
,20170824,3121,3121,,,,3121,3121,0,0,0,0.00,0
,20170825,3121,3121,,,,3121,3121,0,0,0,0.00,0
,20170828,3121,3121,,,,3121,3121,0,0,0,0.00,0
,20170829,3121,3121,,,,3121,3121,0,0,0,0.00,0
,20170830,3121,3121,,,,3121,3121,0,0,0,0.00,0
,20170831,3121,3121,,,,3121,3121,0,0,0,0.00,0
,20170901,3121,3121,,,,3121,3121,0,0,0,0.00,0
,20170904,3121,3121,,,,3121,3121,0,0,0,0.00,0
,20170905,3121,3121,,,,3121,3121,0,0,0,0.00,0
,20170906,3121,3121,,,,3121,3121,0,0,0,0.00,0
,20170907,3121,3121,,,,3121,3121,0,0,0,0.00,0
,20170908,3121,3121,,,,3121,3121,0,0,0,0.00,0
,20170911,3121,3121,,,,3121,3121,0,0,0,0.00,0
,20170912,3121,3121,,,,3121,3121,0,0,0,0.00,0
,20170913,3121,3121,,,,3121,3121,0,0,0,0.00,0
,20170914,3121,3121,,,,3121,3121,0,0,0,0.00,0
,20170915,3121,3121,,,,3121,3121,0,0,0,0.00,0
,20170918,3121,3121,,,,3121,3121,0,0,0,0.00,0
,20170919,3121,3121,,,,3121,3121,0,0,0,0.00,0
,20170920,3121,3121,,,,3121,3121,0,0,0,0.00,0
,20170921,3121,3121,,,,3121,3121,0,0,0,0.00,0
,20170922,3121,3121,,,,3121,3121,0,0,0,0.00,0
,20170925,3121,3121,,,,3121,3121,0,0,0,0.00,0
,20170926,3121,3121,,,,3121,3121,0,0,0,0.00,0
,20170927,3121,3121,,,,3121,3121,0,0,0,0.00,0
,20170928,3121,3121,,,,3121,3121,0,0,0,0.00,0
,20170929,3121,3121,,,,3121,3121,0,0,0,0.00,0
,20171009,3121,3121,,,,3121,3121,0,0,0,0.00,0
,20171010,3121,3121,,,,3121,3121,0,0,0,0.00,0
,20171011,3121,3121,,,,3121,3121,0,0,0,0.00,0
,20171012,3121,3121,,,,3121,3121,0,0,0,0.00,0
,20171013,3121,3121,,,,3121,3121,0,0,0,0.00,0
,20171016,3121,3121,,,,3121,3121,0,0,0,0.00,0
,20171017,3121,3121,,,,3121,3121,0,0,0,0.00,0
,20171018,3121,3121,,,,3121,3121,0,0,0,0.00,0
,20171019,3121,3121,,,,3121,3121,0,0,0,0.00,0
,20171020,3121,3121,,,,3121,3121,0,0,0,0.00,0
,20171023,3121,3121,,,,3121,3121,0,0,0,0.00,0
,20171024,3121,3121,,,,3121,3121,0,0,0,0.00,0
,20171025,3121,3121,,,,3121,3121,0,0,0,0.00,0
,20171026,3121,3121,,,,3121,3121,0,0,0,0.00,0
,20171027,3121,3121,,,,3121,3121,0,0,0,0.00,0
,20171030,3121,3121,,,,3121,3121,0,0,0,0.00,0
,20171031,3121,3121,,,,3121,3121,0,0,0,0.00,0
,20171101,3121,3121,,,,3121,3121,0,0,0,0.00,0
,20171102,3121,3121,,,,3121,3121,0,0,0,0.00,0
,20171103,3121,3121,,,,3121,3121,0,0,0,0.00,0
,20171106,3121,3121,,,,3121,3121,0,0,0,0.00,0
,20171107,3121,3121,,,,3121,3121,0,0,0,0.00,0
,20171108,3121,3121,,,,3121,3121,0,0,0,0.00,0
,20171109,3121,3121,,,,3121,3121,0,0,0,0.00,0
,20171110,3121,3121,,,,3121,3121,0,0,0,0.00,0
,20171113,3121,3121,,,,3121,3121,0,0,0,0.00,0
,20171114,3121,3121,,,,3121,3121,0,0,0,0.00,0
,20171115,3121,3121,,,,3121,3121,0,0,0,0.00,0
,20171116,3121,3121,,,,3121,3121,0,0,0,0.00,0
,20171117,3121,3121,,,,3121,3121,0,0,0,0.00,0
,20171120,3121,3121,,,,3121,3121,0,0,0,0.00,0
,20171121,3121,3121,,,,3121,3121,0,0,0,0.00,0
,20171122,3121,3121,,,,3121,3121,0,0,0,0.00,0
,20171123,3121,3121,,,,3121,3121,0,0,0,0.00,0
,20171124,3121,3121,,,,3121,3121,0,0,0,0.00,0
,20171127,3121,3121,,,,3121,3121,0,0,0,0.00,0
,20171128,3121,3121,,,,3121,3121,0,0,0,0.00,0
,20171129,3121,3121,,,,3121,3121,0,0,0,0.00,0
,20171130,3121,3121,,,,3121,3121,0,0,0,0.00,0
,20171201,3121,3121,,,,3121,3121,0,0,0,0.00,0
,20171204,3121,3121,,,,3121,3121,0,0,0,0.00,0
,20171205,3121,3121,,,,3121,3121,0,0,0,0.00,0
,20171206,3121,3121,,,,3121,3121,0,0,0,0.00,0
,20171207,3121,3121,,,,3121,3121,0,0,0,0.00,0
,20171208,3121,3121,,,,3121,3121,0,0,0,0.00,0
,20171211,3121,3121,,,,3121,3121,0,0,0,0.00,0
,20171212,3121,3121,,,,3121,3121,0,0,0,0.00,0
,20171213,3121,3121,,,,3121,3121,0,0,0,0.00,0
,20171214,3121,3121,,,,3121,3121,0,0,0,0.00,0
,20171215,3121,3121,,,,3121,3121,0,0,0,0.00,0
,20171218,3121,3121,,,,3121,3121,0,0,0,0.00,0
,20171219,3121,3121,,,,3121,3121,0,0,0,0.00,0
,20171220,3121,3121,,,,3121,3121,0,0,0,0.00,0
,20171221,3121,3121,,,,3121,3121,0,0,0,0.00,0
,20171222,3121,3121,,,,3121,3121,0,0,0,0.00,0
,20171225,3121,3121,,,,3121,3121,0,0,0,0.00,0
,20171226,3121,3121,,,,3121,3121,0,0,0,0.00,0
,20171227,3121,3121,,,,3121,3121,0,0,0,0.00,0
,20171228,3121,3121,,,,3121,3121,0,0,0,0.00,0
,20171229,3121,3121,,,,3121,3121,0,0,0,0.00,0
wr1803,20170316,2898,2898,,,,2898,2898,0,0,0,0.00,0
,20170317,2898,2898,,,,2898,2898,0,0,0,0.00,0
,20170320,2898,2898,,,,2898,2898,0,0,0,0.00,0
,20170321,2898,2898,,,,2970,2970,72,72,0,0.00,0
,20170322,2970,2970,,,,2970,2970,0,0,0,0.00,0
,20170323,2970,2970,,,,2970,2970,0,0,0,0.00,0
,20170324,2970,2970,,,,2970,2970,0,0,0,0.00,0
,20170327,2970,2970,,,,2970,2970,0,0,0,0.00,0
,20170328,2970,2970,,,,2970,2970,0,0,0,0.00,0
,20170329,2970,2970,,,,3118,3118,148,148,0,0.00,0
,20170330,3118,3118,,,,3118,3118,0,0,0,0.00,0
,20170331,3118,3118,,,,3118,3118,0,0,0,0.00,0
,20170405,3118,3118,,,,3118,3118,0,0,0,0.00,0
,20170406,3118,3118,,,,3118,3118,0,0,0,0.00,0
,20170407,3118,3118,,,,3118,3118,0,0,0,0.00,0
,20170410,3118,3118,,,,2962,2962,-156,-156,0,0.00,0
,20170411,2962,2962,,,,2962,2962,0,0,0,0.00,0
,20170412,2962,2962,,,,2962,2962,0,0,0,0.00,0
,20170413,2962,2962,,,,2962,2962,0,0,0,0.00,0
,20170414,2962,2962,,,,2962,2962,0,0,0,0.00,0
,20170417,2962,2962,,,,2962,2962,0,0,0,0.00,0
,20170418,2962,2962,,,,2962,2962,0,0,0,0.00,0
,20170419,2962,2962,,,,2864,2864,-98,-98,0,0.00,0
,20170420,2864,2864,,,,2864,2864,0,0,0,0.00,0
,20170421,2864,2864,,,,2864,2864,0,0,0,0.00,0
,20170424,2864,2864,,,,2864,2864,0,0,0,0.00,0
,20170425,2864,2864,,,,2864,2864,0,0,0,0.00,0
,20170426,2864,2864,,,,2722,2722,-142,-142,0,0.00,0
,20170427,2722,2722,,,,2767,2767,45,45,0,0.00,0
,20170428,2767,2767,,,,2858,2858,91,91,0,0.00,0
,20170502,2858,2858,,,,3000,3000,142,142,0,0.00,0
,20170503,3000,3000,,,,3143,3143,143,143,0,0.00,0
,20170504,3143,3143,,,,3017,3017,-126,-126,0,0.00,0
,20170505,3017,3017,,,,3017,3017,0,0,0,0.00,0
,20170508,3017,3017,,,,3017,3017,0,0,0,0.00,0
,20170509,3017,3017,,,,3017,3017,0,0,0,0.00,0
,20170510,3017,3017,,,,3017,3017,0,0,0,0.00,0
,20170511,3017,3017,,,,3017,3017,0,0,0,0.00,0
,20170512,3017,3017,,,,3017,3017,0,0,0,0.00,0
,20170515,3017,3017,,,,3017,3017,0,0,0,0.00,0
,20170516,3017,3017,,,,3017,3017,0,0,0,0.00,0
,20170517,3017,3017,,,,3017,3017,0,0,0,0.00,0
,20170518,3017,3017,,,,3017,3017,0,0,0,0.00,0
,20170519,3017,3017,,,,3017,3017,0,0,0,0.00,0
,20170522,3017,3017,,,,3017,3017,0,0,0,0.00,0
,20170523,3017,3017,,,,3017,3017,0,0,0,0.00,0
,20170524,3017,3017,,,,3017,3017,0,0,0,0.00,0
,20170525,3017,3017,,,,3017,3017,0,0,0,0.00,0
,20170526,3017,3017,,,,3017,3017,0,0,0,0.00,0
,20170531,3017,3017,,,,3017,3017,0,0,0,0.00,0
,20170601,3017,3017,,,,3017,3017,0,0,0,0.00,0
,20170602,3017,3017,,,,3017,3017,0,0,0,0.00,0
,20170605,3017,3017,,,,3017,3017,0,0,0,0.00,0
,20170606,3017,3017,,,,3017,3017,0,0,0,0.00,0
,20170607,3017,3017,,,,3017,3017,0,0,0,0.00,0
,20170608,3017,3017,,,,3017,3017,0,0,0,0.00,0
,20170609,3017,3017,,,,3017,3017,0,0,0,0.00,0
,20170612,3017,3017,,,,3017,3017,0,0,0,0.00,0
,20170613,3017,3017,,,,3017,3017,0,0,0,0.00,0
,20170614,3017,3017,,,,3017,3017,0,0,0,0.00,0
,20170615,3017,3017,,,,3017,3017,0,0,0,0.00,0
,20170616,3017,3017,,,,3017,3017,0,0,0,0.00,0
,20170619,3017,3017,,,,3017,3017,0,0,0,0.00,0
,20170620,3017,3017,,,,3017,3017,0,0,0,0.00,0
,20170621,3017,3017,,,,3017,3017,0,0,0,0.00,0
,20170622,3017,3017,,,,3017,3017,0,0,0,0.00,0
,20170623,3017,3017,,,,3017,3017,0,0,0,0.00,0
,20170626,3017,3017,,,,3017,3017,0,0,0,0.00,0
,20170627,3017,3017,,,,3017,3017,0,0,0,0.00,0
,20170628,3017,3017,,,,3017,3017,0,0,0,0.00,0
,20170629,3017,3017,,,,3017,3017,0,0,0,0.00,0
,20170630,3017,3017,,,,3017,3017,0,0,0,0.00,0
,20170703,3017,3017,,,,3017,3017,0,0,0,0.00,0
,20170704,3017,3017,,,,3017,3017,0,0,0,0.00,0
,20170705,3017,3017,,,,3017,3017,0,0,0,0.00,0
,20170706,3017,3017,,,,3017,3017,0,0,0,0.00,0
,20170707,3017,3017,,,,3017,3017,0,0,0,0.00,0
,20170710,3017,3017,,,,3017,3017,0,0,0,0.00,0
,20170711,3017,3017,,,,3017,3017,0,0,0,0.00,0
,20170712,3017,3017,,,,3017,3017,0,0,0,0.00,0
,20170713,3017,3017,,,,3017,3017,0,0,0,0.00,0
,20170714,3017,3017,,,,3017,3017,0,0,0,0.00,0
,20170717,3017,3017,,,,3017,3017,0,0,0,0.00,0
,20170718,3017,3017,,,,3018,3018,1,1,0,0.00,0
,20170719,3018,3018,,,,3018,3018,0,0,0,0.00,0
,20170720,3018,3018,,,,3018,3018,0,0,0,0.00,0
,20170721,3018,3018,,,,3018,3018,0,0,0,0.00,0
,20170724,3018,3018,,,,3121,3121,103,103,0,0.00,0
,20170725,3121,3121,,,,3121,3121,0,0,0,0.00,0
,20170726,3121,3121,,,,3121,3121,0,0,0,0.00,0
,20170727,3121,3121,,,,3121,3121,0,0,0,0.00,0
,20170728,3121,3121,,,,3121,3121,0,0,0,0.00,0
,20170731,3121,3121,,,,3121,3121,0,0,0,0.00,0
,20170801,3121,3121,,,,3121,3121,0,0,0,0.00,0
,20170802,3121,3121,,,,3121,3121,0,0,0,0.00,0
,20170803,3121,3121,,,,3121,3121,0,0,0,0.00,0
,20170804,3121,3121,,,,3121,3121,0,0,0,0.00,0
,20170807,3121,3121,,,,3121,3121,0,0,0,0.00,0
,20170808,3121,3121,,,,3121,3121,0,0,0,0.00,0
,20170809,3121,3121,,,,3121,3121,0,0,0,0.00,0
,20170810,3121,3121,,,,3121,3121,0,0,0,0.00,0
,20170811,3121,3121,,,,3121,3121,0,0,0,0.00,0
,20170814,3121,3121,,,,3121,3121,0,0,0,0.00,0
,20170815,3121,3121,,,,3121,3121,0,0,0,0.00,0
,20170816,3121,3121,,,,3121,3121,0,0,0,0.00,0
,20170817,3121,3121,,,,3121,3121,0,0,0,0.00,0
,20170818,3121,3121,,,,3121,3121,0,0,0,0.00,0
,20170821,3121,3121,,,,3121,3121,0,0,0,0.00,0
,20170822,3121,3121,,,,3121,3121,0,0,0,0.00,0
,20170823,3121,3121,,,,3121,3121,0,0,0,0.00,0
,20170824,3121,3121,,,,3121,3121,0,0,0,0.00,0
,20170825,3121,3121,,,,3121,3121,0,0,0,0.00,0
,20170828,3121,3121,,,,3121,3121,0,0,0,0.00,0
,20170829,3121,3121,,,,3121,3121,0,0,0,0.00,0
,20170830,3121,3121,,,,3121,3121,0,0,0,0.00,0
,20170831,3121,3121,,,,3121,3121,0,0,0,0.00,0
,20170901,3121,3121,,,,3121,3121,0,0,0,0.00,0
,20170904,3121,3121,,,,3121,3121,0,0,0,0.00,0
,20170905,3121,3121,,,,3121,3121,0,0,0,0.00,0
,20170906,3121,3121,,,,3121,3121,0,0,0,0.00,0
,20170907,3121,3121,,,,3121,3121,0,0,0,0.00,0
,20170908,3121,3121,,,,3121,3121,0,0,0,0.00,0
,20170911,3121,3121,,,,3121,3121,0,0,0,0.00,0
,20170912,3121,3121,,,,3121,3121,0,0,0,0.00,0
,20170913,3121,3121,,,,3121,3121,0,0,0,0.00,0
,20170914,3121,3121,,,,3121,3121,0,0,0,0.00,0
,20170915,3121,3121,,,,3121,3121,0,0,0,0.00,0
,20170918,3121,3121,,,,3121,3121,0,0,0,0.00,0
,20170919,3121,3121,,,,3121,3121,0,0,0,0.00,0
,20170920,3121,3121,,,,3121,3121,0,0,0,0.00,0
,20170921,3121,3121,,,,3121,3121,0,0,0,0.00,0
,20170922,3121,3121,,,,3121,3121,0,0,0,0.00,0
,20170925,3121,3121,,,,3121,3121,0,0,0,0.00,0
,20170926,3121,3121,,,,3121,3121,0,0,0,0.00,0
,20170927,3121,3121,,,,3121,3121,0,0,0,0.00,0
,20170928,3121,3121,,,,3121,3121,0,0,0,0.00,0
,20170929,3121,3121,,,,3121,3121,0,0,0,0.00,0
,20171009,3121,3121,,,,3121,3121,0,0,0,0.00,0
,20171010,3121,3121,,,,3121,3121,0,0,0,0.00,0
,20171011,3121,3121,,,,3121,3121,0,0,0,0.00,0
,20171012,3121,3121,,,,3121,3121,0,0,0,0.00,0
,20171013,3121,3121,,,,3121,3121,0,0,0,0.00,0
,20171016,3121,3121,,,,3121,3121,0,0,0,0.00,0
,20171017,3121,3121,,,,3121,3121,0,0,0,0.00,0
,20171018,3121,3121,,,,3121,3121,0,0,0,0.00,0
,20171019,3121,3121,,,,3121,3121,0,0,0,0.00,0
,20171020,3121,3121,,,,3121,3121,0,0,0,0.00,0
,20171023,3121,3121,,,,3121,3121,0,0,0,0.00,0
,20171024,3121,3121,,,,3121,3121,0,0,0,0.00,0
,20171025,3121,3121,,,,3121,3121,0,0,0,0.00,0
,20171026,3121,3121,,,,3121,3121,0,0,0,0.00,0
,20171027,3121,3121,,,,3121,3121,0,0,0,0.00,0
,20171030,3121,3121,,,,3121,3121,0,0,0,0.00,0
,20171031,3121,3121,,,,3121,3121,0,0,0,0.00,0
,20171101,3121,3121,,,,3121,3121,0,0,0,0.00,0
,20171102,3121,3121,,,,3121,3121,0,0,0,0.00,0
,20171103,3121,3121,,,,3121,3121,0,0,0,0.00,0
,20171106,3121,3121,,,,3121,3121,0,0,0,0.00,0
,20171107,3121,3121,,,,3121,3121,0,0,0,0.00,0
,20171108,3121,3121,,,,3121,3121,0,0,0,0.00,0
,20171109,3121,3121,,,,3121,3121,0,0,0,0.00,0
,20171110,3121,3121,,,,3121,3121,0,0,0,0.00,0
,20171113,3121,3121,,,,3121,3121,0,0,0,0.00,0
,20171114,3121,3121,,,,3121,3121,0,0,0,0.00,0
,20171115,3121,3121,,,,3121,3121,0,0,0,0.00,0
,20171116,3121,3121,,,,3121,3121,0,0,0,0.00,0
,20171117,3121,3121,,,,3121,3121,0,0,0,0.00,0
,20171120,3121,3121,,,,3121,3121,0,0,0,0.00,0
,20171121,3121,3121,,,,3121,3121,0,0,0,0.00,0
,20171122,3121,3121,,,,3121,3121,0,0,0,0.00,0
,20171123,3121,3121,,,,3121,3121,0,0,0,0.00,0
,20171124,3121,3121,,,,3121,3121,0,0,0,0.00,0
,20171127,3121,3121,,,,3121,3121,0,0,0,0.00,0
,20171128,3121,3121,,,,3121,3121,0,0,0,0.00,0
,20171129,3121,3121,,,,3121,3121,0,0,0,0.00,0
,20171130,3121,3121,,,,3121,3121,0,0,0,0.00,0
,20171201,3121,3121,,,,3121,3121,0,0,0,0.00,0
,20171204,3121,3121,,,,3121,3121,0,0,0,0.00,0
,20171205,3121,3121,,,,3121,3121,0,0,0,0.00,0
,20171206,3121,3121,,,,3121,3121,0,0,0,0.00,0
,20171207,3121,3121,,,,3121,3121,0,0,0,0.00,0
,20171208,3121,3121,,,,3121,3121,0,0,0,0.00,0
,20171211,3121,3121,,,,3121,3121,0,0,0,0.00,0
,20171212,3121,3121,,,,3121,3121,0,0,0,0.00,0
,20171213,3121,3121,,,,3121,3121,0,0,0,0.00,0
,20171214,3121,3121,,,,3121,3121,0,0,0,0.00,0
,20171215,3121,3121,,,,3121,3121,0,0,0,0.00,0
,20171218,3121,3121,,,,3121,3121,0,0,0,0.00,0
,20171219,3121,3121,,,,3121,3121,0,0,0,0.00,0
,20171220,3121,3121,,,,3121,3121,0,0,0,0.00,0
,20171221,3121,3121,,,,3121,3121,0,0,0,0.00,0
,20171222,3121,3121,,,,3121,3121,0,0,0,0.00,0
,20171225,3121,3121,,,,3121,3121,0,0,0,0.00,0
,20171226,3121,3121,,,,3121,3121,0,0,0,0.00,0
,20171227,3121,3121,,,,3121,3121,0,0,0,0.00,0
,20171228,3121,3121,,,,3121,3121,0,0,0,0.00,0
,20171229,3121,3121,,,,3121,3121,0,0,0,0.00,0
wr1804,20170418,2962,2962,,,,2962,2962,0,0,0,0.00,0
,20170419,2962,2962,,,,2864,2864,-98,-98,0,0.00,0
,20170420,2864,2864,,,,2864,2864,0,0,0,0.00,0
,20170421,2864,2864,,,,2864,2864,0,0,0,0.00,0
,20170424,2864,2864,,,,2864,2864,0,0,0,0.00,0
,20170425,2864,2864,,,,2864,2864,0,0,0,0.00,0
,20170426,2864,2864,,,,2722,2722,-142,-142,0,0.00,0
,20170427,2722,2722,,,,2767,2767,45,45,0,0.00,0
,20170428,2767,2767,,,,2858,2858,91,91,0,0.00,0
,20170502,2858,2858,,,,3000,3000,142,142,0,0.00,0
,20170503,3000,3000,,,,3143,3143,143,143,0,0.00,0
,20170504,3143,3143,,,,3017,3017,-126,-126,0,0.00,0
,20170505,3017,3017,,,,3017,3017,0,0,0,0.00,0
,20170508,3017,3017,,,,3017,3017,0,0,0,0.00,0
,20170509,3017,3017,,,,3017,3017,0,0,0,0.00,0
,20170510,3017,3017,,,,3017,3017,0,0,0,0.00,0
,20170511,3017,3017,,,,3017,3017,0,0,0,0.00,0
,20170512,3017,3017,,,,3017,3017,0,0,0,0.00,0
,20170515,3017,3017,,,,3017,3017,0,0,0,0.00,0
,20170516,3017,3017,,,,3017,3017,0,0,0,0.00,0
,20170517,3017,3017,,,,3017,3017,0,0,0,0.00,0
,20170518,3017,3017,,,,3017,3017,0,0,0,0.00,0
,20170519,3017,3017,,,,3017,3017,0,0,0,0.00,0
,20170522,3017,3017,,,,3017,3017,0,0,0,0.00,0
,20170523,3017,3017,,,,3017,3017,0,0,0,0.00,0
,20170524,3017,3017,,,,3017,3017,0,0,0,0.00,0
,20170525,3017,3017,,,,3017,3017,0,0,0,0.00,0
,20170526,3017,3017,,,,3017,3017,0,0,0,0.00,0
,20170531,3017,3017,,,,3017,3017,0,0,0,0.00,0
,20170601,3017,3017,,,,3017,3017,0,0,0,0.00,0
,20170602,3017,3017,,,,3017,3017,0,0,0,0.00,0
,20170605,3017,3017,,,,3017,3017,0,0,0,0.00,0
,20170606,3017,3017,,,,3017,3017,0,0,0,0.00,0
,20170607,3017,3017,,,,3017,3017,0,0,0,0.00,0
,20170608,3017,3017,,,,3017,3017,0,0,0,0.00,0
,20170609,3017,3017,,,,3017,3017,0,0,0,0.00,0
,20170612,3017,3017,,,,3017,3017,0,0,0,0.00,0
,20170613,3017,3017,,,,3017,3017,0,0,0,0.00,0
,20170614,3017,3017,,,,3017,3017,0,0,0,0.00,0
,20170615,3017,3017,,,,3017,3017,0,0,0,0.00,0
,20170616,3017,3017,,,,3017,3017,0,0,0,0.00,0
,20170619,3017,3017,,,,3017,3017,0,0,0,0.00,0
,20170620,3017,3017,,,,3017,3017,0,0,0,0.00,0
,20170621,3017,3017,,,,3017,3017,0,0,0,0.00,0
,20170622,3017,3017,,,,3017,3017,0,0,0,0.00,0
,20170623,3017,3017,,,,3017,3017,0,0,0,0.00,0
,20170626,3017,3017,,,,3017,3017,0,0,0,0.00,0
,20170627,3017,3017,,,,3017,3017,0,0,0,0.00,0
,20170628,3017,3017,,,,3017,3017,0,0,0,0.00,0
,20170629,3017,3017,,,,3017,3017,0,0,0,0.00,0
,20170630,3017,3017,,,,3017,3017,0,0,0,0.00,0
,20170703,3017,3017,,,,3017,3017,0,0,0,0.00,0
,20170704,3017,3017,,,,3017,3017,0,0,0,0.00,0
,20170705,3017,3017,,,,3017,3017,0,0,0,0.00,0
,20170706,3017,3017,,,,3017,3017,0,0,0,0.00,0
,20170707,3017,3017,,,,3017,3017,0,0,0,0.00,0
,20170710,3017,3017,,,,3017,3017,0,0,0,0.00,0
,20170711,3017,3017,,,,3017,3017,0,0,0,0.00,0
,20170712,3017,3017,,,,3017,3017,0,0,0,0.00,0
,20170713,3017,3017,,,,3017,3017,0,0,0,0.00,0
,20170714,3017,3017,,,,3017,3017,0,0,0,0.00,0
,20170717,3017,3017,,,,3017,3017,0,0,0,0.00,0
,20170718,3017,3017,,,,3018,3018,1,1,0,0.00,0
,20170719,3018,3018,,,,3018,3018,0,0,0,0.00,0
,20170720,3018,3018,,,,3018,3018,0,0,0,0.00,0
,20170721,3018,3018,,,,3018,3018,0,0,0,0.00,0
,20170724,3018,3018,,,,3121,3121,103,103,0,0.00,0
,20170725,3121,3121,,,,3121,3121,0,0,0,0.00,0
,20170726,3121,3121,,,,3121,3121,0,0,0,0.00,0
,20170727,3121,3121,,,,3121,3121,0,0,0,0.00,0
,20170728,3121,3121,,,,3121,3121,0,0,0,0.00,0
,20170731,3121,3121,,,,3121,3121,0,0,0,0.00,0
,20170801,3121,3121,,,,3121,3121,0,0,0,0.00,0
,20170802,3121,3121,,,,3121,3121,0,0,0,0.00,0
,20170803,3121,3121,,,,3121,3121,0,0,0,0.00,0
,20170804,3121,3121,,,,3121,3121,0,0,0,0.00,0
,20170807,3121,3121,,,,3121,3121,0,0,0,0.00,0
,20170808,3121,3121,,,,3121,3121,0,0,0,0.00,0
,20170809,3121,3121,,,,3121,3121,0,0,0,0.00,0
,20170810,3121,3121,,,,3121,3121,0,0,0,0.00,0
,20170811,3121,3121,,,,3121,3121,0,0,0,0.00,0
,20170814,3121,3121,,,,3121,3121,0,0,0,0.00,0
,20170815,3121,3121,,,,3121,3121,0,0,0,0.00,0
,20170816,3121,3121,,,,3121,3121,0,0,0,0.00,0
,20170817,3121,3121,,,,3121,3121,0,0,0,0.00,0
,20170818,3121,3121,,,,3121,3121,0,0,0,0.00,0
,20170821,3121,3121,,,,3121,3121,0,0,0,0.00,0
,20170822,3121,3121,,,,3121,3121,0,0,0,0.00,0
,20170823,3121,3121,,,,3121,3121,0,0,0,0.00,0
,20170824,3121,3121,,,,3121,3121,0,0,0,0.00,0
,20170825,3121,3121,,,,3121,3121,0,0,0,0.00,0
,20170828,3121,3121,,,,3121,3121,0,0,0,0.00,0
,20170829,3121,3121,,,,3121,3121,0,0,0,0.00,0
,20170830,3121,3121,,,,3121,3121,0,0,0,0.00,0
,20170831,3121,3121,,,,3121,3121,0,0,0,0.00,0
,20170901,3121,3121,,,,3121,3121,0,0,0,0.00,0
,20170904,3121,3121,,,,3121,3121,0,0,0,0.00,0
,20170905,3121,3121,,,,3121,3121,0,0,0,0.00,0
,20170906,3121,3121,,,,3121,3121,0,0,0,0.00,0
,20170907,3121,3121,,,,3121,3121,0,0,0,0.00,0
,20170908,3121,3121,,,,3121,3121,0,0,0,0.00,0
,20170911,3121,3121,,,,3121,3121,0,0,0,0.00,0
,20170912,3121,3121,,,,3121,3121,0,0,0,0.00,0
,20170913,3121,3121,,,,3121,3121,0,0,0,0.00,0
,20170914,3121,3121,,,,3121,3121,0,0,0,0.00,0
,20170915,3121,3121,,,,3121,3121,0,0,0,0.00,0
,20170918,3121,3121,,,,3121,3121,0,0,0,0.00,0
,20170919,3121,3121,,,,3121,3121,0,0,0,0.00,0
,20170920,3121,3121,,,,3121,3121,0,0,0,0.00,0
,20170921,3121,3121,,,,3121,3121,0,0,0,0.00,0
,20170922,3121,3121,,,,3121,3121,0,0,0,0.00,0
,20170925,3121,3121,,,,3121,3121,0,0,0,0.00,0
,20170926,3121,3121,,,,3121,3121,0,0,0,0.00,0
,20170927,3121,3121,,,,3121,3121,0,0,0,0.00,0
,20170928,3121,3121,,,,3121,3121,0,0,0,0.00,0
,20170929,3121,3121,,,,3121,3121,0,0,0,0.00,0
,20171009,3121,3121,,,,3121,3121,0,0,0,0.00,0
,20171010,3121,3121,,,,3121,3121,0,0,0,0.00,0
,20171011,3121,3121,,,,3121,3121,0,0,0,0.00,0
,20171012,3121,3121,,,,3121,3121,0,0,0,0.00,0
,20171013,3121,3121,,,,3121,3121,0,0,0,0.00,0
,20171016,3121,3121,,,,3121,3121,0,0,0,0.00,0
,20171017,3121,3121,,,,3121,3121,0,0,0,0.00,0
,20171018,3121,3121,,,,3121,3121,0,0,0,0.00,0
,20171019,3121,3121,,,,3121,3121,0,0,0,0.00,0
,20171020,3121,3121,,,,3121,3121,0,0,0,0.00,0
,20171023,3121,3121,,,,3121,3121,0,0,0,0.00,0
,20171024,3121,3121,,,,3121,3121,0,0,0,0.00,0
,20171025,3121,3121,,,,3121,3121,0,0,0,0.00,0
,20171026,3121,3121,,,,3121,3121,0,0,0,0.00,0
,20171027,3121,3121,,,,3121,3121,0,0,0,0.00,0
,20171030,3121,3121,,,,3121,3121,0,0,0,0.00,0
,20171031,3121,3121,,,,3121,3121,0,0,0,0.00,0
,20171101,3121,3121,,,,3121,3121,0,0,0,0.00,0
,20171102,3121,3121,,,,3121,3121,0,0,0,0.00,0
,20171103,3121,3121,,,,3121,3121,0,0,0,0.00,0
,20171106,3121,3121,,,,3121,3121,0,0,0,0.00,0
,20171107,3121,3121,,,,3121,3121,0,0,0,0.00,0
,20171108,3121,3121,,,,3121,3121,0,0,0,0.00,0
,20171109,3121,3121,,,,3121,3121,0,0,0,0.00,0
,20171110,3121,3121,,,,3121,3121,0,0,0,0.00,0
,20171113,3121,3121,,,,3121,3121,0,0,0,0.00,0
,20171114,3121,3121,,,,3121,3121,0,0,0,0.00,0
,20171115,3121,3121,,,,3121,3121,0,0,0,0.00,0
,20171116,3121,3121,,,,3121,3121,0,0,0,0.00,0
,20171117,3121,3121,,,,3121,3121,0,0,0,0.00,0
,20171120,3121,3121,,,,3121,3121,0,0,0,0.00,0
,20171121,3121,3121,,,,3121,3121,0,0,0,0.00,0
,20171122,3121,3121,,,,3121,3121,0,0,0,0.00,0
,20171123,3121,3121,,,,3121,3121,0,0,0,0.00,0
,20171124,3121,3121,,,,3121,3121,0,0,0,0.00,0
,20171127,3121,3121,,,,3121,3121,0,0,0,0.00,0
,20171128,3121,3121,,,,3121,3121,0,0,0,0.00,0
,20171129,3121,3121,,,,3121,3121,0,0,0,0.00,0
,20171130,3121,3121,,,,3121,3121,0,0,0,0.00,0
,20171201,3121,3121,,,,3121,3121,0,0,0,0.00,0
,20171204,3121,3121,,,,3121,3121,0,0,0,0.00,0
,20171205,3121,3121,,,,3121,3121,0,0,0,0.00,0
,20171206,3121,3121,,,,3121,3121,0,0,0,0.00,0
,20171207,3121,3121,,,,3121,3121,0,0,0,0.00,0
,20171208,3121,3121,,,,3121,3121,0,0,0,0.00,0
,20171211,3121,3121,,,,3121,3121,0,0,0,0.00,0
,20171212,3121,3121,,,,3121,3121,0,0,0,0.00,0
,20171213,3121,3121,,,,3121,3121,0,0,0,0.00,0
,20171214,3121,3121,,,,3121,3121,0,0,0,0.00,0
,20171215,3121,3121,,,,3121,3121,0,0,0,0.00,0
,20171218,3121,3121,,,,3121,3121,0,0,0,0.00,0
,20171219,3121,3121,,,,3121,3121,0,0,0,0.00,0
,20171220,3121,3121,,,,3121,3121,0,0,0,0.00,0
,20171221,3121,3121,,,,3121,3121,0,0,0,0.00,0
,20171222,3121,3121,,,,3121,3121,0,0,0,0.00,0
,20171225,3121,3121,,,,3121,3121,0,0,0,0.00,0
,20171226,3121,3121,,,,3121,3121,0,0,0,0.00,0
,20171227,3121,3121,,,,3121,3121,0,0,0,0.00,0
,20171228,3121,3121,,,,3121,3121,0,0,0,0.00,0
,20171229,3121,3121,,,,3121,3121,0,0,0,0.00,0
wr1805,20170516,3017,3017,,,,3017,3017,0,0,0,0.00,0
,20170517,3017,3017,,,,3017,3017,0,0,0,0.00,0
,20170518,3017,3017,,,,3017,3017,0,0,0,0.00,0
,20170519,3017,3017,,,,3017,3017,0,0,0,0.00,0
,20170522,3017,3017,,,,3017,3017,0,0,0,0.00,0
,20170523,3017,3017,,,,3017,3017,0,0,0,0.00,0
,20170524,3017,3017,,,,3017,3017,0,0,0,0.00,0
,20170525,3017,3017,,,,3017,3017,0,0,0,0.00,0
,20170526,3017,3017,,,,3017,3017,0,0,0,0.00,0
,20170531,3017,3017,,,,3017,3017,0,0,0,0.00,0
,20170601,3017,3017,,,,3017,3017,0,0,0,0.00,0
,20170602,3017,3017,,,,3017,3017,0,0,0,0.00,0
,20170605,3017,3017,,,,3017,3017,0,0,0,0.00,0
,20170606,3017,3017,,,,3017,3017,0,0,0,0.00,0
,20170607,3017,3017,,,,3017,3017,0,0,0,0.00,0
,20170608,3017,3017,,,,3017,3017,0,0,0,0.00,0
,20170609,3017,3017,,,,3017,3017,0,0,0,0.00,0
,20170612,3017,3017,,,,3017,3017,0,0,0,0.00,0
,20170613,3017,3017,,,,3017,3017,0,0,0,0.00,0
,20170614,3017,3017,,,,3017,3017,0,0,0,0.00,0
,20170615,3017,3017,,,,3017,3017,0,0,0,0.00,0
,20170616,3017,3017,,,,3017,3017,0,0,0,0.00,0
,20170619,3017,3017,,,,3017,3017,0,0,0,0.00,0
,20170620,3017,3017,,,,3017,3017,0,0,0,0.00,0
,20170621,3017,3017,,,,3017,3017,0,0,0,0.00,0
,20170622,3017,3017,,,,3017,3017,0,0,0,0.00,0
,20170623,3017,3017,,,,3017,3017,0,0,0,0.00,0
,20170626,3017,3017,,,,3017,3017,0,0,0,0.00,0
,20170627,3017,3017,,,,3017,3017,0,0,0,0.00,0
,20170628,3017,3017,,,,3017,3017,0,0,0,0.00,0
,20170629,3017,3017,,,,3017,3017,0,0,0,0.00,0
,20170630,3017,3017,,,,3017,3017,0,0,0,0.00,0
,20170703,3017,3017,,,,3017,3017,0,0,0,0.00,0
,20170704,3017,3017,,,,3017,3017,0,0,0,0.00,0
,20170705,3017,3017,,,,3017,3017,0,0,0,0.00,0
,20170706,3017,3017,,,,3017,3017,0,0,0,0.00,0
,20170707,3017,3017,,,,3017,3017,0,0,0,0.00,0
,20170710,3017,3017,,,,3017,3017,0,0,0,0.00,0
,20170711,3017,3017,,,,3017,3017,0,0,0,0.00,0
,20170712,3017,3017,,,,3017,3017,0,0,0,0.00,0
,20170713,3017,3017,,,,3017,3017,0,0,0,0.00,0
,20170714,3017,3017,,,,3017,3017,0,0,0,0.00,0
,20170717,3017,3017,,,,3017,3017,0,0,0,0.00,0
,20170718,3017,3017,,,,3018,3018,1,1,0,0.00,0
,20170719,3018,3018,,,,3018,3018,0,0,0,0.00,0
,20170720,3018,3018,,,,3018,3018,0,0,0,0.00,0
,20170721,3018,3018,,,,3018,3018,0,0,0,0.00,0
,20170724,3018,3018,,,,3121,3121,103,103,0,0.00,0
,20170725,3121,3121,,,,3121,3121,0,0,0,0.00,0
,20170726,3121,3121,,,,3121,3121,0,0,0,0.00,0
,20170727,3121,3121,,,,3121,3121,0,0,0,0.00,0
,20170728,3121,3121,,,,3121,3121,0,0,0,0.00,0
,20170731,3121,3121,,,,3121,3121,0,0,0,0.00,0
,20170801,3121,3121,,,,3121,3121,0,0,0,0.00,0
,20170802,3121,3121,,,,3121,3121,0,0,0,0.00,0
,20170803,3121,3121,,,,3121,3121,0,0,0,0.00,0
,20170804,3121,3121,,,,3121,3121,0,0,0,0.00,0
,20170807,3121,3121,,,,3121,3121,0,0,0,0.00,0
,20170808,3121,3121,,,,3121,3121,0,0,0,0.00,0
,20170809,3121,3121,,,,3121,3121,0,0,0,0.00,0
,20170810,3121,3121,,,,3121,3121,0,0,0,0.00,0
,20170811,3121,3121,,,,3121,3121,0,0,0,0.00,0
,20170814,3121,3121,,,,3121,3121,0,0,0,0.00,0
,20170815,3121,3121,,,,3121,3121,0,0,0,0.00,0
,20170816,3121,3121,,,,3121,3121,0,0,0,0.00,0
,20170817,3121,3121,,,,3121,3121,0,0,0,0.00,0
,20170818,3121,3121,,,,3121,3121,0,0,0,0.00,0
,20170821,3121,3121,,,,3121,3121,0,0,0,0.00,0
,20170822,3121,3121,,,,3121,3121,0,0,0,0.00,0
,20170823,3121,3121,,,,3121,3121,0,0,0,0.00,0
,20170824,3121,3121,,,,3121,3121,0,0,0,0.00,0
,20170825,3121,3121,,,,3121,3121,0,0,0,0.00,0
,20170828,3121,3121,,,,3121,3121,0,0,0,0.00,0
,20170829,3121,3121,,,,3121,3121,0,0,0,0.00,0
,20170830,3121,3121,,,,3121,3121,0,0,0,0.00,0
,20170831,3121,3121,,,,3121,3121,0,0,0,0.00,0
,20170901,3121,3121,,,,3121,3121,0,0,0,0.00,0
,20170904,3121,3121,,,,3121,3121,0,0,0,0.00,0
,20170905,3121,3121,,,,3121,3121,0,0,0,0.00,0
,20170906,3121,3121,,,,3121,3121,0,0,0,0.00,0
,20170907,3121,3121,,,,3121,3121,0,0,0,0.00,0
,20170908,3121,3121,,,,3121,3121,0,0,0,0.00,0
,20170911,3121,3121,,,,3121,3121,0,0,0,0.00,0
,20170912,3121,3121,,,,3121,3121,0,0,0,0.00,0
,20170913,3121,3121,,,,3121,3121,0,0,0,0.00,0
,20170914,3121,3121,,,,3121,3121,0,0,0,0.00,0
,20170915,3121,3121,,,,3121,3121,0,0,0,0.00,0
,20170918,3121,3121,,,,3121,3121,0,0,0,0.00,0
,20170919,3121,3121,,,,3121,3121,0,0,0,0.00,0
,20170920,3121,3121,,,,3121,3121,0,0,0,0.00,0
,20170921,3121,3121,,,,3121,3121,0,0,0,0.00,0
,20170922,3121,3121,,,,3121,3121,0,0,0,0.00,0
,20170925,3121,3121,,,,3121,3121,0,0,0,0.00,0
,20170926,3121,3121,,,,3121,3121,0,0,0,0.00,0
,20170927,3121,3121,,,,3121,3121,0,0,0,0.00,0
,20170928,3121,3121,,,,3121,3121,0,0,0,0.00,0
,20170929,3121,3121,,,,3121,3121,0,0,0,0.00,0
,20171009,3121,3121,,,,3121,3121,0,0,0,0.00,0
,20171010,3121,3121,,,,3121,3121,0,0,0,0.00,0
,20171011,3121,3121,,,,3121,3121,0,0,0,0.00,0
,20171012,3121,3121,,,,3121,3121,0,0,0,0.00,0
,20171013,3121,3121,,,,3121,3121,0,0,0,0.00,0
,20171016,3121,3121,,,,3121,3121,0,0,0,0.00,0
,20171017,3121,3121,,,,3121,3121,0,0,0,0.00,0
,20171018,3121,3121,,,,3121,3121,0,0,0,0.00,0
,20171019,3121,3121,,,,3121,3121,0,0,0,0.00,0
,20171020,3121,3121,,,,3121,3121,0,0,0,0.00,0
,20171023,3121,3121,,,,3121,3121,0,0,0,0.00,0
,20171024,3121,3121,,,,3121,3121,0,0,0,0.00,0
,20171025,3121,3121,,,,3121,3121,0,0,0,0.00,0
,20171026,3121,3121,,,,3121,3121,0,0,0,0.00,0
,20171027,3121,3121,,,,3121,3121,0,0,0,0.00,0
,20171030,3121,3121,,,,3121,3121,0,0,0,0.00,0
,20171031,3121,3121,,,,3121,3121,0,0,0,0.00,0
,20171101,3121,3121,,,,3121,3121,0,0,0,0.00,0
,20171102,3121,3121,,,,3121,3121,0,0,0,0.00,0
,20171103,3121,3121,,,,3121,3121,0,0,0,0.00,0
,20171106,3121,3121,,,,3121,3121,0,0,0,0.00,0
,20171107,3121,3121,,,,3121,3121,0,0,0,0.00,0
,20171108,3121,3121,,,,3121,3121,0,0,0,0.00,0
,20171109,3121,3121,,,,3121,3121,0,0,0,0.00,0
,20171110,3121,3121,,,,3121,3121,0,0,0,0.00,0
,20171113,3121,3121,,,,3121,3121,0,0,0,0.00,0
,20171114,3121,3121,,,,3121,3121,0,0,0,0.00,0
,20171115,3121,3121,,,,3121,3121,0,0,0,0.00,0
,20171116,3121,3121,,,,3121,3121,0,0,0,0.00,0
,20171117,3121,3121,,,,3121,3121,0,0,0,0.00,0
,20171120,3121,3121,,,,3121,3121,0,0,0,0.00,0
,20171121,3121,3121,,,,3121,3121,0,0,0,0.00,0
,20171122,3121,3121,,,,3121,3121,0,0,0,0.00,0
,20171123,3121,3121,,,,3121,3121,0,0,0,0.00,0
,20171124,3121,3121,,,,3121,3121,0,0,0,0.00,0
,20171127,3121,3121,,,,3121,3121,0,0,0,0.00,0
,20171128,3121,3121,,,,3121,3121,0,0,0,0.00,0
,20171129,3121,3121,,,,3121,3121,0,0,0,0.00,0
,20171130,3121,3121,,,,3121,3121,0,0,0,0.00,0
,20171201,3121,3121,,,,3121,3121,0,0,0,0.00,0
,20171204,3121,3121,,,,3121,3121,0,0,0,0.00,0
,20171205,3121,3121,,,,3121,3121,0,0,0,0.00,0
,20171206,3121,3121,,,,3121,3121,0,0,0,0.00,0
,20171207,3121,3121,,,,3121,3121,0,0,0,0.00,0
,20171208,3121,3121,,,,3121,3121,0,0,0,0.00,0
,20171211,3121,3121,,,,3121,3121,0,0,0,0.00,0
,20171212,3121,3121,,,,3121,3121,0,0,0,0.00,0
,20171213,3121,3121,,,,3121,3121,0,0,0,0.00,0
,20171214,3121,3121,,,,3121,3121,0,0,0,0.00,0
,20171215,3121,3121,,,,3121,3121,0,0,0,0.00,0
,20171218,3121,3121,,,,3121,3121,0,0,0,0.00,0
,20171219,3121,3121,,,,3121,3121,0,0,0,0.00,0
,20171220,3121,3121,,,,3121,3121,0,0,0,0.00,0
,20171221,3121,3121,,,,3121,3121,0,0,0,0.00,0
,20171222,3121,3121,,,,3121,3121,0,0,0,0.00,0
,20171225,3121,3121,,,,3121,3121,0,0,0,0.00,0
,20171226,3121,3121,,,,3121,3121,0,0,0,0.00,0
,20171227,3121,3121,,,,3121,3121,0,0,0,0.00,0
,20171228,3121,3121,,,,3121,3121,0,0,0,0.00,0
,20171229,3121,3121,,,,3121,3121,0,0,0,0.00,0
wr1806,20170616,3017,3017,,,,3017,3017,0,0,0,0.00,0
,20170619,3017,3017,,,,3017,3017,0,0,0,0.00,0
,20170620,3017,3017,,,,3017,3017,0,0,0,0.00,0
,20170621,3017,3017,,,,3017,3017,0,0,0,0.00,0
,20170622,3017,3017,,,,3017,3017,0,0,0,0.00,0
,20170623,3017,3017,,,,3017,3017,0,0,0,0.00,0
,20170626,3017,3017,,,,3017,3017,0,0,0,0.00,0
,20170627,3017,3017,,,,3017,3017,0,0,0,0.00,0
,20170628,3017,3017,,,,3017,3017,0,0,0,0.00,0
,20170629,3017,3017,,,,3017,3017,0,0,0,0.00,0
,20170630,3017,3017,,,,3017,3017,0,0,0,0.00,0
,20170703,3017,3017,,,,3017,3017,0,0,0,0.00,0
,20170704,3017,3017,,,,3017,3017,0,0,0,0.00,0
,20170705,3017,3017,,,,3017,3017,0,0,0,0.00,0
,20170706,3017,3017,,,,3017,3017,0,0,0,0.00,0
,20170707,3017,3017,,,,3017,3017,0,0,0,0.00,0
,20170710,3017,3017,,,,3017,3017,0,0,0,0.00,0
,20170711,3017,3017,,,,3017,3017,0,0,0,0.00,0
,20170712,3017,3017,,,,3017,3017,0,0,0,0.00,0
,20170713,3017,3017,,,,3017,3017,0,0,0,0.00,0
,20170714,3017,3017,,,,3017,3017,0,0,0,0.00,0
,20170717,3017,3017,,,,3017,3017,0,0,0,0.00,0
,20170718,3017,3017,,,,3018,3018,1,1,0,0.00,0
,20170719,3018,3018,,,,3018,3018,0,0,0,0.00,0
,20170720,3018,3018,,,,3018,3018,0,0,0,0.00,0
,20170721,3018,3018,,,,3018,3018,0,0,0,0.00,0
,20170724,3018,3018,,,,3121,3121,103,103,0,0.00,0
,20170725,3121,3121,,,,3121,3121,0,0,0,0.00,0
,20170726,3121,3121,,,,3121,3121,0,0,0,0.00,0
,20170727,3121,3121,,,,3121,3121,0,0,0,0.00,0
,20170728,3121,3121,,,,3121,3121,0,0,0,0.00,0
,20170731,3121,3121,,,,3121,3121,0,0,0,0.00,0
,20170801,3121,3121,,,,3121,3121,0,0,0,0.00,0
,20170802,3121,3121,,,,3121,3121,0,0,0,0.00,0
,20170803,3121,3121,,,,3121,3121,0,0,0,0.00,0
,20170804,3121,3121,,,,3121,3121,0,0,0,0.00,0
,20170807,3121,3121,,,,3121,3121,0,0,0,0.00,0
,20170808,3121,3121,,,,3121,3121,0,0,0,0.00,0
,20170809,3121,3121,,,,3121,3121,0,0,0,0.00,0
,20170810,3121,3121,,,,3121,3121,0,0,0,0.00,0
,20170811,3121,3121,,,,3121,3121,0,0,0,0.00,0
,20170814,3121,3121,,,,3121,3121,0,0,0,0.00,0
,20170815,3121,3121,,,,3121,3121,0,0,0,0.00,0
,20170816,3121,3121,,,,3121,3121,0,0,0,0.00,0
,20170817,3121,3121,,,,3121,3121,0,0,0,0.00,0
,20170818,3121,3121,,,,3121,3121,0,0,0,0.00,0
,20170821,3121,3121,,,,3121,3121,0,0,0,0.00,0
,20170822,3121,3121,,,,3121,3121,0,0,0,0.00,0
,20170823,3121,3121,,,,3121,3121,0,0,0,0.00,0
,20170824,3121,3121,,,,3121,3121,0,0,0,0.00,0
,20170825,3121,3121,,,,3121,3121,0,0,0,0.00,0
,20170828,3121,3121,,,,3121,3121,0,0,0,0.00,0
,20170829,3121,3121,,,,3121,3121,0,0,0,0.00,0
,20170830,3121,3121,,,,3121,3121,0,0,0,0.00,0
,20170831,3121,3121,,,,3121,3121,0,0,0,0.00,0
,20170901,3121,3121,,,,3121,3121,0,0,0,0.00,0
,20170904,3121,3121,,,,3121,3121,0,0,0,0.00,0
,20170905,3121,3121,,,,3121,3121,0,0,0,0.00,0
,20170906,3121,3121,,,,3121,3121,0,0,0,0.00,0
,20170907,3121,3121,,,,3121,3121,0,0,0,0.00,0
,20170908,3121,3121,,,,3121,3121,0,0,0,0.00,0
,20170911,3121,3121,,,,3121,3121,0,0,0,0.00,0
,20170912,3121,3121,,,,3121,3121,0,0,0,0.00,0
,20170913,3121,3121,,,,3121,3121,0,0,0,0.00,0
,20170914,3121,3121,,,,3121,3121,0,0,0,0.00,0
,20170915,3121,3121,,,,3121,3121,0,0,0,0.00,0
,20170918,3121,3121,,,,3121,3121,0,0,0,0.00,0
,20170919,3121,3121,,,,3121,3121,0,0,0,0.00,0
,20170920,3121,3121,,,,3121,3121,0,0,0,0.00,0
,20170921,3121,3121,,,,3121,3121,0,0,0,0.00,0
,20170922,3121,3121,,,,3121,3121,0,0,0,0.00,0
,20170925,3121,3121,,,,3121,3121,0,0,0,0.00,0
,20170926,3121,3121,,,,3121,3121,0,0,0,0.00,0
,20170927,3121,3121,,,,3121,3121,0,0,0,0.00,0
,20170928,3121,3121,,,,3121,3121,0,0,0,0.00,0
,20170929,3121,3121,,,,3121,3121,0,0,0,0.00,0
,20171009,3121,3121,,,,3121,3121,0,0,0,0.00,0
,20171010,3121,3121,,,,3121,3121,0,0,0,0.00,0
,20171011,3121,3121,,,,3121,3121,0,0,0,0.00,0
,20171012,3121,3121,,,,3121,3121,0,0,0,0.00,0
,20171013,3121,3121,,,,3121,3121,0,0,0,0.00,0
,20171016,3121,3121,,,,3121,3121,0,0,0,0.00,0
,20171017,3121,3121,,,,3121,3121,0,0,0,0.00,0
,20171018,3121,3121,,,,3121,3121,0,0,0,0.00,0
,20171019,3121,3121,,,,3121,3121,0,0,0,0.00,0
,20171020,3121,3121,,,,3121,3121,0,0,0,0.00,0
,20171023,3121,3121,,,,3121,3121,0,0,0,0.00,0
,20171024,3121,3121,,,,3121,3121,0,0,0,0.00,0
,20171025,3121,3121,,,,3121,3121,0,0,0,0.00,0
,20171026,3121,3121,,,,3121,3121,0,0,0,0.00,0
,20171027,3121,3121,,,,3121,3121,0,0,0,0.00,0
,20171030,3121,3121,,,,3121,3121,0,0,0,0.00,0
,20171031,3121,3121,,,,3121,3121,0,0,0,0.00,0
,20171101,3121,3121,,,,3121,3121,0,0,0,0.00,0
,20171102,3121,3121,,,,3121,3121,0,0,0,0.00,0
,20171103,3121,3121,,,,3121,3121,0,0,0,0.00,0
,20171106,3121,3121,,,,3121,3121,0,0,0,0.00,0
,20171107,3121,3121,,,,3121,3121,0,0,0,0.00,0
,20171108,3121,3121,,,,3121,3121,0,0,0,0.00,0
,20171109,3121,3121,,,,3121,3121,0,0,0,0.00,0
,20171110,3121,3121,,,,3121,3121,0,0,0,0.00,0
,20171113,3121,3121,,,,3121,3121,0,0,0,0.00,0
,20171114,3121,3121,,,,3121,3121,0,0,0,0.00,0
,20171115,3121,3121,,,,3121,3121,0,0,0,0.00,0
,20171116,3121,3121,,,,3121,3121,0,0,0,0.00,0
,20171117,3121,3121,,,,3121,3121,0,0,0,0.00,0
,20171120,3121,3121,,,,3121,3121,0,0,0,0.00,0
,20171121,3121,3121,,,,3121,3121,0,0,0,0.00,0
,20171122,3121,3121,,,,3121,3121,0,0,0,0.00,0
,20171123,3121,3121,,,,3121,3121,0,0,0,0.00,0
,20171124,3121,3121,,,,3121,3121,0,0,0,0.00,0
,20171127,3121,3121,,,,3121,3121,0,0,0,0.00,0
,20171128,3121,3121,,,,3121,3121,0,0,0,0.00,0
,20171129,3121,3121,,,,3121,3121,0,0,0,0.00,0
,20171130,3121,3121,,,,3121,3121,0,0,0,0.00,0
,20171201,3121,3121,,,,3121,3121,0,0,0,0.00,0
,20171204,3121,3121,,,,3121,3121,0,0,0,0.00,0
,20171205,3121,3121,,,,3121,3121,0,0,0,0.00,0
,20171206,3121,3121,,,,3121,3121,0,0,0,0.00,0
,20171207,3121,3121,,,,3121,3121,0,0,0,0.00,0
,20171208,3121,3121,,,,3121,3121,0,0,0,0.00,0
,20171211,3121,3121,,,,3121,3121,0,0,0,0.00,0
,20171212,3121,3121,,,,3121,3121,0,0,0,0.00,0
,20171213,3121,3121,,,,3121,3121,0,0,0,0.00,0
,20171214,3121,3121,,,,3121,3121,0,0,0,0.00,0
,20171215,3121,3121,,,,3121,3121,0,0,0,0.00,0
,20171218,3121,3121,,,,3121,3121,0,0,0,0.00,0
,20171219,3121,3121,,,,3121,3121,0,0,0,0.00,0
,20171220,3121,3121,,,,3121,3121,0,0,0,0.00,0
,20171221,3121,3121,,,,3121,3121,0,0,0,0.00,0
,20171222,3121,3121,,,,3121,3121,0,0,0,0.00,0
,20171225,3121,3121,,,,3121,3121,0,0,0,0.00,0
,20171226,3121,3121,,,,3121,3121,0,0,0,0.00,0
,20171227,3121,3121,,,,3121,3121,0,0,0,0.00,0
,20171228,3121,3121,,,,3121,3121,0,0,0,0.00,0
,20171229,3121,3121,,,,3121,3121,0,0,0,0.00,0
wr1807,20170718,3017,3017,,,,3018,3018,1,1,0,0.00,0
,20170719,3018,3018,,,,3018,3018,0,0,0,0.00,0
,20170720,3018,3018,,,,3018,3018,0,0,0,0.00,0
,20170721,3018,3018,,,,3018,3018,0,0,0,0.00,0
,20170724,3018,3018,,,,3121,3121,103,103,0,0.00,0
,20170725,3121,3121,,,,3121,3121,0,0,0,0.00,0
,20170726,3121,3121,,,,3121,3121,0,0,0,0.00,0
,20170727,3121,3121,,,,3121,3121,0,0,0,0.00,0
,20170728,3121,3121,,,,3121,3121,0,0,0,0.00,0
,20170731,3121,3121,,,,3121,3121,0,0,0,0.00,0
,20170801,3121,3121,,,,3121,3121,0,0,0,0.00,0
,20170802,3121,3121,,,,3121,3121,0,0,0,0.00,0
,20170803,3121,3121,,,,3121,3121,0,0,0,0.00,0
,20170804,3121,3121,,,,3121,3121,0,0,0,0.00,0
,20170807,3121,3121,,,,3121,3121,0,0,0,0.00,0
,20170808,3121,3121,,,,3121,3121,0,0,0,0.00,0
,20170809,3121,3121,,,,3121,3121,0,0,0,0.00,0
,20170810,3121,3121,,,,3121,3121,0,0,0,0.00,0
,20170811,3121,3121,,,,3121,3121,0,0,0,0.00,0
,20170814,3121,3121,,,,3121,3121,0,0,0,0.00,0
,20170815,3121,3121,,,,3121,3121,0,0,0,0.00,0
,20170816,3121,3121,,,,3121,3121,0,0,0,0.00,0
,20170817,3121,3121,,,,3121,3121,0,0,0,0.00,0
,20170818,3121,3121,,,,3121,3121,0,0,0,0.00,0
,20170821,3121,3121,,,,3121,3121,0,0,0,0.00,0
,20170822,3121,3121,,,,3121,3121,0,0,0,0.00,0
,20170823,3121,3121,,,,3121,3121,0,0,0,0.00,0
,20170824,3121,3121,,,,3121,3121,0,0,0,0.00,0
,20170825,3121,3121,,,,3121,3121,0,0,0,0.00,0
,20170828,3121,3121,,,,3121,3121,0,0,0,0.00,0
,20170829,3121,3121,,,,3121,3121,0,0,0,0.00,0
,20170830,3121,3121,,,,3121,3121,0,0,0,0.00,0
,20170831,3121,3121,,,,3121,3121,0,0,0,0.00,0
,20170901,3121,3121,,,,3121,3121,0,0,0,0.00,0
,20170904,3121,3121,,,,3121,3121,0,0,0,0.00,0
,20170905,3121,3121,,,,3121,3121,0,0,0,0.00,0
,20170906,3121,3121,,,,3121,3121,0,0,0,0.00,0
,20170907,3121,3121,,,,3121,3121,0,0,0,0.00,0
,20170908,3121,3121,,,,3121,3121,0,0,0,0.00,0
,20170911,3121,3121,,,,3121,3121,0,0,0,0.00,0
,20170912,3121,3121,,,,3121,3121,0,0,0,0.00,0
,20170913,3121,3121,,,,3121,3121,0,0,0,0.00,0
,20170914,3121,3121,,,,3121,3121,0,0,0,0.00,0
,20170915,3121,3121,,,,3121,3121,0,0,0,0.00,0
,20170918,3121,3121,,,,3121,3121,0,0,0,0.00,0
,20170919,3121,3121,,,,3121,3121,0,0,0,0.00,0
,20170920,3121,3121,,,,3121,3121,0,0,0,0.00,0
,20170921,3121,3121,,,,3121,3121,0,0,0,0.00,0
,20170922,3121,3121,,,,3121,3121,0,0,0,0.00,0
,20170925,3121,3121,,,,3121,3121,0,0,0,0.00,0
,20170926,3121,3121,,,,3121,3121,0,0,0,0.00,0
,20170927,3121,3121,,,,3121,3121,0,0,0,0.00,0
,20170928,3121,3121,,,,3121,3121,0,0,0,0.00,0
,20170929,3121,3121,,,,3121,3121,0,0,0,0.00,0
,20171009,3121,3121,,,,3121,3121,0,0,0,0.00,0
,20171010,3121,3121,,,,3121,3121,0,0,0,0.00,0
,20171011,3121,3121,,,,3121,3121,0,0,0,0.00,0
,20171012,3121,3121,,,,3121,3121,0,0,0,0.00,0
,20171013,3121,3121,,,,3121,3121,0,0,0,0.00,0
,20171016,3121,3121,,,,3121,3121,0,0,0,0.00,0
,20171017,3121,3121,,,,3121,3121,0,0,0,0.00,0
,20171018,3121,3121,,,,3121,3121,0,0,0,0.00,0
,20171019,3121,3121,,,,3121,3121,0,0,0,0.00,0
,20171020,3121,3121,,,,3121,3121,0,0,0,0.00,0
,20171023,3121,3121,,,,3121,3121,0,0,0,0.00,0
,20171024,3121,3121,,,,3121,3121,0,0,0,0.00,0
,20171025,3121,3121,,,,3121,3121,0,0,0,0.00,0
,20171026,3121,3121,,,,3121,3121,0,0,0,0.00,0
,20171027,3121,3121,,,,3121,3121,0,0,0,0.00,0
,20171030,3121,3121,,,,3121,3121,0,0,0,0.00,0
,20171031,3121,3121,,,,3121,3121,0,0,0,0.00,0
,20171101,3121,3121,,,,3121,3121,0,0,0,0.00,0
,20171102,3121,3121,,,,3121,3121,0,0,0,0.00,0
,20171103,3121,3121,,,,3121,3121,0,0,0,0.00,0
,20171106,3121,3121,,,,3121,3121,0,0,0,0.00,0
,20171107,3121,3121,,,,3121,3121,0,0,0,0.00,0
,20171108,3121,3121,,,,3121,3121,0,0,0,0.00,0
,20171109,3121,3121,,,,3121,3121,0,0,0,0.00,0
,20171110,3121,3121,,,,3121,3121,0,0,0,0.00,0
,20171113,3121,3121,,,,3121,3121,0,0,0,0.00,0
,20171114,3121,3121,,,,3121,3121,0,0,0,0.00,0
,20171115,3121,3121,,,,3121,3121,0,0,0,0.00,0
,20171116,3121,3121,,,,3121,3121,0,0,0,0.00,0
,20171117,3121,3121,,,,3121,3121,0,0,0,0.00,0
,20171120,3121,3121,,,,3121,3121,0,0,0,0.00,0
,20171121,3121,3121,,,,3121,3121,0,0,0,0.00,0
,20171122,3121,3121,,,,3121,3121,0,0,0,0.00,0
,20171123,3121,3121,,,,3121,3121,0,0,0,0.00,0
,20171124,3121,3121,,,,3121,3121,0,0,0,0.00,0
,20171127,3121,3121,,,,3121,3121,0,0,0,0.00,0
,20171128,3121,3121,,,,3121,3121,0,0,0,0.00,0
,20171129,3121,3121,,,,3121,3121,0,0,0,0.00,0
,20171130,3121,3121,,,,3121,3121,0,0,0,0.00,0
,20171201,3121,3121,,,,3121,3121,0,0,0,0.00,0
,20171204,3121,3121,,,,3121,3121,0,0,0,0.00,0
,20171205,3121,3121,,,,3121,3121,0,0,0,0.00,0
,20171206,3121,3121,,,,3121,3121,0,0,0,0.00,0
,20171207,3121,3121,,,,3121,3121,0,0,0,0.00,0
,20171208,3121,3121,,,,3121,3121,0,0,0,0.00,0
,20171211,3121,3121,,,,3121,3121,0,0,0,0.00,0
,20171212,3121,3121,,,,3121,3121,0,0,0,0.00,0
,20171213,3121,3121,,,,3121,3121,0,0,0,0.00,0
,20171214,3121,3121,,,,3121,3121,0,0,0,0.00,0
,20171215,3121,3121,,,,3121,3121,0,0,0,0.00,0
,20171218,3121,3121,,,,3121,3121,0,0,0,0.00,0
,20171219,3121,3121,,,,3121,3121,0,0,0,0.00,0
,20171220,3121,3121,,,,3121,3121,0,0,0,0.00,0
,20171221,3121,3121,,,,3121,3121,0,0,0,0.00,0
,20171222,3121,3121,,,,3121,3121,0,0,0,0.00,0
,20171225,3121,3121,,,,3121,3121,0,0,0,0.00,0
,20171226,3121,3121,,,,3121,3121,0,0,0,0.00,0
,20171227,3121,3121,,,,3121,3121,0,0,0,0.00,0
,20171228,3121,3121,,,,3121,3121,0,0,0,0.00,0
,20171229,3121,3121,,,,3121,3121,0,0,0,0.00,0
wr1808,20170816,3121,3121,,,,3121,3121,0,0,0,0.00,0
,20170817,3121,3121,,,,3121,3121,0,0,0,0.00,0
,20170818,3121,3121,,,,3121,3121,0,0,0,0.00,0
,20170821,3121,3121,,,,3121,3121,0,0,0,0.00,0
,20170822,3121,3121,,,,3121,3121,0,0,0,0.00,0
,20170823,3121,3121,,,,3121,3121,0,0,0,0.00,0
,20170824,3121,3121,,,,3121,3121,0,0,0,0.00,0
,20170825,3121,3121,,,,3121,3121,0,0,0,0.00,0
,20170828,3121,3121,,,,3121,3121,0,0,0,0.00,0
,20170829,3121,3121,,,,3121,3121,0,0,0,0.00,0
,20170830,3121,3121,,,,3121,3121,0,0,0,0.00,0
,20170831,3121,3121,,,,3121,3121,0,0,0,0.00,0
,20170901,3121,3121,,,,3121,3121,0,0,0,0.00,0
,20170904,3121,3121,,,,3121,3121,0,0,0,0.00,0
,20170905,3121,3121,,,,3121,3121,0,0,0,0.00,0
,20170906,3121,3121,,,,3121,3121,0,0,0,0.00,0
,20170907,3121,3121,,,,3121,3121,0,0,0,0.00,0
,20170908,3121,3121,,,,3121,3121,0,0,0,0.00,0
,20170911,3121,3121,,,,3121,3121,0,0,0,0.00,0
,20170912,3121,3121,,,,3121,3121,0,0,0,0.00,0
,20170913,3121,3121,,,,3121,3121,0,0,0,0.00,0
,20170914,3121,3121,,,,3121,3121,0,0,0,0.00,0
,20170915,3121,3121,,,,3121,3121,0,0,0,0.00,0
,20170918,3121,3121,,,,3121,3121,0,0,0,0.00,0
,20170919,3121,3121,,,,3121,3121,0,0,0,0.00,0
,20170920,3121,3121,,,,3121,3121,0,0,0,0.00,0
,20170921,3121,3121,,,,3121,3121,0,0,0,0.00,0
,20170922,3121,3121,,,,3121,3121,0,0,0,0.00,0
,20170925,3121,3121,,,,3121,3121,0,0,0,0.00,0
,20170926,3121,3121,,,,3121,3121,0,0,0,0.00,0
,20170927,3121,3121,,,,3121,3121,0,0,0,0.00,0
,20170928,3121,3121,,,,3121,3121,0,0,0,0.00,0
,20170929,3121,3121,,,,3121,3121,0,0,0,0.00,0
,20171009,3121,3121,,,,3121,3121,0,0,0,0.00,0
,20171010,3121,3121,,,,3121,3121,0,0,0,0.00,0
,20171011,3121,3121,,,,3121,3121,0,0,0,0.00,0
,20171012,3121,3121,,,,3121,3121,0,0,0,0.00,0
,20171013,3121,3121,,,,3121,3121,0,0,0,0.00,0
,20171016,3121,3121,,,,3121,3121,0,0,0,0.00,0
,20171017,3121,3121,,,,3121,3121,0,0,0,0.00,0
,20171018,3121,3121,,,,3121,3121,0,0,0,0.00,0
,20171019,3121,3121,,,,3121,3121,0,0,0,0.00,0
,20171020,3121,3121,,,,3121,3121,0,0,0,0.00,0
,20171023,3121,3121,,,,3121,3121,0,0,0,0.00,0
,20171024,3121,3121,,,,3121,3121,0,0,0,0.00,0
,20171025,3121,3121,,,,3121,3121,0,0,0,0.00,0
,20171026,3121,3121,,,,3121,3121,0,0,0,0.00,0
,20171027,3121,3121,,,,3121,3121,0,0,0,0.00,0
,20171030,3121,3121,,,,3121,3121,0,0,0,0.00,0
,20171031,3121,3121,,,,3121,3121,0,0,0,0.00,0
,20171101,3121,3121,,,,3121,3121,0,0,0,0.00,0
,20171102,3121,3121,,,,3121,3121,0,0,0,0.00,0
,20171103,3121,3121,,,,3121,3121,0,0,0,0.00,0
,20171106,3121,3121,,,,3121,3121,0,0,0,0.00,0
,20171107,3121,3121,,,,3121,3121,0,0,0,0.00,0
,20171108,3121,3121,,,,3121,3121,0,0,0,0.00,0
,20171109,3121,3121,,,,3121,3121,0,0,0,0.00,0
,20171110,3121,3121,,,,3121,3121,0,0,0,0.00,0
,20171113,3121,3121,,,,3121,3121,0,0,0,0.00,0
,20171114,3121,3121,,,,3121,3121,0,0,0,0.00,0
,20171115,3121,3121,,,,3121,3121,0,0,0,0.00,0
,20171116,3121,3121,,,,3121,3121,0,0,0,0.00,0
,20171117,3121,3121,,,,3121,3121,0,0,0,0.00,0
,20171120,3121,3121,,,,3121,3121,0,0,0,0.00,0
,20171121,3121,3121,,,,3121,3121,0,0,0,0.00,0
,20171122,3121,3121,,,,3121,3121,0,0,0,0.00,0
,20171123,3121,3121,,,,3121,3121,0,0,0,0.00,0
,20171124,3121,3121,,,,3121,3121,0,0,0,0.00,0
,20171127,3121,3121,,,,3121,3121,0,0,0,0.00,0
,20171128,3121,3121,,,,3121,3121,0,0,0,0.00,0
,20171129,3121,3121,,,,3121,3121,0,0,0,0.00,0
,20171130,3121,3121,,,,3121,3121,0,0,0,0.00,0
,20171201,3121,3121,,,,3121,3121,0,0,0,0.00,0
,20171204,3121,3121,,,,3121,3121,0,0,0,0.00,0
,20171205,3121,3121,,,,3121,3121,0,0,0,0.00,0
,20171206,3121,3121,,,,3121,3121,0,0,0,0.00,0
,20171207,3121,3121,,,,3121,3121,0,0,0,0.00,0
,20171208,3121,3121,,,,3121,3121,0,0,0,0.00,0
,20171211,3121,3121,,,,3121,3121,0,0,0,0.00,0
,20171212,3121,3121,,,,3121,3121,0,0,0,0.00,0
,20171213,3121,3121,,,,3121,3121,0,0,0,0.00,0
,20171214,3121,3121,,,,3121,3121,0,0,0,0.00,0
,20171215,3121,3121,,,,3121,3121,0,0,0,0.00,0
,20171218,3121,3121,,,,3121,3121,0,0,0,0.00,0
,20171219,3121,3121,,,,3121,3121,0,0,0,0.00,0
,20171220,3121,3121,,,,3121,3121,0,0,0,0.00,0
,20171221,3121,3121,,,,3121,3121,0,0,0,0.00,0
,20171222,3121,3121,,,,3121,3121,0,0,0,0.00,0
,20171225,3121,3121,,,,3121,3121,0,0,0,0.00,0
,20171226,3121,3121,,,,3121,3121,0,0,0,0.00,0
,20171227,3121,3121,,,,3121,3121,0,0,0,0.00,0
,20171228,3121,3121,,,,3121,3121,0,0,0,0.00,0
,20171229,3121,3121,,,,3121,3121,0,0,0,0.00,0
wr1809,20170918,3121,3121,,,,3121,3121,0,0,0,0.00,0
,20170919,3121,3121,,,,3121,3121,0,0,0,0.00,0
,20170920,3121,3121,,,,3121,3121,0,0,0,0.00,0
,20170921,3121,3121,,,,3121,3121,0,0,0,0.00,0
,20170922,3121,3121,,,,3121,3121,0,0,0,0.00,0
,20170925,3121,3121,,,,3121,3121,0,0,0,0.00,0
,20170926,3121,3121,,,,3121,3121,0,0,0,0.00,0
,20170927,3121,3121,,,,3121,3121,0,0,0,0.00,0
,20170928,3121,3121,,,,3121,3121,0,0,0,0.00,0
,20170929,3121,3121,,,,3121,3121,0,0,0,0.00,0
,20171009,3121,3121,,,,3121,3121,0,0,0,0.00,0
,20171010,3121,3121,,,,3121,3121,0,0,0,0.00,0
,20171011,3121,3121,,,,3121,3121,0,0,0,0.00,0
,20171012,3121,3121,,,,3121,3121,0,0,0,0.00,0
,20171013,3121,3121,,,,3121,3121,0,0,0,0.00,0
,20171016,3121,3121,,,,3121,3121,0,0,0,0.00,0
,20171017,3121,3121,,,,3121,3121,0,0,0,0.00,0
,20171018,3121,3121,,,,3121,3121,0,0,0,0.00,0
,20171019,3121,3121,,,,3121,3121,0,0,0,0.00,0
,20171020,3121,3121,,,,3121,3121,0,0,0,0.00,0
,20171023,3121,3121,,,,3121,3121,0,0,0,0.00,0
,20171024,3121,3121,,,,3121,3121,0,0,0,0.00,0
,20171025,3121,3121,,,,3121,3121,0,0,0,0.00,0
,20171026,3121,3121,,,,3121,3121,0,0,0,0.00,0
,20171027,3121,3121,,,,3121,3121,0,0,0,0.00,0
,20171030,3121,3121,,,,3121,3121,0,0,0,0.00,0
,20171031,3121,3121,,,,3121,3121,0,0,0,0.00,0
,20171101,3121,3121,,,,3121,3121,0,0,0,0.00,0
,20171102,3121,3121,,,,3121,3121,0,0,0,0.00,0
,20171103,3121,3121,,,,3121,3121,0,0,0,0.00,0
,20171106,3121,3121,,,,3121,3121,0,0,0,0.00,0
,20171107,3121,3121,,,,3121,3121,0,0,0,0.00,0
,20171108,3121,3121,,,,3121,3121,0,0,0,0.00,0
,20171109,3121,3121,,,,3121,3121,0,0,0,0.00,0
,20171110,3121,3121,,,,3121,3121,0,0,0,0.00,0
,20171113,3121,3121,,,,3121,3121,0,0,0,0.00,0
,20171114,3121,3121,,,,3121,3121,0,0,0,0.00,0
,20171115,3121,3121,,,,3121,3121,0,0,0,0.00,0
,20171116,3121,3121,,,,3121,3121,0,0,0,0.00,0
,20171117,3121,3121,,,,3121,3121,0,0,0,0.00,0
,20171120,3121,3121,,,,3121,3121,0,0,0,0.00,0
,20171121,3121,3121,,,,3121,3121,0,0,0,0.00,0
,20171122,3121,3121,,,,3121,3121,0,0,0,0.00,0
,20171123,3121,3121,,,,3121,3121,0,0,0,0.00,0
,20171124,3121,3121,,,,3121,3121,0,0,0,0.00,0
,20171127,3121,3121,,,,3121,3121,0,0,0,0.00,0
,20171128,3121,3121,,,,3121,3121,0,0,0,0.00,0
,20171129,3121,3121,,,,3121,3121,0,0,0,0.00,0
,20171130,3121,3121,,,,3121,3121,0,0,0,0.00,0
,20171201,3121,3121,,,,3121,3121,0,0,0,0.00,0
,20171204,3121,3121,,,,3121,3121,0,0,0,0.00,0
,20171205,3121,3121,,,,3121,3121,0,0,0,0.00,0
,20171206,3121,3121,,,,3121,3121,0,0,0,0.00,0
,20171207,3121,3121,,,,3121,3121,0,0,0,0.00,0
,20171208,3121,3121,,,,3121,3121,0,0,0,0.00,0
,20171211,3121,3121,,,,3121,3121,0,0,0,0.00,0
,20171212,3121,3121,,,,3121,3121,0,0,0,0.00,0
,20171213,3121,3121,,,,3121,3121,0,0,0,0.00,0
,20171214,3121,3121,,,,3121,3121,0,0,0,0.00,0
,20171215,3121,3121,,,,3121,3121,0,0,0,0.00,0
,20171218,3121,3121,,,,3121,3121,0,0,0,0.00,0
,20171219,3121,3121,,,,3121,3121,0,0,0,0.00,0
,20171220,3121,3121,,,,3121,3121,0,0,0,0.00,0
,20171221,3121,3121,,,,3121,3121,0,0,0,0.00,0
,20171222,3121,3121,,,,3121,3121,0,0,0,0.00,0
,20171225,3121,3121,,,,3121,3121,0,0,0,0.00,0
,20171226,3121,3121,,,,3121,3121,0,0,0,0.00,0
,20171227,3121,3121,,,,3121,3121,0,0,0,0.00,0
,20171228,3121,3121,,,,3121,3121,0,0,0,0.00,0
,20171229,3121,3121,,,,3121,3121,0,0,0,0.00,0
wr1810,20171017,3121,3121,,,,3121,3121,0,0,0,0.00,0
,20171018,3121,3121,,,,3121,3121,0,0,0,0.00,0
,20171019,3121,3121,,,,3121,3121,0,0,0,0.00,0
,20171020,3121,3121,,,,3121,3121,0,0,0,0.00,0
,20171023,3121,3121,,,,3121,3121,0,0,0,0.00,0
,20171024,3121,3121,,,,3121,3121,0,0,0,0.00,0
,20171025,3121,3121,,,,3121,3121,0,0,0,0.00,0
,20171026,3121,3121,,,,3121,3121,0,0,0,0.00,0
,20171027,3121,3121,,,,3121,3121,0,0,0,0.00,0
,20171030,3121,3121,,,,3121,3121,0,0,0,0.00,0
,20171031,3121,3121,,,,3121,3121,0,0,0,0.00,0
,20171101,3121,3121,,,,3121,3121,0,0,0,0.00,0
,20171102,3121,3121,,,,3121,3121,0,0,0,0.00,0
,20171103,3121,3121,,,,3121,3121,0,0,0,0.00,0
,20171106,3121,3121,,,,3121,3121,0,0,0,0.00,0
,20171107,3121,3121,,,,3121,3121,0,0,0,0.00,0
,20171108,3121,3121,,,,3121,3121,0,0,0,0.00,0
,20171109,3121,3121,,,,3121,3121,0,0,0,0.00,0
,20171110,3121,3121,,,,3121,3121,0,0,0,0.00,0
,20171113,3121,3121,,,,3121,3121,0,0,0,0.00,0
,20171114,3121,3121,,,,3121,3121,0,0,0,0.00,0
,20171115,3121,3121,,,,3121,3121,0,0,0,0.00,0
,20171116,3121,3121,,,,3121,3121,0,0,0,0.00,0
,20171117,3121,3121,,,,3121,3121,0,0,0,0.00,0
,20171120,3121,3121,,,,3121,3121,0,0,0,0.00,0
,20171121,3121,3121,,,,3121,3121,0,0,0,0.00,0
,20171122,3121,3121,,,,3121,3121,0,0,0,0.00,0
,20171123,3121,3121,,,,3121,3121,0,0,0,0.00,0
,20171124,3121,3121,,,,3121,3121,0,0,0,0.00,0
,20171127,3121,3121,,,,3121,3121,0,0,0,0.00,0
,20171128,3121,3121,,,,3121,3121,0,0,0,0.00,0
,20171129,3121,3121,,,,3121,3121,0,0,0,0.00,0
,20171130,3121,3121,,,,3121,3121,0,0,0,0.00,0
,20171201,3121,3121,,,,3121,3121,0,0,0,0.00,0
,20171204,3121,3121,,,,3121,3121,0,0,0,0.00,0
,20171205,3121,3121,,,,3121,3121,0,0,0,0.00,0
,20171206,3121,3121,,,,3121,3121,0,0,0,0.00,0
,20171207,3121,3121,,,,3121,3121,0,0,0,0.00,0
,20171208,3121,3121,,,,3121,3121,0,0,0,0.00,0
,20171211,3121,3121,,,,3121,3121,0,0,0,0.00,0
,20171212,3121,3121,,,,3121,3121,0,0,0,0.00,0
,20171213,3121,3121,,,,3121,3121,0,0,0,0.00,0
,20171214,3121,3121,,,,3121,3121,0,0,0,0.00,0
,20171215,3121,3121,,,,3121,3121,0,0,0,0.00,0
,20171218,3121,3121,,,,3121,3121,0,0,0,0.00,0
,20171219,3121,3121,,,,3121,3121,0,0,0,0.00,0
,20171220,3121,3121,,,,3121,3121,0,0,0,0.00,0
,20171221,3121,3121,,,,3121,3121,0,0,0,0.00,0
,20171222,3121,3121,,,,3121,3121,0,0,0,0.00,0
,20171225,3121,3121,,,,3121,3121,0,0,0,0.00,0
,20171226,3121,3121,,,,3121,3121,0,0,0,0.00,0
,20171227,3121,3121,,,,3121,3121,0,0,0,0.00,0
,20171228,3121,3121,,,,3121,3121,0,0,0,0.00,0
,20171229,3121,3121,,,,3121,3121,0,0,0,0.00,0
wr1811,20171116,3121,3121,,,,3121,3121,0,0,0,0.00,0
,20171117,3121,3121,,,,3121,3121,0,0,0,0.00,0
,20171120,3121,3121,,,,3121,3121,0,0,0,0.00,0
,20171121,3121,3121,,,,3121,3121,0,0,0,0.00,0
,20171122,3121,3121,,,,3121,3121,0,0,0,0.00,0
,20171123,3121,3121,,,,3121,3121,0,0,0,0.00,0
,20171124,3121,3121,,,,3121,3121,0,0,0,0.00,0
,20171127,3121,3121,,,,3121,3121,0,0,0,0.00,0
,20171128,3121,3121,,,,3121,3121,0,0,0,0.00,0
,20171129,3121,3121,,,,3121,3121,0,0,0,0.00,0
,20171130,3121,3121,,,,3121,3121,0,0,0,0.00,0
,20171201,3121,3121,,,,3121,3121,0,0,0,0.00,0
,20171204,3121,3121,,,,3121,3121,0,0,0,0.00,0
,20171205,3121,3121,,,,3121,3121,0,0,0,0.00,0
,20171206,3121,3121,,,,3121,3121,0,0,0,0.00,0
,20171207,3121,3121,,,,3121,3121,0,0,0,0.00,0
,20171208,3121,3121,,,,3121,3121,0,0,0,0.00,0
,20171211,3121,3121,,,,3121,3121,0,0,0,0.00,0
,20171212,3121,3121,,,,3121,3121,0,0,0,0.00,0
,20171213,3121,3121,,,,3121,3121,0,0,0,0.00,0
,20171214,3121,3121,,,,3121,3121,0,0,0,0.00,0
,20171215,3121,3121,,,,3121,3121,0,0,0,0.00,0
,20171218,3121,3121,,,,3121,3121,0,0,0,0.00,0
,20171219,3121,3121,,,,3121,3121,0,0,0,0.00,0
,20171220,3121,3121,,,,3121,3121,0,0,0,0.00,0
,20171221,3121,3121,,,,3121,3121,0,0,0,0.00,0
,20171222,3121,3121,,,,3121,3121,0,0,0,0.00,0
,20171225,3121,3121,,,,3121,3121,0,0,0,0.00,0
,20171226,3121,3121,,,,3121,3121,0,0,0,0.00,0
,20171227,3121,3121,,,,3121,3121,0,0,0,0.00,0
,20171228,3121,3121,,,,3121,3121,0,0,0,0.00,0
,20171229,3121,3121,,,,3121,3121,0,0,0,0.00,0
wr1812,20171218,3121,3121,,,,3121,3121,0,0,0,0.00,0
,20171219,3121,3121,,,,3121,3121,0,0,0,0.00,0
,20171220,3121,3121,,,,3121,3121,0,0,0,0.00,0
,20171221,3121,3121,,,,3121,3121,0,0,0,0.00,0
,20171222,3121,3121,,,,3121,3121,0,0,0,0.00,0
,20171225,3121,3121,,,,3121,3121,0,0,0,0.00,0
,20171226,3121,3121,,,,3121,3121,0,0,0,0.00,0
,20171227,3121,3121,,,,3121,3121,0,0,0,0.00,0
,20171228,3121,3121,,,,3121,3121,0,0,0,0.00,0
,20171229,3121,3121,,,,3121,3121,0,0,0,0.00,0
zn1701,20170103,20700,20755,21105,21115,20950,21000,21000,245,245,2956,"31,043.01",25570
,20170104,21000,21000,21040,21175,20660,21110,20855,110,-145,5610,"58,506.08",20760
,20170105,21110,20855,21000,21595,21000,21280,21325,425,470,6300,"67,179.68",16340
,20170106,21280,21325,21215,21450,21060,21095,21300,-230,-25,3470,"36,957.63",13010
,20170109,21095,21300,21145,21635,21065,21600,21425,300,125,2230,"23,891.60",12340
,20170110,21600,21425,21680,22550,21635,22510,22000,1085,575,1210,"13,312.90",11880
,20170111,22510,22000,22560,22585,22250,22460,22355,460,355,1420,"15,875.48",10750
,20170112,22460,22355,22285,23395,21295,22300,22290,-55,-65,1810,"20,173.78",8750
,20170113,22300,22290,21525,23435,21525,22200,22485,-90,195,880,"9,894.75",8180
,20170116,22200,22485,22760,23785,22600,22770,22805,285,320,580,"6,614.70",8110
zn1702,20170103,20995,20835,21165,21355,20910,21010,21100,175,265,147160,"1,552,843.91",105568
,20170104,21010,21100,21100,21265,20665,21190,20945,90,-155,192268,"2,013,623.49",95202
,20170105,21190,20945,21100,21685,21030,21310,21385,365,440,144914,"1,549,803.53",88152
,20170106,21310,21385,21345,21535,21135,21190,21335,-195,-50,83472,"890,441.59",80496
,20170109,21190,21335,21225,21730,21045,21725,21430,390,95,71618,"767,488.28",81050
,20170110,21725,21430,21700,22675,21595,22515,22130,1085,700,74066,"819,578.10",72792
,20170111,22515,22130,22615,22760,22290,22450,22500,320,370,56176,"632,112.83",67794
,20170112,22450,22500,22390,22600,22135,22395,22375,-105,-125,60150,"672,980.83",63818
,20170113,22395,22375,22455,22780,22170,22350,22460,-25,85,43680,"490,587.73",60664
,20170116,22350,22460,22395,23100,22320,22730,22770,270,310,45666,"519,973.38",59488
,20170117,22730,22770,22735,22825,21730,22000,22285,-770,-485,44118,"491,632.92",53106
,20170118,22000,22285,22180,22555,21800,22400,22280,115,-5,30196,"336,389.78",49430
,20170119,22400,22280,22400,22515,22130,22270,22360,-10,80,23800,"266,125.08",43656
,20170120,22270,22360,22370,22570,22010,22160,22370,-200,10,29424,"329,177.95",37492
,20170123,22160,22370,22265,23010,22165,22805,22735,435,365,22612,"257,074.02",32764
,20170124,22805,22735,22835,22865,22520,22665,22685,-70,-50,14624,"165,876.91",26132
,20170125,22665,22685,22765,22980,22670,22760,22790,75,105,8676,"98,884.55",23060
,20170126,22760,22790,22695,23555,22520,23555,22765,765,-25,5890,"67,048.00",20220
,20170203,23555,22765,23055,23140,22335,22500,22720,-265,-45,5350,"60,782.83",17930
,20170206,22500,22720,22505,22680,22300,22300,22535,-420,-185,4380,"49,352.65",15500
,20170207,22300,22535,22440,22710,22440,22615,22595,80,60,4060,"45,870.40",13400
,20170208,22615,22595,22790,23020,22670,22865,22840,270,245,4090,"46,708.98",12220
,20170209,22865,22840,22920,23065,22850,22850,22960,10,120,3840,"44,091.30",9620
,20170210,22850,22960,23045,23455,22960,23340,23140,380,180,2500,"28,930.53",8760
,20170213,23340,23140,23640,24110,23600,23900,23960,760,820,2180,"26,118.75",7970
,20170214,23900,23960,23700,23820,23600,23760,23725,-200,-235,2660,"31,560.58",6780
,20170215,23760,23725,23555,23680,22555,23500,23400,-225,-325,990,"11,584.88",6380
zn1703,20170103,21045,20895,21210,21370,20930,21045,21135,150,240,171448,"1,812,095.68",170468
,20170104,21045,21135,21120,21290,20680,21180,20975,45,-160,502512,"5,270,586.63",186160
,20170105,21180,20975,21055,21735,21055,21355,21430,380,455,697788,"7,478,481.80",200310
,20170106,21355,21430,21360,21560,21160,21215,21375,-215,-55,590844,"6,315,487.27",202156
,20170109,21215,21375,21210,21785,21085,21775,21465,400,90,639640,"6,866,249.91",223050
,20170110,21775,21465,21715,22735,21640,22555,22130,1090,665,795712,"8,806,512.88",238524
,20170111,22555,22130,22685,22815,22350,22485,22560,355,430,575184,"6,489,063.35",231702
,20170112,22485,22560,22450,22655,22160,22430,22430,-130,-130,726540,"8,149,526.02",228404
,20170113,22430,22430,22510,22835,22210,22405,22525,-25,95,682378,"7,686,869.55",217394
,20170116,22405,22525,22450,23160,22360,22770,22830,245,305,790566,"9,024,892.98",219320
,20170117,22770,22830,22760,22880,21765,22050,22370,-780,-460,713856,"7,985,566.04",209744
,20170118,22050,22370,22130,22595,22030,22395,22330,25,-40,715374,"7,987,574.12",200286
,20170119,22395,22330,22380,22560,22155,22300,22400,-30,70,592206,"6,632,793.34",194270
,20170120,22300,22400,22450,22595,21990,22145,22355,-255,-45,623114,"6,966,403.87",180750
,20170123,22145,22355,22305,23010,22140,22815,22625,460,270,611472,"6,918,443.06",183464
,20170124,22815,22625,22830,22885,22580,22760,22735,135,110,423496,"4,815,009.07",178086
,20170125,22760,22735,22900,23065,22705,22830,22865,95,130,368750,"4,216,610.11",166066
,20170126,22830,22865,22710,23425,22570,23205,22860,340,-5,377530,"4,315,816.69",159562
,20170203,23205,22860,23275,23275,22385,22645,22790,-215,-70,220802,"2,516,064.35",156378
,20170206,22645,22790,22600,22800,22360,22420,22615,-370,-175,324268,"3,667,300.83",153850
,20170207,22420,22615,22430,22800,22410,22675,22610,60,-5,319360,"3,611,100.01",146858
,20170208,22675,22610,22630,23150,22585,22945,22900,335,290,425762,"4,875,191.18",150824
,20170209,22945,22900,22990,23220,22915,22980,23075,80,175,408402,"4,712,939.76",146640
,20170210,22980,23075,23125,23575,23010,23415,23215,340,140,450886,"5,234,592.98",147820
,20170213,23415,23215,23525,24310,23500,23955,23880,740,665,509608,"6,085,126.01",128938
,20170214,23955,23880,23990,24045,23650,23855,23825,-25,-55,299496,"3,568,451.02",116962
,20170215,23855,23825,23805,23900,23280,23605,23550,-220,-275,285366,"3,360,471.33",107842
,20170216,23605,23550,23555,23775,23170,23310,23510,-240,-40,186192,"2,189,111.60",94630
,20170217,23310,23510,23165,23470,23100,23250,23300,-260,-210,103052,"1,200,592.90",86350
,20170220,23250,23300,23195,23245,22700,22970,22890,-330,-410,93628,"1,071,758.87",76014
,20170221,22970,22890,23200,23590,23200,23400,23395,510,505,57862,"676,932.88",71910
,20170222,23400,23395,23450,23495,23000,23120,23235,-275,-160,38104,"442,730.78",66320
,20170223,23120,23235,23225,23430,22710,22935,23125,-300,-110,40840,"472,308.27",57526
,20170224,22935,23125,23070,23125,22410,22845,22710,-280,-415,40110,"455,498.88",48176
,20170227,22845,22710,22940,23100,22575,22700,22835,-10,125,28524,"325,710.66",41974
,20170228,22700,22835,22785,22950,22650,22830,22815,-5,-20,19774,"225,602.70",33786
,20170301,22830,22815,22830,23200,22775,23175,22925,360,110,9796,"112,290.55",28960
,20170302,23175,22925,23300,23330,23130,23165,23225,240,300,6400,"74,322.05",25700
,20170303,23165,23225,23085,23085,22460,22810,22670,-415,-555,6440,"73,009.28",21920
,20170306,22810,22670,22785,22795,22210,22240,22430,-430,-240,7830,"87,829.98",20060
,20170307,22240,22430,22220,22355,22090,22180,22195,-250,-235,3440,"38,181.45",19660
,20170308,22180,22195,22180,22180,21800,21920,21930,-275,-265,3310,"36,297.33",18140
,20170309,21920,21930,21985,22065,21505,21600,21695,-330,-235,5230,"56,735.95",14930
,20170310,21600,21695,21640,21975,21640,21940,21845,245,150,3620,"39,540.33",13450
,20170313,21940,21845,22150,22570,21890,22570,22365,725,520,2260,"25,274.40",11870
,20170314,22570,22365,22545,22655,22290,22470,22430,105,65,1990,"22,322.60",11060
,20170315,22470,22430,22300,22800,22250,22660,22655,230,225,1460,"16,541.40",10870
zn1704,20170103,21000,20905,21035,21330,20925,21025,21140,120,235,19742,"208,688.64",72028
,20170104,21025,21140,21190,21265,20665,21160,20980,20,-160,22812,"239,334.51",73012
,20170105,21160,20980,21085,21715,21070,21335,21415,355,435,32932,"352,637.76",72646
,20170106,21335,21415,21335,21530,21145,21195,21345,-220,-70,20104,"214,593.06",73080
,20170109,21195,21345,21195,21755,21060,21740,21485,395,140,22640,"243,248.71",75672
,20170110,21740,21485,21685,22710,21625,22550,22220,1065,735,40220,"446,937.57",78314
,20170111,22550,22220,22655,22790,22325,22465,22525,245,305,23314,"262,589.14",79334
,20170112,22465,22525,22460,22625,22150,22420,22390,-105,-135,26936,"301,582.85",79112
,20170113,22420,22390,22485,22810,22200,22375,22500,-15,110,27750,"312,228.24",79682
,20170116,22375,22500,22415,23125,22350,22765,22825,265,325,37054,"422,890.69",80382
,20170117,22765,22825,22765,22860,21795,22050,22275,-775,-550,45274,"504,278.43",83080
,20170118,22050,22275,22105,22585,22050,22405,22330,130,55,58368,"651,687.88",84004
,20170119,22405,22330,22400,22555,22165,22320,22385,-10,55,49288,"551,657.63",86872
,20170120,22320,22385,22465,22620,21990,22120,22335,-265,-50,57436,"641,551.79",91886
,20170123,22120,22335,22305,22990,22145,22795,22655,460,320,54768,"620,503.71",95882
,20170124,22795,22655,22835,22875,22600,22745,22735,90,80,40996,"466,100.00",99796
,20170125,22745,22735,22870,23070,22705,22820,22850,85,115,48552,"554,733.30",105408
,20170126,22820,22850,22690,23385,22565,23170,22885,320,35,56070,"641,665.40",112346
,20170203,23170,22885,23175,23255,22400,22630,22775,-255,-110,68354,"778,470.78",119638
,20170206,22630,22775,22600,22800,22365,22420,22605,-355,-170,98146,"1,109,480.29",128934
,20170207,22420,22605,22435,22805,22425,22680,22635,75,30,95024,"1,075,601.48",129664
,20170208,22680,22635,22635,23150,22600,22970,22905,335,270,145762,"1,669,609.07",130374
,20170209,22970,22905,23020,23240,22970,23020,23100,115,195,133326,"1,540,184.63",135578
,20170210,23020,23100,23160,23650,23065,23500,23285,400,185,207748,"2,418,814.55",148748
,20170213,23500,23285,23615,24390,23570,24000,23970,715,685,311422,"3,732,564.71",162852
,20170214,24000,23970,24030,24105,23710,23890,23880,-80,-90,254332,"3,036,990.56",165228
,20170215,23890,23880,23860,23950,23335,23655,23615,-225,-265,395162,"4,666,482.90",162342
,20170216,23655,23615,23600,23830,23210,23340,23565,-275,-50,477908,"5,631,414.75",163218
,20170217,23340,23565,23200,23520,23130,23280,23340,-285,-225,455468,"5,315,886.67",168878
,20170220,23280,23340,23240,23270,22740,23005,22915,-335,-425,518410,"5,940,638.79",166664
,20170221,23005,22915,23250,23630,23240,23440,23435,525,520,494026,"5,789,289.89",169930
,20170222,23440,23435,23490,23535,23035,23170,23285,-265,-150,409010,"4,761,914.19",174576
,20170223,23170,23285,23280,23490,22790,22985,23205,-300,-80,477822,"5,544,531.26",176694
,20170224,22985,23205,23150,23170,22465,22925,22775,-280,-430,534810,"6,091,066.47",165708
,20170227,22925,22775,22930,23180,22620,22780,22890,5,115,559566,"6,405,590.45",157506
,20170228,22780,22890,22875,23020,22705,22860,22875,-30,-15,467526,"5,347,332.30",150056
,20170301,22860,22875,22900,23310,22865,23290,23040,415,165,508362,"5,856,928.47",155090
,20170302,23290,23040,23380,23435,23195,23270,23315,230,275,376168,"4,385,231.19",149594
,20170303,23270,23315,23225,23230,22530,22880,22820,-435,-495,436512,"4,981,018.05",145186
,20170306,22880,22820,22885,22930,22230,22295,22610,-525,-210,515352,"5,827,271.37",151052
,20170307,22295,22610,22290,22430,22130,22210,22275,-400,-335,384818,"4,286,123.55",144872
,20170308,22210,22275,22160,22225,21795,22010,21995,-265,-280,451768,"4,968,877.94",133950
,20170309,22010,21995,22045,22150,21510,21610,21835,-385,-160,353680,"3,861,786.79",124344
,20170310,21610,21835,21660,22035,21605,21960,21815,125,-20,209604,"2,286,590.86",116894
,20170313,21960,21815,22055,22605,21885,22540,22250,725,435,241202,"2,683,694.02",104108
,20170314,22540,22250,22505,22735,22335,22530,22495,280,245,115492,"1,299,004.96",100882
,20170315,22530,22495,22290,22850,22105,22740,22535,245,40,122654,"1,382,221.30",89960
,20170316,22740,22535,22755,23360,22755,23360,23120,825,585,93766,"1,084,016.39",84132
,20170317,23360,23120,23395,23520,23155,23365,23285,245,165,54908,"639,290.91",81814
,20170320,23365,23285,23505,23915,23400,23765,23675,480,390,48846,"578,245.58",74698
,20170321,23765,23675,23790,23830,23370,23450,23555,-225,-120,35218,"414,798.00",69794
,20170322,23450,23555,23555,23680,23030,23275,23290,-280,-265,37834,"440,595.37",65970
,20170323,23275,23290,23300,23590,23060,23435,23365,145,75,29938,"349,771.30",61928
,20170324,23435,23365,23360,23425,22955,23330,23150,-35,-215,29744,"344,349.75",57356
,20170327,23330,23150,23330,23420,22665,22720,22980,-430,-170,37508,"431,045.34",52808
,20170328,22720,22980,22730,22845,22380,22605,22635,-375,-345,33326,"377,174.73",45608
,20170329,22605,22635,22705,23425,22565,23380,23060,745,425,27388,"315,798.17",40306
,20170330,23380,23060,23380,23650,23280,23455,23435,395,375,21114,"247,426.70",37648
,20170331,23455,23435,23455,23795,23135,23600,23430,165,-5,12650,"148,211.86",35844
,20170405,23600,23430,22945,23225,22945,23110,23120,-320,-310,15184,"175,546.26",27210
,20170406,23110,23120,23220,23290,22890,23110,23020,-10,-100,9840,"113,259.73",24870
,20170407,23110,23020,23120,23135,22060,22115,22620,-905,-400,11220,"126,902.83",19970
,20170410,22115,22620,21915,22270,21885,22065,22070,-555,-550,5940,"65,549.33",17990
,20170411,22065,22070,22160,22195,21380,21380,21625,-690,-445,9360,"101,223.43",14570
,20170412,21380,21625,21600,21600,21175,21430,21460,-195,-165,6120,"65,673.20",12840
,20170413,21430,21460,21550,21870,21550,21780,21735,320,275,1990,"21,626.73",12000
,20170414,21780,21735,21845,21845,21480,21570,21690,-165,-45,1770,"19,197.80",12490
,20170417,21570,21690,21730,22040,21730,22000,21940,310,250,2560,"28,086.60",12160
zn1705,20170103,20995,20895,21035,21295,20905,21005,21085,110,190,5622,"59,283.22",22130
,20170104,21005,21085,21035,21260,20660,21180,20990,95,-95,12154,"127,583.46",23342
,20170105,21180,20990,21100,21690,21060,21305,21400,315,410,14882,"159,263.54",23772
,20170106,21305,21400,21305,21520,21130,21180,21320,-220,-80,11398,"121,529.13",24880
,20170109,21180,21320,21180,21730,21050,21730,21455,410,135,13016,"139,633.45",27372
,20170110,21730,21455,21725,22675,21600,22490,22230,1035,775,24802,"275,703.81",28030
,20170111,22490,22230,22600,22760,22290,22450,22530,220,300,16914,"190,547.34",31294
,20170112,22450,22530,22410,22620,22135,22395,22370,-135,-160,14140,"158,174.26",32028
,20170113,22395,22370,22450,22770,22190,22375,22485,5,115,17216,"193,557.10",32994
,20170116,22375,22485,22460,23115,22345,22755,22805,270,320,22064,"251,609.58",33346
,20170117,22755,22805,22755,22850,21785,22070,22290,-735,-515,19372,"215,942.47",33570
,20170118,22070,22290,22105,22565,22020,22400,22305,110,15,24968,"278,461.27",37160
,20170119,22400,22305,22330,22525,22160,22290,22365,-15,60,21406,"239,418.87",41638
,20170120,22290,22365,22510,22595,21985,22125,22295,-240,-70,27036,"301,446.75",46060
,20170123,22125,22295,22230,22970,22150,22780,22615,485,320,26126,"295,428.77",49900
,20170124,22780,22615,22775,22840,22570,22720,22705,105,90,17224,"195,546.60",51050
,20170125,22720,22705,22815,23040,22685,22800,22825,95,120,24084,"274,913.59",57186
,20170126,22800,22825,22630,23345,22550,23120,22865,295,40,17682,"202,180.89",59642
,20170203,23120,22865,23295,23295,22355,22585,22730,-280,-135,18656,"212,028.60",59808
,20170206,22585,22730,22570,22780,22350,22410,22590,-320,-140,25104,"283,562.79",63368
,20170207,22410,22590,22415,22770,22410,22650,22610,60,20,24004,"271,406.72",66406
,20170208,22650,22610,22645,23125,22570,22930,22880,320,270,37820,"432,728.48",69866
,20170209,22930,22880,22975,23210,22970,23030,23085,150,205,37602,"434,057.47",72636
,20170210,23030,23085,23145,23650,23085,23525,23300,440,215,57482,"669,696.36",80416
,20170213,23525,23300,23665,24385,23585,24010,23980,710,680,78918,"946,407.02",88508
,20170214,24010,23980,24000,24110,23710,23930,23895,-50,-85,49392,"590,172.38",90444
,20170215,23930,23895,23930,23975,23370,23680,23635,-215,-260,59852,"707,392.88",91560
,20170216,23680,23635,23645,23835,23235,23355,23585,-280,-50,72122,"850,531.04",96428
,20170217,23355,23585,23250,23540,23155,23310,23355,-275,-230,66392,"775,415.74",103250
,20170220,23310,23355,23275,23285,22765,23035,22945,-320,-410,75224,"863,080.35",106760
,20170221,23035,22945,23285,23640,23260,23450,23440,505,495,68766,"806,029.84",110294
,20170222,23450,23440,23490,23550,23055,23190,23290,-250,-150,82732,"963,522.71",122194
,20170223,23190,23290,23280,23500,22820,23035,23180,-255,-110,103564,"1,200,544.23",127842
,20170224,23035,23180,23160,23200,22505,22935,22815,-245,-365,130216,"1,485,582.52",136648
,20170227,22935,22815,22935,23200,22650,22835,22925,20,110,125602,"1,439,997.12",142090
,20170228,22835,22925,22925,23050,22760,22890,22915,-35,-10,119918,"1,374,106.80",144974
,20170301,22890,22915,22960,23350,22915,23310,23100,395,185,154788,"1,788,142.26",143838
,20170302,23310,23100,23410,23470,23240,23310,23350,210,250,122630,"1,431,936.25",147828
,20170303,23310,23350,23290,23290,22555,22900,22835,-450,-515,204010,"2,329,443.93",163154
,20170306,22900,22835,22940,22960,22255,22295,22640,-540,-195,272564,"3,085,902.79",191388
,20170307,22295,22640,22300,22460,22155,22240,22285,-400,-355,255226,"2,844,160.68",206398
,20170308,22240,22285,22180,22240,21790,22000,22000,-285,-285,391312,"4,304,648.39",230296
,20170309,22000,22000,22060,22155,21515,21610,21820,-390,-180,397368,"4,336,182.97",246670
,20170310,21610,21820,21620,22035,21610,21950,21830,130,10,431888,"4,714,815.51",259206
,20170313,21950,21830,22075,22620,21890,22550,22255,720,425,824386,"9,174,895.39",269206
,20170314,22550,22255,22535,22750,22350,22555,22515,300,260,522258,"5,879,526.17",271440
,20170315,22555,22515,22305,22870,22105,22770,22545,255,30,696276,"7,849,328.07",260918
,20170316,22770,22545,22810,23365,22810,23360,23130,815,585,740988,"8,569,633.70",256924
,20170317,23360,23130,23400,23535,23160,23365,23290,235,160,545788,"6,356,537.15",267544
,20170320,23365,23290,23520,23930,23415,23780,23690,490,400,625342,"7,407,426.53",272870
,20170321,23780,23690,23790,23840,23370,23445,23590,-245,-100,607836,"7,169,621.47",271178
,20170322,23445,23590,23565,23690,23025,23255,23325,-335,-265,735780,"8,582,692.72",265476
,20170323,23255,23325,23305,23590,23050,23415,23365,90,40,694958,"8,119,666.88",263520
,20170324,23415,23365,23325,23425,22900,23305,23140,-60,-225,669786,"7,750,379.53",262220
,20170327,23305,23140,23255,23410,22640,22665,23055,-475,-85,866172,"9,984,800.37",262016
,20170328,22665,23055,22720,22830,22365,22570,22580,-485,-475,740480,"8,360,761.78",247880
,20170329,22570,22580,22715,23410,22540,23380,22990,800,410,831640,"9,559,863.36",250268
,20170330,23380,22990,23330,23630,23260,23425,23430,435,440,708126,"8,296,574.41",234270
,20170331,23425,23430,23430,23780,23105,23380,23450,-50,20,795526,"9,328,334.18",212720
,20170405,23380,23450,22825,23245,22800,23115,23085,-335,-365,325784,"3,760,621.23",194256
,20170406,23115,23085,23200,23310,22875,23090,23070,5,-15,505778,"5,835,166.38",186814
,20170407,23090,23070,23140,23160,22050,22195,22610,-875,-460,783144,"8,854,295.03",182224
,20170410,22195,22610,22025,22415,21865,22070,22125,-540,-485,596226,"6,597,147.40",171296
,20170411,22070,22125,22125,22225,21335,21395,21700,-730,-425,519570,"5,638,248.44",156730
,20170412,21395,21700,21500,21625,21130,21360,21390,-340,-310,335056,"3,584,049.55",135418
,20170413,21360,21390,21270,21880,21225,21790,21565,400,175,166402,"1,794,482.70",123642
,20170414,21790,21565,21575,21800,21390,21480,21620,-85,55,113806,"1,230,376.17",118748
,20170417,21480,21620,21485,22365,21455,21945,21915,325,295,107176,"1,174,416.37",112180
,20170418,21945,21915,21995,22080,21415,21485,21670,-430,-245,79922,"865,958.31",100960
,20170419,21485,21670,21485,21505,20200,21195,21085,-475,-585,97030,"1,022,973.78",86542
,20170420,21195,21085,21320,21800,20500,21770,21330,685,245,77048,"821,902.79",73056
,20170421,21770,21330,21780,22095,21695,21975,21915,645,585,51236,"561,448.89",65132
,20170424,21975,21915,21850,21850,21425,21635,21610,-280,-305,46440,"501,860.16",56830
,20170425,21635,21610,21680,21795,21500,21710,21645,100,35,36794,"398,269.54",51298
,20170426,21710,21645,21700,21945,21490,21800,21775,155,130,38742,"421,898.77",43898
,20170427,21800,21775,21810,22040,21775,21895,21870,120,95,24256,"265,273.04",42034
,20170428,21895,21870,21895,22145,21590,22090,21865,220,-5,29688,"324,583.02",37150
,20170502,22090,21865,22100,22700,22100,22385,22480,520,615,8830,"99,268.23",33420
,20170503,22385,22480,22350,22410,22020,22060,22135,-420,-345,6770,"74,938.40",30710
,20170504,22060,22135,21910,21920,21390,21560,21715,-575,-420,8990,"97,620.48",25960
,20170505,21560,21715,21580,21820,21580,21580,21695,-135,-20,7190,"78,000.63",22740
,20170508,21580,21695,21630,21905,21475,21770,21660,75,-35,10080,"109,179.15",19140
,20170509,21770,21660,21740,22100,21700,22070,21955,410,295,9190,"100,902.60",15270
,20170510,22070,21955,22120,22250,22050,22170,22135,215,180,4020,"44,492.85",12990
,20170511,22170,22135,22200,22405,22015,22380,22230,245,95,3990,"44,358.23",10760
,20170512,22380,22230,22330,22335,22025,22150,22120,-80,-110,3080,"34,071.10",8480
,20170515,22150,22120,22070,22400,22070,22150,22205,30,85,2320,"25,762.63",7970
zn1706,20170103,20900,20870,21080,21260,20860,20985,21055,115,185,202,"2,127.02",1968
,20170104,20985,21055,21060,21210,20680,21150,21070,95,15,356,"3,750.75",2086
,20170105,21150,21070,21150,21680,21080,21280,21415,210,345,1070,"11,458.06",2770
,20170106,21280,21415,21280,21450,21100,21145,21310,-270,-105,684,"7,289.67",3066
,20170109,21145,21310,21145,21685,21035,21680,21520,370,210,416,"4,476.69",3140
,20170110,21680,21520,21680,22665,21605,22600,22255,1080,735,2258,"25,126.01",3862
,20170111,22600,22255,22600,22765,22320,22445,22605,190,350,1122,"12,682.49",4272
,20170112,22445,22605,22445,22565,22260,22370,22435,-235,-170,384,"4,308.19",4388
,20170113,22370,22435,22385,22735,22190,22285,22500,-150,65,746,"8,393.27",4606
,20170116,22285,22500,22385,23120,22350,22780,22845,280,345,1782,"20,355.26",5070
,20170117,22780,22845,22780,22860,21800,21950,22195,-895,-650,1500,"16,647.15",5568
,20170118,21950,22195,22005,22560,22005,22400,22330,205,135,1496,"16,704.01",5944
,20170119,22400,22330,22400,22495,22185,22245,22405,-85,75,514,"5,758.87",6098
,20170120,22245,22405,22350,22565,22000,22080,22310,-325,-95,528,"5,891.12",6198
,20170123,22080,22310,22185,22960,22100,22755,22670,445,360,584,"6,620.56",6284
,20170124,22755,22670,22755,22800,22580,22670,22725,0,55,990,"11,250.73",6736
,20170125,22670,22725,22720,23000,22700,22760,22770,35,45,1438,"16,373.65",7138
,20170126,22760,22770,22760,23265,22525,23145,22790,375,20,2374,"27,056.94",8188
,20170203,23145,22790,23290,23290,22315,22530,22655,-260,-135,2014,"22,815.89",8356
,20170206,22530,22655,22530,22715,22335,22365,22565,-290,-90,5276,"59,529.19",10920
,20170207,22365,22565,22365,22730,22365,22635,22575,70,10,2160,"24,384.84",11430
,20170208,22635,22575,22605,23100,22550,22920,22875,345,300,6760,"77,322.66",14516
,20170209,22920,22875,22935,23190,22935,23025,23060,150,185,8102,"93,428.22",16900
,20170210,23025,23060,23135,23625,23070,23500,23245,440,185,11062,"128,588.14",19842
,20170213,23500,23245,23565,24350,23565,23995,23985,750,740,15476,"185,623.38",24906
,20170214,23995,23985,23975,24100,23730,23950,23915,-35,-70,6436,"76,964.75",24482
,20170215,23950,23915,23950,23985,23360,23695,23660,-220,-255,4524,"53,528.84",24732
,20170216,23695,23660,23655,23815,23235,23365,23580,-295,-80,4496,"53,011.19",25126
,20170217,23365,23580,23205,23515,23140,23310,23325,-270,-255,7292,"85,043.99",25350
,20170220,23310,23325,23290,23290,22760,23030,22940,-295,-385,9282,"106,471.36",25000
,20170221,23030,22940,23110,23620,23110,23435,23455,495,515,7160,"83,982.90",25816
,20170222,23435,23455,23535,23535,23050,23185,23265,-270,-190,8922,"103,802.82",27568
,20170223,23185,23265,23240,23500,22845,23050,23180,-215,-85,13328,"154,497.35",29090
,20170224,23050,23180,23150,23205,22515,22930,22850,-250,-330,19508,"222,900.70",34656
,20170227,22930,22850,23010,23200,22655,22835,22925,-15,75,20050,"229,843.01",39710
,20170228,22835,22925,22885,23050,22770,22910,22935,-15,10,17850,"204,699.30",42458
,20170301,22910,22935,22945,23370,22930,23345,23120,410,185,16718,"193,268.68",43540
,20170302,23345,23120,23410,23480,23265,23325,23360,205,240,22110,"258,265.93",47324
,20170303,23325,23360,23295,23295,22580,22910,22850,-450,-510,26530,"303,128.86",49706
,20170306,22910,22850,22820,22975,22280,22330,22670,-520,-180,33684,"381,846.73",52582
,20170307,22330,22670,22330,22475,22185,22270,22300,-400,-370,30044,"335,030.90",58630
,20170308,22270,22300,22215,22265,21825,22025,22005,-275,-295,47506,"522,750.79",60364
,20170309,22025,22005,22030,22175,21550,21640,21805,-365,-200,36146,"394,087.08",63160
,20170310,21640,21805,21660,22045,21630,21975,21845,170,40,33056,"361,108.48",65718
,20170313,21975,21845,22045,22635,21900,22570,22305,725,460,58054,"647,521.73",69352
,20170314,22570,22305,22570,22770,22375,22565,22520,260,215,40634,"457,597.59",72986
,20170315,22565,22520,22395,22875,22125,22775,22565,255,45,57642,"650,468.71",71152
,20170316,22775,22565,22810,23365,22810,23360,23150,795,585,73386,"849,526.81",75158
,20170317,23360,23150,23390,23535,23170,23355,23305,205,155,61454,"716,118.34",83080
,20170320,23355,23305,23505,23920,23400,23800,23690,495,385,95180,"1,127,549.32",94924
,20170321,23800,23690,23830,23830,23360,23445,23555,-245,-135,91528,"1,077,972.77",102092
,20170322,23445,23555,23590,23690,23015,23255,23305,-300,-250,126210,"1,470,663.24",113996
,20170323,23255,23305,23295,23570,23040,23395,23360,90,55,126950,"1,482,778.70",121178
,20170324,23395,23360,23290,23440,22930,23295,23140,-65,-220,122880,"1,421,789.15",122276
,20170327,23295,23140,23265,23410,22620,22650,22985,-490,-155,197822,"2,273,599.96",143988
,20170328,22650,22985,22700,22810,22340,22540,22570,-445,-415,176844,"1,995,737.77",158958
,20170329,22540,22570,22670,23400,22520,23385,22990,815,420,207918,"2,390,485.31",169554
,20170330,23385,22990,23330,23640,23265,23405,23420,415,430,194368,"2,276,501.17",182792
,20170331,23405,23420,23425,23765,23080,23360,23415,-60,-5,211238,"2,473,152.23",185126
,20170405,23360,23415,22770,23230,22770,23090,23060,-325,-355,175704,"2,026,180.81",189082
,20170406,23090,23060,23190,23300,22870,23075,23060,15,0,229522,"2,646,858.60",192592
,20170407,23075,23060,23150,23155,22030,22150,22570,-910,-490,545738,"6,159,966.17",227190
,20170410,22150,22570,22000,22395,21825,22035,22095,-535,-475,558316,"6,169,199.35",257472
,20170411,22035,22095,22105,22190,21270,21325,21630,-770,-465,763308,"8,256,797.59",297700
,20170412,21325,21630,21420,21555,21050,21275,21310,-355,-320,830586,"8,851,064.11",319512
,20170413,21275,21310,21200,21820,21140,21725,21505,415,195,782258,"8,411,443.34",326142
,20170414,21725,21505,21525,21750,21320,21425,21565,-80,60,697170,"7,518,059.32",338716
,20170417,21425,21565,21430,22405,21395,21860,21845,295,280,778450,"8,503,243.72",333734
,20170418,21860,21845,21940,21980,21330,21400,21605,-445,-240,697478,"7,534,622.81",361712
,20170419,21400,21605,21395,21430,20700,21025,20960,-580,-645,1065772,"11,171,328.68",378572
,20170420,21025,20960,21070,21690,20875,21660,21190,700,230,1148246,"12,167,585.83",376906
,20170421,21660,21190,21695,21980,21595,21860,21790,670,600,891020,"9,707,940.29",363872
,20170424,21860,21790,21700,21730,21315,21525,21515,-265,-275,850964,"9,155,993.38",352552
,20170425,21525,21515,21565,21660,21350,21555,21485,40,-30,687766,"7,388,945.20",332358
,20170426,21555,21485,21600,21830,21335,21645,21595,160,110,687374,"7,422,855.91",309888
,20170427,21645,21595,21715,21875,21630,21750,21725,155,130,553098,"6,009,306.28",301174
,20170428,21750,21725,21760,21970,21420,21900,21700,175,-25,792984,"8,604,564.68",270888
,20170502,21900,21700,22010,22570,22010,22230,22305,530,605,315994,"3,524,195.80",254010
,20170503,22230,22305,22265,22265,21810,21895,22025,-410,-280,412066,"4,538,520.82",248210
,20170504,21895,22025,21745,21770,21135,21380,21530,-645,-495,646716,"6,962,060.42",240982
,20170505,21380,21530,21315,21630,21275,21305,21465,-225,-65,558466,"5,994,641.10",239066
,20170508,21305,21465,21390,21665,21200,21470,21430,5,-35,709802,"7,606,346.05",229108
,20170509,21470,21430,21505,21910,21400,21865,21665,435,235,503238,"5,451,543.86",227624
,20170510,21865,21665,21915,22080,21770,21915,21915,250,250,430950,"4,722,548.70",215702
,20170511,21915,21915,21945,22195,21715,22175,21910,260,-5,464448,"5,088,654.50",209742
,20170512,22175,21910,22140,22185,21750,21895,21905,-15,-5,384678,"4,214,009.79",198408
,20170515,21895,21905,21910,21970,21625,21885,21785,-20,-120,236002,"2,571,010.53",168878
,20170516,21885,21785,21885,22100,21530,21675,21710,-110,-75,177746,"1,929,690.27",151344
,20170517,21675,21710,21665,22020,21615,21900,21830,190,120,116064,"1,266,911.03",141806
,20170518,21900,21830,21885,21975,21685,21700,21795,-130,-35,105164,"1,146,191.78",135296
,20170519,21700,21795,21260,21960,21190,21800,21635,5,-160,134918,"1,459,508.69",119526
,20170522,21800,21635,22200,22850,22095,22585,22490,950,855,111446,"1,253,298.18",119666
,20170523,22585,22490,22650,22920,22575,22835,22755,345,265,69484,"790,615.55",114144
,20170524,22835,22755,22870,22965,22700,22900,22820,145,65,75086,"856,911.77",100492
,20170525,22900,22820,22945,23060,22660,22715,22935,-105,115,71396,"818,844.38",78244
,20170526,22715,22935,22715,22885,22610,22870,22770,-65,-165,34528,"393,142.83",72908
,20170531,22870,22770,22750,23000,22605,22615,22815,-155,45,27134,"309,577.13",63316
,20170601,22615,22815,22630,22720,22400,22535,22520,-280,-295,20156,"226,974.49",51560
,20170602,22535,22520,22535,22605,22410,22510,22490,-10,-30,13850,"155,762.83",45590
,20170605,22510,22490,22405,22525,22100,22100,22300,-390,-190,17960,"200,282.95",37530
,20170606,22100,22300,21660,22145,21660,21890,21985,-410,-315,9660,"106,187.95",33070
,20170607,21890,21985,21915,21990,21740,21880,21870,-105,-115,12560,"137,356.25",29420
,20170608,21880,21870,21885,22645,21885,22600,22150,730,280,11540,"127,825.78",26730
,20170609,22600,22150,22600,22960,22540,22920,22740,770,590,8610,"97,908.38",25650
,20170612,22920,22740,23400,23700,23275,23500,23580,760,840,11400,"134,414.75",19700
,20170613,23500,23580,23380,23380,22355,22435,22670,-1145,-910,5960,"67,569.68",15680
,20170614,22435,22670,22400,22760,22200,22200,22445,-470,-225,4570,"51,289.13",11820
,20170615,22200,22445,22205,22700,22125,22255,22250,-190,-195,1990,"22,140.70",10920
zn1707,20170103,21000,20865,21190,21240,20965,20965,21140,100,275,12,126.86,570
,20170104,20965,21140,21095,21095,20740,20740,20855,-400,-285,6,62.58,564
,20170105,20740,20855,21500,21515,21495,21515,21500,660,645,6,64.51,564
,20170106,21515,21500,21330,21380,21330,21380,21355,-120,-145,4,42.71,568
,20170109,21380,21355,21335,21665,21335,21665,21515,310,160,12,129.11,574
,20170110,21665,21515,21795,22650,21795,22650,22170,1135,655,202,"2,239.17",646
,20170111,22650,22170,22735,22735,22570,22570,22650,400,480,4,45.31,646
,20170112,22570,22650,22375,22400,22345,22345,22370,-305,-280,10,111.85,648
,20170113,22345,22370,22560,22560,22180,22180,22310,-190,-60,18,200.82,652
,20170116,22180,22310,22425,23115,22425,22865,22755,555,445,66,751.06,660
,20170117,22865,22755,22545,22600,21905,22005,22240,-750,-515,122,"1,356.89",702
,20170118,22005,22240,22090,22560,22060,22415,22425,175,185,134,"1,502.60",642
,20170119,22415,22425,22445,22445,22345,22425,22375,0,-50,18,201.39,644
,20170120,22425,22375,22425,22440,22000,22135,22170,-240,-205,80,886.97,678
,20170123,22135,22170,22220,22895,22120,22820,22565,650,395,412,"4,649.32",890
,20170124,22820,22565,22780,22780,22570,22650,22640,85,75,68,769.91,844
,20170125,22650,22640,22895,22965,22680,22730,22725,90,85,268,"3,045.33",936
,20170126,22730,22725,22730,23105,22505,23105,22775,380,50,154,"1,753.86",934
,20170203,23105,22775,23060,23060,22410,22535,22580,-240,-195,192,"2,167.70",982
,20170206,22535,22580,22605,22680,22350,22350,22520,-230,-60,122,"1,373.88",1002
,20170207,22350,22520,22410,22835,22380,22630,22655,110,135,412,"4,667.79",1270
,20170208,22630,22655,22620,23050,22620,22855,22825,200,170,220,"2,511.01",1358
,20170209,22855,22825,23005,23160,22960,22965,23050,140,225,314,"3,618.88",1446
,20170210,22965,23050,23105,23600,23075,23510,23270,460,220,354,"4,119.55",1588
,20170213,23510,23270,23600,24310,23550,23965,23960,695,690,1206,"14,448.67",2190
,20170214,23965,23960,23970,24000,23785,23925,23870,-35,-90,204,"2,435.00",2260
,20170215,23925,23870,23900,23950,23465,23685,23680,-185,-190,580,"6,868.38",2430
,20170216,23685,23680,23555,23750,23215,23320,23590,-360,-90,354,"4,176.10",2530
,20170217,23320,23590,23205,23490,23205,23215,23375,-375,-215,130,"1,519.67",2516
,20170220,23215,23375,23200,23200,22760,22950,22915,-425,-460,564,"6,462.53",2574
,20170221,22950,22915,23285,23605,23255,23410,23420,495,505,492,"5,761.97",2658
,20170222,23410,23420,23455,23505,23050,23205,23295,-215,-125,384,"4,473.24",2706
,20170223,23205,23295,23265,23455,22850,22900,23220,-395,-75,274,"3,181.30",2762
,20170224,22900,23220,23180,23180,22555,22990,22815,-230,-405,500,"5,704.26",2770
,20170227,22990,22815,22845,23150,22700,22795,22915,-20,100,224,"2,566.53",2790
,20170228,22795,22915,22835,23030,22800,22880,22930,-35,15,406,"4,655.79",2890
,20170301,22880,22930,23000,23365,22965,23340,23090,410,160,548,"6,327.06",3054
,20170302,23340,23090,23420,23460,23145,23295,23340,205,250,664,"7,750.01",3116
,20170303,23295,23340,23185,23185,22595,22950,22805,-390,-535,902,"10,286.36",3070
,20170306,22950,22805,22920,22965,22300,22330,22505,-475,-300,1614,"18,162.48",3798
,20170307,22330,22505,22320,22460,22210,22290,22355,-215,-150,240,"2,682.84",3834
,20170308,22290,22355,22290,22290,21020,22025,22030,-330,-325,782,"8,614.98",3884
,20170309,22025,22030,22070,22175,21595,21680,21935,-350,-95,1012,"11,101.46",4286
,20170310,21680,21935,21680,22040,21660,21985,21835,50,-100,1544,"16,857.58",4826
,20170313,21985,21835,22010,22635,21915,22630,22300,795,465,4172,"46,520.58",6094
,20170314,22630,22300,22630,22750,22390,22520,22530,220,230,2602,"29,316.02",7054
,20170315,22520,22530,22385,22870,22115,22765,22545,235,15,6166,"69,520.53",9120
,20170316,22765,22545,22775,23370,22775,23370,23160,825,615,8582,"99,387.71",11740
,20170317,23370,23160,23410,23525,23165,23355,23315,195,155,4684,"54,603.87",13634
,20170320,23355,23315,23480,23900,23405,23800,23680,485,365,8244,"97,612.17",16706
,20170321,23800,23680,23795,23800,23345,23420,23525,-260,-155,8072,"94,964.36",19052
,20170322,23420,23525,23505,23665,23000,23225,23290,-300,-235,10514,"122,460.51",19910
,20170323,23225,23290,23250,23550,23015,23370,23345,80,55,8642,"100,894.92",21146
,20170324,23370,23345,23330,23400,22920,23280,23120,-65,-225,7992,"92,399.70",21824
,20170327,23280,23120,23180,23365,22595,22645,22935,-475,-185,15292,"175,363.52",24280
,20170328,22645,22935,22620,22780,22315,22515,22565,-420,-370,21600,"243,736.22",30176
,20170329,22515,22565,22605,23375,22495,23345,22950,780,385,19646,"225,480.35",32242
,20170330,23345,22950,23315,23610,23240,23405,23395,455,445,13984,"163,590.06",33450
,20170331,23405,23395,23405,23740,23075,23350,23390,-45,-5,25374,"296,798.52",36692
,20170405,23350,23390,22955,23225,22770,23080,23055,-310,-335,27376,"315,632.90",41334
,20170406,23080,23055,23135,23290,22860,23070,23050,15,-5,30918,"356,333.40",42794
,20170407,23070,23050,23145,23145,22030,22170,22610,-880,-440,77408,"875,180.42",47818
,20170410,22170,22610,22000,22390,21850,22030,22080,-580,-530,59402,"655,847.54",51670
,20170411,22030,22080,22085,22180,21245,21290,21610,-790,-470,71594,"773,703.76",60720
,20170412,21290,21610,21385,21530,21025,21225,21275,-385,-335,73172,"778,524.37",67756
,20170413,21225,21275,21270,21900,21055,21705,21465,430,190,56978,"611,583.49",71654
,20170414,21705,21465,21465,21720,21295,21390,21540,-75,75,67112,"722,833.96",74748
,20170417,21390,21540,21350,22275,21350,21825,21815,285,275,66926,"730,000.43",75212
,20170418,21825,21815,21850,21940,21290,21340,21525,-475,-290,73780,"794,169.27",90038
,20170419,21340,21525,21330,21375,20640,20885,20900,-640,-625,145048,"1,516,052.14",112898
,20170420,20885,20900,20960,21615,20775,21560,21090,660,190,163174,"1,720,874.86",118828
,20170421,21560,21090,21575,21880,21520,21780,21710,690,620,132498,"1,438,414.68",122796
,20170424,21780,21710,21600,21645,21225,21405,21415,-305,-295,150418,"1,610,689.41",142464
,20170425,21405,21415,21440,21540,21230,21440,21375,25,-40,152040,"1,625,156.89",168940
,20170426,21440,21375,21475,21705,21220,21525,21490,150,115,146678,"1,576,262.01",185788
,20170427,21525,21490,21585,21750,21505,21630,21600,140,110,101152,"1,092,683.58",191300
,20170428,21630,21600,21625,21800,21280,21765,21560,165,-40,210542,"2,270,005.56",211942
,20170502,21765,21560,21920,22410,21865,22080,22150,520,590,124608,"1,380,226.39",216202
,20170503,22080,22150,22090,22105,21665,21735,21855,-415,-295,136472,"1,491,618.73",224520
,20170504,21735,21855,21600,21615,21020,21250,21380,-605,-475,235062,"2,513,322.70",230972
,20170505,21250,21380,21190,21475,21120,21130,21310,-250,-70,223212,"2,378,782.20",242156
,20170508,21130,21310,21220,21490,20970,21230,21220,-80,-90,381874,"4,052,073.78",260160
,20170509,21230,21220,21265,21700,21160,21655,21455,435,235,307058,"3,294,237.88",261220
,20170510,21655,21455,21715,21875,21555,21690,21700,235,245,278614,"3,023,325.31",269628
,20170511,21690,21700,21745,21965,21490,21945,21695,245,-5,381458,"4,138,209.69",276704
,20170512,21945,21695,21915,21940,21455,21610,21615,-85,-80,447850,"4,840,734.00",295458
,20170515,21610,21615,21625,21695,21300,21600,21495,-15,-120,578592,"6,219,761.17",304844
,20170516,21600,21495,21615,21840,21160,21310,21375,-185,-120,682230,"7,291,582.85",344740
,20170517,21310,21375,21310,21680,21230,21520,21460,145,85,598252,"6,420,616.28",322488
,20170518,21520,21460,21505,21630,21300,21330,21445,-130,-15,561708,"6,024,016.21",332182
,20170519,21330,21445,20890,21620,20790,21430,21300,-15,-145,925058,"9,852,484.22",304372
,20170522,21430,21300,21855,22525,21740,22195,22150,895,850,989506,"10,959,562.64",303196
,20170523,22195,22150,22290,22510,22170,22370,22325,220,175,593556,"6,626,844.14",306930
,20170524,22370,22325,22415,22575,22150,22385,22355,60,30,631654,"7,060,460.72",308118
,20170525,22385,22355,22405,22515,22165,22245,22380,-110,25,635204,"7,108,767.38",294924
,20170526,22245,22380,22210,22360,22085,22315,22240,-65,-140,575498,"6,400,503.08",273608
,20170531,22315,22240,22240,22520,21870,21875,22200,-365,-40,485084,"5,384,447.57",253020
,20170601,21875,22200,21925,22050,21655,21805,21835,-395,-365,592116,"6,464,519.77",228830
,20170602,21805,21835,21780,21880,21645,21770,21765,-65,-70,437192,"4,758,701.31",228406
,20170605,21770,21765,21600,21860,21410,21430,21630,-335,-135,558178,"6,037,175.73",221688
,20170606,21430,21630,21300,21460,21150,21160,21300,-470,-330,464570,"4,947,834.39",211916
,20170607,21160,21300,21200,21355,20985,21115,21160,-185,-140,530424,"5,613,161.31",205416
,20170608,21115,21160,21145,21720,21080,21645,21290,485,130,518224,"5,517,291.93",187622
,20170609,21645,21290,21615,21835,21525,21815,21660,525,370,420390,"4,552,857.62",180066
,20170612,21815,21660,22020,22325,21960,22145,22200,485,540,304018,"3,374,819.52",176372
,20170613,22145,22200,22120,22160,21235,21355,21635,-845,-565,273158,"2,954,953.38",157546
,20170614,21355,21635,21320,21700,21300,21540,21490,-95,-145,170558,"1,832,861.90",151728
,20170615,21540,21490,21545,21675,21440,21620,21550,130,60,133446,"1,438,131.16",147388
,20170616,21620,21550,21565,21755,21420,21615,21605,65,55,115170,"1,244,194.88",135966
,20170619,21615,21605,21615,21810,21480,21790,21640,185,35,89006,"963,189.89",131206
,20170620,21790,21640,21915,22095,21875,22085,21970,445,330,71692,"787,688.31",131306
,20170621,22085,21970,22045,22090,21860,21985,21990,15,20,62370,"685,897.83",124762
,20170622,21985,21990,22200,22520,22185,22420,22370,430,380,76654,"857,560.43",112756
,20170623,22420,22370,22705,22850,22380,22510,22490,140,120,58138,"653,873.44",101324
,20170626,22510,22490,22500,22500,22125,22375,22250,-115,-240,59684,"664,086.65",81068
,20170627,22375,22250,22405,22670,22205,22670,22355,420,105,37942,"424,100.53",73826
,20170628,22670,22355,22605,22820,22605,22805,22720,450,365,36498,"414,676.70",69068
,20170629,22805,22720,22660,22930,22610,22790,22785,70,65,32366,"368,758.82",61572
,20170630,22790,22785,22790,22930,22545,22930,22695,145,-90,27368,"310,577.55",53300
,20170703,22930,22695,22840,23325,22790,23285,23015,590,320,14310,"164,685.73",48540
,20170704,23285,23015,23240,23330,23040,23130,23185,115,170,9570,"110,959.90",43770
,20170705,23130,23185,23250,23420,23060,23100,23265,-85,80,12110,"140,899.03",38170
,20170706,23100,23265,23055,23195,22930,23185,23085,-80,-180,8600,"99,282.23",33870
,20170707,23185,23085,23185,23340,23075,23320,23170,235,85,7250,"84,009.13",29720
,20170710,23320,23170,23305,23415,23000,23000,23220,-170,50,8300,"96,374.53",25230
,20170711,23000,23220,23000,23360,22875,23280,23115,60,-105,9590,"110,856.23",19460
,20170712,23280,23115,23240,23595,23230,23410,23460,295,345,9650,"113,210.90",14270
,20170713,23410,23460,23430,23470,23220,23340,23345,-120,-115,4420,"51,596.63",11280
,20170714,23340,23345,23180,23180,22870,22970,22935,-375,-410,3630,"41,632.93",9370
,20170717,22970,22935,23050,23250,22900,23250,23095,315,160,2080,"24,022.78",9580
zn1708,20170103,20930,20920,21110,21255,20850,20980,21070,60,150,10,105.37,380
,20170104,20980,21070,20660,21195,20660,21195,20985,125,-85,10,104.93,382
,20170105,21195,20985,21240,21615,21240,21505,21410,520,425,34,364.02,392
,20170106,21505,21410,21175,21465,21165,21165,21260,-245,-150,18,191.34,386
,20170109,21165,21260,21145,21625,21100,21615,21355,355,95,50,533.89,410
,20170110,21615,21355,21590,22535,21590,22535,22090,1180,735,70,773.32,442
,20170111,22535,22090,22645,22645,22310,22310,22410,220,320,22,246.56,444
,20170112,22310,22410,22265,22470,22115,22370,22305,-40,-105,44,490.79,440
,20170113,22370,22305,22345,22345,22165,22165,22265,-140,-40,16,178.13,442
,20170116,22165,22265,22490,22955,22490,22735,22755,470,490,20,227.56,444
,20170117,22735,22755,22370,22370,21880,21880,22130,-875,-625,76,841.08,450
,20170118,21880,22130,22120,22460,22025,22460,22450,330,320,512,"5,748.45",942
,20170119,22460,22450,22445,22445,22250,22250,22380,-200,-70,6,67.14,942
,20170120,22250,22380,22460,22460,22050,22050,22100,-330,-280,38,419.99,960
,20170123,22050,22100,22300,22845,22300,22735,22770,635,670,110,"1,252.54",924
,20170124,22735,22770,22775,22775,22565,22715,22680,-55,-90,36,408.32,920
,20170125,22715,22680,22865,22865,22640,22640,22740,-40,60,12,136.44,918
,20170126,22640,22740,22800,23055,22790,23055,22885,315,145,10,114.45,918
,20170203,23055,22885,22435,22500,22385,22500,22470,-385,-415,28,314.62,924
,20170206,22500,22470,22530,22635,22275,22320,22520,-150,50,62,698.20,930
,20170207,22320,22520,22335,22665,22335,22630,22570,110,50,104,"1,173.74",982
,20170208,22630,22570,22580,23010,22560,22835,22785,265,215,68,774.85,998
,20170209,22835,22785,23015,23090,22940,23025,23015,240,230,42,483.41,1002
,20170210,23025,23015,23135,23465,23075,23445,23235,430,220,82,952.70,1030
,20170213,23445,23235,23565,24220,23500,23985,23770,750,535,146,"1,735.43",1098
,20170214,23985,23770,24000,24000,23725,23960,23860,190,90,38,453.42,1102
,20170215,23960,23860,23880,23885,23405,23690,23590,-170,-270,84,990.79,1106
,20170216,23690,23590,23575,23755,23300,23340,23575,-250,-15,42,495.09,1112
,20170217,23340,23575,23190,23420,23190,23220,23285,-355,-290,32,372.58,1104
,20170220,23220,23285,23105,23105,22770,22930,22865,-355,-420,100,"1,143.44",1092
,20170221,22930,22865,23265,23505,23265,23430,23375,565,510,66,771.54,1108
,20170222,23430,23375,23350,23385,23070,23115,23195,-260,-180,138,"1,600.46",1038
,20170223,23115,23195,23360,23360,22765,22850,23150,-345,-45,110,"1,273.38",1130
,20170224,22850,23150,22770,23050,22655,23005,22835,-145,-315,298,"3,402.60",1106
,20170227,23005,22835,22985,23120,22765,22880,22900,45,65,34,389.32,1090
,20170228,22880,22900,22945,22945,22840,22875,22890,-25,-10,8,91.57,1092
,20170301,22875,22890,23010,23315,22990,23220,23070,330,180,46,530.70,1110
,20170302,23220,23070,23405,23435,23300,23300,23325,230,255,178,"2,076.01",1206
,20170303,23300,23325,23225,23225,22720,22950,22880,-375,-445,116,"1,327.27",1172
,20170306,22950,22880,22845,22845,22300,22300,22575,-580,-305,126,"1,422.31",1202
,20170307,22300,22575,22460,22460,22230,22245,22280,-330,-295,112,"1,247.69",1226
,20170308,22245,22280,22180,22215,21900,22100,22015,-180,-265,30,330.29,1212
,20170309,22100,22015,22030,22100,21620,21665,21785,-350,-230,168,"1,830.11",1256
,20170310,21665,21785,21765,22030,21740,22015,21875,230,90,120,"1,312.52",1298
,20170313,22015,21875,22160,22610,21770,22610,22195,735,320,168,"1,864.76",1316
,20170314,22610,22195,22755,22755,22380,22520,22505,325,310,292,"3,285.76",1454
,20170315,22520,22505,22340,22835,22300,22690,22530,185,25,336,"3,785.35",1510
,20170316,22690,22530,22800,23345,22800,23325,23175,795,645,738,"8,552.70",1724
,20170317,23325,23175,23395,23500,23190,23325,23310,150,135,302,"3,520.30",1830
,20170320,23325,23310,23415,23855,23385,23720,23670,410,360,672,"7,953.17",2106
,20170321,23720,23670,23710,23760,23320,23370,23435,-300,-235,506,"5,929.41",2200
,20170322,23370,23435,23530,23655,22955,23200,23535,-235,100,6658,"78,356.38",2654
,20170323,23200,23535,23255,23500,23110,23360,23355,-175,-180,380,"4,438.03",2778
,20170324,23360,23355,23240,23350,22920,23280,23100,-75,-255,224,"2,587.26",2792
,20170327,23280,23100,23280,23280,22595,22655,22785,-445,-315,834,"9,502.30",2980
,20170328,22655,22785,22650,22735,22310,22505,22535,-280,-250,334,"3,763.90",2956
,20170329,22505,22535,22630,23340,22600,23325,22990,790,455,5356,"61,570.06",6360
,20170330,23325,22990,23260,23555,23215,23380,23355,390,365,870,"10,160.47",6590
,20170331,23380,23355,23350,23695,23035,23295,23265,-60,-90,1604,"18,661.14",6960
,20170405,23295,23265,22840,23185,22815,23030,22990,-235,-275,2688,"30,899.91",8120
,20170406,23030,22990,23110,23250,22835,23040,22950,50,-40,1144,"13,127.78",7824
,20170407,23040,22950,23095,23095,22050,22175,22705,-775,-245,8636,"98,051.44",6196
,20170410,22175,22705,21970,22385,21850,22030,22060,-675,-645,2476,"27,315.35",6310
,20170411,22030,22060,22095,22165,21240,21290,21625,-770,-435,7780,"84,136.54",7486
,20170412,21290,21625,21350,21520,21000,21200,21255,-425,-370,7064,"75,088.31",9518
,20170413,21200,21255,21200,21730,21070,21665,21445,410,190,4844,"51,940.49",9692
,20170414,21665,21445,21540,21695,21275,21375,21500,-70,55,6226,"66,929.50",9842
,20170417,21375,21500,21375,22255,21350,21785,21800,285,300,6262,"68,255.93",10882
,20170418,21785,21800,21785,21885,21250,21315,21485,-485,-315,5532,"59,429.11",11552
,20170419,21315,21485,21315,21325,20600,20810,20855,-675,-630,14920,"155,580.68",15344
,20170420,20810,20855,20825,21515,20695,21515,20980,660,125,23244,"243,879.11",18346
,20170421,21515,20980,21525,21800,21450,21690,21645,710,665,15012,"162,498.50",20700
,20170424,21690,21645,21625,21625,21130,21285,21310,-360,-335,21570,"229,869.67",27358
,20170425,21285,21310,21340,21430,21140,21320,21285,10,-25,28004,"298,085.81",37610
,20170426,21320,21285,21350,21585,21110,21420,21400,135,115,29710,"317,924.60",44646
,20170427,21420,21400,21475,21615,21400,21500,21495,100,95,17816,"191,517.77",48356
,20170428,21500,21495,21515,21645,21155,21620,21475,125,-20,38698,"415,544.28",56824
,20170502,21620,21475,21755,22580,21750,21950,22010,475,535,28804,"317,034.64",55724
,20170503,21950,22010,21945,21970,21545,21615,21720,-395,-290,27540,"299,099.18",57134
,20170504,21615,21720,21505,21505,20910,21130,21255,-590,-465,40724,"432,841.50",61034
,20170505,21130,21255,21115,21350,20995,21000,21195,-255,-60,41184,"436,495.80",68168
,20170508,21000,21195,21050,21350,20820,21060,21050,-135,-145,69810,"734,913.02",76924
,20170509,21060,21050,21095,21520,20995,21470,21290,420,240,62006,"660,157.81",83742
,20170510,21470,21290,21485,21700,21385,21525,21525,235,235,48794,"525,155.44",87964
,20170511,21525,21525,21600,21755,21315,21735,21515,210,-10,56674,"609,730.60",92542
,20170512,21735,21515,21725,21735,21220,21395,21390,-120,-125,71148,"761,042.99",104122
,20170515,21395,21390,21405,21475,21080,21365,21275,-25,-115,75468,"802,961.08",108640
,20170516,21365,21275,21365,21565,20905,21060,21095,-215,-180,99988,"1,054,663.20",121218
,20170517,21060,21095,21050,21405,20980,21265,21220,170,125,94178,"999,411.90",121650
,20170518,21265,21220,21280,21400,21060,21115,21195,-105,-25,99756,"1,057,336.41",128006
,20170519,21115,21195,20680,21350,20565,21180,21040,-15,-155,161040,"1,694,459.30",128620
,20170522,21180,21040,21620,22240,21485,21880,21870,840,830,196972,"2,154,007.36",137690
,20170523,21880,21870,21995,22200,21855,22020,22025,150,155,137632,"1,515,682.35",154976
,20170524,22020,22025,22055,22225,21765,22000,21985,-25,-40,142026,"1,561,381.66",169496
,20170525,22000,21985,22010,22090,21855,21935,21980,-50,-5,143356,"1,575,808.40",187252
,20170526,21935,21980,21900,22035,21775,21985,21920,5,-60,136146,"1,492,213.73",195638
,20170531,21985,21920,21920,22200,21580,21585,21885,-335,-35,132062,"1,445,161.70",210668
,20170601,21585,21885,21620,21655,21230,21385,21420,-500,-465,181036,"1,939,245.90",216608
,20170602,21385,21420,21375,21445,21205,21305,21320,-115,-100,169052,"1,802,307.84",215198
,20170605,21305,21320,21105,21335,20950,20975,21140,-345,-180,241382,"2,551,906.39",219342
,20170606,20975,21140,20860,21035,20680,20680,20855,-460,-285,226584,"2,362,994.98",225476
,20170607,20680,20855,20710,20920,20435,20540,20665,-315,-190,318470,"3,291,222.28",254426
,20170608,20540,20665,20585,21120,20450,21060,20705,395,40,422154,"4,370,489.70",256260
,20170609,21060,20705,21030,21165,20910,21075,21035,370,330,375042,"3,945,146.54",261214
,20170612,21075,21035,21305,21575,21260,21405,21440,370,405,364764,"3,910,837.21",275390
,20170613,21405,21440,21400,21425,20630,20720,20970,-720,-470,621514,"6,516,988.50",286284
,20170614,20720,20970,20695,21110,20680,21040,20890,70,-80,577804,"6,035,787.87",290026
,20170615,21040,20890,21060,21235,20885,21135,21055,245,165,619646,"6,524,589.81",283222
,20170616,21135,21055,21075,21335,20950,21140,21135,85,80,517700,"5,471,692.92",284630
,20170619,21140,21135,21130,21310,20960,21260,21135,125,0,522876,"5,525,773.86",274874
,20170620,21260,21135,21365,21480,21285,21420,21390,285,255,450220,"4,816,162.07",274082
,20170621,21420,21390,21395,21495,21215,21450,21365,60,-25,574704,"6,140,140.97",278484
,20170622,21450,21365,21670,22090,21645,21990,21920,625,555,727424,"7,972,825.81",276400
,20170623,21990,21920,22300,22335,22010,22260,22135,340,215,527994,"5,844,338.28",279124
,20170626,22260,22135,22230,22230,21915,22110,22015,-25,-120,554240,"6,101,126.00",262232
,20170627,22110,22015,22130,22480,21955,22455,22120,440,105,525524,"5,813,086.58",267144
,20170628,22455,22120,22420,22655,22360,22580,22485,460,365,563334,"6,334,616.12",263118
,20170629,22580,22485,22455,22790,22380,22635,22570,150,85,525858,"5,935,280.91",256100
,20170630,22635,22570,22600,22770,22355,22745,22555,175,-15,503356,"5,677,358.63",244704
,20170703,22745,22555,22680,23130,22620,23070,22800,515,245,456238,"5,201,801.18",243462
,20170704,23070,22800,23020,23160,22825,22940,23000,140,200,450448,"5,180,319.04",237784
,20170705,22940,23000,22925,23270,22855,22915,23080,-85,80,438398,"5,059,567.18",228060
,20170706,22915,23080,22845,22980,22700,22965,22850,-115,-230,366360,"4,185,751.70",219928
,20170707,22965,22850,22950,23140,22845,23080,22965,230,115,289846,"3,328,611.86",217520
,20170710,23080,22965,23000,23245,22775,22800,23040,-165,75,316218,"3,643,120.37",205230
,20170711,22800,23040,22810,23175,22650,23095,22905,55,-135,218642,"2,504,493.34",198538
,20170712,23095,22905,23010,23525,22990,23420,23345,515,440,176488,"2,060,228.19",189094
,20170713,23420,23345,23500,23515,23185,23335,23345,-10,0,129120,"1,507,260.63",172786
,20170714,23335,23345,23295,23330,22825,22950,23000,-395,-345,128290,"1,475,608.40",150444
,20170717,22950,23000,22890,23395,22860,23320,23065,320,65,116774,"1,346,757.66",139456
,20170718,23320,23065,23275,23390,22895,23005,23175,-60,110,79840,"925,167.42",131190
,20170719,23005,23175,22980,23120,22835,23090,22955,-85,-220,72236,"829,212.39",124018
,20170720,23090,22955,22910,23065,22745,22910,22845,-45,-110,100060,"1,142,978.19",111524
,20170721,22910,22845,22875,22990,22700,22910,22890,65,45,68984,"789,590.45",102914
,20170724,22910,22890,23005,23200,22775,23015,23005,125,115,70778,"814,284.11",94496
,20170725,23015,23005,23025,23380,23010,23320,23180,315,175,48358,"560,491.83",87982
,20170726,23320,23180,23365,23680,23280,23340,23475,160,295,62208,"730,256.81",84200
,20170727,23340,23475,23310,23445,23260,23385,23345,-90,-130,36256,"423,265.98",74618
,20170728,23385,23345,23305,23500,23030,23150,23250,-195,-95,49196,"571,919.02",61266
,20170731,23150,23250,23125,23490,23060,23470,23270,220,20,33952,"395,108.07",49398
,20170801,23470,23270,23400,23400,23035,23035,23185,-235,-85,16068,"186,304.44",42630
,20170802,23035,23185,23065,23260,22950,23125,23060,-60,-125,11940,"137,693.28",38010
,20170803,23125,23060,23110,23695,23110,23465,23530,405,470,11200,"131,792.23",34160
,20170804,23465,23530,23495,23730,23310,23565,23540,35,10,9610,"113,114.23",30240
,20170807,23565,23540,23575,23675,23225,23430,23405,-110,-135,15110,"176,853.13",22050
,20170808,23430,23405,23535,24110,23465,23800,23870,395,465,8260,"98,583.28",17690
,20170809,23800,23870,23775,24700,23775,24635,24275,765,405,9430,"114,469.08",15420
,20170810,24635,24275,24610,24650,24250,24320,24360,45,85,5230,"63,707.48",12310
,20170811,24320,24360,23280,24355,23270,24130,24180,-230,-180,5080,"61,418.63",8470
,20170814,24130,24180,24330,24370,24180,24250,24300,70,120,6280,"76,310.90",4140
,20170815,24250,24300,24260,24740,24235,24545,24540,245,240,2160,"26,508.25",3480
zn1709,20170103,21060,20970,21170,21335,20885,21055,21210,85,240,28,296.95,254
,20170104,21055,21210,21190,21190,20655,21165,20925,-45,-285,36,376.70,256
,20170105,21165,20925,21310,21610,21310,21465,21415,540,490,24,257.03,266
,20170106,21465,21415,21315,21475,21210,21210,21355,-205,-60,26,277.64,270
,20170109,21210,21355,21220,21705,21170,21695,21475,340,120,54,579.85,298
,20170110,21695,21475,21660,22620,21660,22620,22100,1145,625,116,"1,281.98",326
,20170111,22620,22100,22665,22665,22335,22435,22495,335,395,48,539.98,322
,20170112,22435,22495,22400,22465,22175,22390,22385,-105,-110,26,291.01,312
,20170113,22390,22385,22750,22750,22185,22220,22465,-165,80,62,696.49,338
,20170116,22220,22465,22490,23060,22490,22885,22735,420,270,68,773.02,362
,20170117,22885,22735,22670,22675,21830,21865,22105,-870,-630,160,"1,768.47",368
,20170118,21865,22105,22055,22510,22055,22400,22360,295,255,28,313.08,358
,20170119,22400,22360,22290,22395,22210,22370,22325,10,-35,18,200.93,356
,20170120,22370,22325,22380,22500,22050,22050,22335,-275,10,24,268.03,354
,20170123,22050,22335,22145,22900,22145,22785,22675,450,340,48,544.26,360
,20170124,22785,22675,22710,22730,22535,22535,22655,-140,-20,36,407.82,362
,20170125,22535,22655,22785,22935,22610,22610,22785,-45,130,22,250.68,368
,20170126,22610,22785,22620,23230,22610,22915,22720,130,-65,30,340.85,368
,20170203,22915,22720,24495,24495,22365,22415,22760,-305,40,36,409.72,372
,20170206,22415,22760,22620,22620,22310,22310,22455,-450,-305,38,426.67,370
,20170207,22310,22455,22350,22640,22335,22590,22510,135,55,80,900.56,368
,20170208,22590,22510,22585,22985,22585,22775,22795,265,285,88,"1,003.13",358
,20170209,22775,22795,23030,23035,22930,22945,22985,150,190,28,321.82,362
,20170210,22945,22985,23105,23465,23050,23445,23205,460,220,64,742.70,368
,20170213,23445,23205,23550,24245,23550,23965,23900,760,695,234,"2,796.66",434
,20170214,23965,23900,23970,23970,23685,23940,23850,40,-50,58,691.66,444
,20170215,23940,23850,23485,23685,23395,23620,23615,-230,-235,92,"1,086.40",496
,20170216,23620,23615,23505,23810,23195,23300,23560,-315,-55,152,"1,790.60",530
,20170217,23300,23560,23185,23420,23120,23235,23245,-325,-315,110,"1,278.51",564
,20170220,23235,23245,23170,23170,22710,22845,22860,-400,-385,172,"1,966.17",476
,20170221,22845,22860,23230,23535,23230,23320,23435,460,575,110,"1,289.10",552
,20170222,23320,23435,23465,23465,23030,23040,23205,-395,-230,104,"1,206.67",542
,20170223,23040,23205,23260,23400,22850,22975,23025,-230,-180,60,690.85,550
,20170224,22975,23025,23110,23130,22560,22830,22765,-195,-260,28,318.76,546
,20170227,22830,22765,22975,23225,22710,22880,23020,115,255,26,299.28,548
,20170228,22880,23020,22960,23030,22790,22840,22895,-180,-125,24,274.78,548
,20170301,22840,22895,22960,23340,22945,23270,23245,375,350,168,"1,952.77",516
,20170302,23270,23245,23410,23445,23175,23265,23350,20,105,56,653.87,516
,20170303,23265,23350,23265,23265,22610,22865,22825,-485,-525,108,"1,232.80",530
,20170306,22865,22825,22905,22910,22280,22285,22760,-540,-65,150,"1,707.07",560
,20170307,22285,22760,22315,22470,22205,22355,22335,-405,-425,42,469.12,570
,20170308,22355,22335,22355,22370,21860,22110,22080,-225,-255,72,795.03,568
,20170309,22110,22080,22110,22215,21545,21655,21800,-425,-280,116,"1,264.61",544
,20170310,21655,21800,21685,22035,21680,21980,21865,180,65,128,"1,399.54",562
,20170313,21980,21865,22200,22650,21920,22650,22280,785,415,230,"2,562.60",634
,20170314,22650,22280,22600,22665,22345,22515,22490,235,210,314,"3,531.53",818
,20170315,22515,22490,22515,22820,22160,22710,22590,220,100,168,"1,897.96",846
,20170316,22710,22590,22815,23310,22815,23305,23170,715,580,398,"4,611.76",864
,20170317,23305,23170,22705,23520,22705,23300,23315,130,145,158,"1,842.05",904
,20170320,23300,23315,23530,23865,23450,23700,23690,385,375,326,"3,861.56",1040
,20170321,23700,23690,23730,23755,23315,23360,23550,-330,-140,130,"1,530.93",1018
,20170322,23360,23550,23440,23550,22970,23130,23205,-420,-345,468,"5,430.05",1046
,20170323,23130,23205,23290,23470,22980,23345,23275,140,70,390,"4,539.01",1194
,20170324,23345,23275,23185,23270,22835,23270,23040,-5,-235,304,"3,502.69",1226
,20170327,23270,23040,23200,23305,22565,22630,22755,-410,-285,1440,"16,385.33",1826
,20170328,22630,22755,22630,22745,22305,22455,22520,-300,-235,634,"7,139.17",1774
,20170329,22455,22520,22455,23385,22455,23295,22880,775,360,1164,"13,316.95",2034
,20170330,23295,22880,23295,23555,23200,23345,23360,465,480,466,"5,443.56",2082
,20170331,23345,23360,23325,23680,23025,23285,23285,-75,-75,930,"10,829.44",2232
,20170405,23285,23285,22585,23120,22585,23005,22990,-280,-295,502,"5,771.12",2276
,20170406,23005,22990,23100,23235,22800,23030,22985,40,-5,444,"5,103.76",2310
,20170407,23030,22985,23015,23015,22050,22200,22530,-785,-455,2200,"24,783.46",2456
,20170410,22200,22530,21905,22380,21855,22055,22060,-475,-470,1270,"14,010.08",2570
,20170411,22055,22060,22090,22140,21245,21300,21445,-760,-615,2830,"30,349.94",3564
,20170412,21300,21445,21300,21525,20995,21170,21250,-275,-195,1994,"21,190.87",4456
,20170413,21170,21250,21125,21720,21095,21670,21430,420,180,2342,"25,094.62",5362
,20170414,21670,21430,21425,21660,21265,21335,21455,-95,25,1268,"13,603.36",5150
,20170417,21335,21455,21340,22485,21340,21820,21800,365,345,1120,"12,208.70",5242
,20170418,21820,21800,21810,21850,21210,21270,21510,-530,-290,1244,"13,381.44",5564
,20170419,21270,21510,21055,21285,20605,20750,20780,-760,-730,4928,"51,203.13",6524
,20170420,20750,20780,20835,21475,20605,21475,20895,695,115,3552,"37,111.16",6636
,20170421,21475,20895,21500,21735,21385,21615,21585,720,690,2116,"22,841.57",6818
,20170424,21615,21585,21485,21505,21085,21235,21270,-350,-315,3516,"37,394.34",7236
,20170425,21235,21270,21265,21395,21040,21265,21195,-5,-75,5106,"54,121.28",8822
,20170426,21265,21195,21270,21475,21025,21310,21305,115,110,5800,"61,791.85",10984
,20170427,21310,21305,21380,21525,21310,21440,21405,135,100,2058,"22,028.55",11552
,20170428,21440,21405,21415,21545,21065,21505,21370,100,-35,6024,"64,366.58",13708
,20170502,21505,21370,21680,22185,21680,21840,21910,470,540,3402,"37,277.28",13756
,20170503,21840,21910,21845,21870,21455,21535,21695,-375,-215,4046,"43,889.31",13116
,20170504,21535,21695,21365,21380,20815,21060,21150,-635,-545,5636,"59,600.93",14854
,20170505,21060,21150,21045,21270,20905,20905,21135,-245,-15,7888,"83,375.34",18604
,20170508,20905,21135,20940,21250,20680,20960,20900,-175,-235,14430,"150,819.90",22118
,20170509,20960,20900,20995,21375,20875,21330,21170,430,270,15012,"158,910.72",25506
,20170510,21330,21170,21365,21555,21250,21375,21380,205,210,8130,"86,922.65",26398
,20170511,21375,21380,21375,21585,21180,21575,21360,195,-20,11280,"120,495.54",28116
,20170512,21575,21360,21740,21740,21050,21220,21230,-140,-130,15150,"160,847.57",30250
,20170515,21220,21230,21220,21295,20900,21185,21080,-45,-150,15366,"161,985.84",31176
,20170516,21185,21080,21145,21380,20715,20855,20875,-225,-205,32334,"337,508.89",41634
,20170517,20855,20875,20855,21190,20795,21080,21000,205,125,26074,"273,825.64",45630
,20170518,21080,21000,21080,21215,20900,20990,21045,-10,45,33950,"357,287.02",54098
,20170519,20990,21045,20410,21170,19580,20985,20835,-60,-210,36928,"384,775.02",52718
,20170522,20985,20835,21400,22060,21310,21685,21680,850,845,47526,"515,280.47",53728
,20170523,21685,21680,21810,21970,21635,21770,21805,90,125,36952,"402,935.08",57608
,20170524,21770,21805,21810,21950,21505,21745,21730,-60,-75,36700,"398,788.46",59912
,20170525,21745,21730,21755,21825,21615,21730,21710,0,-20,47216,"512,617.00",70012
,20170526,21730,21710,21685,21900,21620,21820,21740,110,30,44568,"484,462.86",76060
,20170531,21820,21740,21730,22010,21455,21460,21720,-280,-20,47772,"518,810.77",83388
,20170601,21460,21720,21465,21515,21040,21165,21230,-555,-490,61530,"653,208.58",85264
,20170602,21165,21230,21165,21220,20990,21090,21100,-140,-130,43262,"456,500.48",85118
,20170605,21090,21100,20980,21020,20710,20750,20875,-350,-225,61894,"646,111.63",92694
,20170606,20750,20875,20600,20795,20430,20430,20610,-445,-265,44304,"456,609.06",93716
,20170607,20430,20610,20490,20670,20205,20265,20430,-345,-180,61254,"625,824.42",98338
,20170608,20265,20430,20305,20725,20120,20645,20355,215,-75,86568,"881,170.10",100954
,20170609,20645,20355,20660,20765,20525,20700,20645,345,290,65426,"675,456.20",102716
,20170612,20700,20645,20915,21130,20855,21045,20990,400,345,79792,"837,510.79",119024
,20170613,21045,20990,21000,21100,20420,20510,20750,-480,-240,95356,"989,453.35",124912
,20170614,20510,20750,20475,20880,20450,20830,20665,80,-85,75232,"777,452.49",123084
,20170615,20830,20665,20820,21035,20665,20945,20840,280,175,77390,"806,573.41",122108
,20170616,20945,20840,20890,21195,20750,20955,20990,115,150,69920,"733,967.20",120910
,20170619,20955,20990,20910,21095,20770,21010,20945,20,-45,84704,"887,077.13",120410
,20170620,21010,20945,21150,21210,21020,21170,21130,225,185,74018,"782,172.97",126368
,20170621,21170,21130,21120,21245,20965,21195,21110,65,-20,83350,"879,882.48",127904
,20170622,21195,21110,21410,21805,21395,21720,21645,610,535,150866,"1,632,855.52",137262
,20170623,21720,21645,22070,22095,21825,22095,21930,450,285,149312,"1,637,402.91",151954
,20170626,22095,21930,22100,22100,21800,22000,21900,70,-30,149182,"1,633,621.64",156968
,20170627,22000,21900,22020,22360,21835,22360,22025,460,125,147734,"1,627,234.80",170468
,20170628,22360,22025,22310,22485,22240,22445,22350,420,325,148090,"1,654,994.94",182198
,20170629,22445,22350,22300,22625,22230,22515,22445,165,95,155274,"1,742,629.30",193864
,20170630,22515,22445,22465,22635,22265,22630,22440,185,-5,164346,"1,844,108.81",215528
,20170703,22630,22440,22570,22990,22500,22940,22675,500,235,196254,"2,225,395.52",239942
,20170704,22940,22675,22885,23010,22640,22775,22830,100,155,225418,"2,573,631.81",243866
,20170705,22775,22830,22750,23075,22730,22780,22915,-50,85,245062,"2,807,860.62",250288
,20170706,22780,22915,22680,22820,22540,22800,22690,-115,-225,239142,"2,713,331.91",258916
,20170707,22800,22690,22800,23000,22705,22925,22825,235,135,244942,"2,795,721.77",267152
,20170710,22925,22825,22865,23125,22620,22640,22885,-185,60,397992,"4,554,909.35",273216
,20170711,22640,22885,22675,23080,22485,22990,22795,105,-90,504556,"5,750,832.15",284764
,20170712,22990,22795,22885,23410,22880,23330,23240,535,445,551760,"6,411,871.88",303986
,20170713,23330,23240,23390,23430,23110,23325,23275,85,35,421526,"4,906,398.46",298316
,20170714,23325,23275,23310,23310,22755,22920,22965,-355,-310,496018,"5,695,959.58",286480
,20170717,22920,22965,22840,23410,22810,23320,23050,355,85,570024,"6,570,814.13",298362
,20170718,23320,23050,23280,23365,22850,22980,23150,-70,100,468166,"5,419,282.70",289590
,20170719,22980,23150,22930,23060,22780,23030,22915,-120,-235,480938,"5,511,441.40",290228
,20170720,23030,22915,22890,22980,22625,22820,22760,-95,-155,622184,"7,081,411.96",271254
,20170721,22820,22760,22820,22905,22565,22840,22790,80,30,505150,"5,756,330.66",266304
,20170724,22840,22790,22935,23150,22700,22955,22935,165,145,608420,"6,977,700.59",264304
,20170725,22955,22935,22950,23310,22920,23250,23100,315,165,530150,"6,123,647.38",262310
,20170726,23250,23100,23300,23650,23225,23265,23420,165,320,669146,"7,836,760.52",248876
,20170727,23265,23420,23180,23385,23180,23335,23295,-85,-125,407124,"4,742,937.78",244580
,20170728,23335,23295,23285,23445,22935,23075,23190,-220,-105,562258,"6,520,413.44",218540
,20170731,23075,23190,23040,23400,22970,23360,23170,170,-20,528608,"6,125,154.60",200852
,20170801,23360,23170,23290,23345,22950,22955,23160,-215,-10,358274,"4,149,326.94",189582
,20170802,22955,23160,23020,23195,22855,23055,23015,-105,-145,393322,"4,526,399.81",185476
,20170803,23055,23015,23025,23650,23005,23390,23385,375,370,449614,"5,258,103.04",187456
,20170804,23390,23385,23425,23715,23230,23570,23445,185,60,333282,"3,907,666.95",183984
,20170807,23570,23445,23580,23690,23265,23490,23450,45,5,374748,"4,394,732.77",163610
,20170808,23490,23450,23555,24115,23470,23860,23890,410,440,332426,"3,971,656.18",156610
,20170809,23860,23890,23805,24795,23805,24725,24280,835,390,227740,"2,764,865.83",142464
,20170810,24725,24280,24650,24750,24260,24305,24455,25,175,119546,"1,461,920.43",130662
,20170811,24305,24455,24330,24490,24005,24080,24200,-375,-255,124864,"1,511,143.35",116872
,20170814,24080,24200,24195,24310,24015,24235,24185,35,-15,82442,"997,066.64",112766
,20170815,24235,24185,24230,24535,24120,24380,24345,195,160,77294,"940,957.47",109250
,20170816,24380,24345,24405,24915,24325,24885,24655,540,310,67124,"827,495.70",107992
,20170817,24885,24655,25095,26130,25090,26130,25790,1475,1135,62788,"809,788.01",100922
,20170818,26130,25790,26055,26485,25800,26315,26130,525,340,105502,"1,378,394.43",87520
,20170821,26315,26130,26415,26905,26005,26590,26540,460,410,70050,"929,657.01",78570
,20170822,26590,26540,26555,26610,26150,26470,26365,-70,-175,49160,"648,164.50",71224
,20170823,26470,26365,26540,26545,25820,26120,26085,-245,-280,40128,"523,397.66",64306
,20170824,26120,26085,26055,26455,25995,26155,26200,70,115,28978,"379,621.16",62426
,20170825,26155,26200,26155,26550,26050,26520,26300,320,100,28132,"369,973.91",57444
,20170828,26520,26300,26520,26560,25665,26085,25965,-215,-335,38678,"502,145.06",47704
,20170829,26085,25965,26085,26200,25695,25790,25930,-175,-35,25486,"330,450.76",40994
,20170830,25790,25930,25840,26000,25500,25945,25810,15,-120,27480,"354,676.34",34594
,20170831,25945,25810,25770,25900,25635,25840,25805,30,-5,15420,"198,957.26",29180
,20170901,25840,25805,25970,26290,25890,26185,26100,380,295,9240,"120,588.38",29010
,20170904,26185,26100,26150,26580,26060,26250,26370,150,270,6720,"88,608.48",27480
,20170905,26250,26370,26305,26425,26185,26280,26305,-90,-65,5470,"71,956.70",25680
,20170906,26280,26305,26195,26255,25170,25450,25620,-855,-685,13250,"169,740.68",19750
,20170907,25450,25620,25450,25650,25250,25270,25440,-350,-180,5770,"73,403.25",17270
,20170908,25270,25440,25485,25585,24940,25010,25275,-430,-165,7000,"88,466.23",13920
,20170911,25010,25275,25055,25320,24700,25310,25085,35,-190,6380,"80,023.30",9420
,20170912,25310,25085,25390,25615,25200,25550,25375,465,290,5040,"63,951.73",8260
,20170913,25550,25375,25350,25605,25105,25280,25325,-95,-50,2800,"35,456.10",6530
,20170914,25280,25325,25150,25840,25010,25120,25195,-205,-130,2240,"28,222.05",4490
,20170915,25120,25195,25300,25565,24330,24330,25345,-865,150,1140,"14,448.18",3940
zn1710,20170103,21055,21045,21280,21280,21110,21110,21165,65,120,10,105.85,634
,20170104,21110,21165,21005,21215,21005,21215,21050,50,-115,20,210.55,636
,20170105,21215,21050,21240,21695,21240,21435,21360,385,310,18,192.28,628
,20170106,21435,21360,21340,21525,21285,21285,21400,-75,40,18,192.61,628
,20170109,21285,21400,21385,21685,21385,21685,21505,285,105,16,172.04,636
,20170110,21685,21505,21695,22805,21655,22585,22160,1080,655,80,886.46,656
,20170111,22585,22160,22625,22625,22320,22470,22460,310,300,58,651.43,642
,20170112,22470,22460,22425,22425,22210,22320,22305,-140,-155,48,535.38,640
,20170113,22320,22305,22630,22630,22250,22250,22460,-55,155,24,269.52,642
,20170116,22250,22460,22485,22915,22485,22755,22825,295,365,30,342.40,642
,20170117,22755,22825,22520,22520,21815,21945,21995,-880,-830,18,197.98,644
,20170118,21945,21995,22045,22455,22020,22310,22305,315,310,552,"6,156.42",1128
,20170119,22310,22305,22335,22395,22110,22305,22205,0,-100,44,488.61,1148
,20170120,22305,22205,22350,22410,22145,22145,22325,-60,120,24,267.94,1142
,20170123,22145,22325,22440,22780,22065,22730,22360,405,35,100,"1,118.15",1144
,20170124,22730,22360,22625,22625,22525,22525,22605,165,245,14,158.24,1134
,20170125,22525,22605,22715,22870,22700,22715,22755,110,150,16,182.06,1134
,20170126,22715,22755,22790,23000,22670,23000,22775,245,20,14,159.44,1132
,20170203,23000,22775,22860,22930,22495,22495,22695,-280,-80,20,226.97,1132
,20170206,22495,22695,22565,22565,22370,22370,22465,-325,-230,58,651.53,1142
,20170207,22370,22465,22390,22565,22290,22565,22425,100,-40,14,156.98,1136
,20170208,22565,22425,22755,22990,22665,22800,22775,375,350,28,318.86,1138
,20170209,22800,22775,22925,23055,22925,22975,23000,200,225,16,184.02,1142
,20170210,22975,23000,23040,23465,23035,23450,23195,450,195,52,603.11,1150
,20170213,23450,23195,23565,24255,23565,23920,23915,725,720,78,932.74,1170
,20170214,23920,23915,23945,23960,23665,23960,23850,45,-65,74,882.50,1186
,20170215,23960,23850,23595,23735,23335,23735,23500,-115,-350,54,634.60,1202
,20170216,23735,23500,23530,23700,23215,23295,23585,-205,85,106,"1,250.20",1248
,20170217,23295,23585,23250,23445,23090,23130,23255,-455,-330,54,627.96,1254
,20170220,23130,23255,23110,23110,22760,22935,22855,-320,-400,114,"1,303.01",1260
,20170221,22935,22855,23300,23525,23300,23385,23425,530,570,56,655.96,1274
,20170222,23385,23425,23405,23405,23015,23070,23115,-355,-310,68,786.08,1296
,20170223,23070,23115,23175,23360,22885,22895,23040,-220,-75,106,"1,221.37",1248
,20170224,22895,23040,23095,23115,22580,22895,22775,-145,-265,42,478.32,1252
,20170227,22895,22775,22805,23075,22705,22770,22870,-5,95,36,411.71,1250
,20170228,22770,22870,22925,23025,22820,22995,22920,125,50,36,412.59,1246
,20170301,22995,22920,22985,23465,22940,23240,23175,320,255,52,602.66,1244
,20170302,23240,23175,23415,23425,23275,23275,23345,100,170,86,"1,003.85",1256
,20170303,23275,23345,22845,23015,22635,22910,22865,-435,-480,204,"2,332.31",1292
,20170306,22910,22865,22920,23010,22320,22400,22680,-465,-185,216,"2,449.75",1340
,20170307,22400,22680,22365,22480,22280,22280,22375,-400,-305,58,648.89,1340
,20170308,22280,22375,22235,22235,21900,22080,22055,-295,-320,80,882.36,1328
,20170309,22080,22055,22095,22095,21605,21665,21760,-390,-295,160,"1,740.97",1290
,20170310,21665,21760,21615,22010,21615,22010,21820,250,60,30,327.32,1298
,20170313,22010,21820,22200,22625,21970,22625,22245,805,425,66,734.11,1314
,20170314,22625,22245,22595,22600,22335,22510,22490,265,245,600,"6,748.29",1570
,20170315,22510,22490,22335,22815,22255,22655,22655,165,165,256,"2,900.15",1514
,20170316,22655,22655,22825,23295,22800,23275,23100,620,445,576,"6,652.87",1542
,20170317,23275,23100,23215,23395,23160,23260,23280,160,180,450,"5,238.16",1622
,20170320,23260,23280,23390,23795,23390,23585,23595,305,315,76,896.76,1618
,20170321,23585,23595,23650,23705,23360,23360,23415,-235,-180,118,"1,381.53",1612
,20170322,23360,23415,23465,23520,22915,23120,23345,-295,-70,266,"3,105.54",1700
,20170323,23120,23345,23275,23390,23130,23335,23325,-10,-20,184,"2,146.15",1752
,20170324,23335,23325,23130,23295,22865,23230,23080,-95,-245,52,600.21,1750
,20170327,23230,23080,23135,23260,22515,22555,22875,-525,-205,116,"1,326.92",1768
,20170328,22555,22875,22560,22585,22340,22380,22485,-495,-390,22,247.34,1766
,20170329,22380,22485,22550,23245,22500,23245,22925,760,440,178,"2,040.43",1866
,20170330,23245,22925,23165,23425,23165,23340,23265,415,340,154,"1,791.74",1924
,20170331,23340,23265,23465,23610,23035,23265,23205,0,-60,408,"4,734.49",1956
,20170405,23265,23205,22920,23030,22850,22945,22925,-260,-280,46,527.37,1940
,20170406,22945,22925,23100,23140,22875,23040,22980,115,55,58,666.50,1936
,20170407,23040,22980,23000,23000,22055,22205,22325,-775,-655,770,"8,596.56",2134
,20170410,22205,22325,22005,22360,21855,22020,22030,-305,-295,518,"5,705.81",2030
,20170411,22020,22030,22080,22115,21255,21255,21570,-775,-460,416,"4,486.95",2092
,20170412,21255,21570,21420,21475,21065,21170,21265,-400,-305,582,"6,189.07",2244
,20170413,21170,21265,21080,21700,21080,21630,21450,365,185,282,"3,024.62",2312
,20170414,21630,21450,21405,21665,21320,21320,21485,-130,35,238,"2,556.76",2186
,20170417,21320,21485,21385,22065,21385,21775,21725,290,240,286,"3,106.76",2306
,20170418,21775,21725,21705,21710,21230,21270,21450,-455,-275,352,"3,775.42",2416
,20170419,21270,21450,21155,21235,20595,20770,20815,-680,-635,640,"6,662.19",2726
,20170420,20770,20815,21240,21440,20600,21440,20880,625,65,694,"7,245.62",2770
,20170421,21440,20880,21460,21720,21400,21625,21525,745,645,294,"3,164.62",2688
,20170424,21625,21525,21400,21400,21055,21100,21235,-425,-290,366,"3,886.20",2734
,20170425,21100,21235,21240,21305,21040,21210,21170,-25,-65,1602,"16,958.50",3856
,20170426,21210,21170,21285,21695,21035,21275,21300,105,130,1654,"17,617.43",4238
,20170427,21275,21300,21300,21445,21260,21385,21345,85,45,188,"2,006.52",4140
,20170428,21385,21345,21400,21450,21005,21420,21310,75,-35,1322,"14,087.31",5082
,20170502,21420,21310,21680,21980,21635,21765,21810,455,500,228,"2,486.78",5014
,20170503,21765,21810,21700,21725,21400,21400,21490,-410,-320,166,"1,783.70",4940
,20170504,21400,21490,21280,21280,20800,21035,21100,-455,-390,472,"4,979.84",4660
,20170505,21035,21100,20945,21170,20850,20850,21005,-250,-95,310,"3,256.11",4764
,20170508,20850,21005,21010,21105,20640,20900,20815,-105,-190,722,"7,514.90",4938
,20170509,20900,20815,20890,21265,20830,21260,21005,445,190,506,"5,315.33",5134
,20170510,21260,21005,21305,21400,21180,21280,21270,275,265,340,"3,616.48",5286
,20170511,21280,21270,21325,21450,21100,21425,21315,155,45,1092,"11,639.62",5746
,20170512,21425,21315,21495,21495,20945,21100,21070,-215,-245,1060,"11,168.65",6200
,20170515,21100,21070,20955,21070,20795,21070,20910,0,-160,550,"5,751.00",6168
,20170516,21070,20910,21145,21240,20580,20715,20685,-195,-225,1102,"11,400.02",6148
,20170517,20715,20685,20725,21045,20665,20935,20860,250,175,2152,"22,446.09",6186
,20170518,20935,20860,20940,21085,20785,20915,20935,55,75,2338,"24,476.03",5958
,20170519,20915,20935,20435,21035,20295,20845,20805,-90,-130,3520,"36,623.86",7322
,20170522,20845,20805,21230,21880,21180,21540,21525,735,720,8954,"96,381.73",11332
,20170523,21540,21525,21685,21835,21480,21580,21680,55,155,3410,"36,969.61",12160
,20170524,21580,21680,21600,21765,21320,21590,21530,-90,-150,4938,"53,164.89",13532
,20170525,21590,21530,21630,21650,21445,21595,21525,65,-5,5214,"56,123.73",14672
,20170526,21595,21525,21545,21765,21450,21755,21645,230,120,6504,"70,398.66",17330
,20170531,21755,21645,21740,21920,21355,21440,21600,-205,-45,4930,"53,245.23",17382
,20170601,21440,21600,21425,21450,20925,21075,21130,-525,-470,9624,"101,677.60",19400
,20170602,21075,21130,21105,21105,20880,20925,20975,-205,-155,3968,"41,614.71",19122
,20170605,20925,20975,20855,20875,20585,20675,20735,-300,-240,11754,"121,869.63",22226
,20170606,20675,20735,20525,20690,20340,20340,20510,-395,-225,5462,"56,013.68",21970
,20170607,20340,20510,20340,20560,20090,20165,20290,-345,-220,6324,"64,165.04",21734
,20170608,20165,20290,20205,20490,19965,20430,20155,140,-135,15628,"157,508.02",23236
,20170609,20430,20155,20425,20525,20280,20405,20400,250,245,12320,"125,691.26",23942
,20170612,20405,20400,20430,20910,20430,20800,20725,400,325,15048,"155,947.72",27040
,20170613,20800,20725,20760,20945,20285,20370,20605,-355,-120,20634,"212,620.25",31578
,20170614,20370,20605,20260,20725,20260,20670,20545,65,-60,15274,"156,923.85",31436
,20170615,20670,20545,20680,20835,20495,20800,20680,255,135,15402,"159,279.14",33056
,20170616,20800,20680,20715,21070,20615,20815,20885,135,205,15684,"163,790.42",32874
,20170619,20815,20885,20785,20955,20640,20870,20805,-15,-80,12862,"133,817.33",33794
,20170620,20870,20805,21000,21065,20900,21030,20990,225,185,19350,"203,095.78",39470
,20170621,21030,20990,21030,21080,20825,21050,20965,60,-25,16768,"175,779.66",42158
,20170622,21050,20965,21340,21660,21240,21560,21505,595,540,36916,"396,964.87",53012
,20170623,21560,21505,22050,22050,21705,22000,21815,495,310,37786,"412,173.41",61368
,20170626,22000,21815,21965,22000,21690,21930,21840,115,25,39510,"431,507.58",61794
,20170627,21930,21840,21975,22300,21800,22285,21960,445,120,41814,"459,206.78",72030
,20170628,22285,21960,22200,22410,22170,22350,22255,390,295,38786,"431,646.82",74716
,20170629,22350,22255,22225,22495,22100,22395,22320,140,65,41642,"464,767.03",79662
,20170630,22395,22320,22350,22495,22130,22485,22310,165,-10,46492,"518,697.34",92038
,20170703,22485,22310,22475,22830,22350,22760,22520,450,210,42340,"476,800.58",96130
,20170704,22760,22520,22750,22850,22465,22605,22665,85,145,41390,"469,144.08",98318
,20170705,22605,22665,22605,22895,22565,22640,22740,-25,75,44880,"510,389.71",96056
,20170706,22640,22740,22595,22660,22290,22655,22530,-85,-210,34616,"390,013.95",95544
,20170707,22655,22530,22650,22845,22570,22775,22690,245,160,34586,"392,400.04",98144
,20170710,22775,22690,22705,22970,22485,22520,22755,-170,65,46234,"526,077.12",99816
,20170711,22520,22755,22550,22955,22350,22890,22670,135,-85,49192,"557,635.66",99950
,20170712,22890,22670,22830,23260,22760,23205,23105,535,435,58554,"676,482.62",104160
,20170713,23205,23105,23255,23300,23010,23255,23190,150,85,53724,"622,935.39",99852
,20170714,23255,23190,23240,23240,22730,22845,22920,-345,-270,70840,"811,993.17",97536
,20170717,22845,22920,22750,23350,22745,23275,23000,355,80,71160,"818,470.65",96588
,20170718,23275,23000,23255,23300,22800,22930,23080,-70,80,54864,"633,248.30",98204
,20170719,22930,23080,22850,22965,22725,22915,22845,-165,-235,52398,"598,553.20",102712
,20170720,22915,22845,22820,22870,22520,22685,22655,-160,-190,83554,"946,557.43",103570
,20170721,22685,22655,22755,22795,22450,22735,22680,80,25,56850,"644,785.18",103108
,20170724,22735,22680,22850,23060,22595,22900,22870,220,190,106812,"1,221,545.99",119476
,20170725,22900,22870,22880,23220,22855,23150,23025,280,155,109196,"1,257,238.36",128074
,20170726,23150,23025,23195,23500,23120,23160,23310,135,285,153174,"1,785,502.07",134022
,20170727,23160,23310,23105,23280,23080,23255,23195,-55,-115,89360,"1,036,515.08",140134
,20170728,23255,23195,23210,23350,22845,22985,23085,-210,-110,153656,"1,773,685.31",144542
,20170731,22985,23085,22965,23335,22880,23280,23110,195,25,183912,"2,125,553.79",170748
,20170801,23280,23110,23235,23270,22855,22860,23070,-250,-40,169040,"1,950,009.42",169316
,20170802,22860,23070,22920,23110,22755,22940,22915,-130,-155,194622,"2,230,337.26",172950
,20170803,22940,22915,22905,23540,22900,23285,23290,370,375,267240,"3,112,461.93",181452
,20170804,23285,23290,23330,23655,23135,23485,23370,195,80,261830,"3,059,780.65",205240
,20170807,23485,23370,23420,23675,23210,23450,23420,80,50,351166,"4,112,249.98",208014
,20170808,23450,23420,23550,24110,23470,23845,23890,425,470,565718,"6,757,685.34",238546
,20170809,23845,23890,23825,24820,23815,24730,24300,840,410,756702,"9,194,199.72",261158
,20170810,24730,24300,24650,24780,24260,24280,24465,-20,165,560416,"6,855,540.81",255000
,20170811,24280,24465,24280,24455,23890,23955,24170,-510,-295,651710,"7,877,077.88",243286
,20170814,23955,24170,24095,24215,23880,24065,24065,-105,-105,493990,"5,944,465.63",231640
,20170815,24065,24065,24095,24440,23980,24260,24210,195,145,528506,"6,397,790.22",241706
,20170816,24260,24210,24310,24800,24195,24745,24505,535,295,637894,"7,817,064.95",274848
,20170817,24745,24505,25000,25975,24960,25975,25620,1470,1115,634016,"8,122,344.94",299136
,20170818,25975,25620,25900,26330,25660,26150,25965,530,345,934492,"12,133,862.14",304208
,20170821,26150,25965,26265,26750,25830,26400,26320,435,355,1068416,"14,061,848.27",309598
,20170822,26400,26320,26335,26480,26005,26310,26240,-10,-80,681026,"8,936,331.51",285098
,20170823,26310,26240,26355,26375,25640,25965,25950,-275,-290,445832,"5,785,538.26",299172
,20170824,25965,25950,25860,26295,25805,25930,26005,-20,55,358010,"4,655,195.22",276966
,20170825,25930,26005,25925,26330,25820,26200,26085,195,80,374540,"4,885,113.61",275274
,20170828,26200,26085,26170,26270,25355,25830,25675,-255,-410,417108,"5,354,636.50",264252
,20170829,25830,25675,25790,25980,25450,25680,25735,5,60,304264,"3,915,591.15",246614
,20170830,25680,25735,25785,25980,25390,25900,25710,165,-25,335780,"4,316,642.71",249304
,20170831,25900,25710,25750,25790,25520,25640,25645,-70,-65,265284,"3,402,068.42",227478
,20170901,25640,25645,25800,26140,25705,26015,25940,370,295,283496,"3,677,626.85",224702
,20170904,26015,25940,25955,26430,25860,26085,26170,145,230,227112,"2,972,195.35",206352
,20170905,26085,26170,26100,26275,26020,26160,26140,-10,-30,146764,"1,918,461.04",193540
,20170906,26160,26140,26075,26145,24890,25200,25505,-940,-635,266660,"3,400,895.21",172594
,20170907,25200,25505,25270,25435,24980,25050,25220,-455,-285,114390,"1,442,629.46",144374
,20170908,25050,25220,25180,25345,24600,24790,25060,-430,-160,118172,"1,480,986.03",135210
,20170911,24790,25060,24805,25140,24105,25095,24785,35,-275,91884,"1,138,828.51",117166
,20170912,25095,24785,25095,25340,24910,25280,25160,495,375,62990,"792,427.89",110734
,20170913,25280,25160,25080,25300,24850,24985,25075,-175,-85,50692,"635,600.57",102460
,20170914,24985,25075,24950,25075,24700,24825,24905,-250,-170,43950,"547,311.48",96728
,20170915,24825,24905,24825,25225,24760,24790,24990,-115,85,46674,"583,198.66",91714
,20170918,24790,24990,24885,25480,24500,25360,25115,370,125,49728,"624,540.36",87756
,20170919,25360,25115,25390,25840,25260,25620,25625,505,510,35406,"453,707.37",82138
,20170920,25620,25625,25550,25950,25345,25825,25675,200,50,40290,"517,255.89",77202
,20170921,25825,25675,25955,26030,25405,25550,25690,-125,15,42712,"548,721.04",69514
,20170922,25550,25690,25550,25875,24930,25010,25275,-680,-415,43818,"553,797.88",63784
,20170925,25010,25275,25335,25660,24800,25470,25365,195,90,34442,"436,869.07",55746
,20170926,25470,25365,25510,26000,25475,25995,25855,630,490,33676,"435,367.88",51964
,20170927,25995,25855,25930,26395,25820,26310,26085,455,230,24598,"320,854.78",43788
,20170928,26310,26085,26225,26310,25850,26165,26055,80,-30,22214,"289,431.43",34988
,20170929,26165,26055,26205,27125,26010,26645,26365,590,310,17792,"234,577.10",28642
,20171009,26645,26365,27140,27350,26920,27200,27140,835,775,9282,"125,979.89",24910
,20171010,27200,27140,26970,27190,26520,26590,26910,-550,-230,12220,"164,433.28",17470
,20171011,26590,26910,26620,27020,26600,26715,26835,-195,-75,10350,"138,892.10",10300
,20171012,26715,26835,26715,26880,26220,26800,26565,-35,-270,4490,"59,643.75",7420
,20171013,26800,26565,26850,26980,26675,26850,26820,285,255,2910,"39,028.48",6310
,20171016,26850,26820,27000,27000,26450,26450,26590,-370,-230,2670,"35,501.50",5550
zn1711,20170103,21055,21010,21335,21335,21145,21145,21245,135,235,18,191.23,318
,20170104,21145,21245,20895,21195,20780,21155,20960,-90,-285,18,188.68,322
,20170105,21155,20960,21250,21715,21250,21620,21390,660,430,22,235.31,308
,20170106,21620,21390,21325,21520,21295,21295,21375,-95,-15,12,128.28,310
,20170109,21295,21375,21295,21695,21130,21695,21365,320,-10,20,213.67,304
,20170110,21695,21365,21635,22560,21635,22560,22100,1195,735,50,552.51,320
,20170111,22560,22100,22695,22695,22275,22365,22455,265,355,34,381.81,322
,20170112,22365,22455,22425,22475,22195,22410,22320,-45,-135,32,357.17,334
,20170113,22410,22320,22500,22585,22205,22230,22435,-90,115,24,269.28,332
,20170116,22230,22435,22380,22985,22255,22815,22655,380,220,116,"1,314.14",330
,20170117,22815,22655,22680,22680,21915,21990,22085,-665,-570,170,"1,877.48",318
,20170118,21990,22085,22120,22505,22040,22440,22245,355,160,144,"1,601.69",262
,20170119,22440,22245,22400,22405,22180,22405,22300,160,55,46,512.95,284
,20170120,22405,22300,22355,22550,22210,22210,22395,-90,95,50,559.95,304
,20170123,22210,22395,22475,22795,22100,22735,22305,340,-90,280,"3,122.82",432
,20170124,22735,22305,22555,22705,22480,22670,22630,365,325,76,860.11,426
,20170125,22670,22630,22745,22890,22715,22745,22780,115,150,16,182.27,428
,20170126,22745,22780,22675,23005,22675,23005,22885,225,105,18,205.97,436
,20170203,23005,22885,22870,22890,22415,22510,22655,-375,-230,20,226.56,432
,20170206,22510,22655,22585,22585,22245,22245,22475,-410,-180,18,202.32,432
,20170207,22245,22475,22340,22550,22340,22540,22510,65,35,28,315.20,450
,20170208,22540,22510,22480,22995,22480,22785,22805,275,295,8,91.24,446
,20170209,22785,22805,22905,23050,22905,22915,22985,110,180,24,275.86,448
,20170210,22915,22985,22910,23465,22905,23465,23155,480,170,58,671.59,454
,20170213,23465,23155,23565,24155,23500,23960,23930,805,775,134,"1,603.39",488
,20170214,23960,23930,24100,24100,23840,23930,23940,0,10,26,311.26,484
,20170215,23930,23940,23890,23890,23305,23395,23610,-545,-330,50,590.34,478
,20170216,23395,23610,23585,23695,23295,23295,23590,-315,-20,56,660.54,472
,20170217,23295,23590,23215,23360,23105,23205,23230,-385,-360,32,371.70,480
,20170220,23205,23230,23135,23135,22775,22855,22935,-375,-295,56,642.28,484
,20170221,22855,22935,23275,23515,23275,23430,23450,495,515,16,187.61,482
,20170222,23430,23450,23460,23565,23005,23025,23170,-425,-280,18,208.54,486
,20170223,23025,23170,23025,23395,22855,22960,23125,-210,-45,86,994.51,486
,20170224,22960,23125,23120,23120,22620,22990,22815,-135,-310,28,319.46,484
,20170227,22990,22815,22705,23095,22705,22930,22970,115,155,32,367.53,480
,20170228,22930,22970,22930,23000,22765,22910,22920,-60,-50,14,160.47,476
,20170301,22910,22920,23030,23095,22915,22990,23010,70,90,18,207.11,478
,20170302,22990,23010,23325,23325,23325,23325,23325,315,315,2,23.33,478
,20170303,23325,23325,23125,23125,22625,22750,22845,-575,-480,24,274.14,482
,20170306,22750,22845,22690,22790,22400,22400,22620,-445,-225,70,791.87,500
,20170307,22400,22620,22390,22570,22270,22340,22390,-280,-230,54,604.62,478
,20170308,22340,22390,22175,22175,21790,21790,21985,-600,-405,70,769.58,454
,20170309,21790,21985,22085,22095,21630,21650,21905,-335,-80,60,657.30,466
,20170310,21650,21905,21700,21945,21700,21945,21820,40,-85,8,87.29,466
,20170313,21945,21820,22190,22545,21940,22520,22295,700,475,58,646.63,490
,20170314,22520,22295,22560,22585,22305,22510,22510,215,215,40,450.25,500
,20170315,22510,22510,22305,22755,22220,22735,22605,225,95,104,"1,175.62",536
,20170316,22735,22605,22905,23260,22805,23235,23140,630,535,56,647.95,540
,20170317,23235,23140,23300,23395,23150,23150,23290,10,150,46,535.74,544
,20170320,23150,23290,23370,23735,23370,23590,23590,300,300,40,471.83,544
,20170321,23590,23590,23670,23685,23295,23300,23570,-290,-20,32,377.15,544
,20170322,23300,23570,23450,23540,23005,23045,23270,-525,-300,48,558.49,538
,20170323,23045,23270,23285,23320,23120,23280,23305,10,35,52,605.94,566
,20170324,23280,23305,23110,23110,22970,23025,23030,-280,-275,26,299.44,566
,20170327,23025,23030,23275,23275,22680,22680,22815,-350,-215,18,205.37,564
,20170328,22680,22815,22315,22585,22315,22585,22490,-230,-325,6,67.48,564
,20170329,22585,22490,22615,22995,22435,22975,22760,485,270,30,341.44,568
,20170330,22975,22760,23220,23425,23175,23225,23260,465,500,76,883.95,604
,20170331,23225,23260,23465,23465,23005,23225,23150,-35,-110,144,"1,667.00",606
,20170405,23225,23150,22855,23000,22785,23000,22920,-150,-230,66,756.45,610
,20170406,23000,22920,23055,23160,22800,22885,22940,-35,20,42,481.75,608
,20170407,22885,22940,22890,22890,22125,22150,22500,-790,-440,174,"1,957.61",610
,20170410,22150,22500,21925,22340,21870,22060,22115,-440,-385,100,"1,105.89",594
,20170411,22060,22115,21820,21820,21190,21295,21600,-820,-515,48,518.44,582
,20170412,21295,21600,21505,21505,21010,21205,21280,-395,-320,90,957.73,572
,20170413,21205,21280,21180,21695,21180,21500,21355,220,75,50,533.99,566
,20170414,21500,21355,21410,21655,21290,21290,21465,-65,110,28,300.56,558
,20170417,21290,21465,21425,21880,21425,21745,21740,280,275,52,565.34,558
,20170418,21745,21740,21750,21750,21170,21170,21440,-570,-300,20,214.45,558
,20170419,21170,21440,21185,21185,20610,20710,20815,-730,-625,88,915.89,570
,20170420,20710,20815,20935,21100,20625,21100,20860,285,45,74,771.84,558
,20170421,21100,20860,21365,21635,21345,21635,21465,775,605,22,236.12,550
,20170424,21635,21465,21340,21370,21070,21145,21185,-320,-280,50,529.70,544
,20170425,21145,21185,21210,21285,21020,21160,21160,-25,-25,66,698.42,530
,20170426,21160,21160,21030,21280,21030,21200,21180,40,20,190,"2,012.44",544
,20170427,21200,21180,21245,21330,21170,21330,21265,150,85,40,425.32,546
,20170428,21330,21265,21315,21395,20980,21355,21245,90,-20,98,"1,041.11",570
,20170502,21355,21245,21775,21895,21435,21610,21655,365,410,42,454.81,562
,20170503,21610,21655,21430,21550,21290,21290,21425,-365,-230,28,299.98,564
,20170504,21290,21425,20995,21090,20995,21005,21020,-420,-405,58,609.72,532
,20170505,21005,21020,20930,20995,20920,20970,20950,-50,-70,12,125.73,530
,20170508,20970,20950,20900,21000,20600,20795,20755,-155,-195,228,"2,366.29",554
,20170509,20795,20755,20695,21175,20695,21175,20910,420,155,62,648.35,536
,20170510,21175,20910,21270,21305,21105,21230,21195,320,285,288,"3,052.43",696
,20170511,21230,21195,21255,21330,21010,21330,21195,135,0,584,"6,189.97",870
,20170512,21330,21195,21345,21345,20875,20990,21005,-205,-190,176,"1,848.63",982
,20170515,20990,21005,20760,20935,20700,20915,20795,-90,-210,146,"1,518.30",1006
,20170516,20915,20795,21070,21070,20500,20560,20625,-235,-170,624,"6,436.46",1282
,20170517,20560,20625,20585,20895,20570,20830,20785,205,160,274,"2,847.82",1340
,20170518,20830,20785,20800,20925,20680,20805,20765,20,-20,566,"5,877.38",1574
,20170519,20805,20765,20265,20940,20230,20785,20595,20,-170,302,"3,110.37",1598
,20170522,20785,20595,21160,21680,21105,21465,21465,870,870,1018,"10,926.36",2124
,20170523,21465,21465,21480,21680,21400,21480,21545,15,80,494,"5,322.35",2336
,20170524,21480,21545,21505,21630,21230,21480,21410,-65,-135,2260,"24,196.49",3820
,20170525,21480,21410,21480,21550,21315,21430,21405,20,-5,754,"8,069.97",3870
,20170526,21430,21405,21300,21675,21300,21650,21545,245,140,782,"8,424.91",4164
,20170531,21650,21545,21740,22320,21290,21355,21680,-190,135,1024,"11,100.45",4314
,20170601,21355,21680,21430,21430,20850,20935,21045,-745,-635,2458,"25,868.00",5788
,20170602,20935,21045,20900,21005,20800,20855,20870,-190,-175,222,"2,317.00",5820
,20170605,20855,20870,20670,20735,20510,20605,20635,-265,-235,712,"7,346.36",6092
,20170606,20605,20635,20470,20625,20240,20240,20415,-395,-220,450,"4,593.94",6108
,20170607,20240,20415,20295,20480,20005,20005,20230,-410,-185,536,"5,421.84",6022
,20170608,20005,20230,20105,20345,19930,20325,20035,95,-195,1628,"16,308.84",5958
,20170609,20325,20035,20260,20395,20150,20285,20290,250,255,532,"5,397.65",6094
,20170612,20285,20290,20530,20765,20445,20700,20570,410,280,1552,"15,963.70",6650
,20170613,20700,20570,20700,20830,20230,20295,20435,-275,-135,2172,"22,197.16",7790
,20170614,20295,20435,20310,20620,20220,20600,20545,165,110,3150,"32,360.23",7864
,20170615,20600,20545,20525,20750,20460,20720,20650,175,105,2284,"23,584.79",8816
,20170616,20720,20650,20645,20965,20555,20710,20845,60,195,2274,"23,706.01",8210
,20170619,20710,20845,20685,20845,20550,20765,20745,-80,-100,1284,"13,321.41",8854
,20170620,20765,20745,20980,20980,20840,20960,20935,215,190,6082,"63,665.46",13434
,20170621,20960,20935,20920,21000,20705,20980,20920,45,-15,1820,"19,038.32",13438
,20170622,20980,20920,21190,21590,21175,21470,21440,550,520,3092,"33,152.23",13864
,20170623,21470,21440,21790,21985,21650,21985,21800,545,360,6482,"70,661.02",16634
,20170626,21985,21800,21980,21980,21735,21930,21825,130,25,9472,"103,370.68",20692
,20170627,21930,21825,21995,22280,21790,22280,21990,455,165,6748,"74,200.37",22926
,20170628,22280,21990,22230,22375,22120,22290,22215,300,225,4558,"50,635.45",23412
,20170629,22290,22215,22185,22400,22035,22300,22215,85,0,7910,"87,875.55",25404
,20170630,22300,22215,22250,22385,22025,22380,22185,165,-30,11036,"122,426.81",27546
,20170703,22380,22185,22325,22685,22225,22640,22425,455,240,4620,"51,802.63",28336
,20170704,22640,22425,22600,22735,22365,22490,22570,65,145,11442,"129,146.73",31324
,20170705,22490,22570,22510,22770,22470,22530,22645,-40,75,4154,"47,040.56",31376
,20170706,22530,22645,22465,22550,22265,22525,22425,-120,-220,2988,"33,504.50",31354
,20170707,22525,22425,22530,22740,22485,22650,22580,225,155,5912,"66,747.02",33744
,20170710,22650,22580,22635,22845,22380,22410,22655,-170,75,5424,"61,446.15",34834
,20170711,22410,22655,22500,22845,22255,22800,22585,145,-70,7892,"89,136.97",34272
,20170712,22800,22585,22705,23115,22665,23070,22995,485,410,18912,"217,444.68",36150
,20170713,23070,22995,23080,23215,22915,23175,23090,180,95,16692,"192,744.27",38760
,20170714,23175,23090,23145,23155,22680,22785,22885,-305,-205,20750,"237,450.20",41572
,20170717,22785,22885,22705,23275,22705,23235,23015,350,130,17382,"200,030.55",42846
,20170718,23235,23015,23175,23240,22740,22830,23045,-185,30,16936,"195,162.42",43586
,20170719,22830,23045,22805,22870,22665,22800,22770,-245,-275,14652,"166,818.45",44778
,20170720,22800,22770,22650,22750,22430,22565,22560,-205,-210,29818,"336,395.34",45366
,20170721,22565,22560,22560,22690,22370,22625,22590,65,30,14346,"162,053.83",47588
,20170724,22625,22590,22630,22965,22510,22800,22785,210,195,22818,"259,959.73",48824
,20170725,22800,22785,22830,23115,22755,23060,22910,275,125,26782,"306,850.30",55252
,20170726,23060,22910,23105,23380,23005,23045,23190,135,280,39414,"457,047.95",60290
,20170727,23045,23190,23010,23175,22965,23130,23085,-60,-105,17808,"205,578.03",63242
,20170728,23130,23085,23130,23230,22750,22875,22960,-210,-125,28204,"323,820.08",63858
,20170731,22875,22960,22940,23230,22785,23200,23030,240,70,42578,"490,344.27",66146
,20170801,23200,23030,23100,23155,22730,22730,22945,-300,-85,26602,"305,204.25",65548
,20170802,22730,22945,22755,22985,22635,22790,22785,-155,-160,38772,"441,717.97",64136
,20170803,22790,22785,22765,23380,22755,23145,23140,360,355,42232,"488,708.90",65404
,20170804,23145,23140,23155,23495,22995,23330,23210,190,70,40148,"465,972.32",69440
,20170807,23330,23210,23300,23530,23085,23370,23290,160,80,64852,"755,341.05",73766
,20170808,23370,23290,23400,24015,23365,23765,23810,475,520,64974,"773,547.32",79994
,20170809,23765,23810,23765,24750,23740,24635,24230,825,420,85624,"1,037,442.14",89700
,20170810,24635,24230,24580,24705,24160,24190,24400,-40,170,61146,"746,094.62",88294
,20170811,24190,24400,24200,24340,23730,23825,24025,-575,-375,90702,"1,089,743.18",93608
,20170814,23825,24025,23935,24090,23740,23900,23935,-125,-90,76810,"919,358.19",94368
,20170815,23900,23935,23975,24280,23810,24115,24075,180,140,60454,"727,766.75",100608
,20170816,24115,24075,24180,24620,24040,24565,24360,490,285,90482,"1,102,152.39",115018
,20170817,24565,24360,24850,25820,24800,25820,25455,1460,1095,125692,"1,599,878.90",120828
,20170818,25820,25455,25780,26095,25430,25925,25755,470,300,166944,"2,150,002.67",127568
,20170821,25925,25755,26065,26495,25580,26150,26090,395,335,170326,"2,221,955.08",128086
,20170822,26150,26090,26045,26290,25810,26110,26030,20,-60,142348,"1,852,836.21",128952
,20170823,26110,26030,26200,26200,25470,25775,25760,-255,-270,91730,"1,181,586.43",144298
,20170824,25775,25760,25700,26105,25605,25750,25820,-10,60,80884,"1,044,314.54",137894
,20170825,25750,25820,25665,26120,25645,26010,25895,190,75,82410,"1,067,092.93",145456
,20170828,26010,25895,25965,26060,25170,25690,25490,-205,-405,95794,"1,221,044.21",145122
,20170829,25690,25490,25640,25845,25340,25575,25600,85,110,83884,"1,073,784.26",155348
,20170830,25575,25600,25695,25900,25300,25855,25640,255,40,114572,"1,468,902.19",180208
,20170831,25855,25640,25700,25700,25435,25570,25560,-70,-80,95604,"1,221,934.99",183428
,20170901,25570,25560,25750,26060,25615,25955,25865,395,305,141582,"1,831,016.20",201040
,20170904,25955,25865,25850,26360,25800,26010,26110,145,245,155114,"2,025,279.58",210602
,20170905,26010,26110,26040,26220,25945,26070,26075,-40,-35,119952,"1,564,020.25",220628
,20170906,26070,26075,26010,26090,24820,25045,25400,-1030,-675,296250,"3,762,393.49",216088
,20170907,25045,25400,25100,25310,24795,24860,25070,-540,-330,239228,"2,998,889.38",226072
,20170908,24860,25070,25030,25195,24385,24575,24900,-495,-170,334352,"4,163,342.10",232754
,20170911,24575,24900,24590,24985,24210,24905,24570,5,-330,343902,"4,225,567.89",229724
,20170912,24905,24570,24930,25215,24740,25150,25000,580,430,293810,"3,672,857.74",233568
,20170913,25150,25000,24970,25145,24690,24825,24955,-175,-45,239386,"2,987,246.45",223840
,20170914,24825,24955,24760,24905,24505,24645,24725,-310,-230,264470,"3,269,634.89",225432
,20170915,24645,24725,24675,25080,24540,24620,24770,-105,45,320196,"3,966,354.62",237084
,20170918,24620,24770,24720,25300,24290,25165,24850,395,80,443200,"5,507,795.81",253568
,20170919,25165,24850,25260,25665,25075,25425,25405,575,555,320080,"4,066,205.00",244500
,20170920,25425,25405,25415,25760,25120,25620,25450,215,45,367566,"4,677,878.18",264778
,20170921,25620,25450,25760,25820,25050,25205,25430,-245,-20,338728,"4,307,602.31",248086
,20170922,25205,25430,25180,25550,24445,24675,24965,-755,-465,530280,"6,619,671.11",255098
,20170925,24675,24965,25025,25350,24385,25175,24940,210,-25,461462,"5,755,326.33",246606
,20170926,25175,24940,25235,25735,25120,25610,25465,670,525,348688,"4,439,862.68",237142
,20170927,25610,25465,25485,25980,25380,25890,25615,425,150,329130,"4,215,441.85",235104
,20170928,25890,25615,25840,25910,25340,25680,25610,65,-5,363146,"4,650,220.23",228470
,20170929,25680,25610,25790,26145,25505,26070,25865,460,255,367686,"4,755,359.70",210338
,20171009,26070,25865,26495,26935,26310,26735,26675,870,810,190782,"2,544,920.65",196460
,20171010,26735,26675,26720,26790,26120,26240,26510,-435,-165,226206,"2,998,796.95",179088
,20171011,26240,26510,26290,26680,26165,26450,26440,-60,-70,146158,"1,932,346.54",162732
,20171012,26450,26440,26365,26515,25930,26415,26170,-25,-270,128490,"1,681,359.17",151966
,20171013,26415,26170,26435,26740,26310,26565,26490,395,320,75574,"1,001,036.22",141558
,20171016,26565,26490,26580,26695,26060,26480,26365,-10,-125,98690,"1,301,167.16",132878
,20171017,26480,26365,26405,26595,25810,25925,26115,-440,-250,73698,"962,416.89",111790
,20171018,25925,26115,25695,25840,25230,25665,25560,-450,-555,62268,"795,848.04",92338
,20171019,25665,25560,25800,25965,25555,25565,25720,5,160,34280,"440,925.95",88878
,20171020,25565,25720,25525,25985,25455,25855,25775,135,55,27946,"360,200.86",82330
,20171023,25855,25775,25880,25905,25415,25785,25745,10,-30,32304,"415,881.69",79830
,20171024,25785,25745,25790,26200,25750,26095,26060,350,315,30050,"391,605.50",74070
,20171025,26095,26060,26130,26250,25860,25980,26050,-80,-10,22726,"296,026.52",70432
,20171026,25980,26050,26085,26455,26010,26290,26275,240,225,27276,"358,381.18",66274
,20171027,26290,26275,26325,26375,25850,25915,26075,-360,-200,25828,"336,785.04",58676
,20171030,25915,26075,25520,26565,25520,26130,25995,55,-80,22040,"286,515.60",49132
,20171031,26130,25995,26180,26440,26000,26415,26205,420,210,16176,"211,979.89",42456
,20171101,26415,26205,26360,26995,26300,26440,26690,235,485,14826,"197,869.04",40560
,20171102,26440,26690,26495,26530,26235,26300,26355,-390,-335,7560,"99,635.90",38100
,20171103,26300,26355,26285,26470,26155,26295,26335,-60,-20,6610,"87,037.58",35670
,20171106,26295,26335,26220,26355,26085,26300,26245,-35,-90,6380,"83,723.03",32830
,20171107,26300,26245,26370,26370,25920,26015,26115,-230,-130,10020,"130,841.05",27590
,20171108,26015,26115,26015,26015,25680,25785,25815,-330,-300,7900,"101,969.25",23220
,20171109,25785,25815,25840,25995,25740,25920,25885,105,70,8860,"114,674.70",19920
,20171110,25920,25885,25960,26140,25860,26005,26035,120,150,5850,"76,163.40",15390
,20171113,26005,26035,26200,26260,26045,26190,26185,155,150,5330,"69,788.28",11510
,20171114,26190,26185,26075,26210,25990,25990,26115,-195,-70,2600,"33,951.03",9340
,20171115,25990,26115,26090,26090,25210,25300,25475,-815,-640,3190,"40,633.48",7020
zn1712,20170103,21040,21040,21045,21285,21045,21285,21125,245,85,6,63.38,40
,20170104,21285,21125,21190,21300,21000,21175,21180,50,55,12,127.10,46
,20170105,21175,21180,21575,21580,21400,21400,21440,220,260,62,664.75,94
,20170106,21400,21440,21375,21465,21260,21260,21365,-180,-75,6,64.10,94
,20170109,21260,21365,21140,21715,21135,21715,21470,350,105,22,236.18,102
,20170110,21715,21470,21865,22575,21865,22575,22235,1105,765,36,400.29,118
,20170111,22575,22235,22680,22680,22300,22310,22450,75,215,18,202.06,116
,20170112,22310,22450,22360,22370,22255,22365,22315,-85,-135,14,156.23,120
,20170113,22365,22315,22435,22450,22250,22250,22305,-65,-10,14,156.14,124
,20170116,22250,22305,22300,22910,22285,22735,22480,430,175,106,"1,191.50",94
,20170117,22735,22480,22665,22665,21825,21960,22320,-520,-160,34,379.44,76
,20170118,21960,22320,22105,22400,22055,22345,22320,25,0,98,"1,093.74",108
,20170119,22345,22320,22330,22330,22225,22245,22260,-75,-60,24,267.14,114
,20170120,22245,22260,22240,22505,21865,21865,22305,-395,45,42,468.45,124
,20170123,21865,22305,22070,22735,22005,22635,22235,330,-70,148,"1,645.47",202
,20170124,22635,22235,22605,22605,22420,22420,22505,185,270,8,90.03,200
,20170125,22420,22505,22735,22835,22625,22625,22730,120,225,6,68.20,202
,20170126,22625,22730,22540,22795,22540,22795,22650,65,-80,24,271.81,200
,20170203,22795,22650,22660,22660,22325,22325,22450,-325,-200,26,291.91,204
,20170206,22325,22450,22365,22625,22195,22210,22400,-240,-50,78,873.60,206
,20170207,22210,22400,22245,22570,22245,22540,22445,140,45,110,"1,234.54",256
,20170208,22540,22445,22440,22910,22440,22675,22670,230,225,30,340.11,266
,20170209,22675,22670,22885,23040,22860,22950,22940,280,270,38,435.89,270
,20170210,22950,22940,23035,23710,22990,23455,23315,515,375,106,"1,235.93",250
,20170213,23455,23315,23455,24270,23455,23950,24015,635,700,72,864.70,246
,20170214,23950,24015,23960,24215,23785,23990,24130,-25,115,278,"3,354.27",396
,20170215,23990,24130,23940,23975,23460,23750,23750,-380,-380,34,403.79,406
,20170216,23750,23750,23540,23670,23225,23225,23610,-525,-140,54,637.58,376
,20170217,23225,23610,23285,23415,23155,23200,23300,-410,-310,26,302.94,372
,20170220,23200,23300,23135,23140,22775,22845,22935,-455,-365,128,"1,468.08",352
,20170221,22845,22935,23340,23580,23255,23580,23370,645,435,50,584.25,352
,20170222,23580,23370,23370,23465,23020,23020,23280,-350,-90,18,209.52,350
,20170223,23020,23280,23190,23330,22900,22900,23220,-380,-60,18,209.00,354
,20170224,22900,23220,23145,23150,22685,22685,22910,-535,-310,12,137.48,356
,20170227,22685,22910,22940,23080,22880,22880,22965,-30,55,24,275.60,368
,20170228,22880,22965,22890,22930,22875,22875,22905,-90,-60,8,91.63,368
,20170301,22875,22905,22990,23330,22980,23260,23105,355,200,36,415.92,378
,20170302,23260,23105,23435,23435,23285,23290,23365,185,260,24,280.39,378
,20170303,23290,23365,22955,22995,22685,22685,22880,-680,-485,20,228.80,374
,20170306,22685,22880,22965,22965,22575,22575,22745,-305,-135,44,500.43,376
,20170307,22575,22745,22390,22500,22260,22285,22360,-460,-385,38,424.89,380
,20170308,22285,22360,22245,22265,21925,21930,22035,-430,-325,188,"2,071.57",280
,20170309,21930,22035,22020,22055,21620,21670,21940,-365,-95,116,"1,272.53",276
,20170310,21670,21940,21745,22005,21745,22000,21915,60,-25,12,131.50,278
,20170313,22000,21915,22165,22480,22030,22480,22260,565,345,78,868.25,312
,20170314,22480,22260,22550,22550,22340,22510,22460,250,200,14,157.22,314
,20170315,22510,22460,22335,22720,22200,22585,22595,125,135,82,926.52,348
,20170316,22585,22595,22810,23220,22790,23160,23105,565,510,102,"1,178.40",362
,20170317,23160,23105,23225,23395,23140,23210,23225,105,120,40,464.51,362
,20170320,23210,23225,23345,23710,23345,23600,23590,375,365,42,495.44,372
,20170321,23600,23590,23660,23680,23285,23285,23460,-305,-130,76,891.49,372
,20170322,23285,23460,23470,23550,22935,23000,23325,-460,-135,32,373.22,368
,20170323,23000,23325,23180,23330,23115,23305,23295,-20,-30,72,838.68,406
,20170324,23305,23295,22960,23160,22960,23100,23060,-195,-235,8,92.26,406
,20170327,23100,23060,22895,23145,22575,22575,22720,-485,-340,68,772.63,416
,20170328,22575,22720,22370,22620,22170,22540,22425,-180,-295,36,403.68,414
,20170329,22540,22425,22395,23205,22395,23205,22800,780,375,32,364.81,416
,20170330,23205,22800,23175,23425,23130,23295,23245,495,445,190,"2,208.58",472
,20170331,23295,23245,23395,23575,23010,23150,23250,-95,5,246,"2,859.89",518
,20170405,23150,23250,22780,23065,22780,22940,22900,-310,-350,38,435.13,498
,20170406,22940,22900,23115,23145,22775,23000,22970,100,70,32,367.54,496
,20170407,23000,22970,22725,22800,22050,22120,22520,-850,-450,118,"1,328.69",500
,20170410,22120,22520,21915,22200,21850,22090,22050,-430,-470,48,529.24,474
,20170411,22090,22050,22110,22110,21240,21275,21610,-775,-440,30,324.18,470
,20170412,21275,21610,21355,21355,20970,21260,21185,-350,-425,62,656.82,466
,20170413,21260,21185,21155,21530,21085,21530,21305,345,120,60,639.24,456
,20170414,21530,21305,21515,21570,21300,21325,21445,20,140,44,471.87,456
,20170417,21325,21445,21695,21915,21610,21800,21760,355,315,34,369.97,460
,20170418,21800,21760,21525,21525,21255,21255,21335,-505,-425,12,128.02,460
,20170419,21255,21335,20820,20820,20540,20675,20705,-660,-630,24,248.51,454
,20170420,20675,20705,20825,21295,20635,21295,20860,590,155,78,813.67,478
,20170421,21295,20860,21390,21605,21280,21590,21425,730,565,70,749.93,496
,20170424,21590,21425,21250,21305,21010,21105,21175,-320,-250,70,741.19,510
,20170425,21105,21175,21185,21185,20990,21135,21065,-40,-110,40,421.38,512
,20170426,21135,21065,21005,21210,21005,21210,21085,145,20,46,485.06,518
,20170427,21210,21085,21210,21380,21140,21380,21260,295,175,74,786.64,508
,20170428,21380,21260,21285,21355,20945,21275,21175,15,-85,88,931.73,550
,20170502,21275,21175,21565,21740,21410,21540,21530,365,355,82,882.84,548
,20170503,21540,21530,21550,21565,21170,21250,21285,-280,-245,28,298.05,552
,20170504,21250,21285,21000,21035,20615,20925,20915,-360,-370,50,522.96,538
,20170505,20925,20915,20820,21015,20805,20895,20885,-20,-30,16,167.10,534
,20170508,20895,20885,20825,20880,20570,20780,20630,-105,-255,202,"2,083.86",530
,20170509,20780,20630,20805,21125,20610,21125,20805,495,175,48,499.40,518
,20170510,21125,20805,21165,21240,20970,21095,21125,290,320,56,591.51,504
,20170511,21095,21125,21075,21315,20890,21205,21190,80,65,250,"2,649.04",578
,20170512,21205,21190,21260,21260,20730,20800,20825,-390,-365,34,354.04,582
,20170515,20800,20825,20800,20915,20770,20770,20830,-55,5,14,145.82,584
,20170516,20770,20830,20980,20980,20430,20515,20780,-315,-50,120,"1,246.84",610
,20170517,20515,20780,20510,21055,20510,20750,20710,-30,-70,46,476.36,612
,20170518,20750,20710,20795,20815,20590,20760,20720,50,10,102,"1,056.75",584
,20170519,20760,20720,20160,20885,20160,20755,20650,35,-70,74,764.11,576
,20170522,20755,20650,21210,21520,21135,21370,21285,720,635,78,830.13,580
,20170523,21370,21285,21365,21555,21365,21390,21455,105,170,28,300.43,562
,20170524,21390,21455,21425,21440,21085,21360,21350,-95,-105,264,"2,818.65",556
,20170525,21360,21350,21435,21435,21220,21330,21335,-20,-15,130,"1,386.83",596
,20170526,21330,21335,21335,21545,21310,21545,21405,210,70,120,"1,284.44",636
,20170531,21545,21405,21735,21735,21245,21245,21395,-160,-10,66,706.14,630
,20170601,21245,21395,21220,21220,20770,20805,20900,-590,-495,690,"7,210.51",770
,20170602,20805,20900,20800,20885,20735,20785,20790,-115,-110,194,"2,017.00",824
,20170605,20785,20790,20650,20760,20435,20535,20575,-255,-215,466,"4,794.17",912
,20170606,20535,20575,20360,20490,20300,20315,20360,-260,-215,292,"2,973.21",1082
,20170607,20315,20360,20260,20435,19980,20035,20200,-325,-160,108,"1,090.82",1096
,20170608,20035,20200,20075,20280,19870,20240,19970,40,-230,1310,"13,080.88",1774
,20170609,20240,19970,20215,20320,20115,20290,20205,320,235,292,"2,950.63",1778
,20170612,20290,20205,20440,20720,20370,20720,20490,515,285,1896,"19,427.50",2634
,20170613,20720,20490,20605,20870,20175,20235,20610,-255,120,1804,"18,593.73",3428
,20170614,20235,20610,20330,20600,20195,20530,20485,-80,-125,494,"5,059.96",3366
,20170615,20530,20485,20485,20695,20395,20665,20490,180,5,312,"3,196.67",3414
,20170616,20665,20490,20500,20920,20500,20700,20765,210,275,136,"1,412.34",3404
,20170619,20700,20765,20690,20820,20510,20710,20705,-55,-60,708,"7,331.30",3830
,20170620,20710,20705,20875,20925,20785,20905,20850,200,145,1982,"20,666.56",5070
,20170621,20905,20850,20925,20950,20710,20930,20865,80,15,932,"9,724.50",5212
,20170622,20930,20865,21175,21530,21175,21400,21405,535,540,2228,"23,849.87",6200
,20170623,21400,21405,21785,21965,21630,21940,21725,535,320,2012,"21,856.51",7304
,20170626,21940,21725,21890,21890,21690,21890,21810,165,85,1404,"15,310.87",7510
,20170627,21890,21810,21880,22235,21775,22235,22010,425,200,548,"6,030.89",7590
,20170628,22235,22010,22210,22310,22050,22240,22175,230,165,370,"4,102.75",7660
,20170629,22240,22175,22160,22330,21980,22280,22185,105,10,1234,"13,690.93",7622
,20170630,22280,22185,22185,22290,21940,22270,22085,85,-100,1474,"16,277.73",8044
,20170703,22270,22085,22215,22560,22100,22535,22210,450,125,4720,"52,425.75",8758
,20170704,22535,22210,22485,22610,22270,22400,22430,190,220,1420,"15,928.10",9434
,20170705,22400,22430,22365,22650,22365,22430,22540,0,110,1156,"13,030.41",9526
,20170706,22430,22540,22360,22475,22190,22475,22350,-65,-190,506,"5,654.98",9730
,20170707,22475,22350,22470,22660,22400,22620,22540,270,190,630,"7,101.38",9882
,20170710,22620,22540,22560,22750,22340,22380,22530,-160,-10,1802,"20,302.45",11208
,20170711,22380,22530,22405,22775,22235,22690,22580,160,50,2254,"25,450.65",10376
,20170712,22690,22580,22630,23000,22630,23000,22910,420,330,4848,"55,535.23",12280
,20170713,23000,22910,23000,23110,22850,23105,23035,195,125,3502,"40,337.77",13306
,20170714,23105,23035,23020,23065,22600,22710,22865,-325,-170,4836,"55,295.49",12986
,20170717,22710,22865,22680,23200,22635,23155,22955,290,90,4402,"50,525.37",13406
,20170718,23155,22955,23155,23155,22680,22775,22955,-180,0,3556,"40,818.11",13152
,20170719,22775,22955,22720,22795,22600,22755,22690,-200,-265,2092,"23,734.29",13496
,20170720,22755,22690,22635,22660,22335,22455,22435,-235,-255,4988,"55,957.96",14796
,20170721,22455,22435,22475,22580,22260,22515,22485,80,50,3262,"36,673.51",15264
,20170724,22515,22485,22595,22865,22415,22725,22655,240,170,2732,"30,951.67",15564
,20170725,22725,22655,22715,23015,22655,22950,22840,295,185,1614,"18,434.20",15550
,20170726,22950,22840,23065,23240,22890,22920,23105,80,265,6946,"80,245.62",17166
,20170727,22920,23105,22885,23065,22855,23015,22970,-90,-135,4402,"50,561.82",17138
,20170728,23015,22970,22980,23105,22645,22770,22840,-200,-130,6650,"75,959.10",17724
,20170731,22770,22840,22770,23120,22680,23095,22895,255,55,6332,"72,494.54",18462
,20170801,23095,22895,23085,23085,22640,22640,22845,-255,-50,4820,"55,064.17",18702
,20170802,22640,22845,22680,22855,22510,22660,22650,-185,-195,13288,"150,503.38",18240
,20170803,22660,22650,22630,23225,22630,22970,23015,320,365,13284,"152,895.32",20140
,20170804,22970,23015,22995,23320,22825,23195,23070,180,55,11506,"132,745.60",21074
,20170807,23195,23070,23195,23375,22955,23255,23165,185,95,17384,"201,354.49",22190
,20170808,23255,23165,23310,23895,23285,23655,23705,490,540,22564,"267,443.13",24408
,20170809,23655,23705,23650,24580,23550,24550,24155,845,450,37430,"452,065.71",33084
,20170810,24550,24155,24450,24590,24040,24065,24305,-90,150,24572,"298,618.75",36940
,20170811,24065,24305,24040,24180,23555,23625,23885,-680,-420,26440,"315,825.76",37786
,20170814,23625,23885,23775,23920,23570,23715,23775,-170,-110,17820,"211,876.73",37748
,20170815,23715,23775,23720,24085,23620,23920,23910,145,135,19106,"228,416.83",37420
,20170816,23920,23910,23955,24430,23880,24380,24190,470,280,30028,"363,216.36",41476
,20170817,24380,24190,24660,25640,24615,25640,25340,1450,1150,42800,"542,356.08",47926
,20170818,25640,25340,25450,25855,25190,25665,25520,325,180,60628,"773,695.01",48458
,20170821,25665,25520,25895,26210,25330,25890,25820,370,300,35354,"456,432.79",48466
,20170822,25890,25820,25770,26045,25565,25875,25790,55,-30,33792,"435,819.92",48836
,20170823,25875,25790,25950,25950,25260,25580,25540,-210,-250,39804,"508,297.66",49442
,20170824,25580,25540,25450,25895,25450,25545,25625,5,85,40316,"516,605.37",50750
,20170825,25545,25625,25485,25915,25450,25820,25710,195,85,43162,"554,937.89",53298
,20170828,25820,25710,25795,25880,24965,25510,25320,-200,-390,50986,"645,545.95",56452
,20170829,25510,25320,25560,25680,25205,25410,25435,90,115,49202,"625,826.10",53522
,20170830,25410,25435,25515,25800,25170,25725,25505,290,70,59266,"755,862.48",59152
,20170831,25725,25505,25610,25610,25300,25440,25430,-65,-75,47688,"606,361.36",59062
,20170901,25440,25430,25600,25915,25490,25835,25730,405,300,63284,"814,169.91",60786
,20170904,25835,25730,25735,26245,25675,25900,26005,170,275,67704,"880,370.00",63756
,20170905,25900,26005,25955,26095,25800,25965,25965,-40,-40,47718,"619,516.38",65924
,20170906,25965,25965,25935,25970,24720,24905,25275,-1060,-690,96422,"1,218,651.72",66266
,20170907,24905,25275,24930,25170,24660,24715,24930,-560,-345,66400,"827,704.48",67704
,20170908,24715,24930,24910,25045,24225,24400,24715,-530,-215,93256,"1,152,625.52",70846
,20170911,24400,24715,24400,24835,24050,24750,24430,35,-285,91298,"1,115,422.44",72688
,20170912,24750,24430,24850,25070,24595,25035,24860,605,430,90654,"1,126,843.86",80844
,20170913,25035,24860,24825,25010,24545,24705,24820,-155,-40,81624,"1,013,099.56",85914
,20170914,24705,24820,24650,24740,24355,24475,24570,-345,-250,101982,"1,252,895.78",88120
,20170915,24475,24570,24475,24885,24370,24435,24590,-135,20,115644,"1,421,852.16",91380
,20170918,24435,24590,24525,25130,24105,25005,24720,415,130,151796,"1,876,246.70",103870
,20170919,25005,24720,25060,25480,24920,25220,25245,500,525,108024,"1,363,538.71",109290
,20170920,25220,25245,25200,25590,24930,25440,25260,195,15,135630,"1,713,121.52",117080
,20170921,25440,25260,25560,25655,24875,25055,25250,-205,-10,143402,"1,810,466.93",119676
,20170922,25055,25250,25050,25380,24270,24525,24800,-725,-450,215942,"2,677,825.95",124884
,20170925,24525,24800,24835,25150,24210,25010,24815,210,15,227850,"2,827,100.42",134942
,20170926,25010,24815,25075,25550,24950,25410,25300,595,485,199984,"2,529,956.92",147058
,20170927,25410,25300,25285,25750,25185,25680,25420,380,120,200916,"2,553,748.95",154256
,20170928,25680,25420,25640,25670,25155,25485,25390,65,-30,218020,"2,768,090.89",164334
,20170929,25485,25390,25580,25885,25265,25845,25615,455,225,235422,"3,015,534.59",173682
,20171009,25845,25615,26210,26700,26095,26440,26420,825,805,192094,"2,537,949.10",188024
,20171010,26440,26420,26425,26480,25775,25885,26180,-535,-240,398706,"5,220,056.35",209748
,20171011,25885,26180,25970,26390,25825,26135,26135,-45,-45,525512,"6,867,301.88",223210
,20171012,26135,26135,26045,26180,25585,26070,25825,-65,-310,674094,"8,705,197.97",231154
,20171013,26070,25825,26120,26490,25980,26275,26180,450,355,543958,"7,120,898.47",237706
,20171016,26275,26180,26280,26420,25710,26285,26075,105,-105,819358,"10,684,302.48",247768
,20171017,26285,26075,26250,26385,25420,25560,25855,-515,-220,757970,"9,798,819.47",227840
,20171018,25560,25855,25340,25445,24830,25295,25155,-560,-700,470816,"5,922,563.13",273550
,20171019,25295,25155,25435,25650,25190,25195,25390,40,235,377908,"4,797,662.29",263276
,20171020,25195,25390,25205,25675,25090,25505,25390,115,0,318226,"4,040,590.58",259644
,20171023,25505,25390,25495,25580,25050,25430,25360,40,-30,317090,"4,021,392.68",252418
,20171024,25430,25360,25460,25875,25400,25745,25660,385,300,242750,"3,114,627.41",249932
,20171025,25745,25660,25845,25870,25500,25615,25690,-45,30,214726,"2,758,521.79",246074
,20171026,25615,25690,25785,26150,25660,26005,25915,315,225,254078,"3,292,703.34",246944
,20171027,26005,25915,26095,26095,25500,25570,25815,-345,-100,258102,"3,331,504.37",226364
,20171030,25570,25815,25410,25860,25380,25825,25635,10,-180,221746,"2,842,448.30",224100
,20171031,25825,25635,25835,26200,25705,26135,25920,500,285,203036,"2,631,402.78",211424
,20171101,26135,25920,26135,26825,25980,26155,26345,235,425,219446,"2,890,968.48",192950
,20171102,26155,26345,26170,26285,25950,26000,26100,-345,-245,123130,"1,606,940.85",180576
,20171103,26000,26100,25950,26240,25840,26025,26050,-75,-50,116040,"1,511,620.83",173268
,20171106,26025,26050,25930,26120,25780,26060,25945,10,-105,90372,"1,172,475.66",154456
,20171107,26060,25945,26085,26175,25680,25745,25900,-200,-45,75956,"983,671.53",145908
,20171108,25745,25900,25715,25780,25360,25500,25530,-400,-370,86698,"1,106,889.46",136116
,20171109,25500,25530,25620,25735,25380,25635,25590,105,60,63562,"813,390.90",129436
,20171110,25635,25590,25615,25830,25525,25760,25690,170,100,45562,"585,315.30",125356
,20171113,25760,25690,25885,26015,25805,25920,25905,230,215,41130,"532,742.74",122846
,20171114,25920,25905,25850,26025,25740,25835,25870,-70,-35,32242,"417,090.80",121286
,20171115,25835,25870,25785,25850,25060,25130,25295,-740,-575,73716,"932,417.84",115696
,20171116,25130,25295,25220,25290,25015,25135,25160,-160,-135,33334,"419,410.47",105286
,20171117,25135,25160,25210,25340,24880,25225,25175,65,15,33498,"421,680.02",99078
,20171120,25225,25175,25225,25525,25160,25260,25310,85,135,21726,"274,945.06",94074
,20171121,25260,25310,25340,25435,24955,25230,25220,-80,-90,32196,"406,049.62",89038
,20171122,25230,25220,25245,25905,25245,25725,25670,505,450,29368,"376,972.86",82426
,20171123,25725,25670,25725,25810,25590,25620,25695,-50,25,19364,"248,823.83",77484
,20171124,25620,25695,25745,25745,25500,25645,25590,-50,-105,19372,"247,866.73",72900
,20171127,25645,25590,25650,25670,25090,25130,25385,-460,-205,34392,"436,590.04",58302
,20171128,25130,25385,25195,25265,24880,25010,25070,-375,-315,29316,"367,491.12",45268
,20171129,25010,25070,25025,25135,24785,24940,25015,-130,-55,20050,"250,788.76",36994
,20171130,24940,25015,24885,25085,24720,25040,24910,25,-105,17420,"216,992.94",30256
,20171201,25040,24910,25040,25330,24935,25290,25155,380,245,7246,"91,144.57",28100
,20171204,25290,25155,25355,26050,25355,25680,25685,525,530,8960,"115,079.65",24040
,20171205,25680,25685,25665,25665,25300,25300,25500,-385,-185,6730,"85,815.90",20590
,20171206,25300,25500,25220,25295,24665,24860,24890,-640,-610,10330,"128,562.30",15520
,20171207,24860,24890,24905,25080,24650,24790,24900,-100,10,4660,"58,023.85",13090
,20171208,24790,24900,24845,24990,24530,24980,24775,80,-125,6600,"81,766.73",11520
,20171211,24980,24775,24980,25200,24820,24895,25005,120,230,5420,"67,771.65",9010
,20171212,24895,25005,24965,25325,24905,25190,25175,185,170,5120,"64,451.65",6960
,20171213,25190,25175,25450,25460,25320,25460,25355,285,180,1990,"25,233.03",5160
,20171214,25460,25355,25480,25530,25310,25330,25440,-25,85,1440,"18,317.73",3910
,20171215,25330,25440,25490,25650,25455,25600,25525,160,85,780,"9,956.55",3350
zn1801,20170117,22480,22480,21695,22545,21695,22180,22205,-300,-275,12,133.24,0
,20170118,22180,22205,22400,22400,22310,22310,22355,105,150,10,111.79,6
,20170119,22310,22355,22350,22350,22350,22350,22350,-5,-5,2,22.35,6
,20170120,22350,22350,22500,22500,22500,22500,22500,150,150,2,22.50,6
,20170123,22500,22500,22090,22750,22090,22690,22460,190,-40,46,516.62,36
,20170124,22690,22460,22615,22615,22415,22515,22485,55,25,18,202.37,48
,20170125,22515,22485,22635,22730,22515,22515,22615,30,130,34,384.46,52
,20170126,22515,22615,,,,22615,22615,0,0,0,0.00,52
,20170203,22615,22615,22805,22850,22305,22380,22480,-235,-135,38,427.17,46
,20170206,22380,22480,22390,22455,22190,22190,22350,-290,-130,20,223.52,52
,20170207,22190,22350,22215,22570,22215,22570,22385,220,35,182,"2,037.06",120
,20170208,22570,22385,22630,22915,22630,22915,22720,530,335,12,136.34,124
,20170209,22915,22720,22910,22955,22805,22855,22900,135,180,20,229.02,130
,20170210,22855,22900,23070,23590,22920,23385,23315,485,415,158,"1,842.24",144
,20170213,23385,23315,23505,24170,23505,23925,23890,610,575,102,"1,218.52",172
,20170214,23925,23890,23955,24005,23685,24005,23900,115,10,62,740.90,160
,20170215,24005,23900,23525,23760,23525,23680,23660,-220,-240,16,189.31,158
,20170216,23680,23660,23615,23720,23615,23615,23640,-45,-20,16,189.13,146
,20170217,23615,23640,23305,23375,23240,23250,23290,-390,-350,16,186.32,148
,20170220,23250,23290,23110,23110,22835,22985,22910,-305,-380,28,320.81,166
,20170221,22985,22910,23380,23560,23380,23485,23490,575,580,16,187.96,170
,20170222,23485,23490,23500,23500,22850,23080,23195,-410,-295,20,232.00,176
,20170223,23080,23195,23170,23400,22815,22815,23210,-380,15,40,464.22,180
,20170224,22815,23210,23055,23060,22495,22885,22795,-325,-415,64,729.51,208
,20170227,22885,22795,22900,23010,22800,22885,22940,90,145,36,412.99,212
,20170228,22885,22940,22795,23000,22795,22815,22855,-125,-85,8,91.44,212
,20170301,22815,22855,23020,23240,22805,23215,23115,360,260,126,"1,456.41",264
,20170302,23215,23115,23365,23410,23250,23250,23340,135,225,126,"1,470.51",306
,20170303,23250,23340,23160,23160,22605,22830,22850,-510,-490,52,594.11,292
,20170306,22830,22850,22690,22840,22500,22500,22645,-350,-205,58,656.80,304
,20170307,22500,22645,22390,22500,22290,22300,22395,-345,-250,126,"1,410.97",302
,20170308,22300,22395,22280,22285,21905,22060,22090,-335,-305,148,"1,634.93",260
,20170309,22060,22090,22080,22155,21585,21585,21860,-505,-230,112,"1,224.26",270
,20170310,21585,21860,21775,22030,21775,22010,21905,150,45,28,306.74,264
,20170313,22010,21905,22190,22620,22005,22520,22290,615,385,190,"2,117.83",246
,20170314,22520,22290,22715,22715,22355,22475,22540,185,250,22,247.95,246
,20170315,22475,22540,22345,22835,22110,22605,22385,65,-155,46,514.86,238
,20170316,22605,22385,22860,23220,22855,23220,23080,835,695,140,"1,615.87",264
,20170317,23220,23080,23210,23370,23090,23240,23220,160,140,82,952.14,278
,20170320,23240,23220,23325,23720,23325,23550,23590,330,370,84,990.84,290
,20170321,23550,23590,23600,23740,23285,23285,23480,-305,-110,48,563.63,284
,20170322,23285,23480,23455,23510,22965,22975,23125,-505,-355,88,"1,017.71",298
,20170323,22975,23125,23155,23400,22890,23265,23205,140,80,114,"1,322.72",328
,20170324,23265,23205,23040,23145,22890,23120,23005,-85,-200,66,759.31,320
,20170327,23120,23005,23040,23065,22650,22750,22880,-255,-125,80,915.35,314
,20170328,22750,22880,22455,22795,22250,22475,22460,-405,-420,50,561.52,310
,20170329,22475,22460,22580,23215,22390,23215,22805,755,345,52,592.96,328
,20170330,23215,22805,23200,23415,23155,23280,23280,475,475,64,745.03,342
,20170331,23280,23280,23170,23550,22965,23065,23220,-215,-60,120,"1,393.40",338
,20170405,23065,23220,23070,23075,22775,22940,22925,-280,-295,72,825.34,322
,20170406,22940,22925,23050,23115,22775,23000,22925,75,0,34,389.74,326
,20170407,23000,22925,22880,22880,22150,22150,22530,-775,-395,80,901.26,338
,20170410,22150,22530,21865,22265,21790,22040,21985,-490,-545,108,"1,187.35",354
,20170411,22040,21985,21710,22040,21270,21275,21575,-710,-410,60,647.29,352
,20170412,21275,21575,21475,21480,21010,21100,21200,-475,-375,134,"1,420.61",358
,20170413,21100,21200,21170,21780,20985,21760,21405,560,205,58,620.75,364
,20170414,21760,21405,21405,21605,21330,21330,21485,-75,80,18,193.37,364
,20170417,21330,21485,21595,22140,21595,21800,21805,315,320,60,654.18,380
,20170418,21800,21805,21505,21525,21200,21275,21285,-530,-520,28,298.00,372
,20170419,21275,21285,20810,20935,20535,20725,20735,-560,-550,122,"1,264.98",402
,20170420,20725,20735,20815,21280,19330,21280,20800,545,65,118,"1,227.48",408
,20170421,21280,20800,21360,21595,21305,21580,21425,780,625,42,449.98,400
,20170424,21580,21425,21320,21320,20865,21090,21125,-335,-300,120,"1,267.63",412
,20170425,21090,21125,21170,21195,20965,21010,21070,-115,-55,74,779.59,434
,20170426,21010,21070,20975,21275,20935,21275,21070,205,0,104,"1,095.80",448
,20170427,21275,21070,21120,21345,21105,21290,21240,220,170,324,"3,440.93",598
,20170428,21290,21240,21260,21305,20915,21280,21150,40,-90,202,"2,136.57",666
,20170502,21280,21150,21650,21700,21150,21350,21505,200,355,38,408.62,670
,20170503,21350,21505,21375,21535,21020,21110,21320,-395,-185,32,341.19,658
,20170504,21110,21320,20855,20905,20555,20740,20770,-580,-550,18,186.96,652
,20170505,20740,20770,20960,20960,20655,20700,20770,-70,0,80,830.95,650
,20170508,20700,20770,20750,20900,20400,20720,20660,-50,-110,56,578.61,660
,20170509,20720,20660,20555,20960,20500,20775,20665,115,5,80,826.77,658
,20170510,20775,20665,21220,21220,20855,21025,20980,360,315,68,713.34,666
,20170511,21025,20980,20835,21285,20805,21150,21050,170,70,378,"3,978.95",774
,20170512,21150,21050,21030,21030,20700,20805,20860,-245,-190,44,458.98,762
,20170515,20805,20860,20590,20835,20485,20735,20630,-125,-230,64,660.31,758
,20170516,20735,20630,20785,20785,20295,20410,20500,-220,-130,118,"1,209.51",760
,20170517,20410,20500,20475,20700,20475,20680,20645,180,145,40,412.99,766
,20170518,20680,20645,20570,20770,20420,20660,20590,15,-55,108,"1,112.01",780
,20170519,20660,20590,20075,20760,20040,20650,20520,60,-70,60,615.73,748
,20170522,20650,20520,20970,21500,20945,21255,21235,735,715,392,"4,162.35",908
,20170523,21255,21235,22490,22490,21185,21305,21560,70,325,74,797.76,928
,20170524,21305,21560,21360,21405,21060,21235,21260,-325,-300,132,"1,403.25",934
,20170525,21235,21260,21170,21315,21145,21220,21230,-40,-30,118,"1,252.61",930
,20170526,21220,21230,21225,21470,21220,21470,21350,240,120,82,875.48,932
,20170531,21470,21350,21435,21500,20900,21145,21280,-205,-70,346,"3,682.24",872
,20170601,21145,21280,21125,21170,20725,20815,20895,-465,-385,494,"5,162.02",958
,20170602,20815,20895,20835,20875,20695,20830,20780,-65,-115,58,602.66,958
,20170605,20830,20780,20625,20680,20425,20460,20510,-320,-270,448,"4,594.44",1214
,20170606,20460,20510,20330,20490,20230,20235,20345,-275,-165,122,"1,241.28",1226
,20170607,20235,20345,20190,20425,19970,20025,20170,-320,-175,184,"1,855.81",1284
,20170608,20025,20170,20100,20300,19860,20215,19940,45,-230,866,"8,634.03",1490
,20170609,20215,19940,20230,20265,20095,20120,20160,180,220,76,766.19,1496
,20170612,20120,20160,20460,20605,20340,20520,20425,360,265,184,"1,879.17",1488
,20170613,20520,20425,20560,20655,20140,20140,20450,-285,25,272,"2,781.40",1520
,20170614,20140,20450,20125,20610,20110,20480,20340,30,-110,126,"1,281.68",1542
,20170615,20480,20340,20475,20625,20250,20600,20510,260,170,178,"1,825.46",1558
,20170616,20600,20510,20490,20875,20490,20620,20705,110,195,100,"1,035.47",1564
,20170619,20620,20705,20635,20700,20500,20680,20605,-25,-100,34,350.35,1562
,20170620,20680,20605,20780,20895,20760,20885,20825,280,220,476,"4,956.72",1700
,20170621,20885,20825,20875,20900,20700,20890,20860,65,35,252,"2,628.95",1774
,20170622,20890,20860,21160,21480,21135,21420,21310,560,450,568,"6,053.21",1946
,20170623,21420,21310,21795,21945,21580,21945,21680,635,370,630,"6,830.15",2264
,20170626,21945,21680,22000,22000,21705,21880,21810,200,130,358,"3,904.46",2448
,20170627,21880,21810,21820,22205,21740,22200,21910,390,100,506,"5,544.00",2742
,20170628,22200,21910,22110,22280,22045,22195,22160,285,250,188,"2,083.49",2732
,20170629,22195,22160,22165,22285,21955,22225,22050,65,-110,492,"5,425.15",2806
,20170630,22225,22050,22180,22250,21915,22250,22065,200,15,126,"1,390.24",2826
,20170703,22250,22065,22190,22500,22045,22495,22235,430,170,736,"8,183.47",2900
,20170704,22495,22235,22420,22525,22205,22230,22305,-5,70,440,"4,907.67",3098
,20170705,22230,22305,22345,22590,22275,22335,22455,30,150,302,"3,391.19",3162
,20170706,22335,22455,22265,22385,22140,22350,22260,-105,-195,132,"1,469.45",3162
,20170707,22350,22260,22430,22525,22330,22525,22435,265,175,90,"1,009.62",3200
,20170710,22525,22435,22495,22690,22215,22285,22355,-150,-80,318,"3,554.47",3348
,20170711,22285,22355,22025,22680,22025,22650,22425,295,70,586,"6,571.44",3348
,20170712,22650,22425,22600,22940,22515,22865,22820,440,395,392,"4,472.90",3424
,20170713,22865,22820,22955,23005,22760,23000,22935,180,115,484,"5,550.49",3568
,20170714,23000,22935,22945,22955,22500,22630,22735,-305,-200,1266,"14,393.24",3268
,20170717,22630,22735,22585,23100,22520,23070,22965,335,230,2092,"24,024.55",3042
,20170718,23070,22965,23000,23070,22615,22680,22895,-285,-70,1136,"13,006.37",2668
,20170719,22680,22895,22590,22715,22530,22700,22625,-195,-270,648,"7,330.63",2584
,20170720,22700,22625,22525,22555,22285,22370,22420,-255,-205,518,"5,806.79",2564
,20170721,22370,22420,22450,22530,22230,22460,22390,40,-30,318,"3,560.61",2608
,20170724,22460,22390,22550,22780,22375,22635,22595,245,205,658,"7,434.31",2570
,20170725,22635,22595,22650,22930,22635,22905,22790,310,195,406,"4,626.88",2670
,20170726,22905,22790,22915,23150,22825,22840,23010,50,220,744,"8,560.28",2756
,20170727,22840,23010,22840,22960,22800,22915,22875,-95,-135,330,"3,775.00",2730
,20170728,22915,22875,22885,23015,22650,22735,22795,-140,-80,500,"5,699.95",2726
,20170731,22735,22795,22730,23200,22615,22980,22775,185,-20,872,"9,930.87",3202
,20170801,22980,22775,22910,22910,22515,22515,22740,-260,-35,848,"9,643.63",3166
,20170802,22515,22740,22525,22740,22410,22550,22555,-190,-185,1014,"11,435.81",3366
,20170803,22550,22555,22540,23085,22525,22870,22870,315,315,974,"11,140.12",3606
,20170804,22870,22870,22895,23195,22725,23100,23050,230,180,1366,"15,743.71",4184
,20170807,23100,23050,23025,23285,22875,23180,23060,130,10,1892,"21,816.94",3944
,20170808,23180,23060,23290,23790,23215,23555,23580,495,520,3044,"35,893.86",4640
,20170809,23555,23580,23565,24450,23520,24390,24055,810,475,4630,"55,694.05",6086
,20170810,24390,24055,24375,24490,23945,23980,24185,-75,130,3096,"37,443.75",5972
,20170811,23980,24185,23905,24060,23435,23520,23775,-665,-410,4698,"55,854.96",6398
,20170814,23520,23775,23625,23800,23460,23580,23665,-195,-110,2912,"34,458.25",6348
,20170815,23580,23665,23580,23950,23510,23820,23785,155,120,3442,"40,938.07",7278
,20170816,23820,23785,23945,24285,23745,24275,24085,490,300,6012,"72,401.75",8672
,20170817,24275,24085,24360,25530,24360,25530,25320,1445,1235,18754,"237,435.91",12494
,20170818,25530,25320,25360,25645,25000,25490,25345,170,25,18948,"240,124.77",12092
,20170821,25490,25345,25590,25930,25130,25670,25595,325,250,18486,"236,577.83",13846
,20170822,25670,25595,25600,25845,25365,25630,25570,35,-25,12292,"157,157.17",13782
,20170823,25630,25570,25730,25730,25115,25420,25365,-150,-205,13762,"174,545.15",14746
,20170824,25420,25365,25295,25700,25230,25355,25420,-10,55,11514,"146,369.77",15910
,20170825,25355,25420,25355,25700,25265,25625,25510,205,90,14484,"184,746.24",16476
,20170828,25625,25510,25590,25680,24815,25360,25135,-150,-375,15492,"194,703.71",16968
,20170829,25360,25135,25340,25550,25060,25285,25300,150,165,11738,"148,491.37",16702
,20170830,25285,25300,25390,25655,25045,25590,25365,290,65,17332,"219,832.90",20642
,20170831,25590,25365,25470,25470,25170,25330,25295,-35,-70,12748,"161,255.69",20858
,20170901,25330,25295,25410,25785,25375,25725,25605,430,310,15122,"193,605.96",22528
,20170904,25725,25605,25665,26160,25575,25845,25905,240,300,20524,"265,875.23",24906
,20170905,25845,25905,25905,26000,25785,25875,25890,-30,-15,13912,"180,119.62",25310
,20170906,25875,25890,25835,25885,24655,24815,25210,-1075,-680,26972,"340,015.99",27986
,20170907,24815,25210,24835,25080,24565,24630,24835,-580,-375,18716,"232,429.78",27994
,20170908,24630,24835,24785,24950,24000,24310,24655,-525,-180,23426,"288,799.23",28120
,20170911,24310,24655,24325,24720,23950,24650,24310,-5,-345,21138,"256,944.16",27206
,20170912,24650,24310,24560,24960,24500,24940,24740,630,430,19100,"236,301.16",26432
,20170913,24940,24740,24730,24920,24450,24630,24720,-110,-20,16954,"209,553.93",27364
,20170914,24630,24720,24600,24620,24250,24360,24470,-360,-250,19320,"236,408.17",29946
,20170915,24360,24470,24330,24745,24250,24305,24475,-165,5,21108,"258,323.59",32084
,20170918,24305,24475,24355,24960,23980,24895,24565,420,90,35326,"433,931.25",35334
,20170919,24895,24565,24930,25320,24775,25040,25090,475,525,28538,"358,054.01",38140
,20170920,25040,25090,25050,25415,24760,25295,25085,205,-5,32236,"404,369.96",37278
,20170921,25295,25085,25385,25490,24725,24900,25085,-185,0,32446,"407,016.39",37988
,20170922,24900,25085,24900,25215,24105,24360,24625,-725,-460,49394,"608,231.26",38646
,20170925,24360,24625,24570,24990,24050,24860,24650,235,25,55870,"688,634.47",43668
,20170926,24860,24650,24910,25400,24785,25270,25145,620,495,51402,"646,313.06",48258
,20170927,25270,25145,25150,25580,25030,25520,25260,375,115,58598,"740,175.96",55550
,20170928,25520,25260,25520,25520,25000,25300,25230,40,-30,49094,"619,388.72",56772
,20170929,25300,25230,25355,25685,25080,25680,25450,450,220,59174,"753,111.85",58780
,20171009,25680,25450,26000,26535,25915,26250,26245,800,795,47016,"617,061.32",63352
,20171010,26250,26245,26245,26260,25540,25630,25965,-615,-280,70778,"918,895.78",69550
,20171011,25630,25965,25700,26180,25575,25905,25880,-60,-85,76904,"995,270.85",76204
,20171012,25905,25880,25800,25920,25350,25820,25585,-60,-295,103900,"1,329,240.55",78576
,20171013,25820,25585,25890,26160,25760,26045,25945,460,360,80990,"1,050,832.49",80932
,20171016,26045,25945,26055,26175,25525,26060,25865,115,-80,141012,"1,823,663.97",83262
,20171017,26060,25865,26060,26165,25180,25285,25625,-580,-240,136462,"1,748,759.14",84058
,20171018,25285,25625,25095,25200,24600,25005,24910,-620,-715,187938,"2,341,090.52",91802
,20171019,25005,24910,25150,25380,24940,24940,25125,30,215,207106,"2,602,120.89",93240
,20171020,24940,25125,24940,25410,24835,25260,25150,135,25,204912,"2,577,196.18",90514
,20171023,25260,25150,25220,25325,24815,25165,25130,15,-20,229376,"2,882,496.30",97116
,20171024,25165,25130,25185,25640,25150,25495,25420,365,290,214430,"2,725,466.40",102680
,20171025,25495,25420,25620,25630,25290,25425,25470,5,50,201416,"2,565,218.20",110238
,20171026,25425,25470,25585,25965,25465,25810,25720,340,250,246428,"3,169,653.44",127702
,20171027,25810,25720,25885,25910,25355,25420,25665,-300,-55,292486,"3,753,823.72",139236
,20171030,25420,25665,25250,25720,25245,25650,25510,-15,-155,340682,"4,345,658.36",172018
,20171031,25650,25510,25625,26050,25505,25970,25755,460,245,377650,"4,863,939.20",183974
,20171101,25970,25755,25980,26665,25820,25990,26180,235,425,547096,"7,161,763.15",197068
,20171102,25990,26180,26055,26125,25785,25845,25950,-335,-230,454672,"5,900,164.32",201444
,20171103,25845,25950,25805,26120,25710,25935,25920,-15,-30,520576,"6,747,834.12",218332
,20171106,25935,25920,25835,26055,25655,25995,25835,75,-85,501614,"6,480,685.88",224382
,20171107,25995,25835,26045,26110,25625,25705,25850,-130,15,474850,"6,138,151.20",234470
,20171108,25705,25850,25665,25740,25285,25385,25475,-465,-375,561540,"7,152,827.90",238182
,20171109,25385,25475,25495,25620,25230,25495,25470,20,-5,524082,"6,674,576.77",243454
,20171110,25495,25470,25450,25710,25380,25605,25540,135,70,422720,"5,398,441.47",241002
,20171113,25605,25540,25790,25920,25665,25820,25770,280,230,414594,"5,343,029.86",244174
,20171114,25820,25770,25700,25950,25640,25760,25790,-10,20,376174,"4,850,778.65",235748
,20171115,25760,25790,25630,25780,24900,25010,25220,-780,-570,739972,"9,332,452.51",266026
,20171116,25010,25220,25100,25180,24880,25025,25045,-195,-175,463388,"5,803,003.88",262564
,20171117,25025,25045,25180,25245,24750,25115,25050,70,5,515504,"6,457,230.65",262992
,20171120,25115,25050,25140,25440,25045,25165,25225,115,175,450826,"5,686,065.65",252564
,20171121,25165,25225,25200,25350,24830,25160,25100,-65,-125,581244,"7,295,643.19",262366
,20171122,25160,25100,25275,25845,25195,25680,25535,580,435,540856,"6,905,958.97",235680
,20171123,25680,25535,25680,25755,25530,25550,25660,15,125,365552,"4,690,349.55",229328
,20171124,25550,25660,25625,25685,25410,25585,25545,-75,-115,358284,"4,576,575.13",214312
,20171127,25585,25545,25610,25620,24985,25020,25335,-525,-210,449062,"5,689,498.97",219180
,20171128,25020,25335,25055,25150,24720,24870,24960,-465,-375,503008,"6,277,945.40",214632
,20171129,24870,24960,24905,25035,24670,24810,24860,-150,-100,475484,"5,910,885.13",210434
,20171130,24810,24860,24690,24985,24585,24960,24810,100,-50,551274,"6,839,106.89",188694
,20171201,24960,24810,25075,25260,24855,25185,25050,375,240,418478,"5,241,876.32",166806
,20171204,25185,25050,25315,25985,25280,25555,25570,505,520,520936,"6,660,482.22",139242
,20171205,25555,25570,25590,25590,25180,25200,25400,-370,-170,280260,"3,559,733.89",126884
,20171206,25200,25400,25145,25225,24485,24660,24815,-740,-585,351320,"4,359,436.97",118422
,20171207,24660,24815,24770,24980,24510,24655,24765,-160,-50,193198,"2,392,378.95",105384
,20171208,24655,24765,24745,24920,24420,24865,24670,100,-95,156812,"1,934,393.44",102518
,20171211,24865,24670,24770,25115,24715,24810,24895,140,225,120114,"1,495,358.46",95872
,20171212,24810,24895,24850,25345,24750,25090,25030,195,135,93598,"1,171,588.26",89576
,20171213,25090,25030,25375,25380,25090,25325,25245,295,215,76204,"962,013.11",85832
,20171214,25325,25245,25375,25490,25170,25240,25290,-5,45,71386,"902,731.64",81722
,20171215,25240,25290,25265,25505,25265,25485,25395,195,105,58802,"746,742.29",78832
,20171218,25485,25395,25400,25770,25385,25710,25590,315,195,64480,"825,179.84",74478
,20171219,25710,25590,25670,25685,25330,25365,25500,-225,-90,39126,"498,876.15",69294
,20171220,25365,25500,25370,25675,25355,25590,25525,90,25,29354,"374,647.49",66584
,20171221,25590,25525,25690,25795,25400,25500,25525,-25,0,32358,"413,032.64",61576
,20171222,25500,25525,25545,25640,25410,25600,25525,75,0,26640,"340,014.58",58928
,20171225,25600,25525,25600,25960,25310,25320,25645,-205,120,39606,"507,892.32",51636
,20171226,25320,25645,25320,25575,25300,25540,25440,-105,-205,21422,"272,530.08",47690
,20171227,25540,25440,25565,25615,25350,25400,25440,-40,0,17116,"217,735.58",44744
,20171228,25400,25440,25500,25770,25420,25695,25565,255,125,19780,"252,872.02",39516
,20171229,25695,25565,25620,25775,25540,25720,25650,155,85,15056,"193,109.32",34144
zn1802,20170216,23660,23660,23710,23745,23670,23670,23705,10,45,6,71.13,4
,20170217,23670,23705,23140,23420,23140,23235,23250,-470,-455,138,"1,604.49",12
,20170220,23235,23250,23015,23015,23015,23015,23015,-235,-235,2,23.02,12
,20170221,23015,23015,23355,23645,23325,23325,23445,310,430,12,140.68,12
,20170222,23325,23445,23455,23475,22925,23015,23245,-430,-200,94,"1,092.69",48
,20170223,23015,23245,23200,23460,22790,22790,23270,-455,25,36,418.93,50
,20170224,22790,23270,22970,22970,22590,22695,22680,-575,-590,14,158.77,56
,20170227,22695,22680,22970,23015,22970,23010,23000,330,320,10,115.02,60
,20170228,23010,23000,22925,22925,22925,22925,22925,-75,-75,2,22.93,60
,20170301,22925,22925,23090,23090,22855,23005,22995,80,70,10,114.98,64
,20170302,23005,22995,23390,23400,23205,23280,23295,285,300,14,163.09,64
,20170303,23280,23295,22730,22825,22710,22825,22750,-470,-545,16,182.00,66
,20170306,22825,22750,22930,23025,22630,22630,22750,-120,0,18,204.77,70
,20170307,22630,22750,22420,22520,22255,22400,22430,-350,-320,28,314.09,76
,20170308,22400,22430,22185,22240,22040,22040,22165,-390,-265,10,110.85,74
,20170309,22040,22165,22060,22145,21435,21585,21840,-580,-325,66,720.84,78
,20170310,21585,21840,21770,22055,21690,21775,21815,-65,-25,18,196.37,82
,20170313,21775,21815,22285,22465,22285,22465,22350,650,535,6,67.05,82
,20170314,22465,22350,22525,22640,22485,22485,22560,135,210,14,157.92,76
,20170315,22485,22560,22360,22745,22205,22645,22525,85,-35,32,360.40,78
,20170316,22645,22525,22840,23260,22840,23260,23090,735,565,40,461.81,84
,20170317,23260,23090,23165,23360,23105,23255,23230,165,140,24,278.78,86
,20170320,23255,23230,23600,23600,23545,23555,23570,325,340,8,94.28,90
,20170321,23555,23570,23575,23575,23230,23230,23440,-340,-130,18,210.98,88
,20170322,23230,23440,23435,23470,22980,23000,23280,-440,-160,24,279.36,86
,20170323,23000,23280,23245,23270,23000,23245,23200,-35,-80,24,278.45,90
,20170324,23245,23200,23005,23035,22970,22995,23000,-205,-200,20,230.04,92
,20170327,22995,23000,23070,23100,22500,22500,22810,-500,-190,34,387.84,104
,20170328,22500,22810,22360,22645,22230,22585,22450,-225,-360,50,561.31,104
,20170329,22585,22450,22490,23185,22490,23185,22950,735,500,52,596.73,106
,20170330,23185,22950,23125,23410,23120,23205,23250,255,300,46,534.83,116
,20170331,23205,23250,23390,23500,23035,23165,23295,-85,45,44,512.58,118
,20170405,23165,23295,22915,23040,22870,23040,22925,-255,-370,26,298.07,116
,20170406,23040,22925,22980,23000,22780,22995,22925,70,0,32,366.82,126
,20170407,22995,22925,22865,22865,22100,22100,22620,-825,-305,60,678.73,140
,20170410,22100,22620,21980,22235,21760,22025,22025,-595,-595,58,638.79,148
,20170411,22025,22025,22110,22110,21270,21275,21560,-750,-465,22,237.18,156
,20170412,21275,21560,21210,21380,21010,21240,21165,-320,-395,46,486.82,160
,20170413,21240,21165,21080,21640,21080,21640,21330,475,165,64,682.69,154
,20170414,21640,21330,21365,21585,21225,21225,21380,-105,50,40,427.60,154
,20170417,21225,21380,21585,22000,21585,21705,21800,325,420,132,"1,438.81",162
,20170418,21705,21800,21805,21805,21245,21250,21460,-550,-340,42,450.68,166
,20170419,21250,21460,21060,21060,20595,20665,20725,-795,-735,106,"1,098.56",176
,20170420,20665,20725,20790,21285,20570,21190,20835,465,110,100,"1,041.93",192
,20170421,21190,20835,21280,21550,21255,21465,21345,630,510,36,384.30,180
,20170424,21465,21345,21160,21210,20995,21085,21085,-260,-260,24,253.05,182
,20170425,21085,21085,21150,21150,20945,21050,21040,-35,-45,36,378.81,188
,20170426,21050,21040,20895,21205,20895,21015,21055,-25,15,68,715.98,208
,20170427,21015,21055,21130,21260,21085,21250,21175,195,120,74,783.60,178
,20170428,21250,21175,20965,21280,20930,21130,21115,-45,-60,42,443.49,202
,20170502,21130,21115,21565,21815,21345,21345,21530,230,415,20,215.32,208
,20170503,21345,21530,21365,21365,21060,21060,21260,-470,-270,8,85.04,206
,20170504,21060,21260,20820,20880,20615,20615,20740,-645,-520,10,103.72,204
,20170505,20615,20740,20720,20840,20645,20645,20745,-95,5,16,165.98,202
,20170508,20645,20745,20740,20775,20400,20540,20620,-205,-125,12,123.73,202
,20170509,20540,20620,20470,20800,20470,20785,20625,165,5,10,103.14,200
,20170510,20785,20625,20980,20980,20885,20885,20955,260,330,14,146.72,208
,20170511,20885,20955,20900,21030,20890,21030,21010,75,55,132,"1,386.89",256
,20170512,21030,21010,20910,20910,20720,20735,20745,-275,-265,20,207.45,256
,20170515,20735,20745,20525,20675,20525,20675,20600,-70,-145,4,41.20,254
,20170516,20675,20600,20650,20650,20400,20405,20510,-195,-90,12,123.07,256
,20170517,20405,20510,20210,20595,20210,20595,20390,85,-120,22,224.32,254
,20170518,20595,20390,20610,20665,20450,20565,20550,175,160,28,287.71,252
,20170519,20565,20550,20040,20695,20030,20555,20390,5,-160,30,305.88,254
,20170522,20555,20390,21010,21405,21010,21155,21220,765,830,116,"1,230.97",324
,20170523,21155,21220,21200,21375,21125,21200,21270,-20,50,118,"1,254.98",362
,20170524,21200,21270,21250,21250,21015,21130,21120,-140,-150,20,211.22,370
,20170525,21130,21120,21100,21170,21045,21135,21110,15,-10,36,379.98,384
,20170526,21135,21110,21340,21400,21160,21400,21285,290,175,14,149.00,386
,20170531,21400,21285,21435,21435,21100,21135,21265,-150,-20,28,297.72,382
,20170601,21135,21265,20950,21070,20770,20775,20895,-490,-370,38,397.09,384
,20170602,20775,20895,20800,20835,20735,20795,20775,-100,-120,20,207.77,384
,20170605,20795,20775,20605,20630,20305,20525,20525,-250,-250,62,636.37,392
,20170606,20525,20525,20185,20410,20175,20290,20275,-235,-250,18,182.49,400
,20170607,20290,20275,20155,20210,19970,19970,20055,-305,-220,20,200.57,406
,20170608,19970,20055,20050,20250,19870,20250,19925,195,-130,274,"2,730.11",382
,20170609,20250,19925,20145,20215,20070,20145,20140,220,215,40,402.80,372
,20170612,20145,20140,20235,20485,20235,20405,20405,265,265,36,367.31,384
,20170613,20405,20405,20435,20595,20100,20100,20410,-305,5,88,898.15,400
,20170614,20100,20410,20160,20450,20110,20360,20285,-50,-125,70,710.13,400
,20170615,20360,20285,20495,20545,20350,20530,20475,245,190,30,307.17,418
,20170616,20530,20475,20435,20780,20435,20585,20630,110,155,22,226.93,414
,20170619,20585,20630,,,,20630,20630,0,0,0,0.00,414
,20170620,20630,20630,20710,20835,20710,20835,20785,205,155,32,332.62,420
,20170621,20835,20785,20780,20860,20710,20840,20775,55,-10,24,249.34,420
,20170622,20840,20775,21105,21465,21105,21415,21280,640,505,290,"3,085.85",586
,20170623,21415,21280,21665,21860,21535,21860,21625,580,345,214,"2,314.27",686
,20170626,21860,21625,20505,21825,20505,21810,21580,185,-45,130,"1,402.80",752
,20170627,21810,21580,21790,22150,21720,22150,21940,570,360,70,767.95,764
,20170628,22150,21940,22120,22160,22055,22130,22110,190,170,114,"1,260.34",798
,20170629,22130,22110,22090,22275,21930,22275,22065,165,-45,36,397.26,798
,20170630,22275,22065,22040,22180,21835,22180,22075,115,10,82,905.16,826
,20170703,22180,22075,22080,22405,21985,22405,22160,330,85,58,642.70,844
,20170704,22405,22160,22370,22370,22145,22145,22225,-15,65,118,"1,311.43",900
,20170705,22145,22225,22485,22485,22220,22400,22420,175,195,54,605.45,934
,20170706,22400,22420,22200,22260,22075,22250,22185,-170,-235,54,599.09,960
,20170707,22250,22185,22205,22445,22205,22440,22310,255,125,88,981.83,1002
,20170710,22440,22310,22510,22520,22105,22205,22320,-105,10,94,"1,049.05",1044
,20170711,22205,22320,22205,22570,22050,22570,22340,250,20,146,"1,630.90",1080
,20170712,22570,22340,22505,22845,22485,22730,22725,390,385,92,"1,045.40",1078
,20170713,22730,22725,22840,22945,22670,22945,22805,220,80,164,"1,870.10",1118
,20170714,22945,22805,22870,22870,22490,22560,22665,-245,-140,98,"1,110.79",1128
,20170717,22560,22665,22490,23090,22490,23010,22930,345,265,210,"2,407.81",1206
,20170718,23010,22930,22900,23020,22530,22605,22850,-325,-80,130,"1,485.26",1194
,20170719,22605,22850,22530,22645,22500,22640,22565,-210,-285,82,925.31,1214
,20170720,22640,22565,22370,22485,22195,22310,22290,-255,-275,110,"1,226.18",1224
,20170721,22310,22290,22070,22450,22070,22360,22255,70,-35,146,"1,624.92",1250
,20170724,22360,22255,22490,22675,22300,22620,22550,365,295,184,"2,074.84",1260
,20170725,22620,22550,22560,22840,22560,22665,22685,115,135,60,680.66,1274
,20170726,22665,22685,22840,23035,22665,22755,22905,70,220,260,"2,977.92",1316
,20170727,22755,22905,22715,22870,22515,22815,22765,-90,-140,46,523.69,1334
,20170728,22815,22765,22775,22895,22465,22465,22670,-300,-95,60,680.15,1346
,20170731,22465,22670,22595,22920,22485,22920,22705,250,35,44,499.54,1342
,20170801,22920,22705,22780,22835,22490,22490,22635,-215,-70,50,565.91,1360
,20170802,22490,22635,22475,22650,22375,22485,22485,-150,-150,744,"8,364.86",958
,20170803,22485,22485,22590,22990,22580,22770,22740,285,255,244,"2,774.56",896
,20170804,22770,22740,22640,23085,22640,23060,22975,320,235,138,"1,585.37",924
,20170807,23060,22975,22910,23125,22775,23030,22980,55,5,126,"1,447.95",904
,20170808,23030,22980,23150,23710,23150,23560,23505,580,525,292,"3,431.91",872
,20170809,23560,23505,23525,24355,23450,24280,23925,775,420,106,"1,268.19",880
,20170810,24280,23925,24245,24265,23705,23705,24120,-220,195,32,385.99,880
,20170811,23705,24120,23725,24040,23400,23445,23720,-675,-400,58,687.93,880
,20170814,23445,23720,23550,23605,23500,23600,23555,-120,-165,48,565.44,892
,20170815,23600,23555,23460,23755,23460,23755,23675,200,120,74,876.04,900
,20170816,23755,23675,23780,24170,23760,24100,23980,425,305,40,479.61,900
,20170817,24100,23980,24405,25415,24405,25415,25290,1435,1310,830,"10,497.23",1270
,20170818,25415,25290,25235,25430,24790,25325,25185,35,-105,530,"6,674.43",1118
,20170821,25325,25185,25410,25655,24910,25435,25310,250,125,232,"2,935.97",1052
,20170822,25435,25310,25340,25635,25195,25460,25425,150,115,56,711.97,1038
,20170823,25460,25425,25475,25480,24875,25045,25210,-380,-215,68,857.21,1026
,20170824,25045,25210,25250,25495,25175,25280,25280,70,70,34,429.82,1030
,20170825,25280,25280,25490,25490,25220,25360,25280,80,0,328,"4,146.00",958
,20170828,25360,25280,25500,25500,24720,25155,24920,-125,-360,46,573.17,960
,20170829,25155,24920,25195,25350,24955,24955,25220,35,300,128,"1,614.20",998
,20170830,24955,25220,25180,25480,24940,25440,25195,220,-25,60,755.98,1008
,20170831,25440,25195,25290,25290,24965,25185,25150,-10,-45,78,981.02,1018
,20170901,25185,25150,25310,25610,25250,25600,25420,450,270,72,915.29,1026
,20170904,25600,25420,25465,26010,25465,25825,25725,405,305,164,"2,109.50",1070
,20170905,25825,25725,25800,25925,25720,25755,25800,30,75,94,"1,212.64",1104
,20170906,25755,25800,25590,25745,24600,24720,24960,-1080,-840,196,"2,446.42",1064
,20170907,24720,24960,24725,25100,24495,24535,24665,-425,-295,798,"9,841.67",1288
,20170908,24535,24665,24650,24830,24125,24175,24495,-490,-170,332,"4,066.85",1338
,20170911,24175,24495,24155,24600,23940,24575,24265,80,-230,360,"4,367.80",1494
,20170912,24575,24265,24635,24860,24430,24860,24670,595,405,116,"1,430.88",1516
,20170913,24860,24670,24640,24795,24480,24490,24665,-180,-5,62,764.68,1510
,20170914,24490,24665,24480,24530,24215,24275,24475,-390,-190,782,"9,571.57",2154
,20170915,24275,24475,24290,24595,24200,24230,24490,-245,15,1456,"17,830.17",3416
,20170918,24230,24490,24320,24855,23910,24755,24580,265,90,948,"11,652.80",3562
,20170919,24755,24580,24805,25195,24685,24965,24935,385,355,1150,"14,338.21",4002
,20170920,24965,24935,24825,25260,24655,25175,25070,240,135,842,"10,556.30",4124
,20170921,25175,25070,25280,25315,24660,24795,24985,-275,-85,526,"6,571.17",4080
,20170922,24795,24985,24800,25065,23995,23995,24505,-990,-480,848,"10,390.42",4282
,20170925,23995,24505,24295,24850,24065,24710,24535,205,30,356,"4,367.70",4274
,20170926,24710,24535,24795,25280,24685,25085,25045,550,510,468,"5,860.86",4236
,20170927,25085,25045,25040,25385,24930,25360,25155,315,110,544,"6,842.53",4110
,20170928,25360,25155,25390,25390,24880,25095,25110,-60,-45,376,"4,721.51",4114
,20170929,25095,25110,25210,25530,25010,25530,25355,420,245,560,"7,099.43",4112
,20171009,25530,25355,26230,26355,25795,26140,26085,785,730,2532,"33,023.78",5622
,20171010,26140,26085,26140,26140,25420,25500,25815,-585,-270,2966,"38,288.11",6414
,20171011,25500,25815,25580,25970,25445,25765,25695,-50,-120,2442,"31,377.75",6152
,20171012,25765,25695,25680,25745,25160,25625,25400,-70,-295,3712,"47,142.74",6462
,20171013,25625,25400,25655,25935,25590,25880,25765,480,365,4190,"53,981.57",6536
,20171016,25880,25765,25860,26000,25350,25900,25750,135,-15,11324,"145,800.56",8660
,20171017,25900,25750,25865,25990,25000,25105,25395,-645,-355,13980,"177,523.78",11358
,20171018,25105,25395,25030,25030,24435,24815,24735,-580,-660,12594,"155,787.56",12470
,20171019,24815,24735,24960,25180,24770,24785,24940,50,205,11380,"141,931.83",12754
,20171020,24785,24940,24790,25230,24665,25070,24980,130,40,10110,"126,278.24",14532
,20171023,25070,24980,25100,25150,24640,25000,24955,20,-25,10330,"128,910.44",15270
,20171024,25000,24955,25025,25460,24975,25325,25290,370,335,14614,"184,805.30",19558
,20171025,25325,25290,25365,25460,25140,25250,25320,-40,30,14332,"181,461.57",22176
,20171026,25250,25320,25395,25820,25325,25670,25610,350,290,18552,"237,567.64",25720
,20171027,25670,25610,25735,25795,25270,25340,25575,-270,-35,31452,"402,204.95",33784
,20171030,25340,25575,25160,25585,25155,25510,25420,-65,-155,36886,"468,836.77",40610
,20171031,25510,25420,25465,25920,25370,25850,25660,430,240,36074,"462,836.91",43040
,20171101,25850,25660,25850,26530,25685,25890,26065,230,405,61756,"804,978.54",49400
,20171102,25890,26065,26300,26300,25690,25765,25865,-300,-200,46564,"602,224.98",49844
,20171103,25765,25865,25760,26025,25620,25865,25835,0,-30,69736,"900,888.18",58858
,20171106,25865,25835,25800,26035,25605,25975,25830,140,-5,52552,"678,726.19",61416
,20171107,25975,25830,26000,26095,25630,25720,25855,-110,25,52248,"675,483.62",65684
,20171108,25720,25855,25715,25740,25275,25340,25465,-515,-390,50318,"640,698.37",68010
,20171109,25340,25465,25450,25595,25215,25470,25425,5,-40,57036,"725,131.52",70754
,20171110,25470,25425,25450,25670,25345,25565,25530,140,105,43852,"559,815.65",72362
,20171113,25565,25530,25755,25890,25630,25815,25745,285,215,54238,"698,242.67",76516
,20171114,25815,25745,25740,25930,25635,25760,25775,15,30,53276,"686,673.24",80258
,20171115,25760,25775,25650,25770,24925,24985,25200,-790,-575,125182,"1,577,571.84",92868
,20171116,24985,25200,25085,25160,24850,25005,25020,-195,-180,83218,"1,041,223.90",94518
,20171117,25005,25020,25150,25225,24740,25080,25035,60,15,85924,"1,075,742.03",96762
,20171120,25080,25035,25095,25400,25020,25120,25195,85,160,85084,"1,071,892.67",97686
,20171121,25120,25195,25150,25300,24810,25135,25075,-60,-120,109260,"1,369,847.82",100890
,20171122,25135,25075,25230,25800,25165,25645,25500,570,425,107090,"1,365,646.75",99388
,20171123,25645,25500,25660,25720,25490,25505,25625,5,125,70492,"903,205.53",102356
,20171124,25505,25625,25605,25650,25370,25560,25510,-65,-115,72396,"923,417.44",104370
,20171127,25560,25510,25595,25595,24950,24995,25260,-515,-250,129604,"1,637,161.79",124870
,20171128,24995,25260,25020,25120,24625,24780,24875,-480,-385,169412,"2,107,242.47",142610
,20171129,24780,24875,24800,24965,24585,24710,24785,-165,-90,167254,"2,072,807.38",152266
,20171130,24710,24785,24630,24915,24500,24880,24725,95,-60,233158,"2,882,805.06",163480
,20171201,24880,24725,25000,25185,24765,25110,24975,385,250,226732,"2,831,613.80",163258
,20171204,25110,24975,25250,25970,25200,25495,25510,520,535,317832,"4,054,610.32",155046
,20171205,25495,25510,25505,25520,25080,25100,25325,-410,-185,251086,"3,179,701.38",161454
,20171206,25100,25325,25040,25120,24345,24505,24695,-820,-630,419442,"5,179,940.47",175778
,20171207,24505,24695,24595,24845,24340,24495,24615,-200,-80,502820,"6,188,504.58",202376
,20171208,24495,24615,24550,24760,24210,24705,24505,90,-110,642820,"7,876,438.30",217778
,20171211,24705,24505,24590,24980,24530,24640,24720,135,215,536488,"6,631,159.93",210430
,20171212,24640,24720,24695,25220,24580,24965,24885,245,165,516382,"6,425,454.68",202558
,20171213,24965,24885,25210,25250,24950,25190,25115,305,230,477216,"5,993,035.56",220856
,20171214,25190,25115,25215,25385,25010,25105,25165,-10,50,461816,"5,811,631.88",214582
,20171215,25105,25165,25185,25390,25135,25355,25265,190,100,402860,"5,089,246.79",218362
,20171218,25355,25265,25305,25680,25255,25615,25485,350,220,519450,"6,620,004.49",208046
,20171219,25615,25485,25565,25590,25230,25285,25420,-200,-65,374582,"4,761,625.06",203592
,20171220,25285,25420,25305,25620,25270,25525,25430,105,10,350186,"4,453,398.51",208868
,20171221,25525,25430,25585,25745,25340,25460,25525,30,95,407818,"5,204,846.24",205410
,20171222,25460,25525,25520,25610,25360,25565,25495,40,-30,354826,"4,523,667.08",199720
,20171225,25565,25495,25510,25945,25280,25300,25615,-195,120,491886,"6,300,261.00",199400
,20171226,25300,25615,25290,25565,25255,25525,25405,-90,-210,280540,"3,564,014.64",184474
,20171227,25525,25405,25520,25615,25335,25375,25445,-30,40,270758,"3,444,772.83",180530
,20171228,25375,25445,25505,25810,25405,25710,25550,265,105,361002,"4,611,985.79",188638
,20171229,25710,25550,25660,25765,25550,25725,25655,175,105,289952,"3,719,914.69",173218
zn1803,20170316,22525,22525,23085,23575,22820,23380,23175,855,650,10,115.88,6
,20170317,23380,23175,23235,23405,23120,23130,23200,-45,25,30,348.02,30
,20170320,23130,23200,23765,23835,23470,23470,23670,270,470,24,284.05,38
,20170321,23470,23670,23580,23645,23170,23275,23485,-395,-185,156,"1,832.18",46
,20170322,23275,23485,23490,23510,22935,22950,23360,-535,-125,152,"1,775.70",72
,20170323,22950,23360,23005,23355,22940,23230,23255,-130,-105,50,581.50,60
,20170324,23230,23255,22995,23145,22755,23145,22930,-110,-325,58,664.99,58
,20170327,23145,22930,23050,23065,22650,22650,22825,-280,-105,66,753.27,62
,20170328,22650,22825,22485,22510,22295,22510,22380,-315,-445,18,201.42,66
,20170329,22510,22380,22495,23135,22400,23135,22865,755,485,56,640.24,90
,20170330,23135,22865,23160,23390,23130,23140,23220,275,355,42,487.72,96
,20170331,23140,23220,23220,23415,23015,23040,23175,-180,-45,30,347.69,102
,20170405,23040,23175,22800,22995,22800,22885,22885,-290,-290,20,228.86,106
,20170406,22885,22885,22980,23040,22880,23000,22965,115,80,22,252.62,114
,20170407,23000,22965,22745,22760,22100,22100,22455,-865,-510,50,561.50,118
,20170410,22100,22455,21960,22185,21800,22005,21995,-450,-460,48,527.89,130
,20170411,22005,21995,21685,21685,21230,21230,21445,-765,-550,14,150.12,132
,20170412,21230,21445,21420,21425,21000,21185,21205,-260,-240,44,466.59,140
,20170413,21185,21205,21080,21415,21065,21410,21225,205,20,36,382.12,144
,20170414,21410,21225,21360,21515,21290,21290,21310,65,85,122,"1,300.03",234
,20170417,21290,21310,21360,22080,21360,21775,21745,465,435,78,848.17,226
,20170418,21775,21745,21825,21825,21200,21215,21385,-530,-360,76,812.73,246
,20170419,21215,21385,20850,20995,20595,20670,20770,-715,-615,276,"2,866.40",348
,20170420,20670,20770,20795,21200,20500,21200,20925,430,155,144,"1,506.70",368
,20170421,21200,20925,21275,21485,21255,21485,21365,560,440,106,"1,132.35",312
,20170424,21485,21365,21290,21290,21005,21075,21100,-290,-265,114,"1,202.72",316
,20170425,21075,21100,21130,21140,20910,21100,21025,0,-75,68,715.01,348
,20170426,21100,21025,20975,21140,20815,21000,21005,-25,-20,86,903.34,368
,20170427,21000,21005,20975,21230,20975,21200,21130,195,125,64,676.19,376
,20170428,21200,21130,21170,21240,20840,21135,21050,5,-80,90,947.34,426
,20170502,21135,21050,21620,21640,21300,21330,21500,280,450,30,322.53,422
,20170503,21330,21500,21340,21345,21005,21005,21110,-495,-390,20,211.12,420
,20170504,21005,21110,20920,20920,20625,20770,20740,-340,-370,58,601.46,412
,20170505,20770,20740,20725,20775,20570,20570,20725,-170,-15,12,124.36,410
,20170508,20570,20725,20715,20765,20395,20585,20550,-140,-175,38,390.46,398
,20170509,20585,20550,20505,20725,20485,20725,20560,175,10,24,246.77,396
,20170510,20725,20560,20930,20955,20760,20845,20850,285,290,34,354.50,384
,20170511,20845,20850,20790,21010,20700,21010,20830,160,-20,66,687.42,382
,20170512,21010,20830,21235,21235,20510,20710,20795,-120,-35,10,103.98,382
,20170515,20710,20795,20800,20800,20400,20575,20560,-220,-235,46,472.94,390
,20170516,20575,20560,20645,20645,20190,20190,20405,-370,-155,56,571.39,406
,20170517,20190,20405,20195,20530,20195,20530,20385,125,-20,44,448.50,394
,20170518,20530,20385,20485,20555,20410,20530,20485,145,100,64,655.64,388
,20170519,20530,20485,19925,20635,19920,20555,20310,70,-175,22,223.45,388
,20170522,20555,20310,20895,21330,20895,21155,21155,845,845,138,"1,459.81",440
,20170523,21155,21155,21175,21275,21100,21100,21205,-55,50,122,"1,293.80",448
,20170524,21100,21205,21200,21220,20910,21065,21060,-140,-145,92,968.81,448
,20170525,21065,21060,21090,21150,20980,21050,21055,-10,-5,26,273.76,456
,20170526,21050,21055,21085,21275,21085,21275,21220,220,165,88,933.81,498
,20170531,21275,21220,21335,21340,21045,21045,21190,-175,-30,18,190.75,500
,20170601,21045,21190,20975,21020,20760,20760,20900,-430,-290,78,815.28,494
,20170602,20760,20900,20745,20805,20665,20805,20725,-95,-175,34,352.36,496
,20170605,20805,20725,20655,20670,20335,20395,20545,-330,-180,84,862.94,484
,20170606,20395,20545,20170,20370,20160,20160,20220,-385,-325,32,323.60,486
,20170607,20160,20220,20175,20235,19935,19960,20050,-260,-170,94,942.43,472
,20170608,19960,20050,20020,20290,19885,20275,19930,225,-120,152,"1,514.71",404
,20170609,20275,19930,20210,20210,20050,20105,20115,175,185,38,382.24,396
,20170612,20105,20115,20340,20485,20210,20460,20355,345,240,72,732.89,404
,20170613,20460,20355,20370,20565,20060,20065,20285,-290,-70,92,933.15,406
,20170614,20065,20285,20020,20415,20020,20330,20215,45,-70,104,"1,051.37",406
,20170615,20330,20215,20525,20540,20300,20540,20495,325,280,56,573.91,382
,20170616,20540,20495,20475,20865,20470,20650,20685,155,190,34,351.65,372
,20170619,20650,20685,20540,20590,20485,20575,20535,-110,-150,28,287.49,378
,20170620,20575,20535,20700,20800,20700,20795,20760,260,225,72,747.45,368
,20170621,20795,20760,20795,20795,20710,20710,20765,-50,5,6,62.30,370
,20170622,20710,20765,21090,21425,21060,21320,21220,555,455,252,"2,673.77",490
,20170623,21320,21220,21555,21815,21505,21800,21570,580,350,178,"1,919.74",538
,20170626,21800,21570,21765,21775,21635,21775,21705,205,135,122,"1,324.30",592
,20170627,21775,21705,21760,22105,21760,22100,21980,395,275,16,175.85,598
,20170628,22100,21980,22090,22120,22020,22070,22085,90,105,58,640.51,608
,20170629,22070,22085,21960,22175,21945,22115,22070,30,-15,40,441.49,600
,20170630,22115,22070,22080,22080,21870,22000,21970,-70,-100,24,263.64,612
,20170703,22000,21970,22035,22115,21925,22035,22025,65,55,46,506.63,608
,20170704,22035,22025,22290,22290,22065,22085,22140,60,115,38,420.69,598
,20170705,22085,22140,22180,22410,22135,22135,22295,-5,155,36,401.31,606
,20170706,22135,22295,22120,22175,22040,22175,22110,-120,-185,16,176.89,604
,20170707,22175,22110,22260,22370,22170,22370,22250,260,140,18,200.27,606
,20170710,22370,22250,22455,22455,22010,22100,22230,-150,-20,34,377.92,612
,20170711,22100,22230,21990,22560,21980,22555,22285,325,55,176,"1,961.35",724
,20170712,22555,22285,22550,22890,22550,22630,22705,345,420,46,522.23,726
,20170713,22630,22705,22815,22880,22635,22870,22755,165,50,46,523.39,716
,20170714,22870,22755,22775,22775,22390,22490,22560,-265,-195,70,789.72,716
,20170717,22490,22560,22525,22960,22525,22960,22640,400,80,64,724.62,706
,20170718,22960,22640,22905,22990,22600,22600,22840,-40,200,76,867.95,676
,20170719,22600,22840,22580,22585,22480,22540,22530,-300,-310,44,495.75,692
,20170720,22540,22530,22380,22405,22200,22310,22305,-220,-225,38,423.82,698
,20170721,22310,22305,22270,22315,22070,22295,22210,-10,-95,32,355.42,698
,20170724,22295,22210,22470,22635,22300,22635,22470,425,260,30,337.09,700
,20170725,22635,22470,22620,22725,22600,22715,22635,245,165,28,316.92,690
,20170726,22715,22635,22800,22990,22800,22820,22875,185,240,36,411.78,680
,20170727,22820,22875,22750,22750,22675,22730,22725,-145,-150,8,90.91,682
,20170728,22730,22725,22795,22795,22635,22635,22715,-90,-10,10,113.58,686
,20170731,22635,22715,22555,22840,22540,22840,22645,125,-70,32,362.40,676
,20170801,22840,22645,22745,22745,22470,22470,22605,-175,-40,4,45.22,678
,20170802,22470,22605,22485,22485,22310,22310,22380,-295,-225,14,156.67,676
,20170803,22310,22380,22535,22875,22535,22765,22670,385,290,32,362.72,678
,20170804,22765,22670,22600,22960,22600,22960,22730,290,60,24,272.77,678
,20170807,22960,22730,22835,22980,22705,22935,22860,205,130,58,663.01,664
,20170808,22935,22860,23040,23545,23040,23455,23395,595,535,74,865.72,660
,20170809,23455,23395,23385,24260,23385,24180,24090,785,695,118,"1,421.31",652
,20170810,24180,24090,24110,24170,23800,23805,23890,-285,-200,96,"1,146.80",622
,20170811,23805,23890,23780,23865,23370,23370,23670,-520,-220,144,"1,704.41",576
,20170814,23370,23670,23475,23635,23360,23360,23465,-310,-205,68,797.93,572
,20170815,23360,23465,23385,23710,23360,23710,23495,245,30,42,493.50,582
,20170816,23710,23495,23605,24030,23605,24030,23820,535,325,64,762.24,574
,20170817,24030,23820,24325,25245,24325,25245,24955,1425,1135,72,898.39,588
,20170818,25245,24955,25165,25240,24845,25115,25125,160,170,64,804.05,592
,20170821,25115,25125,25345,25685,24920,25305,25415,180,290,128,"1,626.68",594
,20170822,25305,25415,25270,25270,25105,25165,25170,-250,-245,10,125.86,592
,20170823,25165,25170,25145,25145,24825,25040,24985,-130,-185,38,474.77,594
,20170824,25040,24985,25300,25300,25100,25100,25170,115,185,14,176.20,602
,20170825,25100,25170,25190,25190,25165,25165,25180,-5,10,8,100.72,608
,20170828,25165,25180,25380,25380,24570,24860,24825,-320,-355,40,496.52,612
,20170829,24860,24825,25075,25115,24900,24900,25020,75,195,28,350.32,608
,20170830,24900,25020,25085,25365,24800,25250,25030,230,10,30,375.52,606
,20170831,25250,25030,25100,25105,24850,25000,24980,-30,-50,78,974.34,646
,20170901,25000,24980,25445,25495,25195,25465,25315,485,335,24,303.84,642
,20170904,25465,25315,25355,25925,25325,25580,25575,265,260,50,639.38,652
,20170905,25580,25575,25495,25735,25495,25625,25640,50,65,60,769.34,672
,20170906,25625,25640,25510,25510,24575,24615,24920,-1025,-720,50,623.07,674
,20170907,24615,24920,24635,24720,24330,24500,24585,-420,-335,42,516.31,678
,20170908,24500,24585,24500,24670,24500,24505,24580,-80,-5,14,172.07,676
,20170911,24505,24580,24040,24385,23775,24385,24050,-195,-530,92,"1,106.44",670
,20170912,24385,24050,24470,24750,24305,24700,24475,650,425,20,244.80,678
,20170913,24700,24475,24535,24635,24165,24335,24425,-140,-50,26,317.59,682
,20170914,24335,24425,23960,23960,23960,23960,23960,-465,-465,2,23.96,684
,20170915,23960,23960,24445,24475,24240,24240,24380,280,420,56,682.66,708
,20170918,24240,24380,23985,24340,23825,24340,23990,-40,-390,40,479.83,676
,20170919,24340,23990,24640,25030,24625,24835,24910,845,920,38,473.33,682
,20170920,24835,24910,24575,25100,24575,25040,24860,130,-50,16,198.91,678
,20170921,25040,24860,25015,25015,24655,24655,24750,-205,-110,22,272.29,686
,20170922,24655,24750,24640,24640,23915,23975,24185,-775,-565,24,290.25,686
,20170925,23975,24185,24215,24720,24215,24695,24560,510,375,22,270.19,680
,20170926,24695,24560,24605,25040,24605,25020,24920,460,360,70,872.27,676
,20170927,25020,24920,24910,25220,24820,25220,24930,300,10,20,249.34,666
,20170928,25220,24930,25195,25215,24965,24965,25110,35,180,14,175.79,666
,20170929,24965,25110,25290,25420,25115,25420,25245,310,135,94,"1,186.52",678
,20171009,25420,25245,25710,26245,25650,26000,25930,755,685,124,"1,607.78",720
,20171010,26000,25930,25830,25935,25300,25350,25755,-580,-175,32,412.11,738
,20171011,25350,25755,25490,25835,25360,25500,25550,-255,-205,54,689.93,724
,20171012,25500,25550,25235,25555,25070,25555,25235,5,-315,50,630.95,726
,20171013,25555,25235,25580,25760,25560,25565,25660,330,425,86,"1,103.45",738
,20171016,25565,25660,25655,25795,25255,25750,25585,90,-75,92,"1,177.05",740
,20171017,25750,25585,25690,25715,25215,25230,25500,-355,-85,44,561.10,754
,20171018,25230,25500,24860,24880,24365,24730,24620,-770,-880,178,"2,191.58",784
,20171019,24730,24620,24730,25160,24680,24680,24780,60,160,270,"3,345.74",860
,20171020,24680,24780,24665,25115,24555,24975,24760,195,-20,226,"2,798.01",858
,20171023,24975,24760,24955,25175,24550,25045,24820,285,60,190,"2,358.02",874
,20171024,25045,24820,24915,25355,24880,25280,25125,460,305,94,"1,181.01",886
,20171025,25280,25125,25295,25325,25045,25100,25175,-25,50,108,"1,359.71",928
,20171026,25100,25175,25265,25695,25250,25540,25500,365,325,224,"2,856.08",976
,20171027,25540,25500,25575,25670,25200,25220,25505,-280,5,1256,"16,018.68",1614
,20171030,25220,25505,25130,25500,25060,25430,25340,-75,-165,2352,"29,803.26",1904
,20171031,25430,25340,25425,25820,25300,25700,25545,360,205,2672,"34,133.33",2532
,20171101,25700,25545,25710,26400,25600,25780,26035,235,490,3182,"41,429.21",3370
,20171102,25780,26035,25825,26175,25615,25630,25760,-405,-275,1690,"21,769.33",3468
,20171103,25630,25760,25645,25970,25570,25800,25775,40,15,7136,"91,974.09",7160
,20171106,25800,25775,25750,26035,25590,25960,25825,185,50,8508,"109,876.31",10310
,20171107,25960,25825,25995,26060,25650,25735,25845,-90,20,13358,"172,645.12",15518
,20171108,25735,25845,25710,25745,25295,25355,25465,-490,-380,11988,"152,645.79",19270
,20171109,25355,25465,25455,25595,25230,25480,25420,15,-45,16420,"208,701.64",23902
,20171110,25480,25420,25460,25680,25350,25570,25525,150,105,15024,"191,754.42",26800
,20171113,25570,25525,25720,25880,25635,25820,25760,295,235,14472,"186,402.60",28222
,20171114,25820,25760,25750,25910,25635,25775,25785,15,25,14432,"186,091.97",29968
,20171115,25775,25785,25640,25775,24940,25005,25195,-780,-590,23768,"299,439.79",32270
,20171116,25005,25195,25030,25155,24875,25015,25030,-180,-165,17518,"219,274.75",35892
,20171117,25015,25030,25200,25240,24750,25095,25045,65,15,18118,"226,883.39",37746
,20171120,25095,25045,25100,25395,25020,25130,25190,85,145,13938,"175,572.85",38744
,20171121,25130,25190,25140,25305,24815,25140,25075,-50,-115,21424,"268,625.11",40736
,20171122,25140,25075,25200,25790,25170,25625,25535,550,460,25168,"321,355.12",40964
,20171123,25625,25535,25635,25720,25495,25515,25625,-20,90,18292,"234,373.21",42798
,20171124,25515,25625,25560,25650,25380,25545,25505,-80,-120,12206,"155,683.67",43806
,20171127,25545,25505,25600,25600,24950,24975,25245,-530,-260,25006,"315,640.08",44828
,20171128,24975,25245,25040,25100,24580,24700,24855,-545,-390,49204,"611,576.79",49410
,20171129,24700,24855,24700,24935,24550,24670,24760,-185,-95,66474,"822,956.25",58292
,20171130,24670,24760,24550,24855,24440,24810,24665,50,-95,61524,"758,785.33",60820
,20171201,24810,24665,24910,25180,24715,25040,24915,375,250,58986,"734,836.09",64572
,20171204,25040,24915,25200,25905,25170,25460,25485,545,570,73144,"932,048.90",62376
,20171205,25460,25485,25500,25500,25030,25040,25275,-445,-210,40276,"509,051.85",64814
,20171206,25040,25275,24915,25060,24235,24410,24600,-865,-675,72044,"886,203.78",72334
,20171207,24410,24600,24450,24745,24260,24400,24525,-200,-75,68782,"843,513.81",75924
,20171208,24400,24525,24450,24660,24110,24605,24390,80,-135,73418,"895,484.88",82946
,20171211,24605,24390,24495,24900,24430,24540,24660,150,270,72336,"891,916.80",78234
,20171212,24540,24660,24605,25145,24520,24910,24805,250,145,65382,"810,959.42",81768
,20171213,24910,24805,25130,25195,24900,25145,25060,340,255,70478,"883,249.61",86038
,20171214,25145,25060,25195,25320,24945,25025,25105,-35,45,58808,"738,331.37",89914
,20171215,25025,25105,25075,25330,25065,25300,25205,195,100,57158,"720,463.19",94448
,20171218,25300,25205,25255,25610,25205,25550,25430,345,225,71802,"913,013.36",95076
,20171219,25550,25430,25485,25525,25180,25215,25355,-215,-75,61028,"773,745.33",98522
,20171220,25215,25355,25235,25560,25210,25475,25385,120,30,72766,"923,593.11",101292
,20171221,25475,25385,25530,25680,25290,25415,25465,30,80,90568,"1,153,355.38",101590
,20171222,25415,25465,25495,25565,25320,25530,25445,65,-20,88730,"1,128,878.48",102788
,20171225,25530,25445,25455,25890,25240,25245,25570,-200,125,122062,"1,560,673.50",113698
,20171226,25245,25570,25205,25520,25205,25480,25360,-90,-210,71190,"902,788.87",117986
,20171227,25480,25360,25480,25565,25290,25340,25390,-20,30,82212,"1,043,872.17",126838
,20171228,25340,25390,25445,25815,25375,25710,25550,320,160,151706,"1,938,228.02",146720
,20171229,25710,25550,25670,25755,25555,25720,25655,170,105,126240,"1,619,540.63",154530
zn1804,20170418,21745,21745,21430,21430,21265,21265,21345,-480,-400,4,42.70,4
,20170419,21265,21345,21050,21050,20570,20600,20655,-745,-690,28,289.21,24
,20170420,20600,20655,20865,21065,20555,21065,20780,410,125,28,290.95,42
,20170421,21065,20780,21260,21485,21195,21485,21315,705,535,34,362.39,42
,20170424,21485,21315,21220,21225,20940,21050,21105,-265,-210,44,464.33,52
,20170425,21050,21105,20930,21070,20900,20955,20980,-150,-125,80,839.39,108
,20170426,20955,20980,20910,21095,20840,21020,21020,40,40,92,966.94,156
,20170427,21020,21020,21070,21180,21035,21180,21095,160,75,50,527.42,140
,20170428,21180,21095,21135,21220,20855,21090,21060,-5,-35,68,716.13,182
,20170502,21090,21060,21595,21595,21205,21235,21360,175,300,36,384.53,178
,20170503,21235,21360,21205,21265,21030,21055,21145,-305,-215,20,211.45,176
,20170504,21055,21145,20850,20890,20740,20750,20830,-395,-315,20,208.30,174
,20170505,20750,20830,20655,20735,20560,20560,20640,-270,-190,10,103.21,174
,20170508,20560,20640,20790,20840,20390,20520,20535,-120,-105,34,349.15,194
,20170509,20520,20535,20475,20840,20475,20840,20640,305,105,24,247.72,204
,20170510,20840,20640,20990,20990,20710,20870,20830,230,190,62,645.88,214
,20170511,20870,20830,20740,21005,20665,20995,20850,165,20,32,333.64,224
,20170512,20995,20850,20870,20875,20500,20600,20600,-250,-250,68,700.48,256
,20170515,20600,20600,20445,20550,20390,20550,20480,-50,-120,22,225.28,264
,20170516,20550,20480,20620,20620,20120,20175,20355,-305,-125,80,814.27,290
,20170517,20175,20355,20295,20445,20195,20425,20310,70,-45,40,406.28,292
,20170518,20425,20310,20450,20505,20390,20450,20400,140,90,104,"1,060.91",378
,20170519,20450,20400,20020,20600,20020,20500,20355,100,-45,86,875.47,374
,20170522,20500,20355,20860,21310,20860,21130,21090,775,735,104,"1,096.90",394
,20170523,21130,21090,22515,22515,20945,20945,21290,-145,200,64,681.43,410
,20170524,20945,21290,21120,21285,20890,21015,21015,-275,-275,292,"3,068.72",444
,20170525,21015,21015,21000,21080,20925,20950,20960,-65,-55,60,628.87,456
,20170526,20950,20960,21070,21235,21020,21235,21135,275,175,90,951.23,456
,20170531,21235,21135,21265,21265,20990,20990,21205,-145,70,14,148.45,448
,20170601,20990,21205,20910,21000,20750,20750,20850,-455,-355,98,"1,021.84",464
,20170602,20750,20850,20695,20820,20675,20820,20735,-30,-115,32,331.77,464
,20170605,20820,20735,20620,20665,20305,20425,20520,-310,-215,68,697.77,466
,20170606,20425,20520,20225,20345,20115,20140,20220,-380,-300,44,444.93,484
,20170607,20140,20220,20115,20230,19945,19980,20100,-240,-120,52,522.62,496
,20170608,19980,20100,19980,20290,19870,20290,19935,190,-165,134,"1,335.87",498
,20170609,20290,19935,20170,20170,20105,20115,20110,180,175,90,905.14,494
,20170612,20115,20110,20280,20390,20125,20390,20255,280,145,54,546.98,500
,20170613,20390,20255,20465,20520,20005,20060,20250,-195,-5,96,972.03,466
,20170614,20060,20250,19975,20315,19975,20315,20195,65,-55,72,727.10,464
,20170615,20315,20195,20420,20505,20315,20505,20445,310,250,78,797.43,448
,20170616,20505,20445,20370,20795,20370,20545,20585,100,140,32,329.41,452
,20170619,20545,20585,20525,20660,20420,20540,20580,-45,-5,36,370.47,438
,20170620,20540,20580,20750,20780,20660,20780,20755,200,175,70,726.45,414
,20170621,20780,20755,20750,20800,20600,20770,20700,15,-55,28,289.84,408
,20170622,20770,20700,21085,21300,21085,21265,21180,565,480,276,"2,923.02",478
,20170623,21265,21180,21585,21805,21440,21805,21510,625,330,474,"5,098.77",490
,20170626,21805,21510,21745,21745,21615,21715,21675,205,165,80,867.10,542
,20170627,21715,21675,21740,22280,21675,22045,21960,370,285,28,307.49,542
,20170628,22045,21960,22090,22170,21940,22170,22055,210,95,166,"1,830.93",628
,20170629,22170,22055,21985,22135,21770,22125,22005,70,-50,30,330.12,628
,20170630,22125,22005,22060,22060,21765,22050,21935,45,-70,20,219.37,626
,20170703,22050,21935,22005,22275,21915,22275,22045,340,110,80,881.87,642
,20170704,22275,22045,22245,22270,22115,22145,22180,100,135,10,110.90,638
,20170705,22145,22180,22265,22380,22120,22120,22285,-60,105,26,289.77,630
,20170706,22120,22285,21985,22150,21900,22150,22000,-135,-285,12,132.03,630
,20170707,22150,22000,22185,22320,22105,22320,22135,320,135,26,287.80,630
,20170710,22320,22135,22410,22410,22080,22285,22245,150,110,16,178.00,630
,20170711,22285,22245,21925,22495,21925,22495,22165,250,-80,64,709.39,636
,20170712,22495,22165,22380,22690,22380,22645,22595,480,430,24,271.15,632
,20170713,22645,22595,22685,22820,22540,22820,22720,225,125,58,658.95,644
,20170714,22820,22720,22790,22790,22400,22415,22535,-305,-185,42,473.27,640
,20170717,22415,22535,22550,22890,22540,22890,22710,355,175,10,113.57,640
,20170718,22890,22710,22930,22930,22600,22600,22820,-110,110,28,319.52,628
,20170719,22600,22820,22520,22545,22430,22510,22495,-310,-325,28,315.00,640
,20170720,22510,22495,22325,22355,22100,22270,22285,-225,-210,148,"1,649.29",710
,20170721,22270,22285,22295,22300,22080,22265,22225,-20,-60,72,800.25,734
,20170724,22265,22225,22410,22550,22235,22490,22460,265,235,28,314.49,716
,20170725,22490,22460,22435,22695,22435,22685,22580,225,120,18,203.25,724
,20170726,22685,22580,22705,22935,22705,22885,22845,305,265,26,296.99,724
,20170727,22885,22845,22665,22665,22600,22600,22625,-245,-220,18,203.63,728
,20170728,22600,22625,22735,22735,22410,22475,22530,-150,-95,40,450.62,740
,20170731,22475,22530,22500,22740,22365,22740,22535,210,5,22,247.90,740
,20170801,22740,22535,22670,22685,22485,22485,22640,-50,105,76,860.42,772
,20170802,22485,22640,22360,22485,22305,22345,22350,-295,-290,50,558.79,778
,20170803,22345,22350,22465,22840,22460,22630,22650,280,300,66,747.60,792
,20170804,22630,22650,22640,22915,22505,22880,22610,230,-40,38,429.68,792
,20170807,22880,22610,22820,22950,22685,22860,22820,250,210,48,547.70,788
,20170808,22860,22820,22995,23465,22995,23400,23365,580,545,110,"1,285.14",768
,20170809,23400,23365,23305,23890,23305,23890,23575,525,210,16,188.63,768
,20170810,23890,23575,24045,24095,23710,23725,23930,150,355,46,550.45,772
,20170811,23725,23930,23635,23745,23470,23610,23555,-320,-375,52,612.48,770
,20170814,23610,23555,23395,23580,23220,23460,23390,-95,-165,262,"3,064.52",828
,20170815,23460,23390,23335,23645,23325,23555,23460,165,70,64,750.76,832
,20170816,23555,23460,23535,23900,23535,23900,23820,440,360,32,381.18,846
,20170817,23900,23820,24340,25245,24340,25230,25095,1410,1275,166,"2,083.01",962
,20170818,25230,25095,25030,25190,24675,25060,24900,-35,-195,174,"2,166.70",938
,20170821,25060,24900,25335,25540,24760,25280,25155,380,255,60,754.73,936
,20170822,25280,25155,25300,25300,24885,25020,25080,-135,-75,18,225.74,934
,20170823,25020,25080,25135,25250,24710,24945,24885,-135,-195,62,771.47,930
,20170824,24945,24885,25145,25145,24900,24900,25020,15,135,4,50.05,930
,20170825,24900,25020,25090,25245,24970,25175,25115,155,95,102,"1,280.91",916
,20170828,25175,25115,25130,25130,24575,24800,24815,-315,-300,52,645.29,888
,20170829,24800,24815,24940,24980,24695,24695,24945,-120,130,86,"1,072.67",874
,20170830,24695,24945,24805,25225,24610,25110,25090,165,145,168,"2,107.60",946
,20170831,25110,25090,24915,24945,24810,24810,24875,-280,-215,18,223.89,944
,20170901,24810,24875,24970,25315,24970,25130,25145,255,270,16,201.20,948
,20170904,25130,25145,25160,25675,25160,25450,25405,305,260,90,"1,143.33",910
,20170905,25450,25405,25430,25575,25405,25495,25525,90,120,60,765.86,892
,20170906,25495,25525,25335,25335,24400,24510,24830,-1015,-695,82,"1,018.03",894
,20170907,24510,24830,24625,24640,24400,24400,24520,-430,-310,18,220.70,886
,20170908,24400,24520,24540,24540,23920,23920,24250,-600,-270,6,72.76,884
,20170911,23920,24250,23930,24305,23790,24275,23865,25,-385,114,"1,360.57",802
,20170912,24275,23865,24345,24640,24335,24640,24415,775,550,14,170.92,800
,20170913,24640,24415,24405,24475,24180,24180,24265,-235,-150,12,145.60,806
,20170914,24180,24265,,,,24265,24265,0,0,0,0.00,806
,20170915,24265,24265,24400,24400,24215,24215,24345,-50,80,10,121.75,802
,20170918,24215,24345,24140,24400,24075,24400,24185,55,-160,10,120.93,796
,20170919,24400,24185,24550,24930,24460,24820,24745,635,560,48,593.99,794
,20170920,24820,24745,24595,24900,24415,24900,24690,155,-55,26,320.98,808
,20170921,24900,24690,24665,24665,24645,24650,24650,-40,-40,6,73.96,808
,20170922,24650,24650,24520,24520,23800,23800,24040,-850,-610,24,288.51,800
,20170925,23800,24040,24190,24580,23825,24560,24170,520,130,60,725.17,776
,20170926,24560,24170,24500,24990,24470,24845,24745,675,575,36,445.47,762
,20170927,24845,24745,24840,25100,24735,25045,24975,300,230,20,249.76,758
,20170928,25045,24975,25000,25000,24795,24820,24840,-155,-135,30,372.61,746
,20170929,24820,24840,25310,25310,24925,25215,25130,375,290,18,226.20,738
,20171009,25215,25130,25615,26150,25615,25755,25870,625,740,50,646.78,744
,20171010,25755,25870,25820,26015,25120,25320,25665,-550,-205,128,"1,642.71",758
,20171011,25320,25665,25370,25715,25120,25420,25395,-245,-270,30,380.95,774
,20171012,25420,25395,25190,25415,24850,25320,25200,-75,-195,102,"1,285.32",772
,20171013,25320,25200,25690,25690,25370,25435,25520,235,320,50,638.08,788
,20171016,25435,25520,25555,25555,25300,25300,25425,-220,-95,4,50.86,788
,20171017,25300,25425,25625,25625,25085,25155,25425,-270,0,40,508.53,806
,20171018,25155,25425,24630,24645,24300,24575,24410,-850,-1015,92,"1,123.03",810
,20171019,24575,24410,24780,24780,24585,24585,24720,175,310,14,173.06,808
,20171020,24585,24720,24580,24840,24535,24840,24650,120,-70,14,172.57,814
,20171023,24840,24650,24795,24795,24795,24795,24795,145,145,2,24.80,812
,20171024,24795,24795,25110,25130,25100,25100,25110,305,315,44,552.43,788
,20171025,25100,25110,24980,25160,24975,25000,25060,-110,-50,24,300.76,780
,20171026,25000,25060,25115,25485,25090,25485,25305,425,245,40,506.13,766
,20171027,25485,25305,25485,25500,25255,25295,25445,-10,140,290,"3,689.73",764
,20171030,25295,25445,25035,25365,25025,25240,25220,-205,-225,72,908.10,738
,20171031,25240,25220,25315,25665,25250,25665,25370,445,150,38,482.07,742
,20171101,25665,25370,25560,26220,25560,25775,26000,405,630,552,"7,177.03",980
,20171102,25775,26000,27200,27200,25550,25560,25885,-440,-115,94,"1,216.68",982
,20171103,25560,25885,25560,25805,25560,25760,25695,-125,-190,194,"2,492.56",1046
,20171106,25760,25695,25660,26000,25600,25970,25820,275,125,830,"10,716.03",1548
,20171107,25970,25820,25990,26045,25655,25735,25795,-85,-25,1826,"23,554.93",2656
,20171108,25735,25795,25665,25715,25320,25370,25485,-425,-310,890,"11,342.55",2798
,20171109,25370,25485,25495,25585,25250,25475,25405,-10,-80,1496,"19,004.66",3456
,20171110,25475,25405,25480,25680,25355,25555,25535,150,130,1230,"15,705.67",4000
,20171113,25555,25535,25750,25865,25640,25805,25765,270,230,780,"10,049.31",4430
,20171114,25805,25765,25685,25880,25660,25780,25775,15,10,1930,"24,876.49",5576
,20171115,25780,25775,25660,25735,24990,25045,25250,-730,-525,1008,"12,727.60",5534
,20171116,25045,25250,25120,25140,24895,24975,25030,-275,-220,1512,"18,924.41",6318
,20171117,24975,25030,25090,25210,24785,25060,25040,30,10,614,"7,688.27",6452
,20171120,25060,25040,25090,25390,25040,25130,25180,90,140,1620,"20,396.90",7170
,20171121,25130,25180,25155,25305,24825,25135,25075,-45,-105,2940,"36,860.48",8322
,20171122,25135,25075,25215,25760,25190,25625,25400,550,325,3160,"40,132.71",9448
,20171123,25625,25400,25610,25695,25470,25495,25610,95,210,504,"6,454.13",9496
,20171124,25495,25610,25535,25645,25375,25530,25505,-80,-105,526,"6,708.04",9538
,20171127,25530,25505,25580,25580,24970,25000,25230,-505,-275,1330,"16,780.95",9434
,20171128,25000,25230,25015,25100,24560,24650,24840,-580,-390,3794,"47,123.31",8778
,20171129,24650,24840,24715,24910,24550,24635,24745,-205,-95,3784,"46,820.59",8940
,20171130,24635,24745,24525,24835,24425,24800,24635,55,-110,2412,"29,710.10",8970
,20171201,24800,24635,24860,25115,24695,25000,24915,365,280,2404,"29,950.61",8776
,20171204,25000,24915,25040,25885,25040,25405,25470,490,555,5142,"65,489.72",9234
,20171205,25405,25470,25350,25460,25005,25005,25260,-465,-210,3594,"45,394.35",9216
,20171206,25005,25260,25005,25010,24160,24375,24485,-885,-775,6092,"74,593.88",10104
,20171207,24375,24485,24490,24680,24245,24385,24470,-100,-15,4504,"55,113.91",10890
,20171208,24385,24470,24420,24590,24045,24530,24345,60,-125,5108,"62,186.36",11248
,20171211,24530,24345,24505,24820,24365,24475,24575,130,230,5194,"63,826.59",11930
,20171212,24475,24575,24565,25090,24470,24855,24815,280,240,7268,"90,182.75",13342
,20171213,24855,24815,25095,25140,24845,25080,25015,265,200,11858,"148,331.97",14284
,20171214,25080,25015,25080,25260,24895,24975,25055,-40,40,10466,"131,127.86",16150
,20171215,24975,25055,25020,25250,25010,25230,25135,175,80,7006,"88,063.16",17158
,20171218,25230,25135,25205,25540,25150,25485,25375,350,240,12860,"163,177.71",18250
,20171219,25485,25375,25430,25450,25110,25160,25290,-215,-85,7174,"90,727.66",19620
,20171220,25160,25290,25200,25490,25145,25415,25330,125,40,8720,"110,449.26",19746
,20171221,25415,25330,25460,25610,25235,25380,25400,50,70,11640,"147,837.44",21016
,20171222,25380,25400,25400,25500,25275,25475,25405,75,5,12944,"164,439.54",22058
,20171225,25475,25405,25420,25835,25195,25200,25515,-205,110,13654,"174,216.25",22704
,20171226,25200,25515,25210,25470,25210,25430,25320,-85,-195,9012,"114,093.42",23724
,20171227,25430,25320,25450,25520,25255,25300,25360,-20,40,10966,"139,063.29",26018
,20171228,25300,25360,25400,25795,25350,25680,25525,320,165,31062,"396,484.12",28648
,20171229,25680,25525,25650,25730,25545,25680,25645,155,120,25616,"328,478.12",29026
zn1805,20170516,20480,20480,20560,20605,20215,20215,20395,-265,-85,12,122.40,10
,20170517,20215,20395,20155,20465,20155,20465,20355,70,-40,32,325.75,36
,20170518,20465,20355,20355,20440,20275,20400,20350,45,-5,28,284.94,46
,20170519,20400,20350,19875,20855,19845,20480,20375,130,25,36,366.81,58
,20170522,20480,20375,20890,21295,20890,21010,21030,635,655,104,"1,093.57",114
,20170523,21010,21030,21095,21145,21005,21005,21100,-25,70,116,"1,224.00",198
,20170524,21005,21100,21130,21130,20850,20950,20950,-150,-150,44,460.94,216
,20170525,20950,20950,20885,21015,20885,20935,20925,-15,-25,22,230.22,220
,20170526,20935,20925,20945,21220,20945,21220,21115,295,190,260,"2,745.50",418
,20170531,21220,21115,21225,21225,20955,20955,21110,-160,-5,32,337.77,426
,20170601,20955,21110,20950,20970,20700,20700,20860,-410,-250,46,479.81,424
,20170602,20700,20860,20715,21225,20700,20835,20970,-25,110,174,"1,824.49",384
,20170605,20835,20970,20760,20760,20305,20355,20575,-615,-395,124,"1,275.93",382
,20170606,20355,20575,20210,20285,20105,20110,20145,-465,-430,20,201.47,386
,20170607,20110,20145,20080,20255,19885,19885,20080,-260,-65,68,682.73,408
,20170608,19885,20080,19990,20280,19880,20220,19960,140,-120,236,"2,355.71",440
,20170609,20220,19960,20190,20190,20050,20090,20110,130,150,148,"1,488.43",484
,20170612,20090,20110,20285,20395,20085,20395,20225,285,115,236,"2,386.81",570
,20170613,20395,20225,20230,20475,19995,20035,20335,-190,110,142,"1,443.89",578
,20170614,20035,20335,20005,20290,20005,20290,20170,-45,-165,38,383.25,572
,20170615,20290,20170,20245,20505,20245,20450,20375,280,205,86,876.32,570
,20170616,20450,20375,20345,20700,20340,20495,20525,120,150,36,369.53,572
,20170619,20495,20525,20405,20650,20360,20585,20480,60,-45,88,901.26,558
,20170620,20585,20480,20595,20755,20595,20755,20690,275,210,44,455.20,558
,20170621,20755,20690,20535,20790,20535,20775,20760,85,70,42,436.00,560
,20170622,20775,20760,20810,21300,20810,21235,21190,475,430,614,"6,505.96",852
,20170623,21235,21190,21505,21855,21350,21855,21485,665,295,276,"2,965.06",958
,20170626,21855,21485,21695,21745,21585,21685,21680,200,195,192,"2,081.38",1080
,20170627,21685,21680,21685,22040,21660,22040,21840,360,160,82,895.53,1134
,20170628,22040,21840,22045,22100,21880,22025,22005,185,165,232,"2,552.62",1262
,20170629,22025,22005,21945,22095,21795,22050,22010,45,5,114,"1,254.78",1274
,20170630,22050,22010,21975,22045,21700,21900,21885,-110,-125,30,328.34,1276
,20170703,21900,21885,21985,22260,21900,22260,22030,375,145,82,903.25,1278
,20170704,22260,22030,22070,22220,21995,22035,22125,5,95,38,420.41,1282
,20170705,22035,22125,22000,22260,22000,22075,22185,-50,60,70,776.62,1292
,20170706,22075,22185,21915,22145,21785,22050,21925,-135,-260,62,679.81,1300
,20170707,22050,21925,21760,22255,21760,22240,22090,315,165,42,463.99,1304
,20170710,22240,22090,22345,22365,21940,21940,22195,-150,105,38,421.76,1314
,20170711,21940,22195,21865,22370,21805,22370,22115,175,-80,80,884.65,1332
,20170712,22370,22115,22300,22640,22300,22600,22565,485,450,126,"1,421.61",1338
,20170713,22600,22565,22600,22795,22530,22780,22635,215,70,132,"1,494.04",1340
,20170714,22780,22635,22790,22790,22320,22370,22475,-265,-160,66,741.78,1310
,20170717,22370,22475,22420,22980,22410,22900,22710,425,235,114,"1,294.67",1268
,20170718,22900,22710,22750,22930,22375,22460,22720,-250,10,72,817.98,1262
,20170719,22460,22720,22420,22565,22345,22460,22435,-260,-285,66,740.48,1248
,20170720,22460,22435,22405,22405,22045,22200,22190,-235,-245,88,976.47,1230
,20170721,22200,22190,22195,22225,22015,22205,22150,15,-40,28,310.13,1238
,20170724,22205,22150,22300,22495,22135,22410,22295,260,145,68,758.19,1244
,20170725,22410,22295,22385,22610,22385,22610,22510,315,215,46,517.79,1246
,20170726,22610,22510,22650,22895,22515,22630,22755,120,245,122,"1,388.25",1198
,20170727,22630,22755,22650,22660,22540,22630,22585,-125,-170,64,722.74,1192
,20170728,22630,22585,22685,22695,22360,22400,22505,-185,-80,48,540.13,1192
,20170731,22400,22505,22410,22730,22360,22685,22540,180,35,46,518.42,1190
,20170801,22685,22540,22605,22605,22300,22300,22480,-240,-60,30,337.27,1186
,20170802,22300,22480,22360,22390,22200,22310,22290,-170,-190,68,758.03,1176
,20170803,22310,22290,22425,22760,22395,22560,22520,270,230,84,945.86,1164
,20170804,22560,22520,22450,22785,22400,22750,22560,230,40,54,609.20,1172
,20170807,22750,22560,22705,22880,22580,22730,22705,170,145,142,"1,612.35",1158
,20170808,22730,22705,22805,23420,22805,23165,23210,460,505,88,"1,021.45",1146
,20170809,23165,23210,23200,24050,23155,24045,23645,835,435,160,"1,891.95",1148
,20170810,24045,23645,23900,24005,23600,23605,23815,-40,170,520,"6,192.09",1148
,20170811,23605,23815,23550,23685,23220,23220,23485,-595,-330,496,"5,825.41",1108
,20170814,23220,23485,23305,23425,23115,23265,23335,-220,-150,88,"1,026.74",1120
,20170815,23265,23335,23250,23590,23250,23535,23470,200,135,78,915.37,1118
,20170816,23535,23470,23480,23840,23480,23780,23625,310,155,68,803.36,1112
,20170817,23780,23625,24150,25040,24150,25010,24810,1385,1185,512,"6,352.64",1190
,20170818,25010,24810,24900,25045,24550,24875,24815,65,5,254,"3,151.80",1196
,20170821,24875,24815,25055,25215,24590,24900,24855,85,40,456,"5,666.94",1112
,20170822,24900,24855,24955,25115,24800,24995,24940,140,85,162,"2,020.36",1110
,20170823,24995,24940,24975,25000,24565,24760,24740,-180,-200,244,"3,018.67",1072
,20170824,24760,24740,24755,25000,24685,24700,24845,-40,105,80,993.97,1074
,20170825,24700,24845,24880,25065,24795,25030,24920,185,75,116,"1,445.63",1092
,20170828,25030,24920,25040,25040,24300,24695,24650,-225,-270,220,"2,711.96",1060
,20170829,24695,24650,24815,24850,24500,24585,24680,-65,30,116,"1,431.60",1082
,20170830,24585,24680,24660,25030,24440,25025,24850,345,170,168,"2,087.74",1094
,20170831,25025,24850,25020,25020,24620,24725,24745,-125,-105,198,"2,449.91",1106
,20170901,24725,24745,24875,25175,24850,25130,25030,385,285,188,"2,352.94",1108
,20170904,25130,25030,25055,25545,25055,25220,25310,190,280,146,"1,847.85",1106
,20170905,25220,25310,25280,25425,25215,25325,25325,15,15,218,"2,760.48",1202
,20170906,25325,25325,25220,25320,24155,24380,24765,-945,-560,332,"4,111.35",1184
,20170907,24380,24765,24360,24595,24200,24250,24390,-515,-375,142,"1,732.04",1152
,20170908,24250,24390,24420,24545,23855,23915,24305,-475,-85,204,"2,479.53",1096
,20170911,23915,24305,23485,24235,23485,24235,23840,-70,-465,246,"2,932.58",1100
,20170912,24235,23840,24040,24515,24040,24450,24335,610,495,76,924.74,1102
,20170913,24450,24335,24340,24385,24115,24205,24325,-130,-10,52,632.58,1086
,20170914,24205,24325,23990,24140,23835,23905,23985,-420,-340,92,"1,103.53",1078
,20170915,23905,23985,23950,24280,23870,23910,24115,-75,130,106,"1,278.24",1092
,20170918,23910,24115,24020,24450,23570,24405,24150,290,35,236,"2,850.25",1112
,20170919,24405,24150,24450,24725,24305,24520,24580,370,430,268,"3,293.74",1126
,20170920,24520,24580,24415,24855,24210,24750,24560,170,-20,330,"4,052.78",1134
,20170921,24750,24560,24850,24880,24100,24355,24500,-205,-60,258,"3,160.82",1190
,20170922,24355,24500,24125,24650,23710,23910,24135,-590,-365,812,"9,800.63",1394
,20170925,23910,24135,24040,24550,23700,24355,24185,220,50,420,"5,079.67",1470
,20170926,24355,24185,24430,24900,24340,24750,24595,565,410,524,"6,444.53",1506
,20170927,24750,24595,24750,25050,24630,25035,24805,440,210,302,"3,745.72",1556
,20170928,25035,24805,24980,25005,24625,24905,24810,100,5,876,"10,867.88",2020
,20170929,24905,24810,24920,25310,24820,25310,25045,500,235,532,"6,662.22",2234
,20171009,25310,25045,25565,26075,25510,25845,25860,800,815,554,"7,164.30",2458
,20171010,25845,25860,25845,25845,25150,25235,25540,-625,-320,1068,"13,638.63",2740
,20171011,25235,25540,25235,25675,25175,25390,25400,-150,-140,966,"12,269.66",2910
,20171012,25390,25400,25350,25370,24875,25250,25070,-150,-330,1106,"13,864.38",2958
,20171013,25250,25070,25345,25555,25180,25405,25345,335,275,534,"6,768.45",3056
,20171016,25405,25345,25345,25560,24860,25480,25270,135,-75,1222,"15,440.20",3200
,20171017,25480,25270,25430,25630,24720,24835,25115,-435,-155,916,"11,503.26",3236
,20171018,24835,25115,24630,24690,24120,24415,24370,-700,-745,1588,"19,349.93",3408
,20171019,24415,24370,24505,24675,24335,24430,24525,60,155,966,"11,846.82",3496
,20171020,24430,24525,24380,24850,24300,24695,24595,170,70,774,"9,518.61",3514
,20171023,24695,24595,24690,24770,24350,24665,24600,70,5,724,"8,906.87",3594
,20171024,24665,24600,24650,25070,24640,25000,24935,400,335,790,"9,851.22",3630
,20171025,25000,24935,25075,25105,24825,24905,24970,-30,35,470,"5,868.84",3592
,20171026,24905,24970,25045,25425,24985,25310,25215,340,245,854,"10,768.83",3544
,20171027,25310,25215,25345,25420,25020,25095,25270,-120,55,920,"11,625.25",3448
,20171030,25095,25270,24925,25275,24920,25195,25120,-75,-150,814,"10,224.66",3482
,20171031,25195,25120,25195,25625,25120,25530,25385,410,265,888,"11,271.42",3614
,20171101,25530,25385,25540,26195,25425,25650,25845,265,460,1504,"19,439.02",3822
,20171102,25650,25845,25670,25740,25450,25510,25590,-335,-255,636,"8,138.91",3846
,20171103,25510,25590,25490,25785,25385,25680,25615,90,25,1428,"18,289.66",4070
,20171106,25680,25615,25580,25935,25535,25855,25725,240,110,2258,"29,047.46",4630
,20171107,25855,25725,25800,25970,25610,25705,25795,-20,70,1868,"24,093.24",4946
,20171108,25705,25795,25645,25745,25300,25350,25490,-445,-305,1772,"22,586.36",4868
,20171109,25350,25490,25435,25535,25200,25450,25380,-40,-110,1756,"22,287.02",5096
,20171110,25450,25380,25425,25620,25350,25545,25495,165,115,1824,"23,254.30",5518
,20171113,25545,25495,25720,25830,25610,25765,25720,270,225,2752,"35,395.29",6710
,20171114,25765,25720,25650,25870,25610,25775,25760,55,40,2972,"38,283.22",7540
,20171115,25775,25760,25645,25745,24955,25000,25195,-760,-565,5332,"67,175.09",7694
,20171116,25000,25195,25125,25145,24915,25010,25035,-185,-160,3846,"48,143.49",8556
,20171117,25010,25035,25160,25280,24710,25090,25035,55,0,3260,"40,812.54",9630
,20171120,25090,25035,25110,25390,25015,25145,25185,110,150,4600,"57,930.14",10220
,20171121,25145,25185,25220,25275,24830,25195,25050,10,-135,4816,"60,331.00",10220
,20171122,25195,25050,25250,25800,25160,25605,25495,555,445,4958,"63,212.78",10922
,20171123,25605,25495,25680,25695,25465,25470,25585,-25,90,2428,"31,064.91",11072
,20171124,25470,25585,25580,25615,25375,25525,25495,-60,-90,3228,"41,151.79",11216
,20171127,25525,25495,25625,25630,24960,24975,25275,-520,-220,6584,"83,220.71",11366
,20171128,24975,25275,24970,25125,24570,24665,24845,-610,-430,14040,"174,422.38",14816
,20171129,24665,24845,24700,24925,24530,24675,24760,-170,-85,14070,"174,202.39",19816
,20171130,24675,24760,24620,24850,24435,24825,24680,65,-80,13440,"165,862.23",22888
,20171201,24825,24680,24920,25120,24705,25000,24905,320,225,12758,"158,876.29",24846
,20171204,25000,24905,25040,25885,25040,25440,25440,535,535,16308,"207,478.30",25740
,20171205,25440,25440,25455,25465,24980,24980,25265,-460,-175,11416,"144,238.35",26624
,20171206,24980,25265,24905,24990,24160,24300,24535,-965,-730,15702,"192,653.45",27712
,20171207,24300,24535,24365,24660,24170,24325,24430,-210,-105,15878,"193,982.60",31082
,20171208,24325,24430,24330,24565,23990,24510,24265,80,-165,25476,"309,112.18",32712
,20171211,24510,24265,24420,24780,24310,24440,24545,175,280,18830,"231,092.76",32324
,20171212,24440,24545,24500,25075,24405,24800,24745,255,200,22042,"272,729.97",32434
,20171213,24800,24745,25025,25100,24805,25040,24960,295,215,16636,"207,618.85",34202
,20171214,25040,24960,25030,25195,24825,24895,24995,-65,35,15120,"188,994.80",35732
,20171215,24895,24995,25035,25190,24940,25170,25075,175,80,21532,"269,996.80",38644
,20171218,25170,25075,25175,25485,25025,25435,25295,360,220,23430,"296,378.42",40326
,20171219,25435,25295,25390,25395,25050,25080,25220,-215,-75,20212,"254,897.72",41184
,20171220,25080,25220,25110,25485,25085,25355,25260,135,40,20802,"262,729.55",42460
,20171221,25355,25260,25415,25535,25180,25335,25355,75,95,20838,"264,207.88",42924
,20171222,25335,25355,25380,25450,25230,25430,25345,75,-10,20090,"254,634.87",43324
,20171225,25430,25345,25480,25780,25140,25175,25460,-170,115,29838,"379,893.35",43832
,20171226,25175,25460,25195,25420,25150,25390,25265,-70,-195,16748,"211,606.77",45954
,20171227,25390,25265,25395,25465,25210,25250,25310,-15,45,20660,"261,497.32",47008
,20171228,25250,25310,25310,25755,25305,25660,25470,350,160,39766,"506,446.60",54254
,20171229,25660,25470,25600,25700,25520,25700,25615,230,145,26130,"334,661.42",54846
zn1806,20170616,20375,20375,,,,20375,20375,0,0,0,0.00,0
,20170619,20375,20375,,,,20375,20375,0,0,0,0.00,0
,20170620,20375,20375,20680,20685,20625,20625,20670,250,295,14,144.71,12
,20170621,20625,20670,,,,20670,20670,0,0,0,0.00,12
,20170622,20670,20670,20965,21230,20965,21230,21080,560,410,208,"2,192.82",178
,20170623,21230,21080,21300,21845,21300,21845,21445,765,365,196,"2,101.98",288
,20170626,21845,21445,21330,21830,21325,21700,21625,255,180,110,"1,189.40",328
,20170627,21700,21625,21730,22225,21625,22005,21905,380,280,24,262.89,330
,20170628,22005,21905,22020,22080,21935,21975,22010,70,105,68,748.40,334
,20170629,21975,22010,21830,22025,21790,21990,21930,-20,-80,14,153.52,334
,20170630,21990,21930,22015,22015,21810,21975,21905,45,-25,28,306.67,338
,20170703,21975,21905,21960,22390,21845,22205,21980,300,75,96,"1,055.16",332
,20170704,22205,21980,22140,22170,21900,21950,22095,-30,115,50,552.43,326
,20170705,21950,22095,22060,22290,21835,21835,22175,-260,80,34,376.98,326
,20170706,21835,22175,21835,22005,21825,22005,21895,-170,-280,78,854.04,336
,20170707,22005,21895,22110,22190,21950,22190,22025,295,130,54,594.78,320
,20170710,22190,22025,22250,22250,22250,22250,22250,225,225,2,22.25,320
,20170711,22250,22250,21810,22365,21795,22365,22090,115,-160,68,751.16,342
,20170712,22365,22090,22325,22625,22325,22535,22515,445,425,78,878.20,338
,20170713,22535,22515,22615,22730,22455,22710,22575,195,60,68,767.65,340
,20170714,22710,22575,22660,22660,22275,22360,22435,-215,-140,54,605.75,338
,20170717,22360,22435,22355,22800,22345,22800,22460,365,25,72,808.56,342
,20170718,22800,22460,22750,22815,22400,22410,22570,-50,110,48,541.71,346
,20170719,22410,22570,22390,22415,22320,22415,22370,-155,-200,18,201.34,346
,20170720,22415,22370,22220,22245,22000,22090,22120,-280,-250,110,"1,216.61",380
,20170721,22090,22120,22180,22180,21875,22160,22105,40,-15,106,"1,171.61",434
,20170724,22160,22105,22260,22465,22065,22380,22290,275,185,108,"1,203.85",458
,20170725,22380,22290,22295,22555,22295,22555,22400,265,110,28,313.65,470
,20170726,22555,22400,22745,22825,22660,22665,22725,265,325,40,454.58,466
,20170727,22665,22725,22560,22615,22465,22580,22515,-145,-210,40,450.32,468
,20170728,22580,22515,22590,22590,22315,22315,22430,-200,-85,18,201.88,474
,20170731,22315,22430,22295,22600,22245,22600,22435,170,5,26,291.66,476
,20170801,22600,22435,22535,22535,22335,22345,22455,-90,20,14,157.20,470
,20170802,22345,22455,22310,22310,22095,22095,22185,-360,-270,10,110.94,472
,20170803,22095,22185,22330,22680,22330,22640,22520,455,335,56,630.59,490
,20170804,22640,22520,22405,22645,22405,22645,22490,125,-30,30,337.42,496
,20170807,22645,22490,22535,22740,22500,22620,22615,130,125,24,271.40,502
,20170808,22620,22615,22800,23360,22800,23120,23135,505,520,26,300.81,504
,20170809,23120,23135,23085,23850,23040,23850,23440,715,305,76,890.76,506
,20170810,23850,23440,23895,23955,23525,23625,23710,185,270,40,474.25,498
,20170811,23625,23710,23365,23630,23170,23170,23360,-540,-350,54,630.81,498
,20170814,23170,23360,23205,23315,23150,23300,23245,-60,-115,18,209.23,500
,20170815,23300,23245,23160,23510,23160,23510,23345,265,100,22,256.83,508
,20170816,23510,23345,23410,23805,23400,23800,23570,455,225,38,447.92,506
,20170817,23800,23570,24090,24980,24090,24980,24720,1410,1150,94,"1,162.04",528
,20170818,24980,24720,24805,24900,24480,24730,24700,10,-20,50,617.61,532
,20170821,24730,24700,24920,25110,24405,24830,24835,130,135,94,"1,167.25",546
,20170822,24830,24835,24660,24870,24660,24685,24770,-150,-65,30,371.57,538
,20170823,24685,24770,24625,24705,24440,24640,24605,-130,-165,50,615.15,552
,20170824,24640,24605,24635,24830,24565,24600,24650,-5,45,34,419.07,536
,20170825,24600,24650,24700,24900,24700,24900,24745,250,95,16,197.97,536
,20170828,24900,24745,24980,24980,24305,24495,24560,-250,-185,14,171.92,534
,20170829,24495,24560,24650,24650,24375,24495,24515,-65,-45,30,367.78,528
,20170830,24495,24515,24555,24800,24320,24800,24515,285,0,40,490.34,522
,20170831,24800,24515,24600,24685,24475,24545,24565,30,50,28,343.98,522
,20170901,24545,24565,24780,25030,24700,24970,24830,405,265,62,769.84,512
,20170904,24970,24830,24860,25335,24860,25160,25025,330,195,36,450.46,496
,20170905,25160,25025,25055,25230,25045,25180,25160,155,135,48,603.87,478
,20170906,25180,25160,25045,25075,24300,24300,24555,-860,-605,56,687.63,470
,20170907,24300,24555,24390,24420,24390,24395,24400,-160,-155,6,73.21,470
,20170908,24395,24400,24250,24400,23655,23655,24055,-745,-345,32,384.92,468
,20170911,23655,24055,23755,23765,23305,23685,23510,-370,-545,46,540.75,454
,20170912,23685,23510,24115,24210,24090,24210,24120,700,610,14,168.85,450
,20170913,24210,24120,24085,24210,24000,24000,24105,-120,-15,8,96.42,448
,20170914,24000,24105,,,,24105,24105,0,0,0,0.00,448
,20170915,24105,24105,,,,24105,24105,0,0,0,0.00,448
,20170918,24105,24105,23965,24145,23655,24145,23960,40,-145,30,359.41,450
,20170919,24145,23960,24320,24645,24205,24605,24435,645,475,38,464.36,456
,20170920,24605,24435,24425,24430,24155,24310,24300,-125,-135,30,364.56,442
,20170921,24310,24300,24650,24650,24180,24180,24410,-120,110,6,73.23,444
,20170922,24180,24410,24180,24430,23495,23635,23860,-775,-550,46,548.79,438
,20170925,23635,23860,23900,24380,23580,24240,23795,380,-65,156,"1,856.23",464
,20170926,24240,23795,24235,24695,24235,24615,24545,820,750,36,441.89,474
,20170927,24615,24545,24610,24920,24495,24850,24680,305,135,64,789.78,486
,20170928,24850,24680,24810,24810,24555,24710,24680,30,0,110,"1,357.51",444
,20170929,24710,24680,25050,25290,24700,25290,24935,610,255,62,773.13,438
,20171009,25290,24935,25795,25975,25520,25765,25805,830,870,68,877.49,400
,20171010,25765,25805,25655,25655,25205,25205,25440,-600,-365,46,585.21,416
,20171011,25205,25440,25355,25520,25130,25205,25230,-235,-210,42,529.91,428
,20171012,25205,25230,24860,25045,24740,25045,24870,-185,-360,56,696.41,420
,20171013,25045,24870,25280,25315,25225,25315,25280,445,410,30,379.24,440
,20171016,25315,25280,25320,25320,24800,25140,25130,-140,-150,20,251.34,454
,20171017,25140,25130,25290,25320,24605,24605,24955,-525,-175,68,848.63,456
,20171018,24605,24955,24425,24430,24190,24300,24245,-655,-710,158,"1,915.61",406
,20171019,24300,24245,24350,24500,24335,24340,24385,95,140,72,877.95,378
,20171020,24340,24385,24325,24750,24250,24750,24305,365,-80,30,364.65,374
,20171023,24750,24305,,,,24500,24500,195,195,0,0.00,374
,20171024,24500,24500,24600,24995,24580,24890,24735,390,235,28,346.29,364
,20171025,24890,24735,24900,24905,24815,24815,24885,80,150,16,199.11,370
,20171026,24815,24885,24905,25265,24905,25160,25120,275,235,20,251.22,380
,20171027,25160,25120,25255,25265,24955,24955,25175,-165,55,50,629.47,392
,20171030,24955,25175,24875,25165,24875,25075,25005,-100,-170,26,325.13,398
,20171031,25075,25005,25040,25315,25040,25300,25235,295,230,36,454.28,398
,20171101,25300,25235,25695,26050,25570,25570,25725,335,490,24,308.70,410
,20171102,25570,25725,25525,25585,25405,25405,25465,-320,-260,22,280.15,418
,20171103,25405,25465,25410,25685,25335,25640,25555,175,90,150,"1,916.71",480
,20171106,25640,25555,25490,25845,25485,25845,25585,290,30,440,"5,629.16",772
,20171107,25845,25585,25885,25890,25495,25665,25710,80,125,176,"2,262.56",778
,20171108,25665,25710,25610,25610,24955,25350,25425,-360,-285,200,"2,542.90",854
,20171109,25350,25425,25420,25505,25220,25325,25425,-100,0,112,"1,424.06",920
,20171110,25325,25425,25460,25570,25310,25570,25505,145,80,278,"3,545.56",990
,20171113,25570,25505,25845,25845,25635,25780,25710,275,205,24,308.52,994
,20171114,25780,25710,25630,25850,25630,25710,25790,0,80,126,"1,625.00",982
,20171115,25710,25790,25680,25690,25030,25030,25170,-760,-620,156,"1,963.28",964
,20171116,25030,25170,25100,25135,24955,25020,25020,-150,-150,106,"1,326.20",970
,20171117,25020,25020,25120,25170,24900,25090,25085,70,65,50,627.16,968
,20171120,25090,25085,25190,25320,25005,25140,25180,55,95,104,"1,309.46",984
,20171121,25140,25180,25080,25165,24820,25080,25015,-100,-165,76,950.68,962
,20171122,25080,25015,25315,25670,25250,25570,25590,555,575,314,"4,018.22",992
,20171123,25570,25590,25605,25625,25465,25465,25560,-125,-30,38,485.65,996
,20171124,25465,25560,25495,25520,25400,25475,25445,-85,-115,30,381.70,984
,20171127,25475,25445,25525,25540,25050,25050,25355,-395,-90,86,"1,090.34",996
,20171128,25050,25355,25015,25105,24565,24575,24780,-780,-575,150,"1,858.83",996
,20171129,24575,24780,24730,24895,24560,24705,24695,-75,-85,156,"1,926.38",1016
,20171130,24705,24695,24525,24775,24485,24775,24590,80,-105,176,"2,164.15",996
,20171201,24775,24590,24840,25145,24710,24960,24875,370,285,44,547.26,998
,20171204,24960,24875,25215,26130,25200,25395,25485,520,610,208,"2,650.44",1024
,20171205,25395,25485,25370,25385,25025,25025,25185,-460,-300,66,831.18,1008
,20171206,25025,25185,24940,24980,24180,24390,24570,-795,-615,214,"2,629.23",950
,20171207,24390,24570,24415,24620,24300,24340,24455,-230,-115,106,"1,296.29",950
,20171208,24340,24455,24020,24585,24020,24505,24345,50,-110,158,"1,923.61",960
,20171211,24505,24345,24350,24640,24350,24470,24505,125,160,78,955.76,982
,20171212,24470,24505,24430,24960,24430,24720,24655,215,150,28,345.17,986
,20171213,24720,24655,25070,25070,24760,24920,24905,265,250,266,"3,312.41",1134
,20171214,24920,24905,24980,25160,24835,24840,25005,-65,100,56,700.18,1156
,20171215,24840,25005,24990,25115,24990,25110,25060,105,55,426,"5,338.07",1300
,20171218,25110,25060,25060,25465,25060,25365,25245,305,185,288,"3,635.44",1440
,20171219,25365,25245,25190,25275,25015,25015,25160,-230,-85,150,"1,887.12",1534
,20171220,25015,25160,25060,25340,25060,25340,25190,180,30,330,"4,156.89",1698
,20171221,25340,25190,25345,25450,25145,25290,25320,100,130,146,"1,848.66",1756
,20171222,25290,25320,25325,25375,25180,25300,25290,-20,-30,130,"1,644.08",1822
,20171225,25300,25290,25305,25670,25105,25140,25445,-150,155,590,"7,506.64",2064
,20171226,25140,25445,25125,25385,25125,25325,25220,-120,-225,848,"10,693.94",2536
,20171227,25325,25220,25340,25340,25165,25175,25235,-45,15,248,"3,129.56",2628
,20171228,25175,25235,25305,25705,25250,25600,25455,365,220,1504,"19,143.68",3684
,20171229,25600,25455,25610,25665,25465,25620,25545,165,90,944,"12,058.60",4370
zn1807,20170718,22460,22460,,,,22460,22460,0,0,0,0.00,0
,20170719,22460,22460,22495,22495,22275,22275,22385,-185,-75,4,44.77,2
,20170720,22275,22385,22050,22070,21895,22060,22025,-325,-360,12,132.16,10
,20170721,22060,22025,22040,22080,22040,22080,22060,55,35,4,44.12,14
,20170724,22080,22060,22230,22455,22000,22455,22220,395,160,14,155.56,18
,20170725,22455,22220,22400,22575,22400,22575,22445,355,225,8,89.79,22
,20170726,22575,22445,22590,22730,22580,22590,22645,145,200,28,317.07,38
,20170727,22590,22645,22615,22615,22455,22525,22515,-120,-130,16,180.16,42
,20170728,22525,22515,22520,22565,22205,22250,22375,-265,-140,26,290.91,52
,20170731,22250,22375,22295,22550,22170,22550,22295,175,-80,30,334.49,52
,20170801,22550,22295,23630,23630,22225,22225,22470,-70,175,40,449.48,46
,20170802,22225,22470,22190,22270,22115,22150,22195,-320,-275,44,488.32,66
,20170803,22150,22195,22190,22580,22190,22405,22405,210,210,96,"1,075.57",112
,20170804,22405,22405,22325,22640,22245,22640,22415,235,10,40,448.35,124
,20170807,22640,22415,22440,22700,22205,22530,22465,115,50,38,426.91,122
,20170808,22530,22465,22705,23120,22705,23120,22975,655,510,18,206.82,122
,20170809,23120,22975,23015,23900,23015,23900,23445,925,470,74,867.56,132
,20170810,23900,23445,23780,23780,23415,23490,23540,45,95,70,823.98,132
,20170811,23490,23540,23360,23580,23250,23330,23350,-210,-190,24,280.23,132
,20170814,23330,23350,23120,23235,23070,23120,23155,-230,-195,64,741.04,140
,20170815,23120,23155,23265,23410,23265,23410,23355,255,200,6,70.08,142
,20170816,23410,23355,23275,23700,23275,23700,23500,345,145,24,282.05,146
,20170817,23700,23500,23995,24910,23995,24830,24595,1330,1095,264,"3,246.98",308
,20170818,24830,24595,23855,24705,23855,24655,24565,60,-30,96,"1,179.28",324
,20170821,24655,24565,24820,25000,24285,24735,24685,170,120,104,"1,283.78",318
,20170822,24735,24685,24615,24715,24500,24595,24570,-90,-115,28,343.98,312
,20170823,24595,24570,24560,24560,24220,24485,24330,-85,-240,28,340.66,310
,20170824,24485,24330,24700,24715,24400,24400,24510,70,180,16,196.10,322
,20170825,24400,24510,24645,24645,24480,24495,24525,-15,15,26,318.88,316
,20170828,24495,24525,24390,24390,24010,24350,24205,-175,-320,62,750.49,318
,20170829,24350,24205,24415,24575,24215,24215,24425,10,220,38,464.15,294
,20170830,24215,24425,24400,24725,24265,24655,24495,230,70,38,465.42,284
,20170831,24655,24495,24415,24415,24355,24355,24385,-140,-110,4,48.77,284
,20170901,24355,24385,24460,24750,24460,24750,24650,365,265,8,98.60,286
,20170904,24750,24650,24610,25235,24610,24995,25000,345,350,18,225.00,286
,20170905,24995,25000,24965,25130,24965,25040,25045,40,45,6,75.14,284
,20170906,25040,25045,24910,24910,24220,24220,24660,-825,-385,10,123.32,286
,20170907,24220,24660,24260,24260,23965,23965,24025,-695,-635,32,384.42,286
,20170908,23965,24025,24020,24410,23800,23800,24105,-225,80,22,265.16,280
,20170911,23800,24105,23595,23640,23350,23510,23485,-595,-620,72,845.54,254
,20170912,23510,23485,23990,23990,23965,23965,23975,480,490,4,47.96,254
,20170913,23965,23975,24050,24050,23770,23980,23920,5,-55,10,119.61,258
,20170914,23980,23920,23880,23880,23880,23880,23880,-40,-40,2,23.88,260
,20170915,23880,23880,23645,23975,23645,23975,23810,95,-70,4,47.62,260
,20170918,23975,23810,23800,24120,23470,24120,23955,310,145,30,359.37,258
,20170919,24120,23955,24400,24410,24230,24230,24345,275,390,6,73.04,256
,20170920,24230,24345,24315,24320,24040,24220,24220,-125,-125,18,218.00,256
,20170921,24220,24220,24535,24535,24025,24025,24205,-195,-15,6,72.62,256
,20170922,24025,24205,24005,24325,23395,23450,23890,-755,-315,34,406.13,246
,20170925,23450,23890,23800,23970,23395,23970,23665,80,-225,16,189.35,248
,20170926,23970,23665,24340,24580,24340,24500,24455,835,790,10,122.29,246
,20170927,24500,24455,24365,24760,24365,24760,24495,305,40,8,97.99,248
,20170928,24760,24495,24785,25200,24365,24600,24705,105,210,44,543.55,254
,20170929,24600,24705,24900,25055,24720,24800,24855,95,150,30,372.85,244
,20171009,24800,24855,25690,25780,25575,25580,25660,725,805,26,333.63,246
,20171010,25580,25660,25375,25375,25135,25135,25265,-525,-395,6,75.80,242
,20171011,25135,25265,25105,25380,25035,25035,25235,-230,-30,20,252.40,248
,20171012,25035,25235,25095,25095,24760,24765,24865,-470,-370,22,273.56,256
,20171013,24765,24865,25190,25265,25125,25220,25205,355,340,30,378.09,258
,20171016,25220,25205,25165,25170,24805,24980,25035,-225,-170,16,200.31,254
,20171017,24980,25035,25190,25330,24500,24500,24990,-535,-45,20,249.91,270
,20171018,24500,24990,24295,24330,24105,24105,24250,-885,-740,24,291.02,272
,20171019,24105,24250,24445,24480,24225,24225,24415,-25,165,34,415.08,284
,20171020,24225,24415,24165,24620,24165,24610,24495,195,80,14,171.49,292
,20171023,24610,24495,24455,24580,24215,24580,24410,85,-85,8,97.65,296
,20171024,24580,24410,24380,24890,24380,24825,24620,415,210,20,246.23,298
,20171025,24825,24620,24820,24820,24715,24800,24775,180,155,12,148.66,292
,20171026,24800,24775,25205,25230,25095,25150,25165,375,390,24,301.98,292
,20171027,25150,25165,25125,25200,24890,24890,25115,-275,-50,158,"1,984.35",336
,20171030,24890,25115,24790,25100,24790,25055,25020,-60,-95,54,675.65,324
,20171031,25055,25020,25060,25390,24980,25390,25130,370,110,44,552.86,316
,20171101,25390,25130,25480,25905,25240,25390,25725,260,595,46,591.70,312
,20171102,25390,25725,25350,25440,25265,25265,25365,-460,-360,26,329.80,310
,20171103,25265,25365,25320,25555,25230,25555,25470,190,105,130,"1,655.86",418
,20171106,25555,25470,25425,25825,25335,25825,25600,355,130,20,256.00,432
,20171107,25825,25600,25740,25800,25495,25655,25660,55,60,92,"1,180.44",418
,20171108,25655,25660,25520,25520,25390,25390,25455,-270,-205,4,50.91,416
,20171109,25390,25455,25355,25445,25355,25445,25385,-10,-70,6,76.16,418
,20171110,25445,25385,25400,25615,25400,25455,25520,70,135,8,102.09,420
,20171113,25455,25520,25690,25760,25575,25705,25655,185,135,12,153.95,418
,20171114,25705,25655,25845,25975,25700,25820,25880,165,225,64,828.21,386
,20171115,25820,25880,25670,25670,24965,25070,25330,-810,-550,38,481.35,360
,20171116,25070,25330,25090,25090,24950,25010,25025,-320,-305,26,325.37,350
,20171117,25010,25025,24730,25190,24730,25050,24980,25,-45,96,"1,199.15",352
,20171120,25050,24980,25185,25290,25100,25200,25190,220,210,22,277.10,348
,20171121,25200,25190,25200,25200,24900,25040,25135,-150,-55,24,301.66,360
,20171122,25040,25135,25250,25625,25250,25620,25475,485,340,16,203.81,368
,20171123,25620,25475,25610,25610,25610,25610,25610,135,135,28,358.54,342
,20171124,25610,25610,25495,25495,25470,25470,25470,-140,-140,28,356.62,320
,20171127,25470,25470,,,,25340,25340,-130,-130,0,0.00,320
,20171128,25340,25340,25085,25085,24550,24585,24740,-755,-600,46,569.04,334
,20171129,24585,24740,24735,24750,24530,24750,24680,10,-60,34,419.57,326
,20171130,24750,24680,24500,24770,24495,24680,24590,0,-90,78,959.02,314
,20171201,24680,24590,24965,24965,24790,24800,24830,210,240,28,347.67,304
,20171204,24800,24830,25200,25735,25200,25380,25465,550,635,62,789.43,300
,20171205,25380,25465,25345,25350,25035,25035,25200,-430,-265,32,403.23,288
,20171206,25035,25200,25030,25030,24205,24365,24575,-835,-625,110,"1,351.89",272
,20171207,24365,24575,24395,24545,24270,24355,24400,-220,-175,12,146.40,270
,20171208,24355,24400,24160,24160,24000,24115,24090,-285,-310,6,72.28,270
,20171211,24115,24090,24310,24425,24310,24425,24380,335,290,28,341.34,268
,20171212,24425,24380,24390,24840,24390,24660,24650,280,270,14,172.58,260
,20171213,24660,24650,24965,24965,24840,24840,24915,190,265,30,373.77,262
,20171214,24840,24915,25040,25065,24830,24830,24980,-85,65,20,249.82,266
,20171215,24830,24980,24900,25115,24900,25100,25055,120,75,68,852.00,254
,20171218,25100,25055,25150,25360,25150,25340,25330,285,275,68,861.36,268
,20171219,25340,25330,25230,25230,25000,25000,25050,-330,-280,60,751.57,266
,20171220,25000,25050,25070,25265,25040,25260,25225,210,175,28,353.22,266
,20171221,25260,25225,25340,25395,25120,25225,25325,0,100,70,886.51,278
,20171222,25225,25325,25290,25295,25290,25295,25290,-30,-35,8,101.17,282
,20171225,25295,25290,25270,25530,25065,25065,25360,-225,70,62,786.27,278
,20171226,25065,25360,25235,25300,25235,25300,25265,-60,-95,4,50.54,276
,20171227,25300,25265,25300,25300,25120,25120,25195,-145,-70,8,100.80,274
,20171228,25120,25195,25300,25620,25265,25600,25430,405,235,44,559.51,278
,20171229,25600,25430,25465,25575,25445,25565,25500,135,70,36,459.05,290
zn1808,20170816,23355,23355,23255,23650,23255,23625,23535,270,180,26,305.99,22
,20170817,23625,23535,23995,24945,23995,24940,24775,1405,1240,190,"2,354.05",160
,20170818,24940,24775,24825,24825,24325,24460,24535,-315,-240,76,932.41,190
,20170821,24460,24535,24600,24830,24260,24610,24585,75,50,140,"1,721.16",232
,20170822,24610,24585,24510,24510,24370,24370,24445,-215,-140,10,122.24,230
,20170823,24370,24445,24205,24380,24100,24380,24210,-65,-235,16,193.70,230
,20170824,24380,24210,24270,24600,24270,24300,24420,90,210,32,390.73,226
,20170825,24300,24420,24455,24660,24305,24490,24480,70,60,42,514.11,228
,20170828,24490,24480,24475,24475,23815,24020,24160,-460,-320,34,410.73,222
,20170829,24020,24160,24270,24335,24115,24115,24215,-45,55,12,145.32,226
,20170830,24115,24215,24195,24565,24115,24565,24285,350,70,26,315.76,234
,20170831,24565,24285,24145,24365,24145,24280,24260,-5,-25,12,145.57,238
,20170901,24280,24260,24390,24700,24390,24625,24625,365,365,44,541.79,214
,20170904,24625,24625,24710,25145,24710,24955,24955,330,330,76,948.38,230
,20170905,24955,24955,24940,24940,24935,24935,24935,-20,-20,4,49.88,232
,20170906,24935,24935,24825,24950,23870,24065,24350,-870,-585,80,974.15,240
,20170907,24065,24350,24130,24195,23835,23845,23990,-505,-360,56,671.80,256
,20170908,23845,23990,24030,24210,23445,23470,23930,-520,-60,52,622.23,256
,20170911,23470,23930,23530,23795,23280,23795,23405,-135,-525,86,"1,006.50",226
,20170912,23795,23405,23875,24095,23865,24095,23965,690,560,22,263.66,234
,20170913,24095,23965,23960,24000,23620,23650,23895,-315,-70,20,238.98,242
,20170914,23650,23895,23565,23660,23535,23535,23560,-360,-335,22,259.19,246
,20170915,23535,23560,23660,23820,23660,23820,23770,260,210,12,142.62,244
,20170918,23820,23770,23315,24040,23315,23915,23850,145,80,24,286.25,246
,20170919,23915,23850,24095,24300,23905,24200,24145,350,295,40,482.91,246
,20170920,24200,24145,23945,24350,23945,24350,24160,205,15,12,144.96,240
,20170921,24350,24160,24215,24340,23930,23930,24155,-230,-5,22,265.75,248
,20170922,23930,24155,24000,24195,23345,23345,23935,-810,-220,40,478.76,244
,20170925,23345,23935,23600,24085,23400,24085,23670,150,-265,24,284.06,238
,20170926,24085,23670,24105,24510,24105,24345,24325,675,655,46,559.54,238
,20170927,24345,24325,24280,24620,24240,24585,24355,260,30,24,292.31,224
,20170928,24585,24355,24655,24655,24250,24430,24450,75,95,40,489.10,222
,20170929,24430,24450,24800,25155,24515,25155,24745,705,295,40,494.95,226
,20171009,25155,24745,25155,25725,25155,25425,25530,680,785,20,255.34,226
,20171010,25425,25530,25350,25495,25120,25120,25335,-410,-195,30,380.07,240
,20171011,25120,25335,25120,25350,25120,25195,25230,-140,-105,36,454.16,238
,20171012,25195,25230,25050,25050,24660,25000,24835,-230,-395,50,620.98,240
,20171013,25000,24835,25115,25150,25115,25135,25130,300,295,26,326.71,242
,20171016,25135,25130,25125,25125,24680,24970,24925,-160,-205,16,199.43,242
,20171017,24970,24925,25100,25100,24510,24530,24700,-395,-225,26,321.15,240
,20171018,24530,24700,24210,24220,23855,24120,24090,-580,-610,24,289.08,246
,20171019,24120,24090,24220,24425,24220,24260,24340,170,250,16,194.74,252
,20171020,24260,24340,24200,24520,24065,24440,24250,100,-90,12,145.51,256
,20171023,24440,24250,24000,24445,24000,24290,24245,40,-5,10,121.25,262
,20171024,24290,24245,24265,24780,24255,24735,24520,490,275,64,784.75,266
,20171025,24735,24520,24775,24775,24600,24605,24645,85,125,8,98.59,270
,20171026,24605,24645,24705,25150,24705,24930,25030,285,385,46,575.71,270
,20171027,24930,25030,25075,25100,24755,24845,24980,-185,-50,68,849.38,310
,20171030,24845,24980,24690,24915,24685,24905,24805,-75,-175,50,620.24,308
,20171031,24905,24805,25005,25320,24915,25320,25135,515,330,46,578.14,288
,20171101,25320,25135,25325,25850,25325,25380,25740,245,605,36,463.33,302
,20171102,25380,25740,25255,25310,25255,25260,25270,-480,-470,50,631.80,312
,20171103,25260,25270,25355,25475,25245,25450,25415,180,145,90,"1,143.85",362
,20171106,25450,25415,25320,25505,25320,25505,25415,90,0,26,330.41,344
,20171107,25505,25415,25740,25740,25650,25650,25655,235,240,64,821.03,366
,20171108,25650,25655,25415,25515,25300,25300,25450,-355,-205,14,178.17,374
,20171109,25300,25450,25280,25420,25265,25350,25335,-100,-115,14,177.37,378
,20171110,25350,25335,25255,25425,25255,25425,25405,90,70,20,254.08,384
,20171113,25425,25405,25750,25940,25630,25835,25725,430,320,20,257.26,384
,20171114,25835,25725,25915,25945,25680,25845,25880,120,155,70,905.96,380
,20171115,25845,25880,25640,25640,25005,25025,25300,-855,-580,22,278.32,382
,20171116,25025,25300,24910,25030,24910,25030,24925,-270,-375,14,174.49,372
,20171117,25030,24925,24725,25235,24725,25085,25010,160,85,80,"1,000.46",372
,20171120,25085,25010,25010,25260,25010,25050,25130,40,120,58,728.81,360
,20171121,25050,25130,25020,25065,25020,25065,25035,-65,-95,10,125.19,350
,20171122,25065,25035,25085,25700,25085,25565,25505,530,470,42,535.64,338
,20171123,25565,25505,25530,25655,25530,25655,25590,150,85,8,102.37,338
,20171124,25655,25590,25500,25500,25500,25500,25500,-90,-90,2,25.50,336
,20171127,25500,25500,25550,25550,25080,25080,25390,-420,-110,12,152.36,334
,20171128,25080,25390,25000,25000,24595,24650,24750,-740,-640,34,420.82,360
,20171129,24650,24750,24820,24820,24680,24680,24740,-70,-10,14,173.21,364
,20171130,24680,24740,24535,24775,24405,24720,24495,-20,-245,470,"5,756.91",376
,20171201,24720,24495,24850,24940,24720,24800,24805,305,310,24,297.71,374
,20171204,24800,24805,24800,25700,24800,25375,25335,570,530,40,506.74,368
,20171205,25375,25335,25345,25345,24995,24995,25150,-340,-185,8,100.62,366
,20171206,24995,25150,24870,24870,24170,24355,24555,-795,-595,98,"1,203.32",350
,20171207,24355,24555,24415,24475,24210,24210,24355,-345,-200,16,194.87,356
,20171208,24210,24355,24315,24400,24000,24400,24250,45,-105,20,242.54,360
,20171211,24400,24250,24435,24660,24365,24480,24505,230,255,44,539.13,336
,20171212,24480,24505,24405,24730,24405,24690,24585,185,80,12,147.53,328
,20171213,24690,24585,24950,24955,24780,24880,24845,295,260,24,298.18,326
,20171214,24880,24845,24970,25025,24740,24890,24895,45,50,22,273.89,318
,20171215,24890,24895,24920,25100,24900,25005,24985,110,90,52,649.74,298
,20171218,25005,24985,25180,25355,25160,25165,25270,180,285,164,"2,072.49",332
,20171219,25165,25270,25210,25210,24960,24960,25025,-310,-245,20,250.28,322
,20171220,24960,25025,25275,25295,25250,25295,25270,270,245,18,227.45,320
,20171221,25295,25270,25330,25355,25125,25125,25330,-145,60,34,430.66,316
,20171222,25125,25330,25245,25265,25090,25230,25175,-100,-155,32,402.88,310
,20171225,25230,25175,25310,25450,25100,25115,25240,-60,65,12,151.46,310
,20171226,25115,25240,25020,25250,25020,25250,25180,10,-60,12,151.10,300
,20171227,25250,25180,25125,25125,25125,25125,25125,-55,-55,2,25.13,302
,20171228,25125,25125,25230,25565,25170,25480,25340,355,215,46,582.85,324
,20171229,25480,25340,25380,25580,25375,25580,25465,240,125,102,"1,298.78",372
zn1809,20170918,23770,23770,23650,24260,23615,23725,23945,-45,175,336,"4,023.50",38
,20170919,23725,23945,24190,24190,24000,24000,24055,55,110,22,264.65,28
,20170920,24000,24055,23885,24250,23885,24250,23990,195,-65,28,335.93,28
,20170921,24250,23990,24450,24450,23615,23615,24050,-375,60,18,216.45,34
,20170922,23615,24050,23970,23970,23245,23245,23540,-805,-510,20,235.40,36
,20170925,23245,23540,23600,23800,23260,23800,23590,260,50,8,94.36,30
,20170926,23800,23590,24120,24365,24100,24365,24235,775,645,16,193.91,38
,20170927,24365,24235,,,,24235,24235,0,0,0,0.00,38
,20170928,24235,24235,24425,24485,24200,24380,24360,145,125,24,292.35,44
,20170929,24380,24360,24490,24700,24380,24700,24480,340,120,14,171.38,50
,20171009,24700,24480,25595,25595,25395,25395,25510,915,1030,8,102.04,46
,20171010,25395,25510,,,,25380,25380,-130,-130,0,0.00,46
,20171011,25380,25380,24965,25185,24965,25060,25105,-320,-275,56,703.06,58
,20171012,25060,25105,25210,25430,24500,24830,25000,-275,-105,70,875.03,92
,20171013,24830,25000,25000,25040,24950,24960,24995,-40,-5,40,499.96,98
,20171016,24960,24995,24960,25045,24700,24775,24830,-220,-165,16,198.67,108
,20171017,24775,24830,25040,25045,24410,24410,24725,-420,-105,8,98.91,108
,20171018,24410,24725,24100,24180,23885,24125,24000,-600,-725,24,288.05,126
,20171019,24125,24000,24080,24300,24050,24130,24125,130,125,16,193.03,132
,20171020,24130,24125,23975,23975,23975,23975,23975,-150,-150,2,23.98,130
,20171023,23975,23975,24285,24300,24025,24300,24170,325,195,24,290.05,130
,20171024,24300,24170,24270,24745,24000,24715,24415,545,245,204,"2,490.36",164
,20171025,24715,24415,24560,24655,24500,24540,24570,125,155,20,245.71,168
,20171026,24540,24570,24880,24975,24875,24875,24910,305,340,10,124.56,170
,20171027,24875,24910,24875,25125,24830,24830,25005,-80,95,120,"1,500.30",220
,20171030,24830,25005,24695,24935,24640,24930,24830,-75,-175,26,322.84,222
,20171031,24930,24830,24895,25285,24865,25285,25115,455,285,52,653.01,206
,20171101,25285,25115,25205,25815,25205,25535,25555,420,440,78,996.82,218
,20171102,25535,25555,25310,25335,25205,25230,25290,-325,-265,24,303.50,234
,20171103,25230,25290,25190,25455,25185,25455,25335,165,45,68,861.49,258
,20171106,25455,25335,25300,25725,25300,25725,25520,390,185,34,433.84,266
,20171107,25725,25520,25865,25865,25510,25590,25605,70,85,36,460.93,280
,20171108,25590,25605,25450,25480,25195,25225,25270,-380,-335,50,631.87,276
,20171109,25225,25270,25300,25600,25165,25165,25335,-105,65,96,"1,216.15",270
,20171110,25165,25335,25350,25490,25185,25435,25335,100,0,28,354.70,276
,20171113,25435,25335,25545,25645,25470,25645,25545,310,210,24,306.54,286
,20171114,25645,25545,25790,25940,25680,25680,25850,135,305,32,413.67,272
,20171115,25680,25850,25620,25620,24810,25130,25145,-720,-705,78,980.68,272
,20171116,25130,25145,25010,25880,24670,25000,25065,-145,-80,198,"2,481.61",300
,20171117,25000,25065,24950,25125,24825,25040,25020,-25,-45,28,350.31,308
,20171120,25040,25020,25000,25250,24935,25130,25110,110,90,56,703.12,324
,20171121,25130,25110,24750,25060,24750,25050,24935,-60,-175,44,548.63,316
,20171122,25050,24935,25200,25620,25200,25525,25460,590,525,100,"1,273.11",340
,20171123,25525,25460,25665,25665,25440,25440,25525,-20,65,18,229.73,342
,20171124,25440,25525,25470,25470,25295,25375,25415,-150,-110,28,355.81,348
,20171127,25375,25415,25420,25420,25000,25000,25215,-415,-200,20,252.16,352
,20171128,25000,25215,24995,25020,24535,24590,24790,-625,-425,56,694.25,342
,20171129,24590,24790,24610,24850,24535,24640,24605,-150,-185,26,319.89,352
,20171130,24640,24605,24460,24755,24460,24665,24640,60,35,50,616.11,356
,20171201,24665,24640,24845,24970,24715,24915,24870,275,230,50,621.81,350
,20171204,24915,24870,25055,25660,25055,25440,25375,570,505,92,"1,167.45",380
,20171205,25440,25375,25340,25340,25010,25010,25155,-365,-220,26,327.05,380
,20171206,25010,25155,24730,24730,24160,24285,24470,-870,-685,146,"1,786.63",344
,20171207,24285,24470,24490,24500,24135,24320,24340,-150,-130,118,"1,436.19",378
,20171208,24320,24340,24285,24475,23980,24465,24340,125,0,142,"1,728.31",396
,20171211,24465,24340,24370,24610,24295,24480,24450,140,110,48,586.80,386
,20171212,24480,24450,24435,24970,24380,24660,24615,210,165,40,492.35,378
,20171213,24660,24615,24845,25350,24765,24905,24920,290,305,74,922.14,410
,20171214,24905,24920,24960,24960,24755,24790,24890,-130,-30,42,522.70,416
,20171215,24790,24890,24885,25005,24805,25000,24915,110,25,68,847.19,396
,20171218,25000,24915,25015,25310,24975,25180,25065,265,150,26,325.85,396
,20171219,25180,25065,25160,25160,24935,24935,25075,-130,10,34,426.31,386
,20171220,24935,25075,24965,25185,24960,25125,25060,50,-15,38,476.15,398
,20171221,25125,25060,25235,25280,25020,25100,25105,40,45,58,728.07,402
,20171222,25100,25105,25250,25250,25115,25115,25160,10,55,18,226.45,402
,20171225,25115,25160,25235,25465,25000,25000,25300,-160,140,68,860.23,400
,20171226,25000,25300,25000,25150,24920,25150,25040,-150,-260,48,600.99,400
,20171227,25150,25040,25180,25205,25050,25125,25100,85,60,48,602.45,392
,20171228,25125,25100,25130,25550,25130,25495,25395,395,295,140,"1,777.82",454
,20171229,25495,25395,25465,25470,25385,25470,25440,75,45,54,686.99,484
zn1810,20171017,24830,24830,25440,25440,24165,24920,25045,90,215,20,250.46,6
,20171018,24920,25045,23935,24260,23885,24260,23995,-785,-1050,8,95.99,12
,20171019,24260,23995,24045,24045,24045,24045,24045,50,50,2,24.05,12
,20171020,24045,24045,24000,24445,24000,24315,24275,270,230,20,242.77,18
,20171023,24315,24275,24010,24475,24010,24265,24200,-10,-75,16,193.60,22
,20171024,24265,24200,24185,24605,24185,24605,24435,405,235,6,73.32,22
,20171025,24605,24435,,,,24435,24435,0,0,0,0.00,22
,20171026,24435,24435,24790,24920,24585,24880,24755,445,320,48,594.22,22
,20171027,24880,24755,24375,25355,24375,24740,24840,-15,85,52,645.89,48
,20171030,24740,24840,24305,24775,24305,24750,24650,-90,-190,16,197.23,48
,20171031,24750,24650,24795,25200,24760,25200,25005,550,355,38,475.18,66
,20171101,25200,25005,25350,25785,25345,25535,25525,530,520,86,"1,097.58",114
,20171102,25535,25525,25255,25340,25095,25180,25185,-345,-340,34,428.19,118
,20171103,25180,25185,25210,25345,25210,25275,25290,90,105,28,354.11,140
,20171106,25275,25290,25260,25700,25260,25700,25415,410,125,28,355.86,160
,20171107,25700,25415,25605,25705,25485,25655,25630,240,215,48,615.23,184
,20171108,25655,25630,25525,25525,25200,25200,25310,-430,-320,14,177.19,178
,20171109,25200,25310,,,,25310,25310,0,0,0,0.00,178
,20171110,25310,25310,25305,25400,25160,25400,25290,90,-20,8,101.18,182
,20171113,25400,25290,25575,25700,25360,25700,25550,410,260,82,"1,047.75",198
,20171114,25700,25550,25615,25625,25550,25550,25595,0,45,42,537.57,236
,20171115,25550,25595,25485,25485,24770,25030,25045,-565,-550,80,"1,001.94",256
,20171116,25030,25045,25085,25085,24900,24920,24965,-125,-80,144,"1,797.81",348
,20171117,24920,24965,24695,25250,24695,25005,25080,40,115,76,953.22,340
,20171120,25005,25080,25120,25250,25045,25065,25100,-15,20,30,376.52,342
,20171121,25065,25100,25020,25155,24845,25020,25025,-80,-75,80,"1,001.12",298
,20171122,25020,25025,25200,25630,25200,25595,25440,570,415,44,559.73,318
,20171123,25595,25440,25575,25615,25420,25435,25535,-5,95,62,791.59,344
,20171124,25435,25535,25500,25500,25500,25500,25500,-35,-35,4,51.00,344
,20171127,25500,25500,25450,25465,24960,25090,25340,-410,-160,56,709.55,350
,20171128,25090,25340,24950,24955,24560,24560,24845,-780,-495,86,"1,068.37",330
,20171129,24560,24845,24635,24815,24585,24650,24720,-195,-125,288,"3,560.25",262
,20171130,24650,24720,24490,24780,24480,24720,24570,0,-150,112,"1,375.96",234
,20171201,24720,24570,24905,24905,24700,24900,24785,330,215,16,198.31,236
,20171204,24900,24785,24935,25690,24935,25430,25275,645,490,78,985.73,256
,20171205,25430,25275,25290,25330,24990,25000,25190,-275,-85,12,151.14,246
,20171206,25000,25190,24760,24760,24170,24365,24395,-825,-795,120,"1,463.97",218
,20171207,24365,24395,24410,24410,24040,24245,24180,-150,-215,22,266.01,232
,20171208,24245,24180,24275,24315,23990,24265,24160,85,-20,44,531.58,228
,20171211,24265,24160,24305,24575,24265,24575,24435,415,275,56,684.32,264
,20171212,24575,24435,24350,24855,24350,24580,24740,145,305,78,964.93,238
,20171213,24580,24740,24885,24935,24655,24880,24840,140,100,38,471.98,250
,20171214,24880,24840,24850,24990,24780,24780,24870,-60,30,56,696.37,262
,20171215,24780,24870,24860,24995,24860,24970,24925,100,55,34,423.73,258
,20171218,24970,24925,24995,25255,24995,25150,25095,225,170,94,"1,179.54",322
,20171219,25150,25095,25095,25095,24880,24880,24950,-215,-145,38,474.09,306
,20171220,24880,24950,24990,25155,24985,25155,25030,205,80,62,776.07,310
,20171221,25155,25030,25190,25295,25010,25060,25100,30,70,28,351.44,308
,20171222,25060,25100,25090,25150,25090,25150,25125,50,25,6,75.39,312
,20171225,25150,25125,25155,25450,25155,25190,25310,65,185,24,303.75,316
,20171226,25190,25310,24945,25130,24945,25130,25050,-180,-260,16,200.42,318
,20171227,25130,25050,25055,25100,24985,24995,25045,-55,-5,24,300.60,324
,20171228,24995,25045,25060,25535,25040,25500,25325,455,280,256,"3,242.00",434
,20171229,25500,25325,25385,25495,25300,25460,25380,135,55,108,"1,370.77",484
zn1811,20171116,25045,25045,,,,25045,25045,0,0,0,0.00,0
,20171117,25045,25045,,,,25045,25045,0,0,0,0.00,0
,20171120,25045,25045,25085,25085,25085,25085,25085,40,40,2,25.09,2
,20171121,25085,25085,,,,25085,25085,0,0,0,0.00,2
,20171122,25085,25085,25200,25595,25200,25595,25395,510,310,4,50.80,4
,20171123,25595,25395,25420,25420,25420,25420,25420,25,25,2,25.42,6
,20171124,25420,25420,25450,25450,25380,25380,25415,-40,-5,4,50.83,10
,20171127,25380,25415,24665,25450,24665,25450,25055,35,-360,4,50.12,10
,20171128,25450,25055,24965,24990,24635,24635,24885,-420,-170,8,99.56,14
,20171129,24635,24885,24775,24775,24775,24775,24775,-110,-110,2,24.78,16
,20171130,24775,24775,24735,24735,24465,24465,24510,-310,-265,12,147.06,26
,20171201,24465,24510,24775,25075,24660,24820,24865,310,355,66,820.56,30
,20171204,24820,24865,25220,25610,25215,25370,25420,505,555,26,330.51,46
,20171205,25370,25420,25155,25300,24940,24940,25200,-480,-220,14,176.41,46
,20171206,24940,25200,24810,24810,24155,24300,24410,-900,-790,30,366.17,40
,20171207,24300,24410,,,,24410,24410,0,0,0,0.00,40
,20171208,24410,24410,24310,24335,24220,24220,24255,-190,-155,16,194.05,48
,20171211,24220,24255,24355,24550,24250,24545,24445,290,190,28,342.24,58
,20171212,24545,24445,24740,24760,24740,24760,24750,315,305,4,49.50,56
,20171213,24760,24750,24780,24925,24690,24925,24790,175,40,12,148.75,62
,20171214,24925,24790,24745,24820,24580,24580,24700,-210,-90,14,172.92,64
,20171215,24580,24700,24840,24900,24830,24900,24845,200,145,24,298.15,56
,20171218,24900,24845,25125,25145,25020,25020,25090,175,245,16,200.75,66
,20171219,25020,25090,25030,25030,24940,25005,24990,-85,-100,18,224.95,76
,20171220,25005,24990,24865,25145,24865,25100,25000,110,10,16,200.02,80
,20171221,25100,25000,25205,25205,24935,25075,25055,75,55,16,200.46,76
,20171222,25075,25055,,,,25055,25055,0,0,0,0.00,76
,20171225,25055,25055,25140,25395,25140,25345,25310,290,255,10,126.57,80
,20171226,25345,25310,24965,25075,24965,25075,25045,-235,-265,8,100.19,86
,20171227,25075,25045,25060,25060,24970,24970,25015,-75,-30,6,75.05,86
,20171228,24970,25015,24990,25470,24990,25450,25180,435,165,38,478.48,98
,20171229,25450,25180,25320,25415,25310,25395,25375,215,195,82,"1,040.43",158
zn1812,20171218,24845,24845,25135,25330,24925,25000,25065,155,220,22,275.73,14
,20171219,25000,25065,24655,25065,24655,25065,24870,0,-195,48,596.95,38
,20171220,25065,24870,,,,24960,24960,90,90,0,0.00,38
,20171221,24960,24960,25180,25180,25000,25000,25060,40,100,6,75.18,44
,20171222,25000,25060,,,,25060,25060,0,0,0,0.00,44
,20171225,25060,25060,25285,25285,24835,24945,25020,-115,-40,6,75.07,46
,20171226,24945,25020,24905,25010,24905,25010,24980,-10,-40,8,99.94,50
,20171227,25010,24980,,,,24980,24980,0,0,0,0.00,50
,20171228,24980,24980,25150,25375,25150,25375,25260,395,280,4,50.53,52
,20171229,25375,25260,25250,25300,25250,25300,25290,40,30,12,151.75,62
