合约,日期,前收盘,前结算,开盘价,最高价,最低价,收盘价,结算价,涨跌1,涨跌2,成交量,成交金额,持仓量
ag1801,20180102,3718,3782,3730,3801,3730,3800,3792,18,10,288,"1,638.46",2800
,20180103,3800,3792,3814,3815,3801,3801,3806,9,14,376,"2,147.10",2928
,20180104,3801,3806,3815,3815,3775,3776,3789,-30,-17,176,"1,000.52",2956
,20180105,3776,3789,3796,3806,3795,3798,3799,9,10,52,296.33,2952
,20180108,3798,3799,3812,3812,3796,3803,3800,4,1,156,889.24,3008
,20180109,3803,3800,3800,3809,3800,3800,3800,0,0,144,820.92,3112
,20180110,3800,3800,3783,3783,3780,3780,3780,-20,-20,64,362.95,3096
,20180111,3780,3780,3591,3780,3591,3780,3666,0,-114,20,110.00,3084
,20180112,3780,3666,3780,3780,3780,3780,3780,114,114,28,158.76,3084
,20180115,3780,3780,,,,3816,3816,36,36,0,0.00,3084
ag1802,20180102,3807,3804,3827,3827,3827,3827,3827,23,23,2,11.48,498
,20180103,3827,3827,3833,3853,3828,3828,3836,1,9,276,"1,588.37",388
,20180104,3828,3836,3831,3831,3799,3810,3814,-26,-22,30,171.67,374
,20180105,3810,3814,3813,3832,3812,3818,3823,4,9,38,217.93,374
,20180108,3818,3823,3829,3829,3824,3824,3824,1,1,18,103.27,358
,20180109,3824,3824,3824,3824,3814,3822,3820,-2,-4,58,332.41,382
,20180110,3822,3820,3812,3812,3799,3799,3805,-21,-15,4,22.83,378
,20180111,3799,3805,3809,3809,3808,3808,3808,3,3,40,228.50,350
,20180112,3808,3808,3730,3839,3729,3809,3796,1,-12,220,"1,252.83",276
,20180115,3809,3796,3823,3860,3823,3860,3850,64,54,30,173.29,258
,20180116,3860,3850,3840,3840,3811,3811,3830,-39,-20,42,241.33,244
,20180117,3811,3830,3794,3830,3794,3797,3814,-33,-16,42,240.34,236
,20180118,3797,3814,3798,3798,3798,3798,3798,-16,-16,2,11.39,238
,20180119,3798,3798,3772,3772,3772,3772,3772,-26,-26,2,11.32,236
,20180122,3772,3772,3759,3762,3759,3760,3760,-12,-12,24,135.38,216
,20180123,3760,3760,3769,3791,3764,3764,3770,4,10,28,158.37,210
,20180124,3764,3770,3743,3769,3743,3769,3752,-1,-18,20,112.58,220
,20180125,3769,3752,3802,3838,3785,3838,3806,86,54,84,479.63,168
,20180126,3838,3806,3828,3828,3800,3800,3814,-6,8,4,22.88,164
,20180129,3800,3814,3800,3800,3797,3800,3799,-14,-15,76,433.18,128
,20180130,3800,3799,3761,3770,3735,3751,3757,-48,-42,80,450.87,122
,20180131,3751,3757,3736,3815,3727,3750,3750,-7,-7,24,135.03,120
,20180201,3750,3750,3758,3758,3758,3758,3758,8,8,24,135.29,140
,20180202,3758,3758,3749,3749,3748,3748,3748,-10,-10,8,44.98,136
,20180205,3748,3748,3669,3683,3636,3638,3653,-110,-95,40,219.23,140
,20180206,3638,3653,3662,3676,3660,3676,3663,23,10,240,"1,319.00",364
,20180207,3676,3663,,,,3663,3663,0,0,0,0.00,364
,20180208,3663,3663,3553,3553,3553,3553,3553,-110,-110,4,21.32,364
,20180209,3553,3553,3606,3606,3600,3600,3603,47,50,8,43.24,360
ag1803,20180102,3822,3823,,,,3823,3823,0,0,0,0.00,504
,20180103,3823,3823,3843,3860,3843,3855,3850,32,27,100,577.59,446
,20180104,3855,3850,3838,3838,3815,3815,3824,-35,-26,6,34.42,446
,20180105,3815,3824,3827,3839,3823,3839,3828,15,4,12,68.92,446
,20180108,3839,3828,3840,3840,3830,3831,3834,3,6,8,46.01,444
,20180109,3831,3834,3827,3839,3816,3839,3830,5,-4,198,"1,137.63",420
,20180110,3839,3830,3830,3830,3811,3814,3819,-16,-11,12,68.75,414
,20180111,3814,3819,3818,3833,3817,3833,3823,14,4,210,"1,204.50",468
,20180112,3833,3823,3831,3834,3816,3834,3829,11,6,54,310.21,450
,20180115,3834,3829,3836,3875,3835,3875,3846,46,17,28,161.57,438
,20180116,3875,3846,3866,3867,3861,3867,3864,21,18,12,69.57,434
,20180117,3867,3864,3827,3840,3814,3840,3833,-24,-31,32,184.03,448
,20180118,3840,3833,3840,3840,3807,3807,3819,-26,-14,10,57.29,450
,20180119,3807,3819,3786,3786,3783,3783,3784,-36,-35,10,56.77,448
,20180122,3783,3784,3780,3786,3778,3778,3781,-6,-3,26,147.48,436
,20180123,3778,3781,3784,3791,3778,3791,3785,10,4,24,136.27,442
,20180124,3791,3785,3749,3777,3749,3777,3771,-8,-14,18,101.83,442
,20180125,3777,3771,3822,3867,3816,3856,3834,85,63,54,310.61,444
,20180126,3856,3834,3846,3846,3822,3822,3838,-12,4,6,34.54,442
,20180129,3822,3838,3824,3844,3820,3821,3822,-17,-16,26,149.07,448
,20180130,3821,3822,3800,3800,3778,3781,3787,-41,-35,30,170.43,444
,20180131,3781,3787,3783,3787,3768,3768,3779,-19,-8,18,102.05,442
,20180201,3768,3779,3785,3785,3775,3777,3780,-2,1,12,68.05,446
,20180202,3777,3780,3770,3770,3770,3770,3770,-10,-10,2,11.31,446
,20180205,3770,3770,3697,3699,3666,3673,3682,-97,-88,12,66.28,446
,20180206,3673,3682,3687,3740,3675,3740,3700,58,18,6,33.31,446
,20180207,3740,3700,3678,3680,3662,3671,3671,-29,-29,76,418.54,498
,20180208,3671,3671,3629,3640,3592,3610,3610,-61,-61,22,119.15,500
,20180209,3610,3610,3647,3647,3632,3633,3640,23,30,20,109.21,490
,20180212,3633,3640,3613,3636,3608,3632,3623,-8,-17,36,195.68,480
,20180213,3632,3623,3622,3666,3620,3655,3639,32,16,118,644.19,462
,20180214,3655,3639,3634,3664,3630,3664,3649,25,10,26,142.32,462
,20180222,3664,3649,3612,3625,3612,3619,3621,-30,-28,66,358.58,524
,20180223,3619,3621,3637,3643,3630,3640,3639,19,18,172,938.96,660
,20180226,3640,3639,3648,3675,3635,3668,3660,29,21,142,779.65,780
,20180227,3668,3660,3668,3670,3655,3655,3665,-5,5,28,153.97,770
,20180228,3655,3665,3621,3638,3576,3600,3610,-65,-55,74,400.81,752
,20180301,3600,3610,3612,3633,3612,3618,3619,8,9,84,456.08,776
,20180302,3618,3619,3634,3635,3630,3635,3631,16,12,64,348.65,792
,20180305,3635,3631,3642,3642,3639,3639,3639,8,8,24,131.02,788
,20180306,3639,3639,3631,3688,3589,3636,3644,-3,5,100,546.62,728
,20180307,3636,3644,,,,3644,3644,0,0,0,0.00,728
,20180308,3644,3644,3692,3692,3638,3646,3645,2,1,44,240.62,728
,20180309,3646,3645,,,,3645,3645,0,0,0,0.00,728
,20180312,3645,3645,3640,3640,3635,3635,3636,-10,-9,44,240.01,716
,20180313,3635,3636,3624,3624,3624,3624,3624,-12,-12,8,43.49,716
,20180314,3624,3624,3640,3640,3640,3640,3640,16,16,32,174.72,740
,20180315,3640,3640,,,,3640,3640,0,0,0,0.00,740
ag1804,20180102,3845,3841,3868,3870,3868,3868,3868,27,27,24,139.27,134
,20180103,3868,3868,3872,3879,3871,3879,3872,11,4,32,185.89,126
,20180104,3879,3872,3866,3866,3836,3845,3849,-27,-23,34,196.31,120
,20180105,3845,3849,3854,3871,3686,3849,3816,0,-33,16,91.59,126
,20180108,3849,3816,3865,3865,3845,3856,3854,40,38,32,185.04,130
,20180109,3856,3854,,,,3854,3854,0,0,0,0.00,130
,20180110,3854,3854,,,,3854,3854,0,0,0,0.00,130
,20180111,3854,3854,3839,3849,3839,3849,3844,-5,-10,4,23.06,130
,20180112,3849,3844,3820,3877,3814,3859,3841,15,-3,20,115.23,134
,20180115,3859,3841,3855,3906,3855,3898,3897,57,56,26,152.00,148
,20180116,3898,3897,3888,3896,3880,3880,3888,-17,-9,6,34.99,148
,20180117,3880,3888,,,,3850,3850,-38,-38,0,0.00,148
,20180118,3850,3850,,,,3830,3830,-20,-20,0,0.00,148
,20180119,3830,3830,,,,3830,3830,0,0,0,0.00,148
,20180122,3830,3830,,,,3830,3830,0,0,0,0.00,148
,20180123,3830,3830,3808,3810,3808,3810,3809,-20,-21,18,102.85,146
,20180124,3810,3809,,,,3809,3809,0,0,0,0.00,146
,20180125,3809,3809,3829,3868,3829,3868,3848,59,39,4,23.09,144
,20180126,3868,3848,3846,3853,3845,3853,3847,5,-1,32,184.69,132
,20180129,3853,3847,3842,3842,3842,3842,3842,-5,-5,2,11.53,134
,20180130,3842,3842,3821,3821,3801,3801,3807,-41,-35,6,34.27,128
,20180131,3801,3807,,,,3807,3807,0,0,0,0.00,128
,20180201,3807,3807,,,,3807,3807,0,0,0,0.00,128
,20180202,3807,3807,,,,3807,3807,0,0,0,0.00,128
,20180205,3807,3807,3771,3771,3698,3698,3755,-109,-52,18,101.40,122
,20180206,3698,3755,,,,3755,3755,0,0,0,0.00,122
,20180207,3755,3755,3701,3701,3693,3693,3699,-62,-56,26,144.29,140
,20180208,3693,3699,3650,3650,3589,3600,3629,-99,-70,12,65.33,136
,20180209,3600,3629,3643,3643,3643,3643,3643,14,14,4,21.86,136
,20180212,3643,3643,3631,3663,3631,3660,3650,17,7,24,131.42,130
,20180213,3660,3650,3658,3658,3658,3658,3658,8,8,2,10.97,130
,20180214,3658,3658,3678,3688,3678,3688,3681,30,23,16,88.36,130
,20180222,3688,3681,,,,3655,3655,-26,-26,0,0.00,130
,20180223,3655,3655,3659,3666,3659,3666,3662,11,7,18,98.90,130
,20180226,3666,3662,3702,3702,3702,3702,3702,40,40,12,66.64,142
,20180227,3702,3702,3693,3696,3693,3696,3693,-6,-9,8,44.33,144
,20180228,3696,3693,3667,3667,3667,3667,3667,-26,-26,2,11.00,142
,20180301,3667,3667,3639,3639,3638,3638,3638,-29,-29,20,109.15,160
,20180302,3638,3638,3633,3654,3633,3654,3650,16,12,14,76.67,172
,20180305,3654,3650,3656,3663,3651,3663,3656,13,6,12,65.82,172
,20180306,3663,3656,3647,3663,3647,3653,3654,-3,-2,60,328.89,198
,20180307,3653,3654,3678,3695,3678,3682,3684,28,30,8,44.21,198
,20180308,3682,3684,,,,3684,3684,0,0,0,0.00,198
,20180309,3684,3684,,,,3674,3674,-10,-10,0,0.00,198
,20180312,3674,3674,,,,3665,3665,-9,-9,0,0.00,198
,20180313,3665,3665,3652,3652,3652,3652,3652,-13,-13,2,10.96,196
,20180314,3652,3652,,,,3652,3652,0,0,0,0.00,196
,20180315,3652,3652,,,,3652,3652,0,0,0,0.00,196
,20180316,3652,3652,3630,3669,3630,3635,3644,-17,-8,6,32.80,196
,20180319,3635,3644,3634,3634,3598,3600,3610,-44,-34,146,790.74,238
,20180320,3600,3610,3612,3612,3607,3607,3611,-3,1,40,216.66,210
,20180321,3607,3611,3586,3600,3585,3600,3592,-11,-19,26,140.09,204
,20180322,3600,3592,3640,3657,3640,3644,3644,52,52,28,153.05,194
,20180323,3644,3644,3646,3653,3646,3653,3648,9,4,6,32.84,192
,20180326,3653,3648,3651,3651,3651,3651,3651,3,3,22,120.48,192
,20180327,3651,3651,3652,3652,3651,3651,3651,0,0,8,43.82,188
,20180328,3651,3651,3622,3622,3622,3622,3622,-29,-29,2,10.87,188
,20180329,3622,3622,3586,3586,3570,3570,3573,-52,-49,18,96.48,174
,20180330,3570,3573,3617,3622,3574,3584,3590,11,17,40,215.45,168
,20180402,3584,3590,,,,3596,3596,6,6,0,0.00,168
,20180403,3596,3596,,,,3619,3619,23,23,0,0.00,168
,20180404,3619,3619,3608,3608,3608,3608,3608,-11,-11,48,259.78,152
,20180409,3608,3608,,,,3608,3608,0,0,0,0.00,152
,20180410,3608,3608,3610,3612,3610,3612,3611,4,3,20,108.35,152
,20180411,3612,3611,3615,3630,3602,3630,3619,19,8,156,847.01,196
,20180412,3630,3619,3630,3660,3630,3637,3639,18,20,172,938.97,268
,20180413,3637,3639,3602,3615,3602,3615,3608,-24,-31,8,43.30,276
,20180416,3615,3608,3638,3640,3630,3640,3635,32,27,216,"1,177.76",432
ag1805,20180102,3862,3864,3877,3894,3868,3877,3874,13,10,294,"1,708.49",600
,20180103,3877,3874,3887,3904,3886,3890,3892,16,18,42,245.25,592
,20180104,3890,3892,3876,3882,3851,3867,3866,-25,-26,56,324.82,592
,20180105,3867,3866,3876,3886,3869,3869,3874,3,8,48,279.00,584
,20180108,3869,3874,3866,3887,3866,3866,3877,-8,3,62,360.61,574
,20180109,3866,3877,3873,3879,3864,3873,3871,-4,-6,36,209.04,584
,20180110,3873,3871,3873,3873,3849,3855,3856,-16,-15,56,323.90,606
,20180111,3855,3856,3874,3874,3810,3868,3865,12,9,38,220.31,590
,20180112,3868,3865,3863,3870,3848,3870,3858,5,-7,40,231.54,586
,20180115,3870,3858,3870,3917,3864,3905,3889,47,31,456,"2,660.44",648
,20180116,3905,3889,3900,3902,3890,3890,3893,1,4,46,268.67,652
,20180117,3890,3893,3859,3876,3853,3854,3862,-39,-31,68,393.99,646
,20180118,3854,3862,3855,3855,3830,3839,3846,-23,-16,72,415.43,646
,20180119,3839,3846,3829,3840,3813,3813,3825,-33,-21,78,447.63,644
,20180122,3813,3825,3825,3834,3816,3821,3824,-4,-1,100,573.72,628
,20180123,3821,3824,3826,3831,3817,3826,3824,2,0,130,745.77,622
,20180124,3826,3824,3822,3822,3786,3813,3808,-11,-16,80,456.96,622
,20180125,3813,3808,3859,3905,3847,3894,3874,86,66,196,"1,139.24",586
,20180126,3894,3874,3920,3920,3860,3869,3890,-5,16,744,"4,341.31",706
,20180129,3869,3890,3865,3873,3855,3859,3861,-31,-29,132,764.66,680
,20180130,3859,3861,3841,3846,3806,3810,3821,-51,-40,136,779.57,670
,20180131,3810,3821,3841,3841,3805,3810,3820,-11,-1,214,"1,226.51",654
,20180201,3810,3820,3825,3825,3811,3815,3815,-5,-5,56,320.52,644
,20180202,3815,3815,3817,3817,3799,3808,3807,-7,-8,48,274.14,662
,20180205,3808,3807,3802,3802,3707,3716,3744,-91,-63,198,"1,112.25",740
,20180206,3716,3744,3721,3794,3715,3757,3746,13,2,82,460.79,722
,20180207,3757,3746,3725,3725,3702,3716,3715,-30,-31,68,378.93,746
,20180208,3716,3715,3692,3692,3635,3659,3659,-56,-56,164,900.20,820
,20180209,3659,3659,3674,3699,3593,3665,3675,6,16,224,"1,235.04",794
,20180212,3665,3675,3660,3679,3643,3674,3662,-1,-13,218,"1,197.56",778
,20180213,3674,3662,3671,3701,3664,3698,3690,36,28,164,907.93,682
,20180214,3698,3690,3687,3700,3672,3695,3692,5,2,82,454.21,650
,20180222,3695,3692,3677,3690,3580,3656,3661,-36,-31,108,593.10,678
,20180223,3656,3661,3674,3690,3674,3681,3680,20,19,62,342.27,672
,20180226,3681,3680,3691,3724,3651,3707,3700,27,20,176,976.88,658
,20180227,3707,3700,3707,3712,3692,3697,3701,-3,1,108,599.70,646
,20180228,3697,3701,3684,3694,3660,3661,3681,-40,-20,364,"2,010.01",674
,20180301,3661,3681,3670,3676,3654,3655,3664,-26,-17,64,351.83,672
,20180302,3655,3664,3644,3677,3638,3670,3655,6,-9,744,"4,079.81",776
,20180305,3670,3655,3682,3691,3666,3680,3682,25,27,216,"1,192.98",798
,20180306,3680,3682,3675,3679,3666,3676,3676,-6,-6,82,452.20,820
,20180307,3676,3676,3709,3858,3683,3696,3707,20,31,1014,"5,639.12",802
,20180308,3696,3707,3693,3696,3654,3693,3681,-14,-26,198,"1,093.47",826
,20180309,3693,3681,3690,3690,3664,3665,3675,-16,-6,210,"1,157.64",848
,20180312,3665,3675,3667,3701,3657,3674,3671,-1,-4,422,"2,324.18",778
,20180313,3674,3671,3671,3673,3665,3669,3670,-2,-1,86,473.44,750
,20180314,3669,3670,3673,3689,3669,3675,3677,5,7,128,706.00,706
,20180315,3675,3677,3678,3678,3669,3674,3672,-3,-5,20,110.17,708
,20180316,3674,3672,3658,3666,3645,3651,3657,-21,-15,94,515.67,726
,20180319,3651,3657,3653,3655,3615,3618,3632,-39,-25,452,"2,462.75",742
,20180320,3618,3632,3626,3633,3609,3627,3626,-5,-6,106,576.54,724
,20180321,3627,3626,3614,3622,3603,3619,3608,-7,-18,170,920.06,730
,20180322,3619,3608,3619,3684,3619,3666,3660,58,52,334,"1,833.70",730
,20180323,3666,3660,3665,3680,3649,3669,3667,9,7,266,"1,463.50",750
,20180326,3669,3667,3683,3693,3668,3672,3679,5,12,242,"1,335.84",738
,20180327,3672,3679,3668,3685,3668,3680,3676,1,-3,52,286.73,728
,20180328,3680,3676,3660,3663,3640,3640,3653,-36,-23,52,285.00,724
,20180329,3640,3653,3635,3635,3581,3591,3606,-62,-47,92,497.63,730
,20180330,3591,3606,3597,3605,3593,3598,3598,-8,-8,46,248.32,706
,20180402,3598,3598,3601,3620,3595,3612,3610,14,12,72,389.98,666
,20180403,3612,3610,3633,3670,3631,3633,3635,23,25,122,665.38,690
,20180404,3633,3635,3629,3634,3615,3619,3626,-16,-9,84,457.00,676
,20180409,3619,3626,3615,3615,3615,3615,3615,-11,-11,10,54.23,666
,20180410,3615,3615,3619,3629,3616,3617,3618,2,3,158,857.62,614
,20180411,3617,3618,3630,3635,3630,3633,3632,15,14,24,130.79,608
,20180412,3633,3632,3635,3674,3635,3650,3647,18,15,94,514.34,566
,20180413,3650,3647,3633,3635,3620,3620,3625,-27,-22,16,87.01,570
,20180416,3620,3625,3628,3662,3628,3638,3642,13,17,50,273.18,574
,20180417,3638,3642,3644,3644,3634,3640,3641,-2,-1,16,87.38,562
,20180418,3640,3641,3630,3656,3630,3656,3643,15,2,24,131.15,548
,20180419,3656,3643,3705,3735,3693,3735,3717,92,74,242,"1,349.51",634
,20180420,3735,3717,3814,3814,3722,3731,3726,14,9,122,681.99,632
,20180423,3731,3726,3730,3734,3699,3715,3723,-11,-3,126,703.79,698
,20180424,3715,3723,3663,3663,3655,3657,3658,-66,-65,26,142.67,696
,20180425,3657,3658,3656,3663,3650,3660,3655,2,-3,38,208.37,668
,20180426,3660,3655,3631,3655,3631,3639,3639,-16,-16,78,425.86,666
,20180427,3639,3639,3618,3704,3478,3579,3601,-60,-38,66,356.56,644
,20180502,3579,3601,3591,3602,3551,3602,3580,1,-21,132,708.96,588
,20180503,3602,3580,3610,3610,3610,3610,3610,30,30,20,108.30,568
,20180504,3610,3610,3625,3625,3624,3625,3624,15,14,32,173.98,552
,20180507,3625,3624,3641,3641,3638,3638,3639,14,15,120,655.18,440
,20180508,3638,3639,3630,3630,3630,3630,3630,-9,-9,4,21.78,436
,20180509,3630,3630,3600,3600,3600,3600,3600,-30,-30,16,86.40,432
,20180510,3600,3600,3600,3639,3600,3639,3605,39,5,28,151.43,408
,20180511,3639,3605,3665,3665,3665,3665,3665,60,60,24,131.94,396
,20180514,3665,3665,3653,3653,3653,3653,3653,-12,-12,28,153.43,368
,20180515,3653,3653,,,,3653,3653,0,0,0,0.00,368
ag1806,20180102,3883,3885,3899,3910,3891,3902,3900,17,15,137022,"801,626.58",602744
,20180103,3902,3900,3908,3928,3897,3897,3911,-3,11,323606,"1,898,892.08",583810
,20180104,3897,3911,3902,3915,3871,3885,3890,-26,-21,379448,"2,214,380.71",595966
,20180105,3885,3890,3889,3910,3875,3890,3895,0,5,330302,"1,930,229.65",584178
,20180108,3890,3895,3888,3912,3881,3891,3896,-4,1,348074,"2,034,266.41",595602
,20180109,3891,3896,3892,3901,3884,3896,3893,0,-3,234532,"1,369,867.72",606676
,20180110,3896,3893,3891,3892,3868,3873,3879,-20,-14,276074,"1,606,548.65",632452
,20180111,3873,3879,3895,3898,3876,3885,3887,6,8,250670,"1,461,640.59",636290
,20180112,3885,3887,3882,3893,3836,3890,3878,3,-9,415558,"2,417,537.41",642510
,20180115,3890,3878,3892,3939,3875,3926,3904,48,26,471104,"2,758,832.09",670164
,20180116,3926,3904,3925,3928,3903,3907,3918,3,14,236234,"1,388,543.76",660858
,20180117,3907,3918,3889,3898,3869,3876,3881,-42,-37,402960,"2,346,406.79",638304
,20180118,3876,3881,3884,3884,3846,3852,3863,-29,-18,327046,"1,895,340.12",650276
,20180119,3852,3863,3850,3860,3831,3834,3844,-29,-19,317398,"1,830,289.28",662324
,20180122,3834,3844,3841,3848,3835,3838,3841,-6,-3,207686,"1,196,637.81",668780
,20180123,3838,3841,3841,3853,3835,3847,3843,6,2,240510,"1,386,470.44",676724
,20180124,3847,3843,3840,3844,3806,3836,3825,-7,-18,437610,"2,511,247.74",696240
,20180125,3836,3825,3863,3926,3861,3916,3892,91,67,621608,"3,629,599.69",686058
,20180126,3916,3892,3899,3915,3870,3889,3894,-3,2,419062,"2,448,025.40",692052
,20180129,3889,3894,3878,3891,3873,3875,3881,-19,-13,290138,"1,689,141.87",701688
,20180130,3875,3881,3859,3866,3820,3823,3843,-58,-38,373710,"2,154,620.07",718046
,20180131,3823,3843,3843,3851,3821,3832,3834,-11,-9,279930,"1,610,071.95",721492
,20180201,3832,3834,3837,3845,3827,3830,3835,-4,1,235382,"1,354,133.18",721920
,20180202,3830,3835,3830,3836,3813,3824,3823,-11,-12,284856,"1,633,835.25",736950
,20180205,3824,3823,3818,3825,3724,3729,3758,-94,-65,735642,"4,147,530.00",777424
,20180206,3729,3758,3739,3797,3725,3767,3757,9,-1,519518,"2,927,756.66",765472
,20180207,3767,3757,3736,3744,3708,3731,3730,-26,-27,425140,"2,378,673.79",799180
,20180208,3731,3730,3702,3710,3651,3674,3675,-56,-55,632088,"3,484,656.94",812318
,20180209,3674,3675,3674,3717,3673,3687,3694,12,19,407840,"2,259,986.87",796926
,20180212,3687,3694,3676,3697,3656,3690,3676,-4,-18,476280,"2,626,761.35",798288
,20180213,3690,3676,3687,3720,3681,3712,3703,36,27,299838,"1,665,615.77",770352
,20180214,3712,3703,3711,3721,3686,3718,3707,15,4,303870,"1,689,739.25",760906
,20180222,3718,3707,3690,3691,3663,3675,3677,-32,-30,144846,"799,031.84",763644
,20180223,3675,3677,3683,3709,3680,3696,3697,19,20,311096,"1,725,387.95",793630
,20180226,3696,3697,3701,3738,3691,3726,3713,29,16,448470,"2,498,190.39",819066
,20180227,3726,3713,3721,3733,3709,3719,3721,6,8,362268,"2,022,307.11",848188
,20180228,3719,3721,3718,3719,3670,3684,3689,-37,-32,507648,"2,809,395.22",862616
,20180301,3684,3689,3687,3697,3669,3675,3681,-14,-8,320618,"1,770,749.10",875388
,20180302,3675,3681,3660,3695,3650,3683,3672,2,-9,487640,"2,686,095.25",826342
,20180305,3683,3672,3685,3709,3681,3697,3695,25,23,386100,"2,140,434.16",817202
,20180306,3697,3695,3693,3697,3676,3688,3686,-7,-9,292604,"1,618,202.55",837638
,20180307,3688,3686,3707,3736,3699,3711,3716,25,30,522414,"2,912,152.81",785042
,20180308,3711,3716,3709,3712,3683,3704,3697,-12,-19,430620,"2,388,212.07",805520
,20180309,3704,3697,3694,3706,3673,3687,3689,-10,-8,354944,"1,964,315.86",789494
,20180312,3687,3689,3682,3718,3663,3687,3692,-2,3,550260,"3,047,774.58",773788
,20180313,3687,3692,3682,3693,3678,3681,3683,-11,-9,230396,"1,273,160.28",774862
,20180314,3681,3683,3695,3706,3678,3693,3692,10,9,332324,"1,840,471.27",765074
,20180315,3693,3692,3690,3693,3682,3685,3686,-7,-6,222614,"1,231,032.28",772780
,20180316,3685,3686,3676,3681,3657,3668,3669,-18,-17,390238,"2,148,103.23",815020
,20180319,3668,3669,3667,3674,3622,3633,3644,-36,-25,536604,"2,933,283.67",846934
,20180320,3633,3644,3633,3652,3633,3645,3643,1,-1,251720,"1,375,612.33",824786
,20180321,3645,3643,3640,3640,3612,3638,3629,-5,-14,320820,"1,746,687.92",837576
,20180322,3638,3629,3640,3700,3638,3682,3674,53,45,602932,"3,323,509.15",788142
,20180323,3682,3674,3680,3699,3666,3692,3683,18,9,474788,"2,623,516.45",778276
,20180326,3692,3683,3697,3709,3681,3684,3694,1,11,329878,"1,827,885.66",768850
,20180327,3684,3694,3688,3703,3682,3696,3694,2,0,303124,"1,679,671.63",758606
,20180328,3696,3694,3678,3683,3648,3656,3668,-38,-26,331622,"1,825,000.02",778716
,20180329,3656,3668,3646,3650,3599,3602,3621,-66,-47,509674,"2,768,707.17",805344
,20180330,3602,3621,3600,3625,3596,3618,3613,-3,-8,243604,"1,320,571.95",786994
,20180402,3618,3613,3618,3638,3614,3631,3630,18,17,192436,"1,047,837.42",770888
,20180403,3631,3630,3655,3668,3648,3650,3655,20,25,292092,"1,601,485.34",739288
,20180404,3650,3655,3651,3651,3620,3639,3633,-16,-22,225936,"1,231,413.22",747184
,20180409,3639,3633,3635,3642,3631,3636,3635,3,2,91122,"496,886.24",749474
,20180410,3636,3635,3639,3652,3633,3640,3641,5,6,216200,"1,180,869.27",740620
,20180411,3640,3641,3651,3658,3644,3655,3651,14,10,259782,"1,422,848.19",720700
,20180412,3655,3651,3661,3692,3655,3663,3670,12,19,489154,"2,693,251.12",672356
,20180413,3663,3670,3651,3653,3621,3635,3640,-35,-30,309548,"1,690,437.08",636494
,20180416,3635,3640,3643,3674,3642,3656,3658,16,18,288306,"1,582,087.88",641480
,20180417,3656,3658,3665,3671,3651,3666,3663,8,5,222462,"1,222,360.94",625168
,20180418,3666,3663,3651,3685,3646,3680,3669,17,6,341578,"1,879,971.02",619792
,20180419,3680,3669,3720,3766,3713,3764,3736,95,67,722350,"4,048,876.45",597804
,20180420,3764,3736,3762,3767,3741,3750,3752,14,16,441464,"2,485,172.79",556114
,20180423,3750,3752,3748,3755,3724,3735,3738,-17,-14,331642,"1,859,775.36",512132
,20180424,3735,3738,3691,3698,3672,3682,3684,-56,-54,449410,"2,483,637.92",477702
,20180425,3682,3684,3676,3694,3670,3676,3683,-8,-1,219038,"1,210,274.38",463578
,20180426,3676,3683,3664,3678,3655,3670,3670,-13,-13,227756,"1,253,842.94",448044
,20180427,3670,3670,3670,3674,3645,3658,3656,-12,-14,271146,"1,487,200.20",427052
,20180502,3658,3656,3615,3635,3603,3626,3625,-30,-31,127508,"693,364.52",412148
,20180503,3626,3625,3638,3669,3626,3643,3642,18,17,222772,"1,217,114.82",382124
,20180504,3643,3642,3657,3659,3641,3647,3650,5,8,135348,"741,038.18",362788
,20180507,3647,3650,3653,3666,3645,3656,3656,6,6,168872,"926,338.96",330594
,20180508,3656,3656,3651,3661,3650,3656,3655,0,-1,75474,"413,877.02",315786
,20180509,3656,3655,3655,3668,3634,3649,3648,-6,-7,116472,"637,406.92",292892
,20180510,3649,3648,3659,3672,3655,3663,3663,15,15,92504,"508,286.60",274848
,20180511,3663,3663,3689,3689,3675,3679,3679,16,16,77348,"426,863.09",259296
,20180514,3679,3679,3693,3693,3671,3674,3682,-5,3,57904,"319,885.76",239444
,20180515,3674,3682,3665,3671,3636,3638,3651,-44,-31,73056,"400,136.37",206220
,20180516,3638,3651,3614,3620,3600,3616,3610,-35,-41,64766,"350,710.78",188942
,20180517,3616,3610,3607,3630,3597,3614,3618,4,8,28090,"152,480.25",180942
,20180518,3614,3618,3626,3636,3622,3628,3628,10,10,29828,"162,349.69",173218
,20180521,3628,3628,3623,3640,3608,3612,3622,-16,-6,33138,"180,069.09",165832
,20180522,3612,3622,3634,3638,3625,3627,3631,5,9,30160,"164,290.91",154130
,20180523,3627,3631,3644,3652,3634,3644,3641,13,10,34616,"189,085.99",144608
,20180524,3644,3641,3634,3640,3620,3640,3631,-1,-10,26320,"143,376.37",136870
,20180525,3640,3631,3652,3661,3646,3655,3653,24,22,32616,"178,736.76",125060
,20180528,3655,3653,3660,3666,3629,3633,3638,-20,-15,27548,"150,357.74",115590
,20180529,3633,3638,3633,3642,3629,3632,3635,-6,-3,24032,"131,064.09",103762
,20180530,3632,3635,3628,3637,3622,3630,3631,-5,-4,23652,"128,823.58",91590
,20180531,3630,3631,3638,3655,3635,3650,3645,19,14,41174,"225,143.15",64548
ag1807,20180102,3907,3907,,,,3907,3907,0,0,0,0.00,292
,20180103,3907,3907,3936,3936,3926,3926,3929,19,22,14,82.52,284
,20180104,3926,3929,3932,3932,3932,3932,3932,3,3,4,23.59,284
,20180105,3932,3932,3921,3921,3921,3921,3921,-11,-11,4,23.53,284
,20180108,3921,3921,3929,3929,3909,3909,3919,-12,-2,8,47.03,284
,20180109,3909,3919,3917,3920,3913,3920,3917,1,-2,18,105.76,292
,20180110,3920,3917,3901,3901,3901,3901,3901,-16,-16,4,23.41,290
,20180111,3901,3901,,,,3901,3901,0,0,0,0.00,290
,20180112,3901,3901,3911,3911,3911,3911,3911,10,10,8,46.93,282
,20180115,3911,3911,3950,3950,3950,3950,3950,39,39,6,35.55,282
,20180116,3950,3950,,,,3950,3950,0,0,0,0.00,282
,20180117,3950,3950,3906,3917,3906,3917,3912,-33,-38,14,82.16,282
,20180118,3917,3912,3893,3893,3893,3893,3893,-19,-19,6,35.04,282
,20180119,3893,3893,3870,3870,3870,3870,3870,-23,-23,10,58.05,288
,20180122,3870,3870,3868,3881,3860,3868,3870,-2,0,20,116.10,288
,20180123,3868,3870,3870,3880,3870,3880,3873,10,3,6,34.86,294
,20180124,3880,3873,,,,3873,3873,0,0,0,0.00,294
,20180125,3873,3873,3900,3943,3900,3943,3909,70,36,18,105.55,282
,20180126,3943,3909,3930,3934,3919,3925,3929,16,20,12,70.72,290
,20180129,3925,3929,3912,3918,3884,3901,3911,-28,-18,152,891.81,424
,20180130,3901,3911,3860,3860,3852,3852,3858,-59,-53,12,69.46,434
,20180131,3852,3858,3868,3868,3858,3858,3863,0,5,4,23.18,436
,20180201,3858,3863,3857,3857,3857,3857,3857,-6,-6,4,23.14,440
,20180202,3857,3857,3845,3845,3845,3845,3845,-12,-12,4,23.07,444
,20180205,3845,3845,3848,3848,3716,3767,3774,-78,-71,30,169.85,452
,20180206,3767,3774,3773,3781,3769,3774,3774,0,0,32,181.17,442
,20180207,3774,3774,3756,3756,3756,3756,3756,-18,-18,4,22.54,442
,20180208,3756,3756,3724,3724,3724,3724,3724,-32,-32,4,22.34,446
,20180209,3724,3724,3740,3740,3716,3716,3720,-8,-4,24,133.93,466
,20180212,3716,3720,3706,3725,3693,3712,3706,-8,-14,642,"3,569.33",586
,20180213,3712,3706,3710,3737,3710,3737,3725,31,19,38,212.38,596
,20180214,3737,3725,3732,3732,3732,3732,3732,7,7,2,11.20,598
,20180222,3732,3732,,,,3732,3732,0,0,0,0.00,598
,20180223,3732,3732,3713,3713,3713,3713,3713,-19,-19,4,22.28,598
,20180226,3713,3713,3729,3755,3729,3753,3749,40,36,16,89.99,586
,20180227,3753,3749,3761,3766,3731,3748,3751,-1,2,76,427.70,598
,20180228,3748,3751,3738,3738,3700,3708,3719,-43,-32,40,223.19,594
,20180301,3708,3719,3714,3718,3700,3700,3713,-19,-6,10,55.70,598
,20180302,3700,3713,3663,3715,3663,3707,3690,-6,-23,32,177.14,600
,20180305,3707,3690,3723,3723,3717,3719,3721,29,31,26,145.13,584
,20180306,3719,3721,,,,3721,3721,0,0,0,0.00,584
,20180307,3721,3721,3727,3742,3727,3742,3734,21,13,38,212.89,574
,20180308,3742,3734,3721,3741,3713,3725,3724,-9,-10,52,290.49,550
,20180309,3725,3724,3714,3719,3697,3700,3702,-24,-22,48,266.57,520
,20180312,3700,3702,3697,3734,3697,3711,3713,9,11,26,144.84,520
,20180313,3711,3713,3712,3712,3701,3701,3702,-12,-11,26,144.39,498
,20180314,3701,3702,3714,3723,3709,3711,3714,9,12,184,"1,025.10",428
,20180315,3711,3714,3707,3707,3705,3706,3706,-8,-8,8,44.47,426
,20180316,3706,3706,3695,3695,3674,3681,3688,-25,-18,16,88.53,426
,20180319,3681,3688,3683,3683,3657,3665,3659,-23,-29,28,153.71,426
,20180320,3665,3659,3687,3687,3631,3662,3657,3,-2,40,219.45,426
,20180321,3662,3657,3647,3651,3633,3648,3641,-9,-16,48,262.19,442
,20180322,3648,3641,3661,3703,3661,3702,3688,61,47,84,464.75,462
,20180323,3702,3688,3701,3711,3684,3711,3697,23,9,158,876.26,346
,20180326,3711,3697,3726,3726,3706,3710,3708,13,11,122,678.70,378
,20180327,3710,3708,3717,3723,3708,3708,3716,0,8,48,267.61,334
,20180328,3708,3716,3693,3693,3685,3685,3689,-31,-27,6,33.21,330
,20180329,3685,3689,3636,3636,3636,3636,3636,-53,-53,4,21.82,326
,20180330,3636,3636,3622,3647,3618,3640,3635,4,-1,46,250.88,320
,20180402,3640,3635,3641,3660,3638,3651,3643,16,8,20,109.30,310
,20180403,3651,3643,3674,3674,3673,3673,3673,30,30,4,22.04,310
,20180404,3673,3673,3652,3652,3650,3650,3651,-23,-22,4,21.91,310
,20180409,3650,3651,,,,3651,3651,0,0,0,0.00,310
,20180410,3651,3651,3665,3667,3655,3666,3659,15,8,426,"2,338.15",292
,20180411,3666,3659,3676,3676,3674,3674,3674,15,15,6,33.07,292
,20180412,3674,3674,3697,3697,3697,3697,3697,23,23,2,11.09,292
,20180413,3697,3697,,,,3670,3670,-27,-27,0,0.00,292
,20180416,3670,3670,3680,3683,3680,3683,3681,13,11,4,22.09,292
,20180417,3683,3681,3680,3680,3680,3680,3680,-1,-1,2,11.04,292
,20180418,3680,3680,3701,3701,3701,3701,3701,21,21,2,11.10,292
,20180419,3701,3701,3737,3764,3723,3762,3754,61,53,108,608.26,302
,20180420,3762,3754,3766,3784,3741,3768,3769,14,15,180,"1,017.83",226
,20180423,3768,3769,3745,3752,3745,3752,3751,-17,-18,20,112.54,242
,20180424,3752,3751,3680,3755,3680,3707,3704,-44,-47,74,411.19,240
,20180425,3707,3704,3707,3707,3694,3694,3700,-10,-4,10,55.51,238
,20180426,3694,3700,3678,3682,3678,3682,3680,-18,-20,4,22.08,236
,20180427,3682,3680,3686,3686,3667,3672,3676,-8,-4,30,165.44,208
,20180502,3672,3676,3645,3650,3644,3644,3645,-32,-31,10,54.69,202
,20180503,3644,3645,3654,3664,3654,3664,3660,19,15,6,32.95,200
,20180504,3664,3660,3624,3662,3624,3662,3643,2,-17,4,21.86,198
,20180507,3662,3643,3671,3674,3668,3670,3670,27,27,14,77.09,192
,20180508,3670,3670,3667,3675,3665,3671,3670,1,0,38,209.22,198
,20180509,3671,3670,3666,3676,3650,3662,3663,-8,-7,34,186.84,188
,20180510,3662,3663,,,,3673,3673,10,10,0,0.00,188
,20180511,3673,3673,3700,3707,3691,3702,3699,29,26,18,99.89,190
,20180514,3702,3699,3688,3688,3688,3688,3688,-11,-11,2,11.06,188
,20180515,3688,3688,3685,3685,3663,3665,3670,-23,-18,24,132.15,194
,20180516,3665,3670,3637,3637,3616,3623,3628,-47,-42,10,54.43,196
,20180517,3623,3628,3633,3648,3633,3638,3639,10,11,12,65.52,196
,20180518,3638,3639,3645,3649,3637,3637,3643,-2,4,6,32.79,194
,20180521,3637,3643,3642,3661,3630,3630,3641,-13,-2,12,65.54,194
,20180522,3630,3641,3638,3638,3638,3638,3638,-3,-3,2,10.91,194
,20180523,3638,3638,3669,3671,3669,3671,3670,33,32,18,99.11,202
,20180524,3671,3670,3647,3654,3647,3654,3649,-16,-21,12,65.70,206
,20180525,3654,3649,3679,3680,3669,3669,3674,20,25,18,99.22,206
,20180528,3669,3674,3686,3686,3645,3645,3660,-29,-14,30,164.73,226
,20180529,3645,3660,,,,3660,3660,0,0,0,0.00,226
,20180530,3660,3660,3637,3652,3637,3652,3642,-8,-18,6,32.78,224
,20180531,3652,3642,3668,3673,3655,3664,3662,22,20,54,296.66,220
ag1808,20180102,3937,3937,,,,3937,3937,0,0,0,0.00,104
,20180103,3937,3937,3961,3967,3961,3967,3964,30,27,4,23.78,102
,20180104,3967,3964,,,,3964,3964,0,0,0,0.00,102
,20180105,3964,3964,,,,3964,3964,0,0,0,0.00,102
,20180108,3964,3964,3940,3940,3940,3940,3940,-24,-24,22,130.02,100
,20180109,3940,3940,3943,3943,3942,3943,3942,3,2,8,47.31,102
,20180110,3943,3942,3931,3931,3921,3921,3924,-21,-18,8,47.10,100
,20180111,3921,3924,3941,3941,3932,3932,3936,8,12,8,47.24,102
,20180112,3932,3936,3920,3920,3920,3920,3920,-16,-16,6,35.28,96
,20180115,3920,3920,3933,3951,3933,3951,3942,31,22,4,23.65,96
,20180116,3951,3942,3971,3971,3971,3971,3971,29,29,4,23.83,100
,20180117,3971,3971,3918,3926,3918,3926,3925,-45,-46,146,859.70,238
,20180118,3926,3925,3923,3923,3922,3922,3922,-3,-3,4,23.54,238
,20180119,3922,3922,3903,3903,3884,3884,3895,-38,-27,20,116.86,218
,20180122,3884,3895,3888,3888,3888,3888,3888,-7,-7,4,23.33,214
,20180123,3888,3888,3888,3888,3888,3888,3888,0,0,4,23.33,210
,20180124,3888,3888,,,,3888,3888,0,0,0,0.00,210
,20180125,3888,3888,3917,3994,3917,3969,3947,81,59,38,225.03,214
,20180126,3969,3947,3940,3940,3940,3940,3940,-7,-7,4,23.64,218
,20180129,3940,3940,,,,3940,3940,0,0,0,0.00,218
,20180130,3940,3940,3908,3911,3890,3890,3904,-50,-36,28,164.00,220
,20180131,3890,3904,3896,3896,3881,3881,3891,-23,-13,6,35.02,224
,20180201,3881,3891,3880,3900,3880,3895,3894,4,3,34,198.63,238
,20180202,3895,3894,3871,3871,3871,3871,3871,-23,-23,2,11.61,238
,20180205,3871,3871,,,,3790,3790,-81,-81,0,0.00,238
,20180206,3790,3790,3799,3799,3795,3795,3796,5,6,10,56.95,242
,20180207,3795,3796,,,,3785,3785,-11,-11,0,0.00,242
,20180208,3785,3785,3747,3747,3747,3747,3747,-38,-38,6,33.72,242
,20180209,3747,3747,3738,3747,3738,3747,3742,0,-5,4,22.46,242
,20180212,3747,3742,3724,3755,3717,3755,3727,13,-15,34,190.10,254
,20180213,3755,3727,3732,3756,3730,3748,3735,21,8,102,571.58,288
,20180214,3748,3735,3748,3748,3748,3748,3748,13,13,2,11.24,286
,20180222,3748,3748,,,,3718,3718,-30,-30,0,0.00,286
,20180223,3718,3718,,,,3718,3718,0,0,0,0.00,286
,20180226,3718,3718,,,,3764,3764,46,46,0,0.00,286
,20180227,3764,3764,3770,3770,3770,3770,3770,6,6,2,11.31,288
,20180228,3770,3770,,,,3770,3770,0,0,0,0.00,288
,20180301,3770,3770,3723,3723,3723,3723,3723,-47,-47,2,11.17,286
,20180302,3723,3723,3710,3710,3710,3710,3710,-13,-13,6,33.39,280
,20180305,3710,3710,3743,3751,3743,3751,3747,41,37,4,22.48,280
,20180306,3751,3747,,,,3737,3737,-10,-10,0,0.00,280
,20180307,3737,3737,3751,3752,3751,3752,3751,15,14,30,168.80,250
,20180308,3752,3751,3744,3744,3735,3735,3739,-16,-12,8,44.87,250
,20180309,3735,3739,,,,3739,3739,0,0,0,0.00,250
,20180312,3739,3739,,,,3739,3739,0,0,0,0.00,250
,20180313,3739,3739,,,,3739,3739,0,0,0,0.00,250
,20180314,3739,3739,,,,3739,3739,0,0,0,0.00,250
,20180315,3739,3739,,,,3739,3739,0,0,0,0.00,250
,20180316,3739,3739,,,,3739,3739,0,0,0,0.00,250
,20180319,3739,3739,3685,3685,3670,3670,3680,-69,-59,16,88.32,248
,20180320,3670,3680,3664,3687,3664,3687,3673,7,-7,34,187.37,254
,20180321,3687,3673,3664,3672,3664,3672,3668,-1,-5,4,22.01,254
,20180322,3672,3668,,,,3715,3715,47,47,0,0.00,254
,20180323,3715,3715,,,,3715,3715,0,0,0,0.00,254
,20180326,3715,3715,3722,3722,3722,3722,3722,7,7,2,11.17,254
,20180327,3722,3722,,,,3722,3722,0,0,0,0.00,254
,20180328,3722,3722,,,,3698,3698,-24,-24,0,0.00,254
,20180329,3698,3698,3654,3654,3654,3654,3654,-44,-44,2,10.96,252
,20180330,3654,3654,3629,3629,3629,3629,3629,-25,-25,2,10.89,252
,20180402,3629,3629,,,,3629,3629,0,0,0,0.00,252
,20180403,3629,3629,,,,3629,3629,0,0,0,0.00,252
,20180404,3629,3629,3679,3693,3679,3693,3690,64,61,14,77.51,264
,20180409,3693,3690,,,,3690,3690,0,0,0,0.00,264
,20180410,3690,3690,3681,3683,3681,3683,3681,-7,-9,8,44.18,266
,20180411,3683,3681,3686,3693,3679,3679,3686,-2,5,6,33.17,262
,20180412,3679,3686,3694,3702,3685,3701,3697,15,11,40,221.87,280
,20180413,3701,3697,,,,3697,3697,0,0,0,0.00,280
,20180416,3697,3697,,,,3697,3697,0,0,0,0.00,280
,20180417,3697,3697,,,,3697,3697,0,0,0,0.00,280
,20180418,3697,3697,3706,3706,3706,3706,3706,9,9,2,11.12,282
,20180419,3706,3706,3782,3782,3759,3775,3771,69,65,62,350.71,286
,20180420,3775,3771,3783,3810,3783,3784,3790,13,19,46,261.53,312
,20180423,3784,3790,3773,3773,3773,3773,3773,-17,-17,4,22.64,310
,20180424,3773,3773,,,,3773,3773,0,0,0,0.00,310
,20180425,3773,3773,,,,3773,3773,0,0,0,0.00,310
,20180426,3773,3773,,,,3773,3773,0,0,0,0.00,310
,20180427,3773,3773,3699,3712,3673,3673,3691,-100,-82,88,487.26,342
,20180502,3673,3691,3654,3663,3654,3663,3658,-28,-33,6,32.93,342
,20180503,3663,3658,3670,3689,3670,3689,3685,31,27,22,121.63,360
,20180504,3689,3685,3692,3692,3676,3678,3681,-7,-4,16,88.36,358
,20180507,3678,3681,3693,3704,3688,3688,3688,7,7,86,475.82,334
,20180508,3688,3688,3695,3695,3690,3690,3692,2,4,4,22.16,334
,20180509,3690,3692,3686,3686,3686,3686,3686,-6,-6,4,22.12,334
,20180510,3686,3686,3703,3703,3698,3699,3699,13,13,14,77.69,324
,20180511,3699,3699,3721,3725,3711,3725,3721,26,22,24,133.96,326
,20180514,3725,3721,3708,3708,3708,3708,3708,-13,-13,2,11.12,324
,20180515,3708,3708,3688,3689,3688,3689,3688,-19,-20,16,88.53,336
,20180516,3689,3688,3633,3650,3633,3650,3645,-38,-43,24,131.24,340
,20180517,3650,3645,3652,3670,3652,3654,3659,9,14,8,43.91,344
,20180518,3654,3659,,,,3659,3659,0,0,0,0.00,344
,20180521,3659,3659,3675,3675,3647,3647,3654,-12,-5,20,109.62,338
,20180522,3647,3654,3672,3672,3672,3672,3672,18,18,2,11.02,340
,20180523,3672,3672,3678,3683,3675,3675,3679,3,7,10,55.19,340
,20180524,3675,3679,3657,3674,3657,3674,3664,-5,-15,14,76.96,338
,20180525,3674,3664,3685,3691,3681,3685,3686,21,22,32,176.95,328
,20180528,3685,3686,3669,3669,3664,3666,3667,-20,-19,42,231.05,332
,20180529,3666,3667,3660,3669,3660,3669,3667,2,0,14,77.02,340
,20180530,3669,3667,3664,3664,3663,3663,3663,-4,-4,4,21.98,336
,20180531,3663,3663,3681,3692,3678,3682,3680,19,17,28,154.56,320
ag1809,20180102,3954,3949,3977,3977,3965,3975,3971,26,22,18,107.24,390
,20180103,3975,3971,3977,3994,3974,3974,3979,3,8,26,155.20,382
,20180104,3974,3979,3974,3974,3939,3948,3948,-31,-31,46,272.46,378
,20180105,3948,3948,3954,3973,3939,3939,3952,-9,4,98,581.00,442
,20180108,3939,3952,3888,3974,3888,3954,3934,2,-18,228,"1,345.58",376
,20180109,3954,3934,3955,3956,3955,3956,3955,22,21,8,47.47,382
,20180110,3956,3955,3953,3953,3939,3939,3946,-16,-9,22,130.23,388
,20180111,3939,3946,3955,3955,3955,3955,3955,9,9,2,11.87,388
,20180112,3955,3955,3949,3949,3930,3942,3938,-13,-17,32,189.06,380
,20180115,3942,3938,3965,3994,3938,3994,3965,56,27,54,321.23,402
,20180116,3994,3965,3993,3993,3978,3978,3984,13,19,10,59.76,404
,20180117,3978,3984,3943,3960,3936,3938,3945,-46,-39,62,366.95,388
,20180118,3938,3945,3935,3940,3923,3923,3933,-22,-12,10,59.00,384
,20180119,3923,3933,3918,3918,3894,3900,3902,-33,-31,18,105.38,378
,20180122,3900,3902,3907,3909,3903,3903,3906,1,4,18,105.47,376
,20180123,3903,3906,3904,3904,3904,3904,3904,-2,-2,8,46.85,384
,20180124,3904,3904,3894,3902,3880,3902,3896,-2,-8,32,187.04,400
,20180125,3902,3896,3934,3985,3933,3985,3953,89,57,32,189.75,384
,20180126,3985,3953,3965,3965,3954,3954,3957,1,4,30,178.08,370
,20180129,3954,3957,3939,3943,3936,3936,3938,-21,-19,12,70.90,368
,20180130,3936,3938,3917,3921,3907,3913,3913,-25,-25,30,176.12,364
,20180131,3913,3913,3900,3900,3898,3898,3899,-15,-14,4,23.39,368
,20180201,3898,3899,3895,3902,3895,3900,3900,1,1,14,81.90,374
,20180202,3900,3900,3898,3898,3888,3888,3893,-12,-7,4,23.36,374
,20180205,3888,3893,3887,3887,3791,3791,3812,-102,-81,104,594.73,392
,20180206,3791,3812,3803,3847,3803,3832,3812,20,0,40,228.77,394
,20180207,3832,3812,3800,3800,3788,3795,3794,-17,-18,14,79.69,392
,20180208,3795,3794,3765,3765,3681,3734,3740,-60,-54,64,359.08,390
,20180209,3734,3740,3747,3775,3745,3751,3755,11,15,22,123.93,386
,20180212,3751,3755,3741,3758,3730,3752,3744,-3,-11,80,449.29,386
,20180213,3752,3744,3770,3780,3766,3779,3772,35,28,20,113.18,378
,20180214,3779,3772,3779,3779,3779,3779,3779,7,7,2,11.34,376
,20180222,3779,3779,3743,3748,3738,3740,3742,-39,-37,12,67.36,380
,20180223,3740,3742,3751,3766,3751,3764,3761,22,19,38,214.40,400
,20180226,3764,3761,3764,3793,3760,3793,3774,32,13,34,192.49,406
,20180227,3793,3774,3786,3787,3778,3778,3782,4,8,30,170.22,408
,20180228,3778,3782,3769,3769,3745,3751,3749,-31,-33,44,247.49,436
,20180301,3751,3749,3751,3753,3740,3740,3747,-9,-2,20,112.41,440
,20180302,3740,3747,3733,3758,3723,3746,3742,-1,-5,90,505.25,448
,20180305,3746,3742,3749,3770,3749,3766,3755,24,13,32,180.25,446
,20180306,3766,3755,3752,3752,3750,3750,3750,-5,-5,8,45.01,450
,20180307,3750,3750,3773,3792,3762,3778,3779,28,29,34,192.74,436
,20180308,3778,3779,3771,3775,3753,3770,3766,-9,-13,56,316.38,440
,20180309,3770,3766,3769,3769,3741,3754,3745,-12,-21,94,528.16,466
,20180312,3754,3745,3740,3775,3740,3762,3752,17,7,60,337.77,472
,20180313,3762,3752,3743,3749,3740,3742,3743,-10,-9,10,56.15,474
,20180314,3742,3743,3750,3750,3750,3750,3750,7,7,8,45.00,470
,20180315,3750,3750,,,,3750,3750,0,0,0,0.00,470
,20180316,3750,3750,3736,3737,3732,3735,3735,-15,-15,18,100.86,472
,20180319,3735,3735,3738,3738,3692,3698,3706,-37,-29,74,411.38,502
,20180320,3698,3706,3697,3707,3697,3702,3700,-4,-6,28,155.41,522
,20180321,3702,3700,3679,3689,3679,3689,3680,-11,-20,24,132.51,538
,20180322,3689,3680,3731,3751,3721,3749,3733,69,53,44,246.41,542
,20180323,3749,3733,3736,3756,3730,3744,3738,11,5,88,493.49,538
,20180326,3744,3738,3753,3753,3733,3741,3748,3,10,36,202.40,542
,20180327,3741,3748,3750,3753,3744,3753,3752,5,4,44,247.66,534
,20180328,3753,3752,3753,3753,3712,3712,3737,-40,-15,194,"1,087.56",546
,20180329,3712,3737,3702,3702,3661,3661,3677,-76,-60,52,286.87,560
,20180330,3661,3677,3667,3685,3655,3665,3662,-12,-15,1282,"7,043.92",1404
,20180402,3665,3662,3669,3686,3661,3681,3671,19,9,424,"2,335.36",1608
,20180403,3681,3671,3706,3710,3695,3703,3701,32,30,56,310.96,1606
,20180404,3703,3701,3681,3692,3671,3692,3680,-9,-21,26,143.54,1608
,20180409,3692,3680,3688,3691,3682,3687,3687,7,7,82,453.59,1610
,20180410,3687,3687,3685,3705,3684,3688,3692,1,5,82,454.17,1608
,20180411,3688,3692,3697,3708,3696,3704,3701,12,9,198,"1,099.47",1608
,20180412,3704,3701,3708,3737,3705,3713,3714,12,13,140,780.02,1606
,20180413,3713,3714,3692,3700,3632,3682,3675,-32,-39,160,882.06,1602
,20180416,3682,3675,3682,3718,3682,3700,3703,25,28,116,644.35,1608
,20180417,3700,3703,3707,3715,3698,3703,3707,0,4,190,"1,056.73",1604
,20180418,3703,3707,3694,3728,3694,3723,3711,16,4,214,"1,191.30",1480
,20180419,3723,3711,3760,3805,3758,3805,3785,94,74,1310,"7,439.21",1060
,20180420,3805,3785,3808,3824,3799,3805,3815,20,30,658,"3,765.56",906
,20180423,3805,3815,3796,3814,3782,3790,3793,-25,-22,144,819.47,938
,20180424,3790,3793,3742,3756,3734,3743,3745,-50,-48,324,"1,820.18",996
,20180425,3743,3745,3738,3753,3732,3735,3742,-10,-3,226,"1,268.60",1078
,20180426,3735,3742,3725,3740,3554,3735,3699,-7,-43,136,754.68,1062
,20180427,3735,3699,3727,3727,3703,3711,3708,12,9,160,890.06,1078
,20180502,3711,3708,3666,3689,3663,3685,3683,-23,-25,180,994.43,1070
,20180503,3685,3683,3695,3706,3684,3701,3698,18,15,78,432.72,1068
,20180504,3701,3698,3702,3712,3701,3701,3707,3,9,104,578.44,1056
,20180507,3701,3707,3711,3720,3711,3720,3717,13,10,84,468.45,1102
,20180508,3720,3717,3718,3718,3711,3711,3712,-6,-5,24,133.64,1096
,20180509,3711,3712,3711,3711,3691,3702,3701,-10,-11,88,488.60,1102
,20180510,3702,3701,3717,3724,3714,3716,3718,15,17,92,513.09,1128
,20180511,3716,3718,3735,3741,3731,3737,3735,19,17,100,560.31,1110
,20180514,3737,3735,3751,3751,3726,3726,3740,-9,5,100,561.03,1114
,20180515,3726,3740,3720,3727,3689,3689,3708,-51,-32,154,856.60,1180
,20180516,3689,3708,3681,3681,3655,3666,3661,-42,-47,278,"1,526.97",1230
,20180517,3666,3661,3657,3680,3657,3666,3669,5,8,58,319.21,1226
,20180518,3666,3669,3681,3685,3674,3684,3681,15,12,114,629.55,1236
,20180521,3684,3681,3679,3693,3663,3666,3676,-15,-5,176,970.57,1274
,20180522,3666,3676,3696,3696,3680,3683,3687,7,11,50,276.57,1262
,20180523,3683,3687,3702,3710,3690,3695,3700,8,13,250,"1,387.79",1286
,20180524,3695,3700,3682,3691,3667,3686,3682,-14,-18,60,331.42,1268
,20180525,3686,3682,3706,3710,3697,3704,3703,22,21,72,399.93,1248
,20180528,3704,3703,3706,3710,3665,3676,3686,-27,-17,72,398.13,1242
,20180529,3676,3686,3719,3719,3676,3683,3687,-3,1,56,309.76,1234
,20180530,3683,3687,3672,3685,3672,3678,3678,-9,-9,116,640.01,1218
,20180531,3678,3678,3690,3707,3688,3707,3698,29,20,214,"1,187.17",1248
ag1810,20180102,3971,3974,,,,3974,3974,0,0,0,0.00,144
,20180103,3974,3974,4002,4002,4000,4000,4001,26,27,4,24.01,144
,20180104,4000,4001,3968,3968,3968,3968,3968,-33,-33,2,11.90,144
,20180105,3968,3968,,,,3968,3968,0,0,0,0.00,144
,20180108,3968,3968,,,,3968,3968,0,0,0,0.00,144
,20180109,3968,3968,,,,3968,3968,0,0,0,0.00,144
,20180110,3968,3968,,,,3968,3968,0,0,0,0.00,144
,20180111,3968,3968,,,,3968,3968,0,0,0,0.00,144
,20180112,3968,3968,3959,3959,3959,3959,3959,-9,-9,2,11.88,146
,20180115,3959,3959,3991,3991,3991,3991,3991,32,32,2,11.97,146
,20180116,3991,3991,,,,3991,3991,0,0,0,0.00,146
,20180117,3991,3991,3966,3975,3959,3975,3967,-16,-24,10,59.52,144
,20180118,3975,3967,3961,3961,3940,3940,3954,-27,-13,6,35.59,150
,20180119,3940,3954,3918,3918,3918,3918,3918,-36,-36,4,23.51,154
,20180122,3918,3918,3924,3924,3924,3924,3924,6,6,2,11.77,152
,20180123,3924,3924,3929,3929,3921,3926,3926,2,2,10,58.89,160
,20180124,3926,3926,,,,3926,3926,0,0,0,0.00,160
,20180125,3926,3926,3971,3971,3971,3971,3971,45,45,4,23.83,160
,20180126,3971,3971,,,,3971,3971,0,0,0,0.00,160
,20180129,3971,3971,,,,3971,3971,0,0,0,0.00,160
,20180130,3971,3971,3912,3912,3908,3908,3910,-63,-61,6,35.19,154
,20180131,3908,3910,,,,3910,3910,0,0,0,0.00,154
,20180201,3910,3910,,,,3910,3910,0,0,0,0.00,154
,20180202,3910,3910,,,,3910,3910,0,0,0,0.00,154
,20180205,3910,3910,,,,3819,3819,-91,-91,0,0.00,154
,20180206,3819,3819,3856,3856,3856,3856,3856,37,37,8,46.27,146
,20180207,3856,3856,3828,3828,3828,3828,3828,-28,-28,2,11.48,144
,20180208,3828,3828,3737,3746,3737,3746,3741,-82,-87,4,22.45,146
,20180209,3746,3741,,,,3741,3741,0,0,0,0.00,146
,20180212,3741,3741,,,,3741,3741,0,0,0,0.00,146
,20180213,3741,3741,,,,3741,3741,0,0,0,0.00,146
,20180214,3741,3741,,,,3747,3747,6,6,0,0.00,146
,20180222,3747,3747,,,,3747,3747,0,0,0,0.00,146
,20180223,3747,3747,,,,3747,3747,0,0,0,0.00,146
,20180226,3747,3747,,,,3747,3747,0,0,0,0.00,146
,20180227,3747,3747,3822,3822,3808,3808,3819,61,72,12,68.75,146
,20180228,3808,3819,3771,3771,3771,3771,3771,-48,-48,2,11.31,148
,20180301,3771,3771,3772,3772,3772,3772,3772,1,1,2,11.32,150
,20180302,3772,3772,3707,3774,3707,3774,3721,2,-51,16,89.31,148
,20180305,3774,3721,3787,3787,3774,3776,3774,55,53,122,690.80,268
,20180306,3776,3774,,,,3774,3774,0,0,0,0.00,268
,20180307,3774,3774,,,,3774,3774,0,0,0,0.00,268
,20180308,3774,3774,,,,3774,3774,0,0,0,0.00,268
,20180309,3774,3774,3769,3769,3760,3760,3764,-14,-10,8,45.17,264
,20180312,3760,3764,,,,3764,3764,0,0,0,0.00,264
,20180313,3764,3764,3765,3771,3760,3771,3764,7,0,20,112.93,262
,20180314,3771,3764,3762,3768,3762,3768,3765,4,1,4,22.59,262
,20180315,3768,3765,3760,3760,3757,3757,3758,-8,-7,4,22.55,262
,20180316,3757,3758,,,,3758,3758,0,0,0,0.00,262
,20180319,3758,3758,,,,3758,3758,0,0,0,0.00,262
,20180320,3758,3758,,,,3758,3758,0,0,0,0.00,262
,20180321,3758,3758,,,,3720,3720,-38,-38,0,0.00,262
,20180322,3720,3720,,,,3720,3720,0,0,0,0.00,262
,20180323,3720,3720,3812,3812,3763,3763,3795,43,75,6,34.16,256
,20180326,3763,3795,,,,3795,3795,0,0,0,0.00,256
,20180327,3795,3795,3768,3768,3768,3768,3768,-27,-27,4,22.61,256
,20180328,3768,3768,,,,3768,3768,0,0,0,0.00,256
,20180329,3768,3768,3691,3691,3689,3689,3690,-79,-78,4,22.14,254
,20180330,3689,3690,3676,3676,3676,3676,3676,-14,-14,2,11.03,254
,20180402,3676,3676,3689,3716,3689,3695,3692,19,16,26,144.00,274
,20180403,3695,3692,3728,3728,3728,3728,3728,36,36,2,11.18,274
,20180404,3728,3728,,,,3728,3728,0,0,0,0.00,274
,20180409,3728,3728,,,,3728,3728,0,0,0,0.00,274
,20180410,3728,3728,3715,3732,3702,3702,3716,-26,-12,6,33.45,278
,20180411,3702,3716,3716,3716,3716,3716,3716,0,0,2,11.15,278
,20180412,3716,3716,3727,3727,3727,3727,3727,11,11,6,33.54,280
,20180413,3727,3727,3707,3707,3700,3700,3702,-27,-25,14,77.74,280
,20180416,3700,3702,3719,3733,3719,3727,3724,25,22,10,55.86,276
,20180417,3727,3724,3720,3722,3720,3722,3721,-2,-3,4,22.33,276
,20180418,3722,3721,3724,3734,3723,3728,3727,7,6,28,156.56,276
,20180419,3728,3727,3815,3852,3781,3808,3801,81,74,112,638.59,244
,20180420,3808,3801,3828,3833,3810,3822,3823,21,22,80,458.80,228
,20180423,3822,3823,3817,3824,3794,3804,3809,-19,-14,50,285.72,204
,20180424,3804,3809,3756,3768,3756,3766,3760,-43,-49,16,90.26,206
,20180425,3766,3760,3746,3762,3746,3762,3753,2,-7,20,112.61,206
,20180426,3762,3753,,,,3753,3753,0,0,0,0.00,206
,20180427,3753,3753,3732,3732,3706,3706,3722,-47,-31,6,33.50,206
,20180502,3706,3722,3701,3701,3701,3701,3701,-21,-21,2,11.10,206
,20180503,3701,3701,,,,3701,3701,0,0,0,0.00,206
,20180504,3701,3701,,,,3701,3701,0,0,0,0.00,206
,20180507,3701,3701,3735,3735,3722,3723,3728,22,27,20,111.86,210
,20180508,3723,3728,,,,3728,3728,0,0,0,0.00,210
,20180509,3728,3728,,,,3728,3728,0,0,0,0.00,210
,20180510,3728,3728,3740,3741,3731,3731,3733,3,5,18,100.81,214
,20180511,3731,3733,3753,3758,3750,3750,3753,17,20,12,67.56,214
,20180514,3750,3753,3762,3762,3747,3747,3751,-6,-2,8,45.02,210
,20180515,3747,3751,,,,3751,3751,0,0,0,0.00,210
,20180516,3751,3751,3673,3689,3673,3689,3678,-62,-73,12,66.21,210
,20180517,3689,3678,3688,3726,3678,3702,3704,24,26,22,122.24,222
,20180518,3702,3704,,,,3704,3704,0,0,0,0.00,222
,20180521,3704,3704,3694,3694,3694,3694,3694,-10,-10,2,11.08,222
,20180522,3694,3694,3695,3695,3695,3695,3695,1,1,2,11.09,222
,20180523,3695,3695,3720,3720,3682,3682,3712,-13,17,14,77.96,210
,20180524,3682,3712,3690,3706,3690,3706,3702,-6,-10,10,55.54,206
,20180525,3706,3702,,,,3710,3710,8,8,0,0.00,206
,20180528,3710,3710,3733,3753,3708,3708,3718,-2,8,138,769.63,206
,20180529,3708,3718,3704,3704,3704,3704,3704,-14,-14,2,11.11,204
,20180530,3704,3704,,,,3704,3704,0,0,0,0.00,204
,20180531,3704,3704,3720,3728,3690,3726,3717,22,13,48,267.64,182
ag1811,20180102,3987,4000,4006,4006,3999,3999,4001,-1,1,10,60.02,76
,20180103,3999,4001,4003,4012,4003,4012,4004,11,3,10,60.07,72
,20180104,4012,4004,3975,3975,3975,3975,3975,-29,-29,2,11.93,70
,20180105,3975,3975,,,,3975,3975,0,0,0,0.00,70
,20180108,3975,3975,,,,3975,3975,0,0,0,0.00,70
,20180109,3975,3975,,,,3975,3975,0,0,0,0.00,70
,20180110,3975,3975,,,,3975,3975,0,0,0,0.00,70
,20180111,3975,3975,,,,3975,3975,0,0,0,0.00,70
,20180112,3975,3975,3980,3980,3980,3980,3980,5,5,2,11.94,70
,20180115,3980,3980,4058,4058,3949,4020,4008,40,28,14,84.17,72
,20180116,4020,4008,4019,4019,4019,4019,4019,11,11,2,12.06,72
,20180117,4019,4019,,,,3990,3990,-29,-29,0,0.00,72
,20180118,3990,3990,3957,3957,3957,3957,3957,-33,-33,2,11.87,74
,20180119,3957,3957,3940,3940,3940,3940,3940,-17,-17,2,11.82,74
,20180122,3940,3940,3941,3941,3941,3941,3941,1,1,2,11.82,74
,20180123,3941,3941,,,,3941,3941,0,0,0,0.00,74
,20180124,3941,3941,,,,3941,3941,0,0,0,0.00,74
,20180125,3941,3941,,,,3941,3941,0,0,0,0.00,74
,20180126,3941,3941,,,,3941,3941,0,0,0,0.00,74
,20180129,3941,3941,3976,3976,3976,3976,3976,35,35,4,23.86,74
,20180130,3976,3976,3956,3970,3952,3970,3959,-6,-17,6,35.63,76
,20180131,3970,3959,3935,3935,3922,3922,3928,-37,-31,4,23.57,74
,20180201,3922,3928,,,,3928,3928,0,0,0,0.00,74
,20180202,3928,3928,3910,3918,3910,3918,3912,-10,-16,6,35.21,74
,20180205,3918,3912,3867,3867,3829,3829,3842,-83,-70,12,69.16,74
,20180206,3829,3842,3839,3839,3839,3839,3839,-3,-3,2,11.52,74
,20180207,3839,3839,3835,3835,3835,3835,3835,-4,-4,2,11.51,72
,20180208,3835,3835,3780,3780,3755,3755,3766,-80,-69,12,67.80,76
,20180209,3755,3766,3793,3796,3791,3796,3793,30,27,26,147.93,90
,20180212,3796,3793,3763,3763,3763,3763,3763,-30,-30,2,11.29,92
,20180213,3763,3763,3811,3811,3811,3811,3811,48,48,2,11.43,90
,20180214,3811,3811,,,,3811,3811,0,0,0,0.00,90
,20180222,3811,3811,3765,3765,3765,3765,3765,-46,-46,2,11.30,90
,20180223,3765,3765,,,,3765,3765,0,0,0,0.00,90
,20180226,3765,3765,3800,3800,3800,3800,3800,35,35,2,11.40,88
,20180227,3800,3800,,,,3800,3800,0,0,0,0.00,88
,20180228,3800,3800,,,,3800,3800,0,0,0,0.00,88
,20180301,3800,3800,3782,3782,3773,3773,3776,-27,-24,6,33.98,92
,20180302,3773,3776,3790,3790,3790,3790,3790,14,14,2,11.37,92
,20180305,3790,3790,,,,3790,3790,0,0,0,0.00,92
,20180306,3790,3790,,,,3790,3790,0,0,0,0.00,92
,20180307,3790,3790,3814,3814,3814,3814,3814,24,24,4,22.88,88
,20180308,3814,3814,,,,3814,3814,0,0,0,0.00,88
,20180309,3814,3814,3778,3778,3778,3778,3778,-36,-36,4,22.67,84
,20180312,3778,3778,3802,3802,3786,3786,3794,8,16,4,22.76,84
,20180313,3786,3794,,,,3794,3794,0,0,0,0.00,84
,20180314,3794,3794,,,,3794,3794,0,0,0,0.00,84
,20180315,3794,3794,3779,3779,3779,3779,3779,-15,-15,2,11.34,82
,20180316,3779,3779,,,,3779,3779,0,0,0,0.00,82
,20180319,3779,3779,,,,3779,3779,0,0,0,0.00,82
,20180320,3779,3779,3736,3736,3736,3736,3736,-43,-43,2,11.21,80
,20180321,3736,3736,3724,3730,3724,3730,3727,-6,-9,4,22.36,84
,20180322,3730,3727,3773,3773,3773,3773,3773,46,46,4,22.64,84
,20180323,3773,3773,3782,3786,3779,3786,3782,13,9,6,34.04,84
,20180326,3786,3782,,,,3782,3782,0,0,0,0.00,84
,20180327,3782,3782,,,,3782,3782,0,0,0,0.00,84
,20180328,3782,3782,3762,3762,3762,3762,3762,-20,-20,2,11.29,84
,20180329,3762,3762,,,,3761,3761,-1,-1,0,0.00,84
,20180330,3761,3761,3693,3693,3693,3693,3693,-68,-68,4,22.16,88
,20180402,3693,3693,,,,3693,3693,0,0,0,0.00,88
,20180403,3693,3693,3739,3739,3738,3738,3738,45,45,6,33.65,90
,20180404,3738,3738,,,,3738,3738,0,0,0,0.00,90
,20180409,3738,3738,,,,3738,3738,0,0,0,0.00,90
,20180410,3738,3738,,,,3738,3738,0,0,0,0.00,90
,20180411,3738,3738,3746,3764,3727,3727,3745,-11,7,6,33.71,92
,20180412,3727,3745,,,,3745,3745,0,0,0,0.00,92
,20180413,3745,3745,3728,3728,3728,3728,3728,-17,-17,2,11.18,90
,20180416,3728,3728,,,,3728,3728,0,0,0,0.00,90
,20180417,3728,3728,,,,3728,3728,0,0,0,0.00,90
,20180418,3728,3728,,,,3728,3728,0,0,0,0.00,90
,20180419,3728,3728,3811,3832,3805,3816,3817,88,89,42,240.53,92
,20180420,3816,3817,3848,3848,3824,3824,3836,7,19,4,23.02,94
,20180423,3824,3836,3815,3835,3814,3835,3820,-1,-16,10,57.30,90
,20180424,3835,3820,3770,3776,3730,3730,3760,-90,-60,8,45.13,86
,20180425,3730,3760,3770,3770,3770,3770,3770,10,10,2,11.31,84
,20180426,3770,3770,,,,3770,3770,0,0,0,0.00,84
,20180427,3770,3770,3752,3752,3710,3726,3735,-44,-35,8,44.82,84
,20180502,3726,3735,3726,3726,3726,3726,3726,-9,-9,2,11.18,84
,20180503,3726,3726,3709,3732,3705,3732,3709,6,-17,36,200.33,112
,20180504,3732,3709,3739,3739,3739,3739,3739,30,30,28,157.04,84
,20180507,3739,3739,,,,3739,3739,0,0,0,0.00,84
,20180508,3739,3739,,,,3739,3739,0,0,0,0.00,84
,20180509,3739,3739,,,,3739,3739,0,0,0,0.00,84
,20180510,3739,3739,,,,3739,3739,0,0,0,0.00,84
,20180511,3739,3739,3756,3756,3756,3756,3756,17,17,2,11.27,84
,20180514,3756,3756,3767,3767,3746,3763,3755,7,-1,16,90.13,84
,20180515,3763,3755,3746,3749,3733,3733,3742,-22,-13,18,101.05,94
,20180516,3733,3742,,,,3742,3742,0,0,0,0.00,94
,20180517,3742,3742,,,,3742,3742,0,0,0,0.00,94
,20180518,3742,3742,,,,3742,3742,0,0,0,0.00,94
,20180521,3742,3742,3707,3711,3707,3710,3709,-32,-33,16,89.04,104
,20180522,3710,3709,,,,3710,3710,1,1,0,0.00,104
,20180523,3710,3710,,,,3710,3710,0,0,0,0.00,104
,20180524,3710,3710,3717,3717,3717,3717,3717,7,7,2,11.15,104
,20180525,3717,3717,3727,3727,3727,3727,3727,10,10,2,11.18,104
,20180528,3727,3727,3729,3732,3715,3715,3722,-12,-5,10,55.84,108
,20180529,3715,3722,,,,3722,3722,0,0,0,0.00,108
,20180530,3722,3722,3719,3719,3711,3711,3715,-11,-7,4,22.29,108
,20180531,3711,3715,,,,3715,3715,0,0,0,0.00,108
ag1812,20180102,3999,3991,4004,4023,4004,4019,4016,28,25,460,"2,771.16",1208
,20180103,4019,4016,4022,4043,4015,4015,4029,-1,13,1378,"8,329.20",1892
,20180104,4015,4029,4012,4028,3988,3997,4005,-32,-24,692,"4,157.49",2054
,20180105,3997,4005,4002,4023,3993,4005,4010,0,5,478,"2,875.63",2124
,20180108,4005,4010,4007,4025,3998,4006,4010,-4,0,822,"4,944.41",2528
,20180109,4006,4010,4003,4013,4000,4011,4009,1,-1,484,"2,910.61",2674
,20180110,4011,4009,4006,4006,3981,3987,3992,-22,-17,1242,"7,437.14",3202
,20180111,3987,3992,3996,4012,3991,3995,3998,3,6,1342,"8,048.37",3866
,20180112,3995,3998,3994,4002,3963,3999,3988,1,-10,2158,"12,912.14",4678
,20180115,3999,3988,4003,4044,3987,4035,4020,47,32,1912,"11,530.40",5330
,20180116,4035,4020,4035,4039,4012,4017,4028,-3,8,860,"5,197.14",5508
,20180117,4017,4028,4003,4008,3980,3986,3991,-42,-37,1694,"10,142.66",5740
,20180118,3986,3991,3990,3992,3957,3965,3973,-26,-18,1500,"8,941.23",5964
,20180119,3965,3973,3962,3968,3941,3942,3950,-31,-23,1534,"9,089.88",6430
,20180122,3942,3950,3944,3956,3943,3943,3949,-7,-1,1758,"10,414.33",6682
,20180123,3943,3949,3943,3957,3854,3953,3946,4,-3,3092,"18,301.85",7642
,20180124,3953,3946,3945,3949,3911,3940,3927,-6,-19,2320,"13,666.82",7696
,20180125,3940,3927,3972,4034,3969,4022,4000,95,73,6666,"39,998.15",8832
,20180126,4022,4000,4005,4026,3979,4001,4003,1,3,5160,"30,990.41",10426
,20180129,4001,4003,3988,4002,3982,3984,3990,-19,-13,1900,"11,372.42",10942
,20180130,3984,3990,3973,3975,3930,3931,3954,-59,-36,3300,"19,577.02",11326
,20180131,3931,3954,3948,3960,3932,3938,3942,-16,-12,2096,"12,396.55",11744
,20180201,3938,3942,3931,3950,3931,3933,3942,-9,0,2836,"16,772.91",12562
,20180202,3933,3942,3937,3940,3920,3932,3931,-10,-11,4942,"29,141.82",15644
,20180205,3932,3931,3926,3934,3831,3836,3865,-95,-66,8936,"51,807.69",16024
,20180206,3836,3865,3848,3900,3833,3874,3862,9,-3,5746,"33,288.86",17656
,20180207,3874,3862,3852,3852,3821,3833,3833,-29,-29,7360,"42,324.64",20146
,20180208,3833,3833,3813,3813,3757,3779,3779,-54,-54,6842,"38,785.47",20668
,20180209,3779,3779,3786,3820,3779,3792,3799,13,20,4728,"26,944.78",20558
,20180212,3792,3799,3787,3800,3750,3794,3778,-5,-21,6758,"38,305.88",21524
,20180213,3794,3778,3790,3821,3785,3814,3806,36,28,4070,"23,241.68",21338
,20180214,3814,3806,3818,3822,3789,3819,3810,13,4,2866,"16,382.24",21640
,20180222,3819,3810,3810,3810,3767,3779,3780,-31,-30,4054,"22,991.91",21610
,20180223,3779,3780,3781,3813,3781,3803,3800,23,20,7278,"41,494.67",23434
,20180226,3803,3800,3805,3843,3800,3836,3820,36,20,7494,"42,942.45",24882
,20180227,3836,3820,3833,3845,3817,3823,3828,3,8,8472,"48,647.81",27324
,20180228,3823,3828,3823,3823,3779,3788,3795,-40,-33,10578,"60,222.84",29258
,20180301,3788,3795,3794,3803,3776,3781,3783,-14,-12,12280,"69,688.45",35862
,20180302,3781,3783,3768,3804,3757,3792,3782,9,-1,35786,"203,014.52",53556
,20180305,3792,3782,3798,3817,3790,3807,3805,25,23,19886,"113,524.32",58112
,20180306,3807,3805,3800,3807,3787,3795,3794,-10,-11,17200,"97,907.70",62474
,20180307,3795,3794,3817,3846,3808,3820,3824,26,30,29066,"166,756.20",64572
,20180308,3820,3824,3819,3820,3793,3811,3805,-13,-19,27626,"157,710.22",69620
,20180309,3811,3805,3804,3815,3782,3794,3796,-11,-9,23382,"133,144.72",73910
,20180312,3794,3796,3793,3827,3774,3796,3799,0,3,34184,"194,813.36",79146
,20180313,3796,3799,3788,3801,3787,3790,3793,-9,-6,14656,"83,388.29",81802
,20180314,3790,3793,3805,3815,3787,3803,3801,10,8,25070,"142,941.70",83834
,20180315,3803,3801,3799,3802,3790,3794,3795,-7,-6,15206,"86,579.66",86208
,20180316,3794,3795,3787,3789,3766,3776,3779,-19,-16,30496,"172,871.46",91140
,20180319,3776,3779,3778,3781,3718,3739,3749,-40,-30,43588,"245,149.77",97638
,20180320,3739,3749,3744,3757,3739,3752,3748,3,-1,19674,"110,634.80",101042
,20180321,3752,3748,3744,3745,3718,3742,3734,-6,-14,30800,"172,512.03",107012
,20180322,3742,3734,3745,3810,3742,3789,3781,55,47,54730,"310,481.32",114748
,20180323,3789,3781,3791,3805,3773,3802,3792,21,11,55204,"314,008.64",122804
,20180326,3802,3792,3807,3818,3791,3795,3802,3,10,42500,"242,394.29",128620
,20180327,3795,3802,3802,3812,3792,3804,3802,2,0,53622,"305,832.52",135262
,20180328,3804,3802,3783,3789,3754,3762,3773,-40,-29,50338,"284,955.63",143976
,20180329,3762,3773,3752,3754,3700,3702,3723,-71,-50,94330,"526,791.55",158266
,20180330,3702,3723,3701,3724,3686,3717,3708,-6,-15,57620,"320,547.80",162956
,20180402,3717,3708,3716,3740,3715,3732,3731,24,23,29524,"165,242.74",165312
,20180403,3732,3731,3768,3768,3746,3751,3753,20,22,46074,"259,419.79",164106
,20180404,3751,3753,3750,3750,3719,3737,3732,-16,-21,39326,"220,184.72",166922
,20180409,3737,3732,3732,3742,3729,3734,3734,2,2,24452,"136,989.87",172916
,20180410,3734,3734,3743,3754,3734,3741,3741,7,7,42038,"235,914.18",180364
,20180411,3741,3741,3749,3758,3746,3754,3751,13,10,59282,"333,636.59",197370
,20180412,3754,3751,3764,3792,3756,3763,3770,12,19,123100,"696,227.57",216670
,20180413,3763,3770,3750,3752,3728,3736,3739,-34,-31,86406,"484,707.67",226602
,20180416,3736,3739,3747,3773,3743,3755,3758,16,19,71524,"403,197.55",226218
,20180417,3755,3758,3762,3773,3752,3768,3764,10,6,61526,"347,384.41",233538
,20180418,3768,3764,3753,3788,3746,3782,3772,18,8,89334,"505,478.00",245648
,20180419,3782,3772,3826,3867,3820,3867,3846,95,74,263164,"1,518,324.38",299598
,20180420,3867,3846,3873,3878,3849,3859,3861,13,15,178086,"1,031,407.49",313352
,20180423,3859,3861,3859,3865,3831,3841,3847,-20,-14,133872,"772,598.06",322538
,20180424,3841,3847,3791,3801,3774,3785,3787,-62,-60,207620,"1,179,455.51",334510
,20180425,3785,3787,3783,3798,3771,3778,3785,-9,-2,108910,"618,340.04",352476
,20180426,3778,3785,3765,3780,3761,3771,3771,-14,-14,115232,"651,939.36",379646
,20180427,3771,3771,3771,3774,3744,3763,3758,-8,-13,135294,"762,654.34",383158
,20180502,3763,3758,3724,3738,3711,3729,3727,-29,-31,119972,"670,880.17",413112
,20180503,3729,3727,3737,3762,3729,3743,3744,16,17,191800,"1,077,375.55",447916
,20180504,3743,3744,3758,3761,3743,3746,3751,2,7,114562,"644,614.16",464438
,20180507,3746,3751,3750,3768,3746,3754,3758,3,7,176300,"993,840.89",503454
,20180508,3754,3758,3755,3761,3751,3757,3756,-1,-2,131118,"738,777.32",521336
,20180509,3757,3756,3755,3770,3734,3749,3748,-7,-8,328788,"1,848,713.79",538950
,20180510,3749,3748,3760,3775,3757,3764,3764,16,16,306506,"1,730,722.01",569024
,20180511,3764,3764,3784,3789,3775,3782,3781,18,17,319836,"1,814,114.92",592252
,20180514,3782,3781,3792,3797,3774,3777,3785,-4,4,250800,"1,424,146.04",593596
,20180515,3777,3785,3767,3774,3735,3738,3752,-47,-33,284114,"1,599,171.31",616076
,20180516,3738,3752,3710,3718,3696,3716,3708,-36,-44,328888,"1,829,294.32",641196
,20180517,3716,3708,3705,3730,3701,3714,3718,6,10,224432,"1,251,904.34",647324
,20180518,3714,3718,3730,3737,3723,3729,3729,11,11,184272,"1,030,819.08",647222
,20180521,3729,3729,3724,3741,3705,3712,3722,-17,-7,288910,"1,613,215.01",681572
,20180522,3712,3722,3735,3739,3725,3730,3732,8,10,257206,"1,440,157.53",659820
,20180523,3730,3732,3753,3756,3734,3741,3743,9,11,247154,"1,387,772.67",658012
,20180524,3741,3743,3726,3741,3719,3736,3729,-7,-14,247706,"1,385,685.07",679406
,20180525,3736,3729,3752,3760,3746,3750,3752,21,23,336934,"1,896,498.76",676576
,20180528,3750,3752,3762,3762,3723,3728,3737,-24,-15,294560,"1,651,389.89",688958
,20180529,3728,3737,3727,3739,3723,3725,3731,-12,-6,160070,"895,917.47",705588
,20180530,3725,3731,3724,3733,3713,3725,3725,-6,-6,294994,"1,648,484.42",703044
,20180531,3725,3725,3735,3757,3730,3756,3745,31,20,360212,"2,023,564.25",732636
ag1901,20180116,4020,4020,,,,4020,4020,0,0,0,0.00,0
,20180117,4020,4020,,,,4020,4020,0,0,0,0.00,0
,20180118,4020,4020,3997,3997,3997,3997,3997,-23,-23,2,11.99,2
,20180119,3997,3997,,,,3997,3997,0,0,0,0.00,2
,20180122,3997,3997,,,,3997,3997,0,0,0,0.00,2
,20180123,3997,3997,,,,3997,3997,0,0,0,0.00,2
,20180124,3997,3997,,,,3997,3997,0,0,0,0.00,2
,20180125,3997,3997,4048,4086,4048,4086,4065,89,68,6,36.59,8
,20180126,4086,4065,4049,4049,4025,4032,4035,-33,-30,10,60.54,16
,20180129,4032,4035,4021,4021,4021,4021,4021,-14,-14,2,12.06,16
,20180130,4021,4021,4051,4051,3985,3985,4006,-36,-15,12,72.11,22
,20180131,3985,4006,3970,3990,3970,3990,3980,-16,-26,4,23.88,20
,20180201,3990,3980,,,,3980,3980,0,0,0,0.00,20
,20180202,3980,3980,,,,3980,3980,0,0,0,0.00,20
,20180205,3980,3980,3945,3945,3928,3928,3936,-52,-44,4,23.62,24
,20180206,3928,3936,3874,3874,3874,3874,3874,-62,-62,2,11.62,26
,20180207,3874,3874,3864,3874,3856,3856,3863,-18,-11,8,46.36,30
,20180208,3856,3863,3844,3844,3787,3787,3809,-76,-54,22,125.71,40
,20180209,3787,3809,3829,3829,3821,3821,3825,12,16,4,22.95,40
,20180212,3821,3825,3800,3835,3796,3825,3814,0,-11,16,91.55,50
,20180213,3825,3814,3830,3863,3805,3852,3833,38,19,66,379.53,64
,20180214,3852,3833,3843,3856,3843,3856,3853,23,20,10,57.80,64
,20180222,3856,3853,3798,3810,3782,3804,3801,-49,-52,24,136.87,80
,20180223,3804,3801,3815,3841,3815,3833,3834,32,33,30,172.56,94
,20180226,3833,3834,,,,3834,3834,0,0,0,0.00,94
,20180227,3834,3834,,,,3834,3834,0,0,0,0.00,94
,20180228,3834,3834,3820,3820,3819,3819,3819,-15,-15,14,80.21,94
,20180301,3819,3819,3828,3828,3809,3809,3820,-10,1,8,45.85,100
,20180302,3809,3820,3809,3828,3788,3820,3807,0,-13,12,68.53,102
,20180305,3820,3807,3827,3842,3803,3825,3829,18,22,24,137.86,96
,20180306,3825,3829,3818,3822,3798,3815,3817,-14,-12,28,160.31,98
,20180307,3815,3817,3835,3847,3835,3841,3839,24,22,8,46.07,98
,20180308,3841,3839,3836,3836,3832,3835,3834,-4,-5,6,34.51,96
,20180309,3835,3834,3825,3825,3819,3819,3821,-15,-13,6,34.39,96
,20180312,3819,3821,3810,3832,3800,3819,3818,-2,-3,18,103.11,98
,20180313,3819,3818,3818,3822,3818,3818,3820,0,2,12,68.76,106
,20180314,3818,3820,3830,3830,3830,3830,3830,10,10,4,22.98,102
,20180315,3830,3830,3814,3822,3814,3822,3816,-8,-14,8,45.79,102
,20180316,3822,3816,,,,3816,3816,0,0,0,0.00,102
,20180319,3816,3816,3770,3770,3770,3770,3770,-46,-46,2,11.31,102
,20180320,3770,3770,3769,3776,3768,3768,3770,-2,0,24,135.75,108
,20180321,3768,3770,3756,3766,3756,3760,3763,-10,-7,18,101.62,118
,20180322,3760,3763,3794,3820,3794,3820,3811,57,48,12,68.61,118
,20180323,3820,3811,3804,3830,3800,3820,3811,9,0,10,57.17,122
,20180326,3820,3811,3819,3824,3819,3824,3821,13,10,6,34.40,120
,20180327,3824,3821,3824,3833,3824,3833,3828,12,7,4,22.97,118
,20180328,3833,3828,,,,3828,3828,0,0,0,0.00,118
,20180329,3828,3828,3753,3754,3730,3730,3743,-98,-85,52,291.96,130
,20180330,3730,3743,3697,3737,3697,3737,3717,-6,-26,4,22.30,130
,20180402,3737,3717,3744,3764,3739,3753,3749,36,32,12,67.49,136
,20180403,3753,3749,3775,3775,3769,3769,3772,20,23,10,56.59,126
,20180404,3769,3772,3762,3762,3755,3755,3759,-17,-13,12,67.67,130
,20180409,3755,3759,3762,3762,3762,3762,3762,3,3,8,45.14,126
,20180410,3762,3762,3758,3784,3756,3756,3763,-6,1,10,56.45,130
,20180411,3756,3763,3776,3776,3766,3766,3770,3,7,6,33.93,132
,20180412,3766,3770,3805,3805,3787,3787,3793,17,23,6,34.14,138
,20180413,3787,3793,3768,3768,3760,3760,3766,-33,-27,50,282.45,178
,20180416,3760,3766,3775,3797,3773,3773,3777,7,11,62,351.26,134
,20180417,3773,3777,3794,3794,3794,3794,3794,17,17,2,11.38,134
,20180418,3794,3794,,,,3794,3794,0,0,0,0.00,134
,20180419,3794,3794,3882,3885,3859,3885,3872,91,78,40,232.32,122
,20180420,3885,3872,3874,3902,3867,3901,3885,29,13,22,128.23,122
,20180423,3901,3885,3897,3897,3835,3863,3873,-22,-12,12,69.73,126
,20180424,3863,3873,3821,3849,3801,3822,3812,-51,-61,62,354.53,178
,20180425,3822,3812,3813,3832,3799,3799,3821,-13,9,104,596.12,244
,20180426,3799,3821,3791,3806,3791,3791,3797,-30,-24,10,56.96,248
,20180427,3791,3797,3777,3790,3760,3776,3776,-21,-21,10,56.65,252
,20180502,3776,3776,3741,3757,3736,3747,3745,-29,-31,36,202.23,256
,20180503,3747,3745,3758,3758,3758,3758,3758,13,13,4,22.55,252
,20180504,3758,3758,3758,3782,3738,3770,3770,12,12,34,192.32,264
,20180507,3770,3770,3768,3800,3768,3798,3789,28,19,36,204.66,276
,20180508,3798,3789,3799,3799,3752,3780,3782,-9,-7,24,136.16,278
,20180509,3780,3782,3763,3771,3763,3763,3763,-19,-19,20,112.91,266
,20180510,3763,3763,3789,3797,3769,3780,3786,17,23,18,102.23,266
,20180511,3780,3786,3804,3807,3799,3799,3803,13,17,6,34.23,264
,20180514,3799,3803,3810,3810,3798,3800,3803,-3,0,10,57.05,262
,20180515,3800,3803,3784,3799,3756,3756,3776,-47,-27,36,203.92,254
,20180516,3756,3776,3691,3764,3691,3729,3728,-47,-48,28,156.59,256
,20180517,3729,3728,3732,3761,3720,3738,3738,10,10,52,291.60,252
,20180518,3738,3738,3800,3800,3748,3748,3782,10,44,76,431.22,242
,20180521,3748,3782,3752,3765,3733,3733,3752,-49,-30,48,270.17,272
,20180522,3733,3752,3758,3763,3758,3763,3759,11,7,6,33.84,268
,20180523,3763,3759,3766,3774,3760,3760,3766,1,7,14,79.10,260
,20180524,3760,3766,3744,3759,3742,3759,3749,-7,-17,14,78.75,256
,20180525,3759,3749,3786,3796,3774,3774,3779,25,30,22,124.72,254
,20180528,3774,3779,3777,3783,3742,3742,3763,-37,-16,10,56.46,258
,20180529,3742,3763,3755,3765,3755,3755,3757,-8,-6,28,157.83,278
,20180530,3755,3757,3766,3774,3755,3760,3761,3,4,12,67.71,284
,20180531,3760,3761,3776,3776,3776,3776,3776,15,15,2,11.33,284
ag1902,20180212,3825,3825,,,,3825,3825,0,0,0,0.00,0
,20180213,3825,3825,3847,3880,3775,3880,3842,55,17,18,103.74,10
,20180214,3880,3842,3793,3963,3793,3862,3879,20,37,16,93.10,18
,20180222,3862,3879,3862,3863,3828,3828,3841,-51,-38,14,80.67,20
,20180223,3828,3841,3842,3862,3827,3847,3854,6,13,36,208.13,48
,20180226,3847,3854,3878,3878,3878,3878,3878,24,24,2,11.63,46
,20180227,3878,3878,3873,3873,3869,3872,3871,-6,-7,12,69.68,50
,20180228,3872,3871,3824,3824,3824,3824,3824,-47,-47,2,11.47,52
,20180301,3824,3824,,,,3824,3824,0,0,0,0.00,52
,20180302,3824,3824,3799,3799,3799,3799,3799,-25,-25,4,22.79,56
,20180305,3799,3799,3851,3870,3851,3870,3860,71,61,4,23.16,60
,20180306,3870,3860,,,,3860,3860,0,0,0,0.00,60
,20180307,3860,3860,3866,3880,3866,3880,3874,20,14,8,46.49,56
,20180308,3880,3874,3862,3862,3848,3848,3853,-26,-21,6,34.68,60
,20180309,3848,3853,3830,3832,3828,3832,3830,-21,-23,6,34.47,64
,20180312,3832,3830,,,,3830,3830,0,0,0,0.00,64
,20180313,3830,3830,,,,3830,3830,0,0,0,0.00,64
,20180314,3830,3830,,,,3830,3830,0,0,0,0.00,64
,20180315,3830,3830,,,,3830,3830,0,0,0,0.00,64
,20180316,3830,3830,3815,3815,3815,3815,3815,-15,-15,2,11.45,66
,20180319,3815,3815,3811,3811,3778,3789,3793,-26,-22,22,125.19,74
,20180320,3789,3793,,,,3793,3793,0,0,0,0.00,74
,20180321,3793,3793,3780,3786,3763,3786,3775,-7,-18,8,45.31,78
,20180322,3786,3775,3812,3827,3812,3827,3821,52,46,6,34.39,78
,20180323,3827,3821,3820,3839,3820,3832,3829,11,8,48,275.73,92
,20180326,3832,3829,3839,3839,3811,3814,3824,-15,-5,30,172.09,102
,20180327,3814,3824,3831,3843,3819,3842,3831,18,7,42,241.39,108
,20180328,3842,3831,3822,3822,3808,3808,3815,-23,-16,4,22.89,106
,20180329,3808,3815,3768,3768,3753,3753,3764,-62,-51,10,56.47,98
,20180330,3753,3764,3732,3732,3732,3732,3732,-32,-32,2,11.20,96
,20180402,3732,3732,,,,3732,3732,0,0,0,0.00,96
,20180403,3732,3732,3783,3793,3783,3793,3787,61,55,8,45.45,100
,20180404,3793,3787,3781,3781,3775,3775,3777,-12,-10,14,79.32,92
,20180409,3775,3777,,,,3777,3777,0,0,0,0.00,92
,20180410,3777,3777,3782,3798,3782,3783,3787,6,10,8,45.45,94
,20180411,3783,3787,,,,3787,3787,0,0,0,0.00,94
,20180412,3787,3787,3806,3806,3806,3806,3806,19,19,2,11.42,94
,20180413,3806,3806,,,,3806,3806,0,0,0,0.00,94
,20180416,3806,3806,,,,3806,3806,0,0,0,0.00,94
,20180417,3806,3806,3806,3806,3806,3806,3806,0,0,2,11.42,94
,20180418,3806,3806,3820,3820,3820,3820,3820,14,14,2,11.46,96
,20180419,3820,3820,,,,3820,3820,0,0,0,0.00,96
,20180420,3820,3820,3893,3922,3891,3891,3901,71,81,10,58.53,98
,20180423,3891,3901,3864,3864,3864,3864,3864,-37,-37,4,23.18,98
,20180424,3864,3864,3883,3883,3824,3826,3832,-38,-32,16,91.99,108
,20180425,3826,3832,3822,3822,3822,3822,3822,-10,-10,2,11.47,108
,20180426,3822,3822,,,,3822,3822,0,0,0,0.00,108
,20180427,3822,3822,,,,3822,3822,0,0,0,0.00,108
,20180502,3822,3822,3761,3772,3726,3768,3754,-54,-68,14,78.85,110
,20180503,3768,3754,,,,3768,3768,14,14,0,0.00,110
,20180504,3768,3768,3792,3799,3792,3799,3797,31,29,10,56.96,102
,20180507,3799,3797,3795,3795,3795,3795,3795,-2,-2,2,11.39,102
,20180508,3795,3795,3798,3798,3794,3794,3796,-1,1,10,56.95,112
,20180509,3794,3796,3783,3783,3783,3783,3783,-13,-13,2,11.35,112
,20180510,3783,3783,,,,3783,3783,0,0,0,0.00,112
,20180511,3783,3783,,,,3800,3800,17,17,0,0.00,112
,20180514,3800,3800,3820,3820,3820,3820,3820,20,20,2,11.46,112
,20180515,3820,3820,3785,3785,3785,3785,3785,-35,-35,2,11.36,114
,20180516,3785,3785,3763,3763,3749,3749,3756,-36,-29,8,45.07,110
,20180517,3749,3756,3760,3769,3754,3765,3764,9,8,88,496.90,108
,20180518,3765,3764,,,,3764,3764,0,0,0,0.00,108
,20180521,3764,3764,,,,3764,3764,0,0,0,0.00,108
,20180522,3764,3764,,,,3764,3764,0,0,0,0.00,108
,20180523,3764,3764,3791,3791,3791,3791,3791,27,27,2,11.37,108
,20180524,3791,3791,3767,3791,3767,3791,3784,0,-7,8,45.41,112
,20180525,3791,3784,3798,3798,3798,3798,3798,14,14,2,11.39,110
,20180528,3798,3798,3798,3798,3798,3798,3798,0,0,4,22.79,106
,20180529,3798,3798,3783,3783,3780,3780,3781,-18,-17,6,34.03,112
,20180530,3780,3781,,,,3781,3781,0,0,0,0.00,112
,20180531,3781,3781,,,,3796,3796,15,15,0,0.00,112
ag1903,20180316,3830,3830,3838,3838,3838,3838,3838,8,8,2,11.51,2
,20180319,3838,3838,3800,3814,3800,3814,3807,-24,-31,4,22.84,6
,20180320,3814,3807,,,,3807,3807,0,0,0,0.00,6
,20180321,3807,3807,,,,3807,3807,0,0,0,0.00,6
,20180322,3807,3807,3833,3833,3833,3833,3833,26,26,2,11.50,4
,20180323,3833,3833,,,,3860,3860,27,27,0,0.00,4
,20180326,3860,3860,3856,3857,3854,3854,3856,-6,-4,24,138.82,28
,20180327,3854,3856,3856,3856,3856,3856,3856,0,0,2,11.57,30
,20180328,3856,3856,,,,3824,3824,-32,-32,0,0.00,30
,20180329,3824,3824,3771,3771,3768,3768,3769,-56,-55,6,33.92,30
,20180330,3768,3769,,,,3769,3769,0,0,0,0.00,30
,20180402,3769,3769,,,,3769,3769,0,0,0,0.00,30
,20180403,3769,3769,3825,3825,3825,3825,3825,56,56,6,34.43,36
,20180404,3825,3825,3813,3813,3798,3799,3801,-26,-24,36,205.29,62
,20180409,3799,3801,3819,3819,3819,3819,3819,18,18,2,11.46,64
,20180410,3819,3819,3804,3810,3800,3800,3803,-19,-16,12,68.47,68
,20180411,3800,3803,3807,3831,3804,3804,3811,1,8,24,137.21,64
,20180412,3804,3811,3807,3841,3804,3830,3826,19,15,88,505.03,76
,20180413,3830,3826,3808,3808,3808,3808,3808,-18,-18,18,102.82,76
,20180416,3808,3808,3820,3820,3820,3820,3820,12,12,20,114.60,76
,20180417,3820,3820,,,,3820,3820,0,0,0,0.00,76
,20180418,3820,3820,,,,3820,3820,0,0,0,0.00,76
,20180419,3820,3820,3918,3919,3889,3917,3906,97,86,78,457.07,86
,20180420,3917,3906,,,,3906,3906,0,0,0,0.00,86
,20180423,3906,3906,3926,3926,3859,3859,3881,-47,-25,6,34.93,90
,20180424,3859,3881,3859,3859,3859,3859,3859,-22,-22,2,11.58,90
,20180425,3859,3859,,,,3859,3859,0,0,0,0.00,90
,20180426,3859,3859,,,,3859,3859,0,0,0,0.00,90
,20180427,3859,3859,,,,3859,3859,0,0,0,0.00,90
,20180502,3859,3859,3797,3834,3794,3795,3801,-64,-58,14,79.84,96
,20180503,3795,3801,3798,3817,3798,3810,3808,9,7,10,57.13,92
,20180504,3810,3808,3819,3819,3819,3819,3819,11,11,2,11.46,90
,20180507,3819,3819,3815,3817,3809,3817,3813,-2,-6,16,91.52,92
,20180508,3817,3813,3822,3822,3820,3820,3821,7,8,4,22.93,92
,20180509,3820,3821,3818,3818,3818,3818,3818,-3,-3,2,11.45,90
,20180510,3818,3818,3814,3814,3789,3813,3805,-5,-13,6,34.25,90
,20180511,3813,3805,3834,3836,3834,3836,3835,31,30,8,46.03,90
,20180514,3836,3835,3852,3852,3837,3837,3842,2,7,16,92.22,96
,20180515,3837,3842,3803,3803,3784,3793,3795,-49,-47,20,113.87,88
,20180516,3793,3795,3755,3755,3755,3755,3755,-40,-40,2,11.27,88
,20180517,3755,3755,3773,3782,3773,3780,3777,25,22,18,102.00,86
,20180518,3780,3777,,,,3777,3777,0,0,0,0.00,86
,20180521,3777,3777,3777,3777,3777,3777,3777,0,0,2,11.33,86
,20180522,3777,3777,3805,3805,3795,3796,3799,19,22,26,148.17,110
,20180523,3796,3799,3812,3812,3811,3811,3811,12,12,4,22.87,114
,20180524,3811,3811,3784,3804,3784,3797,3795,-14,-16,8,45.54,114
,20180525,3797,3795,,,,3795,3795,0,0,0,0.00,114
,20180528,3795,3795,3820,3820,3820,3820,3820,25,25,4,22.92,110
,20180529,3820,3820,3799,3799,3799,3799,3799,-21,-21,8,45.59,116
,20180530,3799,3799,3796,3796,3795,3795,3795,-4,-4,4,22.77,120
,20180531,3795,3795,,,,3810,3810,15,15,0,0.00,120
ag1904,20180417,3820,3820,3821,3845,3821,3845,3833,25,13,4,23.00,0
,20180418,3845,3833,,,,3839,3839,6,6,0,0.00,0
,20180419,3839,3839,3914,3960,3895,3948,3942,109,103,232,"1,371.82",28
,20180420,3948,3942,3944,3955,3931,3937,3944,-5,2,30,177.51,46
,20180423,3937,3944,3923,3928,3923,3928,3925,-16,-19,4,23.55,48
,20180424,3928,3925,3863,3879,3861,3879,3877,-46,-48,488,"2,838.47",486
,20180425,3879,3877,,,,3870,3870,-7,-7,0,0.00,486
,20180426,3870,3870,3856,3856,3849,3849,3850,-21,-20,12,69.30,484
,20180427,3849,3850,3842,3864,3840,3845,3846,-5,-4,32,184.65,508
,20180502,3845,3846,3830,3833,3820,3833,3825,-13,-21,64,367.21,570
,20180503,3833,3825,3830,3840,3826,3826,3831,1,6,16,91.96,558
,20180504,3826,3831,3859,3859,3846,3847,3850,16,19,12,69.31,566
,20180507,3847,3850,3838,3861,3838,3850,3848,0,-2,30,173.17,570
,20180508,3850,3848,3846,3846,3846,3846,3846,-2,-2,4,23.08,570
,20180509,3846,3846,3839,3839,3828,3837,3833,-9,-13,20,115.01,580
,20180510,3837,3833,3843,3849,3843,3848,3847,15,14,12,69.26,572
,20180511,3848,3847,3877,3877,3860,3862,3866,15,19,22,127.59,582
,20180514,3862,3866,3880,3881,3854,3854,3872,-12,6,8,46.47,584
,20180515,3854,3872,3858,3858,3811,3811,3826,-61,-46,20,114.80,588
,20180516,3811,3826,3794,3794,3793,3793,3793,-33,-33,10,56.90,590
,20180517,3793,3793,3799,3819,3794,3806,3805,13,12,14,79.91,588
,20180518,3806,3805,3862,3862,3812,3812,3821,7,16,14,80.25,594
,20180521,3812,3821,3812,3819,3800,3814,3809,-7,-12,184,"1,051.38",762
,20180522,3814,3809,3831,3836,3823,3836,3829,27,20,34,195.29,762
,20180523,3836,3829,3841,3857,3840,3850,3846,21,17,20,115.40,768
,20180524,3850,3846,3820,3843,3819,3821,3826,-25,-20,174,998.65,856
,20180525,3821,3826,3848,3853,3840,3840,3847,14,21,18,103.88,858
,20180528,3840,3847,3843,3843,3815,3820,3822,-27,-25,36,206.42,852
,20180529,3820,3822,3833,3833,3833,3833,3833,11,11,2,11.50,850
,20180530,3833,3833,3820,3820,3820,3820,3820,-13,-13,4,22.92,850
,20180531,3820,3820,3836,3845,3836,3844,3839,24,19,24,138.22,846
ag1905,20180516,3826,3826,,,,3826,3826,0,0,0,0.00,0
,20180517,3826,3826,,,,3826,3826,0,0,0,0.00,0
,20180518,3826,3826,3843,3843,3843,3843,3843,17,17,2,11.53,2
,20180521,3843,3843,,,,3843,3843,0,0,0,0.00,2
,20180522,3843,3843,3860,3860,3860,3860,3860,17,17,2,11.58,4
,20180523,3860,3860,3866,3866,3866,3866,3866,6,6,2,11.60,6
,20180524,3866,3866,3796,3859,3796,3859,3831,-7,-35,24,137.93,28
,20180525,3859,3831,3886,3886,3886,3886,3886,55,55,2,11.66,30
,20180528,3886,3886,3864,3864,3831,3831,3845,-55,-41,6,34.61,28
,20180529,3831,3845,3862,3862,3862,3862,3862,17,17,2,11.59,28
,20180530,3862,3862,3860,3860,3860,3860,3860,-2,-2,2,11.58,30
,20180531,3860,3860,3841,3878,3841,3858,3858,-2,-2,14,81.02,28
al1801,20180102,15095,15020,15055,15240,14900,14985,15055,-35,35,20326,"153,016.26",90690
,20180103,14985,15055,14995,15045,14935,14960,14970,-95,-85,7790,"58,316.10",89110
,20180104,14960,14970,15000,15025,14810,14940,14915,-30,-55,11830,"88,224.73",84310
,20180105,14940,14915,14970,15010,14915,15010,14965,95,50,9710,"72,673.43",80710
,20180108,15010,14965,14930,15020,14735,14855,14880,-110,-85,11020,"82,014.80",76310
,20180109,14855,14880,14760,14940,14760,14880,14855,0,-25,11380,"84,536.43",72920
,20180110,14880,14855,14865,14910,14810,14880,14860,25,5,13060,"97,059.98",68220
,20180111,14880,14860,14920,15085,14920,15040,14995,180,135,8150,"61,112.23",63260
,20180112,15040,14995,15030,15070,14900,14920,14935,-75,-60,12970,"96,884.30",52870
,20180115,14920,14935,15010,15450,14940,15050,15020,115,85,9280,"69,708.00",48250
al1802,20180102,15225,15125,15255,15450,15010,15075,15165,-50,40,250552,"1,900,202.10",296254
,20180103,15075,15165,15060,15155,15030,15065,15085,-100,-80,190698,"1,438,360.32",283696
,20180104,15065,15085,15060,15145,14905,15050,15015,-35,-70,224166,"1,683,390.64",275750
,20180105,15050,15015,15060,15130,14990,15105,15060,90,45,196028,"1,476,469.54",261340
,20180108,15105,15060,15060,15125,14825,14935,14985,-125,-75,236334,"1,771,102.20",245526
,20180109,14935,14985,14935,15030,14895,14980,14950,-5,-35,163828,"1,225,000.92",231658
,20180110,14980,14950,14945,15005,14875,14970,14940,20,-10,125526,"937,692.26",221892
,20180111,14970,14940,14995,15165,14990,15120,15070,180,130,107242,"808,202.71",215174
,20180112,15120,15070,15125,15140,14930,15005,15020,-65,-50,81780,"614,292.44",202130
,20180115,15005,15020,15040,15175,15025,15040,15105,20,85,75122,"567,372.10",192692
,20180116,15040,15105,15060,15060,14550,14655,14790,-450,-315,112220,"830,061.64",168292
,20180117,14655,14790,14585,14635,14465,14545,14545,-245,-245,71320,"518,679.73",154210
,20180118,14545,14545,14530,14610,14420,14535,14540,-10,-5,48428,"352,096.72",144696
,20180119,14535,14540,14635,14740,14540,14670,14645,130,105,42166,"308,786.70",133986
,20180122,14670,14645,14670,14690,14525,14585,14580,-60,-65,34500,"251,520.81",124958
,20180123,14585,14580,14660,14675,14520,14570,14575,-10,-5,30868,"224,968.41",119092
,20180124,14570,14575,14495,14640,14435,14570,14555,-5,-20,32602,"237,267.16",111568
,20180125,14570,14555,14600,14770,14505,14700,14650,145,95,39656,"290,577.14",103792
,20180126,14700,14650,14685,14735,14530,14530,14610,-120,-40,32946,"240,714.13",96338
,20180129,14530,14610,14575,14675,14530,14580,14610,-30,0,29386,"214,701.11",83626
,20180130,14580,14610,14580,14630,14355,14405,14450,-205,-160,40424,"292,134.83",72644
,20180131,14405,14450,14415,14510,14335,14360,14390,-90,-60,32310,"232,480.26",60652
,20180201,14360,14390,14370,14410,14210,14245,14275,-145,-115,16512,"117,885.57",57750
,20180202,14245,14275,14300,14360,14240,14300,14310,25,35,8830,"63,193.05",54420
,20180205,14300,14310,14320,14390,14190,14220,14240,-90,-70,13850,"98,624.15",49890
,20180206,14220,14240,14210,14310,14050,14060,14165,-180,-75,17440,"123,533.65",43690
,20180207,14060,14165,14090,14185,14035,14125,14120,-40,-45,7090,"50,064.28",39900
,20180208,14125,14120,14180,14280,14105,14130,14180,10,60,13220,"93,751.05",32110
,20180209,14130,14180,14140,14190,14065,14160,14105,-20,-75,5470,"38,584.68",30490
al1803,20180102,15340,15235,15340,15470,15110,15175,15260,-60,25,162174,"1,237,517.28",320394
,20180103,15175,15260,15190,15255,15135,15165,15180,-95,-80,128422,"974,982.90",322438
,20180104,15165,15180,15175,15245,15015,15140,15125,-40,-55,178014,"1,346,344.37",328124
,20180105,15140,15125,15170,15230,15095,15210,15165,85,40,132854,"1,007,547.49",335404
,20180108,15210,15165,15150,15220,14925,15040,15080,-125,-85,201984,"1,523,046.46",326382
,20180109,15040,15080,15020,15130,15000,15075,15045,-5,-35,154802,"1,164,852.82",334426
,20180110,15075,15045,15040,15100,14970,15060,15030,15,-15,174670,"1,313,031.90",340496
,20180111,15060,15030,15100,15260,15085,15210,15165,180,135,236926,"1,796,809.05",360746
,20180112,15210,15165,15215,15235,15020,15090,15110,-75,-55,220870,"1,668,909.54",346842
,20180115,15090,15110,15125,15265,15110,15130,15190,20,80,240762,"1,829,146.86",352818
,20180116,15130,15190,15140,15145,14725,14745,14895,-445,-295,382636,"2,849,993.99",345144
,20180117,14745,14895,14695,14735,14560,14630,14635,-265,-260,252142,"1,845,393.69",339448
,20180118,14630,14635,14635,14700,14505,14620,14620,-15,-15,228818,"1,672,892.44",341062
,20180119,14620,14620,14685,14835,14625,14765,14730,145,110,268758,"1,979,793.60",339218
,20180122,14765,14730,14760,14785,14610,14660,14675,-70,-55,221918,"1,628,843.37",334574
,20180123,14660,14675,14705,14750,14595,14650,14665,-25,-10,217202,"1,592,810.81",333070
,20180124,14650,14665,14560,14725,14530,14640,14635,-25,-30,176038,"1,288,395.27",322908
,20180125,14640,14635,14660,14855,14585,14790,14735,155,100,280592,"2,067,282.81",314356
,20180126,14790,14735,14760,14820,14610,14625,14700,-110,-35,246972,"1,815,413.00",316304
,20180129,14625,14700,14655,14770,14610,14670,14690,-30,-10,218110,"1,602,044.94",303330
,20180130,14670,14690,14685,14730,14415,14470,14555,-220,-135,295754,"2,152,825.45",299862
,20180131,14470,14555,14500,14600,14410,14440,14490,-115,-65,272330,"1,973,649.81",270498
,20180201,14440,14490,14445,14500,14290,14335,14370,-155,-120,225536,"1,620,680.32",267360
,20180202,14335,14370,14340,14460,14310,14390,14395,20,25,182842,"1,316,446.74",260134
,20180205,14390,14395,14360,14475,14260,14320,14355,-75,-40,200166,"1,437,184.02",253212
,20180206,14320,14355,14340,14410,14135,14140,14270,-215,-85,262584,"1,874,013.33",244858
,20180207,14140,14270,14175,14275,14095,14205,14175,-65,-95,191958,"1,360,596.47",228374
,20180208,14205,14175,14210,14380,14180,14215,14250,40,75,263628,"1,878,872.14",216154
,20180209,14215,14250,14250,14290,14160,14185,14215,-65,-35,190656,"1,355,183.57",208548
,20180212,14185,14215,14150,14470,14010,14320,14175,105,-40,274744,"1,947,869.11",191618
,20180213,14320,14175,14295,14410,14230,14305,14300,130,125,127614,"912,545.85",176850
,20180214,14305,14300,14305,14365,14005,14020,14215,-280,-85,84124,"598,107.02",169330
,20180222,14020,14215,14350,14350,13955,14050,14075,-165,-140,43710,"307,681.46",161542
,20180223,14050,14075,14070,14310,14060,14300,14210,225,135,64530,"458,605.39",143410
,20180226,14300,14210,14255,14290,14110,14200,14200,-10,-10,51946,"368,834.22",128986
,20180227,14200,14200,14225,14230,14075,14200,14160,0,-40,41844,"296,302.59",115504
,20180228,14200,14160,14190,14255,14105,14250,14190,90,30,36448,"258,624.07",99614
,20180301,14250,14190,14250,14320,14220,14295,14265,105,75,16284,"116,172.53",91570
,20180302,14295,14265,14270,14375,14175,14250,14300,-15,35,16190,"115,771.18",85780
,20180305,14250,14300,14250,14280,14100,14130,14150,-170,-150,11440,"80,962.43",83440
,20180306,14130,14150,14120,14330,14120,14255,14225,105,75,17250,"122,693.70",76740
,20180307,14255,14225,14275,14280,14070,14100,14185,-125,-40,12160,"86,259.98",73590
,20180308,14100,14185,14090,14125,13970,14065,14035,-120,-150,11780,"82,677.98",68770
,20180309,14065,14035,14035,14120,13850,13910,14035,-125,0,16770,"117,713.38",65470
,20180312,13910,14035,13920,14085,13875,13900,13940,-135,-95,19620,"136,762.20",54420
,20180313,13900,13940,13910,13910,13655,13670,13745,-270,-195,8650,"59,452.15",49960
,20180314,13670,13745,13715,13800,13715,13790,13765,45,20,10590,"72,899.45",42990
,20180315,13790,13765,13845,13850,13720,13820,13795,55,30,6640,"45,799.43",40670
al1804,20180102,15425,15335,15400,15565,15205,15280,15375,-55,40,53446,"410,894.98",123300
,20180103,15280,15375,15300,15350,15230,15255,15275,-120,-100,37926,"289,749.26",126606
,20180104,15255,15275,15265,15340,15110,15235,15215,-40,-60,43822,"333,451.42",127894
,20180105,15235,15215,15265,15345,15195,15305,15260,90,45,40662,"310,344.33",130600
,20180108,15305,15260,15250,15315,15025,15135,15175,-125,-85,60674,"460,427.47",126166
,20180109,15135,15175,15130,15220,15095,15160,15145,-15,-30,38250,"289,653.28",127400
,20180110,15160,15145,15135,15190,15060,15140,15120,-5,-25,36552,"276,375.26",128648
,20180111,15140,15120,15170,15340,15165,15285,15250,165,130,52434,"399,828.22",134606
,20180112,15285,15250,15285,15315,15105,15170,15200,-80,-50,39336,"298,987.84",135188
,20180115,15170,15200,15205,15340,15185,15220,15275,20,75,46680,"356,594.18",137918
,20180116,15220,15275,15220,15225,14815,14840,14975,-435,-300,87850,"657,889.53",146570
,20180117,14840,14975,14800,14825,14655,14725,14725,-250,-250,65212,"480,235.48",152922
,20180118,14725,14725,14735,14795,14600,14715,14715,-10,-10,63796,"469,448.95",159370
,20180119,14715,14715,14770,14920,14720,14855,14815,140,100,85518,"633,687.52",165758
,20180122,14855,14815,14845,14880,14705,14755,14770,-60,-45,79546,"587,636.56",173920
,20180123,14755,14770,14800,14835,14685,14745,14750,-25,-20,86170,"635,587.15",170658
,20180124,14745,14750,14665,14805,14615,14730,14725,-20,-25,71462,"526,281.97",170734
,20180125,14730,14725,14735,14940,14675,14870,14815,145,90,109530,"811,535.71",186540
,20180126,14870,14815,14845,14910,14705,14710,14785,-105,-30,99484,"735,528.13",195604
,20180129,14710,14785,14730,14850,14705,14765,14780,-20,-5,86188,"637,056.09",211250
,20180130,14765,14780,14800,14815,14520,14555,14640,-225,-140,113280,"829,279.65",226348
,20180131,14555,14640,14580,14680,14500,14530,14570,-110,-70,121488,"885,279.89",236688
,20180201,14530,14570,14525,14580,14380,14425,14455,-145,-115,112712,"814,797.10",250542
,20180202,14425,14455,14435,14550,14400,14475,14490,20,35,108734,"787,876.04",253726
,20180205,14475,14490,14465,14555,14355,14405,14445,-85,-45,125632,"907,441.23",260244
,20180206,14405,14445,14405,14485,14215,14225,14345,-220,-100,155800,"1,117,514.89",280866
,20180207,14225,14345,14230,14365,14180,14290,14255,-55,-90,166420,"1,186,403.50",286186
,20180208,14290,14255,14295,14465,14260,14290,14335,35,80,213760,"1,532,657.88",292620
,20180209,14290,14335,14335,14370,14240,14270,14290,-65,-45,117460,"839,477.20",298118
,20180212,14270,14290,14215,14565,14105,14405,14285,115,-5,272912,"1,949,915.63",299842
,20180213,14405,14285,14365,14495,14315,14380,14385,95,100,155522,"1,118,866.90",291270
,20180214,14380,14385,14370,14440,14075,14105,14270,-280,-115,227750,"1,625,452.53",286808
,20180222,14105,14270,14275,14280,14030,14125,14150,-145,-120,131508,"930,448.10",298964
,20180223,14125,14150,14140,14390,14130,14365,14280,215,130,253138,"1,807,865.54",292158
,20180226,14365,14280,14305,14375,14195,14295,14290,15,10,311842,"2,228,860.61",277328
,20180227,14295,14290,14315,14320,14160,14285,14245,-5,-45,268224,"1,910,701.83",280028
,20180228,14285,14245,14285,14350,14190,14325,14275,80,30,267174,"1,907,334.27",270558
,20180301,14325,14275,14290,14425,14280,14390,14355,115,80,203116,"1,457,927.44",258756
,20180302,14390,14355,14375,14480,14250,14340,14390,-15,35,230946,"1,661,782.85",243220
,20180305,14340,14390,14350,14375,14185,14210,14270,-180,-120,177386,"1,265,701.36",231332
,20180306,14210,14270,14225,14430,14200,14350,14290,80,20,168110,"1,201,368.17",210778
,20180307,14350,14290,14355,14380,14130,14180,14275,-110,-15,112154,"800,579.16",200106
,20180308,14180,14275,14160,14220,14050,14150,14135,-125,-140,90898,"642,582.49",191628
,20180309,14150,14135,14170,14210,13935,13995,14125,-140,-10,92194,"651,237.06",184550
,20180312,13995,14125,14020,14190,13955,13980,14035,-145,-90,79920,"560,878.37",180928
,20180313,13980,14035,14005,14025,13740,13770,13850,-265,-185,78742,"545,415.88",177400
,20180314,13770,13850,13815,13900,13785,13870,13850,20,0,52130,"361,083.03",172102
,20180315,13870,13850,13880,13960,13785,13900,13885,50,35,51706,"359,040.97",165480
,20180316,13900,13885,13875,13950,13835,13910,13870,25,-15,29554,"205,019.76",160142
,20180319,13910,13870,13935,14040,13825,13870,13900,0,30,31716,"220,485.17",156636
,20180320,13870,13900,13870,13965,13850,13915,13905,15,5,32808,"228,109.20",147998
,20180321,13915,13905,13930,13930,13780,13845,13825,-60,-80,41584,"287,536.28",142140
,20180322,13845,13825,13850,13925,13770,13890,13855,65,30,30820,"213,526.61",134296
,20180323,13890,13855,13860,13875,13560,13680,13690,-175,-165,48218,"330,065.48",126376
,20180326,13680,13690,13690,13705,13580,13625,13630,-65,-60,36592,"249,390.05",115588
,20180327,13625,13630,13635,13805,13585,13730,13725,100,95,31524,"216,365.76",109026
,20180328,13730,13725,13720,13785,13655,13665,13715,-60,-10,25114,"172,230.52",103630
,20180329,13665,13715,13660,13890,13635,13815,13765,100,50,121986,"839,657.32",96312
,20180330,13815,13765,13720,13820,13620,13730,13705,-35,-60,38584,"264,449.84",83010
,20180402,13730,13705,13795,13970,13695,13950,13845,245,140,21210,"146,862.53",76600
,20180403,13950,13845,14035,14105,13945,14065,14040,220,195,18450,"129,534.03",72090
,20180404,14065,14040,14095,14095,13930,13995,13990,-45,-50,13180,"92,194.60",70000
,20180409,13995,13990,14145,14265,14100,14190,14140,200,150,22620,"159,936.50",69760
,20180410,14190,14140,14240,14345,14230,14265,14280,125,140,19680,"140,547.83",63750
,20180411,14265,14280,14330,14395,14255,14310,14310,30,30,27990,"200,305.05",66720
,20180412,14310,14310,14310,14340,14200,14275,14245,-35,-65,7890,"56,196.65",62170
,20180413,14275,14245,14255,14545,14230,14525,14480,280,235,9960,"72,111.83",59670
,20180416,14525,14480,14540,14575,14450,14550,14515,70,35,10430,"75,720.73",54690
al1805,20180102,15570,15425,15520,15660,15280,15370,15445,-55,20,23296,"179,934.11",64630
,20180103,15370,15445,15395,15450,15320,15345,15375,-100,-70,22692,"174,499.31",66880
,20180104,15345,15375,15345,15430,15205,15325,15315,-50,-60,27494,"210,594.49",69084
,20180105,15325,15315,15350,15415,15290,15395,15350,80,35,21044,"161,559.85",71228
,20180108,15395,15350,15330,15400,15110,15220,15265,-130,-85,29850,"227,835.95",71862
,20180109,15220,15265,15230,15305,15180,15255,15230,-10,-35,23106,"176,002.56",74274
,20180110,15255,15230,15220,15275,15140,15220,15205,-10,-25,28722,"218,386.84",77668
,20180111,15220,15205,15250,15425,15235,15360,15325,155,120,24070,"184,478.46",76926
,20180112,15360,15325,15350,15390,15185,15260,15275,-65,-50,25430,"194,255.92",77588
,20180115,15260,15275,15345,15415,15285,15315,15360,40,85,32882,"252,549.98",78242
,20180116,15315,15360,15300,15310,14915,14935,15065,-425,-295,52656,"396,745.73",83762
,20180117,14935,15065,14875,14920,14750,14795,14820,-270,-245,36152,"267,948.93",89284
,20180118,14795,14820,14820,14885,14695,14790,14800,-30,-20,34662,"256,566.43",94584
,20180119,14790,14800,14880,15010,14805,14950,14900,150,100,46330,"345,247.60",99878
,20180122,14950,14900,14950,14965,14800,14840,14855,-60,-45,39128,"290,647.36",107400
,20180123,14840,14855,14880,14920,14780,14830,14840,-25,-15,30084,"223,282.98",110010
,20180124,14830,14840,14775,14890,14715,14815,14810,-25,-30,37398,"276,936.88",119144
,20180125,14815,14810,14815,15035,14760,14960,14920,150,110,48084,"358,744.32",126956
,20180126,14960,14920,14920,14995,14795,14810,14880,-110,-40,48710,"362,469.93",131496
,20180129,14810,14880,14830,14940,14795,14860,14865,-20,-15,39814,"295,997.72",142384
,20180130,14860,14865,14860,14905,14615,14645,14730,-220,-135,59902,"441,327.24",154640
,20180131,14645,14730,14685,14760,14585,14620,14655,-110,-75,64826,"475,169.90",159198
,20180201,14620,14655,14620,14665,14470,14520,14545,-135,-110,51394,"373,764.72",167434
,20180202,14520,14545,14520,14630,14495,14565,14575,20,30,50474,"367,944.18",171872
,20180205,14565,14575,14560,14640,14435,14495,14525,-80,-50,57788,"419,782.22",176574
,20180206,14495,14525,14495,14570,14310,14320,14425,-205,-100,68944,"497,349.64",180642
,20180207,14320,14425,14325,14455,14270,14380,14355,-45,-70,79242,"568,803.05",189616
,20180208,14380,14355,14355,14545,14310,14380,14420,25,65,76942,"554,775.03",192400
,20180209,14380,14420,14390,14450,14330,14360,14375,-60,-45,42748,"307,256.45",192370
,20180212,14360,14375,14290,14655,14195,14495,14370,120,-5,165286,"1,187,935.28",209858
,20180213,14495,14370,14425,14580,14405,14470,14475,100,105,68302,"494,393.67",214776
,20180214,14470,14475,14435,14525,14180,14205,14345,-270,-130,97990,"702,876.71",217424
,20180222,14205,14345,14395,14395,14125,14215,14235,-130,-110,66554,"473,698.17",231604
,20180223,14215,14235,14230,14470,14220,14455,14375,220,140,117548,"845,012.33",247068
,20180226,14455,14375,14375,14460,14280,14380,14365,5,-10,149100,"1,071,024.12",257772
,20180227,14380,14365,14385,14400,14240,14370,14325,5,-40,140088,"1,003,716.49",272592
,20180228,14370,14325,14370,14440,14280,14415,14365,90,40,151564,"1,088,745.63",289812
,20180301,14415,14365,14365,14500,14365,14460,14440,95,75,147718,"1,066,652.09",302728
,20180302,14460,14440,14450,14560,14355,14425,14470,-15,30,203456,"1,472,303.25",313556
,20180305,14425,14470,14450,14465,14270,14295,14350,-175,-120,198008,"1,421,180.69",322718
,20180306,14295,14350,14300,14515,14290,14440,14385,90,35,289496,"2,082,352.69",330344
,20180307,14440,14385,14430,14470,14220,14260,14350,-125,-35,273082,"1,959,920.20",344758
,20180308,14260,14350,14250,14305,14130,14230,14220,-120,-130,272192,"1,935,601.01",350552
,20180309,14230,14220,14245,14300,14020,14075,14205,-145,-15,300048,"2,131,162.01",352570
,20180312,14075,14205,14115,14275,14035,14065,14125,-140,-80,319510,"2,256,877.06",373102
,20180313,14065,14125,14075,14110,13820,13860,13940,-265,-185,406170,"2,831,090.09",405582
,20180314,13860,13940,13910,13985,13860,13960,13925,20,-15,259884,"1,809,904.31",377468
,20180315,13960,13925,13985,14040,13870,13995,13975,70,50,231630,"1,618,678.30",361556
,20180316,13995,13975,13970,14050,13915,13995,13960,20,-15,202046,"1,410,551.01",351672
,20180319,13995,13960,14000,14130,13910,13960,14000,0,40,223990,"1,568,164.31",349560
,20180320,13960,14000,13995,14050,13930,13990,13995,-10,-5,207628,"1,453,158.46",347634
,20180321,13990,13995,14030,14030,13855,13935,13920,-60,-75,244258,"1,700,365.36",352532
,20180322,13935,13920,13935,14010,13850,13970,13930,50,10,225712,"1,572,401.18",339604
,20180323,13970,13930,13940,13965,13640,13765,13790,-165,-140,386966,"2,668,672.86",329000
,20180326,13765,13790,13785,13790,13660,13715,13725,-75,-65,209934,"1,440,868.69",321348
,20180327,13715,13725,13720,13890,13665,13825,13800,100,75,239416,"1,652,493.09",305916
,20180328,13825,13800,13800,13865,13730,13740,13790,-60,-10,173258,"1,195,018.18",305304
,20180329,13740,13790,13730,13925,13675,13820,13795,30,5,388314,"2,679,187.07",322712
,20180330,13820,13795,13785,13830,13630,13770,13730,-25,-65,289794,"1,990,123.27",315660
,20180402,13770,13730,13765,13995,13705,13990,13860,260,130,311646,"2,160,102.79",292588
,20180403,13990,13860,13980,14125,13960,14080,14050,220,190,221062,"1,553,106.29",275974
,20180404,14080,14050,14115,14125,13935,14010,14005,-40,-45,213588,"1,495,951.17",260994
,20180409,14010,14005,14290,14310,14085,14200,14140,195,135,188792,"1,335,128.78",252668
,20180410,14200,14140,14265,14345,14210,14255,14265,115,125,197150,"1,406,554.59",240458
,20180411,14255,14265,14310,14395,14225,14285,14300,20,35,145106,"1,037,839.31",219430
,20180412,14285,14300,14295,14330,14170,14245,14235,-55,-65,91926,"654,496.41",206504
,20180413,14245,14235,14215,14540,14180,14495,14425,260,190,138104,"996,140.01",191360
,20180416,14495,14425,14545,14580,14410,14545,14495,120,70,88238,"639,571.30",182582
,20180417,14545,14495,14650,14900,14650,14845,14770,350,275,107030,"790,491.54",169754
,20180418,14845,14770,14740,14880,14735,14850,14795,80,25,47996,"355,114.98",166056
,20180419,14850,14795,15090,15470,15030,15285,15190,490,395,87598,"665,493.37",165036
,20180420,15285,15190,15220,15220,14785,14870,14950,-320,-240,64560,"482,730.26",154292
,20180423,14870,14950,14910,14975,14745,14970,14880,20,-70,35914,"267,270.79",150360
,20180424,14970,14880,14345,14475,14135,14315,14360,-565,-520,52042,"373,667.45",142418
,20180425,14315,14360,14315,14435,14290,14330,14360,-30,0,26398,"189,549.35",138368
,20180426,14330,14360,14415,14415,14270,14280,14315,-80,-45,31526,"225,673.88",131370
,20180427,14280,14315,14320,14475,14250,14400,14380,85,65,29688,"213,530.37",121116
,20180502,14400,14380,14350,14415,14305,14350,14350,-30,-30,8946,"64,191.70",118900
,20180503,14350,14350,14425,14500,14415,14490,14460,140,110,13420,"97,028.95",113820
,20180504,14490,14460,14500,14580,14465,14515,14510,55,50,21950,"159,279.10",109540
,20180507,14515,14510,14540,14620,14535,14600,14580,90,70,23260,"169,606.80",107460
,20180508,14600,14580,14590,14660,14565,14615,14625,35,45,21570,"157,735.30",99690
,20180509,14615,14625,14615,14620,14455,14530,14545,-95,-80,17120,"124,527.83",94780
,20180510,14530,14545,14530,14550,14495,14520,14515,-25,-30,17560,"127,481.13",90160
,20180511,14520,14515,14535,14615,14535,14555,14580,40,65,10470,"76,329.35",82920
,20180514,14555,14580,14570,14585,14505,14515,14525,-65,-55,10790,"78,384.00",74360
,20180515,14515,14525,14515,14610,14515,14595,14570,70,45,10620,"77,380.10",71740
al1806,20180102,15585,15510,15635,15735,15380,15460,15530,-50,20,1600,"12,426.74",14956
,20180103,15460,15530,15480,15525,15415,15415,15460,-115,-70,816,"6,309.69",14880
,20180104,15415,15460,15425,15505,15300,15420,15395,-40,-65,836,"6,436.36",14864
,20180105,15420,15395,15420,15495,15375,15480,15435,85,40,508,"3,921.10",14866
,20180108,15480,15435,15395,15480,15210,15300,15325,-135,-110,850,"6,513.61",14740
,20180109,15300,15325,15300,15380,15280,15335,15320,10,-5,590,"4,519.58",14788
,20180110,15335,15320,15305,15360,15225,15305,15305,-15,-15,1948,"14,911.26",14966
,20180111,15305,15305,15360,15500,15300,15445,15395,140,90,1322,"10,178.98",15140
,20180112,15445,15395,15430,15475,15280,15345,15360,-50,-35,1328,"10,201.12",15516
,20180115,15345,15360,15395,15505,15375,15420,15445,60,85,1520,"11,741.11",15940
,20180116,15420,15445,15375,15400,15010,15015,15150,-430,-295,7612,"57,678.27",18664
,20180117,15015,15150,14995,15005,14840,14920,14905,-230,-245,8398,"62,602.76",21494
,20180118,14920,14905,14925,14975,14795,14880,14900,-25,-5,4852,"36,157.71",23010
,20180119,14880,14900,14965,15100,14895,15035,15000,135,100,8540,"64,064.21",25890
,20180122,15035,15000,15045,15045,14900,14940,14930,-60,-70,4232,"31,592.24",27288
,20180123,14940,14930,14985,14990,14865,14915,14925,-15,-5,3490,"26,044.76",27636
,20180124,14915,14925,14855,14980,14805,14910,14890,-15,-35,2062,"15,352.80",28100
,20180125,14910,14890,14920,15110,14855,15045,15015,155,125,2306,"17,316.00",28832
,20180126,15045,15015,15015,15075,14880,14885,14970,-130,-45,7096,"53,128.28",29882
,20180129,14885,14970,14915,15020,14875,14930,14935,-40,-35,7128,"53,239.56",32578
,20180130,14930,14935,14925,14980,14700,14750,14795,-185,-140,14448,"106,888.69",38090
,20180131,14750,14795,14770,14860,14660,14690,14725,-105,-70,24126,"177,678.17",47344
,20180201,14690,14725,14680,14735,14550,14595,14620,-130,-105,13440,"98,272.46",49912
,20180202,14595,14620,14635,14705,14585,14640,14660,20,40,16590,"121,645.95",56900
,20180205,14640,14660,14620,14715,14515,14575,14595,-85,-65,9636,"70,334.02",57040
,20180206,14575,14595,14575,14645,14400,14405,14480,-190,-115,15672,"113,500.10",58508
,20180207,14405,14480,14425,14535,14360,14480,14435,0,-45,17248,"124,512.15",60112
,20180208,14480,14435,14440,14630,14385,14445,14475,10,40,36350,"263,147.93",71328
,20180209,14445,14475,14445,14510,14400,14435,14445,-40,-30,14264,"103,034.85",71620
,20180212,14435,14445,14420,14750,14280,14590,14485,145,40,66262,"480,034.24",68092
,20180213,14590,14485,14560,14665,14495,14555,14560,70,75,18478,"134,541.54",68666
,20180214,14555,14560,14545,14605,14265,14305,14445,-255,-115,25060,"181,047.20",72538
,20180222,14305,14445,14505,14505,14215,14310,14320,-135,-125,25988,"186,118.37",81856
,20180223,14310,14320,14330,14555,14310,14540,14455,220,135,29558,"213,648.19",84738
,20180226,14540,14455,14485,14540,14365,14465,14445,10,-10,46540,"336,237.24",89988
,20180227,14465,14445,14490,14490,14335,14460,14420,15,-25,43954,"316,999.05",98788
,20180228,14460,14420,14460,14525,14370,14505,14455,85,35,34770,"251,362.66",106010
,20180301,14505,14455,14490,14590,14440,14570,14530,115,75,28544,"207,415.06",108610
,20180302,14570,14530,14560,14650,14440,14505,14550,-25,20,44216,"321,781.24",112554
,20180305,14505,14550,14520,14550,14365,14390,14435,-160,-115,50308,"363,200.44",120686
,20180306,14390,14435,14405,14600,14380,14520,14475,85,40,58092,"420,579.75",126572
,20180307,14520,14475,14570,14570,14315,14350,14440,-125,-35,70158,"506,554.11",136256
,20180308,14350,14440,14340,14395,14225,14315,14305,-125,-135,62904,"450,056.47",144538
,20180309,14315,14305,14315,14390,14110,14170,14285,-135,-20,73028,"521,663.48",150168
,20180312,14170,14285,14185,14360,14130,14155,14210,-130,-75,74158,"527,075.20",159814
,20180313,14155,14210,14155,14200,13915,13945,14025,-265,-185,101770,"713,705.49",177338
,20180314,13945,14025,13970,14070,13950,14050,14020,25,-5,78824,"552,557.85",172300
,20180315,14050,14020,14080,14125,13965,14080,14060,60,40,59772,"420,249.61",171818
,20180316,14080,14060,14060,14125,14010,14090,14050,30,-10,61582,"432,667.64",171926
,20180319,14090,14050,14070,14215,14000,14050,14085,0,35,81560,"574,419.14",179446
,20180320,14050,14085,14085,14140,14020,14090,14085,5,0,87692,"617,598.18",185226
,20180321,14090,14085,14090,14110,13945,14010,14005,-75,-80,80938,"566,940.92",192976
,20180322,14010,14005,14020,14095,13945,14060,14020,55,15,82202,"576,332.66",200026
,20180323,14060,14020,14020,14050,13735,13845,13865,-175,-155,159260,"1,104,456.87",209648
,20180326,13845,13865,13880,13880,13740,13790,13805,-75,-60,69416,"479,267.84",211600
,20180327,13790,13805,13795,13970,13750,13900,13885,95,80,94360,"655,171.39",210948
,20180328,13900,13885,13885,13945,13810,13815,13865,-70,-20,64798,"449,350.35",216118
,20180329,13815,13865,13820,13970,13750,13880,13860,15,-5,146002,"1,012,137.50",223336
,20180330,13880,13860,13860,13880,13715,13845,13805,-15,-55,121936,"841,723.59",235770
,20180402,13845,13805,13855,14065,13780,14055,13935,250,130,172928,"1,205,271.35",255338
,20180403,14055,13935,14065,14190,14030,14140,14120,205,185,141562,"999,521.55",259446
,20180404,14140,14120,14165,14205,13995,14060,14065,-60,-55,156138,"1,098,403.20",268980
,20180409,14060,14065,14295,14375,14140,14270,14205,205,140,183096,"1,300,584.95",274084
,20180410,14270,14205,14320,14425,14285,14350,14340,145,135,238282,"1,709,025.73",293540
,20180411,14350,14340,14410,14475,14300,14375,14385,35,45,311348,"2,239,561.98",306450
,20180412,14375,14385,14405,14410,14240,14325,14315,-60,-70,305376,"2,186,034.34",319446
,20180413,14325,14315,14325,14630,14260,14580,14495,265,180,537110,"3,893,649.95",337846
,20180416,14580,14495,14650,14670,14490,14625,14570,130,75,341368,"2,487,329.53",330740
,20180417,14625,14570,14750,14985,14730,14920,14860,350,290,473996,"3,522,142.03",346770
,20180418,14920,14860,14830,14965,14810,14930,14880,70,20,293138,"2,181,142.62",338666
,20180419,14930,14880,15210,15565,15145,15380,15285,500,405,550294,"4,205,815.79",344210
,20180420,15380,15285,15280,15285,14870,14955,15030,-330,-255,547780,"4,117,844.76",312812
,20180423,14955,15030,14960,15055,14825,15035,14935,5,-95,324100,"2,420,953.21",301518
,20180424,15035,14935,14335,14545,14220,14385,14420,-550,-515,567878,"4,094,831.83",255998
,20180425,14385,14420,14365,14515,14360,14405,14435,-15,15,255676,"1,845,748.18",241264
,20180426,14405,14435,14475,14485,14340,14365,14410,-70,-25,224846,"1,620,136.15",238258
,20180427,14365,14410,14355,14555,14305,14480,14475,70,65,298518,"2,160,525.42",227288
,20180502,14480,14475,14455,14515,14375,14430,14435,-45,-40,96212,"694,410.14",220712
,20180503,14430,14435,14540,14585,14475,14565,14530,130,95,145564,"1,057,572.56",217708
,20180504,14565,14530,14545,14660,14480,14575,14565,45,35,222356,"1,619,843.51",206702
,20180507,14575,14565,14600,14700,14585,14660,14630,95,65,156356,"1,144,045.02",206084
,20180508,14660,14630,14640,14720,14615,14690,14675,60,45,95508,"700,865.88",206962
,20180509,14690,14675,14660,14690,14505,14565,14585,-110,-90,108888,"794,319.13",196274
,20180510,14565,14585,14505,14610,14500,14560,14570,-25,-15,68884,"501,865.07",190864
,20180511,14560,14570,14590,14685,14550,14610,14625,40,55,75526,"552,364.20",184732
,20180514,14610,14625,14645,14650,14560,14575,14590,-50,-35,52360,"382,063.01",181714
,20180515,14575,14590,14585,14685,14575,14650,14635,60,45,46994,"343,960.60",178906
,20180516,14650,14635,14630,14755,14575,14725,14680,90,45,47704,"350,169.37",173058
,20180517,14725,14680,14695,14845,14685,14815,14795,135,115,47558,"351,858.08",170710
,20180518,14815,14795,14755,14820,14700,14755,14750,-40,-45,38308,"282,534.87",166084
,20180521,14755,14750,14720,14780,14680,14690,14715,-60,-35,27994,"206,011.07",161766
,20180522,14690,14715,14720,14730,14535,14540,14640,-175,-75,25468,"186,478.54",157860
,20180523,14540,14640,14525,14620,14525,14535,14560,-105,-80,23034,"167,740.11",151848
,20180524,14535,14560,14520,14720,14430,14675,14615,115,55,30228,"220,932.08",144324
,20180525,14675,14615,14675,14800,14660,14755,14725,140,110,31694,"233,348.25",132822
,20180528,14755,14725,14755,14775,14670,14735,14730,10,5,19788,"145,758.03",126968
,20180529,14735,14730,14700,14750,14660,14675,14695,-55,-35,34832,"256,012.15",112634
,20180530,14675,14695,14730,14730,14595,14625,14635,-70,-60,22322,"163,394.56",108758
,20180531,14625,14635,14675,14675,14525,14525,14600,-110,-35,26232,"191,523.81",100420
al1807,20180102,15675,15650,15740,15820,15490,15550,15645,-100,-5,820,"6,415.11",1610
,20180103,15550,15645,15540,15615,15505,15505,15540,-140,-105,172,"1,336.77",1598
,20180104,15505,15540,15505,15565,15405,15515,15485,-25,-55,322,"2,493.83",1612
,20180105,15515,15485,15550,15570,15500,15570,15535,85,50,44,341.82,1612
,20180108,15570,15535,15475,15560,15285,15390,15410,-145,-125,300,"2,311.89",1676
,20180109,15390,15410,15380,15465,15370,15465,15385,55,-25,200,"1,538.84",1680
,20180110,15465,15385,15375,15420,15325,15380,15370,-5,-15,144,"1,106.94",1716
,20180111,15380,15370,15455,15555,15365,15515,15460,145,90,216,"1,669.98",1728
,20180112,15515,15460,15495,15530,15345,15420,15435,-40,-25,234,"1,806.31",1702
,20180115,15420,15435,15475,15570,15475,15500,15525,65,90,276,"2,142.67",1828
,20180116,15500,15525,15470,15470,15110,15110,15300,-415,-225,904,"6,917.28",2402
,20180117,15110,15300,15070,15085,14950,14995,15005,-305,-295,1240,"9,304.39",2894
,20180118,14995,15005,15000,15045,14880,14975,14990,-30,-15,796,"5,967.42",3134
,20180119,14975,14990,15065,15180,14995,15180,15070,190,80,612,"4,612.41",3306
,20180122,15180,15070,15110,15115,14980,15035,15020,-35,-50,716,"5,378.16",3494
,20180123,15035,15020,15055,15085,14965,15020,15010,0,-10,358,"2,687.49",3656
,20180124,15020,15010,14910,15055,14905,14990,14975,-20,-35,676,"5,062.88",3842
,20180125,14990,14975,14980,15200,14955,15140,15070,165,95,240,"1,808.65",3860
,20180126,15140,15070,15095,15165,14970,14985,15050,-85,-20,860,"6,472.16",3996
,20180129,14985,15050,15000,15100,14970,14995,15030,-55,-20,236,"1,773.80",4102
,20180130,14995,15030,15010,15030,14800,14850,14855,-180,-175,3218,"23,903.52",5882
,20180131,14850,14855,14880,14930,14750,14780,14830,-75,-25,2310,"17,131.71",6164
,20180201,14780,14830,14770,14770,14630,14690,14715,-140,-115,3776,"27,791.13",7844
,20180202,14690,14715,14715,14790,14670,14720,14745,5,30,1030,"7,596.16",7992
,20180205,14720,14745,14755,14785,14595,14650,14680,-95,-65,694,"5,094.02",7982
,20180206,14650,14680,14645,14730,14480,14485,14580,-195,-100,1980,"14,434.31",8836
,20180207,14485,14580,14500,14620,14450,14550,14515,-30,-65,3196,"23,200.94",9296
,20180208,14550,14515,14545,14720,14480,14520,14560,5,45,4336,"31,576.87",10700
,20180209,14520,14560,14560,14585,14485,14510,14515,-50,-45,1036,"7,520.81",10776
,20180212,14510,14515,14465,14825,14370,14680,14550,165,35,3402,"24,754.32",11218
,20180213,14680,14550,14665,14750,14595,14645,14655,95,105,976,"7,152.33",11128
,20180214,14645,14655,14625,14690,14360,14390,14490,-265,-165,1850,"13,407.80",11638
,20180222,14390,14490,14565,14565,14300,14390,14375,-100,-115,3660,"26,313.73",13470
,20180223,14390,14375,14420,14640,14420,14630,14550,255,175,3604,"26,224.47",14176
,20180226,14630,14550,14560,14630,14460,14555,14545,5,-5,6340,"46,122.48",16920
,20180227,14555,14545,14560,14575,14425,14560,14500,15,-45,8106,"58,785.02",19580
,20180228,14560,14500,14540,14610,14455,14595,14550,95,50,3104,"22,585.94",19772
,20180301,14595,14550,14565,14675,14565,14650,14615,100,65,6174,"45,128.36",21374
,20180302,14650,14615,14625,14735,14535,14600,14635,-15,20,4974,"36,403.75",21884
,20180305,14600,14635,14650,14650,14450,14480,14505,-155,-130,12592,"91,333.97",24694
,20180306,14480,14505,14505,14690,14470,14605,14565,100,60,12996,"94,674.68",27478
,20180307,14605,14565,14605,14655,14405,14445,14520,-120,-45,14780,"107,325.12",29890
,20180308,14445,14520,14430,14480,14315,14415,14390,-105,-130,14192,"102,119.71",34392
,20180309,14415,14390,14465,14480,14200,14245,14380,-145,-10,15964,"114,811.93",36520
,20180312,14245,14380,14300,14450,14220,14235,14285,-145,-95,14958,"106,869.81",38102
,20180313,14235,14285,14260,14290,14000,14030,14100,-255,-185,23254,"163,969.17",44798
,20180314,14030,14100,14075,14160,14040,14140,14115,40,15,20602,"145,407.88",47784
,20180315,14140,14115,14180,14210,14050,14170,14150,55,35,18648,"131,955.51",51348
,20180316,14170,14150,14155,14215,14095,14165,14130,15,-20,21788,"153,968.15",55014
,20180319,14165,14130,14185,14305,14085,14125,14165,-5,35,17432,"123,462.51",57482
,20180320,14125,14165,14165,14225,14110,14175,14170,10,5,26314,"186,474.70",62636
,20180321,14175,14170,14190,14195,14030,14100,14090,-70,-80,27600,"194,449.82",68860
,20180322,14100,14090,14100,14180,14030,14140,14105,50,15,19428,"137,043.92",71142
,20180323,14140,14105,14085,14140,13820,13930,13950,-175,-155,50028,"349,056.43",76510
,20180326,13930,13950,13950,13970,13830,13860,13885,-90,-65,26068,"180,991.35",81472
,20180327,13860,13885,13870,14045,13835,13980,13970,95,85,29482,"205,940.59",83256
,20180328,13980,13970,13945,14015,13890,13895,13945,-75,-25,17248,"120,273.72",85848
,20180329,13895,13945,13890,14030,13820,13945,13930,0,-15,53434,"372,232.17",92654
,20180330,13945,13930,13910,13955,13790,13920,13875,-10,-55,41140,"285,478.94",97934
,20180402,13920,13875,13930,14130,13860,14125,13995,250,120,51964,"363,684.98",103988
,20180403,14125,13995,14110,14260,14100,14210,14185,215,190,38728,"274,739.62",107706
,20180404,14210,14185,14260,14260,14065,14125,14130,-60,-55,49114,"347,100.82",107308
,20180409,14125,14130,14500,14500,14210,14330,14270,200,140,42250,"301,510.83",106056
,20180410,14330,14270,14380,14495,14350,14430,14410,160,140,57060,"411,253.88",113978
,20180411,14430,14410,14535,14555,14380,14450,14460,40,50,82632,"597,457.04",135542
,20180412,14450,14460,14455,14485,14320,14400,14385,-60,-75,87170,"627,121.06",143314
,20180413,14400,14385,14390,14705,14335,14650,14575,265,190,120706,"879,704.09",160926
,20180416,14650,14575,14680,14775,14570,14700,14650,125,75,87518,"641,230.02",166048
,20180417,14700,14650,14815,15060,14810,15010,14935,360,285,140854,"1,051,896.28",190228
,20180418,15010,14935,14900,15045,14900,15015,14960,80,25,119786,"896,179.97",197738
,20180419,15015,14960,15205,15650,15205,15465,15370,505,410,245450,"1,886,531.21",219560
,20180420,15465,15370,15400,15400,14960,15035,15125,-335,-245,244486,"1,848,997.03",234072
,20180423,15035,15125,15035,15140,14910,15125,15020,0,-105,145986,"1,096,536.74",242392
,20180424,15125,15020,14520,14630,14300,14460,14495,-560,-525,302876,"2,195,316.97",228334
,20180425,14460,14495,14455,14585,14440,14475,14510,-20,15,120366,"873,485.65",228906
,20180426,14475,14510,14555,14560,14415,14450,14480,-60,-30,107696,"779,921.13",230374
,20180427,14450,14480,14435,14625,14405,14560,14550,80,70,155480,"1,131,161.23",244626
,20180502,14560,14550,14520,14595,14460,14505,14515,-45,-35,59488,"431,813.42",253088
,20180503,14505,14515,14600,14670,14560,14645,14610,130,95,123724,"903,825.65",265514
,20180504,14645,14610,14615,14735,14560,14650,14640,40,30,169428,"1,240,573.60",271562
,20180507,14650,14640,14690,14770,14660,14735,14705,95,65,154674,"1,137,602.96",288948
,20180508,14735,14705,14715,14790,14695,14755,14745,50,40,95766,"706,128.68",295666
,20180509,14755,14745,14745,14765,14575,14630,14650,-115,-95,212498,"1,557,061.24",290542
,20180510,14630,14650,14570,14670,14570,14625,14630,-25,-20,179012,"1,309,477.74",291218
,20180511,14625,14630,14640,14755,14605,14670,14690,40,60,198994,"1,461,787.96",289362
,20180514,14670,14690,14670,14715,14625,14635,14660,-55,-30,160222,"1,174,493.79",288660
,20180515,14635,14660,14660,14750,14635,14720,14705,60,45,167362,"1,230,668.39",287504
,20180516,14720,14705,14725,14825,14640,14790,14740,85,35,205460,"1,514,751.24",296138
,20180517,14790,14740,14780,14925,14755,14885,14865,145,125,204742,"1,521,839.80",301438
,20180518,14885,14865,14815,14900,14770,14840,14825,-25,-40,189112,"1,401,800.21",292592
,20180521,14840,14825,14860,14860,14750,14765,14790,-60,-35,172292,"1,274,219.59",285528
,20180522,14765,14790,14805,14805,14595,14610,14710,-180,-80,157014,"1,155,110.22",278388
,20180523,14610,14710,14610,14685,14580,14600,14630,-110,-80,149062,"1,090,428.06",266690
,20180524,14600,14630,14600,14795,14500,14745,14675,115,45,212840,"1,561,771.73",268454
,20180525,14745,14675,14755,14875,14730,14825,14790,150,115,176656,"1,306,425.89",267544
,20180528,14825,14790,14810,14850,14735,14800,14790,10,0,127814,"945,402.42",259860
,20180529,14800,14790,14800,14815,14715,14725,14760,-65,-30,147390,"1,087,767.08",252734
,20180530,14725,14760,14755,14780,14650,14690,14705,-70,-55,158358,"1,164,701.77",246450
,20180531,14690,14705,14700,14745,14585,14590,14660,-115,-45,189918,"1,392,466.49",243288
al1808,20180102,15755,15665,15865,15865,15530,15605,15700,-60,35,66,518.16,948
,20180103,15605,15700,15680,15680,15575,15585,15615,-115,-85,42,327.99,938
,20180104,15585,15615,15565,15660,15475,15585,15530,-30,-85,82,636.90,980
,20180105,15585,15530,15595,15595,15590,15590,15590,60,60,4,31.19,980
,20180108,15590,15590,15635,15635,15350,15450,15435,-140,-155,34,262.45,986
,20180109,15450,15435,15455,15515,15430,15470,15475,35,40,70,541.66,1000
,20180110,15470,15475,15320,15480,15320,15420,15405,-55,-70,178,"1,371.18",1036
,20180111,15420,15405,15490,15620,15475,15570,15505,165,100,102,790.98,1062
,20180112,15570,15505,15555,15555,15405,15495,15485,-10,-20,36,278.77,1072
,20180115,15495,15485,15500,15625,15500,15540,15565,55,80,58,451.46,1092
,20180116,15540,15565,15485,15490,15170,15210,15295,-355,-270,240,"1,835.48",1172
,20180117,15210,15295,15130,15135,15040,15055,15065,-240,-230,176,"1,325.89",1232
,20180118,15055,15065,15080,15135,14955,15060,15055,-5,-10,264,"1,987.48",1252
,20180119,15060,15055,15125,15215,15095,15215,15165,160,110,92,697.80,1214
,20180122,15215,15165,15135,15160,15080,15125,15115,-40,-50,22,166.29,1208
,20180123,15125,15115,15150,15150,15045,15065,15070,-50,-45,20,150.72,1216
,20180124,15065,15070,15015,15135,15000,15050,15050,-20,-20,168,"1,264.58",1200
,20180125,15050,15050,15035,15220,15035,15210,15120,160,70,62,468.75,1206
,20180126,15210,15120,15180,15220,15045,15060,15105,-60,-15,364,"2,749.46",1188
,20180129,15060,15105,15220,15220,15055,15100,15100,-5,-5,112,845.77,1202
,20180130,15100,15100,15080,15085,14865,14930,14935,-170,-165,134,"1,000.93",1190
,20180131,14930,14935,14955,15005,14830,14865,14920,-70,-15,380,"2,835.58",1122
,20180201,14865,14920,14820,14845,14765,14800,14800,-120,-120,282,"2,087.31",1196
,20180202,14800,14800,14790,14885,14775,14815,14835,15,35,434,"3,219.84",1312
,20180205,14815,14835,14725,14880,14695,14705,14760,-130,-75,198,"1,461.38",1298
,20180206,14705,14760,14730,14800,14565,14570,14660,-190,-100,250,"1,833.00",1316
,20180207,14570,14660,14545,14640,14535,14630,14570,-30,-90,416,"3,030.80",1572
,20180208,14630,14570,14635,14795,14560,14600,14630,30,60,2174,"15,906.70",2156
,20180209,14600,14630,14600,14675,14560,14580,14615,-50,-15,562,"4,108.08",2402
,20180212,14580,14615,14535,14895,14460,14760,14625,145,10,1070,"7,826.92",2586
,20180213,14760,14625,14750,14825,14670,14725,14700,100,75,184,"1,352.61",2562
,20180214,14725,14700,14700,14740,14445,14445,14615,-255,-85,676,"4,939.98",2622
,20180222,14445,14615,14625,14645,14395,14490,14475,-125,-140,1264,"9,150.22",3078
,20180223,14490,14475,14510,14725,14510,14725,14620,250,145,1564,"11,434.69",3312
,20180226,14725,14620,14680,14700,14545,14650,14630,30,10,544,"3,979.44",3376
,20180227,14650,14630,14645,14665,14530,14645,14595,15,-35,4472,"32,634.91",5120
,20180228,14645,14595,14645,14700,14555,14690,14620,95,25,266,"1,945.07",5080
,20180301,14690,14620,14665,14765,14660,14740,14705,120,85,2716,"19,973.92",5746
,20180302,14740,14705,14675,14820,14670,14670,14735,-35,30,1400,"10,315.50",6078
,20180305,14670,14735,14695,14715,14545,14575,14610,-160,-125,2202,"16,086.86",6586
,20180306,14575,14610,14575,14780,14570,14695,14665,85,55,3366,"24,687.29",8270
,20180307,14695,14665,14720,14730,14480,14545,14580,-120,-85,3210,"23,402.33",8998
,20180308,14545,14580,14525,14570,14405,14500,14495,-80,-85,3708,"26,875.83",10362
,20180309,14500,14495,14500,14560,14300,14355,14490,-140,-5,3720,"26,959.59",11294
,20180312,14355,14490,14375,14515,14305,14315,14360,-175,-130,1660,"11,921.44",11656
,20180313,14315,14360,14350,14355,14080,14115,14150,-245,-210,5606,"39,666.05",14026
,20180314,14115,14150,14135,14230,14120,14210,14195,60,45,2014,"14,295.30",14688
,20180315,14210,14195,14285,14290,14140,14230,14230,35,35,4356,"31,000.14",15974
,20180316,14230,14230,14230,14290,14175,14240,14210,10,-20,3532,"25,097.61",17040
,20180319,14240,14210,14335,14360,14165,14220,14240,10,30,4334,"30,862.71",18254
,20180320,14220,14240,14245,14300,14200,14260,14260,20,20,2522,"17,982.94",18584
,20180321,14260,14260,14270,14270,14115,14180,14165,-80,-95,3680,"26,068.46",19774
,20180322,14180,14165,14175,14265,14125,14225,14190,60,25,1640,"11,638.79",20194
,20180323,14225,14190,14150,14210,13910,14015,14040,-175,-150,8056,"56,564.19",22912
,20180326,14015,14040,14010,14060,13920,13945,13965,-95,-75,3688,"25,752.49",23368
,20180327,13945,13965,13940,14130,13930,14055,14045,90,80,7542,"52,977.29",24768
,20180328,14055,14045,14030,14100,13980,13980,14025,-65,-20,2434,"17,068.53",25662
,20180329,13980,14025,13965,14100,13910,14015,14005,-10,-20,9882,"69,205.48",27900
,20180330,14015,14005,13970,14020,13880,13980,13955,-25,-50,11586,"80,868.78",28970
,20180402,13980,13955,13985,14205,13930,14200,14090,245,135,14788,"104,215.03",30486
,20180403,14200,14090,14220,14325,14175,14280,14265,190,175,10354,"73,871.28",31592
,20180404,14280,14265,14350,14700,14140,14210,14205,-55,-60,12848,"91,276.50",32476
,20180409,14210,14205,14485,14545,14285,14400,14335,195,130,12438,"89,175.83",33652
,20180410,14400,14335,14540,14555,14425,14480,14485,145,150,22748,"164,780.59",38324
,20180411,14480,14485,14555,14620,14445,14515,14530,30,45,31674,"230,136.93",47346
,20180412,14515,14530,14525,14550,14400,14465,14455,-65,-75,22882,"165,429.62",51124
,20180413,14465,14455,14450,14780,14415,14725,14660,270,205,24988,"183,180.84",53078
,20180416,14725,14660,14775,14880,14650,14780,14730,120,70,21734,"160,114.81",53326
,20180417,14780,14730,14920,15135,14880,15090,15015,360,285,35954,"269,933.89",59816
,20180418,15090,15015,14995,15120,14980,15105,15045,90,30,27684,"208,267.24",60892
,20180419,15105,15045,15375,15715,15300,15540,15450,495,405,63838,"493,161.32",68632
,20180420,15540,15450,15400,15480,15035,15120,15190,-330,-260,37586,"285,532.87",69044
,20180423,15120,15190,15095,15220,14990,15200,15095,10,-95,28786,"217,303.84",72984
,20180424,15200,15095,14680,14700,14380,14535,14565,-560,-530,70046,"510,239.51",80710
,20180425,14535,14565,14535,14655,14510,14555,14590,-10,25,38656,"282,012.31",81660
,20180426,14555,14590,14600,14630,14500,14520,14555,-70,-35,31648,"230,381.07",83762
,20180427,14520,14555,14500,14705,14480,14635,14625,80,70,33670,"246,279.62",83672
,20180502,14635,14625,14620,14675,14540,14590,14595,-35,-30,18076,"131,953.18",85758
,20180503,14590,14595,14665,14750,14640,14720,14685,125,90,30126,"221,275.03",92542
,20180504,14720,14685,14750,14815,14640,14730,14725,45,40,43230,"318,286.24",93180
,20180507,14730,14725,14740,14850,14740,14815,14785,90,60,36246,"267,974.85",95070
,20180508,14815,14785,14850,14865,14765,14830,14815,45,30,25338,"187,725.92",95438
,20180509,14830,14815,14815,14835,14650,14700,14725,-115,-90,38322,"282,194.72",99322
,20180510,14700,14725,14665,14735,14630,14690,14695,-35,-30,35716,"262,423.93",103444
,20180511,14690,14695,14725,14820,14675,14735,14750,40,55,38380,"283,133.17",105310
,20180514,14735,14750,14735,14770,14690,14700,14715,-50,-35,22658,"166,760.91",104154
,20180515,14700,14715,14740,14810,14695,14780,14770,65,55,32320,"238,708.48",108412
,20180516,14780,14770,14780,14890,14710,14860,14800,90,30,46364,"343,206.35",113172
,20180517,14860,14800,14855,14990,14820,14955,14935,155,135,51512,"384,735.90",125198
,20180518,14955,14935,14875,14970,14840,14900,14895,-35,-40,65024,"484,269.98",126070
,20180521,14900,14895,14920,14930,14815,14835,14860,-60,-35,55044,"409,052.69",128358
,20180522,14835,14860,14870,14875,14665,14690,14775,-170,-85,50162,"370,591.33",136490
,20180523,14690,14775,14690,14760,14655,14685,14700,-90,-75,52200,"383,771.37",141830
,20180524,14685,14700,14665,14860,14575,14800,14745,100,45,79484,"586,047.63",146706
,20180525,14800,14745,14835,14935,14800,14895,14850,150,105,62164,"461,657.23",146378
,20180528,14895,14850,14860,14915,14795,14870,14860,20,10,44334,"329,443.22",150186
,20180529,14870,14860,14865,14880,14785,14795,14830,-65,-30,60256,"446,800.44",154896
,20180530,14795,14830,14815,14850,14730,14760,14780,-70,-50,67212,"496,713.80",165048
,20180531,14760,14780,14760,14815,14665,14670,14730,-110,-50,78404,"577,566.38",179684
al1809,20180102,15855,15750,15960,15960,15640,15695,15810,-55,60,20,158.15,526
,20180103,15695,15810,15715,15730,15670,15670,15695,-140,-115,14,109.87,524
,20180104,15670,15695,15635,15715,15540,15655,15620,-40,-75,80,624.95,524
,20180105,15655,15620,15670,15685,15600,15665,15655,45,35,14,109.61,516
,20180108,15665,15655,15700,15700,15450,15520,15560,-135,-95,30,233.43,522
,20180109,15520,15560,15530,15595,15490,15595,15510,35,-50,76,589.41,520
,20180110,15595,15510,15465,15520,15465,15490,15500,-20,-10,40,310.09,522
,20180111,15490,15500,15545,15670,15540,15670,15590,170,90,52,405.38,540
,20180112,15670,15590,15590,15590,15480,15565,15535,-25,-55,8,62.15,546
,20180115,15565,15535,15680,15725,15635,15635,15670,100,135,18,141.07,548
,20180116,15635,15670,15565,15580,15245,15285,15360,-385,-310,108,829.51,584
,20180117,15285,15360,15060,15215,15005,15155,15130,-205,-230,68,514.56,596
,20180118,15155,15130,15165,15215,15010,15155,15110,25,-20,64,483.60,592
,20180119,15155,15110,15160,15300,15150,15245,15210,135,100,28,213.00,590
,20180122,15245,15210,15490,15490,15150,15180,15275,-30,65,42,320.81,592
,20180123,15180,15275,15130,15130,15110,15110,15120,-165,-155,4,30.24,594
,20180124,15110,15120,15125,15125,15125,15125,15125,5,5,2,15.13,592
,20180125,15125,15125,15160,15335,15160,15335,15270,210,145,14,106.91,586
,20180126,15335,15270,15260,15300,15135,15155,15190,-115,-80,48,364.68,582
,20180129,15155,15190,15175,15230,15135,15230,15160,40,-30,46,348.73,574
,20180130,15230,15160,15100,15195,14975,15020,15020,-140,-140,138,"1,036.42",616
,20180131,15020,15020,15060,15095,14940,14945,15010,-75,-10,48,360.29,602
,20180201,14945,15010,14900,14905,14855,14865,14880,-145,-130,16,119.05,606
,20180202,14865,14880,14870,14940,14870,14905,14900,25,20,126,938.96,678
,20180205,14905,14900,14930,14965,14780,14820,14870,-80,-30,98,728.70,724
,20180206,14820,14870,14775,14840,14650,14660,14750,-210,-120,134,988.45,736
,20180207,14660,14750,14640,14720,14595,14705,14655,-45,-95,40,293.17,750
,20180208,14705,14655,14710,14800,14630,14705,14690,50,35,72,529.01,776
,20180209,14705,14690,14680,14700,14640,14660,14660,-30,-30,50,366.58,768
,20180212,14660,14660,14600,14980,14520,14825,14650,165,-10,228,"1,670.48",906
,20180213,14825,14650,14775,14885,14770,14815,14830,165,180,72,534.01,954
,20180214,14815,14830,14760,14835,14505,14560,14715,-270,-115,130,956.67,1000
,20180222,14560,14715,14620,14720,14460,14560,14600,-155,-115,42,306.67,1008
,20180223,14560,14600,14580,14820,14580,14815,14720,215,120,420,"3,091.85",1250
,20180226,14815,14720,14775,14790,14650,14685,14730,-35,10,68,500.93,1262
,20180227,14685,14730,14620,14755,14615,14750,14665,20,-65,1056,"7,745.17",1586
,20180228,14750,14665,14730,14785,14640,14755,14725,90,60,224,"1,649.52",1556
,20180301,14755,14725,14755,14850,14755,14825,14805,100,80,1326,"9,816.64",1974
,20180302,14825,14805,14810,14925,14730,14780,14830,-25,25,712,"5,280.05",2196
,20180305,14780,14830,14775,14815,14635,14660,14705,-170,-125,1188,"8,736.40",2678
,20180306,14660,14705,14670,14870,14655,14810,14755,105,50,1994,"14,711.01",3256
,20180307,14810,14755,14945,14945,14590,14625,14675,-130,-80,1558,"11,432.75",3766
,20180308,14625,14675,14610,14660,14490,14590,14590,-85,-85,2140,"15,615.15",4544
,20180309,14590,14590,14555,14645,14355,14400,14565,-190,-25,1504,"10,955.49",5070
,20180312,14400,14565,14430,14630,14380,14385,14475,-180,-90,1398,"10,120.29",5222
,20180313,14385,14475,14405,14430,14155,14175,14250,-300,-225,2424,"17,273.32",6312
,20180314,14175,14250,14215,14315,14205,14300,14270,50,20,590,"4,210.37",6418
,20180315,14300,14270,14345,14360,14230,14320,14325,50,55,2048,"14,669.47",7210
,20180316,14320,14325,14320,14365,14255,14325,14295,0,-30,578,"4,132.06",7348
,20180319,14325,14295,14365,14455,14250,14300,14320,5,25,2080,"14,897.33",7934
,20180320,14300,14320,14300,14370,14290,14350,14340,30,20,4046,"29,009.91",9642
,20180321,14350,14340,14355,14370,14200,14255,14255,-85,-85,3164,"22,555.18",10936
,20180322,14255,14255,14270,14335,14200,14295,14265,40,10,1902,"13,566.02",11476
,20180323,14295,14265,14255,14295,13990,14125,14120,-140,-145,8502,"60,043.42",14108
,20180326,14125,14120,14065,14120,14005,14020,14055,-100,-65,1930,"13,564.37",14200
,20180327,14020,14055,14050,14205,14010,14150,14125,95,70,4614,"32,593.12",14956
,20180328,14150,14125,14130,14170,14060,14060,14105,-65,-20,1616,"11,398.73",15152
,20180329,14060,14105,14155,14190,14000,14075,14065,-30,-40,6894,"48,487.51",16948
,20180330,14075,14065,14045,14095,13935,14060,14020,-5,-45,4918,"34,481.39",17858
,20180402,14060,14020,14075,14280,14005,14275,14170,255,150,4694,"33,267.35",18348
,20180403,14275,14170,14285,14400,14245,14380,14330,210,160,5942,"42,578.79",19766
,20180404,14380,14330,14395,14395,14210,14260,14285,-70,-45,4888,"34,913.05",19184
,20180409,14260,14285,14425,14625,14365,14470,14410,185,125,4624,"33,324.86",20002
,20180410,14470,14410,14525,14625,14500,14535,14550,125,140,5796,"42,176.88",21220
,20180411,14535,14550,14625,14680,14520,14630,14575,80,25,6110,"44,533.59",20910
,20180412,14630,14575,14635,14635,14470,14550,14525,-25,-50,5888,"42,774.91",20598
,20180413,14550,14525,14550,14845,14485,14840,14765,315,240,9946,"73,446.72",20528
,20180416,14840,14765,14865,14895,14730,14870,14815,105,50,7142,"52,909.21",22938
,20180417,14870,14815,15000,15215,14970,15160,15095,345,280,12344,"93,170.91",25260
,20180418,15160,15095,15080,15195,15055,15180,15110,85,15,11684,"88,278.74",27296
,20180419,15180,15110,15310,15780,15310,15620,15545,510,435,33900,"263,502.12",33968
,20180420,15620,15545,15585,15585,15125,15200,15270,-345,-275,29808,"227,656.84",38484
,20180423,15200,15270,15200,15295,15075,15275,15200,5,-70,14086,"107,079.08",40588
,20180424,15275,15200,14800,14800,14450,14610,14665,-590,-535,31212,"228,880.27",40852
,20180425,14610,14665,14655,14740,14580,14630,14660,-35,-5,16482,"120,851.44",43308
,20180426,14630,14660,14700,14705,14585,14605,14625,-55,-35,11762,"86,030.72",44954
,20180427,14605,14625,14575,14780,14560,14725,14705,100,80,12654,"93,048.89",44324
,20180502,14725,14705,14730,14755,14625,14665,14675,-40,-30,5866,"43,051.45",43358
,20180503,14665,14675,14730,14830,14720,14800,14765,125,90,7318,"54,042.90",43240
,20180504,14800,14765,14795,14890,14720,14800,14800,35,35,12084,"89,438.83",43256
,20180507,14800,14800,14850,14920,14810,14885,14860,85,60,12470,"92,656.97",45166
,20180508,14885,14860,14885,14930,14840,14895,14890,35,30,7386,"54,996.09",45464
,20180509,14895,14890,14875,14910,14725,14770,14800,-120,-90,15212,"112,575.06",47300
,20180510,14770,14800,14695,14805,14695,14760,14765,-40,-35,11822,"87,300.89",49224
,20180511,14760,14765,14760,14885,14745,14795,14820,30,55,10618,"78,690.39",50360
,20180514,14795,14820,14800,14835,14755,14760,14780,-60,-40,14290,"105,609.73",51112
,20180515,14760,14780,14780,14875,14765,14840,14830,60,50,14914,"110,603.76",53050
,20180516,14840,14830,14850,14945,14775,14910,14860,80,30,18806,"139,763.30",55678
,20180517,14910,14860,14890,15050,14880,15005,14990,145,130,19480,"146,037.29",60444
,20180518,15005,14990,14955,15025,14900,14980,14960,-10,-30,20902,"156,388.54",61102
,20180521,14980,14960,14980,14990,14885,14900,14925,-60,-35,17224,"128,562.01",61950
,20180522,14900,14925,14950,14950,14740,14740,14845,-185,-80,15512,"115,152.97",65120
,20180523,14740,14845,14740,14830,14730,14755,14770,-90,-75,14652,"108,214.29",66888
,20180524,14755,14770,14740,14925,14645,14880,14815,110,45,24392,"180,724.90",68452
,20180525,14880,14815,14885,15000,14865,14970,14920,155,105,21374,"159,456.50",72212
,20180528,14970,14920,14940,14985,14865,14935,14935,15,15,18554,"138,574.31",76582
,20180529,14935,14935,14930,14950,14855,14880,14900,-55,-35,33964,"253,049.05",89738
,20180530,14880,14900,14800,14920,14800,14835,14855,-65,-45,29912,"222,222.36",98052
,20180531,14835,14855,14870,14885,14740,14745,14800,-110,-55,35074,"259,622.14",109770
al1810,20180102,15810,15865,16030,16030,15775,15775,15920,-90,55,18,143.30,402
,20180103,15775,15920,15790,15790,15700,15700,15740,-220,-180,32,251.85,408
,20180104,15700,15740,15755,15755,15610,15690,15710,-50,-30,80,628.44,438
,20180105,15690,15710,,,,15710,15710,0,0,0,0.00,438
,20180108,15710,15710,15655,15725,15500,15540,15580,-170,-130,40,311.66,440
,20180109,15540,15580,15550,15640,15550,15615,15585,35,5,12,93.53,438
,20180110,15615,15585,15600,15600,15540,15550,15560,-35,-25,20,155.61,436
,20180111,15550,15560,15605,15630,15595,15630,15610,70,50,40,312.24,434
,20180112,15630,15610,15705,15705,15550,15610,15605,0,-5,26,202.91,454
,20180115,15610,15605,15705,15730,15690,15695,15705,90,100,8,62.82,452
,20180116,15695,15705,15635,15635,15285,15320,15440,-385,-265,48,370.63,472
,20180117,15320,15440,15200,15225,15140,15195,15180,-245,-260,46,349.16,462
,20180118,15195,15180,15195,15270,15190,15195,15215,15,35,20,152.16,476
,20180119,15195,15215,,,,15215,15215,0,0,0,0.00,476
,20180122,15215,15215,15270,15270,15140,15230,15195,15,-20,80,607.83,502
,20180123,15230,15195,15270,15270,15165,15180,15205,-15,10,18,136.87,514
,20180124,15180,15205,15110,15240,15110,15155,15155,-50,-50,24,181.90,524
,20180125,15155,15155,15145,15355,15140,15355,15200,200,45,36,273.65,534
,20180126,15355,15200,15265,15325,15160,15215,15245,15,45,46,350.65,540
,20180129,15215,15245,15245,15245,15245,15245,15245,0,0,2,15.25,540
,20180130,15245,15245,15160,15230,15050,15050,15115,-195,-130,52,393.08,524
,20180131,15050,15115,15120,15120,14975,15020,15025,-95,-90,62,465.87,512
,20180201,15020,15025,14995,14995,14900,14900,14975,-125,-50,14,104.85,510
,20180202,14900,14975,15005,15010,14995,15010,15000,35,25,6,45.01,508
,20180205,15010,15000,15005,15005,14870,14890,14890,-110,-110,52,387.16,520
,20180206,14890,14890,14850,14900,14780,14780,14830,-110,-60,112,830.62,568
,20180207,14780,14830,14710,14810,14695,14770,14725,-60,-105,56,412.36,568
,20180208,14770,14725,14840,14880,14755,14800,14820,75,95,30,222.30,580
,20180209,14800,14820,14725,14750,14725,14750,14730,-70,-90,34,250.49,570
,20180212,14750,14730,14700,15000,14605,14955,14665,225,-65,126,924.06,598
,20180213,14955,14665,,,,14800,14800,135,135,0,0.00,598
,20180214,14800,14800,14845,14855,14715,14715,14770,-85,-30,38,280.64,618
,20180222,14715,14770,14780,14780,14625,14625,14715,-145,-55,14,103.03,626
,20180223,14625,14715,14700,14845,14685,14845,14810,130,95,230,"1,703.65",790
,20180226,14845,14810,14850,14850,14850,14850,14850,40,40,6,44.55,784
,20180227,14850,14850,14730,14880,14725,14815,14780,-35,-70,16,118.27,782
,20180228,14815,14780,14795,14855,14745,14855,14785,75,5,40,295.77,772
,20180301,14855,14785,14885,14950,14840,14930,14875,145,90,664,"4,939.10",1030
,20180302,14930,14875,14860,14975,14860,14900,14945,25,70,386,"2,884.91",1162
,20180305,14900,14945,14840,14840,14725,14760,14780,-185,-165,848,"6,267.78",1592
,20180306,14760,14780,14780,15000,14755,14915,14845,135,65,1156,"8,583.03",2040
,20180307,14915,14845,14905,14915,14725,14730,14745,-115,-100,452,"3,333.00",2238
,20180308,14730,14745,14710,14780,14620,14640,14705,-105,-40,880,"6,471.35",2530
,20180309,14640,14705,14690,14740,14475,14545,14640,-160,-65,382,"2,796.81",2598
,20180312,14545,14640,14545,14640,14450,14470,14530,-170,-110,260,"1,889.14",2636
,20180313,14470,14530,14525,14525,14265,14285,14310,-245,-220,510,"3,649.60",2836
,20180314,14285,14310,14320,14410,14280,14370,14355,60,45,148,"1,062.31",2872
,20180315,14370,14355,14410,14435,14300,14435,14365,80,10,112,804.46,2848
,20180316,14435,14365,14405,14440,14350,14375,14390,10,25,98,705.14,2892
,20180319,14375,14390,14445,14505,14360,14385,14415,-5,25,934,"6,732.48",3216
,20180320,14385,14415,14395,14470,14360,14400,14430,-15,15,2466,"17,796.13",4242
,20180321,14400,14430,14380,14385,14280,14345,14330,-85,-100,104,745.18,4262
,20180322,14345,14330,14325,14415,14310,14370,14345,40,15,796,"5,710.01",4588
,20180323,14370,14345,14360,14385,14060,14140,14220,-205,-125,3770,"26,812.78",6038
,20180326,14140,14220,14205,14205,14100,14125,14130,-95,-90,376,"2,657.11",6092
,20180327,14125,14130,14120,14305,14115,14235,14210,105,80,2052,"14,579.95",6716
,20180328,14235,14210,14265,14265,14140,14155,14175,-55,-35,666,"4,721.08",6880
,20180329,14155,14175,14115,14255,14080,14165,14120,-10,-55,3662,"25,861.04",8498
,20180330,14165,14120,14120,14180,14040,14130,14105,10,-15,1182,"8,337.57",8452
,20180402,14130,14105,14130,14360,14090,14355,14235,250,130,726,"5,167.93",8742
,20180403,14355,14235,14370,14465,14305,14440,14400,205,165,766,"5,516.74",8764
,20180404,14440,14400,14420,14425,14285,14330,14355,-70,-45,1046,"7,508.38",8826
,20180409,14330,14355,14600,14600,14415,14525,14480,170,125,1436,"10,398.17",9150
,20180410,14525,14480,14550,14675,14550,14610,14610,130,130,1268,"9,265.30",9024
,20180411,14610,14610,14685,14750,14585,14660,14660,50,50,682,"5,000.03",8872
,20180412,14660,14660,14685,14685,14525,14625,14580,-35,-80,1150,"8,386.23",8828
,20180413,14625,14580,14635,14900,14560,14860,14800,280,220,3684,"27,267.68",7734
,20180416,14860,14800,14910,14925,14800,14905,14860,105,60,344,"2,556.49",7656
,20180417,14905,14860,15090,15265,15080,15240,15140,380,280,1020,"7,723.12",8120
,20180418,15240,15140,15145,15275,15115,15235,15165,95,25,538,"4,079.74",8084
,20180419,15235,15165,15485,15785,15450,15670,15570,505,405,7048,"54,876.32",9260
,20180420,15670,15570,15535,15565,15170,15245,15370,-325,-200,4582,"35,214.32",9998
,20180423,15245,15370,15285,15370,15145,15340,15260,-30,-110,3682,"28,101.69",9660
,20180424,15340,15260,14710,14860,14550,14720,14760,-540,-500,4468,"32,976.28",10992
,20180425,14720,14760,14615,14815,14615,14710,14740,-50,-20,1284,"9,465.46",11036
,20180426,14710,14740,14750,14770,14665,14695,14715,-45,-25,410,"3,017.25",11054
,20180427,14695,14715,14660,14860,14660,14785,14790,70,75,888,"6,566.98",11048
,20180502,14785,14790,14775,14820,14705,14730,14755,-60,-35,446,"3,290.58",11046
,20180503,14730,14755,14835,14900,14795,14880,14840,125,85,546,"4,051.96",11074
,20180504,14880,14840,14890,14965,14810,14870,14875,30,35,782,"5,816.48",11132
,20180507,14870,14875,14910,14975,14880,14965,14920,90,45,1738,"12,969.10",11494
,20180508,14965,14920,14935,14995,14920,14965,14960,45,40,1202,"8,993.39",11492
,20180509,14965,14960,14965,14975,14785,14840,14875,-120,-85,3430,"25,512.46",12772
,20180510,14840,14875,14795,14875,14785,14835,14835,-40,-40,3966,"29,425.27",14610
,20180511,14835,14835,14825,14950,14825,14865,14890,30,55,2140,"15,933.49",14500
,20180514,14865,14890,14860,14895,14815,14840,14840,-50,-50,1104,"8,193.69",14464
,20180515,14840,14840,14830,14925,14830,14895,14880,55,40,4252,"31,642.66",15382
,20180516,14895,14880,14895,14990,14820,14965,14930,85,50,4708,"35,148.77",15656
,20180517,14965,14930,14950,15105,14925,15055,15045,125,115,4374,"32,909.24",17206
,20180518,15055,15045,14995,15075,14955,15025,14990,-20,-55,1940,"14,544.75",17324
,20180521,15025,14990,15025,15045,14950,14970,14985,-20,-5,2470,"18,511.99",17786
,20180522,14970,14985,14990,14990,14800,14800,14900,-185,-85,2634,"19,629.07",18120
,20180523,14800,14900,14810,14885,14800,14820,14835,-80,-65,1028,"7,627.11",18282
,20180524,14820,14835,14805,14990,14725,14950,14835,115,0,4116,"30,534.87",17776
,20180525,14950,14835,14960,15060,14930,15030,14995,195,160,3144,"23,573.58",17618
,20180528,15030,14995,15015,15045,14940,15015,15000,20,5,2272,"17,043.63",18168
,20180529,15015,15000,15025,15025,14930,14940,14960,-60,-40,3330,"24,911.18",18668
,20180530,14940,14960,14950,14985,14865,14905,14915,-55,-45,1810,"13,499.23",19092
,20180531,14905,14915,14915,14955,14820,14830,14895,-85,-20,3564,"26,543.57",20456
al1811,20180102,16015,15915,15970,15990,15800,15805,15830,-110,-85,36,284.95,312
,20180103,15805,15830,15860,15860,15760,15760,15810,-70,-20,54,426.89,352
,20180104,15760,15810,15800,15800,15710,15770,15735,-40,-75,64,503.65,380
,20180105,15770,15735,15740,15740,15740,15740,15740,5,5,2,15.74,382
,20180108,15740,15740,15580,15580,15580,15580,15580,-160,-160,2,15.58,382
,20180109,15580,15580,15630,15680,15630,15680,15655,100,75,12,93.95,386
,20180110,15680,15655,15590,15615,15590,15595,15595,-60,-60,132,"1,029.33",422
,20180111,15595,15595,15645,15700,15645,15700,15665,105,70,8,62.67,422
,20180112,15700,15665,15595,15650,15595,15650,15620,-15,-45,4,31.25,424
,20180115,15650,15620,15755,15755,15740,15740,15745,120,125,4,31.50,422
,20180116,15740,15745,15675,15675,15340,15340,15450,-405,-295,36,278.16,418
,20180117,15340,15450,15230,15275,15200,15270,15225,-180,-225,20,152.25,408
,20180118,15270,15225,15285,15285,15155,15245,15205,20,-20,10,76.04,402
,20180119,15245,15205,15305,15415,15285,15410,15345,205,140,18,138.14,402
,20180122,15410,15345,15250,15280,15245,15280,15255,-65,-90,18,137.31,404
,20180123,15280,15255,15295,15295,15165,15165,15215,-90,-40,10,76.09,404
,20180124,15165,15215,15180,15295,15180,15295,15235,80,20,6,45.71,408
,20180125,15295,15235,15390,15425,15390,15425,15400,190,165,6,46.21,406
,20180126,15425,15400,15355,15385,15240,15240,15325,-160,-75,12,91.95,408
,20180129,15240,15325,,,,15325,15325,0,0,0,0.00,408
,20180130,15325,15325,15210,15270,15105,15105,15160,-220,-165,26,197.09,406
,20180131,15105,15160,15185,15275,15040,15095,15130,-65,-30,50,378.33,388
,20180201,15095,15130,14980,14980,14980,14980,14980,-150,-150,2,14.98,390
,20180202,14980,14980,15080,15085,15080,15085,15080,105,100,6,45.25,384
,20180205,15085,15080,14965,14995,14950,14995,14965,-85,-115,8,59.87,386
,20180206,14995,14965,14960,14960,14870,14870,14910,-95,-55,62,462.27,382
,20180207,14870,14910,14800,14890,14800,14855,14855,-55,-55,10,74.29,382
,20180208,14855,14855,14865,14865,14830,14850,14850,-5,-5,36,267.33,398
,20180209,14850,14850,14755,14835,14755,14810,14805,-40,-45,18,133.26,388
,20180212,14810,14805,14720,14950,14640,14950,14720,145,-85,94,691.88,376
,20180213,14950,14720,,,,14720,14720,0,0,0,0.00,376
,20180214,14720,14720,14885,14885,14810,14810,14820,90,100,12,88.94,382
,20180222,14810,14820,14860,14865,14695,14695,14775,-125,-45,48,354.71,426
,20180223,14695,14775,14900,14900,14900,14900,14900,125,125,160,"1,192.00",536
,20180226,14900,14900,,,,14900,14900,0,0,0,0.00,536
,20180227,14900,14900,14880,14880,14880,14880,14880,-20,-20,6,44.64,540
,20180228,14880,14880,14905,14925,14865,14925,14895,45,15,30,223.46,558
,20180301,14925,14895,14930,14945,14895,14945,14915,50,20,70,522.10,602
,20180302,14945,14915,15035,15035,14910,14910,14970,-5,55,170,"1,272.87",728
,20180305,14910,14970,14910,14910,14810,14810,14830,-160,-140,224,"1,661.50",886
,20180306,14810,14830,14845,15005,14845,14970,14950,140,120,50,373.79,906
,20180307,14970,14950,14920,14920,14780,14790,14855,-160,-95,50,371.45,940
,20180308,14790,14855,14795,14820,14680,14715,14730,-140,-125,134,986.96,974
,20180309,14715,14730,14750,14790,14620,14620,14700,-110,-30,34,249.94,998
,20180312,14620,14700,14635,14635,14545,14545,14590,-155,-110,28,204.31,1006
,20180313,14545,14590,14450,14450,14365,14365,14380,-225,-210,28,201.37,1020
,20180314,14365,14380,14370,14690,14370,14690,14635,310,255,48,351.30,1064
,20180315,14690,14635,14615,14615,14430,14505,14510,-130,-125,162,"1,175.33",1048
,20180316,14505,14510,14510,14510,14430,14465,14485,-45,-25,70,507.04,1068
,20180319,14465,14485,14485,14540,14440,14455,14495,-30,10,100,724.97,1036
,20180320,14455,14495,14450,14525,14450,14515,14495,20,0,18,130.50,1042
,20180321,14515,14495,14450,14450,14375,14375,14395,-120,-100,28,201.57,1036
,20180322,14375,14395,14445,14490,14440,14490,14450,95,55,54,390.19,1042
,20180323,14490,14450,14350,14350,14200,14240,14265,-210,-185,300,"2,139.82",1260
,20180326,14240,14265,14275,14280,14130,14195,14215,-70,-50,384,"2,729.73",1266
,20180327,14195,14215,14195,14270,14195,14270,14215,55,0,12,85.32,1256
,20180328,14270,14215,,,,14215,14215,0,0,0,0.00,1256
,20180329,14215,14215,14160,14270,14150,14225,14175,10,-40,22,155.98,1270
,20180330,14225,14175,14165,14245,14125,14215,14180,40,5,38,269.44,1266
,20180402,14215,14180,14295,14370,14295,14370,14325,190,145,52,372.54,1224
,20180403,14370,14325,14450,14450,14450,14450,14450,125,125,2,14.45,1226
,20180404,14450,14450,14475,14475,14360,14360,14430,-90,-20,34,245.36,1234
,20180409,14360,14430,14550,14600,14505,14600,14575,170,145,598,"4,358.99",1168
,20180410,14600,14575,14670,14740,14650,14665,14690,90,115,756,"5,553.64",1270
,20180411,14665,14690,14735,14810,14680,14720,14750,30,60,254,"1,873.32",1230
,20180412,14720,14750,14710,14755,14640,14685,14695,-65,-55,102,749.53,1270
,20180413,14685,14695,14480,14995,14480,14930,14745,235,50,298,"2,197.06",1200
,20180416,14930,14745,14985,14995,14860,14975,14930,230,185,194,"1,448.56",1204
,20180417,14975,14930,15140,15290,15140,15255,15215,325,285,128,973.82,1196
,20180418,15255,15215,15205,15320,15195,15290,15240,75,25,266,"2,027.33",1226
,20180419,15290,15240,15560,15830,15535,15715,15675,475,435,576,"4,514.65",1378
,20180420,15715,15675,15600,15620,15250,15275,15450,-400,-225,358,"2,766.17",1346
,20180423,15275,15450,15320,15435,15205,15390,15295,-60,-155,342,"2,616.03",1402
,20180424,15390,15295,14800,14900,14600,14835,14765,-460,-530,242,"1,787.12",1454
,20180425,14835,14765,14805,14880,14795,14795,14835,30,70,582,"4,317.04",1450
,20180426,14795,14835,14815,14815,14775,14775,14775,-60,-60,34,251.26,1474
,20180427,14775,14775,14920,14920,14860,14865,14880,90,105,84,625.04,1474
,20180502,14865,14880,14835,14895,14790,14840,14835,-40,-45,66,489.71,1470
,20180503,14840,14835,14900,14965,14890,14930,14915,95,80,116,865.24,1458
,20180504,14930,14915,15020,15025,14915,14945,14985,30,70,126,944.13,1426
,20180507,14945,14985,15010,15070,14960,15045,15000,60,15,96,720.14,1432
,20180508,15045,15000,15060,15065,15040,15040,15040,40,40,492,"3,700.82",1856
,20180509,15040,15040,15035,15050,14900,14915,14930,-125,-110,380,"2,837.26",1932
,20180510,14915,14930,14880,14970,14875,14895,14930,-35,0,444,"3,314.90",2090
,20180511,14895,14930,14940,15015,14915,14940,14955,10,25,304,"2,273.58",2190
,20180514,14940,14955,14930,14965,14885,14905,14910,-50,-45,216,"1,610.72",2262
,20180515,14905,14910,14945,14985,14945,14945,14955,35,45,588,"4,396.95",2260
,20180516,14945,14955,14900,15050,14900,15020,15005,65,50,328,"2,461.30",2408
,20180517,15020,15005,14990,15155,14990,15120,15100,115,95,256,"1,933.02",2418
,20180518,15120,15100,15070,15125,15020,15085,15050,-15,-50,220,"1,655.94",2364
,20180521,15085,15050,15020,15075,15015,15025,15035,-25,-15,164,"1,232.94",2310
,20180522,15025,15035,15050,15050,14890,14890,15010,-145,-25,260,"1,951.56",2310
,20180523,14890,15010,14900,14930,14875,14875,14905,-135,-105,180,"1,341.77",2388
,20180524,14875,14905,14850,15045,14805,15005,14980,100,75,376,"2,816.98",2354
,20180525,15005,14980,15010,15105,14995,15055,15055,75,75,418,"3,147.01",2522
,20180528,15055,15055,15050,15095,15010,15075,15065,20,10,262,"1,973.88",2630
,20180529,15075,15065,15065,15065,14990,15010,15035,-55,-30,122,917.18,2658
,20180530,15010,15035,15010,15045,14935,14965,14965,-70,-70,56,419.12,2666
,20180531,14965,14965,15010,15010,14885,14895,14960,-70,-5,106,793.06,2666
al1812,20180102,16110,16035,16040,16040,15860,15865,15895,-170,-140,20,158.98,116
,20180103,15865,15895,15870,15915,15805,15830,15825,-65,-70,68,538.15,140
,20180104,15830,15825,15860,15895,15730,15780,15790,-45,-35,156,"1,231.85",240
,20180105,15780,15790,15860,15860,15775,15840,15825,50,35,18,142.45,250
,20180108,15840,15825,15710,15785,15605,15675,15680,-150,-145,42,329.30,270
,20180109,15675,15680,15685,15755,15630,15755,15680,75,0,92,721.49,290
,20180110,15755,15680,15705,15705,15670,15670,15700,-10,20,28,219.84,290
,20180111,15670,15700,15685,15790,15685,15765,15705,65,5,26,204.18,308
,20180112,15765,15705,15695,15700,15695,15700,15695,-5,-10,12,94.20,318
,20180115,15700,15695,15775,15775,15775,15775,15775,80,80,2,15.78,316
,20180116,15775,15775,15655,15655,15450,15450,15525,-325,-250,48,372.66,312
,20180117,15450,15525,15395,15395,15290,15290,15335,-235,-190,16,122.70,314
,20180118,15290,15335,15355,15355,15280,15350,15335,15,0,38,291.40,330
,20180119,15350,15335,15320,15465,15320,15465,15415,130,80,186,"1,433.94",490
,20180122,15465,15415,15380,15435,15320,15320,15365,-95,-50,10,76.84,488
,20180123,15320,15365,15360,15370,15360,15370,15365,5,0,4,30.73,484
,20180124,15370,15365,15265,15265,15240,15245,15250,-120,-115,8,61.01,480
,20180125,15245,15250,15470,15470,15470,15470,15470,220,220,2,15.47,478
,20180126,15470,15470,15370,15405,15370,15405,15385,-65,-85,8,61.55,478
,20180129,15405,15385,,,,15385,15385,0,0,0,0.00,478
,20180130,15385,15385,15320,15320,15200,15210,15235,-175,-150,162,"1,234.24",418
,20180131,15210,15235,15230,15230,15180,15180,15195,-55,-40,26,197.54,418
,20180201,15180,15195,15145,15145,15145,15145,15145,-50,-50,2,15.15,418
,20180202,15145,15145,,,,15145,15145,0,0,0,0.00,418
,20180205,15145,15145,15095,15095,15010,15010,15030,-135,-115,8,60.14,416
,20180206,15010,15030,15000,15015,14930,14950,14955,-80,-75,40,299.18,448
,20180207,14950,14955,14940,14980,14845,14950,14920,-5,-35,80,596.96,436
,20180208,14950,14920,15025,15025,14865,14920,14895,0,-25,66,491.64,476
,20180209,14920,14895,14895,14895,14850,14850,14870,-45,-25,46,342.08,474
,20180212,14850,14870,14825,15110,14820,15110,14860,240,-10,30,222.92,466
,20180213,15110,14860,14990,15030,14990,15030,15010,170,150,4,30.02,464
,20180214,15030,15010,15250,15250,14850,14850,15030,-160,20,18,135.29,470
,20180222,14850,15030,,,,15030,15030,0,0,0,0.00,470
,20180223,15030,15030,14865,15015,14865,14895,14970,-135,-60,252,"1,886.84",682
,20180226,14895,14970,14945,14945,14945,14945,14945,-25,-25,6,44.84,676
,20180227,14945,14945,14815,14920,14815,14920,14875,-25,-70,40,297.50,678
,20180228,14920,14875,14915,14995,14915,14920,14965,45,90,20,149.68,694
,20180301,14920,14965,15050,15070,15010,15060,15040,95,75,42,315.84,714
,20180302,15060,15040,15065,15065,14990,14990,15025,-50,-15,46,345.66,746
,20180305,14990,15025,14930,14930,14875,14875,14900,-150,-125,148,"1,102.72",760
,20180306,14875,14900,14920,15045,14920,15045,14940,145,40,270,"2,017.30",934
,20180307,15045,14940,15030,15030,14815,14815,14970,-125,30,108,808.53,1036
,20180308,14815,14970,14850,14850,14730,14805,14830,-165,-140,276,"2,046.96",1302
,20180309,14805,14830,14850,14860,14605,14605,14770,-225,-60,70,517.07,1364
,20180312,14605,14770,,,,14770,14770,0,0,0,0.00,1364
,20180313,14770,14770,14615,14615,14435,14460,14500,-310,-270,32,232.05,1392
,20180314,14460,14500,14455,14500,14455,14500,14470,0,-30,188,"1,360.47",1554
,20180315,14500,14470,14485,14540,14455,14465,14485,-5,15,140,"1,014.11",1638
,20180316,14465,14485,14540,14540,14445,14510,14490,25,5,26,188.39,1654
,20180319,14510,14490,14605,14605,14475,14525,14510,35,20,44,319.23,1682
,20180320,14525,14510,14565,14565,14505,14545,14535,35,25,6,43.62,1684
,20180321,14545,14535,14500,14520,14410,14425,14440,-110,-95,28,202.22,1700
,20180322,14425,14440,14470,14535,14440,14535,14485,95,45,78,565.08,1722
,20180323,14535,14485,14485,14485,14295,14350,14330,-135,-155,316,"2,264.65",1804
,20180326,14350,14330,14270,14350,14240,14260,14280,-70,-50,110,785.65,1800
,20180327,14260,14280,14295,14380,14295,14360,14365,80,85,84,603.35,1786
,20180328,14360,14365,14335,14350,14335,14350,14345,-15,-20,42,301.34,1826
,20180329,14350,14345,14295,14890,14250,14335,14325,-10,-20,182,"1,304.01",1828
,20180330,14335,14325,14300,14340,14230,14320,14245,-5,-80,66,470.11,1832
,20180402,14320,14245,14265,14500,14265,14500,14405,255,160,80,576.22,1880
,20180403,14500,14405,14555,14675,14505,14545,14560,140,155,34,247.53,1898
,20180404,14545,14560,14540,14540,14440,14485,14465,-75,-95,76,549.85,1898
,20180409,14485,14465,14595,14610,14545,14610,14595,145,130,112,817.35,1942
,20180410,14610,14595,14680,14820,14680,14780,14770,185,175,1018,"7,519.61",1608
,20180411,14780,14770,14820,14900,14750,14790,14825,20,55,684,"5,071.00",1178
,20180412,14790,14825,14800,14825,14740,14765,14790,-60,-35,66,488.18,1180
,20180413,14765,14790,14780,15070,14780,14990,15005,200,215,140,"1,050.61",1178
,20180416,14990,15005,14975,15045,14915,15045,14975,40,-30,50,374.47,1182
,20180417,15045,14975,15190,15355,15190,15350,15250,375,275,138,"1,052.55",1212
,20180418,15350,15250,15255,15380,15245,15375,15305,125,55,142,"1,086.80",1252
,20180419,15375,15305,15395,15895,15395,15780,15675,475,370,1092,"8,560.02",1692
,20180420,15780,15675,15655,15665,15310,15340,15455,-335,-220,308,"2,380.79",1616
,20180423,15340,15455,15335,15535,15285,15450,15410,-5,-45,162,"1,248.44",1588
,20180424,15450,15410,15200,15200,14715,14900,14895,-510,-515,452,"3,367.01",1548
,20180425,14900,14895,14890,14940,14870,14870,14900,-25,5,162,"1,207.03",1470
,20180426,14870,14900,14865,14910,14840,14855,14865,-45,-35,120,891.93,1452
,20180427,14855,14865,14845,14975,14845,14915,14935,50,70,60,448.14,1454
,20180502,14915,14935,14865,14870,14865,14870,14865,-65,-70,14,104.06,1466
,20180503,14870,14865,14980,15010,14950,15010,14985,145,120,184,"1,378.78",1498
,20180504,15010,14985,15045,15080,14945,15015,15030,30,45,48,360.84,1494
,20180507,15015,15030,15055,15115,15030,15050,15055,20,25,16,120.45,1498
,20180508,15050,15055,15125,15125,15090,15100,15110,45,55,38,287.12,1518
,20180509,15100,15110,15100,15100,14945,14990,15010,-120,-100,356,"2,672.60",1528
,20180510,14990,15010,14980,15050,14965,14990,15010,-20,0,322,"2,416.91",1704
,20180511,14990,15010,15070,15080,15020,15020,15045,10,35,120,902.91,1704
,20180514,15020,15045,14980,15025,14965,14985,14985,-60,-60,60,449.59,1710
,20180515,14985,14985,14995,15060,14990,15010,15005,25,20,276,"2,071.06",1758
,20180516,15010,15005,14975,15085,14950,15080,15025,75,20,112,841.64,1832
,20180517,15080,15025,15035,15195,15035,15160,15160,135,135,302,"2,289.65",1932
,20180518,15160,15160,15185,15195,15065,15105,15135,-55,-25,100,756.90,1950
,20180521,15105,15135,15125,15160,15060,15080,15080,-55,-55,510,"3,846.42",2156
,20180522,15080,15080,15120,15120,14945,14945,15035,-135,-45,466,"3,503.49",2246
,20180523,14945,15035,14955,15005,14925,14935,14960,-100,-75,218,"1,630.91",2250
,20180524,14935,14960,14915,15090,14865,15060,15020,100,60,542,"4,070.88",2436
,20180525,15060,15020,15065,15135,15050,15110,15090,90,70,732,"5,524.32",2858
,20180528,15110,15090,15075,15130,15045,15115,15100,25,10,266,"2,008.58",2884
,20180529,15115,15100,15090,15105,15050,15055,15075,-45,-25,160,"1,206.19",2920
,20180530,15055,15075,15030,15055,14965,15010,15005,-65,-70,148,"1,110.47",2940
,20180531,15010,15005,15040,15040,14935,14945,14970,-60,-35,140,"1,047.95",2920
al1901,20180116,15775,15775,15500,15610,15425,15480,15480,-295,-295,18,139.34,4
,20180117,15480,15480,15375,15390,15365,15365,15375,-115,-105,22,169.14,26
,20180118,15365,15375,15365,15445,15365,15445,15405,70,30,8,61.62,28
,20180119,15445,15405,15330,15495,15330,15495,15440,90,35,22,169.88,44
,20180122,15495,15440,,,,15440,15440,0,0,0,0.00,44
,20180123,15440,15440,15400,15400,15350,15350,15375,-90,-65,4,30.75,44
,20180124,15350,15375,15340,15400,15310,15390,15365,15,-10,16,122.93,52
,20180125,15390,15365,15340,15505,15340,15505,15435,140,70,36,277.87,70
,20180126,15505,15435,15380,15500,15360,15365,15400,-70,-35,56,431.27,82
,20180129,15365,15400,,,,15400,15400,0,0,0,0.00,82
,20180130,15400,15400,15185,15285,15160,15285,15205,-115,-195,44,334.54,114
,20180131,15285,15205,15280,15280,15150,15150,15205,-55,0,50,380.23,124
,20180201,15150,15205,15150,15150,15095,15100,15105,-105,-100,40,302.12,150
,20180202,15100,15105,15140,15140,15140,15140,15140,35,35,2,15.14,152
,20180205,15140,15140,15080,15080,15010,15060,15060,-80,-80,34,256.02,160
,20180206,15060,15060,15055,15055,14935,15040,15030,-20,-30,24,180.39,180
,20180207,15040,15030,14900,15010,14820,14965,14905,-65,-125,26,193.81,184
,20180208,14965,14905,15045,15115,14940,14980,15000,75,95,42,315.06,206
,20180209,14980,15000,14925,14925,14910,14910,14910,-90,-90,12,89.48,204
,20180212,14910,14910,14900,15155,14805,15155,14960,245,50,124,927.58,212
,20180213,15155,14960,15060,15140,15060,15110,15095,150,135,22,166.05,206
,20180214,15110,15095,15030,15040,14780,14780,15000,-315,-95,56,420.00,206
,20180222,14780,15000,,,,14955,14955,-45,-45,0,0.00,206
,20180223,14955,14955,14970,15035,14970,15035,15000,80,45,38,285.03,192
,20180226,15035,15000,15045,15045,15045,15045,15045,45,45,2,15.05,192
,20180227,15045,15045,14950,14975,14945,14975,14955,-70,-90,6,44.87,196
,20180228,14975,14955,14995,14995,14995,14995,14995,40,40,2,15.00,198
,20180301,14995,14995,15050,15175,15050,15070,15130,75,135,90,680.90,260
,20180302,15070,15130,15185,15185,15025,15025,15115,-105,-15,8,60.47,260
,20180305,15025,15115,14950,14995,14915,14915,14945,-200,-170,8,59.80,260
,20180306,14915,14945,15185,15185,15045,15045,15150,100,205,8,60.60,266
,20180307,15045,15150,15095,15140,14900,14900,15040,-250,-110,152,"1,143.16",328
,20180308,14900,15040,14840,14855,14840,14850,14845,-190,-195,34,252.41,348
,20180309,14850,14845,14915,14915,14700,14700,14855,-145,10,42,311.99,390
,20180312,14700,14855,14720,14805,14700,14805,14745,-50,-110,22,162.20,392
,20180313,14805,14745,14725,14725,14440,14490,14575,-255,-170,30,218.69,404
,20180314,14490,14575,,,,14575,14575,0,0,0,0.00,404
,20180315,14575,14575,14545,14580,14545,14580,14560,5,-15,4,29.13,404
,20180316,14580,14560,14580,14620,14570,14615,14595,55,35,12,87.59,406
,20180319,14615,14595,14400,14675,14400,14545,14530,-50,-65,50,363.36,420
,20180320,14545,14530,14635,14635,14610,14610,14620,80,90,4,29.25,420
,20180321,14610,14620,14595,14605,14500,14500,14545,-120,-75,12,87.29,422
,20180322,14500,14545,14575,14575,14550,14550,14560,5,15,4,29.13,420
,20180323,14550,14560,14420,14435,14320,14380,14380,-180,-180,56,402.73,448
,20180326,14380,14380,14365,14400,14260,14350,14335,-30,-45,44,315.39,474
,20180327,14350,14335,14350,14490,14350,14440,14395,105,60,10,71.98,472
,20180328,14440,14395,14485,14485,14405,14405,14455,10,60,6,43.38,472
,20180329,14405,14455,14320,14475,14320,14415,14365,-40,-90,14,100.57,476
,20180330,14415,14365,14335,14335,14270,14300,14275,-65,-90,28,199.91,486
,20180402,14300,14275,14300,14505,14300,14505,14410,230,135,26,187.37,486
,20180403,14505,14410,14630,14650,14505,14580,14590,170,180,36,262.66,490
,20180404,14580,14590,14630,14630,14515,14560,14555,-30,-35,20,145.57,492
,20180409,14560,14555,14680,14680,14615,14650,14635,95,80,26,190.29,496
,20180410,14650,14635,14760,14900,14755,14840,14820,205,185,238,"1,764.15",510
,20180411,14840,14820,14900,14995,14805,14865,14895,45,75,270,"2,011.12",602
,20180412,14865,14895,14860,14875,14765,14855,14825,-40,-70,52,385.49,610
,20180413,14855,14825,14950,15100,14845,15055,15035,230,210,258,"1,939.81",676
,20180416,15055,15035,15035,15085,15035,15085,15055,50,20,44,331.28,684
,20180417,15085,15055,15275,15405,15275,15385,15345,330,290,244,"1,872.48",832
,20180418,15385,15345,15325,15445,15305,15440,15375,95,30,132,"1,014.93",882
,20180419,15440,15375,15510,15940,15510,15800,15755,425,380,540,"4,253.92",1052
,20180420,15800,15755,15755,15755,15390,15440,15545,-315,-210,322,"2,503.26",1038
,20180423,15440,15545,15390,15535,15335,15485,15430,-60,-115,226,"1,743.75",1078
,20180424,15485,15430,14995,15050,14770,14930,14950,-500,-480,538,"4,021.96",874
,20180425,14930,14950,15030,15030,14930,14930,14970,-20,20,68,509.09,838
,20180426,14930,14970,14905,14945,14905,14945,14930,-25,-40,6,44.80,842
,20180427,14945,14930,15075,15075,14985,15030,15015,100,85,24,180.23,826
,20180502,15030,15015,14960,14960,14960,14960,14960,-55,-55,2,14.96,828
,20180503,14960,14960,15045,15095,15035,15090,15065,130,105,48,361.59,814
,20180504,15090,15065,15115,15115,15060,15060,15075,-5,10,40,301.55,830
,20180507,15060,15075,15100,15155,15095,15155,15115,80,40,28,211.64,814
,20180508,15155,15115,15140,15190,15120,15130,15155,15,40,136,"1,030.74",848
,20180509,15130,15155,15010,15100,14970,15080,15055,-75,-100,76,572.14,840
,20180510,15080,15055,15025,15055,15020,15055,15030,0,-25,40,300.66,834
,20180511,15055,15030,15105,15150,15100,15100,15115,70,85,6,45.36,830
,20180514,15100,15115,15025,15065,15025,15035,15035,-80,-80,36,270.66,818
,20180515,15035,15035,15095,15095,15085,15085,15090,50,55,4,30.18,820
,20180516,15085,15090,15040,15150,15010,15135,15070,45,-20,158,"1,190.69",848
,20180517,15135,15070,15185,15240,15185,15240,15215,170,145,16,121.74,848
,20180518,15240,15215,15205,15205,15170,15170,15200,-45,-15,14,106.40,858
,20180521,15170,15200,15140,15170,15130,15145,15150,-55,-50,148,"1,121.31",958
,20180522,15145,15150,15155,15170,15020,15020,15130,-130,-20,232,"1,755.42",934
,20180523,15020,15130,15030,15075,14985,14985,15025,-145,-105,76,571.13,916
,20180524,14985,15025,14970,15135,14945,15110,15015,85,-10,38,285.38,926
,20180525,15110,15015,15140,15210,15135,15145,15160,130,145,42,318.40,944
,20180528,15145,15160,15150,15150,15135,15135,15140,-25,-20,4,30.29,944
,20180529,15135,15140,15175,15175,15105,15130,15140,-10,0,10,75.72,940
,20180530,15130,15140,15100,15100,15065,15070,15085,-70,-55,24,181.07,948
,20180531,15070,15085,15115,15115,14980,14980,15025,-105,-60,20,150.28,948
al1902,20180212,14910,14910,14990,15155,14915,15155,14990,245,80,90,674.77,78
,20180213,15155,14990,15135,15135,15135,15135,15135,145,145,2,15.14,80
,20180214,15135,15135,15085,15085,14900,14900,14925,-235,-210,24,179.15,92
,20180222,14900,14925,14900,14900,14900,14900,14900,-25,-25,16,119.20,108
,20180223,14900,14900,15055,15065,15010,15060,15050,160,150,10,75.26,108
,20180226,15060,15050,15120,15160,14950,15040,15025,-10,-25,98,736.39,118
,20180227,15040,15025,14920,14985,14920,14975,14950,-50,-75,22,164.46,128
,20180228,14975,14950,15000,15090,14990,15055,15030,105,80,126,946.92,228
,20180301,15055,15030,15165,15180,15125,15130,15155,100,125,92,697.18,254
,20180302,15130,15155,15215,15215,15110,15160,15195,5,40,74,562.33,290
,20180305,15160,15195,15150,15150,15020,15020,15050,-175,-145,8,60.21,284
,20180306,15020,15050,15010,15260,15000,15185,15100,135,50,24,181.25,292
,20180307,15185,15100,15225,15225,15100,15100,15130,0,30,40,302.62,326
,20180308,15100,15130,14880,14930,14880,14930,14920,-200,-210,28,208.92,326
,20180309,14930,14920,14970,14970,14770,14770,14890,-150,-30,34,253.18,352
,20180312,14770,14890,14840,14840,14800,14800,14820,-90,-70,4,29.64,354
,20180313,14800,14820,14705,14705,14550,14550,14665,-270,-155,102,747.99,412
,20180314,14550,14665,14645,14655,14645,14655,14650,-10,-15,4,29.30,410
,20180315,14655,14650,14635,14725,14615,14700,14660,50,10,14,102.63,414
,20180316,14700,14660,14635,14695,14635,14695,14665,35,5,4,29.33,414
,20180319,14695,14665,14645,14680,14620,14680,14640,15,-25,28,205.00,404
,20180320,14680,14640,14660,14660,14630,14630,14645,-10,5,4,29.29,402
,20180321,14630,14645,14620,14690,14610,14610,14620,-35,-25,44,321.64,400
,20180322,14610,14620,,,,14620,14620,0,0,0,0.00,400
,20180323,14620,14620,14500,14520,14400,14430,14445,-190,-175,72,520.09,408
,20180326,14430,14445,14330,14425,14330,14425,14350,-20,-95,18,129.19,410
,20180327,14425,14350,14470,14560,14470,14540,14525,190,175,60,435.89,390
,20180328,14540,14525,14465,14470,14465,14470,14465,-55,-60,104,752.19,430
,20180329,14470,14465,14385,14410,14385,14410,14405,-55,-60,10,72.03,430
,20180330,14410,14405,14405,14475,14325,14475,14390,70,-15,12,86.35,434
,20180402,14475,14390,14525,14600,14525,14600,14575,210,185,22,160.35,426
,20180403,14600,14575,14695,14720,14685,14685,14705,110,130,10,73.54,430
,20180404,14685,14705,14590,14590,14590,14590,14590,-115,-115,2,14.59,432
,20180409,14590,14590,14645,14780,14645,14720,14695,130,105,120,881.71,448
,20180410,14720,14695,14820,14945,14810,14925,14895,230,200,138,"1,027.88",448
,20180411,14925,14895,14965,15020,14895,14895,14980,0,85,60,449.47,448
,20180412,14895,14980,14940,14955,14880,14905,14910,-75,-70,38,283.31,460
,20180413,14905,14910,14860,15160,14860,15105,15110,195,200,252,"1,904.00",624
,20180416,15105,15110,15140,15140,15140,15140,15140,30,30,44,333.08,666
,20180417,15140,15140,15285,15495,15285,15460,15415,320,275,178,"1,372.02",692
,20180418,15460,15415,15450,15500,15410,15500,15460,85,45,70,541.24,750
,20180419,15500,15460,15800,16000,15690,15915,15855,455,395,172,"1,363.88",848
,20180420,15915,15855,15755,15770,15470,15470,15630,-385,-225,110,859.89,822
,20180423,15470,15630,15485,15585,15390,15585,15505,-45,-125,54,418.73,818
,20180424,15585,15505,15035,15050,14845,15010,14960,-495,-545,98,733.13,810
,20180425,15010,14960,15020,15020,15005,15005,15015,45,55,18,135.15,802
,20180426,15005,15015,15045,15060,15000,15025,15015,10,0,28,210.24,802
,20180427,15025,15015,14995,15095,14995,15060,15055,45,40,32,240.95,784
,20180502,15060,15055,15115,15115,15005,15030,15060,-25,5,20,150.63,794
,20180503,15030,15060,15055,15130,15055,15110,15105,50,45,48,362.59,786
,20180504,15110,15105,15130,15190,15035,15140,15135,35,30,22,166.53,786
,20180507,15140,15135,15150,15285,15130,15285,15200,150,65,66,501.65,812
,20180508,15285,15200,15235,15235,15200,15210,15215,10,15,6,45.65,812
,20180509,15210,15215,15190,15200,15090,15130,15135,-85,-80,50,378.48,814
,20180510,15130,15135,15135,15135,15080,15110,15105,-25,-30,32,241.76,810
,20180511,15110,15105,15200,15200,15125,15125,15160,20,55,16,121.32,812
,20180514,15125,15160,,,,15160,15160,0,0,0,0.00,812
,20180515,15160,15160,15110,15195,15110,15155,15145,-5,-15,10,75.74,810
,20180516,15155,15145,15085,15200,15075,15185,15140,40,-5,74,560.31,864
,20180517,15185,15140,15245,15250,15220,15250,15240,110,100,14,106.71,870
,20180518,15250,15240,15190,15240,15190,15240,15225,0,-15,8,60.90,868
,20180521,15240,15225,15245,15400,15165,15190,15285,-35,60,64,489.21,840
,20180522,15190,15285,15235,15245,15110,15110,15225,-175,-60,382,"2,908.12",1164
,20180523,15110,15225,15105,15155,15060,15060,15095,-165,-130,144,"1,086.92",1178
,20180524,15060,15095,15000,15200,15000,15135,15150,40,55,116,878.94,1166
,20180525,15135,15150,15160,15250,15155,15210,15200,60,50,80,608.03,1190
,20180528,15210,15200,15165,15215,15165,15185,15190,-15,-10,30,227.90,1194
,20180529,15185,15190,15215,15225,15150,15180,15185,-10,-5,70,531.54,1236
,20180530,15180,15185,15170,15170,15135,15135,15145,-50,-40,6,45.44,1240
,20180531,15135,15145,15100,15115,15080,15105,15100,-40,-45,54,407.71,1238
al1903,20180316,14660,14660,,,,14660,14660,0,0,0,0.00,0
,20180319,14660,14660,14685,14720,14670,14720,14690,60,30,8,58.76,8
,20180320,14720,14690,14715,14725,14710,14710,14720,20,30,24,176.68,28
,20180321,14710,14720,14650,14650,14630,14630,14640,-90,-80,4,29.28,28
,20180322,14630,14640,14660,14660,14635,14635,14645,-5,5,4,29.30,30
,20180323,14635,14645,,,,14645,14645,0,0,0,0.00,30
,20180326,14645,14645,,,,14645,14645,0,0,0,0.00,30
,20180327,14645,14645,14645,14655,14490,14585,14615,-60,-30,236,"1,725.13",160
,20180328,14585,14615,,,,14540,14540,-75,-75,0,0.00,160
,20180329,14540,14540,14415,14505,14415,14485,14450,-55,-90,14,101.16,162
,20180330,14485,14450,14400,14400,14400,14400,14400,-50,-50,2,14.40,164
,20180402,14400,14400,14555,14595,14555,14595,14575,195,175,4,29.15,164
,20180403,14595,14575,14740,14740,14740,14740,14740,165,165,2,14.74,162
,20180404,14740,14740,14655,14655,14530,14605,14570,-135,-170,28,204.01,170
,20180409,14605,14570,15025,15025,14700,14700,14820,130,250,12,88.94,176
,20180410,14700,14820,14890,15020,14890,14970,14950,150,130,30,224.26,176
,20180411,14970,14950,15055,15055,14955,14955,14975,5,25,26,194.72,192
,20180412,14955,14975,14980,15025,14940,15025,14970,50,-5,24,179.67,204
,20180413,15025,14970,14905,15285,14905,15150,15120,180,150,34,257.12,208
,20180416,15150,15120,15215,15215,15215,15215,15215,95,95,60,456.45,236
,20180417,15215,15215,15450,15475,15390,15475,15445,260,230,14,108.12,234
,20180418,15475,15445,15620,15620,15390,15550,15500,105,55,66,511.66,262
,20180419,15550,15500,15785,16055,15745,15915,15860,415,360,246,"1,950.82",292
,20180420,15915,15860,15865,15865,15440,15510,15590,-350,-270,94,732.93,306
,20180423,15510,15590,15525,15630,15415,15580,15555,-10,-35,336,"2,613.72",504
,20180424,15580,15555,14815,15115,14815,15060,15020,-495,-535,74,555.90,512
,20180425,15060,15020,15100,15145,15055,15060,15080,40,60,34,256.42,508
,20180426,15060,15080,15100,15100,15040,15040,15070,-40,-10,8,60.30,510
,20180427,15040,15070,15075,15185,15075,15135,15130,65,60,26,196.73,510
,20180502,15135,15130,15085,15085,15085,15085,15085,-45,-45,2,15.09,512
,20180503,15085,15085,15160,15215,15160,15215,15180,130,95,24,182.20,508
,20180504,15215,15180,15245,15285,15210,15210,15245,30,65,12,91.48,516
,20180507,15210,15245,15270,15325,15270,15325,15300,80,55,48,367.25,520
,20180508,15325,15300,15320,15325,15320,15325,15320,25,20,6,45.97,522
,20180509,15325,15320,15200,15200,15200,15200,15200,-120,-120,8,60.80,520
,20180510,15200,15200,,,,15200,15200,0,0,0,0.00,520
,20180511,15200,15200,15285,15285,15215,15215,15235,15,35,6,45.72,518
,20180514,15215,15235,15160,15160,15115,15115,15150,-120,-85,14,106.07,526
,20180515,15115,15150,15200,15200,15200,15200,15200,50,50,4,30.40,522
,20180516,15200,15200,15155,15260,15150,15260,15225,60,25,18,137.05,524
,20180517,15260,15225,15230,15330,15190,15330,15220,105,-5,12,91.32,534
,20180518,15330,15220,15265,15280,15250,15270,15270,50,50,26,198.51,516
,20180521,15270,15270,15285,15285,15160,15235,15225,-35,-45,10,76.14,516
,20180522,15235,15225,15235,15235,15180,15190,15200,-35,-25,10,76.01,512
,20180523,15190,15200,15135,15135,15135,15135,15135,-65,-65,4,30.27,508
,20180524,15135,15135,15080,15235,15080,15235,15175,100,40,6,45.54,508
,20180525,15235,15175,15220,15285,15220,15250,15235,75,60,16,121.92,518
,20180528,15250,15235,15245,15295,15245,15255,15265,20,30,18,137.42,512
,20180529,15255,15265,15265,15265,15265,15265,15265,0,0,2,15.27,510
,20180530,15265,15265,15185,15185,15185,15185,15185,-80,-80,2,15.19,508
,20180531,15185,15185,15160,15160,15160,15160,15160,-25,-25,4,30.32,508
al1904,20180417,15215,15215,15625,15625,15475,15550,15535,335,320,8,62.15,6
,20180418,15550,15535,15600,15600,15600,15600,15600,65,65,4,31.20,10
,20180419,15600,15600,15850,16060,15800,15965,15945,365,345,144,"1,148.18",84
,20180420,15965,15945,15835,15930,15550,15640,15750,-305,-195,136,"1,071.28",78
,20180423,15640,15750,15545,15680,15505,15620,15630,-130,-120,56,437.67,96
,20180424,15620,15630,14880,15215,14880,15140,15150,-490,-480,78,591.02,154
,20180425,15140,15150,15165,15170,15110,15110,15155,-40,5,26,197.03,148
,20180426,15110,15155,15115,15145,15115,15140,15130,-15,-25,6,45.40,148
,20180427,15140,15130,14955,15225,14955,15180,15125,50,-5,78,589.95,164
,20180502,15180,15125,15160,15195,15090,15160,15150,35,25,10,75.77,164
,20180503,15160,15150,15215,15280,15215,15240,15245,90,95,6,45.74,164
,20180504,15240,15245,15275,15350,15275,15275,15300,30,55,8,61.20,164
,20180507,15275,15300,15315,15400,15315,15400,15340,100,40,24,184.11,164
,20180508,15400,15340,15370,15400,15370,15375,15380,35,40,6,46.15,162
,20180509,15375,15380,15345,15345,15275,15295,15310,-85,-70,18,137.81,158
,20180510,15295,15310,15220,15280,15220,15225,15250,-85,-60,8,61.00,150
,20180511,15225,15250,15320,15320,15300,15300,15315,50,65,8,61.26,152
,20180514,15300,15315,15240,15260,15240,15260,15250,-55,-65,14,106.78,162
,20180515,15260,15250,15285,15290,15270,15290,15275,40,25,18,137.49,162
,20180516,15290,15275,15215,15320,15215,15315,15230,40,-45,40,304.62,176
,20180517,15315,15230,15275,15380,15275,15380,15325,150,95,10,76.64,176
,20180518,15380,15325,15320,15370,15320,15330,15335,5,10,10,76.69,178
,20180521,15330,15335,15325,15325,15305,15310,15310,-25,-25,20,153.11,164
,20180522,15310,15310,15235,15240,15235,15240,15235,-70,-75,4,30.48,160
,20180523,15240,15235,15230,15230,15165,15165,15185,-70,-50,10,75.94,154
,20180524,15165,15185,15080,15305,15080,15305,15190,120,5,4,30.39,156
,20180525,15305,15190,15350,15350,15290,15290,15320,100,130,4,30.64,158
,20180528,15290,15320,15325,15325,15305,15305,15310,-15,-10,6,45.94,158
,20180529,15305,15310,15265,15305,15265,15305,15285,-5,-25,4,30.57,158
,20180530,15305,15285,15260,15260,15260,15260,15260,-25,-25,2,15.26,158
,20180531,15260,15260,15195,15195,15180,15180,15185,-80,-75,4,30.38,156
al1905,20180516,15275,15275,15775,15775,15240,15240,15505,-35,230,4,31.02,0
,20180517,15240,15505,,,,15505,15505,0,0,0,0.00,0
,20180518,15505,15505,15370,15370,15360,15360,15365,-145,-140,4,30.73,4
,20180521,15360,15365,,,,15365,15365,0,0,0,0.00,4
,20180522,15365,15365,,,,15365,15365,0,0,0,0.00,4
,20180523,15365,15365,,,,15365,15365,0,0,0,0.00,4
,20180524,15365,15365,,,,15365,15365,0,0,0,0.00,4
,20180525,15365,15365,15350,15430,15350,15430,15390,65,25,200,"1,539.00",92
,20180528,15430,15390,15365,15365,15365,15365,15365,-25,-25,2,15.37,92
,20180529,15365,15365,15305,15330,15305,15325,15310,-40,-55,54,413.41,88
,20180530,15325,15310,15325,15345,15280,15285,15325,-25,15,42,321.93,114
,20180531,15285,15325,15285,15285,15270,15270,15275,-55,-50,4,30.56,114
au1801,20180102,271.75,272.35,,,,272.35,272.35,0,0,0,0.00,84
,20180103,272.35,272.35,,,,272.35,272.35,0,0,0,0.00,84
,20180104,272.35,272.35,,,,272.35,272.35,0,0,0,0.00,84
,20180105,272.35,272.35,,,,272.35,272.35,0,0,0,0.00,84
,20180108,272.35,272.35,,,,273,273,.65,.65,0,0.00,84
,20180109,273,273,,,,273,273,0,0,0,0.00,84
,20180110,273,273,,,,273,273,0,0,0,0.00,84
,20180111,273,273,,,,273,273,0,0,0,0.00,84
,20180112,273,273,,,,273,273,0,0,0,0.00,84
,20180115,273,273,,,,273,273,0,0,0,0.00,84
au1802,20180102,274,273.25,275.15,275.25,274.85,275.25,275.05,2,1.8,8,220.06,270
,20180103,275.25,275.05,276.85,277.25,275.7,276.35,276.4,1.3,1.35,28,773.98,268
,20180104,276.35,276.4,275.55,277.7,274.3,275.35,275.9,-1.05,-.5,76,"2,097.09",286
,20180105,275.35,275.9,274.7,276.3,274.7,276.3,275.3,.4,-.6,18,495.55,292
,20180108,276.3,275.3,275.85,276.6,275.85,276.25,276.25,.95,.95,20,552.56,300
,20180109,276.25,276.25,276.4,277,276.4,277,276.8,.75,.55,10,276.84,302
,20180110,277,276.8,277.15,277.15,276.2,276.35,276.6,-.45,-.2,38,"1,051.10",296
,20180111,276.35,276.6,277.3,278.05,277.3,277.5,277.5,.9,.9,16,444.03,292
,20180112,277.5,277.5,279.05,279.05,276.4,278.15,277.85,.65,.35,18,500.16,288
,20180115,278.15,277.85,279,279,279,279,279,1.15,1.15,2,55.80,286
,20180116,279,279,278.65,278.75,278.6,278.75,278.65,-.25,-.35,6,167.20,284
,20180117,278.75,278.65,278.55,278.55,277.45,277.45,277.8,-1.2,-.85,6,166.69,286
,20180118,277.45,277.8,277,277.5,275.25,276.6,276.45,-1.2,-1.35,14,387.04,284
,20180119,276.6,276.45,,,,276.45,276.45,0,0,0,0.00,284
,20180122,276.45,276.45,276.45,276.45,276.45,276.45,276.45,0,0,2,55.29,282
,20180123,276.45,276.45,275.75,276.65,275.75,276.55,276.3,.1,-.15,6,165.79,280
,20180124,276.55,276.3,276.45,277.3,275.65,277.3,276.45,1,.15,22,608.26,272
,20180125,277.3,276.45,278.1,278.15,278.1,278.15,278.1,1.7,1.65,16,444.98,256
,20180126,278.15,278.1,276.9,278.55,276.2,276.2,277.05,-1.9,-1.05,10,277.09,260
,20180129,276.2,277.05,276.2,276.2,275.45,275.45,275.7,-1.6,-1.35,6,165.42,254
,20180130,275.45,275.7,272.7,277.05,272.7,274.7,275.15,-1,-.55,12,330.23,248
,20180131,274.7,275.15,274.1,274.1,265.9,272.6,269.7,-2.55,-5.45,26,701.34,246
,20180201,272.6,269.7,273.1,273.1,273.1,273.1,273.1,3.4,3.4,6,163.86,246
,20180202,273.1,273.1,273.3,273.3,273.3,273.3,273.3,.2,.2,6,163.98,252
,20180205,273.3,273.3,,,,273.3,273.3,0,0,0,0.00,252
,20180206,273.3,273.3,264.85,273.2,264.85,270.05,271.25,-3.25,-2.05,36,976.56,246
,20180207,270.05,271.25,,,,271.25,271.25,0,0,0,0.00,246
,20180208,271.25,271.25,,,,271.25,271.25,0,0,0,0.00,246
,20180209,271.25,271.25,,,,271.25,271.25,0,0,0,0.00,246
au1803,20180102,272.35,272.35,,,,273.35,273.35,1,1,0,0.00,0
,20180103,273.35,273.35,,,,273.35,273.35,0,0,0,0.00,0
,20180104,273.35,273.35,,,,273.35,273.35,0,0,0,0.00,0
,20180105,273.35,273.35,,,,273.35,273.35,0,0,0,0.00,0
,20180108,273.35,273.35,,,,273.35,273.35,0,0,0,0.00,0
,20180109,273.35,273.35,,,,273.35,273.35,0,0,0,0.00,0
,20180110,273.35,273.35,277.05,277.05,277.05,277.05,277.05,3.7,3.7,2,55.41,2
,20180111,277.05,277.05,,,,277.05,277.05,0,0,0,0.00,2
,20180112,277.05,277.05,,,,277.05,277.05,0,0,0,0.00,2
,20180115,277.05,277.05,279.1,279.1,279.1,279.1,279.1,2.05,2.05,2,55.82,4
,20180116,279.1,279.1,278.9,278.9,278.9,278.9,278.9,-.2,-.2,2,55.78,4
,20180117,278.9,278.9,,,,278.9,278.9,0,0,0,0.00,4
,20180118,278.9,278.9,,,,278.9,278.9,0,0,0,0.00,4
,20180119,278.9,278.9,,,,278.9,278.9,0,0,0,0.00,4
,20180122,278.9,278.9,,,,278.9,278.9,0,0,0,0.00,4
,20180123,278.9,278.9,,,,278.9,278.9,0,0,0,0.00,4
,20180124,278.9,278.9,,,,278.9,278.9,0,0,0,0.00,4
,20180125,278.9,278.9,,,,278.9,278.9,0,0,0,0.00,4
,20180126,278.9,278.9,276.8,277.25,276.8,277.25,277,-1.65,-1.9,4,110.81,4
,20180129,277.25,277,,,,277,277,0,0,0,0.00,4
,20180130,277,277,275,275,275,275,275,-2,-2,2,55.00,6
,20180131,275,275,,,,275,275,0,0,0,0.00,6
,20180201,275,275,,,,275,275,0,0,0,0.00,6
,20180202,275,275,,,,274.2,274.2,-.8,-.8,0,0.00,6
,20180205,274.2,274.2,,,,274.2,274.2,0,0,0,0.00,6
,20180206,274.2,274.2,,,,274.2,274.2,0,0,0,0.00,6
,20180207,274.2,274.2,,,,272.15,272.15,-2.05,-2.05,0,0.00,6
,20180208,272.15,272.15,269.6,269.6,269.6,269.6,269.6,-2.55,-2.55,2,53.92,8
,20180209,269.6,269.6,,,,269.6,269.6,0,0,0,0.00,8
,20180212,269.6,269.6,273.4,273.4,273.4,273.4,273.4,3.8,3.8,4,109.36,12
,20180213,273.4,273.4,,,,273,273,-.4,-.4,0,0.00,12
,20180214,273,273,272.05,272.05,272.05,272.05,272.05,-.95,-.95,4,108.82,8
,20180222,272.05,272.05,,,,272.05,272.05,0,0,0,0.00,8
,20180223,272.05,272.05,271.35,274.25,271.35,274.25,272.3,2.2,.25,6,163.39,8
,20180226,274.25,272.3,271.1,273.6,271.1,273.6,271.9,1.3,-.4,6,163.16,6
,20180227,273.6,271.9,272.95,272.95,272.95,272.95,272.95,1.05,1.05,2,54.59,4
,20180228,272.95,272.95,270.6,270.6,269.25,269.25,269.9,-3.7,-3.05,4,107.97,0
,20180301,269.25,269.9,,,,269.9,269.9,0,0,0,0.00,0
,20180302,269.9,269.9,,,,269.9,269.9,0,0,0,0.00,0
,20180305,269.9,269.9,,,,269.9,269.9,0,0,0,0.00,0
,20180306,269.9,269.9,,,,269.9,269.9,0,0,0,0.00,0
,20180307,269.9,269.9,,,,269.9,269.9,0,0,0,0.00,0
,20180308,269.9,269.9,,,,269.9,269.9,0,0,0,0.00,0
,20180309,269.9,269.9,,,,269.9,269.9,0,0,0,0.00,0
,20180312,269.9,269.9,,,,269.9,269.9,0,0,0,0.00,0
,20180313,269.9,269.9,,,,269.9,269.9,0,0,0,0.00,0
,20180314,269.9,269.9,,,,269.9,269.9,0,0,0,0.00,0
,20180315,269.9,269.9,,,,269.9,269.9,0,0,0,0.00,0
au1804,20180102,275.85,275.85,276.6,276.6,276.6,276.6,276.6,.75,.75,2,55.32,258
,20180103,276.6,276.6,277.5,277.5,277.5,277.5,277.5,.9,.9,2,55.50,258
,20180104,277.5,277.5,,,,277.5,277.5,0,0,0,0.00,258
,20180105,277.5,277.5,277.05,277.05,277.05,277.05,277.05,-.45,-.45,6,166.23,258
,20180108,277.05,277.05,,,,277.05,277.05,0,0,0,0.00,258
,20180109,277.05,277.05,,,,277.05,277.05,0,0,0,0.00,258
,20180110,277.05,277.05,277.75,277.85,277.75,277.85,277.8,.8,.75,4,111.12,258
,20180111,277.85,277.8,278.3,278.6,278.1,278.1,278.3,.3,.5,6,167.00,258
,20180112,278.1,278.3,278.1,278.55,278.1,278.25,278.35,-.05,.05,14,389.70,258
,20180115,278.25,278.35,278.85,280,278.05,278.35,279.3,0,.95,124,"3,463.32",300
,20180116,278.35,279.3,276.5,279.95,276.5,279.6,278.35,.3,-.95,108,"3,006.43",264
,20180117,279.6,278.35,,,,278.35,278.35,0,0,0,0.00,264
,20180118,278.35,278.35,278.5,278.55,278.5,278.55,278.5,.2,.15,4,111.41,266
,20180119,278.55,278.5,276.4,276.45,276.2,276.4,276.3,-2.1,-2.2,30,828.92,268
,20180122,276.4,276.3,,,,276.3,276.3,0,0,0,0.00,268
,20180123,276.3,276.3,,,,276.3,276.3,0,0,0,0.00,268
,20180124,276.3,276.3,278.25,278.3,278.25,278.3,278.25,2,1.95,8,222.62,268
,20180125,278.3,278.25,279.45,279.9,279.45,279.9,279.6,1.65,1.35,6,167.76,264
,20180126,279.9,279.6,,,,279.6,279.6,0,0,0,0.00,264
,20180129,279.6,279.6,276.65,276.65,276.65,276.65,276.65,-2.95,-2.95,2,55.33,262
,20180130,276.65,276.65,275.3,275.3,275.3,275.3,275.3,-1.35,-1.35,4,110.12,262
,20180131,275.3,275.3,,,,275.3,275.3,0,0,0,0.00,262
,20180201,275.3,275.3,274.7,274.7,273.75,274.1,274.15,-1.2,-1.15,6,164.51,260
,20180202,274.1,274.15,,,,274.15,274.15,0,0,0,0.00,260
,20180205,274.15,274.15,,,,274.15,274.15,0,0,0,0.00,260
,20180206,274.15,274.15,,,,274.15,274.15,0,0,0,0.00,260
,20180207,274.15,274.15,270,270,270,270,270,-4.15,-4.15,2,54.00,260
,20180208,270,270,,,,270,270,0,0,0,0.00,260
,20180209,270,270,,,,270,270,0,0,0,0.00,260
,20180212,270,270,,,,270,270,0,0,0,0.00,260
,20180213,270,270,271.95,271.95,271.9,271.9,271.9,1.9,1.9,4,108.77,260
,20180214,271.9,271.9,272.25,272.45,272.1,272.1,272.25,.2,.35,6,163.36,260
,20180222,272.1,272.25,272.55,272.6,272.55,272.6,272.55,.35,.3,4,109.03,260
,20180223,272.6,272.55,273.2,273.35,272.95,272.95,273.2,.4,.65,8,218.56,264
,20180226,272.95,273.2,273.2,274.15,273.2,274.15,273.65,.95,.45,4,109.47,264
,20180227,274.15,273.65,272.9,272.9,272.85,272.85,272.85,-.8,-.8,4,109.15,260
,20180228,272.85,272.85,270.35,270.35,270.35,270.35,270.35,-2.5,-2.5,8,216.28,258
,20180301,270.35,270.35,270.8,270.85,270.4,270.4,270.55,.05,.2,36,974.15,282
,20180302,270.4,270.55,270.05,270.5,270.05,270.5,270.25,-.05,-.3,4,108.11,284
,20180305,270.5,270.25,272.55,272.55,271.65,272.15,272,1.9,1.75,22,598.44,270
,20180306,272.15,272,272.05,272.25,271.65,271.65,272.05,-.35,.05,8,217.64,274
,20180307,271.65,272.05,273.65,273.9,273.3,273.9,273.6,1.85,1.55,14,383.04,266
,20180308,273.9,273.6,,,,273.6,273.6,0,0,0,0.00,266
,20180309,273.6,273.6,272.9,273,272.25,272.25,272.7,-1.35,-.9,6,163.63,264
,20180312,272.25,272.7,,,,272.7,272.7,0,0,0,0.00,264
,20180313,272.7,272.7,,,,272.7,272.7,0,0,0,0.00,264
,20180314,272.7,272.7,271.75,272,271.1,271.45,271.6,-1.25,-1.1,10,271.62,260
,20180315,271.45,271.6,,,,271.6,271.6,0,0,0,0.00,260
,20180316,271.6,271.6,270.3,270.35,269.45,270.35,270.2,-1.25,-1.4,16,432.32,262
,20180319,270.35,270.2,270.45,271.25,268.6,268.6,270.45,-1.6,.25,122,"3,299.87",264
,20180320,268.6,270.45,268.95,270.5,268.95,270.4,270.2,-.05,-.25,30,810.62,236
,20180321,270.4,270.2,270.75,270.75,268.9,268.9,269.55,-1.3,-.65,8,215.65,234
,20180322,268.9,269.55,270.75,272.4,269.45,271,271.05,1.45,1.5,40,"1,084.24",232
,20180323,271,271.05,272.7,273,272.7,273,272.8,1.95,1.75,6,163.68,232
,20180326,273,272.8,274.3,274.3,274.3,274.3,274.3,1.5,1.5,8,219.44,232
,20180327,274.3,274.3,273.15,274.3,273,273.65,273.5,-.65,-.8,18,492.38,234
,20180328,273.65,273.5,272.5,272.5,272.05,272.45,272.4,-1.05,-1.1,18,490.40,226
,20180329,272.45,272.4,272.85,272.85,268.3,269.8,269.75,-2.6,-2.65,68,"1,834.46",244
,20180330,269.8,269.75,269.95,270,268.8,269,269.25,-.75,-.5,38,"1,023.31",228
,20180402,269,269.25,,,,269.25,269.25,0,0,0,0.00,228
,20180403,269.25,269.25,,,,271.3,271.3,2.05,2.05,0,0.00,228
,20180404,271.3,271.3,269.6,269.6,269.6,269.6,269.6,-1.7,-1.7,18,485.28,228
,20180409,269.6,269.6,,,,269.7,269.7,.1,.1,0,0.00,228
,20180410,269.7,269.7,,,,269.7,269.7,0,0,0,0.00,228
,20180411,269.7,269.7,272.8,272.8,272.8,272.8,272.8,3.1,3.1,6,163.68,222
,20180412,272.8,272.8,,,,272.8,272.8,0,0,0,0.00,222
,20180413,272.8,272.8,,,,272.8,272.8,0,0,0,0.00,222
,20180416,272.8,272.8,,,,272.8,272.8,0,0,0,0.00,222
au1805,20180212,270,270,272,272.2,272,272.2,272.1,2.2,2.1,4,108.84,0
,20180213,272.2,272.1,,,,272.1,272.1,0,0,0,0.00,0
,20180214,272.1,272.1,276.25,276.25,276.25,276.25,276.25,4.15,4.15,2,55.25,2
,20180222,276.25,276.25,272.65,272.65,272.65,272.65,272.65,-3.6,-3.6,2,54.53,0
,20180223,272.65,272.65,,,,272.65,272.65,0,0,0,0.00,0
,20180226,272.65,272.65,,,,272.65,272.65,0,0,0,0.00,0
,20180227,272.65,272.65,274.8,274.8,273.7,273.7,274.25,1.05,1.6,4,109.70,0
,20180228,273.7,274.25,273.75,273.75,271.25,271.25,272.5,-3,-1.75,4,109.00,2
,20180301,271.25,272.5,272.3,272.3,270.45,271,271.15,-1.5,-1.35,16,433.88,2
,20180302,271,271.15,270.9,271.9,269.65,271.9,270.6,.75,-.55,22,595.39,2
,20180305,271.9,270.6,271.9,273.5,271.9,273.45,273.3,2.85,2.7,72,"1,967.81",62
,20180306,273.45,273.3,272.2,272.85,272.15,272.75,272.45,-.55,-.85,108,"2,942.63",4
,20180307,272.75,272.45,,,,272.45,272.45,0,0,0,0.00,4
,20180308,272.45,272.45,,,,272.45,272.45,0,0,0,0.00,4
,20180309,272.45,272.45,273.25,274.6,273.05,273.05,273.7,.6,1.25,104,"2,846.60",2
,20180312,273.05,273.7,271.75,272.15,271.2,271.75,271.55,-1.95,-2.15,16,434.48,8
,20180313,271.75,271.55,271.8,271.85,270.95,271.25,271.4,-.3,-.15,16,434.25,4
,20180314,271.25,271.4,273.1,273.1,273.1,273.1,273.1,1.7,1.7,2,54.62,6
,20180315,273.1,273.1,,,,273.1,273.1,0,0,0,0.00,6
,20180316,273.1,273.1,270.3,270.3,270.3,270.3,270.3,-2.8,-2.8,2,54.06,4
,20180319,270.3,270.3,271.25,271.25,269,269.55,270.25,-.75,-.05,40,"1,081.11",14
,20180320,269.55,270.25,269.55,270.8,269.45,270.8,270.2,.55,-.05,16,432.38,14
,20180321,270.8,270.2,,,,270.2,270.2,0,0,0,0.00,14
,20180322,270.2,270.2,271.3,273,271.05,273,271.6,2.8,1.4,10,271.61,10
,20180323,273,271.6,273.85,276.05,273.3,275.7,275.15,4.1,3.55,124,"3,412.00",22
,20180326,275.7,275.15,274.4,276.9,274.4,275.5,275.95,.35,.8,46,"1,269.59",14
,20180327,275.5,275.95,,,,275.95,275.95,0,0,0,0.00,14
,20180328,275.95,275.95,273.8,274.7,273.8,274.1,274.2,-1.85,-1.75,6,164.52,14
,20180329,274.1,274.2,,,,273.3,273.3,-.9,-.9,0,0.00,14
,20180330,273.3,273.3,269.95,270.8,269.8,270.5,270.4,-2.8,-2.9,12,324.53,8
,20180402,270.5,270.4,271.1,273.45,270.8,270.8,271.45,.4,1.05,14,380.07,8
,20180403,270.8,271.45,271.5,274.55,271.5,273.95,272.85,2.5,1.4,16,436.59,8
,20180404,273.95,272.85,274.05,274.05,270.6,272.5,272.25,-.35,-.6,34,925.66,12
,20180409,272.5,272.25,272.4,272.4,272.4,272.4,272.4,.15,.15,2,54.48,12
,20180410,272.4,272.4,273.3,273.3,272.65,272.65,272.95,.25,.55,4,109.19,12
,20180411,272.65,272.95,,,,272.95,272.95,0,0,0,0.00,12
,20180412,272.95,272.95,274.95,276,273.9,273.9,274.75,.95,1.8,14,384.71,6
,20180413,273.9,274.75,273.8,273.8,272.65,272.65,273.2,-2.1,-1.55,14,382.53,6
,20180416,272.65,273.2,,,,273.2,273.2,0,0,0,0.00,6
,20180417,273.2,273.2,273.7,273.7,273.7,273.7,273.7,.5,.5,2,54.74,6
,20180418,273.7,273.7,,,,273.7,273.7,0,0,0,0.00,6
,20180419,273.7,273.7,,,,273.7,273.7,0,0,0,0.00,6
,20180420,273.7,273.7,272.4,275,272.4,273.5,273.65,-.2,-.05,10,273.68,2
,20180423,273.5,273.65,,,,273.65,273.65,0,0,0,0.00,2
,20180424,273.65,273.65,,,,273.65,273.65,0,0,0,0.00,2
,20180425,273.65,273.65,,,,273.65,273.65,0,0,0,0.00,2
,20180426,273.65,273.65,266.45,272.75,265.2,269.6,267.5,-4.05,-6.15,42,"1,123.57",14
,20180427,269.6,267.5,267.5,267.5,267.5,267.5,267.5,0,0,2,53.50,12
,20180502,267.5,267.5,,,,267.5,267.5,0,0,0,0.00,12
,20180503,267.5,267.5,270.85,270.85,270.5,270.5,270.65,3,3.15,12,324.81,6
,20180504,270.5,270.65,,,,270.65,270.65,0,0,0,0.00,6
,20180507,270.65,270.65,,,,270.65,270.65,0,0,0,0.00,6
,20180508,270.65,270.65,270,270,270,270,270,-.65,-.65,6,162.00,0
,20180509,270,270,,,,270,270,0,0,0,0.00,0
,20180510,270,270,,,,270,270,0,0,0,0.00,0
,20180511,270,270,,,,270,270,0,0,0,0.00,0
,20180514,270,270,,,,270,270,0,0,0,0.00,0
,20180515,270,270,,,,270,270,0,0,0,0.00,0
au1806,20180102,277.8,277.9,279.55,279.9,278.95,279.4,279.2,1.5,1.3,54760,"1,529,105.87",255972
,20180103,279.4,279.2,279.8,281.45,279.45,280.35,280.4,1.15,1.2,120498,"3,379,331.40",269758
,20180104,280.35,280.4,280.25,280.5,278.35,279,279.3,-1.4,-1.1,115606,"3,229,031.02",268078
,20180105,279,279.3,279.3,280.5,278.4,279.85,279.7,.55,.4,131968,"3,691,152.04",271418
,20180108,279.85,279.7,279.55,280.8,279.05,280.2,279.95,.5,.25,122670,"3,434,356.25",265332
,20180109,280.2,279.95,280.35,281,280,280.55,280.5,.6,.55,97146,"2,725,383.24",269750
,20180110,280.55,280.5,280.6,280.85,279.75,279.95,280.15,-.55,-.35,100630,"2,819,623.59",275136
,20180111,279.95,280.15,281.7,281.85,280.5,280.85,281.1,.7,.95,107986,"3,035,916.50",277640
,20180112,280.85,281.1,280.95,281.8,280.55,281.55,281.15,.45,.05,107150,"3,013,036.79",281512
,20180115,281.55,281.15,281.7,282.6,280.05,282.05,281.75,.9,.6,154100,"4,342,302.75",281200
,20180116,282.05,281.75,282.25,282.35,281.5,281.65,281.9,-.1,.15,73686,"2,077,222.23",278914
,20180117,281.65,281.9,281.05,281.9,280.55,280.8,281.1,-1.1,-.8,120036,"3,374,587.39",277878
,20180118,280.8,281.1,280.95,281,278.65,279.25,279.65,-1.85,-1.45,120704,"3,375,661.71",275960
,20180119,279.25,279.65,278.8,279.4,277.9,278.35,278.65,-1.3,-1,123998,"3,455,389.51",275066
,20180122,278.35,278.65,278.9,279.15,278.45,278.5,278.85,-.15,.2,91784,"2,559,424.60",274708
,20180123,278.5,278.85,278.9,279.6,278.6,279.4,279.1,.55,.25,106384,"2,969,343.66",282894
,20180124,279.4,279.1,279.65,280.7,279.15,280.7,279.8,1.6,.7,129994,"3,637,826.29",289142
,20180125,280.7,279.8,281.25,282.1,280.75,281.75,281.4,1.95,1.6,147606,"4,154,306.48",289750
,20180126,281.75,281.4,280.65,281.25,279.15,279.95,280.2,-1.45,-1.2,160632,"4,501,325.70",289436
,20180129,279.95,280.2,279.4,280,278.55,278.7,279.25,-1.5,-.95,116526,"3,254,403.80",295796
,20180130,278.7,279.25,278.25,278.75,276.2,276.35,277.45,-2.9,-1.8,142162,"3,944,542.87",298672
,20180131,276.35,277.45,277.55,278.05,276.45,276.6,277.1,-.85,-.35,130220,"3,608,747.27",294800
,20180201,276.6,277.1,276.1,276.8,275.6,276.05,276.15,-1.05,-.95,107992,"2,982,506.60",291744
,20180202,276.05,276.15,275.85,276.85,275.6,276.4,276.25,.25,.1,95114,"2,627,975.30",295254
,20180205,276.4,276.25,276.15,276.5,273.75,274,274.65,-2.25,-1.6,179670,"4,935,017.64",302310
,20180206,274,274.65,274.3,277.4,273.8,276,275.7,1.35,1.05,165138,"4,552,878.83",308226
,20180207,276,275.7,274.95,274.95,271.65,272.3,273.05,-3.4,-2.65,173706,"4,743,367.44",308076
,20180208,272.3,273.05,271.65,272.15,270.35,271.7,271.25,-1.35,-1.8,169214,"4,590,483.72",312778
,20180209,271.7,271.25,272.3,274.5,271.8,273.05,272.95,1.8,1.7,153838,"4,199,119.43",314210
,20180212,273.05,272.95,271.85,273.1,270.85,272.9,272,-.05,-.95,165634,"4,505,411.93",319818
,20180213,272.9,272,272.7,274.35,272.65,274.25,273.5,2.25,1.5,106204,"2,904,825.76",315230
,20180214,274.25,273.5,274.65,276.15,273.55,276.1,275,2.6,1.5,101596,"2,793,963.33",307424
,20180222,276.1,275,274.7,274.8,273.3,273.65,273.85,-1.35,-1.15,69122,"1,893,221.23",313768
,20180223,273.65,273.85,274,275,274,274.6,274.45,.75,.6,89858,"2,466,595.58",321220
,20180226,274.6,274.45,275.05,275.95,274.1,275.85,275.05,1.4,.6,105090,"2,890,647.88",328434
,20180227,275.85,275.05,275.25,275.6,274.05,274.4,274.7,-.65,-.35,109948,"3,020,738.08",324142
,20180228,274.4,274.7,274.35,274.4,271.7,272.05,272.75,-2.65,-1.95,164380,"4,484,251.24",328194
,20180301,272.05,272.75,272.35,272.75,271.35,271.7,272.05,-1.05,-.7,96650,"2,629,526.33",330226
,20180302,271.7,272.05,270.95,273.05,270.7,272.7,271.9,.65,-.15,176954,"4,811,713.03",336474
,20180305,272.7,271.9,273.3,273.9,272.45,273.65,273.35,1.75,1.45,128004,"3,499,444.62",333908
,20180306,273.65,273.35,273.35,273.5,272.35,273.3,273,-.05,-.35,81380,"2,221,775.56",334266
,20180307,273.3,273,273.7,275.3,273.6,274.5,274.55,1.5,1.55,159050,"4,367,158.06",328022
,20180308,274.5,274.55,274,274.35,273.15,274,273.8,-.55,-.75,130368,"3,569,692.50",333818
,20180309,274,273.8,273.75,274.15,272.25,272.55,273.1,-1.25,-.7,119300,"3,258,362.00",334198
,20180312,272.55,273.1,272.4,273.25,271.45,272.5,272.35,-.6,-.75,155822,"4,244,461.54",331402
,20180313,272.5,272.35,271.8,272.9,271.65,272.3,272.2,-.05,-.15,91312,"2,485,678.59",336476
,20180314,272.3,272.2,273,273.6,271.9,272.75,272.9,.55,.7,144588,"3,946,290.13",334406
,20180315,272.75,272.9,272.2,272.85,272,272.5,272.35,-.4,-.55,86940,"2,368,103.74",334692
,20180316,272.5,272.35,271.75,271.9,270.9,271.35,271.45,-1,-.9,112028,"3,041,103.80",335706
,20180319,271.35,271.45,271.5,271.6,269.65,270.05,270.6,-1.4,-.85,133874,"3,622,746.52",339980
,20180320,270.05,270.6,270.55,271.5,270.3,271.2,270.95,.6,.35,94422,"2,558,391.59",339400
,20180321,271.2,270.95,270.45,271.3,269.9,271.15,270.55,.2,-.4,104436,"2,825,643.47",338814
,20180322,271.15,270.55,271.6,274.25,271.55,273.5,272.75,2.95,2.2,214702,"5,856,792.39",336210
,20180323,273.5,272.75,274.2,276.55,273.3,276.5,275.05,3.75,2.3,222076,"6,108,748.39",338094
,20180326,276.5,275.05,276.9,277.25,275.85,276.15,276.65,1.1,1.6,176800,"4,891,311.03",332560
,20180327,276.15,276.65,275.45,276.65,275.35,275.8,275.9,-.85,-.75,132922,"3,667,319.23",330844
,20180328,275.8,275.9,274.3,275.15,273.95,274.2,274.55,-1.7,-1.35,137984,"3,788,638.67",325736
,20180329,274.2,274.55,273.45,273.7,270.95,271.05,272.2,-3.5,-2.35,197124,"5,366,623.36",316296
,20180330,271.05,272.2,271,271.6,270.85,271.55,271.2,-.65,-1,77390,"2,099,143.82",316812
,20180402,271.55,271.2,271.65,272.35,271.3,271.75,271.7,.55,.5,73540,"1,998,432.62",315638
,20180403,271.75,271.7,272.5,274.6,272.3,273.75,273.35,2.05,1.65,159884,"4,370,786.16",309224
,20180404,273.75,273.35,273.35,273.5,271.6,273.4,272.65,.05,-.7,139306,"3,798,768.99",308904
,20180409,273.4,272.65,273,273.2,272.4,272.55,272.75,-.1,.1,63718,"1,738,044.71",309468
,20180410,272.55,272.75,273.35,274.15,272.4,272.7,273.1,-.05,.35,119642,"3,267,949.39",309026
,20180411,272.7,273.1,273.35,274.35,272.75,274.3,273.6,1.2,.5,144666,"3,958,098.94",317112
,20180412,274.3,273.6,275.9,276.8,274.35,275.2,275.45,1.6,1.85,281170,"7,745,979.86",313048
,20180413,275.2,275.45,274.4,274.65,272.65,273.15,273.6,-2.3,-1.85,170916,"4,676,394.09",305098
,20180416,273.15,273.6,273.2,274.9,272.9,274.25,274.15,.65,.55,175852,"4,821,265.64",306138
,20180417,274.25,274.15,274.25,274.85,273.85,274.65,274.4,.5,.25,109886,"3,015,510.66",304832
,20180418,274.65,274.4,273.15,274.75,273.05,274.5,274,.1,-.4,123876,"3,394,351.33",298582
,20180419,274.5,274,275.6,275.8,274.55,275.2,275.05,1.2,1.05,155956,"4,289,846.46",296316
,20180420,275.2,275.05,274.35,274.75,273.5,273.85,274.1,-1.2,-.95,142614,"3,909,127.37",293800
,20180423,273.85,274.1,273.65,273.65,272,272.55,272.75,-1.55,-1.35,185234,"5,052,721.87",274708
,20180424,272.55,272.75,271.5,272.2,271.05,271.85,271.7,-.9,-1.05,154496,"4,198,038.21",254386
,20180425,271.85,271.7,271.65,272.65,271.5,271.6,272,-.1,.3,134470,"3,657,827.15",239004
,20180426,271.6,272,271.3,272.05,271.2,271.9,271.65,-.1,-.35,112116,"3,045,954.57",216630
,20180427,271.9,271.65,271.6,271.75,270.65,271.15,271.05,-.5,-.6,167128,"4,530,830.44",188628
,20180502,271.15,271.05,269.35,270.55,268.6,270.4,270.05,-.65,-1,80522,"2,174,704.87",164692
,20180503,270.4,270.05,270.35,271.5,269.9,270.4,270.55,.35,.5,118292,"3,200,695.45",132928
,20180504,270.4,270.55,271.65,271.65,270.45,270.8,270.85,.25,.3,98532,"2,669,115.59",104964
,20180507,270.8,270.85,271.3,272.05,270.8,271.35,271.3,.5,.45,71462,"1,938,991.43",93990
,20180508,271.35,271.3,271.3,271.65,271.1,271.3,271.4,0,.1,38298,"1,039,478.28",85802
,20180509,271.3,271.4,271.2,272.4,270.25,271.05,271.15,-.35,-.25,39580,"1,073,262.43",78632
,20180510,271.05,271.15,271.6,271.85,271,271.25,271.4,.1,.25,18988,"515,347.05",73496
,20180511,271.25,271.4,272.2,272.2,271.15,271.5,271.55,.1,.15,19086,"518,316.52",69672
,20180514,271.5,271.55,271.7,272.1,271.25,271.4,271.5,-.15,-.05,14966,"406,396.10",64752
,20180515,271.4,271.5,271.4,271.5,270.2,270.3,270.65,-1.2,-.85,13670,"370,034.47",61404
,20180516,270.3,270.65,268.8,268.8,266.95,267.6,267.65,-3.05,-3,24518,"656,254.70",55728
,20180517,267.6,267.65,266.75,267.15,266.15,266.3,266.65,-1.35,-1,16174,"431,342.27",52512
,20180518,266.3,266.65,266.7,266.8,266.3,266.6,266.5,-.05,-.15,10262,"273,502.90",50550
,20180521,266.6,266.5,266.6,267.4,265.75,265.9,266.65,-.6,.15,14720,"392,563.76",46266
,20180522,265.9,266.65,266.35,267,266.2,266.55,266.65,-.1,0,16764,"447,062.04",40066
,20180523,266.55,266.65,266.95,267.15,266.45,266.95,266.9,.3,.25,12200,"325,673.58",34168
,20180524,266.95,266.9,267.8,268.45,266.9,268.4,267.65,1.5,.75,24812,"664,151.94",21992
,20180525,268.4,267.65,268.9,269.8,268.4,269.45,269.35,1.8,1.7,12052,"324,656.45",18344
,20180528,269.45,269.35,269.55,270.3,268.15,268.45,269.1,-.9,-.25,8922,"240,124.76",14744
,20180529,268.45,269.1,268.95,269.6,268.7,269.1,269.25,0,.15,7576,"204,007.97",12212
,20180530,269.1,269.25,269.75,270.6,268.65,269.9,269.75,.65,.5,8368,"225,743.41",10154
,20180531,269.9,269.75,269.9,270.1,269.4,269.85,269.85,.1,.1,5304,"143,140.69",6368
au1807,20180417,274.15,274.15,,,,274.15,274.15,0,0,0,0.00,0
,20180418,274.15,274.15,,,,274.15,274.15,0,0,0,0.00,0
,20180419,274.15,274.15,,,,274.15,274.15,0,0,0,0.00,0
,20180420,274.15,274.15,,,,274.15,274.15,0,0,0,0.00,0
,20180423,274.15,274.15,,,,274.15,274.15,0,0,0,0.00,0
,20180424,274.15,274.15,,,,274.15,274.15,0,0,0,0.00,0
,20180425,274.15,274.15,272.95,272.95,272.1,272.1,272.45,-2.05,-1.7,6,163.47,4
,20180426,272.1,272.45,,,,272.45,272.45,0,0,0,0.00,4
,20180427,272.45,272.45,,,,272.45,272.45,0,0,0,0.00,4
,20180502,272.45,272.45,,,,272.45,272.45,0,0,0,0.00,4
,20180503,272.45,272.45,,,,272.45,272.45,0,0,0,0.00,4
,20180504,272.45,272.45,,,,272.45,272.45,0,0,0,0.00,4
,20180507,272.45,272.45,272,272,272,272,272,-.45,-.45,2,54.40,4
,20180508,272,272,271.45,271.45,271.45,271.45,271.45,-.55,-.55,2,54.29,2
,20180509,271.45,271.45,271.45,272.9,271.45,272.9,272.15,1.45,.7,4,108.87,4
,20180510,272.9,272.15,272.35,272.35,272.35,272.35,272.35,.2,.2,2,54.47,6
,20180511,272.35,272.35,,,,272.35,272.35,0,0,0,0.00,6
,20180514,272.35,272.35,,,,272.35,272.35,0,0,0,0.00,6
,20180515,272.35,272.35,271.55,271.55,271.55,271.55,271.55,-.8,-.8,2,54.31,8
,20180516,271.55,271.55,265.95,268.4,265.95,267.75,267.35,-3.8,-4.2,6,160.42,8
,20180517,267.75,267.35,266.4,266.4,266.4,266.4,266.4,-.95,-.95,4,106.56,10
,20180518,266.4,266.4,,,,266.4,266.4,0,0,0,0.00,10
,20180521,266.4,266.4,267.7,267.7,267.7,267.7,267.7,1.3,1.3,2,53.54,10
,20180522,267.7,267.7,266,267.25,266,267.25,266.6,-.45,-1.1,4,106.65,10
,20180523,267.25,266.6,268.95,268.95,267.55,267.55,268.25,.95,1.65,4,107.30,12
,20180524,267.55,268.25,,,,268.25,268.25,0,0,0,0.00,12
,20180525,268.25,268.25,268.15,271.35,268.15,269.75,269.65,1.5,1.4,8,215.72,10
,20180528,269.75,269.65,269.05,269.05,269.05,269.05,269.05,-.6,-.6,2,53.81,10
,20180529,269.05,269.05,271.1,271.1,268.7,270.55,270.2,1.5,1.15,12,324.28,14
,20180530,270.55,270.2,270.45,271.85,270.45,271.35,271.2,1.15,1,6,162.73,14
,20180531,271.35,271.2,271.1,271.55,270.95,270.95,271.1,-.25,-.1,8,216.91,14
au1808,20180102,280.45,280.45,,,,280.45,280.45,0,0,0,0.00,52
,20180103,280.45,280.45,280.45,283.3,280.45,283.3,282.35,2.85,1.9,6,169.41,52
,20180104,283.3,282.35,282.65,282.65,280.45,280.45,281.55,-1.9,-.8,4,112.62,54
,20180105,280.45,281.55,,,,281.55,281.55,0,0,0,0.00,54
,20180108,281.55,281.55,,,,281.55,281.55,0,0,0,0.00,54
,20180109,281.55,281.55,282.4,282.4,282.4,282.4,282.4,.85,.85,2,56.48,54
,20180110,282.4,282.4,283,283,282.2,282.2,282.6,-.2,.2,4,113.04,54
,20180111,282.2,282.6,283.5,283.5,283.5,283.5,283.5,.9,.9,2,56.70,54
,20180112,283.5,283.5,,,,283.5,283.5,0,0,0,0.00,54
,20180115,283.5,283.5,283.2,284.6,283.2,284.6,283.65,1.1,.15,6,170.20,56
,20180116,284.6,283.65,282.55,284.35,282.55,284,283.55,.35,-.1,26,737.32,56
,20180117,284,283.55,,,,283.55,283.55,0,0,0,0.00,56
,20180118,283.55,283.55,,,,283.55,283.55,0,0,0,0.00,56
,20180119,283.55,283.55,,,,282.55,282.55,-1,-1,0,0.00,56
,20180122,282.55,282.55,,,,282.75,282.75,.2,.2,0,0.00,56
,20180123,282.75,282.75,,,,282.75,282.75,0,0,0,0.00,56
,20180124,282.75,282.75,,,,282.75,282.75,0,0,0,0.00,56
,20180125,282.75,282.75,,,,283.5,283.5,.75,.75,0,0.00,56
,20180126,283.5,283.5,,,,283.5,283.5,0,0,0,0.00,56
,20180129,283.5,283.5,282.1,282.1,282.1,282.1,282.1,-1.4,-1.4,2,56.42,54
,20180130,282.1,282.1,,,,282.1,282.1,0,0,0,0.00,54
,20180131,282.1,282.1,,,,282.1,282.1,0,0,0,0.00,54
,20180201,282.1,282.1,278.15,278.15,278,278,278,-4.1,-4.1,12,333.63,52
,20180202,278,278,277.9,277.9,277.9,277.9,277.9,-.1,-.1,6,166.74,56
,20180205,277.9,277.9,277.95,277.95,276.7,276.7,277.1,-1.2,-.8,8,221.70,54
,20180206,276.7,277.1,,,,277.1,277.1,0,0,0,0.00,54
,20180207,277.1,277.1,275.9,275.9,273.65,274.25,274.35,-2.85,-2.75,28,768.22,52
,20180208,274.25,274.35,,,,274.35,274.35,0,0,0,0.00,52
,20180209,274.35,274.35,274.45,275.55,274.05,275.55,274.4,1.2,.05,70,"1,921.04",54
,20180212,275.55,274.4,273.65,275,273.05,275,274.25,.6,-.15,68,"1,864.93",56
,20180213,275,274.25,,,,274.25,274.25,0,0,0,0.00,56
,20180214,274.25,274.25,,,,274.25,274.25,0,0,0,0.00,56
,20180222,274.25,274.25,275.4,275.4,275.4,275.4,275.4,1.15,1.15,2,55.08,54
,20180223,275.4,275.4,275.85,275.85,275.85,275.85,275.85,.45,.45,4,110.34,58
,20180226,275.85,275.85,276.25,276.25,276.25,276.25,276.25,.4,.4,2,55.25,60
,20180227,276.25,276.25,275.65,275.85,275.45,275.6,275.55,-.65,-.7,12,330.69,68
,20180228,275.6,275.55,275.4,275.4,273.9,273.9,274.5,-1.65,-1.05,10,274.54,64
,20180301,273.9,274.5,273.5,273.5,273,273,273.25,-1.5,-1.25,4,109.30,62
,20180302,273,273.25,272.9,274,272.1,273.95,273.25,.7,0,14,382.61,66
,20180305,273.95,273.25,274.9,274.9,274.9,274.9,274.9,1.65,1.65,4,109.96,62
,20180306,274.9,274.9,274.5,274.5,274.5,274.5,274.5,-.4,-.4,2,54.90,60
,20180307,274.5,274.5,275.4,276,275.4,276,275.8,1.5,1.3,6,165.48,62
,20180308,276,275.8,275,275,274.9,274.9,274.95,-.9,-.85,4,109.98,62
,20180309,274.9,274.95,274.35,274.35,274.35,274.35,274.35,-.6,-.6,2,54.87,60
,20180312,274.35,274.35,273.4,274.05,273.05,273.65,273.4,-.7,-.95,52,"1,421.91",68
,20180313,273.65,273.4,273.4,273.8,273.4,273.6,273.45,.2,.05,14,382.88,60
,20180314,273.6,273.45,,,,273.45,273.45,0,0,0,0.00,60
,20180315,273.45,273.45,273.05,273.05,273.05,273.05,273.05,-.4,-.4,2,54.61,62
,20180316,273.05,273.05,272.95,273.05,272.3,272.3,272.65,-.75,-.4,8,218.15,60
,20180319,272.3,272.65,272.55,272.55,271.65,271.65,271.95,-1,-.7,16,435.15,62
,20180320,271.65,271.95,271.9,273,271.9,273,272.45,1.05,.5,10,272.45,64
,20180321,273,272.45,272.2,273.4,271.95,272.25,272.5,-.2,.05,24,654.06,64
,20180322,272.25,272.5,273.15,275.6,273.15,275.1,274.7,2.6,2.2,36,989.00,68
,20180323,275.1,274.7,276,277.9,276,277.85,277.3,3.15,2.6,10,277.34,66
,20180326,277.85,277.3,,,,277.3,277.3,0,0,0,0.00,66
,20180327,277.3,277.3,278.1,278.1,278.1,278.1,278.1,.8,.8,2,55.62,66
,20180328,278.1,278.1,276.55,276.65,275.9,275.9,276.35,-2.2,-1.75,6,165.82,64
,20180329,275.9,276.35,275.55,275.55,273.2,273.2,274.05,-3.15,-2.3,14,383.68,66
,20180330,273.2,274.05,273.05,273.05,273.05,273.05,273.05,-1,-1,2,54.61,68
,20180402,273.05,273.05,,,,273.05,273.05,0,0,0,0.00,68
,20180403,273.05,273.05,274.45,276,274.45,275.7,275.5,2.65,2.45,10,275.52,68
,20180404,275.7,275.5,274.7,274.7,274.2,274.3,274.35,-1.2,-1.15,8,219.51,72
,20180409,274.3,274.35,275,275,275,275,275,.65,.65,2,55.00,70
,20180410,275,275,,,,275,275,0,0,0,0.00,70
,20180411,275,275,275.3,275.95,275.3,275.95,275.6,.95,.6,6,165.37,72
,20180412,275.95,275.6,277.5,279.25,276.8,277,277.45,1.4,1.85,18,499.42,70
,20180413,277,277.45,275.95,275.95,275.5,275.5,275.55,-1.95,-1.9,12,330.69,72
,20180416,275.5,275.55,276.4,276.55,276.1,276.55,276.15,1,.6,20,552.35,76
,20180417,276.55,276.15,276.6,276.6,276.6,276.6,276.6,.45,.45,2,55.32,78
,20180418,276.6,276.6,276.05,276.3,276.05,276.3,276.15,-.3,-.45,4,110.47,80
,20180419,276.3,276.15,277.25,277.3,277.25,277.25,277.25,1.1,1.1,8,221.81,82
,20180420,277.25,277.25,276.5,276.5,276.5,276.5,276.5,-.75,-.75,4,110.60,78
,20180423,276.5,276.5,275.2,275.2,274.35,274.5,274.6,-2,-1.9,14,384.46,74
,20180424,274.5,274.6,274,274.85,272.95,274.2,273.9,-.4,-.7,144,"3,944.46",138
,20180425,274.2,273.9,274.35,274.6,273.55,273.95,274.35,.05,.45,40,"1,097.47",124
,20180426,273.95,274.35,273.35,273.75,273.1,273.35,273.3,-1,-1.05,38,"1,038.59",118
,20180427,273.35,273.3,272.7,272.7,272.6,272.65,272.65,-.65,-.65,8,218.12,116
,20180502,272.65,272.65,271.65,272.25,271.65,272.25,271.95,-.4,-.7,4,108.78,118
,20180503,272.25,271.95,271.55,272.7,271.55,272.4,272.35,.45,.4,16,435.83,118
,20180504,272.4,272.35,272.7,272.9,272.55,272.55,272.7,.2,.35,8,218.17,116
,20180507,272.55,272.7,272.75,273.6,272.75,273.25,273.5,.55,.8,34,929.92,132
,20180508,273.25,273.5,273.1,273.1,273.1,273.1,273.1,-.4,-.4,24,655.44,126
,20180509,273.1,273.1,272.6,273.6,271.7,272.85,272.4,-.25,-.7,12,326.91,122
,20180510,272.85,272.4,273.05,273.15,272.6,272.85,272.95,.45,.55,22,600.55,118
,20180511,272.85,272.95,273,273,273,273,273,.05,.05,6,163.80,114
,20180514,273,273,,,,273,273,0,0,0,0.00,114
,20180515,273,273,272.25,272.3,272,272.1,272.1,-.9,-.9,10,272.13,112
,20180516,272.1,272.1,269.6,270.05,269.1,269.6,269.55,-2.5,-2.55,30,808.75,132
,20180517,269.6,269.55,268.7,269.15,268.7,268.85,268.95,-.7,-.6,20,537.96,134
,20180518,268.85,268.95,269.05,269.15,268.65,269.15,268.95,.2,0,6,161.37,136
,20180521,269.15,268.95,268.8,269.85,268.4,268.4,269.25,-.55,.3,28,754.02,144
,20180522,268.4,269.25,269.2,269.3,268.9,269.3,269.1,.05,-.15,6,161.48,142
,20180523,269.3,269.1,269.5,269.8,269.35,269.8,269.6,.7,.5,12,323.54,148
,20180524,269.8,269.6,269.4,270.85,269.4,270.7,270.3,1.1,.7,24,648.75,138
,20180525,270.7,270.3,271,272.4,271,271.85,271.7,1.55,1.4,16,434.74,128
,20180528,271.85,271.7,271.65,271.65,271.25,271.25,271.45,-.45,-.25,4,108.58,124
,20180529,271.25,271.45,271.4,272.3,270.75,270.75,271.65,-.7,.2,18,489.01,126
,20180530,270.75,271.65,272,273.2,271.65,272.8,272.55,1.15,.9,14,381.62,124
,20180531,272.8,272.55,272.75,273,272.65,273,272.8,.45,.25,10,272.81,118
au1810,20180102,279.3,279.3,,,,280.6,280.6,1.3,1.3,0,0.00,32
,20180103,280.6,280.6,,,,280.6,280.6,0,0,0,0.00,32
,20180104,280.6,280.6,281.25,281.25,281.25,281.25,281.25,.65,.65,2,56.25,32
,20180105,281.25,281.25,,,,281.25,281.25,0,0,0,0.00,32
,20180108,281.25,281.25,282.4,282.4,282.4,282.4,282.4,1.15,1.15,2,56.48,34
,20180109,282.4,282.4,283.5,283.5,283,283,283.25,.6,.85,4,113.30,34
,20180110,283,283.25,,,,283.25,283.25,0,0,0,0.00,34
,20180111,283.25,283.25,,,,283.25,283.25,0,0,0,0.00,34
,20180112,283.25,283.25,,,,283.25,283.25,0,0,0,0.00,34
,20180115,283.25,283.25,,,,283.4,283.4,.15,.15,0,0.00,34
,20180116,283.4,283.4,,,,283.4,283.4,0,0,0,0.00,34
,20180117,283.4,283.4,,,,283.4,283.4,0,0,0,0.00,34
,20180118,283.4,283.4,,,,283.4,283.4,0,0,0,0.00,34
,20180119,283.4,283.4,,,,283.4,283.4,0,0,0,0.00,34
,20180122,283.4,283.4,,,,283.4,283.4,0,0,0,0.00,34
,20180123,283.4,283.4,,,,283.4,283.4,0,0,0,0.00,34
,20180124,283.4,283.4,,,,283.4,283.4,0,0,0,0.00,34
,20180125,283.4,283.4,,,,283.4,283.4,0,0,0,0.00,34
,20180126,283.4,283.4,,,,283.4,283.4,0,0,0,0.00,34
,20180129,283.4,283.4,,,,283.4,283.4,0,0,0,0.00,34
,20180130,283.4,283.4,279.75,279.75,279.75,279.75,279.75,-3.65,-3.65,2,55.95,34
,20180131,279.75,279.75,,,,279.75,279.75,0,0,0,0.00,34
,20180201,279.75,279.75,278.75,278.75,278.75,278.75,278.75,-1,-1,2,55.75,32
,20180202,278.75,278.75,,,,278.75,278.75,0,0,0,0.00,32
,20180205,278.75,278.75,276.35,276.35,276.35,276.35,276.35,-2.4,-2.4,2,55.27,32
,20180206,276.35,276.35,,,,276.35,276.35,0,0,0,0.00,32
,20180207,276.35,276.35,,,,276.35,276.35,0,0,0,0.00,32
,20180208,276.35,276.35,,,,276.35,276.35,0,0,0,0.00,32
,20180209,276.35,276.35,275.2,275.2,275.2,275.2,275.2,-1.15,-1.15,4,110.08,28
,20180212,275.2,275.2,,,,275.2,275.2,0,0,0,0.00,28
,20180213,275.2,275.2,,,,275.2,275.2,0,0,0,0.00,28
,20180214,275.2,275.2,,,,275.2,275.2,0,0,0,0.00,28
,20180222,275.2,275.2,,,,275.2,275.2,0,0,0,0.00,28
,20180223,275.2,275.2,276.6,276.6,276.6,276.6,276.6,1.4,1.4,2,55.32,28
,20180226,276.6,276.6,,,,276.6,276.6,0,0,0,0.00,28
,20180227,276.6,276.6,278,278,276.75,276.75,277.35,.15,.75,4,110.95,26
,20180228,276.75,277.35,,,,277.35,277.35,0,0,0,0.00,26
,20180301,277.35,277.35,,,,277.35,277.35,0,0,0,0.00,26
,20180302,277.35,277.35,,,,277.35,277.35,0,0,0,0.00,26
,20180305,277.35,277.35,,,,277.35,277.35,0,0,0,0.00,26
,20180306,277.35,277.35,,,,276.9,276.9,-.45,-.45,0,0.00,26
,20180307,276.9,276.9,,,,276.9,276.9,0,0,0,0.00,26
,20180308,276.9,276.9,,,,276.9,276.9,0,0,0,0.00,26
,20180309,276.9,276.9,275.35,275.35,275.35,275.35,275.35,-1.55,-1.55,2,55.07,26
,20180312,275.35,275.35,275.15,275.15,275.15,275.15,275.15,-.2,-.2,2,55.03,26
,20180313,275.15,275.15,,,,275.15,275.15,0,0,0,0.00,26
,20180314,275.15,275.15,,,,275.15,275.15,0,0,0,0.00,26
,20180315,275.15,275.15,,,,275.15,275.15,0,0,0,0.00,26
,20180316,275.15,275.15,,,,275.15,275.15,0,0,0,0.00,26
,20180319,275.15,275.15,,,,275.15,275.15,0,0,0,0.00,26
,20180320,275.15,275.15,,,,275.15,275.15,0,0,0,0.00,26
,20180321,275.15,275.15,,,,275.15,275.15,0,0,0,0.00,26
,20180322,275.15,275.15,,,,275.15,275.15,0,0,0,0.00,26
,20180323,275.15,275.15,,,,275.15,275.15,0,0,0,0.00,26
,20180326,275.15,275.15,,,,275.15,275.15,0,0,0,0.00,26
,20180327,275.15,275.15,,,,275.15,275.15,0,0,0,0.00,26
,20180328,275.15,275.15,,,,275.15,275.15,0,0,0,0.00,26
,20180329,275.15,275.15,,,,275.15,275.15,0,0,0,0.00,26
,20180330,275.15,275.15,,,,275.15,275.15,0,0,0,0.00,26
,20180402,275.15,275.15,,,,275.15,275.15,0,0,0,0.00,26
,20180403,275.15,275.15,,,,275.15,275.15,0,0,0,0.00,26
,20180404,275.15,275.15,,,,275.15,275.15,0,0,0,0.00,26
,20180409,275.15,275.15,,,,275.15,275.15,0,0,0,0.00,26
,20180410,275.15,275.15,,,,275.15,275.15,0,0,0,0.00,26
,20180411,275.15,275.15,275.95,275.95,275.65,275.65,275.8,.5,.65,4,110.32,26
,20180412,275.65,275.8,,,,275.8,275.8,0,0,0,0.00,26
,20180413,275.8,275.8,,,,275.8,275.8,0,0,0,0.00,26
,20180416,275.8,275.8,,,,275.8,275.8,0,0,0,0.00,26
,20180417,275.8,275.8,,,,275.8,275.8,0,0,0,0.00,26
,20180418,275.8,275.8,,,,277.1,277.1,1.3,1.3,0,0.00,26
,20180419,277.1,277.1,,,,277.1,277.1,0,0,0,0.00,26
,20180420,277.1,277.1,,,,277.1,277.1,0,0,0,0.00,26
,20180423,277.1,277.1,,,,277.1,277.1,0,0,0,0.00,26
,20180424,277.1,277.1,,,,277.1,277.1,0,0,0,0.00,26
,20180425,277.1,277.1,,,,277.1,277.1,0,0,0,0.00,26
,20180426,277.1,277.1,,,,277.1,277.1,0,0,0,0.00,26
,20180427,277.1,277.1,,,,277.1,277.1,0,0,0,0.00,26
,20180502,277.1,277.1,,,,276.35,276.35,-.75,-.75,0,0.00,26
,20180503,276.35,276.35,272.6,273.25,272.6,273.25,272.9,-3.1,-3.45,4,109.17,26
,20180504,273.25,272.9,,,,272.9,272.9,0,0,0,0.00,26
,20180507,272.9,272.9,,,,272.9,272.9,0,0,0,0.00,26
,20180508,272.9,272.9,,,,273.1,273.1,.2,.2,0,0.00,26
,20180509,273.1,273.1,,,,273.1,273.1,0,0,0,0.00,26
,20180510,273.1,273.1,,,,273.1,273.1,0,0,0,0.00,26
,20180511,273.1,273.1,,,,273.1,273.1,0,0,0,0.00,26
,20180514,273.1,273.1,274.6,274.6,274.6,274.6,274.6,1.5,1.5,10,274.60,34
,20180515,274.6,274.6,273.95,273.95,273.95,273.95,273.95,-.65,-.65,2,54.79,32
,20180516,273.95,273.95,270.3,271.3,269.2,270.8,270.35,-3.15,-3.6,28,757.04,24
,20180517,270.8,270.35,269.55,269.8,269.05,269.7,269.5,-.65,-.85,12,323.45,24
,20180518,269.7,269.5,269.75,269.75,269.75,269.75,269.75,.25,.25,2,53.95,26
,20180521,269.75,269.75,,,,269.75,269.75,0,0,0,0.00,26
,20180522,269.75,269.75,,,,269.75,269.75,0,0,0,0.00,26
,20180523,269.75,269.75,270.05,270.05,270,270,270,.25,.25,4,108.01,28
,20180524,270,270,,,,270,270,0,0,0,0.00,28
,20180525,270,270,273.6,273.6,272.15,272.15,272.95,2.15,2.95,8,218.39,32
,20180528,272.15,272.95,273.35,273.35,271,271.3,271.75,-1.65,-1.2,18,489.15,26
,20180529,271.3,271.75,,,,271.75,271.75,0,0,0,0.00,26
,20180530,271.75,271.75,272.15,274.3,272.15,274,273.35,2.25,1.6,30,820.09,34
,20180531,274,273.35,273.35,273.85,273,273.05,273.4,-.3,.05,22,601.48,34
au1812,20180102,281.7,281.95,283.65,283.65,282.85,283.35,283.2,1.4,1.25,114,"3,228.51",1038
,20180103,283.35,283.2,284,286,283.25,284.15,284.85,.95,1.65,2696,"76,801.87",3390
,20180104,284.15,284.85,284.05,284.4,282.2,282.75,282.8,-2.1,-2.05,3682,"104,137.73",6412
,20180105,282.75,282.8,282.8,284.45,281,283.7,283.55,.9,.75,3674,"104,194.18",8674
,20180108,283.7,283.55,283.35,284.2,283,283.8,283.5,.25,-.05,3892,"110,339.60",12042
,20180109,283.8,283.5,283.95,284.55,283.75,284.1,284.15,.6,.65,4446,"126,339.83",15484
,20180110,284.1,284.15,284.3,284.6,283.35,283.45,283.8,-.7,-.35,4352,"123,515.68",18556
,20180111,283.45,283.8,285.4,285.4,284.2,284.45,284.85,.65,1.05,1262,"35,950.18",18966
,20180112,284.45,284.85,284.75,285.45,284.2,285.1,285,.25,.15,1078,"30,725.05",19346
,20180115,285.1,285,285.1,286.3,284.1,286,285.65,1,.65,1084,"30,964.73",19686
,20180116,286,285.65,286.15,286.15,285.3,285.45,285.65,-.2,0,592,"16,912.61",19840
,20180117,285.45,285.65,285.1,285.65,284.45,284.6,284.7,-1.05,-.95,1892,"53,874.65",20564
,20180118,284.6,284.7,284.85,284.9,282.45,282.95,283.6,-1.75,-1.1,1060,"30,065.36",20764
,20180119,282.95,283.6,282.45,283.2,282,282.35,282.5,-1.25,-1.1,2832,"80,009.22",21938
,20180122,282.35,282.5,283.55,283.55,282.05,282.7,282.9,.2,.4,2326,"65,806.27",22270
,20180123,282.7,282.9,282.7,283.75,282.7,283.6,283.25,.7,.35,1754,"49,689.53",22624
,20180124,283.6,283.25,283.85,284.75,283.3,284.75,284.1,1.5,.85,3202,"90,977.04",23698
,20180125,284.75,284.1,285.6,286.2,285,285.85,285.7,1.75,1.6,5290,"151,158.11",24940
,20180126,285.85,285.7,285.85,285.85,283.55,284.2,284.15,-1.5,-1.55,3322,"94,406.70",26034
,20180129,284.2,284.15,283.6,284.25,282.65,282.8,283.45,-1.35,-.7,2346,"66,497.49",26544
,20180130,282.8,283.45,282.55,282.8,280.45,280.45,281.45,-3,-2,2948,"82,977.91",27766
,20180131,280.45,281.45,281.6,282.2,280.7,280.8,281.2,-.65,-.25,1832,"51,521.30",28250
,20180201,280.8,281.2,280.65,280.9,280,280.3,280.35,-.9,-.85,1568,"43,962.70",28448
,20180202,280.3,280.35,280.05,280.95,279.75,280.55,280.45,.2,.1,2316,"64,957.43",28630
,20180205,280.55,280.45,280.55,280.55,277.9,277.95,278.6,-2.5,-1.85,3674,"102,366.51",29306
,20180206,277.95,278.6,278.3,281.3,277.85,280.15,279.8,1.55,1.2,2272,"63,572.26",29734
,20180207,280.15,279.8,278.8,278.85,275.8,276.3,276.8,-3.5,-3,2744,"75,960.56",30240
,20180208,276.3,276.8,276,276.15,274.45,275.65,275.15,-1.15,-1.65,1992,"54,813.07",30696
,20180209,275.65,275.15,275.9,278.2,275.9,276.9,276.95,1.75,1.8,1238,"34,290.90",30816
,20180212,276.9,276.95,276.5,277.05,275,277,276.05,.05,-.9,1614,"44,560.55",30958
,20180213,277,276.05,276.05,278.45,276.05,278.45,277.6,2.4,1.55,1562,"43,368.20",30788
,20180214,278.45,277.6,278.75,280.3,277.65,280.1,279.35,2.5,1.75,1452,"40,568.08",30758
,20180222,280.1,279.35,278.1,278.65,277.45,277.95,278,-1.4,-1.35,3256,"90,526.53",31796
,20180223,277.95,278,278.35,279.15,278.25,278.75,278.75,.75,.75,1240,"34,565.00",32178
,20180226,278.75,278.75,279.2,280.1,278.35,280,279.25,1.25,.5,1732,"48,370.99",32190
,20180227,280,279.25,279.5,279.7,278.45,278.7,278.9,-.55,-.35,1458,"40,669.39",32248
,20180228,278.7,278.9,278.5,278.5,276,276.2,277.05,-2.7,-1.85,3078,"85,288.34",32506
,20180301,276.2,277.05,276.55,276.9,275.55,275.9,276.1,-1.15,-.95,2486,"68,648.08",33148
,20180302,275.9,276.1,275.45,277.25,274.95,277,276.25,.9,.15,2934,"81,058.99",33594
,20180305,277,276.25,277,278.1,276.7,277.9,277.75,1.65,1.5,3222,"89,495.60",34334
,20180306,277.9,277.75,277.75,277.75,276.65,277.6,277.3,-.15,-.45,1810,"50,197.88",34598
,20180307,277.6,277.3,278,279.6,277.9,278.85,278.9,1.55,1.6,7362,"205,334.06",37380
,20180308,278.85,278.9,278.75,278.75,277.35,278.1,277.95,-.8,-.95,4226,"117,470.82",37898
,20180309,278.1,277.95,277.7,278.35,276.35,276.8,277.15,-1.15,-.8,3338,"92,518.75",38546
,20180312,276.8,277.15,276.8,277.5,275.7,276.75,276.55,-.4,-.6,6642,"183,688.65",39824
,20180313,276.75,276.55,276,277,275.9,276.45,276.45,-.1,-.1,3484,"96,315.85",40536
,20180314,276.45,276.45,277.2,277.8,276.05,276.95,277.1,.5,.65,5690,"157,675.78",42032
,20180315,276.95,277.1,276.4,276.9,276.15,276.6,276.5,-.5,-.6,2808,"77,653.97",42738
,20180316,276.6,276.5,275.75,276.05,275.05,275.45,275.55,-1.05,-.95,5128,"141,324.34",43642
,20180319,275.45,275.55,275.65,275.7,273.8,274.2,274.6,-1.35,-.95,6212,"170,598.12",43530
,20180320,274.2,274.6,274.7,275.6,274.45,275.5,275,.9,.4,5378,"147,897.97",44550
,20180321,275.5,275,274.5,275.4,274.05,275.3,274.75,.3,-.25,4162,"114,362.46",44560
,20180322,275.3,274.75,275.9,278.5,275.8,277.9,277.3,3.15,2.55,12164,"337,348.82",49470
,20180323,277.9,277.3,278.2,281.15,277.9,281.15,279.5,3.85,2.2,14084,"393,699.44",52960
,20180326,281.15,279.5,282.05,282.05,280.35,280.55,281.05,1.05,1.55,7986,"224,485.95",53078
,20180327,280.55,281.05,280.55,281.1,279.8,280.2,280.3,-.85,-.75,9046,"253,597.52",52214
,20180328,280.2,280.3,278.9,279.45,278.3,278.5,278.95,-1.8,-1.35,8648,"241,241.28",51132
,20180329,278.5,278.95,277.85,278.05,275,275.05,276.6,-3.9,-2.35,23856,"659,924.08",45120
,20180330,275.05,276.6,274.65,275.7,274.65,275.65,275.35,-.95,-1.25,6488,"178,649.73",44864
,20180402,275.65,275.35,276.1,276.4,275.5,275.95,275.85,.6,.5,5032,"138,821.96",45054
,20180403,275.95,275.85,276.95,278.8,276.55,278.15,277.6,2.3,1.75,13982,"388,206.46",48044
,20180404,278.15,277.6,277.7,277.9,276,277.6,277.05,0,-.55,9216,"255,339.98",48466
,20180409,277.6,277.05,277,277.5,276.5,276.6,276.9,-.45,-.15,7596,"210,340.33",49528
,20180410,276.6,276.9,277.25,278.25,276.5,276.75,277.15,-.15,.25,13818,"383,026.25",52450
,20180411,276.75,277.15,277.6,278.45,277,278.45,277.7,1.3,.55,16316,"453,150.04",55186
,20180412,278.45,277.7,279.95,281.25,278.7,279.65,279.9,1.95,2.2,36794,"1,029,924.58",63616
,20180413,279.65,279.9,278.8,279,276.9,277.35,277.8,-2.55,-2.1,21364,"593,502.81",61948
,20180416,277.35,277.8,277.35,279.2,277.15,278.6,278.4,.8,.6,19730,"549,316.42",64078
,20180417,278.6,278.4,278.3,279.05,278,278.8,278.6,.4,.2,15204,"423,594.26",66438
,20180418,278.8,278.6,277.6,278.8,277.05,278.6,278.15,0,-.45,17536,"487,827.91",67192
,20180419,278.6,278.15,280,280.05,278.65,279.45,279.15,1.3,1,25108,"700,962.06",70726
,20180420,279.45,279.15,278.55,279,277.65,277.95,278.15,-1.2,-1,24458,"680,331.67",72498
,20180423,277.95,278.15,277.7,277.7,275.95,276.55,276.4,-1.6,-1.75,65480,"1,810,187.57",97284
,20180424,276.55,276.4,275.5,276.2,274.95,275.6,275.7,-.8,-.7,57854,"1,595,079.83",117352
,20180425,275.6,275.7,275.6,276.5,275.35,275.5,275.85,-.2,.15,38628,"1,065,619.30",133770
,20180426,275.5,275.85,275.05,276.05,275.05,275.95,275.65,.1,-.2,47328,"1,304,668.99",157432
,20180427,275.95,275.65,275.7,275.85,274.65,275,275,-.65,-.65,58148,"1,599,182.74",181412
,20180502,275,275,273.65,274.35,272.55,274.1,273.95,-.9,-1.05,57980,"1,588,362.12",207808
,20180503,274.1,273.95,273.8,274.9,273.35,274.15,274.1,.2,.15,98418,"2,697,969.30",234414
,20180504,274.15,274.1,275.05,275.15,274.05,274.3,274.5,.2,.4,89614,"2,459,996.16",265590
,20180507,274.3,274.5,275,275.75,274.35,275.15,275.05,.65,.55,94876,"2,609,567.02",276690
,20180508,275.15,275.05,275.25,275.45,274.75,274.95,275.05,-.1,0,89848,"2,471,645.83",286166
,20180509,274.95,275.05,274.6,275.95,273.95,274.6,274.75,-.45,-.3,145340,"3,993,590.22",293528
,20180510,274.6,274.75,275.1,275.55,274.65,274.8,275,.05,.25,112892,"3,104,851.10",293762
,20180511,274.8,275,275.7,275.75,274.75,275.2,275.2,.2,.2,98314,"2,705,629.53",295562
,20180514,275.2,275.2,275.7,275.7,275,275.15,275.2,-.05,0,68000,"1,871,682.96",298542
,20180515,275.15,275.2,275,275.2,273.6,273.8,274.3,-1.4,-.9,84694,"2,323,463.73",305570
,20180516,273.8,274.3,272,272.05,270.55,271.25,271.25,-3.05,-3.05,143926,"3,904,037.73",312868
,20180517,271.25,271.25,270.1,270.8,269.75,269.85,270.35,-1.4,-.9,112742,"3,048,241.38",319894
,20180518,269.85,270.35,270,270.45,269.9,270.3,270.15,-.05,-.2,87276,"2,358,085.80",321724
,20180521,270.3,270.15,270.05,271.15,269.45,269.5,270.35,-.65,.2,131962,"3,568,036.45",326826
,20180522,269.5,270.35,270.15,270.8,270,270.25,270.35,-.1,0,101034,"2,731,615.15",325632
,20180523,270.25,270.35,270.8,270.85,270.2,270.5,270.55,.15,.2,105426,"2,852,490.81",331526
,20180524,270.5,270.55,271.15,272.3,270.65,272.25,271.4,1.7,.85,150568,"4,086,732.70",335882
,20180525,272.25,271.4,272.6,273.85,272.25,273.55,273.3,2.15,1.9,137342,"3,753,775.34",332452
,20180528,273.55,273.3,274.1,274.3,272.15,272.35,273.05,-.95,-.25,126806,"3,462,936.37",330022
,20180529,272.35,273.05,273,273.65,272.65,273.25,273.25,.2,.2,82968,"2,267,382.57",334188
,20180530,273.25,273.25,273.5,274.95,272.8,274.15,274.05,.9,.8,183800,"5,037,608.25",339926
,20180531,274.15,274.05,274.4,274.55,273.8,274.5,274.15,.45,.1,93610,"2,566,781.47",336208
au1902,20180116,285.65,285.65,,,,285.65,285.65,0,0,0,0.00,0
,20180117,285.65,285.65,,,,285.65,285.65,0,0,0,0.00,0
,20180118,285.65,285.65,,,,285.65,285.65,0,0,0,0.00,0
,20180119,285.65,285.65,,,,285.65,285.65,0,0,0,0.00,0
,20180122,285.65,285.65,,,,285.65,285.65,0,0,0,0.00,0
,20180123,285.65,285.65,,,,285.65,285.65,0,0,0,0.00,0
,20180124,285.65,285.65,,,,285.65,285.65,0,0,0,0.00,0
,20180125,285.65,285.65,,,,285.65,285.65,0,0,0,0.00,0
,20180126,285.65,285.65,,,,285.65,285.65,0,0,0,0.00,0
,20180129,285.65,285.65,,,,285.65,285.65,0,0,0,0.00,0
,20180130,285.65,285.65,,,,285.35,285.35,-.3,-.3,0,0.00,0
,20180131,285.35,285.35,,,,285.35,285.35,0,0,0,0.00,0
,20180201,285.35,285.35,,,,284.65,284.65,-.7,-.7,0,0.00,0
,20180202,284.65,284.65,,,,284.5,284.5,-.15,-.15,0,0.00,0
,20180205,284.5,284.5,,,,284.5,284.5,0,0,0,0.00,0
,20180206,284.5,284.5,,,,284.5,284.5,0,0,0,0.00,0
,20180207,284.5,284.5,,,,283.15,283.15,-1.35,-1.35,0,0.00,0
,20180208,283.15,283.15,,,,283.1,283.1,-.05,-.05,0,0.00,0
,20180209,283.1,283.1,,,,283.1,283.1,0,0,0,0.00,0
,20180212,283.1,283.1,,,,283.1,283.1,0,0,0,0.00,0
,20180213,283.1,283.1,,,,283.1,283.1,0,0,0,0.00,0
,20180214,283.1,283.1,,,,283.1,283.1,0,0,0,0.00,0
,20180222,283.1,283.1,,,,282.5,282.5,-.6,-.6,0,0.00,0
,20180223,282.5,282.5,,,,280.5,280.5,-2,-2,0,0.00,0
,20180226,280.5,280.5,,,,280.5,280.5,0,0,0,0.00,0
,20180227,280.5,280.5,,,,280.5,280.5,0,0,0,0.00,0
,20180228,280.5,280.5,,,,280.5,280.5,0,0,0,0.00,0
,20180301,280.5,280.5,,,,280.5,280.5,0,0,0,0.00,0
,20180302,280.5,280.5,,,,280.5,280.5,0,0,0,0.00,0
,20180305,280.5,280.5,,,,280.5,280.5,0,0,0,0.00,0
,20180306,280.5,280.5,,,,280.5,280.5,0,0,0,0.00,0
,20180307,280.5,280.5,,,,280.5,280.5,0,0,0,0.00,0
,20180308,280.5,280.5,,,,280.5,280.5,0,0,0,0.00,0
,20180309,280.5,280.5,,,,280.5,280.5,0,0,0,0.00,0
,20180312,280.5,280.5,,,,280.5,280.5,0,0,0,0.00,0
,20180313,280.5,280.5,,,,280.5,280.5,0,0,0,0.00,0
,20180314,280.5,280.5,,,,280.5,280.5,0,0,0,0.00,0
,20180315,280.5,280.5,,,,280.5,280.5,0,0,0,0.00,0
,20180316,280.5,280.5,277.25,277.25,277.25,277.25,277.25,-3.25,-3.25,2,55.45,2
,20180319,277.25,277.25,276.6,276.6,276.6,276.6,276.6,-.65,-.65,2,55.32,4
,20180320,276.6,276.6,275.1,275.1,275.1,275.1,275.1,-1.5,-1.5,2,55.02,4
,20180321,275.1,275.1,,,,275.1,275.1,0,0,0,0.00,4
,20180322,275.1,275.1,,,,275.1,275.1,0,0,0,0.00,4
,20180323,275.1,275.1,280.85,280.85,280.85,280.85,280.85,5.75,5.75,2,56.17,2
,20180326,280.85,280.85,281.55,283.8,281.55,283.8,282.8,2.95,1.95,6,169.70,4
,20180327,283.8,282.8,282.65,282.65,282.65,282.65,282.65,-.15,-.15,2,56.53,6
,20180328,282.65,282.65,280.85,280.85,280.85,280.85,280.85,-1.8,-1.8,4,112.34,10
,20180329,280.85,280.85,276.9,276.9,276.9,276.9,276.9,-3.95,-3.95,4,110.76,6
,20180330,276.9,276.9,,,,276.9,276.9,0,0,0,0.00,6
,20180402,276.9,276.9,276.3,276.3,276.3,276.3,276.3,-.6,-.6,4,110.52,2
,20180403,276.3,276.3,,,,276.3,276.3,0,0,0,0.00,2
,20180404,276.3,276.3,,,,276.3,276.3,0,0,0,0.00,2
,20180409,276.3,276.3,,,,276.3,276.3,0,0,0,0.00,2
,20180410,276.3,276.3,278.7,278.7,278.7,278.7,278.7,2.4,2.4,2,55.74,4
,20180411,278.7,278.7,,,,278.7,278.7,0,0,0,0.00,4
,20180412,278.7,278.7,289.5,289.55,280.9,280.9,284.45,2.2,5.75,110,"3,129.01",18
,20180413,280.9,284.45,280.55,280.55,280.55,280.55,280.55,-3.9,-3.9,2,56.11,16
,20180416,280.55,280.55,,,,280.55,280.55,0,0,0,0.00,16
,20180417,280.55,280.55,,,,280.55,280.55,0,0,0,0.00,16
,20180418,280.55,280.55,,,,280.55,280.55,0,0,0,0.00,16
,20180419,280.55,280.55,281.3,281.35,280.55,281.35,281.05,.8,.5,10,281.08,12
,20180420,281.35,281.05,,,,281.05,281.05,0,0,0,0.00,12
,20180423,281.05,281.05,,,,281.05,281.05,0,0,0,0.00,12
,20180424,281.05,281.05,,,,281.05,281.05,0,0,0,0.00,12
,20180425,281.05,281.05,278.1,278.1,277.95,277.95,278.05,-3.1,-3,8,222.45,20
,20180426,277.95,278.05,277.7,277.7,277.25,277.25,277.4,-.8,-.65,6,166.44,18
,20180427,277.25,277.4,277.1,277.1,277.1,277.1,277.1,-.3,-.3,2,55.42,20
,20180502,277.1,277.1,275.5,275.6,275.5,275.6,275.55,-1.5,-1.55,4,110.22,24
,20180503,275.6,275.55,,,,275.55,275.55,0,0,0,0.00,24
,20180504,275.55,275.55,,,,275.55,275.55,0,0,0,0.00,24
,20180507,275.55,275.55,276.6,277.2,276.55,276.95,276.75,1.4,1.2,34,941.05,30
,20180508,276.95,276.75,,,,276.75,276.75,0,0,0,0.00,30
,20180509,276.75,276.75,,,,276.75,276.75,0,0,0,0.00,30
,20180510,276.75,276.75,,,,276.75,276.75,0,0,0,0.00,30
,20180511,276.75,276.75,276.85,276.9,276.75,276.75,276.8,0,.05,10,276.83,28
,20180514,276.75,276.8,,,,276.8,276.8,0,0,0,0.00,28
,20180515,276.8,276.8,,,,276.8,276.8,0,0,0,0.00,28
,20180516,276.8,276.8,,,,276.8,276.8,0,0,0,0.00,28
,20180517,276.8,276.8,,,,276.8,276.8,0,0,0,0.00,28
,20180518,276.8,276.8,272.15,272.15,272.15,272.15,272.15,-4.65,-4.65,2,54.43,28
,20180521,272.15,272.15,,,,272.15,272.15,0,0,0,0.00,28
,20180522,272.15,272.15,272.35,272.35,272.35,272.35,272.35,.2,.2,2,54.47,28
,20180523,272.35,272.35,272.55,272.7,272.55,272.7,272.55,.35,.2,8,218.07,30
,20180524,272.7,272.55,,,,273.4,273.4,.85,.85,0,0.00,30
,20180525,273.4,273.4,274.5,274.5,274.1,274.1,274.3,.7,.9,4,109.72,30
,20180528,274.1,274.3,275.75,276,275.3,275.95,275.65,1.65,1.35,10,275.67,34
,20180529,275.95,275.65,274.9,274.9,274.9,274.9,274.9,-.75,-.75,2,54.98,36
,20180530,274.9,274.9,275.3,275.3,275.3,275.3,275.3,.4,.4,2,55.06,36
,20180531,275.3,275.3,,,,275.45,275.45,.15,.15,0,0.00,36
au1904,20180316,280.5,280.5,,,,280.5,280.5,0,0,0,0.00,0
,20180319,280.5,280.5,,,,280.5,280.5,0,0,0,0.00,0
,20180320,280.5,280.5,,,,280.5,280.5,0,0,0,0.00,0
,20180321,280.5,280.5,,,,278.7,278.7,-1.8,-1.8,0,0.00,0
,20180322,278.7,278.7,,,,278.7,278.7,0,0,0,0.00,0
,20180323,278.7,278.7,,,,278.7,278.7,0,0,0,0.00,0
,20180326,278.7,278.7,280.9,282.45,280.9,282.45,281.65,3.75,2.95,4,112.67,2
,20180327,282.45,281.65,,,,281.65,281.65,0,0,0,0.00,2
,20180328,281.65,281.65,280.75,280.75,280.75,280.75,280.75,-.9,-.9,2,56.15,2
,20180329,280.75,280.75,,,,280.75,280.75,0,0,0,0.00,2
,20180330,280.75,280.75,,,,280.75,280.75,0,0,0,0.00,2
,20180402,280.75,280.75,,,,280.7,280.7,-.05,-.05,0,0.00,2
,20180403,280.7,280.7,,,,280.7,280.7,0,0,0,0.00,2
,20180404,280.7,280.7,,,,280.7,280.7,0,0,0,0.00,2
,20180409,280.7,280.7,,,,280.7,280.7,0,0,0,0.00,2
,20180410,280.7,280.7,,,,280.7,280.7,0,0,0,0.00,2
,20180411,280.7,280.7,,,,280.7,280.7,0,0,0,0.00,2
,20180412,280.7,280.7,,,,280.7,280.7,0,0,0,0.00,2
,20180413,280.7,280.7,279.35,279.35,279.35,279.35,279.35,-1.35,-1.35,2,55.87,4
,20180416,279.35,279.35,280.25,281.3,280.25,281.2,281,1.85,1.65,10,281.03,12
,20180417,281.2,281,,,,281,281,0,0,0,0.00,12
,20180418,281,281,284.7,284.7,280.65,280.65,282.65,-.35,1.65,4,113.07,14
,20180419,280.65,282.65,282.2,282.2,281.85,281.85,282,-.8,-.65,8,225.63,16
,20180420,281.85,282,,,,282,282,0,0,0,0.00,16
,20180423,282,282,279.55,279.55,279.4,279.4,279.45,-2.6,-2.55,4,111.79,18
,20180424,279.4,279.45,279.3,279.3,279.3,279.3,279.3,-.15,-.15,2,55.86,20
,20180425,279.3,279.3,279.25,279.35,279.25,279.35,279.3,.05,0,4,111.72,24
,20180426,279.35,279.3,,,,279.3,279.3,0,0,0,0.00,24
,20180427,279.3,279.3,278.4,278.8,278.4,278.45,278.6,-.85,-.7,8,222.89,30
,20180502,278.45,278.6,278.45,278.45,277.95,278,278.2,-.6,-.4,26,723.33,54
,20180503,278,278.2,277.65,278.85,277.65,278.85,278.25,.65,.05,4,111.30,56
,20180504,278.85,278.25,,,,278.25,278.25,0,0,0,0.00,56
,20180507,278.25,278.25,278.85,278.85,278.85,278.85,278.85,.6,.6,2,55.77,58
,20180508,278.85,278.85,279.25,279.4,279.25,279.4,279.3,.55,.45,10,279.31,60
,20180509,279.4,279.3,278.3,279,278.05,279,278.6,-.3,-.7,68,"1,894.57",104
,20180510,279,278.6,278.95,281,278.65,279.15,279.6,.55,1,66,"1,845.68",128
,20180511,279.15,279.6,280.9,280.9,279.6,279.6,280.25,0,.65,30,840.76,136
,20180514,279.6,280.25,279.75,280,279.75,280,279.85,-.25,-.4,4,111.95,138
,20180515,280,279.85,279.8,279.8,279,279,279.4,-.85,-.45,4,111.76,138
,20180516,279,279.4,275.9,276.2,275.55,276.1,275.9,-3.3,-3.5,16,441.47,140
,20180517,276.1,275.9,274.7,275.5,274.25,274.25,274.55,-1.65,-1.35,20,549.12,140
,20180518,274.25,274.55,,,,274.55,274.55,0,0,0,0.00,140
,20180521,274.55,274.55,,,,274.55,274.55,0,0,0,0.00,140
,20180522,274.55,274.55,274.75,274.75,274.55,274.55,274.55,0,0,14,384.42,148
,20180523,274.55,274.55,275,275,274.7,274.7,274.95,.15,.4,16,439.92,152
,20180524,274.7,274.95,,,,274.95,274.95,0,0,0,0.00,152
,20180525,274.95,274.95,,,,274.95,274.95,0,0,0,0.00,152
,20180528,274.95,274.95,278.4,279.25,276.6,276.6,277.85,1.65,2.9,10,277.88,152
,20180529,276.6,277.85,277.75,277.75,277.75,277.75,277.75,-.1,-.1,2,55.55,152
,20180530,277.75,277.75,277.65,278.4,277.4,278.4,277.8,.65,.05,6,166.69,150
,20180531,278.4,277.8,279.2,279.2,278.65,278.65,278.9,.85,1.1,4,111.57,150
au1906,20180516,279.4,279.4,276.5,276.5,274.9,275.2,275.45,-4.2,-3.95,22,606.03,8
,20180517,275.2,275.45,274.55,274.55,273.7,273.8,273.95,-1.65,-1.5,20,547.98,24
,20180518,273.8,273.95,274.1,274.25,271.15,274.25,273.5,.3,-.45,10,273.54,26
,20180521,274.25,273.5,,,,273.5,273.5,0,0,0,0.00,26
,20180522,273.5,273.5,274.5,274.6,274.2,274.2,274.4,.7,.9,6,164.66,30
,20180523,274.2,274.4,274.8,274.8,274.4,274.4,274.5,0,.1,6,164.72,34
,20180524,274.4,274.5,275.8,276.05,275.5,276.05,275.8,1.55,1.3,12,330.98,42
,20180525,276.05,275.8,279.6,279.6,277.35,277.35,278.45,1.55,2.65,4,111.39,44
,20180528,277.35,278.45,277.4,277.4,276.35,276.35,276.8,-2.1,-1.65,22,608.98,52
,20180529,276.35,276.8,277.1,277.55,277.1,277.5,277.4,.7,.6,8,221.93,60
,20180530,277.5,277.4,278.95,278.95,277.45,278.1,278.3,.7,.9,14,389.63,68
,20180531,278.1,278.3,279.25,279.25,278.05,278.7,278.4,.4,.1,18,501.20,68
bu1801,20180102,2420,2418,2426,2474,2422,2470,2448,52,30,832,"2,037.77",9462
,20180103,2470,2448,2460,2472,2456,2458,2460,10,12,98,241.08,9396
,20180104,2458,2460,2452,2490,2450,2482,2468,22,8,526,"1,298.33",8946
,20180105,2482,2468,2472,2500,2452,2488,2476,20,8,416,"1,030.21",8668
,20180108,2488,2476,2500,2500,2466,2474,2480,-2,4,1110,"2,753.72",8586
,20180109,2474,2480,2474,2514,2474,2500,2494,20,14,2494,"6,220.04",9460
,20180110,2500,2494,2500,2548,2480,2500,2506,6,12,900,"2,255.70",9660
,20180111,2500,2506,2570,2570,2500,2500,2568,-6,62,1002,"2,575.00",8660
,20180112,2500,2568,,,,2530,2530,-38,-38,0,0.00,8660
,20180115,2530,2530,2550,2580,2400,2580,2520,50,-10,316,796.80,8960
bu1802,20180102,2476,2476,2484,2484,2484,2484,2484,8,8,4,9.94,12
,20180103,2484,2484,2494,2494,2494,2494,2494,10,10,2,4.99,14
,20180104,2494,2494,,,,2494,2494,0,0,0,0.00,14
,20180105,2494,2494,2492,2526,2492,2526,2508,32,14,4,10.04,16
,20180108,2526,2508,,,,2508,2508,0,0,0,0.00,16
,20180109,2508,2508,,,,2522,2522,14,14,0,0.00,16
,20180110,2522,2522,,,,2534,2534,12,12,0,0.00,16
,20180111,2534,2534,,,,2534,2534,0,0,0,0.00,16
,20180112,2534,2534,,,,2560,2560,26,26,0,0.00,16
,20180115,2560,2560,,,,2550,2550,-10,-10,0,0.00,16
,20180116,2550,2550,,,,2550,2550,0,0,0,0.00,16
,20180117,2550,2550,2654,2654,2602,2602,2628,52,78,4,10.51,14
,20180118,2602,2628,,,,2628,2628,0,0,0,0.00,14
,20180119,2628,2628,2508,2512,2492,2512,2506,-116,-122,14,35.09,14
,20180122,2512,2506,2506,2506,2506,2506,2506,0,0,2,5.01,12
,20180123,2506,2506,,,,2506,2506,0,0,0,0.00,12
,20180124,2506,2506,,,,2506,2506,0,0,0,0.00,12
,20180125,2506,2506,,,,2506,2506,0,0,0,0.00,12
,20180126,2506,2506,2606,2654,2606,2654,2644,148,138,12,31.73,12
,20180129,2654,2644,,,,2644,2644,0,0,0,0.00,12
,20180130,2644,2644,2724,2724,2724,2724,2724,80,80,4,10.90,12
,20180131,2724,2724,2580,2736,2580,2736,2658,12,-66,4,10.63,12
,20180201,2736,2658,2738,2738,2736,2736,2736,78,78,6,16.42,6
,20180202,2736,2736,,,,2736,2736,0,0,0,0.00,6
,20180205,2736,2736,2574,2574,2574,2574,2574,-162,-162,2,5.15,6
,20180206,2574,2574,2508,2508,2508,2508,2508,-66,-66,2,5.02,6
,20180207,2508,2508,2358,2358,2358,2358,2358,-150,-150,2,4.72,4
,20180208,2358,2358,,,,2358,2358,0,0,0,0.00,4
,20180209,2358,2358,,,,2358,2358,0,0,0,0.00,4
bu1803,20180102,2518,2518,2566,2588,2566,2576,2576,58,58,6,15.46,90
,20180103,2576,2576,,,,2576,2576,0,0,0,0.00,90
,20180104,2576,2576,,,,2584,2584,8,8,0,0.00,90
,20180105,2584,2584,2622,2630,2584,2584,2600,0,16,12,31.21,94
,20180108,2584,2600,2536,2536,2536,2536,2536,-64,-64,4,10.14,94
,20180109,2536,2536,,,,2564,2564,28,28,0,0.00,94
,20180110,2564,2564,,,,2564,2564,0,0,0,0.00,94
,20180111,2564,2564,2660,2662,2640,2640,2656,76,92,26,69.08,92
,20180112,2640,2656,,,,2656,2656,0,0,0,0.00,92
,20180115,2656,2656,2594,2672,2594,2658,2640,2,-16,8,21.13,94
,20180116,2658,2640,2670,2670,2668,2668,2668,28,28,6,16.01,88
,20180117,2668,2668,2620,2660,2620,2660,2640,-8,-28,4,10.56,88
,20180118,2660,2640,,,,2640,2640,0,0,0,0.00,88
,20180119,2640,2640,2612,2614,2596,2614,2604,-26,-36,8,20.84,90
,20180122,2614,2604,2622,2622,2616,2616,2618,12,14,4,10.48,88
,20180123,2616,2618,2610,2618,2582,2618,2608,0,-10,50,130.46,86
,20180124,2618,2608,2634,2704,2634,2702,2694,94,86,120,323.37,154
,20180125,2702,2694,2732,2792,2730,2780,2748,86,54,296,813.94,434
,20180126,2780,2748,2762,2788,2732,2788,2768,40,20,36,99.65,446
,20180129,2788,2768,2792,2792,2792,2792,2792,24,24,198,552.82,644
,20180130,2792,2792,2762,2774,2732,2732,2756,-60,-36,50,137.80,598
,20180131,2732,2756,2730,2744,2728,2744,2728,-12,-28,82,223.76,516
,20180201,2744,2728,2774,2784,2736,2736,2756,8,28,14,38.61,504
,20180202,2736,2756,2778,2778,2778,2778,2778,22,22,2,5.56,504
,20180205,2778,2778,2730,2730,2698,2698,2710,-80,-68,14,37.96,490
,20180206,2698,2710,2698,2728,2668,2728,2696,18,-14,156,420.78,366
,20180207,2728,2696,2692,2698,2678,2698,2688,2,-8,6,16.14,366
,20180208,2698,2688,2668,2686,2638,2638,2654,-50,-34,252,669.19,120
,20180209,2638,2654,2638,2648,2638,2648,2638,-6,-16,60,158.30,60
,20180212,2648,2638,2676,2676,2608,2608,2642,-30,4,4,10.57,60
,20180213,2608,2642,,,,2630,2630,-12,-12,0,0.00,60
,20180214,2630,2630,,,,2610,2610,-20,-20,0,0.00,60
,20180222,2610,2610,,,,2610,2610,0,0,0,0.00,60
,20180223,2610,2610,,,,2638,2638,28,28,0,0.00,60
,20180226,2638,2638,2656,2656,2656,2656,2656,18,18,2,5.31,60
,20180227,2656,2656,,,,2656,2656,0,0,0,0.00,60
,20180228,2656,2656,,,,2656,2656,0,0,0,0.00,60
,20180301,2656,2656,,,,2656,2656,0,0,0,0.00,60
,20180302,2656,2656,,,,2656,2656,0,0,0,0.00,60
,20180305,2656,2656,,,,2656,2656,0,0,0,0.00,60
,20180306,2656,2656,2656,2656,2656,2656,2656,0,0,2,5.31,60
,20180307,2656,2656,2628,2656,2628,2656,2642,0,-14,4,10.57,56
,20180308,2656,2642,2542,2542,2542,2542,2542,-100,-100,2,5.08,56
,20180309,2542,2542,,,,2542,2542,0,0,0,0.00,56
,20180312,2542,2542,2554,2554,2528,2528,2540,-14,-2,4,10.16,56
,20180313,2528,2540,,,,2540,2540,0,0,0,0.00,56
,20180314,2540,2540,,,,2540,2540,0,0,0,0.00,56
,20180315,2540,2540,,,,2540,2540,0,0,0,0.00,56
bu1804,20180102,2516,2516,,,,2574,2574,58,58,0,0.00,6
,20180103,2574,2574,,,,2574,2574,0,0,0,0.00,6
,20180104,2574,2574,,,,2574,2574,0,0,0,0.00,6
,20180105,2574,2574,,,,2574,2574,0,0,0,0.00,6
,20180108,2574,2574,,,,2574,2574,0,0,0,0.00,6
,20180109,2574,2574,2608,2680,2608,2634,2640,60,66,16,42.26,8
,20180110,2634,2640,2644,2644,2644,2644,2644,4,4,2,5.29,8
,20180111,2644,2644,,,,2644,2644,0,0,0,0.00,8
,20180112,2644,2644,2660,2660,2660,2660,2660,16,16,2,5.32,6
,20180115,2660,2660,2674,2674,2674,2674,2674,14,14,2,5.35,8
,20180116,2674,2674,,,,2674,2674,0,0,0,0.00,8
,20180117,2674,2674,2672,2672,2656,2656,2664,-18,-10,4,10.66,4
,20180118,2656,2664,,,,2664,2664,0,0,0,0.00,4
,20180119,2664,2664,,,,2664,2664,0,0,0,0.00,4
,20180122,2664,2664,,,,2676,2676,12,12,0,0.00,4
,20180123,2676,2676,,,,2676,2676,0,0,0,0.00,4
,20180124,2676,2676,,,,2764,2764,88,88,0,0.00,4
,20180125,2764,2764,,,,2820,2820,56,56,0,0.00,4
,20180126,2820,2820,,,,2820,2820,0,0,0,0.00,4
,20180129,2820,2820,,,,2820,2820,0,0,0,0.00,4
,20180130,2820,2820,,,,2820,2820,0,0,0,0.00,4
,20180131,2820,2820,,,,2820,2820,0,0,0,0.00,4
,20180201,2820,2820,,,,2850,2850,30,30,0,0.00,4
,20180202,2850,2850,,,,2872,2872,22,22,0,0.00,4
,20180205,2872,2872,,,,2802,2802,-70,-70,0,0.00,4
,20180206,2802,2802,,,,2788,2788,-14,-14,0,0.00,4
,20180207,2788,2788,,,,2780,2780,-8,-8,0,0.00,4
,20180208,2780,2780,,,,2746,2746,-34,-34,0,0.00,4
,20180209,2746,2746,,,,2728,2728,-18,-18,0,0.00,4
,20180212,2728,2728,,,,2732,2732,4,4,0,0.00,4
,20180213,2732,2732,,,,2732,2732,0,0,0,0.00,4
,20180214,2732,2732,,,,2732,2732,0,0,0,0.00,4
,20180222,2732,2732,2672,2672,2644,2644,2662,-88,-70,6,15.98,6
,20180223,2644,2662,2674,2674,2674,2674,2674,12,12,2,5.35,4
,20180226,2674,2674,,,,2692,2692,18,18,0,0.00,4
,20180227,2692,2692,,,,2692,2692,0,0,0,0.00,4
,20180228,2692,2692,,,,2692,2692,0,0,0,0.00,4
,20180301,2692,2692,,,,2692,2692,0,0,0,0.00,4
,20180302,2692,2692,,,,2692,2692,0,0,0,0.00,4
,20180305,2692,2692,2736,2736,2736,2736,2736,44,44,2,5.47,4
,20180306,2736,2736,,,,2736,2736,0,0,0,0.00,4
,20180307,2736,2736,2624,2624,2624,2624,2624,-112,-112,2,5.25,2
,20180308,2624,2624,,,,2624,2624,0,0,0,0.00,2
,20180309,2624,2624,,,,2624,2624,0,0,0,0.00,2
,20180312,2624,2624,,,,2622,2622,-2,-2,0,0.00,2
,20180313,2622,2622,,,,2622,2622,0,0,0,0.00,2
,20180314,2622,2622,,,,2622,2622,0,0,0,0.00,2
,20180315,2622,2622,,,,2622,2622,0,0,0,0.00,2
,20180316,2622,2622,,,,2622,2622,0,0,0,0.00,2
,20180319,2622,2622,,,,2622,2622,0,0,0,0.00,2
,20180320,2622,2622,,,,2622,2622,0,0,0,0.00,2
,20180321,2622,2622,2666,2666,2666,2666,2666,44,44,2,5.33,0
,20180322,2666,2666,,,,2666,2666,0,0,0,0.00,0
,20180323,2666,2666,,,,2666,2666,0,0,0,0.00,0
,20180326,2666,2666,,,,2666,2666,0,0,0,0.00,0
,20180327,2666,2666,,,,2666,2666,0,0,0,0.00,0
,20180328,2666,2666,,,,2666,2666,0,0,0,0.00,0
,20180329,2666,2666,,,,2666,2666,0,0,0,0.00,0
,20180330,2666,2666,,,,2666,2666,0,0,0,0.00,0
,20180402,2666,2666,,,,2666,2666,0,0,0,0.00,0
,20180403,2666,2666,,,,2666,2666,0,0,0,0.00,0
,20180404,2666,2666,,,,2666,2666,0,0,0,0.00,0
,20180409,2666,2666,,,,2666,2666,0,0,0,0.00,0
,20180410,2666,2666,,,,2666,2666,0,0,0,0.00,0
,20180411,2666,2666,,,,2666,2666,0,0,0,0.00,0
,20180412,2666,2666,,,,2666,2666,0,0,0,0.00,0
,20180413,2666,2666,,,,2666,2666,0,0,0,0.00,0
,20180416,2666,2666,,,,2666,2666,0,0,0,0.00,0
bu1805,20180102,2602,2596,2588,2662,2588,2646,2634,50,38,552,"1,454.42",244
,20180103,2646,2634,2638,2656,2632,2632,2644,-2,10,2538,"6,715.52",576
,20180104,2632,2644,2634,2672,2622,2668,2646,24,2,1030,"2,725.47",458
,20180105,2668,2646,2660,2688,2634,2676,2656,30,10,970,"2,576.74",328
,20180108,2676,2656,2684,2698,2650,2662,2668,6,12,622,"1,660.70",254
,20180109,2662,2668,2674,2698,2666,2684,2680,16,12,338,906.22,236
,20180110,2684,2680,2690,2732,2674,2730,2710,50,30,824,"2,234.18",398
,20180111,2730,2710,2750,2750,2716,2722,2728,12,18,578,"1,576.80",340
,20180112,2722,2728,2740,2740,2714,2728,2724,0,-4,170,463.20,298
,20180115,2728,2724,2718,2784,2710,2778,2742,54,18,468,"1,283.27",372
,20180116,2778,2742,2774,2776,2732,2734,2760,-8,18,318,877.96,386
,20180117,2734,2760,2730,2770,2718,2738,2732,-22,-28,342,934.58,474
,20180118,2738,2732,2738,2756,2726,2726,2736,-6,4,320,876.07,362
,20180119,2726,2736,2736,2744,2698,2726,2714,-10,-22,392,"1,064.63",316
,20180122,2726,2714,2718,2766,2706,2756,2742,42,28,548,"1,503.55",420
,20180123,2756,2742,2756,2766,2724,2748,2748,6,6,446,"1,226.02",422
,20180124,2748,2748,2748,2832,2742,2828,2786,80,38,948,"2,641.43",540
,20180125,2828,2786,2838,2912,2820,2884,2880,98,94,1616,"4,654.84",942
,20180126,2884,2880,2880,2902,2856,2884,2880,4,0,1116,"3,214.18",1022
,20180129,2884,2880,2900,2926,2874,2896,2902,16,22,950,"2,758.60",1044
,20180130,2896,2902,2882,2886,2836,2858,2862,-44,-40,1226,"3,511.15",1082
,20180131,2858,2862,2862,2882,2834,2868,2852,6,-10,624,"1,780.17",1048
,20180201,2868,2852,2860,2896,2834,2844,2862,-8,10,976,"2,794.17",898
,20180202,2844,2862,2852,2898,2846,2852,2872,-10,10,600,"1,723.38",868
,20180205,2852,2872,2850,2852,2800,2832,2826,-40,-46,1028,"2,905.93",592
,20180206,2832,2826,2828,2844,2772,2778,2788,-48,-38,900,"2,510.31",600
,20180207,2778,2788,2778,2798,2778,2790,2788,2,0,302,842.40,616
,20180208,2790,2788,2778,2790,2734,2738,2748,-50,-40,702,"1,930.10",490
,20180209,2738,2748,2744,2758,2684,2718,2734,-30,-14,476,"1,301.46",356
,20180212,2718,2734,2716,2732,2674,2674,2692,-60,-42,672,"1,809.66",490
,20180213,2674,2692,2686,2688,2652,2672,2668,-20,-24,496,"1,324.18",468
,20180214,2672,2668,2670,2694,2630,2664,2660,-4,-8,532,"1,415.74",428
,20180222,2664,2660,2720,2732,2684,2708,2714,48,54,642,"1,743.05",536
,20180223,2708,2714,2728,2756,2726,2754,2738,40,24,804,"2,202.46",550
,20180226,2754,2738,2758,2784,2746,2768,2762,30,24,392,"1,083.44",538
,20180227,2768,2762,2762,2774,2732,2766,2758,4,-4,286,789.26,578
,20180228,2766,2758,2762,2810,2762,2770,2784,12,26,602,"1,677.03",590
,20180301,2770,2784,2778,2806,2736,2754,2758,-30,-26,466,"1,285.47",608
,20180302,2754,2758,2728,2756,2712,2744,2742,-14,-16,294,806.62,614
,20180305,2744,2742,2748,2794,2684,2690,2726,-52,-16,1050,"2,864.03",538
,20180306,2690,2726,2696,2712,2678,2696,2698,-30,-28,342,922.92,516
,20180307,2696,2698,2714,2724,2680,2690,2694,-8,-4,416,"1,121.08",526
,20180308,2690,2694,2688,2702,2670,2678,2686,-16,-8,248,666.16,530
,20180309,2678,2686,2684,2706,2586,2664,2680,-22,-6,644,"1,726.41",490
,20180312,2664,2680,2684,2728,2674,2706,2700,26,20,952,"2,570.46",402
,20180313,2706,2700,2694,2712,2632,2638,2672,-62,-28,574,"1,534.28",432
,20180314,2638,2672,2648,2654,2602,2636,2642,-36,-30,1492,"3,943.28",564
,20180315,2636,2642,2800,2800,2648,2666,2706,24,64,920,"2,489.89",362
,20180316,2666,2706,2666,2694,2654,2692,2668,-14,-38,292,779.19,320
,20180319,2692,2668,2696,2738,2686,2730,2708,62,40,606,"1,641.13",312
,20180320,2730,2708,2744,2760,2714,2754,2736,46,28,384,"1,051.29",314
,20180321,2754,2736,2754,2790,2748,2758,2770,22,34,422,"1,169.21",360
,20180322,2758,2770,2770,2788,2758,2774,2772,4,2,484,"1,341.74",414
,20180323,2774,2772,2760,2790,2704,2756,2756,-16,-16,1802,"4,967.18",664
,20180326,2756,2756,2756,2868,2738,2822,2814,66,58,1964,"5,529.39",808
,20180327,2822,2814,2822,2830,2798,2810,2812,-4,-2,890,"2,503.74",798
,20180328,2810,2812,2828,2832,2786,2796,2798,-16,-14,1200,"3,358.94",712
,20180329,2796,2798,2808,2832,2788,2828,2806,30,8,704,"1,975.76",710
,20180330,2828,2806,2830,2870,2804,2854,2836,48,30,670,"1,900.76",690
,20180402,2854,2836,2852,2860,2810,2814,2834,-22,-2,428,"1,213.79",660
,20180403,2814,2834,2806,2810,2756,2760,2772,-74,-62,830,"2,301.48",806
,20180404,2760,2772,2762,2770,2748,2750,2756,-22,-16,222,612.10,708
,20180409,2750,2756,2718,2732,2706,2712,2712,-44,-44,168,455.77,694
,20180410,2712,2712,2712,2780,2712,2776,2752,64,40,476,"1,310.77",812
,20180411,2776,2752,2788,2848,2788,2788,2810,36,58,454,"1,275.98",640
,20180412,2788,2810,2806,2812,2796,2806,2806,-4,-4,70,196.47,614
,20180413,2806,2806,2802,2802,2782,2782,2784,-24,-22,32,89.14,614
,20180416,2782,2784,2808,2838,2752,2758,2794,-26,10,186,519.86,632
,20180417,2758,2794,2770,2800,2756,2768,2780,-26,-14,220,611.88,594
,20180418,2768,2780,2784,2820,2784,2810,2806,30,26,132,370.63,586
,20180419,2810,2806,2814,2820,2814,2818,2816,12,10,8,22.54,586
,20180420,2818,2816,2822,2826,2792,2798,2808,-18,-8,34,95.52,580
,20180423,2798,2808,2798,2798,2774,2782,2788,-26,-20,24,66.94,568
,20180424,2782,2788,2784,2790,2756,2782,2770,-6,-18,154,426.72,564
,20180425,2782,2770,2760,2764,2694,2716,2722,-54,-48,326,887.99,372
,20180426,2716,2722,2726,2736,2720,2736,2728,14,6,84,229.31,300
,20180427,2736,2728,2740,2748,2566,2740,2722,12,-6,294,800.58,86
,20180502,2740,2722,2732,2814,2732,2814,2778,92,56,16,44.48,88
,20180503,2814,2778,2788,2788,2762,2780,2770,2,-8,18,49.89,78
,20180504,2780,2770,2784,2784,2784,2784,2784,14,14,2,5.57,78
,20180507,2784,2784,2802,2844,2778,2810,2812,26,28,12,33.76,76
,20180508,2810,2812,2834,2838,2802,2802,2808,-10,-4,56,157.26,76
,20180509,2802,2808,2788,2830,2788,2830,2808,22,0,4,11.24,74
,20180510,2830,2808,2842,2842,2808,2820,2824,12,16,18,50.84,64
,20180511,2820,2824,2840,2840,2840,2840,2840,16,16,12,34.08,70
,20180514,2840,2840,,,,2840,2840,0,0,0,0.00,70
,20180515,2840,2840,,,,2840,2840,0,0,0,0.00,70
bu1806,20180102,2622,2620,2626,2686,2618,2682,2656,62,36,440670,"1,171,299.72",383896
,20180103,2682,2656,2678,2684,2660,2662,2670,6,14,233234,"622,900.86",389628
,20180104,2662,2670,2666,2702,2646,2696,2676,26,6,369982,"990,187.26",403526
,20180105,2696,2676,2694,2712,2660,2698,2686,22,10,457546,"1,229,445.86",423280
,20180108,2698,2686,2690,2712,2676,2690,2692,4,6,333732,"898,524.11",434616
,20180109,2690,2692,2690,2730,2688,2712,2712,20,20,324530,"880,609.99",442126
,20180110,2712,2712,2718,2762,2700,2758,2732,46,20,473946,"1,294,980.71",461060
,20180111,2758,2732,2768,2768,2740,2750,2750,18,18,212658,"585,231.90",453842
,20180112,2750,2750,2758,2766,2738,2752,2752,2,2,269802,"742,614.36",459436
,20180115,2752,2752,2746,2814,2736,2808,2782,56,30,401540,"1,117,208.26",506050
,20180116,2808,2782,2806,2808,2762,2766,2784,-16,2,314638,"876,534.49",458366
,20180117,2766,2784,2762,2790,2744,2766,2764,-18,-20,344972,"953,654.70",454638
,20180118,2766,2764,2760,2786,2750,2764,2766,0,2,293892,"813,239.72",457720
,20180119,2764,2766,2766,2772,2724,2746,2742,-20,-24,471130,"1,292,313.53",443232
,20180122,2746,2742,2752,2794,2734,2784,2766,42,24,352890,"976,759.28",451564
,20180123,2784,2766,2782,2798,2752,2770,2776,4,10,418600,"1,162,331.80",429836
,20180124,2770,2776,2764,2866,2764,2862,2818,86,42,841058,"2,370,873.46",554584
,20180125,2862,2818,2864,2946,2852,2916,2900,98,82,676508,"1,963,024.42",582606
,20180126,2916,2900,2916,2934,2888,2914,2910,14,10,462044,"1,344,913.81",599582
,20180129,2914,2910,2912,2962,2908,2928,2936,18,26,402072,"1,180,491.32",612880
,20180130,2928,2936,2916,2926,2872,2894,2896,-42,-40,512788,"1,485,222.42",571470
,20180131,2894,2896,2890,2902,2864,2898,2882,2,-14,410402,"1,183,234.72",570572
,20180201,2898,2882,2898,2914,2862,2876,2884,-6,2,529036,"1,526,566.68",568992
,20180202,2876,2884,2884,2934,2874,2890,2900,6,16,516142,"1,497,325.26",566498
,20180205,2890,2900,2878,2886,2830,2864,2854,-36,-46,608716,"1,737,762.02",514632
,20180206,2864,2854,2862,2874,2796,2808,2824,-46,-30,553850,"1,564,952.09",492848
,20180207,2808,2824,2806,2832,2804,2814,2816,-10,-8,273800,"771,340.21",484854
,20180208,2814,2816,2800,2824,2762,2766,2784,-50,-32,434422,"1,210,107.08",470102
,20180209,2766,2784,2766,2788,2740,2742,2760,-42,-24,327778,"905,069.38",450106
,20180212,2742,2760,2740,2750,2700,2706,2722,-54,-38,354776,"966,332.29",448028
,20180213,2706,2722,2708,2720,2678,2698,2698,-24,-24,263494,"711,327.09",429990
,20180214,2698,2698,2696,2724,2652,2684,2692,-14,-6,306800,"826,456.18",407970
,20180222,2684,2692,2702,2740,2700,2730,2726,38,34,214510,"584,916.47",413674
,20180223,2730,2726,2734,2786,2732,2778,2764,52,38,331180,"915,383.33",428400
,20180226,2778,2764,2776,2810,2766,2794,2790,30,26,316642,"883,483.95",417402
,20180227,2794,2790,2790,2794,2772,2780,2780,-10,-10,229622,"638,604.17",417674
,20180228,2780,2780,2780,2832,2776,2796,2804,16,24,531636,"1,491,403.56",428044
,20180301,2796,2804,2800,2814,2756,2780,2782,-24,-22,430736,"1,198,424.61",427696
,20180302,2780,2782,2768,2778,2748,2770,2766,-12,-16,329000,"910,539.22",426388
,20180305,2770,2766,2766,2804,2716,2718,2760,-48,-6,624806,"1,724,685.51",452994
,20180306,2718,2760,2716,2738,2698,2728,2720,-32,-40,333572,"907,519.46",436596
,20180307,2728,2720,2738,2748,2704,2710,2720,-10,0,362636,"986,963.17",450554
,20180308,2710,2720,2716,2726,2690,2708,2708,-12,-12,341408,"925,124.84",443602
,20180309,2708,2708,2708,2736,2676,2696,2708,-12,0,473776,"1,283,298.39",429480
,20180312,2696,2708,2706,2746,2700,2730,2724,22,16,396740,"1,081,315.42",409222
,20180313,2730,2724,2724,2730,2660,2664,2696,-60,-28,554586,"1,495,891.02",444952
,20180314,2664,2696,2668,2688,2654,2674,2672,-22,-24,379370,"1,013,679.50",435640
,20180315,2674,2672,2686,2696,2672,2686,2682,14,10,292290,"784,004.74",426294
,20180316,2686,2682,2690,2726,2672,2716,2690,34,8,347432,"935,257.67",407606
,20180319,2716,2690,2714,2766,2710,2760,2736,70,46,466756,"1,277,933.85",406594
,20180320,2760,2736,2760,2788,2740,2780,2762,44,26,387620,"1,071,197.10",412738
,20180321,2780,2762,2788,2816,2774,2786,2790,24,28,491004,"1,370,699.60",399514
,20180322,2786,2790,2792,2816,2776,2800,2796,10,6,398050,"1,113,176.78",413502
,20180323,2800,2796,2792,2824,2752,2784,2784,-12,-12,861046,"2,398,302.46",385434
,20180326,2784,2784,2780,2892,2760,2844,2830,60,46,985028,"2,789,206.55",374354
,20180327,2844,2830,2838,2860,2822,2842,2836,12,6,434794,"1,233,696.88",367466
,20180328,2842,2836,2860,2860,2814,2832,2832,-4,-4,473558,"1,342,048.60",371740
,20180329,2832,2832,2836,2856,2808,2852,2832,20,0,489836,"1,387,834.14",382114
,20180330,2852,2832,2850,2896,2824,2886,2866,54,34,620556,"1,779,212.02",408494
,20180402,2886,2866,2882,2894,2832,2844,2856,-22,-10,448650,"1,281,702.55",381910
,20180403,2844,2856,2840,2846,2784,2792,2806,-64,-50,578092,"1,622,517.26",363618
,20180404,2792,2806,2796,2800,2772,2784,2786,-22,-20,325780,"908,084.54",343362
,20180409,2784,2786,2778,2778,2728,2746,2744,-40,-42,238672,"655,140.95",334656
,20180410,2746,2744,2756,2818,2748,2814,2788,70,44,429346,"1,197,472.37",322452
,20180411,2814,2788,2826,2854,2808,2818,2830,30,42,411416,"1,164,755.83",335568
,20180412,2818,2830,2826,2854,2824,2842,2834,12,4,389402,"1,104,291.32",339172
,20180413,2842,2834,2830,2852,2806,2834,2832,0,-2,356952,"1,011,064.66",343136
,20180416,2834,2832,2840,2872,2786,2790,2822,-42,-10,404754,"1,142,799.04",332424
,20180417,2790,2822,2794,2838,2786,2824,2812,2,-10,294914,"829,423.34",322122
,20180418,2824,2812,2810,2864,2798,2846,2836,34,24,403846,"1,145,918.86",337186
,20180419,2846,2836,2866,2880,2848,2862,2858,26,22,367118,"1,049,824.84",330084
,20180420,2862,2858,2864,2902,2824,2832,2862,-26,4,530818,"1,520,180.72",309836
,20180423,2832,2862,2828,2842,2806,2828,2824,-34,-38,287128,"810,866.50",287432
,20180424,2828,2824,2814,2846,2804,2830,2828,6,4,365168,"1,033,261.10",261846
,20180425,2830,2828,2826,2840,2758,2766,2788,-62,-40,506436,"1,412,585.96",258308
,20180426,2766,2788,2774,2792,2766,2784,2778,-4,-10,210350,"584,596.70",228662
,20180427,2784,2778,2790,2796,2778,2784,2786,6,8,184660,"514,544.63",199080
,20180502,2784,2786,2792,2858,2754,2852,2824,66,38,261140,"737,794.60",173492
,20180503,2852,2824,2848,2852,2836,2848,2842,24,18,123686,"351,715.96",157388
,20180504,2848,2842,2836,2876,2832,2850,2850,8,8,143166,"408,055.74",139316
,20180507,2850,2850,2850,2886,2842,2874,2858,24,8,122018,"348,855.09",116480
,20180508,2874,2858,2878,2894,2862,2870,2872,12,14,48544,"139,447.91",105716
,20180509,2870,2872,2872,2882,2852,2872,2868,0,-4,36014,"103,301.23",97222
,20180510,2872,2868,2870,2884,2860,2876,2872,8,4,51970,"149,285.42",81466
,20180511,2876,2872,2872,2900,2870,2896,2884,24,12,45270,"130,573.06",73406
,20180514,2896,2884,2900,2910,2874,2876,2888,-8,4,30698,"88,668.66",66914
,20180515,2876,2888,2884,2904,2876,2888,2888,0,0,23682,"68,435.41",59658
,20180516,2888,2888,2888,2912,2880,2896,2894,8,6,31128,"90,094.79",50750
,20180517,2896,2894,2884,2924,2884,2914,2902,20,8,20312,"58,963.58",47400
,20180518,2914,2902,2928,3076,2918,3076,3018,174,116,85098,"256,901.92",44110
,20180521,3076,3018,3070,3128,3042,3088,3082,70,64,50794,"156,568.54",36406
,20180522,3088,3082,3082,3110,3066,3088,3090,6,8,19370,"59,885.89",35374
,20180523,3088,3090,3096,3100,3032,3054,3066,-36,-24,21054,"64,588.70",31310
,20180524,3054,3066,3012,3062,3012,3046,3042,-20,-24,16668,"50,734.69",28754
,20180525,3046,3042,3038,3068,3036,3060,3050,18,8,12846,"39,202.97",25224
,20180528,3060,3050,3024,3044,3008,3044,3022,-6,-28,17086,"51,634.70",21044
,20180529,3044,3022,3042,3068,3020,3052,3044,30,22,8614,"26,223.16",19332
,20180530,3052,3044,2970,3076,2970,3014,3010,-30,-34,12350,"37,182.63",15150
,20180531,3014,3010,3016,3084,3008,3048,3048,38,38,6760,"20,606.62",13094
bu1807,20180116,2782,2782,,,,2782,2782,0,0,0,0.00,0
,20180117,2782,2782,,,,2782,2782,0,0,0,0.00,0
,20180118,2782,2782,2848,2848,2764,2764,2806,-18,24,4,11.22,2
,20180119,2764,2806,,,,2782,2782,-24,-24,0,0.00,2
,20180122,2782,2782,2784,2832,2784,2832,2808,50,26,4,11.23,2
,20180123,2832,2808,,,,2808,2808,0,0,0,0.00,2
,20180124,2808,2808,2756,2852,2756,2852,2818,44,10,6,16.92,4
,20180125,2852,2818,2886,2940,2886,2940,2886,122,68,104,300.30,104
,20180126,2940,2886,2918,2918,2918,2918,2918,32,32,2,5.84,106
,20180129,2918,2918,2962,2962,2962,2962,2962,44,44,2,5.92,108
,20180130,2962,2962,,,,2962,2962,0,0,0,0.00,108
,20180131,2962,2962,,,,2962,2962,0,0,0,0.00,108
,20180201,2962,2962,2880,2880,2880,2880,2880,-82,-82,20,57.60,88
,20180202,2880,2880,2912,2912,2912,2912,2912,32,32,2,5.82,86
,20180205,2912,2912,2842,2878,2842,2850,2858,-62,-54,78,222.98,76
,20180206,2850,2858,2820,2820,2820,2820,2820,-38,-38,4,11.28,76
,20180207,2820,2820,,,,2820,2820,0,0,0,0.00,76
,20180208,2820,2820,2812,2812,2800,2800,2806,-20,-14,70,196.42,6
,20180209,2800,2806,,,,2806,2806,0,0,0,0.00,6
,20180212,2806,2806,,,,2768,2768,-38,-38,0,0.00,6
,20180213,2768,2768,2710,2710,2710,2710,2710,-58,-58,2,5.42,8
,20180214,2710,2710,,,,2704,2704,-6,-6,0,0.00,8
,20180222,2704,2704,,,,2712,2712,8,8,0,0.00,8
,20180223,2712,2712,2786,2786,2786,2786,2786,74,74,2,5.57,8
,20180226,2786,2786,,,,2786,2786,0,0,0,0.00,8
,20180227,2786,2786,,,,2786,2786,0,0,0,0.00,8
,20180228,2786,2786,,,,2786,2786,0,0,0,0.00,8
,20180301,2786,2786,2832,2832,2782,2788,2800,2,14,6,16.80,4
,20180302,2788,2800,,,,2800,2800,0,0,0,0.00,4
,20180305,2800,2800,2746,2746,2746,2746,2746,-54,-54,2,5.49,2
,20180306,2746,2746,,,,2746,2746,0,0,0,0.00,2
,20180307,2746,2746,,,,2746,2746,0,0,0,0.00,2
,20180308,2746,2746,,,,2746,2746,0,0,0,0.00,2
,20180309,2746,2746,,,,2746,2746,0,0,0,0.00,2
,20180312,2746,2746,,,,2746,2746,0,0,0,0.00,2
,20180313,2746,2746,,,,2718,2718,-28,-28,0,0.00,2
,20180314,2718,2718,2702,2712,2702,2712,2706,-6,-12,4,10.83,2
,20180315,2712,2706,,,,2706,2706,0,0,0,0.00,2
,20180316,2706,2706,2728,2728,2728,2728,2728,22,22,2,5.46,4
,20180319,2728,2728,,,,2776,2776,48,48,0,0.00,4
,20180320,2776,2776,,,,2776,2776,0,0,0,0.00,4
,20180321,2776,2776,,,,2776,2776,0,0,0,0.00,4
,20180322,2776,2776,,,,2776,2776,0,0,0,0.00,4
,20180323,2776,2776,2940,2940,2778,2790,2878,14,102,82,236.10,42
,20180326,2790,2878,2868,2868,2868,2868,2868,-10,-10,2,5.74,42
,20180327,2868,2868,2872,2872,2872,2872,2872,4,4,2,5.74,44
,20180328,2872,2872,2860,2860,2860,2860,2860,-12,-12,2,5.72,42
,20180329,2860,2860,2860,2860,2860,2860,2860,0,0,4,11.44,40
,20180330,2860,2860,,,,2860,2860,0,0,0,0.00,40
,20180402,2860,2860,,,,2860,2860,0,0,0,0.00,40
,20180403,2860,2860,2810,2826,2800,2826,2812,-34,-48,6,16.87,40
,20180404,2826,2812,2836,2836,2780,2814,2810,2,-2,12,33.74,36
,20180409,2814,2810,2754,2754,2754,2754,2754,-56,-56,2,5.51,36
,20180410,2754,2754,2812,2836,2788,2836,2816,82,62,18,50.72,24
,20180411,2836,2816,2870,2870,2870,2870,2870,54,54,2,5.74,22
,20180412,2870,2870,,,,2870,2870,0,0,0,0.00,22
,20180413,2870,2870,,,,2870,2870,0,0,0,0.00,22
,20180416,2870,2870,,,,2854,2854,-16,-16,0,0.00,22
,20180417,2854,2854,2848,2856,2848,2856,2852,2,-2,8,22.82,14
,20180418,2856,2852,2852,2872,2848,2848,2856,-4,4,12,34.27,6
,20180419,2848,2856,2890,2890,2890,2890,2890,34,34,2,5.78,8
,20180420,2890,2890,,,,2890,2890,0,0,0,0.00,8
,20180423,2890,2890,,,,2876,2876,-14,-14,0,0.00,8
,20180424,2876,2876,2862,2862,2862,2862,2862,-14,-14,2,5.72,8
,20180425,2862,2862,2822,2822,2822,2822,2822,-40,-40,2,5.64,6
,20180426,2822,2822,2820,2820,2820,2820,2820,-2,-2,2,5.64,6
,20180427,2820,2820,,,,2820,2820,0,0,0,0.00,6
,20180502,2820,2820,,,,2820,2820,0,0,0,0.00,6
,20180503,2820,2820,,,,2820,2820,0,0,0,0.00,6
,20180504,2820,2820,2890,2890,2874,2874,2882,54,62,4,11.53,6
,20180507,2874,2882,,,,2882,2882,0,0,0,0.00,6
,20180508,2882,2882,,,,2882,2882,0,0,0,0.00,6
,20180509,2882,2882,,,,2882,2882,0,0,0,0.00,6
,20180510,2882,2882,,,,2902,2902,20,20,0,0.00,6
,20180511,2902,2902,2918,2934,2918,2934,2924,32,22,6,17.55,4
,20180514,2934,2924,,,,2924,2924,0,0,0,0.00,4
,20180515,2924,2924,,,,2924,2924,0,0,0,0.00,4
,20180516,2924,2924,,,,2924,2924,0,0,0,0.00,4
,20180517,2924,2924,,,,2924,2924,0,0,0,0.00,4
,20180518,2924,2924,3096,3098,2966,3028,3028,104,104,178,539.32,52
,20180521,3028,3028,3020,3114,2994,3104,3038,76,10,80,243.06,8
,20180522,3104,3038,3116,3116,3116,3116,3116,78,78,2,6.23,8
,20180523,3116,3116,3134,3136,2952,2952,3022,-164,-94,66,199.55,46
,20180524,2952,3022,2954,3030,2954,2968,2976,-54,-46,28,83.35,42
,20180525,2968,2976,3048,3050,2960,3046,3024,70,48,94,284.38,10
,20180528,3046,3024,3006,3012,2972,2998,2992,-26,-32,14,41.89,6
,20180529,2998,2992,,,,2992,2992,0,0,0,0.00,6
,20180530,2992,2992,,,,2992,2992,0,0,0,0.00,6
,20180531,2992,2992,3066,3132,3060,3062,3084,70,92,20,61.71,8
bu1808,20180212,2806,2806,,,,2806,2806,0,0,0,0.00,0
,20180213,2806,2806,,,,2806,2806,0,0,0,0.00,0
,20180214,2806,2806,2702,2702,2702,2702,2702,-104,-104,2,5.40,2
,20180222,2702,2702,,,,2736,2736,34,34,0,0.00,2
,20180223,2736,2736,,,,2810,2810,74,74,0,0.00,2
,20180226,2810,2810,,,,2810,2810,0,0,0,0.00,2
,20180227,2810,2810,,,,2810,2810,0,0,0,0.00,2
,20180228,2810,2810,,,,2810,2810,0,0,0,0.00,2
,20180301,2810,2810,2782,2782,2782,2782,2782,-28,-28,2,5.56,0
,20180302,2782,2782,,,,2782,2782,0,0,0,0.00,0
,20180305,2782,2782,,,,2728,2728,-54,-54,0,0.00,0
,20180306,2728,2728,,,,2688,2688,-40,-40,0,0.00,0
,20180307,2688,2688,,,,2688,2688,0,0,0,0.00,0
,20180308,2688,2688,,,,2676,2676,-12,-12,0,0.00,0
,20180309,2676,2676,,,,2676,2676,0,0,0,0.00,0
,20180312,2676,2676,,,,2692,2692,16,16,0,0.00,0
,20180313,2692,2692,,,,2692,2692,0,0,0,0.00,0
,20180314,2692,2692,,,,2680,2680,-12,-12,0,0.00,0
,20180315,2680,2680,,,,2690,2690,10,10,0,0.00,0
,20180316,2690,2690,,,,2710,2710,20,20,0,0.00,0
,20180319,2710,2710,,,,2758,2758,48,48,0,0.00,0
,20180320,2758,2758,,,,2784,2784,26,26,0,0.00,0
,20180321,2784,2784,,,,2812,2812,28,28,0,0.00,0
,20180322,2812,2812,,,,2818,2818,6,6,0,0.00,0
,20180323,2818,2818,,,,2818,2818,0,0,0,0.00,0
,20180326,2818,2818,,,,2808,2808,-10,-10,0,0.00,0
,20180327,2808,2808,,,,2810,2810,2,2,0,0.00,0
,20180328,2810,2810,,,,2798,2798,-12,-12,0,0.00,0
,20180329,2798,2798,,,,2798,2798,0,0,0,0.00,0
,20180330,2798,2798,2916,2934,2864,2934,2898,136,100,10,28.99,4
,20180402,2934,2898,,,,2898,2898,0,0,0,0.00,4
,20180403,2898,2898,,,,2848,2848,-50,-50,0,0.00,4
,20180404,2848,2848,,,,2848,2848,0,0,0,0.00,4
,20180409,2848,2848,2824,2824,2784,2784,2804,-64,-44,4,11.22,4
,20180410,2784,2804,2902,2902,2842,2842,2872,38,68,4,11.49,6
,20180411,2842,2872,2884,2884,2858,2858,2870,-14,-2,4,11.48,4
,20180412,2858,2870,2906,2918,2870,2918,2894,48,24,12,34.73,4
,20180413,2918,2894,,,,2894,2894,0,0,0,0.00,4
,20180416,2894,2894,,,,2894,2894,0,0,0,0.00,4
,20180417,2894,2894,,,,2894,2894,0,0,0,0.00,4
,20180418,2894,2894,2880,2880,2880,2880,2880,-14,-14,2,5.76,4
,20180419,2880,2880,2892,2892,2856,2856,2874,-24,-6,4,11.50,6
,20180420,2856,2874,,,,2874,2874,0,0,0,0.00,6
,20180423,2874,2874,,,,2874,2874,0,0,0,0.00,6
,20180424,2874,2874,,,,2874,2874,0,0,0,0.00,6
,20180425,2874,2874,,,,2874,2874,0,0,0,0.00,6
,20180426,2874,2874,,,,2870,2870,-4,-4,0,0.00,6
,20180427,2870,2870,,,,2870,2870,0,0,0,0.00,6
,20180502,2870,2870,2898,2898,2898,2898,2898,28,28,4,11.59,6
,20180503,2898,2898,,,,2898,2898,0,0,0,0.00,6
,20180504,2898,2898,,,,2898,2898,0,0,0,0.00,6
,20180507,2898,2898,,,,2906,2906,8,8,0,0.00,6
,20180508,2906,2906,,,,2906,2906,0,0,0,0.00,6
,20180509,2906,2906,,,,2902,2902,-4,-4,0,0.00,6
,20180510,2902,2902,,,,2902,2902,0,0,0,0.00,6
,20180511,2902,2902,,,,2924,2924,22,22,0,0.00,6
,20180514,2924,2924,,,,2924,2924,0,0,0,0.00,6
,20180515,2924,2924,,,,2924,2924,0,0,0,0.00,6
,20180516,2924,2924,2910,2928,2910,2928,2918,4,-6,4,11.68,10
,20180517,2928,2918,,,,2918,2918,0,0,0,0.00,10
,20180518,2918,2918,2992,3090,2970,3088,3038,170,120,24,72.96,12
,20180521,3088,3038,3044,3070,3030,3066,3056,28,18,10,30.56,14
,20180522,3066,3056,,,,3066,3066,10,10,0,0.00,14
,20180523,3066,3066,3010,3036,3010,3010,3016,-56,-50,8,24.13,20
,20180524,3010,3016,3080,3080,3032,3032,3054,16,38,12,36.66,18
,20180525,3032,3054,,,,3054,3054,0,0,0,0.00,18
,20180528,3054,3054,2940,3034,2940,3034,2990,-20,-64,6,17.95,16
,20180529,3034,2990,,,,2990,2990,0,0,0,0.00,16
,20180530,2990,2990,,,,2990,2990,0,0,0,0.00,16
,20180531,2990,2990,,,,3036,3036,46,46,0,0.00,16
bu1809,20180102,2706,2694,2718,2766,2718,2766,2742,72,48,78,213.91,1066
,20180103,2766,2742,2778,2778,2742,2746,2752,4,10,206,567.10,1074
,20180104,2746,2752,2742,2786,2736,2768,2758,16,6,206,568.23,1142
,20180105,2768,2758,2754,2786,2700,2780,2760,22,2,368,"1,015.72",1200
,20180108,2780,2760,2770,2794,2760,2766,2770,6,10,208,576.19,1254
,20180109,2766,2770,2762,2804,2762,2784,2788,14,18,216,602.46,1224
,20180110,2784,2788,2796,2830,2782,2830,2812,42,24,166,467.04,1242
,20180111,2830,2812,2832,2832,2816,2824,2824,12,12,44,124.28,1236
,20180112,2824,2824,2824,2834,2814,2820,2822,-4,-2,86,242.74,1242
,20180115,2820,2822,2820,2874,2812,2864,2850,42,28,178,507.48,1292
,20180116,2864,2850,2864,2864,2828,2834,2840,-16,-10,48,136.37,1260
,20180117,2834,2840,2822,2842,2812,2820,2822,-20,-18,150,423.51,1326
,20180118,2820,2822,2820,2842,2812,2828,2824,6,2,120,338.97,1308
,20180119,2828,2824,2826,2834,2802,2812,2808,-12,-16,112,314.64,1266
,20180122,2812,2808,2816,2862,2808,2854,2846,46,38,158,449.98,1336
,20180123,2854,2846,2854,2874,2824,2842,2848,-4,2,140,398.86,1358
,20180124,2842,2848,2844,2920,2844,2918,2888,70,40,532,"1,536.74",1714
,20180125,2918,2888,2914,2990,2908,2978,2966,90,78,1906,"5,655.38",2330
,20180126,2978,2966,2962,2994,2948,2966,2976,0,10,622,"1,851.78",2462
,20180129,2966,2976,2976,3002,2970,2976,2990,0,14,910,"2,721.57",2732
,20180130,2976,2990,2964,2964,2922,2940,2946,-50,-44,462,"1,361.22",2604
,20180131,2940,2946,2938,2950,2910,2950,2930,4,-16,428,"1,254.74",2656
,20180201,2950,2930,2946,2962,2916,2926,2930,-4,0,526,"1,541.54",2866
,20180202,2926,2930,2924,2978,2924,2932,2948,2,18,188,554.47,2906
,20180205,2932,2948,2932,2934,2878,2918,2900,-30,-48,534,"1,549.50",2924
,20180206,2918,2900,2904,2920,2850,2860,2870,-40,-30,516,"1,481.43",2790
,20180207,2860,2870,2872,2886,2852,2866,2860,-4,-10,518,"1,481.83",2646
,20180208,2866,2860,2866,2870,2814,2822,2828,-38,-32,916,"2,591.68",2196
,20180209,2822,2828,2830,2836,2788,2788,2804,-40,-24,352,987.47,2090
,20180212,2788,2804,2792,2798,2746,2748,2758,-56,-46,1696,"4,679.78",2432
,20180213,2748,2758,2758,2764,2724,2728,2736,-30,-22,1152,"3,153.47",2478
,20180214,2728,2736,2730,2810,2686,2718,2724,-18,-12,1290,"3,515.12",2928
,20180222,2718,2724,2748,2764,2732,2746,2744,22,20,1230,"3,375.94",3164
,20180223,2746,2744,2750,2804,2748,2804,2776,60,32,1790,"4,971.18",3168
,20180226,2804,2776,2806,2834,2778,2816,2808,40,32,1462,"4,105.52",3558
,20180227,2816,2808,2808,2818,2794,2806,2806,-2,-2,674,"1,891.25",3606
,20180228,2806,2806,2810,2848,2804,2818,2824,12,18,760,"2,146.33",3558
,20180301,2818,2824,2816,2836,2788,2806,2808,-18,-16,778,"2,185.14",3658
,20180302,2806,2808,2796,2808,2778,2792,2794,-16,-14,372,"1,039.73",3658
,20180305,2792,2794,2796,2830,2750,2756,2776,-38,-18,1758,"4,882.01",3858
,20180306,2756,2776,2750,2784,2740,2772,2758,-4,-18,1002,"2,764.67",3530
,20180307,2772,2758,2780,2792,2750,2750,2766,-8,8,522,"1,443.96",3630
,20180308,2750,2766,2756,2760,2710,2750,2746,-16,-20,698,"1,917.01",3746
,20180309,2750,2746,2754,2772,2724,2742,2748,-4,2,772,"2,121.48",3674
,20180312,2742,2748,2756,2792,2746,2780,2766,32,18,498,"1,378.11",3600
,20180313,2780,2766,2768,2772,2710,2710,2740,-56,-26,948,"2,597.60",3776
,20180314,2710,2740,2724,2742,2708,2726,2728,-14,-12,1442,"3,936.16",3822
,20180315,2726,2728,2736,2748,2726,2736,2734,8,6,506,"1,384.04",3756
,20180316,2736,2734,2736,2774,2730,2766,2746,32,12,412,"1,131.62",3750
,20180319,2766,2746,2774,2810,2760,2804,2788,58,42,2542,"7,090.13",3862
,20180320,2804,2788,2808,2822,2788,2822,2802,34,14,1324,"3,710.61",3870
,20180321,2822,2802,2834,2848,2812,2820,2830,18,28,1758,"4,975.63",3738
,20180322,2820,2830,2830,2846,2816,2838,2832,8,2,1588,"4,497.87",3902
,20180323,2838,2832,2828,2848,2784,2808,2814,-24,-18,3694,"10,397.99",4178
,20180326,2808,2814,2812,2926,2788,2890,2866,76,52,6160,"17,666.79",5266
,20180327,2890,2866,2884,2904,2868,2892,2886,26,20,3990,"11,516.14",5236
,20180328,2892,2886,2906,2910,2862,2870,2878,-16,-8,2834,"8,158.47",5392
,20180329,2870,2878,2896,2896,2854,2882,2872,4,-6,2708,"7,781.33",5392
,20180330,2882,2872,2872,2928,2868,2922,2900,50,28,4182,"12,127.97",5598
,20180402,2922,2900,2918,2922,2870,2884,2890,-16,-10,2448,"7,074.87",5420
,20180403,2884,2890,2872,2874,2816,2824,2840,-66,-50,6600,"18,753.82",5748
,20180404,2824,2840,2832,2840,2818,2826,2828,-14,-12,2554,"7,224.21",6186
,20180409,2826,2828,2804,2808,2766,2800,2800,-28,-28,3914,"10,961.11",6662
,20180410,2800,2800,2810,2864,2806,2864,2838,64,38,4276,"12,138.52",6852
,20180411,2864,2838,2866,2898,2860,2868,2876,30,38,4224,"12,150.70",7430
,20180412,2868,2876,2882,2914,2872,2888,2884,12,8,2826,"8,150.91",7520
,20180413,2888,2884,2874,2894,2860,2888,2880,4,-4,2088,"6,014.07",7486
,20180416,2888,2880,2896,2918,2840,2842,2868,-38,-12,3602,"10,334.55",7310
,20180417,2842,2868,2848,2882,2840,2868,2862,0,-6,2162,"6,190.00",7210
,20180418,2868,2862,2856,2912,2844,2906,2890,44,28,3202,"9,257.74",7238
,20180419,2906,2890,2918,2936,2902,2926,2918,36,28,4204,"12,269.65",7774
,20180420,2926,2918,2936,2952,2890,2900,2924,-18,6,5604,"16,393.41",8078
,20180423,2900,2924,2890,2908,2880,2902,2892,-22,-32,5130,"14,836.17",8374
,20180424,2902,2892,2882,2922,2876,2914,2904,22,12,4772,"13,864.74",8118
,20180425,2914,2904,2910,2914,2844,2846,2874,-58,-30,7274,"20,907.95",8980
,20180426,2846,2874,2850,2878,2846,2874,2862,0,-12,7852,"22,478.40",12196
,20180427,2874,2862,2872,2880,2858,2860,2872,-2,10,4554,"13,080.69",13800
,20180502,2860,2872,2862,2936,2844,2934,2896,62,24,7850,"22,744.52",14808
,20180503,2934,2896,2938,2942,2922,2932,2930,36,34,8104,"23,752.68",17732
,20180504,2932,2930,2916,2958,2912,2938,2938,8,8,6686,"19,643.88",19196
,20180507,2938,2938,2944,2968,2936,2958,2950,20,12,6814,"20,114.16",19272
,20180508,2958,2950,2964,2984,2944,2958,2956,8,6,5146,"15,216.85",18886
,20180509,2958,2956,2960,2966,2932,2958,2952,2,-4,5058,"14,931.35",18370
,20180510,2958,2952,2960,2974,2946,2968,2962,16,10,8438,"24,999.72",20048
,20180511,2968,2962,2964,2994,2952,2990,2972,28,10,7472,"22,210.19",21490
,20180514,2990,2972,2982,3006,2976,2976,2988,4,16,5214,"15,579.89",22294
,20180515,2976,2988,2982,3002,2970,2982,2984,-6,-4,5560,"16,598.22",22202
,20180516,2982,2984,2994,3020,2974,2982,2998,-2,14,5956,"17,861.18",22178
,20180517,2982,2998,2982,3014,2974,2994,2990,-4,-8,5168,"15,456.67",22372
,20180518,2994,2990,3004,3168,3004,3164,3112,174,122,30634,"95,354.97",27762
,20180521,3164,3112,3118,3218,3118,3170,3166,58,54,26924,"85,248.32",28062
,20180522,3170,3166,3176,3200,3152,3170,3176,4,10,12018,"38,179.92",29018
,20180523,3170,3176,3172,3188,3110,3136,3146,-40,-30,15956,"50,208.87",26034
,20180524,3136,3146,3130,3140,3106,3122,3122,-24,-24,6854,"21,407.14",26500
,20180525,3122,3122,3100,3144,3098,3114,3118,-8,-4,7912,"24,677.80",26330
,20180528,3114,3118,3092,3092,3032,3068,3056,-50,-62,16804,"51,381.15",23830
,20180529,3068,3056,3064,3094,3054,3080,3076,24,20,7574,"23,311.43",23184
,20180530,3080,3076,3080,3112,3030,3072,3060,-4,-16,11052,"33,832.80",23444
,20180531,3072,3060,3078,3136,3068,3102,3106,42,46,10524,"32,688.06",24058
bu1810,20180417,2868,2868,2526,2894,2526,2892,2802,24,-66,10,28.03,0
,20180418,2892,2802,2930,2930,2846,2902,2896,100,94,26,75.32,8
,20180419,2902,2896,2932,2932,2932,2932,2932,36,36,2,5.86,6
,20180420,2932,2932,2992,2996,2926,2926,2956,-6,24,30,88.70,12
,20180423,2926,2956,2872,2908,2872,2908,2898,-48,-58,16,46.37,14
,20180424,2908,2898,2886,2958,2886,2940,2928,42,30,6,17.57,12
,20180425,2940,2928,,,,2928,2928,0,0,0,0.00,12
,20180426,2928,2928,,,,2928,2928,0,0,0,0.00,12
,20180427,2928,2928,,,,2938,2938,10,10,0,0.00,12
,20180502,2938,2938,2882,2950,2880,2938,2912,0,-26,38,110.71,6
,20180503,2938,2912,,,,2912,2912,0,0,0,0.00,6
,20180504,2912,2912,,,,2946,2946,34,34,0,0.00,6
,20180507,2946,2946,2952,2952,2952,2952,2952,6,6,20,59.04,24
,20180508,2952,2952,3004,3004,2976,2976,2998,24,46,10,29.98,18
,20180509,2976,2998,3008,3012,2946,3012,2968,14,-30,16,47.50,18
,20180510,3012,2968,3022,3022,2964,2996,2986,28,18,10,29.86,18
,20180511,2996,2986,2992,3014,2958,2974,2984,-12,-2,82,244.69,6
,20180514,2974,2984,3020,3020,2994,2994,3006,10,22,4,12.03,6
,20180515,2994,3006,2978,2978,2978,2978,2978,-28,-28,2,5.96,6
,20180516,2978,2978,3000,3000,3000,3000,3000,22,22,2,6.00,8
,20180517,3000,3000,,,,3000,3000,0,0,0,0.00,8
,20180518,3000,3000,3150,3152,3130,3130,3144,130,144,10,31.44,8
,20180521,3130,3144,3256,3258,3186,3186,3234,42,90,22,71.17,6
,20180522,3186,3234,3204,3244,3188,3192,3204,-42,-30,12,38.46,10
,20180523,3192,3204,3184,3184,3166,3166,3174,-38,-30,4,12.70,10
,20180524,3166,3174,3092,3134,3092,3134,3112,-40,-62,4,12.45,10
,20180525,3134,3112,,,,3112,3112,0,0,0,0.00,10
,20180528,3112,3112,3100,3100,2988,3058,3040,-54,-72,90,273.66,14
,20180529,3058,3040,3110,3118,3094,3118,3108,78,68,10,31.08,12
,20180530,3118,3108,3098,3098,3056,3056,3076,-52,-32,100,307.78,28
,20180531,3056,3076,3132,3132,3116,3116,3122,40,46,10,31.22,20
bu1811,20180516,2978,2978,,,,2978,2978,0,0,0,0.00,0
,20180517,2978,2978,,,,2978,2978,0,0,0,0.00,0
,20180518,2978,2978,,,,3120,3120,142,142,0,0.00,0
,20180521,3120,3120,,,,3210,3210,90,90,0,0.00,0
,20180522,3210,3210,,,,3210,3210,0,0,0,0.00,0
,20180523,3210,3210,3144,3220,3124,3220,3172,10,-38,8,25.39,2
,20180524,3220,3172,,,,3172,3172,0,0,0,0.00,2
,20180525,3172,3172,,,,3172,3172,0,0,0,0.00,2
,20180528,3172,3172,,,,3172,3172,0,0,0,0.00,2
,20180529,3172,3172,,,,3172,3172,0,0,0,0.00,2
,20180530,3172,3172,,,,3140,3140,-32,-32,0,0.00,2
,20180531,3140,3140,,,,3186,3186,46,46,0,0.00,2
bu1812,20180102,2784,2780,2786,2838,2782,2832,2810,52,30,2406,"6,765.14",17156
,20180103,2832,2810,2832,2832,2816,2818,2824,8,14,2014,"5,689.92",17306
,20180104,2818,2824,2824,2848,2806,2846,2830,22,6,2674,"7,567.74",18184
,20180105,2846,2830,2838,2860,2814,2852,2834,22,4,3198,"9,065.36",18382
,20180108,2852,2834,2844,2860,2832,2842,2846,8,12,2984,"8,493.26",18224
,20180109,2842,2846,2846,2876,2844,2858,2862,12,16,2750,"7,871.92",18736
,20180110,2858,2862,2858,2906,2852,2898,2880,36,18,3898,"11,230.81",19056
,20180111,2898,2880,2898,2904,2880,2890,2890,10,10,2332,"6,742.66",19096
,20180112,2890,2890,2890,2902,2882,2892,2892,2,2,2556,"7,394.16",19068
,20180115,2892,2892,2886,2946,2878,2928,2918,36,26,5054,"14,751.92",20066
,20180116,2928,2918,2924,2934,2888,2898,2914,-20,-4,3200,"9,325.10",20240
,20180117,2898,2914,2890,2912,2878,2894,2892,-20,-22,4358,"12,610.48",20562
,20180118,2894,2892,2894,2918,2886,2892,2900,0,8,2772,"8,040.55",20898
,20180119,2892,2900,2892,2904,2870,2884,2880,-16,-20,3462,"9,972.83",20728
,20180122,2884,2880,2882,2924,2874,2912,2902,32,22,5248,"15,237.52",21706
,20180123,2912,2902,2902,2922,2894,2906,2908,4,6,4790,"13,930.25",21802
,20180124,2906,2908,2906,2988,2906,2980,2946,72,38,12504,"36,853.52",26098
,20180125,2980,2946,2984,3048,2972,3028,3018,82,72,14710,"44,407.71",30948
,20180126,3028,3018,3036,3040,3002,3024,3020,6,2,5792,"17,497.73",31578
,20180129,3024,3020,3026,3060,3020,3028,3040,8,20,9298,"28,281.67",34868
,20180130,3028,3040,3026,3026,2982,2998,3000,-42,-40,6044,"18,139.51",33848
,20180131,2998,3000,3002,3004,2968,2996,2982,-4,-18,8516,"25,407.60",35898
,20180201,2996,2982,2994,3004,2962,2968,2980,-14,-2,6746,"20,105.36",36878
,20180202,2968,2980,2974,3026,2974,2984,2996,4,16,8004,"23,994.23",37910
,20180205,2984,2996,2982,2984,2934,2966,2956,-30,-40,7460,"22,051.95",36668
,20180206,2966,2956,2960,2972,2902,2910,2918,-46,-38,7836,"22,878.54",35840
,20180207,2910,2918,2902,2930,2900,2918,2914,0,-4,4658,"13,577.41",35008
,20180208,2918,2914,2908,2922,2864,2872,2878,-42,-36,6754,"19,443.11",33148
,20180209,2872,2878,2872,2884,2842,2842,2862,-36,-16,5532,"15,833.83",32504
,20180212,2842,2862,2828,2846,2800,2802,2824,-60,-38,7314,"20,656.61",32902
,20180213,2802,2824,2792,2816,2736,2748,2774,-76,-50,17354,"48,142.51",39416
,20180214,2748,2774,2734,2766,2692,2700,2728,-74,-46,17668,"48,226.32",43380
,20180222,2700,2728,2714,2774,2714,2774,2754,46,26,9992,"27,531.73",45304
,20180223,2774,2754,2778,2826,2774,2822,2806,68,52,10558,"29,640.52",48346
,20180226,2822,2806,2816,2854,2810,2842,2834,36,28,6134,"17,394.91",49388
,20180227,2842,2834,2838,2844,2822,2826,2828,-8,-6,4260,"12,050.12",50294
,20180228,2826,2828,2824,2870,2820,2840,2846,12,18,8534,"24,288.30",50664
,20180301,2840,2846,2834,2862,2806,2826,2830,-20,-16,7432,"21,033.96",52192
,20180302,2826,2830,2818,2842,2802,2826,2822,-4,-8,10960,"30,938.04",55646
,20180305,2826,2822,2824,2858,2786,2798,2820,-24,-2,15256,"43,033.85",56608
,20180306,2798,2820,2790,2818,2776,2804,2800,-16,-20,6630,"18,572.21",55682
,20180307,2804,2800,2812,2826,2780,2784,2796,-16,-4,7316,"20,468.48",56248
,20180308,2784,2796,2788,2792,2758,2784,2774,-12,-22,9956,"27,634.77",56290
,20180309,2784,2774,2780,2804,2752,2770,2780,-4,6,12178,"33,861.12",55306
,20180312,2770,2780,2778,2818,2776,2802,2798,22,18,8920,"24,961.14",55172
,20180313,2802,2798,2792,2802,2748,2754,2772,-44,-26,12488,"34,625.59",54960
,20180314,2754,2772,2756,2790,2748,2768,2774,-4,2,19372,"53,746.28",51748
,20180315,2768,2774,2768,2788,2760,2784,2774,10,0,9386,"26,053.27",51276
,20180316,2784,2774,2784,2808,2774,2806,2786,32,12,10512,"29,295.85",52706
,20180319,2806,2786,2810,2836,2802,2832,2818,46,32,21042,"59,311.52",53700
,20180320,2832,2818,2834,2850,2816,2846,2830,28,12,13992,"39,623.10",54918
,20180321,2846,2830,2852,2878,2840,2852,2858,22,28,24384,"69,735.72",58222
,20180322,2852,2858,2860,2886,2848,2884,2868,26,10,16646,"47,763.60",60270
,20180323,2884,2868,2870,2882,2820,2844,2848,-24,-20,40542,"115,514.75",60338
,20180326,2844,2848,2840,2944,2824,2936,2904,88,56,54072,"157,053.26",76342
,20180327,2936,2904,2932,2960,2910,2942,2936,38,32,50276,"147,631.12",88792
,20180328,2942,2936,2946,2958,2906,2914,2922,-22,-14,26862,"78,498.14",89846
,20180329,2914,2922,2916,2930,2896,2928,2914,6,-8,25366,"73,957.84",92670
,20180330,2928,2914,2920,2966,2906,2958,2942,44,28,38224,"112,461.72",96170
,20180402,2958,2942,2960,2962,2910,2922,2928,-20,-14,26622,"77,984.42",96844
,20180403,2922,2928,2920,2926,2862,2866,2886,-62,-42,46788,"135,042.85",101408
,20180404,2866,2886,2870,2874,2848,2866,2862,-20,-24,28418,"81,341.24",102624
,20180409,2866,2862,2852,2858,2812,2848,2836,-14,-26,28512,"80,916.57",100112
,20180410,2848,2836,2866,2910,2846,2906,2880,70,44,44582,"128,416.06",107506
,20180411,2906,2880,2906,2932,2900,2902,2912,22,32,52446,"152,788.88",117428
,20180412,2902,2912,2910,2942,2908,2928,2920,16,8,50450,"147,399.46",125156
,20180413,2928,2920,2916,2938,2900,2928,2920,8,0,47274,"138,062.76",129198
,20180416,2928,2920,2926,2956,2882,2892,2914,-28,-6,65904,"192,080.41",133228
,20180417,2892,2914,2896,2928,2884,2916,2908,2,-6,50462,"146,747.82",137342
,20180418,2916,2908,2910,2958,2890,2944,2932,36,24,79722,"233,767.52",152792
,20180419,2944,2932,2962,3008,2954,2996,2980,64,48,110306,"328,848.24",175788
,20180420,2996,2980,3000,3020,2970,2974,2990,-6,10,91332,"273,242.75",181166
,20180423,2974,2990,2958,2988,2952,2986,2970,-4,-20,76116,"226,184.92",188842
,20180424,2986,2970,2966,2998,2960,2990,2982,20,12,79832,"238,154.01",194768
,20180425,2990,2982,2990,2990,2906,2912,2942,-70,-40,129932,"382,304.74",182538
,20180426,2912,2942,2910,2928,2908,2918,2918,-24,-24,51652,"150,739.10",183130
,20180427,2918,2918,2922,2936,2910,2912,2924,-6,6,65230,"190,788.77",182834
,20180502,2912,2924,2910,2992,2890,2984,2948,60,24,108610,"320,359.52",186232
,20180503,2984,2948,2984,2998,2972,2984,2982,36,34,93748,"279,601.64",209704
,20180504,2984,2982,2978,3014,2970,3004,2994,22,12,183076,"548,358.32",244266
,20180507,3004,2994,3008,3032,3004,3016,3018,22,24,286850,"865,978.09",276552
,20180508,3016,3018,3022,3048,3006,3012,3018,-6,0,212290,"640,742.63",277012
,20180509,3012,3018,3008,3028,2984,3012,3008,-6,-10,267470,"804,763.10",292922
,20180510,3012,3008,3016,3036,3008,3030,3022,22,14,302166,"913,699.04",315600
,20180511,3030,3022,3028,3056,3004,3048,3026,26,4,395414,"1,196,988.08",334438
,20180514,3048,3026,3050,3068,3032,3036,3044,10,18,245192,"746,428.02",335190
,20180515,3036,3044,3044,3066,3028,3040,3042,-4,-2,312460,"950,533.76",342768
,20180516,3040,3042,3050,3086,3026,3046,3054,4,12,426150,"1,302,272.66",344068
,20180517,3046,3054,3040,3072,3032,3054,3050,0,-4,272824,"832,223.35",342492
,20180518,3054,3050,3064,3232,3058,3232,3160,182,110,806698,"2,549,766.77",450718
,20180521,3232,3160,3256,3336,3222,3274,3268,114,108,984094,"3,217,656.77",443658
,20180522,3274,3268,3268,3310,3252,3270,3282,2,14,647088,"2,124,181.28",467216
,20180523,3270,3282,3272,3292,3180,3212,3238,-70,-44,804902,"2,606,369.16",428490
,20180524,3212,3238,3210,3218,3170,3206,3198,-32,-40,410628,"1,313,651.90",430022
,20180525,3206,3198,3190,3226,3174,3190,3196,-8,-2,480454,"1,536,167.14",434916
,20180528,3190,3196,3150,3154,3090,3120,3122,-76,-74,665996,"2,080,321.80",400100
,20180529,3120,3122,3116,3148,3106,3128,3130,6,8,280950,"879,605.16",391004
,20180530,3128,3130,3138,3160,3068,3116,3106,-14,-24,483696,"1,502,983.92",362226
,20180531,3116,3106,3128,3182,3112,3142,3146,36,40,436074,"1,372,588.89",351730
bu1903,20180102,2802,2802,,,,2812,2812,10,10,0,0.00,22
,20180103,2812,2812,,,,2812,2812,0,0,0,0.00,22
,20180104,2812,2812,2890,2890,2878,2878,2884,66,72,8,23.07,22
,20180105,2878,2884,,,,2884,2884,0,0,0,0.00,22
,20180108,2884,2884,,,,2884,2884,0,0,0,0.00,22
,20180109,2884,2884,2882,2912,2882,2892,2894,8,10,6,17.37,24
,20180110,2892,2894,,,,2900,2900,6,6,0,0.00,24
,20180111,2900,2900,,,,2900,2900,0,0,0,0.00,24
,20180112,2900,2900,,,,2900,2900,0,0,0,0.00,24
,20180115,2900,2900,,,,2902,2902,2,2,0,0.00,24
,20180116,2902,2902,,,,2902,2902,0,0,0,0.00,24
,20180117,2902,2902,,,,2902,2902,0,0,0,0.00,24
,20180118,2902,2902,,,,2902,2902,0,0,0,0.00,24
,20180119,2902,2902,,,,2902,2902,0,0,0,0.00,24
,20180122,2902,2902,,,,2922,2922,20,20,0,0.00,24
,20180123,2922,2922,,,,2928,2928,6,6,0,0.00,24
,20180124,2928,2928,3002,3002,3002,3002,3002,74,74,2,6.00,24
,20180125,3002,3002,,,,3044,3044,42,42,0,0.00,24
,20180126,3044,3044,,,,3044,3044,0,0,0,0.00,24
,20180129,3044,3044,3080,3080,3080,3080,3080,36,36,2,6.16,26
,20180130,3080,3080,3034,3034,3034,3034,3034,-46,-46,2,6.07,26
,20180131,3034,3034,3030,3030,3030,3030,3030,-4,-4,2,6.06,24
,20180201,3030,3030,3016,3016,3016,3016,3016,-14,-14,2,6.03,22
,20180202,3016,3016,,,,3016,3016,0,0,0,0.00,22
,20180205,3016,3016,3006,3006,3006,3006,3006,-10,-10,4,12.02,22
,20180206,3006,3006,3006,3006,3006,3006,3006,0,0,2,6.01,22
,20180207,3006,3006,3002,3002,2938,2938,2972,-68,-34,6,17.84,24
,20180208,2938,2972,2944,2944,2944,2944,2944,-28,-28,2,5.89,22
,20180209,2944,2944,,,,2944,2944,0,0,0,0.00,22
,20180212,2944,2944,,,,2944,2944,0,0,0,0.00,22
,20180213,2944,2944,2896,2896,2796,2796,2828,-148,-116,12,33.94,22
,20180214,2796,2828,2762,2762,2762,2762,2762,-66,-66,2,5.52,24
,20180222,2762,2762,,,,2762,2762,0,0,0,0.00,24
,20180223,2762,2762,,,,2814,2814,52,52,0,0.00,24
,20180226,2814,2814,,,,2814,2814,0,0,0,0.00,24
,20180227,2814,2814,2814,2896,2814,2896,2858,82,44,10,28.58,22
,20180228,2896,2858,2870,2884,2870,2884,2872,26,14,8,22.99,22
,20180301,2884,2872,2872,2872,2868,2868,2870,-4,-2,6,17.22,22
,20180302,2868,2870,,,,2874,2874,4,4,0,0.00,22
,20180305,2874,2874,2870,2870,2870,2870,2870,-4,-4,2,5.74,22
,20180306,2870,2870,,,,2870,2870,0,0,0,0.00,22
,20180307,2870,2870,,,,2870,2870,0,0,0,0.00,22
,20180308,2870,2870,,,,2870,2870,0,0,0,0.00,22
,20180309,2870,2870,,,,2870,2870,0,0,0,0.00,22
,20180312,2870,2870,,,,2870,2870,0,0,0,0.00,22
,20180313,2870,2870,,,,2870,2870,0,0,0,0.00,22
,20180314,2870,2870,2822,2822,2822,2822,2822,-48,-48,2,5.64,22
,20180315,2822,2822,,,,2822,2822,0,0,0,0.00,22
,20180316,2822,2822,,,,2822,2822,0,0,0,0.00,22
,20180319,2822,2822,2876,2876,2876,2876,2876,54,54,18,51.77,8
,20180320,2876,2876,,,,2876,2876,0,0,0,0.00,8
,20180321,2876,2876,,,,2876,2876,0,0,0,0.00,8
,20180322,2876,2876,,,,2876,2876,0,0,0,0.00,8
,20180323,2876,2876,,,,2876,2876,0,0,0,0.00,8
,20180326,2876,2876,,,,2876,2876,0,0,0,0.00,8
,20180327,2876,2876,2960,2960,2952,2952,2954,76,78,6,17.73,8
,20180328,2952,2954,,,,2954,2954,0,0,0,0.00,8
,20180329,2954,2954,,,,2954,2954,0,0,0,0.00,8
,20180330,2954,2954,2958,2958,2958,2958,2958,4,4,2,5.92,6
,20180402,2958,2958,,,,2958,2958,0,0,0,0.00,6
,20180403,2958,2958,,,,2958,2958,0,0,0,0.00,6
,20180404,2958,2958,,,,2958,2958,0,0,0,0.00,6
,20180409,2958,2958,2890,2914,2844,2844,2882,-114,-76,12,34.60,12
,20180410,2844,2882,,,,2882,2882,0,0,0,0.00,12
,20180411,2882,2882,,,,2882,2882,0,0,0,0.00,12
,20180412,2882,2882,2990,2990,2956,2956,2974,74,92,12,35.69,12
,20180413,2956,2974,2980,2980,2980,2980,2980,6,6,2,5.96,10
,20180416,2980,2980,,,,2980,2980,0,0,0,0.00,10
,20180417,2980,2980,2934,2934,2934,2934,2934,-46,-46,4,11.74,8
,20180418,2934,2934,2940,2970,2940,2970,2954,36,20,4,11.82,8
,20180419,2970,2954,3000,3000,3000,3000,3000,46,46,2,6.00,6
,20180420,3000,3000,3026,3066,3026,3066,3046,66,46,4,12.18,8
,20180423,3066,3046,2976,3052,2976,3052,3014,6,-32,4,12.06,8
,20180424,3052,3014,,,,3014,3014,0,0,0,0.00,8
,20180425,3014,3014,,,,3014,3014,0,0,0,0.00,8
,20180426,3014,3014,,,,3014,3014,0,0,0,0.00,8
,20180427,3014,3014,,,,3014,3014,0,0,0,0.00,8
,20180502,3014,3014,,,,3014,3014,0,0,0,0.00,8
,20180503,3014,3014,,,,3014,3014,0,0,0,0.00,8
,20180504,3014,3014,,,,3014,3014,0,0,0,0.00,8
,20180507,3014,3014,,,,3014,3014,0,0,0,0.00,8
,20180508,3014,3014,,,,3014,3014,0,0,0,0.00,8
,20180509,3014,3014,,,,3014,3014,0,0,0,0.00,8
,20180510,3014,3014,,,,3014,3014,0,0,0,0.00,8
,20180511,3014,3014,,,,3014,3014,0,0,0,0.00,8
,20180514,3014,3014,,,,3014,3014,0,0,0,0.00,8
,20180515,3014,3014,,,,3014,3014,0,0,0,0.00,8
,20180516,3014,3014,3096,3118,3088,3088,3098,74,84,8,24.80,12
,20180517,3088,3098,,,,3098,3098,0,0,0,0.00,12
,20180518,3098,3098,3086,3166,3084,3166,3124,68,26,32,99.98,8
,20180521,3166,3124,,,,3232,3232,108,108,0,0.00,8
,20180522,3232,3232,3290,3346,3290,3308,3304,76,72,50,165.28,14
,20180523,3308,3304,3308,3308,3160,3190,3196,-114,-108,244,779.88,162
,20180524,3190,3196,3196,3220,3176,3192,3202,-4,6,222,711.09,246
,20180525,3192,3202,3192,3208,3168,3172,3182,-30,-20,298,948.80,390
,20180528,3172,3182,3122,3178,3082,3112,3142,-70,-40,210,659.90,378
,20180529,3112,3142,3106,3174,3104,3152,3158,10,16,428,"1,351.74",56
,20180530,3152,3158,3122,3146,3098,3098,3110,-60,-48,16,49.76,60
,20180531,3098,3110,3182,3198,3156,3198,3182,88,72,54,171.93,54
bu1906,20180102,2860,2858,2870,2900,2870,2900,2888,42,30,72,207.97,1464
,20180103,2900,2888,2908,2908,2880,2880,2900,-8,12,420,"1,218.05",1608
,20180104,2880,2900,2884,2920,2884,2918,2896,18,-4,346,"1,002.48",1592
,20180105,2918,2896,2918,2930,2900,2922,2912,26,16,84,244.63,1628
,20180108,2922,2912,2924,2924,2908,2912,2918,0,6,42,122.56,1646
,20180109,2912,2918,2920,2948,2920,2944,2938,26,20,200,587.64,1712
,20180110,2944,2938,2934,2970,2928,2968,2952,30,14,184,543.47,1784
,20180111,2968,2952,2962,2966,2950,2966,2958,14,6,86,254.54,1818
,20180112,2966,2958,2958,2966,2952,2962,2958,4,0,68,201.25,1828
,20180115,2962,2958,2956,2998,2950,2980,2978,22,20,234,697.13,1964
,20180116,2980,2978,2984,2984,2946,2954,2968,-24,-10,112,332.44,1990
,20180117,2954,2968,2940,2964,2938,2946,2946,-22,-22,60,176.79,1974
,20180118,2946,2946,2944,2968,2940,2944,2952,-2,6,80,236.28,1980
,20180119,2944,2952,2954,2954,2934,2944,2940,-8,-12,38,111.76,1964
,20180122,2944,2940,2940,2980,2940,2964,2968,24,28,80,237.45,1990
,20180123,2964,2968,2964,2984,2960,2972,2972,4,4,96,285.45,1994
,20180124,2972,2972,2982,3036,2982,3036,3012,64,40,640,"1,928.13",2408
,20180125,3036,3012,3036,3094,3024,3078,3064,66,52,688,"2,108.20",2766
,20180126,3078,3064,3072,3096,3040,3068,3068,4,4,230,706.06,2820
,20180129,3068,3068,3084,3104,3062,3080,3092,12,24,598,"1,849.72",3140
,20180130,3080,3092,3060,3068,3044,3054,3052,-38,-40,104,317.46,3082
,20180131,3054,3052,3046,3060,3034,3044,3044,-8,-8,52,158.36,3060
,20180201,3044,3044,3048,3072,3030,3030,3046,-14,2,24,73.14,3056
,20180202,3030,3046,3056,3070,3042,3060,3058,14,12,72,220.29,3070
,20180205,3060,3058,3020,3046,3014,3030,3020,-28,-38,214,646.37,2938
,20180206,3030,3020,3016,3016,2986,2986,2990,-34,-30,154,460.64,2830
,20180207,2986,2990,2996,3012,2988,2994,2998,4,8,46,137.97,2828
,20180208,2994,2998,2996,3004,2954,2958,2970,-40,-28,520,"1,544.87",2554
,20180209,2958,2970,2968,2974,2932,2942,2952,-28,-18,342,"1,009.84",2340
,20180212,2942,2952,2936,2940,2900,2900,2916,-52,-36,484,"1,412.25",2042
,20180213,2900,2916,2900,2900,2828,2828,2862,-88,-54,414,"1,185.34",1946
,20180214,2828,2862,2844,2866,2798,2800,2830,-62,-32,412,"1,166.09",1946
,20180222,2800,2830,2840,2866,2830,2860,2850,30,20,160,456.19,1970
,20180223,2860,2850,2878,2906,2874,2900,2890,50,40,168,485.68,1904
,20180226,2900,2890,2900,2938,2900,2926,2920,36,30,62,181.14,1904
,20180227,2926,2920,2912,2930,2908,2914,2912,-6,-8,80,233.07,1882
,20180228,2914,2912,2908,2946,2908,2928,2932,16,20,116,340.18,1834
,20180301,2928,2932,2926,2950,2902,2910,2914,-22,-18,232,676.17,1804
,20180302,2910,2914,2908,2922,2884,2912,2908,-2,-6,70,203.67,1802
,20180305,2912,2908,2916,2942,2878,2884,2914,-24,6,180,524.53,1804
,20180306,2884,2914,2880,2902,2870,2894,2886,-20,-28,148,427.24,1796
,20180307,2894,2886,2906,2906,2872,2872,2882,-14,-4,308,887.84,1792
,20180308,2872,2882,2880,2880,2850,2866,2860,-16,-22,212,606.48,1798
,20180309,2866,2860,2872,2882,2848,2856,2864,-4,4,282,807.80,1812
,20180312,2856,2864,2860,2890,2860,2874,2872,10,8,62,178.15,1822
,20180313,2874,2872,2864,2872,2840,2842,2850,-30,-22,88,250.92,1814
,20180314,2842,2850,2848,2864,2846,2850,2854,0,4,134,382.64,1864
,20180315,2850,2854,2832,2866,2806,2862,2834,8,-20,552,"1,564.80",1884
,20180316,2862,2834,2860,2866,2850,2858,2860,24,26,168,480.60,1928
,20180319,2858,2860,2870,2886,2858,2884,2872,24,12,174,500.04,1974
,20180320,2884,2872,2888,2900,2864,2890,2882,18,10,324,934.25,2072
,20180321,2890,2882,2900,2920,2886,2892,2902,10,20,244,708.38,2098
,20180322,2892,2902,2904,2916,2882,2914,2904,12,2,394,"1,144.44",2114
,20180323,2914,2904,2900,2912,2862,2888,2888,-16,-16,370,"1,069.24",2088
,20180326,2888,2888,2872,2960,2870,2952,2918,64,30,434,"1,266.73",2134
,20180327,2952,2918,2940,2976,2938,2962,2956,44,38,304,898.88,2220
,20180328,2962,2956,2980,2982,2930,2940,2958,-16,2,318,941.06,2242
,20180329,2940,2958,2940,2960,2930,2950,2942,-8,-16,174,512.25,2272
,20180330,2950,2942,2942,2998,2942,2998,2974,56,32,562,"1,671.70",2354
,20180402,2998,2974,2986,2986,2952,2952,2964,-22,-10,148,438.69,2350
,20180403,2952,2964,2940,2954,2910,2912,2922,-52,-42,284,830.24,2280
,20180404,2912,2922,2910,2922,2902,2914,2910,-8,-12,128,372.68,2256
,20180409,2914,2910,2900,2926,2870,2910,2898,0,-12,188,544.91,2264
,20180410,2910,2898,2906,2962,2906,2962,2948,64,50,1002,"2,954.00",2492
,20180411,2962,2948,2962,2994,2952,2962,2972,14,24,330,980.78,2660
,20180412,2962,2972,2972,2990,2962,2990,2974,18,2,92,273.76,2678
,20180413,2990,2974,2978,2986,2962,2982,2976,8,2,204,607.16,2756
,20180416,2982,2976,2986,3000,2944,2960,2970,-16,-6,152,451.66,2736
,20180417,2960,2970,2966,2978,2948,2972,2964,2,-6,98,290.48,2726
,20180418,2972,2964,2960,3010,2956,3004,2988,40,24,198,591.75,2774
,20180419,3004,2988,3010,3050,3000,3050,3032,62,44,786,"2,383.81",3162
,20180420,3050,3032,3034,3068,3022,3026,3048,-6,16,362,"1,103.40",3334
,20180423,3026,3048,3016,3038,3008,3034,3026,-14,-22,178,538.89,3344
,20180424,3034,3026,3014,3048,3014,3038,3032,12,6,148,448.88,3348
,20180425,3038,3032,3030,3032,2968,2972,2986,-60,-46,418,"1,248.30",3194
,20180426,2972,2986,2974,2990,2972,2986,2980,0,-6,514,"1,531.84",3168
,20180427,2986,2980,2998,3000,2990,2990,2994,10,14,218,652.95,3230
,20180502,2990,2994,2972,3046,2972,3032,3016,38,22,266,802.42,3340
,20180503,3032,3016,3032,3058,3032,3050,3046,34,30,586,"1,785.18",3510
,20180504,3050,3046,3044,3074,3044,3066,3058,20,12,330,"1,009.15",3726
,20180507,3066,3058,2906,3104,2906,3084,3066,26,8,610,"1,870.51",3950
,20180508,3084,3066,3098,3102,3070,3078,3082,12,16,318,980.47,4016
,20180509,3078,3082,3074,3092,3056,3074,3074,-8,-8,136,418.16,4018
,20180510,3074,3074,3084,3098,3078,3098,3088,24,14,290,895.61,4132
,20180511,3098,3088,3098,3118,3074,3108,3098,20,10,378,"1,171.58",4256
,20180514,3108,3098,3112,3128,3098,3104,3106,6,8,474,"1,473.06",4296
,20180515,3104,3106,3104,3120,3094,3102,3102,-4,-4,234,726.26,4296
,20180516,3102,3102,3108,3144,3092,3110,3124,8,22,468,"1,462.92",4472
,20180517,3110,3124,3102,3128,3098,3112,3110,-12,-14,132,410.70,4506
,20180518,3112,3110,3126,3296,3116,3296,3224,186,114,2626,"8,469.47",6030
,20180521,3296,3224,3280,3370,3272,3324,3324,100,100,4038,"13,429.65",7906
,20180522,3324,3324,3312,3366,3304,3326,3338,2,14,2932,"9,792.30",8322
,20180523,3326,3338,3330,3348,3232,3264,3292,-74,-46,2922,"9,621.79",8172
,20180524,3264,3292,3260,3280,3234,3258,3256,-34,-36,974,"3,173.20",8116
,20180525,3258,3256,3254,3284,3238,3256,3256,0,0,872,"2,839.59",8104
,20180528,3256,3256,3226,3230,3162,3188,3186,-68,-70,3342,"10,651.23",6752
,20180529,3188,3186,3190,3208,3178,3194,3196,8,10,1268,"4,054.95",6742
,20180530,3194,3196,3212,3216,3150,3194,3170,-2,-26,3006,"9,531.46",5954
,20180531,3194,3170,3202,3236,3178,3204,3210,34,40,1980,"6,357.18",6002
bu1909,20180102,2892,2892,2896,2930,2896,2928,2916,36,24,60,175.06,476
,20180103,2928,2916,2930,2938,2928,2928,2932,12,16,44,129.02,502
,20180104,2928,2932,2914,2950,2912,2950,2938,18,6,34,99.96,512
,20180105,2950,2938,2930,2952,2928,2948,2936,10,-2,40,117.49,502
,20180108,2948,2936,2938,2958,2938,2944,2950,8,14,20,59.03,500
,20180109,2944,2950,2960,2974,2960,2966,2968,16,18,60,178.13,506
,20180110,2966,2968,2956,2994,2956,2994,2980,26,12,40,119.22,532
,20180111,2994,2980,2994,2998,2976,2976,2990,-4,10,20,59.82,528
,20180112,2976,2990,2978,2988,2976,2982,2978,-8,-12,26,77.46,518
,20180115,2982,2978,2986,3016,2986,3000,3000,22,22,34,102.01,540
,20180116,3000,3000,2988,2988,2988,2988,2988,-12,-12,2,5.98,540
,20180117,2988,2988,2966,2988,2966,2988,2978,0,-10,30,89.38,528
,20180118,2988,2978,2974,2996,2974,2990,2984,12,6,28,83.60,526
,20180119,2990,2984,2986,2986,2954,2962,2966,-22,-18,34,100.88,514
,20180122,2962,2966,2968,3008,2968,2994,2984,28,18,32,95.53,520
,20180123,2994,2984,3000,3006,2986,2998,2996,14,12,90,269.67,522
,20180124,2998,2996,3004,3068,3004,3044,3028,48,32,90,272.67,582
,20180125,3044,3028,3050,3114,3048,3114,3084,86,56,62,191.32,598
,20180126,3114,3084,3092,3094,3064,3092,3086,8,2,42,129.61,596
,20180129,3092,3086,3082,3118,3082,3102,3102,16,16,36,111.69,598
,20180130,3102,3102,3080,3080,3062,3062,3068,-40,-34,52,159.58,590
,20180131,3062,3068,3074,3074,3056,3068,3064,0,-4,44,134.83,578
,20180201,3068,3064,3056,3064,3056,3064,3058,0,-6,8,24.46,578
,20180202,3064,3058,3068,3090,3068,3090,3076,32,18,6,18.46,574
,20180205,3090,3076,3038,3062,3030,3062,3046,-14,-30,16,48.76,580
,20180206,3062,3046,3034,3034,3010,3012,3018,-34,-28,10,30.18,586
,20180207,3012,3018,3026,3040,3004,3004,3024,-14,6,22,66.56,582
,20180208,3004,3024,3028,3030,2988,2988,3000,-36,-24,64,192.09,536
,20180209,2988,3000,2990,2992,2966,2966,2980,-34,-20,26,77.48,520
,20180212,2966,2980,2960,2960,2940,2940,2948,-40,-32,104,306.65,430
,20180213,2940,2948,2932,2938,2880,2880,2916,-68,-32,114,332.45,334
,20180214,2880,2916,2886,2890,2872,2884,2882,-32,-34,46,132.59,320
,20180222,2884,2882,2888,2888,2884,2888,2884,6,2,14,40.40,314
,20180223,2888,2884,2908,2920,2906,2920,2910,36,26,24,69.88,316
,20180226,2920,2910,2936,2960,2934,2946,2942,36,32,12,35.31,318
,20180227,2946,2942,2940,2940,2940,2940,2940,-2,-2,4,11.76,316
,20180228,2940,2940,2958,2958,2940,2954,2942,14,2,20,58.86,318
,20180301,2954,2942,2934,2934,2934,2934,2934,-8,-8,4,11.74,320
,20180302,2934,2934,2924,2938,2924,2938,2930,4,-4,4,11.72,320
,20180305,2938,2930,2954,2954,2906,2906,2926,-24,-4,54,158.08,302
,20180306,2906,2926,2912,2918,2896,2918,2906,-8,-20,24,69.77,296
,20180307,2918,2906,2918,2924,2904,2904,2912,-2,6,52,151.49,280
,20180308,2904,2912,2890,2910,2888,2896,2896,-16,-16,46,133.22,260
,20180309,2896,2896,2904,2904,2904,2904,2904,8,8,2,5.81,258
,20180312,2904,2904,2908,2910,2880,2910,2894,6,-10,14,40.52,252
,20180313,2910,2894,2878,2880,2872,2872,2876,-22,-18,12,34.52,254
,20180314,2872,2876,2892,2896,2892,2896,2892,20,16,6,17.36,254
,20180315,2896,2892,2882,2898,2882,2882,2886,-10,-6,12,34.63,256
,20180316,2882,2886,2890,2894,2886,2886,2888,0,2,14,40.46,264
,20180319,2886,2888,2892,2894,2886,2894,2888,6,0,14,40.45,262
,20180320,2894,2888,2912,2914,2896,2912,2908,24,20,24,69.81,280
,20180321,2912,2908,2928,2934,2902,2910,2922,2,14,18,52.60,288
,20180322,2910,2922,2934,2934,2924,2926,2928,4,6,8,23.44,290
,20180323,2926,2928,2920,2940,2894,2894,2912,-34,-16,36,104.86,282
,20180326,2894,2912,2914,2956,2914,2948,2942,36,30,52,153.00,304
,20180327,2948,2942,2932,2970,2932,2968,2948,26,6,18,53.10,306
,20180328,2968,2948,2954,2956,2942,2942,2946,-6,-2,10,29.47,310
,20180329,2942,2946,2952,2960,2952,2952,2954,6,8,6,17.73,312
,20180330,2952,2954,2944,2990,2944,2990,2972,36,18,12,35.66,316
,20180402,2990,2972,2984,2988,2956,2956,2970,-16,-2,18,53.48,322
,20180403,2956,2970,2950,2950,2920,2920,2928,-50,-42,22,64.45,310
,20180404,2920,2928,2908,2908,2908,2908,2908,-20,-20,4,11.63,308
,20180409,2908,2908,2906,2906,2892,2906,2902,-2,-6,16,46.43,300
,20180410,2906,2902,2930,2966,2930,2966,2942,64,40,70,205.95,318
,20180411,2966,2942,2976,2984,2944,2956,2960,14,18,66,195.36,338
,20180412,2956,2960,2940,2978,2938,2978,2960,18,0,86,254.70,330
,20180413,2978,2960,2942,2998,2942,2984,2976,24,16,14,41.67,334
,20180416,2984,2976,2950,2972,2940,2940,2948,-36,-28,62,182.86,352
,20180417,2940,2948,2966,2996,2966,2980,2980,32,32,20,59.61,352
,20180418,2980,2980,2990,3008,2990,3008,2998,28,18,88,263.90,296
,20180419,3008,2998,3026,3044,3022,3044,3032,46,34,32,97.07,310
,20180420,3044,3032,3048,3060,3046,3046,3054,14,22,16,48.86,314
,20180423,3046,3054,,,,3054,3054,0,0,0,0.00,314
,20180424,3054,3054,3038,3050,3038,3050,3044,-4,-10,12,36.53,316
,20180425,3050,3044,3014,3014,2976,2986,2990,-58,-54,30,89.73,320
,20180426,2986,2990,2984,3000,2984,3000,2992,10,2,10,29.93,318
,20180427,3000,2992,,,,2994,2994,2,2,0,0.00,318
,20180502,2994,2994,3014,3040,3014,3040,3030,46,36,6,18.18,314
,20180503,3040,3030,3034,3058,3034,3050,3048,20,18,38,115.89,348
,20180504,3050,3048,3050,3068,3050,3068,3056,20,8,12,36.68,352
,20180507,3068,3056,3086,3094,3070,3084,3084,28,28,48,148.04,346
,20180508,3084,3084,3098,3098,3080,3080,3084,-4,0,18,55.54,362
,20180509,3080,3084,3066,3086,3066,3084,3078,0,-6,36,110.84,382
,20180510,3084,3078,3082,3110,3080,3098,3096,20,18,48,148.66,384
,20180511,3098,3096,3096,3116,3084,3116,3104,20,8,50,155.20,374
,20180514,3116,3104,3112,3112,3108,3110,3108,6,4,12,37.32,366
,20180515,3110,3108,3112,3126,3100,3110,3112,2,4,40,124.48,370
,20180516,3110,3112,3112,3154,3100,3130,3118,18,6,22,68.64,368
,20180517,3130,3118,3108,3128,3108,3120,3118,2,0,10,31.18,370
,20180518,3120,3118,3140,3300,3140,3300,3208,182,90,180,577.61,412
,20180521,3300,3208,3286,3370,3286,3334,3326,126,118,146,485.85,464
,20180522,3334,3326,3308,3386,3308,3340,3346,14,20,90,301.26,500
,20180523,3340,3346,3338,3338,3248,3252,3282,-94,-64,84,275.82,486
,20180524,3252,3282,,,,3266,3266,-16,-16,0,0.00,486
,20180525,3266,3266,3262,3262,3260,3260,3260,-6,-6,8,26.08,490
,20180528,3260,3260,3214,3214,3174,3192,3186,-68,-74,24,76.50,480
,20180529,3192,3186,3198,3228,3198,3210,3218,24,32,36,115.88,466
,20180530,3210,3218,3202,3208,3152,3168,3188,-50,-30,208,663.14,318
,20180531,3168,3188,3186,3246,3186,3206,3218,18,30,38,122.32,312
bu1912,20180102,2928,2926,2942,2964,2936,2958,2948,32,22,126,371.69,966
,20180103,2958,2948,2958,2966,2940,2954,2954,6,6,126,372.42,988
,20180104,2954,2954,2944,2970,2944,2966,2960,12,6,286,846.56,1174
,20180105,2966,2960,2962,2980,2952,2972,2964,12,4,242,717.34,1284
,20180108,2972,2964,2986,2988,2962,2976,2974,12,10,174,517.62,1288
,20180109,2976,2974,2978,2992,2974,2980,2982,6,8,346,"1,032.31",1494
,20180110,2980,2982,2984,3000,2974,2998,2988,16,6,296,884.87,1650
,20180111,2998,2988,3000,3004,2986,2994,2992,6,4,202,604.47,1718
,20180112,2994,2992,2986,2992,2980,2988,2984,-4,-8,188,561.15,1686
,20180115,2988,2984,2984,3018,2978,3012,3002,28,18,244,732.89,1824
,20180116,3012,3002,3006,3014,2990,2990,3000,-12,-2,148,444.20,1798
,20180117,2990,3000,2990,2996,2984,2990,2988,-10,-12,184,550.04,1808
,20180118,2990,2988,2984,3018,2984,2994,3004,6,16,360,"1,081.88",1938
,20180119,2994,3004,2990,3000,2980,2990,2988,-14,-16,170,508.19,1924
,20180122,2990,2988,2980,3050,2980,3028,3032,40,44,918,"2,783.55",2360
,20180123,3028,3032,3024,3042,3024,3038,3034,6,2,372,"1,128.72",2530
,20180124,3038,3034,3036,3082,3032,3066,3052,32,18,816,"2,491.96",2960
,20180125,3066,3052,3072,3118,3064,3104,3096,52,44,832,"2,576.20",3208
,20180126,3104,3096,3106,3116,3090,3102,3098,6,2,342,"1,059.96",3130
,20180129,3102,3098,3100,3124,3092,3114,3110,16,12,270,839.88,3208
,20180130,3114,3110,3104,3108,3084,3092,3092,-18,-18,292,903.16,3152
,20180131,3092,3092,3104,3104,3078,3100,3088,8,-4,164,506.74,3142
,20180201,3100,3088,3090,3102,3080,3084,3090,-4,2,148,457.46,3140
,20180202,3084,3090,3094,3112,3090,3094,3102,4,12,212,658.03,3136
,20180205,3094,3102,3096,3096,3070,3094,3080,-8,-22,248,764.24,3040
,20180206,3094,3080,3092,3092,3050,3054,3062,-26,-18,184,563.69,2958
,20180207,3054,3062,3044,3070,3042,3056,3056,-6,-6,62,189.54,2942
,20180208,3056,3056,3050,3050,3020,3020,3032,-36,-24,232,703.43,2844
,20180209,3020,3032,3026,3034,2998,2998,3008,-34,-24,310,932.88,2796
,20180212,2998,3008,2990,3004,2950,2950,2974,-58,-34,482,"1,434.14",2826
,20180213,2950,2974,2960,2962,2894,2894,2928,-80,-46,368,"1,077.53",2918
,20180214,2894,2928,2908,2924,2850,2850,2872,-78,-56,564,"1,620.05",2920
,20180222,2850,2872,2880,2908,2880,2904,2896,32,24,150,434.66,2982
,20180223,2904,2896,2908,2944,2902,2942,2926,46,30,242,708.23,2946
,20180226,2942,2926,2940,2966,2940,2958,2958,32,32,190,562.19,2904
,20180227,2958,2958,2954,2958,2944,2948,2948,-10,-10,52,153.36,2912
,20180228,2948,2948,2956,2986,2956,2964,2966,16,18,156,462.93,2956
,20180301,2964,2966,2960,2980,2938,2948,2954,-18,-12,152,449.02,2976
,20180302,2948,2954,2926,2952,2924,2948,2944,-6,-10,138,406.33,2980
,20180305,2948,2944,2956,2970,2914,2916,2942,-28,-2,288,847.32,3098
,20180306,2916,2942,2928,2934,2900,2926,2918,-16,-24,312,910.67,3176
,20180307,2926,2918,2938,2938,2906,2906,2916,-12,-2,420,"1,224.80",3340
,20180308,2906,2916,2908,2916,2896,2900,2902,-16,-14,158,458.70,3370
,20180309,2900,2902,2912,2916,2886,2890,2900,-12,-2,420,"1,218.29",3492
,20180312,2890,2900,2900,2992,2900,2920,2926,20,26,218,638.27,3514
,20180313,2920,2926,2908,2914,2876,2876,2892,-50,-34,378,"1,093.91",3504
,20180314,2876,2892,2884,2906,2884,2892,2894,0,2,228,659.86,3578
,20180315,2892,2894,2886,2926,2886,2900,2894,6,0,164,474.89,3604
,20180316,2900,2894,2902,2904,2894,2894,2896,0,2,554,"1,604.52",4022
,20180319,2894,2896,2900,2922,2892,2920,2912,24,16,976,"2,843.33",4464
,20180320,2920,2912,2918,2922,2900,2918,2912,6,0,538,"1,567.39",4820
,20180321,2918,2912,2918,2942,2910,2924,2926,12,14,300,878.23,4900
,20180322,2924,2926,2914,2942,2914,2938,2932,12,6,176,516.25,5000
,20180323,2938,2932,2924,2938,2888,2920,2914,-12,-18,816,"2,378.03",4812
,20180326,2920,2914,2910,2970,2904,2954,2938,40,24,1488,"4,373.84",5438
,20180327,2954,2938,2952,2970,2946,2962,2954,24,16,628,"1,856.33",5898
,20180328,2962,2954,2970,2974,2936,2946,2950,-8,-4,354,"1,044.96",5878
,20180329,2946,2950,2944,2960,2936,2956,2948,6,-2,200,589.76,5922
,20180330,2956,2948,2960,2998,2942,2994,2970,46,22,1176,"3,493.56",5572
,20180402,2994,2970,2994,2994,2946,2946,2960,-24,-10,380,"1,125.34",5578
,20180403,2946,2960,2942,2942,2922,2922,2930,-38,-30,404,"1,184.06",5410
,20180404,2922,2930,2912,2926,2906,2920,2916,-10,-14,290,845.65,5320
,20180409,2920,2916,2900,2926,2900,2922,2912,6,-4,222,646.85,5244
,20180410,2922,2912,2940,2964,2924,2962,2952,50,40,354,"1,045.38",5370
,20180411,2962,2952,2968,2982,2960,2964,2970,12,18,280,831.82,5442
,20180412,2964,2970,2970,2982,2960,2980,2970,10,0,160,475.44,5506
,20180413,2980,2970,2988,2988,2962,2978,2974,8,4,178,529.53,5542
,20180416,2978,2974,2990,2996,2954,2960,2968,-14,-6,426,"1,265.02",5494
,20180417,2960,2968,2962,2984,2958,2980,2972,12,4,298,885.90,5470
,20180418,2980,2972,2972,3012,2970,3006,2992,34,20,254,760.16,5468
,20180419,3006,2992,3010,3052,3010,3046,3028,54,36,938,"2,842.04",5774
,20180420,3046,3028,3040,3066,3032,3032,3046,4,18,454,"1,383.53",5810
,20180423,3032,3046,3026,3046,3014,3036,3030,-10,-16,192,582.10,5850
,20180424,3036,3030,3032,3058,3024,3044,3042,14,12,306,930.94,5958
,20180425,3044,3042,3048,3048,2986,2998,3008,-44,-34,458,"1,378.56",5800
,20180426,2998,3008,3004,3012,2990,3002,3000,-6,-8,242,726.39,5800
,20180427,3002,3000,3018,3018,3002,3002,3010,2,10,220,662.53,5798
,20180502,3002,3010,2998,3050,2992,3042,3022,32,12,356,"1,076.04",5932
,20180503,3042,3022,3040,3062,3036,3052,3050,30,28,540,"1,648.01",6186
,20180504,3052,3050,3050,3074,3050,3066,3062,16,12,586,"1,795.07",6522
,20180507,3066,3062,3088,3094,3066,3088,3086,26,24,1200,"3,704.64",6992
,20180508,3088,3086,3098,3108,3084,3092,3090,6,4,464,"1,434.34",7022
,20180509,3092,3090,3082,3098,3064,3094,3086,4,-4,338,"1,043.36",7032
,20180510,3094,3086,3096,3108,3092,3106,3100,20,14,468,"1,451.59",7230
,20180511,3106,3100,3098,3120,3088,3112,3104,12,4,656,"2,037.25",7490
,20180514,3112,3104,3126,3128,3104,3110,3114,6,10,446,"1,389.08",7486
,20180515,3110,3114,3116,3126,3102,3114,3112,0,-2,528,"1,643.80",7508
,20180516,3114,3112,3124,3148,3104,3114,3128,2,16,798,"2,496.52",7648
,20180517,3114,3128,3116,3136,3108,3128,3120,0,-8,266,830.02,7642
,20180518,3128,3120,3130,3304,3130,3294,3222,174,102,2566,"8,268.26",8648
,20180521,3294,3222,3286,3364,3272,3330,3312,108,90,3220,"10,670.20",9386
,20180522,3330,3312,3318,3350,3304,3324,3334,12,22,1876,"6,255.72",9948
,20180523,3324,3334,3328,3340,3240,3262,3288,-72,-46,1776,"5,842.43",9536
,20180524,3262,3288,3260,3274,3232,3262,3256,-26,-32,392,"1,276.56",9558
,20180525,3262,3256,3246,3278,3238,3246,3254,-10,-2,386,"1,256.13",9532
,20180528,3246,3254,3246,3246,3170,3194,3196,-60,-58,1718,"5,493.62",8748
,20180529,3194,3196,3210,3212,3184,3194,3202,-2,6,580,"1,857.66",8626
,20180530,3194,3202,3218,3230,3160,3196,3176,-6,-26,1690,"5,369.50",8086
,20180531,3196,3176,3204,3242,3190,3208,3216,32,40,674,"2,168.32",8228
bu2003,20180316,2894,2894,,,,2894,2894,0,0,0,0.00,0
,20180319,2894,2894,,,,2894,2894,0,0,0,0.00,0
,20180320,2894,2894,2914,2914,2914,2914,2914,20,20,2,5.83,2
,20180321,2914,2914,,,,2914,2914,0,0,0,0.00,2
,20180322,2914,2914,2960,2960,2960,2960,2960,46,46,2,5.92,4
,20180323,2960,2960,,,,2960,2960,0,0,0,0.00,4
,20180326,2960,2960,,,,2984,2984,24,24,0,0.00,4
,20180327,2984,2984,,,,2984,2984,0,0,0,0.00,4
,20180328,2984,2984,,,,2984,2984,0,0,0,0.00,4
,20180329,2984,2984,,,,2984,2984,0,0,0,0.00,4
,20180330,2984,2984,,,,2984,2984,0,0,0,0.00,4
,20180402,2984,2984,,,,2984,2984,0,0,0,0.00,4
,20180403,2984,2984,,,,2954,2954,-30,-30,0,0.00,4
,20180404,2954,2954,,,,2954,2954,0,0,0,0.00,4
,20180409,2954,2954,,,,2950,2950,-4,-4,0,0.00,4
,20180410,2950,2950,,,,2950,2950,0,0,0,0.00,4
,20180411,2950,2950,,,,2950,2950,0,0,0,0.00,4
,20180412,2950,2950,,,,2950,2950,0,0,0,0.00,4
,20180413,2950,2950,,,,2954,2954,4,4,0,0.00,4
,20180416,2954,2954,,,,2954,2954,0,0,0,0.00,4
,20180417,2954,2954,3006,3006,3006,3006,3006,52,52,2,6.01,4
,20180418,3006,3006,3016,3016,3016,3016,3016,10,10,2,6.03,4
,20180419,3016,3016,,,,3054,3054,38,38,0,0.00,4
,20180420,3054,3054,,,,3054,3054,0,0,0,0.00,4
,20180423,3054,3054,,,,3054,3054,0,0,0,0.00,4
,20180424,3054,3054,,,,3054,3054,0,0,0,0.00,4
,20180425,3054,3054,3006,3006,3006,3006,3006,-48,-48,2,6.01,4
,20180426,3006,3006,,,,3006,3006,0,0,0,0.00,4
,20180427,3006,3006,,,,3006,3006,0,0,0,0.00,4
,20180502,3006,3006,,,,3006,3006,0,0,0,0.00,4
,20180503,3006,3006,,,,3006,3006,0,0,0,0.00,4
,20180504,3006,3006,,,,3006,3006,0,0,0,0.00,4
,20180507,3006,3006,,,,3030,3030,24,24,0,0.00,4
,20180508,3030,3030,,,,3030,3030,0,0,0,0.00,4
,20180509,3030,3030,3072,3086,3072,3080,3078,50,48,24,73.90,12
,20180510,3080,3078,,,,3088,3088,10,10,0,0.00,12
,20180511,3088,3088,,,,3088,3088,0,0,0,0.00,12
,20180514,3088,3088,,,,3088,3088,0,0,0,0.00,12
,20180515,3088,3088,,,,3088,3088,0,0,0,0.00,12
,20180516,3088,3088,,,,3104,3104,16,16,0,0.00,12
,20180517,3104,3104,,,,3104,3104,0,0,0,0.00,12
,20180518,3104,3104,3106,3242,3106,3236,3182,132,78,12,38.20,10
,20180521,3236,3182,3288,3328,3278,3312,3294,130,112,28,92.28,18
,20180522,3312,3294,3322,3360,3322,3330,3342,36,48,24,80.21,30
,20180523,3330,3342,3272,3280,3272,3280,3276,-62,-66,4,13.10,28
,20180524,3280,3276,3250,3250,3250,3250,3250,-26,-26,2,6.50,26
,20180525,3250,3250,3290,3290,3242,3262,3260,12,10,8,26.08,26
,20180528,3262,3260,,,,3260,3260,0,0,0,0.00,26
,20180529,3260,3260,,,,3232,3232,-28,-28,0,0.00,26
,20180530,3232,3232,3150,3150,3150,3150,3150,-82,-82,18,56.70,26
,20180531,3150,3150,,,,3190,3190,40,40,0,0.00,26
cu1801,20180102,55150,55430,54430,55420,54430,55100,54920,-330,-510,22504,"617,965.10",46860
,20180103,55100,54920,54950,55080,54570,54680,54710,-240,-210,21610,"591,168.65",43370
,20180104,54680,54710,54600,55070,54430,55000,54730,290,20,22210,"607,846.90",41160
,20180105,55000,54730,55100,55100,54540,54690,54720,-40,-10,21660,"592,705.05",37830
,20180108,54690,54720,54410,54530,54140,54360,54280,-360,-440,24050,"652,750.60",33320
,20180109,54360,54280,54280,54710,54220,54630,54440,350,160,23070,"627,991.30",27620
,20180110,54630,54440,54610,54760,54380,54440,54510,0,70,17210,"469,135.45",20540
,20180111,54440,54510,54760,54920,54580,54730,54690,220,180,16270,"444,956.10",14470
,20180112,54730,54690,54680,54700,54060,54480,54310,-210,-380,13820,"375,334.40",9060
,20180115,54480,54310,54200,54660,54030,54580,54320,270,10,8310,"225,720.50",6650
cu1802,20180102,55470,55600,55400,55640,54840,55250,55140,-350,-460,130716,"3,603,877.56",157116
,20180103,55250,55140,55090,55230,54700,54850,54940,-290,-200,130204,"3,577,133.50",149810
,20180104,54850,54940,54740,55280,54560,55180,54870,240,-70,154148,"4,229,463.86",148736
,20180105,55180,54870,55280,55340,54660,54860,54930,-10,60,121402,"3,334,763.05",138126
,20180108,54860,54930,54600,54700,54270,54530,54460,-400,-470,130666,"3,558,231.69",130120
,20180109,54530,54460,54430,54920,54360,54810,54610,350,150,79864,"2,181,030.28",130596
,20180110,54810,54610,54830,54980,54520,54630,54710,20,100,67140,"1,836,948.21",127364
,20180111,54630,54710,55050,55150,54740,54930,54900,220,190,61908,"1,699,592.11",126474
,20180112,54930,54900,54910,54940,54100,54630,54510,-270,-390,72452,"1,975,040.92",118860
,20180115,54630,54510,54300,54920,54220,54830,54530,320,20,75536,"2,059,596.83",118340
,20180116,54830,54530,54830,54840,54060,54150,54420,-380,-110,73696,"2,005,413.04",110538
,20180117,54150,54420,53780,53910,53460,53470,53690,-950,-730,73580,"1,975,412.54",105552
,20180118,53470,53690,53600,53790,53360,53560,53590,-130,-100,62942,"1,686,621.63",100504
,20180119,53560,53590,53720,53760,53440,53620,53560,30,-30,55786,"1,494,049.99",97788
,20180122,53620,53560,53650,53820,53210,53780,53500,220,-60,64110,"1,715,139.31",94954
,20180123,53780,53500,53770,53770,53310,53590,53490,90,-10,55920,"1,495,730.41",93308
,20180124,53590,53490,52790,52860,52450,52620,52630,-870,-860,87640,"2,306,585.12",88638
,20180125,52620,52630,52800,53990,52670,53700,53470,1070,840,62560,"1,672,701.60",79194
,20180126,53700,53470,53550,53720,53120,53270,53380,-200,-90,33638,"897,800.78",75960
,20180129,53270,53380,53240,53630,52980,53440,53370,60,-10,40734,"1,087,169.17",70400
,20180130,53440,53370,53380,53420,52670,52800,53040,-570,-330,50724,"1,345,414.41",61970
,20180131,52800,53040,52970,53120,52720,52950,52880,-90,-160,43286,"1,144,539.21",51956
,20180201,52950,52880,53100,53140,52750,52790,52880,-90,0,22526,"595,590.60",45830
,20180202,52790,52880,52800,53420,52640,53270,53030,390,150,28490,"755,417.05",37770
,20180205,53270,53030,52980,53050,52510,52790,52720,-240,-310,29860,"787,227.05",27420
,20180206,52790,52720,52760,53450,52320,52480,52630,-240,-90,24880,"654,729.25",21130
,20180207,52480,52630,52500,52820,52220,52410,52630,-220,0,15800,"415,841.55",16770
,20180208,52410,52630,52260,52300,51380,51610,51660,-1020,-970,13320,"344,085.60",11450
,20180209,51610,51660,51720,51720,50460,51060,51240,-600,-420,4960,"127,085.75",10830
cu1803,20180102,55580,55740,55540,55760,54960,55390,55270,-350,-470,89466,"2,472,601.07",219848
,20180103,55390,55270,55250,55350,54810,54970,55050,-300,-220,97976,"2,696,958.72",218480
,20180104,54970,55050,54870,55420,54680,55320,55020,270,-30,135860,"3,737,788.84",226444
,20180105,55320,55020,55460,55480,54800,55010,55070,-10,50,118170,"3,254,029.85",225090
,20180108,55010,55070,54710,54840,54420,54690,54600,-380,-470,158260,"4,320,562.34",226206
,20180109,54690,54600,54600,55100,54530,55010,54800,410,200,176372,"4,832,620.62",235202
,20180110,55010,54800,55000,55180,54680,54800,54890,0,90,161198,"4,424,422.64",229634
,20180111,54800,54890,55210,55310,54900,55110,55080,220,190,158968,"4,378,306.07",232216
,20180112,55110,55080,55050,55130,54260,54800,54680,-280,-400,214000,"5,851,094.15",228728
,20180115,54800,54680,54440,55120,54350,54990,54670,310,-10,223716,"6,116,026.33",235100
,20180116,54990,54670,54970,55010,54180,54300,54600,-370,-70,205918,"5,621,867.22",221526
,20180117,54300,54600,53900,54050,53570,53580,53800,-1020,-800,231424,"6,225,833.72",214052
,20180118,53580,53800,53720,53950,53450,53670,53680,-130,-120,204204,"5,481,604.72",211606
,20180119,53670,53680,53790,53890,53550,53710,53710,30,30,180656,"4,851,585.24",211296
,20180122,53710,53710,53760,53980,53310,53900,53600,190,-110,249866,"6,696,415.70",214884
,20180123,53900,53600,53870,53880,53430,53720,53640,120,40,200602,"5,380,471.30",215576
,20180124,53720,53640,52930,52990,52530,52730,52760,-910,-880,280792,"7,407,642.32",234906
,20180125,52730,52760,52890,54130,52790,53840,53560,1080,800,391388,"10,481,446.60",214644
,20180126,53840,53560,53650,53860,53180,53430,53550,-130,-10,225190,"6,030,553.05",217010
,20180129,53430,53550,53400,53810,53120,53600,53470,50,-80,219076,"5,857,453.85",213290
,20180130,53600,53470,53480,53600,52820,52970,53260,-500,-210,238906,"6,363,035.37",203528
,20180131,52970,53260,53140,53310,52890,53220,53100,-40,-160,219558,"5,829,677.22",190878
,20180201,53220,53100,53300,53380,52920,52980,53140,-120,40,165548,"4,399,282.54",180580
,20180202,52980,53140,52960,53670,52820,53520,53180,380,40,191514,"5,092,995.28",181386
,20180205,53520,53180,53250,53320,52720,53040,53020,-140,-160,200242,"5,309,139.19",183216
,20180206,53040,53020,53060,53820,52580,52750,53130,-270,110,265798,"7,061,089.70",177728
,20180207,52750,53130,52890,53150,52470,52710,52890,-420,-240,187330,"4,954,562.26",176266
,20180208,52710,52890,52520,52640,51610,51920,51960,-970,-930,243836,"6,335,966.30",171850
,20180209,51920,51960,51950,52030,51280,51370,51620,-590,-340,125356,"3,235,580.81",169516
,20180212,51370,51620,51160,51700,50790,51520,51250,-100,-370,101166,"2,592,425.46",166148
,20180213,51520,51250,51490,52070,51330,51910,51710,660,460,60892,"1,574,365.17",158650
,20180214,51910,51710,52110,52630,52040,52620,52360,910,650,55890,"1,463,235.73",148432
,20180222,52620,52360,52940,52940,52340,52530,52520,170,160,35258,"926,019.74",142932
,20180223,52530,52520,52660,53530,52580,53330,53290,810,770,81346,"2,167,656.42",123362
,20180226,53330,53290,53200,53500,52940,53350,53190,60,-100,61734,"1,641,970.50",108396
,20180227,53350,53190,53250,53330,52870,53110,53070,-80,-120,52620,"1,396,292.56",95116
,20180228,53110,53070,52860,52870,52270,52350,52490,-720,-580,57804,"1,517,152.69",79652
,20180301,52350,52490,52360,52420,51930,52100,52120,-390,-370,28222,"735,600.80",76460
,20180302,52100,52120,51800,52240,51690,52130,52060,10,-60,33360,"868,475.40",70260
,20180305,52130,52060,52040,52160,51650,51740,51860,-320,-200,30370,"787,613.15",64650
,20180306,51740,51860,51700,52240,51440,52150,51980,290,120,29840,"775,614.75",61630
,20180307,52150,51980,52370,52400,51930,51950,52050,-30,70,27950,"727,416.65",54890
,20180308,51950,52050,51720,51900,51500,51580,51730,-470,-320,25790,"667,077.00",48660
,20180309,51580,51730,51370,51460,50630,50690,51020,-1040,-710,40200,"1,025,693.30",43460
,20180312,50690,51020,50960,51970,50960,51360,51530,340,510,39780,"1,025,121.20",35260
,20180313,51360,51530,51450,51580,51140,51140,51310,-390,-220,23070,"591,975.50",26070
,20180314,51140,51310,51500,51850,51300,51680,51520,370,210,14740,"379,724.00",20460
,20180315,51680,51520,51900,52060,51400,51500,51670,-20,150,7840,"202,553.85",19560
cu1804,20180102,55750,55840,55640,55880,55090,55530,55380,-310,-460,30198,"836,302.79",101754
,20180103,55530,55380,55400,55470,54920,55090,55170,-290,-210,27882,"769,146.77",105708
,20180104,55090,55170,55090,55560,54810,55470,55200,300,30,33418,"922,494.01",107712
,20180105,55470,55200,55650,55650,54940,55120,55220,-80,20,24146,"666,765.21",106932
,20180108,55120,55220,54810,54950,54570,54850,54740,-370,-480,31834,"871,300.04",106934
,20180109,54850,54740,54720,55240,54670,55150,54940,410,200,26068,"716,158.36",107618
,20180110,55150,54940,55120,55320,54830,54940,55050,0,110,28018,"771,231.53",108702
,20180111,54940,55050,55370,55460,55060,55240,55220,190,170,28068,"775,014.20",111372
,20180112,55240,55220,55200,55260,54400,54930,54830,-290,-390,41014,"1,124,531.36",112890
,20180115,54930,54830,54690,55260,54520,55120,54850,290,20,46784,"1,283,241.84",113722
,20180116,55120,54850,55120,55140,54320,54450,54650,-400,-200,47974,"1,310,971.95",112914
,20180117,54450,54650,53900,54170,53700,53700,53910,-950,-740,65714,"1,771,384.21",111618
,20180118,53700,53910,53810,54080,53580,53800,53840,-110,-70,54316,"1,462,274.86",113690
,20180119,53800,53840,53960,54030,53660,53830,53830,-10,-10,49654,"1,336,640.46",115998
,20180122,53830,53830,53850,54120,53450,54050,53760,220,-70,66384,"1,784,656.57",118014
,20180123,54050,53760,54050,54050,53590,53860,53780,100,20,51866,"1,394,744.33",122408
,20180124,53860,53780,53080,53160,52700,52860,52910,-920,-870,111598,"2,952,650.62",138596
,20180125,52860,52910,53000,54290,52940,54000,53710,1090,800,131454,"3,530,368.19",142128
,20180126,54000,53710,53850,53990,53330,53580,53690,-130,-20,65202,"1,750,429.62",148206
,20180129,53580,53690,53560,53930,53260,53740,53630,50,-60,79916,"2,143,123.90",159018
,20180130,53740,53630,53590,53720,52970,53080,53360,-550,-270,90948,"2,426,871.40",169118
,20180131,53080,53360,53290,53460,53030,53370,53240,10,-120,93718,"2,495,074.90",180862
,20180201,53370,53240,53480,53540,53090,53140,53300,-100,60,75934,"2,023,798.74",186382
,20180202,53140,53300,53070,53830,52970,53670,53390,370,90,110622,"2,953,443.89",197180
,20180205,53670,53390,53390,53490,52890,53210,53190,-180,-200,132408,"3,521,423.63",204758
,20180206,53210,53190,53220,54020,52770,52930,53290,-260,100,233590,"6,224,804.99",215162
,20180207,52930,53290,53060,53360,52670,52890,53070,-400,-220,168268,"4,465,644.20",222180
,20180208,52890,53070,52700,52820,51780,52120,52160,-950,-910,302370,"7,885,998.48",227236
,20180209,52120,52160,52120,52210,51440,51560,51800,-600,-360,258852,"6,705,543.16",234710
,20180212,51560,51800,51330,51900,50920,51710,51360,-90,-440,268694,"6,900,474.22",236352
,20180213,51710,51360,51710,52300,51520,52140,51880,780,520,179328,"4,652,443.22",240142
,20180214,52140,51880,52380,52850,52230,52790,52560,910,680,172660,"4,538,215.45",230544
,20180222,52790,52560,53080,53090,52560,52750,52770,190,210,96064,"2,535,028.98",224352
,20180223,52750,52770,52880,53840,52840,53590,53570,820,800,261144,"6,995,205.31",226444
,20180226,53590,53570,53390,53750,53200,53600,53430,30,-140,220706,"5,896,337.23",226424
,20180227,53600,53430,53490,53580,53100,53370,53330,-60,-100,174578,"4,655,959.15",224336
,20180228,53370,53330,53100,53160,52490,52590,52740,-740,-590,238954,"6,302,058.98",220582
,20180301,52590,52740,52600,52680,52120,52290,52380,-450,-360,178432,"4,674,002.23",217728
,20180302,52290,52380,52010,52500,51900,52320,52240,-60,-140,189950,"4,961,754.17",211270
,20180305,52320,52240,52200,52410,51850,51950,52110,-290,-130,154444,"4,024,602.72",209918
,20180306,51950,52110,51890,52520,51650,52420,52090,310,-20,142742,"3,718,299.83",211256
,20180307,52420,52090,52650,52700,52200,52240,52430,150,340,96522,"2,530,469.76",205330
,20180308,52240,52430,52040,52210,51740,51850,52000,-580,-430,79074,"2,056,191.20",202324
,20180309,51850,52000,51650,51750,50890,50980,51310,-1020,-690,107922,"2,768,815.56",202348
,20180312,50980,51310,51170,52330,51170,51720,51820,410,510,122566,"3,176,112.21",203646
,20180313,51720,51820,51690,51950,51460,51470,51650,-350,-170,71108,"1,836,663.53",207450
,20180314,51470,51650,51760,52180,51640,52050,51890,400,240,72242,"1,874,522.82",204452
,20180315,52050,51890,52350,52450,51720,51860,52070,-30,180,75280,"1,959,958.92",197302
,20180316,51860,52070,51550,52020,51470,51860,51690,-210,-380,63264,"1,635,253.32",191118
,20180319,51860,51690,51860,51900,50930,51190,51200,-500,-490,82002,"2,099,557.66",187680
,20180320,51190,51200,51080,51380,50900,51210,51100,10,-100,63314,"1,617,874.84",182018
,20180321,51210,51100,51050,51090,50260,50400,50590,-700,-510,75366,"1,906,409.68",178942
,20180322,50400,50590,50260,51180,50170,51010,50860,420,270,72268,"1,838,129.90",171104
,20180323,51010,50860,50760,50820,49430,49900,49970,-960,-890,89734,"2,242,356.50",164700
,20180326,49900,49970,49920,50030,48520,48800,49140,-1170,-830,76432,"1,878,223.85",155834
,20180327,48800,49140,48650,49640,48580,49380,49360,240,220,74174,"1,830,836.10",145156
,20180328,49380,49360,49320,49500,49010,49070,49230,-290,-130,58856,"1,448,978.19",135338
,20180329,49070,49230,49120,50070,49120,49850,49620,620,390,153728,"3,814,165.06",98712
,20180330,49850,49620,49960,50270,49780,50190,49980,570,360,50746,"1,268,229.27",83140
,20180402,50190,49980,50140,50520,50130,50470,50250,490,270,32400,"814,159.00",76660
,20180403,50470,50250,50380,50680,50220,50450,50480,200,230,36990,"933,767.30",66630
,20180404,50450,50480,50500,50660,50320,50340,50460,-140,-20,26960,"680,228.15",57760
,20180409,50340,50460,50420,50700,50140,50680,50370,220,-90,35700,"899,279.55",54550
,20180410,50680,50370,50680,51230,50460,51030,50960,660,590,37900,"965,805.75",46660
,20180411,51030,50960,51320,51450,50850,51000,51170,40,210,28610,"732,093.85",36360
,20180412,51000,51170,51200,51220,50330,50600,50670,-570,-500,20210,"512,034.55",29620
,20180413,50600,50670,50350,50700,50200,50590,50530,-80,-140,15150,"382,779.55",24120
,20180416,50590,50530,50660,50660,50200,50380,50410,-150,-120,11350,"286,112.00",23160
cu1805,20180102,55910,56050,55810,56060,55260,55670,55580,-380,-470,18680,"519,209.26",81596
,20180103,55670,55580,55590,55620,55080,55240,55300,-340,-280,18700,"517,058.41",82950
,20180104,55240,55300,55240,55710,54970,55630,55380,330,80,21026,"582,232.14",82876
,20180105,55630,55380,55730,55780,55100,55260,55380,-120,0,16980,"470,210.15",81208
,20180108,55260,55380,55090,55120,54710,54990,54880,-390,-500,23408,"642,323.18",77632
,20180109,54990,54880,54860,55410,54830,55330,55080,450,200,17250,"475,084.45",78518
,20180110,55330,55080,55310,55480,54990,55080,55210,0,130,17366,"479,423.59",79152
,20180111,55080,55210,55460,55600,55230,55410,55390,200,180,16172,"447,899.53",80942
,20180112,55410,55390,55360,55420,54580,55080,54990,-310,-400,24996,"687,275.84",83196
,20180115,55080,54990,54850,55380,54670,55250,55020,260,30,26044,"716,535.26",83894
,20180116,55250,55020,55210,55270,54470,54580,54840,-440,-180,23542,"645,616.42",84078
,20180117,54580,54840,54190,54310,53850,53850,54060,-990,-780,29156,"788,190.39",84116
,20180118,53850,54060,53970,54220,53700,53940,53960,-120,-100,28904,"779,834.27",86138
,20180119,53940,53960,54100,54160,53810,54050,53970,90,10,24132,"651,311.55",86694
,20180122,54050,53970,54050,54270,53600,54190,53920,220,-50,34706,"935,757.23",91158
,20180123,54190,53920,54120,54160,53740,54040,53950,120,30,28832,"777,763.68",95630
,20180124,54040,53950,53380,53380,52880,53010,53060,-940,-890,55732,"1,478,649.62",106776
,20180125,53010,53060,53180,54470,53090,54150,53960,1090,900,88368,"2,384,469.02",109206
,20180126,54150,53960,54000,54140,53500,53730,53830,-230,-130,46604,"1,254,466.98",113862
,20180129,53730,53830,53720,54050,53410,53860,53800,30,-30,66500,"1,788,923.70",116200
,20180130,53860,53800,53700,53860,53100,53230,53510,-570,-290,46026,"1,231,460.55",127324
,20180131,53230,53510,53470,53610,53170,53530,53380,20,-130,39344,"1,050,131.42",133462
,20180201,53530,53380,53600,53690,53220,53290,53450,-90,70,32898,"879,312.91",138588
,20180202,53290,53450,53290,53960,53120,53830,53500,380,50,39896,"1,067,312.40",142332
,20180205,53830,53500,53530,53640,53030,53390,53340,-110,-160,45698,"1,218,808.94",146884
,20180206,53390,53340,53410,54160,52930,53110,53450,-230,110,79766,"2,131,835.44",149996
,20180207,53110,53450,53200,53500,52820,53060,53220,-390,-230,49858,"1,326,914.51",151956
,20180208,53060,53220,52860,52990,51930,52290,52310,-930,-910,105702,"2,765,007.26",155626
,20180209,52290,52310,52250,52390,51630,51740,51970,-570,-340,64796,"1,683,996.24",157016
,20180212,51740,51970,51540,52080,51100,51890,51550,-80,-420,77146,"1,988,811.03",163546
,20180213,51890,51550,51800,52470,51700,52340,52130,790,580,55258,"1,440,397.77",167700
,20180214,52340,52130,52600,53020,52420,52990,52760,860,630,51918,"1,369,596.87",167354
,20180222,52990,52760,53220,53270,52750,52940,52960,180,200,35902,"950,834.44",166024
,20180223,52940,52960,53070,54070,53030,53820,53790,860,830,103254,"2,777,294.63",175966
,20180226,53820,53790,53710,53980,53430,53790,53680,0,-110,107706,"2,890,865.25",196802
,20180227,53790,53680,53700,53800,53340,53560,53540,-120,-140,85628,"2,292,614.56",214600
,20180228,53560,53540,53330,53490,52680,52760,52940,-780,-600,139806,"3,700,939.95",235204
,20180301,52760,52940,52780,52860,52300,52470,52560,-470,-380,118938,"3,126,215.59",245266
,20180302,52470,52560,52170,52700,52110,52540,52450,-20,-110,146956,"3,854,131.17",255936
,20180305,52540,52450,52390,52580,52040,52120,52280,-330,-170,154072,"4,028,047.16",268564
,20180306,52120,52280,52060,52740,51850,52620,52320,340,40,191752,"5,016,476.91",280698
,20180307,52620,52320,52850,52940,52420,52480,52680,160,360,190386,"5,014,898.89",286536
,20180308,52480,52680,52230,52450,51950,52020,52220,-660,-460,197866,"5,167,020.14",288444
,20180309,52020,52220,51820,51970,51080,51190,51540,-1030,-680,289024,"7,449,008.28",290898
,20180312,51190,51540,51410,52560,51410,51960,52040,420,500,308666,"8,031,619.72",291074
,20180313,51960,52040,51950,52200,51710,51740,51930,-300,-110,210318,"5,461,793.39",295518
,20180314,51740,51930,52090,52480,51890,52330,52150,400,220,223704,"5,833,635.51",289222
,20180315,52330,52150,52600,52740,51980,52120,52390,-30,240,248478,"6,509,693.61",288960
,20180316,52120,52390,51820,52300,51730,52120,51950,-270,-440,205452,"5,337,127.60",285674
,20180319,52120,51950,52110,52160,51160,51420,51590,-530,-360,267984,"6,913,175.66",296332
,20180320,51420,51590,51280,51650,51120,51440,51360,-150,-230,222650,"5,718,551.32",295736
,20180321,51440,51360,51280,51350,50470,50580,50840,-780,-520,300280,"7,633,485.31",307212
,20180322,50580,50840,50450,51440,50380,51240,50990,400,150,311050,"7,931,686.82",300526
,20180323,51240,50990,50970,51050,49660,50110,50260,-880,-730,447988,"11,260,119.54",285658
,20180326,50110,50260,50180,50260,48720,49000,49550,-1260,-710,418866,"10,378,354.33",280656
,20180327,49000,49550,48780,49890,48780,49620,49460,70,-90,327668,"8,103,946.26",271856
,20180328,49620,49460,49510,49730,49220,49260,49480,-200,20,260964,"6,456,742.28",264978
,20180329,49260,49480,49640,50100,49300,49880,49660,400,180,391054,"9,709,879.46",279364
,20180330,49880,49660,49930,50280,49780,50180,50000,520,340,228412,"5,711,303.51",268974
,20180402,50180,50000,50150,50600,50080,50390,50280,390,280,177164,"4,454,137.09",261460
,20180403,50390,50280,50400,50640,50150,50370,50390,90,110,202750,"5,109,214.59",257290
,20180404,50370,50390,50420,50580,50210,50280,50360,-110,-30,161216,"4,059,822.94",248708
,20180409,50280,50360,50340,50650,50060,50610,50330,250,-30,148164,"3,728,618.69",252812
,20180410,50610,50330,50580,51160,50360,50950,50780,620,450,192228,"4,881,053.34",245512
,20180411,50950,50780,51220,51360,50740,50950,51110,170,330,173284,"4,428,486.35",234204
,20180412,50950,51110,51200,51210,50180,50510,50710,-600,-400,153782,"3,899,151.88",226164
,20180413,50510,50710,50240,50550,50020,50410,50310,-300,-400,110872,"2,789,128.73",218530
,20180416,50410,50310,50570,50630,49970,50360,50270,50,-40,98100,"2,466,068.30",209820
,20180417,50360,50270,50450,50910,50420,50660,50700,390,430,103506,"2,624,206.98",198732
,20180418,50660,50700,50440,51150,50300,50980,50680,280,-20,98614,"2,499,136.92",194782
,20180419,50980,50680,51470,52020,51390,51720,51650,1040,970,112386,"2,902,535.63",182832
,20180420,51720,51650,51260,51420,50970,51180,51220,-470,-430,85612,"2,192,821.06",175550
,20180423,51180,51220,51250,51800,51200,51640,51550,420,330,71194,"1,835,341.95",168120
,20180424,51640,51550,50840,51610,50620,51310,51280,-240,-270,67862,"1,740,064.36",160500
,20180425,51310,51280,51800,51850,51300,51320,51490,40,210,57086,"1,469,882.87",149610
,20180426,51320,51490,51390,51690,51190,51360,51460,-130,-30,56940,"1,465,343.80",136642
,20180427,51360,51460,51300,51560,51210,51370,51370,-90,-90,60420,"1,551,970.39",126148
,20180502,51370,51370,50690,50980,50510,50960,50810,-410,-560,34908,"886,850.37",120240
,20180503,50960,50810,50800,50900,50680,50860,50780,50,-30,31470,"799,023.40",117040
,20180504,50860,50780,51050,51130,50650,51070,50950,290,170,33650,"857,319.25",109510
,20180507,51070,50950,50870,51000,50760,50920,50900,-30,-50,33910,"863,141.85",101970
,20180508,50920,50900,51210,51210,50870,50990,50980,90,80,35580,"907,067.15",91430
,20180509,50990,50980,50580,50730,50170,50510,50600,-470,-380,42870,"1,084,728.80",81560
,20180510,50510,50600,50610,50920,50570,50700,50780,100,180,40110,"1,018,487.55",65830
,20180511,50700,50780,51220,51220,51000,51050,51080,270,300,27610,"705,173.35",51230
,20180514,51050,51080,51150,51390,51090,51220,51190,140,110,19890,"509,130.15",39430
,20180515,51220,51190,51020,51070,50720,51000,50910,-190,-280,12460,"317,183.55",32150
cu1806,20180102,56060,56230,55990,56200,55470,55810,55850,-420,-380,2728,"76,191.83",46148
,20180103,55810,55850,55700,55790,55260,55440,55480,-410,-370,2566,"71,182.94",46026
,20180104,55440,55480,55330,55880,55150,55780,55540,300,60,1994,"55,374.22",46128
,20180105,55780,55540,55880,55940,55270,55450,55570,-90,30,1470,"40,851.04",46040
,20180108,55450,55570,55130,55270,54880,55120,55020,-450,-550,2430,"66,852.70",46236
,20180109,55120,55020,55020,55560,54930,55470,55280,450,260,3008,"83,153.38",46108
,20180110,55470,55280,55460,55620,55180,55250,55370,-30,90,4368,"120,943.97",45996
,20180111,55250,55370,55700,55760,55420,55550,55570,180,200,2358,"65,518.97",45786
,20180112,55550,55570,55510,55590,54750,55260,55150,-310,-420,3456,"95,303.43",46510
,20180115,55260,55150,55010,55540,54860,55390,55220,240,70,4828,"133,315.22",45754
,20180116,55390,55220,55400,55440,54630,54730,55070,-490,-150,5164,"142,197.91",45480
,20180117,54730,55070,54300,54480,54020,54030,54230,-1040,-840,5058,"137,170.86",45918
,20180118,54030,54230,54160,54370,53890,54130,54160,-100,-70,4030,"109,135.89",46584
,20180119,54130,54160,54250,54330,53980,54160,54160,0,0,4444,"120,352.03",47254
,20180122,54160,54160,54250,54420,53790,54360,54080,200,-80,4798,"129,761.64",47502
,20180123,54360,54080,54300,54300,53920,54180,54120,100,40,7792,"210,889.46",48734
,20180124,54180,54120,53510,53510,53060,53210,53230,-910,-890,10966,"291,905.38",51480
,20180125,53210,53230,53360,54800,53280,54340,54280,1110,1050,21826,"592,414.22",56148
,20180126,54340,54280,54190,54330,53750,53910,54020,-370,-260,7620,"205,820.41",56826
,20180129,53910,54020,53900,54250,53600,54040,54030,20,10,6086,"164,422.45",57414
,20180130,54040,54030,53910,54040,53300,53420,53670,-610,-360,10022,"268,949.72",58548
,20180131,53420,53670,53620,53780,53360,53720,53570,50,-100,9678,"259,235.77",59450
,20180201,53720,53570,53770,53880,53390,53450,53620,-120,50,8372,"224,453.61",60388
,20180202,53450,53620,53450,54130,53310,53990,53720,370,100,9280,"249,298.23",60598
,20180205,53990,53720,53750,53820,53230,53560,53490,-160,-230,15250,"407,935.26",61718
,20180206,53560,53490,53600,54340,53110,53270,53690,-220,200,27924,"749,657.39",63186
,20180207,53270,53690,53310,53680,53000,53240,53390,-450,-300,20826,"556,052.20",65236
,20180208,53240,53390,52980,53150,52130,52460,52480,-930,-910,36054,"946,150.29",68894
,20180209,52460,52480,52380,52560,51820,51930,52090,-550,-390,29618,"771,460.87",70068
,20180212,51930,52090,51620,52250,51300,52060,51790,-30,-300,26548,"687,532.10",73086
,20180213,52060,51790,52020,52660,51890,52500,52400,710,610,23770,"622,821.03",77016
,20180214,52500,52400,52700,53230,52600,53100,52950,700,550,18102,"479,253.72",78172
,20180222,53100,52950,53250,53480,52920,53170,53140,220,190,10332,"274,522.06",78258
,20180223,53170,53140,53270,54280,53230,54000,54010,860,870,42018,"1,134,800.31",80590
,20180226,54000,54010,53830,54180,53630,54000,53870,-10,-140,32458,"874,276.61",87032
,20180227,54000,53870,53820,54000,53530,53760,53720,-110,-150,21198,"569,447.60",91222
,20180228,53760,53720,53460,53590,52870,52940,53110,-780,-610,44260,"1,175,377.44",103736
,20180301,52940,53110,52990,53050,52480,52670,52730,-440,-380,33312,"878,375.27",107196
,20180302,52670,52730,52380,52880,52250,52700,52640,-30,-90,30602,"805,485.64",111388
,20180305,52700,52640,52600,52760,52220,52290,52460,-350,-180,28144,"738,265.04",111100
,20180306,52290,52460,52250,52920,52030,52810,52530,350,70,28150,"739,415.67",113272
,20180307,52810,52530,53080,53120,52600,52680,52840,150,310,30528,"806,664.63",116236
,20180308,52680,52840,52490,52630,52140,52230,52410,-610,-430,32010,"838,834.45",117480
,20180309,52230,52410,52000,52160,51280,51380,51670,-1030,-740,57156,"1,476,640.56",118078
,20180312,51380,51670,51590,52730,51590,52150,52270,480,600,67698,"1,769,469.03",119344
,20180313,52150,52270,52150,52380,51930,51980,52100,-290,-170,41702,"1,086,543.38",122774
,20180314,51980,52100,52350,52690,52120,52540,52390,440,290,36532,"956,988.01",126206
,20180315,52540,52390,52800,52980,52210,52360,52610,-30,220,44620,"1,173,927.77",127900
,20180316,52360,52610,52080,52530,51980,52350,52190,-260,-420,42988,"1,121,910.64",131400
,20180319,52350,52190,52360,52400,51400,51650,51780,-540,-410,74834,"1,937,736.23",138424
,20180320,51650,51780,51540,51860,51350,51630,51580,-150,-200,45030,"1,161,375.93",142142
,20180321,51630,51580,51500,51550,50680,50800,51030,-780,-550,72976,"1,862,166.14",148276
,20180322,50800,51030,50650,51650,50560,51440,51230,410,200,94316,"2,416,344.11",160160
,20180323,51440,51230,51200,51250,49870,50320,50410,-910,-820,155050,"3,908,037.09",167392
,20180326,50320,50410,50400,50460,48900,49170,49650,-1240,-760,154496,"3,836,126.13",173132
,20180327,49170,49650,48950,50070,48940,49830,49680,180,30,145968,"3,626,092.34",189142
,20180328,49830,49680,49710,49930,49390,49430,49640,-250,-40,115230,"2,860,023.76",198160
,20180329,49430,49640,49790,50230,49410,50010,49800,370,160,181994,"4,532,402.06",216790
,20180330,50010,49800,50110,50450,49920,50340,50160,540,360,112732,"2,827,661.25",227386
,20180402,50340,50160,50320,50790,50260,50550,50460,390,300,108144,"2,728,600.95",230614
,20180403,50550,50460,50530,50810,50310,50530,50560,70,100,136086,"3,440,284.87",228992
,20180404,50530,50560,50650,50720,50350,50420,50510,-140,-50,116416,"2,940,090.44",230482
,20180409,50420,50510,50520,50810,50220,50750,50500,240,-10,123742,"3,124,917.20",232140
,20180410,50750,50500,50720,51350,50520,51170,50980,670,480,166274,"4,238,515.98",236596
,20180411,51170,50980,51400,51550,50900,51100,51270,120,290,186814,"4,789,408.08",229850
,20180412,51100,51270,51360,51370,50300,50620,50860,-650,-410,260970,"6,636,871.79",236052
,20180413,50620,50860,50320,50680,50140,50520,50420,-340,-440,225766,"5,691,834.34",240746
,20180416,50520,50420,50700,50740,50070,50490,50400,70,-20,249156,"6,279,510.93",242684
,20180417,50490,50400,50550,51050,50530,50820,50850,420,450,248942,"6,330,130.90",241290
,20180418,50820,50850,50590,51360,50450,51170,50830,320,-20,276956,"7,039,915.39",240394
,20180419,51170,50830,51700,52260,51620,51940,51890,1110,1060,345872,"8,974,740.76",230584
,20180420,51940,51890,51480,51670,51160,51400,51430,-490,-460,254906,"6,555,820.50",227188
,20180423,51400,51430,51580,52050,51420,51860,51720,430,290,236978,"6,128,555.29",227082
,20180424,51860,51720,51000,51840,50830,51530,51430,-190,-290,277464,"7,135,230.41",217922
,20180425,51530,51430,52050,52080,51490,51550,51760,120,330,241754,"6,257,698.24",208710
,20180426,51550,51760,51830,51920,51380,51590,51700,-170,-60,254250,"6,572,409.72",202400
,20180427,51590,51700,51400,51790,51390,51560,51610,-140,-90,225284,"5,814,437.42",196638
,20180502,51560,51610,50750,51210,50700,51190,50990,-420,-620,129718,"3,307,232.41",194974
,20180503,51190,50990,51000,51120,50860,51060,51000,70,10,151522,"3,863,980.49",190032
,20180504,51060,51000,51260,51370,50830,51290,51150,290,150,165814,"4,241,354.82",185122
,20180507,51290,51150,50970,51260,50960,51150,51100,0,-50,135288,"3,457,099.69",183706
,20180508,51150,51100,51440,51500,51040,51170,51220,70,120,94750,"2,426,878.21",187600
,20180509,51170,51220,50650,50960,50300,50710,50740,-510,-480,132658,"3,365,773.32",181794
,20180510,50710,50740,50800,51130,50740,50890,50950,150,210,92414,"2,354,459.97",180164
,20180511,50890,50950,51490,51490,51160,51240,51270,290,320,79250,"2,031,762.68",181850
,20180514,51240,51270,51320,51540,51260,51350,51370,80,100,73998,"1,900,716.09",182774
,20180515,51350,51370,51100,51260,50880,51020,51050,-350,-320,72494,"1,850,764.57",182942
,20180516,51020,51050,50770,51000,50520,50890,50780,-160,-270,71892,"1,825,418.03",177280
,20180517,50890,50780,50780,51070,50700,50900,50920,120,140,58112,"1,479,819.23",173330
,20180518,50900,50920,50960,51160,50880,51120,51050,200,130,58500,"1,493,476.58",164734
,20180521,51120,51050,50900,51330,50760,51210,51170,160,120,74224,"1,899,359.09",161368
,20180522,51210,51170,51490,51490,51220,51260,51290,90,120,48014,"1,231,521.51",156606
,20180523,51260,51290,51700,51980,51430,51570,51660,280,370,67480,"1,743,026.88",146174
,20180524,51570,51660,51190,51290,51000,51270,51190,-390,-470,57534,"1,472,701.81",141990
,20180525,51270,51190,51240,51460,51160,51330,51350,140,160,52512,"1,348,335.45",136992
,20180528,51330,51350,51320,51450,51120,51450,51290,100,-60,44146,"1,132,234.23",129430
,20180529,51450,51290,51250,51610,51110,51520,51410,230,120,51200,"1,316,217.79",118100
,20180530,51520,51410,51530,51760,50670,50700,51080,-710,-330,76250,"1,947,626.38",109328
,20180531,50700,51080,50870,51300,50790,51200,51110,120,30,48990,"1,252,084.00",95412
cu1807,20180102,56260,56400,56340,56350,55660,55960,55920,-440,-480,434,"12,136.23",27636
,20180103,55960,55920,55860,55930,55440,55590,55650,-330,-270,516,"14,359.28",27644
,20180104,55590,55650,55510,56020,55320,55940,55730,290,80,554,"15,437.66",27676
,20180105,55940,55730,56030,56030,55470,55560,55690,-170,-40,420,"11,694.95",27742
,20180108,55560,55690,55300,55450,55050,55280,55220,-410,-470,478,"13,199.00",27792
,20180109,55280,55220,55270,55690,55250,55690,55380,470,160,332,"9,194.35",27800
,20180110,55690,55380,55610,55750,55370,55420,55520,40,140,368,"10,215.74",27800
,20180111,55420,55520,55830,55900,55600,55700,55710,180,190,284,"7,912.12",27812
,20180112,55700,55710,55650,55690,54940,55380,55270,-330,-440,482,"13,321.39",28022
,20180115,55380,55270,55150,55700,55010,55580,55350,310,80,312,"8,635.96",28020
,20180116,55580,55350,55580,55580,54800,54900,55140,-450,-210,704,"19,411.95",28206
,20180117,54900,55140,54510,54620,54210,54210,54380,-930,-760,1114,"30,294.34",28210
,20180118,54210,54380,54310,54550,54080,54320,54270,-60,-110,1184,"32,131.34",28334
,20180119,54320,54270,54500,54500,54140,54300,54260,30,-10,1408,"38,204.65",28470
,20180122,54300,54260,54400,54560,53970,54530,54200,270,-60,938,"25,424.16",28494
,20180123,54530,54200,54450,54520,54070,54360,54320,160,120,2160,"58,666.46",28714
,20180124,54360,54320,53800,53800,53260,53350,53390,-970,-930,1890,"50,462.56",29576
,20180125,53350,53390,53500,55090,53450,54490,54570,1100,1180,15228,"415,545.46",34150
,20180126,54490,54570,54400,54520,53990,54110,54190,-460,-380,2890,"78,306.74",34332
,20180129,54110,54190,54060,54440,53810,54260,54190,70,0,5282,"143,135.33",35502
,20180130,54260,54190,54090,54260,53480,53600,53890,-590,-300,5194,"139,963.84",37084
,20180131,53600,53890,53800,53960,53550,53930,53760,40,-130,1228,"33,010.38",37118
,20180201,53930,53760,53990,54040,53620,53680,53840,-80,80,802,"21,591.24",37082
,20180202,53680,53840,53600,54310,53510,54160,53810,320,-30,1188,"31,967.62",37162
,20180205,54160,53810,53910,54000,53420,53730,53690,-80,-120,1566,"42,039.34",37666
,20180206,53730,53690,53730,54500,53320,53440,53780,-250,90,3196,"85,948.33",38400
,20180207,53440,53780,53550,53850,53160,53440,53480,-340,-300,2760,"73,813.93",39082
,20180208,53440,53480,53200,53340,52350,52650,52690,-830,-790,4212,"110,965.59",39996
,20180209,52650,52690,52640,52720,52020,52140,52330,-550,-360,2548,"66,670.35",40560
,20180212,52140,52330,51910,52410,51520,52230,52020,-100,-310,6640,"172,736.15",41402
,20180213,52230,52020,52200,52850,52090,52710,52460,690,440,6006,"157,555.00",42716
,20180214,52710,52460,52900,53400,52790,53330,53180,870,720,2150,"57,178.02",42724
,20180222,53330,53180,53630,53630,53140,53330,53330,150,150,5318,"141,809.91",44414
,20180223,53330,53330,53450,54490,53440,54200,54200,870,870,9428,"255,537.94",44926
,20180226,54200,54200,54000,54380,53810,54180,54060,-20,-140,6674,"180,406.91",45666
,20180227,54180,54060,54100,54170,53720,53940,53890,-120,-170,3926,"105,801.94",45994
,20180228,53940,53890,53720,53750,53060,53120,53290,-770,-600,6656,"177,369.55",47230
,20180301,53120,53290,53160,53230,52700,52850,52900,-440,-390,8020,"212,156.10",47462
,20180302,52850,52900,52510,53060,52500,52910,52810,10,-90,7292,"192,573.36",48716
,20180305,52910,52810,52720,52940,52410,52480,52680,-330,-130,11566,"304,705.80",50494
,20180306,52480,52680,52400,53090,52230,52990,52720,310,40,6934,"182,811.61",50838
,20180307,52990,52720,53220,53310,52800,52850,53030,130,310,6532,"173,214.23",50740
,20180308,52850,53030,52620,52800,52340,52400,52580,-630,-450,8632,"226,972.40",51818
,20180309,52400,52580,52110,52310,51470,51550,51880,-1030,-700,13494,"350,051.14",52660
,20180312,51550,51880,51800,52940,51780,52350,52480,470,600,15120,"396,797.50",54500
,20180313,52350,52480,52340,52570,52150,52170,52310,-310,-170,9162,"239,676.70",55792
,20180314,52170,52310,52500,52900,52320,52770,52640,460,330,9552,"251,445.83",56784
,20180315,52770,52640,53000,53170,52440,52600,52800,-40,160,13476,"355,824.49",57206
,20180316,52600,52800,52320,52760,52210,52580,52420,-220,-380,9098,"238,469.21",58682
,20180319,52580,52420,52580,52620,51600,51830,51960,-590,-460,20604,"535,311.65",61410
,20180320,51830,51960,51710,52060,51540,51830,51780,-130,-180,12806,"331,563.35",63376
,20180321,51830,51780,51820,51820,50880,50990,51250,-790,-530,19078,"488,914.90",67204
,20180322,50990,51250,50800,51850,50770,51590,51460,340,210,27634,"711,038.84",69426
,20180323,51590,51460,51390,51410,50040,50460,50560,-1000,-900,38052,"961,996.24",72040
,20180326,50460,50560,50460,50610,49030,49230,49750,-1330,-810,35548,"884,419.22",76010
,20180327,49230,49750,49110,50220,49080,49970,49860,220,110,38184,"952,033.91",80556
,20180328,49970,49860,49840,50050,49550,49580,49800,-280,-60,29764,"741,190.62",85970
,20180329,49580,49800,49900,50370,49540,50140,49940,340,140,55902,"1,395,891.58",90858
,20180330,50140,49940,50190,50620,50090,50510,50320,570,380,35394,"890,520.82",98844
,20180402,50510,50320,50600,50950,50440,50750,50620,430,300,22966,"581,341.80",101660
,20180403,50750,50620,50750,50990,50470,50680,50710,60,90,36206,"918,176.76",103956
,20180404,50680,50710,50780,50850,50510,50570,50650,-140,-60,31300,"792,792.89",106256
,20180409,50570,50650,50700,50950,50370,50900,50680,250,30,52934,"1,341,484.52",109478
,20180410,50900,50680,50800,51490,50680,51300,51140,620,460,37274,"953,175.66",113858
,20180411,51300,51140,51530,51690,51070,51280,51430,140,290,45526,"1,170,894.95",117392
,20180412,51280,51430,51500,51550,50470,50790,51030,-640,-400,68328,"1,743,405.44",123470
,20180413,50790,51030,50470,50840,50280,50700,50580,-330,-450,53994,"1,365,577.18",126986
,20180416,50700,50580,50850,50880,50230,50630,50540,50,-40,45868,"1,159,266.09",130102
,20180417,50630,50540,50700,51200,50680,51000,51000,460,460,54196,"1,382,257.04",132562
,20180418,51000,51000,50700,51530,50610,51330,51030,330,30,55520,"1,416,824.25",133322
,20180419,51330,51030,51920,52480,51800,52130,52100,1100,1070,94770,"2,469,042.01",139356
,20180420,52130,52100,51680,51860,51340,51570,51610,-530,-490,68660,"1,771,972.39",142524
,20180423,51570,51610,51730,52230,51610,52070,51910,460,300,64526,"1,675,075.75",149384
,20180424,52070,51910,51160,52030,51000,51720,51570,-190,-340,88322,"2,277,612.76",148736
,20180425,51720,51570,52230,52250,51680,51730,51930,160,360,84258,"2,187,824.08",150746
,20180426,51730,51930,51980,52080,51550,51760,51860,-170,-70,87510,"2,269,374.38",158078
,20180427,51760,51860,51590,51970,51560,51770,51780,-90,-80,96122,"2,488,876.93",169660
,20180502,51770,51780,50960,51400,50900,51380,51170,-400,-610,82136,"2,101,624.47",183048
,20180503,51380,51170,51180,51310,51020,51230,51170,60,0,101286,"2,591,803.51",191858
,20180504,51230,51170,51450,51550,50990,51480,51330,310,160,128410,"3,295,775.13",194632
,20180507,51480,51330,51160,51430,51130,51340,51280,10,-50,125368,"3,214,587.23",197756
,20180508,51340,51280,51630,51680,51220,51370,51400,90,120,123160,"3,165,421.54",203032
,20180509,51370,51400,50800,51130,50450,50870,50900,-530,-500,246322,"6,269,663.22",213992
,20180510,50870,50900,51000,51320,50920,51070,51110,170,210,197810,"5,055,281.42",221634
,20180511,51070,51110,51700,51700,51350,51440,51480,330,370,212786,"5,477,335.74",222190
,20180514,51440,51480,51500,51760,51460,51560,51570,80,90,205314,"5,294,923.60",218296
,20180515,51560,51570,51290,51470,51060,51210,51270,-360,-300,187332,"4,802,884.78",216072
,20180516,51210,51270,51000,51200,50690,51020,50940,-250,-330,218378,"5,562,132.08",215988
,20180517,51020,50940,50960,51270,50880,51050,51070,110,130,157436,"4,020,733.49",211238
,20180518,51050,51070,51160,51370,51060,51290,51240,220,170,141748,"3,631,700.52",206310
,20180521,51290,51240,51090,51520,50920,51370,51290,130,50,256254,"6,571,718.62",212512
,20180522,51370,51290,51650,51660,51390,51440,51480,150,190,154338,"3,973,413.61",208812
,20180523,51440,51480,51880,52180,51620,51770,51880,290,400,246000,"6,382,331.95",205482
,20180524,51770,51880,51380,51460,51250,51430,51350,-450,-530,174960,"4,492,888.35",195564
,20180525,51430,51350,51450,51640,51310,51490,51490,140,140,161524,"4,159,065.61",190732
,20180528,51490,51490,51460,51630,51270,51610,51450,120,-40,137284,"3,531,766.60",186630
,20180529,51610,51450,51290,51810,51270,51710,51540,260,90,179284,"4,620,654.81",187898
,20180530,51710,51540,51780,51960,50780,50780,51330,-760,-210,302378,"7,761,123.24",196688
,20180531,50780,51330,50930,51480,50900,51380,51230,50,-100,208730,"5,346,745.90",175082
cu1808,20180102,56410,56560,56310,56500,55760,56160,56050,-400,-510,396,"11,099.35",24740
,20180103,56160,56050,56070,56100,55580,55720,55760,-330,-290,588,"16,394.64",24952
,20180104,55720,55760,55620,56160,55500,56080,55960,320,200,408,"11,416.46",25020
,20180105,56080,55960,56160,56160,55620,55690,55780,-270,-180,218,"6,080.15",25134
,20180108,55690,55780,55380,55560,55240,55380,55380,-400,-400,318,"8,806.62",25170
,20180109,55380,55380,55340,55800,55340,55800,55550,420,170,98,"2,722.19",25202
,20180110,55800,55550,55900,55900,55550,55570,55680,20,130,162,"4,510.15",25268
,20180111,55570,55680,56060,56060,55750,55870,55870,190,190,108,"3,017.09",25268
,20180112,55870,55870,55770,55840,55070,55490,55430,-380,-440,104,"2,882.74",25300
,20180115,55490,55430,55300,55850,55200,55690,55530,260,100,228,"6,331.40",25274
,20180116,55690,55530,55750,55750,54980,55080,55320,-450,-210,380,"10,511.18",25510
,20180117,55080,55320,54230,54740,54220,54410,54540,-910,-780,384,"10,472.94",25546
,20180118,54410,54540,54470,54630,54270,54410,54440,-130,-100,270,"7,349.51",25598
,20180119,54410,54440,54500,54600,54310,54520,54430,80,-10,142,"3,865.07",25620
,20180122,54520,54430,54540,54650,54100,54650,54340,220,-90,240,"6,521.30",25582
,20180123,54650,54340,54600,54720,54240,54490,54500,150,160,4338,"118,228.14",27058
,20180124,54490,54500,53810,53810,53400,53500,53540,-1000,-960,1256,"33,626.08",27506
,20180125,53500,53540,53700,55300,53600,54650,54850,1110,1310,20468,"561,375.96",35694
,20180126,54650,54850,54560,54670,54170,54250,54360,-600,-490,2798,"76,057.99",35372
,20180129,54250,54360,54020,54600,53980,54450,54420,90,60,2640,"71,838.55",35130
,20180130,54450,54420,55050,55050,53660,53750,53990,-670,-430,820,"22,138.38",35312
,20180131,53750,53990,53990,54110,53710,54080,53890,90,-100,674,"18,163.03",35474
,20180201,54080,53890,54060,54180,53790,53880,53970,-10,80,468,"12,631.16",35494
,20180202,53880,53970,53800,54490,53720,54380,53960,410,-10,646,"17,431.58",35528
,20180205,54380,53960,54000,54180,53600,53920,53850,-40,-110,1166,"31,395.76",35882
,20180206,53920,53850,53900,54640,53500,53600,54040,-250,190,1136,"30,700.35",35928
,20180207,53600,54040,53750,54030,53400,53620,53690,-420,-350,1440,"38,662.48",36344
,20180208,53620,53690,53450,53490,52520,52820,52880,-870,-810,3230,"85,402.49",37354
,20180209,52820,52880,52840,52900,52220,52300,52410,-580,-470,2838,"74,376.31",38712
,20180212,52300,52410,52060,52600,51680,52440,52110,30,-300,2098,"54,665.39",38860
,20180213,52440,52110,52400,53050,52290,52920,52780,810,670,1722,"45,447.64",39164
,20180214,52920,52780,53060,53600,53030,53550,53400,770,620,820,"21,894.23",39194
,20180222,53550,53400,53820,53820,53350,53550,53520,150,120,764,"20,445.29",39092
,20180223,53550,53520,53670,54900,53670,54390,54420,870,900,5260,"143,135.24",39810
,20180226,54390,54420,54280,54550,54040,54400,54320,-20,-100,1692,"45,959.99",40070
,20180227,54400,54320,54330,54370,53930,54120,54120,-200,-200,916,"24,787.56",40072
,20180228,54120,54120,53850,53900,53270,53350,53470,-770,-650,1112,"29,731.36",40290
,20180301,53350,53470,53430,53440,52900,53050,53130,-420,-340,770,"20,455.32",40308
,20180302,53050,53130,52780,53250,52700,53140,52960,10,-170,654,"17,319.23",40446
,20180305,53140,52960,52940,53140,52600,52690,52850,-270,-110,1732,"45,774.74",40648
,20180306,52690,52850,52650,53270,52430,53180,52890,330,40,974,"25,759.90",40758
,20180307,53180,52890,53290,53470,52970,53040,53180,150,290,1992,"52,975.94",40858
,20180308,53040,53180,52770,52970,52520,52620,52790,-560,-390,1962,"51,791.51",41060
,20180309,52620,52790,52350,52510,51660,51740,52140,-1050,-650,6166,"160,772.07",42382
,20180312,51740,52140,52040,53130,52010,52590,52700,450,560,4786,"126,120.12",43482
,20180313,52590,52700,52560,52800,52370,52390,52560,-310,-140,2888,"75,902.56",43850
,20180314,52390,52560,52730,53100,52520,52960,52780,400,220,2644,"69,788.18",43812
,20180315,52960,52780,53210,53370,52640,52770,52990,-10,210,2132,"56,493.05",43532
,20180316,52770,52990,52530,52950,52350,52820,52620,-170,-370,2666,"70,147.29",43424
,20180319,52820,52620,52770,52820,51820,52020,52280,-600,-340,11780,"307,961.91",43698
,20180320,52020,52280,51770,52240,51740,52040,51950,-240,-330,2964,"77,003.79",43946
,20180321,52040,51950,51990,51990,51060,51150,51450,-800,-500,6888,"177,222.39",45140
,20180322,51150,51450,51000,52020,50930,51760,51580,310,130,6762,"174,398.88",45994
,20180323,51760,51580,51470,51560,50210,50600,50630,-980,-950,17918,"453,599.24",46126
,20180326,50600,50630,50600,50750,49200,49390,49840,-1240,-790,14616,"364,251.95",46874
,20180327,49390,49840,49280,50370,49180,50130,50050,290,210,11000,"275,305.02",48502
,20180328,50130,50050,50020,50230,49710,49740,49970,-310,-80,6214,"155,273.30",49334
,20180329,49740,49970,50100,50540,49690,50350,50070,380,100,12570,"314,711.53",50016
,20180330,50350,50070,50400,50790,50260,50680,50490,610,420,8590,"216,880.25",49540
,20180402,50680,50490,50710,51130,50620,50900,50820,410,330,5358,"136,157.65",49472
,20180403,50900,50820,50900,51160,50660,50840,50890,20,70,9954,"253,322.40",49788
,20180404,50840,50890,50930,51040,50670,50750,50840,-140,-50,10224,"259,904.81",49394
,20180409,50750,50840,50840,51130,50540,51090,50830,250,-10,14510,"368,782.10",51546
,20180410,51090,50830,51040,51680,50850,51470,51340,640,510,14196,"364,439.98",51602
,20180411,51470,51340,51720,51870,51250,51440,51590,100,250,15232,"392,917.38",51826
,20180412,51440,51590,51610,51710,50660,50910,51120,-680,-470,15058,"384,937.36",53926
,20180413,50910,51120,50630,50990,50460,50850,50760,-270,-360,13692,"347,505.65",55228
,20180416,50850,50760,51000,51060,50410,50800,50740,40,-20,10050,"254,974.58",55964
,20180417,50800,50740,50830,51360,50830,51170,51170,430,430,15604,"399,281.81",55938
,20180418,51170,51170,50860,51700,50790,51530,51220,360,50,17380,"445,167.94",56346
,20180419,51530,51220,52290,52680,52010,52300,52310,1080,1090,36968,"966,932.74",61498
,20180420,52300,52310,51880,52030,51530,51740,51800,-570,-510,20810,"539,054.04",63530
,20180423,51740,51800,51900,52400,51790,52230,52100,430,300,20538,"535,084.85",66998
,20180424,52230,52100,51550,52200,51200,51860,51770,-240,-330,26842,"694,851.06",69174
,20180425,51860,51770,52280,52430,51870,51910,52130,140,360,22704,"591,848.46",71152
,20180426,51910,52130,52170,52250,51720,51930,52000,-200,-130,22442,"583,599.02",73118
,20180427,51930,52000,51790,52120,51740,51950,51950,-50,-50,20392,"529,760.98",74556
,20180502,51950,51950,51400,51580,51080,51520,51350,-430,-600,22156,"568,927.52",76422
,20180503,51520,51350,51450,51480,51220,51410,51350,60,0,17220,"442,181.01",78130
,20180504,51410,51350,51600,51720,51180,51640,51500,290,150,21388,"550,765.58",79790
,20180507,51640,51500,51310,51600,51310,51500,51460,0,-40,21508,"553,443.11",80208
,20180508,51500,51460,51800,51840,51410,51560,51570,100,110,17344,"447,270.10",82536
,20180509,51560,51570,51110,51290,50640,51050,51080,-520,-490,39500,"1,008,932.25",87578
,20180510,51050,51080,51140,51480,51100,51270,51300,190,220,32998,"846,416.82",91156
,20180511,51270,51300,51740,51840,51540,51620,51650,320,350,29664,"766,107.80",94740
,20180514,51620,51650,51680,51940,51640,51760,51760,110,110,25824,"668,410.43",96578
,20180515,51760,51760,51500,51650,51250,51390,51460,-370,-300,31268,"804,591.04",97826
,20180516,51390,51460,51120,51370,50870,51230,51130,-230,-330,36390,"930,345.57",100418
,20180517,51230,51130,51140,51450,51070,51230,51260,100,130,24302,"622,900.39",101814
,20180518,51230,51260,51310,51540,51240,51450,51420,190,160,26470,"680,628.43",104250
,20180521,51450,51420,51280,51710,51130,51590,51480,170,60,63278,"1,629,040.46",114404
,20180522,51590,51480,51820,51850,51590,51640,51670,160,190,40820,"1,054,738.92",117598
,20180523,51640,51670,52050,52380,51800,51960,52060,290,390,83852,"2,183,026.63",119380
,20180524,51960,52060,51590,51640,51430,51610,51540,-450,-520,54878,"1,414,308.90",123674
,20180525,51610,51540,51590,51830,51500,51670,51680,130,140,58716,"1,517,325.46",130750
,20180528,51670,51680,51610,51780,51450,51770,51620,90,-60,45544,"1,175,641.29",133246
,20180529,51770,51620,51450,51980,51450,51880,51730,260,110,58516,"1,513,808.83",134936
,20180530,51880,51730,51920,52120,50900,50930,51440,-800,-290,145992,"3,755,319.50",153390
,20180531,50930,51440,51100,51650,51000,51560,51380,120,-60,95526,"2,454,225.81",155796
cu1809,20180102,56500,56790,56510,56650,56010,56350,56240,-440,-550,158,"4,443.51",19700
,20180103,56350,56240,56100,56260,55770,55910,55910,-330,-330,956,"26,728.57",19488
,20180104,55910,55910,55880,56350,55680,56300,55960,390,50,1052,"29,436.35",19720
,20180105,56300,55960,56420,56420,55800,55890,55950,-70,-10,474,"13,260.72",19724
,20180108,55890,55950,55600,55760,55430,55570,55640,-380,-310,626,"17,416.53",19608
,20180109,55570,55640,55710,56020,55600,55960,55770,320,130,72,"2,007.77",19614
,20180110,55960,55770,56090,56090,55730,55750,55890,-20,120,88,"2,459.54",19598
,20180111,55750,55890,56230,56230,55900,56040,56030,150,140,216,"6,051.55",19644
,20180112,56040,56030,55940,55940,55260,55730,55490,-300,-540,122,"3,385.01",19628
,20180115,55730,55490,55510,56020,55340,55950,55840,460,350,192,"5,361.04",19652
,20180116,55950,55840,55910,55910,55150,55210,55510,-630,-330,114,"3,164.42",19660
,20180117,55210,55510,54850,54970,54560,54560,54640,-950,-870,396,"10,820.27",19594
,20180118,54560,54640,54650,54850,54430,54620,54650,-20,10,462,"12,625.59",19598
,20180119,54620,54650,54660,54760,54480,54690,54590,40,-60,304,"8,297.89",19616
,20180122,54690,54590,54680,54850,54280,54810,54430,220,-160,382,"10,397.29",19648
,20180123,54810,54430,54680,54980,54410,54680,54710,250,280,5202,"142,319.35",22090
,20180124,54680,54710,54200,54200,53590,53680,53750,-1030,-960,1430,"38,434.86",22158
,20180125,53680,53750,53800,55790,53770,54860,54890,1110,1140,16022,"439,735.78",27940
,20180126,54860,54890,54790,54870,54330,54430,54530,-460,-360,6398,"174,453.32",29268
,20180129,54430,54530,54350,54780,54140,54620,54630,90,100,5324,"145,441.22",29580
,20180130,54620,54630,54450,54560,53870,53930,54180,-700,-450,720,"19,507.84",29454
,20180131,53930,54180,54050,54300,53910,54260,54070,80,-110,404,"10,922.65",29472
,20180201,54260,54070,54280,54400,53970,54010,54190,-60,120,332,"8,996.44",29492
,20180202,54010,54190,53970,54670,53890,54560,54370,370,180,284,"7,720.74",29434
,20180205,54560,54370,54340,54340,53880,54080,54020,-290,-350,256,"6,915.61",29410
,20180206,54080,54020,54070,54830,53660,53810,53970,-210,-50,1060,"28,605.49",29672
,20180207,53810,53970,53930,54240,53580,53730,53810,-240,-160,552,"14,853.97",29786
,20180208,53730,53810,53600,53600,52700,53040,52990,-770,-820,1750,"46,367.27",30244
,20180209,53040,52990,53020,53080,52370,52490,52610,-500,-380,736,"19,360.91",30334
,20180212,52490,52610,52240,52770,51840,52610,52250,0,-360,836,"21,842.96",30316
,20180213,52610,52250,52660,53280,52490,53110,53020,860,770,2196,"58,224.30",30838
,20180214,53110,53020,53270,53780,53210,53650,53580,630,560,484,"12,968.34",30872
,20180222,53650,53580,53670,54010,53550,53740,53700,160,120,586,"15,734.84",30768
,20180223,53740,53700,53850,54950,53820,54620,54690,920,990,7570,"207,007.11",32434
,20180226,54620,54690,54470,54800,54260,54620,54610,-70,-80,3056,"83,447.00",34216
,20180227,54620,54610,54550,54590,54130,54350,54350,-260,-260,1512,"41,091.32",34212
,20180228,54350,54350,54200,54200,53460,53550,53720,-800,-630,2110,"56,675.54",34724
,20180301,53550,53720,53600,53630,53100,53260,53300,-460,-420,980,"26,118.87",34740
,20180302,53260,53300,52940,53450,52900,53350,53210,50,-90,1090,"29,004.69",34992
,20180305,53350,53210,53200,53310,52820,52920,53060,-290,-150,1134,"30,085.55",34952
,20180306,52920,53060,52800,53470,52610,53390,53150,330,90,2048,"54,427.71",35206
,20180307,53390,53150,53440,53640,53180,53240,53380,90,230,1152,"30,748.33",35250
,20180308,53240,53380,53040,53200,52730,52790,52970,-590,-410,1324,"35,068.41",35132
,20180309,52790,52970,52550,52700,51870,51980,52320,-990,-650,2402,"62,837.38",35512
,20180312,51980,52320,52250,53350,52250,52710,52920,390,600,2140,"56,633.05",35692
,20180313,52710,52920,52780,53000,52580,52590,52770,-330,-150,1764,"46,551.44",35736
,20180314,52590,52770,52880,53300,52730,53160,52970,390,200,1168,"30,936.71",35606
,20180315,53160,52970,53500,53550,52830,53000,53330,30,360,1524,"40,638.77",35722
,20180316,53000,53330,52690,53190,52620,52950,52790,-380,-540,1372,"36,220.75",35760
,20180319,52950,52790,52750,52990,52020,52230,52370,-560,-420,5746,"150,467.87",36944
,20180320,52230,52370,52250,52430,51920,52250,52130,-120,-240,1384,"36,077.69",36666
,20180321,52250,52130,52110,52130,51260,51380,51670,-750,-460,4470,"115,499.35",38012
,20180322,51380,51670,51280,52200,51190,51950,51890,280,220,5518,"143,168.25",39180
,20180323,51950,51890,51710,51760,50380,50700,50840,-1190,-1050,5220,"132,707.01",39734
,20180326,50700,50840,50870,50920,49400,49520,49840,-1320,-1000,12810,"319,275.34",36552
,20180327,49520,49840,49410,50540,49380,50320,50160,480,320,5158,"129,387.15",37294
,20180328,50320,50160,50200,50400,49890,49920,50100,-240,-60,2818,"70,597.90",37586
,20180329,49920,50100,50220,50710,49860,50500,50280,400,180,6800,"170,970.14",36752
,20180330,50500,50280,50590,50980,50430,50900,50680,620,400,3050,"77,299.18",36476
,20180402,50900,50680,50890,51270,50790,51090,50960,410,280,2788,"71,046.68",36434
,20180403,51090,50960,51060,51310,50820,50990,51050,30,90,6724,"171,657.57",37174
,20180404,50990,51050,51080,51170,50830,50900,51000,-150,-50,4954,"126,332.91",36658
,20180409,50900,51000,50720,51320,50690,51310,50980,310,-20,4910,"125,158.40",36492
,20180410,51310,50980,51220,51870,51010,51610,51470,630,490,4506,"115,970.23",36922
,20180411,51610,51470,51880,52050,51420,51620,51780,150,310,5038,"130,449.51",37362
,20180412,51620,51780,51710,51890,50830,51200,51330,-580,-450,7576,"194,438.25",37440
,20180413,51200,51330,50990,51160,50650,51040,50920,-290,-410,5992,"152,574.86",37766
,20180416,51040,50920,51090,51240,50600,51020,50920,100,0,5876,"149,615.15",38128
,20180417,51020,50920,51080,51540,51050,51360,51350,440,430,3956,"101,589.47",38034
,20180418,51360,51350,51150,51880,50970,51670,51400,320,50,6466,"166,186.48",37648
,20180419,51670,51400,52010,52880,52010,52480,52520,1080,1120,18986,"498,634.56",37542
,20180420,52480,52520,52100,52220,51730,51930,52000,-590,-520,7956,"206,871.31",37998
,20180423,51930,52000,52070,52580,51960,52430,52260,430,260,4576,"119,592.50",38360
,20180424,52430,52260,51500,52380,51380,52060,51910,-200,-350,7404,"192,202.16",38242
,20180425,52060,51910,52560,52600,52050,52080,52320,170,410,7362,"192,591.48",38590
,20180426,52080,52320,52370,52420,51910,52090,52230,-230,-90,8920,"232,969.07",40466
,20180427,52090,52230,51950,52300,51940,52110,52130,-120,-100,8366,"218,062.04",41288
,20180502,52110,52130,51540,51750,51250,51700,51500,-430,-630,9626,"247,914.71",40560
,20180503,51700,51500,51560,51650,51390,51570,51520,70,20,8264,"212,907.70",41278
,20180504,51570,51520,51780,51890,51350,51830,51680,310,160,9920,"256,365.43",41470
,20180507,51830,51680,51600,51790,51480,51680,51630,0,-50,8580,"221,503.60",41662
,20180508,51680,51630,51980,52050,51600,51720,51750,90,120,6958,"180,068.10",42328
,20180509,51720,51750,51210,51460,50820,51240,51250,-510,-500,14886,"381,526.94",43416
,20180510,51240,51250,51380,51660,51280,51460,51470,210,220,10442,"268,726.24",43482
,20180511,51460,51470,51930,52000,51710,51770,51820,300,350,12236,"317,052.68",45792
,20180514,51770,51820,51880,52100,51820,51940,51930,120,110,14168,"367,892.36",48236
,20180515,51940,51930,51680,51840,51430,51580,51640,-350,-290,11098,"286,583.19",48988
,20180516,51580,51640,51320,51550,51050,51420,51300,-220,-340,14894,"382,087.26",49028
,20180517,51420,51300,51420,51630,51240,51420,51450,120,150,10278,"264,428.62",49372
,20180518,51420,51450,51490,51720,51420,51660,51600,210,150,9560,"246,666.16",50998
,20180521,51660,51600,51560,51900,51340,51760,51690,160,90,25202,"651,380.50",56398
,20180522,51760,51690,52050,52060,51770,51820,51870,130,180,11300,"293,077.93",56562
,20180523,51820,51870,52230,52550,52000,52150,52250,280,380,26590,"694,674.28",59774
,20180524,52150,52250,51830,51830,51620,51780,51720,-470,-530,21626,"559,284.37",62612
,20180525,51780,51720,51800,52010,51680,51850,51850,130,130,20112,"521,444.82",66562
,20180528,51850,51850,51830,51950,51620,51930,51810,80,-40,19860,"514,506.26",70776
,20180529,51930,51810,51700,52170,51630,52070,51890,260,80,28786,"746,974.29",77652
,20180530,52070,51890,52070,52300,51060,51090,51680,-800,-210,75248,"1,944,631.57",75944
,20180531,51090,51680,51190,51800,51180,51690,51520,10,-160,29416,"757,766.78",78594
cu1810,20180102,56780,56920,56700,56840,56160,56520,56330,-400,-590,1104,"31,096.36",17498
,20180103,56520,56330,56460,56460,55950,56060,56120,-270,-210,1012,"28,399.57",17242
,20180104,56060,56120,56000,56550,55900,56500,56250,380,130,678,"19,069.78",17186
,20180105,56500,56250,56450,56460,56010,56090,56170,-160,-80,214,"6,010.23",17158
,20180108,56090,56170,55830,55960,55600,55790,55750,-380,-420,436,"12,155.57",17128
,20180109,55790,55750,55800,56200,55800,56200,55930,450,180,56,"1,566.31",17146
,20180110,56200,55930,56220,56260,55840,55910,56010,-20,80,128,"3,584.81",17144
,20180111,55910,56010,56300,56440,56000,56190,56230,180,220,152,"4,273.57",17156
,20180112,56190,56230,56100,56130,55400,55900,55850,-330,-380,166,"4,636.15",17116
,20180115,55900,55850,55710,56270,55530,56110,55900,260,50,148,"4,136.84",17132
,20180116,56110,55900,55990,55990,55320,55380,55520,-520,-380,296,"8,217.55",17086
,20180117,55380,55520,55160,55160,54690,54700,54840,-820,-680,462,"12,670.21",17024
,20180118,54700,54840,54810,55010,54610,54770,54810,-70,-30,232,"6,357.98",17048
,20180119,54770,54810,54850,54960,54650,54860,54770,50,-40,304,"8,325.58",17062
,20180122,54860,54770,54870,55030,54450,55000,54630,230,-140,194,"5,299.93",17072
,20180123,55000,54630,54700,55100,54620,54850,54940,220,310,1810,"49,725.79",17892
,20180124,54850,54940,54130,54150,53780,53880,53940,-1060,-1000,776,"20,932.16",17816
,20180125,53880,53940,54040,55620,53960,55020,55130,1080,1190,12180,"335,768.64",23776
,20180126,55020,55130,54920,55040,54520,54580,54740,-550,-390,3748,"102,595.76",24688
,20180129,54580,54740,54630,54970,54330,54850,54820,110,80,2652,"72,692.48",24832
,20180130,54850,54820,54670,54770,54030,54090,54440,-730,-380,596,"16,224.28",24748
,20180131,54090,54440,54280,54500,54100,54470,54290,30,-150,392,"10,642.07",24792
,20180201,54470,54290,54400,54570,54180,54220,54350,-70,60,364,"9,893.11",24786
,20180202,54220,54350,54120,54850,54120,54760,54600,410,250,362,"9,882.77",24822
,20180205,54760,54600,54480,54540,53780,54280,54210,-320,-390,670,"18,162.26",24718
,20180206,54280,54210,54280,55040,53880,53970,54220,-240,10,992,"26,897.93",24542
,20180207,53970,54220,54140,54400,53770,54000,54000,-220,-220,512,"13,824.62",24492
,20180208,54000,54000,53790,53810,52880,53210,53200,-790,-800,1626,"43,254.85",24456
,20180209,53210,53200,53010,53210,52560,52640,52860,-560,-340,538,"14,221.36",24432
,20180212,52640,52860,52210,52940,52030,52930,52440,70,-420,556,"14,580.69",24450
,20180213,52930,52440,52770,53480,52720,53300,53240,860,800,2528,"67,306.89",25074
,20180214,53300,53240,53470,53940,53440,53930,53720,690,480,256,"6,876.94",24996
,20180222,53930,53720,53900,54000,53780,53930,53880,210,160,162,"4,364.91",24982
,20180223,53930,53880,54080,55150,54080,54800,54850,920,970,9654,"264,795.50",26870
,20180226,54800,54850,54630,54950,54460,54820,54760,-30,-90,2172,"59,474.71",27728
,20180227,54820,54760,54720,54720,54350,54550,54460,-210,-300,912,"24,836.16",27740
,20180228,54550,54460,54300,54340,53670,53700,53790,-760,-670,1622,"43,627.56",27564
,20180301,53700,53790,53840,53850,53280,53450,53540,-340,-250,1724,"46,155.48",27988
,20180302,53450,53540,53190,53630,53090,53530,53380,-10,-160,282,"7,526.95",27988
,20180305,53530,53380,53430,53450,53000,53090,53210,-290,-170,312,"8,302.25",28010
,20180306,53090,53210,53090,53660,52860,53620,53310,410,100,236,"6,291.03",27982
,20180307,53620,53310,53840,53840,53380,53420,53520,110,210,1372,"36,717.21",27924
,20180308,53420,53520,53190,53350,52910,53010,53190,-510,-330,608,"16,170.02",27968
,20180309,53010,53190,52870,52900,52070,52130,52490,-1060,-700,1156,"30,341.70",28110
,20180312,52130,52490,52560,53560,52560,52900,53190,410,700,1434,"38,143.63",28150
,20180313,52900,53190,53050,53230,52810,52810,52990,-380,-200,1668,"44,199.08",28066
,20180314,52810,52990,53190,53540,52970,53340,53200,350,210,1066,"28,359.66",28030
,20180315,53340,53200,53640,53810,53030,53210,53600,10,400,1876,"50,282.52",27962
,20180316,53210,53600,52920,53390,52820,53210,53040,-390,-560,988,"26,205.47",27956
,20180319,53210,53040,53160,53210,52240,52450,52620,-590,-420,1376,"36,204.25",28158
,20180320,52450,52620,52450,52620,52160,52450,52380,-170,-240,990,"25,929.81",28264
,20180321,52450,52380,52250,52250,51460,51560,51890,-820,-490,1190,"30,880.15",28560
,20180322,51560,51890,51490,52400,51430,52150,52080,260,190,1296,"33,749.84",28772
,20180323,52150,52080,51860,51920,50620,50980,51030,-1100,-1050,1606,"40,982.37",28922
,20180326,50980,51030,50930,51110,49590,49830,50130,-1200,-900,3020,"75,708.59",29160
,20180327,49830,50130,49670,50730,49670,50500,50370,370,240,2108,"53,098.55",29314
,20180328,50500,50370,50410,50570,50080,50110,50320,-260,-50,1216,"30,597.97",29410
,20180329,50110,50320,50460,50880,50010,50730,50440,410,120,4316,"108,867.44",29790
,20180330,50730,50440,50690,51150,50650,51100,50840,660,400,2170,"55,165.94",30048
,20180402,51100,50840,51140,51450,50980,51270,51150,430,310,2274,"58,157.68",30120
,20180403,51270,51150,51240,51500,51020,51180,51220,30,70,3822,"97,898.94",30518
,20180404,51180,51220,51270,51350,51030,51100,51190,-120,-30,2168,"55,493.28",30340
,20180409,51100,51190,51330,51500,50870,51480,51210,290,20,3170,"81,183.61",30378
,20180410,51480,51210,51400,52070,51210,51800,51610,590,400,1994,"51,461.40",30370
,20180411,51800,51610,52110,52230,51620,51740,52020,130,410,1912,"49,738.70",30608
,20180412,51740,52020,52000,52050,51030,51350,51560,-670,-460,1982,"51,096.69",30594
,20180413,51350,51560,50960,51340,50880,51240,51110,-320,-450,1130,"28,879.55",30792
,20180416,51240,51110,51390,51400,50800,51150,51070,40,-40,984,"25,129.76",30782
,20180417,51150,51070,51250,51700,51240,51530,51530,460,460,928,"23,909.97",30700
,20180418,51530,51530,51330,52040,51170,51820,51650,290,120,1170,"30,220.65",30452
,20180419,51820,51650,52500,53080,52400,52630,52780,980,1130,5028,"132,696.08",30902
,20180420,52630,52780,52190,52380,51910,52130,52180,-650,-600,1814,"47,330.23",30898
,20180423,52130,52180,52270,52770,52170,52580,52430,400,250,1030,"27,004.90",30948
,20180424,52580,52430,52290,52510,51600,52270,52140,-160,-290,1192,"31,079.81",30834
,20180425,52270,52140,52420,52790,52220,52280,52490,140,350,1596,"41,889.23",30874
,20180426,52280,52490,52420,52620,52120,52300,52440,-190,-50,1720,"45,100.88",30832
,20180427,52300,52440,52160,52480,52160,52320,52320,-120,-120,2406,"62,949.44",31014
,20180502,52320,52320,51330,51990,51310,51890,51680,-430,-640,1504,"38,870.04",31156
,20180503,51890,51680,51860,51860,51580,51760,51730,80,50,1856,"48,006.72",31408
,20180504,51760,51730,51960,52060,51540,51960,51870,230,140,1096,"28,427.07",31270
,20180507,51960,51870,51830,51950,51680,51860,51780,-10,-90,2902,"75,140.78",31500
,20180508,51860,51780,52000,52250,51800,51910,51910,130,130,1556,"40,389.59",31554
,20180509,51910,51910,51380,51620,51000,51410,51410,-500,-500,4658,"119,752.69",31900
,20180510,51410,51410,51520,51840,51460,51630,51670,220,260,2530,"65,365.27",32416
,20180511,51630,51670,52110,52180,51880,51970,52000,300,330,1780,"46,280.19",32174
,20180514,51970,52000,52020,52290,52010,52120,52140,120,140,2362,"61,583.06",32140
,20180515,52120,52140,51850,52000,51640,51770,51820,-370,-320,1716,"44,464.86",32206
,20180516,51770,51820,51550,51740,51250,51640,51500,-180,-320,2076,"53,464.94",32328
,20180517,51640,51500,51530,51780,51450,51590,51660,90,160,2696,"69,639.01",32376
,20180518,51590,51660,51690,51900,51600,51840,51780,180,120,1690,"43,762.31",32460
,20180521,51840,51780,51710,52070,51520,51940,51890,160,110,2412,"62,582.42",32632
,20180522,51940,51890,52180,52190,51970,52000,52050,110,160,2252,"58,609.80",32920
,20180523,52000,52050,52410,52720,52190,52350,52430,300,380,4622,"121,168.47",33112
,20180524,52350,52430,51930,51990,51820,51950,51910,-480,-520,4098,"106,376.19",33872
,20180525,51950,51910,51980,52190,51860,52040,52040,130,130,2468,"64,218.21",34078
,20180528,52040,52040,51990,52140,51820,52130,51980,90,-60,2400,"62,379.33",34414
,20180529,52130,51980,51830,52340,51800,52230,52060,250,80,3108,"80,911.47",34958
,20180530,52230,52060,52300,52480,51250,51250,51670,-810,-390,24772,"640,080.36",32200
,20180531,51250,51670,51420,51960,51360,51850,51640,180,-30,9008,"232,620.03",34618
cu1811,20180102,56820,57000,56870,56870,56390,56610,56490,-390,-510,64,"1,807.72",1344
,20180103,56610,56490,56540,56580,56110,56200,56210,-290,-280,166,"4,666.23",1344
,20180104,56200,56210,56110,56660,56070,56650,56590,440,380,44,"1,245.12",1344
,20180105,56650,56590,56600,56600,56090,56200,56300,-390,-290,46,"1,295.05",1364
,20180108,56200,56300,56010,56070,55750,55910,55840,-390,-460,84,"2,345.53",1412
,20180109,55910,55840,55800,56130,55800,56130,55960,290,120,40,"1,119.32",1440
,20180110,56130,55960,56380,56380,55990,56010,56090,50,130,254,"7,124.29",1626
,20180111,56010,56090,55860,56600,55860,56410,56330,320,240,244,"6,873.26",1516
,20180112,56410,56330,56000,56050,55550,56020,55880,-310,-450,242,"6,762.56",1598
,20180115,56020,55880,55760,56380,55690,56250,56040,370,160,96,"2,689.92",1622
,20180116,56250,56040,56220,56220,55400,55490,55640,-550,-400,142,"3,950.45",1608
,20180117,55490,55640,55130,55230,54600,54600,54910,-1040,-730,202,"5,546.36",1702
,20180118,54600,54910,54890,55200,54730,54930,54960,20,50,284,"7,805.09",1596
,20180119,54930,54960,55060,55110,54810,55090,54940,130,-20,44,"1,208.84",1574
,20180122,55090,54940,54710,55100,54620,55100,54870,160,-70,88,"2,414.32",1522
,20180123,55100,54870,55130,55210,54770,55020,55030,150,160,270,"7,430.10",1588
,20180124,55020,55030,54260,54350,53920,54010,54050,-1020,-980,244,"6,595.23",1492
,20180125,54010,54050,54150,55720,54150,55180,55320,1130,1270,2646,"73,198.05",2794
,20180126,55180,55320,55160,55200,54750,54810,55000,-510,-320,7734,"212,694.21",6848
,20180129,54810,55000,54760,56950,54500,55010,55060,10,60,11902,"327,669.86",16222
,20180130,55010,55060,54840,54910,54200,54300,54550,-760,-510,1102,"30,059.60",16246
,20180131,54300,54550,54490,54700,54290,54620,54500,70,-50,338,"9,211.09",16186
,20180201,54620,54500,54690,54790,54380,54400,54550,-100,50,456,"12,439.63",16208
,20180202,54400,54550,54330,55030,54260,54940,54760,390,210,504,"13,800.80",16242
,20180205,54940,54760,54700,54700,54200,54440,54390,-320,-370,428,"11,641.18",16306
,20180206,54440,54390,54430,55160,54030,54150,54320,-240,-70,918,"24,936.74",16314
,20180207,54150,54320,54280,54590,53910,54080,54240,-240,-80,274,"7,431.93",16330
,20180208,54080,54240,53900,53980,53070,53380,53390,-860,-850,738,"19,701.44",16402
,20180209,53380,53390,53390,53400,52680,52830,53030,-560,-360,470,"12,463.32",16432
,20180212,52830,53030,52400,53120,52270,53050,52590,20,-440,902,"23,721.60",16400
,20180213,53050,52590,52970,53700,52800,53510,53490,920,900,6924,"185,216.10",20918
,20180214,53510,53490,53650,54160,53640,54150,53940,660,450,726,"19,581.27",20878
,20180222,54150,53940,54440,54480,53940,54140,54080,200,140,310,"8,382.88",20856
,20180223,54140,54080,54250,55360,54250,55000,55000,920,920,16624,"457,208.47",26090
,20180226,55000,55000,54810,55180,54650,55040,54860,40,-140,1602,"43,945.35",25928
,20180227,55040,54860,54980,55020,54580,54790,54700,-70,-160,548,"14,989.58",25802
,20180228,54790,54700,54530,54530,53860,53880,54060,-820,-640,1072,"28,978.76",25402
,20180301,53880,54060,53960,54010,53480,53620,53730,-440,-330,1352,"36,325.51",25264
,20180302,53620,53730,53430,53820,53300,53770,53590,40,-140,142,"3,804.98",25268
,20180305,53770,53590,53580,53680,53200,53270,53450,-320,-140,518,"13,843.79",25182
,20180306,53270,53450,53100,53850,53000,53780,53460,330,10,258,"6,897.40",25212
,20180307,53780,53460,53950,54000,53560,53580,53760,120,300,502,"13,495.57",25222
,20180308,53580,53760,53350,53570,53130,53270,53350,-490,-410,796,"21,235.53",25256
,20180309,53270,53350,53030,53080,52300,52370,52550,-980,-800,266,"6,989.42",25298
,20180312,52370,52550,52660,53810,52660,53160,53460,610,910,820,"21,918.86",25452
,20180313,53160,53460,53050,53420,53020,53050,53210,-410,-250,424,"11,282.19",25426
,20180314,53050,53210,53340,53720,53140,53530,53410,320,200,1860,"49,672.90",25446
,20180315,53530,53410,53850,54200,53200,53380,53720,-30,310,574,"15,418.04",25406
,20180316,53380,53720,53180,53610,53030,53490,53310,-230,-410,800,"21,324.72",25312
,20180319,53490,53310,53400,53400,52460,52650,52670,-660,-640,1460,"38,452.07",25632
,20180320,52650,52670,52650,52860,52380,52670,52600,0,-70,928,"24,410.34",25426
,20180321,52670,52600,52540,52550,51800,51800,52150,-800,-450,672,"17,523.99",25478
,20180322,51800,52150,51780,52590,51580,52290,52230,140,80,842,"21,991.66",25476
,20180323,52290,52230,52030,52160,50850,51140,51240,-1090,-990,644,"16,502.03",25494
,20180326,51140,51240,51270,51280,49770,49940,50200,-1300,-1040,1926,"48,346.44",25650
,20180327,49940,50200,49860,50940,49860,50710,50480,510,280,1428,"36,043.87",25698
,20180328,50710,50480,50600,50740,50270,50300,50510,-180,30,714,"18,033.20",25730
,20180329,50300,50510,50590,51040,50240,50890,50660,380,150,2790,"70,678.26",25898
,20180330,50890,50660,50910,51260,50850,51260,51030,600,370,1152,"29,398.56",25938
,20180402,51260,51030,51220,51910,51200,51450,51400,420,370,304,"7,813.67",25942
,20180403,51450,51400,51330,51670,51220,51310,51370,-90,-30,1950,"50,089.71",26106
,20180404,51310,51370,51420,51490,51220,51250,51320,-120,-50,1756,"45,067.58",26336
,20180409,51250,51320,51260,51740,51050,51680,51320,360,0,2834,"72,728.26",26582
,20180410,51680,51320,51610,52290,51410,51970,51770,650,450,2836,"73,410.18",26664
,20180411,51970,51770,52300,52450,51800,51990,52220,220,450,2196,"57,339.71",26644
,20180412,51990,52220,52040,52210,51230,51520,51810,-700,-410,1154,"29,895.78",26586
,20180413,51520,51810,51180,51490,51080,51430,51300,-380,-510,434,"11,133.14",26696
,20180416,51430,51300,51520,51520,51000,51370,51310,70,10,152,"3,900.21",26690
,20180417,51370,51310,51470,52690,51470,51750,51760,440,450,418,"10,818.03",26730
,20180418,51750,51760,51560,52210,51360,52030,51810,270,50,1256,"32,537.32",26524
,20180419,52030,51810,52700,53320,49880,52860,52800,1050,990,5184,"136,880.98",26784
,20180420,52860,52800,52400,52570,52110,52330,52360,-470,-440,886,"23,199.50",26682
,20180423,52330,52360,52470,52980,52380,52760,52660,400,300,356,"9,373.95",26590
,20180424,52760,52660,52170,52740,51790,52480,52370,-180,-290,572,"14,978.40",26546
,20180425,52480,52370,52720,52930,52440,52450,52650,80,280,276,"7,266.59",26508
,20180426,52450,52650,52690,52810,52310,52480,52510,-170,-140,754,"19,798.78",26412
,20180427,52480,52510,52410,52660,52400,52500,52520,-10,10,728,"19,119.59",26642
,20180502,52500,52520,51700,52110,51700,52080,51950,-440,-570,1052,"27,327.67",26674
,20180503,52080,51950,52000,52010,51780,51960,51890,10,-60,2656,"68,912.67",26748
,20180504,51960,51890,52150,52200,51730,52170,52060,280,170,754,"19,629.39",26748
,20180507,52170,52060,52000,52130,51870,52050,51980,-10,-80,512,"13,308.47",26828
,20180508,52050,51980,52250,52280,51980,52110,52120,130,140,252,"6,567.59",26806
,20180509,52110,52120,51600,51880,51210,51670,51640,-450,-480,966,"24,945.94",26908
,20180510,51670,51640,51790,52040,51660,51840,51900,200,260,762,"19,776.48",27260
,20180511,51840,51900,52250,52280,52070,52150,52180,250,280,1294,"33,762.95",27390
,20180514,52150,52180,52230,52470,52210,52290,52360,110,180,768,"20,108.77",27514
,20180515,52290,52360,52110,52160,51820,51930,52020,-430,-340,340,"8,843.47",27518
,20180516,51930,52020,51780,51910,51460,51780,51730,-240,-290,1012,"26,177.35",27550
,20180517,51780,51730,51690,51950,51630,51770,51850,40,120,712,"18,459.61",27580
,20180518,51770,51850,51870,52040,51800,51990,51980,140,130,284,"7,381.24",27526
,20180521,51990,51980,51850,52260,51700,52160,52020,180,40,634,"16,492.69",27534
,20180522,52160,52020,52290,52340,52150,52170,52210,150,190,472,"12,322.25",27590
,20180523,52170,52210,52530,52940,52380,52470,52660,260,450,1946,"51,242.39",27458
,20180524,52470,52660,52100,52170,52000,52130,52090,-530,-570,458,"11,930.11",27504
,20180525,52130,52090,52230,52390,52040,52200,52260,110,170,1630,"42,598.14",27516
,20180528,52200,52260,52160,52300,52040,52300,52170,40,-90,742,"19,357.65",27518
,20180529,52300,52170,52060,52500,52010,52420,52220,250,50,1040,"27,155.43",27544
,20180530,52420,52220,52390,52620,51450,51450,51880,-770,-340,6424,"166,657.78",28542
,20180531,51450,51880,51450,52140,51450,52040,51850,160,-30,2214,"57,407.99",28854
cu1812,20180102,57050,57110,56830,56830,56460,56770,56600,-340,-510,46,"1,301.95",756
,20180103,56770,56600,56580,56650,56140,56320,56360,-280,-240,328,"9,243.12",794
,20180104,56320,56360,56310,56750,56170,56740,56430,380,70,82,"2,313.70",790
,20180105,56740,56430,56780,56780,56250,56310,56510,-120,80,102,"2,882.11",784
,20180108,56310,56510,56170,56200,55880,56020,55980,-490,-530,136,"3,807.16",754
,20180109,56020,55980,55420,56350,55420,56350,55950,370,-30,120,"3,357.10",740
,20180110,56350,55950,56500,56500,56110,56190,56250,240,300,118,"3,319.02",768
,20180111,56190,56250,56650,56750,56300,56520,56480,270,230,96,"2,711.17",808
,20180112,56520,56480,56240,56240,55760,56140,56080,-340,-400,170,"4,766.95",830
,20180115,56140,56080,55630,56470,55630,56410,55960,330,-120,166,"4,645.13",804
,20180116,56410,55960,56360,56360,55580,55640,55830,-320,-130,92,"2,568.46",800
,20180117,55640,55830,55200,55340,54960,55010,55190,-820,-640,182,"5,022.46",824
,20180118,55010,55190,55020,55330,54950,55100,55170,-90,-20,116,"3,200.03",844
,20180119,55100,55170,55100,55270,54990,55170,55120,0,-50,240,"6,615.02",894
,20180122,55170,55120,55600,55600,54790,55180,55110,60,-10,176,"4,849.68",890
,20180123,55180,55110,55090,55330,54890,55150,55110,40,0,128,"3,527.67",926
,20180124,55150,55110,54380,54390,54100,54100,54230,-1010,-880,444,"12,041.15",888
,20180125,54100,54230,54340,55860,54230,55370,55180,1140,950,1068,"29,469.57",1094
,20180126,55370,55180,55240,55280,54800,54800,55040,-380,-140,306,"8,422.31",1118
,20180129,54800,55040,54530,55280,54530,55130,55050,90,10,548,"15,085.41",1232
,20180130,55130,55050,55000,55030,54400,54460,54730,-590,-320,166,"4,542.95",1176
,20180131,54460,54730,54640,54810,54390,54760,54660,30,-70,188,"5,138.36",1108
,20180201,54760,54660,54770,54950,54550,54570,54820,-90,160,232,"6,359.74",1166
,20180202,54570,54820,54500,55160,54440,55090,54790,270,-30,368,"10,082.25",1240
,20180205,55090,54790,54850,54850,54310,54600,54540,-190,-250,214,"5,836.60",1310
,20180206,54600,54540,54640,55350,54170,54170,54910,-370,370,232,"6,369.60",1254
,20180207,54170,54910,54410,54740,54070,54270,54380,-640,-530,382,"10,387.34",1388
,20180208,54270,54380,54110,54150,53190,53510,53520,-870,-860,538,"14,397.23",1626
,20180209,53510,53520,53360,53560,52910,52970,53220,-550,-300,410,"10,910.21",1794
,20180212,52970,53220,52600,53260,52440,53260,52760,40,-460,290,"7,651.56",1790
,20180213,53260,52760,53090,53900,52990,53710,53700,950,940,8218,"220,683.31",7350
,20180214,53710,53700,53920,54360,53820,54310,54100,610,400,620,"16,773.57",7358
,20180222,54310,54100,54410,54410,54200,54310,54280,210,180,162,"4,397.03",7328
,20180223,54310,54280,54460,55890,54450,55250,55330,970,1050,19050,"527,088.36",16430
,20180226,55250,55330,55020,55420,54850,55200,55190,-130,-140,2826,"77,996.14",17330
,20180227,55200,55190,55090,55190,54730,54980,54930,-210,-260,1004,"27,575.06",17428
,20180228,54980,54930,54750,54750,54010,54010,54180,-920,-750,1074,"29,094.76",17240
,20180301,54010,54180,54120,54180,53670,53840,53890,-340,-290,724,"19,511.27",17274
,20180302,53840,53890,53620,53940,53470,53890,53700,0,-190,318,"8,539.05",17288
,20180305,53890,53700,53810,53810,53360,53460,53540,-240,-160,686,"18,366.84",17294
,20180306,53460,53540,53330,54030,53320,54000,53620,460,80,80,"2,144.83",17302
,20180307,54000,53620,54100,54190,53750,53820,53900,200,280,460,"12,397.59",17306
,20180308,53820,53900,53540,53750,53320,53450,53590,-450,-310,620,"16,613.03",17286
,20180309,53450,53590,53250,53320,52460,52570,52970,-1020,-620,1130,"29,929.48",17356
,20180312,52570,52970,52800,54060,52800,53360,53750,390,780,4830,"129,816.47",20628
,20180313,53360,53750,53440,53610,53220,53230,53370,-520,-380,982,"26,205.60",20738
,20180314,53230,53370,53540,53930,53350,53750,53580,380,210,1254,"33,597.17",21184
,20180315,53750,53580,54040,54200,53390,53600,53780,20,200,2838,"76,318.25",21564
,20180316,53600,53780,53400,53780,53220,53580,53420,-200,-360,2184,"58,337.69",22040
,20180319,53580,53420,53480,53570,52650,52840,53040,-580,-380,1058,"28,060.24",22070
,20180320,52840,53040,52770,53040,52610,52860,52770,-180,-270,1002,"26,438.05",21848
,20180321,52860,52770,52710,52720,51850,52000,52300,-770,-470,456,"11,925.41",21694
,20180322,52000,52300,51970,52760,51800,52520,52390,220,90,562,"14,723.75",21626
,20180323,52520,52390,52180,52290,50990,51360,51600,-1030,-790,1166,"30,083.65",21558
,20180326,51360,51600,51500,51500,50070,50180,50480,-1420,-1120,2092,"52,803.87",21656
,20180327,50180,50480,50170,51150,50170,50930,50620,450,140,2858,"72,340.42",21598
,20180328,50930,50620,50900,50960,50470,50490,50760,-130,140,1900,"48,229.11",22244
,20180329,50490,50760,50750,51290,50440,51080,50850,320,90,2560,"65,092.86",22234
,20180330,51080,50850,51160,51510,51000,51480,51210,630,360,1208,"30,935.94",22258
,20180402,51480,51210,51540,51790,51340,51600,51550,390,340,362,"9,330.80",22272
,20180403,51600,51550,51510,51840,51350,51500,51540,-50,-10,4028,"103,810.36",22702
,20180404,51500,51540,51630,51670,51370,51440,51530,-100,-10,2358,"60,757.87",22932
,20180409,51440,51530,51680,51910,51160,51870,51530,340,0,4236,"109,142.50",24384
,20180410,51870,51530,51760,52500,51600,52140,52230,610,700,4788,"125,055.65",25708
,20180411,52140,52230,52450,52640,51940,52160,52350,-70,120,4756,"124,510.95",26076
,20180412,52160,52350,52370,52400,51430,51730,51960,-620,-390,912,"23,696.94",26122
,20180413,51730,51960,51450,51740,51250,51600,51450,-360,-510,1128,"29,019.19",26060
,20180416,51600,51450,51670,51670,51190,51550,51440,100,-10,566,"14,559.37",26058
,20180417,51550,51440,51630,52080,51630,51870,51930,430,490,440,"11,425.47",25992
,20180418,51870,51930,51520,52370,51520,52220,51980,290,50,1678,"43,612.07",26430
,20180419,52220,51980,53400,53530,52500,53010,53150,1030,1170,6116,"162,546.43",27626
,20180420,53010,53150,52600,52760,52270,52500,52530,-650,-620,1460,"38,350.83",27704
,20180423,52500,52530,52640,53120,52580,52930,52880,400,350,1176,"31,093.94",27676
,20180424,52930,52880,52690,52910,51980,52670,52650,-210,-230,1884,"49,597.93",28084
,20180425,52670,52650,53130,53150,52600,52620,52890,-30,240,1290,"34,117.14",28324
,20180426,52620,52890,52920,53000,52470,52650,52720,-240,-170,2118,"55,837.24",28506
,20180427,52650,52720,52590,52840,52570,52620,52690,-100,-30,700,"18,443.45",28614
,20180502,52620,52690,51800,52250,51800,52230,52060,-460,-630,1918,"49,928.17",28698
,20180503,52230,52060,52200,52200,51900,52120,52020,60,-40,4212,"109,569.19",30254
,20180504,52120,52020,52230,52400,51880,52310,52190,290,170,1546,"40,350.26",30572
,20180507,52310,52190,52190,52300,51980,52200,52120,10,-70,664,"17,306.22",30818
,20180508,52200,52120,52330,52390,52140,52250,52280,130,160,358,"9,359.62",30784
,20180509,52250,52280,52070,52070,51360,51790,51860,-490,-420,1292,"33,502.86",30688
,20180510,51790,51860,51940,52190,51830,52000,52040,140,180,578,"15,040.68",30716
,20180511,52000,52040,52500,52500,52260,52340,52370,300,330,636,"16,656.11",30818
,20180514,52340,52370,52430,52650,52400,52480,52510,110,140,588,"15,439.20",30866
,20180515,52480,52510,52350,52350,52000,52100,52200,-410,-310,574,"14,983.86",30836
,20180516,52100,52200,51940,52070,51630,51960,51830,-240,-370,1662,"43,077.08",31050
,20180517,51960,51830,51820,52150,51770,51940,52040,110,210,748,"19,463.82",31504
,20180518,51940,52040,52070,52250,51940,52160,52150,120,110,1798,"46,891.42",32338
,20180521,52160,52150,52010,52400,51860,52300,52170,150,20,1924,"50,188.24",32972
,20180522,52300,52170,52580,52580,52300,52340,52370,170,200,762,"19,955.39",33294
,20180523,52340,52370,52740,53090,52520,52620,52780,250,410,3946,"104,148.36",33918
,20180524,52620,52780,52340,52350,52160,52320,52260,-460,-520,2998,"78,352.46",33314
,20180525,52320,52260,51990,52550,51980,52360,52390,100,130,2958,"77,484.84",33762
,20180528,52360,52390,52360,52460,52180,52450,52340,60,-50,1988,"52,028.36",34510
,20180529,52450,52340,52250,52670,52150,52570,52340,230,0,2922,"76,478.88",34188
,20180530,52570,52340,52560,52840,51640,51680,52100,-660,-240,7730,"201,383.64",33962
,20180531,51680,52100,52720,52720,51700,52200,52030,100,-70,2628,"68,374.34",34540
cu1901,20180116,55960,55960,56210,56210,55710,55740,55950,-220,-10,158,"4,420.08",142
,20180117,55740,55950,55340,55430,55130,55130,55360,-820,-590,212,"5,868.31",140
,20180118,55130,55360,55240,55370,55070,55230,55250,-130,-110,38,"1,049.78",134
,20180119,55230,55250,55080,55350,55080,55300,55140,50,-110,46,"1,268.40",166
,20180122,55300,55140,54980,55970,54950,55390,55110,250,-30,196,"5,401.08",304
,20180123,55390,55110,55110,55330,55040,55330,55260,220,150,166,"4,587.16",416
,20180124,55330,55260,54510,54520,54270,54280,54430,-980,-830,134,"3,647.26",378
,20180125,54280,54430,54500,55950,54500,55570,55420,1140,990,232,"6,429.31",458
,20180126,55570,55420,55390,55450,55080,55250,55210,-170,-210,80,"2,208.47",482
,20180129,55250,55210,55020,55410,54850,55300,55250,90,40,248,"6,851.77",516
,20180130,55300,55250,55200,55200,54530,54600,54700,-650,-550,56,"1,531.84",496
,20180131,54600,54700,54760,54980,54630,54900,54840,200,140,150,"4,113.67",470
,20180201,54900,54840,54880,55060,54760,54760,54960,-80,120,30,824.44,494
,20180202,54760,54960,54780,55350,54780,55230,55020,270,60,16,440.19,498
,20180205,55230,55020,55040,55040,54530,54720,54700,-300,-320,84,"2,297.57",514
,20180206,54720,54700,54760,55510,54420,54550,54920,-150,220,86,"2,361.96",546
,20180207,54550,54920,54510,54850,54300,54440,54520,-480,-400,174,"4,743.66",574
,20180208,54440,54520,54180,54180,53390,53730,53640,-790,-880,134,"3,593.91",632
,20180209,53730,53640,53440,53530,53030,53160,53410,-480,-230,366,"9,775.13",892
,20180212,53160,53410,52850,53420,52580,53300,52990,-110,-420,204,"5,405.83",1002
,20180213,53300,52990,53280,54090,53150,53870,53650,880,660,776,"20,816.43",1542
,20180214,53870,53650,54000,54500,54000,54500,54280,850,630,188,"5,102.71",1584
,20180222,54500,54280,54450,54550,54340,54550,54420,270,140,46,"1,251.72",1580
,20180223,54550,54420,54650,55930,54650,55350,55450,930,1030,14068,"390,100.41",9136
,20180226,55350,55450,55180,55560,55080,55400,55350,-50,-100,176,"4,871.02",9174
,20180227,55400,55350,55270,55270,54950,55160,55120,-190,-230,540,"14,882.92",9346
,20180228,55160,55120,54790,54790,54200,54200,54400,-920,-720,544,"14,799.45",9374
,20180301,54200,54400,53950,54320,53900,53980,54140,-420,-260,662,"17,923.58",9478
,20180302,53980,54140,53770,54120,53600,54020,53780,-120,-360,482,"12,960.99",9624
,20180305,54020,53780,53970,54010,53560,53660,53770,-120,-10,162,"4,356.17",9610
,20180306,53660,53770,53460,54200,53410,54200,53750,430,-20,36,967.61,9602
,20180307,54200,53750,54260,54390,53930,54060,54030,310,280,96,"2,593.76",9572
,20180308,54060,54030,53760,54070,53520,53610,53900,-420,-130,2006,"54,065.35",10586
,20180309,53610,53900,53380,53420,52670,52700,53020,-1200,-880,802,"21,262.58",10644
,20180312,52700,53020,53120,54290,53120,53510,53890,490,870,4110,"110,749.68",13218
,20180313,53510,53890,53460,53850,53410,53450,53650,-440,-240,2744,"73,616.14",14640
,20180314,53450,53650,53760,54040,53560,53980,53810,330,160,816,"21,956.94",14676
,20180315,53980,53810,54500,54500,53610,53800,54250,-10,440,2326,"63,100.40",15960
,20180316,53800,54250,53500,54000,53400,53860,53780,-390,-470,2364,"63,576.69",17304
,20180319,53860,53780,53840,53840,52780,53020,53230,-760,-550,1190,"31,673.97",17432
,20180320,53020,53230,52930,53210,52760,53080,52990,-150,-240,420,"11,129.97",17490
,20180321,53080,52990,52560,52640,52090,52090,52410,-900,-580,400,"10,482.50",17500
,20180322,52090,52410,52070,53000,51980,52690,52370,280,-40,994,"26,029.02",17452
,20180323,52690,52370,52410,52530,51250,51520,51600,-850,-770,978,"25,236.78",17084
,20180326,51520,51600,51580,51580,50150,50350,50660,-1250,-940,644,"16,315.60",16762
,20180327,50350,50660,50410,51300,50410,51080,50850,420,190,1290,"32,801.48",16444
,20180328,51080,50850,50980,51120,50650,50670,50910,-180,60,194,"4,938.73",16420
,20180329,50670,50910,51030,51410,50660,51250,50940,340,30,562,"14,314.79",16282
,20180330,51250,50940,51200,51670,51200,51670,51380,730,440,362,"9,301.00",16216
,20180402,51670,51380,51760,52000,51580,51810,51800,430,420,374,"9,686.89",16390
,20180403,51810,51800,51680,52050,51600,51710,51760,-90,-40,1262,"32,663.79",16504
,20180404,51710,51760,51790,51810,51600,51620,51730,-140,-30,632,"16,347.17",16432
,20180409,51620,51730,51390,52120,51390,52070,51920,340,190,6362,"165,178.53",20968
,20180410,52070,51920,52060,52680,51820,52370,52400,450,480,3572,"93,587.61",22762
,20180411,52370,52400,52700,52850,52180,52360,52670,-40,270,2660,"70,056.14",23658
,20180412,52360,52670,52640,52640,51600,51840,52440,-830,-230,1550,"40,648.17",24230
,20180413,51840,52440,51700,51920,51470,51800,51660,-640,-780,338,"8,730.92",24260
,20180416,51800,51660,51910,51920,51390,51820,51680,160,20,334,"8,630.74",24262
,20180417,51820,51680,51850,52240,51850,52060,52080,380,400,174,"4,531.38",24258
,20180418,52060,52080,51810,52550,51780,52370,52070,290,-10,1578,"41,090.15",24300
,20180419,52370,52070,53440,53780,53000,53230,53380,1160,1310,13102,"349,735.67",30100
,20180420,53230,53380,52670,52980,52500,52660,52850,-720,-530,1888,"49,898.04",30538
,20180423,52660,52850,52900,53370,52780,53130,53040,280,190,340,"9,017.22",30508
,20180424,53130,53040,52290,53120,52290,52880,52910,-160,-130,1070,"28,308.53",30902
,20180425,52880,52910,53350,53350,52810,52840,53110,-70,200,558,"14,818.29",30928
,20180426,52840,53110,53110,53180,52700,52840,53010,-270,-100,928,"24,598.85",31034
,20180427,52840,53010,52900,53020,52830,52870,52880,-140,-130,230,"6,082.23",31000
,20180502,52870,52880,52180,52440,52150,52430,52240,-450,-640,1084,"28,318.45",31098
,20180503,52430,52240,52160,52350,52140,52320,52230,80,-10,394,"10,290.21",31102
,20180504,52320,52230,52470,52600,52120,52510,52420,280,190,702,"18,399.59",31094
,20180507,52510,52420,52290,52480,52250,52450,52360,30,-60,314,"8,220.95",31110
,20180508,52450,52360,52590,52650,52400,52480,52510,120,150,324,"8,507.57",31100
,20180509,52480,52510,52010,52200,51560,51990,52030,-520,-480,548,"14,256.51",31180
,20180510,51990,52030,52180,52400,52030,52200,52210,170,180,202,"5,273.93",31162
,20180511,52200,52210,52590,52640,52440,52520,52560,310,350,370,"9,723.94",31102
,20180514,52520,52560,52600,52850,52590,52700,52700,140,140,526,"13,861.72",31338
,20180515,52700,52700,52530,52570,52200,52310,52440,-390,-260,936,"24,546.34",31228
,20180516,52310,52440,52170,52250,51800,52150,52050,-290,-390,1420,"36,961.80",31168
,20180517,52150,52050,52060,52320,51990,52120,52170,70,120,432,"11,268.88",31088
,20180518,52120,52170,52280,52400,52200,52360,52360,190,190,2212,"57,910.96",32056
,20180521,52360,52360,52290,52600,52050,52490,52420,130,60,2272,"59,556.79",32846
,20180522,52490,52420,52800,52800,52510,52530,52630,110,210,640,"16,843.37",32944
,20180523,52530,52630,52970,53290,52720,52820,53030,190,400,3204,"84,964.14",32984
,20180524,52820,53030,52550,52550,52360,52530,52440,-500,-590,986,"25,853.57",32978
,20180525,52530,52440,52570,52740,52410,52560,52560,120,120,736,"19,344.20",32852
,20180528,52560,52560,52520,52640,52360,52630,52480,70,-80,1868,"49,025.37",32226
,20180529,52630,52480,52410,52860,52300,52740,52450,260,-30,1888,"49,521.69",32088
,20180530,52740,52450,52730,53010,51820,51840,52410,-610,-40,6816,"178,632.37",32848
,20180531,51840,52410,52000,52490,51930,52410,52180,0,-230,2988,"77,964.36",33144
cu1902,20180212,53410,53410,53270,53330,53270,53330,53300,-80,-110,4,106.60,2
,20180213,53330,53300,53390,54200,53380,54200,53750,900,450,64,"1,720.16",60
,20180214,54200,53750,54320,54650,54320,54650,54480,900,730,26,708.29,74
,20180222,54650,54480,54720,54720,54720,54720,54720,240,240,2,54.72,74
,20180223,54720,54720,54800,56130,54800,55630,55740,910,1020,8540,"238,016.66",4926
,20180226,55630,55740,55380,55730,55220,55560,55470,-180,-270,240,"6,656.42",4986
,20180227,55560,55470,55530,55530,55130,55330,55320,-140,-150,358,"9,902.43",5178
,20180228,55330,55320,55250,55250,54380,54420,54420,-900,-900,1772,"48,223.71",6414
,20180301,54420,54420,54480,54480,54000,54180,54300,-240,-120,528,"14,335.53",6596
,20180302,54180,54300,53940,54300,53790,54160,54070,-140,-230,152,"4,109.77",6614
,20180305,54160,54070,53830,54240,53740,53800,53940,-270,-130,190,"5,124.58",6624
,20180306,53800,53940,53690,54400,53600,54300,53870,360,-70,174,"4,687.04",6652
,20180307,54300,53870,54540,54540,54100,54120,54430,250,560,262,"7,130.82",6874
,20180308,54120,54430,53880,54140,53670,53770,53990,-660,-440,394,"10,637.63",7080
,20180309,53770,53990,53620,53620,52810,52850,53260,-1140,-730,274,"7,297.36",7236
,20180312,52850,53260,53450,54310,53380,53660,53790,400,530,266,"7,154.24",7332
,20180313,53660,53790,53450,54070,53450,53670,53860,-120,70,1830,"49,286.16",8360
,20180314,53670,53860,53960,54340,53760,54170,54010,310,150,2260,"61,041.63",9764
,20180315,54170,54010,54600,54610,53810,53970,54340,-40,330,2190,"59,509.21",11072
,20180316,53970,54340,53730,54240,53520,54040,54050,-300,-290,3796,"102,594.17",13708
,20180319,54040,54050,53970,54040,53060,53180,53390,-870,-660,1106,"29,528.63",13768
,20180320,53180,53390,53220,53380,52980,53260,53160,-130,-230,394,"10,473.10",13810
,20180321,53260,53160,53010,53010,52340,52390,52570,-770,-590,508,"13,353.42",13644
,20180322,52390,52570,52290,53160,52170,52870,52630,300,60,640,"16,844.60",13650
,20180323,52870,52630,52660,52680,51500,51680,51810,-950,-820,332,"8,600.63",13590
,20180326,51680,51810,51800,51800,50460,50510,50930,-1300,-880,420,"10,696.72",13470
,20180327,50510,50930,50510,51410,50510,51250,51140,320,210,732,"18,718.79",13276
,20180328,51250,51140,51150,51220,50810,50810,51030,-330,-110,220,"5,614.01",13310
,20180329,50810,51030,51110,51580,50850,51500,51150,470,120,830,"21,227.51",13454
,20180330,51500,51150,51350,51880,51280,51840,51580,690,430,436,"11,244.52",13482
,20180402,51840,51580,51950,52240,51700,51970,52110,390,530,874,"22,772.69",14012
,20180403,51970,52110,51930,52270,51780,51880,52080,-230,-30,1710,"44,535.70",14816
,20180404,51880,52080,52010,52010,51770,51770,51900,-310,-180,310,"8,045.54",14798
,20180409,51770,51900,52070,52320,51610,52240,52120,340,220,5418,"141,210.22",18090
,20180410,52240,52120,52330,52830,51970,52510,52520,390,400,3264,"85,724.24",19800
,20180411,52510,52520,52930,53030,52360,52520,52890,0,370,2702,"71,463.53",21116
,20180412,52520,52890,52650,52770,51830,52070,52370,-820,-520,710,"18,591.40",21268
,20180413,52070,52370,51710,52070,51610,51990,51790,-380,-580,300,"7,769.79",21332
,20180416,51990,51790,52040,52100,51600,51920,51720,130,-70,288,"7,448.77",21334
,20180417,51920,51720,52020,52420,52020,52270,52300,550,580,150,"3,922.57",21322
,20180418,52270,52300,52110,52750,52090,52560,52290,260,-10,454,"11,871.72",21326
,20180419,52560,52290,53080,53940,53080,53450,53680,1160,1390,9216,"247,390.04",26330
,20180420,53450,53680,53000,53190,52700,52910,53030,-770,-650,2762,"73,243.27",27576
,20180423,52910,53030,53060,53550,53010,53450,53180,420,150,358,"9,520.62",27560
,20180424,53450,53180,52520,53300,52470,53080,52970,-100,-210,460,"12,183.35",27542
,20180425,53080,52970,53550,53610,52990,53060,53210,90,240,1124,"29,904.84",27546
,20180426,53060,53210,53290,53390,52900,53050,53180,-160,-30,658,"17,498.49",27560
,20180427,53050,53180,53000,53260,52970,53080,53110,-100,-70,154,"4,089.92",27522
,20180502,53080,53110,52310,52650,52300,52650,52440,-460,-670,2066,"54,174.98",27732
,20180503,52650,52440,52480,52560,52340,52500,52450,60,10,338,"8,865.55",27688
,20180504,52500,52450,52650,52750,52400,52730,52610,280,160,270,"7,102.72",27650
,20180507,52730,52610,52460,52680,52390,52620,52540,10,-70,84,"2,206.91",27642
,20180508,52620,52540,52800,52810,52530,52650,52700,110,160,304,"8,010.69",27678
,20180509,52650,52700,52210,52420,51920,52240,52210,-460,-490,206,"5,378.53",27718
,20180510,52240,52210,52270,52560,52230,52360,52430,150,220,236,"6,187.06",27676
,20180511,52360,52430,52740,52820,52670,52710,52750,280,320,130,"3,428.99",27638
,20180514,52710,52750,52800,53010,52800,52890,52870,140,120,242,"6,398.09",27608
,20180515,52890,52870,52690,52720,52380,52480,52530,-390,-340,332,"8,720.83",27624
,20180516,52480,52530,52170,52420,52020,52300,52260,-230,-270,1062,"27,751.22",27594
,20180517,52300,52260,52230,52510,52200,52330,52390,70,130,150,"3,929.72",27558
,20180518,52330,52390,52380,52640,52340,52560,52520,170,130,394,"10,347.47",27370
,20180521,52560,52520,52460,52800,51980,52690,52520,170,0,514,"13,498.52",27400
,20180522,52690,52520,52870,52870,52720,52720,52760,200,240,280,"7,386.89",27378
,20180523,52720,52760,53160,53440,52930,53040,53270,280,510,1928,"51,354.09",27310
,20180524,53040,53270,52650,52720,52560,52710,52620,-560,-650,796,"20,944.62",27278
,20180525,52710,52620,52720,52920,52650,52720,52750,100,130,210,"5,539.19",27256
,20180528,52720,52750,52760,52840,52570,52840,52710,90,-40,1804,"47,553.40",27140
,20180529,52840,52710,52610,53050,52540,52990,52700,280,-10,1724,"45,430.06",27132
,20180530,52990,52700,53000,53220,52050,52050,52560,-650,-140,4228,"111,123.95",27094
,20180531,52050,52560,52040,52710,52040,52590,52520,30,-40,1534,"40,287.17",27044
cu1903,20180316,54340,54340,53980,54400,53750,54400,54220,60,-120,132,"3,579.14",120
,20180319,54400,54220,54220,54220,53230,53440,53630,-780,-590,206,"5,524.73",180
,20180320,53440,53630,53380,53580,53110,53390,53290,-240,-340,356,"9,486.58",422
,20180321,53390,53290,53020,53310,52430,52540,52930,-750,-360,284,"7,516.39",448
,20180322,52540,52930,52500,53240,52360,53040,53010,110,80,368,"9,754.86",630
,20180323,53040,53010,52750,52840,51480,51920,51990,-1090,-1020,456,"11,854.09",680
,20180326,51920,51990,51780,51830,50530,50740,51080,-1250,-910,574,"14,661.26",950
,20180327,50740,51080,50990,51640,50830,51500,51400,420,320,872,"22,410.63",1268
,20180328,51500,51400,51570,51570,51000,51040,51270,-360,-130,206,"5,281.74",1250
,20180329,51040,51270,51200,51790,51040,51650,51480,380,210,436,"11,222.93",1340
,20180330,51650,51480,51560,52000,51550,52000,51800,520,320,248,"6,424.23",1438
,20180402,52000,51800,52250,52380,51960,52290,52170,490,370,228,"5,947.52",1506
,20180403,52290,52170,52480,52480,51880,52000,52180,-170,10,592,"15,446.93",1740
,20180404,52000,52180,52020,52180,51900,51940,52020,-240,-160,114,"2,965.23",1756
,20180409,51940,52020,51910,52580,51800,52480,52330,460,310,6090,"159,368.11",6148
,20180410,52480,52330,52520,53050,52110,52680,52700,350,370,3020,"79,583.81",7652
,20180411,52680,52700,53130,53260,52570,52710,53050,10,350,2716,"72,050.46",9086
,20180412,52710,53050,52930,52970,51980,52240,52510,-810,-540,810,"21,269.51",9222
,20180413,52240,52510,51850,52280,51790,52120,52050,-390,-460,256,"6,663.63",9238
,20180416,52120,52050,52150,52330,51800,52100,52140,50,90,406,"10,586.41",9224
,20180417,52100,52140,52210,52600,52210,52480,52500,340,360,230,"6,037.71",9232
,20180418,52480,52500,52250,52920,52150,52750,52520,250,20,472,"12,396.67",9236
,20180419,52750,52520,53270,54160,53270,53650,53900,1130,1380,9998,"269,456.15",15846
,20180420,53650,53900,53230,53390,52910,53080,53150,-820,-750,938,"24,931.70",15886
,20180423,53080,53150,53210,53700,53130,53580,53330,430,180,330,"8,799.57",15906
,20180424,53580,53330,52710,53500,52570,53240,53210,-90,-120,182,"4,842.47",15874
,20180425,53240,53210,53740,53740,53210,53220,53430,10,220,206,"5,503.66",15828
,20180426,53220,53430,53430,53560,53150,53220,53270,-210,-160,260,"6,925.41",15766
,20180427,53220,53270,53240,53430,53200,53260,53310,-10,40,90,"2,399.38",15750
,20180502,53260,53310,52580,52830,52540,52810,52650,-500,-660,432,"11,374.12",15766
,20180503,52810,52650,52570,52720,52530,52700,52650,50,0,576,"15,164.52",15800
,20180504,52700,52650,52830,53030,52550,52890,52860,240,210,474,"12,528.15",15858
,20180507,52890,52860,52630,52850,52580,52810,52690,-50,-170,78,"2,055.00",15868
,20180508,52810,52690,52960,53020,52710,52810,52880,120,190,620,"16,395.64",16192
,20180509,52810,52880,52350,52550,51970,52340,52400,-540,-480,1196,"31,340.69",16472
,20180510,52340,52400,52520,52720,52230,52530,52470,130,70,178,"4,670.41",16544
,20180511,52530,52470,53000,53000,52860,52900,52930,430,460,158,"4,181.70",16516
,20180514,52900,52930,53030,53190,52930,53120,53050,190,120,144,"3,820.19",16546
,20180515,53120,53050,52920,52940,52540,52660,52650,-390,-400,1042,"27,434.11",16922
,20180516,52660,52650,52530,52600,52160,52500,52450,-150,-200,1470,"38,551.55",16466
,20180517,52500,52450,52440,53050,52360,52450,52580,0,130,350,"9,202.66",16540
,20180518,52450,52580,52600,52820,52500,52710,52640,130,60,124,"3,263.88",16574
,20180521,52710,52640,52570,52970,52370,52820,52780,180,140,210,"5,542.44",16558
,20180522,52820,52780,53060,53060,52870,52880,52910,100,130,422,"11,165.58",16774
,20180523,52880,52910,53300,53620,53110,53210,53460,300,550,1288,"34,432.34",17260
,20180524,53210,53460,52920,52920,52760,52810,52800,-650,-660,1208,"31,896.66",17362
,20180525,52810,52800,52940,53100,52800,52890,53010,90,210,94,"2,491.61",17378
,20180528,52890,53010,52900,52980,52800,52980,52900,-30,-110,200,"5,290.14",17406
,20180529,52980,52900,52810,53200,52740,53090,52890,190,-10,518,"13,699.36",17552
,20180530,53090,52890,53200,53420,52230,52250,52980,-640,90,1428,"37,829.14",17562
,20180531,52250,52980,52400,52890,52380,52770,52660,-210,-320,862,"22,699.28",17504
cu1904,20180417,52140,52140,52720,52720,52620,52620,52680,480,540,30,790.20,30
,20180418,52620,52680,52350,53090,52350,53090,52640,410,-40,62,"1,632.13",58
,20180419,53090,52640,53630,54390,53630,53840,54140,1200,1500,6480,"175,416.55",4072
,20180420,53840,54140,53480,53540,53090,53290,53340,-850,-800,706,"18,830.08",4080
,20180423,53290,53340,53490,53890,53430,53760,53670,420,330,132,"3,542.39",4072
,20180424,53760,53670,52930,53710,52930,53480,53450,-190,-220,436,"11,652.60",4092
,20180425,53480,53450,53830,53890,53270,53460,53600,10,150,232,"6,217.79",4126
,20180426,53460,53600,53620,53780,53330,53350,53560,-250,-40,88,"2,357.03",4138
,20180427,53350,53560,53140,53610,53130,53500,53450,-60,-110,56,"1,496.63",4132
,20180502,53500,53450,52820,52970,52740,52970,52830,-480,-620,248,"6,551.37",4142
,20180503,52970,52830,52900,52920,52720,52920,52830,90,0,282,"7,449.46",4166
,20180504,52920,52830,53320,53320,52870,53110,53080,280,250,218,"5,786.11",4154
,20180507,53110,53080,52990,53050,52790,52950,52950,-130,-130,26,688.45,4156
,20180508,52950,52950,53160,53190,52960,53060,53090,110,140,114,"3,026.69",4192
,20180509,53060,53090,52610,52740,52310,52600,52610,-490,-480,100,"2,630.75",4202
,20180510,52600,52610,52870,52920,52620,52710,52740,100,130,144,"3,797.81",4230
,20180511,52710,52740,53220,53220,53050,53110,53120,370,380,66,"1,753.06",4224
,20180514,53110,53120,53170,53380,53170,53270,53270,150,150,74,"1,971.16",4226
,20180515,53270,53270,53050,53080,52800,52880,52920,-390,-350,144,"3,810.27",4246
,20180516,52880,52920,52610,52780,52370,52620,52620,-300,-300,722,"18,995.94",4286
,20180517,52620,52620,52550,52820,52550,52650,52690,30,70,128,"3,372.37",4314
,20180518,52650,52690,52710,52950,52710,52900,52860,210,170,82,"2,167.36",4278
,20180521,52900,52860,52730,53160,52620,53080,53000,220,140,142,"3,763.04",4268
,20180522,53080,53000,53250,53250,53060,53060,53140,60,140,258,"6,855.15",4350
,20180523,53060,53140,53510,53820,53320,53450,53680,310,540,2024,"54,328.45",5120
,20180524,53450,53680,53120,53120,52960,53010,53030,-670,-650,772,"20,471.95",5184
,20180525,53010,53030,53080,53300,53030,53160,53150,130,120,18,478.35,5184
,20180528,53160,53150,53120,53200,52990,53180,53130,30,-20,72,"1,912.90",5144
,20180529,53180,53130,52960,53370,52960,53370,53050,240,-80,274,"7,267.99",5168
,20180530,53370,53050,53260,53660,52460,52460,53310,-590,260,1374,"36,625.50",5698
,20180531,52460,53310,52570,53080,52570,53000,52880,-310,-430,442,"11,687.02",5766
cu1905,20180516,52920,52920,52620,52900,52540,52770,52790,-150,-130,634,"16,737.04",590
,20180517,52770,52790,52720,52960,52720,52820,52910,30,120,274,"7,249.88",834
,20180518,52820,52910,52990,53060,52970,53050,53020,140,110,30,795.36,852
,20180521,53050,53020,53110,53270,53090,53180,53170,160,150,46,"1,222.94",878
,20180522,53180,53170,53370,53460,53230,53230,53380,60,210,416,"11,103.84",1046
,20180523,53230,53380,53920,54080,53520,53610,53940,230,560,12602,"339,917.45",11088
,20180524,53610,53940,53600,53600,53130,53260,53400,-680,-540,3154,"84,212.75",12428
,20180525,53260,53400,53260,53490,53260,53330,53330,-70,-70,122,"3,253.25",12408
,20180528,53330,53330,53320,53420,53170,53390,53280,60,-50,304,"8,099.22",12408
,20180529,53390,53280,53180,53590,53140,53520,53330,240,50,712,"18,987.42",12468
,20180530,53520,53330,53530,53840,52600,52600,53630,-730,300,6192,"166,048.61",17284
,20180531,52600,53630,52920,53310,52770,53170,53020,-460,-610,5804,"153,867.03",21422
fu1803,20180102,3765,3765,,,,3765,3765,0,0,0,0.00,0
,20180103,3765,3765,,,,3765,3765,0,0,0,0.00,0
,20180104,3765,3765,,,,3765,3765,0,0,0,0.00,0
,20180105,3765,3765,,,,3765,3765,0,0,0,0.00,0
,20180108,3765,3765,,,,3765,3765,0,0,0,0.00,0
,20180109,3765,3765,,,,3765,3765,0,0,0,0.00,0
,20180110,3765,3765,,,,3765,3765,0,0,0,0.00,0
,20180111,3765,3765,,,,3765,3765,0,0,0,0.00,0
,20180112,3765,3765,,,,3765,3765,0,0,0,0.00,0
,20180115,3765,3765,,,,3765,3765,0,0,0,0.00,0
,20180116,3765,3765,,,,3765,3765,0,0,0,0.00,0
,20180117,3765,3765,,,,3765,3765,0,0,0,0.00,0
,20180118,3765,3765,,,,3765,3765,0,0,0,0.00,0
,20180119,3765,3765,,,,3765,3765,0,0,0,0.00,0
,20180122,3765,3765,,,,3765,3765,0,0,0,0.00,0
,20180123,3765,3765,,,,3765,3765,0,0,0,0.00,0
,20180124,3765,3765,,,,3765,3765,0,0,0,0.00,0
,20180125,3765,3765,,,,3765,3765,0,0,0,0.00,0
,20180126,3765,3765,,,,3765,3765,0,0,0,0.00,0
,20180129,3765,3765,,,,3765,3765,0,0,0,0.00,0
,20180130,3765,3765,,,,3765,3765,0,0,0,0.00,0
,20180131,3765,3765,,,,3765,3765,0,0,0,0.00,0
,20180201,3765,3765,,,,3765,3765,0,0,0,0.00,0
,20180202,3765,3765,,,,3765,3765,0,0,0,0.00,0
,20180205,3765,3765,,,,3765,3765,0,0,0,0.00,0
,20180206,3765,3765,,,,3765,3765,0,0,0,0.00,0
,20180207,3765,3765,,,,3765,3765,0,0,0,0.00,0
,20180208,3765,3765,,,,3765,3765,0,0,0,0.00,0
,20180209,3765,3765,,,,3765,3765,0,0,0,0.00,0
,20180212,3765,3765,,,,3765,3765,0,0,0,0.00,0
,20180213,3765,3765,,,,3765,3765,0,0,0,0.00,0
,20180214,3765,3765,,,,3765,3765,0,0,0,0.00,0
,20180222,3765,3765,,,,3765,3765,0,0,0,0.00,0
,20180223,3765,3765,,,,3765,3765,0,0,0,0.00,0
,20180226,3765,3765,,,,3765,3765,0,0,0,0.00,0
,20180227,3765,3765,,,,3765,3765,0,0,0,0.00,0
,20180228,3765,3765,,,,3765,3765,0,0,0,0.00,0
fu1804,20180102,4317,4317,,,,4317,4317,0,0,0,0.00,0
,20180103,4317,4317,,,,4317,4317,0,0,0,0.00,0
,20180104,4317,4317,,,,4317,4317,0,0,0,0.00,0
,20180105,4317,4317,,,,4317,4317,0,0,0,0.00,0
,20180108,4317,4317,,,,4317,4317,0,0,0,0.00,0
,20180109,4317,4317,,,,4317,4317,0,0,0,0.00,0
,20180110,4317,4317,,,,4317,4317,0,0,0,0.00,0
,20180111,4317,4317,,,,4317,4317,0,0,0,0.00,0
,20180112,4317,4317,,,,4317,4317,0,0,0,0.00,0
,20180115,4317,4317,,,,4317,4317,0,0,0,0.00,0
,20180116,4317,4317,,,,4317,4317,0,0,0,0.00,0
,20180117,4317,4317,,,,4317,4317,0,0,0,0.00,0
,20180118,4317,4317,,,,4317,4317,0,0,0,0.00,0
,20180119,4317,4317,,,,4317,4317,0,0,0,0.00,0
,20180122,4317,4317,,,,4317,4317,0,0,0,0.00,0
,20180123,4317,4317,,,,4317,4317,0,0,0,0.00,0
,20180124,4317,4317,,,,4317,4317,0,0,0,0.00,0
,20180125,4317,4317,,,,4317,4317,0,0,0,0.00,0
,20180126,4317,4317,,,,4317,4317,0,0,0,0.00,0
,20180129,4317,4317,,,,4317,4317,0,0,0,0.00,0
,20180130,4317,4317,,,,4317,4317,0,0,0,0.00,0
,20180131,4317,4317,,,,4317,4317,0,0,0,0.00,0
,20180201,4317,4317,,,,4317,4317,0,0,0,0.00,0
,20180202,4317,4317,,,,4317,4317,0,0,0,0.00,0
,20180205,4317,4317,,,,4317,4317,0,0,0,0.00,0
,20180206,4317,4317,,,,4317,4317,0,0,0,0.00,0
,20180207,4317,4317,,,,4317,4317,0,0,0,0.00,0
,20180208,4317,4317,,,,4317,4317,0,0,0,0.00,0
,20180209,4317,4317,,,,4317,4317,0,0,0,0.00,0
,20180212,4317,4317,,,,4317,4317,0,0,0,0.00,0
,20180213,4317,4317,,,,4317,4317,0,0,0,0.00,0
,20180214,4317,4317,,,,4317,4317,0,0,0,0.00,0
,20180222,4317,4317,,,,4317,4317,0,0,0,0.00,0
,20180223,4317,4317,,,,4317,4317,0,0,0,0.00,0
,20180226,4317,4317,,,,4317,4317,0,0,0,0.00,0
,20180227,4317,4317,,,,4317,4317,0,0,0,0.00,0
,20180228,4317,4317,,,,4317,4317,0,0,0,0.00,0
,20180301,4317,4317,,,,4317,4317,0,0,0,0.00,0
,20180302,4317,4317,,,,4317,4317,0,0,0,0.00,0
,20180305,4317,4317,,,,4317,4317,0,0,0,0.00,0
,20180306,4317,4317,,,,4317,4317,0,0,0,0.00,0
,20180307,4317,4317,,,,4317,4317,0,0,0,0.00,0
,20180308,4317,4317,,,,4317,4317,0,0,0,0.00,0
,20180309,4317,4317,,,,4317,4317,0,0,0,0.00,0
,20180312,4317,4317,,,,4317,4317,0,0,0,0.00,0
,20180313,4317,4317,,,,4317,4317,0,0,0,0.00,0
,20180314,4317,4317,,,,4317,4317,0,0,0,0.00,0
,20180315,4317,4317,,,,4317,4317,0,0,0,0.00,0
,20180316,4317,4317,,,,4317,4317,0,0,0,0.00,0
,20180319,4317,4317,,,,4317,4317,0,0,0,0.00,0
,20180320,4317,4317,,,,4317,4317,0,0,0,0.00,0
,20180321,4317,4317,,,,4317,4317,0,0,0,0.00,0
,20180322,4317,4317,,,,4317,4317,0,0,0,0.00,0
,20180323,4317,4317,,,,4317,4317,0,0,0,0.00,0
,20180326,4317,4317,,,,4317,4317,0,0,0,0.00,0
,20180327,4317,4317,,,,4317,4317,0,0,0,0.00,0
,20180328,4317,4317,,,,4317,4317,0,0,0,0.00,0
,20180329,4317,4317,,,,4317,4317,0,0,0,0.00,0
,20180330,4317,4317,,,,4317,4317,0,0,0,0.00,0
fu1805,20180102,3791,3791,,,,3791,3791,0,0,0,0.00,0
,20180103,3791,3791,,,,3791,3791,0,0,0,0.00,0
,20180104,3791,3791,,,,3791,3791,0,0,0,0.00,0
,20180105,3791,3791,,,,3791,3791,0,0,0,0.00,0
,20180108,3791,3791,,,,3791,3791,0,0,0,0.00,0
,20180109,3791,3791,,,,3791,3791,0,0,0,0.00,0
,20180110,3791,3791,,,,3791,3791,0,0,0,0.00,0
,20180111,3791,3791,,,,3791,3791,0,0,0,0.00,0
,20180112,3791,3791,,,,3791,3791,0,0,0,0.00,0
,20180115,3791,3791,,,,3791,3791,0,0,0,0.00,0
,20180116,3791,3791,,,,3791,3791,0,0,0,0.00,0
,20180117,3791,3791,,,,3791,3791,0,0,0,0.00,0
,20180118,3791,3791,,,,3791,3791,0,0,0,0.00,0
,20180119,3791,3791,,,,3791,3791,0,0,0,0.00,0
,20180122,3791,3791,,,,3791,3791,0,0,0,0.00,0
,20180123,3791,3791,,,,3791,3791,0,0,0,0.00,0
,20180124,3791,3791,,,,3791,3791,0,0,0,0.00,0
,20180125,3791,3791,,,,3791,3791,0,0,0,0.00,0
,20180126,3791,3791,,,,3791,3791,0,0,0,0.00,0
,20180129,3791,3791,,,,3791,3791,0,0,0,0.00,0
,20180130,3791,3791,,,,3791,3791,0,0,0,0.00,0
,20180131,3791,3791,,,,3791,3791,0,0,0,0.00,0
,20180201,3791,3791,,,,3791,3791,0,0,0,0.00,0
,20180202,3791,3791,,,,3791,3791,0,0,0,0.00,0
,20180205,3791,3791,,,,3791,3791,0,0,0,0.00,0
,20180206,3791,3791,,,,3791,3791,0,0,0,0.00,0
,20180207,3791,3791,,,,3791,3791,0,0,0,0.00,0
,20180208,3791,3791,,,,3791,3791,0,0,0,0.00,0
,20180209,3791,3791,,,,3791,3791,0,0,0,0.00,0
,20180212,3791,3791,,,,3791,3791,0,0,0,0.00,0
,20180213,3791,3791,,,,3791,3791,0,0,0,0.00,0
,20180214,3791,3791,,,,3791,3791,0,0,0,0.00,0
,20180222,3791,3791,,,,3791,3791,0,0,0,0.00,0
,20180223,3791,3791,,,,3791,3791,0,0,0,0.00,0
,20180226,3791,3791,,,,3791,3791,0,0,0,0.00,0
,20180227,3791,3791,,,,3791,3791,0,0,0,0.00,0
,20180228,3791,3791,,,,3791,3791,0,0,0,0.00,0
,20180301,3791,3791,,,,3791,3791,0,0,0,0.00,0
,20180302,3791,3791,,,,3791,3791,0,0,0,0.00,0
,20180305,3791,3791,,,,3791,3791,0,0,0,0.00,0
,20180306,3791,3791,,,,3791,3791,0,0,0,0.00,0
,20180307,3791,3791,,,,3791,3791,0,0,0,0.00,0
,20180308,3791,3791,,,,3791,3791,0,0,0,0.00,0
,20180309,3791,3791,,,,3791,3791,0,0,0,0.00,0
,20180312,3791,3791,,,,3791,3791,0,0,0,0.00,0
,20180313,3791,3791,,,,3791,3791,0,0,0,0.00,0
,20180314,3791,3791,,,,3791,3791,0,0,0,0.00,0
,20180315,3791,3791,,,,3791,3791,0,0,0,0.00,0
,20180316,3791,3791,,,,3791,3791,0,0,0,0.00,0
,20180319,3791,3791,,,,3791,3791,0,0,0,0.00,0
,20180320,3791,3791,,,,3791,3791,0,0,0,0.00,0
,20180321,3791,3791,,,,3791,3791,0,0,0,0.00,0
,20180322,3791,3791,,,,3791,3791,0,0,0,0.00,0
,20180323,3791,3791,,,,3791,3791,0,0,0,0.00,0
,20180326,3791,3791,,,,3791,3791,0,0,0,0.00,0
,20180327,3791,3791,,,,3791,3791,0,0,0,0.00,0
,20180328,3791,3791,,,,3791,3791,0,0,0,0.00,0
,20180329,3791,3791,,,,3791,3791,0,0,0,0.00,0
,20180330,3791,3791,,,,3791,3791,0,0,0,0.00,0
,20180402,3791,3791,,,,3791,3791,0,0,0,0.00,0
,20180403,3791,3791,,,,3791,3791,0,0,0,0.00,0
,20180404,3791,3791,,,,3791,3791,0,0,0,0.00,0
,20180409,3791,3791,,,,3791,3791,0,0,0,0.00,0
,20180410,3791,3791,,,,3791,3791,0,0,0,0.00,0
,20180411,3791,3791,,,,3791,3791,0,0,0,0.00,0
,20180412,3791,3791,,,,3791,3791,0,0,0,0.00,0
,20180413,3791,3791,,,,3791,3791,0,0,0,0.00,0
,20180416,3791,3791,,,,3791,3791,0,0,0,0.00,0
,20180417,3791,3791,,,,3791,3791,0,0,0,0.00,0
,20180418,3791,3791,,,,3791,3791,0,0,0,0.00,0
,20180419,3791,3791,,,,3791,3791,0,0,0,0.00,0
,20180420,3791,3791,,,,3791,3791,0,0,0,0.00,0
,20180423,3791,3791,,,,3791,3791,0,0,0,0.00,0
,20180424,3791,3791,,,,3791,3791,0,0,0,0.00,0
,20180425,3791,3791,,,,3791,3791,0,0,0,0.00,0
,20180426,3791,3791,,,,3791,3791,0,0,0,0.00,0
,20180427,3791,3791,,,,3791,3791,0,0,0,0.00,0
fu1806,20180102,3765,3765,,,,3765,3765,0,0,0,0.00,0
,20180103,3765,3765,,,,3765,3765,0,0,0,0.00,0
,20180104,3765,3765,,,,3765,3765,0,0,0,0.00,0
,20180105,3765,3765,,,,3765,3765,0,0,0,0.00,0
,20180108,3765,3765,,,,3765,3765,0,0,0,0.00,0
,20180109,3765,3765,,,,3765,3765,0,0,0,0.00,0
,20180110,3765,3765,,,,3765,3765,0,0,0,0.00,0
,20180111,3765,3765,,,,3765,3765,0,0,0,0.00,0
,20180112,3765,3765,,,,3765,3765,0,0,0,0.00,0
,20180115,3765,3765,,,,3765,3765,0,0,0,0.00,0
,20180116,3765,3765,,,,3765,3765,0,0,0,0.00,0
,20180117,3765,3765,,,,3765,3765,0,0,0,0.00,0
,20180118,3765,3765,,,,3765,3765,0,0,0,0.00,0
,20180119,3765,3765,,,,3765,3765,0,0,0,0.00,0
,20180122,3765,3765,,,,3765,3765,0,0,0,0.00,0
,20180123,3765,3765,,,,3765,3765,0,0,0,0.00,0
,20180124,3765,3765,,,,3765,3765,0,0,0,0.00,0
,20180125,3765,3765,,,,3765,3765,0,0,0,0.00,0
,20180126,3765,3765,,,,3765,3765,0,0,0,0.00,0
,20180129,3765,3765,,,,3765,3765,0,0,0,0.00,0
,20180130,3765,3765,,,,3765,3765,0,0,0,0.00,0
,20180131,3765,3765,,,,3765,3765,0,0,0,0.00,0
,20180201,3765,3765,,,,3765,3765,0,0,0,0.00,0
,20180202,3765,3765,,,,3765,3765,0,0,0,0.00,0
,20180205,3765,3765,,,,3765,3765,0,0,0,0.00,0
,20180206,3765,3765,,,,3765,3765,0,0,0,0.00,0
,20180207,3765,3765,,,,3765,3765,0,0,0,0.00,0
,20180208,3765,3765,,,,3765,3765,0,0,0,0.00,0
,20180209,3765,3765,,,,3765,3765,0,0,0,0.00,0
,20180212,3765,3765,,,,3765,3765,0,0,0,0.00,0
,20180213,3765,3765,,,,3765,3765,0,0,0,0.00,0
,20180214,3765,3765,,,,3765,3765,0,0,0,0.00,0
,20180222,3765,3765,,,,3765,3765,0,0,0,0.00,0
,20180223,3765,3765,,,,3765,3765,0,0,0,0.00,0
,20180226,3765,3765,,,,3765,3765,0,0,0,0.00,0
,20180227,3765,3765,,,,3765,3765,0,0,0,0.00,0
,20180228,3765,3765,,,,3765,3765,0,0,0,0.00,0
,20180301,3765,3765,,,,3765,3765,0,0,0,0.00,0
,20180302,3765,3765,,,,3765,3765,0,0,0,0.00,0
,20180305,3765,3765,,,,3765,3765,0,0,0,0.00,0
,20180306,3765,3765,,,,3765,3765,0,0,0,0.00,0
,20180307,3765,3765,,,,3765,3765,0,0,0,0.00,0
,20180308,3765,3765,,,,3765,3765,0,0,0,0.00,0
,20180309,3765,3765,,,,3765,3765,0,0,0,0.00,0
,20180312,3765,3765,,,,3765,3765,0,0,0,0.00,0
,20180313,3765,3765,,,,3765,3765,0,0,0,0.00,0
,20180314,3765,3765,,,,3765,3765,0,0,0,0.00,0
,20180315,3765,3765,,,,3765,3765,0,0,0,0.00,0
,20180316,3765,3765,,,,3765,3765,0,0,0,0.00,0
,20180319,3765,3765,,,,3765,3765,0,0,0,0.00,0
,20180320,3765,3765,,,,3765,3765,0,0,0,0.00,0
,20180321,3765,3765,,,,3765,3765,0,0,0,0.00,0
,20180322,3765,3765,,,,3765,3765,0,0,0,0.00,0
,20180323,3765,3765,,,,3765,3765,0,0,0,0.00,0
,20180326,3765,3765,,,,3765,3765,0,0,0,0.00,0
,20180327,3765,3765,,,,3765,3765,0,0,0,0.00,0
,20180328,3765,3765,,,,3765,3765,0,0,0,0.00,0
,20180329,3765,3765,,,,3765,3765,0,0,0,0.00,0
,20180330,3765,3765,,,,3765,3765,0,0,0,0.00,0
,20180402,3765,3765,,,,3765,3765,0,0,0,0.00,0
,20180403,3765,3765,,,,3765,3765,0,0,0,0.00,0
,20180404,3765,3765,,,,3765,3765,0,0,0,0.00,0
,20180409,3765,3765,,,,3765,3765,0,0,0,0.00,0
,20180410,3765,3765,,,,3765,3765,0,0,0,0.00,0
,20180411,3765,3765,,,,3765,3765,0,0,0,0.00,0
,20180412,3765,3765,,,,3765,3765,0,0,0,0.00,0
,20180413,3765,3765,,,,3765,3765,0,0,0,0.00,0
,20180416,3765,3765,,,,3765,3765,0,0,0,0.00,0
,20180417,3765,3765,,,,3765,3765,0,0,0,0.00,0
,20180418,3765,3765,,,,3765,3765,0,0,0,0.00,0
,20180419,3765,3765,,,,3765,3765,0,0,0,0.00,0
,20180420,3765,3765,,,,3765,3765,0,0,0,0.00,0
,20180423,3765,3765,,,,3765,3765,0,0,0,0.00,0
,20180424,3765,3765,,,,3765,3765,0,0,0,0.00,0
,20180425,3765,3765,,,,3765,3765,0,0,0,0.00,0
,20180426,3765,3765,,,,3765,3765,0,0,0,0.00,0
,20180427,3765,3765,,,,3765,3765,0,0,0,0.00,0
,20180502,3765,3765,,,,3765,3765,0,0,0,0.00,0
,20180503,3765,3765,,,,3765,3765,0,0,0,0.00,0
,20180504,3765,3765,,,,3765,3765,0,0,0,0.00,0
,20180507,3765,3765,,,,3765,3765,0,0,0,0.00,0
,20180508,3765,3765,,,,3765,3765,0,0,0,0.00,0
,20180509,3765,3765,,,,3765,3765,0,0,0,0.00,0
,20180510,3765,3765,,,,3765,3765,0,0,0,0.00,0
,20180511,3765,3765,,,,3765,3765,0,0,0,0.00,0
,20180514,3765,3765,,,,3765,3765,0,0,0,0.00,0
,20180515,3765,3765,,,,3765,3765,0,0,0,0.00,0
,20180516,3765,3765,,,,3765,3765,0,0,0,0.00,0
,20180517,3765,3765,,,,3765,3765,0,0,0,0.00,0
,20180518,3765,3765,,,,3765,3765,0,0,0,0.00,0
,20180521,3765,3765,,,,3765,3765,0,0,0,0.00,0
,20180522,3765,3765,,,,3765,3765,0,0,0,0.00,0
,20180523,3765,3765,,,,3765,3765,0,0,0,0.00,0
,20180524,3765,3765,,,,3765,3765,0,0,0,0.00,0
,20180525,3765,3765,,,,3765,3765,0,0,0,0.00,0
,20180528,3765,3765,,,,3765,3765,0,0,0,0.00,0
,20180529,3765,3765,,,,3765,3765,0,0,0,0.00,0
,20180530,3765,3765,,,,3765,3765,0,0,0,0.00,0
,20180531,3765,3765,,,,3765,3765,0,0,0,0.00,0
fu1807,20180102,3748,3748,,,,3748,3748,0,0,0,0.00,0
,20180103,3748,3748,,,,3748,3748,0,0,0,0.00,0
,20180104,3748,3748,,,,3748,3748,0,0,0,0.00,0
,20180105,3748,3748,,,,3748,3748,0,0,0,0.00,0
,20180108,3748,3748,,,,3748,3748,0,0,0,0.00,0
,20180109,3748,3748,,,,3748,3748,0,0,0,0.00,0
,20180110,3748,3748,,,,3748,3748,0,0,0,0.00,0
,20180111,3748,3748,,,,3748,3748,0,0,0,0.00,0
,20180112,3748,3748,,,,3748,3748,0,0,0,0.00,0
,20180115,3748,3748,,,,3748,3748,0,0,0,0.00,0
,20180116,3748,3748,,,,3748,3748,0,0,0,0.00,0
,20180117,3748,3748,,,,3748,3748,0,0,0,0.00,0
,20180118,3748,3748,,,,3748,3748,0,0,0,0.00,0
,20180119,3748,3748,,,,3748,3748,0,0,0,0.00,0
,20180122,3748,3748,,,,3748,3748,0,0,0,0.00,0
,20180123,3748,3748,,,,3748,3748,0,0,0,0.00,0
,20180124,3748,3748,,,,3748,3748,0,0,0,0.00,0
,20180125,3748,3748,,,,3748,3748,0,0,0,0.00,0
,20180126,3748,3748,,,,3748,3748,0,0,0,0.00,0
,20180129,3748,3748,,,,3748,3748,0,0,0,0.00,0
,20180130,3748,3748,,,,3748,3748,0,0,0,0.00,0
,20180131,3748,3748,,,,3748,3748,0,0,0,0.00,0
,20180201,3748,3748,,,,3748,3748,0,0,0,0.00,0
,20180202,3748,3748,,,,3748,3748,0,0,0,0.00,0
,20180205,3748,3748,,,,3748,3748,0,0,0,0.00,0
,20180206,3748,3748,,,,3748,3748,0,0,0,0.00,0
,20180207,3748,3748,,,,3748,3748,0,0,0,0.00,0
,20180208,3748,3748,,,,3748,3748,0,0,0,0.00,0
,20180209,3748,3748,,,,3748,3748,0,0,0,0.00,0
,20180212,3748,3748,,,,3748,3748,0,0,0,0.00,0
,20180213,3748,3748,,,,3748,3748,0,0,0,0.00,0
,20180214,3748,3748,,,,3748,3748,0,0,0,0.00,0
,20180222,3748,3748,,,,3748,3748,0,0,0,0.00,0
,20180223,3748,3748,,,,3748,3748,0,0,0,0.00,0
,20180226,3748,3748,,,,3748,3748,0,0,0,0.00,0
,20180227,3748,3748,,,,3748,3748,0,0,0,0.00,0
,20180228,3748,3748,,,,3748,3748,0,0,0,0.00,0
,20180301,3748,3748,,,,3748,3748,0,0,0,0.00,0
,20180302,3748,3748,,,,3748,3748,0,0,0,0.00,0
,20180305,3748,3748,,,,3748,3748,0,0,0,0.00,0
,20180306,3748,3748,,,,3748,3748,0,0,0,0.00,0
,20180307,3748,3748,,,,3748,3748,0,0,0,0.00,0
,20180308,3748,3748,,,,3748,3748,0,0,0,0.00,0
,20180309,3748,3748,,,,3748,3748,0,0,0,0.00,0
,20180312,3748,3748,,,,3748,3748,0,0,0,0.00,0
,20180313,3748,3748,,,,3748,3748,0,0,0,0.00,0
,20180314,3748,3748,,,,3748,3748,0,0,0,0.00,0
,20180315,3748,3748,,,,3748,3748,0,0,0,0.00,0
,20180316,3748,3748,,,,3748,3748,0,0,0,0.00,0
,20180319,3748,3748,,,,3748,3748,0,0,0,0.00,0
,20180320,3748,3748,,,,3748,3748,0,0,0,0.00,0
,20180321,3748,3748,,,,3748,3748,0,0,0,0.00,0
,20180322,3748,3748,,,,3748,3748,0,0,0,0.00,0
,20180323,3748,3748,,,,3748,3748,0,0,0,0.00,0
,20180326,3748,3748,,,,3748,3748,0,0,0,0.00,0
,20180327,3748,3748,,,,3748,3748,0,0,0,0.00,0
,20180328,3748,3748,,,,3748,3748,0,0,0,0.00,0
,20180329,3748,3748,,,,3748,3748,0,0,0,0.00,0
,20180330,3748,3748,,,,3748,3748,0,0,0,0.00,0
,20180402,3748,3748,,,,3748,3748,0,0,0,0.00,0
,20180403,3748,3748,,,,3748,3748,0,0,0,0.00,0
,20180404,3748,3748,,,,3748,3748,0,0,0,0.00,0
,20180409,3748,3748,,,,3748,3748,0,0,0,0.00,0
,20180410,3748,3748,,,,3748,3748,0,0,0,0.00,0
,20180411,3748,3748,,,,3748,3748,0,0,0,0.00,0
,20180412,3748,3748,,,,3748,3748,0,0,0,0.00,0
,20180413,3748,3748,,,,3748,3748,0,0,0,0.00,0
,20180416,3748,3748,,,,3748,3748,0,0,0,0.00,0
,20180417,3748,3748,,,,3748,3748,0,0,0,0.00,0
,20180418,3748,3748,,,,3748,3748,0,0,0,0.00,0
,20180419,3748,3748,,,,3748,3748,0,0,0,0.00,0
,20180420,3748,3748,,,,3748,3748,0,0,0,0.00,0
,20180423,3748,3748,,,,3748,3748,0,0,0,0.00,0
,20180424,3748,3748,,,,3748,3748,0,0,0,0.00,0
,20180425,3748,3748,,,,3748,3748,0,0,0,0.00,0
,20180426,3748,3748,,,,3748,3748,0,0,0,0.00,0
,20180427,3748,3748,,,,3748,3748,0,0,0,0.00,0
,20180502,3748,3748,,,,3748,3748,0,0,0,0.00,0
,20180503,3748,3748,,,,3748,3748,0,0,0,0.00,0
,20180504,3748,3748,,,,3748,3748,0,0,0,0.00,0
,20180507,3748,3748,,,,3748,3748,0,0,0,0.00,0
,20180508,3748,3748,,,,3748,3748,0,0,0,0.00,0
,20180509,3748,3748,,,,3748,3748,0,0,0,0.00,0
,20180510,3748,3748,,,,3748,3748,0,0,0,0.00,0
,20180511,3748,3748,,,,3748,3748,0,0,0,0.00,0
,20180514,3748,3748,,,,3748,3748,0,0,0,0.00,0
,20180515,3748,3748,,,,3748,3748,0,0,0,0.00,0
,20180516,3748,3748,,,,3748,3748,0,0,0,0.00,0
,20180517,3748,3748,,,,3748,3748,0,0,0,0.00,0
,20180518,3748,3748,,,,3748,3748,0,0,0,0.00,0
,20180521,3748,3748,,,,3748,3748,0,0,0,0.00,0
,20180522,3748,3748,,,,3748,3748,0,0,0,0.00,0
,20180523,3748,3748,,,,3748,3748,0,0,0,0.00,0
,20180524,3748,3748,,,,3748,3748,0,0,0,0.00,0
,20180525,3748,3748,,,,3748,3748,0,0,0,0.00,0
,20180528,3748,3748,,,,3748,3748,0,0,0,0.00,0
,20180529,3748,3748,,,,3748,3748,0,0,0,0.00,0
,20180530,3748,3748,,,,3748,3748,0,0,0,0.00,0
,20180531,3748,3748,,,,3748,3748,0,0,0,0.00,0
fu1808,20180102,3748,3748,,,,3748,3748,0,0,0,0.00,0
,20180103,3748,3748,,,,3748,3748,0,0,0,0.00,0
,20180104,3748,3748,,,,3748,3748,0,0,0,0.00,0
,20180105,3748,3748,,,,3748,3748,0,0,0,0.00,0
,20180108,3748,3748,,,,3748,3748,0,0,0,0.00,0
,20180109,3748,3748,,,,3748,3748,0,0,0,0.00,0
,20180110,3748,3748,,,,3748,3748,0,0,0,0.00,0
,20180111,3748,3748,,,,3748,3748,0,0,0,0.00,0
,20180112,3748,3748,,,,3748,3748,0,0,0,0.00,0
,20180115,3748,3748,,,,3748,3748,0,0,0,0.00,0
,20180116,3748,3748,,,,3748,3748,0,0,0,0.00,0
,20180117,3748,3748,,,,3748,3748,0,0,0,0.00,0
,20180118,3748,3748,,,,3748,3748,0,0,0,0.00,0
,20180119,3748,3748,,,,3748,3748,0,0,0,0.00,0
,20180122,3748,3748,,,,3748,3748,0,0,0,0.00,0
,20180123,3748,3748,,,,3748,3748,0,0,0,0.00,0
,20180124,3748,3748,,,,3748,3748,0,0,0,0.00,0
,20180125,3748,3748,,,,3748,3748,0,0,0,0.00,0
,20180126,3748,3748,,,,3748,3748,0,0,0,0.00,0
,20180129,3748,3748,,,,3748,3748,0,0,0,0.00,0
,20180130,3748,3748,,,,3748,3748,0,0,0,0.00,0
,20180131,3748,3748,,,,3748,3748,0,0,0,0.00,0
,20180201,3748,3748,,,,3748,3748,0,0,0,0.00,0
,20180202,3748,3748,,,,3748,3748,0,0,0,0.00,0
,20180205,3748,3748,,,,3748,3748,0,0,0,0.00,0
,20180206,3748,3748,,,,3748,3748,0,0,0,0.00,0
,20180207,3748,3748,,,,3748,3748,0,0,0,0.00,0
,20180208,3748,3748,,,,3748,3748,0,0,0,0.00,0
,20180209,3748,3748,,,,3748,3748,0,0,0,0.00,0
,20180212,3748,3748,,,,3748,3748,0,0,0,0.00,0
,20180213,3748,3748,,,,3748,3748,0,0,0,0.00,0
,20180214,3748,3748,,,,3748,3748,0,0,0,0.00,0
,20180222,3748,3748,,,,3748,3748,0,0,0,0.00,0
,20180223,3748,3748,,,,3748,3748,0,0,0,0.00,0
,20180226,3748,3748,,,,3748,3748,0,0,0,0.00,0
,20180227,3748,3748,,,,3748,3748,0,0,0,0.00,0
,20180228,3748,3748,,,,3748,3748,0,0,0,0.00,0
,20180301,3748,3748,,,,3748,3748,0,0,0,0.00,0
,20180302,3748,3748,,,,3748,3748,0,0,0,0.00,0
,20180305,3748,3748,,,,3748,3748,0,0,0,0.00,0
,20180306,3748,3748,,,,3748,3748,0,0,0,0.00,0
,20180307,3748,3748,,,,3748,3748,0,0,0,0.00,0
,20180308,3748,3748,,,,3748,3748,0,0,0,0.00,0
,20180309,3748,3748,,,,3748,3748,0,0,0,0.00,0
,20180312,3748,3748,,,,3748,3748,0,0,0,0.00,0
,20180313,3748,3748,,,,3748,3748,0,0,0,0.00,0
,20180314,3748,3748,,,,3748,3748,0,0,0,0.00,0
,20180315,3748,3748,,,,3748,3748,0,0,0,0.00,0
,20180316,3748,3748,,,,3748,3748,0,0,0,0.00,0
,20180319,3748,3748,,,,3748,3748,0,0,0,0.00,0
,20180320,3748,3748,,,,3748,3748,0,0,0,0.00,0
,20180321,3748,3748,,,,3748,3748,0,0,0,0.00,0
,20180322,3748,3748,,,,3748,3748,0,0,0,0.00,0
,20180323,3748,3748,,,,3748,3748,0,0,0,0.00,0
,20180326,3748,3748,,,,3748,3748,0,0,0,0.00,0
,20180327,3748,3748,,,,3748,3748,0,0,0,0.00,0
,20180328,3748,3748,,,,3748,3748,0,0,0,0.00,0
,20180329,3748,3748,,,,3748,3748,0,0,0,0.00,0
,20180330,3748,3748,,,,3748,3748,0,0,0,0.00,0
,20180402,3748,3748,,,,3748,3748,0,0,0,0.00,0
,20180403,3748,3748,,,,3748,3748,0,0,0,0.00,0
,20180404,3748,3748,,,,3748,3748,0,0,0,0.00,0
,20180409,3748,3748,,,,3748,3748,0,0,0,0.00,0
,20180410,3748,3748,,,,3748,3748,0,0,0,0.00,0
,20180411,3748,3748,,,,3748,3748,0,0,0,0.00,0
,20180412,3748,3748,,,,3748,3748,0,0,0,0.00,0
,20180413,3748,3748,,,,3748,3748,0,0,0,0.00,0
,20180416,3748,3748,,,,3748,3748,0,0,0,0.00,0
,20180417,3748,3748,,,,3748,3748,0,0,0,0.00,0
,20180418,3748,3748,,,,3748,3748,0,0,0,0.00,0
,20180419,3748,3748,,,,3748,3748,0,0,0,0.00,0
,20180420,3748,3748,,,,3748,3748,0,0,0,0.00,0
,20180423,3748,3748,,,,3748,3748,0,0,0,0.00,0
,20180424,3748,3748,,,,3748,3748,0,0,0,0.00,0
,20180425,3748,3748,,,,3748,3748,0,0,0,0.00,0
,20180426,3748,3748,,,,3748,3748,0,0,0,0.00,0
,20180427,3748,3748,,,,3748,3748,0,0,0,0.00,0
,20180502,3748,3748,,,,3748,3748,0,0,0,0.00,0
,20180503,3748,3748,,,,3748,3748,0,0,0,0.00,0
,20180504,3748,3748,,,,3748,3748,0,0,0,0.00,0
,20180507,3748,3748,,,,3748,3748,0,0,0,0.00,0
,20180508,3748,3748,,,,3748,3748,0,0,0,0.00,0
,20180509,3748,3748,,,,3748,3748,0,0,0,0.00,0
,20180510,3748,3748,,,,3748,3748,0,0,0,0.00,0
,20180511,3748,3748,,,,3748,3748,0,0,0,0.00,0
,20180514,3748,3748,,,,3748,3748,0,0,0,0.00,0
,20180515,3748,3748,,,,3748,3748,0,0,0,0.00,0
,20180516,3748,3748,,,,3748,3748,0,0,0,0.00,0
,20180517,3748,3748,,,,3748,3748,0,0,0,0.00,0
,20180518,3748,3748,,,,3748,3748,0,0,0,0.00,0
,20180521,3748,3748,,,,3748,3748,0,0,0,0.00,0
,20180522,3748,3748,,,,3748,3748,0,0,0,0.00,0
,20180523,3748,3748,,,,3748,3748,0,0,0,0.00,0
,20180524,3748,3748,,,,3748,3748,0,0,0,0.00,0
,20180525,3748,3748,,,,3748,3748,0,0,0,0.00,0
,20180528,3748,3748,,,,3748,3748,0,0,0,0.00,0
,20180529,3748,3748,,,,3748,3748,0,0,0,0.00,0
,20180530,3748,3748,,,,3748,3748,0,0,0,0.00,0
,20180531,3748,3748,,,,3748,3748,0,0,0,0.00,0
fu1809,20180102,3748,3748,,,,3748,3748,0,0,0,0.00,0
,20180103,3748,3748,,,,3748,3748,0,0,0,0.00,0
,20180104,3748,3748,,,,3748,3748,0,0,0,0.00,0
,20180105,3748,3748,,,,3748,3748,0,0,0,0.00,0
,20180108,3748,3748,,,,3748,3748,0,0,0,0.00,0
,20180109,3748,3748,,,,3748,3748,0,0,0,0.00,0
,20180110,3748,3748,,,,3748,3748,0,0,0,0.00,0
,20180111,3748,3748,,,,3748,3748,0,0,0,0.00,0
,20180112,3748,3748,,,,3748,3748,0,0,0,0.00,0
,20180115,3748,3748,,,,3748,3748,0,0,0,0.00,0
,20180116,3748,3748,,,,3748,3748,0,0,0,0.00,0
,20180117,3748,3748,,,,3748,3748,0,0,0,0.00,0
,20180118,3748,3748,,,,3748,3748,0,0,0,0.00,0
,20180119,3748,3748,,,,3748,3748,0,0,0,0.00,0
,20180122,3748,3748,,,,3748,3748,0,0,0,0.00,0
,20180123,3748,3748,,,,3748,3748,0,0,0,0.00,0
,20180124,3748,3748,,,,3748,3748,0,0,0,0.00,0
,20180125,3748,3748,,,,3748,3748,0,0,0,0.00,0
,20180126,3748,3748,,,,3748,3748,0,0,0,0.00,0
,20180129,3748,3748,,,,3748,3748,0,0,0,0.00,0
,20180130,3748,3748,,,,3748,3748,0,0,0,0.00,0
,20180131,3748,3748,,,,3748,3748,0,0,0,0.00,0
,20180201,3748,3748,,,,3748,3748,0,0,0,0.00,0
,20180202,3748,3748,,,,3748,3748,0,0,0,0.00,0
,20180205,3748,3748,,,,3748,3748,0,0,0,0.00,0
,20180206,3748,3748,,,,3748,3748,0,0,0,0.00,0
,20180207,3748,3748,,,,3748,3748,0,0,0,0.00,0
,20180208,3748,3748,,,,3748,3748,0,0,0,0.00,0
,20180209,3748,3748,,,,3748,3748,0,0,0,0.00,0
,20180212,3748,3748,,,,3748,3748,0,0,0,0.00,0
,20180213,3748,3748,,,,3748,3748,0,0,0,0.00,0
,20180214,3748,3748,,,,3748,3748,0,0,0,0.00,0
,20180222,3748,3748,,,,3748,3748,0,0,0,0.00,0
,20180223,3748,3748,,,,3748,3748,0,0,0,0.00,0
,20180226,3748,3748,,,,3748,3748,0,0,0,0.00,0
,20180227,3748,3748,,,,3748,3748,0,0,0,0.00,0
,20180228,3748,3748,,,,3748,3748,0,0,0,0.00,0
,20180301,3748,3748,,,,3748,3748,0,0,0,0.00,0
,20180302,3748,3748,,,,3748,3748,0,0,0,0.00,0
,20180305,3748,3748,,,,3748,3748,0,0,0,0.00,0
,20180306,3748,3748,,,,3748,3748,0,0,0,0.00,0
,20180307,3748,3748,,,,3748,3748,0,0,0,0.00,0
,20180308,3748,3748,,,,3748,3748,0,0,0,0.00,0
,20180309,3748,3748,,,,3748,3748,0,0,0,0.00,0
,20180312,3748,3748,,,,3748,3748,0,0,0,0.00,0
,20180313,3748,3748,,,,3748,3748,0,0,0,0.00,0
,20180314,3748,3748,,,,3748,3748,0,0,0,0.00,0
,20180315,3748,3748,,,,3748,3748,0,0,0,0.00,0
,20180316,3748,3748,,,,3748,3748,0,0,0,0.00,0
,20180319,3748,3748,,,,3748,3748,0,0,0,0.00,0
,20180320,3748,3748,,,,3748,3748,0,0,0,0.00,0
,20180321,3748,3748,,,,3748,3748,0,0,0,0.00,0
,20180322,3748,3748,,,,3748,3748,0,0,0,0.00,0
,20180323,3748,3748,,,,3748,3748,0,0,0,0.00,0
,20180326,3748,3748,,,,3748,3748,0,0,0,0.00,0
,20180327,3748,3748,,,,3748,3748,0,0,0,0.00,0
,20180328,3748,3748,,,,3748,3748,0,0,0,0.00,0
,20180329,3748,3748,,,,3748,3748,0,0,0,0.00,0
,20180330,3748,3748,,,,3748,3748,0,0,0,0.00,0
,20180402,3748,3748,,,,3748,3748,0,0,0,0.00,0
,20180403,3748,3748,,,,3748,3748,0,0,0,0.00,0
,20180404,3748,3748,,,,3748,3748,0,0,0,0.00,0
,20180409,3748,3748,,,,3748,3748,0,0,0,0.00,0
,20180410,3748,3748,,,,3748,3748,0,0,0,0.00,0
,20180411,3748,3748,,,,3748,3748,0,0,0,0.00,0
,20180412,3748,3748,,,,3748,3748,0,0,0,0.00,0
,20180413,3748,3748,,,,3748,3748,0,0,0,0.00,0
,20180416,3748,3748,,,,3748,3748,0,0,0,0.00,0
,20180417,3748,3748,,,,3748,3748,0,0,0,0.00,0
,20180418,3748,3748,,,,3748,3748,0,0,0,0.00,0
,20180419,3748,3748,,,,3748,3748,0,0,0,0.00,0
,20180420,3748,3748,,,,3748,3748,0,0,0,0.00,0
,20180423,3748,3748,,,,3748,3748,0,0,0,0.00,0
,20180424,3748,3748,,,,3748,3748,0,0,0,0.00,0
,20180425,3748,3748,,,,3748,3748,0,0,0,0.00,0
,20180426,3748,3748,,,,3748,3748,0,0,0,0.00,0
,20180427,3748,3748,,,,3748,3748,0,0,0,0.00,0
,20180502,3748,3748,,,,3748,3748,0,0,0,0.00,0
,20180503,3748,3748,,,,3748,3748,0,0,0,0.00,0
,20180504,3748,3748,,,,3748,3748,0,0,0,0.00,0
,20180507,3748,3748,,,,3748,3748,0,0,0,0.00,0
,20180508,3748,3748,,,,3748,3748,0,0,0,0.00,0
,20180509,3748,3748,,,,3748,3748,0,0,0,0.00,0
,20180510,3748,3748,,,,3748,3748,0,0,0,0.00,0
,20180511,3748,3748,,,,3748,3748,0,0,0,0.00,0
,20180514,3748,3748,,,,3748,3748,0,0,0,0.00,0
,20180515,3748,3748,,,,3748,3748,0,0,0,0.00,0
,20180516,3748,3748,,,,3748,3748,0,0,0,0.00,0
,20180517,3748,3748,,,,3748,3748,0,0,0,0.00,0
,20180518,3748,3748,,,,3748,3748,0,0,0,0.00,0
,20180521,3748,3748,,,,3748,3748,0,0,0,0.00,0
,20180522,3748,3748,,,,3748,3748,0,0,0,0.00,0
,20180523,3748,3748,,,,3748,3748,0,0,0,0.00,0
,20180524,3748,3748,,,,3748,3748,0,0,0,0.00,0
,20180525,3748,3748,,,,3748,3748,0,0,0,0.00,0
,20180528,3748,3748,,,,3748,3748,0,0,0,0.00,0
,20180529,3748,3748,,,,3748,3748,0,0,0,0.00,0
,20180530,3748,3748,,,,3748,3748,0,0,0,0.00,0
,20180531,3748,3748,,,,3748,3748,0,0,0,0.00,0
fu1810,20180102,3748,3748,,,,3748,3748,0,0,0,0.00,0
,20180103,3748,3748,,,,3748,3748,0,0,0,0.00,0
,20180104,3748,3748,,,,3748,3748,0,0,0,0.00,0
,20180105,3748,3748,,,,3748,3748,0,0,0,0.00,0
,20180108,3748,3748,,,,3748,3748,0,0,0,0.00,0
,20180109,3748,3748,,,,3748,3748,0,0,0,0.00,0
,20180110,3748,3748,,,,3748,3748,0,0,0,0.00,0
,20180111,3748,3748,,,,3748,3748,0,0,0,0.00,0
,20180112,3748,3748,,,,3748,3748,0,0,0,0.00,0
,20180115,3748,3748,,,,3748,3748,0,0,0,0.00,0
,20180116,3748,3748,,,,3748,3748,0,0,0,0.00,0
,20180117,3748,3748,,,,3748,3748,0,0,0,0.00,0
,20180118,3748,3748,,,,3748,3748,0,0,0,0.00,0
,20180119,3748,3748,,,,3748,3748,0,0,0,0.00,0
,20180122,3748,3748,,,,3748,3748,0,0,0,0.00,0
,20180123,3748,3748,,,,3748,3748,0,0,0,0.00,0
,20180124,3748,3748,,,,3748,3748,0,0,0,0.00,0
,20180125,3748,3748,,,,3748,3748,0,0,0,0.00,0
,20180126,3748,3748,,,,3748,3748,0,0,0,0.00,0
,20180129,3748,3748,,,,3748,3748,0,0,0,0.00,0
,20180130,3748,3748,,,,3748,3748,0,0,0,0.00,0
,20180131,3748,3748,,,,3748,3748,0,0,0,0.00,0
,20180201,3748,3748,,,,3748,3748,0,0,0,0.00,0
,20180202,3748,3748,,,,3748,3748,0,0,0,0.00,0
,20180205,3748,3748,,,,3748,3748,0,0,0,0.00,0
,20180206,3748,3748,,,,3748,3748,0,0,0,0.00,0
,20180207,3748,3748,,,,3748,3748,0,0,0,0.00,0
,20180208,3748,3748,,,,3748,3748,0,0,0,0.00,0
,20180209,3748,3748,,,,3748,3748,0,0,0,0.00,0
,20180212,3748,3748,,,,3748,3748,0,0,0,0.00,0
,20180213,3748,3748,,,,3748,3748,0,0,0,0.00,0
,20180214,3748,3748,,,,3748,3748,0,0,0,0.00,0
,20180222,3748,3748,,,,3748,3748,0,0,0,0.00,0
,20180223,3748,3748,,,,3748,3748,0,0,0,0.00,0
,20180226,3748,3748,,,,3748,3748,0,0,0,0.00,0
,20180227,3748,3748,,,,3748,3748,0,0,0,0.00,0
,20180228,3748,3748,,,,3748,3748,0,0,0,0.00,0
,20180301,3748,3748,,,,3748,3748,0,0,0,0.00,0
,20180302,3748,3748,,,,3748,3748,0,0,0,0.00,0
,20180305,3748,3748,,,,3748,3748,0,0,0,0.00,0
,20180306,3748,3748,,,,3748,3748,0,0,0,0.00,0
,20180307,3748,3748,,,,3748,3748,0,0,0,0.00,0
,20180308,3748,3748,,,,3748,3748,0,0,0,0.00,0
,20180309,3748,3748,,,,3748,3748,0,0,0,0.00,0
,20180312,3748,3748,,,,3748,3748,0,0,0,0.00,0
,20180313,3748,3748,,,,3748,3748,0,0,0,0.00,0
,20180314,3748,3748,,,,3748,3748,0,0,0,0.00,0
,20180315,3748,3748,,,,3748,3748,0,0,0,0.00,0
,20180316,3748,3748,,,,3748,3748,0,0,0,0.00,0
,20180319,3748,3748,,,,3748,3748,0,0,0,0.00,0
,20180320,3748,3748,,,,3748,3748,0,0,0,0.00,0
,20180321,3748,3748,,,,3748,3748,0,0,0,0.00,0
,20180322,3748,3748,,,,3748,3748,0,0,0,0.00,0
,20180323,3748,3748,,,,3748,3748,0,0,0,0.00,0
,20180326,3748,3748,,,,3748,3748,0,0,0,0.00,0
,20180327,3748,3748,,,,3748,3748,0,0,0,0.00,0
,20180328,3748,3748,,,,3748,3748,0,0,0,0.00,0
,20180329,3748,3748,,,,3748,3748,0,0,0,0.00,0
,20180330,3748,3748,,,,3748,3748,0,0,0,0.00,0
,20180402,3748,3748,,,,3748,3748,0,0,0,0.00,0
,20180403,3748,3748,,,,3748,3748,0,0,0,0.00,0
,20180404,3748,3748,,,,3748,3748,0,0,0,0.00,0
,20180409,3748,3748,,,,3748,3748,0,0,0,0.00,0
,20180410,3748,3748,,,,3748,3748,0,0,0,0.00,0
,20180411,3748,3748,,,,3748,3748,0,0,0,0.00,0
,20180412,3748,3748,,,,3748,3748,0,0,0,0.00,0
,20180413,3748,3748,,,,3748,3748,0,0,0,0.00,0
,20180416,3748,3748,,,,3748,3748,0,0,0,0.00,0
,20180417,3748,3748,,,,3748,3748,0,0,0,0.00,0
,20180418,3748,3748,,,,3748,3748,0,0,0,0.00,0
,20180419,3748,3748,,,,3748,3748,0,0,0,0.00,0
,20180420,3748,3748,,,,3748,3748,0,0,0,0.00,0
,20180423,3748,3748,,,,3748,3748,0,0,0,0.00,0
,20180424,3748,3748,,,,3748,3748,0,0,0,0.00,0
,20180425,3748,3748,,,,3748,3748,0,0,0,0.00,0
,20180426,3748,3748,,,,3748,3748,0,0,0,0.00,0
,20180427,3748,3748,,,,3748,3748,0,0,0,0.00,0
,20180502,3748,3748,,,,3748,3748,0,0,0,0.00,0
,20180503,3748,3748,,,,3748,3748,0,0,0,0.00,0
,20180504,3748,3748,,,,3748,3748,0,0,0,0.00,0
,20180507,3748,3748,,,,3748,3748,0,0,0,0.00,0
,20180508,3748,3748,,,,3748,3748,0,0,0,0.00,0
,20180509,3748,3748,,,,3748,3748,0,0,0,0.00,0
,20180510,3748,3748,,,,3748,3748,0,0,0,0.00,0
,20180511,3748,3748,,,,3748,3748,0,0,0,0.00,0
,20180514,3748,3748,,,,3748,3748,0,0,0,0.00,0
,20180515,3748,3748,,,,3748,3748,0,0,0,0.00,0
,20180516,3748,3748,,,,3748,3748,0,0,0,0.00,0
,20180517,3748,3748,,,,3748,3748,0,0,0,0.00,0
,20180518,3748,3748,,,,3748,3748,0,0,0,0.00,0
,20180521,3748,3748,,,,3748,3748,0,0,0,0.00,0
,20180522,3748,3748,,,,3748,3748,0,0,0,0.00,0
,20180523,3748,3748,,,,3748,3748,0,0,0,0.00,0
,20180524,3748,3748,,,,3748,3748,0,0,0,0.00,0
,20180525,3748,3748,,,,3748,3748,0,0,0,0.00,0
,20180528,3748,3748,,,,3748,3748,0,0,0,0.00,0
,20180529,3748,3748,,,,3748,3748,0,0,0,0.00,0
,20180530,3748,3748,,,,3748,3748,0,0,0,0.00,0
,20180531,3748,3748,,,,3748,3748,0,0,0,0.00,0
fu1811,20180102,3748,3748,,,,3748,3748,0,0,0,0.00,0
,20180103,3748,3748,,,,3748,3748,0,0,0,0.00,0
,20180104,3748,3748,,,,3748,3748,0,0,0,0.00,0
,20180105,3748,3748,,,,3748,3748,0,0,0,0.00,0
,20180108,3748,3748,,,,3748,3748,0,0,0,0.00,0
,20180109,3748,3748,,,,3748,3748,0,0,0,0.00,0
,20180110,3748,3748,,,,3748,3748,0,0,0,0.00,0
,20180111,3748,3748,,,,3748,3748,0,0,0,0.00,0
,20180112,3748,3748,,,,3748,3748,0,0,0,0.00,0
,20180115,3748,3748,,,,3748,3748,0,0,0,0.00,0
,20180116,3748,3748,,,,3748,3748,0,0,0,0.00,0
,20180117,3748,3748,,,,3748,3748,0,0,0,0.00,0
,20180118,3748,3748,,,,3748,3748,0,0,0,0.00,0
,20180119,3748,3748,,,,3748,3748,0,0,0,0.00,0
,20180122,3748,3748,,,,3748,3748,0,0,0,0.00,0
,20180123,3748,3748,,,,3748,3748,0,0,0,0.00,0
,20180124,3748,3748,,,,3748,3748,0,0,0,0.00,0
,20180125,3748,3748,,,,3748,3748,0,0,0,0.00,0
,20180126,3748,3748,,,,3748,3748,0,0,0,0.00,0
,20180129,3748,3748,,,,3748,3748,0,0,0,0.00,0
,20180130,3748,3748,,,,3748,3748,0,0,0,0.00,0
,20180131,3748,3748,,,,3748,3748,0,0,0,0.00,0
,20180201,3748,3748,,,,3748,3748,0,0,0,0.00,0
,20180202,3748,3748,,,,3748,3748,0,0,0,0.00,0
,20180205,3748,3748,,,,3748,3748,0,0,0,0.00,0
,20180206,3748,3748,,,,3748,3748,0,0,0,0.00,0
,20180207,3748,3748,,,,3748,3748,0,0,0,0.00,0
,20180208,3748,3748,,,,3748,3748,0,0,0,0.00,0
,20180209,3748,3748,,,,3748,3748,0,0,0,0.00,0
,20180212,3748,3748,,,,3748,3748,0,0,0,0.00,0
,20180213,3748,3748,,,,3748,3748,0,0,0,0.00,0
,20180214,3748,3748,,,,3748,3748,0,0,0,0.00,0
,20180222,3748,3748,,,,3748,3748,0,0,0,0.00,0
,20180223,3748,3748,,,,3748,3748,0,0,0,0.00,0
,20180226,3748,3748,,,,3748,3748,0,0,0,0.00,0
,20180227,3748,3748,,,,3748,3748,0,0,0,0.00,0
,20180228,3748,3748,,,,3748,3748,0,0,0,0.00,0
,20180301,3748,3748,,,,3748,3748,0,0,0,0.00,0
,20180302,3748,3748,,,,3748,3748,0,0,0,0.00,0
,20180305,3748,3748,,,,3748,3748,0,0,0,0.00,0
,20180306,3748,3748,,,,3748,3748,0,0,0,0.00,0
,20180307,3748,3748,,,,3748,3748,0,0,0,0.00,0
,20180308,3748,3748,,,,3748,3748,0,0,0,0.00,0
,20180309,3748,3748,,,,3748,3748,0,0,0,0.00,0
,20180312,3748,3748,,,,3748,3748,0,0,0,0.00,0
,20180313,3748,3748,,,,3748,3748,0,0,0,0.00,0
,20180314,3748,3748,,,,3748,3748,0,0,0,0.00,0
,20180315,3748,3748,,,,3748,3748,0,0,0,0.00,0
,20180316,3748,3748,,,,3748,3748,0,0,0,0.00,0
,20180319,3748,3748,,,,3748,3748,0,0,0,0.00,0
,20180320,3748,3748,,,,3748,3748,0,0,0,0.00,0
,20180321,3748,3748,,,,3748,3748,0,0,0,0.00,0
,20180322,3748,3748,,,,3748,3748,0,0,0,0.00,0
,20180323,3748,3748,,,,3748,3748,0,0,0,0.00,0
,20180326,3748,3748,,,,3748,3748,0,0,0,0.00,0
,20180327,3748,3748,,,,3748,3748,0,0,0,0.00,0
,20180328,3748,3748,,,,3748,3748,0,0,0,0.00,0
,20180329,3748,3748,,,,3748,3748,0,0,0,0.00,0
,20180330,3748,3748,,,,3748,3748,0,0,0,0.00,0
,20180402,3748,3748,,,,3748,3748,0,0,0,0.00,0
,20180403,3748,3748,,,,3748,3748,0,0,0,0.00,0
,20180404,3748,3748,,,,3748,3748,0,0,0,0.00,0
,20180409,3748,3748,,,,3748,3748,0,0,0,0.00,0
,20180410,3748,3748,,,,3748,3748,0,0,0,0.00,0
,20180411,3748,3748,,,,3748,3748,0,0,0,0.00,0
,20180412,3748,3748,,,,3748,3748,0,0,0,0.00,0
,20180413,3748,3748,,,,3748,3748,0,0,0,0.00,0
,20180416,3748,3748,,,,3748,3748,0,0,0,0.00,0
,20180417,3748,3748,,,,3748,3748,0,0,0,0.00,0
,20180418,3748,3748,,,,3748,3748,0,0,0,0.00,0
,20180419,3748,3748,,,,3748,3748,0,0,0,0.00,0
,20180420,3748,3748,,,,3748,3748,0,0,0,0.00,0
,20180423,3748,3748,,,,3748,3748,0,0,0,0.00,0
,20180424,3748,3748,,,,3748,3748,0,0,0,0.00,0
,20180425,3748,3748,,,,3748,3748,0,0,0,0.00,0
,20180426,3748,3748,,,,3748,3748,0,0,0,0.00,0
,20180427,3748,3748,,,,3748,3748,0,0,0,0.00,0
,20180502,3748,3748,,,,3748,3748,0,0,0,0.00,0
,20180503,3748,3748,,,,3748,3748,0,0,0,0.00,0
,20180504,3748,3748,,,,3748,3748,0,0,0,0.00,0
,20180507,3748,3748,,,,3748,3748,0,0,0,0.00,0
,20180508,3748,3748,,,,3748,3748,0,0,0,0.00,0
,20180509,3748,3748,,,,3748,3748,0,0,0,0.00,0
,20180510,3748,3748,,,,3748,3748,0,0,0,0.00,0
,20180511,3748,3748,,,,3748,3748,0,0,0,0.00,0
,20180514,3748,3748,,,,3748,3748,0,0,0,0.00,0
,20180515,3748,3748,,,,3748,3748,0,0,0,0.00,0
,20180516,3748,3748,,,,3748,3748,0,0,0,0.00,0
,20180517,3748,3748,,,,3748,3748,0,0,0,0.00,0
,20180518,3748,3748,,,,3748,3748,0,0,0,0.00,0
,20180521,3748,3748,,,,3748,3748,0,0,0,0.00,0
,20180522,3748,3748,,,,3748,3748,0,0,0,0.00,0
,20180523,3748,3748,,,,3748,3748,0,0,0,0.00,0
,20180524,3748,3748,,,,3748,3748,0,0,0,0.00,0
,20180525,3748,3748,,,,3748,3748,0,0,0,0.00,0
,20180528,3748,3748,,,,3748,3748,0,0,0,0.00,0
,20180529,3748,3748,,,,3748,3748,0,0,0,0.00,0
,20180530,3748,3748,,,,3748,3748,0,0,0,0.00,0
,20180531,3748,3748,,,,3748,3748,0,0,0,0.00,0
fu1812,20180102,3748,3748,,,,3748,3748,0,0,0,0.00,0
,20180103,3748,3748,,,,3748,3748,0,0,0,0.00,0
,20180104,3748,3748,,,,3748,3748,0,0,0,0.00,0
,20180105,3748,3748,,,,3748,3748,0,0,0,0.00,0
,20180108,3748,3748,,,,3748,3748,0,0,0,0.00,0
,20180109,3748,3748,,,,3748,3748,0,0,0,0.00,0
,20180110,3748,3748,,,,3748,3748,0,0,0,0.00,0
,20180111,3748,3748,,,,3748,3748,0,0,0,0.00,0
,20180112,3748,3748,,,,3748,3748,0,0,0,0.00,0
,20180115,3748,3748,,,,3748,3748,0,0,0,0.00,0
,20180116,3748,3748,,,,3748,3748,0,0,0,0.00,0
,20180117,3748,3748,,,,3748,3748,0,0,0,0.00,0
,20180118,3748,3748,,,,3748,3748,0,0,0,0.00,0
,20180119,3748,3748,,,,3748,3748,0,0,0,0.00,0
,20180122,3748,3748,,,,3748,3748,0,0,0,0.00,0
,20180123,3748,3748,,,,3748,3748,0,0,0,0.00,0
,20180124,3748,3748,,,,3748,3748,0,0,0,0.00,0
,20180125,3748,3748,,,,3748,3748,0,0,0,0.00,0
,20180126,3748,3748,,,,3748,3748,0,0,0,0.00,0
,20180129,3748,3748,,,,3748,3748,0,0,0,0.00,0
,20180130,3748,3748,,,,3748,3748,0,0,0,0.00,0
,20180131,3748,3748,,,,3748,3748,0,0,0,0.00,0
,20180201,3748,3748,,,,3748,3748,0,0,0,0.00,0
,20180202,3748,3748,,,,3748,3748,0,0,0,0.00,0
,20180205,3748,3748,,,,3748,3748,0,0,0,0.00,0
,20180206,3748,3748,,,,3748,3748,0,0,0,0.00,0
,20180207,3748,3748,,,,3748,3748,0,0,0,0.00,0
,20180208,3748,3748,,,,3748,3748,0,0,0,0.00,0
,20180209,3748,3748,,,,3748,3748,0,0,0,0.00,0
,20180212,3748,3748,,,,3748,3748,0,0,0,0.00,0
,20180213,3748,3748,,,,3748,3748,0,0,0,0.00,0
,20180214,3748,3748,,,,3748,3748,0,0,0,0.00,0
,20180222,3748,3748,,,,3748,3748,0,0,0,0.00,0
,20180223,3748,3748,,,,3748,3748,0,0,0,0.00,0
,20180226,3748,3748,,,,3748,3748,0,0,0,0.00,0
,20180227,3748,3748,,,,3748,3748,0,0,0,0.00,0
,20180228,3748,3748,,,,3748,3748,0,0,0,0.00,0
,20180301,3748,3748,,,,3748,3748,0,0,0,0.00,0
,20180302,3748,3748,,,,3748,3748,0,0,0,0.00,0
,20180305,3748,3748,,,,3748,3748,0,0,0,0.00,0
,20180306,3748,3748,,,,3748,3748,0,0,0,0.00,0
,20180307,3748,3748,,,,3748,3748,0,0,0,0.00,0
,20180308,3748,3748,,,,3748,3748,0,0,0,0.00,0
,20180309,3748,3748,,,,3748,3748,0,0,0,0.00,0
,20180312,3748,3748,,,,3748,3748,0,0,0,0.00,0
,20180313,3748,3748,,,,3748,3748,0,0,0,0.00,0
,20180314,3748,3748,,,,3748,3748,0,0,0,0.00,0
,20180315,3748,3748,,,,3748,3748,0,0,0,0.00,0
,20180316,3748,3748,,,,3748,3748,0,0,0,0.00,0
,20180319,3748,3748,,,,3748,3748,0,0,0,0.00,0
,20180320,3748,3748,,,,3748,3748,0,0,0,0.00,0
,20180321,3748,3748,,,,3748,3748,0,0,0,0.00,0
,20180322,3748,3748,,,,3748,3748,0,0,0,0.00,0
,20180323,3748,3748,,,,3748,3748,0,0,0,0.00,0
,20180326,3748,3748,,,,3748,3748,0,0,0,0.00,0
,20180327,3748,3748,,,,3748,3748,0,0,0,0.00,0
,20180328,3748,3748,,,,3748,3748,0,0,0,0.00,0
,20180329,3748,3748,,,,3748,3748,0,0,0,0.00,0
,20180330,3748,3748,,,,3748,3748,0,0,0,0.00,0
,20180402,3748,3748,,,,3748,3748,0,0,0,0.00,0
,20180403,3748,3748,,,,3748,3748,0,0,0,0.00,0
,20180404,3748,3748,,,,3748,3748,0,0,0,0.00,0
,20180409,3748,3748,,,,3748,3748,0,0,0,0.00,0
,20180410,3748,3748,,,,3748,3748,0,0,0,0.00,0
,20180411,3748,3748,,,,3748,3748,0,0,0,0.00,0
,20180412,3748,3748,,,,3748,3748,0,0,0,0.00,0
,20180413,3748,3748,,,,3748,3748,0,0,0,0.00,0
,20180416,3748,3748,,,,3748,3748,0,0,0,0.00,0
,20180417,3748,3748,,,,3748,3748,0,0,0,0.00,0
,20180418,3748,3748,,,,3748,3748,0,0,0,0.00,0
,20180419,3748,3748,,,,3748,3748,0,0,0,0.00,0
,20180420,3748,3748,,,,3748,3748,0,0,0,0.00,0
,20180423,3748,3748,,,,3748,3748,0,0,0,0.00,0
,20180424,3748,3748,,,,3748,3748,0,0,0,0.00,0
,20180425,3748,3748,,,,3748,3748,0,0,0,0.00,0
,20180426,3748,3748,,,,3748,3748,0,0,0,0.00,0
,20180427,3748,3748,,,,3748,3748,0,0,0,0.00,0
,20180502,3748,3748,,,,3748,3748,0,0,0,0.00,0
,20180503,3748,3748,,,,3748,3748,0,0,0,0.00,0
,20180504,3748,3748,,,,3748,3748,0,0,0,0.00,0
,20180507,3748,3748,,,,3748,3748,0,0,0,0.00,0
,20180508,3748,3748,,,,3748,3748,0,0,0,0.00,0
,20180509,3748,3748,,,,3748,3748,0,0,0,0.00,0
,20180510,3748,3748,,,,3748,3748,0,0,0,0.00,0
,20180511,3748,3748,,,,3748,3748,0,0,0,0.00,0
,20180514,3748,3748,,,,3748,3748,0,0,0,0.00,0
,20180515,3748,3748,,,,3748,3748,0,0,0,0.00,0
,20180516,3748,3748,,,,3748,3748,0,0,0,0.00,0
,20180517,3748,3748,,,,3748,3748,0,0,0,0.00,0
,20180518,3748,3748,,,,3748,3748,0,0,0,0.00,0
,20180521,3748,3748,,,,3748,3748,0,0,0,0.00,0
,20180522,3748,3748,,,,3748,3748,0,0,0,0.00,0
,20180523,3748,3748,,,,3748,3748,0,0,0,0.00,0
,20180524,3748,3748,,,,3748,3748,0,0,0,0.00,0
,20180525,3748,3748,,,,3748,3748,0,0,0,0.00,0
,20180528,3748,3748,,,,3748,3748,0,0,0,0.00,0
,20180529,3748,3748,,,,3748,3748,0,0,0,0.00,0
,20180530,3748,3748,,,,3748,3748,0,0,0,0.00,0
,20180531,3748,3748,,,,3748,3748,0,0,0,0.00,0
fu1901,20180102,3748,3748,,,,3748,3748,0,0,0,0.00,0
,20180103,3748,3748,,,,3748,3748,0,0,0,0.00,0
,20180104,3748,3748,,,,3748,3748,0,0,0,0.00,0
,20180105,3748,3748,,,,3748,3748,0,0,0,0.00,0
,20180108,3748,3748,,,,3748,3748,0,0,0,0.00,0
,20180109,3748,3748,,,,3748,3748,0,0,0,0.00,0
,20180110,3748,3748,,,,3748,3748,0,0,0,0.00,0
,20180111,3748,3748,,,,3748,3748,0,0,0,0.00,0
,20180112,3748,3748,,,,3748,3748,0,0,0,0.00,0
,20180115,3748,3748,,,,3748,3748,0,0,0,0.00,0
,20180116,3748,3748,,,,3748,3748,0,0,0,0.00,0
,20180117,3748,3748,,,,3748,3748,0,0,0,0.00,0
,20180118,3748,3748,,,,3748,3748,0,0,0,0.00,0
,20180119,3748,3748,,,,3748,3748,0,0,0,0.00,0
,20180122,3748,3748,,,,3748,3748,0,0,0,0.00,0
,20180123,3748,3748,,,,3748,3748,0,0,0,0.00,0
,20180124,3748,3748,,,,3748,3748,0,0,0,0.00,0
,20180125,3748,3748,,,,3748,3748,0,0,0,0.00,0
,20180126,3748,3748,,,,3748,3748,0,0,0,0.00,0
,20180129,3748,3748,,,,3748,3748,0,0,0,0.00,0
,20180130,3748,3748,,,,3748,3748,0,0,0,0.00,0
,20180131,3748,3748,,,,3748,3748,0,0,0,0.00,0
,20180201,3748,3748,,,,3748,3748,0,0,0,0.00,0
,20180202,3748,3748,,,,3748,3748,0,0,0,0.00,0
,20180205,3748,3748,,,,3748,3748,0,0,0,0.00,0
,20180206,3748,3748,,,,3748,3748,0,0,0,0.00,0
,20180207,3748,3748,,,,3748,3748,0,0,0,0.00,0
,20180208,3748,3748,,,,3748,3748,0,0,0,0.00,0
,20180209,3748,3748,,,,3748,3748,0,0,0,0.00,0
,20180212,3748,3748,,,,3748,3748,0,0,0,0.00,0
,20180213,3748,3748,,,,3748,3748,0,0,0,0.00,0
,20180214,3748,3748,,,,3748,3748,0,0,0,0.00,0
,20180222,3748,3748,,,,3748,3748,0,0,0,0.00,0
,20180223,3748,3748,,,,3748,3748,0,0,0,0.00,0
,20180226,3748,3748,,,,3748,3748,0,0,0,0.00,0
,20180227,3748,3748,,,,3748,3748,0,0,0,0.00,0
,20180228,3748,3748,,,,3748,3748,0,0,0,0.00,0
,20180301,3748,3748,,,,3748,3748,0,0,0,0.00,0
,20180302,3748,3748,,,,3748,3748,0,0,0,0.00,0
,20180305,3748,3748,,,,3748,3748,0,0,0,0.00,0
,20180306,3748,3748,,,,3748,3748,0,0,0,0.00,0
,20180307,3748,3748,,,,3748,3748,0,0,0,0.00,0
,20180308,3748,3748,,,,3748,3748,0,0,0,0.00,0
,20180309,3748,3748,,,,3748,3748,0,0,0,0.00,0
,20180312,3748,3748,,,,3748,3748,0,0,0,0.00,0
,20180313,3748,3748,,,,3748,3748,0,0,0,0.00,0
,20180314,3748,3748,,,,3748,3748,0,0,0,0.00,0
,20180315,3748,3748,,,,3748,3748,0,0,0,0.00,0
,20180316,3748,3748,,,,3748,3748,0,0,0,0.00,0
,20180319,3748,3748,,,,3748,3748,0,0,0,0.00,0
,20180320,3748,3748,,,,3748,3748,0,0,0,0.00,0
,20180321,3748,3748,,,,3748,3748,0,0,0,0.00,0
,20180322,3748,3748,,,,3748,3748,0,0,0,0.00,0
,20180323,3748,3748,,,,3748,3748,0,0,0,0.00,0
,20180326,3748,3748,,,,3748,3748,0,0,0,0.00,0
,20180327,3748,3748,,,,3748,3748,0,0,0,0.00,0
,20180328,3748,3748,,,,3748,3748,0,0,0,0.00,0
,20180329,3748,3748,,,,3748,3748,0,0,0,0.00,0
,20180330,3748,3748,,,,3748,3748,0,0,0,0.00,0
,20180402,3748,3748,,,,3748,3748,0,0,0,0.00,0
,20180403,3748,3748,,,,3748,3748,0,0,0,0.00,0
,20180404,3748,3748,,,,3748,3748,0,0,0,0.00,0
,20180409,3748,3748,,,,3748,3748,0,0,0,0.00,0
,20180410,3748,3748,,,,3748,3748,0,0,0,0.00,0
,20180411,3748,3748,,,,3748,3748,0,0,0,0.00,0
,20180412,3748,3748,,,,3748,3748,0,0,0,0.00,0
,20180413,3748,3748,,,,3748,3748,0,0,0,0.00,0
,20180416,3748,3748,,,,3748,3748,0,0,0,0.00,0
,20180417,3748,3748,,,,3748,3748,0,0,0,0.00,0
,20180418,3748,3748,,,,3748,3748,0,0,0,0.00,0
,20180419,3748,3748,,,,3748,3748,0,0,0,0.00,0
,20180420,3748,3748,,,,3748,3748,0,0,0,0.00,0
,20180423,3748,3748,,,,3748,3748,0,0,0,0.00,0
,20180424,3748,3748,,,,3748,3748,0,0,0,0.00,0
,20180425,3748,3748,,,,3748,3748,0,0,0,0.00,0
,20180426,3748,3748,,,,3748,3748,0,0,0,0.00,0
,20180427,3748,3748,,,,3748,3748,0,0,0,0.00,0
,20180502,3748,3748,,,,3748,3748,0,0,0,0.00,0
,20180503,3748,3748,,,,3748,3748,0,0,0,0.00,0
,20180504,3748,3748,,,,3748,3748,0,0,0,0.00,0
,20180507,3748,3748,,,,3748,3748,0,0,0,0.00,0
,20180508,3748,3748,,,,3748,3748,0,0,0,0.00,0
,20180509,3748,3748,,,,3748,3748,0,0,0,0.00,0
,20180510,3748,3748,,,,3748,3748,0,0,0,0.00,0
,20180511,3748,3748,,,,3748,3748,0,0,0,0.00,0
,20180514,3748,3748,,,,3748,3748,0,0,0,0.00,0
,20180515,3748,3748,,,,3748,3748,0,0,0,0.00,0
,20180516,3748,3748,,,,3748,3748,0,0,0,0.00,0
,20180517,3748,3748,,,,3748,3748,0,0,0,0.00,0
,20180518,3748,3748,,,,3748,3748,0,0,0,0.00,0
,20180521,3748,3748,,,,3748,3748,0,0,0,0.00,0
,20180522,3748,3748,,,,3748,3748,0,0,0,0.00,0
,20180523,3748,3748,,,,3748,3748,0,0,0,0.00,0
,20180524,3748,3748,,,,3748,3748,0,0,0,0.00,0
,20180525,3748,3748,,,,3748,3748,0,0,0,0.00,0
,20180528,3748,3748,,,,3748,3748,0,0,0,0.00,0
,20180529,3748,3748,,,,3748,3748,0,0,0,0.00,0
,20180530,3748,3748,,,,3748,3748,0,0,0,0.00,0
,20180531,3748,3748,,,,3748,3748,0,0,0,0.00,0
fu1903,20180301,3748,3748,,,,3748,3748,0,0,0,0.00,0
,20180302,3748,3748,,,,3748,3748,0,0,0,0.00,0
,20180305,3748,3748,,,,3748,3748,0,0,0,0.00,0
,20180306,3748,3748,,,,3748,3748,0,0,0,0.00,0
,20180307,3748,3748,,,,3748,3748,0,0,0,0.00,0
,20180308,3748,3748,,,,3748,3748,0,0,0,0.00,0
,20180309,3748,3748,,,,3748,3748,0,0,0,0.00,0
,20180312,3748,3748,,,,3748,3748,0,0,0,0.00,0
,20180313,3748,3748,,,,3748,3748,0,0,0,0.00,0
,20180314,3748,3748,,,,3748,3748,0,0,0,0.00,0
,20180315,3748,3748,,,,3748,3748,0,0,0,0.00,0
,20180316,3748,3748,,,,3748,3748,0,0,0,0.00,0
,20180319,3748,3748,,,,3748,3748,0,0,0,0.00,0
,20180320,3748,3748,,,,3748,3748,0,0,0,0.00,0
,20180321,3748,3748,,,,3748,3748,0,0,0,0.00,0
,20180322,3748,3748,,,,3748,3748,0,0,0,0.00,0
,20180323,3748,3748,,,,3748,3748,0,0,0,0.00,0
,20180326,3748,3748,,,,3748,3748,0,0,0,0.00,0
,20180327,3748,3748,,,,3748,3748,0,0,0,0.00,0
,20180328,3748,3748,,,,3748,3748,0,0,0,0.00,0
,20180329,3748,3748,,,,3748,3748,0,0,0,0.00,0
,20180330,3748,3748,,,,3748,3748,0,0,0,0.00,0
,20180402,3748,3748,,,,3748,3748,0,0,0,0.00,0
,20180403,3748,3748,,,,3748,3748,0,0,0,0.00,0
,20180404,3748,3748,,,,3748,3748,0,0,0,0.00,0
,20180409,3748,3748,,,,3748,3748,0,0,0,0.00,0
,20180410,3748,3748,,,,3748,3748,0,0,0,0.00,0
,20180411,3748,3748,,,,3748,3748,0,0,0,0.00,0
,20180412,3748,3748,,,,3748,3748,0,0,0,0.00,0
,20180413,3748,3748,,,,3748,3748,0,0,0,0.00,0
,20180416,3748,3748,,,,3748,3748,0,0,0,0.00,0
,20180417,3748,3748,,,,3748,3748,0,0,0,0.00,0
,20180418,3748,3748,,,,3748,3748,0,0,0,0.00,0
,20180419,3748,3748,,,,3748,3748,0,0,0,0.00,0
,20180420,3748,3748,,,,3748,3748,0,0,0,0.00,0
,20180423,3748,3748,,,,3748,3748,0,0,0,0.00,0
,20180424,3748,3748,,,,3748,3748,0,0,0,0.00,0
,20180425,3748,3748,,,,3748,3748,0,0,0,0.00,0
,20180426,3748,3748,,,,3748,3748,0,0,0,0.00,0
,20180427,3748,3748,,,,3748,3748,0,0,0,0.00,0
,20180502,3748,3748,,,,3748,3748,0,0,0,0.00,0
,20180503,3748,3748,,,,3748,3748,0,0,0,0.00,0
,20180504,3748,3748,,,,3748,3748,0,0,0,0.00,0
,20180507,3748,3748,,,,3748,3748,0,0,0,0.00,0
,20180508,3748,3748,,,,3748,3748,0,0,0,0.00,0
,20180509,3748,3748,,,,3748,3748,0,0,0,0.00,0
,20180510,3748,3748,,,,3748,3748,0,0,0,0.00,0
,20180511,3748,3748,,,,3748,3748,0,0,0,0.00,0
,20180514,3748,3748,,,,3748,3748,0,0,0,0.00,0
,20180515,3748,3748,,,,3748,3748,0,0,0,0.00,0
,20180516,3748,3748,,,,3748,3748,0,0,0,0.00,0
,20180517,3748,3748,,,,3748,3748,0,0,0,0.00,0
,20180518,3748,3748,,,,3748,3748,0,0,0,0.00,0
,20180521,3748,3748,,,,3748,3748,0,0,0,0.00,0
,20180522,3748,3748,,,,3748,3748,0,0,0,0.00,0
,20180523,3748,3748,,,,3748,3748,0,0,0,0.00,0
,20180524,3748,3748,,,,3748,3748,0,0,0,0.00,0
,20180525,3748,3748,,,,3748,3748,0,0,0,0.00,0
,20180528,3748,3748,,,,3748,3748,0,0,0,0.00,0
,20180529,3748,3748,,,,3748,3748,0,0,0,0.00,0
,20180530,3748,3748,,,,3748,3748,0,0,0,0.00,0
,20180531,3748,3748,,,,3748,3748,0,0,0,0.00,0
fu1904,20180402,3748,3748,,,,3748,3748,0,0,0,0.00,0
,20180403,3748,3748,,,,3748,3748,0,0,0,0.00,0
,20180404,3748,3748,,,,3748,3748,0,0,0,0.00,0
,20180409,3748,3748,,,,3748,3748,0,0,0,0.00,0
,20180410,3748,3748,,,,3748,3748,0,0,0,0.00,0
,20180411,3748,3748,,,,3748,3748,0,0,0,0.00,0
,20180412,3748,3748,,,,3748,3748,0,0,0,0.00,0
,20180413,3748,3748,,,,3748,3748,0,0,0,0.00,0
,20180416,3748,3748,,,,3748,3748,0,0,0,0.00,0
,20180417,3748,3748,,,,3748,3748,0,0,0,0.00,0
,20180418,3748,3748,,,,3748,3748,0,0,0,0.00,0
,20180419,3748,3748,,,,3748,3748,0,0,0,0.00,0
,20180420,3748,3748,,,,3748,3748,0,0,0,0.00,0
,20180423,3748,3748,,,,3748,3748,0,0,0,0.00,0
,20180424,3748,3748,,,,3748,3748,0,0,0,0.00,0
,20180425,3748,3748,,,,3748,3748,0,0,0,0.00,0
,20180426,3748,3748,,,,3748,3748,0,0,0,0.00,0
,20180427,3748,3748,,,,3748,3748,0,0,0,0.00,0
,20180502,3748,3748,,,,3748,3748,0,0,0,0.00,0
,20180503,3748,3748,,,,3748,3748,0,0,0,0.00,0
,20180504,3748,3748,,,,3748,3748,0,0,0,0.00,0
,20180507,3748,3748,,,,3748,3748,0,0,0,0.00,0
,20180508,3748,3748,,,,3748,3748,0,0,0,0.00,0
,20180509,3748,3748,,,,3748,3748,0,0,0,0.00,0
,20180510,3748,3748,,,,3748,3748,0,0,0,0.00,0
,20180511,3748,3748,,,,3748,3748,0,0,0,0.00,0
,20180514,3748,3748,,,,3748,3748,0,0,0,0.00,0
,20180515,3748,3748,,,,3748,3748,0,0,0,0.00,0
,20180516,3748,3748,,,,3748,3748,0,0,0,0.00,0
,20180517,3748,3748,,,,3748,3748,0,0,0,0.00,0
,20180518,3748,3748,,,,3748,3748,0,0,0,0.00,0
,20180521,3748,3748,,,,3748,3748,0,0,0,0.00,0
,20180522,3748,3748,,,,3748,3748,0,0,0,0.00,0
,20180523,3748,3748,,,,3748,3748,0,0,0,0.00,0
,20180524,3748,3748,,,,3748,3748,0,0,0,0.00,0
,20180525,3748,3748,,,,3748,3748,0,0,0,0.00,0
,20180528,3748,3748,,,,3748,3748,0,0,0,0.00,0
,20180529,3748,3748,,,,3748,3748,0,0,0,0.00,0
,20180530,3748,3748,,,,3748,3748,0,0,0,0.00,0
,20180531,3748,3748,,,,3748,3748,0,0,0,0.00,0
fu1905,20180502,3748,3748,,,,3748,3748,0,0,0,0.00,0
,20180503,3748,3748,,,,3748,3748,0,0,0,0.00,0
,20180504,3748,3748,,,,3748,3748,0,0,0,0.00,0
,20180507,3748,3748,,,,3748,3748,0,0,0,0.00,0
,20180508,3748,3748,,,,3748,3748,0,0,0,0.00,0
,20180509,3748,3748,3693,4000,3693,4000,3846,252,98,4,76.93,0
,20180510,4000,3846,,,,3846,3846,0,0,0,0.00,0
,20180511,3846,3846,,,,3846,3846,0,0,0,0.00,0
,20180514,3846,3846,,,,3846,3846,0,0,0,0.00,0
,20180515,3846,3846,,,,3846,3846,0,0,0,0.00,0
,20180516,3846,3846,,,,3846,3846,0,0,0,0.00,0
,20180517,3846,3846,,,,3846,3846,0,0,0,0.00,0
,20180518,3846,3846,,,,3846,3846,0,0,0,0.00,0
,20180521,3846,3846,,,,3846,3846,0,0,0,0.00,0
,20180522,3846,3846,,,,3846,3846,0,0,0,0.00,0
,20180523,3846,3846,,,,3846,3846,0,0,0,0.00,0
,20180524,3846,3846,,,,3846,3846,0,0,0,0.00,0
,20180525,3846,3846,,,,3846,3846,0,0,0,0.00,0
,20180528,3846,3846,,,,3846,3846,0,0,0,0.00,0
,20180529,3846,3846,,,,3846,3846,0,0,0,0.00,0
,20180530,3846,3846,,,,3846,3846,0,0,0,0.00,0
,20180531,3846,3846,,,,3846,3846,0,0,0,0.00,0
hc1801,20180102,4160,4155,4189,4189,4157,4170,4177,15,22,6006,"25,087.68",32160
,20180103,4170,4177,4179,4187,4161,4169,4173,-8,-4,3240,"13,521.00",29340
,20180104,4169,4173,4170,4185,4161,4175,4176,2,3,5400,"22,554.66",24480
,20180105,4175,4176,4175,4196,4155,4196,4172,20,-4,3420,"14,269.98",21360
,20180108,4196,4172,4170,4172,4151,4170,4162,-2,-10,2100,"8,741.76",20280
,20180109,4170,4162,4180,4180,4166,4175,4173,13,11,1560,"6,510.96",18840
,20180110,4175,4173,4180,4180,4172,4180,4178,7,5,720,"3,008.16",18120
,20180111,4180,4178,4180,4180,4169,4169,4174,-9,-4,120,500.94,18120
,20180112,4169,4174,4130,4175,4130,4160,4159,-14,-15,1500,"6,239.10",17820
,20180115,4160,4159,,,,4159,4159,0,0,0,0.00,17820
hc1802,20180102,4000,4000,4022,4127,4022,4127,4039,127,39,12,48.47,74
,20180103,4127,4039,3989,4173,3989,4071,4105,32,66,26,106.75,74
,20180104,4071,4105,4036,4118,4036,4118,4089,13,-16,6,24.54,74
,20180105,4118,4089,4128,4128,4124,4124,4124,35,35,18,74.24,58
,20180108,4124,4124,4052,4052,4011,4011,4031,-113,-93,4,16.13,58
,20180109,4011,4031,4140,4140,4139,4139,4139,108,108,10,41.40,48
,20180110,4139,4139,4140,4140,4140,4140,4140,1,1,2,8.28,46
,20180111,4140,4140,4105,4105,4105,4105,4105,-35,-35,2,8.21,46
,20180112,4105,4105,4140,4140,4139,4139,4139,34,34,8,33.12,38
,20180115,4139,4139,,,,4137,4137,-2,-2,0,0.00,38
,20180116,4137,4137,,,,4137,4137,0,0,0,0.00,38
,20180117,4137,4137,,,,4137,4137,0,0,0,0.00,38
,20180118,4137,4137,,,,4137,4137,0,0,0,0.00,38
,20180119,4137,4137,,,,4137,4137,0,0,0,0.00,38
,20180122,4137,4137,4139,4140,4139,4140,4139,3,2,8,33.12,30
,20180123,4140,4139,,,,4139,4139,0,0,0,0.00,30
,20180124,4139,4139,4100,4100,4100,4100,4100,-39,-39,18,73.80,12
,20180125,4100,4100,,,,4100,4100,0,0,0,0.00,12
,20180126,4100,4100,4061,4061,4061,4061,4061,-39,-39,6,24.37,8
,20180129,4061,4061,,,,4061,4061,0,0,0,0.00,8
,20180130,4061,4061,3945,3969,3846,3958,3922,-103,-139,12,47.07,4
,20180131,3958,3922,3994,3994,3963,3963,3978,41,56,4,15.91,0
,20180201,3963,3978,,,,3978,3978,0,0,0,0.00,0
,20180202,3978,3978,,,,3978,3978,0,0,0,0.00,0
,20180205,3978,3978,,,,3978,3978,0,0,0,0.00,0
,20180206,3978,3978,,,,3978,3978,0,0,0,0.00,0
,20180207,3978,3978,,,,3978,3978,0,0,0,0.00,0
,20180208,3978,3978,,,,3978,3978,0,0,0,0.00,0
,20180209,3978,3978,,,,3978,3978,0,0,0,0.00,0
hc1803,20180102,3982,3986,4060,4060,4055,4060,4058,74,72,6,24.35,94
,20180103,4060,4058,3985,3992,3985,3992,3988,-66,-70,4,15.95,90
,20180104,3992,3988,,,,3988,3988,0,0,0,0.00,90
,20180105,3988,3988,3970,3985,3970,3985,3981,-3,-7,8,31.85,96
,20180108,3985,3981,3985,3985,3985,3985,3985,4,4,12,47.82,108
,20180109,3985,3985,,,,3987,3987,2,2,0,0.00,108
,20180110,3987,3987,3985,3985,3985,3985,3985,-2,-2,4,15.94,108
,20180111,3985,3985,,,,3990,3990,5,5,0,0.00,108
,20180112,3990,3990,,,,4000,4000,10,10,0,0.00,108
,20180115,4000,4000,,,,4000,4000,0,0,0,0.00,108
,20180116,4000,4000,,,,4000,4000,0,0,0,0.00,108
,20180117,4000,4000,,,,4000,4000,0,0,0,0.00,108
,20180118,4000,4000,4059,4059,4059,4059,4059,59,59,2,8.12,110
,20180119,4059,4059,4050,4060,4050,4060,4050,1,-9,24,97.22,106
,20180122,4060,4050,4054,4054,4054,4054,4054,4,4,2,8.11,104
,20180123,4054,4054,,,,4054,4054,0,0,0,0.00,104
,20180124,4054,4054,,,,4054,4054,0,0,0,0.00,104
,20180125,4054,4054,4100,4100,4100,4100,4100,46,46,4,16.40,100
,20180126,4100,4100,,,,4100,4100,0,0,0,0.00,100
,20180129,4100,4100,,,,4100,4100,0,0,0,0.00,100
,20180130,4100,4100,,,,4100,4100,0,0,0,0.00,100
,20180131,4100,4100,,,,4100,4100,0,0,0,0.00,100
,20180201,4100,4100,,,,4100,4100,0,0,0,0.00,100
,20180202,4100,4100,4165,4165,4165,4165,4165,65,65,6,24.99,100
,20180205,4165,4165,,,,4165,4165,0,0,0,0.00,100
,20180206,4165,4165,,,,4165,4165,0,0,0,0.00,100
,20180207,4165,4165,,,,4150,4150,-15,-15,0,0.00,100
,20180208,4150,4150,4145,4145,4145,4145,4145,-5,-5,8,33.16,92
,20180209,4145,4145,4062,4062,4062,4062,4062,-83,-83,2,8.12,92
,20180212,4062,4062,,,,4062,4062,0,0,0,0.00,92
,20180213,4062,4062,,,,4062,4062,0,0,0,0.00,92
,20180214,4062,4062,4100,4100,4100,4100,4100,38,38,6,24.60,86
,20180222,4100,4100,,,,4100,4100,0,0,0,0.00,86
,20180223,4100,4100,4105,4105,4105,4105,4105,5,5,6,24.63,80
,20180226,4105,4105,4052,4052,4035,4035,4046,-70,-59,12,48.56,84
,20180227,4035,4046,4055,4249,4032,4032,4068,-14,22,42,170.86,70
,20180228,4032,4068,4120,4179,4120,4179,4131,111,63,10,41.32,60
,20180301,4179,4131,4235,4235,4235,4235,4235,104,104,60,254.10,0
,20180302,4235,4235,,,,4235,4235,0,0,0,0.00,0
,20180305,4235,4235,,,,4235,4235,0,0,0,0.00,0
,20180306,4235,4235,,,,4235,4235,0,0,0,0.00,0
,20180307,4235,4235,,,,4235,4235,0,0,0,0.00,0
,20180308,4235,4235,,,,4235,4235,0,0,0,0.00,0
,20180309,4235,4235,,,,4235,4235,0,0,0,0.00,0
,20180312,4235,4235,,,,4235,4235,0,0,0,0.00,0
,20180313,4235,4235,,,,4235,4235,0,0,0,0.00,0
,20180314,4235,4235,,,,4235,4235,0,0,0,0.00,0
,20180315,4235,4235,,,,4235,4235,0,0,0,0.00,0
hc1804,20180102,3968,3968,3870,4014,3870,4000,3965,32,-3,24,95.17,72
,20180103,4000,3965,3961,3961,3961,3961,3961,-4,-4,2,7.92,74
,20180104,3961,3961,3894,3919,3894,3919,3906,-42,-55,4,15.63,72
,20180105,3919,3906,3909,3909,3909,3909,3909,3,3,2,7.82,72
,20180108,3909,3909,3925,3925,3891,3891,3907,-18,-2,42,164.12,72
,20180109,3891,3907,3906,3906,3906,3906,3906,-1,-1,2,7.81,70
,20180110,3906,3906,3924,3924,3924,3924,3924,18,18,6,23.54,72
,20180111,3924,3924,3978,3978,3927,3933,3954,9,30,16,63.26,70
,20180112,3933,3954,3909,3909,3909,3909,3909,-45,-45,4,15.64,74
,20180115,3909,3909,,,,3909,3909,0,0,0,0.00,74
,20180116,3909,3909,3873,3873,3873,3873,3873,-36,-36,2,7.75,74
,20180117,3873,3873,,,,3873,3873,0,0,0,0.00,74
,20180118,3873,3873,,,,3873,3873,0,0,0,0.00,74
,20180119,3873,3873,,,,3865,3865,-8,-8,0,0.00,74
,20180122,3865,3865,,,,3868,3868,3,3,0,0.00,74
,20180123,3868,3868,,,,3930,3930,62,62,0,0.00,74
,20180124,3930,3930,,,,3951,3951,21,21,0,0.00,74
,20180125,3951,3951,3996,4049,3996,4037,4031,86,80,10,40.31,66
,20180126,4037,4031,3970,3970,3970,3970,3970,-61,-61,4,15.88,70
,20180129,3970,3970,3976,3977,3976,3977,3976,7,6,4,15.91,68
,20180130,3977,3976,,,,3976,3976,0,0,0,0.00,68
,20180131,3976,3976,,,,3976,3976,0,0,0,0.00,68
,20180201,3976,3976,,,,3976,3976,0,0,0,0.00,68
,20180202,3976,3976,,,,4039,4039,63,63,0,0.00,68
,20180205,4039,4039,4111,4111,4081,4081,4096,42,57,4,16.38,66
,20180206,4081,4096,,,,4096,4096,0,0,0,0.00,66
,20180207,4096,4096,,,,4096,4096,0,0,0,0.00,66
,20180208,4096,4096,,,,4096,4096,0,0,0,0.00,66
,20180209,4096,4096,,,,4013,4013,-83,-83,0,0.00,66
,20180212,4013,4013,,,,4013,4013,0,0,0,0.00,66
,20180213,4013,4013,,,,4013,4013,0,0,0,0.00,66
,20180214,4013,4013,,,,4050,4050,37,37,0,0.00,66
,20180222,4050,4050,,,,4050,4050,0,0,0,0.00,66
,20180223,4050,4050,,,,4050,4050,0,0,0,0.00,66
,20180226,4050,4050,,,,3992,3992,-58,-58,0,0.00,66
,20180227,3992,3992,,,,4013,4013,21,21,0,0.00,66
,20180228,4013,4013,,,,4075,4075,62,62,0,0.00,66
,20180301,4075,4075,,,,4075,4075,0,0,0,0.00,66
,20180302,4075,4075,,,,4100,4100,25,25,0,0.00,66
,20180305,4100,4100,4054,4054,4054,4054,4054,-46,-46,4,16.22,66
,20180306,4054,4054,,,,4054,4054,0,0,0,0.00,66
,20180307,4054,4054,,,,4054,4054,0,0,0,0.00,66
,20180308,4054,4054,3900,3969,3886,3886,3904,-168,-150,38,148.38,78
,20180309,3886,3904,3888,3923,3858,3923,3915,19,11,76,297.55,76
,20180312,3923,3915,,,,3915,3915,0,0,0,0.00,76
,20180313,3915,3915,,,,3915,3915,0,0,0,0.00,76
,20180314,3915,3915,3918,3923,3918,3923,3920,8,5,6,23.52,72
,20180315,3923,3920,3998,3998,3998,3998,3998,78,78,4,15.99,74
,20180316,3998,3998,3914,4075,3914,4052,4002,54,4,14,56.04,72
,20180319,4052,4002,,,,4002,4002,0,0,0,0.00,72
,20180320,4002,4002,,,,4002,4002,0,0,0,0.00,72
,20180321,4002,4002,3908,3908,3908,3908,3908,-94,-94,4,15.63,72
,20180322,3908,3908,3888,3888,3888,3888,3888,-20,-20,6,23.33,72
,20180323,3888,3888,3808,3893,3656,3750,3784,-138,-104,24,90.83,72
,20180326,3750,3784,,,,3784,3784,0,0,0,0.00,72
,20180327,3784,3784,,,,3784,3784,0,0,0,0.00,72
,20180328,3784,3784,3740,3750,3708,3750,3729,-34,-55,24,89.52,72
,20180329,3750,3729,3799,3800,3668,3799,3772,70,43,12,45.27,72
,20180330,3799,3772,3874,3874,3784,3784,3795,12,23,16,60.72,60
,20180402,3784,3795,,,,3795,3795,0,0,0,0.00,60
,20180403,3795,3795,3920,3920,3920,3920,3920,125,125,60,235.20,0
,20180404,3920,3920,,,,3920,3920,0,0,0,0.00,0
,20180409,3920,3920,,,,3920,3920,0,0,0,0.00,0
,20180410,3920,3920,,,,3920,3920,0,0,0,0.00,0
,20180411,3920,3920,,,,3920,3920,0,0,0,0.00,0
,20180412,3920,3920,,,,3920,3920,0,0,0,0.00,0
,20180413,3920,3920,,,,3920,3920,0,0,0,0.00,0
,20180416,3920,3920,,,,3920,3920,0,0,0,0.00,0
hc1805,20180102,3846,3861,3850,3940,3842,3927,3893,66,32,570750,"2,222,428.54",635234
,20180103,3927,3893,3931,3934,3861,3864,3899,-29,6,500302,"1,950,813.21",632164
,20180104,3864,3899,3857,3897,3845,3877,3868,-22,-31,568448,"2,199,086.79",648052
,20180105,3877,3868,3878,3878,3791,3842,3832,-26,-36,869870,"3,333,560.31",711304
,20180108,3842,3832,3839,3865,3770,3864,3810,32,-22,769662,"2,932,567.44",714236
,20180109,3864,3810,3860,3894,3852,3862,3869,52,59,595800,"2,305,655.42",681804
,20180110,3862,3869,3860,3906,3830,3880,3871,11,2,696268,"2,695,632.28",679090
,20180111,3880,3871,3888,3908,3857,3874,3885,3,14,516546,"2,006,799.14",655534
,20180112,3874,3885,3877,3886,3814,3831,3844,-54,-41,506008,"1,945,520.01",668280
,20180115,3831,3844,3820,3848,3791,3837,3825,-7,-19,429202,"1,642,049.16",660654
,20180116,3837,3825,3836,3879,3820,3822,3847,-3,22,592030,"2,278,000.58",662994
,20180117,3822,3847,3820,3865,3812,3843,3840,-4,-7,629880,"2,419,042.10",662154
,20180118,3843,3840,3837,3873,3829,3861,3852,21,12,537790,"2,072,007.11",680280
,20180119,3861,3852,3863,3928,3818,3923,3859,71,7,932068,"3,597,135.55",691054
,20180122,3923,3859,3923,3945,3883,3898,3908,39,49,610550,"2,386,510.35",709654
,20180123,3898,3908,3901,3920,3871,3903,3897,-5,-11,644968,"2,513,922.04",685074
,20180124,3903,3897,3903,3943,3883,3939,3917,42,20,509920,"1,997,386.69",711894
,20180125,3939,3917,3936,4009,3920,3973,3962,56,45,702804,"2,784,592.01",698556
,20180126,3973,3962,3970,3987,3936,3962,3963,0,1,447618,"1,774,057.18",675822
,20180129,3962,3963,3961,3977,3940,3964,3960,1,-3,311510,"1,233,877.92",674618
,20180130,3964,3960,3970,3970,3913,3939,3938,-21,-22,432572,"1,703,843.58",642366
,20180131,3939,3938,3944,3994,3908,3934,3932,-4,-6,424890,"1,670,671.38",620176
,20180201,3934,3932,3940,4000,3935,3972,3970,40,38,660720,"2,623,325.24",653874
,20180202,3972,3970,3964,4041,3956,4033,4012,63,42,836666,"3,356,948.76",752600
,20180205,4033,4012,4033,4045,3992,4028,4019,16,7,546466,"2,196,256.23",719200
,20180206,4028,4019,4030,4050,3994,4010,4018,-9,-1,537924,"2,161,833.40",668316
,20180207,4010,4018,4017,4027,3982,4012,4007,-6,-11,431298,"1,728,487.88",643280
,20180208,4012,4007,4006,4040,4000,4027,4020,20,13,461064,"1,853,582.39",656842
,20180209,4027,4020,4031,4042,3949,3958,3995,-62,-25,609574,"2,435,716.51",621172
,20180212,3958,3995,3957,3985,3945,3973,3964,-22,-31,322006,"1,276,654.10",594878
,20180213,3973,3964,3965,4008,3958,3985,3985,21,21,295748,"1,178,642.39",566246
,20180214,3985,3985,3976,4002,3968,3984,3984,-1,-1,254260,"1,013,036.39",545414
,20180222,3984,3984,3978,4000,3906,3927,3945,-57,-39,335892,"1,325,193.98",555952
,20180223,3927,3945,3918,3983,3888,3972,3928,27,-17,669432,"2,630,142.29",573130
,20180226,3972,3928,3982,4084,3970,4080,4040,152,112,583884,"2,359,215.62",591630
,20180227,4080,4040,4085,4102,4039,4099,4069,59,29,448872,"1,826,836.57",620264
,20180228,4099,4069,4089,4105,4071,4087,4086,18,17,431470,"1,763,175.29",624326
,20180301,4087,4086,4078,4124,4077,4094,4096,8,10,426214,"1,745,929.80",635258
,20180302,4094,4096,4082,4124,4065,4120,4091,24,-5,526900,"2,155,672.46",659956
,20180305,4120,4091,4114,4115,4037,4047,4071,-44,-20,618146,"2,516,936.09",577204
,20180306,4047,4071,4046,4061,4016,4042,4041,-29,-30,462866,"1,870,569.97",548768
,20180307,4042,4041,4040,4049,3945,3946,4000,-95,-41,640136,"2,561,082.65",542904
,20180308,3946,4000,3946,3970,3880,3883,3934,-117,-66,546380,"2,149,939.64",504782
,20180309,3883,3934,3875,3896,3760,3803,3838,-131,-96,821858,"3,154,851.26",488736
,20180312,3803,3838,3840,3851,3785,3821,3822,-17,-16,557188,"2,129,934.30",456466
,20180313,3821,3822,3825,3850,3792,3811,3824,-11,2,465964,"1,782,055.37",463320
,20180314,3811,3824,3820,3872,3772,3856,3822,32,-2,595988,"2,278,422.04",452032
,20180315,3856,3822,3864,3879,3833,3862,3858,40,36,416146,"1,605,650.46",439320
,20180316,3862,3858,3860,3902,3836,3877,3872,19,14,570262,"2,208,432.77",464510
,20180319,3877,3872,3878,3888,3780,3815,3825,-57,-47,753830,"2,884,047.48",449164
,20180320,3815,3825,3810,3847,3786,3816,3818,-9,-7,639886,"2,443,085.79",442650
,20180321,3816,3818,3813,3849,3725,3735,3783,-83,-35,892754,"3,377,548.91",494124
,20180322,3735,3783,3737,3768,3706,3747,3738,-36,-45,692420,"2,588,414.08",460976
,20180323,3747,3738,3743,3743,3513,3536,3596,-202,-142,1137830,"4,092,504.46",409926
,20180326,3536,3596,3536,3590,3491,3513,3530,-83,-66,730960,"2,580,522.70",389114
,20180327,3513,3530,3520,3626,3507,3587,3567,57,37,733978,"2,618,717.19",389954
,20180328,3587,3567,3593,3628,3539,3579,3588,12,21,775712,"2,783,756.89",380464
,20180329,3579,3588,3582,3639,3562,3631,3600,43,12,569474,"2,050,407.11",367478
,20180330,3631,3600,3633,3729,3611,3726,3659,126,59,562774,"2,059,717.95",350676
,20180402,3726,3659,3711,3795,3682,3712,3710,53,51,466136,"1,729,655.27",311510
,20180403,3712,3710,3718,3755,3671,3698,3717,-12,7,469822,"1,746,705.55",280760
,20180404,3698,3717,3705,3743,3688,3713,3713,-4,-4,365670,"1,357,950.11",248348
,20180409,3713,3713,3707,3785,3707,3782,3747,69,34,311930,"1,168,834.34",237904
,20180410,3782,3747,3780,3828,3758,3813,3787,66,40,202200,"765,875.81",198942
,20180411,3813,3787,3814,3832,3763,3775,3792,-12,5,147184,"558,214.51",173686
,20180412,3775,3792,3784,3819,3760,3801,3786,9,-6,127078,"481,124.57",158026
,20180413,3801,3786,3806,3842,3770,3840,3806,54,20,84578,"321,970.52",146702
,20180416,3840,3806,3840,3853,3796,3810,3818,4,12,92452,"353,046.33",131976
,20180417,3810,3818,3818,3869,3805,3852,3841,34,23,94712,"363,810.17",114592
,20180418,3852,3841,3870,3922,3866,3903,3896,62,55,80984,"315,566.96",100624
,20180419,3903,3896,3912,3953,3900,3939,3925,43,29,63350,"248,682.12",91546
,20180420,3939,3925,3945,3950,3917,3929,3933,4,8,39852,"156,754.03",85602
,20180423,3929,3933,3931,4031,3927,4029,3986,96,53,52722,"210,154.01",73490
,20180424,4029,3986,4024,4091,4022,4075,4066,89,80,47522,"193,242.72",57944
,20180425,4075,4066,4081,4100,4061,4097,4082,31,16,30130,"122,998.99",50302
,20180426,4097,4082,4098,4125,4088,4108,4102,26,20,36538,"149,908.19",34442
,20180427,4108,4102,4102,4122,4100,4119,4110,17,8,26480,"108,856.88",19628
,20180502,4119,4110,4180,4205,4161,4200,4192,90,82,6488,"27,197.90",14700
,20180503,4200,4192,4200,4202,4130,4140,4158,-52,-34,3420,"14,223.30",13620
,20180504,4140,4158,4110,4166,4110,4150,4142,-8,-16,2460,"10,191.54",12060
,20180507,4150,4142,4150,4180,4122,4180,4151,38,9,1380,"5,728.92",10740
,20180508,4180,4151,4180,4180,4162,4162,4170,11,19,960,"4,003.86",9900
,20180509,4162,4170,4150,4150,4120,4130,4128,-40,-42,4320,"17,836.32",6180
,20180510,4130,4128,4130,4145,4125,4140,4134,12,6,2040,"8,434.98",5160
,20180511,4140,4134,4135,4165,4130,4165,4145,31,11,1200,"4,974.24",5940
,20180514,4165,4145,4190,4190,4190,4190,4190,45,45,300,"1,257.00",5760
,20180515,4190,4190,4195,4198,4195,4198,4195,8,5,360,"1,510.38",5520
hc1806,20180102,3835,3835,,,,3867,3867,32,32,0,0.00,32
,20180103,3867,3867,,,,3873,3873,6,6,0,0.00,32
,20180104,3873,3873,3865,3865,3830,3830,3847,-43,-26,200,769.50,16
,20180105,3830,3847,3797,3797,3797,3797,3797,-50,-50,2,7.59,18
,20180108,3797,3797,3693,3783,3693,3783,3748,-14,-49,6,22.49,20
,20180109,3783,3748,,,,3806,3806,58,58,0,0.00,20
,20180110,3806,3806,,,,3808,3808,2,2,0,0.00,20
,20180111,3808,3808,,,,3808,3808,0,0,0,0.00,20
,20180112,3808,3808,,,,3808,3808,0,0,0,0.00,20
,20180115,3808,3808,3819,3819,3819,3819,3819,11,11,2,7.64,18
,20180116,3819,3819,,,,3841,3841,22,22,0,0.00,18
,20180117,3841,3841,,,,3841,3841,0,0,0,0.00,18
,20180118,3841,3841,,,,3841,3841,0,0,0,0.00,18
,20180119,3841,3841,,,,3841,3841,0,0,0,0.00,18
,20180122,3841,3841,,,,3841,3841,0,0,0,0.00,18
,20180123,3841,3841,,,,3841,3841,0,0,0,0.00,18
,20180124,3841,3841,3887,3901,3887,3900,3899,59,58,20,77.98,22
,20180125,3900,3899,3900,3902,3900,3902,3901,3,2,4,15.60,18
,20180126,3902,3901,3896,3896,3896,3896,3896,-5,-5,2,7.79,16
,20180129,3896,3896,,,,3896,3896,0,0,0,0.00,16
,20180130,3896,3896,3852,3852,3852,3852,3852,-44,-44,2,7.70,18
,20180131,3852,3852,,,,3852,3852,0,0,0,0.00,18
,20180201,3852,3852,,,,3889,3889,37,37,0,0.00,18
,20180202,3889,3889,3981,3981,3981,3981,3981,92,92,2,7.96,16
,20180205,3981,3981,3991,4011,3991,4011,4004,30,23,6,24.03,12
,20180206,4011,4004,3985,3985,3985,3985,3985,-19,-19,2,7.97,12
,20180207,3985,3985,,,,3985,3985,0,0,0,0.00,12
,20180208,3985,3985,3960,4060,3925,3964,3955,-21,-30,44,174.02,34
,20180209,3964,3955,3929,3929,3900,3920,3924,-35,-31,20,78.49,20
,20180212,3920,3924,,,,3924,3924,0,0,0,0.00,20
,20180213,3924,3924,3902,3960,3902,3960,3928,36,4,24,94.28,18
,20180214,3960,3928,,,,3927,3927,-1,-1,0,0.00,18
,20180222,3927,3927,,,,3888,3888,-39,-39,0,0.00,18
,20180223,3888,3888,3873,3925,3865,3925,3886,37,-2,14,54.41,20
,20180226,3925,3886,4001,4001,4001,4001,4001,115,115,2,8.00,18
,20180227,4001,4001,4041,4041,4041,4041,4041,40,40,2,8.08,18
,20180228,4041,4041,4008,4072,4003,4009,4043,-32,2,16,64.69,20
,20180301,4009,4043,4009,4067,3974,4067,4035,24,-8,22,88.79,22
,20180302,4067,4035,3988,3988,3988,3988,3988,-47,-47,2,7.98,22
,20180305,3988,3988,3995,3995,3995,3995,3995,7,7,2,7.99,20
,20180306,3995,3995,3999,3999,3999,3999,3999,4,4,2,8.00,20
,20180307,3999,3999,3952,3952,3906,3915,3918,-84,-81,10,39.19,14
,20180308,3915,3918,3876,3876,3876,3876,3876,-42,-42,2,7.75,14
,20180309,3876,3876,,,,3782,3782,-94,-94,0,0.00,14
,20180312,3782,3782,3808,3808,3750,3750,3792,-32,10,82,311.00,14
,20180313,3750,3792,3766,3800,3766,3800,3783,8,-9,82,310.24,16
,20180314,3800,3783,3810,3810,3810,3810,3810,27,27,2,7.62,14
,20180315,3810,3810,3795,3796,3795,3796,3795,-14,-15,4,15.18,16
,20180316,3796,3795,,,,3795,3795,0,0,0,0.00,16
,20180319,3795,3795,3862,3867,3862,3867,3864,72,69,4,15.46,18
,20180320,3867,3864,,,,3864,3864,0,0,0,0.00,18
,20180321,3864,3864,,,,3828,3828,-36,-36,0,0.00,18
,20180322,3828,3828,3730,3761,3730,3761,3741,-67,-87,8,29.93,20
,20180323,3761,3741,3531,3611,3531,3545,3585,-196,-156,18,64.54,8
,20180326,3545,3585,,,,3519,3519,-66,-66,0,0.00,8
,20180327,3519,3519,3546,3623,3546,3569,3590,50,71,8,28.72,8
,20180328,3569,3590,,,,3590,3590,0,0,0,0.00,8
,20180329,3590,3590,3571,3571,3571,3571,3571,-19,-19,2,7.14,6
,20180330,3571,3571,,,,3630,3630,59,59,0,0.00,6
,20180402,3630,3630,3677,3677,3677,3677,3677,47,47,8,29.42,6
,20180403,3677,3677,,,,3677,3677,0,0,0,0.00,6
,20180404,3677,3677,,,,3677,3677,0,0,0,0.00,6
,20180409,3677,3677,3669,3670,3669,3670,3669,-7,-8,4,14.68,6
,20180410,3670,3669,3837,3837,3660,3790,3797,121,128,16,60.76,6
,20180411,3790,3797,3734,3808,3734,3808,3771,11,-26,4,15.08,6
,20180412,3808,3771,,,,3771,3771,0,0,0,0.00,6
,20180413,3771,3771,,,,3791,3791,20,20,0,0.00,6
,20180416,3791,3791,3800,3800,3787,3787,3797,-4,6,12,45.57,16
,20180417,3787,3797,,,,3797,3797,0,0,0,0.00,16
,20180418,3797,3797,,,,3852,3852,55,55,0,0.00,16
,20180419,3852,3852,3995,3995,3995,3995,3995,143,143,2,7.99,16
,20180420,3995,3995,,,,3995,3995,0,0,0,0.00,16
,20180423,3995,3995,,,,3995,3995,0,0,0,0.00,16
,20180424,3995,3995,4022,4022,4022,4022,4022,27,27,2,8.04,16
,20180425,4022,4022,,,,4022,4022,0,0,0,0.00,16
,20180426,4022,4022,3978,3978,3978,3978,3978,-44,-44,4,15.91,18
,20180427,3978,3978,,,,3986,3986,8,8,0,0.00,18
,20180502,3986,3986,,,,4065,4065,79,79,0,0.00,18
,20180503,4065,4065,4095,4103,4095,4098,4098,33,33,6,24.59,22
,20180504,4098,4098,,,,4098,4098,0,0,0,0.00,22
,20180507,4098,4098,,,,4098,4098,0,0,0,0.00,22
,20180508,4098,4098,,,,4098,4098,0,0,0,0.00,22
,20180509,4098,4098,4098,4098,4098,4098,4098,0,0,2,8.20,20
,20180510,4098,4098,,,,4098,4098,0,0,0,0.00,20
,20180511,4098,4098,,,,4101,4101,3,3,0,0.00,20
,20180514,4101,4101,4088,4167,4088,4165,4132,64,31,14,57.86,20
,20180515,4165,4132,4172,4172,4172,4172,4172,40,40,2,8.34,18
,20180516,4172,4172,,,,4172,4172,0,0,0,0.00,18
,20180517,4172,4172,,,,4172,4172,0,0,0,0.00,18
,20180518,4172,4172,,,,4172,4172,0,0,0,0.00,18
,20180521,4172,4172,3999,4336,3999,4199,4178,27,6,6,25.07,18
,20180522,4199,4178,3991,4296,3991,4296,4078,118,-100,14,57.09,18
,20180523,4296,4078,,,,4078,4078,0,0,0,0.00,18
,20180524,4078,4078,,,,4078,4078,0,0,0,0.00,18
,20180525,4078,4078,4175,4175,4175,4175,4175,97,97,2,8.35,16
,20180528,4175,4175,4010,4200,3968,4001,4092,-174,-83,134,548.41,16
,20180529,4001,4092,4005,4150,4005,4150,4054,58,-38,10,40.54,10
,20180530,4150,4054,3971,4196,3971,4196,4046,142,-8,6,24.28,8
,20180531,4196,4046,4286,4286,4185,4185,4252,139,206,12,51.03,0
hc1807,20180102,3789,3766,,,,3798,3798,32,32,0,0.00,0
,20180103,3798,3798,,,,3804,3804,6,6,0,0.00,0
,20180104,3804,3804,,,,3804,3804,0,0,0,0.00,0
,20180105,3804,3804,,,,3804,3804,0,0,0,0.00,0
,20180108,3804,3804,,,,3804,3804,0,0,0,0.00,0
,20180109,3804,3804,3831,3831,3733,3733,3782,-71,-22,4,15.13,0
,20180110,3733,3782,,,,3782,3782,0,0,0,0.00,0
,20180111,3782,3782,,,,3782,3782,0,0,0,0.00,0
,20180112,3782,3782,3706,3791,3706,3791,3748,9,-34,4,14.99,2
,20180115,3791,3748,,,,3748,3748,0,0,0,0.00,2
,20180116,3748,3748,,,,3748,3748,0,0,0,0.00,2
,20180117,3748,3748,,,,3748,3748,0,0,0,0.00,2
,20180118,3748,3748,,,,3748,3748,0,0,0,0.00,2
,20180119,3748,3748,,,,3755,3755,7,7,0,0.00,2
,20180122,3755,3755,,,,3803,3803,48,48,0,0.00,2
,20180123,3803,3803,,,,3803,3803,0,0,0,0.00,2
,20180124,3803,3803,,,,3817,3817,14,14,0,0.00,2
,20180125,3817,3817,,,,3818,3818,1,1,0,0.00,2
,20180126,3818,3818,,,,3813,3813,-5,-5,0,0.00,2
,20180129,3813,3813,,,,3811,3811,-2,-2,0,0.00,2
,20180130,3811,3811,,,,3767,3767,-44,-44,0,0.00,2
,20180131,3767,3767,,,,3761,3761,-6,-6,0,0.00,2
,20180201,3761,3761,,,,3797,3797,36,36,0,0.00,2
,20180202,3797,3797,,,,3886,3886,89,89,0,0.00,2
,20180205,3886,3886,,,,3908,3908,22,22,0,0.00,2
,20180206,3908,3908,,,,3908,3908,0,0,0,0.00,2
,20180207,3908,3908,,,,3908,3908,0,0,0,0.00,2
,20180208,3908,3908,,,,3878,3878,-30,-30,0,0.00,2
,20180209,3878,3878,,,,3878,3878,0,0,0,0.00,2
,20180212,3878,3878,,,,3878,3878,0,0,0,0.00,2
,20180213,3878,3878,,,,3878,3878,0,0,0,0.00,2
,20180214,3878,3878,,,,3878,3878,0,0,0,0.00,2
,20180222,3878,3878,,,,3878,3878,0,0,0,0.00,2
,20180223,3878,3878,,,,3878,3878,0,0,0,0.00,2
,20180226,3878,3878,,,,3992,3992,114,114,0,0.00,2
,20180227,3992,3992,,,,3992,3992,0,0,0,0.00,2
,20180228,3992,3992,,,,3992,3992,0,0,0,0.00,2
,20180301,3992,3992,,,,3992,3992,0,0,0,0.00,2
,20180302,3992,3992,,,,3992,3992,0,0,0,0.00,2
,20180305,3992,3992,3909,3909,3909,3909,3909,-83,-83,2,7.82,4
,20180306,3909,3909,,,,3912,3912,3,3,0,0.00,4
,20180307,3912,3912,,,,3912,3912,0,0,0,0.00,4
,20180308,3912,3912,,,,3912,3912,0,0,0,0.00,4
,20180309,3912,3912,3782,3782,3782,3782,3782,-130,-130,2,7.56,4
,20180312,3782,3782,,,,3782,3782,0,0,0,0.00,4
,20180313,3782,3782,,,,3782,3782,0,0,0,0.00,4
,20180314,3782,3782,3802,3804,3703,3731,3748,-51,-34,10,37.49,6
,20180315,3731,3748,,,,3751,3751,3,3,0,0.00,6
,20180316,3751,3751,,,,3751,3751,0,0,0,0.00,6
,20180319,3751,3751,3750,3788,3750,3788,3769,37,18,4,15.08,8
,20180320,3788,3769,,,,3769,3769,0,0,0,0.00,8
,20180321,3769,3769,,,,3734,3734,-35,-35,0,0.00,8
,20180322,3734,3734,3700,3700,3700,3700,3700,-34,-34,40,148.00,48
,20180323,3700,3700,3600,3640,3600,3605,3620,-95,-80,232,839.98,224
,20180326,3605,3620,3570,3580,3570,3580,3573,-40,-47,30,107.20,254
,20180327,3580,3573,3536,3656,3536,3610,3591,37,18,24,86.21,260
,20180328,3610,3591,,,,3591,3591,0,0,0,0.00,260
,20180329,3591,3591,,,,3592,3592,1,1,0,0.00,260
,20180330,3592,3592,,,,3592,3592,0,0,0,0.00,260
,20180402,3592,3592,3720,3725,3720,3725,3723,133,131,6,22.34,258
,20180403,3725,3723,3700,3700,3700,3700,3700,-23,-23,2,7.40,258
,20180404,3700,3700,3592,3650,3592,3650,3621,-50,-79,4,14.48,258
,20180409,3650,3621,3660,3752,3635,3752,3683,131,62,30,110.49,256
,20180410,3752,3683,3775,3775,3775,3775,3775,92,92,2,7.55,256
,20180411,3775,3775,3760,3760,3760,3760,3760,-15,-15,4,15.04,256
,20180412,3760,3760,3765,3775,3691,3775,3752,15,-8,10,37.52,256
,20180413,3775,3752,3780,3780,3741,3748,3753,-4,1,44,165.13,256
,20180416,3748,3753,3705,3843,3692,3780,3762,27,9,244,918.02,412
,20180417,3780,3762,3814,3825,3753,3800,3785,38,23,80,302.81,434
,20180418,3800,3785,3810,3822,3805,3805,3813,20,28,10,38.13,436
,20180419,3805,3813,3830,3854,3821,3844,3833,31,20,54,207.00,438
,20180420,3844,3833,3814,3876,3807,3808,3838,-25,5,90,345.49,432
,20180423,3808,3838,3903,3934,3903,3912,3913,74,75,38,148.73,434
,20180424,3912,3913,3978,3978,3936,3968,3961,55,48,56,221.86,442
,20180425,3968,3961,3988,3991,3916,3936,3946,-25,-15,136,536.77,450
,20180426,3936,3946,3930,3985,3923,3946,3944,0,-2,122,481.18,440
,20180427,3946,3944,3990,3990,3943,3971,3968,27,24,152,603.26,448
,20180502,3971,3968,3996,4067,3996,4065,4027,97,59,60,241.66,454
,20180503,4065,4027,4044,4087,4012,4015,4055,-12,28,100,405.59,444
,20180504,4015,4055,4007,4033,3989,4015,4004,-40,-51,50,200.21,450
,20180507,4015,4004,3982,4119,3975,4115,4060,111,56,240,974.42,428
,20180508,4115,4060,4100,4122,4084,4084,4102,24,42,98,402.01,440
,20180509,4084,4102,4051,4051,3965,3993,4023,-109,-79,154,619.58,450
,20180510,3993,4023,3967,4015,3967,3991,3990,-32,-33,32,127.68,442
,20180511,3991,3990,4027,4134,4001,4098,4079,108,89,264,"1,076.97",450
,20180514,4098,4079,4098,4133,4090,4125,4124,46,45,122,503.15,438
,20180515,4125,4124,4124,4146,4094,4131,4123,7,-1,58,239.15,444
,20180516,4131,4123,4108,4164,4097,4097,4127,-26,4,110,454.01,440
,20180517,4097,4127,4108,4149,4101,4144,4130,17,3,88,363.50,444
,20180518,4144,4130,4168,4170,4122,4129,4151,-1,21,74,307.18,438
,20180521,4129,4151,4105,4150,4105,4130,4130,-21,-21,84,346.95,438
,20180522,4130,4130,4142,4142,4106,4110,4120,-20,-10,22,90.65,438
,20180523,4110,4120,4106,4119,4065,4076,4093,-44,-27,70,286.56,440
,20180524,4076,4093,4052,4112,4052,4112,4079,19,-14,46,187.68,444
,20180525,4112,4079,4125,4175,4097,4124,4133,45,54,84,347.20,438
,20180528,4124,4133,4117,4149,4098,4119,4117,-14,-16,66,271.78,442
,20180529,4119,4117,4107,4201,4094,4161,4167,44,50,274,"1,141.99",440
,20180530,4161,4167,4153,4190,4133,4187,4164,20,-3,24,99.94,442
,20180531,4187,4164,4165,4213,4164,4209,4191,45,27,72,301.79,442
hc1808,20180102,3654,3654,,,,3685,3685,31,31,0,0.00,12
,20180103,3685,3685,,,,3690,3690,5,5,0,0.00,12
,20180104,3690,3690,,,,3665,3665,-25,-25,0,0.00,12
,20180105,3665,3665,,,,3617,3617,-48,-48,0,0.00,12
,20180108,3617,3617,,,,3570,3570,-47,-47,0,0.00,12
,20180109,3570,3570,3784,3784,3784,3784,3784,214,214,10,37.84,14
,20180110,3784,3784,,,,3786,3786,2,2,0,0.00,14
,20180111,3786,3786,,,,3799,3799,13,13,0,0.00,14
,20180112,3799,3799,3801,3801,3801,3801,3801,2,2,6,22.81,10
,20180115,3801,3801,,,,3801,3801,0,0,0,0.00,10
,20180116,3801,3801,,,,3801,3801,0,0,0,0.00,10
,20180117,3801,3801,,,,3801,3801,0,0,0,0.00,10
,20180118,3801,3801,,,,3813,3813,12,12,0,0.00,10
,20180119,3813,3813,,,,3820,3820,7,7,0,0.00,10
,20180122,3820,3820,,,,3869,3869,49,49,0,0.00,10
,20180123,3869,3869,,,,3869,3869,0,0,0,0.00,10
,20180124,3869,3869,,,,3910,3910,41,41,0,0.00,10
,20180125,3910,3910,3910,3910,3910,3910,3910,0,0,2,7.82,10
,20180126,3910,3910,,,,3910,3910,0,0,0,0.00,10
,20180129,3910,3910,,,,3910,3910,0,0,0,0.00,10
,20180130,3910,3910,,,,3910,3910,0,0,0,0.00,10
,20180131,3910,3910,,,,3910,3910,0,0,0,0.00,10
,20180201,3910,3910,,,,3910,3910,0,0,0,0.00,10
,20180202,3910,3910,,,,4002,4002,92,92,0,0.00,10
,20180205,4002,4002,,,,4002,4002,0,0,0,0.00,10
,20180206,4002,4002,,,,4002,4002,0,0,0,0.00,10
,20180207,4002,4002,,,,4002,4002,0,0,0,0.00,10
,20180208,4002,4002,,,,4002,4002,0,0,0,0.00,10
,20180209,4002,4002,4071,4071,3956,3961,3988,-41,-14,8,31.91,10
,20180212,3961,3988,,,,3988,3988,0,0,0,0.00,10
,20180213,3988,3988,,,,3988,3988,0,0,0,0.00,10
,20180214,3988,3988,,,,3988,3988,0,0,0,0.00,10
,20180222,3988,3988,,,,3988,3988,0,0,0,0.00,10
,20180223,3988,3988,,,,3988,3988,0,0,0,0.00,10
,20180226,3988,3988,,,,3988,3988,0,0,0,0.00,10
,20180227,3988,3988,,,,3988,3988,0,0,0,0.00,10
,20180228,3988,3988,,,,3988,3988,0,0,0,0.00,10
,20180301,3988,3988,,,,3988,3988,0,0,0,0.00,10
,20180302,3988,3988,,,,3988,3988,0,0,0,0.00,10
,20180305,3988,3988,,,,3988,3988,0,0,0,0.00,10
,20180306,3988,3988,,,,3988,3988,0,0,0,0.00,10
,20180307,3988,3988,,,,3988,3988,0,0,0,0.00,10
,20180308,3988,3988,,,,3988,3988,0,0,0,0.00,10
,20180309,3988,3988,,,,3855,3855,-133,-133,0,0.00,10
,20180312,3855,3855,,,,3855,3855,0,0,0,0.00,10
,20180313,3855,3855,3888,3888,3888,3888,3888,33,33,2,7.78,8
,20180314,3888,3888,,,,3888,3888,0,0,0,0.00,8
,20180315,3888,3888,,,,3888,3888,0,0,0,0.00,8
,20180316,3888,3888,,,,3888,3888,0,0,0,0.00,8
,20180319,3888,3888,,,,3888,3888,0,0,0,0.00,8
,20180320,3888,3888,,,,3886,3886,-2,-2,0,0.00,8
,20180321,3886,3886,,,,3850,3850,-36,-36,0,0.00,8
,20180322,3850,3850,,,,3832,3832,-18,-18,0,0.00,8
,20180323,3832,3832,,,,3602,3602,-230,-230,0,0.00,8
,20180326,3602,3602,,,,3602,3602,0,0,0,0.00,8
,20180327,3602,3602,3648,3648,3648,3648,3648,46,46,2,7.30,6
,20180328,3648,3648,,,,3670,3670,22,22,0,0.00,6
,20180329,3670,3670,,,,3657,3657,-13,-13,0,0.00,6
,20180330,3657,3657,,,,3657,3657,0,0,0,0.00,6
,20180402,3657,3657,,,,3657,3657,0,0,0,0.00,6
,20180403,3657,3657,,,,3657,3657,0,0,0,0.00,6
,20180404,3657,3657,,,,3657,3657,0,0,0,0.00,6
,20180409,3657,3657,,,,3657,3657,0,0,0,0.00,6
,20180410,3657,3657,,,,3748,3748,91,91,0,0.00,6
,20180411,3748,3748,,,,3748,3748,0,0,0,0.00,6
,20180412,3748,3748,,,,3748,3748,0,0,0,0.00,6
,20180413,3748,3748,,,,3748,3748,0,0,0,0.00,6
,20180416,3748,3748,,,,3748,3748,0,0,0,0.00,6
,20180417,3748,3748,,,,3748,3748,0,0,0,0.00,6
,20180418,3748,3748,,,,3748,3748,0,0,0,0.00,6
,20180419,3748,3748,,,,3767,3767,19,19,0,0.00,6
,20180420,3767,3767,,,,3767,3767,0,0,0,0.00,6
,20180423,3767,3767,,,,3841,3841,74,74,0,0.00,6
,20180424,3841,3841,,,,3841,3841,0,0,0,0.00,6
,20180425,3841,3841,,,,3841,3841,0,0,0,0.00,6
,20180426,3841,3841,,,,3841,3841,0,0,0,0.00,6
,20180427,3841,3841,,,,3841,3841,0,0,0,0.00,6
,20180502,3841,3841,,,,3898,3898,57,57,0,0.00,6
,20180503,3898,3898,,,,3898,3898,0,0,0,0.00,6
,20180504,3898,3898,3855,3945,3855,3905,3900,7,2,26,101.42,8
,20180507,3905,3900,3847,3916,3818,3904,3876,4,-24,46,178.33,24
,20180508,3904,3876,3825,3828,3824,3828,3825,-48,-51,18,68.86,36
,20180509,3828,3825,3777,3777,3700,3756,3756,-69,-69,40,150.26,52
,20180510,3756,3756,3742,3748,3742,3748,3744,-8,-12,6,22.46,56
,20180511,3748,3744,3786,3953,3786,3953,3886,209,142,84,326.43,48
,20180514,3953,3886,3932,3940,3931,3940,3932,54,46,30,117.97,26
,20180515,3940,3932,3868,3949,3868,3946,3905,14,-27,30,117.15,22
,20180516,3946,3905,3933,3933,3933,3933,3933,28,28,8,31.46,16
,20180517,3933,3933,,,,3933,3933,0,0,0,0.00,16
,20180518,3933,3933,,,,3933,3933,0,0,0,0.00,16
,20180521,3933,3933,,,,3933,3933,0,0,0,0.00,16
,20180522,3933,3933,,,,3933,3933,0,0,0,0.00,16
,20180523,3933,3933,,,,3907,3907,-26,-26,0,0.00,16
,20180524,3907,3907,,,,3894,3894,-13,-13,0,0.00,16
,20180525,3894,3894,,,,3894,3894,0,0,0,0.00,16
,20180528,3894,3894,3905,3963,3901,3963,3927,69,33,204,801.23,16
,20180529,3963,3927,,,,3975,3975,48,48,0,0.00,16
,20180530,3975,3975,3992,3992,3992,3992,3992,17,17,2,7.98,18
,20180531,3992,3992,3995,3995,3995,3995,3995,3,3,2,7.99,18
hc1809,20180102,3701,3701,3798,3821,3798,3821,3809,120,108,4,15.24,28
,20180103,3821,3809,,,,3809,3809,0,0,0,0.00,28
,20180104,3809,3809,3739,3739,3739,3739,3739,-70,-70,2,7.48,30
,20180105,3739,3739,3750,3750,3750,3750,3750,11,11,8,30.00,26
,20180108,3750,3750,3750,3780,3705,3780,3741,30,-9,22,82.31,26
,20180109,3780,3741,3715,3821,3715,3785,3787,44,46,36,136.36,42
,20180110,3785,3787,3826,3826,3826,3826,3826,39,39,2,7.65,42
,20180111,3826,3826,3814,3814,3814,3814,3814,-12,-12,2,7.63,40
,20180112,3814,3814,,,,3814,3814,0,0,0,0.00,40
,20180115,3814,3814,3757,3757,3757,3757,3757,-57,-57,2,7.51,40
,20180116,3757,3757,3823,3831,3765,3765,3798,8,41,14,53.17,44
,20180117,3765,3798,3820,3820,3820,3820,3820,22,22,2,7.64,44
,20180118,3820,3820,,,,3818,3818,-2,-2,0,0.00,44
,20180119,3818,3818,3822,3822,3719,3820,3757,2,-61,74,278.05,36
,20180122,3820,3757,3823,3859,3823,3852,3849,95,92,24,92.38,36
,20180123,3852,3849,3803,3843,3794,3815,3812,-34,-37,24,91.50,32
,20180124,3815,3812,3840,3866,3828,3866,3846,54,34,8,30.77,28
,20180125,3866,3846,3830,3961,3830,3866,3889,20,43,40,155.58,38
,20180126,3866,3889,3910,3910,3866,3866,3880,-23,-9,6,23.28,34
,20180129,3866,3880,,,,3880,3880,0,0,0,0.00,34
,20180130,3880,3880,3871,3871,3847,3863,3861,-17,-19,12,46.34,26
,20180131,3863,3861,,,,3861,3861,0,0,0,0.00,26
,20180201,3861,3861,3897,3898,3895,3898,3896,37,35,8,31.17,26
,20180202,3898,3896,3925,3925,3925,3925,3925,29,29,2,7.85,26
,20180205,3925,3925,,,,3925,3925,0,0,0,0.00,26
,20180206,3925,3925,,,,3925,3925,0,0,0,0.00,26
,20180207,3925,3925,,,,3925,3925,0,0,0,0.00,26
,20180208,3925,3925,3908,3918,3889,3918,3905,-7,-20,6,23.43,28
,20180209,3918,3905,3902,3902,3902,3902,3902,-3,-3,2,7.80,26
,20180212,3902,3902,3905,3905,3905,3905,3905,3,3,2,7.81,24
,20180213,3905,3905,,,,3905,3905,0,0,0,0.00,24
,20180214,3905,3905,3908,3908,3908,3908,3908,3,3,2,7.82,22
,20180222,3908,3908,3832,3849,3832,3849,3840,-59,-68,4,15.36,22
,20180223,3849,3840,3847,3860,3847,3860,3858,20,18,24,92.61,42
,20180226,3860,3858,3920,3990,3920,3990,3960,132,102,40,158.42,64
,20180227,3990,3960,3988,3997,3967,3997,3975,37,15,34,135.17,78
,20180228,3997,3975,3995,3997,3982,3982,3990,7,15,10,39.91,82
,20180301,3982,3990,3998,4106,3973,3973,4019,-17,29,16,64.31,78
,20180302,3973,4019,,,,4019,4019,0,0,0,0.00,78
,20180305,4019,4019,3974,3975,3970,3975,3973,-44,-46,6,23.84,72
,20180306,3975,3973,3941,3962,3941,3962,3948,-11,-25,10,39.48,70
,20180307,3962,3948,3951,3953,3912,3912,3929,-36,-19,16,62.87,66
,20180308,3912,3929,3849,3894,3846,3846,3873,-83,-56,26,100.72,72
,20180309,3846,3873,3760,3826,3745,3756,3787,-117,-86,126,477.26,74
,20180312,3756,3787,3761,3773,3737,3772,3754,-15,-33,26,97.63,74
,20180313,3772,3754,3764,3861,3675,3720,3766,-34,12,52,195.86,74
,20180314,3720,3766,3729,3759,3704,3750,3731,-16,-35,110,410.48,92
,20180315,3750,3731,3747,3797,3747,3754,3767,23,36,106,399.33,140
,20180316,3754,3767,3742,3785,3717,3761,3749,-6,-18,278,"1,042.37",192
,20180319,3761,3749,3755,3824,3686,3692,3734,-57,-15,242,903.69,168
,20180320,3692,3734,3715,3762,3604,3705,3707,-29,-27,384,"1,423.57",180
,20180321,3705,3707,3704,3722,3604,3605,3640,-102,-67,332,"1,208.77",248
,20180322,3605,3640,3617,3663,3587,3647,3624,7,-16,586,"2,123.81",372
,20180323,3647,3624,3631,3637,3431,3500,3507,-124,-117,568,"1,992.22",752
,20180326,3500,3507,3518,3518,3405,3440,3473,-67,-34,196,680.72,682
,20180327,3440,3473,3454,3520,3439,3479,3497,6,24,124,433.65,666
,20180328,3479,3497,3520,3564,3477,3493,3509,-4,12,250,877.47,642
,20180329,3493,3509,3501,3542,3480,3542,3506,33,-3,110,385.73,654
,20180330,3542,3506,3526,3625,3496,3609,3538,103,32,410,"1,450.96",642
,20180402,3609,3538,3609,3648,3555,3558,3584,20,46,308,"1,103.96",626
,20180403,3558,3584,3573,3615,3525,3545,3568,-39,-16,324,"1,156.31",646
,20180404,3545,3568,3574,3606,3491,3530,3567,-38,-1,934,"3,332.01",660
,20180409,3530,3567,3594,3635,3517,3635,3576,68,9,314,"1,122.88",662
,20180410,3635,3576,3641,3656,3603,3624,3625,48,49,630,"2,283.91",660
,20180411,3624,3625,3630,3655,3575,3585,3607,-40,-18,560,"2,020.04",666
,20180412,3585,3607,3596,3641,3534,3641,3591,34,-16,412,"1,479.66",724
,20180413,3641,3591,3661,3667,3598,3650,3630,59,39,666,"2,418.09",652
,20180416,3650,3630,3651,3700,3578,3584,3637,-46,7,508,"1,847.82",764
,20180417,3584,3637,3566,3667,3564,3630,3613,-7,-24,352,"1,272.07",778
,20180418,3630,3613,3663,3737,3649,3695,3698,82,85,672,"2,485.20",840
,20180419,3695,3698,3733,3746,3699,3732,3723,34,25,456,"1,697.93",720
,20180420,3732,3723,3778,3778,3689,3700,3716,-23,-7,228,847.26,716
,20180423,3700,3716,3714,3802,3714,3784,3748,68,32,476,"1,784.39",750
,20180424,3784,3748,3789,3839,3788,3790,3801,42,53,538,"2,045.27",748
,20180425,3790,3801,3801,3818,3770,3789,3794,-12,-7,660,"2,504.41",688
,20180426,3789,3794,3786,3833,3747,3779,3779,-15,-15,498,"1,882.02",652
,20180427,3779,3779,3788,3820,3770,3811,3799,32,20,204,775.13,668
,20180502,3811,3799,3860,3916,3853,3916,3880,117,81,138,535.44,664
,20180503,3916,3880,3918,3918,3838,3846,3872,-34,-8,230,890.60,664
,20180504,3846,3872,3842,3875,3839,3862,3853,-10,-19,114,439.32,684
,20180507,3862,3853,3837,3881,3825,3857,3851,4,-2,298,"1,147.87",678
,20180508,3857,3851,3852,3865,3834,3861,3854,10,3,42,161.87,676
,20180509,3861,3854,3855,3855,3671,3700,3713,-154,-141,5980,"22,208.78",3304
,20180510,3700,3713,3715,3748,3691,3741,3718,28,5,12550,"46,670.43",14698
,20180511,3741,3718,3765,3799,3742,3792,3773,74,55,10998,"41,496.68",24050
,20180514,3792,3773,3804,3814,3799,3812,3807,39,34,3380,"12,870.51",24998
,20180515,3812,3807,3813,3834,3803,3825,3822,18,15,15466,"59,116.32",32252
,20180516,3825,3822,3819,3860,3818,3840,3840,18,18,21374,"82,095.39",34544
,20180517,3840,3840,3840,3873,3828,3870,3853,30,13,15104,"58,207.45",45528
,20180518,3870,3853,3870,3885,3844,3845,3864,-8,11,15756,"60,883.32",40424
,20180521,3845,3864,3843,3881,3815,3815,3837,-49,-27,18666,"71,622.17",30138
,20180522,3815,3837,3825,3835,3815,3816,3824,-21,-13,6986,"26,720.19",31022
,20180523,3816,3824,3818,3821,3732,3770,3792,-54,-32,13730,"52,076.57",23520
,20180524,3770,3792,3769,3823,3768,3819,3800,27,8,8260,"31,392.50",28440
,20180525,3819,3800,3842,3883,3816,3830,3835,30,35,24394,"93,560.38",31798
,20180528,3830,3835,3825,3870,3816,3839,3845,4,10,33718,"129,645.79",37590
,20180529,3839,3845,3844,3902,3834,3888,3870,43,25,33046,"127,894.16",54818
,20180530,3888,3870,3895,3927,3880,3905,3902,35,32,32220,"125,731.16",61570
,20180531,3905,3902,3910,3953,3895,3930,3924,28,22,28148,"110,462.98",70454
hc1810,20180102,3681,3699,3690,3765,3681,3741,3727,42,28,22786,"84,938.71",52124
,20180103,3741,3727,3750,3750,3696,3701,3720,-26,-7,19228,"71,544.09",52164
,20180104,3701,3720,3705,3731,3694,3715,3710,-5,-10,26918,"99,879.38",53096
,20180105,3715,3710,3710,3719,3662,3696,3689,-14,-21,31554,"116,422.95",54826
,20180108,3696,3689,3695,3710,3648,3710,3674,21,-15,28022,"102,976.88",54788
,20180109,3710,3674,3720,3736,3705,3717,3719,43,45,24932,"92,729.48",53224
,20180110,3717,3719,3724,3760,3700,3737,3733,18,14,27256,"101,770.54",50626
,20180111,3737,3733,3745,3759,3724,3737,3742,4,9,18562,"69,474.30",48954
,20180112,3737,3742,3740,3750,3698,3705,3717,-37,-25,22604,"84,025.10",50060
,20180115,3705,3717,3705,3736,3670,3722,3710,5,-7,27154,"100,759.63",51538
,20180116,3722,3710,3720,3749,3706,3711,3726,1,16,27300,"101,738.30",49656
,20180117,3711,3726,3712,3750,3698,3714,3718,-12,-8,29716,"110,508.51",52052
,20180118,3714,3718,3718,3739,3682,3727,3725,9,7,18114,"67,485.32",52468
,20180119,3727,3725,3728,3798,3705,3797,3739,72,14,37540,"140,398.08",52542
,20180122,3797,3739,3800,3831,3778,3791,3799,52,60,31670,"120,316.06",53380
,20180123,3791,3799,3795,3812,3768,3796,3789,-3,-10,23220,"87,994.03",52384
,20180124,3796,3789,3788,3842,3782,3831,3812,42,23,19650,"74,910.46",54046
,20180125,3831,3812,3831,3884,3813,3855,3857,43,45,35494,"136,917.78",55240
,20180126,3855,3857,3863,3867,3825,3844,3847,-13,-10,17804,"68,498.19",55930
,20180129,3844,3847,3846,3857,3826,3846,3845,-1,-2,10456,"40,209.86",56888
,20180130,3846,3845,3846,3870,3809,3826,3826,-19,-19,17594,"67,327.95",59154
,20180131,3826,3826,3826,3874,3792,3813,3818,-13,-8,20242,"77,296.74",58954
,20180201,3813,3818,3827,3854,3810,3826,3830,8,12,32772,"125,545.94",62102
,20180202,3826,3830,3829,3886,3814,3872,3864,42,34,29210,"112,870.55",62536
,20180205,3872,3864,3872,3890,3844,3885,3870,21,6,18152,"70,248.34",62924
,20180206,3885,3870,3894,3896,3853,3868,3873,-2,3,20440,"79,174.20",62656
,20180207,3868,3873,3868,3880,3837,3869,3858,-4,-15,21734,"83,853.29",57414
,20180208,3869,3858,3865,3901,3854,3894,3881,36,23,21942,"85,174.45",57754
,20180209,3894,3881,3893,3904,3820,3831,3859,-50,-22,27474,"106,042.71",60922
,20180212,3831,3859,3830,3860,3818,3842,3836,-17,-23,15966,"61,246.18",60352
,20180213,3842,3836,3822,3877,3822,3857,3857,21,21,12076,"46,582.34",58722
,20180214,3857,3857,3857,3873,3848,3858,3859,1,2,8582,"33,118.38",58728
,20180222,3858,3859,3867,3876,3798,3813,3827,-46,-32,29840,"114,211.71",67594
,20180223,3813,3827,3801,3883,3796,3877,3834,50,7,48808,"187,149.96",77390
,20180226,3877,3834,3871,3965,3871,3965,3932,131,98,43836,"172,383.04",78070
,20180227,3965,3932,3961,3968,3927,3957,3946,25,14,27942,"110,262.40",75372
,20180228,3957,3946,3955,3963,3938,3949,3950,3,4,25734,"101,666.40",76048
,20180301,3949,3950,3950,3976,3938,3952,3954,2,4,22286,"88,133.54",77736
,20180302,3952,3954,3945,3974,3920,3974,3940,20,-14,32162,"126,748.75",81646
,20180305,3974,3940,3970,3971,3903,3906,3932,-34,-8,34878,"137,144.70",85176
,20180306,3906,3932,3905,3926,3880,3916,3906,-16,-26,29888,"116,751.56",85564
,20180307,3916,3906,3910,3926,3844,3851,3889,-55,-17,54956,"213,743.48",98244
,20180308,3851,3889,3850,3871,3800,3801,3834,-88,-55,80208,"307,555.60",128212
,20180309,3801,3834,3790,3800,3674,3704,3741,-130,-93,105998,"396,561.39",125988
,20180312,3704,3741,3725,3742,3681,3699,3713,-42,-28,84280,"312,941.69",124868
,20180313,3699,3713,3704,3726,3664,3673,3694,-40,-19,65672,"242,597.08",128228
,20180314,3673,3694,3680,3724,3645,3703,3682,9,-12,77778,"286,452.69",128040
,20180315,3703,3682,3711,3727,3682,3702,3704,20,22,53464,"198,035.55",129802
,20180316,3702,3704,3700,3726,3676,3705,3705,1,1,84936,"314,697.94",134602
,20180319,3705,3705,3705,3724,3620,3640,3660,-65,-45,109322,"400,136.30",143812
,20180320,3640,3660,3621,3660,3582,3619,3623,-41,-37,136722,"495,405.39",163540
,20180321,3619,3623,3613,3644,3544,3549,3588,-74,-35,140650,"504,664.93",177406
,20180322,3549,3588,3548,3580,3534,3560,3558,-28,-30,122196,"434,821.23",193626
,20180323,3560,3558,3550,3550,3344,3378,3421,-180,-137,291924,"998,771.21",227766
,20180326,3378,3421,3373,3393,3302,3316,3344,-105,-77,193466,"647,076.50",224656
,20180327,3316,3344,3320,3401,3308,3363,3352,19,8,182778,"612,679.07",229388
,20180328,3363,3352,3372,3415,3325,3354,3373,2,21,229986,"775,751.36",228548
,20180329,3354,3373,3355,3413,3331,3402,3377,29,4,198736,"671,234.74",242236
,20180330,3402,3377,3408,3513,3388,3512,3438,135,61,235666,"810,344.31",233832
,20180402,3512,3438,3510,3571,3459,3464,3492,26,54,273880,"956,507.07",244208
,20180403,3464,3492,3464,3507,3411,3451,3455,-41,-37,376380,"1,300,762.17",265094
,20180404,3451,3455,3453,3484,3410,3422,3438,-33,-17,302886,"1,041,433.69",283418
,20180409,3422,3438,3419,3522,3402,3516,3457,78,19,370708,"1,281,664.28",309232
,20180410,3516,3457,3516,3552,3496,3531,3525,74,68,486370,"1,714,506.25",349334
,20180411,3531,3525,3540,3554,3466,3479,3506,-46,-19,637208,"2,234,422.76",384214
,20180412,3479,3506,3482,3529,3460,3510,3493,4,-13,643152,"2,246,806.05",391608
,20180413,3510,3493,3500,3562,3474,3549,3517,56,24,651604,"2,292,301.50",383426
,20180416,3549,3517,3545,3566,3445,3459,3496,-58,-21,634646,"2,218,801.92",411206
,20180417,3459,3496,3464,3548,3452,3501,3503,5,7,672808,"2,356,949.90",379558
,20180418,3501,3503,3537,3617,3508,3577,3571,74,68,787262,"2,811,517.96",393528
,20180419,3577,3571,3597,3642,3580,3620,3609,49,38,712366,"2,571,362.84",413516
,20180420,3620,3609,3610,3624,3573,3587,3599,-22,-10,573568,"2,064,378.81",438072
,20180423,3587,3599,3590,3690,3589,3680,3647,81,48,670638,"2,445,974.53",473292
,20180424,3680,3647,3660,3708,3660,3675,3690,28,43,620398,"2,289,841.55",498744
,20180425,3675,3690,3684,3702,3651,3677,3681,-13,-9,531674,"1,957,241.11",493602
,20180426,3677,3681,3690,3720,3642,3671,3673,-10,-8,580340,"2,132,156.96",505724
,20180427,3671,3673,3670,3708,3657,3698,3683,25,10,543238,"2,001,136.01",488148
,20180502,3698,3683,3720,3806,3720,3801,3771,118,88,526902,"1,987,108.67",538450
,20180503,3801,3771,3804,3807,3724,3737,3763,-34,-8,592808,"2,231,125.58",582002
,20180504,3737,3763,3737,3755,3714,3737,3735,-26,-28,456226,"1,704,006.94",582832
,20180507,3737,3735,3730,3775,3707,3745,3741,10,6,631480,"2,362,516.95",582694
,20180508,3745,3741,3748,3764,3726,3734,3744,-7,3,387408,"1,450,787.79",576402
,20180509,3734,3744,3726,3730,3666,3676,3688,-68,-56,610728,"2,252,873.07",593554
,20180510,3676,3688,3677,3718,3669,3716,3691,28,3,575626,"2,125,098.91",566482
,20180511,3716,3691,3722,3783,3721,3767,3751,76,60,549740,"2,062,614.71",566942
,20180514,3767,3751,3777,3786,3746,3769,3769,18,18,398148,"1,500,925.06",533572
,20180515,3769,3769,3775,3818,3745,3796,3782,27,13,710368,"2,686,950.84",525202
,20180516,3796,3782,3791,3850,3776,3810,3806,28,24,735530,"2,799,931.28",543926
,20180517,3810,3806,3812,3854,3792,3847,3827,41,21,599150,"2,293,348.00",604402
,20180518,3847,3827,3857,3870,3791,3800,3825,-27,-2,642132,"2,456,353.65",573010
,20180521,3800,3825,3802,3836,3743,3755,3787,-70,-38,704958,"2,670,094.83",575384
,20180522,3755,3787,3760,3796,3744,3762,3767,-25,-20,517336,"1,949,111.89",586312
,20180523,3762,3767,3760,3764,3679,3709,3714,-58,-53,642166,"2,385,619.91",590928
,20180524,3709,3714,3701,3773,3695,3773,3730,59,16,584654,"2,181,140.52",631642
,20180525,3773,3730,3788,3829,3743,3764,3795,34,65,899730,"3,414,885.05",632698
,20180528,3764,3795,3752,3830,3749,3786,3791,-9,-4,684758,"2,596,439.99",647122
,20180529,3786,3791,3786,3870,3776,3851,3823,60,32,719956,"2,753,060.89",702714
,20180530,3851,3823,3852,3893,3832,3867,3865,44,42,686646,"2,654,353.07",742064
,20180531,3867,3865,3861,3920,3851,3901,3885,36,20,632192,"2,456,690.42",748874
hc1811,20180102,3671,3671,,,,3671,3671,0,0,0,0.00,6
,20180103,3671,3671,,,,3671,3671,0,0,0,0.00,6
,20180104,3671,3671,,,,3671,3671,0,0,0,0.00,6
,20180105,3671,3671,,,,3671,3671,0,0,0,0.00,6
,20180108,3671,3671,,,,3656,3656,-15,-15,0,0.00,6
,20180109,3656,3656,,,,3656,3656,0,0,0,0.00,6
,20180110,3656,3656,,,,3656,3656,0,0,0,0.00,6
,20180111,3656,3656,,,,3656,3656,0,0,0,0.00,6
,20180112,3656,3656,,,,3656,3656,0,0,0,0.00,6
,20180115,3656,3656,,,,3656,3656,0,0,0,0.00,6
,20180116,3656,3656,,,,3672,3672,16,16,0,0.00,6
,20180117,3672,3672,,,,3664,3664,-8,-8,0,0.00,6
,20180118,3664,3664,,,,3671,3671,7,7,0,0.00,6
,20180119,3671,3671,,,,3685,3685,14,14,0,0.00,6
,20180122,3685,3685,,,,3744,3744,59,59,0,0.00,6
,20180123,3744,3744,,,,3734,3734,-10,-10,0,0.00,6
,20180124,3734,3734,,,,3756,3756,22,22,0,0.00,6
,20180125,3756,3756,,,,3756,3756,0,0,0,0.00,6
,20180126,3756,3756,,,,3756,3756,0,0,0,0.00,6
,20180129,3756,3756,,,,3754,3754,-2,-2,0,0.00,6
,20180130,3754,3754,,,,3736,3736,-18,-18,0,0.00,6
,20180131,3736,3736,,,,3728,3728,-8,-8,0,0.00,6
,20180201,3728,3728,,,,3728,3728,0,0,0,0.00,6
,20180202,3728,3728,,,,3761,3761,33,33,0,0.00,6
,20180205,3761,3761,,,,3761,3761,0,0,0,0.00,6
,20180206,3761,3761,,,,3764,3764,3,3,0,0.00,6
,20180207,3764,3764,,,,3764,3764,0,0,0,0.00,6
,20180208,3764,3764,,,,3764,3764,0,0,0,0.00,6
,20180209,3764,3764,,,,3764,3764,0,0,0,0.00,6
,20180212,3764,3764,,,,3741,3741,-23,-23,0,0.00,6
,20180213,3741,3741,,,,3741,3741,0,0,0,0.00,6
,20180214,3741,3741,,,,3742,3742,1,1,0,0.00,6
,20180222,3742,3742,,,,3742,3742,0,0,0,0.00,6
,20180223,3742,3742,,,,3749,3749,7,7,0,0.00,6
,20180226,3749,3749,,,,3845,3845,96,96,0,0.00,6
,20180227,3845,3845,,,,3858,3858,13,13,0,0.00,6
,20180228,3858,3858,,,,3862,3862,4,4,0,0.00,6
,20180301,3862,3862,,,,3862,3862,0,0,0,0.00,6
,20180302,3862,3862,,,,3862,3862,0,0,0,0.00,6
,20180305,3862,3862,3934,3963,3914,3914,3937,52,75,6,23.62,10
,20180306,3914,3937,,,,3911,3911,-26,-26,0,0.00,10
,20180307,3911,3911,,,,3868,3868,-43,-43,0,0.00,10
,20180308,3868,3868,3840,3840,3781,3814,3828,-54,-40,32,122.51,30
,20180309,3814,3828,,,,3828,3828,0,0,0,0.00,30
,20180312,3828,3828,,,,3799,3799,-29,-29,0,0.00,30
,20180313,3799,3799,,,,3799,3799,0,0,0,0.00,30
,20180314,3799,3799,3664,3691,3627,3691,3660,-108,-139,12,43.93,22
,20180315,3691,3660,,,,3665,3665,5,5,0,0.00,22
,20180316,3665,3665,,,,3667,3667,2,2,0,0.00,22
,20180319,3667,3667,,,,3667,3667,0,0,0,0.00,22
,20180320,3667,3667,,,,3667,3667,0,0,0,0.00,22
,20180321,3667,3667,,,,3610,3610,-57,-57,0,0.00,22
,20180322,3610,3610,3521,3580,3521,3580,3563,-30,-47,142,506.04,156
,20180323,3580,3563,3431,3490,3430,3482,3463,-81,-100,902,"3,124.22",886
,20180326,3482,3463,3462,3495,3410,3455,3438,-8,-25,296,"1,017.93",1168
,20180327,3455,3438,3449,3450,3449,3450,3449,12,11,4,13.80,1172
,20180328,3450,3449,3471,3471,3471,3471,3471,22,22,2,6.94,1174
,20180329,3471,3471,3478,3478,3417,3458,3443,-13,-28,224,771.29,1176
,20180330,3458,3443,,,,3511,3511,68,68,0,0.00,1176
,20180402,3511,3511,3537,3557,3501,3501,3530,-10,19,42,148.28,1178
,20180403,3501,3530,,,,3530,3530,0,0,0,0.00,1178
,20180404,3530,3530,3468,3468,3468,3468,3468,-62,-62,2,6.94,1178
,20180409,3468,3468,,,,3480,3480,12,12,0,0.00,1178
,20180410,3480,3480,,,,3521,3521,41,41,0,0.00,1178
,20180411,3521,3521,,,,3521,3521,0,0,0,0.00,1178
,20180412,3521,3521,3567,3567,3501,3549,3539,28,18,6,21.23,1178
,20180413,3549,3539,,,,3540,3540,1,1,0,0.00,1178
,20180416,3540,3540,3572,3572,3531,3531,3551,-9,11,4,14.21,1178
,20180417,3531,3551,,,,3551,3551,0,0,0,0.00,1178
,20180418,3551,3551,,,,3573,3573,22,22,0,0.00,1178
,20180419,3573,3573,,,,3633,3633,60,60,0,0.00,1178
,20180420,3633,3633,3648,3648,3648,3648,3648,15,15,2,7.30,1176
,20180423,3648,3648,,,,3687,3687,39,39,0,0.00,1176
,20180424,3687,3687,3762,3762,3681,3701,3731,14,44,228,850.72,1188
,20180425,3701,3731,3703,3703,3663,3682,3687,-49,-44,54,199.13,1186
,20180426,3682,3687,3701,3701,3681,3686,3689,-1,2,14,51.65,1182
,20180427,3686,3689,3672,3673,3672,3673,3672,-16,-17,8,29.38,1178
,20180502,3673,3672,,,,3760,3760,88,88,0,0.00,1178
,20180503,3760,3760,,,,3760,3760,0,0,0,0.00,1178
,20180504,3760,3760,,,,3760,3760,0,0,0,0.00,1178
,20180507,3760,3760,3756,3756,3756,3756,3756,-4,-4,2,7.51,1178
,20180508,3756,3756,3743,3743,3743,3743,3743,-13,-13,4,14.97,1178
,20180509,3743,3743,3729,3729,3675,3676,3688,-67,-55,158,582.76,1222
,20180510,3676,3688,3695,3719,3671,3705,3693,17,5,432,"1,595.72",1182
,20180511,3705,3693,3715,3769,3715,3761,3751,68,58,136,510.26,1184
,20180514,3761,3751,3761,3771,3760,3771,3764,20,13,52,195.75,1164
,20180515,3771,3764,3787,3794,3756,3760,3784,-4,20,32,121.09,1174
,20180516,3760,3784,3780,3839,3758,3805,3798,21,14,394,"1,496.77",1166
,20180517,3805,3798,3805,3840,3788,3840,3796,42,-2,316,"1,199.58",1158
,20180518,3840,3796,3822,3822,3821,3821,3821,25,25,4,15.29,1158
,20180521,3821,3821,3786,3798,3771,3783,3787,-38,-34,14,53.02,1158
,20180522,3783,3787,3754,3779,3747,3755,3761,-32,-26,28,105.33,1162
,20180523,3755,3761,3721,3721,3671,3689,3701,-72,-60,32,118.45,1164
,20180524,3689,3701,3695,3696,3687,3696,3691,-5,-10,10,36.91,1164
,20180525,3696,3691,3811,3811,3781,3781,3802,90,111,34,129.30,1158
,20180528,3781,3802,3774,3775,3766,3775,3769,-27,-33,10,37.70,1158
,20180529,3775,3769,3769,3769,3769,3769,3769,0,0,2,7.54,1156
,20180530,3769,3769,3834,3860,3834,3860,3847,91,78,4,15.39,1158
,20180531,3860,3847,3836,3866,3836,3847,3849,0,2,12,46.19,1160
hc1812,20180102,3691,3691,,,,3691,3691,0,0,0,0.00,0
,20180103,3691,3691,,,,3691,3691,0,0,0,0.00,0
,20180104,3691,3691,,,,3691,3691,0,0,0,0.00,0
,20180105,3691,3691,,,,3691,3691,0,0,0,0.00,0
,20180108,3691,3691,,,,3691,3691,0,0,0,0.00,0
,20180109,3691,3691,,,,3691,3691,0,0,0,0.00,0
,20180110,3691,3691,,,,3691,3691,0,0,0,0.00,0
,20180111,3691,3691,,,,3691,3691,0,0,0,0.00,0
,20180112,3691,3691,,,,3691,3691,0,0,0,0.00,0
,20180115,3691,3691,,,,3691,3691,0,0,0,0.00,0
,20180116,3691,3691,,,,3691,3691,0,0,0,0.00,0
,20180117,3691,3691,,,,3691,3691,0,0,0,0.00,0
,20180118,3691,3691,,,,3691,3691,0,0,0,0.00,0
,20180119,3691,3691,,,,3691,3691,0,0,0,0.00,0
,20180122,3691,3691,,,,3691,3691,0,0,0,0.00,0
,20180123,3691,3691,,,,3691,3691,0,0,0,0.00,0
,20180124,3691,3691,,,,3700,3700,9,9,0,0.00,0
,20180125,3700,3700,,,,3732,3732,32,32,0,0.00,0
,20180126,3732,3732,,,,3732,3732,0,0,0,0.00,0
,20180129,3732,3732,,,,3733,3733,1,1,0,0.00,0
,20180130,3733,3733,,,,3733,3733,0,0,0,0.00,0
,20180131,3733,3733,,,,3733,3733,0,0,0,0.00,0
,20180201,3733,3733,,,,3733,3733,0,0,0,0.00,0
,20180202,3733,3733,,,,3733,3733,0,0,0,0.00,0
,20180205,3733,3733,,,,3763,3763,30,30,0,0.00,0
,20180206,3763,3763,,,,3763,3763,0,0,0,0.00,0
,20180207,3763,3763,,,,3763,3763,0,0,0,0.00,0
,20180208,3763,3763,,,,3782,3782,19,19,0,0.00,0
,20180209,3782,3782,,,,3782,3782,0,0,0,0.00,0
,20180212,3782,3782,,,,3782,3782,0,0,0,0.00,0
,20180213,3782,3782,,,,3782,3782,0,0,0,0.00,0
,20180214,3782,3782,,,,3782,3782,0,0,0,0.00,0
,20180222,3782,3782,,,,3782,3782,0,0,0,0.00,0
,20180223,3782,3782,,,,3782,3782,0,0,0,0.00,0
,20180226,3782,3782,,,,3841,3841,59,59,0,0.00,0
,20180227,3841,3841,,,,3851,3851,10,10,0,0.00,0
,20180228,3851,3851,,,,3851,3851,0,0,0,0.00,0
,20180301,3851,3851,,,,3851,3851,0,0,0,0.00,0
,20180302,3851,3851,,,,3853,3853,2,2,0,0.00,0
,20180305,3853,3853,,,,3853,3853,0,0,0,0.00,0
,20180306,3853,3853,,,,3853,3853,0,0,0,0.00,0
,20180307,3853,3853,,,,3853,3853,0,0,0,0.00,0
,20180308,3853,3853,,,,3853,3853,0,0,0,0.00,0
,20180309,3853,3853,,,,3853,3853,0,0,0,0.00,0
,20180312,3853,3853,,,,3853,3853,0,0,0,0.00,0
,20180313,3853,3853,,,,3853,3853,0,0,0,0.00,0
,20180314,3853,3853,,,,3853,3853,0,0,0,0.00,0
,20180315,3853,3853,,,,3759,3759,-94,-94,0,0.00,0
,20180316,3759,3759,,,,3759,3759,0,0,0,0.00,0
,20180319,3759,3759,,,,3708,3708,-51,-51,0,0.00,0
,20180320,3708,3708,3562,3688,3549,3639,3609,-69,-99,8,28.88,0
,20180321,3639,3609,,,,3574,3574,-35,-35,0,0.00,0
,20180322,3574,3574,3574,3574,3560,3565,3563,-9,-11,160,570.08,160
,20180323,3565,3563,3450,3479,3440,3440,3453,-123,-110,540,"1,864.72",700
,20180326,3440,3453,3432,3464,3405,3453,3433,0,-20,202,693.50,880
,20180327,3453,3433,3405,3405,3405,3405,3405,-28,-28,2,6.81,880
,20180328,3405,3405,3450,3453,3374,3374,3412,-31,7,8,27.30,882
,20180329,3374,3412,3443,3444,3427,3429,3437,17,25,20,68.74,882
,20180330,3429,3437,3451,3453,3448,3453,3450,16,13,6,20.70,882
,20180402,3453,3450,,,,3450,3450,0,0,0,0.00,882
,20180403,3450,3450,,,,3450,3450,0,0,0,0.00,882
,20180404,3450,3450,3431,3431,3431,3431,3431,-19,-19,2,6.86,882
,20180409,3431,3431,,,,3450,3450,19,19,0,0.00,882
,20180410,3450,3450,3545,3554,3545,3554,3551,104,101,8,28.41,880
,20180411,3554,3551,,,,3551,3551,0,0,0,0.00,880
,20180412,3551,3551,,,,3551,3551,0,0,0,0.00,880
,20180413,3551,3551,,,,3551,3551,0,0,0,0.00,880
,20180416,3551,3551,,,,3520,3520,-31,-31,0,0.00,880
,20180417,3520,3520,3548,3548,3548,3548,3548,28,28,2,7.10,880
,20180418,3548,3548,3586,3586,3586,3586,3586,38,38,2,7.17,880
,20180419,3586,3586,,,,3624,3624,38,38,0,0.00,880
,20180420,3624,3624,,,,3624,3624,0,0,0,0.00,880
,20180423,3624,3624,,,,3672,3672,48,48,0,0.00,880
,20180424,3672,3672,,,,3716,3716,44,44,0,0.00,880
,20180425,3716,3716,3660,3690,3660,3685,3680,-31,-36,14,51.53,882
,20180426,3685,3680,3690,3707,3680,3680,3693,0,13,42,155.14,902
,20180427,3680,3693,3717,3719,3691,3719,3712,26,19,32,118.80,920
,20180502,3719,3712,3774,3774,3774,3774,3774,62,62,40,150.96,916
,20180503,3774,3774,3811,3811,3754,3754,3791,-20,17,24,90.98,896
,20180504,3754,3791,3753,3753,3753,3753,3753,-38,-38,4,15.01,892
,20180507,3753,3753,3726,3759,3726,3759,3745,6,-8,12,44.95,880
,20180508,3759,3745,,,,3745,3745,0,0,0,0.00,880
,20180509,3745,3745,,,,3745,3745,0,0,0,0.00,880
,20180510,3745,3745,3685,3688,3685,3688,3686,-57,-59,4,14.75,880
,20180511,3688,3686,,,,3744,3744,58,58,0,0.00,880
,20180514,3744,3744,,,,3757,3757,13,13,0,0.00,880
,20180515,3757,3757,,,,3777,3777,20,20,0,0.00,880
,20180516,3777,3777,3776,3776,3776,3776,3776,-1,-1,2,7.55,880
,20180517,3776,3776,,,,3774,3774,-2,-2,0,0.00,880
,20180518,3774,3774,,,,3774,3774,0,0,0,0.00,880
,20180521,3774,3774,3825,3825,3762,3762,3800,-12,26,16,60.81,890
,20180522,3762,3800,,,,3800,3800,0,0,0,0.00,890
,20180523,3800,3800,3739,3739,3739,3739,3739,-61,-61,2,7.48,890
,20180524,3739,3739,3725,3767,3725,3767,3753,28,14,6,22.52,890
,20180525,3767,3753,3818,3818,3748,3749,3772,-4,19,24,90.53,890
,20180528,3749,3772,3752,3752,3752,3752,3752,-20,-20,2,7.50,888
,20180529,3752,3752,,,,3752,3752,0,0,0,0.00,888
,20180530,3752,3752,,,,3829,3829,77,77,0,0.00,888
,20180531,3829,3829,3786,3838,3786,3838,3822,9,-7,14,53.52,880
hc1901,20180116,3691,3691,3709,3709,3638,3646,3668,-45,-23,1706,"6,258.73",1388
,20180117,3646,3668,3628,3665,3628,3658,3651,-10,-17,614,"2,241.77",1550
,20180118,3658,3651,3657,3665,3640,3655,3655,4,4,712,"2,602.78",1496
,20180119,3655,3655,3662,3684,3601,3677,3639,22,-16,4266,"15,525.45",3244
,20180122,3677,3639,3678,3750,3673,3690,3691,51,52,1312,"4,843.66",3104
,20180123,3690,3691,3681,3721,3677,3714,3696,23,5,974,"3,600.72",3538
,20180124,3714,3696,3706,3745,3706,3738,3719,42,23,1126,"4,188.40",3850
,20180125,3738,3719,3732,3788,3720,3762,3759,43,40,1004,"3,775.04",4064
,20180126,3762,3759,3767,3773,3731,3755,3751,-4,-8,468,"1,755.73",4232
,20180129,3755,3751,3755,3760,3740,3755,3753,4,2,282,"1,058.54",4224
,20180130,3755,3753,3740,3753,3717,3735,3733,-18,-20,774,"2,889.45",4572
,20180131,3735,3733,3740,3774,3710,3722,3725,-11,-8,718,"2,674.66",4704
,20180201,3722,3725,3730,3755,3725,3735,3740,10,15,408,"1,526.31",4618
,20180202,3735,3740,3720,3780,3720,3770,3757,30,17,884,"3,321.68",4580
,20180205,3770,3757,3760,3798,3750,3788,3769,31,12,352,"1,326.80",4618
,20180206,3788,3769,3791,3804,3765,3777,3780,8,11,444,"1,678.68",4734
,20180207,3777,3780,3770,3787,3755,3776,3767,-4,-13,418,"1,574.73",4764
,20180208,3776,3767,3760,3803,3760,3795,3790,28,23,680,"2,577.76",4578
,20180209,3795,3790,3795,3808,3741,3753,3778,-37,-12,560,"2,116.15",4750
,20180212,3753,3778,3749,3770,3740,3763,3752,-15,-26,342,"1,283.47",4820
,20180213,3763,3752,3751,3780,3738,3770,3757,18,5,650,"2,442.36",5020
,20180214,3770,3757,3775,3780,3765,3773,3774,16,17,208,785.02,5046
,20180222,3773,3774,3780,3780,3721,3733,3744,-41,-30,672,"2,516.03",5400
,20180223,3733,3744,3732,3800,3722,3793,3746,49,2,1630,"6,106.86",6168
,20180226,3793,3746,3798,3883,3793,3875,3841,129,95,1334,"5,124.59",6022
,20180227,3875,3841,3866,3879,3846,3876,3857,35,16,962,"3,711.15",6414
,20180228,3876,3857,3866,3880,3855,3864,3860,7,3,346,"1,335.77",6232
,20180301,3864,3860,3868,3888,3850,3861,3867,1,7,540,"2,088.44",6318
,20180302,3861,3867,3854,3876,3838,3871,3853,4,-14,1136,"4,377.37",6722
,20180305,3871,3853,3870,3873,3824,3824,3846,-29,-7,716,"2,754.03",7034
,20180306,3824,3846,3817,3846,3803,3834,3826,-12,-20,884,"3,382.95",7608
,20180307,3834,3826,3832,3841,3782,3782,3811,-44,-15,3358,"12,799.61",9938
,20180308,3782,3811,3776,3792,3740,3740,3757,-71,-54,3226,"12,120.35",10218
,20180309,3740,3757,3739,3744,3618,3649,3682,-108,-75,2036,"7,498.48",10794
,20180312,3649,3682,3652,3675,3625,3640,3652,-42,-30,1680,"6,136.24",10756
,20180313,3640,3652,3640,3657,3608,3613,3630,-39,-22,1780,"6,462.34",11204
,20180314,3613,3630,3620,3642,3583,3626,3617,-4,-13,2036,"7,364.99",11154
,20180315,3626,3617,3640,3650,3618,3626,3630,9,13,1080,"3,920.53",11134
,20180316,3626,3630,3624,3645,3607,3629,3625,-1,-5,1234,"4,474.27",11078
,20180319,3629,3625,3624,3636,3556,3568,3583,-57,-42,3684,"13,202.04",10812
,20180320,3568,3583,3562,3586,3519,3552,3552,-31,-31,3134,"11,132.99",10960
,20180321,3552,3552,3556,3566,3477,3477,3517,-75,-35,2928,"10,299.14",11536
,20180322,3477,3517,3476,3505,3462,3480,3482,-37,-35,3162,"11,012.26",11956
,20180323,3480,3482,3482,3482,3273,3302,3358,-180,-124,8600,"28,881.77",13434
,20180326,3302,3358,3292,3310,3228,3235,3266,-123,-92,3114,"10,171.97",13792
,20180327,3235,3266,3228,3325,3228,3283,3282,17,16,3742,"12,282.49",13366
,20180328,3283,3282,3294,3330,3252,3273,3294,-9,12,3722,"12,261.53",13258
,20180329,3273,3294,3276,3326,3258,3313,3298,19,4,3744,"12,349.35",13698
,20180330,3313,3298,3318,3415,3303,3414,3343,116,45,5058,"16,912.05",13340
,20180402,3414,3343,3412,3463,3352,3360,3390,17,47,7842,"26,585.43",13540
,20180403,3360,3390,3356,3392,3308,3338,3347,-52,-43,5494,"18,393.36",14976
,20180404,3338,3347,3341,3357,3306,3315,3329,-32,-18,3672,"12,226.71",15544
,20180409,3315,3329,3319,3400,3296,3400,3340,71,11,5216,"17,423.20",15924
,20180410,3400,3340,3394,3424,3380,3405,3399,65,59,4598,"15,631.85",15874
,20180411,3405,3399,3411,3432,3312,3359,3388,-40,-11,9604,"32,546.34",18640
,20180412,3359,3388,3377,3398,3343,3390,3370,2,-18,5930,"19,987.53",18640
,20180413,3390,3370,3377,3440,3358,3431,3403,61,33,8264,"28,124.09",18628
,20180416,3431,3403,3427,3440,3330,3333,3377,-70,-26,8928,"30,156.39",21160
,20180417,3333,3377,3335,3410,3332,3373,3375,-4,-2,8262,"27,887.48",19930
,20180418,3373,3375,3378,3469,3378,3428,3430,53,55,11464,"39,329.25",20226
,20180419,3428,3430,3438,3498,3438,3475,3466,45,36,7338,"25,437.20",20530
,20180420,3475,3466,3468,3473,3428,3441,3449,-25,-17,10532,"36,334.60",24024
,20180423,3441,3449,3437,3535,3437,3518,3501,69,52,10008,"35,046.37",23886
,20180424,3518,3501,3508,3540,3500,3512,3522,11,21,25516,"89,883.05",29262
,20180425,3512,3522,3516,3534,3489,3516,3514,-6,-8,12232,"42,988.47",31160
,20180426,3516,3514,3511,3550,3483,3502,3510,-12,-4,14232,"49,966.02",34100
,20180427,3502,3510,3500,3541,3497,3530,3518,20,8,12838,"45,165.74",33674
,20180502,3530,3518,3550,3642,3550,3636,3596,118,78,16756,"60,260.08",34086
,20180503,3636,3596,3636,3641,3572,3584,3613,-12,17,20314,"73,397.78",35936
,20180504,3584,3613,3588,3600,3565,3588,3585,-25,-28,17170,"61,557.67",35028
,20180507,3588,3585,3583,3625,3556,3603,3592,18,7,21054,"75,633.31",34280
,20180508,3603,3592,3600,3618,3585,3585,3602,-7,10,16296,"58,704.31",33822
,20180509,3585,3602,3585,3587,3530,3536,3550,-66,-52,21766,"77,288.58",35896
,20180510,3536,3550,3539,3570,3534,3570,3551,20,1,13484,"47,883.59",35558
,20180511,3570,3551,3576,3627,3576,3610,3602,59,51,16130,"58,108.79",34302
,20180514,3610,3602,3618,3624,3600,3611,3614,9,12,13280,"47,994.93",34636
,20180515,3611,3614,3613,3656,3595,3643,3625,29,11,22350,"81,034.24",34800
,20180516,3643,3625,3639,3694,3627,3665,3655,40,30,28272,"103,348.38",35724
,20180517,3665,3655,3671,3691,3650,3681,3674,26,19,25486,"93,636.93",38366
,20180518,3681,3674,3688,3702,3636,3640,3665,-34,-9,17354,"63,611.65",37744
,20180521,3640,3665,3640,3680,3601,3610,3638,-55,-27,23060,"83,905.84",41148
,20180522,3610,3638,3610,3642,3604,3619,3620,-19,-18,16576,"60,014.15",44080
,20180523,3619,3620,3617,3619,3540,3567,3575,-53,-45,21166,"75,687.95",45152
,20180524,3567,3575,3565,3628,3555,3624,3589,49,14,15458,"55,487.86",46942
,20180525,3624,3589,3630,3674,3590,3608,3639,19,50,29252,"106,449.10",51302
,20180528,3608,3639,3606,3672,3593,3627,3637,-12,-2,18050,"65,664.42",50802
,20180529,3627,3637,3610,3703,3610,3692,3660,55,23,20764,"76,015.34",46280
,20180530,3692,3660,3692,3720,3671,3690,3698,30,38,17134,"63,361.76",47218
,20180531,3690,3698,3693,3719,3680,3693,3696,-5,-2,30680,"113,417.15",57630
hc1902,20180212,3778,3778,,,,3778,3778,0,0,0,0.00,0
,20180213,3778,3778,,,,3778,3778,0,0,0,0.00,0
,20180214,3778,3778,,,,3795,3795,17,17,0,0.00,0
,20180222,3795,3795,,,,3795,3795,0,0,0,0.00,0
,20180223,3795,3795,,,,3795,3795,0,0,0,0.00,0
,20180226,3795,3795,,,,3795,3795,0,0,0,0.00,0
,20180227,3795,3795,,,,3795,3795,0,0,0,0.00,0
,20180228,3795,3795,,,,3795,3795,0,0,0,0.00,0
,20180301,3795,3795,,,,3795,3795,0,0,0,0.00,0
,20180302,3795,3795,,,,3795,3795,0,0,0,0.00,0
,20180305,3795,3795,,,,3795,3795,0,0,0,0.00,0
,20180306,3795,3795,,,,3795,3795,0,0,0,0.00,0
,20180307,3795,3795,,,,3795,3795,0,0,0,0.00,0
,20180308,3795,3795,,,,3795,3795,0,0,0,0.00,0
,20180309,3795,3795,,,,3795,3795,0,0,0,0.00,0
,20180312,3795,3795,,,,3717,3717,-78,-78,0,0.00,0
,20180313,3717,3717,,,,3681,3681,-36,-36,0,0.00,0
,20180314,3681,3681,,,,3681,3681,0,0,0,0.00,0
,20180315,3681,3681,,,,3681,3681,0,0,0,0.00,0
,20180316,3681,3681,,,,3681,3681,0,0,0,0.00,0
,20180319,3681,3681,,,,3651,3651,-30,-30,0,0.00,0
,20180320,3651,3651,,,,3651,3651,0,0,0,0.00,0
,20180321,3651,3651,,,,3651,3651,0,0,0,0.00,0
,20180322,3651,3651,,,,3651,3651,0,0,0,0.00,0
,20180323,3651,3651,,,,3531,3531,-120,-120,0,0.00,0
,20180326,3531,3531,,,,3531,3531,0,0,0,0.00,0
,20180327,3531,3531,,,,3531,3531,0,0,0,0.00,0
,20180328,3531,3531,,,,3380,3380,-151,-151,0,0.00,0
,20180329,3380,3380,,,,3380,3380,0,0,0,0.00,0
,20180330,3380,3380,,,,3380,3380,0,0,0,0.00,0
,20180402,3380,3380,,,,3380,3380,0,0,0,0.00,0
,20180403,3380,3380,,,,3380,3380,0,0,0,0.00,0
,20180404,3380,3380,,,,3380,3380,0,0,0,0.00,0
,20180409,3380,3380,,,,3380,3380,0,0,0,0.00,0
,20180410,3380,3380,,,,3380,3380,0,0,0,0.00,0
,20180411,3380,3380,,,,3380,3380,0,0,0,0.00,0
,20180412,3380,3380,,,,3380,3380,0,0,0,0.00,0
,20180413,3380,3380,,,,3380,3380,0,0,0,0.00,0
,20180416,3380,3380,,,,3380,3380,0,0,0,0.00,0
,20180417,3380,3380,,,,3380,3380,0,0,0,0.00,0
,20180418,3380,3380,,,,3380,3380,0,0,0,0.00,0
,20180419,3380,3380,,,,3380,3380,0,0,0,0.00,0
,20180420,3380,3380,,,,3380,3380,0,0,0,0.00,0
,20180423,3380,3380,,,,3380,3380,0,0,0,0.00,0
,20180424,3380,3380,,,,3400,3400,20,20,0,0.00,0
,20180425,3400,3400,,,,3400,3400,0,0,0,0.00,0
,20180426,3400,3400,,,,3400,3400,0,0,0,0.00,0
,20180427,3400,3400,,,,3400,3400,0,0,0,0.00,0
,20180502,3400,3400,,,,3475,3475,75,75,0,0.00,0
,20180503,3475,3475,,,,3475,3475,0,0,0,0.00,0
,20180504,3475,3475,,,,3535,3535,60,60,0,0.00,0
,20180507,3535,3535,,,,3535,3535,0,0,0,0.00,0
,20180508,3535,3535,,,,3535,3535,0,0,0,0.00,0
,20180509,3535,3535,,,,3535,3535,0,0,0,0.00,0
,20180510,3535,3535,,,,3551,3551,16,16,0,0.00,0
,20180511,3551,3551,,,,3551,3551,0,0,0,0.00,0
,20180514,3551,3551,,,,3551,3551,0,0,0,0.00,0
,20180515,3551,3551,,,,3551,3551,0,0,0,0.00,0
,20180516,3551,3551,,,,3551,3551,0,0,0,0.00,0
,20180517,3551,3551,,,,3551,3551,0,0,0,0.00,0
,20180518,3551,3551,,,,3551,3551,0,0,0,0.00,0
,20180521,3551,3551,,,,3551,3551,0,0,0,0.00,0
,20180522,3551,3551,,,,3551,3551,0,0,0,0.00,0
,20180523,3551,3551,,,,3551,3551,0,0,0,0.00,0
,20180524,3551,3551,,,,3551,3551,0,0,0,0.00,0
,20180525,3551,3551,,,,3551,3551,0,0,0,0.00,0
,20180528,3551,3551,,,,3551,3551,0,0,0,0.00,0
,20180529,3551,3551,,,,3551,3551,0,0,0,0.00,0
,20180530,3551,3551,,,,3551,3551,0,0,0,0.00,0
,20180531,3551,3551,3661,3709,3661,3709,3673,158,122,70,257.13,38
hc1903,20180316,3681,3681,,,,3681,3681,0,0,0,0.00,0
,20180319,3681,3681,,,,3681,3681,0,0,0,0.00,0
,20180320,3681,3681,,,,3681,3681,0,0,0,0.00,0
,20180321,3681,3681,,,,3681,3681,0,0,0,0.00,0
,20180322,3681,3681,3588,3588,3408,3408,3498,-273,-183,4,13.99,2
,20180323,3408,3498,,,,3373,3373,-125,-125,0,0.00,2
,20180326,3373,3373,3230,3331,3230,3331,3245,-42,-128,70,227.21,0
,20180327,3331,3245,,,,3261,3261,16,16,0,0.00,0
,20180328,3261,3261,,,,3261,3261,0,0,0,0.00,0
,20180329,3261,3261,,,,3265,3265,4,4,0,0.00,0
,20180330,3265,3265,,,,3310,3310,45,45,0,0.00,0
,20180402,3310,3310,,,,3356,3356,46,46,0,0.00,0
,20180403,3356,3356,,,,3314,3314,-42,-42,0,0.00,0
,20180404,3314,3314,,,,3296,3296,-18,-18,0,0.00,0
,20180409,3296,3296,,,,3307,3307,11,11,0,0.00,0
,20180410,3307,3307,,,,3366,3366,59,59,0,0.00,0
,20180411,3366,3366,,,,3355,3355,-11,-11,0,0.00,0
,20180412,3355,3355,,,,3337,3337,-18,-18,0,0.00,0
,20180413,3337,3337,,,,3369,3369,32,32,0,0.00,0
,20180416,3369,3369,,,,3343,3343,-26,-26,0,0.00,0
,20180417,3343,3343,,,,3341,3341,-2,-2,0,0.00,0
,20180418,3341,3341,,,,3396,3396,55,55,0,0.00,0
,20180419,3396,3396,,,,3432,3432,36,36,0,0.00,0
,20180420,3432,3432,,,,3416,3416,-16,-16,0,0.00,0
,20180423,3416,3416,,,,3468,3468,52,52,0,0.00,0
,20180424,3468,3468,,,,3489,3489,21,21,0,0.00,0
,20180425,3489,3489,,,,3481,3481,-8,-8,0,0.00,0
,20180426,3481,3481,,,,3477,3477,-4,-4,0,0.00,0
,20180427,3477,3477,,,,3485,3485,8,8,0,0.00,0
,20180502,3485,3485,,,,3562,3562,77,77,0,0.00,0
,20180503,3562,3562,,,,3562,3562,0,0,0,0.00,0
,20180504,3562,3562,,,,3534,3534,-28,-28,0,0.00,0
,20180507,3534,3534,,,,3541,3541,7,7,0,0.00,0
,20180508,3541,3541,,,,3541,3541,0,0,0,0.00,0
,20180509,3541,3541,,,,3490,3490,-51,-51,0,0.00,0
,20180510,3490,3490,,,,3491,3491,1,1,0,0.00,0
,20180511,3491,3491,,,,3541,3541,50,50,0,0.00,0
,20180514,3541,3541,,,,3552,3552,11,11,0,0.00,0
,20180515,3552,3552,,,,3563,3563,11,11,0,0.00,0
,20180516,3563,3563,,,,3592,3592,29,29,0,0.00,0
,20180517,3592,3592,,,,3610,3610,18,18,0,0.00,0
,20180518,3610,3610,,,,3601,3601,-9,-9,0,0.00,0
,20180521,3601,3601,,,,3575,3575,-26,-26,0,0.00,0
,20180522,3575,3575,,,,3557,3557,-18,-18,0,0.00,0
,20180523,3557,3557,,,,3513,3513,-44,-44,0,0.00,0
,20180524,3513,3513,,,,3527,3527,14,14,0,0.00,0
,20180525,3527,3527,,,,3576,3576,49,49,0,0.00,0
,20180528,3576,3576,,,,3574,3574,-2,-2,0,0.00,0
,20180529,3574,3574,,,,3597,3597,23,23,0,0.00,0
,20180530,3597,3597,,,,3634,3634,37,37,0,0.00,0
,20180531,3634,3634,,,,3759,3759,125,125,0,0.00,0
hc1904,20180417,3343,3343,,,,3343,3343,0,0,0,0.00,0
,20180418,3343,3343,,,,3398,3398,55,55,0,0.00,0
,20180419,3398,3398,,,,3434,3434,36,36,0,0.00,0
,20180420,3434,3434,,,,3418,3418,-16,-16,0,0.00,0
,20180423,3418,3418,,,,3470,3470,52,52,0,0.00,0
,20180424,3470,3470,,,,3491,3491,21,21,0,0.00,0
,20180425,3491,3491,,,,3483,3483,-8,-8,0,0.00,0
,20180426,3483,3483,,,,3479,3479,-4,-4,0,0.00,0
,20180427,3479,3479,,,,3487,3487,8,8,0,0.00,0
,20180502,3487,3487,,,,3564,3564,77,77,0,0.00,0
,20180503,3564,3564,,,,3564,3564,0,0,0,0.00,0
,20180504,3564,3564,,,,3564,3564,0,0,0,0.00,0
,20180507,3564,3564,,,,3571,3571,7,7,0,0.00,0
,20180508,3571,3571,,,,3571,3571,0,0,0,0.00,0
,20180509,3571,3571,,,,3520,3520,-51,-51,0,0.00,0
,20180510,3520,3520,,,,3555,3555,35,35,0,0.00,0
,20180511,3555,3555,,,,3598,3598,43,43,0,0.00,0
,20180514,3598,3598,3624,3644,3624,3644,3630,46,32,6,21.78,4
,20180515,3644,3630,3646,3646,3646,3646,3646,16,16,2,7.29,4
,20180516,3646,3646,,,,3646,3646,0,0,0,0.00,4
,20180517,3646,3646,,,,3646,3646,0,0,0,0.00,4
,20180518,3646,3646,3650,3664,3650,3664,3657,18,11,4,14.63,4
,20180521,3664,3657,3648,3648,3648,3648,3648,-9,-9,2,7.30,2
,20180522,3648,3648,,,,3648,3648,0,0,0,0.00,2
,20180523,3648,3648,,,,3648,3648,0,0,0,0.00,2
,20180524,3648,3648,,,,3648,3648,0,0,0,0.00,2
,20180525,3648,3648,,,,3648,3648,0,0,0,0.00,2
,20180528,3648,3648,,,,3648,3648,0,0,0,0.00,2
,20180529,3648,3648,,,,3671,3671,23,23,0,0.00,2
,20180530,3671,3671,,,,3709,3709,38,38,0,0.00,2
,20180531,3709,3709,,,,3836,3836,127,127,0,0.00,2
hc1905,20180516,3646,3646,3532,3608,3532,3575,3563,-71,-83,2008,"7,156.03",1154
,20180517,3575,3563,3572,3606,3572,3589,3590,26,27,980,"3,519.01",1602
,20180518,3589,3590,3599,3601,3551,3555,3582,-35,-8,1140,"4,084.11",1576
,20180521,3555,3582,3551,3591,3522,3536,3543,-46,-39,1208,"4,280.16",2290
,20180522,3536,3543,3530,3555,3520,3531,3533,-12,-10,516,"1,823.22",2500
,20180523,3531,3533,3525,3528,3474,3500,3500,-33,-33,2940,"10,292.36",4974
,20180524,3500,3500,3497,3542,3479,3542,3502,42,2,540,"1,891.60",4884
,20180525,3542,3502,3553,3584,3508,3527,3560,25,58,1502,"5,347.38",4230
,20180528,3527,3560,3516,3570,3515,3543,3550,-17,-10,1072,"3,806.43",3886
,20180529,3543,3550,3547,3588,3543,3574,3570,24,20,1386,"4,949.13",3480
,20180530,3574,3570,3584,3610,3569,3599,3588,29,18,1450,"5,203.46",3096
,20180531,3599,3588,3574,3607,3574,3586,3589,-2,1,602,"2,160.99",3148
ni1801,20180102,96400,95810,97670,98390,97240,98120,97630,2310,1820,10150,"99,096.01",36300
,20180103,98120,97630,98470,98850,97300,97580,97810,-50,180,5052,"49,417.08",34308
,20180104,97580,97810,97560,98110,96420,98110,97160,300,-650,2964,"28,798.54",33096
,20180105,98110,97160,98110,98530,96800,97300,97670,140,510,4392,"42,901.01",31896
,20180108,97300,97670,97150,97470,96030,96900,96780,-770,-890,1956,"18,930.38",30960
,20180109,96900,96780,97120,98150,97000,98000,97810,1220,1030,3012,"29,461.44",29736
,20180110,98000,97810,99080,99810,97880,98890,98960,1080,1150,2628,"26,008.18",29952
,20180111,98890,98960,99350,100120,99350,99650,99740,690,780,1512,"15,080.75",29820
,20180112,99650,99740,98690,98940,97500,97860,97870,-1880,-1870,2232,"21,845.82",29148
,20180115,97860,97870,97210,99000,97200,98500,98200,630,330,660,"6,481.82",29748
ni1802,20180102,96220,96020,97960,98870,97030,98870,97840,2850,1820,36,352.23,158
,20180103,98870,97840,99830,99830,98110,98110,99000,270,1160,52,514.83,168
,20180104,98110,99000,97000,97400,96350,97000,96990,-2000,-2010,20,194.00,158
,20180105,97000,96990,99050,99050,98350,98350,98580,1360,1590,6,59.15,156
,20180108,98350,98580,97300,97300,97300,97300,97300,-1280,-1280,2,19.46,156
,20180109,97300,97300,98720,99110,97950,99090,98670,1790,1370,12,118.41,158
,20180110,99090,98670,99810,99840,99490,99540,99740,870,1070,94,937.64,220
,20180111,99540,99740,100820,100820,100230,100310,100300,570,560,714,"7,161.74",920
,20180112,100310,100300,95070,100250,95070,98500,99090,-1800,-1210,380,"3,765.75",1028
,20180115,98500,99090,99030,99510,98210,99510,99430,420,340,134,"1,332.38",904
,20180116,99510,99430,99190,99190,97390,97390,98080,-2040,-1350,16,156.94,888
,20180117,97390,98080,97390,97390,95310,95380,95930,-2700,-2150,450,"4,316.86",518
,20180118,95380,95930,95680,96280,95680,96000,95970,70,40,70,671.83,494
,20180119,96000,95970,95790,96280,94960,96280,95380,310,-590,60,572.31,478
,20180122,96280,95380,96240,98180,96240,98180,97390,2800,2010,318,"3,097.00",332
,20180123,98180,97390,97730,98300,96370,98300,97670,910,280,58,566.52,334
,20180124,98300,97670,98000,98700,97300,97300,98120,-370,450,106,"1,040.12",270
,20180125,97300,98120,99010,104000,99010,103580,102970,5460,4850,196,"2,018.25",282
,20180126,103580,102970,104000,104290,102800,104040,103760,1070,790,108,"1,120.61",300
,20180129,104040,103760,103630,106900,103200,104940,105170,1180,1410,118,"1,241.10",214
,20180130,104940,105170,105000,105000,102900,103160,103390,-2010,-1780,84,868.51,206
,20180131,103160,103390,103200,103300,101000,101300,102410,-2090,-980,36,368.68,180
,20180201,101300,102410,101600,101860,101500,101500,101640,-910,-770,48,487.87,180
,20180202,101500,101640,,,,101640,101640,0,0,0,0.00,180
,20180205,101640,101640,,,,101640,101640,0,0,0,0.00,180
,20180206,101640,101640,,,,101640,101640,0,0,0,0.00,180
,20180207,101640,101640,101640,101640,101640,101640,101640,0,0,108,"1,097.71",180
,20180208,101640,101640,,,,101640,101640,0,0,0,0.00,180
,20180209,101640,101640,,,,101640,101640,0,0,0,0.00,180
ni1803,20180102,96430,96490,98340,99000,97840,98750,98270,2260,1780,216,"2,122.77",4040
,20180103,98750,98270,99190,99460,98000,98170,98840,-100,570,128,"1,265.27",4032
,20180104,98170,98840,97770,98790,97040,98790,97530,-50,-1310,340,"3,316.05",3858
,20180105,98790,97530,99110,99110,98030,98090,98310,560,780,54,530.90,3844
,20180108,98090,98310,98300,98300,97000,97900,97700,-410,-610,126,"1,231.13",3892
,20180109,97900,97700,98630,99060,98430,98680,98670,980,970,186,"1,835.33",4028
,20180110,98680,98670,98700,100180,98700,99830,99710,1160,1040,336,"3,350.34",4054
,20180111,99830,99710,101020,101050,100350,100720,100630,1010,920,112,"1,127.14",4040
,20180112,100720,100630,100430,100430,98690,98900,98960,-1730,-1670,260,"2,573.17",3860
,20180115,98900,98960,98720,100050,98310,100030,99310,1070,350,232,"2,304.15",3750
,20180116,100030,99310,99320,99320,96800,97010,97150,-2300,-2160,2206,"21,432.96",5566
,20180117,97010,97150,96310,97330,95890,95910,96650,-1240,-500,2428,"23,468.59",4116
,20180118,95910,96650,95910,96840,95910,96000,96560,-650,-90,382,"3,688.68",3888
,20180119,96000,96560,96500,97080,95360,95760,96420,-800,-140,418,"4,030.55",3806
,20180122,95760,96420,95760,97840,95760,97710,96800,1290,380,148,"1,432.75",3704
,20180123,97710,96800,98280,98800,96800,98800,98020,2000,1220,188,"1,842.78",3648
,20180124,98800,98020,99000,99190,97800,98230,98650,210,630,328,"3,235.88",3562
,20180125,98230,98650,99320,104490,99220,104490,102830,5840,4180,912,"9,378.25",3744
,20180126,104490,102830,103740,103910,102980,103650,103590,820,760,128,"1,326.00",3698
,20180129,103650,103590,103890,106960,103450,105240,105030,1650,1440,2458,"25,818.60",3544
,20180130,105240,105030,105250,105410,102940,103140,104730,-1890,-300,588,"6,158.66",3452
,20180131,103140,104730,103200,103560,101140,102060,102020,-2670,-2710,138,"1,407.90",3444
,20180201,102060,102020,101840,102340,101200,101480,101790,-540,-230,406,"4,132.70",3418
,20180202,101480,101790,101750,104630,101750,104120,104040,2330,2250,220,"2,288.94",3296
,20180205,104120,104040,103590,103860,99850,101730,102420,-2310,-1620,218,"2,232.87",3278
,20180206,101730,102420,101420,103510,100400,100550,100900,-1870,-1520,108,"1,089.76",3230
,20180207,100550,100900,101410,102300,101410,101940,101860,1040,960,36,366.70,3214
,20180208,101940,101860,99560,100540,99000,100130,99950,-1730,-1910,34,339.84,3212
,20180209,100130,99950,99670,99670,98590,98590,99200,-1360,-750,8,79.36,3204
,20180212,98590,99200,99290,99530,98870,99380,99280,180,80,22,218.42,3200
,20180213,99380,99280,99350,100450,99350,100400,100260,1120,980,54,541.44,3248
,20180214,100400,100260,100420,102180,100420,102180,101820,1920,1560,34,346.22,3240
,20180222,102180,101820,102550,102890,101520,102200,102320,380,500,22,225.12,3222
,20180223,102200,102320,102930,104510,102930,104280,103590,1960,1270,90,932.39,3230
,20180226,104280,103590,104140,104830,103840,104830,104210,1240,620,78,812.87,3170
,20180227,104830,104210,104760,105400,104340,104630,104690,420,480,102,"1,067.88",3104
,20180228,104630,104690,103990,105050,103000,104000,103430,-690,-1260,294,"3,041.09",3084
,20180301,104000,103430,103880,104180,103880,104180,103940,750,510,60,623.69,3036
,20180302,104180,103940,,,,103940,103940,0,0,0,0.00,3036
,20180305,103940,103940,102080,102080,100960,100960,101230,-2980,-2710,372,"3,765.95",3036
,20180306,100960,101230,101620,102000,101620,102000,101760,770,530,120,"1,221.18",3036
,20180307,102000,101760,101320,101320,101300,101300,101310,-460,-450,36,364.73,3024
,20180308,101300,101310,101850,101850,100290,100290,101540,-1020,230,432,"4,386.53",3024
,20180309,100290,101540,,,,101540,101540,0,0,0,0.00,3024
,20180312,101540,101540,103200,104100,103000,103450,103360,1910,1820,96,992.32,3024
,20180313,103450,103360,102800,103050,102400,102400,102950,-960,-410,552,"5,682.84",3024
,20180314,102400,102950,103100,103500,103100,103500,103160,550,210,96,990.36,3024
,20180315,103500,103160,,,,103160,103160,0,0,0,0.00,3024
ni1804,20180102,96880,96630,,,,98410,98410,1780,1780,0,0.00,102
,20180103,98410,98410,,,,98410,98410,0,0,0,0.00,102
,20180104,98410,98410,98050,98050,97510,97510,97610,-900,-800,10,97.62,96
,20180105,97510,97610,98840,98840,98720,98720,98780,1110,1170,4,39.51,96
,20180108,98720,98780,97030,98590,97030,97150,97710,-1630,-1070,16,156.34,94
,20180109,97150,97710,97970,97970,97970,97970,97970,260,260,2,19.59,94
,20180110,97970,97970,99990,100440,99860,100440,100180,2470,2210,8,80.15,90
,20180111,100440,100180,,,,100180,100180,0,0,0,0.00,90
,20180112,100180,100180,100610,100610,98530,98530,99040,-1650,-1140,70,693.33,112
,20180115,98530,99040,99110,100130,98820,100130,99240,1090,200,38,377.13,104
,20180116,100130,99240,99640,99850,97920,98380,99390,-860,150,62,616.24,106
,20180117,98380,99390,96040,97540,96030,97410,96740,-1980,-2650,30,290.25,112
,20180118,97410,96740,96540,96540,96540,96540,96540,-200,-200,2,19.31,110
,20180119,96540,96540,96680,96680,96670,96680,96670,140,130,16,154.68,106
,20180122,96680,96670,98400,98400,97740,97740,97870,1070,1200,10,97.87,96
,20180123,97740,97870,98100,98490,97230,97500,97730,-370,-140,58,566.87,92
,20180124,97500,97730,98500,99380,98500,99380,98910,1650,1180,14,138.48,94
,20180125,99380,98910,93180,104770,93180,104550,102560,5640,3650,114,"1,169.26",96
,20180126,104550,102560,104340,104340,103340,104000,103780,1440,1220,56,581.20,84
,20180129,104000,103780,103790,106200,103530,106200,104500,2420,720,28,292.61,88
,20180130,106200,104500,105290,105630,103800,104330,104600,-170,100,34,355.66,98
,20180131,104330,104600,104020,104020,102620,102620,103480,-1980,-1120,26,269.07,112
,20180201,102620,103480,102350,102350,102180,102310,102270,-1170,-1210,26,265.92,110
,20180202,102310,102270,102750,105220,102560,104890,104180,2620,1910,126,"1,312.73",112
,20180205,104890,104180,104130,104160,99500,101820,103080,-2360,-1100,236,"2,432.89",116
,20180206,101820,103080,103640,104250,100760,100760,102750,-2320,-330,10,102.76,112
,20180207,100760,102750,102750,102750,102340,102340,102540,-410,-210,4,41.02,110
,20180208,102340,102540,100150,100880,100150,100310,100390,-2230,-2150,24,240.94,110
,20180209,100310,100390,,,,99500,99500,-890,-890,0,0.00,110
,20180212,99500,99500,99550,99550,99430,99430,99490,-70,-10,4,39.80,106
,20180213,99430,99490,101160,101160,101160,101160,101160,1670,1670,6,60.70,106
,20180214,101160,101160,100750,103360,100750,103360,102740,2200,1580,146,"1,500.02",110
,20180222,103360,102740,103220,103220,103220,103220,103220,480,480,6,61.93,110
,20180223,103220,103220,103610,105470,103600,104310,104250,1090,1030,36,375.32,114
,20180226,104310,104250,104890,105350,104530,105110,104760,860,510,22,230.49,104
,20180227,105110,104760,105240,105240,104960,104960,105040,200,280,54,567.26,60
,20180228,104960,105040,104880,105440,104690,104690,105040,-350,0,30,315.13,52
,20180301,104690,105040,104190,104330,104190,104330,104290,-710,-750,8,83.44,50
,20180302,104330,104290,,,,104090,104090,-200,-200,0,0.00,50
,20180305,104090,104090,,,,103470,103470,-620,-620,0,0.00,50
,20180306,103470,103470,102400,102400,102020,102020,102210,-1450,-1260,4,40.88,50
,20180307,102020,102210,,,,102210,102210,0,0,0,0.00,50
,20180308,102210,102210,102140,102140,102140,102140,102140,-70,-70,2,20.43,48
,20180309,102140,102140,100550,101770,99920,99920,100620,-2220,-1520,16,161.00,40
,20180312,99920,100620,101450,103970,101450,103970,102380,3350,1760,10,102.38,40
,20180313,103970,102380,,,,102450,102450,70,70,0,0.00,40
,20180314,102450,102450,104280,104280,103600,104220,104030,1770,1580,12,124.84,46
,20180315,104220,104030,,,,104030,104030,0,0,0,0.00,46
,20180316,104030,104030,,,,104030,104030,0,0,0,0.00,46
,20180319,104030,104030,99880,102730,99880,102730,101300,-1300,-2730,4,40.52,46
,20180320,102730,101300,100300,102900,100300,101800,101580,500,280,24,243.80,42
,20180321,101800,101580,101300,101980,101300,101390,101410,-190,-170,40,405.66,8
,20180322,101390,101410,101490,103120,101490,102000,102200,590,790,12,122.64,8
,20180323,102000,102200,102300,102300,99730,99730,101010,-2470,-1190,8,80.81,8
,20180326,99730,101010,100120,100120,95740,96290,98010,-4720,-3000,14,137.21,10
,20180327,96290,98010,96770,98330,94890,97010,96490,-1000,-1520,18,173.69,4
,20180328,97010,96490,,,,96490,96490,0,0,0,0.00,4
,20180329,96490,96490,96490,96490,96490,96490,96490,0,0,4,38.60,0
,20180330,96490,96490,,,,96490,96490,0,0,0,0.00,0
,20180402,96490,96490,,,,96490,96490,0,0,0,0.00,0
,20180403,96490,96490,,,,96490,96490,0,0,0,0.00,0
,20180404,96490,96490,,,,96490,96490,0,0,0,0.00,0
,20180409,96490,96490,,,,96490,96490,0,0,0,0.00,0
,20180410,96490,96490,,,,96490,96490,0,0,0,0.00,0
,20180411,96490,96490,,,,96490,96490,0,0,0,0.00,0
,20180412,96490,96490,,,,96490,96490,0,0,0,0.00,0
,20180413,96490,96490,,,,96490,96490,0,0,0,0.00,0
,20180416,96490,96490,,,,96490,96490,0,0,0,0.00,0
ni1805,20180102,96870,96880,99000,99470,98080,99170,98750,2290,1870,410050,"4,049,472.72",529614
,20180103,99170,98750,99820,99980,98260,98620,99150,-130,400,620810,"6,155,866.72",515014
,20180104,98620,99150,98690,99200,97210,99180,98100,30,-1050,725542,"7,117,679.05",514988
,20180105,99180,98100,99540,99640,97870,98580,98820,480,720,682494,"6,744,582.53",499422
,20180108,98580,98820,98340,98710,97000,98490,98030,-330,-790,659222,"6,462,911.80",477646
,20180109,98490,98030,98330,99750,98140,99380,99140,1350,1110,576140,"5,712,223.31",504024
,20180110,99380,99140,99240,100900,98910,100420,100340,1280,1200,806584,"8,093,319.89",532080
,20180111,100420,100340,102000,102380,100710,101430,101350,1090,1010,599622,"6,077,254.26",535222
,20180112,101430,101350,101250,101500,98600,99570,99790,-1780,-1560,783130,"7,815,234.94",481772
,20180115,99570,99790,99250,100660,98500,100210,99550,420,-240,733326,"7,300,359.48",500056
,20180116,100210,99550,100350,100480,97720,97810,99190,-1740,-360,802706,"7,962,727.28",481932
,20180117,97810,99190,96980,97970,96390,96950,97200,-2240,-1990,740004,"7,192,964.41",470912
,20180118,96950,97200,96880,97440,96500,96780,97020,-420,-180,584154,"5,668,017.72",471862
,20180119,96780,97020,97060,97800,95700,96830,96770,-190,-250,792194,"7,666,583.42",450508
,20180122,96830,96770,97500,98860,97080,98540,98040,1770,1270,757364,"7,425,935.10",460512
,20180123,98540,98040,98680,99760,97110,99720,98480,1680,440,852496,"8,395,935.25",475008
,20180124,99720,98480,99230,99810,98270,98640,99150,160,670,805358,"7,985,909.46",473946
,20180125,98640,99150,99980,105090,99560,104740,102580,5590,3430,1384708,"14,205,583.07",585362
,20180126,104740,102580,104360,104750,103280,104360,104090,1780,1510,888200,"9,245,479.06",599144
,20180129,104360,104090,104730,107050,103620,105920,105210,1830,1120,1132986,"11,921,182.75",617980
,20180130,105920,105210,105800,106100,103310,103780,104890,-1430,-320,965772,"10,130,826.59",570366
,20180131,103780,104890,104000,104460,101550,102620,102670,-2270,-2220,1136170,"11,665,465.71",520118
,20180201,102620,102670,102750,103150,101620,102090,102420,-580,-250,860566,"8,814,696.71",502610
,20180202,102090,102420,102260,105780,102210,104530,104250,2110,1830,1090262,"11,366,979.65",522146
,20180205,104530,104250,104400,104490,100000,102190,102030,-2060,-2220,1587594,"16,198,778.13",491826
,20180206,102190,102030,102480,104240,100530,101260,102380,-770,350,1515994,"15,520,794.55",483786
,20180207,101260,102380,101380,103260,100850,102260,102000,-120,-380,1224438,"12,489,358.55",475210
,20180208,102260,102000,102090,102480,99220,100470,100790,-1530,-1210,1438336,"14,498,364.91",448810
,20180209,100470,100790,100460,101180,98420,98770,100120,-2020,-670,1215786,"12,173,583.66",443252
,20180212,98770,100120,99000,100300,97770,99820,99100,-300,-1020,590974,"5,856,554.14",454368
,20180213,99820,99100,99620,101230,99340,100870,100320,1770,1220,444774,"4,462,144.34",438146
,20180214,100870,100320,101220,103500,100750,103490,102340,3170,2020,447314,"4,578,151.82",421808
,20180222,103490,102340,103860,104000,101900,102840,102910,500,570,216024,"2,223,196.48",417206
,20180223,102840,102910,103170,105370,102910,104950,104720,2040,1810,519170,"5,436,804.29",483238
,20180226,104950,104720,105200,105580,103680,105470,104950,750,230,527612,"5,537,706.96",496642
,20180227,105470,104950,105600,106590,104300,106000,105410,1050,460,536948,"5,660,174.36",520620
,20180228,106000,105410,105680,105860,103820,105010,104970,-400,-440,511922,"5,373,960.97",496072
,20180301,105010,104970,104950,105380,103490,104780,104490,-190,-480,519416,"5,427,471.74",491184
,20180302,104780,104490,103630,103870,101680,102180,102710,-2310,-1780,619302,"6,360,979.84",501914
,20180305,102180,102710,102210,102890,101440,101440,102190,-1270,-520,459628,"4,696,958.11",483776
,20180306,101440,102190,101560,102830,100650,102410,101810,220,-380,515210,"5,245,403.01",505504
,20180307,102410,101810,102930,103530,102050,102060,102860,250,1050,436148,"4,486,266.39",471720
,20180308,102060,102860,101770,102800,100450,100730,101820,-2130,-1040,460718,"4,691,458.50",482830
,20180309,100730,101820,100730,101010,99770,100420,100370,-1400,-1450,522806,"5,247,893.98",450238
,20180312,100420,100370,101210,105020,100870,103640,102960,3270,2590,620518,"6,389,188.10",458634
,20180313,103640,102960,103760,104490,103020,103440,103780,480,820,390078,"4,048,278.11",430464
,20180314,103440,103780,104250,104660,103520,104350,104120,570,340,364044,"3,790,443.23",436226
,20180315,104350,104120,104660,104800,102630,103300,103590,-820,-530,357574,"3,704,309.72",418816
,20180316,103300,103590,103040,103320,101760,103220,102500,-370,-1090,350406,"3,591,686.49",413476
,20180319,103220,102500,103200,103520,101360,101690,102200,-810,-300,374786,"3,830,387.34",406490
,20180320,101690,102200,101620,102460,100600,102280,101610,80,-590,340770,"3,462,852.75",386736
,20180321,102280,101610,102320,102350,100800,101020,101400,-590,-210,340766,"3,455,589.79",384598
,20180322,101020,101400,100770,102690,99480,101200,101090,-200,-310,418026,"4,225,965.36",379546
,20180323,101200,101090,100800,101170,96900,97990,98880,-3100,-2210,572852,"5,664,459.82",378590
,20180326,97990,98880,98060,99300,95850,95900,97570,-2980,-1310,418588,"4,084,474.22",313838
,20180327,95900,97570,95900,97980,95470,97210,96860,-360,-710,289280,"2,802,158.69",295274
,20180328,97210,96860,97050,97510,95740,96210,96600,-650,-260,257086,"2,483,696.98",278680
,20180329,96210,96600,96520,98400,96220,98360,96960,1760,360,237860,"2,306,340.57",236138
,20180330,98360,96960,98330,99450,97760,99350,98500,2390,1540,172554,"1,699,758.47",205292
,20180402,99350,98500,99290,101450,99080,100080,100340,1580,1840,169732,"1,703,249.86",184446
,20180403,100080,100340,100340,100680,99260,100300,100040,-40,-300,101530,"1,015,785.19",156278
,20180404,100300,100040,100470,100800,99630,99870,100030,-170,-10,67626,"676,477.92",144426
,20180409,99870,100030,99500,99900,97510,99140,98400,-890,-1630,64286,"632,633.68",134972
,20180410,99140,98400,99140,100980,98800,100360,100040,1960,1640,56442,"564,676.53",122220
,20180411,100360,100040,101410,101820,100450,101100,101070,1060,1030,36928,"373,265.69",113918
,20180412,101100,101070,101180,102220,100190,101530,101210,460,140,40974,"414,721.64",111930
,20180413,101530,101210,101010,103710,100700,103050,102550,1840,1340,47488,"487,013.12",97124
,20180416,103050,102550,103440,103910,102200,103580,103030,1030,480,23680,"243,975.25",90660
,20180417,103580,103030,103620,104200,102510,103080,103140,50,110,24888,"256,699.80",82630
,20180418,103080,103140,102320,104360,101880,103910,103120,770,-20,27124,"279,713.73",80278
,20180419,103910,103120,106800,109100,96940,107270,106890,4150,3770,46024,"491,990.58",78196
,20180420,107270,106890,106010,106100,103130,103610,104810,-3280,-2080,23866,"250,140.78",67266
,20180423,103610,104810,103590,104670,103000,104110,103980,-700,-830,16026,"166,642.46",62762
,20180424,104110,103980,102990,103670,101330,102710,102830,-1270,-1150,15414,"158,505.41",57392
,20180425,102710,102830,102710,103910,102440,102790,103030,-40,200,16374,"168,708.30",49958
,20180426,102790,103030,102840,103460,102390,103000,102870,-30,-160,9798,"100,794.81",45652
,20180427,103000,102870,103000,104490,102650,104470,103850,1600,980,16908,"175,597.64",39726
,20180502,104470,103850,103600,105000,103150,104920,103820,1070,-30,4590,"47,656.76",38016
,20180503,104920,103820,104820,105070,103900,104350,104470,530,650,6696,"69,955.00",35352
,20180504,104350,104470,104460,104550,102690,103350,103500,-1120,-970,15180,"157,123.51",28752
,20180507,103350,103500,103000,104050,102470,103900,103220,400,-280,6324,"65,277.46",28044
,20180508,103900,103220,103940,105000,103390,104600,104100,1380,880,7764,"80,823.85",26448
,20180509,104600,104100,104250,104410,102870,103410,103470,-690,-630,6600,"68,293.84",23832
,20180510,103410,103470,103940,104210,103310,103700,103640,230,170,4956,"51,366.40",21804
,20180511,103700,103640,103820,104200,103600,103600,103760,-40,120,1584,"16,436.29",20340
,20180514,103600,103760,104400,105990,104400,105800,104950,2040,1190,540,"5,667.52",20304
,20180515,105800,104950,105900,107200,105650,106200,106370,1250,1420,1164,"12,381.98",20376
ni1806,20180102,96660,96790,,,,96790,96790,0,0,0,0.00,120
,20180103,96790,96790,100220,100220,98650,98960,99330,2170,2540,28,278.14,112
,20180104,98960,99330,98560,99230,97320,99230,98080,-100,-1250,14,137.32,116
,20180105,99230,98080,99660,99660,98320,98690,98900,610,820,26,257.15,116
,20180108,98690,98900,98240,98290,98200,98290,98240,-610,-660,14,137.54,120
,20180109,98290,98240,99590,99590,99090,99090,99420,850,1180,6,59.65,120
,20180110,99090,99420,,,,99420,99420,0,0,0,0.00,120
,20180111,99420,99420,102430,102430,101220,101420,101910,2000,2490,180,"1,834.55",126
,20180112,101420,101910,101600,101600,99080,99080,100100,-2830,-1810,28,280.28,118
,20180115,99080,100100,99460,100430,99240,100430,99320,330,-780,300,"2,979.61",354
,20180116,100430,99320,100300,100440,98140,98220,99650,-1100,330,410,"4,086.00",144
,20180117,98220,99650,98000,98040,96800,96800,97700,-2850,-1950,16,156.32,138
,20180118,96800,97700,97170,97280,97000,97000,97120,-700,-580,14,135.98,124
,20180119,97000,97120,96450,96450,96450,96450,96450,-670,-670,4,38.58,124
,20180122,96450,96450,97530,98840,97530,98470,98560,2020,2110,74,729.41,122
,20180123,98470,98560,,,,98560,98560,0,0,0,0.00,122
,20180124,98560,98560,99400,99400,99250,99350,99340,790,780,66,655.66,124
,20180125,99350,99340,100830,105300,100490,105300,101640,5960,2300,284,"2,886.59",166
,20180126,105300,101640,104950,104950,104010,104370,104490,2730,2850,40,418.00,154
,20180129,104370,104490,104330,107220,104330,105420,106040,930,1550,8,84.84,158
,20180130,105420,106040,106610,106610,103690,103940,105050,-2100,-990,44,462.23,162
,20180131,103940,105050,104300,104680,102200,102930,102760,-2120,-2290,48,493.29,146
,20180201,102930,102760,102740,103010,102710,102710,102870,-50,110,34,349.76,144
,20180202,102710,102870,103020,105690,102930,104730,104320,1860,1450,76,792.91,152
,20180205,104730,104320,104120,104250,101590,101920,102550,-2400,-1770,38,389.71,142
,20180206,101920,102550,103270,103480,100810,100810,101910,-1740,-640,88,896.87,154
,20180207,100810,101910,101830,102560,101200,101650,102060,-260,150,72,734.84,146
,20180208,101650,102060,102470,102470,99620,101350,101670,-710,-390,32,325.35,126
,20180209,101350,101670,101280,101280,99000,99000,99930,-2670,-1740,38,379.75,130
,20180212,99000,99930,99270,99980,97900,99970,99430,40,-500,16,159.09,128
,20180213,99970,99430,100160,101630,100160,101630,100600,2200,1170,20,201.21,132
,20180214,101630,100600,103830,103830,103830,103830,103830,3230,3230,4,41.53,136
,20180222,103830,103830,103830,103830,103560,103560,103740,-270,-90,6,62.24,134
,20180223,103560,103740,104100,105890,104100,105890,105090,2150,1350,62,651.60,140
,20180226,105890,105090,105370,106180,104850,105570,105400,480,310,452,"4,764.15",272
,20180227,105570,105400,106010,106120,105300,106120,105790,720,390,64,677.11,220
,20180228,106120,105790,105940,105960,104950,105150,105480,-640,-310,46,485.25,206
,20180301,105150,105480,105020,105020,104210,104970,104510,-510,-970,48,501.67,190
,20180302,104970,104510,103580,103580,102070,102070,102380,-2440,-2130,28,286.68,176
,20180305,102070,102380,102630,102800,102130,102340,102290,-40,-90,112,"1,145.75",140
,20180306,102340,102290,101940,102240,101110,102090,101800,-200,-490,36,366.49,132
,20180307,102090,101800,103650,103650,102420,102420,103110,620,1310,10,103.11,130
,20180308,102420,103110,102550,102620,102440,102620,102570,-490,-540,18,184.63,114
,20180309,102620,102570,101090,101090,100340,100570,100760,-2000,-1810,32,322.44,106
,20180312,100570,100760,103000,104690,103000,104090,104280,3330,3520,36,375.44,96
,20180313,104090,104280,104150,104480,103730,103900,104190,-380,-90,18,187.56,94
,20180314,103900,104190,,,,104190,104190,0,0,0,0.00,94
,20180315,104190,104190,104800,104800,103770,103990,104080,-200,-110,20,208.17,92
,20180316,103990,104080,102930,103110,102930,103110,103020,-970,-1060,4,41.21,90
,20180319,103110,103020,103160,103180,101870,101870,102470,-1150,-550,44,450.88,96
,20180320,101870,102470,108600,108600,101430,102450,104690,-20,2220,100,"1,046.93",132
,20180321,102450,104690,101780,102650,101070,101600,101730,-3090,-2960,230,"2,339.87",122
,20180322,101600,101730,100230,101370,100160,101370,100700,-360,-1030,30,302.11,120
,20180323,101370,100700,100670,100670,97710,97980,99680,-2720,-1020,122,"1,216.18",210
,20180326,97980,99680,98560,98560,95310,96470,96130,-3210,-3550,50,480.67,236
,20180327,96470,96130,96200,98180,96200,98180,97420,2050,1290,66,643.00,208
,20180328,98180,97420,98180,98180,96200,96200,97300,-1220,-120,14,136.23,210
,20180329,96200,97300,97230,97980,96430,97980,96960,680,-340,138,"1,338.11",216
,20180330,97980,96960,98520,99760,98450,99760,98740,2800,1780,38,375.22,206
,20180402,99760,98740,100000,100550,100000,100550,100020,1810,1280,104,"1,040.21",106
,20180403,100550,100020,100060,100450,99870,100220,100110,200,90,20,200.23,104
,20180404,100220,100110,,,,100110,100110,0,0,0,0.00,104
,20180409,100110,100110,99260,99310,97920,98270,98990,-1840,-1120,80,791.97,118
,20180410,98270,98990,99550,101160,99550,100880,100310,1890,1320,18,180.57,116
,20180411,100880,100310,101970,101980,100960,100960,101240,650,930,42,425.25,88
,20180412,100960,101240,101100,102150,100710,101800,101150,560,-90,270,"2,731.31",102
,20180413,101800,101150,101350,103980,101250,103360,102730,2210,1580,112,"1,150.62",108
,20180416,103360,102730,102980,102980,102980,102980,102980,250,250,2,20.60,110
,20180417,102980,102980,104000,104630,103340,103910,103890,930,910,36,374.04,118
,20180418,103910,103890,103010,105710,103010,105390,104290,1500,400,34,354.59,130
,20180419,105390,104290,107400,109610,106030,108000,106780,3710,2490,270,"2,883.29",178
,20180420,108000,106780,106050,106090,103600,104210,104010,-2570,-2770,652,"6,781.91",162
,20180423,104210,104010,104340,104820,103660,104820,104380,810,370,68,709.80,138
,20180424,104820,104380,101980,103880,101980,103880,103110,-500,-1270,120,"1,237.35",118
,20180425,103880,103110,103790,104260,103050,103380,103620,270,510,58,601.05,114
,20180426,103380,103620,103080,103260,103080,103180,103190,-440,-430,56,577.89,132
,20180427,103180,103190,103100,105240,103100,105240,104190,2050,1000,74,771.02,142
,20180502,105240,104190,104280,105000,103550,105000,104380,810,190,28,292.27,144
,20180503,105000,104380,104800,104800,104800,104800,104800,420,420,2,20.96,142
,20180504,104800,104800,104590,104590,103140,103660,103920,-1140,-880,50,519.61,134
,20180507,103660,103920,103600,104290,103140,104290,103590,370,-330,32,331.52,126
,20180508,104290,103590,104250,104800,104250,104800,104430,1210,840,6,62.66,130
,20180509,104800,104430,104840,104840,103640,103670,103930,-760,-500,16,166.30,122
,20180510,103670,103930,,,,103930,103930,0,0,0,0.00,122
,20180511,103930,103930,103840,103840,103650,103650,103770,-280,-160,6,62.27,116
,20180514,103650,103770,105390,107450,104820,107450,105660,3680,1890,12,126.80,112
,20180515,107450,105660,106700,107990,106460,107990,106900,2330,1240,26,277.95,98
,20180516,107990,106900,106450,108690,106450,107960,108120,1060,1220,46,497.36,108
,20180517,107960,108120,108110,108300,107690,108040,107910,-80,-210,22,237.42,100
,20180518,108040,107910,107460,109700,107080,109590,108780,1680,870,206,"2,240.99",92
,20180521,109590,108780,,,,108780,108780,0,0,0,0.00,92
,20180522,108780,108780,109230,109230,108940,109230,109150,450,370,20,218.31,84
,20180523,109230,109150,108890,108890,108660,108660,108850,-490,-300,20,217.71,74
,20180524,108660,108850,,,,108850,108850,0,0,0,0.00,74
,20180525,108850,108850,108220,111580,108220,109910,109720,1060,870,40,438.91,50
,20180528,109910,109720,109200,109200,109200,109200,109200,-520,-520,2,21.84,50
,20180529,109200,109200,108600,111610,108600,111610,110570,2410,1370,52,575.00,38
,20180530,111610,110570,111470,111470,108770,110200,110360,-370,-210,30,331.11,38
,20180531,110200,110360,114850,116200,110480,113940,112760,3580,2400,26,293.19,36
ni1807,20180102,97290,97250,97970,99850,97970,99560,99060,2310,1810,10266,"101,704.56",25974
,20180103,99560,99060,100000,100860,98780,99160,99680,100,620,24336,"242,586.32",31546
,20180104,99160,99680,99200,99680,97740,99670,98870,-10,-810,21586,"213,436.63",35220
,20180105,99670,98870,100010,100150,98370,99050,99410,180,540,18896,"187,859.83",38122
,20180108,99050,99410,99010,99180,97500,99000,98480,-410,-930,16944,"166,880.32",38022
,20180109,99000,98480,98770,100150,98600,99810,99580,1330,1100,16976,"169,047.67",37904
,20180110,99810,99580,99670,101300,99330,100840,100760,1260,1180,15400,"155,180.30",39220
,20180111,100840,100760,102210,102810,101140,101830,101720,1070,960,16246,"165,270.07",40356
,20180112,101830,101720,101780,101910,99050,99970,100350,-1750,-1370,16348,"164,056.17",39760
,20180115,99970,100350,99590,101060,98960,100660,100010,310,-340,14250,"142,523.71",39760
,20180116,100660,100010,100860,100910,98190,98310,100010,-1700,0,19856,"198,597.22",44470
,20180117,98310,100010,97640,98430,96890,97450,97710,-2560,-2300,14872,"145,328.92",46558
,20180118,97450,97710,97450,97890,96990,97230,97500,-480,-210,10262,"100,061.77",46816
,20180119,97230,97500,97500,98260,96190,97320,97200,-180,-300,15298,"148,708.10",46636
,20180122,97320,97200,97850,99280,97550,98960,98540,1760,1340,14732,"145,173.09",47028
,20180123,98960,98540,99170,100230,97630,100190,98890,1650,350,17200,"170,093.68",47978
,20180124,100190,98890,99960,100220,98730,99070,99610,180,720,17236,"171,704.95",49582
,20180125,99070,99610,100340,105580,100010,105080,102830,5470,3220,27282,"280,547.08",51436
,20180126,105080,102830,104890,105100,103640,104800,104490,1970,1660,38024,"397,346.90",55622
,20180129,104800,104490,105110,107500,104200,106270,105780,1780,1290,50304,"532,150.60",60878
,20180130,106270,105780,106220,106500,103780,104220,105420,-1560,-360,39020,"411,352.78",61556
,20180131,104220,105420,104500,104910,102040,103070,103160,-2350,-2260,40950,"422,458.81",62778
,20180201,103070,103160,103070,103580,102160,102550,102860,-610,-300,34772,"357,681.01",64618
,20180202,102550,102860,102790,106160,102760,104960,104630,2100,1770,50842,"531,962.41",64980
,20180205,104960,104630,104660,104960,100470,102700,102610,-1930,-2020,59726,"612,896.54",66938
,20180206,102700,102610,103190,104660,101000,101730,102690,-880,80,60956,"625,985.14",71094
,20180207,101730,102690,101860,103850,101320,102730,102480,40,-210,45586,"467,200.49",73364
,20180208,102730,102480,102580,103050,99690,101000,101300,-1480,-1180,54586,"552,990.84",74328
,20180209,101000,101300,101190,101640,98770,99230,100590,-2070,-710,54590,"549,172.96",75620
,20180212,99230,100590,99380,100740,98300,100300,99650,-290,-940,104868,"1,045,077.81",75984
,20180213,100300,99650,100140,101600,99820,101230,100760,1580,1110,127630,"1,286,078.85",77684
,20180214,101230,100760,101680,104020,101140,104000,102710,3240,1950,137128,"1,408,444.17",75840
,20180222,104000,102710,104120,104750,102300,103310,103320,600,610,64126,"662,581.74",78068
,20180223,103310,103320,103560,105800,103410,105530,105230,2210,1910,192608,"2,026,948.29",89068
,20180226,105530,105230,105590,106090,104270,105990,105470,760,240,201704,"2,127,560.79",94302
,20180227,105990,105470,106100,107000,104840,106500,105860,1030,390,248418,"2,629,858.20",98424
,20180228,106500,105860,106150,106330,104380,105460,105480,-400,-380,284378,"2,999,898.12",99200
,20180301,105460,105480,105450,105830,103960,105230,104950,-250,-530,326920,"3,431,343.58",102292
,20180302,105230,104950,103900,104350,102140,102610,103160,-2340,-1790,421080,"4,344,077.65",113152
,20180305,102610,103160,102650,103300,101880,101940,102600,-1220,-560,395550,"4,058,717.51",120964
,20180306,101940,102600,102030,103200,101140,102830,102220,230,-380,459140,"4,693,596.63",125588
,20180307,102830,102220,103510,104020,102520,102540,103320,320,1100,473902,"4,896,490.26",138880
,20180308,102540,103320,102180,103330,100950,101250,102350,-2070,-970,570534,"5,839,617.67",149950
,20180309,101250,102350,101150,101500,100220,100820,100860,-1530,-1490,757828,"7,643,755.74",162322
,20180312,100820,100860,101540,105500,101360,104110,103450,3250,2590,818148,"8,464,165.92",177544
,20180313,104110,103450,104300,105010,103520,103910,104260,460,810,711118,"7,414,654.12",182794
,20180314,103910,104260,104680,105180,104010,104850,104610,590,350,688480,"7,202,714.31",199278
,20180315,104850,104610,105220,105230,103130,103820,104110,-790,-500,700072,"7,288,537.45",202200
,20180316,103820,104110,103610,103810,102250,103710,102980,-400,-1130,756284,"7,788,627.22",199388
,20180319,103710,102980,103750,104030,101830,102170,102660,-810,-320,897004,"9,209,155.24",207616
,20180320,102170,102660,102010,102980,101070,102750,102120,90,-540,970026,"9,906,709.72",221914
,20180321,102750,102120,102750,102860,101200,101480,101870,-640,-250,987628,"10,061,438.07",228534
,20180322,101480,101870,101200,103100,99830,101780,101650,-90,-220,1141414,"11,603,451.54",239610
,20180323,101780,101650,101100,101680,97350,98520,99380,-3130,-2270,1564108,"15,545,039.30",261262
,20180326,98520,99380,98500,99790,96310,96360,98070,-3020,-1310,1268062,"12,436,130.22",282914
,20180327,96360,98070,96200,98450,96190,97680,97330,-390,-740,934544,"9,096,413.11",277624
,20180328,97680,97330,97500,97980,96150,96600,97050,-730,-280,1070228,"10,387,522.52",296774
,20180329,96600,97050,96990,98850,96520,98810,97310,1760,260,1322386,"12,868,306.26",324542
,20180330,98810,97310,98800,99890,98150,99800,98920,2490,1610,1171256,"11,586,901.95",322588
,20180402,99800,98920,99710,101960,99520,100470,100750,1550,1830,1347636,"13,577,765.37",315644
,20180403,100470,100750,100500,101130,99700,100790,100490,40,-260,1204770,"12,107,679.25",331826
,20180404,100790,100490,100870,101330,100060,100350,100480,-140,-10,1102936,"11,082,412.20",321348
,20180409,100350,100480,99730,100450,97920,99630,98850,-850,-1630,816064,"8,067,229.24",320082
,20180410,99630,98850,99550,101530,99260,100930,100430,2080,1580,1370952,"13,768,879.16",327786
,20180411,100930,100430,101940,102250,100950,101670,101640,1240,1210,1267790,"12,886,874.99",326776
,20180412,101670,101640,101610,102840,100700,102150,101790,510,150,1769138,"18,008,722.11",339296
,20180413,102150,101790,101500,104440,101260,103760,102660,1970,870,1708386,"17,539,138.81",361512
,20180416,103760,102660,104080,104700,102840,104350,103680,1690,1020,1389812,"14,410,294.27",371574
,20180417,104350,103680,104500,105000,103220,103800,103980,120,300,1400604,"14,564,730.60",341266
,20180418,103800,103980,103000,105200,102570,104750,103720,770,-260,1738750,"18,035,698.17",389436
,20180419,104750,103720,107470,109790,106210,108120,107680,4400,3960,2273952,"24,487,089.73",394460
,20180420,108120,107680,106600,106900,103810,104260,105460,-3420,-2220,1038092,"10,948,172.99",351900
,20180423,104260,105460,104350,105490,103740,104930,104600,-530,-860,795386,"8,320,398.11",338778
,20180424,104930,104600,102650,104450,102000,103330,103380,-1270,-1220,774652,"8,008,773.73",296626
,20180425,103330,103380,103500,104500,103030,103300,103790,-80,410,654302,"6,791,431.05",296266
,20180426,103300,103790,103500,103980,102830,103350,103390,-440,-400,551602,"5,703,321.52",291750
,20180427,103350,103390,103100,104970,102930,104740,104260,1350,870,753250,"7,854,120.11",278730
,20180502,104740,104260,103850,105300,103280,105100,104330,840,70,367426,"3,833,561.04",293928
,20180503,105100,104330,104990,105690,104220,104760,104940,430,610,521086,"5,468,432.32",290706
,20180504,104760,104940,105000,105280,103400,103910,104120,-1030,-820,554832,"5,777,415.12",287648
,20180507,103910,104120,103810,104920,103130,104560,104130,440,10,574322,"5,980,974.88",302144
,20180508,104560,104130,104790,105850,103870,105160,104860,1030,730,566508,"5,940,804.26",321420
,20180509,105160,104860,104760,105080,103350,103900,104130,-960,-730,636528,"6,628,489.98",306236
,20180510,103900,104130,103990,104760,103520,103770,104190,-360,60,564144,"5,877,862.19",304732
,20180511,103770,104190,104250,104480,103620,103920,104040,-270,-150,506926,"5,274,488.45",304252
,20180514,103920,104040,104340,106750,104110,106490,105360,2450,1320,753232,"7,936,734.69",351634
,20180515,106490,105360,106670,107840,106240,107150,107060,1790,1700,685050,"7,334,613.63",348032
,20180516,107150,107060,107080,108740,106170,107740,107370,680,310,757476,"8,133,067.75",347384
,20180517,107740,107370,107700,108440,107170,107820,107870,450,500,470362,"5,073,875.12",347716
,20180518,107820,107870,108000,110430,107870,110240,109170,2370,1300,762792,"8,327,557.42",394776
,20180521,110240,109170,110320,110560,108300,108850,109230,-320,60,598134,"6,533,819.51",344154
,20180522,108850,109230,109030,109800,108130,108250,109090,-980,-140,492954,"5,377,999.80",339322
,20180523,108250,109090,109080,109400,107500,108440,108560,-650,-530,548720,"5,957,015.82",330994
,20180524,108440,108560,108220,108420,107420,108190,107950,-370,-610,473628,"5,112,843.55",318940
,20180525,108190,107950,108100,111660,108020,109880,110020,1930,2070,924190,"10,168,440.83",343102
,20180528,109880,110020,109880,110650,109020,110520,109850,500,-170,523906,"5,755,526.41",354004
,20180529,110520,109850,110350,112950,110070,112880,111590,3030,1740,671634,"7,494,801.71",407202
,20180530,112880,111590,112600,112810,111430,111650,112040,60,450,533436,"5,977,074.37",365130
,20180531,111650,112040,112020,114870,111930,114820,113760,2780,1720,732688,"8,335,415.87",378670
ni1808,20180102,98020,97960,99300,99880,99060,99380,99350,1420,1390,10,99.35,70
,20180103,99380,99350,99600,100850,99600,100000,100300,650,950,16,160.49,72
,20180104,100000,100300,98820,98820,98440,98440,98560,-1860,-1740,6,59.14,66
,20180105,98440,98560,,,,98560,98560,0,0,0,0.00,66
,20180108,98560,98560,97960,98870,97700,97700,98150,-860,-410,16,157.05,78
,20180109,97700,98150,98650,99990,98650,99910,99660,1760,1510,40,398.67,74
,20180110,99910,99660,99980,101520,99980,101110,101030,1450,1370,8,80.83,76
,20180111,101110,101030,102310,102310,101600,101600,101840,570,810,34,346.29,72
,20180112,101600,101840,102150,102150,99750,99750,101320,-2090,-520,14,141.86,70
,20180115,99750,101320,,,,101320,101320,0,0,0,0.00,70
,20180116,101320,101320,,,,99780,99780,-1540,-1540,0,0.00,70
,20180117,99780,99780,98280,98280,97910,97910,98030,-1870,-1750,6,58.82,70
,20180118,97910,98030,,,,98030,98030,0,0,0,0.00,70
,20180119,98030,98030,,,,98030,98030,0,0,0,0.00,70
,20180122,98030,98030,,,,98030,98030,0,0,0,0.00,70
,20180123,98030,98030,98060,98280,97920,98280,98080,250,50,32,313.87,84
,20180124,98280,98080,99750,99750,99160,99160,99630,1080,1550,10,99.63,74
,20180125,99160,99630,104120,104120,104120,104120,104120,4490,4490,2,20.82,74
,20180126,104120,104120,105060,105290,104290,104820,104860,700,740,38,398.50,78
,20180129,104820,104860,105100,107670,105100,107670,106920,2810,2060,36,384.94,102
,20180130,107670,106920,106350,106640,104580,104580,105880,-2340,-1040,52,550.59,88
,20180131,104580,105880,102430,102970,102420,102970,102700,-2910,-3180,10,102.70,86
,20180201,102970,102700,,,,102700,102700,0,0,0,0.00,86
,20180202,102700,102700,105000,106450,105000,105360,105730,2660,3030,26,274.92,106
,20180205,105360,105730,102110,102440,101950,102280,102200,-3450,-3530,20,204.41,100
,20180206,102280,102200,103020,103020,103020,103020,103020,820,820,2,20.60,102
,20180207,103020,103020,103020,104180,102990,102990,103130,-30,110,22,226.89,102
,20180208,102990,103130,102980,102980,102010,102010,102530,-1120,-600,30,307.62,102
,20180209,102010,102530,101970,101970,100780,100970,101340,-1560,-1190,22,222.96,110
,20180212,100970,101340,99720,100550,99070,100100,99820,-1240,-1520,36,359.39,112
,20180213,100100,99820,101030,101030,101030,101030,101030,1210,1210,2,20.21,114
,20180214,101030,101030,,,,102580,102580,1550,1550,0,0.00,114
,20180222,102580,102580,,,,102580,102580,0,0,0,0.00,114
,20180223,102580,102580,104380,105710,104380,105140,105270,2560,2690,24,252.65,108
,20180226,105140,105270,105850,106250,104980,106250,105710,980,440,16,169.14,106
,20180227,106250,105710,106220,106600,105470,106600,105940,890,230,18,190.69,108
,20180228,106600,105940,105710,106560,105420,105420,105960,-520,20,20,211.92,102
,20180301,105420,105960,105060,105760,104920,105760,105300,-200,-660,12,126.37,104
,20180302,105760,105300,102560,103470,102560,103330,103070,-1970,-2230,10,103.08,104
,20180305,103330,103070,,,,103070,103070,0,0,0,0.00,104
,20180306,103070,103070,,,,103070,103070,0,0,0,0.00,104
,20180307,103070,103070,103780,104600,102550,103660,103770,590,700,20,207.55,104
,20180308,103660,103770,102310,103320,101810,101810,102680,-1960,-1090,40,410.72,108
,20180309,101810,102680,101250,101340,100630,101310,101180,-1370,-1500,14,141.65,110
,20180312,101310,101180,101910,105000,101910,104630,104020,3450,2840,40,416.10,104
,20180313,104630,104020,,,,104020,104020,0,0,0,0.00,104
,20180314,104020,104020,104510,105010,104510,105010,104730,990,710,8,83.78,104
,20180315,105010,104730,105320,105320,104280,104460,104520,-270,-210,10,104.52,104
,20180316,104460,104520,103000,103290,103000,103280,103140,-1240,-1380,16,165.04,108
,20180319,103280,103140,103950,104030,103950,104030,103990,890,850,4,41.60,104
,20180320,104030,103990,102350,102730,102150,102150,102420,-1840,-1570,14,143.39,106
,20180321,102150,102420,102510,102510,101830,101830,102190,-590,-230,24,245.26,92
,20180322,101830,102190,101100,102780,100320,102780,101370,590,-820,16,162.20,94
,20180323,102780,101370,100110,100110,99450,99450,99630,-1920,-1740,38,378.60,120
,20180326,99450,99630,99170,99880,95700,97300,99250,-2330,-380,54,536.00,100
,20180327,97300,99250,,,,99250,99250,0,0,0,0.00,100
,20180328,99250,99250,97530,97790,97260,97260,97520,-1990,-1730,6,58.52,100
,20180329,97260,97520,97310,99690,97260,99690,97700,2170,180,22,214.95,104
,20180330,99690,97700,98630,99170,98630,99170,98880,1470,1180,18,177.99,100
,20180402,99170,98880,100380,102090,99690,100920,100970,2040,2090,28,282.72,110
,20180403,100920,100970,100850,100900,100110,100670,100670,-300,-300,40,402.68,124
,20180404,100670,100670,101060,101060,100270,100820,100780,150,110,16,161.25,114
,20180409,100820,100780,,,,100780,100780,0,0,0,0.00,114
,20180410,100780,100780,99700,101770,99700,101280,100730,500,-50,16,161.18,120
,20180411,101280,100730,102290,102290,101250,101250,101590,520,860,34,345.43,94
,20180412,101250,101590,101400,101550,101400,101480,101490,-110,-100,14,142.10,80
,20180413,101480,101490,103870,104290,103870,103960,103950,2470,2460,12,124.75,82
,20180416,103960,103950,104000,104000,103460,103600,103710,-350,-240,8,82.97,82
,20180417,103600,103710,105060,105060,103170,104340,104090,630,380,12,124.91,80
,20180418,104340,104090,104680,104680,103750,103750,104170,-340,80,20,208.34,86
,20180419,103750,104170,106980,109780,106920,108040,108110,3870,3940,120,"1,297.39",104
,20180420,108040,108110,106750,106920,106200,106200,106560,-1910,-1550,16,170.51,100
,20180423,106200,106560,105500,105500,104730,104980,105200,-1580,-1360,16,168.33,100
,20180424,104980,105200,103990,103990,103960,103960,103960,-1240,-1240,8,83.17,104
,20180425,103960,103960,104420,104420,103330,103330,103980,-630,20,34,353.54,106
,20180426,103330,103980,103440,103720,103200,103660,103360,-320,-620,32,330.77,132
,20180427,103660,103360,103250,104680,103250,104260,104250,900,890,78,813.19,148
,20180502,104260,104250,103780,104660,103160,104530,103850,280,-400,42,436.18,128
,20180503,104530,103850,104820,104940,104420,104440,104600,590,750,108,"1,129.71",122
,20180504,104440,104600,104570,104570,104000,104000,104280,-600,-320,4,41.71,118
,20180507,104000,104280,103430,104500,103200,104500,103810,220,-470,54,560.59,120
,20180508,104500,103810,104320,105420,103700,105000,104550,1190,740,52,543.70,142
,20180509,105000,104550,104520,104520,103470,103700,103950,-850,-600,16,166.32,134
,20180510,103700,103950,103660,103660,103660,103660,103660,-290,-290,2,20.73,132
,20180511,103660,103660,,,,103660,103660,0,0,0,0.00,132
,20180514,103660,103660,105350,106250,104640,106250,105700,2590,2040,34,359.38,140
,20180515,106250,105700,106510,107130,106510,107130,106830,1430,1130,8,85.47,140
,20180516,107130,106830,106600,107410,106280,107000,106780,170,-50,28,298.99,138
,20180517,107000,106780,,,,107270,107270,490,490,0,0.00,138
,20180518,107270,107270,107940,110000,107940,110000,109310,2730,2040,22,240.50,144
,20180521,110000,109310,108560,108840,108490,108800,108680,-510,-630,10,108.69,142
,20180522,108800,108680,108380,108380,108000,108000,108250,-680,-430,12,129.90,130
,20180523,108000,108250,108730,108890,107660,107750,108250,-500,0,8,86.61,126
,20180524,107750,108250,,,,108250,108250,0,0,0,0.00,126
,20180525,108250,108250,109920,110020,109370,110000,109810,1750,1560,22,241.59,134
,20180528,110000,109810,,,,109810,109810,0,0,0,0.00,134
,20180529,109810,109810,110670,112100,110670,111460,111420,1650,1610,26,289.70,144
,20180530,111460,111420,111370,111450,111000,111000,111260,-420,-160,12,133.52,138
,20180531,111000,111260,112890,113800,112870,113780,113300,2520,2040,48,543.88,142
ni1809,20180102,97630,97800,99000,100150,98960,99880,99470,2080,1670,3498,"34,795.45",21910
,20180103,99880,99470,100420,100790,99080,99420,99840,-50,370,7044,"70,328.79",23674
,20180104,99420,99840,99410,100030,98120,100030,99030,190,-810,5380,"53,280.69",24216
,20180105,100030,99030,100250,100460,98750,99420,99750,390,720,4174,"41,637.20",24448
,20180108,99420,99750,99240,99540,97980,99450,98950,-300,-800,4220,"41,760.32",25448
,20180109,99450,98950,99190,100500,99000,100220,100080,1270,1130,8392,"83,992.27",29152
,20180110,100220,100080,100060,101740,99850,101360,101220,1280,1140,5144,"52,068.30",30578
,20180111,101360,101220,102860,103060,101650,102320,102220,1100,1000,6416,"65,586.65",33084
,20180112,102320,102220,102220,102370,99540,100500,100660,-1720,-1560,7092,"71,388.45",33854
,20180115,100500,100660,100340,101500,99330,101140,100600,480,-60,5426,"54,590.08",35314
,20180116,101140,100600,101140,101350,98640,98740,100110,-1860,-490,7492,"75,005.98",35822
,20180117,98740,100110,98000,98860,97310,97830,98030,-2280,-2080,7576,"74,272.95",37328
,20180118,97830,98030,97850,98300,97460,97650,97980,-380,-50,5428,"53,185.05",38630
,20180119,97650,97980,97900,98680,96620,97800,97680,-180,-300,7514,"73,399.27",39996
,20180122,97800,97680,98220,99680,97990,99290,98860,1610,1180,6970,"68,912.35",41166
,20180123,99290,98860,99290,100500,98010,100500,99300,1640,440,7058,"70,087.84",42826
,20180124,100500,99300,99990,100490,99040,99450,99930,150,630,6126,"61,218.43",43894
,20180125,99450,99930,100700,105830,100330,105420,103220,5490,3290,19526,"201,566.67",50410
,20180126,105420,103220,104900,105440,104010,105130,104790,1910,1570,7146,"74,883.37",51108
,20180129,105130,104790,105400,107750,104360,106630,106040,1840,1250,9842,"104,368.05",52384
,20180130,106630,106040,106580,106760,104190,104610,105500,-1430,-540,10518,"110,969.00",52438
,20180131,104610,105500,104890,105160,102400,103510,103630,-1990,-1870,18028,"186,839.32",53844
,20180201,103510,103630,104000,104010,102470,102940,103260,-690,-370,7092,"73,236.67",53830
,20180202,102940,103260,103230,106590,103140,105300,105260,2040,2000,15268,"160,723.29",55748
,20180205,105300,105260,105000,105350,100800,103200,102850,-2060,-2410,26476,"272,321.31",59490
,20180206,103200,102850,103430,105200,101450,102110,103180,-740,330,22548,"232,660.80",63146
,20180207,102110,103180,102080,104110,101780,103100,102910,-80,-270,15710,"161,679.89",63980
,20180208,103100,102910,103050,103270,100080,101290,101610,-1620,-1300,19710,"200,273.34",65500
,20180209,101290,101610,101290,101960,99180,99570,100840,-2040,-770,19782,"199,482.03",68072
,20180212,99570,100840,99580,100970,98600,100640,99920,-200,-920,21352,"213,368.20",70624
,20180213,100640,99920,100400,101890,100100,101480,101070,1560,1150,15728,"158,973.19",70570
,20180214,101480,101070,101900,104200,101490,104200,103020,3130,1950,16448,"169,455.18",71232
,20180222,104200,103020,106500,106500,102600,103590,103810,570,790,15950,"165,577.46",72590
,20180223,103590,103810,103810,106080,103700,105790,105430,1980,1620,32154,"339,030.03",76502
,20180226,105790,105430,105950,106340,104620,106280,105720,850,290,29682,"313,807.80",77142
,20180227,106280,105720,106310,107330,105000,106830,106260,1110,540,32826,"348,829.60",77166
,20180228,106830,106260,106560,106680,104760,105820,105770,-440,-490,34458,"364,496.17",78430
,20180301,105820,105770,105730,106160,104320,105600,105290,-170,-480,28260,"297,566.72",79154
,20180302,105600,105290,104500,104700,102500,103010,103540,-2280,-1750,41368,"428,347.10",80284
,20180305,103010,103540,103100,103710,102240,102280,103050,-1260,-490,39150,"403,441.30",83142
,20180306,102280,103050,102200,103650,101520,103280,102660,230,-390,47448,"487,120.94",88652
,20180307,103280,102660,103890,104390,102900,102900,103710,240,1050,35292,"366,016.13",89858
,20180308,102900,103710,102500,103670,101250,101690,102640,-2020,-1070,44412,"455,864.18",94570
,20180309,101690,102640,101590,101940,100680,101370,101320,-1270,-1320,46912,"475,335.21",96330
,20180312,101370,101320,102030,105770,101810,104560,103940,3240,2620,72664,"755,341.80",100848
,20180313,104560,103940,104790,105380,104010,104360,104660,420,720,48580,"508,449.54",107680
,20180314,104360,104660,105090,105650,104500,105370,105100,710,440,51878,"545,279.87",116262
,20180315,105370,105100,105710,105710,103670,104350,104570,-750,-530,60542,"633,126.65",124194
,20180316,104350,104570,104000,104280,102720,104150,103570,-420,-1000,58968,"610,740.06",132538
,20180319,104150,103570,104290,104440,102350,102640,103120,-930,-450,68430,"705,704.54",139590
,20180320,102640,103120,102540,103450,101570,103260,102610,140,-510,67760,"695,288.49",145250
,20180321,103260,102610,103260,103320,101700,101990,102360,-620,-250,61098,"625,426.79",147990
,20180322,101990,102360,101890,103580,99000,102230,102120,-130,-240,94324,"963,285.77",152080
,20180323,102230,102120,101540,102170,97760,98930,99710,-3190,-2410,129532,"1,291,632.01",153268
,20180326,98930,99710,99000,100180,96730,96870,98340,-2840,-1370,98632,"969,996.02",162858
,20180327,96870,98340,96780,98880,96510,98130,97830,-210,-510,66836,"653,903.61",163804
,20180328,98130,97830,97830,98420,96650,97050,97510,-780,-320,69300,"675,784.18",166098
,20180329,97050,97510,97610,99300,96970,99300,97790,1790,280,97986,"958,261.77",171626
,20180330,99300,97790,99210,100300,98600,100240,99380,2450,1590,72702,"722,560.95",172316
,20180402,100240,99380,99980,102360,99950,100850,101170,1470,1790,73328,"741,868.01",175032
,20180403,100850,101170,100850,101520,100020,101180,100880,10,-290,63196,"637,558.32",179676
,20180404,101180,100880,101110,101780,100480,100780,100870,-100,-10,56546,"570,428.12",180432
,20180409,100780,100870,100410,100770,98380,100020,99310,-850,-1560,70738,"702,530.51",182678
,20180410,100020,99310,100000,101880,99660,101360,100890,2050,1580,90326,"911,384.84",185018
,20180411,101360,100890,102360,102670,101340,102050,102040,1160,1150,87678,"894,719.59",189870
,20180412,102050,102040,102100,103230,101120,102580,102160,540,120,132286,"1,351,556.32",197934
,20180413,102580,102160,101800,104770,101650,104180,103320,2020,1160,130226,"1,345,510.23",206048
,20180416,104180,103320,104580,105060,103280,104800,104150,1480,830,119598,"1,245,665.27",215250
,20180417,104800,104150,104980,105480,103750,104350,104490,200,340,121942,"1,274,182.84",216260
,20180418,104350,104490,103470,105680,103060,105280,104300,790,-190,153732,"1,603,486.33",220904
,20180419,105280,104300,108480,110240,106700,108390,108160,4090,3860,335824,"3,632,412.47",227206
,20180420,108390,108160,106800,107200,104240,104620,105730,-3540,-2430,205524,"2,173,204.69",220972
,20180423,104620,105730,104650,105910,104170,105310,105040,-420,-690,137218,"1,441,396.24",217736
,20180424,105310,105040,102910,104760,102380,103590,103710,-1450,-1330,163608,"1,696,836.34",221700
,20180425,103590,103710,103750,104750,103330,103530,104050,-180,340,108662,"1,130,715.68",221176
,20180426,103530,104050,103700,104250,103100,103300,103570,-750,-480,106744,"1,105,648.57",218666
,20180427,103300,103570,103250,104760,103000,104200,103960,630,390,157474,"1,637,225.55",214598
,20180502,104200,103960,103510,104800,102820,104510,103860,550,-100,97808,"1,015,868.21",221864
,20180503,104510,103860,104520,105020,103720,104240,104370,380,510,99176,"1,035,161.63",222244
,20180504,104240,104370,104550,104770,103150,103760,103860,-610,-510,121588,"1,262,822.03",216370
,20180507,103760,103860,103500,104500,103000,104100,103920,240,60,114590,"1,190,926.74",219192
,20180508,104100,103920,104500,105180,103370,104680,104320,760,400,122346,"1,276,419.87",224986
,20180509,104680,104320,104180,104540,102820,103450,103610,-870,-710,138896,"1,439,183.31",221968
,20180510,103450,103610,103500,104180,103110,103330,103660,-280,50,99770,"1,034,251.94",219624
,20180511,103330,103660,103750,103960,103230,103450,103580,-210,-80,94698,"980,925.87",222846
,20180514,103450,103580,103900,106190,103600,106030,104920,2450,1340,157738,"1,655,015.36",228394
,20180515,106030,104920,106150,107220,105730,106680,106500,1760,1580,149210,"1,589,197.71",229534
,20180516,106680,106500,106500,108200,105760,107250,106920,750,420,156704,"1,675,607.13",234132
,20180517,107250,106920,107250,107880,106710,107280,107360,360,440,89630,"962,344.47",236308
,20180518,107280,107360,107400,109900,107350,109700,108720,2340,1360,198272,"2,155,742.86",256424
,20180521,109700,108720,109820,109970,107730,108330,108660,-390,-60,166380,"1,808,049.40",255280
,20180522,108330,108660,108420,109200,107660,107740,108530,-920,-130,122650,"1,331,224.40",258314
,20180523,107740,108530,108500,108850,107080,108050,108000,-480,-530,152590,"1,648,020.35",266080
,20180524,108050,108000,107540,107900,107010,107810,107510,-190,-490,123994,"1,333,130.43",266618
,20180525,107810,107510,107790,110950,107610,109300,109440,1790,1930,267246,"2,924,986.20",288952
,20180528,109300,109440,109400,109990,108480,109850,109230,410,-210,147938,"1,616,057.51",293292
,20180529,109850,109230,109650,112080,109450,111980,110920,2750,1690,219210,"2,431,564.66",314242
,20180530,111980,110920,111740,111900,110510,110800,111140,-120,220,209802,"2,331,754.83",307216
,20180531,110800,111140,111020,113690,111020,113660,112740,2520,1600,324796,"3,661,879.37",338172
ni1810,20180102,98050,97900,98900,100270,98900,100270,99420,2370,1520,32,318.15,88
,20180103,100270,99420,99950,100840,99950,99960,100310,540,890,24,240.76,88
,20180104,99960,100310,99360,99550,98610,99550,99200,-760,-1110,20,198.41,98
,20180105,99550,99200,,,,99200,99200,0,0,0,0.00,98
,20180108,99200,99200,,,,99200,99200,0,0,0,0.00,98
,20180109,99200,99200,99680,100220,99680,100020,100000,820,800,32,320.01,118
,20180110,100020,100000,101100,101460,100910,101320,101190,1320,1190,56,566.69,150
,20180111,101320,101190,102580,102580,101840,102300,102240,1110,1050,36,368.08,172
,20180112,102300,102240,101980,101980,99780,99780,100570,-2460,-1670,24,241.38,176
,20180115,99780,100570,100170,100400,100160,100250,100220,-320,-350,20,200.44,182
,20180116,100250,100220,100670,101130,99270,99270,100350,-950,130,6,60.21,182
,20180117,99270,100350,98420,98520,98420,98520,98440,-1830,-1910,10,98.44,188
,20180118,98520,98440,,,,98440,98440,0,0,0,0.00,188
,20180119,98440,98440,98630,98630,96640,97160,96880,-1280,-1560,46,445.66,212
,20180122,97160,96880,98360,99420,98360,99420,98640,2540,1760,24,236.75,220
,20180123,99420,98640,99580,99580,98870,98870,99200,230,560,14,138.88,214
,20180124,98870,99200,100380,100380,99400,99400,99870,200,670,22,219.71,198
,20180125,99400,99870,100200,105450,100190,105450,101590,5580,1720,94,954.96,244
,20180126,105450,101590,105370,105370,104490,104980,104850,3390,3260,36,377.48,240
,20180129,104980,104850,105080,105080,104840,104840,105020,-10,170,8,84.02,240
,20180130,104840,105020,105940,105940,105270,105270,105670,250,650,10,105.67,244
,20180131,105270,105670,103050,103160,102920,103160,103040,-2510,-2630,8,82.44,242
,20180201,103160,103040,,,,103040,103040,0,0,0,0.00,242
,20180202,103040,103040,,,,104590,104590,1550,1550,0,0.00,242
,20180205,104590,104590,102370,102530,102370,102530,102420,-2060,-2170,6,61.45,242
,20180206,102530,102420,103280,104770,102280,102280,103270,-140,850,36,371.79,250
,20180207,102280,103270,103390,103390,103390,103390,103390,120,120,4,41.36,246
,20180208,103390,103390,102390,102680,100500,101760,101120,-1630,-2270,70,707.87,212
,20180209,101760,101120,101970,101970,100190,100190,100960,-930,-160,14,141.34,216
,20180212,100190,100960,99900,101650,99700,101650,100560,690,-400,20,201.13,216
,20180213,101650,100560,100550,100550,100540,100540,100540,-20,-20,8,80.43,208
,20180214,100540,100540,102000,103700,101910,103620,103040,3080,2500,16,164.87,198
,20180222,103620,103040,111260,111280,103310,103540,106020,500,2980,172,"1,823.58",230
,20180223,103540,106020,104680,106150,104680,105780,105410,-240,-610,70,737.90,208
,20180226,105780,105410,107250,107250,107220,107220,107230,1810,1820,4,42.89,208
,20180227,107220,107230,105840,105840,105630,105810,105760,-1420,-1470,6,63.46,208
,20180228,105810,105760,106390,106390,104980,105380,105570,-380,-190,16,168.92,210
,20180301,105380,105570,,,,105570,105570,0,0,0,0.00,210
,20180302,105570,105570,104230,104450,102970,103130,103500,-2440,-2070,22,227.70,212
,20180305,103130,103500,103530,103530,102800,102800,103040,-700,-460,6,61.83,206
,20180306,102800,103040,102630,103030,102630,103030,102680,-10,-360,14,143.76,208
,20180307,103030,102680,103930,103930,103930,103930,103930,1250,1250,4,41.57,208
,20180308,103930,103930,101300,102770,101300,101620,102040,-2310,-1890,12,122.45,210
,20180309,101620,102040,101420,102000,101420,102000,101640,-40,-400,6,60.98,212
,20180312,102000,101640,102230,104630,100760,104630,103170,2990,1530,42,433.35,218
,20180313,104630,103170,,,,103170,103170,0,0,0,0.00,218
,20180314,103170,103170,105200,105850,104900,105850,105440,2680,2270,30,316.34,222
,20180315,105850,105440,104590,105440,103980,103980,104630,-1460,-810,8,83.71,220
,20180316,103980,104630,104050,104050,103440,103440,103640,-1190,-990,6,62.19,218
,20180319,103440,103640,103210,103490,103210,103490,103350,-150,-290,4,41.34,218
,20180320,103490,103350,102600,103330,102460,103330,102730,-20,-620,12,123.28,220
,20180321,103330,102730,102500,102500,102500,102500,102500,-230,-230,4,41.00,216
,20180322,102500,102500,101500,102940,101490,102450,102360,-50,-140,24,245.68,218
,20180323,102450,102360,100080,100080,98100,98930,99230,-3430,-3130,100,992.35,178
,20180326,98930,99230,99300,99300,97000,97000,97810,-2230,-1420,48,469.51,156
,20180327,97000,97810,97150,97150,97150,97150,97150,-660,-660,4,38.86,154
,20180328,97150,97150,,,,97150,97150,0,0,0,0.00,154
,20180329,97150,97150,98020,99600,97590,99600,98210,2450,1060,8,78.57,152
,20180330,99600,98210,99600,100850,98990,100850,99480,2640,1270,34,338.26,138
,20180402,100850,99480,100420,102860,100410,101450,101830,1970,2350,182,"1,853.43",176
,20180403,101450,101830,101770,101770,100860,100860,101110,-970,-720,28,283.11,186
,20180404,100860,101110,101540,101540,100900,100900,101060,-210,-50,8,80.85,186
,20180409,100900,101060,99320,100530,99320,100530,99800,-530,-1260,12,119.76,190
,20180410,100530,99800,100550,102150,100140,101740,101240,1940,1440,122,"1,235.20",194
,20180411,101740,101240,102380,102760,101700,102200,102290,960,1050,92,941.08,192
,20180412,102200,102290,102160,103290,101640,102680,102640,390,350,58,595.34,184
,20180413,102680,102640,102260,104500,102260,104440,103530,1800,890,48,496.95,202
,20180416,104440,103530,104280,104830,103630,104760,104200,1230,670,190,"1,979.84",210
,20180417,104760,104200,104710,105060,103780,104120,104550,-80,350,86,899.17,228
,20180418,104120,104550,104090,105890,103230,105710,104620,1160,70,222,"2,322.64",258
,20180419,105710,104620,108160,110210,107090,108830,108310,4210,3690,406,"4,397.74",370
,20180420,108830,108310,106810,106990,104820,104910,106490,-3400,-1820,158,"1,682.63",284
,20180423,104910,106490,104490,105930,104490,105580,105430,-910,-1060,80,843.46,308
,20180424,105580,105430,103070,104450,102670,104150,103610,-1280,-1820,562,"5,822.94",274
,20180425,104150,103610,104040,104640,103430,104120,104220,510,610,42,437.74,262
,20180426,104120,104220,103960,103960,103500,103500,103550,-720,-670,118,"1,221.90",216
,20180427,103500,103550,103510,104600,103480,103560,104010,10,460,204,"2,121.81",322
,20180502,103560,104010,103330,104450,103330,104450,103880,440,-130,10,103.88,322
,20180503,104450,103880,104420,104670,103560,103950,104200,70,320,148,"1,542.22",316
,20180504,103950,104200,104250,104250,103140,103690,103590,-510,-610,134,"1,388.20",274
,20180507,103690,103590,103450,104320,103240,104190,103530,600,-60,106,"1,097.43",250
,20180508,104190,103530,104180,104910,103410,104320,104160,790,630,30,312.50,250
,20180509,104320,104160,104040,104040,102800,103310,103460,-850,-700,50,517.34,234
,20180510,103310,103460,103460,103960,103270,103270,103670,-190,210,26,269.56,232
,20180511,103270,103670,103610,103610,103040,103240,103270,-430,-400,18,185.89,232
,20180514,103240,103270,103950,106100,103950,105810,104840,2540,1570,88,922.60,236
,20180515,105810,104840,105920,107060,105750,106350,106260,1510,1420,138,"1,466.46",192
,20180516,106350,106260,106110,107860,105800,107160,106720,900,460,108,"1,152.67",240
,20180517,107160,106720,108300,108300,106490,106980,107400,260,680,192,"2,062.10",226
,20180518,106980,107400,107650,109430,107550,109260,108250,1860,850,170,"1,840.42",228
,20180521,109260,108250,109290,109460,107470,108310,108940,60,690,66,719.00,234
,20180522,108310,108940,108170,108840,107410,107410,108320,-1530,-620,54,584.95,236
,20180523,107410,108320,108360,108620,106990,107770,107940,-550,-380,60,647.67,250
,20180524,107770,107940,107240,107490,107240,107490,107330,-450,-610,30,321.99,256
,20180525,107490,107330,107650,110500,107650,109030,109380,1700,2050,192,"2,100.24",282
,20180528,109030,109380,108800,109840,108340,109560,108980,180,-400,58,632.14,278
,20180529,109560,108980,109600,111690,109540,111470,110720,2490,1740,266,"2,945.28",322
,20180530,111470,110720,111470,111470,110210,110300,110790,-420,70,90,997.14,340
,20180531,110300,110790,111500,113290,111470,113150,112400,2360,1610,490,"5,507.77",404
ni1811,20180102,98410,98410,99610,99610,99500,99500,99570,1090,1160,12,119.49,36
,20180103,99500,99570,99770,99770,99750,99750,99760,180,190,6,59.86,38
,20180104,99750,99760,99070,99070,99070,99070,99070,-690,-690,2,19.81,36
,20180105,99070,99070,,,,99070,99070,0,0,0,0.00,36
,20180108,99070,99070,,,,99070,99070,0,0,0,0.00,36
,20180109,99070,99070,100120,100260,100120,100260,100190,1190,1120,4,40.08,38
,20180110,100260,100190,101600,101600,101600,101600,101600,1410,1410,2,20.32,40
,20180111,101600,101600,,,,101600,101600,0,0,0,0.00,40
,20180112,101600,101600,100680,100680,100680,100680,100680,-920,-920,2,20.14,40
,20180115,100680,100680,,,,100680,100680,0,0,0,0.00,40
,20180116,100680,100680,101220,101220,101220,101220,101220,540,540,2,20.24,40
,20180117,101220,101220,98370,98830,98370,98830,98600,-2390,-2620,4,39.44,40
,20180118,98830,98600,,,,98600,98600,0,0,0,0.00,40
,20180119,98600,98600,,,,98600,98600,0,0,0,0.00,40
,20180122,98600,98600,,,,100390,100390,1790,1790,0,0.00,40
,20180123,100390,100390,98610,98610,98610,98610,98610,-1780,-1780,8,78.89,48
,20180124,98610,98610,,,,98770,98770,160,160,0,0.00,48
,20180125,98770,98770,,,,104690,104690,5920,5920,0,0.00,48
,20180126,104690,104690,105630,105630,105010,105010,105190,320,500,10,105.19,54
,20180129,105010,105190,105520,108100,105180,107340,106730,2150,1540,16,170.77,58
,20180130,107340,106730,106980,106980,105550,105550,106320,-1180,-410,8,85.06,58
,20180131,105550,106320,103690,103690,103370,103370,103530,-2950,-2790,4,41.41,58
,20180201,103370,103530,,,,103530,103530,0,0,0,0.00,58
,20180202,103530,103530,106300,106300,105380,105380,105710,1850,2180,10,105.71,58
,20180205,105380,105710,,,,104330,104330,-1380,-1380,0,0.00,58
,20180206,104330,104330,104880,104880,102490,102490,103370,-1840,-960,6,62.03,60
,20180207,102490,103370,,,,103370,103370,0,0,0,0.00,60
,20180208,103370,103370,101000,101000,101000,101000,101000,-2370,-2370,2,20.20,62
,20180209,101000,101000,100530,100530,100530,100530,100530,-470,-470,2,20.11,62
,20180212,100530,100530,100120,100230,99910,100170,100090,-360,-440,24,240.22,56
,20180213,100170,100090,100660,101710,100660,101710,101340,1620,1250,14,141.88,64
,20180214,101710,101340,101910,103850,101910,103780,102930,2440,1590,18,185.28,72
,20180222,103780,102930,104220,104230,104220,104230,104220,1300,1290,8,83.38,78
,20180223,104230,104220,104850,106000,104850,106000,105180,1780,960,14,147.26,86
,20180226,106000,105180,105970,105970,105670,105670,105770,490,590,6,63.46,86
,20180227,105670,105770,107250,107250,107000,107000,107120,1230,1350,4,42.85,90
,20180228,107000,107120,,,,107120,107120,0,0,0,0.00,90
,20180301,107120,107120,105000,105510,105000,105510,105120,-1610,-2000,8,84.10,90
,20180302,105510,105120,103690,103860,103220,103550,103560,-1570,-1560,12,124.27,92
,20180305,103550,103560,,,,103560,103560,0,0,0,0.00,92
,20180306,103560,103560,,,,103560,103560,0,0,0,0.00,92
,20180307,103560,103560,,,,103560,103560,0,0,0,0.00,92
,20180308,103560,103560,,,,103170,103170,-390,-390,0,0.00,92
,20180309,103170,103170,,,,102390,102390,-780,-780,0,0.00,92
,20180312,102390,102390,103080,105100,103080,105100,104310,2710,1920,6,62.59,92
,20180313,105100,104310,,,,104310,104310,0,0,0,0.00,92
,20180314,104310,104310,105560,105560,105560,105560,105560,1250,1250,2,21.11,90
,20180315,105560,105560,,,,104750,104750,-810,-810,0,0.00,90
,20180316,104750,104750,104020,104020,104020,104020,104020,-730,-730,8,83.22,90
,20180319,104020,104020,102860,103520,102610,103520,102920,-500,-1100,12,123.51,98
,20180320,103520,102920,,,,102920,102920,0,0,0,0.00,98
,20180321,102920,102920,102940,102940,102400,102400,102760,-520,-160,6,61.66,96
,20180322,102400,102760,,,,102760,102760,0,0,0,0.00,96
,20180323,102760,102760,97890,99210,97890,99210,99080,-3550,-3680,30,297.24,80
,20180326,99210,99080,100000,100080,99800,99800,99960,720,880,6,59.98,78
,20180327,99800,99960,,,,99470,99470,-490,-490,0,0.00,78
,20180328,99470,99470,97000,97000,97000,97000,97000,-2470,-2470,4,38.80,74
,20180329,97000,97000,,,,97670,97670,670,670,0,0.00,74
,20180330,97670,97670,99090,100100,99090,100100,99730,2430,2060,10,99.74,76
,20180402,100100,99730,101810,101810,101810,101810,101810,2080,2080,4,40.72,80
,20180403,101810,101810,,,,101810,101810,0,0,0,0.00,80
,20180404,101810,101810,,,,101810,101810,0,0,0,0.00,80
,20180409,101810,101810,,,,101810,101810,0,0,0,0.00,80
,20180410,101810,101810,101400,101600,101400,101600,101520,-210,-290,10,101.52,86
,20180411,101600,101520,103080,103080,101760,101760,102020,240,500,12,122.43,88
,20180412,101760,102020,101920,103070,101920,103070,102510,1050,490,12,123.02,84
,20180413,103070,102510,103070,103070,103070,103070,103070,560,560,4,41.23,88
,20180416,103070,103070,104600,105330,103680,105000,104520,1930,1450,5640,"58,950.10",3302
,20180417,105000,104520,106190,106190,104210,104750,104940,230,420,6216,"65,236.57",6796
,20180418,104750,104940,104130,106070,103560,105550,104690,610,-250,7590,"79,460.53",10038
,20180419,105550,104690,108200,110760,107140,108890,108530,4200,3840,28204,"306,114.72",18278
,20180420,108890,108530,107990,107990,104680,105040,106160,-3490,-2370,33430,"354,907.70",23026
,20180423,105040,106160,105050,106250,104590,105660,105410,-500,-750,44540,"469,512.77",27160
,20180424,105660,105410,103790,105040,102810,103990,104180,-1420,-1230,51396,"535,456.51",33122
,20180425,103990,104180,104120,105130,103660,103860,104410,-320,230,53946,"563,277.53",38254
,20180426,103860,104410,104010,104460,103290,103320,103800,-1090,-610,63994,"664,305.87",46794
,20180427,103320,103800,103300,104710,102930,103710,103800,-90,0,62178,"645,418.91",49178
,20180502,103710,103800,103010,104360,102430,104010,103450,210,-350,34400,"355,891.67",54188
,20180503,104010,103450,103830,104440,103270,103750,103890,300,440,47114,"489,479.87",58624
,20180504,103750,103890,104010,104140,102940,103680,103500,-210,-390,59000,"610,653.06",65704
,20180507,103680,103500,103650,104320,103000,103720,103690,220,190,60012,"622,274.78",72018
,20180508,103720,103690,103880,104690,103010,104270,103880,580,190,56472,"586,670.35",76814
,20180509,104270,103880,103920,104090,102490,103080,103280,-800,-600,59174,"611,196.74",75196
,20180510,103080,103280,103100,103730,102790,103030,103300,-250,20,48350,"499,484.19",74402
,20180511,103030,103300,103300,103590,102860,103110,103230,-190,-70,47676,"492,185.88",74924
,20180514,103110,103230,103360,105750,103310,105600,104480,2370,1250,65768,"687,190.70",74008
,20180515,105600,104480,105700,106800,105400,106320,106130,1840,1650,65962,"700,103.84",73430
,20180516,106320,106130,106280,107830,105390,106830,106460,700,330,73114,"778,439.40",73396
,20180517,106830,106460,106790,107480,106400,106940,107000,480,540,54762,"585,959.71",73196
,20180518,106940,107000,107120,109460,107000,109360,108260,2360,1260,75642,"818,927.21",77762
,20180521,109360,108260,109390,109570,107410,107910,108290,-350,30,66614,"721,417.27",76270
,20180522,107910,108290,108100,108830,107300,107400,108200,-890,-90,53874,"582,958.20",77330
,20180523,107400,108200,107830,108480,106810,107690,107740,-510,-460,69826,"752,326.15",78818
,20180524,107690,107740,107520,107620,106780,107510,107240,-230,-500,61788,"662,637.43",80538
,20180525,107510,107240,107460,110640,107370,109040,109130,1800,1890,104376,"1,139,156.24",81810
,20180528,109040,109130,109140,109650,108200,109480,108920,350,-210,66558,"725,002.47",83694
,20180529,109480,108920,109300,111670,109120,111550,110410,2630,1490,71424,"788,609.63",84932
,20180530,111550,110410,111400,111460,110110,110270,110680,-140,270,70572,"781,118.08",82470
,20180531,110270,110680,110500,113140,110470,113000,112160,2320,1480,100134,"1,123,170.07",84814
ni1812,20180102,98100,98100,,,,98430,98430,330,330,0,0.00,20
,20180103,98430,98430,100450,100450,100450,100450,100450,2020,2020,2,20.09,20
,20180104,100450,100450,,,,100450,100450,0,0,0,0.00,20
,20180105,100450,100450,,,,100450,100450,0,0,0,0.00,20
,20180108,100450,100450,98600,98600,98600,98600,98600,-1850,-1850,2,19.72,20
,20180109,98600,98600,,,,98600,98600,0,0,0,0.00,20
,20180110,98600,98600,,,,99850,99850,1250,1250,0,0.00,20
,20180111,99850,99850,,,,100630,100630,780,780,0,0.00,20
,20180112,100630,100630,,,,100630,100630,0,0,0,0.00,20
,20180115,100630,100630,101200,101390,100960,101340,101260,710,630,24,243.03,24
,20180116,101340,101260,101350,101350,99390,99600,100200,-1660,-1060,16,160.32,38
,20180117,99600,100200,,,,99150,99150,-1050,-1050,0,0.00,38
,20180118,99150,99150,98120,98630,98100,98100,98280,-1050,-870,6,58.97,40
,20180119,98100,98280,,,,98280,98280,0,0,0,0.00,40
,20180122,98280,98280,,,,98280,98280,0,0,0,0.00,40
,20180123,98280,98280,100200,100200,98760,98760,99480,480,1200,4,39.79,38
,20180124,98760,99480,100500,100900,99680,99680,100290,200,810,14,140.41,42
,20180125,99680,100290,104700,106020,104700,106020,105360,5730,5070,4,42.14,40
,20180126,106020,105360,104900,104900,104900,104900,104900,-460,-460,2,20.98,38
,20180129,104900,104900,,,,105190,105190,290,290,0,0.00,38
,20180130,105190,105190,,,,105190,105190,0,0,0,0.00,38
,20180131,105190,105190,,,,104670,104670,-520,-520,0,0.00,38
,20180201,104670,104670,103770,103770,103210,103210,103350,-1460,-1320,8,82.68,46
,20180202,103210,103350,106250,106350,105860,106350,106170,3000,2820,16,169.88,52
,20180205,106350,106170,105690,105690,101150,103230,103180,-2940,-2990,14,144.45,54
,20180206,103230,103180,103740,104810,102530,102530,104000,-650,820,12,124.80,60
,20180207,102530,104000,103280,103330,103280,103330,103300,-670,-700,4,41.32,62
,20180208,103330,103300,,,,103300,103300,0,0,0,0.00,62
,20180209,103300,103300,,,,101600,101600,-1700,-1700,0,0.00,62
,20180212,101600,101600,100950,101750,100950,101530,101410,-70,-190,12,121.70,58
,20180213,101530,101410,102090,102510,102090,102510,102220,1100,810,20,204.45,46
,20180214,102510,102220,103870,104450,103870,104450,104220,2230,2000,8,83.38,48
,20180222,104450,104220,104890,104890,104890,104890,104890,670,670,2,20.98,48
,20180223,104890,104890,105670,106300,105670,106300,105900,1410,1010,10,105.90,48
,20180226,106300,105900,106800,106800,106800,106800,106800,900,900,2,21.36,48
,20180227,106800,106800,,,,106800,106800,0,0,0,0.00,48
,20180228,106800,106800,106000,106000,106000,106000,106000,-800,-800,2,21.20,46
,20180301,106000,106000,,,,106000,106000,0,0,0,0.00,46
,20180302,106000,106000,104770,104770,104770,104770,104770,-1230,-1230,2,20.95,44
,20180305,104770,104770,104000,104000,104000,104000,104000,-770,-770,4,41.60,44
,20180306,104000,104000,103520,103520,103520,103520,103520,-480,-480,4,41.41,44
,20180307,103520,103520,104550,104550,103720,103720,104210,200,690,8,83.37,38
,20180308,103720,104210,,,,103600,103600,-610,-610,0,0.00,38
,20180309,103600,103600,,,,103570,103570,-30,-30,0,0.00,38
,20180312,103570,103570,,,,104250,104250,680,680,0,0.00,38
,20180313,104250,104250,,,,104250,104250,0,0,0,0.00,38
,20180314,104250,104250,,,,104610,104610,360,360,0,0.00,38
,20180315,104610,104610,,,,104610,104610,0,0,0,0.00,38
,20180316,104610,104610,,,,104610,104610,0,0,0,0.00,38
,20180319,104610,104610,,,,104610,104610,0,0,0,0.00,38
,20180320,104610,104610,,,,104610,104610,0,0,0,0.00,38
,20180321,104610,104610,,,,104160,104160,-450,-450,0,0.00,38
,20180322,104160,104160,,,,104160,104160,0,0,0,0.00,38
,20180323,104160,104160,,,,100760,100760,-3400,-3400,0,0.00,38
,20180326,100760,100760,,,,99270,99270,-1490,-1490,0,0.00,38
,20180327,99270,99270,98620,100160,98620,99220,99620,-50,350,34,338.73,60
,20180328,99220,99620,,,,99620,99620,0,0,0,0.00,60
,20180329,99620,99620,99510,99870,99510,99870,99600,250,-20,32,318.73,42
,20180330,99870,99600,,,,99840,99840,240,240,0,0.00,42
,20180402,99840,99840,102240,102240,101900,101900,102070,2060,2230,4,40.83,42
,20180403,101900,102070,,,,102070,102070,0,0,0,0.00,42
,20180404,102070,102070,,,,102070,102070,0,0,0,0.00,42
,20180409,102070,102070,,,,102070,102070,0,0,0,0.00,42
,20180410,102070,102070,,,,102070,102070,0,0,0,0.00,42
,20180411,102070,102070,,,,102070,102070,0,0,0,0.00,42
,20180412,102070,102070,102440,102440,102440,102440,102440,370,370,4,40.98,38
,20180413,102440,102440,,,,103030,103030,590,590,0,0.00,38
,20180416,103030,103030,,,,103620,103620,590,590,0,0.00,38
,20180417,103620,103620,105210,105210,104730,104730,104890,1110,1270,6,62.93,44
,20180418,104730,104890,104970,105850,104970,105850,105410,960,520,4,42.16,48
,20180419,105850,105410,110040,110510,108050,108050,109730,2640,4320,26,285.30,62
,20180420,108050,109730,,,,106510,106510,-3220,-3220,0,0.00,62
,20180423,106510,106510,,,,106510,106510,0,0,0,0.00,62
,20180424,106510,106510,,,,106510,106510,0,0,0,0.00,62
,20180425,106510,106510,104600,104710,104520,104520,104620,-1990,-1890,10,104.62,64
,20180426,104520,104620,104420,104710,103510,103510,103910,-1110,-710,118,"1,226.17",156
,20180427,103510,103910,103510,104690,103320,103550,104170,-360,260,242,"2,520.97",274
,20180502,103550,104170,103050,103350,103050,103250,103140,-920,-1030,16,165.04,286
,20180503,103250,103140,104010,104010,104010,104010,104010,870,870,2,20.80,288
,20180504,104010,104010,103970,104040,103330,103860,103770,-150,-240,42,435.84,252
,20180507,103860,103770,103520,104450,103520,103880,104040,110,270,34,353.74,248
,20180508,103880,104040,,,,104040,104040,0,0,0,0.00,248
,20180509,104040,104040,103960,103990,102980,102980,103260,-1060,-780,58,598.95,258
,20180510,102980,103260,101500,103400,101500,103400,102500,140,-760,104,"1,066.05",238
,20180511,103400,102500,,,,102500,102500,0,0,0,0.00,238
,20180514,102500,102500,105000,105420,105000,105390,105210,2890,2710,12,126.25,238
,20180515,105390,105210,,,,105210,105210,0,0,0,0.00,238
,20180516,105210,105210,,,,105210,105210,0,0,0,0.00,238
,20180517,105210,105210,106960,107370,106480,106800,106840,1590,1630,90,961.57,236
,20180518,106800,106840,105990,109180,105990,108830,106750,1990,-90,158,"1,686.73",214
,20180521,108830,106750,107860,108340,107550,108160,107970,1410,1220,82,885.36,264
,20180522,108160,107970,109390,109390,107740,108440,108640,470,670,158,"1,716.54",204
,20180523,108440,108640,107560,107560,107560,107560,107560,-1080,-1080,2,21.51,202
,20180524,107560,107560,107420,107420,105520,106960,106300,-600,-1260,186,"1,977.28",252
,20180525,106960,106300,109080,109350,109000,109350,109060,3050,2760,20,218.13,260
,20180528,109350,109060,,,,109060,109060,0,0,0,0.00,260
,20180529,109060,109060,111000,111000,110570,111000,110870,1940,1810,12,133.05,256
,20180530,111000,110870,111200,111200,110490,110490,110840,-380,-30,4,44.34,252
,20180531,110490,110840,112220,113200,111830,112590,112440,1750,1600,36,404.79,242
ni1901,20180116,101260,101260,101860,102000,99800,99800,100790,-1460,-470,104,"1,048.30",82
,20180117,99800,100790,99130,99820,98590,98590,99240,-2200,-1550,98,972.58,116
,20180118,98590,99240,99170,99720,98400,98760,99160,-480,-80,78,773.49,138
,20180119,98760,99160,99190,99190,97800,98760,98440,-400,-720,46,452.86,152
,20180122,98760,98440,99670,100560,99070,100410,100040,1970,1600,170,"1,700.84",160
,20180123,100410,100040,100350,101500,99450,101500,100730,1460,690,210,"2,115.44",186
,20180124,101500,100730,101090,101330,100110,100600,100870,-130,140,86,867.48,178
,20180125,100600,100870,101560,106470,101330,106100,104490,5230,3620,726,"7,586.03",416
,20180126,106100,104490,105800,106190,104720,105820,105540,1330,1050,306,"3,229.58",484
,20180129,105820,105540,105950,108320,105240,107240,106880,1700,1340,510,"5,450.99",612
,20180130,107240,106880,107000,107380,105000,105470,106240,-1410,-640,508,"5,397.34",520
,20180131,105470,106240,105520,105900,103270,104480,104460,-1760,-1780,288,"3,008.72",554
,20180201,104480,104460,104660,104840,103680,104100,104120,-360,-340,102,"1,062.11",556
,20180202,104100,104120,104180,107580,104180,106370,106170,2250,2050,302,"3,206.36",566
,20180205,106370,106170,106300,106300,101930,104220,103730,-1950,-2440,440,"4,564.48",622
,20180206,104220,103730,104280,106040,102690,103160,104200,-570,470,468,"4,876.62",640
,20180207,103160,104200,103560,105040,102990,104330,104070,130,-130,350,"3,642.66",580
,20180208,104330,104070,104350,104350,101360,102440,102700,-1630,-1370,382,"3,923.33",564
,20180209,102440,102700,102260,102970,100630,100890,101880,-1810,-820,306,"3,117.64",656
,20180212,100890,101880,101430,102030,100000,101760,101160,-120,-720,268,"2,711.31",660
,20180213,101760,101160,101360,103120,101360,102650,102290,1490,1130,252,"2,577.71",634
,20180214,102650,102290,102980,105000,102710,104970,104310,2680,2020,162,"1,689.88",680
,20180222,104970,104310,105960,106050,103990,104640,104800,330,490,144,"1,509.24",700
,20180223,104640,104800,105420,107170,105380,106920,106630,2120,1830,514,"5,480.81",754
,20180226,106920,106630,107000,107360,105780,107250,106780,620,150,374,"3,993.69",726
,20180227,107250,106780,107310,108300,106320,107750,107320,970,540,348,"3,734.83",772
,20180228,107750,107320,107830,107830,106000,106990,106870,-330,-450,248,"2,650.51",760
,20180301,106990,106870,106970,107200,105600,106640,106370,-230,-500,278,"2,957.15",806
,20180302,106640,106370,105410,105790,103950,104300,104770,-2070,-1600,650,"6,810.59",948
,20180305,104300,104770,104430,106720,103530,103530,104370,-1240,-400,510,"5,323.15",954
,20180306,103530,104370,103520,104650,102730,104390,103700,20,-670,476,"4,936.49",1062
,20180307,104390,103700,104960,105520,104060,104260,104770,560,1070,442,"4,630.94",1076
,20180308,104260,104770,104010,104690,102510,102760,103380,-2010,-1390,578,"5,975.65",1074
,20180309,102760,103380,102700,103060,102000,102550,102500,-830,-880,336,"3,444.32",1104
,20180312,102550,102500,103080,106800,103000,105700,105400,3200,2900,858,"9,043.77",1216
,20180313,105700,105400,105830,106420,105300,105620,105840,220,440,808,"8,551.97",1392
,20180314,105620,105840,105820,106730,105670,106410,106300,570,460,774,"8,228.20",1616
,20180315,106410,106300,106670,106670,104900,105490,106000,-810,-300,1360,"14,416.00",1682
,20180316,105490,106000,105290,105490,104020,105390,104810,-610,-1190,606,"6,351.67",1702
,20180319,105390,104810,105400,105720,103700,103900,104440,-910,-370,574,"5,995.34",1760
,20180320,103900,104440,104080,104730,102920,104490,103900,50,-540,718,"7,460.42",1870
,20180321,104490,103900,104530,104630,103060,103250,103550,-650,-350,708,"7,332.03",1758
,20180322,103250,103550,103250,104710,101770,103400,103200,-150,-350,1416,"14,614.06",2020
,20180323,103400,103200,102800,103310,99050,99950,101180,-3250,-2020,1834,"18,556.87",2400
,20180326,99950,101180,100520,101360,98050,98100,99570,-3080,-1610,1010,"10,056.65",2456
,20180327,98100,99570,98080,100120,98080,99420,99180,-150,-390,1360,"13,489.04",2882
,20180328,99420,99180,99240,99560,97910,98240,98660,-940,-520,812,"8,011.20",3100
,20180329,98240,98660,98680,100380,98220,100310,99000,1650,340,1222,"12,098.06",3262
,20180330,100310,99000,100310,101240,99890,101170,100470,2170,1470,1766,"17,743.60",3678
,20180402,101170,100470,101160,103310,100910,102050,102040,1580,1570,1002,"10,225.19",3760
,20180403,102050,102040,101740,102570,101180,102050,101900,10,-140,706,"7,194.53",3832
,20180404,102050,101900,102250,102250,101470,101710,101820,-190,-80,714,"7,269.97",3784
,20180409,101710,101820,101810,101810,99400,101010,100250,-810,-1570,972,"9,744.44",3874
,20180410,101010,100250,101000,102830,100680,102270,102020,2020,1770,1436,"14,650.51",3992
,20180411,102270,102020,103490,103800,102310,103070,103040,1050,1020,2254,"23,226.11",3990
,20180412,103070,103040,102830,104170,102160,103460,103060,420,20,2092,"21,561.12",4096
,20180413,103460,103060,103460,105500,102570,105000,104360,1940,1300,2554,"26,656.10",4732
,20180416,105000,104360,105210,105740,104090,105430,104980,1070,620,3000,"31,496.63",5268
,20180417,105430,104980,105500,106190,104580,105230,105240,250,260,2904,"30,561.73",5658
,20180418,105230,105240,104490,106400,104000,106050,105240,810,0,3022,"31,805.31",6232
,20180419,106050,105240,107600,110960,107580,109210,108940,3970,3700,8070,"87,916.53",7942
,20180420,109210,108940,108000,108000,105100,105530,106570,-3410,-2370,4384,"46,721.42",7644
,20180423,105530,106570,105880,106600,105120,106100,105870,-470,-700,3584,"37,944.53",7468
,20180424,106100,105870,103990,105540,103240,104460,104640,-1410,-1230,4172,"43,658.04",7436
,20180425,104460,104640,104510,105630,104210,104410,104860,-230,220,2392,"25,083.68",7994
,20180426,104410,104860,104600,104950,103550,103620,104170,-1240,-690,5420,"56,461.18",10026
,20180427,103620,104170,103600,104730,102850,103640,103660,-530,-510,16962,"175,837.73",18212
,20180502,103640,103660,103010,104440,102500,104020,103470,360,-190,4124,"42,672.84",18554
,20180503,104020,103470,104490,104580,103460,103950,104170,480,700,5924,"61,713.63",20332
,20180504,103950,104170,104420,104680,103220,104030,103870,-140,-300,3036,"31,535.30",20128
,20180507,104030,103870,103830,104610,103500,103900,104010,30,140,5038,"52,400.81",20672
,20180508,103900,104010,103950,104830,103400,104370,104030,360,20,3308,"34,413.86",20928
,20180509,104370,104030,104190,104220,102530,103160,103310,-870,-720,7986,"82,505.81",22086
,20180510,103160,103310,103120,103740,102700,102860,103190,-450,-120,4538,"46,827.94",22906
,20180511,102860,103190,103210,103500,102870,102920,103150,-270,-40,3784,"39,032.52",23106
,20180514,102920,103150,103390,105350,103200,105300,104540,2150,1390,7826,"81,815.00",22030
,20180515,105300,104540,105500,106590,105210,106160,105890,1620,1350,6386,"67,624.04",22758
,20180516,106160,105890,105500,107500,105190,106650,106370,760,480,4400,"46,805.65",22628
,20180517,106650,106370,106500,107100,106260,106560,106680,190,310,5462,"58,272.68",23264
,20180518,106560,106680,106800,109100,106690,108960,107910,2280,1230,6488,"70,014.71",23852
,20180521,108960,107910,108810,109140,107040,107700,107960,-210,50,5060,"54,631.15",24788
,20180522,107700,107960,108010,108440,107010,107060,107770,-900,-190,4662,"50,242.67",25748
,20180523,107060,107770,108000,108120,106500,107380,107340,-390,-430,6528,"70,075.76",27594
,20180524,107380,107340,107380,107380,106480,107170,106940,-170,-400,6272,"67,076.02",28368
,20180525,107170,106940,107110,110300,107090,108900,108770,1960,1830,12558,"136,604.06",30102
,20180528,108900,108770,108900,109220,107880,109080,108590,310,-180,4850,"52,668.17",30812
,20180529,109080,108590,109060,111220,108760,111100,110350,2510,1760,8582,"94,706.54",31768
,20180530,111100,110350,111090,111090,109760,109880,110280,-470,-70,7248,"79,935.12",31630
,20180531,109880,110280,110660,113070,110050,112610,111880,2330,1600,13446,"150,444.18",33880
ni1902,20180212,101880,101880,,,,101160,101160,-720,-720,0,0.00,0
,20180213,101160,101160,,,,101160,101160,0,0,0,0.00,0
,20180214,101160,101160,,,,101160,101160,0,0,0,0.00,0
,20180222,101160,101160,,,,101160,101160,0,0,0,0.00,0
,20180223,101160,101160,,,,101160,101160,0,0,0,0.00,0
,20180226,101160,101160,,,,103530,103530,2370,2370,0,0.00,0
,20180227,103530,103530,,,,104760,104760,1230,1230,0,0.00,0
,20180228,104760,104760,,,,104760,104760,0,0,0,0.00,0
,20180301,104760,104760,,,,104760,104760,0,0,0,0.00,0
,20180302,104760,104760,,,,104760,104760,0,0,0,0.00,0
,20180305,104760,104760,103680,103680,103680,103680,103680,-1080,-1080,2,20.74,2
,20180306,103680,103680,,,,103680,103680,0,0,0,0.00,2
,20180307,103680,103680,,,,103680,103680,0,0,0,0.00,2
,20180308,103680,103680,104600,104600,104600,104600,104600,920,920,2,20.92,2
,20180309,104600,104600,102710,102710,102710,102710,102710,-1890,-1890,2,20.54,2
,20180312,102710,102710,102710,106900,102710,106070,106530,3360,3820,56,596.60,46
,20180313,106070,106530,106580,106580,106580,106580,106580,50,50,8,85.26,54
,20180314,106580,106580,106660,107170,106660,107170,106910,590,330,4,42.77,56
,20180315,107170,106910,107390,107390,105760,105760,106550,-1150,-360,10,106.55,58
,20180316,105760,106550,104760,105070,104760,105070,104960,-1480,-1590,6,62.98,62
,20180319,105070,104960,104390,104490,104390,104490,104440,-470,-520,4,41.78,64
,20180320,104490,104440,,,,104440,104440,0,0,0,0.00,64
,20180321,104440,104440,103620,103620,103620,103620,103620,-820,-820,2,20.72,66
,20180322,103620,103620,103330,104810,103330,104810,104060,1190,440,8,83.25,68
,20180323,104810,104060,100980,100980,100980,100980,100980,-3080,-3080,2,20.20,66
,20180326,100980,100980,100530,100530,99460,99460,99910,-1520,-1070,14,139.89,70
,20180327,99460,99910,,,,99910,99910,0,0,0,0.00,70
,20180328,99910,99910,,,,99910,99910,0,0,0,0.00,70
,20180329,99910,99910,99360,99360,99360,99360,99360,-550,-550,2,19.87,70
,20180330,99360,99360,100380,101710,100380,101650,101350,2290,1990,12,121.62,78
,20180402,101650,101350,102760,102760,101710,102440,102390,1090,1040,22,225.27,82
,20180403,102440,102390,102380,102540,102380,102540,102440,150,50,6,61.47,84
,20180404,102540,102440,102140,102260,101680,101680,102050,-760,-390,8,81.65,86
,20180409,101680,102050,,,,102050,102050,0,0,0,0.00,86
,20180410,102050,102050,101540,102200,101540,102200,102030,150,-20,10,102.04,96
,20180411,102200,102030,,,,102050,102050,20,20,0,0.00,96
,20180412,102050,102050,102880,102880,102880,102880,102880,830,830,2,20.58,94
,20180413,102880,102880,103090,106680,103090,104760,104780,1880,1900,34,356.26,108
,20180416,104760,104780,104670,104670,104670,104670,104670,-110,-110,4,41.87,108
,20180417,104670,104670,,,,104670,104670,0,0,0,0.00,108
,20180418,104670,104670,104870,105210,104870,105210,105040,540,370,4,42.02,106
,20180419,105210,105040,108470,109610,108430,109610,108690,4570,3650,20,217.39,112
,20180420,109610,108690,107680,107680,106920,106920,107300,-1770,-1390,4,42.92,112
,20180423,106920,107300,105710,106250,105330,105910,105820,-1390,-1480,14,148.15,110
,20180424,105910,105820,104090,105650,104090,104630,104930,-1190,-890,10,104.94,112
,20180425,104630,104930,105400,105400,105400,105400,105400,470,470,8,84.32,116
,20180426,105400,105400,104870,104980,103790,103790,104480,-1610,-920,34,355.24,130
,20180427,103790,104480,104480,104690,103660,103660,104440,-820,-40,72,751.98,172
,20180502,103660,104440,102970,104300,102700,104300,103320,-140,-1120,10,103.32,174
,20180503,104300,103320,103940,104580,103570,104170,103880,850,560,24,249.33,174
,20180504,104170,103880,104700,104700,103560,104150,103990,270,110,38,395.19,170
,20180507,104150,103990,103990,104290,103680,104190,104010,200,20,72,748.88,166
,20180508,104190,104010,104170,104780,104170,104780,104470,770,460,4,41.79,168
,20180509,104780,104470,,,,103750,103750,-720,-720,0,0.00,168
,20180510,103750,103750,103640,103940,103600,103810,103730,60,-20,14,145.23,172
,20180511,103810,103730,103380,103380,103380,103380,103380,-350,-350,2,20.68,170
,20180514,103380,103380,104310,105500,104190,105020,104910,1640,1530,90,944.22,232
,20180515,105020,104910,104000,106170,104000,105730,104880,820,-30,164,"1,720.15",180
,20180516,105730,104880,,,,104880,104880,0,0,0,0.00,180
,20180517,104880,104880,106810,107210,106810,107160,107060,2280,2180,6,64.24,182
,20180518,107160,107060,106880,107030,106880,107030,106910,-30,-150,8,85.53,174
,20180521,107030,106910,,,,106910,106910,0,0,0,0.00,174
,20180522,106910,106910,,,,106910,106910,0,0,0,0.00,174
,20180523,106910,106910,108090,108090,108090,108090,108090,1180,1180,4,43.24,174
,20180524,108090,108090,106870,106870,106870,106870,106870,-1220,-1220,2,21.37,172
,20180525,106870,106870,108250,109270,108250,109180,108970,2310,2100,16,174.35,176
,20180528,109180,108970,,,,108970,108970,0,0,0,0.00,176
,20180529,108970,108970,,,,110200,110200,1230,1230,0,0.00,176
,20180530,110200,110200,111060,111060,111060,111060,111060,860,860,2,22.21,178
,20180531,111060,111060,111560,113020,111560,113020,112150,1960,1090,52,583.21,186
ni1903,20180316,106550,106550,,,,106550,106550,0,0,0,0.00,0
,20180319,106550,106550,,,,105950,105950,-600,-600,0,0.00,0
,20180320,105950,105950,,,,105950,105950,0,0,0,0.00,0
,20180321,105950,105950,,,,105950,105950,0,0,0,0.00,0
,20180322,105950,105950,104560,104560,104560,104560,104560,-1390,-1390,2,20.91,2
,20180323,104560,104560,103560,103560,100280,100280,101920,-4280,-2640,4,40.77,2
,20180326,100280,101920,100440,100440,100440,100440,100440,-1480,-1480,2,20.09,4
,20180327,100440,100440,100000,100000,100000,100000,100000,-440,-440,2,20.00,4
,20180328,100000,100000,,,,100000,100000,0,0,0,0.00,4
,20180329,100000,100000,,,,100000,100000,0,0,0,0.00,4
,20180330,100000,100000,100110,100520,100110,100520,100380,520,380,6,60.23,10
,20180402,100520,100380,102920,102920,102920,102920,102920,2540,2540,2,20.58,12
,20180403,102920,102920,,,,102920,102920,0,0,0,0.00,12
,20180404,102920,102920,101020,101940,101020,101940,101480,-980,-1440,4,40.59,14
,20180409,101940,101480,,,,101480,101480,0,0,0,0.00,14
,20180410,101480,101480,,,,101480,101480,0,0,0,0.00,14
,20180411,101480,101480,102730,102730,102730,102730,102730,1250,1250,2,20.55,16
,20180412,102730,102730,,,,102730,102730,0,0,0,0.00,16
,20180413,102730,102730,102520,105260,102520,105250,104630,2520,1900,22,230.19,24
,20180416,105250,104630,104770,104770,104570,104570,104670,-60,40,4,41.87,28
,20180417,104570,104670,105230,105230,105230,105230,105230,560,560,2,21.05,30
,20180418,105230,105230,105090,105090,104780,104780,104980,-450,-250,6,62.99,36
,20180419,104780,104980,108100,109870,108100,109870,109280,4890,4300,6,65.57,42
,20180420,109870,109280,105100,105100,105100,105100,105100,-4180,-4180,2,21.02,44
,20180423,105100,105100,105990,106110,105990,106110,106070,1010,970,6,63.64,50
,20180424,106110,106070,,,,105780,105780,-290,-290,0,0.00,50
,20180425,105780,105780,,,,105700,105700,-80,-80,0,0.00,50
,20180426,105700,105700,104380,104380,103690,103900,104050,-1800,-1650,46,478.66,48
,20180427,103900,104050,104590,105050,104150,104150,104700,100,650,42,439.74,78
,20180502,104150,104700,102110,103650,102110,103650,103420,-1050,-1280,14,144.80,76
,20180503,103650,103420,104620,104620,104080,104080,104400,660,980,6,62.64,80
,20180504,104080,104400,104480,104490,103670,103670,104140,-730,-260,8,83.31,80
,20180507,103670,104140,103890,104840,103750,104330,104130,190,-10,36,374.87,86
,20180508,104330,104130,104310,104880,103800,104400,104300,270,170,26,271.20,94
,20180509,104400,104300,104360,104360,103390,103490,103690,-810,-610,14,145.17,92
,20180510,103490,103690,103450,103470,103450,103470,103460,-220,-230,14,144.85,104
,20180511,103470,103460,103200,103660,103190,103190,103330,-270,-130,8,82.66,106
,20180514,103190,103330,,,,104670,104670,1340,1340,0,0.00,106
,20180515,104670,104670,,,,105190,105190,520,520,0,0.00,106
,20180516,105190,105190,105570,106380,105570,106150,106030,960,840,6,63.62,104
,20180517,106150,106030,107010,107010,106600,106600,106800,570,770,4,42.72,102
,20180518,106600,106800,108400,108400,108400,108400,108400,1600,1600,2,21.68,100
,20180521,108400,108400,107800,107800,107800,107800,107800,-600,-600,2,21.56,100
,20180522,107800,107800,107600,107600,107600,107600,107600,-200,-200,2,21.52,100
,20180523,107600,107600,106900,107440,106900,107440,107170,-160,-430,4,42.87,98
,20180524,107440,107170,107100,107100,107100,107100,107100,-70,-70,2,21.42,98
,20180525,107100,107100,109150,109610,108620,108620,109110,1520,2010,18,196.41,88
,20180528,108620,109110,109000,109000,109000,109000,109000,-110,-110,28,305.20,88
,20180529,109000,109000,111080,113900,110860,110860,111830,1860,2830,60,671.01,86
,20180530,110860,111830,110860,110860,109870,109870,110410,-1960,-1420,8,88.33,88
,20180531,109870,110410,111620,112930,111620,112930,111980,2520,1570,8,89.59,90
ni1904,20180417,104670,104670,,,,104670,104670,0,0,0,0.00,0
,20180418,104670,104670,,,,104670,104670,0,0,0,0.00,0
,20180419,104670,104670,,,,104670,104670,0,0,0,0.00,0
,20180420,104670,104670,,,,104670,104670,0,0,0,0.00,0
,20180423,104670,104670,,,,104670,104670,0,0,0,0.00,0
,20180424,104670,104670,,,,104670,104670,0,0,0,0.00,0
,20180425,104670,104670,104320,105100,104320,105100,104710,430,40,8,83.77,4
,20180426,105100,104710,,,,104710,104710,0,0,0,0.00,4
,20180427,104710,104710,104980,104980,104660,104660,104910,-50,200,10,104.92,14
,20180502,104660,104910,104030,104560,104030,104560,104260,-350,-650,8,83.41,12
,20180503,104560,104260,105400,105400,105140,105140,105290,880,1030,8,84.24,20
,20180504,105140,105290,104730,104870,104730,104870,104830,-420,-460,8,83.87,28
,20180507,104870,104830,104700,105220,104630,104690,104810,-140,-20,16,167.70,30
,20180508,104690,104810,104790,104790,103850,104780,104560,-30,-250,10,104.56,34
,20180509,104780,104560,103770,104120,103770,104120,103880,-440,-680,6,62.33,36
,20180510,104120,103880,103510,103510,103510,103510,103510,-370,-370,2,20.70,36
,20180511,103510,103510,,,,103510,103510,0,0,0,0.00,36
,20180514,103510,103510,104730,104730,104730,104730,104730,1220,1220,2,20.95,38
,20180515,104730,104730,106870,106870,106350,106620,106640,1890,1910,8,85.32,42
,20180516,106620,106640,107540,107540,106550,106550,107040,-90,400,4,42.82,42
,20180517,106550,107040,107320,107320,107320,107320,107320,280,280,2,21.46,44
,20180518,107320,107320,107780,110090,107780,108380,108820,1060,1500,8,87.06,50
,20180521,108380,108820,109080,109080,107870,108380,108440,-440,-380,26,281.97,74
,20180522,108380,108440,,,,108440,108440,0,0,0,0.00,74
,20180523,108440,108440,107780,107780,107780,107780,107780,-660,-660,2,21.56,74
,20180524,107780,107780,107470,107810,107300,107300,107730,-480,-50,26,280.11,94
,20180525,107300,107730,109260,110090,109200,109490,109510,1760,1780,8,87.61,98
,20180528,109490,109510,,,,109510,109510,0,0,0,0.00,98
,20180529,109510,109510,108800,111110,108800,111080,110940,1570,1430,44,488.14,138
,20180530,111080,110940,110040,110300,110040,110300,110170,-640,-770,4,44.07,136
,20180531,110300,110170,111220,113470,111220,113470,113020,3300,2850,10,113.02,134
ni1905,20180516,106640,106640,107000,107660,106040,107120,107020,480,380,66,706.35,34
,20180517,107120,107020,106810,107720,106690,106850,107040,-170,20,26,278.33,42
,20180518,106850,107040,108020,108870,106970,108870,107990,1830,950,138,"1,490.28",100
,20180521,108870,107990,108910,109140,107500,107700,108170,-290,180,94,"1,016.84",134
,20180522,107700,108170,107900,108440,107000,107200,107740,-970,-430,68,732.69,164
,20180523,107200,107740,107860,107860,106380,106890,107010,-850,-730,76,813.31,202
,20180524,106890,107010,106940,107380,106500,107170,107060,160,50,66,706.65,230
,20180525,107170,107060,107370,110160,107370,108350,109190,1290,2130,390,"4,258.42",472
,20180528,108350,109190,108310,109190,107830,108730,108460,-460,-730,154,"1,670.44",476
,20180529,108730,108460,108500,110890,108500,110890,109890,2430,1430,246,"2,703.34",518
,20180530,110890,109890,110600,111000,109730,109730,110210,-160,320,102,"1,124.21",540
,20180531,109730,110210,110000,113900,110000,113110,113070,2900,2860,4748,"53,687.39",4710
pb1801,20180102,19180,19105,19080,19145,18860,18940,18945,-165,-160,1430,"13,547.03",8710
,20180103,18940,18945,19125,19295,19055,19215,19210,270,265,2120,"20,367.70",8130
,20180104,19215,19210,19260,19400,19155,19320,19325,110,115,3930,"37,976.53",5490
,20180105,19320,19325,19300,19410,19255,19405,19325,80,0,1170,"11,306.50",4920
,20180108,19405,19325,19390,19410,19255,19320,19300,-5,-25,810,"7,818.18",4660
,20180109,19320,19300,19260,19520,19260,19490,19480,190,180,1110,"10,813.28",4430
,20180110,19490,19480,19495,19560,19295,19305,19410,-175,-70,490,"4,756.43",4240
,20180111,19305,19410,19250,19250,19200,19225,19220,-185,-190,300,"2,883.00",4360
,20180112,19225,19220,19080,19080,19000,19000,19030,-220,-190,50,475.80,4360
,20180115,19000,19030,19100,19100,19100,19100,19100,70,70,30,286.50,4330
pb1802,20180102,19170,19160,19180,19220,18880,19020,19005,-140,-155,37084,"352,459.47",40980
,20180103,19020,19005,19180,19390,19095,19310,19250,305,245,59086,"568,797.53",42516
,20180104,19310,19250,19365,19495,19205,19405,19350,155,100,48210,"466,471.29",43036
,20180105,19405,19350,19400,19565,19325,19480,19405,130,55,41500,"402,728.81",42652
,20180108,19480,19405,19425,19590,19345,19405,19445,0,40,47440,"461,249.19",41510
,20180109,19405,19445,19395,19650,19320,19620,19515,175,70,40624,"396,423.64",40288
,20180110,19620,19515,19570,19685,19350,19415,19500,-100,-15,38552,"375,912.56",36732
,20180111,19415,19500,19490,19515,19325,19390,19405,-110,-95,25206,"244,579.84",34752
,20180112,19390,19405,19490,19490,19180,19250,19280,-155,-125,33314,"321,186.65",31034
,20180115,19250,19280,19120,19210,19005,19185,19115,-95,-165,35774,"341,989.55",29650
,20180116,19185,19115,19155,19205,18745,18820,19020,-295,-95,39234,"373,201.89",24766
,20180117,18820,19020,18790,19195,18775,19135,19035,115,15,33404,"317,995.79",21428
,20180118,19135,19035,19175,19270,19035,19270,19160,235,125,20062,"192,220.12",18842
,20180119,19270,19160,19320,19535,19160,19515,19405,355,245,18406,"178,592.94",15492
,20180122,19515,19405,19550,19550,19270,19450,19385,45,-20,10586,"102,621.92",13534
,20180123,19450,19385,19470,19765,19365,19760,19510,375,125,9050,"88,289.24",12790
,20180124,19760,19510,19715,19730,19525,19550,19640,40,130,5150,"50,580.77",11882
,20180125,19550,19640,19605,19835,19500,19620,19615,-20,-25,6608,"64,811.51",10404
,20180126,19620,19615,19525,19570,19360,19435,19450,-180,-165,6636,"64,538.41",8622
,20180129,19435,19450,19470,19865,19400,19775,19625,325,175,3806,"37,347.63",7822
,20180130,19775,19625,19775,19775,19475,19535,19580,-90,-45,5678,"55,589.39",6052
,20180131,19535,19580,19625,19635,19310,19310,19445,-270,-135,2562,"24,913.74",4674
,20180201,19310,19445,19430,19600,19430,19550,19480,105,35,494,"4,811.77",4330
,20180202,19550,19480,19675,19725,19595,19670,19665,190,185,450,"4,424.73",4230
,20180205,19670,19665,19625,19625,19500,19520,19535,-145,-130,280,"2,735.58",4080
,20180206,19520,19535,19460,19520,19365,19470,19405,-65,-130,340,"3,298.88",3920
,20180207,19470,19405,19200,19200,19100,19100,19130,-305,-275,110,"1,052.30",3900
,20180208,19100,19130,18900,19080,18900,19040,19025,-90,-105,210,"1,997.93",3870
,20180209,19040,19025,19050,19110,18800,19000,19005,-25,-20,300,"2,851.33",3900
pb1803,20180102,19125,19135,18980,19180,18860,19030,18980,-105,-155,8724,"82,808.98",15046
,20180103,19030,18980,19115,19380,19095,19305,19260,325,280,13906,"133,947.29",15668
,20180104,19305,19260,19375,19480,19215,19415,19350,155,90,12456,"120,532.46",16686
,20180105,19415,19350,19420,19515,19310,19465,19385,115,35,14452,"140,112.06",18900
,20180108,19465,19385,19435,19550,19320,19405,19410,20,25,11394,"110,583.91",19130
,20180109,19405,19410,19390,19650,19290,19605,19535,195,125,16318,"159,395.54",22540
,20180110,19605,19535,19600,19675,19350,19420,19490,-115,-45,17300,"168,609.93",23680
,20180111,19420,19490,19515,19525,19335,19390,19405,-100,-85,14060,"136,451.82",24852
,20180112,19390,19405,19485,19485,19200,19280,19295,-125,-110,18248,"176,061.43",25148
,20180115,19280,19295,19135,19265,19065,19235,19165,-60,-130,22574,"216,367.58",26002
,20180116,19235,19165,19200,19275,18810,18870,19075,-295,-90,30790,"293,665.69",27980
,20180117,18870,19075,18815,19265,18815,19195,19100,120,25,45658,"436,124.43",32840
,20180118,19195,19100,19195,19340,19080,19330,19220,230,120,46984,"451,543.61",37432
,20180119,19330,19220,19400,19595,19355,19570,19465,350,245,60022,"584,281.51",42956
,20180122,19570,19465,19575,19575,19305,19480,19435,15,-30,53950,"524,272.19",40976
,20180123,19480,19435,19490,19815,19425,19800,19580,365,145,67798,"663,860.73",49846
,20180124,19800,19580,19740,19780,19560,19575,19690,-5,110,48702,"479,482.39",47512
,20180125,19575,19690,19620,19890,19545,19650,19675,-40,-15,70204,"690,638.86",45326
,20180126,19650,19675,19540,19630,19395,19470,19500,-205,-175,53436,"521,088.29",43418
,20180129,19470,19500,19545,19895,19450,19800,19680,300,180,62010,"610,277.82",46400
,20180130,19800,19680,19840,19840,19455,19540,19600,-140,-80,61692,"604,645.25",42068
,20180131,19540,19600,19650,19650,19350,19400,19465,-200,-135,46324,"450,884.59",40366
,20180201,19400,19465,19465,19645,19380,19570,19500,105,35,44964,"438,503.79",40732
,20180202,19570,19500,19655,19785,19595,19660,19690,160,190,46992,"462,649.91",41554
,20180205,19660,19690,19595,19780,19505,19535,19595,-155,-95,46904,"459,562.90",40176
,20180206,19535,19595,19470,19640,19405,19465,19495,-130,-100,35882,"349,798.02",37682
,20180207,19465,19495,19380,19415,19150,19200,19275,-295,-220,48456,"467,088.79",35130
,20180208,19200,19275,19125,19255,19015,19080,19110,-195,-165,46594,"445,298.84",31164
,20180209,19080,19110,19130,19195,18975,19040,19080,-70,-30,43106,"411,243.44",28964
,20180212,19040,19080,19165,19185,19010,19030,19095,-50,15,41788,"399,036.22",27582
,20180213,19030,19095,19025,19040,18905,19015,18975,-80,-120,26628,"252,661.74",24208
,20180214,19015,18975,19035,19345,18980,19320,19190,345,215,26280,"252,210.52",20494
,20180222,19320,19190,19220,19340,19165,19305,19240,115,50,12668,"121,874.55",18950
,20180223,19305,19240,19270,19490,19250,19385,19375,145,135,11872,"115,027.75",15732
,20180226,19385,19375,19300,19460,19270,19440,19365,65,-10,11528,"111,643.10",12788
,20180227,19440,19365,19500,19585,19445,19505,19505,140,140,5672,"55,318.30",10886
,20180228,19505,19505,19540,19540,18880,19215,19235,-290,-270,6898,"66,351.54",7556
,20180301,19215,19235,19105,19120,19005,19005,19055,-230,-180,2536,"24,165.27",6120
,20180302,19005,19055,18855,18920,18800,18920,18840,-135,-215,900,"8,478.35",5790
,20180305,18920,18840,18910,18910,18750,18750,18825,-90,-15,940,"8,848.88",5260
,20180306,18750,18825,18650,18700,18550,18660,18630,-165,-195,740,"6,893.33",5130
,20180307,18660,18630,18720,18780,18660,18755,18745,125,115,1050,"9,843.20",4650
,20180308,18755,18745,18715,18750,18530,18665,18650,-80,-95,1530,"14,270.15",4420
,20180309,18665,18650,18590,18620,18400,18500,18500,-150,-150,710,"6,568.75",3840
,20180312,18500,18500,18490,18580,18480,18520,18535,20,35,260,"2,410.15",3700
,20180313,18520,18535,18250,18295,18250,18280,18270,-255,-265,220,"2,009.95",3720
,20180314,18280,18270,18460,18585,18460,18560,18530,290,260,560,"5,188.80",4140
,20180315,18560,18530,18660,18710,18550,18710,18655,180,125,450,"4,197.53",4220
pb1804,20180102,19125,19125,19180,19185,18850,18915,18990,-210,-135,134,"1,272.49",646
,20180103,18915,18990,19145,19345,19140,19295,19245,305,255,306,"2,944.92",640
,20180104,19295,19245,19320,19455,19220,19445,19340,200,95,228,"2,205.24",670
,20180105,19445,19340,19455,19455,19320,19325,19380,-15,40,392,"3,798.81",836
,20180108,19325,19380,19430,19500,19330,19420,19395,40,15,194,"1,881.65",870
,20180109,19420,19395,19315,19665,19315,19525,19475,130,80,300,"2,921.86",944
,20180110,19525,19475,19540,19615,19300,19405,19505,-70,30,112,"1,092.38",954
,20180111,19405,19505,19500,19500,19350,19420,19400,-85,-105,380,"3,686.21",1158
,20180112,19420,19400,19430,19430,19180,19300,19235,-100,-165,2324,"22,356.61",2424
,20180115,19300,19235,19150,19250,19050,19250,19145,15,-90,2360,"22,593.38",3730
,20180116,19250,19145,19265,19265,18820,18885,19070,-260,-75,3072,"29,299.03",5408
,20180117,18885,19070,18850,19220,18850,19170,19055,100,-15,3786,"36,074.41",7276
,20180118,19170,19055,19170,19300,19060,19290,19235,235,180,2432,"23,393.29",8256
,20180119,19290,19235,19400,19540,19310,19515,19425,280,190,3400,"33,025.65",9004
,20180122,19515,19425,19490,19490,19285,19465,19400,40,-25,2768,"26,851.23",9414
,20180123,19465,19400,19485,19765,19415,19760,19590,360,190,3512,"34,407.80",10710
,20180124,19760,19590,19680,19740,19515,19520,19630,-70,40,3080,"30,233.16",11430
,20180125,19520,19630,19565,19850,19535,19620,19660,-10,30,8032,"78,968.05",13482
,20180126,19620,19660,19555,19635,19410,19475,19515,-185,-145,6048,"59,016.55",14494
,20180129,19475,19515,19545,19850,19470,19750,19690,235,175,8750,"86,158.06",17748
,20180130,19750,19690,19750,19810,19475,19525,19605,-165,-85,9536,"93,479.92",17732
,20180131,19525,19605,19620,19630,19365,19410,19455,-195,-150,9016,"87,721.20",17360
,20180201,19410,19455,19450,19625,19375,19560,19495,105,40,10986,"107,092.41",18466
,20180202,19560,19495,19665,19755,19580,19650,19665,155,170,13380,"131,586.12",19844
,20180205,19650,19665,19625,19740,19485,19535,19585,-130,-80,18396,"180,150.14",22090
,20180206,19535,19585,19470,19635,19400,19450,19485,-135,-100,13112,"127,773.59",22292
,20180207,19450,19485,19350,19480,19155,19210,19275,-275,-210,17486,"168,526.64",22976
,20180208,19210,19275,19145,19250,19005,19045,19110,-230,-165,20862,"199,355.69",24304
,20180209,19045,19110,19105,19195,18975,19050,19085,-60,-25,19558,"186,658.27",25690
,20180212,19050,19085,19100,19175,19020,19045,19085,-40,0,23150,"220,949.42",26786
,20180213,19045,19085,19040,19040,18910,19005,18970,-80,-115,17682,"167,753.15",28996
,20180214,19005,18970,19000,19340,18985,19315,19190,345,220,20116,"193,035.58",29982
,20180222,19315,19190,19285,19340,19155,19295,19230,105,40,13728,"131,995.57",31604
,20180223,19295,19230,19240,19440,19240,19375,19365,145,135,31874,"308,659.77",34778
,20180226,19375,19365,19300,19465,19255,19430,19355,65,-10,39950,"386,678.02",37886
,20180227,19430,19355,19485,19575,19430,19500,19500,145,145,33472,"326,396.08",39120
,20180228,19500,19500,19485,19490,19145,19205,19300,-295,-200,47168,"455,223.30",41732
,20180301,19205,19300,19175,19180,19035,19080,19100,-220,-200,40934,"390,967.33",40584
,20180302,19080,19100,18925,18930,18775,18895,18860,-205,-240,44718,"421,738.19",39732
,20180305,18895,18860,18880,18950,18730,18750,18825,-110,-35,37330,"351,430.09",38082
,20180306,18750,18825,18660,18730,18500,18640,18615,-185,-210,41152,"383,102.83",37852
,20180307,18640,18615,18670,18775,18615,18715,18695,100,80,32380,"302,742.86",38032
,20180308,18715,18695,18700,18750,18440,18580,18570,-115,-125,43106,"400,331.01",36598
,20180309,18580,18570,18510,18590,18315,18475,18440,-95,-130,40764,"375,910.72",33022
,20180312,18475,18440,18465,18600,18375,18445,18475,5,35,40116,"370,611.71",31340
,20180313,18445,18475,18365,18395,18105,18190,18215,-285,-260,38252,"348,474.29",30586
,20180314,18190,18215,18485,18575,18320,18540,18440,325,225,32384,"298,630.11",26054
,20180315,18540,18440,18665,18800,18560,18700,18690,260,250,29448,"275,252.39",24410
,20180316,18700,18690,18655,18730,18595,18610,18655,-80,-35,15806,"147,434.25",18550
,20180319,18610,18655,18625,18720,18405,18440,18550,-215,-105,9024,"83,706.56",17214
,20180320,18440,18550,18490,18525,18365,18435,18450,-115,-100,8022,"74,015.21",15498
,20180321,18435,18450,18490,18550,18280,18470,18395,20,-55,7882,"72,512.56",15412
,20180322,18470,18395,18550,18990,18500,18930,18775,535,380,8508,"79,886.00",14788
,20180323,18930,18775,18800,18890,18405,18580,18660,-195,-115,8822,"82,315.84",13424
,20180326,18580,18660,18605,18655,18465,18565,18545,-95,-115,4720,"43,766.38",12214
,20180327,18565,18545,18650,18810,18560,18750,18715,205,170,3228,"30,207.42",11504
,20180328,18750,18715,18740,18885,18670,18835,18785,120,70,3100,"29,118.14",10560
,20180329,18835,18785,18865,18945,18755,18900,18845,115,60,3476,"32,754.23",8804
,20180330,18900,18845,18860,19200,18840,19200,18925,355,80,2884,"27,296.07",7200
,20180402,19200,18925,19180,19250,19000,19060,19130,135,205,1750,"16,740.58",6510
,20180403,19060,19130,19000,19000,18780,18840,18860,-290,-270,1430,"13,485.50",5440
,20180404,18840,18860,18865,18905,18685,18725,18745,-135,-115,1850,"17,340.90",4180
,20180409,18725,18745,18700,18735,18645,18670,18680,-75,-65,310,"2,896.00",4010
,20180410,18670,18680,18665,18695,18580,18680,18630,0,-50,360,"3,354.08",3800
,20180411,18680,18630,18760,18760,18605,18635,18645,5,15,360,"3,356.10",3560
,20180412,18635,18645,18420,18420,18420,18420,18420,-225,-225,10,92.10,3560
,20180413,18420,18420,18430,18430,18320,18355,18385,-65,-35,480,"4,413.03",3520
,20180416,18355,18385,18200,18530,18200,18530,18395,145,10,560,"5,150.80",3800
pb1805,20180102,19180,19150,19150,19160,18930,19035,19005,-115,-145,254,"2,413.70",2130
,20180103,19035,19005,19200,19350,19135,19335,19250,330,245,880,"8,471.63",2382
,20180104,19335,19250,19340,19500,19200,19455,19380,205,130,652,"6,318.36",2338
,20180105,19455,19380,19470,19495,19345,19495,19420,115,40,296,"2,874.52",2328
,20180108,19495,19420,19460,19525,19305,19370,19410,-50,-10,406,"3,941.12",2254
,20180109,19370,19410,19335,19600,19320,19560,19475,150,65,474,"4,616.55",2464
,20180110,19560,19475,19620,19665,19300,19430,19530,-45,55,482,"4,707.49",2574
,20180111,19430,19530,19510,19510,19350,19415,19395,-115,-135,350,"3,394.90",2530
,20180112,19415,19395,19420,19440,19195,19295,19300,-100,-95,874,"8,434.78",2400
,20180115,19295,19300,19200,19260,19100,19235,19170,-65,-130,1362,"13,057.49",2710
,20180116,19235,19170,19255,19255,18810,18900,19020,-270,-150,1278,"12,153.98",2840
,20180117,18900,19020,18850,19205,18845,19165,19100,145,80,1400,"13,370.24",3288
,20180118,19165,19100,19145,19290,19070,19240,19215,140,115,2260,"21,714.48",3738
,20180119,19240,19215,19265,19530,19265,19510,19420,295,205,2132,"20,703.32",4464
,20180122,19510,19420,19510,19510,19280,19455,19365,35,-55,1800,"17,432.79",4874
,20180123,19455,19365,19460,19725,19320,19680,19510,315,145,2040,"19,904.23",5804
,20180124,19680,19510,19580,19700,19495,19520,19615,10,105,1428,"14,006.69",6100
,20180125,19520,19615,19555,19800,19505,19665,19625,50,10,4804,"47,140.60",7594
,20180126,19665,19625,19505,19610,19395,19465,19505,-160,-120,2878,"28,072.26",7792
,20180129,19465,19505,19540,19815,19455,19725,19650,220,145,2894,"28,440.74",8288
,20180130,19725,19650,19725,19755,19465,19475,19580,-175,-70,3718,"36,401.79",8494
,20180131,19475,19580,19540,19600,19350,19400,19450,-180,-130,1830,"17,797.67",8542
,20180201,19400,19450,19450,19625,19380,19555,19495,105,45,2132,"20,786.84",8828
,20180202,19555,19495,19620,19755,19580,19640,19660,145,165,2574,"25,302.95",9810
,20180205,19640,19660,19565,19690,19455,19510,19545,-150,-115,3120,"30,491.02",10850
,20180206,19510,19545,19505,19600,19385,19440,19455,-105,-90,1608,"15,644.54",11184
,20180207,19440,19455,19360,19380,19130,19175,19270,-280,-185,3496,"33,684.59",11646
,20180208,19175,19270,19175,19245,19005,19060,19115,-210,-155,4158,"39,743.17",11546
,20180209,19060,19115,19230,19230,18965,19040,19075,-75,-40,2552,"24,344.56",11794
,20180212,19040,19075,19050,19150,19005,19040,19075,-35,0,4092,"39,029.65",12354
,20180213,19040,19075,19000,19055,18920,19030,18985,-45,-90,2776,"26,355.23",12670
,20180214,19030,18985,19025,19325,19015,19290,19190,305,205,3334,"31,997.16",12676
,20180222,19290,19190,19290,19290,19115,19215,19180,25,-10,2776,"26,626.94",13230
,20180223,19215,19180,19215,19380,19205,19305,19310,125,130,5468,"52,797.08",14830
,20180226,19305,19310,19260,19400,19185,19370,19290,60,-20,6106,"58,906.58",15652
,20180227,19370,19290,19450,19500,19350,19420,19430,130,140,5630,"54,704.72",17032
,20180228,19420,19430,19420,19420,19090,19210,19235,-220,-195,12362,"118,902.54",20528
,20180301,19210,19235,19175,19175,19025,19090,19090,-145,-145,12448,"118,843.80",22396
,20180302,19090,19090,18950,18950,18765,18885,18855,-205,-235,15688,"147,914.93",23488
,20180305,18885,18855,18850,18950,18720,18725,18820,-130,-35,15250,"143,527.57",24944
,20180306,18725,18820,18680,18710,18490,18615,18615,-205,-205,17930,"166,884.55",26860
,20180307,18615,18615,18665,18740,18610,18650,18670,35,55,14256,"133,097.31",28054
,20180308,18650,18670,18635,18680,18340,18495,18485,-175,-185,22038,"203,731.73",28782
,20180309,18495,18485,18435,18500,18200,18355,18330,-130,-155,25066,"229,769.41",31802
,20180312,18355,18330,18350,18520,18280,18350,18395,20,65,28938,"266,200.31",30964
,20180313,18350,18395,18285,18315,18050,18120,18150,-275,-245,28892,"262,243.31",34210
,20180314,18120,18150,18405,18420,18245,18385,18330,235,180,35280,"323,428.43",34524
,20180315,18385,18330,18500,18610,18370,18460,18495,130,165,58528,"541,244.93",40770
,20180316,18460,18495,18435,18575,18375,18550,18475,55,-20,49102,"453,656.51",41954
,20180319,18550,18475,18540,18625,18305,18345,18460,-130,-15,48210,"445,022.27",43090
,20180320,18345,18460,18330,18445,18250,18325,18355,-135,-105,42282,"388,046.09",42092
,20180321,18325,18355,18380,18420,18150,18355,18290,0,-65,51428,"470,330.81",45806
,20180322,18355,18290,18450,18920,18390,18855,18685,565,395,92420,"863,595.53",55834
,20180323,18855,18685,18700,18800,18275,18435,18560,-250,-125,93890,"871,511.87",50446
,20180326,18435,18560,18435,18550,18290,18405,18410,-155,-150,63910,"588,383.95",48474
,20180327,18405,18410,18475,18665,18385,18570,18535,160,125,60024,"556,287.71",49756
,20180328,18570,18535,18555,18735,18465,18645,18610,110,75,58440,"543,874.92",50970
,20180329,18645,18610,18645,18780,18550,18735,18660,125,50,55544,"518,226.98",52214
,20180330,18735,18660,18735,18870,18560,18825,18710,165,50,46530,"435,331.42",53932
,20180402,18825,18710,18815,19110,18800,18895,18915,185,205,56132,"530,990.81",53678
,20180403,18895,18915,18845,18900,18640,18705,18765,-210,-150,41650,"390,818.06",51850
,20180404,18705,18765,18770,18770,18610,18640,18680,-125,-85,37362,"349,050.13",48154
,20180409,18640,18680,18690,18745,18435,18555,18550,-125,-130,32814,"304,379.45",47228
,20180410,18555,18550,18605,18605,18380,18490,18460,-60,-90,41200,"380,354.12",43980
,20180411,18490,18460,18490,18595,18435,18485,18495,25,35,26900,"248,813.96",42434
,20180412,18485,18495,18515,18645,18350,18475,18515,-20,20,57724,"534,396.80",41718
,20180413,18475,18515,18375,18380,18115,18365,18280,-150,-235,53978,"493,377.54",39844
,20180416,18365,18280,18300,18350,18035,18350,18195,70,-85,52874,"481,069.51",35032
,20180417,18350,18195,18320,18580,18305,18395,18445,200,250,30110,"277,690.22",29894
,20180418,18395,18445,18325,18495,18260,18380,18380,-65,-65,18710,"171,945.79",26534
,20180419,18380,18380,18560,18685,18450,18510,18570,130,190,16608,"154,218.23",23158
,20180420,18510,18570,18435,18495,18325,18475,18420,-95,-150,9946,"91,619.54",22044
,20180423,18475,18420,18565,18590,18425,18565,18510,145,90,7960,"73,672.63",19242
,20180424,18565,18510,18415,18550,18380,18530,18500,20,-10,6764,"62,571.91",17416
,20180425,18530,18500,18630,18630,18405,18405,18495,-95,-5,6878,"63,613.42",13474
,20180426,18405,18495,18420,18485,18310,18420,18395,-75,-100,6094,"56,064.02",10158
,20180427,18420,18395,18340,18575,18340,18495,18450,100,55,4462,"41,171.97",7318
,20180502,18495,18450,18520,18740,18520,18700,18660,250,210,1438,"13,417.12",6670
,20180503,18700,18660,18705,18755,18615,18680,18680,20,20,1690,"15,784.98",5820
,20180504,18680,18680,19590,19590,18650,18700,18695,20,15,1390,"12,995.38",4950
,20180507,18700,18695,18695,19080,18695,19070,18905,375,210,1260,"11,911.28",4420
,20180508,19070,18905,19100,19175,19085,19120,19120,215,215,970,"9,273.53",4090
,20180509,19120,19120,19100,19150,18970,19150,19080,30,-40,1020,"9,732.95",2700
,20180510,19150,19080,19150,19200,19080,19110,19100,30,20,970,"9,265.65",2180
,20180511,19110,19100,19100,19375,19100,19310,19265,210,165,560,"5,395.00",1930
,20180514,19310,19265,19410,19650,19410,19600,19580,335,315,510,"4,993.10",2150
,20180515,19600,19580,18755,19500,18755,19500,19425,-80,-155,160,"1,554.30",2280
pb1806,20180102,19095,19120,19100,19100,18940,18940,18990,-180,-130,6,56.98,188
,20180103,18940,18990,19210,19295,19210,19285,19230,295,240,20,192.35,192
,20180104,19285,19230,19270,19420,19235,19420,19305,190,75,6,57.93,190
,20180105,19420,19305,19415,19610,19360,19450,19485,145,180,14,136.43,186
,20180108,19450,19485,19390,19390,19390,19390,19390,-95,-95,2,19.39,184
,20180109,19390,19390,19380,19560,19380,19560,19470,170,80,4,38.94,182
,20180110,19560,19470,,,,19470,19470,0,0,0,0.00,182
,20180111,19470,19470,19410,19415,19340,19340,19375,-130,-95,8,77.51,178
,20180112,19340,19375,,,,19375,19375,0,0,0,0.00,178
,20180115,19375,19375,19180,19230,19080,19180,19175,-195,-200,62,594.46,218
,20180116,19180,19175,19000,19275,18915,18915,19105,-260,-70,120,"1,146.41",196
,20180117,18915,19105,18895,19165,18895,19135,19115,30,10,16,152.93,200
,20180118,19135,19115,19085,19215,19050,19215,19085,100,-30,42,400.88,192
,20180119,19215,19085,19450,19450,19435,19440,19445,355,360,104,"1,011.27",278
,20180122,19440,19445,19415,19415,19250,19320,19280,-125,-165,108,"1,041.38",360
,20180123,19320,19280,19345,19680,19345,19650,19590,370,310,132,"1,293.01",472
,20180124,19650,19590,19640,19685,19260,19510,19540,-80,-50,62,605.84,496
,20180125,19510,19540,19520,19700,19500,19600,19565,60,25,114,"1,115.27",474
,20180126,19600,19565,19500,19560,19395,19450,19475,-115,-90,36,350.60,480
,20180129,19450,19475,19425,19745,19425,19745,19660,270,185,62,609.47,510
,20180130,19745,19660,19630,19635,19400,19400,19545,-260,-115,40,390.91,496
,20180131,19400,19545,19400,19450,19365,19405,19395,-140,-150,178,"1,726.47",578
,20180201,19405,19395,19365,19555,19365,19550,19485,155,90,60,584.56,590
,20180202,19550,19485,19695,19700,19600,19655,19635,170,150,184,"1,806.42",664
,20180205,19655,19635,19565,19650,19565,19650,19640,15,5,24,235.69,674
,20180206,19650,19640,19500,19525,19500,19525,19505,-115,-135,8,78.03,672
,20180207,19525,19505,19300,19370,19150,19155,19250,-350,-255,30,288.78,654
,20180208,19155,19250,19185,19185,19000,19060,19080,-190,-170,46,438.86,646
,20180209,19060,19080,19090,19090,18960,18960,19015,-120,-65,54,513.44,646
,20180212,18960,19015,19050,19100,19010,19030,19040,15,25,124,"1,180.75",726
,20180213,19030,19040,18970,19055,18970,19000,19020,-40,-20,20,190.22,728
,20180214,19000,19020,19060,19275,19060,19275,19225,255,205,38,365.30,726
,20180222,19275,19225,19160,19190,19145,19170,19160,-55,-65,48,459.92,718
,20180223,19170,19160,19190,19330,19190,19285,19265,125,105,214,"2,061.65",872
,20180226,19285,19265,19235,19350,19195,19330,19265,65,0,322,"3,101.85",970
,20180227,19330,19265,19400,19470,19315,19390,19395,125,130,344,"3,336.23",1158
,20180228,19390,19395,19310,19345,19065,19160,19230,-235,-165,592,"5,692.63",1370
,20180301,19160,19230,19085,19115,19000,19050,19060,-180,-170,464,"4,422.65",1362
,20180302,19050,19060,18860,18900,18745,18860,18820,-200,-240,974,"9,167.67",1704
,20180305,18860,18820,18840,18915,18690,18700,18790,-120,-30,924,"8,682.02",2194
,20180306,18700,18790,18600,18665,18455,18565,18575,-225,-215,1818,"16,884.95",2948
,20180307,18565,18575,18620,18690,18565,18575,18620,0,45,1296,"12,065.81",3170
,20180308,18575,18620,18610,18610,18290,18410,18420,-210,-200,1572,"14,478.26",3344
,20180309,18410,18420,18390,18435,18125,18275,18270,-145,-150,3160,"28,868.80",4306
,20180312,18275,18270,18255,18410,18185,18200,18285,-70,15,5814,"53,164.85",7600
,20180313,18200,18285,18155,18165,17955,18040,18040,-245,-245,2342,"21,128.63",7920
,20180314,18040,18040,18305,18315,18155,18280,18245,240,205,2998,"27,350.80",8158
,20180315,18280,18245,18420,18455,18240,18310,18360,65,115,5082,"46,663.63",9904
,20180316,18310,18360,18285,18480,18240,18460,18380,100,20,5416,"49,785.26",9338
,20180319,18460,18380,18480,18515,18200,18230,18350,-150,-30,4028,"36,965.26",10174
,20180320,18230,18350,18210,18335,18135,18215,18230,-135,-120,3186,"29,043.94",10872
,20180321,18215,18230,18205,18295,18020,18180,18150,-50,-80,6670,"60,545.35",12874
,20180322,18180,18150,18300,18770,18255,18720,18535,570,385,8830,"81,847.07",15250
,20180323,18720,18535,18595,18650,18135,18285,18425,-250,-110,16236,"149,608.95",16344
,20180326,18285,18425,18280,18420,18175,18260,18285,-165,-140,13572,"124,084.90",17434
,20180327,18260,18285,18305,18480,18250,18420,18385,135,100,11128,"102,309.11",17978
,20180328,18420,18385,18425,18540,18350,18435,18430,50,45,13194,"121,600.51",21256
,20180329,18435,18430,18435,18580,18360,18540,18465,110,35,12132,"112,030.77",21640
,20180330,18540,18465,18500,18600,18330,18565,18480,100,15,7838,"72,441.40",22716
,20180402,18565,18480,18555,18800,18515,18585,18600,105,120,16794,"156,199.86",23790
,20180403,18585,18600,18585,18600,18405,18485,18500,-115,-100,14734,"136,291.04",24016
,20180404,18485,18500,18550,18580,18460,18465,18520,-35,20,15674,"145,158.23",25252
,20180409,18465,18520,18480,18625,18255,18440,18420,-80,-100,11854,"109,175.39",24544
,20180410,18440,18420,18490,18490,18265,18370,18335,-50,-85,21880,"200,620.39",24140
,20180411,18370,18335,18380,18470,18315,18365,18375,30,40,15506,"142,482.18",25618
,20180412,18365,18375,18345,18490,18100,18280,18335,-95,-40,47804,"438,298.31",34618
,20180413,18280,18335,18120,18215,17970,18160,18115,-175,-220,47016,"425,863.89",37482
,20180416,18160,18115,18150,18160,17785,18100,17965,-15,-150,69820,"627,287.21",42242
,20180417,18100,17965,18140,18300,18045,18155,18195,190,230,64858,"590,065.70",46816
,20180418,18155,18195,18050,18250,18020,18170,18135,-25,-60,67528,"612,357.97",48364
,20180419,18170,18135,18405,18530,18290,18350,18400,215,265,71996,"662,542.48",46966
,20180420,18350,18400,18250,18340,18140,18325,18240,-75,-160,54986,"501,604.73",47032
,20180423,18325,18240,18465,18470,18305,18440,18385,200,145,41808,"384,403.78",48012
,20180424,18440,18385,18305,18415,18240,18365,18355,-20,-30,39132,"359,174.52",47998
,20180425,18365,18355,18410,18440,18215,18215,18315,-140,-40,41326,"378,468.92",48204
,20180426,18215,18315,18285,18285,18110,18225,18205,-90,-110,56992,"518,835.26",49926
,20180427,18225,18205,18220,18430,18200,18370,18300,165,95,50264,"459,955.71",50320
,20180502,18370,18300,18350,18595,18300,18590,18455,290,155,33906,"312,936.98",55046
,20180503,18590,18455,18560,18605,18400,18510,18475,55,20,40122,"370,715.78",54952
,20180504,18510,18475,18525,18570,18420,18550,18495,75,20,42816,"396,026.96",58160
,20180507,18550,18495,18530,18965,18495,18865,18755,370,260,59922,"562,034.77",64864
,20180508,18865,18755,18875,18980,18830,18955,18900,200,145,32072,"303,098.73",64232
,20180509,18955,18900,18950,18990,18790,18950,18895,50,-5,39630,"374,473.05",66900
,20180510,18950,18895,18930,18960,18850,18935,18905,40,10,32684,"309,004.84",67072
,20180511,18935,18905,19015,19245,19010,19160,19140,255,235,62036,"593,833.62",67910
,20180514,19160,19140,19240,19815,19185,19385,19495,245,355,89236,"869,947.49",62738
,20180515,19385,19495,19465,19530,19305,19490,19410,-5,-85,40442,"392,590.14",61776
,20180516,19490,19410,19400,19490,19250,19410,19335,0,-75,36262,"350,635.10",58084
,20180517,19410,19335,19335,19635,19300,19410,19460,75,125,44306,"431,159.41",56698
,20180518,19410,19460,19420,19705,19360,19665,19545,205,85,30518,"298,313.13",57848
,20180521,19665,19545,19600,19920,19580,19825,19760,280,215,40364,"398,815.45",56780
,20180522,19825,19760,19825,20465,19820,20200,20225,440,465,91824,"928,761.95",49930
,20180523,20200,20225,20400,20450,19990,20200,20205,-25,-20,48154,"486,525.77",44168
,20180524,20200,20205,20120,20545,20040,20445,20355,240,150,38888,"395,861.48",38736
,20180525,20445,20355,20410,20650,20365,20415,20520,60,165,25792,"264,636.07",31226
,20180528,20415,20520,20310,20390,20155,20315,20260,-205,-260,14720,"149,129.52",27162
,20180529,20315,20260,20305,20530,20215,20395,20335,135,75,16614,"168,940.81",20914
,20180530,20395,20335,20310,20390,20050,20085,20185,-250,-150,13116,"132,388.38",15930
,20180531,20085,20185,20085,20265,20085,20220,20160,35,-25,6634,"66,884.94",12524
pb1807,20180102,19150,19135,19110,19110,19110,19110,19110,-25,-25,2,19.11,116
,20180103,19110,19110,19285,19295,19285,19295,19290,185,180,6,57.88,120
,20180104,19295,19290,19160,19270,19160,19265,19210,-25,-80,18,172.93,122
,20180105,19265,19210,19415,19425,19410,19425,19415,215,205,18,174.76,124
,20180108,19425,19415,19470,19470,19380,19390,19420,-25,5,18,174.79,124
,20180109,19390,19420,19475,19475,19475,19475,19475,55,55,2,19.48,122
,20180110,19475,19475,,,,19475,19475,0,0,0,0.00,122
,20180111,19475,19475,19425,19425,19350,19380,19370,-95,-105,18,174.34,128
,20180112,19380,19370,19420,19420,19290,19290,19310,-80,-60,12,115.88,132
,20180115,19290,19310,19200,19200,19130,19200,19180,-110,-130,18,172.66,138
,20180116,19200,19180,18880,19160,18875,18910,18945,-270,-235,20,189.46,140
,20180117,18910,18945,19185,19185,19130,19130,19155,185,210,4,38.32,138
,20180118,19130,19155,19195,19235,19080,19235,19200,80,45,12,115.22,138
,20180119,19235,19200,19455,19500,19450,19500,19455,300,255,18,175.14,146
,20180122,19500,19455,19265,19280,19265,19280,19275,-175,-180,6,57.83,148
,20180123,19280,19275,19640,19640,19640,19640,19640,365,365,16,157.12,162
,20180124,19640,19640,19600,19620,19580,19580,19605,-60,-35,18,176.45,162
,20180125,19580,19605,19640,19640,19545,19545,19575,-60,-30,22,215.36,156
,20180126,19545,19575,19525,19530,19300,19445,19475,-130,-100,94,915.36,154
,20180129,19445,19475,19450,19720,19450,19720,19585,245,110,4,39.17,156
,20180130,19720,19585,19505,19575,19500,19575,19525,-10,-60,6,58.58,156
,20180131,19575,19525,19350,19405,19305,19405,19350,-120,-175,20,193.52,158
,20180201,19405,19350,19410,19410,19385,19390,19395,40,45,32,310.36,158
,20180202,19390,19395,19560,19560,19560,19560,19560,165,165,2,19.56,158
,20180205,19560,19560,,,,19560,19560,0,0,0,0.00,158
,20180206,19560,19560,19360,19360,19360,19360,19360,-200,-200,2,19.36,158
,20180207,19360,19360,19220,19220,19125,19125,19140,-235,-220,10,95.72,150
,20180208,19125,19140,,,,19140,19140,0,0,0,0.00,150
,20180209,19140,19140,19035,19065,18945,18950,19000,-190,-140,106,"1,007.19",110
,20180212,18950,19000,19060,19060,19060,19060,19060,60,60,4,38.12,110
,20180213,19060,19060,18985,18985,18905,18935,18935,-125,-125,10,94.68,110
,20180214,18935,18935,19155,19340,19155,19270,19235,335,300,20,192.36,112
,20180222,19270,19235,19175,19175,19120,19150,19145,-85,-90,16,153.17,118
,20180223,19150,19145,19270,19420,19215,19270,19285,125,140,74,713.68,160
,20180226,19270,19285,,,,19285,19285,0,0,0,0.00,160
,20180227,19285,19285,19395,19430,19335,19430,19385,145,100,54,523.53,144
,20180228,19430,19385,19310,19335,19050,19085,19265,-300,-120,40,385.34,138
,20180301,19085,19265,19020,19020,18980,18980,18980,-285,-285,22,208.82,144
,20180302,18980,18980,,,,18980,18980,0,0,0,0.00,144
,20180305,18980,18980,18800,18800,18750,18750,18760,-230,-220,28,262.70,166
,20180306,18750,18760,18645,18645,18510,18510,18555,-250,-205,62,575.28,220
,20180307,18510,18555,18665,18665,18585,18585,18630,30,75,18,167.69,230
,20180308,18585,18630,18515,18515,18325,18325,18380,-305,-250,58,533.02,276
,20180309,18325,18380,18320,18320,18090,18140,18180,-240,-200,702,"6,381.32",534
,20180312,18140,18180,18285,18300,18110,18110,18245,-70,65,400,"3,649.53",746
,20180313,18110,18245,17990,18040,17945,18015,17990,-230,-255,124,"1,115.55",780
,20180314,18015,17990,18155,18190,18110,18190,18125,200,135,48,435.01,822
,20180315,18190,18125,18285,18385,18200,18290,18305,165,180,192,"1,757.51",906
,20180316,18290,18305,18210,18410,18170,18365,18285,60,-20,322,"2,944.66",868
,20180319,18365,18285,18400,18400,18150,18160,18230,-125,-55,98,893.43,914
,20180320,18160,18230,18130,18245,18050,18130,18140,-100,-90,158,"1,433.36",956
,20180321,18130,18140,18000,18195,17950,18120,18075,-20,-65,200,"1,807.96",1038
,20180322,18120,18075,18205,18650,18190,18580,18425,505,350,168,"1,547.89",1082
,20180323,18580,18425,18435,18495,17980,18220,18240,-205,-185,618,"5,637.17",1286
,20180326,18220,18240,18180,18300,18120,18175,18190,-65,-50,828,"7,531.84",1344
,20180327,18175,18190,18240,18375,18200,18365,18315,175,125,740,"6,778.07",1896
,20180328,18365,18315,18360,18430,18270,18300,18320,-15,5,808,"7,402.71",1858
,20180329,18300,18320,18315,18375,18250,18370,18305,50,-15,194,"1,775.94",1902
,20180330,18370,18305,18350,18420,18230,18405,18305,100,0,160,"1,464.62",1936
,20180402,18405,18305,18440,18560,18320,18385,18395,80,90,1462,"13,449.45",2398
,20180403,18385,18395,18375,18400,18210,18295,18285,-100,-110,2222,"20,320.07",2890
,20180404,18295,18285,18315,18450,18275,18390,18360,105,75,1926,"17,684.31",3360
,20180409,18390,18360,18360,18460,18150,18270,18255,-90,-105,906,"8,271.24",3332
,20180410,18270,18255,18265,18280,18175,18260,18220,5,-35,1418,"12,921.39",3414
,20180411,18260,18220,18265,18330,18195,18230,18255,10,35,1094,"9,987.15",3454
,20180412,18230,18255,18270,18320,18000,18110,18165,-145,-90,4078,"37,040.56",5194
,20180413,18110,18165,17930,18070,17835,18005,17970,-160,-195,4150,"37,292.84",6570
,20180416,18005,17970,17995,18020,17610,17945,17810,-25,-160,4742,"42,235.96",7338
,20180417,17945,17810,17995,18100,17905,17950,18005,140,195,4606,"41,468.85",7700
,20180418,17950,18005,17865,18050,17835,18015,17950,10,-55,4114,"36,926.79",7950
,20180419,18015,17950,18120,18650,18120,18215,18240,265,290,5208,"47,504.85",8500
,20180420,18215,18240,18050,18180,17985,18165,18090,-75,-150,5330,"48,211.33",9858
,20180423,18165,18090,18260,18325,18155,18295,18250,205,160,5224,"47,675.43",12042
,20180424,18295,18250,18150,18260,18085,18235,18205,-15,-45,6908,"62,896.55",13982
,20180425,18235,18205,18285,18305,18075,18075,18185,-130,-20,9394,"85,416.96",17076
,20180426,18075,18185,18125,18135,17980,18065,18060,-120,-125,9998,"90,284.36",18766
,20180427,18065,18060,18070,18250,18055,18185,18130,125,70,12640,"114,594.23",22644
,20180502,18185,18130,18140,18380,18115,18375,18265,245,135,8482,"77,465.34",23808
,20180503,18375,18265,18330,18400,18160,18270,18250,5,-15,14248,"130,038.98",24784
,20180504,18270,18250,18270,18310,18155,18280,18230,30,-20,12572,"114,619.94",25702
,20180507,18280,18230,18235,18680,18200,18615,18475,385,245,19638,"181,417.87",30372
,20180508,18615,18475,18560,18715,18560,18690,18630,215,155,10214,"95,151.55",31580
,20180509,18690,18630,18680,18685,18520,18650,18615,20,-15,15430,"143,622.40",34244
,20180510,18650,18615,18655,18655,18555,18620,18605,5,-10,10782,"100,312.79",35492
,20180511,18620,18605,18670,18840,18655,18795,18765,190,160,28436,"266,804.86",40984
,20180514,18795,18765,18885,19275,18820,18905,19000,140,235,33234,"315,801.16",46650
,20180515,18905,19000,19000,19010,18830,18990,18925,-10,-75,21370,"202,258.30",47586
,20180516,18990,18925,18830,18985,18760,18900,18850,-25,-75,17452,"164,520.78",47780
,20180517,18900,18850,18825,19155,18805,18870,18955,20,105,33736,"319,766.32",49416
,20180518,18870,18955,18880,19200,18875,19170,19050,215,95,22738,"216,612.66",52444
,20180521,19170,19050,19090,19435,19090,19310,19255,260,205,36706,"353,406.93",58706
,20180522,19310,19255,19325,19760,19325,19685,19595,430,340,61356,"601,231.65",61928
,20180523,19685,19595,19885,19895,19520,19750,19690,155,95,50210,"494,375.11",64234
,20180524,19750,19690,19740,20100,19625,19990,19890,300,200,99048,"985,237.54",74710
,20180525,19990,19890,20000,20225,19955,19995,20085,105,195,103500,"1,039,442.97",78102
,20180528,19995,20085,19915,19960,19635,19870,19800,-215,-285,97126,"961,644.42",73886
,20180529,19870,19800,19890,20210,19750,20065,19965,265,165,109648,"1,094,577.29",77094
,20180530,20065,19965,20045,20055,19785,19835,19890,-130,-75,70108,"697,305.41",77402
,20180531,19835,19890,19885,20115,19855,19940,19975,50,85,64822,"647,433.75",77668
pb1808,20180102,19125,19125,19100,19105,18900,18900,19010,-225,-115,8,76.06,46
,20180103,18900,19010,19355,19355,19355,19355,19355,345,345,2,19.36,48
,20180104,19355,19355,19280,19280,19280,19280,19280,-75,-75,2,19.28,48
,20180105,19280,19280,19445,19445,19400,19400,19430,120,150,6,58.29,42
,20180108,19400,19430,,,,19430,19430,0,0,0,0.00,42
,20180109,19430,19430,,,,19500,19500,70,70,0,0.00,42
,20180110,19500,19500,,,,19500,19500,0,0,0,0.00,42
,20180111,19500,19500,19340,19400,19340,19400,19360,-100,-140,8,77.44,44
,20180112,19400,19360,,,,19360,19360,0,0,0,0.00,44
,20180115,19360,19360,19165,19230,19165,19230,19215,-130,-145,16,153.74,54
,20180116,19230,19215,,,,19215,19215,0,0,0,0.00,54
,20180117,19215,19215,19100,19190,19100,19190,19170,-25,-45,10,95.86,62
,20180118,19190,19170,19255,19255,19250,19255,19250,85,80,26,250.30,88
,20180119,19255,19250,19355,19430,19335,19430,19370,180,120,26,251.87,90
,20180122,19430,19370,19400,19400,19280,19280,19340,-90,-30,4,38.68,86
,20180123,19280,19340,,,,19340,19340,0,0,0,0.00,86
,20180124,19340,19340,,,,19305,19305,-35,-35,0,0.00,86
,20180125,19305,19305,,,,19305,19305,0,0,0,0.00,86
,20180126,19305,19305,19500,19500,19445,19445,19480,140,175,22,214.30,88
,20180129,19445,19480,19690,19690,19690,19690,19690,210,210,2,19.69,86
,20180130,19690,19690,,,,19690,19690,0,0,0,0.00,86
,20180131,19690,19690,,,,19380,19380,-310,-310,0,0.00,86
,20180201,19380,19380,19395,19410,19330,19330,19370,-50,-10,26,251.84,84
,20180202,19330,19370,,,,19500,19500,130,130,0,0.00,84
,20180205,19500,19500,,,,19500,19500,0,0,0,0.00,84
,20180206,19500,19500,,,,19450,19450,-50,-50,0,0.00,84
,20180207,19450,19450,19110,19110,19110,19110,19110,-340,-340,2,19.11,82
,20180208,19110,19110,19070,19070,19070,19070,19070,-40,-40,2,19.07,80
,20180209,19070,19070,,,,19070,19070,0,0,0,0.00,80
,20180212,19070,19070,,,,19070,19070,0,0,0,0.00,80
,20180213,19070,19070,,,,19000,19000,-70,-70,0,0.00,80
,20180214,19000,19000,,,,19000,19000,0,0,0,0.00,80
,20180222,19000,19000,19130,19140,19130,19135,19135,135,135,12,114.81,88
,20180223,19135,19135,19255,19280,19240,19240,19255,105,120,6,57.78,82
,20180226,19240,19255,19190,19190,19165,19165,19180,-90,-75,6,57.55,84
,20180227,19165,19180,,,,19180,19180,0,0,0,0.00,84
,20180228,19180,19180,19000,19085,19000,19085,19030,-95,-150,8,76.13,88
,20180301,19085,19030,19005,19030,18990,18990,19010,-40,-20,22,209.15,76
,20180302,18990,19010,18675,18780,18675,18780,18740,-230,-270,8,74.96,74
,20180305,18780,18740,,,,18740,18740,0,0,0,0.00,74
,20180306,18740,18740,,,,18585,18585,-155,-155,0,0.00,74
,20180307,18585,18585,18630,18630,18540,18550,18575,-35,-10,8,74.31,76
,20180308,18550,18575,18385,18445,18215,18340,18340,-235,-235,12,110.07,76
,20180309,18340,18340,18175,18175,18000,18000,18110,-340,-230,88,797.03,134
,20180312,18000,18110,18245,18245,18075,18220,18200,110,90,42,382.26,148
,20180313,18220,18200,17950,17990,17870,17990,17895,-210,-305,36,322.16,148
,20180314,17990,17895,,,,18010,18010,115,115,0,0.00,148
,20180315,18010,18010,18280,18280,18210,18210,18265,200,255,12,109.61,154
,20180316,18210,18265,18300,18310,18300,18310,18300,45,35,10,91.51,154
,20180319,18310,18300,,,,18140,18140,-160,-160,0,0.00,154
,20180320,18140,18140,,,,18095,18095,-45,-45,0,0.00,154
,20180321,18095,18095,17980,17980,17980,17980,17980,-115,-115,2,17.98,156
,20180322,17980,17980,18215,18570,18190,18540,18390,560,410,32,294.25,166
,20180323,18540,18390,18340,18340,18100,18105,18155,-285,-235,22,199.73,158
,20180326,18105,18155,18125,18125,18070,18070,18090,-85,-65,20,180.92,154
,20180327,18070,18090,18285,18285,18285,18285,18285,195,195,2,18.29,156
,20180328,18285,18285,18340,18340,18245,18245,18255,-40,-30,66,602.51,198
,20180329,18245,18255,,,,18255,18255,0,0,0,0.00,198
,20180330,18255,18255,18220,18340,18220,18305,18265,50,10,20,182.68,202
,20180402,18305,18265,18250,18500,18250,18300,18370,35,105,12,110.23,206
,20180403,18300,18370,18300,18300,18105,18125,18185,-245,-185,16,145.49,214
,20180404,18125,18185,18195,18235,18195,18235,18225,50,40,32,291.60,198
,20180409,18235,18225,18300,18300,18100,18240,18150,15,-75,58,526.42,200
,20180410,18240,18150,18300,18300,18045,18125,18240,-25,90,78,711.46,194
,20180411,18125,18240,18195,18205,18100,18115,18155,-125,-85,52,472.10,226
,20180412,18115,18155,17955,18150,17800,17905,17980,-250,-175,154,"1,384.73",218
,20180413,17905,17980,17945,17975,17760,17850,17885,-130,-95,76,679.67,244
,20180416,17850,17885,17840,17840,17465,17745,17610,-140,-275,90,792.51,272
,20180417,17745,17610,17900,17950,17795,17850,17865,240,255,134,"1,197.01",272
,20180418,17850,17865,17780,17900,17725,17820,17795,-45,-70,94,836.41,322
,20180419,17820,17795,18000,18235,18000,18040,18110,245,315,378,"3,423.01",302
,20180420,18040,18110,18040,18045,17880,18030,17975,-80,-135,50,449.45,316
,20180423,18030,17975,18095,18190,18025,18190,18130,215,155,124,"1,124.11",350
,20180424,18190,18130,18055,18150,18000,18145,18090,15,-40,124,"1,121.83",380
,20180425,18145,18090,18145,18150,17915,17950,18080,-140,-10,912,"8,244.54",1116
,20180426,17950,18080,17950,18015,17890,17950,17940,-130,-140,1094,"9,814.26",1796
,20180427,17950,17940,17985,18100,17940,18100,17975,160,35,1174,"10,553.95",2592
,20180502,18100,17975,18080,18200,17980,18200,18085,225,110,1250,"11,303.52",3486
,20180503,18200,18085,18135,18210,18005,18100,18125,15,40,1602,"14,518.99",4558
,20180504,18100,18125,18090,18125,17990,18065,18070,-60,-55,850,"7,681.48",4950
,20180507,18065,18070,18085,18460,18050,18330,18220,260,150,1836,"16,726.98",5746
,20180508,18330,18220,18395,18490,18350,18475,18415,255,195,1484,"13,667.20",6490
,20180509,18475,18415,18435,18445,18315,18395,18390,-20,-25,2074,"19,071.69",7678
,20180510,18395,18390,18395,18410,18320,18365,18360,-25,-30,1074,"9,859.67",8270
,20180511,18365,18360,18450,18545,18375,18470,18465,110,105,2928,"27,037.08",9410
,20180514,18470,18465,18510,18945,18510,18580,18705,115,240,3884,"36,331.32",10932
,20180515,18580,18705,18590,18660,18465,18640,18570,-65,-135,2010,"18,664.00",10788
,20180516,18640,18570,18450,18660,18425,18590,18520,20,-50,1190,"11,020.43",10928
,20180517,18590,18520,18535,18830,18480,18540,18620,20,100,2390,"22,254.08",11616
,20180518,18540,18620,18500,18810,18500,18795,18680,175,60,2028,"18,946.21",12012
,20180521,18795,18680,18700,18940,18700,18890,18865,210,185,4954,"46,729.62",14186
,20180522,18890,18865,18905,19280,18895,19225,19125,360,260,6488,"62,053.32",14752
,20180523,19225,19125,19420,19445,19095,19330,19255,205,130,5800,"55,845.03",15214
,20180524,19330,19255,19305,19625,19200,19565,19450,310,195,4684,"45,552.17",15800
,20180525,19565,19450,19565,19790,19515,19600,19645,150,195,6054,"59,468.24",16322
,20180528,19600,19645,19510,19580,19255,19490,19420,-155,-225,7590,"73,711.57",17860
,20180529,19490,19420,19535,19835,19410,19740,19660,320,240,14010,"137,726.30",21736
,20180530,19740,19660,19700,19700,19460,19500,19555,-160,-105,12008,"117,437.74",22904
,20180531,19500,19555,19555,19765,19510,19590,19630,35,75,9696,"95,186.46",24946
pb1809,20180102,19180,19140,19095,19095,18960,18995,19015,-145,-125,58,551.52,74
,20180103,18995,19015,19235,19365,19150,19340,19250,325,235,194,"1,867.71",94
,20180104,19340,19250,19335,19480,19220,19480,19310,230,60,190,"1,834.91",92
,20180105,19480,19310,19480,19505,19410,19505,19455,195,145,136,"1,323.17",100
,20180108,19505,19455,19520,19555,19365,19365,19455,-90,0,196,"1,906.76",102
,20180109,19365,19455,19395,19660,19370,19645,19485,190,30,328,"3,195.59",104
,20180110,19645,19485,19570,19630,19345,19455,19475,-30,-10,126,"1,227.04",102
,20180111,19455,19475,19455,19510,19285,19425,19355,-50,-120,380,"3,678.37",164
,20180112,19425,19355,19410,19410,19245,19310,19295,-45,-60,216,"2,084.28",192
,20180115,19310,19295,19200,19300,19115,19300,19210,5,-85,204,"1,959.61",162
,20180116,19300,19210,19275,19275,18920,19000,19110,-210,-100,102,974.79,156
,20180117,19000,19110,18925,19215,18925,19205,19160,95,50,38,364.08,158
,20180118,19205,19160,19180,19290,19090,19260,19200,100,40,20,192.05,146
,20180119,19260,19200,19345,19480,19315,19480,19390,280,190,46,446.03,174
,20180122,19480,19390,19395,19430,19275,19275,19355,-115,-35,16,154.88,170
,20180123,19275,19355,19390,19640,19390,19640,19535,285,180,12,117.23,168
,20180124,19640,19535,19630,19630,19550,19550,19585,15,50,12,117.53,166
,20180125,19550,19585,,,,19585,19585,0,0,0,0.00,166
,20180126,19585,19585,19555,19555,19345,19410,19450,-175,-135,50,486.34,164
,20180129,19410,19450,19620,19735,19620,19735,19695,285,245,6,59.09,166
,20180130,19735,19695,19595,19595,19595,19595,19595,-100,-100,2,19.60,164
,20180131,19595,19595,,,,19595,19595,0,0,0,0.00,164
,20180201,19595,19595,19395,19395,19395,19395,19395,-200,-200,2,19.40,164
,20180202,19395,19395,19615,19620,19615,19620,19615,225,220,8,78.48,170
,20180205,19620,19615,19580,19580,19450,19450,19490,-165,-125,6,58.48,166
,20180206,19450,19490,19430,19450,19420,19420,19425,-70,-65,12,116.56,166
,20180207,19420,19425,19220,19260,19215,19260,19220,-165,-205,18,173.02,160
,20180208,19260,19220,19120,19275,18990,19000,19010,-220,-210,172,"1,634.93",312
,20180209,19000,19010,19015,19020,18950,18950,18995,-60,-15,16,151.97,314
,20180212,18950,18995,19075,19075,19025,19025,19050,30,55,6,57.16,314
,20180213,19025,19050,18955,18955,18955,18955,18955,-95,-95,2,18.96,314
,20180214,18955,18955,18985,19265,18985,19265,19095,310,140,10,95.50,314
,20180222,19265,19095,19125,19140,19070,19135,19115,40,20,14,133.83,314
,20180223,19135,19115,19295,19295,19205,19250,19245,135,130,20,192.47,318
,20180226,19250,19245,19175,19215,19170,19215,19185,-30,-60,6,57.56,316
,20180227,19215,19185,19405,19405,19230,19265,19295,80,110,40,385.94,314
,20180228,19265,19295,19165,19165,19035,19035,19105,-260,-190,8,76.43,316
,20180301,19035,19105,19020,19050,18950,18950,18970,-155,-135,22,208.72,314
,20180302,18950,18970,18825,18870,18660,18870,18785,-100,-185,22,206.68,312
,20180305,18870,18785,18810,18810,18725,18755,18745,-30,-40,20,187.47,308
,20180306,18755,18745,18505,18570,18445,18450,18495,-295,-250,26,240.49,310
,20180307,18450,18495,18560,18630,18525,18525,18585,30,90,16,148.71,306
,20180308,18525,18585,18470,18470,18290,18290,18355,-295,-230,42,385.50,316
,20180309,18290,18355,18200,18270,18000,18000,18155,-355,-200,36,326.83,310
,20180312,18000,18155,18155,18155,18030,18030,18100,-125,-55,14,126.72,312
,20180313,18030,18100,17935,17940,17830,17910,17875,-190,-225,60,536.27,320
,20180314,17910,17875,18080,18135,17995,18045,18080,170,205,36,325.49,312
,20180315,18045,18080,18180,18260,18115,18150,18170,70,90,20,181.73,302
,20180316,18150,18170,18260,18260,18225,18225,18230,55,60,8,72.94,304
,20180319,18225,18230,18100,18100,18035,18035,18065,-195,-165,4,36.14,304
,20180320,18035,18065,17935,17935,17935,17935,17935,-130,-130,2,17.94,302
,20180321,17935,17935,18120,18120,17875,17875,17930,-60,-5,14,125.52,312
,20180322,17875,17930,18235,18455,18075,18455,18270,525,340,34,310.64,322
,20180323,18455,18270,18140,18160,17850,18045,18020,-225,-250,82,738.84,342
,20180326,18045,18020,18010,18145,17980,17980,18025,-40,5,92,829.15,352
,20180327,17980,18025,18230,18295,18115,18235,18215,210,190,20,182.19,346
,20180328,18235,18215,18125,18360,18125,18140,18185,-75,-30,62,563.84,362
,20180329,18140,18185,18100,18260,18100,18100,18150,-85,-35,14,127.06,364
,20180330,18100,18150,18025,18200,18025,18200,18135,50,-15,14,126.95,364
,20180402,18200,18135,18285,18285,18105,18200,18220,65,85,22,200.44,364
,20180403,18200,18220,18205,18205,18030,18030,18115,-190,-105,16,144.93,368
,20180404,18030,18115,18115,18175,18050,18175,18135,60,20,34,308.34,374
,20180409,18175,18135,18175,18175,17965,18080,18080,-55,-55,64,578.62,374
,20180410,18080,18080,18070,18080,17980,18010,18030,-70,-50,36,324.56,380
,20180411,18010,18030,18095,18145,18050,18050,18090,20,60,52,470.42,376
,20180412,18050,18090,18000,18100,17715,17830,17985,-260,-105,74,665.51,398
,20180413,17830,17985,17800,17800,17690,17775,17735,-210,-250,28,248.34,406
,20180416,17775,17735,17725,17755,17420,17610,17575,-125,-160,82,720.71,424
,20180417,17610,17575,17915,17915,17700,17720,17760,145,185,64,568.33,432
,20180418,17720,17760,17785,17785,17580,17740,17690,-20,-70,38,336.13,432
,20180419,17740,17690,17900,18110,17755,18020,18025,330,335,142,"1,279.88",466
,20180420,18020,18025,17855,17965,17795,17935,17860,-90,-165,46,410.85,460
,20180423,17935,17860,18025,18130,17960,18110,18065,250,205,66,596.29,442
,20180424,18110,18065,17955,18080,17955,18050,18020,-15,-45,20,180.22,432
,20180425,18050,18020,18095,18095,17860,17860,17975,-160,-45,110,988.82,506
,20180426,17860,17975,17700,17920,17700,17870,17850,-105,-125,484,"4,319.87",676
,20180427,17870,17850,17800,18020,17800,18000,17895,150,45,262,"2,344.34",712
,20180502,18000,17895,17985,18170,17935,18085,18035,190,140,252,"2,272.60",900
,20180503,18085,18035,18090,18100,17950,18045,18075,10,40,220,"1,988.49",1062
,20180504,18045,18075,18045,18140,17950,17995,18020,-80,-55,114,"1,027.40",1122
,20180507,17995,18020,18075,18415,18030,18345,18265,325,245,102,931.70,1148
,20180508,18345,18265,18265,18405,18265,18405,18370,140,105,150,"1,377.91",1238
,20180509,18405,18370,18395,18395,18175,18245,18295,-125,-75,346,"3,165.79",1292
,20180510,18245,18295,18235,18285,18195,18225,18240,-70,-55,80,729.71,1344
,20180511,18225,18240,18300,18400,18250,18310,18325,70,85,310,"2,841.12",1478
,20180514,18310,18325,18395,18820,18375,18440,18495,115,170,1168,"10,803.79",1890
,20180515,18440,18495,18460,18480,18315,18470,18405,-25,-90,676,"6,222.42",2098
,20180516,18470,18405,18320,18470,18265,18375,18320,-30,-85,264,"2,418.88",2104
,20180517,18375,18320,18270,18610,18270,18350,18465,30,145,566,"5,226.95",2096
,20180518,18350,18465,18430,18595,18380,18560,18480,95,15,428,"3,954.78",2100
,20180521,18560,18480,18550,18710,18450,18650,18640,170,160,614,"5,723.87",2208
,20180522,18650,18640,18605,18980,18605,18905,18845,265,205,1196,"11,270.36",2354
,20180523,18905,18845,19045,19150,18810,19040,18960,195,115,1248,"11,832.80",2346
,20180524,19040,18960,19000,19315,18935,19250,19150,290,190,826,"7,910.54",2490
,20180525,19250,19150,19240,19470,19240,19315,19350,165,200,628,"6,076.06",2504
,20180528,19315,19350,19235,19275,19000,19195,19135,-155,-215,1088,"10,410.80",2564
,20180529,19195,19135,19190,19555,19135,19490,19335,355,200,844,"8,160.56",2730
,20180530,19490,19335,19425,19425,19205,19225,19300,-110,-35,564,"5,443.60",2840
,20180531,19225,19300,19275,19505,19275,19330,19370,30,70,798,"7,729.78",2764
pb1810,20180102,19190,19190,19120,19120,18990,19030,19050,-160,-140,10,95.26,26
,20180103,19030,19050,19200,19380,19200,19320,19305,270,255,14,135.14,28
,20180104,19320,19305,19310,19320,19310,19320,19315,15,10,4,38.63,26
,20180105,19320,19315,19480,19490,19395,19490,19455,175,140,14,136.21,28
,20180108,19490,19455,19510,19610,19505,19610,19540,155,85,6,58.63,30
,20180109,19610,19540,19430,19580,19430,19580,19530,40,-10,6,58.59,34
,20180110,19580,19530,,,,19530,19530,0,0,0,0.00,34
,20180111,19530,19530,19390,19390,19335,19370,19370,-160,-160,8,77.49,38
,20180112,19370,19370,19285,19285,19285,19285,19285,-85,-85,2,19.29,40
,20180115,19285,19285,19230,19230,19225,19225,19225,-60,-60,4,38.46,36
,20180116,19225,19225,19265,19265,19010,19010,19135,-215,-90,4,38.28,34
,20180117,19010,19135,18990,19200,18990,19200,19115,65,-20,8,76.46,36
,20180118,19200,19115,19125,19265,19125,19265,19215,150,100,6,57.66,36
,20180119,19265,19215,19375,19415,19375,19415,19395,200,180,6,58.19,38
,20180122,19415,19395,19415,19415,19295,19295,19355,-100,-40,4,38.71,38
,20180123,19295,19355,,,,19355,19355,0,0,0,0.00,38
,20180124,19355,19355,19605,19605,19605,19605,19605,250,250,2,19.61,38
,20180125,19605,19605,19600,19600,19565,19565,19585,-40,-20,10,97.93,40
,20180126,19565,19585,19530,19530,19440,19440,19480,-145,-105,62,603.92,42
,20180129,19440,19480,19670,19670,19670,19670,19670,190,190,2,19.67,40
,20180130,19670,19670,19590,19590,19590,19590,19590,-80,-80,2,19.59,42
,20180131,19590,19590,19395,19395,19395,19395,19395,-195,-195,4,38.79,42
,20180201,19395,19395,,,,19395,19395,0,0,0,0.00,42
,20180202,19395,19395,,,,19395,19395,0,0,0,0.00,42
,20180205,19395,19395,,,,19425,19425,30,30,0,0.00,42
,20180206,19425,19425,19385,19385,19385,19385,19385,-40,-40,2,19.39,42
,20180207,19385,19385,,,,19385,19385,0,0,0,0.00,42
,20180208,19385,19385,,,,19050,19050,-335,-335,0,0.00,42
,20180209,19050,19050,,,,19050,19050,0,0,0,0.00,42
,20180212,19050,19050,,,,19050,19050,0,0,0,0.00,42
,20180213,19050,19050,18910,18920,18910,18920,18910,-130,-140,10,94.57,36
,20180214,18920,18910,,,,18910,18910,0,0,0,0.00,36
,20180222,18910,18910,19150,19150,19120,19120,19125,210,215,16,153.02,50
,20180223,19120,19125,19240,19245,19215,19215,19230,90,105,6,57.70,54
,20180226,19215,19230,19145,19215,19145,19200,19205,-30,-25,24,230.50,76
,20180227,19200,19205,19330,19330,19250,19250,19305,45,100,30,289.63,98
,20180228,19250,19305,19210,19215,19030,19030,19200,-275,-105,42,403.21,122
,20180301,19030,19200,18945,18970,18945,18965,18960,-235,-240,20,189.65,122
,20180302,18965,18960,18780,18810,18645,18810,18745,-150,-215,6,56.24,122
,20180305,18810,18745,18720,18720,18720,18720,18720,-25,-25,2,18.72,122
,20180306,18720,18720,,,,18545,18545,-175,-175,0,0.00,122
,20180307,18545,18545,18545,18545,18510,18510,18530,-35,-15,8,74.14,122
,20180308,18510,18530,18310,18350,18275,18300,18310,-230,-220,16,146.49,124
,20180309,18300,18310,18240,18240,17825,17825,17925,-485,-385,14,125.51,124
,20180312,17825,17925,18100,18100,18100,18100,18100,175,175,4,36.20,124
,20180313,18100,18100,,,,17900,17900,-200,-200,0,0.00,124
,20180314,17900,17900,,,,17900,17900,0,0,0,0.00,124
,20180315,17900,17900,,,,17900,17900,0,0,0,0.00,124
,20180316,17900,17900,18015,18015,18015,18015,18015,115,115,20,180.15,108
,20180319,18015,18015,,,,18015,18015,0,0,0,0.00,108
,20180320,18015,18015,,,,18015,18015,0,0,0,0.00,108
,20180321,18015,18015,,,,18015,18015,0,0,0,0.00,108
,20180322,18015,18015,18405,18405,18405,18405,18405,390,390,2,18.41,106
,20180323,18405,18405,,,,17990,17990,-415,-415,0,0.00,106
,20180326,17990,17990,,,,17990,17990,0,0,0,0.00,106
,20180327,17990,17990,,,,17990,17990,0,0,0,0.00,106
,20180328,17990,17990,,,,17990,17990,0,0,0,0.00,106
,20180329,17990,17990,,,,17990,17990,0,0,0,0.00,106
,20180330,17990,17990,,,,17990,17990,0,0,0,0.00,106
,20180402,17990,17990,18270,18270,18055,18055,18095,65,105,10,90.49,106
,20180403,18055,18095,17860,18295,17860,17960,18050,-135,-45,10,90.27,106
,20180404,17960,18050,18025,18045,18025,18045,18035,-5,-15,4,36.07,106
,20180409,18045,18035,17935,17965,17935,17965,17940,-70,-95,8,71.77,102
,20180410,17965,17940,,,,17940,17940,0,0,0,0.00,102
,20180411,17940,17940,,,,17940,17940,0,0,0,0.00,102
,20180412,17940,17940,17860,17860,17745,17745,17785,-195,-155,8,71.15,106
,20180413,17745,17785,17740,17740,17650,17685,17680,-100,-105,14,123.79,100
,20180416,17685,17680,17500,17545,17440,17440,17495,-240,-185,6,52.49,100
,20180417,17440,17495,,,,17545,17545,50,50,0,0.00,100
,20180418,17545,17545,17800,17980,17585,17585,17795,40,250,14,124.58,104
,20180419,17585,17795,17900,17970,17900,17915,17940,120,145,38,340.91,86
,20180420,17915,17940,17705,17705,17705,17705,17705,-235,-235,4,35.41,82
,20180423,17705,17705,18055,18075,18040,18040,18055,335,350,26,234.73,108
,20180424,18040,18055,18005,18005,18005,18005,18005,-50,-50,2,18.01,108
,20180425,18005,18005,17955,17955,17875,17875,17880,-130,-125,22,196.73,112
,20180426,17875,17880,17795,17835,17795,17815,17795,-65,-85,52,462.79,108
,20180427,17815,17795,17925,17925,17875,17915,17895,120,100,54,483.23,112
,20180502,17915,17895,17900,18105,17900,17985,17990,90,95,96,863.55,208
,20180503,17985,17990,18015,18055,17900,18015,18005,25,15,132,"1,188.59",282
,20180504,18015,18005,18195,18195,17855,17855,18050,-150,45,164,"1,480.40",284
,20180507,17855,18050,18000,18255,18000,18205,18190,155,140,14,127.33,286
,20180508,18205,18190,18335,18335,18325,18325,18325,135,135,6,54.99,288
,20180509,18325,18325,18250,18250,18100,18210,18215,-115,-110,86,783.44,354
,20180510,18210,18215,18230,18235,18155,18235,18195,20,-20,28,254.79,364
,20180511,18235,18195,18200,18250,18170,18170,18210,-25,15,14,127.50,360
,20180514,18170,18210,18500,18550,18275,18275,18400,65,190,118,"1,085.66",414
,20180515,18275,18400,18100,18425,18100,18255,18265,-145,-135,272,"2,484.19",436
,20180516,18255,18265,18055,18260,18055,18220,18150,-45,-115,178,"1,615.76",450
,20180517,18220,18150,18155,18400,18155,18245,18285,95,135,88,804.69,440
,20180518,18245,18285,18255,18420,18240,18385,18305,100,20,76,695.66,426
,20180521,18385,18305,18350,18590,18350,18510,18510,205,205,154,"1,425.60",482
,20180522,18510,18510,18500,18770,18475,18770,18625,260,115,94,875.40,492
,20180523,18770,18625,18910,18910,18680,18830,18820,205,195,236,"2,220.77",544
,20180524,18830,18820,18800,19115,18680,19070,18915,250,95,120,"1,135.12",532
,20180525,19070,18915,19225,19265,19060,19100,19145,185,230,64,612.74,514
,20180528,19100,19145,19055,19055,18820,18980,18890,-165,-255,226,"2,134.99",484
,20180529,18980,18890,18985,19395,18940,19265,19125,375,235,134,"1,281.42",508
,20180530,19265,19125,19260,19260,19040,19075,19135,-50,10,302,"2,890.03",598
,20180531,19075,19135,19115,19290,19115,19195,19195,60,60,160,"1,535.69",504
pb1811,20180102,19195,19195,19040,19040,19040,19040,19040,-155,-155,6,57.12,66
,20180103,19040,19040,19275,19390,19275,19360,19350,320,310,8,77.40,60
,20180104,19360,19350,19480,19480,19480,19480,19480,130,130,4,38.96,60
,20180105,19480,19480,19480,19480,19480,19480,19480,0,0,2,19.48,62
,20180108,19480,19480,,,,19480,19480,0,0,0,0.00,62
,20180109,19480,19480,,,,19480,19480,0,0,0,0.00,62
,20180110,19480,19480,,,,19480,19480,0,0,0,0.00,62
,20180111,19480,19480,19340,19450,19340,19435,19390,-45,-90,20,193.91,50
,20180112,19435,19390,19325,19335,19325,19335,19330,-55,-60,4,38.66,52
,20180115,19335,19330,19175,19175,19175,19175,19175,-155,-155,8,76.70,54
,20180116,19175,19175,19275,19275,19275,19275,19275,100,100,4,38.55,54
,20180117,19275,19275,,,,19275,19275,0,0,0,0.00,54
,20180118,19275,19275,19290,19290,19285,19285,19285,10,10,12,115.72,66
,20180119,19285,19285,19370,19370,19370,19370,19370,85,85,2,19.37,64
,20180122,19370,19370,,,,19400,19400,30,30,0,0.00,64
,20180123,19400,19400,19640,19640,19630,19630,19635,230,235,4,39.27,66
,20180124,19630,19635,19620,19620,19620,19620,19620,-15,-15,2,19.62,64
,20180125,19620,19620,19590,19590,19590,19590,19590,-30,-30,4,39.18,60
,20180126,19590,19590,19540,19540,19335,19335,19460,-255,-130,8,77.85,56
,20180129,19335,19460,19680,19730,19680,19725,19705,265,245,10,98.53,56
,20180130,19725,19705,,,,19705,19705,0,0,0,0.00,56
,20180131,19705,19705,19420,19425,19420,19425,19420,-280,-285,6,58.27,56
,20180201,19425,19420,,,,19460,19460,40,40,0,0.00,56
,20180202,19460,19460,19650,19650,19650,19650,19650,190,190,2,19.65,56
,20180205,19650,19650,19490,19490,19490,19490,19490,-160,-160,2,19.49,56
,20180206,19490,19490,19430,19440,19430,19440,19435,-50,-55,4,38.87,54
,20180207,19440,19435,19250,19250,19250,19250,19250,-185,-185,2,19.25,52
,20180208,19250,19250,,,,19250,19250,0,0,0,0.00,52
,20180209,19250,19250,19040,19070,18960,18980,19010,-270,-240,82,779.59,50
,20180212,18980,19010,19110,19110,19110,19110,19110,100,100,2,19.11,48
,20180213,19110,19110,,,,19110,19110,0,0,0,0.00,48
,20180214,19110,19110,19180,19180,19180,19180,19180,70,70,2,19.18,50
,20180222,19180,19180,19115,19130,19115,19130,19125,-50,-55,6,57.38,50
,20180223,19130,19125,19255,19255,19255,19255,19255,130,130,6,57.77,46
,20180226,19255,19255,19180,19230,19180,19230,19215,-25,-40,12,115.31,56
,20180227,19230,19215,19335,19335,19250,19250,19270,35,55,12,115.64,56
,20180228,19250,19270,19030,19030,18995,18995,19005,-275,-265,6,57.02,56
,20180301,18995,19005,18960,19030,18940,19030,18995,25,-10,44,417.92,82
,20180302,19030,18995,18765,18830,18740,18810,18800,-185,-195,18,169.21,94
,20180305,18810,18800,,,,18695,18695,-105,-105,0,0.00,94
,20180306,18695,18695,18560,18560,18340,18455,18410,-240,-285,78,718.11,62
,20180307,18455,18410,18510,18510,18510,18510,18510,100,100,2,18.51,60
,20180308,18510,18510,18505,18505,18275,18305,18340,-205,-170,8,73.37,66
,20180309,18305,18340,18245,18245,18100,18120,18175,-220,-165,12,109.06,70
,20180312,18120,18175,,,,18175,18175,0,0,0,0.00,70
,20180313,18175,18175,,,,17945,17945,-230,-230,0,0.00,70
,20180314,17945,17945,,,,17945,17945,0,0,0,0.00,70
,20180315,17945,17945,,,,17945,17945,0,0,0,0.00,70
,20180316,17945,17945,,,,17945,17945,0,0,0,0.00,70
,20180319,17945,17945,,,,17945,17945,0,0,0,0.00,70
,20180320,17945,17945,,,,17945,17945,0,0,0,0.00,70
,20180321,17945,17945,17835,17835,17835,17835,17835,-110,-110,6,53.51,64
,20180322,17835,17835,,,,18100,18100,265,265,0,0.00,64
,20180323,18100,18100,,,,17925,17925,-175,-175,0,0.00,64
,20180326,17925,17925,,,,17925,17925,0,0,0,0.00,64
,20180327,17925,17925,,,,17950,17950,25,25,0,0.00,64
,20180328,17950,17950,,,,17950,17950,0,0,0,0.00,64
,20180329,17950,17950,,,,17950,17950,0,0,0,0.00,64
,20180330,17950,17950,,,,17950,17950,0,0,0,0.00,64
,20180402,17950,17950,,,,17950,17950,0,0,0,0.00,64
,20180403,17950,17950,,,,17950,17950,0,0,0,0.00,64
,20180404,17950,17950,,,,17950,17950,0,0,0,0.00,64
,20180409,17950,17950,,,,17950,17950,0,0,0,0.00,64
,20180410,17950,17950,17860,17860,17860,17860,17860,-90,-90,2,17.86,64
,20180411,17860,17860,,,,17860,17860,0,0,0,0.00,64
,20180412,17860,17860,,,,17860,17860,0,0,0,0.00,64
,20180413,17860,17860,,,,17725,17725,-135,-135,0,0.00,64
,20180416,17725,17725,,,,17665,17665,-60,-60,0,0.00,64
,20180417,17665,17665,,,,17665,17665,0,0,0,0.00,64
,20180418,17665,17665,,,,17665,17665,0,0,0,0.00,64
,20180419,17665,17665,,,,17850,17850,185,185,0,0.00,64
,20180420,17850,17850,17800,17800,17800,17800,17800,-50,-50,2,17.80,62
,20180423,17800,17800,18050,18180,18015,18015,18135,215,335,120,"1,088.32",162
,20180424,18015,18135,17950,17970,17950,17970,17950,-165,-185,18,161.57,170
,20180425,17970,17950,,,,17865,17865,-85,-85,0,0.00,170
,20180426,17865,17865,17835,17835,17830,17830,17830,-35,-35,4,35.67,172
,20180427,17830,17830,18000,18000,17850,17850,17925,20,95,4,35.85,174
,20180502,17850,17925,17855,17920,17835,17920,17860,-5,-65,88,786.05,230
,20180503,17920,17860,17845,17860,17845,17860,17855,0,-5,6,53.57,230
,20180504,17860,17855,17915,17915,17865,17865,17910,10,55,42,376.12,270
,20180507,17865,17910,18005,18190,18005,18190,18035,280,125,12,108.22,272
,20180508,18190,18035,,,,18205,18205,170,170,0,0.00,272
,20180509,18205,18205,,,,18205,18205,0,0,0,0.00,272
,20180510,18205,18205,,,,18205,18205,0,0,0,0.00,272
,20180511,18205,18205,,,,18205,18205,0,0,0,0.00,272
,20180514,18205,18205,,,,18205,18205,0,0,0,0.00,272
,20180515,18205,18205,,,,18205,18205,0,0,0,0.00,272
,20180516,18205,18205,18500,18500,18070,18070,18285,-135,80,4,36.57,270
,20180517,18070,18285,18225,18230,18120,18140,18210,-145,-75,32,291.39,280
,20180518,18140,18210,18320,18320,18320,18320,18320,110,110,2,18.32,280
,20180521,18320,18320,18380,18380,18380,18380,18380,60,60,2,18.38,280
,20180522,18380,18380,18530,18695,18370,18695,18580,315,200,110,"1,021.92",294
,20180523,18695,18580,18705,18705,18525,18655,18645,75,65,16,149.18,294
,20180524,18655,18645,18505,18885,18505,18885,18845,240,200,64,603.05,246
,20180525,18885,18845,19005,19035,18865,18930,18970,85,125,86,815.80,246
,20180528,18930,18970,18800,18850,18690,18850,18735,-120,-235,316,"2,960.53",304
,20180529,18850,18735,18895,19200,18895,19065,19105,330,370,256,"2,445.48",276
,20180530,19065,19105,19025,19025,18875,19015,18940,-90,-165,74,700.83,274
,20180531,19015,18940,19030,19165,19030,19115,19105,175,165,32,305.68,286
pb1812,20180102,19010,19010,,,,19010,19010,0,0,0,0.00,0
,20180103,19010,19010,,,,19010,19010,0,0,0,0.00,0
,20180104,19010,19010,,,,19010,19010,0,0,0,0.00,0
,20180105,19010,19010,,,,19010,19010,0,0,0,0.00,0
,20180108,19010,19010,,,,19010,19010,0,0,0,0.00,0
,20180109,19010,19010,,,,19010,19010,0,0,0,0.00,0
,20180110,19010,19010,,,,19010,19010,0,0,0,0.00,0
,20180111,19010,19010,19370,19595,19320,19320,19425,310,415,6,58.29,2
,20180112,19320,19425,,,,19425,19425,0,0,0,0.00,2
,20180115,19425,19425,19230,19230,19230,19230,19230,-195,-195,2,19.23,2
,20180116,19230,19230,,,,19330,19330,100,100,0,0.00,2
,20180117,19330,19330,,,,19330,19330,0,0,0,0.00,2
,20180118,19330,19330,19280,19280,19280,19280,19280,-50,-50,2,19.28,4
,20180119,19280,19280,19365,19520,19365,19520,19440,240,160,4,38.89,8
,20180122,19520,19440,,,,19440,19440,0,0,0,0.00,8
,20180123,19440,19440,,,,19440,19440,0,0,0,0.00,8
,20180124,19440,19440,19650,19650,19650,19650,19650,210,210,2,19.65,10
,20180125,19650,19650,19645,19645,19645,19645,19645,-5,-5,2,19.65,12
,20180126,19645,19645,,,,19645,19645,0,0,0,0.00,12
,20180129,19645,19645,,,,19645,19645,0,0,0,0.00,12
,20180130,19645,19645,,,,19645,19645,0,0,0,0.00,12
,20180131,19645,19645,,,,19645,19645,0,0,0,0.00,12
,20180201,19645,19645,,,,19645,19645,0,0,0,0.00,12
,20180202,19645,19645,,,,19645,19645,0,0,0,0.00,12
,20180205,19645,19645,,,,19645,19645,0,0,0,0.00,12
,20180206,19645,19645,,,,19645,19645,0,0,0,0.00,12
,20180207,19645,19645,,,,19645,19645,0,0,0,0.00,12
,20180208,19645,19645,,,,19645,19645,0,0,0,0.00,12
,20180209,19645,19645,,,,19040,19040,-605,-605,0,0.00,12
,20180212,19040,19040,,,,19040,19040,0,0,0,0.00,12
,20180213,19040,19040,,,,19000,19000,-40,-40,0,0.00,12
,20180214,19000,19000,,,,19000,19000,0,0,0,0.00,12
,20180222,19000,19000,19110,19140,19110,19140,19130,140,130,6,57.39,16
,20180223,19140,19130,,,,19130,19130,0,0,0,0.00,16
,20180226,19130,19130,19145,19240,19145,19240,19190,110,60,4,38.39,20
,20180227,19240,19190,19265,19265,19265,19265,19265,75,75,2,19.27,22
,20180228,19265,19265,,,,19265,19265,0,0,0,0.00,22
,20180301,19265,19265,18860,18970,18860,18970,18940,-295,-325,8,75.77,20
,20180302,18970,18940,18750,18750,18750,18750,18750,-190,-190,2,18.75,22
,20180305,18750,18750,,,,18750,18750,0,0,0,0.00,22
,20180306,18750,18750,18495,18640,18430,18525,18555,-225,-195,22,204.12,22
,20180307,18525,18555,18540,18610,18525,18540,18545,-15,-10,24,222.59,40
,20180308,18540,18545,18460,18540,18235,18340,18390,-205,-155,28,257.51,56
,20180309,18340,18390,18170,18170,18170,18170,18170,-220,-220,2,18.17,56
,20180312,18170,18170,,,,18170,18170,0,0,0,0.00,56
,20180313,18170,18170,,,,17900,17900,-270,-270,0,0.00,56
,20180314,17900,17900,,,,17900,17900,0,0,0,0.00,56
,20180315,17900,17900,,,,17900,17900,0,0,0,0.00,56
,20180316,17900,17900,17975,17975,17975,17975,17975,75,75,2,17.98,58
,20180319,17975,17975,,,,17975,17975,0,0,0,0.00,58
,20180320,17975,17975,,,,17975,17975,0,0,0,0.00,58
,20180321,17975,17975,,,,17975,17975,0,0,0,0.00,58
,20180322,17975,17975,17945,18200,17945,18200,18095,225,120,6,54.30,58
,20180323,18200,18095,,,,17910,17910,-185,-185,0,0.00,58
,20180326,17910,17910,,,,17910,17910,0,0,0,0.00,58
,20180327,17910,17910,,,,17910,17910,0,0,0,0.00,58
,20180328,17910,17910,,,,17910,17910,0,0,0,0.00,58
,20180329,17910,17910,,,,17910,17910,0,0,0,0.00,58
,20180330,17910,17910,17975,17975,17975,17975,17975,65,65,2,17.98,60
,20180402,17975,17975,18180,18255,17885,17885,18100,-90,125,28,253.44,70
,20180403,17885,18100,17850,17850,17850,17850,17850,-250,-250,2,17.85,72
,20180404,17850,17850,,,,17850,17850,0,0,0,0.00,72
,20180409,17850,17850,,,,17850,17850,0,0,0,0.00,72
,20180410,17850,17850,17785,17895,17785,17895,17840,45,-10,4,35.68,74
,20180411,17895,17840,17885,18015,17735,17970,17905,130,65,12,107.45,76
,20180412,17970,17905,17605,17970,17605,17630,17760,-275,-145,10,88.81,80
,20180413,17630,17760,17620,17700,17540,17655,17615,-105,-145,12,105.72,80
,20180416,17655,17615,17360,17570,17335,17570,17420,-45,-195,6,52.27,78
,20180417,17570,17420,,,,17420,17420,0,0,0,0.00,78
,20180418,17420,17420,,,,17420,17420,0,0,0,0.00,78
,20180419,17420,17420,,,,17750,17750,330,330,0,0.00,78
,20180420,17750,17750,,,,17750,17750,0,0,0,0.00,78
,20180423,17750,17750,17910,17945,17910,17945,17920,195,170,6,53.77,76
,20180424,17945,17920,17875,17875,17875,17875,17875,-45,-45,2,17.88,74
,20180425,17875,17875,17890,17890,17890,17890,17890,15,15,4,35.78,76
,20180426,17890,17890,17720,17720,17720,17720,17720,-170,-170,4,35.44,72
,20180427,17720,17720,17800,17840,17745,17840,17795,120,75,24,213.59,62
,20180502,17840,17795,,,,17735,17735,-60,-60,0,0.00,62
,20180503,17735,17735,,,,17735,17735,0,0,0,0.00,62
,20180504,17735,17735,,,,17735,17735,0,0,0,0.00,62
,20180507,17735,17735,17990,18155,17990,18135,18075,400,340,38,343.45,70
,20180508,18135,18075,,,,18075,18075,0,0,0,0.00,70
,20180509,18075,18075,18140,18140,18110,18120,18125,45,50,26,235.68,96
,20180510,18120,18125,18085,18085,18085,18085,18085,-40,-40,6,54.26,90
,20180511,18085,18085,18175,18285,18120,18120,18255,35,170,42,383.36,124
,20180514,18120,18255,,,,18255,18255,0,0,0,0.00,124
,20180515,18255,18255,18010,18100,18010,18100,18040,-155,-215,6,54.13,124
,20180516,18100,18040,,,,18040,18040,0,0,0,0.00,124
,20180517,18040,18040,18185,18185,18055,18090,18130,50,90,20,181.31,124
,20180518,18090,18130,,,,18130,18130,0,0,0,0.00,124
,20180521,18130,18130,18315,18315,18315,18315,18315,185,185,10,91.58,130
,20180522,18315,18315,18380,18590,18380,18590,18495,275,180,58,536.44,174
,20180523,18590,18495,18610,18610,18585,18585,18595,90,100,4,37.20,172
,20180524,18585,18595,18815,18855,18765,18785,18815,190,220,10,94.08,172
,20180525,18785,18815,18825,18985,18825,18985,18905,170,90,4,37.81,168
,20180528,18985,18905,18540,18795,18540,18795,18690,-110,-215,6,56.08,172
,20180529,18795,18690,19005,19005,19005,19005,19005,315,315,2,19.01,172
,20180530,19005,19005,19005,19005,18800,18840,18920,-165,-85,156,"1,475.95",156
,20180531,18840,18920,18950,18950,18950,18950,18950,30,30,2,18.95,156
pb1901,20180116,19230,19230,,,,19230,19230,0,0,0,0.00,0
,20180117,19230,19230,19085,19305,19085,19305,19195,75,-35,4,38.39,2
,20180118,19305,19195,19180,19225,18995,19225,19125,30,-70,38,363.42,24
,20180119,19225,19125,19275,19610,19275,19610,19455,485,330,6,58.37,24
,20180122,19610,19455,,,,19455,19455,0,0,0,0.00,24
,20180123,19455,19455,,,,19455,19455,0,0,0,0.00,24
,20180124,19455,19455,,,,19455,19455,0,0,0,0.00,24
,20180125,19455,19455,19660,19660,19510,19510,19585,55,130,4,39.17,26
,20180126,19510,19585,,,,19585,19585,0,0,0,0.00,26
,20180129,19585,19585,,,,19585,19585,0,0,0,0.00,26
,20180130,19585,19585,19695,19695,19450,19450,19570,-135,-15,4,39.15,26
,20180131,19450,19570,19240,19240,19240,19240,19240,-330,-330,2,19.24,26
,20180201,19240,19240,19385,19385,19385,19385,19385,145,145,2,19.39,28
,20180202,19385,19385,,,,19385,19385,0,0,0,0.00,28
,20180205,19385,19385,19495,19495,19495,19495,19495,110,110,2,19.50,28
,20180206,19495,19495,19405,19405,19405,19405,19405,-90,-90,2,19.41,28
,20180207,19405,19405,,,,19405,19405,0,0,0,0.00,28
,20180208,19405,19405,,,,19405,19405,0,0,0,0.00,28
,20180209,19405,19405,,,,19405,19405,0,0,0,0.00,28
,20180212,19405,19405,,,,19405,19405,0,0,0,0.00,28
,20180213,19405,19405,18845,18845,18845,18845,18845,-560,-560,2,18.85,30
,20180214,18845,18845,18970,19120,18970,19120,19045,275,200,4,38.09,32
,20180222,19120,19045,,,,19045,19045,0,0,0,0.00,32
,20180223,19045,19045,19205,19205,19205,19205,19205,160,160,4,38.41,36
,20180226,19205,19205,19160,19160,19130,19130,19140,-75,-65,6,57.42,40
,20180227,19130,19140,19230,19230,19220,19220,19225,80,85,4,38.45,44
,20180228,19220,19225,,,,19225,19225,0,0,0,0.00,44
,20180301,19225,19225,18875,18935,18875,18935,18910,-290,-315,8,75.65,48
,20180302,18935,18910,18760,18760,18760,18760,18760,-150,-150,2,18.76,50
,20180305,18760,18760,,,,18700,18700,-60,-60,0,0.00,50
,20180306,18700,18700,18455,18475,18325,18400,18410,-300,-290,20,184.11,56
,20180307,18400,18410,18540,18540,18540,18540,18540,130,130,2,18.54,58
,20180308,18540,18540,18445,18470,18245,18265,18340,-275,-200,22,201.76,72
,20180309,18265,18340,18175,18310,17980,18035,18170,-305,-170,36,327.09,82
,20180312,18035,18170,18110,18110,18020,18020,18045,-150,-125,8,72.20,86
,20180313,18020,18045,17860,17860,17765,17765,17795,-280,-250,6,53.40,86
,20180314,17765,17795,17900,17900,17900,17900,17900,105,105,2,17.90,86
,20180315,17900,17900,18115,18120,17940,17950,18020,50,120,12,108.14,86
,20180316,17950,18020,17940,17990,17805,17990,17830,-30,-190,24,213.98,94
,20180319,17990,17830,18015,18190,17885,17885,17995,55,165,28,252.00,96
,20180320,17885,17995,17845,17865,17845,17865,17855,-130,-140,4,35.71,92
,20180321,17865,17855,17870,17870,17565,17605,17665,-250,-190,12,106.00,94
,20180322,17605,17665,17900,18145,17900,18115,18075,450,410,16,144.61,94
,20180323,18115,18075,17810,17810,17790,17790,17800,-285,-275,4,35.60,94
,20180326,17790,17800,,,,17800,17800,0,0,0,0.00,94
,20180327,17800,17800,,,,17800,17800,0,0,0,0.00,94
,20180328,17800,17800,,,,17800,17800,0,0,0,0.00,94
,20180329,17800,17800,,,,17800,17800,0,0,0,0.00,94
,20180330,17800,17800,,,,17800,17800,0,0,0,0.00,94
,20180402,17800,17800,,,,17800,17800,0,0,0,0.00,94
,20180403,17800,17800,,,,17800,17800,0,0,0,0.00,94
,20180404,17800,17800,,,,17800,17800,0,0,0,0.00,94
,20180409,17800,17800,,,,17800,17800,0,0,0,0.00,94
,20180410,17800,17800,17425,17735,17425,17735,17585,-65,-215,6,52.77,92
,20180411,17735,17585,,,,17640,17640,55,55,0,0.00,92
,20180412,17640,17640,17830,17830,17830,17830,17830,190,190,2,17.83,92
,20180413,17830,17830,,,,17685,17685,-145,-145,0,0.00,92
,20180416,17685,17685,17390,17390,17390,17390,17390,-295,-295,6,52.17,94
,20180417,17390,17390,17575,17575,17565,17565,17570,175,180,4,35.14,94
,20180418,17565,17570,17425,17425,17425,17425,17425,-145,-145,2,17.43,94
,20180419,17425,17425,17770,17770,17770,17770,17770,345,345,2,17.77,94
,20180420,17770,17770,17555,17740,17555,17740,17610,-30,-160,12,105.68,100
,20180423,17740,17610,17905,17905,17905,17905,17905,295,295,2,17.91,102
,20180424,17905,17905,17835,17915,17835,17915,17900,10,-5,44,393.87,138
,20180425,17915,17900,17850,17855,17635,17695,17695,-205,-205,68,601.71,150
,20180426,17695,17695,17735,17735,17730,17730,17730,35,35,4,35.47,150
,20180427,17730,17730,17750,17800,17750,17785,17775,55,45,6,53.34,152
,20180502,17785,17775,17755,17785,17755,17785,17770,10,-5,4,35.54,148
,20180503,17785,17770,17860,17975,17815,17820,17865,50,95,8,71.47,146
,20180504,17820,17865,17810,17810,17810,17810,17810,-55,-55,2,17.81,148
,20180507,17810,17810,17890,18220,17890,18220,18005,410,195,64,576.18,154
,20180508,18220,18005,18120,18120,18120,18120,18120,115,115,4,36.24,154
,20180509,18120,18120,18120,18120,18080,18095,18090,-25,-30,32,289.47,158
,20180510,18095,18090,18070,18150,18070,18135,18120,45,30,18,163.10,158
,20180511,18135,18120,18260,18270,18005,18005,18210,-115,90,50,455.36,182
,20180514,18005,18210,18275,18300,18265,18300,18280,90,70,8,73.14,178
,20180515,18300,18280,18075,18075,17875,18020,17935,-260,-345,40,358.77,174
,20180516,18020,17935,17760,17880,17760,17880,17795,-55,-140,14,124.59,168
,20180517,17880,17795,,,,17820,17820,25,25,0,0.00,168
,20180518,17820,17820,18080,18080,18080,18080,18080,260,260,14,126.56,162
,20180521,18080,18080,18275,18275,18095,18200,18140,120,60,18,163.27,172
,20180522,18200,18140,18065,18390,18050,18385,18235,245,95,34,310.02,182
,20180523,18385,18235,18370,18505,18370,18505,18410,270,175,8,73.65,178
,20180524,18505,18410,18625,18625,18625,18625,18625,215,215,2,18.63,180
,20180525,18625,18625,18840,18910,18795,18895,18875,270,250,44,415.36,150
,20180528,18895,18875,18600,18605,18565,18565,18595,-310,-280,22,204.59,148
,20180529,18565,18595,18750,18990,18700,18935,18830,340,235,86,809.79,226
,20180530,18935,18830,18870,18870,18735,18735,18745,-95,-85,24,224.96,234
,20180531,18735,18745,18855,18855,18805,18805,18825,60,80,6,56.48,234
pb1902,20180212,19405,19405,,,,19405,19405,0,0,0,0.00,0
,20180213,19405,19405,19235,19365,18915,18940,19135,-465,-270,48,459.34,8
,20180214,18940,19135,19105,19105,19105,19105,19105,-30,-30,2,19.11,10
,20180222,19105,19105,19130,19130,19130,19130,19130,25,25,2,19.13,12
,20180223,19130,19130,19135,19135,19135,19135,19135,5,5,2,19.14,12
,20180226,19135,19135,19150,19150,19150,19150,19150,15,15,2,19.15,14
,20180227,19150,19150,19380,19380,19190,19195,19295,45,145,14,135.09,14
,20180228,19195,19295,,,,19030,19030,-265,-265,0,0.00,14
,20180301,19030,19030,,,,19030,19030,0,0,0,0.00,14
,20180302,19030,19030,18735,18735,18735,18735,18735,-295,-295,2,18.74,14
,20180305,18735,18735,,,,18735,18735,0,0,0,0.00,14
,20180306,18735,18735,18455,18530,18455,18530,18490,-205,-245,4,36.99,16
,20180307,18530,18490,,,,18490,18490,0,0,0,0.00,16
,20180308,18490,18490,18280,18280,18280,18280,18280,-210,-210,2,18.28,18
,20180309,18280,18280,18165,18230,18010,18010,18110,-270,-170,16,144.91,30
,20180312,18010,18110,18335,18335,18115,18115,18225,5,115,4,36.45,32
,20180313,18115,18225,17650,17865,17530,17730,17660,-495,-565,32,282.61,40
,20180314,17730,17660,17995,18100,17880,18070,17985,410,325,26,233.85,34
,20180315,18070,17985,18060,18060,17955,17955,18020,-30,35,8,72.09,34
,20180316,17955,18020,,,,18020,18020,0,0,0,0.00,34
,20180319,18020,18020,,,,18020,18020,0,0,0,0.00,34
,20180320,18020,18020,,,,18020,18020,0,0,0,0.00,34
,20180321,18020,18020,,,,17980,17980,-40,-40,0,0.00,34
,20180322,17980,17980,,,,17980,17980,0,0,0,0.00,34
,20180323,17980,17980,,,,17950,17950,-30,-30,0,0.00,34
,20180326,17950,17950,,,,17950,17950,0,0,0,0.00,34
,20180327,17950,17950,,,,17950,17950,0,0,0,0.00,34
,20180328,17950,17950,17915,17915,17915,17915,17915,-35,-35,2,17.92,36
,20180329,17915,17915,17965,17965,17965,17965,17965,50,50,8,71.86,44
,20180330,17965,17965,17895,17895,17895,17895,17895,-70,-70,2,17.90,44
,20180402,17895,17895,18015,18015,18015,18015,18015,120,120,2,18.02,46
,20180403,18015,18015,,,,18015,18015,0,0,0,0.00,46
,20180404,18015,18015,17880,17880,17660,17660,17770,-355,-245,4,35.54,46
,20180409,17660,17770,17720,17720,17720,17720,17720,-50,-50,2,17.72,44
,20180410,17720,17720,,,,17720,17720,0,0,0,0.00,44
,20180411,17720,17720,,,,17720,17720,0,0,0,0.00,44
,20180412,17720,17720,17700,17700,17610,17610,17670,-110,-50,6,53.01,48
,20180413,17610,17670,,,,17660,17660,-10,-10,0,0.00,48
,20180416,17660,17660,,,,17540,17540,-120,-120,0,0.00,48
,20180417,17540,17540,,,,17540,17540,0,0,0,0.00,48
,20180418,17540,17540,,,,17540,17540,0,0,0,0.00,48
,20180419,17540,17540,17730,17830,17730,17830,17785,290,245,18,160.07,54
,20180420,17830,17785,17680,17780,17680,17780,17725,-5,-60,58,514.04,102
,20180423,17780,17725,17725,17850,17725,17850,17755,125,30,14,124.29,96
,20180424,17850,17755,,,,17755,17755,0,0,0,0.00,96
,20180425,17755,17755,,,,17755,17755,0,0,0,0.00,96
,20180426,17755,17755,17630,17630,17630,17630,17630,-125,-125,4,35.26,92
,20180427,17630,17630,,,,17630,17630,0,0,0,0.00,92
,20180502,17630,17630,,,,17625,17625,-5,-5,0,0.00,92
,20180503,17625,17625,,,,17625,17625,0,0,0,0.00,92
,20180504,17625,17625,,,,17625,17625,0,0,0,0.00,92
,20180507,17625,17625,17945,17945,17945,17945,17945,320,320,2,17.95,90
,20180508,17945,17945,,,,17955,17955,10,10,0,0.00,90
,20180509,17955,17955,,,,17960,17960,5,5,0,0.00,90
,20180510,17960,17960,,,,17965,17965,5,5,0,0.00,90
,20180511,17965,17965,,,,17970,17970,5,5,0,0.00,90
,20180514,17970,17970,18240,18240,18240,18240,18240,270,270,4,36.48,94
,20180515,18240,18240,17955,17955,17900,17900,17925,-340,-315,4,35.86,92
,20180516,17900,17925,17890,17910,17830,17830,17890,-95,-35,12,107.34,100
,20180517,17830,17890,18030,18030,17835,17890,17915,0,25,12,107.50,100
,20180518,17890,17915,,,,17955,17955,40,40,0,0.00,100
,20180521,17955,17955,18200,18200,18200,18200,18200,245,245,2,18.20,98
,20180522,18200,18200,18245,18265,18245,18255,18255,55,55,8,73.03,94
,20180523,18255,18255,18345,18425,18345,18425,18365,170,110,8,73.46,96
,20180524,18425,18365,,,,18505,18505,140,140,0,0.00,96
,20180525,18505,18505,,,,18540,18540,35,35,0,0.00,96
,20180528,18540,18540,18480,18485,18480,18485,18480,-55,-60,12,110.90,90
,20180529,18485,18480,18700,18900,18700,18890,18775,410,295,10,93.89,88
,20180530,18890,18775,18705,18705,18705,18705,18705,-70,-70,2,18.71,86
,20180531,18705,18705,18850,18855,18810,18810,18840,105,135,10,94.22,84
pb1903,20180316,18020,18020,17905,17905,17905,17905,17905,-115,-115,2,17.91,2
,20180319,17905,17905,18195,18195,17745,17745,17970,-160,65,4,35.94,2
,20180320,17745,17970,,,,17970,17970,0,0,0,0.00,2
,20180321,17970,17970,,,,17950,17950,-20,-20,0,0.00,2
,20180322,17950,17950,17460,18125,17460,18125,17875,175,-75,6,53.64,6
,20180323,18125,17875,,,,17875,17875,0,0,0,0.00,6
,20180326,17875,17875,,,,17875,17875,0,0,0,0.00,6
,20180327,17875,17875,,,,17875,17875,0,0,0,0.00,6
,20180328,17875,17875,,,,17875,17875,0,0,0,0.00,6
,20180329,17875,17875,,,,17875,17875,0,0,0,0.00,6
,20180330,17875,17875,,,,17875,17875,0,0,0,0.00,6
,20180402,17875,17875,,,,17875,17875,0,0,0,0.00,6
,20180403,17875,17875,17690,18250,17690,18250,17970,375,95,4,35.94,6
,20180404,18250,17970,,,,17970,17970,0,0,0,0.00,6
,20180409,17970,17970,,,,17970,17970,0,0,0,0.00,6
,20180410,17970,17970,17770,17770,17770,17770,17770,-200,-200,2,17.77,6
,20180411,17770,17770,,,,17770,17770,0,0,0,0.00,6
,20180412,17770,17770,17680,17680,17650,17650,17665,-120,-105,4,35.33,8
,20180413,17650,17665,17515,17515,17515,17515,17515,-150,-150,2,17.52,10
,20180416,17515,17515,,,,17515,17515,0,0,0,0.00,10
,20180417,17515,17515,,,,17515,17515,0,0,0,0.00,10
,20180418,17515,17515,,,,17515,17515,0,0,0,0.00,10
,20180419,17515,17515,17780,17780,17690,17695,17720,180,205,6,53.17,14
,20180420,17695,17720,17650,17675,17650,17665,17660,-55,-60,6,52.99,18
,20180423,17665,17660,17740,17795,17740,17795,17765,135,105,36,319.80,28
,20180424,17795,17765,17785,17785,17785,17785,17785,20,20,14,124.50,34
,20180425,17785,17785,17795,17795,17795,17795,17795,10,10,10,88.98,40
,20180426,17795,17795,,,,17760,17760,-35,-35,0,0.00,40
,20180427,17760,17760,17770,17770,17745,17745,17755,-15,-5,4,35.52,42
,20180502,17745,17755,17800,17800,17800,17800,17800,45,45,2,17.80,44
,20180503,17800,17800,,,,17800,17800,0,0,0,0.00,44
,20180504,17800,17800,17775,17775,17765,17770,17770,-30,-30,6,53.31,48
,20180507,17770,17770,17900,18135,17900,18135,18015,365,245,4,36.04,50
,20180508,18135,18015,,,,18015,18015,0,0,0,0.00,50
,20180509,18015,18015,18080,18080,18020,18020,18050,5,35,6,54.16,54
,20180510,18020,18050,,,,18050,18050,0,0,0,0.00,54
,20180511,18050,18050,18055,18075,18055,18075,18060,25,10,6,54.19,56
,20180514,18075,18060,18200,18285,18195,18285,18240,225,180,12,109.45,58
,20180515,18285,18240,17870,17870,17805,17805,17830,-435,-410,8,71.33,52
,20180516,17805,17830,,,,17830,17830,0,0,0,0.00,52
,20180517,17830,17830,17755,17805,17755,17805,17785,-25,-45,6,53.36,56
,20180518,17805,17785,,,,17785,17785,0,0,0,0.00,56
,20180521,17785,17785,18195,18195,18050,18050,18120,265,335,4,36.25,56
,20180522,18050,18120,18270,18270,18270,18270,18270,150,150,2,18.27,58
,20180523,18270,18270,18180,18330,18180,18330,18250,60,-20,6,54.76,58
,20180524,18330,18250,18535,18560,18535,18560,18555,310,305,14,129.90,64
,20180525,18560,18555,,,,18555,18555,0,0,0,0.00,64
,20180528,18555,18555,18480,18485,18480,18480,18480,-75,-75,48,443.54,78
,20180529,18480,18480,18695,18880,18695,18880,18710,400,230,46,430.41,60
,20180530,18880,18710,,,,18710,18710,0,0,0,0.00,60
,20180531,18710,18710,,,,18710,18710,0,0,0,0.00,60
pb1904,20180417,17515,17515,,,,17510,17510,-5,-5,0,0.00,0
,20180418,17510,17510,,,,17510,17510,0,0,0,0.00,0
,20180419,17510,17510,17985,19250,17250,17660,18095,150,585,46,416.21,4
,20180420,17660,18095,17450,17670,17450,17670,17540,-425,-555,12,105.27,8
,20180423,17670,17540,17755,17755,17755,17755,17755,215,215,2,17.76,8
,20180424,17755,17755,17595,17725,17595,17725,17660,-30,-95,4,35.32,10
,20180425,17725,17660,,,,17660,17660,0,0,0,0.00,10
,20180426,17660,17660,17570,17570,17570,17570,17570,-90,-90,2,17.57,10
,20180427,17570,17570,,,,17565,17565,-5,-5,0,0.00,10
,20180502,17565,17565,,,,17565,17565,0,0,0,0.00,10
,20180503,17565,17565,,,,17565,17565,0,0,0,0.00,10
,20180504,17565,17565,17765,17765,17765,17765,17765,200,200,2,17.77,10
,20180507,17765,17765,,,,17765,17765,0,0,0,0.00,10
,20180508,17765,17765,,,,17765,17765,0,0,0,0.00,10
,20180509,17765,17765,18080,18080,18000,18000,18040,235,275,4,36.08,12
,20180510,18000,18040,,,,18040,18040,0,0,0,0.00,12
,20180511,18040,18040,18045,18045,18045,18045,18045,5,5,2,18.05,12
,20180514,18045,18045,18185,18270,18085,18085,18180,40,135,14,127.28,22
,20180515,18085,18180,17880,18005,17705,17885,17860,-295,-320,20,178.61,22
,20180516,17885,17860,17850,17850,17655,17740,17705,-120,-155,14,123.95,30
,20180517,17740,17705,17675,17715,17675,17680,17700,-25,-5,16,141.61,24
,20180518,17680,17700,17860,17955,17860,17955,17905,255,205,4,35.82,24
,20180521,17955,17905,,,,17905,17905,0,0,0,0.00,24
,20180522,17905,17905,18180,18180,18060,18060,18110,155,205,6,54.34,30
,20180523,18060,18110,18220,18220,18170,18170,18185,60,75,12,109.12,22
,20180524,18170,18185,18175,18530,18175,18355,18350,170,165,22,201.89,34
,20180525,18355,18350,18740,18740,18525,18525,18635,175,285,30,279.55,34
,20180528,18525,18635,,,,18550,18550,-85,-85,0,0.00,34
,20180529,18550,18550,18765,18795,18765,18795,18780,245,230,4,37.56,36
,20180530,18795,18780,18565,18565,18565,18565,18565,-215,-215,2,18.57,38
,20180531,18565,18565,18605,18605,18605,18605,18605,40,40,2,18.61,38
pb1905,20180516,17860,17860,17610,17610,17610,17610,17610,-250,-250,2,17.61,2
,20180517,17610,17610,,,,17610,17610,0,0,0,0.00,2
,20180518,17610,17610,,,,17610,17610,0,0,0,0.00,2
,20180521,17610,17610,,,,17610,17610,0,0,0,0.00,2
,20180522,17610,17610,18095,18230,17835,17975,17940,365,330,58,520.40,40
,20180523,17975,17940,18115,18155,18015,18050,18100,110,160,16,144.82,42
,20180524,18050,18100,18260,18495,18045,18415,18325,315,225,110,"1,008.04",40
,20180525,18415,18325,18325,18675,18195,18340,18455,15,130,122,"1,125.95",62
,20180528,18340,18455,18115,18400,18095,18395,18320,-60,-135,60,549.74,68
,20180529,18395,18320,18390,18650,18340,18650,18465,330,145,22,203.14,64
,20180530,18650,18465,18560,18560,18345,18440,18445,-25,-20,6,55.35,68
,20180531,18440,18445,18645,18645,18580,18580,18610,135,165,4,37.23,70
rb1801,20180102,4248,4215,4285,4301,4233,4280,4286,65,71,14954,"64,105.97",44820
,20180103,4280,4286,4287,4289,4218,4218,4268,-68,-18,8760,"37,388.34",38460
,20180104,4218,4268,4236,4250,4215,4231,4232,-37,-36,4080,"17,268.00",35640
,20180105,4231,4232,4222,4232,4150,4175,4192,-57,-40,9360,"39,238.26",30180
,20180108,4175,4192,4156,4190,4150,4180,4171,-12,-21,7260,"30,281.58",26400
,20180109,4180,4171,4179,4195,4170,4195,4182,24,11,7260,"30,361.50",20340
,20180110,4195,4182,4195,4400,4184,4398,4291,216,109,16440,"70,544.22",7920
,20180111,4398,4291,4398,4410,4340,4390,4386,99,95,1560,"6,842.16",6720
,20180112,4390,4386,4390,4420,4380,4394,4392,8,6,3120,"13,705.68",4560
,20180115,4394,4392,4690,4699,4550,4699,4687,307,295,1020,"4,781.28",3600
rb1802,20180102,3987,4027,3984,4070,3984,4038,4041,11,14,388,"1,567.92",3830
,20180103,4038,4041,4032,4040,3988,3988,4016,-53,-25,114,457.85,3888
,20180104,3988,4016,3970,4016,3970,4000,3992,-16,-24,176,702.72,3914
,20180105,4000,3992,3995,3999,3918,3966,3979,-26,-13,414,"1,647.58",3748
,20180108,3966,3979,3995,4000,3921,4000,3956,21,-23,576,"2,278.72",3662
,20180109,4000,3956,3993,4008,3959,3980,3974,24,18,484,"1,923.82",3788
,20180110,3980,3974,3964,3991,3955,3976,3982,2,8,270,"1,075.38",3872
,20180111,3976,3982,3981,4020,3981,3986,3992,4,10,118,471.17,3828
,20180112,3986,3992,3971,3978,3923,3930,3936,-62,-56,298,"1,173.02",3790
,20180115,3930,3936,3915,3917,3846,3872,3891,-64,-45,592,"2,303.69",4132
,20180116,3872,3891,3893,3893,3840,3857,3868,-34,-23,110,425.59,4140
,20180117,3857,3868,3829,3864,3828,3858,3843,-10,-25,524,"2,013.75",4124
,20180118,3858,3843,3857,3874,3838,3873,3855,30,12,960,"3,701.41",4200
,20180119,3873,3855,3898,3923,3834,3923,3900,68,45,372,"1,451.01",4220
,20180122,3923,3900,3913,3960,3913,3913,3945,13,45,276,"1,088.82",4178
,20180123,3913,3945,3920,3920,3869,3900,3901,-45,-44,54,210.67,4182
,20180124,3900,3901,3911,3928,3819,3928,3906,27,5,502,"1,961.30",4200
,20180125,3928,3906,3898,3979,3898,3955,3937,49,31,944,"3,716.93",4204
,20180126,3955,3937,3932,3979,3932,3962,3956,25,19,58,229.45,4194
,20180129,3962,3956,3937,3986,3937,3952,3970,-4,14,168,667.04,4172
,20180130,3952,3970,3979,3979,3825,3841,3887,-129,-83,294,"1,142.94",4158
,20180131,3841,3887,3887,4083,3641,3641,3866,-246,-21,396,"1,531.32",4082
,20180201,3641,3866,3900,3953,3900,3920,3928,54,62,302,"1,186.31",3960
,20180202,3920,3928,3920,3950,3920,3930,3930,2,2,1080,"4,244.46",3840
,20180205,3930,3930,3930,3930,3930,3930,3930,0,0,120,471.60,3720
,20180206,3930,3930,3930,3970,3860,3870,3910,-60,-20,480,"1,876.86",3360
,20180207,3870,3910,3920,3920,3920,3920,3920,10,10,60,235.20,3360
,20180208,3920,3920,3920,3940,3920,3940,3930,20,10,120,471.60,3300
,20180209,3940,3930,3970,3970,3970,3970,3970,40,40,60,238.20,3300
rb1803,20180102,3969,3990,3971,4043,3969,4030,4017,40,27,508,"2,040.90",4204
,20180103,4030,4017,4025,4030,3962,3966,4005,-51,-12,404,"1,618.27",4344
,20180104,3966,4005,3973,3995,3922,3995,3971,-10,-34,66,262.12,4352
,20180105,3995,3971,3986,3986,3923,3957,3947,-14,-24,184,726.30,4392
,20180108,3957,3947,3957,3957,3897,3951,3922,4,-25,818,"3,208.90",4730
,20180109,3951,3922,3950,3978,3943,3944,3961,22,39,894,"3,541.67",4944
,20180110,3944,3961,3955,3993,3935,3976,3966,15,5,154,610.88,4956
,20180111,3976,3966,3980,4003,3954,3961,3963,-5,-3,440,"1,744.03",5252
,20180112,3961,3963,3960,3969,3880,3892,3903,-71,-60,852,"3,325.84",5844
,20180115,3892,3903,3863,3889,3817,3872,3863,-31,-40,2232,"8,623.55",7174
,20180116,3872,3863,3878,3896,3852,3860,3873,-3,10,418,"1,619.07",7294
,20180117,3860,3873,3852,3890,3852,3886,3875,13,2,184,713.16,7370
,20180118,3886,3875,3889,3897,3865,3880,3883,5,8,320,"1,242.71",7368
,20180119,3880,3883,3898,3929,3882,3928,3914,45,31,466,"1,823.99",7362
,20180122,3928,3914,3925,3965,3922,3933,3940,19,26,228,898.48,7366
,20180123,3933,3940,3946,3946,3894,3925,3916,-15,-24,60,234.97,7366
,20180124,3925,3916,3928,3941,3913,3938,3930,22,14,54,212.27,7358
,20180125,3938,3930,3922,3983,3921,3968,3961,38,31,58,229.76,7358
,20180126,3968,3961,3967,3967,3928,3941,3948,-20,-13,96,379.01,7354
,20180129,3941,3948,3956,3966,3938,3952,3954,4,6,482,"1,906.23",7746
,20180130,3952,3954,3931,3950,3891,3908,3921,-46,-33,160,627.50,7712
,20180131,3908,3921,3946,3954,3876,3905,3905,-16,-16,100,390.53,7706
,20180201,3905,3905,3934,3949,3925,3925,3932,20,27,360,"1,415.53",7408
,20180202,3925,3932,3934,3970,3928,3955,3941,23,9,352,"1,387.42",7402
,20180205,3955,3941,3943,3983,3938,3983,3956,42,15,124,490.62,7296
,20180206,3983,3956,3988,3996,3944,3958,3975,2,19,158,628.06,7216
,20180207,3958,3975,3941,3968,3941,3947,3952,-28,-23,56,221.33,7196
,20180208,3947,3952,3937,3946,3926,3943,3935,-9,-17,102,401.44,7180
,20180209,3943,3935,3922,3941,3893,3911,3918,-24,-17,176,689.65,7016
,20180212,3911,3918,3931,3931,3921,3921,3924,3,6,6,23.55,7014
,20180213,3921,3924,3911,3932,3911,3931,3923,7,-1,198,776.93,6954
,20180214,3931,3923,3920,3945,3920,3945,3935,22,12,14,55.09,6944
,20180222,3945,3935,3918,3926,3866,3868,3884,-67,-51,480,"1,864.50",6594
,20180223,3868,3884,3849,3955,3849,3950,3904,66,20,634,"2,475.25",6128
,20180226,3950,3904,3950,4111,3947,4111,4062,207,158,2464,"10,010.17",4808
,20180227,4111,4062,4130,4220,4095,4127,4127,65,65,462,"1,906.94",4660
,20180228,4127,4127,4118,4324,4080,4158,4135,31,8,580,"2,398.36",4260
,20180301,4158,4135,4121,4248,4121,4240,4195,105,60,360,"1,510.26",4020
,20180302,4240,4195,4119,4119,4119,4119,4119,-76,-76,180,741.42,4020
,20180305,4119,4119,4121,4127,4121,4127,4122,8,3,240,989.40,4020
,20180306,4127,4122,,,,4122,4122,0,0,0,0.00,4020
,20180307,4122,4122,4180,4185,4180,4185,4182,63,60,120,501.90,3960
,20180308,4185,4182,4000,4000,4000,4000,4000,-182,-182,60,240.00,3960
,20180309,4000,4000,4100,4100,3838,3839,3890,-161,-110,300,"1,167.24",3960
,20180312,3839,3890,4158,4158,4158,4158,4158,268,268,60,249.48,3900
,20180313,4158,4158,3980,3980,3980,3980,3980,-178,-178,60,238.80,3900
,20180314,3980,3980,3920,3990,3920,3990,3983,10,3,660,"2,629.20",3900
,20180315,3990,3983,3984,3984,3984,3984,3984,1,1,600,"2,390.40",3900
rb1804,20180102,3878,3896,3927,3985,3914,3985,3931,89,35,340,"1,336.72",4296
,20180103,3985,3931,3964,3967,3907,3907,3942,-24,11,382,"1,506.20",4336
,20180104,3907,3942,3914,3938,3891,3914,3918,-28,-24,164,642.57,4386
,20180105,3914,3918,3915,3937,3869,3920,3908,2,-10,218,852.07,4490
,20180108,3920,3908,3904,3920,3845,3897,3871,-11,-37,236,913.56,4528
,20180109,3897,3871,3941,3944,3914,3914,3935,43,64,402,"1,581.97",4602
,20180110,3914,3935,3944,3979,3896,3952,3923,17,-12,418,"1,640.22",4372
,20180111,3952,3923,3967,3975,3918,3936,3946,13,23,392,"1,547.12",4296
,20180112,3936,3946,3929,3937,3867,3867,3897,-79,-49,366,"1,426.63",4234
,20180115,3867,3897,3869,3890,3839,3872,3864,-25,-33,854,"3,300.03",4426
,20180116,3872,3864,3877,3910,3863,3866,3879,2,15,172,667.21,4528
,20180117,3866,3879,3878,3902,3858,3890,3880,11,1,598,"2,320.30",4616
,20180118,3890,3880,3895,3952,3891,3917,3910,37,30,424,"1,658.23",4606
,20180119,3917,3910,3930,3990,3919,3978,3955,68,45,450,"1,780.19",4656
,20180122,3978,3955,3997,4026,3977,3982,4000,27,45,606,"2,424.45",4398
,20180123,3982,4000,3975,3985,3935,3970,3967,-30,-33,606,"2,404.09",4576
,20180124,3970,3967,3953,3991,3953,3987,3978,20,11,856,"3,405.36",4926
,20180125,3987,3978,3987,4045,3967,4010,4018,32,40,604,"2,427.44",5026
,20180126,4010,4018,4005,4029,3981,3990,4001,-28,-17,158,632.16,5018
,20180129,3990,4001,3991,4014,3980,3990,3996,-11,-5,244,975.12,5116
,20180130,3990,3996,3993,4006,3960,3973,3974,-23,-22,186,739.31,5128
,20180131,3973,3974,4016,4016,3950,3963,3977,-11,3,604,"2,402.52",5328
,20180201,3963,3977,3980,4014,3978,3978,3990,1,13,520,"2,075.25",5454
,20180202,3978,3990,3997,4026,3995,4018,4012,28,22,146,585.78,5426
,20180205,4018,4012,4012,4026,3981,4026,4012,14,0,126,505.56,5426
,20180206,4026,4012,4020,4080,4005,4011,4042,-1,30,446,"1,802.85",5454
,20180207,4011,4042,4008,4027,3950,4000,4004,-42,-38,452,"1,810.07",5442
,20180208,4000,4004,4001,4002,3981,3981,3993,-23,-11,652,"2,604.04",5338
,20180209,3981,3993,3990,3999,3940,3955,3965,-38,-28,626,"2,482.60",5342
,20180212,3955,3965,3941,3969,3941,3969,3957,4,-8,92,364.05,5374
,20180213,3969,3957,3979,3986,3956,3971,3975,14,18,144,572.41,5346
,20180214,3971,3975,3970,3995,3958,3992,3975,17,0,606,"2,409.05",5500
,20180222,3992,3975,3970,3970,3900,3922,3918,-53,-57,116,454.50,5568
,20180223,3922,3918,3904,4000,3904,4000,3940,82,22,230,906.27,5602
,20180226,4000,3940,3998,4090,3990,4083,4064,143,124,1202,"4,885.30",5144
,20180227,4083,4064,4077,4107,4060,4107,4072,43,8,554,"2,256.40",5146
,20180228,4107,4072,4076,4093,4075,4093,4083,21,11,134,547.15,5194
,20180301,4093,4083,4092,4135,4088,4131,4109,48,26,798,"3,279.23",5084
,20180302,4131,4109,4106,4117,4086,4095,4100,-14,-9,146,598.70,5030
,20180305,4095,4100,4109,4109,4052,4053,4079,-47,-21,1074,"4,380.91",4684
,20180306,4053,4079,4033,4081,4021,4081,4039,2,-40,356,"1,438.21",4554
,20180307,4081,4039,4050,4073,3990,3990,4044,-49,5,598,"2,418.68",4220
,20180308,3990,4044,3982,3996,3890,3904,3949,-140,-95,150,592.38,4212
,20180309,3904,3949,3892,3938,3807,3807,3870,-142,-79,1608,"6,223.78",3632
,20180312,3807,3870,3835,3880,3826,3868,3839,-2,-31,762,"2,925.40",3070
,20180313,3868,3839,3879,3885,3855,3877,3867,38,28,860,"3,326.40",2304
,20180314,3877,3867,3893,3920,3834,3880,3879,13,12,762,"2,956.43",1772
,20180315,3880,3879,3880,3910,3875,3896,3894,17,15,142,553.08,1692
,20180316,3896,3894,3865,3901,3808,3844,3842,-50,-52,728,"2,797.11",1284
,20180319,3844,3842,3809,3811,3747,3752,3769,-90,-73,152,572.93,1170
,20180320,3752,3769,3727,3763,3676,3722,3740,-47,-29,952,"3,560.82",1138
,20180321,3722,3740,3744,3744,3675,3703,3716,-37,-24,96,356.74,1086
,20180322,3703,3716,3710,3710,3667,3667,3691,-49,-25,22,81.22,1072
,20180323,3667,3691,3674,3674,3450,3467,3525,-224,-166,82,289.06,1056
,20180326,3467,3525,3419,3483,3351,3417,3410,-108,-115,106,361.55,1048
,20180327,3417,3410,3333,3470,3333,3435,3417,25,7,20,68.35,1044
,20180328,3435,3417,3429,3450,3411,3436,3433,19,16,102,350.26,1052
,20180329,3436,3433,3447,3490,3403,3490,3409,57,-24,234,797.89,862
,20180330,3490,3409,3486,3635,3480,3626,3530,217,121,140,494.20,780
,20180402,3626,3530,3668,3668,3668,3668,3668,138,138,60,220.08,720
,20180403,3668,3668,3679,3679,3600,3600,3656,-68,-12,660,"2,413.14",120
,20180404,3600,3656,,,,3656,3656,0,0,0,0.00,120
,20180409,3656,3656,,,,3656,3656,0,0,0,0.00,120
,20180410,3656,3656,,,,3656,3656,0,0,0,0.00,120
,20180411,3656,3656,3700,3700,3700,3700,3700,44,44,60,222.00,60
,20180412,3700,3700,,,,3700,3700,0,0,0,0.00,60
,20180413,3700,3700,,,,3700,3700,0,0,0,0.00,60
,20180416,3700,3700,,,,3700,3700,0,0,0,0.00,60
rb1805,20180102,3794,3794,3801,3886,3794,3874,3842,80,48,2961436,"11,380,175.18",2413572
,20180103,3874,3842,3866,3877,3803,3809,3845,-33,3,3523844,"13,551,810.88",2433636
,20180104,3809,3845,3805,3842,3788,3819,3811,-26,-34,3747764,"14,286,351.72",2581090
,20180105,3819,3811,3812,3827,3760,3798,3791,-13,-20,3941160,"14,943,605.71",2744436
,20180108,3798,3791,3795,3820,3733,3818,3772,27,-19,4329290,"16,332,800.15",2717212
,20180109,3818,3772,3818,3843,3810,3819,3824,47,52,3148548,"12,040,219.82",2564464
,20180110,3819,3824,3818,3868,3792,3849,3833,25,9,4174000,"16,000,940.77",2676566
,20180111,3849,3833,3858,3876,3824,3838,3850,5,17,3631732,"13,985,308.16",2597150
,20180112,3838,3850,3838,3849,3778,3790,3807,-60,-43,3298806,"12,561,607.89",2733076
,20180115,3790,3807,3786,3811,3749,3802,3784,-5,-23,3097214,"11,722,953.63",2833502
,20180116,3802,3784,3803,3844,3788,3790,3814,6,30,3670054,"13,999,238.04",2637024
,20180117,3790,3814,3788,3841,3783,3827,3816,13,2,4281478,"16,341,772.77",2736546
,20180118,3827,3816,3825,3868,3815,3859,3843,43,27,3516314,"13,514,118.96",2926692
,20180119,3859,3843,3867,3927,3855,3926,3883,83,40,4341444,"16,858,210.17",3154466
,20180122,3926,3883,3937,3974,3916,3927,3939,44,56,3595842,"14,165,740.53",3235974
,20180123,3927,3939,3930,3933,3874,3912,3905,-27,-34,4132416,"16,138,330.52",3017524
,20180124,3912,3905,3904,3948,3896,3937,3924,32,19,2808360,"11,021,574.39",3132256
,20180125,3937,3924,3933,3998,3916,3966,3958,42,34,3860830,"15,281,929.84",3207556
,20180126,3966,3958,3965,3976,3920,3945,3948,-13,-10,2985708,"11,788,159.55",3094676
,20180129,3945,3948,3942,3968,3923,3945,3945,-3,-3,2502918,"9,874,196.22",3065612
,20180130,3945,3945,3938,3944,3903,3921,3923,-24,-22,2680272,"10,516,455.26",2943354
,20180131,3921,3923,3919,3988,3892,3915,3918,-8,-5,2741322,"10,741,832.14",2858688
,20180201,3915,3918,3920,3969,3919,3931,3941,13,23,3082336,"12,148,395.58",2909296
,20180202,3931,3941,3921,3973,3913,3961,3949,20,8,2699418,"10,661,984.06",2912456
,20180205,3961,3949,3960,3971,3922,3967,3946,18,-3,2520722,"9,948,525.80",2786752
,20180206,3967,3946,3970,3998,3931,3943,3960,-3,14,3078200,"12,190,619.55",2719124
,20180207,3943,3960,3949,3965,3927,3937,3944,-23,-16,2060998,"8,128,622.19",2682964
,20180208,3937,3944,3936,3951,3916,3930,3931,-14,-13,2206992,"8,677,885.23",2668894
,20180209,3930,3931,3928,3946,3881,3895,3911,-36,-20,2574966,"10,072,761.05",2586270
,20180212,3895,3911,3890,3925,3882,3918,3906,7,-5,1570766,"6,136,718.07",2455788
,20180213,3918,3906,3920,3935,3894,3921,3918,15,12,1344078,"5,267,116.19",2318730
,20180214,3921,3918,3921,3951,3916,3934,3934,16,16,1115116,"4,386,904.38",2226628
,20180222,3934,3934,3945,3955,3841,3866,3881,-68,-53,2061350,"8,000,455.94",2438736
,20180223,3866,3881,3846,3959,3841,3949,3898,68,17,3569646,"13,915,545.55",2472076
,20180226,3949,3898,3954,4047,3938,4028,4000,130,102,2765834,"11,063,627.87",2556516
,20180227,4028,4000,4038,4040,3981,4035,4014,35,14,2380880,"9,557,364.25",2509598
,20180228,4035,4014,4030,4034,4006,4020,4019,6,5,2004708,"8,057,502.65",2523848
,20180301,4020,4019,4017,4062,4012,4032,4036,13,17,2698576,"10,893,887.86",2608248
,20180302,4032,4036,4022,4029,3991,4024,4009,-12,-27,2319730,"9,301,430.13",2495890
,20180305,4024,4009,4019,4028,3948,3957,3980,-52,-29,2822262,"11,233,902.99",2571916
,20180306,3957,3980,3948,3987,3919,3969,3954,-11,-26,3130932,"12,380,028.84",2667332
,20180307,3969,3954,3980,3985,3885,3890,3939,-64,-15,3411932,"13,440,976.08",2732922
,20180308,3890,3939,3885,3893,3792,3794,3853,-145,-86,3825014,"14,739,836.63",2708162
,20180309,3794,3853,3773,3805,3663,3709,3738,-144,-115,5354170,"20,016,243.41",2582206
,20180312,3709,3738,3737,3751,3676,3709,3719,-29,-19,4245310,"15,790,410.61",2550928
,20180313,3709,3719,3716,3739,3683,3695,3712,-24,-7,2974572,"11,043,890.37",2608346
,20180314,3695,3712,3703,3755,3657,3735,3707,23,-5,4231252,"15,685,286.11",2567680
,20180315,3735,3707,3748,3769,3727,3752,3748,45,41,3267560,"12,248,466.02",2423320
,20180316,3752,3748,3752,3758,3718,3731,3737,-17,-11,2793532,"10,441,721.14",2399336
,20180319,3731,3737,3731,3735,3638,3651,3675,-86,-62,3932802,"14,453,343.31",2390864
,20180320,3651,3675,3646,3667,3605,3649,3637,-26,-38,3093030,"11,250,969.60",2259540
,20180321,3649,3637,3653,3685,3608,3617,3646,-20,9,3150512,"11,489,154.22",2319096
,20180322,3617,3646,3617,3655,3589,3619,3623,-27,-23,3353098,"12,150,835.73",2288630
,20180323,3619,3623,3609,3609,3369,3369,3460,-254,-163,6156296,"21,305,076.24",2028014
,20180326,3369,3460,3379,3415,3333,3363,3364,-97,-96,3940734,"13,257,789.27",1931786
,20180327,3363,3364,3355,3474,3352,3433,3413,69,49,3469360,"11,843,929.08",1734578
,20180328,3433,3413,3447,3470,3383,3424,3431,11,18,3680998,"12,631,003.48",1637770
,20180329,3424,3431,3425,3480,3412,3479,3446,48,15,2241628,"7,724,651.83",1494846
,20180330,3479,3446,3483,3596,3474,3592,3518,146,72,2222082,"7,817,690.49",1266886
,20180402,3592,3518,3598,3663,3570,3591,3594,73,76,1600342,"5,751,717.78",1099996
,20180403,3591,3594,3595,3665,3584,3599,3627,5,33,1561044,"5,662,641.20",965474
,20180404,3599,3627,3605,3628,3576,3590,3600,-37,-27,957088,"3,445,787.51",856370
,20180409,3590,3600,3595,3650,3585,3649,3623,49,23,587002,"2,126,761.20",765700
,20180410,3649,3623,3650,3680,3628,3669,3651,46,28,532130,"1,943,304.05",676162
,20180411,3669,3651,3670,3693,3652,3663,3670,12,19,449024,"1,648,043.98",609708
,20180412,3663,3670,3659,3691,3634,3671,3660,1,-10,386950,"1,416,418.49",546416
,20180413,3671,3660,3664,3718,3649,3715,3685,55,25,303082,"1,117,059.17",498884
,20180416,3715,3685,3714,3725,3668,3680,3695,-5,10,252552,"933,209.15",458370
,20180417,3680,3695,3680,3709,3662,3687,3686,-8,-9,220510,"812,988.19",414992
,20180418,3687,3686,3710,3747,3709,3725,3724,39,38,301136,"1,121,622.50",359616
,20180419,3725,3724,3746,3788,3740,3779,3760,55,36,217828,"819,097.40",306810
,20180420,3779,3760,3778,3785,3723,3731,3748,-29,-12,153612,"575,812.41",275276
,20180423,3731,3748,3718,3820,3718,3816,3783,68,35,178090,"673,779.84",230368
,20180424,3816,3783,3806,3900,3802,3890,3868,107,85,167902,"649,545.11",182174
,20180425,3890,3868,3891,3909,3863,3897,3889,29,21,107194,"416,949.36",154188
,20180426,3897,3889,3908,3925,3880,3922,3906,33,17,104492,"408,204.89",118192
,20180427,3922,3906,3922,3964,3913,3954,3938,48,32,109788,"432,376.17",46922
,20180502,3954,3938,4050,4100,3967,4098,4028,160,90,19922,"80,250.83",32400
,20180503,4098,4028,4110,4110,4012,4029,4057,1,29,9960,"40,408.44",26580
,20180504,4029,4057,4020,4069,4012,4066,4040,9,-17,4140,"16,726.74",24480
,20180507,4066,4040,4050,4114,4025,4105,4087,65,47,6960,"28,448.94",20100
,20180508,4105,4087,4109,4111,4089,4105,4105,18,18,4080,"16,750.08",16800
,20180509,4105,4105,4100,4104,4040,4050,4072,-55,-33,6900,"28,100.22",11280
,20180510,4050,4072,4038,4080,4038,4067,4066,-5,-6,9480,"38,548.62",2700
,20180511,4067,4066,4041,4041,3900,3900,4010,-166,-56,720,"2,887.56",2280
,20180514,3900,4010,,,,4010,4010,0,0,0,0.00,2280
,20180515,4010,4010,4010,4010,3980,3980,4007,-30,-3,1380,"5,530.14",1200
rb1806,20180102,3747,3738,3754,3832,3750,3820,3788,82,50,148,560.76,2784
,20180103,3820,3788,3812,3819,3760,3767,3788,-21,0,114,431.89,2796
,20180104,3767,3788,3790,3800,3750,3775,3774,-13,-14,1046,"3,947.82",3324
,20180105,3775,3774,3754,3763,3726,3754,3743,-20,-31,822,"3,077.50",3990
,20180108,3754,3743,3768,3768,3701,3768,3726,25,-17,204,760.11,3998
,20180109,3768,3726,3777,3800,3774,3781,3787,55,61,194,734.82,4000
,20180110,3781,3787,3773,3827,3753,3810,3805,23,18,1268,"4,824.82",3944
,20180111,3810,3805,3817,3826,3778,3793,3813,-12,8,604,"2,303.19",3944
,20180112,3793,3813,3788,3796,3738,3754,3760,-59,-53,414,"1,556.92",4052
,20180115,3754,3760,3743,3761,3725,3758,3741,-2,-19,220,823.17,4096
,20180116,3758,3741,3770,3790,3744,3760,3774,19,33,202,762.49,4128
,20180117,3760,3774,3750,3789,3744,3779,3771,5,-3,190,716.55,4188
,20180118,3779,3771,3782,3815,3778,3803,3795,32,24,54,204.95,4200
,20180119,3803,3795,3822,3881,3802,3881,3836,86,41,264,"1,012.83",4196
,20180122,3881,3836,3880,3908,3869,3872,3882,36,46,312,"1,211.36",4186
,20180123,3872,3882,3862,3871,3826,3851,3859,-31,-23,90,347.32,4222
,20180124,3851,3859,3856,3898,3851,3896,3887,37,28,426,"1,655.98",4260
,20180125,3896,3887,3893,3945,3614,3922,3826,35,-61,482,"1,844.23",4258
,20180126,3922,3826,3900,3925,3867,3893,3898,67,72,112,436.66,4264
,20180129,3893,3898,3901,3969,3880,3902,3908,4,10,80,312.68,4250
,20180130,3902,3908,3903,3903,3855,3855,3884,-53,-24,128,497.26,4228
,20180131,3855,3884,3921,3921,3840,3866,3868,-18,-16,148,572.59,4260
,20180201,3866,3868,3866,3915,3866,3890,3896,22,28,110,428.64,4280
,20180202,3890,3896,3886,3913,3886,3912,3906,16,10,24,93.75,4280
,20180205,3912,3906,3885,3913,3885,3910,3899,4,-7,20,77.98,4274
,20180206,3910,3899,3931,3952,3892,3892,3926,-7,27,96,376.94,4274
,20180207,3892,3926,3894,3920,3893,3896,3901,-30,-25,32,124.84,4262
,20180208,3896,3901,3882,3901,3870,3899,3885,-2,-16,426,"1,655.04",4228
,20180209,3899,3885,3889,3889,3846,3846,3863,-39,-22,138,533.14,4216
,20180212,3846,3863,,,,3863,3863,0,0,0,0.00,4216
,20180213,3863,3863,3869,3892,3866,3875,3879,12,16,86,333.68,4208
,20180214,3875,3879,3878,3904,3875,3891,3891,12,12,82,319.10,4204
,20180222,3891,3891,3881,3881,3817,3823,3828,-68,-63,278,"1,064.24",4374
,20180223,3823,3828,3828,3904,3810,3888,3836,60,8,108,414.34,4398
,20180226,3888,3836,3896,3998,3896,3979,3964,143,128,180,713.69,4414
,20180227,3979,3964,3973,3993,3941,3983,3968,19,4,552,"2,190.88",4522
,20180228,3983,3968,3967,3983,3963,3967,3971,-1,3,120,476.56,4544
,20180301,3967,3971,3967,4035,3967,4002,3998,31,27,898,"3,590.26",5018
,20180302,4002,3998,3970,3984,3953,3984,3969,-14,-29,778,"3,088.64",5646
,20180305,3984,3969,3976,3976,3913,3926,3942,-43,-27,114,449.48,5644
,20180306,3926,3942,3902,3944,3886,3937,3907,-5,-35,136,531.35,5660
,20180307,3937,3907,3942,3943,3866,3866,3902,-41,-5,156,608.72,5724
,20180308,3866,3902,3868,3869,3780,3780,3808,-122,-94,914,"3,481.19",5958
,20180309,3780,3808,3745,3793,3648,3686,3711,-122,-97,1570,"5,826.83",6424
,20180312,3686,3711,3715,3738,3666,3691,3704,-20,-7,2948,"10,922.24",6780
,20180313,3691,3704,3698,3704,3657,3668,3680,-36,-24,374,"1,376.45",6626
,20180314,3668,3680,3684,3718,3643,3686,3671,6,-9,440,"1,615.49",6712
,20180315,3686,3671,3709,3726,3694,3725,3704,54,33,236,874.31,6794
,20180316,3725,3704,3702,3719,3684,3697,3700,-7,-4,150,555.00,6780
,20180319,3697,3700,3689,3696,3606,3606,3632,-94,-68,482,"1,750.91",6744
,20180320,3606,3632,3613,3628,3576,3621,3617,-11,-15,1762,"6,374.13",6814
,20180321,3621,3617,3622,3644,3579,3583,3623,-34,6,380,"1,377.00",6826
,20180322,3583,3623,3587,3613,3577,3577,3589,-46,-34,272,976.24,6792
,20180323,3577,3589,3560,3566,3337,3359,3452,-230,-137,580,"2,002.62",6864
,20180326,3359,3452,3359,3390,3313,3315,3341,-137,-111,380,"1,269.62",6974
,20180327,3315,3341,3330,3439,3330,3409,3390,68,49,950,"3,221.27",7216
,20180328,3409,3390,3418,3453,3359,3399,3399,9,9,750,"2,549.52",7316
,20180329,3399,3399,3401,3451,3390,3445,3415,46,16,934,"3,189.70",7928
,20180330,3445,3415,3467,3555,3450,3555,3487,140,72,1300,"4,533.41",8452
,20180402,3555,3487,3568,3599,3549,3570,3564,83,77,1584,"5,645.83",9028
,20180403,3570,3564,3560,3628,3551,3583,3588,19,24,1380,"4,951.79",9582
,20180404,3583,3588,3560,3602,3558,3568,3570,-20,-18,1146,"4,091.50",10256
,20180409,3568,3570,3592,3620,3571,3620,3588,50,18,344,"1,234.41",10266
,20180410,3620,3588,3605,3658,3603,3642,3630,54,42,422,"1,532.13",10258
,20180411,3642,3630,3653,3672,3633,3643,3645,13,15,498,"1,815.52",10458
,20180412,3643,3645,3629,3666,3616,3658,3637,13,-8,878,"3,194.08",10828
,20180413,3658,3637,3669,3700,3637,3690,3668,53,31,812,"2,979.04",10634
,20180416,3690,3668,3696,3709,3656,3665,3672,-3,4,986,"3,621.09",10630
,20180417,3665,3672,3656,3700,3653,3686,3681,14,9,1328,"4,889.29",10786
,20180418,3686,3681,3766,3778,3690,3759,3746,78,65,2062,"7,725.68",10044
,20180419,3759,3746,3791,3822,3777,3822,3798,76,52,1148,"4,360.36",9980
,20180420,3822,3798,3806,3814,3765,3773,3784,-25,-14,2736,"10,354.90",10356
,20180423,3773,3784,3778,3835,3776,3835,3820,51,36,2510,"9,589.18",9090
,20180424,3835,3820,3829,3895,3828,3888,3871,68,51,1296,"5,017.36",8966
,20180425,3888,3871,3906,3906,3859,3880,3883,9,12,692,"2,687.14",8990
,20180426,3880,3883,3906,3906,3865,3898,3884,15,1,1350,"5,244.22",9112
,20180427,3898,3884,3895,3917,3890,3909,3904,25,20,2126,"8,300.93",8388
,20180502,3909,3904,3942,4048,3934,4043,4000,139,96,1018,"4,072.30",8552
,20180503,4043,4000,4030,4066,4030,4062,4051,62,51,2036,"8,249.84",9038
,20180504,4062,4051,4053,4067,4042,4056,4056,5,5,1420,"5,760.83",8770
,20180507,4056,4056,4048,4098,4021,4076,4047,20,-9,3306,"13,380.73",9336
,20180508,4076,4047,4055,4077,4050,4070,4068,23,21,898,"3,653.27",9242
,20180509,4070,4068,4053,4062,4010,4035,4048,-33,-20,1458,"5,902.93",9680
,20180510,4035,4048,4024,4067,4024,4067,4054,19,6,1546,"6,268.24",9208
,20180511,4067,4054,4066,4099,4054,4084,4077,30,23,1622,"6,614.51",8256
,20180514,4084,4077,4096,4096,4071,4078,4081,1,4,404,"1,648.81",8210
,20180515,4078,4081,4083,4111,4077,4098,4096,17,15,1630,"6,678.09",7308
,20180516,4098,4096,4092,4096,4065,4080,4087,-16,-9,466,"1,904.57",7064
,20180517,4080,4087,4071,4094,4069,4090,4082,3,-5,270,"1,102.35",7002
,20180518,4090,4082,4092,4092,4072,4084,4080,2,-2,396,"1,615.74",6918
,20180521,4084,4080,4064,4092,4064,4068,4083,-12,3,720,"2,940.19",6574
,20180522,4068,4083,4076,4078,4065,4066,4071,-17,-12,768,"3,126.54",6040
,20180523,4066,4071,4071,4071,4011,4016,4035,-55,-36,1098,"4,431.40",5724
,20180524,4016,4035,4018,4031,3994,4029,4015,-6,-20,1490,"5,983.38",4582
,20180525,4029,4015,4047,4047,4020,4024,4029,9,14,1068,"4,303.03",3698
,20180528,4024,4029,4013,4028,4000,4012,4021,-17,-8,684,"2,750.64",3236
,20180529,4012,4021,4002,4035,4002,4010,4019,-11,-2,716,"2,877.78",2658
,20180530,4010,4019,4016,4065,4016,4065,4055,46,36,580,"2,352.00",2204
,20180531,4065,4055,4040,4287,4040,4287,4130,232,75,1312,"5,419.66",1260
rb1807,20180102,3709,3722,3726,3815,3726,3806,3757,84,35,180,676.26,382
,20180103,3806,3757,3782,3799,3735,3742,3764,-15,7,70,263.50,398
,20180104,3742,3764,3740,3746,3735,3746,3737,-18,-27,32,119.58,408
,20180105,3746,3737,3749,3749,3692,3733,3728,-4,-9,144,536.93,392
,20180108,3733,3728,3733,3756,3690,3756,3713,28,-15,50,185.66,408
,20180109,3756,3713,3756,3777,3745,3759,3765,46,52,122,459.39,398
,20180110,3759,3765,3743,3787,3743,3787,3775,22,10,88,332.28,376
,20180111,3787,3775,3800,3803,3764,3780,3790,5,15,80,303.27,390
,20180112,3780,3790,3773,3773,3718,3721,3745,-69,-45,82,307.09,400
,20180115,3721,3745,3726,3754,3690,3740,3725,-5,-20,194,722.67,508
,20180116,3740,3725,3753,3777,3753,3758,3764,33,39,90,338.84,446
,20180117,3758,3764,3759,3773,3741,3743,3757,-21,-7,44,165.33,458
,20180118,3743,3757,3774,3797,3770,3797,3777,40,20,74,279.51,424
,20180119,3797,3777,3800,3848,3790,3848,3806,71,29,84,319.72,396
,20180122,3848,3806,3856,3872,3846,3851,3859,45,53,66,254.71,390
,20180123,3851,3859,3852,3852,3791,3852,3835,-7,-24,36,138.08,410
,20180124,3852,3835,3852,3873,3852,3872,3859,37,24,72,277.85,384
,20180125,3872,3859,3860,3920,3858,3920,3894,61,35,100,389.41,376
,20180126,3920,3894,3899,3902,3868,3892,3885,-2,-9,34,132.12,396
,20180129,3892,3885,3880,3894,3873,3892,3885,7,0,40,155.40,408
,20180130,3892,3885,3875,3886,3860,3860,3874,-25,-11,24,92.99,422
,20180131,3860,3874,3901,3905,3836,3849,3869,-25,-5,102,394.69,414
,20180201,3849,3869,3864,3900,3864,3870,3880,1,11,132,512.22,436
,20180202,3870,3880,3882,3892,3873,3892,3887,12,7,18,69.98,444
,20180205,3892,3887,3903,3903,3868,3898,3888,11,1,34,132.22,434
,20180206,3898,3888,3910,3927,3880,3880,3892,-8,4,58,225.79,424
,20180207,3880,3892,3871,3900,3869,3872,3878,-20,-14,58,224.95,394
,20180208,3872,3878,3862,3891,3862,3877,3877,-1,-1,38,147.35,424
,20180209,3877,3877,3882,3882,3845,3845,3862,-32,-15,80,308.97,448
,20180212,3845,3862,3823,3843,3822,3843,3824,-19,-38,22,84.13,442
,20180213,3843,3824,3849,3868,3847,3860,3856,36,32,20,77.12,438
,20180214,3860,3856,3868,3889,3859,3870,3869,14,13,18,69.65,436
,20180222,3870,3869,3841,3843,3821,3824,3830,-45,-39,16,61.29,444
,20180223,3824,3830,3814,3908,3814,3908,3879,78,49,24,93.11,440
,20180226,3908,3879,3890,3988,3890,3957,3959,78,80,188,744.38,366
,20180227,3957,3959,3957,3979,3938,3979,3951,20,-8,124,489.97,422
,20180228,3979,3951,3964,3980,3956,3980,3970,29,19,68,270.02,440
,20180301,3980,3970,3974,3998,3958,3986,3984,16,14,176,701.32,482
,20180302,3986,3984,3953,3961,3947,3947,3951,-37,-33,36,142.24,504
,20180305,3947,3951,3954,3954,3907,3907,3928,-44,-23,56,220.01,522
,20180306,3907,3928,3888,3932,3875,3932,3902,4,-26,66,257.57,538
,20180307,3932,3902,3926,3938,3870,3870,3902,-32,0,286,"1,115.97",750
,20180308,3870,3902,3858,3882,3802,3808,3833,-94,-69,246,943.01,878
,20180309,3808,3833,3771,3803,3661,3703,3748,-130,-85,386,"1,446.91",936
,20180312,3703,3748,3715,3745,3672,3704,3710,-44,-38,324,"1,202.33",996
,20180313,3704,3710,3702,3714,3672,3673,3693,-37,-17,120,443.17,1006
,20180314,3673,3693,3691,3718,3651,3711,3686,18,-7,212,781.46,1016
,20180315,3711,3686,3728,3741,3706,3726,3723,40,37,150,558.55,1034
,20180316,3726,3723,3714,3727,3692,3724,3704,1,-19,118,437.17,1034
,20180319,3724,3704,3695,3724,3609,3630,3667,-74,-37,436,"1,598.81",1040
,20180320,3630,3667,3628,3639,3584,3628,3608,-39,-59,534,"1,926.68",1302
,20180321,3628,3608,3618,3654,3588,3588,3622,-20,14,234,847.73,1298
,20180322,3588,3622,3586,3624,3582,3603,3597,-19,-25,416,"1,496.64",1302
,20180323,3603,3597,3572,3578,3345,3360,3421,-237,-176,1066,"3,647.79",1326
,20180326,3360,3421,3366,3390,3330,3343,3353,-78,-68,408,"1,368.04",1332
,20180327,3343,3353,3348,3448,3344,3394,3395,41,42,1426,"4,842.06",1150
,20180328,3394,3395,3428,3428,3361,3391,3399,-4,4,206,700.24,1144
,20180329,3391,3399,3397,3439,3382,3439,3418,40,19,540,"1,845.96",1436
,20180330,3439,3418,3450,3517,3433,3517,3483,99,65,578,"2,013.33",1586
,20180402,3517,3483,3515,3575,3507,3513,3527,30,44,134,472.66,1596
,20180403,3513,3527,3514,3560,3510,3510,3526,-17,-1,92,324.44,1580
,20180404,3510,3526,3509,3525,3483,3490,3506,-36,-20,50,175.33,1588
,20180409,3490,3506,3498,3551,3470,3551,3515,45,9,174,611.69,1606
,20180410,3551,3515,3548,3601,3547,3572,3571,57,56,88,314.28,1596
,20180411,3572,3571,3612,3618,3557,3570,3582,-1,11,188,673.55,1544
,20180412,3570,3582,3558,3598,3551,3586,3570,4,-12,122,435.59,1546
,20180413,3586,3570,3569,3628,3560,3604,3604,34,34,436,"1,571.37",1568
,20180416,3604,3604,3619,3627,3573,3587,3602,-17,-2,280,"1,008.84",1594
,20180417,3587,3602,3565,3627,3565,3616,3605,14,3,90,324.49,1608
,20180418,3616,3605,3644,3676,3623,3676,3649,71,44,234,853.90,1650
,20180419,3676,3649,3682,3700,3663,3695,3680,46,31,354,"1,302.82",1648
,20180420,3695,3680,3684,3684,3645,3660,3663,-20,-17,24,87.93,1648
,20180423,3660,3663,3655,3718,3652,3710,3687,47,24,94,346.64,1660
,20180424,3710,3687,3720,3763,3715,3760,3734,73,47,224,836.43,1656
,20180425,3760,3734,3803,3803,3749,3771,3771,37,37,442,"1,667.21",1686
,20180426,3771,3771,3790,3795,3743,3761,3763,-10,-8,248,933.25,1740
,20180427,3761,3763,3784,3799,3763,3774,3773,11,10,170,641.49,1742
,20180502,3774,3773,3872,3908,3835,3907,3876,134,103,560,"2,170.93",1832
,20180503,3907,3876,3918,3927,3885,3906,3914,30,38,566,"2,215.73",1642
,20180504,3906,3914,3900,3920,3879,3899,3898,-15,-16,406,"1,582.91",1720
,20180507,3899,3898,3904,3946,3879,3910,3910,12,12,450,"1,759.63",1686
,20180508,3910,3910,3913,3927,3901,3902,3914,-8,4,44,172.24,1686
,20180509,3902,3914,3900,3900,3842,3842,3878,-72,-36,346,"1,341.85",1720
,20180510,3842,3878,3879,3891,3846,3879,3876,1,-2,96,372.12,1740
,20180511,3879,3876,3896,3927,3869,3910,3888,34,12,358,"1,391.99",1896
,20180514,3910,3888,3920,3929,3896,3900,3914,12,26,192,751.60,1906
,20180515,3900,3914,3921,3937,3887,3913,3911,-1,-3,244,954.36,1874
,20180516,3913,3911,3912,3925,3884,3892,3911,-19,0,366,"1,431.48",1960
,20180517,3892,3911,3884,3917,3883,3906,3899,-5,-12,120,467.98,1962
,20180518,3906,3899,3901,3921,3861,3888,3887,-11,-12,274,"1,065.27",1882
,20180521,3888,3887,3867,3896,3860,3865,3877,-22,-10,124,480.77,1856
,20180522,3865,3877,3878,3878,3853,3853,3868,-24,-9,72,278.55,1842
,20180523,3853,3868,3858,3884,3800,3800,3829,-68,-39,208,796.61,1746
,20180524,3800,3829,3792,3828,3776,3809,3798,-20,-31,242,919.29,1702
,20180525,3809,3798,3834,3847,3806,3812,3834,14,36,366,"1,403.45",1694
,20180528,3812,3834,3798,3850,3792,3812,3826,-22,-8,314,"1,201.65",1644
,20180529,3812,3826,3809,3840,3806,3838,3824,12,-2,514,"1,965.97",1632
,20180530,3838,3824,3856,3925,3850,3917,3897,93,73,382,"1,489.02",1590
,20180531,3917,3897,3893,3987,3893,3949,3947,52,50,208,821.18,1570
rb1808,20180102,3718,3722,3709,3772,3707,3758,3729,36,7,100,372.91,466
,20180103,3758,3729,3761,3761,3713,3713,3731,-16,2,8,29.85,462
,20180104,3713,3731,3713,3727,3702,3724,3714,-7,-17,32,118.87,454
,20180105,3724,3714,3724,3724,3688,3711,3707,-3,-7,54,200.22,458
,20180108,3711,3707,3714,3725,3672,3725,3693,18,-14,124,457.94,456
,20180109,3725,3693,3741,3748,3731,3734,3739,41,46,34,127.13,452
,20180110,3734,3739,3731,3773,3721,3773,3748,34,9,16,59.97,456
,20180111,3773,3748,3780,3785,3751,3758,3766,10,18,138,519.72,434
,20180112,3758,3766,3752,3752,3703,3728,3725,-38,-41,98,365.06,478
,20180115,3728,3725,3712,3715,3692,3712,3700,-13,-25,90,333.02,478
,20180116,3712,3700,3740,3755,3726,3726,3743,26,43,10,37.43,470
,20180117,3726,3743,3748,3753,3714,3732,3736,-11,-7,8,29.89,466
,20180118,3732,3736,3745,3773,3743,3765,3751,29,15,54,202.57,450
,20180119,3765,3751,3774,3799,3766,3786,3779,35,28,64,241.91,436
,20180122,3786,3779,3831,3848,3821,3823,3832,44,53,82,314.24,420
,20180123,3823,3832,3820,3825,3788,3812,3816,-20,-16,68,259.49,418
,20180124,3812,3816,3832,3851,3823,3851,3835,35,19,22,84.38,426
,20180125,3851,3835,3857,3888,3856,3880,3867,45,32,10,38.68,428
,20180126,3880,3867,3866,3866,3857,3859,3860,-8,-7,8,30.88,428
,20180129,3859,3860,,,,3860,3860,0,0,0,0.00,428
,20180130,3860,3860,3859,3862,3850,3851,3856,-9,-4,12,46.28,440
,20180131,3851,3856,3889,3889,3828,3828,3856,-28,0,18,69.41,444
,20180201,3828,3856,3855,3872,3854,3857,3858,1,2,20,77.18,432
,20180202,3857,3858,,,,3858,3858,0,0,0,0.00,432
,20180205,3858,3858,3864,3864,3864,3864,3864,6,6,4,15.46,436
,20180206,3864,3864,3874,3875,3861,3861,3870,-3,6,6,23.22,436
,20180207,3861,3870,3852,3852,3852,3852,3852,-18,-18,2,7.70,436
,20180208,3852,3852,3869,3874,3867,3867,3869,15,17,26,100.61,458
,20180209,3867,3869,3863,3863,3843,3843,3853,-26,-16,4,15.41,460
,20180212,3843,3853,,,,3853,3853,0,0,0,0.00,460
,20180213,3853,3853,3849,3849,3849,3849,3849,-4,-4,2,7.70,460
,20180214,3849,3849,,,,3849,3849,0,0,0,0.00,460
,20180222,3849,3849,3863,3863,3796,3814,3822,-35,-27,58,221.73,498
,20180223,3814,3822,3904,3904,3895,3895,3895,73,73,24,93.50,498
,20180226,3895,3895,3887,3974,3886,3970,3949,75,54,32,126.40,500
,20180227,3970,3949,3964,3964,3937,3949,3950,0,1,44,173.83,470
,20180228,3949,3950,4004,4004,3957,3970,3992,20,42,3670,"14,653.85",2662
,20180301,3970,3992,3969,4003,3942,3960,3972,-32,-20,1052,"4,178.65",1854
,20180302,3960,3972,3944,3964,3936,3945,3947,-27,-25,300,"1,184.16",1860
,20180305,3945,3947,3953,3953,3897,3901,3919,-46,-28,250,979.75,1898
,20180306,3901,3919,3897,3918,3872,3918,3887,-1,-32,136,528.69,1914
,20180307,3918,3887,3920,3922,3857,3857,3878,-30,-9,184,713.57,2010
,20180308,3857,3878,3860,3863,3789,3789,3815,-89,-63,310,"1,182.70",2178
,20180309,3789,3815,3777,3777,3677,3695,3722,-120,-93,112,416.86,2210
,20180312,3695,3722,3710,3718,3671,3685,3702,-37,-20,154,570.18,2228
,20180313,3685,3702,3696,3710,3653,3674,3687,-28,-15,84,309.76,2226
,20180314,3674,3687,3677,3728,3646,3696,3675,9,-12,232,852.71,2328
,20180315,3696,3675,3717,3727,3703,3725,3713,50,38,106,393.59,2320
,20180316,3725,3713,3703,3721,3686,3695,3706,-18,-7,148,548.63,2292
,20180319,3695,3706,3691,3695,3609,3636,3651,-70,-55,200,730.32,2248
,20180320,3636,3651,3618,3629,3573,3613,3608,-38,-43,322,"1,161.84",2070
,20180321,3613,3608,3614,3637,3583,3585,3608,-23,0,190,685.57,2032
,20180322,3585,3608,3588,3621,3563,3593,3590,-15,-18,184,660.60,2032
,20180323,3593,3590,3564,3570,3338,3361,3462,-229,-128,332,"1,149.64",2174
,20180326,3361,3462,3360,3377,3313,3313,3350,-149,-112,280,938.03,2042
,20180327,3313,3350,3322,3424,3322,3391,3376,41,26,486,"1,641.09",1884
,20180328,3391,3376,3410,3424,3354,3387,3391,11,15,296,"1,003.91",1862
,20180329,3387,3391,3374,3437,3371,3434,3403,43,12,188,639.93,1850
,20180330,3434,3403,3448,3532,3426,3532,3487,129,84,398,"1,387.91",1950
,20180402,3532,3487,3527,3598,3511,3512,3531,25,44,472,"1,666.92",1884
,20180403,3512,3531,3518,3547,3503,3510,3522,-21,-9,78,274.75,1868
,20180404,3510,3522,3504,3528,3471,3471,3501,-51,-21,136,476.24,1814
,20180409,3471,3501,3515,3553,3496,3552,3528,51,27,136,479.93,1840
,20180410,3552,3528,3549,3588,3537,3586,3565,58,37,230,820.03,1814
,20180411,3586,3565,3579,3603,3539,3548,3552,-17,-13,184,653.71,1828
,20180412,3548,3552,3540,3567,3530,3567,3538,15,-14,440,"1,556.87",1628
,20180413,3567,3538,3545,3598,3522,3580,3578,42,40,1276,"4,566.25",778
,20180416,3580,3578,3579,3585,3511,3512,3555,-66,-23,414,"1,472.16",580
,20180417,3512,3555,3509,3567,3504,3547,3527,-8,-28,158,557.39,668
,20180418,3547,3527,3565,3613,3540,3586,3578,59,51,314,"1,123.63",576
,20180419,3586,3578,3613,3644,3611,3629,3626,51,48,106,384.41,598
,20180420,3629,3626,3607,3624,3575,3575,3599,-51,-27,66,237.59,586
,20180423,3575,3599,3605,3687,3605,3677,3659,78,60,92,336.64,570
,20180424,3677,3659,3681,3712,3675,3704,3693,45,34,110,406.33,574
,20180425,3704,3693,3705,3718,3683,3706,3701,13,8,48,177.68,566
,20180426,3706,3701,3724,3734,3674,3694,3696,-7,-5,34,125.68,572
,20180427,3694,3696,3699,3723,3686,3702,3704,6,8,30,111.12,576
,20180502,3702,3704,3783,3860,3773,3860,3809,156,105,104,396.19,644
,20180503,3860,3809,3859,3876,3804,3804,3866,-5,57,114,440.80,636
,20180504,3804,3866,3800,3829,3797,3817,3813,-49,-53,132,503.39,622
,20180507,3817,3813,3788,3838,3771,3834,3815,21,2,92,351.04,620
,20180508,3834,3815,3812,3820,3779,3782,3798,-33,-17,82,311.52,632
,20180509,3782,3798,3748,3776,3733,3738,3753,-60,-45,374,"1,403.92",760
,20180510,3738,3753,3733,3769,3733,3755,3754,2,1,162,608.17,756
,20180511,3755,3754,3784,3829,3772,3819,3802,65,48,374,"1,422.23",674
,20180514,3819,3802,3820,3828,3802,3822,3818,20,16,38,145.09,668
,20180515,3822,3818,3856,3860,3788,3835,3825,17,7,106,405.46,666
,20180516,3835,3825,3806,3841,3801,3825,3820,0,-5,68,259.80,678
,20180517,3825,3820,3796,3832,3796,3817,3815,-3,-5,48,183.12,680
,20180518,3817,3815,3823,3840,3775,3780,3811,-35,-4,142,541.28,640
,20180521,3780,3811,3752,3792,3747,3765,3761,-46,-50,100,376.12,612
,20180522,3765,3761,3753,3772,3736,3743,3751,-18,-10,144,540.21,672
,20180523,3743,3751,3733,3749,3704,3704,3722,-47,-29,110,409.46,712
,20180524,3704,3722,3722,3759,3722,3748,3753,26,31,38,142.62,686
,20180525,3748,3753,3788,3790,3744,3753,3762,0,9,46,173.07,692
,20180528,3753,3762,3729,3798,3720,3763,3769,1,7,174,655.81,644
,20180529,3763,3769,3764,3816,3764,3793,3803,24,34,112,425.97,576
,20180530,3793,3803,3823,3823,3780,3813,3808,10,5,184,700.82,696
,20180531,3813,3808,3789,3858,3789,3848,3844,40,36,134,515.20,680
rb1809,20180102,3666,3675,3667,3730,3657,3715,3695,40,20,824,"3,045.00",3882
,20180103,3715,3695,3713,3727,3675,3675,3699,-20,4,840,"3,107.65",3878
,20180104,3675,3699,3673,3699,3671,3693,3684,-6,-15,562,"2,070.86",3968
,20180105,3693,3684,3693,3697,3657,3679,3676,-5,-8,568,"2,088.29",4054
,20180108,3679,3676,3660,3684,3642,3684,3662,8,-14,1124,"4,116.52",4164
,20180109,3684,3662,3689,3710,3682,3699,3697,37,35,822,"3,039.45",4010
,20180110,3699,3697,3704,3747,3688,3731,3712,34,15,940,"3,489.29",4098
,20180111,3731,3712,3738,3748,3704,3721,3729,9,17,916,"3,416.37",4166
,20180112,3721,3729,3723,3725,3679,3689,3695,-40,-34,1044,"3,857.91",4308
,20180115,3689,3695,3684,3715,3671,3706,3694,11,-1,700,"2,586.22",4324
,20180116,3706,3694,3705,3734,3680,3690,3715,-4,21,888,"3,299.06",4404
,20180117,3690,3715,3687,3727,3687,3719,3709,4,-6,636,"2,358.93",4404
,20180118,3719,3709,3719,3737,3700,3721,3718,12,9,504,"1,874.34",4394
,20180119,3721,3718,3715,3783,3715,3783,3733,65,15,1372,"5,121.81",4274
,20180122,3783,3733,3781,3812,3775,3795,3796,62,63,1146,"4,350.52",4620
,20180123,3795,3796,3793,3809,3774,3798,3792,2,-4,1450,"5,498.94",4916
,20180124,3798,3792,3785,3840,3785,3835,3814,43,22,636,"2,426.30",4906
,20180125,3835,3814,3837,3876,3815,3860,3846,46,32,542,"2,084.62",4902
,20180126,3860,3846,3841,3857,3815,3840,3837,-6,-9,288,"1,105.32",4896
,20180129,3840,3837,3838,3854,3822,3845,3841,8,4,450,"1,728.54",4982
,20180130,3845,3841,3839,3843,3816,3828,3826,-13,-15,464,"1,775.69",5104
,20180131,3828,3826,3837,3856,3798,3815,3811,-11,-15,602,"2,294.50",5332
,20180201,3815,3811,3791,3842,3791,3809,3824,-2,13,724,"2,769.20",5118
,20180202,3809,3824,3810,3847,3806,3833,3834,9,10,604,"2,315.85",5052
,20180205,3833,3834,3839,3852,3815,3852,3832,18,-2,912,"3,495.67",4970
,20180206,3852,3832,3854,3879,3832,3844,3852,12,20,454,"1,749.20",5014
,20180207,3844,3852,3830,3855,3825,3838,3841,-14,-11,908,"3,488.20",5458
,20180208,3838,3841,3833,3854,3820,3840,3836,-1,-5,790,"3,030.57",5382
,20180209,3840,3836,3843,3851,3801,3812,3826,-24,-10,680,"2,601.73",5478
,20180212,3812,3826,3808,3830,3796,3817,3817,-9,-9,316,"1,206.21",5408
,20180213,3817,3817,3827,3845,3814,3835,3833,18,16,566,"2,169.76",5244
,20180214,3835,3833,3838,3857,3830,3838,3848,5,15,424,"1,631.68",5210
,20180222,3838,3848,3859,3859,3792,3807,3821,-41,-27,738,"2,820.61",5438
,20180223,3807,3821,3800,3892,3797,3887,3838,66,17,2504,"9,611.79",5224
,20180226,3887,3838,3892,3956,3880,3946,3930,108,92,1634,"6,422.43",5344
,20180227,3946,3930,3950,3955,3910,3931,3928,1,-2,1404,"5,515.45",5456
,20180228,3931,3928,3937,3938,3920,3928,3930,0,2,406,"1,595.70",5534
,20180301,3928,3930,3927,3946,3914,3923,3930,-7,0,648,"2,546.74",5538
,20180302,3923,3930,3909,3926,3898,3926,3909,-4,-21,840,"3,283.84",5602
,20180305,3926,3909,3924,3930,3875,3885,3896,-24,-13,884,"3,444.32",5710
,20180306,3885,3896,3876,3910,3850,3898,3883,2,-13,1248,"4,846.96",6176
,20180307,3898,3883,3905,3910,3849,3854,3875,-29,-8,2226,"8,626.49",6206
,20180308,3854,3875,3849,3857,3788,3790,3815,-85,-60,5572,"21,258.46",8088
,20180309,3790,3815,3788,3830,3655,3685,3727,-130,-88,5242,"19,541.44",8970
,20180312,3685,3727,3704,3726,3653,3678,3693,-49,-34,4616,"17,049.60",9084
,20180313,3678,3693,3680,3693,3650,3651,3674,-42,-19,3216,"11,818.51",9502
,20180314,3651,3674,3662,3703,3628,3679,3661,5,-13,4778,"17,494.48",9732
,20180315,3679,3661,3671,3710,3671,3691,3691,30,30,3032,"11,193.58",9432
,20180316,3691,3691,3688,3688,3653,3664,3668,-27,-23,2504,"9,185.08",9788
,20180319,3664,3668,3652,3665,3570,3571,3607,-97,-61,4124,"14,878.95",10998
,20180320,3571,3607,3578,3579,3501,3551,3542,-56,-65,5070,"17,960.16",11094
,20180321,3551,3542,3568,3569,3519,3523,3546,-19,4,2922,"10,363.90",11156
,20180322,3523,3546,3526,3554,3516,3522,3533,-24,-13,2830,"10,000.71",11330
,20180323,3522,3533,3503,3513,3285,3326,3378,-207,-155,12070,"40,779.30",12604
,20180326,3326,3378,3346,3346,3250,3269,3289,-109,-89,8460,"27,830.64",13840
,20180327,3269,3289,3260,3348,3250,3315,3304,26,15,6506,"21,498.51",13778
,20180328,3315,3304,3323,3356,3272,3297,3321,-7,17,9750,"32,381.88",12868
,20180329,3297,3321,3310,3380,3285,3371,3333,50,12,7036,"23,454.62",12086
,20180330,3371,3333,3401,3474,3360,3474,3404,141,71,8244,"28,068.70",11552
,20180402,3474,3404,3456,3559,3425,3430,3467,26,63,9638,"33,422.47",11324
,20180403,3430,3467,3437,3475,3415,3432,3441,-35,-26,7170,"24,678.45",11044
,20180404,3432,3441,3442,3461,3396,3405,3426,-36,-15,5794,"19,850.52",10778
,20180409,3405,3426,3400,3494,3354,3490,3449,64,23,6504,"22,436.74",10552
,20180410,3490,3449,3495,3529,3473,3502,3492,53,43,11876,"41,471.17",10634
,20180411,3502,3492,3516,3547,3467,3480,3506,-12,14,7808,"27,375.14",10784
,20180412,3480,3506,3466,3519,3452,3490,3479,-16,-27,5664,"19,706.50",10636
,20180413,3490,3479,3484,3552,3463,3540,3505,61,26,6458,"22,638.89",9946
,20180416,3540,3505,3539,3545,3440,3445,3488,-60,-17,9232,"32,205.31",10664
,20180417,3445,3488,3452,3522,3433,3475,3476,-13,-12,8672,"30,152.04",10024
,20180418,3475,3476,3495,3579,3495,3535,3537,59,61,9382,"33,191.91",9974
,20180419,3535,3537,3545,3613,3545,3597,3580,60,43,8962,"32,092.08",9148
,20180420,3597,3580,3598,3598,3524,3538,3558,-42,-22,5698,"20,275.20",8844
,20180423,3538,3558,3550,3635,3535,3623,3592,65,34,6048,"21,730.42",8520
,20180424,3623,3592,3611,3700,3601,3647,3648,55,56,8208,"29,943.80",8664
,20180425,3647,3648,3645,3674,3626,3655,3654,7,6,5400,"19,732.85",8692
,20180426,3655,3654,3659,3695,3621,3641,3648,-13,-6,5166,"18,846.82",9366
,20180427,3641,3648,3641,3678,3636,3675,3657,27,9,7832,"28,641.89",9128
,20180502,3675,3657,3675,3808,3675,3801,3752,144,95,7512,"28,186.76",9356
,20180503,3801,3752,3800,3813,3740,3758,3781,6,29,6336,"23,959.79",9394
,20180504,3758,3781,3753,3774,3728,3756,3750,-25,-31,3882,"14,560.76",9290
,20180507,3756,3750,3743,3771,3701,3744,3736,-6,-14,5552,"20,745.43",8840
,20180508,3744,3736,3744,3755,3721,3721,3737,-15,1,3426,"12,804.03",8852
,20180509,3721,3737,3719,3722,3654,3663,3686,-74,-51,11360,"41,877.39",9070
,20180510,3663,3686,3672,3699,3664,3692,3678,6,-8,6044,"22,235.29",8572
,20180511,3692,3678,3705,3763,3701,3759,3732,81,54,6490,"24,221.15",8246
,20180514,3759,3732,3770,3770,3740,3754,3754,22,22,2368,"8,890.40",8198
,20180515,3754,3754,3758,3795,3727,3764,3762,10,8,6536,"24,591.73",7496
,20180516,3764,3762,3760,3789,3724,3758,3757,-4,-5,4456,"16,742.39",7132
,20180517,3758,3757,3758,3769,3743,3758,3757,1,0,2680,"10,069.67",7190
,20180518,3758,3757,3775,3786,3705,3718,3737,-39,-20,5698,"21,298.10",7186
,20180521,3718,3737,3707,3732,3666,3673,3699,-64,-38,6964,"25,763.72",6292
,20180522,3673,3699,3668,3695,3643,3663,3666,-36,-33,3260,"11,953.04",6562
,20180523,3663,3666,3664,3665,3602,3610,3635,-56,-31,5208,"18,932.98",7054
,20180524,3610,3635,3603,3678,3603,3675,3641,40,6,4804,"17,492.54",7028
,20180525,3675,3641,3675,3701,3636,3660,3679,19,38,6544,"24,078.21",6590
,20180528,3660,3679,3650,3710,3629,3672,3669,-7,-10,6984,"25,628.36",6136
,20180529,3672,3669,3669,3730,3662,3724,3703,55,34,4918,"18,212.69",5314
,20180530,3724,3703,3726,3745,3698,3728,3724,25,21,3422,"12,744.50",5106
,20180531,3728,3724,3726,3763,3712,3763,3739,39,15,3736,"13,971.15",4890
rb1810,20180102,3609,3618,3610,3674,3606,3663,3638,45,20,141180,"513,729.76",298196
,20180103,3663,3638,3662,3664,3614,3619,3639,-19,1,134752,"490,401.71",305060
,20180104,3619,3639,3619,3645,3612,3638,3626,-1,-13,130526,"473,406.43",304188
,20180105,3638,3626,3637,3643,3599,3625,3617,-1,-9,132496,"479,361.70",330908
,20180108,3625,3617,3623,3633,3583,3631,3606,14,-11,168406,"607,382.73",342724
,20180109,3631,3606,3636,3657,3629,3647,3643,41,37,139638,"508,720.70",336396
,20180110,3647,3643,3655,3685,3632,3671,3661,28,18,162878,"596,376.12",330868
,20180111,3671,3661,3678,3691,3646,3658,3670,-3,9,137280,"503,946.94",330082
,20180112,3658,3670,3662,3672,3621,3631,3641,-39,-29,132592,"482,799.50",339018
,20180115,3631,3641,3623,3668,3601,3657,3641,16,0,202078,"735,837.27",347052
,20180116,3657,3641,3660,3680,3636,3642,3660,1,19,141174,"516,697.45",331496
,20180117,3642,3660,3642,3675,3638,3658,3654,-2,-6,139974,"511,557.92",330788
,20180118,3658,3654,3657,3680,3642,3671,3664,17,10,143694,"526,620.61",339330
,20180119,3671,3664,3675,3728,3665,3728,3688,64,24,171234,"631,533.90",344004
,20180122,3728,3688,3730,3758,3721,3741,3739,53,51,168814,"631,203.25",349226
,20180123,3741,3739,3741,3759,3715,3745,3736,6,-3,243412,"909,510.14",328692
,20180124,3745,3736,3737,3793,3730,3780,3761,44,25,154434,"580,921.08",334978
,20180125,3780,3761,3781,3823,3757,3798,3789,37,28,172022,"651,946.58",328632
,20180126,3798,3789,3800,3806,3761,3785,3783,-4,-6,111450,"421,669.97",325066
,20180129,3785,3783,3780,3800,3767,3793,3785,10,2,93170,"352,734.59",328496
,20180130,3793,3785,3794,3794,3759,3773,3773,-12,-12,110196,"415,873.15",348106
,20180131,3773,3773,3775,3817,3741,3759,3765,-14,-8,126598,"476,741.27",346300
,20180201,3759,3765,3759,3791,3751,3752,3767,-13,2,178052,"670,767.01",371006
,20180202,3752,3767,3747,3797,3737,3784,3775,17,8,106326,"401,382.09",366420
,20180205,3784,3775,3780,3803,3758,3800,3778,25,3,112552,"425,276.25",363606
,20180206,3800,3778,3805,3826,3775,3782,3799,4,21,182120,"691,957.01",367234
,20180207,3782,3799,3780,3799,3767,3779,3782,-20,-17,98314,"371,898.49",366684
,20180208,3779,3782,3775,3804,3763,3790,3784,8,2,163160,"617,462.84",389038
,20180209,3790,3784,3791,3800,3749,3756,3775,-28,-9,158178,"597,155.27",386814
,20180212,3756,3775,3755,3779,3742,3766,3762,-9,-13,90782,"341,581.41",386076
,20180213,3766,3762,3770,3796,3761,3782,3781,20,19,76418,"288,946.35",379990
,20180214,3782,3781,3784,3808,3778,3795,3796,14,15,71306,"270,687.50",375394
,20180222,3795,3796,3798,3810,3738,3753,3766,-43,-30,157236,"592,151.04",398858
,20180223,3753,3766,3740,3849,3737,3845,3794,79,28,296260,"1,124,181.73",462836
,20180226,3845,3794,3842,3912,3831,3900,3878,106,84,243978,"946,234.09",456438
,20180227,3900,3878,3902,3910,3857,3883,3878,5,0,197222,"765,002.44",449604
,20180228,3883,3878,3882,3891,3868,3872,3877,-6,-1,123550,"479,045.87",446728
,20180301,3872,3877,3868,3896,3862,3870,3877,-7,0,179268,"695,071.04",429858
,20180302,3870,3877,3860,3880,3843,3880,3858,3,-19,176936,"682,725.71",446464
,20180305,3880,3858,3879,3883,3822,3826,3843,-32,-15,229798,"883,121.02",468814
,20180306,3826,3843,3823,3858,3798,3841,3830,-2,-13,284604,"1,090,132.20",507400
,20180307,3841,3830,3852,3862,3805,3806,3832,-24,2,405874,"1,555,446.99",571786
,20180308,3806,3832,3800,3811,3746,3746,3777,-86,-55,631348,"2,384,766.32",781948
,20180309,3746,3777,3735,3746,3621,3643,3688,-134,-89,791624,"2,920,004.28",867790
,20180312,3643,3688,3670,3684,3610,3622,3646,-66,-42,613830,"2,238,252.11",951832
,20180313,3622,3646,3622,3640,3598,3602,3620,-44,-26,462690,"1,675,136.03",1020410
,20180314,3602,3620,3599,3643,3570,3621,3604,1,-16,709976,"2,559,193.70",1059966
,20180315,3621,3604,3630,3650,3603,3621,3622,17,18,658194,"2,384,333.40",1140534
,20180316,3621,3622,3614,3620,3577,3583,3594,-39,-28,691634,"2,486,041.83",1266380
,20180319,3583,3594,3581,3597,3486,3491,3529,-103,-65,949596,"3,351,759.06",1433160
,20180320,3491,3529,3485,3497,3412,3469,3459,-60,-70,1177052,"4,071,797.38",1563558
,20180321,3469,3459,3460,3484,3431,3432,3460,-27,1,1010570,"3,496,654.15",1607168
,20180322,3432,3460,3435,3470,3432,3441,3448,-19,-12,945942,"3,262,475.37",1664990
,20180323,3441,3448,3426,3426,3206,3252,3292,-196,-156,3043168,"10,021,063.75",1681896
,20180326,3252,3292,3253,3262,3163,3184,3202,-108,-90,2077768,"6,654,987.13",1928918
,20180327,3184,3202,3175,3255,3173,3228,3216,26,14,1935804,"6,227,044.12",2012074
,20180328,3228,3216,3239,3276,3187,3212,3236,-4,20,2592142,"8,388,859.84",1936094
,20180329,3212,3236,3218,3295,3195,3289,3248,53,12,3252386,"10,565,731.43",2081700
,20180330,3289,3248,3296,3393,3273,3391,3323,143,75,3903414,"12,971,679.68",2279344
,20180402,3391,3323,3386,3480,3335,3344,3381,21,58,4829256,"16,330,188.92",2321024
,20180403,3344,3381,3351,3393,3326,3354,3356,-27,-25,4646490,"15,597,988.24",2405478
,20180404,3354,3356,3358,3379,3305,3318,3343,-38,-13,4320168,"14,443,567.69",2488046
,20180409,3318,3343,3318,3415,3310,3408,3362,65,19,4219576,"14,188,238.36",2687440
,20180410,3408,3362,3415,3448,3394,3419,3419,57,57,4461648,"15,258,696.53",2794184
,20180411,3419,3419,3430,3467,3386,3395,3421,-24,2,5117786,"17,512,492.83",2774720
,20180412,3395,3421,3393,3438,3372,3402,3397,-19,-24,4996770,"16,975,842.14",2799314
,20180413,3402,3397,3400,3473,3377,3452,3422,55,25,5542606,"18,971,271.85",2957458
,20180416,3452,3422,3450,3462,3353,3357,3403,-65,-19,5051502,"17,192,967.75",2864790
,20180417,3357,3403,3361,3437,3344,3384,3389,-19,-14,5717310,"19,379,934.04",2927264
,20180418,3384,3389,3411,3496,3410,3446,3447,57,58,6277210,"21,642,368.32",2901930
,20180419,3446,3447,3477,3529,3463,3516,3493,69,46,6220952,"21,729,991.12",2841970
,20180420,3516,3493,3505,3510,3442,3454,3475,-39,-18,4660282,"16,196,057.62",2853460
,20180423,3454,3475,3455,3555,3450,3544,3510,69,35,4872116,"17,103,374.18",2818162
,20180424,3544,3510,3536,3589,3522,3562,3564,52,54,3992888,"14,231,736.07",2864466
,20180425,3562,3564,3570,3594,3540,3573,3569,9,5,4221012,"15,068,022.27",2947476
,20180426,3573,3569,3578,3613,3536,3558,3565,-11,-4,4795470,"17,096,661.75",2955976
,20180427,3558,3565,3551,3600,3548,3593,3574,28,9,4499726,"16,085,697.62",2898548
,20180502,3593,3574,3640,3729,3634,3727,3677,153,103,4114388,"15,132,268.73",3234126
,20180503,3727,3677,3729,3733,3655,3673,3695,-4,18,4217694,"15,588,374.89",3055156
,20180504,3673,3695,3668,3688,3642,3664,3663,-31,-32,3693968,"13,533,219.56",2999864
,20180507,3664,3663,3663,3690,3616,3657,3654,-6,-9,4811508,"17,582,698.28",2944954
,20180508,3657,3654,3657,3672,3634,3637,3651,-17,-3,3148852,"11,499,168.07",2972300
,20180509,3637,3651,3626,3630,3563,3571,3596,-80,-55,4787862,"17,221,902.06",3161058
,20180510,3571,3596,3577,3618,3575,3615,3593,19,-3,3814674,"13,707,189.40",3097422
,20180511,3615,3593,3628,3686,3620,3675,3650,82,57,3980122,"14,529,905.07",3044550
,20180514,3675,3650,3690,3695,3652,3667,3672,17,22,3163110,"11,617,505.10",2976578
,20180515,3667,3672,3673,3715,3636,3681,3677,9,5,5015452,"18,445,095.11",2928956
,20180516,3681,3677,3682,3705,3641,3677,3674,0,-3,4263970,"15,666,019.69",2844188
,20180517,3677,3674,3677,3688,3658,3679,3674,5,0,2893558,"10,631,001.60",2923310
,20180518,3679,3674,3685,3705,3619,3631,3655,-43,-19,4186806,"15,305,317.28",3039540
,20180521,3631,3655,3626,3651,3582,3589,3614,-66,-41,3846112,"13,902,758.59",3112692
,20180522,3589,3614,3586,3614,3556,3573,3582,-41,-32,3540894,"12,684,569.16",3127742
,20180523,3573,3582,3575,3579,3511,3531,3541,-51,-41,3394370,"12,021,950.74",3138232
,20180524,3531,3541,3530,3590,3520,3583,3548,42,7,3251118,"11,535,506.98",3111164
,20180525,3583,3548,3580,3615,3542,3565,3584,17,36,3675128,"13,173,381.37",3058798
,20180528,3565,3584,3560,3626,3540,3579,3584,-5,0,3738744,"13,401,485.89",3073260
,20180529,3579,3584,3581,3650,3570,3635,3611,51,27,3950374,"14,265,805.98",3028136
,20180530,3635,3611,3642,3667,3614,3644,3642,33,31,3500508,"12,751,453.74",3022838
,20180531,3644,3642,3639,3697,3634,3696,3671,54,29,3065394,"11,253,259.90",3151666
rb1811,20180102,3568,3570,3564,3623,3564,3615,3595,45,25,150,539.32,3264
,20180103,3615,3595,3612,3615,3572,3572,3600,-23,5,258,928.81,3266
,20180104,3572,3600,3580,3595,3570,3586,3582,-14,-18,242,866.88,3382
,20180105,3586,3582,3593,3594,3559,3578,3571,-4,-11,220,785.84,3434
,20180108,3578,3571,3575,3585,3548,3584,3566,13,-5,214,763.14,3428
,20180109,3584,3566,3588,3611,3584,3604,3599,38,33,232,835.04,3322
,20180110,3604,3599,3613,3636,3593,3626,3621,27,22,216,782.18,3198
,20180111,3626,3621,3630,3644,3604,3612,3627,-9,6,250,906.83,3200
,20180112,3612,3627,3620,3623,3581,3588,3598,-39,-29,198,712.52,3302
,20180115,3588,3598,3590,3624,3575,3618,3606,20,8,196,706.93,3232
,20180116,3618,3606,3611,3637,3602,3602,3618,-4,12,96,347.42,3188
,20180117,3602,3618,3610,3626,3599,3626,3612,8,-6,92,332.33,3154
,20180118,3626,3612,3617,3639,3601,3623,3625,11,13,204,739.66,2988
,20180119,3623,3625,3630,3686,3623,3673,3638,48,13,212,771.30,2814
,20180122,3673,3638,3678,3704,3671,3685,3679,47,41,852,"3,135.20",2686
,20180123,3685,3679,3680,3708,3667,3691,3685,12,6,180,663.40,2676
,20180124,3691,3685,3696,3738,3694,3736,3703,51,18,190,703.64,2568
,20180125,3736,3703,3724,3770,3710,3767,3734,64,31,172,642.38,2596
,20180126,3767,3734,3753,3755,3717,3732,3736,-2,2,54,201.76,2610
,20180129,3732,3736,3746,3748,3722,3743,3743,7,7,56,209.63,2608
,20180130,3743,3743,3746,3746,3715,3715,3727,-28,-16,20,74.55,2604
,20180131,3715,3727,3737,3737,3700,3712,3714,-15,-13,98,364.00,2594
,20180201,3712,3714,3726,3743,3708,3708,3718,-6,4,132,490.90,2630
,20180202,3708,3718,3703,3747,3701,3738,3727,20,9,126,469.63,2606
,20180205,3738,3727,3727,3755,3727,3755,3748,28,21,80,299.86,2544
,20180206,3755,3748,3748,3777,3734,3734,3757,-14,9,122,458.43,2522
,20180207,3734,3757,3730,3752,3727,3730,3733,-27,-24,72,268.84,2550
,20180208,3730,3733,3727,3753,3724,3743,3741,10,8,70,261.90,2540
,20180209,3743,3741,3743,3752,3708,3719,3728,-22,-13,116,432.46,2578
,20180212,3719,3728,3717,3736,3717,3723,3726,-5,-2,92,342.84,2512
,20180213,3723,3726,3736,3751,3722,3740,3735,14,9,112,418.32,2488
,20180214,3740,3735,3738,3758,3738,3756,3753,21,18,28,105.11,2462
,20180222,3756,3753,3755,3755,3712,3722,3728,-31,-25,8,29.82,2468
,20180223,3722,3728,3706,3800,3706,3791,3770,63,42,78,294.09,2410
,20180226,3791,3770,3790,3859,3790,3858,3837,88,67,160,614.04,2354
,20180227,3858,3837,3825,3843,3825,3843,3831,6,-6,30,114.93,2364
,20180228,3843,3831,,,,3831,3831,0,0,0,0.00,2364
,20180301,3831,3831,3846,3853,3824,3832,3839,1,8,112,430.00,2366
,20180302,3832,3839,3825,3830,3808,3828,3825,-11,-14,48,183.62,2380
,20180305,3828,3825,3816,3817,3787,3787,3807,-38,-18,92,350.25,2366
,20180306,3787,3807,3767,3815,3757,3810,3780,3,-27,72,272.20,2380
,20180307,3810,3780,3812,3812,3775,3786,3796,6,16,46,174.66,2384
,20180308,3786,3796,3756,3773,3730,3730,3747,-66,-49,46,172.38,2406
,20180309,3730,3747,3716,3719,3600,3621,3670,-126,-77,154,565.25,2464
,20180312,3621,3670,3634,3650,3598,3608,3622,-62,-48,56,202.88,2468
,20180313,3608,3622,3607,3607,3565,3574,3594,-48,-28,50,179.71,2478
,20180314,3574,3594,3584,3605,3549,3599,3567,5,-27,110,392.47,2504
,20180315,3599,3567,3606,3618,3586,3589,3593,22,26,42,150.94,2496
,20180316,3589,3593,3565,3574,3550,3550,3565,-43,-28,40,142.64,2482
,20180319,3550,3565,3538,3553,3383,3475,3469,-90,-96,196,679.98,2516
,20180320,3475,3469,3463,3464,3389,3449,3423,-20,-46,170,582.05,2510
,20180321,3449,3423,3439,3447,3403,3407,3433,-16,10,90,309.04,2490
,20180322,3407,3433,3396,3428,3396,3413,3416,-20,-17,60,205.01,2504
,20180323,3413,3416,3391,3391,3176,3203,3249,-213,-167,380,"1,234.64",2670
,20180326,3203,3249,3203,3228,3140,3150,3188,-99,-61,88,280.56,2628
,20180327,3150,3188,3164,3222,3163,3203,3191,15,3,90,287.20,2602
,20180328,3203,3191,3223,3223,3181,3181,3215,-10,24,98,315.09,2564
,20180329,3181,3215,3188,3262,3188,3262,3229,47,14,60,193.74,2556
,20180330,3262,3229,3267,3356,3240,3341,3273,112,44,72,235.70,2516
,20180402,3341,3273,3360,3390,3301,3301,3357,28,84,48,161.16,2508
,20180403,3301,3357,3322,3338,3300,3302,3315,-55,-42,38,126.01,2514
,20180404,3302,3315,3312,3338,3276,3276,3311,-39,-4,120,397.34,2518
,20180409,3276,3311,3322,3372,3288,3366,3325,55,14,140,465.59,2486
,20180410,3366,3325,3376,3406,3372,3384,3390,59,65,180,610.21,2462
,20180411,3384,3390,3389,3425,3354,3369,3391,-21,1,96,325.57,2472
,20180412,3369,3391,3357,3390,3356,3380,3376,-11,-15,58,195.81,2488
,20180413,3380,3376,3358,3437,3345,3425,3382,49,6,210,710.43,2466
,20180416,3425,3382,3417,3422,3328,3334,3385,-48,3,170,575.50,2430
,20180417,3334,3385,3334,3388,3305,3362,3344,-23,-41,444,"1,484.80",2368
,20180418,3362,3344,3379,3449,3376,3397,3406,53,62,240,817.45,2300
,20180419,3397,3406,3427,3490,3427,3478,3466,72,60,250,866.62,2276
,20180420,3478,3466,3462,3472,3401,3410,3447,-56,-19,314,"1,082.60",2330
,20180423,3410,3447,3437,3511,3426,3497,3482,50,35,554,"1,929.48",2230
,20180424,3497,3482,3500,3551,3500,3533,3523,51,41,548,"1,930.81",2198
,20180425,3533,3523,3548,3552,3521,3540,3539,17,16,236,835.23,2134
,20180426,3540,3539,3543,3579,3513,3527,3548,-12,9,172,610.30,2180
,20180427,3527,3548,3529,3558,3515,3550,3540,2,-8,970,"3,434.51",2076
,20180502,3550,3540,3616,3692,3612,3692,3648,152,108,68,248.09,2060
,20180503,3692,3648,3696,3696,3620,3627,3664,-21,16,36,131.91,2072
,20180504,3627,3664,3634,3649,3612,3619,3636,-45,-28,100,363.63,2074
,20180507,3619,3636,3585,3655,3585,3632,3616,-4,-20,42,151.90,2082
,20180508,3632,3616,3612,3621,3604,3604,3619,-12,3,70,253.36,2012
,20180509,3604,3619,3566,3584,3542,3542,3567,-77,-52,258,920.50,2014
,20180510,3542,3567,3552,3585,3552,3585,3565,18,-2,78,278.10,2012
,20180511,3585,3565,3612,3650,3604,3650,3632,85,67,130,472.20,2000
,20180514,3650,3632,3645,3650,3631,3650,3640,18,8,38,138.35,2000
,20180515,3650,3640,3654,3681,3611,3667,3657,27,17,74,270.67,2000
,20180516,3667,3657,3653,3703,3620,3637,3652,-20,-5,274,"1,000.79",2088
,20180517,3637,3652,3638,3659,3637,3653,3645,1,-7,66,240.59,2082
,20180518,3653,3645,3661,3672,3600,3611,3636,-34,-9,74,269.09,2090
,20180521,3611,3636,3591,3615,3557,3575,3579,-61,-57,52,186.11,2110
,20180522,3575,3579,3571,3580,3537,3555,3562,-24,-17,104,370.53,2106
,20180523,3555,3562,3551,3556,3498,3504,3534,-58,-28,94,332.22,2142
,20180524,3504,3534,3500,3762,3438,3438,3546,-96,12,162,574.47,2180
,20180525,3438,3546,3500,3590,3500,3536,3542,-10,-4,146,517.27,2186
,20180528,3536,3542,3524,3597,3501,3552,3550,10,8,458,"1,626.03",2182
,20180529,3552,3550,3553,3615,3538,3595,3599,45,49,828,"2,980.72",2038
,20180530,3595,3599,3621,3629,3592,3624,3614,25,15,260,939.87,2028
,20180531,3624,3614,3614,3662,3614,3661,3646,47,32,144,525.10,2026
rb1812,20180102,3552,3569,3578,3616,3570,3611,3590,42,21,124,445.27,450
,20180103,3611,3590,3606,3611,3568,3575,3593,-15,3,190,682.84,522
,20180104,3575,3593,3571,3593,3568,3584,3578,-9,-15,110,393.64,560
,20180105,3584,3578,3595,3595,3552,3567,3575,-11,-3,78,278.87,564
,20180108,3567,3575,3556,3585,3541,3585,3563,10,-12,206,734.18,698
,20180109,3585,3563,3583,3599,3580,3599,3589,36,26,200,717.98,642
,20180110,3599,3589,3600,3624,3581,3605,3602,16,13,198,713.30,580
,20180111,3605,3602,3618,3622,3582,3594,3602,-8,0,160,576.38,636
,20180112,3594,3602,3615,3615,3575,3578,3586,-24,-16,192,688.63,682
,20180115,3578,3586,3577,3606,3570,3602,3586,16,0,202,724.43,686
,20180116,3602,3586,3595,3620,3585,3589,3601,3,15,110,396.14,654
,20180117,3589,3601,3599,3612,3583,3605,3600,4,-1,96,345.66,656
,20180118,3605,3600,3605,3618,3592,3611,3605,11,5,124,447.04,640
,20180119,3611,3605,3611,3649,3602,3645,3618,40,13,124,448.67,578
,20180122,3645,3618,3640,3674,3640,3655,3654,37,36,124,453.21,546
,20180123,3655,3654,3644,3678,3643,3664,3659,10,5,118,431.85,510
,20180124,3664,3659,3653,3707,3653,3704,3683,45,24,294,"1,082.84",464
,20180125,3704,3683,3690,3733,3690,3726,3718,43,35,68,252.89,458
,20180126,3726,3718,3723,3737,3710,3719,3721,1,3,46,171.19,462
,20180129,3719,3721,3712,3730,3706,3718,3724,-3,3,34,126.62,452
,20180130,3718,3724,3713,3718,3697,3697,3708,-27,-16,24,89.01,454
,20180131,3697,3708,3713,3730,3685,3685,3700,-23,-8,54,199.83,452
,20180201,3685,3700,3704,3715,3695,3695,3702,-5,2,46,170.30,452
,20180202,3695,3702,3687,3718,3687,3718,3701,16,-1,6,22.21,450
,20180205,3718,3701,3705,3720,3681,3720,3709,19,8,164,608.33,446
,20180206,3720,3709,3734,3743,3715,3715,3724,6,15,68,253.28,452
,20180207,3715,3724,3711,3722,3705,3717,3712,-7,-12,32,118.80,460
,20180208,3717,3712,3712,3730,3708,3720,3719,8,7,42,156.23,460
,20180209,3720,3719,3720,3731,3700,3704,3714,-15,-5,62,230.29,494
,20180212,3704,3714,3706,3713,3706,3713,3709,-1,-5,10,37.09,492
,20180213,3713,3709,3721,3725,3706,3725,3719,16,10,24,89.27,478
,20180214,3725,3719,3725,3743,3725,3732,3733,13,14,14,52.26,476
,20180222,3732,3733,3730,3730,3708,3708,3723,-25,-10,16,59.57,478
,20180223,3708,3723,3702,3777,3697,3777,3744,54,21,42,157.26,474
,20180226,3777,3744,3780,3835,3780,3816,3814,72,70,36,137.32,484
,20180227,3816,3814,3817,3830,3805,3830,3816,16,2,76,290.06,480
,20180228,3830,3816,3809,3820,3806,3807,3809,-9,-7,28,106.67,478
,20180301,3807,3809,3825,3826,3806,3806,3819,-3,10,12,45.83,474
,20180302,3806,3819,3801,3806,3791,3806,3801,-13,-18,26,98.83,472
,20180305,3806,3801,3804,3811,3770,3785,3804,-16,3,68,258.74,476
,20180306,3785,3804,3761,3785,3745,3785,3762,-19,-42,14,52.67,478
,20180307,3785,3762,3794,3799,3757,3757,3786,-5,24,60,227.20,476
,20180308,3757,3786,3744,3750,3713,3729,3733,-57,-53,24,89.61,482
,20180309,3729,3733,3693,3698,3615,3634,3660,-99,-73,44,161.07,500
,20180312,3634,3660,3634,3639,3589,3602,3616,-58,-44,56,202.54,508
,20180313,3602,3616,3581,3609,3578,3578,3584,-38,-32,116,415.75,546
,20180314,3578,3584,3575,3602,3552,3585,3569,1,-15,64,228.45,558
,20180315,3585,3569,3595,3601,3567,3580,3584,11,15,96,344.07,542
,20180316,3580,3584,3575,3575,3545,3545,3564,-39,-20,28,99.80,558
,20180319,3545,3564,3535,3535,3469,3469,3497,-95,-67,62,216.83,582
,20180320,3469,3497,3400,3440,3399,3440,3411,-57,-86,42,143.30,596
,20180321,3440,3411,3427,3440,3398,3398,3421,-13,10,108,369.55,614
,20180322,3398,3421,3398,3420,3398,3405,3406,-16,-15,56,190.75,614
,20180323,3405,3406,3386,3387,3167,3232,3287,-174,-119,232,762.66,688
,20180326,3232,3287,3217,3218,3137,3152,3168,-135,-119,96,304.17,658
,20180327,3152,3168,3157,3208,3157,3191,3179,23,11,62,197.10,656
,20180328,3191,3179,3208,3231,3166,3173,3197,-6,18,160,511.66,660
,20180329,3173,3197,3170,3244,3168,3244,3204,47,7,74,237.11,632
,20180330,3244,3204,3277,3334,3237,3334,3280,130,76,78,255.85,622
,20180402,3334,3280,3350,3388,3284,3289,3326,9,46,104,346.00,640
,20180403,3289,3326,3287,3318,3277,3279,3295,-47,-31,88,289.99,642
,20180404,3279,3295,3274,3297,3251,3251,3268,-44,-27,52,169.98,654
,20180409,3251,3268,3263,3354,3263,3353,3296,85,28,82,270.28,642
,20180410,3353,3296,3339,3368,3337,3344,3352,48,56,90,301.70,626
,20180411,3344,3352,3362,3383,3328,3355,3360,3,8,54,181.46,628
,20180412,3355,3360,3333,3342,3313,3322,3329,-38,-31,52,173.13,640
,20180413,3322,3329,3348,3402,3348,3395,3376,66,47,66,222.82,628
,20180416,3395,3376,3340,3340,3301,3308,3314,-68,-62,24,79.54,638
,20180417,3308,3314,3285,3362,3260,3325,3325,11,11,118,392.37,630
,20180418,3325,3325,3352,3410,3352,3377,3378,52,53,132,445.90,610
,20180419,3377,3378,3401,3460,3401,3444,3428,66,50,108,370.27,624
,20180420,3444,3428,3431,3439,3392,3396,3417,-32,-11,108,369.13,656
,20180423,3396,3417,3423,3479,3419,3473,3452,56,35,62,214.05,634
,20180424,3473,3452,3463,3506,3463,3493,3485,41,33,94,327.62,628
,20180425,3493,3485,3498,3504,3476,3504,3494,19,9,20,69.88,630
,20180426,3504,3494,3508,3512,3467,3487,3485,-7,-9,76,264.88,654
,20180427,3487,3485,3488,3507,3486,3504,3497,19,12,86,300.80,580
,20180502,3504,3497,3570,3620,3543,3616,3581,119,84,112,401.17,560
,20180503,3616,3581,3612,3637,3584,3584,3619,3,38,82,296.82,544
,20180504,3584,3619,3581,3598,3563,3592,3584,-27,-35,82,293.92,576
,20180507,3592,3584,3570,3608,3548,3608,3564,24,-20,130,463.42,572
,20180508,3608,3564,3590,3605,3573,3573,3581,9,17,220,787.85,608
,20180509,3573,3581,3545,3548,3487,3497,3510,-84,-71,88,308.95,578
,20180510,3497,3510,3512,3531,3508,3520,3516,10,6,48,168.81,568
,20180511,3520,3516,3551,3601,3548,3590,3582,74,66,66,236.44,568
,20180514,3590,3582,3593,3594,3574,3577,3582,-5,0,18,64.48,570
,20180515,3577,3582,3607,3607,3558,3598,3585,16,3,24,86.05,564
,20180516,3598,3585,3579,3616,3576,3597,3591,12,6,26,93.38,562
,20180517,3597,3591,3588,3603,3584,3589,3593,-2,2,18,64.68,558
,20180518,3589,3593,3612,3612,3545,3545,3579,-48,-14,38,136.01,548
,20180521,3545,3579,3543,3564,3513,3517,3536,-62,-43,64,226.36,552
,20180522,3517,3536,3529,3545,3490,3516,3516,-20,-20,28,98.46,546
,20180523,3516,3516,3502,3505,3450,3471,3476,-45,-40,54,187.71,534
,20180524,3471,3476,3465,3511,3458,3511,3473,35,-3,42,145.88,516
,20180525,3511,3473,3527,3543,3485,3485,3515,12,42,30,105.48,512
,20180528,3485,3515,3495,3542,3495,3522,3512,7,-3,24,84.29,510
,20180529,3522,3512,3520,3572,3509,3572,3541,60,29,62,219.54,480
,20180530,3572,3541,3574,3580,3550,3565,3571,24,30,108,385.72,554
,20180531,3565,3571,3560,3581,3555,3565,3566,-6,-5,34,121.26,558
rb1901,20180116,3586,3586,3588,3619,3567,3570,3590,-16,4,10416,"37,395.11",8068
,20180117,3570,3590,3557,3592,3557,3578,3579,-12,-11,3898,"13,954.43",9042
,20180118,3578,3579,3580,3594,3566,3583,3582,4,3,5186,"18,576.53",10176
,20180119,3583,3582,3594,3600,3573,3599,3588,17,6,11478,"41,187.76",14494
,20180122,3599,3588,3600,3626,3599,3616,3612,28,24,10756,"38,860.50",16658
,20180123,3616,3612,3619,3649,3609,3641,3622,29,10,10410,"37,714.49",19210
,20180124,3641,3622,3640,3684,3635,3675,3655,53,33,11024,"40,301.99",22026
,20180125,3675,3655,3711,3820,3663,3707,3695,52,40,12822,"47,385.59",23558
,20180126,3707,3695,3709,3713,3671,3694,3693,-1,-2,7428,"27,433.61",24784
,20180129,3694,3693,3692,3705,3680,3691,3692,-2,-1,6196,"22,879.30",25454
,20180130,3691,3692,3686,3694,3669,3677,3679,-15,-13,6442,"23,702.94",27816
,20180131,3677,3679,3684,3716,3656,3666,3671,-13,-8,7624,"27,993.08",28702
,20180201,3666,3671,3674,3695,3665,3669,3677,-2,6,6514,"23,955.80",29132
,20180202,3669,3677,3668,3697,3653,3685,3682,8,5,5400,"19,885.68",28266
,20180205,3685,3682,3688,3704,3670,3703,3686,21,4,5672,"20,911.24",28028
,20180206,3703,3686,3706,3726,3690,3698,3706,12,20,8446,"31,301.11",27736
,20180207,3698,3706,3691,3710,3685,3690,3695,-16,-11,4290,"15,851.96",28356
,20180208,3690,3695,3688,3711,3687,3700,3698,5,3,9468,"35,020.33",30576
,20180209,3700,3698,3700,3711,3681,3684,3695,-14,-3,10774,"39,814.09",34470
,20180212,3684,3695,3683,3701,3677,3694,3689,-1,-6,5118,"18,885.31",33800
,20180213,3694,3689,3691,3719,3688,3705,3707,16,18,5800,"21,502.05",33068
,20180214,3705,3707,3711,3728,3703,3714,3717,7,10,3998,"14,862.26",32134
,20180222,3714,3717,3710,3721,3666,3680,3689,-37,-28,9674,"35,692.05",36244
,20180223,3680,3689,3669,3754,3668,3749,3706,60,17,13134,"48,679.74",37052
,20180226,3749,3706,3750,3815,3743,3801,3784,95,78,13046,"49,377.64",38894
,20180227,3801,3784,3801,3803,3774,3792,3790,8,6,8080,"30,626.84",39672
,20180228,3792,3790,3791,3797,3780,3781,3786,-9,-4,8828,"33,424.99",42812
,20180301,3781,3786,3780,3800,3772,3783,3787,-3,1,8870,"33,594.65",42878
,20180302,3783,3787,3781,3790,3765,3790,3774,3,-13,8178,"30,868.56",44210
,20180305,3790,3774,3792,3794,3746,3754,3764,-20,-10,14506,"54,610.36",49672
,20180306,3754,3764,3759,3776,3730,3766,3749,2,-15,15614,"58,544.99",54400
,20180307,3766,3749,3775,3779,3732,3738,3748,-11,-1,21386,"80,160.12",58906
,20180308,3738,3748,3735,3736,3683,3683,3708,-65,-40,22198,"82,320.77",65390
,20180309,3683,3708,3679,3683,3572,3588,3629,-120,-79,26806,"97,293.83",69844
,20180312,3588,3629,3599,3616,3558,3571,3587,-58,-42,21470,"77,016.72",72582
,20180313,3571,3587,3570,3584,3542,3543,3563,-44,-24,17418,"62,061.33",76570
,20180314,3543,3563,3551,3572,3510,3548,3537,-15,-26,30286,"107,140.53",73570
,20180315,3548,3537,3554,3573,3533,3539,3549,2,12,24690,"87,625.91",74818
,20180316,3539,3549,3539,3540,3506,3510,3517,-39,-32,18338,"64,508.16",79216
,20180319,3510,3517,3510,3522,3428,3428,3469,-89,-48,42244,"146,548.98",88302
,20180320,3428,3469,3431,3438,3353,3396,3395,-73,-74,39680,"134,736.84",93552
,20180321,3396,3395,3401,3408,3359,3361,3385,-34,-10,41130,"139,252.17",88970
,20180322,3361,3385,3353,3390,3353,3380,3377,-5,-8,50632,"171,015.27",115812
,20180323,3380,3377,3375,3375,3141,3192,3248,-185,-129,134116,"435,711.96",150446
,20180326,3192,3248,3176,3202,3101,3114,3142,-134,-106,95634,"300,509.66",159430
,20180327,3114,3142,3120,3181,3111,3158,3149,16,7,73610,"231,814.29",166452
,20180328,3158,3149,3170,3200,3120,3139,3165,-10,16,71514,"226,387.07",165060
,20180329,3139,3165,3140,3215,3126,3213,3174,48,9,61762,"196,060.04",162754
,20180330,3213,3174,3213,3307,3198,3306,3243,132,69,68360,"221,737.52",164624
,20180402,3306,3243,3310,3385,3231,3235,3280,-8,37,118480,"388,696.83",177246
,20180403,3235,3280,3235,3277,3212,3233,3239,-47,-41,98136,"317,941.02",185998
,20180404,3233,3239,3240,3259,3197,3205,3227,-34,-12,59538,"192,181.97",189404
,20180409,3205,3227,3202,3290,3199,3287,3241,60,14,61014,"197,796.86",184904
,20180410,3287,3241,3286,3323,3277,3299,3299,58,58,65646,"216,578.64",183914
,20180411,3299,3299,3305,3341,3271,3278,3303,-21,4,74222,"245,169.17",190000
,20180412,3278,3303,3289,3313,3256,3283,3278,-20,-25,67938,"222,758.80",188604
,20180413,3283,3278,3278,3342,3262,3330,3304,52,26,71480,"236,198.02",190108
,20180416,3330,3304,3333,3333,3220,3223,3276,-81,-28,92802,"304,037.99",206110
,20180417,3223,3276,3224,3295,3217,3248,3255,-28,-21,90456,"294,516.64",205942
,20180418,3248,3255,3260,3334,3260,3303,3299,48,44,97450,"321,582.56",199068
,20180419,3303,3299,3320,3378,3319,3365,3346,66,47,100544,"336,421.51",194670
,20180420,3365,3346,3362,3362,3312,3321,3338,-25,-8,82268,"274,691.36",206884
,20180423,3321,3338,3314,3416,3314,3401,3378,63,40,114450,"386,655.06",204532
,20180424,3401,3378,3395,3437,3381,3413,3413,35,35,83086,"283,649.48",208644
,20180425,3413,3413,3415,3433,3391,3416,3416,3,3,83180,"284,148.13",211514
,20180426,3416,3416,3418,3449,3380,3397,3406,-19,-10,98780,"336,526.91",222354
,20180427,3397,3406,3397,3442,3393,3429,3417,23,11,99962,"341,654.65",225148
,20180502,3429,3417,3471,3561,3464,3559,3508,142,91,142314,"499,289.89",240458
,20180503,3559,3508,3570,3572,3501,3517,3539,9,31,125348,"443,642.68",258790
,20180504,3517,3539,3521,3532,3490,3513,3509,-26,-30,129984,"456,234.42",260668
,20180507,3513,3509,3513,3540,3472,3517,3505,8,-4,120730,"423,182.45",264756
,20180508,3517,3505,3510,3522,3483,3487,3505,-18,0,104498,"366,306.24",262432
,20180509,3487,3505,3485,3485,3421,3427,3451,-78,-54,133238,"459,922.03",269888
,20180510,3427,3451,3439,3466,3431,3465,3446,14,-5,100610,"346,797.22",269384
,20180511,3465,3446,3485,3524,3472,3510,3497,64,51,130784,"457,437.37",261274
,20180514,3510,3497,3517,3525,3495,3503,3511,6,14,96050,"337,269.29",260610
,20180515,3503,3511,3502,3553,3480,3525,3519,14,8,147904,"520,494.43",264826
,20180516,3525,3519,3520,3554,3498,3532,3524,13,5,143928,"507,240.24",273608
,20180517,3532,3524,3525,3535,3510,3522,3523,-2,-1,79610,"280,477.74",274636
,20180518,3522,3523,3526,3545,3471,3480,3504,-43,-19,128264,"449,484.99",284124
,20180521,3480,3504,3478,3505,3441,3445,3469,-59,-35,115250,"399,822.73",299380
,20180522,3445,3469,3448,3469,3428,3437,3444,-32,-25,118582,"408,465.63",312136
,20180523,3437,3444,3449,3476,3387,3404,3416,-40,-28,152682,"521,709.34",329974
,20180524,3404,3416,3404,3457,3392,3456,3420,40,4,122980,"420,700.22",342468
,20180525,3456,3420,3460,3484,3415,3432,3455,12,35,139652,"482,505.87",343738
,20180528,3432,3455,3431,3490,3417,3450,3451,-5,-4,151080,"521,525.99",351360
,20180529,3450,3451,3443,3500,3437,3490,3471,39,20,132412,"459,692.28",349886
,20180530,3490,3471,3500,3510,3470,3487,3492,16,21,119312,"416,669.35",345986
,20180531,3487,3492,3488,3517,3474,3512,3493,20,1,193452,"675,764.03",340304
rb1902,20180212,3695,3695,3673,3770,3673,3681,3712,-14,17,14,51.98,6
,20180213,3681,3712,3757,3757,3656,3725,3716,13,4,24,89.19,16
,20180214,3725,3716,3694,3705,3694,3700,3701,-16,-15,34,125.86,44
,20180222,3700,3701,3680,3680,3651,3664,3665,-37,-36,88,322.57,126
,20180223,3664,3665,3675,3714,3658,3714,3677,49,12,252,926.72,258
,20180226,3714,3677,3726,3790,3717,3771,3762,94,85,246,925.55,282
,20180227,3771,3762,3766,3780,3755,3780,3766,18,4,126,474.63,328
,20180228,3780,3766,3760,3761,3760,3760,3760,-6,-6,8,30.08,330
,20180301,3760,3760,3763,3782,3759,3761,3764,1,4,34,128.00,356
,20180302,3761,3764,3766,3766,3744,3762,3753,-2,-11,46,172.66,386
,20180305,3762,3753,3761,3762,3720,3721,3733,-32,-20,126,470.39,406
,20180306,3721,3733,3712,3748,3712,3740,3730,7,-3,60,223.84,412
,20180307,3740,3730,3735,3750,3708,3709,3733,-21,3,188,701.96,494
,20180308,3709,3733,3695,3712,3662,3671,3680,-62,-53,168,618.37,484
,20180309,3671,3680,3663,3668,3551,3583,3620,-97,-60,196,709.68,586
,20180312,3583,3620,3579,3601,3550,3576,3577,-44,-43,88,314.79,664
,20180313,3576,3577,3559,3569,3525,3530,3549,-47,-28,200,709.91,748
,20180314,3530,3549,3529,3544,3489,3523,3509,-26,-40,172,603.69,822
,20180315,3523,3509,3530,3556,3512,3512,3524,3,15,120,422.91,850
,20180316,3512,3524,3424,3513,3424,3476,3487,-48,-37,204,711.42,916
,20180319,3476,3487,3485,3489,3402,3405,3432,-82,-55,242,830.61,1038
,20180320,3405,3432,3399,3410,3324,3366,3374,-66,-58,292,985.23,1182
,20180321,3366,3374,3380,3382,3333,3333,3368,-41,-6,436,"1,468.60",1446
,20180322,3333,3368,3336,3361,3333,3356,3350,-12,-18,122,408.73,1472
,20180323,3356,3350,3336,3336,3115,3167,3214,-183,-136,752,"2,417.29",1914
,20180326,3167,3214,3144,3155,3075,3085,3128,-129,-86,718,"2,246.35",2150
,20180327,3085,3128,3045,3146,3045,3132,3129,4,1,708,"2,216.01",2184
,20180328,3132,3129,3149,3166,3100,3113,3140,-16,11,330,"1,036.29",2100
,20180329,3113,3140,3114,3182,3098,3182,3139,42,-1,166,521.12,2096
,20180330,3182,3139,3186,3266,3167,3266,3226,127,87,306,987.32,2132
,20180402,3266,3226,3281,3334,3203,3203,3258,-23,32,414,"1,349.20",2152
,20180403,3203,3258,3210,3242,3184,3200,3209,-58,-49,392,"1,258.31",2096
,20180404,3200,3209,3192,3225,3163,3167,3200,-42,-9,142,454.53,2120
,20180409,3167,3200,3200,3246,3176,3246,3222,46,22,430,"1,385.53",2266
,20180410,3246,3222,3257,3281,3241,3253,3262,31,40,120,391.51,2268
,20180411,3253,3262,3195,3299,3195,3240,3259,-22,-3,124,404.16,2292
,20180412,3240,3259,3220,3264,3220,3245,3237,-14,-22,282,913.05,2206
,20180413,3245,3237,3238,3300,3223,3289,3264,52,27,174,568.02,2160
,20180416,3289,3264,3279,3290,3190,3190,3232,-74,-32,104,336.23,2138
,20180417,3190,3232,3190,3250,3188,3221,3214,-11,-18,88,282.92,2130
,20180418,3221,3214,3237,3290,3235,3252,3264,38,50,146,476.63,2162
,20180419,3252,3264,3303,3335,3282,3329,3307,65,43,444,"1,468.61",2054
,20180420,3329,3307,3319,3319,3280,3281,3304,-26,-3,88,290.82,2046
,20180423,3281,3304,3287,3368,3271,3355,3324,51,20,436,"1,449.57",2016
,20180424,3355,3324,3359,3393,3359,3370,3376,46,52,484,"1,634.22",1860
,20180425,3370,3376,3379,3391,3364,3380,3381,4,5,240,811.59,1828
,20180426,3380,3381,3385,3408,3351,3359,3367,-22,-14,314,"1,057.28",1786
,20180427,3359,3367,3376,3402,3364,3398,3386,31,19,204,690.93,1730
,20180502,3398,3386,3442,3524,3425,3524,3473,138,87,440,"1,528.50",1610
,20180503,3524,3473,3525,3538,3473,3479,3501,6,28,294,"1,029.55",1658
,20180504,3479,3501,3481,3493,3468,3479,3476,-22,-25,180,625.73,1666
,20180507,3479,3476,3467,3497,3440,3477,3476,1,0,496,"1,724.57",1544
,20180508,3477,3476,3477,3484,3460,3460,3475,-16,-1,228,792.50,1564
,20180509,3460,3475,3435,3440,3392,3401,3412,-74,-63,146,498.20,1616
,20180510,3401,3412,3421,3430,3411,3430,3419,18,7,76,259.87,1616
,20180511,3430,3419,3455,3484,3444,3472,3467,53,48,404,"1,400.99",1692
,20180514,3472,3467,3484,3486,3465,3473,3477,6,10,96,333.83,1700
,20180515,3473,3477,3480,3509,3450,3490,3481,13,4,118,410.79,1742
,20180516,3490,3481,3488,3508,3471,3490,3483,9,2,192,668.81,1820
,20180517,3490,3483,3486,3502,3483,3498,3495,15,12,202,705.99,1828
,20180518,3498,3495,3497,3507,3446,3455,3468,-40,-27,296,"1,026.82",1920
,20180521,3455,3468,3444,3468,3418,3423,3448,-45,-20,344,"1,186.41",2012
,20180522,3423,3448,3426,3439,3404,3410,3420,-38,-28,256,875.58,2164
,20180523,3410,3420,3412,3417,3361,3375,3374,-45,-46,412,"1,390.45",2368
,20180524,3375,3374,3374,3420,3368,3420,3392,46,18,90,305.34,2402
,20180525,3420,3392,3424,3446,3389,3390,3411,-2,19,90,307.04,2416
,20180528,3390,3411,3402,3453,3388,3410,3424,-1,13,302,"1,034.11",2512
,20180529,3410,3424,3415,3461,3415,3460,3443,36,19,320,"1,101.82",2530
,20180530,3460,3443,3461,3469,3438,3456,3456,13,13,168,580.72,2496
,20180531,3456,3456,3460,3472,3448,3471,3458,15,2,122,421.98,2492
rb1903,20180316,3524,3524,3504,3504,3455,3458,3464,-66,-60,58,200.97,50
,20180319,3458,3464,3482,3482,3405,3418,3428,-46,-36,64,219.44,60
,20180320,3418,3428,3397,3400,3341,3374,3371,-54,-57,48,161.81,84
,20180321,3374,3371,3367,3393,3331,3331,3356,-40,-15,64,214.84,136
,20180322,3331,3356,3337,3362,3334,3335,3340,-21,-16,10,33.41,138
,20180323,3335,3340,3334,3346,3119,3172,3246,-168,-94,338,"1,097.30",264
,20180326,3172,3246,3145,3145,3081,3081,3112,-165,-134,40,124.50,286
,20180327,3081,3112,3136,3150,3096,3128,3124,16,12,82,256.22,308
,20180328,3128,3124,3144,3157,3099,3114,3128,-10,4,42,131.42,308
,20180329,3114,3128,3105,3192,3100,3157,3155,29,27,22,69.43,310
,20180330,3157,3155,3188,3255,3161,3255,3189,100,34,122,389.17,356
,20180402,3255,3189,3268,3345,3195,3197,3226,8,37,320,"1,032.34",576
,20180403,3197,3226,3205,3235,3165,3190,3200,-36,-26,138,441.67,668
,20180404,3190,3200,3192,3207,3143,3162,3179,-38,-21,126,400.59,696
,20180409,3162,3179,3174,3230,3173,3230,3200,51,21,204,652.88,778
,20180410,3230,3200,3247,3277,3229,3263,3252,63,52,142,461.91,796
,20180411,3263,3252,3267,3288,3235,3239,3248,-13,-4,176,571.78,872
,20180412,3239,3248,3245,3256,3220,3240,3236,-8,-12,142,459.63,916
,20180413,3240,3236,3201,3291,3201,3285,3261,49,25,192,626.26,968
,20180416,3285,3261,3274,3290,3184,3185,3241,-76,-20,206,667.72,1100
,20180417,3185,3241,3182,3238,3175,3210,3201,-31,-40,122,390.57,1132
,20180418,3210,3201,3210,3269,3210,3249,3243,48,42,38,123.26,1132
,20180419,3249,3243,3280,3321,3247,3308,3290,65,47,148,486.95,1122
,20180420,3308,3290,3313,3317,3241,3270,3284,-20,-6,238,781.60,1174
,20180423,3270,3284,3276,3355,3272,3344,3321,60,37,198,657.60,1126
,20180424,3344,3321,3331,3380,3331,3358,3362,37,41,330,"1,109.50",1168
,20180425,3358,3362,3377,3385,3342,3372,3365,10,3,74,249.05,1184
,20180426,3372,3365,3370,3391,3337,3354,3356,-11,-9,262,879.41,1202
,20180427,3354,3356,3373,3392,3348,3382,3376,26,20,144,486.25,1216
,20180502,3382,3376,3435,3500,3409,3500,3460,124,84,366,"1,266.38",1134
,20180503,3500,3460,3512,3530,3450,3468,3489,8,29,154,537.37,1156
,20180504,3468,3489,3458,3481,3447,3457,3459,-32,-30,114,394.41,1204
,20180507,3457,3459,3446,3484,3429,3473,3462,14,3,218,754.92,1148
,20180508,3473,3462,3468,3468,3439,3457,3459,-5,-3,228,788.80,1254
,20180509,3457,3459,3418,3433,3386,3387,3415,-72,-44,344,"1,175.05",1406
,20180510,3387,3415,3391,3435,3391,3420,3411,5,-4,298,"1,016.54",1430
,20180511,3420,3411,3444,3474,3431,3474,3455,63,44,430,"1,485.75",1312
,20180514,3474,3455,3469,3478,3459,3464,3464,9,9,254,880.06,1160
,20180515,3464,3464,3474,3500,3441,3483,3464,19,0,204,706.66,1050
,20180516,3483,3464,3464,3499,3460,3483,3483,19,19,234,815.15,1118
,20180517,3483,3483,3480,3495,3475,3482,3483,-1,0,48,167.19,1124
,20180518,3482,3483,3494,3503,3438,3453,3480,-30,-3,272,946.66,1316
,20180521,3453,3480,3435,3466,3413,3420,3440,-60,-40,392,"1,348.81",1556
,20180522,3420,3440,3428,3435,3400,3406,3414,-34,-26,324,"1,106.24",1636
,20180523,3406,3414,3405,3405,3360,3368,3368,-46,-46,730,"2,458.66",1992
,20180524,3368,3368,3370,3408,3357,3408,3374,40,6,358,"1,208.08",2026
,20180525,3408,3374,3430,3438,3384,3395,3400,21,26,262,891.06,2150
,20180528,3395,3400,3390,3445,3390,3406,3415,6,15,230,785.47,2202
,20180529,3406,3415,3417,3449,3415,3449,3432,34,17,90,308.90,2268
,20180530,3449,3432,3454,3455,3436,3442,3444,10,12,56,192.88,2250
,20180531,3442,3444,3447,3458,3419,3454,3448,10,4,102,351.70,2236
rb1904,20180417,3241,3241,3180,3218,3180,3218,3211,-23,-30,12,38.54,12
,20180418,3218,3211,3233,3269,3198,3254,3232,43,21,66,213.33,20
,20180419,3254,3232,3277,3330,3277,3308,3305,76,73,12,39.67,32
,20180420,3308,3305,3293,3323,3243,3268,3290,-37,-15,48,157.95,64
,20180423,3268,3290,3306,3355,3306,3355,3331,65,41,12,39.98,68
,20180424,3355,3331,3330,3378,3330,3346,3350,15,19,74,247.93,118
,20180425,3346,3350,3374,3374,3340,3356,3347,6,-3,40,133.89,126
,20180426,3356,3347,3346,3388,3334,3338,3346,-9,-1,222,743.02,226
,20180427,3338,3346,3368,3392,3347,3367,3378,21,32,230,777.07,266
,20180502,3367,3378,3405,3491,3405,3491,3436,113,58,296,"1,017.33",302
,20180503,3491,3436,3498,3518,3331,3450,3470,14,34,416,"1,443.68",338
,20180504,3450,3470,3452,3470,3427,3448,3453,-22,-17,206,711.32,422
,20180507,3448,3453,3450,3475,3418,3461,3451,8,-2,258,890.49,434
,20180508,3461,3451,3459,3459,3437,3437,3447,-14,-4,188,648.17,536
,20180509,3437,3447,3418,3419,3383,3383,3402,-64,-45,722,"2,456.68",886
,20180510,3383,3402,3392,3420,3392,3420,3405,18,3,264,898.98,780
,20180511,3420,3405,3456,3472,3431,3452,3450,47,45,78,269.15,766
,20180514,3452,3450,3470,3480,3461,3462,3471,12,21,240,833.24,924
,20180515,3462,3471,3452,3500,3442,3484,3473,13,2,108,375.13,942
,20180516,3484,3473,3472,3500,3465,3474,3480,1,7,148,515.04,926
,20180517,3474,3480,3467,3484,3467,3484,3476,4,-4,48,166.87,922
,20180518,3484,3476,3481,3481,3421,3440,3452,-36,-24,78,269.26,926
,20180521,3440,3452,3433,3456,3412,3412,3435,-40,-17,210,721.46,966
,20180522,3412,3435,3410,3417,3403,3403,3408,-32,-27,18,61.35,968
,20180523,3403,3408,3370,3392,3358,3362,3366,-46,-42,130,437.61,908
,20180524,3362,3366,3351,3406,3351,3406,3378,40,12,18,60.81,900
,20180525,3406,3378,3418,3439,3393,3397,3423,19,45,56,191.70,866
,20180528,3397,3423,3391,3445,3383,3410,3416,-13,-7,38,129.83,862
,20180529,3410,3416,3408,3455,3407,3454,3426,38,10,106,363.24,904
,20180530,3454,3426,3453,3456,3437,3452,3451,26,25,158,545.37,830
,20180531,3452,3451,3433,3468,3433,3468,3449,17,-2,32,110.39,836
rb1905,20180516,3473,3473,3420,3465,3420,3445,3438,-28,-35,9300,"31,976.43",5806
,20180517,3445,3438,3439,3465,3430,3443,3443,5,5,8016,"27,604.15",8906
,20180518,3443,3443,3449,3454,3397,3405,3422,-38,-21,12556,"42,968.49",14678
,20180521,3405,3422,3401,3426,3375,3378,3396,-44,-26,13028,"44,249.91",21032
,20180522,3378,3396,3380,3398,3361,3367,3375,-29,-21,9018,"30,440.63",23676
,20180523,3367,3375,3367,3377,3331,3341,3348,-34,-27,13820,"46,281.94",30632
,20180524,3341,3348,3344,3384,3327,3383,3347,35,-1,12972,"43,427.19",28624
,20180525,3383,3347,3388,3402,3345,3359,3375,12,28,18150,"61,268.98",31618
,20180528,3359,3375,3358,3407,3347,3373,3382,-2,7,12224,"41,342.24",31738
,20180529,3373,3382,3375,3410,3365,3401,3395,19,13,18890,"64,144.09",31922
,20180530,3401,3395,3410,3421,3386,3402,3406,7,11,18076,"61,567.11",30664
,20180531,3402,3406,3400,3416,3391,3412,3402,6,-4,22036,"74,981.47",34662
ru1801,20180102,13630,13675,13655,13925,13620,13865,13850,190,175,6924,"95,920.87",30124
,20180103,13865,13850,13865,13960,13790,13820,13850,-30,0,4092,"56,684.08",28704
,20180104,13820,13850,13805,13805,13545,13670,13645,-180,-205,5482,"74,810.79",27224
,20180105,13670,13645,13675,13695,13500,13630,13615,-15,-30,6080,"82,790.32",26016
,20180108,13630,13615,13625,13645,13520,13600,13580,-15,-35,5236,"71,105.35",24542
,20180109,13600,13580,13595,13735,13570,13625,13635,45,55,4900,"66,820.41",22142
,20180110,13625,13635,13635,13795,13520,13600,13625,-35,-10,10576,"144,127.95",16834
,20180111,13600,13625,13585,13710,13580,13700,13650,75,25,1014,"13,844.31",16318
,20180112,13700,13650,13750,13970,13730,13880,13875,230,225,826,"11,463.48",15888
,20180115,13880,13875,13840,14030,13780,14000,13915,125,40,364,"5,065.68",15684
ru1803,20180102,14030,14035,14270,14295,14210,14210,14235,175,200,24,341.65,158
,20180103,14210,14235,14120,14200,14105,14185,14150,-50,-85,14,198.14,156
,20180104,14185,14150,14035,14035,13900,13980,13975,-170,-175,12,167.71,158
,20180105,13980,13975,13960,13990,13835,13990,13920,15,-55,20,278.41,158
,20180108,13990,13920,13900,13900,13855,13890,13880,-30,-40,12,166.58,156
,20180109,13890,13880,13930,13940,13890,13940,13920,60,40,8,111.36,154
,20180110,13940,13920,13875,14020,13860,13860,13880,-60,-40,18,249.86,156
,20180111,13860,13880,13885,14020,13860,14020,13930,140,50,18,250.75,158
,20180112,14020,13930,14040,14200,14040,14200,14135,270,205,12,169.62,160
,20180115,14200,14135,14295,14295,14195,14195,14235,60,100,8,113.88,152
,20180116,14195,14235,14165,14165,14055,14060,14085,-175,-150,14,197.24,156
,20180117,14060,14085,14025,14070,13975,14020,14030,-65,-55,34,477.06,152
,20180118,14020,14030,14090,14090,14090,14090,14090,60,60,6,84.54,148
,20180119,14090,14090,13985,14000,13975,13995,13990,-95,-100,18,251.82,146
,20180122,13995,13990,,,,13980,13980,-10,-10,0,0.00,146
,20180123,13980,13980,13910,13910,13580,13580,13855,-400,-125,22,304.84,136
,20180124,13580,13855,13635,13640,13560,13560,13615,-295,-240,10,136.15,132
,20180125,13560,13615,13595,13695,13565,13625,13610,10,-5,34,462.89,120
,20180126,13625,13610,13605,13605,13605,13605,13605,-5,-5,4,54.42,118
,20180129,13605,13605,13590,13635,13565,13565,13595,-40,-10,16,217.54,116
,20180130,13565,13595,13540,13540,13540,13540,13540,-55,-55,12,162.48,110
,20180131,13540,13540,13245,13275,12825,12835,12910,-705,-630,38,490.74,102
,20180201,12835,12910,12830,12870,12830,12835,12840,-75,-70,8,102.73,100
,20180202,12835,12840,12760,12760,12725,12760,12740,-80,-100,30,382.32,90
,20180205,12760,12740,12750,12790,12595,12595,12685,-145,-55,8,101.51,90
,20180206,12595,12685,12810,12810,12400,12400,12615,-285,-70,8,100.95,90
,20180207,12400,12615,12420,12515,12400,12400,12440,-215,-175,26,323.53,90
,20180208,12400,12440,12190,12205,12190,12205,12200,-235,-240,6,73.20,94
,20180209,12205,12200,,,,12200,12200,0,0,0,0.00,94
,20180212,12200,12200,12345,12345,12275,12340,12310,140,110,26,320.17,88
,20180213,12340,12310,12340,12340,12185,12185,12205,-125,-105,16,195.30,82
,20180214,12185,12205,12230,12255,12205,12205,12225,0,20,20,244.54,86
,20180222,12205,12225,12290,12290,12245,12245,12265,20,40,4,49.07,84
,20180223,12245,12265,12245,12600,12245,12580,12525,315,260,32,400.86,66
,20180226,12580,12525,12395,12760,12360,12760,12565,235,40,22,276.53,64
,20180227,12760,12565,13050,13050,12425,12615,12695,50,130,40,507.81,66
,20180228,12615,12695,12675,12680,12550,12605,12625,-90,-70,10,126.29,66
,20180301,12605,12625,,,,12660,12660,35,35,0,0.00,66
,20180302,12660,12660,12850,12850,12625,12625,12735,-35,75,4,50.95,66
,20180305,12625,12735,,,,12735,12735,0,0,0,0.00,66
,20180306,12735,12735,12500,13015,12420,12930,12715,195,-20,12,152.60,66
,20180307,12930,12715,,,,12715,12715,0,0,0,0.00,66
,20180308,12715,12715,12645,12645,12645,12645,12645,-70,-70,2,25.29,64
,20180309,12645,12645,12370,12995,11930,12005,12345,-640,-300,32,395.16,62
,20180312,12005,12345,12300,12400,12300,12300,12330,-45,-15,6,74.00,62
,20180313,12300,12330,,,,12330,12330,0,0,0,0.00,62
,20180314,12330,12330,,,,12330,12330,0,0,0,0.00,62
,20180315,12330,12330,,,,12330,12330,0,0,0,0.00,62
ru1804,20180102,14175,14140,14305,14315,14305,14315,14305,175,165,6,85.85,64
,20180103,14315,14305,,,,14305,14305,0,0,0,0.00,64
,20180104,14305,14305,14090,14090,13970,14060,14040,-245,-265,12,168.48,68
,20180105,14060,14040,13920,13985,13920,13985,13940,-55,-100,6,83.65,62
,20180108,13985,13940,13910,13950,13910,13950,13920,10,-20,6,83.54,64
,20180109,13950,13920,14060,14110,13995,13995,14060,75,140,10,140.61,66
,20180110,13995,14060,,,,14035,14035,-25,-25,0,0.00,66
,20180111,14035,14035,14100,14100,14060,14060,14070,25,35,6,84.44,66
,20180112,14060,14070,14160,14295,14160,14295,14245,225,175,8,113.99,62
,20180115,14295,14245,14195,14380,14195,14330,14295,85,50,8,114.38,64
,20180116,14330,14295,14340,14340,14220,14220,14280,-75,-15,6,85.70,62
,20180117,14220,14280,14185,14185,14185,14185,14185,-95,-95,2,28.37,64
,20180118,14185,14185,,,,14185,14185,0,0,0,0.00,64
,20180119,14185,14185,14155,14200,13950,13980,14115,-205,-70,116,"1,637.83",104
,20180122,13980,14115,14180,14180,13985,13985,14080,-130,-35,4,56.33,106
,20180123,13985,14080,13780,13840,13780,13840,13810,-240,-270,4,55.24,106
,20180124,13840,13810,,,,13810,13810,0,0,0,0.00,106
,20180125,13810,13810,13810,13810,13710,13800,13775,-10,-35,16,220.42,102
,20180126,13800,13775,,,,13765,13765,-10,-10,0,0.00,102
,20180129,13765,13765,13880,13880,13725,13725,13775,-40,10,6,82.66,104
,20180130,13725,13775,13665,13665,13665,13665,13665,-110,-110,2,27.33,104
,20180131,13665,13665,13125,13125,13125,13125,13125,-540,-540,6,78.75,110
,20180201,13125,13125,13100,13130,13030,13030,13085,-95,-40,14,183.23,106
,20180202,13030,13085,13010,13010,13010,13010,13010,-75,-75,2,26.02,104
,20180205,13010,13010,12995,12995,12895,12970,12965,-40,-45,28,363.04,80
,20180206,12970,12965,12970,12970,12600,12610,12675,-355,-290,38,481.74,60
,20180207,12610,12675,12780,12780,12780,12780,12780,105,105,2,25.56,60
,20180208,12780,12780,12615,12615,12560,12560,12585,-220,-195,4,50.35,62
,20180209,12560,12585,,,,12415,12415,-170,-170,0,0.00,62
,20180212,12415,12415,,,,12415,12415,0,0,0,0.00,62
,20180213,12415,12415,,,,12415,12415,0,0,0,0.00,62
,20180214,12415,12415,12450,12475,12370,12370,12415,-45,0,20,248.31,58
,20180222,12370,12415,12415,12495,12415,12495,12455,80,40,28,348.74,62
,20180223,12495,12455,12470,12815,12470,12785,12755,330,300,56,714.45,54
,20180226,12785,12755,12725,12985,12725,12850,12805,95,50,16,204.95,50
,20180227,12850,12805,12885,12885,12755,12755,12775,-50,-30,12,153.32,46
,20180228,12755,12775,12945,12945,12945,12945,12945,170,170,4,51.78,42
,20180301,12945,12945,,,,12945,12945,0,0,0,0.00,42
,20180302,12945,12945,12925,12925,12845,12845,12885,-100,-60,4,51.54,40
,20180305,12845,12885,13000,13085,12970,13060,13025,175,140,8,104.23,42
,20180306,13060,13025,,,,12880,12880,-145,-145,0,0.00,42
,20180307,12880,12880,12755,12755,12755,12755,12755,-125,-125,2,25.51,42
,20180308,12755,12755,12960,12960,12770,12770,12855,15,100,20,257.17,40
,20180309,12770,12855,12575,12575,12575,12575,12575,-280,-280,2,25.15,38
,20180312,12575,12575,,,,12575,12575,0,0,0,0.00,38
,20180313,12575,12575,12525,12525,12525,12525,12525,-50,-50,2,25.05,36
,20180314,12525,12525,12700,12700,12700,12700,12700,175,175,2,25.40,36
,20180315,12700,12700,12665,12740,12665,12740,12700,40,0,4,50.81,32
,20180316,12740,12700,12575,12655,12575,12655,12615,-45,-85,4,50.46,32
,20180319,12655,12615,12380,12525,12355,12355,12435,-260,-180,22,273.62,34
,20180320,12355,12435,12525,12525,12160,12160,12325,-275,-110,16,197.24,28
,20180321,12160,12325,,,,12130,12130,-195,-195,0,0.00,28
,20180322,12130,12130,12075,12170,12075,12170,12120,40,-10,4,48.49,28
,20180323,12170,12120,,,,12120,12120,0,0,0,0.00,28
,20180326,12120,12120,11270,11270,11270,11270,11270,-850,-850,8,90.16,32
,20180327,11270,11270,11205,11205,11205,11205,11205,-65,-65,2,22.41,32
,20180328,11205,11205,11250,11250,11145,11230,11190,25,-15,20,223.85,12
,20180329,11230,11190,11145,11145,11120,11120,11125,-70,-65,16,178.02,12
,20180330,11120,11125,11025,11025,11025,11025,11025,-100,-100,2,22.05,14
,20180402,11025,11025,,,,11025,11025,0,0,0,0.00,14
,20180403,11025,11025,,,,11025,11025,0,0,0,0.00,14
,20180404,11025,11025,,,,11025,11025,0,0,0,0.00,14
,20180409,11025,11025,,,,11025,11025,0,0,0,0.00,14
,20180410,11025,11025,,,,11025,11025,0,0,0,0.00,14
,20180411,11025,11025,10990,10990,10250,10250,10725,-775,-300,12,128.74,10
,20180412,10250,10725,,,,10725,10725,0,0,0,0.00,10
,20180413,10725,10725,10500,10500,10500,10500,10500,-225,-225,4,42.00,10
,20180416,10500,10500,11235,11235,9765,9765,10500,-735,0,4,42.00,10
ru1805,20180102,14105,14140,14090,14430,14080,14340,14325,200,185,381536,"5,466,671.06",367234
,20180103,14340,14325,14340,14460,14240,14295,14320,-30,-5,327334,"4,687,676.81",374936
,20180104,14295,14320,14280,14280,13990,14115,14095,-205,-225,564406,"7,956,352.14",404120
,20180105,14115,14095,14095,14160,13920,14090,14065,-5,-30,447564,"6,296,486.63",405010
,20180108,14090,14065,14060,14110,13960,14075,14035,10,-30,319626,"4,487,093.41",413072
,20180109,14075,14035,14090,14200,14010,14075,14095,40,60,368066,"5,189,129.17",413940
,20180110,14075,14095,14100,14280,13985,14035,14105,-60,10,527278,"7,437,299.81",416768
,20180111,14035,14105,14090,14195,14050,14170,14120,65,15,336572,"4,753,760.17",405546
,20180112,14170,14120,14220,14405,14185,14295,14310,175,190,563098,"8,058,140.00",407302
,20180115,14295,14310,14290,14500,14130,14445,14370,135,60,390868,"5,617,658.70",413742
,20180116,14445,14370,14440,14475,14155,14225,14310,-145,-60,437546,"6,262,216.82",409008
,20180117,14225,14310,14185,14285,14070,14145,14200,-165,-110,322056,"4,573,761.66",409030
,20180118,14145,14200,14120,14280,14115,14165,14200,-35,0,310410,"4,407,965.30",412314
,20180119,14165,14200,14145,14230,13975,14065,14095,-135,-105,494914,"6,976,490.54",432858
,20180122,14065,14095,14095,14150,14000,14075,14075,-20,-20,321526,"4,525,998.75",438652
,20180123,14075,14075,14035,14135,13760,13795,13920,-280,-155,543608,"7,567,573.67",491676
,20180124,13795,13920,13750,13840,13645,13775,13780,-145,-140,266134,"3,667,915.51",486616
,20180125,13775,13780,13785,13900,13700,13755,13810,-25,30,393930,"5,440,834.76",488396
,20180126,13755,13810,13755,13870,13730,13770,13795,-40,-15,301580,"4,161,527.50",485152
,20180129,13770,13795,13730,13950,13620,13770,13810,-25,15,418768,"5,783,268.65",481884
,20180130,13770,13810,13770,13825,13330,13395,13585,-415,-225,560042,"7,608,886.47",508666
,20180131,13395,13585,13400,13440,12880,13120,13175,-465,-410,576542,"7,596,240.29",509238
,20180201,13120,13175,13180,13185,12890,12955,13025,-220,-150,347664,"4,529,447.69",510868
,20180202,12955,13025,12990,13075,12965,13005,13015,-20,-10,263916,"3,435,725.66",509384
,20180205,13005,13015,12990,13105,12790,13055,13010,40,-5,350518,"4,561,912.16",499050
,20180206,13055,13010,13065,13135,12500,12585,12775,-425,-235,599878,"7,664,078.50",506882
,20180207,12585,12775,12635,12730,12580,12655,12645,-120,-130,271528,"3,434,806.37",491602
,20180208,12655,12645,12650,12690,12280,12390,12435,-255,-210,472784,"5,879,649.98",490542
,20180209,12390,12435,12420,12495,12225,12450,12410,15,-25,350406,"4,349,410.45",465470
,20180212,12450,12410,12420,12685,12400,12520,12525,110,115,290064,"3,634,152.25",455634
,20180213,12520,12525,12495,12580,12380,12450,12475,-75,-50,220900,"2,755,966.36",447754
,20180214,12450,12475,12435,12550,12320,12500,12460,25,-15,269100,"3,354,237.68",429866
,20180222,12500,12460,12545,12675,12370,12500,12485,40,25,216152,"2,698,829.11",439456
,20180223,12500,12485,12510,12940,12505,12850,12760,365,275,450308,"5,748,026.64",425890
,20180226,12850,12760,12850,12975,12810,12935,12895,175,135,303970,"3,920,297.71",417918
,20180227,12935,12895,12930,12955,12765,12885,12860,-10,-35,296358,"3,811,571.86",408132
,20180228,12885,12860,12865,13100,12710,13030,12940,170,80,458812,"5,939,142.45",401278
,20180301,13030,12940,13045,13075,12925,13010,13005,70,65,287962,"3,745,645.19",398062
,20180302,13010,13005,12900,13000,12770,12950,12925,-55,-80,293706,"3,796,397.03",394754
,20180305,12950,12925,12905,13185,12905,13055,13085,130,160,425548,"5,568,982.27",391132
,20180306,13055,13085,13020,13090,12850,12930,12965,-155,-120,341572,"4,428,696.99",387948
,20180307,12930,12965,12945,12965,12810,12865,12885,-100,-80,304098,"3,918,797.85",390964
,20180308,12865,12885,12835,13035,12740,12910,12905,25,20,405380,"5,231,493.00",384874
,20180309,12910,12905,12905,13050,12555,12620,12810,-285,-95,582352,"7,460,212.58",391748
,20180312,12620,12810,12670,12795,12570,12695,12690,-115,-120,338148,"4,292,548.27",386428
,20180313,12695,12690,12680,12745,12610,12695,12680,5,-10,253366,"3,213,742.93",387448
,20180314,12695,12680,12720,12880,12675,12775,12780,95,100,372494,"4,760,537.82",379652
,20180315,12775,12780,12800,12850,12685,12810,12780,30,0,294284,"3,761,288.03",379934
,20180316,12810,12780,12790,12880,12515,12580,12645,-200,-135,484914,"6,131,997.45",404824
,20180319,12580,12645,12600,12640,12425,12510,12520,-135,-125,303680,"3,803,087.10",399774
,20180320,12510,12520,12540,12570,12075,12240,12295,-280,-225,481012,"5,916,169.94",403044
,20180321,12240,12295,12255,12275,12110,12130,12190,-165,-105,270522,"3,298,716.02",401216
,20180322,12130,12190,12105,12250,12055,12130,12160,-60,-30,282496,"3,436,384.37",394462
,20180323,12130,12160,12095,12140,11305,11305,11675,-855,-485,548548,"6,404,528.01",356612
,20180326,11305,11675,11205,11260,10830,11020,11010,-655,-665,701844,"7,730,007.63",316336
,20180327,11020,11010,11070,11270,10995,11175,11140,165,130,338128,"3,768,202.85",296766
,20180328,11175,11140,11200,11225,10890,11075,11065,-65,-75,374110,"4,139,803.43",279464
,20180329,11075,11065,11080,11150,11000,11100,11085,35,20,253650,"2,811,722.26",264128
,20180330,11100,11085,11120,11390,10985,11290,11185,205,100,379936,"4,250,612.42",233958
,20180402,11290,11185,11305,11320,11120,11240,11215,55,30,193542,"2,171,211.99",213276
,20180403,11240,11215,11240,11295,10965,11070,11145,-145,-70,169008,"1,883,766.80",198116
,20180404,11070,11145,11080,11115,10905,10960,11025,-185,-120,94076,"1,037,446.52",186932
,20180409,10960,11025,11040,11110,10960,11070,11030,45,5,63682,"702,582.96",174198
,20180410,11070,11030,11100,11255,11045,11185,11160,155,130,84102,"938,702.67",157800
,20180411,11185,11160,11215,11275,11030,11085,11155,-75,-5,69416,"774,547.98",148852
,20180412,11085,11155,11140,11150,10940,11085,11075,-70,-80,59966,"664,173.40",142416
,20180413,11085,11075,11115,11165,11005,11110,11090,35,15,45508,"504,811.16",137272
,20180416,11110,11090,11130,11165,10615,10745,10870,-345,-220,83356,"906,450.01",128618
,20180417,10745,10870,10805,10805,10635,10690,10715,-180,-155,42516,"455,724.23",121456
,20180418,10690,10715,10755,10835,10690,10800,10770,85,55,41870,"451,028.70",115744
,20180419,10800,10770,10865,11465,10840,11365,11100,595,330,96002,"1,065,803.41",96368
,20180420,11365,11100,11400,11400,11085,11140,11255,40,155,59740,"672,610.15",87246
,20180423,11140,11255,11130,11345,11090,11275,11235,20,-20,47442,"533,135.36",75872
,20180424,11275,11235,11230,11270,11045,11155,11160,-80,-75,36654,"409,239.62",66556
,20180425,11155,11160,11195,11295,11120,11210,11200,50,40,29770,"333,560.65",59658
,20180426,11210,11200,11185,11245,11010,11060,11105,-140,-95,31192,"346,466.74",51162
,20180427,11060,11105,11100,11115,10820,10940,10960,-165,-145,28600,"313,584.14",36618
,20180502,10940,10960,10985,11220,10955,11165,11070,205,110,9198,"101,843.11",32988
,20180503,11165,11070,11235,11235,11110,11230,11175,160,105,6732,"75,260.92",30330
,20180504,11230,11175,11235,11345,11200,11260,11270,85,95,6196,"69,859.88",27750
,20180507,11260,11270,11260,11520,11170,11435,11375,165,105,8800,"100,102.28",23940
,20180508,11435,11375,11470,11470,11315,11425,11410,50,35,6070,"69,287.29",21726
,20180509,11425,11410,11550,11550,11225,11320,11335,-90,-75,7280,"82,546.14",18050
,20180510,11320,11335,11350,11480,11180,11310,11330,-25,-5,11068,"125,449.13",11302
,20180511,11310,11330,11270,11390,11115,11390,11320,60,-10,1420,"16,076.35",10652
,20180514,11390,11320,11310,11445,11110,11365,11340,45,20,390,"4,423.00",10462
,20180515,11365,11340,11345,11345,10820,10995,11175,-345,-165,478,"5,342.92",10060
ru1806,20180102,14235,14250,14320,14470,14320,14415,14400,165,150,24,345.70,238
,20180103,14415,14400,,,,14400,14400,0,0,0,0.00,238
,20180104,14400,14400,14285,14320,14135,14195,14225,-205,-175,56,796.82,250
,20180105,14195,14225,14190,14220,14085,14205,14180,-20,-45,100,"1,418.14",250
,20180108,14205,14180,14120,14145,14070,14145,14110,-35,-70,64,903.21,226
,20180109,14145,14110,14225,14275,14175,14205,14215,95,105,20,284.38,232
,20180110,14205,14215,14160,14340,14150,14220,14210,5,-5,24,341.04,242
,20180111,14220,14210,14175,14240,14175,14240,14215,30,5,6,85.31,240
,20180112,14240,14215,14250,14460,14250,14365,14370,150,155,30,431.10,236
,20180115,14365,14370,14295,14500,14295,14500,14400,130,30,28,403.21,234
,20180116,14500,14400,14385,14455,14295,14325,14390,-75,-10,66,949.90,230
,20180117,14325,14390,14290,14360,14260,14265,14305,-125,-85,94,"1,345.08",228
,20180118,14265,14305,14285,14350,14265,14265,14285,-40,-20,96,"1,371.46",240
,20180119,14265,14285,14220,14220,14065,14130,14170,-155,-115,28,396.80,232
,20180122,14130,14170,14205,14235,14145,14145,14205,-25,35,16,227.31,236
,20180123,14145,14205,14230,14230,13890,13890,13965,-315,-240,18,251.37,244
,20180124,13890,13965,13775,13925,13775,13910,13885,-55,-80,56,777.62,244
,20180125,13910,13885,13870,13935,13860,13870,13865,-15,-20,26,360.55,260
,20180126,13870,13865,13950,13950,13880,13880,13915,15,50,36,501.11,268
,20180129,13880,13915,13940,13940,13780,13885,13865,-30,-50,46,637.87,264
,20180130,13885,13865,13890,13890,13465,13465,13645,-400,-220,26,354.85,264
,20180131,13465,13645,13505,13505,13045,13180,13270,-465,-375,22,292.02,268
,20180201,13180,13270,13205,13250,13055,13090,13170,-180,-100,32,421.44,272
,20180202,13090,13170,13070,13185,13070,13140,13135,-30,-35,14,183.92,274
,20180205,13140,13135,13065,13160,13060,13120,13105,-15,-30,22,288.35,272
,20180206,13120,13105,13140,13140,12800,12835,12840,-270,-265,32,410.93,256
,20180207,12835,12840,12845,12845,12785,12815,12810,-25,-30,8,102.49,254
,20180208,12815,12810,12835,12835,12380,12440,12485,-370,-325,36,449.63,246
,20180209,12440,12485,12550,12570,12515,12570,12540,85,55,32,401.31,240
,20180212,12570,12540,12555,12750,12550,12625,12645,85,105,72,910.75,280
,20180213,12625,12645,12550,12640,12550,12555,12580,-90,-65,28,352.27,284
,20180214,12555,12580,12545,12585,12475,12585,12550,5,-30,18,225.98,278
,20180222,12585,12550,12635,12635,12605,12625,12625,75,75,8,101.00,278
,20180223,12625,12625,12645,12980,12645,12955,12870,330,245,52,669.46,266
,20180226,12955,12870,12995,13035,12990,13000,13005,130,135,8,104.04,262
,20180227,13000,13005,13040,13060,12960,13015,13020,10,15,36,468.78,264
,20180228,13015,13020,12955,13165,12955,13135,13085,115,65,12,157.03,268
,20180301,13135,13085,13130,13155,13075,13135,13115,50,30,32,419.79,280
,20180302,13135,13115,13045,13115,13035,13105,13065,-10,-50,16,209.08,276
,20180305,13105,13065,13240,13265,13165,13185,13215,120,150,22,290.79,282
,20180306,13185,13215,13075,13170,13010,13100,13090,-115,-125,18,235.65,294
,20180307,13100,13090,13060,13060,12950,12980,13000,-110,-90,16,208.03,298
,20180308,12980,13000,12950,13130,12920,13005,13055,5,55,54,705.00,278
,20180309,13005,13055,13135,13140,12760,12775,12955,-280,-100,50,647.87,286
,20180312,12775,12955,12705,12940,12705,12840,12880,-115,-75,52,669.83,286
,20180313,12840,12880,12750,12825,12750,12825,12780,-55,-100,18,230.10,288
,20180314,12825,12780,12910,12930,12865,12925,12895,145,115,30,386.94,274
,20180315,12925,12895,12890,12930,12855,12930,12880,35,-15,44,566.84,274
,20180316,12930,12880,12850,12850,12635,12695,12700,-185,-180,82,"1,041.46",318
,20180319,12695,12700,12690,12690,12570,12645,12635,-55,-65,26,328.59,322
,20180320,12645,12635,12520,12520,12275,12275,12355,-360,-280,62,766.19,308
,20180321,12275,12355,12255,12255,12240,12250,12250,-105,-105,12,147.00,312
,20180322,12250,12250,12240,12325,12240,12265,12275,15,25,12,147.31,312
,20180323,12265,12275,12060,12060,11415,11450,11565,-825,-710,56,647.86,318
,20180326,11450,11565,11305,11325,10950,11125,11120,-440,-445,98,"1,090.06",332
,20180327,11125,11120,11390,11390,11120,11270,11245,150,125,268,"3,014.69",326
,20180328,11270,11245,11325,11325,11040,11245,11155,0,-90,70,781.14,314
,20180329,11245,11155,11180,11235,11175,11200,11215,45,60,74,830.12,314
,20180330,11200,11215,11275,11430,11190,11430,11280,215,65,34,383.60,298
,20180402,11430,11280,11380,11410,11285,11365,11345,85,65,86,975.87,298
,20180403,11365,11345,11380,11410,11120,11235,11275,-110,-70,22,248.13,296
,20180404,11235,11275,11200,11220,11030,11030,11145,-245,-130,72,802.67,306
,20180409,11030,11145,11090,11195,11065,11195,11095,50,-50,20,221.98,302
,20180410,11195,11095,11175,11335,11170,11315,11235,220,140,34,382.10,312
,20180411,11315,11235,11360,11360,11155,11200,11250,-35,15,18,202.58,314
,20180412,11200,11250,11220,11250,11120,11195,11190,-55,-60,110,"1,231.27",328
,20180413,11195,11190,11240,11260,11190,11210,11220,20,30,54,605.92,322
,20180416,11210,11220,11250,11250,10765,10840,10845,-380,-375,60,650.79,322
,20180417,10840,10845,10790,10805,10775,10775,10785,-70,-60,22,237.35,316
,20180418,10775,10785,10860,10955,10860,10910,10890,125,105,38,413.96,320
,20180419,10910,10890,10965,11475,10965,11475,11255,585,365,50,562.75,320
,20180420,11475,11255,11440,11440,11245,11260,11355,5,100,30,340.78,318
,20180423,11260,11355,11325,11370,11325,11370,11345,15,-10,4,45.39,316
,20180424,11370,11345,11205,11285,11200,11280,11250,-65,-95,10,112.50,316
,20180425,11280,11250,11310,11365,11275,11365,11305,115,55,24,271.35,314
,20180426,11365,11305,11315,11315,11125,11140,11185,-165,-120,20,223.77,300
,20180427,11140,11185,11110,11110,10950,10970,10970,-215,-215,70,768.04,248
,20180502,10970,10970,11145,11145,11145,11145,11145,175,175,2,22.29,248
,20180503,11145,11145,11320,11335,11240,11335,11300,190,155,22,248.64,246
,20180504,11335,11300,11380,11420,11295,11335,11350,35,50,18,204.33,246
,20180507,11335,11350,11410,11570,11370,11525,11510,175,160,34,391.35,224
,20180508,11525,11510,11475,11530,11450,11530,11500,20,-10,24,276.01,206
,20180509,11530,11500,11660,11660,11380,11380,11420,-120,-80,24,274.17,198
,20180510,11380,11420,11500,11555,11335,11360,11420,-60,0,80,913.70,188
,20180511,11360,11420,11400,11450,11360,11420,11395,0,-25,118,"1,344.95",186
,20180514,11420,11395,11400,11400,11400,11400,11400,5,5,2,22.80,186
,20180515,11400,11400,11305,11305,11085,11085,11160,-315,-240,16,178.62,186
,20180516,11085,11160,11120,11160,11120,11160,11135,0,-25,6,66.82,186
,20180517,11160,11135,11155,11155,11125,11150,11140,15,5,16,178.30,186
,20180518,11150,11140,11200,11570,11200,11410,11365,270,225,20,227.39,186
,20180521,11410,11365,11405,11970,11370,11945,11605,580,240,176,"2,043.00",176
,20180522,11945,11605,11965,12105,11810,11865,11990,260,385,78,935.50,174
,20180523,11865,11990,11755,11930,11260,11360,11410,-630,-580,106,"1,209.61",174
,20180524,11360,11410,11410,11410,11410,11410,11410,0,0,2,22.82,174
,20180525,11410,11410,11420,11560,11420,11560,11485,150,75,28,321.61,174
,20180528,11560,11485,11300,11525,11300,11440,11440,-45,-45,12,137.29,180
,20180529,11440,11440,11585,11805,11585,11610,11650,170,210,14,163.11,176
,20180530,11610,11650,,,,11560,11560,-90,-90,0,0.00,176
,20180531,11560,11560,11125,11430,11125,11200,11295,-360,-265,22,248.59,176
ru1807,20180102,14300,14300,14590,14590,14590,14590,14590,290,290,2,29.18,260
,20180103,14590,14590,14530,14530,14530,14530,14530,-60,-60,2,29.06,258
,20180104,14530,14530,14290,14290,14230,14275,14265,-255,-265,24,342.36,260
,20180105,14275,14265,,,,14265,14265,0,0,0,0.00,260
,20180108,14265,14265,14230,14230,14220,14230,14225,-35,-40,12,170.72,264
,20180109,14230,14225,14390,14390,14390,14390,14390,165,165,2,28.78,264
,20180110,14390,14390,14285,14285,14285,14285,14285,-105,-105,2,28.57,266
,20180111,14285,14285,,,,14325,14325,40,40,0,0.00,266
,20180112,14325,14325,14600,14600,14460,14460,14530,135,205,4,58.12,262
,20180115,14460,14530,14690,14690,14625,14625,14670,95,140,8,117.39,256
,20180116,14625,14670,,,,14670,14670,0,0,0,0.00,256
,20180117,14670,14670,14390,14435,14390,14400,14405,-270,-265,8,115.25,256
,20180118,14400,14405,14430,14430,14430,14430,14430,25,25,6,86.58,256
,20180119,14430,14430,14370,14380,14215,14215,14330,-215,-100,10,143.31,260
,20180122,14215,14330,,,,14330,14330,0,0,0,0.00,260
,20180123,14330,14330,14260,14260,13960,13990,14010,-340,-320,70,980.93,312
,20180124,13990,14010,13930,13995,13900,13970,13950,-40,-60,22,306.97,294
,20180125,13970,13950,14040,14040,14020,14020,14030,70,80,4,56.12,294
,20180126,14020,14030,,,,14030,14030,0,0,0,0.00,294
,20180129,14030,14030,14030,14150,14030,14060,14055,30,25,16,224.90,300
,20180130,14060,14055,13955,13955,13555,13625,13620,-430,-435,68,926.24,298
,20180131,13625,13620,13635,13635,13300,13365,13445,-255,-175,22,295.83,294
,20180201,13365,13445,,,,13340,13340,-105,-105,0,0.00,294
,20180202,13340,13340,13205,13235,13205,13235,13225,-105,-115,26,343.87,288
,20180205,13235,13225,,,,13225,13225,0,0,0,0.00,288
,20180206,13225,13225,12880,12880,12875,12875,12875,-350,-350,16,206.03,288
,20180207,12875,12875,12880,12880,12830,12850,12855,-25,-20,24,308.61,286
,20180208,12850,12855,12660,12660,12500,12500,12580,-355,-275,8,100.64,282
,20180209,12500,12580,12635,12635,12635,12635,12635,55,55,100,"1,263.50",182
,20180212,12635,12635,12650,12790,12650,12760,12750,125,115,28,357.12,190
,20180213,12760,12750,12760,12760,12660,12660,12705,-90,-45,6,76.25,190
,20180214,12660,12705,12665,12675,12645,12675,12660,-30,-45,16,202.59,178
,20180222,12675,12660,12685,12685,12685,12685,12685,25,25,2,25.37,178
,20180223,12685,12685,13075,13075,13075,13075,13075,390,390,2,26.15,180
,20180226,13075,13075,13100,13155,13100,13155,13115,80,40,6,78.71,180
,20180227,13155,13115,13000,13195,13000,13145,13090,30,-25,20,261.87,178
,20180228,13145,13090,13250,13250,13245,13245,13245,155,155,6,79.48,174
,20180301,13245,13245,,,,13245,13245,0,0,0,0.00,174
,20180302,13245,13245,,,,13245,13245,0,0,0,0.00,174
,20180305,13245,13245,,,,13245,13245,0,0,0,0.00,174
,20180306,13245,13245,,,,13245,13245,0,0,0,0.00,174
,20180307,13245,13245,,,,13245,13245,0,0,0,0.00,174
,20180308,13245,13245,13160,13160,13000,13130,13095,-115,-150,22,288.16,170
,20180309,13130,13095,12835,12880,12835,12880,12855,-215,-240,4,51.43,166
,20180312,12880,12855,12885,12885,12885,12885,12885,30,30,2,25.77,164
,20180313,12885,12885,12910,12910,12870,12875,12885,-10,0,8,103.10,164
,20180314,12875,12885,12905,12905,12905,12905,12905,20,20,2,25.81,162
,20180315,12905,12905,13000,13035,13000,13035,13015,130,110,4,52.07,164
,20180316,13035,13015,13040,13040,12825,12825,12960,-190,-55,10,129.63,166
,20180319,12825,12960,,,,12960,12960,0,0,0,0.00,166
,20180320,12960,12960,12365,12475,12360,12425,12405,-535,-555,30,372.18,174
,20180321,12425,12405,12415,12465,12400,12400,12425,-5,20,8,99.43,174
,20180322,12400,12425,,,,12365,12365,-60,-60,0,0.00,174
,20180323,12365,12365,11500,11630,11495,11570,11560,-795,-805,24,277.48,176
,20180326,11570,11560,11405,11405,11025,11240,11230,-320,-330,186,"2,089.52",192
,20180327,11240,11230,11300,11800,10935,11445,11365,215,135,42,477.33,188
,20180328,11445,11365,11410,11410,11145,11280,11290,-85,-75,22,248.45,186
,20180329,11280,11290,11315,11350,11240,11295,11275,5,-15,16,180.42,184
,20180330,11295,11275,11305,11560,11305,11560,11430,285,155,20,228.66,176
,20180402,11560,11430,11440,11445,11395,11445,11425,15,-5,10,114.28,176
,20180403,11445,11425,11540,11540,11235,11345,11365,-80,-60,40,454.67,180
,20180404,11345,11365,11305,11320,11205,11205,11270,-160,-95,24,270.55,186
,20180409,11205,11270,11220,11300,11220,11300,11290,30,20,70,790.32,204
,20180410,11300,11290,11310,11440,11310,11440,11415,150,125,24,273.98,192
,20180411,11440,11415,11415,11415,11335,11335,11360,-80,-55,6,68.17,188
,20180412,11335,11360,11375,11375,11235,11235,11305,-125,-55,4,45.22,190
,20180413,11235,11305,,,,11305,11305,0,0,0,0.00,190
,20180416,11305,11305,,,,10925,10925,-380,-380,0,0.00,190
,20180417,10925,10925,10990,11025,10910,10955,10970,30,45,110,"1,207.11",192
,20180418,10955,10970,11035,11065,10945,11010,10995,40,25,82,901.93,166
,20180419,11010,10995,11095,11625,11095,11605,11325,610,330,38,430.50,156
,20180420,11605,11325,11490,11580,11290,11365,11485,40,160,52,597.46,142
,20180423,11365,11485,,,,11485,11485,0,0,0,0.00,142
,20180424,11485,11485,11295,11445,11295,11400,11385,-85,-100,24,273.32,132
,20180425,11400,11385,11415,11465,11415,11465,11435,80,50,14,160.12,134
,20180426,11465,11435,11465,11465,11270,11270,11355,-165,-80,6,68.15,130
,20180427,11270,11355,11145,11165,11080,11085,11120,-270,-235,10,111.23,136
,20180502,11085,11120,11230,11280,11190,11250,11230,130,110,12,134.76,138
,20180503,11250,11230,11430,11455,11360,11385,11385,155,155,20,227.79,136
,20180504,11385,11385,11395,11575,11395,11500,11500,115,115,16,184.03,130
,20180507,11500,11500,11430,11670,11400,11625,11560,125,60,16,184.98,126
,20180508,11625,11560,11545,11590,11545,11590,11560,30,0,6,69.36,130
,20180509,11590,11560,11590,11590,11445,11485,11490,-75,-70,18,206.88,124
,20180510,11485,11490,11385,11535,11385,11535,11475,45,-15,14,160.71,126
,20180511,11535,11475,11540,11570,11465,11540,11525,65,50,34,391.95,126
,20180514,11540,11525,11500,11500,11490,11490,11495,-35,-30,4,45.98,128
,20180515,11490,11495,11510,11510,11460,11460,11475,-35,-20,10,114.77,126
,20180516,11460,11475,11345,11345,11345,11345,11345,-130,-130,4,45.38,128
,20180517,11345,11345,11345,11350,11270,11270,11305,-75,-40,34,384.38,146
,20180518,11270,11305,11335,11620,11335,11585,11510,280,205,14,161.18,146
,20180521,11585,11510,11745,12135,11745,12135,12000,625,490,24,288.04,148
,20180522,12135,12000,12040,12100,11900,11960,11990,-40,-10,18,215.89,154
,20180523,11960,11990,12060,12100,11570,11640,11910,-350,-80,86,"1,024.55",154
,20180524,11640,11910,11685,11715,11650,11650,11675,-260,-235,8,93.40,154
,20180525,11650,11675,11610,11655,11610,11655,11640,-20,-35,10,116.43,154
,20180528,11655,11640,11630,11630,11500,11585,11585,-55,-55,10,115.87,152
,20180529,11585,11585,11705,11725,11705,11715,11715,130,130,8,93.74,156
,20180530,11715,11715,11870,11870,11545,11635,11700,-80,-15,20,234.00,150
,20180531,11635,11700,11410,11525,11410,11495,11475,-205,-225,6,68.86,152
ru1808,20180102,14380,14360,14480,14640,14480,14580,14565,220,205,6,87.40,90
,20180103,14580,14565,14625,14625,14625,14625,14625,60,60,2,29.25,88
,20180104,14625,14625,14465,14465,14465,14465,14465,-160,-160,2,28.93,88
,20180105,14465,14465,,,,14465,14465,0,0,0,0.00,88
,20180108,14465,14465,,,,14395,14395,-70,-70,0,0.00,88
,20180109,14395,14395,14365,14455,14310,14350,14375,-45,-20,20,287.56,82
,20180110,14350,14375,14370,14445,14370,14370,14390,-5,15,8,115.12,84
,20180111,14370,14390,14410,14420,14390,14420,14400,30,10,8,115.23,82
,20180112,14420,14400,14460,14460,14460,14460,14460,60,60,2,28.92,82
,20180115,14460,14460,14555,14730,14555,14730,14600,270,140,8,116.83,88
,20180116,14730,14600,14675,14710,14650,14650,14690,50,90,12,176.29,92
,20180117,14650,14690,14425,14445,14425,14445,14435,-245,-255,4,57.74,92
,20180118,14445,14435,14480,14480,14480,14480,14480,45,45,2,28.96,92
,20180119,14480,14480,14240,14240,14240,14240,14240,-240,-240,2,28.48,92
,20180122,14240,14240,,,,14240,14240,0,0,0,0.00,92
,20180123,14240,14240,14225,14225,13985,14020,14055,-220,-185,14,196.77,92
,20180124,14020,14055,13925,14010,13915,14010,13945,-45,-110,10,139.47,90
,20180125,14010,13945,14005,14035,14005,14035,14020,90,75,4,56.08,88
,20180126,14035,14020,14035,14035,14035,14035,14035,15,15,2,28.07,86
,20180129,14035,14035,13985,14060,13985,14060,14015,25,-20,8,112.13,88
,20180130,14060,14015,13615,13645,13615,13645,13625,-370,-390,8,109.00,88
,20180131,13645,13625,13665,13670,13225,13430,13515,-195,-110,12,162.20,90
,20180201,13430,13515,,,,13515,13515,0,0,0,0.00,90
,20180202,13515,13515,13320,13375,13290,13350,13340,-165,-175,14,186.79,92
,20180205,13350,13340,13270,13355,13270,13355,13310,15,-30,20,266.29,92
,20180206,13355,13310,13360,13360,12915,12940,13285,-370,-25,1270,"16,878.07",1090
,20180207,12940,13285,12945,12990,12900,12990,12925,-295,-360,1040,"13,445.97",164
,20180208,12990,12925,12590,12670,12590,12670,12600,-255,-325,12,151.24,160
,20180209,12670,12600,12620,12620,12605,12605,12610,5,10,10,126.11,152
,20180212,12605,12610,12730,12910,12720,12900,12815,290,205,8,102.52,150
,20180213,12900,12815,,,,12750,12750,-65,-65,0,0.00,150
,20180214,12750,12750,12825,12825,12795,12795,12810,45,60,4,51.24,148
,20180222,12795,12810,12750,12775,12750,12750,12755,-60,-55,6,76.55,150
,20180223,12750,12755,12840,13125,12840,13125,13055,370,300,112,"1,462.43",112
,20180226,13125,13055,,,,13100,13100,45,45,0,0.00,112
,20180227,13100,13100,,,,13100,13100,0,0,0,0.00,112
,20180228,13100,13100,13285,13285,13285,13285,13285,185,185,2,26.57,112
,20180301,13285,13285,13245,13245,13225,13225,13235,-60,-50,22,291.21,106
,20180302,13225,13235,,,,13215,13215,-20,-20,0,0.00,106
,20180305,13215,13215,13255,13325,13255,13325,13290,110,75,4,53.16,106
,20180306,13325,13290,13345,13350,13255,13255,13300,-35,10,20,266.06,102
,20180307,13255,13300,13185,13190,13135,13140,13170,-160,-130,24,316.08,88
,20180308,13140,13170,13245,13265,13135,13135,13195,-35,25,16,211.16,78
,20180309,13135,13195,13240,13280,12905,12905,13160,-290,-35,26,342.26,74
,20180312,12905,13160,12925,13030,12925,13005,13000,-155,-160,14,182.06,72
,20180313,13005,13000,12965,12975,12930,12930,12955,-70,-45,6,77.74,72
,20180314,12930,12955,13135,13135,13135,13135,13135,180,180,2,26.27,72
,20180315,13135,13135,13080,13080,13055,13055,13060,-80,-75,6,78.38,72
,20180316,13055,13060,13020,13075,12770,12830,12985,-230,-75,352,"4,571.79",88
,20180319,12830,12985,12845,12845,12705,12705,12800,-280,-185,18,230.47,88
,20180320,12705,12800,12775,12775,12415,12415,12570,-385,-230,22,276.56,82
,20180321,12415,12570,12530,12530,12530,12530,12530,-40,-40,4,50.12,78
,20180322,12530,12530,12420,12455,12405,12405,12425,-125,-105,6,74.56,80
,20180323,12405,12425,12330,12330,11555,11660,11750,-765,-675,132,"1,551.44",84
,20180326,11660,11750,11530,11550,11195,11290,11430,-460,-320,52,594.44,92
,20180327,11290,11430,11560,11560,11455,11515,11505,85,75,16,184.11,94
,20180328,11515,11505,11500,11505,11410,11505,11470,0,-35,6,68.83,90
,20180329,11505,11470,11410,11410,11410,11410,11410,-60,-60,2,22.82,92
,20180330,11410,11410,11410,11575,11410,11575,11510,165,100,10,115.11,84
,20180402,11575,11510,11545,11545,11450,11450,11505,-60,-5,36,414.34,86
,20180403,11450,11505,11505,11550,11485,11500,11485,-5,-20,114,"1,309.60",138
,20180404,11500,11485,11275,11275,11220,11220,11240,-265,-245,8,89.92,140
,20180409,11220,11240,11300,11380,11270,11380,11300,140,60,22,248.70,126
,20180410,11380,11300,11390,11390,11390,11390,11390,90,90,2,22.78,124
,20180411,11390,11390,,,,11390,11390,0,0,0,0.00,124
,20180412,11390,11390,11300,11445,11300,11435,11370,45,-20,8,90.97,122
,20180413,11435,11370,11400,11450,11400,11450,11425,80,55,4,45.70,122
,20180416,11450,11425,11450,11450,11190,11315,11330,-110,-95,14,158.65,120
,20180417,11315,11330,11000,11100,10975,10975,11020,-355,-310,58,639.40,104
,20180418,10975,11020,11060,11160,11060,11115,11120,95,100,20,222.43,104
,20180419,11115,11120,11275,11690,11240,11690,11400,570,280,14,159.64,106
,20180420,11690,11400,11725,11725,11570,11610,11650,210,250,16,186.45,110
,20180423,11610,11650,11285,11635,11285,11600,11525,-50,-125,10,115.28,110
,20180424,11600,11525,11400,11705,11400,11525,11515,0,-10,88,"1,013.42",112
,20180425,11525,11515,11540,11585,11470,11540,11540,25,25,20,230.83,112
,20180426,11540,11540,11505,11505,11395,11395,11450,-145,-90,28,320.62,132
,20180427,11395,11450,11250,11345,11095,11270,11205,-180,-245,66,739.60,156
,20180502,11270,11205,11330,11390,11280,11390,11340,185,135,62,703.23,136
,20180503,11390,11340,11525,11525,11460,11525,11480,185,140,34,390.46,128
,20180504,11525,11480,11505,11585,11505,11575,11525,95,45,84,968.22,140
,20180507,11575,11525,11485,11770,11465,11720,11550,195,25,74,854.92,108
,20180508,11720,11550,11685,11685,11655,11655,11670,105,120,6,70.04,108
,20180509,11655,11670,11560,11605,11560,11575,11580,-95,-90,18,208.48,106
,20180510,11575,11580,11695,11745,11695,11745,11720,165,140,4,46.88,102
,20180511,11745,11720,11635,11675,11580,11670,11630,-50,-90,92,"1,070.17",110
,20180514,11670,11630,11600,11675,11545,11545,11595,-85,-35,30,347.89,120
,20180515,11545,11595,11525,11600,11280,11350,11375,-245,-220,30,341.28,126
,20180516,11350,11375,11295,11425,11265,11365,11370,-10,-5,34,386.60,142
,20180517,11365,11370,11355,11355,11340,11340,11345,-30,-25,6,68.09,144
,20180518,11340,11345,11645,11740,11570,11620,11615,275,270,50,580.99,136
,20180521,11620,11615,11660,12265,11660,12155,12095,540,480,48,580.67,158
,20180522,12155,12095,12125,12125,12105,12105,12110,10,15,6,72.67,158
,20180523,12105,12110,12125,12135,11680,11725,11915,-385,-195,38,452.92,162
,20180524,11725,11915,11735,11735,11735,11735,11735,-180,-180,2,23.47,162
,20180525,11735,11735,11730,11825,11705,11765,11750,30,15,40,470.18,180
,20180528,11765,11750,,,,11695,11695,-55,-55,0,0.00,180
,20180529,11695,11695,11910,11910,11910,11910,11910,215,215,2,23.82,180
,20180530,11910,11910,11900,11900,11575,11575,11625,-335,-285,62,720.98,176
,20180531,11575,11625,11630,11630,11630,11630,11630,5,5,2,23.26,176
ru1809,20180102,14450,14480,14450,14760,14420,14670,14650,190,170,31726,"464,839.46",41628
,20180103,14670,14650,14670,14775,14585,14625,14650,-25,0,25926,"379,898.98",42712
,20180104,14625,14650,14590,14620,14350,14450,14440,-200,-210,39688,"573,290.91",45770
,20180105,14450,14440,14450,14495,14275,14425,14410,-15,-30,33430,"481,785.29",47022
,20180108,14425,14410,14380,14450,14305,14405,14375,-5,-35,29442,"423,271.17",48552
,20180109,14405,14375,14405,14520,14350,14405,14430,30,55,29616,"427,403.61",49696
,20180110,14405,14430,14440,14595,14320,14375,14435,-55,5,40710,"587,714.11",51348
,20180111,14375,14435,14415,14520,14380,14485,14455,50,20,29492,"426,325.49",53538
,20180112,14485,14455,14530,14695,14505,14595,14610,140,155,45712,"668,046.92",56528
,20180115,14595,14610,14570,14790,14450,14740,14665,130,55,34882,"511,617.53",57468
,20180116,14740,14665,14725,14765,14470,14535,14620,-130,-45,43200,"631,676.12",60938
,20180117,14535,14620,14480,14575,14395,14465,14505,-155,-115,31224,"452,940.53",61720
,20180118,14465,14505,14450,14540,14420,14430,14480,-75,-25,38544,"558,177.49",67042
,20180119,14430,14480,14400,14470,14255,14315,14365,-165,-115,51604,"741,327.31",71066
,20180122,14315,14365,14340,14390,14245,14325,14320,-40,-45,34912,"500,059.02",74602
,20180123,14325,14320,14300,14385,13975,14000,14140,-320,-180,69102,"977,243.66",85796
,20180124,14000,14140,13970,14065,13880,14000,14005,-140,-135,30612,"428,858.23",87518
,20180125,14000,14005,14005,14130,13920,14005,14050,0,45,44666,"627,569.40",90164
,20180126,14005,14050,14000,14115,13990,14025,14055,-25,5,32316,"454,223.50",91444
,20180129,14025,14055,14005,14195,13900,14030,14070,-25,15,40738,"573,296.22",91450
,20180130,14030,14070,14050,14075,13670,13690,13875,-380,-195,58386,"810,135.97",95890
,20180131,13690,13875,13705,13760,13265,13475,13520,-400,-355,72518,"980,757.57",100862
,20180201,13475,13520,13520,13535,13280,13310,13385,-210,-135,44068,"590,038.34",104620
,20180202,13310,13385,13325,13415,13320,13355,13370,-30,-15,32856,"439,303.76",104496
,20180205,13355,13370,13325,13410,13130,13385,13345,15,-25,42770,"570,801.31",105138
,20180206,13385,13345,13385,13450,12890,12955,13135,-390,-210,76506,"1,004,994.85",109986
,20180207,12955,13135,12985,13085,12970,13025,13020,-110,-115,41198,"536,479.01",111676
,20180208,13025,13020,13020,13060,12680,12770,12810,-250,-210,70012,"897,025.62",115604
,20180209,12770,12810,12790,12855,12615,12830,12780,20,-30,54120,"691,701.94",113910
,20180212,12830,12780,12805,13050,12785,12910,12905,130,125,43298,"558,768.99",115546
,20180213,12910,12905,12890,12945,12780,12830,12855,-75,-50,32076,"412,431.00",115350
,20180214,12830,12855,12820,12910,12710,12890,12840,35,-15,38922,"499,860.86",115256
,20180222,12890,12840,12915,13055,12775,12875,12870,35,30,36040,"464,001.38",117888
,20180223,12875,12870,12935,13305,12885,13245,13135,375,265,88136,"1,158,002.36",122720
,20180226,13245,13135,13245,13365,13205,13320,13285,185,150,60312,"801,430.44",125942
,20180227,13320,13285,13330,13345,13160,13280,13245,-5,-40,58764,"778,539.66",129232
,20180228,13280,13245,13250,13455,13110,13400,13325,155,80,81832,"1,090,598.06",134402
,20180301,13400,13325,13405,13440,13295,13355,13365,30,40,52568,"702,675.43",137930
,20180302,13355,13365,13210,13350,13155,13310,13275,-55,-90,51942,"689,754.71",140862
,20180305,13310,13275,13290,13530,13270,13415,13440,140,165,94154,"1,265,870.69",148064
,20180306,13415,13440,13380,13450,13220,13290,13335,-150,-105,78282,"1,044,073.50",151780
,20180307,13290,13335,13310,13325,13200,13245,13260,-90,-75,71126,"943,282.47",157720
,20180308,13245,13260,13195,13390,13110,13275,13265,15,5,87896,"1,166,073.60",158970
,20180309,13275,13265,13260,13395,12920,12990,13155,-275,-110,147106,"1,935,377.91",164334
,20180312,12990,13155,13040,13155,12950,13060,13065,-95,-90,78086,"1,020,198.59",168206
,20180313,13060,13065,13030,13110,12980,13050,13045,-15,-20,65062,"848,771.38",172430
,20180314,13050,13045,13080,13210,13040,13120,13120,75,75,91106,"1,195,709.45",172586
,20180315,13120,13120,13140,13160,13025,13115,13100,-5,-20,73522,"963,473.47",177190
,20180316,13115,13100,13080,13150,12855,12920,12960,-180,-140,127646,"1,654,568.73",189146
,20180319,12920,12960,12940,12950,12760,12830,12840,-130,-120,85340,"1,095,973.79",194686
,20180320,12830,12840,12840,12880,12465,12585,12640,-255,-200,145334,"1,837,284.43",211660
,20180321,12585,12640,12595,12620,12470,12490,12545,-150,-95,87908,"1,103,193.50",220996
,20180322,12490,12545,12450,12610,12415,12455,12505,-90,-40,124246,"1,554,156.68",234148
,20180323,12455,12505,12420,12445,11625,11625,11935,-880,-570,296138,"3,534,540.08",250848
,20180326,11625,11935,11600,11645,11220,11390,11400,-545,-535,364026,"4,150,428.18",265044
,20180327,11390,11400,11410,11635,11385,11555,11530,155,130,192972,"2,225,226.60",277996
,20180328,11555,11530,11600,11605,11300,11450,11455,-80,-75,225020,"2,577,635.46",285246
,20180329,11450,11455,11470,11520,11365,11475,11455,20,0,174240,"1,996,023.45",299770
,20180330,11475,11455,11490,11720,11360,11640,11535,185,80,336264,"3,879,005.12",328200
,20180402,11640,11535,11650,11650,11445,11575,11555,40,20,310676,"3,591,367.89",344968
,20180403,11575,11555,11560,11635,11260,11430,11470,-125,-85,504570,"5,789,907.31",366560
,20180404,11430,11470,11415,11470,11285,11340,11390,-130,-80,336852,"3,837,088.44",380348
,20180409,11340,11390,11395,11495,11340,11450,11415,60,25,289784,"3,308,275.30",396210
,20180410,11450,11415,11470,11675,11425,11580,11555,165,140,477604,"5,518,756.10",407648
,20180411,11580,11555,11595,11685,11405,11480,11545,-75,-10,466266,"5,383,863.57",421774
,20180412,11480,11545,11495,11555,11320,11480,11465,-65,-80,456574,"5,235,701.26",425692
,20180413,11480,11465,11450,11570,11390,11505,11480,40,15,356604,"4,095,416.01",433492
,20180416,11505,11480,11515,11565,11015,11135,11275,-345,-205,745558,"8,408,886.12",488406
,20180417,11135,11275,11180,11185,11040,11090,11110,-185,-165,391828,"4,355,053.04",491768
,20180418,11090,11110,11155,11245,11085,11190,11170,80,60,453036,"5,060,711.48",486982
,20180419,11190,11170,11275,11835,11235,11780,11520,610,350,998972,"11,511,073.62",480006
,20180420,11780,11520,11750,11810,11480,11555,11655,35,135,705064,"8,220,768.52",483408
,20180423,11555,11655,11530,11765,11490,11680,11645,25,-10,566360,"6,596,304.96",493214
,20180424,11680,11645,11605,11665,11400,11530,11550,-115,-95,541200,"6,253,548.68",497460
,20180425,11530,11550,11575,11710,11505,11605,11600,55,50,512218,"5,942,637.52",501432
,20180426,11605,11600,11620,11635,11370,11420,11480,-180,-120,530580,"6,091,143.22",515296
,20180427,11420,11480,11445,11475,11160,11290,11315,-190,-165,638712,"7,230,204.07",522830
,20180502,11290,11315,11395,11600,11310,11525,11450,210,135,397548,"4,553,611.27",511560
,20180503,11525,11450,11520,11610,11440,11605,11525,155,75,420914,"4,852,662.81",516374
,20180504,11605,11525,11610,11720,11555,11615,11625,90,100,599994,"6,975,654.79",517530
,20180507,11615,11625,11595,11920,11510,11765,11705,140,80,692242,"8,105,717.69",524620
,20180508,11765,11705,11785,11800,11675,11735,11740,30,35,387642,"4,552,277.69",525332
,20180509,11735,11740,11730,11730,11520,11605,11610,-135,-130,477848,"5,548,838.66",523126
,20180510,11605,11610,11635,11820,11610,11680,11690,70,80,557260,"6,516,905.12",528030
,20180511,11680,11690,11705,11750,11615,11680,11680,-10,-10,518358,"6,054,822.88",532834
,20180514,11680,11680,11650,11765,11550,11600,11670,-80,-10,515274,"6,013,588.92",539910
,20180515,11600,11670,11560,11660,11325,11440,11465,-230,-205,678582,"7,782,714.60",552476
,20180516,11440,11465,11430,11545,11250,11455,11395,-10,-70,616324,"7,023,661.90",538432
,20180517,11455,11395,11455,11520,11405,11445,11460,50,65,394282,"4,519,473.96",533086
,20180518,11445,11460,11460,11920,11430,11765,11700,305,240,819428,"9,587,786.32",525320
,20180521,11765,11700,11760,12355,11690,12230,12085,530,385,1083342,"13,097,385.91",550932
,20180522,12230,12085,12225,12280,12070,12155,12180,70,95,607234,"7,396,399.88",550316
,20180523,12155,12180,12165,12340,11705,11860,12005,-320,-175,962736,"11,559,236.35",536404
,20180524,11860,12005,11810,11925,11765,11855,11845,-150,-160,440170,"5,213,868.35",532728
,20180525,11855,11845,11850,11950,11720,11875,11860,30,15,560894,"6,652,895.39",529550
,20180528,11875,11860,11840,11850,11610,11720,11760,-140,-100,496938,"5,846,151.72",524036
,20180529,11720,11760,11720,12115,11660,11930,11920,170,160,682104,"8,132,343.85",534696
,20180530,11930,11920,11920,12050,11635,11655,11800,-265,-120,698708,"8,247,916.23",538568
,20180531,11655,11800,11650,11805,11550,11670,11705,-130,-95,461718,"5,405,455.58",536034
ru1810,20180102,14665,14665,,,,14665,14665,0,0,0,0.00,10
,20180103,14665,14665,,,,14665,14665,0,0,0,0.00,10
,20180104,14665,14665,,,,14665,14665,0,0,0,0.00,10
,20180105,14665,14665,,,,14665,14665,0,0,0,0.00,10
,20180108,14665,14665,14450,14450,14330,14330,14390,-335,-275,8,115.12,14
,20180109,14330,14390,14555,14555,14510,14510,14530,120,140,4,58.13,14
,20180110,14510,14530,,,,14530,14530,0,0,0,0.00,14
,20180111,14530,14530,,,,14530,14530,0,0,0,0.00,14
,20180112,14530,14530,,,,14530,14530,0,0,0,0.00,14
,20180115,14530,14530,,,,14560,14560,30,30,0,0.00,14
,20180116,14560,14560,,,,14560,14560,0,0,0,0.00,14
,20180117,14560,14560,,,,14560,14560,0,0,0,0.00,14
,20180118,14560,14560,,,,14560,14560,0,0,0,0.00,14
,20180119,14560,14560,14560,14560,14340,14340,14450,-220,-110,4,57.80,16
,20180122,14340,14450,14450,14450,14450,14450,14450,0,0,2,28.90,18
,20180123,14450,14450,,,,14395,14395,-55,-55,0,0.00,18
,20180124,14395,14395,,,,14365,14365,-30,-30,0,0.00,18
,20180125,14365,14365,,,,14365,14365,0,0,0,0.00,18
,20180126,14365,14365,,,,14365,14365,0,0,0,0.00,18
,20180129,14365,14365,,,,14365,14365,0,0,0,0.00,18
,20180130,14365,14365,,,,14165,14165,-200,-200,0,0.00,18
,20180131,14165,14165,,,,13875,13875,-290,-290,0,0.00,18
,20180201,13875,13875,,,,13740,13740,-135,-135,0,0.00,18
,20180202,13740,13740,,,,13685,13685,-55,-55,0,0.00,18
,20180205,13685,13685,,,,13685,13685,0,0,0,0.00,18
,20180206,13685,13685,,,,13670,13670,-15,-15,0,0.00,18
,20180207,13670,13670,,,,13400,13400,-270,-270,0,0.00,18
,20180208,13400,13400,13110,13110,12800,12800,13035,-600,-365,22,286.84,16
,20180209,12800,13035,12895,12895,12740,12740,12835,-295,-200,16,205.37,22
,20180212,12740,12835,,,,12835,12835,0,0,0,0.00,22
,20180213,12835,12835,,,,12840,12840,5,5,0,0.00,22
,20180214,12840,12840,,,,12840,12840,0,0,0,0.00,22
,20180222,12840,12840,,,,12840,12840,0,0,0,0.00,22
,20180223,12840,12840,13180,13335,13180,13335,13255,495,415,4,53.03,22
,20180226,13335,13255,,,,13255,13255,0,0,0,0.00,22
,20180227,13255,13255,,,,13255,13255,0,0,0,0.00,22
,20180228,13255,13255,,,,13255,13255,0,0,0,0.00,22
,20180301,13255,13255,13515,13515,13430,13505,13480,250,225,10,134.82,20
,20180302,13505,13480,13375,13375,13370,13370,13370,-110,-110,6,80.24,20
,20180305,13370,13370,13575,13575,13575,13575,13575,205,205,6,81.45,26
,20180306,13575,13575,13560,13560,13400,13425,13415,-150,-160,84,"1,126.99",28
,20180307,13425,13415,,,,13415,13415,0,0,0,0.00,28
,20180308,13415,13415,13305,13305,13285,13285,13295,-130,-120,8,106.36,28
,20180309,13285,13295,13200,13200,13200,13200,13200,-95,-95,4,52.80,32
,20180312,13200,13200,13220,13435,13140,13185,13245,-15,45,10,132.46,28
,20180313,13185,13245,13225,13245,13100,13155,13160,-90,-85,18,236.94,32
,20180314,13155,13160,13225,13225,13225,13225,13225,65,65,2,26.45,32
,20180315,13225,13225,13280,13280,13170,13170,13215,-55,-10,8,105.74,34
,20180316,13170,13215,13005,13005,13005,13005,13005,-210,-210,2,26.01,36
,20180319,13005,13005,,,,13005,13005,0,0,0,0.00,36
,20180320,13005,13005,12830,12830,12830,12830,12830,-175,-175,6,76.98,32
,20180321,12830,12830,12715,12715,12655,12690,12675,-140,-155,8,101.43,32
,20180322,12690,12675,12660,12680,12505,12560,12615,-115,-60,20,252.33,40
,20180323,12560,12615,12050,12050,11730,11730,11880,-885,-735,6,71.28,42
,20180326,11730,11880,11580,11595,11455,11520,11535,-360,-345,116,"1,338.21",64
,20180327,11520,11535,11685,11765,11660,11725,11685,190,150,32,373.94,50
,20180328,11725,11685,11700,11700,11495,11495,11545,-190,-140,8,92.37,54
,20180329,11495,11545,11610,11610,11610,11610,11610,65,65,4,46.44,54
,20180330,11610,11610,11490,11795,11490,11795,11690,185,80,38,444.30,48
,20180402,11795,11690,11615,11715,11610,11715,11680,25,-10,22,256.96,56
,20180403,11715,11680,11735,11735,11395,11540,11530,-140,-150,38,438.14,74
,20180404,11540,11530,11575,11575,11490,11490,11525,-40,-5,14,161.41,80
,20180409,11490,11525,11515,11600,11510,11525,11545,0,20,42,484.91,76
,20180410,11525,11545,11640,11730,11640,11730,11685,185,140,12,140.25,68
,20180411,11730,11685,11665,11760,11580,11580,11665,-105,-20,22,256.72,60
,20180412,11580,11665,11580,11685,11475,11580,11595,-85,-70,46,533.55,76
,20180413,11580,11595,11580,11600,11580,11585,11590,-10,-5,14,162.28,66
,20180416,11585,11590,11555,11555,11205,11215,11385,-375,-205,36,410.00,88
,20180417,11215,11385,11260,11290,11190,11190,11240,-195,-145,16,179.85,96
,20180418,11190,11240,11325,11325,11280,11300,11305,60,65,28,316.57,102
,20180419,11300,11305,11450,11955,11425,11855,11610,550,305,94,"1,091.59",66
,20180420,11855,11610,11850,11860,11700,11700,11785,90,175,28,330.07,66
,20180423,11700,11785,11710,11885,11640,11855,11745,70,-40,68,798.99,84
,20180424,11855,11745,11725,11750,11680,11695,11725,-50,-20,54,633.26,112
,20180425,11695,11725,11675,11685,11675,11685,11680,-40,-45,12,140.20,122
,20180426,11685,11680,11630,11640,11510,11545,11575,-135,-105,14,162.08,122
,20180427,11545,11575,11430,11470,11325,11335,11375,-240,-200,22,250.30,124
,20180502,11335,11375,11515,11655,11470,11640,11570,265,195,18,208.34,112
,20180503,11640,11570,11705,11705,11595,11595,11660,25,90,10,116.63,108
,20180504,11595,11660,11795,12390,10940,11820,11765,160,105,112,"1,317.84",170
,20180507,11820,11765,11735,12000,11675,11850,11875,85,110,18,213.83,184
,20180508,11850,11875,,,,11875,11875,0,0,0,0.00,184
,20180509,11875,11875,11695,11750,11530,11690,11665,-185,-210,270,"3,150.87",128
,20180510,11690,11665,11800,12480,11715,11720,11885,55,220,148,"1,759.60",114
,20180511,11720,11885,11785,11865,11745,11805,11800,-80,-85,40,472.01,126
,20180514,11805,11800,11785,11870,11730,11730,11800,-70,0,40,472.01,122
,20180515,11730,11800,11760,11760,11455,11525,11535,-275,-265,28,323.02,134
,20180516,11525,11535,11505,11645,11455,11645,11500,110,-35,24,276.11,140
,20180517,11645,11500,11590,11620,11565,11565,11585,65,85,8,92.71,138
,20180518,11565,11585,11860,11890,11815,11860,11850,275,265,34,403.04,132
,20180521,11860,11850,11890,12435,11890,12345,12240,495,390,110,"1,346.67",100
,20180522,12345,12240,12365,12365,12195,12250,12270,10,30,20,245.46,100
,20180523,12250,12270,12390,12390,11775,11970,11940,-300,-330,420,"5,016.14",148
,20180524,11970,11940,11950,11990,11935,11955,11960,15,20,24,287.10,148
,20180525,11955,11960,11850,11850,11850,11850,11850,-110,-110,2,23.70,148
,20180528,11850,11850,11920,11940,11855,11855,11900,5,50,14,166.61,152
,20180529,11855,11900,11800,12195,11800,12065,12065,165,165,20,241.33,150
,20180530,12065,12065,11845,11925,11735,11800,11800,-265,-265,82,967.73,148
,20180531,11800,11800,11720,11895,11720,11865,11755,65,-45,88,"1,034.69",158
ru1811,20180102,14630,14675,14800,14800,14775,14775,14780,100,105,6,88.70,100
,20180103,14775,14780,14800,14800,14780,14780,14795,0,15,10,147.96,100
,20180104,14780,14795,14565,14600,14565,14600,14580,-195,-215,6,87.50,98
,20180105,14600,14580,14590,14595,14500,14595,14545,15,-35,10,145.46,102
,20180108,14595,14545,14585,14585,14585,14585,14585,40,40,2,29.17,104
,20180109,14585,14585,14605,14625,14585,14625,14610,40,25,10,146.13,110
,20180110,14625,14610,14560,14745,14555,14580,14600,-30,-10,30,438.12,124
,20180111,14580,14600,14650,14650,14615,14615,14630,15,30,4,58.53,128
,20180112,14615,14630,14705,15450,14705,14735,14800,105,170,36,532.84,124
,20180115,14735,14800,14700,14895,14700,14865,14780,65,-20,16,236.55,120
,20180116,14865,14780,14845,14845,14640,14640,14750,-140,-30,10,147.51,124
,20180117,14640,14750,14595,14595,14595,14595,14595,-155,-155,4,58.38,120
,20180118,14595,14595,14630,14630,14630,14630,14630,35,35,2,29.26,118
,20180119,14630,14630,14605,14605,14445,14445,14510,-185,-120,18,261.22,120
,20180122,14445,14510,14460,14530,14460,14500,14490,-10,-20,12,173.91,126
,20180123,14500,14490,14505,14510,14180,14180,14365,-310,-125,38,546.00,140
,20180124,14180,14365,14135,14195,14135,14180,14170,-185,-195,36,510.23,150
,20180125,14180,14170,14155,14265,14135,14210,14205,40,35,28,397.78,150
,20180126,14210,14205,14185,14280,14180,14180,14205,-25,0,16,227.30,146
,20180129,14180,14205,14235,14290,14180,14180,14245,-25,40,14,199.46,138
,20180130,14180,14245,14175,14200,13860,13915,14060,-330,-185,34,478.11,146
,20180131,13915,14060,13920,13980,13500,13655,13630,-405,-430,164,"2,235.67",230
,20180201,13655,13630,13630,13630,13470,13470,13535,-160,-95,26,351.94,236
,20180202,13470,13535,13525,13565,13525,13545,13535,10,0,18,243.69,228
,20180205,13545,13535,13415,13560,13320,13560,13465,25,-70,16,215.44,230
,20180206,13560,13465,13570,13570,13095,13165,13295,-300,-170,92,"1,223.33",302
,20180207,13165,13295,13230,13240,13200,13205,13225,-90,-70,14,185.17,302
,20180208,13205,13225,13190,13190,12910,12935,12990,-290,-235,54,701.66,344
,20180209,12935,12990,12985,13030,12880,13030,12965,40,-25,20,259.31,346
,20180212,13030,12965,13040,13135,13015,13125,13085,160,120,12,157.07,346
,20180213,13125,13085,13000,13135,12980,13100,13025,15,-60,54,703.41,352
,20180214,13100,13025,13015,13015,13015,13015,13015,-10,-10,2,26.03,352
,20180222,13015,13015,,,,13055,13055,40,40,0,0.00,352
,20180223,13055,13055,13180,13470,13175,13385,13290,330,235,32,425.37,352
,20180226,13385,13290,13435,13580,13420,13525,13485,235,195,44,593.50,348
,20180227,13525,13485,13530,13555,13385,13495,13485,10,0,76,"1,025.22",374
,20180228,13495,13485,13445,13630,13445,13565,13565,80,80,64,868.16,382
,20180301,13565,13565,13560,13570,13480,13515,13535,-50,-30,48,649.77,394
,20180302,13515,13535,13500,13520,13500,13520,13510,-15,-25,4,54.04,392
,20180305,13520,13510,13640,13700,13570,13570,13625,60,115,24,327.11,388
,20180306,13570,13625,13470,13520,13470,13520,13485,-105,-140,6,80.92,388
,20180307,13520,13485,13440,13460,13390,13460,13420,-25,-65,18,241.61,394
,20180308,13460,13420,13395,13525,13395,13410,13485,-10,65,160,"2,158.30",398
,20180309,13410,13485,13540,13540,13160,13160,13260,-325,-225,40,530.54,418
,20180312,13160,13260,13225,13270,13225,13245,13240,-15,-20,22,291.31,422
,20180313,13245,13240,13250,13250,13150,13185,13190,-55,-50,26,343.02,422
,20180314,13185,13190,13320,13325,13255,13290,13285,100,95,34,451.80,440
,20180315,13290,13285,13245,13270,13215,13230,13225,-55,-60,74,978.95,454
,20180316,13230,13225,13230,13295,13045,13050,13125,-175,-100,44,577.57,460
,20180319,13050,13125,13050,13050,12915,12990,12975,-135,-150,80,"1,038.29",490
,20180320,12990,12975,13000,13000,12665,12715,12795,-260,-180,54,691.04,514
,20180321,12715,12795,12735,12755,12620,12630,12700,-165,-95,406,"5,157.11",868
,20180322,12630,12700,12630,12770,12565,12595,12645,-105,-55,96,"1,214.33",918
,20180323,12595,12645,12575,12575,11755,11755,11900,-890,-745,664,"7,903.84",1212
,20180326,11755,11900,11790,11790,11410,11580,11600,-320,-300,422,"4,895.82",1384
,20180327,11580,11600,11600,11800,11600,11700,11695,100,95,606,"7,088.29",1602
,20180328,11700,11695,11765,11765,11490,11600,11600,-95,-95,308,"3,574.02",1640
,20180329,11600,11600,11625,11680,11555,11650,11625,50,25,254,"2,953.79",1722
,20180330,11650,11625,11650,11870,11555,11805,11720,180,95,312,"3,657.65",1802
,20180402,11805,11720,11745,11780,11640,11770,11720,50,0,368,"4,314.54",1946
,20180403,11770,11720,11735,11825,11460,11625,11615,-95,-105,468,"5,436.55",2164
,20180404,11625,11615,11615,11625,11500,11530,11580,-85,-35,380,"4,402.26",2360
,20180409,11530,11580,11555,11645,11555,11635,11600,55,20,188,"2,181.16",2414
,20180410,11635,11600,11635,11840,11615,11745,11760,145,160,514,"6,045.53",2442
,20180411,11745,11760,11740,11830,11560,11640,11705,-120,-55,1294,"15,150.04",3054
,20180412,11640,11705,11645,11680,11480,11595,11615,-110,-90,1708,"19,843.23",4086
,20180413,11595,11615,11580,11695,11540,11610,11610,-5,-5,326,"3,785.43",4200
,20180416,11610,11610,11645,11680,11180,11305,11375,-305,-235,1012,"11,515.73",4682
,20180417,11305,11375,11285,11320,11200,11250,11260,-125,-115,428,"4,819.69",4760
,20180418,11250,11260,11270,11390,11245,11340,11295,80,35,1842,"20,806.91",5064
,20180419,11340,11295,11390,11930,11380,11870,11675,575,380,1598,"18,661.65",5420
,20180420,11870,11675,11895,11925,11610,11685,11755,10,80,1630,"19,160.66",5730
,20180423,11685,11755,11645,11890,11645,11805,11810,50,55,860,"10,158.10",5762
,20180424,11805,11810,11735,11780,11565,11680,11700,-130,-110,1100,"12,875.09",5618
,20180425,11680,11700,11725,11830,11660,11775,11725,75,25,734,"8,606.67",5772
,20180426,11775,11725,11740,11760,11515,11570,11630,-155,-95,880,"10,234.62",5960
,20180427,11570,11630,11590,11620,11335,11430,11425,-200,-205,2074,"23,697.90",6680
,20180502,11430,11425,11575,11730,11470,11670,11600,245,175,556,"6,451.17",6644
,20180503,11670,11600,11700,11755,11605,11735,11685,135,85,572,"6,684.61",6730
,20180504,11735,11685,11750,11850,11715,11770,11775,85,90,894,"10,530.13",6716
,20180507,11770,11775,11755,12045,11660,11930,11870,155,95,1090,"12,942.36",6736
,20180508,11930,11870,11920,11950,11845,11890,11900,20,30,422,"5,022.68",6786
,20180509,11890,11900,11830,11830,11690,11775,11760,-125,-140,1112,"13,082.53",7122
,20180510,11775,11760,11800,11970,11775,11845,11845,85,85,1140,"13,508.59",7188
,20180511,11845,11845,11870,11905,11780,11855,11835,10,-10,740,"8,759.81",7320
,20180514,11855,11835,11815,11925,11715,11770,11830,-65,-5,700,"8,281.77",7392
,20180515,11770,11830,11755,11820,11495,11605,11610,-225,-220,1476,"17,143.36",7860
,20180516,11605,11610,11645,11705,11420,11640,11570,30,-40,1626,"18,812.97",8150
,20180517,11640,11570,11650,11675,11580,11605,11625,35,55,1954,"22,719.15",7970
,20180518,11605,11625,11605,12075,11605,11900,11885,275,260,4674,"55,569.47",9024
,20180521,11900,11885,11915,12500,11850,12410,12255,525,370,3352,"41,079.72",8926
,20180522,12410,12255,12380,12450,12245,12320,12325,65,70,2712,"33,426.10",9062
,20180523,12320,12325,12325,12495,11880,12020,12055,-305,-270,4240,"51,126.17",8890
,20180524,12020,12055,11990,12075,11935,12025,12000,-30,-55,1382,"16,584.89",8942
,20180525,12025,12000,12040,12115,11895,12050,12020,50,20,1224,"14,714.95",8682
,20180528,12050,12020,11980,12020,11805,11885,11960,-135,-60,2720,"32,534.08",8174
,20180529,11885,11960,11870,12260,11845,12105,12025,145,65,1750,"21,048.63",8178
,20180530,12105,12025,12100,12200,11800,11830,11960,-195,-65,1636,"19,574.22",8318
,20180531,11830,11960,11810,11970,11750,11850,11870,-110,-90,1026,"12,180.69",8320
ru1901,20180116,14780,14780,16300,16725,16200,16355,16500,1575,1720,7438,"122,738.61",4596
,20180117,16355,16500,16310,16380,16240,16260,16320,-240,-180,3622,"59,123.54",6644
,20180118,16260,16320,16230,16325,16230,16250,16270,-70,-50,3482,"56,662.52",8298
,20180119,16250,16270,16230,16280,16090,16170,16185,-100,-85,3354,"54,294.48",9402
,20180122,16170,16185,16190,16250,16125,16180,16180,-5,-5,3544,"57,355.20",11300
,20180123,16180,16180,16185,16235,15855,15935,16035,-245,-145,3850,"61,753.94",12126
,20180124,15935,16035,15845,15955,15845,15890,15905,-145,-130,2684,"42,701.04",12996
,20180125,15890,15905,15980,16015,15830,15915,15950,10,45,2858,"45,591.14",14026
,20180126,15915,15950,15915,16005,15905,15910,15945,-40,-5,1940,"30,939.24",14812
,20180129,15910,15945,15890,16080,15850,15905,15960,-40,15,2430,"38,785.30",15194
,20180130,15905,15960,15925,15950,15530,15545,15800,-415,-160,3570,"56,423.34",16416
,20180131,15545,15800,15640,15640,15180,15405,15400,-395,-400,5158,"79,441.23",16118
,20180201,15405,15400,15445,15450,15220,15245,15310,-155,-90,4332,"66,333.81",17276
,20180202,15245,15310,15290,15410,15285,15310,15340,0,30,4102,"62,929.57",17732
,20180205,15310,15340,15270,15400,15165,15400,15340,60,0,3606,"55,329.06",18394
,20180206,15400,15340,15395,15420,15005,15095,15145,-245,-195,6808,"103,115.81",18812
,20180207,15095,15145,15100,15215,15070,15180,15155,35,10,3890,"58,962.02",20262
,20180208,15180,15155,15170,15215,14850,14935,14995,-220,-160,6296,"94,414.45",20810
,20180209,14935,14995,14950,15015,14800,15000,14945,5,-50,3726,"55,698.34",21540
,20180212,15000,14945,15020,15200,14960,15070,15085,125,140,2952,"44,537.94",21764
,20180213,15070,15085,15075,15085,14960,14995,15025,-90,-60,2556,"38,404.45",22602
,20180214,14995,15025,14950,15055,14865,15000,14990,-25,-35,3084,"46,230.89",23246
,20180222,15000,14990,15065,15165,14950,15080,15045,90,55,2350,"35,356.88",23738
,20180223,15080,15045,15080,15415,15075,15365,15280,320,235,5398,"82,486.99",25648
,20180226,15365,15280,15310,15490,15310,15455,15420,175,140,3408,"52,551.94",26132
,20180227,15455,15420,15445,15490,15325,15450,15395,30,-25,2916,"44,903.44",26338
,20180228,15450,15395,15440,15610,15300,15550,15490,155,95,4180,"64,761.29",27008
,20180301,15550,15490,15540,15580,15425,15460,15485,-30,-5,3998,"61,910.51",28046
,20180302,15460,15485,15400,15470,15240,15435,15410,-50,-75,3432,"52,897.93",28448
,20180305,15435,15410,15415,15630,15415,15450,15520,40,110,7836,"121,616.28",31226
,20180306,15450,15520,15420,15470,15280,15330,15355,-190,-165,8040,"123,484.19",32090
,20180307,15330,15355,15340,15365,15220,15240,15275,-115,-80,7246,"110,687.36",33636
,20180308,15240,15275,15220,15355,15140,15230,15250,-45,-25,6664,"101,654.20",33798
,20180309,15230,15250,15235,15380,14915,15015,15145,-235,-105,7224,"109,424.13",33708
,20180312,15015,15145,15070,15125,14990,15060,15055,-85,-90,4388,"66,080.71",34258
,20180313,15060,15055,15050,15095,14855,14955,14930,-100,-125,8408,"125,567.45",37100
,20180314,14955,14930,14950,15050,14910,14920,14965,-10,35,8290,"124,091.78",38806
,20180315,14920,14965,14970,14995,14775,14860,14875,-105,-90,11292,"167,982.81",41932
,20180316,14860,14875,14775,14885,14555,14795,14710,-80,-165,19854,"292,073.06",44536
,20180319,14795,14710,14800,14835,14585,14730,14700,20,-10,11504,"169,166.24",45172
,20180320,14730,14700,14730,14760,14480,14575,14605,-125,-95,14484,"211,541.43",44542
,20180321,14575,14605,14595,14665,14500,14510,14575,-95,-30,10984,"160,096.14",45160
,20180322,14510,14575,14510,14595,14270,14310,14425,-265,-150,14616,"210,895.10",48942
,20180323,14310,14425,14310,14310,13415,13415,13760,-1010,-665,34056,"468,641.64",51660
,20180326,13415,13760,13465,13600,13225,13390,13390,-370,-370,31372,"420,134.91",50008
,20180327,13390,13390,13415,13710,13395,13610,13580,220,190,14768,"200,557.72",50400
,20180328,13610,13580,13600,13650,13400,13500,13510,-80,-70,11432,"154,469.06",50762
,20180329,13500,13510,13455,13560,13455,13530,13505,20,-5,7820,"105,639.17",50804
,20180330,13530,13505,13570,13810,13455,13715,13605,210,100,12450,"169,387.61",50734
,20180402,13715,13605,13705,13745,13565,13695,13645,90,40,10096,"137,773.94",52626
,20180403,13695,13645,13695,13750,13465,13510,13580,-135,-65,15078,"204,773.76",53960
,20180404,13510,13580,13535,13550,13380,13415,13480,-165,-100,12764,"172,113.22",55108
,20180409,13415,13480,13485,13580,13435,13510,13490,30,10,10346,"139,579.91",56752
,20180410,13510,13490,13525,13700,13490,13650,13600,160,110,12324,"167,656.64",58598
,20180411,13650,13600,13655,13705,13465,13525,13580,-75,-20,11312,"153,645.43",59788
,20180412,13525,13580,13540,13615,13410,13545,13530,-35,-50,15814,"214,028.55",62180
,20180413,13545,13530,13510,13650,13500,13590,13575,60,45,11836,"160,685.44",64110
,20180416,13590,13575,13585,13630,13105,13215,13350,-360,-225,21430,"286,183.54",65112
,20180417,13215,13350,13200,13295,13110,13145,13185,-205,-165,14924,"196,810.63",66548
,20180418,13145,13185,13160,13295,13155,13235,13230,50,45,12982,"171,759.26",67784
,20180419,13235,13230,13260,13850,13260,13800,13570,570,340,40814,"553,848.29",70360
,20180420,13800,13570,13765,13810,13450,13515,13630,-55,60,30444,"414,976.78",74830
,20180423,13515,13630,13515,13700,13450,13535,13580,-95,-50,34118,"463,323.56",79796
,20180424,13535,13580,13435,13535,13270,13420,13425,-160,-155,25124,"337,362.47",81372
,20180425,13420,13425,13435,13610,13405,13530,13500,105,75,20366,"274,941.07",82648
,20180426,13530,13500,13535,13550,13370,13440,13445,-60,-55,31716,"426,555.27",81602
,20180427,13440,13445,13440,13480,13150,13280,13315,-165,-130,37076,"493,783.55",85018
,20180502,13280,13315,13365,13545,13290,13495,13420,180,105,27618,"370,671.67",86370
,20180503,13495,13420,13500,13575,13445,13560,13510,140,90,29650,"400,675.14",88440
,20180504,13560,13510,13590,13680,13535,13570,13585,60,75,41136,"558,925.91",90294
,20180507,13570,13585,13530,13815,13455,13705,13640,120,55,50936,"694,803.83",92374
,20180508,13705,13640,13705,13730,13615,13660,13675,20,35,27002,"369,339.83",92610
,20180509,13660,13675,13625,13650,13470,13545,13560,-130,-115,37048,"502,379.55",93294
,20180510,13545,13560,13570,13745,13545,13615,13620,55,60,37414,"509,619.66",95302
,20180511,13615,13620,13635,13660,13560,13605,13610,-15,-10,30498,"415,123.34",97254
,20180514,13605,13610,13595,13695,13490,13565,13605,-45,-5,35660,"485,195.07",97510
,20180515,13565,13605,13505,13620,13320,13435,13450,-170,-155,59142,"795,551.69",98054
,20180516,13435,13450,13450,13530,13265,13425,13390,-25,-60,60112,"805,127.45",97702
,20180517,13425,13390,13425,13510,13400,13435,13445,45,55,30962,"416,360.36",99202
,20180518,13435,13445,13420,13880,13415,13740,13680,295,235,71168,"973,707.45",105382
,20180521,13740,13680,13735,14390,13665,14275,14095,595,415,116806,"1,646,397.98",115954
,20180522,14275,14095,14250,14375,14105,14200,14235,105,140,66884,"952,405.80",119098
,20180523,14200,14235,14200,14390,13760,13925,14070,-310,-165,104842,"1,475,331.76",118336
,20180524,13925,14070,13890,13995,13810,13930,13905,-140,-165,44852,"623,749.99",118236
,20180525,13930,13905,13900,14035,13820,13945,13945,40,40,54792,"764,075.76",119630
,20180528,13945,13945,13890,13905,13700,13800,13835,-145,-110,52462,"725,984.68",118770
,20180529,13800,13835,13780,14150,13750,13990,13975,155,140,71824,"1,003,790.93",123000
,20180530,13990,13975,13975,14100,13710,13715,13875,-260,-100,71958,"998,444.58",123292
,20180531,13715,13875,13700,13880,13565,13760,13785,-115,-90,50638,"698,099.41",124070
ru1903,20180316,14875,14875,14900,14900,14455,14835,14750,-40,-125,18,265.58,6
,20180319,14835,14750,14885,14885,14800,14800,14830,50,80,6,89.00,6
,20180320,14800,14830,14765,14780,14670,14670,14730,-160,-100,12,176.77,6
,20180321,14670,14730,,,,14675,14675,-55,-55,0,0.00,6
,20180322,14675,14675,14575,14575,14390,14390,14475,-285,-200,8,115.81,8
,20180323,14390,14475,14370,14370,13460,13460,13660,-1015,-815,40,546.52,16
,20180326,13460,13660,13635,13635,13380,13495,13510,-165,-150,22,297.30,22
,20180327,13495,13510,13580,13805,13580,13695,13745,185,235,14,192.47,26
,20180328,13695,13745,13625,13625,13530,13620,13600,-125,-145,10,136.01,24
,20180329,13620,13600,13675,13675,13675,13675,13675,75,75,2,27.35,24
,20180330,13675,13675,13850,13850,13850,13850,13850,175,175,2,27.70,26
,20180402,13850,13850,13740,13740,13735,13735,13735,-115,-115,6,82.43,26
,20180403,13735,13735,13785,13810,13595,13635,13710,-100,-25,14,191.95,26
,20180404,13635,13710,13650,13670,13510,13510,13625,-200,-85,20,272.56,28
,20180409,13510,13625,13640,13695,13565,13695,13630,70,5,10,136.31,30
,20180410,13695,13630,13715,13715,13675,13680,13685,50,55,8,109.50,34
,20180411,13680,13685,13605,13620,13605,13620,13610,-65,-75,6,81.66,28
,20180412,13620,13610,13655,13735,13655,13735,13705,125,95,6,82.25,28
,20180413,13735,13705,,,,13705,13705,0,0,0,0.00,28
,20180416,13705,13705,13700,13700,13260,13335,13450,-370,-255,36,484.27,34
,20180417,13335,13450,13270,13270,13270,13270,13270,-180,-180,2,26.54,32
,20180418,13270,13270,13325,13415,13325,13335,13350,65,80,8,106.83,32
,20180419,13335,13350,13500,13880,13500,13880,13730,530,380,10,137.31,28
,20180420,13880,13730,13965,13965,13735,13735,13855,5,125,8,110.87,30
,20180423,13735,13855,13665,13815,13650,13650,13715,-205,-140,14,192.07,34
,20180424,13650,13715,13600,13655,13510,13555,13590,-160,-125,18,244.68,32
,20180425,13555,13590,,,,13655,13655,65,65,0,0.00,32
,20180426,13655,13655,,,,13640,13640,-15,-15,0,0.00,32
,20180427,13640,13640,13570,13570,13300,13400,13365,-240,-275,44,588.13,40
,20180502,13400,13365,13445,13445,13445,13445,13445,80,80,2,26.89,38
,20180503,13445,13445,13725,13725,13635,13670,13660,225,215,10,136.64,40
,20180504,13670,13660,,,,13670,13670,10,10,0,0.00,40
,20180507,13670,13670,13695,13900,13695,13890,13820,220,150,12,165.84,42
,20180508,13890,13820,13900,13915,13870,13890,13890,70,70,12,166.71,52
,20180509,13890,13890,13680,13780,13660,13775,13725,-115,-165,16,219.66,58
,20180510,13775,13725,14175,14175,13765,13765,13970,40,245,4,55.88,58
,20180511,13765,13970,13835,13835,13835,13835,13835,-135,-135,2,27.67,60
,20180514,13835,13835,,,,13835,13835,0,0,0,0.00,60
,20180515,13835,13835,,,,13680,13680,-155,-155,0,0.00,60
,20180516,13680,13680,13510,13580,13510,13580,13545,-100,-135,4,54.18,60
,20180517,13580,13545,13665,13665,13665,13665,13665,120,120,2,27.33,62
,20180518,13665,13665,13920,13920,13920,13920,13920,255,255,2,27.84,62
,20180521,13920,13920,13950,14545,13950,14480,14335,560,415,14,200.72,64
,20180522,14480,14335,14460,14550,14255,14335,14365,0,30,58,833.20,68
,20180523,14335,14365,14605,14605,13980,14120,14295,-245,-70,30,428.92,66
,20180524,14120,14295,14075,14150,14030,14140,14100,-155,-195,14,197.46,66
,20180525,14140,14100,14165,14165,14165,14165,14165,65,65,2,28.33,66
,20180528,14165,14165,14030,14030,14030,14030,14030,-135,-135,2,28.06,66
,20180529,14030,14030,14065,14285,14040,14285,14095,255,65,16,225.59,68
,20180530,14285,14095,14240,14240,14040,14040,14105,-55,10,6,84.64,66
,20180531,14040,14105,14065,14065,14010,14010,14035,-95,-70,4,56.15,70
ru1904,20180417,13450,13450,,,,13450,13450,0,0,0,0.00,0
,20180418,13450,13450,13510,13510,13470,13470,13500,20,50,10,135.02,10
,20180419,13470,13500,13595,13705,13595,13705,13650,205,150,4,54.60,12
,20180420,13705,13650,13920,13965,13600,13630,13740,-20,90,26,357.29,20
,20180423,13630,13740,13645,13715,13645,13700,13685,-40,-55,6,82.12,20
,20180424,13700,13685,13605,13605,13550,13550,13575,-135,-110,4,54.31,20
,20180425,13550,13575,,,,13650,13650,75,75,0,0.00,20
,20180426,13650,13650,13600,13620,13600,13620,13610,-30,-40,4,54.44,22
,20180427,13620,13610,13610,13610,13400,13400,13505,-210,-105,4,54.02,22
,20180502,13400,13505,13595,13610,13595,13610,13600,105,95,4,54.41,20
,20180503,13610,13600,13730,13730,13630,13630,13675,30,75,14,191.51,22
,20180504,13630,13675,13770,13770,13770,13770,13770,95,95,2,27.54,22
,20180507,13770,13770,13975,13975,13825,13825,13900,55,130,4,55.60,24
,20180508,13825,13900,13865,13955,13785,13920,13875,20,-25,10,138.76,26
,20180509,13920,13875,13700,13820,13700,13820,13740,-55,-135,6,82.44,30
,20180510,13820,13740,13960,13960,13835,13835,13880,95,140,6,83.28,30
,20180511,13835,13880,13880,13880,13835,13835,13855,-45,-25,4,55.43,30
,20180514,13835,13855,,,,13855,13855,0,0,0,0.00,30
,20180515,13855,13855,13715,13730,13655,13655,13690,-200,-165,10,136.92,28
,20180516,13655,13690,13875,13875,13600,13660,13650,-30,-40,16,218.42,30
,20180517,13660,13650,,,,13650,13650,0,0,0,0.00,30
,20180518,13650,13650,14000,14000,14000,14000,14000,350,350,4,56.00,34
,20180521,14000,14000,14010,14545,14010,14545,14275,545,275,4,57.11,36
,20180522,14545,14275,,,,14275,14275,0,0,0,0.00,36
,20180523,14275,14275,14175,14180,13990,14100,14095,-175,-180,38,535.73,42
,20180524,14100,14095,14120,14120,14085,14085,14100,-10,5,6,84.62,46
,20180525,14085,14100,14090,14090,14090,14090,14090,-10,-10,2,28.18,44
,20180528,14090,14090,,,,14090,14090,0,0,0,0.00,44
,20180529,14090,14090,14110,14290,14110,14290,14235,200,145,60,854.23,48
,20180530,14290,14235,14040,14040,14040,14040,14040,-195,-195,2,28.08,46
,20180531,14040,14040,,,,14015,14015,-25,-25,0,0.00,46
ru1905,20180516,13690,13690,13700,13810,13550,13695,13665,5,-25,1372,"18,751.83",740
,20180517,13695,13665,13700,13800,13685,13720,13745,55,80,1178,"16,192.67",1260
,20180518,13720,13745,13740,14150,13720,14025,13940,280,195,1836,"25,600.36",1498
,20180521,14025,13940,14000,14655,13950,14585,14420,645,480,3102,"44,731.59",2412
,20180522,14585,14420,14550,14700,14410,14500,14560,80,140,1970,"28,685.23",2856
,20180523,14500,14560,14490,14680,14105,14210,14380,-350,-180,3804,"54,705.85",3336
,20180524,14210,14380,14160,14295,14125,14230,14210,-150,-170,1412,"20,066.07",3678
,20180525,14230,14210,14225,14325,14125,14240,14225,30,15,1626,"23,130.25",3706
,20180528,14240,14225,14160,14210,14020,14105,14135,-120,-90,1238,"17,501.48",3804
,20180529,14105,14135,14100,14415,14025,14295,14205,160,70,4202,"59,704.14",4812
,20180530,14295,14205,14260,14380,14005,14025,14150,-180,-55,3812,"53,955.30",5170
,20180531,14025,14150,14000,14160,13925,14045,14070,-105,-80,2234,"31,436.71",5506
sn1801,20180102,142800,142640,143320,144400,143010,143410,143550,770,910,1328,"19,064.10",4972
,20180103,143410,143550,143850,143850,142140,142730,142470,-820,-1080,1152,"16,412.99",4196
,20180104,142730,142470,142730,143200,141800,143200,142540,730,70,256,"3,649.20",4072
,20180105,143200,142540,142260,143140,142260,143140,142700,600,160,136,"1,940.79",4056
,20180108,143140,142700,142700,142910,142000,142450,142570,-250,-130,244,"3,478.91",3948
,20180109,142450,142570,142110,142900,142010,142800,142430,230,-140,800,"11,394.64",3424
,20180110,142800,142430,142600,143590,142600,143490,143200,1060,770,348,"4,983.60",3284
,20180111,143490,143200,,,,143600,143600,400,400,0,0.00,3284
,20180112,143600,143600,143500,143600,143410,143410,143430,-190,-170,328,"4,704.62",3260
,20180115,143410,143430,143430,144500,141000,143300,143320,-130,-110,260,"3,726.36",3260
sn1802,20180102,139310,139310,,,,142730,142730,3420,3420,0,0.00,8
,20180103,142730,142730,,,,142730,142730,0,0,0,0.00,8
,20180104,142730,142730,143800,143800,143320,143320,143560,590,830,4,57.42,6
,20180105,143320,143560,,,,143560,143560,0,0,0,0.00,6
,20180108,143560,143560,142660,142660,142660,142660,142660,-900,-900,2,28.53,8
,20180109,142660,142660,142050,142050,142050,142050,142050,-610,-610,2,28.41,6
,20180110,142050,142050,,,,142820,142820,770,770,0,0.00,6
,20180111,142820,142820,,,,142820,142820,0,0,0,0.00,6
,20180112,142820,142820,,,,142820,142820,0,0,0,0.00,6
,20180115,142820,142820,142310,144380,142210,142210,142890,-610,70,14,200.05,6
,20180116,142210,142890,,,,142890,142890,0,0,0,0.00,6
,20180117,142890,142890,141220,143330,141220,143330,142620,440,-270,6,85.57,4
,20180118,143330,142620,,,,142620,142620,0,0,0,0.00,4
,20180119,142620,142620,,,,142620,142620,0,0,0,0.00,4
,20180122,142620,142620,,,,142620,142620,0,0,0,0.00,4
,20180123,142620,142620,,,,142620,142620,0,0,0,0.00,4
,20180124,142620,142620,,,,142620,142620,0,0,0,0.00,4
,20180125,142620,142620,,,,142620,142620,0,0,0,0.00,4
,20180126,142620,142620,,,,142620,142620,0,0,0,0.00,4
,20180129,142620,142620,142620,142620,142620,142620,142620,0,0,4,57.05,0
,20180130,142620,142620,,,,142620,142620,0,0,0,0.00,0
,20180131,142620,142620,,,,142620,142620,0,0,0,0.00,0
,20180201,142620,142620,,,,142620,142620,0,0,0,0.00,0
,20180202,142620,142620,,,,142620,142620,0,0,0,0.00,0
,20180205,142620,142620,,,,142620,142620,0,0,0,0.00,0
,20180206,142620,142620,,,,142620,142620,0,0,0,0.00,0
,20180207,142620,142620,,,,142620,142620,0,0,0,0.00,0
,20180208,142620,142620,,,,142620,142620,0,0,0,0.00,0
,20180209,142620,142620,,,,142620,142620,0,0,0,0.00,0
sn1803,20180102,139960,139960,,,,140850,140850,890,890,0,0.00,2
,20180103,140850,140850,,,,139790,139790,-1060,-1060,0,0.00,2
,20180104,139790,139790,,,,140600,140600,810,810,0,0.00,2
,20180105,140600,140600,,,,140760,140760,160,160,0,0.00,2
,20180108,140760,140760,,,,139870,139870,-890,-890,0,0.00,2
,20180109,139870,139870,,,,139270,139270,-600,-600,0,0.00,2
,20180110,139270,139270,,,,140020,140020,750,750,0,0.00,2
,20180111,140020,140020,,,,140020,140020,0,0,0,0.00,2
,20180112,140020,140020,,,,139850,139850,-170,-170,0,0.00,2
,20180115,139850,139850,,,,142120,142120,2270,2270,0,0.00,2
,20180116,142120,142120,,,,142120,142120,0,0,0,0.00,2
,20180117,142120,142120,,,,141850,141850,-270,-270,0,0.00,2
,20180118,141850,141850,,,,141850,141850,0,0,0,0.00,2
,20180119,141850,141850,,,,141850,141850,0,0,0,0.00,2
,20180122,141850,141850,,,,141850,141850,0,0,0,0.00,2
,20180123,141850,141850,,,,141850,141850,0,0,0,0.00,2
,20180124,141850,141850,,,,141850,141850,0,0,0,0.00,2
,20180125,141850,141850,,,,141850,141850,0,0,0,0.00,2
,20180126,141850,141850,,,,141850,141850,0,0,0,0.00,2
,20180129,141850,141850,,,,141850,141850,0,0,0,0.00,2
,20180130,141850,141850,148920,148930,148920,148930,148920,7080,7070,4,59.57,4
,20180131,148930,148920,,,,148920,148920,0,0,0,0.00,4
,20180201,148920,148920,,,,148920,148920,0,0,0,0.00,4
,20180202,148920,148920,,,,148920,148920,0,0,0,0.00,4
,20180205,148920,148920,,,,148920,148920,0,0,0,0.00,4
,20180206,148920,148920,,,,148920,148920,0,0,0,0.00,4
,20180207,148920,148920,,,,149690,149690,770,770,0,0.00,4
,20180208,149690,149690,,,,149690,149690,0,0,0,0.00,4
,20180209,149690,149690,,,,149690,149690,0,0,0,0.00,4
,20180212,149690,149690,,,,149690,149690,0,0,0,0.00,4
,20180213,149690,149690,,,,149690,149690,0,0,0,0.00,4
,20180214,149690,149690,,,,149690,149690,0,0,0,0.00,4
,20180222,149690,149690,,,,149690,149690,0,0,0,0.00,4
,20180223,149690,149690,146500,146500,146490,146490,146490,-3200,-3200,4,58.60,0
,20180226,146490,146490,,,,146490,146490,0,0,0,0.00,0
,20180227,146490,146490,,,,146490,146490,0,0,0,0.00,0
,20180228,146490,146490,,,,146490,146490,0,0,0,0.00,0
,20180301,146490,146490,,,,146490,146490,0,0,0,0.00,0
,20180302,146490,146490,,,,146490,146490,0,0,0,0.00,0
,20180305,146490,146490,,,,146490,146490,0,0,0,0.00,0
,20180306,146490,146490,,,,146490,146490,0,0,0,0.00,0
,20180307,146490,146490,,,,146490,146490,0,0,0,0.00,0
,20180308,146490,146490,,,,146490,146490,0,0,0,0.00,0
,20180309,146490,146490,,,,146490,146490,0,0,0,0.00,0
,20180312,146490,146490,,,,146490,146490,0,0,0,0.00,0
,20180313,146490,146490,,,,146490,146490,0,0,0,0.00,0
,20180314,146490,146490,,,,146490,146490,0,0,0,0.00,0
,20180315,146490,146490,,,,146490,146490,0,0,0,0.00,0
sn1804,20180102,139610,139610,,,,140500,140500,890,890,0,0.00,2
,20180103,140500,140500,,,,139440,139440,-1060,-1060,0,0.00,2
,20180104,139440,139440,,,,140250,140250,810,810,0,0.00,2
,20180105,140250,140250,,,,140410,140410,160,160,0,0.00,2
,20180108,140410,140410,,,,139520,139520,-890,-890,0,0.00,2
,20180109,139520,139520,,,,138920,138920,-600,-600,0,0.00,2
,20180110,138920,138920,,,,139670,139670,750,750,0,0.00,2
,20180111,139670,139670,,,,139670,139670,0,0,0,0.00,2
,20180112,139670,139670,,,,139500,139500,-170,-170,0,0.00,2
,20180115,139500,139500,,,,142110,142110,2610,2610,0,0.00,2
,20180116,142110,142110,,,,142110,142110,0,0,0,0.00,2
,20180117,142110,142110,,,,141840,141840,-270,-270,0,0.00,2
,20180118,141840,141840,,,,141840,141840,0,0,0,0.00,2
,20180119,141840,141840,141840,141840,141840,141840,141840,0,0,2,28.37,2
,20180122,141840,141840,,,,141840,141840,0,0,0,0.00,2
,20180123,141840,141840,,,,141840,141840,0,0,0,0.00,2
,20180124,141840,141840,,,,141840,141840,0,0,0,0.00,2
,20180125,141840,141840,,,,141840,141840,0,0,0,0.00,2
,20180126,141840,141840,,,,141840,141840,0,0,0,0.00,2
,20180129,141840,141840,148930,148930,148930,148930,148930,7090,7090,2,29.79,4
,20180130,148930,148930,,,,156350,156350,7420,7420,0,0.00,4
,20180131,156350,156350,,,,156350,156350,0,0,0,0.00,4
,20180201,156350,156350,151840,151840,151840,151840,151840,-4510,-4510,20,303.68,22
,20180202,151840,151840,,,,150530,150530,-1310,-1310,0,0.00,22
,20180205,150530,150530,150610,151050,147940,149600,149310,-930,-1220,144,"2,150.17",4
,20180206,149600,149310,,,,149310,149310,0,0,0,0.00,4
,20180207,149310,149310,,,,149310,149310,0,0,0,0.00,4
,20180208,149310,149310,,,,149310,149310,0,0,0,0.00,4
,20180209,149310,149310,,,,149310,149310,0,0,0,0.00,4
,20180212,149310,149310,148220,148220,148220,148220,148220,-1090,-1090,10,148.22,14
,20180213,148220,148220,144850,144900,144850,144900,144870,-3320,-3350,18,260.77,10
,20180214,144900,144870,147740,147740,147740,147740,147740,2870,2870,2,29.55,8
,20180222,147740,147740,,,,147740,147740,0,0,0,0.00,8
,20180223,147740,147740,147000,147000,147000,147000,147000,-740,-740,8,117.60,4
,20180226,147000,147000,,,,147000,147000,0,0,0,0.00,4
,20180227,147000,147000,,,,147000,147000,0,0,0,0.00,4
,20180228,147000,147000,150610,150610,146040,146040,148320,-960,1320,4,59.33,6
,20180301,146040,148320,,,,148320,148320,0,0,0,0.00,6
,20180302,148320,148320,,,,148320,148320,0,0,0,0.00,6
,20180305,148320,148320,,,,148320,148320,0,0,0,0.00,6
,20180306,148320,148320,,,,148320,148320,0,0,0,0.00,6
,20180307,148320,148320,,,,148320,148320,0,0,0,0.00,6
,20180308,148320,148320,,,,148320,148320,0,0,0,0.00,6
,20180309,148320,148320,147300,147300,147300,147300,147300,-1020,-1020,2,29.46,4
,20180312,147300,147300,,,,147300,147300,0,0,0,0.00,4
,20180313,147300,147300,,,,147300,147300,0,0,0,0.00,4
,20180314,147300,147300,,,,147300,147300,0,0,0,0.00,4
,20180315,147300,147300,,,,147300,147300,0,0,0,0.00,4
,20180316,147300,147300,147300,147300,147300,147300,147300,0,0,2,29.46,6
,20180319,147300,147300,145680,145680,143190,143190,144430,-4110,-2870,4,57.77,8
,20180320,143190,144430,,,,144430,144430,0,0,0,0.00,8
,20180321,144430,144430,,,,144430,144430,0,0,0,0.00,8
,20180322,144430,144430,142660,142660,141270,141270,141960,-3160,-2470,4,56.79,10
,20180323,141270,141960,140000,145300,140000,141240,142180,-720,220,6,85.31,8
,20180326,141240,142180,138430,138430,138430,138430,138430,-3750,-3750,2,27.69,8
,20180327,138430,138430,140060,141200,140060,141200,140630,2770,2200,4,56.25,4
,20180328,141200,140630,,,,140630,140630,0,0,0,0.00,4
,20180329,140630,140630,140630,140630,140630,140630,140630,0,0,2,28.13,4
,20180330,140630,140630,,,,140630,140630,0,0,0,0.00,4
,20180402,140630,140630,,,,140630,140630,0,0,0,0.00,4
,20180403,140630,140630,,,,140630,140630,0,0,0,0.00,4
,20180404,140630,140630,,,,140630,140630,0,0,0,0.00,4
,20180409,140630,140630,,,,140630,140630,0,0,0,0.00,4
,20180410,140630,140630,,,,140630,140630,0,0,0,0.00,4
,20180411,140630,140630,,,,140630,140630,0,0,0,0.00,4
,20180412,140630,140630,,,,140630,140630,0,0,0,0.00,4
,20180413,140630,140630,,,,140630,140630,0,0,0,0.00,4
,20180416,140630,140630,140630,140630,140630,140630,140630,0,0,4,56.25,0
sn1805,20180102,144840,144450,145060,146740,144510,145940,145910,1490,1460,8176,"119,302.96",16690
,20180103,145940,145910,146150,146350,144590,145050,145280,-860,-630,9410,"136,717.06",17224
,20180104,145050,145280,145500,145640,144130,145310,144930,30,-350,9820,"142,322.25",17392
,20180105,145310,144930,145410,145800,144400,145600,145060,670,130,9058,"131,395.64",17770
,20180108,145600,145060,145490,145670,144340,144610,144990,-450,-70,8574,"124,321.66",17708
,20180109,144610,144990,144610,144890,143610,144620,144340,-370,-650,10634,"153,494.53",18044
,20180110,144620,144340,144700,145560,144550,145300,145070,960,730,12054,"174,873.50",17964
,20180111,145300,145070,145500,146350,145100,145150,145640,80,570,9632,"140,282.10",18074
,20180112,145150,145640,145380,145870,144740,145400,145330,-240,-310,12388,"180,037.99",18226
,20180115,145400,145330,145560,145680,144670,144840,145200,-490,-130,12438,"180,608.58",17774
,20180116,144840,145200,145080,145790,144750,144970,145230,-230,30,11520,"167,307.39",17484
,20180117,144970,145230,145000,145570,144500,144730,144970,-500,-260,12492,"181,106.00",17296
,20180118,144730,144970,144730,145140,143630,143770,144420,-1200,-550,14194,"205,001.15",18078
,20180119,143770,144420,143980,146090,143630,146050,144630,1630,210,21040,"304,318.42",18632
,20180122,146050,144630,145980,146880,145340,146690,146110,2060,1480,15690,"229,247.96",19782
,20180123,146690,146110,146560,147060,145900,146900,146570,790,460,11720,"171,784.94",19552
,20180124,146900,146570,146850,146900,146180,146600,146530,30,-40,7120,"104,331.44",19580
,20180125,146600,146530,146970,148030,146800,146890,147500,360,970,15548,"229,345.60",20370
,20180126,146890,147500,147000,147850,146590,147090,147310,-410,-190,12440,"183,254.49",20760
,20180129,147090,147310,148060,151470,148050,150950,149810,3640,2500,42392,"635,104.76",25642
,20180130,150950,149810,151330,151390,149370,150020,150540,210,730,26498,"398,913.93",25820
,20180131,150020,150540,150550,150880,148610,150150,149780,-390,-760,21794,"326,431.56",25922
,20180201,150150,149780,150020,150200,148900,149270,149590,-510,-190,11710,"175,177.72",24712
,20180202,149270,149590,149290,149850,148250,148690,149060,-900,-530,12292,"183,226.31",24318
,20180205,148690,149060,148960,150350,147430,150110,148930,1050,-130,20534,"305,821.71",25616
,20180206,150110,148930,150090,150760,149220,150000,150060,1070,1130,16792,"251,984.27",25906
,20180207,150000,150060,150200,151940,149440,151250,151030,1190,970,28040,"423,513.29",29086
,20180208,151250,151030,151320,151930,149190,149360,150320,-1670,-710,27406,"411,969.35",26142
,20180209,149360,150320,149360,149600,147000,147200,148560,-3120,-1760,24256,"360,347.36",24166
,20180212,147200,148560,147000,147390,146030,146340,146610,-2220,-1950,17456,"255,934.50",22872
,20180213,146340,146610,146740,147700,146310,146800,146850,190,240,10634,"156,169.24",21824
,20180214,146800,146850,147180,149350,147010,148880,148410,2030,1560,15652,"232,299.65",21880
,20180222,148880,148410,149000,149480,147100,147180,147810,-1230,-600,6846,"101,192.02",22072
,20180223,147180,147810,147240,148350,146600,147310,147550,-500,-260,13820,"203,923.10",22172
,20180226,147310,147550,147510,148140,146870,147480,147580,-70,30,13006,"191,952.22",21758
,20180227,147480,147580,147480,148480,147010,148250,147950,670,370,15940,"235,847.20",22066
,20180228,148250,147950,147830,148830,147640,148070,148180,120,230,12418,"184,020.40",22476
,20180301,148070,148180,148120,148500,147200,147330,147780,-850,-400,12466,"184,231.50",22170
,20180302,147330,147780,147120,147560,146520,147380,147000,-400,-780,9836,"144,589.80",22184
,20180305,147380,147000,147120,148300,147110,147610,147650,610,650,10886,"160,738.88",22132
,20180306,147610,147650,147580,147790,146500,146590,147120,-1060,-530,15616,"229,744.87",22828
,20180307,146590,147120,146930,147190,146150,146580,146620,-540,-500,13504,"198,005.25",22992
,20180308,146580,146620,146720,146790,145610,145610,146010,-1010,-610,11944,"174,400.71",23458
,20180309,145610,146010,145790,147300,145450,146460,146520,450,510,20568,"301,371.62",23362
,20180312,146460,146520,146350,147670,146030,146970,146990,450,470,13964,"205,259.88",22356
,20180313,146970,146990,146920,147000,146100,146160,146550,-830,-440,11796,"172,880.36",22198
,20180314,146160,146550,146500,146680,145100,145170,145830,-1380,-720,19314,"281,665.23",23532
,20180315,145170,145830,145440,145600,144510,144870,144870,-960,-960,22916,"331,993.69",23598
,20180316,144870,144870,144100,144820,143550,144720,144170,-150,-700,19212,"276,994.42",22722
,20180319,144720,144170,144700,145130,144120,144850,144670,680,500,13630,"197,187.13",22692
,20180320,144850,144670,144370,144540,143710,143750,144170,-920,-500,14298,"206,138.50",22998
,20180321,143750,144170,143920,144630,143300,143320,144000,-850,-170,15426,"222,139.88",23438
,20180322,143320,144000,143200,145030,143200,144820,144260,820,260,13844,"199,721.50",22382
,20180323,144820,144260,144800,145260,137150,141480,143240,-2780,-1020,28390,"406,660.34",22652
,20180326,141480,143240,141300,142670,141300,142260,142010,-980,-1230,17908,"254,311.94",22050
,20180327,142260,142010,142230,143230,141660,141920,142380,-90,370,13352,"190,105.91",21556
,20180328,141920,142380,142020,142240,140200,140690,141310,-1690,-1070,14830,"209,570.13",22084
,20180329,140690,141310,141000,141780,140370,141780,140960,470,-350,13348,"188,158.47",21550
,20180330,141780,140960,141880,144680,141860,144680,142890,3720,1930,17146,"245,003.50",20716
,20180402,144680,142890,144760,146260,144050,146100,145260,3210,2370,19094,"277,359.77",19222
,20180403,146100,145260,145820,146380,145120,145400,145580,140,320,13398,"195,054.35",18408
,20180404,145400,145580,145700,145820,145010,145250,145320,-330,-260,12180,"177,004.77",17546
,20180409,145250,145320,145120,145490,144010,144750,144600,-570,-720,11390,"164,702.74",17112
,20180410,144750,144600,144700,145380,144360,144650,144820,50,220,11582,"167,740.00",16884
,20180411,144650,144820,144810,145010,143780,144280,144280,-540,-540,11652,"168,119.53",16686
,20180412,144280,144280,144260,144290,142690,143160,143340,-1120,-940,14376,"206,075.22",16916
,20180413,143160,143340,143000,143690,142620,143130,143070,-210,-270,13594,"194,499.32",15682
,20180416,143130,143070,143220,144170,142610,144080,143210,1010,140,12688,"181,715.42",14792
,20180417,144080,143210,144080,145090,143550,144950,144450,1740,1240,13188,"190,505.22",13296
,20180418,144950,144450,144700,145870,144540,145690,145140,1240,690,11444,"166,104.88",12510
,20180419,145690,145140,145900,147560,144930,145780,145910,640,770,11944,"174,277.82",11842
,20180420,145780,145910,145740,146330,145050,146200,145800,290,-110,7544,"109,991.86",11088
,20180423,146200,145800,146280,146760,145500,145640,145930,-160,130,3826,"55,836.39",9972
,20180424,145640,145930,144600,145180,143730,143860,144300,-2070,-1630,3828,"55,241.08",8982
,20180425,143860,144300,143830,144410,143700,143700,144070,-600,-230,2076,"29,909.02",8736
,20180426,143700,144070,144360,144980,143970,144440,144410,370,340,2604,"37,606.26",9372
,20180427,144440,144410,144710,145700,144310,145160,145060,750,650,3486,"50,568.46",8464
,20180502,145160,145060,144740,144840,144200,144700,144550,-360,-510,360,"5,204.05",8332
,20180503,144700,144550,144760,144910,144400,144690,144670,140,120,564,"8,159.65",7908
,20180504,144690,144670,145200,145850,145140,145480,145570,810,900,404,"5,881.33",7792
,20180507,145480,145570,144990,144990,144590,144830,144800,-740,-770,324,"4,691.75",7740
,20180508,144830,144800,144250,144290,143670,143670,143950,-1130,-850,116,"1,669.92",7748
,20180509,143670,143950,143500,144030,143000,143120,143270,-830,-680,108,"1,547.39",7708
,20180510,143120,143270,143000,143880,143000,143880,143270,610,0,328,"4,699.26",7692
,20180511,143880,143270,142950,143300,142700,143000,143060,-270,-210,436,"6,237.70",7608
,20180514,143000,143060,143700,143700,143320,143460,143480,400,420,140,"2,008.82",7604
,20180515,143460,143480,143060,144380,143050,144380,143410,900,-70,176,"2,524.07",7616
sn1806,20180102,145050,145050,,,,146520,146520,1470,1470,0,0.00,2
,20180103,146520,146520,,,,145890,145890,-630,-630,0,0.00,2
,20180104,145890,145890,,,,145530,145530,-360,-360,0,0.00,2
,20180105,145530,145530,,,,145660,145660,130,130,0,0.00,2
,20180108,145660,145660,,,,145590,145590,-70,-70,0,0.00,2
,20180109,145590,145590,,,,144940,144940,-650,-650,0,0.00,2
,20180110,144940,144940,,,,145670,145670,730,730,0,0.00,2
,20180111,145670,145670,146890,146890,146890,146890,146890,1220,1220,2,29.38,2
,20180112,146890,146890,145370,145370,145370,145370,145370,-1520,-1520,2,29.07,0
,20180115,145370,145370,143630,148030,143630,145350,145780,-20,410,10,145.78,6
,20180116,145350,145780,,,,145810,145810,30,30,0,0.00,6
,20180117,145810,145810,,,,145550,145550,-260,-260,0,0.00,6
,20180118,145550,145550,,,,145000,145000,-550,-550,0,0.00,6
,20180119,145000,145000,145840,145840,145840,145840,145840,840,840,2,29.17,6
,20180122,145840,145840,,,,147330,147330,1490,1490,0,0.00,6
,20180123,147330,147330,148050,148050,146590,146590,147320,-740,-10,4,58.93,6
,20180124,146590,147320,,,,147280,147280,-40,-40,0,0.00,6
,20180125,147280,147280,,,,148260,148260,980,980,0,0.00,6
,20180126,148260,148260,,,,148060,148060,-200,-200,0,0.00,6
,20180129,148060,148060,,,,150570,150570,2510,2510,0,0.00,6
,20180130,150570,150570,,,,151300,151300,730,730,0,0.00,6
,20180131,151300,151300,,,,150530,150530,-770,-770,0,0.00,6
,20180201,150530,150530,147370,149940,147370,149940,148650,-590,-1880,4,59.46,8
,20180202,149940,148650,,,,148120,148120,-530,-530,0,0.00,8
,20180205,148120,148120,,,,147990,147990,-130,-130,0,0.00,8
,20180206,147990,147990,,,,149110,149110,1120,1120,0,0.00,8
,20180207,149110,149110,,,,150080,150080,970,970,0,0.00,8
,20180208,150080,150080,,,,149370,149370,-710,-710,0,0.00,8
,20180209,149370,149370,,,,147620,147620,-1750,-1750,0,0.00,8
,20180212,147620,147620,,,,145680,145680,-1940,-1940,0,0.00,8
,20180213,145680,145680,,,,145920,145920,240,240,0,0.00,8
,20180214,145920,145920,150580,150580,148920,149920,149780,4000,3860,10,149.78,8
,20180222,149920,149780,,,,149170,149170,-610,-610,0,0.00,8
,20180223,149170,149170,,,,148910,148910,-260,-260,0,0.00,8
,20180226,148910,148910,,,,148940,148940,30,30,0,0.00,8
,20180227,148940,148940,,,,149320,149320,380,380,0,0.00,8
,20180228,149320,149320,148600,148600,148600,148600,148600,-720,-720,2,29.72,6
,20180301,148600,148600,,,,148200,148200,-400,-400,0,0.00,6
,20180302,148200,148200,,,,147410,147410,-790,-790,0,0.00,6
,20180305,147410,147410,,,,148060,148060,650,650,0,0.00,6
,20180306,148060,148060,,,,147520,147520,-540,-540,0,0.00,6
,20180307,147520,147520,,,,147020,147020,-500,-500,0,0.00,6
,20180308,147020,147020,,,,146410,146410,-610,-610,0,0.00,6
,20180309,146410,146410,145020,148120,145020,148120,146600,1710,190,6,87.96,8
,20180312,148120,146600,145300,147770,145300,147770,146530,1170,-70,4,58.61,6
,20180313,147770,146530,,,,146090,146090,-440,-440,0,0.00,6
,20180314,146090,146090,,,,145370,145370,-720,-720,0,0.00,6
,20180315,145370,145370,,,,144410,144410,-960,-960,0,0.00,6
,20180316,144410,144410,,,,143720,143720,-690,-690,0,0.00,6
,20180319,143720,143720,,,,144210,144210,490,490,0,0.00,6
,20180320,144210,144210,,,,143710,143710,-500,-500,0,0.00,6
,20180321,143710,143710,145350,145350,144550,144550,144950,840,1240,4,57.98,4
,20180322,144550,144950,,,,145210,145210,260,260,0,0.00,4
,20180323,145210,145210,,,,144180,144180,-1030,-1030,0,0.00,4
,20180326,144180,144180,,,,142940,142940,-1240,-1240,0,0.00,4
,20180327,142940,142940,,,,143310,143310,370,370,0,0.00,4
,20180328,143310,143310,,,,142230,142230,-1080,-1080,0,0.00,4
,20180329,142230,142230,,,,141880,141880,-350,-350,0,0.00,4
,20180330,141880,141880,,,,143820,143820,1940,1940,0,0.00,4
,20180402,143820,143820,,,,146200,146200,2380,2380,0,0.00,4
,20180403,146200,146200,,,,146520,146520,320,320,0,0.00,4
,20180404,146520,146520,,,,146260,146260,-260,-260,0,0.00,4
,20180409,146260,146260,,,,145530,145530,-730,-730,0,0.00,4
,20180410,145530,145530,,,,145750,145750,220,220,0,0.00,4
,20180411,145750,145750,,,,145210,145210,-540,-540,0,0.00,4
,20180412,145210,145210,,,,144270,144270,-940,-940,0,0.00,4
,20180413,144270,144270,142360,142360,142360,142360,142360,-1910,-1910,2,28.47,4
,20180416,142360,142360,,,,142500,142500,140,140,0,0.00,4
,20180417,142500,142500,,,,143730,143730,1230,1230,0,0.00,4
,20180418,143730,143730,,,,144420,144420,690,690,0,0.00,4
,20180419,144420,144420,,,,145180,145180,760,760,0,0.00,4
,20180420,145180,145180,,,,145070,145070,-110,-110,0,0.00,4
,20180423,145070,145070,,,,145200,145200,130,130,0,0.00,4
,20180424,145200,145200,146090,146090,146090,146090,146090,890,890,2,29.22,4
,20180425,146090,146090,,,,145850,145850,-240,-240,0,0.00,4
,20180426,145850,145850,,,,146200,146200,350,350,0,0.00,4
,20180427,146200,146200,,,,146850,146850,650,650,0,0.00,4
,20180502,146850,146850,,,,146340,146340,-510,-510,0,0.00,4
,20180503,146340,146340,,,,146460,146460,120,120,0,0.00,4
,20180504,146460,146460,147360,147360,147360,147360,147360,900,900,2,29.47,4
,20180507,147360,147360,,,,146580,146580,-780,-780,0,0.00,4
,20180508,146580,146580,,,,145720,145720,-860,-860,0,0.00,4
,20180509,145720,145720,,,,145030,145030,-690,-690,0,0.00,4
,20180510,145030,145030,,,,145030,145030,0,0,0,0.00,4
,20180511,145030,145030,,,,144820,144820,-210,-210,0,0.00,4
,20180514,144820,144820,142120,142120,142120,142120,142120,-2700,-2700,2,28.42,6
,20180515,142120,142120,,,,142050,142050,-70,-70,0,0.00,6
,20180516,142050,142050,,,,142050,142050,0,0,0,0.00,6
,20180517,142050,142050,141600,145200,141600,141960,142240,-90,190,44,625.87,42
,20180518,141960,142240,140460,141850,140460,141850,141570,-390,-670,10,141.57,38
,20180521,141850,141570,145480,145480,144500,144500,145160,2930,3590,40,580.67,10
,20180522,144500,145160,,,,145160,145160,0,0,0,0.00,10
,20180523,145160,145160,145160,145160,145160,145160,145160,0,0,4,58.06,6
,20180524,145160,145160,,,,145160,145160,0,0,0,0.00,6
,20180525,145160,145160,,,,145160,145160,0,0,0,0.00,6
,20180528,145160,145160,,,,145160,145160,0,0,0,0.00,6
,20180529,145160,145160,145750,145750,145750,145750,145750,590,590,10,145.75,16
,20180530,145750,145750,153020,153020,153020,153020,153020,7270,7270,14,214.23,4
,20180531,153020,153020,,,,153020,153020,0,0,0,0.00,4
sn1807,20180102,143160,143160,,,,144610,144610,1450,1450,0,0.00,0
,20180103,144610,144610,,,,143990,143990,-620,-620,0,0.00,0
,20180104,143990,143990,,,,143640,143640,-350,-350,0,0.00,0
,20180105,143640,143640,,,,143760,143760,120,120,0,0.00,0
,20180108,143760,143760,,,,143690,143690,-70,-70,0,0.00,0
,20180109,143690,143690,,,,143040,143040,-650,-650,0,0.00,0
,20180110,143040,143040,,,,143760,143760,720,720,0,0.00,0
,20180111,143760,143760,,,,144960,144960,1200,1200,0,0.00,0
,20180112,144960,144960,,,,143450,143450,-1510,-1510,0,0.00,0
,20180115,143450,143450,,,,143850,143850,400,400,0,0.00,0
,20180116,143850,143850,,,,143880,143880,30,30,0,0.00,0
,20180117,143880,143880,,,,143620,143620,-260,-260,0,0.00,0
,20180118,143620,143620,,,,143080,143080,-540,-540,0,0.00,0
,20180119,143080,143080,,,,143900,143900,820,820,0,0.00,0
,20180122,143900,143900,,,,145370,145370,1470,1470,0,0.00,0
,20180123,145370,145370,,,,145360,145360,-10,-10,0,0.00,0
,20180124,145360,145360,,,,145320,145320,-40,-40,0,0.00,0
,20180125,145320,145320,,,,146290,146290,970,970,0,0.00,0
,20180126,146290,146290,,,,146100,146100,-190,-190,0,0.00,0
,20180129,146100,146100,,,,148580,148580,2480,2480,0,0.00,0
,20180130,148580,148580,,,,149300,149300,720,720,0,0.00,0
,20180131,149300,149300,,,,148540,148540,-760,-760,0,0.00,0
,20180201,148540,148540,,,,146680,146680,-1860,-1860,0,0.00,0
,20180202,146680,146680,,,,146160,146160,-520,-520,0,0.00,0
,20180205,146160,146160,,,,146030,146030,-130,-130,0,0.00,0
,20180206,146030,146030,,,,147140,147140,1110,1110,0,0.00,0
,20180207,147140,147140,,,,148090,148090,950,950,0,0.00,0
,20180208,148090,148090,,,,147390,147390,-700,-700,0,0.00,0
,20180209,147390,147390,,,,145660,145660,-1730,-1730,0,0.00,0
,20180212,145660,145660,,,,143750,143750,-1910,-1910,0,0.00,0
,20180213,143750,143750,,,,143990,143990,240,240,0,0.00,0
,20180214,143990,143990,,,,147800,147800,3810,3810,0,0.00,0
,20180222,147800,147800,,,,147200,147200,-600,-600,0,0.00,0
,20180223,147200,147200,,,,146940,146940,-260,-260,0,0.00,0
,20180226,146940,146940,,,,146970,146970,30,30,0,0.00,0
,20180227,146970,146970,,,,147340,147340,370,370,0,0.00,0
,20180228,147340,147340,,,,146620,146620,-720,-720,0,0.00,0
,20180301,146620,146620,,,,146230,146230,-390,-390,0,0.00,0
,20180302,146230,146230,,,,145450,145450,-780,-780,0,0.00,0
,20180305,145450,145450,,,,146090,146090,640,640,0,0.00,0
,20180306,146090,146090,146600,149140,146600,149140,147870,3050,1780,4,59.15,2
,20180307,149140,147870,,,,147370,147370,-500,-500,0,0.00,2
,20180308,147370,147370,,,,146760,146760,-610,-610,0,0.00,2
,20180309,146760,146760,,,,146950,146950,190,190,0,0.00,2
,20180312,146950,146950,,,,146880,146880,-70,-70,0,0.00,2
,20180313,146880,146880,,,,146440,146440,-440,-440,0,0.00,2
,20180314,146440,146440,,,,145720,145720,-720,-720,0,0.00,2
,20180315,145720,145720,,,,144760,144760,-960,-960,0,0.00,2
,20180316,144760,144760,,,,144060,144060,-700,-700,0,0.00,2
,20180319,144060,144060,,,,144560,144560,500,500,0,0.00,2
,20180320,144560,144560,,,,144060,144060,-500,-500,0,0.00,2
,20180321,144060,144060,,,,145300,145300,1240,1240,0,0.00,2
,20180322,145300,145300,,,,145560,145560,260,260,0,0.00,2
,20180323,145560,145560,,,,144530,144530,-1030,-1030,0,0.00,2
,20180326,144530,144530,,,,143280,143280,-1250,-1250,0,0.00,2
,20180327,143280,143280,,,,143650,143650,370,370,0,0.00,2
,20180328,143650,143650,,,,142570,142570,-1080,-1080,0,0.00,2
,20180329,142570,142570,,,,142220,142220,-350,-350,0,0.00,2
,20180330,142220,142220,,,,144160,144160,1940,1940,0,0.00,2
,20180402,144160,144160,,,,146550,146550,2390,2390,0,0.00,2
,20180403,146550,146550,,,,146870,146870,320,320,0,0.00,2
,20180404,146870,146870,,,,146610,146610,-260,-260,0,0.00,2
,20180409,146610,146610,,,,145880,145880,-730,-730,0,0.00,2
,20180410,145880,145880,147600,147600,144410,144410,146000,-1470,120,4,58.40,4
,20180411,144410,146000,,,,145450,145450,-550,-550,0,0.00,4
,20180412,145450,145450,,,,144500,144500,-950,-950,0,0.00,4
,20180413,144500,144500,,,,142580,142580,-1920,-1920,0,0.00,4
,20180416,142580,142580,146350,146350,141910,143990,144100,1410,1520,10,144.11,6
,20180417,143990,144100,,,,145350,145350,1250,1250,0,0.00,6
,20180418,145350,145350,,,,146050,146050,700,700,0,0.00,6
,20180419,146050,146050,,,,146820,146820,770,770,0,0.00,6
,20180420,146820,146820,,,,146700,146700,-120,-120,0,0.00,6
,20180423,146700,146700,,,,146840,146840,140,140,0,0.00,6
,20180424,146840,146840,,,,146840,146840,0,0,0,0.00,6
,20180425,146840,146840,,,,146600,146600,-240,-240,0,0.00,6
,20180426,146600,146600,146770,146770,146770,146770,146770,170,170,2,29.35,4
,20180427,146770,146770,147120,147120,144130,147050,146700,280,-70,20,293.40,12
,20180502,147050,146700,147090,147090,147090,147090,147090,390,390,2,29.42,10
,20180503,147090,147090,,,,147210,147210,120,120,0,0.00,10
,20180504,147210,147210,147210,147540,147000,147080,147200,-130,-10,8,117.77,12
,20180507,147080,147200,,,,146420,146420,-780,-780,0,0.00,12
,20180508,146420,146420,,,,145560,145560,-860,-860,0,0.00,12
,20180509,145560,145560,,,,145560,145560,0,0,0,0.00,12
,20180510,145560,145560,,,,145560,145560,0,0,0,0.00,12
,20180511,145560,145560,,,,145350,145350,-210,-210,0,0.00,12
,20180514,145350,145350,,,,145350,145350,0,0,0,0.00,12
,20180515,145350,145350,,,,145280,145280,-70,-70,0,0.00,12
,20180516,145280,145280,,,,145280,145280,0,0,0,0.00,12
,20180517,145280,145280,143500,146050,143490,146050,144770,770,-510,12,173.73,22
,20180518,146050,144770,144600,144600,142820,142820,143710,-1950,-1060,8,114.97,18
,20180521,142820,143710,141090,145380,141090,145380,143230,1670,-480,4,57.29,20
,20180522,145380,143230,,,,143230,143230,0,0,0,0.00,20
,20180523,143230,143230,,,,143230,143230,0,0,0,0.00,20
,20180524,143230,143230,146960,148770,143040,146830,146380,3600,3150,158,"2,312.85",42
,20180525,146830,146380,145590,146470,145590,146470,145990,90,-390,22,321.18,32
,20180528,146470,145990,,,,145990,145990,0,0,0,0.00,32
,20180529,145990,145990,149900,149900,149900,149900,149900,3910,3910,2,29.98,32
,20180530,149900,149900,154490,154530,151060,152830,153000,2930,3100,36,550.82,34
,20180531,152830,153000,,,,153000,153000,0,0,0,0.00,34
sn1808,20180102,144910,144910,,,,146380,146380,1470,1470,0,0.00,4
,20180103,146380,146380,,,,145750,145750,-630,-630,0,0.00,4
,20180104,145750,145750,,,,145390,145390,-360,-360,0,0.00,4
,20180105,145390,145390,,,,145520,145520,130,130,0,0.00,4
,20180108,145520,145520,,,,145450,145450,-70,-70,0,0.00,4
,20180109,145450,145450,,,,144800,144800,-650,-650,0,0.00,4
,20180110,144800,144800,,,,145530,145530,730,730,0,0.00,4
,20180111,145530,145530,,,,146740,146740,1210,1210,0,0.00,4
,20180112,146740,146740,,,,145220,145220,-1520,-1520,0,0.00,4
,20180115,145220,145220,,,,145220,145220,0,0,0,0.00,4
,20180116,145220,145220,,,,145250,145250,30,30,0,0.00,4
,20180117,145250,145250,,,,144990,144990,-260,-260,0,0.00,4
,20180118,144990,144990,,,,144440,144440,-550,-550,0,0.00,4
,20180119,144440,144440,,,,145270,145270,830,830,0,0.00,4
,20180122,145270,145270,,,,146750,146750,1480,1480,0,0.00,4
,20180123,146750,146750,,,,146740,146740,-10,-10,0,0.00,4
,20180124,146740,146740,,,,146700,146700,-40,-40,0,0.00,4
,20180125,146700,146700,,,,147670,147670,970,970,0,0.00,4
,20180126,147670,147670,,,,147480,147480,-190,-190,0,0.00,4
,20180129,147480,147480,,,,149990,149990,2510,2510,0,0.00,4
,20180130,149990,149990,,,,150720,150720,730,730,0,0.00,4
,20180131,150720,150720,,,,149950,149950,-770,-770,0,0.00,4
,20180201,149950,149950,,,,148080,148080,-1870,-1870,0,0.00,4
,20180202,148080,148080,,,,147550,147550,-530,-530,0,0.00,4
,20180205,147550,147550,,,,147420,147420,-130,-130,0,0.00,4
,20180206,147420,147420,,,,148540,148540,1120,1120,0,0.00,4
,20180207,148540,148540,,,,151360,151360,2820,2820,0,0.00,4
,20180208,151360,151360,,,,150640,150640,-720,-720,0,0.00,4
,20180209,150640,150640,,,,148870,148870,-1770,-1770,0,0.00,4
,20180212,148870,148870,,,,146920,146920,-1950,-1950,0,0.00,4
,20180213,146920,146920,,,,147160,147160,240,240,0,0.00,4
,20180214,147160,147160,,,,151050,151050,3890,3890,0,0.00,4
,20180222,151050,151050,,,,150440,150440,-610,-610,0,0.00,4
,20180223,150440,150440,,,,150180,150180,-260,-260,0,0.00,4
,20180226,150180,150180,,,,150210,150210,30,30,0,0.00,4
,20180227,150210,150210,,,,150050,150050,-160,-160,0,0.00,4
,20180228,150050,150050,,,,149840,149840,-210,-210,0,0.00,4
,20180301,149840,149840,,,,149440,149440,-400,-400,0,0.00,4
,20180302,149440,149440,,,,148650,148650,-790,-790,0,0.00,4
,20180305,148650,148650,,,,149310,149310,660,660,0,0.00,4
,20180306,149310,149310,,,,148180,148180,-1130,-1130,0,0.00,4
,20180307,148180,148180,,,,147680,147680,-500,-500,0,0.00,4
,20180308,147680,147680,,,,147070,147070,-610,-610,0,0.00,4
,20180309,147070,147070,,,,147260,147260,190,190,0,0.00,4
,20180312,147260,147260,,,,147190,147190,-70,-70,0,0.00,4
,20180313,147190,147190,,,,146750,146750,-440,-440,0,0.00,4
,20180314,146750,146750,,,,146030,146030,-720,-720,0,0.00,4
,20180315,146030,146030,,,,145070,145070,-960,-960,0,0.00,4
,20180316,145070,145070,,,,144370,144370,-700,-700,0,0.00,4
,20180319,144370,144370,,,,144870,144870,500,500,0,0.00,4
,20180320,144870,144870,,,,144370,144370,-500,-500,0,0.00,4
,20180321,144370,144370,,,,145610,145610,1240,1240,0,0.00,4
,20180322,145610,145610,,,,145870,145870,260,260,0,0.00,4
,20180323,145870,145870,,,,144830,144830,-1040,-1040,0,0.00,4
,20180326,144830,144830,143590,143590,143590,143590,143590,-1240,-1240,4,57.44,4
,20180327,143590,143590,,,,143960,143960,370,370,0,0.00,4
,20180328,143960,143960,,,,142880,142880,-1080,-1080,0,0.00,4
,20180329,142880,142880,,,,142520,142520,-360,-360,0,0.00,4
,20180330,142520,142520,,,,144470,144470,1950,1950,0,0.00,4
,20180402,144470,144470,,,,144470,144470,0,0,0,0.00,4
,20180403,144470,144470,,,,144470,144470,0,0,0,0.00,4
,20180404,144470,144470,,,,144210,144210,-260,-260,0,0.00,4
,20180409,144210,144210,,,,143490,143490,-720,-720,0,0.00,4
,20180410,143490,143490,,,,143490,143490,0,0,0,0.00,4
,20180411,143490,143490,,,,142950,142950,-540,-540,0,0.00,4
,20180412,142950,142950,,,,142020,142020,-930,-930,0,0.00,4
,20180413,142020,142020,,,,140130,140130,-1890,-1890,0,0.00,4
,20180416,140130,140130,,,,140920,140920,790,790,0,0.00,4
,20180417,140920,140920,,,,142140,142140,1220,1220,0,0.00,4
,20180418,142140,142140,,,,142820,142820,680,680,0,0.00,4
,20180419,142820,142820,,,,143580,143580,760,760,0,0.00,4
,20180420,143580,143580,,,,143470,143470,-110,-110,0,0.00,4
,20180423,143470,143470,,,,143600,143600,130,130,0,0.00,4
,20180424,143600,143600,143060,143060,143060,143060,143060,-540,-540,2,28.61,6
,20180425,143060,143060,146670,146670,146670,146670,146670,3610,3610,2,29.33,6
,20180426,146670,146670,,,,146670,146670,0,0,0,0.00,6
,20180427,146670,146670,,,,146600,146600,-70,-70,0,0.00,6
,20180502,146600,146600,,,,146980,146980,380,380,0,0.00,6
,20180503,146980,146980,,,,147100,147100,120,120,0,0.00,6
,20180504,147100,147100,147110,147110,147110,147110,147110,10,10,2,29.42,4
,20180507,147110,147110,,,,146330,146330,-780,-780,0,0.00,4
,20180508,146330,146330,144820,144820,144820,144820,144820,-1510,-1510,2,28.96,2
,20180509,144820,144820,,,,144140,144140,-680,-680,0,0.00,2
,20180510,144140,144140,,,,144140,144140,0,0,0,0.00,2
,20180511,144140,144140,,,,143930,143930,-210,-210,0,0.00,2
,20180514,143930,143930,,,,141240,141240,-2690,-2690,0,0.00,2
,20180515,141240,141240,,,,141170,141170,-70,-70,0,0.00,2
,20180516,141170,141170,,,,141170,141170,0,0,0,0.00,2
,20180517,141170,141170,,,,140670,140670,-500,-500,0,0.00,2
,20180518,140670,140670,,,,139640,139640,-1030,-1030,0,0.00,2
,20180521,139640,139640,,,,139170,139170,-470,-470,0,0.00,2
,20180522,139170,139170,,,,139170,139170,0,0,0,0.00,2
,20180523,139170,139170,,,,139170,139170,0,0,0,0.00,2
,20180524,139170,139170,,,,142230,142230,3060,3060,0,0.00,2
,20180525,142230,142230,,,,141850,141850,-380,-380,0,0.00,2
,20180528,141850,141850,,,,141850,141850,0,0,0,0.00,2
,20180529,141850,141850,,,,148940,148940,7090,7090,0,0.00,2
,20180530,148940,148940,151800,155570,151800,155570,153350,6630,4410,8,122.68,2
,20180531,155570,153350,,,,153350,153350,0,0,0,0.00,2
sn1809,20180102,145810,145890,145660,147110,145660,146560,146760,670,870,52,763.16,176
,20180103,146560,146760,147000,147000,145830,145880,146260,-880,-500,52,760.56,182
,20180104,145880,146260,145200,146200,145200,146200,145980,-60,-280,44,642.33,202
,20180105,146200,145980,146100,146540,145500,146240,146150,260,170,78,"1,140.04",256
,20180108,146240,146150,144700,146330,144700,145600,145590,-550,-560,90,"1,310.35",258
,20180109,145600,145590,145640,145720,144800,144800,145390,-790,-200,16,232.62,264
,20180110,144800,145390,146100,146410,145730,146300,146130,910,740,80,"1,169.05",300
,20180111,146300,146130,146770,146900,146040,146040,146390,-90,260,112,"1,639.66",356
,20180112,146040,146390,144600,146520,144600,146440,145800,50,-590,200,"2,916.12",356
,20180115,146440,145800,146350,146510,145970,146090,146310,290,510,64,936.41,392
,20180116,146090,146310,146530,146600,145650,146000,146290,-310,-20,108,"1,579.99",426
,20180117,146000,146290,145940,146320,145750,145940,146010,-350,-280,90,"1,314.14",458
,20180118,145940,146010,145930,145930,144770,144770,145190,-1240,-820,60,871.15,458
,20180119,144770,145190,144990,147100,144790,147100,146230,1910,1040,380,"5,556.81",694
,20180122,147100,146230,147110,147800,146500,147530,147240,1300,1010,320,"4,711.95",904
,20180123,147530,147240,147650,147950,147090,147320,147730,80,490,200,"2,954.75",980
,20180124,147320,147730,146200,147770,146200,147540,147190,-190,-540,182,"2,678.89",976
,20180125,147540,147190,148420,149000,148000,148000,148490,810,1300,184,"2,732.30",1052
,20180126,148000,148490,148580,148900,147780,148000,148350,-490,-140,86,"1,275.86",1062
,20180129,148000,148350,149270,151980,149270,151500,150740,3150,2390,1104,"16,641.96",1708
,20180130,151500,150740,151840,151970,149940,150970,151320,230,580,380,"5,750.25",1732
,20180131,150970,151320,151250,151430,149520,151000,150430,-320,-890,248,"3,730.69",1744
,20180201,151000,150430,150750,150750,149870,149980,150190,-450,-240,120,"1,802.38",1732
,20180202,149980,150190,150570,150570,149500,149650,149770,-540,-420,146,"2,186.71",1692
,20180205,149650,149770,149890,151060,148580,150840,150470,1070,700,264,"3,972.55",1778
,20180206,150840,150470,150730,151440,150090,150770,150950,300,480,220,"3,320.93",1834
,20180207,150770,150950,150310,152500,150310,152150,151920,1200,970,444,"6,745.55",2164
,20180208,152150,151920,152020,152500,149940,149940,151200,-1980,-720,400,"6,048.16",2200
,20180209,149940,151200,149950,150320,148260,148260,149100,-2940,-2100,330,"4,920.39",2152
,20180212,148260,149100,147700,148340,147370,147700,147880,-1400,-1220,254,"3,756.30",2188
,20180213,147700,147880,148040,148380,147820,148380,148000,500,120,46,680.80,2196
,20180214,148380,148000,148850,150500,148850,150270,150010,2270,2010,88,"1,320.15",2184
,20180222,150270,150010,149610,149800,148550,148550,149290,-1460,-720,48,716.60,2204
,20180223,148550,149290,148580,149630,148480,149050,148970,-240,-320,336,"5,005.54",2318
,20180226,149050,148970,149540,149650,148560,149070,149200,100,230,258,"3,849.38",2324
,20180227,149070,149200,149250,150080,148680,149750,149570,550,370,374,"5,594.19",2440
,20180228,149750,149570,149450,150360,149260,149770,149920,200,350,252,"3,778.05",2598
,20180301,149770,149920,149800,150230,149100,149170,149550,-750,-370,132,"1,974.10",2642
,20180302,149170,149550,148620,149660,148490,149160,148880,-390,-670,244,"3,632.71",2554
,20180305,149160,148880,149400,150000,149270,149410,149660,530,780,146,"2,185.11",2556
,20180306,149410,149660,149330,149770,148540,148540,148890,-1120,-770,232,"3,454.42",2558
,20180307,148540,148890,148800,148910,148180,148500,148580,-390,-310,310,"4,606.10",2410
,20180308,148500,148580,148210,148410,147660,147660,147970,-920,-610,184,"2,722.73",2398
,20180309,147660,147970,148070,149200,147470,148340,148550,370,580,934,"13,875.09",2766
,20180312,148340,148550,147840,149360,147840,148740,148890,190,340,272,"4,050.07",2812
,20180313,148740,148890,148200,148750,148060,148060,148380,-830,-510,232,"3,442.53",2852
,20180314,148060,148380,148500,148500,147560,147600,147820,-780,-560,706,"10,436.57",2882
,20180315,147600,147820,146970,147910,146970,147410,147360,-410,-460,722,"10,639.81",2878
,20180316,147410,147360,146510,147200,145940,147100,146590,-260,-770,558,"8,179.82",2922
,20180319,147100,146590,147400,147560,146440,147070,146990,480,400,368,"5,409.24",3004
,20180320,147070,146990,146460,146820,146230,146320,146560,-670,-430,398,"5,833.21",3042
,20180321,146320,146560,146740,146760,145800,145880,146300,-680,-260,440,"6,437.45",3114
,20180322,145880,146300,145960,147370,145760,147350,146600,1050,300,730,"10,701.97",3342
,20180323,147350,146600,147870,147870,143960,144000,145430,-2600,-1170,1752,"25,480.40",3902
,20180326,144000,145430,144000,145120,143990,144720,144390,-710,-1040,1272,"18,366.85",4344
,20180327,144720,144390,144550,145550,144090,144260,144700,-130,310,1176,"17,017.10",4522
,20180328,144260,144700,144550,144670,142600,142960,143580,-1740,-1120,1638,"23,518.81",4960
,20180329,142960,143580,143360,144140,142770,144140,143350,560,-230,2096,"30,046.64",5776
,20180330,144140,143350,144030,146740,144030,146740,145110,3390,1760,2646,"38,398.57",6388
,20180402,146740,145110,147000,148260,146450,148130,147440,3020,2330,2980,"43,937.43",6904
,20180403,148130,147440,148070,148290,147200,147620,147620,180,180,2492,"36,786.97",7194
,20180404,147620,147620,147620,147700,147270,147480,147440,-140,-180,2470,"36,418.52",7990
,20180409,147480,147440,147480,147640,146160,146900,146660,-540,-780,2476,"36,314.85",8530
,20180410,146900,146660,146900,147580,146600,146840,147030,180,370,2582,"37,963.55",8668
,20180411,146840,147030,147180,147270,145880,146250,146380,-780,-650,3498,"51,206.59",9094
,20180412,146250,146380,146380,146380,145050,145250,145520,-1130,-860,5168,"75,209.58",11014
,20180413,145250,145520,145010,145990,144780,145470,145420,-50,-100,4328,"62,938.22",12138
,20180416,145470,145420,145720,146550,145050,146430,145630,1010,210,5096,"74,214.05",13200
,20180417,146430,145630,146600,147580,146310,147490,146990,1860,1360,7168,"105,367.95",15586
,20180418,147490,146990,147310,148320,146950,148230,147620,1240,630,7802,"115,176.68",16950
,20180419,148230,147620,148630,149990,147530,148280,148410,660,790,10650,"158,057.45",17404
,20180420,148280,148410,147980,148760,147550,148480,148200,70,-210,8644,"128,111.63",18364
,20180423,148480,148200,148480,148880,147660,148150,148290,-50,90,12522,"185,697.59",19258
,20180424,148150,148290,147690,147690,146090,146290,146590,-2000,-1700,17904,"262,465.86",19394
,20180425,146290,146590,146500,146880,145890,146100,146480,-490,-110,10520,"154,102.49",19616
,20180426,146100,146480,146110,147390,146110,146760,146860,280,380,14138,"207,636.93",20280
,20180427,146760,146860,146740,148200,146740,147700,147480,840,620,13832,"204,006.38",20934
,20180502,147700,147480,147300,147680,146650,147400,147080,-80,-400,7650,"112,522.71",20818
,20180503,147400,147080,147400,147500,146850,147290,147170,210,90,8706,"128,126.67",21808
,20180504,147290,147170,147440,148580,147440,147800,148110,630,940,19200,"284,383.33",23854
,20180507,147800,148110,147610,147940,147200,147440,147460,-670,-650,11828,"174,418.65",23748
,20180508,147440,147460,147500,147600,146000,146190,146590,-1270,-870,18912,"277,244.26",24118
,20180509,146190,146590,146200,146500,145370,145400,145830,-1190,-760,14434,"210,495.06",24342
,20180510,145400,145830,145390,146490,145220,146480,145840,650,10,15710,"229,120.74",24646
,20180511,146480,145840,145400,145700,144900,145590,145380,-250,-460,14502,"210,833.09",26294
,20180514,145590,145380,145560,146180,145390,146130,145870,750,490,11976,"174,704.83",26874
,20180515,146130,145870,145920,146350,145370,146290,145840,420,-30,11616,"169,409.66",26892
,20180516,146290,145840,145800,146480,145510,145710,145910,-130,70,10410,"151,895.74",26392
,20180517,145710,145910,145580,146250,145160,145940,145770,30,-140,11924,"173,817.19",26504
,20180518,145940,145770,145350,145600,144500,144980,145130,-790,-640,17666,"256,390.11",28208
,20180521,144980,145130,144970,146250,144300,146220,145500,1090,370,16244,"236,364.70",27402
,20180522,146220,145500,146000,146450,145660,145800,146060,300,560,11960,"174,689.58",27754
,20180523,145800,146060,145840,147290,145510,147260,146400,1200,340,17724,"259,497.00",28840
,20180524,147260,146400,147100,148240,146730,148220,147400,1820,1000,25526,"376,257.09",30524
,20180525,148220,147400,147710,148160,146400,146540,147390,-860,-10,18790,"276,956.43",28214
,20180528,146540,147390,146470,150830,146370,150490,149180,3100,1790,38814,"579,032.86",35424
,20180529,150490,149180,150460,155140,150010,154670,152780,5490,3600,88052,"1,345,283.57",45388
,20180530,154670,152780,154180,157560,153000,153300,155060,520,2280,123228,"1,910,822.05",47476
,20180531,153300,155060,153390,156500,153170,154990,155010,-70,-50,82540,"1,279,463.37",52610
sn1810,20180102,146480,146480,,,,147350,147350,870,870,0,0.00,0
,20180103,147350,147350,,,,146850,146850,-500,-500,0,0.00,0
,20180104,146850,146850,,,,146570,146570,-280,-280,0,0.00,0
,20180105,146570,146570,,,,146740,146740,170,170,0,0.00,0
,20180108,146740,146740,,,,146180,146180,-560,-560,0,0.00,0
,20180109,146180,146180,,,,145970,145970,-210,-210,0,0.00,0
,20180110,145970,145970,,,,146710,146710,740,740,0,0.00,0
,20180111,146710,146710,,,,146970,146970,260,260,0,0.00,0
,20180112,146970,146970,149220,149920,145400,146000,147630,-970,660,8,118.11,2
,20180115,146000,147630,,,,147630,147630,0,0,0,0.00,2
,20180116,147630,147630,,,,147610,147610,-20,-20,0,0.00,2
,20180117,147610,147610,,,,147330,147330,-280,-280,0,0.00,2
,20180118,147330,147330,,,,146500,146500,-830,-830,0,0.00,2
,20180119,146500,146500,,,,147550,147550,1050,1050,0,0.00,2
,20180122,147550,147550,,,,148570,148570,1020,1020,0,0.00,2
,20180123,148570,148570,,,,149070,149070,500,500,0,0.00,2
,20180124,149070,149070,,,,148520,148520,-550,-550,0,0.00,2
,20180125,148520,148520,,,,149830,149830,1310,1310,0,0.00,2
,20180126,149830,149830,,,,149690,149690,-140,-140,0,0.00,2
,20180129,149690,149690,,,,152100,152100,2410,2410,0,0.00,2
,20180130,152100,152100,,,,152680,152680,580,580,0,0.00,2
,20180131,152680,152680,,,,151780,151780,-900,-900,0,0.00,2
,20180201,151780,151780,,,,151540,151540,-240,-240,0,0.00,2
,20180202,151540,151540,,,,151120,151120,-420,-420,0,0.00,2
,20180205,151120,151120,,,,151830,151830,710,710,0,0.00,2
,20180206,151830,151830,,,,152310,152310,480,480,0,0.00,2
,20180207,152310,152310,,,,153290,153290,980,980,0,0.00,2
,20180208,153290,153290,,,,152560,152560,-730,-730,0,0.00,2
,20180209,152560,152560,,,,150440,150440,-2120,-2120,0,0.00,2
,20180212,150440,150440,,,,149210,149210,-1230,-1230,0,0.00,2
,20180213,149210,149210,,,,149330,149330,120,120,0,0.00,2
,20180214,149330,149330,,,,151360,151360,2030,2030,0,0.00,2
,20180222,151360,151360,,,,150630,150630,-730,-730,0,0.00,2
,20180223,150630,150630,,,,150310,150310,-320,-320,0,0.00,2
,20180226,150310,150310,,,,150540,150540,230,230,0,0.00,2
,20180227,150540,150540,,,,150920,150920,380,380,0,0.00,2
,20180228,150920,150920,,,,151270,151270,350,350,0,0.00,2
,20180301,151270,151270,,,,150890,150890,-380,-380,0,0.00,2
,20180302,150890,150890,,,,150210,150210,-680,-680,0,0.00,2
,20180305,150210,150210,,,,151000,151000,790,790,0,0.00,2
,20180306,151000,151000,,,,150230,150230,-770,-770,0,0.00,2
,20180307,150230,150230,,,,149920,149920,-310,-310,0,0.00,2
,20180308,149920,149920,,,,149300,149300,-620,-620,0,0.00,2
,20180309,149300,149300,,,,149890,149890,590,590,0,0.00,2
,20180312,149890,149890,,,,150240,150240,350,350,0,0.00,2
,20180313,150240,150240,,,,149730,149730,-510,-510,0,0.00,2
,20180314,149730,149730,,,,149170,149170,-560,-560,0,0.00,2
,20180315,149170,149170,,,,148710,148710,-460,-460,0,0.00,2
,20180316,148710,148710,,,,147930,147930,-780,-780,0,0.00,2
,20180319,147930,147930,,,,148330,148330,400,400,0,0.00,2
,20180320,148330,148330,,,,147890,147890,-440,-440,0,0.00,2
,20180321,147890,147890,,,,147630,147630,-260,-260,0,0.00,2
,20180322,147630,147630,,,,147930,147930,300,300,0,0.00,2
,20180323,147930,147930,,,,146750,146750,-1180,-1180,0,0.00,2
,20180326,146750,146750,,,,145700,145700,-1050,-1050,0,0.00,2
,20180327,145700,145700,,,,146010,146010,310,310,0,0.00,2
,20180328,146010,146010,,,,144880,144880,-1130,-1130,0,0.00,2
,20180329,144880,144880,,,,144650,144650,-230,-230,0,0.00,2
,20180330,144650,144650,,,,146430,146430,1780,1780,0,0.00,2
,20180402,146430,146430,149680,149690,147970,148100,148900,1670,2470,64,952.97,34
,20180403,148100,148900,147880,147880,147000,147480,147400,-1420,-1500,14,206.36,30
,20180404,147480,147400,147450,147450,147450,147450,147450,50,50,2,29.49,30
,20180409,147450,147450,147590,147680,147590,147680,147630,230,180,4,59.05,30
,20180410,147680,147630,,,,147630,147630,0,0,0,0.00,30
,20180411,147630,147630,,,,147630,147630,0,0,0,0.00,30
,20180412,147630,147630,,,,147630,147630,0,0,0,0.00,30
,20180413,147630,147630,,,,146250,146250,-1380,-1380,0,0.00,30
,20180416,146250,146250,,,,146250,146250,0,0,0,0.00,30
,20180417,146250,146250,,,,147230,147230,980,980,0,0.00,30
,20180418,147230,147230,147680,148630,147680,148630,148190,1400,960,30,444.58,4
,20180419,148630,148190,,,,148980,148980,790,790,0,0.00,4
,20180420,148980,148980,,,,148980,148980,0,0,0,0.00,4
,20180423,148980,148980,,,,149070,149070,90,90,0,0.00,4
,20180424,149070,149070,147800,147800,147800,147800,147800,-1270,-1270,2,29.56,4
,20180425,147800,147800,,,,147690,147690,-110,-110,0,0.00,4
,20180426,147690,147690,,,,147690,147690,0,0,0,0.00,4
,20180427,147690,147690,,,,148320,148320,630,630,0,0.00,4
,20180502,148320,148320,,,,147920,147920,-400,-400,0,0.00,4
,20180503,147920,147920,,,,148010,148010,90,90,0,0.00,4
,20180504,148010,148010,,,,148960,148960,950,950,0,0.00,4
,20180507,148960,148960,,,,148300,148300,-660,-660,0,0.00,4
,20180508,148300,148300,,,,147430,147430,-870,-870,0,0.00,4
,20180509,147430,147430,,,,146660,146660,-770,-770,0,0.00,4
,20180510,146660,146660,,,,146670,146670,10,10,0,0.00,4
,20180511,146670,146670,,,,146200,146200,-470,-470,0,0.00,4
,20180514,146200,146200,,,,146700,146700,500,500,0,0.00,4
,20180515,146700,146700,,,,146670,146670,-30,-30,0,0.00,4
,20180516,146670,146670,,,,146740,146740,70,70,0,0.00,4
,20180517,146740,146740,,,,146600,146600,-140,-140,0,0.00,4
,20180518,146600,146600,,,,145950,145950,-650,-650,0,0.00,4
,20180521,145950,145950,,,,146330,146330,380,380,0,0.00,4
,20180522,146330,146330,,,,146890,146890,560,560,0,0.00,4
,20180523,146890,146890,,,,147240,147240,350,350,0,0.00,4
,20180524,147240,147240,,,,147240,147240,0,0,0,0.00,4
,20180525,147240,147240,,,,147230,147230,-10,-10,0,0.00,4
,20180528,147230,147230,,,,149010,149010,1780,1780,0,0.00,4
,20180529,149010,149010,,,,152600,152600,3590,3590,0,0.00,4
,20180530,152600,152600,,,,152600,152600,0,0,0,0.00,4
,20180531,152600,152600,,,,152550,152550,-50,-50,0,0.00,4
sn1811,20180102,146850,146850,,,,147720,147720,870,870,0,0.00,0
,20180103,147720,147720,,,,147210,147210,-510,-510,0,0.00,0
,20180104,147210,147210,,,,146930,146930,-280,-280,0,0.00,0
,20180105,146930,146930,,,,147110,147110,180,180,0,0.00,0
,20180108,147110,147110,,,,146550,146550,-560,-560,0,0.00,0
,20180109,146550,146550,,,,146340,146340,-210,-210,0,0.00,0
,20180110,146340,146340,,,,147080,147080,740,740,0,0.00,0
,20180111,147080,147080,,,,147340,147340,260,260,0,0.00,0
,20180112,147340,147340,150300,150300,144500,144500,146870,-2840,-470,14,205.62,2
,20180115,144500,146870,,,,146870,146870,0,0,0,0.00,2
,20180116,146870,146870,,,,146850,146850,-20,-20,0,0.00,2
,20180117,146850,146850,,,,146570,146570,-280,-280,0,0.00,2
,20180118,146570,146570,,,,145740,145740,-830,-830,0,0.00,2
,20180119,145740,145740,,,,146780,146780,1040,1040,0,0.00,2
,20180122,146780,146780,149310,149310,149310,149310,149310,2530,2530,2,29.86,2
,20180123,149310,149310,,,,149810,149810,500,500,0,0.00,2
,20180124,149810,149810,,,,149260,149260,-550,-550,0,0.00,2
,20180125,149260,149260,,,,150580,150580,1320,1320,0,0.00,2
,20180126,150580,150580,,,,150440,150440,-140,-140,0,0.00,2
,20180129,150440,150440,,,,152860,152860,2420,2420,0,0.00,2
,20180130,152860,152860,,,,153450,153450,590,590,0,0.00,2
,20180131,153450,153450,,,,152540,152540,-910,-910,0,0.00,2
,20180201,152540,152540,,,,152300,152300,-240,-240,0,0.00,2
,20180202,152300,152300,,,,151870,151870,-430,-430,0,0.00,2
,20180205,151870,151870,,,,152580,152580,710,710,0,0.00,2
,20180206,152580,152580,,,,153060,153060,480,480,0,0.00,2
,20180207,153060,153060,,,,154050,154050,990,990,0,0.00,2
,20180208,154050,154050,,,,153320,153320,-730,-730,0,0.00,2
,20180209,153320,153320,,,,151190,151190,-2130,-2130,0,0.00,2
,20180212,151190,151190,,,,149950,149950,-1240,-1240,0,0.00,2
,20180213,149950,149950,,,,150070,150070,120,120,0,0.00,2
,20180214,150070,150070,,,,152110,152110,2040,2040,0,0.00,2
,20180222,152110,152110,,,,151380,151380,-730,-730,0,0.00,2
,20180223,151380,151380,,,,151060,151060,-320,-320,0,0.00,2
,20180226,151060,151060,,,,151290,151290,230,230,0,0.00,2
,20180227,151290,151290,,,,151670,151670,380,380,0,0.00,2
,20180228,151670,151670,,,,152020,152020,350,350,0,0.00,2
,20180301,152020,152020,,,,151640,151640,-380,-380,0,0.00,2
,20180302,151640,151640,,,,150960,150960,-680,-680,0,0.00,2
,20180305,150960,150960,,,,151750,151750,790,790,0,0.00,2
,20180306,151750,151750,,,,150970,150970,-780,-780,0,0.00,2
,20180307,150970,150970,,,,150650,150650,-320,-320,0,0.00,2
,20180308,150650,150650,,,,150030,150030,-620,-620,0,0.00,2
,20180309,150030,150030,,,,150620,150620,590,590,0,0.00,2
,20180312,150620,150620,,,,150970,150970,350,350,0,0.00,2
,20180313,150970,150970,,,,150450,150450,-520,-520,0,0.00,2
,20180314,150450,150450,,,,149880,149880,-570,-570,0,0.00,2
,20180315,149880,149880,,,,149410,149410,-470,-470,0,0.00,2
,20180316,149410,149410,,,,148630,148630,-780,-780,0,0.00,2
,20180319,148630,148630,,,,149030,149030,400,400,0,0.00,2
,20180320,149030,149030,,,,148590,148590,-440,-440,0,0.00,2
,20180321,148590,148590,,,,148330,148330,-260,-260,0,0.00,2
,20180322,148330,148330,,,,148630,148630,300,300,0,0.00,2
,20180323,148630,148630,,,,147440,147440,-1190,-1190,0,0.00,2
,20180326,147440,147440,,,,146380,146380,-1060,-1060,0,0.00,2
,20180327,146380,146380,,,,146690,146690,310,310,0,0.00,2
,20180328,146690,146690,,,,145550,145550,-1140,-1140,0,0.00,2
,20180329,145550,145550,,,,145310,145310,-240,-240,0,0.00,2
,20180330,145310,145310,,,,147100,147100,1790,1790,0,0.00,2
,20180402,147100,147100,,,,149580,149580,2480,2480,0,0.00,2
,20180403,149580,149580,,,,148070,148070,-1510,-1510,0,0.00,2
,20180404,148070,148070,,,,148120,148120,50,50,0,0.00,2
,20180409,148120,148120,,,,148300,148300,180,180,0,0.00,2
,20180410,148300,148300,,,,148670,148670,370,370,0,0.00,2
,20180411,148670,148670,,,,148020,148020,-650,-650,0,0.00,2
,20180412,148020,148020,,,,147150,147150,-870,-870,0,0.00,2
,20180413,147150,147150,,,,147040,147040,-110,-110,0,0.00,2
,20180416,147040,147040,,,,147250,147250,210,210,0,0.00,2
,20180417,147250,147250,,,,148630,148630,1380,1380,0,0.00,2
,20180418,148630,148630,,,,149600,149600,970,970,0,0.00,2
,20180419,149600,149600,,,,150400,150400,800,800,0,0.00,2
,20180420,150400,150400,,,,150190,150190,-210,-210,0,0.00,2
,20180423,150190,150190,,,,150280,150280,90,90,0,0.00,2
,20180424,150280,150280,,,,148990,148990,-1290,-1290,0,0.00,2
,20180425,148990,148990,,,,148880,148880,-110,-110,0,0.00,2
,20180426,148880,148880,,,,149270,149270,390,390,0,0.00,2
,20180427,149270,149270,,,,149900,149900,630,630,0,0.00,2
,20180502,149900,149900,,,,149500,149500,-400,-400,0,0.00,2
,20180503,149500,149500,,,,149590,149590,90,90,0,0.00,2
,20180504,149590,149590,,,,150550,150550,960,960,0,0.00,2
,20180507,150550,150550,,,,149890,149890,-660,-660,0,0.00,2
,20180508,149890,149890,,,,149010,149010,-880,-880,0,0.00,2
,20180509,149010,149010,,,,148240,148240,-770,-770,0,0.00,2
,20180510,148240,148240,,,,148250,148250,10,10,0,0.00,2
,20180511,148250,148250,,,,147780,147780,-470,-470,0,0.00,2
,20180514,147780,147780,,,,148280,148280,500,500,0,0.00,2
,20180515,148280,148280,,,,148250,148250,-30,-30,0,0.00,2
,20180516,148250,148250,,,,148320,148320,70,70,0,0.00,2
,20180517,148320,148320,,,,148170,148170,-150,-150,0,0.00,2
,20180518,148170,148170,,,,147520,147520,-650,-650,0,0.00,2
,20180521,147520,147520,,,,147900,147900,380,380,0,0.00,2
,20180522,147900,147900,,,,148470,148470,570,570,0,0.00,2
,20180523,148470,148470,,,,148820,148820,350,350,0,0.00,2
,20180524,148820,148820,,,,149830,149830,1010,1010,0,0.00,2
,20180525,149830,149830,,,,149820,149820,-10,-10,0,0.00,2
,20180528,149820,149820,,,,151640,151640,1820,1820,0,0.00,2
,20180529,151640,151640,,,,155300,155300,3660,3660,0,0.00,2
,20180530,155300,155300,,,,157620,157620,2320,2320,0,0.00,2
,20180531,157620,157620,,,,157570,157570,-50,-50,0,0.00,2
sn1812,20180102,146850,146850,,,,147720,147720,870,870,0,0.00,0
,20180103,147720,147720,,,,147210,147210,-510,-510,0,0.00,0
,20180104,147210,147210,,,,146930,146930,-280,-280,0,0.00,0
,20180105,146930,146930,,,,147110,147110,180,180,0,0.00,0
,20180108,147110,147110,,,,146550,146550,-560,-560,0,0.00,0
,20180109,146550,146550,,,,146340,146340,-210,-210,0,0.00,0
,20180110,146340,146340,,,,147080,147080,740,740,0,0.00,0
,20180111,147080,147080,,,,147340,147340,260,260,0,0.00,0
,20180112,147340,147340,,,,146870,146870,-470,-470,0,0.00,0
,20180115,146870,146870,,,,146870,146870,0,0,0,0.00,0
,20180116,146870,146870,,,,146850,146850,-20,-20,0,0.00,0
,20180117,146850,146850,,,,146570,146570,-280,-280,0,0.00,0
,20180118,146570,146570,,,,145740,145740,-830,-830,0,0.00,0
,20180119,145740,145740,,,,146780,146780,1040,1040,0,0.00,0
,20180122,146780,146780,,,,149310,149310,2530,2530,0,0.00,0
,20180123,149310,149310,,,,149810,149810,500,500,0,0.00,0
,20180124,149810,149810,,,,149260,149260,-550,-550,0,0.00,0
,20180125,149260,149260,,,,150580,150580,1320,1320,0,0.00,0
,20180126,150580,150580,,,,150440,150440,-140,-140,0,0.00,0
,20180129,150440,150440,,,,152860,152860,2420,2420,0,0.00,0
,20180130,152860,152860,,,,153450,153450,590,590,0,0.00,0
,20180131,153450,153450,,,,152540,152540,-910,-910,0,0.00,0
,20180201,152540,152540,,,,152300,152300,-240,-240,0,0.00,0
,20180202,152300,152300,,,,151870,151870,-430,-430,0,0.00,0
,20180205,151870,151870,,,,152580,152580,710,710,0,0.00,0
,20180206,152580,152580,,,,153060,153060,480,480,0,0.00,0
,20180207,153060,153060,,,,154050,154050,990,990,0,0.00,0
,20180208,154050,154050,,,,153320,153320,-730,-730,0,0.00,0
,20180209,153320,153320,,,,151190,151190,-2130,-2130,0,0.00,0
,20180212,151190,151190,,,,149950,149950,-1240,-1240,0,0.00,0
,20180213,149950,149950,,,,150070,150070,120,120,0,0.00,0
,20180214,150070,150070,,,,152110,152110,2040,2040,0,0.00,0
,20180222,152110,152110,,,,151380,151380,-730,-730,0,0.00,0
,20180223,151380,151380,,,,151060,151060,-320,-320,0,0.00,0
,20180226,151060,151060,,,,151290,151290,230,230,0,0.00,0
,20180227,151290,151290,,,,151670,151670,380,380,0,0.00,0
,20180228,151670,151670,146840,153110,146840,153110,149970,1440,-1700,8,119.98,4
,20180301,153110,149970,,,,149600,149600,-370,-370,0,0.00,4
,20180302,149600,149600,,,,148930,148930,-670,-670,0,0.00,4
,20180305,148930,148930,,,,149710,149710,780,780,0,0.00,4
,20180306,149710,149710,,,,148940,148940,-770,-770,0,0.00,4
,20180307,148940,148940,,,,148630,148630,-310,-310,0,0.00,4
,20180308,148630,148630,,,,148020,148020,-610,-610,0,0.00,4
,20180309,148020,148020,,,,148600,148600,580,580,0,0.00,4
,20180312,148600,148600,,,,148940,148940,340,340,0,0.00,4
,20180313,148940,148940,,,,148430,148430,-510,-510,0,0.00,4
,20180314,148430,148430,,,,147870,147870,-560,-560,0,0.00,4
,20180315,147870,147870,,,,147410,147410,-460,-460,0,0.00,4
,20180316,147410,147410,,,,146640,146640,-770,-770,0,0.00,4
,20180319,146640,146640,,,,147040,147040,400,400,0,0.00,4
,20180320,147040,147040,,,,146610,146610,-430,-430,0,0.00,4
,20180321,146610,146610,,,,146350,146350,-260,-260,0,0.00,4
,20180322,146350,146350,,,,146650,146650,300,300,0,0.00,4
,20180323,146650,146650,,,,145480,145480,-1170,-1170,0,0.00,4
,20180326,145480,145480,,,,144440,144440,-1040,-1040,0,0.00,4
,20180327,144440,144440,,,,144750,144750,310,310,0,0.00,4
,20180328,144750,144750,,,,143630,143630,-1120,-1120,0,0.00,4
,20180329,143630,143630,,,,143400,143400,-230,-230,0,0.00,4
,20180330,143400,143400,,,,145160,145160,1760,1760,0,0.00,4
,20180402,145160,145160,,,,147610,147610,2450,2450,0,0.00,4
,20180403,147610,147610,,,,146120,146120,-1490,-1490,0,0.00,4
,20180404,146120,146120,,,,146160,146160,40,40,0,0.00,4
,20180409,146160,146160,,,,146340,146340,180,180,0,0.00,4
,20180410,146340,146340,,,,146710,146710,370,370,0,0.00,4
,20180411,146710,146710,,,,146060,146060,-650,-650,0,0.00,4
,20180412,146060,146060,,,,145210,145210,-850,-850,0,0.00,4
,20180413,145210,145210,,,,145110,145110,-100,-100,0,0.00,4
,20180416,145110,145110,,,,145320,145320,210,210,0,0.00,4
,20180417,145320,145320,,,,146680,146680,1360,1360,0,0.00,4
,20180418,146680,146680,,,,147630,147630,950,950,0,0.00,4
,20180419,147630,147630,,,,148420,148420,790,790,0,0.00,4
,20180420,148420,148420,,,,148210,148210,-210,-210,0,0.00,4
,20180423,148210,148210,,,,148300,148300,90,90,0,0.00,4
,20180424,148300,148300,,,,147030,147030,-1270,-1270,0,0.00,4
,20180425,147030,147030,,,,146920,146920,-110,-110,0,0.00,4
,20180426,146920,146920,,,,147300,147300,380,380,0,0.00,4
,20180427,147300,147300,149300,149300,149300,149300,149300,2000,2000,4,59.72,0
,20180502,149300,149300,,,,148900,148900,-400,-400,0,0.00,0
,20180503,148900,148900,,,,148990,148990,90,90,0,0.00,0
,20180504,148990,148990,,,,149940,149940,950,950,0,0.00,0
,20180507,149940,149940,,,,149280,149280,-660,-660,0,0.00,0
,20180508,149280,149280,,,,148400,148400,-880,-880,0,0.00,0
,20180509,148400,148400,,,,147630,147630,-770,-770,0,0.00,0
,20180510,147630,147630,,,,147640,147640,10,10,0,0.00,0
,20180511,147640,147640,,,,147170,147170,-470,-470,0,0.00,0
,20180514,147170,147170,,,,147670,147670,500,500,0,0.00,0
,20180515,147670,147670,,,,147640,147640,-30,-30,0,0.00,0
,20180516,147640,147640,,,,147710,147710,70,70,0,0.00,0
,20180517,147710,147710,,,,147560,147560,-150,-150,0,0.00,0
,20180518,147560,147560,,,,146910,146910,-650,-650,0,0.00,0
,20180521,146910,146910,,,,147290,147290,380,380,0,0.00,0
,20180522,147290,147290,,,,147850,147850,560,560,0,0.00,0
,20180523,147850,147850,,,,148200,148200,350,350,0,0.00,0
,20180524,148200,148200,,,,149210,149210,1010,1010,0,0.00,0
,20180525,149210,149210,,,,149200,149200,-10,-10,0,0.00,0
,20180528,149200,149200,,,,151010,151010,1810,1810,0,0.00,0
,20180529,151010,151010,,,,154650,154650,3640,3640,0,0.00,0
,20180530,154650,154650,,,,156960,156960,2310,2310,0,0.00,0
,20180531,156960,156960,,,,156910,156910,-50,-50,0,0.00,0
sn1901,20180116,146870,146870,146970,148920,144010,148380,147680,1510,810,12,177.22,6
,20180117,148380,147680,147730,148930,147300,148770,147880,1090,200,12,177.47,6
,20180118,148770,147880,,,,147300,147300,-580,-580,0,0.00,6
,20180119,147300,147300,,,,147300,147300,0,0,0,0.00,6
,20180122,147300,147300,,,,147300,147300,0,0,0,0.00,6
,20180123,147300,147300,,,,147300,147300,0,0,0,0.00,6
,20180124,147300,147300,,,,147300,147300,0,0,0,0.00,6
,20180125,147300,147300,,,,147300,147300,0,0,0,0.00,6
,20180126,147300,147300,,,,148010,148010,710,710,0,0.00,6
,20180129,148010,148010,147870,153310,147870,152770,151060,4760,3050,32,483.40,12
,20180130,152770,151060,153210,153210,151530,151530,152520,470,1460,6,91.51,16
,20180131,151530,152520,150920,153370,149770,151970,151550,-550,-970,32,484.99,26
,20180201,151970,151550,,,,151550,151550,0,0,0,0.00,26
,20180202,151550,151550,151540,151540,151060,151060,151300,-490,-250,4,60.52,26
,20180205,151060,151300,149880,151550,149880,151550,150450,250,-850,22,331.00,36
,20180206,151550,150450,150500,151010,150500,151000,150830,550,380,6,90.50,40
,20180207,151000,150830,,,,150830,150830,0,0,0,0.00,40
,20180208,150830,150830,152550,152550,150300,150300,151680,-530,850,6,91.01,46
,20180209,150300,151680,150590,151490,149870,149870,151030,-1810,-650,76,"1,147.88",62
,20180212,149870,151030,149690,150310,149060,149540,149600,-1490,-1430,16,239.37,60
,20180213,149540,149600,149320,149450,149320,149450,149360,-150,-240,6,89.62,60
,20180214,149450,149360,149450,152490,149450,152490,150970,3130,1610,4,60.39,60
,20180222,152490,150970,150230,150230,149990,149990,150150,-980,-820,6,90.09,62
,20180223,149990,150150,150100,150100,150100,150100,150100,-50,-50,2,30.02,62
,20180226,150100,150100,,,,150100,150100,0,0,0,0.00,62
,20180227,150100,150100,,,,150860,150860,760,760,0,0.00,62
,20180228,150860,150860,,,,150860,150860,0,0,0,0.00,62
,20180301,150860,150860,150200,150200,150200,150200,150200,-660,-660,2,30.04,62
,20180302,150200,150200,150190,150220,150190,150190,150190,-10,-10,8,120.16,58
,20180305,150190,150190,150250,150500,150060,150500,150340,310,150,16,240.54,70
,20180306,150500,150340,149880,149880,149850,149850,149860,-490,-480,4,59.95,68
,20180307,149850,149860,149960,150210,149960,150210,150170,350,310,16,240.29,82
,20180308,150210,150170,149740,149740,149740,149740,149740,-430,-430,2,29.95,82
,20180309,149740,149740,149500,150200,142250,150040,149150,300,-590,28,417.63,80
,20180312,150040,149150,150100,150100,149740,149770,149870,620,720,6,89.92,84
,20180313,149770,149870,150050,150050,149310,149310,149690,-560,-180,8,119.76,82
,20180314,149310,149690,149050,149930,148750,149040,149180,-650,-510,20,298.37,80
,20180315,149040,149180,148560,148940,148140,148910,148450,-270,-730,28,415.68,84
,20180316,148910,148450,147860,148770,147170,148770,148080,320,-370,16,236.93,86
,20180319,148770,148080,148740,148740,147540,148740,148220,660,140,10,148.23,88
,20180320,148740,148220,147650,147920,147500,147650,147710,-570,-510,22,324.97,98
,20180321,147650,147710,147760,147760,147680,147680,147720,-30,10,4,59.09,100
,20180322,147680,147720,145720,147820,145720,147820,147430,100,-290,68,"1,002.54",116
,20180323,147820,147430,147840,147840,145010,145010,146030,-2420,-1400,32,467.30,134
,20180326,145010,146030,144870,145460,144870,145250,145120,-780,-910,30,435.38,132
,20180327,145250,145120,145580,145920,144630,144810,145410,-310,290,64,930.64,160
,20180328,144810,145410,144470,144470,144060,144060,144260,-1350,-1150,4,57.71,160
,20180329,144060,144260,143000,145790,143000,145790,144850,1530,590,48,695.31,136
,20180330,145790,144850,145760,148070,145150,148070,146840,3220,1990,26,381.79,140
,20180402,148070,146840,148000,149320,147520,149320,148520,2480,1680,80,"1,188.24",162
,20180403,149320,148520,149220,149540,148500,149300,148860,780,340,32,476.36,170
,20180404,149300,148860,148500,148620,148340,148620,148500,-240,-360,10,148.50,176
,20180409,148620,148500,,,,148500,148500,0,0,0,0.00,176
,20180410,148500,148500,148110,149300,148110,148480,148630,-20,130,8,118.90,178
,20180411,148480,148630,148260,148260,147580,147580,147810,-1050,-820,24,354.75,174
,20180412,147580,147810,147250,147380,146270,146270,146820,-1540,-990,16,234.93,172
,20180413,146270,146820,145720,147360,145720,147300,146820,480,0,44,646.02,176
,20180416,147300,146820,146990,147100,145970,147100,146800,280,-20,28,411.05,178
,20180417,147100,146800,148030,148890,147390,148260,148120,1460,1320,114,"1,688.68",248
,20180418,148260,148120,147000,150020,147000,149660,148320,1540,200,206,"3,055.43",224
,20180419,149660,148320,152350,152370,148820,149110,149690,790,1370,86,"1,287.40",202
,20180420,149110,149690,149860,150280,149490,149810,149770,120,80,56,838.76,204
,20180423,149810,149770,149690,149800,149690,149780,149740,10,-30,10,149.75,204
,20180424,149780,149740,148200,148850,147910,148000,148210,-1740,-1530,48,711.43,206
,20180425,148000,148210,148450,148450,147440,147440,147960,-770,-250,60,887.76,244
,20180426,147440,147960,146000,148760,146000,148490,147580,530,-380,168,"2,479.36",252
,20180427,148490,147580,148740,149620,148740,149150,149160,1570,1580,64,954.66,264
,20180502,149150,149160,149110,149160,148440,149160,148860,0,-300,72,"1,071.85",296
,20180503,149160,148860,150500,150500,148530,148830,149510,-30,650,144,"2,152.98",266
,20180504,148830,149510,149440,150060,149140,149320,149700,-190,190,124,"1,856.33",310
,20180507,149320,149700,148500,149470,148500,149300,149010,-400,-690,226,"3,367.83",324
,20180508,149300,149010,150480,150480,147810,147900,148970,-1110,-40,190,"2,830.58",278
,20180509,147900,148970,148230,148230,147190,147300,147570,-1670,-1400,34,501.75,280
,20180510,147300,147570,147300,147650,147300,147550,147510,-20,-60,10,147.52,282
,20180511,147550,147510,146910,147320,146880,147280,147100,-230,-410,48,706.08,284
,20180514,147280,147100,147250,147760,147210,147690,147510,590,410,22,324.54,274
,20180515,147690,147510,147300,147930,147270,147700,147690,190,180,84,"1,240.66",280
,20180516,147700,147690,147000,148190,147000,147660,147410,-30,-280,198,"2,918.75",314
,20180517,147660,147410,147040,148040,147040,147870,147700,460,290,138,"2,038.31",406
,20180518,147870,147700,147250,147300,146650,146800,146890,-900,-810,82,"1,204.54",464
,20180521,146800,146890,146680,148120,146370,148060,147170,1170,280,46,676.98,474
,20180522,148060,147170,147830,148260,147650,147650,147910,480,740,38,562.08,488
,20180523,147650,147910,147810,149230,147470,149000,148510,1090,600,80,"1,188.15",534
,20180524,149000,148510,149000,150000,148680,149990,149290,1480,780,176,"2,627.60",588
,20180525,149990,149290,149650,150000,147920,148490,148940,-800,-350,138,"2,055.45",618
,20180528,148490,148940,148600,152180,148380,152180,151350,3240,2410,678,"10,261.89",904
,20180529,152180,151350,151800,156000,151420,155500,154070,4150,2720,714,"11,001.16",1230
,20180530,155500,154070,155500,158320,153910,154010,156120,-60,2050,990,"15,456.21",1612
,20180531,154010,156120,154490,157470,154140,155940,156090,-180,-30,478,"7,461.56",1734
sn1902,20180212,151030,151030,,,,149600,149600,-1430,-1430,0,0.00,0
,20180213,149600,149600,,,,149600,149600,0,0,0,0.00,0
,20180214,149600,149600,,,,149600,149600,0,0,0,0.00,0
,20180222,149600,149600,,,,149600,149600,0,0,0,0.00,0
,20180223,149600,149600,,,,149600,149600,0,0,0,0.00,0
,20180226,149600,149600,,,,149830,149830,230,230,0,0.00,0
,20180227,149830,149830,,,,149830,149830,0,0,0,0.00,0
,20180228,149830,149830,,,,149830,149830,0,0,0,0.00,0
,20180301,149830,149830,,,,149830,149830,0,0,0,0.00,0
,20180302,149830,149830,,,,149830,149830,0,0,0,0.00,0
,20180305,149830,149830,,,,149830,149830,0,0,0,0.00,0
,20180306,149830,149830,,,,149830,149830,0,0,0,0.00,0
,20180307,149830,149830,,,,149830,149830,0,0,0,0.00,0
,20180308,149830,149830,,,,149830,149830,0,0,0,0.00,0
,20180309,149830,149830,,,,149830,149830,0,0,0,0.00,0
,20180312,149830,149830,,,,149830,149830,0,0,0,0.00,0
,20180313,149830,149830,,,,149830,149830,0,0,0,0.00,0
,20180314,149830,149830,,,,149320,149320,-510,-510,0,0.00,0
,20180315,149320,149320,,,,149320,149320,0,0,0,0.00,0
,20180316,149320,149320,,,,148940,148940,-380,-380,0,0.00,0
,20180319,148940,148940,,,,149080,149080,140,140,0,0.00,0
,20180320,149080,149080,,,,148570,148570,-510,-510,0,0.00,0
,20180321,148570,148570,,,,148580,148580,10,10,0,0.00,0
,20180322,148580,148580,,,,148290,148290,-290,-290,0,0.00,0
,20180323,148290,148290,,,,146880,146880,-1410,-1410,0,0.00,0
,20180326,146880,146880,,,,145970,145970,-910,-910,0,0.00,0
,20180327,145970,145970,,,,146260,146260,290,290,0,0.00,0
,20180328,146260,146260,,,,145100,145100,-1160,-1160,0,0.00,0
,20180329,145100,145100,,,,145690,145690,590,590,0,0.00,0
,20180330,145690,145690,,,,147690,147690,2000,2000,0,0.00,0
,20180402,147690,147690,,,,149380,149380,1690,1690,0,0.00,0
,20180403,149380,149380,,,,149720,149720,340,340,0,0.00,0
,20180404,149720,149720,,,,149350,149350,-370,-370,0,0.00,0
,20180409,149350,149350,,,,149530,149530,180,180,0,0.00,0
,20180410,149530,149530,,,,149660,149660,130,130,0,0.00,0
,20180411,149660,149660,,,,148830,148830,-830,-830,0,0.00,0
,20180412,148830,148830,,,,147840,147840,-990,-990,0,0.00,0
,20180413,147840,147840,,,,147840,147840,0,0,0,0.00,0
,20180416,147840,147840,,,,147820,147820,-20,-20,0,0.00,0
,20180417,147820,147820,,,,149150,149150,1330,1330,0,0.00,0
,20180418,149150,149150,,,,149350,149350,200,200,0,0.00,0
,20180419,149350,149350,,,,150730,150730,1380,1380,0,0.00,0
,20180420,150730,150730,,,,150810,150810,80,80,0,0.00,0
,20180423,150810,150810,,,,150780,150780,-30,-30,0,0.00,0
,20180424,150780,150780,,,,149240,149240,-1540,-1540,0,0.00,0
,20180425,149240,149240,,,,148980,148980,-260,-260,0,0.00,0
,20180426,148980,148980,,,,148590,148590,-390,-390,0,0.00,0
,20180427,148590,148590,,,,150180,150180,1590,1590,0,0.00,0
,20180502,150180,150180,,,,149880,149880,-300,-300,0,0.00,0
,20180503,149880,149880,,,,150530,150530,650,650,0,0.00,0
,20180504,150530,150530,,,,150530,150530,0,0,0,0.00,0
,20180507,150530,150530,,,,149840,149840,-690,-690,0,0.00,0
,20180508,149840,149840,,,,149800,149800,-40,-40,0,0.00,0
,20180509,149800,149800,,,,148390,148390,-1410,-1410,0,0.00,0
,20180510,148390,148390,,,,148330,148330,-60,-60,0,0.00,0
,20180511,148330,148330,,,,147910,147910,-420,-420,0,0.00,0
,20180514,147910,147910,,,,148330,148330,420,420,0,0.00,0
,20180515,148330,148330,,,,148510,148510,180,180,0,0.00,0
,20180516,148510,148510,,,,148220,148220,-290,-290,0,0.00,0
,20180517,148220,148220,,,,148510,148510,290,290,0,0.00,0
,20180518,148510,148510,,,,147700,147700,-810,-810,0,0.00,0
,20180521,147700,147700,,,,147980,147980,280,280,0,0.00,0
,20180522,147980,147980,,,,148720,148720,740,740,0,0.00,0
,20180523,148720,148720,,,,149330,149330,610,610,0,0.00,0
,20180524,149330,149330,,,,150120,150120,790,790,0,0.00,0
,20180525,150120,150120,,,,149770,149770,-350,-350,0,0.00,0
,20180528,149770,149770,,,,152190,152190,2420,2420,0,0.00,0
,20180529,152190,152190,,,,154930,154930,2740,2740,0,0.00,0
,20180530,154930,154930,,,,156990,156990,2060,2060,0,0.00,0
,20180531,156990,156990,,,,156960,156960,-30,-30,0,0.00,0
sn1903,20180316,149320,149320,,,,149320,149320,0,0,0,0.00,0
,20180319,149320,149320,149700,149700,148200,148200,148950,-1120,-370,4,59.58,0
,20180320,148200,148950,,,,148440,148440,-510,-510,0,0.00,0
,20180321,148440,148440,,,,148450,148450,10,10,0,0.00,0
,20180322,148450,148450,,,,148160,148160,-290,-290,0,0.00,0
,20180323,148160,148160,,,,146750,146750,-1410,-1410,0,0.00,0
,20180326,146750,146750,,,,145840,145840,-910,-910,0,0.00,0
,20180327,145840,145840,,,,145840,145840,0,0,0,0.00,0
,20180328,145840,145840,,,,144690,144690,-1150,-1150,0,0.00,0
,20180329,144690,144690,,,,145280,145280,590,590,0,0.00,0
,20180330,145280,145280,,,,147270,147270,1990,1990,0,0.00,0
,20180402,147270,147270,,,,147270,147270,0,0,0,0.00,0
,20180403,147270,147270,,,,147270,147270,0,0,0,0.00,0
,20180404,147270,147270,,,,146910,146910,-360,-360,0,0.00,0
,20180409,146910,146910,,,,147090,147090,180,180,0,0.00,0
,20180410,147090,147090,,,,147210,147210,120,120,0,0.00,0
,20180411,147210,147210,,,,146400,146400,-810,-810,0,0.00,0
,20180412,146400,146400,,,,145420,145420,-980,-980,0,0.00,0
,20180413,145420,145420,,,,145420,145420,0,0,0,0.00,0
,20180416,145420,145420,,,,145400,145400,-20,-20,0,0.00,0
,20180417,145400,145400,,,,146710,146710,1310,1310,0,0.00,0
,20180418,146710,146710,,,,146910,146910,200,200,0,0.00,0
,20180419,146910,146910,,,,148270,148270,1360,1360,0,0.00,0
,20180420,148270,148270,,,,148350,148350,80,80,0,0.00,0
,20180423,148350,148350,,,,148320,148320,-30,-30,0,0.00,0
,20180424,148320,148320,,,,146800,146800,-1520,-1520,0,0.00,0
,20180425,146800,146800,,,,146550,146550,-250,-250,0,0.00,0
,20180426,146550,146550,,,,146170,146170,-380,-380,0,0.00,0
,20180427,146170,146170,,,,147740,147740,1570,1570,0,0.00,0
,20180502,147740,147740,,,,147740,147740,0,0,0,0.00,0
,20180503,147740,147740,,,,147740,147740,0,0,0,0.00,0
,20180504,147740,147740,,,,147930,147930,190,190,0,0.00,0
,20180507,147930,147930,,,,147930,147930,0,0,0,0.00,0
,20180508,147930,147930,,,,147890,147890,-40,-40,0,0.00,0
,20180509,147890,147890,,,,146500,146500,-1390,-1390,0,0.00,0
,20180510,146500,146500,,,,146500,146500,0,0,0,0.00,0
,20180511,146500,146500,,,,146500,146500,0,0,0,0.00,0
,20180514,146500,146500,,,,146500,146500,0,0,0,0.00,0
,20180515,146500,146500,,,,146500,146500,0,0,0,0.00,0
,20180516,146500,146500,,,,146500,146500,0,0,0,0.00,0
,20180517,146500,146500,,,,146790,146790,290,290,0,0.00,0
,20180518,146790,146790,,,,146790,146790,0,0,0,0.00,0
,20180521,146790,146790,,,,146790,146790,0,0,0,0.00,0
,20180522,146790,146790,,,,147530,147530,740,740,0,0.00,0
,20180523,147530,147530,,,,147530,147530,0,0,0,0.00,0
,20180524,147530,147530,,,,147530,147530,0,0,0,0.00,0
,20180525,147530,147530,,,,147530,147530,0,0,0,0.00,0
,20180528,147530,147530,,,,149920,149920,2390,2390,0,0.00,0
,20180529,149920,149920,,,,152620,152620,2700,2700,0,0.00,0
,20180530,152620,152620,,,,154650,154650,2030,2030,0,0.00,0
,20180531,154650,154650,,,,154620,154620,-30,-30,0,0.00,0
sn1904,20180417,145400,145400,,,,146710,146710,1310,1310,0,0.00,0
,20180418,146710,146710,,,,146910,146910,200,200,0,0.00,0
,20180419,146910,146910,,,,148270,148270,1360,1360,0,0.00,0
,20180420,148270,148270,,,,148270,148270,0,0,0,0.00,0
,20180423,148270,148270,,,,148240,148240,-30,-30,0,0.00,0
,20180424,148240,148240,,,,146720,146720,-1520,-1520,0,0.00,0
,20180425,146720,146720,,,,146470,146470,-250,-250,0,0.00,0
,20180426,146470,146470,,,,146470,146470,0,0,0,0.00,0
,20180427,146470,146470,,,,148040,148040,1570,1570,0,0.00,0
,20180502,148040,148040,,,,147750,147750,-290,-290,0,0.00,0
,20180503,147750,147750,,,,148390,148390,640,640,0,0.00,0
,20180504,148390,148390,,,,148580,148580,190,190,0,0.00,0
,20180507,148580,148580,,,,148580,148580,0,0,0,0.00,0
,20180508,148580,148580,,,,148580,148580,0,0,0,0.00,0
,20180509,148580,148580,,,,147180,147180,-1400,-1400,0,0.00,0
,20180510,147180,147180,,,,147180,147180,0,0,0,0.00,0
,20180511,147180,147180,,,,146770,146770,-410,-410,0,0.00,0
,20180514,146770,146770,,,,147180,147180,410,410,0,0.00,0
,20180515,147180,147180,,,,147360,147360,180,180,0,0.00,0
,20180516,147360,147360,,,,147080,147080,-280,-280,0,0.00,0
,20180517,147080,147080,,,,147370,147370,290,290,0,0.00,0
,20180518,147370,147370,,,,146560,146560,-810,-810,0,0.00,0
,20180521,146560,146560,,,,146830,146830,270,270,0,0.00,0
,20180522,146830,146830,,,,147570,147570,740,740,0,0.00,0
,20180523,147570,147570,,,,148170,148170,600,600,0,0.00,0
,20180524,148170,148170,,,,148950,148950,780,780,0,0.00,0
,20180525,148950,148950,,,,148600,148600,-350,-350,0,0.00,0
,20180528,148600,148600,,,,151000,151000,2400,2400,0,0.00,0
,20180529,151000,151000,,,,153720,153720,2720,2720,0,0.00,0
,20180530,153720,153720,,,,155760,155760,2040,2040,0,0.00,0
,20180531,155760,155760,,,,155730,155730,-30,-30,0,0.00,0
sn1905,20180516,147360,147360,,,,147360,147360,0,0,0,0.00,0
,20180517,147360,147360,148220,148770,147340,148350,148250,990,890,10,148.25,8
,20180518,148350,148250,148000,148000,148000,148000,148000,-250,-250,2,29.60,10
,20180521,148000,148000,147450,147450,147450,147450,147450,-550,-550,2,29.49,10
,20180522,147450,147450,,,,147450,147450,0,0,0,0.00,10
,20180523,147450,147450,149090,149440,148090,149440,148760,1990,1310,14,208.27,20
,20180524,149440,148760,149920,150440,149480,150440,150100,1680,1340,26,390.27,46
,20180525,150440,150100,150360,150470,149000,149000,149910,-1100,-190,24,359.80,46
,20180528,149000,149910,149400,152770,149400,152130,151980,2220,2070,56,851.12,96
,20180529,152130,151980,152260,156260,152260,155510,154490,3530,2510,86,"1,328.63",158
,20180530,155510,154490,155990,158270,153880,154590,155970,100,1480,36,561.51,176
,20180531,154590,155970,156730,157390,154560,156310,156450,340,480,46,719.68,198
wr1801,20180102,3121,3121,,,,3121,3121,0,0,0,0.00,0
,20180103,3121,3121,,,,3121,3121,0,0,0,0.00,0
,20180104,3121,3121,,,,3121,3121,0,0,0,0.00,0
,20180105,3121,3121,,,,3121,3121,0,0,0,0.00,0
,20180108,3121,3121,,,,3121,3121,0,0,0,0.00,0
,20180109,3121,3121,,,,3121,3121,0,0,0,0.00,0
,20180110,3121,3121,,,,3121,3121,0,0,0,0.00,0
,20180111,3121,3121,,,,3121,3121,0,0,0,0.00,0
,20180112,3121,3121,,,,3121,3121,0,0,0,0.00,0
,20180115,3121,3121,,,,3121,3121,0,0,0,0.00,0
wr1802,20180102,3121,3121,,,,3121,3121,0,0,0,0.00,0
,20180103,3121,3121,,,,3121,3121,0,0,0,0.00,0
,20180104,3121,3121,,,,3121,3121,0,0,0,0.00,0
,20180105,3121,3121,,,,3121,3121,0,0,0,0.00,0
,20180108,3121,3121,,,,3121,3121,0,0,0,0.00,0
,20180109,3121,3121,,,,3121,3121,0,0,0,0.00,0
,20180110,3121,3121,,,,3121,3121,0,0,0,0.00,0
,20180111,3121,3121,,,,3121,3121,0,0,0,0.00,0
,20180112,3121,3121,,,,3121,3121,0,0,0,0.00,0
,20180115,3121,3121,,,,3121,3121,0,0,0,0.00,0
,20180116,3121,3121,,,,3121,3121,0,0,0,0.00,0
,20180117,3121,3121,,,,3121,3121,0,0,0,0.00,0
,20180118,3121,3121,,,,3121,3121,0,0,0,0.00,0
,20180119,3121,3121,,,,3121,3121,0,0,0,0.00,0
,20180122,3121,3121,,,,3121,3121,0,0,0,0.00,0
,20180123,3121,3121,,,,3121,3121,0,0,0,0.00,0
,20180124,3121,3121,,,,3121,3121,0,0,0,0.00,0
,20180125,3121,3121,,,,3121,3121,0,0,0,0.00,0
,20180126,3121,3121,,,,3121,3121,0,0,0,0.00,0
,20180129,3121,3121,,,,3121,3121,0,0,0,0.00,0
,20180130,3121,3121,,,,3121,3121,0,0,0,0.00,0
,20180131,3121,3121,,,,3121,3121,0,0,0,0.00,0
,20180201,3121,3121,,,,3121,3121,0,0,0,0.00,0
,20180202,3121,3121,,,,3121,3121,0,0,0,0.00,0
,20180205,3121,3121,,,,3121,3121,0,0,0,0.00,0
,20180206,3121,3121,,,,3121,3121,0,0,0,0.00,0
,20180207,3121,3121,,,,3121,3121,0,0,0,0.00,0
,20180208,3121,3121,,,,3121,3121,0,0,0,0.00,0
,20180209,3121,3121,,,,3121,3121,0,0,0,0.00,0
wr1803,20180102,3121,3121,,,,3121,3121,0,0,0,0.00,0
,20180103,3121,3121,,,,3121,3121,0,0,0,0.00,0
,20180104,3121,3121,,,,3121,3121,0,0,0,0.00,0
,20180105,3121,3121,,,,3121,3121,0,0,0,0.00,0
,20180108,3121,3121,,,,3121,3121,0,0,0,0.00,0
,20180109,3121,3121,,,,3121,3121,0,0,0,0.00,0
,20180110,3121,3121,,,,3121,3121,0,0,0,0.00,0
,20180111,3121,3121,,,,3121,3121,0,0,0,0.00,0
,20180112,3121,3121,,,,3121,3121,0,0,0,0.00,0
,20180115,3121,3121,,,,3121,3121,0,0,0,0.00,0
,20180116,3121,3121,,,,3121,3121,0,0,0,0.00,0
,20180117,3121,3121,,,,3121,3121,0,0,0,0.00,0
,20180118,3121,3121,,,,3121,3121,0,0,0,0.00,0
,20180119,3121,3121,,,,3121,3121,0,0,0,0.00,0
,20180122,3121,3121,,,,3121,3121,0,0,0,0.00,0
,20180123,3121,3121,,,,3121,3121,0,0,0,0.00,0
,20180124,3121,3121,,,,3121,3121,0,0,0,0.00,0
,20180125,3121,3121,,,,3121,3121,0,0,0,0.00,0
,20180126,3121,3121,,,,3121,3121,0,0,0,0.00,0
,20180129,3121,3121,,,,3121,3121,0,0,0,0.00,0
,20180130,3121,3121,,,,3121,3121,0,0,0,0.00,0
,20180131,3121,3121,,,,3121,3121,0,0,0,0.00,0
,20180201,3121,3121,,,,3121,3121,0,0,0,0.00,0
,20180202,3121,3121,,,,3121,3121,0,0,0,0.00,0
,20180205,3121,3121,,,,3121,3121,0,0,0,0.00,0
,20180206,3121,3121,,,,3121,3121,0,0,0,0.00,0
,20180207,3121,3121,,,,3121,3121,0,0,0,0.00,0
,20180208,3121,3121,,,,3121,3121,0,0,0,0.00,0
,20180209,3121,3121,,,,3121,3121,0,0,0,0.00,0
,20180212,3121,3121,,,,3121,3121,0,0,0,0.00,0
,20180213,3121,3121,,,,3121,3121,0,0,0,0.00,0
,20180214,3121,3121,,,,3121,3121,0,0,0,0.00,0
,20180222,3121,3121,,,,3121,3121,0,0,0,0.00,0
,20180223,3121,3121,,,,3121,3121,0,0,0,0.00,0
,20180226,3121,3121,,,,3121,3121,0,0,0,0.00,0
,20180227,3121,3121,,,,3121,3121,0,0,0,0.00,0
,20180228,3121,3121,,,,3121,3121,0,0,0,0.00,0
,20180301,3121,3121,,,,3121,3121,0,0,0,0.00,0
,20180302,3121,3121,,,,3121,3121,0,0,0,0.00,0
,20180305,3121,3121,,,,3121,3121,0,0,0,0.00,0
,20180306,3121,3121,,,,3121,3121,0,0,0,0.00,0
,20180307,3121,3121,,,,3121,3121,0,0,0,0.00,0
,20180308,3121,3121,,,,3121,3121,0,0,0,0.00,0
,20180309,3121,3121,,,,3121,3121,0,0,0,0.00,0
,20180312,3121,3121,,,,3121,3121,0,0,0,0.00,0
,20180313,3121,3121,,,,3121,3121,0,0,0,0.00,0
,20180314,3121,3121,,,,3121,3121,0,0,0,0.00,0
,20180315,3121,3121,,,,3121,3121,0,0,0,0.00,0
wr1804,20180102,3121,3121,,,,3121,3121,0,0,0,0.00,0
,20180103,3121,3121,,,,3121,3121,0,0,0,0.00,0
,20180104,3121,3121,,,,3121,3121,0,0,0,0.00,0
,20180105,3121,3121,,,,3121,3121,0,0,0,0.00,0
,20180108,3121,3121,,,,3121,3121,0,0,0,0.00,0
,20180109,3121,3121,,,,3121,3121,0,0,0,0.00,0
,20180110,3121,3121,,,,3121,3121,0,0,0,0.00,0
,20180111,3121,3121,,,,3121,3121,0,0,0,0.00,0
,20180112,3121,3121,,,,3121,3121,0,0,0,0.00,0
,20180115,3121,3121,,,,3121,3121,0,0,0,0.00,0
,20180116,3121,3121,,,,3121,3121,0,0,0,0.00,0
,20180117,3121,3121,,,,3121,3121,0,0,0,0.00,0
,20180118,3121,3121,,,,3121,3121,0,0,0,0.00,0
,20180119,3121,3121,,,,3121,3121,0,0,0,0.00,0
,20180122,3121,3121,,,,3121,3121,0,0,0,0.00,0
,20180123,3121,3121,,,,3121,3121,0,0,0,0.00,0
,20180124,3121,3121,,,,3121,3121,0,0,0,0.00,0
,20180125,3121,3121,,,,3121,3121,0,0,0,0.00,0
,20180126,3121,3121,,,,3121,3121,0,0,0,0.00,0
,20180129,3121,3121,,,,3121,3121,0,0,0,0.00,0
,20180130,3121,3121,,,,3121,3121,0,0,0,0.00,0
,20180131,3121,3121,,,,3121,3121,0,0,0,0.00,0
,20180201,3121,3121,,,,3121,3121,0,0,0,0.00,0
,20180202,3121,3121,,,,3121,3121,0,0,0,0.00,0
,20180205,3121,3121,,,,3121,3121,0,0,0,0.00,0
,20180206,3121,3121,,,,3121,3121,0,0,0,0.00,0
,20180207,3121,3121,,,,3121,3121,0,0,0,0.00,0
,20180208,3121,3121,,,,3121,3121,0,0,0,0.00,0
,20180209,3121,3121,,,,3121,3121,0,0,0,0.00,0
,20180212,3121,3121,,,,3121,3121,0,0,0,0.00,0
,20180213,3121,3121,,,,3121,3121,0,0,0,0.00,0
,20180214,3121,3121,,,,3121,3121,0,0,0,0.00,0
,20180222,3121,3121,,,,3121,3121,0,0,0,0.00,0
,20180223,3121,3121,,,,3121,3121,0,0,0,0.00,0
,20180226,3121,3121,,,,3121,3121,0,0,0,0.00,0
,20180227,3121,3121,,,,3121,3121,0,0,0,0.00,0
,20180228,3121,3121,,,,3121,3121,0,0,0,0.00,0
,20180301,3121,3121,,,,3121,3121,0,0,0,0.00,0
,20180302,3121,3121,,,,3121,3121,0,0,0,0.00,0
,20180305,3121,3121,,,,3121,3121,0,0,0,0.00,0
,20180306,3121,3121,,,,3121,3121,0,0,0,0.00,0
,20180307,3121,3121,,,,3121,3121,0,0,0,0.00,0
,20180308,3121,3121,,,,3121,3121,0,0,0,0.00,0
,20180309,3121,3121,,,,3121,3121,0,0,0,0.00,0
,20180312,3121,3121,,,,3121,3121,0,0,0,0.00,0
,20180313,3121,3121,,,,3121,3121,0,0,0,0.00,0
,20180314,3121,3121,,,,3121,3121,0,0,0,0.00,0
,20180315,3121,3121,,,,3121,3121,0,0,0,0.00,0
,20180316,3121,3121,,,,3121,3121,0,0,0,0.00,0
,20180319,3121,3121,,,,3121,3121,0,0,0,0.00,0
,20180320,3121,3121,,,,3121,3121,0,0,0,0.00,0
,20180321,3121,3121,,,,3121,3121,0,0,0,0.00,0
,20180322,3121,3121,,,,3121,3121,0,0,0,0.00,0
,20180323,3121,3121,,,,3121,3121,0,0,0,0.00,0
,20180326,3121,3121,,,,3121,3121,0,0,0,0.00,0
,20180327,3121,3121,,,,3121,3121,0,0,0,0.00,0
,20180328,3121,3121,,,,3121,3121,0,0,0,0.00,0
,20180329,3121,3121,,,,3121,3121,0,0,0,0.00,0
,20180330,3121,3121,,,,3121,3121,0,0,0,0.00,0
,20180402,3121,3121,,,,3121,3121,0,0,0,0.00,0
,20180403,3121,3121,,,,3121,3121,0,0,0,0.00,0
,20180404,3121,3121,,,,3121,3121,0,0,0,0.00,0
,20180409,3121,3121,,,,3121,3121,0,0,0,0.00,0
,20180410,3121,3121,,,,3121,3121,0,0,0,0.00,0
,20180411,3121,3121,,,,3121,3121,0,0,0,0.00,0
,20180412,3121,3121,,,,3121,3121,0,0,0,0.00,0
,20180413,3121,3121,,,,3121,3121,0,0,0,0.00,0
,20180416,3121,3121,,,,3121,3121,0,0,0,0.00,0
wr1805,20180102,3121,3121,,,,3121,3121,0,0,0,0.00,0
,20180103,3121,3121,,,,3121,3121,0,0,0,0.00,0
,20180104,3121,3121,,,,3121,3121,0,0,0,0.00,0
,20180105,3121,3121,,,,3121,3121,0,0,0,0.00,0
,20180108,3121,3121,,,,3121,3121,0,0,0,0.00,0
,20180109,3121,3121,,,,3121,3121,0,0,0,0.00,0
,20180110,3121,3121,,,,3121,3121,0,0,0,0.00,0
,20180111,3121,3121,,,,3121,3121,0,0,0,0.00,0
,20180112,3121,3121,,,,3121,3121,0,0,0,0.00,0
,20180115,3121,3121,,,,3121,3121,0,0,0,0.00,0
,20180116,3121,3121,,,,3121,3121,0,0,0,0.00,0
,20180117,3121,3121,,,,3121,3121,0,0,0,0.00,0
,20180118,3121,3121,,,,3121,3121,0,0,0,0.00,0
,20180119,3121,3121,,,,3121,3121,0,0,0,0.00,0
,20180122,3121,3121,,,,3121,3121,0,0,0,0.00,0
,20180123,3121,3121,,,,3121,3121,0,0,0,0.00,0
,20180124,3121,3121,,,,3121,3121,0,0,0,0.00,0
,20180125,3121,3121,,,,3121,3121,0,0,0,0.00,0
,20180126,3121,3121,,,,3121,3121,0,0,0,0.00,0
,20180129,3121,3121,,,,3121,3121,0,0,0,0.00,0
,20180130,3121,3121,,,,3121,3121,0,0,0,0.00,0
,20180131,3121,3121,,,,3121,3121,0,0,0,0.00,0
,20180201,3121,3121,,,,3121,3121,0,0,0,0.00,0
,20180202,3121,3121,,,,3121,3121,0,0,0,0.00,0
,20180205,3121,3121,,,,3121,3121,0,0,0,0.00,0
,20180206,3121,3121,,,,3121,3121,0,0,0,0.00,0
,20180207,3121,3121,,,,3121,3121,0,0,0,0.00,0
,20180208,3121,3121,,,,3121,3121,0,0,0,0.00,0
,20180209,3121,3121,,,,3121,3121,0,0,0,0.00,0
,20180212,3121,3121,,,,3121,3121,0,0,0,0.00,0
,20180213,3121,3121,,,,3121,3121,0,0,0,0.00,0
,20180214,3121,3121,,,,3121,3121,0,0,0,0.00,0
,20180222,3121,3121,,,,3121,3121,0,0,0,0.00,0
,20180223,3121,3121,,,,3121,3121,0,0,0,0.00,0
,20180226,3121,3121,,,,3121,3121,0,0,0,0.00,0
,20180227,3121,3121,,,,3121,3121,0,0,0,0.00,0
,20180228,3121,3121,,,,3121,3121,0,0,0,0.00,0
,20180301,3121,3121,,,,3121,3121,0,0,0,0.00,0
,20180302,3121,3121,,,,3121,3121,0,0,0,0.00,0
,20180305,3121,3121,,,,3121,3121,0,0,0,0.00,0
,20180306,3121,3121,,,,3121,3121,0,0,0,0.00,0
,20180307,3121,3121,,,,3121,3121,0,0,0,0.00,0
,20180308,3121,3121,,,,3121,3121,0,0,0,0.00,0
,20180309,3121,3121,,,,3121,3121,0,0,0,0.00,0
,20180312,3121,3121,,,,3121,3121,0,0,0,0.00,0
,20180313,3121,3121,,,,3121,3121,0,0,0,0.00,0
,20180314,3121,3121,,,,3121,3121,0,0,0,0.00,0
,20180315,3121,3121,,,,3121,3121,0,0,0,0.00,0
,20180316,3121,3121,3131,3131,3131,3131,3131,10,10,20,62.62,20
,20180319,3131,3131,,,,3287,3287,156,156,0,0.00,20
,20180320,3287,3287,,,,3451,3451,164,164,0,0.00,20
,20180321,3451,3451,3278,3278,3278,3278,3278,-173,-173,2,6.56,20
,20180322,3278,3278,,,,3439,3439,161,161,0,0.00,20
,20180323,3439,3439,3401,3401,3401,3401,3401,-38,-38,20,68.02,0
,20180326,3401,3401,,,,3401,3401,0,0,0,0.00,0
,20180327,3401,3401,,,,3401,3401,0,0,0,0.00,0
,20180328,3401,3401,,,,3401,3401,0,0,0,0.00,0
,20180329,3401,3401,,,,3401,3401,0,0,0,0.00,0
,20180330,3401,3401,,,,3401,3401,0,0,0,0.00,0
,20180402,3401,3401,,,,3401,3401,0,0,0,0.00,0
,20180403,3401,3401,,,,3401,3401,0,0,0,0.00,0
,20180404,3401,3401,,,,3401,3401,0,0,0,0.00,0
,20180409,3401,3401,,,,3401,3401,0,0,0,0.00,0
,20180410,3401,3401,,,,3401,3401,0,0,0,0.00,0
,20180411,3401,3401,,,,3401,3401,0,0,0,0.00,0
,20180412,3401,3401,,,,3401,3401,0,0,0,0.00,0
,20180413,3401,3401,,,,3401,3401,0,0,0,0.00,0
,20180416,3401,3401,,,,3401,3401,0,0,0,0.00,0
,20180417,3401,3401,,,,3401,3401,0,0,0,0.00,0
,20180418,3401,3401,,,,3401,3401,0,0,0,0.00,0
,20180419,3401,3401,,,,3401,3401,0,0,0,0.00,0
,20180420,3401,3401,,,,3401,3401,0,0,0,0.00,0
,20180423,3401,3401,,,,3401,3401,0,0,0,0.00,0
,20180424,3401,3401,,,,3401,3401,0,0,0,0.00,0
,20180425,3401,3401,,,,3401,3401,0,0,0,0.00,0
,20180426,3401,3401,,,,3401,3401,0,0,0,0.00,0
,20180427,3401,3401,,,,3401,3401,0,0,0,0.00,0
,20180502,3401,3401,,,,3401,3401,0,0,0,0.00,0
,20180503,3401,3401,,,,3401,3401,0,0,0,0.00,0
,20180504,3401,3401,,,,3401,3401,0,0,0,0.00,0
,20180507,3401,3401,,,,3401,3401,0,0,0,0.00,0
,20180508,3401,3401,,,,3401,3401,0,0,0,0.00,0
,20180509,3401,3401,,,,3401,3401,0,0,0,0.00,0
,20180510,3401,3401,,,,3401,3401,0,0,0,0.00,0
,20180511,3401,3401,,,,3401,3401,0,0,0,0.00,0
,20180514,3401,3401,,,,3401,3401,0,0,0,0.00,0
,20180515,3401,3401,,,,4083,4083,682,682,0,0.00,0
wr1806,20180102,3121,3121,,,,3121,3121,0,0,0,0.00,0
,20180103,3121,3121,,,,3121,3121,0,0,0,0.00,0
,20180104,3121,3121,,,,3121,3121,0,0,0,0.00,0
,20180105,3121,3121,,,,3121,3121,0,0,0,0.00,0
,20180108,3121,3121,,,,3121,3121,0,0,0,0.00,0
,20180109,3121,3121,,,,3121,3121,0,0,0,0.00,0
,20180110,3121,3121,,,,3121,3121,0,0,0,0.00,0
,20180111,3121,3121,,,,3121,3121,0,0,0,0.00,0
,20180112,3121,3121,,,,3121,3121,0,0,0,0.00,0
,20180115,3121,3121,,,,3121,3121,0,0,0,0.00,0
,20180116,3121,3121,,,,3121,3121,0,0,0,0.00,0
,20180117,3121,3121,,,,3121,3121,0,0,0,0.00,0
,20180118,3121,3121,,,,3121,3121,0,0,0,0.00,0
,20180119,3121,3121,,,,3121,3121,0,0,0,0.00,0
,20180122,3121,3121,,,,3121,3121,0,0,0,0.00,0
,20180123,3121,3121,,,,3121,3121,0,0,0,0.00,0
,20180124,3121,3121,,,,3121,3121,0,0,0,0.00,0
,20180125,3121,3121,,,,3121,3121,0,0,0,0.00,0
,20180126,3121,3121,,,,3121,3121,0,0,0,0.00,0
,20180129,3121,3121,,,,3121,3121,0,0,0,0.00,0
,20180130,3121,3121,,,,3121,3121,0,0,0,0.00,0
,20180131,3121,3121,,,,3121,3121,0,0,0,0.00,0
,20180201,3121,3121,,,,3121,3121,0,0,0,0.00,0
,20180202,3121,3121,,,,3121,3121,0,0,0,0.00,0
,20180205,3121,3121,,,,3121,3121,0,0,0,0.00,0
,20180206,3121,3121,,,,3121,3121,0,0,0,0.00,0
,20180207,3121,3121,,,,3121,3121,0,0,0,0.00,0
,20180208,3121,3121,,,,3121,3121,0,0,0,0.00,0
,20180209,3121,3121,,,,3121,3121,0,0,0,0.00,0
,20180212,3121,3121,,,,3121,3121,0,0,0,0.00,0
,20180213,3121,3121,,,,3121,3121,0,0,0,0.00,0
,20180214,3121,3121,,,,3121,3121,0,0,0,0.00,0
,20180222,3121,3121,,,,3121,3121,0,0,0,0.00,0
,20180223,3121,3121,,,,3121,3121,0,0,0,0.00,0
,20180226,3121,3121,,,,3121,3121,0,0,0,0.00,0
,20180227,3121,3121,,,,3121,3121,0,0,0,0.00,0
,20180228,3121,3121,,,,3121,3121,0,0,0,0.00,0
,20180301,3121,3121,,,,3121,3121,0,0,0,0.00,0
,20180302,3121,3121,,,,3121,3121,0,0,0,0.00,0
,20180305,3121,3121,,,,3121,3121,0,0,0,0.00,0
,20180306,3121,3121,,,,3121,3121,0,0,0,0.00,0
,20180307,3121,3121,,,,3121,3121,0,0,0,0.00,0
,20180308,3121,3121,,,,3121,3121,0,0,0,0.00,0
,20180309,3121,3121,,,,3121,3121,0,0,0,0.00,0
,20180312,3121,3121,,,,3121,3121,0,0,0,0.00,0
,20180313,3121,3121,,,,3121,3121,0,0,0,0.00,0
,20180314,3121,3121,,,,3121,3121,0,0,0,0.00,0
,20180315,3121,3121,,,,3121,3121,0,0,0,0.00,0
,20180316,3121,3121,,,,3131,3131,10,10,0,0.00,0
,20180319,3131,3131,,,,3131,3131,0,0,0,0.00,0
,20180320,3131,3131,,,,3131,3131,0,0,0,0.00,0
,20180321,3131,3131,,,,2974,2974,-157,-157,0,0.00,0
,20180322,2974,2974,,,,2974,2974,0,0,0,0.00,0
,20180323,2974,2974,,,,2941,2941,-33,-33,0,0.00,0
,20180326,2941,2941,,,,2941,2941,0,0,0,0.00,0
,20180327,2941,2941,,,,2941,2941,0,0,0,0.00,0
,20180328,2941,2941,,,,2941,2941,0,0,0,0.00,0
,20180329,2941,2941,,,,2941,2941,0,0,0,0.00,0
,20180330,2941,2941,,,,2941,2941,0,0,0,0.00,0
,20180402,2941,2941,,,,2941,2941,0,0,0,0.00,0
,20180403,2941,2941,,,,2941,2941,0,0,0,0.00,0
,20180404,2941,2941,,,,2941,2941,0,0,0,0.00,0
,20180409,2941,2941,,,,2941,2941,0,0,0,0.00,0
,20180410,2941,2941,,,,2941,2941,0,0,0,0.00,0
,20180411,2941,2941,,,,2941,2941,0,0,0,0.00,0
,20180412,2941,2941,,,,2941,2941,0,0,0,0.00,0
,20180413,2941,2941,,,,2941,2941,0,0,0,0.00,0
,20180416,2941,2941,,,,2941,2941,0,0,0,0.00,0
,20180417,2941,2941,,,,2941,2941,0,0,0,0.00,0
,20180418,2941,2941,,,,2941,2941,0,0,0,0.00,0
,20180419,2941,2941,,,,2941,2941,0,0,0,0.00,0
,20180420,2941,2941,,,,2941,2941,0,0,0,0.00,0
,20180423,2941,2941,,,,2941,2941,0,0,0,0.00,0
,20180424,2941,2941,,,,2941,2941,0,0,0,0.00,0
,20180425,2941,2941,,,,2941,2941,0,0,0,0.00,0
,20180426,2941,2941,,,,2941,2941,0,0,0,0.00,0
,20180427,2941,2941,,,,2941,2941,0,0,0,0.00,0
,20180502,2941,2941,,,,2941,2941,0,0,0,0.00,0
,20180503,2941,2941,,,,2941,2941,0,0,0,0.00,0
,20180504,2941,2941,,,,2941,2941,0,0,0,0.00,0
,20180507,2941,2941,,,,2941,2941,0,0,0,0.00,0
,20180508,2941,2941,,,,2941,2941,0,0,0,0.00,0
,20180509,2941,2941,,,,2941,2941,0,0,0,0.00,0
,20180510,2941,2941,,,,2941,2941,0,0,0,0.00,0
,20180511,2941,2941,,,,2941,2941,0,0,0,0.00,0
,20180514,2941,2941,,,,2941,2941,0,0,0,0.00,0
,20180515,2941,2941,,,,4212,4212,1271,1271,0,0.00,0
,20180516,4212,4212,,,,4212,4212,0,0,0,0.00,0
,20180517,4212,4212,,,,4212,4212,0,0,0,0.00,0
,20180518,4212,4212,,,,4212,4212,0,0,0,0.00,0
,20180521,4212,4212,,,,4212,4212,0,0,0,0.00,0
,20180522,4212,4212,,,,4212,4212,0,0,0,0.00,0
,20180523,4212,4212,,,,4212,4212,0,0,0,0.00,0
,20180524,4212,4212,,,,4212,4212,0,0,0,0.00,0
,20180525,4212,4212,,,,4212,4212,0,0,0,0.00,0
,20180528,4212,4212,,,,4212,4212,0,0,0,0.00,0
,20180529,4212,4212,,,,4212,4212,0,0,0,0.00,0
,20180530,4212,4212,,,,4212,4212,0,0,0,0.00,0
,20180531,4212,4212,,,,4212,4212,0,0,0,0.00,0
wr1807,20180102,3121,3121,,,,3121,3121,0,0,0,0.00,0
,20180103,3121,3121,,,,3121,3121,0,0,0,0.00,0
,20180104,3121,3121,,,,3121,3121,0,0,0,0.00,0
,20180105,3121,3121,,,,3121,3121,0,0,0,0.00,0
,20180108,3121,3121,,,,3121,3121,0,0,0,0.00,0
,20180109,3121,3121,,,,3121,3121,0,0,0,0.00,0
,20180110,3121,3121,,,,3121,3121,0,0,0,0.00,0
,20180111,3121,3121,,,,3121,3121,0,0,0,0.00,0
,20180112,3121,3121,,,,3121,3121,0,0,0,0.00,0
,20180115,3121,3121,,,,3121,3121,0,0,0,0.00,0
,20180116,3121,3121,,,,3121,3121,0,0,0,0.00,0
,20180117,3121,3121,,,,3121,3121,0,0,0,0.00,0
,20180118,3121,3121,,,,3121,3121,0,0,0,0.00,0
,20180119,3121,3121,,,,3121,3121,0,0,0,0.00,0
,20180122,3121,3121,,,,3121,3121,0,0,0,0.00,0
,20180123,3121,3121,,,,3121,3121,0,0,0,0.00,0
,20180124,3121,3121,,,,3121,3121,0,0,0,0.00,0
,20180125,3121,3121,,,,3121,3121,0,0,0,0.00,0
,20180126,3121,3121,,,,3121,3121,0,0,0,0.00,0
,20180129,3121,3121,,,,3121,3121,0,0,0,0.00,0
,20180130,3121,3121,,,,3121,3121,0,0,0,0.00,0
,20180131,3121,3121,,,,3121,3121,0,0,0,0.00,0
,20180201,3121,3121,,,,3121,3121,0,0,0,0.00,0
,20180202,3121,3121,,,,3121,3121,0,0,0,0.00,0
,20180205,3121,3121,,,,3121,3121,0,0,0,0.00,0
,20180206,3121,3121,,,,3121,3121,0,0,0,0.00,0
,20180207,3121,3121,,,,3121,3121,0,0,0,0.00,0
,20180208,3121,3121,,,,3121,3121,0,0,0,0.00,0
,20180209,3121,3121,,,,3121,3121,0,0,0,0.00,0
,20180212,3121,3121,,,,3121,3121,0,0,0,0.00,0
,20180213,3121,3121,,,,3121,3121,0,0,0,0.00,0
,20180214,3121,3121,,,,3121,3121,0,0,0,0.00,0
,20180222,3121,3121,,,,3121,3121,0,0,0,0.00,0
,20180223,3121,3121,,,,3121,3121,0,0,0,0.00,0
,20180226,3121,3121,,,,3121,3121,0,0,0,0.00,0
,20180227,3121,3121,,,,3121,3121,0,0,0,0.00,0
,20180228,3121,3121,,,,3121,3121,0,0,0,0.00,0
,20180301,3121,3121,,,,3121,3121,0,0,0,0.00,0
,20180302,3121,3121,,,,3121,3121,0,0,0,0.00,0
,20180305,3121,3121,,,,3121,3121,0,0,0,0.00,0
,20180306,3121,3121,,,,3121,3121,0,0,0,0.00,0
,20180307,3121,3121,,,,3121,3121,0,0,0,0.00,0
,20180308,3121,3121,,,,3121,3121,0,0,0,0.00,0
,20180309,3121,3121,,,,3121,3121,0,0,0,0.00,0
,20180312,3121,3121,,,,3121,3121,0,0,0,0.00,0
,20180313,3121,3121,,,,3121,3121,0,0,0,0.00,0
,20180314,3121,3121,,,,3121,3121,0,0,0,0.00,0
,20180315,3121,3121,,,,3121,3121,0,0,0,0.00,0
,20180316,3121,3121,,,,3131,3131,10,10,0,0.00,0
,20180319,3131,3131,,,,3131,3131,0,0,0,0.00,0
,20180320,3131,3131,,,,3131,3131,0,0,0,0.00,0
,20180321,3131,3131,,,,2974,2974,-157,-157,0,0.00,0
,20180322,2974,2974,,,,2974,2974,0,0,0,0.00,0
,20180323,2974,2974,,,,2941,2941,-33,-33,0,0.00,0
,20180326,2941,2941,,,,2941,2941,0,0,0,0.00,0
,20180327,2941,2941,,,,2941,2941,0,0,0,0.00,0
,20180328,2941,2941,,,,2941,2941,0,0,0,0.00,0
,20180329,2941,2941,,,,2941,2941,0,0,0,0.00,0
,20180330,2941,2941,,,,2941,2941,0,0,0,0.00,0
,20180402,2941,2941,,,,2941,2941,0,0,0,0.00,0
,20180403,2941,2941,,,,2941,2941,0,0,0,0.00,0
,20180404,2941,2941,,,,2941,2941,0,0,0,0.00,0
,20180409,2941,2941,,,,2941,2941,0,0,0,0.00,0
,20180410,2941,2941,,,,2941,2941,0,0,0,0.00,0
,20180411,2941,2941,,,,2941,2941,0,0,0,0.00,0
,20180412,2941,2941,,,,2941,2941,0,0,0,0.00,0
,20180413,2941,2941,,,,2941,2941,0,0,0,0.00,0
,20180416,2941,2941,,,,2941,2941,0,0,0,0.00,0
,20180417,2941,2941,,,,2941,2941,0,0,0,0.00,0
,20180418,2941,2941,,,,2941,2941,0,0,0,0.00,0
,20180419,2941,2941,,,,2941,2941,0,0,0,0.00,0
,20180420,2941,2941,,,,2941,2941,0,0,0,0.00,0
,20180423,2941,2941,,,,2941,2941,0,0,0,0.00,0
,20180424,2941,2941,,,,2941,2941,0,0,0,0.00,0
,20180425,2941,2941,,,,2941,2941,0,0,0,0.00,0
,20180426,2941,2941,,,,2941,2941,0,0,0,0.00,0
,20180427,2941,2941,,,,2941,2941,0,0,0,0.00,0
,20180502,2941,2941,,,,2941,2941,0,0,0,0.00,0
,20180503,2941,2941,,,,2941,2941,0,0,0,0.00,0
,20180504,2941,2941,,,,2941,2941,0,0,0,0.00,0
,20180507,2941,2941,,,,2941,2941,0,0,0,0.00,0
,20180508,2941,2941,,,,2941,2941,0,0,0,0.00,0
,20180509,2941,2941,,,,2941,2941,0,0,0,0.00,0
,20180510,2941,2941,,,,2941,2941,0,0,0,0.00,0
,20180511,2941,2941,,,,2941,2941,0,0,0,0.00,0
,20180514,2941,2941,,,,2941,2941,0,0,0,0.00,0
,20180515,2941,2941,,,,4012,4012,1071,1071,0,0.00,0
,20180516,4012,4012,,,,4012,4012,0,0,0,0.00,0
,20180517,4012,4012,,,,4012,4012,0,0,0,0.00,0
,20180518,4012,4012,,,,4012,4012,0,0,0,0.00,0
,20180521,4012,4012,,,,4012,4012,0,0,0,0.00,0
,20180522,4012,4012,,,,4012,4012,0,0,0,0.00,0
,20180523,4012,4012,,,,4012,4012,0,0,0,0.00,0
,20180524,4012,4012,,,,4012,4012,0,0,0,0.00,0
,20180525,4012,4012,,,,4012,4012,0,0,0,0.00,0
,20180528,4012,4012,,,,4012,4012,0,0,0,0.00,0
,20180529,4012,4012,,,,4012,4012,0,0,0,0.00,0
,20180530,4012,4012,,,,4012,4012,0,0,0,0.00,0
,20180531,4012,4012,,,,4012,4012,0,0,0,0.00,0
wr1808,20180102,3121,3121,,,,3121,3121,0,0,0,0.00,0
,20180103,3121,3121,,,,3121,3121,0,0,0,0.00,0
,20180104,3121,3121,,,,3121,3121,0,0,0,0.00,0
,20180105,3121,3121,,,,3121,3121,0,0,0,0.00,0
,20180108,3121,3121,,,,3121,3121,0,0,0,0.00,0
,20180109,3121,3121,,,,3121,3121,0,0,0,0.00,0
,20180110,3121,3121,,,,3121,3121,0,0,0,0.00,0
,20180111,3121,3121,,,,3121,3121,0,0,0,0.00,0
,20180112,3121,3121,,,,3121,3121,0,0,0,0.00,0
,20180115,3121,3121,,,,3121,3121,0,0,0,0.00,0
,20180116,3121,3121,,,,3121,3121,0,0,0,0.00,0
,20180117,3121,3121,,,,3121,3121,0,0,0,0.00,0
,20180118,3121,3121,,,,3121,3121,0,0,0,0.00,0
,20180119,3121,3121,,,,3121,3121,0,0,0,0.00,0
,20180122,3121,3121,,,,3121,3121,0,0,0,0.00,0
,20180123,3121,3121,,,,3121,3121,0,0,0,0.00,0
,20180124,3121,3121,,,,3121,3121,0,0,0,0.00,0
,20180125,3121,3121,,,,3121,3121,0,0,0,0.00,0
,20180126,3121,3121,,,,3121,3121,0,0,0,0.00,0
,20180129,3121,3121,,,,3121,3121,0,0,0,0.00,0
,20180130,3121,3121,,,,3121,3121,0,0,0,0.00,0
,20180131,3121,3121,,,,3121,3121,0,0,0,0.00,0
,20180201,3121,3121,,,,3121,3121,0,0,0,0.00,0
,20180202,3121,3121,,,,3121,3121,0,0,0,0.00,0
,20180205,3121,3121,,,,3121,3121,0,0,0,0.00,0
,20180206,3121,3121,,,,3121,3121,0,0,0,0.00,0
,20180207,3121,3121,,,,3121,3121,0,0,0,0.00,0
,20180208,3121,3121,,,,3121,3121,0,0,0,0.00,0
,20180209,3121,3121,,,,3121,3121,0,0,0,0.00,0
,20180212,3121,3121,,,,3121,3121,0,0,0,0.00,0
,20180213,3121,3121,,,,3121,3121,0,0,0,0.00,0
,20180214,3121,3121,,,,3121,3121,0,0,0,0.00,0
,20180222,3121,3121,,,,3121,3121,0,0,0,0.00,0
,20180223,3121,3121,,,,3121,3121,0,0,0,0.00,0
,20180226,3121,3121,,,,3121,3121,0,0,0,0.00,0
,20180227,3121,3121,,,,3121,3121,0,0,0,0.00,0
,20180228,3121,3121,,,,3121,3121,0,0,0,0.00,0
,20180301,3121,3121,,,,3121,3121,0,0,0,0.00,0
,20180302,3121,3121,,,,3121,3121,0,0,0,0.00,0
,20180305,3121,3121,,,,3121,3121,0,0,0,0.00,0
,20180306,3121,3121,,,,3121,3121,0,0,0,0.00,0
,20180307,3121,3121,,,,3121,3121,0,0,0,0.00,0
,20180308,3121,3121,,,,3121,3121,0,0,0,0.00,0
,20180309,3121,3121,,,,3121,3121,0,0,0,0.00,0
,20180312,3121,3121,,,,3121,3121,0,0,0,0.00,0
,20180313,3121,3121,,,,3121,3121,0,0,0,0.00,0
,20180314,3121,3121,,,,3121,3121,0,0,0,0.00,0
,20180315,3121,3121,,,,3121,3121,0,0,0,0.00,0
,20180316,3121,3121,,,,3131,3131,10,10,0,0.00,0
,20180319,3131,3131,,,,3131,3131,0,0,0,0.00,0
,20180320,3131,3131,,,,3131,3131,0,0,0,0.00,0
,20180321,3131,3131,,,,2974,2974,-157,-157,0,0.00,0
,20180322,2974,2974,,,,2974,2974,0,0,0,0.00,0
,20180323,2974,2974,,,,2941,2941,-33,-33,0,0.00,0
,20180326,2941,2941,,,,2941,2941,0,0,0,0.00,0
,20180327,2941,2941,,,,2941,2941,0,0,0,0.00,0
,20180328,2941,2941,,,,2941,2941,0,0,0,0.00,0
,20180329,2941,2941,,,,2941,2941,0,0,0,0.00,0
,20180330,2941,2941,,,,2941,2941,0,0,0,0.00,0
,20180402,2941,2941,,,,2941,2941,0,0,0,0.00,0
,20180403,2941,2941,,,,2941,2941,0,0,0,0.00,0
,20180404,2941,2941,,,,2941,2941,0,0,0,0.00,0
,20180409,2941,2941,,,,2941,2941,0,0,0,0.00,0
,20180410,2941,2941,,,,2941,2941,0,0,0,0.00,0
,20180411,2941,2941,,,,2941,2941,0,0,0,0.00,0
,20180412,2941,2941,,,,2941,2941,0,0,0,0.00,0
,20180413,2941,2941,,,,2941,2941,0,0,0,0.00,0
,20180416,2941,2941,,,,2941,2941,0,0,0,0.00,0
,20180417,2941,2941,,,,2941,2941,0,0,0,0.00,0
,20180418,2941,2941,,,,2941,2941,0,0,0,0.00,0
,20180419,2941,2941,,,,2941,2941,0,0,0,0.00,0
,20180420,2941,2941,,,,2941,2941,0,0,0,0.00,0
,20180423,2941,2941,,,,2941,2941,0,0,0,0.00,0
,20180424,2941,2941,,,,2941,2941,0,0,0,0.00,0
,20180425,2941,2941,,,,2941,2941,0,0,0,0.00,0
,20180426,2941,2941,,,,2941,2941,0,0,0,0.00,0
,20180427,2941,2941,,,,2941,2941,0,0,0,0.00,0
,20180502,2941,2941,,,,2941,2941,0,0,0,0.00,0
,20180503,2941,2941,,,,2941,2941,0,0,0,0.00,0
,20180504,2941,2941,,,,2941,2941,0,0,0,0.00,0
,20180507,2941,2941,,,,2941,2941,0,0,0,0.00,0
,20180508,2941,2941,,,,2941,2941,0,0,0,0.00,0
,20180509,2941,2941,,,,2941,2941,0,0,0,0.00,0
,20180510,2941,2941,,,,2941,2941,0,0,0,0.00,0
,20180511,2941,2941,,,,2941,2941,0,0,0,0.00,0
,20180514,2941,2941,,,,2941,2941,0,0,0,0.00,0
,20180515,2941,2941,,,,3921,3921,980,980,0,0.00,0
,20180516,3921,3921,,,,3921,3921,0,0,0,0.00,0
,20180517,3921,3921,,,,3921,3921,0,0,0,0.00,0
,20180518,3921,3921,,,,3921,3921,0,0,0,0.00,0
,20180521,3921,3921,,,,3921,3921,0,0,0,0.00,0
,20180522,3921,3921,,,,3921,3921,0,0,0,0.00,0
,20180523,3921,3921,,,,3921,3921,0,0,0,0.00,0
,20180524,3921,3921,,,,3921,3921,0,0,0,0.00,0
,20180525,3921,3921,,,,3921,3921,0,0,0,0.00,0
,20180528,3921,3921,,,,3921,3921,0,0,0,0.00,0
,20180529,3921,3921,,,,3921,3921,0,0,0,0.00,0
,20180530,3921,3921,,,,3921,3921,0,0,0,0.00,0
,20180531,3921,3921,,,,3921,3921,0,0,0,0.00,0
wr1809,20180102,3121,3121,,,,3121,3121,0,0,0,0.00,0
,20180103,3121,3121,,,,3121,3121,0,0,0,0.00,0
,20180104,3121,3121,,,,3121,3121,0,0,0,0.00,0
,20180105,3121,3121,,,,3121,3121,0,0,0,0.00,0
,20180108,3121,3121,,,,3121,3121,0,0,0,0.00,0
,20180109,3121,3121,,,,3121,3121,0,0,0,0.00,0
,20180110,3121,3121,,,,3121,3121,0,0,0,0.00,0
,20180111,3121,3121,,,,3121,3121,0,0,0,0.00,0
,20180112,3121,3121,,,,3121,3121,0,0,0,0.00,0
,20180115,3121,3121,,,,3121,3121,0,0,0,0.00,0
,20180116,3121,3121,,,,3121,3121,0,0,0,0.00,0
,20180117,3121,3121,,,,3121,3121,0,0,0,0.00,0
,20180118,3121,3121,,,,3121,3121,0,0,0,0.00,0
,20180119,3121,3121,,,,3121,3121,0,0,0,0.00,0
,20180122,3121,3121,,,,3121,3121,0,0,0,0.00,0
,20180123,3121,3121,,,,3121,3121,0,0,0,0.00,0
,20180124,3121,3121,,,,3121,3121,0,0,0,0.00,0
,20180125,3121,3121,,,,3121,3121,0,0,0,0.00,0
,20180126,3121,3121,,,,3121,3121,0,0,0,0.00,0
,20180129,3121,3121,,,,3121,3121,0,0,0,0.00,0
,20180130,3121,3121,,,,3121,3121,0,0,0,0.00,0
,20180131,3121,3121,,,,3121,3121,0,0,0,0.00,0
,20180201,3121,3121,,,,3121,3121,0,0,0,0.00,0
,20180202,3121,3121,,,,3121,3121,0,0,0,0.00,0
,20180205,3121,3121,,,,3121,3121,0,0,0,0.00,0
,20180206,3121,3121,,,,3121,3121,0,0,0,0.00,0
,20180207,3121,3121,,,,3121,3121,0,0,0,0.00,0
,20180208,3121,3121,,,,3121,3121,0,0,0,0.00,0
,20180209,3121,3121,,,,3121,3121,0,0,0,0.00,0
,20180212,3121,3121,,,,3121,3121,0,0,0,0.00,0
,20180213,3121,3121,,,,3121,3121,0,0,0,0.00,0
,20180214,3121,3121,,,,3121,3121,0,0,0,0.00,0
,20180222,3121,3121,,,,3121,3121,0,0,0,0.00,0
,20180223,3121,3121,,,,3121,3121,0,0,0,0.00,0
,20180226,3121,3121,,,,3121,3121,0,0,0,0.00,0
,20180227,3121,3121,,,,3121,3121,0,0,0,0.00,0
,20180228,3121,3121,,,,3121,3121,0,0,0,0.00,0
,20180301,3121,3121,,,,3121,3121,0,0,0,0.00,0
,20180302,3121,3121,,,,3121,3121,0,0,0,0.00,0
,20180305,3121,3121,,,,3121,3121,0,0,0,0.00,0
,20180306,3121,3121,,,,3121,3121,0,0,0,0.00,0
,20180307,3121,3121,,,,3121,3121,0,0,0,0.00,0
,20180308,3121,3121,,,,3121,3121,0,0,0,0.00,0
,20180309,3121,3121,,,,3121,3121,0,0,0,0.00,0
,20180312,3121,3121,,,,3121,3121,0,0,0,0.00,0
,20180313,3121,3121,,,,3121,3121,0,0,0,0.00,0
,20180314,3121,3121,,,,3121,3121,0,0,0,0.00,0
,20180315,3121,3121,,,,3121,3121,0,0,0,0.00,0
,20180316,3121,3121,,,,3131,3131,10,10,0,0.00,0
,20180319,3131,3131,,,,3131,3131,0,0,0,0.00,0
,20180320,3131,3131,,,,3131,3131,0,0,0,0.00,0
,20180321,3131,3131,,,,2974,2974,-157,-157,0,0.00,0
,20180322,2974,2974,,,,2974,2974,0,0,0,0.00,0
,20180323,2974,2974,,,,2941,2941,-33,-33,0,0.00,0
,20180326,2941,2941,,,,2941,2941,0,0,0,0.00,0
,20180327,2941,2941,,,,2941,2941,0,0,0,0.00,0
,20180328,2941,2941,,,,2941,2941,0,0,0,0.00,0
,20180329,2941,2941,,,,2941,2941,0,0,0,0.00,0
,20180330,2941,2941,,,,2941,2941,0,0,0,0.00,0
,20180402,2941,2941,,,,2941,2941,0,0,0,0.00,0
,20180403,2941,2941,,,,2941,2941,0,0,0,0.00,0
,20180404,2941,2941,,,,2941,2941,0,0,0,0.00,0
,20180409,2941,2941,,,,2941,2941,0,0,0,0.00,0
,20180410,2941,2941,,,,2941,2941,0,0,0,0.00,0
,20180411,2941,2941,,,,2941,2941,0,0,0,0.00,0
,20180412,2941,2941,,,,2941,2941,0,0,0,0.00,0
,20180413,2941,2941,,,,2941,2941,0,0,0,0.00,0
,20180416,2941,2941,,,,2941,2941,0,0,0,0.00,0
,20180417,2941,2941,,,,2941,2941,0,0,0,0.00,0
,20180418,2941,2941,,,,2941,2941,0,0,0,0.00,0
,20180419,2941,2941,,,,2941,2941,0,0,0,0.00,0
,20180420,2941,2941,,,,2941,2941,0,0,0,0.00,0
,20180423,2941,2941,,,,2941,2941,0,0,0,0.00,0
,20180424,2941,2941,,,,2941,2941,0,0,0,0.00,0
,20180425,2941,2941,,,,2941,2941,0,0,0,0.00,0
,20180426,2941,2941,,,,2941,2941,0,0,0,0.00,0
,20180427,2941,2941,,,,2941,2941,0,0,0,0.00,0
,20180502,2941,2941,,,,2941,2941,0,0,0,0.00,0
,20180503,2941,2941,,,,2941,2941,0,0,0,0.00,0
,20180504,2941,2941,,,,2941,2941,0,0,0,0.00,0
,20180507,2941,2941,,,,2941,2941,0,0,0,0.00,0
,20180508,2941,2941,,,,2941,2941,0,0,0,0.00,0
,20180509,2941,2941,,,,2941,2941,0,0,0,0.00,0
,20180510,2941,2941,,,,2941,2941,0,0,0,0.00,0
,20180511,2941,2941,,,,2941,2941,0,0,0,0.00,0
,20180514,2941,2941,,,,2941,2941,0,0,0,0.00,0
,20180515,2941,2941,,,,3858,3858,917,917,0,0.00,0
,20180516,3858,3858,,,,3858,3858,0,0,0,0.00,0
,20180517,3858,3858,,,,3858,3858,0,0,0,0.00,0
,20180518,3858,3858,,,,3858,3858,0,0,0,0.00,0
,20180521,3858,3858,,,,3858,3858,0,0,0,0.00,0
,20180522,3858,3858,,,,3858,3858,0,0,0,0.00,0
,20180523,3858,3858,,,,3858,3858,0,0,0,0.00,0
,20180524,3858,3858,,,,3858,3858,0,0,0,0.00,0
,20180525,3858,3858,,,,3858,3858,0,0,0,0.00,0
,20180528,3858,3858,,,,3858,3858,0,0,0,0.00,0
,20180529,3858,3858,,,,3858,3858,0,0,0,0.00,0
,20180530,3858,3858,,,,3858,3858,0,0,0,0.00,0
,20180531,3858,3858,,,,3858,3858,0,0,0,0.00,0
wr1810,20180102,3121,3121,,,,3121,3121,0,0,0,0.00,0
,20180103,3121,3121,,,,3121,3121,0,0,0,0.00,0
,20180104,3121,3121,,,,3121,3121,0,0,0,0.00,0
,20180105,3121,3121,,,,3121,3121,0,0,0,0.00,0
,20180108,3121,3121,,,,3121,3121,0,0,0,0.00,0
,20180109,3121,3121,,,,3121,3121,0,0,0,0.00,0
,20180110,3121,3121,,,,3121,3121,0,0,0,0.00,0
,20180111,3121,3121,,,,3121,3121,0,0,0,0.00,0
,20180112,3121,3121,,,,3121,3121,0,0,0,0.00,0
,20180115,3121,3121,,,,3121,3121,0,0,0,0.00,0
,20180116,3121,3121,,,,3121,3121,0,0,0,0.00,0
,20180117,3121,3121,,,,3121,3121,0,0,0,0.00,0
,20180118,3121,3121,,,,3121,3121,0,0,0,0.00,0
,20180119,3121,3121,,,,3121,3121,0,0,0,0.00,0
,20180122,3121,3121,,,,3121,3121,0,0,0,0.00,0
,20180123,3121,3121,,,,3121,3121,0,0,0,0.00,0
,20180124,3121,3121,,,,3121,3121,0,0,0,0.00,0
,20180125,3121,3121,,,,3121,3121,0,0,0,0.00,0
,20180126,3121,3121,,,,3121,3121,0,0,0,0.00,0
,20180129,3121,3121,,,,3121,3121,0,0,0,0.00,0
,20180130,3121,3121,,,,3121,3121,0,0,0,0.00,0
,20180131,3121,3121,,,,3121,3121,0,0,0,0.00,0
,20180201,3121,3121,,,,3121,3121,0,0,0,0.00,0
,20180202,3121,3121,,,,3121,3121,0,0,0,0.00,0
,20180205,3121,3121,,,,3121,3121,0,0,0,0.00,0
,20180206,3121,3121,,,,3121,3121,0,0,0,0.00,0
,20180207,3121,3121,,,,3121,3121,0,0,0,0.00,0
,20180208,3121,3121,,,,3121,3121,0,0,0,0.00,0
,20180209,3121,3121,,,,3121,3121,0,0,0,0.00,0
,20180212,3121,3121,,,,3121,3121,0,0,0,0.00,0
,20180213,3121,3121,,,,3121,3121,0,0,0,0.00,0
,20180214,3121,3121,,,,3121,3121,0,0,0,0.00,0
,20180222,3121,3121,,,,3121,3121,0,0,0,0.00,0
,20180223,3121,3121,,,,3121,3121,0,0,0,0.00,0
,20180226,3121,3121,,,,3121,3121,0,0,0,0.00,0
,20180227,3121,3121,,,,3121,3121,0,0,0,0.00,0
,20180228,3121,3121,,,,3121,3121,0,0,0,0.00,0
,20180301,3121,3121,,,,3121,3121,0,0,0,0.00,0
,20180302,3121,3121,,,,3121,3121,0,0,0,0.00,0
,20180305,3121,3121,,,,3121,3121,0,0,0,0.00,0
,20180306,3121,3121,,,,3121,3121,0,0,0,0.00,0
,20180307,3121,3121,,,,3121,3121,0,0,0,0.00,0
,20180308,3121,3121,,,,3121,3121,0,0,0,0.00,0
,20180309,3121,3121,,,,3121,3121,0,0,0,0.00,0
,20180312,3121,3121,,,,3121,3121,0,0,0,0.00,0
,20180313,3121,3121,,,,3121,3121,0,0,0,0.00,0
,20180314,3121,3121,,,,3121,3121,0,0,0,0.00,0
,20180315,3121,3121,,,,3121,3121,0,0,0,0.00,0
,20180316,3121,3121,,,,3131,3131,10,10,0,0.00,0
,20180319,3131,3131,,,,3131,3131,0,0,0,0.00,0
,20180320,3131,3131,,,,3131,3131,0,0,0,0.00,0
,20180321,3131,3131,,,,2974,2974,-157,-157,0,0.00,0
,20180322,2974,2974,,,,2974,2974,0,0,0,0.00,0
,20180323,2974,2974,,,,2941,2941,-33,-33,0,0.00,0
,20180326,2941,2941,,,,2941,2941,0,0,0,0.00,0
,20180327,2941,2941,,,,2941,2941,0,0,0,0.00,0
,20180328,2941,2941,,,,2941,2941,0,0,0,0.00,0
,20180329,2941,2941,,,,2941,2941,0,0,0,0.00,0
,20180330,2941,2941,,,,2941,2941,0,0,0,0.00,0
,20180402,2941,2941,,,,2941,2941,0,0,0,0.00,0
,20180403,2941,2941,,,,2941,2941,0,0,0,0.00,0
,20180404,2941,2941,,,,2941,2941,0,0,0,0.00,0
,20180409,2941,2941,,,,2941,2941,0,0,0,0.00,0
,20180410,2941,2941,,,,2941,2941,0,0,0,0.00,0
,20180411,2941,2941,,,,2941,2941,0,0,0,0.00,0
,20180412,2941,2941,,,,2941,2941,0,0,0,0.00,0
,20180413,2941,2941,,,,2941,2941,0,0,0,0.00,0
,20180416,2941,2941,,,,2941,2941,0,0,0,0.00,0
,20180417,2941,2941,,,,2941,2941,0,0,0,0.00,0
,20180418,2941,2941,,,,2941,2941,0,0,0,0.00,0
,20180419,2941,2941,,,,2941,2941,0,0,0,0.00,0
,20180420,2941,2941,,,,2941,2941,0,0,0,0.00,0
,20180423,2941,2941,,,,2941,2941,0,0,0,0.00,0
,20180424,2941,2941,,,,2941,2941,0,0,0,0.00,0
,20180425,2941,2941,,,,2941,2941,0,0,0,0.00,0
,20180426,2941,2941,,,,2941,2941,0,0,0,0.00,0
,20180427,2941,2941,,,,2941,2941,0,0,0,0.00,0
,20180502,2941,2941,,,,2941,2941,0,0,0,0.00,0
,20180503,2941,2941,,,,2941,2941,0,0,0,0.00,0
,20180504,2941,2941,,,,2941,2941,0,0,0,0.00,0
,20180507,2941,2941,,,,2941,2941,0,0,0,0.00,0
,20180508,2941,2941,,,,2941,2941,0,0,0,0.00,0
,20180509,2941,2941,,,,2941,2941,0,0,0,0.00,0
,20180510,2941,2941,,,,2941,2941,0,0,0,0.00,0
,20180511,2941,2941,,,,2941,2941,0,0,0,0.00,0
,20180514,2941,2941,,,,2941,2941,0,0,0,0.00,0
,20180515,2941,2941,,,,3771,3771,830,830,0,0.00,0
,20180516,3771,3771,,,,3771,3771,0,0,0,0.00,0
,20180517,3771,3771,,,,3771,3771,0,0,0,0.00,0
,20180518,3771,3771,,,,3771,3771,0,0,0,0.00,0
,20180521,3771,3771,,,,3771,3771,0,0,0,0.00,0
,20180522,3771,3771,,,,3771,3771,0,0,0,0.00,0
,20180523,3771,3771,,,,3771,3771,0,0,0,0.00,0
,20180524,3771,3771,,,,3771,3771,0,0,0,0.00,0
,20180525,3771,3771,,,,3771,3771,0,0,0,0.00,0
,20180528,3771,3771,,,,3771,3771,0,0,0,0.00,0
,20180529,3771,3771,,,,3771,3771,0,0,0,0.00,0
,20180530,3771,3771,,,,3771,3771,0,0,0,0.00,0
,20180531,3771,3771,,,,3771,3771,0,0,0,0.00,0
wr1811,20180102,3121,3121,,,,3121,3121,0,0,0,0.00,0
,20180103,3121,3121,,,,3121,3121,0,0,0,0.00,0
,20180104,3121,3121,,,,3121,3121,0,0,0,0.00,0
,20180105,3121,3121,,,,3121,3121,0,0,0,0.00,0
,20180108,3121,3121,,,,3121,3121,0,0,0,0.00,0
,20180109,3121,3121,,,,3121,3121,0,0,0,0.00,0
,20180110,3121,3121,,,,3121,3121,0,0,0,0.00,0
,20180111,3121,3121,,,,3121,3121,0,0,0,0.00,0
,20180112,3121,3121,,,,3121,3121,0,0,0,0.00,0
,20180115,3121,3121,,,,3121,3121,0,0,0,0.00,0
,20180116,3121,3121,,,,3121,3121,0,0,0,0.00,0
,20180117,3121,3121,,,,3121,3121,0,0,0,0.00,0
,20180118,3121,3121,,,,3121,3121,0,0,0,0.00,0
,20180119,3121,3121,,,,3121,3121,0,0,0,0.00,0
,20180122,3121,3121,,,,3121,3121,0,0,0,0.00,0
,20180123,3121,3121,,,,3121,3121,0,0,0,0.00,0
,20180124,3121,3121,,,,3121,3121,0,0,0,0.00,0
,20180125,3121,3121,,,,3121,3121,0,0,0,0.00,0
,20180126,3121,3121,,,,3121,3121,0,0,0,0.00,0
,20180129,3121,3121,,,,3121,3121,0,0,0,0.00,0
,20180130,3121,3121,,,,3121,3121,0,0,0,0.00,0
,20180131,3121,3121,,,,3121,3121,0,0,0,0.00,0
,20180201,3121,3121,,,,3121,3121,0,0,0,0.00,0
,20180202,3121,3121,,,,3121,3121,0,0,0,0.00,0
,20180205,3121,3121,,,,3121,3121,0,0,0,0.00,0
,20180206,3121,3121,,,,3121,3121,0,0,0,0.00,0
,20180207,3121,3121,,,,3121,3121,0,0,0,0.00,0
,20180208,3121,3121,,,,3121,3121,0,0,0,0.00,0
,20180209,3121,3121,,,,3121,3121,0,0,0,0.00,0
,20180212,3121,3121,,,,3121,3121,0,0,0,0.00,0
,20180213,3121,3121,,,,3121,3121,0,0,0,0.00,0
,20180214,3121,3121,,,,3121,3121,0,0,0,0.00,0
,20180222,3121,3121,,,,3121,3121,0,0,0,0.00,0
,20180223,3121,3121,,,,3121,3121,0,0,0,0.00,0
,20180226,3121,3121,,,,3121,3121,0,0,0,0.00,0
,20180227,3121,3121,,,,3121,3121,0,0,0,0.00,0
,20180228,3121,3121,,,,3121,3121,0,0,0,0.00,0
,20180301,3121,3121,,,,3121,3121,0,0,0,0.00,0
,20180302,3121,3121,,,,3121,3121,0,0,0,0.00,0
,20180305,3121,3121,,,,3121,3121,0,0,0,0.00,0
,20180306,3121,3121,,,,3121,3121,0,0,0,0.00,0
,20180307,3121,3121,,,,3121,3121,0,0,0,0.00,0
,20180308,3121,3121,,,,3121,3121,0,0,0,0.00,0
,20180309,3121,3121,,,,3121,3121,0,0,0,0.00,0
,20180312,3121,3121,,,,3121,3121,0,0,0,0.00,0
,20180313,3121,3121,,,,3121,3121,0,0,0,0.00,0
,20180314,3121,3121,,,,3121,3121,0,0,0,0.00,0
,20180315,3121,3121,,,,3121,3121,0,0,0,0.00,0
,20180316,3121,3121,,,,3131,3131,10,10,0,0.00,0
,20180319,3131,3131,,,,3131,3131,0,0,0,0.00,0
,20180320,3131,3131,,,,3131,3131,0,0,0,0.00,0
,20180321,3131,3131,,,,2974,2974,-157,-157,0,0.00,0
,20180322,2974,2974,,,,2974,2974,0,0,0,0.00,0
,20180323,2974,2974,,,,2941,2941,-33,-33,0,0.00,0
,20180326,2941,2941,,,,2941,2941,0,0,0,0.00,0
,20180327,2941,2941,,,,2941,2941,0,0,0,0.00,0
,20180328,2941,2941,,,,2941,2941,0,0,0,0.00,0
,20180329,2941,2941,,,,2941,2941,0,0,0,0.00,0
,20180330,2941,2941,,,,2941,2941,0,0,0,0.00,0
,20180402,2941,2941,,,,2941,2941,0,0,0,0.00,0
,20180403,2941,2941,,,,2941,2941,0,0,0,0.00,0
,20180404,2941,2941,,,,2941,2941,0,0,0,0.00,0
,20180409,2941,2941,,,,2941,2941,0,0,0,0.00,0
,20180410,2941,2941,,,,2941,2941,0,0,0,0.00,0
,20180411,2941,2941,,,,2941,2941,0,0,0,0.00,0
,20180412,2941,2941,,,,2941,2941,0,0,0,0.00,0
,20180413,2941,2941,,,,2941,2941,0,0,0,0.00,0
,20180416,2941,2941,,,,2941,2941,0,0,0,0.00,0
,20180417,2941,2941,,,,2941,2941,0,0,0,0.00,0
,20180418,2941,2941,,,,2941,2941,0,0,0,0.00,0
,20180419,2941,2941,,,,2941,2941,0,0,0,0.00,0
,20180420,2941,2941,,,,2941,2941,0,0,0,0.00,0
,20180423,2941,2941,,,,2941,2941,0,0,0,0.00,0
,20180424,2941,2941,,,,2941,2941,0,0,0,0.00,0
,20180425,2941,2941,,,,2941,2941,0,0,0,0.00,0
,20180426,2941,2941,,,,2941,2941,0,0,0,0.00,0
,20180427,2941,2941,,,,2941,2941,0,0,0,0.00,0
,20180502,2941,2941,,,,2941,2941,0,0,0,0.00,0
,20180503,2941,2941,,,,2941,2941,0,0,0,0.00,0
,20180504,2941,2941,,,,2941,2941,0,0,0,0.00,0
,20180507,2941,2941,,,,2941,2941,0,0,0,0.00,0
,20180508,2941,2941,,,,2941,2941,0,0,0,0.00,0
,20180509,2941,2941,,,,2941,2941,0,0,0,0.00,0
,20180510,2941,2941,,,,2941,2941,0,0,0,0.00,0
,20180511,2941,2941,,,,2941,2941,0,0,0,0.00,0
,20180514,2941,2941,,,,2941,2941,0,0,0,0.00,0
,20180515,2941,2941,,,,3735,3735,794,794,0,0.00,0
,20180516,3735,3735,,,,3735,3735,0,0,0,0.00,0
,20180517,3735,3735,,,,3735,3735,0,0,0,0.00,0
,20180518,3735,3735,,,,3735,3735,0,0,0,0.00,0
,20180521,3735,3735,,,,3735,3735,0,0,0,0.00,0
,20180522,3735,3735,,,,3735,3735,0,0,0,0.00,0
,20180523,3735,3735,,,,3735,3735,0,0,0,0.00,0
,20180524,3735,3735,,,,3735,3735,0,0,0,0.00,0
,20180525,3735,3735,,,,3735,3735,0,0,0,0.00,0
,20180528,3735,3735,,,,3735,3735,0,0,0,0.00,0
,20180529,3735,3735,,,,3735,3735,0,0,0,0.00,0
,20180530,3735,3735,,,,3735,3735,0,0,0,0.00,0
,20180531,3735,3735,,,,3735,3735,0,0,0,0.00,0
wr1812,20180102,3121,3121,,,,3121,3121,0,0,0,0.00,0
,20180103,3121,3121,,,,3121,3121,0,0,0,0.00,0
,20180104,3121,3121,,,,3121,3121,0,0,0,0.00,0
,20180105,3121,3121,,,,3121,3121,0,0,0,0.00,0
,20180108,3121,3121,,,,3121,3121,0,0,0,0.00,0
,20180109,3121,3121,,,,3121,3121,0,0,0,0.00,0
,20180110,3121,3121,,,,3121,3121,0,0,0,0.00,0
,20180111,3121,3121,,,,3121,3121,0,0,0,0.00,0
,20180112,3121,3121,,,,3121,3121,0,0,0,0.00,0
,20180115,3121,3121,,,,3121,3121,0,0,0,0.00,0
,20180116,3121,3121,,,,3121,3121,0,0,0,0.00,0
,20180117,3121,3121,,,,3121,3121,0,0,0,0.00,0
,20180118,3121,3121,,,,3121,3121,0,0,0,0.00,0
,20180119,3121,3121,,,,3121,3121,0,0,0,0.00,0
,20180122,3121,3121,,,,3121,3121,0,0,0,0.00,0
,20180123,3121,3121,,,,3121,3121,0,0,0,0.00,0
,20180124,3121,3121,,,,3121,3121,0,0,0,0.00,0
,20180125,3121,3121,,,,3121,3121,0,0,0,0.00,0
,20180126,3121,3121,,,,3121,3121,0,0,0,0.00,0
,20180129,3121,3121,,,,3121,3121,0,0,0,0.00,0
,20180130,3121,3121,,,,3121,3121,0,0,0,0.00,0
,20180131,3121,3121,,,,3121,3121,0,0,0,0.00,0
,20180201,3121,3121,,,,3121,3121,0,0,0,0.00,0
,20180202,3121,3121,,,,3121,3121,0,0,0,0.00,0
,20180205,3121,3121,,,,3121,3121,0,0,0,0.00,0
,20180206,3121,3121,,,,3121,3121,0,0,0,0.00,0
,20180207,3121,3121,,,,3121,3121,0,0,0,0.00,0
,20180208,3121,3121,,,,3121,3121,0,0,0,0.00,0
,20180209,3121,3121,,,,3121,3121,0,0,0,0.00,0
,20180212,3121,3121,,,,3121,3121,0,0,0,0.00,0
,20180213,3121,3121,,,,3121,3121,0,0,0,0.00,0
,20180214,3121,3121,,,,3121,3121,0,0,0,0.00,0
,20180222,3121,3121,,,,3121,3121,0,0,0,0.00,0
,20180223,3121,3121,,,,3121,3121,0,0,0,0.00,0
,20180226,3121,3121,,,,3121,3121,0,0,0,0.00,0
,20180227,3121,3121,,,,3121,3121,0,0,0,0.00,0
,20180228,3121,3121,,,,3121,3121,0,0,0,0.00,0
,20180301,3121,3121,,,,3121,3121,0,0,0,0.00,0
,20180302,3121,3121,,,,3121,3121,0,0,0,0.00,0
,20180305,3121,3121,,,,3121,3121,0,0,0,0.00,0
,20180306,3121,3121,,,,3121,3121,0,0,0,0.00,0
,20180307,3121,3121,,,,3121,3121,0,0,0,0.00,0
,20180308,3121,3121,,,,3121,3121,0,0,0,0.00,0
,20180309,3121,3121,,,,3121,3121,0,0,0,0.00,0
,20180312,3121,3121,,,,3121,3121,0,0,0,0.00,0
,20180313,3121,3121,,,,3121,3121,0,0,0,0.00,0
,20180314,3121,3121,,,,3121,3121,0,0,0,0.00,0
,20180315,3121,3121,,,,3121,3121,0,0,0,0.00,0
,20180316,3121,3121,,,,3131,3131,10,10,0,0.00,0
,20180319,3131,3131,,,,3131,3131,0,0,0,0.00,0
,20180320,3131,3131,,,,3131,3131,0,0,0,0.00,0
,20180321,3131,3131,,,,2974,2974,-157,-157,0,0.00,0
,20180322,2974,2974,,,,2974,2974,0,0,0,0.00,0
,20180323,2974,2974,,,,2941,2941,-33,-33,0,0.00,0
,20180326,2941,2941,,,,2941,2941,0,0,0,0.00,0
,20180327,2941,2941,,,,2941,2941,0,0,0,0.00,0
,20180328,2941,2941,,,,2941,2941,0,0,0,0.00,0
,20180329,2941,2941,,,,2941,2941,0,0,0,0.00,0
,20180330,2941,2941,,,,2941,2941,0,0,0,0.00,0
,20180402,2941,2941,,,,2941,2941,0,0,0,0.00,0
,20180403,2941,2941,,,,2941,2941,0,0,0,0.00,0
,20180404,2941,2941,,,,2941,2941,0,0,0,0.00,0
,20180409,2941,2941,,,,2941,2941,0,0,0,0.00,0
,20180410,2941,2941,,,,2941,2941,0,0,0,0.00,0
,20180411,2941,2941,,,,2941,2941,0,0,0,0.00,0
,20180412,2941,2941,,,,2941,2941,0,0,0,0.00,0
,20180413,2941,2941,,,,2941,2941,0,0,0,0.00,0
,20180416,2941,2941,,,,2941,2941,0,0,0,0.00,0
,20180417,2941,2941,,,,2941,2941,0,0,0,0.00,0
,20180418,2941,2941,,,,2941,2941,0,0,0,0.00,0
,20180419,2941,2941,,,,2941,2941,0,0,0,0.00,0
,20180420,2941,2941,2941,3234,2941,3234,3170,293,229,112,355.09,0
,20180423,3234,3170,,,,3170,3170,0,0,0,0.00,0
,20180424,3170,3170,,,,3170,3170,0,0,0,0.00,0
,20180425,3170,3170,,,,3170,3170,0,0,0,0.00,0
,20180426,3170,3170,,,,3170,3170,0,0,0,0.00,0
,20180427,3170,3170,,,,3170,3170,0,0,0,0.00,0
,20180502,3170,3170,,,,3170,3170,0,0,0,0.00,0
,20180503,3170,3170,,,,3170,3170,0,0,0,0.00,0
,20180504,3170,3170,,,,3170,3170,0,0,0,0.00,0
,20180507,3170,3170,,,,3170,3170,0,0,0,0.00,0
,20180508,3170,3170,,,,3170,3170,0,0,0,0.00,0
,20180509,3170,3170,,,,3170,3170,0,0,0,0.00,0
,20180510,3170,3170,3328,3328,3327,3327,3327,157,157,4,13.31,0
,20180511,3327,3327,,,,3327,3327,0,0,0,0.00,0
,20180514,3327,3327,,,,3327,3327,0,0,0,0.00,0
,20180515,3327,3327,,,,3694,3694,367,367,0,0.00,0
,20180516,3694,3694,,,,3694,3694,0,0,0,0.00,0
,20180517,3694,3694,,,,3694,3694,0,0,0,0.00,0
,20180518,3694,3694,,,,3694,3694,0,0,0,0.00,0
,20180521,3694,3694,,,,3694,3694,0,0,0,0.00,0
,20180522,3694,3694,,,,3694,3694,0,0,0,0.00,0
,20180523,3694,3694,,,,3694,3694,0,0,0,0.00,0
,20180524,3694,3694,,,,3694,3694,0,0,0,0.00,0
,20180525,3694,3694,,,,3694,3694,0,0,0,0.00,0
,20180528,3694,3694,,,,3694,3694,0,0,0,0.00,0
,20180529,3694,3694,,,,3694,3694,0,0,0,0.00,0
,20180530,3694,3694,,,,3694,3694,0,0,0,0.00,0
,20180531,3694,3694,,,,3694,3694,0,0,0,0.00,0
wr1901,20180116,3121,3121,,,,3121,3121,0,0,0,0.00,0
,20180117,3121,3121,,,,3121,3121,0,0,0,0.00,0
,20180118,3121,3121,,,,3121,3121,0,0,0,0.00,0
,20180119,3121,3121,,,,3121,3121,0,0,0,0.00,0
,20180122,3121,3121,,,,3121,3121,0,0,0,0.00,0
,20180123,3121,3121,,,,3121,3121,0,0,0,0.00,0
,20180124,3121,3121,,,,3121,3121,0,0,0,0.00,0
,20180125,3121,3121,,,,3121,3121,0,0,0,0.00,0
,20180126,3121,3121,,,,3121,3121,0,0,0,0.00,0
,20180129,3121,3121,,,,3121,3121,0,0,0,0.00,0
,20180130,3121,3121,,,,3121,3121,0,0,0,0.00,0
,20180131,3121,3121,,,,3121,3121,0,0,0,0.00,0
,20180201,3121,3121,,,,3121,3121,0,0,0,0.00,0
,20180202,3121,3121,,,,3121,3121,0,0,0,0.00,0
,20180205,3121,3121,,,,3121,3121,0,0,0,0.00,0
,20180206,3121,3121,,,,3121,3121,0,0,0,0.00,0
,20180207,3121,3121,,,,3121,3121,0,0,0,0.00,0
,20180208,3121,3121,,,,3121,3121,0,0,0,0.00,0
,20180209,3121,3121,,,,3121,3121,0,0,0,0.00,0
,20180212,3121,3121,,,,3121,3121,0,0,0,0.00,0
,20180213,3121,3121,,,,3121,3121,0,0,0,0.00,0
,20180214,3121,3121,,,,3121,3121,0,0,0,0.00,0
,20180222,3121,3121,,,,3121,3121,0,0,0,0.00,0
,20180223,3121,3121,,,,3121,3121,0,0,0,0.00,0
,20180226,3121,3121,,,,3121,3121,0,0,0,0.00,0
,20180227,3121,3121,,,,3121,3121,0,0,0,0.00,0
,20180228,3121,3121,,,,3121,3121,0,0,0,0.00,0
,20180301,3121,3121,,,,3121,3121,0,0,0,0.00,0
,20180302,3121,3121,,,,3121,3121,0,0,0,0.00,0
,20180305,3121,3121,,,,3121,3121,0,0,0,0.00,0
,20180306,3121,3121,,,,3121,3121,0,0,0,0.00,0
,20180307,3121,3121,,,,3121,3121,0,0,0,0.00,0
,20180308,3121,3121,,,,3121,3121,0,0,0,0.00,0
,20180309,3121,3121,,,,3121,3121,0,0,0,0.00,0
,20180312,3121,3121,,,,3121,3121,0,0,0,0.00,0
,20180313,3121,3121,,,,3121,3121,0,0,0,0.00,0
,20180314,3121,3121,,,,3121,3121,0,0,0,0.00,0
,20180315,3121,3121,,,,3121,3121,0,0,0,0.00,0
,20180316,3121,3121,,,,3131,3131,10,10,0,0.00,0
,20180319,3131,3131,,,,3131,3131,0,0,0,0.00,0
,20180320,3131,3131,,,,3131,3131,0,0,0,0.00,0
,20180321,3131,3131,,,,2974,2974,-157,-157,0,0.00,0
,20180322,2974,2974,,,,2974,2974,0,0,0,0.00,0
,20180323,2974,2974,,,,2941,2941,-33,-33,0,0.00,0
,20180326,2941,2941,,,,2941,2941,0,0,0,0.00,0
,20180327,2941,2941,,,,2941,2941,0,0,0,0.00,0
,20180328,2941,2941,,,,2941,2941,0,0,0,0.00,0
,20180329,2941,2941,,,,2941,2941,0,0,0,0.00,0
,20180330,2941,2941,,,,2941,2941,0,0,0,0.00,0
,20180402,2941,2941,,,,2941,2941,0,0,0,0.00,0
,20180403,2941,2941,,,,2941,2941,0,0,0,0.00,0
,20180404,2941,2941,,,,2941,2941,0,0,0,0.00,0
,20180409,2941,2941,,,,2941,2941,0,0,0,0.00,0
,20180410,2941,2941,,,,2941,2941,0,0,0,0.00,0
,20180411,2941,2941,,,,2941,2941,0,0,0,0.00,0
,20180412,2941,2941,,,,2941,2941,0,0,0,0.00,0
,20180413,2941,2941,,,,2941,2941,0,0,0,0.00,0
,20180416,2941,2941,,,,2941,2941,0,0,0,0.00,0
,20180417,2941,2941,,,,2941,2941,0,0,0,0.00,0
,20180418,2941,2941,,,,2941,2941,0,0,0,0.00,0
,20180419,2941,2941,,,,2941,2941,0,0,0,0.00,0
,20180420,2941,2941,,,,3170,3170,229,229,0,0.00,0
,20180423,3170,3170,,,,3170,3170,0,0,0,0.00,0
,20180424,3170,3170,,,,3170,3170,0,0,0,0.00,0
,20180425,3170,3170,,,,3170,3170,0,0,0,0.00,0
,20180426,3170,3170,,,,3170,3170,0,0,0,0.00,0
,20180427,3170,3170,,,,3170,3170,0,0,0,0.00,0
,20180502,3170,3170,,,,3170,3170,0,0,0,0.00,0
,20180503,3170,3170,,,,3170,3170,0,0,0,0.00,0
,20180504,3170,3170,,,,3170,3170,0,0,0,0.00,0
,20180507,3170,3170,,,,3170,3170,0,0,0,0.00,0
,20180508,3170,3170,,,,3170,3170,0,0,0,0.00,0
,20180509,3170,3170,,,,3170,3170,0,0,0,0.00,0
,20180510,3170,3170,,,,3327,3327,157,157,0,0.00,0
,20180511,3327,3327,,,,3327,3327,0,0,0,0.00,0
,20180514,3327,3327,,,,3327,3327,0,0,0,0.00,0
,20180515,3327,3327,,,,3610,3610,283,283,0,0.00,0
,20180516,3610,3610,,,,3610,3610,0,0,0,0.00,0
,20180517,3610,3610,,,,3610,3610,0,0,0,0.00,0
,20180518,3610,3610,,,,3610,3610,0,0,0,0.00,0
,20180521,3610,3610,,,,3610,3610,0,0,0,0.00,0
,20180522,3610,3610,,,,3610,3610,0,0,0,0.00,0
,20180523,3610,3610,,,,3610,3610,0,0,0,0.00,0
,20180524,3610,3610,,,,3610,3610,0,0,0,0.00,0
,20180525,3610,3610,,,,3610,3610,0,0,0,0.00,0
,20180528,3610,3610,,,,3610,3610,0,0,0,0.00,0
,20180529,3610,3610,,,,3610,3610,0,0,0,0.00,0
,20180530,3610,3610,,,,3610,3610,0,0,0,0.00,0
,20180531,3610,3610,,,,3610,3610,0,0,0,0.00,0
wr1902,20180212,3121,3121,,,,3121,3121,0,0,0,0.00,0
,20180213,3121,3121,,,,3121,3121,0,0,0,0.00,0
,20180214,3121,3121,,,,3121,3121,0,0,0,0.00,0
,20180222,3121,3121,,,,3121,3121,0,0,0,0.00,0
,20180223,3121,3121,,,,3121,3121,0,0,0,0.00,0
,20180226,3121,3121,,,,3121,3121,0,0,0,0.00,0
,20180227,3121,3121,,,,3121,3121,0,0,0,0.00,0
,20180228,3121,3121,,,,3121,3121,0,0,0,0.00,0
,20180301,3121,3121,,,,3121,3121,0,0,0,0.00,0
,20180302,3121,3121,,,,3121,3121,0,0,0,0.00,0
,20180305,3121,3121,,,,3121,3121,0,0,0,0.00,0
,20180306,3121,3121,,,,3121,3121,0,0,0,0.00,0
,20180307,3121,3121,,,,3121,3121,0,0,0,0.00,0
,20180308,3121,3121,,,,3121,3121,0,0,0,0.00,0
,20180309,3121,3121,,,,3121,3121,0,0,0,0.00,0
,20180312,3121,3121,,,,3121,3121,0,0,0,0.00,0
,20180313,3121,3121,,,,3121,3121,0,0,0,0.00,0
,20180314,3121,3121,,,,3121,3121,0,0,0,0.00,0
,20180315,3121,3121,,,,3121,3121,0,0,0,0.00,0
,20180316,3121,3121,,,,3131,3131,10,10,0,0.00,0
,20180319,3131,3131,,,,3131,3131,0,0,0,0.00,0
,20180320,3131,3131,,,,3131,3131,0,0,0,0.00,0
,20180321,3131,3131,,,,2974,2974,-157,-157,0,0.00,0
,20180322,2974,2974,,,,2974,2974,0,0,0,0.00,0
,20180323,2974,2974,,,,2941,2941,-33,-33,0,0.00,0
,20180326,2941,2941,,,,2941,2941,0,0,0,0.00,0
,20180327,2941,2941,,,,2941,2941,0,0,0,0.00,0
,20180328,2941,2941,,,,2941,2941,0,0,0,0.00,0
,20180329,2941,2941,,,,2941,2941,0,0,0,0.00,0
,20180330,2941,2941,,,,2941,2941,0,0,0,0.00,0
,20180402,2941,2941,,,,2941,2941,0,0,0,0.00,0
,20180403,2941,2941,,,,2941,2941,0,0,0,0.00,0
,20180404,2941,2941,,,,2941,2941,0,0,0,0.00,0
,20180409,2941,2941,,,,2941,2941,0,0,0,0.00,0
,20180410,2941,2941,,,,2941,2941,0,0,0,0.00,0
,20180411,2941,2941,,,,2941,2941,0,0,0,0.00,0
,20180412,2941,2941,,,,2941,2941,0,0,0,0.00,0
,20180413,2941,2941,,,,2941,2941,0,0,0,0.00,0
,20180416,2941,2941,,,,2941,2941,0,0,0,0.00,0
,20180417,2941,2941,,,,2941,2941,0,0,0,0.00,0
,20180418,2941,2941,,,,2941,2941,0,0,0,0.00,0
,20180419,2941,2941,,,,2941,2941,0,0,0,0.00,0
,20180420,2941,2941,,,,3170,3170,229,229,0,0.00,0
,20180423,3170,3170,,,,3170,3170,0,0,0,0.00,0
,20180424,3170,3170,,,,3170,3170,0,0,0,0.00,0
,20180425,3170,3170,,,,3170,3170,0,0,0,0.00,0
,20180426,3170,3170,,,,3170,3170,0,0,0,0.00,0
,20180427,3170,3170,,,,3170,3170,0,0,0,0.00,0
,20180502,3170,3170,,,,3170,3170,0,0,0,0.00,0
,20180503,3170,3170,,,,3170,3170,0,0,0,0.00,0
,20180504,3170,3170,,,,3170,3170,0,0,0,0.00,0
,20180507,3170,3170,,,,3170,3170,0,0,0,0.00,0
,20180508,3170,3170,,,,3170,3170,0,0,0,0.00,0
,20180509,3170,3170,,,,3170,3170,0,0,0,0.00,0
,20180510,3170,3170,,,,3327,3327,157,157,0,0.00,0
,20180511,3327,3327,,,,3327,3327,0,0,0,0.00,0
,20180514,3327,3327,,,,3327,3327,0,0,0,0.00,0
,20180515,3327,3327,,,,3579,3579,252,252,0,0.00,0
,20180516,3579,3579,,,,3579,3579,0,0,0,0.00,0
,20180517,3579,3579,,,,3579,3579,0,0,0,0.00,0
,20180518,3579,3579,,,,3579,3579,0,0,0,0.00,0
,20180521,3579,3579,,,,3579,3579,0,0,0,0.00,0
,20180522,3579,3579,,,,3579,3579,0,0,0,0.00,0
,20180523,3579,3579,,,,3579,3579,0,0,0,0.00,0
,20180524,3579,3579,,,,3579,3579,0,0,0,0.00,0
,20180525,3579,3579,,,,3579,3579,0,0,0,0.00,0
,20180528,3579,3579,,,,3579,3579,0,0,0,0.00,0
,20180529,3579,3579,,,,3579,3579,0,0,0,0.00,0
,20180530,3579,3579,,,,3579,3579,0,0,0,0.00,0
,20180531,3579,3579,,,,3579,3579,0,0,0,0.00,0
wr1903,20180316,3121,3121,,,,3131,3131,10,10,0,0.00,0
,20180319,3131,3131,,,,3131,3131,0,0,0,0.00,0
,20180320,3131,3131,,,,3131,3131,0,0,0,0.00,0
,20180321,3131,3131,,,,2974,2974,-157,-157,0,0.00,0
,20180322,2974,2974,,,,2974,2974,0,0,0,0.00,0
,20180323,2974,2974,,,,2941,2941,-33,-33,0,0.00,0
,20180326,2941,2941,,,,2941,2941,0,0,0,0.00,0
,20180327,2941,2941,,,,2941,2941,0,0,0,0.00,0
,20180328,2941,2941,,,,2941,2941,0,0,0,0.00,0
,20180329,2941,2941,,,,2941,2941,0,0,0,0.00,0
,20180330,2941,2941,,,,2941,2941,0,0,0,0.00,0
,20180402,2941,2941,,,,2941,2941,0,0,0,0.00,0
,20180403,2941,2941,,,,2941,2941,0,0,0,0.00,0
,20180404,2941,2941,,,,2941,2941,0,0,0,0.00,0
,20180409,2941,2941,,,,2941,2941,0,0,0,0.00,0
,20180410,2941,2941,,,,2941,2941,0,0,0,0.00,0
,20180411,2941,2941,,,,2941,2941,0,0,0,0.00,0
,20180412,2941,2941,,,,2941,2941,0,0,0,0.00,0
,20180413,2941,2941,,,,2941,2941,0,0,0,0.00,0
,20180416,2941,2941,,,,2941,2941,0,0,0,0.00,0
,20180417,2941,2941,,,,2941,2941,0,0,0,0.00,0
,20180418,2941,2941,,,,2941,2941,0,0,0,0.00,0
,20180419,2941,2941,,,,2941,2941,0,0,0,0.00,0
,20180420,2941,2941,,,,3170,3170,229,229,0,0.00,0
,20180423,3170,3170,,,,3170,3170,0,0,0,0.00,0
,20180424,3170,3170,,,,3170,3170,0,0,0,0.00,0
,20180425,3170,3170,,,,3170,3170,0,0,0,0.00,0
,20180426,3170,3170,,,,3170,3170,0,0,0,0.00,0
,20180427,3170,3170,,,,3170,3170,0,0,0,0.00,0
,20180502,3170,3170,,,,3170,3170,0,0,0,0.00,0
,20180503,3170,3170,,,,3170,3170,0,0,0,0.00,0
,20180504,3170,3170,,,,3170,3170,0,0,0,0.00,0
,20180507,3170,3170,,,,3170,3170,0,0,0,0.00,0
,20180508,3170,3170,,,,3170,3170,0,0,0,0.00,0
,20180509,3170,3170,,,,3170,3170,0,0,0,0.00,0
,20180510,3170,3170,,,,3327,3327,157,157,0,0.00,0
,20180511,3327,3327,,,,3327,3327,0,0,0,0.00,0
,20180514,3327,3327,,,,3327,3327,0,0,0,0.00,0
,20180515,3327,3327,,,,3565,3565,238,238,0,0.00,0
,20180516,3565,3565,,,,3565,3565,0,0,0,0.00,0
,20180517,3565,3565,,,,3565,3565,0,0,0,0.00,0
,20180518,3565,3565,,,,3565,3565,0,0,0,0.00,0
,20180521,3565,3565,,,,3565,3565,0,0,0,0.00,0
,20180522,3565,3565,,,,3565,3565,0,0,0,0.00,0
,20180523,3565,3565,,,,3565,3565,0,0,0,0.00,0
,20180524,3565,3565,,,,3565,3565,0,0,0,0.00,0
,20180525,3565,3565,,,,3565,3565,0,0,0,0.00,0
,20180528,3565,3565,,,,3565,3565,0,0,0,0.00,0
,20180529,3565,3565,,,,3565,3565,0,0,0,0.00,0
,20180530,3565,3565,,,,3565,3565,0,0,0,0.00,0
,20180531,3565,3565,,,,3565,3565,0,0,0,0.00,0
wr1904,20180417,2941,2941,,,,2941,2941,0,0,0,0.00,0
,20180418,2941,2941,,,,2941,2941,0,0,0,0.00,0
,20180419,2941,2941,,,,2941,2941,0,0,0,0.00,0
,20180420,2941,2941,,,,3170,3170,229,229,0,0.00,0
,20180423,3170,3170,,,,3170,3170,0,0,0,0.00,0
,20180424,3170,3170,,,,3170,3170,0,0,0,0.00,0
,20180425,3170,3170,,,,3170,3170,0,0,0,0.00,0
,20180426,3170,3170,,,,3170,3170,0,0,0,0.00,0
,20180427,3170,3170,,,,3170,3170,0,0,0,0.00,0
,20180502,3170,3170,,,,3170,3170,0,0,0,0.00,0
,20180503,3170,3170,,,,3170,3170,0,0,0,0.00,0
,20180504,3170,3170,,,,3170,3170,0,0,0,0.00,0
,20180507,3170,3170,,,,3170,3170,0,0,0,0.00,0
,20180508,3170,3170,,,,3170,3170,0,0,0,0.00,0
,20180509,3170,3170,,,,3170,3170,0,0,0,0.00,0
,20180510,3170,3170,,,,3327,3327,157,157,0,0.00,0
,20180511,3327,3327,,,,3327,3327,0,0,0,0.00,0
,20180514,3327,3327,,,,3327,3327,0,0,0,0.00,0
,20180515,3327,3327,,,,3559,3559,232,232,0,0.00,0
,20180516,3559,3559,,,,3559,3559,0,0,0,0.00,0
,20180517,3559,3559,,,,3559,3559,0,0,0,0.00,0
,20180518,3559,3559,,,,3559,3559,0,0,0,0.00,0
,20180521,3559,3559,,,,3559,3559,0,0,0,0.00,0
,20180522,3559,3559,,,,3559,3559,0,0,0,0.00,0
,20180523,3559,3559,,,,3559,3559,0,0,0,0.00,0
,20180524,3559,3559,,,,3559,3559,0,0,0,0.00,0
,20180525,3559,3559,,,,3559,3559,0,0,0,0.00,0
,20180528,3559,3559,,,,3559,3559,0,0,0,0.00,0
,20180529,3559,3559,,,,3559,3559,0,0,0,0.00,0
,20180530,3559,3559,,,,3559,3559,0,0,0,0.00,0
,20180531,3559,3559,,,,3559,3559,0,0,0,0.00,0
wr1905,20180516,3559,3559,,,,3559,3559,0,0,0,0.00,0
,20180517,3559,3559,,,,3559,3559,0,0,0,0.00,0
,20180518,3559,3559,,,,3559,3559,0,0,0,0.00,0
,20180521,3559,3559,,,,3559,3559,0,0,0,0.00,0
,20180522,3559,3559,,,,3559,3559,0,0,0,0.00,0
,20180523,3559,3559,,,,3559,3559,0,0,0,0.00,0
,20180524,3559,3559,,,,3559,3559,0,0,0,0.00,0
,20180525,3559,3559,,,,3559,3559,0,0,0,0.00,0
,20180528,3559,3559,,,,3559,3559,0,0,0,0.00,0
,20180529,3559,3559,,,,3559,3559,0,0,0,0.00,0
,20180530,3559,3559,,,,3559,3559,0,0,0,0.00,0
,20180531,3559,3559,,,,3559,3559,0,0,0,0.00,0
zn1801,20180102,25720,25650,25795,26055,25715,25835,25845,185,195,9684,"125,152.78",28080
,20180103,25835,25845,26000,26000,25755,25780,25875,-65,30,5800,"75,046.93",25440
,20180104,25780,25875,25805,25960,25710,25955,25885,80,10,9230,"119,464.60",19900
,20180105,25955,25885,26085,26125,25890,26080,25985,195,100,7800,"101,346.35",14940
,20180108,26080,25985,26045,26070,25880,26040,25950,55,-35,5650,"73,316.45",10910
,20180109,26040,25950,26020,26375,25995,26325,26245,375,295,6050,"79,403.28",7910
,20180110,26325,26245,26235,26245,25925,26020,26105,-225,-140,4730,"61,739.45",5080
,20180111,26020,26105,26080,26200,25995,26190,26070,85,-35,3340,"43,537.80",3590
,20180112,26190,26070,26150,26290,26110,26280,26185,210,115,2030,"26,579.15",2720
,20180115,26280,26185,26220,26320,26165,26320,26220,135,35,700,"9,178.63",2520
zn1802,20180102,25725,25655,25820,26115,25710,25850,25855,195,200,228518,"2,954,438.99",170592
,20180103,25850,25855,25980,26000,25745,25775,25890,-80,35,216656,"2,804,781.43",168272
,20180104,25775,25890,25820,25985,25670,25980,25810,90,-80,199944,"2,580,512.98",163114
,20180105,25980,25810,26015,26140,25865,26080,25970,270,160,195342,"2,536,817.38",158470
,20180108,26080,25970,26050,26090,25850,26040,25965,70,-5,127678,"1,657,741.12",146426
,20180109,26040,25965,25970,26390,25970,26330,26200,365,235,104650,"1,370,925.85",138128
,20180110,26330,26200,26220,26275,26005,26020,26135,-180,-65,80484,"1,051,882.31",127260
,20180111,26020,26135,26195,26290,26045,26220,26145,85,10,70488,"921,459.23",121280
,20180112,26220,26145,26295,26350,26065,26350,26240,205,95,68398,"897,505.08",120046
,20180115,26350,26240,26260,26435,26200,26325,26285,85,45,64290,"845,081.14",112376
,20180116,26325,26285,26325,26360,25945,26045,26155,-240,-130,76656,"1,002,574.66",94408
,20180117,26045,26155,25970,26135,25930,26050,26040,-105,-115,41912,"545,765.15",90760
,20180118,26050,26040,26085,26110,25920,25975,26005,-65,-35,34562,"449,403.07",86248
,20180119,25975,26005,26000,26120,25890,26095,25990,90,-15,38192,"496,382.62",81552
,20180122,26095,25990,26180,26230,26050,26210,26145,220,155,34686,"453,505.75",78394
,20180123,26210,26145,26205,26240,26050,26200,26115,55,-30,33464,"436,976.66",72190
,20180124,26200,26115,26100,26210,25840,25885,26045,-230,-70,31614,"411,694.04",65282
,20180125,25885,26045,25920,27495,25920,26260,26220,215,175,45502,"596,609.45",53362
,20180126,26260,26220,26235,26285,26115,26180,26175,-40,-45,24446,"319,954.45",46528
,20180129,26180,26175,26260,27195,26190,27030,26875,855,700,39458,"530,243.30",38552
,20180130,27030,26875,26995,27090,26660,26795,26840,-80,-35,29712,"398,755.74",27690
,20180131,26795,26840,26855,26895,26485,26640,26670,-200,-170,21386,"285,223.23",18754
,20180201,26640,26670,26690,26780,26600,26630,26680,-40,10,7124,"95,043.88",15110
,20180202,26630,26680,26630,26900,26585,26810,26770,130,90,7000,"93,705.60",12740
,20180205,26810,26770,26725,26775,26550,26740,26675,-30,-95,6760,"90,164.10",10400
,20180206,26740,26675,26700,26875,26335,26440,26520,-235,-155,6620,"87,797.18",8050
,20180207,26440,26520,26450,26570,26350,26400,26505,-120,-15,1640,"21,735.10",7570
,20180208,26400,26505,26280,26280,26080,26150,26135,-355,-370,1610,"21,041.23",7280
,20180209,26150,26135,26300,26355,26000,26000,26165,-135,30,450,"5,887.28",7070
zn1803,20180102,25720,25655,25795,26095,25710,25855,25850,200,195,132988,"1,719,167.93",164164
,20180103,25855,25850,25900,26010,25730,25765,25880,-85,30,156208,"2,021,355.75",182370
,20180104,25765,25880,25810,25990,25670,25990,25820,110,-60,179698,"2,319,935.78",202016
,20180105,25990,25820,26045,26155,25880,26105,25995,285,175,223420,"2,903,942.95",225064
,20180108,26105,25995,26070,26110,25875,26060,25990,65,-5,323376,"4,202,735.87",234586
,20180109,26060,25990,26010,26430,25995,26350,26220,360,230,364862,"4,783,603.36",259538
,20180110,26350,26220,26260,26305,26015,26040,26165,-180,-55,302676,"3,959,873.79",246380
,20180111,26040,26165,26220,26320,26065,26255,26170,90,5,264638,"3,462,895.85",251746
,20180112,26255,26170,26330,26385,26090,26375,26265,205,95,341214,"4,481,416.37",267686
,20180115,26375,26265,26300,26480,26215,26360,26315,95,50,319106,"4,198,953.89",270808
,20180116,26360,26315,26345,26395,25945,26065,26175,-250,-140,361116,"4,726,763.42",249168
,20180117,26065,26175,26000,26155,25940,26055,26055,-120,-120,304396,"3,965,640.54",242348
,20180118,26055,26055,26090,26130,25925,25995,26010,-60,-45,280388,"3,646,766.50",233230
,20180119,25995,26010,26045,26135,25880,26100,26005,90,-5,309238,"4,021,199.03",226354
,20180122,26100,26005,26200,26250,26050,26210,26165,205,160,291540,"3,814,099.37",229078
,20180123,26210,26165,26185,26245,26040,26215,26125,50,-40,287432,"3,755,139.81",223428
,20180124,26215,26125,26135,26215,25820,25875,26065,-250,-60,344828,"4,494,638.78",226272
,20180125,25875,26065,25990,26415,25940,26290,26195,225,130,472790,"6,192,720.28",223120
,20180126,26290,26195,26250,26310,26115,26185,26195,-10,0,249650,"3,269,947.78",213584
,20180129,26185,26195,26315,27235,26200,27055,26835,860,640,531324,"7,129,294.47",231608
,20180130,27055,26835,27065,27130,26700,26825,26915,-10,80,355712,"4,787,151.43",211140
,20180131,26825,26915,26900,26915,26520,26780,26715,-135,-200,347076,"4,636,766.63",199402
,20180201,26780,26715,26740,26825,26630,26670,26730,-45,15,219902,"2,939,448.11",184706
,20180202,26670,26730,26730,26950,26630,26850,26800,120,70,264264,"3,541,663.18",175534
,20180205,26850,26800,26780,26840,26540,26805,26715,5,-85,311262,"4,158,444.35",170376
,20180206,26805,26715,26795,27000,26420,26555,26705,-160,-10,345694,"4,616,179.02",154912
,20180207,26555,26705,26535,26690,26440,26480,26555,-225,-150,254880,"3,384,666.65",138086
,20180208,26480,26555,26470,26560,26010,26255,26260,-300,-295,321754,"4,224,884.40",124878
,20180209,26255,26260,26340,26470,25940,26090,26255,-170,-5,238686,"3,133,412.45",110092
,20180212,26090,26255,26110,26150,25815,25920,25985,-335,-270,127140,"1,652,120.13",94874
,20180213,25920,25985,25975,26240,25865,26185,26010,200,25,64730,"841,830.06",85530
,20180214,26185,26010,26260,26700,26185,26635,26455,625,445,64146,"848,643.49",79024
,20180222,26635,26455,26905,26990,26150,26305,26405,-150,-50,46718,"616,811.93",69552
,20180223,26305,26405,26315,26665,26315,26515,26540,110,135,41038,"544,656.23",63236
,20180226,26515,26540,26515,26705,26335,26655,26555,115,15,39412,"523,363.63",55316
,20180227,26655,26555,26675,26735,26565,26630,26645,75,90,32754,"436,435.20",46148
,20180228,26630,26645,26585,26585,26270,26400,26380,-245,-265,29256,"385,950.15",35012
,20180301,26400,26380,26345,26445,26215,26390,26340,10,-40,9952,"131,078.91",30830
,20180302,26390,26340,26050,26265,26025,26230,26170,-110,-170,8050,"105,336.90",27050
,20180305,26230,26170,26155,26185,25585,25620,25905,-550,-265,12420,"160,874.23",21080
,20180306,25620,25905,25485,25500,25180,25380,25350,-525,-555,13590,"172,270.95",14750
,20180307,25380,25350,25510,25540,25300,25300,25415,-50,65,5330,"67,743.35",11670
,20180308,25300,25415,25235,25400,25100,25115,25265,-300,-150,3490,"44,092.90",10430
,20180309,25115,25265,25130,25175,24520,24685,24830,-580,-435,5620,"69,777.00",7930
,20180312,24685,24830,24780,25245,24780,24985,25010,155,180,3530,"44,150.23",6690
,20180313,24985,25010,25000,25105,24885,25050,25015,40,5,3560,"44,534.50",4860
,20180314,25050,25015,25050,25180,25000,25095,25085,80,70,850,"10,662.05",4690
,20180315,25095,25085,25030,25030,24700,24760,24785,-325,-300,380,"4,709.25",4750
zn1804,20180102,25680,25645,25770,26050,25690,25830,25840,185,195,29102,"376,030.22",31632
,20180103,25830,25840,25950,25975,25690,25720,25845,-120,5,33234,"429,517.30",37442
,20180104,25720,25845,25750,25950,25635,25950,25795,105,-50,35386,"456,404.53",41344
,20180105,25950,25795,26000,26100,25855,26080,25970,285,175,35052,"455,232.30",47482
,20180108,26080,25970,26015,26080,25865,26030,25960,60,-10,42092,"546,396.70",51122
,20180109,26030,25960,26000,26380,25975,26315,26185,355,225,47988,"628,309.71",57620
,20180110,26315,26185,26240,26280,26000,26015,26140,-170,-45,38772,"506,792.32",60388
,20180111,26015,26140,26200,26290,26055,26230,26145,90,5,36386,"475,728.47",65994
,20180112,26230,26145,26310,26395,26070,26340,26250,195,105,48828,"640,970.93",73486
,20180115,26340,26250,26290,26445,26200,26335,26300,85,50,47254,"621,468.41",76048
,20180116,26335,26300,26365,26380,25940,26050,26175,-250,-125,78564,"1,028,252.74",82222
,20180117,26050,26175,26000,26180,25925,26000,26045,-175,-130,61974,"807,071.00",82628
,20180118,26000,26045,26080,26115,25920,25985,26000,-60,-45,55486,"721,387.05",86116
,20180119,25985,26000,26015,26125,25885,26085,25990,85,-10,58418,"759,285.53",89198
,20180122,26085,25990,26220,26235,26040,26210,26150,220,160,61416,"803,140.49",91156
,20180123,26210,26150,26170,26230,26030,26210,26115,60,-35,61852,"807,666.49",93442
,20180124,26210,26115,26125,26200,25815,25855,26055,-260,-60,70244,"915,191.44",101656
,20180125,25855,26055,25950,26400,25930,26280,26190,225,135,94880,"1,242,625.83",107450
,20180126,26280,26190,26225,26295,26105,26180,26180,-10,-10,70370,"921,278.15",118028
,20180129,26180,26180,26290,27750,26185,27015,26805,835,625,138518,"1,856,822.16",128800
,20180130,27015,26805,27000,27085,26650,26800,26865,-5,60,101708,"1,366,338.29",138458
,20180131,26800,26865,26900,26900,26510,26765,26700,-100,-165,100700,"1,344,469.49",148716
,20180201,26765,26700,26745,26795,26595,26655,26705,-45,5,89168,"1,190,697.97",158264
,20180202,26655,26705,26705,26935,26615,26825,26790,120,85,130512,"1,748,339.14",170550
,20180205,26825,26790,26740,26825,26525,26790,26705,0,-85,169468,"2,262,924.56",176876
,20180206,26790,26705,26800,26995,26410,26535,26690,-170,-15,214498,"2,862,707.69",189680
,20180207,26535,26690,26510,26685,26435,26470,26550,-220,-140,190386,"2,527,681.13",195444
,20180208,26470,26550,26455,26560,26005,26270,26255,-280,-295,287974,"3,780,977.04",195586
,20180209,26270,26255,26330,26495,25975,26120,26270,-135,15,245676,"3,227,123.08",190284
,20180212,26120,26270,26150,26180,25850,25940,26015,-330,-255,321452,"4,181,999.28",184112
,20180213,25940,26015,26000,26275,25875,26230,26035,215,20,223396,"2,908,097.70",184990
,20180214,26230,26035,26270,26695,26235,26650,26480,615,445,225764,"2,989,673.80",187350
,20180222,26650,26480,26930,26945,26155,26330,26410,-150,-70,235906,"3,115,371.71",183548
,20180223,26330,26410,26380,26710,26360,26560,26575,150,165,316532,"4,206,123.61",175076
,20180226,26560,26575,26575,26745,26380,26670,26575,95,0,296500,"3,940,005.79",173488
,20180227,26670,26575,26690,26770,26600,26660,26675,85,100,252854,"3,372,861.09",171266
,20180228,26660,26675,26580,26615,26290,26400,26415,-275,-260,309998,"4,094,392.22",163940
,20180301,26400,26415,26355,26480,26225,26430,26355,15,-60,252760,"3,331,139.51",155998
,20180302,26430,26355,26100,26315,26060,26260,26205,-95,-150,263028,"3,446,683.40",148212
,20180305,26260,26205,26180,26240,25645,25660,25985,-545,-220,317126,"4,120,882.40",140660
,20180306,25660,25985,25515,25555,25210,25450,25390,-535,-595,302018,"3,834,690.75",128398
,20180307,25450,25390,25565,25620,25350,25360,25490,-30,100,137960,"1,758,626.08",122210
,20180308,25360,25490,25335,25485,25160,25170,25320,-320,-170,140446,"1,778,175.22",109538
,20180309,25170,25320,25120,25230,24580,24700,24890,-620,-430,153858,"1,915,119.16",98738
,20180312,24700,24890,24820,25350,24775,25035,25040,145,150,104322,"1,306,221.53",91632
,20180313,25035,25040,24980,25240,24910,25165,25100,125,60,74478,"934,747.64",87550
,20180314,25165,25100,25275,25335,25100,25205,25215,105,115,61894,"780,413.75",83352
,20180315,25205,25215,25130,25180,24700,24890,24880,-325,-335,68856,"856,624.71",79478
,20180316,24890,24880,24855,24985,24690,24890,24870,10,-10,51270,"637,544.95",73630
,20180319,24890,24870,25035,25095,24765,24820,24925,-50,55,46028,"573,630.47",68080
,20180320,24820,24925,24870,24975,24620,24795,24805,-130,-120,36510,"452,856.07",61904
,20180321,24795,24805,24835,24835,24310,24420,24470,-385,-335,37674,"461,012.07",57204
,20180322,24420,24470,24565,25030,24500,24865,24785,395,315,30476,"377,735.61",52092
,20180323,24865,24785,24730,24850,24280,24690,24615,-95,-170,31070,"382,399.60",47044
,20180326,24690,24615,24690,24805,24330,24670,24590,55,-25,27982,"344,077.23",41368
,20180327,24670,24590,24710,25065,24605,24960,24945,370,355,23034,"287,313.48",38670
,20180328,24960,24945,24960,25045,24765,24790,24870,-155,-75,17980,"223,619.25",36962
,20180329,24790,24870,24870,24995,24675,24995,24845,125,-25,30250,"375,821.70",31260
,20180330,24995,24845,24925,25050,24720,24970,24920,125,75,17902,"223,066.17",26170
,20180402,24970,24920,25080,25235,24975,25020,25055,100,135,5800,"72,664.98",23250
,20180403,25020,25055,25020,25060,24775,24805,24935,-250,-120,8360,"104,237.50",20320
,20180404,24805,24935,24865,24875,24630,24715,24735,-220,-200,5750,"71,116.43",18410
,20180409,24715,24735,24855,24930,24410,24595,24510,-140,-225,8620,"105,646.00",15060
,20180410,24595,24510,24515,24700,24420,24645,24585,135,75,7330,"90,117.40",13380
,20180411,24645,24585,24645,24775,24525,24740,24660,155,75,6200,"76,450.93",11810
,20180412,24740,24660,24590,24590,23695,23850,24095,-810,-565,6150,"74,105.28",8670
,20180413,23850,24095,23800,23820,23510,23740,23745,-355,-350,2810,"33,361.73",8190
,20180416,23740,23745,23540,24315,23500,23930,23740,185,-5,1460,"17,331.80",7520
zn1805,20180102,25700,25615,25750,26000,25645,25795,25790,180,175,22220,"286,582.13",56254
,20180103,25795,25790,26000,26000,25635,25680,25800,-110,10,25394,"327,589.60",56630
,20180104,25680,25800,25700,25900,25590,25900,25745,100,-55,23268,"299,550.73",56662
,20180105,25900,25745,26000,26065,25820,26025,25930,280,185,31326,"406,166.83",59812
,20180108,26025,25930,25950,26035,25835,25995,25930,65,0,39882,"517,089.61",63740
,20180109,25995,25930,25945,26350,25930,26265,26140,335,210,40728,"532,338.20",66610
,20180110,26265,26140,26230,26235,25955,25970,26090,-170,-50,32488,"423,855.84",67872
,20180111,25970,26090,26120,26240,26015,26195,26105,105,15,30090,"392,758.40",71480
,20180112,26195,26105,26290,26300,26040,26295,26205,190,100,36748,"481,502.00",75354
,20180115,26295,26205,26185,26385,26165,26315,26255,110,50,39732,"521,611.95",78390
,20180116,26315,26255,26310,26350,25900,26015,26130,-240,-125,50998,"666,351.36",78018
,20180117,26015,26130,25990,26105,25880,26005,26005,-125,-125,38038,"494,598.59",81002
,20180118,26005,26005,26015,26075,25870,25945,25965,-60,-40,30052,"390,197.04",81848
,20180119,25945,25965,26000,26085,25845,26030,25955,65,-10,33306,"432,230.39",83414
,20180122,26030,25955,26170,26200,26010,26180,26105,225,150,33222,"433,708.11",87090
,20180123,26180,26105,26120,26190,25990,26160,26070,55,-35,34368,"448,054.53",89236
,20180124,26160,26070,26105,26160,25780,25815,26005,-255,-65,40094,"521,408.36",92508
,20180125,25815,26005,25885,26350,25885,26230,26150,225,145,55736,"728,814.92",97692
,20180126,26230,26150,26165,26245,26055,26125,26135,-25,-15,27620,"360,992.98",98104
,20180129,26125,26135,26305,27075,26135,26955,26700,820,565,76454,"1,020,684.73",102240
,20180130,26955,26700,26980,27015,26580,26735,26785,35,85,54930,"735,735.75",103978
,20180131,26735,26785,26820,26820,26430,26695,26630,-90,-155,48162,"641,320.31",103980
,20180201,26695,26630,26705,26730,26525,26570,26635,-60,5,35274,"469,827.01",103062
,20180202,26570,26635,26610,26850,26540,26750,26720,115,85,47808,"638,743.42",103358
,20180205,26750,26720,26620,26760,26460,26715,26630,-5,-90,69366,"923,750.51",106332
,20180206,26715,26630,26690,26895,26335,26455,26620,-175,-10,78376,"1,043,262.21",105920
,20180207,26455,26620,26445,26605,26365,26395,26470,-225,-150,55448,"733,975.74",105716
,20180208,26395,26470,26380,26490,25940,26195,26180,-275,-290,86554,"1,133,057.35",103354
,20180209,26195,26180,26260,26420,25920,26070,26200,-110,20,76074,"996,659.61",104710
,20180212,26070,26200,26085,26150,25835,25900,25985,-300,-215,80616,"1,047,572.49",103410
,20180213,25900,25985,25950,26230,25845,26190,26010,205,25,49942,"649,578.67",104630
,20180214,26190,26010,26180,26635,26180,26585,26455,575,445,57580,"761,643.60",106380
,20180222,26585,26455,26975,26975,26105,26295,26380,-160,-75,90930,"1,199,479.64",109872
,20180223,26295,26380,26320,26670,26320,26530,26535,150,155,117244,"1,555,546.31",122640
,20180226,26530,26535,26575,26740,26365,26650,26550,115,15,103842,"1,378,681.40",127090
,20180227,26650,26550,26650,26750,26590,26650,26660,100,110,108764,"1,449,958.49",140436
,20180228,26650,26660,26580,26600,26275,26400,26400,-260,-260,122078,"1,611,515.25",152006
,20180301,26400,26400,26345,26470,26215,26430,26345,30,-55,129040,"1,700,010.57",151742
,20180302,26430,26345,26095,26305,26040,26265,26200,-80,-145,189220,"2,478,798.30",163050
,20180305,26265,26200,26165,26230,25625,25650,25970,-550,-230,278918,"3,622,358.18",173900
,20180306,25650,25970,25450,25510,25175,25395,25360,-575,-610,369516,"4,685,698.41",181084
,20180307,25395,25360,25500,25590,25295,25300,25445,-60,85,334270,"4,253,073.41",207718
,20180308,25300,25445,25300,25440,25100,25100,25265,-345,-180,407040,"5,142,283.14",221504
,20180309,25100,25265,25070,25170,24505,24615,24825,-650,-440,546906,"6,788,680.89",240190
,20180312,24615,24825,24720,25280,24700,24985,24980,160,155,571042,"7,133,181.74",237044
,20180313,24985,24980,24950,25220,24865,25130,25045,150,65,434118,"5,437,111.88",236224
,20180314,25130,25045,25250,25330,25065,25195,25180,150,135,366752,"4,618,141.74",235524
,20180315,25195,25180,25180,25180,24665,24860,24860,-320,-320,511652,"6,360,201.83",244134
,20180316,24860,24860,24850,24990,24670,24910,24845,50,-15,428084,"5,318,551.22",237142
,20180319,24910,24845,25070,25100,24755,24805,24920,-40,75,468432,"5,837,519.30",241454
,20180320,24805,24920,24920,24980,24600,24770,24820,-150,-100,476500,"5,914,029.43",243344
,20180321,24770,24820,24800,24800,24290,24405,24450,-415,-370,668916,"8,178,030.68",257696
,20180322,24405,24450,24520,25035,24475,24845,24745,395,295,587844,"7,274,478.04",241186
,20180323,24845,24745,24660,24845,24235,24670,24590,-75,-155,804784,"9,895,858.11",236648
,20180326,24670,24590,24710,24810,24320,24640,24595,50,5,640570,"7,878,879.56",222136
,20180327,24640,24595,24665,25095,24665,24950,24940,355,345,548046,"6,834,766.48",209302
,20180328,24950,24940,25010,25045,24760,24805,24880,-135,-60,486174,"6,048,057.89",204668
,20180329,24805,24880,24875,24960,24650,24955,24790,75,-90,466392,"5,781,648.88",192150
,20180330,24955,24790,24955,25010,24670,24945,24860,155,70,493248,"6,131,372.32",178618
,20180402,24945,24860,24910,25275,24905,24970,25060,110,200,367360,"4,603,367.67",159670
,20180403,24970,25060,25020,25045,24695,24765,24905,-295,-155,387638,"4,827,186.73",148338
,20180404,24765,24905,24850,24875,24585,24620,24720,-285,-185,280924,"3,472,368.09",141080
,20180409,24620,24720,24705,24875,24315,24470,24495,-250,-225,221500,"2,712,930.67",135442
,20180410,24470,24495,24470,24650,24380,24585,24530,90,35,176582,"2,165,791.54",119930
,20180411,24585,24530,24700,24755,24460,24665,24600,135,70,143598,"1,766,539.81",112988
,20180412,24665,24600,24640,24655,23600,23745,24090,-855,-510,192220,"2,315,556.77",117548
,20180413,23745,24090,23630,23780,23380,23655,23615,-435,-475,121966,"1,440,291.01",110646
,20180416,23655,23615,23655,23875,23310,23815,23645,200,30,105880,"1,251,852.00",98486
,20180417,23815,23645,23860,23950,23670,23825,23825,180,180,63338,"754,554.94",95248
,20180418,23825,23825,23770,24135,23750,24020,23965,195,140,64508,"773,007.87",87422
,20180419,24020,23965,24295,24980,24295,24620,24640,655,675,79526,"979,936.07",77986
,20180420,24620,24640,24320,24565,24295,24475,24450,-165,-190,44890,"548,869.25",72134
,20180423,24475,24450,24575,24690,24380,24585,24565,135,115,34322,"421,616.32",67260
,20180424,24585,24565,24375,24680,24230,24535,24540,-30,-25,37994,"466,224.64",57658
,20180425,24535,24540,24615,24665,24260,24275,24505,-265,-35,27816,"340,877.77",52276
,20180426,24275,24505,24200,24300,23770,23810,23935,-695,-570,37346,"446,980.04",45466
,20180427,23810,23935,23740,24115,23740,24000,23995,65,60,21642,"259,654.51",39764
,20180502,24000,23995,23890,24130,23735,24015,23915,20,-80,14254,"170,446.97",34830
,20180503,24015,23915,23890,23930,23700,23825,23810,-90,-105,16810,"200,160.85",28350
,20180504,23825,23810,23740,23740,23295,23395,23420,-415,-390,15270,"178,837.78",21020
,20180507,23395,23420,23295,23970,23250,23970,23800,550,380,8070,"96,037.30",18340
,20180508,23970,23800,23970,24070,23880,23935,23960,135,160,9120,"109,270.30",13650
,20180509,23935,23960,23820,23975,23705,23835,23865,-125,-95,6230,"74,343.75",9700
,20180510,23835,23865,23895,23990,23815,23865,23910,0,45,5040,"60,264.98",6340
,20180511,23865,23910,23830,23890,23780,23890,23835,-20,-75,2420,"28,842.20",4910
,20180514,23890,23835,23885,23885,23650,23715,23735,-120,-100,3890,"46,171.28",3180
,20180515,23715,23735,23780,23900,23760,23900,23860,165,125,1330,"15,869.43",2340
zn1806,20180102,25620,25545,25635,25930,25630,25770,25750,225,205,462,"5,948.83",4448
,20180103,25770,25750,25860,25900,25600,25640,25775,-110,25,876,"11,289.79",4792
,20180104,25640,25775,25645,25870,25580,25865,25800,90,25,4712,"60,789.09",6582
,20180105,25865,25800,25865,26040,25780,25985,25895,185,95,2322,"30,068.64",7696
,20180108,25985,25895,25950,25990,25800,25955,25885,60,-10,1008,"13,046.15",8240
,20180109,25955,25885,25930,26280,25925,26230,26150,345,265,7904,"103,360.94",11808
,20180110,26230,26150,26190,26200,25910,25920,26035,-230,-115,2140,"27,859.69",12222
,20180111,25920,26035,26100,26180,25990,26130,26045,95,10,6064,"78,969.20",14638
,20180112,26130,26045,26050,26245,25995,26230,26160,185,115,4596,"60,123.61",14496
,20180115,26230,26160,26155,26325,26105,26260,26200,100,40,7524,"98,568.55",14976
,20180116,26260,26200,26240,26260,25850,25960,26120,-240,-80,7828,"102,238.81",15660
,20180117,25960,26120,25905,26035,25840,25965,25965,-155,-155,4476,"58,111.99",17134
,20180118,25965,25965,25965,26015,25830,25895,25910,-70,-55,3660,"47,420.03",18152
,20180119,25895,25910,25930,26015,25790,25995,25890,85,-20,5588,"72,346.21",19188
,20180122,25995,25890,26100,26140,25950,26090,26050,200,160,6392,"83,262.54",20270
,20180123,26090,26050,26060,26120,25935,26110,26010,60,-40,3270,"42,530.90",20776
,20180124,26110,26010,26025,26095,25710,25740,25915,-270,-95,5822,"75,440.88",22514
,20180125,25740,25915,25835,26260,25815,26160,26060,245,145,9834,"128,154.42",25852
,20180126,26160,26060,26100,26160,25975,26070,26050,10,-10,2242,"29,203.49",25878
,20180129,26070,26050,26195,26940,26040,26875,26620,825,570,20012,"266,386.13",31850
,20180130,26875,26620,26910,26910,26460,26650,26680,30,60,14600,"194,765.52",33792
,20180131,26650,26680,26740,26740,26360,26595,26530,-85,-150,11504,"152,602.98",33208
,20180201,26595,26530,26625,26630,26425,26490,26525,-40,-5,7590,"100,677.08",34276
,20180202,26490,26525,26545,26740,26450,26660,26615,135,90,11110,"147,863.81",35938
,20180205,26660,26615,26610,26645,26375,26580,26525,-35,-90,15734,"208,673.39",37628
,20180206,26580,26525,26570,26790,26225,26350,26505,-175,-20,25390,"336,526.33",40868
,20180207,26350,26505,26330,26485,26260,26300,26365,-205,-140,14954,"197,151.17",42382
,20180208,26300,26365,26300,26375,25840,26075,26065,-290,-300,24470,"318,911.64",44104
,20180209,26075,26065,26155,26310,25825,25980,26105,-85,40,29180,"380,882.53",44806
,20180212,25980,26105,25950,26090,25755,25840,25940,-265,-165,22238,"288,469.62",43334
,20180213,25840,25940,25885,26155,25775,26125,25955,185,15,13882,"180,153.67",44702
,20180214,26125,25955,26155,26545,26120,26470,26375,515,420,15142,"199,701.76",45498
,20180222,26470,26375,26605,26820,26025,26215,26290,-160,-85,18674,"245,481.07",46494
,20180223,26215,26290,26260,26615,26240,26470,26475,180,185,32666,"432,448.71",51960
,20180226,26470,26475,26480,26660,26315,26585,26505,110,30,25824,"342,280.45",54884
,20180227,26585,26505,26630,26690,26545,26610,26610,105,105,23098,"307,329.75",57612
,20180228,26610,26610,26550,26550,26230,26335,26350,-275,-260,23682,"312,030.33",58694
,20180301,26335,26350,26335,26420,26170,26375,26295,25,-55,26498,"348,408.89",59574
,20180302,26375,26295,26005,26250,26005,26195,26145,-100,-150,35548,"464,704.48",62496
,20180305,26195,26145,26145,26175,25575,25585,25915,-560,-230,49506,"641,578.84",64894
,20180306,25585,25915,25400,25500,25120,25330,25305,-585,-610,61182,"774,204.21",72168
,20180307,25330,25305,25430,25530,25230,25250,25385,-55,80,33104,"420,180.55",74586
,20180308,25250,25385,25205,25370,25040,25045,25190,-340,-195,40244,"506,926.62",77588
,20180309,25045,25190,25050,25100,24425,24540,24740,-650,-450,65116,"805,630.85",82340
,20180312,24540,24740,24630,25195,24615,24900,24910,160,170,63270,"788,144.25",83040
,20180313,24900,24910,24910,25150,24800,25070,25000,160,90,68920,"861,662.41",88360
,20180314,25070,25000,25160,25230,25000,25140,25115,140,115,44780,"562,421.23",89766
,20180315,25140,25115,25100,25120,24620,24805,24810,-310,-305,58228,"722,453.21",92316
,20180316,24805,24810,24800,24955,24625,24875,24810,65,0,48484,"601,519.18",93566
,20180319,24875,24810,25015,25095,24715,24760,24870,-50,60,69472,"864,036.10",98348
,20180320,24760,24870,24840,24940,24570,24730,24770,-140,-100,85980,"1,064,915.83",103824
,20180321,24730,24770,24720,24745,24250,24355,24405,-415,-365,124514,"1,519,442.06",113032
,20180322,24355,24405,24455,24955,24430,24790,24685,385,280,135430,"1,671,556.35",125402
,20180323,24790,24685,24610,24750,24155,24580,24500,-105,-185,204714,"2,507,892.60",137880
,20180326,24580,24500,24600,24720,24220,24560,24495,60,-5,165910,"2,032,276.51",137524
,20180327,24560,24495,24585,25020,24585,24880,24860,385,365,144132,"1,791,731.98",137662
,20180328,24880,24860,24950,24975,24680,24745,24815,-115,-45,164260,"2,038,218.76",154316
,20180329,24745,24815,24830,24920,24590,24910,24740,95,-75,159888,"1,978,009.72",157158
,20180330,24910,24740,24930,24975,24610,24880,24805,140,65,208562,"2,586,691.65",162458
,20180402,24880,24805,24865,25250,24855,24910,25000,105,195,185512,"2,319,171.92",169450
,20180403,24910,25000,24960,24990,24635,24710,24845,-290,-155,242546,"3,013,194.62",185182
,20180404,24710,24845,24770,24820,24515,24535,24645,-310,-200,247026,"3,044,270.04",198002
,20180409,24535,24645,24615,24785,24180,24355,24370,-290,-275,276874,"3,374,188.76",217408
,20180410,24355,24370,24360,24575,24250,24500,24415,130,45,416226,"5,081,545.19",222864
,20180411,24500,24415,24600,24675,24340,24580,24500,165,85,476456,"5,837,474.07",222172
,20180412,24580,24500,24525,24570,23435,23625,23955,-875,-545,916278,"10,975,436.42",294998
,20180413,23625,23955,23480,23650,23250,23515,23470,-440,-485,723502,"8,490,460.31",297016
,20180416,23515,23470,23515,23755,23165,23690,23495,220,25,688420,"8,088,436.07",276630
,20180417,23690,23495,23720,23815,23515,23690,23660,195,165,469440,"5,554,239.91",274148
,20180418,23690,23660,23650,24030,23605,23890,23835,230,175,500956,"5,970,294.23",263898
,20180419,23890,23835,24205,24930,24205,24530,24560,695,725,643728,"7,905,152.16",231266
,20180420,24530,24560,24350,24485,24185,24395,24345,-165,-215,453148,"5,516,005.37",220594
,20180423,24395,24345,24480,24615,24280,24500,24450,155,105,360160,"4,403,303.65",220574
,20180424,24500,24450,24150,24590,24120,24430,24420,-20,-30,363622,"4,440,129.23",221856
,20180425,24430,24420,24505,24560,24145,24165,24405,-255,-15,402462,"4,911,044.54",222038
,20180426,24165,24405,24125,24195,23630,23685,23890,-720,-515,561848,"6,711,852.93",220606
,20180427,23685,23890,23660,23985,23650,23950,23855,60,-35,433508,"5,171,567.93",198956
,20180502,23950,23855,23790,24045,23605,23900,23815,45,-40,230436,"2,744,088.02",190712
,20180503,23900,23815,23770,23840,23595,23730,23725,-85,-90,359642,"4,266,264.79",174132
,20180504,23730,23725,23665,23675,23180,23300,23375,-425,-350,407092,"4,758,187.58",174196
,20180507,23300,23375,23200,23925,23145,23910,23570,535,195,380182,"4,480,905.71",160560
,20180508,23910,23570,23875,24000,23790,23885,23880,315,310,212092,"2,532,839.03",153352
,20180509,23885,23880,23750,23940,23605,23795,23800,-85,-80,161386,"1,920,820.43",141538
,20180510,23795,23800,23850,23960,23760,23835,23860,35,60,118532,"1,414,174.90",135162
,20180511,23835,23860,23900,23960,23695,23805,23800,-55,-60,98842,"1,176,244.79",130950
,20180514,23805,23800,23880,23910,23630,23670,23755,-130,-45,98872,"1,174,398.43",127356
,20180515,23670,23755,23605,23880,23560,23870,23760,115,5,96064,"1,141,299.95",119166
,20180516,23870,23760,23800,24050,23730,23875,23890,115,130,86914,"1,038,241.10",111928
,20180517,23875,23890,23825,24000,23640,23670,23845,-220,-45,57646,"687,398.45",107726
,20180518,23670,23845,23660,23930,23660,23840,23815,-5,-30,55756,"663,948.06",106406
,20180521,23840,23815,23885,24175,23775,24080,24030,265,215,62492,"750,848.98",99748
,20180522,24080,24030,24095,24170,23720,23730,23935,-300,-95,61006,"730,166.84",96386
,20180523,23730,23935,23790,23860,23655,23750,23760,-185,-175,51314,"609,691.25",91916
,20180524,23750,23760,23730,23745,23540,23645,23630,-115,-130,65250,"771,007.13",84056
,20180525,23645,23630,23620,23910,23580,23910,23760,280,130,30326,"360,332.95",80504
,20180528,23910,23760,23910,24075,23750,24070,23985,310,225,38778,"465,067.93",71584
,20180529,24070,23985,24095,24320,24020,24270,24180,285,195,43810,"529,696.19",62768
,20180530,24270,24180,24270,24365,24080,24150,24215,-30,35,33294,"403,147.54",56276
,20180531,24150,24215,24340,24590,24250,24590,24480,375,265,28058,"343,473.24",50930
zn1807,20180102,25565,25500,25635,25825,25575,25690,25655,190,155,44,564.43,300
,20180103,25690,25655,25795,25795,25555,25555,25700,-100,45,128,"1,645.00",380
,20180104,25555,25700,25615,25805,25560,25805,25725,105,25,102,"1,312.01",418
,20180105,25805,25725,25835,25890,25780,25780,25845,55,120,96,"1,240.65",476
,20180108,25780,25845,25850,25960,25795,25855,25845,10,0,152,"1,964.31",506
,20180109,25855,25845,25965,26180,25885,26160,26055,315,210,74,964.11,544
,20180110,26160,26055,26065,26120,25890,25890,26015,-165,-40,40,520.32,532
,20180111,25890,26015,26010,26100,25980,26085,26015,70,0,44,572.37,540
,20180112,26085,26015,26120,26200,25970,26200,26110,185,95,168,"2,193.35",508
,20180115,26200,26110,26120,26285,26040,26255,26130,145,20,176,"2,299.84",558
,20180116,26255,26130,26170,26180,25810,25960,25930,-170,-200,414,"5,368.17",744
,20180117,25960,25930,25885,25965,25850,25865,25915,-65,-15,512,"6,634.41",1014
,20180118,25865,25915,25870,25910,25780,25840,25875,-75,-40,290,"3,751.90",1118
,20180119,25840,25875,25890,25965,25800,25955,25880,80,5,542,"7,014.75",1552
,20180122,25955,25880,26010,26080,25925,26060,26020,180,140,1004,"13,062.41",2084
,20180123,26060,26020,25995,26025,25895,26025,25975,5,-45,212,"2,753.66",2214
,20180124,26025,25975,26005,26060,25700,25710,25920,-265,-55,202,"2,618.24",2324
,20180125,25710,25920,25780,26200,25770,26130,26095,210,175,872,"11,378.32",2868
,20180126,26130,26095,26065,26105,25925,26000,25995,-95,-100,292,"3,795.35",2934
,20180129,26000,25995,26055,26845,25995,26730,26580,735,585,1024,"13,610.04",3244
,20180130,26730,26580,26725,26780,26390,26505,26585,-75,5,1288,"17,121.03",3526
,20180131,26505,26585,26800,26800,26260,26540,26430,-45,-155,484,"6,397.02",3390
,20180201,26540,26430,26470,26550,26330,26395,26435,-35,5,744,"9,834.55",3598
,20180202,26395,26435,26405,26640,26405,26510,26520,75,85,394,"5,225.05",3538
,20180205,26510,26520,26470,26540,26270,26510,26440,-10,-80,1112,"14,702.35",3906
,20180206,26510,26440,26505,26675,26135,26240,26405,-200,-35,2498,"32,981.26",4826
,20180207,26240,26405,26270,26385,26165,26245,26320,-160,-85,2358,"31,035.14",6180
,20180208,26245,26320,26215,26300,25755,26005,25995,-315,-325,2112,"27,454.26",7038
,20180209,26005,25995,26065,26280,25765,25875,26085,-120,90,3298,"43,020.93",8718
,20180212,25875,26085,25935,26060,25690,25750,25885,-335,-200,1748,"22,627.70",8642
,20180213,25750,25885,25790,26090,25720,26075,25850,190,-35,2970,"38,389.64",8806
,20180214,26075,25850,26110,26455,26060,26400,26290,550,440,2406,"31,627.48",9492
,20180222,26400,26290,26585,26725,25960,26165,26220,-125,-70,2200,"28,842.66",9678
,20180223,26165,26220,26185,26560,26185,26440,26415,220,195,4938,"65,221.12",11322
,20180226,26440,26415,26410,26600,26250,26570,26480,155,65,4292,"56,833.52",12784
,20180227,26570,26480,26605,26640,26490,26555,26555,75,75,5618,"74,594.56",14052
,20180228,26555,26555,26475,26490,26190,26280,26290,-275,-265,6400,"84,140.18",14384
,20180301,26280,26290,26260,26360,26130,26320,26265,30,-25,4126,"54,192.77",14266
,20180302,26320,26265,26045,26210,25960,26170,26100,-95,-165,4956,"64,687.43",15640
,20180305,26170,26100,26095,26125,25505,25505,25840,-595,-260,9262,"119,672.17",17240
,20180306,25505,25840,25465,25465,25065,25265,25245,-575,-595,10516,"132,759.54",18426
,20180307,25265,25245,25265,25465,25175,25180,25330,-65,85,6784,"85,928.61",18858
,20180308,25180,25330,25180,25290,24970,24985,25130,-345,-200,11882,"149,298.45",19938
,20180309,24985,25130,24940,25025,24345,24480,24655,-650,-475,18720,"230,790.01",22824
,20180312,24480,24655,24485,25110,24485,24830,24835,175,180,17242,"214,112.15",24716
,20180313,24830,24835,24810,25050,24715,24960,24925,125,90,20532,"255,890.48",28698
,20180314,24960,24925,25060,25125,24905,25055,25030,130,105,18438,"230,765.92",32146
,20180315,25055,25030,25005,25015,24550,24705,24730,-325,-300,17800,"220,101.93",31892
,20180316,24705,24730,24710,24895,24535,24820,24745,90,15,15490,"191,664.81",29078
,20180319,24820,24745,24985,25000,24655,24700,24815,-45,70,19980,"247,949.95",29158
,20180320,24700,24815,24800,24880,24520,24660,24710,-155,-105,22380,"276,553.14",32706
,20180321,24660,24710,24665,24670,24195,24295,24350,-415,-360,32614,"397,150.42",35120
,20180322,24295,24350,24375,24870,24340,24690,24605,340,255,47408,"583,352.70",48070
,20180323,24690,24605,24575,24670,24040,24510,24400,-95,-205,54164,"660,864.07",51728
,20180326,24510,24400,24560,24645,24140,24465,24420,65,20,48916,"597,341.78",58318
,20180327,24465,24420,24590,24925,24505,24805,24780,385,360,35476,"439,620.08",62166
,20180328,24805,24780,24815,24885,24610,24670,24740,-110,-40,37980,"469,848.78",67598
,20180329,24670,24740,24740,24850,24510,24840,24665,100,-75,36710,"452,774.41",68824
,20180330,24840,24665,24835,24900,24540,24820,24745,155,80,48158,"595,835.54",70998
,20180402,24820,24745,24790,25140,24775,24835,24925,90,180,44654,"556,517.12",76292
,20180403,24835,24925,24835,24905,24560,24620,24750,-305,-175,44984,"556,784.36",77802
,20180404,24620,24750,24750,24750,24420,24420,24565,-330,-185,47854,"587,831.44",79850
,20180409,24420,24565,24460,24695,24090,24275,24280,-290,-285,69204,"840,300.85",87230
,20180410,24275,24280,24260,24500,24155,24430,24325,150,45,58436,"710,780.50",89858
,20180411,24430,24325,24525,24585,24255,24495,24425,170,100,68258,"833,642.94",92906
,20180412,24495,24425,24480,24480,23325,23510,23810,-915,-615,132138,"1,573,315.96",111098
,20180413,23510,23810,23375,23550,23145,23415,23385,-395,-425,84326,"986,016.06",117780
,20180416,23415,23385,23450,23645,23065,23575,23395,190,10,109918,"1,285,898.19",124362
,20180417,23575,23395,23600,23670,23375,23530,23525,135,130,117860,"1,386,332.86",140330
,20180418,23530,23525,23500,23895,23460,23765,23705,240,180,118800,"1,408,288.46",140812
,20180419,23765,23705,24010,24800,24010,24400,24435,695,730,175048,"2,138,810.75",133754
,20180420,24400,24435,24210,24360,24050,24260,24205,-175,-230,137670,"1,666,439.65",140948
,20180423,24260,24205,24330,24495,24165,24370,24340,165,135,98116,"1,194,233.33",140936
,20180424,24370,24340,24020,24470,24010,24320,24300,-20,-40,113138,"1,374,803.79",144672
,20180425,24320,24300,24400,24440,24010,24030,24280,-270,-20,117574,"1,427,489.64",153010
,20180426,24030,24280,23960,24075,23500,23540,23755,-740,-525,169512,"2,013,736.47",176866
,20180427,23540,23755,23540,23840,23505,23805,23715,50,-40,170244,"2,019,020.27",181928
,20180502,23805,23715,23610,23900,23460,23760,23660,45,-55,137962,"1,632,131.25",190390
,20180503,23760,23660,23630,23700,23460,23600,23585,-60,-75,197814,"2,333,069.01",200740
,20180504,23600,23585,23505,23535,23005,23165,23230,-420,-355,306040,"3,555,267.79",229418
,20180507,23165,23230,23050,23835,23010,23830,23470,600,240,347162,"4,074,163.33",223496
,20180508,23830,23470,23840,23950,23720,23815,23810,345,340,274496,"3,268,381.32",227258
,20180509,23815,23810,23675,23865,23495,23700,23715,-110,-95,387528,"4,595,233.26",238654
,20180510,23700,23715,23780,23890,23670,23740,23780,25,65,338556,"4,025,895.28",246590
,20180511,23740,23780,23830,23880,23585,23695,23700,-85,-80,359644,"4,262,590.99",257842
,20180514,23695,23700,23745,23820,23515,23555,23665,-145,-35,392822,"4,648,160.61",273772
,20180515,23555,23665,23480,23795,23450,23780,23640,115,-25,431270,"5,098,439.04",251006
,20180516,23780,23640,23695,23980,23630,23780,23790,140,150,437748,"5,207,535.58",239976
,20180517,23780,23790,23745,23930,23530,23570,23755,-220,-35,345628,"4,105,706.96",246112
,20180518,23570,23755,23590,23820,23560,23725,23700,-30,-55,320408,"3,797,176.22",242604
,20180521,23725,23700,23705,24080,23645,23955,23900,255,200,404658,"4,835,862.23",250458
,20180522,23955,23900,24005,24045,23580,23585,23825,-315,-75,337590,"4,022,170.71",247268
,20180523,23585,23825,23630,23730,23505,23605,23615,-220,-210,309572,"3,655,855.08",243830
,20180524,23605,23615,23535,23580,23285,23435,23410,-180,-205,398818,"4,668,792.65",251668
,20180525,23435,23410,23385,23700,23350,23690,23535,280,125,314782,"3,704,655.71",246308
,20180528,23690,23535,23685,23920,23540,23900,23765,365,230,356272,"4,233,440.44",235742
,20180529,23900,23765,23905,24180,23825,24110,23995,345,230,365982,"4,391,498.73",223686
,20180530,24110,23995,24060,24240,23885,23960,24065,-35,70,333422,"4,011,908.96",210004
,20180531,23960,24065,24075,24465,24050,24420,24335,355,270,475852,"5,790,931.26",200172
zn1808,20180102,25580,25465,25645,25710,25595,25595,25665,130,200,10,128.33,372
,20180103,25595,25665,25710,25730,25540,25540,25695,-125,30,20,256.98,386
,20180104,25540,25695,25555,25750,25550,25750,25575,55,-120,16,204.63,386
,20180105,25750,25575,25830,25860,25810,25810,25830,235,255,10,129.17,392
,20180108,25810,25830,25860,25860,25820,25820,25840,-10,10,6,77.53,392
,20180109,25820,25840,25875,26120,25875,26120,26020,280,180,26,338.28,394
,20180110,26120,26020,26020,26070,25910,25930,25995,-90,-25,20,259.97,394
,20180111,25930,25995,25940,26045,25925,26000,25985,5,-10,62,805.59,406
,20180112,26000,25985,25740,26195,25740,26145,25980,160,-5,156,"2,026.71",374
,20180115,26145,25980,26090,26195,26020,26195,26070,215,90,74,964.59,400
,20180116,26195,26070,26120,26135,25785,25900,25875,-170,-195,144,"1,863.11",408
,20180117,25900,25875,25815,25925,25740,25805,25835,-70,-40,116,"1,498.49",392
,20180118,25805,25835,25865,25865,25760,25760,25820,-75,-15,34,438.95,400
,20180119,25760,25820,25820,25820,25735,25735,25770,-85,-50,12,154.64,392
,20180122,25735,25770,25925,25975,25840,25970,25920,200,150,78,"1,010.94",412
,20180123,25970,25920,25905,25920,25830,25920,25900,0,-20,32,414.46,432
,20180124,25920,25900,25935,25995,25650,25650,25900,-250,0,28,362.62,428
,20180125,25650,25900,25725,26050,25720,26015,25980,115,80,106,"1,377.00",446
,20180126,26015,25980,26015,26030,25880,25935,25950,-45,-30,48,622.88,460
,20180129,25935,25950,26010,26760,25920,26640,26595,690,645,626,"8,324.42",662
,20180130,26640,26595,26680,26730,26305,26345,26460,-250,-135,210,"2,778.81",738
,20180131,26345,26460,26180,26460,26180,26405,26310,-55,-150,202,"2,657.45",664
,20180201,26405,26310,26395,26420,26255,26270,26350,-40,40,36,474.31,670
,20180202,26270,26350,26435,26480,26385,26440,26415,90,65,34,449.10,670
,20180205,26440,26415,26305,26375,26195,26375,26315,-40,-100,114,"1,500.13",648
,20180206,26375,26315,26430,26540,26035,26080,26275,-235,-40,628,"8,251.14",1028
,20180207,26080,26275,26175,26270,26080,26140,26220,-135,-55,488,"6,398.79",1406
,20180208,26140,26220,26100,26110,25750,25875,25870,-345,-350,210,"2,716.84",1458
,20180209,25875,25870,25950,26080,25735,25795,25990,-75,120,124,"1,611.58",1456
,20180212,25795,25990,25860,25940,25630,25655,25765,-335,-225,276,"3,556.12",1430
,20180213,25655,25765,25700,26020,25665,25985,25810,220,45,738,"9,524.23",1520
,20180214,25985,25810,26015,26380,25985,26320,26215,510,405,174,"2,280.79",1416
,20180222,26320,26215,26620,26625,26005,26130,26290,-85,75,88,"1,156.80",1436
,20180223,26130,26290,26170,26430,26170,26400,26325,110,35,92,"1,211.04",1452
,20180226,26400,26325,26350,26490,26235,26490,26435,165,110,630,"8,327.33",1664
,20180227,26490,26435,26520,26555,26430,26490,26485,55,50,1694,"22,434.63",2594
,20180228,26490,26485,26400,26400,26145,26245,26235,-240,-250,2138,"28,049.36",4376
,20180301,26245,26235,26215,26300,26095,26275,26220,40,-15,604,"7,919.35",4734
,20180302,26275,26220,25985,26140,25955,26100,26045,-120,-175,1752,"22,819.24",6050
,20180305,26100,26045,26000,26100,25490,25520,25850,-525,-195,2394,"30,944.97",6416
,20180306,25520,25850,25445,25445,25020,25260,25170,-590,-680,978,"12,310.57",6504
,20180307,25260,25170,25360,25415,25120,25120,25270,-50,100,934,"11,802.11",6752
,20180308,25120,25270,25120,25220,24905,24935,25065,-335,-205,734,"9,200.60",6802
,20180309,24935,25065,24930,24950,24285,24390,24565,-675,-500,3436,"42,210.73",7720
,20180312,24390,24565,24470,25050,24470,24755,24785,190,220,2126,"26,349.42",8230
,20180313,24755,24785,24745,24980,24640,24870,24840,85,55,1560,"19,378.74",8672
,20180314,24870,24840,24945,25055,24835,24960,24960,120,120,1806,"22,539.13",9422
,20180315,24960,24960,24930,24950,24480,24675,24645,-285,-315,2242,"27,629.44",9670
,20180316,24675,24645,24620,24835,24470,24750,24700,105,55,2482,"30,653.07",9820
,20180319,24750,24700,24915,24940,24590,24645,24770,-55,70,2062,"25,541.44",10024
,20180320,24645,24770,24660,24815,24460,24595,24655,-175,-115,3186,"39,277.81",10870
,20180321,24595,24655,24630,24800,24145,24265,24320,-390,-335,6240,"75,887.90",12940
,20180322,24265,24320,24340,24815,24330,24660,24535,340,215,7258,"89,050.30",14392
,20180323,24660,24535,24485,24600,23970,24460,24315,-75,-220,5420,"65,904.71",14612
,20180326,24460,24315,24480,24545,24070,24380,24370,65,55,5428,"66,143.11",15134
,20180327,24380,24370,24465,24840,24445,24715,24705,345,335,4126,"50,969.55",15076
,20180328,24715,24705,24715,24795,24525,24570,24650,-135,-55,5512,"67,937.73",15340
,20180329,24570,24650,24645,24760,24440,24760,24595,110,-55,5622,"69,138.85",16102
,20180330,24760,24595,24795,24840,24480,24730,24675,135,80,4878,"60,191.08",16112
,20180402,24730,24675,24760,25065,24720,24750,24845,75,170,4988,"61,968.33",16562
,20180403,24750,24845,24735,24830,24485,24525,24675,-320,-170,4302,"53,082.29",17278
,20180404,24525,24675,24610,24655,24350,24370,24460,-305,-215,5980,"73,144.25",18090
,20180409,24370,24460,24410,24590,24005,24165,24150,-295,-310,15524,"187,453.98",21728
,20180410,24165,24150,24105,24410,24055,24340,24230,190,80,13128,"159,077.80",23350
,20180411,24340,24230,24440,24495,24170,24395,24325,165,95,16166,"196,626.65",25144
,20180412,24395,24325,24360,24385,23230,23420,23655,-905,-670,27630,"326,860.56",29764
,20180413,23420,23655,23345,23470,23060,23320,23285,-335,-370,21394,"249,112.98",31662
,20180416,23320,23285,23335,23565,22975,23465,23345,180,60,31442,"367,027.95",32494
,20180417,23465,23345,23515,23565,23275,23435,23425,90,80,20178,"236,354.70",37642
,20180418,23435,23425,23440,23795,23375,23665,23630,240,205,23250,"274,725.48",38220
,20180419,23665,23630,24005,24705,23970,24315,24335,685,705,34446,"419,148.16",38556
,20180420,24315,24335,24105,24270,23935,24160,24110,-175,-225,36100,"435,234.16",47956
,20180423,24160,24110,24225,24405,24075,24285,24270,175,160,17564,"213,152.95",47922
,20180424,24285,24270,24065,24370,23935,24210,24225,-60,-45,20502,"248,371.27",50994
,20180425,24210,24225,24325,24350,23935,23950,24185,-275,-40,24222,"292,962.71",56370
,20180426,23950,24185,23860,23980,23415,23490,23655,-695,-530,30730,"363,460.26",62156
,20180427,23490,23655,23420,23760,23420,23710,23630,55,-25,36500,"431,280.94",67460
,20180502,23710,23630,23350,23805,23350,23640,23580,10,-50,33042,"389,645.43",67968
,20180503,23640,23580,23515,23600,23375,23520,23485,-60,-95,48646,"571,282.98",65390
,20180504,23520,23485,23455,23455,22935,23085,23130,-400,-355,43700,"505,451.92",67960
,20180507,23085,23130,22940,23770,22930,23735,23405,605,275,64380,"753,478.39",65356
,20180508,23735,23405,23775,23890,23665,23760,23765,355,360,50484,"599,956.96",71290
,20180509,23760,23765,23620,23800,23425,23635,23655,-130,-110,43342,"512,703.44",72242
,20180510,23635,23655,23700,23820,23615,23680,23715,25,60,34790,"412,591.39",74542
,20180511,23680,23715,23725,23810,23520,23640,23640,-75,-75,28616,"338,283.64",74196
,20180514,23640,23640,23700,23760,23450,23500,23585,-140,-55,33174,"391,285.29",76636
,20180515,23500,23585,23435,23730,23405,23725,23575,140,-10,46126,"543,730.88",75700
,20180516,23725,23575,23660,23910,23560,23720,23715,145,140,51356,"609,032.28",73274
,20180517,23720,23715,23680,23865,23460,23505,23695,-210,-20,49698,"588,812.12",70898
,20180518,23505,23695,23500,23745,23480,23650,23620,-45,-75,43242,"510,702.77",73948
,20180521,23650,23620,23600,23995,23570,23895,23840,275,220,50406,"600,846.09",76100
,20180522,23895,23840,23905,24010,23505,23515,23760,-325,-80,46708,"554,924.25",80608
,20180523,23515,23760,23520,23645,23350,23515,23535,-245,-225,52568,"618,632.20",84988
,20180524,23515,23535,23420,23475,23175,23345,23305,-190,-230,91548,"1,066,881.41",94324
,20180525,23345,23305,23320,23580,23260,23570,23425,265,120,70506,"825,908.34",98644
,20180528,23570,23425,23585,23780,23405,23745,23625,320,200,89792,"1,060,871.14",112628
,20180529,23745,23625,23680,24050,23655,23975,23865,350,240,112960,"1,347,996.33",122474
,20180530,23975,23865,23925,24075,23715,23800,23900,-65,35,109458,"1,308,105.47",123188
,20180531,23800,23900,23920,24300,23880,24250,24170,350,270,160374,"1,938,201.83",138652
zn1809,20180102,25470,25440,25750,25750,25460,25635,25575,195,135,24,306.95,492
,20180103,25635,25575,25690,25690,25460,25460,25620,-115,45,54,691.77,474
,20180104,25460,25620,25540,25750,25385,25750,25600,130,-20,80,"1,024.01",514
,20180105,25750,25600,25775,25855,25675,25855,25755,255,155,132,"1,699.87",546
,20180108,25855,25755,25805,25810,25705,25810,25755,55,0,58,746.99,540
,20180109,25810,25755,25835,26100,25785,25815,26000,60,245,182,"2,366.37",600
,20180110,25815,26000,25740,26055,25740,25850,25885,-150,-115,194,"2,511.13",578
,20180111,25850,25885,25925,26010,25885,25970,25920,85,35,60,777.62,580
,20180112,25970,25920,26025,26095,25880,26095,26020,175,100,116,"1,509.39",640
,20180115,26095,26020,26025,26125,25960,26110,26040,90,20,70,911.41,642
,20180116,26110,26040,26080,26080,25695,25785,25850,-255,-190,290,"3,748.71",714
,20180117,25785,25850,25790,25855,25705,25765,25770,-85,-80,146,"1,881.49",734
,20180118,25765,25770,25735,25785,25655,25695,25720,-75,-50,78,"1,003.16",756
,20180119,25695,25720,25730,25835,25630,25835,25720,115,0,52,668.83,768
,20180122,25835,25720,25940,25940,25795,25920,25865,200,145,130,"1,681.39",760
,20180123,25920,25865,25850,25915,25790,25915,25820,50,-45,44,568.05,778
,20180124,25915,25820,25875,25875,25550,25550,25715,-270,-105,36,462.88,774
,20180125,25550,25715,25680,26020,25680,26020,25860,305,145,94,"1,215.46",752
,20180126,26020,25860,25940,25950,25805,25875,25875,15,15,48,621.04,752
,20180129,25875,25875,25925,26690,25880,26555,26490,680,615,354,"4,688.81",868
,20180130,26555,26490,26620,26620,26245,26385,26425,-105,-65,104,"1,374.25",852
,20180131,26385,26425,26395,26400,26120,26325,26240,-100,-185,72,944.66,826
,20180201,26325,26240,26315,26360,26200,26220,26270,-20,30,38,499.17,838
,20180202,26220,26270,26265,26395,26245,26375,26330,105,60,50,658.31,834
,20180205,26375,26330,26315,26355,26100,26275,26215,-55,-115,98,"1,284.74",806
,20180206,26275,26215,26425,26475,25935,26030,26150,-185,-65,156,"2,039.98",832
,20180207,26030,26150,26010,26190,25935,26030,26080,-120,-70,126,"1,643.09",836
,20180208,26030,26080,26020,26020,25645,25850,25830,-230,-250,138,"1,782.53",780
,20180209,25850,25830,25805,25980,25700,25730,25810,-100,-20,98,"1,264.81",782
,20180212,25730,25810,25750,25850,25535,25705,25690,-105,-120,214,"2,748.91",808
,20180213,25705,25690,25650,25945,25580,25905,25695,215,5,318,"4,085.59",762
,20180214,25905,25695,25850,26265,25850,26210,26155,515,460,156,"2,040.36",814
,20180222,26210,26155,26350,26525,25870,26060,26240,-95,85,526,"6,901.78",1024
,20180223,26060,26240,26085,26365,26050,26310,26255,70,15,220,"2,888.20",1044
,20180226,26310,26255,26260,26400,26080,26390,26280,135,25,372,"4,888.21",1168
,20180227,26390,26280,26335,26450,26330,26420,26390,140,110,230,"3,035.28",1222
,20180228,26420,26390,26365,26365,26105,26180,26200,-210,-190,230,"3,013.12",1198
,20180301,26180,26200,26135,26230,26030,26165,26155,-35,-45,270,"3,531.55",1274
,20180302,26165,26155,25850,26135,25785,26095,25955,-60,-200,400,"5,191.85",1248
,20180305,26095,25955,25915,26005,25420,25515,25745,-440,-210,502,"6,462.00",1206
,20180306,25515,25745,25440,25440,24960,25160,25140,-585,-605,694,"8,724.66",1222
,20180307,25160,25140,25255,25330,25045,25100,25215,-40,75,276,"3,480.34",1246
,20180308,25100,25215,25130,25145,24835,24845,25010,-370,-205,378,"4,727.50",1368
,20180309,24845,25010,24800,24905,24215,24310,24560,-700,-450,918,"11,274.84",1438
,20180312,24310,24560,24410,25010,24410,24735,24710,175,150,866,"10,700.14",1648
,20180313,24735,24710,24710,24890,24575,24800,24775,90,65,694,"8,597.04",1580
,20180314,24800,24775,24895,24995,24785,24895,24880,120,105,1116,"13,885.82",1886
,20180315,24895,24880,24850,24870,24290,24565,24570,-315,-310,1060,"13,024.02",1658
,20180316,24565,24570,24555,24730,24400,24690,24625,120,55,638,"7,856.68",1648
,20180319,24690,24625,24780,24820,24550,24575,24660,-50,35,528,"6,511.30",1750
,20180320,24575,24660,24685,24765,24425,24550,24560,-110,-100,1188,"14,591.30",2088
,20180321,24550,24560,24540,24540,24080,24200,24245,-360,-315,1860,"22,549.14",2398
,20180322,24200,24245,24290,24740,24270,24585,24445,340,200,1920,"23,469.95",2928
,20180323,24585,24445,24485,24525,23880,24350,24280,-95,-165,2206,"26,785.59",3322
,20180326,24350,24280,24490,24490,24010,24315,24280,35,0,1878,"22,802.72",3340
,20180327,24315,24280,24380,24750,24380,24620,24610,340,330,3222,"39,647.61",3234
,20180328,24620,24610,24685,24710,24430,24505,24560,-105,-50,2272,"27,904.12",3420
,20180329,24505,24560,24595,24675,24365,24675,24500,115,-60,1538,"18,841.00",3438
,20180330,24675,24500,24675,24745,24395,24660,24600,160,100,1642,"20,200.24",3532
,20180402,24660,24600,24670,24980,24630,24680,24755,80,155,2366,"29,289.70",3650
,20180403,24680,24755,24665,24740,24405,24500,24605,-255,-150,1608,"19,785.46",3860
,20180404,24500,24605,24500,24580,24280,24315,24385,-290,-220,2122,"25,874.47",3932
,20180409,24315,24385,24310,24535,23930,24080,24045,-305,-340,4374,"52,591.02",5206
,20180410,24080,24045,24130,24315,23975,24245,24120,200,75,3152,"38,019.84",5244
,20180411,24245,24120,24250,24415,24080,24305,24260,185,140,2716,"32,945.65",5568
,20180412,24305,24260,24235,24305,23150,23350,23590,-910,-670,8510,"100,379.77",7564
,20180413,23350,23590,23275,23385,22975,23265,23225,-325,-365,7982,"92,701.64",8136
,20180416,23265,23225,23260,23490,22905,23385,23245,160,20,13518,"157,121.08",12256
,20180417,23385,23245,23400,23480,23195,23330,23340,85,95,9070,"105,853.60",15296
,20180418,23330,23340,23310,23720,23300,23590,23530,250,190,6964,"81,943.88",14914
,20180419,23590,23530,23930,24940,23915,24215,24270,685,740,13478,"163,573.75",15584
,20180420,24215,24270,24030,24190,23865,24095,24050,-175,-220,13402,"161,169.61",19566
,20180423,24095,24050,24110,24330,24005,24230,24190,180,140,6372,"77,073.44",19824
,20180424,24230,24190,23845,24300,23845,24145,24145,-45,-45,6510,"78,602.62",20352
,20180425,24145,24145,24165,24270,23860,23875,24120,-270,-25,7944,"95,806.07",20840
,20180426,23875,24120,23810,23915,23350,23390,23610,-730,-510,10562,"124,689.75",21124
,20180427,23390,23610,23335,23680,23335,23630,23560,20,-50,11988,"141,233.30",22504
,20180502,23630,23560,23510,23725,23285,23585,23490,25,-70,8934,"104,931.15",22258
,20180503,23585,23490,23485,23525,23300,23410,23405,-80,-85,15942,"186,578.51",25094
,20180504,23410,23405,23350,23355,22875,22995,23065,-410,-340,17416,"200,860.83",27408
,20180507,22995,23065,22895,23725,22850,23700,23345,635,280,22842,"266,652.56",25784
,20180508,23700,23345,23715,23835,23605,23705,23705,360,360,16056,"190,328.59",27854
,20180509,23705,23705,23550,23740,23370,23570,23595,-135,-110,16538,"195,119.20",28364
,20180510,23570,23595,23630,23750,23565,23610,23655,15,60,14712,"174,040.92",30258
,20180511,23610,23655,23720,23755,23460,23560,23565,-95,-90,18562,"218,726.89",31426
,20180514,23560,23565,23590,23685,23400,23440,23520,-125,-45,15058,"177,106.47",32300
,20180515,23440,23520,23355,23670,23350,23670,23530,150,10,19446,"228,805.31",32682
,20180516,23670,23530,23610,23845,23500,23650,23655,120,125,15758,"186,399.81",33088
,20180517,23650,23655,23645,23805,23390,23440,23610,-215,-45,22714,"268,140.78",33014
,20180518,23440,23610,23405,23680,23405,23580,23555,-30,-55,15792,"185,994.46",32710
,20180521,23580,23555,23545,23925,23505,23845,23775,290,220,19746,"234,758.72",33278
,20180522,23845,23775,23860,23900,23450,23455,23680,-320,-95,20170,"238,845.91",35720
,20180523,23455,23680,23530,23585,23360,23450,23470,-230,-210,24612,"288,846.64",36376
,20180524,23450,23470,23320,23400,23080,23240,23220,-230,-250,32106,"372,780.22",41994
,20180525,23240,23220,23340,23485,23170,23480,23365,260,145,21148,"247,066.14",43068
,20180528,23480,23365,23485,23680,23310,23655,23520,290,155,21674,"254,935.91",44092
,20180529,23655,23520,23580,23910,23550,23845,23745,325,225,34832,"413,550.25",47796
,20180530,23845,23745,23860,23970,23595,23660,23755,-85,10,32326,"383,994.60",49606
,20180531,23660,23755,23800,24180,23765,24140,24040,385,285,47136,"566,640.43",53324
zn1810,20180102,25460,25380,25525,25760,25430,25595,25575,215,195,32,409.27,494
,20180103,25595,25575,25620,25620,25410,25410,25580,-165,5,50,639.53,508
,20180104,25410,25580,25465,25700,25375,25700,25615,120,35,54,691.71,514
,20180105,25700,25615,25750,25800,25705,25790,25740,175,125,30,386.12,516
,20180108,25790,25740,25715,25750,25655,25750,25710,10,-30,16,205.70,516
,20180109,25750,25710,25885,26050,25845,25975,25955,265,245,28,363.44,530
,20180110,25975,25955,25925,25955,25755,25755,25865,-200,-90,36,465.64,526
,20180111,25755,25865,25865,25950,25820,25930,25860,65,-5,38,491.40,536
,20180112,25930,25860,25970,26030,25795,25990,25940,130,80,50,648.51,558
,20180115,25990,25940,25960,26090,25900,26060,26010,120,70,46,598.27,556
,20180116,26060,26010,26050,26050,25635,25755,25750,-255,-260,266,"3,425.26",670
,20180117,25755,25750,25785,25785,25650,25685,25715,-65,-35,98,"1,260.24",708
,20180118,25685,25715,25625,25665,25625,25650,25645,-65,-70,28,359.08,712
,20180119,25650,25645,25700,25710,25570,25570,25630,-75,-15,38,487.00,718
,20180122,25570,25630,26880,26880,24635,25815,25780,185,150,28,360.95,724
,20180123,25815,25780,25775,25850,25620,25835,25740,55,-40,44,566.38,730
,20180124,25835,25740,25760,25790,25565,25565,25745,-175,5,42,540.75,722
,20180125,25565,25745,25635,25960,25605,25900,25820,155,75,96,"1,239.46",718
,20180126,25900,25820,25895,25925,25750,25750,25815,-70,-5,42,542.13,710
,20180129,25750,25815,25910,26610,25795,26445,26410,630,595,192,"2,535.57",774
,20180130,26445,26410,26460,26460,26260,26260,26375,-150,-35,12,158.28,774
,20180131,26260,26375,26275,26275,26075,26075,26185,-300,-190,60,785.70,780
,20180201,26075,26185,26210,26235,26145,26150,26175,-35,-10,10,130.89,780
,20180202,26150,26175,26255,26280,26255,26280,26265,105,90,8,105.06,778
,20180205,26280,26265,26220,26235,26105,26175,26175,-90,-90,14,183.26,780
,20180206,26175,26175,26325,26325,25925,25955,26100,-220,-75,44,574.28,786
,20180207,25955,26100,25925,26080,25920,25920,25970,-180,-130,16,207.80,782
,20180208,25920,25970,25925,25925,25635,25750,25730,-220,-240,54,694.76,740
,20180209,25750,25730,25950,25960,25480,25480,25735,-250,5,30,386.04,730
,20180212,25480,25735,25465,25735,25400,25420,25620,-315,-115,68,871.16,778
,20180213,25420,25620,25580,25780,25530,25780,25595,160,-25,10,127.99,776
,20180214,25780,25595,25880,26150,25880,26100,26060,505,465,16,208.49,786
,20180222,26100,26060,26270,26270,25805,25985,25995,-75,-65,30,389.96,778
,20180223,25985,25995,25990,26275,25990,26130,26170,135,175,18,235.53,782
,20180226,26130,26170,26120,26285,26015,26245,26170,75,0,80,"1,046.81",814
,20180227,26245,26170,26280,26315,26235,26315,26285,145,115,28,368.02,830
,20180228,26315,26285,26110,26205,25600,26070,26045,-215,-240,80,"1,041.82",832
,20180301,26070,26045,25985,26200,25985,26140,26130,95,85,22,287.45,828
,20180302,26140,26130,25930,25970,25790,25915,25875,-215,-255,66,853.93,840
,20180305,25915,25875,25860,25900,25400,25400,25775,-475,-100,52,670.21,804
,20180306,25400,25775,25350,25350,24955,25130,25060,-645,-715,136,"1,704.35",754
,20180307,25130,25060,25195,25195,25005,25005,25125,-55,65,34,427.18,768
,20180308,25005,25125,25005,25050,24800,24845,24950,-280,-175,52,648.72,748
,20180309,24845,24950,24770,24825,24340,24340,24670,-610,-280,88,"1,085.65",746
,20180312,24340,24670,24345,24950,24345,24670,24660,0,-10,46,567.18,746
,20180313,24670,24660,24625,24805,24625,24675,24730,15,70,94,"1,162.33",772
,20180314,24675,24730,24470,24890,24470,24770,24665,40,-65,140,"1,726.66",732
,20180315,24770,24665,24780,24780,24385,24400,24500,-265,-165,34,416.56,738
,20180316,24400,24500,24510,24650,24445,24635,24540,135,40,68,834.48,750
,20180319,24635,24540,24750,24750,24440,24455,24610,-85,70,34,418.43,752
,20180320,24455,24610,24595,24610,24325,24595,24450,-15,-160,62,758.01,762
,20180321,24595,24450,24295,24320,24015,24120,24145,-330,-305,94,"1,134.83",748
,20180322,24120,24145,24240,24540,24240,24530,24385,385,240,76,926.64,764
,20180323,24530,24385,24450,24450,23965,24200,24160,-185,-225,204,"2,464.67",836
,20180326,24200,24160,24235,24325,23995,24080,24195,-80,35,140,"1,693.72",846
,20180327,24080,24195,24080,24655,24080,24575,24450,380,255,322,"3,937.07",802
,20180328,24575,24450,24575,24605,24385,24385,24485,-65,35,114,"1,395.76",824
,20180329,24385,24485,24410,24540,24285,24540,24400,55,-85,128,"1,561.87",792
,20180330,24540,24400,24565,24600,24440,24540,24540,140,140,106,"1,300.67",840
,20180402,24540,24540,24310,24920,24310,24530,24555,-10,15,186,"2,284.04",814
,20180403,24530,24555,24590,24655,24285,24285,24440,-270,-115,226,"2,762.09",874
,20180404,24285,24440,24200,24490,24150,24240,24300,-200,-140,220,"2,673.30",872
,20180409,24240,24300,24185,24185,23845,24020,23905,-280,-395,210,"2,510.16",848
,20180410,24020,23905,24020,24220,23890,24200,24110,295,205,200,"2,411.27",852
,20180411,24200,24110,24180,24275,24030,24160,24135,50,25,80,965.52,854
,20180412,24160,24135,24100,24100,23085,23255,23420,-880,-715,258,"3,021.74",842
,20180413,23255,23420,23155,23290,22885,23165,23135,-255,-285,234,"2,707.26",832
,20180416,23165,23135,23175,23385,22975,23290,23190,155,55,162,"1,878.71",828
,20180417,23290,23190,23280,23390,23140,23210,23250,20,60,130,"1,511.33",818
,20180418,23210,23250,23195,23630,23190,23515,23480,265,230,254,"2,982.04",826
,20180419,23515,23480,23880,24510,23880,24140,24165,660,685,592,"7,152.94",722
,20180420,24140,24165,23970,24100,23810,24010,23965,-155,-200,332,"3,978.72",638
,20180423,24010,23965,24055,24225,23935,24145,24115,180,150,194,"2,339.18",658
,20180424,24145,24115,23880,24220,23820,24070,24050,-45,-65,136,"1,635.61",664
,20180425,24070,24050,24070,24175,23830,23830,24035,-220,-15,130,"1,562.57",660
,20180426,23830,24035,23820,23820,23290,23340,23545,-695,-490,308,"3,626.19",690
,20180427,23340,23545,23340,23595,23325,23505,23485,-40,-60,252,"2,959.41",722
,20180502,23505,23485,23365,23635,23230,23485,23435,0,-50,268,"3,140.31",782
,20180503,23485,23435,23380,23425,23245,23360,23345,-75,-90,508,"5,930.78",796
,20180504,23360,23345,23210,23210,22810,22930,23050,-415,-295,656,"7,561.48",912
,20180507,22930,23050,22805,23640,22805,23640,23290,590,240,1810,"21,081.29",1504
,20180508,23640,23290,23600,23770,23550,23635,23655,345,365,774,"9,156.14",1742
,20180509,23635,23655,23550,23665,23330,23495,23575,-160,-80,2654,"31,288.47",3128
,20180510,23495,23575,23565,23665,23490,23565,23595,-10,20,1024,"12,081.73",3264
,20180511,23565,23595,23660,23670,23400,23515,23515,-80,-80,718,"8,442.03",3208
,20180514,23515,23515,23530,23615,23345,23390,23510,-125,-5,572,"6,723.99",3250
,20180515,23390,23510,23330,23585,23310,23560,23455,50,-55,596,"6,989.96",3264
,20180516,23560,23455,23515,23775,23440,23600,23605,145,150,1328,"15,674.81",3468
,20180517,23600,23605,23600,23725,23345,23385,23525,-220,-80,962,"11,315.99",3552
,20180518,23385,23525,23390,23615,23375,23510,23505,-15,-20,1478,"17,370.60",3532
,20180521,23510,23505,23530,23870,23450,23765,23695,260,190,1150,"13,627.22",3532
,20180522,23765,23695,23815,23815,23390,23395,23585,-300,-110,1956,"23,070.20",3686
,20180523,23395,23585,23430,23520,23300,23380,23405,-205,-180,1190,"13,928.03",3750
,20180524,23380,23405,23315,23350,23035,23185,23165,-220,-240,3460,"40,083.62",4856
,20180525,23185,23165,23150,23415,23125,23415,23285,250,120,2896,"33,720.22",5198
,20180528,23415,23285,23430,23595,23245,23565,23465,280,180,2868,"33,649.20",5426
,20180529,23565,23465,23590,23815,23465,23765,23655,300,190,4912,"58,108.26",7274
,20180530,23765,23655,23730,23870,23520,23600,23660,-55,5,4706,"55,675.51",8634
,20180531,23600,23660,23690,24090,23675,24065,23970,405,310,3342,"40,055.29",9116
zn1811,20180102,25395,25375,25685,25685,25510,25510,25625,135,250,6,76.88,162
,20180103,25510,25625,25585,25585,25585,25585,25585,-40,-40,2,25.59,162
,20180104,25585,25585,25470,25625,25405,25625,25465,40,-120,30,382.03,158
,20180105,25625,25465,25700,25700,25625,25640,25660,175,195,18,230.98,172
,20180108,25640,25660,25695,25695,25615,25615,25655,-45,-5,4,51.31,172
,20180109,25615,25655,25995,26000,25925,26000,25975,345,320,8,103.91,180
,20180110,26000,25975,25895,25895,25800,25800,25845,-175,-130,4,51.70,176
,20180111,25800,25845,25810,25930,25810,25930,25825,85,-20,26,335.74,186
,20180112,25930,25825,25935,25965,25895,25965,25920,140,95,10,129.62,192
,20180115,25965,25920,25875,26040,25875,26035,25960,115,40,22,285.58,198
,20180116,26035,25960,25980,25980,25605,25610,25690,-350,-270,92,"1,181.80",222
,20180117,25610,25690,25615,25670,25595,25595,25635,-95,-55,12,153.82,220
,20180118,25595,25635,25615,25615,25615,25615,25615,-20,-20,6,76.85,216
,20180119,25615,25615,25570,25570,25570,25570,25570,-45,-45,6,76.71,220
,20180122,25570,25570,25770,25770,25625,25710,25710,140,140,24,308.57,224
,20180123,25710,25710,25755,25755,25735,25750,25745,40,35,8,102.99,226
,20180124,25750,25745,25765,25765,25475,25475,25695,-270,-50,28,359.74,238
,20180125,25475,25695,25815,25930,25815,25905,25870,210,175,22,284.62,248
,20180126,25905,25870,,,,25870,25870,0,0,0,0.00,248
,20180129,25870,25870,25950,26530,25950,26435,26385,565,515,180,"2,374.82",302
,20180130,26435,26385,26415,26415,26100,26100,26255,-285,-130,4,52.52,300
,20180131,26100,26255,26020,26180,26020,26180,26100,-75,-155,4,52.20,298
,20180201,26180,26100,,,,26100,26100,0,0,0,0.00,298
,20180202,26100,26100,26220,26220,26210,26210,26215,110,115,4,52.43,296
,20180205,26210,26215,26120,26120,26005,26045,26055,-170,-160,6,78.17,294
,20180206,26045,26055,25850,25850,25810,25845,25820,-210,-235,16,206.59,300
,20180207,25845,25820,25865,26000,25850,25925,25940,105,120,18,233.50,300
,20180208,25925,25940,25820,25820,25585,25620,25710,-320,-230,16,205.68,286
,20180209,25620,25710,25855,25855,25465,25575,25580,-135,-130,20,255.82,280
,20180212,25575,25580,25365,25630,25310,25490,25535,-90,-45,58,740.53,296
,20180213,25490,25535,25485,25680,25485,25680,25580,145,45,4,51.17,296
,20180214,25680,25580,25800,26065,25760,26000,25945,420,365,20,259.46,302
,20180222,26000,25945,26020,26020,25720,25820,25905,-125,-40,22,285.00,300
,20180223,25820,25905,26055,26120,26035,26085,26065,180,160,16,208.55,306
,20180226,26085,26065,25955,25955,25955,25955,25955,-110,-110,8,103.82,312
,20180227,25955,25955,26160,26200,26145,26180,26175,225,220,18,235.62,320
,20180228,26180,26175,26100,26100,25905,26000,26005,-175,-170,38,494.10,336
,20180301,26000,26005,25910,26045,25910,26010,25970,5,-35,68,883.02,380
,20180302,26010,25970,25725,25835,25725,25835,25785,-135,-185,34,438.39,388
,20180305,25835,25785,25845,25850,25445,25445,25690,-340,-95,22,282.64,386
,20180306,25445,25690,25050,25190,24890,25075,25010,-615,-680,192,"2,401.24",358
,20180307,25075,25010,25070,25150,24935,24935,25070,-75,60,30,376.11,358
,20180308,24935,25070,24905,24905,24720,24750,24795,-320,-275,48,595.11,358
,20180309,24750,24795,24745,24745,24155,24155,24615,-640,-180,36,443.15,358
,20180312,24155,24615,24225,24635,24225,24600,24510,-15,-105,92,"1,127.59",396
,20180313,24600,24510,24590,24665,24470,24635,24555,125,45,62,761.33,398
,20180314,24635,24555,24700,24840,24660,24740,24715,185,160,34,420.21,410
,20180315,24740,24715,24655,24670,24260,24350,24420,-365,-295,34,415.21,406
,20180316,24350,24420,24320,24570,24320,24570,24490,150,70,98,"1,200.02",428
,20180319,24570,24490,24580,24580,24385,24385,24490,-105,0,20,244.94,442
,20180320,24385,24490,24535,24535,24250,24470,24420,-20,-70,26,317.48,448
,20180321,24470,24420,24130,24130,23980,24050,24030,-370,-390,148,"1,778.58",504
,20180322,24050,24030,24140,24525,24140,24495,24335,465,305,74,900.55,498
,20180323,24495,24335,24350,24350,24010,24275,24205,-60,-130,54,653.66,540
,20180326,24275,24205,24300,24335,23820,24250,24205,45,0,226,"2,735.72",518
,20180327,24250,24205,24310,24540,24305,24455,24430,250,225,120,"1,466.08",506
,20180328,24455,24430,24475,24525,24265,24265,24370,-165,-60,158,"1,925.53",556
,20180329,24265,24370,24040,24500,24040,24500,24295,130,-75,318,"3,863.45",506
,20180330,24500,24295,24500,24515,24270,24460,24425,165,130,88,"1,074.71",506
,20180402,24460,24425,24700,24770,24465,24510,24600,85,175,248,"3,050.47",502
,20180403,24510,24600,24465,24560,24265,24270,24435,-330,-165,42,513.19,522
,20180404,24270,24435,24315,24355,24110,24155,24190,-280,-245,18,217.75,524
,20180409,24155,24190,24100,24100,23775,23885,23840,-305,-350,128,"1,525.90",524
,20180410,23885,23840,23865,24070,23795,24070,23885,230,45,74,883.83,526
,20180411,24070,23885,24035,24120,24010,24055,24045,170,160,36,432.87,538
,20180412,24055,24045,23965,24010,23000,23205,23345,-840,-700,84,980.65,508
,20180413,23205,23345,23055,23290,22900,23055,23155,-290,-190,264,"3,056.88",578
,20180416,23055,23155,23090,23260,22750,23080,23165,-75,10,132,"1,528.96",598
,20180417,23080,23165,22980,23320,22980,23200,23145,35,-20,194,"2,245.07",542
,20180418,23200,23145,23200,23490,23200,23430,23375,285,230,42,490.96,556
,20180419,23430,23375,23970,24360,23945,24160,24070,785,695,390,"4,694.19",462
,20180420,24160,24070,23845,23990,23735,23800,23860,-270,-210,84,"1,002.30",438
,20180423,23800,23860,24000,24130,23930,24025,24035,165,175,174,"2,091.14",496
,20180424,24025,24035,23750,24070,23745,23960,23875,-75,-160,260,"3,103.85",484
,20180425,23960,23875,24015,24095,23805,23805,24030,-70,155,302,"3,628.69",456
,20180426,23805,24030,23730,23755,23225,23250,23465,-780,-565,226,"2,651.66",470
,20180427,23250,23465,23425,23515,23365,23515,23425,50,-40,96,"1,124.52",466
,20180502,23515,23425,23395,23520,23170,23500,23410,75,-15,106,"1,240.82",494
,20180503,23500,23410,23740,23740,23170,23285,23425,-125,15,214,"2,506.63",460
,20180504,23285,23425,23210,23210,22770,22940,22895,-485,-530,188,"2,152.59",558
,20180507,22940,22895,22805,23570,22805,23570,23300,675,405,326,"3,798.46",516
,20180508,23570,23300,23570,23710,23525,23640,23580,340,280,132,"1,556.34",536
,20180509,23640,23580,23540,23590,23275,23415,23460,-165,-120,112,"1,314.01",518
,20180510,23415,23460,23550,23555,23450,23495,23515,35,55,46,540.93,524
,20180511,23495,23515,23550,23550,23360,23430,23435,-85,-80,54,632.78,522
,20180514,23430,23435,23480,23515,23295,23350,23380,-85,-55,122,"1,426.36",562
,20180515,23350,23380,23375,23520,23350,23505,23435,125,55,42,492.22,554
,20180516,23505,23435,23475,23705,23415,23575,23520,140,85,48,564.53,552
,20180517,23575,23520,23555,23645,23300,23335,23340,-185,-180,904,"10,551.84",1104
,20180518,23335,23340,23395,23565,23345,23475,23440,135,100,1492,"17,489.73",1856
,20180521,23475,23440,23415,23765,23415,23735,23600,295,160,260,"3,068.37",1854
,20180522,23735,23600,23640,23720,23345,23355,23515,-245,-85,238,"2,798.32",1876
,20180523,23355,23515,23360,23440,23275,23340,23340,-175,-175,388,"4,528.08",1912
,20180524,23340,23340,23080,23200,22950,23125,23110,-215,-230,592,"6,841.92",2106
,20180525,23125,23110,23175,23350,23155,23345,23230,235,120,212,"2,462.75",2100
,20180528,23345,23230,23380,23505,23195,23475,23370,245,140,324,"3,786.03",2120
,20180529,23475,23370,23445,23710,23385,23660,23485,290,115,454,"5,331.81",2412
,20180530,23660,23485,23720,23790,23450,23530,23585,45,100,1010,"11,910.81",3046
,20180531,23530,23585,23700,24065,23665,23980,23920,395,335,2160,"25,834.60",4158
zn1812,20180102,25300,25290,25415,25540,25415,25540,25475,250,185,4,50.96,64
,20180103,25540,25475,25350,25450,25350,25450,25400,-25,-75,4,50.80,64
,20180104,25450,25400,25425,25425,25425,25425,25425,25,25,2,25.43,64
,20180105,25425,25425,25650,25650,25650,25650,25650,225,225,2,25.65,64
,20180108,25650,25650,,,,25650,25650,0,0,0,0.00,64
,20180109,25650,25650,25645,25840,25640,25840,25715,190,65,8,102.88,68
,20180110,25840,25715,25760,25770,25645,25645,25720,-70,5,8,102.89,68
,20180111,25645,25720,25745,25800,25745,25800,25765,80,45,6,77.30,72
,20180112,25800,25765,25800,25845,25800,25845,25815,80,50,6,77.46,78
,20180115,25845,25815,25850,25935,25830,25935,25865,120,50,10,129.35,82
,20180116,25935,25865,25930,25930,25600,25600,25745,-265,-120,10,128.75,90
,20180117,25600,25745,25460,25755,25460,25620,25620,-125,-125,14,179.35,86
,20180118,25620,25620,25590,25590,25590,25590,25590,-30,-30,2,25.59,86
,20180119,25590,25590,25480,26485,25470,25565,25685,-25,95,12,154.11,84
,20180122,25565,25685,25645,25720,25645,25720,25700,35,15,8,102.81,84
,20180123,25720,25700,25770,25770,25595,25595,25700,-105,0,10,128.51,78
,20180124,25595,25700,25315,25315,25315,25315,25315,-385,-385,2,25.32,80
,20180125,25315,25315,25530,25800,25530,25800,25725,485,410,62,797.56,124
,20180126,25800,25725,25755,25755,25655,25655,25705,-70,-20,4,51.41,126
,20180129,25655,25705,25740,26515,25740,26425,26345,720,640,110,"1,449.22",176
,20180130,26425,26345,26195,26195,26085,26130,26135,-215,-210,28,365.91,178
,20180131,26130,26135,26115,26205,25985,26130,26110,-5,-25,50,652.80,184
,20180201,26130,26110,26120,26120,26040,26040,26060,-70,-50,8,104.24,188
,20180202,26040,26060,26090,26220,26090,26220,26155,160,95,8,104.62,192
,20180205,26220,26155,26080,26135,26025,26095,26085,-60,-70,18,234.79,200
,20180206,26095,26085,26080,26235,25795,25870,25930,-215,-155,126,"1,633.87",162
,20180207,25870,25930,25945,25945,25815,25940,25915,10,-15,24,311.00,166
,20180208,25940,25915,25655,25655,25590,25590,25630,-325,-285,8,102.54,162
,20180209,25590,25630,25390,25460,25370,25460,25415,-170,-215,30,381.28,158
,20180212,25460,25415,25265,25540,25210,25540,25305,125,-110,18,227.78,152
,20180213,25540,25305,,,,25570,25570,265,265,0,0.00,152
,20180214,25570,25570,25630,25885,25630,25885,25805,315,235,30,387.12,172
,20180222,25885,25805,25970,25970,25565,25765,25795,-40,-10,16,206.40,174
,20180223,25765,25795,25800,26000,25800,26000,25915,205,120,98,"1,269.85",198
,20180226,26000,25915,25840,26080,25800,26080,25995,165,80,60,779.91,228
,20180227,26080,25995,26105,26150,26025,26150,26095,155,100,24,313.19,242
,20180228,26150,26095,25880,25955,25820,25920,25895,-175,-200,42,543.87,238
,20180301,25920,25895,25860,25935,25810,25935,25885,40,-10,24,310.63,234
,20180302,25935,25885,25780,25795,25735,25795,25760,-90,-125,26,334.89,234
,20180305,25795,25760,25775,25810,25430,25430,25670,-330,-90,24,308.07,232
,20180306,25430,25670,25050,25060,24830,25035,24935,-635,-735,64,798.00,236
,20180307,25035,24935,25085,25085,24875,24875,25010,-60,75,20,250.13,226
,20180308,24875,25010,24795,24840,24650,24650,24710,-360,-300,24,296.53,226
,20180309,24650,24710,24425,24425,24035,24035,24230,-675,-480,18,218.07,224
,20180312,24035,24230,24455,24600,24455,24530,24565,300,335,24,294.83,234
,20180313,24530,24565,24495,24620,24415,24620,24535,55,-30,54,662.57,260
,20180314,24620,24535,24680,24700,24605,24700,24675,165,140,10,123.39,270
,20180315,24700,24675,24270,24305,24125,24255,24225,-420,-450,26,314.98,270
,20180316,24255,24225,24340,24485,24340,24485,24465,260,240,48,587.27,292
,20180319,24485,24465,24510,24510,24345,24470,24430,5,-35,8,97.73,286
,20180320,24470,24430,24415,24465,24300,24300,24405,-130,-25,10,122.03,284
,20180321,24300,24405,24000,24005,23975,24000,23990,-405,-415,20,239.94,298
,20180322,24000,23990,24280,24420,24195,24310,24300,320,310,46,558.94,268
,20180323,24310,24300,24270,24300,23895,24120,24125,-180,-175,40,482.56,272
,20180326,24120,24125,24310,24310,23840,24005,23950,-120,-175,16,191.61,264
,20180327,24005,23950,24285,24485,24275,24350,24395,400,445,40,487.94,272
,20180328,24350,24395,24300,24300,24190,24275,24245,-120,-150,18,218.24,268
,20180329,24275,24245,24145,24380,24145,24380,24255,135,10,12,145.53,276
,20180330,24380,24255,24175,24380,24175,24370,24275,115,20,8,97.10,278
,20180402,24370,24275,24610,24630,24385,24395,24485,120,210,62,759.04,292
,20180403,24395,24485,24445,24445,24310,24310,24330,-175,-155,14,170.34,292
,20180404,24310,24330,24240,24240,24210,24225,24220,-105,-110,8,96.90,292
,20180409,24225,24220,23680,23810,23680,23750,23745,-470,-475,8,94.99,296
,20180410,23750,23745,23950,23980,23925,23960,23955,215,210,22,263.55,304
,20180411,23960,23955,23925,24090,23895,24015,24015,60,60,80,960.62,310
,20180412,24015,24015,23860,23860,23050,23145,23160,-870,-855,146,"1,690.71",342
,20180413,23145,23160,23350,23350,22820,23025,23085,-135,-75,202,"2,331.63",320
,20180416,23025,23085,23015,23220,22760,23120,22990,35,-95,86,988.78,330
,20180417,23120,22990,23145,23230,23015,23015,23100,25,110,24,277.24,338
,20180418,23015,23100,23255,23425,23220,23425,23335,325,235,42,490.12,334
,20180419,23425,23335,23865,24205,23865,24095,23980,760,645,200,"2,398.47",336
,20180420,24095,23980,23740,23965,23650,23780,23805,-200,-175,84,999.83,326
,20180423,23780,23805,23945,24000,23830,23975,23935,170,130,46,550.54,306
,20180424,23975,23935,23975,23975,23715,23960,23865,25,-70,22,262.53,296
,20180425,23960,23865,23960,24005,23715,23715,23900,-150,35,52,621.48,308
,20180426,23715,23900,23680,23680,23155,23155,23435,-745,-465,84,984.39,316
,20180427,23155,23435,23205,23420,23205,23380,23340,-55,-95,54,630.19,310
,20180502,23380,23340,23320,23485,23110,23465,23220,125,-120,38,441.21,316
,20180503,23465,23220,23150,23255,23095,23095,23175,-125,-45,34,393.98,308
,20180504,23095,23175,23100,23100,22725,22815,22855,-360,-320,166,"1,897.06",376
,20180507,22815,22855,22750,23495,22740,23495,23280,640,425,454,"5,285.64",710
,20180508,23495,23280,23520,23620,23450,23540,23500,260,220,78,916.53,732
,20180509,23540,23500,23445,23555,23215,23420,23440,-80,-60,54,632.98,746
,20180510,23420,23440,23475,23490,23430,23445,23465,5,25,24,281.59,742
,20180511,23445,23465,23555,23555,23370,23390,23440,-75,-25,36,421.95,744
,20180514,23390,23440,23465,23495,23270,23355,23405,-85,-35,48,561.81,736
,20180515,23355,23405,23240,23415,23240,23415,23300,10,-105,28,326.26,746
,20180516,23415,23300,23380,23630,23340,23480,23465,180,165,130,"1,525.55",726
,20180517,23480,23465,23495,23510,23260,23260,23415,-205,-50,66,772.70,720
,20180518,23260,23415,23290,23470,23275,23390,23385,-25,-30,24,280.64,730
,20180521,23390,23385,23435,23670,23360,23610,23510,225,125,228,"2,680.64",818
,20180522,23610,23510,23545,23600,23260,23260,23490,-250,-20,72,845.66,794
,20180523,23260,23490,23295,23360,23195,23240,23250,-250,-240,66,767.41,780
,20180524,23240,23250,23140,23190,22945,23060,23050,-190,-200,210,"2,420.39",828
,20180525,23060,23050,23160,23280,23100,23255,23185,205,135,26,301.42,826
,20180528,23255,23185,23375,23415,23145,23390,23305,205,120,116,"1,351.79",844
,20180529,23390,23305,23390,23560,23355,23560,23405,255,100,22,257.50,842
,20180530,23560,23405,23670,23670,23400,23430,23520,25,115,26,305.81,840
,20180531,23430,23520,23640,23920,23640,23920,23840,400,320,60,715.22,862
zn1901,20180116,25865,25865,25610,25610,25610,25610,25610,-255,-255,4,51.22,4
,20180117,25610,25610,25590,25640,25275,25570,25550,-40,-60,16,204.42,8
,20180118,25570,25550,,,,25550,25550,0,0,0,0.00,8
,20180119,25550,25550,25495,25495,25495,25495,25495,-55,-55,4,50.99,8
,20180122,25495,25495,25685,25685,25630,25640,25650,145,155,14,179.56,18
,20180123,25640,25650,25640,25830,25400,25555,25570,-95,-80,12,153.43,18
,20180124,25555,25570,25500,25560,25375,25375,25500,-195,-70,16,204.02,34
,20180125,25375,25500,25450,25705,25450,25705,25565,205,65,24,306.79,34
,20180126,25705,25565,,,,25565,25565,0,0,0,0.00,34
,20180129,25565,25565,25740,26415,25740,26230,26125,665,560,28,365.75,54
,20180130,26230,26125,26300,26300,25990,26080,26150,-45,25,44,575.39,82
,20180131,26080,26150,25990,26040,25875,26040,25965,-110,-185,32,415.52,98
,20180201,26040,25965,26050,26050,26050,26050,26050,85,85,2,26.05,100
,20180202,26050,26050,26055,26145,26055,26145,26070,95,20,10,130.37,110
,20180205,26145,26070,25855,26000,25855,26000,25980,-70,-90,18,233.86,126
,20180206,26000,25980,26190,26205,25845,25885,26065,-95,85,28,364.97,142
,20180207,25885,26065,25860,25890,25860,25870,25870,-195,-195,20,258.72,154
,20180208,25870,25870,25805,25805,25455,25500,25550,-370,-320,20,255.54,154
,20180209,25500,25550,25510,25510,25270,25270,25350,-280,-200,40,507.05,154
,20180212,25270,25350,25470,25470,25105,25435,25310,85,-40,50,632.80,126
,20180213,25435,25310,25445,25445,25445,25445,25445,135,135,4,50.89,126
,20180214,25445,25445,25515,25830,25515,25800,25755,355,310,38,489.42,146
,20180222,25800,25755,25825,25825,25550,25665,25685,-90,-70,36,462.33,144
,20180223,25665,25685,25800,25915,25745,25770,25825,85,140,38,490.69,154
,20180226,25770,25825,25885,25955,25725,25940,25885,115,60,74,957.79,172
,20180227,25940,25885,25865,26075,25865,26050,25980,165,95,52,675.51,196
,20180228,26050,25980,25820,25870,25665,25755,25785,-225,-195,106,"1,366.71",220
,20180301,25755,25785,25740,25865,25740,25865,25830,80,45,20,258.30,232
,20180302,25865,25830,25675,25705,25625,25665,25675,-165,-155,44,564.86,232
,20180305,25665,25675,25695,25695,25205,25205,25505,-470,-170,46,586.68,248
,20180306,25205,25505,25005,25050,24710,24965,24945,-540,-560,96,"1,197.49",276
,20180307,24965,24945,25030,25035,24825,24830,24910,-115,-35,48,597.85,278
,20180308,24830,24910,24825,24850,24600,24600,24750,-310,-160,38,470.28,272
,20180309,24600,24750,24725,24725,24000,24000,24400,-750,-350,170,"2,074.39",268
,20180312,24000,24400,24165,24650,24165,24380,24460,-20,60,170,"2,079.13",318
,20180313,24380,24460,24450,24520,24205,24520,24450,60,-10,58,709.10,330
,20180314,24520,24450,24510,24620,24470,24510,24530,60,80,58,711.39,360
,20180315,24510,24530,24510,24510,24070,24330,24245,-200,-285,72,872.83,336
,20180316,24330,24245,24285,24405,24165,24405,24275,160,30,66,801.09,346
,20180319,24405,24275,23050,24500,23050,24255,24245,-20,-30,134,"1,624.57",404
,20180320,24255,24245,24305,24395,24100,24250,24260,5,15,154,"1,868.15",438
,20180321,24250,24260,24050,24080,23790,23910,23905,-350,-355,100,"1,195.42",458
,20180322,23910,23905,24050,24385,24000,24235,24205,330,300,196,"2,372.26",564
,20180323,24235,24205,24105,24260,23765,23850,24005,-355,-200,202,"2,424.69",528
,20180326,23850,24005,24150,24160,23770,24060,23980,55,-25,98,"1,175.02",532
,20180327,24060,23980,24115,24330,24050,24250,24220,270,240,222,"2,688.47",662
,20180328,24250,24220,24290,24335,24055,24175,24220,-45,0,192,"2,325.50",708
,20180329,24175,24220,24215,24300,23995,24300,24115,80,-105,94,"1,133.42",748
,20180330,24300,24115,24280,24345,24065,24295,24205,180,90,132,"1,597.63",768
,20180402,24295,24205,24480,24560,24185,24310,24395,105,190,270,"3,293.38",910
,20180403,24310,24395,24290,24345,23980,24035,24210,-360,-185,94,"1,138.01",928
,20180404,24035,24210,24185,24185,23900,24015,24050,-195,-160,114,"1,370.98",938
,20180409,24015,24050,24100,24100,23565,23670,23765,-380,-285,122,"1,449.73",888
,20180410,23670,23765,23770,23900,23700,23845,23815,80,50,140,"1,667.25",934
,20180411,23845,23815,23800,24025,23800,23945,23885,130,70,126,"1,505.00",892
,20180412,23945,23885,23840,23850,22890,23040,23150,-845,-735,570,"6,598.01",820
,20180413,23040,23150,22955,23005,22690,22955,22840,-195,-310,254,"2,901.20",818
,20180416,22955,22840,22930,23115,22655,23035,22940,195,100,160,"1,835.51",828
,20180417,23035,22940,23075,23120,22900,23035,23020,95,80,142,"1,634.51",884
,20180418,23035,23020,23095,23315,23065,23270,23180,250,160,276,"3,199.08",992
,20180419,23270,23180,23405,24105,23405,23835,23865,655,685,866,"10,334.59",1096
,20180420,23835,23865,23715,23980,23600,23710,23710,-155,-155,320,"3,794.11",1088
,20180423,23710,23710,23870,23960,23765,23955,23870,245,160,228,"2,721.22",1122
,20180424,23955,23870,23435,23950,23435,23865,23810,-5,-60,332,"3,952.95",1148
,20180425,23865,23810,23900,23990,23620,23620,23805,-190,-5,134,"1,595.20",1184
,20180426,23620,23805,23610,23630,23030,23065,23325,-740,-480,434,"5,061.95",1172
,20180427,23065,23325,23265,23405,23180,23330,23270,5,-55,192,"2,234.13",1222
,20180502,23330,23270,23265,23395,23020,23290,23160,20,-110,84,972.84,1232
,20180503,23290,23160,23195,23205,23050,23115,23105,-45,-55,150,"1,733.17",1254
,20180504,23115,23105,23070,23070,22670,22795,22845,-310,-260,342,"3,906.72",1344
,20180507,22795,22845,22655,23475,22655,23475,23225,630,380,624,"7,246.80",1324
,20180508,23475,23225,23515,23625,23400,23475,23475,250,250,336,"3,943.95",1282
,20180509,23475,23475,23360,23490,23190,23380,23375,-95,-100,224,"2,618.16",1310
,20180510,23380,23375,23440,23475,23330,23350,23415,-25,40,112,"1,311.34",1310
,20180511,23350,23415,23480,23480,23275,23305,23320,-110,-95,168,"1,959.30",1294
,20180514,23305,23320,23405,23440,23200,23270,23335,-50,15,202,"2,357.04",1342
,20180515,23270,23335,23190,23420,23175,23360,23325,25,-10,346,"4,035.40",1276
,20180516,23360,23325,23300,23605,23275,23435,23400,110,75,232,"2,714.67",1254
,20180517,23435,23400,23420,23540,23160,23220,23340,-180,-60,166,"1,937.45",1268
,20180518,23220,23340,23275,23440,23245,23345,23345,5,5,156,"1,821.05",1262
,20180521,23345,23345,23375,23605,23350,23560,23475,215,130,218,"2,559.09",1282
,20180522,23560,23475,23510,23585,23160,23160,23270,-315,-205,706,"8,214.72",1388
,20180523,23160,23270,23250,23255,23140,23200,23195,-70,-75,170,"1,971.66",1380
,20180524,23200,23195,23160,23160,22875,23005,22985,-190,-210,578,"6,643.15",1352
,20180525,23005,22985,22950,23225,22950,23225,23080,240,95,142,"1,638.75",1290
,20180528,23225,23080,23250,23350,23065,23310,23215,230,135,758,"8,799.06",1648
,20180529,23310,23215,23320,23575,23270,23525,23465,310,250,266,"3,120.91",1700
,20180530,23525,23465,23650,23650,23270,23330,23465,-135,0,524,"6,148.59",1798
,20180531,23330,23465,23500,23835,23500,23790,23735,325,270,354,"4,201.17",1788
zn1902,20180212,25350,25350,,,,25350,25350,0,0,0,0.00,0
,20180213,25350,25350,25210,25210,25210,25210,25210,-140,-140,2,25.21,2
,20180214,25210,25210,25730,25730,25730,25730,25730,520,520,2,25.73,4
,20180222,25730,25730,26255,26255,25520,25605,25790,-125,60,6,77.38,8
,20180223,25605,25790,25705,25920,25700,25765,25760,-25,-30,14,180.34,12
,20180226,25765,25760,25860,25860,25860,25860,25860,100,100,2,25.86,14
,20180227,25860,25860,25820,25965,25815,25965,25875,105,15,16,207.02,16
,20180228,25965,25875,25835,25835,25630,25715,25715,-160,-160,14,180.04,24
,20180301,25715,25715,25665,25715,25665,25715,25680,0,-35,6,77.05,30
,20180302,25715,25680,25580,25685,25565,25685,25590,5,-90,12,153.56,34
,20180305,25685,25590,25600,25600,25265,25265,25390,-325,-200,6,76.17,38
,20180306,25265,25390,24865,25080,24740,24800,24815,-590,-575,18,223.34,38
,20180307,24800,24815,,,,24815,24815,0,0,0,0.00,38
,20180308,24815,24815,24770,24790,24560,24560,24705,-255,-110,20,247.05,38
,20180309,24560,24705,24330,24350,23995,24000,24150,-705,-555,38,458.93,44
,20180312,24000,24150,24250,24475,24250,24340,24380,190,230,20,243.82,40
,20180313,24340,24380,24470,24470,24470,24470,24470,90,90,2,24.47,40
,20180314,24470,24470,24595,24595,24450,24465,24500,-5,30,26,318.55,48
,20180315,24465,24500,24390,24390,24020,24165,24245,-335,-255,10,121.23,56
,20180316,24165,24245,24190,24230,24100,24230,24165,-15,-80,88,"1,063.31",94
,20180319,24230,24165,24360,24360,24185,24200,24255,35,90,16,194.05,98
,20180320,24200,24255,24295,24300,24105,24145,24240,-110,-15,14,169.70,104
,20180321,24145,24240,23890,23955,23715,23800,23850,-440,-390,44,524.78,126
,20180322,23800,23850,23930,24310,23930,24135,24160,285,310,28,338.28,112
,20180323,24135,24160,24135,24135,23665,23985,23945,-175,-215,24,287.39,124
,20180326,23985,23945,23980,23980,23595,23965,23820,20,-125,8,95.30,126
,20180327,23965,23820,24030,24260,24030,24155,24190,335,370,40,483.82,150
,20180328,24155,24190,24150,24200,24150,24200,24190,10,0,12,145.15,160
,20180329,24200,24190,24175,24200,23860,24200,24090,10,-100,80,963.67,184
,20180330,24200,24090,24070,24180,24070,24175,24150,85,60,8,96.61,186
,20180402,24175,24150,24375,24375,24145,24160,24205,10,55,8,96.83,188
,20180403,24160,24205,24195,24260,24040,24040,24175,-165,-30,14,169.24,190
,20180404,24040,24175,23990,24010,23810,23850,23915,-325,-260,10,119.59,188
,20180409,23850,23915,23725,23725,23495,23545,23570,-370,-345,8,94.29,190
,20180410,23545,23570,23675,23795,23510,23790,23565,220,-5,26,306.36,194
,20180411,23790,23565,23840,23890,23820,23820,23840,255,275,18,214.59,196
,20180412,23820,23840,23625,23625,22750,22930,22955,-910,-885,36,413.21,192
,20180413,22930,22955,22930,23120,22700,22990,22885,35,-70,46,526.37,188
,20180416,22990,22885,22810,22970,22555,22970,22770,85,-115,12,136.63,190
,20180417,22970,22770,,,,22770,22770,0,0,0,0.00,190
,20180418,22770,22770,23100,23200,23090,23200,23170,430,400,30,347.60,188
,20180419,23200,23170,23725,24020,23685,23685,23950,515,780,128,"1,533.00",170
,20180420,23685,23950,23615,23700,23510,23700,23600,-250,-350,76,896.90,200
,20180423,23700,23600,23790,23840,23790,23835,23800,235,200,26,309.41,192
,20180424,23835,23800,23800,23800,23800,23800,23800,0,0,2,23.80,192
,20180425,23800,23800,23840,23845,23725,23725,23775,-75,-25,32,380.42,216
,20180426,23725,23775,23500,23520,22955,22955,23410,-820,-365,56,655.59,232
,20180427,22955,23410,23130,23300,23095,23290,23190,-120,-220,28,324.72,242
,20180502,23290,23190,22975,23345,22965,23230,23120,40,-70,34,393.07,242
,20180503,23230,23120,23115,23115,23080,23085,23090,-35,-30,6,69.28,238
,20180504,23085,23090,22875,22930,22680,22800,22805,-290,-285,366,"4,173.37",480
,20180507,22800,22805,23000,23320,22640,23285,23055,480,250,370,"4,265.51",372
,20180508,23285,23055,23380,23610,22825,23515,23415,460,360,150,"1,756.34",294
,20180509,23515,23415,23380,23430,23285,23285,23385,-130,-30,112,"1,309.63",286
,20180510,23285,23385,23355,23410,23305,23410,23350,25,-35,16,186.81,286
,20180511,23410,23350,23375,23380,23255,23260,23300,-90,-50,12,139.81,284
,20180514,23260,23300,,,,23200,23200,-100,-100,0,0.00,284
,20180515,23200,23200,23130,23285,23130,23285,23265,85,65,98,"1,140.05",208
,20180516,23285,23265,23260,23500,23180,23450,23390,185,125,88,"1,029.26",276
,20180517,23450,23390,23680,23680,23175,23180,23400,-210,10,284,"3,323.49",304
,20180518,23180,23400,23175,23335,23175,23290,23270,-110,-130,106,"1,233.46",274
,20180521,23290,23270,23360,23545,23325,23545,23380,275,110,226,"2,642.21",424
,20180522,23545,23380,23410,23440,23130,23155,23230,-225,-150,96,"1,115.22",426
,20180523,23155,23230,23110,23140,23050,23055,23110,-175,-120,44,508.51,402
,20180524,23055,23110,22915,22945,22820,22910,22870,-200,-240,32,365.95,398
,20180525,22910,22870,23030,23105,22940,23035,23005,165,135,58,667.15,404
,20180528,23035,23005,23220,23265,23005,23265,23185,260,180,176,"2,040.58",494
,20180529,23265,23185,23310,23450,23195,23415,23385,230,200,44,514.47,508
,20180530,23415,23385,23450,23450,23320,23320,23385,-65,0,4,46.77,506
,20180531,23320,23385,23650,23745,23650,23745,23695,360,310,14,165.89,504
zn1903,20180316,24245,24245,,,,24245,24245,0,0,0,0.00,0
,20180319,24245,24245,,,,24245,24245,0,0,0,0.00,0
,20180320,24245,24245,,,,24245,24245,0,0,0,0.00,0
,20180321,24245,24245,24460,24460,23700,23700,24030,-545,-215,12,144.20,6
,20180322,23700,24030,23900,24220,23900,24025,24040,-5,10,100,"1,202.08",72
,20180323,24025,24040,24285,24285,23610,23610,23865,-430,-175,14,167.07,76
,20180326,23610,23865,23640,23845,23640,23845,23760,-20,-105,8,95.05,82
,20180327,23845,23760,24000,24200,24000,24040,24070,280,310,24,288.90,100
,20180328,24040,24070,23995,24170,23995,24170,24080,100,10,4,48.17,102
,20180329,24170,24080,,,,24080,24080,0,0,0,0.00,102
,20180330,24080,24080,23880,24100,23880,24080,24050,0,-30,12,144.30,112
,20180402,24080,24050,24400,24400,23960,24075,24175,25,125,16,193.43,118
,20180403,24075,24175,24005,24130,23980,23980,24030,-195,-145,10,120.15,120
,20180404,23980,24030,24020,24020,23670,23875,23870,-155,-160,8,95.48,122
,20180409,23875,23870,24270,24270,23370,23370,23610,-500,-260,10,118.06,124
,20180410,23370,23610,23680,23680,23615,23615,23660,5,50,18,212.96,142
,20180411,23615,23660,23625,23790,23575,23725,23705,65,45,74,877.24,180
,20180412,23725,23705,23525,23525,22700,22810,22770,-895,-935,192,"2,186.07",328
,20180413,22810,22770,22605,22870,22550,22665,22770,-105,0,36,409.88,340
,20180416,22665,22770,22820,22960,22530,22960,22725,190,-45,34,386.38,352
,20180417,22960,22725,22840,22950,22780,22950,22870,225,145,12,137.22,356
,20180418,22950,22870,22980,23145,22950,23090,23040,220,170,90,"1,037.01",330
,20180419,23090,23040,23435,23805,23400,23675,23720,635,680,368,"4,364.53",190
,20180420,23675,23720,23525,23645,23425,23645,23560,-75,-160,56,659.72,170
,20180423,23645,23560,23690,23830,23535,23815,23670,255,110,28,331.44,170
,20180424,23815,23670,23615,23770,23615,23650,23685,-20,15,30,355.35,178
,20180425,23650,23685,23735,23735,23650,23735,23690,50,5,10,118.47,182
,20180426,23735,23690,23430,23430,23025,23030,23230,-660,-460,60,697.05,176
,20180427,23030,23230,23015,23110,23015,23110,23075,-120,-155,6,69.24,172
,20180502,23110,23075,23130,23150,22980,23140,23045,65,-30,34,391.79,178
,20180503,23140,23045,22885,22990,22820,22990,22920,-55,-125,8,91.69,174
,20180504,22990,22920,22730,22850,22650,22680,22765,-240,-155,274,"3,119.31",350
,20180507,22680,22765,22705,23375,22705,23370,23010,605,245,32,368.18,340
,20180508,23370,23010,23375,23450,23315,23400,23365,390,355,86,"1,004.77",350
,20180509,23400,23365,23315,23360,23115,23275,23305,-90,-60,132,"1,538.19",294
,20180510,23275,23305,23320,23350,23300,23350,23330,45,25,22,256.68,310
,20180511,23350,23330,23265,23265,23155,23265,23215,-65,-115,14,162.52,312
,20180514,23265,23215,23320,23320,23105,23265,23255,50,40,12,139.53,312
,20180515,23265,23255,23080,23180,23075,23180,23170,-75,-85,128,"1,483.12",270
,20180516,23180,23170,23195,23400,23175,23220,23260,50,90,40,465.29,270
,20180517,23220,23260,23300,23310,23095,23175,23210,-85,-50,80,928.45,324
,20180518,23175,23210,23420,23420,23090,23195,23250,-15,40,226,"2,627.31",298
,20180521,23195,23250,23180,23445,23180,23405,23310,155,60,172,"2,005.00",384
,20180522,23405,23310,23310,23315,23010,23010,23145,-300,-165,64,740.67,394
,20180523,23010,23145,23060,23060,22905,22905,23045,-240,-100,22,253.51,374
,20180524,22905,23045,22765,22915,22755,22915,22780,-130,-265,14,159.47,376
,20180525,22915,22780,23010,23010,22955,22955,22980,175,200,4,45.97,374
,20180528,22955,22980,23100,23210,23090,23195,23110,215,130,98,"1,132.48",386
,20180529,23195,23110,23200,23350,23140,23345,23215,235,105,36,417.92,388
,20180530,23345,23215,23460,23460,23165,23165,23325,-50,110,16,186.62,388
,20180531,23165,23325,23645,23690,23580,23580,23640,255,315,14,165.50,388
zn1904,20180417,22725,22725,,,,22725,22725,0,0,0,0.00,0
,20180418,22725,22725,,,,22725,22725,0,0,0,0.00,0
,20180419,22725,22725,23805,23805,23445,23445,23615,720,890,20,236.17,18
,20180420,23445,23615,23205,23605,23110,23395,23385,-220,-230,56,654.88,36
,20180423,23395,23385,23530,23875,23440,23800,23685,415,300,28,331.65,30
,20180424,23800,23685,23685,23685,23545,23545,23615,-140,-70,4,47.23,30
,20180425,23545,23615,23735,23755,23470,23480,23590,-135,-25,26,306.70,40
,20180426,23480,23590,23190,23570,22900,22900,23305,-690,-285,42,489.47,38
,20180427,22900,23305,23115,23120,23115,23120,23115,-185,-190,4,46.24,38
,20180502,23120,23115,22900,22900,22900,22900,22900,-215,-215,6,68.70,42
,20180503,22900,22900,,,,22900,22900,0,0,0,0.00,42
,20180504,22900,22900,22650,22790,22600,22685,22680,-215,-220,242,"2,744.74",246
,20180507,22685,22680,22810,23385,22810,23380,23245,700,565,68,790.41,266
,20180508,23380,23245,23390,23465,23250,23405,23370,160,125,140,"1,636.14",258
,20180509,23405,23370,23280,23320,23205,23205,23270,-165,-100,132,"1,536.05",196
,20180510,23205,23270,23500,23500,23240,23270,23370,0,100,60,701.22,190
,20180511,23270,23370,,,,23200,23200,-170,-170,0,0.00,190
,20180514,23200,23200,,,,23200,23200,0,0,0,0.00,190
,20180515,23200,23200,23120,23200,23120,23200,23170,0,-30,30,347.57,174
,20180516,23200,23170,23110,23315,23100,23150,23205,-20,35,158,"1,833.52",160
,20180517,23150,23205,23180,23250,23025,23060,23155,-145,-50,84,972.53,188
,20180518,23060,23155,23080,23200,23070,23140,23110,-15,-45,78,901.36,224
,20180521,23140,23110,23185,23350,23165,23345,23280,235,170,182,"2,118.61",366
,20180522,23345,23280,23520,23520,23000,23000,23215,-280,-65,346,"4,016.73",454
,20180523,23000,23215,23065,23090,22975,22975,23050,-240,-165,30,345.79,440
,20180524,22975,23050,22705,22865,22705,22780,22745,-270,-305,148,"1,683.39",410
,20180525,22780,22745,22820,22850,22760,22760,22805,15,60,34,387.75,422
,20180528,22760,22805,23080,23170,22920,23120,23115,315,310,1732,"20,019.34",2038
,20180529,23120,23115,23165,23325,23050,23265,23125,150,10,420,"4,856.42",2360
,20180530,23265,23125,23295,23370,23060,23135,23315,10,190,298,"3,474.15",2156
,20180531,23135,23315,23270,23640,23270,23550,23470,235,155,388,"4,553.52",2052
zn1905,20180516,23170,23170,23005,23280,22880,23060,23025,-110,-145,126,"1,450.83",90
,20180517,23060,23025,23145,23205,22845,22965,23040,-60,15,68,783.41,128
,20180518,22965,23040,23025,23125,22980,23040,23040,0,0,58,668.25,166
,20180521,23040,23040,23030,23245,23005,23245,23135,205,95,96,"1,110.57",246
,20180522,23245,23135,23150,23345,22910,22910,23065,-225,-70,104,"1,199.55",280
,20180523,22910,23065,23000,23000,22865,22865,22950,-200,-115,6,68.86,280
,20180524,22865,22950,22620,22765,22615,22760,22690,-190,-260,46,521.92,302
,20180525,22760,22690,22720,22915,22720,22915,22820,225,130,42,479.24,332
,20180528,22915,22820,22920,23115,22865,23020,22970,200,150,48,551.36,356
,20180529,23020,22970,23030,23225,23000,23150,23125,180,155,220,"2,544.00",490
,20180530,23150,23125,23190,23280,23005,23015,23075,-110,-50,82,946.20,456
,20180531,23015,23075,23315,23500,23285,23420,23395,345,320,44,514.72,470
