   ,合约,日期,前收盘价,前结算价,开盘价,最高价,最低价,收盘价,结算价,涨跌1,涨跌2,成交量,成交金额,持仓量
1,m1201,20120104,2850,2856,2703,2870,2703,2870,2869,14,13,3788,108711860,66
2,m1201,20120105,2870,2869,0,0,0,2869,2869,0,0,0,0,66
3,m1201,20120106,2869,2869,0,0,0,2869,2869,0,0,0,0,66
4,m1201,20120109,2869,2869,2870,2870,2870,2870,2870,1,1,14,401800,52
5,m1201,20120110,2870,2870,0,0,0,2870,2870,0,0,0,0,52
6,m1201,20120111,2870,2870,0,0,0,2870,2870,0,0,0,0,52
7,m1201,20120112,2870,2870,0,0,0,2870,2870,0,0,0,0,52
8,m1201,20120113,2870,2870,2880,2880,2880,2880,2880,10,10,42,1209600,10
9,m1201,20120116,2880,2880,0,0,0,2880,2880,0,0,0,0,10
10,m1201,20120117,2880,2880,0,0,0,2880,2870,0,-10,0,0,0
11,m1203,20120104,2898,2883,2936,2936,2911,2923,2925,40,42,54,1579600,122
12,m1203,20120105,2923,2925,2917,2925,2915,2924,2919,-1,-6,24,700580,108
13,m1203,20120106,2924,2919,2901,2912,2901,2906,2906,-13,-13,16,465040,102
14,m1203,20120109,2906,2906,2898,2919,2898,2919,2908,13,2,14,407220,94
15,m1203,20120110,2919,2908,2950,2962,2950,2962,2954,54,46,12,354520,90
16,m1203,20120111,2962,2954,2948,2955,2948,2955,2952,1,-2,10,295220,88
17,m1203,20120112,2955,2952,2926,2930,2926,2929,2927,-23,-25,8,234220,92
18,m1203,20120113,2929,2927,2903,2916,2903,2906,2913,-21,-14,98,2855680,90
19,m1203,20120116,2906,2913,2881,2881,2870,2870,2873,-43,-40,16,459820,90
20,m1203,20120117,2870,2873,2948,2948,2899,2921,2923,48,50,96,2806080,88
21,m1203,20120118,2921,2923,2920,2920,2918,2918,2919,-5,-4,16,467080,88
22,m1203,20120119,2918,2919,2930,2950,2928,2932,2931,13,12,26,762180,84
23,m1203,20120120,2932,2931,2950,2961,2950,2952,2953,21,22,12,354380,80
24,m1203,20120130,2952,2953,2952,3012,2952,2965,2976,12,23,12,357160,80
25,m1203,20120131,2965,2976,2935,2945,2935,2945,2938,-31,-38,8,235080,80
26,m1203,20120201,2945,2938,2954,2994,2954,2972,2981,34,43,34,1013580,74
27,m1203,20120202,2972,2981,0,0,0,2981,2981,0,0,0,0,74
28,m1203,20120203,2981,2981,3017,3017,2970,2970,2993,-11,12,4,119740,74
29,m1203,20120206,2970,2993,3055,3055,3011,3012,3019,19,26,12,362340,72
30,m1203,20120207,3012,3019,3012,3012,3012,3012,3012,-7,-7,2,60240,70
31,m1203,20120208,3012,3012,3029,3040,3015,3029,3028,17,16,8,242260,66
32,m1203,20120209,3029,3028,3037,3037,3028,3028,3032,0,4,4,121300,66
33,m1203,20120210,3028,3032,3015,3015,3000,3000,3007,-32,-25,8,240580,64
34,m1203,20120213,3000,3007,3015,3015,3012,3015,3014,8,7,6,180840,62
35,m1203,20120214,3015,3014,3037,3037,3026,3026,3029,12,15,14,424080,56
36,m1203,20120215,3026,3029,3028,3031,3028,3031,3029,2,0,6,181740,56
37,m1203,20120216,3031,3029,3030,3046,3030,3042,3034,13,5,14,424780,44
38,m1203,20120217,3042,3034,3047,3057,3047,3050,3049,16,15,22,670960,30
39,m1203,20120220,3050,3049,3055,3055,3055,3055,3055,6,6,4,122200,26
40,m1203,20120221,3055,3055,3129,3129,3080,3100,3103,45,48,6,186180,24
41,m1203,20120222,3100,3103,0,0,0,3103,3103,0,0,0,0,24
42,m1203,20120223,3103,3103,0,0,0,3103,3103,0,0,0,0,24
43,m1203,20120224,3103,3103,0,0,0,3103,3103,0,0,0,0,24
44,m1203,20120227,3103,3103,3150,3150,3109,3109,3139,6,36,16,502380,28
45,m1203,20120228,3109,3139,3152,3152,3152,3152,3152,13,13,4,126080,24
46,m1203,20120229,3152,3152,3279,3279,2995,2995,3045,-157,-107,38,1157220,22
47,m1203,20120301,2995,3045,2863,2863,2863,2863,2863,-182,-182,10,286300,12
48,m1203,20120302,2863,2863,0,0,0,2863,2863,0,0,0,0,12
49,m1203,20120305,2863,2863,0,0,0,2863,2863,0,0,0,0,12
50,m1203,20120306,2863,2863,0,0,0,2863,2863,0,0,0,0,12
51,m1203,20120307,2863,2863,3000,3000,3000,3000,3000,137,137,12,360000,0
52,m1203,20120308,3000,3000,0,0,0,3000,3000,0,0,0,0,0
53,m1203,20120309,3000,3000,0,0,0,3000,3000,0,0,0,0,0
54,m1203,20120312,3000,3000,0,0,0,3000,3000,0,0,0,0,0
55,m1203,20120313,3000,3000,0,0,0,3000,3000,0,0,0,0,0
56,m1203,20120314,3000,3000,0,0,0,3000,2937,0,-63,0,0,0
57,m1205,20120104,2906,2900,2936,2938,2923,2929,2930,29,30,52524,1539199080,318692
58,m1205,20120105,2929,2930,2928,2934,2920,2929,2927,-1,-3,49226,1440937600,289830
59,m1205,20120106,2929,2927,2908,2910,2898,2908,2902,-19,-25,31968,927928120,280128
60,m1205,20120109,2908,2902,2901,2915,2892,2910,2903,8,1,40694,1181350320,265186
61,m1205,20120110,2910,2903,2933,2956,2932,2950,2946,47,43,37332,1100098060,246584
62,m1205,20120111,2950,2946,2948,2951,2936,2947,2944,1,-2,27082,797551440,239288
63,m1205,20120112,2947,2944,2926,2926,2904,2913,2911,-31,-33,31614,920342640,240338
64,m1205,20120113,2913,2911,2883,2893,2871,2874,2879,-37,-32,48146,1386524160,253390
65,m1205,20120116,2874,2879,2852,2853,2828,2832,2837,-47,-42,32476,921540840,247606
66,m1205,20120117,2832,2837,2845,2864,2840,2864,2851,27,14,22424,639434460,246538
67,m1205,20120118,2864,2851,2857,2865,2851,2851,2858,0,7,19248,550150340,237464
68,m1205,20120119,2851,2858,2860,2884,2858,2882,2866,24,8,31250,895825280,223990
69,m1205,20120120,2882,2866,2884,2904,2882,2904,2892,38,26,20720,599274360,218766
70,m1205,20120130,2904,2892,2920,2921,2900,2910,2913,18,21,18950,552032000,212410
71,m1205,20120131,2910,2913,2895,2900,2883,2898,2894,-15,-19,15012,434462500,215382
72,m1205,20120201,2898,2894,2902,2927,2902,2915,2915,21,21,19196,559654320,213584
73,m1205,20120202,2915,2915,2923,2934,2917,2924,2926,9,11,16256,475770500,207248
74,m1205,20120203,2924,2926,2930,2934,2918,2920,2924,-6,-2,8836,258379640,205206
75,m1205,20120206,2920,2924,2950,2962,2942,2961,2952,37,28,34760,1026353200,199780
76,m1205,20120207,2961,2952,2953,2969,2943,2952,2955,0,3,16774,495727960,193262
77,m1205,20120208,2952,2955,2958,2975,2950,2974,2960,19,5,20448,605460420,183992
78,m1205,20120209,2974,2960,2960,2966,2946,2960,2961,0,1,11560,342309180,181278
79,m1205,20120210,2960,2961,2950,2956,2926,2926,2934,-35,-27,14780,433665620,180542
80,m1205,20120213,2926,2934,2931,2967,2931,2965,2954,31,20,13078,386379180,176126
81,m1205,20120214,2965,2954,2979,2994,2977,2978,2984,24,30,24412,728626220,163378
82,m1205,20120215,2978,2984,2982,3001,2982,2989,2990,5,6,21746,650221460,152966
83,m1205,20120216,2989,2990,2999,3003,2983,2996,2993,6,3,29562,884923360,139098
84,m1205,20120217,2996,2993,3000,3027,3000,3022,3018,29,25,17734,535248860,133242
85,m1205,20120220,3022,3018,3049,3049,3029,3036,3035,18,17,12378,375699360,127750
86,m1205,20120221,3036,3035,3040,3048,3026,3043,3038,8,3,13814,419709620,122790
87,m1205,20120222,3043,3038,3038,3040,3022,3028,3029,-10,-9,13940,422246640,121494
88,m1205,20120223,3028,3029,3029,3030,3015,3029,3019,0,-10,17274,521612880,110404
89,m1205,20120224,3029,3019,3027,3034,3018,3027,3026,8,7,15832,479113260,102388
90,m1205,20120227,3027,3026,3029,3056,3028,3055,3046,29,20,12614,384322120,95830
91,m1205,20120228,3055,3046,3060,3084,3060,3083,3075,37,29,13654,419916200,87394
92,m1205,20120229,3083,3075,3090,3095,3085,3094,3089,19,14,11986,370287460,82532
93,m1205,20120301,3094,3089,3084,3106,3077,3078,3091,-11,2,11744,363051640,77600
94,m1205,20120302,3078,3091,3097,3118,3092,3117,3105,26,14,9318,289399740,73606
95,m1205,20120305,3117,3105,3131,3147,3128,3146,3137,41,32,8344,261818060,70430
96,m1205,20120306,3146,3137,3149,3149,3130,3139,3135,2,-2,4384,137479660,68964
97,m1205,20120307,3139,3135,3143,3148,3116,3117,3130,-18,-5,9854,308528620,65054
98,m1205,20120308,3117,3130,3110,3127,3097,3100,3112,-30,-18,6042,188068420,63416
99,m1205,20120309,3100,3112,3120,3158,3120,3155,3141,43,29,8356,262474800,59998
100,m1205,20120312,3155,3141,3133,3143,3113,3137,3124,-4,-17,8320,259934460,56308
101,m1205,20120313,3137,3124,3130,3149,3127,3142,3138,18,14,6506,204190460,53000
102,m1205,20120314,3142,3138,3148,3167,3143,3153,3156,15,18,7506,236962900,50266
103,m1205,20120315,3153,3156,3160,3170,3145,3169,3161,13,5,8076,255361040,46672
104,m1205,20120316,3169,3161,3178,3181,3161,3175,3171,14,10,9816,311324840,42018
105,m1205,20120319,3175,3171,3185,3197,3173,3193,3183,22,12,8144,259283380,38018
106,m1205,20120320,3193,3183,3188,3188,3163,3163,3172,-20,-11,9080,288078520,34200
107,m1205,20120321,3163,3172,3160,3165,3150,3159,3157,-13,-15,4188,132237900,31990
108,m1205,20120322,3159,3157,3164,3179,3164,3169,3172,12,15,2370,75179600,30686
109,m1205,20120323,3169,3172,3178,3220,3177,3220,3198,48,26,5558,177800020,28986
110,m1205,20120326,3220,3198,3224,3253,3220,3251,3240,53,42,3182,103110460,27626
111,m1205,20120327,3251,3240,3260,3269,3245,3267,3257,27,17,4270,139076780,25436
112,m1205,20120328,3267,3257,3257,3290,3255,3277,3278,20,21,6520,213758120,23578
113,m1205,20120329,3277,3278,3280,3287,3259,3262,3271,-16,-7,2138,69936040,22764
114,m1205,20120330,3262,3271,3255,3255,3226,3240,3236,-31,-35,3140,101620540,21124
115,m1205,20120405,3240,3236,3308,3387,3298,3383,3339,147,103,6994,233576800,16036
116,m1205,20120406,3383,3339,3394,3411,3384,3409,3396,70,57,5834,198156220,14154
117,m1205,20120409,3409,3396,3422,3424,3402,3407,3413,11,17,4668,159327100,11552
118,m1205,20120410,3407,3413,3400,3416,3392,3414,3401,1,-12,1768,60145820,10694
119,m1205,20120411,3414,3401,3395,3395,3367,3384,3381,-17,-20,1844,62354580,9800
120,m1205,20120412,3384,3381,3390,3390,3376,3381,3382,0,1,1942,65684500,8280
121,m1205,20120413,3381,3382,3405,3417,3400,3405,3407,23,25,974,33184840,7704
122,m1205,20120416,3405,3407,3376,3390,3367,3385,3379,-22,-28,1398,47244220,6730
123,m1205,20120417,3385,3379,3396,3422,3385,3421,3408,42,29,2966,101101620,4512
124,m1205,20120418,3421,3408,3424,3438,3373,3388,3401,-20,-7,1186,40346300,3448
125,m1205,20120419,3388,3401,3378,3410,3378,3406,3399,5,-2,930,31612720,2754
126,m1205,20120420,3406,3399,3400,3440,3400,3427,3427,28,28,888,30435260,2308
127,m1205,20120423,3427,3427,3458,3478,3433,3438,3451,11,24,604,20846160,1904
128,m1205,20120424,3438,3451,3406,3434,3402,3411,3418,-40,-33,564,19278640,1432
129,m1205,20120425,3411,3418,3430,3456,3402,3413,3423,-5,5,588,20133080,958
130,m1205,20120426,3413,3423,3419,3421,3381,3420,3405,-3,-18,880,29971680,660
131,m1205,20120427,3420,3405,3440,3575,3414,3449,3460,44,55,454,15710480,446
132,m1205,20120502,3449,3460,3382,3529,3365,3504,3477,44,17,196,6815760,542
133,m1205,20120503,3504,3477,3400,3400,3400,3400,3400,-77,-77,4,136000,542
134,m1205,20120504,3400,3400,0,0,0,3400,3400,0,0,0,0,542
135,m1205,20120507,3400,3400,0,0,0,3400,3400,0,0,0,0,542
136,m1205,20120508,3400,3400,0,0,0,3400,3400,0,0,0,0,450
137,m1205,20120509,3400,3400,3480,3480,3480,3480,3480,80,80,4,139200,454
138,m1205,20120510,3480,3480,3480,3480,3480,3480,3480,0,0,6,208800,454
139,m1205,20120511,3480,3480,3480,3500,3480,3500,3496,20,16,12,419600,450
140,m1205,20120514,3500,3496,3480,3480,3480,3480,3480,-16,-16,4,139200,446
141,m1205,20120515,3480,3480,0,0,0,3480,3477,0,-3,0,0,0
142,m1207,20120104,2932,2931,2990,2990,2962,2962,2971,31,40,6,178280,200
143,m1207,20120105,2962,2971,2958,2966,2945,2959,2957,-12,-14,30,887240,202
144,m1207,20120106,2959,2957,2946,2946,2938,2942,2942,-15,-15,10,294200,202
145,m1207,20120109,2942,2942,2932,2939,2932,2938,2935,-4,-7,10,293520,202
146,m1207,20120110,2938,2935,2973,2979,2973,2979,2975,44,40,6,178500,196
147,m1207,20120111,2979,2975,0,0,0,2975,2975,0,0,0,0,196
148,m1207,20120112,2975,2975,2943,2946,2940,2946,2943,-29,-32,12,353180,196
149,m1207,20120113,2946,2943,2913,2919,2913,2913,2915,-30,-28,8,233240,196
150,m1207,20120116,2913,2915,2877,2877,2870,2874,2873,-41,-42,10,287380,192
151,m1207,20120117,2874,2873,0,0,0,2873,2873,0,0,0,0,192
152,m1207,20120118,2873,2873,2873,2873,2873,2873,2873,0,0,4,114920,188
153,m1207,20120119,2873,2873,2899,2899,2884,2885,2886,12,13,22,634960,174
154,m1207,20120120,2885,2886,2893,2931,2893,2931,2913,45,27,12,349640,172
155,m1207,20120130,2931,2913,0,0,0,2913,2913,0,0,0,0,172
156,m1207,20120131,2913,2913,0,0,0,2913,2913,0,0,0,0,172
157,m1207,20120201,2913,2913,0,0,0,2913,2913,0,0,0,0,172
158,m1207,20120202,2913,2913,2953,2965,2953,2965,2959,52,46,4,118360,174
159,m1207,20120203,2965,2959,2938,2967,2938,2955,2955,-4,-4,16,472820,176
160,m1207,20120206,2955,2955,2964,2988,2964,2988,2971,33,16,20,594360,178
161,m1207,20120207,2988,2971,2999,2999,2985,2985,2992,14,21,6,179540,176
162,m1207,20120208,2985,2992,2990,2990,2990,2990,2990,-2,-2,2,59800,176
163,m1207,20120209,2990,2990,2997,2997,2977,2991,2985,1,-5,8,238860,176
164,m1207,20120210,2991,2985,0,0,0,2985,2985,0,0,0,0,176
165,m1207,20120213,2985,2985,2980,2998,2980,2998,2989,13,4,4,119560,176
166,m1207,20120214,2998,2989,0,0,0,2989,2989,0,0,0,0,176
167,m1207,20120215,2989,2989,0,0,0,2989,2989,0,0,0,0,176
168,m1207,20120216,2989,2989,0,0,0,2989,2989,0,0,0,0,176
169,m1207,20120217,2989,2989,0,0,0,2989,2989,0,0,0,0,176
170,m1207,20120220,2989,2989,2989,3044,2989,3044,3016,55,27,8,241320,176
171,m1207,20120221,3044,3016,3051,3051,3051,3051,3051,35,35,2,61020,174
172,m1207,20120222,3051,3051,3041,3048,3041,3045,3044,-6,-7,18,548080,162
173,m1207,20120223,3045,3044,3047,3047,3033,3047,3043,3,-1,8,243480,160
174,m1207,20120224,3047,3043,3069,3070,3069,3070,3069,27,26,6,184160,158
175,m1207,20120227,3070,3069,3080,3085,3080,3085,3081,16,12,6,184900,154
176,m1207,20120228,3085,3081,0,0,0,3081,3081,0,0,0,0,154
177,m1207,20120229,3081,3081,3099,3105,3099,3105,3102,24,21,12,372340,156
178,m1207,20120301,3105,3102,3093,3120,3093,3116,3110,14,8,12,373280,154
179,m1207,20120302,3116,3110,3133,3133,3120,3121,3124,11,14,6,187480,152
180,m1207,20120305,3121,3124,3174,3176,3169,3176,3172,52,48,10,317260,152
181,m1207,20120306,3176,3172,3172,3188,3171,3171,3173,-1,1,18,571260,152
182,m1207,20120307,3171,3173,3173,3173,3162,3162,3166,-11,-7,8,253340,150
183,m1207,20120308,3162,3166,3145,3145,3133,3133,3137,-33,-29,10,313720,152
184,m1207,20120309,3133,3137,3149,3186,3149,3186,3163,49,26,18,569480,150
185,m1207,20120312,3186,3163,3165,3165,3165,3165,3165,2,2,2,63300,150
186,m1207,20120313,3165,3165,3181,3181,3181,3181,3181,16,16,14,445340,160
187,m1207,20120314,3181,3181,3184,3191,3184,3191,3185,10,4,16,509720,156
188,m1207,20120315,3191,3185,3204,3206,3185,3201,3199,16,14,56,1791640,160
189,m1207,20120316,3201,3199,3211,3211,3191,3199,3200,0,1,16,512020,154
190,m1207,20120319,3199,3200,3191,3225,3191,3211,3211,11,11,16,513880,156
191,m1207,20120320,3211,3211,3190,3198,3176,3176,3187,-35,-24,32,1019960,158
192,m1207,20120321,3176,3187,3153,3183,3153,3182,3171,-5,-16,30,951560,144
193,m1207,20120322,3182,3171,3180,3180,3180,3180,3180,9,9,2,63600,142
194,m1207,20120323,3180,3180,3220,3239,3196,3226,3234,46,54,236,7634580,298
195,m1207,20120326,3226,3234,0,0,0,3234,3234,0,0,0,0,298
196,m1207,20120327,3234,3234,3269,3274,3269,3273,3270,39,36,40,1308020,310
197,m1207,20120328,3273,3270,3298,3313,3286,3286,3299,16,29,98,3233340,240
198,m1207,20120329,3286,3299,3293,3293,3280,3284,3288,-15,-11,18,591940,240
199,m1207,20120330,3284,3288,3262,3279,3252,3258,3260,-30,-28,48,1565060,240
200,m1207,20120405,3258,3260,3325,3385,3325,3368,3340,108,80,192,6413000,362
201,m1207,20120406,3368,3340,3436,3436,3372,3400,3388,60,48,40,1355340,372
202,m1207,20120409,3400,3388,3396,3400,3383,3383,3393,-5,5,20,678720,368
203,m1207,20120410,3383,3393,3372,3400,3368,3398,3381,5,-12,20,676220,368
204,m1207,20120411,3398,3381,3360,3367,3333,3367,3356,-14,-25,26,872660,366
205,m1207,20120412,3367,3356,3333,3353,3333,3353,3341,-3,-15,36,1203080,380
206,m1207,20120413,3353,3341,3397,3397,3370,3385,3379,44,38,36,1216740,374
207,m1207,20120416,3385,3379,3345,3357,3345,3357,3353,-22,-26,6,201180,368
208,m1207,20120417,3357,3353,0,0,0,3353,3353,0,0,0,0,368
209,m1207,20120418,3353,3353,3401,3401,3353,3372,3368,19,15,20,673740,370
210,m1207,20120419,3372,3368,3355,3355,3355,3355,3355,-13,-13,18,603900,368
211,m1207,20120420,3355,3355,3355,3368,3355,3359,3362,4,7,26,874300,360
212,m1207,20120423,3359,3362,3460,3460,3361,3396,3406,34,44,30,1021860,362
213,m1207,20120424,3396,3406,3380,3400,3373,3373,3381,-33,-25,20,676280,358
214,m1207,20120425,3373,3381,3387,3388,3387,3388,3387,7,6,4,135500,356
215,m1207,20120426,3388,3387,3360,3379,3326,3375,3353,-12,-34,166,5566300,392
216,m1207,20120427,3375,3353,3403,3426,3403,3426,3410,73,57,178,6070040,394
217,m1207,20120502,3426,3410,3426,3431,3412,3430,3423,20,13,16,547720,388
218,m1207,20120503,3430,3423,3435,3435,3415,3422,3425,-1,2,140,4796280,442
219,m1207,20120504,3422,3425,3424,3460,3424,3460,3442,35,17,126,4337200,428
220,m1207,20120507,3460,3442,3478,3479,3446,3451,3461,9,19,280,9692680,544
221,m1207,20120508,3451,3461,3446,3464,3445,3450,3450,-11,-11,140,4830540,540
222,m1207,20120509,3450,3450,3422,3448,3421,3426,3426,-24,-24,154,5276240,542
223,m1207,20120510,3426,3426,3439,3451,3436,3451,3442,25,16,156,5369900,526
224,m1207,20120511,3451,3442,3452,3453,3417,3427,3433,-15,-9,246,8447140,384
225,m1207,20120514,3427,3433,3379,3417,3301,3301,3366,-132,-67,186,6262060,318
226,m1207,20120515,3301,3366,3308,3349,3308,3325,3318,-41,-48,154,5110280,264
227,m1207,20120516,3325,3318,3321,3349,3273,3282,3318,-36,0,102,3384820,236
228,m1207,20120517,3282,3318,3333,3378,3309,3370,3346,52,28,60,2007740,222
229,m1207,20120518,3370,3346,3373,3373,3334,3364,3358,18,12,40,1343520,218
230,m1207,20120521,3364,3358,3360,3368,3358,3358,3361,0,3,28,941300,208
231,m1207,20120522,3358,3361,3360,3360,3350,3360,3356,-1,-5,16,537100,200
232,m1207,20120523,3360,3356,3236,3313,3236,3307,3295,-49,-61,30,988600,200
233,m1207,20120524,3307,3295,3329,3345,3325,3345,3331,50,36,38,1266140,202
234,m1207,20120525,3345,3331,3331,3344,3326,3344,3331,13,0,46,1532640,198
235,m1207,20120528,3344,3331,3338,3339,3320,3339,3329,8,-2,96,3196040,202
236,m1207,20120529,3339,3329,3324,3348,3320,3348,3329,19,0,38,1265120,198
237,m1207,20120530,3348,3329,3349,3355,3278,3351,3315,22,-14,224,7427020,200
238,m1207,20120531,3351,3315,3334,3335,3290,3320,3319,5,4,50,1659620,182
239,m1207,20120601,3320,3319,3320,3320,3288,3314,3298,-5,-21,14,461840,172
240,m1207,20120604,3314,3298,3282,3311,3282,3300,3302,2,4,20,660560,170
241,m1207,20120605,3300,3302,3314,3314,3303,3306,3307,4,5,44,1455280,182
242,m1207,20120606,3306,3307,3310,3311,3306,3311,3308,4,1,12,397040,186
243,m1207,20120607,3311,3308,3337,3337,3330,3330,3333,22,25,4,133340,190
244,m1207,20120608,3330,3333,3340,3340,3340,3340,3340,7,7,2,66800,188
245,m1207,20120611,3340,3340,0,0,0,3340,3340,0,0,0,0,188
246,m1207,20120612,3340,3340,0,0,0,3340,3340,0,0,0,0,188
247,m1207,20120613,3340,3340,3389,3390,3387,3390,3388,50,48,12,406580,178
248,m1207,20120614,3390,3388,3351,3351,3340,3340,3347,-48,-41,6,200820,174
249,m1207,20120615,3340,3347,0,0,0,3347,3347,0,0,0,0,174
250,m1207,20120618,3347,3347,3390,3390,3352,3352,3365,5,18,6,201900,172
251,m1207,20120619,3352,3365,3390,3420,3362,3420,3394,55,29,14,475280,170
252,m1207,20120620,3420,3394,0,0,0,3394,3394,0,0,0,0,170
253,m1207,20120621,3394,3394,3509,3509,3426,3456,3481,62,87,28,974860,166
254,m1207,20120625,3456,3481,3475,3520,3410,3520,3474,39,-7,20,694840,154
255,m1207,20120626,3520,3474,3514,3525,3514,3525,3518,51,44,18,633340,148
256,m1207,20120627,3525,3518,3599,3599,3520,3520,3559,2,41,4,142380,146
257,m1207,20120628,3520,3559,3550,3551,3550,3550,3550,-9,-9,6,213020,142
258,m1207,20120629,3550,3550,3411,3600,3408,3408,3460,-142,-90,8,276800,142
259,m1207,20120702,3408,3460,3260,3260,3260,3260,3260,-200,-200,6,195600,142
260,m1207,20120703,3260,3260,3350,3350,3350,3350,3350,90,90,8,268000,134
261,m1207,20120704,3350,3350,0,0,0,3350,3350,0,0,0,0,32
262,m1207,20120705,3350,3350,3551,3551,3551,3551,3551,201,201,2,71020,0
263,m1207,20120706,3551,3551,0,0,0,3551,3551,0,0,0,0,0
264,m1207,20120709,3551,3551,0,0,0,3551,3551,0,0,0,0,0
265,m1207,20120710,3551,3551,0,0,0,3551,3551,0,0,0,0,0
266,m1207,20120711,3551,3551,0,0,0,3551,3551,0,0,0,0,0
267,m1207,20120712,3551,3551,0,0,0,3551,3551,0,0,0,0,0
268,m1207,20120713,3551,3551,0,0,0,3551,3341,0,-210,0,0,0
269,m1208,20120104,2964,2961,2999,2999,2983,2992,2993,31,32,34,1017840,56
270,m1208,20120105,2992,2993,2984,2987,2984,2987,2985,-6,-8,16,477740,50
271,m1208,20120106,2987,2985,2964,2973,2964,2967,2968,-18,-17,6,178080,50
272,m1208,20120109,2967,2968,2956,2967,2956,2967,2959,-1,-9,16,473520,40
273,m1208,20120110,2967,2959,0,0,0,2959,2959,0,0,0,0,40
274,m1208,20120111,2959,2959,2994,2994,2982,2982,2988,23,29,24,717200,42
275,m1208,20120112,2982,2988,3032,3032,2964,2967,2973,-21,-15,24,713540,42
276,m1208,20120113,2967,2973,2944,2944,2944,2944,2944,-29,-29,4,117760,38
277,m1208,20120116,2944,2944,2903,2903,2892,2901,2899,-43,-45,8,231960,38
278,m1208,20120117,2901,2899,2910,2910,2910,2910,2910,11,11,2,58200,38
279,m1208,20120118,2910,2910,2910,2927,2910,2922,2916,12,6,12,350020,38
280,m1208,20120119,2922,2916,2929,2929,2929,2929,2929,13,13,2,58580,36
281,m1208,20120120,2929,2929,2957,2957,2957,2957,2957,28,28,2,59140,38
282,m1208,20120130,2957,2957,0,0,0,2957,2957,0,0,0,0,38
283,m1208,20120131,2957,2957,2949,2967,2949,2967,2957,10,0,22,650640,38
284,m1208,20120201,2967,2957,2967,2998,2967,2982,2990,25,33,120,3588720,36
285,m1208,20120202,2982,2990,2992,2992,2972,2978,2979,-12,-11,14,417120,40
286,m1208,20120203,2978,2979,3003,3003,2976,2976,2983,-3,4,10,298380,36
287,m1208,20120206,2976,2983,3029,3029,3011,3025,3020,42,37,16,483280,36
288,m1208,20120207,3025,3020,3002,3028,3002,3014,3019,-6,-1,18,543440,36
289,m1208,20120208,3014,3019,3029,3030,3013,3030,3023,11,4,22,665200,34
290,m1208,20120209,3030,3023,3017,3021,3012,3012,3016,-11,-7,22,663700,30
291,m1208,20120210,3012,3016,2987,2987,2976,2976,2981,-40,-35,6,178860,28
292,m1208,20120213,2976,2981,2991,3017,2991,3017,3006,36,25,24,721660,32
293,m1208,20120214,3017,3006,3030,3030,3030,3030,3030,24,24,4,121200,30
294,m1208,20120215,3030,3030,3031,3031,3026,3026,3028,-4,-2,4,121140,32
295,m1208,20120216,3026,3028,3029,3029,3009,3009,3020,-19,-8,12,362420,30
296,m1208,20120217,3009,3020,3055,3059,3055,3059,3057,39,37,4,122280,32
297,m1208,20120220,3059,3057,3087,3087,3074,3074,3077,17,20,8,246200,34
298,m1208,20120221,3074,3077,3063,3095,3063,3081,3078,4,1,18,554060,34
299,m1208,20120222,3081,3078,3072,3074,3060,3071,3067,-7,-11,38,1165540,34
300,m1208,20120223,3071,3067,3067,3069,3058,3069,3064,2,-3,8,245180,30
301,m1208,20120224,3069,3064,3085,3085,3074,3075,3078,11,14,10,307820,30
302,m1208,20120227,3075,3078,3093,3108,3090,3097,3097,19,19,38,1177020,30
303,m1208,20120228,3097,3097,3100,3122,3100,3122,3114,25,17,12,373700,32
304,m1208,20120229,3122,3114,3137,3137,3121,3132,3128,18,14,44,1376700,26
305,m1208,20120301,3132,3128,3132,3139,3118,3120,3130,-8,2,18,563520,26
306,m1208,20120302,3120,3130,3186,3189,3143,3163,3167,33,37,100,3167380,52
307,m1208,20120305,3163,3167,3173,3196,3173,3190,3184,23,17,50,1592020,52
308,m1208,20120306,3190,3184,3195,3195,3166,3180,3178,-4,-6,66,2097720,40
309,m1208,20120307,3180,3178,3182,3182,3170,3171,3174,-7,-4,32,1015680,38
310,m1208,20120308,3171,3174,3162,3176,3139,3175,3157,1,-17,92,2904800,42
311,m1208,20120309,3175,3157,3161,3205,3161,3205,3187,48,30,32,1020080,46
312,m1208,20120312,3205,3187,3176,3176,3155,3161,3162,-26,-25,72,2276800,66
313,m1208,20120313,3161,3162,3180,3182,3172,3173,3178,11,16,56,1779940,56
314,m1208,20120314,3173,3178,3199,3216,3199,3204,3211,26,33,42,1348800,60
315,m1208,20120315,3204,3211,3194,3220,3193,3206,3201,-5,-10,16,512220,56
316,m1208,20120316,3206,3201,3210,3210,3205,3205,3207,4,6,4,128300,56
317,m1208,20120319,3205,3207,3208,3219,3208,3219,3218,12,11,34,1094240,76
318,m1208,20120320,3219,3218,3199,3199,3058,3181,3168,-37,-50,68,2154660,48
319,m1208,20120321,3181,3168,3137,3178,3137,3168,3165,0,-3,26,823140,44
320,m1208,20120322,3168,3165,3193,3193,3180,3183,3184,18,19,18,573220,36
321,m1208,20120323,3183,3184,3167,3297,3167,3297,3221,113,37,54,1739500,56
322,m1208,20120326,3297,3221,3275,3275,3239,3263,3249,42,28,48,1559800,36
323,m1208,20120327,3263,3249,3267,3271,3261,3270,3264,21,15,30,979320,34
324,m1208,20120328,3270,3264,3266,3284,3266,3276,3277,12,13,20,655500,32
325,m1208,20120329,3276,3277,3266,3274,3262,3262,3269,-15,-8,50,1634760,28
326,m1208,20120330,3262,3269,3254,3254,3073,3244,3235,-25,-34,928,30028240,352
327,m1208,20120405,3244,3235,3346,3390,3333,3390,3349,155,114,66,2210900,348
328,m1208,20120406,3390,3349,3401,3405,3391,3391,3395,42,46,42,1426240,346
329,m1208,20120409,3391,3395,3394,3400,3385,3392,3391,-3,-4,12,406940,346
330,m1208,20120410,3392,3391,3381,3391,3380,3391,3385,0,-6,8,270820,346
331,m1208,20120411,3391,3385,3343,3375,3343,3362,3363,-23,-22,38,1278080,344
332,m1208,20120412,3362,3363,3341,3369,3341,3351,3355,-12,-8,16,536840,344
333,m1208,20120413,3351,3355,3389,3389,3380,3388,3385,33,30,26,880100,342
334,m1208,20120416,3388,3385,3351,3361,3341,3350,3347,-35,-38,370,12386540,286
335,m1208,20120417,3350,3347,3365,3374,3365,3370,3368,23,21,12,404220,288
336,m1208,20120418,3370,3368,3412,3412,3339,3357,3379,-11,11,86,2906780,298
337,m1208,20120419,3357,3379,3344,3359,3330,3350,3344,-29,-35,72,2408340,292
338,m1208,20120420,3350,3344,3359,3367,3355,3356,3359,12,15,18,604700,290
339,m1208,20120423,3356,3359,3415,3415,3393,3398,3400,39,41,44,1496260,288
340,m1208,20120424,3398,3400,3381,3388,3370,3373,3379,-27,-21,116,3920580,294
341,m1208,20120425,3373,3379,3384,3390,3384,3390,3385,11,6,66,2234180,236
342,m1208,20120426,3390,3385,3372,3372,3372,3372,3372,-13,-13,2,67440,236
343,m1208,20120427,3372,3372,3379,3418,3379,3418,3406,46,34,30,1021980,242
344,m1208,20120502,3418,3406,3416,3424,3416,3420,3421,14,15,20,684200,242
345,m1208,20120503,3420,3421,3430,3434,3421,3421,3426,0,5,36,1233620,256
346,m1208,20120504,3421,3426,3395,3450,3305,3443,3419,17,-7,340,11626120,330
347,m1208,20120507,3443,3419,3454,3471,3431,3434,3454,15,35,510,17620060,528
348,m1208,20120508,3434,3454,3425,3442,3425,3433,3436,-21,-18,236,8109640,504
349,m1208,20120509,3433,3436,3385,3414,3371,3398,3402,-38,-34,134,4558800,466
350,m1208,20120510,3398,3402,3410,3413,3391,3413,3402,11,0,82,2789700,462
351,m1208,20120511,3413,3402,3419,3419,3378,3379,3395,-23,-7,120,4074280,460
352,m1208,20120514,3379,3395,3340,3382,3305,3313,3328,-82,-67,408,13580900,438
353,m1208,20120515,3313,3328,3308,3340,3285,3308,3314,-20,-14,338,11201680,272
354,m1208,20120516,3308,3314,3295,3314,3232,3232,3277,-82,-37,218,7144300,166
355,m1208,20120517,3232,3277,3272,3313,3265,3307,3283,30,6,46,1510600,160
356,m1208,20120518,3307,3283,3283,3331,3282,3295,3297,12,14,50,1648760,158
357,m1208,20120521,3295,3297,3282,3315,3282,3300,3302,3,5,40,1321060,164
358,m1208,20120522,3300,3302,3329,3329,3284,3284,3299,-18,-3,22,725820,150
359,m1208,20120523,3284,3299,3212,3270,3212,3242,3238,-57,-61,54,1748920,170
360,m1208,20120524,3242,3238,3220,3289,3220,3266,3253,28,15,336,10930520,194
361,m1208,20120525,3266,3253,3294,3295,3251,3269,3267,16,14,28,914920,186
362,m1208,20120528,3269,3267,3269,3292,3244,3291,3268,24,1,44,1438220,198
363,m1208,20120529,3291,3268,3288,3303,3275,3300,3286,32,18,16,525820,194
364,m1208,20120530,3300,3286,3298,3312,3298,3299,3303,13,17,10,330380,192
365,m1208,20120531,3299,3303,3287,3287,3276,3277,3279,-26,-24,18,590280,182
366,m1208,20120601,3277,3279,3224,3240,3224,3239,3235,-40,-44,24,776500,180
367,m1208,20120604,3239,3235,3231,3243,3215,3215,3228,-20,-7,12,387460,176
368,m1208,20120605,3215,3228,3244,3268,3235,3267,3250,39,22,24,780060,170
369,m1208,20120606,3267,3250,3271,3298,3271,3298,3287,48,37,6,197240,172
370,m1208,20120607,3298,3287,3347,3347,3327,3331,3336,44,49,8,266880,170
371,m1208,20120608,3331,3336,3337,3337,3337,3337,3337,1,1,2,66740,172
372,m1208,20120611,3337,3337,3386,3410,3386,3410,3391,73,54,14,474840,170
373,m1208,20120612,3410,3391,3390,3395,3366,3391,3390,0,-1,68,2305400,112
374,m1208,20120613,3391,3390,3388,3388,3386,3386,3386,-4,-4,6,203200,110
375,m1208,20120614,3386,3386,3366,3366,3355,3359,3360,-27,-26,8,268840,108
376,m1208,20120615,3359,3360,3366,3366,3366,3366,3366,6,6,2,67320,110
377,m1208,20120618,3366,3366,3398,3399,3368,3375,3379,9,13,50,1689580,98
378,m1208,20120619,3375,3379,3408,3476,3408,3463,3465,84,86,32,1109100,100
379,m1208,20120620,3463,3465,3530,3530,3524,3524,3527,59,62,4,141080,104
380,m1208,20120621,3524,3527,3528,3528,3466,3470,3486,-57,-41,20,697200,104
381,m1208,20120625,3470,3486,3528,3560,3512,3540,3535,54,49,40,1414020,100
382,m1208,20120626,3540,3535,3528,3539,3528,3539,3537,4,2,22,778140,94
383,m1208,20120627,3539,3537,3528,3528,3528,3528,3528,-9,-9,2,70560,94
384,m1208,20120628,3528,3528,0,0,0,3528,3528,0,0,0,0,94
385,m1208,20120629,3528,3528,3455,3551,3455,3492,3488,-36,-40,8,279060,92
386,m1208,20120702,3492,3488,3536,3579,3520,3520,3534,32,46,60,2120600,100
387,m1208,20120703,3520,3534,3506,3506,3502,3502,3505,-32,-29,10,350500,102
388,m1208,20120704,3502,3505,3545,3546,3533,3546,3543,41,38,26,921320,104
389,m1208,20120705,3546,3543,3620,3639,3620,3639,3634,96,91,16,581480,94
390,m1208,20120706,3639,3634,0,0,0,3634,3634,0,0,0,0,94
391,m1208,20120709,3634,3634,3655,3756,3655,3756,3700,122,66,8,296020,92
392,m1208,20120710,3756,3700,3700,3789,3691,3691,3726,-9,26,6,223600,92
393,m1208,20120711,3691,3726,3776,3864,3775,3780,3791,54,65,12,454940,90
394,m1208,20120712,3780,3791,3847,3847,3730,3731,3766,-60,-25,8,301340,86
395,m1208,20120713,3731,3766,3766,3909,3731,3775,3771,9,5,50,1885880,44
396,m1208,20120716,3775,3771,3921,3921,3921,3921,3921,150,150,2,78420,44
397,m1208,20120717,3921,3921,4020,4055,3955,4018,3988,97,67,28,1116840,36
398,m1208,20120718,4018,3988,3989,3992,3925,3988,3977,0,-11,36,1432040,18
399,m1208,20120719,3988,3977,4097,4098,3983,4084,4067,107,90,26,1057540,22
400,m1208,20120720,4084,4067,0,0,0,4067,4067,0,0,0,0,22
401,m1208,20120723,4067,4067,4067,4228,4051,4186,4163,119,96,22,916000,24
402,m1208,20120724,4186,4163,4096,4267,4090,4166,4148,3,-15,46,1908140,24
403,m1208,20120725,4166,4148,4210,4220,4190,4190,4202,42,54,8,336200,24
404,m1208,20120726,4190,4202,4201,4249,4188,4188,4205,-14,3,32,1345660,24
405,m1208,20120727,4188,4205,4091,4099,4037,4037,4067,-168,-138,26,1057520,6
406,m1208,20120730,4037,4067,4220,4229,4220,4229,4224,162,157,4,168980,2
407,m1208,20120731,4229,4224,4172,4172,4172,4172,4172,-52,-52,2,83440,0
408,m1208,20120801,4172,4172,0,0,0,4172,4172,0,0,0,0,0
409,m1208,20120802,4172,4172,0,0,0,4172,4172,0,0,0,0,0
410,m1208,20120803,4172,4172,0,0,0,4172,4172,0,0,0,0,0
411,m1208,20120806,4172,4172,0,0,0,4172,4172,0,0,0,0,0
412,m1208,20120807,4172,4172,0,0,0,4172,4172,0,0,0,0,0
413,m1208,20120808,4172,4172,0,0,0,4172,4172,0,0,0,0,0
414,m1208,20120809,4172,4172,0,0,0,4172,4172,0,0,0,0,0
415,m1208,20120810,4172,4172,0,0,0,4172,4172,0,0,0,0,0
416,m1208,20120813,4172,4172,0,0,0,4172,4172,0,0,0,0,0
417,m1208,20120814,4172,4172,0,0,0,4172,4172,0,0,0,0,0
418,m1209,20120104,2951,2945,2972,2980,2964,2969,2971,24,26,227364,6755768340,510454
419,m1209,20120105,2969,2971,2975,2975,2954,2963,2964,-8,-7,275404,8164120580,512926
420,m1209,20120106,2963,2964,2940,2948,2935,2947,2940,-17,-24,211140,6209420020,521634
421,m1209,20120109,2947,2940,2941,2949,2928,2942,2938,2,-2,224392,6594157300,521452
422,m1209,20120110,2942,2938,2969,2994,2968,2983,2981,45,43,311038,9275114060,519050
423,m1209,20120111,2983,2981,2975,2982,2965,2976,2973,-5,-8,163234,4854534540,517996
424,m1209,20120112,2976,2973,2942,2948,2935,2947,2941,-26,-32,221864,6527103640,541124
425,m1209,20120113,2947,2941,2921,2929,2910,2913,2918,-28,-23,289144,8439706140,567416
426,m1209,20120116,2913,2918,2882,2886,2870,2873,2878,-45,-40,255018,7340568960,590288
427,m1209,20120117,2873,2878,2890,2909,2883,2909,2894,31,16,274990,7960393840,612510
428,m1209,20120118,2909,2894,2908,2914,2892,2893,2902,-1,8,196024,5689350920,591754
429,m1209,20120119,2893,2902,2904,2924,2896,2912,2904,10,2,176672,5131218620,562292
430,m1209,20120120,2912,2904,2922,2950,2918,2949,2932,45,28,177668,5209235380,566712
431,m1209,20120130,2949,2932,2953,2964,2947,2956,2955,24,23,195850,5787413200,557848
432,m1209,20120131,2956,2955,2934,2946,2930,2943,2940,-12,-15,188646,5546237320,592306
433,m1209,20120201,2943,2940,2951,2982,2949,2969,2968,29,28,383148,11373741020,639464
434,m1209,20120202,2969,2968,2979,2993,2968,2975,2980,7,12,334920,9981173880,672984
435,m1209,20120203,2975,2980,2980,2987,2969,2971,2977,-9,-3,250072,7445467580,673376
436,m1209,20120206,2971,2977,2995,3034,2992,3032,3018,55,41,495090,14942194760,730958
437,m1209,20120207,3032,3018,3024,3043,3010,3015,3025,-3,7,438038,13252804740,709532
438,m1209,20120208,3015,3025,3022,3039,3013,3038,3025,13,0,510496,15444409080,760520
439,m1209,20120209,3038,3025,3023,3030,3012,3017,3021,-8,-4,412092,12451481280,785072
440,m1209,20120210,3017,3021,3005,3009,2976,2983,2989,-38,-32,384016,11480567240,790358
441,m1209,20120213,2983,2989,3000,3021,2997,3018,3010,29,21,407776,12277164280,805634
442,m1209,20120214,3018,3010,3041,3051,3028,3029,3039,19,29,474862,14433394000,796614
443,m1209,20120215,3029,3039,3040,3045,3024,3025,3034,-14,-5,325758,9883884320,774540
444,m1209,20120216,3025,3034,3035,3038,3008,3025,3021,-9,-13,506434,15303456600,744586
445,m1209,20120217,3025,3021,3036,3069,3033,3067,3058,46,37,699098,21380854680,811528
446,m1209,20120220,3067,3058,3088,3095,3067,3072,3077,14,19,418966,12891683980,817220
447,m1209,20120221,3072,3077,3073,3086,3055,3082,3070,5,-7,431348,13246319160,814228
448,m1209,20120222,3082,3070,3073,3079,3061,3068,3068,-2,-2,346470,10630981000,798720
449,m1209,20120223,3068,3068,3071,3078,3058,3077,3065,9,-3,284436,8719245780,815642
450,m1209,20120224,3077,3065,3073,3086,3068,3078,3077,13,12,386252,11885821860,805468
451,m1209,20120227,3078,3077,3082,3111,3079,3106,3101,29,24,439986,13644457460,847480
452,m1209,20120228,3106,3101,3120,3136,3116,3136,3124,35,23,413072,12906966760,862720
453,m1209,20120229,3136,3124,3144,3145,3131,3138,3137,14,13,394670,12382155860,873724
454,m1209,20120301,3138,3137,3130,3153,3116,3117,3133,-20,-4,632522,19817720560,812498
455,m1209,20120302,3117,3133,3135,3160,3132,3158,3148,25,15,569264,17923402800,860822
456,m1209,20120305,3158,3148,3166,3190,3166,3184,3180,36,32,657680,20917763440,905672
457,m1209,20120306,3184,3180,3174,3187,3170,3181,3178,1,-2,535238,17011422080,923688
458,m1209,20120307,3181,3178,3186,3194,3155,3158,3174,-20,-4,1027704,32625205600,918524
459,m1209,20120308,3158,3174,3156,3171,3134,3140,3153,-34,-21,1124322,35460820920,861550
460,m1209,20120309,3140,3153,3159,3198,3155,3193,3176,40,23,914452,29047491940,837914
461,m1209,20120312,3193,3176,3173,3179,3151,3174,3165,-2,-11,800182,25327750600,877450
462,m1209,20120313,3174,3165,3171,3187,3168,3186,3179,21,14,689374,21917891920,883578
463,m1209,20120314,3186,3179,3198,3221,3191,3204,3208,25,29,890826,28580622240,930764
464,m1209,20120315,3204,3208,3215,3218,3196,3209,3207,1,-1,717426,23008450540,938290
465,m1209,20120316,3209,3207,3222,3225,3194,3205,3209,-2,2,668250,21446912120,939150
466,m1209,20120319,3205,3209,3221,3225,3207,3214,3215,5,6,529510,17024517120,894226
467,m1209,20120320,3214,3215,3205,3206,3169,3170,3182,-45,-33,696360,22161643660,884232
468,m1209,20120321,3170,3182,3160,3178,3160,3168,3167,-14,-15,480978,15237069760,861472
469,m1209,20120322,3168,3167,3180,3188,3173,3180,3180,13,13,662296,21066555880,906514
470,m1209,20120323,3180,3180,3198,3242,3194,3240,3219,60,39,1299288,41826174020,1111666
471,m1209,20120326,3240,3219,3255,3263,3242,3260,3252,41,33,951856,30961374640,1127392
472,m1209,20120327,3260,3252,3263,3282,3252,3279,3268,27,16,980782,32061401600,1234158
473,m1209,20120328,3279,3268,3265,3299,3262,3277,3280,9,12,1486784,48772572420,1308328
474,m1209,20120329,3277,3280,3284,3287,3256,3266,3270,-14,-10,1182612,38672530640,1238510
475,m1209,20120330,3266,3270,3255,3258,3229,3244,3240,-26,-30,949536,30773062980,1086190
476,m1209,20120405,3244,3240,3318,3389,3309,3384,3352,144,112,1427086,47844459780,1285884
477,m1209,20120406,3384,3352,3388,3414,3382,3400,3396,48,44,1629400,55344652520,1321574
478,m1209,20120409,3400,3396,3411,3419,3386,3392,3398,-4,2,1182096,40173532120,1302964
479,m1209,20120410,3392,3398,3388,3404,3373,3401,3390,3,-8,956452,32425353440,1253866
480,m1209,20120411,3401,3390,3370,3375,3344,3350,3356,-40,-34,848300,28472033500,1190246
481,m1209,20120412,3350,3356,3345,3360,3342,3356,3352,0,-4,574630,19263624780,1165334
482,m1209,20120413,3356,3352,3400,3403,3375,3382,3386,30,34,611410,20706601000,1177414
483,m1209,20120416,3382,3386,3345,3355,3335,3347,3343,-39,-43,573136,19162494280,1134876
484,m1209,20120417,3347,3343,3347,3385,3344,3384,3372,41,29,1107570,37349207420,1304822
485,m1209,20120418,3384,3372,3396,3403,3324,3351,3359,-21,-13,1878268,63109051440,1253602
486,m1209,20120419,3351,3359,3343,3358,3335,3356,3348,-3,-11,872626,29222526380,1208116
487,m1209,20120420,3356,3348,3350,3371,3341,3365,3359,17,11,835390,28065638040,1247926
488,m1209,20120423,3365,3359,3418,3427,3398,3401,3413,42,54,979188,33423182680,1225450
489,m1209,20120424,3401,3413,3380,3394,3363,3375,3379,-38,-34,825402,27894281380,1093000
490,m1209,20120425,3375,3379,3418,3418,3386,3389,3398,10,19,779180,26482794760,1039662
491,m1209,20120426,3389,3398,3379,3379,3361,3368,3370,-30,-28,397452,13396056940,975118
492,m1209,20120427,3368,3370,3378,3435,3373,3423,3409,53,39,1579178,53846195980,1213700
493,m1209,20120502,3423,3409,3438,3442,3416,3435,3428,26,19,953980,32703825800,1234562
494,m1209,20120503,3435,3428,3421,3444,3406,3418,3423,-10,-5,1733116,59340959500,1307168
495,m1209,20120504,3418,3423,3416,3450,3412,3448,3426,25,3,1018728,34910717420,1366300
496,m1209,20120507,3448,3426,3441,3447,3395,3408,3412,-18,-14,1237658,42230509320,1184774
497,m1209,20120508,3408,3412,3400,3418,3397,3401,3408,-11,-4,705644,24051254400,1155264
498,m1209,20120509,3401,3408,3367,3378,3354,3359,3365,-49,-43,699116,23531913560,1068216
499,m1209,20120510,3359,3365,3375,3379,3358,3378,3369,13,4,513898,17315199680,1039288
500,m1209,20120511,3378,3369,3388,3389,3333,3350,3359,-19,-10,650886,21865399820,1002934
501,m1209,20120514,3350,3359,3314,3320,3229,3241,3265,-118,-94,1037788,33884707680,926704
502,m1209,20120515,3241,3265,3222,3282,3219,3274,3257,9,-8,1486942,48431353340,973912
503,m1209,20120516,3274,3257,3268,3279,3192,3197,3235,-60,-22,1023916,33125509340,882018
504,m1209,20120517,3197,3235,3250,3300,3232,3289,3266,54,31,1918960,62681052100,1002462
505,m1209,20120518,3289,3266,3276,3308,3255,3292,3282,26,16,1297784,42595803060,989478
506,m1209,20120521,3292,3282,3300,3305,3264,3293,3284,11,2,979356,32162442200,936356
507,m1209,20120522,3293,3284,3285,3285,3258,3268,3269,-16,-15,691906,22622553500,879270
508,m1209,20120523,3268,3269,3210,3223,3193,3214,3210,-55,-59,596612,19156815140,820714
509,m1209,20120524,3214,3210,3231,3250,3222,3249,3237,39,27,669240,21666960220,840084
510,m1209,20120525,3249,3237,3242,3248,3218,3233,3231,-4,-6,507694,16403608060,822110
511,m1209,20120528,3233,3231,3240,3254,3224,3249,3237,18,6,432498,14003333880,790628
512,m1209,20120529,3249,3237,3232,3272,3231,3268,3250,31,13,410608,13345819560,733054
513,m1209,20120530,3268,3250,3260,3287,3253,3258,3269,8,19,643588,21041742920,734230
514,m1209,20120531,3258,3269,3245,3255,3236,3237,3246,-32,-23,293920,9540931760,685980
515,m1209,20120601,3237,3246,3188,3213,3188,3208,3203,-38,-43,380292,12181869280,651006
516,m1209,20120604,3208,3203,3205,3224,3164,3181,3187,-22,-16,465922,14852507640,599836
517,m1209,20120605,3181,3187,3200,3242,3190,3233,3218,46,31,380194,12235557600,593104
518,m1209,20120606,3233,3218,3230,3277,3229,3265,3260,47,42,298954,9748484640,586598
519,m1209,20120607,3265,3260,3299,3317,3295,3306,3305,46,45,312368,10325403280,579968
520,m1209,20120608,3306,3305,3330,3337,3300,3324,3320,19,15,396958,13181461340,594772
521,m1209,20120611,3324,3320,3338,3400,3338,3398,3375,78,55,447566,15106080680,623882
522,m1209,20120612,3398,3375,3375,3394,3372,3391,3382,16,7,327836,11089440100,576006
523,m1209,20120613,3391,3382,3388,3394,3371,3372,3380,-10,-2,200876,6791114480,555982
524,m1209,20120614,3372,3380,3343,3349,3318,3324,3332,-56,-48,257900,8594629840,515864
525,m1209,20120615,3324,3332,3325,3365,3325,3365,3351,33,19,187592,6287048380,512454
526,m1209,20120618,3365,3351,3361,3380,3338,3356,3354,5,3,188298,6315707740,510472
527,m1209,20120619,3356,3354,3380,3421,3369,3418,3406,64,52,282684,9628746140,494222
528,m1209,20120620,3418,3406,3440,3480,3440,3470,3456,64,50,193508,6687716460,469492
529,m1209,20120621,3470,3456,3446,3458,3414,3432,3432,-24,-24,210784,7236001120,416504
530,m1209,20120625,3432,3432,3422,3525,3422,3476,3494,44,62,336612,11762808140,399522
531,m1209,20120626,3476,3494,3498,3498,3470,3486,3480,-8,-14,116028,4038252460,370160
532,m1209,20120627,3486,3480,3475,3492,3466,3469,3474,-11,-6,77268,2684928120,359116
533,m1209,20120628,3469,3474,3480,3480,3441,3442,3452,-32,-22,67736,2338623920,345184
534,m1209,20120629,3442,3452,3446,3459,3422,3459,3444,7,-8,81196,2796559040,327540
535,m1209,20120702,3459,3444,3510,3516,3455,3461,3476,17,32,93560,3252789360,311316
536,m1209,20120703,3461,3476,3476,3484,3450,3484,3466,8,-10,72112,2499719740,303098
537,m1209,20120704,3484,3466,3500,3534,3484,3533,3509,67,43,99264,3483304660,282524
538,m1209,20120705,3533,3509,3530,3645,3528,3641,3608,132,99,352698,12727947640,278884
539,m1209,20120706,3641,3608,3650,3694,3624,3656,3661,48,53,392836,14384941780,269004
540,m1209,20120709,3656,3661,3681,3800,3665,3797,3748,136,87,571430,21418660860,260294
541,m1209,20120710,3797,3748,3773,3828,3745,3807,3792,59,44,489626,18568672740,263608
542,m1209,20120711,3807,3792,3820,3930,3777,3817,3837,25,45,844900,32426819980,260956
543,m1209,20120712,3817,3837,3811,3843,3754,3782,3789,-55,-48,627936,23796748500,257150
544,m1209,20120713,3782,3789,3818,3897,3800,3836,3838,47,49,570844,21909835020,239338
545,m1209,20120716,3836,3838,3902,3991,3901,3991,3957,153,119,725376,28708897260,264236
546,m1209,20120717,3991,3957,3988,3998,3828,3905,3907,-52,-50,667610,26086160480,209406
547,m1209,20120718,3905,3907,3940,3955,3896,3948,3924,41,17,311630,12230578940,201000
548,m1209,20120719,3948,3924,4000,4022,3962,4017,3994,93,70,326212,13031167520,199390
549,m1209,20120720,4017,3994,4000,4125,3990,4116,4073,122,79,610972,24889172440,225416
550,m1209,20120723,4116,4073,4070,4157,4044,4155,4120,82,47,660794,27226305260,247196
551,m1209,20120724,4155,4120,3956,4082,3956,4038,4033,-82,-87,1053668,42502041400,239956
552,m1209,20120725,4038,4033,4000,4055,3962,3964,3999,-69,-34,944548,37778726160,179210
553,m1209,20120726,3964,3999,4001,4022,3946,3987,3982,-12,-17,464070,18479756680,177160
554,m1209,20120727,3987,3982,3980,4005,3906,4002,3951,20,-31,688760,27218942440,214508
555,m1209,20120730,4002,3951,4080,4109,4067,4109,4098,158,147,243012,9960540160,213124
556,m1209,20120731,4109,4098,4120,4212,4100,4184,4170,86,72,475090,19812315980,160884
557,m1209,20120801,4184,4170,4178,4240,4162,4175,4195,5,25,232730,9763856140,131406
558,m1209,20120802,4175,4195,4136,4188,4130,4155,4157,-40,-38,162428,6753105660,115044
559,m1209,20120803,4155,4157,4104,4181,4094,4126,4136,-31,-21,111624,4617513560,100506
560,m1209,20120806,4126,4136,4106,4117,4051,4068,4071,-68,-65,59534,2423636960,83184
561,m1209,20120807,4068,4071,4086,4118,4044,4117,4077,46,6,51678,2107078320,64724
562,m1209,20120808,4117,4077,4077,4093,4065,4068,4077,-9,0,30158,1229710140,52704
563,m1209,20120809,4068,4077,4126,4126,4094,4115,4107,38,30,13216,542855160,50704
564,m1209,20120810,4115,4107,4188,4199,4156,4158,4168,51,61,18688,778971860,45054
565,m1209,20120813,4158,4168,4149,4180,4134,4141,4158,-27,-10,12294,511238000,39954
566,m1209,20120814,4141,4158,4116,4158,4114,4158,4132,0,-26,10704,442384880,35592
567,m1209,20120815,4158,4132,4167,4209,4149,4197,4177,65,45,13456,562123460,26976
568,m1209,20120816,4197,4177,4220,4228,4181,4194,4202,17,25,7178,301631300,22718
569,m1209,20120817,4194,4202,4210,4210,4184,4203,4200,1,-2,6312,265115860,17550
570,m1209,20120820,4203,4200,4221,4258,4212,4254,4241,54,41,6322,268163640,13212
571,m1209,20120821,4254,4241,4288,4382,4275,4367,4319,126,78,4948,213732080,10646
572,m1209,20120822,4367,4319,4382,4420,4382,4410,4403,91,84,3488,153599360,8272
573,m1209,20120823,4410,4403,4446,4455,4412,4421,4430,18,27,2796,123879900,7092
574,m1209,20120824,4421,4430,4400,4474,4400,4458,4446,28,16,1120,49803720,6826
575,m1209,20120827,4458,4446,4499,4529,4467,4483,4496,37,50,1854,83366540,6418
576,m1209,20120828,4483,4496,4451,4496,4451,4471,4472,-25,-24,1014,45356040,5704
577,m1209,20120829,4471,4472,4479,4550,4479,4544,4522,72,50,2964,134054320,4802
578,m1209,20120830,4544,4522,4594,4616,4572,4591,4591,69,69,1410,64738700,4634
579,m1209,20120831,4591,4591,4595,4615,4540,4591,4577,0,-14,2898,132644840,4378
580,m1209,20120903,4591,4577,4560,4634,4560,4634,4622,57,45,874,40402840,3820
581,m1209,20120904,4634,4622,4699,4699,4630,4638,4682,16,60,94,4401660,3800
582,m1209,20120905,4638,4682,4700,4700,4620,4620,4646,-62,-36,392,18214380,3602
583,m1209,20120906,4620,4646,4580,4580,4580,4580,4580,-66,-66,20,916000,3602
584,m1209,20120907,4580,4580,4570,4570,4570,4570,4570,-10,-10,200,9140000,3502
585,m1209,20120910,4570,4570,4550,4560,4550,4550,4550,-20,-20,1420,64614000,2698
586,m1209,20120911,4550,4550,4520,4520,4520,4520,4520,-30,-30,20,904000,2698
587,m1209,20120912,4520,4520,4520,4520,4480,4480,4480,-40,-40,1126,50452800,1572
588,m1209,20120913,4480,4480,4300,4552,4250,4552,4480,72,0,2878,128935600,1572
589,m1209,20120914,4552,4480,4500,4500,4500,4500,4527,20,47,2,90000,0
590,m1211,20120104,2982,2982,2999,3007,2999,3007,3002,25,20,14,420340,158
591,m1211,20120105,3007,3002,2992,2998,2992,2998,2995,-4,-7,6,179720,156
592,m1211,20120106,2998,2995,2970,2977,2970,2973,2973,-22,-22,6,178400,158
593,m1211,20120109,2973,2973,2966,2981,2966,2981,2975,8,2,16,476040,158
594,m1211,20120110,2981,2975,3000,3016,3000,3016,3009,41,34,14,421340,154
595,m1211,20120111,3016,3009,3009,3010,3006,3006,3008,-3,-1,6,180500,154
596,m1211,20120112,3006,3008,2981,2983,2969,2981,2977,-27,-31,42,1250460,158
597,m1211,20120113,2981,2977,2956,2961,2954,2954,2957,-23,-20,10,295740,154
598,m1211,20120116,2954,2957,2943,2943,2908,2916,2915,-41,-42,24,699700,146
599,m1211,20120117,2916,2915,2921,2932,2921,2932,2927,17,12,14,409860,142
600,m1211,20120118,2932,2927,2946,2946,2930,2930,2938,3,11,4,117520,142
601,m1211,20120119,2930,2938,2930,2933,2930,2933,2931,-5,-7,12,351720,130
602,m1211,20120120,2933,2931,2946,2967,2932,2967,2953,36,22,12,354360,124
603,m1211,20120130,2967,2953,2981,2992,2981,2992,2987,39,34,14,418240,126
604,m1211,20120131,2992,2987,2938,2972,2938,2972,2960,-15,-27,12,355280,128
605,m1211,20120201,2972,2960,3000,3012,3000,3007,3005,47,45,20,601040,126
606,m1211,20120202,3007,3005,3007,3010,3003,3010,3006,5,1,14,420900,128
607,m1211,20120203,3010,3006,2998,2998,2993,2993,2996,-13,-10,8,239720,126
608,m1211,20120206,2993,2996,3029,3062,3028,3062,3043,66,47,30,912940,132
609,m1211,20120207,3062,3043,3054,3060,3036,3038,3048,-5,5,66,2012260,122
610,m1211,20120208,3038,3048,3045,3055,3037,3054,3048,6,0,12,365760,122
611,m1211,20120209,3054,3048,3044,3048,3036,3036,3042,-12,-6,56,1704020,124
612,m1211,20120210,3036,3042,3015,3018,3013,3013,3015,-29,-27,66,1990240,122
613,m1211,20120213,3013,3015,3033,3046,3032,3040,3037,25,22,28,850620,122
614,m1211,20120214,3040,3037,3057,3058,3035,3035,3053,-2,16,32,977080,104
615,m1211,20120215,3035,3053,0,0,0,3053,3053,0,0,0,0,104
616,m1211,20120216,3053,3053,3035,3056,3035,3040,3042,-13,-11,30,912720,102
617,m1211,20120217,3040,3042,3071,3084,3071,3077,3076,35,34,10,307680,104
618,m1211,20120220,3077,3076,3083,3089,3070,3078,3077,2,1,56,1723180,122
619,m1211,20120221,3078,3077,3076,3098,3066,3096,3087,19,10,38,1173240,118
620,m1211,20120222,3096,3087,3073,3087,3073,3078,3079,-9,-8,18,554240,114
621,m1211,20120223,3078,3079,3072,3078,3072,3078,3077,-1,-2,18,553860,128
622,m1211,20120224,3078,3077,3104,3104,3079,3090,3088,13,11,32,988400,128
623,m1211,20120227,3090,3088,3115,3134,3097,3126,3124,38,36,258,8060560,138
624,m1211,20120228,3126,3124,3142,3147,3134,3147,3139,23,15,38,1193020,126
625,m1211,20120229,3147,3139,0,0,0,3139,3139,0,0,0,0,126
626,m1211,20120301,3139,3139,3139,3158,3132,3132,3143,-7,4,10,314300,124
627,m1211,20120302,3132,3143,3162,3173,3156,3166,3160,23,17,20,632180,120
628,m1211,20120305,3166,3160,3191,3198,3188,3192,3194,32,34,32,1022200,128
629,m1211,20120306,3192,3194,3182,3191,3179,3185,3184,-9,-10,62,1974560,116
630,m1211,20120307,3185,3184,3182,3204,3170,3170,3179,-14,-5,102,3242880,116
631,m1211,20120308,3170,3179,3169,3169,3142,3142,3155,-37,-24,48,1514680,108
632,m1211,20120309,3142,3155,3171,3200,3171,3200,3183,45,28,28,891420,116
633,m1211,20120312,3200,3183,3189,3189,3164,3176,3177,-7,-6,34,1080280,116
634,m1211,20120313,3176,3177,3189,3189,3178,3189,3183,12,6,12,382000,110
635,m1211,20120314,3189,3183,3214,3216,3197,3205,3206,22,23,24,769540,106
636,m1211,20120315,3205,3206,3203,3216,3198,3208,3208,2,2,54,1732440,78
637,m1211,20120316,3208,3208,3219,3219,3200,3208,3210,0,2,22,706220,76
638,m1211,20120319,3208,3210,3280,3280,3208,3214,3222,4,12,20,644420,78
639,m1211,20120320,3214,3222,3210,3210,3180,3181,3186,-41,-36,24,764640,74
640,m1211,20120321,3181,3186,3165,3189,3165,3187,3179,1,-7,20,635900,80
641,m1211,20120322,3187,3179,3199,3199,3184,3188,3191,9,12,58,1850920,88
642,m1211,20120323,3188,3191,3208,3239,3208,3239,3223,48,32,40,1289240,94
643,m1211,20120326,3239,3223,3244,3264,3244,3254,3254,31,31,58,1887880,90
644,m1211,20120327,3254,3254,3274,3285,3274,3285,3278,31,24,18,590180,88
645,m1211,20120328,3285,3278,3258,3272,3258,3270,3267,-8,-11,8,261400,84
646,m1211,20120329,3270,3267,3274,3275,3257,3275,3268,8,1,20,653680,84
647,m1211,20120330,3275,3268,3250,3250,3236,3241,3242,-27,-26,26,843020,74
648,m1211,20120405,3241,3242,3293,3369,3172,3367,3312,125,70,132,4372200,84
649,m1211,20120406,3367,3312,3395,3398,3361,3390,3382,78,70,42,1420680,84
650,m1211,20120409,3390,3382,3433,3433,3384,3384,3391,2,9,36,1221040,88
651,m1211,20120410,3384,3391,3390,3412,3378,3390,3391,-1,0,70,2374120,80
652,m1211,20120411,3390,3391,3342,3358,3331,3344,3346,-47,-45,192,6425100,98
653,m1211,20120412,3344,3346,3337,3349,3337,3349,3342,3,-4,30,1002760,110
654,m1211,20120413,3349,3342,3373,3378,3339,3365,3369,23,27,42,1415160,134
655,m1211,20120416,3365,3369,3336,3346,3316,3325,3325,-44,-44,32,1064040,136
656,m1211,20120417,3325,3325,3327,3371,3327,3364,3360,39,35,100,3360760,126
657,m1211,20120418,3364,3360,3396,3396,3317,3340,3337,-20,-23,98,3271060,126
658,m1211,20120419,3340,3337,3330,3343,3329,3343,3331,6,-6,52,1732380,102
659,m1211,20120420,3343,3331,3345,3354,3340,3346,3346,15,15,14,468520,104
660,m1211,20120423,3346,3346,3415,3415,3350,3380,3393,34,47,50,1696900,108
661,m1211,20120424,3380,3393,3380,3380,3349,3353,3360,-40,-33,78,2620840,120
662,m1211,20120425,3353,3360,3389,3389,3380,3380,3384,20,24,4,135380,120
663,m1211,20120426,3380,3384,3351,3362,3351,3362,3358,-22,-26,66,2216800,130
664,m1211,20120427,3362,3358,3375,3400,3361,3391,3373,33,15,64,2159060,112
665,m1211,20120502,3391,3373,3386,3404,3386,3404,3392,31,19,30,1017700,118
666,m1211,20120503,3404,3392,3391,3396,3368,3373,3386,-19,-6,40,1354600,126
667,m1211,20120504,3373,3386,3375,3383,3356,3383,3374,-3,-12,16,539980,132
668,m1211,20120507,3383,3374,3356,3394,3356,3366,3365,-8,-9,40,1346040,124
669,m1211,20120508,3366,3365,3366,3373,3345,3348,3357,-17,-8,40,1342860,126
670,m1211,20120509,3348,3357,3297,3324,3293,3308,3306,-49,-51,44,1455060,116
671,m1211,20120510,3308,3306,3321,3321,3308,3308,3312,2,6,6,198740,110
672,m1211,20120511,3308,3312,3312,3315,3274,3281,3298,-31,-14,56,1846980,88
673,m1211,20120514,3281,3298,3244,3244,3175,3179,3203,-119,-95,60,1922020,90
674,m1211,20120515,3179,3203,3179,3196,3163,3187,3181,-16,-22,16,509040,90
675,m1211,20120516,3187,3181,3191,3191,3139,3139,3172,-42,-9,56,1776780,76
676,m1211,20120517,3139,3172,3181,3265,3167,3216,3203,44,31,26,832920,84
677,m1211,20120518,3216,3203,3162,3242,3162,3204,3193,1,-10,114,3640340,82
678,m1211,20120521,3204,3193,3192,3222,3192,3216,3203,23,10,16,512520,72
679,m1211,20120522,3216,3203,3192,3205,3192,3195,3196,-8,-7,14,447460,72
680,m1211,20120523,3195,3196,3195,3195,3133,3146,3149,-50,-47,18,566860,76
681,m1211,20120524,3146,3149,3160,3185,3160,3176,3173,27,24,32,1015640,64
682,m1211,20120525,3176,3173,3180,3180,3154,3170,3168,-3,-5,52,1647740,72
683,m1211,20120528,3170,3168,3169,3195,3169,3190,3185,22,17,38,1210540,80
684,m1211,20120529,3190,3185,3181,3221,3181,3221,3200,36,15,24,768060,76
685,m1211,20120530,3221,3200,3220,3229,3220,3223,3223,23,23,14,451260,76
686,m1211,20120531,3223,3223,3204,3214,3204,3204,3210,-19,-13,24,770420,66
687,m1211,20120601,3204,3210,3179,3183,3178,3178,3180,-32,-30,14,445200,62
688,m1211,20120604,3178,3180,3158,3175,3158,3168,3168,-12,-12,30,950480,66
689,m1211,20120605,3168,3168,3170,3229,3170,3220,3200,52,32,44,1408220,62
690,m1211,20120606,3220,3200,3231,3256,3231,3241,3240,41,40,22,712880,56
691,m1211,20120607,3241,3240,3274,3288,3267,3267,3274,27,34,18,589380,56
692,m1211,20120608,3267,3274,3282,3306,3266,3283,3284,9,10,16,525480,50
693,m1211,20120611,3283,3284,3338,3354,3338,3350,3347,66,63,46,1539960,66
694,m1211,20120612,3350,3347,3321,3330,3321,3330,3326,-17,-21,10,332640,64
695,m1211,20120613,3330,3326,3282,3336,3282,3312,3312,-14,-14,10,331260,60
696,m1211,20120614,3312,3312,3270,3274,3254,3273,3266,-39,-46,10,326660,58
697,m1211,20120615,3273,3266,3273,3304,3273,3284,3286,18,20,8,262900,58
698,m1211,20120618,3284,3286,3299,3299,3298,3299,3298,13,12,14,461840,70
699,m1211,20120619,3299,3298,3330,3380,3330,3380,3355,82,57,18,603980,70
700,m1211,20120620,3380,3355,3438,3438,3394,3396,3402,41,47,12,408260,76
701,m1211,20120621,3396,3402,3423,3423,3395,3395,3404,-7,2,12,408540,72
702,m1211,20120625,3395,3404,0,0,0,3404,3404,0,0,0,0,72
703,m1211,20120626,3404,3404,3467,3468,3450,3467,3462,63,58,18,623160,80
704,m1211,20120627,3467,3462,3456,3456,3442,3452,3452,-10,-10,10,345220,78
705,m1211,20120628,3452,3452,3461,3461,3428,3430,3441,-22,-11,24,825840,74
706,m1211,20120629,3430,3441,3430,3446,3421,3446,3434,5,-7,14,480820,70
707,m1211,20120702,3446,3434,3460,3460,3440,3440,3450,6,16,4,138000,68
708,m1211,20120703,3440,3450,3432,3463,3432,3455,3447,5,-3,54,1861440,72
709,m1211,20120704,3455,3447,3497,3516,3497,3515,3507,68,60,10,350780,74
710,m1211,20120705,3515,3507,3558,3594,3558,3589,3573,82,66,60,2144280,90
711,m1211,20120706,3589,3573,3603,3621,3572,3597,3601,24,28,42,1512500,84
712,m1211,20120709,3597,3601,3637,3719,3637,3719,3679,118,78,68,2501720,106
713,m1211,20120710,3719,3679,3691,3728,3691,3709,3713,30,34,22,816960,106
714,m1211,20120711,3709,3713,3747,3802,3668,3710,3753,-3,40,38,1426500,104
715,m1211,20120712,3710,3753,3700,3748,3700,3724,3716,-29,-37,786,29208240,598
716,m1211,20120713,3724,3716,3781,3839,3758,3839,3802,123,86,402,15286940,604
717,m1211,20120716,3839,3802,3944,3954,3860,3951,3934,149,132,176,6923840,612
718,m1211,20120717,3951,3934,4038,4038,3881,3930,3926,-4,-8,328,12877340,588
719,m1211,20120718,3930,3926,3930,3955,3916,3945,3931,19,5,564,22176120,916
720,m1211,20120719,3945,3931,3966,4020,3966,4019,4001,88,70,838,33533960,1540
721,m1211,20120720,4019,4001,4010,4147,4000,4115,4065,114,64,200,8131500,1544
722,m1211,20120723,4115,4065,4092,4127,4037,4107,4093,42,28,152,6221400,1536
723,m1211,20120724,4107,4093,3950,4020,3930,4000,3988,-93,-105,472,18826540,1534
724,m1211,20120725,4000,3988,3958,4004,3925,3953,3977,-35,-11,1904,75735080,2828
725,m1211,20120726,3953,3977,3981,3997,3952,3974,3971,-3,-6,456,18109680,2882
726,m1211,20120727,3974,3971,3970,3985,3912,3985,3945,14,-26,1058,41747820,2890
727,m1211,20120730,3985,3945,4044,4102,4044,4102,4094,157,149,506,20718880,3106
728,m1211,20120731,4102,4094,4130,4235,4101,4191,4164,97,70,888,36979160,3098
729,m1211,20120801,4191,4164,4173,4235,4160,4179,4197,15,33,1202,50455540,3284
730,m1211,20120802,4179,4197,4106,4180,4106,4154,4155,-43,-42,1590,66067700,3596
731,m1211,20120803,4154,4155,4122,4175,4101,4125,4137,-30,-18,1208,49976940,3642
732,m1211,20120806,4125,4137,4098,4105,4069,4080,4082,-57,-55,1086,44334340,3618
733,m1211,20120807,4080,4082,4081,4110,4038,4108,4073,26,-9,7064,287760020,8538
734,m1211,20120808,4108,4073,4086,4086,4038,4044,4049,-29,-24,3496,141563920,10696
735,m1211,20120809,4044,4049,4086,4086,4062,4070,4069,21,20,1568,63806600,11174
736,m1211,20120810,4070,4069,4131,4149,4115,4125,4127,56,58,1164,48042920,11370
737,m1211,20120813,4125,4127,4125,4135,4100,4119,4123,-8,-4,2066,85187300,12484
738,m1211,20120814,4119,4123,4100,4126,4075,4122,4097,-1,-26,1470,60228640,12448
739,m1211,20120815,4122,4097,4105,4170,4105,4168,4144,71,47,884,36634700,12450
740,m1211,20120816,4168,4144,4185,4185,4144,4145,4155,1,11,912,37893620,12458
741,m1211,20120817,4145,4155,4150,4178,4142,4176,4165,21,10,1176,48987500,13136
742,m1211,20120820,4176,4165,4194,4235,4186,4230,4220,65,55,1754,74030600,13586
743,m1211,20120821,4230,4220,4270,4340,4270,4336,4313,116,93,1234,53229960,13732
744,m1211,20120822,4336,4313,4355,4395,4349,4383,4371,70,58,1542,67407900,14440
745,m1211,20120823,4383,4371,4376,4429,4374,4385,4400,14,29,2044,89948420,14750
746,m1211,20120824,4385,4400,4370,4448,4370,4447,4419,47,19,2102,92904020,15544
747,m1211,20120827,4447,4419,4477,4537,4477,4494,4505,75,86,1984,89391040,15554
748,m1211,20120828,4494,4505,4430,4490,4430,4475,4479,-30,-26,2668,119518200,15570
749,m1211,20120829,4475,4479,4480,4525,4480,4525,4509,46,30,3312,149342800,15752
750,m1211,20120830,4525,4509,4540,4555,4513,4540,4532,31,23,1108,50215620,15724
751,m1211,20120831,4540,4532,4540,4545,4508,4541,4523,9,-9,1606,72645060,16272
752,m1211,20120903,4541,4523,4540,4639,4540,4625,4608,102,85,1562,71992460,16126
753,m1211,20120904,4625,4608,4627,4650,4612,4642,4636,34,28,1334,61847980,16134
754,m1211,20120905,4642,4636,4630,4630,4603,4605,4610,-31,-26,986,45460060,15974
755,m1211,20120906,4605,4610,4567,4570,4513,4534,4542,-76,-68,1136,51602380,15602
756,m1211,20120907,4534,4542,4569,4588,4516,4516,4545,-26,3,896,40728840,15408
757,m1211,20120910,4516,4545,4528,4549,4499,4540,4533,-5,-12,1544,70001360,15206
758,m1211,20120911,4540,4533,4510,4539,4466,4472,4488,-61,-45,1404,63023880,14944
759,m1211,20120912,4472,4488,4461,4478,4448,4461,4460,-27,-28,1220,54412000,15012
760,m1211,20120913,4461,4460,4500,4512,4483,4483,4495,23,35,920,41359100,15332
761,m1211,20120914,4483,4495,4510,4546,4501,4502,4518,7,23,1132,51151040,15334
762,m1211,20120917,4502,4518,4492,4492,4356,4357,4422,-161,-96,1394,61643660,15142
763,m1211,20120918,4357,4422,4212,4340,4212,4280,4287,-142,-135,1508,64661780,14822
764,m1211,20120919,4280,4287,4336,4342,4285,4306,4302,19,15,606,26076000,14828
765,m1211,20120920,4306,4302,4322,4322,4259,4304,4301,2,-1,610,26241820,14810
766,m1211,20120921,4304,4301,4258,4290,4247,4276,4270,-25,-31,2032,86773440,14264
767,m1211,20120924,4276,4270,4259,4259,4160,4218,4185,-52,-85,1756,73493780,12980
768,m1211,20120925,4218,4185,4245,4263,4201,4233,4235,48,50,572,24228680,12990
769,m1211,20120926,4233,4235,4218,4249,4218,4239,4228,4,-7,718,30363600,12950
770,m1211,20120927,4239,4228,4201,4240,4201,4223,4229,-5,1,4970,210202880,13494
771,m1211,20120928,4223,4229,4216,4249,4202,4225,4218,-4,-11,270,11388940,13450
772,m1211,20121008,4225,4218,4220,4220,4111,4124,4146,-94,-72,2830,117354960,13762
773,m1211,20121009,4124,4146,4139,4139,4118,4121,4128,-25,-18,1162,47968500,13378
774,m1211,20121010,4121,4128,4112,4112,4008,4015,4030,-113,-98,4048,163145220,14372
775,m1211,20121011,4015,4030,3997,4038,3991,3997,4009,-33,-21,7056,282930500,11594
776,m1211,20121012,3997,4009,4030,4030,3950,3951,3984,-58,-25,2398,95538580,10848
777,m1211,20121015,3951,3984,3901,3920,3849,3850,3868,-134,-116,2538,98188420,9402
778,m1211,20121016,3850,3868,3868,3922,3860,3874,3876,6,8,698,27056840,8962
779,m1211,20121017,3874,3876,3870,3870,3836,3860,3848,-16,-28,2798,107692960,6874
780,m1211,20121018,3860,3848,3853,3908,3853,3895,3895,47,47,892,34749120,6230
781,m1211,20121019,3895,3895,3917,3919,3890,3910,3901,15,6,500,19507000,5838
782,m1211,20121022,3910,3901,3920,3920,3897,3911,3904,10,3,540,21084180,5398
783,m1211,20121023,3911,3904,3904,3904,3841,3841,3882,-63,-22,492,19103480,5130
784,m1211,20121024,3841,3882,3869,3897,3831,3894,3895,12,13,718,27967280,4458
785,m1211,20121025,3894,3895,3880,3888,3865,3881,3877,-14,-18,106,4110540,4464
786,m1211,20121026,3881,3877,3861,3888,3840,3855,3841,-22,-36,1030,39564640,3452
787,m1211,20121029,3855,3841,3834,3839,3806,3806,3812,-35,-29,88,3355320,3370
788,m1211,20121030,3806,3812,3815,3830,3750,3830,3750,18,-62,3384,126914980,12
789,m1211,20121031,3830,3750,3748,3748,3705,3705,3721,-45,-29,12,446620,2
790,m1211,20121101,3705,3721,3701,3701,3701,3701,3701,-20,-20,2,74020,0
791,m1211,20121102,3701,3701,0,0,0,3701,3701,0,0,0,0,0
792,m1211,20121105,3701,3701,0,0,0,3701,3701,0,0,0,0,0
793,m1211,20121106,3701,3701,0,0,0,3701,3701,0,0,0,0,0
794,m1211,20121107,3701,3701,0,0,0,3701,3701,0,0,0,0,0
795,m1211,20121108,3701,3701,0,0,0,3701,3701,0,0,0,0,0
796,m1211,20121109,3701,3701,0,0,0,3701,3701,0,0,0,0,0
797,m1211,20121112,3701,3701,0,0,0,3701,3701,0,0,0,0,0
798,m1211,20121113,3701,3701,0,0,0,3701,3701,0,0,0,0,0
799,m1211,20121114,3701,3701,0,0,0,3701,3701,0,0,0,0,0
800,m1212,20120104,2990,2994,3026,3026,3003,3020,3019,26,25,26,785160,66
801,m1212,20120105,3020,3019,3020,3020,3012,3017,3017,-2,-2,8,241360,64
802,m1212,20120106,3017,3017,3003,3003,3003,3003,3003,-14,-14,2,60060,66
803,m1212,20120109,3003,3003,2989,3000,2989,3000,2992,-3,-11,6,179560,66
804,m1212,20120110,3000,2992,3031,3031,3031,3031,3031,39,39,2,60620,66
805,m1212,20120111,3031,3031,3024,3031,3023,3031,3025,0,-6,8,242060,68
806,m1212,20120112,3031,3025,3003,3004,2985,2998,2999,-27,-26,14,419900,68
807,m1212,20120113,2998,2999,2967,2978,2967,2978,2971,-21,-28,10,297140,64
808,m1212,20120116,2978,2971,2889,2954,2889,2927,2922,-44,-49,20,584520,66
809,m1212,20120117,2927,2922,2988,2988,2940,2961,2955,39,33,10,295520,66
810,m1212,20120118,2961,2955,2952,2952,2952,2952,2952,-3,-3,2,59040,64
811,m1212,20120119,2952,2952,2951,2951,2951,2951,2951,-1,-1,2,59020,62
812,m1212,20120120,2951,2951,2994,2998,2977,2998,2989,47,38,12,358680,60
813,m1212,20120130,2998,2989,2993,3010,2993,3007,3003,18,14,6,180200,60
814,m1212,20120131,3007,3003,2990,2990,2980,2980,2986,-23,-17,6,179200,58
815,m1212,20120201,2980,2986,3019,3019,3019,3019,3019,33,33,2,60380,58
816,m1212,20120202,3019,3019,3030,3030,2993,3012,3011,-7,-8,6,180700,56
817,m1212,20120203,3012,3011,0,0,0,3011,3011,0,0,0,0,56
818,m1212,20120206,3011,3011,3047,3047,3047,3047,3047,36,36,2,60940,56
819,m1212,20120207,3047,3047,3060,3060,3054,3054,3057,7,10,6,183460,54
820,m1212,20120208,3054,3057,3061,3061,3061,3061,3061,4,4,2,61220,54
821,m1212,20120209,3061,3061,3052,3076,3052,3068,3065,7,4,14,429180,60
822,m1212,20120210,3068,3065,3038,3038,3010,3010,3017,-55,-48,8,241360,54
823,m1212,20120213,3010,3017,3040,3054,3036,3040,3043,23,26,24,730420,62
824,m1212,20120214,3040,3043,3062,3062,3051,3051,3056,8,13,4,122260,60
825,m1212,20120215,3051,3056,3054,3054,3053,3053,3053,-3,-3,4,122140,56
826,m1212,20120216,3053,3053,3061,3062,3041,3045,3050,-8,-3,10,305060,56
827,m1212,20120217,3045,3050,3083,3088,3083,3088,3085,38,35,4,123420,58
828,m1212,20120220,3088,3085,0,0,0,3085,3085,0,0,0,0,58
829,m1212,20120221,3085,3085,3092,3092,3092,3092,3092,7,7,2,61840,60
830,m1212,20120222,3092,3092,3085,3085,3085,3085,3085,-7,-7,2,61700,58
831,m1212,20120223,3085,3085,3091,3091,3091,3091,3091,6,6,2,61820,60
832,m1212,20120224,3091,3091,3115,3115,3094,3112,3110,21,19,52,1617420,68
833,m1212,20120227,3112,3110,3109,3109,3109,3109,3109,-1,-1,12,373080,68
834,m1212,20120228,3109,3109,3147,3154,3126,3146,3142,37,33,26,816940,70
835,m1212,20120229,3146,3142,3145,3175,3145,3166,3164,24,22,10,316460,66
836,m1212,20120301,3166,3164,3152,3165,3152,3165,3158,1,-6,4,126340,66
837,m1212,20120302,3165,3158,3155,3160,3155,3160,3157,2,-1,4,126300,66
838,m1212,20120305,3160,3157,0,0,0,3157,3157,0,0,0,0,66
839,m1212,20120306,3157,3157,3192,3192,3189,3189,3190,32,33,4,127620,66
840,m1212,20120307,3189,3190,3173,3173,3173,3173,3173,-17,-17,2,63460,66
841,m1212,20120308,3173,3173,3158,3158,3155,3155,3156,-18,-17,4,126260,68
842,m1212,20120309,3155,3156,3185,3186,3185,3186,3185,30,29,4,127420,70
843,m1212,20120312,3186,3185,3178,3182,3178,3182,3180,-3,-5,4,127200,74
844,m1212,20120313,3182,3180,3184,3184,3184,3184,3184,4,4,2,63680,72
845,m1212,20120314,3184,3184,3210,3210,3208,3208,3209,24,25,4,128360,68
846,m1212,20120315,3208,3209,3229,3229,3198,3198,3213,-11,4,12,385620,68
847,m1212,20120316,3198,3213,0,0,0,3213,3213,0,0,0,0,68
848,m1212,20120319,3213,3213,3220,3220,3216,3216,3217,3,4,14,450460,66
849,m1212,20120320,3216,3217,3196,3196,3192,3192,3194,-25,-23,4,127760,66
850,m1212,20120321,3192,3194,3165,3178,3165,3178,3165,-16,-29,84,2658860,144
851,m1212,20120322,3178,3165,3189,3189,3178,3188,3186,23,21,10,318620,146
852,m1212,20120323,3188,3186,3220,3230,3217,3230,3224,44,38,62,1999360,122
853,m1212,20120326,3230,3224,3244,3250,3244,3250,3249,26,25,22,714880,122
854,m1212,20120327,3250,3249,3260,3263,3260,3262,3261,13,12,6,195700,122
855,m1212,20120328,3262,3261,3260,3264,3253,3264,3258,3,-3,16,521320,120
856,m1212,20120329,3264,3258,3241,3241,3241,3241,3241,-17,-17,4,129640,118
857,m1212,20120330,3241,3241,3212,3212,3203,3205,3207,-36,-34,24,769820,114
858,m1212,20120405,3205,3207,3319,3345,3319,3345,3332,138,125,14,466560,108
859,m1212,20120406,3345,3332,3359,3381,3359,3380,3375,48,43,16,540100,104
860,m1212,20120409,3380,3375,3385,3386,3381,3381,3384,6,9,18,609280,98
861,m1212,20120410,3381,3384,3372,3382,3363,3382,3374,-2,-10,12,404920,96
862,m1212,20120411,3382,3374,3320,3320,3320,3320,3320,-54,-54,6,199200,96
863,m1212,20120412,3320,3320,0,0,0,3320,3320,0,0,0,0,96
864,m1212,20120413,3320,3320,3434,3434,3363,3370,3379,50,59,26,878620,104
865,m1212,20120416,3370,3379,3332,3332,3317,3324,3324,-55,-55,34,1130400,100
866,m1212,20120417,3324,3324,3324,3336,3318,3334,3325,10,1,38,1263500,106
867,m1212,20120418,3334,3325,3332,3332,3290,3303,3304,-22,-21,146,4824180,110
868,m1212,20120419,3303,3304,3306,3316,3306,3316,3311,12,7,46,1523100,112
869,m1212,20120420,3316,3311,3292,3316,3292,3316,3308,5,-3,22,727800,112
870,m1212,20120423,3316,3308,3350,3415,3340,3349,3351,41,43,144,4826620,118
871,m1212,20120424,3349,3351,3325,3359,3325,3331,3343,-20,-8,66,2206740,100
872,m1212,20120425,3331,3343,3367,3374,3351,3358,3361,15,18,46,1546160,106
873,m1212,20120426,3358,3361,3328,3334,3323,3330,3328,-31,-33,14,466000,108
874,m1212,20120427,3330,3328,3348,3358,3325,3347,3338,19,10,60,2002960,116
875,m1212,20120502,3347,3338,3365,3383,3360,3360,3365,22,27,26,875120,110
876,m1212,20120503,3360,3365,3357,3361,3335,3335,3351,-30,-14,20,670220,102
877,m1212,20120504,3335,3351,3335,3362,3301,3362,3334,11,-17,218,7268120,152
878,m1212,20120507,3362,3334,3359,3359,3324,3333,3333,-1,-1,62,2066920,110
879,m1212,20120508,3333,3333,3320,3358,3320,3326,3334,-7,1,22,733580,110
880,m1212,20120509,3326,3334,3287,3301,3256,3272,3271,-62,-63,46,1504980,104
881,m1212,20120510,3272,3271,3277,3287,3272,3286,3278,15,7,18,590060,104
882,m1212,20120511,3286,3278,3296,3296,3240,3240,3272,-38,-6,24,785380,96
883,m1212,20120514,3240,3272,3191,3220,3160,3160,3183,-112,-89,246,7831280,52
884,m1212,20120515,3160,3183,3116,3180,3116,3155,3162,-28,-21,84,2656760,60
885,m1212,20120516,3155,3162,3161,3162,3126,3129,3147,-33,-15,16,503520,54
886,m1212,20120517,3129,3147,3173,3185,3142,3185,3159,38,12,26,821340,54
887,m1212,20120518,3185,3159,3162,3175,3158,3169,3170,10,11,18,570680,64
888,m1212,20120521,3169,3170,3199,3206,3182,3194,3196,24,26,10,319640,64
889,m1212,20120522,3194,3196,3197,3197,3185,3188,3190,-8,-6,18,574200,58
890,m1212,20120523,3188,3190,3160,3160,3130,3137,3143,-53,-47,34,1068940,56
891,m1212,20120524,3137,3143,3136,3183,3136,3183,3156,40,13,20,631320,62
892,m1212,20120525,3183,3156,3145,3172,3145,3170,3164,14,8,18,569560,66
893,m1212,20120528,3170,3164,3162,3198,3162,3198,3187,34,23,24,764880,64
894,m1212,20120529,3198,3187,3181,3198,3181,3196,3190,9,3,36,1148400,64
895,m1212,20120530,3196,3190,3188,3203,3188,3191,3193,1,3,16,510960,60
896,m1212,20120531,3191,3193,3185,3185,3184,3184,3184,-9,-9,4,127380,56
897,m1212,20120601,3184,3184,3159,3172,3150,3150,3160,-34,-24,22,695300,54
898,m1212,20120604,3150,3160,3139,3142,3119,3128,3132,-32,-28,12,375860,56
899,m1212,20120605,3128,3132,3160,3205,3160,3205,3187,73,55,16,510040,66
900,m1212,20120606,3205,3187,3230,3246,3226,3233,3232,46,45,46,1487100,66
901,m1212,20120607,3233,3232,3265,3265,3220,3254,3255,22,23,54,1757880,54
902,m1212,20120608,3254,3255,3240,3251,3212,3251,3234,-4,-21,66,2134940,52
903,m1212,20120611,3251,3234,3297,3330,3278,3317,3313,83,79,48,1590340,50
904,m1212,20120612,3317,3313,3295,3313,3295,3304,3302,-9,-11,38,1255020,46
905,m1212,20120613,3304,3302,3312,3312,3284,3284,3297,-18,-5,78,2571880,56
906,m1212,20120614,3284,3297,3245,3245,3245,3245,3245,-52,-52,2,64900,54
907,m1212,20120615,3245,3245,3297,3297,3269,3269,3283,24,38,4,131320,54
908,m1212,20120618,3269,3283,3277,3288,3263,3288,3274,5,-9,16,523980,54
909,m1212,20120619,3288,3274,3316,3367,3316,3366,3350,92,76,122,4087000,64
910,m1212,20120620,3366,3350,3420,3420,3393,3419,3400,69,50,154,5236000,72
911,m1212,20120621,3419,3400,3400,3437,3400,3422,3410,22,10,40,1364340,62
912,m1212,20120625,3422,3410,3498,3541,3481,3490,3520,80,110,46,1619260,54
913,m1212,20120626,3490,3520,3492,3492,3467,3485,3474,-35,-46,98,3404880,68
914,m1212,20120627,3485,3474,3442,3469,3442,3458,3454,-16,-20,148,5113040,68
915,m1212,20120628,3458,3454,3459,3459,3419,3419,3443,-35,-11,28,964100,62
916,m1212,20120629,3419,3443,3456,3456,3411,3453,3442,10,-1,36,1239160,48
917,m1212,20120702,3453,3442,3508,3508,3442,3470,3455,28,13,218,7532980,52
918,m1212,20120703,3470,3455,3434,3473,3429,3460,3436,5,-19,244,8384220,54
919,m1212,20120704,3460,3436,3477,3541,3477,3516,3508,80,72,42,1473700,64
920,m1212,20120705,3516,3508,3532,3592,3532,3585,3548,77,40,152,5393700,58
921,m1212,20120706,3585,3548,3597,3627,3587,3590,3609,42,61,26,938420,66
922,m1212,20120709,3590,3609,3566,3721,3566,3705,3643,96,34,138,5028280,84
923,m1212,20120710,3705,3643,3684,3740,3680,3717,3694,74,51,94,3472980,108
924,m1212,20120711,3717,3694,3743,3836,3665,3695,3740,1,46,206,7705500,124
925,m1212,20120712,3695,3740,3681,3703,3642,3703,3678,-37,-62,290,10668560,220
926,m1212,20120713,3703,3678,3727,3805,3712,3805,3747,127,69,188,7045280,244
927,m1212,20120716,3805,3747,3850,3896,3850,3896,3884,149,137,94,3651060,288
928,m1212,20120717,3896,3884,4056,4056,3806,3868,3892,-16,8,134,5215380,246
929,m1212,20120718,3868,3892,3900,3903,3862,3902,3883,10,-9,228,8853800,296
930,m1212,20120719,3902,3883,3957,4003,3930,4003,3971,120,88,598,23751720,716
931,m1212,20120720,4003,3971,3990,4095,3990,4083,4025,112,54,226,9097180,712
932,m1212,20120723,4083,4025,4035,4080,3990,4080,4047,55,22,166,6719620,712
933,m1212,20120724,4080,4047,3907,3997,3890,3928,3919,-119,-128,92,3606380,710
934,m1212,20120725,3928,3919,3935,3936,3891,3905,3917,-14,-2,132,5170720,710
935,m1212,20120726,3905,3917,3939,3939,3893,3915,3907,-2,-10,52,2031900,710
936,m1212,20120727,3915,3907,3899,3920,3866,3920,3895,13,-12,104,4050840,720
937,m1212,20120730,3920,3895,3993,4050,3993,4050,4033,155,138,164,6615620,772
938,m1212,20120731,4050,4033,4053,4164,4053,4132,4092,99,59,68,2783020,766
939,m1212,20120801,4132,4092,4124,4152,4085,4095,4132,3,40,212,8761480,810
940,m1212,20120802,4095,4132,4084,4109,4045,4069,4067,-63,-65,192,7810520,776
941,m1212,20120803,4069,4067,4062,4098,4031,4042,4066,-25,-1,172,6994880,792
942,m1212,20120806,4042,4066,4035,4035,3990,4001,4011,-65,-55,66,2647660,794
943,m1212,20120807,4001,4011,3999,4016,3964,4012,3993,1,-18,118,4711840,796
944,m1212,20120808,4012,3993,3991,3992,3960,3960,3974,-33,-19,116,4610200,778
945,m1212,20120809,3960,3974,3960,3999,3958,3986,3976,12,2,974,38730620,962
946,m1212,20120810,3986,3976,3986,4063,3986,4025,4026,49,50,274,11033460,1058
947,m1212,20120813,4025,4026,4002,4025,4000,4022,4012,-4,-14,672,26961700,826
948,m1212,20120814,4022,4012,4003,4036,4003,4035,4013,23,1,430,17257800,810
949,m1212,20120815,4035,4013,4030,4094,4030,4078,4063,65,50,120,4876280,810
950,m1212,20120816,4078,4063,4141,4141,4070,4084,4079,21,16,252,10281460,942
951,m1212,20120817,4084,4079,4097,4108,4075,4105,4091,26,12,144,5891080,968
952,m1212,20120820,4105,4091,4133,4160,4133,4154,4149,63,58,82,3402400,970
953,m1212,20120821,4154,4149,4212,4287,4184,4274,4238,125,89,180,7628800,982
954,m1212,20120822,4274,4238,4276,4329,4276,4293,4296,55,58,314,13492280,986
955,m1212,20120823,4293,4296,4330,4341,4291,4299,4315,3,19,198,8544360,976
956,m1212,20120824,4299,4315,4292,4340,4241,4338,4322,23,7,248,10718660,1044
957,m1212,20120827,4338,4322,4352,4429,4352,4395,4409,73,87,146,6437320,1014
958,m1212,20120828,4395,4409,4346,4382,4346,4371,4371,-38,-38,84,3671880,1000
959,m1212,20120829,4371,4371,4395,4448,4371,4413,4403,42,32,148,6517600,958
960,m1212,20120830,4413,4403,4456,4456,4394,4436,4423,33,20,72,3184680,962
961,m1212,20120831,4436,4423,4423,4434,4376,4414,4401,-9,-22,144,6338800,964
962,m1212,20120903,4414,4401,4430,4534,4429,4476,4484,75,83,122,5471020,986
963,m1212,20120904,4476,4484,4504,4537,4490,4535,4514,51,30,102,4604520,986
964,m1212,20120905,4535,4514,4508,4512,4498,4504,4507,-10,-7,100,4507760,930
965,m1212,20120906,4504,4507,4470,4470,4401,4417,4429,-90,-78,110,4872460,926
966,m1212,20120907,4417,4429,4429,4451,4402,4409,4431,-20,2,80,3545160,922
967,m1212,20120910,4409,4431,4393,4438,4391,4430,4414,-1,-17,102,4502520,924
968,m1212,20120911,4430,4414,4379,4420,4305,4368,4385,-46,-29,166,7279460,934
969,m1212,20120912,4368,4385,4335,4379,4335,4366,4364,-19,-21,228,9950780,910
970,m1212,20120913,4366,4364,4405,4411,4392,4392,4404,28,40,112,4932700,902
971,m1212,20120914,4392,4404,4458,4458,4408,4408,4418,4,14,276,12194360,962
972,m1212,20120917,4408,4418,4351,4377,4270,4270,4328,-148,-90,416,18006900,958
973,m1212,20120918,4270,4328,4201,4238,4178,4188,4210,-140,-118,352,14820080,880
974,m1212,20120919,4188,4210,4232,4234,4182,4200,4205,-10,-5,196,8242720,870
975,m1212,20120920,4200,4205,4189,4265,4176,4201,4202,-4,-3,166,6975720,902
976,m1212,20120921,4201,4202,4159,4193,4155,4188,4169,-14,-33,132,5504360,882
977,m1212,20120924,4188,4169,4111,4153,4080,4129,4108,-40,-61,698,28676680,1000
978,m1212,20120925,4129,4108,4134,4173,4134,4158,4159,50,51,246,10231900,942
979,m1212,20120926,4158,4159,4131,4154,4130,4136,4140,-23,-19,60,2484220,960
980,m1212,20120927,4136,4140,4138,4161,4103,4146,4126,6,-14,60,2475860,954
981,m1212,20120928,4146,4126,4127,4130,4118,4123,4123,-3,-3,52,2144080,950
982,m1212,20121008,4123,4123,4104,4121,4025,4030,4082,-93,-41,906,36989180,1014
983,m1212,20121009,4030,4082,4049,4061,4005,4030,4031,-52,-51,362,14593700,1030
984,m1212,20121010,4030,4031,3988,3988,3935,3944,3959,-87,-72,180,7126580,1030
985,m1212,20121011,3944,3959,3932,3981,3915,3938,3947,-21,-12,352,13896300,1000
986,m1212,20121012,3938,3947,3940,3954,3877,3877,3894,-70,-53,316,12307960,946
987,m1212,20121015,3877,3894,3832,3858,3771,3783,3801,-111,-93,198,7527480,890
988,m1212,20121016,3783,3801,3797,3818,3770,3791,3800,-10,-1,68,2584120,904
989,m1212,20121017,3791,3800,3791,3791,3761,3785,3781,-15,-19,92,3479240,840
990,m1212,20121018,3785,3781,3867,3867,3815,3824,3835,43,54,142,5447000,850
991,m1212,20121019,3824,3835,3848,3860,3834,3844,3846,9,11,20,769240,848
992,m1212,20121022,3844,3846,3860,3885,3823,3858,3860,12,14,262,10115080,836
993,m1212,20121023,3858,3860,3860,3860,3822,3825,3839,-35,-21,320,12286600,820
994,m1212,20121024,3825,3839,3848,3882,3848,3864,3866,25,27,112,4330600,772
995,m1212,20121025,3864,3866,3861,3865,3843,3865,3853,-1,-13,46,1772420,766
996,m1212,20121026,3865,3853,3839,3854,3837,3843,3846,-10,-7,476,18307740,724
997,m1212,20121029,3843,3846,3770,3850,3754,3780,3779,-66,-67,140,5291660,696
998,m1212,20121030,3780,3779,3751,3762,3751,3760,3759,-19,-20,216,8121260,728
999,m1212,20121031,3760,3759,3757,3770,3752,3770,3762,11,3,128,4815680,736
1000,m1212,20121101,3770,3762,3795,3833,3715,3831,3782,69,20,420,15885920,748
1001,m1212,20121102,3831,3782,3827,3827,3772,3772,3807,-10,25,26,989960,730
1002,m1212,20121105,3772,3807,3750,3758,3750,3753,3754,-54,-53,10,375460,722
1003,m1212,20121106,3753,3754,3773,3788,3773,3780,3782,26,28,18,680860,712
1004,m1212,20121107,3780,3782,3780,3780,3760,3762,3763,-20,-19,64,2408600,658
1005,m1212,20121108,3762,3763,3711,3744,3711,3735,3733,-28,-30,14,522740,656
1006,m1212,20121109,3735,3733,3702,3740,3702,3731,3731,-2,-2,34,1268740,638
1007,m1212,20121112,3731,3731,3612,3617,3582,3582,3588,-149,-143,72,2583440,582
1008,m1212,20121113,3582,3588,3491,3597,3491,3531,3554,-57,-34,28,995220,574
1009,m1212,20121114,3531,3554,3550,3560,3541,3554,3547,0,-7,64,2270680,560
1010,m1212,20121115,3554,3547,3542,3542,3542,3542,3542,-5,-5,2,70840,558
1011,m1212,20121116,3542,3542,3487,3487,3487,3487,3487,-55,-55,2,69740,558
1012,m1212,20121119,3487,3487,3530,3530,3470,3494,3494,7,7,548,19147980,552
1013,m1212,20121120,3494,3494,3520,3525,3480,3525,3487,31,-7,32,1115900,532
1014,m1212,20121121,3525,3487,3524,3524,3502,3510,3512,23,25,26,913360,540
1015,m1212,20121122,3510,3512,3565,3565,3520,3520,3558,8,46,14,498200,532
1016,m1212,20121123,3520,3558,3578,3578,3578,3578,3578,20,20,2,71560,532
1017,m1212,20121126,3578,3578,3590,3590,3590,3590,3590,12,12,2,71800,532
1018,m1212,20121127,3590,3590,0,0,0,3590,3590,0,0,0,0,532
1019,m1212,20121128,3590,3590,0,0,0,3590,3590,0,0,0,0,532
1020,m1212,20121129,3590,3590,3699,3699,3650,3650,3670,60,80,528,19379160,12
1021,m1212,20121130,3650,3670,3789,3800,3789,3800,3794,130,124,8,303580,6
1022,m1212,20121203,3800,3794,0,0,0,3794,3794,0,0,0,0,6
1023,m1212,20121204,3794,3794,0,0,0,3794,3794,0,0,0,0,6
1024,m1212,20121205,3794,3794,3800,3800,3800,3800,3800,6,6,6,228000,0
1025,m1212,20121206,3800,3800,0,0,0,3800,3800,0,0,0,0,0
1026,m1212,20121207,3800,3800,0,0,0,3800,3800,0,0,0,0,0
1027,m1212,20121210,3800,3800,0,0,0,3800,3800,0,0,0,0,0
1028,m1212,20121211,3800,3800,0,0,0,3800,3800,0,0,0,0,0
1029,m1212,20121212,3800,3800,0,0,0,3800,3800,0,0,0,0,0
1030,m1212,20121213,3800,3800,0,0,0,3800,3800,0,0,0,0,0
1031,m1212,20121214,3800,3800,0,0,0,3800,3800,0,0,0,0,0
1032,m1301,20120119,2924,2933,2939,2955,2936,2950,2942,17,9,154,4530800,274
1033,m1301,20120120,2950,2942,2960,3000,2956,2998,2977,56,35,518,15424820,648
1034,m1301,20120130,2998,2977,3030,3030,2999,3010,3007,33,30,1098,33020720,1142
1035,m1301,20120131,3010,3007,3000,3002,2988,3001,2995,-6,-12,2180,65312680,2390
1036,m1301,20120201,3001,2995,3015,3042,3008,3030,3027,35,32,4476,135524540,5370
1037,m1301,20120202,3030,3027,3040,3048,3003,3007,3020,-20,-7,11018,332829000,13366
1038,m1301,20120203,3007,3020,3015,3020,3002,3006,3012,-14,-8,2324,70002080,13648
1039,m1301,20120206,3006,3012,3030,3064,3026,3063,3047,51,35,4126,125754120,14408
1040,m1301,20120207,3063,3047,3055,3070,3040,3050,3054,3,7,4448,135852100,15718
1041,m1301,20120208,3050,3054,3050,3065,3046,3064,3054,10,0,3666,111989160,17006
1042,m1301,20120209,3064,3054,3052,3059,3045,3047,3052,-7,-2,4784,146019400,19066
1043,m1301,20120210,3047,3052,3030,3041,3007,3012,3017,-40,-35,7856,237083540,23384
1044,m1301,20120213,3012,3017,3030,3043,3025,3038,3035,21,18,13852,420513340,32998
1045,m1301,20120214,3038,3035,3054,3066,3043,3045,3053,10,18,24184,738446580,45716
1046,m1301,20120215,3045,3053,3051,3065,3051,3052,3059,-1,6,10808,330674300,44042
1047,m1301,20120216,3052,3059,3060,3064,3034,3046,3044,-13,-15,13836,421221020,49432
1048,m1301,20120217,3046,3044,3051,3090,3051,3089,3080,45,36,28548,879333400,56322
1049,m1301,20120220,3089,3080,3100,3115,3092,3099,3099,19,19,11544,357818620,57984
1050,m1301,20120221,3099,3099,3100,3121,3088,3114,3106,15,7,16604,515737040,60070
1051,m1301,20120222,3114,3106,3105,3110,3099,3103,3103,-3,-3,9114,282810980,60264
1052,m1301,20120223,3103,3103,3105,3112,3095,3111,3100,8,-3,4598,142583500,60646
1053,m1301,20120224,3111,3100,3110,3132,3108,3126,3121,26,21,20220,631124640,63958
1054,m1301,20120227,3126,3121,3120,3151,3120,3145,3141,24,20,13134,412571600,64030
1055,m1301,20120228,3145,3141,3157,3176,3157,3175,3165,34,24,12426,393391920,66970
1056,m1301,20120229,3175,3165,3178,3183,3169,3177,3175,12,10,16574,526378700,74354
1057,m1301,20120301,3177,3175,3166,3186,3152,3153,3168,-22,-7,25360,803429200,83388
1058,m1301,20120302,3153,3168,3168,3191,3168,3189,3181,21,13,26416,840499320,87990
1059,m1301,20120305,3189,3181,3186,3215,3186,3210,3208,29,27,26234,841596440,98534
1060,m1301,20120306,3210,3208,3200,3209,3196,3207,3203,-1,-5,22208,711414080,107642
1061,m1301,20120307,3207,3203,3218,3218,3186,3187,3202,-16,-1,31432,1006539320,110710
1062,m1301,20120308,3187,3202,3195,3199,3168,3171,3184,-31,-18,28290,900854980,112202
1063,m1301,20120309,3171,3184,3188,3224,3187,3222,3206,38,22,47936,1537063240,133642
1064,m1301,20120312,3222,3206,3204,3205,3180,3200,3191,-6,-15,35098,1120126640,130946
1065,m1301,20120313,3200,3191,3195,3208,3192,3207,3201,16,10,19442,622528900,136692
1066,m1301,20120314,3207,3201,3220,3240,3210,3220,3226,19,25,42124,1359202360,137318
1067,m1301,20120315,3220,3226,3226,3235,3214,3221,3222,-5,-4,43630,1405859180,148670
1068,m1301,20120316,3221,3222,3232,3235,3198,3210,3215,-12,-7,36576,1176226380,161570
1069,m1301,20120319,3210,3215,3220,3228,3213,3219,3221,4,6,20790,669762440,166228
1070,m1301,20120320,3219,3221,3212,3214,3182,3183,3196,-38,-25,45288,1447708440,183410
1071,m1301,20120321,3183,3196,3173,3190,3171,3187,3182,-9,-14,21240,676062640,185478
1072,m1301,20120322,3187,3182,3193,3204,3190,3200,3199,18,17,33408,1068808680,185818
1073,m1301,20120323,3200,3199,3211,3251,3211,3249,3233,50,34,68092,2201723580,205748
1074,m1301,20120326,3249,3233,3265,3275,3250,3273,3261,40,28,80304,2619231380,239542
1075,m1301,20120327,3273,3261,3270,3278,3263,3270,3268,9,7,73730,2409928240,257574
1076,m1301,20120328,3270,3268,3259,3275,3254,3261,3265,-7,-3,80532,2629662760,264416
1077,m1301,20120329,3261,3265,3265,3268,3233,3241,3249,-24,-16,55584,1806002380,261602
1078,m1301,20120330,3241,3249,3235,3238,3200,3209,3212,-40,-37,68768,2209471520,261722
1079,m1301,20120405,3209,3212,3299,3362,3282,3354,3326,142,114,148804,4949269600,287654
1080,m1301,20120406,3354,3326,3370,3406,3355,3394,3382,68,56,282944,9570513620,364246
1081,m1301,20120409,3394,3382,3420,3420,3379,3384,3392,2,10,201418,6834006200,408690
1082,m1301,20120410,3384,3392,3383,3404,3365,3400,3386,8,-6,295616,10012329960,484304
1083,m1301,20120411,3400,3386,3364,3367,3286,3337,3339,-49,-47,355648,11876635680,499690
1084,m1301,20120412,3337,3339,3336,3350,3326,3350,3340,11,1,205142,6851791460,532220
1085,m1301,20120413,3350,3340,3389,3394,3366,3370,3377,30,37,361536,12209946440,590812
1086,m1301,20120416,3370,3377,3320,3333,3310,3312,3318,-65,-59,325608,10806829200,601458
1087,m1301,20120417,3312,3318,3310,3339,3308,3330,3326,12,8,436960,14535039320,622132
1088,m1301,20120418,3330,3326,3344,3346,3262,3286,3293,-40,-33,958626,31567933800,654578
1089,m1301,20120419,3286,3293,3279,3312,3268,3310,3297,17,4,872588,28776986920,769100
1090,m1301,20120420,3310,3297,3307,3309,3282,3301,3297,4,0,876034,28886267440,777322
1091,m1301,20120423,3301,3297,3337,3354,3333,3340,3342,43,45,1026984,34331527860,853664
1092,m1301,20120424,3340,3342,3318,3352,3308,3332,3329,-10,-13,1628242,54220094200,994696
1093,m1301,20120425,3332,3329,3375,3378,3344,3348,3356,19,27,1426074,47867296080,1098788
1094,m1301,20120426,3348,3356,3328,3337,3315,3320,3323,-36,-33,880434,29262268360,1049908
1095,m1301,20120427,3320,3323,3330,3348,3319,3345,3336,22,13,1031878,34425233000,986548
1096,m1301,20120502,3345,3336,3377,3383,3355,3355,3364,19,28,956082,32164150720,978488
1097,m1301,20120503,3355,3364,3342,3358,3320,3324,3338,-40,-26,1153090,38497527460,965586
1098,m1301,20120504,3324,3338,3323,3360,3317,3359,3336,21,-2,1335296,44554047680,1005022
1099,m1301,20120507,3359,3336,3345,3351,3299,3310,3316,-26,-20,1211198,40173095520,905438
1100,m1301,20120508,3310,3316,3312,3324,3288,3294,3307,-22,-9,1694042,56022699440,979704
1101,m1301,20120509,3294,3307,3270,3274,3238,3241,3254,-66,-53,1658756,53991367080,990414
1102,m1301,20120510,3241,3254,3255,3271,3242,3264,3256,10,2,1461632,47600875440,983060
1103,m1301,20120511,3264,3256,3275,3277,3218,3226,3247,-30,-9,2211598,71823024060,1003872
1104,m1301,20120514,3226,3247,3200,3203,3118,3118,3147,-129,-100,1782962,56119071300,871298
1105,m1301,20120515,3118,3147,3096,3137,3066,3134,3115,-13,-32,2249656,70083642740,865000
1106,m1301,20120516,3134,3115,3128,3144,3068,3081,3108,-34,-7,2826682,87866164220,1002510
1107,m1301,20120517,3081,3108,3140,3155,3102,3146,3132,38,24,2639240,82665530540,886684
1108,m1301,20120518,3146,3132,3120,3146,3106,3129,3125,-3,-7,2607696,81515569980,950322
1109,m1301,20120521,3129,3125,3130,3165,3118,3152,3146,27,21,2379778,74870760080,982102
1110,m1301,20120522,3152,3146,3140,3145,3126,3137,3136,-9,-10,1964758,61616775300,994146
1111,m1301,20120523,3137,3136,3073,3084,3058,3079,3073,-57,-63,2034986,62543884960,1009746
1112,m1301,20120524,3079,3073,3091,3119,3086,3117,3101,44,28,1548172,48021395440,945712
1113,m1301,20120525,3117,3101,3109,3116,3089,3107,3104,6,3,1520406,47197286080,957234
1114,m1301,20120528,3107,3104,3118,3143,3104,3137,3124,33,20,1450712,45324564680,968156
1115,m1301,20120529,3137,3124,3131,3175,3126,3174,3149,50,25,1689710,53213655740,1008848
1116,m1301,20120530,3174,3149,3160,3180,3152,3156,3164,7,15,1532924,48506891420,972440
1117,m1301,20120531,3156,3164,3140,3161,3136,3145,3151,-19,-13,1393710,43920134560,1025282
1118,m1301,20120601,3145,3151,3100,3128,3098,3109,3111,-42,-40,1208900,37614698780,974084
1119,m1301,20120604,3109,3111,3101,3121,3060,3082,3082,-29,-29,2625156,80916791300,1237880
1120,m1301,20120605,3082,3082,3102,3154,3091,3141,3124,59,42,2401438,75022993120,1130010
1121,m1301,20120606,3141,3124,3135,3196,3135,3179,3175,55,51,2150032,68272020400,1052744
1122,m1301,20120607,3179,3175,3218,3231,3199,3209,3214,34,39,1487766,47826368960,1015434
1123,m1301,20120608,3209,3214,3231,3239,3191,3223,3217,9,3,1955548,62916326060,1054860
1124,m1301,20120611,3223,3217,3242,3304,3234,3302,3275,85,58,2009872,65838495000,1132252
1125,m1301,20120612,3302,3275,3280,3296,3267,3295,3283,20,8,1901296,62428289860,1114306
1126,m1301,20120613,3295,3283,3300,3300,3263,3267,3275,-16,-8,1672566,54776929880,1109822
1127,m1301,20120614,3267,3275,3242,3250,3217,3224,3230,-51,-45,1662182,53692063100,1090538
1128,m1301,20120615,3224,3230,3230,3266,3226,3264,3253,34,23,1532838,49868273740,1065248
1129,m1301,20120618,3264,3253,3270,3289,3243,3267,3261,14,8,1616418,52725288100,1097512
1130,m1301,20120619,3267,3261,3306,3367,3295,3361,3344,100,83,2521126,84323663080,1251342
1131,m1301,20120620,3361,3344,3392,3426,3380,3416,3398,72,54,2045142,69508669780,1395668
1132,m1301,20120621,3416,3398,3390,3422,3382,3416,3403,18,5,2431646,82751374780,1464328
1133,m1301,20120625,3416,3403,3449,3538,3446,3491,3504,88,101,2860462,1.00241E+11,1464248
1134,m1301,20120626,3491,3504,3509,3513,3474,3500,3489,-4,-15,2227942,77751287660,1487256
1135,m1301,20120627,3500,3489,3489,3510,3479,3486,3490,-3,1,1816696,63410058300,1465564
1136,m1301,20120628,3486,3490,3487,3491,3449,3454,3464,-36,-26,2165076,75017909000,1369332
1137,m1301,20120629,3454,3464,3465,3483,3436,3482,3464,18,0,1795272,62205067240,1332990
1138,m1301,20120702,3482,3464,3530,3532,3461,3469,3486,5,22,1923996,67087484960,1368826
1139,m1301,20120703,3469,3486,3480,3493,3458,3492,3476,6,-10,2397482,83344752160,1407910
1140,m1301,20120704,3492,3476,3512,3555,3502,3552,3534,76,58,2712622,95878132620,1573620
1141,m1301,20120705,3552,3534,3550,3638,3543,3634,3595,100,61,3249702,1.1684E+11,1711714
1142,m1301,20120706,3634,3595,3650,3656,3606,3621,3627,26,32,2844354,1.03185E+11,1716538
1143,m1301,20120709,3621,3627,3635,3755,3627,3752,3697,125,70,4307634,1.59265E+11,1962606
1144,m1301,20120710,3752,3697,3732,3757,3704,3748,3734,51,37,3699580,1.38153E+11,2037140
1145,m1301,20120711,3748,3734,3745,3878,3695,3721,3768,-13,34,7363376,2.77458E+11,1882632
1146,m1301,20120712,3721,3768,3690,3702,3651,3668,3675,-100,-93,3895584,1.43187E+11,1876390
1147,m1301,20120713,3668,3675,3705,3775,3702,3771,3732,96,57,4066192,1.51775E+11,1975760
1148,m1301,20120716,3771,3732,3881,3881,3850,3881,3876,149,144,1358656,52666022380,2109882
1149,m1301,20120717,3881,3876,3932,3952,3751,3838,3847,-38,-29,5107070,1.96483E+11,1951086
1150,m1301,20120718,3838,3847,3876,3908,3837,3891,3868,44,21,4903664,1.89675E+11,2091592
1151,m1301,20120719,3891,3868,3934,3947,3891,3945,3924,77,56,3778866,1.48285E+11,2037774
1152,m1301,20120720,3945,3924,3932,3999,3911,3997,3962,73,38,3812526,1.5106E+11,2186350
1153,m1301,20120723,3997,3962,3948,3966,3873,3961,3935,-1,-27,4017616,1.58102E+11,2074366
1154,m1301,20120724,3961,3935,3778,3838,3778,3791,3806,-144,-129,3586408,1.36509E+11,1843406
1155,m1301,20120725,3791,3806,3750,3831,3737,3744,3796,-62,-10,4772058,1.81161E+11,1763770
1156,m1301,20120726,3744,3796,3799,3799,3752,3787,3777,-9,-19,3584050,1.35394E+11,1881122
1157,m1301,20120727,3787,3777,3768,3820,3745,3813,3778,36,1,3320266,1.25466E+11,1924754
1158,m1301,20120730,3813,3778,3900,3929,3880,3929,3918,151,140,1551380,60786963340,2028144
1159,m1301,20120731,3929,3918,3918,4007,3910,4003,3968,85,50,3689814,1.46414E+11,2257532
1160,m1301,20120801,4003,3968,4002,4048,3967,3974,4012,6,44,4122746,1.6542E+11,2221546
1161,m1301,20120802,3974,4012,3948,3982,3918,3952,3950,-60,-62,4863714,1.92129E+11,2302538
1162,m1301,20120803,3952,3950,3930,3986,3888,3926,3939,-24,-11,5037830,1.98462E+11,2346640
1163,m1301,20120806,3926,3939,3900,3909,3842,3869,3863,-70,-76,3455168,1.33505E+11,2270588
1164,m1301,20120807,3869,3863,3866,3914,3830,3912,3867,49,4,4475904,1.73113E+11,2453854
1165,m1301,20120808,3912,3867,3879,3886,3830,3835,3857,-32,-10,3819214,1.47324E+11,2227580
1166,m1301,20120809,3835,3857,3865,3884,3842,3861,3864,4,7,3144608,1.21525E+11,2138420
1167,m1301,20120810,3861,3864,3937,3942,3900,3921,3921,57,57,3047880,1.19508E+11,2197404
1168,m1301,20120813,3921,3921,3905,3910,3868,3868,3887,-53,-34,2309012,89756580720,2204618
1169,m1301,20120814,3868,3887,3842,3871,3817,3870,3842,-17,-45,2978566,1.14455E+11,2241964
1170,m1301,20120815,3870,3842,3861,3938,3856,3927,3901,85,59,3520554,1.3737E+11,2374892
1171,m1301,20120816,3927,3901,3941,3948,3884,3888,3908,-13,7,2617216,1.02281E+11,2255654
1172,m1301,20120817,3888,3908,3896,3915,3875,3900,3896,-8,-12,2010334,78341479920,2217714
1173,m1301,20120820,3900,3896,3915,3969,3914,3956,3950,60,54,2860252,1.13003E+11,2404998
1174,m1301,20120821,3956,3950,4000,4096,4000,4088,4057,138,107,3483306,1.41347E+11,2569800
1175,m1301,20120822,4088,4057,4111,4144,4098,4134,4122,77,65,2820540,1.1627E+11,2532816
1176,m1301,20120823,4134,4122,4151,4185,4116,4130,4146,8,24,3298936,1.36792E+11,2493654
1177,m1301,20120824,4130,4146,4110,4189,4105,4187,4157,41,11,2734652,1.13691E+11,2612452
1178,m1301,20120827,4187,4157,4230,4290,4215,4237,4249,80,92,3196404,1.35823E+11,2545154
1179,m1301,20120828,4237,4249,4200,4230,4188,4202,4207,-47,-42,2693302,1.13317E+11,2541258
1180,m1301,20120829,4202,4207,4215,4263,4196,4260,4227,53,20,2968380,1.25488E+11,2572396
1181,m1301,20120830,4260,4227,4270,4287,4217,4262,4255,35,28,3170010,1.34888E+11,2520434
1182,m1301,20120831,4262,4255,4245,4253,4212,4235,4229,-20,-26,2967250,1.25512E+11,2643374
1183,m1301,20120903,4235,4229,4253,4361,4244,4341,4313,112,84,3112052,1.34238E+11,2573612
1184,m1301,20120904,4341,4313,4336,4369,4323,4366,4346,53,33,2151336,93513282560,2485108
1185,m1301,20120905,4366,4346,4321,4335,4306,4312,4319,-34,-27,1727916,74629264820,2391172
1186,m1301,20120906,4312,4319,4253,4257,4201,4237,4237,-82,-82,1899362,80479098960,2349262
1187,m1301,20120907,4237,4237,4255,4275,4205,4212,4246,-25,9,1992032,84587803800,2322130
1188,m1301,20120910,4212,4246,4205,4251,4190,4238,4227,-8,-19,1574752,66577387840,2309894
1189,m1301,20120911,4238,4227,4210,4239,4152,4170,4185,-57,-42,2463206,1.03085E+11,2223028
1190,m1301,20120912,4170,4185,4159,4210,4155,4201,4185,16,0,2000566,83737459040,2226770
1191,m1301,20120913,4201,4185,4255,4275,4215,4219,4248,34,63,1696868,72086891200,2155150
1192,m1301,20120914,4219,4248,4250,4300,4231,4249,4254,1,6,1606458,68351248900,2122522
1193,m1301,20120917,4249,4254,4203,4210,4075,4083,4143,-171,-111,2460894,1.01959E+11,2186828
1194,m1301,20120918,4083,4143,4008,4050,3983,4002,4020,-141,-123,2713544,1.09088E+11,2063482
1195,m1301,20120919,4002,4020,4048,4065,4010,4040,4032,20,12,2018448,81392721220,2059056
1196,m1301,20120920,4040,4032,4052,4075,4001,4037,4042,5,10,2773738,1.12136E+11,2087850
1197,m1301,20120921,4037,4042,3990,4020,3971,4013,3997,-29,-45,2356428,94189787900,2113874
1198,m1301,20120924,4013,3997,3976,3979,3897,3961,3936,-36,-61,3159918,1.24397E+11,2094940
1199,m1301,20120925,3961,3936,3990,4020,3972,4000,3997,64,61,1914810,76546727780,2053988
1200,m1301,20120926,4000,3997,3978,3995,3961,3969,3975,-28,-22,1358190,53996874680,2001288
1201,m1301,20120927,3969,3975,3934,3981,3934,3970,3956,-5,-19,1296498,51296865920,1843012
1202,m1301,20120928,3970,3956,3978,3991,3946,3984,3965,28,9,1117478,44313439160,1747002
1203,m1301,20121008,3984,3965,3951,3962,3877,3878,3904,-87,-61,1904024,74342008140,1804112
1204,m1301,20121009,3878,3904,3905,3916,3878,3897,3899,-7,-5,1853574,72277383880,1801940
1205,m1301,20121010,3897,3899,3861,3865,3822,3835,3838,-64,-61,1779530,68301904940,1843358
1206,m1301,20121011,3835,3838,3808,3879,3808,3839,3848,1,10,2040306,78524364120,1817070
1207,m1301,20121012,3839,3848,3851,3868,3781,3782,3825,-66,-23,2321642,88815837580,1767490
1208,m1301,20121015,3782,3825,3712,3759,3678,3684,3713,-141,-112,2030806,75411348420,1732888
1209,m1301,20121016,3684,3713,3708,3723,3686,3713,3706,0,-7,1819568,67450851480,1705322
1210,m1301,20121017,3713,3706,3680,3718,3656,3712,3688,6,-18,1978450,72970524060,1816894
1211,m1301,20121018,3712,3688,3729,3773,3724,3769,3752,81,64,1795350,67366125640,1682474
1212,m1301,20121019,3769,3752,3788,3798,3756,3785,3775,33,23,1359550,51334595160,1688342
1213,m1301,20121022,3785,3775,3788,3835,3779,3828,3812,53,37,1611354,61433828540,1648878
1214,m1301,20121023,3828,3812,3826,3831,3746,3750,3781,-62,-31,1968706,74455759860,1796066
1215,m1301,20121024,3750,3781,3793,3826,3782,3809,3805,28,24,1681646,64000337340,1689478
1216,m1301,20121025,3809,3805,3810,3819,3773,3790,3793,-15,-12,1447610,54913488280,1691158
1217,m1301,20121026,3790,3793,3785,3807,3757,3796,3783,3,-10,1164876,44077398760,1652704
1218,m1301,20121029,3796,3783,3780,3780,3726,3740,3742,-43,-41,1358726,50851857080,1664774
1219,m1301,20121030,3740,3742,3728,3753,3713,3745,3730,3,-12,876546,32700668580,1618322
1220,m1301,20121031,3745,3730,3745,3769,3732,3768,3747,38,17,611400,22913396460,1566706
1221,m1301,20121101,3768,3747,3770,3850,3766,3845,3813,98,66,986704,37627802860,1483008
1222,m1301,20121102,3845,3813,3820,3825,3792,3806,3807,-7,-6,617424,23506755940,1422336
1223,m1301,20121105,3806,3807,3743,3781,3738,3767,3760,-40,-47,530838,19961413560,1412550
1224,m1301,20121106,3767,3760,3780,3802,3763,3790,3782,30,22,464978,17588981000,1362240
1225,m1301,20121107,3790,3782,3782,3797,3762,3766,3778,-16,-4,480512,18156605720,1376804
1226,m1301,20121108,3766,3778,3754,3769,3733,3761,3749,-17,-29,538926,20208412780,1371820
1227,m1301,20121109,3761,3749,3742,3763,3728,3733,3745,-16,-4,420210,15737806640,1346852
1228,m1301,20121112,3733,3745,3633,3648,3596,3596,3608,-149,-137,639266,23069280600,1278278
1229,m1301,20121113,3596,3608,3580,3589,3516,3556,3556,-52,-52,1070518,38076748120,1304074
1230,m1301,20121114,3556,3556,3553,3609,3553,3603,3583,47,27,576590,20661078840,1246288
1231,m1301,20121115,3603,3583,3591,3608,3542,3545,3581,-38,-2,614194,21999903540,1241258
1232,m1301,20121116,3545,3581,3540,3562,3498,3518,3524,-63,-57,676666,23847699820,1241038
1233,m1301,20121119,3518,3524,3541,3553,3527,3547,3539,23,15,433312,15337944180,1233896
1234,m1301,20121120,3547,3539,3551,3556,3490,3494,3508,-45,-31,767776,26935617020,1286244
1235,m1301,20121121,3494,3508,3526,3539,3496,3515,3515,7,7,575222,20224049900,1246988
1236,m1301,20121122,3515,3515,3509,3513,3458,3502,3482,-13,-33,1273996,44370994240,1239674
1237,m1301,20121123,3502,3482,3496,3593,3493,3590,3555,108,73,1633372,58069461620,1313094
1238,m1301,20121126,3590,3555,3592,3611,3548,3567,3567,12,12,1056808,37699697520,1139140
1239,m1301,20121127,3567,3567,3585,3618,3574,3599,3599,32,32,957460,34465260580,1106526
1240,m1301,20121128,3599,3599,3629,3657,3623,3645,3643,46,44,812762,29614697320,1049164
1241,m1301,20121129,3645,3643,3653,3690,3638,3686,3659,43,16,922366,33757362360,1029296
1242,m1301,20121130,3686,3659,3684,3696,3664,3678,3679,19,20,954060,35103780220,886806
1243,m1301,20121203,3678,3679,3690,3767,3690,3760,3743,81,64,606170,22693001020,744926
1244,m1301,20121204,3760,3743,3765,3770,3734,3750,3747,7,4,465304,17435995000,600868
1245,m1301,20121205,3750,3747,3755,3765,3717,3732,3733,-15,-14,356616,13313032120,561812
1246,m1301,20121206,3732,3733,3780,3780,3744,3744,3760,11,27,288300,10840974460,445866
1247,m1301,20121207,3744,3760,3744,3792,3727,3788,3767,28,7,225334,8490168340,392020
1248,m1301,20121210,3788,3767,3754,3792,3753,3776,3770,9,3,136498,5146326340,334068
1249,m1301,20121211,3776,3770,3774,3808,3774,3795,3796,25,26,116288,4414956240,282980
1250,m1301,20121212,3795,3796,3795,3805,3772,3787,3789,-9,-7,91066,3450900820,262288
1251,m1301,20121213,3787,3789,3790,3827,3781,3816,3806,27,17,93038,3541277140,238304
1252,m1301,20121214,3816,3806,3823,3872,3820,3869,3847,63,41,93414,3594221360,199216
1253,m1301,20121217,3869,3847,3940,3962,3890,3937,3939,90,92,83260,3280100720,149032
1254,m1301,20121218,3937,3939,3930,3936,3888,3896,3906,-43,-33,48478,1893963480,132464
1255,m1301,20121219,3896,3906,3880,3880,3830,3858,3853,-48,-53,27478,1058951620,118390
1256,m1301,20121220,3858,3853,3820,3820,3773,3785,3786,-68,-67,24422,924795580,102268
1257,m1301,20121221,3785,3786,3769,3772,3744,3749,3754,-37,-32,36722,1378687780,81328
1258,m1301,20121224,3749,3754,3750,3796,3750,3758,3774,4,20,14358,541895720,72786
1259,m1301,20121225,3758,3774,3770,3770,3748,3770,3759,-4,-15,20618,775046640,65626
1260,m1301,20121226,3770,3759,3771,3848,3769,3844,3826,85,67,21136,808757600,54032
1261,m1301,20121227,3844,3826,3836,3850,3827,3829,3838,3,12,22276,855003060,39520
1262,m1301,20121228,3829,3838,3824,3839,3808,3828,3820,-10,-18,15362,586945960,28906
1263,m1301,20121231,3828,3820,3895,3932,3822,3840,3842,20,22,9852,378554540,21086
1264,m1303,20120316,3270,3270,3247,3253,3223,3223,3245,-47,-25,32,1038660,22
1265,m1303,20120319,3223,3245,3231,3247,3231,3240,3237,-5,-8,12,388440,24
1266,m1303,20120320,3240,3237,3239,3239,3205,3205,3217,-32,-20,36,1158220,26
1267,m1303,20120321,3205,3217,3207,3207,3207,3207,3207,-10,-10,4,128280,28
1268,m1303,20120322,3207,3207,3224,3224,3222,3223,3223,16,16,8,257840,28
1269,m1303,20120323,3223,3223,3232,3256,3232,3254,3245,31,22,18,584100,26
1270,m1303,20120326,3254,3245,3276,3280,3258,3272,3268,27,23,14,457600,30
1271,m1303,20120327,3272,3268,3288,3292,3276,3281,3281,13,13,18,590720,28
1272,m1303,20120328,3281,3281,3272,3292,3272,3276,3283,-5,2,30,984940,34
1273,m1303,20120329,3276,3283,3275,3275,3259,3259,3268,-24,-15,12,392180,36
1274,m1303,20120330,3259,3268,3246,3246,3215,3230,3234,-38,-34,32,1035140,40
1275,m1303,20120405,3230,3234,3260,3368,3260,3368,3332,134,98,38,1266220,34
1276,m1303,20120406,3368,3332,3373,3392,3373,3392,3386,60,54,24,812780,44
1277,m1303,20120409,3392,3386,3383,3400,3376,3386,3385,0,-1,30,1015660,58
1278,m1303,20120410,3386,3385,3390,3390,3376,3390,3387,5,2,20,677500,46
1279,m1303,20120411,3390,3387,3353,3353,3330,3346,3345,-41,-42,20,669000,48
1280,m1303,20120412,3346,3345,3352,3352,3352,3352,3352,7,7,2,67040,48
1281,m1303,20120413,3352,3352,3388,3389,3367,3385,3375,33,23,32,1080200,44
1282,m1303,20120416,3385,3375,3333,3339,3326,3327,3331,-48,-44,30,999560,62
1283,m1303,20120417,3327,3331,3328,3339,3327,3335,3336,4,5,56,1868460,72
1284,m1303,20120418,3335,3336,3333,3333,3270,3300,3295,-36,-41,100,3295800,64
1285,m1303,20120419,3300,3295,3297,3320,3291,3307,3303,12,8,34,1123240,64
1286,m1303,20120420,3307,3303,3330,3330,3284,3305,3304,2,1,28,925220,70
1287,m1303,20120423,3305,3304,3340,3369,3330,3350,3345,46,41,70,2341780,70
1288,m1303,20120424,3350,3345,3337,3358,3321,3337,3335,-8,-10,82,2735320,82
1289,m1303,20120425,3337,3335,3355,3375,3351,3354,3360,19,25,76,2553700,90
1290,m1303,20120426,3354,3360,3340,3341,3320,3326,3325,-34,-35,102,3392000,140
1291,m1303,20120427,3326,3325,3332,3353,3329,3353,3341,28,16,386,12899840,172
1292,m1303,20120502,3353,3341,3368,3379,3351,3351,3363,10,22,90,3027140,184
1293,m1303,20120503,3351,3363,3354,3365,3329,3329,3344,-34,-19,104,3477780,184
1294,m1303,20120504,3329,3344,3332,3358,3332,3358,3340,14,-4,154,5144720,188
1295,m1303,20120507,3358,3340,3379,3380,3314,3326,3326,-14,-14,388,12905500,344
1296,m1303,20120508,3326,3326,3320,3330,3301,3304,3319,-22,-7,152,5046240,356
1297,m1303,20120509,3304,3319,3282,3287,3221,3256,3270,-63,-49,148,4840500,352
1298,m1303,20120510,3256,3270,3264,3290,3260,3290,3271,20,1,214,7000300,348
1299,m1303,20120511,3290,3271,3296,3296,3231,3234,3261,-37,-10,104,3392460,342
1300,m1303,20120514,3234,3261,3208,3208,3131,3131,3176,-130,-85,918,29158500,472
1301,m1303,20120515,3131,3176,3105,3146,3090,3145,3120,-31,-56,164,5116880,458
1302,m1303,20120516,3145,3120,3124,3134,3051,3055,3105,-65,-15,720,22356540,460
1303,m1303,20120517,3055,3105,3150,3150,3084,3111,3115,6,10,138,4299640,456
1304,m1303,20120518,3111,3115,3088,3107,3074,3090,3086,-25,-29,202,6235080,374
1305,m1303,20120521,3090,3086,3090,3127,3074,3116,3108,30,22,330,10257080,228
1306,m1303,20120522,3116,3108,3116,3133,3089,3098,3102,-10,-6,146,4529500,244
1307,m1303,20120523,3098,3102,3060,3064,3021,3043,3039,-59,-63,172,5228740,246
1308,m1303,20120524,3043,3039,3058,3077,3045,3077,3058,38,19,208,6361800,230
1309,m1303,20120525,3077,3058,3083,3083,3052,3073,3068,15,10,134,4112240,234
1310,m1303,20120528,3073,3068,3082,3101,3073,3100,3089,32,21,40,1235980,222
1311,m1303,20120529,3100,3089,3114,3124,3092,3122,3106,33,17,126,3914240,228
1312,m1303,20120530,3122,3106,3112,3136,3101,3117,3118,11,12,136,4241680,216
1313,m1303,20120531,3117,3118,3110,3122,3105,3105,3111,-13,-7,56,1742600,216
1314,m1303,20120601,3105,3111,3105,3105,3070,3074,3079,-37,-32,66,2032700,242
1315,m1303,20120604,3074,3079,3081,3091,3043,3053,3060,-26,-19,146,4468160,240
1316,m1303,20120605,3053,3060,3059,3132,3059,3113,3096,53,36,300,9290460,130
1317,m1303,20120606,3113,3096,3130,3176,3112,3143,3148,47,52,324,10200820,124
1318,m1303,20120607,3143,3148,3164,3184,3158,3163,3170,15,22,110,3487180,116
1319,m1303,20120608,3163,3170,3179,3181,3152,3173,3164,3,-6,126,3987540,146
1320,m1303,20120611,3173,3164,3195,3238,3191,3230,3212,66,48,192,6168340,120
1321,m1303,20120612,3230,3212,3234,3234,3197,3228,3214,16,2,80,2571600,106
1322,m1303,20120613,3228,3214,3226,3226,3198,3200,3208,-14,-6,132,4235560,110
1323,m1303,20120614,3200,3208,3167,3191,3134,3154,3159,-54,-49,84,2653900,112
1324,m1303,20120615,3154,3159,3173,3190,3148,3188,3180,29,21,122,3879940,142
1325,m1303,20120618,3188,3180,3188,3218,3168,3190,3193,10,13,98,3130020,156
1326,m1303,20120619,3190,3193,3213,3279,3213,3270,3247,77,54,140,4547160,150
1327,m1303,20120620,3270,3247,3293,3321,3287,3321,3301,74,54,104,3433480,170
1328,m1303,20120621,3321,3301,3281,3308,3280,3303,3294,2,-7,130,4283220,170
1329,m1303,20120625,3303,3294,3357,3420,3357,3365,3392,71,98,142,4816640,154
1330,m1303,20120626,3365,3392,3381,3381,3360,3378,3369,-14,-23,202,6806960,166
1331,m1303,20120627,3378,3369,3375,3382,3367,3378,3374,9,5,74,2497460,142
1332,m1303,20120628,3378,3374,3373,3379,3329,3329,3358,-45,-16,68,2284100,118
1333,m1303,20120629,3329,3358,3352,3376,3344,3369,3361,11,3,70,2353020,126
1334,m1303,20120702,3369,3361,3395,3414,3357,3357,3384,-4,23,176,5956980,118
1335,m1303,20120703,3357,3384,3347,3385,3347,3383,3372,-1,-12,156,5260360,124
1336,m1303,20120704,3383,3372,3411,3452,3411,3445,3433,73,61,152,5219640,146
1337,m1303,20120705,3445,3433,3426,3520,3426,3520,3483,87,50,348,12122060,146
1338,m1303,20120706,3520,3483,3476,3518,3475,3497,3501,14,18,220,7702300,168
1339,m1303,20120709,3497,3501,3513,3597,3502,3589,3550,88,49,204,7243280,182
1340,m1303,20120710,3589,3550,3566,3588,3542,3542,3563,-8,13,196,6985260,170
1341,m1303,20120711,3542,3563,3552,3652,3495,3514,3554,-49,-9,206,7321420,130
1342,m1303,20120712,3514,3554,3478,3493,3449,3485,3474,-69,-80,126,4378400,138
1343,m1303,20120713,3485,3474,3500,3529,3471,3523,3517,49,43,138,4854160,132
1344,m1303,20120716,3523,3517,3655,3657,3601,3657,3637,140,120,246,8948360,166
1345,m1303,20120717,3657,3637,3716,3716,3533,3578,3582,-59,-55,182,6519720,142
1346,m1303,20120718,3578,3582,3560,3626,3551,3590,3584,8,2,102,3655940,150
1347,m1303,20120719,3590,3584,3626,3700,3621,3690,3658,106,74,156,5707520,154
1348,m1303,20120720,3690,3658,3662,3728,3658,3682,3688,24,30,200,7377440,198
1349,m1303,20120723,3682,3688,3612,3689,3588,3641,3639,-47,-49,272,9898680,232
1350,m1303,20120724,3641,3639,3501,3529,3494,3494,3504,-145,-135,276,9673160,260
1351,m1303,20120725,3494,3504,3447,3523,3445,3480,3486,-24,-18,194,6764320,258
1352,m1303,20120726,3480,3486,3488,3503,3466,3498,3484,12,-2,204,7109280,242
1353,m1303,20120727,3498,3484,3513,3514,3465,3510,3493,26,9,268,9363840,290
1354,m1303,20120730,3510,3493,3553,3632,3553,3632,3611,139,118,114,4117160,304
1355,m1303,20120731,3632,3611,3585,3636,3574,3626,3600,15,-11,496,17860580,496
1356,m1303,20120801,3626,3600,3668,3687,3609,3610,3647,10,47,434,15830080,458
1357,m1303,20120802,3610,3647,3620,3625,3586,3603,3603,-44,-44,264,9512660,458
1358,m1303,20120803,3603,3603,3592,3621,3565,3582,3601,-21,-2,126,4538240,418
1359,m1303,20120806,3582,3601,3567,3604,3542,3570,3563,-31,-38,230,8196020,388
1360,m1303,20120807,3570,3563,3579,3610,3568,3610,3583,47,20,210,7525160,378
1361,m1303,20120808,3610,3583,3587,3589,3557,3557,3576,-26,-7,222,7940200,380
1362,m1303,20120809,3557,3576,3584,3588,3563,3577,3578,1,2,78,2791520,388
1363,m1303,20120810,3577,3578,3631,3634,3529,3610,3610,32,32,104,3754440,376
1364,m1303,20120813,3610,3610,3605,3608,3571,3582,3593,-28,-17,86,3090400,364
1365,m1303,20120814,3582,3593,3565,3583,3534,3568,3557,-25,-36,90,3201720,386
1366,m1303,20120815,3568,3557,3596,3630,3561,3612,3585,55,28,106,3800980,378
1367,m1303,20120816,3612,3585,3620,3620,3582,3591,3595,6,10,64,2301260,378
1368,m1303,20120817,3591,3595,3599,3605,3590,3602,3595,7,0,70,2516560,382
1369,m1303,20120820,3602,3595,3629,3653,3629,3646,3638,51,43,278,10115560,392
1370,m1303,20120821,3646,3638,3644,3748,3644,3738,3724,100,86,78,2904860,408
1371,m1303,20120822,3738,3724,3792,3801,3754,3798,3788,74,64,118,4470400,386
1372,m1303,20120823,3798,3788,3832,3864,3797,3807,3840,19,52,156,5991420,352
1373,m1303,20120824,3807,3840,3786,3858,3739,3852,3830,12,-10,310,11875880,444
1374,m1303,20120827,3852,3830,3933,3933,3838,3870,3891,40,61,274,10661800,454
1375,m1303,20120828,3870,3891,3857,3871,3838,3844,3853,-47,-38,154,5934040,456
1376,m1303,20120829,3844,3853,3864,3898,3835,3868,3856,15,3,304,11723800,448
1377,m1303,20120830,3868,3856,3880,3888,3852,3880,3874,24,18,148,5734100,434
1378,m1303,20120831,3880,3874,3871,3872,3852,3870,3860,-4,-14,164,6331120,458
1379,m1303,20120903,3870,3860,3880,3982,3879,3974,3924,114,64,550,21586260,434
1380,m1303,20120904,3974,3924,3993,4001,3963,3996,3986,72,62,200,7972320,422
1381,m1303,20120905,3996,3986,3983,3992,3967,3967,3983,-19,-3,72,2867920,422
1382,m1303,20120906,3967,3983,3915,3933,3854,3881,3892,-102,-91,152,5916660,432
1383,m1303,20120907,3881,3892,3877,3929,3861,3861,3899,-31,7,100,3899540,406
1384,m1303,20120910,3861,3899,3822,3910,3822,3901,3878,2,-21,268,10393780,464
1385,m1303,20120911,3901,3878,3898,3901,3855,3856,3874,-22,-4,156,6044180,446
1386,m1303,20120912,3856,3874,3852,3890,3851,3890,3874,16,0,204,7904600,498
1387,m1303,20120913,3890,3874,3935,4040,3923,3936,3949,62,75,382,15088040,602
1388,m1303,20120914,3936,3949,3949,3998,3943,3958,3963,9,14,186,7371260,652
1389,m1303,20120917,3958,3963,3940,3940,3835,3853,3878,-110,-85,312,12101920,640
1390,m1303,20120918,3853,3878,3801,3855,3768,3777,3797,-101,-81,302,11468240,648
1391,m1303,20120919,3777,3797,3778,3830,3778,3798,3801,1,4,216,8210200,620
1392,m1303,20120920,3798,3801,3800,3808,3775,3786,3789,-15,-12,188,7125080,606
1393,m1303,20120921,3786,3789,3750,3769,3727,3751,3754,-38,-35,152,5707580,606
1394,m1303,20120924,3751,3754,3713,3717,3656,3715,3675,-39,-79,300,11026680,616
1395,m1303,20120925,3715,3675,3737,3750,3709,3741,3735,66,60,130,4856600,594
1396,m1303,20120926,3741,3735,3734,3747,3716,3723,3726,-12,-9,126,4695940,606
1397,m1303,20120927,3723,3726,3653,3911,3653,3713,3737,-13,11,292,10914100,554
1398,m1303,20120928,3713,3737,3733,3734,3708,3718,3718,-19,-19,86,3197780,534
1399,m1303,20121008,3718,3718,3673,3699,3647,3657,3671,-61,-47,70,2569700,542
1400,m1303,20121009,3657,3671,3670,3682,3650,3662,3669,-9,-2,326,11963060,572
1401,m1303,20121010,3662,3669,3668,3668,3627,3634,3637,-35,-32,234,8510980,484
1402,m1303,20121011,3634,3637,3626,3668,3626,3662,3646,25,9,176,6417800,488
1403,m1303,20121012,3662,3646,3651,3791,3620,3621,3680,-25,34,590,21717040,518
1404,m1303,20121015,3621,3680,3600,3600,3547,3550,3564,-130,-116,304,10835180,576
1405,m1303,20121016,3550,3564,3579,3590,3554,3562,3571,-2,7,380,13573500,558
1406,m1303,20121017,3562,3571,3515,3560,3515,3560,3540,-11,-31,352,12462860,426
1407,m1303,20121018,3560,3540,3588,3598,3553,3574,3574,34,34,310,11081040,408
1408,m1303,20121019,3574,3574,3601,3601,3560,3560,3587,-14,13,296,10617740,420
1409,m1303,20121022,3560,3587,3598,3620,3583,3618,3602,31,15,232,8358680,422
1410,m1303,20121023,3618,3602,3630,3660,3578,3579,3607,-23,5,242,8730520,432
1411,m1303,20121024,3579,3607,3601,3610,3589,3606,3602,-1,-5,208,7492400,430
1412,m1303,20121025,3606,3602,3609,3613,3580,3596,3594,-6,-8,212,7620200,424
1413,m1303,20121026,3596,3594,3582,3595,3562,3572,3579,-22,-15,114,4080060,398
1414,m1303,20121029,3572,3579,3577,3577,3523,3525,3540,-54,-39,118,4177240,406
1415,m1303,20121030,3525,3540,3515,3520,3500,3518,3508,-22,-32,298,10454540,470
1416,m1303,20121031,3518,3508,3518,3573,3516,3567,3544,59,36,176,6239020,476
1417,m1303,20121101,3567,3544,3570,3666,3570,3655,3625,111,81,208,7540280,506
1418,m1303,20121102,3655,3625,3640,3649,3610,3642,3634,17,9,172,6251740,494
1419,m1303,20121105,3642,3634,3602,3611,3571,3591,3589,-43,-45,96,3445480,490
1420,m1303,20121106,3591,3589,3592,3651,3592,3640,3630,51,41,120,4356880,534
1421,m1303,20121107,3640,3630,3655,3655,3591,3600,3618,-30,-12,204,7381900,578
1422,m1303,20121108,3600,3618,3582,3605,3577,3594,3592,-24,-26,152,5460580,574
1423,m1303,20121109,3594,3592,3579,3592,3566,3570,3579,-22,-13,104,3722460,570
1424,m1303,20121112,3570,3579,3502,3504,3436,3436,3444,-143,-135,266,9162780,586
1425,m1303,20121113,3436,3444,3437,3547,3374,3396,3419,-48,-25,514,17575180,606
1426,m1303,20121114,3396,3419,3390,3437,3389,3428,3409,9,-10,214,7296180,608
1427,m1303,20121115,3428,3409,3420,3420,3361,3361,3401,-48,-8,198,6734120,634
1428,m1303,20121116,3361,3401,3377,3391,3344,3354,3355,-47,-46,280,9396140,576
1429,m1303,20121119,3354,3355,3372,3390,3354,3383,3379,28,24,98,3311540,568
1430,m1303,20121120,3383,3379,3383,3383,3335,3368,3360,-11,-19,156,5242720,588
1431,m1303,20121121,3368,3360,3381,3403,3376,3389,3387,29,27,134,4539120,578
1432,m1303,20121122,3389,3387,3394,3394,3363,3389,3378,2,-9,384,12972600,534
1433,m1303,20121123,3389,3378,3389,3438,3381,3438,3414,60,36,288,9833000,574
1434,m1303,20121126,3438,3414,3437,3439,3418,3418,3428,4,14,226,7749280,550
1435,m1303,20121127,3418,3428,3428,3445,3423,3436,3437,8,9,106,3643400,554
1436,m1303,20121128,3436,3437,3465,3481,3455,3465,3468,28,31,156,5411460,590
1437,m1303,20121129,3465,3468,3470,3475,3431,3468,3454,0,-14,196,6771400,558
1438,m1303,20121130,3468,3454,3453,3469,3438,3458,3454,4,0,144,4974100,568
1439,m1303,20121203,3458,3454,3474,3518,3470,3506,3498,52,44,196,6856780,570
1440,m1303,20121204,3506,3498,3505,3508,3486,3501,3497,3,-1,136,4756560,622
1441,m1303,20121205,3501,3497,3505,3524,3483,3506,3502,9,5,230,8056320,632
1442,m1303,20121206,3506,3502,3540,3557,3527,3544,3543,42,41,314,11127920,664
1443,m1303,20121207,3544,3543,3545,3625,3422,3575,3558,32,15,312,11103740,656
1444,m1303,20121210,3575,3558,3558,3566,3546,3552,3555,-6,-3,104,3697420,678
1445,m1303,20121211,3552,3555,3568,3595,3568,3581,3584,26,29,164,5878180,686
1446,m1303,20121212,3581,3584,3580,3588,3568,3572,3577,-12,-7,80,2862080,700
1447,m1303,20121213,3572,3577,3589,3590,3544,3579,3578,2,1,82,2934600,728
1448,m1303,20121214,3579,3578,3585,3645,3585,3635,3617,57,39,132,4775300,720
1449,m1303,20121217,3635,3617,3683,3714,3683,3691,3701,74,84,394,14582000,802
1450,m1303,20121218,3691,3701,3685,3692,3661,3664,3667,-37,-34,172,6307840,836
1451,m1303,20121219,3664,3667,3639,3639,3601,3615,3619,-52,-48,204,7383680,866
1452,m1303,20121220,3615,3619,3561,3573,3550,3561,3564,-58,-55,140,4990160,900
1453,m1303,20121221,3561,3564,3535,3574,3535,3554,3560,-10,-4,218,7761440,936
1454,m1303,20121224,3554,3560,3569,3582,3553,3553,3570,-7,10,114,4070860,940
1455,m1303,20121225,3553,3570,3553,3559,3532,3535,3544,-35,-26,186,6592240,984
1456,m1303,20121226,3535,3544,3545,3575,3544,3564,3560,20,16,166,5911140,1034
1457,m1303,20121227,3564,3560,3551,3577,3546,3571,3564,11,4,208,7414760,1038
1458,m1303,20121228,3571,3564,3591,3592,3561,3561,3574,-3,10,130,4646280,1042
1459,m1303,20121231,3561,3574,3553,3567,3527,3533,3548,-41,-26,132,4683820,1032
1460,m1305,20120517,2955,2995,2985,3022,2980,3011,3003,16,8,83622,2511963320,107834
1461,m1305,20120518,3011,3003,2997,3006,2970,2979,2985,-24,-18,74720,2230782860,134236
1462,m1305,20120521,2979,2985,2982,3014,2979,3003,3000,18,15,75546,2266992580,156200
1463,m1305,20120522,3003,3000,2992,2995,2980,2983,2985,-17,-15,64220,1917423320,172374
1464,m1305,20120523,2983,2985,2935,2935,2916,2928,2926,-57,-59,52340,1531638900,170028
1465,m1305,20120524,2928,2926,2938,2963,2935,2958,2948,32,22,36822,1085754320,170068
1466,m1305,20120525,2958,2948,2969,2969,2943,2962,2956,14,8,34170,1010335540,179058
1467,m1305,20120528,2962,2956,2975,3000,2962,2996,2983,40,27,49006,1462077920,184374
1468,m1305,20120529,2996,2983,2987,3018,2980,3016,2995,33,12,90612,2714600120,211020
1469,m1305,20120530,3016,2995,2997,3036,2997,3011,3015,16,20,127356,3840868980,233556
1470,m1305,20120531,3011,3015,2990,3016,2988,3000,3008,-15,-7,102812,3092894640,245554
1471,m1305,20120601,3000,3008,2955,2982,2954,2968,2970,-40,-38,107808,3202042980,258224
1472,m1305,20120604,2968,2970,2963,2977,2931,2953,2951,-17,-19,154790,4568271560,271296
1473,m1305,20120605,2953,2951,2970,3036,2970,3021,3008,70,57,233648,7028376460,311264
1474,m1305,20120606,3021,3008,3020,3068,3010,3050,3046,42,38,334846,10201081580,328672
1475,m1305,20120607,3050,3046,3076,3094,3061,3071,3076,25,30,193118,5940524000,313902
1476,m1305,20120608,3071,3076,3090,3098,3048,3075,3074,-1,-2,201810,6204005680,284288
1477,m1305,20120611,3075,3074,3074,3147,3074,3145,3120,71,46,263032,8208076520,325416
1478,m1305,20120612,3145,3120,3122,3139,3112,3135,3125,15,5,261102,8159610340,354238
1479,m1305,20120613,3135,3125,3138,3139,3108,3109,3117,-16,-8,195984,6109968360,352118
1480,m1305,20120614,3109,3117,3090,3093,3063,3064,3076,-53,-41,198622,6111572340,368382
1481,m1305,20120615,3064,3076,3065,3102,3065,3094,3088,18,12,209740,6478620020,377222
1482,m1305,20120618,3094,3088,3100,3122,3088,3106,3102,18,14,183130,5681354580,381452
1483,m1305,20120619,3106,3102,3147,3198,3132,3188,3175,86,73,370346,11762174960,407698
1484,m1305,20120620,3188,3175,3228,3232,3203,3223,3215,48,40,288682,9283838220,437062
1485,m1305,20120621,3223,3215,3194,3215,3185,3204,3200,-11,-15,335524,10738113620,450138
1486,m1305,20120625,3204,3200,3235,3328,3235,3274,3300,74,100,852156,28127168300,493222
1487,m1305,20120626,3274,3300,3295,3297,3262,3284,3273,-16,-27,448028,14665469300,509098
1488,m1305,20120627,3284,3273,3283,3314,3272,3300,3295,27,22,835342,27526005480,647440
1489,m1305,20120628,3300,3295,3300,3309,3258,3261,3281,-34,-14,1299642,42654172340,715616
1490,m1305,20120629,3261,3281,3275,3298,3251,3292,3277,11,-4,1014798,33258928400,726114
1491,m1305,20120702,3292,3277,3348,3348,3271,3274,3295,-3,18,955334,31487685560,715358
1492,m1305,20120703,3274,3295,3283,3335,3271,3334,3299,39,4,1861036,61410128800,867704
1493,m1305,20120704,3334,3299,3350,3398,3344,3396,3373,97,74,2059904,69482912640,974756
1494,m1305,20120705,3396,3373,3399,3455,3389,3443,3425,70,52,2526256,86539815660,983674
1495,m1305,20120706,3443,3425,3448,3455,3389,3409,3419,-16,-6,2014306,68878116560,960426
1496,m1305,20120709,3409,3419,3410,3478,3399,3453,3439,34,20,2335438,80334490380,913716
1497,m1305,20120710,3453,3439,3424,3459,3404,3425,3430,-14,-9,2002498,68695918640,921836
1498,m1305,20120711,3425,3430,3435,3520,3373,3390,3435,-40,5,3659746,1.25733E+11,875466
1499,m1305,20120712,3390,3435,3373,3384,3313,3320,3348,-115,-87,2202626,73764667420,870556
1500,m1305,20120713,3320,3348,3336,3399,3336,3398,3373,50,25,2405346,81144808080,847750
1501,m1305,20120716,3398,3373,3451,3507,3451,3507,3491,134,118,1785922,62353624460,863188
1502,m1305,20120717,3507,3491,3535,3536,3321,3389,3412,-102,-79,2452156,83668306260,795636
1503,m1305,20120718,3389,3412,3416,3438,3374,3412,3406,0,-6,2733050,93091237400,827588
1504,m1305,20120719,3412,3406,3450,3532,3430,3524,3492,118,86,4309558,1.50491E+11,1089018
1505,m1305,20120720,3524,3492,3499,3499,3453,3480,3477,-12,-15,2652664,92251182680,1063860
1506,m1305,20120723,3480,3477,3417,3437,3370,3392,3396,-85,-81,1524414,51778237960,930896
1507,m1305,20120724,3392,3396,3261,3301,3261,3261,3277,-135,-119,1464594,48001429200,889506
1508,m1305,20120725,3261,3277,3214,3306,3214,3249,3269,-28,-8,2883594,94270493320,902752
1509,m1305,20120726,3249,3269,3278,3296,3258,3288,3274,19,5,2259580,73994612040,871900
1510,m1305,20120727,3288,3274,3278,3343,3269,3339,3305,65,31,2749618,90881094680,946688
1511,m1305,20120730,3339,3305,3393,3436,3378,3428,3412,123,107,3132406,1.06901E+11,1013744
1512,m1305,20120731,3428,3412,3398,3430,3381,3415,3405,3,-7,2093278,71294926320,928984
1513,m1305,20120801,3415,3405,3425,3466,3385,3395,3435,-10,30,3212798,1.10367E+11,1034788
1514,m1305,20120802,3395,3435,3399,3404,3370,3385,3385,-50,-50,1986954,67270684900,903712
1515,m1305,20120803,3385,3385,3374,3407,3353,3377,3381,-8,-4,1930116,65275122580,927418
1516,m1305,20120806,3377,3381,3358,3377,3328,3346,3350,-35,-31,1609108,53915720620,863216
1517,m1305,20120807,3346,3350,3357,3416,3355,3413,3388,63,38,2287692,77507829560,891954
1518,m1305,20120808,3413,3388,3383,3404,3365,3367,3387,-21,-1,1568244,53119267620,865826
1519,m1305,20120809,3367,3387,3390,3395,3364,3379,3381,-8,-6,1152084,38961896680,880856
1520,m1305,20120810,3379,3381,3416,3430,3382,3401,3405,20,24,1078644,36737637860,891498
1521,m1305,20120813,3401,3405,3400,3412,3382,3386,3396,-19,-9,886164,30095121640,877276
1522,m1305,20120814,3386,3396,3370,3377,3339,3373,3359,-23,-37,804028,27014915860,857526
1523,m1305,20120815,3373,3359,3368,3415,3363,3412,3390,53,31,940326,31881478640,862442
1524,m1305,20120816,3412,3390,3420,3425,3381,3387,3395,-3,5,737306,25038795180,841112
1525,m1305,20120817,3387,3395,3394,3420,3385,3406,3405,11,10,884710,30125460020,868378
1526,m1305,20120820,3406,3405,3413,3452,3408,3444,3432,39,27,956916,32849316640,945474
1527,m1305,20120821,3444,3432,3480,3521,3471,3514,3498,82,66,1183816,41416904080,986314
1528,m1305,20120822,3514,3498,3544,3584,3528,3579,3561,81,63,1544124,54988650740,995798
1529,m1305,20120823,3579,3561,3590,3648,3569,3595,3605,34,44,1892836,68242533320,999734
1530,m1305,20120824,3595,3605,3561,3631,3561,3628,3605,23,0,1246174,44935660980,1035152
1531,m1305,20120827,3628,3605,3667,3683,3634,3653,3662,48,57,1232854,45151152960,1006840
1532,m1305,20120828,3653,3662,3625,3648,3616,3620,3631,-42,-31,848150,30799778940,996358
1533,m1305,20120829,3620,3631,3630,3670,3598,3666,3638,35,7,1067034,38822605320,1016490
1534,m1305,20120830,3666,3638,3670,3695,3641,3688,3670,50,32,1458476,53529468420,988716
1535,m1305,20120831,3688,3670,3689,3689,3650,3668,3667,-2,-3,1104696,40518909320,998908
1536,m1305,20120903,3668,3667,3683,3829,3675,3791,3773,124,106,2107490,79536591920,1021838
1537,m1305,20120904,3791,3773,3782,3828,3767,3827,3806,54,33,1650638,62832517560,1081164
1538,m1305,20120905,3827,3806,3809,3824,3793,3806,3810,0,4,1339328,51035329280,1114136
1539,m1305,20120906,3806,3810,3751,3754,3638,3688,3696,-122,-114,1765744,65272992880,1122586
1540,m1305,20120907,3688,3696,3720,3725,3651,3653,3693,-43,-3,1500050,55397949060,1120236
1541,m1305,20120910,3653,3693,3660,3694,3620,3688,3668,-5,-25,1236322,45355049340,1109542
1542,m1305,20120911,3688,3668,3659,3684,3610,3630,3641,-38,-27,1439648,52424890040,1040978
1543,m1305,20120912,3630,3641,3636,3671,3615,3669,3647,28,6,1222912,44600575860,1039578
1544,m1305,20120913,3669,3647,3711,3720,3664,3664,3692,17,45,1153558,42598320020,1118172
1545,m1305,20120914,3664,3692,3716,3745,3674,3686,3699,-6,7,1309544,48449524460,1084958
1546,m1305,20120917,3686,3699,3652,3660,3548,3550,3600,-149,-99,1340844,48277539820,1052024
1547,m1305,20120918,3550,3600,3500,3531,3476,3492,3503,-108,-97,1657846,58075465060,935710
1548,m1305,20120919,3492,3503,3520,3546,3495,3529,3514,26,11,1099676,38653266500,952754
1549,m1305,20120920,3529,3514,3537,3545,3503,3516,3522,2,8,1193710,42053765920,934988
1550,m1305,20120921,3516,3522,3480,3500,3457,3484,3477,-38,-45,1075618,37403798320,940734
1551,m1305,20120924,3484,3477,3452,3464,3402,3451,3433,-26,-44,1403522,48183732380,916490
1552,m1305,20120925,3451,3433,3466,3492,3452,3473,3471,40,38,976596,33902414660,926838
1553,m1305,20120926,3473,3471,3450,3466,3437,3439,3449,-32,-22,702878,24249122680,887556
1554,m1305,20120927,3439,3449,3419,3461,3411,3436,3430,-13,-19,681236,23371996280,833620
1555,m1305,20120928,3436,3430,3446,3452,3423,3436,3437,6,7,392560,13493524960,803548
1556,m1305,20121008,3436,3437,3430,3430,3374,3374,3401,-63,-36,587370,19977188860,771226
1557,m1305,20121009,3374,3401,3400,3435,3394,3428,3416,27,15,872014,29795722700,851662
1558,m1305,20121010,3428,3416,3400,3404,3372,3395,3391,-21,-25,734496,24907351360,867692
1559,m1305,20121011,3395,3391,3372,3472,3372,3436,3440,45,49,1795586,61783719920,993626
1560,m1305,20121012,3436,3440,3450,3465,3390,3396,3429,-44,-11,1484696,50914802560,954544
1561,m1305,20121015,3396,3429,3360,3375,3324,3334,3344,-95,-85,1135576,37980140480,975454
1562,m1305,20121016,3334,3344,3350,3380,3350,3362,3365,18,21,922824,31054407520,975186
1563,m1305,20121017,3362,3365,3345,3373,3333,3362,3352,-3,-13,972652,32606656560,989710
1564,m1305,20121018,3362,3352,3374,3388,3368,3381,3377,29,25,930892,31443967880,1021714
1565,m1305,20121019,3381,3377,3398,3409,3386,3392,3396,15,19,875788,29748740760,1020704
1566,m1305,20121022,3392,3396,3393,3420,3375,3418,3398,22,2,807628,27446415240,982492
1567,m1305,20121023,3418,3398,3418,3422,3363,3365,3390,-33,-8,837746,28406929720,995830
1568,m1305,20121024,3365,3390,3389,3410,3381,3405,3397,15,7,822156,27929665800,1004278
1569,m1305,20121025,3405,3397,3408,3412,3375,3377,3387,-20,-10,832630,28202207260,1062776
1570,m1305,20121026,3377,3387,3380,3393,3347,3376,3374,-11,-13,734968,24799184480,1014522
1571,m1305,20121029,3376,3374,3365,3367,3310,3317,3331,-57,-43,924992,30811498320,1068908
1572,m1305,20121030,3317,3331,3302,3324,3283,3314,3299,-17,-32,917334,30269518980,1072254
1573,m1305,20121031,3314,3299,3315,3378,3311,3375,3339,76,40,1152014,38468073740,1185922
1574,m1305,20121101,3375,3339,3377,3466,3372,3453,3422,114,83,2291060,78406463820,1264690
1575,m1305,20121102,3453,3422,3433,3446,3400,3425,3426,3,4,2009362,68857884020,1222150
1576,m1305,20121105,3425,3426,3382,3397,3351,3373,3374,-53,-52,1718348,57978350780,1274138
1577,m1305,20121106,3373,3374,3382,3446,3377,3434,3415,60,41,2447962,83610691780,1423124
1578,m1305,20121107,3434,3415,3436,3441,3366,3378,3397,-37,-18,2623710,89141213280,1256888
1579,m1305,20121108,3378,3397,3361,3394,3346,3381,3375,-16,-22,1844990,62275617020,1287530
1580,m1305,20121109,3381,3375,3363,3379,3338,3344,3358,-31,-17,1678598,56368802740,1261732
1581,m1305,20121112,3344,3358,3258,3265,3224,3224,3234,-134,-124,1039420,33617116780,1245950
1582,m1305,20121113,3224,3234,3202,3215,3154,3179,3181,-55,-53,2889946,91947296480,1350788
1583,m1305,20121114,3179,3181,3186,3218,3173,3214,3198,33,17,1980992,63360709520,1354890
1584,m1305,20121115,3214,3198,3204,3213,3133,3141,3182,-57,-16,2717968,86489235440,1541004
1585,m1305,20121116,3141,3182,3142,3164,3122,3133,3137,-49,-45,2982414,93570314620,1482566
1586,m1305,20121119,3133,3137,3145,3179,3143,3174,3166,37,29,1955744,61936277080,1452130
1587,m1305,20121120,3174,3166,3176,3185,3129,3142,3147,-24,-19,2527456,79552984380,1451796
1588,m1305,20121121,3142,3147,3176,3192,3161,3191,3176,44,29,2399410,76219641760,1469180
1589,m1305,20121122,3191,3176,3188,3207,3170,3188,3188,12,12,2574960,82096730340,1377134
1590,m1305,20121123,3188,3188,3184,3238,3181,3234,3212,46,24,2582644,82955010380,1441644
1591,m1305,20121126,3234,3212,3227,3240,3209,3212,3223,0,11,1669496,53814914780,1429004
1592,m1305,20121127,3212,3223,3226,3245,3223,3224,3232,1,9,1535698,49648922080,1411854
1593,m1305,20121128,3224,3232,3245,3265,3241,3257,3254,25,22,1796400,58456123680,1400590
1594,m1305,20121129,3257,3254,3261,3266,3233,3253,3246,-1,-8,1877338,60940197580,1435434
1595,m1305,20121130,3253,3246,3250,3253,3212,3231,3233,-15,-13,2189178,70776249680,1426132
1596,m1305,20121203,3231,3233,3246,3299,3241,3285,3277,52,44,1574978,51621921380,1438388
1597,m1305,20121204,3285,3277,3280,3285,3250,3276,3266,-1,-11,1382752,45164352200,1445298
1598,m1305,20121205,3276,3266,3285,3308,3279,3303,3294,37,28,1765486,58162601240,1455802
1599,m1305,20121206,3303,3294,3329,3373,3324,3352,3349,58,55,2449584,82037887600,1384698
1600,m1305,20121207,3352,3349,3350,3399,3344,3398,3372,49,23,2036022,68663662420,1446720
1601,m1305,20121210,3398,3372,3360,3385,3352,3375,3366,3,-6,1813398,61056409180,1375114
1602,m1305,20121211,3375,3366,3390,3421,3385,3413,3410,47,44,1928540,65780555340,1318372
1603,m1305,20121212,3413,3410,3405,3419,3383,3391,3400,-19,-10,2133338,72542486200,1374648
1604,m1305,20121213,3391,3400,3410,3414,3379,3393,3394,-7,-6,1420558,48216542180,1343058
1605,m1305,20121214,3393,3394,3403,3457,3395,3456,3428,62,34,1859516,63756527200,1363816
1606,m1305,20121217,3456,3428,3470,3525,3469,3497,3501,69,73,1798962,62999177240,1348220
1607,m1305,20121218,3497,3501,3490,3499,3455,3467,3471,-34,-30,1847748,64148684100,1317380
1608,m1305,20121219,3467,3471,3433,3437,3394,3419,3416,-52,-55,1883460,64350279700,1264802
1609,m1305,20121220,3419,3416,3368,3371,3352,3358,3360,-58,-56,1537310,51666581720,1189376
1610,m1305,20121221,3358,3360,3337,3372,3334,3347,3354,-13,-6,1783334,59816476840,1149434
1611,m1305,20121224,3347,3354,3365,3387,3348,3349,3371,-5,17,1283354,43267156000,1169348
1612,m1305,20121225,3349,3371,3355,3357,3315,3318,3335,-53,-36,1948344,64987593380,1219118
1613,m1305,20121226,3318,3335,3316,3358,3309,3333,3339,-2,4,2280378,76142039700,1270114
1614,m1305,20121227,3333,3339,3315,3370,3306,3368,3344,29,5,2155590,72090263800,1391796
1615,m1305,20121228,3368,3344,3362,3374,3332,3336,3351,-8,7,1649790,55294535260,1257114
1616,m1305,20121231,3336,3351,3332,3346,3272,3276,3308,-75,-43,1575052,52115584080,1226466
1617,m1307,20120717,3561,3545,3530,3565,3404,3404,3430,-141,-115,1186,40686400,760
1618,m1307,20120718,3404,3430,3390,3418,3346,3375,3386,-55,-44,800,27094960,894
1619,m1307,20120719,3375,3386,3395,3462,3386,3460,3430,74,44,1862,63880060,938
1620,m1307,20120720,3460,3430,3444,3450,3416,3431,3430,1,0,990,33957920,892
1621,m1307,20120723,3431,3430,3400,3400,3313,3346,3351,-84,-79,696,23324460,934
1622,m1307,20120724,3346,3351,3230,3260,3217,3217,3229,-134,-122,514,16597860,922
1623,m1307,20120725,3217,3229,3152,3290,3152,3219,3228,-10,-1,806,26025460,932
1624,m1307,20120726,3219,3228,3228,3249,3220,3235,3230,7,2,332,10726680,930
1625,m1307,20120727,3235,3230,3200,3314,3200,3306,3272,76,42,770,25196320,1026
1626,m1307,20120730,3306,3272,3339,3402,3339,3378,3377,106,105,724,24450540,1056
1627,m1307,20120731,3378,3377,3366,3394,3359,3390,3377,13,0,714,24117200,1136
1628,m1307,20120801,3390,3377,3392,3416,3356,3363,3396,-14,19,958,32538780,1120
1629,m1307,20120802,3363,3396,3340,3374,3340,3360,3357,-36,-39,914,30685740,1132
1630,m1307,20120803,3360,3357,3345,3380,3340,3359,3365,2,8,1020,34323640,1218
1631,m1307,20120806,3359,3365,3335,3351,3328,3339,3340,-26,-25,504,16835600,1206
1632,m1307,20120807,3339,3340,3346,3385,3346,3385,3363,45,23,452,15200980,1242
1633,m1307,20120808,3385,3363,3365,3377,3346,3347,3365,-16,2,384,12923700,1332
1634,m1307,20120809,3347,3365,3351,3370,3351,3354,3362,-11,-3,224,7531020,1316
1635,m1307,20120810,3354,3362,3399,3410,3373,3387,3392,25,30,332,11261800,1308
1636,m1307,20120813,3387,3392,3370,3388,3366,3376,3378,-16,-14,178,6013640,1332
1637,m1307,20120814,3376,3378,3354,3362,3330,3352,3342,-26,-36,546,18248940,1216
1638,m1307,20120815,3352,3342,3347,3394,3347,3390,3375,48,33,320,10802900,1150
1639,m1307,20120816,3390,3375,3390,3416,3361,3361,3375,-14,0,336,11343080,1260
1640,m1307,20120817,3361,3375,3373,3393,3373,3375,3379,0,4,198,6691480,1288
1641,m1307,20120820,3375,3379,3380,3425,3380,3417,3405,38,26,224,7627220,1342
1642,m1307,20120821,3417,3405,3440,3499,3437,3494,3476,89,71,262,9108100,1346
1643,m1307,20120822,3494,3476,3531,3560,3515,3549,3542,73,66,596,21114600,1428
1644,m1307,20120823,3549,3542,3576,3639,3553,3566,3585,24,43,460,16493440,1470
1645,m1307,20120824,3566,3585,3556,3613,3542,3613,3593,28,8,312,11211720,1610
1646,m1307,20120827,3613,3593,3650,3687,3616,3632,3650,39,57,444,16209080,1704
1647,m1307,20120828,3632,3650,3606,3625,3574,3607,3604,-43,-46,354,12759080,1658
1648,m1307,20120829,3607,3604,3616,3643,3600,3643,3619,39,15,230,8324120,1664
1649,m1307,20120830,3643,3619,3664,3673,3630,3666,3654,47,35,452,16518460,1676
1650,m1307,20120831,3666,3654,3646,3660,3633,3650,3646,-4,-8,362,13199600,1670
1651,m1307,20120903,3650,3646,3650,3793,3650,3763,3737,117,91,610,22797000,1752
1652,m1307,20120904,3763,3737,3764,3800,3751,3800,3782,63,45,514,19444580,1774
1653,m1307,20120905,3800,3782,3768,3804,3768,3780,3785,-2,3,240,9086240,1762
1654,m1307,20120906,3780,3785,3760,3760,3646,3671,3689,-114,-96,778,28702920,1698
1655,m1307,20120907,3671,3689,3682,3706,3629,3632,3669,-57,-20,730,26784160,1786
1656,m1307,20120910,3632,3669,3620,3660,3600,3653,3634,-16,-35,546,19842080,1774
1657,m1307,20120911,3653,3634,3630,3643,3580,3599,3603,-35,-31,660,23783180,1734
1658,m1307,20120912,3599,3603,3595,3625,3584,3624,3605,21,2,446,16078720,1716
1659,m1307,20120913,3624,3605,3641,3669,3623,3623,3648,18,43,340,12405880,1804
1660,m1307,20120914,3623,3648,3663,3683,3644,3649,3662,1,14,440,16112900,1798
1661,m1307,20120917,3649,3662,3640,3640,3499,3500,3562,-162,-100,1160,41326740,2170
1662,m1307,20120918,3500,3562,3450,3470,3410,3447,3454,-115,-108,470,16234360,2056
1663,m1307,20120919,3447,3454,3472,3490,3449,3470,3467,16,13,192,6657440,2014
1664,m1307,20120920,3470,3467,3481,3499,3448,3469,3471,2,4,148,5138380,1992
1665,m1307,20120921,3469,3471,3430,3452,3417,3435,3435,-36,-36,242,8313400,1946
1666,m1307,20120924,3435,3435,3404,3408,3367,3400,3386,-35,-49,252,8535160,1866
1667,m1307,20120925,3400,3386,3398,3441,3398,3422,3422,36,36,156,5338580,1860
1668,m1307,20120926,3422,3422,3395,3419,3371,3385,3393,-37,-29,784,26607860,1242
1669,m1307,20120927,3385,3393,3360,3410,3360,3388,3382,-5,-11,360,12176760,1036
1670,m1307,20120928,3388,3382,3399,3405,3375,3386,3390,4,8,360,12206820,894
1671,m1307,20121008,3386,3390,3370,3370,3335,3340,3354,-50,-36,54,1811240,892
1672,m1307,20121009,3340,3354,3345,3385,3345,3378,3375,24,21,208,7021980,846
1673,m1307,20121010,3378,3375,3277,3369,3277,3354,3349,-21,-26,130,4354580,850
1674,m1307,20121011,3354,3349,3335,3427,3334,3389,3397,40,48,354,12028460,852
1675,m1307,20121012,3389,3397,3412,3421,3360,3360,3392,-37,-5,98,3324240,866
1676,m1307,20121015,3360,3392,3330,3345,3314,3322,3324,-70,-68,162,5385720,864
1677,m1307,20121016,3322,3324,3338,3362,3338,3345,3349,21,25,94,3148780,850
1678,m1307,20121017,3345,3349,3325,3353,3325,3346,3342,-3,-7,64,2139440,854
1679,m1307,20121018,3346,3342,3361,3369,3355,3364,3361,22,19,78,2622280,850
1680,m1307,20121019,3364,3361,3380,3395,3372,3381,3383,20,22,144,4871540,888
1681,m1307,20121022,3381,3383,3398,3401,3373,3388,3384,5,1,160,5414740,852
1682,m1307,20121023,3388,3384,3392,3397,3350,3350,3374,-34,-10,282,9516640,864
1683,m1307,20121024,3350,3374,3361,3395,3361,3385,3380,11,6,106,3583640,846
1684,m1307,20121025,3385,3380,3392,3392,3363,3375,3372,-5,-8,130,4384420,866
1685,m1307,20121026,3375,3372,3350,3383,3342,3345,3361,-27,-11,96,3227000,838
1686,m1307,20121029,3345,3361,3350,3350,3303,3303,3323,-58,-38,250,8309820,802
1687,m1307,20121030,3303,3323,3300,3330,3270,3291,3286,-32,-37,112,3680980,788
1688,m1307,20121031,3291,3286,3306,3348,3296,3348,3316,62,30,100,3316720,756
1689,m1307,20121101,3348,3316,3355,3427,3350,3418,3403,102,87,248,8440120,722
1690,m1307,20121102,3418,3403,3438,3438,3383,3409,3410,6,7,178,6071280,712
1691,m1307,20121105,3409,3410,3382,3382,3340,3361,3365,-49,-45,134,4509920,710
1692,m1307,20121106,3361,3365,3386,3426,3381,3407,3407,42,42,870,29643040,1296
1693,m1307,20121107,3407,3407,3427,3427,3365,3365,3385,-42,-22,888,30061460,810
1694,m1307,20121108,3365,3385,3350,3384,3350,3375,3371,-10,-14,178,6000800,774
1695,m1307,20121109,3375,3371,3363,3375,3344,3345,3357,-26,-14,146,4901600,754
1696,m1307,20121112,3345,3357,3310,3310,3223,3223,3236,-134,-121,288,9320340,754
1697,m1307,20121113,3223,3236,3201,3224,3152,3179,3176,-57,-60,732,23251780,708
1698,m1307,20121114,3179,3176,3180,3216,3155,3207,3194,31,18,214,6836800,686
1699,m1307,20121115,3207,3194,3196,3205,3131,3135,3180,-59,-14,280,8904540,704
1700,m1307,20121116,3135,3180,3130,3144,3111,3124,3126,-56,-54,348,10880500,704
1701,m1307,20121119,3124,3126,3141,3165,3140,3155,3152,29,26,108,3404360,688
1702,m1307,20121120,3155,3152,3164,3164,3117,3121,3129,-31,-23,134,4193400,710
1703,m1307,20121121,3121,3129,3168,3168,3141,3161,3156,32,27,152,4797320,698
1704,m1307,20121122,3161,3156,3158,3179,3151,3171,3168,15,12,326,10328460,500
1705,m1307,20121123,3171,3168,3179,3216,3168,3210,3197,42,29,210,6715160,504
1706,m1307,20121126,3210,3197,3217,3226,3203,3207,3212,10,15,192,6168640,488
1707,m1307,20121127,3207,3212,3221,3227,3206,3206,3223,-6,11,158,5093520,484
1708,m1307,20121128,3206,3223,3247,3250,3224,3230,3236,7,13,128,4142540,480
1709,m1307,20121129,3230,3236,3232,3241,3216,3224,3232,-12,-4,262,8469800,484
1710,m1307,20121130,3224,3232,3217,3233,3200,3233,3211,1,-21,434,13938660,494
1711,m1307,20121203,3233,3211,3232,3266,3228,3265,3251,54,40,424,13786520,466
1712,m1307,20121204,3265,3251,3255,3255,3232,3249,3243,-2,-8,138,4475580,474
1713,m1307,20121205,3249,3243,3269,3276,3260,3275,3268,32,25,136,4444540,444
1714,m1307,20121206,3275,3268,3307,3346,3305,3324,3325,56,57,240,7981860,422
1715,m1307,20121207,3324,3325,3320,3365,3320,3353,3338,28,13,164,5475220,432
1716,m1307,20121210,3353,3338,3322,3346,3322,3334,3331,-4,-7,92,3065280,442
1717,m1307,20121211,3334,3331,3383,3383,3358,3359,3370,28,39,42,1415440,438
1718,m1307,20121212,3359,3370,3366,3369,3344,3348,3360,-22,-10,90,3024340,448
1719,m1307,20121213,3348,3360,3348,3362,3344,3352,3350,-8,-10,48,1608260,432
1720,m1307,20121214,3352,3350,3353,3400,3353,3396,3379,46,29,108,3650260,430
1721,m1307,20121217,3396,3379,3478,3478,3415,3460,3456,81,77,148,5114920,410
1722,m1307,20121218,3460,3456,3450,3450,3415,3421,3425,-35,-31,114,3904580,398
1723,m1307,20121219,3421,3425,3391,3391,3351,3376,3370,-49,-55,144,4853600,388
1724,m1307,20121220,3376,3370,3324,3336,3313,3316,3321,-54,-49,212,7041740,400
1725,m1307,20121221,3316,3321,3270,3351,3270,3337,3330,16,9,298,9924740,416
1726,m1307,20121224,3337,3330,3347,3366,3330,3330,3355,0,25,172,5771400,394
1727,m1307,20121225,3330,3355,3326,3338,3305,3305,3323,-50,-32,118,3921640,430
1728,m1307,20121226,3305,3323,3319,3344,3307,3324,3331,1,8,232,7729420,412
1729,m1307,20121227,3324,3331,3321,3356,3314,3345,3330,14,-1,140,4662880,424
1730,m1307,20121228,3345,3330,3374,3374,3324,3329,3338,-1,8,126,4206500,436
1731,m1307,20121231,3329,3338,3339,3342,3263,3263,3295,-75,-43,86,2834040,420
1732,m1308,20120816,3417,3400,3401,3401,3334,3370,3373,-30,-27,14,472260,10
1733,m1308,20120817,3370,3373,3389,3395,3371,3381,3381,8,8,14,473420,10
1734,m1308,20120820,3381,3381,3413,3425,3409,3425,3414,44,33,28,956020,14
1735,m1308,20120821,3425,3414,3537,3537,3486,3518,3509,104,95,46,1614400,32
1736,m1308,20120822,3518,3509,3535,3560,3508,3548,3546,39,37,128,4538980,74
1737,m1308,20120823,3548,3546,3577,3606,3550,3579,3580,33,34,76,2721300,74
1738,m1308,20120824,3579,3580,3560,3599,3552,3582,3571,2,-9,66,2357440,76
1739,m1308,20120827,3582,3571,3647,3668,3578,3618,3622,47,51,106,3840140,86
1740,m1308,20120828,3618,3622,3620,3620,3573,3573,3596,-49,-26,62,2229600,92
1741,m1308,20120829,3573,3596,3620,3633,3596,3633,3606,37,10,32,1154220,94
1742,m1308,20120830,3633,3606,3601,3656,3601,3651,3639,45,33,42,1528620,98
1743,m1308,20120831,3651,3639,3626,3659,3611,3651,3644,12,5,70,2551060,112
1744,m1308,20120903,3651,3644,3670,3793,3670,3760,3758,116,114,114,4284500,148
1745,m1308,20120904,3760,3758,3786,3794,3768,3791,3781,33,23,80,3025300,168
1746,m1308,20120905,3791,3781,3759,3793,3759,3771,3776,-10,-5,94,3549940,158
1747,m1308,20120906,3771,3776,3710,3717,3641,3671,3678,-105,-98,64,2354100,156
1748,m1308,20120907,3671,3678,3694,3694,3633,3633,3658,-45,-20,38,1390080,150
1749,m1308,20120910,3633,3658,3618,3654,3600,3648,3633,-10,-25,40,1453240,160
1750,m1308,20120911,3648,3633,3638,3654,3576,3585,3606,-48,-27,114,4111180,144
1751,m1308,20120912,3585,3606,3591,3620,3531,3618,3600,12,-6,116,4176580,148
1752,m1308,20120913,3618,3600,3654,3681,3645,3645,3658,45,58,86,3146040,146
1753,m1308,20120914,3645,3658,3688,3696,3650,3654,3670,-4,12,74,2716180,164
1754,m1308,20120917,3654,3670,3602,3603,3511,3511,3552,-159,-118,130,4618280,180
1755,m1308,20120918,3511,3552,3460,3480,3446,3452,3463,-100,-89,96,3324560,140
1756,m1308,20120919,3452,3463,3430,3486,3430,3458,3451,-5,-12,246,8491500,118
1757,m1308,20120920,3458,3451,3455,3462,3440,3462,3453,11,2,28,967000,108
1758,m1308,20120921,3462,3453,3440,3440,3400,3418,3422,-35,-31,44,1505680,114
1759,m1308,20120924,3418,3422,3368,3398,3355,3370,3367,-52,-55,18,606220,116
1760,m1308,20120925,3370,3367,3408,3419,3385,3391,3397,24,30,34,1155160,110
1761,m1308,20120926,3391,3397,3396,3396,3372,3378,3381,-19,-16,12,405760,100
1762,m1308,20120927,3378,3381,3343,3381,3343,3354,3366,-27,-15,26,875180,98
1763,m1308,20120928,3354,3366,3371,3374,3360,3360,3367,-6,1,24,808140,94
1764,m1308,20121008,3360,3367,3345,3345,3332,3332,3339,-35,-28,12,400740,92
1765,m1308,20121009,3332,3339,3350,3358,3350,3358,3354,19,15,4,134160,90
1766,m1308,20121010,3358,3354,3345,3345,3321,3341,3337,-13,-17,18,600800,92
1767,m1308,20121011,3341,3337,3355,3413,3355,3397,3396,60,59,34,1154720,100
1768,m1308,20121012,3397,3396,3455,3455,3360,3364,3393,-32,-3,68,2307680,112
1769,m1308,20121015,3364,3393,3332,3361,3318,3322,3331,-71,-62,88,2932040,146
1770,m1308,20121016,3322,3331,3359,3359,3330,3337,3343,6,12,60,2005880,104
1771,m1308,20121017,3337,3343,3325,3332,3320,3332,3328,-11,-15,36,1198080,102
1772,m1308,20121018,3332,3328,3341,3350,3341,3350,3347,22,19,34,1138100,104
1773,m1308,20121019,3350,3347,3357,3375,3355,3366,3362,19,15,42,1412340,92
1774,m1308,20121022,3366,3362,3355,3383,3355,3370,3364,8,2,14,471040,88
1775,m1308,20121023,3370,3364,3362,3371,3335,3335,3352,-29,-12,96,3218160,120
1776,m1308,20121024,3335,3352,3350,3374,3350,3369,3363,17,11,92,3094060,100
1777,m1308,20121025,3369,3363,3352,3368,3351,3357,3358,-6,-5,56,1880960,94
1778,m1308,20121026,3357,3358,3360,3362,3335,3352,3353,-6,-5,36,1207200,84
1779,m1308,20121029,3352,3353,3325,3332,3290,3295,3309,-58,-44,56,1853140,88
1780,m1308,20121030,3295,3309,3265,3284,3260,3264,3266,-45,-43,14,457300,86
1781,m1308,20121031,3264,3266,3285,3335,3284,3323,3307,57,41,18,595260,82
1782,m1308,20121101,3323,3307,3339,3424,3338,3408,3402,101,95,94,3198140,136
1783,m1308,20121102,3408,3402,3403,3403,3367,3392,3388,-10,-14,48,1626480,136
1784,m1308,20121105,3392,3388,3340,3354,3340,3352,3349,-36,-39,16,535940,138
1785,m1308,20121106,3352,3349,3362,3395,3362,3390,3387,41,38,14,474280,128
1786,m1308,20121107,3390,3387,3397,3400,3336,3352,3352,-35,-35,106,3553520,74
1787,m1308,20121108,3352,3352,3352,3365,3345,3363,3357,11,5,32,1074380,82
1788,m1308,20121109,3363,3357,3369,3369,3336,3340,3353,-17,-4,22,737840,78
1789,m1308,20121112,3340,3353,3226,3226,3219,3220,3220,-133,-133,24,772960,90
1790,m1308,20121113,3220,3220,3190,3198,3143,3160,3180,-60,-40,116,3689600,110
1791,m1308,20121114,3160,3180,3160,3230,3160,3196,3175,16,-5,58,1842040,92
1792,m1308,20121115,3196,3175,3161,3195,3126,3126,3165,-49,-10,276,8737640,90
1793,m1308,20121116,3126,3165,3134,3139,3099,3106,3113,-59,-52,184,5727920,94
1794,m1308,20121119,3106,3113,3114,3140,3114,3136,3132,23,19,28,877080,96
1795,m1308,20121120,3136,3132,3119,3121,3105,3115,3110,-17,-22,78,2426100,108
1796,m1308,20121121,3115,3110,3134,3174,3129,3139,3142,29,32,106,3331280,112
1797,m1308,20121122,3139,3142,3141,3155,3135,3146,3144,4,2,72,2264380,114
1798,m1308,20121123,3146,3144,3164,3191,3160,3191,3167,47,23,38,1203460,108
1799,m1308,20121126,3191,3167,3176,3187,3175,3176,3180,9,13,44,1399600,106
1800,m1308,20121127,3176,3180,3176,3199,3176,3184,3190,4,10,14,446620,114
1801,m1308,20121128,3184,3190,3184,3207,3184,3206,3199,16,9,16,511980,106
1802,m1308,20121129,3206,3199,3229,3229,3196,3213,3209,14,10,90,2888740,106
1803,m1308,20121130,3213,3209,3205,3208,3190,3194,3200,-15,-9,174,5568280,122
1804,m1308,20121203,3194,3200,3194,3289,3194,3241,3254,41,54,672,21868760,322
1805,m1308,20121204,3241,3254,3255,3255,3220,3232,3234,-22,-20,292,9445500,302
1806,m1308,20121205,3232,3234,3256,3260,3237,3255,3246,21,12,64,2077860,288
1807,m1308,20121206,3255,3246,3291,3316,3283,3295,3301,49,55,172,5678840,206
1808,m1308,20121207,3295,3301,3292,3331,3292,3331,3313,30,12,104,3446240,190
1809,m1308,20121210,3331,3313,3303,3314,3293,3306,3304,-7,-9,92,3040460,168
1810,m1308,20121211,3306,3304,3330,3351,3330,3336,3343,32,39,56,1872400,164
1811,m1308,20121212,3336,3343,3343,3377,3311,3317,3328,-26,-15,44,1464380,158
1812,m1308,20121213,3317,3328,3328,3329,3316,3325,3324,-3,-4,36,1196740,154
1813,m1308,20121214,3325,3324,3360,3372,3351,3372,3359,48,35,52,1746920,136
1814,m1308,20121217,3372,3359,3422,3441,3413,3418,3431,59,72,62,2127360,136
1815,m1308,20121218,3418,3431,3368,3404,3366,3400,3385,-31,-46,162,5484360,90
1816,m1308,20121219,3400,3385,3370,3376,3344,3365,3358,-20,-27,46,1545060,90
1817,m1308,20121220,3365,3358,3304,3305,3286,3303,3300,-55,-58,66,2178260,84
1818,m1308,20121221,3303,3300,3299,3334,3285,3320,3309,20,9,72,2383020,88
1819,m1308,20121224,3320,3309,3324,3351,3324,3325,3339,16,30,42,1402760,88
1820,m1308,20121225,3325,3339,3319,3319,3301,3308,3310,-31,-29,18,595900,94
1821,m1308,20121226,3308,3310,3310,3325,3300,3310,3309,0,-1,36,1191320,96
1822,m1308,20121227,3310,3309,3303,3328,3303,3328,3313,19,4,26,861620,94
1823,m1308,20121228,3328,3313,3330,3344,3315,3315,3328,2,15,50,1664020,98
1824,m1308,20121231,3315,3328,3306,3312,3260,3261,3281,-67,-47,22,721900,104
1825,m1309,20120918,3450,3498,3398,3420,3390,3393,3406,-105,-92,20058,683262660,19174
1826,m1309,20120919,3393,3406,3418,3435,3392,3413,3407,7,1,15414,525263880,23940
1827,m1309,20120920,3413,3407,3420,3422,3393,3397,3409,-10,2,12488,425769540,25624
1828,m1309,20120921,3397,3409,3380,3403,3350,3390,3381,-19,-28,18436,623411300,29052
1829,m1309,20120924,3390,3381,3370,3370,3313,3352,3339,-29,-42,18062,603121980,31232
1830,m1309,20120925,3352,3339,3358,3391,3356,3369,3370,30,31,14122,476005140,32874
1831,m1309,20120926,3369,3370,3365,3366,3346,3348,3354,-22,-16,7736,259475160,33148
1832,m1309,20120927,3348,3354,3325,3366,3314,3344,3338,-10,-16,9680,323149380,33544
1833,m1309,20120928,3344,3338,3346,3358,3330,3352,3343,14,5,7736,258617460,34274
1834,m1309,20121008,3352,3343,3335,3346,3296,3302,3322,-41,-21,16568,550525360,37028
1835,m1309,20121009,3302,3322,3320,3356,3315,3346,3340,24,18,23848,796577820,42816
1836,m1309,20121010,3346,3340,3330,3330,3308,3319,3317,-21,-23,18008,597355100,46874
1837,m1309,20121011,3319,3317,3301,3393,3300,3367,3359,50,42,36054,1211261080,44190
1838,m1309,20121012,3367,3359,3377,3400,3332,3339,3367,-20,8,29180,982687220,50520
1839,m1309,20121015,3339,3367,3310,3335,3301,3322,3319,-45,-48,38524,1278931360,60580
1840,m1309,20121016,3322,3319,3338,3359,3334,3335,3344,16,25,29952,1001638280,62826
1841,m1309,20121017,3335,3344,3320,3335,3310,3329,3321,-15,-23,30344,1007823100,69674
1842,m1309,20121018,3329,3321,3337,3349,3337,3345,3343,24,22,18336,612994740,70074
1843,m1309,20121019,3345,3343,3361,3365,3346,3354,3354,11,11,19952,669375960,68170
1844,m1309,20121022,3354,3354,3354,3363,3331,3362,3351,8,-3,23136,775334400,69514
1845,m1309,20121023,3362,3351,3359,3365,3320,3321,3341,-30,-10,20816,695508000,73524
1846,m1309,20121024,3321,3341,3333,3364,3333,3361,3350,20,9,25452,852799240,79138
1847,m1309,20121025,3361,3350,3362,3366,3334,3339,3344,-11,-6,27338,914323820,82248
1848,m1309,20121026,3339,3344,3339,3353,3320,3337,3337,-7,-7,26296,877665400,82090
1849,m1309,20121029,3337,3337,3330,3334,3281,3287,3306,-50,-31,43248,1429922720,90434
1850,m1309,20121030,3287,3306,3278,3279,3248,3270,3263,-36,-43,41302,1347694320,95498
1851,m1309,20121031,3270,3263,3275,3312,3260,3309,3280,46,17,28042,920033380,91636
1852,m1309,20121101,3309,3280,3310,3391,3310,3377,3350,97,70,47582,1594346720,90078
1853,m1309,20121102,3377,3350,3368,3379,3343,3364,3360,14,10,34744,1167527020,87784
1854,m1309,20121105,3364,3360,3330,3336,3301,3319,3316,-41,-44,34566,1146467480,92216
1855,m1309,20121106,3319,3316,3314,3373,3314,3361,3346,45,30,30904,1034222500,90434
1856,m1309,20121107,3361,3346,3376,3387,3317,3327,3346,-19,0,58332,1951861620,103774
1857,m1309,20121108,3327,3346,3312,3342,3301,3331,3326,-15,-20,42870,1426221040,104124
1858,m1309,20121109,3331,3326,3323,3333,3302,3307,3317,-19,-9,38596,1280379920,110736
1859,m1309,20121112,3307,3317,3250,3250,3185,3185,3197,-132,-120,70404,2251435100,130252
1860,m1309,20121113,3185,3197,3175,3187,3126,3146,3155,-51,-42,103324,3260862680,153288
1861,m1309,20121114,3146,3155,3156,3174,3140,3170,3156,15,1,62906,1985750280,160732
1862,m1309,20121115,3170,3156,3155,3167,3086,3091,3137,-65,-19,95786,3004888600,184850
1863,m1309,20121116,3091,3137,3091,3104,3062,3073,3078,-64,-59,129332,3981254660,196176
1864,m1309,20121119,3073,3078,3091,3124,3091,3116,3108,38,30,100480,3123780540,193884
1865,m1309,20121120,3116,3108,3116,3120,3074,3084,3089,-24,-19,96070,2967999220,199858
1866,m1309,20121121,3084,3089,3112,3120,3101,3119,3111,30,22,85230,2652151420,195770
1867,m1309,20121122,3119,3111,3120,3133,3103,3122,3119,11,8,116544,3636129740,200746
1868,m1309,20121123,3122,3119,3119,3168,3117,3166,3144,47,25,110680,3480478760,215856
1869,m1309,20121126,3166,3144,3170,3170,3147,3150,3156,6,12,78526,2479040680,217504
1870,m1309,20121127,3150,3156,3160,3177,3160,3161,3167,5,11,77518,2455520320,216756
1871,m1309,20121128,3161,3167,3182,3203,3170,3182,3188,15,21,127630,4069192860,215962
1872,m1309,20121129,3182,3188,3185,3191,3165,3186,3178,-2,-10,103344,3284718420,215206
1873,m1309,20121130,3186,3178,3180,3187,3166,3177,3177,-1,-1,89518,2844666900,221418
1874,m1309,20121203,3177,3177,3188,3247,3182,3243,3230,66,53,183924,5941932320,220088
1875,m1309,20121204,3243,3230,3239,3248,3217,3231,3229,1,-1,109670,3541468300,247734
1876,m1309,20121205,3231,3229,3245,3252,3232,3248,3240,19,11,130674,4234617620,232412
1877,m1309,20121206,3248,3240,3270,3308,3270,3291,3285,51,45,243128,7988624060,258432
1878,m1309,20121207,3291,3285,3289,3312,3276,3311,3295,26,10,179634,5919574600,284522
1879,m1309,20121210,3311,3295,3281,3291,3270,3286,3281,-9,-14,153468,5035486140,276012
1880,m1309,20121211,3286,3281,3291,3333,3291,3320,3320,39,39,206776,6866864460,244996
1881,m1309,20121212,3320,3320,3318,3320,3283,3290,3303,-30,-17,145578,4809092300,244832
1882,m1309,20121213,3290,3303,3306,3311,3288,3300,3300,-3,-3,151270,4992478420,236754
1883,m1309,20121214,3300,3300,3307,3354,3302,3353,3333,53,33,192484,6415594260,232694
1884,m1309,20121217,3353,3333,3373,3423,3370,3405,3405,72,72,235122,8006964920,242590
1885,m1309,20121218,3405,3405,3398,3408,3364,3370,3380,-35,-25,224536,7590410840,243044
1886,m1309,20121219,3370,3380,3342,3348,3312,3337,3334,-43,-46,210478,7017729380,246248
1887,m1309,20121220,3337,3334,3296,3296,3266,3279,3277,-55,-57,201754,6611626480,266456
1888,m1309,20121221,3279,3277,3255,3319,3254,3299,3296,22,19,387654,12778366180,330836
1889,m1309,20121224,3299,3296,3320,3340,3301,3302,3321,6,25,386028,12821057360,359202
1890,m1309,20121225,3302,3321,3312,3312,3268,3269,3284,-52,-37,361758,11882174760,361410
1891,m1309,20121226,3269,3284,3269,3305,3258,3278,3284,-6,0,334508,10985399960,364092
1892,m1309,20121227,3278,3284,3270,3309,3258,3308,3288,24,4,330542,10869514080,371266
1893,m1309,20121228,3308,3288,3302,3310,3281,3288,3296,0,8,262178,8643409280,361692
1894,m1309,20121231,3288,3296,3288,3297,3223,3226,3261,-70,-35,295032,9622156300,377140
1895,m1311,20121116,3086,3140,3072,3088,3062,3062,3074,-78,-66,20,614800,44
1896,m1311,20121119,3062,3074,3090,3117,3090,3099,3103,25,29,16,496480,46
1897,m1311,20121120,3099,3103,3077,3077,3062,3065,3072,-38,-31,40,1228960,70
1898,m1311,20121121,3065,3072,3065,3109,3065,3091,3097,19,25,20,619400,72
1899,m1311,20121122,3091,3097,3105,3117,3078,3110,3105,13,8,132,4099540,128
1900,m1311,20121123,3110,3105,3116,3147,3106,3146,3132,41,27,100,3132680,122
1901,m1311,20121126,3146,3132,3157,3157,3134,3135,3139,3,7,126,3956240,150
1902,m1311,20121127,3135,3139,3146,3163,3143,3145,3149,6,10,90,2834900,156
1903,m1311,20121128,3145,3149,3175,3194,3156,3161,3173,12,24,82,2602320,174
1904,m1311,20121129,3161,3173,3154,3171,3154,3170,3163,-3,-10,48,1518440,172
1905,m1311,20121130,3170,3163,3158,3171,3155,3166,3163,3,0,138,4366240,194
1906,m1311,20121203,3166,3163,3166,3239,3164,3217,3222,54,59,212,6831880,178
1907,m1311,20121204,3217,3222,3226,3230,3196,3216,3212,-6,-10,128,4111720,232
1908,m1311,20121205,3216,3212,3211,3236,3211,3230,3229,18,17,106,3422940,262
1909,m1311,20121206,3230,3229,3255,3290,3252,3275,3267,46,38,328,10716200,254
1910,m1311,20121207,3275,3267,3261,3296,3261,3296,3284,29,17,146,4795540,274
1911,m1311,20121210,3296,3284,3245,3278,3245,3272,3268,-12,-16,148,4836720,276
1912,m1311,20121211,3272,3268,3275,3318,3275,3302,3305,34,37,174,5751980,280
1913,m1311,20121212,3302,3305,3299,3308,3275,3283,3291,-22,-14,158,5200140,316
1914,m1311,20121213,3283,3291,3299,3299,3278,3295,3288,4,-3,168,5524520,348
1915,m1311,20121214,3295,3288,3296,3345,3296,3345,3323,57,35,128,4253520,310
1916,m1311,20121217,3345,3323,3365,3410,3365,3396,3397,73,74,74,2514080,326
1917,m1311,20121218,3396,3397,3392,3397,3355,3373,3371,-24,-26,80,2697360,332
1918,m1311,20121219,3373,3371,3331,3341,3308,3327,3323,-44,-48,100,3323240,346
1919,m1311,20121220,3327,3323,3259,3270,3243,3269,3262,-54,-61,72,2349000,344
1920,m1311,20121221,3269,3262,3260,3306,3245,3281,3284,19,22,190,6240480,296
1921,m1311,20121224,3281,3284,3299,3317,3285,3285,3299,1,15,158,5212460,308
1922,m1311,20121225,3285,3299,3263,3274,3251,3251,3264,-48,-35,88,2872960,308
1923,m1311,20121226,3251,3264,3260,3290,3260,3271,3275,7,11,128,4192740,318
1924,m1311,20121227,3271,3275,3270,3305,3270,3305,3285,30,10,78,2562900,312
1925,m1311,20121228,3305,3285,3301,3308,3281,3284,3294,-1,9,86,2832980,308
1926,m1311,20121231,3284,3294,3278,3278,3225,3232,3257,-62,-37,94,3062380,312
1927,m1312,20121218,3383,3399,3398,3398,3359,3360,3366,-39,-33,54,1818140,36
1928,m1312,20121219,3360,3366,3313,3336,3307,3328,3324,-38,-42,58,1928040,60
1929,m1312,20121220,3328,3324,3266,3275,3230,3275,3265,-49,-59,48,1567460,84
1930,m1312,20121221,3275,3265,3265,3312,3264,3288,3294,23,29,172,5666280,116
1931,m1312,20121224,3288,3294,3324,3324,3294,3294,3309,0,15,72,2382500,116
1932,m1312,20121225,3294,3309,3268,3278,3260,3260,3268,-49,-41,56,1830120,122
1933,m1312,20121226,3260,3268,3274,3301,3264,3277,3282,9,14,78,2560120,152
1934,m1312,20121227,3277,3282,3284,3308,3280,3308,3292,26,10,34,1119360,154
1935,m1312,20121228,3308,3292,3302,3302,3265,3281,3291,-11,-1,36,1184780,138
1936,m1312,20121231,3281,3291,3265,3265,3233,3238,3243,-53,-48,38,1232380,150
