   ,合约,日期,前收盘价,前结算价,开盘价,最高价,最低价,收盘价,结算价,涨跌1,涨跌2,成交量,成交金额,持仓量
1,m1101,20110104,3338,3351,3450,3450,3350,3350,3375,-1,24,528,17823760,2748
2,m1101,20110105,3350,3375,3350,3350,3310,3310,3333,-65,-42,1400,46670400,1372
3,m1101,20110106,3310,3333,3336,3340,3330,3335,3336,2,3,658,21955520,1086
4,m1101,20110107,3335,3336,3340,3340,3320,3320,3327,-16,-9,646,21497200,440
5,m1101,20110110,3320,3327,3330,3330,3330,3330,3330,3,3,104,3463200,336
6,m1101,20110111,3330,3330,0,0,0,3330,3330,0,0,0,0,336
7,m1101,20110112,3330,3330,0,0,0,3330,3330,0,0,0,0,336
8,m1101,20110113,3330,3330,0,0,0,3330,3330,0,0,0,0,336
9,m1101,20110114,3330,3330,0,0,0,3330,3330,0,0,0,0,336
10,m1101,20110117,3330,3330,0,0,0,3330,3339,0,9,0,0,0
11,m1103,20110104,3340,3332,3333,3360,3333,3360,3347,28,15,8,267800,404
12,m1103,20110105,3360,3347,3345,3345,3325,3333,3335,-14,-12,26,867220,398
13,m1103,20110106,3333,3335,3387,3387,3352,3352,3369,17,34,4,134780,396
14,m1103,20110107,3352,3369,3319,3353,3319,3335,3332,-34,-37,10,333280,400
15,m1103,20110110,3335,3332,3362,3366,3343,3346,3352,14,20,10,335240,398
16,m1103,20110111,3346,3352,3343,3367,3343,3367,3355,15,3,4,134200,398
17,m1103,20110112,3367,3355,3356,3356,3356,3356,3356,1,1,2,67120,400
18,m1103,20110113,3356,3356,3397,3444,3384,3417,3417,61,61,50,1708920,384
19,m1103,20110114,3417,3417,3413,3440,3413,3438,3435,21,18,76,2611020,320
20,m1103,20110117,3438,3435,3460,3489,3456,3465,3467,30,32,58,2011400,300
21,m1103,20110118,3465,3467,3462,3488,3462,3480,3479,13,12,46,1600600,258
22,m1103,20110119,3480,3479,3480,3480,3480,3480,3480,1,1,48,1670400,210
23,m1103,20110120,3480,3480,3501,3506,3450,3459,3459,-21,-21,88,3044020,154
24,m1103,20110121,3459,3459,3459,3489,3456,3456,3460,-3,1,62,2145220,98
25,m1103,20110124,3456,3460,3585,3585,3289,3490,3457,30,-3,50,1728880,100
26,m1103,20110125,3490,3457,3479,3479,3415,3446,3430,-11,-27,22,754600,100
27,m1103,20110126,3446,3430,3380,3380,3356,3356,3364,-74,-66,8,269120,104
28,m1103,20110127,3356,3364,3387,3400,3371,3371,3390,7,26,20,678180,94
29,m1103,20110128,3371,3390,3381,3414,3381,3414,3398,24,8,14,475820,88
30,m1103,20110131,3414,3398,3429,3454,3425,3425,3435,27,37,10,343500,82
31,m1103,20110201,3425,3435,3499,3499,3464,3464,3485,29,50,8,278860,80
32,m1103,20110209,3464,3485,3499,3500,3499,3500,3499,15,14,28,979980,52
33,m1103,20110210,3500,3499,0,0,0,3499,3499,0,0,0,0,52
34,m1103,20110211,3499,3499,3499,3499,3490,3495,3494,-4,-5,6,209680,46
35,m1103,20110214,3495,3494,3659,3659,3471,3615,3590,121,96,8,287200,50
36,m1103,20110215,3615,3590,3451,3490,3451,3490,3477,-100,-113,6,208620,46
37,m1103,20110216,3490,3477,0,0,0,3477,3477,0,0,0,0,46
38,m1103,20110217,3477,3477,3570,3570,3440,3440,3521,-37,44,10,352180,46
39,m1103,20110218,3440,3521,0,0,0,3521,3521,0,0,0,0,46
40,m1103,20110221,3521,3521,3520,3520,3520,3520,3520,-1,-1,6,211200,44
41,m1103,20110222,3520,3520,3501,3501,3400,3409,3432,-111,-88,66,2265240,48
42,m1103,20110223,3409,3432,3408,3408,3235,3240,3284,-192,-148,52,1708100,50
43,m1103,20110224,3240,3284,3240,3299,3232,3250,3267,-34,-17,30,980380,38
44,m1103,20110225,3250,3267,3345,3345,3260,3260,3260,-7,-7,402,13106900,436
45,m1103,20110228,3260,3260,3355,3355,3206,3222,3269,-38,9,430,14057980,30
46,m1103,20110301,3222,3269,0,0,0,3269,3269,0,0,0,0,30
47,m1103,20110302,3269,3269,3349,3349,3349,3349,3349,80,80,2,66980,30
48,m1103,20110303,3349,3349,0,0,0,3349,3349,0,0,0,0,30
49,m1103,20110304,3349,3349,0,0,0,3349,3349,0,0,0,0,30
50,m1103,20110307,3349,3349,3380,3380,3380,3380,3380,31,31,2,67600,30
51,m1103,20110308,3380,3380,0,0,0,3380,3380,0,0,0,0,30
52,m1103,20110309,3380,3380,3440,3440,3440,3440,3440,60,60,2,68800,30
53,m1103,20110310,3440,3440,0,0,0,3440,3440,0,0,0,0,30
54,m1103,20110311,3440,3440,0,0,0,3440,3440,0,0,0,0,30
55,m1103,20110314,3440,3440,0,0,0,3440,3389,0,-51,0,0,0
56,m1105,20110104,3393,3388,3391,3405,3379,3379,3388,-9,0,8984,304397280,130188
57,m1105,20110105,3379,3388,3372,3372,3335,3343,3349,-45,-39,8918,298750300,128086
58,m1105,20110106,3343,3349,3364,3384,3360,3379,3376,30,27,6544,220978700,127290
59,m1105,20110107,3379,3376,3361,3370,3331,3331,3351,-45,-25,11796,395332140,124388
60,m1105,20110110,3331,3351,3338,3371,3338,3355,3357,4,6,5720,192022800,122670
61,m1105,20110111,3355,3357,3385,3387,3361,3371,3372,14,15,3004,101319180,122452
62,m1105,20110112,3371,3372,3355,3382,3352,3366,3366,-6,-6,7130,240035000,120472
63,m1105,20110113,3366,3366,3446,3456,3416,3426,3427,60,61,16028,549326460,115378
64,m1105,20110114,3426,3427,3430,3470,3422,3469,3455,42,28,10878,375871540,110080
65,m1105,20110117,3469,3455,3488,3519,3470,3505,3498,50,43,10622,371597780,106292
66,m1105,20110118,3505,3498,3500,3513,3478,3510,3495,12,-3,4722,165073000,104812
67,m1105,20110119,3510,3495,3506,3513,3499,3506,3504,11,9,19664,689079000,89262
68,m1105,20110120,3506,3504,3499,3510,3475,3480,3493,-24,-11,17912,625833360,81910
69,m1105,20110121,3480,3493,3478,3506,3472,3489,3494,-4,1,11934,416992020,74560
70,m1105,20110124,3489,3494,3495,3533,3490,3522,3509,28,15,16320,572688600,61712
71,m1105,20110125,3522,3509,3509,3520,3460,3460,3498,-49,-11,16696,584117340,49340
72,m1105,20110126,3460,3498,3452,3452,3397,3409,3416,-89,-82,4388,149907140,48206
73,m1105,20110127,3409,3416,3434,3440,3414,3430,3426,14,10,2496,85529340,47724
74,m1105,20110128,3430,3426,3424,3434,3416,3416,3425,-10,-1,1836,62894320,46900
75,m1105,20110131,3416,3425,3422,3445,3422,3441,3436,16,11,1706,58631760,46416
76,m1105,20110201,3441,3436,3431,3465,3431,3464,3453,28,17,2570,88763760,45412
77,m1105,20110209,3464,3453,3500,3500,3465,3480,3482,27,29,3646,126979320,45212
78,m1105,20110210,3480,3482,3482,3505,3472,3479,3492,-3,10,5406,188805000,44382
79,m1105,20110211,3479,3492,3466,3489,3455,3487,3474,-5,-18,4482,155727280,41546
80,m1105,20110214,3487,3474,3400,3488,3400,3470,3459,-4,-15,4430,153261700,40828
81,m1105,20110215,3470,3459,3455,3457,3420,3420,3432,-39,-27,3380,116024180,39848
82,m1105,20110216,3420,3432,3381,3403,3381,3403,3390,-29,-42,1746,59206760,39450
83,m1105,20110217,3403,3390,3416,3416,3378,3381,3397,-9,7,3204,108852560,37730
84,m1105,20110218,3381,3397,3409,3419,3397,3399,3406,2,9,1160,39512500,37016
85,m1105,20110221,3399,3406,3399,3399,3370,3385,3394,-21,-12,1458,49486480,35916
86,m1105,20110222,3385,3394,3406,3417,3362,3398,3397,4,3,6054,205656740,31026
87,m1105,20110223,3398,3397,3306,3310,3255,3288,3294,-109,-103,5052,166413240,30378
88,m1105,20110224,3288,3294,3310,3310,3255,3263,3271,-31,-23,5588,182787920,30498
89,m1105,20110225,3263,3271,3289,3310,3277,3304,3299,33,28,1146,37807660,30698
90,m1105,20110228,3304,3299,3341,3351,3305,3316,3320,17,21,4690,155715920,30002
91,m1105,20110301,3316,3320,3317,3317,3296,3300,3303,-20,-17,2176,71878260,29788
92,m1105,20110302,3300,3303,3301,3332,3296,3328,3314,25,11,2884,95601180,29704
93,m1105,20110303,3328,3314,3325,3328,3308,3312,3317,-2,3,1142,37890780,29672
94,m1105,20110304,3312,3317,3323,3335,3312,3322,3325,5,8,750,24943620,29570
95,m1105,20110307,3322,3325,3320,3320,3306,3309,3311,-16,-14,966,31989100,29550
96,m1105,20110308,3309,3311,3290,3290,3248,3275,3264,-36,-47,1716,56026000,29648
97,m1105,20110309,3275,3264,3279,3282,3263,3263,3271,-1,7,812,26565680,29586
98,m1105,20110310,3263,3271,3228,3243,3216,3216,3229,-55,-42,1918,61944700,28398
99,m1105,20110311,3216,3229,3230,3232,3198,3208,3212,-21,-17,1574,50557320,27924
100,m1105,20110314,3208,3212,3188,3209,3162,3167,3178,-45,-34,2126,67585080,27842
101,m1105,20110315,3167,3178,3188,3190,3162,3182,3175,4,-3,1512,48015660,27568
102,m1105,20110316,3182,3175,3111,3130,3109,3115,3118,-60,-57,1864,58126000,27344
103,m1105,20110317,3115,3118,3115,3138,3109,3130,3125,12,7,1410,44068320,27298
104,m1105,20110318,3130,3125,3152,3163,3140,3146,3148,21,23,882,27771120,26992
105,m1105,20110321,3146,3148,3156,3176,3145,3160,3157,12,9,1432,45212740,26910
106,m1105,20110322,3160,3157,3157,3160,3147,3157,3155,0,-2,686,21649500,26958
107,m1105,20110323,3157,3155,3160,3184,3158,3181,3172,26,17,1098,34838420,26878
108,m1105,20110324,3181,3172,3171,3204,3166,3177,3187,5,15,1262,40229480,26886
109,m1105,20110325,3177,3187,3180,3198,3162,3170,3178,-17,-9,1286,40872080,27552
110,m1105,20110328,3170,3178,3161,3169,3130,3151,3156,-27,-22,1030,32515180,27770
111,m1105,20110329,3151,3156,3130,3150,3130,3138,3137,-18,-19,1088,34137480,28028
112,m1105,20110330,3138,3137,3143,3150,3124,3149,3140,12,3,1844,57906640,27972
113,m1105,20110331,3149,3140,3149,3165,3141,3161,3152,21,12,1194,37639060,27768
114,m1105,20110401,3161,3152,3190,3190,3173,3186,3182,34,30,992,31572380,27354
115,m1105,20110406,3186,3182,3175,3175,3146,3146,3153,-36,-29,1648,51971940,27828
116,m1105,20110407,3146,3153,3145,3161,3145,3161,3157,8,4,2598,82041580,27954
117,m1105,20110408,3161,3157,3146,3154,3145,3154,3150,-3,-7,1344,42339740,27944
118,m1105,20110411,3154,3150,3170,3175,3162,3166,3169,16,19,1322,41900680,27928
119,m1105,20110412,3166,3169,3145,3148,3123,3130,3137,-39,-32,1796,56342400,27860
120,m1105,20110413,3130,3137,3102,3108,3081,3100,3094,-37,-43,3454,106884060,28388
121,m1105,20110414,3100,3094,3090,3095,3072,3078,3084,-16,-10,1594,49161200,27116
122,m1105,20110415,3078,3084,3076,3080,3053,3055,3067,-29,-17,1172,35947280,26398
123,m1105,20110418,3055,3067,3023,3045,3023,3035,3029,-32,-38,590,17875180,26280
124,m1105,20110419,3035,3029,3030,3038,3020,3020,3025,-9,-4,1490,45085060,25404
125,m1105,20110420,3020,3025,3026,3040,3026,3030,3034,5,9,5644,171286080,25534
126,m1105,20110421,3030,3034,3034,3066,3030,3035,3038,1,4,1256,38163540,25626
127,m1105,20110422,3035,3038,3035,3070,3035,3069,3061,31,23,1664,50935100,25784
128,m1105,20110425,3069,3061,3068,3085,3063,3070,3082,9,21,7250,223505140,26104
129,m1105,20110426,3070,3082,3052,3060,3051,3055,3055,-27,-27,1174,35867160,25470
130,m1105,20110427,3055,3055,3065,3073,3065,3070,3069,15,14,2044,62745080,24778
131,m1105,20110428,3070,3069,3078,3078,3054,3064,3064,-5,-5,17324,530901860,19334
132,m1105,20110429,3064,3064,3036,3036,2999,3007,3004,-57,-60,3982,119632320,16016
133,m1105,20110503,3007,3004,3050,3070,3001,3010,3041,6,37,1028,31263540,14814
134,m1105,20110504,3010,3041,2930,2980,2930,2946,2970,-95,-71,400,11883020,7820
135,m1105,20110505,2946,2970,3014,3014,3000,3000,3001,30,31,272,8165040,8082
136,m1105,20110506,3000,3001,0,0,0,3001,3001,0,0,0,0,8082
137,m1105,20110509,3001,3001,0,0,0,3001,3001,0,0,0,0,8082
138,m1105,20110510,3001,3001,0,0,0,3001,3001,0,0,0,0,8082
139,m1105,20110511,3001,3001,2970,2970,2970,2970,2970,-31,-31,3494,103771800,8082
140,m1105,20110512,2970,2970,2970,2970,2970,2970,2970,0,0,3600,106920000,8082
141,m1105,20110513,2970,2970,0,0,0,2970,2970,0,0,0,0,8082
142,m1105,20110516,2970,2970,0,0,0,2970,2979,0,9,0,0,0
143,m1107,20110104,3358,3354,3346,3364,3346,3355,3357,1,3,80,2685700,3038
144,m1107,20110105,3355,3357,3336,3360,3315,3320,3326,-37,-31,94,3126560,3040
145,m1107,20110106,3320,3326,3333,3353,3333,3350,3346,24,20,126,4216300,3024
146,m1107,20110107,3350,3346,3330,3335,3299,3308,3308,-38,-38,210,6948760,3022
147,m1107,20110110,3308,3308,3310,3344,3310,3323,3327,15,19,116,3860020,3024
148,m1107,20110111,3323,3327,3341,3350,3332,3340,3340,13,13,178,5945500,2898
149,m1107,20110112,3340,3340,3340,3358,3328,3337,3341,-3,1,226,7550700,2770
150,m1107,20110113,3337,3341,3386,3400,3382,3392,3394,51,53,198,6720920,2774
151,m1107,20110114,3392,3394,3390,3420,3388,3418,3408,24,14,422,14385060,2544
152,m1107,20110117,3418,3408,3417,3460,3367,3456,3442,48,34,308,10604020,2438
153,m1107,20110118,3456,3442,3443,3466,3434,3460,3450,18,8,136,4692180,2386
154,m1107,20110119,3460,3450,3469,3469,3463,3463,3463,13,13,94,3255340,2298
155,m1107,20110120,3463,3463,3430,3455,3421,3430,3442,-33,-21,32,1101580,2292
156,m1107,20110121,3430,3442,3449,3455,3425,3426,3433,-16,-9,118,4051000,2296
157,m1107,20110124,3426,3433,3415,3463,3415,3446,3446,13,13,164,5651980,2220
158,m1107,20110125,3446,3446,3435,3436,3410,3420,3426,-26,-20,138,4727900,2192
159,m1107,20110126,3420,3426,3361,3361,3324,3331,3340,-95,-86,188,6280920,2152
160,m1107,20110127,3331,3340,3351,3359,3340,3351,3352,11,12,172,5765900,2136
161,m1107,20110128,3351,3352,3353,3353,3341,3345,3347,-7,-5,88,2945920,2096
162,m1107,20110131,3345,3347,3367,3375,3363,3365,3369,18,22,182,6132380,1978
163,m1107,20110201,3365,3369,3369,3395,3369,3395,3378,26,9,98,3310580,1926
164,m1107,20110209,3395,3378,3397,3439,3397,3439,3430,61,52,112,3841900,1900
165,m1107,20110210,3439,3430,3458,3465,3422,3422,3447,-8,17,170,5860460,1842
166,m1107,20110211,3422,3447,3435,3442,3421,3440,3433,-7,-14,70,2403660,1824
167,m1107,20110214,3440,3433,3456,3456,3440,3442,3443,9,10,42,1446460,1808
168,m1107,20110215,3442,3443,3424,3434,3405,3405,3426,-38,-17,66,2261760,1796
169,m1107,20110216,3405,3426,3410,3410,3380,3395,3387,-31,-39,84,2845280,1774
170,m1107,20110217,3395,3387,3393,3403,3381,3381,3393,-6,6,156,5293420,1798
171,m1107,20110218,3381,3393,3415,3416,3403,3410,3409,17,16,46,1568240,1780
172,m1107,20110221,3410,3409,3385,3400,3385,3400,3393,-9,-16,22,746540,1768
173,m1107,20110222,3400,3393,3385,3416,3382,3409,3400,16,7,140,4760080,1768
174,m1107,20110223,3409,3400,3297,3308,3297,3299,3301,-101,-99,16,528160,1770
175,m1107,20110224,3299,3301,3304,3317,3252,3264,3288,-37,-13,32,1052360,1760
176,m1107,20110225,3264,3288,3245,3300,3245,3300,3295,12,7,38,1252160,1760
177,m1107,20110228,3300,3295,3323,3340,3323,3330,3332,35,37,42,1399840,1764
178,m1107,20110301,3330,3332,3321,3331,3297,3330,3322,-2,-10,14,465120,1764
179,m1107,20110302,3330,3322,3342,3349,3335,3342,3343,20,21,34,1136780,1760
180,m1107,20110303,3342,3343,3346,3349,3325,3325,3344,-18,1,14,468260,1754
181,m1107,20110304,3325,3344,3347,3366,3347,3357,3351,13,7,34,1139640,1754
182,m1107,20110307,3357,3351,3350,3350,3335,3337,3347,-14,-4,22,736440,1748
183,m1107,20110308,3337,3347,3312,3319,3291,3291,3308,-56,-39,14,463160,1742
184,m1107,20110309,3291,3308,3278,3300,3278,3300,3283,-8,-25,8,262680,1740
185,m1107,20110310,3300,3283,3252,3253,3252,3253,3252,-30,-31,20,650580,1734
186,m1107,20110311,3253,3252,3258,3258,3235,3235,3246,-17,-6,54,1752880,1704
187,m1107,20110314,3235,3246,3257,3257,3208,3208,3229,-38,-17,66,2131400,1718
188,m1107,20110315,3208,3229,3256,3266,3204,3219,3218,-10,-11,102,3283300,1684
189,m1107,20110316,3219,3218,3119,3158,3119,3146,3145,-72,-73,148,4654860,1622
190,m1107,20110317,3146,3145,3128,3163,3128,3156,3155,11,10,22,694180,1632
191,m1107,20110318,3156,3155,3177,3190,3170,3182,3182,27,27,112,3564340,1574
192,m1107,20110321,3182,3182,3205,3219,3191,3210,3209,28,27,50,1604800,1554
193,m1107,20110322,3210,3209,3195,3214,3190,3214,3198,5,-11,50,1599420,1534
194,m1107,20110323,3214,3198,3220,3243,3215,3243,3232,45,34,100,3232920,1492
195,m1107,20110324,3243,3232,3235,3238,3220,3220,3232,-12,0,60,1939760,1466
196,m1107,20110325,3220,3232,3225,3245,3225,3240,3238,8,6,40,1295480,1442
197,m1107,20110328,3240,3238,3253,3253,3214,3221,3239,-17,1,30,971720,1422
198,m1107,20110329,3221,3239,3239,3239,3201,3226,3219,-13,-20,62,1995900,1428
199,m1107,20110330,3226,3219,3230,3230,3221,3229,3228,10,9,114,3680800,1520
200,m1107,20110331,3229,3228,3231,3231,3219,3224,3224,-4,-4,22,709420,1516
201,m1107,20110401,3224,3224,3236,3246,3225,3240,3237,16,13,214,6927740,1468
202,m1107,20110406,3240,3237,3201,3224,3200,3210,3211,-27,-26,26,834860,1460
203,m1107,20110407,3210,3211,3210,3210,3210,3210,3210,-1,-1,2,64200,1460
204,m1107,20110408,3210,3210,3193,3211,3191,3211,3199,1,-11,50,1599580,1440
205,m1107,20110411,3211,3199,3229,3236,3215,3235,3232,36,33,136,4395880,1382
206,m1107,20110412,3235,3232,3181,3204,3181,3189,3190,-43,-42,14,446680,1380
207,m1107,20110413,3189,3190,3132,3164,3132,3164,3150,-26,-40,24,756140,1386
208,m1107,20110414,3164,3150,3150,3160,3150,3152,3153,2,3,10,315320,1380
209,m1107,20110415,3152,3153,3131,3139,3131,3139,3136,-14,-17,28,878240,1378
210,m1107,20110418,3139,3136,3137,3137,3125,3125,3127,-11,-9,22,687980,1386
211,m1107,20110419,3125,3127,3121,3138,3110,3112,3121,-15,-6,60,1872760,1412
212,m1107,20110420,3112,3121,3120,3124,3110,3110,3119,-11,-2,54,1684600,1452
213,m1107,20110421,3110,3119,3114,3114,3114,3114,3114,-5,-5,4,124560,1456
214,m1107,20110422,3114,3114,3124,3149,3124,3147,3135,33,21,70,2194500,1474
215,m1107,20110425,3147,3135,3149,3153,3126,3152,3147,17,12,30,944200,1476
216,m1107,20110426,3152,3147,3118,3137,3118,3121,3122,-26,-25,12,374720,1478
217,m1107,20110427,3121,3122,3149,3149,3130,3147,3130,25,8,752,23538680,1476
218,m1107,20110428,3147,3130,3145,3145,3131,3144,3139,14,9,330,10361520,1476
219,m1107,20110429,3144,3139,3122,3122,3070,3079,3086,-60,-53,76,2345620,1516
220,m1107,20110503,3079,3086,3109,3109,3093,3095,3098,9,12,16,495720,1516
221,m1107,20110504,3095,3098,3079,3079,3062,3065,3070,-33,-28,38,1166620,1508
222,m1107,20110505,3065,3070,3040,3070,3040,3060,3060,-10,-10,276,8445740,1510
223,m1107,20110506,3060,3060,3022,3030,3012,3018,3028,-42,-32,164,4967000,1506
224,m1107,20110509,3018,3028,3049,3049,3016,3025,3030,-3,2,10,303000,1506
225,m1107,20110510,3025,3030,3038,3038,3030,3035,3033,5,3,14,424740,1506
226,m1107,20110511,3035,3033,3022,3026,3016,3016,3021,-17,-12,66,1994040,1528
227,m1107,20110512,3016,3021,3020,3020,2987,2987,2998,-34,-23,100,2998260,1532
228,m1107,20110513,2987,2998,3005,3012,2995,3004,3001,6,3,144,4322260,1582
229,m1107,20110516,3004,3001,2999,3003,2996,3000,2998,-1,-3,32,959560,1582
230,m1107,20110517,3000,2998,2981,2981,2942,2963,2957,-35,-41,110,3252880,1580
231,m1107,20110518,2963,2957,2961,2979,2961,2971,2970,14,13,30,891060,1580
232,m1107,20110519,2971,2970,2997,2997,2975,2980,2986,10,16,86,2568480,1582
233,m1107,20110520,2980,2986,2980,3004,2980,3004,2994,18,8,94,2814820,1582
234,m1107,20110523,3004,2994,3007,3014,2991,2996,3004,2,10,90,2703640,1580
235,m1107,20110524,2996,3004,2988,3001,2988,3001,2997,-3,-7,32,959200,1580
236,m1107,20110525,3001,2997,3007,3007,2983,2985,2989,-12,-8,30,896740,1582
237,m1107,20110526,2985,2989,2997,3002,2995,2997,2999,8,10,214,6418140,1588
238,m1107,20110527,2997,2999,2997,2998,2988,2996,2992,-3,-7,82,2453800,1588
239,m1107,20110530,2996,2992,3009,3009,2969,2998,2993,6,1,100,2993900,1590
240,m1107,20110531,2998,2993,2990,2991,2973,2973,2982,-20,-11,72,2147560,1586
241,m1107,20110601,2973,2982,2982,2985,2958,2970,2967,-12,-15,144,4273580,1560
242,m1107,20110602,2970,2967,2971,2976,2958,2976,2967,9,0,162,4806780,1564
243,m1107,20110603,2976,2967,2975,2990,2975,2990,2984,23,17,220,6565460,1398
244,m1107,20110607,2990,2984,2970,2970,2968,2970,2969,-14,-15,94,2791000,1326
245,m1107,20110608,2970,2969,2958,2972,2938,2970,2965,1,-4,308,9132760,1082
246,m1107,20110609,2970,2965,2967,2981,2966,2980,2978,15,13,146,4348880,1096
247,m1107,20110610,2980,2978,2975,2982,2975,2982,2979,4,1,106,3157820,1076
248,m1107,20110613,2982,2979,2959,2983,2959,2983,2976,4,-3,32,952480,1070
249,m1107,20110614,2983,2976,2981,2981,2979,2979,2979,3,3,12,357580,1066
250,m1107,20110615,2979,2979,2971,2973,2954,2967,2965,-12,-14,24,711600,1064
251,m1107,20110616,2967,2965,2950,2974,2950,2970,2969,5,4,170,5047600,934
252,m1107,20110617,2970,2969,2962,2971,2962,2962,2965,-7,-4,72,2135000,922
253,m1107,20110620,2962,2965,2963,3000,2963,3000,2983,35,18,60,1790300,930
254,m1107,20110621,3000,2983,2992,3006,2992,3002,2999,19,16,62,1859600,926
255,m1107,20110622,3002,2999,3005,3055,3004,3055,3039,56,40,184,5592460,938
256,m1107,20110623,3055,3039,3020,3052,3019,3050,3048,11,9,174,5303740,934
257,m1107,20110624,3050,3048,3050,3053,3037,3049,3049,1,1,524,15976820,964
258,m1107,20110627,3049,3049,3174,3174,3047,3051,3050,2,1,150,4576240,962
259,m1107,20110628,3051,3050,3046,3050,3046,3049,3048,-1,-2,20,609720,964
260,m1107,20110629,3049,3048,3047,3050,2950,2950,3047,-98,-1,142,4327940,1044
261,m1107,20110630,2950,3047,3005,3054,3005,3050,3042,3,-5,42,1277660,1044
262,m1107,20110701,3050,3042,3050,3052,3050,3050,3050,8,8,18,549040,712
263,m1107,20110704,3050,3050,0,0,0,3050,3050,0,0,0,0,706
264,m1107,20110705,3050,3050,0,0,0,3050,3050,0,0,0,0,706
265,m1107,20110706,3050,3050,0,0,0,3050,3050,0,0,0,0,706
266,m1107,20110707,3050,3050,0,0,0,3050,3050,0,0,0,0,706
267,m1107,20110708,3050,3050,0,0,0,3050,3050,0,0,0,0,206
268,m1107,20110711,3050,3050,0,0,0,3050,3050,0,0,0,0,10
269,m1107,20110712,3050,3050,0,0,0,3050,3050,0,0,0,0,10
270,m1107,20110713,3050,3050,0,0,0,3050,3050,0,0,0,0,10
271,m1107,20110714,3050,3050,0,0,0,3050,3050,0,0,0,0,0
272,m1108,20110104,3456,3447,0,0,0,3447,3447,0,0,0,0,296
273,m1108,20110105,3447,3447,3380,3413,3380,3406,3398,-41,-49,12,407840,296
274,m1108,20110106,3406,3398,3406,3441,3406,3438,3430,40,32,16,548880,298
275,m1108,20110107,3438,3430,3418,3418,3345,3394,3398,-36,-32,36,1223480,296
276,m1108,20110110,3394,3398,3391,3419,3391,3398,3403,0,5,26,884820,294
277,m1108,20110111,3398,3403,3440,3440,3405,3418,3414,15,11,38,1297520,290
278,m1108,20110112,3418,3414,3372,3418,3372,3402,3408,-12,-6,358,12200740,298
279,m1108,20110113,3402,3408,3450,3496,3450,3457,3463,49,55,66,2285820,296
280,m1108,20110114,3457,3463,3422,3474,3422,3471,3455,8,-8,42,1451140,296
281,m1108,20110117,3471,3455,3511,3633,3483,3502,3512,47,57,80,2810060,300
282,m1108,20110118,3502,3512,3487,3526,3485,3508,3503,-4,-9,134,4695080,264
283,m1108,20110119,3508,3503,3487,3526,3487,3504,3506,1,3,100,3506800,242
284,m1108,20110120,3504,3506,3491,3513,3480,3485,3490,-21,-16,54,1884780,236
285,m1108,20110121,3485,3490,3463,3511,3463,3488,3495,-2,5,38,1328140,232
286,m1108,20110124,3488,3495,3468,3530,3468,3513,3506,18,11,44,1542800,236
287,m1108,20110125,3513,3506,3483,3509,3483,3483,3492,-23,-14,68,2374560,230
288,m1108,20110126,3483,3492,3421,3445,3408,3416,3419,-76,-73,108,3693480,224
289,m1108,20110127,3416,3419,3420,3438,3420,3437,3429,18,10,20,685820,228
290,m1108,20110128,3437,3429,3429,3453,3429,3452,3445,23,16,14,482340,226
291,m1108,20110131,3452,3445,3494,3494,3464,3485,3483,40,38,22,766360,226
292,m1108,20110201,3485,3483,3476,3508,3468,3508,3476,25,-7,18,625760,234
293,m1108,20110209,3508,3476,3476,3554,3476,3517,3525,41,49,36,1269340,236
294,m1108,20110210,3517,3525,3520,3570,3520,3533,3539,8,14,50,1769600,236
295,m1108,20110211,3533,3539,3518,3548,3509,3542,3527,3,-12,94,3316120,220
296,m1108,20110214,3542,3527,3515,3539,3515,3539,3532,12,5,24,847880,220
297,m1108,20110215,3539,3532,3511,3523,3493,3502,3512,-30,-20,46,1615740,222
298,m1108,20110216,3502,3512,3458,3458,3450,3457,3456,-55,-56,50,1728380,222
299,m1108,20110217,3457,3456,3477,3477,3464,3464,3470,8,14,4,138820,222
300,m1108,20110218,3464,3470,3475,3485,3464,3464,3476,-6,6,14,486680,218
301,m1108,20110221,3464,3476,3421,3444,3421,3438,3434,-38,-42,6,206060,216
302,m1108,20110222,3438,3434,3460,3460,3441,3454,3450,20,16,10,345000,214
303,m1108,20110223,3454,3450,3378,3378,3378,3378,3378,-72,-72,2,67560,214
304,m1108,20110224,3378,3378,3351,3382,3285,3321,3344,-57,-34,104,3478600,210
305,m1108,20110225,3321,3344,3354,3365,3352,3365,3358,21,14,26,873180,206
306,m1108,20110228,3365,3358,3363,3420,3363,3418,3412,60,54,34,1160360,198
307,m1108,20110301,3418,3412,3390,3403,3390,3403,3396,-9,-16,4,135860,198
308,m1108,20110302,3403,3396,3410,3420,3410,3420,3416,24,20,6,205000,196
309,m1108,20110303,3420,3416,0,0,0,3416,3416,0,0,0,0,196
310,m1108,20110304,3416,3416,3450,3453,3438,3453,3446,37,30,14,482540,202
311,m1108,20110307,3453,3446,0,0,0,3446,3446,0,0,0,0,202
312,m1108,20110308,3446,3446,3381,3381,3352,3370,3372,-76,-74,14,472180,206
313,m1108,20110309,3370,3372,3365,3365,3365,3365,3365,-7,-7,2,67300,206
314,m1108,20110310,3365,3365,3362,3362,3328,3328,3345,-37,-20,4,133800,204
315,m1108,20110311,3328,3345,3328,3328,3325,3325,3326,-20,-19,18,598700,214
316,m1108,20110314,3325,3326,3304,3304,3299,3304,3301,-22,-25,14,462260,216
317,m1108,20110315,3304,3301,3290,3318,3286,3318,3303,17,2,14,462420,214
318,m1108,20110316,3318,3303,3258,3258,3247,3247,3252,-56,-51,8,260220,208
319,m1108,20110317,3247,3252,3240,3241,3240,3241,3240,-11,-12,4,129620,206
320,m1108,20110318,3241,3240,3386,3386,3268,3289,3293,49,53,22,724600,202
321,m1108,20110321,3289,3293,3368,3368,3309,3330,3336,37,43,10,333680,202
322,m1108,20110322,3330,3336,0,0,0,3336,3336,0,0,0,0,202
323,m1108,20110323,3336,3336,3296,3340,3296,3340,3333,4,-3,44,1466600,168
324,m1108,20110324,3340,3333,3323,3323,3323,3323,3323,-10,-10,2,66460,168
325,m1108,20110325,3323,3323,3358,3358,3358,3358,3358,35,35,2,67160,168
326,m1108,20110328,3358,3358,3340,3348,3286,3296,3314,-62,-44,32,1060660,168
327,m1108,20110329,3296,3314,3305,3314,3295,3300,3300,-14,-14,48,1584280,130
328,m1108,20110330,3300,3300,3305,3345,3296,3325,3315,25,15,16,530520,132
329,m1108,20110331,3325,3315,0,0,0,3315,3315,0,0,0,0,132
330,m1108,20110401,3315,3315,3342,3342,3318,3323,3324,8,9,10,332460,132
331,m1108,20110406,3323,3324,0,0,0,3324,3324,0,0,0,0,132
332,m1108,20110407,3324,3324,3330,3330,3330,3330,3330,6,6,2,66600,134
333,m1108,20110408,3330,3330,3295,3295,3292,3292,3293,-38,-37,4,131740,134
334,m1108,20110411,3292,3293,3388,3388,3345,3345,3366,52,73,4,134660,132
335,m1108,20110412,3345,3366,3282,3282,3282,3282,3282,-84,-84,2,65640,134
336,m1108,20110413,3282,3282,3269,3269,3269,3269,3269,-13,-13,2,65380,136
337,m1108,20110414,3269,3269,3241,3273,3235,3235,3247,-34,-22,18,584500,148
338,m1108,20110415,3235,3247,3225,3225,3223,3223,3224,-24,-23,4,128960,148
339,m1108,20110418,3223,3224,3244,3245,3217,3229,3229,5,5,22,710540,144
340,m1108,20110419,3229,3229,3210,3214,3194,3197,3208,-32,-21,36,1155100,132
341,m1108,20110420,3197,3208,3210,3210,3198,3198,3205,-10,-3,6,192320,132
342,m1108,20110421,3198,3205,3200,3201,3195,3195,3198,-10,-7,12,383780,130
343,m1108,20110422,3195,3198,3228,3229,3206,3228,3219,30,21,14,450740,130
344,m1108,20110425,3228,3219,3222,3222,3203,3222,3216,3,-3,10,321680,128
345,m1108,20110426,3222,3216,3211,3217,3191,3211,3208,-5,-8,20,641660,134
346,m1108,20110427,3211,3208,3212,3212,3212,3212,3212,4,4,2,64240,132
347,m1108,20110428,3212,3212,3223,3223,3223,3223,3223,11,11,4,128920,128
348,m1108,20110429,3223,3223,3166,3166,3142,3142,3158,-81,-65,16,505360,138
349,m1108,20110503,3142,3158,3177,3178,3177,3178,3177,20,19,4,127100,138
350,m1108,20110504,3178,3177,0,0,0,3177,3177,0,0,0,0,138
351,m1108,20110505,3177,3177,0,0,0,3177,3177,0,0,0,0,138
352,m1108,20110506,3177,3177,0,0,0,3177,3177,0,0,0,0,138
353,m1108,20110509,3177,3177,3132,3132,3132,3132,3132,-45,-45,2,62640,136
354,m1108,20110510,3132,3132,0,0,0,3132,3132,0,0,0,0,136
355,m1108,20110511,3132,3132,3137,3137,3123,3123,3130,-9,-2,4,125200,136
356,m1108,20110512,3123,3130,3123,3123,3100,3100,3111,-30,-19,4,124460,138
357,m1108,20110513,3100,3111,3129,3129,3129,3129,3129,18,18,2,62580,140
358,m1108,20110516,3129,3129,3146,3146,3133,3133,3137,4,8,54,1694420,164
359,m1108,20110517,3133,3137,3133,3148,3083,3144,3130,7,-7,18,563540,168
360,m1108,20110518,3144,3130,3122,3129,3121,3121,3122,-9,-8,18,562060,162
361,m1108,20110519,3121,3122,3144,3157,3144,3157,3150,35,28,6,189040,160
362,m1108,20110520,3157,3150,3167,3187,3167,3187,3170,37,20,126,3994780,278
363,m1108,20110523,3187,3170,3217,3217,3191,3191,3204,21,34,4,128160,278
364,m1108,20110524,3191,3204,0,0,0,3204,3204,0,0,0,0,278
365,m1108,20110525,3204,3204,3188,3199,3188,3199,3192,-5,-12,6,191540,278
366,m1108,20110526,3199,3192,0,0,0,3192,3192,0,0,0,0,278
367,m1108,20110527,3192,3192,3238,3238,3206,3206,3222,14,30,4,128880,278
368,m1108,20110530,3206,3222,3199,3222,3198,3201,3204,-21,-18,36,1153620,284
369,m1108,20110531,3201,3204,3207,3208,3185,3193,3195,-11,-9,10,319580,280
370,m1108,20110601,3193,3195,0,0,0,3195,3195,0,0,0,0,280
371,m1108,20110602,3195,3195,3198,3198,3190,3190,3192,-5,-3,8,255380,280
372,m1108,20110603,3190,3192,3240,3240,3207,3209,3212,17,20,92,2955660,338
373,m1108,20110607,3209,3212,3185,3239,3185,3206,3208,-6,-4,136,4363100,294
374,m1108,20110608,3206,3208,3208,3210,3208,3210,3208,2,0,86,2758920,208
375,m1108,20110609,3210,3208,3240,3240,3229,3229,3234,21,26,4,129380,208
376,m1108,20110610,3229,3234,3212,3225,3206,3210,3212,-24,-22,16,514000,208
377,m1108,20110613,3210,3212,3232,3232,3232,3232,3232,20,20,2,64640,206
378,m1108,20110614,3232,3232,3238,3238,3211,3218,3222,-14,-10,10,322220,208
379,m1108,20110615,3218,3222,3228,3228,3228,3228,3228,6,6,2,64560,208
380,m1108,20110616,3228,3228,3207,3207,3202,3202,3204,-26,-24,8,256360,208
381,m1108,20110617,3202,3204,3191,3193,3188,3188,3190,-16,-14,10,319040,206
382,m1108,20110620,3188,3190,3172,3188,3170,3188,3178,-2,-12,8,254280,206
383,m1108,20110621,3188,3178,3189,3192,3168,3168,3185,-10,7,20,637160,206
384,m1108,20110622,3168,3185,3215,3215,3165,3185,3181,0,-4,28,890760,210
385,m1108,20110623,3185,3181,3177,3186,3174,3182,3179,1,-2,16,508720,214
386,m1108,20110624,3182,3179,3193,3196,3193,3195,3195,16,16,28,894620,232
387,m1108,20110627,3195,3195,3182,3196,3170,3182,3181,-13,-14,24,763520,234
388,m1108,20110628,3182,3181,3186,3186,3186,3186,3186,5,5,6,191160,236
389,m1108,20110629,3186,3186,3190,3223,3190,3212,3200,26,14,26,832220,240
390,m1108,20110630,3212,3200,0,0,0,3200,3200,0,0,0,0,240
391,m1108,20110701,3200,3200,3192,3192,3171,3171,3185,-29,-15,14,445980,242
392,m1108,20110704,3171,3185,3190,3190,3190,3190,3190,5,5,2,63800,240
393,m1108,20110705,3190,3190,3169,3169,3169,3169,3169,-21,-21,2,63380,240
394,m1108,20110706,3169,3169,3195,3195,3195,3195,3195,26,26,6,191700,236
395,m1108,20110707,3195,3195,3201,3201,3201,3201,3201,6,6,2,64020,236
396,m1108,20110708,3201,3201,3225,3225,3202,3217,3211,16,10,32,1027620,244
397,m1108,20110711,3217,3211,3211,3215,3211,3215,3211,4,0,60,1927000,194
398,m1108,20110712,3215,3211,3233,3233,3230,3230,3231,19,20,4,129260,194
399,m1108,20110713,3230,3231,3264,3288,3248,3266,3259,35,28,54,1759920,216
400,m1108,20110714,3266,3259,3298,3298,3267,3267,3282,8,23,10,328200,218
401,m1108,20110715,3267,3282,3284,3310,3284,3310,3293,28,11,14,461100,220
402,m1108,20110718,3310,3293,0,0,0,3293,3293,0,0,0,0,220
403,m1108,20110719,3293,3293,0,0,0,3293,3293,0,0,0,0,220
404,m1108,20110720,3293,3293,3290,3343,3290,3331,3320,38,27,16,531340,218
405,m1108,20110721,3331,3320,3374,3374,3358,3358,3366,38,46,4,134640,216
406,m1108,20110722,3358,3366,0,0,0,3366,3366,0,0,0,0,216
407,m1108,20110725,3366,3366,3341,3396,3341,3367,3376,1,10,14,472660,216
408,m1108,20110726,3367,3376,3468,3468,3451,3468,3462,92,86,12,415520,214
409,m1108,20110727,3468,3462,3518,3528,3361,3363,3421,-99,-41,144,4927180,206
410,m1108,20110728,3363,3421,3313,3387,3309,3350,3347,-71,-74,56,1874780,186
411,m1108,20110729,3350,3347,3472,3472,3322,3360,3368,13,21,58,1953500,170
412,m1108,20110801,3360,3368,0,0,0,3368,3368,0,0,0,0,170
413,m1108,20110802,3368,3368,0,0,0,3368,3368,0,0,0,0,50
414,m1108,20110803,3368,3368,0,0,0,3368,3368,0,0,0,0,50
415,m1108,20110804,3368,3368,0,0,0,3368,3368,0,0,0,0,50
416,m1108,20110805,3368,3368,0,0,0,3368,3368,0,0,0,0,50
417,m1108,20110808,3368,3368,3368,3368,3166,3166,3267,-202,-101,8,261360,50
418,m1108,20110809,3166,3267,0,0,0,3267,3267,0,0,0,0,50
419,m1108,20110810,3267,3267,0,0,0,3267,3267,0,0,0,0,50
420,m1108,20110811,3267,3267,0,0,0,3267,3267,0,0,0,0,50
421,m1108,20110812,3267,3267,0,0,0,3267,3267,0,0,0,0,0
422,m1109,20110104,3440,3439,3439,3448,3423,3432,3434,-7,-5,454046,15591968200,875650
423,m1109,20110105,3432,3434,3406,3411,3375,3386,3391,-48,-43,377990,12821140120,862902
424,m1109,20110106,3386,3391,3411,3430,3411,3424,3422,33,31,374444,12814092800,852438
425,m1109,20110107,3424,3422,3395,3396,3360,3361,3381,-61,-41,456964,15452881560,816626
426,m1109,20110110,3361,3381,3375,3415,3370,3390,3394,9,13,459470,15596082380,815652
427,m1109,20110111,3390,3394,3413,3418,3394,3405,3403,11,9,271212,9232036740,808406
428,m1109,20110112,3405,3403,3381,3421,3380,3403,3402,0,-1,712110,24229893640,848168
429,m1109,20110113,3403,3402,3500,3500,3455,3456,3470,54,68,550464,19102958740,806888
430,m1109,20110114,3456,3470,3451,3506,3451,3497,3485,27,15,599986,20912164280,845706
431,m1109,20110117,3497,3485,3500,3550,3496,3531,3529,46,44,754220,26621371860,870052
432,m1109,20110118,3531,3529,3515,3543,3503,3538,3523,9,-6,564928,19905372020,894632
433,m1109,20110119,3538,3523,3543,3545,3520,3526,3528,3,5,429066,15139094080,865804
434,m1109,20110120,3526,3528,3504,3518,3488,3491,3502,-37,-26,429840,15056816280,829690
435,m1109,20110121,3491,3502,3487,3510,3480,3487,3498,-15,-4,373672,13071752220,813034
436,m1109,20110124,3487,3498,3493,3540,3490,3523,3519,25,21,548730,19313507620,820118
437,m1109,20110125,3523,3519,3510,3527,3466,3472,3503,-47,-16,411740,14424169380,812354
438,m1109,20110126,3472,3503,3440,3455,3405,3419,3421,-84,-82,390080,13347037220,793712
439,m1109,20110127,3419,3421,3443,3466,3426,3455,3447,34,26,391972,13515193320,806344
440,m1109,20110128,3455,3447,3455,3475,3445,3452,3459,5,12,244932,8472366280,798042
441,m1109,20110131,3452,3459,3460,3488,3457,3484,3478,25,19,217212,7555560260,801260
442,m1109,20110201,3484,3478,3490,3519,3486,3516,3502,38,24,233436,8176792540,810464
443,m1109,20110209,3516,3502,3535,3568,3521,3560,3552,58,50,382886,13602478400,805462
444,m1109,20110210,3560,3552,3568,3604,3542,3545,3574,-7,22,496258,17736509420,779874
445,m1109,20110211,3545,3574,3542,3560,3525,3543,3547,-31,-27,354558,12579348920,742756
446,m1109,20110214,3543,3547,3542,3554,3530,3541,3541,-6,-6,215852,7643477500,748932
447,m1109,20110215,3541,3541,3520,3527,3480,3486,3504,-55,-37,282368,9895217080,751058
448,m1109,20110216,3486,3504,3441,3467,3433,3461,3449,-43,-55,253934,8759174720,736666
449,m1109,20110217,3461,3449,3465,3476,3433,3436,3458,-13,9,182598,6314612060,716792
450,m1109,20110218,3436,3458,3480,3482,3450,3452,3469,-6,11,183070,6350958960,680556
451,m1109,20110221,3452,3469,3432,3455,3426,3446,3442,-23,-27,142126,4893063720,657396
452,m1109,20110222,3446,3442,3480,3480,3420,3459,3452,17,10,185590,6407835280,637392
453,m1109,20110223,3459,3452,3374,3374,3310,3343,3344,-109,-108,186206,6227621240,615686
454,m1109,20110224,3343,3344,3364,3366,3298,3310,3324,-34,-20,196788,6541580400,568078
455,m1109,20110225,3310,3324,3324,3362,3321,3360,3344,36,20,143722,4806935660,542032
456,m1109,20110228,3360,3344,3385,3423,3383,3406,3405,62,61,190138,6475784860,509906
457,m1109,20110301,3406,3405,3401,3412,3401,3405,3405,0,0,82926,2824299120,505760
458,m1109,20110302,3405,3405,3406,3444,3402,3434,3424,29,19,180908,6195260760,501924
459,m1109,20110303,3434,3424,3420,3442,3417,3422,3430,-2,6,94248,3232783400,492224
460,m1109,20110304,3422,3430,3449,3457,3421,3437,3441,7,11,131846,4536841140,472974
461,m1109,20110307,3437,3441,3424,3436,3423,3431,3430,-10,-11,71202,2442838540,462238
462,m1109,20110308,3431,3430,3400,3410,3363,3367,3385,-63,-45,107860,3651348280,456438
463,m1109,20110309,3367,3385,3373,3376,3360,3369,3367,-16,-18,57150,1924706560,448868
464,m1109,20110310,3369,3367,3330,3345,3326,3327,3335,-40,-32,70680,2357517120,436062
465,m1109,20110311,3327,3335,3335,3349,3316,3326,3333,-9,-2,64868,2162409400,427556
466,m1109,20110314,3326,3333,3315,3333,3288,3291,3308,-42,-25,97982,3241486840,423642
467,m1109,20110315,3291,3308,3303,3314,3276,3310,3297,2,-11,121440,4004665180,401118
468,m1109,20110316,3310,3297,3221,3247,3221,3235,3234,-62,-63,127668,4129424740,394178
469,m1109,20110317,3235,3234,3232,3253,3220,3241,3234,7,0,86096,2785131260,388886
470,m1109,20110318,3241,3234,3278,3285,3266,3273,3275,39,41,88434,2896319720,368574
471,m1109,20110321,3273,3275,3301,3319,3285,3294,3300,19,25,113194,3736250520,337748
472,m1109,20110322,3294,3300,3284,3294,3280,3286,3288,-14,-12,36724,1207573040,332958
473,m1109,20110323,3286,3288,3290,3344,3286,3338,3323,50,35,87228,2899020200,307424
474,m1109,20110324,3338,3323,3330,3335,3307,3316,3318,-7,-5,59184,1964108500,298912
475,m1109,20110325,3316,3318,3327,3350,3326,3339,3338,21,20,67436,2251305960,296664
476,m1109,20110328,3339,3338,3343,3346,3290,3316,3324,-22,-14,58286,1937640580,296070
477,m1109,20110329,3316,3324,3290,3332,3290,3321,3313,-3,-11,38862,1287599740,295914
478,m1109,20110330,3321,3313,3328,3338,3317,3324,3326,11,13,26106,868352480,292762
479,m1109,20110331,3324,3326,3330,3335,3318,3328,3325,2,-1,22268,740460240,288402
480,m1109,20110401,3328,3325,3347,3361,3345,3347,3352,22,27,55736,1868477920,266950
481,m1109,20110406,3347,3352,3313,3335,3306,3310,3315,-42,-37,97402,3228984020,308664
482,m1109,20110407,3310,3315,3309,3317,3305,3308,3309,-7,-6,30800,1019417900,310586
483,m1109,20110408,3308,3309,3300,3307,3284,3306,3294,-3,-15,70596,2325519360,325610
484,m1109,20110411,3306,3294,3332,3339,3323,3328,3329,34,35,53582,1784264360,317234
485,m1109,20110412,3328,3329,3300,3303,3263,3265,3283,-64,-46,61978,2034815880,341804
486,m1109,20110413,3265,3283,3236,3261,3226,3254,3241,-29,-42,113930,3693414940,366666
487,m1109,20110414,3254,3241,3245,3250,3220,3222,3237,-19,-4,51182,1657256800,368320
488,m1109,20110415,3222,3237,3232,3239,3210,3212,3223,-25,-14,67466,2175102820,369464
489,m1109,20110418,3212,3223,3200,3222,3196,3220,3214,-3,-9,39800,1279515160,371042
490,m1109,20110419,3220,3214,3227,3232,3215,3219,3224,5,10,56740,1829497900,356950
491,m1109,20110420,3219,3224,3230,3240,3228,3236,3233,12,9,39682,1283252940,361024
492,m1109,20110421,3236,3233,3238,3241,3230,3232,3235,-1,2,23934,774368620,358272
493,m1109,20110422,3232,3235,3244,3272,3244,3264,3259,29,24,61168,1993588800,357876
494,m1109,20110425,3264,3259,3275,3279,3256,3266,3268,7,9,42896,1401953460,358464
495,m1109,20110426,3266,3268,3250,3253,3237,3239,3247,-29,-21,35512,1153396820,352620
496,m1109,20110427,3239,3247,3248,3264,3243,3249,3256,2,9,38796,1263290100,347898
497,m1109,20110428,3249,3256,3251,3265,3251,3263,3257,7,1,28116,915998640,341802
498,m1109,20110429,3263,3257,3225,3230,3184,3190,3207,-67,-50,55480,1779402300,349292
499,m1109,20110503,3190,3207,3210,3228,3210,3224,3222,17,15,35568,1146066880,341882
500,m1109,20110504,3224,3222,3200,3210,3190,3193,3197,-29,-25,28796,920728520,347762
501,m1109,20110505,3193,3197,3082,3204,3082,3197,3182,0,-15,43352,1379778500,338548
502,m1109,20110506,3197,3182,3156,3168,3151,3153,3157,-29,-25,43844,1384481560,331058
503,m1109,20110509,3153,3157,3161,3168,3158,3165,3163,8,6,15010,474906640,328124
504,m1109,20110510,3165,3163,3168,3181,3166,3179,3173,16,10,14540,461457320,327010
505,m1109,20110511,3179,3173,3180,3183,3158,3159,3170,-14,-3,29436,933142280,323462
506,m1109,20110512,3159,3170,3161,3169,3141,3143,3157,-27,-13,21666,684072700,319596
507,m1109,20110513,3143,3157,3160,3185,3155,3177,3166,20,9,23662,749323240,314476
508,m1109,20110516,3177,3166,3169,3172,3160,3163,3166,-3,0,16578,524860680,316278
509,m1109,20110517,3163,3166,3156,3161,3124,3146,3138,-20,-28,40746,1279004320,310442
510,m1109,20110518,3146,3138,3156,3166,3156,3163,3162,25,24,20476,647499680,309762
511,m1109,20110519,3163,3162,3198,3205,3190,3199,3198,37,36,36788,1176799900,293058
512,m1109,20110520,3199,3198,3203,3229,3198,3228,3218,30,20,30016,966021200,287364
513,m1109,20110523,3228,3218,3236,3239,3215,3218,3227,0,9,19300,622844640,281158
514,m1109,20110524,3218,3227,3220,3229,3213,3227,3221,0,-6,16462,530371600,273912
515,m1109,20110525,3227,3221,3223,3226,3206,3211,3212,-10,-9,16654,534984320,269772
516,m1109,20110526,3211,3212,3218,3224,3215,3223,3220,11,8,14488,466525320,268686
517,m1109,20110527,3223,3220,3230,3230,3218,3222,3221,2,1,14882,479424480,261498
518,m1109,20110530,3222,3221,3228,3228,3215,3222,3220,1,-1,17900,576390840,257748
519,m1109,20110531,3222,3220,3220,3223,3206,3212,3211,-8,-9,21606,693928720,253950
520,m1109,20110601,3212,3211,3221,3221,3209,3210,3212,-1,1,13782,442810800,250956
521,m1109,20110602,3210,3212,3217,3233,3212,3227,3225,15,13,20500,661206700,247096
522,m1109,20110603,3227,3225,3239,3247,3235,3240,3242,15,17,49120,1592565340,224402
523,m1109,20110607,3240,3242,3210,3216,3199,3208,3207,-34,-35,39542,1268378320,207982
524,m1109,20110608,3208,3207,3220,3226,3207,3216,3216,9,9,19202,617545200,198968
525,m1109,20110609,3216,3216,3228,3237,3226,3226,3232,10,16,21018,679470780,191170
526,m1109,20110610,3226,3232,3230,3231,3212,3226,3224,-6,-8,14714,474437160,187114
527,m1109,20110613,3226,3224,3234,3242,3223,3232,3231,8,7,13720,443334740,180172
528,m1109,20110614,3232,3231,3231,3242,3229,3241,3235,10,4,13870,448697060,175696
529,m1109,20110615,3241,3235,3233,3240,3228,3232,3232,-3,-3,18360,593540500,175222
530,m1109,20110616,3232,3232,3233,3243,3220,3226,3234,-6,2,18662,603660620,168508
531,m1109,20110617,3226,3234,3230,3230,3205,3212,3210,-22,-24,14962,480400120,165342
532,m1109,20110620,3212,3210,3202,3208,3194,3198,3200,-12,-10,7914,253255400,162524
533,m1109,20110621,3198,3200,3201,3215,3201,3212,3208,12,8,9504,304934220,157136
534,m1109,20110622,3212,3208,3230,3230,3214,3219,3218,11,10,6970,224347320,154302
535,m1109,20110623,3219,3218,3210,3218,3201,3217,3208,-1,-10,9214,295667340,150364
536,m1109,20110624,3217,3208,3208,3234,3205,3216,3223,8,15,14690,473531960,146388
537,m1109,20110627,3216,3223,3209,3211,3182,3198,3198,-25,-25,13780,440791320,139082
538,m1109,20110628,3198,3198,3206,3222,3203,3219,3217,21,19,11596,373124000,132644
539,m1109,20110629,3219,3217,3210,3232,3210,3229,3228,12,11,6774,218727500,130078
540,m1109,20110630,3229,3228,3227,3238,3227,3236,3233,8,5,6172,199560560,127876
541,m1109,20110701,3236,3233,3218,3228,3205,3227,3221,-6,-12,6072,195610460,126246
542,m1109,20110704,3227,3221,3235,3240,3223,3235,3234,14,13,5048,163280680,124596
543,m1109,20110705,3235,3234,3235,3239,3227,3232,3232,-2,-2,4150,134149480,122688
544,m1109,20110706,3232,3232,3232,3236,3220,3233,3230,1,-2,8064,260529220,118230
545,m1109,20110707,3233,3230,3233,3239,3229,3239,3233,9,3,9254,299231980,111596
546,m1109,20110708,3239,3233,3250,3260,3250,3258,3257,25,24,13504,439946000,102148
547,m1109,20110711,3258,3257,3265,3282,3265,3281,3269,24,12,13500,441416280,93580
548,m1109,20110712,3281,3269,3278,3281,3266,3272,3272,3,3,10198,333722740,88132
549,m1109,20110713,3272,3272,3285,3320,3285,3319,3302,47,30,21866,722019580,81014
550,m1109,20110714,3319,3302,3325,3342,3320,3330,3332,28,30,5306,176807420,78786
551,m1109,20110715,3330,3332,3332,3335,3314,3327,3327,-5,-5,5226,173883760,75422
552,m1109,20110718,3327,3327,3332,3350,3324,3331,3340,4,13,11166,372988800,67576
553,m1109,20110719,3331,3340,3330,3342,3330,3341,3338,1,-2,8500,283738320,61028
554,m1109,20110720,3341,3338,3348,3348,3325,3340,3333,2,-5,7114,237135780,57158
555,m1109,20110721,3340,3333,3330,3346,3325,3343,3338,10,5,3710,123856620,55478
556,m1109,20110722,3343,3338,3345,3352,3343,3349,3347,11,9,1746,58448420,54560
557,m1109,20110725,3349,3347,3341,3344,3309,3311,3327,-36,-20,4176,138955400,52326
558,m1109,20110726,3311,3327,3318,3336,3311,3333,3323,6,-4,4948,164456660,50608
559,m1109,20110727,3333,3323,3340,3365,3340,3360,3358,37,35,6910,232039460,47484
560,m1109,20110728,3360,3358,3348,3354,3340,3350,3346,-8,-12,4124,138029300,44550
561,m1109,20110729,3350,3346,3345,3349,3323,3323,3337,-23,-9,4522,150926560,41616
562,m1109,20110801,3323,3337,3322,3337,3322,3336,3332,-1,-5,4896,163174040,38124
563,m1109,20110802,3336,3332,3337,3342,3320,3336,3327,4,-5,9650,321065140,30384
564,m1109,20110803,3336,3327,3350,3353,3327,3332,3339,5,12,3274,109340080,28580
565,m1109,20110804,3332,3339,3323,3333,3310,3312,3316,-27,-23,3624,120194440,25974
566,m1109,20110805,3312,3316,3299,3299,3226,3270,3273,-46,-43,7338,240224720,21880
567,m1109,20110808,3270,3273,3225,3252,3220,3231,3231,-42,-42,7438,240393200,15440
568,m1109,20110809,3231,3231,3202,3202,3167,3200,3192,-31,-39,5172,165093620,11100
569,m1109,20110810,3200,3192,3240,3240,3217,3228,3228,36,36,1416,45716620,9878
570,m1109,20110811,3228,3228,3220,3234,3208,3234,3217,6,-11,1076,34622280,8986
571,m1109,20110812,3234,3217,3258,3258,3230,3237,3237,20,20,568,18390720,8684
572,m1109,20110815,3237,3237,3250,3255,3236,3238,3243,1,6,1568,50860860,7822
573,m1109,20110816,3238,3243,3238,3238,3205,3226,3228,-17,-15,1100,35510280,7098
574,m1109,20110817,3226,3228,3221,3237,3221,3237,3232,9,4,578,18682440,6580
575,m1109,20110818,3237,3232,3259,3259,3225,3233,3229,1,-3,662,21382060,5982
576,m1109,20110819,3233,3229,3190,3220,3185,3213,3212,-16,-17,994,31934860,5172
577,m1109,20110822,3213,3212,3215,3215,3188,3201,3200,-11,-12,2046,65475200,3372
578,m1109,20110823,3201,3200,3202,3224,3201,3224,3211,24,11,744,23894780,2918
579,m1109,20110824,3224,3211,3212,3216,3203,3212,3211,1,0,534,17150720,2464
580,m1109,20110825,3212,3211,3202,3203,3198,3198,3199,-13,-12,246,7871400,2242
581,m1109,20110826,3198,3199,3191,3213,3163,3205,3194,6,-5,514,16420260,1882
582,m1109,20110829,3205,3194,3220,3235,3216,3232,3225,38,31,910,29352040,1490
583,m1109,20110830,3232,3225,3206,3220,3205,3209,3211,-16,-14,662,21257540,984
584,m1109,20110831,3209,3211,3182,3218,3182,3205,3206,-6,-5,838,26869980,548
585,m1109,20110901,3205,3206,3206,3206,3200,3200,3202,-6,-4,16,512360,394
586,m1109,20110902,3200,3202,3280,3300,3215,3215,3255,13,53,20,651100,384
587,m1109,20110905,3215,3255,0,0,0,3255,3255,0,0,0,0,384
588,m1109,20110906,3255,3255,0,0,0,3255,3255,0,0,0,0,384
589,m1109,20110907,3255,3255,3200,3200,3200,3200,3200,-55,-55,100,3200000,470
590,m1109,20110908,3200,3200,0,0,0,3200,3200,0,0,0,0,470
591,m1109,20110909,3200,3200,0,0,0,3200,3200,0,0,0,0,470
592,m1109,20110913,3200,3200,0,0,0,3200,3200,0,0,0,0,470
593,m1109,20110914,3200,3200,0,0,0,3200,3200,0,0,0,0,470
594,m1109,20110915,3200,3200,0,0,0,3200,3208,0,8,0,0,0
595,m1111,20110104,3392,3392,3400,3405,3384,3392,3393,0,1,126,4275460,2224
596,m1111,20110105,3392,3393,3365,3365,3340,3348,3352,-45,-41,272,9118320,2308
597,m1111,20110106,3348,3352,3358,3387,3358,3383,3375,31,23,162,5468980,2318
598,m1111,20110107,3383,3375,3355,3359,3330,3330,3348,-45,-27,632,21164540,2656
599,m1111,20110110,3330,3348,3338,3370,3330,3353,3359,5,11,1796,60330760,3068
600,m1111,20110111,3353,3359,3386,3386,3357,3366,3363,7,4,182,6122080,3170
601,m1111,20110112,3366,3363,3368,3368,3337,3344,3350,-19,-13,1076,36049080,3566
602,m1111,20110113,3344,3350,3390,3415,3374,3385,3391,35,41,1292,43820000,3592
603,m1111,20110114,3385,3391,3381,3419,3381,3406,3402,15,11,500,17014060,3604
604,m1111,20110117,3406,3402,3466,3528,3402,3439,3461,37,59,2318,80230340,3686
605,m1111,20110118,3439,3461,3435,3449,3413,3439,3422,-22,-39,1570,53727340,3654
606,m1111,20110119,3439,3422,3440,3460,3425,3425,3431,3,9,308,10568380,3650
607,m1111,20110120,3425,3431,3410,3427,3391,3392,3407,-39,-24,252,8585760,3648
608,m1111,20110121,3392,3407,3398,3405,3320,3383,3394,-24,-13,296,10046720,3652
609,m1111,20110124,3383,3394,3398,3415,3394,3410,3404,16,10,198,6740720,3658
610,m1111,20110125,3410,3404,3378,3395,3360,3360,3374,-44,-30,218,7355360,3644
611,m1111,20110126,3360,3374,3300,3334,3300,3324,3321,-50,-53,494,16407680,3642
612,m1111,20110127,3324,3321,3340,3352,3330,3339,3340,18,19,208,6947220,3640
613,m1111,20110128,3339,3340,3344,3351,3338,3340,3345,0,5,102,3412640,3642
614,m1111,20110131,3340,3345,3348,3366,3344,3366,3357,21,12,260,8729540,3642
615,m1111,20110201,3366,3357,3367,3375,3364,3371,3368,14,11,1060,35701760,3300
616,m1111,20110209,3371,3368,3385,3425,3382,3425,3408,57,40,694,23656380,3038
617,m1111,20110210,3425,3408,3434,3479,3416,3441,3454,33,46,1194,41251460,2500
618,m1111,20110211,3441,3454,3439,3470,3427,3465,3453,11,-1,526,18167940,2362
619,m1111,20110214,3465,3453,3474,3474,3445,3464,3461,11,8,382,13223460,2326
620,m1111,20110215,3464,3461,3446,3456,3431,3438,3446,-23,-15,304,10478200,2388
621,m1111,20110216,3438,3446,3402,3418,3400,3418,3407,-28,-39,266,9065160,2366
622,m1111,20110217,3418,3407,3414,3428,3401,3402,3413,-5,6,172,5871120,2388
623,m1111,20110218,3402,3413,3435,3436,3410,3420,3423,7,10,162,5546680,2382
624,m1111,20110221,3420,3423,3423,3423,3388,3413,3410,-10,-13,202,6889380,2398
625,m1111,20110222,3413,3410,3429,3430,3370,3415,3410,5,0,320,10912060,2380
626,m1111,20110223,3415,3410,3330,3369,3300,3316,3323,-94,-87,348,11564280,2404
627,m1111,20110224,3316,3323,3322,3338,3290,3304,3309,-19,-14,106,3508020,2416
628,m1111,20110225,3304,3309,3320,3329,3312,3329,3319,20,10,86,2854460,2402
629,m1111,20110228,3329,3319,3348,3363,3346,3359,3353,40,34,234,7846220,2326
630,m1111,20110301,3359,3353,3343,3353,3343,3350,3349,-3,-4,64,2143940,2322
631,m1111,20110302,3350,3349,3350,3385,3350,3377,3368,28,19,198,6669400,2268
632,m1111,20110303,3377,3368,3396,3396,3362,3370,3382,2,14,170,5750460,2196
633,m1111,20110304,3370,3382,3407,3409,3385,3386,3396,4,14,234,7948440,2092
634,m1111,20110307,3386,3396,3411,3411,3382,3390,3391,-6,-5,28,949500,2082
635,m1111,20110308,3390,3391,3372,3380,3340,3348,3361,-43,-30,90,3024900,2072
636,m1111,20110309,3348,3361,3341,3344,3341,3343,3341,-18,-20,16,534700,2060
637,m1111,20110310,3343,3341,3307,3314,3307,3314,3309,-27,-32,98,3242960,2046
638,m1111,20110311,3314,3309,3329,3329,3304,3304,3310,-5,1,54,1787860,2024
639,m1111,20110314,3304,3310,3300,3320,3274,3282,3294,-28,-16,176,5798700,2016
640,m1111,20110315,3282,3294,3318,3318,3270,3295,3288,1,-6,112,3682740,2016
641,m1111,20110316,3295,3288,3227,3248,3227,3241,3240,-47,-48,128,4147940,2026
642,m1111,20110317,3241,3240,3250,3264,3240,3254,3241,14,1,374,12125060,2028
643,m1111,20110318,3254,3241,3270,3278,3268,3268,3271,27,30,78,2552140,2022
644,m1111,20110321,3268,3271,3290,3304,3290,3298,3294,27,23,70,2306100,2022
645,m1111,20110322,3298,3294,3286,3289,3286,3287,3287,-7,-7,14,460280,2030
646,m1111,20110323,3287,3287,3302,3325,3302,3325,3316,38,29,108,3582200,2022
647,m1111,20110324,3325,3316,3317,3327,3304,3313,3315,-3,-1,74,2453520,2020
648,m1111,20110325,3313,3315,3322,3340,3322,3338,3332,23,17,176,5865080,2022
649,m1111,20110328,3338,3332,3344,3344,3304,3313,3324,-19,-8,108,3590480,2022
650,m1111,20110329,3313,3324,3304,3335,3303,3330,3326,6,2,124,4124640,2012
651,m1111,20110330,3330,3326,3326,3335,3322,3326,3328,0,2,32,1065000,2004
652,m1111,20110331,3326,3328,3338,3338,3326,3331,3330,3,2,82,2731040,1994
653,m1111,20110401,3331,3330,3350,3358,3338,3347,3351,17,21,130,4357540,1990
654,m1111,20110406,3347,3351,3286,3334,3286,3324,3320,-27,-31,164,5445040,2004
655,m1111,20110407,3324,3320,3332,3333,3319,3327,3328,7,8,80,2662680,2006
656,m1111,20110408,3327,3328,3316,3319,3306,3319,3312,-9,-16,74,2451080,2004
657,m1111,20110411,3319,3312,3344,3388,3338,3343,3349,31,37,156,5224800,1962
658,m1111,20110412,3343,3349,3309,3311,3300,3302,3306,-47,-43,68,2248100,1986
659,m1111,20110413,3302,3306,3268,3290,3265,3289,3273,-17,-33,36,1178300,1976
660,m1111,20110414,3289,3273,3281,3281,3259,3259,3268,-14,-5,42,1372880,1964
661,m1111,20110415,3259,3268,3255,3260,3241,3260,3254,-8,-14,8,260320,1962
662,m1111,20110418,3260,3254,3250,3258,3241,3249,3251,-5,-3,40,1300560,1950
663,m1111,20110419,3249,3251,3273,3273,3250,3251,3257,0,6,70,2280480,1926
664,m1111,20110420,3251,3257,3265,3277,3255,3277,3271,20,14,32,1046900,1920
665,m1111,20110421,3277,3271,3270,3275,3270,3271,3273,0,2,20,654680,1912
666,m1111,20110422,3271,3273,3311,3364,3290,3305,3312,32,39,92,3047160,1898
667,m1111,20110425,3305,3312,3308,3310,3305,3306,3306,-6,-6,46,1521000,1878
668,m1111,20110426,3306,3306,3295,3295,3260,3276,3276,-30,-30,32,1048540,1878
669,m1111,20110427,3276,3276,3305,3305,3283,3296,3293,20,17,68,2239820,1844
670,m1111,20110428,3296,3293,3296,3309,3294,3298,3301,5,8,78,2575300,1838
671,m1111,20110429,3298,3301,3266,3266,3238,3240,3250,-61,-51,58,1885240,1834
672,m1111,20110503,3240,3250,3263,3268,3252,3266,3261,16,11,12,391380,1826
673,m1111,20110504,3266,3261,3261,3261,3234,3234,3238,-27,-23,24,777120,1824
674,m1111,20110505,3234,3238,3210,3257,3210,3255,3243,17,5,36,1167600,1830
675,m1111,20110506,3255,3243,3176,3228,3176,3203,3213,-40,-30,58,1863680,1824
676,m1111,20110509,3203,3213,3218,3218,3217,3218,3217,5,4,10,321780,1830
677,m1111,20110510,3218,3217,3223,3235,3223,3235,3229,18,12,4,129160,1830
678,m1111,20110511,3235,3229,3232,3232,3209,3209,3218,-20,-11,44,1416080,1824
679,m1111,20110512,3209,3218,3217,3218,3191,3191,3210,-27,-8,58,1862120,1812
680,m1111,20110513,3191,3210,3217,3235,3216,3230,3220,20,10,48,1546020,1792
681,m1111,20110516,3230,3220,3220,3230,3220,3224,3220,4,0,1782,57382100,1788
682,m1111,20110517,3224,3220,3210,3210,3161,3178,3178,-42,-42,100,3178140,1782
683,m1111,20110518,3178,3178,3198,3205,3198,3200,3202,22,24,120,3843080,1670
684,m1111,20110519,3200,3202,3213,3223,3210,3221,3218,19,16,26,836800,1670
685,m1111,20110520,3221,3218,3229,3279,3229,3269,3241,51,23,138,4473440,1612
686,m1111,20110523,3269,3241,3264,3278,3250,3250,3263,9,22,76,2480360,1570
687,m1111,20110524,3250,3263,3251,3263,3251,3263,3258,0,-5,34,1107900,1544
688,m1111,20110525,3263,3258,3266,3266,3252,3258,3258,0,0,18,586600,1542
689,m1111,20110526,3258,3258,3278,3325,3277,3288,3303,30,45,1234,40771140,1508
690,m1111,20110527,3288,3303,3280,3283,3280,3281,3281,-22,-22,14,459360,1502
691,m1111,20110530,3281,3281,3284,3299,3284,3299,3286,18,5,26,854440,1488
692,m1111,20110531,3299,3286,3282,3282,3271,3272,3274,-14,-12,26,851440,1492
693,m1111,20110601,3272,3274,3274,3285,3274,3277,3280,3,6,38,1246680,1482
694,m1111,20110602,3277,3280,3302,3305,3288,3305,3303,25,23,134,4426060,1394
695,m1111,20110603,3305,3303,3326,3326,3314,3324,3323,21,20,42,1395920,1366
696,m1111,20110607,3324,3323,3278,3292,3278,3286,3285,-37,-38,48,1577060,1334
697,m1111,20110608,3286,3285,3290,3300,3288,3290,3291,5,6,42,1382440,1336
698,m1111,20110609,3290,3291,3290,3303,3290,3293,3297,2,6,38,1252880,1312
699,m1111,20110610,3293,3297,3290,3296,3286,3290,3291,-7,-6,66,2172280,1266
700,m1111,20110613,3290,3291,3298,3310,3298,3310,3302,19,11,62,2047660,1210
701,m1111,20110614,3310,3302,3316,3316,3291,3300,3300,-2,-2,40,1320000,1186
702,m1111,20110615,3300,3300,3290,3290,3290,3290,3290,-10,-10,2,65800,1186
703,m1111,20110616,3290,3290,3303,3304,3295,3295,3299,5,9,60,1979880,1158
704,m1111,20110617,3295,3299,3267,3280,3265,3265,3268,-34,-31,16,522960,1160
705,m1111,20110620,3265,3268,3249,3257,3249,3257,3253,-11,-15,6,195220,1162
706,m1111,20110621,3257,3253,3263,3263,3263,3263,3263,10,10,2,65260,1160
707,m1111,20110622,3263,3263,0,0,0,3263,3263,0,0,0,0,1160
708,m1111,20110623,3263,3263,3248,3257,3248,3257,3254,-6,-9,8,260380,1156
709,m1111,20110624,3257,3254,3271,3283,3271,3272,3274,18,20,10,327440,1160
710,m1111,20110627,3272,3274,3248,3248,3238,3241,3243,-33,-31,20,648700,1154
711,m1111,20110628,3241,3243,3253,3255,3253,3255,3254,12,11,6,195240,1154
712,m1111,20110629,3255,3254,3271,3284,3271,3273,3274,19,20,8,261980,1150
713,m1111,20110630,3273,3274,3292,3293,3286,3286,3288,12,14,10,328880,1146
714,m1111,20110701,3286,3288,0,0,0,3288,3288,0,0,0,0,1146
715,m1111,20110704,3288,3288,3270,3295,3270,3290,3284,2,-4,12,394120,1146
716,m1111,20110705,3290,3284,3290,3290,3272,3281,3282,-3,-2,32,1050280,1134
717,m1111,20110706,3281,3282,3275,3275,3250,3268,3268,-14,-14,52,1699680,1116
718,m1111,20110707,3268,3268,3261,3267,3260,3266,3263,-2,-5,28,913780,1116
719,m1111,20110708,3266,3263,3266,3293,3266,3288,3277,25,14,68,2228720,1106
720,m1111,20110711,3288,3277,3286,3300,3285,3287,3291,10,14,58,1909080,1118
721,m1111,20110712,3287,3291,3283,3284,3270,3282,3278,-9,-13,22,721260,1124
722,m1111,20110713,3282,3278,3318,3326,3313,3322,3317,44,39,46,1526240,1122
723,m1111,20110714,3322,3317,3331,3337,3326,3337,3333,20,16,36,1200040,1122
724,m1111,20110715,3337,3333,3329,3341,3329,3341,3334,8,1,20,666920,1116
725,m1111,20110718,3341,3334,3349,3370,3343,3343,3356,9,22,40,1342780,1102
726,m1111,20110719,3343,3356,3377,3377,3332,3349,3335,-7,-21,362,12073140,898
727,m1111,20110720,3349,3335,3343,3343,3331,3343,3340,8,5,40,1336280,880
728,m1111,20110721,3343,3340,3331,3360,3331,3348,3349,8,9,72,2411780,828
729,m1111,20110722,3348,3349,3358,3364,3348,3348,3357,-1,8,22,738680,830
730,m1111,20110725,3348,3357,3340,3340,3321,3321,3327,-36,-30,22,732100,822
731,m1111,20110726,3321,3327,3336,3345,3325,3343,3336,16,9,56,1868460,828
732,m1111,20110727,3343,3336,3368,3380,3367,3375,3376,39,40,46,1553380,816
733,m1111,20110728,3375,3376,3346,3362,3346,3356,3352,-20,-24,36,1206980,816
734,m1111,20110729,3356,3352,0,0,0,3352,3352,0,0,0,0,816
735,m1111,20110801,3352,3352,0,0,0,3352,3352,0,0,0,0,816
736,m1111,20110802,3352,3352,3350,3350,3320,3338,3338,-14,-14,438,14624140,764
737,m1111,20110803,3338,3338,3345,3360,3343,3343,3344,5,6,46,1538460,732
738,m1111,20110804,3343,3344,3324,3324,3312,3312,3320,-32,-24,36,1195200,730
739,m1111,20110805,3312,3320,3245,3278,3168,3250,3259,-70,-61,236,7693060,622
740,m1111,20110808,3250,3259,3258,3258,3221,3225,3231,-34,-28,14,452360,620
741,m1111,20110809,3225,3231,3169,3198,3169,3198,3177,-33,-54,24,762640,618
742,m1111,20110810,3198,3177,3248,3248,3223,3230,3230,53,53,74,2390520,604
743,m1111,20110811,3230,3230,3182,3248,3182,3248,3233,18,3,44,1422680,592
744,m1111,20110812,3248,3233,3245,3272,3245,3260,3260,27,27,50,1630100,578
745,m1111,20110815,3260,3260,3275,3280,3262,3280,3277,20,17,72,2360140,532
746,m1111,20110816,3280,3277,3312,3312,3267,3267,3279,-10,2,14,459080,532
747,m1111,20110817,3267,3279,3264,3286,3263,3271,3270,-8,-9,26,850200,524
748,m1111,20110818,3271,3270,3272,3277,3272,3272,3275,2,5,20,655180,516
749,m1111,20110819,3272,3275,3272,3276,3270,3270,3272,-5,-3,16,523660,512
750,m1111,20110822,3270,3272,3300,3302,3286,3286,3296,14,24,18,593440,506
751,m1111,20110823,3286,3296,3300,3310,3299,3310,3300,14,4,32,1056160,480
752,m1111,20110824,3310,3300,3277,3308,3277,3308,3299,8,-1,26,857900,460
753,m1111,20110825,3308,3299,3271,3299,3271,3288,3293,-11,-6,32,1053840,454
754,m1111,20110826,3288,3293,3335,3335,3288,3323,3324,30,31,72,2393380,478
755,m1111,20110829,3323,3324,3335,3345,3328,3336,3339,12,15,74,2471480,508
756,m1111,20110830,3336,3339,3323,3330,3306,3306,3319,-33,-20,62,2057880,530
757,m1111,20110831,3306,3319,3295,3324,3290,3306,3312,-13,-7,164,5432380,562
758,m1111,20110901,3306,3312,3286,3300,3286,3300,3293,-12,-19,18,592820,552
759,m1111,20110902,3300,3293,3299,3339,3281,3290,3295,-3,2,132,4350580,516
760,m1111,20110905,3290,3295,3326,3327,3290,3294,3306,-1,11,24,793560,522
761,m1111,20110906,3294,3306,3250,3292,3250,3292,3271,-14,-35,4,130840,522
762,m1111,20110907,3292,3271,3293,3298,3293,3298,3295,27,24,4,131820,522
763,m1111,20110908,3298,3295,0,0,0,3295,3295,0,0,0,0,522
764,m1111,20110909,3295,3295,3217,3298,3217,3298,3275,3,-20,10,327540,524
765,m1111,20110913,3298,3275,3295,3295,3256,3256,3270,-19,-5,26,850400,524
766,m1111,20110914,3256,3270,3284,3284,3235,3239,3267,-31,-3,20,653480,522
767,m1111,20110915,3239,3267,3216,3252,3216,3240,3235,-27,-32,30,970580,522
768,m1111,20110916,3240,3235,3220,3220,3212,3212,3216,-23,-19,4,128640,522
769,m1111,20110919,3212,3216,3212,3212,3170,3170,3184,-46,-32,6,191060,522
770,m1111,20110920,3170,3184,3181,3181,3171,3174,3174,-10,-10,18,571380,510
771,m1111,20110921,3174,3174,3161,3168,3142,3167,3159,-7,-15,18,568760,510
772,m1111,20110922,3167,3159,3087,3150,3087,3128,3107,-31,-52,170,5283280,456
773,m1111,20110923,3128,3107,3032,3093,2954,2992,3001,-115,-106,72,2161000,450
774,m1111,20110926,2992,3001,3022,3022,2940,2940,2987,-61,-14,32,956060,438
775,m1111,20110927,2940,2987,3040,3040,2965,3005,3002,18,15,70,2101740,420
776,m1111,20110928,3005,3002,2945,2985,2945,2980,2967,-22,-35,26,771560,422
777,m1111,20110929,2980,2967,2912,2913,2878,2880,2897,-87,-70,72,2086400,376
778,m1111,20110930,2880,2897,2852,2940,2852,2940,2925,43,28,40,1170140,352
779,m1111,20111010,2940,2925,2910,2975,2910,2963,2948,38,23,80,2358720,332
780,m1111,20111011,2963,2948,2951,3000,2951,2999,2965,51,17,160,4744080,332
781,m1111,20111012,2999,2965,3010,3069,2992,3040,3024,75,59,78,2359460,318
782,m1111,20111013,3040,3024,3100,3100,3021,3049,3044,25,20,214,6516000,494
783,m1111,20111014,3049,3044,3041,3044,3040,3044,3041,0,-3,30,912340,522
784,m1111,20111017,3044,3041,0,0,0,3041,3041,0,0,0,0,522
785,m1111,20111018,3041,3041,3010,3058,3001,3001,3030,-40,-11,12,363600,518
786,m1111,20111019,3001,3030,3001,3039,3001,3035,3027,5,-3,8,242200,520
787,m1111,20111020,3035,3027,3028,3028,2950,3014,2982,-13,-45,10,298240,518
788,m1111,20111021,3014,2982,2951,2955,2951,2955,2953,-27,-29,6,177220,514
789,m1111,20111024,2955,2953,2900,3010,2900,3000,2969,47,16,26,772160,508
790,m1111,20111025,3000,2969,2938,2999,2938,2999,2971,30,2,20,594300,498
791,m1111,20111026,2999,2971,2993,3000,2993,2995,2994,24,23,12,359340,486
792,m1111,20111027,2995,2994,2994,2994,2945,2945,2990,-49,-4,100,2990580,392
793,m1111,20111028,2945,2990,2921,2930,2841,2841,2874,-149,-116,24,689760,392
794,m1111,20111031,2841,2874,2723,2800,2702,2770,2751,-104,-123,104,2861180,388
795,m1111,20111101,2770,2751,2750,2750,2750,2750,2750,-1,-1,2,55000,100
796,m1111,20111102,2750,2750,0,0,0,2750,2750,0,0,0,0,100
797,m1111,20111103,2750,2750,0,0,0,2750,2750,0,0,0,0,100
798,m1111,20111104,2750,2750,0,0,0,2750,2750,0,0,0,0,100
799,m1111,20111107,2750,2750,0,0,0,2750,2750,0,0,0,0,100
800,m1111,20111108,2750,2750,0,0,0,2750,2750,0,0,0,0,0
801,m1111,20111109,2750,2750,0,0,0,2750,2750,0,0,0,0,0
802,m1111,20111110,2750,2750,0,0,0,2750,2750,0,0,0,0,0
803,m1111,20111111,2750,2750,0,0,0,2750,2750,0,0,0,0,0
804,m1111,20111114,2750,2750,0,0,0,2750,2750,0,0,0,0,0
805,m1112,20110104,3401,3401,3393,3403,3392,3394,3394,-7,-7,34,1154160,494
806,m1112,20110105,3394,3394,3352,3360,3344,3346,3354,-48,-40,150,5031020,598
807,m1112,20110106,3346,3354,3370,3416,3370,3388,3385,34,31,36,1218880,598
808,m1112,20110107,3388,3385,3388,3388,3330,3330,3348,-55,-37,158,5291400,692
809,m1112,20110110,3330,3348,3338,3367,3335,3354,3351,6,3,112,3753200,728
810,m1112,20110111,3354,3351,3358,3369,3354,3354,3363,3,12,18,605360,726
811,m1112,20110112,3354,3363,3312,3355,3299,3316,3315,-47,-48,7618,252557540,6728
812,m1112,20110113,3316,3315,3369,3389,3355,3374,3371,59,56,2890,97428060,7372
813,m1112,20110114,3374,3371,3373,3418,3373,3406,3398,35,27,6224,211550600,11054
814,m1112,20110117,3406,3398,3437,3445,3401,3438,3433,40,35,3134,107594660,10944
815,m1112,20110118,3438,3433,3430,3448,3423,3435,3433,2,0,2974,102098000,10976
816,m1112,20110119,3435,3433,3431,3435,3421,3422,3428,-11,-5,2646,90715520,10046
817,m1112,20110120,3422,3428,3411,3420,3383,3387,3399,-41,-29,1730,58808020,10044
818,m1112,20110121,3387,3399,3395,3405,3370,3379,3388,-20,-11,1268,42961020,10050
819,m1112,20110124,3379,3388,3380,3413,3380,3398,3397,10,9,1348,45804180,10042
820,m1112,20110125,3398,3397,3390,3392,3361,3361,3382,-36,-15,2364,79954420,8188
821,m1112,20110126,3361,3382,3360,3360,3328,3354,3346,-28,-36,2874,96180140,6210
822,m1112,20110127,3354,3346,3369,3390,3354,3373,3368,27,22,1042,35102200,5564
823,m1112,20110128,3373,3368,3368,3390,3367,3377,3380,9,12,204,6896820,5430
824,m1112,20110131,3377,3380,3388,3408,3387,3408,3401,28,21,1200,40815780,5062
825,m1112,20110201,3408,3401,3390,3425,3390,3420,3415,19,14,1372,46863580,4564
826,m1112,20110209,3420,3415,3400,3492,3400,3480,3451,65,36,1772,61168380,3404
827,m1112,20110210,3480,3451,3500,3526,3494,3500,3513,49,62,1530,53756180,3154
828,m1112,20110211,3500,3513,3488,3550,3488,3546,3539,33,26,2650,93789360,1410
829,m1112,20110214,3546,3539,3539,3557,3539,3550,3550,11,11,1282,45512440,660
830,m1112,20110215,3550,3550,3533,3545,3492,3494,3517,-56,-33,258,9074720,670
831,m1112,20110216,3494,3517,3500,3500,3446,3457,3458,-60,-59,170,5878940,696
832,m1112,20110217,3457,3458,3467,3475,3434,3444,3456,-14,-2,72,2488760,686
833,m1112,20110218,3444,3456,3477,3477,3456,3456,3465,0,9,68,2356740,682
834,m1112,20110221,3456,3465,3416,3450,3416,3450,3446,-15,-19,44,1516500,700
835,m1112,20110222,3450,3446,3478,3487,3425,3445,3462,-1,16,90,3115980,718
836,m1112,20110223,3445,3462,3390,3390,3313,3355,3369,-107,-93,182,6131700,828
837,m1112,20110224,3355,3369,3366,3366,3306,3327,3337,-42,-32,84,2803820,834
838,m1112,20110225,3327,3337,3335,3364,3332,3364,3338,27,1,48,1602300,798
839,m1112,20110228,3364,3338,3389,3390,3367,3373,3374,35,36,130,4386540,766
840,m1112,20110301,3373,3374,3370,3374,3370,3374,3373,0,-1,10,337320,766
841,m1112,20110302,3374,3373,3374,3405,3365,3401,3384,28,11,240,8121640,676
842,m1112,20110303,3401,3384,3400,3410,3390,3390,3400,6,16,100,3400420,620
843,m1112,20110304,3390,3400,3429,3448,3406,3412,3418,12,18,40,1367500,624
844,m1112,20110307,3412,3418,3400,3414,3400,3409,3406,-9,-12,24,817500,620
845,m1112,20110308,3409,3406,3385,3389,3358,3365,3376,-41,-30,68,2296220,626
846,m1112,20110309,3365,3376,3372,3372,3347,3368,3358,-8,-18,20,671720,626
847,m1112,20110310,3368,3358,3362,3362,3326,3333,3346,-25,-12,20,669300,620
848,m1112,20110311,3333,3346,3357,3357,3331,3336,3340,-10,-6,28,935260,614
849,m1112,20110314,3336,3340,3337,3350,3318,3325,3331,-15,-9,52,1732120,632
850,m1112,20110315,3325,3331,3320,3346,3313,3341,3319,10,-12,306,10157940,714
851,m1112,20110316,3341,3319,3329,3329,3266,3281,3288,-38,-31,274,9010020,646
852,m1112,20110317,3281,3288,3280,3295,3275,3291,3285,3,-3,66,2168380,652
853,m1112,20110318,3291,3285,3295,3298,3285,3286,3292,1,7,114,3753180,636
854,m1112,20110321,3286,3292,3309,3310,3304,3304,3307,12,15,20,661500,636
855,m1112,20110322,3304,3307,3301,3305,3296,3297,3300,-10,-7,20,660160,632
856,m1112,20110323,3297,3300,3333,3346,3318,3346,3331,46,31,30,999540,632
857,m1112,20110324,3346,3331,3368,3368,3330,3330,3354,-1,23,96,3220000,652
858,m1112,20110325,3330,3354,3330,3377,3330,3371,3362,17,8,28,941520,650
859,m1112,20110328,3371,3362,3380,3380,3339,3349,3360,-13,-2,34,1142660,650
860,m1112,20110329,3349,3360,3337,3376,3336,3360,3363,0,3,30,1008960,646
861,m1112,20110330,3360,3363,3361,3374,3360,3363,3369,0,6,58,1954040,598
862,m1112,20110331,3363,3369,3386,3386,3349,3368,3369,-1,0,44,1482460,586
863,m1112,20110401,3368,3369,3368,3400,3368,3394,3393,25,24,58,1968220,560
864,m1112,20110406,3394,3393,3411,3411,3392,3393,3393,0,0,36,1221720,550
865,m1112,20110407,3393,3393,3390,3390,3386,3386,3388,-7,-5,8,271040,548
866,m1112,20110408,3386,3388,3375,3388,3375,3376,3377,-12,-11,26,878220,536
867,m1112,20110411,3376,3377,3410,3436,3403,3415,3421,38,44,68,2326400,524
868,m1112,20110412,3415,3421,3367,3382,3366,3369,3369,-52,-52,34,1145540,510
869,m1112,20110413,3369,3369,3399,3399,3340,3350,3359,-19,-10,26,873440,516
870,m1112,20110414,3350,3359,3360,3367,3330,3330,3348,-29,-11,110,3683500,522
871,m1112,20110415,3330,3348,3350,3350,3320,3322,3332,-26,-16,34,1132920,522
872,m1112,20110418,3322,3332,3294,3329,3294,3324,3317,-8,-15,50,1658920,520
873,m1112,20110419,3324,3317,3304,3319,3304,3314,3308,-3,-9,20,661740,516
874,m1112,20110420,3314,3308,3333,3345,3330,3345,3336,37,28,34,1134320,522
875,m1112,20110421,3345,3336,3355,3355,3337,3337,3342,1,6,12,401080,520
876,m1112,20110422,3337,3342,3359,3359,3349,3352,3355,10,13,54,1811880,494
877,m1112,20110425,3352,3355,3395,3395,3352,3352,3359,-3,4,48,1612680,484
878,m1112,20110426,3352,3359,3338,3355,3338,3350,3345,-9,-14,24,802880,474
879,m1112,20110427,3350,3345,3353,3353,3344,3345,3348,0,3,26,870500,472
880,m1112,20110428,3345,3348,3354,3354,3342,3353,3348,5,0,32,1071600,466
881,m1112,20110429,3353,3348,3304,3321,3288,3292,3305,-56,-43,62,2049280,468
882,m1112,20110503,3292,3305,3321,3322,3305,3322,3315,17,10,18,596740,466
883,m1112,20110504,3322,3315,3267,3309,3267,3294,3290,-21,-25,38,1250480,468
884,m1112,20110505,3294,3290,3316,3316,3268,3297,3301,7,11,32,1056440,466
885,m1112,20110506,3297,3301,3259,3272,3257,3257,3262,-44,-39,28,913600,466
886,m1112,20110509,3257,3262,3273,3279,3263,3266,3268,4,6,68,2222900,464
887,m1112,20110510,3266,3268,3294,3294,3275,3283,3285,15,17,32,1051260,464
888,m1112,20110511,3283,3285,3297,3297,3261,3262,3278,-23,-7,30,983460,472
889,m1112,20110512,3262,3278,3276,3283,3271,3271,3276,-7,-2,30,982800,456
890,m1112,20110513,3271,3276,3283,3298,3277,3298,3280,22,4,280,9185520,462
891,m1112,20110516,3298,3280,3288,3288,3280,3285,3286,5,6,14,460080,456
892,m1112,20110517,3285,3286,3271,3293,3235,3257,3255,-29,-31,32,1041720,450
893,m1112,20110518,3257,3255,3206,3291,3206,3256,3257,1,2,50,1628760,430
894,m1112,20110519,3256,3257,3269,3284,3269,3284,3277,27,20,8,262180,422
895,m1112,20110520,3284,3277,3310,3315,3296,3296,3305,19,28,16,528820,422
896,m1112,20110523,3296,3305,3296,3344,3296,3311,3337,6,32,130,4338600,506
897,m1112,20110524,3311,3337,0,0,0,3337,3337,0,0,0,0,506
898,m1112,20110525,3337,3337,3298,3323,3298,3316,3315,-21,-22,28,928200,510
899,m1112,20110526,3316,3315,3323,3335,3323,3335,3330,20,15,118,3930460,408
900,m1112,20110527,3335,3330,3330,3336,3330,3331,3332,1,2,28,933020,400
901,m1112,20110530,3331,3332,3334,3344,3331,3336,3335,4,3,18,600400,398
902,m1112,20110531,3336,3335,3348,3348,3320,3320,3328,-15,-7,56,1863740,396
903,m1112,20110601,3320,3328,0,0,0,3328,3328,0,0,0,0,396
904,m1112,20110602,3328,3328,3340,3358,3340,3358,3348,30,20,56,1875000,390
905,m1112,20110603,3358,3348,3378,3382,3369,3382,3373,34,25,12,404760,392
906,m1112,20110607,3382,3373,3327,3369,3327,3342,3346,-31,-27,38,1271580,384
907,m1112,20110608,3342,3346,3360,3360,3350,3354,3356,8,10,52,1745260,386
908,m1112,20110609,3354,3356,3376,3376,3355,3355,3360,-1,4,38,1277120,390
909,m1112,20110610,3355,3360,3352,3352,3340,3340,3341,-20,-19,14,467840,402
910,m1112,20110613,3340,3341,3349,3365,3349,3365,3358,24,17,16,537280,396
911,m1112,20110614,3365,3358,3366,3370,3351,3355,3360,-3,2,72,2419360,400
912,m1112,20110615,3355,3360,3345,3345,3345,3345,3345,-15,-15,2,66900,400
913,m1112,20110616,3345,3345,3350,3364,3340,3340,3354,-5,9,64,2147160,396
914,m1112,20110617,3340,3354,3347,3347,3313,3313,3323,-41,-31,10,332360,396
915,m1112,20110620,3313,3323,3263,3298,3263,3298,3290,-25,-33,30,987260,398
916,m1112,20110621,3298,3290,3300,3300,3295,3295,3297,5,7,4,131900,396
917,m1112,20110622,3295,3297,3307,3307,3302,3304,3304,7,7,6,198260,396
918,m1112,20110623,3304,3304,3290,3299,3277,3299,3289,-5,-15,76,2500380,338
919,m1112,20110624,3299,3289,3304,3315,3304,3308,3309,19,20,6,198540,336
920,m1112,20110627,3308,3309,3296,3296,3269,3269,3277,-40,-32,24,786680,338
921,m1112,20110628,3269,3277,3280,3288,3269,3277,3278,0,1,16,524540,338
922,m1112,20110629,3277,3278,3273,3303,3273,3295,3292,17,14,40,1316940,352
923,m1112,20110630,3295,3292,3307,3315,3302,3310,3311,18,19,26,860960,344
924,m1112,20110701,3310,3311,3294,3300,3288,3290,3293,-21,-18,40,1317380,344
925,m1112,20110704,3290,3293,3311,3311,3281,3300,3295,7,2,28,922800,344
926,m1112,20110705,3300,3295,3309,3314,3288,3295,3300,0,5,78,2574580,368
927,m1112,20110706,3295,3300,3285,3302,3270,3270,3289,-30,-11,14,460580,370
928,m1112,20110707,3270,3289,3284,3294,3284,3292,3291,3,2,60,1974720,362
929,m1112,20110708,3292,3291,3318,3318,3314,3314,3315,23,24,16,530480,364
930,m1112,20110711,3314,3315,3334,3334,3308,3321,3323,6,8,50,1661520,360
931,m1112,20110712,3321,3323,3238,3316,3238,3305,3292,-18,-31,92,3029340,380
932,m1112,20110713,3305,3292,3325,3344,3325,3344,3336,52,44,44,1468220,346
933,m1112,20110714,3344,3336,0,0,0,3336,3336,0,0,0,0,346
934,m1112,20110715,3336,3336,3349,3349,3349,3349,3349,13,13,2,66980,346
935,m1112,20110718,3349,3349,3367,3405,3367,3384,3389,35,40,48,1626780,330
936,m1112,20110719,3384,3389,3381,3393,3381,3393,3390,4,1,26,881520,314
937,m1112,20110720,3393,3390,3400,3409,3398,3398,3401,8,11,10,340140,314
938,m1112,20110721,3398,3401,3380,3397,3380,3397,3393,-4,-8,20,678680,308
939,m1112,20110722,3397,3393,3400,3400,3400,3400,3400,7,7,2,68000,308
940,m1112,20110725,3400,3400,3400,3400,3378,3380,3384,-20,-16,14,473820,314
941,m1112,20110726,3380,3384,3381,3403,3381,3403,3398,19,14,44,1495340,346
942,m1112,20110727,3403,3398,3435,3444,3435,3441,3440,43,42,14,481600,338
943,m1112,20110728,3441,3440,3421,3423,3420,3420,3421,-20,-19,14,478960,338
944,m1112,20110729,3420,3421,3411,3440,3403,3403,3416,-18,-5,50,1708280,316
945,m1112,20110801,3403,3416,3398,3409,3398,3409,3399,-7,-17,12,407980,316
946,m1112,20110802,3409,3399,3390,3390,3390,3390,3390,-9,-9,2,67800,316
947,m1112,20110803,3390,3390,0,0,0,3390,3390,0,0,0,0,316
948,m1112,20110804,3390,3390,3377,3378,3351,3351,3367,-39,-23,28,942800,302
949,m1112,20110805,3351,3367,3282,3299,3264,3284,3285,-83,-82,70,2299620,276
950,m1112,20110808,3284,3285,3271,3271,3260,3260,3265,-25,-20,4,130620,272
951,m1112,20110809,3260,3265,3190,3238,3190,3221,3212,-44,-53,24,771020,260
952,m1112,20110810,3221,3212,3274,3274,3274,3274,3274,62,62,2,65480,260
953,m1112,20110811,3274,3274,3230,3267,3230,3267,3255,-7,-19,8,260440,258
954,m1112,20110812,3267,3255,3288,3288,3277,3277,3282,22,27,8,262600,254
955,m1112,20110815,3277,3282,3300,3300,3300,3300,3300,18,18,2,66000,252
956,m1112,20110816,3300,3300,3290,3290,3290,3290,3290,-10,-10,4,131600,248
957,m1112,20110817,3290,3290,0,0,0,3290,3290,0,0,0,0,248
958,m1112,20110818,3290,3290,0,0,0,3290,3290,0,0,0,0,248
959,m1112,20110819,3290,3290,3310,3310,3283,3283,3303,-7,13,8,264260,250
960,m1112,20110822,3283,3303,3341,3341,3311,3311,3326,8,23,4,133040,250
961,m1112,20110823,3311,3326,3349,3349,3335,3341,3341,15,15,24,801880,268
962,m1112,20110824,3341,3341,3351,3357,3351,3351,3354,10,13,20,670920,248
963,m1112,20110825,3351,3354,3341,3341,3341,3341,3341,-13,-13,8,267280,246
964,m1112,20110826,3341,3341,3327,3363,3327,3333,3341,-8,0,14,467820,252
965,m1112,20110829,3333,3341,3381,3395,3381,3395,3387,54,46,20,677480,242
966,m1112,20110830,3395,3387,3382,3382,3375,3375,3377,-12,-10,20,675400,244
967,m1112,20110831,3375,3377,3378,3401,3378,3386,3392,9,15,68,2306600,218
968,m1112,20110901,3386,3392,3388,3388,3379,3379,3386,-13,-6,12,406360,220
969,m1112,20110902,3379,3386,3367,3377,3367,3367,3371,-19,-15,8,269720,222
970,m1112,20110905,3367,3371,3388,3388,3357,3359,3364,-12,-7,30,1009420,208
971,m1112,20110906,3359,3364,3359,3359,3328,3340,3339,-24,-25,10,333920,208
972,m1112,20110907,3340,3339,3364,3366,3354,3354,3363,15,24,10,336320,206
973,m1112,20110908,3354,3363,3368,3368,3348,3348,3354,-15,-9,14,469680,202
974,m1112,20110909,3348,3354,3341,3350,3340,3350,3345,-4,-9,46,1538900,200
975,m1112,20110913,3350,3345,3258,3258,3258,3258,3258,-87,-87,14,456120,214
976,m1112,20110914,3258,3258,3260,3260,3260,3260,3260,2,2,2,65200,214
977,m1112,20110915,3260,3260,3253,3257,3250,3256,3252,-4,-8,20,650440,208
978,m1112,20110916,3256,3252,3246,3266,3241,3251,3245,-1,-7,30,973740,194
979,m1112,20110919,3251,3245,3250,3250,3250,3250,3250,5,5,10,325000,194
980,m1112,20110920,3250,3250,3249,3249,3248,3248,3248,-2,-2,8,259860,194
981,m1112,20110921,3248,3248,3240,3245,3223,3245,3234,-3,-14,10,323420,196
982,m1112,20110922,3245,3234,3198,3220,3186,3186,3206,-48,-28,40,1282600,202
983,m1112,20110923,3186,3206,3128,3166,3066,3066,3089,-140,-117,32,988480,180
984,m1112,20110926,3066,3089,3035,3146,3035,3061,3068,-28,-21,16,491020,180
985,m1112,20110927,3061,3068,3087,3087,3049,3075,3070,7,2,6,184220,180
986,m1112,20110928,3075,3070,3034,3034,3034,3034,3034,-36,-36,2,60680,178
987,m1112,20110929,3034,3034,2950,2976,2920,2920,2933,-114,-101,126,3695700,148
988,m1112,20110930,2920,2933,2950,2984,2941,2968,2960,35,27,24,710460,146
989,m1112,20111010,2968,2960,2922,2947,2922,2925,2929,-35,-31,28,820320,138
990,m1112,20111011,2925,2929,2956,2956,2916,2922,2937,-7,8,18,528740,136
991,m1112,20111012,2922,2937,2952,2990,2952,2980,2973,43,36,22,654220,134
992,m1112,20111013,2980,2973,2934,3059,2934,2999,3001,26,28,36,1080420,132
993,m1112,20111014,2999,3001,3010,3029,3002,3029,3015,28,14,14,422180,132
994,m1112,20111017,3029,3015,3011,3037,3011,3023,3020,8,5,10,302000,132
995,m1112,20111018,3023,3020,2935,2935,2935,2935,2935,-85,-85,2,58700,132
996,m1112,20111019,2935,2935,2960,2971,2960,2971,2967,36,32,6,178020,134
997,m1112,20111020,2971,2967,2949,2951,2919,2920,2930,-47,-37,26,761980,128
998,m1112,20111021,2920,2930,2945,3018,2945,2987,2983,57,53,176,5251080,120
999,m1112,20111024,2987,2983,2990,3004,2990,3004,2998,21,15,10,299820,122
1000,m1112,20111025,3004,2998,0,0,0,2998,2998,0,0,0,0,122
1001,m1112,20111026,2998,2998,2979,3025,2979,3001,3001,3,3,6,180100,122
1002,m1112,20111027,3001,3001,0,0,0,3001,3001,0,0,0,0,122
1003,m1112,20111028,3001,3001,3070,3088,3008,3021,3021,20,20,66,1994500,120
1004,m1112,20111031,3021,3021,2995,2995,2990,2990,2993,-31,-28,6,179600,120
1005,m1112,20111101,2990,2993,0,0,0,2993,2993,0,0,0,0,120
1006,m1112,20111102,2993,2993,2980,2990,2980,2990,2985,-3,-8,4,119400,120
1007,m1112,20111103,2990,2985,2963,3003,2963,2976,2975,-9,-10,30,892660,114
1008,m1112,20111104,2976,2975,2999,3000,2999,3000,2999,25,24,10,299980,110
1009,m1112,20111107,3000,2999,0,0,0,2999,2999,0,0,0,0,110
1010,m1112,20111108,2999,2999,3000,3000,3000,3000,3000,1,1,2,60000,108
1011,m1112,20111109,3000,3000,2970,2970,2950,2950,2955,-50,-45,8,236400,100
1012,m1112,20111110,2950,2955,0,0,0,2955,2955,0,0,0,0,100
1013,m1112,20111111,2955,2955,0,0,0,2955,2955,0,0,0,0,100
1014,m1112,20111114,2955,2955,2850,2902,2850,2902,2875,-53,-80,30,862720,88
1015,m1112,20111115,2902,2875,2890,2905,2873,2873,2897,-2,22,66,1912080,46
1016,m1112,20111116,2873,2897,0,0,0,2897,2897,0,0,0,0,46
1017,m1112,20111117,2897,2897,0,0,0,2897,2897,0,0,0,0,46
1018,m1112,20111118,2897,2897,0,0,0,2897,2897,0,0,0,0,46
1019,m1112,20111121,2897,2897,0,0,0,2897,2897,0,0,0,0,46
1020,m1112,20111122,2897,2897,0,0,0,2897,2897,0,0,0,0,46
1021,m1112,20111123,2897,2897,2755,2755,2755,2755,2755,-142,-142,2,55100,44
1022,m1112,20111124,2755,2755,0,0,0,2755,2755,0,0,0,0,44
1023,m1112,20111125,2755,2755,2690,2690,2680,2680,2686,-75,-69,16,429800,38
1024,m1112,20111128,2680,2686,2651,2690,2651,2690,2670,4,-16,4,106820,36
1025,m1112,20111129,2690,2670,2702,2728,2702,2728,2710,58,40,6,162640,36
1026,m1112,20111130,2728,2710,0,0,0,2710,2710,0,0,0,0,36
1027,m1112,20111201,2710,2710,0,0,0,2710,2710,0,0,0,0,36
1028,m1112,20111202,2710,2710,2750,2750,2750,2750,2750,40,40,36,990000,0
1029,m1112,20111205,2750,2750,0,0,0,2750,2750,0,0,0,0,0
1030,m1112,20111206,2750,2750,0,0,0,2750,2750,0,0,0,0,0
1031,m1112,20111207,2750,2750,0,0,0,2750,2750,0,0,0,0,0
1032,m1112,20111208,2750,2750,0,0,0,2750,2750,0,0,0,0,0
1033,m1112,20111209,2750,2750,0,0,0,2750,2750,0,0,0,0,0
1034,m1112,20111212,2750,2750,0,0,0,2750,2750,0,0,0,0,0
1035,m1112,20111213,2750,2750,0,0,0,2750,2750,0,0,0,0,0
1036,m1112,20111214,2750,2750,0,0,0,2750,2750,0,0,0,0,0
1037,m1201,20110119,3448,3435,3452,3473,3439,3458,3458,23,23,73446,2539991240,78358
1038,m1201,20110120,3458,3458,3457,3457,3414,3421,3432,-37,-26,92652,3179817200,129194
1039,m1201,20110121,3421,3432,3422,3442,3407,3412,3425,-20,-7,63470,2174431260,145630
1040,m1201,20110124,3412,3425,3418,3453,3416,3439,3434,14,9,88552,3041525060,160316
1041,m1201,20110125,3439,3434,3419,3438,3400,3400,3416,-34,-18,67684,2312684600,179604
1042,m1201,20110126,3400,3416,3380,3380,3340,3353,3355,-63,-61,66996,2247997880,183970
1043,m1201,20110127,3353,3355,3372,3383,3352,3375,3369,20,14,50384,1697566840,179746
1044,m1201,20110128,3375,3369,3369,3383,3360,3373,3374,4,5,34952,1179541000,181840
1045,m1201,20110131,3373,3374,3380,3399,3377,3390,3391,16,17,42508,1441791900,193526
1046,m1201,20110201,3390,3391,3398,3421,3395,3420,3408,29,17,43530,1483641420,201378
1047,m1201,20110209,3420,3408,3434,3497,3424,3491,3471,83,63,106444,3695102160,198418
1048,m1201,20110210,3491,3471,3502,3560,3493,3528,3532,57,61,169676,5994350140,240206
1049,m1201,20110211,3528,3532,3514,3565,3510,3543,3544,11,12,259736,9205669800,315272
1050,m1201,20110214,3543,3544,3546,3556,3527,3545,3542,1,-2,158198,5604941480,341804
1051,m1201,20110215,3545,3542,3518,3526,3490,3494,3511,-48,-31,182884,6421599680,393270
1052,m1201,20110216,3494,3511,3460,3471,3438,3468,3457,-43,-54,234110,8094750580,445368
1053,m1201,20110217,3468,3457,3472,3478,3428,3438,3459,-19,2,238386,8247754800,469190
1054,m1201,20110218,3438,3459,3484,3492,3458,3458,3475,-1,16,277410,9641377040,422024
1055,m1201,20110221,3458,3475,3455,3464,3435,3459,3453,-16,-22,124282,4291900140,420958
1056,m1201,20110222,3459,3453,3474,3491,3436,3484,3471,31,18,266032,9234783220,443304
1057,m1201,20110223,3484,3471,3385,3390,3357,3368,3375,-103,-96,262100,8846350200,472014
1058,m1201,20110224,3368,3375,3388,3388,3329,3339,3359,-36,-16,190996,6415897900,466096
1059,m1201,20110225,3339,3359,3350,3375,3346,3373,3363,14,4,127596,4291993600,462980
1060,m1201,20110228,3373,3363,3392,3414,3392,3407,3406,44,43,153842,5240286540,440192
1061,m1201,20110301,3407,3406,3411,3417,3403,3413,3410,7,4,112728,3844215280,442766
1062,m1201,20110302,3413,3410,3416,3458,3408,3453,3434,43,24,216266,7427932420,455040
1063,m1201,20110303,3453,3434,3454,3457,3428,3433,3444,-1,10,136354,4697019200,458208
1064,m1201,20110304,3433,3444,3457,3474,3436,3452,3455,8,11,194414,6717703260,460096
1065,m1201,20110307,3452,3455,3440,3455,3431,3445,3445,-10,-10,127142,4380559280,467124
1066,m1201,20110308,3445,3445,3415,3430,3380,3393,3404,-52,-41,187096,6369218360,460888
1067,m1201,20110309,3393,3404,3400,3401,3383,3389,3391,-15,-13,101164,3430824900,460638
1068,m1201,20110310,3389,3391,3360,3368,3342,3346,3354,-45,-37,141960,4761667300,454666
1069,m1201,20110311,3346,3354,3359,3367,3331,3347,3351,-7,-3,138790,4651835400,464756
1070,m1201,20110314,3347,3351,3320,3355,3307,3315,3323,-36,-28,203868,6776141940,482204
1071,m1201,20110315,3315,3323,3330,3342,3308,3339,3328,16,5,236546,7873160420,489190
1072,m1201,20110316,3339,3328,3296,3297,3257,3272,3272,-56,-56,356352,11660769380,510708
1073,m1201,20110317,3272,3272,3259,3298,3252,3285,3276,13,4,344010,11273145380,517948
1074,m1201,20110318,3285,3276,3319,3328,3303,3305,3311,29,35,235520,7798946940,502426
1075,m1201,20110321,3305,3311,3332,3339,3317,3331,3329,20,18,289500,9639591440,455366
1076,m1201,20110322,3331,3329,3325,3336,3320,3330,3330,1,1,154166,5134572680,443826
1077,m1201,20110323,3330,3330,3330,3384,3328,3382,3363,52,33,297724,10014182320,416558
1078,m1201,20110324,3382,3363,3368,3377,3352,3358,3364,-5,1,188702,6348710040,411478
1079,m1201,20110325,3358,3364,3371,3403,3369,3399,3393,35,29,275640,9355099800,421808
1080,m1201,20110328,3399,3393,3389,3408,3363,3392,3388,-1,-5,325544,11032065340,402982
1081,m1201,20110329,3392,3388,3375,3417,3366,3404,3394,16,6,397798,13504520540,441308
1082,m1201,20110330,3404,3394,3410,3420,3396,3406,3407,12,13,254000,8653951940,427680
1083,m1201,20110331,3406,3407,3412,3422,3396,3410,3408,3,1,242634,8270285240,429584
1084,m1201,20110401,3410,3408,3438,3445,3426,3427,3435,19,27,239084,8212911940,425626
1085,m1201,20110406,3427,3435,3400,3433,3399,3427,3419,-8,-16,237918,8135075180,447586
1086,m1201,20110407,3427,3419,3424,3437,3417,3423,3424,4,5,180202,6170409060,466054
1087,m1201,20110408,3423,3424,3415,3417,3389,3414,3405,-10,-19,336654,11463525180,496540
1088,m1201,20110411,3414,3405,3434,3462,3429,3439,3445,34,40,384016,13231462300,503350
1089,m1201,20110412,3439,3445,3403,3415,3381,3386,3402,-59,-43,287386,9778226260,531214
1090,m1201,20110413,3386,3402,3358,3380,3353,3376,3367,-26,-35,243188,8188521420,554318
1091,m1201,20110414,3376,3367,3360,3374,3340,3344,3360,-23,-7,257172,8642495740,569812
1092,m1201,20110415,3344,3360,3362,3362,3333,3338,3345,-22,-15,210582,7045990540,566872
1093,m1201,20110418,3338,3345,3330,3352,3320,3346,3339,1,-6,211914,7076049900,582978
1094,m1201,20110419,3346,3339,3353,3357,3336,3340,3346,1,7,240476,8048573580,569968
1095,m1201,20110420,3340,3346,3349,3376,3348,3374,3365,28,19,233688,7865709920,576554
1096,m1201,20110421,3374,3365,3379,3381,3362,3365,3370,0,5,171856,5793205780,573208
1097,m1201,20110422,3365,3370,3385,3393,3376,3392,3385,22,15,234360,7933735920,543704
1098,m1201,20110425,3392,3385,3402,3408,3380,3387,3391,2,6,158496,5375099820,539452
1099,m1201,20110426,3387,3391,3370,3375,3352,3359,3368,-32,-23,150602,5072382720,527798
1100,m1201,20110427,3359,3368,3370,3379,3357,3360,3369,-8,1,162880,5487769040,516986
1101,m1201,20110428,3360,3369,3370,3392,3367,3389,3378,20,9,172620,5831813460,516642
1102,m1201,20110429,3389,3378,3340,3350,3302,3316,3328,-62,-50,298580,9938042760,556958
1103,m1201,20110503,3316,3328,3355,3356,3333,3342,3341,14,13,148670,4968383280,511942
1104,m1201,20110504,3342,3341,3324,3332,3316,3322,3323,-19,-18,137744,4578107040,510082
1105,m1201,20110505,3322,3323,3305,3342,3302,3328,3326,5,3,328484,10928281500,545328
1106,m1201,20110506,3328,3326,3292,3298,3276,3279,3286,-47,-40,287162,9437313580,553552
1107,m1201,20110509,3279,3286,3290,3298,3286,3292,3292,6,6,127588,4200664720,553902
1108,m1201,20110510,3292,3292,3293,3316,3293,3310,3305,18,13,249090,8234641920,564762
1109,m1201,20110511,3310,3305,3310,3319,3293,3294,3306,-11,1,231622,7658660640,595936
1110,m1201,20110512,3294,3306,3293,3311,3282,3282,3296,-24,-10,295780,9750442000,569400
1111,m1201,20110513,3282,3296,3298,3338,3295,3323,3310,27,14,251380,8321728720,566664
1112,m1201,20110516,3323,3310,3304,3322,3304,3310,3311,0,1,227962,7550031780,580010
1113,m1201,20110517,3310,3311,3309,3310,3253,3270,3270,-41,-41,488570,15979796700,624052
1114,m1201,20110518,3270,3270,3285,3290,3275,3276,3282,6,12,263168,8639261980,602132
1115,m1201,20110519,3276,3282,3309,3316,3298,3303,3306,21,24,269484,8911543020,553402
1116,m1201,20110520,3303,3306,3306,3345,3303,3344,3326,38,20,355364,11820987620,584786
1117,m1201,20110523,3344,3326,3356,3361,3327,3334,3344,8,18,289970,9697545000,571102
1118,m1201,20110524,3334,3344,3339,3346,3329,3344,3335,0,-9,223622,7459780360,568006
1119,m1201,20110525,3344,3335,3340,3343,3332,3335,3336,0,1,144346,4815580900,558448
1120,m1201,20110526,3335,3336,3347,3367,3341,3362,3358,26,22,258802,8691811420,591044
1121,m1201,20110527,3362,3358,3370,3373,3351,3359,3359,1,1,180220,6053914260,567460
1122,m1201,20110530,3359,3359,3350,3367,3348,3361,3359,2,0,233230,7836141620,544828
1123,m1201,20110531,3361,3359,3365,3368,3338,3345,3348,-14,-11,202026,6765373380,538144
1124,m1201,20110601,3345,3348,3350,3362,3345,3348,3353,0,5,225966,7577591180,555442
1125,m1201,20110602,3348,3353,3355,3385,3350,3380,3373,27,20,602354,20319386920,607352
1126,m1201,20110603,3380,3373,3395,3400,3384,3399,3391,26,18,356644,12095461380,580946
1127,m1201,20110607,3399,3391,3366,3376,3358,3366,3366,-25,-25,257152,8657143480,557306
1128,m1201,20110608,3366,3366,3380,3382,3358,3363,3368,-3,2,201964,6803621140,551084
1129,m1201,20110609,3363,3368,3380,3380,3363,3366,3372,-2,4,154056,5196192760,525158
1130,m1201,20110610,3366,3372,3368,3370,3344,3358,3356,-14,-16,198934,6678068400,493610
1131,m1201,20110613,3358,3356,3352,3384,3352,3374,3371,18,15,326042,10991219640,533226
1132,m1201,20110614,3374,3371,3366,3376,3365,3375,3370,4,-1,205048,6911520440,543556
1133,m1201,20110615,3375,3370,3363,3369,3355,3363,3361,-7,-9,207458,6974416380,550940
1134,m1201,20110616,3363,3361,3357,3377,3342,3344,3363,-17,2,378442,12728849060,560184
1135,m1201,20110617,3344,3363,3326,3340,3304,3312,3319,-51,-44,290128,9629440340,512894
1136,m1201,20110620,3312,3319,3303,3311,3288,3307,3302,-12,-17,263256,8694406260,517988
1137,m1201,20110621,3307,3302,3318,3318,3305,3316,3312,14,10,166784,5525068680,523378
1138,m1201,20110622,3316,3312,3320,3323,3310,3316,3316,4,4,101838,3377735920,518546
1139,m1201,20110623,3316,3316,3295,3313,3285,3310,3299,-6,-17,216218,7134078840,524206
1140,m1201,20110624,3310,3299,3295,3333,3293,3325,3321,26,22,336634,11180700000,558230
1141,m1201,20110627,3325,3321,3308,3312,3265,3279,3288,-42,-33,386382,12704684620,598744
1142,m1201,20110628,3279,3288,3299,3302,3281,3288,3290,0,2,215246,7082426740,570656
1143,m1201,20110629,3288,3290,3301,3325,3296,3315,3311,25,21,222436,7366354940,567854
1144,m1201,20110630,3315,3311,3311,3332,3310,3324,3322,13,11,196102,6515645060,575168
1145,m1201,20110701,3324,3322,3298,3310,3287,3304,3297,-18,-25,242624,7999509720,609518
1146,m1201,20110704,3304,3297,3318,3323,3298,3314,3310,17,13,349170,11560039480,655606
1147,m1201,20110705,3314,3310,3312,3315,3290,3304,3304,-6,-6,271832,8981990120,626504
1148,m1201,20110706,3304,3304,3302,3312,3281,3293,3294,-11,-10,220400,7261408980,604444
1149,m1201,20110707,3293,3294,3293,3308,3290,3303,3300,9,6,188430,6218329440,579106
1150,m1201,20110708,3303,3300,3319,3326,3313,3318,3318,18,18,179760,5965913620,526456
1151,m1201,20110711,3318,3318,3322,3332,3318,3331,3326,13,8,156850,5217075520,471998
1152,m1201,20110712,3331,3326,3327,3328,3314,3317,3320,-9,-6,81202,2696506040,451846
1153,m1201,20110713,3317,3320,3330,3366,3330,3362,3351,42,31,145198,4866111360,408650
1154,m1201,20110714,3362,3351,3376,3393,3369,3383,3378,32,27,122724,4145959700,362630
1155,m1201,20110715,3383,3378,3377,3388,3370,3382,3378,4,0,84508,2855397280,336908
1156,m1201,20110718,3382,3378,3388,3409,3381,3385,3396,7,18,136280,4628518600,311086
1157,m1201,20110719,3385,3396,3388,3407,3383,3406,3395,10,-1,68830,2336922240,297202
1158,m1201,20110720,3406,3395,3401,3410,3386,3404,3398,9,3,84294,2864366660,272370
1159,m1201,20110721,3404,3398,3396,3415,3391,3413,3406,15,8,77782,2649586880,262484
1160,m1201,20110722,3413,3406,3419,3421,3412,3416,3415,10,9,31240,1067113700,259988
1161,m1201,20110725,3416,3415,3402,3408,3373,3375,3390,-40,-25,57028,1933629920,246878
1162,m1201,20110726,3375,3390,3382,3406,3376,3405,3391,15,1,38778,1315193600,238088
1163,m1201,20110727,3405,3391,3414,3446,3412,3444,3435,53,44,49276,1692765660,234996
1164,m1201,20110728,3444,3435,3431,3432,3418,3424,3424,-11,-11,37738,1292281220,230384
1165,m1201,20110729,3424,3424,3412,3429,3399,3400,3415,-24,-9,33808,1154747140,227180
1166,m1201,20110801,3400,3415,3399,3410,3392,3408,3400,-7,-15,45102,1533812060,219446
1167,m1201,20110802,3408,3400,3405,3409,3391,3391,3397,-9,-3,31134,1057763440,215114
1168,m1201,20110803,3391,3397,3405,3410,3388,3390,3396,-7,-1,30184,1025302060,207642
1169,m1201,20110804,3390,3396,3382,3389,3354,3355,3366,-41,-30,40406,1360311280,191462
1170,m1201,20110805,3355,3366,3320,3320,3201,3291,3284,-75,-82,64874,2130494460,177522
1171,m1201,20110808,3291,3284,3270,3294,3263,3269,3275,-15,-9,30748,1007097640,171230
1172,m1201,20110809,3269,3275,3250,3250,3169,3238,3214,-37,-61,52018,1672164500,160262
1173,m1201,20110810,3238,3214,3253,3275,3253,3265,3267,51,53,25188,823001880,157002
1174,m1201,20110811,3265,3267,3243,3286,3243,3282,3270,15,3,28892,944938100,155136
1175,m1201,20110812,3282,3270,3298,3310,3287,3290,3299,20,29,24970,823952500,151474
1176,m1201,20110815,3290,3299,3308,3324,3307,3319,3316,20,17,12444,412732240,151198
1177,m1201,20110816,3319,3316,3322,3327,3295,3297,3310,-19,-6,10206,337882380,149388
1178,m1201,20110817,3297,3310,3305,3316,3304,3311,3310,1,0,10912,361244340,149944
1179,m1201,20110818,3311,3310,3328,3328,3314,3315,3318,5,8,11338,376259500,145426
1180,m1201,20110819,3315,3318,3300,3319,3291,3312,3308,-6,-10,16184,535384840,143032
1181,m1201,20110822,3312,3308,3321,3344,3321,3333,3337,25,29,22414,748045420,136548
1182,m1201,20110823,3333,3337,3351,3372,3351,3372,3359,35,22,13432,451314900,135380
1183,m1201,20110824,3372,3359,3375,3377,3356,3363,3364,4,5,14040,472398060,133280
1184,m1201,20110825,3363,3364,3351,3359,3344,3353,3350,-11,-14,9350,313247000,131130
1185,m1201,20110826,3353,3350,3360,3362,3333,3336,3343,-14,-7,13766,460304200,131148
1186,m1201,20110829,3336,3343,3380,3400,3378,3397,3388,54,45,23880,809168460,126090
1187,m1201,20110830,3397,3388,3401,3404,3388,3396,3397,8,9,13874,471331020,121780
1188,m1201,20110831,3396,3397,3405,3420,3397,3405,3410,8,13,12326,420391480,118020
1189,m1201,20110901,3405,3410,3404,3407,3378,3382,3391,-28,-19,14488,491361860,116088
1190,m1201,20110902,3382,3391,3375,3378,3363,3373,3372,-18,-19,11562,389939120,116906
1191,m1201,20110905,3373,3372,3378,3392,3369,3373,3378,1,6,16424,554810800,112286
1192,m1201,20110906,3373,3378,3365,3368,3336,3350,3351,-28,-27,10870,364266880,109974
1193,m1201,20110907,3350,3351,3361,3375,3346,3373,3359,22,8,11488,385987420,105444
1194,m1201,20110908,3373,3359,3368,3368,3345,3346,3351,-13,-8,8828,295832740,105726
1195,m1201,20110909,3346,3351,3348,3355,3340,3354,3346,3,-5,7986,267249960,105662
1196,m1201,20110913,3354,3346,3329,3329,3290,3292,3303,-54,-43,18036,595839500,107460
1197,m1201,20110914,3292,3303,3295,3302,3255,3259,3271,-44,-32,13452,440100400,105976
1198,m1201,20110915,3259,3271,3275,3275,3249,3263,3264,-8,-7,10732,350302280,102802
1199,m1201,20110916,3263,3264,3230,3257,3228,3242,3241,-22,-23,15350,497635080,98442
1200,m1201,20110919,3242,3241,3240,3240,3205,3209,3212,-32,-29,14232,457246640,94994
1201,m1201,20110920,3209,3212,3220,3222,3211,3217,3217,5,5,8286,266609140,90434
1202,m1201,20110921,3217,3217,3211,3211,3188,3209,3204,-8,-13,11122,356389680,86548
1203,m1201,20110922,3209,3204,3180,3180,3107,3143,3150,-61,-54,14126,445054740,81190
1204,m1201,20110923,3143,3150,3108,3109,3002,3062,3062,-88,-88,27164,831995460,66646
1205,m1201,20110926,3062,3062,3050,3065,2955,2968,3014,-94,-48,17646,531939700,60090
1206,m1201,20110927,2968,3014,3010,3059,3010,3059,3031,45,17,12632,382974480,55392
1207,m1201,20110928,3059,3031,3035,3035,2998,3017,3015,-14,-16,8026,242013140,53210
1208,m1201,20110929,3017,3015,2955,2956,2909,2950,2934,-65,-81,11388,334213460,49178
1209,m1201,20110930,2950,2934,2971,2999,2962,2999,2983,65,49,6412,191330800,46202
1210,m1201,20111010,2999,2983,2900,2952,2900,2931,2936,-52,-47,5068,148836600,45282
1211,m1201,20111011,2931,2936,2950,2964,2910,2915,2939,-21,3,5440,159891600,44414
1212,m1201,20111012,2915,2939,2970,3000,2953,2993,2980,54,41,11352,338378600,39932
1213,m1201,20111013,2993,2980,2998,3018,2990,3018,3006,38,26,6110,183669740,37156
1214,m1201,20111014,3018,3006,3030,3048,3027,3040,3034,34,28,3638,110379200,35752
1215,m1201,20111017,3040,3034,3056,3056,3030,3033,3038,-1,4,2602,79065020,34618
1216,m1201,20111018,3033,3038,3018,3018,2973,2978,2995,-60,-43,5002,149818020,30882
1217,m1201,20111019,2978,2995,2994,3008,2982,3005,2999,10,4,2982,89449260,29826
1218,m1201,20111020,3005,2999,2971,2971,2932,2957,2946,-42,-53,2858,84224280,28780
1219,m1201,20111021,2957,2946,2962,2999,2962,2997,2980,51,34,2690,80166140,27150
1220,m1201,20111024,2997,2980,2997,3033,2975,3022,3008,42,28,3460,104079340,25766
1221,m1201,20111025,3022,3008,3011,3035,3011,3025,3024,17,16,2168,65564640,25184
1222,m1201,20111026,3025,3024,3008,3022,3005,3017,3013,-7,-11,1064,32065140,25080
1223,m1201,20111027,3017,3013,3010,3040,3005,3039,3027,26,14,1702,51533300,24578
1224,m1201,20111028,3039,3027,3045,3057,3018,3018,3031,-9,4,1818,55108060,23908
1225,m1201,20111031,3018,3031,3010,3015,2970,2975,2988,-56,-43,986,29466620,23768
1226,m1201,20111101,2975,2988,2988,2993,2971,2976,2980,-12,-8,1444,43033960,23688
1227,m1201,20111102,2976,2980,2970,2990,2952,2986,2970,6,-10,2246,66722280,23516
1228,m1201,20111103,2986,2970,2992,2992,2965,2968,2973,-2,3,1260,37465360,23152
1229,m1201,20111104,2968,2973,2986,3004,2986,2998,2995,25,22,670,20070300,22958
1230,m1201,20111107,2998,2995,2992,2992,2979,2983,2983,-12,-12,1812,54057340,22550
1231,m1201,20111108,2983,2983,2978,2978,2960,2973,2969,-10,-14,738,21918320,22290
1232,m1201,20111109,2973,2969,2976,2981,2968,2968,2972,-1,3,302,8977440,22104
1233,m1201,20111110,2968,2972,2955,2955,2900,2912,2922,-60,-50,2456,71778220,20874
1234,m1201,20111111,2912,2922,2908,2939,2908,2935,2926,13,4,1414,41387360,20248
1235,m1201,20111114,2935,2926,2940,2955,2938,2946,2947,20,21,554,16327960,19892
1236,m1201,20111115,2946,2947,2940,2959,2925,2942,2941,-5,-6,1004,29533300,19104
1237,m1201,20111116,2942,2941,2960,2960,2924,2926,2936,-15,-5,364,10689020,18932
1238,m1201,20111117,2926,2936,2920,2925,2900,2905,2911,-31,-25,916,26667060,18570
1239,m1201,20111118,2905,2911,2890,2890,2864,2867,2870,-44,-41,1138,32667040,18168
1240,m1201,20111121,2867,2870,2869,2869,2857,2862,2861,-8,-9,850,24326660,17662
1241,m1201,20111122,2862,2861,2842,2842,2780,2785,2801,-76,-60,1274,35695860,17248
1242,m1201,20111123,2785,2801,2795,2795,2764,2767,2770,-34,-31,1832,50762600,15872
1243,m1201,20111124,2767,2770,2748,2748,2706,2731,2726,-39,-44,1684,45911440,14960
1244,m1201,20111125,2731,2726,2720,2735,2715,2731,2726,5,0,774,21100940,14480
1245,m1201,20111128,2731,2726,2729,2765,2729,2765,2749,39,23,710,19522120,14056
1246,m1201,20111129,2765,2749,2775,2779,2756,2779,2765,30,16,276,7633300,13942
1247,m1201,20111130,2779,2765,2785,2785,2741,2744,2750,-21,-15,482,13257600,13644
1248,m1201,20111201,2744,2750,2762,2794,2762,2776,2775,26,25,576,15987040,13640
1249,m1201,20111202,2776,2775,2768,2770,2746,2749,2753,-26,-22,564,15530080,13608
1250,m1201,20111205,2749,2753,2755,2757,2742,2746,2745,-7,-8,402,11037200,13552
1251,m1201,20111206,2746,2745,2727,2731,2720,2729,2728,-16,-17,714,19482780,12956
1252,m1201,20111207,2729,2728,2732,2738,2722,2730,2731,2,3,340,9286360,12744
1253,m1201,20111208,2730,2731,2721,2721,2689,2701,2701,-30,-30,1540,41606180,11670
1254,m1201,20111209,2701,2701,2696,2717,2683,2717,2706,16,5,658,17807060,11162
1255,m1201,20111212,2717,2706,2698,2698,2685,2685,2687,-21,-19,588,15802100,10862
1256,m1201,20111213,2685,2687,2671,2692,2671,2680,2684,-7,-3,232,6228780,10702
1257,m1201,20111214,2680,2684,2680,2684,2676,2683,2683,-1,-1,890,23878880,10174
1258,m1201,20111215,2683,2683,2660,2673,2659,2672,2665,-11,-18,836,22283540,9604
1259,m1201,20111216,2672,2665,2676,2689,2665,2689,2680,24,15,218,5843320,9460
1260,m1201,20111219,2689,2680,2699,2710,2685,2709,2694,29,14,456,12287800,9258
1261,m1201,20111220,2709,2694,2710,2722,2710,2721,2716,27,22,370,10050060,9044
1262,m1201,20111221,2721,2716,2728,2750,2725,2732,2734,16,18,230,6289520,8896
1263,m1201,20111222,2732,2734,2732,2758,2732,2752,2750,18,16,808,22220560,8254
1264,m1201,20111223,2752,2750,2760,2764,2756,2764,2761,14,11,400,11044740,7962
1265,m1201,20111226,2764,2761,2749,2769,2749,2761,2762,0,1,154,4253960,7838
1266,m1201,20111227,2761,2762,2769,2772,2760,2770,2769,8,7,184,5095980,7670
1267,m1201,20111228,2770,2769,2785,2830,2785,2825,2812,56,43,216,6074700,7492
1268,m1201,20111229,2825,2812,2825,2848,2825,2841,2831,29,19,2902,82166080,4628
1269,m1201,20111230,2841,2831,2848,2885,2838,2850,2856,19,25,5224,149216660,3852
1270,m1203,20110316,3335,3338,3328,3328,3211,3276,3275,-62,-63,24,786160,2
1271,m1203,20110317,3276,3275,3300,3300,3264,3264,3288,-11,13,6,197280,2
1272,m1203,20110318,3264,3288,3342,3342,3285,3309,3318,21,30,12,398260,2
1273,m1203,20110321,3309,3318,3350,3350,3350,3350,3350,32,32,2,67000,0
1274,m1203,20110322,3350,3350,3288,3339,3288,3339,3313,-11,-37,4,132540,0
1275,m1203,20110323,3339,3313,0,0,0,3313,3313,0,0,0,0,0
1276,m1203,20110324,3313,3313,0,0,0,3313,3313,0,0,0,0,0
1277,m1203,20110325,3313,3313,3427,3427,3427,3427,3427,114,114,2,68540,2
1278,m1203,20110328,3427,3427,3486,3486,3356,3377,3413,-50,-14,16,546100,2
1279,m1203,20110329,3377,3413,3377,3426,3377,3426,3400,13,-13,16,544060,2
1280,m1203,20110330,3426,3400,3379,3469,3379,3424,3417,24,17,26,888540,4
1281,m1203,20110331,3424,3417,3417,3437,3413,3434,3423,17,6,18,616140,10
1282,m1203,20110401,3434,3423,3427,3427,3427,3427,3427,4,4,2,68540,10
1283,m1203,20110406,3427,3427,3430,3430,3430,3430,3430,3,3,2,68600,10
1284,m1203,20110407,3430,3430,3425,3425,3425,3425,3425,-5,-5,2,68500,12
1285,m1203,20110408,3425,3425,3417,3427,3409,3427,3414,2,-11,44,1502580,28
1286,m1203,20110411,3427,3414,3418,3456,3418,3426,3440,12,26,28,963440,36
1287,m1203,20110412,3426,3440,3415,3415,3397,3397,3406,-43,-34,14,476860,32
1288,m1203,20110413,3397,3406,3392,3395,3364,3378,3382,-28,-24,18,608800,40
1289,m1203,20110414,3378,3382,3391,3394,3360,3361,3383,-21,1,48,1623880,40
1290,m1203,20110415,3361,3383,3360,3360,3345,3345,3346,-38,-37,22,736200,48
1291,m1203,20110418,3345,3346,3358,3366,3333,3360,3350,14,4,170,5696140,44
1292,m1203,20110419,3360,3350,3357,3360,3355,3355,3356,5,6,12,402760,38
1293,m1203,20110420,3355,3356,3369,3387,3369,3373,3377,17,21,18,607880,42
1294,m1203,20110421,3373,3377,3381,3386,3381,3383,3383,6,6,16,541380,50
1295,m1203,20110422,3383,3383,3391,3400,3391,3393,3396,10,13,28,951100,62
1296,m1203,20110425,3393,3396,3420,3424,3387,3391,3398,-5,2,40,1359580,86
1297,m1203,20110426,3391,3398,3373,3388,3369,3372,3378,-26,-20,78,2635480,84
1298,m1203,20110427,3372,3378,3394,3394,3370,3370,3378,-8,0,22,743220,90
1299,m1203,20110428,3370,3378,3387,3388,3366,3388,3383,10,5,52,1759280,100
1300,m1203,20110429,3388,3383,3361,3361,3314,3331,3341,-52,-42,54,1804480,90
1301,m1203,20110503,3331,3341,3332,3355,3332,3355,3347,14,6,12,401700,90
1302,m1203,20110504,3355,3347,3346,3346,3327,3327,3335,-20,-12,8,266800,90
1303,m1203,20110505,3327,3335,3351,3366,3340,3348,3355,13,20,72,2415760,78
1304,m1203,20110506,3348,3355,3259,3315,3259,3300,3302,-55,-53,32,1056780,82
1305,m1203,20110509,3300,3302,3312,3317,3307,3316,3313,14,11,32,1060200,86
1306,m1203,20110510,3316,3313,3310,3340,3310,3328,3325,15,12,42,1396760,76
1307,m1203,20110511,3328,3325,3335,3336,3325,3326,3332,1,7,20,666400,76
1308,m1203,20110512,3326,3332,3334,3336,3324,3324,3329,-8,-3,14,466080,78
1309,m1203,20110513,3324,3329,3327,3350,3324,3350,3331,21,2,74,2465440,92
1310,m1203,20110516,3350,3331,3326,3336,3326,3331,3330,0,-1,32,1065760,94
1311,m1203,20110517,3331,3330,3326,3326,3272,3287,3291,-43,-39,176,5793720,132
1312,m1203,20110518,3287,3291,3292,3298,3275,3280,3286,-11,-5,90,2957880,136
1313,m1203,20110519,3280,3286,3290,3312,3290,3294,3296,8,10,24,791180,126
1314,m1203,20110520,3294,3296,3290,3315,3290,3314,3306,18,10,42,1388820,122
1315,m1203,20110523,3314,3306,3340,3340,3309,3309,3324,3,18,34,1130480,114
1316,m1203,20110524,3309,3324,3310,3319,3310,3319,3313,-5,-11,6,198780,110
1317,m1203,20110525,3319,3313,3318,3318,3313,3317,3315,4,2,8,265220,104
1318,m1203,20110526,3317,3315,3335,3336,3321,3330,3331,15,16,34,1132760,98
1319,m1203,20110527,3330,3331,3335,3335,3325,3325,3330,-6,-1,14,466280,92
1320,m1203,20110530,3325,3330,3303,3340,3303,3330,3326,0,-4,34,1131020,96
1321,m1203,20110531,3330,3326,3326,3330,3314,3316,3321,-10,-5,48,1594320,94
1322,m1203,20110601,3316,3321,3330,3330,3315,3321,3321,0,0,30,996320,100
1323,m1203,20110602,3321,3321,3321,3339,3321,3332,3332,11,11,32,1066460,102
1324,m1203,20110603,3332,3332,3345,3366,3341,3345,3347,13,15,26,870400,92
1325,m1203,20110607,3345,3347,3265,3335,3261,3315,3311,-32,-36,26,860920,90
1326,m1203,20110608,3315,3311,3338,3365,3320,3328,3337,17,26,62,2069080,94
1327,m1203,20110609,3328,3337,3330,3341,3330,3333,3334,-4,-3,68,2267700,78
1328,m1203,20110610,3333,3334,3340,3340,3318,3318,3327,-16,-7,24,798540,86
1329,m1203,20110613,3318,3327,3326,3344,3326,3336,3337,9,10,52,1735720,80
1330,m1203,20110614,3336,3337,3335,3336,3334,3335,3335,-2,-2,10,333500,74
1331,m1203,20110615,3335,3335,3330,3334,3317,3327,3327,-8,-8,18,599000,82
1332,m1203,20110616,3327,3327,3315,3333,3315,3322,3323,-5,-4,42,1395880,86
1333,m1203,20110617,3322,3323,3307,3316,3281,3294,3293,-29,-30,78,2569300,84
1334,m1203,20110620,3294,3293,3271,3289,3271,3289,3284,-4,-9,100,3284540,82
1335,m1203,20110621,3289,3284,3301,3302,3292,3292,3297,8,13,14,461700,88
1336,m1203,20110622,3292,3297,3305,3305,3290,3290,3299,-7,2,8,263980,88
1337,m1203,20110623,3290,3299,3286,3294,3271,3292,3281,-7,-18,18,590720,86
1338,m1203,20110624,3292,3281,3230,3300,3230,3292,3279,11,-2,40,1311860,88
1339,m1203,20110627,3292,3279,3273,3275,3257,3265,3267,-14,-12,20,653400,86
1340,m1203,20110628,3265,3267,3297,3297,3270,3272,3283,5,16,20,656680,88
1341,m1203,20110629,3272,3283,3272,3272,3272,3272,3272,-11,-11,2,65440,86
1342,m1203,20110630,3272,3272,3305,3305,3288,3290,3290,18,18,24,789660,88
1343,m1203,20110701,3290,3290,3263,3284,3263,3282,3272,-8,-18,36,1177940,90
1344,m1203,20110704,3282,3272,3318,3318,3289,3291,3294,19,22,16,527080,86
1345,m1203,20110705,3291,3294,3302,3305,3287,3296,3298,2,4,60,1978860,84
1346,m1203,20110706,3296,3298,3287,3289,3287,3287,3287,-11,-11,6,197260,82
1347,m1203,20110707,3287,3287,3266,3296,3266,3290,3287,3,0,16,526040,80
1348,m1203,20110708,3290,3287,3310,3310,3301,3308,3306,21,19,18,595140,80
1349,m1203,20110711,3308,3306,3305,3329,3305,3325,3316,19,10,56,1857060,82
1350,m1203,20110712,3325,3316,3302,3320,3291,3303,3304,-13,-12,12,396540,84
1351,m1203,20110713,3303,3304,3322,3344,3322,3341,3335,37,31,24,800580,82
1352,m1203,20110714,3341,3335,3361,3377,3361,3370,3369,35,34,22,741200,80
1353,m1203,20110715,3370,3369,3365,3378,3365,3376,3370,7,1,20,674100,72
1354,m1203,20110718,3376,3370,3376,3409,3376,3388,3390,18,20,148,5018340,116
1355,m1203,20110719,3388,3390,3387,3404,3374,3404,3388,14,-2,70,2372100,76
1356,m1203,20110720,3404,3388,3388,3403,3367,3389,3386,1,-2,58,1963920,74
1357,m1203,20110721,3389,3386,3400,3408,3393,3406,3402,20,16,66,2245600,64
1358,m1203,20110722,3406,3402,3396,3409,3392,3406,3402,4,0,16,544320,64
1359,m1203,20110725,3406,3402,3403,3403,3353,3379,3381,-23,-21,26,879140,60
1360,m1203,20110726,3379,3381,3388,3399,3388,3399,3393,18,12,6,203620,60
1361,m1203,20110727,3399,3393,3437,3438,3437,3438,3437,45,44,4,137500,56
1362,m1203,20110728,3438,3437,3424,3424,3400,3415,3408,-22,-29,24,818080,64
1363,m1203,20110729,3415,3408,3386,3416,3386,3415,3408,7,0,16,545400,66
1364,m1203,20110801,3415,3408,3398,3402,3387,3402,3393,-6,-15,34,1153820,64
1365,m1203,20110802,3402,3393,3405,3405,3388,3389,3395,-4,2,10,339520,64
1366,m1203,20110803,3389,3395,3395,3399,3395,3399,3397,4,2,4,135880,60
1367,m1203,20110804,3399,3397,3376,3376,3376,3376,3376,-21,-21,2,67520,60
1368,m1203,20110805,3376,3376,3302,3317,3289,3291,3300,-85,-76,86,2838240,88
1369,m1203,20110808,3291,3300,3256,3289,3256,3289,3276,-11,-24,6,196560,86
1370,m1203,20110809,3289,3276,3222,3258,3215,3246,3229,-30,-47,60,1937440,82
1371,m1203,20110810,3246,3229,3288,3288,3278,3278,3279,49,50,14,459180,84
1372,m1203,20110811,3278,3279,3265,3292,3264,3291,3281,12,2,34,1115600,82
1373,m1203,20110812,3291,3281,3292,3312,3292,3301,3303,20,22,8,264300,82
1374,m1203,20110815,3301,3303,3333,3333,3314,3314,3317,11,14,14,464440,82
1375,m1203,20110816,3314,3317,3314,3334,3314,3317,3322,0,5,8,265820,82
1376,m1203,20110817,3317,3322,3311,3325,3311,3325,3318,3,-4,4,132720,82
1377,m1203,20110818,3325,3318,3325,3335,3325,3335,3330,17,12,4,133200,84
1378,m1203,20110819,3335,3330,3317,3329,3309,3321,3321,-9,-9,18,597840,82
1379,m1203,20110822,3321,3321,3350,3350,3350,3350,3350,29,29,2,67000,82
1380,m1203,20110823,3350,3350,3395,3395,3351,3358,3360,8,10,64,2150780,48
1381,m1203,20110824,3358,3360,3372,3372,3372,3372,3372,12,12,2,67440,46
1382,m1203,20110825,3372,3372,3351,3363,3351,3363,3358,-9,-14,24,805920,44
1383,m1203,20110826,3363,3358,3353,3373,3350,3352,3357,-6,-1,32,1074360,44
1384,m1203,20110829,3352,3357,3407,3413,3396,3413,3402,56,45,128,4355160,80
1385,m1203,20110830,3413,3402,3418,3418,3401,3401,3415,-1,13,12,409820,76
1386,m1203,20110831,3401,3415,3405,3452,3405,3423,3435,8,20,22,755840,76
1387,m1203,20110901,3423,3435,3412,3419,3409,3417,3414,-18,-21,12,409700,74
1388,m1203,20110902,3417,3414,3418,3418,3396,3408,3406,-6,-8,10,340620,74
1389,m1203,20110905,3408,3406,3416,3424,3403,3405,3412,-1,6,24,818920,78
1390,m1203,20110906,3405,3412,3397,3398,3369,3390,3383,-22,-29,22,744300,78
1391,m1203,20110907,3390,3383,3385,3405,3385,3404,3397,21,14,18,611520,70
1392,m1203,20110908,3404,3397,3395,3395,3387,3388,3389,-9,-8,8,271180,68
1393,m1203,20110909,3388,3389,3389,3393,3389,3393,3392,4,3,10,339200,66
1394,m1203,20110913,3393,3392,3347,3357,3330,3334,3343,-58,-49,40,1337200,68
1395,m1203,20110914,3334,3343,3337,3341,3293,3297,3317,-46,-26,28,928780,76
1396,m1203,20110915,3297,3317,3312,3313,3282,3305,3300,-12,-17,58,1914000,86
1397,m1203,20110916,3305,3300,3280,3302,3279,3288,3283,-12,-17,24,788140,80
1398,m1203,20110919,3288,3283,3266,3277,3253,3254,3259,-29,-24,44,1434020,82
1399,m1203,20110920,3254,3259,3248,3268,3247,3264,3257,5,-2,36,1172780,74
1400,m1203,20110921,3264,3257,3271,3271,3241,3256,3255,-1,-2,10,325520,80
1401,m1203,20110922,3256,3255,3223,3223,3193,3193,3208,-62,-47,26,834180,90
1402,m1203,20110923,3193,3208,3120,3156,3048,3094,3095,-114,-113,96,2971620,90
1403,m1203,20110926,3094,3095,3046,3075,2947,3002,3018,-93,-77,32,966000,98
1404,m1203,20110927,3002,3018,3032,3072,3032,3057,3051,39,33,20,610280,90
1405,m1203,20110928,3057,3051,3037,3037,2988,3035,3022,-16,-29,12,362720,86
1406,m1203,20110929,3035,3022,2934,2934,2934,2934,2934,-88,-88,2,58680,86
1407,m1203,20110930,2934,2934,2934,2997,2934,2996,2977,62,43,14,416780,84
1408,m1203,20111010,2996,2977,2977,2983,2921,2968,2973,-9,-4,72,2141000,98
1409,m1203,20111011,2968,2973,2991,2991,2954,2956,2973,-17,0,22,654200,102
1410,m1203,20111012,2956,2973,2972,3021,2972,3014,2992,41,19,72,2154340,82
1411,m1203,20111013,3014,2992,3012,3057,3012,3037,3042,45,50,44,1338840,82
1412,m1203,20111014,3037,3042,3048,3063,3045,3045,3052,3,10,6,183120,80
1413,m1203,20111017,3045,3052,3098,3098,3069,3069,3088,17,36,6,185300,82
1414,m1203,20111018,3069,3088,2991,3022,2991,3022,3008,-66,-80,8,240700,82
1415,m1203,20111019,3022,3008,3026,3026,3008,3016,3015,8,7,36,1085400,82
1416,m1203,20111020,3016,3015,2997,2997,2947,2958,2966,-57,-49,16,474660,80
1417,m1203,20111021,2958,2966,3000,3016,3000,3016,3006,50,40,18,541200,74
1418,m1203,20111024,3016,3006,2975,3059,2975,3044,3023,38,17,32,967580,76
1419,m1203,20111025,3044,3023,3030,3039,3029,3039,3034,16,11,12,364140,70
1420,m1203,20111026,3039,3034,3032,3032,3032,3032,3032,-2,-2,2,60640,70
1421,m1203,20111027,3032,3032,3039,3049,3026,3049,3037,17,5,24,728920,72
1422,m1203,20111028,3049,3037,3036,3057,3022,3028,3039,-9,2,34,1033520,68
1423,m1203,20111031,3028,3039,3056,3056,3005,3010,3015,-29,-24,32,965060,62
1424,m1203,20111101,3010,3015,3026,3026,3015,3015,3019,0,4,8,241580,64
1425,m1203,20111102,3015,3019,2999,3002,2988,3000,2994,-19,-25,18,539080,62
1426,m1203,20111103,3000,2994,2969,3003,2969,3001,2991,7,-3,28,837700,64
1427,m1203,20111104,3001,2991,3005,3025,2993,3009,3012,18,21,112,3373720,62
1428,m1203,20111107,3009,3012,3012,3012,2956,3000,2992,-12,-20,82,2453960,68
1429,m1203,20111108,3000,2992,2984,2993,2984,2984,2987,-8,-5,18,537760,76
1430,m1203,20111109,2984,2987,2986,2988,2979,2981,2983,-6,-4,10,298380,74
1431,m1203,20111110,2981,2983,2944,2962,2915,2941,2942,-42,-41,22,647260,78
1432,m1203,20111111,2941,2942,2921,2944,2921,2935,2934,-7,-8,66,1936780,84
1433,m1203,20111114,2935,2934,2941,2958,2936,2953,2946,19,12,46,1355500,84
1434,m1203,20111115,2953,2946,2931,2955,2921,2944,2938,-2,-8,62,1821960,82
1435,m1203,20111116,2944,2938,2938,2953,2933,2938,2942,0,4,46,1353580,84
1436,m1203,20111117,2938,2942,2942,2945,2909,2942,2935,0,-7,96,2818140,88
1437,m1203,20111118,2942,2935,2912,2915,2907,2909,2911,-26,-24,24,698680,86
1438,m1203,20111121,2909,2911,2914,2914,2904,2909,2907,-2,-4,10,290740,88
1439,m1203,20111122,2909,2907,2877,2881,2859,2859,2864,-48,-43,30,859460,84
1440,m1203,20111123,2859,2864,2872,2872,2828,2839,2844,-25,-20,20,568980,84
1441,m1203,20111124,2839,2844,2814,2815,2770,2772,2787,-72,-57,148,4126040,144
1442,m1203,20111125,2772,2787,2772,2786,2770,2785,2774,-2,-13,44,1220600,134
1443,m1203,20111128,2785,2774,2791,2804,2730,2787,2766,13,-8,266,7357820,164
1444,m1203,20111129,2787,2766,2782,2805,2753,2800,2793,34,27,116,3240960,124
1445,m1203,20111130,2800,2793,2790,2797,2776,2797,2787,4,-6,6,167260,124
1446,m1203,20111201,2797,2787,2887,2887,2789,2828,2829,41,42,34,961880,134
1447,m1203,20111202,2828,2829,2811,2825,2800,2818,2808,-11,-21,70,1965660,136
1448,m1203,20111205,2818,2808,2828,2828,2810,2816,2816,8,8,14,394240,140
1449,m1203,20111206,2816,2816,2794,2794,2783,2789,2790,-27,-26,18,502280,140
1450,m1203,20111207,2789,2790,2792,2808,2767,2793,2792,3,2,40,1116800,140
1451,m1203,20111208,2793,2792,2783,2813,2761,2772,2779,-20,-13,76,2112680,156
1452,m1203,20111209,2772,2779,2767,2783,2765,2783,2774,4,-5,34,943260,162
1453,m1203,20111212,2783,2774,2707,2767,2707,2753,2750,-21,-24,46,1265000,180
1454,m1203,20111213,2753,2750,2755,2769,2748,2756,2758,6,8,62,1710520,170
1455,m1203,20111214,2756,2758,2750,2753,2745,2745,2750,-13,-8,8,220000,168
1456,m1203,20111215,2745,2750,2748,2781,2739,2750,2748,0,-2,62,1704040,178
1457,m1203,20111216,2750,2748,2768,2780,2751,2763,2758,15,10,72,1986180,184
1458,m1203,20111219,2763,2758,2807,2807,2773,2794,2780,36,22,62,1723600,204
1459,m1203,20111220,2794,2780,2791,2791,2778,2782,2783,2,3,42,1168860,202
1460,m1203,20111221,2782,2783,2789,2805,2779,2788,2788,5,5,20,557760,206
1461,m1203,20111222,2788,2788,2797,2803,2790,2800,2794,12,6,70,1955900,192
1462,m1203,20111223,2800,2794,2805,2817,2794,2805,2801,11,7,100,2801800,206
1463,m1203,20111226,2805,2801,2801,2801,2789,2791,2794,-10,-7,118,3297360,162
1464,m1203,20111227,2791,2794,2793,2795,2793,2795,2794,1,0,10,279400,152
1465,m1203,20111228,2795,2794,2803,2849,2803,2845,2839,51,45,38,1078940,144
1466,m1203,20111229,2845,2839,2860,2870,2847,2864,2864,25,25,48,1375060,132
1467,m1203,20111230,2864,2864,2855,2898,2855,2898,2883,34,19,114,3287420,130
1468,m1205,20110518,3224,3232,3249,3249,3217,3217,3233,-15,1,41214,1332467680,105944
1469,m1205,20110519,3217,3233,3255,3256,3241,3244,3248,11,15,40976,1331235880,118466
1470,m1205,20110520,3244,3248,3250,3268,3245,3266,3256,18,8,44984,1464837360,137750
1471,m1205,20110523,3266,3256,3277,3287,3257,3259,3276,3,20,53152,1741262760,159108
1472,m1205,20110524,3259,3276,3268,3268,3257,3266,3263,-10,-13,30740,1003060400,171646
1473,m1205,20110525,3266,3263,3260,3267,3256,3261,3261,-2,-2,28502,929727740,178918
1474,m1205,20110526,3261,3261,3267,3290,3264,3285,3281,24,20,48880,1604062440,194006
1475,m1205,20110527,3285,3281,3291,3295,3279,3281,3286,0,5,42286,1389553760,201898
1476,m1205,20110530,3281,3286,3273,3305,3272,3288,3292,2,6,93750,3087086260,234376
1477,m1205,20110531,3288,3292,3288,3291,3274,3274,3280,-18,-12,52408,1719142880,255926
1478,m1205,20110601,3274,3280,3279,3281,3270,3271,3275,-9,-5,45836,1501548100,280010
1479,m1205,20110602,3271,3275,3278,3292,3274,3290,3283,15,8,60274,1979322540,287510
1480,m1205,20110603,3290,3283,3298,3309,3294,3300,3301,17,18,130642,4312936760,340494
1481,m1205,20110607,3300,3301,3279,3280,3264,3272,3271,-29,-30,68486,2240208800,364938
1482,m1205,20110608,3272,3271,3276,3284,3266,3277,3277,6,6,51782,1696916000,358316
1483,m1205,20110609,3277,3277,3291,3303,3286,3292,3295,15,18,98276,3239120380,356362
1484,m1205,20110610,3292,3295,3295,3296,3280,3284,3289,-11,-6,58570,1926699680,362440
1485,m1205,20110613,3284,3289,3280,3308,3280,3303,3298,14,9,103680,3420390520,382388
1486,m1205,20110614,3303,3298,3295,3307,3295,3305,3300,7,2,51928,1713827100,391474
1487,m1205,20110615,3305,3300,3289,3299,3289,3292,3293,-8,-7,99020,3260963680,422692
1488,m1205,20110616,3292,3293,3285,3299,3268,3269,3286,-24,-7,83136,2732379280,424108
1489,m1205,20110617,3269,3286,3268,3268,3237,3241,3250,-45,-36,79166,2573090740,432064
1490,m1205,20110620,3241,3250,3229,3241,3227,3230,3233,-20,-17,72482,2343926800,461350
1491,m1205,20110621,3230,3233,3238,3247,3235,3247,3241,14,8,62092,2012573200,478728
1492,m1205,20110622,3247,3241,3251,3252,3242,3246,3246,5,5,34132,1108202620,477108
1493,m1205,20110623,3246,3246,3229,3239,3217,3233,3228,-13,-18,90698,2928198080,474418
1494,m1205,20110624,3233,3228,3220,3251,3218,3243,3238,15,10,123238,3991535040,499456
1495,m1205,20110627,3243,3238,3226,3229,3192,3199,3211,-39,-27,131946,4237492500,523268
1496,m1205,20110628,3199,3211,3218,3228,3212,3218,3218,7,7,82160,2644717620,516314
1497,m1205,20110629,3218,3218,3235,3243,3227,3233,3235,15,17,71914,2326533960,517946
1498,m1205,20110630,3233,3235,3235,3248,3232,3247,3241,12,6,77956,2526950740,517292
1499,m1205,20110701,3247,3241,3202,3229,3202,3225,3218,-16,-23,90452,2911177300,537310
1500,m1205,20110704,3225,3218,3243,3255,3220,3247,3237,29,19,224784,7277066700,609976
1501,m1205,20110705,3247,3237,3248,3262,3237,3244,3249,7,12,195592,6356012200,645740
1502,m1205,20110706,3244,3249,3244,3255,3228,3246,3244,-3,-5,168260,5458701440,658992
1503,m1205,20110707,3246,3244,3246,3260,3241,3258,3251,14,7,204536,6649958580,688174
1504,m1205,20110708,3258,3251,3275,3285,3271,3284,3277,33,26,242814,7958976280,736740
1505,m1205,20110711,3284,3277,3289,3307,3283,3300,3296,23,19,340544,11225161080,798524
1506,m1205,20110712,3300,3296,3296,3296,3280,3288,3287,-8,-9,253784,8342423340,785818
1507,m1205,20110713,3288,3287,3310,3360,3308,3359,3339,72,52,611316,20415277680,948060
1508,m1205,20110714,3359,3339,3374,3393,3366,3381,3378,42,39,548696,18538720620,1002572
1509,m1205,20110715,3381,3378,3376,3391,3365,3385,3380,7,2,430540,14552489300,1030422
1510,m1205,20110718,3385,3380,3387,3413,3369,3372,3393,-8,13,650986,22094089020,1113158
1511,m1205,20110719,3372,3393,3380,3390,3366,3389,3381,-4,-12,400410,13539315560,1125520
1512,m1205,20110720,3389,3381,3388,3406,3375,3393,3392,12,11,666110,22597347800,1173074
1513,m1205,20110721,3393,3392,3385,3415,3377,3408,3400,16,8,671496,22837376020,1287062
1514,m1205,20110722,3408,3400,3416,3419,3401,3405,3408,5,8,344876,11755556080,1303618
1515,m1205,20110725,3405,3408,3390,3397,3360,3361,3378,-47,-30,526314,17780092240,1274934
1516,m1205,20110726,3361,3378,3362,3393,3361,3392,3380,14,2,365120,12342046280,1334780
1517,m1205,20110727,3392,3380,3405,3433,3402,3429,3423,49,43,599696,20533358500,1429854
1518,m1205,20110728,3429,3423,3402,3415,3396,3402,3404,-21,-19,432318,14719411000,1417490
1519,m1205,20110729,3402,3404,3392,3407,3373,3375,3394,-29,-10,551960,18736425020,1434644
1520,m1205,20110801,3375,3394,3380,3395,3380,3394,3388,0,-6,407272,13798670120,1509832
1521,m1205,20110802,3394,3388,3388,3396,3371,3373,3382,-15,-6,460840,15588260540,1492152
1522,m1205,20110803,3373,3382,3386,3395,3372,3373,3385,-9,3,375466,12709839600,1480042
1523,m1205,20110804,3373,3385,3365,3373,3340,3343,3352,-42,-33,505640,16953680800,1438784
1524,m1205,20110805,3343,3352,3299,3300,3185,3263,3258,-89,-94,763396,24873167680,1273080
1525,m1205,20110808,3263,3258,3245,3271,3234,3252,3253,-6,-5,515496,16771691220,1197152
1526,m1205,20110809,3252,3253,3190,3235,3150,3226,3197,-27,-56,778704,24895905660,1046812
1527,m1205,20110810,3226,3197,3248,3267,3245,3260,3259,63,62,410986,13395011480,1041780
1528,m1205,20110811,3260,3259,3241,3279,3241,3277,3266,18,7,511010,16692809920,1123094
1529,m1205,20110812,3277,3266,3302,3309,3280,3282,3293,16,27,343364,11307722820,1088000
1530,m1205,20110815,3282,3293,3307,3318,3301,3308,3309,15,16,360014,11914240760,1109598
1531,m1205,20110816,3308,3309,3315,3318,3285,3288,3301,-21,-8,283296,9352283760,1089660
1532,m1205,20110817,3288,3301,3299,3313,3295,3307,3306,6,5,253924,8395204900,1080874
1533,m1205,20110818,3307,3306,3318,3320,3305,3307,3311,1,5,192384,6370583120,1062588
1534,m1205,20110819,3307,3311,3281,3312,3281,3306,3300,-5,-11,322440,10642805840,1033212
1535,m1205,20110822,3306,3300,3325,3343,3322,3327,3332,27,32,370000,12330748240,1014554
1536,m1205,20110823,3327,3332,3359,3370,3346,3369,3354,37,22,393580,13200880400,1039608
1537,m1205,20110824,3369,3354,3372,3375,3348,3355,3358,1,4,338328,11363495340,1037286
1538,m1205,20110825,3355,3358,3349,3353,3335,3349,3343,-9,-15,267128,8931266020,1042032
1539,m1205,20110826,3349,3343,3358,3358,3330,3337,3343,-6,0,268714,8983612460,1036576
1540,m1205,20110829,3337,3343,3385,3425,3378,3416,3402,73,59,845450,28764791100,1118306
1541,m1205,20110830,3416,3402,3419,3427,3401,3408,3414,6,12,595428,20333792680,1036388
1542,m1205,20110831,3408,3414,3416,3444,3411,3423,3431,9,17,645146,22136697700,1076800
1543,m1205,20110901,3423,3431,3423,3426,3402,3407,3413,-24,-18,425350,14518935840,1089120
1544,m1205,20110902,3407,3413,3399,3409,3385,3406,3400,-7,-13,348654,11855305820,1074722
1545,m1205,20110905,3406,3400,3407,3436,3396,3400,3416,0,16,664826,22715728040,1063900
1546,m1205,20110906,3400,3416,3390,3395,3360,3378,3375,-38,-41,549430,18548517520,1052336
1547,m1205,20110907,3378,3375,3380,3404,3376,3402,3389,27,14,410378,13908426220,1094208
1548,m1205,20110908,3402,3389,3391,3395,3371,3373,3380,-16,-9,443954,15007804460,1132632
1549,m1205,20110909,3373,3380,3370,3386,3366,3385,3378,5,-2,362188,12237510440,1108648
1550,m1205,20110913,3385,3378,3350,3352,3315,3318,3326,-60,-52,539126,17936149340,1128996
1551,m1205,20110914,3318,3326,3320,3329,3271,3277,3297,-49,-29,566336,18672416600,1064426
1552,m1205,20110915,3277,3297,3283,3290,3268,3284,3282,-13,-15,322826,10596260460,1066122
1553,m1205,20110916,3284,3282,3252,3274,3251,3273,3261,-9,-21,363936,11871256940,1058630
1554,m1205,20110919,3273,3261,3255,3258,3218,3221,3233,-40,-28,365548,11819165460,1067352
1555,m1205,20110920,3221,3233,3238,3248,3230,3234,3240,1,7,404834,13117014860,1100070
1556,m1205,20110921,3234,3240,3221,3237,3203,3228,3222,-12,-18,381608,12298435000,1130502
1557,m1205,20110922,3228,3222,3174,3187,3130,3162,3168,-60,-54,507444,16077685300,1136678
1558,m1205,20110923,3162,3168,3110,3133,3015,3079,3085,-89,-83,864288,26666347680,971414
1559,m1205,20110926,3079,3085,3066,3083,2990,3012,3039,-73,-46,831574,25271709380,872218
1560,m1205,20110927,3012,3039,3079,3088,3059,3082,3073,43,34,449726,13821673280,857302
1561,m1205,20110928,3082,3073,3052,3055,3017,3041,3039,-32,-34,404660,12300027280,826642
1562,m1205,20110929,3041,3039,2950,2997,2927,2987,2970,-52,-69,487140,14471192820,716906
1563,m1205,20110930,2987,2970,3001,3036,3001,3030,3023,60,53,300284,9078389880,711774
1564,m1205,20111010,3030,3023,2935,2982,2932,2954,2960,-69,-63,598528,17722222640,858690
1565,m1205,20111011,2954,2960,2968,2985,2922,2929,2959,-31,-1,666018,19711765140,948682
1566,m1205,20111012,2929,2959,2989,3020,2964,3010,2993,51,34,893144,26740352600,833964
1567,m1205,20111013,3010,2993,3020,3035,3005,3025,3021,32,28,552994,16707543480,850242
1568,m1205,20111014,3025,3021,3055,3058,3036,3048,3047,27,26,425284,12959332800,823656
1569,m1205,20111017,3048,3047,3058,3060,3038,3042,3046,-5,-1,309556,9431558540,805526
1570,m1205,20111018,3042,3046,3022,3023,2982,2988,3001,-58,-45,420230,12613260320,771256
1571,m1205,20111019,2988,3001,3010,3022,2988,3007,3008,6,7,402946,12122483440,753410
1572,m1205,20111020,3007,3008,2961,2965,2929,2959,2945,-49,-63,581690,17132782320,715832
1573,m1205,20111021,2959,2945,2976,3009,2975,3006,2992,61,47,342452,10248648220,712782
1574,m1205,20111024,3006,2992,2996,3047,2981,3027,3013,35,21,675954,20372435240,736076
1575,m1205,20111025,3027,3013,3026,3044,3015,3022,3028,9,15,476082,14420512720,740266
1576,m1205,20111026,3022,3028,3013,3027,3003,3018,3015,-10,-13,286866,8650139500,727678
1577,m1205,20111027,3018,3015,3000,3046,3000,3041,3029,26,14,633022,19179657520,853948
1578,m1205,20111028,3041,3029,3060,3066,3014,3016,3036,-13,7,504514,15318240080,846088
1579,m1205,20111031,3016,3036,3010,3013,2966,2970,2984,-66,-52,382790,11424159660,848116
1580,m1205,20111101,2970,2984,2983,2993,2968,2973,2979,-11,-5,325686,9704965440,831036
1581,m1205,20111102,2973,2979,2950,2992,2947,2992,2965,13,-14,394638,11702297660,832346
1582,m1205,20111103,2992,2965,2968,2986,2960,2966,2970,1,5,434774,12916997980,856362
1583,m1205,20111104,2966,2970,2999,3007,2987,2996,2997,26,27,411652,12340369120,873220
1584,m1205,20111107,2996,2997,2992,2995,2958,2968,2970,-29,-27,311202,9244002980,821728
1585,m1205,20111108,2968,2970,2965,2968,2940,2953,2953,-17,-17,276682,8170774840,827206
1586,m1205,20111109,2953,2953,2964,2968,2948,2949,2957,-4,4,213784,6321880500,823402
1587,m1205,20111110,2949,2957,2918,2918,2873,2892,2898,-65,-59,421080,12205369620,805760
1588,m1205,20111111,2892,2898,2888,2906,2881,2890,2893,-8,-5,354018,10244801020,877284
1589,m1205,20111114,2890,2893,2910,2923,2899,2915,2911,22,18,452950,13188996660,897502
1590,m1205,20111115,2915,2911,2898,2928,2886,2908,2903,-3,-8,342962,9956485780,886938
1591,m1205,20111116,2908,2903,2922,2925,2884,2887,2901,-16,-2,302672,8782108920,898296
1592,m1205,20111117,2887,2901,2884,2903,2876,2889,2889,-12,-12,298272,8618384220,898860
1593,m1205,20111118,2889,2889,2851,2869,2850,2863,2861,-26,-28,192110,5497305640,889386
1594,m1205,20111121,2863,2861,2859,2871,2848,2850,2859,-11,-2,212142,6066901780,881342
1595,m1205,20111122,2850,2859,2829,2838,2796,2800,2812,-59,-47,468174,13167497540,910026
1596,m1205,20111123,2800,2812,2807,2811,2784,2795,2796,-17,-16,354264,9905886080,852056
1597,m1205,20111124,2795,2796,2780,2780,2738,2758,2759,-38,-37,462914,12774213100,811236
1598,m1205,20111125,2758,2759,2740,2767,2740,2757,2757,-2,-2,336802,9287146460,785210
1599,m1205,20111128,2757,2757,2775,2787,2772,2780,2779,23,22,245506,6824584660,751524
1600,m1205,20111129,2780,2779,2785,2799,2780,2795,2789,16,10,221286,6172342720,728948
1601,m1205,20111130,2795,2789,2798,2799,2770,2772,2781,-17,-8,167792,4667359020,713052
1602,m1205,20111201,2772,2781,2818,2840,2813,2830,2823,49,42,278598,7866724580,674204
1603,m1205,20111202,2830,2823,2816,2820,2803,2814,2811,-9,-12,157844,4437515140,686030
1604,m1205,20111205,2814,2811,2823,2823,2814,2817,2817,6,6,95072,2678992100,684082
1605,m1205,20111206,2817,2817,2800,2804,2784,2792,2791,-25,-26,116960,3265507480,694384
1606,m1205,20111207,2792,2791,2802,2810,2795,2809,2802,18,11,99578,2790617400,679466
1607,m1205,20111208,2809,2802,2800,2801,2776,2792,2788,-10,-14,169696,4732422960,683772
1608,m1205,20111209,2792,2788,2780,2799,2778,2795,2794,7,6,139420,3895549500,660440
1609,m1205,20111212,2795,2794,2770,2783,2758,2761,2771,-33,-23,127676,3537997280,664642
1610,m1205,20111213,2761,2771,2765,2778,2763,2767,2771,-4,0,103746,2875703380,638268
1611,m1205,20111214,2767,2771,2775,2776,2768,2774,2772,3,1,57262,1587748380,622928
1612,m1205,20111215,2774,2772,2749,2784,2745,2779,2768,7,-4,122080,3379386600,601564
1613,m1205,20111216,2779,2768,2785,2793,2779,2792,2784,24,16,78916,2197172920,593882
1614,m1205,20111219,2792,2784,2822,2831,2806,2830,2820,46,36,145058,4091721580,549198
1615,m1205,20111220,2830,2820,2830,2832,2818,2824,2824,4,4,82890,2341216640,516384
1616,m1205,20111221,2824,2824,2834,2841,2821,2821,2831,-3,7,63620,1801404960,495412
1617,m1205,20111222,2821,2831,2832,2842,2829,2839,2835,8,4,60266,1709004340,474408
1618,m1205,20111223,2839,2835,2840,2850,2839,2848,2845,13,10,44556,1268037760,456430
1619,m1205,20111226,2848,2845,2850,2851,2831,2833,2839,-12,-6,38052,1080563920,451528
1620,m1205,20111227,2833,2839,2833,2843,2827,2841,2838,2,-1,37630,1068233020,437414
1621,m1205,20111228,2841,2838,2868,2918,2865,2913,2898,75,60,168402,4880387660,378398
1622,m1205,20111229,2913,2898,2901,2916,2897,2899,2906,1,8,90060,2617650340,356518
1623,m1205,20111230,2899,2906,2900,2907,2890,2906,2900,0,-6,41070,1191387440,341754
1624,m1207,20110718,3388,3396,3410,3419,3396,3396,3409,0,13,78,2659060,32
1625,m1207,20110719,3396,3409,3402,3406,3387,3406,3400,-3,-9,14,476100,26
1626,m1207,20110720,3406,3400,3414,3430,3406,3412,3417,12,17,22,751880,26
1627,m1207,20110721,3412,3417,3414,3437,3414,3435,3427,18,10,42,1439620,38
1628,m1207,20110722,3435,3427,3438,3441,3432,3435,3437,8,10,18,618700,44
1629,m1207,20110725,3435,3437,3412,3424,3393,3395,3409,-42,-28,62,2113580,52
1630,m1207,20110726,3395,3409,3401,3422,3401,3422,3412,13,3,36,1228480,62
1631,m1207,20110727,3422,3412,3452,3459,3450,3450,3453,38,41,44,1519340,60
1632,m1207,20110728,3450,3453,3446,3446,3435,3440,3440,-13,-13,14,481640,60
1633,m1207,20110729,3440,3440,3433,3438,3403,3403,3428,-37,-12,72,2468340,76
1634,m1207,20110801,3403,3428,3420,3443,3415,3423,3423,-5,-5,196,6710920,92
1635,m1207,20110802,3423,3423,3432,3432,3408,3412,3417,-11,-6,38,1298740,108
1636,m1207,20110803,3412,3417,3425,3425,3410,3418,3417,1,0,38,1298640,102
1637,m1207,20110804,3418,3417,3391,3400,3380,3380,3388,-37,-29,66,2236180,128
1638,m1207,20110805,3380,3388,3331,3344,3223,3302,3293,-86,-95,148,4874140,134
1639,m1207,20110808,3302,3293,3306,3312,3290,3290,3299,-3,6,26,857880,140
1640,m1207,20110809,3290,3299,3222,3273,3172,3273,3230,-26,-69,34,1098400,136
1641,m1207,20110810,3273,3230,3298,3309,3290,3297,3299,67,69,74,2441380,136
1642,m1207,20110811,3297,3299,3317,3317,3284,3308,3306,9,7,12,396760,136
1643,m1207,20110812,3308,3306,3332,3332,3316,3327,3326,21,20,44,1463440,128
1644,m1207,20110815,3327,3326,3340,3355,3340,3347,3345,21,19,16,535320,128
1645,m1207,20110816,3347,3345,3330,3332,3323,3332,3328,-13,-17,14,466000,128
1646,m1207,20110817,3332,3328,3348,3348,3340,3340,3345,12,17,10,334500,128
1647,m1207,20110818,3340,3345,3343,3343,3340,3340,3341,-5,-4,4,133660,128
1648,m1207,20110819,3340,3341,3337,3350,3333,3336,3342,-5,1,32,1069480,132
1649,m1207,20110822,3336,3342,3360,3374,3356,3364,3366,22,24,44,1481080,106
1650,m1207,20110823,3364,3366,3366,3390,3366,3390,3373,24,7,20,674620,100
1651,m1207,20110824,3390,3373,3383,3383,3374,3382,3380,9,7,38,1284440,88
1652,m1207,20110825,3382,3380,3363,3373,3356,3365,3366,-15,-14,30,1009840,88
1653,m1207,20110826,3365,3366,3384,3384,3355,3364,3365,-2,-1,18,605720,90
1654,m1207,20110829,3364,3365,3360,3428,3360,3428,3399,63,34,58,1971700,78
1655,m1207,20110830,3428,3399,3401,3429,3401,3405,3417,6,18,22,751820,76
1656,m1207,20110831,3405,3417,3420,3448,3420,3427,3437,10,20,24,825080,80
1657,m1207,20110901,3427,3437,3422,3422,3404,3416,3414,-21,-23,48,1639080,80
1658,m1207,20110902,3416,3414,3401,3421,3391,3417,3409,3,-5,56,1909300,82
1659,m1207,20110905,3417,3409,3434,3438,3407,3407,3424,-2,15,34,1164360,84
1660,m1207,20110906,3407,3424,3407,3407,3369,3385,3389,-39,-35,84,2846820,104
1661,m1207,20110907,3385,3389,3397,3417,3390,3417,3399,28,10,44,1495900,104
1662,m1207,20110908,3417,3399,3399,3402,3387,3397,3394,-2,-5,24,814760,104
1663,m1207,20110909,3397,3394,3396,3396,3396,3396,3396,2,2,4,135840,100
1664,m1207,20110913,3396,3396,3363,3363,3334,3346,3349,-50,-47,108,3617940,102
1665,m1207,20110914,3346,3349,3341,3345,3306,3314,3326,-35,-23,50,1663480,102
1666,m1207,20110915,3314,3326,3306,3320,3306,3315,3314,-11,-12,28,928140,110
1667,m1207,20110916,3315,3314,3282,3315,3282,3306,3296,-8,-18,42,1384540,112
1668,m1207,20110919,3306,3296,3273,3273,3252,3255,3261,-41,-35,38,1239200,106
1669,m1207,20110920,3255,3261,3279,3288,3267,3271,3279,10,18,32,1049540,108
1670,m1207,20110921,3271,3279,3269,3269,3253,3264,3259,-15,-20,62,2021040,110
1671,m1207,20110922,3264,3259,3159,3230,3159,3191,3200,-68,-59,58,1856280,98
1672,m1207,20110923,3191,3200,3116,3178,3045,3120,3093,-80,-107,472,14602120,222
1673,m1207,20110926,3120,3093,3079,3112,3020,3050,3077,-43,-16,100,3077780,218
1674,m1207,20110927,3050,3077,3079,3079,3079,3079,3079,2,2,4,123160,214
1675,m1207,20110928,3079,3079,3040,3040,3040,3040,3040,-39,-39,10,304000,204
1676,m1207,20110929,3040,3040,3040,3040,2970,3029,3008,-11,-32,10,300800,204
1677,m1207,20110930,3029,3008,3053,3061,3041,3049,3055,41,47,30,916780,186
1678,m1207,20111010,3049,3055,3006,3024,2992,2992,3011,-63,-44,8,240920,188
1679,m1207,20111011,2992,3011,2980,3015,2961,2961,2985,-50,-26,22,656900,192
1680,m1207,20111012,2961,2985,2961,3038,2961,3027,3013,42,28,28,843820,190
1681,m1207,20111013,3027,3013,3054,3054,3021,3036,3039,23,26,16,486240,188
1682,m1207,20111014,3036,3039,3069,3089,3063,3089,3075,50,36,10,307540,186
1683,m1207,20111017,3089,3075,3061,3089,3061,3070,3072,-5,-3,8,245800,188
1684,m1207,20111018,3070,3072,3069,3069,3001,3001,3009,-71,-63,356,10715000,468
1685,m1207,20111019,3001,3009,3041,3041,3009,3015,3025,6,16,30,907740,472
1686,m1207,20111020,3015,3025,2946,2968,2934,2955,2952,-70,-73,56,1653480,482
1687,m1207,20111021,2955,2952,2975,3007,2975,3006,2997,54,45,58,1738820,502
1688,m1207,20111024,3006,2997,3006,3059,2987,3058,3024,61,27,464,14033100,324
1689,m1207,20111025,3058,3024,0,0,0,3024,3024,0,0,0,0,324
1690,m1207,20111026,3024,3024,3069,3069,3011,3045,3040,21,16,26,790600,318
1691,m1207,20111027,3045,3040,3040,3064,3040,3063,3051,23,11,32,976340,312
1692,m1207,20111028,3063,3051,3087,3087,3028,3028,3063,-23,12,14,428820,316
1693,m1207,20111031,3028,3063,3061,3061,3006,3006,3025,-57,-38,6,181520,316
1694,m1207,20111101,3006,3025,3017,3017,3010,3010,3012,-15,-13,6,180740,314
1695,m1207,20111102,3010,3012,2992,3003,2979,3003,2992,-9,-20,26,778040,308
1696,m1207,20111103,3003,2992,3010,3010,3001,3001,3007,9,15,6,180420,312
1697,m1207,20111104,3001,3007,3020,3025,3020,3024,3022,17,15,18,544060,312
1698,m1207,20111107,3024,3022,3007,3008,3006,3008,3007,-14,-15,6,180420,306
1699,m1207,20111108,3008,3007,2939,3002,2939,2991,2972,-16,-35,58,1724140,326
1700,m1207,20111109,2991,2972,2990,2991,2990,2991,2990,19,18,56,1674940,274
1701,m1207,20111110,2991,2990,2924,2941,2898,2923,2927,-67,-63,118,3454260,274
1702,m1207,20111111,2923,2927,2933,2933,2926,2926,2930,-1,3,30,879140,268
1703,m1207,20111114,2926,2930,2918,2940,2918,2940,2934,10,4,12,352120,260
1704,m1207,20111115,2940,2934,2929,2929,2929,2929,2929,-5,-5,2,58580,258
1705,m1207,20111116,2929,2929,2929,2943,2924,2924,2930,-5,1,8,234400,260
1706,m1207,20111117,2924,2930,2922,2930,2921,2925,2924,-5,-6,22,643460,256
1707,m1207,20111118,2925,2924,0,0,0,2924,2924,0,0,0,0,256
1708,m1207,20111121,2924,2924,2924,2924,2893,2894,2918,-30,-6,24,700540,272
1709,m1207,20111122,2894,2918,2859,2876,2851,2851,2859,-67,-59,18,514640,268
1710,m1207,20111123,2851,2859,2840,2849,2829,2829,2839,-30,-20,6,170360,266
1711,m1207,20111124,2829,2839,2791,2800,2785,2786,2792,-53,-47,24,670080,262
1712,m1207,20111125,2786,2792,2795,2795,2787,2790,2791,-2,-1,8,223340,262
1713,m1207,20111128,2790,2791,2830,2830,2813,2813,2819,22,28,10,281980,264
1714,m1207,20111129,2813,2819,2825,2829,2821,2829,2825,10,6,6,169500,264
1715,m1207,20111130,2829,2825,2838,2838,2809,2810,2822,-15,-3,24,677300,270
1716,m1207,20111201,2810,2822,2859,2868,2841,2856,2857,34,35,62,1771400,268
1717,m1207,20111202,2856,2857,2838,2845,2838,2845,2842,-12,-15,6,170560,272
1718,m1207,20111205,2845,2842,2844,2844,2843,2843,2843,1,1,12,341260,264
1719,m1207,20111206,2843,2843,2842,2842,2812,2825,2826,-18,-17,6,169580,266
1720,m1207,20111207,2825,2826,2832,2840,2828,2838,2834,12,8,12,340180,262
1721,m1207,20111208,2838,2834,2816,2820,2812,2820,2816,-14,-18,8,225280,264
1722,m1207,20111209,2820,2816,2829,2833,2829,2833,2831,17,15,6,169900,258
1723,m1207,20111212,2833,2831,2804,2818,2800,2803,2807,-28,-24,26,730060,254
1724,m1207,20111213,2803,2807,2802,2802,2798,2798,2800,-9,-7,12,336020,254
1725,m1207,20111214,2798,2800,2800,2805,2800,2805,2804,5,4,26,729200,234
1726,m1207,20111215,2805,2804,2773,2818,2773,2804,2795,0,-9,24,670840,224
1727,m1207,20111216,2804,2795,2803,2803,2802,2802,2802,7,7,4,112100,222
1728,m1207,20111219,2802,2802,2846,2846,2846,2846,2846,44,44,2,56920,220
1729,m1207,20111220,2846,2846,0,0,0,2846,2846,0,0,0,0,220
1730,m1207,20111221,2846,2846,0,0,0,2846,2846,0,0,0,0,220
1731,m1207,20111222,2846,2846,0,0,0,2846,2846,0,0,0,0,220
1732,m1207,20111223,2846,2846,2850,2873,2850,2872,2868,26,22,14,401520,220
1733,m1207,20111226,2872,2868,2862,2878,2858,2868,2872,0,4,38,1091480,204
1734,m1207,20111227,2868,2872,2881,2881,2881,2881,2881,9,9,2,57620,204
1735,m1207,20111228,2881,2881,2928,2952,2917,2943,2938,62,57,38,1116760,204
1736,m1207,20111229,2943,2938,2940,2953,2936,2937,2939,-1,1,18,529080,200
1737,m1207,20111230,2937,2939,2930,2932,2930,2932,2931,-7,-8,4,117240,198
1738,m1208,20110816,3340,3344,3359,3359,3359,3359,3359,15,15,2,67180,2
1739,m1208,20110817,3359,3359,0,0,0,3359,3359,0,0,0,0,2
1740,m1208,20110818,3359,3359,3338,3338,3319,3333,3327,-26,-32,8,266200,4
1741,m1208,20110819,3333,3327,3355,3355,3354,3354,3354,27,27,6,201280,2
1742,m1208,20110822,3354,3354,0,0,0,3354,3354,0,0,0,0,2
1743,m1208,20110823,3354,3354,3354,3363,3354,3363,3357,9,3,6,201420,6
1744,m1208,20110824,3363,3357,3360,3420,3360,3398,3384,41,27,18,609200,8
1745,m1208,20110825,3398,3384,0,0,0,3384,3384,0,0,0,0,8
1746,m1208,20110826,3384,3384,0,0,0,3384,3384,0,0,0,0,8
1747,m1208,20110829,3384,3384,3380,3428,3380,3414,3413,30,29,16,546120,8
1748,m1208,20110830,3414,3413,3429,3437,3404,3424,3419,11,6,18,615560,10
1749,m1208,20110831,3424,3419,3438,3458,3438,3440,3448,21,29,28,965600,20
1750,m1208,20110901,3440,3448,3441,3441,3441,3441,3441,-7,-7,2,68820,20
1751,m1208,20110902,3441,3441,3472,3472,3425,3429,3439,-12,-2,20,687800,18
1752,m1208,20110905,3429,3439,3457,3459,3435,3435,3442,-4,3,20,688480,28
1753,m1208,20110906,3435,3442,3413,3413,3401,3412,3408,-30,-34,26,886120,34
1754,m1208,20110907,3412,3408,3412,3433,3412,3433,3418,25,10,10,341880,34
1755,m1208,20110908,3433,3418,3412,3412,3396,3409,3408,-9,-10,26,886320,36
1756,m1208,20110909,3409,3408,3411,3411,3411,3411,3411,3,3,2,68220,36
1757,m1208,20110913,3411,3411,3399,3399,3356,3371,3377,-40,-34,8,270200,38
1758,m1208,20110914,3371,3377,3362,3366,3348,3348,3358,-29,-19,20,671640,42
1759,m1208,20110915,3348,3358,3331,3342,3330,3336,3336,-22,-22,10,333600,46
1760,m1208,20110916,3336,3336,3336,3336,3308,3314,3317,-22,-19,30,995300,46
1761,m1208,20110919,3314,3317,3314,3320,3278,3278,3297,-39,-20,20,659520,48
1762,m1208,20110920,3278,3297,3278,3290,3278,3290,3283,-7,-14,8,262700,44
1763,m1208,20110921,3290,3283,3273,3274,3262,3269,3267,-14,-16,22,718840,44
1764,m1208,20110922,3269,3267,3210,3210,3210,3210,3210,-57,-57,2,64200,44
1765,m1208,20110923,3210,3210,3220,3220,3080,3117,3131,-93,-79,50,1565940,50
1766,m1208,20110926,3117,3131,3078,3121,3031,3031,3080,-100,-51,20,616000,52
1767,m1208,20110927,3031,3080,3080,3131,3080,3131,3108,51,28,10,310860,48
1768,m1208,20110928,3131,3108,3079,3079,3079,3079,3079,-29,-29,2,61580,48
1769,m1208,20110929,3079,3079,2952,2952,2952,2952,2952,-127,-127,2,59040,46
1770,m1208,20110930,2952,2952,3076,3076,3036,3047,3058,95,106,10,305860,44
1771,m1208,20111010,3047,3058,3024,3024,3024,3024,3024,-34,-34,2,60480,46
1772,m1208,20111011,3024,3024,3001,3001,2971,2971,2986,-53,-38,8,238900,44
1773,m1208,20111012,2971,2986,3135,3135,2985,3035,3033,49,47,76,2305660,46
1774,m1208,20111013,3035,3033,3002,3069,3002,3062,3042,29,9,102,3103540,80
1775,m1208,20111014,3062,3042,3077,3080,3076,3080,3077,38,35,14,430840,72
1776,m1208,20111017,3080,3077,3086,3087,3061,3061,3078,-16,1,6,184680,72
1777,m1208,20111018,3061,3078,3031,3048,3011,3011,3032,-67,-46,14,424480,76
1778,m1208,20111019,3011,3032,3037,3044,3024,3026,3034,-6,2,18,546200,70
1779,m1208,20111020,3026,3034,3018,3018,2968,2986,2985,-48,-49,10,298500,70
1780,m1208,20111021,2986,2985,2998,3040,2998,3035,3025,50,40,12,363080,70
1781,m1208,20111024,3035,3025,3054,3085,3054,3073,3069,48,44,18,552500,66
1782,m1208,20111025,3073,3069,3064,3067,3057,3065,3064,-4,-5,18,551620,66
1783,m1208,20111026,3065,3064,3035,3046,3035,3046,3041,-18,-23,10,304140,64
1784,m1208,20111027,3046,3041,3069,3069,3052,3052,3062,11,21,8,244960,64
1785,m1208,20111028,3052,3062,3068,3075,3058,3058,3067,-4,5,14,429480,66
1786,m1208,20111031,3058,3067,3025,3025,2996,3020,3017,-47,-50,16,482760,60
1787,m1208,20111101,3020,3017,3013,3038,3011,3020,3023,3,6,14,423300,62
1788,m1208,20111102,3020,3023,3027,3027,2990,3017,3013,-6,-10,54,1627080,72
1789,m1208,20111103,3017,3013,3014,3020,3010,3010,3013,-3,0,12,361600,74
1790,m1208,20111104,3010,3013,3036,3045,3030,3034,3036,21,23,16,485860,70
1791,m1208,20111107,3034,3036,3045,3045,2999,3003,3013,-33,-23,42,1265720,76
1792,m1208,20111108,3003,3013,2991,3008,2991,3008,2997,-5,-16,16,479560,76
1793,m1208,20111109,3008,2997,3002,3030,3002,3002,3007,5,10,18,541420,74
1794,m1208,20111110,3002,3007,2946,2956,2934,2941,2942,-66,-65,38,1118320,60
1795,m1208,20111111,2941,2942,2940,2940,2938,2938,2938,-4,-4,6,176320,58
1796,m1208,20111114,2938,2938,2952,2957,2945,2957,2953,19,15,14,413440,58
1797,m1208,20111115,2957,2953,2942,2942,2942,2942,2942,-11,-11,2,58840,58
1798,m1208,20111116,2942,2942,0,0,0,2942,2942,0,0,0,0,58
1799,m1208,20111117,2942,2942,2911,2945,2911,2933,2932,-9,-10,8,234600,58
1800,m1208,20111118,2933,2932,2906,2913,2901,2901,2909,-31,-23,22,640060,56
1801,m1208,20111121,2901,2909,2930,2930,2895,2895,2910,-14,1,10,291080,56
1802,m1208,20111122,2895,2910,2890,2890,2841,2841,2859,-69,-51,58,1658780,66
1803,m1208,20111123,2841,2859,2831,2850,2831,2832,2836,-27,-23,12,340380,64
1804,m1208,20111124,2832,2836,2880,2880,2783,2801,2813,-35,-23,34,956660,70
1805,m1208,20111125,2801,2813,2812,2812,2794,2794,2801,-19,-12,6,168060,68
1806,m1208,20111128,2794,2801,2812,2830,2812,2817,2818,16,17,18,507340,66
1807,m1208,20111129,2817,2818,2800,2834,2800,2834,2815,16,-3,36,1013600,66
1808,m1208,20111130,2834,2815,2825,2825,2815,2815,2820,0,5,10,282020,66
1809,m1208,20111201,2815,2820,2850,2863,2848,2862,2852,42,32,42,1198180,52
1810,m1208,20111202,2862,2852,2844,2857,2835,2851,2846,-1,-6,22,626140,52
1811,m1208,20111205,2851,2846,2859,2859,2851,2851,2853,5,7,28,799100,46
1812,m1208,20111206,2851,2853,2836,2837,2835,2837,2836,-16,-17,12,340380,38
1813,m1208,20111207,2837,2836,2851,2851,2851,2851,2851,15,15,2,57020,38
1814,m1208,20111208,2851,2851,2820,2851,2820,2851,2835,0,-16,4,113420,38
1815,m1208,20111209,2851,2835,2823,2853,2823,2848,2843,13,8,14,398100,38
1816,m1208,20111212,2848,2843,2843,2847,2783,2810,2820,-33,-23,32,902660,40
1817,m1208,20111213,2810,2820,0,0,0,2820,2820,0,0,0,0,40
1818,m1208,20111214,2820,2820,2821,2821,2810,2810,2815,-10,-5,4,112620,42
1819,m1208,20111215,2810,2815,2807,2836,2797,2836,2813,21,-2,58,1631700,50
1820,m1208,20111216,2836,2813,2841,2841,2841,2841,2841,28,28,2,56820,50
1821,m1208,20111219,2841,2841,2850,2884,2844,2871,2871,30,30,16,459380,52
1822,m1208,20111220,2871,2871,2880,2884,2876,2878,2880,7,9,40,1152300,52
1823,m1208,20111221,2878,2880,2940,2940,2886,2893,2898,13,18,20,579640,52
1824,m1208,20111222,2893,2898,2888,2906,2888,2905,2898,7,0,12,347760,54
1825,m1208,20111223,2905,2898,2912,2924,2912,2913,2915,15,17,8,233220,54
1826,m1208,20111226,2913,2915,2919,2946,2894,2899,2909,-16,-6,20,581980,54
1827,m1208,20111227,2899,2909,2905,2905,2905,2905,2905,-4,-4,2,58100,52
1828,m1208,20111228,2905,2905,2967,2968,2927,2968,2955,63,50,60,1773220,66
1829,m1208,20111229,2968,2955,2967,2970,2961,2961,2965,6,10,8,237240,60
1830,m1208,20111230,2961,2965,2955,2968,2955,2964,2961,-1,-4,20,592220,60
1831,m1209,20110919,3283,3276,3276,3276,3234,3236,3249,-40,-27,21374,694604460,39464
1832,m1209,20110920,3236,3249,3249,3257,3241,3242,3247,-7,-2,27932,907184700,53926
1833,m1209,20110921,3242,3247,3235,3249,3219,3238,3230,-9,-17,36130,1167021280,65136
1834,m1209,20110922,3238,3230,3180,3200,3153,3182,3184,-48,-46,23334,743183880,68956
1835,m1209,20110923,3182,3184,3120,3149,3051,3099,3110,-85,-74,36072,1121954220,68958
1836,m1209,20110926,3099,3110,3099,3103,3023,3032,3072,-78,-38,33842,1039892960,74872
1837,m1209,20110927,3032,3072,3080,3113,3080,3106,3101,34,29,31510,977361120,77376
1838,m1209,20110928,3106,3101,3087,3087,3053,3067,3070,-34,-31,20182,619700040,76906
1839,m1209,20110929,3067,3070,2995,3050,2927,3015,3003,-55,-67,29452,884638000,74362
1840,m1209,20110930,3015,3003,3018,3069,3018,3065,3052,62,49,23140,706397880,74496
1841,m1209,20111010,3065,3052,3010,3025,2981,2985,3004,-67,-48,43394,1303710680,94046
1842,m1209,20111011,2985,3004,3006,3011,2950,2954,2990,-50,-14,71724,2144914880,127892
1843,m1209,20111012,2954,2990,3000,3033,2988,3029,3014,39,24,60446,1822414000,124646
1844,m1209,20111013,3029,3014,3023,3041,3023,3037,3034,23,20,30396,922232680,125900
1845,m1209,20111014,3037,3034,3052,3075,3052,3069,3062,35,28,19004,581979740,126030
1846,m1209,20111017,3069,3062,3072,3081,3063,3063,3069,1,7,15838,486079600,125620
1847,m1209,20111018,3063,3069,3040,3040,3000,3007,3018,-62,-51,30880,932006320,125550
1848,m1209,20111019,3007,3018,3025,3039,3016,3032,3028,14,10,33270,1007639180,117812
1849,m1209,20111020,3032,3028,2985,2994,2960,2992,2975,-36,-53,43744,1301744780,108104
1850,m1209,20111021,2992,2975,3003,3036,3003,3035,3021,60,46,17958,542612200,108012
1851,m1209,20111024,3035,3021,3033,3070,3011,3060,3047,39,26,34866,1062423200,112618
1852,m1209,20111025,3060,3047,3064,3069,3045,3054,3058,7,11,57850,1769457600,122600
1853,m1209,20111026,3054,3058,3045,3062,3033,3054,3046,-4,-12,30102,917091500,123484
1854,m1209,20111027,3054,3046,3035,3066,3035,3063,3055,17,9,63946,1953938780,148576
1855,m1209,20111028,3063,3055,3080,3087,3039,3041,3060,-14,5,47372,1449934320,155930
1856,m1209,20111031,3041,3060,3039,3042,3000,3010,3017,-50,-43,40284,1215416140,154360
1857,m1209,20111101,3010,3017,3015,3031,3008,3012,3019,-5,2,24516,740159380,155042
1858,m1209,20111102,3012,3019,3000,3025,2992,3025,3005,6,-14,46164,1387684180,162860
1859,m1209,20111103,3025,3005,3012,3014,2987,2992,2998,-13,-7,84160,2523554160,188716
1860,m1209,20111104,2992,2998,3025,3029,3012,3018,3018,20,20,68798,2076412540,202334
1861,m1209,20111107,3018,3018,3022,3022,2982,2990,2993,-28,-25,37906,1134835060,206594
1862,m1209,20111108,2990,2993,2980,2990,2966,2980,2976,-13,-17,35790,1065345480,209136
1863,m1209,20111109,2980,2976,2983,2990,2973,2975,2981,-1,5,27006,805282720,212704
1864,m1209,20111110,2975,2981,2933,2938,2906,2920,2922,-61,-59,75092,2194359180,199030
1865,m1209,20111111,2920,2922,2920,2930,2910,2916,2920,-6,-2,59246,1729999900,216660
1866,m1209,20111114,2916,2920,2926,2940,2920,2935,2932,15,12,96970,2843418940,242414
1867,m1209,20111115,2935,2932,2920,2943,2908,2933,2925,1,-7,55290,1617663840,245946
1868,m1209,20111116,2933,2925,2945,2947,2909,2912,2925,-13,0,66472,1944311960,241708
1869,m1209,20111117,2912,2925,2909,2925,2900,2912,2913,-13,-12,69500,2024580160,257102
1870,m1209,20111118,2912,2913,2880,2889,2874,2882,2882,-31,-31,109962,3169777320,277756
1871,m1209,20111121,2882,2882,2878,2890,2864,2871,2876,-11,-6,109972,3163858800,304964
1872,m1209,20111122,2871,2876,2850,2856,2817,2823,2836,-53,-40,138066,3915813020,328704
1873,m1209,20111123,2823,2836,2828,2831,2804,2812,2816,-24,-20,139954,3941404160,333732
1874,m1209,20111124,2812,2816,2786,2794,2749,2769,2772,-47,-44,178736,4955388540,375954
1875,m1209,20111125,2769,2772,2751,2786,2751,2769,2772,-3,0,108114,2997949620,367922
1876,m1209,20111128,2769,2772,2791,2803,2782,2788,2791,16,19,97598,2724478900,385386
1877,m1209,20111129,2788,2791,2800,2810,2788,2806,2798,15,7,104936,2936546120,390042
1878,m1209,20111130,2806,2798,2804,2808,2782,2783,2794,-15,-4,104082,2908304060,375222
1879,m1209,20111201,2783,2794,2833,2850,2822,2843,2836,49,42,133524,3787375800,378670
1880,m1209,20111202,2843,2836,2833,2834,2815,2825,2824,-11,-12,86692,2449040860,387730
1881,m1209,20111205,2825,2824,2833,2838,2828,2835,2832,11,8,71358,2021324420,400014
1882,m1209,20111206,2835,2832,2818,2818,2806,2815,2812,-17,-20,77666,2184033360,415948
1883,m1209,20111207,2815,2812,2823,2830,2817,2828,2824,16,12,53962,1523955120,423064
1884,m1209,20111208,2828,2824,2818,2829,2807,2821,2818,-3,-6,101764,2868245120,426346
1885,m1209,20111209,2821,2818,2815,2846,2811,2832,2835,14,17,224746,6372926640,472194
1886,m1209,20111212,2832,2835,2812,2824,2788,2789,2808,-46,-27,219850,6173408480,502638
1887,m1209,20111213,2789,2808,2791,2804,2785,2787,2795,-21,-13,192808,5389745900,500106
1888,m1209,20111214,2787,2795,2788,2802,2787,2800,2796,5,1,122680,3430793740,490810
1889,m1209,20111215,2800,2796,2778,2820,2772,2813,2800,17,4,291922,8174291680,508636
1890,m1209,20111216,2813,2800,2816,2832,2813,2831,2821,31,21,225202,6353895340,511356
1891,m1209,20111219,2831,2821,2846,2874,2841,2869,2858,48,37,414386,11845452320,531366
1892,m1209,20111220,2869,2858,2869,2872,2853,2865,2863,7,5,279392,8000312200,540546
1893,m1209,20111221,2865,2863,2876,2884,2857,2858,2869,-5,6,268422,7703599600,547714
1894,m1209,20111222,2858,2869,2866,2878,2864,2877,2872,8,3,242276,6960575180,534358
1895,m1209,20111223,2877,2872,2880,2895,2877,2892,2888,20,16,208764,6030001320,526582
1896,m1209,20111226,2892,2888,2894,2896,2879,2883,2886,-5,-2,177998,5138487440,525034
1897,m1209,20111227,2883,2886,2885,2891,2879,2884,2884,-2,-2,173780,5012419200,533026
1898,m1209,20111228,2884,2884,2915,2950,2911,2948,2935,64,51,445308,13071393180,552604
1899,m1209,20111229,2948,2935,2937,2957,2935,2944,2948,9,13,329594,9717740340,533466
1900,m1209,20111230,2944,2948,2943,2951,2937,2951,2945,3,-3,204226,6014979980,495042
1901,m1211,20111116,2938,2953,2930,2930,2930,2930,2930,-23,-23,2,58600,6
1902,m1211,20111117,2930,2930,2940,2940,2940,2940,2940,10,10,2,58800,6
1903,m1211,20111118,2940,2940,2910,2910,2883,2910,2902,-30,-38,16,464460,6
1904,m1211,20111121,2910,2902,0,0,0,2902,2902,0,0,0,0,6
1905,m1211,20111122,2902,2902,2832,2832,2832,2832,2832,-70,-70,2,56640,4
1906,m1211,20111123,2832,2832,2838,2838,2838,2838,2838,6,6,2,56760,6
1907,m1211,20111124,2838,2838,2796,2796,2760,2777,2775,-61,-63,8,222060,6
1908,m1211,20111125,2777,2775,0,0,0,2775,2775,0,0,0,0,6
1909,m1211,20111128,2775,2775,0,0,0,2775,2775,0,0,0,0,6
1910,m1211,20111129,2775,2775,0,0,0,2775,2775,0,0,0,0,6
1911,m1211,20111130,2775,2775,2818,2818,2775,2814,2802,39,27,6,168140,8
1912,m1211,20111201,2814,2802,2890,2890,2855,2860,2870,58,68,12,344400,12
1913,m1211,20111202,2860,2870,2900,2900,2769,2836,2839,-34,-31,28,794940,22
1914,m1211,20111205,2836,2839,2842,2842,2832,2832,2837,-7,-2,4,113480,26
1915,m1211,20111206,2832,2837,2831,2834,2820,2834,2829,-3,-8,12,339580,34
1916,m1211,20111207,2834,2829,2834,2840,2834,2838,2836,9,7,14,397160,28
1917,m1211,20111208,2838,2836,2825,2844,2825,2838,2834,2,-2,14,396840,32
1918,m1211,20111209,2838,2834,2828,2848,2828,2841,2841,7,7,18,511440,26
1919,m1211,20111212,2841,2841,2813,2813,2813,2813,2813,-28,-28,2,56260,24
1920,m1211,20111213,2813,2813,2815,2815,2804,2804,2806,-9,-7,8,224540,26
1921,m1211,20111214,2804,2806,2814,2814,2814,2814,2814,8,8,2,56280,28
1922,m1211,20111215,2814,2814,2818,2819,2801,2819,2811,5,-3,20,562340,36
1923,m1211,20111216,2819,2811,2870,2870,2814,2855,2841,44,30,30,852380,48
1924,m1211,20111219,2855,2841,2856,2900,2856,2900,2885,59,44,70,2019740,92
1925,m1211,20111220,2900,2885,2893,2895,2888,2890,2892,5,7,12,347120,100
1926,m1211,20111221,2890,2892,2965,2965,2896,2901,2908,9,16,40,1163480,122
1927,m1211,20111222,2901,2908,2912,2914,2911,2911,2912,3,4,6,174740,124
1928,m1211,20111223,2911,2912,2924,2925,2920,2925,2923,13,11,16,467820,128
1929,m1211,20111226,2925,2923,2916,2928,2916,2926,2923,3,0,12,350780,124
1930,m1211,20111227,2926,2923,2926,2926,2919,2926,2923,3,0,6,175420,126
1931,m1211,20111228,2926,2923,2965,2988,2965,2988,2976,65,53,18,535740,132
1932,m1211,20111229,2988,2976,2986,2995,2955,2983,2982,7,6,120,3579560,158
1933,m1211,20111230,2983,2982,0,0,0,2982,2982,0,0,0,0,158
1934,m1212,20111216,2823,2809,2880,2949,2802,2860,2856,51,47,54,1542540,30
1935,m1212,20111219,2860,2856,2890,2910,2880,2910,2898,54,42,20,579600,38
1936,m1212,20111220,2910,2898,2892,2913,2892,2913,2906,15,8,16,465000,44
1937,m1212,20111221,2913,2906,2919,2919,2919,2919,2919,13,13,2,58380,46
1938,m1212,20111222,2919,2919,2918,2925,2917,2925,2922,6,3,10,292200,50
1939,m1212,20111223,2925,2922,2941,2952,2941,2951,2946,29,24,14,412560,58
1940,m1212,20111226,2951,2946,2947,2947,2930,2930,2942,-16,-4,10,294240,56
1941,m1212,20111227,2930,2942,2975,2975,2945,2945,2955,3,13,6,177300,56
1942,m1212,20111228,2945,2955,2992,2992,2992,2992,2992,37,37,4,119680,56
1943,m1212,20111229,2992,2992,3012,3013,3009,3009,3011,17,19,28,843300,66
1944,m1212,20111230,3009,3011,2999,2999,2990,2990,2994,-21,-17,4,119780,64
