ROWNUM,合约,日期,前收盘价,前结算价,开盘价,最高价,最低价,收盘价,结算价,涨跌1,涨跌2,成交量,成交金额,持仓量
1,m1701,20170103,3026,3053,2922,3087,2919,3011,3028,-42,-25,3840,116281920,10790
2,m1701,20170104,3011,3028,3018,3048,3013,3020,3020,-8,-8,734,22172200,10184
3,m1701,20170105,3020,3020,2961,3047,2961,2990,2997,-30,-23,618,18523500,9574
4,m1701,20170106,2990,2997,3000,3037,2978,3029,3026,32,29,2588,78324180,8702
5,m1701,20170109,3029,3026,2968,3021,2968,3000,3002,-26,-24,1240,37233680,8396
6,m1701,20170110,3000,3002,2990,2999,2980,2999,2997,-3,-5,3664,109841400,6850
7,m1701,20170111,2999,2997,3090,3090,2967,2970,3069,-27,72,1010,31006860,6088
8,m1701,20170112,2970,3069,2969,3020,2969,3000,3009,-69,-60,68,2046180,6088
9,m1701,20170113,3000,3009,2969,3030,2950,2998,3001,-11,-8,208,6242900,6088
10,m1701,20170116,2998,3001,2979,3038,2979,3000,3017,-1,16,472,14129000,0
11,m1703,20170103,3080,3097,3090,3090,3090,3090,3090,-7,-7,2,61800,114
12,m1703,20170104,3090,3090,3057,3065,3035,3035,3042,-55,-48,16,486720,114
13,m1703,20170105,3035,3042,3035,3058,3030,3058,3038,16,-4,8,243060,118
14,m1703,20170106,3058,3038,2977,2977,2977,2977,2977,-61,-61,2,59540,118
15,m1703,20170109,2977,2977,3047,3047,2967,2970,2979,-7,2,14,417080,108
16,m1703,20170110,2970,2979,2928,2928,2928,2928,2928,-51,-51,2,58560,110
17,m1703,20170111,2928,2928,3033,3033,2971,2971,3003,43,75,8,240260,108
18,m1703,20170112,2971,3003,3005,3006,2994,3002,3000,-1,-3,18,540000,108
19,m1703,20170113,3002,3000,3039,3094,3029,3092,3071,92,71,16,491500,106
20,m1703,20170116,3092,3071,3039,3039,3037,3037,3038,-34,-33,20,607660,124
21,m1703,20170117,3037,3038,3100,3100,3040,3097,3073,59,35,22,676120,118
22,m1703,20170118,3097,3073,0,0,0,3080,3080,7,7,0,0,118
23,m1703,20170119,3080,3080,3044,3044,3044,3044,3044,-36,-36,6,182640,114
24,m1703,20170120,3044,3044,3071,3071,3033,3033,3058,-11,14,6,183500,112
25,m1703,20170123,3033,3058,3047,3086,2945,3079,3044,21,-14,14,426240,112
26,m1703,20170124,3079,3044,3070,3150,3054,3150,3114,106,70,22,685180,108
27,m1703,20170125,3150,3114,3116,3163,3084,3084,3118,-30,4,10,311820,106
28,m1703,20170126,3084,3118,3194,3194,3114,3114,3171,-4,53,40,1268420,82
29,m1703,20170203,3114,3171,3063,3063,3000,3000,3005,-171,-166,62,1863260,88
30,m1703,20170206,3000,3005,3060,3124,3014,3060,3058,55,53,10,305820,90
31,m1703,20170207,3060,3058,3056,3056,3056,3056,3056,-2,-2,2,61120,90
32,m1703,20170208,3056,3056,3119,3120,3052,3119,3108,63,52,22,683780,74
33,m1703,20170209,3119,3108,3134,3134,3134,3134,3134,26,26,2,62680,74
34,m1703,20170210,3134,3134,3110,3110,3046,3055,3065,-79,-69,46,1410300,72
35,m1703,20170213,3055,3065,3115,3115,3055,3055,3075,-10,10,6,184500,72
36,m1703,20170214,3055,3075,3061,3061,2981,3022,3026,-53,-49,22,665880,70
37,m1703,20170215,3022,3026,3022,3029,3021,3021,3023,-5,-3,22,665200,48
38,m1703,20170216,3021,3023,3029,3053,2995,3051,3032,28,9,54,1637600,22
39,m1703,20170217,3051,3032,2993,3040,2993,3040,3016,8,-16,4,120660,18
40,m1703,20170220,3040,3016,2961,3044,2961,2993,3001,-23,-15,14,420160,12
41,m1703,20170221,2993,3001,2995,2995,2951,2951,2965,-50,-36,6,177940,10
42,m1703,20170222,2951,2965,2995,2995,2950,2950,2972,-15,7,4,118900,10
43,m1703,20170223,2950,2972,3041,3041,3041,3041,3041,69,69,2,60820,10
44,m1703,20170224,3041,3041,3064,3064,2929,2987,2979,-54,-62,16,476780,14
45,m1703,20170227,2987,2979,3029,3029,2962,2985,2989,6,10,12,358720,12
46,m1703,20170228,2985,2989,2989,3110,2903,3110,2978,121,-11,24,714880,0
47,m1703,20170301,3110,2978,0,0,0,2978,2978,0,0,0,0,0
48,m1703,20170302,2978,2978,0,0,0,2978,2978,0,0,0,0,0
49,m1703,20170303,2978,2978,0,0,0,2978,2978,0,0,0,0,0
50,m1703,20170306,2978,2978,0,0,0,2978,2978,0,0,0,0,0
51,m1703,20170307,2978,2978,0,0,0,2978,2978,0,0,0,0,0
52,m1703,20170308,2978,2978,0,0,0,2978,2978,0,0,0,0,0
53,m1703,20170309,2978,2978,0,0,0,2978,2978,0,0,0,0,0
54,m1703,20170310,2978,2978,0,0,0,2978,2978,0,0,0,0,0
55,m1703,20170313,2978,2978,0,0,0,2978,2978,0,0,0,0,0
56,m1703,20170314,2978,2978,0,0,0,2978,2978,0,0,0,0,0
57,m1705,20170103,2803,2812,2796,2811,2769,2773,2787,-39,-25,809118,22556692560,2269460
58,m1705,20170104,2773,2787,2775,2796,2756,2792,2780,5,-7,1290250,35877748840,2191136
59,m1705,20170105,2792,2780,2790,2818,2776,2786,2798,6,18,1134786,31753948920,2204112
60,m1705,20170106,2786,2798,2786,2802,2773,2791,2785,-7,-13,863538,24051694880,2197806
61,m1705,20170109,2791,2785,2790,2807,2761,2775,2779,-10,-6,1293632,35957613900,2251342
62,m1705,20170110,2775,2779,2775,2794,2754,2778,2772,-1,-7,1272818,35286924820,2266272
63,m1705,20170111,2778,2772,2774,2836,2773,2824,2810,52,38,1997404,56128773680,2287546
64,m1705,20170112,2824,2810,2820,2832,2800,2808,2817,-2,7,1103476,31091076360,2316562
65,m1705,20170113,2808,2817,2811,2889,2809,2871,2859,54,42,1638226,46838098200,2288442
66,m1705,20170116,2871,2859,2873,2913,2863,2909,2890,50,31,1353330,39123506120,2245840
67,m1705,20170117,2909,2890,2917,2952,2896,2922,2924,32,34,1493336,43668235600,2173016
68,m1705,20170118,2922,2924,2927,2956,2909,2936,2931,12,7,1788652,52431335620,2207064
69,m1705,20170119,2936,2931,2933,2971,2927,2967,2950,36,19,1487892,43896509520,2199494
70,m1705,20170120,2967,2950,2966,2967,2926,2929,2945,-21,-5,1081220,31850989240,2077056
71,m1705,20170123,2929,2945,2932,2948,2915,2935,2929,-10,-16,967394,28336575760,2020200
72,m1705,20170124,2935,2929,2930,2944,2917,2939,2932,10,3,795134,23314921160,2006794
73,m1705,20170125,2939,2932,2938,2938,2881,2882,2901,-50,-31,1093450,31727521940,1917380
74,m1705,20170126,2882,2901,2885,2924,2885,2913,2908,12,7,705932,20532002780,1857588
75,m1705,20170203,2913,2908,2887,2912,2851,2889,2889,-19,-19,630506,18216953080,1873050
76,m1705,20170206,2889,2889,2888,2934,2886,2921,2911,32,22,1596652,46479837780,2157850
77,m1705,20170207,2921,2911,2924,2936,2912,2916,2921,5,10,892698,26075901040,2201328
78,m1705,20170208,2916,2921,2914,2967,2896,2965,2939,44,18,1437878,42266454480,2332566
79,m1705,20170209,2965,2939,2968,2985,2955,2964,2970,25,31,1177440,34971577980,2284898
80,m1705,20170210,2964,2970,2963,2999,2957,2997,2975,27,5,1178690,35072730240,2323924
81,m1705,20170213,2997,2975,2996,3028,2976,2985,3002,10,27,1524206,45761336920,2311794
82,m1705,20170214,2985,3002,2986,3008,2951,2956,2980,-46,-22,1229388,36644233000,2272244
83,m1705,20170215,2956,2980,2964,2968,2933,2937,2948,-43,-32,1147160,33826385780,2258876
84,m1705,20170216,2937,2948,2931,2990,2921,2955,2963,7,15,1507112,44667095820,2168468
85,m1705,20170217,2955,2963,2955,2985,2892,2906,2938,-57,-25,2028018,59602800860,2011988
86,m1705,20170220,2906,2938,2907,2924,2901,2916,2912,-22,-26,879368,25615764480,1972062
87,m1705,20170221,2916,2912,2917,2970,2914,2955,2945,43,33,1389894,40938170340,1966262
88,m1705,20170222,2955,2945,2955,2962,2906,2914,2931,-31,-14,1152724,33790470000,1934580
89,m1705,20170223,2914,2931,2919,2929,2877,2880,2904,-51,-27,1305428,37918244680,1874894
90,m1705,20170224,2880,2904,2880,2886,2852,2878,2871,-26,-33,1089774,31292780720,1834364
91,m1705,20170227,2878,2871,2880,2895,2865,2890,2882,19,11,965244,27827839220,1848434
92,m1705,20170228,2890,2882,2893,2899,2873,2881,2884,-1,2,934378,26955662640,1841310
93,m1705,20170301,2881,2884,2882,2932,2878,2909,2909,25,25,1570740,45696209600,1762774
94,m1705,20170302,2909,2909,2916,2950,2909,2945,2930,36,21,1074142,31477886800,1736892
95,m1705,20170303,2945,2930,2940,2943,2913,2933,2926,3,-4,893762,26156980400,1732534
96,m1705,20170306,2933,2926,2934,2965,2919,2962,2944,36,18,1235364,36376998480,1791880
97,m1705,20170307,2962,2944,2960,2970,2946,2951,2955,7,11,992444,29336073580,1752380
98,m1705,20170308,2951,2955,2948,2951,2900,2903,2919,-52,-36,1220056,35621952660,1664476
99,m1705,20170309,2903,2919,2900,2909,2887,2898,2898,-21,-21,985134,28557167940,1644378
100,m1705,20170310,2898,2898,2891,2901,2857,2860,2877,-38,-21,1174750,33807799260,1615210
101,m1705,20170313,2860,2877,2863,2884,2853,2874,2868,-3,-9,914456,26227215580,1544892
102,m1705,20170314,2874,2868,2872,2890,2839,2844,2861,-24,-7,1203478,34440813860,1530920
103,m1705,20170315,2844,2861,2840,2886,2825,2871,2859,10,-2,1161044,33202346940,1436080
104,m1705,20170316,2871,2859,2875,2885,2848,2864,2866,5,7,793424,22744437920,1438896
105,m1705,20170317,2864,2866,2869,2873,2836,2851,2851,-15,-15,812200,23158627980,1402864
106,m1705,20170320,2851,2851,2848,2895,2839,2891,2871,40,20,900660,25861363080,1359368
107,m1705,20170321,2891,2871,2891,2894,2851,2855,2873,-16,2,555812,15968978800,1306464
108,m1705,20170322,2855,2873,2855,2862,2835,2854,2850,-19,-23,448720,12790612440,1251638
109,m1705,20170323,2854,2850,2851,2858,2813,2815,2834,-35,-16,604476,17134594320,1153286
110,m1705,20170324,2815,2834,2817,2833,2798,2804,2810,-30,-24,333708,9378902480,1103488
111,m1705,20170327,2804,2810,2807,2810,2776,2798,2793,-12,-17,307512,8589464520,1046152
112,m1705,20170328,2798,2793,2795,2806,2785,2792,2795,-1,2,238886,6677371460,984900
113,m1705,20170329,2792,2795,2797,2809,2780,2801,2793,6,-2,212724,5942603040,917586
114,m1705,20170330,2801,2793,2798,2805,2766,2780,2780,-13,-13,236786,6583409640,859622
115,m1705,20170331,2780,2780,2771,2789,2762,2780,2778,0,-2,154528,4293024400,803518
116,m1705,20170405,2780,2778,2750,2800,2733,2757,2748,-21,-30,184578,5072701260,726740
117,m1705,20170406,2757,2748,2759,2791,2754,2779,2763,31,15,232710,6431555000,622546
118,m1705,20170407,2779,2763,2780,2786,2750,2757,2768,-6,5,233872,6474579060,525096
119,m1705,20170410,2757,2768,2762,2798,2761,2797,2778,29,10,141744,3938632980,474912
120,m1705,20170411,2797,2778,2810,2816,2792,2810,2802,32,24,134478,3769266080,410240
121,m1705,20170412,2810,2802,2810,2850,2790,2839,2828,37,26,144876,4098288940,356028
122,m1705,20170413,2839,2828,2842,2877,2833,2871,2853,43,25,101312,2891209700,316430
123,m1705,20170414,2871,2853,2872,2876,2858,2864,2868,11,15,110388,3166074760,263206
124,m1705,20170417,2864,2868,2860,2884,2851,2861,2863,-7,-5,83078,2378918380,228816
125,m1705,20170418,2861,2863,2865,2869,2847,2853,2856,-10,-7,54758,1564063400,202178
126,m1705,20170419,2853,2856,2853,2881,2831,2881,2855,25,-1,67036,1914046440,167440
127,m1705,20170420,2881,2855,2871,2903,2863,2888,2883,33,28,51914,1497149760,143156
128,m1705,20170421,2888,2883,2899,2899,2871,2888,2882,5,-1,54516,1571297940,112442
129,m1705,20170424,2888,2882,2888,2917,2872,2907,2904,25,22,69914,2030390060,73886
130,m1705,20170425,2907,2904,2911,2915,2900,2909,2906,5,2,43710,1270623900,48944
131,m1705,20170426,2909,2906,2905,2910,2860,2866,2889,-40,-17,27702,800544180,33640
132,m1705,20170427,2866,2889,2864,2892,2841,2841,2867,-48,-22,27676,793589500,22250
133,m1705,20170428,2841,2867,2840,2864,2797,2851,2834,-16,-33,25698,728471460,8916
134,m1705,20170502,2851,2834,2716,2931,2716,2931,2888,97,54,3078,88895300,4932
135,m1705,20170503,2931,2888,2931,2952,2867,2880,2904,-8,16,274,7958240,2582
136,m1705,20170504,2880,2904,2880,2910,2872,2910,2887,6,-17,826,23850720,3016
137,m1705,20170505,2910,2887,0,0,0,2887,2887,0,0,0,0,3008
138,m1705,20170508,2887,2887,2835,2881,2835,2871,2857,-16,-30,14,399980,3006
139,m1705,20170509,2871,2857,2859,2860,2840,2840,2856,-17,-1,212,6055920,3006
140,m1705,20170510,2840,2856,2846,2846,2846,2846,2846,-10,-10,20,569200,3006
141,m1705,20170511,2846,2846,2839,2839,2839,2839,2839,-7,-7,120,3406800,3006
142,m1705,20170512,2839,2839,2830,2830,2830,2830,2830,-9,-9,2520,71316000,3006
143,m1705,20170515,2830,2830,0,0,0,2865,2865,35,35,486,13923900,0
144,m1707,20170103,2786,2822,2813,2813,2794,2794,2804,-28,-18,34,953520,164
145,m1707,20170104,2794,2804,2791,2834,2786,2834,2795,30,-9,40,1118380,170
146,m1707,20170105,2834,2795,2800,2806,2797,2806,2801,11,6,6,168060,168
147,m1707,20170106,2806,2801,2796,2810,2796,2810,2801,9,0,18,504240,160
148,m1707,20170109,2810,2801,2790,2817,2771,2780,2800,-21,-1,72,2016660,158
149,m1707,20170110,2780,2800,2791,2805,2791,2805,2798,5,-2,4,111920,156
150,m1707,20170111,2805,2798,2798,2846,2798,2846,2816,48,18,8,225340,154
151,m1707,20170112,2846,2816,2837,2856,2820,2826,2835,10,19,38,1077300,144
152,m1707,20170113,2826,2835,2808,2892,2808,2889,2868,54,33,8,229460,142
153,m1707,20170116,2889,2868,2881,2924,2881,2921,2903,53,35,24,696820,140
154,m1707,20170117,2921,2903,2917,2958,2915,2934,2935,31,32,58,1702860,140
155,m1707,20170118,2934,2935,2918,2953,2918,2951,2930,16,-5,46,1348080,146
156,m1707,20170119,2951,2930,2963,2978,2945,2978,2972,48,42,28,832260,138
157,m1707,20170120,2978,2972,2961,2982,2943,2951,2965,-21,-7,78,2313320,146
158,m1707,20170123,2951,2965,2951,2951,2930,2930,2940,-35,-25,4,117620,148
159,m1707,20170124,2930,2940,2957,2957,2957,2957,2957,17,17,2,59140,148
160,m1707,20170125,2957,2957,2937,2937,2880,2904,2897,-53,-60,20,579400,142
161,m1707,20170126,2904,2897,2912,2926,2912,2926,2918,29,21,8,233460,138
162,m1707,20170203,2926,2918,2913,2913,2896,2896,2910,-22,-8,12,349220,138
163,m1707,20170206,2896,2910,2913,2969,2913,2931,2932,21,22,32,938420,148
164,m1707,20170207,2931,2932,2942,2942,2926,2926,2934,-6,2,12,352080,154
165,m1707,20170208,2926,2934,2918,3028,2918,2975,2958,41,24,38,1124060,146
166,m1707,20170209,2975,2958,2991,2991,2955,2985,2978,27,20,10,297820,142
167,m1707,20170210,2985,2978,2987,2996,2986,2996,2987,18,9,20,597460,124
168,m1707,20170213,2996,2987,3014,3019,3000,3000,3008,13,21,34,1022920,120
169,m1707,20170214,3000,3008,3001,3001,2980,2980,2987,-28,-21,26,776780,120
170,m1707,20170215,2980,2987,2962,3001,2935,2965,2963,-22,-24,48,1422680,124
171,m1707,20170216,2965,2963,2949,3000,2949,2971,2976,8,13,20,595200,126
172,m1707,20170217,2971,2976,3000,3000,2917,2935,2977,-41,1,266,7919420,314
173,m1707,20170220,2935,2977,2939,2964,2935,2950,2943,-27,-34,206,6064540,414
174,m1707,20170221,2950,2943,2954,3011,2947,2986,2960,43,17,92,2723640,432
175,m1707,20170222,2986,2960,2983,2983,2938,2955,2955,-5,-5,206,6087520,624
176,m1707,20170223,2955,2955,2957,2968,2919,2919,2945,-36,-10,178,5243700,624
177,m1707,20170224,2919,2945,2934,2966,2901,2924,2939,-21,-6,228,6701760,740
178,m1707,20170227,2924,2939,2920,2952,2918,2930,2925,-9,-14,28,819260,750
179,m1707,20170228,2930,2925,0,0,0,2925,2925,0,0,0,0,750
180,m1707,20170301,2925,2925,2965,2990,2945,2958,2962,33,37,136,4029600,700
181,m1707,20170302,2958,2962,2957,2985,2919,2985,2972,23,10,266,7907980,870
182,m1707,20170303,2985,2972,2963,2965,2963,2965,2964,-7,-8,8,237120,864
183,m1707,20170306,2965,2964,2972,2987,2960,2987,2972,23,8,10,297260,864
184,m1707,20170307,2987,2972,2996,2996,2971,2991,2990,19,18,38,1136200,848
185,m1707,20170308,2991,2990,2983,2983,2940,2940,2967,-50,-23,16,474740,850
186,m1707,20170309,2940,2967,2942,2954,2933,2938,2940,-29,-27,24,705640,844
187,m1707,20170310,2938,2940,2932,2940,2908,2908,2931,-32,-9,34,996800,846
188,m1707,20170313,2908,2931,2906,2920,2906,2920,2910,-11,-21,30,873060,840
189,m1707,20170314,2920,2910,2909,2911,2886,2895,2902,-15,-8,122,3540820,884
190,m1707,20170315,2895,2902,2882,2927,2877,2922,2906,20,4,48,1395240,886
191,m1707,20170316,2922,2906,2914,2915,2901,2901,2906,-5,0,42,1220780,908
192,m1707,20170317,2901,2906,2905,2909,2891,2891,2904,-15,-2,36,1045780,936
193,m1707,20170320,2891,2904,2895,2943,2885,2940,2916,36,12,54,1575120,936
194,m1707,20170321,2940,2916,2939,2939,2905,2905,2929,-11,13,28,820220,944
195,m1707,20170322,2905,2929,2904,2907,2896,2907,2900,-22,-29,14,406020,938
196,m1707,20170323,2907,2900,2901,2901,2877,2877,2887,-23,-13,20,577480,948
197,m1707,20170324,2877,2887,2877,2883,2848,2848,2860,-39,-27,54,1544780,948
198,m1707,20170327,2848,2860,2845,2867,2793,2802,2831,-58,-29,738,20893360,898
199,m1707,20170328,2802,2831,2819,2819,2819,2819,2819,-12,-12,8,225520,902
200,m1707,20170329,2819,2819,2811,2819,2811,2818,2815,-1,-4,8,225220,902
201,m1707,20170330,2818,2815,2828,2838,2802,2802,2819,-13,4,24,676560,902
202,m1707,20170331,2802,2819,2825,2825,2794,2797,2801,-22,-18,392,10982140,1104
203,m1707,20170405,2797,2801,2795,2795,2760,2776,2768,-25,-33,524,14509000,1380
204,m1707,20170406,2776,2768,2784,2785,2764,2770,2773,2,5,154,4270900,1368
205,m1707,20170407,2770,2773,2770,2770,2735,2748,2754,-25,-19,194,5344200,1424
206,m1707,20170410,2748,2754,2761,2794,2754,2777,2771,23,17,246,6819000,1306
207,m1707,20170411,2777,2771,2791,2796,2774,2795,2783,24,12,52,1447240,1290
208,m1707,20170412,2795,2783,2778,2835,2770,2811,2819,28,36,658,18554780,1498
209,m1707,20170413,2811,2819,2822,2850,2808,2850,2839,31,20,716,20330260,1930
210,m1707,20170414,2850,2839,2842,2862,2841,2846,2849,7,10,328,9346400,1956
211,m1707,20170417,2846,2849,2843,2866,2836,2846,2848,-3,-1,318,9059580,1928
212,m1707,20170418,2846,2848,2844,2865,2831,2831,2842,-17,-6,134,3808580,1842
213,m1707,20170419,2831,2842,2816,2900,2790,2900,2830,58,-12,926,26214340,1946
214,m1707,20170420,2900,2830,2855,2865,2843,2865,2855,35,25,288,8223080,1894
215,m1707,20170421,2865,2855,2864,2865,2835,2860,2857,5,2,444,12688480,1748
216,m1707,20170424,2860,2857,2857,2889,2850,2885,2865,28,8,152,4355920,1762
217,m1707,20170425,2885,2865,2898,2898,2870,2875,2873,10,8,160,4597720,1732
218,m1707,20170426,2875,2873,2869,2878,2834,2834,2853,-39,-20,144,4109380,1692
219,m1707,20170427,2834,2853,2845,2859,2832,2837,2844,-16,-9,392,11150100,1530
220,m1707,20170428,2837,2844,2840,2847,2825,2825,2835,-19,-9,340,9639760,1412
221,m1707,20170502,2825,2835,2860,2906,2860,2898,2892,63,57,400,11571500,1326
222,m1707,20170503,2898,2892,2905,2906,2870,2885,2890,-7,-2,106,3063720,1326
223,m1707,20170504,2885,2890,2887,2894,2883,2889,2889,-1,-1,30,866700,1314
224,m1707,20170505,2889,2889,2880,2920,2870,2870,2895,-19,6,294,8511700,1288
225,m1707,20170508,2870,2895,2874,2895,2847,2847,2859,-48,-36,80,2287920,1282
226,m1707,20170509,2847,2859,2844,2853,2842,2849,2847,-10,-12,140,3986220,1228
227,m1707,20170510,2849,2847,2856,2865,2855,2865,2860,18,13,48,1373080,1242
228,m1707,20170511,2865,2860,2865,2874,2834,2867,2860,7,0,102,2918180,1212
229,m1707,20170512,2867,2860,2855,2858,2828,2828,2847,-32,-13,56,1594320,1200
230,m1707,20170515,2828,2847,2825,2836,2821,2823,2828,-24,-19,440,12445120,1258
231,m1707,20170516,2823,2828,2831,2834,2801,2814,2815,-14,-13,396,11147640,1278
232,m1707,20170517,2814,2815,2831,2862,2819,2843,2841,28,26,442,12558440,1358
233,m1707,20170518,2843,2841,2841,2843,2801,2810,2816,-31,-25,114,3210620,1306
234,m1707,20170519,2810,2816,2765,2800,2765,2784,2786,-32,-30,142,3956400,1290
235,m1707,20170522,2784,2786,2801,2814,2778,2795,2795,9,9,126,3521760,1252
236,m1707,20170523,2795,2795,2782,2798,2782,2783,2788,-12,-7,18,501980,1252
237,m1707,20170524,2783,2788,2784,2785,2763,2772,2769,-16,-19,70,1938760,1252
238,m1707,20170525,2772,2769,2785,2785,2774,2781,2781,12,12,50,1390940,1250
239,m1707,20170526,2781,2781,2751,2754,2744,2754,2750,-27,-31,40,1100080,1248
240,m1707,20170531,2754,2750,2709,2719,2653,2660,2673,-90,-77,352,9409480,1296
241,m1707,20170601,2660,2673,2673,2677,2660,2665,2665,-8,-8,1056,28149460,1746
242,m1707,20170602,2665,2665,2665,2682,2608,2608,2647,-57,-18,304,8046960,1734
243,m1707,20170605,2608,2647,2635,2655,2609,2627,2641,-20,-6,668,17647220,1822
244,m1707,20170606,2627,2641,2612,2641,2612,2627,2628,-14,-13,208,5466840,1826
245,m1707,20170607,2627,2628,2618,2663,2618,2631,2628,3,0,4432,116473480,2096
246,m1707,20170608,2631,2628,2648,2648,2630,2635,2635,7,7,738,19449440,1616
247,m1707,20170609,2635,2635,2635,2653,2635,2642,2643,7,8,324,8564640,1550
248,m1707,20170612,2642,2643,2630,2630,2610,2612,2627,-31,-16,96,2522740,1468
249,m1707,20170613,2612,2627,2602,2602,2575,2581,2585,-46,-42,48,1240900,1438
250,m1707,20170614,2581,2585,2595,2596,2585,2585,2591,0,6,16,414660,1424
251,m1707,20170615,2585,2591,2559,2579,2475,2579,2546,-12,-45,134,3412580,1360
252,m1707,20170616,2579,2546,2577,2609,2574,2600,2588,54,42,68,1759900,1310
253,m1707,20170619,2600,2588,2617,2661,2566,2618,2619,30,31,208,5449220,1214
254,m1707,20170620,2618,2619,2660,2691,2643,2654,2665,35,46,78,2078840,1196
255,m1707,20170621,2654,2665,2653,2653,2633,2652,2641,-13,-24,14,369820,1192
256,m1707,20170622,2652,2641,2600,2619,2600,2618,2608,-23,-33,18,469460,1184
257,m1707,20170623,2618,2608,2599,2600,2555,2555,2587,-53,-21,26,672800,1174
258,m1707,20170626,2555,2587,2589,2589,2531,2531,2564,-56,-23,6,153860,1172
259,m1707,20170627,2531,2564,2522,2582,2461,2575,2559,11,-5,230,5887780,1150
260,m1707,20170628,2575,2559,2589,2632,2578,2632,2613,73,54,78,2038260,1098
261,m1707,20170629,2632,2613,2638,2640,2565,2565,2632,-48,19,36,947620,1062
262,m1707,20170630,2565,2632,2539,2552,2503,2538,2533,-94,-99,52,1317220,1036
263,m1707,20170703,2538,2533,2650,2660,2539,2618,2593,85,60,108,2801340,956
264,m1707,20170704,2618,2593,2748,2748,2601,2601,2674,8,81,8,213960,956
265,m1707,20170705,2601,2674,0,0,0,2674,2674,0,0,0,0,956
266,m1707,20170706,2674,2674,2750,2750,2750,2750,2750,76,76,102,2805000,854
267,m1707,20170707,2750,2750,2748,2752,2748,2752,2749,2,-1,6,164960,850
268,m1707,20170710,2752,2749,2740,2740,2740,2740,2740,-9,-9,2,54800,848
269,m1707,20170711,2740,2740,0,0,0,2753,2753,13,13,0,0,848
270,m1707,20170712,2753,2753,2822,2822,2822,2822,2822,69,69,44,1241680,804
271,m1707,20170713,2822,2822,2820,2855,2820,2850,2842,28,20,844,23989900,248
272,m1707,20170714,2850,2842,0,0,0,2807,2807,-35,-35,98,2750860,0
273,m1708,20170103,2828,2838,2812,2821,2812,2821,2815,-17,-23,6,168940,106
274,m1708,20170104,2821,2815,2803,2808,2802,2804,2805,-11,-10,14,392700,108
275,m1708,20170105,2804,2805,2809,2809,2809,2809,2809,4,4,2,56180,108
276,m1708,20170106,2809,2809,0,0,0,2809,2809,0,0,0,0,108
277,m1708,20170109,2809,2809,2811,2811,2795,2797,2803,-12,-6,18,504540,108
278,m1708,20170110,2797,2803,2798,2798,2798,2798,2798,-5,-5,4,111920,108
279,m1708,20170111,2798,2798,2836,2836,2835,2835,2835,37,37,4,113420,106
280,m1708,20170112,2835,2835,2835,2835,2835,2835,2835,0,0,2,56700,106
281,m1708,20170113,2835,2835,2855,2855,2855,2855,2855,20,20,6,171300,106
282,m1708,20170116,2855,2855,2937,2937,2907,2907,2922,52,67,4,116880,106
283,m1708,20170117,2907,2922,3057,3057,2914,2955,2951,33,29,40,1180780,102
284,m1708,20170118,2955,2951,2946,2946,2946,2946,2946,-5,-5,2,58920,102
285,m1708,20170119,2946,2946,2958,2992,2948,2972,2966,26,20,30,889980,94
286,m1708,20170120,2972,2966,2945,2960,2945,2960,2956,-6,-10,16,472980,102
287,m1708,20170123,2960,2956,2942,2949,2941,2949,2945,-7,-11,22,647920,98
288,m1708,20170124,2949,2945,2946,2949,2936,2949,2943,4,-2,6,176620,98
289,m1708,20170125,2949,2943,2941,2941,2883,2883,2903,-60,-40,42,1219580,100
290,m1708,20170126,2883,2903,2910,2941,2910,2938,2931,35,28,26,762140,104
291,m1708,20170203,2938,2931,2925,2936,2914,2914,2924,-17,-7,32,935860,112
292,m1708,20170206,2914,2924,2925,2938,2918,2918,2927,-6,3,26,761140,98
293,m1708,20170207,2918,2927,2947,2975,2947,2951,2968,24,41,86,2552780,176
294,m1708,20170208,2951,2968,2970,3010,2970,2987,2986,19,18,56,1672320,148
295,m1708,20170209,2987,2986,2995,2996,2985,2993,2992,7,6,68,2034980,130
296,m1708,20170210,2993,2992,2992,3010,2972,2997,2994,5,2,46,1377540,124
297,m1708,20170213,2997,2994,3017,3053,3013,3025,3031,31,37,96,2910560,172
298,m1708,20170214,3025,3031,3010,3019,3001,3019,3005,-12,-26,80,2404620,124
299,m1708,20170215,3019,3005,2978,2978,2978,2978,2978,-27,-27,2,59560,124
300,m1708,20170216,2978,2978,2956,3010,2956,2980,2975,2,-3,46,1368660,114
301,m1708,20170217,2980,2975,2999,2999,2946,2949,2961,-26,-14,30,888400,128
302,m1708,20170220,2949,2961,2936,2951,2936,2951,2945,-10,-16,28,824660,140
303,m1708,20170221,2951,2945,0,0,0,2965,2965,20,20,0,0,140
304,m1708,20170222,2965,2965,2956,2967,2956,2960,2959,-5,-6,22,651080,152
305,m1708,20170223,2960,2959,2969,2973,2945,2945,2963,-14,4,124,3675180,206
306,m1708,20170224,2945,2963,2933,2933,2907,2924,2916,-39,-47,316,9215260,318
307,m1708,20170227,2924,2916,0,0,0,2916,2916,0,0,0,0,318
308,m1708,20170228,2916,2916,2928,2935,2917,2927,2925,11,9,16,468000,312
309,m1708,20170301,2927,2925,2926,2963,2919,2963,2946,38,21,26,766020,324
310,m1708,20170302,2963,2946,2960,2978,2960,2978,2970,32,24,34,1009940,326
311,m1708,20170303,2978,2970,2973,2982,2953,2968,2966,-2,-4,28,830520,314
312,m1708,20170306,2968,2966,0,0,0,2981,2981,15,15,0,0,314
313,m1708,20170307,2981,2981,2987,2987,2975,2975,2983,-6,2,10,298320,312
314,m1708,20170308,2975,2983,3007,3007,2947,2947,2961,-36,-22,44,1302840,314
315,m1708,20170309,2947,2961,2931,2944,2931,2944,2934,-17,-27,22,645660,302
316,m1708,20170310,2944,2934,0,0,0,2911,2911,-23,-23,0,0,302
317,m1708,20170313,2911,2911,2906,2907,2901,2907,2904,-4,-7,10,290440,302
318,m1708,20170314,2907,2904,2929,2929,2885,2904,2907,0,3,28,814140,300
319,m1708,20170315,2904,2907,2925,2925,2922,2922,2922,15,15,8,233820,300
320,m1708,20170316,2922,2922,2920,2922,2917,2917,2919,-5,-3,14,408680,300
321,m1708,20170317,2917,2919,2908,2908,2908,2908,2908,-11,-11,2,58160,300
322,m1708,20170320,2908,2908,2904,2967,2902,2941,2935,33,27,14,411000,300
323,m1708,20170321,2941,2935,2936,2969,2917,2922,2928,-13,-7,62,1815740,308
324,m1708,20170322,2922,2928,2909,2954,2907,2942,2928,14,0,66,1932740,302
325,m1708,20170323,2942,2928,2924,2924,2884,2894,2898,-34,-30,142,4115260,294
326,m1708,20170324,2894,2898,2892,2892,2871,2871,2875,-27,-23,34,977760,264
327,m1708,20170327,2871,2875,2867,2867,2815,2839,2851,-36,-24,34,969560,264
328,m1708,20170328,2839,2851,2854,2855,2841,2841,2852,-10,1,14,399360,250
329,m1708,20170329,2841,2852,2852,2852,2852,2852,2852,0,0,8,228160,242
330,m1708,20170330,2852,2852,2835,2835,2817,2828,2830,-24,-22,20,566060,242
331,m1708,20170331,2828,2830,2818,2840,2800,2800,2811,-30,-19,504,14171960,508
332,m1708,20170405,2800,2811,2764,2786,2764,2776,2773,-35,-38,36,998540,530
333,m1708,20170406,2776,2773,2791,2791,2768,2777,2776,4,3,52,1443980,544
334,m1708,20170407,2777,2776,2754,2757,2750,2750,2752,-26,-24,16,440360,552
335,m1708,20170410,2750,2752,2762,2792,2762,2792,2786,40,34,26,724560,560
336,m1708,20170411,2792,2786,2782,2794,2777,2794,2786,8,0,56,1560680,562
337,m1708,20170412,2794,2786,2773,2842,2769,2818,2821,32,35,62,1749400,556
338,m1708,20170413,2818,2821,2818,2858,2818,2856,2846,35,25,84,2391340,564
339,m1708,20170414,2856,2846,2868,2872,2855,2872,2862,26,16,14,400680,570
340,m1708,20170417,2872,2862,2847,2862,2841,2843,2847,-19,-15,74,2106840,576
341,m1708,20170418,2843,2847,2837,2848,2832,2832,2840,-15,-7,26,738520,580
342,m1708,20170419,2832,2840,2825,2860,2816,2854,2829,14,-11,102,2885680,592
343,m1708,20170420,2854,2829,2848,2860,2848,2850,2853,21,24,78,2225980,622
344,m1708,20170421,2850,2853,2846,2850,2834,2842,2841,-11,-12,20,568320,622
345,m1708,20170424,2842,2841,2843,2878,2835,2872,2856,31,15,124,3542540,660
346,m1708,20170425,2872,2856,2841,2880,2841,2862,2868,6,12,80,2295180,712
347,m1708,20170426,2862,2868,2867,2869,2816,2826,2832,-42,-36,114,3228640,720
348,m1708,20170427,2826,2832,2831,2832,2792,2817,2814,-15,-18,174,4896640,692
349,m1708,20170428,2817,2814,2820,2831,2820,2824,2824,10,10,58,1638240,716
350,m1708,20170502,2824,2824,2845,2894,2845,2893,2883,69,59,78,2249240,696
351,m1708,20170503,2893,2883,0,0,0,2883,2883,0,0,0,0,696
352,m1708,20170504,2883,2883,0,0,0,2883,2883,0,0,0,0,696
353,m1708,20170505,2883,2883,2853,2892,2853,2869,2880,-14,-3,64,1843200,706
354,m1708,20170508,2869,2880,2880,2880,2866,2866,2876,-14,-4,10,287600,706
355,m1708,20170509,2866,2876,2834,2844,2828,2837,2835,-39,-41,16,453600,706
356,m1708,20170510,2837,2835,2849,2849,2844,2849,2845,14,10,16,455280,702
357,m1708,20170511,2849,2845,2860,2860,2848,2848,2853,3,8,20,570680,704
358,m1708,20170512,2848,2853,2839,2839,2804,2813,2820,-40,-33,8,225600,706
359,m1708,20170515,2813,2820,2810,2810,2790,2801,2802,-19,-18,8,224220,708
360,m1708,20170516,2801,2802,2802,2802,2772,2785,2778,-17,-24,118,3279180,754
361,m1708,20170517,2785,2778,2804,2825,2804,2825,2817,47,39,30,845320,750
362,m1708,20170518,2825,2817,2816,2816,2781,2783,2800,-34,-17,18,504120,750
363,m1708,20170519,2783,2800,2763,2770,2745,2751,2759,-49,-41,24,662160,748
364,m1708,20170522,2751,2759,2763,2775,2749,2760,2760,1,1,42,1159560,748
365,m1708,20170523,2760,2760,2760,2763,2751,2751,2759,-9,-1,40,1103760,734
366,m1708,20170524,2751,2759,2740,2756,2729,2751,2743,-8,-16,18,493840,730
367,m1708,20170525,2751,2743,2740,2750,2737,2737,2742,-6,-1,6,164540,728
368,m1708,20170526,2737,2742,2732,2732,2707,2715,2714,-27,-28,68,1845880,730
369,m1708,20170531,2715,2714,2715,2715,2632,2635,2664,-79,-50,16,426320,726
370,m1708,20170601,2635,2664,0,0,0,2642,2642,-22,-22,0,0,726
371,m1708,20170602,2642,2642,2625,2637,2618,2633,2625,-9,-17,96,2520700,684
372,m1708,20170605,2633,2625,2634,2664,2634,2645,2647,20,22,72,1905860,674
373,m1708,20170606,2645,2647,2626,2663,2626,2647,2648,0,1,38,1006580,658
374,m1708,20170607,2647,2648,2668,2668,2645,2658,2659,10,11,50,1329500,616
375,m1708,20170608,2658,2659,2675,2698,2675,2680,2680,21,21,160,4289480,584
376,m1708,20170609,2680,2680,2686,2719,2683,2683,2693,3,13,24,646400,580
377,m1708,20170612,2683,2693,2686,2686,2669,2674,2674,-19,-19,38,1016140,578
378,m1708,20170613,2674,2674,2637,2675,2636,2660,2661,-14,-13,372,9901720,660
379,m1708,20170614,2660,2661,2663,2682,2663,2666,2668,5,7,74,1975040,638
380,m1708,20170615,2666,2668,2669,2691,2546,2649,2629,-19,-39,68,1788260,624
381,m1708,20170616,2649,2629,2639,2681,2639,2665,2661,36,32,250,6652500,704
382,m1708,20170619,2665,2661,2665,2721,2655,2683,2672,22,11,70,1871020,700
383,m1708,20170620,2683,2672,2687,2687,2670,2687,2683,15,11,30,805120,684
384,m1708,20170621,2687,2683,2670,2683,2668,2668,2673,-15,-10,28,748540,678
385,m1708,20170622,2668,2673,2672,2675,2648,2652,2669,-21,-4,102,2722480,656
386,m1708,20170623,2652,2669,2647,2647,2633,2642,2641,-27,-28,36,950760,648
387,m1708,20170626,2642,2641,2647,2659,2626,2650,2647,9,6,96,2541960,650
388,m1708,20170627,2650,2647,2653,2653,2650,2653,2652,6,5,14,371280,646
389,m1708,20170628,2653,2652,2665,2670,2651,2651,2661,-1,9,14,372580,646
390,m1708,20170629,2651,2661,2649,2660,2649,2654,2654,-7,-7,54,1433420,612
391,m1708,20170630,2654,2654,2660,2687,2645,2653,2651,-1,-3,98,2598300,622
392,m1708,20170703,2653,2651,2724,2783,2724,2783,2755,132,104,1440,39676840,1098
393,m1708,20170704,2783,2755,2776,2805,2771,2804,2793,49,38,354,9890000,1130
394,m1708,20170705,2804,2793,2798,2813,2785,2795,2797,2,4,276,7719880,1090
395,m1708,20170706,2795,2797,2824,2825,2804,2809,2814,12,17,172,4841420,1066
396,m1708,20170707,2809,2814,2782,2833,2782,2832,2819,18,5,1954,55084020,924
397,m1708,20170710,2832,2819,2833,2959,2832,2949,2909,130,90,286,8320300,726
398,m1708,20170711,2949,2909,2952,2988,2918,2942,2954,33,45,110,3250060,678
399,m1708,20170712,2942,2954,2938,2977,2938,2954,2949,0,-5,60,1769460,668
400,m1708,20170713,2954,2949,2948,2967,2898,2900,2913,-49,-36,252,7341800,474
401,m1708,20170714,2900,2913,2899,2899,2812,2841,2848,-72,-65,70,1993840,444
402,m1708,20170717,2841,2848,2888,2888,2821,2860,2861,12,13,22,629460,442
403,m1708,20170718,2860,2861,2877,2877,2841,2865,2861,4,0,36,1030200,418
404,m1708,20170719,2865,2861,2891,2891,2857,2870,2876,9,15,66,1898800,372
405,m1708,20170720,2870,2876,2893,2893,2879,2883,2880,7,4,72,2074060,302
406,m1708,20170721,2883,2880,2896,2913,2896,2900,2901,20,21,44,1276660,268
407,m1708,20170724,2900,2901,2905,2905,2846,2850,2859,-51,-42,48,1372440,240
408,m1708,20170725,2850,2859,2888,2915,2812,2867,2867,8,8,338,9692920,164
409,m1708,20170726,2867,2867,2861,2861,2815,2829,2823,-38,-44,76,2146100,88
410,m1708,20170727,2829,2823,2822,2919,2808,2820,2822,-3,-1,84,2371120,16
411,m1708,20170728,2820,2822,2784,2963,2775,2892,2868,70,46,364,10440080,20
412,m1708,20170731,2892,2868,2958,2958,2829,2850,2871,-18,3,52,1493120,4
413,m1708,20170801,2850,2871,0,0,0,2871,2871,0,0,0,0,4
414,m1708,20170802,2871,2871,0,0,0,2871,2871,0,0,0,0,4
415,m1708,20170803,2871,2871,2820,2820,2820,2820,2820,-51,-51,4,112800,0
416,m1708,20170804,2820,2820,0,0,0,2820,2820,0,0,0,0,0
417,m1708,20170807,2820,2820,0,0,0,2820,2820,0,0,0,0,0
418,m1708,20170808,2820,2820,0,0,0,2820,2820,0,0,0,0,0
419,m1708,20170809,2820,2820,0,0,0,2820,2820,0,0,0,0,0
420,m1708,20170810,2820,2820,0,0,0,2820,2820,0,0,0,0,0
421,m1708,20170811,2820,2820,0,0,0,2820,2820,0,0,0,0,0
422,m1708,20170814,2820,2820,0,0,0,2820,2820,0,0,0,0,0
423,m1709,20170103,2816,2822,2813,2824,2784,2789,2802,-33,-20,100552,2818295860,572286
424,m1709,20170104,2789,2802,2785,2813,2773,2805,2797,3,-5,141572,3960160980,582710
425,m1709,20170105,2805,2797,2802,2830,2793,2804,2814,7,17,128208,3608251040,596426
426,m1709,20170106,2804,2814,2804,2820,2793,2806,2803,-8,-11,111660,3130707700,613822
427,m1709,20170109,2806,2803,2806,2818,2777,2789,2794,-14,-9,145542,4066558480,621610
428,m1709,20170110,2789,2794,2785,2806,2768,2788,2785,-6,-9,146886,4091388780,628222
429,m1709,20170111,2788,2785,2787,2839,2785,2827,2817,42,32,238620,6722026900,652926
430,m1709,20170112,2827,2817,2824,2837,2811,2819,2825,2,8,142452,4024895920,662324
431,m1709,20170113,2819,2825,2822,2900,2819,2885,2871,60,46,270862,7777738780,693920
432,m1709,20170116,2885,2871,2885,2924,2875,2920,2905,49,34,227810,6618896880,676024
433,m1709,20170117,2920,2905,2925,2955,2905,2931,2931,26,26,247350,7251289380,695234
434,m1709,20170118,2931,2931,2934,2968,2918,2944,2940,13,9,303032,8912131240,709406
435,m1709,20170119,2944,2940,2939,2972,2935,2961,2956,21,16,197460,5838460720,693282
436,m1709,20170120,2961,2956,2956,2962,2928,2931,2946,-25,-10,214938,6332492120,691050
437,m1709,20170123,2931,2946,2934,2948,2917,2936,2932,-10,-14,150874,4424489180,699994
438,m1709,20170124,2936,2932,2936,2947,2924,2944,2937,12,5,132984,3906753940,704756
439,m1709,20170125,2944,2937,2943,2943,2886,2886,2906,-51,-31,147732,4294123420,705356
440,m1709,20170126,2886,2906,2890,2930,2890,2916,2913,10,7,125818,3666018740,708274
441,m1709,20170203,2916,2913,2920,2920,2860,2898,2897,-15,-16,152826,4428706720,725504
442,m1709,20170206,2898,2897,2895,2945,2893,2936,2922,39,25,343514,10040553840,758824
443,m1709,20170207,2936,2922,2935,2951,2926,2935,2937,13,15,227830,6692410880,813420
444,m1709,20170208,2935,2937,2935,2990,2916,2989,2965,52,28,401026,11890645020,883120
445,m1709,20170209,2989,2965,2992,3006,2972,2975,2987,10,22,308334,9210886200,911194
446,m1709,20170210,2975,2987,2976,3011,2971,3010,2987,23,0,259584,7755482740,926598
447,m1709,20170213,3010,2987,3007,3030,2985,2995,3008,8,21,422880,12722020360,970166
448,m1709,20170214,2995,3008,3000,3014,2965,2970,2988,-38,-20,270248,8076218480,970086
449,m1709,20170215,2970,2988,2975,2979,2944,2951,2960,-37,-28,301430,8925103080,966932
450,m1709,20170216,2951,2960,2946,3008,2935,2979,2983,19,23,441304,13164963980,1004934
451,m1709,20170217,2979,2983,2985,3006,2921,2934,2962,-49,-21,535910,15875222600,1019724
452,m1709,20170220,2934,2962,2940,2957,2931,2954,2944,-8,-18,253182,7456148700,1079686
453,m1709,20170221,2954,2944,2956,3000,2954,2984,2977,40,33,380860,11340446140,1126106
454,m1709,20170222,2984,2977,2978,2988,2945,2953,2963,-24,-14,306870,9095016260,1138460
455,m1709,20170223,2953,2963,2953,2967,2925,2926,2947,-37,-16,400244,11796566660,1129526
456,m1709,20170224,2926,2947,2930,2934,2895,2915,2913,-32,-34,356062,10374041680,1120530
457,m1709,20170227,2915,2913,2919,2931,2902,2924,2919,11,6,343990,10041861260,1147436
458,m1709,20170228,2924,2919,2924,2928,2903,2913,2915,-6,-4,323888,9443999540,1167932
459,m1709,20170301,2913,2915,2913,2968,2912,2947,2945,32,30,601306,17709313720,1246036
460,m1709,20170302,2947,2945,2955,2980,2945,2979,2964,34,19,419606,12438931000,1309820
461,m1709,20170303,2979,2964,2976,2976,2944,2962,2957,-2,-7,389060,11505612560,1344802
462,m1709,20170306,2962,2957,2962,2988,2948,2983,2969,26,12,521294,15477323560,1417308
463,m1709,20170307,2983,2969,2979,2991,2960,2964,2971,-5,2,486584,14459136620,1428574
464,m1709,20170308,2964,2971,2956,2962,2920,2924,2937,-47,-34,563766,16563405360,1420112
465,m1709,20170309,2924,2937,2920,2929,2908,2922,2920,-15,-17,450122,13146142060,1428794
466,m1709,20170310,2922,2920,2920,2929,2875,2878,2900,-42,-20,694594,20148975820,1387484
467,m1709,20170313,2878,2900,2860,2897,2860,2890,2881,-10,-19,464386,13383194900,1386960
468,m1709,20170314,2890,2881,2890,2903,2862,2865,2881,-16,0,558372,16091544980,1443154
469,m1709,20170315,2865,2881,2860,2899,2841,2884,2876,3,-5,702714,20210134320,1446544
470,m1709,20170316,2884,2876,2890,2900,2872,2889,2887,13,11,553812,15989261180,1527242
471,m1709,20170317,2889,2887,2890,2896,2857,2875,2873,-12,-14,612986,17614616100,1604870
472,m1709,20170320,2875,2873,2874,2914,2861,2907,2895,34,22,959790,27792692480,1745374
473,m1709,20170321,2907,2895,2900,2916,2872,2877,2894,-18,-1,1063812,30796823860,1870528
474,m1709,20170322,2877,2894,2881,2884,2858,2875,2872,-19,-22,1117262,32088608220,2002054
475,m1709,20170323,2875,2872,2872,2882,2825,2827,2852,-45,-20,1781858,50821584960,2119364
476,m1709,20170324,2827,2852,2829,2848,2806,2813,2821,-39,-31,1249086,35248352840,2146658
477,m1709,20170327,2813,2821,2815,2818,2783,2807,2801,-14,-20,1193478,33432313440,2107942
478,m1709,20170328,2807,2801,2805,2813,2793,2801,2804,0,3,1060160,29727090740,2186788
479,m1709,20170329,2801,2804,2804,2819,2788,2816,2803,12,-1,1217214,34119744120,2214330
480,m1709,20170330,2816,2803,2815,2817,2773,2785,2789,-18,-14,1357636,37877521300,2245112
481,m1709,20170331,2785,2789,2775,2800,2766,2780,2784,-9,-5,790108,21998053580,2212768
482,m1709,20170405,2780,2784,2740,2762,2733,2755,2749,-29,-35,1049690,28863202480,2359122
483,m1709,20170406,2755,2749,2756,2765,2743,2754,2753,5,4,1151572,31707000020,2465404
484,m1709,20170407,2754,2753,2755,2759,2723,2729,2737,-24,-16,1305006,35729633820,2406850
485,m1709,20170410,2729,2737,2735,2774,2732,2762,2751,25,14,1442414,39683317940,2375378
486,m1709,20170411,2762,2751,2763,2768,2745,2762,2757,11,6,1049786,28948921680,2468820
487,m1709,20170412,2762,2757,2757,2808,2740,2783,2779,26,22,1824958,50727356740,2444924
488,m1709,20170413,2783,2779,2789,2838,2783,2836,2809,57,30,1558500,43791323200,2448010
489,m1709,20170414,2836,2809,2837,2849,2824,2830,2835,21,26,1426256,40445613040,2356906
490,m1709,20170417,2830,2835,2835,2854,2814,2825,2829,-10,-6,1433722,40561872600,2473674
491,m1709,20170418,2825,2829,2823,2835,2809,2812,2820,-17,-9,1340506,37803021320,2485364
492,m1709,20170419,2812,2820,2810,2859,2793,2856,2820,36,0,1941632,54771007680,2543530
493,m1709,20170420,2856,2820,2834,2849,2821,2844,2836,24,16,1621148,45991541040,2510120
494,m1709,20170421,2844,2836,2846,2849,2817,2828,2830,-8,-6,1170678,33135436780,2536034
495,m1709,20170424,2828,2830,2833,2867,2817,2857,2846,27,16,1542910,43922426320,2615406
496,m1709,20170425,2857,2846,2858,2866,2840,2851,2855,5,9,1083314,30929858580,2611450
497,m1709,20170426,2851,2855,2850,2857,2804,2806,2829,-49,-26,1614830,45684972820,2554874
498,m1709,20170427,2806,2829,2810,2827,2790,2792,2805,-37,-24,1366500,38335024220,2517108
499,m1709,20170428,2792,2805,2796,2808,2787,2799,2799,-6,-6,902756,25271973680,2475892
500,m1709,20170502,2799,2799,2825,2884,2823,2879,2860,80,61,1441082,41215882400,2515604
501,m1709,20170503,2879,2860,2870,2873,2850,2861,2861,1,1,1024048,29301268500,2483980
502,m1709,20170504,2861,2861,2861,2875,2848,2869,2864,8,3,1445900,41410635180,2476938
503,m1709,20170505,2869,2864,2865,2888,2836,2841,2862,-23,-2,2017480,57757948260,2454184
504,m1709,20170508,2841,2862,2856,2868,2816,2818,2842,-44,-20,1784408,50717356840,2351434
505,m1709,20170509,2818,2842,2822,2827,2808,2817,2817,-25,-25,1026774,28927757980,2341432
506,m1709,20170510,2817,2817,2819,2841,2817,2838,2831,21,14,906150,25659068780,2297294
507,m1709,20170511,2838,2831,2837,2846,2812,2835,2828,4,-3,1300712,36794997260,2346480
508,m1709,20170512,2835,2828,2829,2833,2788,2792,2807,-36,-21,1545332,43390440280,2434192
509,m1709,20170515,2792,2807,2794,2798,2778,2781,2787,-26,-20,1091052,30414824900,2455252
510,m1709,20170516,2781,2787,2791,2796,2758,2772,2774,-15,-13,1151504,31952856540,2509790
511,m1709,20170517,2772,2774,2778,2814,2774,2809,2795,35,21,1127932,31536972940,2362248
512,m1709,20170518,2809,2795,2814,2816,2755,2768,2778,-27,-17,1232404,34240406080,2403338
513,m1709,20170519,2768,2778,2751,2764,2732,2737,2744,-41,-34,1705320,46806829140,2529628
514,m1709,20170522,2737,2744,2741,2764,2727,2750,2747,6,3,1534324,42150655180,2567968
515,m1709,20170523,2750,2747,2749,2755,2734,2742,2745,-5,-2,873936,23989793640,2569754
516,m1709,20170524,2742,2745,2741,2748,2710,2733,2728,-12,-17,1680706,45862536460,2638990
517,m1709,20170525,2733,2728,2739,2741,2725,2732,2733,4,5,712340,19468626400,2623854
518,m1709,20170526,2732,2733,2730,2735,2690,2700,2706,-33,-27,1365232,36952511720,2712432
519,m1709,20170531,2700,2706,2668,2672,2604,2613,2635,-93,-71,1518098,40003329060,2753026
520,m1709,20170601,2613,2635,2618,2632,2614,2629,2623,-6,-12,951688,24968696800,2720494
521,m1709,20170602,2629,2623,2637,2650,2610,2627,2630,4,7,1005804,26453981540,2680396
522,m1709,20170605,2627,2630,2633,2670,2630,2650,2655,20,25,1307918,34726967980,2631062
523,m1709,20170606,2650,2655,2655,2665,2642,2650,2652,-5,-3,842032,22336947080,2614600
524,m1709,20170607,2650,2652,2652,2685,2647,2664,2668,12,16,1282134,34213445200,2617972
525,m1709,20170608,2664,2668,2675,2688,2668,2685,2679,17,11,1100954,29496625220,2638308
526,m1709,20170609,2685,2679,2690,2708,2685,2686,2693,7,14,1054008,28389560240,2584416
527,m1709,20170612,2686,2693,2693,2697,2665,2677,2679,-16,-14,1291808,34614639400,2581412
528,m1709,20170613,2677,2679,2668,2668,2647,2663,2656,-16,-23,1148508,30512946160,2552284
529,m1709,20170614,2663,2656,2664,2689,2663,2680,2676,24,20,984284,26348621180,2538772
530,m1709,20170615,2680,2676,2680,2689,2651,2664,2665,-12,-11,1232390,32849963220,2594886
531,m1709,20170616,2664,2665,2655,2705,2645,2687,2680,22,15,1379718,36976642220,2521732
532,m1709,20170619,2687,2680,2692,2731,2677,2709,2704,29,24,1558108,42141214820,2484560
533,m1709,20170620,2709,2704,2708,2716,2693,2711,2705,7,1,915068,24761530340,2423798
534,m1709,20170621,2711,2705,2700,2703,2684,2696,2693,-9,-12,898338,24201088940,2431078
535,m1709,20170622,2696,2693,2696,2703,2655,2658,2674,-35,-19,1203530,32184879080,2457152
536,m1709,20170623,2658,2674,2653,2661,2634,2645,2646,-29,-28,1026780,27169712920,2433844
537,m1709,20170626,2645,2646,2648,2664,2633,2657,2650,11,4,877444,23258158020,2358442
538,m1709,20170627,2657,2650,2662,2670,2651,2663,2660,13,10,691016,18383401280,2298884
539,m1709,20170628,2663,2660,2670,2680,2647,2658,2662,-2,2,970046,25830844300,2341754
540,m1709,20170629,2658,2662,2658,2670,2653,2665,2662,3,0,931290,24791304320,2258590
541,m1709,20170630,2665,2662,2670,2691,2643,2655,2665,-7,3,1357794,36195218380,2274202
542,m1709,20170703,2655,2665,2658,2788,2652,2780,2750,115,85,1825034,50191746060,2080446
543,m1709,20170704,2780,2750,2792,2804,2769,2798,2788,48,38,1570472,43787157180,2096392
544,m1709,20170705,2798,2788,2797,2808,2775,2792,2791,4,3,895288,24990282340,2056712
545,m1709,20170706,2792,2791,2790,2829,2789,2815,2812,24,21,1542188,43376005100,2024462
546,m1709,20170707,2815,2812,2810,2841,2807,2834,2826,22,14,893170,25249098280,1988160
547,m1709,20170710,2834,2826,2844,2943,2826,2919,2886,93,60,2000796,57756351180,1959536
548,m1709,20170711,2919,2886,2918,2948,2888,2930,2922,44,36,1597096,46676182620,1733774
549,m1709,20170712,2930,2922,2913,2930,2907,2914,2917,-8,-5,1004978,29316688760,1643514
550,m1709,20170713,2914,2917,2909,2926,2842,2849,2873,-68,-44,1543238,44342303120,1608410
551,m1709,20170714,2849,2873,2835,2849,2787,2803,2813,-70,-60,1316922,37046328440,1542914
552,m1709,20170717,2803,2813,2812,2832,2802,2810,2814,-3,1,905190,25477954240,1513754
553,m1709,20170718,2810,2814,2825,2836,2808,2824,2823,10,9,818614,23109501740,1482552
554,m1709,20170719,2824,2823,2839,2856,2821,2826,2838,3,15,795318,22571369640,1464842
555,m1709,20170720,2826,2838,2830,2853,2826,2842,2841,4,3,712538,20245733140,1444244
556,m1709,20170721,2842,2841,2856,2876,2851,2869,2864,28,23,917814,26291126720,1431812
557,m1709,20170724,2869,2864,2861,2862,2789,2805,2820,-59,-44,987632,27852287040,1327848
558,m1709,20170725,2805,2820,2805,2871,2802,2864,2842,44,22,838294,23827643520,1263114
559,m1709,20170726,2864,2842,2855,2858,2803,2808,2822,-34,-20,887872,25061624180,1216524
560,m1709,20170727,2808,2822,2796,2830,2758,2815,2804,-7,-18,633296,17760300400,1146574
561,m1709,20170728,2815,2804,2830,2856,2822,2841,2837,37,33,846930,24028069740,1123996
562,m1709,20170731,2841,2837,2844,2868,2822,2840,2842,3,5,617710,17557435940,1015756
563,m1709,20170801,2840,2842,2833,2859,2831,2844,2843,2,1,441168,12545523400,941252
564,m1709,20170802,2844,2843,2835,2847,2806,2818,2820,-25,-23,494870,13958714180,812504
565,m1709,20170803,2818,2820,2825,2827,2786,2791,2808,-29,-12,341838,9600823660,684730
566,m1709,20170804,2791,2808,2790,2802,2781,2798,2792,-10,-16,216600,6048220320,618032
567,m1709,20170807,2798,2792,2805,2824,2794,2808,2808,16,16,254886,7158864700,522372
568,m1709,20170808,2808,2808,2811,2856,2809,2846,2835,38,27,197690,5604549200,452022
569,m1709,20170809,2846,2835,2850,2859,2838,2854,2847,19,12,124876,3555393080,401408
570,m1709,20170810,2854,2847,2853,2862,2842,2855,2851,8,4,110290,3144897920,374506
571,m1709,20170811,2855,2851,2864,2883,2763,2775,2807,-76,-44,254344,7140794260,272438
572,m1709,20170814,2775,2807,2780,2792,2767,2780,2777,-27,-30,83406,2316365060,244116
573,m1709,20170815,2780,2777,2780,2783,2765,2778,2775,1,-2,69170,1920148160,217212
574,m1709,20170816,2778,2775,2773,2778,2750,2757,2760,-18,-15,63478,1752577400,191596
575,m1709,20170817,2757,2760,2767,2774,2756,2765,2765,5,5,36350,1005194320,178092
576,m1709,20170818,2765,2765,2772,2778,2767,2769,2773,4,8,37508,1040297940,167896
577,m1709,20170821,2769,2773,2756,2778,2756,2765,2769,-8,-4,42586,1179314500,151384
578,m1709,20170822,2765,2769,2763,2768,2731,2763,2752,-6,-17,80374,2212675540,114308
579,m1709,20170823,2763,2752,2754,2768,2750,2759,2756,7,4,26876,740920940,100176
580,m1709,20170824,2759,2756,2762,2766,2738,2754,2750,-2,-6,28742,790581880,84758
581,m1709,20170825,2754,2750,2759,2778,2747,2775,2763,25,13,26374,728801020,69316
582,m1709,20170828,2775,2763,2777,2785,2766,2775,2778,12,15,24012,667224980,53488
583,m1709,20170829,2775,2778,2784,2790,2754,2756,2764,-22,-14,16752,463120720,43910
584,m1709,20170830,2756,2764,2748,2755,2740,2741,2745,-23,-19,17634,484084980,31954
585,m1709,20170831,2741,2745,2740,2743,2702,2720,2724,-25,-21,24496,667464560,11584
586,m1709,20170901,2720,2724,2724,2757,2700,2725,2730,1,6,3930,107319320,8430
587,m1709,20170904,2725,2730,2734,2765,2730,2765,2737,35,7,3878,106173320,5508
588,m1709,20170905,2765,2737,0,0,0,2737,2737,0,0,0,0,5508
589,m1709,20170906,2737,2737,2750,2750,2750,2750,2750,13,13,972,26730000,5502
590,m1709,20170907,2750,2750,0,0,0,2750,2750,0,0,0,0,5502
591,m1709,20170908,2750,2750,2730,2770,2730,2750,2764,0,14,450,12440480,4054
592,m1709,20170911,2750,2764,2756,2756,2756,2756,2756,-8,-8,2492,68679520,4054
593,m1709,20170912,2756,2756,2756,2756,2756,2756,2756,0,0,264,7275840,590
594,m1709,20170913,2756,2756,0,0,0,2756,2756,0,0,0,0,590
595,m1709,20170914,2756,2756,0,0,0,2741,2741,-15,-15,0,0,0
596,m1711,20170103,2827,2827,0,0,0,2803,2803,-24,-24,0,0,76
597,m1711,20170104,2803,2803,2805,2810,2783,2810,2804,7,1,20,560960,66
598,m1711,20170105,2810,2804,2808,2833,2808,2833,2820,29,16,4,112820,64
599,m1711,20170106,2833,2820,2806,2806,2806,2806,2806,-14,-14,2,56120,62
600,m1711,20170109,2806,2806,2817,2823,2762,2762,2802,-44,-4,16,448360,66
601,m1711,20170110,2762,2802,2797,2802,2791,2800,2796,-2,-6,22,615200,68
602,m1711,20170111,2800,2796,2809,2836,2809,2836,2827,40,31,6,169620,62
603,m1711,20170112,2836,2827,0,0,0,2827,2827,0,0,0,0,62
604,m1711,20170113,2827,2827,2838,2925,2825,2888,2866,61,39,14,401300,62
605,m1711,20170116,2888,2866,2925,2926,2925,2926,2925,60,59,12,351080,64
606,m1711,20170117,2926,2925,2959,2962,2919,2927,2947,2,22,18,530460,62
607,m1711,20170118,2927,2947,2936,2945,2936,2945,2940,-2,-7,4,117620,60
608,m1711,20170119,2945,2940,2960,2960,2960,2960,2960,20,20,2,59200,60
609,m1711,20170120,2960,2960,0,0,0,2959,2959,-1,-1,0,0,60
610,m1711,20170123,2959,2959,2957,2957,2908,2908,2932,-51,-27,26,762340,60
611,m1711,20170124,2908,2932,2934,2934,2930,2930,2932,-2,0,4,117280,58
612,m1711,20170125,2930,2932,2926,2926,2874,2875,2878,-57,-54,24,690820,50
613,m1711,20170126,2875,2878,2895,2898,2895,2897,2896,19,18,6,173800,50
614,m1711,20170203,2897,2896,2899,2899,2880,2880,2892,-16,-4,6,173560,46
615,m1711,20170206,2880,2892,2927,2928,2904,2904,2919,12,27,6,175180,48
616,m1711,20170207,2904,2919,2928,2930,2928,2930,2929,11,10,6,175760,52
617,m1711,20170208,2930,2929,2929,2953,2929,2953,2937,24,8,6,176220,46
618,m1711,20170209,2953,2937,2985,2985,2956,2956,2970,19,33,4,118820,46
619,m1711,20170210,2956,2970,0,0,0,2991,2991,21,21,0,0,46
620,m1711,20170213,2991,2991,3015,3015,2988,2989,2995,-2,4,8,239640,42
621,m1711,20170214,2989,2995,2991,2997,2991,2997,2994,2,-1,4,119760,40
622,m1711,20170215,2997,2994,2950,2950,2949,2949,2949,-45,-45,4,117980,36
623,m1711,20170216,2949,2949,2992,2995,2982,2982,2990,33,41,8,239260,32
624,m1711,20170217,2982,2990,2911,2911,2911,2911,2911,-79,-79,2,58220,32
625,m1711,20170220,2911,2911,2933,2939,2933,2939,2936,28,25,4,117440,34
626,m1711,20170221,2939,2936,2948,2967,2948,2967,2957,31,21,18,532320,42
627,m1711,20170222,2967,2957,0,0,0,2957,2957,0,0,0,0,42
628,m1711,20170223,2957,2957,0,0,0,2957,2957,0,0,0,0,42
629,m1711,20170224,2957,2957,2921,2926,2906,2906,2918,-51,-39,18,525340,38
630,m1711,20170227,2906,2918,2913,2913,2913,2913,2913,-5,-5,4,116520,42
631,m1711,20170228,2913,2913,0,0,0,2913,2913,0,0,0,0,42
632,m1711,20170301,2913,2913,2937,2937,2937,2937,2937,24,24,2,58740,42
633,m1711,20170302,2937,2937,2948,2969,2948,2964,2957,27,20,8,236580,40
634,m1711,20170303,2964,2957,0,0,0,2957,2957,0,0,0,0,40
635,m1711,20170306,2957,2957,2988,2988,2966,2966,2977,9,20,12,357240,44
636,m1711,20170307,2966,2977,2972,2983,2962,2963,2972,-14,-5,16,475660,38
637,m1711,20170308,2963,2972,2950,2950,2925,2925,2937,-47,-35,8,235000,40
638,m1711,20170309,2925,2937,2908,2931,2908,2931,2919,-6,-18,4,116780,40
639,m1711,20170310,2931,2919,2926,2926,2926,2926,2926,7,7,2,58520,40
640,m1711,20170313,2926,2926,2890,2917,2890,2914,2902,-12,-24,90,2612140,50
641,m1711,20170314,2914,2902,2907,2907,2899,2899,2903,-3,1,4,116120,48
642,m1711,20170315,2899,2903,2893,2893,2893,2893,2893,-10,-10,6,173580,42
643,m1711,20170316,2893,2893,2914,2914,2907,2907,2911,14,18,6,174700,42
644,m1711,20170317,2907,2911,2908,2908,2877,2877,2889,-34,-22,22,635660,34
645,m1711,20170320,2877,2889,0,0,0,2901,2901,12,12,0,0,34
646,m1711,20170321,2901,2901,2925,2925,2925,2925,2925,24,24,2,58500,34
647,m1711,20170322,2925,2925,0,0,0,2925,2925,0,0,0,0,34
648,m1711,20170323,2925,2925,2886,2886,2871,2871,2876,-54,-49,6,172580,38
649,m1711,20170324,2871,2876,2859,2859,2837,2839,2841,-37,-35,14,397820,36
650,m1711,20170327,2839,2841,2835,2835,2835,2835,2835,-6,-6,8,226800,36
651,m1711,20170328,2835,2835,0,0,0,2835,2835,0,0,0,0,36
652,m1711,20170329,2835,2835,2825,2825,2825,2825,2825,-10,-10,4,113000,36
653,m1711,20170330,2825,2825,2841,2841,2805,2807,2813,-18,-12,20,562640,42
654,m1711,20170331,2807,2813,2817,2819,2812,2815,2816,2,3,34,957740,50
655,m1711,20170405,2815,2816,2779,2783,2763,2783,2776,-33,-40,12,333160,42
656,m1711,20170406,2783,2776,2793,2793,2782,2782,2784,6,8,10,278420,44
657,m1711,20170407,2782,2784,2810,2812,2759,2759,2785,-25,1,38,1058440,56
658,m1711,20170410,2759,2785,2766,2800,2766,2783,2778,-2,-7,10,277880,56
659,m1711,20170411,2783,2778,2790,2790,2779,2790,2787,12,9,14,390300,54
660,m1711,20170412,2790,2787,2790,2835,2775,2814,2811,27,24,58,1630940,88
661,m1711,20170413,2814,2811,2815,2841,2813,2841,2819,30,8,64,1804160,118
662,m1711,20170414,2841,2819,0,0,0,2819,2819,0,0,0,0,118
663,m1711,20170417,2819,2819,2855,2869,2833,2833,2853,14,34,16,456620,120
664,m1711,20170418,2833,2853,0,0,0,2853,2853,0,0,0,0,120
665,m1711,20170419,2853,2853,2810,2853,2810,2849,2835,-4,-18,56,1588140,138
666,m1711,20170420,2849,2835,2844,2844,2844,2844,2844,9,9,4,113760,138
667,m1711,20170421,2844,2844,2848,2848,2841,2841,2844,-3,0,18,511940,134
668,m1711,20170424,2841,2844,2839,2891,2833,2848,2850,4,6,122,3477880,150
669,m1711,20170425,2848,2850,2860,2860,2855,2855,2856,5,6,36,1028360,150
670,m1711,20170426,2855,2856,2848,2853,2824,2829,2841,-27,-15,14,397800,152
671,m1711,20170427,2829,2841,2806,2858,2806,2808,2823,-33,-18,144,4066520,136
672,m1711,20170428,2808,2823,2836,2836,2813,2813,2817,-10,-6,22,619880,146
673,m1711,20170502,2813,2817,2865,2894,2865,2894,2884,77,67,28,807660,144
674,m1711,20170503,2894,2884,2894,2894,2881,2883,2883,-1,-1,22,634340,138
675,m1711,20170504,2883,2883,2876,2876,2876,2876,2876,-7,-7,2,57520,138
676,m1711,20170505,2876,2876,2887,2887,2859,2859,2875,-17,-1,16,460000,138
677,m1711,20170508,2859,2875,2850,2850,2845,2850,2848,-25,-27,6,170900,140
678,m1711,20170509,2850,2848,2826,2826,2826,2826,2826,-22,-22,2,56520,138
679,m1711,20170510,2826,2826,2857,2857,2851,2852,2853,26,27,26,741980,146
680,m1711,20170511,2852,2853,2863,2875,2835,2849,2857,-4,4,18,514380,152
681,m1711,20170512,2849,2857,2845,2845,2821,2821,2831,-36,-26,14,396400,154
682,m1711,20170515,2821,2831,2796,2809,2794,2808,2804,-23,-27,30,841300,176
683,m1711,20170516,2808,2804,2815,2815,2785,2792,2797,-12,-7,6,167840,176
684,m1711,20170517,2792,2797,2822,2836,2822,2831,2830,34,33,36,1018920,202
685,m1711,20170518,2831,2830,2793,2793,2791,2792,2792,-38,-38,10,279220,202
686,m1711,20170519,2792,2792,2774,2778,2759,2760,2770,-32,-22,28,775780,204
687,m1711,20170522,2760,2770,2773,2790,2764,2780,2769,10,-1,78,2160060,248
688,m1711,20170523,2780,2769,2770,2778,2742,2756,2769,-13,0,58,1606080,280
689,m1711,20170524,2756,2769,2765,2774,2741,2763,2756,-6,-13,32,881960,262
690,m1711,20170525,2763,2756,0,0,0,2756,2756,0,0,0,0,262
691,m1711,20170526,2756,2756,2726,2731,2726,2728,2727,-28,-29,14,381860,254
692,m1711,20170531,2728,2727,2686,2686,2632,2632,2657,-95,-70,16,425200,254
693,m1711,20170601,2632,2657,2642,2661,2640,2655,2646,-2,-11,24,635100,254
694,m1711,20170602,2655,2646,2643,2657,2643,2657,2650,11,4,4,106000,250
695,m1711,20170605,2657,2650,2678,2704,2676,2688,2687,38,37,14,376200,250
696,m1711,20170606,2688,2687,2678,2684,2678,2679,2680,-8,-7,16,428860,244
697,m1711,20170607,2679,2680,2720,2720,2689,2689,2703,9,23,6,162220,246
698,m1711,20170608,2689,2703,2619,2712,2619,2712,2694,9,-9,18,484920,246
699,m1711,20170609,2712,2694,2712,2718,2694,2694,2711,0,17,16,433800,238
700,m1711,20170612,2694,2711,2704,2705,2671,2690,2691,-21,-20,108,2906600,248
701,m1711,20170613,2690,2691,2665,2677,2665,2672,2671,-19,-20,32,854960,248
702,m1711,20170614,2672,2671,2685,2696,2685,2685,2687,14,16,16,430040,256
703,m1711,20170615,2685,2687,2693,2693,2661,2674,2675,-13,-12,10,267580,254
704,m1711,20170616,2674,2675,2676,2708,2676,2708,2697,33,22,20,539440,254
705,m1711,20170619,2708,2697,2701,2750,2701,2715,2714,18,17,22,597240,260
706,m1711,20170620,2715,2714,2716,2717,2706,2706,2712,-8,-2,24,651060,266
707,m1711,20170621,2706,2712,2693,2702,2693,2700,2698,-12,-14,12,323840,260
708,m1711,20170622,2700,2698,2664,2664,2664,2664,2664,-34,-34,10,266400,260
709,m1711,20170623,2664,2664,2637,2653,2637,2653,2646,-11,-18,46,1217240,284
710,m1711,20170626,2653,2646,2661,2664,2657,2664,2661,18,15,12,319420,286
711,m1711,20170627,2664,2661,2653,2653,2653,2653,2653,-8,-8,2,53060,286
712,m1711,20170628,2653,2653,2710,2710,2662,2662,2691,9,38,212,5705420,358
713,m1711,20170629,2662,2691,2673,2679,2673,2678,2677,-13,-14,20,535540,348
714,m1711,20170630,2678,2677,2688,2708,2654,2670,2687,-7,10,26,698720,334
715,m1711,20170703,2670,2687,2673,2790,2673,2789,2733,102,46,30,820160,334
716,m1711,20170704,2789,2733,2867,2867,2771,2804,2800,71,67,116,3248480,314
717,m1711,20170705,2804,2800,2786,2795,2784,2791,2790,-9,-10,16,446460,320
718,m1711,20170706,2791,2790,2815,2826,2807,2807,2816,17,26,40,1126440,348
719,m1711,20170707,2807,2816,2810,2842,2810,2832,2836,16,20,210,5956500,248
720,m1711,20170710,2832,2836,2853,2926,2833,2919,2907,83,71,58,1686580,250
721,m1711,20170711,2919,2907,2923,2953,2874,2910,2917,3,10,76,2217580,258
722,m1711,20170712,2910,2917,2912,2912,2911,2911,2911,-6,-6,4,116460,260
723,m1711,20170713,2911,2911,2915,2915,2854,2854,2872,-57,-39,40,1149100,260
724,m1711,20170714,2854,2872,2848,2849,2798,2807,2813,-65,-59,40,1125540,248
725,m1711,20170717,2807,2813,2827,2835,2814,2817,2821,4,8,32,902980,248
726,m1711,20170718,2817,2821,2868,2868,2832,2833,2839,12,18,80,2271860,254
727,m1711,20170719,2833,2839,2858,2860,2831,2831,2842,-8,3,46,1307500,250
728,m1711,20170720,2831,2842,2857,2860,2849,2860,2852,18,10,18,513480,240
729,m1711,20170721,2860,2852,2875,2888,2857,2878,2872,26,20,46,1321340,228
730,m1711,20170724,2878,2872,2869,2869,2801,2819,2822,-53,-50,34,959760,232
731,m1711,20170725,2819,2822,2832,2891,2832,2880,2870,58,48,30,861100,232
732,m1711,20170726,2880,2870,2871,2871,2825,2825,2845,-45,-25,40,1138260,240
733,m1711,20170727,2825,2845,2802,2841,2801,2834,2819,-11,-26,32,902080,242
734,m1711,20170728,2834,2819,2859,2860,2859,2860,2859,41,40,4,114380,240
735,m1711,20170731,2860,2859,2856,2881,2844,2847,2860,-12,1,60,1716280,224
736,m1711,20170801,2847,2860,2845,2863,2832,2860,2854,0,-6,34,970500,234
737,m1711,20170802,2860,2854,2846,2846,2805,2812,2815,-42,-39,44,1238760,248
738,m1711,20170803,2812,2815,2834,2834,2805,2805,2819,-10,4,60,1691500,234
739,m1711,20170804,2805,2819,2798,2806,2798,2806,2802,-13,-17,4,112080,232
740,m1711,20170807,2806,2802,2840,2840,2817,2817,2821,15,19,12,338620,234
741,m1711,20170808,2817,2821,2844,2853,2842,2850,2848,29,27,32,911580,220
742,m1711,20170809,2850,2848,2852,2852,2840,2843,2842,-5,-6,70,1989800,216
743,m1711,20170810,2843,2842,2841,2850,2837,2850,2845,8,3,22,626100,210
744,m1711,20170811,2850,2845,2848,2870,2754,2763,2803,-82,-42,150,4204920,222
745,m1711,20170814,2763,2803,2773,2773,2762,2766,2766,-37,-37,44,1217180,250
746,m1711,20170815,2766,2766,2765,2776,2765,2768,2771,2,5,28,776000,254
747,m1711,20170816,2768,2771,2755,2762,2738,2755,2751,-16,-20,48,1320740,268
748,m1711,20170817,2755,2751,2763,2772,2763,2769,2767,18,16,56,1549840,282
749,m1711,20170818,2769,2767,2775,2775,2761,2761,2766,-6,-1,16,442600,272
750,m1711,20170821,2761,2766,2763,2771,2763,2771,2765,5,-1,10,276540,270
751,m1711,20170822,2771,2765,2764,2775,2750,2772,2765,7,0,44,1216920,248
752,m1711,20170823,2772,2765,2751,2779,2751,2763,2770,-2,5,16,443260,246
753,m1711,20170824,2763,2770,2761,2761,2749,2759,2752,-11,-18,38,1045780,252
754,m1711,20170825,2759,2752,2755,2758,2755,2758,2755,6,3,8,220460,252
755,m1711,20170828,2758,2755,2771,2778,2767,2777,2773,22,18,46,1275860,222
756,m1711,20170829,2777,2773,2775,2775,2761,2765,2768,-8,-5,64,1772040,230
757,m1711,20170830,2765,2768,2767,2767,2758,2758,2762,-10,-6,4,110500,230
758,m1711,20170831,2758,2762,0,0,0,2760,2760,-2,-2,0,0,230
759,m1711,20170901,2760,2760,2755,2758,2755,2755,2756,-5,-4,54,1488340,244
760,m1711,20170904,2755,2756,2759,2765,2759,2765,2761,9,5,8,220940,246
761,m1711,20170905,2765,2761,2771,2771,2771,2771,2771,10,10,2,55420,244
762,m1711,20170906,2771,2771,2831,2831,2778,2778,2798,7,27,84,2350320,238
763,m1711,20170907,2778,2798,2792,2797,2775,2789,2788,-9,-10,30,836580,226
764,m1711,20170908,2789,2788,2765,2765,2753,2753,2756,-35,-32,8,220540,228
765,m1711,20170911,2753,2756,2752,2752,2752,2752,2752,-4,-4,2,55040,228
766,m1711,20170912,2752,2752,2769,2769,2769,2769,2769,17,17,4,110760,228
767,m1711,20170913,2769,2769,2756,2756,2716,2716,2746,-53,-23,18,494420,226
768,m1711,20170914,2716,2746,0,0,0,2746,2746,0,0,0,0,226
769,m1711,20170915,2746,2746,2760,2796,2754,2770,2766,24,20,34,940660,230
770,m1711,20170918,2770,2766,2785,2785,2753,2767,2763,1,-3,50,1381760,236
771,m1711,20170919,2767,2763,2773,2775,2773,2775,2774,12,11,14,388420,238
772,m1711,20170920,2775,2774,2773,2777,2773,2777,2774,3,0,8,221920,244
773,m1711,20170921,2777,2774,0,0,0,2774,2774,0,0,0,0,244
774,m1711,20170922,2774,2774,2798,2818,2798,2808,2812,34,38,118,3318240,252
775,m1711,20170925,2808,2812,2777,2848,2777,2838,2823,26,11,42,1185820,240
776,m1711,20170926,2838,2823,2800,2834,2800,2823,2822,0,-1,40,1128800,248
777,m1711,20170927,2823,2822,2820,2832,2810,2817,2821,-5,-1,34,959360,248
778,m1711,20170928,2817,2821,2820,2855,2751,2826,2797,5,-24,24,671440,238
779,m1711,20170929,2826,2797,2813,2826,2788,2789,2800,-8,3,32,896180,242
780,m1711,20171009,2789,2800,2896,2896,2821,2827,2855,27,55,60,1713220,234
781,m1711,20171010,2827,2855,2819,2831,2812,2812,2818,-43,-37,136,3832700,290
782,m1711,20171011,2812,2818,2807,2807,2807,2807,2807,-11,-11,6,168420,336
783,m1711,20171012,2807,2807,2811,2811,2805,2805,2808,-2,1,40,1123200,338
784,m1711,20171013,2805,2808,2816,2902,2816,2902,2870,94,62,1698,48732920,374
785,m1711,20171016,2902,2870,2918,2918,2875,2880,2890,10,20,84,2428260,320
786,m1711,20171017,2880,2890,2856,2919,2856,2906,2901,16,11,80,2321220,270
787,m1711,20171018,2906,2901,2885,2899,2885,2899,2888,-2,-13,8,231080,262
788,m1711,20171019,2899,2888,2881,2940,2881,2883,2896,-5,8,20,579320,248
789,m1711,20171020,2883,2896,0,0,0,2896,2896,0,0,0,0,248
790,m1711,20171023,2896,2896,2896,2896,2881,2890,2888,-6,-8,22,635500,226
791,m1711,20171024,2890,2888,2870,2908,2867,2908,2883,20,-5,32,922720,210
792,m1711,20171025,2908,2883,2876,2947,2876,2947,2925,64,42,22,643580,194
793,m1711,20171026,2947,2925,2910,2910,2880,2882,2898,-43,-27,62,1797000,132
794,m1711,20171027,2882,2898,2900,2939,2885,2910,2904,12,6,64,1858780,78
795,m1711,20171030,2910,2904,2895,2895,2858,2858,2882,-46,-22,74,2133300,46
796,m1711,20171031,2858,2882,2938,3026,2938,3026,2996,144,114,6,179800,42
797,m1711,20171101,3026,2996,2900,2900,2900,2900,2900,-96,-96,22,638000,42
798,m1711,20171102,2900,2900,2900,2900,2726,2726,2808,-174,-92,42,1179720,0
799,m1711,20171103,2726,2808,0,0,0,2808,2808,0,0,0,0,0
800,m1711,20171106,2808,2808,0,0,0,2808,2808,0,0,0,0,0
801,m1711,20171107,2808,2808,0,0,0,2808,2808,0,0,0,0,0
802,m1711,20171108,2808,2808,0,0,0,2808,2808,0,0,0,0,0
803,m1711,20171109,2808,2808,0,0,0,2808,2808,0,0,0,0,0
804,m1711,20171110,2808,2808,0,0,0,2808,2808,0,0,0,0,0
805,m1711,20171113,2808,2808,0,0,0,2808,2808,0,0,0,0,0
806,m1711,20171114,2808,2808,0,0,0,2840,2840,32,32,0,0,0
807,m1712,20170103,2830,2830,0,0,0,2830,2830,0,0,0,0,10
808,m1712,20170104,2830,2830,0,0,0,2830,2830,0,0,0,0,10
809,m1712,20170105,2830,2830,0,0,0,2830,2830,0,0,0,0,10
810,m1712,20170106,2830,2830,2809,2809,2809,2809,2809,-21,-21,2,56180,12
811,m1712,20170109,2809,2809,0,0,0,2809,2809,0,0,0,0,12
812,m1712,20170110,2809,2809,2874,2874,2785,2796,2810,-13,1,28,787060,32
813,m1712,20170111,2796,2810,2824,2826,2823,2826,2824,16,14,8,225960,32
814,m1712,20170112,2826,2824,2850,2850,2848,2848,2849,24,25,4,113960,36
815,m1712,20170113,2848,2849,2879,2907,2822,2902,2881,53,32,20,576200,30
816,m1712,20170116,2902,2881,2947,2947,2928,2928,2935,47,54,12,352200,40
817,m1712,20170117,2928,2935,2929,2936,2924,2935,2931,0,-4,10,293180,46
818,m1712,20170118,2935,2931,2934,2940,2934,2940,2937,9,6,18,528720,34
819,m1712,20170119,2940,2937,2921,2935,2916,2916,2923,-21,-14,8,233860,28
820,m1712,20170120,2916,2923,0,0,0,2923,2923,0,0,0,0,28
821,m1712,20170123,2923,2923,2912,2912,2912,2912,2912,-11,-11,4,116480,26
822,m1712,20170124,2912,2912,2911,2911,2911,2911,2911,-1,-1,2,58220,26
823,m1712,20170125,2911,2911,0,0,0,2911,2911,0,0,0,0,26
824,m1712,20170126,2911,2911,2862,2862,2862,2862,2862,-49,-49,4,114480,22
825,m1712,20170203,2862,2862,2850,2897,2848,2850,2876,-12,14,60,1726100,34
826,m1712,20170206,2850,2876,2928,2928,2928,2928,2928,52,52,2,58560,32
827,m1712,20170207,2928,2928,2929,2929,2894,2894,2906,-34,-22,6,174360,28
828,m1712,20170208,2894,2906,2882,2980,2881,2950,2934,44,28,64,1878060,22
829,m1712,20170209,2950,2934,2957,2989,2957,2966,2970,32,36,6,178240,20
830,m1712,20170210,2966,2970,2959,2959,2958,2958,2958,-12,-12,4,118340,18
831,m1712,20170213,2958,2958,2990,2990,2990,2990,2990,32,32,2,59800,16
832,m1712,20170214,2990,2990,0,0,0,2990,2990,0,0,0,0,16
833,m1712,20170215,2990,2990,2973,2973,2938,2946,2951,-44,-39,36,1062580,14
834,m1712,20170216,2946,2951,2979,2979,2979,2979,2979,28,28,4,119160,14
835,m1712,20170217,2979,2979,0,0,0,2979,2979,0,0,0,0,14
836,m1712,20170220,2979,2979,0,0,0,2976,2976,-3,-3,0,0,14
837,m1712,20170221,2976,2976,0,0,0,2976,2976,0,0,0,0,14
838,m1712,20170222,2976,2976,0,0,0,2972,2972,-4,-4,0,0,14
839,m1712,20170223,2972,2972,0,0,0,2972,2972,0,0,0,0,14
840,m1712,20170224,2972,2972,0,0,0,2968,2968,-4,-4,0,0,14
841,m1712,20170227,2968,2968,2963,2963,2963,2963,2963,-5,-5,2,59260,16
842,m1712,20170228,2963,2963,0,0,0,2945,2945,-18,-18,0,0,16
843,m1712,20170301,2945,2945,2970,2970,2952,2954,2958,9,13,6,177520,16
844,m1712,20170302,2954,2958,3002,3002,3002,3002,3002,44,44,2,60040,18
845,m1712,20170303,3002,3002,0,0,0,3002,3002,0,0,0,0,18
846,m1712,20170306,3002,3002,0,0,0,3002,3002,0,0,0,0,18
847,m1712,20170307,3002,3002,0,0,0,2977,2977,-25,-25,0,0,18
848,m1712,20170308,2977,2977,2948,2948,2948,2948,2948,-29,-29,2,58960,16
849,m1712,20170309,2948,2948,2939,2939,2939,2939,2939,-9,-9,2,58780,16
850,m1712,20170310,2939,2939,2939,2939,2922,2922,2930,-17,-9,4,117220,14
851,m1712,20170313,2922,2930,0,0,0,2930,2930,0,0,0,0,14
852,m1712,20170314,2930,2930,0,0,0,2909,2909,-21,-21,0,0,14
853,m1712,20170315,2909,2909,0,0,0,2909,2909,0,0,0,0,14
854,m1712,20170316,2909,2909,2916,2916,2916,2916,2916,7,7,2,58320,12
855,m1712,20170317,2916,2916,0,0,0,2916,2916,0,0,0,0,12
856,m1712,20170320,2916,2916,0,0,0,2916,2916,0,0,0,0,12
857,m1712,20170321,2916,2916,0,0,0,2916,2916,0,0,0,0,12
858,m1712,20170322,2916,2916,0,0,0,2916,2916,0,0,0,0,12
859,m1712,20170323,2916,2916,2886,2895,2886,2891,2890,-25,-26,6,173440,14
860,m1712,20170324,2891,2890,0,0,0,2890,2890,0,0,0,0,14
861,m1712,20170327,2890,2890,0,0,0,2890,2890,0,0,0,0,14
862,m1712,20170328,2890,2890,0,0,0,2890,2890,0,0,0,0,14
863,m1712,20170329,2890,2890,0,0,0,2890,2890,0,0,0,0,14
864,m1712,20170330,2890,2890,0,0,0,2890,2890,0,0,0,0,14
865,m1712,20170331,2890,2890,2833,2842,2824,2827,2833,-63,-57,354,10030580,290
866,m1712,20170405,2827,2833,2970,2970,2767,2767,2868,-66,35,4,114740,292
867,m1712,20170406,2767,2868,2807,2838,2807,2818,2815,-50,-53,74,2083780,354
868,m1712,20170407,2818,2815,2796,2807,2796,2800,2804,-15,-11,28,785320,376
869,m1712,20170410,2800,2804,2809,2824,2809,2824,2818,20,14,22,620020,376
870,m1712,20170411,2824,2818,2811,2821,2811,2821,2813,3,-5,12,337600,376
871,m1712,20170412,2821,2813,2845,2851,2826,2831,2834,18,21,230,6519000,400
872,m1712,20170413,2831,2834,2847,2847,2847,2847,2847,13,13,2,56940,400
873,m1712,20170414,2847,2847,2873,2879,2868,2879,2873,32,26,22,632080,394
874,m1712,20170417,2879,2873,2856,2876,2854,2855,2865,-18,-8,16,458520,392
875,m1712,20170418,2855,2865,2852,2852,2852,2852,2852,-13,-13,2,57040,390
876,m1712,20170419,2852,2852,2835,2877,2835,2866,2848,14,-4,48,1367040,370
877,m1712,20170420,2866,2848,2865,2865,2856,2861,2859,13,11,22,629140,360
878,m1712,20170421,2861,2859,2845,2847,2839,2839,2844,-20,-15,30,853440,372
879,m1712,20170424,2839,2844,2877,2882,2868,2882,2877,38,33,42,1208540,348
880,m1712,20170425,2882,2877,2864,2865,2861,2861,2863,-16,-14,10,286340,356
881,m1712,20170426,2861,2863,2875,2875,2836,2836,2850,-27,-13,6,171020,356
882,m1712,20170427,2836,2850,2819,2819,2819,2819,2819,-31,-31,8,225520,348
883,m1712,20170428,2819,2819,0,0,0,2819,2819,0,0,0,0,348
884,m1712,20170502,2819,2819,2865,2882,2865,2882,2873,63,54,4,114940,346
885,m1712,20170503,2882,2873,2880,2880,2880,2880,2880,7,7,2,57600,344
886,m1712,20170504,2880,2880,2879,2894,2877,2894,2884,14,4,36,1038300,322
887,m1712,20170505,2894,2884,2875,2875,2875,2875,2875,-9,-9,2,57500,322
888,m1712,20170508,2875,2875,2864,2867,2854,2854,2859,-21,-16,10,285980,326
889,m1712,20170509,2854,2859,2847,2847,2834,2834,2841,-25,-18,6,170480,328
890,m1712,20170510,2834,2841,2845,2863,2845,2863,2859,22,18,14,400320,318
891,m1712,20170511,2863,2859,2859,2859,2859,2859,2859,0,0,6,171540,318
892,m1712,20170512,2859,2859,2835,2846,2830,2830,2837,-29,-22,6,170220,318
893,m1712,20170515,2830,2837,0,0,0,2837,2837,0,0,0,0,318
894,m1712,20170516,2837,2837,2795,2795,2795,2795,2795,-42,-42,2,55900,318
895,m1712,20170517,2795,2795,2826,2835,2821,2835,2825,40,30,48,1356160,306
896,m1712,20170518,2835,2825,2801,2810,2801,2802,2803,-23,-22,36,1009300,328
897,m1712,20170519,2802,2803,2791,2791,2776,2776,2782,-27,-21,12,333880,326
898,m1712,20170522,2776,2782,2780,2792,2780,2792,2785,10,3,20,557000,326
899,m1712,20170523,2792,2785,0,0,0,2780,2780,-5,-5,0,0,326
900,m1712,20170524,2780,2780,2746,2759,2746,2759,2752,-21,-28,4,110100,326
901,m1712,20170525,2759,2752,0,0,0,2752,2752,0,0,0,0,326
902,m1712,20170526,2752,2752,2735,2735,2735,2735,2735,-17,-17,4,109400,326
903,m1712,20170531,2735,2735,2698,2701,2656,2656,2687,-79,-48,20,537540,324
904,m1712,20170601,2656,2687,2654,2737,2649,2737,2699,50,12,74,1997480,380
905,m1712,20170602,2737,2699,2678,2680,2659,2662,2672,-37,-27,90,2405360,354
906,m1712,20170605,2662,2672,2675,2693,2671,2671,2685,-1,13,28,752040,372
907,m1712,20170606,2671,2685,2678,2678,2678,2678,2678,-7,-7,2,53560,370
908,m1712,20170607,2678,2678,2719,2744,2689,2690,2698,12,20,70,1888640,360
909,m1712,20170608,2690,2698,2707,2721,2703,2707,2709,9,11,118,3196720,370
910,m1712,20170609,2707,2709,2722,2722,2722,2722,2722,13,13,2,54440,368
911,m1712,20170612,2722,2722,0,0,0,2705,2705,-17,-17,0,0,368
912,m1712,20170613,2705,2705,2690,2690,2679,2684,2682,-21,-23,86,2307260,414
913,m1712,20170614,2684,2682,2693,2695,2692,2693,2693,11,11,38,1023400,440
914,m1712,20170615,2693,2693,2685,2685,2685,2685,2685,-8,-8,6,161100,442
915,m1712,20170616,2685,2685,2694,2703,2694,2702,2698,17,13,8,215860,446
916,m1712,20170619,2702,2698,2717,2724,2710,2724,2717,26,19,12,326040,448
917,m1712,20170620,2724,2717,0,0,0,2717,2717,0,0,0,0,448
918,m1712,20170621,2717,2717,2712,2712,2712,2712,2712,-5,-5,6,162720,450
919,m1712,20170622,2712,2712,0,0,0,2712,2712,0,0,0,0,450
920,m1712,20170623,2712,2712,2655,2663,2651,2660,2655,-52,-57,22,584300,428
921,m1712,20170626,2660,2655,2667,2674,2661,2674,2668,19,13,12,320220,426
922,m1712,20170627,2674,2668,2673,2681,2657,2667,2662,-1,-6,50,1331280,464
923,m1712,20170628,2667,2662,2683,2683,2667,2667,2675,5,13,4,107000,462
924,m1712,20170629,2667,2675,2739,2747,2668,2675,2713,0,38,78,2116320,430
925,m1712,20170630,2675,2713,2655,2664,2655,2664,2655,-49,-58,82,2177280,426
926,m1712,20170703,2664,2655,2682,2787,2682,2787,2779,132,124,98,2723860,448
927,m1712,20170704,2787,2779,2740,2806,2740,2806,2790,27,11,44,1227780,482
928,m1712,20170705,2806,2790,2797,2798,2784,2784,2795,-6,5,18,503240,494
929,m1712,20170706,2784,2795,2819,2827,2810,2813,2818,18,23,78,2198360,512
930,m1712,20170707,2813,2818,2815,2841,2815,2839,2831,21,13,44,1245940,544
931,m1712,20170710,2839,2831,2858,2941,2846,2933,2932,102,101,766,22464780,684
932,m1712,20170711,2933,2932,2933,2962,2913,2922,2934,-10,2,126,3698060,678
933,m1712,20170712,2922,2934,2921,2950,2918,2918,2929,-16,-5,6,175780,676
934,m1712,20170713,2918,2929,2862,2874,2856,2874,2861,-55,-68,18,515080,662
935,m1712,20170714,2874,2861,2837,2847,2793,2809,2803,-52,-58,76,2130720,600
936,m1712,20170717,2809,2803,2817,2817,2813,2813,2816,10,13,14,394240,588
937,m1712,20170718,2813,2816,2847,2847,2835,2835,2839,19,23,10,283980,588
938,m1712,20170719,2835,2839,2855,2856,2839,2839,2849,0,10,12,341880,588
939,m1712,20170720,2839,2849,2854,2854,2838,2838,2848,-11,-1,12,341800,584
940,m1712,20170721,2838,2848,2880,2882,2868,2882,2878,34,30,42,1209060,592
941,m1712,20170724,2882,2878,2828,2830,2815,2830,2824,-48,-54,32,903720,570
942,m1712,20170725,2830,2824,2839,2885,2828,2885,2870,61,46,22,631420,568
943,m1712,20170726,2885,2870,2832,2833,2825,2833,2831,-37,-39,40,1132400,578
944,m1712,20170727,2833,2831,2820,2841,2820,2841,2835,10,4,42,1190880,578
945,m1712,20170728,2841,2835,2864,2864,2864,2864,2864,29,29,4,114560,578
946,m1712,20170731,2864,2864,2877,2877,2847,2853,2861,-11,-3,10,286140,576
947,m1712,20170801,2853,2861,2862,2862,2853,2853,2855,-8,-6,24,685320,564
948,m1712,20170802,2853,2855,2854,2854,2805,2817,2816,-38,-39,82,2309540,506
949,m1712,20170803,2817,2816,2842,2842,2795,2795,2814,-21,-2,58,1632140,518
950,m1712,20170804,2795,2814,2802,2809,2794,2803,2801,-11,-13,26,728340,518
951,m1712,20170807,2803,2801,2813,2831,2797,2812,2828,11,27,178,5034880,634
952,m1712,20170808,2812,2828,2824,2862,2824,2854,2844,26,16,84,2389740,638
953,m1712,20170809,2854,2844,2853,2854,2853,2854,2853,10,9,10,285340,638
954,m1712,20170810,2854,2853,2853,2855,2850,2853,2850,0,-3,84,2394760,590
955,m1712,20170811,2853,2850,2870,2873,2760,2764,2785,-86,-65,352,9804520,818
956,m1712,20170814,2764,2785,2767,2770,2759,2770,2765,-15,-20,154,4258120,842
957,m1712,20170815,2770,2765,2759,2770,2759,2768,2765,3,0,10,276520,848
958,m1712,20170816,2768,2765,2759,2763,2754,2756,2759,-9,-6,54,1490360,852
959,m1712,20170817,2756,2759,2763,2768,2762,2768,2763,9,4,32,884380,862
960,m1712,20170818,2768,2763,2768,2774,2766,2768,2768,5,5,384,10629500,486
961,m1712,20170821,2768,2768,2765,2765,2765,2765,2765,-3,-3,2,55300,486
962,m1712,20170822,2765,2765,2761,2771,2744,2769,2762,4,-3,80,2210280,454
963,m1712,20170823,2769,2762,2764,2772,2764,2766,2769,4,7,32,886160,468
964,m1712,20170824,2766,2769,2763,2766,2746,2766,2755,-3,-14,58,1598400,462
965,m1712,20170825,2766,2755,0,0,0,2764,2764,9,9,0,0,462
966,m1712,20170828,2764,2764,0,0,0,2776,2776,12,12,0,0,462
967,m1712,20170829,2776,2776,2766,2772,2759,2759,2766,-17,-10,20,553260,456
968,m1712,20170830,2759,2766,2759,2759,2743,2743,2751,-23,-15,14,385200,456
969,m1712,20170831,2743,2751,2740,2740,2735,2735,2738,-16,-13,8,219100,452
970,m1712,20170901,2735,2738,2747,2747,2747,2747,2747,9,9,2,54940,452
971,m1712,20170904,2747,2747,2746,2775,2746,2775,2762,28,15,14,386720,448
972,m1712,20170905,2775,2762,2764,2838,2762,2764,2768,2,6,48,1328920,438
973,m1712,20170906,2764,2768,2830,2830,2771,2777,2791,9,23,46,1284160,438
974,m1712,20170907,2777,2791,2775,2775,2763,2763,2771,-28,-20,30,831340,458
975,m1712,20170908,2763,2771,2764,2774,2751,2757,2767,-14,-4,188,5202180,500
976,m1712,20170911,2757,2767,2746,2746,2743,2746,2745,-21,-22,82,2251100,442
977,m1712,20170912,2746,2745,2750,2750,2745,2745,2747,0,2,4,109900,442
978,m1712,20170913,2745,2747,2749,2749,2718,2718,2723,-29,-24,28,762700,464
979,m1712,20170914,2718,2723,2727,2736,2727,2736,2732,13,9,8,218560,460
980,m1712,20170915,2736,2732,2763,2765,2741,2765,2755,33,23,36,992000,444
981,m1712,20170918,2765,2755,2742,2762,2742,2761,2755,6,0,18,496040,436
982,m1712,20170919,2761,2755,2764,2792,2764,2772,2773,17,18,8,221840,438
983,m1712,20170920,2772,2773,2752,2752,2752,2752,2752,-21,-21,6,165120,438
984,m1712,20170921,2752,2752,2752,2766,2741,2760,2752,8,0,44,1211260,438
985,m1712,20170922,2760,2752,2767,2807,2767,2805,2796,53,44,64,1789500,406
986,m1712,20170925,2805,2796,2820,2820,2804,2817,2809,21,13,70,1966660,388
987,m1712,20170926,2817,2809,2802,2804,2783,2796,2795,-13,-14,22,615000,384
988,m1712,20170927,2796,2795,2796,2796,2775,2785,2783,-10,-12,26,723740,388
989,m1712,20170928,2785,2783,2791,2791,2779,2779,2785,-4,2,4,111400,386
990,m1712,20170929,2779,2785,2760,2760,2756,2756,2757,-29,-28,16,441160,384
991,m1712,20171009,2756,2757,2802,2802,2791,2791,2797,34,40,20,559480,386
992,m1712,20171010,2791,2797,2801,2801,2775,2775,2791,-22,-6,12,335000,386
993,m1712,20171011,2775,2791,2794,2794,2769,2769,2785,-22,-6,6,167140,380
994,m1712,20171012,2769,2785,0,0,0,2785,2785,0,0,0,0,380
995,m1712,20171013,2785,2785,2774,2868,2772,2858,2854,73,69,104,2968620,400
996,m1712,20171016,2858,2854,2869,2869,2854,2863,2859,9,5,46,1315200,396
997,m1712,20171017,2863,2859,2872,2876,2833,2847,2856,-12,-3,30,857020,398
998,m1712,20171018,2847,2856,2852,2855,2842,2842,2850,-14,-6,14,399100,400
999,m1712,20171019,2842,2850,2848,2860,2848,2855,2855,5,5,22,628140,410
1000,m1712,20171020,2855,2855,2852,2861,2850,2859,2853,4,-2,52,1484000,442
1001,m1712,20171023,2859,2853,2870,2870,2836,2840,2852,-13,-1,42,1198080,436
1002,m1712,20171024,2840,2852,2875,2875,2875,2875,2875,23,23,2,57500,436
1003,m1712,20171025,2875,2875,2857,2857,2834,2834,2852,-41,-23,10,285240,442
1004,m1712,20171026,2834,2852,2850,2850,2838,2838,2844,-14,-8,10,284400,442
1005,m1712,20171027,2838,2844,2823,2823,2823,2823,2823,-21,-21,4,112920,446
1006,m1712,20171030,2823,2823,2820,2825,2820,2825,2822,2,-1,14,395200,456
1007,m1712,20171031,2825,2822,2810,2821,2810,2818,2815,-4,-7,74,2083440,460
1008,m1712,20171101,2818,2815,2817,2822,2812,2813,2815,-2,0,120,3378260,540
1009,m1712,20171102,2813,2815,2805,2832,2805,2832,2826,17,11,536,15149120,840
1010,m1712,20171103,2832,2826,2832,2855,2828,2836,2838,10,12,1094,31055940,1388
1011,m1712,20171106,2836,2838,2830,2844,2808,2810,2830,-28,-8,1324,37470320,1480
1012,m1712,20171107,2810,2830,2797,2841,2797,2826,2827,-4,-3,3778,106805220,1646
1013,m1712,20171108,2826,2827,2828,2843,2820,2839,2834,12,7,212,6009960,1624
1014,m1712,20171109,2839,2834,2838,2849,2838,2848,2845,14,11,88,2503740,1582
1015,m1712,20171110,2848,2845,2897,2897,2821,2821,2845,-24,0,28,796820,1574
1016,m1712,20171113,2821,2845,2857,2860,2849,2860,2855,15,10,6,171320,1572
1017,m1712,20171114,2860,2855,2843,2843,2838,2838,2840,-17,-15,4,113620,1570
1018,m1712,20171115,2838,2840,0,0,0,2840,2840,0,0,0,0,1570
1019,m1712,20171116,2840,2840,2885,2885,2836,2884,2881,44,41,96,2766140,1570
1020,m1712,20171117,2884,2881,2881,2881,2881,2881,2881,0,0,86,2477660,1484
1021,m1712,20171120,2881,2881,0,0,0,2881,2881,0,0,0,0,1484
1022,m1712,20171121,2881,2881,2841,2841,2841,2841,2841,-40,-40,2,56820,1484
1023,m1712,20171122,2841,2841,2949,2949,2949,2949,2949,108,108,4,117960,1480
1024,m1712,20171123,2949,2949,2952,2952,2937,2937,2947,-12,-2,8,235820,1476
1025,m1712,20171124,2937,2947,0,0,0,2947,2947,0,0,0,0,1476
1026,m1712,20171127,2947,2947,0,0,0,2940,2940,-7,-7,0,0,1476
1027,m1712,20171128,2940,2940,0,0,0,2940,2940,0,0,0,0,1476
1028,m1712,20171129,2940,2940,0,0,0,2929,2929,-11,-11,0,0,1476
1029,m1712,20171130,2929,2929,2901,2902,2901,2902,2901,-27,-28,12,348140,1464
1030,m1712,20171201,2902,2901,2901,2901,2900,2900,2900,-1,-1,36,1044020,1428
1031,m1712,20171204,2900,2900,0,0,0,2900,2900,0,0,0,0,1428
1032,m1712,20171205,2900,2900,2885,2889,2885,2889,2886,-11,-14,40,1154400,1428
1033,m1712,20171206,2889,2886,0,0,0,2886,2886,0,0,0,0,1428
1034,m1712,20171207,2886,2886,0,0,0,2886,2886,0,0,0,0,1428
1035,m1712,20171208,2886,2886,0,0,0,2886,2886,0,0,0,0,628
1036,m1712,20171211,2886,2886,2947,2947,2940,2940,2943,54,57,616,18134400,170
1037,m1712,20171212,2940,2943,2945,2945,2945,2945,2945,2,2,78,2297100,170
1038,m1712,20171213,2945,2945,0,0,0,2945,2945,0,0,0,0,12
1039,m1712,20171214,2945,2945,2945,2945,2945,2945,2939,0,-6,12,353400,0
1040,m1801,20170117,2935,2935,2945,2945,2892,2904,2910,-31,-25,14798,430766260,10066
1041,m1801,20170118,2904,2910,2908,2925,2881,2890,2894,-20,-16,14678,424830580,17546
1042,m1801,20170119,2890,2894,2890,2907,2882,2898,2894,4,0,8452,244650660,20476
1043,m1801,20170120,2898,2894,2892,2903,2878,2880,2892,-14,-2,14892,430736380,28478
1044,m1801,20170123,2880,2892,2885,2895,2874,2890,2883,-2,-9,10116,291742380,34778
1045,m1801,20170124,2890,2883,2884,2896,2879,2892,2889,9,6,4610,133192000,35610
1046,m1801,20170125,2892,2889,2888,2893,2845,2845,2860,-44,-29,16466,470932520,45386
1047,m1801,20170126,2845,2860,2847,2879,2847,2870,2864,10,4,6648,190425200,46500
1048,m1801,20170203,2870,2864,2850,2879,2830,2866,2868,2,4,20850,598161220,63792
1049,m1801,20170206,2866,2868,2865,2910,2863,2904,2891,36,23,31632,914679040,74512
1050,m1801,20170207,2904,2891,2901,2920,2900,2915,2910,24,19,22952,667909720,85436
1051,m1801,20170208,2915,2910,2913,2958,2893,2956,2939,46,29,19058,560194060,83726
1052,m1801,20170209,2956,2939,2960,2973,2943,2945,2958,6,19,11010,325755700,85734
1053,m1801,20170210,2945,2958,2949,2979,2943,2979,2956,21,-2,15574,460437640,89738
1054,m1801,20170213,2979,2956,2976,2998,2961,2971,2978,15,22,33720,1004477700,102652
1055,m1801,20170214,2971,2978,2972,2983,2947,2947,2963,-31,-15,33962,1006318260,107726
1056,m1801,20170215,2947,2963,2959,2965,2925,2935,2944,-28,-19,35884,1056689100,117906
1057,m1801,20170216,2935,2944,2930,2983,2922,2962,2962,18,18,32772,970845600,119974
1058,m1801,20170217,2962,2962,2960,2984,2920,2931,2941,-31,-21,59954,1763301460,153518
1059,m1801,20170220,2931,2941,2932,2949,2925,2947,2939,6,-2,11208,329403560,153756
1060,m1801,20170221,2947,2939,2945,2983,2945,2968,2965,29,26,16108,477604160,149984
1061,m1801,20170222,2968,2965,2965,2974,2938,2948,2950,-17,-15,18826,555452880,157544
1062,m1801,20170223,2948,2950,2945,2960,2922,2923,2942,-27,-8,23422,689278440,162264
1063,m1801,20170224,2923,2942,2927,2932,2896,2919,2913,-23,-29,29360,855393160,167108
1064,m1801,20170227,2919,2913,2921,2939,2910,2935,2927,22,14,19036,557281320,171138
1065,m1801,20170228,2935,2927,2936,2946,2927,2931,2934,4,7,19482,571767800,167934
1066,m1801,20170301,2931,2934,2928,2974,2928,2962,2953,28,19,42172,1245550940,160552
1067,m1801,20170302,2962,2953,2962,2992,2960,2990,2979,37,26,29994,893670640,160928
1068,m1801,20170303,2990,2979,2985,2985,2960,2973,2972,-6,-7,14804,440111240,159142
1069,m1801,20170306,2973,2972,2977,2988,2963,2976,2974,4,2,50704,1508081940,160092
1070,m1801,20170307,2976,2974,2976,2985,2961,2965,2971,-9,-3,40320,1198116080,161622
1071,m1801,20170308,2965,2971,2967,2967,2925,2925,2938,-46,-33,31002,910907280,163878
1072,m1801,20170309,2925,2938,2922,2939,2919,2930,2929,-8,-9,31638,926765860,172622
1073,m1801,20170310,2930,2929,2925,2936,2901,2905,2913,-24,-16,33778,984156220,187960
1074,m1801,20170313,2905,2913,2905,2922,2897,2914,2909,1,-4,22018,640644720,192568
1075,m1801,20170314,2914,2909,2908,2930,2890,2895,2909,-14,0,30278,880930960,204826
1076,m1801,20170315,2895,2909,2898,2924,2872,2918,2907,9,-2,52210,1517893940,227352
1077,m1801,20170316,2918,2907,2921,2932,2904,2921,2916,14,9,57832,1686417280,229496
1078,m1801,20170317,2921,2916,2925,2927,2889,2908,2902,-8,-14,31522,914797220,232340
1079,m1801,20170320,2908,2902,2902,2936,2891,2930,2919,28,17,34452,1005934120,223882
1080,m1801,20170321,2930,2919,2921,2938,2899,2906,2915,-13,-4,28496,830765840,227782
1081,m1801,20170322,2906,2915,2901,2912,2883,2907,2900,-8,-15,42090,1221002660,234832
1082,m1801,20170323,2907,2900,2900,2910,2870,2873,2888,-27,-12,67736,1956292020,260212
1083,m1801,20170324,2873,2888,2878,2886,2850,2856,2862,-32,-26,32316,925190100,265952
1084,m1801,20170327,2856,2862,2854,2860,2825,2844,2843,-18,-19,40320,1146555420,263136
1085,m1801,20170328,2844,2843,2840,2850,2833,2836,2841,-7,-2,20668,587323900,260520
1086,m1801,20170329,2836,2841,2837,2855,2830,2851,2842,10,1,33802,960915540,260376
1087,m1801,20170330,2851,2842,2854,2854,2812,2819,2829,-23,-13,43936,1243232640,273206
1088,m1801,20170331,2819,2829,2808,2835,2806,2820,2823,-9,-6,25568,721804320,275166
1089,m1801,20170405,2820,2823,2800,2811,2780,2801,2796,-22,-27,45194,1264070400,297268
1090,m1801,20170406,2801,2796,2798,2810,2790,2799,2798,3,2,48488,1356778400,309454
1091,m1801,20170407,2799,2798,2801,2805,2771,2774,2784,-24,-14,70062,1950726940,334590
1092,m1801,20170410,2774,2784,2776,2810,2776,2798,2794,14,10,56676,1583781080,326120
1093,m1801,20170411,2798,2794,2802,2804,2784,2794,2793,0,-1,55578,1552295900,335824
1094,m1801,20170412,2794,2793,2783,2833,2778,2817,2809,24,16,105056,2951738520,330420
1095,m1801,20170413,2817,2809,2817,2868,2812,2865,2843,56,34,76372,2171514820,318698
1096,m1801,20170414,2865,2843,2876,2876,2850,2859,2865,16,22,59634,1708680460,312378
1097,m1801,20170417,2859,2865,2861,2882,2844,2859,2859,-6,-6,85374,2441330000,335254
1098,m1801,20170418,2859,2859,2859,2866,2840,2845,2852,-14,-7,71780,2047724920,342152
1099,m1801,20170419,2845,2852,2842,2885,2824,2881,2851,29,-1,114764,3272857540,351292
1100,m1801,20170420,2881,2851,2844,2869,2841,2855,2854,4,3,155492,4439024980,358966
1101,m1801,20170421,2855,2854,2855,2861,2832,2841,2843,-13,-11,66390,1888122920,356080
1102,m1801,20170424,2841,2843,2840,2876,2829,2867,2858,24,15,84048,2402259840,362258
1103,m1801,20170425,2867,2858,2866,2876,2858,2868,2867,10,9,73858,2117970660,364488
1104,m1801,20170426,2868,2867,2872,2874,2828,2830,2848,-37,-19,106096,3021985340,381256
1105,m1801,20170427,2830,2848,2830,2847,2811,2814,2828,-34,-20,169920,4805353260,390384
1106,m1801,20170428,2814,2828,2820,2828,2808,2815,2820,-13,-8,68438,1930113760,394602
1107,m1801,20170502,2815,2820,2845,2886,2837,2880,2869,60,49,95774,2747959180,385364
1108,m1801,20170503,2880,2869,2872,2879,2858,2867,2867,-2,-2,70218,2013560980,371136
1109,m1801,20170504,2867,2867,2870,2881,2858,2874,2871,7,4,83360,2393843800,373972
1110,m1801,20170505,2874,2871,2870,2891,2843,2849,2869,-22,-2,115962,3327686680,376674
1111,m1801,20170508,2849,2869,2861,2878,2832,2832,2854,-37,-15,115376,3292927680,398054
1112,m1801,20170509,2832,2854,2835,2840,2823,2829,2831,-25,-23,85236,2413854640,410590
1113,m1801,20170510,2829,2831,2829,2855,2826,2850,2846,19,15,87912,2502249980,427410
1114,m1801,20170511,2850,2846,2845,2862,2832,2853,2846,7,0,118906,3384383560,444506
1115,m1801,20170512,2853,2846,2853,2853,2808,2811,2823,-35,-23,129222,3648501140,472108
1116,m1801,20170515,2811,2823,2811,2818,2801,2804,2809,-19,-14,79254,2226740540,485920
1117,m1801,20170516,2804,2809,2812,2818,2779,2791,2796,-18,-13,133914,3744452020,512654
1118,m1801,20170517,2791,2796,2796,2831,2794,2827,2814,31,18,102658,2888803860,506048
1119,m1801,20170518,2827,2814,2823,2834,2777,2794,2797,-20,-17,106740,2986432880,533512
1120,m1801,20170519,2794,2797,2775,2791,2763,2768,2773,-29,-24,157428,4365592600,561380
1121,m1801,20170522,2768,2773,2771,2791,2758,2776,2776,3,3,106002,2943451220,564572
1122,m1801,20170523,2776,2776,2789,2789,2763,2770,2772,-6,-4,88866,2463537820,566070
1123,m1801,20170524,2770,2772,2773,2778,2743,2764,2758,-8,-14,122114,3368429560,583278
1124,m1801,20170525,2764,2758,2766,2773,2756,2763,2765,5,7,62076,1716585620,580702
1125,m1801,20170526,2763,2765,2767,2767,2721,2730,2737,-35,-28,122874,3363525500,603122
1126,m1801,20170531,2730,2737,2711,2711,2644,2652,2673,-85,-64,150836,4032270260,615888
1127,m1801,20170601,2652,2673,2665,2666,2650,2665,2659,-8,-14,96366,2562697700,618786
1128,m1801,20170602,2665,2659,2670,2685,2644,2662,2664,3,5,90858,2421138340,624036
1129,m1801,20170605,2662,2664,2662,2700,2662,2683,2686,19,22,116632,3132854480,617272
1130,m1801,20170606,2683,2686,2685,2698,2675,2685,2686,-1,0,65876,1769734040,627750
1131,m1801,20170607,2685,2686,2686,2718,2681,2701,2704,15,18,156600,4235238820,627204
1132,m1801,20170608,2701,2704,2710,2723,2705,2721,2715,17,11,108608,2949030940,639620
1133,m1801,20170609,2721,2715,2729,2744,2720,2721,2729,6,14,135558,3699409640,649292
1134,m1801,20170612,2721,2729,2729,2732,2703,2713,2716,-16,-13,161024,4374095380,671134
1135,m1801,20170613,2713,2716,2704,2704,2685,2699,2695,-17,-21,120216,3240362400,691398
1136,m1801,20170614,2699,2695,2700,2726,2700,2715,2713,20,18,135664,3680852240,672106
1137,m1801,20170615,2715,2713,2716,2725,2690,2701,2703,-12,-10,148432,4012551060,695650
1138,m1801,20170616,2701,2703,2695,2740,2683,2722,2717,19,14,178538,4851526440,682624
1139,m1801,20170619,2722,2717,2721,2762,2711,2743,2735,26,18,185156,5065520560,690760
1140,m1801,20170620,2743,2735,2743,2751,2727,2744,2739,9,4,148296,4063050060,701734
1141,m1801,20170621,2744,2739,2738,2738,2713,2724,2723,-15,-16,115128,3135122340,700614
1142,m1801,20170622,2724,2723,2723,2730,2680,2687,2696,-36,-27,216570,5840823720,701236
1143,m1801,20170623,2687,2696,2683,2688,2658,2674,2671,-22,-25,194806,5203789080,723342
1144,m1801,20170626,2674,2671,2676,2693,2662,2688,2680,17,9,145622,3903943460,757230
1145,m1801,20170627,2688,2680,2689,2697,2683,2692,2689,12,9,157426,4234755620,784672
1146,m1801,20170628,2692,2689,2696,2704,2676,2684,2691,-5,2,163434,4398296820,828708
1147,m1801,20170629,2684,2691,2686,2697,2680,2689,2688,-2,-3,217452,5846216220,842096
1148,m1801,20170630,2689,2688,2693,2717,2670,2679,2688,-9,0,259318,6972988980,885484
1149,m1801,20170703,2679,2688,2680,2812,2680,2808,2779,120,91,436048,12119380160,893240
1150,m1801,20170704,2808,2779,2819,2830,2797,2825,2814,46,35,359302,10113560820,937100
1151,m1801,20170705,2825,2814,2825,2834,2802,2818,2816,4,2,193950,5463166260,951362
1152,m1801,20170706,2818,2816,2816,2855,2816,2838,2839,22,23,476554,13530838360,1033336
1153,m1801,20170707,2838,2839,2833,2868,2832,2862,2855,23,16,264202,7543384940,1054696
1154,m1801,20170710,2862,2855,2871,2981,2864,2957,2925,102,70,758118,22180801480,1181606
1155,m1801,20170711,2957,2925,2958,2987,2921,2953,2958,28,33,568910,16833840620,1133874
1156,m1801,20170712,2953,2958,2934,2962,2934,2946,2948,-12,-10,313970,9258770580,1162596
1157,m1801,20170713,2946,2948,2940,2955,2862,2876,2898,-72,-50,686248,19892369020,1098158
1158,m1801,20170714,2876,2898,2865,2873,2802,2825,2835,-73,-63,583450,16541024980,1052978
1159,m1801,20170717,2825,2835,2837,2844,2820,2826,2830,-9,-5,420820,11910235380,1084620
1160,m1801,20170718,2826,2830,2838,2859,2833,2849,2845,19,15,447834,12743755200,1163362
1161,m1801,20170719,2849,2845,2863,2878,2838,2845,2857,0,12,393202,11235642320,1209736
1162,m1801,20170720,2845,2857,2850,2875,2845,2865,2863,8,6,394890,11305710540,1230744
1163,m1801,20170721,2865,2863,2880,2899,2874,2893,2887,30,24,490410,14158499260,1263626
1164,m1801,20170724,2893,2887,2879,2886,2812,2829,2842,-58,-45,555304,15786136380,1303322
1165,m1801,20170725,2829,2842,2828,2894,2823,2887,2866,45,24,541136,15511122920,1334002
1166,m1801,20170726,2887,2866,2878,2881,2819,2824,2841,-42,-25,654894,18607820640,1378928
1167,m1801,20170727,2824,2841,2811,2844,2776,2828,2819,-13,-22,530666,14961557060,1375504
1168,m1801,20170728,2828,2819,2841,2870,2833,2851,2851,32,32,826692,23569059960,1431610
1169,m1801,20170731,2851,2851,2855,2879,2829,2844,2848,-7,-3,736666,20983641040,1435258
1170,m1801,20170801,2844,2848,2840,2863,2835,2838,2845,-10,-3,945596,26906268700,1544160
1171,m1801,20170802,2838,2845,2825,2837,2786,2796,2803,-49,-42,1375242,38554554420,1625138
1172,m1801,20170803,2796,2803,2800,2807,2757,2760,2785,-43,-18,1071826,29850406320,1679996
1173,m1801,20170804,2760,2785,2760,2774,2752,2768,2764,-17,-21,907282,25080388080,1713078
1174,m1801,20170807,2768,2764,2772,2795,2767,2775,2777,11,13,969450,26929381320,1737620
1175,m1801,20170808,2775,2777,2780,2825,2777,2819,2805,42,28,1178400,33055219420,1677164
1176,m1801,20170809,2819,2805,2820,2828,2809,2820,2817,15,12,905224,25508807140,1673618
1177,m1801,20170810,2820,2817,2820,2835,2810,2829,2822,12,5,1029814,29070688600,1757888
1178,m1801,20170811,2829,2822,2836,2855,2723,2725,2769,-97,-53,2131214,59017453540,1583006
1179,m1801,20170814,2725,2769,2738,2742,2718,2734,2731,-35,-38,913516,24949879360,1550682
1180,m1801,20170815,2734,2731,2730,2740,2721,2728,2730,-3,-1,805784,21997932380,1540208
1181,m1801,20170816,2728,2730,2721,2727,2705,2716,2715,-14,-15,783802,21281447140,1564320
1182,m1801,20170817,2716,2715,2719,2734,2712,2725,2722,10,7,870850,23711297640,1565092
1183,m1801,20170818,2725,2722,2730,2735,2724,2727,2730,5,8,670208,18296878500,1578858
1184,m1801,20170821,2727,2730,2724,2737,2718,2727,2727,-3,-3,941288,25669447280,1648744
1185,m1801,20170822,2727,2727,2726,2744,2697,2739,2724,12,-3,1444050,39346849140,1663602
1186,m1801,20170823,2739,2724,2730,2743,2728,2734,2734,10,10,1051594,28751960060,1680570
1187,m1801,20170824,2734,2734,2737,2743,2709,2724,2722,-10,-12,1200884,32697587180,1767646
1188,m1801,20170825,2724,2722,2726,2738,2720,2735,2731,13,9,807670,22059656440,1714790
1189,m1801,20170828,2735,2731,2741,2754,2731,2746,2742,15,11,1009332,27681424780,1761520
1190,m1801,20170829,2746,2742,2748,2748,2720,2723,2729,-19,-13,912880,24912659160,1782932
1191,m1801,20170830,2723,2729,2716,2722,2703,2707,2714,-22,-15,890384,24169439160,1861264
1192,m1801,20170831,2707,2714,2706,2710,2692,2697,2699,-17,-15,791420,21367148960,1887826
1193,m1801,20170901,2697,2699,2695,2720,2690,2705,2708,6,9,1035906,28052344280,1890296
1194,m1801,20170904,2705,2708,2708,2734,2700,2726,2716,18,8,1020340,27712778960,1889532
1195,m1801,20170905,2726,2716,2726,2735,2721,2727,2728,11,12,739104,20168617560,1873520
1196,m1801,20170906,2727,2728,2732,2750,2729,2737,2739,9,11,1091608,29905506980,1865810
1197,m1801,20170907,2737,2739,2741,2750,2730,2742,2740,3,1,943724,25863195560,1822578
1198,m1801,20170908,2742,2740,2741,2749,2710,2717,2731,-23,-9,1195144,32650835380,1853534
1199,m1801,20170911,2717,2731,2718,2728,2706,2725,2720,-6,-11,857258,23318474580,1798134
1200,m1801,20170912,2725,2720,2722,2730,2713,2722,2721,2,1,749448,20395770740,1864652
1201,m1801,20170913,2722,2721,2722,2738,2685,2690,2711,-31,-10,1789078,48519480640,1958260
1202,m1801,20170914,2690,2711,2691,2719,2690,2713,2705,2,-6,966532,26150214300,1842808
1203,m1801,20170915,2713,2705,2720,2743,2716,2738,2734,33,29,1386540,37908225120,1822900
1204,m1801,20170918,2738,2734,2731,2744,2710,2741,2730,7,-4,1158322,31624672680,1792144
1205,m1801,20170919,2741,2730,2735,2759,2730,2730,2741,0,11,1284218,35209649940,1877552
1206,m1801,20170920,2730,2741,2731,2737,2717,2730,2726,-11,-15,721788,19680829160,1834210
1207,m1801,20170921,2730,2726,2732,2748,2730,2741,2739,15,13,915492,25084056920,1883094
1208,m1801,20170922,2741,2739,2739,2800,2732,2790,2770,51,31,1811852,50201798140,2129772
1209,m1801,20170925,2790,2770,2791,2816,2788,2809,2803,39,33,1371604,38446065800,2111194
1210,m1801,20170926,2809,2803,2806,2809,2776,2787,2789,-16,-14,872936,24351042780,1997378
1211,m1801,20170927,2787,2789,2780,2784,2765,2783,2774,-6,-15,763092,21172197680,1979450
1212,m1801,20170928,2783,2774,2779,2787,2755,2762,2771,-12,-3,931008,25805752320,1843230
1213,m1801,20170929,2762,2771,2763,2780,2723,2729,2751,-42,-20,1177762,32411831800,1642354
1214,m1801,20171009,2729,2751,2780,2803,2775,2782,2785,31,34,705360,19647938360,1609128
1215,m1801,20171010,2782,2785,2782,2794,2771,2774,2781,-11,-4,689826,19185363000,1626400
1216,m1801,20171011,2774,2781,2781,2791,2762,2764,2774,-17,-7,697172,19340866040,1651474
1217,m1801,20171012,2764,2774,2766,2778,2763,2769,2769,-5,-5,456060,12630594240,1595786
1218,m1801,20171013,2769,2769,2769,2855,2765,2855,2827,86,58,1226308,34677150640,1663780
1219,m1801,20171016,2855,2827,2860,2871,2846,2852,2856,25,29,888542,25377102300,1614844
1220,m1801,20171017,2852,2856,2852,2879,2836,2842,2852,-14,-4,804128,22940788440,1642624
1221,m1801,20171018,2842,2852,2838,2845,2829,2837,2836,-15,-16,635958,18037879580,1621386
1222,m1801,20171019,2837,2836,2840,2855,2835,2851,2846,15,10,678364,19311246020,1657482
1223,m1801,20171020,2851,2846,2853,2861,2844,2852,2852,6,6,594794,16964579580,1658420
1224,m1801,20171023,2852,2852,2855,2874,2816,2835,2843,-17,-9,1013442,28812992000,1693784
1225,m1801,20171024,2835,2843,2830,2843,2822,2822,2831,-21,-12,617776,17494347080,1641204
1226,m1801,20171025,2822,2831,2820,2835,2812,2830,2825,-1,-6,664920,18785135900,1681106
1227,m1801,20171026,2830,2825,2832,2840,2812,2817,2825,-8,0,681112,19245541260,1635744
1228,m1801,20171027,2817,2825,2822,2827,2794,2797,2809,-28,-16,773682,21736386020,1600232
1229,m1801,20171030,2797,2809,2801,2815,2796,2803,2805,-6,-4,541254,15185602020,1539164
1230,m1801,20171031,2803,2805,2803,2807,2785,2792,2795,-13,-10,594660,16621173420,1600062
1231,m1801,20171101,2792,2795,2792,2807,2784,2797,2795,2,0,582038,16273123460,1583462
1232,m1801,20171102,2797,2795,2797,2816,2787,2801,2802,6,7,748358,20973927580,1560468
1233,m1801,20171103,2801,2802,2802,2818,2802,2809,2809,7,7,618700,17384535320,1551290
1234,m1801,20171106,2809,2809,2806,2811,2780,2784,2790,-25,-19,796450,22223959140,1539296
1235,m1801,20171107,2784,2790,2782,2806,2781,2794,2795,4,5,548642,15339265600,1515846
1236,m1801,20171108,2794,2795,2791,2807,2786,2804,2799,9,4,516462,14457203000,1527200
1237,m1801,20171109,2804,2799,2804,2823,2799,2819,2809,20,10,656712,18453238000,1533650
1238,m1801,20171110,2819,2809,2822,2828,2783,2794,2801,-15,-8,771750,21620448320,1505356
1239,m1801,20171113,2794,2801,2795,2834,2794,2834,2815,33,14,679160,19120468060,1476832
1240,m1801,20171114,2834,2815,2828,2841,2812,2820,2823,5,8,763284,21553732040,1420908
1241,m1801,20171115,2820,2823,2819,2842,2808,2832,2825,9,2,1004438,28379590740,1454372
1242,m1801,20171116,2832,2825,2835,2869,2827,2861,2848,36,23,995346,28351675180,1427806
1243,m1801,20171117,2861,2848,2858,2869,2845,2850,2853,2,5,729416,20816781600,1452166
1244,m1801,20171120,2850,2853,2855,2909,2843,2897,2880,44,27,1022536,29453515020,1410874
1245,m1801,20171121,2897,2880,2897,2931,2888,2921,2908,41,28,818280,23797605460,1385470
1246,m1801,20171122,2921,2908,2913,2926,2895,2902,2908,-6,0,676508,19675933280,1307442
1247,m1801,20171123,2902,2908,2907,2921,2896,2897,2908,-11,0,768804,22364205040,1177804
1248,m1801,20171124,2897,2908,2900,2914,2896,2911,2906,3,-2,244470,7106146080,1108290
1249,m1801,20171127,2911,2906,2913,2917,2890,2893,2903,-13,-3,395048,11470819160,1042764
1250,m1801,20171128,2893,2903,2898,2909,2892,2898,2901,-5,-2,245606,7125418700,973328
1251,m1801,20171129,2898,2901,2894,2901,2886,2887,2892,-14,-9,231738,6702122220,914272
1252,m1801,20171130,2887,2892,2887,2904,2880,2885,2891,-7,-1,261490,7561395540,825202
1253,m1801,20171201,2885,2891,2880,2884,2865,2870,2871,-21,-20,226938,6516456320,784930
1254,m1801,20171204,2870,2871,2875,2929,2872,2926,2909,55,38,314414,9149436880,713186
1255,m1801,20171205,2926,2909,2925,2930,2910,2919,2919,10,10,209824,6124826740,649802
1256,m1801,20171206,2919,2919,2929,2972,2926,2962,2956,43,37,272878,8067722340,590554
1257,m1801,20171207,2962,2956,2966,2966,2929,2935,2945,-21,-11,218764,6444481240,530834
1258,m1801,20171208,2935,2945,2925,2935,2915,2932,2924,-13,-21,138094,4038921660,491348
1259,m1801,20171211,2932,2924,2936,2940,2903,2912,2915,-12,-9,161378,4704626300,436880
1260,m1801,20171212,2912,2915,2905,2920,2903,2914,2911,-1,-4,144024,4193953600,382388
1261,m1801,20171213,2914,2911,2910,2919,2898,2916,2910,5,-1,163376,4754740920,334550
1262,m1801,20171214,2916,2910,2912,2929,2906,2908,2917,-2,7,136944,3994855360,282680
1263,m1801,20171215,2908,2917,2906,2916,2896,2900,2905,-17,-12,106648,3098225260,255632
1264,m1801,20171218,2900,2905,2900,2910,2891,2903,2900,-2,-5,60752,1762194600,232330
1265,m1801,20171219,2903,2900,2908,2917,2883,2890,2894,-10,-6,76054,2201761900,204062
1266,m1801,20171220,2890,2894,2893,2904,2885,2894,2891,0,-3,75320,2177879600,177578
1267,m1801,20171221,2894,2891,2891,2894,2877,2878,2885,-13,-6,59374,1713421100,151736
1268,m1801,20171222,2878,2885,2881,2885,2873,2881,2877,-4,-8,32828,944690940,139300
1269,m1801,20171225,2881,2877,2882,2900,2876,2883,2886,6,9,36192,1044742740,118298
1270,m1801,20171226,2883,2886,2889,2915,2881,2910,2902,24,16,38818,1126715220,95022
1271,m1801,20171227,2910,2902,2915,2923,2902,2917,2914,15,12,34026,991805200,74444
1272,m1801,20171228,2917,2914,2911,2920,2896,2902,2906,-12,-8,38886,1130114640,50496
1273,m1801,20171229,2902,2906,2903,2903,2810,2850,2875,-56,-31,47458,1364846900,13160
1274,m1803,20170315,2909,2909,2724,2907,2724,2907,2816,-2,-93,34,957640,4
1275,m1803,20170316,2907,2816,0,0,0,2891,2891,75,75,0,0,4
1276,m1803,20170317,2891,2891,0,0,0,2891,2891,0,0,0,0,4
1277,m1803,20170320,2891,2891,0,0,0,2906,2906,15,15,0,0,4
1278,m1803,20170321,2906,2906,2953,2953,2896,2896,2926,-10,20,26,760800,4
1279,m1803,20170322,2896,2926,2881,2881,2881,2881,2881,-45,-45,2,57620,6
1280,m1803,20170323,2881,2881,2888,2888,2888,2888,2888,7,7,2,57760,6
1281,m1803,20170324,2888,2888,0,0,0,2888,2888,0,0,0,0,6
1282,m1803,20170327,2888,2888,0,0,0,2888,2888,0,0,0,0,6
1283,m1803,20170328,2888,2888,0,0,0,2888,2888,0,0,0,0,6
1284,m1803,20170329,2888,2888,0,0,0,2888,2888,0,0,0,0,6
1285,m1803,20170330,2888,2888,0,0,0,2881,2881,-7,-7,0,0,6
1286,m1803,20170331,2881,2881,2843,2843,2843,2843,2843,-38,-38,12,341160,16
1287,m1803,20170405,2843,2843,0,0,0,2816,2816,-27,-27,0,0,16
1288,m1803,20170406,2816,2816,2801,2801,2801,2801,2801,-15,-15,2,56020,14
1289,m1803,20170407,2801,2801,2795,2795,2782,2782,2788,-19,-13,4,111540,14
1290,m1803,20170410,2782,2788,2790,2790,2790,2790,2790,2,2,2,55800,14
1291,m1803,20170411,2790,2790,2804,2815,2791,2803,2803,13,13,26,729000,26
1292,m1803,20170412,2803,2803,2826,2827,2814,2814,2821,11,18,18,507900,40
1293,m1803,20170413,2814,2821,2842,2858,2842,2844,2851,23,30,34,969520,66
1294,m1803,20170414,2844,2851,2864,2864,2864,2864,2864,13,13,2,57280,66
1295,m1803,20170417,2864,2864,2837,2870,2837,2846,2851,-18,-13,20,570280,72
1296,m1803,20170418,2846,2851,2853,2853,2840,2840,2843,-11,-8,24,682500,90
1297,m1803,20170419,2840,2843,2855,2864,2855,2864,2861,21,18,14,400580,90
1298,m1803,20170420,2864,2861,2841,2852,2828,2848,2843,-13,-18,30,852960,88
1299,m1803,20170421,2848,2843,2830,2830,2830,2830,2830,-13,-13,14,396200,94
1300,m1803,20170424,2830,2830,2839,2869,2830,2869,2843,39,13,50,1421600,92
1301,m1803,20170425,2869,2843,0,0,0,2843,2843,0,0,0,0,92
1302,m1803,20170426,2843,2843,2867,2867,2864,2864,2865,21,22,8,229260,94
1303,m1803,20170427,2864,2865,2829,2836,2812,2812,2828,-53,-37,20,565660,94
1304,m1803,20170428,2812,2828,2811,2818,2808,2808,2814,-20,-14,28,788180,104
1305,m1803,20170502,2808,2814,2856,2876,2856,2863,2868,49,54,18,516260,110
1306,m1803,20170503,2863,2868,2872,2872,2847,2871,2860,3,-8,14,400420,108
1307,m1803,20170504,2871,2860,2870,2870,2865,2865,2868,5,8,38,1089960,110
1308,m1803,20170505,2865,2868,2876,2876,2832,2836,2850,-32,-18,26,741040,110
1309,m1803,20170508,2836,2850,2852,2871,2830,2830,2850,-20,0,20,570040,116
1310,m1803,20170509,2830,2850,2829,2829,2825,2825,2826,-25,-24,22,621780,130
1311,m1803,20170510,2825,2826,2846,2859,2846,2854,2854,28,28,76,2169280,148
1312,m1803,20170511,2854,2854,2855,2856,2838,2838,2852,-16,-2,20,570460,154
1313,m1803,20170512,2838,2852,2840,2840,2818,2818,2829,-34,-23,4,113160,156
1314,m1803,20170515,2818,2829,2810,2810,2807,2807,2808,-22,-21,10,280800,160
1315,m1803,20170516,2807,2808,2804,2820,2772,2773,2791,-35,-17,76,2121720,162
1316,m1803,20170517,2773,2791,2799,2820,2796,2820,2807,29,16,24,673820,164
1317,m1803,20170518,2820,2807,2813,2813,2777,2787,2785,-20,-22,52,1448460,162
1318,m1803,20170519,2787,2785,2773,2775,2751,2769,2769,-16,-16,48,1329360,190
1319,m1803,20170522,2769,2769,2763,2775,2762,2762,2766,-7,-3,22,608720,202
1320,m1803,20170523,2762,2766,2761,2761,2761,2761,2761,-5,-5,2,55220,202
1321,m1803,20170524,2761,2761,0,0,0,2761,2761,0,0,0,0,202
1322,m1803,20170525,2761,2761,2754,2754,2754,2754,2754,-7,-7,2,55080,202
1323,m1803,20170526,2754,2754,2722,2726,2722,2726,2724,-28,-30,6,163480,202
1324,m1803,20170531,2726,2724,2687,2697,2657,2657,2691,-67,-33,26,699760,206
1325,m1803,20170601,2657,2691,2650,2655,2646,2648,2649,-43,-42,22,582780,216
1326,m1803,20170602,2648,2649,2656,2669,2636,2653,2649,4,0,24,635860,230
1327,m1803,20170605,2653,2649,2675,2675,2672,2672,2673,23,24,10,267320,238
1328,m1803,20170606,2672,2673,2669,2669,2669,2669,2669,-4,-4,6,160140,244
1329,m1803,20170607,2669,2669,2675,2702,2675,2696,2692,27,23,8,215380,246
1330,m1803,20170608,2696,2692,2689,2698,2689,2697,2695,5,3,18,485100,262
1331,m1803,20170609,2697,2695,2714,2714,2704,2704,2709,9,14,4,108360,262
1332,m1803,20170612,2704,2709,2684,2684,2684,2684,2684,-25,-25,4,107360,260
1333,m1803,20170613,2684,2684,0,0,0,2682,2682,-2,-2,0,0,260
1334,m1803,20170614,2682,2682,2688,2695,2687,2692,2691,10,9,46,1237960,266
1335,m1803,20170615,2692,2691,2699,2699,2678,2678,2688,-13,-3,4,107540,268
1336,m1803,20170616,2678,2688,2681,2741,2681,2705,2712,17,24,26,705280,280
1337,m1803,20170619,2705,2712,2702,2728,2701,2714,2711,2,-1,36,976040,300
1338,m1803,20170620,2714,2711,2710,2712,2703,2710,2708,-1,-3,16,433380,312
1339,m1803,20170621,2710,2708,2689,2689,2689,2689,2689,-19,-19,2,53780,312
1340,m1803,20170622,2689,2689,2679,2679,2661,2661,2664,-28,-25,12,319680,312
1341,m1803,20170623,2661,2664,2659,2659,2635,2639,2639,-25,-25,44,1161560,352
1342,m1803,20170626,2639,2639,2665,2665,2664,2664,2664,25,25,4,106580,352
1343,m1803,20170627,2664,2664,2652,2656,2642,2656,2651,-8,-13,16,424300,358
1344,m1803,20170628,2656,2651,2665,2665,2643,2648,2652,-3,1,6,159120,358
1345,m1803,20170629,2648,2652,2658,2658,2653,2653,2654,1,2,26,690280,358
1346,m1803,20170630,2653,2654,2644,2654,2640,2654,2650,0,-4,14,371080,362
1347,m1803,20170703,2654,2650,2649,2767,2649,2753,2701,103,51,52,1404760,362
1348,m1803,20170704,2753,2701,2766,2778,2766,2774,2768,73,67,74,2048400,358
1349,m1803,20170705,2774,2768,2768,2768,2756,2758,2758,-10,-10,28,772340,376
1350,m1803,20170706,2758,2758,2789,2799,2766,2773,2777,15,19,50,1388780,380
1351,m1803,20170707,2773,2777,2775,2800,2775,2794,2792,17,15,54,1508000,396
1352,m1803,20170710,2794,2792,2812,2892,2812,2877,2872,85,80,28,804260,398
1353,m1803,20170711,2877,2872,2891,2905,2866,2868,2881,-4,9,30,864580,408
1354,m1803,20170712,2868,2881,2882,2882,2871,2875,2875,-6,-6,24,690080,414
1355,m1803,20170713,2875,2875,2868,2877,2814,2821,2831,-54,-44,54,1529100,416
1356,m1803,20170714,2821,2831,2760,2760,2751,2754,2756,-77,-75,18,496120,424
1357,m1803,20170717,2754,2756,2760,2783,2760,2766,2774,10,18,96,2663860,474
1358,m1803,20170718,2766,2774,2773,2791,2766,2780,2777,6,3,40,1110940,472
1359,m1803,20170719,2780,2777,2807,2812,2771,2785,2793,8,16,40,1117380,472
1360,m1803,20170720,2785,2793,2804,2816,2804,2816,2811,23,18,18,506140,476
1361,m1803,20170721,2816,2811,2845,2845,2825,2839,2834,28,23,90,2551160,470
1362,m1803,20170724,2839,2834,2801,2810,2773,2781,2788,-53,-46,28,780900,452
1363,m1803,20170725,2781,2788,2808,2848,2808,2830,2832,42,44,20,566500,452
1364,m1803,20170726,2830,2832,2970,2970,2758,2783,2850,-49,18,130,3705240,452
1365,m1803,20170727,2783,2850,2758,2782,2758,2776,2777,-74,-73,66,1833100,458
1366,m1803,20170728,2776,2777,2784,2804,2784,2804,2798,27,21,44,1231260,448
1367,m1803,20170731,2804,2798,2808,2815,2759,2795,2782,-3,-16,70,1948020,440
1368,m1803,20170801,2795,2782,2795,2795,2784,2784,2785,2,3,22,612700,418
1369,m1803,20170802,2784,2785,2770,2771,2733,2749,2738,-36,-47,116,3177200,386
1370,m1803,20170803,2749,2738,2742,2744,2709,2709,2734,-29,-4,40,1093800,360
1371,m1803,20170804,2709,2734,2732,2732,2706,2707,2714,-27,-20,28,760120,362
1372,m1803,20170807,2707,2714,2740,2740,2720,2737,2727,23,13,22,600120,364
1373,m1803,20170808,2737,2727,2737,2775,2737,2772,2756,45,29,36,992500,366
1374,m1803,20170809,2772,2756,2763,2763,2738,2738,2757,-18,1,12,330900,356
1375,m1803,20170810,2738,2757,0,0,0,2757,2757,0,0,0,0,356
1376,m1803,20170811,2757,2757,2786,2787,2678,2680,2697,-77,-60,56,1510640,344
1377,m1803,20170814,2680,2697,2677,2681,2665,2681,2676,-16,-21,52,1391660,348
1378,m1803,20170815,2681,2676,2672,2679,2672,2679,2674,3,-2,6,160460,350
1379,m1803,20170816,2679,2674,2661,2663,2661,2661,2661,-13,-13,14,372640,348
1380,m1803,20170817,2661,2661,2677,2702,2677,2678,2685,17,24,44,1181600,342
1381,m1803,20170818,2678,2685,2683,2683,2665,2679,2676,-6,-9,42,1124100,338
1382,m1803,20170821,2679,2676,2659,2700,2659,2686,2685,10,9,18,483460,338
1383,m1803,20170822,2686,2685,2671,2693,2644,2689,2676,4,-9,74,1980580,368
1384,m1803,20170823,2689,2676,2687,2688,2680,2682,2684,6,8,90,2416020,342
1385,m1803,20170824,2682,2684,2684,2684,2671,2676,2674,-8,-10,50,1337160,338
1386,m1803,20170825,2676,2674,2680,2696,2680,2696,2683,22,9,48,1288140,356
1387,m1803,20170828,2696,2683,2694,2705,2682,2697,2691,14,8,54,1453660,368
1388,m1803,20170829,2697,2691,2695,2705,2688,2688,2693,-3,2,78,2101000,314
1389,m1803,20170830,2688,2693,0,0,0,2693,2693,0,0,0,0,314
1390,m1803,20170831,2693,2693,2670,2685,2670,2685,2679,-8,-14,34,910980,324
1391,m1803,20170901,2685,2679,2672,2709,2672,2700,2693,21,14,52,1400780,340
1392,m1803,20170904,2700,2693,2697,2724,2697,2716,2714,23,21,12,325760,336
1393,m1803,20170905,2716,2714,2723,2723,2721,2721,2721,7,7,40,1088540,334
1394,m1803,20170906,2721,2721,2748,2748,2737,2737,2740,16,19,64,1753680,382
1395,m1803,20170907,2737,2740,2735,2749,2735,2749,2739,9,-1,18,493100,384
1396,m1803,20170908,2749,2739,2738,2741,2716,2716,2725,-23,-14,30,817600,368
1397,m1803,20170911,2716,2725,0,0,0,2725,2725,0,0,0,0,368
1398,m1803,20170912,2725,2725,2723,2723,2721,2721,2722,-4,-3,8,217760,372
1399,m1803,20170913,2721,2722,2738,2738,2695,2708,2719,-14,-3,36,979080,368
1400,m1803,20170914,2708,2719,0,0,0,2719,2719,0,0,0,0,368
1401,m1803,20170915,2719,2719,2719,2745,2719,2745,2731,26,12,22,600980,352
1402,m1803,20170918,2745,2731,2727,2738,2727,2735,2734,4,3,40,1093780,328
1403,m1803,20170919,2735,2734,2738,2752,2734,2735,2741,1,7,28,767560,312
1404,m1803,20170920,2735,2741,2726,2734,2724,2734,2726,-7,-15,10,272680,312
1405,m1803,20170921,2734,2726,2742,2751,2740,2751,2742,25,16,16,438820,316
1406,m1803,20170922,2751,2742,2742,2788,2742,2788,2779,46,37,56,1556560,282
1407,m1803,20170925,2788,2779,2798,2809,2790,2809,2797,30,18,10,279740,280
1408,m1803,20170926,2809,2797,0,0,0,2797,2797,0,0,0,0,280
1409,m1803,20170927,2797,2797,2775,2785,2772,2772,2777,-25,-20,6,166640,278
1410,m1803,20170928,2772,2777,2782,2782,2781,2781,2781,4,4,12,333780,278
1411,m1803,20170929,2781,2781,2743,2770,2743,2743,2748,-38,-33,10,274840,278
1412,m1803,20171009,2743,2748,2806,2806,2778,2778,2786,30,38,18,501640,276
1413,m1803,20171010,2778,2786,2789,2789,2773,2780,2785,-6,-1,18,501340,268
1414,m1803,20171011,2780,2785,2746,2785,2746,2760,2771,-25,-14,34,942160,276
1415,m1803,20171012,2760,2771,0,0,0,2771,2771,0,0,0,0,276
1416,m1803,20171013,2771,2771,2718,2850,2718,2850,2805,79,34,84,2356380,270
1417,m1803,20171016,2850,2805,2858,2858,2850,2853,2853,48,48,44,1255620,280
1418,m1803,20171017,2853,2853,2864,2867,2840,2840,2853,-13,0,30,856180,280
1419,m1803,20171018,2840,2853,2836,2836,2832,2832,2834,-21,-19,32,907080,254
1420,m1803,20171019,2832,2834,2848,2848,2848,2848,2848,14,14,2,56960,256
1421,m1803,20171020,2848,2848,2856,2860,2856,2860,2858,12,10,4,114320,254
1422,m1803,20171023,2860,2858,2870,2870,2834,2834,2846,-24,-12,32,910860,252
1423,m1803,20171024,2834,2846,2828,2828,2828,2828,2828,-18,-18,12,339360,252
1424,m1803,20171025,2828,2828,2834,2837,2825,2830,2831,2,3,48,1359320,246
1425,m1803,20171026,2830,2831,2836,2836,2817,2817,2822,-14,-9,28,790180,250
1426,m1803,20171027,2817,2822,2814,2826,2783,2798,2804,-24,-18,40,1121720,258
1427,m1803,20171030,2798,2804,2799,2807,2799,2807,2804,3,0,28,785140,256
1428,m1803,20171031,2807,2804,2796,2807,2793,2800,2798,-4,-6,126,3526440,256
1429,m1803,20171101,2800,2798,2811,2811,2811,2811,2811,13,13,2,56220,254
1430,m1803,20171102,2811,2811,2789,2811,2789,2810,2806,-1,-5,42,1178620,244
1431,m1803,20171103,2810,2806,2820,2828,2810,2822,2817,16,11,22,619840,244
1432,m1803,20171106,2822,2817,2809,2809,2786,2786,2802,-31,-15,22,616500,258
1433,m1803,20171107,2786,2802,2804,2804,2804,2804,2804,2,2,2,56080,256
1434,m1803,20171108,2804,2804,2817,2817,2805,2805,2811,1,7,4,112440,256
1435,m1803,20171109,2805,2811,2814,2823,2812,2823,2819,12,8,30,845820,250
1436,m1803,20171110,2823,2819,2826,2826,2788,2808,2815,-11,-4,12,337800,250
1437,m1803,20171113,2808,2815,2808,2828,2808,2828,2818,13,3,4,112720,250
1438,m1803,20171114,2828,2818,2826,2833,2799,2817,2824,-1,6,34,960480,248
1439,m1803,20171115,2817,2824,2816,2831,2816,2817,2821,-7,-3,30,846360,246
1440,m1803,20171116,2817,2821,2820,2844,2792,2830,2810,9,-11,162,4553400,238
1441,m1803,20171117,2830,2810,2848,2898,2726,2818,2829,8,19,150,4244920,250
1442,m1803,20171120,2818,2829,2829,2870,2829,2869,2853,40,24,84,2396780,258
1443,m1803,20171121,2869,2853,2851,2875,2847,2864,2864,11,11,62,1775860,268
1444,m1803,20171122,2864,2864,2875,2875,2852,2859,2860,-5,-4,70,2002260,294
1445,m1803,20171123,2859,2860,2862,2868,2857,2857,2863,-3,3,44,1260060,310
1446,m1803,20171124,2857,2863,2860,2869,2860,2860,2863,-3,0,10,286320,306
1447,m1803,20171127,2860,2863,2872,2872,2858,2858,2864,-5,1,16,458340,308
1448,m1803,20171128,2858,2864,2847,2863,2847,2856,2854,-8,-10,12,342540,304
1449,m1803,20171129,2856,2854,2859,2864,2849,2852,2855,-2,1,42,1199400,308
1450,m1803,20171130,2852,2855,2857,2874,2844,2847,2856,-8,1,16,457060,308
1451,m1803,20171201,2847,2856,2847,2848,2824,2828,2827,-28,-29,4284,121140380,3058
1452,m1803,20171204,2828,2827,2838,2875,2831,2873,2862,46,35,2682,76769800,3438
1453,m1803,20171205,2873,2862,2875,2889,2873,2884,2882,22,20,2878,82967300,3646
1454,m1803,20171206,2884,2882,2900,2948,2900,2933,2923,51,41,2958,86489880,3270
1455,m1803,20171207,2933,2923,2941,2946,2903,2907,2933,-16,10,3536,103734160,3134
1456,m1803,20171208,2907,2933,2889,2915,2889,2910,2897,-23,-36,4686,135767300,3014
1457,m1803,20171211,2910,2897,2917,2917,2880,2887,2897,-10,0,5490,159078720,3064
1458,m1803,20171212,2887,2897,2880,2890,2879,2884,2882,-13,-15,5248,151256520,3194
1459,m1803,20171213,2884,2882,2890,2890,2874,2881,2881,-1,-1,6604,190273820,3296
1460,m1803,20171214,2881,2881,2880,2890,2870,2871,2881,-10,0,5632,162280920,3524
1461,m1803,20171215,2871,2881,2879,2888,2862,2866,2873,-15,-8,6784,194923160,3682
1462,m1803,20171218,2866,2873,2866,2874,2861,2869,2870,-4,-3,6472,185807580,3736
1463,m1803,20171219,2869,2870,2876,2882,2864,2866,2875,-4,5,6100,175433040,3582
1464,m1803,20171220,2866,2875,2868,2874,2858,2861,2865,-14,-10,9000,257865500,4004
1465,m1803,20171221,2861,2865,2862,2862,2847,2849,2858,-16,-7,8678,248072220,4086
1466,m1803,20171222,2849,2858,2850,2855,2848,2850,2850,-8,-8,9068,258439360,3870
1467,m1803,20171225,2850,2850,2854,2863,2847,2855,2855,5,5,9760,278735140,3712
1468,m1803,20171226,2855,2855,2855,2877,2853,2869,2861,14,6,9428,269781140,3084
1469,m1803,20171227,2869,2861,2872,2877,2863,2873,2868,12,7,7514,215560020,2770
1470,m1803,20171228,2873,2868,2873,2873,2859,2862,2867,-6,-1,8608,246829740,2904
1471,m1803,20171229,2862,2867,2861,2862,2824,2828,2852,-39,-15,9534,271967220,3214
1472,m1805,20170516,2808,2808,2751,2771,2728,2738,2741,-70,-67,13510,370348700,10938
1473,m1805,20170517,2738,2741,2740,2778,2740,2774,2760,33,19,9226,254679660,13874
1474,m1805,20170518,2774,2760,2776,2778,2738,2751,2751,-9,-9,8392,230893000,17742
1475,m1805,20170519,2751,2751,2745,2754,2726,2736,2738,-15,-13,12406,339701360,23502
1476,m1805,20170522,2736,2738,2736,2750,2727,2742,2741,4,3,6352,174116840,24594
1477,m1805,20170523,2742,2741,2738,2746,2730,2734,2739,-7,-2,5934,162544700,25700
1478,m1805,20170524,2734,2739,2731,2748,2717,2735,2727,-4,-12,14732,401779600,31394
1479,m1805,20170525,2735,2727,2732,2741,2728,2733,2734,6,7,3990,109101500,32918
1480,m1805,20170526,2733,2734,2740,2740,2699,2704,2709,-30,-25,7176,194463780,35916
1481,m1805,20170531,2704,2709,2695,2695,2629,2635,2650,-74,-59,19700,522211660,43070
1482,m1805,20170601,2635,2650,2641,2645,2631,2637,2637,-13,-13,7358,194090120,45972
1483,m1805,20170602,2637,2637,2640,2656,2622,2636,2633,-1,-4,13546,356760600,52308
1484,m1805,20170605,2636,2633,2641,2669,2638,2654,2655,21,22,12014,319030220,55800
1485,m1805,20170606,2654,2655,2654,2669,2646,2655,2657,0,2,10988,292011040,60900
1486,m1805,20170607,2655,2657,2654,2681,2650,2662,2666,5,9,11192,298444860,62912
1487,m1805,20170608,2662,2666,2668,2687,2668,2684,2678,18,12,14538,389343920,71110
1488,m1805,20170609,2684,2678,2688,2700,2678,2681,2685,3,7,14112,379018920,75616
1489,m1805,20170612,2681,2685,2685,2693,2668,2677,2678,-8,-7,10342,277057080,77526
1490,m1805,20170613,2677,2678,2668,2669,2653,2661,2660,-17,-18,10622,282585840,81910
1491,m1805,20170614,2661,2660,2661,2685,2661,2675,2673,15,13,7674,205165060,83778
1492,m1805,20170615,2675,2673,2676,2681,2650,2661,2658,-12,-15,16802,446692020,94408
1493,m1805,20170616,2661,2658,2658,2699,2647,2682,2674,24,16,13676,365796060,93910
1494,m1805,20170619,2682,2674,2681,2714,2668,2698,2687,24,13,26940,724056240,84746
1495,m1805,20170620,2698,2687,2694,2704,2683,2698,2694,11,7,9408,253529320,85946
1496,m1805,20170621,2698,2694,2692,2692,2674,2680,2680,-14,-14,11774,315586300,90526
1497,m1805,20170622,2680,2680,2680,2686,2643,2649,2655,-31,-25,17584,467015300,99872
1498,m1805,20170623,2649,2655,2644,2649,2623,2638,2635,-17,-20,30134,794089940,109246
1499,m1805,20170626,2638,2635,2638,2650,2626,2648,2641,13,6,13304,351482400,108942
1500,m1805,20170627,2648,2641,2651,2655,2640,2652,2648,11,7,8726,231131380,108776
1501,m1805,20170628,2652,2648,2655,2662,2638,2643,2650,-5,2,16178,428770080,110542
1502,m1805,20170629,2643,2650,2645,2655,2641,2652,2649,2,-1,15068,399210720,113420
1503,m1805,20170630,2652,2649,2657,2679,2633,2639,2653,-10,4,26266,696930700,114804
1504,m1805,20170703,2639,2653,2645,2759,2642,2748,2728,95,75,47448,1294565780,109896
1505,m1805,20170704,2748,2728,2755,2766,2743,2758,2754,30,26,29616,815904580,112340
1506,m1805,20170705,2758,2754,2759,2766,2744,2753,2752,-1,-2,16698,459680600,116730
1507,m1805,20170706,2753,2752,2752,2781,2752,2771,2769,19,17,37152,1028992760,127166
1508,m1805,20170707,2771,2769,2766,2800,2766,2793,2788,24,19,23666,659953420,136112
1509,m1805,20170710,2793,2788,2795,2892,2790,2874,2847,86,59,51104,1454955020,142672
1510,m1805,20170711,2874,2847,2872,2899,2844,2874,2878,27,31,32296,929675640,147460
1511,m1805,20170712,2874,2878,2865,2881,2851,2869,2870,-9,-8,19550,561155360,148626
1512,m1805,20170713,2869,2870,2865,2880,2796,2808,2826,-62,-44,55324,1563758280,160266
1513,m1805,20170714,2808,2826,2802,2805,2740,2760,2765,-66,-61,42502,1175353120,167148
1514,m1805,20170717,2760,2765,2760,2780,2754,2761,2765,-4,0,24032,664710440,171186
1515,m1805,20170718,2761,2765,2763,2786,2763,2777,2775,12,10,37100,1029657160,182978
1516,m1805,20170719,2777,2775,2785,2804,2768,2775,2783,0,8,20482,570151520,184132
1517,m1805,20170720,2775,2783,2775,2800,2775,2792,2789,9,6,20066,559711160,184402
1518,m1805,20170721,2792,2789,2806,2824,2803,2821,2814,32,25,23100,650062140,185856
1519,m1805,20170724,2821,2814,2815,2815,2743,2759,2771,-55,-43,35954,996539160,193382
1520,m1805,20170725,2759,2771,2763,2825,2756,2816,2798,45,27,43630,1220787520,195736
1521,m1805,20170726,2816,2798,2808,2813,2758,2761,2774,-37,-24,40330,1118780000,207442
1522,m1805,20170727,2761,2774,2754,2778,2721,2764,2756,-10,-18,33546,924738520,203592
1523,m1805,20170728,2764,2756,2772,2796,2767,2783,2780,27,24,40826,1135216840,200594
1524,m1805,20170731,2783,2780,2785,2802,2760,2775,2774,-5,-6,39900,1107014540,201004
1525,m1805,20170801,2775,2774,2769,2785,2764,2766,2771,-8,-3,40604,1125289520,206496
1526,m1805,20170802,2766,2771,2760,2763,2716,2727,2733,-44,-38,63160,1726576980,219264
1527,m1805,20170803,2727,2733,2730,2736,2692,2694,2714,-39,-19,55890,1517138620,245094
1528,m1805,20170804,2694,2714,2695,2704,2686,2700,2697,-14,-17,46968,1266790600,260970
1529,m1805,20170807,2700,2697,2705,2726,2699,2706,2709,9,12,60818,1647959260,261412
1530,m1805,20170808,2706,2709,2706,2745,2706,2741,2727,32,18,52546,1433094920,251248
1531,m1805,20170809,2741,2727,2740,2751,2730,2745,2740,18,13,56600,1551258880,250876
1532,m1805,20170810,2745,2740,2745,2758,2736,2750,2745,10,5,63470,1742535500,247366
1533,m1805,20170811,2750,2745,2756,2769,2652,2652,2688,-93,-57,180912,4862971120,295482
1534,m1805,20170814,2652,2688,2666,2671,2650,2662,2660,-26,-28,72258,1922617220,325696
1535,m1805,20170815,2662,2660,2656,2670,2652,2662,2661,2,1,63492,1689922980,346026
1536,m1805,20170816,2662,2661,2657,2661,2642,2647,2648,-14,-13,78778,2086565600,374710
1537,m1805,20170817,2647,2648,2650,2659,2642,2655,2651,7,3,93716,2484889000,382956
1538,m1805,20170818,2655,2651,2660,2665,2654,2655,2658,4,7,60778,1615990140,392560
1539,m1805,20170821,2655,2658,2656,2666,2649,2655,2656,-3,-2,97196,2582318220,397386
1540,m1805,20170822,2655,2656,2655,2675,2633,2669,2656,13,0,152256,4044866320,429386
1541,m1805,20170823,2669,2656,2664,2673,2661,2668,2666,12,10,107730,2872611780,451170
1542,m1805,20170824,2668,2666,2669,2674,2644,2658,2655,-8,-11,140506,3730536120,504068
1543,m1805,20170825,2658,2655,2661,2675,2657,2671,2667,16,12,124964,3333218580,523416
1544,m1805,20170828,2671,2667,2676,2688,2667,2682,2677,15,10,119212,3192304600,534400
1545,m1805,20170829,2682,2677,2683,2686,2660,2662,2668,-15,-9,126248,3368364020,574826
1546,m1805,20170830,2662,2668,2658,2661,2642,2644,2652,-24,-16,166116,4405439580,606196
1547,m1805,20170831,2644,2652,2645,2646,2630,2636,2637,-16,-15,125694,3314794180,633984
1548,m1805,20170901,2636,2637,2635,2656,2631,2644,2646,7,9,123864,3277975020,628300
1549,m1805,20170904,2644,2646,2648,2674,2641,2671,2657,25,11,167704,4455953720,634620
1550,m1805,20170905,2671,2657,2652,2674,2652,2668,2669,11,12,137908,3680828240,630920
1551,m1805,20170906,2668,2669,2675,2689,2669,2677,2679,8,10,168118,4505366520,628780
1552,m1805,20170907,2677,2679,2682,2689,2672,2682,2680,3,1,112492,3015507180,625084
1553,m1805,20170908,2682,2680,2688,2688,2654,2662,2672,-18,-8,169572,4531117800,657966
1554,m1805,20170911,2662,2672,2661,2669,2649,2666,2661,-6,-11,158250,4211753320,655120
1555,m1805,20170912,2666,2661,2662,2671,2657,2665,2663,4,2,91370,2433202320,660682
1556,m1805,20170913,2665,2663,2664,2679,2646,2648,2661,-15,-2,254558,6775411900,727576
1557,m1805,20170914,2648,2661,2652,2676,2650,2667,2665,6,4,181814,4846115100,716454
1558,m1805,20170915,2667,2665,2672,2696,2671,2690,2687,25,22,239922,6448452700,733516
1559,m1805,20170918,2690,2687,2691,2695,2662,2695,2681,8,-6,205514,5510536900,708222
1560,m1805,20170919,2695,2681,2688,2712,2684,2684,2695,3,14,231592,6241596140,726230
1561,m1805,20170920,2684,2695,2685,2694,2676,2687,2685,-8,-10,144464,3879160760,741928
1562,m1805,20170921,2687,2685,2690,2701,2688,2695,2695,10,10,158802,4279834020,741934
1563,m1805,20170922,2695,2695,2684,2747,2684,2736,2719,41,24,286100,7781817120,739058
1564,m1805,20170925,2736,2719,2737,2755,2732,2747,2742,28,23,236714,6492551160,691670
1565,m1805,20170926,2747,2742,2751,2751,2724,2731,2735,-11,-7,112426,3074890840,676402
1566,m1805,20170927,2731,2735,2727,2732,2715,2731,2723,-4,-12,105486,2872491640,673976
1567,m1805,20170928,2731,2723,2726,2732,2709,2712,2719,-11,-4,176968,4812095860,645182
1568,m1805,20170929,2712,2719,2712,2728,2682,2685,2702,-34,-17,196902,5321307420,672782
1569,m1805,20171009,2685,2702,2726,2749,2723,2729,2734,27,32,155840,4261451360,685088
1570,m1805,20171010,2729,2734,2730,2739,2718,2720,2727,-14,-7,121888,3323967820,696728
1571,m1805,20171011,2720,2727,2728,2736,2710,2711,2719,-16,-8,119472,3248934480,702994
1572,m1805,20171012,2711,2719,2714,2725,2711,2716,2717,-3,-2,79746,2167226620,700674
1573,m1805,20171013,2716,2717,2715,2802,2714,2789,2770,72,53,241870,6700983220,700828
1574,m1805,20171016,2789,2770,2794,2806,2784,2787,2792,17,22,151916,4241825780,704660
1575,m1805,20171017,2787,2792,2789,2809,2771,2774,2783,-18,-9,154428,4298539700,733452
1576,m1805,20171018,2774,2783,2770,2777,2764,2775,2770,-8,-13,110772,3069431540,733680
1577,m1805,20171019,2775,2770,2777,2786,2771,2782,2780,12,10,117470,3265761980,735524
1578,m1805,20171020,2782,2780,2782,2792,2779,2786,2785,6,5,88456,2463637400,733156
1579,m1805,20171023,2786,2785,2788,2805,2751,2770,2776,-15,-9,194564,5401418740,758600
1580,m1805,20171024,2770,2776,2768,2779,2754,2755,2764,-21,-12,173710,4801653140,734442
1581,m1805,20171025,2755,2764,2754,2768,2744,2767,2759,3,-5,120752,3331837620,759318
1582,m1805,20171026,2767,2759,2770,2773,2749,2751,2759,-8,0,113458,3131306780,760376
1583,m1805,20171027,2751,2759,2755,2765,2726,2730,2745,-29,-14,274592,7537985860,800498
1584,m1805,20171030,2730,2745,2732,2750,2730,2739,2741,-6,-4,137756,3776307500,789260
1585,m1805,20171031,2739,2741,2742,2744,2729,2734,2735,-7,-6,133652,3655799680,830764
1586,m1805,20171101,2734,2735,2732,2756,2724,2743,2740,8,5,267800,7337913860,867610
1587,m1805,20171102,2743,2740,2747,2775,2735,2755,2757,15,17,418974,11553295480,959082
1588,m1805,20171103,2755,2757,2755,2776,2754,2765,2765,8,8,280436,7755085820,986438
1589,m1805,20171106,2765,2765,2767,2767,2737,2741,2749,-24,-16,340176,9353337820,1062704
1590,m1805,20171107,2741,2749,2740,2762,2737,2755,2753,6,4,194318,5350046060,1056484
1591,m1805,20171108,2755,2753,2749,2760,2743,2756,2753,3,0,223390,6151736920,1105358
1592,m1805,20171109,2756,2753,2756,2772,2750,2770,2760,17,7,267234,7376915620,1105290
1593,m1805,20171110,2770,2760,2775,2778,2737,2742,2750,-18,-10,396060,10892934920,1161684
1594,m1805,20171113,2742,2750,2743,2767,2740,2764,2753,14,3,294596,8112977840,1143378
1595,m1805,20171114,2764,2753,2753,2767,2740,2750,2752,-3,-1,349448,9620189160,1201116
1596,m1805,20171115,2750,2752,2751,2770,2734,2747,2749,-5,-3,500810,13768733700,1221470
1597,m1805,20171116,2747,2749,2745,2772,2744,2771,2761,22,12,417136,11517622220,1216676
1598,m1805,20171117,2771,2761,2768,2779,2758,2769,2766,8,5,385982,10677977540,1256394
1599,m1805,20171120,2769,2766,2774,2833,2767,2820,2806,54,40,687000,19282531100,1341672
1600,m1805,20171121,2820,2806,2815,2838,2811,2832,2825,26,19,511548,14452941500,1386220
1601,m1805,20171122,2832,2825,2826,2839,2814,2826,2825,1,0,483304,13653343420,1453542
1602,m1805,20171123,2826,2825,2835,2855,2818,2821,2840,-4,15,765862,21750808280,1521616
1603,m1805,20171124,2821,2840,2822,2849,2822,2842,2837,2,-3,385232,10932586020,1592312
1604,m1805,20171127,2842,2837,2843,2855,2820,2823,2837,-14,0,793296,22506852120,1664764
1605,m1805,20171128,2823,2837,2831,2845,2819,2832,2833,-5,-4,609122,17256544020,1689878
1606,m1805,20171129,2832,2833,2828,2835,2817,2822,2824,-11,-9,499208,14098499860,1677694
1607,m1805,20171130,2822,2824,2823,2838,2810,2816,2824,-8,0,675944,19091039700,1684700
1608,m1805,20171201,2816,2824,2816,2816,2791,2800,2801,-24,-23,685906,19217155660,1645184
1609,m1805,20171204,2800,2801,2801,2874,2801,2871,2845,70,44,1119594,31862005260,1824170
1610,m1805,20171205,2871,2845,2870,2878,2859,2864,2866,19,21,657768,18857514640,1796226
1611,m1805,20171206,2864,2866,2870,2927,2870,2912,2906,46,40,1313822,38181750000,1991050
1612,m1805,20171207,2912,2906,2915,2917,2871,2880,2893,-26,-13,1141444,33024662660,1940536
1613,m1805,20171208,2880,2893,2865,2882,2855,2875,2867,-18,-26,903280,25899189900,1953444
1614,m1805,20171211,2875,2867,2880,2885,2838,2850,2857,-17,-10,993028,28376438600,1895126
1615,m1805,20171212,2850,2857,2840,2858,2838,2844,2847,-13,-10,647512,18439327460,1869982
1616,m1805,20171213,2844,2847,2841,2847,2829,2842,2839,-5,-8,686548,19495484980,1908404
1617,m1805,20171214,2842,2839,2840,2852,2822,2823,2838,-16,-1,798108,22652978840,1877782
1618,m1805,20171215,2823,2838,2822,2829,2809,2811,2818,-27,-20,780636,22004911720,1887940
1619,m1805,20171218,2811,2818,2816,2822,2805,2815,2812,-3,-6,639710,17992030820,1861032
1620,m1805,20171219,2815,2812,2818,2834,2808,2818,2818,6,6,824612,23242298940,1926396
1621,m1805,20171220,2818,2818,2818,2825,2800,2804,2809,-14,-9,752574,21141770420,1913522
1622,m1805,20171221,2804,2809,2806,2809,2787,2790,2798,-19,-11,770660,21569132360,1916428
1623,m1805,20171222,2790,2798,2790,2800,2785,2786,2790,-12,-8,530614,14806043140,1896014
1624,m1805,20171225,2786,2790,2791,2806,2789,2794,2797,4,7,529378,14811950860,1901608
1625,m1805,20171226,2794,2797,2796,2826,2794,2820,2814,23,17,665858,18738862140,1940728
1626,m1805,20171227,2820,2814,2822,2830,2811,2824,2822,10,8,695078,19617517440,1938862
1627,m1805,20171228,2824,2822,2822,2824,2801,2806,2811,-16,-11,611406,17188383120,1989892
1628,m1805,20171229,2806,2811,2805,2807,2756,2761,2780,-50,-31,997662,27739085500,1996114
1629,m1807,20170717,2765,2765,0,0,0,2765,2765,0,0,0,0,0
1630,m1807,20170718,2765,2765,0,0,0,2765,2765,0,0,0,0,0
1631,m1807,20170719,2765,2765,0,0,0,2765,2765,0,0,0,0,0
1632,m1807,20170720,2765,2765,0,0,0,2773,2773,8,8,0,0,0
1633,m1807,20170721,2773,2773,0,0,0,2773,2773,0,0,0,0,0
1634,m1807,20170724,2773,2773,2792,2792,2753,2753,2769,-20,-4,14,387760,2
1635,m1807,20170725,2753,2769,2787,2793,2787,2793,2789,24,20,6,167340,2
1636,m1807,20170726,2793,2789,2760,2760,2750,2760,2756,-29,-33,6,165400,6
1637,m1807,20170727,2760,2756,2750,2750,2750,2750,2750,-6,-6,2,55000,4
1638,m1807,20170728,2750,2750,2781,2781,2781,2781,2781,31,31,2,55620,2
1639,m1807,20170731,2781,2781,2784,2790,2766,2766,2775,-15,-6,12,333100,12
1640,m1807,20170801,2766,2775,2777,2788,2755,2780,2780,5,5,42,1167920,20
1641,m1807,20170802,2780,2780,2758,2771,2733,2737,2748,-43,-32,32,879520,40
1642,m1807,20170803,2737,2748,2736,2736,2720,2720,2732,-28,-16,26,710520,66
1643,m1807,20170804,2720,2732,2708,2712,2708,2712,2710,-20,-22,6,162600,72
1644,m1807,20170807,2712,2710,2728,2728,2722,2722,2723,12,13,8,217880,76
1645,m1807,20170808,2722,2723,2706,2763,2706,2763,2732,40,9,12,327900,74
1646,m1807,20170809,2763,2732,2759,2759,2759,2759,2759,27,27,6,165540,76
1647,m1807,20170810,2759,2759,2765,2765,2747,2759,2756,0,-3,12,330800,74
1648,m1807,20170811,2759,2756,2769,2769,2651,2676,2693,-80,-63,48,1292840,76
1649,m1807,20170814,2676,2693,2676,2678,2668,2668,2674,-25,-19,6,160440,80
1650,m1807,20170815,2668,2674,2691,2691,2680,2680,2684,6,10,8,214740,84
1651,m1807,20170816,2680,2684,2660,2669,2650,2650,2657,-34,-27,52,1381700,98
1652,m1807,20170817,2650,2657,2669,2669,2644,2664,2659,7,2,52,1382720,120
1653,m1807,20170818,2664,2659,2668,2669,2666,2666,2667,7,8,16,426760,120
1654,m1807,20170821,2666,2667,2665,2673,2659,2666,2666,-1,-1,34,906660,138
1655,m1807,20170822,2666,2666,2665,2677,2654,2677,2665,11,-1,30,799560,140
1656,m1807,20170823,2677,2665,2678,2685,2673,2681,2682,16,17,46,1233800,182
1657,m1807,20170824,2681,2682,2681,2681,2669,2679,2674,-3,-8,52,1390720,220
1658,m1807,20170825,2679,2674,2680,2689,2680,2687,2684,13,10,16,429480,226
1659,m1807,20170828,2687,2684,2689,2705,2689,2705,2700,21,16,24,648160,238
1660,m1807,20170829,2705,2700,2690,2690,2684,2689,2686,-11,-14,14,376160,244
1661,m1807,20170830,2689,2686,2689,2689,2670,2671,2679,-15,-7,60,1607500,258
1662,m1807,20170831,2671,2679,2671,2671,2660,2664,2662,-15,-17,30,798720,260
1663,m1807,20170901,2664,2662,2666,2667,2666,2667,2666,5,4,4,106660,260
1664,m1807,20170904,2667,2666,2683,2736,2683,2702,2707,36,41,6,162420,258
1665,m1807,20170905,2702,2707,2702,2702,2702,2702,2702,-5,-5,2,54040,258
1666,m1807,20170906,2702,2702,2707,2715,2707,2712,2711,10,9,18,488100,254
1667,m1807,20170907,2712,2711,2715,2717,2711,2717,2715,6,4,10,271500,252
1668,m1807,20170908,2717,2715,2705,2705,2693,2705,2700,-10,-15,30,810280,250
1669,m1807,20170911,2705,2700,2699,2700,2675,2699,2697,-1,-3,40,1078960,250
1670,m1807,20170912,2699,2697,0,0,0,2697,2697,0,0,0,0,250
1671,m1807,20170913,2697,2697,2704,2704,2689,2689,2693,-8,-4,12,323220,252
1672,m1807,20170914,2689,2693,2700,2700,2700,2700,2700,7,7,4,108000,252
1673,m1807,20170915,2700,2700,2713,2726,2713,2714,2718,14,18,34,924220,244
1674,m1807,20170918,2714,2718,2720,2720,2720,2720,2720,2,2,8,217600,238
1675,m1807,20170919,2720,2720,2720,2727,2710,2710,2724,-10,4,22,599320,234
1676,m1807,20170920,2710,2724,2714,2722,2714,2717,2718,-7,-6,8,217500,240
1677,m1807,20170921,2717,2718,0,0,0,2718,2718,0,0,0,0,240
1678,m1807,20170922,2718,2718,2731,2758,2731,2746,2746,28,28,36,988780,218
1679,m1807,20170925,2746,2746,2761,2780,2761,2767,2767,21,21,10,276760,218
1680,m1807,20170926,2767,2767,2759,2759,2755,2755,2757,-12,-10,6,165440,216
1681,m1807,20170927,2755,2757,2748,2767,2748,2767,2758,10,1,26,717300,212
1682,m1807,20170928,2767,2758,0,0,0,2758,2758,0,0,0,0,212
1683,m1807,20170929,2758,2758,2753,2753,2729,2729,2732,-29,-26,54,1475560,220
1684,m1807,20171009,2729,2732,2763,2763,2762,2762,2762,30,30,4,110500,220
1685,m1807,20171010,2762,2762,2758,2758,2758,2758,2758,-4,-4,2,55160,220
1686,m1807,20171011,2758,2758,0,0,0,2758,2758,0,0,0,0,220
1687,m1807,20171012,2758,2758,2752,2757,2748,2757,2751,-1,-7,46,1265840,218
1688,m1807,20171013,2757,2751,0,0,0,2815,2815,64,64,0,0,218
1689,m1807,20171016,2815,2815,2831,2831,2811,2812,2815,-3,0,50,1407880,190
1690,m1807,20171017,2812,2815,0,0,0,2815,2815,0,0,0,0,190
1691,m1807,20171018,2815,2815,2781,2781,2781,2781,2781,-34,-34,2,55620,188
1692,m1807,20171019,2781,2781,2797,2797,2792,2792,2796,11,15,10,279600,188
1693,m1807,20171020,2792,2796,2791,2815,2791,2805,2802,9,6,14,392400,190
1694,m1807,20171023,2805,2802,2803,2803,2803,2803,2803,1,1,2,56060,190
1695,m1807,20171024,2803,2803,2783,2783,2764,2764,2772,-39,-31,20,554540,174
1696,m1807,20171025,2764,2772,0,0,0,2772,2772,0,0,0,0,174
1697,m1807,20171026,2772,2772,2762,2769,2762,2769,2764,-3,-8,6,165860,176
1698,m1807,20171027,2769,2764,0,0,0,2764,2764,0,0,0,0,176
1699,m1807,20171030,2764,2764,0,0,0,2764,2764,0,0,0,0,176
1700,m1807,20171031,2764,2764,0,0,0,2764,2764,0,0,0,0,176
1701,m1807,20171101,2764,2764,2763,2763,2763,2763,2763,-1,-1,10,276300,178
1702,m1807,20171102,2763,2763,2782,2782,2782,2782,2782,19,19,2,55640,176
1703,m1807,20171103,2782,2782,2778,2778,2778,2778,2778,-4,-4,2,55560,176
1704,m1807,20171106,2778,2778,2777,2777,2777,2777,2777,-1,-1,4,111080,180
1705,m1807,20171107,2777,2777,0,0,0,2777,2777,0,0,0,0,180
1706,m1807,20171108,2777,2777,2763,2774,2763,2774,2766,-3,-11,6,166000,178
1707,m1807,20171109,2774,2766,2762,2775,2758,2775,2764,9,-2,12,331700,174
1708,m1807,20171110,2775,2764,2781,2781,2768,2768,2775,4,11,6,166520,176
1709,m1807,20171113,2768,2775,2762,2762,2760,2760,2760,-15,-15,10,276080,174
1710,m1807,20171114,2760,2760,2763,2779,2759,2761,2774,1,14,502,13926320,168
1711,m1807,20171115,2761,2774,2772,2772,2759,2759,2765,-15,-9,4,110620,168
1712,m1807,20171116,2759,2765,0,0,0,2770,2770,5,5,0,0,168
1713,m1807,20171117,2770,2770,2777,2777,2777,2777,2777,7,7,6,166620,162
1714,m1807,20171120,2777,2777,2776,2832,2776,2828,2812,51,35,14,393800,160
1715,m1807,20171121,2828,2812,0,0,0,2812,2812,0,0,0,0,160
1716,m1807,20171122,2812,2812,2826,2826,2816,2816,2818,4,6,22,620060,160
1717,m1807,20171123,2816,2818,2833,2833,2833,2833,2833,15,15,6,169980,166
1718,m1807,20171124,2833,2833,2841,2841,2835,2838,2836,5,3,42,1191320,168
1719,m1807,20171127,2838,2836,2837,2837,2837,2837,2837,1,1,4,113480,168
1720,m1807,20171128,2837,2837,0,0,0,2837,2837,0,0,0,0,168
1721,m1807,20171129,2837,2837,2826,2828,2813,2828,2820,-9,-17,24,676800,170
1722,m1807,20171130,2828,2820,2824,2824,2824,2824,2824,4,4,4,112960,170
1723,m1807,20171201,2824,2824,2800,2802,2794,2795,2797,-29,-27,486,13597660,360
1724,m1807,20171204,2795,2797,2798,2855,2798,2855,2835,58,38,166,4706340,362
1725,m1807,20171205,2855,2835,2857,2862,2850,2850,2858,15,23,168,4801640,436
1726,m1807,20171206,2850,2858,2866,2905,2866,2892,2887,34,29,560,16171680,560
1727,m1807,20171207,2892,2887,2895,2895,2871,2871,2879,-16,-8,218,6277160,608
1728,m1807,20171208,2871,2879,2851,2876,2851,2876,2862,-3,-17,578,16544160,590
1729,m1807,20171211,2876,2862,2876,2879,2852,2853,2866,-9,4,104,2981440,640
1730,m1807,20171212,2853,2866,2850,2859,2850,2854,2854,-12,-12,64,1826860,644
1731,m1807,20171213,2854,2854,2851,2851,2843,2851,2846,-3,-8,90,2562000,662
1732,m1807,20171214,2851,2846,2855,2855,2835,2835,2844,-11,-2,64,1820380,626
1733,m1807,20171215,2835,2844,2835,2835,2815,2818,2823,-26,-21,142,4009380,690
1734,m1807,20171218,2818,2823,2821,2821,2818,2820,2819,-3,-4,48,1353560,732
1735,m1807,20171219,2820,2819,2829,2836,2817,2817,2829,-2,10,44,1245040,714
1736,m1807,20171220,2817,2829,2819,2819,2808,2809,2813,-20,-16,104,2925520,750
1737,m1807,20171221,2809,2813,2814,2814,2799,2799,2806,-14,-7,82,2301060,784
1738,m1807,20171222,2799,2806,2802,2802,2795,2795,2798,-11,-8,12,335820,784
1739,m1807,20171225,2795,2798,2805,2805,2800,2800,2800,2,2,20,560120,770
1740,m1807,20171226,2800,2800,2811,2830,2809,2824,2821,24,21,152,4287960,746
1741,m1807,20171227,2824,2821,2819,2828,2819,2828,2821,7,0,100,2821540,728
1742,m1807,20171228,2828,2821,2812,2815,2811,2811,2811,-10,-10,48,1349600,738
1743,m1807,20171229,2811,2811,2810,2810,2777,2777,2798,-34,-13,64,1790840,742
1744,m1808,20170815,2674,2674,2637,2690,2637,2690,2663,16,-11,4,106540,2
1745,m1808,20170816,2690,2663,2640,2666,2640,2666,2653,3,-10,12,318360,6
1746,m1808,20170817,2666,2653,0,0,0,2653,2653,0,0,0,0,6
1747,m1808,20170818,2653,2653,0,0,0,2653,2653,0,0,0,0,6
1748,m1808,20170821,2653,2653,2651,2676,2651,2671,2671,18,18,64,1709460,56
1749,m1808,20170822,2671,2671,2671,2682,2666,2681,2673,10,2,42,1122840,74
1750,m1808,20170823,2681,2673,2683,2685,2674,2682,2683,9,10,28,751240,100
1751,m1808,20170824,2682,2683,2671,2680,2669,2680,2673,-3,-10,20,534740,112
1752,m1808,20170825,2680,2673,2672,2693,2672,2691,2687,18,14,54,1451180,156
1753,m1808,20170828,2691,2687,2702,2709,2681,2699,2694,12,7,46,1239560,170
1754,m1808,20170829,2699,2694,2690,2692,2685,2685,2688,-9,-6,14,376380,180
1755,m1808,20170830,2685,2688,2688,2688,2673,2673,2680,-15,-8,46,1233140,200
1756,m1808,20170831,2673,2680,2665,2671,2662,2662,2665,-18,-15,16,426440,206
1757,m1808,20170901,2662,2665,2688,2688,2678,2678,2682,13,17,12,321840,214
1758,m1808,20170904,2678,2682,2675,2709,2675,2702,2700,20,18,28,756120,230
1759,m1808,20170905,2702,2700,2702,2704,2702,2704,2703,4,3,14,378460,244
1760,m1808,20170906,2704,2703,2711,2722,2709,2717,2715,14,12,40,1086280,262
1761,m1808,20170907,2717,2715,2720,2725,2712,2720,2717,5,2,32,869600,278
1762,m1808,20170908,2720,2717,2723,2723,2696,2701,2713,-16,-4,40,1085480,304
1763,m1808,20170911,2701,2713,2706,2707,2699,2707,2701,-6,-12,20,540380,308
1764,m1808,20170912,2707,2701,2706,2720,2700,2709,2707,8,6,10,270700,310
1765,m1808,20170913,2709,2707,2713,2713,2690,2696,2697,-11,-10,18,485540,318
1766,m1808,20170914,2696,2697,2698,2720,2698,2720,2706,23,9,10,270660,326
1767,m1808,20170915,2720,2706,2728,2733,2717,2717,2721,11,15,82,2231240,250
1768,m1808,20170918,2717,2721,0,0,0,2721,2721,0,0,0,0,250
1769,m1808,20170919,2721,2721,2743,2743,2720,2727,2723,6,2,40,1089420,238
1770,m1808,20170920,2727,2723,2718,2723,2710,2723,2716,0,-7,14,380300,244
1771,m1808,20170921,2723,2716,2739,2739,2726,2726,2730,10,14,6,163820,240
1772,m1808,20170922,2726,2730,2729,2750,2729,2750,2745,20,15,22,603960,222
1773,m1808,20170925,2750,2745,2766,2779,2752,2770,2768,25,23,72,1993480,206
1774,m1808,20170926,2770,2768,2759,2761,2759,2761,2760,-7,-8,4,110400,208
1775,m1808,20170927,2761,2760,2752,2762,2752,2761,2760,1,0,14,386400,200
1776,m1808,20170928,2761,2760,2738,2758,2738,2742,2747,-18,-13,32,879100,176
1777,m1808,20170929,2742,2747,2731,2745,2730,2730,2733,-17,-14,12,328000,174
1778,m1808,20171009,2730,2733,0,0,0,2733,2733,0,0,0,0,174
1779,m1808,20171010,2733,2733,0,0,0,2733,2733,0,0,0,0,174
1780,m1808,20171011,2733,2733,2733,2733,2733,2733,2733,0,0,2,54660,172
1781,m1808,20171012,2733,2733,2749,2760,2749,2760,2751,27,18,10,275160,174
1782,m1808,20171013,2760,2751,0,0,0,2813,2813,62,62,0,0,174
1783,m1808,20171016,2813,2813,2827,2831,2812,2812,2816,-1,3,30,844900,156
1784,m1808,20171017,2812,2816,2813,2813,2813,2813,2813,-3,-3,6,168780,154
1785,m1808,20171018,2813,2813,2789,2789,2789,2789,2789,-24,-24,4,111560,150
1786,m1808,20171019,2789,2789,2779,2779,2779,2779,2779,-10,-10,4,111160,150
1787,m1808,20171020,2779,2779,0,0,0,2779,2779,0,0,0,0,150
1788,m1808,20171023,2779,2779,0,0,0,2779,2779,0,0,0,0,150
1789,m1808,20171024,2779,2779,2781,2781,2781,2781,2781,2,2,2,55620,148
1790,m1808,20171025,2781,2781,2770,2770,2770,2770,2770,-11,-11,12,332400,152
1791,m1808,20171026,2770,2770,0,0,0,2770,2770,0,0,0,0,152
1792,m1808,20171027,2770,2770,0,0,0,2770,2770,0,0,0,0,152
1793,m1808,20171030,2770,2770,2777,2777,2751,2754,2761,-16,-9,12,331360,148
1794,m1808,20171031,2754,2761,0,0,0,2761,2761,0,0,0,0,148
1795,m1808,20171101,2761,2761,2757,2764,2751,2751,2755,-10,-6,8,220460,144
1796,m1808,20171102,2751,2755,2792,2792,2761,2768,2771,13,16,22,609720,150
1797,m1808,20171103,2768,2771,2777,2787,2773,2787,2780,16,9,26,722960,140
1798,m1808,20171106,2787,2780,2764,2764,2764,2764,2764,-16,-16,4,110560,142
1799,m1808,20171107,2764,2764,2770,2770,2770,2770,2770,6,6,2,55400,142
1800,m1808,20171108,2770,2770,0,0,0,2770,2770,0,0,0,0,142
1801,m1808,20171109,2770,2770,2764,2764,2764,2764,2764,-6,-6,4,110560,140
1802,m1808,20171110,2764,2764,2789,2789,2762,2763,2773,-1,9,10,277300,138
1803,m1808,20171113,2763,2773,2756,2775,2756,2775,2763,2,-10,10,276340,136
1804,m1808,20171114,2775,2763,2764,2764,2764,2764,2764,1,1,4,110560,136
1805,m1808,20171115,2764,2764,2778,2793,2735,2760,2772,-4,8,20,554560,140
1806,m1808,20171116,2760,2772,2762,2773,2762,2773,2771,1,-1,20,554220,136
1807,m1808,20171117,2773,2771,0,0,0,2771,2771,0,0,0,0,136
1808,m1808,20171120,2771,2771,2782,2829,2782,2820,2811,49,40,50,1405960,122
1809,m1808,20171121,2820,2811,2822,2827,2817,2827,2820,16,9,16,451260,130
1810,m1808,20171122,2827,2820,0,0,0,2820,2820,0,0,0,0,130
1811,m1808,20171123,2820,2820,2827,2844,2827,2844,2837,24,17,14,397240,138
1812,m1808,20171124,2844,2837,0,0,0,2835,2835,-2,-2,0,0,138
1813,m1808,20171127,2835,2835,2835,2878,2808,2829,2836,-6,1,10,283640,136
1814,m1808,20171128,2829,2836,0,0,0,2824,2824,-12,-12,0,0,136
1815,m1808,20171129,2824,2824,0,0,0,2823,2823,-1,-1,0,0,136
1816,m1808,20171130,2823,2823,2815,2842,2815,2842,2828,19,5,4,113140,136
1817,m1808,20171201,2842,2828,2809,2809,2781,2795,2793,-33,-35,26,726320,134
1818,m1808,20171204,2795,2793,2796,2814,2796,2814,2807,21,14,8,224560,134
1819,m1808,20171205,2814,2807,2837,2845,2837,2845,2843,38,36,10,284340,136
1820,m1808,20171206,2845,2843,2883,2883,2865,2878,2879,35,36,16,460740,130
1821,m1808,20171207,2878,2879,2892,2893,2850,2850,2872,-29,-7,10,287260,130
1822,m1808,20171208,2850,2872,2850,2850,2826,2841,2845,-31,-27,20,569180,142
1823,m1808,20171211,2841,2845,2850,2850,2824,2824,2843,-21,-2,14,398120,132
1824,m1808,20171212,2824,2843,2832,2832,2829,2829,2830,-14,-13,4,113220,132
1825,m1808,20171213,2829,2830,0,0,0,2830,2830,0,0,0,0,132
1826,m1808,20171214,2830,2830,0,0,0,2830,2830,0,0,0,0,132
1827,m1808,20171215,2830,2830,0,0,0,2816,2816,-14,-14,0,0,132
1828,m1808,20171218,2816,2816,2795,2806,2795,2806,2801,-10,-15,6,168060,132
1829,m1808,20171219,2806,2801,2801,2801,2798,2798,2799,-3,-2,4,111980,132
1830,m1808,20171220,2798,2799,0,0,0,2799,2799,0,0,0,0,132
1831,m1808,20171221,2799,2799,2793,2793,2784,2784,2788,-15,-11,4,111540,132
1832,m1808,20171222,2784,2788,2786,2786,2761,2761,2777,-27,-11,14,388780,134
1833,m1808,20171225,2761,2777,2790,2790,2779,2779,2784,2,7,4,111380,134
1834,m1808,20171226,2779,2784,2804,2804,2804,2804,2804,20,20,2,56080,134
1835,m1808,20171227,2804,2804,0,0,0,2804,2804,0,0,0,0,134
1836,m1808,20171228,2804,2804,2776,2776,2776,2776,2776,-28,-28,2,55520,134
1837,m1808,20171229,2776,2776,0,0,0,2776,2776,0,0,0,0,134
1838,m1809,20170915,2706,2706,2665,2714,2665,2709,2704,3,-2,8832,238870560,7178
1839,m1809,20170918,2709,2704,2707,2730,2688,2725,2715,21,11,14812,402219380,16554
1840,m1809,20170919,2725,2715,2720,2745,2716,2717,2727,2,12,7630,208083620,18892
1841,m1809,20170920,2717,2727,2720,2726,2707,2711,2713,-16,-14,7300,198051320,19360
1842,m1809,20170921,2711,2713,2710,2727,2710,2721,2722,8,9,10078,274355040,22110
1843,m1809,20170922,2721,2722,2720,2772,2713,2761,2750,39,28,12620,347138200,26582
1844,m1809,20170925,2761,2750,2762,2778,2755,2767,2765,17,15,9938,274830240,26160
1845,m1809,20170926,2767,2765,2764,2770,2744,2755,2754,-10,-11,4976,137068900,26078
1846,m1809,20170927,2755,2754,2744,2755,2740,2755,2748,1,-6,4962,136361060,26890
1847,m1809,20170928,2755,2748,2752,2755,2733,2739,2744,-9,-4,9174,251783720,31316
1848,m1809,20170929,2739,2744,2739,2752,2711,2712,2728,-32,-16,6392,174433140,34104
1849,m1809,20171009,2712,2728,2748,2767,2748,2753,2755,25,27,5014,138184920,33024
1850,m1809,20171010,2753,2755,2749,2762,2742,2743,2749,-12,-6,5220,143523200,35280
1851,m1809,20171011,2743,2749,2748,2758,2734,2734,2742,-15,-7,5062,138847660,37124
1852,m1809,20171012,2734,2742,2738,2745,2736,2738,2739,-4,-3,5322,145817980,37632
1853,m1809,20171013,2738,2739,2737,2822,2735,2811,2799,72,60,10670,298693340,40128
1854,m1809,20171016,2811,2799,2818,2826,2806,2807,2814,8,15,7860,221225060,41792
1855,m1809,20171017,2807,2814,2809,2826,2790,2794,2805,-20,-9,9500,266493960,45074
1856,m1809,20171018,2794,2805,2790,2793,2785,2787,2787,-18,-18,8752,243999260,47852
1857,m1809,20171019,2787,2787,2788,2796,2779,2789,2788,2,1,12050,336025600,48910
1858,m1809,20171020,2789,2788,2790,2796,2785,2790,2789,2,1,6344,176967460,49384
1859,m1809,20171023,2790,2789,2793,2807,2758,2775,2781,-14,-8,10778,299795960,52898
1860,m1809,20171024,2775,2781,2770,2783,2760,2761,2770,-20,-11,7216,199939500,55836
1861,m1809,20171025,2761,2770,2758,2771,2751,2770,2763,0,-7,10228,282697220,57470
1862,m1809,20171026,2770,2763,2773,2775,2752,2754,2759,-9,-4,8242,227462500,57906
1863,m1809,20171027,2754,2759,2758,2765,2734,2739,2747,-20,-12,19156,526362120,66784
1864,m1809,20171030,2739,2747,2742,2757,2739,2748,2750,1,3,13144,361573520,71010
1865,m1809,20171031,2748,2750,2745,2752,2740,2742,2744,-8,-6,8006,219706080,73770
1866,m1809,20171101,2742,2744,2746,2763,2738,2756,2749,12,5,12826,352680820,75908
1867,m1809,20171102,2756,2749,2751,2785,2748,2770,2771,21,22,14366,398158400,77452
1868,m1809,20171103,2770,2771,2772,2786,2753,2780,2775,9,4,21022,583361920,85216
1869,m1809,20171106,2780,2775,2778,2781,2752,2757,2764,-18,-11,20698,572258200,92586
1870,m1809,20171107,2757,2764,2751,2774,2751,2769,2767,5,3,10760,297793160,94346
1871,m1809,20171108,2769,2767,2767,2770,2758,2767,2765,0,-2,14050,388558300,94556
1872,m1809,20171109,2767,2765,2771,2782,2763,2782,2770,17,5,10026,277787020,94842
1873,m1809,20171110,2782,2770,2787,2788,2747,2756,2762,-14,-8,29118,804465940,109112
1874,m1809,20171113,2756,2762,2761,2776,2746,2773,2765,11,3,13582,375598880,108090
1875,m1809,20171114,2773,2765,2768,2775,2753,2762,2762,-3,-3,20074,554481040,112262
1876,m1809,20171115,2762,2762,2760,2780,2749,2758,2761,-4,-1,29080,802945820,118612
1877,m1809,20171116,2758,2761,2759,2779,2755,2776,2769,15,8,32946,912518440,121826
1878,m1809,20171117,2776,2769,2772,2784,2765,2772,2773,3,4,20768,575921640,123974
1879,m1809,20171120,2772,2773,2778,2832,2771,2823,2806,50,33,44220,1241066060,130510
1880,m1809,20171121,2823,2806,2819,2840,2814,2833,2828,27,22,23112,653649820,135264
1881,m1809,20171122,2833,2828,2828,2839,2818,2826,2826,-2,-2,32212,910371260,141350
1882,m1809,20171123,2826,2826,2832,2850,2815,2818,2837,-8,11,40084,1137242720,149262
1883,m1809,20171124,2818,2837,2819,2838,2819,2832,2829,-5,-8,18634,527300180,151826
1884,m1809,20171127,2832,2829,2832,2844,2814,2817,2828,-12,-1,26622,752872620,158104
1885,m1809,20171128,2817,2828,2818,2832,2812,2819,2822,-9,-6,40786,1151072660,158332
1886,m1809,20171129,2819,2822,2821,2822,2807,2810,2813,-12,-9,30206,849966700,157246
1887,m1809,20171130,2810,2813,2810,2826,2797,2801,2812,-12,-1,35276,992091880,159632
1888,m1809,20171201,2801,2812,2801,2803,2783,2787,2789,-25,-23,37636,1049983780,166548
1889,m1809,20171204,2787,2789,2791,2849,2789,2849,2826,60,37,59020,1667932420,167304
1890,m1809,20171205,2849,2826,2850,2855,2838,2839,2844,13,18,35624,1013221640,172620
1891,m1809,20171206,2839,2844,2845,2895,2845,2883,2877,39,33,52020,1496803340,182788
1892,m1809,20171207,2883,2877,2884,2888,2852,2857,2869,-20,-8,43764,1255874780,187464
1893,m1809,20171208,2857,2869,2845,2858,2832,2854,2844,-15,-25,45220,1286484320,180730
1894,m1809,20171211,2854,2844,2856,2860,2823,2833,2836,-11,-8,32820,931055760,189706
1895,m1809,20171212,2833,2836,2826,2839,2822,2831,2831,-5,-5,17288,489541320,193086
1896,m1809,20171213,2831,2831,2828,2833,2817,2832,2825,1,-6,41714,1178563820,198696
1897,m1809,20171214,2832,2825,2828,2834,2810,2810,2823,-15,-2,35802,1010980340,197500
1898,m1809,20171215,2810,2823,2808,2816,2797,2801,2805,-22,-18,38760,1087254320,211156
1899,m1809,20171218,2801,2805,2805,2808,2794,2805,2801,0,-4,26360,738572040,215728
1900,m1809,20171219,2805,2801,2806,2820,2799,2808,2807,7,6,30774,863872500,215790
1901,m1809,20171220,2808,2807,2807,2813,2792,2796,2797,-11,-10,33662,941851280,217834
1902,m1809,20171221,2796,2797,2798,2802,2780,2781,2792,-16,-5,60128,1678895160,229994
1903,m1809,20171222,2781,2792,2780,2792,2775,2775,2780,-17,-12,49394,1373587080,237330
1904,m1809,20171225,2775,2780,2781,2795,2779,2784,2786,4,6,36532,1017918100,238668
1905,m1809,20171226,2784,2786,2781,2810,2781,2808,2802,22,16,37324,1045974980,228520
1906,m1809,20171227,2808,2802,2806,2818,2800,2813,2808,11,6,56090,1575468840,221854
1907,m1809,20171228,2813,2808,2816,2816,2789,2794,2799,-14,-9,49900,1396797040,227566
1908,m1809,20171229,2794,2799,2793,2796,2750,2755,2770,-44,-29,119084,3298832380,262218
1909,m1811,20171115,2762,2762,0,0,0,2759,2759,-3,-3,0,0,0
1910,m1811,20171116,2759,2759,2765,2769,2765,2769,2767,10,8,4,110680,2
1911,m1811,20171117,2769,2767,2826,2826,2826,2826,2826,59,59,2,56520,2
1912,m1811,20171120,2826,2826,0,0,0,2826,2826,0,0,0,0,2
1913,m1811,20171121,2826,2826,0,0,0,2826,2826,0,0,0,0,2
1914,m1811,20171122,2826,2826,0,0,0,2826,2826,0,0,0,0,2
1915,m1811,20171123,2826,2826,0,0,0,2826,2826,0,0,0,0,2
1916,m1811,20171124,2826,2826,0,0,0,2826,2826,0,0,0,0,2
1917,m1811,20171127,2826,2826,0,0,0,2826,2826,0,0,0,0,2
1918,m1811,20171128,2826,2826,0,0,0,2826,2826,0,0,0,0,2
1919,m1811,20171129,2826,2826,0,0,0,2826,2826,0,0,0,0,2
1920,m1811,20171130,2826,2826,0,0,0,2826,2826,0,0,0,0,2
1921,m1811,20171201,2826,2826,2793,2799,2792,2793,2794,-33,-32,276,7713440,146
1922,m1811,20171204,2793,2794,2802,2848,2802,2848,2830,54,36,288,8150480,208
1923,m1811,20171205,2848,2830,2850,2851,2841,2842,2846,12,16,158,4497820,174
1924,m1811,20171206,2842,2846,2840,2884,2840,2878,2872,32,26,518,14879380,242
1925,m1811,20171207,2878,2872,2865,2869,2850,2851,2861,-21,-11,174,4979440,376
1926,m1811,20171208,2851,2861,2843,2860,2838,2860,2845,-1,-16,490,13944120,336
1927,m1811,20171211,2860,2845,2904,2904,2836,2840,2853,-5,8,156,4450800,350
1928,m1811,20171212,2840,2853,2836,2845,2836,2840,2840,-13,-13,62,1761260,322
1929,m1811,20171213,2840,2840,2832,2836,2831,2836,2832,-4,-8,74,2096300,322
1930,m1811,20171214,2836,2832,2833,2837,2783,2796,2826,-36,-6,284,8028620,460
1931,m1811,20171215,2796,2826,2802,2812,2796,2802,2801,-24,-25,142,3978640,406
1932,m1811,20171218,2802,2801,2827,2827,2796,2810,2803,9,2,412,11549400,448
1933,m1811,20171219,2810,2803,2819,2823,2805,2810,2812,7,9,178,5005480,466
1934,m1811,20171220,2810,2812,2811,2815,2799,2801,2806,-11,-6,130,3648940,462
1935,m1811,20171221,2801,2806,2806,2808,2782,2782,2797,-24,-9,232,6489100,420
1936,m1811,20171222,2782,2797,2792,2795,2785,2785,2791,-12,-6,62,1730520,428
1937,m1811,20171225,2785,2791,2796,2798,2786,2789,2792,-2,1,310,8655420,522
1938,m1811,20171226,2789,2792,2792,2816,2792,2810,2811,18,19,104,2924260,532
1939,m1811,20171227,2810,2811,2812,2822,2808,2819,2812,8,1,110,3093700,492
1940,m1811,20171228,2819,2812,2814,2815,2796,2796,2805,-16,-7,82,2300380,488
1941,m1811,20171229,2796,2805,2796,2801,2763,2763,2791,-42,-14,158,4410940,460
1942,m1812,20171215,2826,2826,2772,2825,2772,2825,2798,-1,-28,4,111940,2
1943,m1812,20171218,2825,2798,0,0,0,2798,2798,0,0,0,0,2
1944,m1812,20171219,2798,2798,0,0,0,2798,2798,0,0,0,0,2
1945,m1812,20171220,2798,2798,0,0,0,2798,2798,0,0,0,0,2
1946,m1812,20171221,2798,2798,0,0,0,2798,2798,0,0,0,0,2
1947,m1812,20171222,2798,2798,0,0,0,2798,2798,0,0,0,0,2
1948,m1812,20171225,2798,2798,2765,2807,2678,2807,2764,9,-34,8,221140,4
1949,m1812,20171226,2807,2764,0,0,0,2786,2786,22,22,0,0,4
1950,m1812,20171227,2786,2786,2792,2792,2792,2792,2792,6,6,2,55840,2
1951,m1812,20171228,2792,2792,0,0,0,2792,2792,0,0,0,0,2
1952,m1812,20171229,2792,2792,2765,2795,2765,2795,2780,3,-12,2000,55600000,2
